,All people aged 16 to 74,1. Higher managerial administrative and professional occupations: Total,1. Higher managerial administrative and professional occupations: 1.1 Large employers and higher managerial occupations,1. Higher managerial administrative and professional occupations: 1.2 Higher professional occupations,2. Lower managerial and professional occupations,3. Intermediate occupations,4. Small employers and own account workers,5.  Lower supervisory and technical occupations,6. Semi-routine occupations,7. Routine occupations,8. Never worked and long-term unemployed: Total,8. Never worked and long-term unemployed: L14.1 Never worked,8. Never worked and long-term unemployed: L14.2 Long-term unemployed,L15 Full-time students
S92000003,3970530,344228,65396,278832,802545,513038,294610,326930,616404,514036,198630,124530,74100,360109
S01006506,692,111,12,99,180,88,58,50,79,54,28,24,4,44
S01006507,640,57,12,45,121,82,56,60,104,89,23,21,2,48
S01006508,530,82,11,71,137,99,39,54,51,35,5,4,1,28
S01006509,420,42,12,30,77,64,35,42,80,55,8,7,1,17
S01006510,455,46,10,36,106,61,29,46,75,40,18,11,7,34
S01006511,551,96,23,73,146,77,38,34,54,40,15,8,7,51
S01006512,340,78,12,66,85,36,38,15,30,18,4,3,1,36
S01006513,417,84,14,70,120,57,28,24,49,16,10,9,1,29
S01006514,709,172,34,138,216,86,46,27,35,23,18,16,2,86
S01006515,537,140,23,117,150,60,43,18,43,17,10,10,0,56
S01006516,423,99,24,75,115,34,48,16,36,11,4,4,0,60
S01006517,727,187,36,151,182,78,59,45,66,24,16,14,2,70
S01006518,464,124,32,92,133,49,47,17,37,5,7,5,2,45
S01006519,625,145,25,120,154,84,53,15,69,20,20,17,3,65
S01006520,497,156,31,125,144,49,23,14,32,8,11,6,5,60
S01006521,495,160,40,120,137,43,54,22,26,6,5,3,2,42
S01006522,402,136,21,115,121,45,20,7,24,8,5,3,2,36
S01006523,655,186,44,142,202,80,35,40,39,12,6,3,3,55
S01006524,618,131,30,101,142,65,56,23,51,22,77,70,7,51
S01006525,566,144,25,119,157,60,42,24,63,15,7,6,1,54
S01006526,676,43,6,37,101,75,23,72,105,93,33,19,14,131
S01006527,496,26,3,23,59,58,23,57,101,78,24,18,6,70
S01006528,805,40,4,36,112,83,29,83,123,106,31,23,8,198
S01006529,696,66,8,58,132,71,30,52,116,73,23,16,7,133
S01006530,618,33,6,27,86,73,27,69,106,90,35,24,11,99
S01006531,718,33,3,30,86,68,23,62,133,147,42,28,14,124
S01006532,519,98,16,82,144,78,45,18,41,24,14,11,3,57
S01006533,539,137,22,115,170,58,40,24,34,19,6,4,2,51
S01006534,663,186,39,147,201,87,37,30,55,13,10,6,4,44
S01006535,871,159,17,142,265,110,41,58,80,40,19,12,7,99
S01006536,882,173,24,149,264,109,33,62,80,46,16,8,8,99
S01006537,538,111,18,93,158,78,43,33,59,18,10,8,2,28
S01006538,410,82,20,62,128,57,22,34,40,15,7,5,2,25
S01006539,521,108,23,85,186,69,28,26,39,18,6,5,1,41
S01006540,723,174,34,140,201,111,32,41,64,29,9,8,1,62
S01006541,513,114,21,93,151,96,30,34,44,14,8,3,5,22
S01006542,707,175,33,142,220,106,40,28,54,27,17,15,2,40
S01006543,526,92,20,72,174,87,39,29,51,19,8,5,3,27
S01006544,811,254,40,214,219,90,63,49,45,20,16,11,5,55
S01006545,759,162,31,131,225,103,49,46,77,30,17,11,6,50
S01006546,470,102,18,84,155,60,20,19,40,24,11,9,2,39
S01006547,638,106,28,78,160,98,39,41,79,55,19,10,9,41
S01006548,503,107,18,89,168,81,31,17,45,13,6,3,3,35
S01006549,606,145,27,118,168,72,58,24,61,28,12,10,2,38
S01006550,659,154,23,131,183,112,41,39,43,18,10,9,1,59
S01006551,492,52,7,45,81,68,35,51,76,84,14,10,4,31
S01006552,700,146,22,124,202,107,46,34,63,33,11,6,5,58
S01006553,550,73,11,62,135,80,50,45,81,48,12,5,7,26
S01006554,521,63,3,60,123,76,29,46,78,65,21,11,10,20
S01006555,621,54,5,49,125,82,29,55,103,114,25,17,8,34
S01006556,569,24,5,19,102,69,38,57,100,118,24,16,8,37
S01006557,525,29,7,22,78,77,24,62,103,94,20,11,9,38
S01006558,511,148,12,136,152,63,16,36,29,18,3,3,0,46
S01006559,472,156,24,132,120,39,18,17,17,11,12,9,3,82
S01006560,706,209,30,179,202,76,48,25,37,21,10,9,1,78
S01006561,558,148,22,126,172,65,39,20,38,18,6,4,2,52
S01006562,531,101,13,88,135,69,28,31,62,39,17,15,2,49
S01006563,602,157,12,145,154,70,23,36,58,37,16,9,7,51
S01006564,818,112,8,104,184,67,32,76,103,78,40,31,9,126
S01006565,925,107,8,99,172,80,24,71,97,71,15,10,5,288
S01006566,663,130,7,123,181,83,20,36,58,34,16,12,4,105
S01006567,735,79,4,75,147,72,15,65,84,67,29,18,11,177
S01006568,863,198,10,188,232,79,21,55,66,41,15,6,9,156
S01006569,470,113,13,100,106,46,21,32,43,29,11,8,3,69
S01006570,609,155,25,130,181,60,28,35,38,24,17,10,7,71
S01006571,697,187,21,166,215,75,33,34,44,24,12,8,4,73
S01006572,643,213,47,166,173,74,44,26,39,10,8,6,2,56
S01006573,534,191,37,154,137,48,29,24,25,6,6,2,4,68
S01006574,741,231,43,188,225,62,51,29,45,12,18,13,5,68
S01006575,721,177,21,156,198,79,50,47,51,29,19,11,8,71
S01006576,544,170,24,146,139,51,28,29,39,18,6,4,2,64
S01006577,651,140,13,127,191,83,39,42,48,22,13,6,7,73
S01006578,952,174,10,164,241,110,16,72,103,63,29,17,12,144
S01006579,882,172,17,155,210,117,17,74,88,35,10,8,2,159
S01006580,615,148,13,135,183,73,25,37,46,26,17,12,5,60
S01006581,670,198,38,160,178,75,49,28,56,20,11,6,5,55
S01006582,797,143,8,135,160,75,32,50,106,55,27,12,15,149
S01006583,666,128,6,122,128,67,12,45,56,29,8,3,5,193
S01006584,561,114,9,105,136,46,17,36,39,25,5,4,1,143
S01006585,691,66,3,63,100,80,34,71,84,94,25,13,12,137
S01006586,929,121,10,111,159,91,28,74,120,85,19,12,7,232
S01006587,501,67,4,63,84,51,18,37,79,40,14,6,8,111
S01006588,551,71,2,69,102,47,8,31,61,39,8,5,3,184
S01006589,624,59,1,58,90,51,26,57,54,82,17,8,9,188
S01006590,644,114,8,106,128,72,37,41,75,39,32,27,5,106
S01006591,649,114,9,105,142,80,33,44,86,39,18,11,7,93
S01006592,600,124,12,112,181,77,24,49,48,17,8,7,1,72
S01006593,677,156,15,141,182,62,28,63,37,40,13,13,0,96
S01006594,446,78,10,68,92,81,26,30,42,35,2,1,1,60
S01006595,828,172,16,156,234,111,29,58,76,41,18,13,5,89
S01006596,590,147,10,137,153,65,40,45,56,22,9,5,4,53
S01006597,488,84,6,78,123,43,20,43,56,30,11,9,2,78
S01006598,766,209,33,176,219,93,51,54,50,26,9,4,5,55
S01006599,648,67,8,59,123,89,31,63,92,71,19,10,9,93
S01006600,798,162,23,139,190,108,48,56,98,45,18,12,6,73
S01006601,847,155,21,134,210,126,40,55,91,56,23,12,11,91
S01006602,606,175,31,144,155,57,38,27,48,23,15,13,2,68
S01006603,625,24,6,18,85,96,19,86,118,122,46,33,13,29
S01006604,538,23,4,19,82,71,37,56,108,98,16,9,7,47
S01006605,548,27,2,25,76,62,22,57,124,121,26,11,15,33
S01006606,618,65,14,51,143,78,47,51,97,67,22,18,4,48
S01006607,695,34,5,29,102,116,35,70,136,138,21,14,7,43
S01006608,562,54,8,46,132,83,67,58,61,48,12,5,7,47
S01006609,772,24,3,21,103,126,38,105,156,157,21,11,10,42
S01006610,328,16,8,8,40,49,13,45,65,65,16,13,3,19
S01006611,654,25,3,22,105,87,29,80,136,123,29,15,14,40
S01006612,669,48,4,44,146,97,33,62,111,113,10,7,3,49
S01006613,472,52,10,42,114,102,30,49,61,39,4,2,2,21
S01006614,484,76,10,66,138,85,31,40,50,37,7,3,4,20
S01006615,551,92,27,65,135,92,37,58,68,32,2,0,2,35
S01006616,655,63,9,54,147,110,37,74,103,68,8,4,4,45
S01006617,520,42,10,32,101,92,40,52,84,79,7,4,3,23
S01006618,443,54,14,40,94,72,26,55,76,44,3,2,1,19
S01006619,705,60,7,53,139,98,57,87,115,87,7,6,1,55
S01006620,690,44,7,37,148,125,36,91,124,83,8,4,4,31
S01006621,414,21,3,18,90,63,28,60,71,56,8,5,3,17
S01006622,543,59,10,49,133,107,38,61,70,43,3,3,0,29
S01006623,584,32,3,29,99,88,26,82,99,104,15,13,2,39
S01006624,857,52,7,45,110,91,43,114,151,175,51,40,11,70
S01006625,510,32,6,26,80,60,30,53,95,111,13,9,4,36
S01006626,548,11,4,7,61,63,21,59,125,149,21,13,8,38
S01006627,753,46,10,36,122,96,29,90,121,178,25,9,16,46
S01006628,954,70,7,63,129,94,30,131,154,207,27,12,15,112
S01006629,568,17,5,12,62,50,18,65,121,141,45,28,17,49
S01006630,459,8,2,6,34,49,22,58,103,132,29,22,7,24
S01006631,711,38,8,30,96,79,25,88,143,178,37,30,7,27
S01006632,624,24,1,23,71,59,21,63,132,157,47,30,17,50
S01006633,503,15,4,11,38,49,14,52,109,138,42,35,7,46
S01006634,445,17,6,11,35,31,9,54,86,135,56,40,16,22
S01006635,485,21,0,21,57,55,23,60,98,118,21,11,10,32
S01006636,603,11,1,10,40,47,21,70,143,182,38,26,12,51
S01006637,619,75,6,69,103,68,24,55,99,70,23,15,8,102
S01006638,758,64,3,61,129,85,14,57,113,84,22,11,11,190
S01006639,805,57,10,47,122,72,27,63,121,96,36,22,14,211
S01006640,683,110,13,97,141,68,12,42,41,30,9,6,3,230
S01006641,940,108,8,100,159,96,23,71,112,82,34,26,8,255
S01006642,1306,71,3,68,123,68,20,50,73,53,17,11,6,831
S01006643,701,74,7,67,113,60,18,31,56,39,14,7,7,296
S01006644,893,94,6,88,125,83,20,59,92,82,20,15,5,318
S01006645,547,35,4,31,82,51,16,53,103,104,29,17,12,74
S01006646,943,44,2,42,91,39,7,36,61,32,8,5,3,625
S01006647,529,32,2,30,88,59,17,46,86,81,24,15,9,96
S01006648,1719,85,6,79,165,93,30,100,128,107,27,10,17,984
S01006649,881,101,2,99,133,106,19,61,115,106,33,20,13,207
S01006650,793,58,6,52,138,59,28,54,100,73,20,15,5,263
S01006651,564,47,0,47,74,52,9,53,65,52,20,10,10,192
S01006652,505,60,2,58,95,42,19,39,36,35,17,9,8,162
S01006653,500,96,5,91,114,55,16,30,40,23,5,4,1,121
S01006654,728,61,4,57,107,94,23,64,112,128,40,23,17,99
S01006655,620,117,14,103,125,63,21,37,57,51,50,46,4,99
S01006656,834,116,3,113,165,90,25,62,94,73,33,18,15,176
S01006657,474,54,5,49,72,59,8,30,64,52,6,1,5,129
S01006658,854,59,1,58,95,57,27,85,105,99,40,25,15,287
S01006659,566,67,6,61,83,43,14,31,43,26,8,5,3,251
S01006660,422,26,1,25,42,28,15,39,54,54,17,13,4,147
S01006661,567,66,7,59,86,58,15,37,47,34,5,2,3,219
S01006662,732,17,2,15,61,37,22,47,64,60,26,17,9,398
S01006663,512,50,3,47,58,36,15,19,23,23,13,10,3,275
S01006664,458,47,4,43,60,17,7,29,45,24,13,8,5,216
S01006665,655,44,3,41,72,46,17,28,36,34,13,11,2,365
S01006666,651,22,2,20,63,51,30,76,129,162,56,35,21,62
S01006667,613,21,3,18,68,43,22,70,101,141,57,35,22,90
S01006668,831,73,4,69,113,61,12,38,67,26,12,7,5,429
S01006669,1101,78,3,75,70,47,28,60,90,110,23,16,7,595
S01006670,839,35,5,30,94,68,21,29,62,60,10,6,4,460
S01006671,2327,53,11,42,58,39,13,29,46,32,23,17,6,2034
S01006672,648,40,1,39,70,48,18,42,95,110,33,23,10,192
S01006673,736,50,3,47,73,54,38,57,90,91,23,9,14,260
S01006674,662,35,7,28,62,70,33,78,121,157,48,25,23,58
S01006675,526,12,1,11,45,33,17,55,108,145,41,22,19,70
S01006676,569,33,1,32,51,41,24,49,116,155,32,20,12,68
S01006677,597,17,2,15,69,51,23,61,108,125,33,13,20,110
S01006678,893,18,3,15,92,72,28,92,180,249,58,35,23,104
S01006679,548,37,4,33,126,84,23,59,94,75,5,1,4,45
S01006680,630,12,2,10,54,40,26,79,129,199,47,25,22,44
S01006681,588,35,4,31,124,71,19,84,95,98,21,10,11,41
S01006682,629,22,1,21,72,35,28,61,118,164,48,27,21,81
S01006683,684,34,1,33,83,62,18,61,129,124,34,18,16,139
S01006684,589,33,7,26,60,63,26,68,123,123,24,11,13,69
S01006685,597,28,5,23,110,60,23,60,97,128,38,11,27,53
S01006686,472,32,3,29,75,53,20,47,106,92,12,8,4,35
S01006687,647,42,2,40,111,84,16,80,121,114,24,16,8,55
S01006688,672,58,15,43,139,99,51,56,116,86,14,9,5,53
S01006689,529,104,12,92,133,75,35,20,37,20,7,3,4,98
S01006690,472,64,4,60,104,43,13,39,53,44,13,6,7,99
S01006691,466,83,6,77,86,49,22,22,54,28,6,4,2,116
S01006692,594,88,17,71,138,53,31,49,72,53,10,7,3,100
S01006693,780,87,12,75,135,104,34,84,83,113,32,22,10,108
S01006694,555,12,4,8,74,76,29,71,125,130,13,8,5,25
S01006695,535,46,12,34,80,63,36,69,88,107,15,12,3,31
S01006696,608,34,5,29,77,81,19,52,110,117,28,17,11,90
S01006697,691,33,3,30,103,93,36,76,129,137,15,9,6,69
S01006698,511,23,0,23,83,58,15,47,89,119,17,11,6,60
S01006699,377,38,7,31,69,48,14,24,54,69,6,3,3,55
S01006700,658,66,7,59,130,86,37,50,90,101,18,11,7,80
S01006701,507,12,2,10,65,53,18,70,127,109,33,19,14,20
S01006702,563,16,2,14,63,74,38,60,138,131,22,8,14,21
S01006703,468,17,4,13,65,56,23,48,107,106,22,15,7,24
S01006704,446,6,4,2,58,57,14,48,92,110,35,20,15,26
S01006705,546,16,5,11,62,65,35,63,126,134,15,9,6,30
S01006706,451,17,4,13,77,61,28,51,89,78,23,18,5,27
S01006707,506,20,2,18,65,56,21,55,110,105,36,20,16,38
S01006708,558,25,4,21,94,82,27,68,119,97,8,7,1,38
S01006709,619,24,7,17,72,85,44,64,134,130,25,16,9,41
S01006710,640,16,2,14,116,109,35,84,120,121,20,13,7,19
S01006711,699,20,4,16,124,109,50,71,124,146,27,15,12,28
S01006712,381,19,9,10,65,60,14,47,64,84,15,8,7,13
S01006713,679,22,6,16,82,100,32,71,131,174,30,26,4,37
S01006714,513,21,4,17,67,75,20,57,103,110,29,24,5,31
S01006715,416,15,1,14,43,28,16,39,84,117,25,17,8,49
S01006716,478,19,2,17,66,46,25,57,107,103,20,15,5,35
S01006717,705,22,9,13,82,92,30,87,161,160,38,25,13,33
S01006718,471,12,3,9,51,49,26,57,99,113,22,13,9,42
S01006719,691,30,3,27,104,71,40,80,135,157,28,20,8,46
S01006720,446,13,1,12,67,59,18,44,88,115,16,10,6,26
S01006721,683,23,3,20,99,68,32,75,130,175,36,23,13,45
S01006722,585,23,4,19,70,61,18,67,135,139,32,21,11,40
S01006723,506,23,4,19,80,59,25,64,85,113,33,27,6,24
S01006724,676,16,4,12,55,59,25,59,142,190,64,45,19,66
S01006725,499,17,5,12,50,52,22,56,122,125,20,14,6,35
S01006726,975,20,1,19,86,72,37,108,181,261,106,60,46,104
S01006727,704,12,2,10,63,61,23,72,144,185,69,52,17,75
S01006728,542,27,6,21,79,65,19,52,115,115,30,18,12,40
S01006729,596,12,3,9,68,54,16,57,131,168,52,36,16,38
S01006730,547,20,4,16,90,79,13,59,119,114,15,10,5,38
S01006731,468,8,1,7,62,61,23,58,86,121,26,17,9,23
S01006732,795,134,29,105,185,92,65,38,67,45,19,15,4,150
S01006733,625,146,23,123,176,108,36,30,51,19,15,11,4,44
S01006734,693,161,26,135,169,110,55,41,48,43,28,23,5,38
S01006735,431,104,22,82,133,67,25,16,28,21,2,1,1,35
S01006736,762,158,27,131,217,117,49,66,60,41,16,7,9,38
S01006737,495,83,24,59,123,71,46,41,60,30,11,10,1,30
S01006738,684,55,7,48,157,126,38,81,100,82,18,9,9,27
S01006739,510,50,6,44,129,85,30,52,66,62,12,2,10,24
S01006740,557,29,6,23,113,61,23,62,111,112,16,10,6,30
S01006741,496,27,6,21,77,78,23,61,109,99,5,3,2,17
S01006742,328,16,2,14,56,47,21,40,73,55,9,5,4,11
S01006743,422,28,4,24,93,80,26,43,65,53,2,1,1,32
S01006744,498,46,12,34,103,71,33,62,96,57,12,8,4,18
S01006745,601,31,4,27,100,74,33,73,129,116,17,14,3,28
S01006746,592,21,4,17,99,94,30,75,123,88,19,14,5,43
S01006747,621,73,10,63,156,104,27,66,92,57,11,8,3,35
S01006748,701,77,20,57,164,113,53,84,102,75,14,13,1,19
S01006749,702,43,8,35,133,108,25,91,157,109,17,11,6,19
S01006750,539,28,6,22,98,62,31,77,92,94,13,10,3,44
S01006751,358,30,11,19,67,42,23,54,67,47,12,11,1,16
S01006752,521,29,4,25,95,75,14,74,104,100,10,5,5,20
S01006753,706,99,24,75,152,112,45,78,89,75,12,8,4,44
S01006754,745,92,18,74,182,132,37,95,95,60,18,10,8,34
S01006755,548,73,6,67,137,72,59,48,58,43,7,2,5,51
S01006756,540,146,29,117,144,72,26,24,48,22,11,8,3,47
S01006757,629,52,6,46,177,119,35,64,66,49,19,15,4,48
S01006758,575,82,15,67,147,90,23,54,100,43,2,0,2,34
S01006759,470,49,11,38,112,87,24,43,60,56,7,6,1,32
S01006760,398,44,10,34,103,83,17,34,42,38,4,2,2,33
S01006761,584,52,15,37,146,110,35,37,101,69,5,2,3,29
S01006762,573,62,10,52,144,104,46,50,90,44,6,4,2,27
S01006763,662,78,11,67,188,112,30,62,73,48,18,16,2,53
S01006764,656,66,16,50,171,120,23,72,87,65,8,4,4,44
S01006765,487,51,12,39,125,101,19,53,69,40,5,3,2,24
S01006766,487,83,20,63,120,77,30,37,59,27,10,6,4,44
S01006767,544,50,7,43,107,93,30,60,98,55,6,3,3,45
S01006768,495,93,28,65,105,83,40,35,48,30,5,5,0,56
S01006769,749,63,12,51,158,118,41,82,134,88,10,4,6,55
S01006770,544,50,13,37,122,119,27,51,93,47,9,6,3,26
S01006771,373,57,13,44,78,60,21,33,58,13,4,2,2,49
S01006772,683,77,15,62,164,124,52,63,104,56,8,3,5,35
S01006773,520,37,6,31,129,119,44,46,67,30,6,4,2,42
S01006774,534,60,15,45,126,94,33,49,81,38,9,6,3,44
S01006775,509,37,5,32,106,85,28,48,91,68,9,5,4,37
S01006776,352,20,6,14,59,45,21,46,78,63,8,4,4,12
S01006777,534,49,9,40,134,104,34,53,79,42,1,1,0,38
S01006778,525,52,10,42,95,96,23,55,96,68,9,5,4,31
S01006779,438,25,7,18,53,66,18,42,86,92,8,4,4,48
S01006780,458,34,7,27,102,64,43,41,75,56,12,8,4,31
S01006781,543,49,14,35,111,117,40,45,75,50,6,4,2,50
S01006782,590,72,18,54,144,79,44,61,84,54,11,8,3,41
S01006783,505,36,4,32,125,79,29,50,83,64,10,7,3,29
S01006784,502,62,10,52,138,69,41,42,64,40,7,5,2,39
S01006785,487,60,16,44,127,86,27,46,64,29,3,2,1,45
S01006786,645,104,19,85,160,95,38,54,96,40,9,5,4,49
S01006787,522,55,12,43,106,88,46,51,80,54,7,5,2,35
S01006788,611,95,19,76,130,77,44,47,90,47,33,30,3,48
S01006789,458,47,12,35,92,37,70,59,79,53,9,3,6,12
S01006790,610,54,15,39,122,62,66,76,118,76,8,4,4,28
S01006791,390,36,8,28,81,31,75,52,50,37,9,4,5,19
S01006792,376,43,10,33,74,43,61,36,56,42,4,3,1,17
S01006793,414,31,7,24,81,27,66,65,68,67,3,3,0,6
S01006794,436,39,11,28,110,36,42,49,80,59,10,5,5,11
S01006795,520,99,23,76,121,61,56,41,68,33,11,9,2,30
S01006796,401,59,12,47,97,52,49,35,58,26,5,4,1,20
S01006797,469,70,21,49,127,44,74,35,50,34,12,8,4,23
S01006798,452,58,15,43,97,57,85,40,61,24,3,1,2,27
S01006799,623,58,14,44,127,86,49,71,98,85,13,9,4,36
S01006800,635,129,28,101,171,57,56,49,67,44,6,3,3,56
S01006801,671,86,21,65,149,103,93,64,79,51,17,11,6,29
S01006802,493,48,13,35,96,42,68,53,77,72,6,4,2,31
S01006803,481,28,6,22,102,66,36,66,70,80,7,4,3,26
S01006804,541,66,19,47,143,64,44,61,83,58,5,3,2,17
S01006805,821,70,16,54,186,103,97,61,134,91,16,9,7,63
S01006806,794,85,16,69,184,103,106,79,98,82,11,8,3,46
S01006807,472,37,8,29,108,65,63,41,67,58,13,2,11,20
S01006808,467,59,13,46,135,62,53,42,50,34,3,2,1,29
S01006809,581,38,17,21,125,55,64,58,108,89,15,7,8,29
S01006810,656,76,18,58,147,59,91,62,95,71,23,12,11,32
S01006811,787,116,28,88,192,95,95,62,96,72,20,12,8,39
S01006812,575,70,12,58,138,62,64,53,89,59,13,10,3,27
S01006813,574,45,8,37,123,58,67,68,83,86,13,7,6,31
S01006814,594,96,22,74,168,75,38,49,65,29,13,11,2,61
S01006815,408,29,13,16,66,46,26,45,92,71,16,7,9,17
S01006816,533,42,14,28,130,76,54,52,81,57,10,8,2,31
S01006817,489,54,6,48,103,53,54,46,88,59,5,2,3,27
S01006818,544,75,20,55,132,60,76,53,88,25,8,4,4,27
S01006819,623,115,31,84,152,59,91,36,65,41,9,5,4,55
S01006820,354,65,12,53,107,42,26,27,34,25,5,2,3,23
S01006821,464,72,16,56,107,64,75,36,37,33,8,2,6,32
S01006822,584,100,32,68,127,70,94,35,65,38,10,5,5,45
S01006823,536,93,15,78,143,87,32,47,59,26,16,13,3,33
S01006824,601,18,5,13,92,65,33,56,138,127,42,31,11,30
S01006825,646,44,8,36,154,99,36,71,108,84,10,6,4,40
S01006826,683,94,31,63,171,84,54,52,78,74,23,22,1,53
S01006827,665,79,14,65,130,97,35,59,116,100,17,11,6,32
S01006828,702,66,17,49,179,98,59,85,105,66,17,10,7,27
S01006829,286,66,13,53,89,40,19,23,19,12,3,1,2,15
S01006830,571,47,9,38,114,101,49,52,92,44,16,10,6,56
S01006831,423,53,10,43,128,66,24,40,58,22,3,2,1,29
S01006832,765,130,38,92,224,92,61,56,81,54,11,10,1,56
S01006833,318,64,13,51,97,43,38,18,30,11,0,0,0,17
S01006834,374,77,23,54,110,53,19,16,25,24,7,5,2,43
S01006835,583,70,17,53,149,60,63,67,82,48,12,9,3,32
S01006836,367,76,18,58,106,41,28,25,46,23,3,2,1,19
S01006837,442,66,12,54,117,70,40,34,45,34,6,5,1,30
S01006838,485,71,15,56,113,64,33,42,62,59,5,5,0,36
S01006839,786,76,13,63,191,144,50,79,107,84,14,6,8,41
S01006840,744,112,18,94,222,118,44,57,77,49,9,5,4,56
S01006841,710,79,12,67,205,119,43,52,87,60,12,6,6,53
S01006842,643,59,18,41,176,121,39,57,92,47,6,4,2,46
S01006843,642,61,13,48,135,138,41,57,102,47,10,7,3,51
S01006844,560,47,3,44,126,103,37,57,90,59,2,0,2,39
S01006845,753,76,15,61,192,113,43,80,116,50,16,11,5,67
S01006846,438,35,8,27,84,73,28,54,88,41,5,4,1,30
S01006847,518,63,15,48,117,87,37,57,58,37,11,10,1,51
S01006848,737,131,29,102,149,79,85,50,75,76,45,38,7,47
S01006849,692,99,25,74,174,133,35,60,83,62,11,7,4,35
S01006850,743,51,13,38,166,122,37,84,130,92,16,10,6,45
S01006851,589,41,13,28,102,95,35,59,112,90,16,12,4,39
S01006852,468,66,16,50,110,59,50,53,59,36,6,2,4,29
S01006853,639,154,36,118,166,58,80,40,43,40,9,4,5,49
S01006854,643,100,26,74,155,87,58,43,83,66,15,5,10,36
S01006855,572,121,28,93,146,72,77,29,65,25,8,5,3,29
S01006856,483,85,16,69,122,49,59,46,53,40,6,2,4,23
S01006857,753,108,21,87,182,71,150,54,85,56,10,5,5,37
S01006858,483,89,9,80,125,52,84,26,45,32,4,4,0,26
S01006859,792,152,48,104,235,95,62,42,87,37,20,13,7,62
S01006860,393,27,5,22,73,36,35,40,77,75,5,3,2,25
S01006861,409,96,17,79,117,63,31,24,30,12,6,4,2,30
S01006862,502,71,10,61,102,67,46,51,84,47,5,0,5,29
S01006863,486,45,14,31,105,67,41,55,80,67,6,5,1,20
S01006864,305,43,11,32,70,36,19,30,48,30,12,7,5,17
S01006865,716,141,27,114,165,69,85,50,93,57,6,4,2,50
S01006866,413,77,12,65,136,58,22,34,32,17,3,3,0,34
S01006867,537,127,25,102,160,50,41,33,52,22,7,5,2,45
S01006868,624,79,15,64,136,63,48,72,105,73,6,5,1,42
S01006869,381,55,10,45,69,39,48,41,52,44,13,11,2,20
S01006870,355,54,8,46,97,31,42,27,37,28,7,2,5,32
S01006871,476,72,19,53,144,67,33,30,52,36,12,6,6,30
S01006872,504,112,24,88,137,56,67,43,37,24,3,2,1,25
S01006873,622,112,24,88,161,53,87,41,83,37,10,5,5,38
S01006874,447,72,14,58,99,49,64,32,56,34,7,3,4,34
S01006875,487,50,7,43,91,49,64,47,75,65,16,6,10,30
S01006876,702,87,21,66,138,84,111,62,89,72,11,7,4,48
S01006877,703,111,17,94,163,90,125,47,72,44,11,7,4,40
S01006878,520,40,9,31,113,46,127,35,80,51,9,4,5,19
S01006879,574,84,16,68,108,49,115,49,65,49,13,6,7,42
S01006880,443,77,18,59,135,56,47,39,40,22,1,1,0,26
S01006881,430,69,21,48,101,53,75,32,46,34,3,1,2,17
S01006882,258,12,2,10,51,31,19,32,57,39,5,3,2,12
S01006883,329,36,9,27,86,39,31,22,49,41,6,0,6,19
S01006884,627,52,14,38,135,89,52,64,115,67,7,2,5,46
S01006885,386,64,12,52,89,44,49,34,46,30,5,5,0,25
S01006886,575,102,18,84,158,62,75,41,53,45,10,8,2,29
S01006887,418,70,19,51,111,39,49,36,42,43,6,3,3,22
S01006888,596,86,15,71,136,76,93,48,70,35,15,8,7,37
S01006889,624,30,9,21,107,66,31,76,119,135,26,13,13,34
S01006890,487,74,17,57,127,68,37,53,57,42,8,1,7,21
S01006891,693,95,18,77,177,80,40,76,93,77,10,7,3,45
S01006892,458,24,3,21,92,56,28,72,78,77,11,8,3,20
S01006893,390,22,6,16,78,53,24,45,64,67,8,7,1,29
S01006894,718,64,9,55,176,103,42,76,105,97,21,15,6,34
S01006895,411,25,4,21,75,52,23,56,83,75,9,6,3,13
S01006896,606,58,16,42,132,91,25,75,84,93,13,6,7,35
S01006897,572,62,14,48,128,79,30,78,101,54,9,3,6,31
S01006898,559,48,7,41,133,80,34,48,104,77,14,13,1,21
S01006899,462,65,17,48,127,86,19,40,53,39,5,3,2,28
S01006900,467,47,14,33,97,76,19,46,75,66,9,8,1,32
S01006901,460,24,8,16,97,57,18,55,89,87,8,5,3,25
S01006902,502,38,11,27,113,68,25,49,90,76,14,9,5,29
S01006903,587,41,5,36,104,66,31,54,116,124,20,16,4,31
S01006904,491,48,7,41,106,70,27,57,74,69,4,3,1,36
S01006905,645,72,19,53,145,68,70,67,112,72,14,12,2,25
S01006906,582,25,5,20,95,82,33,68,115,124,19,12,7,21
S01006907,480,27,7,20,105,62,38,55,64,92,20,16,4,17
S01006908,618,40,7,33,131,76,33,77,102,115,18,7,11,26
S01006909,552,103,24,79,151,97,46,48,52,28,4,3,1,23
S01006910,665,118,20,98,183,75,85,38,56,54,14,10,4,42
S01006911,450,95,15,80,139,54,26,41,35,32,5,3,2,23
S01006912,364,49,6,43,99,27,50,23,58,33,4,1,3,21
S01006913,380,62,13,49,110,62,30,24,43,23,3,1,2,23
S01006914,557,100,21,79,124,63,65,55,51,57,2,0,2,40
S01006915,609,92,17,75,147,78,70,60,64,56,10,9,1,32
S01006916,391,52,11,41,94,61,19,42,61,32,6,4,2,24
S01006917,637,138,26,112,179,114,55,51,44,29,4,0,4,23
S01006918,349,60,13,47,82,58,29,27,37,35,6,3,3,15
S01006919,380,46,8,38,101,55,33,35,46,34,7,5,2,23
S01006920,355,41,12,29,95,55,26,32,63,28,3,1,2,12
S01006921,551,89,15,74,180,79,24,51,62,30,4,2,2,32
S01006922,385,67,17,50,80,37,54,20,71,32,4,2,2,20
S01006923,554,88,24,64,132,77,64,49,75,38,12,8,4,19
S01006924,426,71,22,49,122,36,73,31,43,21,3,1,2,26
S01006925,375,55,10,45,95,65,23,28,48,34,5,3,2,22
S01006926,528,97,20,77,143,98,31,48,66,23,6,2,4,16
S01006927,703,148,19,129,208,134,40,55,56,30,14,5,9,18
S01006928,776,98,9,89,186,115,60,94,94,80,8,6,2,41
S01006929,623,166,44,122,170,98,38,23,41,18,13,6,7,56
S01006930,719,137,37,100,217,108,44,48,57,29,14,6,8,65
S01006931,289,56,8,48,75,40,34,15,23,20,4,3,1,22
S01006932,433,64,17,47,123,71,34,23,36,27,5,3,2,50
S01006933,474,79,6,73,122,79,24,30,62,28,6,3,3,44
S01006934,448,69,13,56,94,56,50,39,55,42,18,16,2,25
S01006935,535,82,19,63,151,87,35,37,62,35,8,6,2,38
S01006936,480,60,15,45,148,81,25,35,64,32,7,4,3,28
S01006937,565,66,11,55,166,97,34,47,71,34,9,4,5,41
S01006938,382,50,9,41,90,65,21,40,62,27,2,1,1,25
S01006939,481,86,23,63,129,91,22,25,57,32,1,0,1,38
S01006940,743,118,22,96,212,118,45,55,75,41,11,10,1,68
S01006941,458,54,7,47,115,75,25,37,61,43,9,6,3,39
S01006942,793,120,31,89,205,132,57,60,100,33,7,4,3,79
S01006943,441,109,21,88,142,56,25,20,38,15,7,2,5,29
S01006944,616,105,21,84,177,119,31,49,55,30,8,4,4,42
S01006945,409,72,19,53,115,60,30,30,47,22,6,4,2,27
S01006946,621,102,23,79,186,84,45,47,63,45,8,4,4,41
S01006947,609,91,15,76,161,107,33,61,60,51,8,5,3,37
S01006948,657,91,26,65,172,99,69,52,84,49,6,3,3,35
S01006949,489,103,22,81,133,65,52,34,42,22,8,7,1,30
S01006950,379,72,10,62,107,47,21,49,42,28,1,1,0,12
S01006951,361,31,8,23,91,60,22,50,50,34,6,3,3,17
S01006952,667,89,21,68,132,98,82,60,91,72,3,2,1,40
S01006953,608,111,29,82,158,85,57,50,69,32,7,6,1,39
S01006954,621,76,16,60,180,90,50,64,68,46,5,2,3,42
S01006955,455,40,9,31,112,75,32,54,61,48,7,5,2,26
S01006956,804,113,18,95,250,104,46,93,83,47,13,7,6,55
S01006957,779,115,20,95,203,119,89,73,78,37,10,7,3,55
S01006958,665,77,13,64,192,88,52,54,96,59,12,9,3,35
S01006959,484,47,8,39,107,52,33,45,74,77,19,12,7,30
S01006960,674,127,41,86,174,96,51,61,69,31,16,10,6,49
S01006961,665,95,17,78,218,103,38,52,69,38,6,3,3,46
S01006962,675,68,11,57,168,89,45,74,117,69,13,9,4,32
S01006963,543,51,18,33,152,70,31,53,75,48,15,12,3,48
S01006964,621,50,12,38,151,85,33,76,93,92,7,4,3,34
S01006965,395,48,13,35,104,46,32,41,51,38,7,4,3,28
S01006966,444,25,2,23,88,58,20,47,80,75,16,4,12,35
S01006967,489,48,7,41,121,70,32,52,71,51,9,4,5,35
S01006968,402,19,3,16,83,57,23,50,80,64,3,2,1,23
S01006969,692,62,15,47,157,107,51,73,95,97,11,7,4,39
S01006970,529,67,17,50,143,104,19,52,68,28,7,6,1,41
S01006971,385,26,7,19,68,41,23,44,82,62,11,10,1,28
S01006972,406,58,13,45,88,65,56,33,48,23,5,5,0,30
S01006973,438,68,18,50,124,64,45,31,47,32,5,2,3,22
S01006974,775,123,26,97,219,105,56,75,83,56,15,6,9,43
S01006975,740,98,23,75,165,87,109,72,103,64,10,4,6,32
S01006976,354,46,12,34,93,37,55,30,48,21,4,2,2,20
S01006977,621,78,16,62,140,66,103,55,85,52,6,2,4,36
S01006978,656,107,24,83,141,71,67,64,98,59,14,10,4,35
S01006979,614,93,31,62,139,69,76,49,75,65,13,6,7,35
S01006980,652,92,22,70,157,82,63,61,84,48,17,8,9,48
S01006981,621,76,24,52,155,74,74,40,81,74,10,8,2,37
S01006982,640,76,20,56,137,90,60,72,101,58,8,2,6,38
S01006983,560,69,21,48,153,71,64,48,61,47,8,4,4,39
S01006984,543,105,11,94,131,65,72,50,52,27,6,4,2,35
S01006985,755,71,10,61,160,96,70,84,103,115,12,8,4,44
S01006986,468,66,12,54,99,68,27,49,61,53,15,11,4,30
S01006987,482,63,13,50,135,64,24,43,64,51,16,9,7,22
S01006988,442,63,12,51,112,55,49,35,50,33,12,7,5,33
S01006989,768,141,29,112,184,109,100,52,74,55,5,3,2,48
S01006990,642,115,27,88,182,101,64,45,55,29,8,4,4,43
S01006991,307,29,5,24,56,25,32,32,68,47,7,7,0,11
S01006992,487,58,11,47,123,52,74,38,61,38,9,6,3,34
S01006993,414,39,6,33,86,38,78,42,59,38,5,4,1,29
S01006994,471,57,11,46,113,54,57,49,53,55,7,4,3,26
S01006995,638,76,19,57,142,76,96,62,82,63,11,5,6,30
S01006996,554,51,16,35,103,66,64,62,94,75,7,2,5,32
S01006997,575,91,19,72,151,67,73,54,50,41,5,3,2,43
S01006998,829,107,21,86,206,99,110,88,96,70,8,4,4,45
S01006999,659,50,11,39,123,69,134,81,92,75,7,6,1,28
S01007000,692,68,17,51,157,94,65,78,87,101,10,5,5,32
S01007001,668,80,17,63,162,83,72,66,86,66,12,7,5,41
S01007002,422,36,6,30,81,52,57,32,64,59,20,15,5,21
S01007003,391,34,4,30,72,38,85,29,65,43,9,3,6,16
S01007004,550,54,9,45,111,73,99,41,71,60,8,7,1,33
S01007005,682,97,17,80,169,68,96,63,82,58,6,3,3,43
S01007006,675,63,12,51,114,56,95,73,136,97,12,7,5,29
S01007007,632,51,12,39,110,65,135,68,85,68,23,17,6,27
S01007008,728,53,15,38,106,70,56,99,141,130,30,26,4,43
S01007009,766,40,6,34,149,92,67,91,145,125,19,14,5,38
S01007010,535,51,9,42,120,69,52,40,98,66,13,8,5,26
S01007011,599,22,8,14,78,65,56,74,148,105,26,15,11,25
S01007012,504,15,4,11,50,51,18,56,120,131,36,16,20,27
S01007013,433,44,8,36,80,48,94,43,52,40,7,6,1,25
S01007014,743,57,16,41,162,87,116,86,118,58,17,10,7,42
S01007015,478,32,11,21,86,49,106,49,73,49,12,9,3,22
S01007016,465,44,9,35,90,51,76,50,68,44,11,5,6,31
S01007017,705,30,5,25,85,70,53,90,154,170,23,15,8,30
S01007018,690,37,10,27,133,81,64,85,142,106,15,8,7,27
S01007019,500,21,4,17,74,52,36,61,109,105,19,11,8,23
S01007020,556,40,14,26,95,61,46,76,103,85,22,15,7,28
S01007021,650,29,11,18,103,80,44,75,140,138,22,15,7,19
S01007022,350,17,5,12,64,30,38,36,66,64,15,8,7,20
S01007023,355,13,2,11,63,31,77,40,61,42,14,11,3,14
S01007024,766,38,6,32,146,70,164,64,124,97,16,9,7,47
S01007025,625,24,6,18,93,46,59,78,127,160,20,13,7,18
S01007026,637,33,9,24,121,61,88,74,106,109,17,12,5,28
S01007027,766,40,11,29,141,65,105,87,139,127,25,21,4,37
S01007028,563,35,6,29,107,57,119,49,91,57,17,13,4,31
S01007029,427,25,5,20,72,41,112,34,61,49,14,10,4,19
S01007030,609,20,9,11,97,50,74,61,135,137,11,8,3,24
S01007031,459,25,6,19,88,26,55,49,108,68,16,8,8,24
S01007032,720,38,6,32,136,62,58,65,138,124,48,35,13,51
S01007033,548,19,4,15,87,56,19,61,124,125,30,21,9,27
S01007034,443,24,7,17,85,42,29,43,93,68,17,10,7,42
S01007035,569,18,9,9,54,36,41,49,168,154,18,9,9,31
S01007036,658,49,17,32,140,67,78,65,114,73,27,25,2,45
S01007037,747,23,7,16,93,82,60,85,168,158,29,16,13,49
S01007038,570,21,6,15,90,61,60,55,120,102,27,16,11,34
S01007039,632,19,10,9,99,60,59,70,124,132,34,22,12,35
S01007040,466,18,6,12,62,43,32,55,112,100,13,8,5,31
S01007041,555,23,5,18,95,51,54,63,110,89,38,29,9,32
S01007042,514,31,6,25,78,53,63,53,96,86,23,11,12,31
S01007043,766,69,16,53,155,79,146,74,108,91,20,15,5,24
S01007044,504,32,9,23,80,52,92,52,85,67,9,8,1,35
S01007045,632,44,7,37,115,55,150,54,94,70,23,16,7,27
S01007046,472,20,2,18,93,43,72,43,94,74,11,11,0,22
S01007047,519,29,8,21,110,61,91,50,72,69,11,6,5,26
S01007048,726,42,10,32,104,81,136,77,120,101,20,17,3,45
S01007049,701,21,5,16,115,56,57,88,154,162,21,12,9,27
S01007050,477,36,10,26,77,39,70,49,88,72,23,21,2,23
S01007051,570,43,10,33,102,74,46,69,97,95,22,19,3,22
S01007052,442,30,10,20,68,53,52,53,81,70,11,8,3,24
S01007053,383,39,11,28,72,41,65,44,49,40,9,5,4,24
S01007054,691,39,11,28,107,76,55,102,127,128,29,17,12,28
S01007055,404,30,4,26,79,39,87,34,60,45,6,4,2,24
S01007056,478,42,5,37,95,53,95,35,66,47,11,6,5,34
S01007057,383,18,6,12,91,59,30,39,62,57,10,8,2,17
S01007058,401,15,4,11,65,47,35,57,81,77,6,4,2,18
S01007059,723,56,20,36,134,90,56,72,130,115,26,21,5,44
S01007060,463,20,7,13,48,43,26,59,107,94,29,17,12,37
S01007061,711,98,26,72,176,91,100,62,94,44,13,6,7,33
S01007062,539,72,14,58,115,59,107,44,51,49,7,6,1,35
S01007063,496,28,5,23,95,63,56,54,70,82,13,9,4,35
S01007064,502,48,6,42,100,58,92,38,62,72,5,5,0,27
S01007065,445,67,15,52,121,51,46,37,52,38,6,5,1,27
S01007066,511,42,12,30,108,47,75,66,69,60,11,7,4,33
S01007067,451,37,12,25,99,71,31,61,73,53,8,4,4,18
S01007068,545,60,14,46,115,64,68,61,76,61,21,12,9,19
S01007069,600,28,9,19,103,89,48,60,126,91,18,11,7,37
S01007070,395,10,3,7,67,47,33,50,77,83,15,6,9,13
S01007071,642,55,10,45,138,68,41,70,109,107,15,7,8,39
S01007072,493,35,16,19,94,71,45,66,96,50,6,3,3,30
S01007073,838,43,12,31,165,112,75,99,155,119,31,24,7,39
S01007074,517,22,5,17,81,50,31,63,120,113,20,9,11,17
S01007075,537,15,3,12,70,52,12,67,129,143,17,11,6,32
S01007076,580,22,3,19,87,61,38,76,128,128,18,14,4,22
S01007077,522,20,4,16,87,61,23,83,115,95,22,14,8,16
S01007078,642,31,11,20,83,85,50,70,121,136,34,22,12,32
S01007079,726,25,5,20,128,66,48,99,161,139,35,23,12,25
S01007080,557,13,5,8,92,56,28,67,123,112,22,8,14,44
S01007081,690,22,9,13,88,48,54,74,149,190,29,20,9,36
S01007082,410,10,0,10,64,24,29,53,87,102,19,12,7,22
S01007083,697,18,5,13,62,46,37,83,154,208,54,41,13,35
S01007084,435,28,9,19,80,59,38,48,84,66,6,6,0,26
S01007085,637,38,9,29,100,54,50,86,122,121,30,14,16,36
S01007086,871,18,6,12,88,52,42,106,182,241,83,43,40,59
S01007087,660,22,3,19,57,35,40,84,154,188,44,33,11,36
S01007088,408,8,1,7,31,23,25,55,86,123,37,22,15,20
S01007089,404,32,15,17,95,62,36,49,59,48,8,6,2,15
S01007090,414,15,4,11,84,63,33,49,90,57,8,6,2,15
S01007091,576,34,12,22,84,58,31,71,114,102,23,14,9,59
S01007092,449,13,4,9,65,44,25,58,102,106,17,11,6,19
S01007093,749,53,11,42,148,133,53,102,121,92,8,7,1,39
S01007094,679,34,12,22,142,78,76,75,107,120,11,9,2,36
S01007095,419,44,14,30,88,46,68,38,52,45,14,13,1,24
S01007096,602,57,14,43,153,70,74,68,90,58,7,5,2,25
S01007097,372,34,7,27,60,55,52,42,61,41,8,5,3,19
S01007098,617,51,18,33,154,80,94,58,75,58,16,12,4,31
S01007099,649,30,11,19,141,74,110,79,85,85,12,7,5,33
S01007100,561,31,10,21,132,59,52,69,85,85,17,14,3,31
S01007101,611,17,7,10,84,50,36,63,147,155,25,15,10,34
S01007102,553,30,8,22,104,48,73,77,80,89,13,11,2,39
S01007103,607,35,10,25,86,75,79,86,101,89,7,5,2,49
S01007104,377,27,6,21,58,47,76,29,68,48,7,6,1,17
S01007105,384,23,5,18,75,49,37,49,54,64,8,5,3,25
S01007106,550,24,5,19,89,56,59,75,98,91,19,12,7,39
S01007107,505,30,12,18,104,62,92,53,63,61,9,6,3,31
S01007108,433,20,5,15,84,49,100,40,67,42,12,8,4,19
S01007109,614,11,6,5,70,43,62,70,130,181,22,13,9,25
S01007110,558,33,19,14,93,65,48,66,101,100,18,7,11,34
S01007111,398,12,4,8,58,42,31,61,86,67,12,7,5,29
S01007112,434,24,4,20,77,47,65,51,66,63,17,11,6,24
S01007113,402,43,8,35,91,32,51,45,56,49,16,13,3,19
S01007114,659,30,5,25,101,80,44,94,132,120,6,5,1,52
S01007115,496,24,10,14,89,66,33,61,101,67,14,12,2,41
S01007116,718,54,13,41,132,91,95,88,125,66,8,6,2,59
S01007117,364,34,14,20,76,37,44,39,67,34,7,5,2,26
S01007118,516,13,3,10,53,48,25,61,126,128,30,20,10,32
S01007119,625,19,6,13,70,37,39,100,120,170,22,12,10,48
S01007120,862,23,7,16,98,45,44,121,219,218,43,20,23,51
S01007121,355,9,4,5,33,23,30,42,77,98,14,6,8,29
S01007122,453,29,8,21,94,48,40,46,81,72,12,9,3,31
S01007123,468,13,6,7,64,42,20,59,98,126,15,10,5,31
S01007124,666,26,10,16,96,72,47,98,147,126,18,5,13,36
S01007125,622,25,3,22,67,46,36,72,133,169,27,19,8,47
S01007126,681,8,0,8,50,24,36,81,148,216,64,45,19,54
S01007127,782,24,9,15,59,32,53,85,186,265,37,19,18,41
S01007128,618,12,1,11,72,33,29,94,150,161,32,13,19,35
S01007129,698,164,27,137,223,93,59,28,37,31,14,9,5,49
S01007130,456,50,6,44,125,71,33,40,69,39,6,3,3,23
S01007131,576,64,16,48,194,88,36,49,61,43,4,3,1,37
S01007132,517,68,7,61,139,88,39,33,59,38,5,3,2,48
S01007133,515,66,10,56,115,64,83,38,47,51,10,7,3,41
S01007134,542,70,12,58,111,63,74,43,68,76,12,7,5,25
S01007135,395,74,12,62,115,42,55,16,30,28,6,4,2,29
S01007136,384,83,16,67,97,49,63,20,19,15,8,4,4,30
S01007137,514,82,19,63,177,67,56,34,34,19,7,2,5,38
S01007138,443,58,10,48,127,58,53,33,39,43,8,4,4,24
S01007139,568,47,16,31,125,81,69,65,87,54,12,5,7,28
S01007140,783,92,20,72,225,106,98,48,98,47,19,10,9,50
S01007141,506,60,18,42,128,71,58,33,61,53,7,6,1,35
S01007142,403,61,18,43,129,55,24,17,30,18,20,17,3,49
S01007143,431,57,16,41,145,65,30,40,44,23,5,3,2,22
S01007144,572,49,9,40,123,63,91,45,76,73,22,12,10,30
S01007145,635,62,13,49,182,104,50,39,82,57,20,12,8,39
S01007146,517,54,13,41,158,73,33,31,70,52,7,4,3,39
S01007147,538,47,10,37,170,85,34,42,64,43,13,9,4,40
S01007148,414,55,11,44,109,65,29,32,53,21,9,2,7,41
S01007149,426,30,6,24,114,91,26,48,49,39,5,3,2,24
S01007150,500,63,18,45,149,84,43,32,63,22,4,3,1,40
S01007151,640,85,18,67,171,108,47,44,66,40,18,11,7,61
S01007152,410,49,13,36,130,64,30,27,49,23,6,3,3,32
S01007153,456,35,12,23,149,82,30,39,52,40,4,4,0,25
S01007154,513,42,8,34,157,83,27,38,82,46,12,7,5,26
S01007155,445,36,9,27,128,77,37,38,51,40,9,5,4,29
S01007156,549,32,7,25,119,79,37,54,96,79,18,12,6,35
S01007157,468,15,5,10,105,71,40,55,80,65,14,10,4,23
S01007158,698,41,9,32,176,117,40,81,104,70,26,12,14,43
S01007159,621,21,4,17,128,81,49,52,117,110,22,6,16,41
S01007160,617,19,3,16,129,74,45,73,117,93,20,12,8,47
S01007161,519,36,13,23,132,84,36,50,73,55,24,17,7,29
S01007162,365,23,7,16,107,48,28,31,49,43,12,5,7,24
S01007163,642,49,7,42,166,107,42,50,101,78,15,10,5,34
S01007164,419,32,6,26,113,55,35,33,55,48,10,6,4,38
S01007165,578,65,15,50,177,81,56,40,68,39,14,7,7,38
S01007166,487,55,13,42,132,69,38,51,55,52,12,8,4,23
S01007167,615,71,22,49,179,107,53,37,64,46,10,6,4,48
S01007168,746,94,16,78,200,141,52,46,102,51,6,4,2,54
S01007169,551,53,10,43,147,90,36,42,71,51,16,12,4,45
S01007170,514,50,14,36,125,54,96,43,58,43,16,8,8,29
S01007171,677,52,16,36,118,102,97,61,114,84,15,8,7,34
S01007172,621,80,18,62,149,73,84,53,82,49,24,18,6,27
S01007173,647,32,8,24,172,109,46,71,91,61,12,8,4,53
S01007174,609,40,13,27,137,77,43,63,86,75,26,18,8,62
S01007175,438,28,11,17,96,57,29,33,88,72,9,8,1,26
S01007176,501,26,9,17,110,62,33,50,104,63,21,10,11,32
S01007177,458,17,3,14,72,54,17,50,103,79,36,15,21,30
S01007178,769,19,3,16,108,85,58,86,165,144,54,33,21,50
S01007179,754,71,19,52,202,110,49,60,110,89,16,9,7,47
S01007180,521,49,19,30,154,89,49,35,67,40,15,8,7,23
S01007181,607,61,16,45,155,87,76,37,47,44,37,29,8,63
S01007182,785,71,19,52,185,100,56,72,125,105,25,16,9,46
S01007183,788,42,14,28,145,109,72,77,149,120,24,17,7,50
S01007184,810,26,3,23,162,75,50,96,167,135,44,20,24,55
S01007185,600,20,4,16,85,62,37,63,100,129,67,42,25,37
S01007186,463,12,1,11,51,44,34,43,93,92,55,33,22,39
S01007187,614,22,6,16,109,66,50,70,113,115,31,16,15,38
S01007188,473,21,2,19,85,43,54,57,84,69,29,16,13,31
S01007189,530,17,5,12,90,59,39,53,107,90,39,22,17,36
S01007190,595,21,8,13,109,80,61,61,116,90,19,16,3,38
S01007191,456,13,0,13,63,44,37,59,103,85,30,20,10,22
S01007192,451,18,5,13,53,39,26,52,112,88,33,21,12,30
S01007193,558,14,5,9,67,54,43,57,125,124,23,12,11,51
S01007194,432,6,3,3,47,36,22,43,115,78,50,27,23,35
S01007195,400,11,3,8,60,22,23,38,96,87,27,16,11,36
S01007196,522,13,3,10,83,50,25,55,129,86,27,9,18,54
S01007197,443,9,2,7,53,26,19,57,87,102,58,27,31,32
S01007198,369,9,3,6,52,31,32,42,62,71,48,30,18,22
S01007199,573,11,5,6,50,51,22,73,134,106,64,38,26,62
S01007200,667,19,4,15,115,71,38,69,162,125,29,15,14,39
S01007201,557,27,8,19,105,69,32,58,100,106,29,17,12,31
S01007202,571,17,4,13,87,53,37,63,140,105,42,21,21,27
S01007203,485,14,5,9,86,57,37,62,84,95,12,7,5,38
S01007204,778,58,13,45,206,70,103,66,100,92,38,32,6,45
S01007205,543,48,8,40,129,48,70,45,75,65,12,10,2,51
S01007206,282,14,1,13,68,23,20,31,54,51,8,6,2,13
S01007207,685,39,11,28,150,86,65,87,110,80,27,15,12,41
S01007208,729,38,9,29,111,92,31,101,127,129,56,25,31,44
S01007209,560,29,4,25,118,65,49,55,95,76,40,28,12,33
S01007210,565,13,1,12,95,54,31,82,107,117,36,24,12,30
S01007211,724,19,8,11,135,67,55,78,154,120,45,27,18,51
S01007212,421,18,6,12,102,47,41,54,62,58,20,11,9,19
S01007213,643,44,5,39,155,63,57,80,107,76,22,15,7,39
S01007214,544,31,4,27,91,61,35,47,109,113,32,20,12,25
S01007215,569,36,6,30,106,70,37,65,84,103,29,18,11,39
S01007216,524,50,11,39,116,76,39,55,77,59,21,12,9,31
S01007217,707,31,7,24,110,73,43,83,159,124,34,20,14,50
S01007218,652,72,20,52,175,86,48,60,89,70,12,8,4,40
S01007219,617,21,6,15,108,71,45,70,116,120,28,19,9,38
S01007220,511,16,6,10,78,52,40,58,113,99,34,24,10,21
S01007221,466,50,7,43,123,62,42,40,70,37,17,14,3,25
S01007222,604,37,15,22,112,59,50,71,122,88,29,19,10,36
S01007223,366,43,13,30,102,47,27,37,50,30,10,5,5,20
S01007224,420,40,12,28,101,58,49,42,59,49,8,4,4,14
S01007225,677,73,25,48,172,70,92,63,93,62,15,13,2,37
S01007226,612,59,11,48,148,58,111,50,75,49,21,15,6,41
S01007227,701,59,19,40,154,88,64,64,118,95,23,12,11,36
S01007228,480,35,8,27,108,52,83,49,67,39,16,11,5,31
S01007229,840,68,21,47,194,93,141,69,123,81,23,18,5,48
S01007230,536,12,5,7,62,53,30,63,126,104,50,34,16,36
S01007231,491,18,5,13,51,43,24,53,117,108,42,24,18,35
S01007232,530,17,6,11,50,52,25,60,117,116,54,32,22,39
S01007233,596,34,7,27,114,63,50,64,99,111,37,24,13,24
S01007234,431,16,7,9,81,34,30,35,85,92,19,12,7,39
S01007235,572,25,8,17,116,59,45,60,106,107,25,9,16,29
S01007236,452,26,9,17,89,74,37,60,73,51,17,10,7,25
S01007237,526,29,7,22,113,81,43,63,88,63,14,8,6,32
S01007238,696,32,8,24,157,88,42,79,124,111,15,7,8,48
S01007239,600,74,24,50,157,87,58,60,65,49,15,11,4,35
S01007240,440,35,10,25,98,54,75,37,66,45,9,7,2,21
S01007241,471,51,12,39,97,55,87,40,59,43,7,4,3,32
S01007242,727,49,9,40,189,98,72,70,93,83,20,8,12,53
S01007243,459,39,11,28,133,61,44,40,50,44,16,11,5,32
S01007244,569,51,18,33,140,65,78,41,76,76,13,8,5,29
S01007245,500,20,4,16,109,63,82,52,88,54,10,5,5,22
S01007246,444,30,11,19,91,59,59,45,44,81,14,8,6,21
S01007247,485,49,11,38,112,51,60,41,76,64,13,11,2,19
S01007248,571,65,21,44,159,84,54,54,70,35,13,8,5,37
S01007249,297,29,7,22,62,48,34,20,40,37,8,6,2,19
S01007250,627,41,9,32,139,85,45,53,97,105,26,15,11,36
S01007251,342,17,5,12,69,49,34,30,56,53,7,4,3,27
S01007252,586,30,9,21,98,68,62,70,104,87,19,13,6,48
S01007253,598,48,18,30,155,78,52,63,78,78,12,3,9,34
S01007254,574,23,6,17,95,76,30,58,100,111,57,49,8,24
S01007255,562,16,2,14,73,56,23,60,112,138,63,27,36,21
S01007256,563,26,6,20,90,53,29,52,124,130,30,16,14,29
S01007257,450,15,2,13,62,39,37,48,98,79,31,16,15,41
S01007258,618,35,7,28,126,64,50,57,101,99,34,23,11,52
S01007259,600,24,6,18,85,52,45,69,115,136,31,19,12,43
S01007260,663,18,5,13,82,59,39,60,140,143,65,36,29,57
S01007261,603,52,18,34,130,84,50,55,90,88,20,12,8,34
S01007262,533,14,3,11,78,49,20,59,130,118,32,16,16,33
S01007263,580,20,7,13,98,68,30,70,111,131,16,9,7,36
S01007264,544,38,11,27,124,51,29,53,104,99,16,12,4,30
S01007265,761,33,8,25,122,86,53,82,140,168,24,14,10,53
S01007266,511,38,9,29,111,58,36,53,97,85,10,6,4,23
S01007267,402,49,3,46,86,41,70,33,50,38,12,6,6,23
S01007268,461,49,10,39,108,44,83,36,52,40,17,11,6,32
S01007269,387,45,19,26,100,43,46,26,39,40,13,8,5,35
S01007270,345,28,4,24,81,28,68,22,50,39,11,8,3,18
S01007271,733,47,14,33,164,86,86,80,111,103,21,10,11,35
S01007272,596,15,3,12,88,49,34,69,141,132,32,19,13,36
S01007273,496,35,11,24,99,49,41,53,88,78,23,15,8,30
S01007274,602,44,6,38,115,61,62,61,97,88,29,9,20,45
S01007275,398,46,5,41,105,52,29,30,47,53,9,6,3,27
S01007276,604,49,14,35,130,78,38,53,93,90,28,16,12,45
S01007277,561,58,12,46,163,67,50,45,76,52,9,7,2,41
S01007278,391,43,16,27,113,59,31,26,43,37,7,5,2,32
S01007279,421,50,12,38,98,24,102,26,51,40,14,9,5,16
S01007280,426,38,7,31,90,44,79,44,56,43,13,5,8,19
S01007281,766,60,15,45,125,94,123,81,113,100,27,22,5,43
S01007282,406,35,9,26,75,23,70,55,72,43,12,7,5,21
S01007283,687,92,20,72,174,81,78,68,73,76,17,13,4,28
S01007284,601,32,6,26,138,70,131,54,79,62,10,9,1,25
S01007285,639,45,7,38,135,60,167,51,99,50,8,4,4,24
S01007286,707,37,10,27,161,62,153,70,109,79,16,7,9,20
S01007287,477,30,5,25,98,30,143,43,78,33,11,2,9,11
S01007288,438,35,6,29,96,33,109,33,61,44,11,3,8,16
S01007289,626,49,15,34,175,84,92,41,97,50,2,2,0,36
S01007290,504,22,6,16,108,48,58,40,98,73,20,12,8,37
S01007291,479,20,1,19,99,44,46,43,93,89,20,14,6,25
S01007292,593,25,7,18,151,78,64,56,103,76,3,1,2,37
S01007293,547,16,2,14,72,34,37,69,140,127,27,12,15,25
S01007294,684,27,8,19,120,64,72,75,141,117,16,12,4,52
S01007295,370,10,1,9,51,22,23,49,91,86,26,21,5,12
S01007296,464,28,2,26,92,33,58,53,81,69,24,9,15,26
S01007297,728,81,12,69,179,68,96,67,112,79,15,10,5,31
S01007298,395,15,2,13,76,58,40,45,65,62,8,3,5,26
S01007299,650,28,6,22,112,56,77,89,116,103,21,6,15,48
S01007300,355,8,3,5,43,39,39,40,82,67,22,8,14,15
S01007301,548,60,15,45,143,59,106,37,67,46,9,4,5,21
S01007302,465,18,5,13,72,49,49,58,111,62,17,10,7,29
S01007303,658,62,12,50,151,74,126,64,93,42,17,15,2,29
S01007304,501,44,10,34,120,42,123,37,66,40,11,9,2,18
S01007305,544,67,18,49,131,61,82,49,81,44,4,3,1,25
S01007306,551,54,14,40,138,69,75,45,80,52,12,6,6,26
S01007307,611,63,14,49,136,74,139,52,73,39,13,8,5,22
S01007308,628,54,20,34,141,54,88,61,108,88,10,3,7,24
S01007309,505,53,11,42,126,34,102,39,72,52,11,7,4,16
S01007310,601,61,13,48,139,53,131,40,87,50,13,7,6,27
S01007311,592,33,11,22,91,51,99,81,119,86,12,2,10,20
S01007312,543,57,15,42,153,61,75,45,74,46,16,8,8,16
S01007313,753,89,21,68,220,74,152,41,75,59,14,7,7,29
S01007314,493,45,8,37,128,57,71,41,68,46,13,9,4,24
S01007315,700,62,19,43,192,108,43,58,96,87,21,11,10,33
S01007316,648,39,13,26,152,87,51,65,82,100,41,23,18,31
S01007317,490,40,7,33,134,65,40,43,63,55,25,18,7,25
S01007318,439,26,3,23,87,52,61,44,75,61,15,5,10,18
S01007319,546,45,8,37,127,67,76,54,64,78,15,7,8,20
S01007320,557,71,23,48,159,59,98,41,56,30,11,6,5,32
S01007321,482,46,15,31,117,34,115,34,62,46,12,4,8,16
S01007322,552,20,3,17,118,77,94,43,69,87,21,10,11,23
S01007323,342,15,3,12,64,39,55,35,50,66,3,3,0,15
S01007324,258,33,14,19,59,13,41,21,44,30,7,3,4,10
S01007325,599,39,13,26,127,63,129,51,98,61,13,10,3,18
S01007326,592,34,9,25,105,46,110,74,121,68,13,7,6,21
S01007327,563,27,8,19,94,59,70,55,115,92,23,12,11,28
S01007328,633,21,5,16,90,59,92,46,160,107,27,18,9,31
S01007329,507,26,6,20,107,37,129,38,68,54,20,13,7,28
S01007330,571,34,10,24,144,58,143,35,85,44,12,5,7,16
S01007331,732,34,4,30,136,86,145,61,120,100,23,14,9,27
S01007332,385,22,4,18,73,28,114,26,47,28,14,11,3,33
S01007333,574,45,9,36,135,75,73,49,84,69,18,11,7,26
S01007334,509,12,3,9,51,53,38,57,110,120,43,25,18,25
S01007335,586,7,0,7,77,74,40,74,127,131,35,20,15,21
S01007336,400,14,3,11,70,43,47,47,69,55,42,27,15,13
S01007337,454,15,6,9,72,69,53,44,100,70,17,8,9,14
S01007338,554,17,5,12,78,81,47,69,105,112,16,10,6,29
S01007339,437,28,4,24,114,66,60,32,60,51,10,7,3,16
S01007340,349,24,7,17,88,31,43,30,53,51,19,13,6,10
S01007341,538,37,12,25,116,74,83,40,79,62,20,14,6,27
S01007342,622,86,21,65,157,83,112,36,60,43,10,6,4,35
S01007343,483,35,8,27,83,45,136,42,73,41,7,7,0,21
S01007344,320,14,2,12,75,46,45,25,59,29,9,7,2,18
S01007345,400,5,2,3,55,45,40,38,84,75,35,18,17,23
S01007346,416,9,2,7,61,56,37,47,76,81,36,19,17,13
S01007347,475,14,6,8,59,51,45,36,94,102,39,21,18,35
S01007348,422,5,1,4,54,51,37,50,97,70,25,14,11,33
S01007349,316,13,5,8,50,46,24,32,70,51,18,12,6,12
S01007350,414,16,7,9,73,53,61,42,59,71,20,11,9,19
S01007351,467,32,8,24,110,31,124,41,71,41,9,6,3,8
S01007352,411,42,14,28,98,43,104,25,48,29,13,7,6,9
S01007353,475,43,9,34,127,59,71,37,61,46,11,5,6,20
S01007354,583,46,14,32,157,88,83,34,71,57,19,11,8,28
S01007355,734,76,17,59,197,58,134,58,99,70,22,14,8,20
S01007356,552,61,18,43,143,62,68,35,85,53,22,10,12,23
S01007357,573,52,15,37,136,48,107,42,101,60,10,6,4,17
S01007358,712,47,13,34,180,71,104,82,107,91,18,12,6,12
S01007359,584,24,9,15,110,65,61,49,124,83,28,14,14,40
S01007360,424,27,7,20,123,56,49,35,59,40,7,3,4,28
S01007361,733,60,15,45,171,101,105,59,103,66,21,8,13,47
S01007362,526,33,6,27,125,81,52,30,93,61,16,10,6,35
S01007363,497,33,6,27,115,69,50,40,84,65,23,9,14,18
S01007364,633,9,1,8,71,69,34,52,164,123,47,24,23,64
S01007365,327,18,2,16,59,34,30,32,59,57,22,13,9,16
S01007366,328,9,1,8,45,26,21,40,58,73,36,26,10,20
S01007367,420,18,4,14,71,49,56,38,84,62,25,12,13,17
S01007368,376,8,3,5,56,49,27,39,59,69,32,14,18,37
S01007369,588,17,4,13,121,89,52,51,121,89,22,11,11,26
S01007370,588,38,4,34,114,69,56,70,93,80,29,17,12,39
S01007371,508,20,6,14,112,75,53,42,93,62,21,10,11,30
S01007372,608,43,12,31,148,81,65,52,96,73,16,7,9,34
S01007373,473,50,13,37,125,63,76,43,38,35,15,11,4,28
S01007374,408,36,10,26,108,54,49,37,50,41,10,4,6,23
S01007375,354,58,21,37,85,40,48,25,40,25,12,6,6,21
S01007376,631,19,4,15,106,79,39,64,124,98,56,31,25,46
S01007377,507,63,15,48,146,75,54,37,65,29,13,8,5,25
S01007378,1330,110,62,48,334,686,46,29,53,31,13,10,3,28
S01007379,338,8,3,5,49,34,17,46,70,73,24,8,16,17
S01007380,425,27,10,17,85,57,26,44,74,69,18,10,8,25
S01007381,343,82,32,50,94,45,32,9,31,20,9,6,3,21
S01007382,494,72,22,50,145,75,44,25,49,37,11,5,6,36
S01007383,571,89,23,66,169,69,49,42,75,40,13,9,4,25
S01007384,557,79,39,40,152,91,27,31,79,47,14,6,8,37
S01007385,611,63,16,47,163,93,55,38,76,61,11,4,7,51
S01007386,599,131,27,104,190,67,53,28,59,12,12,7,5,47
S01007387,600,131,31,100,195,65,52,29,49,24,9,5,4,46
S01007388,530,71,25,46,164,102,36,17,52,24,18,9,9,46
S01007389,383,12,2,10,109,55,14,35,78,30,17,9,8,33
S01007390,362,13,3,10,87,78,25,24,57,41,12,8,4,25
S01007391,444,51,15,36,147,73,33,30,46,24,9,6,3,31
S01007392,345,63,17,46,101,50,31,21,30,22,9,4,5,18
S01007393,485,94,21,73,131,64,40,19,40,26,8,6,2,63
S01007394,429,70,22,48,140,62,33,23,43,18,17,8,9,23
S01007395,610,33,8,25,129,89,59,63,115,70,28,16,12,24
S01007396,614,44,10,34,137,76,48,58,108,82,30,20,10,31
S01007397,698,98,22,76,207,96,53,49,73,49,18,10,8,55
S01007398,492,9,3,6,50,42,30,56,108,125,41,25,16,31
S01007399,485,24,5,19,73,34,33,44,81,100,70,39,31,26
S01007400,522,50,13,37,129,75,40,29,90,49,19,8,11,41
S01007401,514,35,7,28,148,86,34,39,78,32,20,14,6,42
S01007402,458,41,11,30,125,78,36,38,65,28,7,7,0,40
S01007403,534,27,10,17,212,77,25,28,74,36,15,4,11,40
S01007404,326,38,8,30,71,29,72,35,28,28,8,5,3,17
S01007405,505,92,22,70,170,63,64,17,39,21,11,7,4,28
S01007406,458,79,20,59,146,70,45,19,36,22,13,6,7,28
S01007407,516,76,22,54,143,89,49,29,40,37,11,6,5,42
S01007408,443,34,8,26,92,68,40,47,63,50,24,11,13,25
S01007409,534,32,6,26,107,85,37,63,88,75,16,13,3,31
S01007410,502,7,3,4,37,46,18,63,110,140,45,28,17,36
S01007411,639,18,7,11,78,74,38,64,122,146,60,39,21,39
S01007412,348,11,1,10,49,44,16,38,71,79,21,12,9,19
S01007413,704,53,11,42,165,111,47,79,107,71,20,8,12,51
S01007414,512,77,23,54,151,70,33,42,56,34,13,7,6,36
S01007415,634,16,3,13,82,61,31,67,128,175,38,16,22,36
S01007416,411,7,2,5,36,31,16,34,90,113,49,27,22,35
S01007417,767,93,21,72,222,140,43,66,84,53,24,13,11,42
S01007418,500,14,1,13,62,51,20,47,114,122,36,20,16,34
S01007419,632,11,4,7,61,74,30,49,132,153,70,41,29,52
S01007420,1259,69,18,51,198,121,111,139,147,240,180,166,14,54
S01007421,498,69,8,61,117,57,42,30,71,64,23,16,7,25
S01007422,429,37,10,27,104,62,36,45,56,48,21,15,6,20
S01007423,553,60,14,46,162,79,27,46,82,63,17,10,7,17
S01007424,602,63,12,51,178,107,28,52,86,48,11,10,1,29
S01007425,670,67,14,53,161,84,36,57,107,91,24,14,10,43
S01007426,480,31,1,30,87,51,33,48,91,72,22,11,11,45
S01007427,496,16,6,10,78,64,22,54,106,97,31,11,20,28
S01007428,660,19,7,12,139,93,40,74,105,125,26,11,15,39
S01007429,563,36,5,31,136,61,35,55,92,76,26,12,14,46
S01007430,355,27,11,16,84,43,33,43,43,42,8,4,4,32
S01007431,448,39,12,27,117,77,27,31,70,37,11,4,7,39
S01007432,661,34,5,29,122,89,47,68,115,109,41,37,4,36
S01007433,605,60,17,43,124,63,55,43,118,86,22,14,8,34
S01007434,384,11,3,8,43,38,38,39,80,84,31,16,15,20
S01007435,532,31,7,24,113,75,34,50,88,87,25,10,15,29
S01007436,504,32,7,25,77,47,18,47,89,128,33,23,10,33
S01007437,338,19,2,17,72,45,26,25,64,41,26,15,11,20
S01007438,520,29,8,21,87,57,24,69,106,98,34,15,19,16
S01007439,547,42,11,31,102,70,29,67,104,84,20,10,10,29
S01007440,481,23,8,15,87,57,29,55,100,76,23,13,10,31
S01007441,439,48,13,35,117,70,27,41,67,31,8,2,6,30
S01007442,382,55,10,45,115,70,29,27,43,14,7,4,3,22
S01007443,649,104,24,80,164,63,50,42,65,46,24,12,12,91
S01007444,657,123,29,94,215,72,66,32,48,35,17,12,5,49
S01007445,472,107,26,81,157,55,34,31,36,18,5,4,1,29
S01007446,382,90,23,67,126,29,37,14,26,20,8,2,6,32
S01007447,384,74,16,58,113,44,51,25,30,15,8,4,4,24
S01007448,674,53,14,39,159,88,80,61,97,83,22,14,8,31
S01007449,757,47,14,33,119,95,42,70,151,126,64,28,36,43
S01007450,549,23,6,17,74,64,30,45,111,105,63,38,25,34
S01007451,477,23,9,14,84,73,23,40,109,76,20,13,7,29
S01007452,382,23,5,18,53,37,37,38,66,69,32,16,16,27
S01007453,450,56,15,41,150,51,33,42,51,19,15,11,4,33
S01007454,399,13,4,9,55,50,29,28,86,91,27,18,9,20
S01007455,639,15,6,9,95,78,25,70,130,124,58,36,22,44
S01007456,624,9,1,8,69,52,30,55,167,151,47,28,19,44
S01007457,796,33,8,25,139,94,47,82,128,150,82,50,32,41
S01007458,385,25,8,17,86,72,21,51,54,38,14,8,6,24
S01007459,474,20,3,17,106,70,29,59,75,79,16,9,7,20
S01007460,568,23,7,16,82,56,44,74,117,108,46,29,17,18
S01007461,529,12,5,7,51,39,35,51,118,111,75,45,30,37
S01007462,626,34,5,29,117,79,44,56,130,91,44,28,16,31
S01007463,698,12,3,9,51,54,41,38,155,184,104,63,41,59
S01007464,497,10,2,8,35,43,14,44,128,146,49,33,16,28
S01007465,567,13,3,10,47,42,20,37,135,150,102,67,35,21
S01007466,802,37,6,31,87,74,36,74,169,171,107,69,38,47
S01007467,720,32,9,23,140,95,34,81,134,122,39,27,12,43
S01007468,578,46,17,29,107,84,38,70,108,77,9,6,3,39
S01007469,434,19,8,11,64,51,19,40,97,87,31,16,15,26
S01007470,492,21,6,15,73,58,26,38,115,80,49,34,15,32
S01007471,353,19,3,16,60,57,13,30,64,64,17,7,10,29
S01007472,406,7,0,7,45,48,19,41,90,113,23,10,13,20
S01007473,339,13,4,9,46,45,16,38,74,69,20,13,7,18
S01007474,419,37,7,30,93,76,38,36,74,36,6,3,3,23
S01007475,463,47,10,37,125,74,25,41,55,54,18,10,8,24
S01007476,475,51,14,37,104,72,29,51,76,52,14,8,6,26
S01007477,403,50,12,38,96,62,33,39,45,44,7,2,5,27
S01007478,649,74,11,63,179,76,46,47,88,72,24,16,8,43
S01007479,427,28,5,23,93,76,25,49,62,57,15,12,3,22
S01007480,587,39,8,31,133,87,31,65,102,79,19,9,10,32
S01007481,610,53,16,37,161,85,79,55,90,51,10,8,2,26
S01007482,325,11,3,8,50,37,27,31,72,66,21,19,2,10
S01007483,574,12,2,10,76,57,64,58,122,120,35,17,18,30
S01007484,416,12,2,10,62,28,40,47,86,76,41,20,21,24
S01007485,336,5,1,4,23,17,18,30,103,84,44,22,22,12
S01007486,353,1,1,0,25,28,16,30,84,93,59,31,28,17
S01007487,692,13,1,12,78,56,63,75,161,150,67,46,21,29
S01007488,756,20,4,16,148,95,78,64,147,116,44,25,19,44
S01007489,618,18,7,11,90,90,64,59,119,110,27,15,12,41
S01007490,650,14,4,10,77,70,53,77,130,147,41,30,11,41
S01007491,796,16,4,12,111,96,51,86,191,150,54,27,27,41
S01007492,536,16,5,11,80,61,38,51,132,101,32,20,12,25
S01007493,623,16,6,10,92,73,36,88,136,120,34,19,15,28
S01007494,404,21,4,17,69,36,92,27,82,39,16,11,5,22
S01007495,626,35,5,30,112,80,143,54,103,64,8,7,1,27
S01007496,776,46,12,34,171,74,165,62,130,73,24,12,12,31
S01007497,439,15,4,11,44,40,73,37,104,76,29,25,4,21
S01007498,628,19,4,15,88,75,92,65,140,90,23,16,7,36
S01007499,635,21,6,15,86,48,120,50,135,110,34,20,14,31
S01007500,448,25,5,20,57,36,81,52,104,59,17,8,9,17
S01007501,528,25,4,21,106,54,136,35,87,47,23,7,16,15
S01007502,412,18,6,12,74,35,90,40,71,52,11,6,5,21
S01007503,758,27,6,21,131,58,163,58,144,104,40,26,14,33
S01007504,523,27,3,24,93,45,129,38,84,65,18,9,9,24
S01007505,321,21,5,16,57,32,80,20,52,35,13,7,6,11
S01007506,369,27,7,20,81,36,105,25,51,28,7,4,3,9
S01007507,669,34,7,27,104,59,127,44,147,95,32,21,11,27
S01007508,545,28,4,24,86,56,114,47,107,71,20,17,3,16
S01007509,479,34,6,28,89,42,121,34,83,36,21,14,7,19
S01007510,723,32,3,29,125,60,155,60,157,69,28,18,10,37
S01007511,612,14,1,13,68,43,93,40,161,111,55,42,13,27
S01007512,394,23,8,15,89,28,96,25,71,29,17,10,7,16
S01007513,761,33,12,21,101,64,73,79,189,135,60,41,19,27
S01007514,399,10,3,7,70,34,51,55,81,61,20,11,9,17
S01007515,422,34,7,27,127,56,52,33,53,37,14,8,6,16
S01007516,424,15,2,13,45,36,43,49,118,77,28,19,9,13
S01007517,315,19,3,16,61,43,38,26,72,34,14,11,3,8
S01007518,611,11,3,8,87,47,67,65,137,132,39,25,14,26
S01007519,338,33,8,25,76,38,76,20,51,23,10,7,3,11
S01007520,706,40,8,32,109,65,121,45,152,104,32,14,18,38
S01007521,344,35,9,26,64,31,71,34,66,22,4,3,1,17
S01007522,676,50,13,37,138,57,99,60,141,78,28,16,12,25
S01007523,404,36,6,30,85,35,76,24,67,42,19,15,4,20
S01007524,721,45,6,39,135,68,157,63,126,78,23,16,7,26
S01007525,375,21,7,14,62,36,51,40,90,58,11,5,6,6
S01007526,521,30,13,17,95,54,71,42,93,83,29,21,8,24
S01007527,582,38,8,30,107,58,86,63,107,88,18,10,8,17
S01007528,544,25,3,22,88,36,67,58,115,97,33,24,9,25
S01007529,476,46,12,34,117,51,72,28,84,42,11,4,7,25
S01007530,392,33,5,28,77,47,88,25,64,31,6,4,2,21
S01007531,518,21,4,17,124,51,108,29,92,43,17,12,5,33
S01007532,438,30,6,24,80,37,96,36,72,48,15,10,5,24
S01007533,407,18,5,13,76,44,107,22,77,26,15,8,7,22
S01007534,681,35,11,24,104,61,83,54,150,126,30,21,9,38
S01007535,735,39,11,28,118,90,85,58,157,88,56,36,20,44
S01007536,675,31,5,26,97,78,81,71,155,105,26,15,11,31
S01007537,718,54,8,46,124,79,86,65,126,125,30,21,9,29
S01007538,661,37,3,34,138,72,131,45,122,65,21,14,7,30
S01007539,454,41,10,31,120,67,67,29,66,37,9,3,6,18
S01007540,604,25,7,18,90,75,65,54,136,115,22,13,9,22
S01007541,530,27,7,20,121,65,56,52,97,79,12,7,5,21
S01007542,632,23,6,17,103,61,74,52,134,113,39,16,23,33
S01007543,811,22,4,18,104,73,77,78,216,165,34,13,21,42
S01007544,728,94,19,75,174,78,173,35,79,46,16,11,5,33
S01007545,596,51,12,39,118,69,131,42,88,54,11,7,4,32
S01007546,416,31,5,26,91,54,89,33,46,39,9,4,5,24
S01007547,425,40,8,32,87,38,101,23,70,35,11,3,8,20
S01007548,528,23,4,19,112,58,79,53,93,66,22,9,13,22
S01007549,442,36,12,24,93,51,80,35,65,45,13,7,6,24
S01007550,650,68,11,57,136,66,110,50,111,69,15,10,5,25
S01007551,688,72,16,56,141,64,185,35,79,56,26,19,7,30
S01007552,689,17,6,11,71,49,61,83,166,138,53,31,22,51
S01007553,653,14,2,12,66,47,33,84,162,155,63,43,20,29
S01007554,334,4,3,1,21,17,14,31,102,98,27,20,7,20
S01007555,379,21,3,18,73,38,42,40,73,66,13,6,7,13
S01007556,345,11,4,7,30,29,35,38,87,68,29,16,13,18
S01007557,810,16,8,8,75,69,46,82,214,196,55,36,19,57
S01007558,339,16,4,12,74,26,65,34,55,37,16,9,7,16
S01007559,529,55,12,43,117,57,94,46,77,40,16,9,7,27
S01007560,648,45,10,35,109,87,77,61,127,101,19,14,5,22
S01007561,497,20,5,15,85,65,47,40,121,73,23,18,5,23
S01007562,631,49,9,40,135,70,101,38,124,62,15,10,5,37
S01007563,636,49,10,39,164,69,119,35,102,45,14,9,5,39
S01007564,580,50,7,43,133,61,124,31,86,43,16,10,6,36
S01007565,723,58,9,49,137,79,95,51,152,82,29,18,11,40
S01007566,565,32,8,24,104,53,99,40,105,69,18,13,5,45
S01007567,457,28,9,19,118,45,89,36,61,37,10,6,4,33
S01007568,508,47,18,29,125,65,73,51,67,49,11,9,2,20
S01007569,597,27,5,22,120,66,82,47,127,82,12,9,3,34
S01007570,526,65,20,45,120,66,57,42,87,51,18,7,11,20
S01007571,413,44,12,32,112,39,71,22,60,30,7,5,2,28
S01007572,648,37,10,27,117,98,72,55,111,90,37,22,15,31
S01007573,633,56,14,42,193,101,40,59,95,54,8,7,1,27
S01007574,750,11,3,8,96,94,37,64,195,166,37,21,16,50
S01007575,616,9,1,8,70,60,39,60,141,159,54,29,25,24
S01007576,498,11,1,10,33,35,20,44,122,115,97,54,43,21
S01007577,492,9,0,9,44,43,16,41,127,129,45,25,20,38
S01007578,494,8,4,4,28,44,25,55,144,121,42,28,14,27
S01007579,456,9,3,6,58,51,13,35,120,99,35,19,16,36
S01007580,586,8,4,4,52,41,22,62,146,137,55,39,16,63
S01007581,368,6,2,4,33,32,24,50,85,85,34,25,9,19
S01007582,486,9,1,8,52,50,33,54,113,105,39,26,13,31
S01007583,755,16,4,12,68,62,41,71,206,182,70,44,26,39
S01007584,435,19,5,14,54,43,31,40,95,95,31,18,13,27
S01007585,640,42,10,32,122,97,50,56,115,109,12,6,6,37
S01007586,611,17,5,12,92,65,33,49,166,118,35,16,19,36
S01007587,618,44,7,37,129,72,62,57,85,98,52,45,7,19
S01007588,609,81,15,66,177,76,55,34,65,53,13,11,2,55
S01007589,610,45,11,34,151,90,42,36,92,63,35,25,10,56
S01007590,449,71,15,56,127,66,42,28,49,32,5,4,1,29
S01007591,452,33,3,30,100,64,31,40,76,73,15,11,4,20
S01007592,524,21,2,19,78,62,20,44,129,110,31,15,16,29
S01007593,783,70,17,53,170,95,67,88,140,96,18,11,7,39
S01007594,615,43,14,29,136,91,77,48,101,69,12,9,3,38
S01007595,811,67,12,55,177,73,153,59,122,80,44,35,9,36
S01007596,416,31,12,19,78,42,81,35,68,49,13,10,3,19
S01007597,487,44,13,31,121,55,72,36,72,42,8,2,6,37
S01007598,501,43,11,32,122,56,65,46,64,49,16,11,5,40
S01007599,641,54,11,43,155,71,40,37,115,79,26,18,8,64
S01007600,811,130,20,110,195,98,66,63,94,82,31,26,5,52
S01007601,503,34,10,24,139,64,28,46,87,71,11,2,9,23
S01007602,501,33,9,24,128,92,29,46,73,56,12,9,3,32
S01007603,616,56,13,43,208,99,32,48,81,48,12,6,6,32
S01007604,666,61,22,39,183,119,41,59,97,57,13,7,6,36
S01007605,640,49,8,41,174,112,37,53,101,75,5,3,2,34
S01007606,471,30,7,23,131,71,36,40,80,39,13,8,5,31
S01007607,536,44,11,33,137,96,33,45,91,57,8,6,2,25
S01007608,566,33,6,27,167,85,37,42,96,62,10,8,2,34
S01007609,683,25,5,20,112,102,32,56,143,130,39,25,14,44
S01007610,356,18,4,14,77,43,20,35,77,56,19,12,7,11
S01007611,683,38,4,34,98,85,38,76,155,115,44,32,12,34
S01007612,861,26,2,24,146,92,63,88,159,133,83,46,37,71
S01007613,597,66,9,57,148,68,78,34,85,44,37,19,18,37
S01007614,619,96,30,66,214,95,47,18,79,29,5,4,1,36
S01007615,785,69,19,50,200,110,63,62,129,97,24,13,11,31
S01007616,542,16,2,14,108,73,38,58,109,81,29,19,10,30
S01007617,401,9,3,6,51,55,27,34,108,76,23,14,9,18
S01007618,418,3,1,2,56,45,18,43,106,96,18,10,8,33
S01007619,456,6,1,5,49,46,22,38,135,114,27,19,8,19
S01007620,459,19,3,16,101,86,48,41,88,57,2,1,1,17
S01007621,473,13,6,7,100,84,38,59,94,63,6,1,5,16
S01007622,413,13,4,9,85,58,36,43,90,62,13,7,6,13
S01007623,463,43,8,35,116,70,38,36,66,51,12,7,5,31
S01007624,506,27,7,20,92,89,35,50,108,72,6,6,0,27
S01007625,384,22,6,16,76,60,25,41,68,55,9,5,4,28
S01007626,476,29,7,22,98,77,37,57,94,48,8,3,5,28
S01007627,393,39,8,31,104,67,35,40,60,19,6,5,1,23
S01007628,503,29,4,25,131,81,49,53,80,45,12,8,4,23
S01007629,527,31,8,23,128,67,73,41,82,71,10,6,4,24
S01007630,652,48,10,38,153,84,120,43,98,52,12,9,3,42
S01007631,449,48,5,43,98,51,99,31,67,31,12,8,4,12
S01007632,707,44,15,29,123,86,68,63,143,117,29,21,8,34
S01007633,717,39,10,29,129,86,62,74,155,111,28,13,15,33
S01007634,433,32,9,23,87,48,63,30,81,58,14,6,8,20
S01007635,489,39,9,30,128,53,72,40,77,38,15,12,3,27
S01007636,590,33,11,22,112,76,50,41,123,95,31,22,9,29
S01007637,611,21,5,16,69,69,58,64,158,125,25,15,10,22
S01007638,565,26,9,17,114,61,44,69,109,90,24,13,11,28
S01007639,782,33,9,24,113,81,53,66,205,163,30,16,14,38
S01007640,555,30,7,23,95,59,116,55,100,61,13,8,5,26
S01007641,607,60,26,34,111,70,92,50,106,72,19,9,10,27
S01007642,577,51,10,41,138,54,111,59,71,51,15,9,6,27
S01007643,663,51,15,36,148,51,94,74,113,72,22,10,12,38
S01007644,612,64,18,46,128,56,62,61,116,73,19,11,8,33
S01007645,418,31,9,22,94,39,102,27,57,37,14,4,10,17
S01007646,481,47,16,31,92,45,91,48,78,44,13,6,7,23
S01007647,536,34,10,24,118,76,72,39,83,71,16,6,10,27
S01007648,640,33,7,26,114,104,72,63,91,118,14,6,8,31
S01007649,558,18,8,10,75,61,69,56,103,128,26,19,7,22
S01007650,713,38,9,29,147,84,139,46,100,100,18,7,11,41
S01007651,428,31,10,21,74,45,114,22,64,41,17,10,7,20
S01007652,426,18,4,14,77,47,66,42,75,65,15,9,6,21
S01007653,690,39,7,32,109,70,124,75,134,85,14,4,10,40
S01007654,804,29,10,19,116,65,115,74,198,137,29,21,8,41
S01007655,613,45,12,33,114,55,181,36,95,54,13,9,4,20
S01007656,663,38,9,29,118,66,134,53,131,65,24,17,7,34
S01007657,336,16,4,12,70,32,63,29,68,38,7,4,3,13
S01007658,382,21,5,16,89,43,66,40,62,39,6,3,3,16
S01007659,585,44,6,38,99,58,88,63,115,81,20,8,12,17
S01007660,634,10,4,6,63,47,45,83,198,126,38,23,15,24
S01007661,492,17,5,12,89,53,54,49,105,85,14,10,4,26
S01007662,630,24,10,14,109,63,54,71,143,116,26,20,6,24
S01007663,624,40,3,37,123,73,57,62,125,98,10,4,6,36
S01007664,430,13,3,10,59,32,29,53,116,93,17,11,6,18
S01007665,457,15,5,10,74,48,26,60,120,83,15,9,6,16
S01007666,374,29,8,21,79,59,19,41,62,56,12,11,1,17
S01007667,516,37,6,31,123,86,52,58,82,52,6,6,0,20
S01007668,757,16,4,12,85,79,37,79,200,189,37,23,14,35
S01007669,456,9,1,8,36,28,25,35,140,118,41,21,20,24
S01007670,503,13,2,11,58,47,25,55,130,88,55,28,27,32
S01007671,553,60,19,41,134,52,88,49,87,46,5,4,1,32
S01007672,654,70,16,54,171,93,66,52,106,54,18,15,3,24
S01007673,540,18,4,14,111,62,55,69,109,79,11,8,3,26
S01007674,590,10,2,8,62,57,36,76,162,125,37,17,20,25
S01007675,478,31,8,23,101,64,62,45,96,55,7,4,3,17
S01007676,513,37,12,25,90,57,116,45,88,47,10,7,3,23
S01007677,348,21,5,16,63,46,36,41,58,52,6,4,2,25
S01007678,575,10,5,5,71,53,40,70,139,134,28,20,8,30
S01007679,602,16,8,8,71,62,42,63,172,127,29,15,14,20
S01007680,710,28,7,21,138,87,77,78,145,107,5,3,2,45
S01007681,316,9,2,7,35,33,42,41,80,61,4,4,0,11
S01007682,680,144,21,123,181,79,60,37,54,28,20,10,10,77
S01007683,522,143,9,134,114,56,25,16,35,18,18,14,4,97
S01007684,573,121,13,108,185,66,30,25,40,25,13,9,4,68
S01007685,746,153,14,139,128,49,40,13,24,18,12,9,3,309
S01007686,507,94,7,87,140,54,27,21,37,21,16,13,3,97
S01007687,717,126,6,120,160,67,34,19,43,32,18,14,4,218
S01007688,908,109,7,102,136,90,36,30,71,38,24,12,12,374
S01007689,498,72,0,72,87,24,16,14,33,25,21,19,2,206
S01007690,792,63,6,57,108,35,16,28,42,30,52,42,10,418
S01007691,2798,64,3,61,115,58,27,28,78,56,66,37,29,2306
S01007692,835,62,4,58,93,38,25,28,44,33,16,9,7,496
S01007693,922,31,1,30,35,25,11,26,48,32,40,27,13,674
S01007694,959,50,2,48,68,59,24,36,97,50,59,43,16,516
S01007695,757,96,3,93,128,70,33,45,99,64,34,18,16,188
S01007696,693,33,3,30,59,28,19,25,68,46,51,32,19,364
S01007697,767,92,9,83,151,74,35,42,80,83,30,17,13,180
S01007698,949,57,6,51,140,83,37,46,112,77,49,31,18,348
S01007699,672,50,4,46,92,52,24,26,87,64,41,25,16,236
S01007700,777,161,23,138,213,74,48,34,56,61,32,26,6,98
S01007701,458,21,3,18,55,27,6,22,51,68,61,34,27,147
S01007702,957,69,3,66,74,25,16,17,40,16,11,3,8,689
S01007703,624,68,7,61,120,80,27,38,89,65,22,10,12,115
S01007704,765,23,4,19,74,42,29,48,118,122,126,73,53,183
S01007705,735,20,2,18,38,26,9,27,41,38,25,12,13,511
S01007706,753,17,1,16,52,35,5,28,31,16,23,14,9,546
S01007707,759,138,8,130,144,46,30,44,35,27,24,19,5,271
S01007708,505,27,0,27,86,80,22,46,78,64,37,22,15,65
S01007709,487,30,2,28,62,38,18,42,70,81,56,32,24,90
S01007710,730,40,3,37,107,58,27,38,93,65,38,25,13,264
S01007711,904,27,2,25,91,66,20,51,124,113,32,22,10,380
S01007712,590,49,1,48,104,63,21,35,54,42,23,16,7,199
S01007713,396,25,2,23,49,40,26,28,60,46,46,34,12,76
S01007714,523,19,2,17,84,71,22,52,95,87,27,20,7,66
S01007715,397,14,1,13,53,29,13,25,75,66,47,28,19,75
S01007716,811,30,4,26,93,73,41,59,117,133,105,82,23,160
S01007717,789,17,4,13,92,85,43,49,151,135,81,41,40,136
S01007718,566,20,2,18,73,49,35,61,108,105,41,23,18,74
S01007719,774,24,3,21,118,95,37,77,151,155,51,25,26,66
S01007720,521,19,5,14,76,82,28,54,104,93,32,19,13,33
S01007721,578,18,2,16,110,69,38,70,79,108,37,18,19,49
S01007722,667,19,4,15,82,83,30,63,122,146,77,55,22,45
S01007723,726,16,2,14,91,71,22,75,145,177,70,55,15,59
S01007724,519,11,0,11,40,57,15,47,103,84,61,36,25,101
S01007725,631,22,0,22,79,80,21,53,95,142,72,40,32,67
S01007726,647,21,5,16,90,66,28,54,108,107,69,52,17,104
S01007727,845,23,2,21,108,86,40,54,129,147,85,61,24,173
S01007728,674,20,2,18,79,62,28,55,103,85,64,36,28,178
S01007729,654,25,3,22,91,65,24,50,106,104,62,28,34,127
S01007730,661,43,2,41,121,86,29,45,122,70,43,20,23,102
S01007731,589,35,5,30,130,71,23,47,100,68,36,20,16,79
S01007732,564,40,2,38,91,63,24,41,91,65,36,19,17,113
S01007733,642,74,19,55,189,93,56,42,62,38,35,22,13,53
S01007734,616,68,15,53,164,104,58,44,63,55,18,9,9,42
S01007735,637,63,11,52,165,102,47,53,76,52,19,12,7,60
S01007736,543,46,9,37,113,74,55,52,86,45,20,18,2,52
S01007737,757,59,7,52,167,117,56,53,126,83,34,25,9,62
S01007738,495,48,13,35,103,81,30,43,72,68,22,10,12,28
S01007739,390,22,5,17,75,54,28,35,69,70,14,5,9,23
S01007740,422,32,4,28,98,83,27,38,64,35,16,10,6,29
S01007741,508,31,10,21,83,87,28,27,88,95,29,17,12,40
S01007742,453,26,9,17,102,74,29,34,68,72,15,10,5,33
S01007743,666,31,7,24,101,89,35,69,122,124,42,21,21,53
S01007744,534,12,1,11,59,57,18,43,115,133,62,41,21,35
S01007745,496,8,1,7,59,67,31,57,114,104,31,11,20,25
S01007746,672,8,2,6,83,62,25,71,138,174,75,45,30,36
S01007747,388,7,2,5,43,38,23,42,93,75,43,25,18,24
S01007748,496,5,1,4,63,47,23,41,106,105,78,52,26,28
S01007749,537,46,11,35,120,105,35,48,80,41,23,16,7,39
S01007750,595,103,17,86,152,107,57,34,61,33,11,10,1,37
S01007751,491,88,14,74,144,63,47,22,39,28,27,21,6,33
S01007752,449,92,16,76,139,57,24,23,49,28,10,6,4,27
S01007753,382,4,1,3,50,42,19,40,82,98,25,15,10,22
S01007754,614,10,1,9,60,64,33,42,140,158,73,39,34,34
S01007755,570,7,1,6,73,63,20,48,121,132,74,44,30,32
S01007756,411,6,0,6,49,45,19,29,113,92,38,25,13,20
S01007757,589,57,8,49,186,121,41,41,62,29,5,3,2,47
S01007758,628,110,19,91,209,76,60,35,60,30,13,9,4,35
S01007759,733,64,9,55,177,101,54,58,118,77,34,16,18,50
S01007760,405,84,20,64,135,60,37,12,28,13,7,5,2,29
S01007761,639,116,14,102,205,75,50,34,55,31,17,8,9,56
S01007762,566,77,11,66,163,79,42,47,68,48,9,5,4,33
S01007763,335,21,3,18,68,53,27,40,48,49,16,8,8,13
S01007764,588,70,20,50,161,105,53,42,59,35,8,6,2,55
S01007765,496,56,8,48,142,106,33,36,66,24,7,3,4,26
S01007766,653,86,19,67,208,108,32,42,69,41,7,4,3,60
S01007767,658,79,20,59,188,114,49,47,69,45,18,12,6,49
S01007768,470,66,10,56,168,55,30,22,50,23,18,11,7,38
S01007769,532,73,17,56,184,81,49,19,49,29,11,8,3,37
S01007770,522,121,28,93,155,70,39,26,39,18,9,4,5,45
S01007771,376,77,14,63,115,63,25,22,22,17,12,7,5,23
S01007772,682,37,5,32,135,118,30,60,127,93,39,23,16,43
S01007773,581,53,13,40,177,110,44,43,72,32,10,6,4,40
S01007774,671,98,20,78,225,108,44,48,62,27,7,4,3,52
S01007775,628,82,17,65,187,105,37,49,73,34,13,7,6,48
S01007776,523,91,23,68,168,74,32,31,36,26,11,8,3,54
S01007777,661,102,17,85,227,99,45,39,56,25,9,6,3,59
S01007778,363,70,14,56,126,27,31,18,39,14,21,21,0,17
S01007779,577,27,12,15,113,106,42,65,108,70,17,11,6,29
S01007780,629,27,5,22,161,98,45,57,105,68,18,12,6,50
S01007781,722,40,11,29,161,110,39,80,118,114,29,14,15,31
S01007782,363,9,1,8,58,29,20,26,70,73,45,30,15,33
S01007783,588,8,0,8,41,62,15,52,122,171,89,53,36,28
S01007784,521,28,8,20,79,86,36,34,106,80,30,14,16,42
S01007785,404,6,0,6,44,36,13,29,94,76,63,36,27,43
S01007786,556,9,3,6,74,60,27,50,145,136,34,16,18,21
S01007787,489,7,3,4,55,55,28,44,121,109,43,32,11,27
S01007788,455,5,1,4,35,43,24,32,100,82,92,52,40,42
S01007789,455,6,0,6,49,44,17,34,93,106,53,41,12,53
S01007790,551,6,3,3,55,40,12,40,152,107,95,65,30,44
S01007791,356,28,8,20,88,53,37,27,59,38,5,2,3,21
S01007792,649,7,3,4,83,70,30,59,145,166,54,31,23,35
S01007793,646,14,2,12,59,59,27,60,149,143,83,49,34,52
S01007794,427,6,2,4,57,57,18,44,94,89,28,18,10,34
S01007795,435,7,1,6,54,46,18,48,100,116,16,10,6,30
S01007796,494,14,4,10,79,58,21,53,114,87,33,14,19,35
S01007797,376,7,3,4,33,42,14,31,71,102,49,30,19,27
S01007798,479,37,7,30,95,96,39,38,77,44,19,16,3,34
S01007799,427,33,6,27,106,59,36,41,56,39,17,11,6,40
S01007800,655,5,2,3,77,57,31,46,142,166,90,53,37,41
S01007801,752,6,3,3,57,41,25,56,147,156,94,71,23,170
S01007802,398,17,0,17,85,78,26,34,72,46,13,8,5,27
S01007803,728,13,2,11,49,77,23,71,156,182,97,63,34,60
S01007804,427,8,3,5,49,47,15,34,82,84,57,42,15,51
S01007805,351,5,0,5,36,45,12,24,83,66,45,31,14,35
S01007806,463,10,1,9,58,73,19,36,89,128,30,17,13,20
S01007807,515,40,8,32,121,83,31,46,70,58,24,16,8,42
S01007808,615,20,0,20,83,73,35,47,126,118,58,40,18,55
S01007809,675,59,14,45,182,118,41,59,86,71,9,8,1,50
S01007810,630,10,5,5,70,53,21,53,122,170,84,60,24,47
S01007811,606,14,1,13,63,72,21,55,136,131,64,47,17,50
S01007812,578,10,1,9,56,47,22,47,128,133,88,55,33,47
S01007813,547,10,2,8,61,68,16,48,113,125,64,40,24,42
S01007814,435,11,1,10,83,52,26,40,76,87,26,18,8,34
S01007815,687,47,16,31,159,122,41,75,87,74,22,16,6,60
S01007816,523,28,8,20,111,99,40,62,82,68,10,7,3,23
S01007817,355,10,6,4,55,48,17,34,62,94,11,6,5,24
S01007818,569,32,12,20,135,88,42,49,97,79,16,11,5,31
S01007819,594,22,4,18,132,81,47,60,98,98,24,18,6,32
S01007820,730,26,5,21,129,98,40,67,130,127,54,41,13,59
S01007821,419,16,4,12,94,61,25,36,83,64,10,10,0,30
S01007822,542,29,5,24,135,97,31,41,80,90,8,3,5,31
S01007823,538,34,9,25,147,90,34,59,70,49,13,11,2,42
S01007824,533,46,11,35,133,81,39,41,76,59,10,10,0,48
S01007825,735,60,9,51,165,113,68,59,121,67,21,15,6,61
S01007826,389,6,1,5,61,32,17,39,81,98,38,29,9,17
S01007827,477,44,6,38,106,67,23,42,79,46,27,16,11,43
S01007828,720,34,4,30,127,107,39,73,118,105,59,35,24,58
S01007829,421,26,8,18,76,64,27,36,60,83,22,20,2,27
S01007830,697,26,6,20,105,92,21,64,144,128,46,30,16,71
S01007831,633,26,2,24,100,74,29,50,115,99,63,42,21,77
S01007832,489,14,1,13,82,62,19,35,91,103,36,20,16,47
S01007833,519,12,3,9,99,66,31,52,115,84,26,15,11,34
S01007834,568,46,4,42,75,87,17,45,96,98,45,22,23,59
S01007835,499,52,4,48,115,66,26,43,73,60,30,18,12,34
S01007836,380,44,9,35,100,72,19,27,39,29,28,21,7,22
S01007837,594,39,11,28,162,117,55,50,65,50,9,8,1,47
S01007838,602,51,10,41,159,118,39,41,71,55,11,7,4,57
S01007839,487,49,3,46,63,54,26,30,51,62,30,24,6,122
S01007840,564,23,3,20,93,91,21,59,97,102,30,19,11,48
S01007841,504,13,1,12,74,82,28,34,87,95,41,18,23,50
S01007842,552,20,2,18,58,82,26,41,95,105,74,43,31,51
S01007843,522,19,2,17,69,85,18,44,96,83,43,22,21,65
S01007844,713,38,4,34,108,90,37,60,119,114,65,31,34,82
S01007845,606,16,4,12,76,81,26,42,116,131,83,53,30,35
S01007846,514,11,2,9,75,72,17,53,128,91,41,20,21,26
S01007847,658,24,5,19,83,88,22,74,134,141,54,29,25,38
S01007848,586,14,0,14,90,61,16,52,118,128,56,24,32,51
S01007849,629,10,1,9,82,87,26,62,125,132,54,35,19,51
S01007850,542,10,2,8,53,74,33,57,112,107,52,41,11,44
S01007851,628,25,6,19,109,92,42,58,116,131,18,9,9,37
S01007852,499,12,0,12,68,61,26,30,97,90,78,49,29,37
S01007853,465,9,0,9,55,49,21,39,100,88,67,42,25,37
S01007854,780,25,4,21,108,79,36,62,157,135,119,63,56,59
S01007855,390,15,3,12,54,46,23,35,79,64,47,17,30,27
S01007856,634,22,3,19,116,86,32,56,111,114,42,30,12,55
S01007857,352,5,1,4,48,47,17,16,77,76,31,23,8,35
S01007858,745,19,4,15,112,101,42,54,159,136,70,33,37,52
S01007859,358,6,3,3,41,41,21,31,69,86,34,20,14,29
S01007860,441,35,8,27,80,51,31,32,80,67,33,17,16,32
S01007861,495,7,1,6,59,60,20,41,128,116,37,26,11,27
S01007862,538,8,1,7,74,53,30,49,119,129,36,19,17,40
S01007863,641,9,1,8,75,76,21,68,107,165,79,50,29,41
S01007864,683,21,3,18,99,95,22,67,148,135,56,34,22,40
S01007865,483,58,14,44,147,68,27,46,52,27,18,14,4,40
S01007866,441,31,6,25,130,79,37,36,48,32,6,3,3,42
S01007867,348,56,6,50,105,46,31,24,29,27,7,6,1,23
S01007868,704,73,8,65,208,118,43,58,69,53,20,10,10,62
S01007869,696,144,14,130,188,87,34,51,61,34,23,15,8,74
S01007870,412,23,8,15,62,41,54,58,84,50,14,12,2,26
S01007871,485,6,3,3,32,30,31,54,125,122,62,37,25,23
S01007872,529,6,0,6,49,36,25,46,124,138,78,58,20,27
S01007873,506,11,2,9,65,59,43,62,103,102,38,29,9,23
S01007874,550,11,3,8,63,65,40,63,125,123,31,17,14,29
S01007875,396,12,1,11,79,37,19,42,81,82,21,13,8,23
S01007876,732,27,5,22,143,103,67,78,140,106,28,19,9,40
S01007877,588,15,3,12,66,71,46,62,122,135,41,27,14,30
S01007878,471,10,1,9,63,40,24,59,105,104,36,23,13,30
S01007879,558,4,1,3,54,49,23,61,143,140,49,31,18,35
S01007880,311,28,7,21,81,26,50,23,41,32,16,6,10,14
S01007881,410,8,2,6,64,37,38,43,81,81,35,18,17,23
S01007882,586,60,19,41,144,66,106,38,65,45,11,4,7,51
S01007883,793,40,13,27,167,115,77,77,125,118,27,18,9,47
S01007884,483,13,2,11,66,68,35,46,104,90,30,19,11,31
S01007885,567,12,0,12,53,43,34,62,122,123,85,44,41,33
S01007886,677,31,7,24,125,84,57,90,110,106,35,24,11,39
S01007887,429,31,10,21,97,50,84,28,53,37,15,9,6,34
S01007888,794,8,1,7,63,76,31,90,185,207,83,46,37,51
S01007889,390,7,2,5,43,43,16,56,97,92,21,13,8,15
S01007890,552,20,0,20,82,58,51,63,110,112,32,17,15,24
S01007891,639,22,4,18,119,87,41,78,125,113,16,12,4,38
S01007892,567,40,12,28,136,79,53,50,97,59,23,15,8,30
S01007893,764,63,9,54,200,79,80,67,110,79,26,19,7,60
S01007894,685,33,6,27,88,79,53,70,133,144,34,20,14,51
S01007895,402,28,7,21,94,54,41,32,60,50,14,6,8,29
S01007896,635,8,0,8,77,56,38,69,133,148,58,34,24,48
S01007897,332,24,3,21,84,27,73,28,49,22,8,3,5,17
S01007898,347,19,5,14,64,42,69,23,50,44,7,5,2,29
S01007899,289,14,3,11,54,36,81,15,29,36,5,1,4,19
S01007900,408,9,5,4,42,31,22,39,95,99,41,32,9,30
S01007901,521,8,2,6,59,62,31,58,98,129,38,24,14,38
S01007902,690,7,2,5,49,75,41,88,139,187,74,56,18,30
S01007903,479,10,5,5,70,56,43,60,91,95,30,16,14,24
S01007904,656,57,17,40,138,61,106,56,67,74,14,9,5,83
S01007905,509,7,2,5,34,34,14,52,130,126,78,42,36,34
S01007906,526,8,3,5,46,39,25,70,107,162,44,27,17,25
S01007907,428,13,4,9,42,35,22,49,87,118,37,23,14,25
S01007908,694,19,8,11,110,73,57,76,136,151,35,23,12,37
S01007909,398,9,2,7,44,41,20,52,81,103,21,13,8,27
S01007910,652,12,5,7,83,47,31,63,128,156,67,42,25,65
S01007911,576,15,4,11,97,76,39,61,114,104,28,20,8,42
S01007912,605,15,4,11,90,65,29,62,132,144,37,25,12,31
S01007913,449,1,0,1,59,34,34,47,96,107,50,36,14,21
S01007914,476,6,3,3,58,44,26,37,116,100,43,26,17,46
S01007915,631,19,4,15,77,86,45,80,136,106,35,16,19,47
S01007916,584,16,2,14,75,78,46,51,104,132,43,28,15,39
S01007917,648,9,4,5,90,73,40,82,117,160,41,30,11,36
S01007918,692,34,5,29,107,85,44,72,105,144,51,31,20,50
S01007919,587,66,18,48,172,86,38,57,65,48,10,6,4,45
S01007920,463,36,7,29,111,73,40,57,58,52,11,8,3,25
S01007921,690,12,3,9,63,63,45,76,144,188,65,44,21,34
S01007922,658,9,2,7,69,53,53,61,149,159,67,42,25,38
S01007923,734,27,10,17,144,95,65,88,125,121,21,10,11,48
S01007924,735,14,5,9,99,57,46,67,156,179,69,38,31,48
S01007925,367,44,8,36,90,36,95,25,29,20,8,4,4,20
S01007926,365,44,8,36,82,47,76,21,36,27,8,6,2,24
S01007927,494,55,7,48,118,58,115,27,45,33,10,8,2,33
S01007928,739,89,26,63,191,101,87,47,90,63,25,20,5,46
S01007929,568,75,11,64,142,53,116,38,48,38,12,7,5,46
S01007930,454,66,15,51,112,37,99,36,35,27,8,5,3,34
S01007931,821,131,33,98,216,107,57,46,93,87,29,22,7,55
S01007932,650,80,16,64,208,91,59,38,63,37,20,13,7,54
S01007933,616,56,12,44,146,66,48,41,107,68,25,13,12,59
S01007934,500,31,7,24,103,76,39,27,70,75,28,19,9,51
S01007935,593,56,8,48,118,90,52,53,81,74,36,18,18,33
S01007936,741,122,23,99,224,118,50,64,60,28,19,12,7,56
S01007937,813,99,22,77,214,131,60,71,95,69,23,13,10,51
S01007938,585,27,9,18,94,90,43,56,115,93,28,12,16,39
S01007939,620,10,1,9,75,77,36,54,152,117,58,33,25,41
S01007940,760,60,10,50,130,92,69,73,125,141,30,18,12,40
S01007941,513,40,14,26,111,101,42,53,67,57,10,8,2,32
S01007942,347,23,5,18,59,59,26,32,40,69,26,13,13,13
S01007943,482,31,11,20,104,66,46,43,78,78,18,10,8,18
S01007944,694,39,11,28,117,76,61,75,121,130,40,24,16,35
S01007945,631,44,9,35,114,71,65,57,85,101,48,23,25,46
S01007946,608,31,7,24,110,67,48,56,102,97,47,21,26,50
S01007947,572,55,18,37,113,74,47,45,83,81,29,13,16,45
S01007948,484,15,3,12,56,34,31,44,92,120,62,38,24,30
S01007949,605,43,12,31,142,99,39,69,101,66,19,9,10,27
S01007950,691,57,18,39,174,120,69,68,72,60,16,9,7,55
S01007951,561,32,9,23,109,85,42,56,80,84,24,10,14,49
S01007952,467,17,3,14,58,57,47,43,94,85,40,23,17,26
S01007953,710,20,2,18,101,85,58,65,157,134,30,11,19,60
S01007954,553,9,0,9,58,44,22,62,129,126,62,33,29,41
S01007955,606,8,1,7,59,77,29,60,151,126,62,32,30,34
S01007956,533,13,4,9,59,65,28,54,112,114,35,21,14,53
S01007957,702,20,3,17,94,88,37,83,152,138,48,38,10,42
S01007958,629,22,6,16,72,74,34,70,130,110,80,42,38,37
S01007959,597,25,8,17,124,89,51,75,105,85,18,8,10,25
S01007960,535,14,2,12,70,63,28,52,125,123,26,14,12,34
S01007961,1061,57,12,45,139,76,178,100,155,168,148,143,5,40
S01007962,418,18,8,10,40,56,29,44,80,85,29,18,11,37
S01007963,668,10,4,6,37,60,44,62,138,150,133,80,53,34
S01007964,569,14,3,11,57,55,26,69,122,129,49,28,21,48
S01007965,414,8,2,6,45,52,18,40,96,80,42,26,16,33
S01007966,661,21,4,17,71,66,24,53,147,139,86,43,43,54
S01007967,444,2,0,2,44,45,21,22,118,92,65,41,24,35
S01007968,614,14,3,11,83,102,32,64,123,116,34,16,18,46
S01007969,590,11,2,9,96,95,29,51,146,93,33,17,16,36
S01007970,625,17,3,14,106,85,33,63,134,113,41,16,25,33
S01007971,659,15,8,7,85,86,30,74,130,131,57,30,27,51
S01007972,600,13,4,9,86,70,28,72,127,133,31,19,12,40
S01007973,678,44,13,31,175,131,39,64,102,78,9,5,4,36
S01007974,610,21,3,18,74,76,31,59,128,130,55,36,19,36
S01007975,470,7,2,5,72,65,33,49,98,81,30,15,15,35
S01007976,536,24,4,20,81,72,23,48,109,113,42,14,28,24
S01007977,518,40,10,30,126,66,30,64,96,43,11,6,5,42
S01007978,456,22,6,16,93,65,25,52,81,68,22,11,11,28
S01007979,639,73,12,61,200,91,40,42,71,45,21,10,11,56
S01007980,528,38,12,26,111,78,37,48,82,74,20,11,9,40
S01007981,426,21,6,15,109,92,40,33,65,36,13,7,6,17
S01007982,400,30,7,23,100,66,29,36,66,34,6,3,3,33
S01007983,556,15,3,12,66,64,29,55,118,119,42,20,22,48
S01007984,615,38,8,30,122,81,31,51,122,98,32,22,10,40
S01007985,698,19,10,9,61,81,36,71,169,142,66,32,34,53
S01007986,437,22,6,16,71,67,21,41,90,72,16,11,5,37
S01007987,586,41,4,37,114,92,33,52,93,86,26,10,16,49
S01007988,632,16,3,13,86,84,30,59,164,115,44,29,15,34
S01007989,532,10,3,7,81,52,38,47,123,93,38,23,15,50
S01007990,665,28,7,21,106,94,32,79,127,102,37,14,23,60
S01007991,699,92,22,70,232,122,48,40,65,31,18,9,9,51
S01007992,484,50,6,44,129,73,44,52,36,30,6,3,3,64
S01007993,676,54,11,43,174,106,53,64,115,54,13,8,5,43
S01007994,596,91,21,70,195,99,43,33,53,30,9,5,4,43
S01007995,674,75,13,62,183,114,32,65,84,48,15,10,5,58
S01007996,361,42,10,32,106,43,44,27,34,26,12,8,4,27
S01007997,515,65,12,53,175,71,45,37,48,27,17,10,7,30
S01007998,399,53,11,42,116,54,44,26,43,22,11,6,5,30
S01007999,496,7,1,6,52,46,33,43,139,103,34,16,18,39
S01008000,627,14,1,13,66,70,31,57,141,140,60,38,22,48
S01008001,610,11,1,10,46,50,22,55,141,150,89,52,37,46
S01008002,584,9,4,5,47,48,45,56,128,103,107,68,39,41
S01008003,447,17,3,14,78,46,33,41,96,70,26,13,13,40
S01008004,454,36,3,33,101,65,22,45,68,59,16,9,7,42
S01008005,396,37,4,33,87,60,29,34,61,34,26,14,12,28
S01008006,413,10,4,6,30,27,19,42,92,95,69,51,18,29
S01008007,327,6,0,6,34,33,9,35,62,72,53,32,21,23
S01008008,439,14,0,14,60,37,27,41,78,91,63,42,21,28
S01008009,568,27,8,19,86,74,37,48,97,97,65,44,21,37
S01008010,722,29,11,18,116,87,52,72,132,90,100,59,41,44
S01008011,477,15,1,14,87,51,22,33,95,97,60,36,24,17
S01008012,646,40,8,32,138,90,46,57,97,83,42,26,16,53
S01008013,470,40,9,31,90,83,39,34,70,71,19,12,7,24
S01008014,487,40,9,31,123,62,36,46,70,60,16,11,5,34
S01008015,585,25,1,24,102,82,26,70,113,99,39,20,19,29
S01008016,587,23,3,20,101,84,52,59,114,88,40,23,17,26
S01008017,638,76,19,57,204,100,43,41,68,34,14,7,7,58
S01008018,489,59,16,43,141,78,39,33,64,35,3,2,1,37
S01008019,537,79,11,68,168,59,39,32,68,37,10,7,3,45
S01008020,475,39,8,31,108,88,40,47,56,50,8,5,3,39
S01008021,426,53,14,39,132,68,39,26,51,16,9,4,5,32
S01008022,550,54,16,38,180,78,49,40,61,30,8,5,3,50
S01008023,529,72,16,56,142,77,43,46,66,18,8,3,5,57
S01008024,477,90,16,74,174,63,36,31,32,17,5,3,2,29
S01008025,565,36,6,30,120,109,40,60,79,69,17,13,4,35
S01008026,761,38,10,28,134,101,53,76,141,137,42,25,17,39
S01008027,433,21,2,19,78,75,10,50,59,88,22,11,11,30
S01008028,439,23,5,18,91,66,39,46,72,61,13,9,4,28
S01008029,675,65,6,59,145,78,103,44,101,56,39,31,8,44
S01008030,811,70,11,59,234,111,83,59,88,92,16,10,6,58
S01008031,662,43,6,37,107,93,46,59,123,107,39,23,16,45
S01008032,691,34,9,25,126,104,49,67,112,127,18,9,9,54
S01008033,600,121,24,97,179,70,53,28,37,23,7,3,4,82
S01008034,578,122,22,100,177,72,57,20,35,14,9,7,2,72
S01008035,485,65,15,50,133,109,29,33,39,21,15,9,6,41
S01008036,515,70,10,60,161,74,35,31,57,25,13,8,5,49
S01008037,752,46,7,39,141,100,56,76,169,85,19,7,12,60
S01008038,530,33,4,29,95,73,42,52,103,72,21,10,11,39
S01008039,656,49,12,37,146,77,46,61,121,64,17,7,10,75
S01008040,568,100,16,84,154,85,48,29,61,31,10,4,6,50
S01008041,485,85,12,73,140,70,34,26,56,31,9,5,4,34
S01008042,397,102,10,92,127,46,32,8,33,11,7,4,3,31
S01008043,640,163,19,144,200,74,79,16,37,17,9,6,3,45
S01008044,686,139,20,119,238,78,52,30,58,15,9,7,2,67
S01008045,698,146,13,133,197,82,79,34,48,34,30,19,11,48
S01008046,549,64,14,50,124,88,22,37,81,60,45,31,14,28
S01008047,489,94,8,86,142,71,46,20,38,18,8,5,3,52
S01008048,425,77,17,60,135,68,25,19,35,13,11,7,4,42
S01008049,596,112,17,95,203,110,51,19,34,14,7,3,4,46
S01008050,437,108,23,85,130,69,36,6,15,15,14,10,4,44
S01008051,619,148,25,123,196,92,30,29,38,21,13,11,2,52
S01008052,602,161,21,140,219,73,38,11,34,13,9,7,2,44
S01008053,419,97,10,87,152,54,30,10,22,19,1,0,1,34
S01008054,528,129,24,105,164,63,50,17,24,20,10,5,5,51
S01008055,748,208,33,175,250,82,47,17,38,10,13,10,3,83
S01008056,494,130,14,116,141,55,35,21,36,14,6,4,2,56
S01008057,637,145,25,120,215,88,54,17,41,11,6,5,1,60
S01008058,695,170,24,146,191,65,82,18,59,14,15,10,5,81
S01008059,527,78,7,71,159,91,47,24,40,21,9,8,1,58
S01008060,696,116,20,96,196,132,50,31,54,26,14,8,6,77
S01008061,495,80,12,68,149,81,40,24,46,19,12,8,4,44
S01008062,638,69,11,58,189,140,44,51,67,33,8,5,3,37
S01008063,655,128,16,112,195,104,47,29,60,7,14,10,4,71
S01008064,522,41,3,38,106,79,32,40,79,51,39,24,15,55
S01008065,720,173,25,148,232,87,45,22,45,22,12,7,5,82
S01008066,659,225,28,197,191,43,54,9,31,10,15,7,8,81
S01008067,466,131,13,118,140,44,32,16,34,14,5,5,0,50
S01008068,701,122,23,99,209,101,56,42,64,41,9,8,1,57
S01008069,699,62,9,53,187,141,46,47,90,54,17,8,9,55
S01008070,686,49,11,38,170,147,40,55,102,47,15,4,11,61
S01008071,518,65,8,57,171,84,35,39,41,25,9,6,3,49
S01008072,603,150,22,128,202,69,44,20,31,16,14,8,6,57
S01008073,345,109,17,92,100,31,34,8,16,10,6,5,1,31
S01008074,719,154,23,131,228,102,60,27,48,14,13,11,2,73
S01008075,401,94,9,85,123,60,37,7,19,9,8,6,2,44
S01008076,418,107,13,94,127,67,33,15,25,5,11,9,2,28
S01008077,570,162,23,139,177,66,51,16,26,12,16,10,6,44
S01008078,595,128,21,107,172,76,55,23,47,15,15,11,4,64
S01008079,648,135,23,112,237,77,64,21,45,10,20,11,9,39
S01008080,497,94,16,78,147,76,52,26,40,19,9,5,4,34
S01008081,441,93,17,76,130,57,35,17,42,11,11,8,3,45
S01008082,607,107,18,89,202,84,51,26,44,23,15,13,2,55
S01008083,540,101,19,82,167,80,44,22,48,15,10,8,2,53
S01008084,654,88,15,73,170,103,68,41,68,31,16,8,8,69
S01008085,744,102,13,89,240,93,84,34,66,27,12,10,2,86
S01008086,812,116,20,96,206,121,80,55,87,63,16,8,8,68
S01008087,582,88,21,67,160,114,33,29,58,34,13,11,2,53
S01008088,682,84,13,71,185,127,38,53,74,41,19,14,5,61
S01008089,494,52,15,37,144,82,37,32,58,21,15,11,4,53
S01008090,541,78,13,65,122,98,33,30,52,56,15,8,7,57
S01008091,289,35,4,31,82,40,19,13,38,26,7,6,1,29
S01008092,630,98,12,86,188,107,47,28,57,23,8,5,3,74
S01008093,558,73,18,55,154,115,42,35,51,21,8,6,2,59
S01008094,488,73,7,66,148,67,50,27,39,19,13,6,7,52
S01008095,557,49,9,40,138,114,36,41,60,48,14,6,8,57
S01008096,554,74,18,56,162,93,37,31,62,36,7,5,2,52
S01008097,433,45,15,30,123,76,41,23,46,23,6,2,4,50
S01008098,539,68,16,52,152,95,34,35,47,41,14,12,2,53
S01008099,408,37,6,31,92,73,29,38,50,32,10,6,4,47
S01008100,671,120,16,104,199,88,63,33,50,37,16,8,8,65
S01008101,599,77,13,64,171,83,43,45,66,46,19,11,8,49
S01008102,607,42,9,33,142,103,47,42,81,72,31,19,12,47
S01008103,452,36,9,27,100,58,38,24,76,63,30,17,13,27
S01008104,659,33,5,28,103,124,41,59,105,93,51,32,19,50
S01008105,780,38,10,28,140,127,52,64,126,122,58,32,26,53
S01008106,575,20,2,18,94,83,31,42,113,104,51,30,21,37
S01008107,614,85,15,70,152,82,81,44,65,29,15,11,4,61
S01008108,531,68,16,52,130,92,43,33,67,41,11,7,4,46
S01008109,726,59,18,41,167,150,57,56,102,53,17,10,7,65
S01008110,652,42,6,36,194,118,50,53,72,44,14,4,10,65
S01008111,638,89,20,69,177,123,41,38,67,32,4,4,0,67
S01008112,614,52,12,40,163,128,36,54,88,29,11,10,1,53
S01008113,683,82,12,70,184,142,38,49,75,40,7,5,2,66
S01008114,510,54,11,43,126,92,37,42,63,41,13,6,7,42
S01008115,734,47,9,38,165,154,57,73,84,53,20,10,10,81
S01008116,703,99,18,81,204,130,39,30,69,42,15,10,5,75
S01008117,582,100,22,78,189,82,42,23,51,19,18,9,9,58
S01008118,587,59,8,51,154,99,45,50,82,41,17,6,11,40
S01008119,496,19,3,16,82,62,25,50,101,78,32,22,10,47
S01008120,431,66,12,54,131,77,27,17,52,21,12,6,6,28
S01008121,475,112,21,91,148,74,30,23,36,12,5,3,2,35
S01008122,529,133,15,118,165,60,43,14,23,16,14,8,6,61
S01008123,675,167,26,141,222,85,48,17,41,14,11,8,3,70
S01008124,635,82,14,68,196,121,41,30,53,32,7,4,3,73
S01008125,659,94,29,65,200,117,42,30,69,39,7,5,2,61
S01008126,644,114,19,95,191,112,41,39,49,19,11,4,7,68
S01008127,367,69,13,56,131,56,16,16,28,16,9,4,5,26
S01008128,695,89,14,75,199,124,43,39,60,44,17,5,12,80
S01008129,684,35,9,26,161,104,46,58,116,82,45,25,20,37
S01008130,748,46,10,36,169,118,40,49,122,84,61,35,26,59
S01008131,596,36,3,33,127,95,38,43,101,72,38,19,19,46
S01008132,716,110,22,88,223,127,53,45,62,31,14,6,8,51
S01008133,450,55,9,46,115,52,30,27,69,46,27,21,6,29
S01008134,470,63,10,53,126,73,31,41,58,31,21,12,9,26
S01008135,861,75,17,58,223,121,61,70,127,62,60,44,16,62
S01008136,681,48,8,40,133,106,36,58,129,100,42,30,12,29
S01008137,634,21,5,16,60,66,24,59,150,122,84,49,35,48
S01008138,613,18,4,14,81,58,30,57,143,118,65,41,24,43
S01008139,647,25,4,21,117,102,42,60,95,102,47,21,26,57
S01008140,344,27,6,21,50,52,18,22,66,65,26,17,9,18
S01008141,643,52,7,45,166,110,52,62,86,41,13,9,4,61
S01008142,636,51,15,36,178,111,34,51,76,53,18,8,10,64
S01008143,674,35,1,34,155,100,33,48,120,96,43,25,18,44
S01008144,468,45,9,36,127,83,55,24,50,25,5,4,1,54
S01008145,600,24,6,18,93,57,41,71,110,128,36,20,16,40
S01008146,376,21,5,16,56,44,28,32,63,78,21,11,10,33
S01008147,621,32,9,23,121,97,41,58,133,77,23,13,10,39
S01008148,620,41,3,38,147,114,40,53,93,67,17,13,4,48
S01008149,528,20,4,16,109,95,34,41,99,69,21,6,15,40
S01008150,686,33,9,24,117,114,35,61,125,123,34,21,13,44
S01008151,509,25,3,22,85,67,33,61,105,57,26,16,10,50
S01008152,755,41,8,33,149,116,48,68,150,93,39,23,16,51
S01008153,667,72,11,61,187,117,46,46,68,47,16,8,8,68
S01008154,635,89,18,71,174,109,46,33,72,54,11,5,6,47
S01008155,537,58,14,44,147,95,32,37,63,33,23,13,10,49
S01008156,704,54,8,46,156,94,76,55,106,71,32,12,20,60
S01008157,564,73,7,66,148,85,41,45,71,30,14,5,9,57
S01008158,602,48,9,39,174,111,43,55,65,38,13,5,8,55
S01008159,713,39,8,31,113,86,42,67,151,101,63,34,29,51
S01008160,663,40,8,32,113,75,38,62,130,92,60,30,30,53
S01008161,778,80,16,64,256,98,82,62,87,43,18,11,7,52
S01008162,756,89,14,75,203,87,56,63,116,93,11,8,3,38
S01008163,544,25,4,21,73,69,43,59,110,105,31,21,10,29
S01008164,1292,22,3,19,84,70,43,46,101,91,23,12,11,812
S01008165,545,58,7,51,149,96,67,38,52,33,16,10,6,36
S01008166,402,9,1,8,60,37,28,36,98,83,20,15,5,31
S01008167,521,12,5,7,57,65,32,56,111,118,37,19,18,33
S01008168,596,27,3,24,86,81,30,58,141,103,38,26,12,32
S01008169,531,20,4,16,88,71,35,49,122,96,19,15,4,31
S01008170,439,69,14,55,108,63,41,23,57,31,7,2,5,40
S01008171,527,38,7,31,94,97,27,53,89,69,15,10,5,45
S01008172,414,18,8,10,84,87,30,34,69,54,8,3,5,30
S01008173,491,43,8,35,110,97,28,35,84,45,14,9,5,35
S01008174,412,29,5,24,78,102,31,33,62,44,2,1,1,31
S01008175,579,47,7,40,113,96,42,50,90,88,23,12,11,30
S01008176,563,104,19,85,159,63,58,37,53,32,14,6,8,43
S01008177,552,41,12,29,106,90,40,44,106,80,20,12,8,25
S01008178,512,36,9,27,123,121,32,36,69,44,15,10,5,36
S01008179,387,42,11,31,95,72,35,22,48,22,1,0,1,50
S01008180,374,37,7,30,107,68,35,24,51,9,7,5,2,36
S01008181,515,58,14,44,125,103,49,32,58,31,13,10,3,46
S01008182,754,61,7,54,157,134,42,62,111,93,35,15,20,59
S01008183,476,49,11,38,97,86,34,44,58,37,18,11,7,53
S01008184,606,49,11,38,126,111,43,39,82,83,26,10,16,47
S01008185,762,43,8,35,170,131,46,60,119,103,35,14,21,55
S01008186,618,31,3,28,142,74,30,51,63,47,30,19,11,150
S01008187,454,45,7,38,72,53,37,32,89,64,28,20,8,34
S01008188,643,29,5,24,98,85,36,56,123,111,35,23,12,70
S01008189,431,40,9,31,86,81,40,29,51,51,12,4,8,41
S01008190,642,19,3,16,94,81,38,34,150,138,40,25,15,48
S01008191,357,19,7,12,68,57,23,30,61,51,23,15,8,25
S01008192,637,54,5,49,131,93,44,49,100,92,34,22,12,40
S01008193,560,59,7,52,122,78,34,37,110,66,15,10,5,39
S01008194,440,45,10,35,100,54,28,40,65,58,25,13,12,25
S01008195,590,19,4,15,88,90,40,45,131,93,29,22,7,55
S01008196,555,15,4,11,69,82,40,58,107,104,42,25,17,38
S01008197,731,72,11,61,206,124,39,80,82,68,31,17,14,29
S01008198,514,14,3,11,77,72,34,66,116,90,19,11,8,26
S01008199,581,7,0,7,55,54,28,67,153,137,52,36,16,28
S01008200,441,17,1,16,58,61,29,39,101,98,21,17,4,17
S01008201,582,18,3,15,74,77,21,60,128,122,47,28,19,35
S01008202,425,18,5,13,71,84,24,29,86,70,9,5,4,34
S01008203,424,8,1,7,64,48,31,32,80,98,42,19,23,21
S01008204,640,40,7,33,121,86,53,60,112,112,33,23,10,23
S01008205,512,22,11,11,69,67,38,64,116,87,20,8,12,29
S01008206,464,15,3,12,61,67,32,58,91,100,26,20,6,14
S01008207,434,8,4,4,39,55,35,47,106,95,24,15,9,25
S01008208,607,48,9,39,141,105,47,65,87,68,18,5,13,28
S01008209,408,29,5,24,92,87,47,33,55,28,4,3,1,33
S01008210,685,41,9,32,141,115,71,57,119,85,23,9,14,33
S01008211,665,59,10,49,140,114,70,47,90,76,31,16,15,38
S01008212,433,36,6,30,116,82,35,44,59,25,10,6,4,26
S01008213,745,84,15,69,177,119,57,60,108,60,21,12,9,59
S01008214,506,34,12,22,105,81,43,48,85,73,27,17,10,10
S01008215,553,29,3,26,125,98,40,50,101,55,21,14,7,34
S01008216,396,33,8,25,94,76,38,24,54,29,10,4,6,38
S01008217,438,66,15,51,143,70,41,35,36,20,5,1,4,22
S01008218,790,97,17,80,218,135,84,45,82,60,13,6,7,56
S01008219,752,55,8,47,146,116,78,51,134,93,38,22,16,41
S01008220,440,14,3,11,54,37,24,56,108,82,33,26,7,32
S01008221,500,18,3,15,63,35,37,47,120,94,61,42,19,25
S01008222,428,12,3,9,63,57,28,41,101,81,24,13,11,21
S01008223,434,14,5,9,74,68,20,30,106,71,27,17,10,24
S01008224,731,44,8,36,143,171,52,71,138,66,15,11,4,31
S01008225,558,20,5,15,122,93,32,49,106,83,8,5,3,45
S01008226,521,12,2,10,66,70,37,41,125,109,37,25,12,24
S01008227,621,15,0,15,85,76,34,59,148,157,23,17,6,24
S01008228,479,32,5,27,120,77,62,33,70,46,11,8,3,28
S01008229,516,18,4,14,80,75,28,55,112,111,17,12,5,20
S01008230,604,49,11,38,147,100,61,51,90,52,14,9,5,40
S01008231,521,50,11,39,133,101,58,43,55,38,6,5,1,37
S01008232,480,57,8,49,113,80,35,41,62,46,23,14,9,23
S01008233,344,34,7,27,83,58,34,23,36,46,12,9,3,18
S01008234,298,7,1,6,41,38,24,34,70,58,12,11,1,14
S01008235,597,34,3,31,116,92,49,58,104,96,16,7,9,32
S01008236,627,53,9,44,149,91,66,58,94,63,24,8,16,29
S01008237,647,54,13,41,119,87,76,48,118,86,24,15,9,35
S01008238,551,20,2,18,89,76,38,68,90,113,34,21,13,23
S01008239,570,37,11,26,110,81,70,53,102,83,13,10,3,21
S01008240,666,106,17,89,209,113,73,32,61,35,5,0,5,32
S01008241,501,82,22,60,168,82,55,24,39,16,8,4,4,27
S01008242,645,78,14,64,162,83,73,54,84,63,22,14,8,26
S01008243,647,105,17,88,190,71,78,36,77,43,10,8,2,37
S01008244,410,58,9,49,127,41,50,26,43,31,12,7,5,22
S01008245,715,92,15,77,235,86,79,40,93,52,7,3,4,31
S01008246,714,125,22,103,208,94,74,40,71,42,10,6,4,50
S01008247,612,87,25,62,157,62,100,35,77,45,11,7,4,38
S01008248,665,85,14,71,153,60,96,54,91,65,21,13,8,40
S01008249,674,107,28,79,191,68,111,39,71,41,13,8,5,33
S01008250,773,142,25,117,232,91,101,26,78,33,21,14,7,49
S01008251,518,112,16,96,158,75,38,21,41,22,6,3,3,45
S01008252,612,74,14,60,201,99,46,37,66,39,10,5,5,40
S01008253,550,29,5,24,114,67,38,55,101,101,26,16,10,19
S01008254,710,40,6,34,137,81,47,83,130,115,38,25,13,39
S01008255,527,39,6,33,125,78,42,38,98,52,20,16,4,35
S01008256,615,33,3,30,89,62,55,55,128,112,37,21,16,44
S01008257,401,42,7,35,98,42,41,27,59,58,17,14,3,17
S01008258,646,71,15,56,162,101,50,48,102,64,11,7,4,37
S01008259,558,70,20,50,150,56,72,37,76,54,17,9,8,26
S01008260,611,34,10,24,119,65,35,60,148,92,29,20,9,29
S01008261,659,29,8,21,105,62,55,64,135,131,38,24,14,40
S01008262,467,72,14,58,108,38,67,39,72,36,8,5,3,27
S01008263,426,90,14,76,116,54,46,26,45,22,8,7,1,19
S01008264,506,50,9,41,109,62,42,51,89,61,20,11,9,22
S01008265,453,87,12,75,136,71,45,24,37,26,7,4,3,20
S01008266,473,119,30,89,145,55,50,18,35,18,9,6,3,24
S01008267,606,97,26,71,157,68,80,46,75,46,10,6,4,27
S01008268,595,145,27,118,190,65,66,34,39,20,4,0,4,32
S01008269,507,97,23,74,161,62,45,21,55,21,13,10,3,32
S01008270,516,95,16,79,186,57,54,17,32,29,16,7,9,30
S01008271,507,46,8,38,136,52,65,42,65,34,32,19,13,35
S01008272,737,110,24,86,200,76,82,49,106,49,10,7,3,55
S01008273,593,101,22,79,175,70,44,33,82,32,13,10,3,43
S01008274,516,41,7,34,89,48,49,61,118,63,19,9,10,28
S01008275,392,79,16,63,109,37,36,23,37,38,9,6,3,24
S01008276,402,74,14,60,107,50,45,26,43,25,10,8,2,22
S01008277,371,56,12,44,111,30,75,19,32,16,12,6,6,20
S01008278,569,123,23,100,174,55,74,21,53,30,11,6,5,28
S01008279,522,46,10,36,123,67,51,35,90,71,13,5,8,26
S01008280,689,98,16,82,177,64,102,53,88,56,18,5,13,33
S01008281,547,72,17,55,145,57,78,35,74,44,19,10,9,23
S01008282,536,56,13,43,122,64,93,38,75,56,12,7,5,20
S01008283,369,69,10,59,90,51,42,19,40,17,12,3,9,29
S01008284,618,71,17,54,152,78,62,47,80,82,18,10,8,28
S01008285,552,20,3,17,68,59,45,66,132,116,23,13,10,23
S01008286,537,31,8,23,93,55,42,55,97,112,14,9,5,38
S01008287,567,49,15,34,120,63,40,47,87,88,29,16,13,44
S01008288,630,76,14,62,150,64,65,48,92,76,26,15,11,33
S01008289,495,27,8,19,105,67,48,56,85,80,13,9,4,14
S01008290,644,83,21,62,157,67,75,48,87,57,32,19,13,38
S01008291,509,44,12,32,98,93,33,62,95,59,11,5,6,14
S01008292,569,43,7,36,98,61,42,40,113,104,35,22,13,33
S01008293,415,84,13,71,123,69,36,19,36,13,6,3,3,29
S01008294,643,94,16,78,161,91,51,55,78,62,18,12,6,33
S01008295,765,52,11,41,174,138,42,85,121,66,17,12,5,70
S01008296,477,31,5,26,79,57,38,46,86,58,35,24,11,47
S01008297,551,50,8,42,145,92,40,40,67,50,22,14,8,45
S01008298,567,38,7,31,133,88,49,55,86,44,25,19,6,49
S01008299,551,27,7,20,105,62,34,40,106,85,53,28,25,39
S01008300,644,25,8,17,125,81,46,50,134,70,50,30,20,63
S01008301,666,65,12,53,151,131,51,52,84,54,19,10,9,59
S01008302,559,99,20,79,151,73,76,26,45,32,8,5,3,49
S01008303,422,40,8,32,76,82,31,33,66,45,15,7,8,34
S01008304,369,55,9,46,99,54,26,35,37,20,10,8,2,33
S01008305,619,58,18,40,158,121,37,54,85,45,11,6,5,50
S01008306,510,38,3,35,132,92,34,37,70,49,8,7,1,50
S01008307,420,42,10,32,106,94,28,23,52,37,9,2,7,29
S01008308,448,63,13,50,135,83,21,33,47,19,10,7,3,37
S01008309,522,32,9,23,76,71,25,45,102,76,45,30,15,50
S01008310,693,35,7,28,143,110,36,74,103,90,41,21,20,61
S01008311,284,20,5,15,45,44,14,27,52,41,15,6,9,26
S01008312,309,26,3,23,73,54,10,17,56,25,22,16,6,26
S01008313,675,31,11,20,101,69,34,66,163,118,63,45,18,30
S01008314,454,18,4,14,70,54,25,52,104,59,30,14,16,42
S01008315,567,28,4,24,82,75,37,53,112,90,51,30,21,39
S01008316,410,16,1,15,54,33,17,24,74,92,70,53,17,30
S01008317,551,41,8,33,117,72,37,40,88,76,35,26,9,45
S01008318,696,84,26,58,190,115,56,42,83,48,24,19,5,54
S01008319,529,24,2,22,91,95,36,42,105,74,24,16,8,38
S01008320,495,41,13,28,113,67,30,50,94,52,22,16,6,26
S01008321,420,37,10,27,106,75,33,33,47,29,14,11,3,46
S01008322,768,53,11,42,156,140,39,70,132,93,35,17,18,50
S01008323,576,14,4,10,75,70,36,46,130,103,54,31,23,48
S01008324,469,28,7,21,74,60,30,35,95,70,32,19,13,45
S01008325,530,13,2,11,74,70,17,56,103,98,56,39,17,43
S01008326,710,15,4,11,106,95,35,61,171,118,57,32,25,52
S01008327,623,27,6,21,81,96,28,63,133,101,47,27,20,47
S01008328,479,81,9,72,137,71,53,20,37,17,16,12,4,47
S01008329,657,101,15,86,196,100,57,30,58,26,22,14,8,67
S01008330,660,72,19,53,175,109,47,33,91,31,28,16,12,74
S01008331,453,57,8,49,122,59,46,24,58,25,18,11,7,44
S01008332,650,112,17,95,184,81,62,12,76,22,26,21,5,75
S01008333,651,143,38,105,204,77,70,13,56,14,16,11,5,58
S01008334,511,90,12,78,157,58,42,27,50,16,25,18,7,46
S01008335,511,51,8,43,125,72,32,32,86,46,15,9,6,52
S01008336,455,50,10,40,102,65,51,27,60,41,25,16,9,34
S01008337,620,124,20,104,190,82,21,42,62,28,20,13,7,51
S01008338,576,122,17,105,174,72,45,16,48,12,16,13,3,71
S01008339,486,81,12,69,130,86,37,22,53,18,16,11,5,43
S01008340,622,92,11,81,183,78,54,33,69,24,21,13,8,68
S01008341,481,101,15,86,144,59,50,16,29,12,12,3,9,58
S01008342,656,111,17,94,171,77,46,34,70,51,25,20,5,71
S01008343,611,153,23,130,186,61,58,11,37,15,14,6,8,76
S01008344,631,175,34,141,172,66,75,19,36,11,17,13,4,60
S01008345,674,161,34,127,203,73,85,18,28,13,16,13,3,77
S01008346,682,175,48,127,204,77,69,14,35,18,15,7,8,75
S01008347,636,106,21,85,188,86,73,16,55,26,22,15,7,64
S01008348,520,97,14,83,153,83,46,18,44,12,19,9,10,48
S01008349,603,155,28,127,187,72,62,11,20,0,21,15,6,75
S01008350,416,79,18,61,135,63,47,10,29,7,10,3,7,36
S01008351,626,125,31,94,210,82,46,23,48,13,13,8,5,66
S01008352,463,117,17,100,146,56,39,13,25,7,12,11,1,48
S01008353,351,81,14,67,85,45,39,10,28,5,9,5,4,49
S01008354,482,95,20,75,116,57,77,27,37,26,17,12,5,30
S01008355,457,44,9,35,108,70,48,31,53,42,25,16,9,36
S01008356,431,66,14,52,125,68,40,24,48,17,7,2,5,36
S01008357,502,83,16,67,136,87,37,30,52,25,5,3,2,47
S01008358,493,57,11,46,117,72,46,39,68,45,15,5,10,34
S01008359,446,62,13,49,121,75,71,33,28,15,10,6,4,31
S01008360,637,126,26,100,186,102,57,23,43,25,8,5,3,67
S01008361,389,45,11,34,117,67,34,21,39,17,8,6,2,41
S01008362,672,102,11,91,233,107,44,26,59,23,19,13,6,59
S01008363,552,108,24,84,150,92,36,30,52,14,9,6,3,61
S01008364,564,110,20,90,153,74,57,25,52,13,13,10,3,67
S01008365,510,99,23,76,152,63,69,19,35,9,13,7,6,51
S01008366,578,59,5,54,143,92,33,28,88,43,28,17,11,64
S01008367,549,44,9,35,120,73,42,34,78,60,28,18,10,70
S01008368,492,64,11,53,148,90,36,20,52,33,10,5,5,39
S01008369,383,53,14,39,104,48,21,18,46,46,13,5,8,34
S01008370,499,82,17,65,136,63,43,26,49,23,13,9,4,64
S01008371,567,95,19,76,177,91,34,35,41,17,8,6,2,69
S01008372,583,74,18,56,157,100,32,51,60,24,18,9,9,67
S01008373,579,99,16,83,215,83,32,25,39,9,13,8,5,64
S01008374,503,66,12,54,159,93,30,28,47,22,5,2,3,53
S01008375,570,93,29,64,178,88,38,26,58,12,9,5,4,68
S01008376,380,74,16,58,115,53,31,20,27,18,10,5,5,32
S01008377,528,88,9,79,156,87,43,29,44,17,14,9,5,50
S01008378,680,123,25,98,212,96,53,26,63,19,13,10,3,75
S01008379,375,48,14,34,133,56,19,30,29,7,16,12,4,37
S01008380,484,82,13,69,150,81,31,27,37,17,6,3,3,53
S01008381,465,69,10,59,155,76,44,19,33,12,4,0,4,53
S01008382,452,81,11,70,137,79,43,20,26,18,4,3,1,44
S01008383,342,66,14,52,109,43,24,16,32,16,7,3,4,29
S01008384,714,91,13,78,175,134,46,53,94,41,8,6,2,72
S01008385,475,93,16,77,150,69,42,20,30,17,11,6,5,43
S01008386,609,58,12,46,154,122,36,52,66,42,14,8,6,65
S01008387,441,51,12,39,127,91,27,20,55,22,9,3,6,39
S01008388,475,53,6,47,125,87,36,29,63,32,6,2,4,44
S01008389,372,66,11,55,118,59,34,19,28,11,4,3,1,33
S01008390,457,96,16,80,145,64,35,16,35,16,6,4,2,44
S01008391,492,102,16,86,151,60,29,23,45,20,15,8,7,47
S01008392,663,153,28,125,223,65,45,26,37,13,22,18,4,79
S01008393,534,124,20,104,179,63,31,20,29,21,11,6,5,56
S01008394,566,166,37,129,174,59,40,14,19,20,11,7,4,63
S01008395,395,53,11,42,119,69,22,18,42,16,9,8,1,47
S01008396,421,55,10,45,123,74,41,14,45,23,13,7,6,33
S01008397,713,159,31,128,211,98,45,38,49,23,15,10,5,75
S01008398,408,90,16,74,123,65,26,13,36,11,7,3,4,37
S01008399,368,51,9,42,119,58,36,14,32,14,17,17,0,27
S01008400,476,84,9,75,126,80,34,19,39,12,26,22,4,56
S01008401,672,85,13,72,218,123,47,26,73,20,17,16,1,63
S01008402,774,180,35,145,231,91,108,15,39,14,13,11,2,83
S01008403,431,102,13,89,115,61,33,16,24,14,12,6,6,54
S01008404,617,122,21,101,198,90,52,13,48,22,13,6,7,59
S01008405,545,159,20,139,153,54,47,12,29,13,18,13,5,60
S01008406,599,135,15,120,169,72,51,12,51,19,31,25,6,59
S01008407,355,52,12,40,106,51,27,16,30,15,29,27,2,29
S01008408,467,60,10,50,132,69,36,17,44,35,21,17,4,53
S01008409,603,51,11,40,130,109,38,45,99,57,32,22,10,42
S01008410,399,71,16,55,99,57,34,13,39,23,28,24,4,35
S01008411,455,52,5,47,99,82,40,26,64,32,15,12,3,45
S01008412,509,69,14,55,123,64,35,32,63,17,28,22,6,78
S01008413,407,55,6,49,89,63,33,25,53,26,25,17,8,38
S01008414,327,50,9,41,100,46,32,10,27,7,7,6,1,48
S01008415,621,57,8,49,139,91,51,42,105,57,22,14,8,57
S01008416,724,45,6,39,130,117,47,62,111,92,57,37,20,63
S01008417,548,101,15,86,171,82,51,23,44,19,12,8,4,45
S01008418,536,107,15,92,158,85,48,24,52,27,4,3,1,31
S01008419,349,83,25,58,117,37,24,11,25,14,9,4,5,29
S01008420,356,74,9,65,93,63,20,17,32,22,5,1,4,30
S01008421,620,81,13,68,149,97,34,38,96,49,28,15,13,48
S01008422,417,96,17,79,150,62,25,9,23,19,4,4,0,29
S01008423,750,194,42,152,231,89,62,15,44,31,19,11,8,65
S01008424,583,140,29,111,185,87,38,19,43,8,8,7,1,55
S01008425,2209,118,17,101,190,142,59,36,69,37,18,12,6,1540
S01008426,407,23,2,21,74,62,21,41,81,59,12,10,2,34
S01008427,851,141,27,114,199,151,68,50,105,45,11,7,4,81
S01008428,457,35,6,29,89,75,34,32,69,72,13,10,3,38
S01008429,601,94,22,72,164,120,38,29,56,38,15,10,5,47
S01008430,469,72,12,60,125,65,36,19,60,31,17,12,5,44
S01008431,602,96,9,87,151,123,33,24,68,39,18,14,4,50
S01008432,497,76,11,65,140,113,35,25,44,13,11,6,5,40
S01008433,645,58,14,44,159,149,49,54,81,53,8,6,2,34
S01008434,630,74,7,67,173,133,52,42,63,32,15,9,6,46
S01008435,606,83,17,66,147,142,37,49,60,31,7,6,1,50
S01008436,619,128,24,104,161,93,49,33,59,25,16,12,4,55
S01008437,506,95,16,79,136,74,48,24,53,24,12,7,5,40
S01008438,335,72,14,58,111,38,36,5,23,13,10,8,2,27
S01008439,783,240,47,193,267,89,40,23,40,15,9,5,4,60
S01008440,688,202,31,171,243,75,52,14,32,9,10,4,6,51
S01008441,333,93,22,71,90,54,28,7,22,11,5,2,3,23
S01008442,519,144,28,116,175,53,54,12,32,12,14,9,5,23
S01008443,422,100,13,87,125,50,38,14,29,18,9,5,4,39
S01008444,479,95,36,59,128,70,33,20,47,30,15,7,8,41
S01008445,535,73,14,59,168,98,29,17,67,34,17,12,5,32
S01008446,726,153,19,134,222,64,45,14,29,10,5,5,0,184
S01008447,503,129,23,106,177,56,52,19,27,19,3,1,2,21
S01008448,578,88,16,72,136,111,64,30,49,36,12,8,4,52
S01008449,573,26,6,20,63,40,33,43,129,106,75,52,23,58
S01008450,384,9,1,8,37,36,23,35,96,77,31,17,14,40
S01008451,497,13,3,10,25,49,19,31,103,111,89,52,37,57
S01008452,433,8,4,4,37,37,22,30,101,99,36,24,12,63
S01008453,374,27,0,27,59,47,25,29,69,42,32,19,13,44
S01008454,674,11,2,9,77,82,30,46,156,119,73,61,12,80
S01008455,770,22,2,20,71,75,25,74,156,153,79,56,23,115
S01008456,747,12,0,12,79,72,35,71,154,153,115,65,50,56
S01008457,477,9,2,7,51,57,12,35,122,117,42,28,14,32
S01008458,747,29,3,26,117,116,41,79,143,113,47,30,17,62
S01008459,590,12,1,11,49,60,18,56,137,127,84,58,26,47
S01008460,552,8,1,7,38,51,17,47,125,131,89,61,28,46
S01008461,686,10,0,10,66,72,28,58,133,169,89,63,26,61
S01008462,457,5,2,3,35,57,16,33,108,116,63,34,29,24
S01008463,538,17,1,16,46,68,25,48,114,120,60,39,21,40
S01008464,637,29,4,25,105,143,28,70,103,91,27,16,11,41
S01008465,559,32,5,27,81,106,29,42,115,80,26,18,8,48
S01008466,564,21,2,19,64,85,23,58,119,103,28,13,15,63
S01008467,602,14,3,11,74,112,45,64,133,90,33,14,19,37
S01008468,454,9,1,8,43,71,22,46,98,69,33,27,6,63
S01008469,455,26,3,23,77,48,30,34,66,74,26,22,4,74
S01008470,549,18,2,16,49,45,24,51,104,144,61,43,18,53
S01008471,607,17,2,15,56,67,24,44,150,126,61,42,19,62
S01008472,508,16,2,14,63,65,37,47,88,84,45,33,12,63
S01008473,520,20,4,16,65,70,24,37,100,106,45,29,16,53
S01008474,584,20,2,18,63,83,18,62,119,132,39,20,19,48
S01008475,437,17,6,11,71,69,15,27,109,67,18,12,6,44
S01008476,524,33,4,29,78,78,26,47,89,106,41,33,8,26
S01008477,599,28,3,25,90,98,30,70,115,117,29,20,9,22
S01008478,568,27,2,25,99,97,25,45,104,70,48,31,17,53
S01008479,570,22,1,21,98,79,23,48,123,94,41,25,16,42
S01008480,480,33,3,30,88,65,14,33,74,65,33,25,8,75
S01008481,1351,46,7,39,144,133,125,158,238,261,173,160,13,73
S01008482,446,26,8,18,65,75,25,41,86,64,25,17,8,39
S01008483,463,19,1,18,64,73,34,35,92,71,19,14,5,56
S01008484,556,42,14,28,93,108,47,54,84,58,33,19,14,37
S01008485,753,45,14,31,173,147,53,60,105,60,21,12,9,89
S01008486,656,42,9,33,147,115,50,51,97,73,19,12,7,62
S01008487,642,127,22,105,168,89,41,43,54,34,12,6,6,74
S01008488,611,63,6,57,118,97,32,44,75,65,26,20,6,91
S01008489,494,36,6,30,73,98,28,31,71,64,32,18,14,61
S01008490,734,96,9,87,161,124,29,56,98,64,24,13,11,82
S01008491,777,98,7,91,137,107,32,33,94,59,28,19,9,189
S01008492,806,93,7,86,199,114,30,42,89,66,61,52,9,112
S01008493,608,47,7,40,121,102,26,28,90,68,23,17,6,103
S01008494,558,52,2,50,121,86,30,32,64,63,34,24,10,76
S01008495,841,96,3,93,174,122,22,55,90,62,45,27,18,175
S01008496,910,137,11,126,207,126,31,56,77,62,37,13,24,177
S01008497,738,110,7,103,167,103,23,42,95,60,28,16,12,110
S01008498,709,91,9,82,149,86,32,70,87,50,31,18,13,113
S01008499,919,127,11,116,177,112,36,54,79,70,38,22,16,226
S01008500,347,37,2,35,46,42,11,19,43,40,33,23,10,76
S01008501,553,131,6,125,135,45,9,23,28,27,26,20,6,129
S01008502,597,102,9,93,145,84,13,24,44,12,17,11,6,156
S01008503,728,141,7,134,233,76,27,32,55,25,11,5,6,128
S01008504,916,227,23,204,279,103,33,37,57,27,23,15,8,130
S01008505,571,136,17,119,182,54,29,24,41,22,9,2,7,74
S01008506,591,155,20,135,189,56,31,18,43,20,7,4,3,72
S01008507,780,145,11,134,215,70,28,24,43,20,12,9,3,223
S01008508,627,168,22,146,200,71,52,17,40,19,10,7,3,50
S01008509,730,196,27,169,240,85,47,26,43,22,11,6,5,60
S01008510,671,124,24,100,207,88,57,28,55,20,11,8,3,81
S01008511,626,166,25,141,177,69,58,22,37,25,13,11,2,59
S01008512,356,95,16,79,106,49,29,9,19,10,9,5,4,30
S01008513,465,140,30,110,147,48,32,8,39,8,6,4,2,37
S01008514,588,187,17,170,193,44,35,13,28,18,18,14,4,52
S01008515,522,159,18,141,159,54,34,16,38,9,9,3,6,44
S01008516,775,154,17,137,204,86,30,30,63,36,18,6,12,154
S01008517,681,139,11,128,192,72,24,19,32,13,10,5,5,180
S01008518,672,208,17,191,215,57,25,16,37,12,3,2,1,99
S01008519,564,185,21,164,184,49,34,6,35,10,11,7,4,50
S01008520,751,222,42,180,246,78,65,19,42,10,10,6,4,59
S01008521,640,212,29,183,205,69,43,14,29,11,9,7,2,48
S01008522,398,127,21,106,134,41,31,5,14,3,4,2,2,39
S01008523,701,231,42,189,239,77,43,13,32,10,8,6,2,48
S01008524,647,29,11,18,87,90,38,58,130,93,49,30,19,73
S01008525,500,20,2,18,78,75,20,45,105,79,32,20,12,46
S01008526,629,46,7,39,126,105,43,48,99,85,28,18,10,49
S01008527,545,41,9,32,126,103,23,45,85,58,16,13,3,48
S01008528,505,35,5,30,128,89,40,30,93,35,23,7,16,32
S01008529,532,32,11,21,111,97,35,43,92,57,24,12,12,41
S01008530,516,17,1,16,75,71,27,45,112,102,39,25,14,28
S01008531,547,25,4,21,75,88,31,45,114,104,40,30,10,25
S01008532,317,19,3,16,48,57,25,19,55,48,24,14,10,22
S01008533,360,18,2,16,116,77,15,21,48,25,24,20,4,16
S01008534,549,59,15,44,148,120,34,21,62,28,16,8,8,61
S01008535,543,96,17,79,157,97,49,15,33,26,11,5,6,59
S01008536,391,88,10,78,125,62,30,16,29,14,2,1,1,25
S01008537,508,121,18,103,169,76,30,15,42,9,7,4,3,39
S01008538,373,80,14,66,145,46,29,10,13,6,7,4,3,37
S01008539,613,157,24,133,196,84,42,18,40,20,9,6,3,47
S01008540,598,141,21,120,198,84,60,20,33,14,3,0,3,45
S01008541,618,119,14,105,200,116,38,12,44,24,11,8,3,54
S01008542,670,136,25,111,211,126,39,18,46,23,10,5,5,61
S01008543,542,88,15,73,174,86,43,34,39,25,11,8,3,42
S01008544,467,125,16,109,144,49,33,18,18,12,7,2,5,61
S01008545,626,175,29,146,195,73,58,14,30,10,11,7,4,60
S01008546,621,164,35,129,211,83,49,15,34,12,9,6,3,44
S01008547,786,100,14,86,211,129,68,56,87,56,31,19,12,48
S01008548,641,71,17,54,161,93,55,55,74,64,29,17,12,39
S01008549,736,63,14,49,167,116,77,69,99,68,31,22,9,46
S01008550,630,113,21,92,186,94,45,33,68,26,17,14,3,48
S01008551,771,96,12,84,190,145,80,44,90,54,22,15,7,50
S01008552,676,91,11,80,173,104,64,39,87,38,19,13,6,61
S01008553,411,39,7,32,77,74,37,28,53,56,17,13,4,30
S01008554,738,34,5,29,71,64,52,56,148,155,101,75,26,57
S01008555,755,33,4,29,101,85,38,48,148,142,94,68,26,66
S01008556,522,16,2,14,75,60,30,48,90,101,59,39,20,43
S01008557,584,17,3,14,74,60,28,60,124,122,61,43,18,38
S01008558,618,27,6,21,88,86,38,58,119,108,51,39,12,43
S01008559,495,18,4,14,63,64,30,52,93,101,36,27,9,38
S01008560,492,19,4,15,76,64,26,53,98,85,39,30,9,32
S01008561,472,26,5,21,75,71,32,33,98,75,18,11,7,44
S01008562,430,17,1,16,52,62,24,35,93,84,40,23,17,23
S01008563,612,32,6,26,88,66,30,53,129,113,51,36,15,50
S01008564,467,22,4,18,77,67,30,56,84,83,25,19,6,23
S01008565,653,19,5,14,91,102,41,57,113,127,55,35,20,48
S01008566,774,29,6,23,98,102,57,88,154,138,68,53,15,40
S01008567,541,28,4,24,87,65,38,50,101,88,42,34,8,42
S01008568,593,47,6,41,138,98,43,38,106,49,34,25,9,40
S01008569,492,33,0,33,38,29,27,35,88,104,94,53,41,44
S01008570,665,20,3,17,79,69,53,66,130,116,81,57,24,51
S01008571,492,27,4,23,71,73,36,32,113,81,24,16,8,35
S01008572,629,39,6,33,112,80,48,50,123,96,31,23,8,50
S01008573,606,93,14,79,129,99,67,50,61,37,21,19,2,49
S01008574,576,97,12,85,137,90,44,39,58,37,15,12,3,59
S01008575,594,124,25,99,158,90,59,29,50,14,17,14,3,53
S01008576,648,82,7,75,159,96,60,36,85,46,13,8,5,71
S01008577,575,94,10,84,172,82,55,26,56,30,19,14,5,41
S01008578,527,158,22,136,173,50,50,8,22,9,8,6,2,49
S01008579,506,111,13,98,154,58,63,20,28,17,16,14,2,39
S01008580,417,66,9,57,90,67,25,24,50,34,11,6,5,50
S01008581,672,37,4,33,108,92,34,57,138,106,38,18,20,62
S01008582,749,67,8,59,119,113,53,57,111,115,48,28,20,66
S01008583,519,47,2,45,83,62,35,41,75,73,28,22,6,75
S01008584,607,60,9,51,95,86,37,36,89,84,34,24,10,86
S01008585,433,26,2,24,75,53,23,38,81,64,29,21,8,44
S01008586,582,37,5,32,83,73,35,62,102,100,41,28,13,49
S01008587,718,155,23,132,152,70,45,23,32,11,29,26,3,201
S01008588,539,129,6,123,161,46,28,17,32,17,14,8,6,95
S01008589,255,54,7,47,66,47,14,10,27,8,7,7,0,22
S01008590,511,116,18,98,140,66,23,12,39,11,8,5,3,96
S01008591,627,130,11,119,157,52,41,29,40,17,24,20,4,137
S01008592,534,67,5,62,113,61,34,30,62,42,17,13,4,108
S01008593,544,193,29,164,160,39,51,13,18,7,12,10,2,51
S01008594,808,255,27,228,186,64,58,8,36,18,17,10,7,166
S01008595,661,64,8,56,115,88,28,49,95,97,49,39,10,76
S01008596,674,55,1,54,90,79,31,49,79,95,56,40,16,140
S01008597,638,110,20,90,175,108,53,28,64,41,9,6,3,50
S01008598,706,82,3,79,114,55,28,23,54,27,20,18,2,303
S01008599,754,181,21,160,166,53,40,18,41,14,12,7,5,229
S01008600,597,144,18,126,116,39,60,18,28,13,30,21,9,149
S01008601,2442,85,10,75,91,36,19,18,48,18,20,17,3,2107
S01008602,586,79,9,70,88,35,25,14,35,22,20,15,5,268
S01008603,1041,134,9,125,150,61,31,24,59,37,35,21,14,510
S01008604,798,160,18,142,145,43,55,24,37,23,17,11,6,294
S01008605,609,139,16,123,128,48,16,17,30,14,10,1,9,207
S01008606,573,168,19,149,159,44,37,16,31,15,6,2,4,97
S01008607,428,168,18,150,125,30,29,6,18,10,12,5,7,30
S01008608,514,164,11,153,163,47,32,14,16,7,5,4,1,66
S01008609,609,171,21,150,178,62,59,14,33,13,11,5,6,68
S01008610,570,143,17,126,137,48,26,12,24,10,7,6,1,163
S01008611,1286,173,9,164,179,84,30,21,39,24,25,17,8,711
S01008612,713,110,4,106,108,45,26,18,43,18,22,15,7,323
S01008613,627,134,8,126,129,47,16,10,31,20,15,10,5,225
S01008614,624,102,7,95,75,21,17,15,19,21,16,9,7,338
S01008615,739,122,4,118,110,25,21,9,31,13,14,13,1,394
S01008616,671,83,2,81,91,22,22,7,18,9,9,7,2,410
S01008617,735,79,7,72,95,25,23,13,11,4,5,3,2,480
S01008618,669,84,6,78,69,26,11,8,32,6,5,3,2,428
S01008619,474,64,6,58,82,17,17,12,26,8,8,7,1,240
S01008620,756,105,9,96,99,37,23,16,24,14,9,7,2,429
S01008621,699,80,3,77,83,30,30,13,22,9,10,5,5,422
S01008622,456,84,8,76,85,31,16,14,24,14,3,0,3,185
S01008623,800,157,17,140,132,30,44,5,29,15,15,10,5,373
S01008624,486,144,14,130,139,47,61,20,19,19,9,7,2,28
S01008625,417,161,29,132,131,28,28,3,14,9,10,6,4,33
S01008626,684,224,22,202,189,63,39,19,29,19,11,8,3,91
S01008627,475,147,19,128,161,35,36,7,21,8,11,6,5,49
S01008628,491,115,7,108,151,35,28,9,21,13,15,11,4,104
S01008629,438,102,10,92,124,48,12,9,34,16,6,3,3,87
S01008630,460,76,10,66,115,39,24,6,24,10,8,5,3,158
S01008631,695,171,15,156,191,68,36,19,42,23,15,4,11,130
S01008632,780,146,9,137,201,63,34,20,65,45,114,106,8,92
S01008633,642,188,35,153,192,62,40,9,26,11,22,15,7,92
S01008634,571,153,21,132,141,34,43,7,24,6,12,10,2,151
S01008635,681,178,16,162,159,41,55,11,30,10,20,12,8,177
S01008636,683,161,21,140,173,56,30,12,28,19,7,5,2,197
S01008637,527,136,12,124,148,45,40,11,25,13,8,6,2,101
S01008638,649,102,9,93,122,53,34,35,51,32,12,10,2,208
S01008639,765,183,14,169,185,76,44,26,43,21,21,14,7,166
S01008640,687,155,6,149,145,47,27,19,43,16,6,1,5,229
S01008641,765,133,8,125,143,49,21,19,55,14,12,8,4,319
S01008642,806,206,18,188,217,63,26,16,34,18,2,1,1,224
S01008643,590,152,11,141,169,50,33,20,34,10,12,6,6,110
S01008644,644,95,13,82,164,48,28,23,36,24,20,13,7,206
S01008645,690,116,13,103,139,61,23,22,41,34,19,13,6,235
S01008646,707,136,12,124,180,69,27,33,70,31,12,8,4,149
S01008647,537,117,8,109,135,49,20,21,41,30,8,3,5,116
S01008648,548,106,8,98,111,58,14,32,53,44,9,7,2,121
S01008649,792,123,14,109,201,103,14,53,81,66,21,13,8,130
S01008650,693,133,10,123,143,95,19,36,76,39,8,8,0,144
S01008651,930,119,9,110,133,71,30,33,52,48,38,30,8,406
S01008652,538,69,4,65,105,58,21,35,85,49,27,15,12,89
S01008653,614,82,3,79,108,52,15,43,71,53,39,30,9,151
S01008654,871,132,8,124,187,95,26,45,89,52,37,22,15,208
S01008655,732,151,7,144,142,83,29,39,44,40,18,17,1,186
S01008656,591,66,2,64,112,69,22,30,86,49,35,20,15,122
S01008657,670,81,13,68,130,72,26,35,40,48,34,28,6,204
S01008658,1022,103,11,92,156,90,33,54,84,70,57,27,30,375
S01008659,773,73,7,66,122,49,34,43,66,40,29,17,12,317
S01008660,866,152,15,137,149,53,24,38,51,25,34,18,16,340
S01008661,916,68,5,63,112,76,29,47,72,58,32,21,11,422
S01008662,726,55,1,54,68,26,15,29,41,21,22,15,7,449
S01008663,774,74,4,70,122,70,35,24,40,54,28,18,10,327
S01008664,653,111,6,105,138,50,24,25,44,37,21,12,9,203
S01008665,1099,117,8,109,195,66,49,52,65,66,50,36,14,439
S01008666,925,91,5,86,125,45,19,22,37,17,11,6,5,558
S01008667,893,99,11,88,111,42,20,20,43,34,18,9,9,506
S01008668,578,80,2,78,78,40,19,15,24,11,5,3,2,306
S01008669,541,20,1,19,38,19,9,8,23,10,11,9,2,403
S01008670,822,44,3,41,59,34,18,16,26,12,15,9,6,598
S01008671,717,52,1,51,65,28,13,17,25,21,17,9,8,479
S01008672,620,74,5,69,66,44,12,13,40,26,10,7,3,335
S01008673,967,106,10,96,137,61,39,18,59,32,30,18,12,485
S01008674,911,63,1,62,106,41,27,24,42,44,25,10,15,539
S01008675,665,93,15,78,133,63,37,23,58,47,36,22,14,175
S01008676,722,100,4,96,168,45,39,23,37,33,19,12,7,258
S01008677,768,85,4,81,145,50,30,33,69,46,20,15,5,290
S01008678,1154,67,8,59,89,28,30,23,51,39,33,25,8,794
S01008679,1078,59,7,52,102,52,34,37,86,68,42,27,15,598
S01008680,590,53,2,51,52,44,17,20,39,32,32,23,9,301
S01008681,870,66,5,61,91,50,24,35,55,49,42,31,11,458
S01008682,690,80,5,75,107,47,28,32,61,50,35,28,7,250
S01008683,1327,41,2,39,111,67,35,63,118,115,99,65,34,678
S01008684,830,76,12,64,113,65,39,37,104,96,81,55,26,219
S01008685,920,77,6,71,136,74,31,48,99,64,44,18,26,347
S01008686,786,64,6,58,148,92,44,62,106,99,59,47,12,112
S01008687,601,88,11,77,154,66,19,26,61,50,22,14,8,115
S01008688,737,116,16,100,194,91,41,43,65,54,37,23,14,96
S01008689,743,89,12,77,199,79,32,64,101,67,23,12,11,89
S01008690,870,142,15,127,230,123,48,54,86,50,27,15,12,110
S01008691,957,107,15,92,289,149,50,76,94,61,32,14,18,99
S01008692,590,59,8,51,152,89,22,41,76,53,26,15,11,72
S01008693,353,24,2,22,67,66,36,33,61,35,10,6,4,21
S01008694,855,121,10,111,239,123,37,52,99,60,23,10,13,101
S01008695,545,90,9,81,182,73,25,16,52,25,21,11,10,61
S01008696,515,88,20,68,172,80,40,26,37,22,12,7,5,38
S01008697,804,137,23,114,238,129,68,38,67,46,13,11,2,68
S01008698,382,53,8,45,95,60,34,25,56,19,7,5,2,33
S01008699,639,50,9,41,124,104,40,52,108,75,43,31,12,43
S01008700,407,73,19,54,119,63,37,10,27,17,18,15,3,43
S01008701,296,10,0,10,25,30,13,16,68,59,54,35,19,21
S01008702,489,47,6,41,80,62,26,25,69,49,38,24,14,93
S01008703,728,32,1,31,64,45,43,48,126,163,122,95,27,85
S01008704,505,27,4,23,78,57,37,34,101,83,54,40,14,34
S01008705,360,10,1,9,36,28,22,35,74,85,36,27,9,34
S01008706,387,12,1,11,38,36,20,19,95,80,51,37,14,36
S01008707,588,10,2,8,48,53,27,45,136,120,98,78,20,51
S01008708,679,15,1,14,55,62,26,61,166,141,100,64,36,53
S01008709,525,10,0,10,55,51,27,50,115,120,63,47,16,34
S01008710,354,10,1,9,41,35,18,35,68,55,49,34,15,43
S01008711,514,10,0,10,60,45,18,47,114,142,43,35,8,35
S01008712,775,29,4,25,54,75,44,85,163,177,99,71,28,49
S01008713,438,7,1,6,32,49,28,32,118,90,55,35,20,27
S01008714,417,22,3,19,61,58,28,30,79,79,41,25,16,19
S01008715,548,17,4,13,72,77,33,43,109,123,36,26,10,38
S01008716,364,7,2,5,60,56,34,22,77,66,22,12,10,20
S01008717,327,17,2,15,48,59,26,26,74,32,21,12,9,24
S01008718,391,27,6,21,58,77,48,29,66,48,15,9,6,23
S01008719,757,31,3,28,118,107,91,77,139,96,47,36,11,51
S01008720,408,25,1,24,60,65,37,33,70,56,24,16,8,38
S01008721,621,66,10,56,167,119,58,49,64,42,10,7,3,46
S01008722,749,101,25,76,192,129,92,39,68,57,16,12,4,55
S01008723,530,67,12,55,119,100,47,29,46,25,10,7,3,87
S01008724,646,107,20,87,211,85,71,31,54,24,18,12,6,45
S01008725,559,90,12,78,166,69,51,20,52,50,20,12,8,41
S01008726,414,104,17,87,151,39,33,12,24,14,4,1,3,33
S01008727,777,150,18,132,249,84,56,49,64,38,21,16,5,66
S01008728,361,34,2,32,85,49,25,17,65,40,23,15,8,23
S01008729,514,99,17,82,177,53,43,17,44,24,14,12,2,43
S01008730,626,91,14,77,194,67,50,36,54,41,44,26,18,49
S01008731,323,25,9,16,68,46,28,22,57,35,25,17,8,17
S01008732,467,31,3,28,106,66,38,37,69,57,33,19,14,30
S01008733,666,78,11,67,164,120,33,43,101,84,12,3,9,31
S01008734,410,58,6,52,130,53,35,15,47,22,21,14,7,29
S01008735,710,119,18,101,207,110,80,33,61,23,15,10,5,62
S01008736,505,60,13,47,129,68,47,41,59,29,19,15,4,53
S01008737,561,61,8,53,148,108,52,28,67,34,16,10,6,47
S01008738,540,92,17,75,134,102,57,33,43,22,18,14,4,39
S01008739,428,31,6,25,73,88,44,39,71,34,6,4,2,42
S01008740,424,28,6,22,96,101,39,33,54,27,12,9,3,34
S01008741,676,44,10,34,141,159,63,52,97,53,13,8,5,54
S01008742,337,29,4,25,86,61,26,16,44,42,12,11,1,21
S01008743,697,48,5,43,143,96,38,51,126,109,40,25,15,46
S01008744,751,66,14,52,141,135,47,51,130,90,32,17,15,59
S01008745,346,65,4,61,85,59,18,16,43,22,9,5,4,29
S01008746,819,53,9,44,128,114,41,60,142,132,61,42,19,88
S01008747,361,48,7,41,87,66,40,20,39,24,7,6,1,30
S01008748,480,58,6,52,126,103,44,28,55,31,10,9,1,25
S01008749,728,65,7,58,190,124,83,47,78,60,32,25,7,49
S01008750,515,56,8,48,115,117,48,32,68,36,9,5,4,34
S01008751,431,26,3,23,90,74,40,31,57,58,24,9,15,31
S01008752,582,9,3,6,83,97,33,47,113,96,70,47,23,34
S01008753,402,15,0,15,68,55,26,32,76,88,24,11,13,18
S01008754,515,36,3,33,101,83,30,42,88,81,20,13,7,34
S01008755,750,36,5,31,106,105,46,77,121,148,59,32,27,52
S01008756,567,22,2,20,73,75,26,52,125,108,44,25,19,42
S01008757,491,12,1,11,40,47,32,51,100,137,58,33,25,14
S01008758,611,21,4,17,73,92,47,49,121,111,53,34,19,44
S01008759,414,14,1,13,56,57,28,34,92,74,36,22,14,23
S01008760,723,27,5,22,74,81,41,63,153,156,82,57,25,46
S01008761,562,40,2,38,115,67,43,46,72,75,46,39,7,58
S01008762,462,41,7,34,104,83,33,31,69,56,13,9,4,32
S01008763,719,112,10,102,202,132,46,37,87,66,14,7,7,23
S01008764,547,86,10,76,170,60,41,35,63,34,16,11,5,42
S01008765,653,99,13,86,197,83,53,42,73,44,19,13,6,43
S01008766,750,92,16,76,179,121,86,56,78,60,25,15,10,53
S01008767,420,34,10,24,95,85,32,32,43,50,8,3,5,41
S01008768,390,42,6,36,97,55,29,32,49,41,18,13,5,27
S01008769,613,152,18,134,202,89,37,26,33,16,14,7,7,44
S01008770,722,166,29,137,195,79,58,34,48,38,26,18,8,78
S01008771,620,137,18,119,165,70,46,28,64,30,29,20,9,51
S01008772,593,104,11,93,164,80,42,36,49,55,23,15,8,40
S01008773,856,95,19,76,226,127,47,66,127,84,34,18,16,50
S01008774,769,64,7,57,155,103,51,74,112,97,54,30,24,59
S01008775,391,54,5,49,111,45,27,36,30,42,18,12,6,28
S01008776,701,56,4,52,140,89,34,54,116,93,58,41,17,61
S01008777,901,65,8,57,161,94,56,87,155,161,70,45,25,52
S01008778,995,178,10,168,289,99,69,45,116,67,47,28,19,85
S01008779,655,145,20,125,220,70,38,32,51,30,14,5,9,55
S01008780,525,79,6,73,168,52,34,27,48,52,11,9,2,54
S01008781,776,114,14,100,197,83,31,77,93,87,40,21,19,54
S01008782,651,125,10,115,183,71,40,51,66,38,27,19,8,50
S01008783,364,66,6,60,126,38,20,20,39,30,11,7,4,14
S01008784,394,66,8,58,120,40,21,29,56,25,15,8,7,22
S01008785,685,58,6,52,110,64,34,70,108,112,69,50,19,60
S01008786,836,123,18,105,249,87,42,72,82,74,48,29,19,59
S01008787,268,9,0,9,24,21,9,20,59,64,36,21,15,26
S01008788,604,104,14,90,184,73,29,50,67,46,13,8,5,38
S01008789,486,37,4,33,86,66,26,49,74,90,24,17,7,34
S01008790,553,50,4,46,107,61,35,40,74,59,46,31,15,81
S01008791,767,90,7,83,154,86,53,76,77,93,40,24,16,98
S01008792,651,74,9,65,167,83,41,45,88,66,37,26,11,50
S01008793,345,21,2,19,58,41,17,36,47,44,38,24,14,43
S01008794,637,59,6,53,124,92,27,50,116,92,36,19,17,41
S01008795,963,110,11,99,238,117,51,78,122,91,42,29,13,114
S01008796,892,65,4,61,186,109,45,68,140,131,56,41,15,92
S01008797,834,89,6,83,209,105,38,60,121,76,29,21,8,107
S01008798,678,70,7,63,150,94,32,66,104,61,32,13,19,69
S01008799,555,41,2,39,100,58,26,58,75,71,39,30,9,87
S01008800,952,95,8,87,261,120,55,74,126,96,30,13,17,95
S01008801,855,93,9,84,203,112,36,91,91,86,32,19,13,111
S01008802,861,81,6,75,195,90,45,78,120,87,42,25,17,123
S01008803,831,91,14,77,178,92,44,62,118,99,57,36,21,90
S01008804,489,44,7,37,98,59,26,40,59,56,27,23,4,80
S01008805,570,74,3,71,96,73,19,36,62,35,21,14,7,154
S01008806,897,138,15,123,235,104,46,66,84,49,34,24,10,141
S01008807,712,87,10,77,201,92,32,56,82,57,29,19,10,76
S01008808,568,117,5,112,139,50,51,30,54,42,23,12,11,62
S01008809,541,115,23,92,128,40,61,23,42,16,17,9,8,99
S01008810,632,127,15,112,192,65,30,28,36,41,12,9,3,101
S01008811,765,134,21,113,182,64,49,42,54,50,24,14,10,166
S01008812,424,85,7,78,117,32,23,12,38,24,5,3,2,88
S01008813,793,65,7,58,162,85,54,68,135,74,63,46,17,87
S01008814,696,88,10,78,166,81,48,67,69,47,29,19,10,101
S01008815,776,85,8,77,205,87,40,49,70,100,42,24,18,98
S01008816,424,70,9,61,110,64,15,28,43,29,35,27,8,30
S01008817,642,87,7,80,135,91,32,64,84,77,33,20,13,39
S01008818,619,86,5,81,186,95,40,46,66,44,12,10,2,44
S01008819,571,114,13,101,194,73,31,27,50,36,14,8,6,32
S01008820,910,87,8,79,238,106,53,57,131,100,76,51,25,62
S01008821,524,122,16,106,170,47,33,21,37,26,20,14,6,48
S01008822,536,127,19,108,180,52,44,18,40,14,17,12,5,44
S01008823,453,114,26,88,141,46,49,12,35,15,11,6,5,30
S01008824,749,167,28,139,268,91,49,29,69,22,17,8,9,37
S01008825,451,126,24,102,136,62,30,22,38,14,5,5,0,18
S01008826,536,96,15,81,147,72,42,36,50,40,22,15,7,31
S01008827,491,168,22,146,153,50,35,14,22,5,9,6,3,35
S01008828,666,127,18,109,221,90,57,31,56,18,16,11,5,50
S01008829,493,80,14,66,137,52,33,21,49,45,17,12,5,59
S01008830,476,119,18,101,161,62,32,12,28,14,7,2,5,41
S01008831,552,143,19,124,161,76,48,20,26,18,11,6,5,49
S01008832,535,129,26,103,141,62,53,13,44,18,28,14,14,47
S01008833,732,215,26,189,212,71,36,30,44,33,10,7,3,81
S01008834,837,192,33,159,256,124,76,25,51,24,24,20,4,65
S01008835,608,103,23,80,166,102,32,34,69,49,13,7,6,40
S01008836,562,77,11,66,132,71,26,47,65,72,22,18,4,50
S01008837,918,222,29,193,264,118,43,43,70,55,37,26,11,66
S01008838,881,159,19,140,267,135,40,59,72,45,22,17,5,82
S01008839,876,191,23,168,230,121,64,41,71,52,14,10,4,92
S01008840,871,173,20,153,254,113,49,31,64,37,16,6,10,134
S01008841,475,84,8,76,130,63,39,24,52,29,8,6,2,46
S01008842,771,135,12,123,184,71,45,35,95,48,31,25,6,127
S01008843,886,177,14,163,201,90,46,36,73,34,32,27,5,197
S01008844,607,138,9,129,168,57,27,15,48,34,27,18,9,93
S01008845,778,177,22,155,173,53,31,31,32,20,14,11,3,247
S01008846,719,144,10,134,163,68,63,23,39,30,15,9,6,174
S01008847,523,124,18,106,122,33,38,16,30,10,5,1,4,145
S01008848,683,175,22,153,164,58,37,11,25,19,27,19,8,167
S01008849,630,174,20,154,165,40,51,20,27,20,5,3,2,128
S01008850,699,204,33,171,172,48,47,20,11,8,12,8,4,177
S01008851,869,214,26,188,266,62,50,38,59,45,20,5,15,115
S01008852,816,256,33,223,228,58,67,13,28,19,14,9,5,133
S01008853,599,170,20,150,157,43,36,22,31,12,12,6,6,116
S01008854,821,221,38,183,220,57,58,15,21,14,22,12,10,193
S01008855,949,295,38,257,309,68,58,23,46,15,17,9,8,118
S01008856,494,120,17,103,151,52,26,19,31,20,10,7,3,65
S01008857,655,186,25,161,197,62,38,27,49,24,13,7,6,59
S01008858,467,136,19,117,167,43,33,12,22,13,4,2,2,37
S01008859,902,256,27,229,284,102,63,38,38,28,17,8,9,76
S01008860,756,180,13,167,231,83,42,26,60,30,17,8,9,87
S01008861,583,193,26,167,183,39,60,7,24,11,7,5,2,59
S01008862,794,253,34,219,229,83,52,34,33,30,11,7,4,69
S01008863,592,186,33,153,198,64,32,15,32,21,6,3,3,38
S01008864,778,157,12,145,186,58,28,16,20,13,8,3,5,292
S01008865,666,173,12,161,213,73,26,26,64,20,9,7,2,62
S01008866,670,236,24,212,209,71,47,13,30,17,10,2,8,37
S01008867,640,215,31,184,232,52,60,13,22,10,9,5,4,27
S01008868,716,161,23,138,190,45,38,43,39,37,10,4,6,153
S01008869,860,257,26,231,269,79,54,30,42,28,14,4,10,87
S01008870,638,212,30,182,203,48,54,23,34,13,15,9,6,36
S01008871,933,247,45,202,247,75,55,19,42,23,15,6,9,210
S01008872,743,183,15,168,198,52,43,19,25,23,14,13,1,186
S01008873,533,149,27,122,189,50,50,7,22,12,10,8,2,44
S01008874,702,176,22,154,216,72,43,24,48,32,16,10,6,75
S01008875,662,126,15,111,191,79,38,44,74,26,6,3,3,78
S01008876,392,76,8,68,116,65,33,10,32,13,11,5,6,36
S01008877,402,103,13,90,120,67,25,15,23,11,4,2,2,34
S01008878,639,80,16,64,135,120,58,29,90,64,23,13,10,40
S01008879,611,98,11,87,156,107,46,32,72,55,15,7,8,30
S01008880,445,88,17,71,132,83,24,21,28,20,13,9,4,36
S01008881,395,118,28,90,112,46,37,11,14,19,15,9,6,23
S01008882,764,262,44,218,220,82,44,13,24,16,7,6,1,96
S01008883,589,198,47,151,182,57,53,6,23,9,12,9,3,49
S01008884,462,134,20,114,164,46,34,7,15,5,12,8,4,45
S01008885,596,173,29,144,182,68,54,10,37,6,14,5,9,52
S01008886,637,154,16,138,192,82,39,24,40,14,13,7,6,79
S01008887,546,111,13,98,171,69,33,26,43,33,9,6,3,51
S01008888,511,143,23,120,169,71,27,11,25,10,11,4,7,44
S01008889,417,82,16,66,119,57,39,24,32,27,13,7,6,24
S01008890,497,78,7,71,149,89,43,33,31,25,7,3,4,42
S01008891,532,123,22,101,165,83,44,22,41,11,7,5,2,36
S01008892,684,152,27,125,198,103,44,24,68,29,20,10,10,46
S01008893,623,162,22,140,204,71,65,19,30,13,13,11,2,46
S01008894,620,157,25,132,226,63,56,12,36,14,7,4,3,49
S01008895,483,141,26,115,154,75,40,12,18,9,3,1,2,31
S01008896,374,110,28,82,131,46,17,11,21,3,8,5,3,27
S01008897,462,119,16,103,139,66,38,17,33,9,18,14,4,23
S01008898,598,152,32,120,160,83,67,22,35,14,12,7,5,53
S01008899,590,18,3,15,53,69,39,52,132,139,40,21,19,48
S01008900,713,44,8,36,105,96,41,78,132,131,36,24,12,50
S01008901,601,37,10,27,93,84,47,42,99,113,46,31,15,40
S01008902,753,47,9,38,132,92,39,54,131,127,75,60,15,56
S01008903,697,22,8,14,117,109,39,72,142,130,33,27,6,33
S01008904,780,24,3,21,83,65,41,70,142,157,71,51,20,127
S01008905,815,15,4,11,90,75,33,50,183,186,89,57,32,94
S01008906,608,19,4,15,65,63,32,56,138,110,55,27,28,70
S01008907,410,8,1,7,28,23,17,35,86,105,58,47,11,50
S01008908,681,45,7,38,93,94,51,64,85,117,74,53,21,58
S01008909,610,27,5,22,89,91,32,64,118,120,30,11,19,39
S01008910,349,29,3,26,68,52,26,28,50,54,12,8,4,30
S01008911,728,158,21,137,204,89,55,34,65,47,17,6,11,59
S01008912,592,93,10,83,164,97,47,42,64,40,13,6,7,32
S01008913,494,86,8,78,105,70,35,34,62,44,16,9,7,42
S01008914,630,44,7,37,119,110,46,48,100,102,17,13,4,44
S01008915,411,52,8,44,113,57,35,19,56,24,10,6,4,45
S01008916,778,26,3,23,104,105,43,61,180,153,64,40,24,42
S01008917,532,19,2,17,54,70,29,52,100,117,60,41,19,31
S01008918,415,6,1,5,32,28,27,38,83,103,63,43,20,35
S01008919,393,12,0,12,39,39,15,40,70,76,66,43,23,36
S01008920,936,157,19,138,261,130,68,50,83,58,39,25,14,90
S01008921,543,14,2,12,45,57,28,51,115,121,76,46,30,36
S01008922,587,22,6,16,75,86,42,50,123,98,54,35,19,37
S01008923,544,19,2,17,64,80,40,43,109,116,40,22,18,33
S01008924,675,17,7,10,52,70,36,57,150,141,81,47,34,71
S01008925,496,11,1,10,75,75,34,52,84,90,32,17,15,43
S01008926,462,27,3,24,68,92,33,35,83,76,25,18,7,23
S01008927,651,54,11,43,139,120,30,45,90,97,22,14,8,54
S01008928,545,45,7,38,90,50,29,48,81,87,24,9,15,91
S01008929,611,10,2,8,45,36,20,46,130,152,125,73,52,47
S01008930,634,13,1,12,48,52,27,54,134,174,85,50,35,47
S01008931,547,1,0,1,62,53,20,39,123,141,63,45,18,45
S01008932,662,61,8,53,123,96,40,59,109,73,36,27,9,65
S01008933,491,16,2,14,48,51,18,41,88,111,75,44,31,43
S01008934,567,37,6,31,83,58,36,36,110,107,53,40,13,47
S01008935,613,76,15,61,158,128,35,41,65,47,17,8,9,46
S01008936,269,64,12,52,87,38,29,14,15,3,2,1,1,17
S01008937,599,80,13,67,165,112,44,40,59,43,16,10,6,40
S01008938,478,77,7,70,136,76,45,28,45,19,6,3,3,46
S01008939,548,63,13,50,138,112,52,34,54,23,12,4,8,60
S01008940,417,116,19,97,143,56,29,8,17,9,10,7,3,29
S01008941,564,166,30,136,191,64,51,12,32,13,4,1,3,31
S01008942,508,112,15,97,151,88,42,16,34,13,12,5,7,40
S01008943,592,154,33,121,187,79,54,10,34,9,17,6,11,48
S01008944,686,177,36,141,217,94,70,19,32,15,11,7,4,51
S01008945,558,141,26,115,191,70,57,14,27,13,10,6,4,35
S01008946,636,156,26,130,204,75,62,22,44,16,14,7,7,43
S01008947,681,172,28,144,204,89,53,27,46,14,18,13,5,58
S01008948,524,107,23,84,144,78,55,28,33,25,12,8,4,42
S01008949,653,38,10,28,131,122,44,48,109,91,21,17,4,49
S01008950,651,48,9,39,128,99,51,37,127,75,27,17,10,59
S01008951,623,34,10,24,103,100,27,64,116,101,42,30,12,36
S01008952,609,29,4,25,77,93,37,42,147,108,48,31,17,28
S01008953,624,39,8,31,111,91,46,45,114,99,41,29,12,38
S01008954,577,42,7,35,105,79,42,47,104,83,38,23,15,37
S01008955,476,78,20,58,125,76,44,23,50,29,11,9,2,40
S01008956,692,90,18,72,170,137,41,44,95,53,16,8,8,46
S01008957,738,87,16,71,183,128,49,46,102,57,35,25,10,51
S01008958,516,46,3,43,123,98,31,30,69,54,33,30,3,32
S01008959,652,54,7,47,145,145,42,47,94,66,19,15,4,40
S01008960,661,174,30,144,211,77,47,23,47,14,11,7,4,57
S01008961,570,81,9,72,151,106,43,25,63,34,18,14,4,49
S01008962,481,74,15,59,143,100,34,22,47,28,8,3,5,25
S01008963,571,83,19,64,187,109,41,34,48,21,10,8,2,38
S01008964,353,78,17,61,85,65,24,18,30,9,5,3,2,39
S01008965,516,106,16,90,158,85,46,25,33,24,8,7,1,31
S01008966,411,60,9,51,109,97,29,23,34,18,7,5,2,34
S01008967,711,138,17,121,226,118,52,33,62,31,17,13,4,34
S01008968,707,146,25,121,196,133,61,28,51,20,14,6,8,58
S01008969,766,132,19,113,202,142,47,53,75,57,15,9,6,43
S01008970,752,173,22,151,257,106,51,21,57,23,16,15,1,48
S01008971,522,143,20,123,180,68,35,16,30,9,6,1,5,35
S01008972,530,163,25,138,171,76,29,11,20,10,9,7,2,41
S01008973,585,111,19,92,184,97,53,18,36,30,29,24,5,27
S01008974,546,85,17,68,166,95,28,32,57,34,17,10,7,32
S01008975,453,60,4,56,105,77,28,29,62,42,13,7,6,37
S01008976,383,80,11,69,121,57,26,12,31,21,10,6,4,25
S01008977,446,90,23,67,123,102,29,18,28,18,9,6,3,29
S01008978,439,33,7,26,97,93,28,28,73,41,4,2,2,42
S01008979,551,63,8,55,123,105,39,40,60,37,22,15,7,62
S01008980,592,45,4,41,125,110,38,49,84,62,23,15,8,56
S01008981,479,73,9,64,112,99,43,22,71,31,9,4,5,19
S01008982,596,40,6,34,102,135,32,45,90,65,27,19,8,60
S01008983,522,31,7,24,102,109,26,60,77,67,15,12,3,35
S01008984,366,31,7,24,74,78,19,36,49,44,13,7,6,22
S01008985,525,41,7,34,88,124,36,41,88,59,12,7,5,36
S01008986,534,40,5,35,137,108,49,44,77,34,13,7,6,32
S01008987,611,43,5,38,131,165,52,37,84,47,11,4,7,41
S01008988,725,92,15,77,152,145,43,53,94,60,33,21,12,53
S01008989,540,69,6,63,137,118,33,40,50,44,18,10,8,31
S01008990,625,74,4,70,155,152,37,48,60,56,18,10,8,25
S01008991,736,102,15,87,215,124,51,54,73,28,13,8,5,76
S01008992,431,37,3,34,93,87,29,33,58,38,17,11,6,39
S01008993,799,129,38,91,205,133,89,51,88,41,18,10,8,45
S01008994,577,42,5,37,87,77,48,53,95,105,30,22,8,40
S01008995,657,129,21,108,205,92,39,35,67,24,15,7,8,51
S01008996,424,27,6,21,72,59,25,40,86,72,16,9,7,27
S01008997,734,103,23,80,160,113,65,60,96,75,22,13,9,40
S01008998,454,22,0,22,65,57,21,48,97,77,28,16,12,39
S01008999,610,55,11,44,122,99,38,43,108,95,21,10,11,29
S01009000,691,107,19,88,184,119,69,44,81,45,11,6,5,31
S01009001,604,93,15,78,160,111,47,41,65,32,16,11,5,39
S01009002,593,114,40,74,183,78,44,27,67,35,17,7,10,28
S01009003,705,155,16,139,220,90,54,28,62,37,7,5,2,52
S01009004,508,41,9,32,105,117,44,44,72,56,4,3,1,25
S01009005,554,52,7,45,126,100,38,58,85,46,11,7,4,38
S01009006,546,54,7,47,114,92,31,38,77,69,25,19,6,46
S01009007,491,26,1,25,91,94,28,48,79,72,16,10,6,37
S01009008,681,127,26,101,192,118,41,32,82,46,18,9,9,25
S01009009,327,13,1,12,59,55,24,32,63,51,17,10,7,13
S01009010,798,103,27,76,217,143,40,58,93,67,9,6,3,68
S01009011,675,98,19,79,187,140,42,33,75,40,12,1,11,48
S01009012,581,76,11,65,176,106,47,33,60,34,8,4,4,41
S01009013,700,94,21,73,194,114,46,39,78,47,22,9,13,66
S01009014,446,13,7,6,77,39,66,48,108,64,13,5,8,18
S01009015,459,20,6,14,110,46,60,44,80,67,13,6,7,19
S01009016,367,17,7,10,92,33,46,41,58,56,12,3,9,12
S01009017,447,20,5,15,83,48,51,53,85,70,28,14,14,9
S01009018,559,26,6,20,108,49,74,62,90,95,14,7,7,41
S01009019,391,17,5,12,96,49,36,47,50,70,16,3,13,10
S01009020,598,41,7,34,131,80,50,55,107,90,26,10,16,18
S01009021,560,34,7,27,139,44,93,44,91,76,13,9,4,26
S01009022,675,34,6,28,164,67,95,57,115,91,18,8,10,34
S01009023,700,40,5,35,133,65,131,57,109,106,21,9,12,38
S01009024,710,34,8,26,150,67,111,65,134,117,15,7,8,17
S01009025,669,44,13,31,162,60,89,62,115,80,30,16,14,27
S01009026,679,50,9,41,137,83,78,49,110,106,29,14,15,37
S01009027,565,41,15,26,132,58,88,52,83,65,21,9,12,25
S01009028,374,22,3,19,86,39,58,40,45,61,6,3,3,17
S01009029,457,33,5,28,109,37,67,45,62,65,21,8,13,18
S01009030,540,19,4,15,108,67,63,46,89,95,21,10,11,32
S01009031,566,16,4,12,117,69,59,62,122,83,14,9,5,24
S01009032,484,29,5,24,100,60,53,42,86,84,12,5,7,18
S01009033,565,25,8,17,115,58,68,50,110,96,13,5,8,30
S01009034,496,33,8,25,112,61,42,57,78,82,10,2,8,21
S01009035,669,42,13,29,161,100,68,57,99,88,25,15,10,29
S01009036,752,45,10,35,171,102,69,75,115,105,26,15,11,44
S01009037,660,36,8,28,151,102,65,61,97,91,16,8,8,41
S01009038,793,49,12,37,170,98,62,69,131,120,37,23,14,57
S01009039,500,20,6,14,83,50,44,55,94,97,25,11,14,32
S01009040,467,22,3,19,90,59,40,30,87,73,19,10,9,47
S01009041,638,70,16,54,145,77,71,69,71,78,26,11,15,31
S01009042,620,34,8,26,114,84,43,64,108,109,27,10,17,37
S01009043,478,40,2,38,82,57,33,38,96,89,26,14,12,17
S01009044,563,38,9,29,117,70,47,54,109,96,13,7,6,19
S01009045,490,33,4,29,94,75,47,41,72,92,9,6,3,27
S01009046,641,30,4,26,168,68,64,53,112,83,10,4,6,53
S01009047,586,36,6,30,148,83,40,65,101,80,6,3,3,27
S01009048,618,45,12,33,165,80,46,52,111,75,7,2,5,37
S01009049,452,31,4,27,116,56,44,37,70,73,6,2,4,19
S01009050,585,45,11,34,126,112,42,56,61,84,31,24,7,28
S01009051,516,19,2,17,85,79,44,54,88,97,21,12,9,29
S01009052,488,25,11,14,93,87,46,44,77,79,9,4,5,28
S01009053,402,6,2,4,34,49,17,27,93,99,50,21,29,27
S01009054,444,13,4,9,74,63,24,47,78,96,27,12,15,22
S01009055,643,61,15,46,134,88,78,59,85,85,27,9,18,26
S01009056,415,12,5,7,42,47,36,25,87,107,31,17,14,28
S01009057,403,14,1,13,57,42,26,25,83,99,37,17,20,20
S01009058,594,25,3,22,108,88,27,55,107,123,27,10,17,34
S01009059,657,57,14,43,159,82,53,56,71,79,46,30,16,54
S01009060,405,46,10,36,124,59,45,26,30,35,7,6,1,33
S01009061,632,28,7,21,101,93,28,63,135,125,24,11,13,35
S01009062,485,9,3,6,56,88,30,49,96,102,31,17,14,24
S01009063,569,49,8,41,130,84,36,50,82,87,12,8,4,39
S01009064,433,15,0,15,69,70,13,38,87,97,21,8,13,23
S01009065,476,15,0,15,55,63,30,48,95,91,45,25,20,34
S01009066,539,15,6,9,84,75,36,56,112,106,36,19,17,19
S01009067,637,62,20,42,159,120,57,61,80,46,16,10,6,36
S01009068,670,35,6,29,121,124,42,78,96,106,27,16,11,41
S01009069,510,51,13,38,159,77,37,45,59,45,6,1,5,31
S01009070,494,28,8,20,102,97,53,41,73,55,13,7,6,32
S01009071,379,28,7,21,85,50,41,30,50,54,23,15,8,18
S01009072,394,34,9,25,84,55,44,30,53,50,21,14,7,23
S01009073,447,12,7,5,54,49,29,51,101,99,27,14,13,25
S01009074,538,21,3,18,58,50,28,56,100,138,51,28,23,36
S01009075,418,15,4,11,60,55,35,50,71,95,22,12,10,15
S01009076,752,49,9,40,176,129,58,73,99,98,17,9,8,53
S01009077,491,35,9,26,119,72,32,49,70,58,24,14,10,32
S01009078,567,86,15,71,179,104,35,36,50,36,13,10,3,28
S01009079,630,21,6,15,83,75,40,70,134,142,41,24,17,24
S01009080,688,21,8,13,111,90,48,79,129,143,39,27,12,28
S01009081,501,24,8,16,118,82,46,43,76,81,11,10,1,20
S01009082,734,29,6,23,102,110,66,75,131,128,44,25,19,49
S01009083,585,24,7,17,111,90,36,61,106,94,33,20,13,30
S01009084,347,26,7,19,78,48,53,23,48,39,14,9,5,18
S01009085,572,54,9,45,163,109,35,46,56,58,10,6,4,41
S01009086,524,23,4,19,98,77,39,61,91,85,27,14,13,23
S01009087,455,19,4,15,62,55,24,49,111,86,21,9,12,28
S01009088,782,76,20,56,200,123,80,61,91,83,22,13,9,46
S01009089,672,116,35,81,202,99,49,45,59,30,11,7,4,61
S01009090,634,114,16,98,215,102,44,31,55,40,20,19,1,13
S01009091,474,102,18,84,173,53,30,28,28,13,10,4,6,37
S01009092,780,77,22,55,173,121,47,82,113,94,22,9,13,51
S01009093,570,17,3,14,102,81,40,45,113,101,32,13,19,39
S01009094,489,66,16,50,183,68,23,36,52,30,8,7,1,23
S01009095,593,61,13,48,151,66,56,41,84,59,39,31,8,36
S01009096,675,109,21,88,206,107,44,38,76,49,17,14,3,29
S01009097,661,84,16,68,219,101,32,52,65,40,13,7,6,55
S01009098,386,50,15,35,129,47,29,27,40,18,12,7,5,34
S01009099,564,33,10,23,120,82,33,51,89,88,30,26,4,38
S01009100,539,22,8,14,88,62,40,55,100,91,56,50,6,25
S01009101,706,22,8,14,97,79,39,73,169,141,41,19,22,45
S01009102,572,11,2,9,58,70,22,54,129,124,62,41,21,42
S01009103,437,29,7,22,113,79,16,45,68,38,9,5,4,40
S01009104,603,24,8,16,120,91,30,67,117,93,18,12,6,43
S01009105,592,38,9,29,152,101,40,51,88,69,17,13,4,36
S01009106,403,14,1,13,84,69,22,44,68,76,15,5,10,11
S01009107,625,63,16,47,160,103,22,63,88,67,21,13,8,38
S01009108,561,53,15,38,148,101,31,58,75,56,9,6,3,30
S01009109,546,54,9,45,148,88,29,55,77,39,5,4,1,51
S01009110,453,21,2,19,90,84,32,46,75,71,10,5,5,24
S01009111,668,56,12,44,179,117,47,64,80,59,18,10,8,48
S01009112,421,54,11,43,129,58,33,39,52,31,3,3,0,22
S01009113,681,52,14,38,185,114,57,70,87,65,15,11,4,36
S01009114,597,40,10,30,126,85,40,62,83,97,18,10,8,46
S01009115,455,32,4,28,118,68,27,41,69,56,5,3,2,39
S01009116,387,34,10,24,99,76,18,41,59,23,7,3,4,30
S01009117,639,33,7,26,113,122,41,68,99,96,34,18,16,33
S01009118,459,41,9,32,114,81,28,54,48,41,7,5,2,45
S01009119,560,13,3,10,53,65,33,78,116,131,41,24,17,30
S01009120,408,15,2,13,67,39,23,42,85,88,24,15,9,25
S01009121,627,24,4,20,84,88,35,72,124,150,22,9,13,28
S01009122,719,58,13,45,161,81,68,73,109,99,29,10,19,41
S01009123,427,63,18,45,114,45,33,32,47,51,13,8,5,29
S01009124,391,29,4,25,95,58,39,33,64,58,5,4,1,10
S01009125,490,25,6,19,93,53,27,55,90,103,30,18,12,14
S01009126,428,8,2,6,37,37,18,39,95,99,68,39,29,27
S01009127,444,7,1,6,57,46,21,50,105,78,42,13,29,38
S01009128,587,15,3,12,55,60,35,63,117,147,79,51,28,16
S01009129,367,8,3,5,40,41,11,32,99,84,32,20,12,20
S01009130,474,20,4,16,95,53,30,43,88,78,37,26,11,30
S01009131,370,17,3,14,43,51,21,40,75,83,25,14,11,15
S01009132,615,56,13,43,165,111,30,46,85,56,23,9,14,43
S01009133,450,8,4,4,57,59,25,54,87,112,31,15,16,17
S01009134,689,54,21,33,148,104,34,62,120,103,23,6,17,41
S01009135,441,38,4,34,111,73,26,49,50,43,21,15,6,30
S01009136,515,49,10,39,148,78,43,29,55,48,19,16,3,46
S01009137,435,59,21,38,152,75,29,26,41,20,4,3,1,29
S01009138,679,74,19,55,175,102,63,60,74,66,24,14,10,41
S01009139,336,16,0,16,53,45,15,20,64,58,43,21,22,22
S01009140,569,39,11,28,102,70,30,62,100,102,34,24,10,30
S01009141,640,33,5,28,96,82,46,73,122,108,56,30,26,24
S01009142,487,17,2,15,92,61,24,49,86,104,31,11,20,23
S01009143,435,5,1,4,56,50,26,38,93,103,32,22,10,32
S01009144,538,60,9,51,134,96,32,52,59,56,17,12,5,32
S01009145,808,22,6,16,111,108,43,101,182,167,38,24,14,36
S01009146,700,20,1,19,108,87,37,62,137,138,61,37,24,50
S01009147,578,17,2,15,66,63,31,64,121,137,52,33,19,27
S01009148,517,14,9,5,53,43,19,66,111,141,30,17,13,40
S01009149,610,49,11,38,156,93,52,59,86,52,17,11,6,46
S01009150,455,14,2,12,45,65,27,51,112,122,19,14,5,0
S01009151,587,52,9,43,137,88,50,48,78,85,17,12,5,32
S01009152,505,31,5,26,84,87,35,52,80,94,26,14,12,16
S01009153,373,34,0,34,96,55,34,29,49,38,16,7,9,22
S01009154,684,100,18,82,198,93,69,42,61,46,29,24,5,46
S01009155,400,72,14,58,126,43,25,18,49,23,15,10,5,29
S01009156,388,71,9,62,108,53,42,25,27,21,9,3,6,32
S01009157,607,30,4,26,106,83,43,71,112,102,23,17,6,37
S01009158,395,14,1,13,87,70,21,36,77,58,17,10,7,15
S01009159,379,6,0,6,30,44,23,37,97,88,35,20,15,19
S01009160,510,14,5,9,57,62,34,65,111,111,36,21,15,20
S01009161,468,10,1,9,43,52,17,53,121,103,47,18,29,22
S01009162,579,13,2,11,99,79,17,61,100,133,58,39,19,19
S01009163,369,27,3,24,89,47,17,37,70,40,25,16,9,17
S01009164,557,12,5,7,67,66,27,81,112,129,26,14,12,37
S01009165,543,15,3,12,68,71,26,52,108,113,48,28,20,42
S01009166,627,12,2,10,61,61,31,55,143,165,64,40,24,35
S01009167,389,7,2,5,38,43,26,40,80,97,38,26,12,20
S01009168,508,58,16,42,147,77,30,49,72,43,5,3,2,27
S01009169,528,20,5,15,81,65,30,80,105,97,24,14,10,26
S01009170,518,16,2,14,65,68,37,48,101,114,39,17,22,30
S01009171,517,22,4,18,81,66,38,50,92,100,40,13,27,28
S01009172,504,109,19,90,168,60,35,25,26,27,9,6,3,45
S01009173,584,94,25,69,160,99,36,55,65,35,7,5,2,33
S01009174,343,62,17,45,112,48,31,20,27,12,11,4,7,20
S01009175,629,117,31,86,203,103,39,47,46,23,10,6,4,41
S01009176,679,131,29,102,199,108,47,59,61,25,17,11,6,32
S01009177,629,21,6,15,95,86,50,80,110,105,44,25,19,38
S01009178,549,13,4,9,70,63,35,64,106,108,51,31,20,39
S01009179,522,14,1,13,94,79,29,46,107,91,30,14,16,32
S01009180,742,24,9,15,101,96,49,82,164,155,35,21,14,36
S01009181,634,22,6,16,78,72,54,74,120,140,34,17,17,40
S01009182,754,47,10,37,180,105,72,73,112,103,25,6,19,37
S01009183,585,51,8,43,167,95,35,57,66,48,11,4,7,55
S01009184,628,38,9,29,88,67,75,54,110,110,56,29,27,30
S01009185,652,34,6,28,94,75,67,58,144,107,36,21,15,37
S01009186,609,36,4,32,99,80,49,62,112,99,35,16,19,37
S01009187,387,52,12,40,100,47,61,30,43,26,5,5,0,23
S01009188,661,39,6,33,113,70,75,65,116,105,36,23,13,42
S01009189,551,21,3,18,58,52,37,61,140,121,43,26,17,18
S01009190,604,72,13,59,157,106,60,54,60,38,21,16,5,36
S01009191,495,78,20,58,169,82,33,29,35,20,5,3,2,44
S01009192,951,37,13,24,125,75,60,79,135,182,216,206,10,42
S01009193,239,26,7,19,85,37,11,25,25,16,3,3,0,11
S01009194,619,78,17,61,187,98,44,58,60,37,9,4,5,48
S01009195,621,101,21,80,206,96,31,51,56,38,7,4,3,35
S01009196,528,39,4,35,102,77,50,54,82,58,19,15,4,47
S01009197,745,111,15,96,242,112,60,42,64,59,18,12,6,37
S01009198,557,53,10,43,168,95,46,48,55,41,14,5,9,37
S01009199,452,40,9,31,131,76,37,42,47,36,13,8,5,30
S01009200,817,136,35,101,207,124,47,69,90,75,26,21,5,43
S01009201,502,15,2,13,90,61,38,48,98,80,32,16,16,40
S01009202,373,41,9,32,118,61,27,23,45,24,10,5,5,24
S01009203,442,14,1,13,57,41,33,48,102,98,32,18,14,17
S01009204,657,42,10,32,121,91,48,48,103,111,33,24,9,60
S01009205,587,67,16,51,162,104,40,44,61,56,13,8,5,40
S01009206,663,75,24,51,202,127,25,65,73,39,17,8,9,40
S01009207,629,75,12,63,195,123,34,71,69,40,4,0,4,18
S01009208,478,55,9,46,124,73,24,48,64,40,12,6,6,38
S01009209,458,57,12,45,140,77,28,36,50,42,7,2,5,21
S01009210,429,54,12,42,125,73,39,30,57,28,9,6,3,14
S01009211,468,35,7,28,79,83,35,47,66,64,21,9,12,38
S01009212,618,19,10,9,82,85,40,66,130,139,27,20,7,30
S01009213,637,17,4,13,99,72,46,76,119,137,31,22,9,40
S01009214,741,72,15,57,196,136,42,61,99,74,17,10,7,44
S01009215,685,29,5,24,113,88,38,68,135,126,45,24,21,43
S01009216,692,19,6,13,97,91,41,95,141,140,25,19,6,43
S01009217,460,12,2,10,52,46,33,41,103,104,43,27,16,26
S01009218,607,39,14,25,128,101,39,61,97,88,17,11,6,37
S01009219,475,9,3,6,67,59,24,50,113,97,32,10,22,24
S01009220,385,18,3,15,47,60,21,39,80,78,24,11,13,18
S01009221,399,11,4,7,44,57,20,49,70,108,21,11,10,19
S01009222,377,7,1,6,33,39,21,44,82,106,19,10,9,26
S01009223,410,14,1,13,54,58,19,44,89,92,14,11,3,26
S01009224,478,14,4,10,54,65,23,58,79,130,31,16,15,24
S01009225,390,8,3,5,52,47,19,58,82,89,15,7,8,20
S01009226,690,19,6,13,120,87,29,68,130,169,49,28,21,19
S01009227,425,11,2,9,70,75,19,62,83,76,13,3,10,16
S01009228,437,10,1,9,52,48,25,38,91,112,38,14,24,23
S01009229,430,17,3,14,97,73,28,46,67,63,14,9,5,25
S01009230,469,20,7,13,106,85,29,52,71,71,17,13,4,18
S01009231,734,42,8,34,146,134,57,90,94,104,23,8,15,44
S01009232,430,10,4,6,45,49,11,47,95,86,59,31,28,28
S01009233,408,13,2,11,61,46,18,47,89,97,17,8,9,20
S01009234,735,13,2,11,60,80,27,89,162,165,78,50,28,61
S01009235,690,21,3,18,105,98,29,75,113,157,52,16,36,40
S01009236,351,23,7,16,74,66,19,39,61,41,13,7,6,15
S01009237,640,48,18,30,172,106,41,86,81,46,14,7,7,46
S01009238,581,14,0,14,81,93,12,77,110,133,32,20,12,29
S01009239,643,13,5,8,100,95,20,86,144,118,27,15,12,40
S01009240,495,8,4,4,41,53,20,54,110,119,59,24,35,31
S01009241,663,10,2,8,77,82,34,65,143,164,55,31,24,33
S01009242,570,28,9,19,127,81,30,79,110,64,20,8,12,31
S01009243,742,28,6,22,126,106,39,96,159,124,26,10,16,38
S01009244,641,59,15,44,163,120,42,70,88,58,10,7,3,31
S01009245,670,51,16,35,164,113,44,63,110,74,13,4,9,38
S01009246,606,19,8,11,83,73,36,84,146,118,21,11,10,26
S01009247,749,30,11,19,107,95,26,99,168,152,30,6,24,42
S01009248,532,25,10,15,121,78,38,68,99,49,13,9,4,41
S01009249,610,25,9,16,73,68,45,62,124,152,36,24,12,25
S01009250,484,25,8,17,65,53,30,59,116,99,17,10,7,20
S01009251,435,29,4,25,79,58,29,43,89,60,18,8,10,30
S01009252,348,45,10,35,101,59,18,32,34,24,6,2,4,29
S01009253,345,8,2,6,35,39,23,52,80,76,9,5,4,23
S01009254,595,20,3,17,64,60,26,67,133,145,53,29,24,27
S01009255,516,39,14,25,91,50,34,55,112,92,32,11,21,11
S01009256,354,28,10,18,93,46,22,38,60,47,9,4,5,11
S01009257,531,43,12,31,104,80,43,46,106,70,21,7,14,18
S01009258,481,69,13,56,125,54,61,36,68,42,11,7,4,15
S01009259,693,94,28,66,178,95,52,58,101,67,12,7,5,36
S01009260,890,60,13,47,162,132,60,81,194,131,31,17,14,39
S01009261,553,32,9,23,79,58,32,66,109,119,30,14,16,28
S01009262,397,7,3,4,43,40,16,40,102,103,19,6,13,27
S01009263,632,95,16,79,210,85,41,41,82,43,14,11,3,21
S01009264,408,28,9,19,100,61,41,36,54,48,14,9,5,26
S01009265,593,34,8,26,117,68,27,70,114,84,34,13,21,45
S01009266,634,33,9,24,98,78,41,82,125,121,31,18,13,25
S01009267,612,51,7,44,126,71,39,69,118,76,33,22,11,29
S01009268,723,45,15,30,141,77,46,69,130,136,32,10,22,47
S01009269,624,13,6,7,61,80,28,63,121,157,57,30,27,44
S01009270,430,11,5,6,40,48,30,35,97,98,41,24,17,30
S01009271,718,52,10,42,187,109,57,68,96,79,17,8,9,53
S01009272,526,7,0,7,56,58,29,50,128,111,47,29,18,40
S01009273,373,60,21,39,100,53,35,32,43,21,8,1,7,21
S01009274,471,44,4,40,100,55,30,50,82,54,18,11,7,38
S01009275,504,48,14,34,110,66,63,43,65,57,31,27,4,21
S01009276,692,80,25,55,176,103,63,61,98,59,20,13,7,32
S01009277,418,57,11,46,121,62,72,23,35,14,7,4,3,27
S01009278,405,66,15,51,129,59,27,25,40,40,7,5,2,12
S01009279,464,47,10,37,103,61,46,42,58,69,14,9,5,24
S01009280,629,6,1,5,54,58,17,79,138,186,68,41,27,23
S01009281,615,23,7,16,70,69,22,64,127,160,44,25,19,36
S01009282,572,70,14,56,155,77,62,50,65,42,20,12,8,31
S01009283,337,43,11,32,84,47,26,28,39,40,9,3,6,21
S01009284,614,70,17,53,192,98,46,38,71,41,6,2,4,52
S01009285,675,49,8,41,138,137,44,61,106,68,14,8,6,58
S01009286,590,57,18,39,174,84,53,50,83,43,11,6,5,35
S01009287,543,102,16,86,183,87,52,16,44,28,6,3,3,25
S01009288,587,92,24,68,183,82,64,31,49,35,20,11,9,31
S01009289,673,90,21,69,182,126,63,47,76,48,13,5,8,28
S01009290,471,78,21,57,144,99,41,26,39,14,7,4,3,23
S01009291,766,70,18,52,189,157,56,67,98,75,8,2,6,46
S01009292,385,8,0,8,54,44,18,43,73,92,22,12,10,31
S01009293,522,55,16,39,116,84,44,34,77,64,17,11,6,31
S01009294,388,51,12,39,114,56,34,34,48,17,7,3,4,27
S01009295,511,64,11,53,115,102,34,49,65,50,3,1,2,29
S01009296,414,35,12,23,96,62,37,43,56,40,8,4,4,37
S01009297,652,111,24,87,203,106,30,37,62,42,15,8,7,46
S01009298,740,40,7,33,112,93,39,73,154,138,53,27,26,38
S01009299,713,88,15,73,185,112,58,52,85,57,32,19,13,44
S01009300,413,43,6,37,93,55,25,39,58,47,28,20,8,25
S01009301,730,43,10,33,136,111,45,65,103,101,86,43,43,40
S01009302,650,21,4,17,86,68,22,43,160,144,65,37,28,41
S01009303,564,65,19,46,195,80,30,34,62,47,22,14,8,29
S01009304,712,51,12,39,153,126,48,60,133,89,27,14,13,25
S01009305,573,54,10,44,150,95,25,41,87,69,25,6,19,27
S01009306,828,71,14,57,184,139,49,76,114,91,54,28,26,50
S01009307,817,75,14,61,225,121,50,62,94,85,46,21,25,59
S01009308,385,53,7,46,91,59,34,28,32,39,21,9,12,28
S01009309,580,86,12,74,161,86,43,46,64,39,23,9,14,32
S01009310,720,115,20,95,201,111,49,51,79,46,18,12,6,50
S01009311,531,13,3,10,81,59,27,54,116,99,43,30,13,39
S01009312,535,55,6,49,148,91,25,32,68,54,32,19,13,30
S01009313,411,12,2,10,71,57,27,43,75,75,31,25,6,20
S01009314,510,66,17,49,109,96,27,36,81,42,22,12,10,31
S01009315,477,19,5,14,78,66,31,47,79,87,36,22,14,34
S01009316,570,113,26,87,176,83,23,32,58,26,18,7,11,41
S01009317,650,87,14,73,187,136,45,43,67,26,11,3,8,48
S01009318,467,80,18,62,159,72,23,21,58,15,1,1,0,38
S01009319,636,85,15,70,204,131,36,41,64,39,12,7,5,24
S01009320,485,53,10,43,107,85,32,39,85,52,9,6,3,23
S01009321,519,68,19,49,151,103,30,36,67,28,4,4,0,32
S01009322,610,48,11,37,141,129,40,44,83,76,16,9,7,33
S01009323,491,18,4,14,122,70,37,33,100,72,20,13,7,19
S01009324,407,19,4,15,74,63,29,33,70,79,19,6,13,21
S01009325,529,68,12,56,155,91,44,45,62,31,8,3,5,25
S01009326,420,43,8,35,116,60,11,21,55,43,32,22,10,39
S01009327,414,48,11,37,115,79,18,23,54,39,14,6,8,24
S01009328,474,79,8,71,181,79,22,29,35,22,7,2,5,20
S01009329,331,45,8,37,107,72,12,28,30,18,7,3,4,12
S01009330,349,30,5,25,91,55,21,23,61,32,12,6,6,24
S01009331,395,77,14,63,120,61,20,21,34,19,4,2,2,39
S01009332,678,96,18,78,203,117,43,37,60,47,29,23,6,46
S01009333,535,24,6,18,87,91,32,45,98,99,27,12,15,32
S01009334,473,19,4,15,61,65,24,43,85,88,51,26,25,37
S01009335,592,15,2,13,88,75,22,51,118,136,46,30,16,41
S01009336,485,12,0,12,67,52,21,50,92,82,76,39,37,33
S01009337,526,12,1,11,74,68,24,47,107,93,56,32,24,45
S01009338,547,18,5,13,69,59,20,39,113,130,68,33,35,31
S01009339,590,10,2,8,70,58,27,74,123,122,76,38,38,30
S01009340,434,6,1,5,42,49,18,40,117,112,24,15,9,26
S01009341,447,15,5,10,43,70,32,46,93,85,38,24,14,25
S01009342,547,23,4,19,73,98,31,54,92,105,39,19,20,32
S01009343,433,18,2,16,86,78,15,40,98,60,12,7,5,26
S01009344,470,9,1,8,59,69,22,50,111,99,36,23,13,15
S01009345,697,25,1,24,131,117,32,70,137,106,28,16,12,51
S01009346,474,85,16,69,177,63,43,21,40,13,11,6,5,21
S01009347,457,108,28,80,152,61,35,22,29,15,5,1,4,30
S01009348,348,56,10,46,110,56,21,20,39,14,4,1,3,28
S01009349,557,100,13,87,187,93,35,31,32,33,11,5,6,35
S01009350,440,41,5,36,133,73,22,31,56,39,14,7,7,31
S01009351,388,57,11,46,129,66,24,28,36,24,9,8,1,15
S01009352,562,101,17,84,212,79,25,29,47,21,13,7,6,35
S01009353,285,42,7,35,95,53,24,20,20,9,10,4,6,12
S01009354,628,96,16,80,214,99,46,31,56,29,13,9,4,44
S01009355,694,71,12,59,158,146,45,65,116,52,12,11,1,29
S01009356,760,64,16,48,208,156,52,71,91,67,7,5,2,44
S01009357,359,72,19,53,99,68,24,22,29,22,8,3,5,15
S01009358,528,128,32,96,173,67,35,24,39,16,6,5,1,40
S01009359,565,86,13,73,181,90,35,27,59,33,8,4,4,46
S01009360,646,95,20,75,164,111,37,50,74,61,8,5,3,46
S01009361,592,56,8,48,136,102,33,41,114,64,16,14,2,30
S01009362,802,85,16,69,192,169,33,75,113,65,17,12,5,53
S01009363,633,28,8,20,97,120,28,71,126,106,29,13,16,28
S01009364,672,35,9,26,120,125,44,83,118,73,27,16,11,47
S01009365,445,20,2,18,81,79,24,46,73,77,25,14,11,20
S01009366,549,27,7,20,72,93,45,56,112,93,27,14,13,24
S01009367,473,19,2,17,88,74,21,59,88,75,19,8,11,30
S01009368,428,12,1,11,50,75,23,41,100,79,22,6,16,26
S01009369,431,13,0,13,75,71,23,44,78,71,25,15,10,31
S01009370,668,40,8,32,111,122,32,60,134,97,35,23,12,37
S01009371,397,17,5,12,74,62,12,32,79,77,16,10,6,28
S01009372,407,18,3,15,60,53,29,50,87,63,18,10,8,29
S01009373,597,19,1,18,98,82,27,61,121,110,55,36,19,24
S01009374,653,39,10,29,101,100,33,77,127,109,36,19,17,31
S01009375,606,22,7,15,92,66,22,76,146,115,31,15,16,36
S01009376,446,16,6,10,50,79,19,49,91,95,26,18,8,21
S01009377,978,52,12,40,219,339,37,71,118,76,28,13,15,38
S01009378,717,33,5,28,125,126,43,58,136,95,27,11,16,74
S01009379,678,71,11,60,148,134,34,59,84,58,33,14,19,57
S01009380,467,27,17,10,93,79,21,47,79,62,23,18,5,36
S01009381,517,66,12,54,115,90,39,36,69,49,14,5,9,39
S01009382,605,31,7,24,96,89,43,45,120,113,23,10,13,45
S01009383,638,29,3,26,127,99,40,62,122,89,41,20,21,29
S01009384,434,81,15,66,157,59,43,19,32,11,13,10,3,19
S01009385,381,66,11,55,88,55,30,34,49,32,8,5,3,19
S01009386,497,11,5,6,89,67,24,52,119,78,24,12,12,33
S01009387,441,30,6,24,67,69,21,34,85,85,23,8,15,27
S01009388,644,26,3,23,79,77,28,61,127,120,68,33,35,58
S01009389,726,85,13,72,170,113,55,57,102,77,25,10,15,42
S01009390,543,116,27,89,175,95,26,16,47,15,4,2,2,49
S01009391,509,70,17,53,169,92,33,32,51,26,3,3,0,33
S01009392,370,65,10,55,112,71,29,19,40,12,2,1,1,20
S01009393,528,57,6,51,143,90,50,41,61,35,16,11,5,35
S01009394,695,123,17,106,196,124,46,45,53,44,20,10,10,44
S01009395,498,97,23,74,165,83,35,25,46,23,3,2,1,21
S01009396,562,117,27,90,187,81,44,19,55,15,10,7,3,34
S01009397,534,91,21,70,143,83,36,35,71,29,13,5,8,33
S01009398,533,41,12,29,133,112,42,51,79,34,11,6,5,30
S01009399,534,62,15,47,142,97,33,37,81,43,11,4,7,28
S01009400,390,23,10,13,77,84,24,39,72,39,10,3,7,22
S01009401,504,81,20,61,136,91,30,43,50,27,12,5,7,34
S01009402,693,84,18,66,215,110,63,45,74,44,13,9,4,45
S01009403,400,39,8,31,109,69,23,30,63,28,7,6,1,32
S01009404,410,15,3,12,54,42,28,51,69,87,35,25,10,29
S01009405,315,17,4,13,72,52,41,32,44,27,12,6,6,18
S01009406,695,36,7,29,133,106,60,57,111,127,31,18,13,34
S01009407,393,23,6,17,86,52,33,33,63,67,17,10,7,19
S01009408,581,62,16,46,138,95,52,62,71,56,13,5,8,32
S01009409,492,17,4,13,64,50,21,64,103,112,27,13,14,34
S01009410,667,16,7,9,76,69,45,60,164,148,49,30,19,40
S01009411,641,11,2,9,78,73,38,60,150,154,42,21,21,35
S01009412,644,11,3,8,73,84,33,76,145,164,38,24,14,20
S01009413,774,31,7,24,132,104,55,80,141,152,34,18,16,45
S01009414,503,17,6,11,85,74,30,49,99,95,22,12,10,32
S01009415,600,28,12,16,91,79,42,53,107,105,62,39,23,33
S01009416,419,28,9,19,81,76,32,52,73,36,10,6,4,31
S01009417,222,17,3,14,58,35,35,15,31,18,6,3,3,7
S01009418,834,29,4,25,105,109,53,83,171,200,44,23,21,40
S01009419,428,12,4,8,56,64,15,50,85,89,30,22,8,27
S01009420,459,7,1,6,45,32,13,33,100,148,38,26,12,43
S01009421,522,11,4,7,59,47,28,59,107,129,51,30,21,31
S01009422,584,29,9,20,87,78,23,62,118,115,33,18,15,39
S01009423,691,61,10,51,199,130,52,58,71,56,21,8,13,43
S01009424,441,44,13,31,93,74,25,40,66,58,21,13,8,20
S01009425,558,28,8,20,109,77,32,53,107,90,33,13,20,29
S01009426,566,15,6,9,68,73,28,52,131,127,45,28,17,27
S01009427,433,18,5,13,44,55,25,36,84,105,51,28,23,15
S01009428,430,13,1,12,59,52,25,48,81,94,32,17,15,26
S01009429,514,18,4,14,51,53,12,51,107,140,47,35,12,35
S01009430,547,19,7,12,69,74,33,40,128,115,36,22,14,33
S01009431,477,18,3,15,84,48,34,57,68,96,42,30,12,30
S01009432,584,7,2,5,43,59,17,60,156,144,53,38,15,45
S01009433,590,9,1,8,52,60,26,56,138,128,71,44,27,50
S01009434,398,3,2,1,50,51,26,41,69,92,38,25,13,28
S01009435,544,7,1,6,55,38,30,59,127,122,75,41,34,31
S01009436,508,17,6,11,76,66,21,56,133,87,26,12,14,26
S01009437,514,15,6,9,70,62,44,53,107,116,20,8,12,27
S01009438,635,19,3,16,74,68,47,64,126,141,43,26,17,53
S01009439,690,8,1,7,82,62,25,93,147,163,58,31,27,52
S01009440,464,17,3,14,50,58,29,46,117,104,33,19,14,10
S01009441,582,7,2,5,61,58,29,64,137,136,48,24,24,42
S01009442,415,27,5,22,93,58,55,44,57,38,16,14,2,27
S01009443,499,30,8,22,100,65,62,54,78,64,20,12,8,26
S01009444,637,53,13,40,131,106,46,68,116,55,23,18,5,39
S01009445,591,7,2,5,75,61,36,65,134,145,35,23,12,33
S01009446,632,13,2,11,67,67,34,55,144,139,71,41,30,42
S01009447,391,14,2,12,48,49,25,32,77,88,33,20,13,25
S01009448,622,38,11,27,134,84,40,63,108,101,28,15,13,26
S01009449,375,12,4,8,51,51,28,35,84,74,19,15,4,21
S01009450,444,5,1,4,39,47,23,38,91,138,50,28,22,13
S01009451,716,10,5,5,70,76,49,82,141,176,73,44,29,39
S01009452,375,7,1,6,39,44,20,27,99,89,32,18,14,18
S01009453,738,19,5,14,93,102,38,97,144,150,48,28,20,47
S01009454,658,127,23,104,210,76,48,37,70,36,15,8,7,39
S01009455,615,129,32,97,201,69,75,24,39,31,9,4,5,38
S01009456,518,22,8,14,90,56,49,49,98,103,32,22,10,19
S01009457,445,41,13,28,114,51,73,33,69,42,5,4,1,17
S01009458,481,45,12,33,114,70,42,43,72,57,17,6,11,21
S01009459,649,43,10,33,132,72,67,68,102,85,38,14,24,42
S01009460,606,17,6,11,79,52,27,66,128,134,77,31,46,26
S01009461,405,84,18,66,145,56,23,15,29,29,8,5,3,16
S01009462,502,47,12,35,92,67,29,49,84,92,16,6,10,26
S01009463,483,42,11,31,100,75,38,48,76,63,17,9,8,24
S01009464,625,53,9,44,153,112,56,59,80,61,20,12,8,31
S01009465,440,17,4,13,95,56,31,47,83,66,14,7,7,31
S01009466,428,73,15,58,122,67,39,31,45,22,8,4,4,21
S01009467,570,85,20,65,187,73,43,26,64,36,18,7,11,38
S01009468,565,28,7,21,105,77,30,59,118,92,29,14,15,27
S01009469,619,64,13,51,165,86,41,39,86,66,27,10,17,45
S01009470,348,22,5,17,85,52,25,33,62,35,14,6,8,20
S01009471,469,22,9,13,78,32,30,45,89,104,43,21,22,26
S01009472,673,58,12,46,148,50,47,43,124,82,79,42,37,42
S01009473,684,23,3,20,78,57,40,78,139,133,82,39,43,54
S01009474,649,32,6,26,112,67,48,58,126,83,74,30,44,49
S01009475,431,68,22,46,120,68,43,29,44,24,9,6,3,26
S01009476,345,56,12,44,117,33,30,17,34,22,10,8,2,26
S01009477,513,60,8,52,160,64,43,35,58,45,12,5,7,36
S01009478,691,35,8,27,169,89,46,50,114,79,48,32,16,61
S01009479,614,68,12,56,144,56,42,49,88,69,50,30,20,48
S01009480,591,81,14,67,177,75,55,34,68,47,16,11,5,38
S01009481,693,47,8,39,154,106,39,57,128,99,20,14,6,43
S01009482,477,38,7,31,98,53,30,55,87,58,15,7,8,43
S01009483,576,49,4,45,156,79,48,45,81,52,28,11,17,38
S01009484,579,49,11,38,116,90,29,40,103,60,33,15,18,59
S01009485,565,26,5,21,90,69,46,49,109,90,44,26,18,42
S01009486,445,47,12,35,116,60,31,30,65,57,15,8,7,24
S01009487,561,22,5,17,84,80,19,62,114,105,35,24,11,40
S01009488,486,23,7,16,83,68,30,49,95,73,23,8,15,42
S01009489,586,28,7,21,72,65,32,61,121,114,62,42,20,31
S01009490,623,11,1,10,54,72,20,65,131,148,78,42,36,44
S01009491,491,19,1,18,66,76,32,39,97,104,37,24,13,21
S01009492,572,8,4,4,76,74,30,59,118,145,22,12,10,40
S01009493,597,120,14,106,198,82,49,26,43,32,8,4,4,39
S01009494,714,77,15,62,209,117,61,62,80,49,17,9,8,42
S01009495,696,65,16,49,192,129,56,61,77,54,10,6,4,52
S01009496,585,17,3,14,81,83,36,67,133,114,20,17,3,34
S01009497,736,32,7,25,138,102,38,87,149,118,35,21,14,37
S01009498,507,50,10,40,153,92,31,42,56,46,10,5,5,27
S01009499,597,48,12,36,123,78,45,49,104,85,26,13,13,39
S01009500,552,10,1,9,74,65,30,47,123,110,56,36,20,37
S01009501,474,11,4,7,57,43,25,51,105,106,41,21,20,35
S01009502,615,11,3,8,76,62,35,66,149,139,41,21,20,36
S01009503,537,15,3,12,102,62,43,47,113,102,22,10,12,31
S01009504,498,8,1,7,48,50,30,54,111,116,44,24,20,37
S01009505,555,9,1,8,53,54,13,51,134,117,89,52,37,35
S01009506,527,10,4,6,71,49,27,53,138,106,44,24,20,29
S01009507,614,30,14,16,111,105,38,64,96,96,36,22,14,38
S01009508,632,8,2,6,61,62,30,70,151,131,74,43,31,45
S01009509,715,22,5,17,81,74,44,59,157,149,68,37,31,61
S01009510,538,40,9,31,139,94,35,54,83,42,17,10,7,34
S01009511,440,38,12,26,112,85,32,34,63,36,9,6,3,31
S01009512,583,45,8,37,145,120,40,46,91,57,10,4,6,29
S01009513,443,44,12,32,140,70,20,30,72,31,8,4,4,28
S01009514,553,44,7,37,158,102,35,47,86,43,8,6,2,30
S01009515,515,17,2,15,57,71,29,61,109,103,35,23,12,33
S01009516,623,21,6,15,99,89,42,65,132,113,30,22,8,32
S01009517,697,82,16,66,230,118,46,49,80,33,12,4,8,47
S01009518,658,77,16,61,206,119,51,44,78,33,11,6,5,39
S01009519,390,26,7,19,70,53,30,43,70,56,17,13,4,25
S01009520,639,59,21,38,142,89,43,52,96,86,22,15,7,50
S01009521,617,11,3,8,68,57,40,53,135,156,64,41,23,33
S01009522,713,24,4,20,87,78,55,68,137,146,63,37,26,55
S01009523,434,12,0,12,52,53,12,31,91,101,36,22,14,46
S01009524,492,24,4,20,91,55,23,39,112,69,43,24,19,36
S01009525,398,16,3,13,69,40,18,37,63,85,38,28,10,32
S01009526,541,54,5,49,145,75,39,56,83,42,19,8,11,28
S01009527,506,38,7,31,92,69,27,44,102,71,33,18,15,30
S01009528,349,32,7,25,70,43,20,38,69,53,8,5,3,16
S01009529,412,47,11,36,100,51,37,37,64,35,13,2,11,28
S01009530,429,53,15,38,132,76,30,32,50,20,7,6,1,29
S01009531,607,9,0,9,53,74,35,70,128,153,47,25,22,38
S01009532,591,12,4,8,73,67,23,67,135,144,49,29,20,21
S01009533,588,15,5,10,79,74,29,56,134,135,39,21,18,27
S01009534,587,11,3,8,63,47,39,63,125,104,87,51,36,48
S01009535,457,6,0,6,58,39,25,46,94,102,61,34,27,26
S01009536,378,13,6,7,62,43,23,44,64,77,27,12,15,25
S01009537,399,24,1,23,75,48,25,44,72,66,18,10,8,27
S01009538,579,39,4,35,106,61,41,52,108,89,59,31,28,24
S01009539,650,23,8,15,108,97,42,73,132,112,15,7,8,48
S01009540,636,18,8,10,90,65,33,67,148,118,66,34,32,31
S01009541,581,33,14,19,121,78,45,63,91,89,27,21,6,34
S01009542,539,12,0,12,58,53,41,39,120,114,71,24,47,31
S01009543,402,25,9,16,73,46,36,47,73,66,17,10,7,19
S01009544,639,33,3,30,133,89,55,55,124,94,30,15,15,26
S01009545,582,20,7,13,95,59,52,52,118,110,29,17,12,47
S01009546,752,26,7,19,127,86,52,92,148,134,49,29,20,38
S01009547,557,35,6,29,79,51,42,66,119,85,36,24,12,44
S01009548,512,24,10,14,89,66,31,49,114,88,20,8,12,31
S01009549,581,29,12,17,89,79,44,58,130,90,18,7,11,44
S01009550,374,29,11,18,85,62,19,38,61,39,10,7,3,31
S01009551,391,15,4,11,79,63,16,41,79,56,24,15,9,18
S01009552,669,40,11,29,134,78,59,65,126,109,22,9,13,36
S01009553,626,21,5,16,67,46,30,81,157,126,58,29,29,40
S01009554,504,23,10,13,76,43,55,47,116,78,36,16,20,30
S01009555,571,30,10,20,102,78,62,53,103,72,38,15,23,33
S01009556,574,14,3,11,74,68,30,57,141,103,46,20,26,41
S01009557,493,15,4,11,55,44,24,47,133,97,54,25,29,24
S01009558,486,8,2,6,44,39,19,40,138,104,50,23,27,44
S01009559,654,13,3,10,69,59,29,67,166,150,65,42,23,36
S01009560,557,16,4,12,80,53,23,45,142,107,59,39,20,32
S01009561,383,9,0,9,57,40,16,41,99,69,30,16,14,22
S01009562,547,26,4,22,98,68,22,63,112,87,28,14,14,43
S01009563,551,17,4,13,89,71,22,56,127,102,27,20,7,40
S01009564,465,24,8,16,97,70,22,43,96,69,11,6,5,33
S01009565,426,9,2,7,68,56,14,53,77,77,36,21,15,36
S01009566,780,34,9,25,154,99,41,89,175,105,28,17,11,55
S01009567,663,26,5,21,120,95,34,69,133,113,38,18,20,35
S01009568,522,16,3,13,90,65,31,57,114,81,27,15,12,41
S01009569,601,17,4,13,83,74,19,58,161,132,25,15,10,32
S01009570,400,7,3,4,60,46,20,37,90,81,22,14,8,37
S01009571,511,5,0,5,59,52,24,50,130,84,60,37,23,47
S01009572,761,14,5,9,89,79,37,64,183,156,73,38,35,66
S01009573,537,10,1,9,45,47,16,54,136,117,67,43,24,45
S01009574,719,21,3,18,96,76,39,73,160,165,38,21,17,51
S01009575,381,12,3,9,80,57,21,50,68,48,17,8,9,28
S01009576,428,37,8,29,104,82,38,41,69,31,7,7,0,19
S01009577,556,49,16,33,155,64,47,45,76,60,24,21,3,36
S01009578,574,23,9,14,120,80,33,38,113,87,35,23,12,45
S01009579,806,53,20,33,179,110,56,89,132,96,43,24,19,48
S01009580,722,50,15,35,183,118,51,67,106,66,14,10,4,67
S01009581,439,11,5,6,85,68,22,48,86,72,19,9,10,28
S01009582,380,13,2,11,70,64,23,40,80,59,14,1,13,17
S01009583,582,17,3,14,77,91,34,57,138,89,36,21,15,43
S01009584,372,33,11,22,87,54,41,30,65,31,12,6,6,19
S01009585,730,16,6,10,106,99,45,90,179,122,27,13,14,46
S01009586,494,21,10,11,91,68,25,68,95,68,36,29,7,22
S01009587,497,30,11,19,87,60,24,58,112,80,24,12,12,22
S01009588,725,20,3,17,113,82,34,94,177,118,34,25,9,53
S01009589,677,14,4,10,105,80,33,90,150,109,44,28,16,52
S01009590,543,53,16,37,172,69,39,42,68,40,13,8,5,47
S01009591,533,59,15,44,130,80,37,48,87,50,13,5,8,29
S01009592,441,60,11,49,124,55,42,37,68,30,5,2,3,20
S01009593,454,61,18,43,122,76,43,32,47,24,19,13,6,30
S01009594,525,61,18,43,132,102,32,60,64,36,12,8,4,26
S01009595,392,53,24,29,106,60,37,22,51,20,12,7,5,31
S01009596,607,21,6,15,88,81,37,61,152,97,36,24,12,34
S01009597,619,13,3,10,65,69,38,74,141,97,68,34,34,54
S01009598,483,12,1,11,57,48,32,43,108,87,51,27,24,45
S01009599,687,30,12,18,108,105,34,74,142,108,50,28,22,36
S01009600,453,13,4,9,65,54,24,43,95,91,36,23,13,32
S01009601,505,14,4,10,76,66,21,63,94,85,54,32,22,32
S01009602,592,73,21,52,177,93,38,43,77,42,16,9,7,33
S01009603,442,52,18,34,114,67,32,34,62,28,22,21,1,31
S01009604,648,30,7,23,153,78,33,79,122,93,22,17,5,38
S01009605,580,27,8,19,83,75,40,70,119,75,46,35,11,45
S01009606,413,57,14,43,140,50,26,29,55,22,12,10,2,22
S01009607,404,51,18,33,122,62,31,31,43,34,6,4,2,24
S01009608,427,21,5,16,83,57,25,43,83,74,20,9,11,21
S01009609,606,43,11,32,148,87,50,55,91,68,24,17,7,40
S01009610,732,37,7,30,167,97,40,83,141,101,23,11,12,43
S01009611,408,52,12,40,82,63,54,40,61,29,3,2,1,24
S01009612,449,21,7,14,72,72,39,40,82,83,13,8,5,27
S01009613,355,24,7,17,131,41,46,25,48,16,6,4,2,18
S01009614,388,32,11,21,83,45,47,44,55,47,10,4,6,25
S01009615,303,20,5,15,55,50,27,34,43,47,9,6,3,18
S01009616,564,29,9,20,87,76,43,68,116,75,31,15,16,39
S01009617,568,41,7,34,120,68,46,77,102,65,10,6,4,39
S01009618,528,11,3,8,63,70,33,56,128,109,38,20,18,20
S01009619,464,14,2,12,74,53,24,54,105,78,33,19,14,29
S01009620,570,10,1,9,70,44,28,68,148,123,48,32,16,31
S01009621,591,18,5,13,86,75,39,74,125,101,53,34,19,20
S01009622,536,8,2,6,52,63,31,49,123,114,74,47,27,22
S01009623,355,8,2,6,33,42,19,39,92,73,24,17,7,25
S01009624,668,19,4,15,74,58,26,79,171,155,42,29,13,44
S01009625,602,5,2,3,53,55,24,67,157,144,57,29,28,40
S01009626,424,10,2,8,30,34,22,27,108,107,57,41,16,29
S01009627,587,13,3,10,70,56,29,55,144,135,43,30,13,42
S01009628,354,7,2,5,31,34,14,35,95,92,25,18,7,21
S01009629,769,12,4,8,82,75,38,83,179,158,83,48,35,59
S01009630,582,11,5,6,55,56,20,46,131,135,76,51,25,52
S01009631,544,7,0,7,48,37,23,60,153,134,60,35,25,22
S01009632,394,6,3,3,29,26,19,43,108,95,53,31,22,15
S01009633,512,4,1,3,33,41,14,52,130,115,80,51,29,43
S01009634,362,5,1,4,33,39,6,46,89,87,42,27,15,15
S01009635,654,17,2,15,87,58,38,68,172,133,39,20,19,42
S01009636,693,12,5,7,52,56,42,76,168,136,118,70,48,33
S01009637,548,19,3,16,78,59,35,64,133,97,32,23,9,31
S01009638,514,12,6,6,54,27,26,48,114,112,75,47,28,46
S01009639,560,57,9,48,159,73,47,43,64,46,29,19,10,42
S01009640,420,13,1,12,65,48,14,44,100,79,28,21,7,29
S01009641,563,19,1,18,99,82,42,56,107,95,42,22,20,21
S01009642,706,29,6,23,140,99,44,79,126,104,40,27,13,45
S01009643,419,28,9,19,107,63,21,43,89,35,10,5,5,23
S01009644,604,28,4,24,78,67,29,65,128,128,39,27,12,42
S01009645,474,10,2,8,65,59,35,55,103,100,23,16,7,24
S01009646,430,8,0,8,58,35,33,44,109,82,30,20,10,31
S01009647,424,8,2,6,58,40,28,33,105,83,38,17,21,31
S01009648,627,12,2,10,90,70,43,83,142,109,37,20,17,41
S01009649,793,29,10,19,154,100,40,79,177,116,50,32,18,48
S01009650,565,42,9,33,173,93,50,49,79,45,6,3,3,28
S01009651,682,74,7,67,188,68,98,48,92,61,16,7,9,37
S01009652,538,90,13,77,156,67,70,28,57,33,5,3,2,32
S01009653,389,51,17,34,117,46,40,33,48,29,6,6,0,19
S01009654,408,31,4,27,104,50,41,33,60,50,10,3,7,29
S01009655,641,14,2,12,70,46,31,69,172,153,43,28,15,43
S01009656,529,14,6,8,45,29,30,59,128,136,65,40,25,23
S01009657,599,30,7,23,111,74,48,71,111,74,36,20,16,44
S01009658,535,11,3,8,74,54,26,50,142,113,39,29,10,26
S01009659,384,15,3,12,58,40,28,35,81,73,31,16,15,23
S01009660,795,27,5,22,140,96,39,72,197,131,38,29,9,55
S01009661,640,78,24,54,172,65,111,43,65,49,14,7,7,43
S01009662,552,49,15,34,126,71,68,51,77,58,16,9,7,36
S01009663,492,59,12,47,136,51,35,48,67,38,17,8,9,41
S01009664,688,104,26,78,149,91,86,45,91,61,25,15,10,36
S01009665,475,42,16,26,100,52,45,39,75,76,20,13,7,26
S01009666,561,43,13,30,136,67,66,45,75,72,22,11,11,35
S01009667,384,50,12,38,114,52,47,29,47,24,1,1,0,20
S01009668,421,48,11,37,126,55,33,40,46,33,11,5,6,29
S01009669,361,40,6,34,87,46,42,40,50,37,5,2,3,14
S01009670,586,79,21,58,150,54,52,39,81,59,23,15,8,49
S01009671,485,54,13,41,132,56,57,33,69,33,6,2,4,45
S01009672,581,37,13,24,95,76,51,60,119,100,23,17,6,20
S01009673,590,59,20,39,135,68,70,43,82,74,23,16,7,36
S01009674,651,90,23,67,172,74,76,47,71,69,17,9,8,35
S01009675,682,82,23,59,178,98,68,48,76,64,17,10,7,51
S01009676,585,53,17,36,143,65,69,56,88,71,14,8,6,26
S01009677,446,65,12,53,105,44,79,29,63,20,11,5,6,30
S01009678,442,34,6,28,69,54,42,58,79,76,6,4,2,24
S01009679,676,30,7,23,149,79,57,60,116,113,38,20,18,34
S01009680,606,40,11,29,118,64,53,69,126,79,30,16,14,27
S01009681,530,33,7,26,109,54,37,52,78,91,43,34,9,33
S01009682,458,45,6,39,151,67,28,35,67,36,11,6,5,18
S01009683,608,81,15,66,177,63,33,40,56,43,18,12,6,97
S01009684,793,114,28,86,227,100,98,41,82,48,23,16,7,60
S01009685,458,28,7,21,100,52,37,52,73,66,18,12,6,32
S01009686,816,69,8,61,164,72,42,72,150,111,34,21,13,102
S01009687,523,33,5,28,131,77,34,43,72,74,25,13,12,34
S01009688,636,20,4,16,82,59,29,70,143,130,55,38,17,48
S01009689,452,47,8,39,86,41,32,42,72,57,23,13,10,52
S01009690,531,58,7,51,128,58,31,43,86,62,29,17,12,36
S01009691,424,48,8,40,126,61,31,24,56,31,10,6,4,37
S01009692,750,80,16,64,197,108,59,56,119,78,15,10,5,38
S01009693,461,53,13,40,131,71,32,42,60,26,9,5,4,37
S01009694,694,109,22,87,185,106,42,38,104,54,10,9,1,46
S01009695,463,64,13,51,122,54,71,26,44,51,10,5,5,21
S01009696,698,122,26,96,192,71,83,43,88,38,27,17,10,34
S01009697,525,94,15,79,139,52,65,40,53,46,9,4,5,27
S01009698,458,58,16,42,123,36,86,34,48,28,6,5,1,39
S01009699,330,46,14,32,70,38,49,26,46,30,10,9,1,15
S01009700,488,37,5,32,96,44,69,47,78,66,13,8,5,38
S01009701,286,42,10,32,86,29,34,20,32,17,7,4,3,19
S01009702,472,67,10,57,101,41,84,39,58,39,7,4,3,36
S01009703,414,30,7,23,78,48,55,50,69,58,9,4,5,17
S01009704,706,59,10,49,170,69,120,59,103,72,17,11,6,37
S01009705,549,19,3,16,98,40,77,62,109,96,20,10,10,28
S01009706,440,44,11,33,83,50,69,39,66,42,16,9,7,31
S01009707,359,42,5,37,92,41,41,34,42,32,13,8,5,22
S01009708,442,50,10,40,87,55,70,34,69,45,7,6,1,25
S01009709,618,56,9,47,113,78,78,65,97,89,20,10,10,22
S01009710,406,30,4,26,83,42,66,46,53,39,14,8,6,33
S01009711,549,38,8,30,82,50,87,42,111,74,26,17,9,39
S01009712,456,39,5,34,100,40,78,49,70,37,20,12,8,23
S01009713,653,71,15,56,147,55,98,59,93,61,24,15,9,45
S01009714,662,100,19,81,161,75,92,52,81,50,12,5,7,39
S01009715,500,88,12,76,107,48,83,34,65,33,12,4,8,30
S01009716,532,91,8,83,107,46,42,29,53,40,4,2,2,120
S01009717,858,33,1,32,66,35,27,33,83,65,20,9,11,496
S01009718,563,40,3,37,73,28,31,56,82,98,18,10,8,137
S01009719,571,41,8,33,70,48,38,59,116,85,16,10,6,98
S01009720,611,44,5,39,79,47,25,69,101,108,12,8,4,126
S01009721,551,23,0,23,17,7,7,8,13,7,3,2,1,466
S01009722,1012,54,7,47,63,20,27,11,30,20,4,3,1,783
S01009723,703,44,1,43,35,18,12,12,15,13,9,8,1,545
S01009724,813,56,2,54,60,31,39,56,90,87,45,37,8,349
S01009725,627,33,4,29,38,11,16,17,22,19,16,10,6,455
S01009726,988,29,5,24,36,12,38,10,7,4,5,3,2,847
S01009727,635,112,24,88,149,53,50,36,69,40,10,3,7,116
S01009728,562,98,17,81,182,72,42,28,41,27,10,6,4,62
S01009729,454,97,7,90,146,53,32,27,31,19,9,5,4,40
S01009730,423,52,6,46,55,62,28,32,46,45,8,3,5,95
S01009731,410,76,6,70,107,48,37,13,29,16,4,3,1,80
S01009732,661,72,7,65,79,21,43,21,34,20,13,9,4,358
S01009733,397,62,8,54,90,37,46,24,61,49,4,2,2,24
S01009734,653,130,23,107,153,66,71,49,57,34,9,5,4,84
S01009735,975,151,22,129,149,57,54,10,17,5,6,5,1,526
S01009736,2500,51,5,46,46,22,26,15,17,5,12,12,0,2306
S01009737,590,17,5,12,179,108,34,45,97,76,10,6,4,24
S01009738,343,21,3,18,76,41,31,44,55,42,9,6,3,24
S01009739,566,76,43,33,180,77,37,33,55,37,16,5,11,55
S01009740,402,17,7,10,79,49,32,51,66,56,17,10,7,35
S01009741,681,42,38,4,227,273,9,18,46,35,8,4,4,23
S01009742,391,75,15,60,131,49,36,24,33,16,8,4,4,19
S01009743,694,123,17,106,182,86,78,57,65,53,15,8,7,35
S01009744,536,76,20,56,142,88,52,39,56,37,8,7,1,38
S01009745,803,104,22,82,233,120,61,56,120,45,13,8,5,51
S01009746,431,66,10,56,118,37,74,24,48,28,10,6,4,26
S01009747,506,51,8,43,121,79,40,45,64,58,19,11,8,29
S01009748,550,85,16,69,143,83,37,41,73,44,10,4,6,34
S01009749,721,109,15,94,191,97,41,57,78,73,21,13,8,54
S01009750,488,38,4,34,118,50,36,50,76,70,17,5,12,33
S01009751,627,42,6,36,129,80,27,66,115,90,26,12,14,52
S01009752,438,131,12,119,140,46,28,12,29,17,6,2,4,29
S01009753,461,87,10,77,139,52,47,19,49,31,9,4,5,28
S01009754,603,122,17,105,147,61,44,38,66,45,23,12,11,57
S01009755,495,96,13,83,155,58,32,39,36,22,19,16,3,38
S01009756,566,132,23,109,170,58,32,31,51,37,14,9,5,41
S01009757,495,135,16,119,157,45,44,18,34,10,8,5,3,44
S01009758,447,37,6,31,101,73,25,36,68,53,13,7,6,41
S01009759,661,7,2,5,37,46,30,45,159,154,105,71,34,78
S01009760,615,13,0,13,53,83,31,48,127,143,67,50,17,50
S01009761,699,47,10,37,119,121,44,69,124,81,35,21,14,59
S01009762,711,7,2,5,59,52,13,65,176,179,86,56,30,74
S01009763,572,94,21,73,147,64,69,23,52,24,28,24,4,71
S01009764,483,13,2,11,63,55,24,43,111,85,61,36,25,28
S01009765,668,30,4,26,95,111,47,72,131,75,50,31,19,57
S01009766,445,19,5,14,100,71,21,48,82,47,10,5,5,47
S01009767,413,9,3,6,42,51,19,34,91,78,59,46,13,30
S01009768,456,27,3,24,71,52,35,26,98,64,53,30,23,30
S01009769,491,41,6,35,113,77,36,36,81,51,17,5,12,39
S01009770,545,31,9,22,105,82,37,56,96,40,40,38,2,58
S01009771,652,36,7,29,129,113,60,54,94,45,51,40,11,70
S01009772,488,33,8,25,105,89,32,35,80,61,17,6,11,36
S01009773,415,50,4,46,84,46,51,29,37,17,29,26,3,72
S01009774,353,43,3,40,85,42,33,23,35,23,25,21,4,44
S01009775,631,18,5,13,42,46,14,58,153,143,86,65,21,71
S01009776,470,7,0,7,37,31,8,46,107,110,95,58,37,29
S01009777,366,8,0,8,36,50,16,31,93,68,29,19,10,35
S01009778,623,16,4,12,45,58,23,58,159,158,57,43,14,49
S01009779,375,3,1,2,22,39,12,37,88,90,44,24,20,40
S01009780,435,4,1,3,27,34,10,20,104,98,92,58,34,46
S01009781,392,2,1,1,36,42,6,33,95,94,57,41,16,27
S01009782,392,24,1,23,60,47,28,31,71,54,45,28,17,32
S01009783,544,7,2,5,64,53,21,45,137,112,75,58,17,30
S01009784,559,12,3,9,54,55,14,48,141,116,66,42,24,53
S01009785,588,9,2,7,53,63,25,40,145,130,80,67,13,43
S01009786,684,13,4,9,56,81,23,39,179,148,90,53,37,55
S01009787,642,10,3,7,57,76,27,51,154,131,92,59,33,44
S01009788,600,21,3,18,72,90,33,40,137,128,37,24,13,42
S01009789,648,23,5,18,77,78,27,60,144,138,46,35,11,55
S01009790,468,14,6,8,60,65,13,48,108,90,38,26,12,32
S01009791,478,11,2,9,47,41,26,39,118,85,73,49,24,38
S01009792,706,98,22,76,172,83,53,42,77,46,42,36,6,93
S01009793,684,47,11,36,149,126,50,61,104,74,25,14,11,48
S01009794,387,42,7,35,109,83,20,29,47,27,7,3,4,23
S01009795,632,76,20,56,154,132,47,45,56,38,15,7,8,69
S01009796,565,49,14,35,146,88,49,44,95,37,19,17,2,38
S01009797,590,54,8,46,150,106,45,49,62,46,26,16,10,52
S01009798,538,49,10,39,149,91,46,35,65,32,12,8,4,59
S01009799,600,7,2,5,48,74,16,42,149,135,87,51,36,42
S01009800,807,19,5,14,89,112,44,65,173,148,79,55,24,78
S01009801,640,8,1,7,59,87,21,50,139,153,68,43,25,55
S01009802,735,21,5,16,104,110,29,69,149,106,75,52,23,72
S01009803,576,13,4,9,79,60,28,33,124,104,65,45,20,70
S01009804,427,57,5,52,103,41,16,31,61,40,60,56,4,18
S01009805,696,29,2,27,68,90,19,44,162,133,74,48,26,77
S01009806,605,25,3,22,107,98,28,45,133,93,30,18,12,46
S01009807,727,20,3,17,98,113,28,82,164,85,84,60,24,53
S01009808,637,7,3,4,69,58,34,50,144,98,109,76,33,68
S01009809,509,23,3,20,93,82,23,40,117,72,27,18,9,32
S01009810,596,11,3,8,83,86,20,57,130,105,68,40,28,36
S01009811,793,23,5,18,103,103,34,53,190,149,88,66,22,50
S01009812,538,19,3,16,78,96,28,48,104,86,48,32,16,31
S01009813,494,5,0,5,33,46,22,31,111,81,97,76,21,68
S01009814,614,40,6,34,134,85,34,52,80,91,37,28,9,61
S01009815,547,28,7,21,118,91,25,36,90,84,25,19,6,50
S01009816,545,29,2,27,110,85,30,56,107,62,16,10,6,50
S01009817,486,23,6,17,95,78,15,49,97,60,35,21,14,34
S01009818,716,65,12,53,198,139,49,54,84,45,25,19,6,57
S01009819,456,40,5,35,104,80,32,31,67,50,20,14,6,32
S01009820,686,38,9,29,150,132,37,59,122,69,36,26,10,43
S01009821,490,50,14,36,120,68,31,28,66,49,20,13,7,58
S01009822,334,16,2,14,64,48,12,28,64,55,25,13,12,22
S01009823,501,13,5,8,61,60,13,46,103,97,61,45,16,47
S01009824,594,19,2,17,90,78,21,68,113,119,48,33,15,38
S01009825,723,24,8,16,107,98,34,52,145,148,62,46,16,53
S01009826,402,8,2,6,45,43,17,38,97,74,45,27,18,35
S01009827,624,9,5,4,67,82,19,45,141,156,47,35,12,58
S01009828,551,17,3,14,73,65,19,56,112,110,72,53,19,27
S01009829,712,33,6,27,123,132,29,75,122,93,60,38,22,45
S01009830,576,12,4,8,84,112,23,45,115,104,39,22,17,42
S01009831,560,22,4,18,107,116,15,39,110,70,31,17,14,50
S01009832,717,44,9,35,146,120,33,64,136,91,35,22,13,48
S01009833,441,18,4,14,115,58,26,34,65,65,28,23,5,32
S01009834,606,19,6,13,91,97,27,40,113,111,58,33,25,50
S01009835,376,10,2,8,24,44,13,25,97,98,33,20,13,32
S01009836,723,31,11,20,121,102,36,64,132,133,56,43,13,48
S01009837,481,10,3,7,58,71,16,40,101,118,44,36,8,23
S01009838,563,20,3,17,91,71,22,51,96,107,69,38,31,36
S01009839,795,23,3,20,95,115,21,61,171,150,98,54,44,61
S01009840,731,27,5,22,88,110,32,61,150,154,70,48,22,39
S01009841,651,18,8,10,87,67,16,60,125,128,91,58,33,59
S01009842,511,15,3,12,52,42,19,43,94,89,88,60,28,69
S01009843,467,8,0,8,39,52,9,37,83,111,94,68,26,34
S01009844,426,10,0,10,35,36,27,37,74,84,92,65,27,31
S01009845,603,14,2,12,52,53,24,55,114,113,128,86,42,50
S01009846,691,20,4,16,86,77,35,53,136,147,85,57,28,52
S01009847,452,7,3,4,55,67,10,35,98,101,42,28,14,37
S01009848,666,17,5,12,65,77,23,57,148,130,93,69,24,56
S01009849,518,26,2,24,95,66,18,44,106,96,36,25,11,31
S01009850,654,36,5,31,106,97,29,56,130,117,42,29,13,41
S01009851,595,26,5,21,75,76,33,55,136,120,41,21,20,33
S01009852,416,23,6,17,77,73,13,29,77,49,33,24,9,42
S01009853,592,27,5,22,88,113,31,34,114,95,41,26,15,49
S01009854,657,21,4,17,102,91,26,54,137,120,64,35,29,42
S01009855,426,33,6,27,95,58,21,36,71,52,15,8,7,45
S01009856,460,33,4,29,92,68,22,31,72,53,32,21,11,57
S01009857,629,41,4,37,141,106,29,46,109,73,35,27,8,49
S01009858,550,22,4,18,96,92,26,50,116,66,28,20,8,54
S01009859,806,27,4,23,77,90,22,52,166,184,131,89,42,57
S01009860,715,12,1,11,64,88,11,65,139,172,111,85,26,53
S01009861,802,21,0,21,108,70,32,64,130,157,145,116,29,75
S01009862,866,30,4,26,96,114,42,84,143,168,113,70,43,76
S01009863,662,32,5,27,85,80,38,54,139,87,78,61,17,69
S01009864,494,40,3,37,75,53,21,31,55,75,73,59,14,71
S01009865,375,23,2,21,51,54,27,32,67,45,44,32,12,32
S01009866,723,37,5,32,116,110,35,74,112,113,58,40,18,68
S01009867,877,137,17,120,207,143,54,40,87,79,36,24,12,94
S01009868,558,61,5,56,97,70,27,41,73,76,43,33,10,70
S01009869,455,32,6,26,77,55,27,38,61,34,36,24,12,95
S01009870,481,25,0,25,74,52,27,36,59,66,71,59,12,71
S01009871,719,60,10,50,120,91,53,44,105,95,68,50,18,83
S01009872,580,44,6,38,108,71,40,45,69,56,61,43,18,86
S01009873,684,96,9,87,150,76,74,29,58,65,74,55,19,62
S01009874,782,89,14,75,150,98,55,46,125,92,54,30,24,73
S01009875,504,31,3,28,61,51,34,27,58,48,102,91,11,92
S01009876,506,8,0,8,52,46,18,32,92,64,110,88,22,84
S01009877,684,145,16,129,190,52,73,17,42,25,69,62,7,71
S01009878,517,38,4,34,66,42,52,34,55,46,100,93,7,84
S01009879,661,199,36,163,170,46,71,18,39,15,38,34,4,65
S01009880,568,106,15,91,94,48,56,18,56,12,97,91,6,81
S01009881,391,23,2,21,54,39,33,24,28,41,80,76,4,69
S01009882,925,147,11,136,227,99,68,50,90,49,77,52,25,118
S01009883,590,41,5,36,101,42,47,34,76,42,112,100,12,95
S01009884,615,59,6,53,144,57,48,30,71,42,90,82,8,74
S01009885,621,64,7,57,113,59,63,29,68,23,102,88,14,100
S01009886,571,51,1,50,103,40,39,26,60,41,98,91,7,113
S01009887,749,30,2,28,120,70,51,56,102,83,104,78,26,133
S01009888,506,29,6,23,73,42,42,38,73,50,82,70,12,77
S01009889,601,37,1,36,105,51,44,52,90,56,87,76,11,79
S01009890,419,13,1,12,47,36,22,38,76,74,71,49,22,42
S01009891,577,28,2,26,113,78,38,47,74,83,64,47,17,52
S01009892,675,26,6,20,93,71,21,60,118,127,102,82,20,57
S01009893,650,44,4,40,113,78,45,55,86,66,83,68,15,80
S01009894,623,23,3,20,89,64,32,50,118,95,78,56,22,74
S01009895,595,24,3,21,70,63,24,38,119,111,81,59,22,65
S01009896,727,21,2,19,83,68,56,51,131,128,116,90,26,73
S01009897,715,41,9,32,146,91,44,60,117,101,57,35,22,58
S01009898,432,16,1,15,35,47,41,30,91,62,68,51,17,42
S01009899,632,71,3,68,188,97,36,42,72,44,33,20,13,49
S01009900,715,123,13,110,269,102,26,27,79,33,25,12,13,31
S01009901,717,123,7,116,256,97,41,39,60,30,32,18,14,39
S01009902,680,41,2,39,114,88,47,52,96,108,73,50,23,61
S01009903,639,101,17,84,173,54,53,29,66,38,63,60,3,62
S01009904,614,99,15,84,205,79,36,27,42,42,25,18,7,59
S01009905,605,56,3,53,136,58,26,34,73,43,71,50,21,108
S01009906,543,59,6,53,134,67,31,42,57,49,42,34,8,62
S01009907,711,41,4,37,142,85,39,34,87,64,72,46,26,147
S01009908,827,142,13,129,264,69,58,48,89,36,40,35,5,81
S01009909,743,112,12,100,195,106,50,35,82,45,55,36,19,63
S01009910,444,64,10,54,142,58,21,16,49,29,22,13,9,43
S01009911,747,137,18,119,238,77,46,34,63,49,45,34,11,58
S01009912,660,160,21,139,172,55,67,27,38,23,50,47,3,68
S01009913,568,96,8,88,118,53,87,19,38,22,68,61,7,67
S01009914,733,168,25,143,197,78,90,19,48,21,37,30,7,75
S01009915,686,166,16,150,203,63,65,21,42,21,37,31,6,68
S01009916,703,83,7,76,137,76,109,31,62,16,105,97,8,84
S01009917,536,122,20,102,178,67,34,18,38,20,26,22,4,33
S01009918,546,115,9,106,177,55,43,15,39,25,32,26,6,45
S01009919,851,85,9,76,196,126,46,44,128,81,52,36,16,93
S01009920,741,159,11,148,236,105,34,38,59,42,21,16,5,47
S01009921,576,96,5,91,183,95,21,36,52,16,26,14,12,51
S01009922,893,191,19,172,283,135,40,50,65,33,29,21,8,67
S01009923,728,74,6,68,218,119,40,49,81,62,34,19,15,51
S01009924,850,139,18,121,230,134,43,43,84,55,43,34,9,79
S01009925,584,111,10,101,177,103,17,22,58,26,24,14,10,46
S01009926,606,81,8,73,205,66,33,30,61,42,40,33,7,48
S01009927,399,68,8,60,94,51,26,21,55,33,22,11,11,29
S01009928,701,192,31,161,254,66,51,16,46,18,20,10,10,38
S01009929,378,83,11,72,114,52,31,19,22,22,12,7,5,23
S01009930,726,116,13,103,222,105,49,41,80,27,30,12,18,56
S01009931,671,143,19,124,243,99,37,30,40,18,12,5,7,49
S01009932,539,88,9,79,179,80,35,25,45,34,16,9,7,37
S01009933,721,48,4,44,139,82,29,62,98,122,84,49,35,57
S01009934,696,126,21,105,204,94,43,38,77,36,30,27,3,48
S01009935,399,16,1,15,50,45,14,39,96,78,49,33,16,12
S01009936,518,50,4,46,103,63,27,32,77,80,48,31,17,38
S01009937,336,9,4,5,38,35,13,24,48,57,66,47,19,46
S01009938,681,33,4,29,106,71,38,61,141,125,62,46,16,44
S01009939,664,8,0,8,44,51,21,40,118,116,217,160,57,49
S01009940,636,9,1,8,49,65,28,57,160,151,85,61,24,32
S01009941,739,39,2,37,129,99,70,48,114,60,68,54,14,112
S01009942,763,8,0,8,66,80,29,53,158,191,115,91,24,63
S01009943,631,9,4,5,46,63,24,50,147,168,81,56,25,43
S01009944,590,31,1,30,83,93,38,49,112,80,35,21,14,69
S01009945,683,26,4,22,96,109,31,48,154,96,64,38,26,59
S01009946,619,26,7,19,112,85,29,42,113,113,45,33,12,54
S01009947,416,31,4,27,73,48,21,31,82,57,45,30,15,28
S01009948,595,23,6,17,73,68,38,42,123,110,61,35,26,57
S01009949,590,42,1,41,103,93,27,56,101,67,49,24,25,52
S01009950,547,132,21,111,165,49,42,15,36,23,21,13,8,64
S01009951,576,180,18,162,142,32,67,7,33,15,32,28,4,68
S01009952,525,110,22,88,155,75,32,22,44,21,20,13,7,46
S01009953,669,118,18,100,183,87,46,39,69,53,26,22,4,48
S01009954,493,68,14,54,103,61,55,15,56,25,48,40,8,62
S01009955,716,108,12,96,151,102,41,38,101,62,48,36,12,65
S01009956,539,47,7,40,114,82,38,39,68,50,45,29,16,56
S01009957,558,150,15,135,161,66,50,25,36,19,8,5,3,43
S01009958,694,136,14,122,223,107,47,34,64,27,14,8,6,42
S01009959,468,102,13,89,137,55,43,15,37,16,19,17,2,44
S01009960,611,131,21,110,175,85,45,17,44,18,29,25,4,67
S01009961,508,35,7,28,127,82,41,38,67,48,25,18,7,45
S01009962,810,93,11,82,206,145,50,70,113,62,32,19,13,39
S01009963,605,56,11,45,159,103,58,54,61,45,12,9,3,57
S01009964,701,109,19,90,219,94,56,39,59,32,32,22,10,61
S01009965,546,44,11,33,142,99,37,40,75,49,18,9,9,42
S01009966,597,47,15,32,129,113,31,55,89,60,18,9,9,55
S01009967,626,116,27,89,222,90,42,25,49,19,12,5,7,51
S01009968,468,17,7,10,103,106,34,34,75,45,15,11,4,39
S01009969,626,117,24,93,164,90,54,34,58,29,24,14,10,56
S01009970,655,10,2,8,52,89,23,53,142,135,95,53,42,56
S01009971,834,28,6,22,109,84,52,67,160,189,92,53,39,53
S01009972,578,36,6,30,133,81,46,54,73,68,41,31,10,46
S01009973,553,20,3,17,86,73,26,47,109,116,37,23,14,39
S01009974,434,8,0,8,24,49,18,31,105,114,68,43,25,17
S01009975,580,5,0,5,35,47,23,40,149,137,113,94,19,31
S01009976,372,4,0,4,36,43,14,27,82,99,49,37,12,18
S01009977,738,13,1,12,67,60,17,54,141,206,135,88,47,45
S01009978,747,16,6,10,77,64,27,59,177,158,103,69,34,66
S01009979,408,4,0,4,31,39,16,31,96,122,54,40,14,15
S01009980,481,6,2,4,33,47,10,30,98,124,94,69,25,39
S01009981,496,17,3,14,52,47,12,35,100,121,83,53,30,29
S01009982,748,27,4,23,99,78,43,43,132,164,93,68,25,69
S01009983,418,10,0,10,25,29,7,21,88,82,117,84,33,39
S01009984,567,16,2,14,63,74,39,57,97,114,63,42,21,44
S01009985,456,5,1,4,30,35,16,42,115,90,96,65,31,27
S01009986,409,10,0,10,34,55,7,28,80,110,68,43,25,17
S01009987,618,12,1,11,55,87,31,61,151,132,62,37,25,27
S01009988,388,5,0,5,31,45,8,30,88,93,59,38,21,29
S01009989,612,23,2,21,95,105,33,38,128,97,42,26,16,51
S01009990,524,28,5,23,81,105,22,44,100,81,19,10,9,44
S01009991,601,30,8,22,103,121,31,59,107,63,30,20,10,57
S01009992,512,6,1,5,47,65,19,42,134,104,71,39,32,24
S01009993,626,44,3,41,126,102,42,50,105,92,16,8,8,49
S01009994,512,21,5,16,99,100,26,53,97,60,21,12,9,35
S01009995,517,26,4,22,90,111,25,50,89,57,19,11,8,50
S01009996,542,26,6,20,90,82,29,54,100,83,27,15,12,51
S01009997,441,23,4,19,88,85,20,33,82,42,26,17,9,42
S01009998,458,51,13,38,102,62,49,26,41,42,35,28,7,50
S01009999,540,42,7,35,121,102,25,49,85,44,25,15,10,47
S01010000,476,16,1,15,99,84,22,36,102,55,27,12,15,35
S01010001,567,42,7,35,108,96,28,44,96,69,31,23,8,53
S01010002,608,30,2,28,120,104,34,51,106,69,35,22,13,59
S01010003,546,48,11,37,122,98,29,48,94,48,18,10,8,41
S01010004,546,60,10,50,153,84,44,19,57,41,23,18,5,65
S01010005,620,51,7,44,135,119,30,48,89,56,53,26,27,39
S01010006,727,80,9,71,204,115,22,48,87,85,37,18,19,49
S01010007,719,94,16,78,213,117,48,36,70,55,18,10,8,68
S01010008,537,80,8,72,164,88,28,32,62,36,21,12,9,26
S01010009,505,46,5,41,132,76,24,38,73,51,33,19,14,32
S01010010,773,110,18,92,238,98,57,33,99,44,25,20,5,69
S01010011,601,64,13,51,177,99,26,44,71,65,34,14,20,21
S01010012,624,39,6,33,133,121,44,45,84,62,40,33,7,56
S01010013,659,76,12,64,190,95,33,46,83,50,34,17,17,52
S01010014,830,112,20,92,223,127,50,49,94,66,51,39,12,58
S01010015,696,115,13,102,195,102,41,39,57,33,32,20,12,82
S01010016,513,11,3,8,77,70,31,43,108,96,38,25,13,39
S01010017,555,11,5,6,49,72,19,33,117,122,76,39,37,56
S01010018,695,24,4,20,111,103,31,57,136,145,44,34,10,44
S01010019,522,3,2,1,53,56,18,42,121,107,91,55,36,31
S01010020,547,15,5,10,62,90,24,48,115,114,38,31,7,41
S01010021,597,15,0,15,43,43,26,46,115,116,120,91,29,73
S01010022,735,32,1,31,103,90,27,61,133,146,90,60,30,53
S01010023,455,6,2,4,43,38,14,50,100,115,67,50,17,22
S01010024,586,35,1,34,86,58,17,38,116,117,52,36,16,67
S01010025,438,17,0,17,54,39,25,37,72,87,70,53,17,37
S01010026,725,55,9,46,135,59,29,43,115,130,77,53,24,82
S01010027,719,59,7,52,160,77,29,42,83,91,59,43,16,119
S01010028,471,34,1,33,77,46,11,44,71,85,55,36,19,48
S01010029,485,12,4,8,57,50,16,49,89,126,55,42,13,31
S01010030,676,116,15,101,140,74,15,50,82,79,29,23,6,91
S01010031,725,132,11,121,163,68,21,46,40,31,49,33,16,175
S01010032,802,76,4,72,111,62,21,32,51,42,90,76,14,317
S01010033,728,48,4,44,107,82,36,47,118,93,100,74,26,97
S01010034,799,40,5,35,89,54,18,57,109,166,77,57,20,189
S01010035,545,15,1,14,41,39,14,61,95,83,112,85,27,85
S01010036,767,67,8,59,117,58,24,32,52,29,30,25,5,358
S01010037,476,15,0,15,41,54,14,38,92,124,63,45,18,35
S01010038,782,28,1,27,101,64,31,58,143,161,79,63,16,117
S01010039,921,143,12,131,186,73,37,44,49,39,35,28,7,315
S01010040,651,74,8,66,158,81,34,33,83,72,43,28,15,73
S01010041,608,88,4,84,116,49,27,42,49,45,55,45,10,137
S01010042,955,77,7,70,196,122,40,66,100,102,62,38,24,190
S01010043,615,31,4,27,81,61,19,45,111,121,93,55,38,53
S01010044,890,51,6,45,143,114,32,83,135,167,93,74,19,72
S01010045,381,4,1,3,15,30,10,28,89,114,65,50,15,26
S01010046,606,15,3,12,78,75,33,51,115,128,77,53,24,34
S01010047,615,11,4,7,47,61,29,47,127,161,97,74,23,35
S01010048,727,11,2,9,66,75,19,66,152,203,81,54,27,54
S01010049,561,8,3,5,32,35,19,41,144,147,95,65,30,40
S01010050,733,19,1,18,45,63,22,58,147,187,134,95,39,58
S01010051,528,7,2,5,40,48,21,33,107,149,82,63,19,41
S01010052,515,15,2,13,54,61,20,32,116,107,72,47,25,38
S01010053,666,21,2,19,59,55,19,58,145,138,86,74,12,85
S01010054,398,4,0,4,23,30,9,16,90,101,96,77,19,29
S01010055,874,21,2,19,94,98,37,63,173,167,133,89,44,88
S01010056,351,5,0,5,22,32,8,32,93,87,45,29,16,27
S01010057,293,12,2,10,37,29,10,29,58,55,36,26,10,27
S01010058,590,19,7,12,59,57,17,46,121,157,69,46,23,45
S01010059,506,26,3,23,86,73,29,43,79,92,32,13,19,46
S01010060,713,21,6,15,89,81,33,55,140,160,83,58,25,51
S01010061,395,13,1,12,76,70,25,27,65,54,23,13,10,42
S01010062,525,14,0,14,68,62,25,42,119,112,50,38,12,33
S01010063,778,26,7,19,74,80,27,77,167,168,105,66,39,54
S01010064,398,11,2,9,64,47,17,34,78,75,41,28,13,31
S01010065,635,11,4,7,66,53,31,57,162,152,65,49,16,38
S01010066,570,5,0,5,43,44,24,47,131,151,68,53,15,57
S01010067,438,4,1,3,31,37,15,30,109,105,74,42,32,33
S01010068,474,27,3,24,63,49,26,46,111,77,32,20,12,43
S01010069,656,27,8,19,129,106,55,50,128,96,18,11,7,47
S01010070,546,35,11,24,101,81,49,50,92,63,15,8,7,60
S01010071,593,27,10,17,93,85,57,62,96,90,41,30,11,42
S01010072,610,33,5,28,89,75,34,58,141,114,29,17,12,37
S01010073,555,28,7,21,116,98,34,56,85,85,13,9,4,40
S01010074,573,43,4,39,137,97,41,46,81,55,31,20,11,42
S01010075,444,8,3,5,50,54,21,37,112,99,36,25,11,27
S01010076,507,17,2,15,62,65,34,43,103,116,30,22,8,37
S01010077,472,7,3,4,59,58,37,37,108,97,32,28,4,37
S01010078,490,35,12,23,114,83,31,39,74,49,17,11,6,48
S01010079,710,86,25,61,176,114,80,42,65,58,17,13,4,72
S01010080,499,54,16,38,108,102,40,43,62,42,8,2,6,40
S01010081,546,56,13,43,122,96,75,25,57,43,15,14,1,57
S01010082,656,66,11,55,170,101,64,41,77,56,27,18,9,54
S01010083,541,15,1,14,55,83,28,48,105,111,50,37,13,46
S01010084,654,6,1,5,64,96,26,66,156,155,57,43,14,28
S01010085,599,39,6,33,123,119,31,65,94,70,18,4,14,40
S01010086,702,8,4,4,89,69,28,67,170,160,54,34,20,57
S01010087,449,44,11,33,96,76,56,33,70,34,13,8,5,27
S01010088,604,92,14,78,176,73,63,37,64,28,19,11,8,52
S01010089,546,22,6,16,69,86,37,49,98,85,31,18,13,69
S01010090,810,50,18,32,183,133,54,73,115,82,34,25,9,86
S01010091,654,49,9,40,151,89,56,47,106,68,28,14,14,60
S01010092,715,30,5,25,83,92,34,54,149,136,79,63,16,58
S01010093,676,42,14,28,123,114,47,69,103,83,28,18,10,67
S01010094,497,27,5,22,119,102,28,40,66,62,19,13,6,34
S01010095,534,36,8,28,116,102,37,55,77,63,14,5,9,34
S01010096,567,32,5,27,147,94,39,35,90,53,17,10,7,60
S01010097,543,24,6,18,111,87,47,42,96,65,27,19,8,44
S01010098,534,38,8,30,120,84,46,41,72,62,16,9,7,55
S01010099,511,36,4,32,129,93,41,39,60,49,13,8,5,51
S01010100,675,41,5,36,142,94,49,69,111,95,20,17,3,54
S01010101,566,26,8,18,123,101,40,49,98,75,15,6,9,39
S01010102,738,60,9,51,200,128,39,69,73,52,17,12,5,100
S01010103,758,41,5,36,160,129,72,87,96,72,12,6,6,89
S01010104,548,37,8,29,142,85,42,46,67,57,11,7,4,61
S01010105,311,8,4,4,36,30,6,16,71,70,47,30,17,27
S01010106,316,3,0,3,35,18,14,22,72,88,41,25,16,23
S01010107,604,8,1,7,55,57,29,58,122,138,62,36,26,75
S01010108,571,16,2,14,55,65,39,65,126,133,44,32,12,28
S01010109,590,31,4,27,61,63,33,51,112,109,66,51,15,64
S01010110,595,8,1,7,42,58,21,45,119,172,85,60,25,45
S01010111,722,8,1,7,60,50,27,56,142,190,132,102,30,57
S01010112,711,6,2,4,59,48,22,50,159,170,126,90,36,71
S01010113,374,8,3,5,27,40,12,20,80,93,69,41,28,25
S01010114,569,9,3,6,33,48,15,44,139,152,94,68,26,35
S01010115,473,11,1,10,74,56,35,49,88,77,35,24,11,48
S01010116,779,39,7,32,149,113,45,72,128,108,34,20,14,91
S01010117,488,50,10,40,123,63,39,38,61,62,20,11,9,32
S01010118,456,4,0,4,34,37,12,31,108,93,104,77,27,33
S01010119,380,12,0,12,40,25,12,35,83,92,47,30,17,34
S01010120,744,7,3,4,53,62,20,44,168,177,155,109,46,58
S01010121,497,3,0,3,35,43,19,41,148,95,86,65,21,27
S01010122,345,5,3,2,23,24,10,28,71,97,63,44,19,24
S01010123,513,11,2,9,46,50,18,28,127,130,71,53,18,32
S01010124,495,14,6,8,80,65,33,60,101,75,27,14,13,40
S01010125,395,9,3,6,44,49,19,33,79,84,54,34,20,24
S01010126,563,21,6,15,77,57,46,52,109,118,45,31,14,38
S01010127,462,14,6,8,58,60,25,35,94,103,48,33,15,25
S01010128,336,4,3,1,25,28,13,17,83,80,55,37,18,31
S01010129,530,6,0,6,41,40,16,48,113,127,97,67,30,42
S01010130,299,5,2,3,28,29,16,30,79,70,25,16,9,17
S01010131,733,49,8,41,142,117,75,75,94,102,23,14,9,56
S01010132,713,11,4,7,56,84,29,47,152,182,88,63,25,64
S01010133,530,6,0,6,57,68,19,43,119,135,47,28,19,36
S01010134,743,26,4,22,82,86,39,69,142,197,66,42,24,36
S01010135,544,8,2,6,58,63,19,45,134,138,49,38,11,30
S01010136,608,23,6,17,96,89,36,48,117,103,43,21,22,53
S01010137,666,29,7,22,106,96,38,63,129,110,47,30,17,48
S01010138,760,16,8,8,68,79,50,77,160,158,124,65,59,28
S01010139,780,21,3,18,96,111,38,77,158,155,77,51,26,47
S01010140,582,30,7,23,100,106,29,51,104,87,36,25,11,39
S01010141,613,12,3,9,58,45,25,62,123,158,91,67,24,39
S01010142,458,13,7,6,54,47,30,32,102,85,51,36,15,44
S01010143,517,17,4,13,61,62,28,52,121,116,35,23,12,25
S01010144,557,15,2,13,79,67,25,44,112,123,57,34,23,35
S01010145,586,16,3,13,96,71,31,46,119,115,52,33,19,40
S01010146,614,9,1,8,60,57,25,52,136,131,92,65,27,52
S01010147,718,10,4,6,59,68,31,58,173,156,119,79,40,44
S01010148,565,9,2,7,50,47,19,53,114,134,99,74,25,40
S01010149,408,16,0,16,87,53,33,31,57,70,36,33,3,25
S01010150,464,11,2,9,41,53,26,40,111,107,57,41,16,18
S01010151,431,8,0,8,41,57,13,39,89,102,49,36,13,33
S01010152,620,18,5,13,67,101,20,59,109,144,52,32,20,50
S01010153,688,25,9,16,87,81,36,62,134,146,71,59,12,46
S01010154,629,17,4,13,87,86,18,43,138,146,54,46,8,40
S01010155,511,16,3,13,58,68,21,44,111,117,46,34,12,30
S01010156,396,15,1,14,27,50,33,26,79,98,46,29,17,22
S01010157,423,6,1,5,26,50,19,27,90,117,64,45,19,24
S01010158,667,12,1,11,82,95,36,58,137,140,61,39,22,46
S01010159,513,11,1,10,71,56,27,53,111,118,44,34,10,22
S01010160,465,4,0,4,18,28,30,46,96,112,88,57,31,43
S01010161,469,16,4,12,51,48,25,44,112,94,46,34,12,33
S01010162,542,7,1,6,32,52,16,32,117,122,117,80,37,47
S01010163,442,7,1,6,37,51,13,28,96,100,70,53,17,40
S01010164,550,11,6,5,55,51,29,53,108,124,68,51,17,51
S01010165,459,2,0,2,37,42,8,31,101,118,82,60,22,38
S01010166,551,7,2,5,51,53,23,50,140,126,67,49,18,34
S01010167,612,6,1,5,36,65,25,47,142,194,72,40,32,25
S01010168,375,7,2,5,44,54,22,27,83,66,46,26,20,26
S01010169,611,5,0,5,92,57,24,44,152,113,84,60,24,40
S01010170,416,4,0,4,42,37,21,36,96,112,45,28,17,23
S01010171,726,10,2,8,36,51,24,57,163,171,166,125,41,48
S01010172,501,14,1,13,84,73,22,46,80,114,55,38,17,13
S01010173,529,12,1,11,69,75,33,50,125,85,42,31,11,38
S01010174,1251,30,8,22,97,86,79,131,210,282,296,275,21,40
S01010175,344,9,5,4,45,53,18,20,63,85,31,20,11,20
S01010176,495,18,3,15,67,57,26,39,119,92,46,34,12,31
S01010177,541,5,2,3,44,54,21,47,109,114,99,71,28,48
S01010178,708,7,1,6,51,70,23,54,168,147,130,101,29,58
S01010179,640,8,1,7,41,58,14,49,155,174,102,82,20,39
S01010180,386,17,1,16,58,50,27,35,76,59,45,33,12,19
S01010181,450,7,1,6,41,46,23,25,91,107,89,64,25,21
S01010182,552,40,10,30,112,86,44,45,91,73,22,15,7,39
S01010183,320,4,0,4,41,38,9,32,72,64,43,33,10,17
S01010184,462,8,3,5,35,48,18,39,108,113,54,33,21,39
S01010185,445,4,1,3,38,33,20,37,116,115,52,36,16,30
S01010186,501,23,6,17,100,81,39,42,77,71,17,12,5,51
S01010187,528,26,7,19,105,100,27,53,88,67,21,13,8,41
S01010188,561,55,12,43,144,92,50,40,67,50,25,20,5,38
S01010189,730,65,7,58,177,128,58,59,76,67,24,17,7,76
S01010190,573,102,18,84,140,61,71,39,47,23,26,16,10,64
S01010191,521,48,4,44,137,81,46,41,58,46,21,14,7,43
S01010192,627,77,13,64,136,102,49,58,73,53,32,24,8,47
S01010193,575,48,9,39,135,85,53,51,84,52,24,19,5,43
S01010194,472,13,2,11,59,68,18,38,98,93,47,31,16,38
S01010195,390,13,3,10,39,57,22,33,76,81,32,23,9,37
S01010196,561,13,3,10,48,79,13,49,107,149,71,52,19,32
S01010197,500,4,1,3,48,51,12,39,116,124,59,39,20,47
S01010198,748,15,3,12,70,72,29,63,171,181,94,66,28,53
S01010199,375,10,0,10,34,41,11,25,75,91,62,39,23,26
S01010200,487,10,2,8,52,67,24,39,116,119,39,25,14,21
S01010201,453,12,6,6,43,74,26,48,88,111,29,20,9,22
S01010202,520,9,0,9,43,46,18,36,113,104,111,79,32,40
S01010203,504,31,8,23,91,80,29,49,81,72,25,21,4,46
S01010204,589,8,0,8,41,48,13,50,129,146,104,84,20,50
S01010205,534,16,2,14,84,52,23,38,108,110,69,53,16,34
S01010206,338,9,2,7,8,14,11,14,32,26,184,173,11,40
S01010207,459,9,2,7,34,25,20,33,63,72,125,113,12,78
S01010208,745,33,6,27,133,126,38,68,112,115,62,43,19,58
S01010209,677,36,5,31,100,75,24,65,121,127,86,56,30,43
S01010210,641,26,3,23,119,77,29,46,125,125,51,34,17,43
S01010211,634,12,1,11,67,72,17,47,134,145,84,65,19,56
S01010212,779,14,0,14,61,77,15,75,174,162,120,83,37,81
S01010213,657,13,3,10,81,96,15,69,163,140,46,31,15,34
S01010214,717,44,9,35,113,112,43,80,109,118,41,29,12,57
S01010215,608,9,1,8,46,76,20,58,136,142,78,44,34,43
S01010216,464,10,2,8,45,48,22,24,107,93,78,60,18,37
S01010217,598,20,7,13,63,58,12,51,109,100,108,74,34,77
S01010218,790,27,3,24,118,99,40,59,164,119,115,72,43,49
S01010219,382,11,2,9,29,26,12,25,79,49,64,48,16,87
S01010220,433,87,5,82,92,49,23,19,37,20,11,8,3,95
S01010221,394,12,1,11,36,34,7,37,95,78,65,55,10,30
S01010222,414,21,5,16,35,56,15,53,76,76,40,26,14,42
S01010223,462,18,4,14,58,51,19,48,83,80,52,37,15,53
S01010224,727,21,4,17,62,49,21,47,152,161,144,107,37,70
S01010225,636,19,2,17,101,71,14,47,125,111,82,71,11,66
S01010226,565,18,1,17,42,30,30,39,103,74,131,107,24,98
S01010227,454,13,1,12,27,22,15,20,74,74,134,114,20,75
S01010228,499,7,1,6,36,51,17,34,113,146,71,61,10,24
S01010229,787,25,5,20,82,86,30,70,174,170,93,71,22,57
S01010230,772,22,3,19,56,50,19,38,156,143,153,113,40,135
S01010231,712,15,0,15,58,79,27,44,189,146,86,61,25,68
S01010232,792,20,5,15,62,74,31,37,151,183,130,97,33,104
S01010233,705,12,0,12,64,54,27,43,138,133,170,129,41,64
S01010234,793,91,7,84,167,94,38,45,102,81,37,25,12,138
S01010235,742,140,11,129,168,65,13,43,44,27,23,17,6,219
S01010236,618,66,5,61,156,69,27,48,71,46,34,24,10,101
S01010237,543,74,7,67,124,74,23,43,57,46,23,13,10,79
S01010238,704,57,5,52,147,80,37,42,106,66,34,21,13,135
S01010239,612,20,1,19,64,77,17,43,120,137,68,43,25,66
S01010240,580,41,5,36,122,76,17,41,85,87,37,24,13,74
S01010241,830,63,14,49,158,118,34,60,117,120,61,32,29,99
S01010242,644,33,1,32,87,101,25,37,102,93,81,53,28,85
S01010243,833,25,4,21,103,119,27,61,134,141,136,86,50,87
S01010244,591,22,3,19,58,51,20,43,110,105,106,67,39,76
S01010245,741,6,2,4,46,33,29,42,145,235,143,111,32,62
S01010246,649,11,1,10,56,53,20,71,148,134,81,54,27,75
S01010247,581,17,2,15,90,90,27,73,108,98,33,21,12,45
S01010248,738,108,8,100,189,69,30,48,75,54,21,12,9,144
S01010249,617,52,6,46,135,69,16,39,73,67,28,18,10,138
S01010250,676,79,10,69,166,64,22,36,63,43,19,12,7,184
S01010251,558,63,1,62,127,64,26,32,43,33,17,12,5,153
S01010252,521,55,0,55,130,81,22,24,62,47,29,24,5,71
S01010253,481,16,1,15,52,51,15,43,85,82,69,49,20,68
S01010254,841,42,5,37,119,102,33,51,169,154,66,57,9,105
S01010255,523,12,2,10,56,52,28,42,82,109,80,46,34,62
S01010256,676,18,0,18,68,77,38,41,147,137,78,47,31,72
S01010257,770,63,6,57,92,44,23,20,60,52,63,41,22,353
S01010258,1461,99,7,92,99,40,11,13,24,19,21,15,6,1135
S01010259,1089,21,2,19,43,43,17,37,106,114,84,61,23,624
S01010260,1780,141,10,131,144,92,34,47,79,57,47,30,17,1139
S01010261,2373,19,2,17,52,67,16,43,94,121,75,54,21,1886
S01010262,676,18,2,16,53,47,19,57,112,140,66,47,19,164
S01010263,713,109,9,100,150,51,20,18,29,29,19,9,10,288
S01010264,788,137,10,127,138,63,23,30,71,69,55,28,27,202
S01010265,1014,175,21,154,180,60,29,28,28,11,14,9,5,489
S01010266,474,52,6,46,76,25,25,17,21,15,32,25,7,211
S01010267,582,63,2,61,78,26,13,32,24,23,13,7,6,310
S01010268,753,62,4,58,127,52,30,26,60,41,49,39,10,306
S01010269,498,50,5,45,63,38,19,31,35,21,38,29,9,203
S01010270,972,62,5,57,148,82,50,74,115,158,79,56,23,204
S01010271,695,48,6,42,82,38,23,40,43,31,51,44,7,339
S01010272,891,94,5,89,135,69,33,48,118,88,128,97,31,178
S01010273,641,106,7,99,137,58,20,24,26,13,25,23,2,232
S01010274,548,108,6,102,105,39,20,17,36,23,15,11,4,185
S01010275,575,88,10,78,108,37,24,23,23,11,12,6,6,249
S01010276,920,223,27,196,260,82,48,33,42,20,26,11,15,186
S01010277,464,19,2,17,56,55,16,35,80,92,41,32,9,70
S01010278,472,27,2,25,76,34,20,44,90,60,58,46,12,63
S01010279,526,35,5,30,75,47,29,40,64,42,31,19,12,163
S01010280,719,100,12,88,146,87,20,30,55,49,27,21,6,205
S01010281,719,98,6,92,149,61,30,29,52,38,31,20,11,231
S01010282,841,104,4,100,173,67,25,51,86,98,51,32,19,186
S01010283,489,83,5,78,113,39,19,21,39,20,33,24,9,122
S01010284,1339,178,5,173,231,98,36,33,45,41,33,18,15,644
S01010285,719,69,8,61,131,61,33,32,50,46,45,22,23,252
S01010286,1443,114,9,105,107,48,19,21,42,45,49,38,11,998
S01010287,810,93,6,87,147,34,34,30,37,30,23,16,7,382
S01010288,745,131,14,117,141,54,41,19,36,15,18,11,7,290
S01010289,687,204,25,179,191,38,55,26,21,10,20,13,7,122
S01010290,485,63,10,53,95,40,17,25,25,21,32,30,2,167
S01010291,975,72,4,68,136,65,24,37,74,49,46,38,8,472
S01010292,831,121,5,116,166,53,31,29,44,28,30,21,9,329
S01010293,723,59,4,55,98,48,25,38,51,25,53,40,13,326
S01010294,631,56,3,53,71,33,15,23,29,23,36,32,4,345
S01010295,870,87,5,82,117,41,38,36,65,30,45,37,8,411
S01010296,560,50,2,48,76,49,21,22,52,40,47,36,11,203
S01010297,894,63,7,56,126,84,34,68,119,124,94,68,26,182
S01010298,677,60,4,56,122,70,28,42,95,59,44,37,7,157
S01010299,404,23,1,22,43,42,24,29,74,50,65,51,14,54
S01010300,764,63,9,54,123,76,22,33,100,66,71,64,7,210
S01010301,457,39,4,35,73,35,20,23,40,24,36,23,13,167
S01010302,495,17,1,16,41,36,24,52,79,72,114,82,32,60
S01010303,387,7,1,6,35,21,22,23,57,53,113,99,14,56
S01010304,456,27,1,26,58,38,8,34,74,56,59,42,17,102
S01010305,694,64,6,58,107,68,33,54,80,89,65,51,14,134
S01010306,675,90,5,85,148,57,12,27,58,31,49,27,22,203
S01010307,732,145,6,139,184,71,36,21,46,26,17,9,8,186
S01010308,858,160,12,148,215,63,31,27,51,25,36,27,9,250
S01010309,356,10,3,7,26,36,10,29,63,100,56,43,13,26
S01010310,540,12,3,9,41,53,15,57,97,104,88,61,27,73
S01010311,556,5,0,5,37,42,17,45,104,134,118,89,29,54
S01010312,647,5,1,4,46,48,18,42,154,157,128,94,34,49
S01010313,529,18,4,14,33,30,23,38,128,131,86,56,30,42
S01010314,1034,38,3,35,123,96,34,45,158,128,133,107,26,279
S01010315,678,44,4,40,111,81,26,50,116,111,75,58,17,64
S01010316,414,24,3,21,47,39,12,23,103,67,49,41,8,50
S01010317,660,112,5,107,154,55,29,23,38,28,10,8,2,211
S01010318,1497,23,2,21,57,37,26,37,81,44,47,18,29,1145
S01010319,624,92,7,85,127,68,26,41,73,53,23,16,7,121
S01010320,594,69,3,66,103,55,21,30,70,72,48,34,14,126
S01010321,634,52,1,51,127,70,21,39,89,77,46,30,16,113
S01010322,914,224,16,208,243,73,40,37,52,28,21,14,7,196
S01010323,466,14,3,11,31,24,3,27,113,113,94,72,22,47
S01010324,566,4,0,4,54,51,28,45,130,167,51,37,14,36
S01010325,666,7,5,2,62,76,24,49,161,182,74,55,19,31
S01010326,707,10,0,10,51,54,25,48,160,152,152,109,43,55
S01010327,660,33,5,28,86,65,34,57,121,122,75,51,24,67
S01010328,706,28,4,24,100,89,44,62,113,143,66,43,23,61
S01010329,435,17,3,14,59,58,23,44,77,101,33,26,7,23
S01010330,474,7,0,7,28,46,18,31,112,113,89,60,29,30
S01010331,643,18,8,10,65,75,20,63,146,159,68,41,27,29
S01010332,549,1,0,1,50,53,22,54,137,99,90,70,20,43
S01010333,712,16,1,15,74,76,42,59,169,145,64,42,22,67
S01010334,674,16,2,14,97,99,34,61,150,134,46,32,14,37
S01010335,573,11,2,9,52,67,26,45,116,124,70,51,19,62
S01010336,471,11,0,11,27,46,20,27,117,98,94,53,41,31
S01010337,485,6,1,5,38,61,15,40,119,124,45,32,13,37
S01010338,537,9,0,9,48,48,20,52,112,127,86,64,22,35
S01010339,489,11,2,9,52,52,19,35,104,123,62,44,18,31
S01010340,551,15,4,11,62,72,25,56,112,101,56,27,29,52
S01010341,441,11,3,8,68,67,25,34,85,88,21,11,10,42
S01010342,506,24,2,22,100,68,31,63,97,70,9,6,3,44
S01010343,745,37,6,31,161,133,47,83,126,72,20,11,9,66
S01010344,540,10,1,9,41,58,24,54,116,132,74,41,33,31
S01010345,339,45,13,32,97,39,31,20,23,25,16,10,6,43
S01010346,783,87,18,69,174,119,48,54,123,85,31,25,6,62
S01010347,885,31,6,25,96,88,36,67,120,99,93,66,27,255
S01010348,707,28,3,25,93,113,25,80,162,130,38,18,20,38
S01010349,666,14,2,12,82,90,31,74,158,138,43,26,17,36
S01010350,668,14,4,10,75,73,22,62,150,142,86,52,34,44
S01010351,636,35,7,28,104,77,30,58,108,102,39,27,12,83
S01010352,395,14,3,11,55,42,14,32,75,85,47,30,17,31
S01010353,706,19,1,18,62,52,28,63,151,153,131,96,35,47
S01010354,562,21,4,17,73,63,22,47,125,88,51,31,20,72
S01010355,582,26,5,21,69,61,29,48,115,105,81,58,23,48
S01010356,539,33,4,29,102,72,22,56,83,73,41,21,20,57
S01010357,468,16,4,12,57,53,18,41,96,89,62,36,26,36
S01010358,621,19,6,13,52,58,22,51,143,141,88,48,40,47
S01010359,553,15,4,11,45,46,23,39,136,116,84,56,28,49
S01010360,430,16,0,16,58,45,14,27,72,93,57,34,23,48
S01010361,485,16,0,16,41,38,15,52,94,86,94,48,46,49
S01010362,672,24,2,22,50,58,11,61,119,164,127,81,46,58
S01010363,607,94,7,87,197,71,31,27,47,35,26,12,14,79
S01010364,700,118,16,102,213,95,60,35,40,34,25,18,7,80
S01010365,782,201,27,174,257,67,63,25,43,17,23,17,6,86
S01010366,850,167,16,151,263,76,51,36,69,34,31,19,12,123
S01010367,1413,217,20,197,258,71,48,23,47,22,15,9,6,712
S01010368,543,177,25,152,160,58,34,15,21,12,11,6,5,55
S01010369,654,116,9,107,182,60,35,21,58,38,40,28,12,104
S01010370,618,157,19,138,177,40,44,18,21,20,18,10,8,123
S01010371,872,182,19,163,244,59,40,23,26,20,27,19,8,251
S01010372,431,99,13,86,125,41,19,19,25,17,11,7,4,75
S01010373,654,140,11,129,186,53,27,21,36,35,16,9,7,140
S01010374,792,210,22,188,199,48,41,24,26,18,20,15,5,206
S01010375,492,58,3,55,58,18,16,4,21,12,9,4,5,296
S01010376,659,83,6,77,125,39,23,20,32,15,16,13,3,306
S01010377,851,95,8,87,101,52,33,16,48,28,45,35,10,433
S01010378,678,100,8,92,69,26,13,9,15,13,20,10,10,413
S01010379,1044,99,9,90,150,48,24,24,42,29,19,11,8,609
S01010380,847,161,16,145,226,82,35,17,45,39,24,10,14,218
S01010381,561,100,6,94,84,44,15,16,32,22,17,11,6,231
S01010382,763,116,7,109,164,64,25,34,59,44,30,16,14,227
S01010383,575,40,4,36,84,65,26,23,75,60,42,25,17,160
S01010384,736,147,17,130,172,59,25,30,41,37,19,11,8,206
S01010385,749,95,4,91,162,76,34,39,69,56,29,17,12,189
S01010386,768,65,8,57,138,74,35,38,102,100,52,30,22,164
S01010387,940,146,9,137,203,73,27,50,76,69,36,22,14,260
S01010388,867,72,3,69,149,112,37,57,128,112,58,28,30,142
S01010389,967,246,29,217,266,68,40,26,46,33,20,10,10,222
S01010390,981,157,16,141,272,129,36,45,90,60,46,15,31,146
S01010391,707,81,7,74,192,89,31,48,86,51,27,15,12,102
S01010392,630,180,23,157,190,56,34,18,18,10,14,6,8,110
S01010393,880,136,10,126,265,102,32,55,75,45,30,20,10,140
S01010394,640,57,4,53,115,71,39,35,90,89,76,50,26,68
S01010395,840,115,11,104,204,99,36,53,91,59,35,21,14,148
S01010396,863,148,10,138,184,89,31,45,84,78,42,25,17,162
S01010397,475,122,14,108,117,33,20,6,27,18,17,9,8,115
S01010398,909,220,23,197,249,85,49,35,58,26,19,8,11,168
S01010399,946,316,28,288,292,64,25,21,34,13,20,8,12,161
S01010400,891,236,21,215,281,58,53,27,36,31,23,15,8,146
S01010401,592,152,15,137,164,53,30,17,24,20,9,3,6,123
S01010402,855,292,31,261,235,76,38,11,41,17,18,11,7,127
S01010403,836,284,30,254,247,61,46,17,22,12,9,4,5,138
S01010404,622,161,16,145,214,43,59,17,20,23,14,10,4,71
S01010405,660,220,15,205,207,49,43,19,20,15,16,8,8,71
S01010406,735,175,17,158,172,49,42,20,36,25,25,15,10,191
S01010407,819,114,20,94,145,45,23,16,32,20,14,7,7,410
S01010408,369,78,16,62,89,56,29,15,30,28,16,12,4,28
S01010409,491,100,11,89,135,54,42,18,36,18,18,12,6,70
S01010410,424,129,15,114,113,50,25,16,19,12,15,9,6,45
S01010411,738,209,24,185,246,70,37,27,22,17,23,16,7,87
S01010412,694,198,22,176,187,56,40,24,35,37,34,30,4,83
S01010413,503,133,15,118,157,50,36,19,23,15,19,16,3,51
S01010414,771,179,16,163,247,89,38,39,46,32,18,9,9,83
S01010415,776,80,13,67,149,91,55,59,91,98,58,38,20,95
S01010416,523,117,17,100,166,61,33,28,38,22,9,5,4,49
S01010417,428,108,11,97,144,47,24,10,30,12,12,7,5,41
S01010418,894,249,19,230,297,82,46,25,44,24,40,32,8,87
S01010419,772,251,25,226,258,78,33,20,34,25,11,6,5,62
S01010420,476,88,7,81,138,46,28,27,40,33,13,9,4,63
S01010421,637,177,20,157,199,72,35,20,36,16,15,9,6,67
S01010422,778,139,22,117,248,81,42,30,71,49,31,18,13,87
S01010423,661,45,7,38,100,85,24,44,117,94,85,54,31,67
S01010424,635,35,4,31,117,75,30,47,109,96,63,40,23,63
S01010425,819,38,8,30,146,87,32,66,169,116,83,52,31,82
S01010426,582,41,5,36,134,71,35,53,95,61,56,37,19,36
S01010427,703,34,4,30,111,63,37,42,114,99,141,106,35,62
S01010428,507,90,11,79,158,78,22,21,45,24,23,18,5,46
S01010429,725,151,19,132,258,75,34,27,58,33,26,19,7,63
S01010430,645,13,4,9,64,86,36,40,128,119,71,48,23,88
S01010431,514,107,19,88,188,51,29,21,26,25,9,5,4,58
S01010432,698,24,8,16,88,91,31,57,143,113,65,46,19,86
S01010433,537,9,0,9,27,25,33,40,90,70,161,132,29,82
S01010434,473,19,4,15,67,43,14,45,72,85,74,49,25,54
S01010435,443,16,1,15,66,76,15,39,91,79,25,18,7,36
S01010436,634,29,4,25,100,74,37,35,106,105,79,56,23,69
S01010437,406,10,4,6,60,60,12,29,83,77,37,22,15,38
S01010438,592,18,2,16,94,53,20,55,119,97,77,59,18,59
S01010439,772,34,6,28,137,94,25,60,127,140,64,47,17,91
S01010440,490,28,6,22,62,64,18,37,81,83,74,55,19,43
S01010441,686,64,8,56,175,125,27,56,89,74,32,11,21,44
S01010442,587,23,4,19,109,81,25,43,101,92,69,39,30,44
S01010443,378,17,4,13,67,57,29,37,70,57,22,15,7,22
S01010444,496,18,3,15,62,65,26,33,105,104,49,31,18,34
S01010445,581,22,4,18,65,72,31,58,120,104,62,53,9,47
S01010446,649,27,7,20,126,88,55,70,99,95,34,21,13,55
S01010447,747,22,2,20,87,96,38,81,163,115,82,56,26,63
S01010448,644,40,11,29,129,112,36,42,102,81,41,28,13,61
S01010449,571,17,1,16,95,88,21,49,108,116,51,36,15,26
S01010450,605,21,3,18,112,82,26,67,109,98,47,30,17,43
S01010451,600,32,4,28,75,62,38,44,111,99,92,56,36,47
S01010452,569,26,3,23,105,102,23,56,103,89,28,20,8,37
S01010453,513,24,2,22,60,62,31,49,59,83,109,70,39,36
S01010454,572,23,5,18,87,98,27,58,110,97,38,28,10,34
S01010455,697,23,1,22,81,96,43,49,135,143,84,55,29,43
S01010456,386,19,2,17,71,63,21,39,72,53,24,15,9,24
S01010457,466,27,4,23,70,52,34,30,82,81,60,40,20,30
S01010458,557,11,2,9,80,94,25,43,119,87,49,35,14,49
S01010459,409,24,4,20,66,62,22,23,74,58,37,31,6,43
S01010460,532,130,16,114,157,52,47,24,36,25,18,13,5,43
S01010461,519,25,3,22,95,70,17,32,102,81,59,41,18,38
S01010462,614,5,1,4,31,29,19,30,97,103,212,145,67,88
S01010463,567,55,9,46,131,74,47,26,96,50,38,21,17,50
S01010464,369,22,4,18,76,64,30,35,48,46,25,15,10,23
S01010465,769,94,8,86,241,125,29,49,84,58,21,11,10,68
S01010466,753,126,21,105,213,94,37,37,60,36,26,13,13,124
S01010467,596,105,18,87,188,83,38,26,53,20,25,17,8,58
S01010468,726,127,11,116,193,89,47,21,67,38,27,21,6,117
S01010469,473,50,4,46,123,72,19,34,51,34,37,19,18,53
S01010470,536,28,5,23,113,95,40,44,77,74,35,27,8,30
S01010471,472,26,2,24,76,65,16,45,74,82,47,36,11,41
S01010472,449,86,8,78,121,46,19,23,40,30,25,13,12,59
S01010473,630,60,6,54,163,95,24,35,87,67,36,21,15,63
S01010474,672,73,5,68,144,77,24,35,78,69,53,35,18,119
S01010475,560,101,12,89,188,92,22,30,36,24,10,6,4,57
S01010476,747,87,8,79,165,118,40,48,82,69,39,24,15,99
S01010477,559,23,3,20,104,93,23,56,108,87,24,19,5,41
S01010478,776,21,2,19,126,108,46,61,155,143,65,44,21,51
S01010479,735,34,6,28,128,106,31,69,143,113,47,30,17,64
S01010480,417,31,10,21,81,68,28,32,75,52,27,22,5,23
S01010481,459,6,2,4,47,46,21,41,102,86,70,47,23,40
S01010482,547,28,9,19,96,78,35,41,92,90,44,31,13,43
S01010483,758,46,10,36,148,103,44,57,140,131,49,32,17,40
S01010484,428,21,3,18,60,71,22,41,77,73,35,24,11,28
S01010485,684,37,11,26,154,113,38,61,95,77,52,31,21,57
S01010486,709,53,14,39,180,134,63,61,84,58,23,17,6,53
S01010487,683,36,8,28,119,116,34,71,126,101,36,20,16,44
S01010488,559,15,3,12,40,62,17,45,142,109,88,62,26,41
S01010489,719,24,6,18,83,91,26,68,153,132,83,55,28,59
S01010490,508,12,1,11,37,61,17,43,111,91,85,50,35,51
S01010491,610,8,5,3,41,63,24,28,168,111,120,72,48,47
S01010492,395,6,3,3,26,35,14,27,90,96,68,51,17,33
S01010493,473,6,1,5,17,49,19,31,110,102,102,65,37,37
S01010494,464,12,3,9,56,49,23,47,96,84,67,46,21,30
S01010495,626,9,4,5,48,60,16,53,133,142,117,78,39,48
S01010496,598,6,0,6,50,67,14,44,104,152,121,100,21,40
S01010497,547,8,3,5,60,55,29,36,116,100,95,74,21,48
S01010498,624,10,1,9,35,66,16,43,131,165,110,76,34,48
S01010499,586,5,1,4,27,40,16,34,126,125,158,113,45,55
S01010500,732,24,6,18,69,68,24,42,152,153,136,93,43,64
S01010501,673,12,2,10,84,82,29,61,149,145,76,53,23,35
S01010502,599,11,1,10,75,84,34,56,125,112,58,45,13,44
S01010503,503,3,0,3,42,49,16,35,125,128,73,58,15,32
S01010504,389,32,1,31,81,35,124,14,49,34,9,7,2,11
S01010505,423,33,2,31,86,19,114,25,77,39,13,9,4,17
S01010506,629,37,8,29,166,46,136,50,88,68,14,7,7,24
S01010507,588,21,8,13,105,44,85,64,129,83,27,17,10,30
S01010508,736,52,12,40,168,63,122,64,129,85,16,11,5,37
S01010509,735,53,8,45,190,61,118,75,126,69,12,6,6,31
S01010510,571,29,5,24,124,74,51,59,125,71,18,11,7,20
S01010511,620,18,4,14,85,46,36,89,165,128,18,7,11,35
S01010512,420,15,2,13,90,44,37,51,92,70,10,5,5,11
S01010513,576,55,18,37,138,69,70,69,86,53,10,6,4,26
S01010514,504,12,5,7,71,56,40,64,115,107,14,8,6,25
S01010515,600,12,3,9,86,48,28,99,141,146,18,9,9,22
S01010516,477,38,7,31,117,40,98,42,62,53,12,3,9,15
S01010517,642,31,9,22,152,53,54,73,124,83,34,12,22,38
S01010518,510,26,9,17,109,57,38,61,97,76,13,5,8,33
S01010519,542,22,5,17,113,62,32,60,119,85,22,10,12,27
S01010520,667,36,11,25,132,89,41,97,129,105,9,5,4,29
S01010521,563,17,3,14,110,52,62,74,126,93,12,5,7,17
S01010522,441,24,8,16,66,37,46,55,92,75,25,20,5,21
S01010523,433,6,0,6,63,26,28,40,132,106,15,9,6,17
S01010524,415,36,8,28,101,36,82,44,58,46,5,3,2,7
S01010525,486,40,14,26,119,38,91,54,62,49,9,8,1,24
S01010526,581,41,7,34,119,67,102,60,104,67,5,3,2,16
S01010527,658,22,8,14,138,61,51,92,131,118,27,13,14,18
S01010528,445,39,9,30,126,30,71,40,60,36,12,9,3,31
S01010529,528,40,8,32,115,46,81,54,89,66,10,6,4,27
S01010530,501,43,16,27,100,44,114,44,78,55,5,3,2,18
S01010531,803,68,18,50,167,77,134,88,126,100,15,13,2,28
S01010532,411,41,12,29,66,39,81,57,66,36,8,4,4,17
S01010533,419,38,9,29,102,33,63,45,76,41,7,4,3,14
S01010534,654,44,7,37,138,69,81,67,129,72,16,9,7,38
S01010535,524,48,8,40,151,51,83,43,76,41,8,6,2,23
S01010536,631,31,10,21,116,78,53,96,115,107,17,6,11,18
S01010537,630,29,7,22,114,58,54,110,113,107,16,7,9,29
S01010538,585,51,7,44,124,74,63,67,91,71,13,3,10,31
S01010539,913,58,21,37,236,109,99,120,147,107,11,4,7,26
S01010540,475,58,14,44,116,42,66,44,65,48,8,6,2,28
S01010541,649,47,10,37,173,76,96,73,94,63,5,2,3,22
S01010542,673,59,11,48,181,62,99,72,94,63,13,6,7,30
S01010543,470,41,12,29,100,51,119,26,77,38,5,5,0,13
S01010544,625,30,5,25,109,49,78,65,130,112,31,13,18,21
S01010545,509,38,11,27,113,57,77,35,84,72,15,7,8,18
S01010546,544,40,7,33,99,54,74,53,99,88,15,6,9,22
S01010547,567,35,9,26,130,53,99,70,77,62,11,7,4,30
S01010548,487,55,11,44,108,66,80,41,81,32,4,1,3,20
S01010549,660,62,10,52,201,94,45,66,96,61,6,3,3,29
S01010550,397,38,6,32,77,41,34,59,55,51,9,5,4,33
S01010551,485,59,9,50,107,55,88,36,59,47,11,5,6,23
S01010552,582,83,16,67,125,56,80,46,87,64,9,7,2,32
S01010553,486,56,17,39,106,58,100,41,68,23,10,6,4,24
S01010554,563,32,7,25,133,66,63,56,101,75,16,9,7,21
S01010555,711,50,11,39,151,90,67,68,125,94,25,10,15,41
S01010556,670,31,6,25,106,64,39,86,145,118,44,27,17,37
S01010557,440,31,7,24,88,52,18,41,91,75,24,16,8,20
S01010558,586,42,13,29,130,69,57,52,99,83,32,19,13,22
S01010559,491,77,10,67,156,58,42,39,52,32,14,9,5,21
S01010560,487,53,7,46,130,63,47,47,77,36,10,6,4,24
S01010561,495,68,12,56,131,69,49,31,58,51,11,7,4,27
S01010562,553,29,6,23,118,78,42,74,112,67,10,7,3,23
S01010563,390,17,7,10,63,40,24,44,87,79,20,10,10,16
S01010564,386,11,2,9,49,29,36,50,88,83,28,13,15,12
S01010565,492,29,8,21,97,60,26,59,99,79,13,9,4,30
S01010566,798,88,29,59,186,91,110,88,109,55,20,10,10,51
S01010567,795,95,32,63,210,83,113,57,94,47,41,39,2,55
S01010568,742,87,18,69,164,86,95,69,103,71,12,10,2,55
S01010569,675,57,13,44,151,136,99,50,75,58,17,13,4,32
S01010570,777,44,8,36,131,71,57,89,187,120,33,20,13,45
S01010571,626,49,10,39,156,89,46,79,100,78,7,5,2,22
S01010572,590,33,5,28,97,79,34,81,122,100,24,8,16,20
S01010573,406,17,6,11,69,43,24,59,91,81,12,6,6,10
S01010574,416,52,9,43,117,67,29,32,51,33,8,4,4,27
S01010575,511,49,17,32,142,96,35,30,78,36,14,6,8,31
S01010576,613,72,14,58,175,114,51,43,79,37,12,6,6,30
S01010577,659,13,4,9,96,64,41,75,152,128,34,23,11,56
S01010578,436,12,4,8,86,50,33,58,89,71,13,10,3,24
S01010579,580,28,7,21,151,79,47,71,105,51,9,7,2,39
S01010580,444,35,2,33,89,61,25,50,78,64,22,18,4,20
S01010581,402,37,9,28,109,59,22,39,61,43,16,11,5,16
S01010582,346,43,7,36,84,53,35,33,42,23,12,10,2,21
S01010583,742,56,8,48,216,146,45,66,109,54,7,4,3,43
S01010584,580,66,19,47,145,85,60,44,74,43,20,13,7,43
S01010585,595,72,22,50,161,88,52,63,80,36,10,5,5,33
S01010586,591,84,21,63,183,93,48,46,76,30,6,1,5,25
S01010587,527,50,8,42,163,72,39,47,68,44,14,12,2,30
S01010588,460,53,14,39,118,74,34,33,75,38,13,9,4,22
S01010589,482,27,4,23,92,69,27,52,109,69,17,15,2,20
S01010590,600,97,29,68,209,83,53,35,53,29,7,2,5,34
S01010591,531,50,9,41,155,82,26,58,79,41,19,8,11,21
S01010592,402,32,5,27,94,68,20,38,75,50,14,10,4,11
S01010593,465,56,11,45,142,72,44,30,54,34,8,7,1,25
S01010594,488,45,6,39,133,78,34,68,67,34,10,6,4,19
S01010595,555,78,13,65,164,76,32,48,68,47,9,4,5,33
S01010596,609,79,17,62,164,83,74,48,75,48,12,4,8,26
S01010597,481,42,8,34,146,77,42,47,57,32,13,8,5,25
S01010598,728,87,17,70,224,112,48,58,91,58,13,11,2,37
S01010599,447,57,14,43,130,75,27,34,53,38,5,3,2,28
S01010600,698,74,16,58,190,104,64,65,98,50,15,11,4,38
S01010601,450,43,4,39,134,67,38,47,52,36,7,5,2,26
S01010602,422,33,8,25,117,53,30,56,62,48,6,4,2,17
S01010603,600,58,13,45,174,99,37,57,83,55,8,1,7,29
S01010604,344,45,10,35,110,44,29,28,40,18,3,2,1,27
S01010605,668,78,21,57,172,98,65,70,90,43,8,4,4,44
S01010606,581,19,4,15,98,69,49,64,117,109,20,10,10,36
S01010607,603,70,21,49,204,80,60,28,73,51,9,7,2,28
S01010608,477,26,3,23,62,53,20,50,123,77,32,13,19,34
S01010609,429,15,2,13,63,47,21,49,93,100,13,9,4,28
S01010610,525,76,13,63,135,74,41,45,70,43,23,12,11,18
S01010611,717,20,2,18,143,84,37,99,159,121,27,15,12,27
S01010612,567,28,3,25,118,82,32,61,116,86,13,9,4,31
S01010613,522,41,9,32,134,69,21,54,92,77,5,4,1,29
S01010614,411,3,1,2,54,42,15,46,96,106,22,11,11,27
S01010615,639,55,6,49,169,101,25,67,96,78,11,3,8,37
S01010616,640,50,9,41,180,111,36,61,98,54,5,5,0,45
S01010617,688,49,10,39,200,117,41,56,120,66,6,5,1,33
S01010618,600,42,5,37,141,98,46,55,104,71,10,4,6,33
S01010619,499,27,3,24,77,51,33,60,85,107,25,13,12,34
S01010620,545,35,4,31,98,53,18,52,120,93,47,28,19,29
S01010621,741,108,17,91,178,69,56,56,108,72,51,37,14,43
S01010622,469,12,0,12,75,56,22,51,109,90,28,7,21,26
S01010623,548,34,15,19,167,94,28,38,93,49,17,5,12,28
S01010624,519,61,4,57,94,56,15,52,82,76,18,10,8,65
S01010625,578,93,21,72,176,84,64,31,65,20,10,5,5,35
S01010626,619,98,9,89,180,86,63,37,64,42,24,21,3,25
S01010627,637,85,12,73,147,61,63,53,100,69,24,18,6,35
S01010628,792,80,11,69,174,100,65,71,114,114,27,16,11,47
S01010629,654,109,19,90,181,61,62,43,83,62,21,11,10,32
S01010630,441,24,4,20,87,54,44,37,77,60,32,23,9,26
S01010631,462,46,3,43,110,70,32,42,79,55,12,5,7,16
S01010632,681,28,7,21,108,95,57,78,138,115,31,13,18,31
S01010633,704,17,3,14,82,73,34,87,171,160,40,20,20,40
S01010634,476,15,4,11,68,48,37,58,97,117,13,3,10,23
S01010635,577,14,4,10,83,73,36,59,131,112,29,17,12,40
S01010636,625,61,16,45,148,82,67,48,95,79,16,8,8,29
S01010637,445,31,5,26,64,43,37,49,99,77,26,15,11,19
S01010638,585,31,7,24,97,58,57,55,119,118,22,14,8,28
S01010639,871,43,7,36,129,88,51,109,181,172,48,26,22,50
S01010640,693,56,7,49,135,55,69,69,126,100,53,41,12,30
S01010641,726,36,2,34,87,80,40,57,185,146,70,40,30,25
S01010642,686,10,4,6,61,66,45,81,151,163,73,45,28,36
S01010643,511,3,1,2,53,43,26,52,118,132,53,31,22,31
S01010644,492,5,0,5,35,32,26,51,133,138,55,31,24,17
S01010645,445,38,8,30,93,68,35,42,80,62,7,5,2,20
S01010646,520,39,10,29,129,89,29,54,81,51,9,4,5,39
S01010647,522,41,9,32,119,73,35,59,83,64,10,4,6,38
S01010648,522,37,6,31,101,86,37,48,91,75,20,11,9,27
S01010649,415,31,10,21,109,71,32,44,57,51,7,3,4,13
S01010650,392,15,3,12,89,49,43,25,68,42,39,33,6,22
S01010651,533,13,3,10,82,76,48,58,117,86,27,21,6,26
S01010652,590,38,11,27,149,86,34,49,87,68,45,32,13,34
S01010653,482,26,5,21,109,88,33,60,73,63,8,6,2,22
S01010654,603,10,2,8,105,91,46,56,146,97,20,14,6,32
S01010655,657,60,11,49,161,77,135,52,78,58,8,2,6,28
S01010656,335,20,4,16,70,42,40,29,66,45,9,5,4,14
S01010657,498,63,15,48,122,65,79,45,50,38,11,3,8,25
S01010658,562,72,14,58,149,69,69,45,69,50,9,2,7,30
S01010659,501,60,10,50,132,61,66,32,63,42,17,14,3,28
S01010660,437,24,3,21,99,53,47,52,72,62,7,5,2,21
S01010661,449,22,7,15,113,49,44,57,72,65,19,14,5,8
S01010662,554,60,12,48,120,87,88,47,57,47,9,6,3,39
S01010663,709,62,10,52,177,86,115,57,92,75,16,9,7,29
S01010664,619,74,13,61,150,63,128,40,76,47,12,8,4,29
S01010665,686,71,17,54,156,75,108,73,90,77,11,7,4,25
S01010666,680,47,10,37,155,74,91,90,116,55,14,7,7,38
S01010667,523,62,11,51,123,51,90,44,64,50,14,10,4,25
S01010668,834,51,17,34,172,68,163,113,111,99,22,11,11,35
S01010669,417,41,11,30,87,38,76,43,57,52,10,7,3,13
S01010670,522,43,8,35,105,56,85,53,78,58,13,7,6,31
S01010671,576,50,5,45,127,53,93,40,94,63,17,7,10,39
S01010672,468,16,5,11,64,52,65,59,96,73,18,7,11,25
S01010673,696,53,8,45,160,61,135,54,110,87,21,9,12,15
S01010674,715,62,5,57,159,46,162,48,114,81,16,7,9,27
S01010675,480,37,8,29,104,34,105,36,74,63,11,1,10,16
S01010676,713,64,11,53,172,62,119,59,89,65,12,8,4,71
S01010677,363,32,4,28,96,36,63,27,47,42,3,1,2,17
S01010678,472,24,4,20,101,46,76,44,79,73,14,8,6,15
S01010679,421,23,4,19,95,42,61,46,67,51,14,6,8,22
S01010680,472,20,1,19,89,44,74,36,93,84,15,8,7,17
S01010681,759,23,8,15,159,82,87,75,151,102,43,21,22,37
S01010682,731,50,7,43,168,82,141,52,100,97,17,9,8,24
S01010683,738,37,7,30,166,71,139,49,116,102,27,13,14,31
S01010684,612,35,9,26,147,56,142,56,85,63,14,8,6,14
S01010685,472,45,7,38,104,48,104,35,68,41,12,5,7,15
S01010686,523,34,4,30,101,41,115,63,80,53,12,6,6,24
S01010687,607,42,10,32,142,67,101,60,99,65,10,9,1,21
S01010688,560,48,8,40,143,49,140,48,57,52,3,0,3,20
S01010689,557,53,9,44,141,44,113,46,87,48,8,5,3,17
S01010690,466,21,4,17,84,41,96,56,89,55,11,5,6,13
S01010691,563,58,15,43,119,67,141,58,54,37,11,6,5,18
S01010692,538,28,3,25,95,44,88,77,107,64,7,3,4,28
S01010693,363,39,12,27,94,36,82,25,38,26,6,4,2,17
S01010694,425,34,4,30,89,30,81,37,78,51,6,3,3,19
S01010695,545,51,8,43,130,68,92,47,79,41,14,12,2,23
S01010696,721,65,7,58,140,83,93,74,97,117,21,14,7,31
S01010697,845,79,8,71,189,83,121,91,100,89,53,44,9,40
S01010698,560,49,12,37,103,51,92,59,90,76,14,9,5,26
S01010699,463,41,12,29,98,36,72,63,74,42,11,7,4,26
S01010700,457,53,13,40,107,55,57,37,78,44,3,0,3,23
S01010701,774,59,9,50,181,97,71,68,127,107,19,11,8,45
S01010702,747,54,17,37,195,101,104,67,111,63,18,13,5,34
S01010703,642,48,12,36,166,81,105,54,77,63,12,8,4,36
S01010704,471,27,5,22,80,57,31,54,99,88,14,12,2,21
S01010705,819,62,15,47,171,109,79,93,124,104,33,15,18,44
S01010706,490,17,6,11,95,64,44,49,98,72,28,14,14,23
S01010707,540,54,7,47,121,76,96,45,60,41,18,17,1,29
S01010708,412,24,1,23,88,72,48,44,65,42,13,9,4,16
S01010709,534,44,9,35,121,88,46,46,81,60,14,5,9,34
S01010710,553,16,1,15,92,70,37,52,111,112,30,20,10,33
S01010711,544,71,14,57,167,87,49,30,75,39,7,5,2,19
S01010712,525,20,7,13,75,69,28,64,104,106,21,14,7,38
S01010713,585,25,9,16,93,64,40,70,137,112,17,10,7,27
S01010714,531,21,6,15,66,58,37,61,112,120,27,17,10,29
S01010715,511,24,4,20,81,65,41,58,124,85,17,4,13,16
S01010716,649,46,6,40,127,81,46,55,130,113,27,16,11,24
S01010717,472,49,11,38,129,84,33,39,76,34,7,5,2,21
S01010718,702,45,6,39,175,103,66,68,108,75,25,14,11,37
S01010719,460,54,8,46,103,49,44,48,70,53,11,7,4,28
S01010720,520,80,13,67,131,46,62,38,74,48,10,8,2,31
S01010721,477,57,7,50,137,60,62,32,62,36,12,8,4,19
S01010722,605,57,12,45,155,61,67,60,100,49,14,7,7,42
S01010723,671,93,23,70,166,73,108,49,79,46,10,6,4,47
S01010724,635,79,20,59,149,77,88,51,88,60,12,4,8,31
S01010725,554,79,15,64,142,65,106,29,61,32,7,5,2,33
S01010726,697,70,18,52,189,97,81,53,95,60,13,7,6,39
S01010727,491,72,21,51,123,73,66,28,57,34,7,5,2,31
S01010728,388,48,12,36,124,45,46,27,44,20,9,3,6,25
S01010729,558,67,15,52,132,80,79,49,57,57,7,3,4,30
S01010730,651,64,12,52,189,80,113,47,51,54,11,7,4,42
S01010731,679,62,12,50,154,64,89,58,106,83,19,7,12,44
S01010732,621,20,3,17,60,67,43,71,152,129,43,26,17,36
S01010733,414,6,1,5,44,49,22,44,108,85,36,25,11,20
S01010734,665,25,7,18,80,55,42,62,153,150,52,41,11,46
S01010735,447,13,4,9,62,31,24,42,96,106,50,36,14,23
S01010736,391,26,4,22,102,50,33,44,74,43,5,2,3,14
S01010737,804,41,6,35,150,80,63,81,152,153,40,28,12,44
S01010738,411,11,2,9,55,44,26,52,92,96,17,14,3,18
S01010739,643,30,1,29,111,61,46,82,122,129,36,24,12,26
S01010740,361,8,3,5,45,40,12,33,90,89,35,21,14,9
S01010741,439,23,4,19,83,54,48,48,75,66,18,10,8,24
S01010742,516,24,5,19,70,53,17,69,132,94,33,19,14,24
S01010743,499,12,1,11,63,45,19,67,123,94,47,33,14,29
S01010744,796,36,9,27,179,74,63,102,139,127,29,19,10,47
S01010745,465,26,6,20,79,52,39,59,85,84,23,14,9,18
S01010746,777,49,15,34,161,95,108,73,132,92,26,20,6,41
S01010747,622,32,9,23,100,70,46,70,125,108,40,26,14,31
S01010748,479,29,7,22,95,61,75,43,82,56,17,12,5,21
S01010749,467,37,10,27,93,54,65,43,63,72,15,6,9,25
S01010750,481,33,6,27,108,48,84,40,83,56,20,14,6,9
S01010751,534,17,2,15,60,57,48,65,110,111,50,32,18,16
S01010752,544,23,2,21,96,62,40,63,105,104,27,15,12,24
S01010753,765,35,7,28,136,75,79,82,147,105,57,38,19,49
S01010754,473,30,8,22,85,47,45,53,98,74,21,14,7,20
S01010755,456,20,2,18,72,54,39,60,110,75,11,9,2,15
S01010756,477,36,5,31,107,76,61,38,79,46,11,6,5,23
S01010757,569,39,12,27,106,71,101,65,87,66,17,13,4,17
S01010758,506,37,12,25,104,56,76,58,74,57,11,5,6,33
S01010759,439,22,3,19,76,48,45,50,84,69,12,7,5,33
S01010760,397,44,11,33,91,44,42,40,56,50,15,9,6,15
S01010761,402,38,10,28,80,30,65,54,70,31,15,5,10,19
S01010762,435,26,8,18,95,55,81,35,70,43,8,6,2,22
S01010763,475,30,4,26,89,52,81,41,67,68,23,9,14,24
S01010764,429,35,8,27,98,43,80,40,64,43,6,4,2,20
S01010765,746,52,15,37,133,74,120,72,135,104,20,13,7,36
S01010766,560,28,5,23,122,55,77,59,99,74,21,11,10,25
S01010767,506,22,4,18,80,48,48,65,99,101,26,15,11,17
S01010768,410,11,1,10,65,52,44,49,73,74,23,14,9,19
S01010769,381,32,8,24,91,41,78,33,48,34,6,2,4,18
S01010770,646,28,8,20,98,70,86,81,122,96,34,23,11,31
S01010771,621,25,3,22,112,54,108,80,112,84,24,12,12,22
S01010772,617,31,7,24,110,59,99,56,101,94,46,35,11,21
S01010773,604,39,7,32,108,88,96,63,100,75,17,9,8,18
S01010774,529,37,8,29,89,53,79,50,106,60,34,23,11,21
S01010775,494,27,5,22,102,65,81,47,79,64,10,8,2,19
S01010776,402,14,2,12,83,41,38,38,86,66,24,13,11,12
S01010777,380,13,5,8,59,36,28,38,86,69,28,17,11,23
S01010778,356,7,1,6,40,28,18,40,79,71,52,36,16,21
S01010779,564,22,8,14,78,51,37,58,123,100,67,44,23,28
S01010780,406,21,3,18,76,53,23,39,83,75,24,16,8,12
S01010781,600,55,8,47,128,80,64,63,82,73,17,9,8,38
S01010782,439,25,4,21,69,48,59,46,78,57,41,26,15,16
S01010783,419,12,3,9,48,46,21,62,96,82,32,18,14,20
S01010784,529,13,3,10,58,49,23,61,130,115,58,35,23,22
S01010785,532,43,9,34,123,74,46,52,86,76,12,8,4,20
S01010786,485,24,4,20,102,78,36,46,91,59,17,11,6,32
S01010787,655,47,10,37,119,82,120,64,102,76,20,13,7,25
S01010788,461,30,3,27,83,57,66,51,87,60,12,9,3,15
S01010789,551,28,5,23,97,48,96,55,99,77,18,8,10,33
S01010790,512,30,6,24,89,47,98,58,78,73,18,15,3,21
S01010791,642,55,7,48,145,62,113,63,95,58,20,10,10,31
S01010792,461,33,3,30,58,45,27,63,99,93,22,12,10,21
S01010793,485,44,10,34,110,46,71,40,79,61,13,7,6,21
S01010794,412,48,10,38,85,53,49,57,54,36,10,6,4,20
S01010795,727,62,16,46,135,96,64,81,112,111,31,12,19,35
S01010796,630,59,7,52,137,65,120,71,78,55,8,3,5,37
S01010797,581,58,10,48,141,67,77,73,82,48,13,8,5,22
S01010798,494,56,9,47,100,52,74,50,77,49,9,4,5,27
S01010799,681,65,6,59,157,71,66,69,109,83,30,16,14,31
S01010800,537,16,4,12,76,59,32,71,134,104,27,14,13,18
S01010801,525,24,3,21,96,51,34,56,132,86,26,17,9,20
S01010802,419,38,5,33,91,43,32,51,68,58,17,8,9,21
S01010803,428,30,7,23,79,41,30,53,80,51,28,13,15,36
S01010804,431,47,5,42,97,63,32,48,59,48,9,6,3,28
S01010805,637,59,10,49,152,81,43,75,101,62,21,9,12,43
S01010806,678,39,4,35,120,73,34,75,134,107,64,45,19,32
S01010807,408,32,5,27,81,45,27,55,82,53,12,5,7,21
S01010808,388,52,6,46,97,53,19,40,59,38,10,5,5,20
S01010809,584,75,14,61,149,66,47,57,81,65,19,11,8,25
S01010810,370,26,9,17,85,30,53,50,53,43,12,8,4,18
S01010811,659,60,12,48,139,61,119,68,102,58,20,6,14,32
S01010812,373,12,4,8,65,25,76,36,74,56,15,8,7,14
S01010813,424,14,5,9,77,32,88,48,76,64,7,2,5,18
S01010814,484,43,10,33,90,37,128,37,73,48,12,4,8,16
S01010815,341,12,3,9,88,38,47,37,60,38,6,4,2,15
S01010816,419,113,28,85,113,51,40,17,28,13,12,9,3,32
S01010817,656,161,23,138,182,88,69,18,48,22,20,14,6,48
S01010818,698,156,22,134,192,85,63,36,69,32,20,6,14,45
S01010819,581,73,15,58,134,80,48,51,103,52,16,11,5,24
S01010820,396,77,18,59,106,53,50,19,37,22,6,4,2,26
S01010821,436,96,17,79,127,52,51,24,31,20,5,4,1,30
S01010822,567,117,21,96,156,45,57,18,48,21,61,57,4,44
S01010823,346,15,3,12,65,59,33,23,50,55,17,17,0,29
S01010824,524,61,18,43,169,88,38,28,53,34,7,4,3,46
S01010825,245,29,3,26,78,44,17,23,24,16,2,1,1,12
S01010826,581,91,23,68,161,88,50,26,69,31,16,11,5,49
S01010827,476,43,13,30,125,96,24,46,53,29,8,6,2,52
S01010828,928,117,29,88,279,152,58,59,99,52,18,9,9,94
S01010829,731,116,33,83,199,125,68,36,93,46,13,11,2,35
S01010830,442,30,8,22,107,68,26,30,56,63,13,6,7,49
S01010831,432,58,17,41,117,69,25,30,48,20,11,6,5,54
S01010832,593,28,6,22,134,105,32,47,107,66,24,14,10,50
S01010833,701,124,19,105,202,99,53,55,56,35,6,5,1,71
S01010834,702,104,26,78,225,141,45,29,62,32,7,4,3,57
S01010835,510,65,17,48,167,91,30,24,48,25,7,5,2,53
S01010836,616,94,18,76,177,86,45,42,65,48,22,14,8,37
S01010837,501,24,9,15,96,92,29,41,102,61,12,8,4,44
S01010838,610,33,6,27,116,115,26,57,114,94,12,7,5,43
S01010839,504,38,12,26,107,92,35,41,84,47,14,9,5,46
S01010840,376,32,6,26,101,65,20,25,58,38,15,9,6,22
S01010841,603,60,12,48,167,104,26,53,83,54,20,10,10,36
S01010842,659,37,3,34,115,115,33,51,104,108,49,36,13,47
S01010843,480,31,9,22,98,90,28,40,84,68,18,12,6,23
S01010844,512,59,9,50,141,99,20,41,50,34,6,1,5,62
S01010845,477,30,5,25,111,79,26,44,74,57,16,9,7,40
S01010846,596,17,4,13,86,89,30,58,123,98,36,19,17,59
S01010847,509,43,11,32,149,92,17,48,61,46,13,9,4,40
S01010848,503,9,0,9,49,53,15,44,123,127,35,23,12,48
S01010849,687,11,2,9,80,70,35,53,137,175,44,33,11,82
S01010850,609,6,1,5,62,56,21,57,135,159,63,42,21,50
S01010851,574,12,1,11,74,79,14,38,121,148,51,31,20,37
S01010852,565,18,7,11,57,75,36,52,129,136,23,20,3,39
S01010853,663,28,5,23,94,92,38,64,131,135,26,16,10,55
S01010854,660,20,1,19,76,86,27,43,155,130,61,39,22,62
S01010855,412,5,1,4,41,57,20,31,104,90,22,17,5,42
S01010856,633,16,5,11,88,97,31,68,121,120,47,30,17,45
S01010857,629,33,5,28,119,110,23,62,112,77,26,16,10,67
S01010858,522,11,0,11,75,64,15,43,120,120,31,18,13,43
S01010859,538,13,3,10,52,61,21,39,140,135,37,28,9,40
S01010860,487,17,5,12,73,77,14,53,108,93,24,15,9,28
S01010861,477,19,8,11,59,57,17,27,116,113,35,20,15,34
S01010862,420,11,5,6,38,33,9,37,98,103,46,32,14,45
S01010863,566,62,12,50,166,88,25,32,72,55,12,7,5,54
S01010864,431,61,6,55,147,77,18,28,38,18,6,2,4,38
S01010865,536,78,14,64,177,87,32,21,44,35,11,8,3,51
S01010866,482,64,7,57,134,71,34,31,55,50,13,9,4,30
S01010867,472,70,16,54,131,68,49,27,47,29,8,8,0,43
S01010868,580,66,5,61,161,96,29,32,64,50,37,35,2,45
S01010869,565,73,15,58,164,104,40,30,48,30,20,14,6,56
S01010870,565,56,12,44,170,90,34,32,85,49,14,9,5,35
S01010871,626,62,10,52,160,96,51,41,78,57,19,10,9,62
S01010872,571,35,5,30,112,104,32,49,95,72,20,16,4,52
S01010873,364,11,1,10,50,42,13,35,81,82,30,16,14,20
S01010874,589,61,12,49,154,109,37,31,65,44,17,10,7,71
S01010875,395,31,5,26,95,65,20,21,58,54,15,8,7,36
S01010876,552,21,4,17,102,99,11,48,96,83,30,23,7,62
S01010877,733,56,12,44,151,148,35,51,105,93,42,29,13,52
S01010878,892,28,5,23,127,143,40,80,162,181,87,72,15,44
S01010879,655,31,7,24,129,116,46,53,118,94,26,17,9,42
S01010880,403,10,2,8,57,52,11,47,85,81,31,19,12,29
S01010881,455,17,3,14,84,81,21,42,79,71,18,11,7,42
S01010882,441,18,6,12,94,68,10,46,83,58,18,9,9,46
S01010883,664,37,13,24,136,97,28,57,110,86,31,20,11,82
S01010884,534,9,3,6,60,61,23,47,123,123,57,42,15,31
S01010885,709,20,6,14,108,81,19,53,157,135,84,55,29,52
S01010886,383,11,1,10,54,53,18,29,77,61,42,32,10,38
S01010887,604,6,0,6,62,60,31,38,142,145,67,45,22,53
S01010888,630,28,2,26,93,74,26,55,134,130,45,24,21,45
S01010889,438,15,3,12,51,54,20,30,99,111,44,32,12,14
S01010890,515,10,1,9,58,69,17,50,126,133,31,23,8,21
S01010891,308,7,1,6,20,27,12,27,61,77,43,39,4,34
S01010892,646,20,2,18,83,90,20,56,140,150,55,42,13,32
S01010893,386,9,1,8,28,51,13,34,95,93,33,25,8,30
S01010894,464,26,1,25,86,66,17,41,77,89,31,16,15,31
S01010895,324,8,1,7,48,44,12,16,59,78,40,30,10,19
S01010896,525,10,2,8,66,60,20,46,111,125,44,27,17,43
S01010897,622,14,3,11,60,61,27,52,137,166,64,40,24,41
S01010898,473,7,3,4,44,48,33,45,93,116,53,35,18,34
S01010899,455,16,4,12,79,59,17,39,89,84,22,13,9,50
S01010900,493,14,1,13,59,50,17,48,115,120,41,23,18,29
S01010901,325,5,1,4,21,25,9,28,87,107,26,19,7,17
S01010902,742,35,11,24,109,92,28,75,154,149,52,37,15,48
S01010903,603,9,3,6,54,52,21,60,157,149,69,49,20,32
S01010904,430,12,1,11,32,45,15,33,106,96,54,38,16,37
S01010905,486,28,4,24,94,76,18,28,85,69,43,37,6,45
S01010906,724,29,6,23,95,74,25,54,147,185,59,38,21,56
S01010907,391,41,11,30,105,72,23,24,57,36,13,7,6,20
S01010908,455,27,5,22,78,71,17,32,90,86,23,16,7,31
S01010909,551,33,12,21,127,95,33,43,91,62,17,11,6,50
S01010910,376,10,2,8,48,51,9,26,84,75,48,22,26,25
S01010911,399,10,3,7,59,42,11,33,97,111,18,9,9,18
S01010912,483,19,0,19,49,46,29,34,103,118,42,30,12,43
S01010913,504,27,4,23,109,87,33,33,75,78,17,13,4,45
S01010914,528,16,4,12,87,106,30,47,102,82,16,6,10,42
S01010915,575,26,7,19,85,72,26,53,141,99,18,12,6,55
S01010916,433,5,1,4,32,57,18,27,87,121,37,24,13,49
S01010917,537,22,5,17,83,83,19,57,118,92,34,24,10,29
S01010918,532,7,3,4,66,50,19,51,136,128,34,25,9,41
S01010919,613,12,1,11,74,63,21,56,145,155,40,28,12,47
S01010920,439,20,4,16,36,43,22,34,86,111,50,32,18,37
S01010921,486,7,1,6,43,58,15,49,107,139,34,27,7,34
S01010922,630,15,2,13,70,53,21,57,145,156,48,39,9,65
S01010923,687,14,2,12,80,99,30,53,157,172,42,27,15,40
S01010924,472,4,3,1,54,51,16,52,116,128,24,16,8,27
S01010925,619,6,0,6,70,75,26,45,147,175,37,17,20,38
S01010926,614,7,2,5,56,77,26,57,133,182,32,22,10,44
S01010927,418,9,4,5,53,41,17,38,112,92,35,25,10,21
S01010928,526,10,2,8,50,49,27,39,123,147,41,27,14,40
S01010929,483,5,1,4,38,42,16,53,116,145,27,16,11,41
S01010930,666,132,19,113,200,72,95,26,49,36,15,3,12,41
S01010931,331,44,12,32,73,44,56,18,51,23,5,2,3,17
S01010932,413,21,7,14,79,51,37,36,78,71,25,19,6,15
S01010933,560,102,14,88,155,81,63,28,53,33,16,13,3,29
S01010934,779,125,22,103,227,133,57,43,88,44,20,11,9,42
S01010935,473,70,11,59,125,86,41,25,58,37,8,7,1,23
S01010936,526,39,4,35,110,110,46,45,66,65,15,6,9,30
S01010937,573,49,14,35,140,116,42,48,81,54,10,3,7,33
S01010938,572,16,3,13,79,79,34,60,111,118,46,23,23,29
S01010939,402,27,3,24,78,76,29,43,68,38,10,5,5,33
S01010940,520,76,17,59,148,103,28,27,60,30,6,3,3,42
S01010941,668,73,15,58,189,131,54,42,77,29,12,7,5,61
S01010942,523,68,17,51,151,109,30,29,65,28,6,4,2,37
S01010943,469,22,3,19,88,63,21,54,95,67,29,12,17,30
S01010944,431,13,1,12,71,65,20,38,94,87,21,9,12,22
S01010945,415,15,2,13,66,75,31,43,76,74,15,8,7,20
S01010946,600,19,4,15,92,87,46,61,112,111,39,27,12,33
S01010947,404,15,4,11,66,64,26,36,108,57,17,11,6,15
S01010948,510,23,4,19,71,90,36,41,110,95,16,8,8,28
S01010949,732,77,15,62,180,149,54,61,100,43,11,6,5,57
S01010950,616,49,8,41,139,101,35,56,113,81,16,8,8,26
S01010951,469,25,5,20,87,91,22,48,82,67,13,6,7,34
S01010952,392,38,9,29,69,70,27,41,66,39,14,11,3,28
S01010953,438,23,7,16,82,93,25,33,84,59,8,5,3,31
S01010954,517,39,15,24,113,149,32,31,66,41,5,3,2,41
S01010955,691,91,21,70,199,116,53,32,93,34,23,12,11,50
S01010956,545,88,9,79,134,54,84,32,61,51,15,11,4,26
S01010957,443,65,13,52,111,91,30,35,62,23,6,4,2,20
S01010958,364,51,11,40,88,48,31,20,58,43,9,4,5,16
S01010959,442,51,9,42,119,60,31,29,63,40,13,4,9,36
S01010960,812,57,11,46,135,95,65,65,134,151,54,28,26,56
S01010961,411,21,2,19,65,63,29,38,85,75,15,11,4,20
S01010962,462,18,3,15,75,61,43,43,92,106,9,4,5,15
S01010963,699,65,19,46,151,109,63,50,114,79,23,12,11,45
S01010964,406,25,1,24,75,67,29,36,66,83,5,2,3,20
S01010965,393,17,4,13,56,46,18,39,61,94,36,25,11,26
S01010966,536,20,4,16,88,70,44,61,102,98,15,6,9,38
S01010967,487,25,1,24,65,75,29,52,92,90,22,16,6,37
S01010968,535,32,5,27,106,112,43,46,78,75,15,10,5,28
S01010969,444,36,4,32,99,92,44,33,53,43,21,11,10,23
S01010970,704,61,12,49,133,110,60,76,97,104,24,13,11,39
S01010971,772,62,14,48,183,150,64,73,97,73,20,12,8,50
S01010972,613,20,4,16,61,86,30,57,144,124,46,29,17,45
S01010973,389,15,4,11,59,86,28,41,64,56,11,8,3,29
S01010974,522,9,1,8,56,71,40,46,124,125,25,13,12,26
S01010975,350,8,2,6,37,43,26,36,80,75,25,19,6,20
S01010976,399,20,7,13,64,63,22,33,92,59,23,18,5,23
S01010977,535,30,5,25,93,91,32,47,108,80,17,14,3,37
S01010978,518,19,6,13,77,81,34,51,114,81,33,18,15,28
S01010979,592,23,4,19,82,82,35,58,133,92,41,21,20,46
S01010980,538,39,4,35,86,89,42,34,115,74,23,15,8,36
S01010981,535,26,7,19,88,81,40,53,95,93,30,21,9,29
S01010982,884,143,21,122,237,124,95,64,92,63,34,21,13,32
S01010983,578,49,9,40,111,111,50,53,91,71,18,12,6,24
S01010984,506,48,13,35,117,107,40,36,62,54,20,15,5,22
S01010985,444,25,4,21,74,81,28,45,80,68,16,12,4,27
S01010986,386,47,11,36,100,85,34,27,41,18,6,6,0,28
S01010987,433,61,13,48,143,80,42,24,37,12,4,3,1,30
S01010988,442,57,15,42,132,81,29,17,54,22,7,4,3,43
S01010989,689,95,10,85,220,142,49,52,69,28,6,4,2,28
S01010990,596,28,3,25,84,119,43,64,124,95,15,10,5,24
S01010991,413,45,8,37,87,73,33,35,64,39,9,1,8,28
S01010992,394,82,11,71,124,49,37,23,32,12,7,5,2,28
S01010993,471,35,7,28,128,85,30,36,69,54,8,2,6,26
S01010994,781,158,24,134,243,109,53,32,72,34,16,11,5,64
S01010995,575,51,13,38,155,111,47,42,79,38,9,7,2,43
S01010996,432,72,8,64,116,71,50,26,42,21,4,3,1,30
S01010997,482,84,12,72,142,93,48,21,44,15,4,2,2,31
S01010998,419,97,15,82,132,50,49,13,28,10,8,3,5,32
S01010999,650,110,25,85,183,100,48,37,64,55,24,24,0,29
S01011000,645,70,11,59,139,90,89,52,76,82,11,6,5,36
S01011001,482,10,1,9,75,74,33,46,98,98,18,17,1,30
S01011002,521,14,2,12,71,90,34,59,99,109,17,13,4,28
S01011003,485,11,6,5,63,75,36,60,106,76,18,13,5,40
S01011004,452,42,8,34,98,77,39,31,71,53,14,5,9,27
S01011005,500,17,0,17,80,84,28,56,99,87,18,13,5,31
S01011006,746,55,15,40,175,126,61,62,116,85,34,24,10,32
S01011007,480,13,2,11,47,61,34,62,93,116,18,13,5,36
S01011008,600,22,4,18,86,74,36,75,139,106,31,16,15,31
S01011009,395,10,6,4,51,60,24,50,83,81,21,16,5,15
S01011010,450,25,5,20,76,56,19,29,86,80,56,41,15,23
S01011011,586,21,4,17,63,95,27,52,132,105,61,50,11,30
S01011012,506,17,0,17,48,47,20,53,111,126,52,29,23,32
S01011013,583,21,5,16,83,102,34,54,121,129,15,8,7,24
S01011014,657,38,9,29,111,141,36,66,135,74,18,7,11,38
S01011015,350,20,1,19,72,51,32,22,71,46,22,11,11,14
S01011016,626,70,12,58,181,95,64,49,61,45,19,12,7,42
S01011017,630,103,20,83,161,94,93,37,58,37,10,5,5,37
S01011018,625,37,2,35,130,82,57,50,118,96,18,8,10,37
S01011019,736,102,23,79,157,82,95,62,97,71,32,19,13,38
S01011020,351,59,5,54,91,55,36,31,28,33,7,3,4,11
S01011021,646,14,3,11,93,85,47,65,133,116,52,40,12,41
S01011022,414,7,1,6,38,47,29,53,84,104,24,16,8,28
S01011023,614,32,7,25,90,84,60,58,109,102,41,29,12,38
S01011024,547,12,2,10,67,67,30,52,113,116,51,34,17,39
S01011025,536,10,4,6,57,75,22,60,119,122,40,22,18,31
S01011026,449,5,0,5,45,69,28,54,96,103,27,12,15,22
S01011027,626,13,1,12,54,78,31,54,147,158,55,35,20,36
S01011028,689,14,5,9,74,83,37,70,171,153,52,33,19,35
S01011029,473,18,4,14,67,72,27,39,110,88,25,18,7,27
S01011030,766,43,13,30,153,150,54,69,124,101,12,7,5,60
S01011031,515,21,3,18,55,76,21,49,120,113,42,30,12,18
S01011032,594,21,5,16,84,80,37,43,124,125,42,29,13,38
S01011033,480,37,6,31,101,87,27,46,76,74,11,6,5,21
S01011034,477,30,11,19,74,65,36,44,114,74,26,18,8,14
S01011035,486,27,10,17,67,50,34,47,110,93,32,23,9,26
S01011036,495,38,9,29,108,78,34,40,78,66,15,7,8,38
S01011037,685,24,6,18,94,91,49,72,137,122,56,38,18,40
S01011038,622,10,3,7,55,70,38,75,115,151,64,40,24,44
S01011039,598,30,2,28,107,108,51,61,81,102,27,18,9,31
S01011040,523,18,5,13,64,72,25,55,115,102,30,19,11,42
S01011041,523,17,2,15,67,61,27,33,122,97,51,32,19,48
S01011042,603,53,13,40,131,102,47,58,88,68,22,10,12,34
S01011043,503,22,8,14,84,67,32,53,88,104,27,17,10,26
S01011044,530,26,9,17,72,72,43,48,112,94,31,20,11,32
S01011045,582,39,9,30,95,64,112,59,112,52,23,10,13,26
S01011046,680,40,19,21,115,77,131,77,108,83,22,13,9,27
S01011047,724,49,19,30,150,67,97,94,120,105,12,6,6,30
S01011048,709,27,9,18,106,73,83,85,145,133,21,12,9,36
S01011049,512,24,6,18,64,50,38,64,144,104,9,3,6,15
S01011050,595,35,11,24,119,49,81,69,129,70,16,12,4,27
S01011051,687,48,15,33,120,76,88,88,112,118,14,8,6,23
S01011052,572,44,19,25,107,54,57,72,107,95,13,8,5,23
S01011053,478,15,3,12,68,49,28,68,108,89,23,13,10,30
S01011054,400,38,14,24,69,40,43,51,86,47,8,6,2,18
S01011055,428,30,6,24,90,43,54,49,81,53,11,8,3,17
S01011056,501,45,15,30,81,35,114,37,97,59,7,4,3,26
S01011057,439,16,5,11,61,43,71,44,89,94,7,4,3,14
S01011058,487,24,7,17,103,55,111,31,79,42,8,4,4,34
S01011059,476,31,8,23,96,56,83,36,75,67,15,8,7,17
S01011060,594,39,7,32,107,75,54,55,113,106,16,9,7,29
S01011061,619,13,4,9,61,52,38,91,151,157,27,14,13,29
S01011062,660,26,9,17,84,64,69,77,146,146,15,11,4,33
S01011063,736,28,3,25,90,74,49,90,185,152,32,20,12,36
S01011064,750,39,12,27,114,89,72,88,158,144,21,11,10,25
S01011065,524,38,9,29,88,59,75,54,95,68,16,10,6,31
S01011066,374,26,6,20,79,51,64,34,49,44,14,8,6,13
S01011067,394,30,10,20,62,47,55,50,70,54,14,8,6,12
S01011068,389,14,3,11,63,34,45,43,91,71,9,5,4,19
S01011069,418,20,5,15,84,34,40,47,93,69,12,7,5,19
S01011070,455,23,7,16,93,52,43,55,88,80,3,2,1,18
S01011071,637,35,8,27,147,75,82,67,106,75,17,9,8,33
S01011072,740,33,12,21,156,91,88,92,135,92,22,12,10,31
S01011073,528,26,7,19,83,60,54,65,113,92,7,4,3,28
S01011074,456,18,5,13,78,45,45,58,113,63,14,12,2,22
S01011075,507,8,5,3,40,33,36,62,147,127,38,25,13,16
S01011076,517,13,3,10,62,43,40,84,126,96,34,19,15,19
S01011077,537,4,0,4,57,34,25,57,148,150,40,24,16,22
S01011078,795,43,13,30,141,96,86,103,153,97,28,19,9,48
S01011079,775,26,10,16,135,61,73,127,145,150,28,14,14,30
S01011080,733,26,8,18,98,84,59,115,151,119,43,34,9,38
S01011081,598,15,4,11,64,54,38,95,161,111,23,14,9,37
S01011082,336,9,3,6,36,27,17,53,77,89,16,11,5,12
S01011083,570,29,9,20,118,55,47,80,124,82,19,11,8,16
S01011084,591,43,11,32,150,82,85,54,81,52,16,9,7,28
S01011085,675,61,20,41,185,96,63,54,98,61,16,13,3,41
S01011086,475,43,15,28,105,59,41,58,85,53,10,10,0,21
S01011087,429,15,7,8,74,43,33,66,90,81,13,9,4,14
S01011088,697,47,13,34,173,92,62,54,110,98,25,18,7,36
S01011089,462,15,3,12,82,42,33,44,105,81,31,18,13,29
S01011090,548,46,15,31,118,61,83,55,93,56,8,4,4,28
S01011091,491,44,13,31,104,61,69,57,77,53,11,5,6,15
S01011092,316,11,3,8,49,38,20,27,52,64,27,17,10,28
S01011093,475,46,17,29,121,53,69,55,55,41,9,5,4,26
S01011094,370,40,12,28,103,39,54,33,48,26,7,5,2,20
S01011095,598,57,22,35,147,71,92,59,78,43,13,4,9,38
S01011096,433,38,14,24,105,50,48,47,56,48,8,5,3,33
S01011097,518,50,11,39,129,59,72,51,76,46,9,5,4,26
S01011098,577,27,6,21,138,78,42,55,117,83,9,7,2,28
S01011099,627,12,6,6,87,66,36,75,136,149,28,16,12,38
S01011100,321,12,0,12,55,45,24,35,71,52,9,5,4,18
S01011101,459,10,6,4,36,43,18,68,111,123,24,17,7,26
S01011102,503,10,2,8,70,30,13,60,145,126,33,18,15,16
S01011103,441,16,6,10,75,27,23,49,101,91,34,23,11,25
S01011104,456,39,7,32,118,42,38,42,69,48,33,26,7,27
S01011105,613,27,10,17,106,53,43,69,128,139,22,13,9,26
S01011106,637,17,4,13,174,92,26,54,130,85,32,14,18,27
S01011107,633,28,10,18,150,61,30,66,136,98,17,7,10,47
S01011108,418,15,4,11,74,40,25,52,83,69,19,13,6,41
S01011109,619,32,8,24,109,89,44,76,124,112,16,10,6,17
S01011110,539,13,4,9,77,69,22,70,122,105,26,16,10,35
S01011111,648,11,4,7,77,54,32,70,172,152,48,42,6,32
S01011112,624,34,8,26,148,91,37,86,107,71,15,10,5,35
S01011113,696,28,5,23,123,79,39,87,171,122,18,14,4,29
S01011114,575,21,3,18,122,85,42,78,110,68,14,8,6,35
S01011115,691,12,5,7,84,68,45,100,151,159,31,20,11,41
S01011116,501,19,5,14,89,70,28,64,99,84,12,8,4,36
S01011117,546,68,9,59,137,55,59,44,77,49,16,14,2,41
S01011118,597,88,20,68,169,71,45,43,80,50,11,6,5,40
S01011119,666,83,23,60,196,102,52,43,75,66,11,11,0,38
S01011120,510,68,19,49,165,78,42,32,62,26,13,10,3,24
S01011121,408,25,2,23,65,47,25,48,95,72,12,7,5,19
S01011122,480,25,5,20,113,55,33,54,92,73,9,7,2,26
S01011123,811,21,10,11,118,88,45,112,183,184,24,15,9,36
S01011124,449,20,7,13,97,57,27,46,68,92,9,5,4,33
S01011125,374,9,3,6,50,34,18,50,95,74,21,16,5,23
S01011126,337,10,3,7,69,53,25,36,72,48,10,3,7,14
S01011127,324,4,1,3,119,82,11,12,59,15,5,4,1,17
S01011128,562,29,5,24,111,68,28,59,106,102,23,16,7,36
S01011129,679,128,92,36,190,88,49,47,83,49,13,9,4,32
S01011130,444,15,4,11,94,59,20,33,97,82,26,15,11,18
S01011131,508,32,18,14,134,65,35,46,91,58,14,7,7,33
S01011132,683,61,24,37,175,105,54,73,105,50,16,12,4,44
S01011133,338,17,5,12,53,38,23,43,74,70,7,5,2,13
S01011134,589,21,9,12,158,71,70,49,116,76,11,5,6,17
S01011135,567,14,2,12,89,58,40,77,117,109,27,14,13,36
S01011136,487,29,11,18,102,68,30,72,79,65,14,9,5,28
S01011137,343,24,12,12,82,35,30,39,52,41,13,5,8,27
S01011138,450,6,3,3,84,52,30,55,104,77,22,13,9,20
S01011139,1102,78,71,7,308,466,24,59,76,47,13,4,9,31
S01011140,407,11,2,9,74,48,29,43,80,79,14,8,6,29
S01011141,414,6,3,3,81,51,19,47,94,82,15,6,9,19
S01011142,870,51,16,35,204,74,64,57,80,45,14,6,8,281
S01011143,694,50,19,31,169,82,60,69,137,66,13,8,5,48
S01011144,534,41,16,25,131,80,48,51,85,57,7,6,1,34
S01011145,482,54,19,35,150,47,35,43,78,48,11,7,4,16
S01011146,553,31,9,22,118,68,43,50,114,77,20,9,11,32
S01011147,770,45,14,31,183,96,58,86,159,96,17,9,8,30
S01011148,607,74,20,54,140,47,95,62,75,72,20,15,5,22
S01011149,690,71,31,40,216,186,68,35,35,35,13,7,6,31
S01011150,318,35,22,13,107,31,11,36,43,34,11,4,7,10
S01011151,412,24,12,12,134,68,22,19,56,44,19,4,15,26
S01011152,509,67,18,49,147,62,63,44,60,34,14,10,4,18
S01011153,642,40,8,32,148,68,66,67,117,76,30,18,12,30
S01011154,418,17,6,11,75,48,38,32,89,79,24,12,12,16
S01011155,457,32,5,27,93,51,45,39,89,53,37,15,22,18
S01011156,451,21,1,20,116,67,37,51,75,48,7,6,1,29
S01011157,461,23,5,18,130,76,35,64,77,35,7,3,4,14
S01011158,374,64,17,47,109,48,34,25,54,26,6,6,0,8
S01011159,389,14,5,9,62,61,16,47,82,85,13,6,7,9
S01011160,680,31,8,23,122,108,40,64,160,88,32,17,15,35
S01011161,469,10,2,8,62,45,30,57,123,98,21,9,12,23
S01011162,343,13,3,10,65,48,16,39,69,50,17,6,11,26
S01011163,619,8,6,2,73,72,29,85,159,124,30,17,13,39
S01011164,515,26,6,20,140,73,33,46,97,50,14,4,10,36
S01011165,541,12,1,11,86,59,43,58,120,100,32,17,15,31
S01011166,373,41,8,33,83,64,32,32,56,28,10,7,3,27
S01011167,566,86,24,62,160,72,77,39,61,33,12,10,2,26
S01011168,656,56,20,36,142,68,125,65,89,60,14,8,6,37
S01011169,682,53,19,34,206,95,47,62,100,55,16,8,8,48
S01011170,692,72,24,48,194,79,79,62,92,57,22,13,9,35
S01011171,677,52,12,40,169,61,133,57,105,65,14,6,8,21
S01011172,570,39,8,31,128,46,124,62,82,57,14,6,8,18
S01011173,407,47,9,38,86,41,86,30,57,26,8,4,4,26
S01011174,319,31,7,24,63,34,73,30,44,28,6,5,1,10
S01011175,366,22,2,20,54,42,44,46,65,61,16,9,7,16
S01011176,401,34,10,24,106,35,76,34,35,48,9,5,4,24
S01011177,628,40,11,29,130,60,110,64,109,78,14,9,5,23
S01011178,359,21,10,11,79,48,30,33,67,42,17,7,10,22
S01011179,476,13,3,10,50,54,31,57,82,124,31,21,10,34
S01011180,502,10,2,8,52,34,20,50,104,144,56,35,21,32
S01011181,382,31,10,21,88,50,84,19,42,44,7,5,2,17
S01011182,330,25,5,20,77,36,49,31,52,30,14,11,3,16
S01011183,430,29,9,20,83,46,46,48,64,44,38,20,18,32
S01011184,605,62,15,47,188,94,47,59,67,27,16,9,7,45
S01011185,518,34,8,26,120,82,28,60,82,61,21,15,6,30
S01011186,686,45,11,34,123,101,39,65,120,114,36,24,12,43
S01011187,573,40,13,27,147,97,26,77,86,45,11,2,9,44
S01011188,714,28,7,21,107,101,42,80,152,113,39,15,24,52
S01011189,616,36,9,27,123,100,51,79,89,70,29,11,18,39
S01011190,466,6,2,4,67,66,44,44,96,83,28,18,10,32
S01011191,398,17,6,11,58,45,20,49,79,92,23,12,11,15
S01011192,537,11,2,9,85,64,17,58,121,101,37,15,22,43
S01011193,531,16,5,11,64,56,23,49,117,114,44,30,14,48
S01011194,533,15,4,11,63,51,27,54,107,103,51,21,30,62
S01011195,570,12,3,9,75,74,17,70,136,97,44,17,27,45
S01011196,657,16,4,12,88,72,33,62,141,142,56,28,28,47
S01011197,630,17,4,13,71,70,40,54,138,124,54,33,21,62
S01011198,463,13,2,11,61,49,34,54,90,90,33,19,14,39
S01011199,595,18,3,15,98,84,41,50,130,90,34,17,17,50
S01011200,582,31,9,22,101,83,32,58,108,96,31,17,14,42
S01011201,472,19,3,16,84,72,27,60,90,62,20,15,5,38
S01011202,630,19,7,12,100,82,38,95,111,114,32,18,14,39
S01011203,596,33,6,27,106,83,31,67,130,69,25,13,12,52
S01011204,436,50,8,42,119,69,29,39,60,28,7,3,4,35
S01011205,495,57,12,45,129,77,28,50,63,34,14,3,11,43
S01011206,548,40,13,27,150,69,39,58,77,46,20,5,15,49
S01011207,570,44,9,35,114,80,34,59,96,61,39,28,11,43
S01011208,691,67,26,41,169,117,47,56,92,58,19,9,10,66
S01011209,477,22,6,16,67,73,24,60,94,82,25,13,12,30
S01011210,583,76,28,48,146,77,64,45,63,30,19,12,7,63
S01011211,527,49,10,39,128,77,34,49,72,40,25,16,9,53
S01011212,406,7,1,6,38,32,23,50,95,96,33,22,11,32
S01011213,772,26,7,19,108,74,36,89,155,148,64,39,25,72
S01011214,629,7,1,6,75,78,28,61,123,142,71,41,30,44
S01011215,432,2,0,2,44,44,26,32,102,92,58,28,30,32
S01011216,341,6,1,5,42,42,19,30,82,69,27,7,20,24
S01011217,585,12,1,11,66,67,28,50,136,101,76,36,40,49
S01011218,471,8,1,7,50,40,18,53,87,108,70,42,28,37
S01011219,600,13,1,12,61,67,30,57,139,132,57,28,29,44
S01011220,677,13,4,9,90,67,39,75,160,132,64,39,25,37
S01011221,696,15,2,13,86,87,33,80,152,147,43,24,19,53
S01011222,496,11,5,6,67,75,23,46,108,107,27,13,14,32
S01011223,570,25,3,22,100,101,39,52,96,90,25,11,14,42
S01011224,506,16,5,11,65,49,41,54,104,97,37,25,12,43
S01011225,513,22,7,15,71,55,22,40,107,102,55,33,22,39
S01011226,703,65,15,50,153,100,60,91,105,56,32,19,13,41
S01011227,545,33,6,27,130,60,38,50,87,79,36,21,15,32
S01011228,595,22,7,15,105,85,32,63,115,97,38,23,15,38
S01011229,383,15,3,12,61,45,22,40,63,61,50,31,19,26
S01011230,698,10,1,9,61,52,32,56,176,164,116,70,46,31
S01011231,440,8,2,6,48,40,21,41,125,95,43,29,14,19
S01011232,777,40,6,34,166,72,61,73,140,123,65,39,26,37
S01011233,295,12,0,12,48,36,16,28,42,47,37,29,8,29
S01011234,751,19,8,11,100,58,32,80,132,155,97,56,41,78
S01011235,297,7,1,6,32,36,16,32,59,59,29,19,10,27
S01011236,438,14,3,11,71,38,28,40,106,90,35,23,12,16
S01011237,552,12,2,10,83,57,25,59,86,110,68,42,26,52
S01011238,480,12,2,10,51,52,22,43,97,95,80,50,30,28
S01011239,546,13,4,9,68,59,41,52,109,100,69,34,35,35
S01011240,564,17,5,12,84,57,34,64,106,83,91,42,49,28
S01011241,783,43,13,30,171,77,66,93,118,108,63,34,29,44
S01011242,570,31,6,25,109,82,38,57,112,67,37,22,15,37
S01011243,675,22,2,20,86,64,43,66,140,112,113,66,47,29
S01011244,535,15,3,12,54,64,16,43,118,102,89,48,41,34
S01011245,659,20,5,15,74,75,35,62,146,122,88,49,39,37
S01011246,681,54,11,43,162,80,70,55,111,80,34,8,26,35
S01011247,587,70,13,57,152,91,43,67,66,54,12,8,4,32
S01011248,588,36,10,26,116,80,35,56,119,85,15,11,4,46
S01011249,568,44,10,34,112,112,33,70,76,56,18,7,11,47
S01011250,767,25,3,22,98,81,41,71,188,118,82,45,37,63
S01011251,659,11,3,8,99,60,36,73,144,131,46,32,14,59
S01011252,612,8,2,6,60,63,17,53,157,130,63,36,27,61
S01011253,638,8,1,7,50,56,23,80,162,130,65,46,19,64
S01011254,756,60,17,43,172,121,44,82,115,63,22,10,12,77
S01011255,567,71,14,57,175,85,32,65,64,20,12,8,4,43
S01011256,331,21,10,11,91,53,26,32,46,32,8,6,2,22
S01011257,325,33,8,25,91,48,23,35,43,18,13,6,7,21
S01011258,445,48,10,38,121,44,26,46,61,36,15,8,7,48
S01011259,564,28,5,23,121,91,48,48,99,72,28,16,12,29
S01011260,549,38,7,31,138,86,34,55,75,53,24,15,9,46
S01011261,579,9,2,7,61,49,33,72,116,116,75,53,22,48
S01011262,367,13,2,11,61,49,25,31,91,45,31,21,10,21
S01011263,796,39,7,32,144,125,40,84,149,109,53,34,19,53
S01011264,485,9,4,5,67,45,24,59,90,105,47,24,23,39
S01011265,750,13,5,8,67,71,50,52,165,150,107,51,56,75
S01011266,662,19,5,14,86,80,33,90,147,117,39,23,16,51
S01011267,445,28,2,26,116,63,27,50,60,53,22,11,11,26
S01011268,293,18,5,13,61,37,19,35,40,51,21,12,9,11
S01011269,389,12,4,8,71,46,17,47,56,83,36,18,18,21
S01011270,523,12,2,10,70,62,27,60,105,94,44,17,27,49
S01011271,598,26,3,23,71,74,29,74,116,107,49,23,26,52
S01011272,576,19,3,16,73,63,26,73,97,126,62,27,35,37
S01011273,626,10,1,9,70,69,24,69,125,120,77,43,34,62
S01011274,637,16,3,13,59,75,33,89,137,101,61,38,23,66
S01011275,496,11,2,9,52,41,24,45,119,99,62,43,19,43
S01011276,698,21,4,17,70,74,29,86,147,115,92,51,41,64
S01011277,554,30,8,22,128,101,34,67,91,49,11,7,4,43
S01011278,400,32,9,23,91,81,15,53,55,43,13,9,4,17
S01011279,504,32,8,24,127,99,21,54,81,37,22,17,5,31
S01011280,487,48,12,36,138,76,32,49,57,34,10,5,5,43
S01011281,495,48,12,36,143,70,36,50,48,41,9,4,5,50
S01011282,671,51,13,38,174,115,43,57,89,63,13,9,4,66
S01011283,543,52,8,44,151,93,38,51,60,47,9,6,3,42
S01011284,406,53,17,36,132,63,32,39,27,25,3,0,3,32
S01011285,528,8,1,7,68,63,30,52,134,101,38,17,21,34
S01011286,515,7,0,7,67,70,25,53,97,93,42,22,20,61
S01011287,601,21,7,14,82,72,31,54,136,91,50,25,25,64
S01011288,555,10,2,8,76,66,21,54,136,98,47,27,20,47
S01011289,682,13,3,10,84,74,35,80,158,129,44,24,20,65
S01011290,826,26,6,20,108,94,72,86,165,155,68,37,31,52
S01011291,619,24,7,17,87,78,31,77,115,124,38,15,23,45
S01011292,512,7,2,5,43,40,28,53,137,93,74,37,37,37
S01011293,529,12,2,10,64,43,20,68,105,136,36,17,19,45
S01011294,609,14,2,12,90,70,44,67,103,135,62,31,31,24
S01011295,741,70,9,61,203,121,49,78,71,72,21,9,12,56
S01011296,434,11,3,8,72,61,37,47,67,73,30,12,18,36
S01011297,622,15,3,12,76,70,34,62,125,130,45,26,19,65
S01011298,460,11,5,6,54,41,21,40,107,80,51,30,21,55
S01011299,388,33,10,23,91,38,92,30,41,31,6,4,2,26
S01011300,708,17,3,14,67,76,37,64,153,182,75,36,39,37
S01011301,543,51,13,38,121,91,44,45,68,59,23,11,12,41
S01011302,639,20,7,13,88,85,39,69,108,132,68,39,29,30
S01011303,754,64,11,53,180,125,57,92,101,72,15,7,8,48
S01011304,497,16,8,8,58,48,21,66,85,98,53,34,19,52
S01011305,608,33,3,30,105,65,44,69,95,89,64,36,28,44
S01011306,411,14,4,10,87,43,12,58,68,64,38,16,22,27
S01011307,350,32,6,26,77,55,68,26,44,22,5,5,0,21
S01011308,358,57,17,40,92,30,73,17,30,19,13,7,6,27
S01011309,522,96,21,75,158,77,55,31,49,19,10,6,4,27
S01011310,502,40,3,37,131,61,54,46,69,37,21,12,9,43
S01011311,527,74,13,61,178,71,57,39,54,24,6,3,3,24
S01011312,828,173,34,139,248,97,92,60,56,28,24,12,12,50
S01011313,524,54,8,46,146,74,62,45,65,37,11,6,5,30
S01011314,807,115,21,94,218,95,71,74,89,64,27,11,16,54
S01011315,289,19,4,15,48,22,26,32,55,50,17,10,7,20
S01011316,521,24,5,19,85,51,36,54,97,84,53,34,19,37
S01011317,522,67,11,56,145,89,71,22,43,32,18,8,10,35
S01011318,636,89,15,74,164,93,65,38,90,51,15,8,7,31
S01011319,566,78,13,65,162,82,45,42,66,35,11,7,4,45
S01011320,376,19,2,17,82,55,32,37,64,46,14,10,4,27
S01011321,465,38,5,33,108,67,29,37,90,57,9,4,5,30
S01011322,468,36,7,29,105,75,36,36,67,53,19,9,10,41
S01011323,674,47,8,39,112,76,51,74,138,81,41,21,20,54
S01011324,330,26,7,19,73,50,27,27,51,34,18,12,6,24
S01011325,563,24,3,21,79,66,60,74,95,98,37,16,21,30
S01011326,544,31,8,23,99,56,61,63,113,64,31,15,16,26
S01011327,516,24,7,17,92,64,64,58,83,64,51,37,14,16
S01011328,501,36,4,32,100,52,96,46,74,56,17,11,6,24
S01011329,634,55,8,47,152,85,55,60,104,51,27,10,17,45
S01011330,519,73,19,54,136,95,32,33,67,40,12,8,4,31
S01011331,527,81,21,60,168,81,36,38,58,22,14,11,3,29
S01011332,636,101,18,83,190,93,54,42,68,36,14,7,7,38
S01011333,520,82,15,67,173,84,55,23,42,28,6,1,5,27
S01011334,550,81,16,65,115,73,117,22,51,44,19,11,8,28
S01011335,703,119,27,92,209,109,65,42,57,29,13,7,6,60
S01011336,437,36,11,25,78,59,33,46,84,50,22,13,9,29
S01011337,545,106,26,80,170,75,55,27,32,33,12,7,5,35
S01011338,488,33,5,28,89,54,22,64,74,82,33,11,22,37
S01011339,421,12,2,10,63,45,22,43,93,54,47,38,9,42
S01011340,504,12,6,6,48,62,28,55,119,93,44,19,25,43
S01011341,552,28,6,22,94,65,24,67,100,86,41,22,19,47
S01011342,539,35,14,21,100,100,37,61,90,51,22,9,13,43
S01011343,626,13,5,8,86,59,34,76,140,120,67,39,28,31
S01011344,636,12,2,10,63,66,32,74,130,155,64,30,34,40
S01011345,558,8,1,7,63,37,24,57,138,123,66,29,37,42
S01011346,509,12,4,8,65,66,34,51,97,109,44,29,15,31
S01011347,780,37,10,27,126,103,56,87,163,122,50,27,23,36
S01011348,669,30,9,21,110,96,31,66,115,108,65,31,34,48
S01011349,717,62,18,44,166,125,61,65,93,80,18,5,13,47
S01011350,503,53,13,40,133,85,54,27,60,35,15,10,5,41
S01011351,526,11,2,9,63,61,26,53,111,117,51,25,26,33
S01011352,474,23,4,19,89,68,29,46,83,65,53,30,23,18
S01011353,487,22,8,14,73,64,34,50,86,96,34,24,10,28
S01011354,542,47,7,40,116,83,42,47,78,68,20,6,14,41
S01011355,698,33,12,21,126,116,47,75,126,96,26,13,13,53
S01011356,735,81,13,68,194,65,143,64,82,50,24,17,7,32
S01011357,646,39,6,33,143,103,41,71,87,98,21,13,8,43
S01011358,426,48,13,35,122,75,13,22,52,30,13,7,6,51
S01011359,564,27,5,22,93,66,37,56,109,113,40,24,16,23
S01011360,565,8,1,7,55,51,28,49,133,148,56,30,26,37
S01011361,427,7,1,6,27,31,22,34,90,122,76,40,36,18
S01011362,403,38,10,28,99,69,59,39,45,28,4,2,2,22
S01011363,660,39,14,25,135,91,48,54,112,95,54,39,15,32
S01011364,475,26,5,21,111,79,20,46,79,70,17,7,10,27
S01011365,442,34,14,20,147,76,25,34,47,45,11,6,5,23
S01011366,342,14,1,13,57,64,13,31,65,70,19,14,5,9
S01011367,628,31,3,28,99,84,31,64,153,106,26,16,10,34
S01011368,628,64,11,53,212,114,41,46,52,43,15,10,5,41
S01011369,606,16,1,15,96,90,29,63,117,104,40,19,21,51
S01011370,598,67,16,51,169,104,18,51,79,67,16,12,4,27
S01011371,680,17,1,16,106,86,30,65,140,129,67,25,42,40
S01011372,504,9,2,7,52,51,15,52,102,117,72,38,34,34
S01011373,509,14,3,11,59,51,29,41,122,85,52,22,30,56
S01011374,526,31,8,23,124,116,21,45,75,55,18,13,5,41
S01011375,493,41,13,28,89,89,29,44,75,53,23,5,18,50
S01011376,352,10,1,9,54,51,18,31,82,73,19,6,13,14
S01011377,451,77,13,64,148,79,30,16,30,20,11,7,4,40
S01011378,570,45,17,28,125,122,33,41,95,53,18,9,9,38
S01011379,703,88,12,76,214,140,43,37,54,43,11,5,6,73
S01011380,525,39,7,32,97,115,26,42,67,76,33,25,8,30
S01011381,482,34,8,26,116,99,30,33,68,48,20,8,12,34
S01011382,422,19,6,13,80,39,33,30,74,84,30,18,12,33
S01011383,523,7,0,7,55,61,12,39,128,134,59,32,27,28
S01011384,502,6,0,6,39,34,25,32,119,131,96,55,41,20
S01011385,702,15,2,13,69,68,33,72,142,188,74,43,31,41
S01011386,403,6,4,2,23,26,14,47,103,87,76,44,32,21
S01011387,608,34,5,29,65,58,21,44,133,139,89,54,35,25
S01011388,797,57,19,38,216,131,37,76,107,87,28,16,12,58
S01011389,590,20,6,14,92,84,35,46,101,109,49,32,17,54
S01011390,609,20,7,13,72,70,18,67,138,141,50,28,22,33
S01011391,484,8,4,4,57,52,22,35,133,105,33,21,12,39
S01011392,511,7,2,5,46,45,29,59,125,103,60,28,32,37
S01011393,603,19,7,12,88,90,56,62,117,104,31,13,18,36
S01011394,399,60,15,45,96,71,25,30,35,34,9,5,4,39
S01011395,567,20,3,17,101,77,34,54,121,104,39,26,13,17
S01011396,555,24,8,16,104,86,27,46,111,78,44,30,14,35
S01011397,548,23,7,16,103,65,30,60,85,91,48,30,18,43
S01011398,540,8,1,7,66,59,25,59,102,120,72,39,33,29
S01011399,391,10,2,8,39,56,16,35,92,86,37,21,16,20
S01011400,529,43,11,32,128,91,30,32,81,66,28,14,14,30
S01011401,471,32,13,19,123,78,24,33,60,63,25,22,3,33
S01011402,647,42,11,31,116,117,44,66,115,89,32,18,14,26
S01011403,400,20,6,14,79,56,17,35,64,67,30,23,7,32
S01011404,710,25,5,20,130,109,30,53,139,127,50,30,20,47
S01011405,443,41,11,30,105,69,24,33,66,46,42,29,13,17
S01011406,475,18,7,11,89,53,25,44,101,93,26,14,12,26
S01011407,807,41,9,32,183,142,52,61,110,127,40,20,20,51
S01011408,589,11,4,7,72,79,24,47,157,123,37,19,18,39
S01011409,587,17,1,16,87,74,32,51,120,114,50,29,21,42
S01011410,455,14,1,13,66,80,19,44,107,86,20,11,9,19
S01011411,470,13,3,10,72,69,25,48,98,91,27,12,15,27
S01011412,659,61,20,41,198,113,49,48,83,41,21,12,9,45
S01011413,445,28,6,22,108,87,24,31,59,47,13,10,3,48
S01011414,605,26,6,20,98,98,27,67,101,104,49,30,19,35
S01011415,667,39,12,27,148,112,36,56,109,101,29,15,14,37
S01011416,517,35,8,27,141,99,37,54,59,39,16,12,4,37
S01011417,594,20,4,16,93,99,43,64,106,109,29,17,12,31
S01011418,429,11,3,8,53,44,17,47,100,101,28,13,15,28
S01011419,425,19,1,18,60,72,16,47,74,89,29,17,12,19
S01011420,380,10,1,9,41,33,19,28,84,93,42,23,19,30
S01011421,441,32,10,22,127,77,22,41,54,41,32,21,11,15
S01011422,505,18,3,15,67,61,21,46,105,119,41,23,18,27
S01011423,381,19,3,16,54,34,12,29,78,77,60,41,19,18
S01011424,424,8,2,6,64,55,22,49,86,99,25,14,11,16
S01011425,640,30,8,22,117,64,45,57,114,102,62,39,23,49
S01011426,719,85,16,69,198,97,74,58,76,65,15,8,7,51
S01011427,524,22,3,19,99,57,39,44,94,111,25,14,11,33
S01011428,387,17,6,11,62,51,21,42,65,90,20,14,6,19
S01011429,1021,48,11,37,152,72,108,116,136,217,110,106,4,62
S01011430,680,43,8,35,137,108,51,54,116,103,28,17,11,40
S01011431,798,29,10,19,118,89,44,80,166,161,52,31,21,59
S01011432,819,21,9,12,127,120,30,88,166,183,44,22,22,40
S01011433,640,11,3,8,49,62,23,56,149,163,80,45,35,47
S01011434,423,15,6,9,85,65,24,45,81,71,19,11,8,18
S01011435,712,51,17,34,191,105,48,56,96,83,23,13,10,59
S01011436,544,9,1,8,76,66,33,47,117,118,53,24,29,25
S01011437,552,15,5,10,70,63,36,59,114,120,46,31,15,29
S01011438,406,4,2,2,32,36,20,39,111,95,52,35,17,17
S01011439,657,24,6,18,107,70,51,63,124,137,50,31,19,31
S01011440,443,10,2,8,41,58,21,47,109,124,22,13,9,11
S01011441,603,15,5,10,62,75,33,56,141,138,58,28,30,25
S01011442,492,6,2,4,50,77,35,50,94,119,27,16,11,34
S01011443,464,14,7,7,53,52,26,43,94,116,23,12,11,43
S01011444,570,8,2,6,64,65,33,59,118,147,53,30,23,23
S01011445,406,25,4,21,80,50,23,31,56,94,24,8,16,23
S01011446,387,28,6,22,66,62,53,32,51,53,17,13,4,25
S01011447,636,15,5,10,87,117,41,45,98,147,46,26,20,40
S01011448,705,36,9,27,148,95,61,68,109,97,42,28,14,49
S01011449,393,13,2,11,57,53,25,48,69,86,32,22,10,10
S01011450,471,48,11,37,119,74,40,32,46,55,24,19,5,33
S01011451,540,64,17,47,114,61,77,26,54,32,29,20,9,83
S01011452,737,52,16,36,162,117,62,70,123,83,22,13,9,46
S01011453,525,18,7,11,93,79,27,56,92,102,26,18,8,32
S01011454,571,18,4,14,94,67,29,62,121,111,32,18,14,37
S01011455,559,9,1,8,63,68,29,54,139,106,58,35,23,33
S01011456,642,15,3,12,81,75,50,68,120,143,50,40,10,40
S01011457,691,14,0,14,74,87,25,66,166,166,55,34,21,38
S01011458,855,65,12,53,191,143,57,80,115,93,32,25,7,79
S01011459,765,50,7,43,181,144,43,67,119,101,30,20,10,30
S01011460,525,25,5,20,101,59,31,42,83,108,43,32,11,33
S01011461,548,9,2,7,68,82,25,46,120,110,49,28,21,39
S01011462,701,60,16,44,120,110,42,74,120,99,24,13,11,52
S01011463,513,15,2,13,103,94,39,42,92,78,19,11,8,31
S01011464,431,56,13,43,131,57,33,35,37,36,9,7,2,37
S01011465,383,7,2,5,44,40,22,34,82,81,50,32,18,23
S01011466,448,20,4,16,63,51,19,22,92,108,40,21,19,33
S01011467,403,35,8,27,78,64,18,30,71,59,27,16,11,21
S01011468,614,73,21,52,179,112,41,49,65,37,18,13,5,40
S01011469,620,24,6,18,79,74,25,55,106,119,89,66,23,49
S01011470,840,43,12,31,148,131,56,70,145,131,44,30,14,72
S01011471,664,53,16,37,141,84,36,56,122,107,15,7,8,50
S01011472,693,20,5,15,103,93,28,75,125,131,70,33,37,48
S01011473,493,11,1,10,60,77,16,48,120,105,38,24,14,18
S01011474,582,23,5,18,92,83,15,60,119,116,52,26,26,22
S01011475,409,11,1,10,56,63,18,40,81,83,37,18,19,20
S01011476,379,50,8,42,101,89,16,30,36,22,4,2,2,31
S01011477,670,78,19,59,195,143,43,45,67,36,15,10,5,48
S01011478,784,122,32,90,257,132,53,45,62,26,11,3,8,76
S01011479,616,61,13,48,183,124,41,49,67,39,16,13,3,36
S01011480,738,129,22,107,233,117,56,32,73,35,11,8,3,52
S01011481,597,50,9,41,155,97,39,55,77,67,18,10,8,39
S01011482,666,36,6,30,124,101,25,62,119,116,42,24,18,41
S01011483,421,36,6,30,145,64,26,27,44,29,19,11,8,31
S01011484,642,13,1,12,80,88,25,53,157,134,50,37,13,42
S01011485,705,21,7,14,72,76,19,72,153,153,79,45,34,60
S01011486,389,4,2,2,40,40,17,34,82,103,34,21,13,35
S01011487,809,30,5,25,85,108,42,71,180,152,79,61,18,62
S01011488,484,10,3,7,45,44,23,54,107,114,57,36,21,30
S01011489,540,38,13,25,122,97,38,48,70,61,26,15,11,40
S01011490,747,22,5,17,145,111,42,66,133,160,42,26,16,26
S01011491,385,9,1,8,45,51,9,40,92,78,46,28,18,15
S01011492,566,13,0,13,72,55,21,51,105,138,64,40,24,47
S01011493,394,35,12,23,111,75,24,38,33,27,4,4,0,47
S01011494,544,22,4,18,85,87,24,46,103,113,32,18,14,32
S01011495,605,21,5,16,79,81,19,56,130,115,58,37,21,46
S01011496,472,10,3,7,43,30,23,47,129,119,46,30,16,25
S01011497,483,39,11,28,110,83,37,36,74,42,27,17,10,35
S01011498,533,26,7,19,134,98,33,51,74,51,10,5,5,56
S01011499,619,30,8,22,124,120,47,67,92,82,22,13,9,35
S01011500,391,15,5,10,65,59,17,38,68,83,18,4,14,28
S01011501,498,13,2,11,41,49,30,43,112,144,48,24,24,18
S01011502,566,13,7,6,63,87,25,67,128,116,37,21,16,30
S01011503,479,15,4,11,69,64,26,39,98,107,34,21,13,27
S01011504,434,19,4,15,69,67,34,42,73,77,22,14,8,31
S01011505,518,25,5,20,77,61,20,50,98,106,49,24,25,32
S01011506,358,19,7,12,69,46,21,31,66,68,17,11,6,21
S01011507,463,15,7,8,80,51,28,51,91,86,43,32,11,18
S01011508,755,53,13,40,154,108,47,80,97,138,37,21,16,41
S01011509,489,23,9,14,70,82,24,65,83,82,29,19,10,31
S01011510,779,16,6,10,109,95,41,79,189,126,65,37,28,59
S01011511,394,4,0,4,39,37,16,27,100,119,36,16,20,16
S01011512,669,11,1,10,57,91,22,68,149,158,77,48,29,36
S01011513,572,6,1,5,66,64,20,68,123,131,66,37,29,28
S01011514,685,13,2,11,65,71,39,71,147,168,54,32,22,57
S01011515,436,20,4,16,82,80,28,51,74,61,22,15,7,18
S01011516,705,50,14,36,182,134,47,66,94,52,22,15,7,58
S01011517,406,15,3,12,58,57,25,42,87,80,19,7,12,23
S01011518,487,9,2,7,49,39,29,57,109,132,42,27,15,21
S01011519,593,13,5,8,83,67,20,58,122,149,41,21,20,40
S01011520,422,7,0,7,41,42,15,41,81,109,61,43,18,25
S01011521,700,26,7,19,93,89,34,62,144,132,81,51,30,39
S01011522,681,20,4,16,107,91,31,64,163,122,48,27,21,35
S01011523,586,15,3,12,71,57,34,61,131,145,40,25,15,32
S01011524,720,49,10,39,133,118,43,71,130,108,26,15,11,42
S01011525,689,41,12,29,141,92,36,76,137,98,26,24,2,42
S01011526,781,29,4,25,124,125,35,89,153,138,45,28,17,43
S01011527,557,44,20,24,102,100,41,53,93,72,16,9,7,36
S01011528,719,28,13,15,105,89,32,73,159,134,53,26,27,46
S01011529,362,10,3,7,41,48,20,24,89,71,39,19,20,20
S01011530,728,33,7,26,88,96,34,67,144,160,68,41,27,38
S01011531,803,71,12,59,208,117,71,57,100,96,29,20,9,54
S01011532,468,54,14,40,114,65,48,40,51,44,12,5,7,40
S01011533,475,19,6,13,43,52,30,51,93,113,57,36,21,17
S01011534,553,30,4,26,89,99,37,51,98,90,32,18,14,27
S01011535,640,14,5,9,70,76,23,64,135,142,77,48,29,39
S01011536,555,61,15,46,147,99,49,37,62,48,12,5,7,40
S01011537,435,46,11,35,107,94,19,38,49,43,11,6,5,28
S01011538,532,72,20,52,142,84,33,30,70,35,8,3,5,58
S01011539,568,24,5,19,64,55,25,55,121,133,50,30,20,41
S01011540,791,28,3,25,130,104,49,80,154,163,37,22,15,46
S01011541,678,16,6,10,57,56,37,63,169,172,48,30,18,60
S01011542,699,20,8,12,67,86,34,74,173,162,48,23,25,35
S01011543,591,10,3,7,54,66,27,56,145,142,53,35,18,38
S01011544,515,11,3,8,60,49,23,38,137,135,33,20,13,29
S01011545,452,12,5,7,45,50,20,59,113,107,22,13,9,24
S01011546,547,59,18,41,152,91,53,31,57,32,9,5,4,63
S01011547,432,41,7,34,133,66,34,30,43,36,12,7,5,37
S01011548,543,31,10,21,79,95,34,50,102,100,12,6,6,40
S01011549,625,47,10,37,148,104,38,50,91,87,21,8,13,39
S01011550,564,63,8,55,157,120,45,31,58,33,10,2,8,47
S01011551,406,20,5,15,79,62,33,45,64,54,22,12,10,27
S01011552,568,32,3,29,121,101,40,54,90,50,20,10,10,60
S01011553,615,90,14,76,190,60,72,32,51,29,22,12,10,69
S01011554,657,23,5,18,84,105,43,61,127,158,30,21,9,26
S01011555,438,8,2,6,39,61,18,43,96,100,31,24,7,42
S01011556,378,8,3,5,42,56,26,32,89,64,34,19,15,27
S01011557,550,9,6,3,80,68,25,47,139,122,35,21,14,25
S01011558,428,13,5,8,44,58,27,45,88,92,32,16,16,29
S01011559,471,8,2,6,52,45,25,56,109,102,46,24,22,28
S01011560,580,15,9,6,72,64,17,47,136,157,41,22,19,31
S01011561,602,7,1,6,72,66,20,59,132,134,57,34,23,55
S01011562,466,10,0,10,47,68,24,38,84,96,58,40,18,41
S01011563,556,10,4,6,78,68,25,39,109,112,51,40,11,64
S01011564,711,28,7,21,115,114,45,79,113,141,35,15,20,41
S01011565,705,17,5,12,94,99,31,77,154,146,41,22,19,46
S01011566,673,19,5,14,59,92,32,69,136,149,63,34,29,54
S01011567,715,23,3,20,72,113,43,65,148,157,56,46,10,38
S01011568,612,35,9,26,106,97,41,53,117,92,37,25,12,34
S01011569,743,45,13,32,126,109,32,75,152,128,36,26,10,40
S01011570,537,17,7,10,63,89,24,48,129,107,29,19,10,31
S01011571,498,10,1,9,68,65,26,46,112,114,32,18,14,25
S01011572,451,25,7,18,87,65,28,36,78,71,36,21,15,25
S01011573,783,55,10,45,175,123,59,62,111,109,37,21,16,52
S01011574,570,33,13,20,101,91,43,62,94,103,18,13,5,25
S01011575,381,12,3,9,63,39,19,36,78,68,33,18,15,33
S01011576,576,6,1,5,43,66,23,48,140,156,62,34,28,32
S01011577,547,32,5,27,110,81,31,42,98,85,33,23,10,35
S01011578,642,22,6,16,99,87,24,48,131,123,50,29,21,58
S01011579,820,96,22,74,245,135,70,57,82,35,18,8,10,82
S01011580,537,31,5,26,85,81,33,48,84,87,46,31,15,42
S01011581,567,23,4,19,66,68,28,62,127,116,58,38,20,19
S01011582,848,107,24,83,250,140,61,47,114,58,8,6,2,63
S01011583,524,28,8,20,117,70,18,57,101,81,27,13,14,25
S01011584,536,12,2,10,68,95,15,52,114,124,35,25,10,21
S01011585,513,15,4,11,72,86,24,46,119,88,26,17,9,37
S01011586,425,8,3,5,59,59,14,42,81,95,34,17,17,33
S01011587,417,9,4,5,53,44,16,48,99,85,27,16,11,36
S01011588,568,21,9,12,61,82,38,52,124,99,45,31,14,46
S01011589,637,22,8,14,98,93,35,55,138,118,34,28,6,44
S01011590,511,17,3,14,64,72,29,57,107,96,42,24,18,27
S01011591,477,12,0,12,55,51,27,43,88,119,54,31,23,28
S01011592,508,14,2,12,60,60,26,49,110,111,56,35,21,22
S01011593,536,32,9,23,97,91,29,40,92,91,25,15,10,39
S01011594,344,14,4,10,50,45,33,38,66,63,6,4,2,29
S01011595,475,51,8,43,123,86,44,27,42,58,10,2,8,34
S01011596,779,65,14,51,187,122,38,42,127,93,47,31,16,58
S01011597,436,25,6,19,100,67,22,45,82,44,16,9,7,35
S01011598,646,10,1,9,43,70,31,54,144,143,114,52,62,37
S01011599,596,20,4,16,106,92,25,50,113,125,34,18,16,31
S01011600,561,21,2,19,86,84,27,64,116,108,24,19,5,31
S01011601,644,52,14,38,152,116,39,62,82,71,15,10,5,55
S01011602,442,22,6,16,66,48,28,32,97,94,37,24,13,18
S01011603,566,8,1,7,75,86,26,53,123,121,45,27,18,29
S01011604,460,5,2,3,52,59,22,43,102,105,43,22,21,29
S01011605,622,12,3,9,89,93,46,64,142,108,31,15,16,37
S01011606,725,71,15,56,208,127,39,55,83,73,12,7,5,57
S01011607,469,38,11,27,104,86,33,48,66,42,15,5,10,37
S01011608,726,59,17,42,167,144,55,64,102,77,18,12,6,40
S01011609,722,17,0,17,55,61,38,73,147,180,96,60,36,55
S01011610,598,12,2,10,64,71,22,40,144,137,72,51,21,36
S01011611,516,28,9,19,120,96,30,49,70,63,18,10,8,42
S01011612,451,67,11,56,155,72,40,24,35,27,11,9,2,20
S01011613,753,81,18,63,209,138,62,54,73,75,16,10,6,45
S01011614,339,20,7,13,79,61,21,22,44,52,16,9,7,24
S01011615,526,21,8,13,81,71,31,47,108,102,31,20,11,34
S01011616,307,11,2,9,35,39,21,30,58,68,35,22,13,10
S01011617,645,13,4,9,59,102,35,59,131,162,48,30,18,36
S01011618,437,14,3,11,65,53,19,42,99,98,27,21,6,20
S01011619,795,69,16,53,198,159,39,61,112,89,23,12,11,45
S01011620,796,82,14,68,216,139,62,72,86,73,12,8,4,54
S01011621,572,33,11,22,122,93,31,52,108,73,25,15,10,35
S01011622,468,59,12,47,134,81,46,30,44,39,8,4,4,27
S01011623,514,16,4,12,70,83,46,42,97,96,35,24,11,29
S01011624,528,35,12,23,127,93,35,40,73,68,23,12,11,34
S01011625,428,13,2,11,73,74,21,42,76,73,23,9,14,33
S01011626,617,58,15,43,157,103,45,51,62,54,14,5,9,73
S01011627,516,46,11,35,155,92,32,41,63,41,7,5,2,39
S01011628,822,70,15,55,200,150,62,61,106,91,17,12,5,65
S01011629,450,5,3,2,53,59,21,51,94,102,36,19,17,29
S01011630,469,17,4,13,52,75,28,50,82,100,37,18,19,28
S01011631,439,6,3,3,26,50,18,52,82,114,56,34,22,35
S01011632,541,10,1,9,58,62,41,41,120,132,51,34,17,26
S01011633,515,18,4,14,54,68,20,50,94,129,47,28,19,35
S01011634,417,11,3,8,45,65,12,42,79,88,44,32,12,31
S01011635,506,9,3,6,64,58,29,46,123,95,56,47,9,26
S01011636,520,12,2,10,47,70,20,55,115,122,48,33,15,31
S01011637,525,8,0,8,90,64,31,45,104,92,52,30,22,39
S01011638,382,15,5,10,64,61,25,24,77,77,21,11,10,18
S01011639,420,13,2,11,54,63,12,38,89,89,39,25,14,23
S01011640,508,16,6,10,60,63,19,55,101,108,45,26,19,41
S01011641,367,29,4,25,88,75,25,28,55,37,5,4,1,25
S01011642,622,48,11,37,126,132,37,51,96,63,31,9,22,38
S01011643,422,44,8,36,115,64,40,28,50,47,14,10,4,20
S01011644,487,36,6,30,116,85,36,38,78,56,7,3,4,35
S01011645,382,13,3,10,79,73,24,34,68,63,10,6,4,18
S01011646,550,65,14,51,141,114,33,39,59,39,11,7,4,49
S01011647,673,63,23,40,177,120,38,46,89,53,22,14,8,65
S01011648,502,53,11,42,126,68,32,36,73,57,30,17,13,27
S01011649,360,13,7,6,65,62,20,40,59,65,14,7,7,22
S01011650,528,53,12,41,137,88,40,31,68,59,27,19,8,25
S01011651,693,46,8,38,146,115,34,58,104,108,32,15,17,50
S01011652,612,52,12,40,136,107,33,48,88,69,26,19,7,53
S01011653,661,15,3,12,86,89,35,66,119,132,71,41,30,48
S01011654,723,46,8,38,128,86,52,49,125,107,87,51,36,43
S01011655,646,15,2,13,79,79,40,68,119,148,80,35,45,18
S01011656,464,8,2,6,48,51,21,44,79,113,64,34,30,36
S01011657,405,14,4,10,54,36,19,31,82,88,54,31,23,27
S01011658,498,15,3,12,48,47,40,49,113,103,49,27,22,34
S01011659,584,17,5,12,71,78,32,61,110,144,37,20,17,34
S01011660,733,45,13,32,148,108,51,62,113,106,31,15,16,69
S01011661,406,13,3,10,51,68,34,40,71,89,21,13,8,19
S01011662,473,41,6,35,126,86,40,31,67,45,9,7,2,28
S01011663,735,14,0,14,79,87,35,85,125,169,93,52,41,48
S01011664,789,11,3,8,75,85,35,73,168,210,85,67,18,47
S01011665,657,22,2,20,116,87,26,41,126,130,57,32,25,52
S01011666,655,17,3,14,85,92,31,57,122,131,76,37,39,44
S01011667,580,38,6,32,73,85,39,53,95,120,47,37,10,30
S01011668,756,13,2,11,74,80,20,77,170,191,77,49,28,54
S01011669,496,48,10,38,112,79,45,34,68,58,21,12,9,31
S01011670,379,7,0,7,50,57,20,30,82,80,30,16,14,23
S01011671,493,40,7,33,107,88,41,30,80,68,13,5,8,26
S01011672,429,29,6,23,75,47,27,32,80,69,34,22,12,36
S01011673,502,19,3,16,53,71,25,53,81,114,48,30,18,38
S01011674,761,44,7,37,155,129,28,59,137,124,42,25,17,43
S01011675,685,31,9,22,98,79,37,60,139,146,60,42,18,35
S01011676,516,10,0,10,44,55,19,61,100,142,54,32,22,31
S01011677,449,29,8,21,108,70,29,33,51,59,39,23,16,31
S01011678,352,11,2,9,34,39,26,41,61,78,43,33,10,19
S01011679,407,22,7,15,110,74,23,50,50,41,12,8,4,25
S01011680,771,27,10,17,89,93,43,61,145,187,79,50,29,47
S01011681,615,29,5,24,93,82,33,58,123,123,35,19,16,39
S01011682,404,29,8,21,76,41,65,36,42,57,40,31,9,18
S01011683,577,12,2,10,66,73,52,71,100,127,37,25,12,39
S01011684,400,18,5,13,76,58,31,37,65,73,13,7,6,29
S01011685,585,54,16,38,150,90,58,38,71,70,9,6,3,45
S01011686,657,55,15,40,162,113,66,54,67,74,9,5,4,57
S01011687,649,28,4,24,94,95,30,56,137,117,55,35,20,37
S01011688,602,58,16,42,132,83,69,39,71,74,26,17,9,50
S01011689,509,62,17,45,120,81,62,38,40,48,14,8,6,44
S01011690,715,72,16,56,151,105,72,58,103,72,44,29,15,38
S01011691,444,44,12,32,103,72,30,29,67,63,10,8,2,26
S01011692,813,19,4,15,95,118,39,77,173,183,60,38,22,49
S01011693,624,61,8,53,162,108,40,48,76,67,22,14,8,40
S01011694,376,49,15,34,110,47,24,25,45,42,14,9,5,20
S01011695,662,80,24,56,192,110,55,49,72,61,12,10,2,31
S01011696,722,151,24,127,238,90,73,34,54,30,13,8,5,39
S01011697,723,87,17,70,200,120,51,46,87,60,30,18,12,42
S01011698,505,9,1,8,95,65,40,61,92,82,24,8,16,37
S01011699,707,72,18,54,154,139,52,66,82,64,16,11,5,62
S01011700,578,47,12,35,112,108,44,52,81,67,13,7,6,54
S01011701,757,111,21,90,209,121,69,53,70,57,18,11,7,49
S01011702,548,70,19,51,123,80,45,38,77,57,21,12,9,37
S01011703,453,64,10,54,133,55,65,31,32,27,12,7,5,34
S01011704,515,68,9,59,133,86,35,37,63,32,10,6,4,51
S01011705,558,32,6,26,82,78,46,46,92,88,38,20,18,56
S01011706,752,46,9,37,148,114,51,73,129,102,35,22,13,54
S01011707,548,46,10,36,158,110,37,44,69,44,12,5,7,28
S01011708,726,33,6,27,137,119,42,56,139,113,38,25,13,49
S01011709,729,54,13,41,144,94,54,66,110,107,32,18,14,68
S01011710,459,5,1,4,53,60,22,38,111,98,42,17,25,30
S01011711,497,13,1,12,54,70,27,42,93,125,45,23,22,28
S01011712,422,25,5,20,68,69,25,48,84,59,21,8,13,23
S01011713,690,46,10,36,127,128,52,56,124,98,21,13,8,38
S01011714,390,35,3,32,94,62,36,38,52,38,9,4,5,26
S01011715,456,18,0,18,62,66,20,53,80,96,33,17,16,28
S01011716,686,48,10,38,187,140,55,42,87,57,17,11,6,53
S01011717,584,37,7,30,135,110,45,50,90,69,16,8,8,32
S01011718,567,69,14,55,176,90,50,45,49,42,19,12,7,27
S01011719,524,53,17,36,137,108,40,35,48,33,2,0,2,68
S01011720,442,46,13,33,138,88,32,23,41,34,4,3,1,36
S01011721,540,21,4,17,78,112,24,54,98,97,26,11,15,30
S01011722,525,24,4,20,93,93,33,46,98,71,29,17,12,38
S01011723,715,44,9,35,139,125,46,69,109,115,25,13,12,43
S01011724,519,45,7,38,111,91,32,43,60,55,25,17,8,57
S01011725,489,51,15,36,129,79,45,32,50,39,8,4,4,56
S01011726,418,46,12,34,106,95,27,34,35,36,9,8,1,30
S01011727,553,91,21,70,163,83,56,34,53,21,10,3,7,42
S01011728,717,26,7,19,124,133,53,68,135,104,22,16,6,52
S01011729,518,21,4,17,82,70,23,65,78,98,37,20,17,44
S01011730,713,54,10,44,166,139,54,68,101,84,6,2,4,41
S01011731,630,20,4,16,102,102,45,64,121,108,24,17,7,44
S01011732,658,55,15,40,188,140,43,50,70,51,12,7,5,49
S01011733,650,24,6,18,122,131,40,52,102,117,23,8,15,39
S01011734,585,39,9,30,127,89,44,57,102,67,14,8,6,46
S01011735,576,53,14,39,162,98,45,34,69,46,16,6,10,53
S01011736,549,19,2,17,91,106,28,44,111,86,20,12,8,44
S01011737,505,18,5,13,75,83,36,28,87,84,41,28,13,53
S01011738,779,42,14,28,139,117,55,57,142,131,43,27,16,53
S01011739,383,6,1,5,53,61,21,41,96,60,19,8,11,26
S01011740,572,15,3,12,84,61,22,54,116,100,61,36,25,59
S01011741,493,18,5,13,50,96,19,43,104,98,32,16,16,33
S01011742,561,26,3,23,100,93,28,48,117,70,29,13,16,50
S01011743,595,29,3,26,111,137,29,56,89,85,16,8,8,43
S01011744,603,32,6,26,121,99,34,45,101,98,41,19,22,32
S01011745,488,14,6,8,75,70,23,44,86,124,25,20,5,27
S01011746,388,5,2,3,42,39,21,30,115,83,28,11,17,25
S01011747,704,13,4,9,76,86,31,66,153,150,67,28,39,62
S01011748,619,13,3,10,75,80,27,57,157,107,51,28,23,52
S01011749,552,12,2,10,58,55,21,42,125,111,83,56,27,45
S01011750,642,21,6,15,98,117,40,51,112,116,32,16,16,55
S01011751,745,20,5,15,86,94,27,67,178,144,68,31,37,61
S01011752,687,24,5,19,137,109,36,79,123,119,25,13,12,35
S01011753,602,47,13,34,165,100,33,45,92,56,20,7,13,44
S01011754,543,21,7,14,86,95,29,62,107,77,19,8,11,47
S01011755,728,29,8,21,118,119,42,63,149,123,41,22,19,44
S01011756,745,24,6,18,117,128,37,67,141,125,38,13,25,68
S01011757,520,16,3,13,80,86,28,46,111,84,28,15,13,41
S01011758,479,25,8,17,65,99,22,38,96,79,25,16,9,30
S01011759,627,27,7,20,78,123,31,63,121,113,30,17,13,41
S01011760,697,19,3,16,105,134,35,62,141,124,32,17,15,45
S01011761,492,28,7,21,81,69,26,37,97,95,17,10,7,42
S01011762,503,23,5,18,72,86,25,41,107,71,29,18,11,49
S01011763,603,22,7,15,94,107,43,65,118,89,21,10,11,44
S01011764,326,13,4,9,63,50,15,38,64,40,10,6,4,33
S01011765,799,68,12,56,202,157,58,46,94,71,14,10,4,89
S01011766,395,45,17,28,97,71,40,19,41,53,6,3,3,23
S01011767,663,27,9,18,114,81,45,61,129,119,42,19,23,45
S01011768,530,15,2,13,73,84,25,48,89,114,45,20,25,37
S01011769,466,22,4,18,74,80,39,39,87,76,23,12,11,26
S01011770,606,27,5,22,83,99,30,53,131,103,46,24,22,34
S01011771,522,63,10,53,149,82,39,34,50,39,12,8,4,54
S01011772,848,131,35,96,246,120,92,40,74,35,23,16,7,87
S01011773,439,59,15,44,118,81,30,37,43,20,7,5,2,44
S01011774,678,70,11,59,170,116,54,46,77,55,20,12,8,70
S01011775,463,83,27,56,138,72,35,24,46,17,11,10,1,37
S01011776,729,121,31,90,229,118,67,34,60,32,19,13,6,49
S01011777,460,62,10,52,149,97,24,23,46,26,7,2,5,26
S01011778,465,72,15,57,139,76,38,25,41,20,8,1,7,46
S01011779,595,75,15,60,170,111,50,44,61,32,10,2,8,42
S01011780,709,116,29,87,190,105,71,38,70,39,14,8,6,66
S01011781,437,50,12,38,112,71,26,31,58,35,3,0,3,51
S01011782,556,67,18,49,151,90,43,38,68,34,11,5,6,54
S01011783,464,53,9,44,127,77,37,30,53,35,11,7,4,41
S01011784,615,24,5,19,100,119,33,49,119,84,28,18,10,59
S01011785,634,38,10,28,121,135,34,45,122,88,20,14,6,31
S01011786,293,48,10,38,84,47,23,21,13,11,10,6,4,36
S01011787,751,22,7,15,89,80,59,70,150,161,61,34,27,59
S01011788,496,105,27,78,146,56,82,11,28,15,8,2,6,45
S01011789,501,31,6,25,98,76,63,59,63,71,10,8,2,30
S01011790,749,40,11,29,125,87,82,60,129,112,53,35,18,61
S01011791,547,16,2,14,75,80,43,55,99,115,28,22,6,36
S01011792,638,36,9,27,133,88,53,53,105,117,29,16,13,24
S01011793,518,51,10,41,115,79,46,48,73,57,11,7,4,38
S01011794,669,16,5,11,104,107,56,60,115,130,36,20,16,45
S01011795,477,15,3,12,76,61,32,57,102,94,26,13,13,14
S01011796,554,18,2,16,80,69,32,55,105,108,44,19,25,43
S01011797,801,80,24,56,207,135,75,56,94,71,13,8,5,70
S01011798,411,14,1,13,67,45,36,43,83,71,29,18,11,23
S01011799,704,50,13,37,157,99,48,73,111,98,24,18,6,44
S01011800,378,11,2,9,47,57,28,47,76,84,13,7,6,15
S01011801,440,13,6,7,63,58,21,34,96,80,38,23,15,37
S01011802,494,17,9,8,73,67,39,56,102,86,26,9,17,28
S01011803,435,22,8,14,54,53,43,52,92,71,23,11,12,25
S01011804,547,30,6,24,112,46,58,57,103,105,17,10,7,19
S01011805,418,31,1,30,90,33,54,46,74,53,6,4,2,31
S01011806,560,40,11,29,125,47,75,66,100,73,13,6,7,21
S01011807,831,63,13,50,183,65,199,63,133,74,11,10,1,40
S01011808,455,28,8,20,101,39,44,43,97,61,13,7,6,29
S01011809,556,53,13,40,105,69,108,43,88,61,10,7,3,19
S01011810,709,47,11,36,138,72,134,74,114,97,15,9,6,18
S01011811,776,48,12,36,163,62,180,72,127,83,12,8,4,29
S01011812,491,52,7,45,124,40,104,37,65,35,10,6,4,24
S01011813,572,34,8,26,103,57,106,57,109,68,11,8,3,27
S01011814,517,35,8,27,117,49,106,27,90,64,6,2,4,23
S01011815,579,30,6,24,137,62,82,46,104,76,9,5,4,33
S01011816,476,44,17,27,139,66,60,39,69,34,3,2,1,22
S01011817,550,38,13,25,128,41,93,66,87,59,6,2,4,32
S01011818,800,44,12,32,170,101,72,82,158,119,14,10,4,40
S01011819,665,23,5,18,94,80,56,87,140,156,11,8,3,18
S01011820,518,35,4,31,107,62,49,54,78,70,23,17,6,40
S01011821,335,9,2,7,56,30,23,29,75,65,25,13,12,23
S01011822,544,26,6,20,89,46,58,89,113,93,15,11,4,15
S01011823,456,18,6,12,85,51,42,46,103,81,10,8,2,20
S01011824,520,11,2,9,88,57,39,61,118,113,16,9,7,17
S01011825,409,22,4,18,95,39,37,44,84,56,11,10,1,21
S01011826,495,36,10,26,94,54,47,53,100,79,8,5,3,24
S01011827,417,18,4,14,85,24,84,46,83,53,18,10,8,6
S01011828,692,45,9,36,124,69,165,57,124,70,10,5,5,28
S01011829,321,23,6,17,68,35,56,33,52,39,4,2,2,11
S01011830,439,22,6,16,76,34,140,32,70,42,14,9,5,9
S01011831,666,47,7,40,100,44,204,36,139,41,27,17,10,28
S01011832,628,24,7,17,118,38,183,54,125,56,13,11,2,17
S01011833,712,119,33,86,217,70,90,34,61,41,23,15,8,57
S01011834,347,72,15,57,102,45,33,22,28,15,7,4,3,23
S01011835,516,90,19,71,152,67,77,23,39,28,14,9,5,26
S01011836,609,109,20,89,180,74,70,34,64,25,16,11,5,37
S01011837,502,73,12,61,143,55,76,33,46,26,20,19,1,30
S01011838,641,114,24,90,190,89,58,43,69,35,4,3,1,39
S01011839,735,89,22,67,209,93,66,56,103,62,15,9,6,42
S01011840,738,77,26,51,195,102,58,63,107,79,13,6,7,44
S01011841,662,63,21,42,176,89,64,55,83,80,24,15,9,28
S01011842,700,47,11,36,141,72,46,78,118,128,27,12,15,43
S01011843,754,116,28,88,211,75,149,39,67,42,14,10,4,41
S01011844,512,121,20,101,155,47,59,18,37,29,5,4,1,41
S01011845,614,52,20,32,156,84,62,50,93,68,10,6,4,39
S01011846,648,108,29,79,177,70,74,33,66,63,11,8,3,46
S01011847,327,57,16,41,120,34,47,14,28,13,2,2,0,12
S01011848,532,77,7,70,133,61,85,27,75,38,2,1,1,34
S01011849,597,77,20,57,135,62,61,66,107,53,12,6,6,24
S01011850,524,67,24,43,143,59,94,35,60,35,6,3,3,25
S01011851,639,54,7,47,143,49,87,63,105,82,23,8,15,33
S01011852,702,52,11,41,136,82,86,80,96,109,23,15,8,38
S01011853,525,63,13,50,126,56,62,56,70,57,13,7,6,22
S01011854,564,53,10,43,134,63,62,60,86,59,10,5,5,37
S01011855,615,31,5,26,84,60,57,78,115,140,19,10,9,31
S01011856,494,85,25,60,154,49,78,23,42,20,9,5,4,34
S01011857,494,45,13,32,127,49,86,40,71,37,14,9,5,25
S01011858,564,80,19,61,154,60,75,30,72,38,16,12,4,39
S01011859,586,51,12,39,131,60,82,54,108,57,14,11,3,29
S01011860,484,39,8,31,104,38,69,61,71,59,13,9,4,30
S01011861,565,60,15,45,143,41,123,44,61,53,15,8,7,25
S01011862,699,92,23,69,222,76,62,59,98,34,11,4,7,45
S01011863,552,103,23,80,145,48,49,40,53,49,26,20,6,39
S01011864,521,65,18,47,154,63,61,34,69,38,5,4,1,32
S01011865,431,35,10,25,94,58,41,52,59,58,12,6,6,22
S01011866,563,41,7,34,119,69,69,60,87,76,16,8,8,26
S01011867,666,28,5,23,114,58,59,82,139,132,15,10,5,39
S01011868,610,49,8,41,140,62,71,62,107,61,19,10,9,39
S01011869,601,55,7,48,125,57,77,70,96,72,16,10,6,33
S01011870,508,32,7,25,87,47,40,62,105,77,19,16,3,39
S01011871,799,88,21,67,192,72,137,71,98,65,25,16,9,51
S01011872,674,102,19,83,177,87,124,37,64,33,10,6,4,40
S01011873,608,76,16,60,169,96,64,45,73,44,8,8,0,33
S01011874,496,39,10,29,127,82,60,47,69,38,8,3,5,26
S01011875,470,39,8,31,98,78,33,39,77,77,15,12,3,14
S01011876,698,99,24,75,196,79,103,43,86,48,9,6,3,35
S01011877,418,36,10,26,97,62,52,41,56,53,9,8,1,12
S01011878,917,106,29,77,221,84,88,52,79,53,14,7,7,220
S01011879,415,69,20,49,111,45,51,24,39,21,13,9,4,42
S01011880,444,77,20,57,111,37,76,21,54,33,12,8,4,23
S01011881,549,56,11,45,137,77,55,35,77,67,12,5,7,33
S01011882,679,42,10,32,139,114,55,63,113,93,27,20,7,33
S01011883,857,102,20,82,245,119,73,52,93,51,16,9,7,106
S01011884,325,42,8,34,95,42,55,14,30,29,5,3,2,13
S01011885,479,83,9,74,173,60,60,17,42,18,3,1,2,23
S01011886,637,96,14,82,145,88,59,55,74,68,8,5,3,44
S01011887,419,36,6,30,77,56,44,41,77,52,8,6,2,28
S01011888,606,24,3,21,109,77,46,60,118,97,30,17,13,45
S01011889,628,88,18,70,171,105,58,38,71,52,14,11,3,31
S01011890,514,60,14,46,131,69,31,48,62,63,15,10,5,35
S01011891,1049,32,3,29,110,82,75,139,176,237,165,149,16,33
S01011892,771,97,13,84,216,123,60,56,99,66,13,6,7,41
S01011893,708,69,14,55,163,145,39,63,105,82,18,8,10,24
S01011894,483,38,7,31,107,76,27,43,82,64,11,6,5,35
S01011895,448,84,9,75,122,61,51,26,36,19,7,6,1,42
S01011896,625,87,12,75,158,108,43,55,71,54,16,12,4,33
S01011897,710,90,15,75,207,120,49,47,80,51,19,14,5,47
S01011898,494,105,15,90,161,76,46,14,30,17,4,3,1,41
S01011899,601,59,14,45,168,128,29,43,86,48,8,7,1,32
S01011900,549,91,13,78,155,106,44,26,70,21,8,6,2,28
S01011901,651,97,23,74,178,105,70,34,86,40,11,5,6,30
S01011902,787,113,20,93,250,129,55,39,94,44,13,11,2,50
S01011903,573,63,15,48,185,115,44,33,64,33,12,10,2,24
S01011904,559,67,16,51,172,101,40,30,68,39,13,10,3,29
S01011905,559,91,21,70,148,97,52,30,50,28,10,8,2,53
S01011906,325,31,5,26,106,58,21,25,43,23,6,3,3,12
S01011907,585,48,6,42,156,107,31,72,90,49,5,2,3,27
S01011908,286,25,6,19,82,50,14,29,48,20,5,2,3,13
S01011909,775,64,12,52,235,142,46,73,111,59,10,6,4,35
S01011910,659,22,5,17,74,74,40,69,143,149,54,30,24,34
S01011911,462,17,5,12,85,67,24,51,91,85,23,18,5,19
S01011912,515,15,3,12,73,63,31,61,109,116,21,12,9,26
S01011913,534,20,4,16,83,59,26,54,124,116,33,19,14,19
S01011914,586,10,2,8,70,76,42,58,134,114,43,27,16,39
S01011915,591,23,4,19,75,76,35,62,125,124,34,25,9,37
S01011916,420,9,3,6,50,56,22,45,85,97,27,18,9,29
S01011917,372,5,1,4,55,53,20,36,87,76,16,11,5,24
S01011918,564,17,2,15,66,44,39,41,128,135,57,36,21,37
S01011919,724,36,8,28,111,81,33,71,124,105,40,28,12,123
S01011920,475,14,1,13,59,60,32,48,102,106,23,14,9,31
S01011921,419,17,1,16,53,52,22,41,93,95,22,10,12,24
S01011922,581,15,3,12,61,71,27,58,151,146,30,19,11,22
S01011923,643,13,3,10,87,84,31,68,149,125,47,30,17,39
S01011924,329,8,3,5,47,49,20,34,69,66,10,3,7,26
S01011925,544,62,14,48,144,76,47,50,70,47,17,13,4,31
S01011926,483,18,3,15,60,74,31,41,128,91,19,13,6,21
S01011927,468,11,3,8,64,76,28,43,112,86,17,12,5,31
S01011928,565,31,8,23,80,73,45,75,105,116,15,10,5,25
S01011929,531,11,2,9,76,87,15,59,119,113,23,15,8,28
S01011930,476,15,6,9,73,70,29,43,94,107,14,9,5,31
S01011931,457,12,2,10,59,40,27,40,92,113,43,29,14,31
S01011932,497,35,2,33,104,74,20,49,77,73,29,21,8,36
S01011933,516,26,3,23,79,66,27,63,89,98,25,15,10,43
S01011934,821,62,16,46,163,99,60,57,137,113,28,16,12,102
S01011935,686,40,4,36,95,72,52,61,118,145,29,14,15,74
S01011936,554,70,7,63,123,68,35,45,80,56,23,12,11,54
S01011937,542,60,9,51,103,70,34,46,82,76,24,19,5,47
S01011938,539,59,13,46,141,66,59,30,69,71,14,8,6,30
S01011939,641,39,7,32,119,73,34,61,119,92,46,21,25,58
S01011940,338,25,6,19,54,35,18,32,66,59,23,12,11,26
S01011941,627,48,6,42,111,72,32,69,124,96,27,11,16,48
S01011942,661,34,3,31,112,74,33,63,117,127,28,16,12,73
S01011943,946,47,7,40,158,98,52,87,187,159,79,49,30,79
S01011944,340,59,10,49,95,35,47,20,37,14,8,4,4,25
S01011945,605,128,26,102,192,75,54,21,50,27,30,29,1,28
S01011946,561,63,15,48,103,69,42,58,99,65,22,10,12,40
S01011947,354,27,2,25,89,63,22,36,59,34,5,4,1,19
S01011948,789,109,14,95,211,89,70,49,86,60,79,65,14,36
S01011949,545,78,20,58,171,90,55,31,68,27,4,2,2,21
S01011950,514,55,12,43,115,88,35,45,83,58,13,8,5,22
S01011951,484,35,7,28,126,87,49,37,70,44,10,5,5,26
S01011952,354,61,13,48,105,64,30,22,43,13,4,3,1,12
S01011953,524,71,14,57,155,79,50,34,55,38,6,2,4,36
S01011954,350,16,6,10,79,71,19,41,57,47,7,3,4,13
S01011955,686,44,6,38,152,103,65,61,118,89,17,11,6,37
S01011956,717,112,18,94,198,111,63,44,91,57,8,7,1,33
S01011957,721,74,21,53,156,67,89,74,131,56,29,19,10,45
S01011958,799,82,12,70,204,84,144,61,104,78,11,5,6,31
S01011959,665,66,15,51,146,85,93,57,78,58,45,42,3,37
S01011960,603,116,17,99,176,71,62,50,57,44,7,5,2,20
S01011961,531,66,11,55,139,72,38,48,72,56,8,2,6,32
S01011962,512,95,21,74,147,67,69,29,40,30,6,6,0,29
S01011963,359,47,7,40,90,48,23,24,60,42,9,4,5,16
S01011964,759,106,20,86,195,113,49,75,96,74,19,11,8,32
S01011965,549,88,18,70,142,75,32,52,54,51,10,8,2,45
S01011966,600,112,22,90,157,93,47,37,59,43,16,11,5,36
S01011967,909,146,25,121,207,101,126,57,102,92,30,28,2,48
S01011968,752,117,14,103,182,127,54,57,87,62,15,6,9,51
S01011969,762,55,10,45,147,88,52,88,146,136,20,11,9,30
S01011970,711,26,8,18,70,62,54,92,191,145,41,25,16,30
S01011971,392,47,12,35,91,45,47,35,56,41,10,2,8,20
S01011972,886,75,16,59,218,84,169,61,126,81,27,19,8,45
S01011973,463,60,19,41,106,56,62,24,73,49,10,5,5,23
S01011974,591,68,19,49,146,79,79,56,83,46,11,8,3,23
S01011975,352,40,6,34,80,26,49,37,60,39,6,5,1,15
S01011976,573,51,13,38,127,63,80,61,76,65,17,10,7,33
S01011977,880,67,15,52,191,80,113,87,135,123,40,28,12,44
S01011978,470,19,4,15,106,42,43,48,102,82,8,5,3,20
S01011979,724,74,15,59,194,74,123,45,105,62,15,12,3,32
S01011980,318,38,13,25,67,29,69,28,32,31,6,3,3,18
S01011981,716,60,12,48,148,70,139,89,106,63,12,7,5,29
S01011982,717,72,21,51,170,66,140,61,111,57,13,8,5,27
S01011983,548,47,6,41,107,52,111,71,82,53,12,9,3,13
S01011984,468,14,2,12,82,44,37,44,93,109,28,23,5,17
S01011985,526,25,5,20,118,55,74,45,95,62,26,23,3,26
S01011986,480,11,2,9,77,38,43,53,111,93,34,18,16,20
S01011987,703,36,11,25,138,88,67,61,142,98,27,17,10,46
S01011988,501,37,8,29,144,60,54,31,63,45,32,30,2,35
S01011989,616,40,9,31,126,87,68,71,101,79,14,10,4,30
S01011990,527,43,11,32,119,91,57,52,78,57,9,6,3,21
S01011991,521,22,7,15,108,58,52,41,101,86,17,10,7,36
S01011992,673,84,10,74,180,80,73,45,103,58,18,8,10,32
S01011993,625,26,9,17,98,69,36,80,133,123,31,18,13,29
S01011994,518,89,23,66,169,62,67,27,37,28,12,8,4,27
S01011995,613,77,16,61,155,68,98,50,81,53,6,6,0,25
S01011996,404,24,9,15,82,51,35,46,58,64,20,19,1,24
S01011997,668,71,16,55,146,76,63,66,98,86,17,8,9,45
S01011998,382,54,13,41,107,72,44,29,42,20,3,1,2,11
S01011999,477,45,8,37,97,54,76,56,70,46,6,2,4,27
S01012000,335,27,4,23,86,63,36,34,41,36,0,0,0,12
S01012001,459,31,9,22,86,69,61,52,64,76,9,4,5,11
S01012002,391,25,5,20,72,62,42,51,65,49,9,7,2,16
S01012003,419,16,5,11,103,55,43,34,64,67,13,3,10,24
S01012004,638,66,18,48,136,107,65,47,86,74,13,9,4,44
S01012005,644,74,16,58,162,109,53,50,88,60,15,8,7,33
S01012006,708,60,13,47,166,41,91,40,46,38,11,7,4,215
S01012007,580,59,7,52,149,59,78,57,84,51,15,6,9,28
S01012008,707,75,20,55,173,59,104,70,90,60,37,35,2,39
S01012009,557,54,11,43,144,40,81,42,86,76,11,7,4,23
S01012010,872,90,14,76,207,72,123,108,115,111,11,8,3,35
S01012011,824,59,9,50,166,58,104,103,168,97,15,5,10,54
S01012012,477,43,9,34,128,45,94,39,63,40,7,3,4,18
S01012013,580,61,17,44,117,52,131,53,72,66,11,8,3,17
S01012014,600,38,12,26,117,35,77,72,122,100,16,9,7,23
S01012015,655,41,13,28,146,67,89,67,118,73,12,4,8,42
S01012016,667,64,11,53,135,60,101,89,106,70,17,8,9,25
S01012017,400,52,8,44,100,26,98,33,36,24,11,9,2,20
S01012018,657,64,11,53,171,34,120,77,92,54,16,8,8,29
S01012019,616,85,11,74,183,96,56,45,63,40,15,7,8,33
S01012020,509,63,3,60,127,65,31,33,63,73,15,11,4,39
S01012021,437,72,14,58,103,53,28,31,51,36,16,7,9,47
S01012022,495,39,10,29,112,69,42,47,83,60,14,8,6,29
S01012023,418,78,19,59,117,45,70,25,23,22,13,9,4,25
S01012024,654,96,15,81,176,112,47,42,68,55,19,9,10,39
S01012025,524,46,8,38,121,87,37,46,92,59,10,4,6,26
S01012026,454,79,23,56,125,69,41,24,41,17,11,8,3,47
S01012027,665,92,24,68,170,94,71,43,70,55,32,23,9,38
S01012028,711,153,43,110,231,98,54,24,50,27,8,3,5,66
S01012029,810,94,28,66,175,109,84,68,108,71,26,19,7,75
S01012030,512,68,13,55,128,60,79,27,43,51,15,9,6,41
S01012031,418,100,20,80,147,53,40,19,23,12,9,6,3,15
S01012032,273,47,9,38,83,35,46,12,15,12,5,4,1,18
S01012033,622,63,15,48,147,106,29,51,87,74,27,16,11,38
S01012034,602,68,13,55,143,78,47,40,75,80,29,15,14,42
S01012035,694,90,16,74,184,102,49,48,98,57,28,20,8,38
S01012036,665,78,15,63,186,113,38,43,71,56,20,14,6,60
S01012037,697,25,4,21,98,99,24,67,135,134,56,28,28,59
S01012038,607,10,1,9,49,55,20,53,134,154,84,54,30,48
S01012039,740,21,7,14,88,101,39,81,147,159,54,37,17,50
S01012040,524,46,16,30,132,86,36,43,66,42,18,13,5,55
S01012041,646,27,9,18,121,96,33,62,122,96,29,15,14,60
S01012042,675,23,2,21,101,88,47,68,142,125,36,22,14,45
S01012043,658,22,6,16,103,68,30,65,131,137,66,46,20,36
S01012044,654,22,10,12,87,83,32,40,144,158,51,29,22,37
S01012045,828,51,13,38,141,116,41,79,137,125,77,48,29,61
S01012046,502,13,2,11,59,63,21,56,99,94,61,43,18,36
S01012047,667,16,4,12,97,82,36,64,129,140,65,40,25,38
S01012048,512,16,1,15,63,80,27,55,114,85,45,35,10,27
S01012049,527,31,8,23,104,90,34,48,91,71,25,16,9,33
S01012050,776,48,17,31,161,147,41,62,113,98,43,25,18,63
S01012051,365,30,5,25,94,65,28,24,46,35,15,10,5,28
S01012052,660,25,6,19,124,100,28,67,144,104,30,17,13,38
S01012053,662,17,4,13,97,90,28,91,147,104,45,23,22,43
S01012054,615,14,2,12,67,61,27,66,131,122,81,32,49,46
S01012055,622,22,5,17,86,84,29,73,131,130,33,14,19,34
S01012056,592,51,8,43,125,98,37,57,83,68,16,11,5,57
S01012057,576,65,17,48,177,107,33,40,53,34,17,7,10,50
S01012058,558,57,12,45,157,94,46,30,68,44,14,8,6,48
S01012059,628,21,5,16,82,84,43,57,120,130,44,27,17,47
S01012060,620,37,8,29,118,84,36,48,111,96,50,35,15,40
S01012061,760,100,26,74,221,108,45,51,80,62,41,26,15,52
S01012062,656,51,16,35,172,110,50,61,89,51,9,5,4,63
S01012063,398,24,3,21,89,56,29,41,77,44,14,8,6,24
S01012064,468,15,4,11,33,41,11,41,69,114,105,75,30,39
S01012065,409,4,1,3,21,21,5,24,89,105,99,80,19,41
S01012066,619,16,5,11,65,67,23,47,146,141,66,45,21,48
S01012067,405,3,0,3,36,30,7,25,110,96,69,43,26,29
S01012068,403,3,1,2,17,36,12,32,71,96,91,70,21,45
S01012069,387,7,3,4,63,39,14,23,80,79,57,32,25,25
S01012070,546,14,4,10,48,58,19,41,105,131,81,43,38,49
S01012071,836,28,2,26,104,98,38,85,152,177,89,59,30,65
S01012072,863,45,5,40,116,81,42,53,173,160,118,82,36,75
S01012073,538,54,8,46,142,74,29,47,74,51,24,12,12,43
S01012074,545,49,16,33,153,105,39,50,47,39,14,9,5,49
S01012075,574,65,22,43,138,108,49,47,46,42,7,3,4,72
S01012076,531,38,8,30,130,93,29,41,94,54,24,17,7,28
S01012077,561,20,2,18,84,84,22,39,119,113,36,21,15,44
S01012078,673,42,13,29,146,125,36,51,81,95,45,26,19,52
S01012079,671,30,10,20,78,104,38,68,122,140,46,26,20,45
S01012080,549,16,3,13,70,66,22,44,121,100,67,41,26,43
S01012081,542,8,2,6,64,61,25,53,125,114,61,34,27,31
S01012082,451,9,0,9,54,58,18,46,101,97,49,29,20,19
S01012083,532,12,3,9,78,70,18,52,120,116,35,13,22,31
S01012084,440,22,10,12,97,82,29,48,62,62,9,6,3,29
S01012085,539,39,12,27,106,110,22,45,94,75,13,8,5,35
S01012086,670,18,6,12,104,106,24,64,140,120,57,32,25,37
S01012087,504,19,9,10,96,80,22,41,100,85,29,13,16,32
S01012088,535,51,15,36,145,83,32,51,65,41,24,16,8,43
S01012089,648,58,15,43,212,140,38,49,59,36,16,9,7,40
S01012090,708,105,21,84,248,117,47,41,49,33,13,6,7,55
S01012091,429,27,10,17,106,78,22,41,70,36,14,10,4,35
S01012092,407,48,16,32,100,78,27,34,52,35,7,4,3,26
S01012093,435,49,10,39,110,82,32,33,54,50,10,4,6,15
S01012094,582,94,20,74,195,88,51,32,50,25,6,3,3,41
S01012095,838,53,16,37,167,127,44,74,126,116,41,26,15,90
S01012096,667,14,3,11,102,82,31,60,166,120,39,20,19,53
S01012097,489,12,3,9,69,80,24,44,105,90,35,18,17,30
S01012098,466,11,5,6,69,59,21,41,97,100,26,13,13,42
S01012099,583,16,6,10,63,75,16,50,143,126,45,22,23,49
S01012100,759,20,8,12,128,103,46,62,180,116,63,47,16,41
S01012101,604,83,10,73,167,79,28,45,93,32,22,15,7,55
S01012102,474,14,3,11,79,62,12,37,111,76,36,19,17,47
S01012103,722,41,7,34,161,136,43,51,129,85,26,7,19,50
S01012104,676,125,53,72,193,89,51,42,72,32,12,7,5,60
S01012105,841,103,32,71,234,135,56,58,99,68,20,10,10,68
S01012106,832,112,24,88,254,156,65,48,66,48,14,11,3,69
S01012107,510,80,14,66,161,73,42,31,39,25,21,13,8,38
S01012108,610,33,7,26,107,85,36,47,108,128,39,13,26,27
S01012109,714,35,4,31,124,90,32,76,134,102,70,39,31,51
S01012110,541,50,9,41,81,102,24,54,103,77,29,15,14,21
S01012111,417,20,6,14,58,61,19,37,65,66,46,24,22,45
S01012112,535,48,10,38,95,106,26,46,77,89,23,11,12,25
S01012113,738,42,8,34,154,131,46,70,119,102,15,4,11,59
S01012114,757,82,12,70,187,97,46,30,58,28,17,11,6,212
S01012115,379,16,4,12,52,70,11,43,89,66,12,10,2,20
S01012116,431,14,4,10,82,69,21,46,82,71,15,6,9,31
S01012117,559,63,22,41,189,103,40,46,53,28,4,3,1,33
S01012118,482,48,13,35,135,82,34,36,60,33,9,4,5,45
S01012119,705,74,14,60,176,139,48,47,84,64,20,18,2,53
S01012120,435,21,5,16,64,58,15,38,77,89,31,21,10,42
S01012121,665,22,5,17,89,97,22,71,142,116,57,35,22,49
S01012122,617,26,3,23,73,83,25,66,127,139,28,20,8,50
S01012123,393,30,4,26,75,56,28,32,58,50,24,14,10,40
S01012124,430,23,1,22,104,80,21,32,64,58,9,4,5,39
S01012125,618,18,4,14,114,70,25,60,108,115,58,30,28,50
S01012126,628,74,12,62,172,101,37,64,62,44,21,9,12,53
S01012127,713,46,9,37,112,110,37,51,102,88,76,40,36,91
S01012128,414,36,7,29,91,52,15,43,69,53,27,17,10,28
S01012129,558,37,7,30,104,89,27,51,86,73,53,37,16,38
S01012130,774,45,13,32,158,118,41,58,117,135,62,39,23,40
S01012131,935,34,5,29,134,108,21,74,128,134,82,50,32,220
S01012132,561,32,6,26,87,59,31,32,101,79,47,33,14,93
S01012133,778,63,9,54,137,74,31,58,88,78,38,20,18,211
S01012134,861,100,21,79,245,130,51,46,83,59,29,17,12,118
S01012135,702,23,4,19,77,86,30,67,157,124,80,51,29,58
S01012136,699,26,2,24,94,87,24,58,133,105,56,25,31,116
S01012137,514,14,3,11,109,71,20,53,85,67,39,24,15,56
S01012138,681,88,15,73,171,116,32,47,63,72,16,9,7,76
S01012139,656,55,14,41,143,119,37,43,106,87,25,14,11,41
S01012140,397,60,7,53,142,56,20,20,38,24,7,2,5,30
S01012141,755,79,20,59,225,133,50,56,84,40,23,11,12,65
S01012142,693,93,31,62,213,124,51,48,74,35,8,4,4,47
S01012143,633,102,18,84,186,107,50,35,50,19,19,13,6,65
S01012144,743,99,27,72,184,145,57,54,84,47,20,16,4,53
S01012145,732,116,16,100,234,126,45,41,58,24,18,12,6,70
S01012146,701,24,2,22,102,86,31,70,141,142,40,23,17,65
S01012147,572,18,5,13,63,81,21,52,127,113,58,35,23,39
S01012148,540,12,5,7,61,63,17,53,116,112,69,46,23,37
S01012149,620,43,5,38,124,97,48,59,94,61,36,31,5,58
S01012150,553,11,2,9,66,84,21,52,118,125,48,29,19,28
S01012151,552,25,6,19,71,64,18,52,119,129,47,29,18,27
S01012152,565,20,4,16,54,74,24,59,128,101,65,42,23,40
S01012153,433,14,2,12,66,54,19,61,83,61,39,28,11,36
S01012154,637,26,1,25,78,83,24,76,120,122,61,35,26,47
S01012155,461,9,1,8,73,53,25,46,77,96,41,19,22,41
S01012156,474,9,2,7,68,47,20,40,102,114,52,33,19,22
S01012157,742,40,7,33,146,101,29,72,127,134,39,25,14,54
S01012158,843,69,10,59,219,125,61,75,104,69,38,24,14,83
S01012159,411,30,6,24,88,73,23,56,65,38,9,7,2,29
S01012160,525,44,8,36,108,118,36,53,75,57,7,2,5,27
S01012161,322,12,2,10,50,23,11,19,96,75,20,14,6,16
S01012162,663,33,6,27,114,73,24,77,134,92,63,48,15,53
S01012163,561,34,4,30,100,78,25,56,95,90,50,39,11,33
S01012164,794,64,17,47,226,146,42,73,109,60,16,13,3,58
S01012165,670,19,6,13,66,87,25,70,156,141,66,40,26,40
S01012166,473,7,2,5,71,64,22,56,105,91,20,13,7,37
S01012167,649,29,6,23,102,113,32,79,125,113,23,9,14,33
S01012168,611,47,15,32,153,119,36,57,88,55,15,9,6,41
S01012169,639,24,10,14,115,119,28,55,143,80,23,19,4,52
S01012170,697,26,8,18,112,130,32,83,136,124,24,14,10,30
S01012171,762,25,3,22,121,103,21,72,204,151,25,16,9,40
S01012172,550,11,2,9,68,93,20,57,123,112,36,27,9,30
S01012173,482,42,10,32,134,92,30,36,59,37,12,11,1,40
S01012174,657,64,12,52,172,113,50,42,83,48,12,7,5,73
S01012175,656,61,8,53,176,126,28,51,95,63,9,6,3,47
S01012176,704,40,14,26,153,127,47,78,126,73,13,9,4,47
S01012177,502,38,7,31,101,103,37,57,66,41,12,8,4,47
S01012178,431,33,4,29,94,113,27,40,46,42,7,4,3,29
S01012179,429,31,9,22,83,66,23,43,66,54,29,19,10,34
S01012180,407,31,5,26,89,67,25,34,70,57,13,7,6,21
S01012181,553,42,16,26,116,84,37,47,89,71,31,17,14,36
S01012182,831,101,17,84,217,128,51,79,116,40,19,16,3,80
S01012183,571,36,9,27,115,85,28,58,96,76,39,31,8,38
S01012184,435,75,10,65,122,66,23,30,42,28,9,4,5,40
S01012185,613,25,4,21,98,91,33,59,80,114,88,59,29,25
S01012186,501,29,15,14,100,61,20,46,101,81,39,20,19,24
S01012187,517,11,3,8,62,81,17,57,113,97,40,24,16,39
S01012188,398,24,9,15,94,79,21,36,65,41,9,5,4,29
S01012189,421,36,10,26,107,70,19,56,58,46,10,7,3,19
S01012190,393,47,8,39,118,79,16,22,51,29,2,2,0,29
S01012191,693,85,22,63,167,131,44,62,95,38,15,9,6,56
S01012192,397,41,10,31,105,66,30,34,41,31,10,5,5,39
S01012193,422,64,19,45,114,68,30,33,49,21,2,1,1,41
S01012194,425,52,10,42,123,78,14,29,49,16,7,1,6,57
S01012195,843,71,17,54,231,178,38,80,88,54,22,14,8,81
S01012196,424,54,12,42,110,79,26,21,52,27,10,6,4,45
S01012197,529,28,5,23,95,88,23,59,106,80,19,9,10,31
S01012198,647,42,12,30,141,130,30,50,95,68,30,21,9,61
S01012199,568,28,9,19,99,107,21,60,112,83,15,8,7,43
S01012200,486,23,5,18,82,96,25,48,93,66,18,9,9,35
S01012201,556,29,8,21,112,84,28,66,104,71,18,9,9,44
S01012202,441,33,7,26,108,66,16,52,81,50,7,6,1,28
S01012203,617,61,16,45,165,123,39,48,76,41,15,12,3,49
S01012204,646,51,8,43,171,126,40,54,69,41,18,8,10,76
S01012205,548,67,19,48,144,85,51,41,75,32,6,4,2,47
S01012206,650,46,9,37,155,101,34,53,119,65,10,2,8,67
S01012207,642,24,9,15,120,131,26,56,129,88,16,11,5,52
S01012208,731,27,3,24,139,130,47,87,112,109,28,17,11,52
S01012209,537,25,5,20,106,89,37,53,96,65,24,11,13,42
S01012210,527,22,7,15,85,110,21,71,97,63,21,16,5,37
S01012211,664,60,19,41,154,104,41,57,93,78,19,8,11,58
S01012212,619,77,18,59,195,119,28,50,76,22,10,6,4,42
S01012213,669,72,17,55,206,132,32,44,94,39,3,1,2,47
S01012214,502,65,13,52,172,103,39,22,43,21,7,3,4,30
S01012215,687,81,16,65,227,132,22,52,62,35,13,7,6,63
S01012216,551,93,22,71,158,88,36,24,53,33,9,6,3,57
S01012217,410,8,2,6,48,48,10,46,82,84,47,31,16,37
S01012218,332,6,1,5,40,27,10,29,73,77,35,15,20,35
S01012219,611,19,5,14,68,81,22,64,113,142,52,40,12,50
S01012220,470,7,0,7,56,57,24,55,106,102,49,27,22,14
S01012221,468,9,2,7,60,69,20,60,90,93,39,26,13,28
S01012222,602,16,7,9,75,102,29,73,124,117,26,18,8,40
S01012223,510,17,7,10,57,82,16,56,107,107,37,21,16,31
S01012224,544,27,6,21,68,82,23,64,106,91,33,25,8,50
S01012225,750,24,7,17,109,100,35,80,157,150,44,29,15,51
S01012226,538,21,6,15,95,105,27,52,99,76,18,7,11,45
S01012227,496,14,4,10,90,91,15,61,77,82,24,10,14,42
S01012228,511,35,7,28,62,97,27,46,101,86,14,9,5,43
S01012229,542,68,12,56,153,90,31,46,58,40,16,5,11,40
S01012230,692,102,25,77,206,137,39,50,57,31,12,6,6,58
S01012231,619,105,19,86,183,88,54,34,50,24,13,8,5,68
S01012232,637,101,14,87,212,91,39,36,56,26,10,4,6,66
S01012233,714,120,27,93,231,115,44,35,57,37,13,6,7,62
S01012234,811,138,32,106,245,115,57,48,61,47,19,13,6,81
S01012235,356,67,16,51,112,71,24,19,21,11,4,3,1,27
S01012236,451,52,13,39,105,72,28,37,55,46,21,11,10,35
S01012237,580,136,32,104,185,78,43,14,32,24,14,9,5,54
S01012238,455,46,13,33,98,51,32,43,67,62,22,11,11,34
S01012239,444,28,6,22,66,59,26,38,78,81,30,20,10,38
S01012240,616,58,13,45,128,63,38,64,96,87,31,19,12,51
S01012241,418,126,15,111,126,49,38,12,21,15,10,8,2,21
S01012242,587,118,12,106,179,93,51,21,32,19,10,6,4,64
S01012243,449,73,16,57,138,68,27,27,42,29,14,9,5,31
S01012244,709,184,38,146,182,57,95,17,64,24,46,45,1,40
S01012245,503,103,13,90,155,57,46,24,51,30,12,4,8,25
S01012246,550,131,24,107,162,62,68,25,40,22,5,3,2,35
S01012247,553,111,20,91,158,47,60,45,62,25,13,10,3,32
S01012248,607,91,22,69,138,57,113,42,69,41,15,6,9,41
S01012249,641,109,20,89,135,48,125,40,80,48,19,11,8,37
S01012250,511,57,19,38,140,50,101,34,53,42,14,9,5,20
S01012251,671,35,3,32,113,66,64,78,133,115,30,14,16,37
S01012252,510,34,7,27,94,56,53,50,99,65,29,10,19,30
S01012253,665,62,10,52,142,74,63,57,112,98,25,15,10,32
S01012254,621,62,13,49,163,73,62,61,95,58,17,6,11,30
S01012255,627,99,17,82,161,62,68,49,76,66,16,7,9,30
S01012256,619,82,21,61,180,89,50,38,74,52,17,8,9,37
S01012257,698,64,12,52,165,81,53,58,111,107,25,14,11,34
S01012258,517,104,15,89,201,69,43,19,26,18,12,7,5,25
S01012259,428,76,15,61,156,40,56,11,37,19,11,4,7,22
S01012260,597,67,15,52,140,62,73,39,100,76,16,10,6,24
S01012261,596,96,29,67,199,81,50,30,65,28,9,3,6,38
S01012262,609,96,24,72,144,76,118,40,76,28,10,5,5,21
S01012263,547,27,7,20,106,47,78,55,102,90,17,7,10,25
S01012264,339,52,10,42,92,41,29,14,55,38,5,2,3,13
S01012265,564,19,5,14,81,43,51,64,115,134,24,15,9,33
S01012266,770,74,19,55,181,112,79,82,103,90,18,8,10,31
S01012267,533,74,20,54,155,61,75,35,61,49,7,3,4,16
S01012268,470,59,16,43,123,38,95,22,63,35,9,3,6,26
S01012269,711,60,11,49,163,86,89,55,104,98,22,12,10,34
S01012270,550,27,9,18,104,63,46,36,116,91,27,15,12,40
S01012271,780,93,20,73,216,88,154,49,80,32,22,16,6,46
S01012272,513,78,19,59,153,62,50,28,67,33,10,4,6,32
S01012273,543,74,22,52,143,88,62,32,72,29,10,6,4,33
S01012274,718,53,7,46,161,113,67,63,103,89,26,12,14,43
S01012275,681,33,8,25,112,65,50,60,106,96,40,21,19,119
S01012276,703,58,14,44,177,88,53,54,114,82,33,19,14,44
S01012277,774,41,12,29,174,84,72,63,136,116,34,16,18,54
S01012278,530,35,8,27,105,62,40,28,95,70,19,11,8,76
S01012279,600,33,10,23,115,74,33,69,99,84,37,28,9,56
S01012280,698,23,3,20,99,92,50,62,151,128,39,19,20,54
S01012281,527,19,9,10,107,74,38,57,120,65,19,13,6,28
S01012282,833,63,17,46,158,112,69,36,103,53,22,18,4,217
S01012283,629,68,23,45,136,89,65,44,79,70,22,8,14,56
S01012284,569,37,12,25,91,67,43,40,103,89,46,28,18,53
S01012285,416,35,9,26,133,70,29,26,52,42,8,7,1,21
S01012286,821,33,10,23,115,69,55,73,168,161,43,22,21,104
S01012287,698,15,3,12,83,52,45,48,173,164,70,31,39,48
S01012288,573,11,4,7,62,56,31,54,135,134,57,24,33,33
S01012289,621,125,18,107,178,63,76,28,56,25,34,29,5,36
S01012290,381,31,11,20,83,50,47,20,63,57,14,8,6,16
S01012291,687,99,19,80,206,87,67,31,83,51,30,24,6,33
S01012292,484,95,22,73,141,53,75,20,50,20,10,10,0,20
S01012293,344,33,9,24,92,55,34,23,50,32,9,6,3,16
S01012294,667,31,9,22,140,105,46,62,133,87,25,18,7,38
S01012295,538,40,13,27,142,89,47,31,71,54,29,15,14,35
S01012296,606,81,19,62,198,64,81,50,57,33,2,1,1,40
S01012297,439,68,19,49,111,48,124,14,31,21,10,5,5,12
S01012298,600,73,11,62,153,86,83,38,84,48,7,3,4,28
S01012299,475,69,10,59,118,47,81,41,64,31,5,5,0,19
S01012300,480,27,11,16,92,41,71,37,94,71,17,14,3,30
S01012301,718,74,19,55,164,69,114,60,105,80,23,14,9,29
S01012302,455,43,9,34,93,41,82,44,84,36,14,8,6,18
S01012303,664,87,12,75,162,64,130,39,91,37,16,8,8,38
S01012304,727,57,17,40,154,77,140,52,121,81,16,9,7,29
S01012305,506,27,7,20,123,59,59,42,81,54,25,21,4,36
S01012306,387,16,11,5,65,31,41,32,94,75,15,10,5,18
S01012307,458,35,5,30,81,59,34,43,84,81,23,14,9,18
S01012308,620,30,10,20,111,78,54,62,133,104,7,6,1,41
S01012309,398,35,11,24,81,43,50,28,68,70,10,7,3,13
S01012310,692,69,15,54,160,54,161,35,110,68,14,10,4,21
S01012311,415,35,8,27,106,41,54,44,63,34,14,9,5,24
S01012312,793,59,8,51,155,79,159,66,135,68,20,14,6,52
S01012313,598,55,14,41,119,64,90,55,97,75,12,7,5,31
S01012314,605,18,6,12,71,54,57,65,161,132,27,17,10,20
S01012315,527,17,4,13,92,46,80,53,108,77,28,18,10,26
S01012316,456,13,6,7,65,27,44,53,120,107,16,3,13,11
S01012317,366,14,5,9,97,36,43,36,59,41,11,4,7,29
S01012318,602,14,6,8,93,46,46,64,148,132,24,16,8,35
S01012319,578,55,11,44,121,56,99,50,89,68,14,7,7,26
S01012320,492,16,6,10,69,40,48,46,129,93,22,16,6,29
S01012321,546,42,11,31,89,57,62,48,130,73,14,5,9,31
S01012322,742,85,22,63,186,93,141,36,84,63,21,14,7,33
S01012323,676,75,20,55,162,80,130,45,87,53,22,11,11,22
S01012324,601,56,21,35,107,69,131,52,97,54,12,6,6,23
S01012325,422,30,9,21,73,62,32,30,97,70,14,6,8,14
S01012326,412,21,4,17,60,42,46,53,89,58,31,16,15,12
S01012327,570,30,8,22,94,57,65,57,121,101,20,15,5,25
S01012328,405,50,13,37,108,41,53,30,58,46,12,5,7,7
S01012329,613,49,14,35,122,61,132,58,101,55,15,8,7,20
S01012330,429,43,13,30,96,50,59,30,70,44,10,7,3,27
S01012331,446,47,13,34,128,55,46,33,64,49,9,4,5,15
S01012332,744,75,15,60,161,79,142,70,110,56,11,8,3,40
S01012333,720,53,12,41,166,83,135,53,119,63,23,11,12,25
S01012334,589,14,5,9,83,64,58,75,140,113,21,7,14,21
S01012335,745,42,19,23,136,100,46,71,168,124,23,11,12,35
S01012336,427,10,4,6,65,39,38,43,106,98,11,6,5,17
S01012337,596,23,9,14,83,59,49,78,143,92,45,26,19,24
S01012338,502,31,6,25,114,58,59,41,93,63,18,7,11,25
S01012339,432,37,7,30,93,48,37,42,75,54,23,10,13,23
S01012340,696,56,21,35,158,72,69,59,138,84,29,19,10,31
S01012341,740,71,20,51,148,80,187,43,89,68,19,8,11,35
S01012342,661,58,17,41,154,69,112,44,113,67,16,11,5,28
S01012343,760,74,21,53,183,79,151,54,114,56,25,13,12,24
S01012344,454,17,3,14,80,59,45,40,89,87,24,14,10,13
S01012345,520,30,11,19,111,61,60,67,64,82,8,6,2,37
S01012346,615,72,7,65,134,61,117,48,77,57,14,10,4,35
S01012347,552,58,23,35,123,75,56,46,88,76,16,9,7,14
S01012348,509,72,21,51,143,65,57,35,47,48,17,9,8,25
S01012349,679,19,7,12,90,51,57,72,152,177,22,12,10,39
S01012350,553,39,18,21,97,57,70,42,105,96,17,9,8,30
S01012351,610,23,6,17,90,57,47,77,142,120,18,11,7,36
S01012352,547,31,11,20,96,50,75,46,108,94,16,10,6,31
S01012353,561,35,8,27,102,57,71,53,103,80,27,14,13,33
S01012354,545,27,4,23,98,47,91,60,85,97,16,10,6,24
S01012355,714,68,19,49,154,68,176,38,94,71,11,9,2,34
S01012356,478,37,10,27,102,70,67,32,73,71,11,9,2,15
S01012357,654,72,18,54,171,65,156,27,78,44,13,9,4,28
S01012358,609,55,10,45,122,36,170,40,73,69,16,13,3,28
S01012359,570,8,6,2,53,47,34,49,140,173,42,27,15,24
S01012360,561,11,2,9,47,49,37,41,143,140,57,42,15,36
S01012361,447,7,4,3,47,23,33,50,104,115,39,16,23,29
S01012362,556,7,2,5,53,33,35,49,129,152,53,35,18,45
S01012363,729,25,9,16,116,67,75,62,121,153,59,37,22,51
S01012364,510,17,7,10,88,62,39,54,102,104,18,8,10,26
S01012365,696,45,18,27,140,105,69,66,95,130,16,11,5,30
S01012366,671,28,8,20,115,74,59,55,127,154,23,15,8,36
S01012367,685,41,12,29,117,88,50,57,120,151,17,6,11,44
S01012368,448,42,10,32,109,63,50,28,63,63,8,2,6,22
S01012369,658,49,20,29,134,79,79,43,103,120,17,10,7,34
S01012370,711,33,8,25,108,70,67,56,136,195,23,16,7,23
S01012371,672,28,12,16,103,64,49,60,131,174,34,22,12,29
S01012372,551,17,3,14,63,62,45,52,106,149,29,16,13,28
S01012373,746,43,14,29,134,101,53,55,117,163,42,30,12,38
S01012374,659,22,11,11,108,78,59,52,145,140,21,12,9,34
S01012375,668,20,8,12,88,68,42,64,121,196,34,17,17,35
S01012376,731,93,26,67,184,72,143,41,86,51,14,5,9,47
S01012377,543,86,20,66,134,65,93,32,53,41,13,11,2,26
S01012378,456,41,11,30,104,45,102,29,54,46,13,9,4,22
S01012379,398,33,11,22,99,40,67,29,68,27,14,10,4,21
S01012380,673,27,12,15,131,93,64,77,112,117,22,15,7,30
S01012381,573,26,9,17,107,73,53,46,119,104,20,12,8,25
S01012382,725,50,16,34,201,123,94,52,96,69,18,15,3,22
S01012383,601,34,5,29,125,89,52,55,94,111,19,12,7,22
S01012384,380,29,8,21,99,51,36,32,60,48,13,5,8,12
S01012385,554,40,9,31,146,76,66,42,81,53,20,10,10,30
S01012386,714,36,7,29,81,91,53,66,163,132,55,32,23,37
S01012387,692,47,11,36,154,85,68,104,131,68,9,5,4,26
S01012388,516,55,14,41,139,53,61,39,87,55,6,6,0,21
S01012389,630,34,16,18,149,63,58,71,122,92,8,5,3,33
S01012390,583,49,11,38,127,66,44,61,119,87,4,4,0,26
S01012391,752,65,23,42,187,104,72,80,109,83,13,8,5,39
S01012392,569,40,16,24,144,70,29,58,117,70,11,9,2,30
S01012393,684,43,11,32,163,65,70,75,129,102,12,10,2,25
S01012394,475,17,6,11,81,51,27,50,107,95,20,10,10,27
S01012395,439,22,3,19,92,51,36,38,98,77,6,3,3,19
S01012396,468,25,7,18,95,57,33,60,92,77,12,10,2,17
S01012397,636,49,10,39,159,59,56,82,114,79,14,8,6,24
S01012398,665,56,9,47,152,74,32,67,128,119,12,10,2,25
S01012399,451,17,5,12,70,55,15,59,112,98,3,2,1,22
S01012400,455,11,3,8,64,44,36,66,104,98,13,7,6,19
S01012401,619,19,6,13,101,55,38,76,134,155,27,14,13,14
S01012402,335,18,2,16,72,39,35,42,66,44,5,2,3,14
S01012403,793,59,12,47,175,89,105,70,143,111,10,8,2,31
S01012404,736,35,7,28,167,71,62,84,143,124,15,6,9,35
S01012405,529,42,12,30,138,64,61,66,73,52,5,4,1,28
S01012406,461,36,6,30,109,38,49,55,78,69,5,3,2,22
S01012407,589,43,6,37,122,64,65,62,117,82,13,8,5,21
S01012408,460,27,6,21,93,47,60,47,83,63,3,2,1,37
S01012409,497,37,10,27,104,35,68,46,93,87,10,7,3,17
S01012410,795,42,10,32,186,82,57,108,156,107,17,8,9,40
S01012411,718,36,10,26,108,80,43,105,151,134,22,16,6,39
S01012412,487,25,2,23,70,40,68,66,110,71,13,6,7,24
S01012413,696,32,8,24,170,52,66,81,144,130,9,7,2,12
S01012414,522,22,4,18,106,34,66,63,130,72,14,7,7,15
S01012415,402,11,1,10,62,32,85,36,93,59,4,1,3,20
S01012416,408,12,3,9,83,28,73,45,81,62,5,4,1,19
S01012417,469,17,5,12,76,44,79,49,103,70,14,9,5,17
S01012418,610,27,10,17,94,56,153,51,109,62,33,19,14,25
S01012419,572,40,11,29,97,50,144,52,80,47,26,13,13,36
S01012420,625,23,11,12,72,51,50,75,151,131,30,21,9,42
S01012421,555,27,5,22,114,47,87,69,88,72,14,11,3,37
S01012422,645,47,14,33,133,55,102,64,104,77,28,13,15,35
S01012423,624,41,12,29,139,59,94,67,97,75,22,11,11,30
S01012424,671,21,4,17,78,73,49,85,161,136,35,12,23,33
S01012425,433,5,2,3,38,25,25,34,113,127,38,32,6,28
S01012426,343,1,1,0,36,38,20,45,76,70,29,13,16,28
S01012427,485,7,1,6,53,27,28,49,131,119,36,23,13,35
S01012428,486,15,3,12,54,64,35,51,127,96,19,11,8,25
S01012429,407,13,3,10,73,53,29,47,79,68,24,15,9,21
S01012430,414,18,6,12,84,45,39,42,88,53,19,14,5,26
S01012431,652,46,10,36,121,60,97,55,124,76,36,24,12,37
S01012432,513,19,4,15,105,52,45,51,94,89,21,12,9,37
S01012433,391,8,0,8,55,48,33,53,82,77,19,15,4,16
S01012434,512,19,7,12,70,56,30,68,104,97,36,20,16,32
S01012435,485,17,3,14,61,52,39,52,114,87,26,9,17,37
S01012436,542,19,7,12,65,62,37,56,127,87,45,24,21,44
S01012437,565,17,8,9,87,70,43,79,103,102,31,24,7,33
S01012438,506,21,5,16,91,61,48,57,103,74,23,11,12,28
S01012439,559,26,7,19,106,71,45,64,95,75,35,17,18,42
S01012440,407,26,6,20,116,56,40,43,51,38,9,5,4,28
S01012441,688,70,14,56,160,62,129,63,87,62,20,12,8,35
S01012442,749,72,16,56,217,72,113,47,101,51,31,19,12,45
S01012443,571,41,13,28,132,76,83,54,73,51,22,13,9,39
S01012444,627,74,16,58,160,78,51,45,75,51,60,51,9,33
S01012445,387,78,14,64,107,39,37,30,33,22,16,12,4,25
S01012446,370,17,4,13,69,57,20,36,75,62,13,7,6,21
S01012447,649,57,9,48,189,103,55,57,72,46,16,11,5,54
S01012448,667,56,16,40,187,103,74,57,70,36,33,22,11,51
S01012449,444,28,8,20,88,72,36,37,79,63,13,6,7,28
S01012450,654,61,10,51,189,65,91,43,64,57,23,19,4,61
S01012451,623,113,19,94,207,98,55,24,48,22,21,17,4,35
S01012452,404,48,11,37,125,64,38,32,52,17,7,3,4,21
S01012453,599,116,35,81,219,75,69,20,40,23,9,4,5,28
S01012454,474,60,13,47,165,82,35,21,49,17,14,8,6,31
S01012455,430,86,16,70,144,62,53,14,19,15,8,3,5,29
S01012456,546,100,30,70,196,70,46,32,37,18,13,6,7,34
S01012457,658,129,34,95,235,90,60,28,57,19,11,6,5,29
S01012458,566,113,19,94,200,58,57,16,43,14,16,10,6,49
S01012459,540,53,9,44,146,98,43,36,71,41,8,4,4,44
S01012460,410,43,8,35,127,74,35,32,48,21,8,4,4,22
S01012461,376,24,1,23,83,45,23,35,71,60,14,10,4,21
S01012462,556,14,1,13,99,44,26,62,117,115,39,24,15,40
S01012463,451,15,3,12,71,56,28,41,94,81,36,20,16,29
S01012464,476,9,2,7,63,50,27,49,114,81,40,23,17,43
S01012465,542,11,4,7,88,58,30,62,109,108,33,16,17,43
S01012466,582,45,9,36,140,67,63,36,89,63,37,24,13,42
S01012467,496,19,2,17,111,61,39,42,106,65,11,3,8,42
S01012468,550,33,9,24,119,84,34,69,94,58,19,7,12,40
S01012469,556,104,23,81,189,78,58,22,46,19,10,7,3,30
S01012470,683,54,12,42,141,93,38,58,132,85,44,27,17,38
S01012471,605,104,18,86,207,76,79,23,43,26,6,5,1,41
S01012472,498,69,14,55,158,84,44,28,53,23,7,4,3,32
S01012473,414,53,10,43,130,59,23,38,48,23,12,8,4,28
S01012474,534,39,8,31,144,70,40,47,78,54,29,21,8,33
S01012475,450,46,9,37,121,83,29,48,54,34,11,6,5,24
S01012476,676,22,4,18,129,104,37,84,136,78,35,19,16,51
S01012477,524,54,13,41,140,101,31,45,68,40,6,4,2,39
S01012478,607,27,8,19,106,94,44,59,129,84,16,10,6,48
S01012479,533,57,11,46,140,80,42,52,66,45,6,3,3,45
S01012480,450,52,14,38,105,46,29,42,57,54,18,10,8,47
S01012481,671,55,10,45,147,76,42,61,101,74,55,39,16,60
S01012482,561,67,17,50,136,63,66,39,68,39,46,29,17,37
S01012483,698,42,14,28,139,52,48,68,132,99,54,32,22,64
S01012484,579,102,27,75,188,66,62,31,48,22,22,15,7,38
S01012485,588,112,20,92,211,71,62,27,45,16,16,11,5,28
S01012486,368,72,22,50,123,44,40,14,32,11,7,6,1,25
S01012487,476,24,6,18,88,55,42,46,85,88,20,12,8,28
S01012488,693,32,7,25,146,110,46,68,132,84,36,22,14,39
S01012489,801,17,1,16,109,56,44,111,172,165,84,53,31,43
S01012490,779,33,5,28,126,81,37,94,140,147,76,44,32,45
S01012491,343,7,2,5,27,28,12,34,74,88,53,30,23,20
S01012492,631,10,5,5,69,58,32,77,130,106,87,51,36,62
S01012493,463,33,5,28,104,51,33,35,73,85,19,15,4,30
S01012494,720,12,4,8,108,66,40,76,145,119,25,13,12,129
S01012495,757,12,4,8,107,100,40,69,161,152,58,31,27,58
S01012496,571,14,7,7,57,54,28,62,131,120,54,41,13,51
S01012497,378,5,2,3,32,26,17,48,87,102,35,25,10,26
S01012498,592,8,3,5,48,38,26,65,141,139,73,45,28,54
S01012499,499,21,7,14,47,62,30,52,111,88,46,30,16,42
S01012500,347,2,1,1,41,33,19,33,67,100,31,19,12,21
S01012501,428,6,2,4,38,22,5,51,109,104,62,36,26,31
S01012502,574,6,0,6,48,35,31,42,139,137,89,58,31,47
S01012503,467,10,1,9,47,38,25,60,107,109,40,23,17,31
S01012504,446,10,3,7,52,43,21,53,105,90,38,12,26,34
S01012505,783,22,10,12,110,96,50,83,170,142,67,38,29,43
S01012506,360,24,5,19,82,51,28,37,65,32,13,7,6,28
S01012507,730,31,8,23,154,97,45,79,150,95,50,31,19,29
S01012508,558,33,6,27,103,72,32,60,114,73,38,20,18,33
S01012509,401,29,4,25,97,56,39,36,67,40,11,7,4,26
S01012510,659,30,6,24,159,110,35,72,106,78,32,17,15,37
S01012511,514,29,5,24,109,88,26,49,103,55,12,11,1,43
S01012512,480,37,13,24,88,51,39,48,86,53,54,37,17,24
S01012513,423,36,10,26,119,75,24,40,71,23,10,8,2,25
S01012514,719,68,11,57,212,125,42,65,86,46,14,7,7,61
S01012515,434,18,5,13,70,65,36,40,94,65,15,9,6,31
S01012516,466,35,7,28,107,62,27,51,79,53,21,13,8,31
S01012517,640,33,7,26,144,72,40,74,122,70,41,22,19,44
S01012518,428,50,8,42,129,57,36,34,40,28,17,8,9,37
S01012519,386,22,5,17,93,56,43,50,45,40,15,8,7,22
S01012520,564,84,17,67,176,69,44,43,59,26,17,11,6,46
S01012521,371,46,6,40,95,51,33,39,52,28,11,6,5,16
S01012522,651,85,14,71,199,91,75,51,61,32,12,6,6,45
S01012523,638,64,7,57,176,102,42,54,84,45,21,12,9,50
S01012524,630,61,18,43,190,106,53,59,78,32,16,11,5,35
S01012525,564,50,10,40,175,92,41,54,65,36,16,7,9,35
S01012526,574,85,14,71,214,80,43,35,54,18,6,2,4,39
S01012527,448,43,10,33,119,71,38,37,71,43,12,9,3,14
S01012528,616,32,6,26,87,67,31,81,129,109,31,24,7,49
S01012529,539,39,10,29,136,60,25,58,89,73,17,11,6,42
S01012530,608,49,13,36,156,122,37,64,71,54,17,8,9,38
S01012531,566,79,20,59,130,76,51,49,67,55,25,20,5,34
S01012532,597,40,14,26,132,77,69,61,102,63,15,7,8,38
S01012533,420,32,8,24,105,64,29,47,63,40,13,7,6,27
S01012534,421,15,5,10,88,65,20,46,77,66,25,17,8,19
S01012535,626,13,4,9,94,71,38,79,137,131,18,9,9,45
S01012536,576,19,4,15,83,65,50,49,110,111,32,20,12,57
S01012537,620,13,3,10,70,54,35,65,114,127,37,15,22,105
S01012538,791,36,15,21,115,92,63,97,162,131,44,24,20,51
S01012539,523,29,8,21,85,55,77,50,101,75,21,13,8,30
S01012540,528,15,2,13,44,50,38,60,130,121,35,22,13,35
S01012541,808,53,13,40,139,85,137,61,153,97,30,18,12,53
S01012542,702,74,14,60,166,75,68,61,91,60,76,70,6,31
S01012543,522,66,8,58,119,73,79,43,58,45,11,4,7,28
S01012544,581,58,13,45,146,65,59,58,84,63,20,11,9,28
S01012545,335,11,5,6,65,27,28,34,68,70,21,10,11,11
S01012546,602,34,5,29,124,95,62,69,93,61,18,10,8,46
S01012547,565,70,13,57,153,79,41,36,83,46,26,19,7,31
S01012548,630,79,17,62,168,97,49,60,84,49,17,11,6,27
S01012549,399,13,2,11,82,35,19,44,95,67,25,13,12,19
S01012550,621,31,8,23,146,67,43,67,112,70,32,13,19,53
S01012551,624,53,11,42,192,116,48,55,84,32,6,2,4,38
S01012552,706,91,17,74,223,112,55,46,75,37,8,4,4,59
S01012553,623,74,11,63,183,110,41,48,79,31,15,6,9,42
S01012554,357,37,12,25,93,62,27,33,42,18,6,4,2,39
S01012555,416,46,8,38,126,76,23,36,40,21,6,1,5,42
S01012556,437,63,16,47,137,54,32,30,48,21,8,5,3,44
S01012557,447,63,15,48,137,63,32,34,45,25,14,7,7,34
S01012558,454,16,2,14,92,54,22,56,91,74,27,14,13,22
S01012559,538,31,12,19,105,65,34,70,104,74,36,19,17,19
S01012560,392,28,5,23,76,68,20,48,63,57,15,7,8,17
S01012561,549,39,9,30,130,80,29,52,86,58,29,18,11,46
S01012562,568,32,5,27,126,68,31,79,86,79,35,20,15,32
S01012563,475,90,20,70,156,70,41,18,38,9,8,5,3,45
S01012564,608,84,15,69,188,75,73,41,68,31,12,8,4,36
S01012565,538,79,10,69,155,75,50,33,64,38,6,5,1,38
S01012566,544,54,11,43,148,64,52,43,79,53,26,14,12,25
S01012567,792,73,20,53,168,100,62,79,139,71,46,23,23,54
S01012568,436,83,18,65,147,46,47,18,30,16,15,9,6,34
S01012569,559,124,25,99,167,59,77,18,36,17,11,8,3,50
S01012570,367,27,3,24,66,44,51,48,64,33,14,10,4,20
S01012571,624,35,4,31,130,58,98,56,109,84,21,10,11,33
S01012572,408,31,5,26,74,42,58,36,71,55,20,14,6,21
S01012573,633,94,17,77,168,65,104,43,80,37,19,17,2,23
S01012574,654,69,24,45,199,80,89,50,68,59,14,7,7,26
S01012575,474,64,12,52,114,55,56,32,79,35,11,5,6,28
S01012576,545,83,16,67,144,60,75,41,68,46,7,2,5,21
S01012577,569,53,7,46,130,55,81,51,94,72,10,4,6,23
S01012578,661,73,20,53,166,63,86,49,84,86,20,16,4,34
S01012579,522,60,13,47,108,52,67,47,77,61,21,8,13,29
S01012580,588,90,19,71,144,56,106,42,63,39,23,13,10,25
S01012581,521,17,5,12,84,67,36,56,102,76,51,25,26,32
S01012582,690,74,16,58,175,78,100,48,89,62,20,11,9,44
S01012583,525,32,10,22,107,63,38,59,85,91,28,15,13,22
S01012584,555,49,13,36,129,70,75,45,64,69,17,13,4,37
S01012585,610,24,7,17,115,50,46,71,114,117,44,25,19,29
S01012586,751,67,14,53,157,81,88,55,100,93,62,56,6,48
S01012587,655,61,14,47,177,69,117,47,76,58,13,10,3,37
S01012588,493,49,13,36,99,69,79,33,66,58,12,7,5,28
S01012589,510,19,2,17,71,86,22,62,89,110,23,16,7,28
S01012590,592,32,7,25,83,63,34,58,129,130,35,25,10,28
S01012591,577,15,5,10,75,59,28,59,136,136,51,35,16,18
S01012592,431,72,18,54,110,72,46,29,44,24,13,7,6,21
S01012593,647,63,14,49,189,115,39,54,62,67,8,3,5,50
S01012594,361,27,6,21,87,54,19,31,54,51,13,10,3,25
S01012595,492,23,2,21,108,79,41,50,77,73,22,14,8,19
S01012596,566,21,7,14,82,79,31,52,86,139,41,25,16,35
S01012597,334,28,1,27,95,47,23,41,37,33,17,11,6,13
S01012598,530,77,11,66,167,85,32,41,45,38,10,7,3,35
S01012599,494,57,13,44,134,73,33,29,58,51,24,16,8,35
S01012600,571,55,17,38,173,116,32,35,64,45,18,12,6,33
S01012601,691,78,14,64,209,126,41,51,68,53,15,9,6,50
S01012602,434,24,5,19,95,56,16,44,63,75,38,28,10,23
S01012603,531,19,4,15,99,87,32,41,81,105,37,22,15,30
S01012604,514,31,10,21,96,56,21,37,114,104,23,15,8,32
S01012605,386,31,6,25,80,59,18,33,64,55,15,10,5,31
S01012606,547,96,18,78,197,93,20,29,49,25,5,3,2,33
S01012607,596,47,8,39,135,79,46,49,93,70,31,15,16,46
S01012608,613,22,3,19,118,83,30,52,104,133,35,21,14,36
S01012609,614,12,2,10,74,91,29,61,126,151,50,34,16,20
S01012610,691,29,7,22,103,90,43,63,125,119,70,50,20,49
S01012611,659,60,11,49,167,82,45,47,110,81,15,9,6,52
S01012612,569,29,7,22,93,93,42,48,71,94,46,28,18,53
S01012613,521,32,6,26,102,73,29,45,86,100,30,20,10,24
S01012614,799,57,17,40,204,131,46,71,113,83,31,18,13,63
S01012615,515,77,16,61,140,62,54,22,57,47,22,11,11,34
S01012616,688,99,25,74,155,87,86,41,87,60,28,20,8,45
S01012617,305,32,7,25,87,52,43,22,21,17,8,7,1,23
S01012618,420,35,7,28,101,47,34,36,64,50,19,13,6,34
S01012619,407,27,6,21,64,57,31,35,68,70,40,29,11,15
S01012620,566,84,12,72,174,88,55,30,64,24,11,8,3,36
S01012621,437,59,11,48,122,67,35,21,46,30,32,22,10,25
S01012622,540,38,9,29,130,72,46,47,98,61,23,16,7,25
S01012623,506,26,4,22,83,65,35,56,100,93,25,16,9,23
S01012624,522,20,6,14,92,73,35,46,105,84,32,17,15,35
S01012625,401,17,4,13,76,51,28,37,73,70,25,20,5,24
S01012626,374,32,4,28,102,57,24,33,55,30,10,8,2,31
S01012627,412,36,11,25,84,49,30,33,56,59,43,23,20,22
S01012628,670,104,26,78,208,103,58,35,65,36,18,13,5,43
S01012629,351,60,15,45,117,42,28,22,28,20,11,7,4,23
S01012630,614,52,9,43,145,79,51,58,79,78,43,25,18,29
S01012631,681,31,5,26,128,71,42,66,124,115,57,32,25,47
S01012632,551,53,6,47,114,85,101,34,69,63,13,12,1,19
S01012633,527,66,16,50,130,53,90,40,71,32,19,14,5,26
S01012634,526,25,5,20,87,77,56,40,87,92,35,19,16,27
S01012635,824,94,17,77,218,104,82,60,117,78,23,10,13,48
S01012636,466,43,7,36,122,49,74,29,62,57,12,10,2,18
S01012637,612,12,2,10,67,66,30,62,125,160,61,37,24,29
S01012638,630,40,8,32,106,77,44,61,108,127,35,17,18,32
S01012639,620,21,5,16,82,74,42,45,160,138,30,18,12,28
S01012640,703,8,3,5,92,59,69,60,146,146,91,47,44,32
S01012641,678,28,10,18,124,66,55,66,146,114,45,22,23,34
S01012642,601,10,2,8,54,45,25,62,146,162,70,49,21,27
S01012643,339,2,0,2,53,31,18,34,76,84,26,16,10,15
S01012644,477,16,3,13,81,45,32,44,118,84,41,32,9,16
S01012645,576,44,8,36,134,68,68,49,73,86,29,16,13,25
S01012646,706,67,15,52,162,95,80,66,109,71,23,14,9,33
S01012647,525,52,11,41,158,90,35,37,57,54,10,5,5,32
S01012648,411,8,2,6,62,38,24,28,110,78,31,17,14,32
S01012649,505,46,10,36,83,56,42,31,96,65,51,45,6,35
S01012650,466,46,11,35,112,71,47,35,60,61,15,8,7,19
S01012651,472,10,2,8,49,49,21,46,104,140,37,22,15,16
S01012652,828,93,28,65,225,140,50,73,100,78,20,8,12,49
S01012653,671,26,6,20,110,67,59,61,121,108,74,52,22,45
S01012654,576,55,13,42,136,101,67,32,74,56,22,12,10,33
S01012655,816,36,14,22,133,111,77,71,140,144,64,46,18,40
S01012656,595,22,5,17,90,77,43,57,124,117,37,23,14,28
S01012657,395,11,1,10,71,64,24,27,71,80,21,13,8,26
S01012658,747,55,13,42,178,140,59,81,106,69,18,12,6,41
S01012659,746,82,16,66,222,128,43,55,86,56,14,9,5,60
S01012660,532,42,7,35,102,63,29,54,102,90,24,11,13,26
S01012661,582,51,12,39,122,87,59,50,79,80,16,8,8,38
S01012662,567,23,7,16,85,62,44,56,120,116,26,17,9,35
S01012663,545,39,7,32,117,88,52,49,81,71,19,10,9,29
S01012664,691,37,9,28,128,87,72,73,111,111,31,17,14,41
S01012665,521,10,3,7,59,62,35,49,107,130,45,30,15,24
S01012666,497,11,6,5,56,53,27,50,106,146,36,19,17,12
S01012667,445,12,5,7,52,50,37,51,79,86,48,25,23,30
S01012668,547,10,2,8,76,81,44,53,95,116,42,26,16,30
S01012669,569,38,11,27,161,102,20,47,88,60,8,5,3,45
S01012670,545,50,10,40,136,97,34,48,81,47,14,9,5,38
S01012671,685,14,4,10,89,82,47,73,144,158,46,29,17,32
S01012672,547,6,3,3,52,55,25,70,121,154,45,25,20,19
S01012673,456,7,0,7,31,52,16,54,109,122,38,20,18,27
S01012674,414,3,2,1,49,41,18,37,77,98,68,43,25,23
S01012675,604,12,1,11,71,64,35,54,129,159,50,33,17,30
S01012676,595,16,4,12,90,91,36,69,114,108,32,16,16,39
S01012677,439,12,3,9,62,48,29,42,79,112,37,24,13,18
S01012678,553,38,8,30,151,79,47,48,69,66,16,10,6,39
S01012679,594,39,12,27,122,79,46,56,95,114,23,13,10,20
S01012680,406,50,4,46,104,55,30,31,53,44,10,6,4,29
S01012681,518,22,5,17,109,81,69,35,60,70,27,13,14,45
S01012682,520,52,15,37,120,82,45,39,77,63,13,8,5,29
S01012683,568,35,9,26,96,72,33,51,127,74,38,16,22,42
S01012684,406,43,10,33,104,61,36,28,48,48,19,14,5,19
S01012685,579,24,6,18,100,76,37,48,115,106,34,11,23,39
S01012686,711,114,22,92,201,111,69,43,68,45,22,14,8,38
S01012687,384,73,12,61,138,65,40,12,19,10,2,2,0,25
S01012688,591,75,16,59,159,94,44,39,62,65,23,11,12,30
S01012689,358,64,14,50,104,31,37,24,37,30,4,3,1,27
S01012690,391,43,9,34,101,57,26,33,59,39,12,7,5,21
S01012691,548,106,21,85,187,63,37,34,45,16,12,9,3,48
S01012692,557,60,14,46,132,74,38,53,82,56,29,23,6,33
S01012693,662,131,28,103,201,98,56,26,56,20,9,2,7,65
S01012694,328,32,7,25,82,45,23,30,66,26,7,5,2,17
S01012695,612,58,11,47,130,75,114,33,81,66,17,10,7,38
S01012696,702,77,19,58,128,67,126,31,67,55,56,55,1,95
S01012697,380,53,12,41,94,39,72,26,38,27,9,8,1,22
S01012698,590,61,12,49,168,86,74,34,85,36,19,12,7,27
S01012699,786,99,19,80,181,99,125,50,91,65,28,18,10,48
S01012700,614,67,24,43,139,93,67,45,89,49,13,9,4,52
S01012701,431,53,10,43,107,90,28,34,53,24,8,6,2,34
S01012702,451,68,13,55,121,58,42,36,45,46,14,6,8,21
S01012703,456,43,8,35,115,61,32,37,62,45,15,7,8,46
S01012704,563,13,7,6,67,68,39,59,118,117,52,28,24,30
S01012705,574,73,19,54,154,111,44,44,55,33,9,8,1,51
S01012706,516,18,6,12,58,56,29,42,125,120,35,21,14,33
S01012707,699,93,18,75,211,132,52,42,73,31,14,9,5,51
S01012708,548,16,4,12,85,73,32,44,105,115,44,17,27,34
S01012709,379,22,6,16,74,71,21,37,66,51,16,7,9,21
S01012710,534,33,11,22,102,74,42,56,99,80,24,17,7,24
S01012711,626,30,11,19,92,70,38,61,105,143,65,37,28,22
S01012712,613,89,14,75,180,103,43,41,67,24,16,8,8,50
S01012713,526,69,19,50,149,94,35,33,63,39,10,6,4,34
S01012714,441,66,13,53,140,83,33,26,46,16,8,5,3,23
S01012715,556,49,9,40,120,93,38,46,75,77,30,13,17,28
S01012716,611,125,25,100,179,94,66,25,44,21,15,8,7,42
S01012717,725,73,11,62,163,125,49,50,104,88,44,24,20,29
S01012718,726,90,19,71,219,92,52,55,93,64,23,14,9,38
S01012719,644,66,13,53,144,94,48,48,90,70,28,12,16,56
S01012720,447,55,8,47,105,53,33,31,57,44,23,11,12,46
S01012721,472,28,7,21,98,76,28,42,82,77,15,10,5,26
S01012722,576,20,3,17,68,72,20,64,121,133,47,26,21,31
S01012723,510,14,3,11,71,64,36,49,104,103,39,26,13,30
S01012724,551,43,7,36,134,76,41,38,110,74,15,10,5,20
S01012725,698,73,18,55,159,115,44,55,82,85,36,21,15,49
S01012726,431,23,4,19,65,71,29,36,87,71,24,12,12,25
S01012727,528,8,2,6,75,49,25,58,110,117,62,43,19,24
S01012728,556,11,3,8,68,63,27,39,131,129,64,36,28,24
S01012729,638,53,9,44,147,95,46,66,98,61,25,16,9,47
S01012730,428,13,5,8,56,51,23,42,102,93,28,14,14,20
S01012731,571,21,2,19,80,82,30,63,116,124,35,24,11,20
S01012732,520,26,7,19,67,77,25,54,121,101,29,10,19,20
S01012733,755,107,24,83,237,133,78,44,60,33,6,3,3,57
S01012734,422,83,17,66,140,60,28,29,27,15,3,1,2,37
S01012735,376,17,2,15,51,58,13,44,71,79,21,11,10,22
S01012736,707,45,10,35,144,116,34,77,137,94,27,21,6,33
S01012737,608,50,8,42,139,104,42,57,97,67,20,14,6,32
S01012738,474,15,1,14,75,54,33,51,85,93,33,22,11,35
S01012739,612,111,18,93,174,102,64,34,41,27,13,7,6,46
S01012740,621,90,16,74,180,87,62,42,62,43,14,6,8,41
S01012741,471,58,15,43,133,98,29,29,53,34,5,1,4,32
S01012742,551,67,13,54,163,112,40,32,66,31,7,6,1,33
S01012743,449,43,9,34,130,92,31,35,54,21,1,1,0,42
S01012744,556,78,12,66,141,111,37,50,50,45,11,5,6,33
S01012745,532,72,16,56,129,101,41,42,60,36,16,10,6,35
S01012746,614,61,16,45,155,97,46,50,81,64,16,9,7,44
S01012747,629,34,5,29,119,87,37,49,115,96,42,25,17,50
S01012748,591,11,3,8,60,52,28,52,127,159,64,43,21,38
S01012749,645,8,2,6,74,66,44,63,126,125,87,52,35,52
S01012750,588,11,5,6,52,61,27,41,155,136,65,33,32,40
S01012751,596,19,5,14,83,84,26,66,138,115,45,22,23,20
S01012752,638,42,9,33,113,69,39,63,116,122,38,18,20,36
S01012753,371,12,6,6,41,35,18,36,84,97,32,20,12,16
S01012754,438,21,1,20,68,47,27,46,82,91,30,18,12,26
S01012755,387,13,3,10,48,50,15,33,95,71,44,32,12,18
S01012756,378,15,6,9,57,65,25,39,74,66,26,23,3,11
S01012757,359,7,2,5,49,42,26,33,75,94,18,11,7,15
S01012758,450,31,6,25,75,70,38,32,80,61,31,20,11,32
S01012759,549,12,1,11,66,67,27,52,134,110,51,37,14,30
S01012760,696,20,9,11,100,104,29,67,123,130,72,47,25,51
S01012761,599,32,8,24,90,93,40,69,101,104,39,17,22,31
S01012762,567,25,6,19,91,93,32,74,108,93,18,10,8,33
S01012763,326,11,6,5,46,33,14,38,76,67,22,17,5,19
S01012764,569,26,10,16,87,83,27,56,102,117,35,24,11,36
S01012765,553,30,8,22,113,67,32,52,111,84,29,20,9,35
S01012766,642,29,10,19,102,86,40,76,124,107,40,20,20,38
S01012767,458,34,8,26,109,78,32,45,77,50,7,5,2,26
S01012768,592,39,8,31,127,132,37,68,103,49,6,4,2,31
S01012769,342,41,9,32,88,50,31,21,42,35,10,8,2,24
S01012770,628,29,5,24,121,110,37,58,113,96,27,17,10,37
S01012771,554,46,9,37,104,72,28,48,100,78,38,22,16,40
S01012772,505,8,3,5,46,67,28,56,116,119,36,22,14,29
S01012773,674,35,7,28,110,93,45,64,135,126,39,25,14,27
S01012774,676,41,14,27,121,99,36,69,125,101,45,24,21,39
S01012775,329,18,4,14,62,47,28,28,72,36,22,10,12,16
S01012776,594,13,0,13,71,71,26,57,142,136,42,18,24,36
S01012777,699,50,10,40,167,114,51,72,104,57,30,25,5,54
S01012778,527,31,7,24,95,84,24,41,76,87,48,34,14,41
S01012779,332,15,3,12,51,36,20,27,61,67,35,19,16,20
S01012780,524,17,5,12,64,59,26,45,126,98,57,34,23,32
S01012781,514,31,5,26,133,74,48,42,78,51,17,10,7,40
S01012782,464,6,1,5,41,62,22,41,105,110,54,33,21,23
S01012783,524,12,2,10,54,59,26,54,115,116,59,34,25,29
S01012784,565,22,3,19,94,80,21,65,121,103,34,16,18,25
S01012785,543,10,3,7,61,52,30,55,131,123,67,39,28,14
S01012786,551,10,1,9,55,59,21,59,117,104,75,38,37,51
S01012787,433,32,8,24,110,63,25,33,74,46,20,13,7,30
S01012788,477,20,2,18,53,37,26,47,72,128,62,42,20,32
S01012789,586,55,9,46,114,93,46,46,92,71,29,17,12,40
S01012790,438,83,9,74,137,67,23,18,34,35,11,9,2,30
S01012791,523,76,17,59,155,90,39,21,68,28,7,3,4,39
S01012792,696,52,8,44,144,117,44,56,98,113,36,20,16,36
S01012793,624,22,6,16,81,59,33,31,116,107,55,41,14,120
S01012794,494,76,12,64,153,61,39,32,53,50,12,6,6,18
S01012795,787,19,6,13,73,83,50,64,195,176,69,43,26,58
S01012796,581,28,3,25,114,88,37,42,113,95,36,18,18,28
S01012797,528,20,4,16,91,53,28,44,108,97,51,29,22,36
S01012798,518,107,29,78,144,61,55,21,37,33,11,6,5,49
S01012799,555,122,25,97,184,69,57,23,31,25,8,4,4,36
S01012800,674,135,21,114,220,79,69,30,50,22,12,7,5,57
S01012801,297,65,8,57,93,41,22,12,21,15,6,3,3,22
S01012802,461,114,25,89,109,60,57,20,27,9,10,8,2,55
S01012803,544,72,14,58,160,111,29,31,44,25,4,1,3,68
S01012804,561,33,2,31,117,82,43,48,102,69,30,19,11,37
S01012805,664,36,10,26,109,102,35,51,137,100,37,20,17,57
S01012806,550,54,11,43,125,86,36,35,77,65,30,20,10,42
S01012807,436,96,24,72,119,58,59,18,19,16,5,2,3,46
S01012808,757,132,28,104,194,109,60,51,84,52,24,12,12,51
S01012809,494,68,12,56,139,60,35,37,60,35,19,9,10,41
S01012810,648,48,15,33,98,103,42,53,116,112,31,18,13,45
S01012811,587,57,10,47,133,80,30,50,96,76,21,13,8,44
S01012812,520,53,10,43,118,76,34,42,80,66,19,10,9,32
S01012813,693,139,27,112,217,115,52,33,58,22,12,10,2,45
S01012814,624,50,5,45,188,108,49,55,71,55,16,3,13,32
S01012815,620,84,17,67,178,101,45,52,67,37,18,6,12,38
S01012816,425,35,10,25,102,68,39,37,54,44,17,11,6,29
S01012817,382,56,10,46,95,83,33,17,36,27,11,7,4,24
S01012818,614,60,8,52,161,104,40,42,91,41,17,12,5,58
S01012819,555,16,3,13,68,66,21,60,128,110,53,33,20,33
S01012820,772,79,14,65,195,133,76,54,101,56,25,16,9,53
S01012821,549,63,9,54,116,85,59,49,57,36,42,34,8,42
S01012822,345,11,1,10,29,38,17,41,82,68,41,19,22,18
S01012823,626,46,10,36,133,101,42,61,112,51,31,20,11,49
S01012824,492,26,6,20,115,83,33,40,81,59,18,11,7,37
S01012825,380,21,4,17,67,46,19,37,61,77,27,13,14,25
S01012826,436,11,4,7,46,46,21,29,85,87,69,50,19,42
S01012827,475,46,11,35,129,74,40,39,49,51,23,18,5,24
S01012828,456,41,7,34,147,82,31,29,62,40,6,3,3,18
S01012829,607,16,1,15,63,75,39,44,137,145,65,43,22,23
S01012830,526,23,9,14,93,71,42,50,105,79,42,32,10,21
S01012831,466,18,6,12,80,54,32,48,89,105,22,14,8,18
S01012832,407,26,6,20,66,58,37,34,72,56,30,20,10,28
S01012833,529,21,1,20,60,57,21,37,132,112,56,38,18,33
S01012834,491,38,4,34,76,64,41,46,81,77,49,31,18,19
S01012835,679,52,10,42,155,99,35,63,92,110,46,34,12,27
S01012836,495,60,13,47,132,70,54,39,48,30,16,11,5,46
S01012837,565,8,2,6,48,69,28,52,128,103,87,41,46,42
S01012838,686,17,3,14,74,66,24,67,159,134,114,55,59,31
S01012839,551,45,8,37,130,100,52,53,90,46,10,4,6,25
S01012840,580,86,19,67,159,106,45,30,72,32,13,8,5,37
S01012841,461,47,9,38,129,76,39,48,53,35,7,4,3,27
S01012842,393,39,7,32,100,67,20,39,56,36,10,7,3,26
S01012843,707,118,21,97,219,107,64,31,61,29,20,15,5,58
S01012844,521,110,20,90,165,60,45,17,34,25,9,5,4,56
S01012845,511,90,13,77,139,64,50,23,45,24,31,24,7,45
S01012846,695,26,3,23,104,107,42,66,120,131,56,36,20,43
S01012847,403,21,4,17,85,65,39,40,65,40,12,9,3,36
S01012848,541,60,11,49,141,85,47,43,70,48,20,10,10,27
S01012849,528,43,9,34,96,96,27,47,83,79,34,23,11,23
S01012850,529,15,4,11,72,73,27,45,114,130,26,19,7,27
S01012851,611,41,9,32,126,90,40,47,105,84,28,24,4,50
S01012852,534,81,15,66,162,103,34,33,47,16,9,4,5,49
S01012853,593,46,12,34,174,100,45,43,86,48,16,9,7,35
S01012854,646,89,11,78,178,123,44,34,73,44,12,9,3,49
S01012855,517,69,13,56,154,78,30,35,74,31,20,12,8,26
S01012856,506,23,5,18,95,83,31,32,89,89,42,28,14,22
S01012857,578,17,3,14,97,107,26,54,118,85,53,41,12,21
S01012858,571,34,6,28,83,94,24,49,116,93,43,29,14,35
S01012859,797,34,3,31,144,131,61,60,122,120,46,27,19,79
S01012860,669,51,17,34,150,115,69,30,96,75,28,19,9,55
S01012861,539,46,10,36,141,71,52,40,71,53,17,9,8,48
S01012862,461,6,3,3,56,56,26,49,104,79,46,25,21,39
S01012863,527,17,2,15,81,67,16,46,97,110,72,32,40,21
S01012864,635,19,2,17,86,96,38,50,109,119,77,44,33,41
S01012865,557,34,5,29,87,94,42,42,106,86,24,17,7,42
S01012866,589,28,9,19,101,92,36,50,95,95,36,16,20,56
S01012867,559,6,3,3,60,56,23,68,110,161,55,37,18,20
S01012868,458,9,1,8,66,62,22,53,101,95,30,17,13,20
S01012869,405,7,2,5,28,43,18,39,82,95,68,45,23,25
S01012870,729,38,10,28,150,127,63,57,131,98,26,20,6,39
S01012871,635,37,7,30,158,131,45,43,96,65,25,13,12,35
S01012872,552,27,5,22,100,122,31,44,94,69,25,13,12,40
S01012873,621,33,7,26,123,138,36,54,91,74,24,17,7,48
S01012874,583,26,5,21,90,76,32,47,124,104,45,20,25,39
S01012875,455,18,0,18,76,60,29,34,74,87,38,21,17,39
S01012876,584,17,8,9,70,76,34,51,148,114,35,24,11,39
S01012877,552,8,3,5,67,107,31,51,113,122,23,13,10,30
S01012878,726,99,25,74,193,148,52,46,81,42,8,3,5,57
S01012879,535,76,12,64,143,82,37,33,49,44,17,7,10,54
S01012880,659,129,18,111,188,96,41,34,62,21,16,11,5,72
S01012881,604,87,17,70,162,113,43,34,65,36,18,14,4,46
S01012882,452,20,5,15,61,55,31,47,92,81,29,18,11,36
S01012883,456,17,4,13,49,48,34,31,103,100,54,28,26,20
S01012884,352,41,11,30,81,35,26,23,46,52,21,13,8,27
S01012885,347,4,1,3,28,47,20,24,86,81,42,27,15,15
S01012886,573,71,10,61,169,97,38,48,57,38,13,9,4,42
S01012887,542,83,17,66,151,94,30,38,62,34,15,9,6,35
S01012888,588,125,20,105,176,80,46,29,30,34,11,7,4,57
S01012889,651,75,15,60,173,87,55,47,85,75,19,18,1,35
S01012890,529,26,7,19,70,60,29,43,105,106,49,36,13,41
S01012891,408,14,3,11,56,51,39,32,93,85,19,9,10,19
S01012892,834,29,6,23,84,110,42,93,181,180,75,34,41,40
S01012893,529,13,3,10,48,62,23,55,144,104,44,25,19,36
S01012894,568,72,14,58,152,75,45,28,66,55,26,18,8,49
S01012895,388,50,13,37,105,46,49,26,42,28,11,7,4,31
S01012896,681,39,10,29,127,113,44,62,134,92,34,20,14,36
S01012897,451,54,8,46,112,72,35,38,71,27,12,10,2,30
S01012898,397,71,16,55,104,59,32,28,36,20,8,3,5,39
S01012899,444,13,2,11,69,70,32,48,82,87,27,8,19,16
S01012900,457,53,9,44,123,67,56,36,37,43,15,11,4,27
S01012901,523,29,9,20,102,92,39,44,87,69,22,7,15,39
S01012902,585,33,8,25,143,105,34,52,91,71,23,9,14,33
S01012903,619,28,6,22,103,112,32,62,112,86,28,9,19,56
S01012904,573,23,4,19,105,116,39,57,97,58,35,21,14,43
S01012905,465,15,3,12,68,79,24,45,95,67,24,11,13,48
S01012906,693,57,9,48,197,121,39,66,100,55,18,6,12,40
S01012907,607,23,4,19,116,116,36,60,110,86,22,12,10,38
S01012908,524,18,3,15,85,88,30,50,89,83,38,18,20,43
S01012909,411,22,5,17,95,85,16,32,68,55,22,13,9,16
S01012910,654,24,6,18,112,100,52,56,129,113,34,15,19,34
S01012911,536,40,7,33,118,78,29,56,97,52,15,12,3,51
S01012912,476,26,10,16,85,89,29,37,87,70,24,10,14,29
S01012913,623,49,7,42,111,120,29,49,106,96,21,8,13,42
S01012914,636,63,8,55,142,90,41,68,93,75,25,12,13,39
S01012915,745,74,21,53,196,125,47,72,96,70,25,6,19,40
S01012916,510,42,7,35,124,87,28,44,63,58,10,7,3,54
S01012917,537,57,6,51,139,100,41,35,68,31,5,5,0,61
S01012918,352,24,7,17,63,70,20,40,51,51,11,4,7,22
S01012919,334,15,2,13,77,64,17,38,51,42,18,10,8,12
S01012920,466,63,11,52,146,83,49,22,42,14,9,3,6,38
S01012921,511,24,9,15,91,97,24,44,95,69,24,13,11,43
S01012922,719,60,14,46,171,114,36,58,119,84,19,10,9,58
S01012923,541,41,12,29,112,97,35,48,78,61,14,12,2,55
S01012924,395,31,10,21,83,72,37,36,51,39,13,4,9,33
S01012925,378,42,12,30,108,74,22,19,36,23,7,1,6,47
S01012926,558,45,10,35,126,99,45,49,71,52,21,7,14,50
S01012927,582,41,2,39,121,91,29,52,97,79,14,7,7,58
S01012928,596,43,11,32,158,111,33,39,79,55,16,8,8,62
S01012929,541,44,9,35,117,113,27,51,74,61,9,6,3,45
S01012930,607,60,9,51,155,103,39,48,68,81,28,10,18,25
S01012931,649,48,11,37,138,127,37,62,99,77,21,11,10,40
S01012932,368,57,13,44,90,45,37,32,41,23,8,6,2,35
S01012933,597,41,7,34,111,107,39,55,97,70,35,23,12,42
S01012934,500,36,5,31,108,85,39,45,82,60,27,14,13,18
S01012935,616,51,11,40,124,109,33,41,108,68,26,10,16,56
S01012936,524,51,10,41,111,77,43,48,68,60,31,19,12,35
S01012937,526,53,14,39,118,90,19,41,73,52,30,15,15,50
S01012938,528,97,21,76,142,69,39,31,47,33,11,5,6,59
S01012939,477,71,11,60,129,82,29,29,48,17,9,6,3,63
S01012940,555,83,13,70,148,109,49,33,55,22,5,4,1,51
S01012941,592,107,27,80,177,99,44,24,39,20,11,9,2,71
S01012942,555,27,4,23,86,88,19,60,112,87,30,13,17,46
S01012943,538,64,14,50,143,84,35,46,68,40,13,4,9,45
S01012944,379,52,7,45,135,66,26,15,24,15,10,6,4,36
S01012945,538,98,22,76,159,89,45,29,33,17,10,5,5,58
S01012946,658,78,13,65,202,116,46,45,54,39,5,5,0,73
S01012947,365,68,12,56,99,52,36,13,17,19,9,5,4,52
S01012948,553,55,15,40,135,107,49,31,73,43,7,6,1,53
S01012949,562,52,9,43,147,104,50,45,56,43,15,10,5,50
S01012950,672,109,22,87,198,113,46,23,53,27,16,7,9,87
S01012951,646,137,34,103,228,80,62,20,44,19,11,8,3,45
S01012952,463,94,19,75,128,56,81,15,22,12,8,6,2,47
S01012953,541,57,12,45,139,131,38,24,58,42,13,10,3,39
S01012954,380,31,2,29,94,78,26,26,54,33,7,1,6,31
S01012955,697,123,28,95,205,117,41,43,54,34,17,10,7,63
S01012956,683,50,5,45,116,125,39,63,96,96,38,27,11,60
S01012957,483,28,8,20,89,78,28,43,82,69,28,11,17,38
S01012958,416,30,4,26,87,74,33,31,64,49,19,16,3,29
S01012959,455,39,11,28,111,86,31,28,67,39,9,8,1,45
S01012960,478,50,6,44,107,74,28,31,81,48,18,8,10,41
S01012961,400,52,15,37,106,80,32,18,39,33,4,1,3,36
S01012962,526,69,13,56,146,106,32,35,56,26,5,2,3,51
S01012963,590,88,24,64,166,98,43,41,63,32,9,5,4,50
S01012964,443,65,16,49,123,63,41,40,32,27,7,2,5,45
S01012965,458,66,9,57,107,65,23,33,66,40,12,5,7,46
S01012966,518,43,7,36,122,68,40,44,79,64,16,7,9,42
S01012967,383,16,2,14,62,60,22,40,75,64,16,8,8,28
S01012968,504,20,1,19,83,90,29,36,107,99,12,9,3,28
S01012969,512,30,6,24,81,82,26,42,97,96,13,5,8,45
S01012970,449,21,5,16,83,60,35,38,94,78,16,9,7,24
S01012971,628,27,6,21,93,78,35,53,114,120,43,27,16,65
S01012972,572,14,4,10,70,94,37,67,113,119,28,16,12,30
S01012973,587,35,11,24,97,101,29,61,126,84,25,18,7,29
S01012974,703,36,6,30,112,87,44,65,151,127,46,25,21,35
S01012975,431,18,6,12,51,71,19,45,103,78,22,12,10,24
S01012976,401,22,6,16,63,64,18,26,99,61,13,6,7,35
S01012977,541,21,5,16,80,63,34,59,116,92,26,17,9,50
S01012978,618,25,8,17,79,81,37,60,108,125,39,30,9,64
S01012979,476,24,5,19,88,57,32,46,97,72,18,13,5,42
S01012980,494,20,3,17,86,84,21,49,85,77,34,15,19,38
S01012981,585,30,10,20,107,95,24,57,100,98,18,7,11,56
S01012982,619,22,7,15,115,118,29,70,105,105,20,11,9,35
S01012983,566,50,6,44,127,118,35,35,85,51,10,2,8,55
S01012984,472,29,5,24,115,78,22,38,82,51,15,5,10,42
S01012985,574,24,4,20,107,101,42,66,89,81,15,11,4,49
S01012986,560,19,5,14,109,104,27,47,96,99,24,12,12,35
S01012987,539,24,2,22,93,87,44,43,96,86,21,11,10,45
S01012988,620,30,7,23,125,95,30,73,110,90,21,11,10,46
S01012989,663,35,7,28,135,132,34,65,100,81,33,15,18,48
S01012990,429,16,8,8,71,85,20,42,65,74,20,8,12,36
S01012991,561,28,3,25,116,97,32,59,84,87,26,10,16,32
S01012992,549,31,6,25,114,87,29,45,103,67,22,9,13,51
S01012993,494,24,3,21,89,92,27,50,86,64,26,12,14,36
S01012994,656,36,6,30,108,104,46,61,114,108,29,9,20,50
S01012995,628,55,14,41,131,118,37,67,95,83,13,8,5,29
S01012996,533,13,1,12,107,81,36,52,106,65,21,8,13,52
S01012997,364,27,3,24,73,62,11,29,70,49,14,5,9,29
S01012998,771,65,19,46,166,126,48,62,112,108,14,7,7,70
S01012999,346,17,3,14,52,49,22,36,62,67,13,7,6,28
S01013000,475,24,2,22,74,70,29,57,111,75,14,4,10,21
S01013001,282,51,15,36,85,20,51,22,24,7,3,1,2,19
S01013002,367,81,8,73,80,33,63,18,32,19,5,2,3,36
S01013003,454,131,19,112,146,47,34,14,31,10,4,1,3,37
S01013004,474,84,10,74,142,45,60,23,41,21,14,7,7,44
S01013005,517,122,21,101,157,46,70,23,33,19,10,6,4,37
S01013006,457,124,23,101,142,37,37,17,30,13,13,8,5,44
S01013007,654,123,22,101,218,78,62,33,54,30,14,9,5,42
S01013008,570,119,34,85,148,57,58,39,51,44,18,8,10,36
S01013009,439,45,8,37,126,59,49,34,64,34,8,6,2,20
S01013010,438,83,20,63,108,41,90,18,37,25,10,4,6,26
S01013011,477,68,9,59,136,48,68,26,54,22,11,5,6,44
S01013012,476,48,8,40,102,54,40,41,78,45,22,13,9,46
S01013013,510,80,20,60,126,55,78,18,67,43,12,7,5,31
S01013014,523,48,11,37,132,53,85,42,70,51,18,11,7,24
S01013015,531,76,17,59,143,55,100,42,29,36,7,4,3,43
S01013016,459,99,19,80,122,43,92,21,32,17,5,3,2,28
S01013017,596,91,22,69,150,58,64,45,86,47,16,9,7,39
S01013018,687,123,23,100,199,82,88,45,52,34,21,10,11,43
S01013019,634,137,30,107,218,76,51,23,53,23,4,0,4,49
S01013020,333,22,3,19,69,43,21,30,52,71,12,8,4,13
S01013021,342,23,3,20,59,50,28,30,61,55,14,12,2,22
S01013022,310,28,5,23,81,44,18,20,52,32,15,8,7,20
S01013023,642,123,26,97,243,76,45,21,56,28,9,7,2,41
S01013024,365,59,17,42,110,50,34,23,35,21,4,2,2,29
S01013025,413,50,12,38,94,33,101,23,26,44,13,9,4,29
S01013026,760,67,11,56,148,104,43,70,124,135,41,24,17,28
S01013027,726,19,6,13,63,70,29,72,162,189,79,46,33,43
S01013028,367,38,10,28,68,32,43,34,61,53,10,5,5,28
S01013029,435,13,2,11,44,41,14,42,110,127,22,15,7,22
S01013030,454,11,1,10,46,54,31,51,83,106,48,32,16,24
S01013031,479,5,1,4,44,46,27,55,107,141,27,11,16,27
S01013032,564,48,12,36,123,84,51,56,87,81,8,5,3,26
S01013033,496,19,3,16,98,64,35,56,92,90,18,10,8,24
S01013034,537,14,3,11,49,60,17,76,133,133,30,22,8,25
S01013035,506,8,3,5,48,41,18,62,110,154,37,23,14,28
S01013036,585,8,1,7,60,45,30,73,132,145,59,39,20,33
S01013037,567,42,9,33,142,98,41,59,76,49,16,9,7,44
S01013038,701,36,7,29,118,85,39,70,140,116,44,33,11,53
S01013039,416,45,10,35,95,78,19,34,47,28,6,6,0,64
S01013040,480,29,1,28,82,77,36,57,106,57,12,8,4,24
S01013041,445,24,5,19,91,61,31,41,81,70,18,8,10,28
S01013042,613,54,14,40,128,85,54,53,78,86,22,14,8,53
S01013043,510,16,4,12,68,53,30,49,100,118,45,32,13,31
S01013044,610,12,1,11,92,65,31,55,144,129,38,23,15,44
S01013045,490,42,6,36,95,69,34,41,83,71,20,13,7,35
S01013046,392,9,5,4,56,55,23,36,82,75,20,12,8,36
S01013047,685,81,20,61,194,111,47,53,84,53,12,9,3,50
S01013048,646,54,15,39,176,110,24,68,96,66,14,3,11,38
S01013049,639,75,13,62,178,109,41,58,88,41,11,6,5,38
S01013050,608,38,11,27,105,87,46,65,91,96,49,35,14,31
S01013051,667,28,5,23,100,106,43,69,132,117,41,25,16,31
S01013052,522,28,4,24,87,76,31,52,100,88,34,28,6,26
S01013053,465,19,4,15,58,59,38,46,89,95,44,32,12,17
S01013054,504,41,9,32,105,69,37,53,86,70,20,12,8,23
S01013055,512,17,2,15,78,58,45,50,102,100,30,17,13,32
S01013056,677,29,5,24,98,80,50,78,117,139,41,31,10,45
S01013057,602,19,4,15,71,69,39,60,122,108,70,39,31,44
S01013058,414,64,18,46,132,61,26,24,40,26,11,7,4,30
S01013059,521,111,24,87,138,72,38,25,46,40,20,14,6,31
S01013060,381,76,16,60,125,46,26,17,25,13,24,15,9,29
S01013061,563,107,23,84,206,76,39,26,45,19,6,3,3,39
S01013062,573,144,23,121,187,59,52,25,27,13,12,8,4,54
S01013063,580,181,30,151,163,53,48,9,26,20,11,6,5,69
S01013064,634,26,5,21,106,93,41,60,138,114,31,22,9,25
S01013065,661,29,6,23,108,93,35,61,111,110,39,22,17,75
S01013066,552,42,12,30,118,68,45,47,80,63,42,21,21,47
S01013067,768,52,3,49,89,39,21,41,49,47,33,19,14,397
S01013068,636,37,4,33,79,52,21,40,88,100,51,25,26,168
S01013069,648,45,9,36,69,34,23,31,59,43,42,28,14,302
S01013070,546,19,2,17,53,36,23,26,65,46,33,23,10,245
S01013071,914,25,5,20,85,31,20,39,60,59,26,20,6,569
S01013072,408,8,2,6,31,32,14,38,98,116,42,30,12,29
S01013073,585,26,3,23,100,46,24,40,103,112,68,47,21,66
S01013074,493,8,0,8,28,22,39,52,113,119,68,44,24,44
S01013075,657,21,3,18,73,50,40,54,123,162,77,52,25,57
S01013076,641,45,8,37,73,33,37,19,43,24,10,6,4,357
S01013077,504,20,3,17,53,58,15,51,105,115,55,27,28,32
S01013078,417,6,1,5,49,47,20,45,78,100,41,29,12,31
S01013079,1022,122,11,111,229,103,68,53,120,103,123,108,15,101
S01013080,645,104,23,81,156,61,51,37,47,33,16,9,7,140
S01013081,498,100,11,89,135,81,36,27,50,30,9,5,4,30
S01013082,660,75,11,64,186,127,44,43,98,36,12,7,5,39
S01013083,2163,56,10,46,111,49,27,18,38,20,7,4,3,1837
S01013084,530,101,23,78,167,73,40,25,51,27,10,6,4,36
S01013085,486,34,9,25,64,46,32,27,55,39,12,8,4,177
S01013086,679,134,15,119,155,71,45,34,63,37,24,15,9,116
S01013087,610,155,37,118,172,53,47,10,25,16,12,4,8,120
S01013088,687,159,36,123,242,72,77,25,35,9,12,6,6,56
S01013089,563,65,12,53,124,67,35,43,73,75,24,13,11,57
S01013090,651,84,13,71,138,50,47,35,58,26,20,13,7,193
S01013091,448,45,6,39,96,38,17,22,24,24,14,11,3,168
S01013092,676,94,14,80,163,77,37,46,66,67,32,18,14,94
S01013093,357,68,20,48,109,48,52,20,19,14,2,2,0,25
S01013094,446,104,16,88,164,60,21,11,33,15,6,4,2,32
S01013095,607,181,47,134,200,53,39,19,30,21,6,2,4,58
S01013096,420,29,11,18,83,45,20,31,62,52,10,4,6,88
S01013097,466,92,17,75,154,33,63,27,37,26,9,7,2,25
S01013098,416,131,37,94,143,33,25,9,22,13,5,3,2,35
S01013099,645,110,15,95,219,51,61,49,65,32,17,9,8,41
S01013100,416,114,28,86,149,46,31,12,19,9,16,12,4,20
S01013101,716,63,14,49,146,82,54,82,124,81,41,24,17,43
S01013102,409,79,16,63,149,42,14,18,56,20,7,4,3,24
S01013103,590,98,25,73,201,76,48,36,56,16,11,5,6,48
S01013104,718,126,24,102,243,96,66,32,70,25,17,9,8,43
S01013105,658,154,30,124,221,80,42,23,55,29,16,11,5,38
S01013106,577,56,8,48,134,58,76,50,77,67,17,11,6,42
S01013107,512,90,19,71,160,65,69,31,40,22,8,7,1,27
S01013108,436,59,10,49,94,49,52,31,70,49,11,6,5,21
S01013109,824,110,22,88,174,87,141,53,106,59,49,43,6,45
S01013110,437,50,6,44,124,33,96,26,47,25,13,8,5,23
S01013111,341,52,3,49,103,31,56,14,29,20,2,1,1,34
S01013112,457,47,11,36,97,57,49,38,75,46,17,8,9,31
S01013113,572,30,10,20,112,49,66,51,129,85,24,18,6,26
S01013114,620,68,15,53,134,67,101,51,83,61,21,11,10,34
S01013115,465,27,5,22,105,49,74,46,88,37,15,9,6,24
S01013116,559,78,21,57,187,62,80,26,62,25,9,7,2,30
S01013117,477,29,6,23,121,39,48,65,82,51,11,9,2,31
S01013118,418,55,11,44,110,26,60,41,45,60,5,3,2,16
S01013119,607,61,18,43,148,43,145,41,69,61,11,7,4,28
S01013120,736,61,11,50,141,62,140,78,125,79,9,4,5,41
S01013121,314,15,2,13,49,18,70,37,57,41,17,7,10,10
S01013122,446,12,4,8,48,50,14,33,97,94,69,37,32,29
S01013123,568,23,5,18,99,102,18,53,114,75,46,25,21,38
S01013124,537,22,10,12,94,90,18,57,109,84,27,17,10,36
S01013125,587,33,15,18,110,117,48,34,96,76,32,24,8,41
S01013126,547,14,3,11,60,71,20,39,127,97,67,37,30,52
S01013127,585,10,2,8,60,66,25,53,145,111,76,45,31,39
S01013128,517,18,6,12,91,93,10,52,96,88,47,22,25,22
S01013129,858,33,10,23,179,143,38,84,156,110,59,37,22,56
S01013130,515,18,3,15,79,63,22,40,105,62,78,49,29,48
S01013131,484,21,6,15,67,86,18,43,98,86,29,12,17,36
S01013132,429,13,0,13,54,53,25,42,97,69,42,24,18,34
S01013133,611,24,5,19,88,95,27,52,122,100,69,38,31,34
S01013134,601,44,12,32,123,94,39,50,97,81,26,16,10,47
S01013135,559,10,1,9,52,71,25,40,134,121,62,43,19,44
S01013136,699,10,3,7,101,107,23,65,159,151,43,27,16,40
S01013137,565,12,3,9,71,89,31,53,109,130,32,19,13,38
S01013138,492,6,1,5,60,71,22,42,117,81,53,30,23,40
S01013139,647,23,6,17,70,96,32,49,148,118,58,35,23,53
S01013140,598,18,5,13,73,73,31,46,127,118,58,45,13,54
S01013141,461,14,6,8,65,77,20,23,87,101,44,28,16,30
S01013142,566,11,4,7,63,78,26,54,122,113,60,43,17,39
S01013143,651,26,5,21,116,102,32,70,123,98,31,22,9,53
S01013144,666,23,8,15,105,108,32,71,139,95,42,22,20,51
S01013145,528,26,7,19,97,82,26,52,96,77,29,18,11,43
S01013146,327,15,3,12,50,47,25,23,75,57,18,14,4,17
S01013147,515,29,4,25,79,89,37,42,96,63,17,13,4,63
S01013148,565,32,8,24,129,110,33,52,96,57,32,18,14,24
S01013149,619,40,11,29,122,124,26,59,90,77,25,13,12,56
S01013150,646,34,8,26,106,128,34,53,123,92,25,16,9,51
S01013151,424,33,8,25,106,88,38,36,48,38,14,9,5,23
S01013152,659,47,10,37,114,106,38,58,106,96,43,29,14,51
S01013153,621,19,4,15,65,80,28,56,137,114,68,41,27,54
S01013154,702,22,5,17,102,105,30,66,137,126,57,28,29,57
S01013155,651,15,2,13,69,75,23,43,168,116,75,44,31,67
S01013156,619,8,2,6,75,67,16,70,138,117,68,35,33,60
S01013157,694,14,4,10,72,93,19,71,145,118,92,57,35,70
S01013158,419,28,5,23,124,80,35,28,51,26,15,10,5,32
S01013159,553,32,11,21,138,117,44,35,77,54,10,5,5,46
S01013160,558,58,14,44,127,137,48,32,72,36,12,5,7,36
S01013161,765,39,4,35,140,144,45,71,128,116,38,21,17,44
S01013162,610,23,7,16,99,107,32,59,112,102,43,18,25,33
S01013163,561,35,8,27,125,106,31,70,76,54,14,7,7,50
S01013164,783,60,10,50,145,118,63,68,119,104,45,24,21,61
S01013165,643,50,7,43,137,118,45,49,93,77,26,16,10,48
S01013166,502,11,3,8,44,71,26,42,107,104,64,36,28,33
S01013167,503,10,1,9,53,68,23,43,109,91,80,26,54,26
S01013168,658,10,0,10,71,114,28,82,133,102,70,38,32,48
S01013169,596,11,2,9,96,101,34,60,122,93,43,33,10,36
S01013170,387,7,0,7,47,61,18,35,80,63,58,33,25,18
S01013171,493,49,10,39,108,93,30,32,60,49,21,11,10,51
S01013172,574,29,8,21,100,113,26,43,115,75,30,18,12,43
S01013173,624,47,17,30,131,106,33,48,105,86,25,13,12,43
S01013174,600,62,13,49,170,105,33,58,81,38,8,5,3,45
S01013175,613,63,10,53,171,109,30,66,73,51,12,5,7,38
S01013176,584,44,10,34,135,108,35,57,86,66,21,12,9,32
S01013177,485,29,6,23,135,106,25,32,64,56,8,5,3,30
S01013178,575,42,10,32,142,92,30,54,85,73,12,5,7,45
S01013179,653,34,9,25,146,117,51,54,105,76,25,18,7,45
S01013180,354,21,4,17,95,63,21,34,41,31,12,6,6,36
S01013181,546,37,13,24,122,87,24,64,85,76,15,5,10,36
S01013182,536,22,4,18,82,74,24,47,122,103,31,14,17,31
S01013183,657,60,14,46,184,116,23,58,88,59,21,10,11,48
S01013184,416,5,1,4,37,59,18,33,106,65,68,44,24,25
S01013185,562,16,4,12,103,77,18,57,122,92,39,15,24,38
S01013186,496,5,3,2,51,67,20,52,144,81,50,23,27,26
S01013187,617,23,7,16,110,76,29,65,123,86,53,30,23,52
S01013188,675,42,11,31,152,108,33,70,110,81,23,16,7,56
S01013189,480,37,8,29,113,68,22,39,91,56,11,7,4,43
S01013190,596,38,10,28,127,91,39,63,97,76,25,14,11,40
S01013191,789,94,24,70,216,139,44,69,77,56,16,11,5,78
S01013192,706,54,9,45,174,123,40,50,117,62,28,18,10,58
S01013193,504,35,11,24,122,105,27,40,79,59,15,9,6,22
S01013194,471,32,6,26,93,76,26,54,86,56,13,4,9,35
S01013195,763,54,3,51,162,132,33,63,136,101,20,12,8,62
S01013196,504,38,13,25,139,72,34,54,78,55,10,5,5,24
S01013197,412,32,10,22,121,72,21,35,57,34,13,9,4,27
S01013198,601,29,10,19,100,87,44,53,105,95,46,31,15,42
S01013199,687,68,15,53,178,85,59,51,105,71,30,15,15,40
S01013200,529,30,6,24,111,74,28,34,90,72,54,44,10,36
S01013201,557,20,3,17,62,63,24,36,134,112,82,53,29,24
S01013202,428,18,4,14,66,44,18,31,75,78,57,34,23,41
S01013203,538,26,2,24,83,62,18,44,111,108,53,32,21,33
S01013204,610,31,5,26,146,96,17,61,102,88,24,12,12,45
S01013205,440,4,1,3,49,39,21,38,104,85,64,46,18,36
S01013206,489,14,4,10,64,60,18,46,113,102,35,18,17,37
S01013207,596,19,6,13,103,81,53,49,117,102,40,27,13,32
S01013208,717,20,6,14,102,80,37,74,149,125,86,63,23,44
S01013209,621,30,3,27,123,98,40,60,116,96,28,15,13,30
S01013210,475,51,9,42,97,95,40,33,63,43,12,6,6,41
S01013211,680,37,11,26,113,112,33,84,140,95,31,20,11,35
S01013212,468,32,7,25,109,82,31,41,72,42,7,5,2,52
S01013213,449,34,6,28,94,86,42,45,54,35,9,4,5,50
S01013214,339,16,4,12,90,63,23,40,46,25,9,6,3,27
S01013215,636,26,7,19,112,115,35,84,125,91,20,6,14,28
S01013216,441,8,2,6,50,65,19,51,101,78,36,25,11,33
S01013217,521,17,5,12,63,74,22,50,125,100,32,15,17,38
S01013218,445,3,2,1,42,39,22,46,117,102,43,28,15,31
S01013219,405,7,1,6,55,42,16,43,105,78,29,12,17,30
S01013220,491,9,1,8,52,58,21,52,130,97,46,20,26,26
S01013221,677,28,6,22,78,85,56,73,144,111,46,25,21,56
S01013222,433,13,3,10,48,55,22,31,98,104,35,24,11,27
S01013223,785,41,11,30,141,110,42,86,130,112,78,50,28,45
S01013224,638,31,5,26,108,91,39,74,128,91,37,22,15,39
S01013225,589,20,2,18,79,65,24,63,124,113,60,39,21,41
S01013226,388,30,11,19,96,59,22,35,63,43,12,6,6,28
S01013227,507,13,1,12,71,57,20,80,113,85,35,24,11,33
S01013228,575,28,10,18,99,73,38,52,129,91,45,19,26,20
S01013229,580,26,5,21,79,88,23,64,113,108,46,28,18,33
S01013230,479,17,2,15,76,95,14,56,91,93,14,11,3,23
S01013231,559,15,5,10,101,97,26,56,107,94,37,26,11,26
S01013232,527,20,8,12,78,76,36,43,116,107,26,17,9,25
S01013233,435,24,5,19,96,66,30,43,86,50,17,13,4,23
S01013234,303,30,10,20,110,49,26,21,28,11,5,4,1,23
S01013235,612,40,7,33,120,107,41,66,118,73,16,11,5,31
S01013236,675,53,10,43,166,113,71,70,85,50,23,18,5,44
S01013237,617,36,10,26,134,112,41,52,96,68,19,13,6,59
S01013238,563,12,2,10,64,58,29,60,133,110,63,41,22,34
S01013239,660,13,2,11,98,63,25,67,150,134,67,37,30,43
S01013240,403,7,4,3,42,37,16,36,95,91,53,32,21,26
S01013241,665,65,22,43,203,132,48,52,77,34,11,6,5,43
S01013242,451,53,9,44,101,53,84,33,49,30,10,7,3,38
S01013243,569,25,7,18,73,66,34,49,131,128,37,22,15,26
S01013244,544,13,2,11,75,66,43,47,107,129,33,20,13,31
S01013245,753,61,16,45,119,112,62,82,121,134,30,15,15,32
S01013246,345,29,9,20,46,52,31,40,64,62,8,7,1,13
S01013247,557,16,3,13,66,62,36,52,133,128,43,28,15,21
S01013248,471,10,4,6,54,65,28,31,110,114,35,14,21,24
S01013249,337,6,1,5,55,43,21,33,74,69,19,12,7,17
S01013250,668,61,9,52,159,60,100,48,89,87,24,16,8,40
S01013251,531,16,5,11,62,61,16,48,120,131,41,25,16,36
S01013252,521,30,14,16,87,54,42,47,87,119,24,15,9,31
S01013253,537,28,5,23,94,80,30,49,103,106,20,9,11,27
S01013254,469,20,4,16,43,48,35,51,80,130,38,26,12,24
S01013255,1158,33,10,23,114,103,106,133,170,288,166,149,17,45
S01013256,516,52,13,39,116,67,48,43,93,45,31,24,7,21
S01013257,574,37,8,29,115,79,52,47,104,84,18,7,11,38
S01013258,588,59,18,41,131,103,50,52,86,55,19,15,4,33
S01013259,622,26,5,21,108,108,36,69,115,104,21,12,9,35
S01013260,633,26,8,18,71,84,22,62,134,145,53,34,19,36
S01013261,575,18,2,16,51,77,28,73,137,127,30,16,14,34
S01013262,485,21,5,16,56,68,37,64,102,95,25,13,12,17
S01013263,388,84,19,65,111,59,37,27,24,17,6,1,5,23
S01013264,372,59,12,47,114,64,23,17,27,14,10,6,4,44
S01013265,478,99,21,78,141,70,41,15,31,14,12,7,5,55
S01013266,415,78,12,66,106,77,26,26,37,22,8,4,4,35
S01013267,408,28,8,20,78,62,27,27,75,53,28,21,7,30
S01013268,613,29,5,24,126,102,34,68,112,83,21,12,9,38
S01013269,730,103,19,84,215,119,48,42,72,59,16,8,8,56
S01013270,593,133,31,102,174,106,38,25,44,20,7,4,3,46
S01013271,469,112,24,88,153,87,24,22,27,16,7,5,2,21
S01013272,553,109,22,87,178,80,38,19,42,26,10,3,7,51
S01013273,635,127,22,105,177,112,51,41,50,27,5,2,3,45
S01013274,651,78,22,56,161,133,35,55,77,46,17,10,7,49
S01013275,508,62,11,51,122,100,61,29,53,40,5,5,0,36
S01013276,488,45,10,35,111,109,32,39,63,41,11,4,7,37
S01013277,681,26,9,17,111,87,31,79,152,114,28,16,12,53
S01013278,607,17,9,8,73,94,33,58,128,113,45,21,24,46
S01013279,527,19,7,12,65,72,21,47,119,95,40,27,13,49
S01013280,412,21,4,17,81,88,22,27,78,58,6,3,3,31
S01013281,677,27,4,23,83,93,42,61,152,142,30,22,8,47
S01013282,611,13,3,10,69,93,20,67,139,116,57,29,28,37
S01013283,524,56,3,53,83,71,29,47,99,77,27,21,6,35
S01013284,516,45,7,38,137,116,28,35,74,45,5,2,3,31
S01013285,522,48,5,43,121,110,18,50,76,53,5,2,3,41
S01013286,534,48,5,43,136,101,32,50,74,45,5,3,2,43
S01013287,618,102,16,86,184,110,37,37,50,30,2,1,1,66
S01013288,482,59,13,46,103,94,33,36,57,47,19,14,5,34
S01013289,562,93,16,77,141,83,71,28,61,41,13,8,5,31
S01013290,655,69,13,56,142,102,40,48,107,82,27,12,15,38
S01013291,522,41,8,33,107,88,43,52,80,65,11,3,8,35
S01013292,602,38,10,28,118,120,44,61,85,69,17,5,12,50
S01013293,559,62,10,52,136,110,56,35,69,35,3,1,2,53
S01013294,573,50,7,43,111,117,33,57,76,67,13,10,3,49
S01013295,609,44,7,37,123,140,45,62,85,54,13,11,2,43
S01013296,534,19,4,15,60,70,34,57,107,128,27,14,13,32
S01013297,524,37,10,27,82,96,35,57,91,64,21,13,8,41
S01013298,505,34,6,28,99,86,43,51,67,74,25,20,5,26
S01013299,763,41,9,32,153,122,38,76,134,113,29,15,14,57
S01013300,445,25,5,20,81,52,26,44,96,84,17,10,7,20
S01013301,373,15,5,10,50,50,25,46,79,73,23,16,7,12
S01013302,481,44,7,37,90,82,54,47,64,60,13,6,7,27
S01013303,679,56,13,43,141,116,34,51,103,129,14,10,4,35
S01013304,710,21,1,20,80,78,22,77,157,169,51,27,24,55
S01013305,740,24,9,15,98,115,29,61,147,185,41,27,14,40
S01013306,742,13,6,7,60,82,34,59,179,178,97,55,42,40
S01013307,792,23,7,16,77,85,26,81,169,204,81,48,33,46
S01013308,653,19,2,17,47,85,28,61,161,141,57,39,18,54
S01013309,476,68,15,53,112,79,27,28,56,50,23,19,4,33
S01013310,483,23,3,20,82,76,15,55,102,82,21,11,10,27
S01013311,605,18,3,15,75,89,36,63,134,115,31,20,11,44
S01013312,788,22,4,18,112,110,47,70,152,177,52,31,21,46
S01013313,509,17,5,12,70,76,19,40,106,105,41,33,8,35
S01013314,495,21,7,14,63,86,23,55,104,94,14,7,7,35
S01013315,379,84,21,63,117,50,26,16,35,20,5,5,0,26
S01013316,498,71,19,52,127,94,30,36,65,31,14,12,2,30
S01013317,430,28,6,22,101,91,23,35,68,50,6,2,4,28
S01013318,466,64,13,51,126,78,20,36,61,50,8,6,2,23
S01013319,422,55,13,42,102,72,27,35,54,29,20,16,4,28
S01013320,726,101,16,85,203,115,42,58,82,59,16,12,4,50
S01013321,331,10,2,8,67,59,16,41,39,63,23,12,11,13
S01013322,556,27,5,22,100,111,24,48,103,70,16,12,4,57
S01013323,738,38,7,31,111,107,34,70,141,143,40,21,19,54
S01013324,481,18,7,11,63,61,19,40,113,93,43,21,22,31
S01013325,641,32,8,24,88,73,24,56,124,122,68,51,17,54
S01013326,409,12,1,11,38,49,21,33,104,99,24,17,7,29
S01013327,529,13,3,10,48,67,27,58,121,119,35,25,10,41
S01013328,465,11,2,9,45,56,19,58,112,111,28,19,9,25
S01013329,402,10,3,7,72,47,16,34,100,72,17,12,5,34
S01013330,807,94,17,77,201,147,38,64,106,88,17,8,9,52
S01013331,475,52,9,43,98,95,30,37,62,56,18,12,6,27
S01013332,499,18,2,16,80,79,31,42,101,97,17,8,9,34
S01013333,622,49,7,42,141,112,35,60,92,82,14,7,7,37
S01013334,555,21,3,18,75,75,26,55,116,118,36,23,13,33
S01013335,560,10,2,8,50,76,31,44,133,127,47,24,23,42
S01013336,648,14,4,10,79,67,35,48,136,155,69,42,27,45
S01013337,732,59,17,42,160,125,50,61,94,115,27,14,13,41
S01013338,381,59,12,47,119,60,26,19,28,20,12,10,2,38
S01013339,456,64,13,51,116,91,25,38,52,27,11,4,7,32
S01013340,656,87,22,65,155,133,48,57,70,45,12,10,2,49
S01013341,701,134,34,100,217,103,60,33,65,40,18,8,10,31
S01013342,475,11,3,8,57,65,14,49,111,109,37,28,9,22
S01013343,504,21,4,17,94,90,25,37,88,103,16,11,5,30
S01013344,593,13,3,10,79,80,30,69,108,134,39,30,9,41
S01013345,548,13,3,10,73,74,17,57,107,138,31,15,16,38
S01013346,616,85,22,63,147,104,30,43,86,41,17,10,7,63
S01013347,560,42,7,35,140,117,37,46,71,69,15,5,10,23
S01013348,338,45,10,35,97,68,29,21,29,19,2,2,0,28
S01013349,611,75,12,63,133,88,26,48,80,97,28,22,6,36
S01013350,506,19,3,16,84,77,27,53,104,92,23,12,11,27
S01013351,596,40,15,25,103,117,22,66,106,87,20,11,9,35
S01013352,674,25,5,20,113,130,34,55,131,111,26,14,12,49
S01013353,488,14,2,12,72,73,30,47,92,96,36,25,11,28
S01013354,555,43,18,25,123,90,40,60,89,77,12,8,4,21
S01013355,482,34,4,30,83,64,35,48,80,91,17,9,8,30
S01013356,563,17,5,12,78,55,41,48,113,138,48,24,24,25
S01013357,613,41,12,29,137,110,40,63,95,81,17,9,8,29
S01013358,607,37,10,27,92,78,48,68,128,97,28,19,9,31
S01013359,453,14,6,8,60,43,26,38,90,118,34,26,8,30
S01013360,521,14,5,9,65,59,23,54,129,122,29,18,11,26
S01013361,448,13,6,7,44,69,12,46,109,103,27,19,8,25
S01013362,341,10,3,7,41,35,15,37,81,77,19,11,8,26
S01013363,568,11,5,6,50,77,23,45,129,146,54,29,25,33
S01013364,690,63,16,47,128,87,40,76,111,128,23,17,6,34
S01013365,641,41,10,31,140,122,58,66,89,89,10,4,6,26
S01013366,687,46,13,33,154,125,38,77,83,82,21,12,9,61
S01013367,452,47,12,35,100,69,45,33,53,61,10,10,0,34
S01013368,554,37,12,25,79,68,57,45,95,106,29,20,9,38
S01013369,636,27,6,21,73,90,24,53,159,142,39,28,11,29
S01013370,435,15,3,12,67,51,19,35,83,113,30,16,14,22
S01013371,467,23,8,15,68,68,21,53,94,101,18,11,7,21
S01013372,791,14,7,7,69,87,32,58,205,195,72,36,36,59
S01013373,667,25,8,17,91,88,30,68,145,139,47,24,23,34
S01013374,667,14,2,12,59,75,34,50,129,198,80,44,36,28
S01013375,429,12,2,10,41,69,20,46,101,99,20,12,8,21
S01013376,435,15,3,12,49,63,26,49,83,111,30,18,12,9
S01013377,558,16,2,14,74,75,21,54,120,146,31,16,15,21
S01013378,750,42,14,28,139,111,38,63,112,133,52,24,28,60
S01013379,664,23,3,20,127,101,44,68,130,109,28,20,8,34
S01013380,90,6,2,4,21,13,14,9,8,4,9,9,0,6
S01013381,380,16,5,11,53,39,29,41,75,93,15,8,7,19
S01013382,421,22,11,11,59,55,29,50,82,87,10,4,6,27
S01013383,505,15,2,13,77,65,19,56,108,104,31,19,12,30
S01013384,547,31,6,25,80,77,39,55,97,124,26,19,7,18
S01013385,372,17,5,12,95,66,23,32,48,64,13,9,4,14
S01013386,659,56,9,47,183,108,41,45,88,80,13,5,8,45
S01013387,407,23,8,15,51,56,20,34,82,88,32,14,18,21
S01013388,534,29,7,22,85,78,38,41,88,130,28,18,10,17
S01013389,588,25,3,22,103,93,24,74,98,110,18,10,8,43
S01013390,353,9,0,9,49,52,21,33,76,89,16,8,8,8
S01013391,318,26,8,18,66,47,27,19,56,44,17,11,6,16
S01013392,549,59,16,43,135,116,45,55,56,48,6,4,2,29
S01013393,521,34,10,24,73,57,29,61,102,110,34,12,22,21
S01013394,500,18,5,13,64,66,26,54,89,113,45,32,13,25
S01013395,493,11,2,9,46,45,16,39,105,133,74,43,31,24
S01013396,496,56,10,46,132,99,47,35,56,43,9,5,4,19
S01013397,649,33,6,27,108,99,48,61,111,124,36,26,10,29
S01013398,438,64,10,54,89,88,22,41,49,40,12,9,3,33
S01013399,766,69,18,51,199,125,43,73,116,90,19,12,7,32
S01013400,504,24,5,19,88,75,29,50,109,82,27,16,11,20
S01013401,611,80,17,63,197,104,36,37,57,54,23,15,8,23
S01013402,763,139,20,119,236,136,29,52,65,58,11,7,4,37
S01013403,622,89,18,71,196,114,36,36,67,49,6,4,2,29
S01013404,416,58,13,45,108,56,18,22,60,46,14,10,4,34
S01013405,498,36,9,27,85,87,27,52,85,82,24,6,18,20
S01013406,456,8,2,6,56,60,16,47,107,105,41,21,20,16
S01013407,386,11,6,5,50,50,15,36,90,94,19,10,9,21
S01013408,454,13,2,11,52,73,23,40,89,101,40,21,19,23
S01013409,805,58,22,36,163,126,62,54,126,133,28,14,14,55
S01013410,471,9,5,4,34,70,21,40,109,104,47,18,29,37
S01013411,550,51,5,46,122,87,32,30,84,93,27,15,12,24
S01013412,623,44,14,30,125,106,26,57,85,101,31,16,15,48
S01013413,552,92,29,63,172,72,34,38,56,49,11,8,3,28
S01013414,605,38,6,32,134,74,29,53,104,112,42,25,17,19
S01013415,489,11,4,7,70,85,35,44,95,102,35,18,17,12
S01013416,452,17,4,13,60,52,24,30,100,98,42,30,12,29
S01013417,673,39,9,30,136,98,33,69,126,114,25,12,13,33
S01013418,476,42,8,34,84,65,35,42,77,75,21,13,8,35
S01013419,363,40,4,36,106,73,25,20,37,24,11,6,5,27
S01013420,425,26,5,21,93,90,16,35,68,60,16,10,6,21
S01013421,556,66,12,54,152,103,32,47,64,48,9,7,2,35
S01013422,540,15,1,14,88,101,28,51,109,80,18,10,8,50
S01013423,628,46,9,37,134,107,35,46,86,97,28,18,10,49
S01013424,370,37,12,25,100,65,26,31,47,28,4,3,1,32
S01013425,332,32,5,27,80,52,26,24,49,46,9,3,6,14
S01013426,615,22,8,14,72,100,30,50,120,153,39,24,15,29
S01013427,332,50,11,39,120,38,36,14,26,21,6,3,3,21
S01013428,719,28,6,22,114,89,42,64,127,171,43,26,17,41
S01013429,525,30,4,26,93,81,38,63,102,78,19,14,5,21
S01013430,521,36,7,29,98,78,45,55,84,81,29,22,7,15
S01013431,510,27,9,18,85,62,43,40,98,101,31,19,12,23
S01013432,545,45,10,35,119,69,65,42,78,85,19,6,13,23
S01013433,549,90,25,65,139,71,48,40,71,57,7,4,3,26
S01013434,398,68,9,59,123,40,68,20,30,12,7,5,2,30
S01013435,480,118,32,86,161,65,26,14,29,16,6,4,2,45
S01013436,615,70,14,56,109,83,34,51,103,97,21,14,7,47
S01013437,523,48,6,42,117,76,29,44,79,71,12,6,6,47
S01013438,430,38,10,28,89,64,31,38,72,55,17,8,9,26
S01013439,694,146,22,124,248,101,43,34,46,22,10,3,7,44
S01013440,773,196,31,165,262,111,38,31,44,24,4,0,4,63
S01013441,558,131,26,105,194,68,38,30,32,19,13,10,3,33
S01013442,607,91,10,81,161,94,38,42,81,56,14,10,4,30
S01013443,457,80,14,66,146,43,30,31,61,31,13,6,7,22
S01013444,703,106,15,91,166,74,58,55,108,69,38,22,16,29
S01013445,410,116,20,96,117,57,27,24,30,9,10,8,2,20
S01013446,508,41,7,34,82,94,33,44,90,81,16,9,7,27
S01013447,419,110,19,91,134,61,22,15,25,6,5,2,3,41
S01013448,577,132,28,104,186,90,35,29,46,21,11,9,2,27
S01013449,499,86,16,70,147,101,32,22,55,22,2,1,1,32
S01013450,451,77,11,66,138,84,20,27,41,28,6,3,3,30
S01013451,656,136,25,111,208,89,37,24,53,18,15,10,5,76
S01013452,576,117,21,96,183,80,37,26,48,23,8,6,2,54
S01013453,547,29,8,21,73,60,22,57,111,133,36,16,20,26
S01013454,572,84,15,69,151,78,53,52,66,59,11,7,4,18
S01013455,427,49,10,39,105,56,50,31,54,53,17,9,8,12
S01013456,591,45,9,36,105,73,37,62,102,106,24,13,11,37
S01013457,655,11,0,11,74,89,33,67,142,157,38,17,21,44
S01013458,564,43,13,30,109,87,37,51,96,96,16,3,13,29
S01013459,610,37,6,31,101,88,39,54,111,128,22,12,10,30
S01013460,597,25,5,20,94,96,33,49,112,138,28,18,10,22
S01013461,781,64,10,54,156,120,38,69,121,126,39,17,22,48
S01013462,657,63,14,49,159,103,38,61,92,95,11,5,6,35
S01013463,397,30,5,25,63,69,19,28,88,54,22,10,12,24
S01013464,536,39,13,26,131,85,34,51,80,67,13,9,4,36
S01013465,514,34,5,29,88,124,34,47,85,68,12,8,4,22
S01013466,376,31,4,27,58,18,32,13,31,21,11,5,6,161
S01013467,671,103,16,87,170,105,44,48,81,67,13,9,4,40
S01013468,481,41,14,27,101,79,42,29,82,56,25,16,9,26
S01013469,585,58,12,46,122,102,46,53,92,72,15,12,3,25
S01013470,550,16,4,12,69,60,31,58,134,124,29,18,11,29
S01013471,702,31,10,21,87,103,37,79,155,130,35,22,13,45
S01013472,445,68,16,52,110,78,40,33,42,31,13,6,7,30
S01013473,466,81,20,61,130,82,36,28,35,30,6,4,2,38
S01013474,443,50,8,42,120,86,32,21,52,45,12,7,5,25
S01013475,492,29,6,23,109,78,34,40,97,53,13,7,6,39
S01013476,496,38,13,25,86,100,31,43,90,63,16,10,6,29
S01013477,459,24,7,17,64,56,37,49,76,114,21,10,11,18
S01013478,643,46,5,41,139,97,39,52,100,87,38,24,14,45
S01013479,599,22,2,20,69,92,32,61,126,135,39,19,20,23
S01013480,494,16,4,12,50,66,26,61,120,111,20,8,12,24
S01013481,353,22,6,16,77,53,34,31,51,51,10,6,4,24
