,,All people aged 16 to 74,1. Higher managerial administrative and professional occupations: Total,1. Higher managerial administrative and professional occupations: 1.1 Large employers and higher managerial and administrative occupations,1. Higher managerial administrative and professional occupations: 1.2 Higher professional occupations,2. Lower managerial administrative and professional occupations,3. Intermediate occupations,4. Small employers and own account workers,5. Lower supervisory and technical occupations,6. Semi-routine occupations,7. Routine occupations,8. Never worked and long-term unemployed: Total,8. Never worked and long-term unemployed: L14.1 Never worked,8. Never worked and long-term unemployed: L14.2 Long-term unemployed,L15 Full-time students
S92000003,All people aged 16 to 74,3970530,344228,65396,278832,802545,513038,294610,326930,616404,514036,198630,124530,74100,360109
S92000003,Very good health,1966841,214175,38029,176146,446613,257990,135824,146220,253984,183037,63695,36395,27300,265303
S92000003,Good health,1308531,102095,21171,80924,260886,177468,106989,113750,223393,178318,66928,37181,29747,78704
S92000003,Fair health,468935,21392,4708,16684,68205,54755,36965,43383,92747,94733,43759,29638,14121,12996
S92000003,Bad health,172686,5108,1149,3959,20604,17786,11304,17882,35771,43837,17871,15280,2591,2523
S92000003,Very bad health,53537,1458,339,1119,6237,5039,3528,5695,10509,14111,6377,6036,341,583
S01006506,All people aged 16 to 74,692,111,12,99,180,88,58,50,79,54,28,24,4,44
S01006506,Very good health,364,67,5,62,102,47,32,20,35,22,6,5,1,33
S01006506,Good health,249,38,6,32,66,32,22,20,33,20,10,7,3,8
S01006506,Fair health,60,6,1,5,9,7,4,9,8,6,8,8,0,3
S01006506,Bad health,17,0,0,0,3,1,0,1,3,5,4,4,0,0
S01006506,Very bad health,2,0,0,0,0,1,0,0,0,1,0,0,0,0
S01006507,All people aged 16 to 74,640,57,12,45,121,82,56,60,104,89,23,21,2,48
S01006507,Very good health,335,43,10,33,76,44,23,23,44,35,4,4,0,43
S01006507,Good health,216,12,2,10,35,32,21,27,41,33,12,10,2,3
S01006507,Fair health,74,2,0,2,8,6,11,6,17,16,6,6,0,2
S01006507,Bad health,14,0,0,0,2,0,1,4,1,5,1,1,0,0
S01006507,Very bad health,1,0,0,0,0,0,0,0,1,0,0,0,0,0
S01006508,All people aged 16 to 74,530,82,11,71,137,99,39,54,51,35,5,4,1,28
S01006508,Very good health,295,52,7,45,72,60,20,28,31,13,0,0,0,19
S01006508,Good health,174,28,4,24,48,28,12,21,12,16,2,1,1,7
S01006508,Fair health,48,2,0,2,14,9,5,5,6,4,1,1,0,2
S01006508,Bad health,11,0,0,0,2,2,2,0,2,1,2,2,0,0
S01006508,Very bad health,2,0,0,0,1,0,0,0,0,1,0,0,0,0
S01006509,All people aged 16 to 74,420,42,12,30,77,64,35,42,80,55,8,7,1,17
S01006509,Very good health,197,18,5,13,44,32,16,17,32,23,1,1,0,14
S01006509,Good health,172,23,6,17,30,25,15,17,37,19,5,5,0,1
S01006509,Fair health,38,1,1,0,3,6,2,7,7,9,1,1,0,2
S01006509,Bad health,9,0,0,0,0,1,2,0,3,2,1,0,1,0
S01006509,Very bad health,4,0,0,0,0,0,0,1,1,2,0,0,0,0
S01006510,All people aged 16 to 74,455,46,10,36,106,61,29,46,75,40,18,11,7,34
S01006510,Very good health,217,27,4,23,60,22,15,17,27,13,6,2,4,30
S01006510,Good health,177,18,6,12,32,32,11,23,35,13,9,6,3,4
S01006510,Fair health,47,1,0,1,11,4,2,4,11,12,2,2,0,0
S01006510,Bad health,9,0,0,0,2,3,0,1,1,1,1,1,0,0
S01006510,Very bad health,5,0,0,0,1,0,1,1,1,1,0,0,0,0
S01006511,All people aged 16 to 74,551,96,23,73,146,77,38,34,54,40,15,8,7,51
S01006511,Very good health,305,60,13,47,85,31,18,15,22,18,8,2,6,48
S01006511,Good health,173,30,9,21,47,35,15,11,21,9,2,2,0,3
S01006511,Fair health,46,6,1,5,7,8,3,5,8,5,4,3,1,0
S01006511,Bad health,17,0,0,0,5,2,2,2,2,3,1,1,0,0
S01006511,Very bad health,10,0,0,0,2,1,0,1,1,5,0,0,0,0
S01006512,All people aged 16 to 74,340,78,12,66,85,36,38,15,30,18,4,3,1,36
S01006512,Very good health,212,64,10,54,54,23,20,10,14,9,1,1,0,17
S01006512,Good health,97,13,2,11,21,12,13,4,9,6,3,2,1,16
S01006512,Fair health,22,1,0,1,7,0,4,1,4,2,0,0,0,3
S01006512,Bad health,7,0,0,0,3,1,0,0,3,0,0,0,0,0
S01006512,Very bad health,2,0,0,0,0,0,1,0,0,1,0,0,0,0
S01006513,All people aged 16 to 74,417,84,14,70,120,57,28,24,49,16,10,9,1,29
S01006513,Very good health,240,52,7,45,69,31,17,13,24,6,1,0,1,27
S01006513,Good health,134,26,7,19,40,22,7,10,18,7,3,3,0,1
S01006513,Fair health,28,5,0,5,11,3,2,0,2,1,3,3,0,1
S01006513,Bad health,13,1,0,1,0,1,1,1,5,1,3,3,0,0
S01006513,Very bad health,2,0,0,0,0,0,1,0,0,1,0,0,0,0
S01006514,All people aged 16 to 74,709,172,34,138,216,86,46,27,35,23,18,16,2,86
S01006514,Very good health,468,119,26,93,140,58,32,14,18,11,12,11,1,64
S01006514,Good health,202,46,5,41,65,22,13,11,12,9,4,3,1,20
S01006514,Fair health,32,6,3,3,9,5,1,2,4,2,1,1,0,2
S01006514,Bad health,5,1,0,1,1,1,0,0,1,0,1,1,0,0
S01006514,Very bad health,2,0,0,0,1,0,0,0,0,1,0,0,0,0
S01006515,All people aged 16 to 74,537,140,23,117,150,60,43,18,43,17,10,10,0,56
S01006515,Very good health,345,95,14,81,98,35,24,10,24,8,4,4,0,47
S01006515,Good health,150,39,7,32,42,23,13,6,11,6,2,2,0,8
S01006515,Fair health,34,6,2,4,8,1,5,1,6,2,4,4,0,1
S01006515,Bad health,5,0,0,0,1,1,1,1,1,0,0,0,0,0
S01006515,Very bad health,3,0,0,0,1,0,0,0,1,1,0,0,0,0
S01006516,All people aged 16 to 74,423,99,24,75,115,34,48,16,36,11,4,4,0,60
S01006516,Very good health,270,66,19,47,78,24,25,9,22,7,0,0,0,39
S01006516,Good health,131,24,4,20,34,9,21,7,14,2,4,4,0,16
S01006516,Fair health,18,9,1,8,3,1,1,0,0,0,0,0,0,4
S01006516,Bad health,3,0,0,0,0,0,1,0,0,2,0,0,0,0
S01006516,Very bad health,1,0,0,0,0,0,0,0,0,0,0,0,0,1
S01006517,All people aged 16 to 74,727,187,36,151,182,78,59,45,66,24,16,14,2,70
S01006517,Very good health,451,123,23,100,110,43,38,28,33,9,7,6,1,60
S01006517,Good health,209,47,13,34,62,23,17,10,27,9,4,4,0,10
S01006517,Fair health,48,15,0,15,6,9,3,4,6,3,2,1,1,0
S01006517,Bad health,14,1,0,1,1,3,1,2,0,3,3,3,0,0
S01006517,Very bad health,5,1,0,1,3,0,0,1,0,0,0,0,0,0
S01006518,All people aged 16 to 74,464,124,32,92,133,49,47,17,37,5,7,5,2,45
S01006518,Very good health,316,82,18,64,89,30,32,12,26,3,3,3,0,39
S01006518,Good health,120,35,13,22,36,16,10,4,10,1,3,1,2,5
S01006518,Fair health,24,6,0,6,7,3,4,1,0,1,1,1,0,1
S01006518,Bad health,4,1,1,0,1,0,1,0,1,0,0,0,0,0
S01006518,Very bad health,0,0,0,0,0,0,0,0,0,0,0,0,0,0
S01006519,All people aged 16 to 74,625,145,25,120,154,84,53,15,69,20,20,17,3,65
S01006519,Very good health,398,101,16,85,98,54,30,10,31,12,5,3,2,57
S01006519,Good health,181,37,9,28,48,26,21,4,28,5,6,5,1,6
S01006519,Fair health,31,4,0,4,6,3,1,1,7,2,6,6,0,1
S01006519,Bad health,12,3,0,3,1,1,1,0,3,0,2,2,0,1
S01006519,Very bad health,3,0,0,0,1,0,0,0,0,1,1,1,0,0
S01006520,All people aged 16 to 74,497,156,31,125,144,49,23,14,32,8,11,6,5,60
S01006520,Very good health,358,116,23,93,91,38,13,10,23,7,5,2,3,55
S01006520,Good health,115,36,7,29,44,7,7,4,7,1,4,3,1,5
S01006520,Fair health,18,4,1,3,6,3,2,0,2,0,1,0,1,0
S01006520,Bad health,6,0,0,0,3,1,1,0,0,0,1,1,0,0
S01006520,Very bad health,0,0,0,0,0,0,0,0,0,0,0,0,0,0
S01006521,All people aged 16 to 74,495,160,40,120,137,43,54,22,26,6,5,3,2,42
S01006521,Very good health,375,125,28,97,96,38,34,17,17,4,3,3,0,41
S01006521,Good health,99,31,11,20,34,4,18,3,8,0,1,0,1,0
S01006521,Fair health,18,4,1,3,7,1,2,1,1,0,1,0,1,1
S01006521,Bad health,2,0,0,0,0,0,0,1,0,1,0,0,0,0
S01006521,Very bad health,1,0,0,0,0,0,0,0,0,1,0,0,0,0
S01006522,All people aged 16 to 74,402,136,21,115,121,45,20,7,24,8,5,3,2,36
S01006522,Very good health,272,96,17,79,78,25,15,5,16,6,3,2,1,28
S01006522,Good health,111,36,4,32,37,15,3,2,8,2,1,1,0,7
S01006522,Fair health,15,3,0,3,4,5,2,0,0,0,1,0,1,0
S01006522,Bad health,3,0,0,0,2,0,0,0,0,0,0,0,0,1
S01006522,Very bad health,1,1,0,1,0,0,0,0,0,0,0,0,0,0
S01006523,All people aged 16 to 74,655,186,44,142,202,80,35,40,39,12,6,3,3,55
S01006523,Very good health,413,125,26,99,123,45,23,21,17,10,3,1,2,46
S01006523,Good health,184,49,15,34,57,29,8,15,15,0,2,1,1,9
S01006523,Fair health,51,12,3,9,17,5,4,4,7,1,1,1,0,0
S01006523,Bad health,7,0,0,0,5,1,0,0,0,1,0,0,0,0
S01006523,Very bad health,0,0,0,0,0,0,0,0,0,0,0,0,0,0
S01006524,All people aged 16 to 74,618,131,30,101,142,65,56,23,51,22,77,70,7,51
S01006524,Very good health,322,84,18,66,75,36,21,14,25,10,16,10,6,41
S01006524,Good health,222,40,12,28,53,23,27,5,18,8,40,40,0,8
S01006524,Fair health,56,7,0,7,11,5,5,1,6,3,17,16,1,1
S01006524,Bad health,13,0,0,0,3,0,1,3,1,1,3,3,0,1
S01006524,Very bad health,5,0,0,0,0,1,2,0,1,0,1,1,0,0
S01006525,All people aged 16 to 74,566,144,25,119,157,60,42,24,63,15,7,6,1,54
S01006525,Very good health,367,104,17,87,93,34,26,17,35,9,3,3,0,46
S01006525,Good health,162,35,7,28,52,18,15,5,22,4,4,3,1,7
S01006525,Fair health,33,4,1,3,11,7,1,2,5,2,0,0,0,1
S01006525,Bad health,2,1,0,1,0,1,0,0,0,0,0,0,0,0
S01006525,Very bad health,2,0,0,0,1,0,0,0,1,0,0,0,0,0
S01006526,All people aged 16 to 74,676,43,6,37,101,75,23,72,105,93,33,19,14,131
S01006526,Very good health,322,25,1,24,56,35,10,37,40,30,10,6,4,79
S01006526,Good health,254,12,4,8,32,31,11,29,49,31,14,9,5,45
S01006526,Fair health,74,6,1,5,11,7,2,4,15,17,5,1,4,7
S01006526,Bad health,22,0,0,0,1,2,0,2,1,13,3,2,1,0
S01006526,Very bad health,4,0,0,0,1,0,0,0,0,2,1,1,0,0
S01006527,All people aged 16 to 74,496,26,3,23,59,58,23,57,101,78,24,18,6,70
S01006527,Very good health,225,15,0,15,33,26,10,31,38,21,7,4,3,44
S01006527,Good health,176,8,1,7,19,24,9,17,38,31,8,7,1,22
S01006527,Fair health,69,1,1,0,4,6,2,7,19,19,8,6,2,3
S01006527,Bad health,19,2,1,1,2,2,1,1,5,4,1,1,0,1
S01006527,Very bad health,7,0,0,0,1,0,1,1,1,3,0,0,0,0
S01006528,All people aged 16 to 74,805,40,4,36,112,83,29,83,123,106,31,23,8,198
S01006528,Very good health,386,30,1,29,58,48,10,27,54,29,9,8,1,121
S01006528,Good health,317,7,3,4,44,24,16,44,48,49,15,11,4,70
S01006528,Fair health,79,2,0,2,8,10,1,8,19,20,6,4,2,5
S01006528,Bad health,18,1,0,1,2,1,2,2,2,5,1,0,1,2
S01006528,Very bad health,5,0,0,0,0,0,0,2,0,3,0,0,0,0
S01006529,All people aged 16 to 74,696,66,8,58,132,71,30,52,116,73,23,16,7,133
S01006529,Very good health,369,34,5,29,80,34,14,19,47,22,16,12,4,103
S01006529,Good health,232,28,3,25,46,25,12,28,41,27,2,0,2,23
S01006529,Fair health,78,4,0,4,5,11,3,4,22,20,3,2,1,6
S01006529,Bad health,14,0,0,0,1,0,1,1,6,2,2,2,0,1
S01006529,Very bad health,3,0,0,0,0,1,0,0,0,2,0,0,0,0
S01006530,All people aged 16 to 74,618,33,6,27,86,73,27,69,106,90,35,24,11,99
S01006530,Very good health,262,17,0,17,44,33,10,22,35,26,8,5,3,67
S01006530,Good health,214,10,4,6,26,27,9,32,40,34,12,8,4,24
S01006530,Fair health,93,5,1,4,7,10,8,10,21,15,11,8,3,6
S01006530,Bad health,34,1,1,0,7,1,0,4,7,10,3,3,0,1
S01006530,Very bad health,15,0,0,0,2,2,0,1,3,5,1,0,1,1
S01006531,All people aged 16 to 74,718,33,3,30,86,68,23,62,133,147,42,28,14,124
S01006531,Very good health,318,17,1,16,37,32,9,26,43,51,16,13,3,87
S01006531,Good health,257,11,1,10,31,21,10,21,53,60,18,9,9,32
S01006531,Fair health,106,4,1,3,16,11,3,12,23,26,6,4,2,5
S01006531,Bad health,29,1,0,1,0,4,0,3,12,7,2,2,0,0
S01006531,Very bad health,8,0,0,0,2,0,1,0,2,3,0,0,0,0
S01006532,All people aged 16 to 74,519,98,16,82,144,78,45,18,41,24,14,11,3,57
S01006532,Very good health,278,58,12,46,80,39,22,9,17,10,4,2,2,39
S01006532,Good health,198,32,3,29,54,32,17,8,19,12,7,6,1,17
S01006532,Fair health,37,5,1,4,9,6,5,1,5,2,3,3,0,1
S01006532,Bad health,5,3,0,3,1,0,1,0,0,0,0,0,0,0
S01006532,Very bad health,1,0,0,0,0,1,0,0,0,0,0,0,0,0
S01006533,All people aged 16 to 74,539,137,22,115,170,58,40,24,34,19,6,4,2,51
S01006533,Very good health,367,98,15,83,118,38,27,11,21,10,4,2,2,40
S01006533,Good health,144,34,5,29,43,14,12,11,10,7,2,2,0,11
S01006533,Fair health,25,5,2,3,9,4,1,1,3,2,0,0,0,0
S01006533,Bad health,2,0,0,0,0,1,0,1,0,0,0,0,0,0
S01006533,Very bad health,1,0,0,0,0,1,0,0,0,0,0,0,0,0
S01006534,All people aged 16 to 74,663,186,39,147,201,87,37,30,55,13,10,6,4,44
S01006534,Very good health,418,122,24,98,131,52,22,19,28,8,2,0,2,34
S01006534,Good health,194,56,15,41,55,28,11,11,17,4,5,4,1,7
S01006534,Fair health,38,8,0,8,12,4,3,0,7,1,1,1,0,2
S01006534,Bad health,11,0,0,0,2,2,1,0,3,0,2,1,1,1
S01006534,Very bad health,2,0,0,0,1,1,0,0,0,0,0,0,0,0
S01006535,All people aged 16 to 74,871,159,17,142,265,110,41,58,80,40,19,12,7,99
S01006535,Very good health,507,106,9,97,171,56,22,29,33,18,7,4,3,65
S01006535,Good health,303,46,7,39,81,44,14,24,37,14,11,8,3,32
S01006535,Fair health,52,7,1,6,12,9,3,4,10,5,1,0,1,1
S01006535,Bad health,8,0,0,0,1,1,1,1,0,3,0,0,0,1
S01006535,Very bad health,1,0,0,0,0,0,1,0,0,0,0,0,0,0
S01006536,All people aged 16 to 74,882,173,24,149,264,109,33,62,80,46,16,8,8,99
S01006536,Very good health,573,130,17,113,162,70,13,40,51,24,12,5,7,71
S01006536,Good health,254,40,6,34,83,32,15,18,25,15,3,3,0,23
S01006536,Fair health,40,3,1,2,15,5,3,2,3,6,1,0,1,2
S01006536,Bad health,14,0,0,0,4,2,2,2,0,1,0,0,0,3
S01006536,Very bad health,1,0,0,0,0,0,0,0,1,0,0,0,0,0
S01006537,All people aged 16 to 74,538,111,18,93,158,78,43,33,59,18,10,8,2,28
S01006537,Very good health,306,72,11,61,98,44,18,15,27,6,2,2,0,24
S01006537,Good health,194,36,6,30,52,28,20,14,27,9,4,2,2,4
S01006537,Fair health,31,2,1,1,8,6,3,2,5,3,2,2,0,0
S01006537,Bad health,5,1,0,1,0,0,1,2,0,0,1,1,0,0
S01006537,Very bad health,2,0,0,0,0,0,1,0,0,0,1,1,0,0
S01006538,All people aged 16 to 74,410,82,20,62,128,57,22,34,40,15,7,5,2,25
S01006538,Very good health,231,53,14,39,84,25,11,16,14,8,3,2,1,17
S01006538,Good health,140,24,4,20,33,22,7,15,21,6,4,3,1,8
S01006538,Fair health,32,5,2,3,10,8,4,2,3,0,0,0,0,0
S01006538,Bad health,5,0,0,0,1,2,0,0,2,0,0,0,0,0
S01006538,Very bad health,2,0,0,0,0,0,0,1,0,1,0,0,0,0
S01006539,All people aged 16 to 74,521,108,23,85,186,69,28,26,39,18,6,5,1,41
S01006539,Very good health,302,63,9,54,112,30,17,11,23,9,4,3,1,33
S01006539,Good health,167,36,12,24,60,28,6,12,12,5,0,0,0,8
S01006539,Fair health,44,6,2,4,14,9,4,3,4,4,0,0,0,0
S01006539,Bad health,8,3,0,3,0,2,1,0,0,0,2,2,0,0
S01006539,Very bad health,0,0,0,0,0,0,0,0,0,0,0,0,0,0
S01006540,All people aged 16 to 74,723,174,34,140,201,111,32,41,64,29,9,8,1,62
S01006540,Very good health,450,128,26,102,128,57,17,21,41,10,3,2,1,45
S01006540,Good health,215,37,6,31,61,47,11,16,14,13,1,1,0,15
S01006540,Fair health,44,7,2,5,11,4,4,1,7,5,4,4,0,1
S01006540,Bad health,11,0,0,0,1,3,0,3,2,0,1,1,0,1
S01006540,Very bad health,3,2,0,2,0,0,0,0,0,1,0,0,0,0
S01006541,All people aged 16 to 74,513,114,21,93,151,96,30,34,44,14,8,3,5,22
S01006541,Very good health,306,74,12,62,95,50,17,17,25,3,6,2,4,19
S01006541,Good health,175,39,9,30,49,38,10,12,15,9,1,0,1,2
S01006541,Fair health,27,1,0,1,6,5,3,4,4,2,1,1,0,1
S01006541,Bad health,4,0,0,0,0,3,0,1,0,0,0,0,0,0
S01006541,Very bad health,1,0,0,0,1,0,0,0,0,0,0,0,0,0
S01006542,All people aged 16 to 74,707,175,33,142,220,106,40,28,54,27,17,15,2,40
S01006542,Very good health,427,117,19,98,140,56,21,13,24,12,9,8,1,35
S01006542,Good health,228,52,13,39,68,44,13,12,21,11,4,3,1,3
S01006542,Fair health,38,4,1,3,10,6,5,1,6,3,2,2,0,1
S01006542,Bad health,6,2,0,2,0,0,0,1,0,1,1,1,0,1
S01006542,Very bad health,8,0,0,0,2,0,1,1,3,0,1,1,0,0
S01006543,All people aged 16 to 74,526,92,20,72,174,87,39,29,51,19,8,5,3,27
S01006543,Very good health,296,52,11,41,100,41,21,18,29,7,5,3,2,23
S01006543,Good health,194,37,9,28,57,40,17,8,20,10,2,2,0,3
S01006543,Fair health,30,3,0,3,16,5,1,1,1,1,1,0,1,1
S01006543,Bad health,5,0,0,0,0,1,0,2,1,1,0,0,0,0
S01006543,Very bad health,1,0,0,0,1,0,0,0,0,0,0,0,0,0
S01006544,All people aged 16 to 74,811,254,40,214,219,90,63,49,45,20,16,11,5,55
S01006544,Very good health,515,162,28,134,150,50,29,32,25,10,10,6,4,47
S01006544,Good health,242,84,10,74,56,31,28,12,15,6,6,5,1,4
S01006544,Fair health,40,4,1,3,9,8,6,4,3,2,0,0,0,4
S01006544,Bad health,13,4,1,3,4,0,0,1,2,2,0,0,0,0
S01006544,Very bad health,1,0,0,0,0,1,0,0,0,0,0,0,0,0
S01006545,All people aged 16 to 74,759,162,31,131,225,103,49,46,77,30,17,11,6,50
S01006545,Very good health,456,109,22,87,145,53,27,20,36,17,8,5,3,41
S01006545,Good health,237,46,9,37,63,44,15,19,26,10,6,3,3,8
S01006545,Fair health,49,7,0,7,10,5,5,6,11,1,3,3,0,1
S01006545,Bad health,15,0,0,0,6,0,2,1,4,2,0,0,0,0
S01006545,Very bad health,2,0,0,0,1,1,0,0,0,0,0,0,0,0
S01006546,All people aged 16 to 74,470,102,18,84,155,60,20,19,40,24,11,9,2,39
S01006546,Very good health,271,60,11,49,91,25,13,11,25,16,0,0,0,30
S01006546,Good health,164,40,7,33,54,30,4,4,15,5,4,3,1,8
S01006546,Fair health,23,1,0,1,6,4,1,3,0,2,6,5,1,0
S01006546,Bad health,11,1,0,1,4,1,2,0,0,1,1,1,0,1
S01006546,Very bad health,1,0,0,0,0,0,0,1,0,0,0,0,0,0
S01006547,All people aged 16 to 74,638,106,28,78,160,98,39,41,79,55,19,10,9,41
S01006547,Very good health,351,73,19,54,107,50,24,17,23,19,9,3,6,29
S01006547,Good health,196,29,9,20,40,33,9,17,33,23,5,3,2,7
S01006547,Fair health,66,3,0,3,9,12,6,4,17,7,4,3,1,4
S01006547,Bad health,15,0,0,0,2,2,0,1,5,4,0,0,0,1
S01006547,Very bad health,10,1,0,1,2,1,0,2,1,2,1,1,0,0
S01006548,All people aged 16 to 74,503,107,18,89,168,81,31,17,45,13,6,3,3,35
S01006548,Very good health,290,73,12,61,92,42,16,7,27,2,2,1,1,29
S01006548,Good health,186,27,4,23,70,36,13,10,16,6,3,2,1,5
S01006548,Fair health,23,6,2,4,5,3,2,0,2,4,1,0,1,0
S01006548,Bad health,3,1,0,1,1,0,0,0,0,0,0,0,0,1
S01006548,Very bad health,1,0,0,0,0,0,0,0,0,1,0,0,0,0
S01006549,All people aged 16 to 74,606,145,27,118,168,72,58,24,61,28,12,10,2,38
S01006549,Very good health,372,94,17,77,104,45,30,16,35,13,3,3,0,32
S01006549,Good health,192,44,10,34,55,21,21,6,24,11,5,3,2,5
S01006549,Fair health,33,6,0,6,7,5,6,2,2,3,2,2,0,0
S01006549,Bad health,8,1,0,1,1,1,1,0,0,1,2,2,0,1
S01006549,Very bad health,1,0,0,0,1,0,0,0,0,0,0,0,0,0
S01006550,All people aged 16 to 74,659,154,23,131,183,112,41,39,43,18,10,9,1,59
S01006550,Very good health,377,85,12,73,99,66,23,21,25,8,2,1,1,48
S01006550,Good health,226,57,10,47,75,37,15,9,13,5,8,8,0,7
S01006550,Fair health,44,10,1,9,8,7,2,8,3,3,0,0,0,3
S01006550,Bad health,10,1,0,1,1,2,0,1,2,2,0,0,0,1
S01006550,Very bad health,2,1,0,1,0,0,1,0,0,0,0,0,0,0
S01006551,All people aged 16 to 74,492,52,7,45,81,68,35,51,76,84,14,10,4,31
S01006551,Very good health,223,34,4,30,43,29,17,20,24,31,3,2,1,22
S01006551,Good health,186,15,3,12,29,26,15,17,31,34,10,7,3,9
S01006551,Fair health,57,2,0,2,6,10,2,8,14,15,0,0,0,0
S01006551,Bad health,19,1,0,1,1,3,1,4,5,3,1,1,0,0
S01006551,Very bad health,7,0,0,0,2,0,0,2,2,1,0,0,0,0
S01006552,All people aged 16 to 74,700,146,22,124,202,107,46,34,63,33,11,6,5,58
S01006552,Very good health,380,91,13,78,113,51,15,21,29,14,6,2,4,40
S01006552,Good health,252,45,7,38,63,51,27,12,21,14,3,2,1,16
S01006552,Fair health,57,9,1,8,24,5,3,1,9,4,1,1,0,1
S01006552,Bad health,9,1,1,0,1,0,1,0,4,1,1,1,0,0
S01006552,Very bad health,2,0,0,0,1,0,0,0,0,0,0,0,0,1
S01006553,All people aged 16 to 74,550,73,11,62,135,80,50,45,81,48,12,5,7,26
S01006553,Very good health,286,44,8,36,79,33,23,20,34,23,7,3,4,23
S01006553,Good health,167,22,3,19,42,32,15,10,30,13,2,1,1,1
S01006553,Fair health,67,7,0,7,7,9,9,10,13,9,2,1,1,1
S01006553,Bad health,23,0,0,0,6,3,2,4,4,2,1,0,1,1
S01006553,Very bad health,7,0,0,0,1,3,1,1,0,1,0,0,0,0
S01006554,All people aged 16 to 74,521,63,3,60,123,76,29,46,78,65,21,11,10,20
S01006554,Very good health,239,40,2,38,60,34,13,22,31,23,5,2,3,11
S01006554,Good health,194,17,1,16,49,30,10,15,27,29,9,7,2,8
S01006554,Fair health,61,4,0,4,11,11,6,4,12,7,5,1,4,1
S01006554,Bad health,23,2,0,2,3,1,0,3,6,6,2,1,1,0
S01006554,Very bad health,4,0,0,0,0,0,0,2,2,0,0,0,0,0
S01006555,All people aged 16 to 74,621,54,5,49,125,82,29,55,103,114,25,17,8,34
S01006555,Very good health,275,36,2,34,66,36,10,25,39,36,8,4,4,19
S01006555,Good health,232,17,3,14,50,31,12,24,37,43,9,8,1,9
S01006555,Fair health,90,1,0,1,8,12,6,4,21,28,6,3,3,4
S01006555,Bad health,22,0,0,0,1,2,1,1,6,7,2,2,0,2
S01006555,Very bad health,2,0,0,0,0,1,0,1,0,0,0,0,0,0
S01006556,All people aged 16 to 74,569,24,5,19,102,69,38,57,100,118,24,16,8,37
S01006556,Very good health,227,12,2,10,48,31,10,24,38,30,4,2,2,30
S01006556,Good health,209,10,2,8,42,21,16,20,37,49,9,5,4,5
S01006556,Fair health,87,1,1,0,10,13,11,9,19,17,5,3,2,2
S01006556,Bad health,37,1,0,1,1,4,0,3,6,18,4,4,0,0
S01006556,Very bad health,9,0,0,0,1,0,1,1,0,4,2,2,0,0
S01006557,All people aged 16 to 74,525,29,7,22,78,77,24,62,103,94,20,11,9,38
S01006557,Very good health,235,17,6,11,34,37,9,27,41,32,6,2,4,32
S01006557,Good health,181,9,1,8,25,30,10,27,39,27,8,5,3,6
S01006557,Fair health,73,1,0,1,14,7,3,5,18,20,5,3,2,0
S01006557,Bad health,29,2,0,2,4,3,0,3,5,12,0,0,0,0
S01006557,Very bad health,7,0,0,0,1,0,2,0,0,3,1,1,0,0
S01006558,All people aged 16 to 74,511,148,12,136,152,63,16,36,29,18,3,3,0,46
S01006558,Very good health,324,101,7,94,97,36,7,20,15,8,2,2,0,38
S01006558,Good health,150,41,5,36,45,21,5,14,9,7,0,0,0,8
S01006558,Fair health,30,6,0,6,8,4,4,2,4,1,1,1,0,0
S01006558,Bad health,6,0,0,0,2,2,0,0,0,2,0,0,0,0
S01006558,Very bad health,1,0,0,0,0,0,0,0,1,0,0,0,0,0
S01006559,All people aged 16 to 74,472,156,24,132,120,39,18,17,17,11,12,9,3,82
S01006559,Very good health,336,117,20,97,85,16,9,10,13,8,6,4,2,72
S01006559,Good health,110,34,2,32,29,20,6,7,2,1,2,2,0,9
S01006559,Fair health,23,5,2,3,5,3,2,0,2,2,4,3,1,0
S01006559,Bad health,2,0,0,0,1,0,1,0,0,0,0,0,0,0
S01006559,Very bad health,1,0,0,0,0,0,0,0,0,0,0,0,0,1
S01006560,All people aged 16 to 74,706,209,30,179,202,76,48,25,37,21,10,9,1,78
S01006560,Very good health,472,147,22,125,128,43,32,15,22,12,4,3,1,69
S01006560,Good health,191,56,7,49,62,27,14,8,9,3,3,3,0,9
S01006560,Fair health,33,5,1,4,10,5,1,1,4,5,2,2,0,0
S01006560,Bad health,6,1,0,1,2,0,1,0,2,0,0,0,0,0
S01006560,Very bad health,4,0,0,0,0,1,0,1,0,1,1,1,0,0
S01006561,All people aged 16 to 74,558,148,22,126,172,65,39,20,38,18,6,4,2,52
S01006561,Very good health,355,104,19,85,106,38,17,12,20,13,2,1,1,43
S01006561,Good health,167,38,3,35,55,21,16,6,16,3,4,3,1,8
S01006561,Fair health,31,6,0,6,9,6,6,2,0,1,0,0,0,1
S01006561,Bad health,4,0,0,0,2,0,0,0,1,1,0,0,0,0
S01006561,Very bad health,1,0,0,0,0,0,0,0,1,0,0,0,0,0
S01006562,All people aged 16 to 74,531,101,13,88,135,69,28,31,62,39,17,15,2,49
S01006562,Very good health,290,70,7,63,78,31,16,15,21,16,2,1,1,41
S01006562,Good health,154,26,5,21,45,22,9,7,25,9,4,4,0,7
S01006562,Fair health,55,4,1,3,8,14,2,7,9,5,5,4,1,1
S01006562,Bad health,26,1,0,1,4,2,1,2,5,7,4,4,0,0
S01006562,Very bad health,6,0,0,0,0,0,0,0,2,2,2,2,0,0
S01006563,All people aged 16 to 74,602,157,12,145,154,70,23,36,58,37,16,9,7,51
S01006563,Very good health,336,104,8,96,88,29,10,18,27,14,8,5,3,38
S01006563,Good health,197,46,4,42,45,33,12,12,19,13,5,3,2,12
S01006563,Fair health,52,7,0,7,16,6,1,3,9,6,3,1,2,1
S01006563,Bad health,9,0,0,0,3,2,0,1,2,1,0,0,0,0
S01006563,Very bad health,8,0,0,0,2,0,0,2,1,3,0,0,0,0
S01006564,All people aged 16 to 74,818,112,8,104,184,67,32,76,103,78,40,31,9,126
S01006564,Very good health,430,78,5,73,103,26,13,30,47,34,8,7,1,91
S01006564,Good health,285,30,3,27,64,33,10,28,41,29,17,10,7,33
S01006564,Fair health,75,2,0,2,12,7,6,15,11,11,9,9,0,2
S01006564,Bad health,20,2,0,2,4,1,2,2,3,3,3,2,1,0
S01006564,Very bad health,8,0,0,0,1,0,1,1,1,1,3,3,0,0
S01006565,All people aged 16 to 74,925,107,8,99,172,80,24,71,97,71,15,10,5,288
S01006565,Very good health,524,71,6,65,96,40,8,32,43,27,7,5,2,200
S01006565,Good health,291,27,0,27,52,32,14,25,35,23,4,2,2,79
S01006565,Fair health,74,6,1,5,17,6,1,7,11,15,2,1,1,9
S01006565,Bad health,25,2,0,2,4,1,1,4,8,4,1,1,0,0
S01006565,Very bad health,11,1,1,0,3,1,0,3,0,2,1,1,0,0
S01006566,All people aged 16 to 74,663,130,7,123,181,83,20,36,58,34,16,12,4,105
S01006566,Very good health,413,90,1,89,111,50,10,21,27,16,5,2,3,83
S01006566,Good health,202,34,5,29,61,27,9,13,20,10,7,6,1,21
S01006566,Fair health,34,5,1,4,7,6,1,1,7,3,4,4,0,0
S01006566,Bad health,12,1,0,1,2,0,0,1,3,4,0,0,0,1
S01006566,Very bad health,2,0,0,0,0,0,0,0,1,1,0,0,0,0
S01006567,All people aged 16 to 74,735,79,4,75,147,72,15,65,84,67,29,18,11,177
S01006567,Very good health,385,47,1,46,91,32,8,27,34,19,11,6,5,116
S01006567,Good health,252,26,3,23,41,32,6,26,33,24,8,4,4,56
S01006567,Fair health,67,4,0,4,10,5,1,8,9,18,7,6,1,5
S01006567,Bad health,29,2,0,2,5,3,0,4,6,6,3,2,1,0
S01006567,Very bad health,2,0,0,0,0,0,0,0,2,0,0,0,0,0
S01006568,All people aged 16 to 74,863,198,10,188,232,79,21,55,66,41,15,6,9,156
S01006568,Very good health,556,143,8,135,150,47,8,27,34,22,4,1,3,121
S01006568,Good health,253,50,1,49,70,29,11,20,22,12,8,4,4,31
S01006568,Fair health,43,4,1,3,11,1,2,6,7,6,2,0,2,4
S01006568,Bad health,10,1,0,1,1,1,0,2,3,1,1,1,0,0
S01006568,Very bad health,1,0,0,0,0,1,0,0,0,0,0,0,0,0
S01006569,All people aged 16 to 74,470,113,13,100,106,46,21,32,43,29,11,8,3,69
S01006569,Very good health,301,85,10,75,74,21,8,22,19,14,3,2,1,55
S01006569,Good health,133,22,2,20,26,21,11,5,20,12,4,2,2,12
S01006569,Fair health,24,3,1,2,5,1,2,5,3,1,4,4,0,0
S01006569,Bad health,11,3,0,3,1,3,0,0,1,1,0,0,0,2
S01006569,Very bad health,1,0,0,0,0,0,0,0,0,1,0,0,0,0
S01006570,All people aged 16 to 74,609,155,25,130,181,60,28,35,38,24,17,10,7,71
S01006570,Very good health,390,104,19,85,113,34,17,26,23,9,7,3,4,57
S01006570,Good health,166,43,5,38,48,22,10,4,9,12,5,2,3,13
S01006570,Fair health,40,8,1,7,16,4,1,5,2,2,2,2,0,0
S01006570,Bad health,10,0,0,0,2,0,0,0,3,1,3,3,0,1
S01006570,Very bad health,3,0,0,0,2,0,0,0,1,0,0,0,0,0
S01006571,All people aged 16 to 74,697,187,21,166,215,75,33,34,44,24,12,8,4,73
S01006571,Very good health,452,131,14,117,141,44,19,24,27,9,3,0,3,54
S01006571,Good health,196,51,6,45,59,25,13,9,11,10,6,6,0,12
S01006571,Fair health,40,5,1,4,10,5,1,1,6,4,2,2,0,6
S01006571,Bad health,9,0,0,0,5,1,0,0,0,1,1,0,1,1
S01006571,Very bad health,0,0,0,0,0,0,0,0,0,0,0,0,0,0
S01006572,All people aged 16 to 74,643,213,47,166,173,74,44,26,39,10,8,6,2,56
S01006572,Very good health,434,159,35,124,115,43,24,18,20,4,3,3,0,48
S01006572,Good health,180,47,9,38,53,26,17,7,16,3,4,2,2,7
S01006572,Fair health,22,6,2,4,4,4,2,1,2,1,1,1,0,1
S01006572,Bad health,6,1,1,0,1,1,0,0,1,2,0,0,0,0
S01006572,Very bad health,1,0,0,0,0,0,1,0,0,0,0,0,0,0
S01006573,All people aged 16 to 74,534,191,37,154,137,48,29,24,25,6,6,2,4,68
S01006573,Very good health,351,129,27,102,92,25,18,11,13,3,5,2,3,55
S01006573,Good health,149,58,9,49,35,17,7,10,6,3,0,0,0,13
S01006573,Fair health,25,4,1,3,8,4,3,1,4,0,1,0,1,0
S01006573,Bad health,5,0,0,0,2,1,1,1,0,0,0,0,0,0
S01006573,Very bad health,4,0,0,0,0,1,0,1,2,0,0,0,0,0
S01006574,All people aged 16 to 74,741,231,43,188,225,62,51,29,45,12,18,13,5,68
S01006574,Very good health,516,167,30,137,156,36,28,20,32,6,9,9,0,62
S01006574,Good health,190,53,11,42,61,22,20,4,11,5,9,4,5,5
S01006574,Fair health,28,8,2,6,7,4,1,5,2,0,0,0,0,1
S01006574,Bad health,5,2,0,2,0,0,2,0,0,1,0,0,0,0
S01006574,Very bad health,2,1,0,1,1,0,0,0,0,0,0,0,0,0
S01006575,All people aged 16 to 74,721,177,21,156,198,79,50,47,51,29,19,11,8,71
S01006575,Very good health,466,131,17,114,139,45,25,26,31,9,8,6,2,52
S01006575,Good health,195,38,4,34,47,27,18,17,10,16,4,3,1,18
S01006575,Fair health,48,7,0,7,8,7,6,3,9,3,4,0,4,1
S01006575,Bad health,10,1,0,1,3,0,1,1,1,1,2,2,0,0
S01006575,Very bad health,2,0,0,0,1,0,0,0,0,0,1,0,1,0
S01006576,All people aged 16 to 74,544,170,24,146,139,51,28,29,39,18,6,4,2,64
S01006576,Very good health,329,104,18,86,87,25,14,18,17,8,4,2,2,52
S01006576,Good health,165,52,5,47,40,21,11,9,14,7,2,2,0,9
S01006576,Fair health,40,13,1,12,9,4,2,2,4,3,0,0,0,3
S01006576,Bad health,7,1,0,1,2,0,1,0,3,0,0,0,0,0
S01006576,Very bad health,3,0,0,0,1,1,0,0,1,0,0,0,0,0
S01006577,All people aged 16 to 74,651,140,13,127,191,83,39,42,48,22,13,6,7,73
S01006577,Very good health,434,98,9,89,126,54,21,25,32,14,8,4,4,56
S01006577,Good health,180,36,4,32,54,26,14,14,12,5,4,2,2,15
S01006577,Fair health,29,6,0,6,8,2,4,2,3,1,1,0,1,2
S01006577,Bad health,8,0,0,0,3,1,0,1,1,2,0,0,0,0
S01006577,Very bad health,0,0,0,0,0,0,0,0,0,0,0,0,0,0
S01006578,All people aged 16 to 74,952,174,10,164,241,110,16,72,103,63,29,17,12,144
S01006578,Very good health,560,114,3,111,163,68,9,28,46,28,7,3,4,97
S01006578,Good health,303,53,6,47,60,34,5,35,40,24,17,11,6,35
S01006578,Fair health,67,5,1,4,16,5,1,6,12,8,4,3,1,10
S01006578,Bad health,22,2,0,2,2,3,1,3,5,3,1,0,1,2
S01006578,Very bad health,0,0,0,0,0,0,0,0,0,0,0,0,0,0
S01006579,All people aged 16 to 74,882,172,17,155,210,117,17,74,88,35,10,8,2,159
S01006579,Very good health,555,119,11,108,138,67,6,40,51,16,5,4,1,113
S01006579,Good health,271,47,5,42,64,43,8,31,25,14,3,2,1,36
S01006579,Fair health,43,5,1,4,7,6,2,3,8,2,0,0,0,10
S01006579,Bad health,10,1,0,1,1,0,0,0,3,3,2,2,0,0
S01006579,Very bad health,3,0,0,0,0,1,1,0,1,0,0,0,0,0
S01006580,All people aged 16 to 74,615,148,13,135,183,73,25,37,46,26,17,12,5,60
S01006580,Very good health,361,98,7,91,102,44,11,17,27,8,10,7,3,44
S01006580,Good health,193,41,6,35,62,23,10,16,16,8,4,2,2,13
S01006580,Fair health,49,8,0,8,15,5,3,4,2,8,1,1,0,3
S01006580,Bad health,7,0,0,0,4,1,1,0,1,0,0,0,0,0
S01006580,Very bad health,5,1,0,1,0,0,0,0,0,2,2,2,0,0
S01006581,All people aged 16 to 74,670,198,38,160,178,75,49,28,56,20,11,6,5,55
S01006581,Very good health,428,133,24,109,114,45,32,13,24,14,7,4,3,46
S01006581,Good health,207,57,12,45,55,27,16,14,24,3,3,2,1,8
S01006581,Fair health,32,8,2,6,8,3,0,1,7,3,1,0,1,1
S01006581,Bad health,2,0,0,0,1,0,1,0,0,0,0,0,0,0
S01006581,Very bad health,1,0,0,0,0,0,0,0,1,0,0,0,0,0
S01006582,All people aged 16 to 74,797,143,8,135,160,75,32,50,106,55,27,12,15,149
S01006582,Very good health,495,96,5,91,99,45,18,28,64,28,8,8,0,109
S01006582,Good health,228,42,1,41,44,28,12,10,29,15,12,3,9,36
S01006582,Fair health,61,5,2,3,13,2,2,8,12,10,6,1,5,3
S01006582,Bad health,12,0,0,0,3,0,0,4,1,2,1,0,1,1
S01006582,Very bad health,1,0,0,0,1,0,0,0,0,0,0,0,0,0
S01006583,All people aged 16 to 74,666,128,6,122,128,67,12,45,56,29,8,3,5,193
S01006583,Very good health,406,80,4,76,85,41,2,24,26,13,4,1,3,131
S01006583,Good health,215,46,2,44,36,21,7,17,25,9,4,2,2,50
S01006583,Fair health,36,2,0,2,5,4,2,3,4,5,0,0,0,11
S01006583,Bad health,6,0,0,0,1,0,1,1,1,2,0,0,0,0
S01006583,Very bad health,3,0,0,0,1,1,0,0,0,0,0,0,0,1
S01006584,All people aged 16 to 74,561,114,9,105,136,46,17,36,39,25,5,4,1,143
S01006584,Very good health,378,83,4,79,98,32,9,18,22,14,4,3,1,98
S01006584,Good health,143,28,4,24,28,10,5,15,13,4,1,1,0,39
S01006584,Fair health,39,3,1,2,10,4,3,3,3,7,0,0,0,6
S01006584,Bad health,1,0,0,0,0,0,0,0,1,0,0,0,0,0
S01006584,Very bad health,0,0,0,0,0,0,0,0,0,0,0,0,0,0
S01006585,All people aged 16 to 74,691,66,3,63,100,80,34,71,84,94,25,13,12,137
S01006585,Very good health,351,47,2,45,61,46,19,27,26,26,10,7,3,89
S01006585,Good health,232,17,1,16,32,21,13,28,35,36,7,2,5,43
S01006585,Fair health,73,1,0,1,5,5,2,12,14,23,6,2,4,5
S01006585,Bad health,32,1,0,1,2,7,0,4,8,8,2,2,0,0
S01006585,Very bad health,3,0,0,0,0,1,0,0,1,1,0,0,0,0
S01006586,All people aged 16 to 74,929,121,10,111,159,91,28,74,120,85,19,12,7,232
S01006586,Very good health,531,86,5,81,91,50,16,31,42,28,7,4,3,180
S01006586,Good health,250,28,3,25,48,30,8,26,41,24,3,2,1,42
S01006586,Fair health,107,5,1,4,14,8,4,12,28,21,5,3,2,10
S01006586,Bad health,33,1,1,0,4,3,0,4,6,11,4,3,1,0
S01006586,Very bad health,8,1,0,1,2,0,0,1,3,1,0,0,0,0
S01006587,All people aged 16 to 74,501,67,4,63,84,51,18,37,79,40,14,6,8,111
S01006587,Very good health,300,49,4,45,55,31,12,20,42,9,7,2,5,75
S01006587,Good health,149,13,0,13,23,15,4,15,22,20,4,3,1,33
S01006587,Fair health,43,3,0,3,5,4,2,2,12,10,2,0,2,3
S01006587,Bad health,8,2,0,2,1,1,0,0,2,1,1,1,0,0
S01006587,Very bad health,1,0,0,0,0,0,0,0,1,0,0,0,0,0
S01006588,All people aged 16 to 74,551,71,2,69,102,47,8,31,61,39,8,5,3,184
S01006588,Very good health,332,46,2,44,55,26,2,21,39,18,2,2,0,123
S01006588,Good health,183,23,0,23,40,16,5,8,14,17,4,3,1,56
S01006588,Fair health,26,1,0,1,7,5,1,2,4,2,0,0,0,4
S01006588,Bad health,6,1,0,1,0,0,0,0,1,1,2,0,2,1
S01006588,Very bad health,4,0,0,0,0,0,0,0,3,1,0,0,0,0
S01006589,All people aged 16 to 74,624,59,1,58,90,51,26,57,54,82,17,8,9,188
S01006589,Very good health,350,40,1,39,44,24,11,20,29,43,7,2,5,132
S01006589,Good health,209,17,0,17,40,19,11,30,17,20,6,3,3,49
S01006589,Fair health,42,0,0,0,3,7,4,4,6,8,3,2,1,7
S01006589,Bad health,19,2,0,2,3,1,0,2,1,9,1,1,0,0
S01006589,Very bad health,4,0,0,0,0,0,0,1,1,2,0,0,0,0
S01006590,All people aged 16 to 74,644,114,8,106,128,72,37,41,75,39,32,27,5,106
S01006590,Very good health,383,79,5,74,80,36,20,24,32,16,4,3,1,92
S01006590,Good health,198,30,1,29,40,28,12,14,31,16,15,12,3,12
S01006590,Fair health,45,3,1,2,5,8,4,3,8,4,8,8,0,2
S01006590,Bad health,14,2,1,1,2,0,0,0,3,3,4,3,1,0
S01006590,Very bad health,4,0,0,0,1,0,1,0,1,0,1,1,0,0
S01006591,All people aged 16 to 74,649,114,9,105,142,80,33,44,86,39,18,11,7,93
S01006591,Very good health,396,85,7,78,92,45,12,24,47,16,7,3,4,68
S01006591,Good health,200,27,2,25,40,33,13,15,30,11,7,5,2,24
S01006591,Fair health,42,2,0,2,8,1,4,4,9,10,3,2,1,1
S01006591,Bad health,7,0,0,0,2,0,3,1,0,0,1,1,0,0
S01006591,Very bad health,4,0,0,0,0,1,1,0,0,2,0,0,0,0
S01006592,All people aged 16 to 74,600,124,12,112,181,77,24,49,48,17,8,7,1,72
S01006592,Very good health,413,95,10,85,124,48,10,32,37,10,2,2,0,55
S01006592,Good health,159,25,2,23,54,22,8,13,9,5,6,5,1,17
S01006592,Fair health,20,2,0,2,3,6,4,2,2,1,0,0,0,0
S01006592,Bad health,7,2,0,2,0,1,1,2,0,1,0,0,0,0
S01006592,Very bad health,1,0,0,0,0,0,1,0,0,0,0,0,0,0
S01006593,All people aged 16 to 74,677,156,15,141,182,62,28,63,37,40,13,13,0,96
S01006593,Very good health,441,115,12,103,122,42,13,33,27,16,7,7,0,66
S01006593,Good health,194,36,2,34,50,17,11,26,7,18,3,3,0,26
S01006593,Fair health,33,5,1,4,6,3,2,3,3,5,2,2,0,4
S01006593,Bad health,8,0,0,0,4,0,2,1,0,0,1,1,0,0
S01006593,Very bad health,1,0,0,0,0,0,0,0,0,1,0,0,0,0
S01006594,All people aged 16 to 74,446,78,10,68,92,81,26,30,42,35,2,1,1,60
S01006594,Very good health,245,52,8,44,52,42,14,14,16,10,0,0,0,45
S01006594,Good health,158,20,1,19,31,31,10,15,21,17,1,0,1,12
S01006594,Fair health,33,6,1,5,7,5,1,1,5,5,1,1,0,2
S01006594,Bad health,7,0,0,0,1,3,0,0,0,2,0,0,0,1
S01006594,Very bad health,3,0,0,0,1,0,1,0,0,1,0,0,0,0
S01006595,All people aged 16 to 74,828,172,16,156,234,111,29,58,76,41,18,13,5,89
S01006595,Very good health,527,128,9,119,145,74,14,30,40,18,10,7,3,68
S01006595,Good health,243,41,7,34,79,31,10,19,23,17,5,3,2,18
S01006595,Fair health,47,2,0,2,9,4,5,6,11,4,3,3,0,3
S01006595,Bad health,10,1,0,1,1,2,0,2,2,2,0,0,0,0
S01006595,Very bad health,1,0,0,0,0,0,0,1,0,0,0,0,0,0
S01006596,All people aged 16 to 74,590,147,10,137,153,65,40,45,56,22,9,5,4,53
S01006596,Very good health,371,100,7,93,102,44,25,22,29,11,3,1,2,35
S01006596,Good health,173,43,3,40,43,13,13,18,21,7,3,1,2,12
S01006596,Fair health,39,4,0,4,7,4,2,5,6,2,3,3,0,6
S01006596,Bad health,6,0,0,0,1,3,0,0,0,2,0,0,0,0
S01006596,Very bad health,1,0,0,0,0,1,0,0,0,0,0,0,0,0
S01006597,All people aged 16 to 74,488,84,6,78,123,43,20,43,56,30,11,9,2,78
S01006597,Very good health,302,59,3,56,82,26,13,23,30,13,3,3,0,53
S01006597,Good health,145,22,2,20,36,11,3,16,18,12,5,3,2,22
S01006597,Fair health,33,3,1,2,4,5,4,3,6,4,2,2,0,2
S01006597,Bad health,6,0,0,0,1,1,0,0,1,1,1,1,0,1
S01006597,Very bad health,2,0,0,0,0,0,0,1,1,0,0,0,0,0
S01006598,All people aged 16 to 74,766,209,33,176,219,93,51,54,50,26,9,4,5,55
S01006598,Very good health,498,153,21,132,141,58,28,32,28,10,7,4,3,41
S01006598,Good health,222,50,10,40,65,28,17,16,19,13,2,0,2,12
S01006598,Fair health,37,4,2,2,10,6,4,5,3,3,0,0,0,2
S01006598,Bad health,7,2,0,2,2,0,2,1,0,0,0,0,0,0
S01006598,Very bad health,2,0,0,0,1,1,0,0,0,0,0,0,0,0
S01006599,All people aged 16 to 74,648,67,8,59,123,89,31,63,92,71,19,10,9,93
S01006599,Very good health,334,49,6,43,66,46,18,31,35,19,5,2,3,65
S01006599,Good health,202,12,1,11,40,30,8,23,29,31,5,2,3,24
S01006599,Fair health,77,6,1,5,12,8,3,6,18,16,6,3,3,2
S01006599,Bad health,28,0,0,0,4,4,1,3,7,4,3,3,0,2
S01006599,Very bad health,7,0,0,0,1,1,1,0,3,1,0,0,0,0
S01006600,All people aged 16 to 74,798,162,23,139,190,108,48,56,98,45,18,12,6,73
S01006600,Very good health,465,111,15,96,124,60,24,29,40,13,6,4,2,58
S01006600,Good health,242,38,8,30,51,40,16,20,36,21,6,2,4,14
S01006600,Fair health,66,10,0,10,10,7,5,4,17,8,4,4,0,1
S01006600,Bad health,22,3,0,3,5,0,1,3,5,3,2,2,0,0
S01006600,Very bad health,3,0,0,0,0,1,2,0,0,0,0,0,0,0
S01006601,All people aged 16 to 74,847,155,21,134,210,126,40,55,91,56,23,12,11,91
S01006601,Very good health,471,104,11,93,134,68,17,26,38,19,7,4,3,58
S01006601,Good health,278,38,8,30,62,51,14,19,32,30,6,1,5,26
S01006601,Fair health,78,8,2,6,12,5,8,9,20,4,7,4,3,5
S01006601,Bad health,18,5,0,5,2,2,1,0,1,2,3,3,0,2
S01006601,Very bad health,2,0,0,0,0,0,0,1,0,1,0,0,0,0
S01006602,All people aged 16 to 74,606,175,31,144,155,57,38,27,48,23,15,13,2,68
S01006602,Very good health,396,113,20,93,106,29,21,20,29,15,8,7,1,55
S01006602,Good health,156,51,8,43,40,21,12,5,13,2,1,1,0,11
S01006602,Fair health,41,8,2,6,5,6,5,1,4,5,6,5,1,1
S01006602,Bad health,8,3,1,2,3,0,0,0,0,1,0,0,0,1
S01006602,Very bad health,5,0,0,0,1,1,0,1,2,0,0,0,0,0
S01006603,All people aged 16 to 74,625,24,6,18,85,96,19,86,118,122,46,33,13,29
S01006603,Very good health,225,9,2,7,33,46,7,28,36,41,7,3,4,18
S01006603,Good health,252,11,2,9,37,30,6,44,55,49,11,6,5,9
S01006603,Fair health,103,2,1,1,11,16,3,9,19,24,17,13,4,2
S01006603,Bad health,28,2,1,1,3,4,2,3,5,6,3,3,0,0
S01006603,Very bad health,17,0,0,0,1,0,1,2,3,2,8,8,0,0
S01006604,All people aged 16 to 74,538,23,4,19,82,71,37,56,108,98,16,9,7,47
S01006604,Very good health,218,12,1,11,35,23,18,22,41,29,5,4,1,33
S01006604,Good health,206,9,3,6,33,32,14,21,41,39,5,3,2,12
S01006604,Fair health,75,0,0,0,10,13,3,6,17,20,4,2,2,2
S01006604,Bad health,29,0,0,0,2,3,2,6,8,6,2,0,2,0
S01006604,Very bad health,10,2,0,2,2,0,0,1,1,4,0,0,0,0
S01006605,All people aged 16 to 74,548,27,2,25,76,62,22,57,124,121,26,11,15,33
S01006605,Very good health,223,12,1,11,38,19,7,30,45,42,9,4,5,21
S01006605,Good health,220,12,0,12,25,28,10,22,51,52,12,4,8,8
S01006605,Fair health,71,3,1,2,8,5,3,4,23,19,3,1,2,3
S01006605,Bad health,27,0,0,0,4,7,2,1,5,5,2,2,0,1
S01006605,Very bad health,7,0,0,0,1,3,0,0,0,3,0,0,0,0
S01006606,All people aged 16 to 74,618,65,14,51,143,78,47,51,97,67,22,18,4,48
S01006606,Very good health,296,32,7,25,75,38,25,28,38,24,3,3,0,33
S01006606,Good health,235,27,6,21,55,30,13,16,45,25,11,10,1,13
S01006606,Fair health,63,6,1,5,10,10,6,4,9,10,7,4,3,1
S01006606,Bad health,20,0,0,0,3,0,3,3,3,7,0,0,0,1
S01006606,Very bad health,4,0,0,0,0,0,0,0,2,1,1,1,0,0
S01006607,All people aged 16 to 74,695,34,5,29,102,116,35,70,136,138,21,14,7,43
S01006607,Very good health,298,24,4,20,50,45,15,31,52,47,3,2,1,31
S01006607,Good health,274,8,0,8,33,50,15,31,54,63,10,8,2,10
S01006607,Fair health,87,2,1,1,10,13,3,6,24,20,7,3,4,2
S01006607,Bad health,26,0,0,0,4,5,1,2,6,7,1,1,0,0
S01006607,Very bad health,10,0,0,0,5,3,1,0,0,1,0,0,0,0
S01006608,All people aged 16 to 74,562,54,8,46,132,83,67,58,61,48,12,5,7,47
S01006608,Very good health,337,39,6,33,90,51,31,33,33,23,3,1,2,34
S01006608,Good health,162,14,2,12,33,20,23,21,19,16,5,3,2,11
S01006608,Fair health,54,1,0,1,7,11,12,3,9,7,2,0,2,2
S01006608,Bad health,8,0,0,0,2,1,1,0,0,2,2,1,1,0
S01006608,Very bad health,1,0,0,0,0,0,0,1,0,0,0,0,0,0
S01006609,All people aged 16 to 74,772,24,3,21,103,126,38,105,156,157,21,11,10,42
S01006609,Very good health,336,13,1,12,57,56,18,39,60,52,9,4,5,32
S01006609,Good health,278,8,1,7,31,49,15,47,55,59,8,4,4,6
S01006609,Fair health,110,1,1,0,13,16,4,12,25,33,3,3,0,3
S01006609,Bad health,37,1,0,1,1,4,0,6,14,9,1,0,1,1
S01006609,Very bad health,11,1,0,1,1,1,1,1,2,4,0,0,0,0
S01006610,All people aged 16 to 74,328,16,8,8,40,49,13,45,65,65,16,13,3,19
S01006610,Very good health,138,9,4,5,14,26,4,15,25,25,4,3,1,16
S01006610,Good health,132,6,3,3,22,17,8,21,28,22,5,4,1,3
S01006610,Fair health,38,1,1,0,4,5,0,3,8,13,4,3,1,0
S01006610,Bad health,17,0,0,0,0,1,1,5,4,4,2,2,0,0
S01006610,Very bad health,3,0,0,0,0,0,0,1,0,1,1,1,0,0
S01006611,All people aged 16 to 74,654,25,3,22,105,87,29,80,136,123,29,15,14,40
S01006611,Very good health,281,15,1,14,60,37,10,36,48,44,7,2,5,24
S01006611,Good health,240,7,2,5,30,39,15,27,53,40,14,7,7,15
S01006611,Fair health,90,2,0,2,8,5,3,11,31,23,6,5,1,1
S01006611,Bad health,32,0,0,0,6,4,1,5,3,11,2,1,1,0
S01006611,Very bad health,11,1,0,1,1,2,0,1,1,5,0,0,0,0
S01006612,All people aged 16 to 74,669,48,4,44,146,97,33,62,111,113,10,7,3,49
S01006612,Very good health,350,32,3,29,88,53,12,32,45,49,3,3,0,36
S01006612,Good health,215,13,0,13,50,33,11,19,41,35,2,1,1,11
S01006612,Fair health,71,3,1,2,5,8,8,8,17,17,3,2,1,2
S01006612,Bad health,22,0,0,0,2,2,2,2,4,9,1,0,1,0
S01006612,Very bad health,11,0,0,0,1,1,0,1,4,3,1,1,0,0
S01006613,All people aged 16 to 74,472,52,10,42,114,102,30,49,61,39,4,2,2,21
S01006613,Very good health,288,35,6,29,66,69,17,30,32,20,1,0,1,18
S01006613,Good health,154,13,3,10,40,28,11,18,26,12,3,2,1,3
S01006613,Fair health,21,4,1,3,6,5,0,1,2,3,0,0,0,0
S01006613,Bad health,7,0,0,0,0,0,2,0,1,4,0,0,0,0
S01006613,Very bad health,2,0,0,0,2,0,0,0,0,0,0,0,0,0
S01006614,All people aged 16 to 74,484,76,10,66,138,85,31,40,50,37,7,3,4,20
S01006614,Very good health,283,54,6,48,76,45,22,26,26,15,4,2,2,15
S01006614,Good health,172,19,4,15,53,37,7,12,18,19,2,1,1,5
S01006614,Fair health,18,3,0,3,6,1,0,2,3,3,0,0,0,0
S01006614,Bad health,8,0,0,0,3,1,2,0,1,0,1,0,1,0
S01006614,Very bad health,3,0,0,0,0,1,0,0,2,0,0,0,0,0
S01006615,All people aged 16 to 74,551,92,27,65,135,92,37,58,68,32,2,0,2,35
S01006615,Very good health,354,58,18,40,96,57,24,39,37,17,2,0,2,24
S01006615,Good health,166,27,9,18,38,30,12,15,25,12,0,0,0,7
S01006615,Fair health,27,7,0,7,1,4,1,3,5,3,0,0,0,3
S01006615,Bad health,4,0,0,0,0,1,0,1,1,0,0,0,0,1
S01006615,Very bad health,0,0,0,0,0,0,0,0,0,0,0,0,0,0
S01006616,All people aged 16 to 74,655,63,9,54,147,110,37,74,103,68,8,4,4,45
S01006616,Very good health,380,38,3,35,91,67,17,44,58,34,3,2,1,28
S01006616,Good health,224,22,5,17,50,35,15,23,36,23,4,1,3,16
S01006616,Fair health,46,2,1,1,6,7,5,7,9,9,1,1,0,0
S01006616,Bad health,5,1,0,1,0,1,0,0,0,2,0,0,0,1
S01006616,Very bad health,0,0,0,0,0,0,0,0,0,0,0,0,0,0
S01006617,All people aged 16 to 74,520,42,10,32,101,92,40,52,84,79,7,4,3,23
S01006617,Very good health,276,29,4,25,51,61,21,30,35,24,4,2,2,21
S01006617,Good health,180,11,5,6,40,21,12,16,35,42,2,2,0,1
S01006617,Fair health,54,2,1,1,6,10,7,3,13,12,1,0,1,0
S01006617,Bad health,8,0,0,0,4,0,0,2,1,1,0,0,0,0
S01006617,Very bad health,2,0,0,0,0,0,0,1,0,0,0,0,0,1
S01006618,All people aged 16 to 74,443,54,14,40,94,72,26,55,76,44,3,2,1,19
S01006618,Very good health,204,30,8,22,37,35,10,26,37,12,1,1,0,16
S01006618,Good health,188,20,6,14,47,33,12,19,30,22,2,1,1,3
S01006618,Fair health,38,4,0,4,8,2,3,9,7,5,0,0,0,0
S01006618,Bad health,10,0,0,0,2,2,1,1,2,2,0,0,0,0
S01006618,Very bad health,3,0,0,0,0,0,0,0,0,3,0,0,0,0
S01006619,All people aged 16 to 74,705,60,7,53,139,98,57,87,115,87,7,6,1,55
S01006619,Very good health,355,32,6,26,75,54,24,41,52,32,1,1,0,44
S01006619,Good health,250,23,1,22,50,28,28,33,39,39,1,0,1,9
S01006619,Fair health,74,4,0,4,11,13,3,10,16,13,3,3,0,1
S01006619,Bad health,19,1,0,1,2,3,2,3,3,2,2,2,0,1
S01006619,Very bad health,7,0,0,0,1,0,0,0,5,1,0,0,0,0
S01006620,All people aged 16 to 74,690,44,7,37,148,125,36,91,124,83,8,4,4,31
S01006620,Very good health,340,20,4,16,83,64,16,44,48,36,4,1,3,25
S01006620,Good health,248,20,2,18,55,48,17,30,39,31,2,1,1,6
S01006620,Fair health,78,4,1,3,9,10,3,13,24,13,2,2,0,0
S01006620,Bad health,19,0,0,0,1,2,0,3,10,3,0,0,0,0
S01006620,Very bad health,5,0,0,0,0,1,0,1,3,0,0,0,0,0
S01006621,All people aged 16 to 74,414,21,3,18,90,63,28,60,71,56,8,5,3,17
S01006621,Very good health,201,13,1,12,49,26,13,22,38,25,2,2,0,13
S01006621,Good health,158,6,2,4,35,28,10,32,22,19,3,1,2,3
S01006621,Fair health,47,2,0,2,6,8,5,4,9,9,3,2,1,1
S01006621,Bad health,8,0,0,0,0,1,0,2,2,3,0,0,0,0
S01006621,Very bad health,0,0,0,0,0,0,0,0,0,0,0,0,0,0
S01006622,All people aged 16 to 74,543,59,10,49,133,107,38,61,70,43,3,3,0,29
S01006622,Very good health,284,27,2,25,76,54,15,34,41,15,0,0,0,22
S01006622,Good health,214,27,8,19,50,43,20,21,22,23,2,2,0,6
S01006622,Fair health,35,3,0,3,6,8,2,6,4,4,1,1,0,1
S01006622,Bad health,9,2,0,2,1,1,1,0,3,1,0,0,0,0
S01006622,Very bad health,1,0,0,0,0,1,0,0,0,0,0,0,0,0
S01006623,All people aged 16 to 74,584,32,3,29,99,88,26,82,99,104,15,13,2,39
S01006623,Very good health,261,20,1,19,51,32,15,24,49,42,2,2,0,26
S01006623,Good health,221,11,2,9,35,43,6,33,35,39,9,7,2,10
S01006623,Fair health,73,1,0,1,9,13,4,14,11,15,4,4,0,2
S01006623,Bad health,23,0,0,0,3,0,1,9,3,6,0,0,0,1
S01006623,Very bad health,6,0,0,0,1,0,0,2,1,2,0,0,0,0
S01006624,All people aged 16 to 74,857,52,7,45,110,91,43,114,151,175,51,40,11,70
S01006624,Very good health,352,32,3,29,51,30,22,47,50,59,15,14,1,46
S01006624,Good health,340,17,2,15,47,40,10,44,67,76,21,12,9,18
S01006624,Fair health,123,2,2,0,9,16,7,17,29,30,8,8,0,5
S01006624,Bad health,32,1,0,1,3,4,3,4,4,6,7,6,1,0
S01006624,Very bad health,10,0,0,0,0,1,1,2,1,4,0,0,0,1
S01006625,All people aged 16 to 74,510,32,6,26,80,60,30,53,95,111,13,9,4,36
S01006625,Very good health,220,12,1,11,31,36,10,22,36,39,8,6,2,26
S01006625,Good health,204,18,5,13,32,20,12,21,44,46,2,1,1,9
S01006625,Fair health,57,2,0,2,11,4,2,8,9,18,2,1,1,1
S01006625,Bad health,17,0,0,0,2,0,5,2,3,4,1,1,0,0
S01006625,Very bad health,12,0,0,0,4,0,1,0,3,4,0,0,0,0
S01006626,All people aged 16 to 74,548,11,4,7,61,63,21,59,125,149,21,13,8,38
S01006626,Very good health,198,6,0,6,29,27,6,21,38,46,5,3,2,20
S01006626,Good health,229,5,4,1,19,26,11,26,52,69,6,4,2,15
S01006626,Fair health,75,0,0,0,7,5,3,9,27,15,8,5,3,1
S01006626,Bad health,35,0,0,0,5,4,1,2,5,15,1,0,1,2
S01006626,Very bad health,11,0,0,0,1,1,0,1,3,4,1,1,0,0
S01006627,All people aged 16 to 74,753,46,10,36,122,96,29,90,121,178,25,9,16,46
S01006627,Very good health,329,26,5,21,67,43,10,40,41,65,8,3,5,29
S01006627,Good health,294,13,2,11,48,38,14,35,57,68,7,3,4,14
S01006627,Fair health,84,5,2,3,7,12,3,6,15,27,7,3,4,2
S01006627,Bad health,40,2,1,1,0,3,2,6,7,16,3,0,3,1
S01006627,Very bad health,6,0,0,0,0,0,0,3,1,2,0,0,0,0
S01006628,All people aged 16 to 74,954,70,7,63,129,94,30,131,154,207,27,12,15,112
S01006628,Very good health,468,43,4,39,70,45,8,66,52,93,11,4,7,80
S01006628,Good health,340,24,2,22,46,30,16,48,75,71,7,3,4,23
S01006628,Fair health,109,3,1,2,11,16,6,13,16,30,5,1,4,9
S01006628,Bad health,34,0,0,0,2,3,0,4,10,11,4,4,0,0
S01006628,Very bad health,3,0,0,0,0,0,0,0,1,2,0,0,0,0
S01006629,All people aged 16 to 74,568,17,5,12,62,50,18,65,121,141,45,28,17,49
S01006629,Very good health,215,6,2,4,29,24,6,25,44,44,9,6,3,28
S01006629,Good health,221,9,2,7,25,17,4,24,53,59,16,7,9,14
S01006629,Fair health,88,2,1,1,7,7,6,12,16,19,13,10,3,6
S01006629,Bad health,32,0,0,0,1,2,1,3,5,15,4,3,1,1
S01006629,Very bad health,12,0,0,0,0,0,1,1,3,4,3,2,1,0
S01006630,All people aged 16 to 74,459,8,2,6,34,49,22,58,103,132,29,22,7,24
S01006630,Very good health,158,4,1,3,9,21,9,15,40,38,9,7,2,13
S01006630,Good health,174,2,0,2,18,20,8,25,40,47,4,1,3,10
S01006630,Fair health,86,1,1,0,5,6,4,14,17,32,7,6,1,0
S01006630,Bad health,30,1,0,1,2,2,1,4,5,11,3,3,0,1
S01006630,Very bad health,11,0,0,0,0,0,0,0,1,4,6,5,1,0
S01006631,All people aged 16 to 74,711,38,8,30,96,79,25,88,143,178,37,30,7,27
S01006631,Very good health,297,26,6,20,50,38,12,28,57,56,12,10,2,18
S01006631,Good health,270,8,1,7,32,33,11,38,52,78,12,10,2,6
S01006631,Fair health,101,3,0,3,11,5,2,13,26,29,9,6,3,3
S01006631,Bad health,37,1,1,0,2,2,0,9,8,13,2,2,0,0
S01006631,Very bad health,6,0,0,0,1,1,0,0,0,2,2,2,0,0
S01006632,All people aged 16 to 74,624,24,1,23,71,59,21,63,132,157,47,30,17,50
S01006632,Very good health,233,10,0,10,30,30,9,25,48,37,15,9,6,29
S01006632,Good health,240,11,1,10,29,19,6,26,53,64,16,7,9,16
S01006632,Fair health,105,2,0,2,10,9,5,6,19,43,7,5,2,4
S01006632,Bad health,36,1,0,1,1,1,1,4,10,11,7,7,0,0
S01006632,Very bad health,10,0,0,0,1,0,0,2,2,2,2,2,0,1
S01006633,All people aged 16 to 74,503,15,4,11,38,49,14,52,109,138,42,35,7,46
S01006633,Very good health,201,7,1,6,20,21,8,19,40,49,12,10,2,25
S01006633,Good health,201,5,2,3,12,22,4,24,50,52,16,13,3,16
S01006633,Fair health,71,1,0,1,5,3,1,6,17,27,8,7,1,3
S01006633,Bad health,27,1,1,0,1,3,1,3,1,9,6,5,1,2
S01006633,Very bad health,3,1,0,1,0,0,0,0,1,1,0,0,0,0
S01006634,All people aged 16 to 74,445,17,6,11,35,31,9,54,86,135,56,40,16,22
S01006634,Very good health,166,11,5,6,13,14,2,19,35,45,13,7,6,14
S01006634,Good health,165,4,0,4,16,12,3,17,38,52,17,11,6,6
S01006634,Fair health,77,0,0,0,4,2,3,13,12,29,12,9,3,2
S01006634,Bad health,29,0,0,0,2,3,0,4,1,7,12,11,1,0
S01006634,Very bad health,8,2,1,1,0,0,1,1,0,2,2,2,0,0
S01006635,All people aged 16 to 74,485,21,0,21,57,55,23,60,98,118,21,11,10,32
S01006635,Very good health,233,8,0,8,29,28,10,29,44,52,11,6,5,22
S01006635,Good health,172,10,0,10,21,18,10,26,33,39,5,1,4,10
S01006635,Fair health,54,3,0,3,5,7,2,1,14,18,4,3,1,0
S01006635,Bad health,19,0,0,0,1,2,1,3,7,5,0,0,0,0
S01006635,Very bad health,7,0,0,0,1,0,0,1,0,4,1,1,0,0
S01006636,All people aged 16 to 74,603,11,1,10,40,47,21,70,143,182,38,26,12,51
S01006636,Very good health,205,5,0,5,17,21,9,27,35,44,15,12,3,32
S01006636,Good health,252,4,1,3,18,20,8,29,65,81,13,8,5,14
S01006636,Fair health,98,1,0,1,4,2,4,9,26,42,7,4,3,3
S01006636,Bad health,41,1,0,1,1,3,0,5,16,11,2,1,1,2
S01006636,Very bad health,7,0,0,0,0,1,0,0,1,4,1,1,0,0
S01006637,All people aged 16 to 74,619,75,6,69,103,68,24,55,99,70,23,15,8,102
S01006637,Very good health,324,50,3,47,55,34,10,28,43,28,4,1,3,72
S01006637,Good health,192,20,2,18,38,23,9,14,34,21,8,5,3,25
S01006637,Fair health,81,4,1,3,9,8,4,11,18,16,6,5,1,5
S01006637,Bad health,19,1,0,1,0,3,1,2,3,4,5,4,1,0
S01006637,Very bad health,3,0,0,0,1,0,0,0,1,1,0,0,0,0
S01006638,All people aged 16 to 74,758,64,3,61,129,85,14,57,113,84,22,11,11,190
S01006638,Very good health,400,41,2,39,67,44,6,30,47,28,9,4,5,128
S01006638,Good health,239,22,1,21,42,30,2,21,45,20,6,2,4,51
S01006638,Fair health,85,1,0,1,15,8,2,2,14,27,5,4,1,11
S01006638,Bad health,29,0,0,0,4,3,4,4,5,7,2,1,1,0
S01006638,Very bad health,5,0,0,0,1,0,0,0,2,2,0,0,0,0
S01006639,All people aged 16 to 74,805,57,10,47,122,72,27,63,121,96,36,22,14,211
S01006639,Very good health,400,42,7,35,61,40,11,18,48,32,5,3,2,143
S01006639,Good health,266,12,3,9,46,19,11,22,45,35,14,7,7,62
S01006639,Fair health,87,1,0,1,6,9,2,18,14,19,12,7,5,6
S01006639,Bad health,41,2,0,2,7,3,1,3,11,9,5,5,0,0
S01006639,Very bad health,11,0,0,0,2,1,2,2,3,1,0,0,0,0
S01006640,All people aged 16 to 74,683,110,13,97,141,68,12,42,41,30,9,6,3,230
S01006640,Very good health,481,79,8,71,95,52,7,23,28,13,5,3,2,179
S01006640,Good health,166,28,5,23,39,15,2,13,9,12,2,2,0,46
S01006640,Fair health,30,2,0,2,7,1,3,5,3,5,0,0,0,4
S01006640,Bad health,4,0,0,0,0,0,0,0,1,0,2,1,1,1
S01006640,Very bad health,2,1,0,1,0,0,0,1,0,0,0,0,0,0
S01006641,All people aged 16 to 74,940,108,8,100,159,96,23,71,112,82,34,26,8,255
S01006641,Very good health,524,68,4,64,90,44,8,34,69,24,10,8,2,177
S01006641,Good health,309,39,4,35,52,43,9,25,31,35,10,7,3,65
S01006641,Fair health,74,1,0,1,13,5,3,7,9,14,11,8,3,11
S01006641,Bad health,30,0,0,0,3,4,3,5,2,8,3,3,0,2
S01006641,Very bad health,3,0,0,0,1,0,0,0,1,1,0,0,0,0
S01006642,All people aged 16 to 74,1306,71,3,68,123,68,20,50,73,53,17,11,6,831
S01006642,Very good health,802,52,3,49,62,36,8,21,36,14,9,6,3,564
S01006642,Good health,394,16,0,16,48,21,9,16,25,23,3,1,2,233
S01006642,Fair health,88,3,0,3,9,10,0,10,12,9,4,3,1,31
S01006642,Bad health,19,0,0,0,4,1,2,3,0,6,1,1,0,2
S01006642,Very bad health,3,0,0,0,0,0,1,0,0,1,0,0,0,1
S01006643,All people aged 16 to 74,701,74,7,67,113,60,18,31,56,39,14,7,7,296
S01006643,Very good health,450,46,4,42,70,42,10,17,29,22,8,4,4,206
S01006643,Good health,200,25,2,23,34,13,7,10,20,10,2,1,1,79
S01006643,Fair health,37,2,1,1,8,3,1,2,3,5,2,1,1,11
S01006643,Bad health,10,1,0,1,0,2,0,0,4,1,2,1,1,0
S01006643,Very bad health,4,0,0,0,1,0,0,2,0,1,0,0,0,0
S01006644,All people aged 16 to 74,893,94,6,88,125,83,20,59,92,82,20,15,5,318
S01006644,Very good health,524,60,3,57,76,47,11,17,42,27,6,5,1,238
S01006644,Good health,257,31,3,28,37,25,5,28,28,22,8,5,3,73
S01006644,Fair health,73,2,0,2,9,6,2,9,13,21,5,4,1,6
S01006644,Bad health,29,1,0,1,2,4,2,3,8,7,1,1,0,1
S01006644,Very bad health,10,0,0,0,1,1,0,2,1,5,0,0,0,0
S01006645,All people aged 16 to 74,547,35,4,31,82,51,16,53,103,104,29,17,12,74
S01006645,Very good health,224,22,4,18,37,21,8,17,39,22,14,11,3,44
S01006645,Good health,204,10,0,10,35,20,3,22,37,46,5,2,3,26
S01006645,Fair health,84,2,0,2,9,6,3,9,18,27,6,1,5,4
S01006645,Bad health,25,0,0,0,1,4,0,4,7,6,3,2,1,0
S01006645,Very bad health,10,1,0,1,0,0,2,1,2,3,1,1,0,0
S01006646,All people aged 16 to 74,943,44,2,42,91,39,7,36,61,32,8,5,3,625
S01006646,Very good health,571,32,2,30,57,17,3,19,37,10,4,3,1,392
S01006646,Good health,294,7,0,7,29,19,3,13,13,11,2,0,2,197
S01006646,Fair health,56,3,0,3,3,2,0,4,10,5,2,2,0,27
S01006646,Bad health,15,1,0,1,2,0,1,0,0,3,0,0,0,8
S01006646,Very bad health,7,1,0,1,0,1,0,0,1,3,0,0,0,1
S01006647,All people aged 16 to 74,529,32,2,30,88,59,17,46,86,81,24,15,9,96
S01006647,Very good health,244,20,2,18,45,28,9,17,34,21,9,5,4,61
S01006647,Good health,202,12,0,12,28,19,6,20,35,43,7,3,4,32
S01006647,Fair health,60,0,0,0,12,9,1,6,13,13,3,2,1,3
S01006647,Bad health,20,0,0,0,3,1,1,3,4,3,5,5,0,0
S01006647,Very bad health,3,0,0,0,0,2,0,0,0,1,0,0,0,0
S01006648,All people aged 16 to 74,1719,85,6,79,165,93,30,100,128,107,27,10,17,984
S01006648,Very good health,1030,56,3,53,87,53,19,43,57,37,5,2,3,673
S01006648,Good health,544,27,3,24,60,28,9,44,51,41,12,2,10,272
S01006648,Fair health,112,0,0,0,14,11,1,7,14,21,8,4,4,36
S01006648,Bad health,28,2,0,2,2,1,1,6,6,7,1,1,0,2
S01006648,Very bad health,5,0,0,0,2,0,0,0,0,1,1,1,0,1
S01006649,All people aged 16 to 74,881,101,2,99,133,106,19,61,115,106,33,20,13,207
S01006649,Very good health,502,68,1,67,81,62,6,35,63,37,12,6,6,138
S01006649,Good health,261,27,1,26,40,29,9,17,32,39,8,7,1,60
S01006649,Fair health,85,4,0,4,8,8,3,8,16,19,11,5,6,8
S01006649,Bad health,29,2,0,2,3,7,1,1,3,9,2,2,0,1
S01006649,Very bad health,4,0,0,0,1,0,0,0,1,2,0,0,0,0
S01006650,All people aged 16 to 74,793,58,6,52,138,59,28,54,100,73,20,15,5,263
S01006650,Very good health,453,34,2,32,81,31,15,24,46,36,10,8,2,176
S01006650,Good health,258,22,4,18,44,23,11,18,39,22,4,2,2,75
S01006650,Fair health,63,2,0,2,12,4,1,8,13,9,4,4,0,10
S01006650,Bad health,14,0,0,0,0,1,1,3,1,5,2,1,1,1
S01006650,Very bad health,5,0,0,0,1,0,0,1,1,1,0,0,0,1
S01006651,All people aged 16 to 74,564,47,0,47,74,52,9,53,65,52,20,10,10,192
S01006651,Very good health,289,26,0,26,37,25,2,26,23,18,6,5,1,126
S01006651,Good health,200,15,0,15,30,18,1,20,30,20,8,3,5,58
S01006651,Fair health,58,3,0,3,6,8,5,4,10,10,5,1,4,7
S01006651,Bad health,12,1,0,1,1,1,1,3,0,3,1,1,0,1
S01006651,Very bad health,5,2,0,2,0,0,0,0,2,1,0,0,0,0
S01006652,All people aged 16 to 74,505,60,2,58,95,42,19,39,36,35,17,9,8,162
S01006652,Very good health,310,43,0,43,59,26,16,19,20,11,5,1,4,111
S01006652,Good health,156,14,2,12,28,12,3,15,11,19,7,4,3,47
S01006652,Fair health,30,2,0,2,5,4,0,4,4,3,4,3,1,4
S01006652,Bad health,9,1,0,1,3,0,0,1,1,2,1,1,0,0
S01006652,Very bad health,0,0,0,0,0,0,0,0,0,0,0,0,0,0
S01006653,All people aged 16 to 74,500,96,5,91,114,55,16,30,40,23,5,4,1,121
S01006653,Very good health,297,66,4,62,64,32,5,14,18,9,2,2,0,87
S01006653,Good health,166,25,1,24,41,15,7,13,16,12,3,2,1,34
S01006653,Fair health,25,5,0,5,5,5,3,2,5,0,0,0,0,0
S01006653,Bad health,11,0,0,0,4,3,0,1,1,2,0,0,0,0
S01006653,Very bad health,1,0,0,0,0,0,1,0,0,0,0,0,0,0
S01006654,All people aged 16 to 74,728,61,4,57,107,94,23,64,112,128,40,23,17,99
S01006654,Very good health,322,43,2,41,47,40,11,22,40,39,6,2,4,74
S01006654,Good health,246,15,1,14,36,29,9,23,39,53,22,16,6,20
S01006654,Fair health,113,2,1,1,17,17,1,17,26,19,9,3,6,5
S01006654,Bad health,35,0,0,0,4,7,2,2,5,13,2,2,0,0
S01006654,Very bad health,12,1,0,1,3,1,0,0,2,4,1,0,1,0
S01006655,All people aged 16 to 74,620,117,14,103,125,63,21,37,57,51,50,46,4,99
S01006655,Very good health,352,87,12,75,86,34,13,16,20,12,8,6,2,76
S01006655,Good health,179,25,2,23,28,22,6,13,25,21,18,17,1,21
S01006655,Fair health,60,4,0,4,8,6,1,4,9,10,17,17,0,1
S01006655,Bad health,21,0,0,0,1,1,1,4,3,6,4,3,1,1
S01006655,Very bad health,8,1,0,1,2,0,0,0,0,2,3,3,0,0
S01006656,All people aged 16 to 74,834,116,3,113,165,90,25,62,94,73,33,18,15,176
S01006656,Very good health,477,83,1,82,109,45,12,27,47,24,13,8,5,117
S01006656,Good health,266,26,2,24,41,32,10,28,33,31,11,5,6,54
S01006656,Fair health,64,4,0,4,13,11,0,4,10,12,6,3,3,4
S01006656,Bad health,19,1,0,1,2,2,2,3,2,3,3,2,1,1
S01006656,Very bad health,8,2,0,2,0,0,1,0,2,3,0,0,0,0
S01006657,All people aged 16 to 74,474,54,5,49,72,59,8,30,64,52,6,1,5,129
S01006657,Very good health,291,41,2,39,43,34,4,12,32,23,2,0,2,100
S01006657,Good health,135,11,2,9,23,15,4,12,21,21,2,0,2,26
S01006657,Fair health,33,2,1,1,5,6,0,6,7,3,1,0,1,3
S01006657,Bad health,12,0,0,0,1,2,0,0,4,4,1,1,0,0
S01006657,Very bad health,3,0,0,0,0,2,0,0,0,1,0,0,0,0
S01006658,All people aged 16 to 74,854,59,1,58,95,57,27,85,105,99,40,25,15,287
S01006658,Very good health,454,38,1,37,47,32,12,33,42,41,18,10,8,191
S01006658,Good health,287,18,0,18,34,17,11,36,47,33,14,8,6,77
S01006658,Fair health,83,2,0,2,11,5,3,10,12,16,6,5,1,18
S01006658,Bad health,24,1,0,1,3,3,0,4,3,8,1,1,0,1
S01006658,Very bad health,6,0,0,0,0,0,1,2,1,1,1,1,0,0
S01006659,All people aged 16 to 74,566,67,6,61,83,43,14,31,43,26,8,5,3,251
S01006659,Very good health,367,53,5,48,52,24,7,13,22,7,3,2,1,186
S01006659,Good health,162,13,1,12,26,14,3,14,16,13,5,3,2,58
S01006659,Fair health,30,1,0,1,3,3,4,3,5,4,0,0,0,7
S01006659,Bad health,5,0,0,0,1,2,0,1,0,1,0,0,0,0
S01006659,Very bad health,2,0,0,0,1,0,0,0,0,1,0,0,0,0
S01006660,All people aged 16 to 74,422,26,1,25,42,28,15,39,54,54,17,13,4,147
S01006660,Very good health,215,13,0,13,21,16,6,16,23,19,3,2,1,98
S01006660,Good health,153,8,1,7,18,11,6,12,24,29,6,5,1,39
S01006660,Fair health,42,4,0,4,3,0,2,7,7,6,4,2,2,9
S01006660,Bad health,8,1,0,1,0,1,1,2,0,0,2,2,0,1
S01006660,Very bad health,4,0,0,0,0,0,0,2,0,0,2,2,0,0
S01006661,All people aged 16 to 74,567,66,7,59,86,58,15,37,47,34,5,2,3,219
S01006661,Very good health,357,44,2,42,50,35,6,17,24,17,2,2,0,162
S01006661,Good health,158,15,2,13,26,16,6,18,15,11,1,0,1,50
S01006661,Fair health,38,6,3,3,6,5,1,1,6,4,2,0,2,7
S01006661,Bad health,12,1,0,1,3,2,2,1,1,2,0,0,0,0
S01006661,Very bad health,2,0,0,0,1,0,0,0,1,0,0,0,0,0
S01006662,All people aged 16 to 74,732,17,2,15,61,37,22,47,64,60,26,17,9,398
S01006662,Very good health,415,9,1,8,35,13,7,18,24,19,8,6,2,282
S01006662,Good health,221,6,1,5,18,11,10,14,27,24,11,6,5,100
S01006662,Fair health,68,2,0,2,7,9,4,10,7,10,4,3,1,15
S01006662,Bad health,23,0,0,0,1,4,1,3,4,6,3,2,1,1
S01006662,Very bad health,5,0,0,0,0,0,0,2,2,1,0,0,0,0
S01006663,All people aged 16 to 74,512,50,3,47,58,36,15,19,23,23,13,10,3,275
S01006663,Very good health,338,35,2,33,36,17,10,9,11,11,3,3,0,206
S01006663,Good health,140,10,1,9,16,14,4,7,10,8,8,6,2,63
S01006663,Fair health,31,5,0,5,6,5,0,3,2,3,2,1,1,5
S01006663,Bad health,2,0,0,0,0,0,1,0,0,0,0,0,0,1
S01006663,Very bad health,1,0,0,0,0,0,0,0,0,1,0,0,0,0
S01006664,All people aged 16 to 74,458,47,4,43,60,17,7,29,45,24,13,8,5,216
S01006664,Very good health,279,28,2,26,32,9,3,16,21,13,2,0,2,155
S01006664,Good health,142,18,2,16,22,8,3,7,15,7,9,6,3,53
S01006664,Fair health,28,0,0,0,6,0,1,4,5,3,2,2,0,7
S01006664,Bad health,6,1,0,1,0,0,0,1,2,1,0,0,0,1
S01006664,Very bad health,3,0,0,0,0,0,0,1,2,0,0,0,0,0
S01006665,All people aged 16 to 74,655,44,3,41,72,46,17,28,36,34,13,11,2,365
S01006665,Very good health,383,27,1,26,43,22,9,10,13,6,6,5,1,247
S01006665,Good health,199,17,2,15,21,19,3,12,13,12,3,3,0,99
S01006665,Fair health,63,0,0,0,7,5,5,5,9,12,3,2,1,17
S01006665,Bad health,6,0,0,0,0,0,0,1,1,2,1,1,0,1
S01006665,Very bad health,4,0,0,0,1,0,0,0,0,2,0,0,0,1
S01006666,All people aged 16 to 74,651,22,2,20,63,51,30,76,129,162,56,35,21,62
S01006666,Very good health,218,9,0,9,26,22,9,22,42,31,11,7,4,46
S01006666,Good health,248,8,0,8,22,12,16,32,61,62,24,12,12,11
S01006666,Fair health,124,3,2,1,11,11,3,15,15,46,15,10,5,5
S01006666,Bad health,48,2,0,2,4,6,1,6,8,18,3,3,0,0
S01006666,Very bad health,13,0,0,0,0,0,1,1,3,5,3,3,0,0
S01006667,All people aged 16 to 74,613,21,3,18,68,43,22,70,101,141,57,35,22,90
S01006667,Very good health,230,12,1,11,24,11,7,16,39,47,14,6,8,60
S01006667,Good health,235,5,0,5,29,22,11,36,36,49,20,12,8,27
S01006667,Fair health,95,3,2,1,10,10,4,9,17,25,15,10,5,2
S01006667,Bad health,40,1,0,1,2,0,0,6,9,15,6,5,1,1
S01006667,Very bad health,13,0,0,0,3,0,0,3,0,5,2,2,0,0
S01006668,All people aged 16 to 74,831,73,4,69,113,61,12,38,67,26,12,7,5,429
S01006668,Very good health,552,58,4,54,69,34,4,14,35,9,5,3,2,324
S01006668,Good health,226,14,0,14,33,17,6,18,27,8,3,2,1,100
S01006668,Fair health,40,1,0,1,8,7,2,5,4,6,2,0,2,5
S01006668,Bad health,11,0,0,0,3,2,0,1,1,3,1,1,0,0
S01006668,Very bad health,2,0,0,0,0,1,0,0,0,0,1,1,0,0
S01006669,All people aged 16 to 74,1101,78,3,75,70,47,28,60,90,110,23,16,7,595
S01006669,Very good health,606,47,1,46,34,25,4,18,26,25,7,4,3,420
S01006669,Good health,312,21,1,20,15,14,10,17,38,27,10,6,4,160
S01006669,Fair health,114,10,1,9,10,2,8,14,16,38,4,4,0,12
S01006669,Bad health,56,0,0,0,8,5,6,9,10,15,2,2,0,1
S01006669,Very bad health,13,0,0,0,3,1,0,2,0,5,0,0,0,2
S01006670,All people aged 16 to 74,839,35,5,30,94,68,21,29,62,60,10,6,4,460
S01006670,Very good health,482,22,3,19,52,35,6,9,21,22,4,3,1,311
S01006670,Good health,271,11,2,9,33,21,9,14,29,21,3,1,2,130
S01006670,Fair health,62,2,0,2,5,10,5,4,8,11,1,1,0,16
S01006670,Bad health,22,0,0,0,4,2,1,2,3,5,2,1,1,3
S01006670,Very bad health,2,0,0,0,0,0,0,0,1,1,0,0,0,0
S01006671,All people aged 16 to 74,2327,53,11,42,58,39,13,29,46,32,23,17,6,2034
S01006671,Very good health,1554,38,9,29,32,21,6,14,19,12,9,7,2,1403
S01006671,Good health,659,7,1,6,17,10,6,11,22,11,10,6,4,565
S01006671,Fair health,90,8,1,7,7,6,1,2,3,4,3,3,0,56
S01006671,Bad health,20,0,0,0,2,1,0,2,2,3,1,1,0,9
S01006671,Very bad health,4,0,0,0,0,1,0,0,0,2,0,0,0,1
S01006672,All people aged 16 to 74,648,40,1,39,70,48,18,42,95,110,33,23,10,192
S01006672,Very good health,340,26,0,26,39,24,7,22,43,42,10,6,4,127
S01006672,Good health,203,11,1,10,21,17,9,12,31,43,9,8,1,50
S01006672,Fair health,70,1,0,1,8,6,0,6,16,15,8,3,5,10
S01006672,Bad health,31,2,0,2,2,1,2,2,4,9,4,4,0,5
S01006672,Very bad health,4,0,0,0,0,0,0,0,1,1,2,2,0,0
S01006673,All people aged 16 to 74,736,50,3,47,73,54,38,57,90,91,23,9,14,260
S01006673,Very good health,409,32,0,32,42,24,17,24,33,35,7,3,4,195
S01006673,Good health,228,12,2,10,23,19,14,22,43,30,10,4,6,55
S01006673,Fair health,57,2,1,1,4,7,6,4,7,13,6,2,4,8
S01006673,Bad health,34,3,0,3,4,4,0,5,6,10,0,0,0,2
S01006673,Very bad health,8,1,0,1,0,0,1,2,1,3,0,0,0,0
S01006674,All people aged 16 to 74,662,35,7,28,62,70,33,78,121,157,48,25,23,58
S01006674,Very good health,215,9,2,7,21,28,11,25,36,41,13,7,6,31
S01006674,Good health,277,19,4,15,28,22,15,35,44,70,21,10,11,23
S01006674,Fair health,119,4,0,4,9,13,5,10,28,33,13,7,6,4
S01006674,Bad health,43,1,0,1,4,7,2,6,11,12,0,0,0,0
S01006674,Very bad health,8,2,1,1,0,0,0,2,2,1,1,1,0,0
S01006675,All people aged 16 to 74,526,12,1,11,45,33,17,55,108,145,41,22,19,70
S01006675,Very good health,219,9,0,9,19,13,13,16,39,51,12,9,3,47
S01006675,Good health,187,3,1,2,18,14,2,21,38,57,14,6,8,20
S01006675,Fair health,80,0,0,0,7,2,2,13,19,27,8,2,6,2
S01006675,Bad health,35,0,0,0,1,3,0,5,10,10,6,5,1,0
S01006675,Very bad health,5,0,0,0,0,1,0,0,2,0,1,0,1,1
S01006676,All people aged 16 to 74,569,33,1,32,51,41,24,49,116,155,32,20,12,68
S01006676,Very good health,210,18,1,17,22,10,8,16,33,42,6,5,1,55
S01006676,Good health,228,15,0,15,17,19,14,23,51,65,13,7,6,11
S01006676,Fair health,80,0,0,0,8,5,1,8,20,27,9,5,4,2
S01006676,Bad health,35,0,0,0,3,6,1,1,7,13,4,3,1,0
S01006676,Very bad health,16,0,0,0,1,1,0,1,5,8,0,0,0,0
S01006677,All people aged 16 to 74,597,17,2,15,69,51,23,61,108,125,33,13,20,110
S01006677,Very good health,265,9,2,7,37,21,10,26,37,39,5,2,3,81
S01006677,Good health,216,8,0,8,25,18,9,23,44,46,18,9,9,25
S01006677,Fair health,75,0,0,0,6,10,3,4,15,26,8,2,6,3
S01006677,Bad health,32,0,0,0,0,2,1,6,10,11,2,0,2,0
S01006677,Very bad health,9,0,0,0,1,0,0,2,2,3,0,0,0,1
S01006678,All people aged 16 to 74,893,18,3,15,92,72,28,92,180,249,58,35,23,104
S01006678,Very good health,364,10,1,9,45,29,10,37,63,88,18,12,6,64
S01006678,Good health,334,7,2,5,34,28,9,31,74,99,19,10,9,33
S01006678,Fair health,134,1,0,1,9,12,6,18,29,35,17,11,6,7
S01006678,Bad health,51,0,0,0,3,3,1,6,11,23,4,2,2,0
S01006678,Very bad health,10,0,0,0,1,0,2,0,3,4,0,0,0,0
S01006679,All people aged 16 to 74,548,37,4,33,126,84,23,59,94,75,5,1,4,45
S01006679,Very good health,258,21,3,18,60,38,9,30,40,26,2,0,2,32
S01006679,Good health,191,12,1,11,52,30,8,20,35,22,0,0,0,12
S01006679,Fair health,68,3,0,3,10,11,6,8,10,18,1,0,1,1
S01006679,Bad health,28,1,0,1,3,4,0,1,8,9,2,1,1,0
S01006679,Very bad health,3,0,0,0,1,1,0,0,1,0,0,0,0,0
S01006680,All people aged 16 to 74,630,12,2,10,54,40,26,79,129,199,47,25,22,44
S01006680,Very good health,244,7,0,7,27,22,12,31,49,56,11,5,6,29
S01006680,Good health,265,4,2,2,21,14,13,34,50,99,19,11,8,11
S01006680,Fair health,82,1,0,1,4,2,1,7,19,34,11,3,8,3
S01006680,Bad health,35,0,0,0,2,2,0,7,11,9,3,3,0,1
S01006680,Very bad health,4,0,0,0,0,0,0,0,0,1,3,3,0,0
S01006681,All people aged 16 to 74,588,35,4,31,124,71,19,84,95,98,21,10,11,41
S01006681,Very good health,254,20,2,18,69,34,11,30,29,28,7,3,4,26
S01006681,Good health,218,14,2,12,43,28,5,35,37,37,7,1,6,12
S01006681,Fair health,79,1,0,1,9,7,3,12,17,21,7,6,1,2
S01006681,Bad health,29,0,0,0,2,2,0,4,9,11,0,0,0,1
S01006681,Very bad health,8,0,0,0,1,0,0,3,3,1,0,0,0,0
S01006682,All people aged 16 to 74,629,22,1,21,72,35,28,61,118,164,48,27,21,81
S01006682,Very good health,242,9,0,9,22,12,7,26,34,59,13,8,5,60
S01006682,Good health,254,10,1,9,35,11,15,23,53,67,20,9,11,20
S01006682,Fair health,87,3,0,3,11,7,3,8,18,26,10,6,4,1
S01006682,Bad health,38,0,0,0,4,4,3,2,10,10,5,4,1,0
S01006682,Very bad health,8,0,0,0,0,1,0,2,3,2,0,0,0,0
S01006683,All people aged 16 to 74,684,34,1,33,83,62,18,61,129,124,34,18,16,139
S01006683,Very good health,357,20,0,20,40,38,9,29,56,46,14,7,7,105
S01006683,Good health,235,10,0,10,37,22,5,27,47,53,10,5,5,24
S01006683,Fair health,56,1,0,1,4,2,4,2,11,16,7,4,3,9
S01006683,Bad health,30,3,1,2,2,0,0,3,12,7,2,1,1,1
S01006683,Very bad health,6,0,0,0,0,0,0,0,3,2,1,1,0,0
S01006684,All people aged 16 to 74,589,33,7,26,60,63,26,68,123,123,24,11,13,69
S01006684,Very good health,249,16,3,13,30,21,8,27,47,47,4,2,2,49
S01006684,Good health,210,12,4,8,19,31,10,22,42,47,8,3,5,19
S01006684,Fair health,83,5,0,5,6,5,6,14,25,13,8,4,4,1
S01006684,Bad health,35,0,0,0,4,5,2,4,8,10,2,1,1,0
S01006684,Very bad health,12,0,0,0,1,1,0,1,1,6,2,1,1,0
S01006685,All people aged 16 to 74,597,28,5,23,110,60,23,60,97,128,38,11,27,53
S01006685,Very good health,236,15,2,13,50,23,7,28,29,37,10,2,8,37
S01006685,Good health,229,12,2,10,41,28,7,21,40,50,17,7,10,13
S01006685,Fair health,88,1,1,0,13,6,5,8,17,28,7,2,5,3
S01006685,Bad health,34,0,0,0,6,0,4,2,7,11,4,0,4,0
S01006685,Very bad health,10,0,0,0,0,3,0,1,4,2,0,0,0,0
S01006686,All people aged 16 to 74,472,32,3,29,75,53,20,47,106,92,12,8,4,35
S01006686,Very good health,200,19,2,17,42,22,8,19,37,26,1,1,0,26
S01006686,Good health,167,8,0,8,23,24,8,17,38,36,5,3,2,8
S01006686,Fair health,65,5,1,4,9,4,1,9,20,13,3,2,1,1
S01006686,Bad health,27,0,0,0,1,2,2,2,6,12,2,1,1,0
S01006686,Very bad health,13,0,0,0,0,1,1,0,5,5,1,1,0,0
S01006687,All people aged 16 to 74,647,42,2,40,111,84,16,80,121,114,24,16,8,55
S01006687,Very good health,264,23,2,21,64,30,6,31,33,34,5,5,0,38
S01006687,Good health,257,17,0,17,30,38,4,34,63,46,12,5,7,13
S01006687,Fair health,75,1,0,1,13,8,4,7,16,18,4,3,1,4
S01006687,Bad health,37,0,0,0,3,6,2,8,6,10,2,2,0,0
S01006687,Very bad health,14,1,0,1,1,2,0,0,3,6,1,1,0,0
S01006688,All people aged 16 to 74,672,58,15,43,139,99,51,56,116,86,14,9,5,53
S01006688,Very good health,277,32,5,27,65,43,22,20,38,22,3,1,2,32
S01006688,Good health,256,21,7,14,52,39,20,20,50,31,3,1,2,20
S01006688,Fair health,90,4,3,1,15,12,6,9,17,23,3,2,1,1
S01006688,Bad health,43,1,0,1,5,5,3,6,8,10,5,5,0,0
S01006688,Very bad health,6,0,0,0,2,0,0,1,3,0,0,0,0,0
S01006689,All people aged 16 to 74,529,104,12,92,133,75,35,20,37,20,7,3,4,98
S01006689,Very good health,351,82,9,73,86,45,22,10,18,5,4,2,2,79
S01006689,Good health,148,20,3,17,40,26,12,9,13,10,2,0,2,16
S01006689,Fair health,23,2,0,2,6,3,1,1,4,2,1,1,0,3
S01006689,Bad health,6,0,0,0,1,1,0,0,1,3,0,0,0,0
S01006689,Very bad health,1,0,0,0,0,0,0,0,1,0,0,0,0,0
S01006690,All people aged 16 to 74,472,64,4,60,104,43,13,39,53,44,13,6,7,99
S01006690,Very good health,272,40,3,37,61,24,7,17,24,14,5,2,3,80
S01006690,Good health,143,21,1,20,36,14,6,14,16,16,4,2,2,16
S01006690,Fair health,37,3,0,3,7,4,0,5,6,8,2,0,2,2
S01006690,Bad health,11,0,0,0,0,0,0,1,4,4,1,1,0,1
S01006690,Very bad health,9,0,0,0,0,1,0,2,3,2,1,1,0,0
S01006691,All people aged 16 to 74,466,83,6,77,86,49,22,22,54,28,6,4,2,116
S01006691,Very good health,284,61,4,57,54,25,8,5,30,11,2,2,0,88
S01006691,Good health,145,16,1,15,23,21,9,15,17,15,3,1,2,26
S01006691,Fair health,31,6,1,5,8,3,3,1,7,1,0,0,0,2
S01006691,Bad health,6,0,0,0,1,0,2,1,0,1,1,1,0,0
S01006691,Very bad health,0,0,0,0,0,0,0,0,0,0,0,0,0,0
S01006692,All people aged 16 to 74,594,88,17,71,138,53,31,49,72,53,10,7,3,100
S01006692,Very good health,320,53,10,43,89,22,10,26,23,16,4,2,2,77
S01006692,Good health,203,30,5,25,40,23,18,19,35,14,4,3,1,20
S01006692,Fair health,53,3,1,2,5,5,3,4,13,16,2,2,0,2
S01006692,Bad health,13,2,1,1,2,2,0,0,1,5,0,0,0,1
S01006692,Very bad health,5,0,0,0,2,1,0,0,0,2,0,0,0,0
S01006693,All people aged 16 to 74,780,87,12,75,135,104,34,84,83,113,32,22,10,108
S01006693,Very good health,394,56,7,49,65,65,16,31,38,39,14,9,5,70
S01006693,Good health,287,23,3,20,57,32,11,41,30,55,11,8,3,27
S01006693,Fair health,66,7,2,5,9,7,4,10,10,12,4,3,1,3
S01006693,Bad health,26,1,0,1,3,0,1,2,4,4,3,2,1,8
S01006693,Very bad health,7,0,0,0,1,0,2,0,1,3,0,0,0,0
S01006694,All people aged 16 to 74,555,12,4,8,74,76,29,71,125,130,13,8,5,25
S01006694,Very good health,215,7,2,5,30,28,11,29,52,39,3,1,2,16
S01006694,Good health,198,3,2,1,27,34,11,28,38,45,3,2,1,9
S01006694,Fair health,88,1,0,1,12,11,4,8,21,28,3,2,1,0
S01006694,Bad health,41,1,0,1,4,2,1,6,11,13,3,2,1,0
S01006694,Very bad health,13,0,0,0,1,1,2,0,3,5,1,1,0,0
S01006695,All people aged 16 to 74,535,46,12,34,80,63,36,69,88,107,15,12,3,31
S01006695,Very good health,211,24,3,21,36,22,13,32,28,36,1,1,0,19
S01006695,Good health,217,17,6,11,28,28,15,26,40,46,6,5,1,11
S01006695,Fair health,75,4,2,2,9,11,6,6,14,18,6,4,2,1
S01006695,Bad health,26,1,1,0,6,2,2,3,4,6,2,2,0,0
S01006695,Very bad health,6,0,0,0,1,0,0,2,2,1,0,0,0,0
S01006696,All people aged 16 to 74,608,34,5,29,77,81,19,52,110,117,28,17,11,90
S01006696,Very good health,278,24,4,20,35,38,9,20,42,37,10,7,3,63
S01006696,Good health,217,7,0,7,28,31,4,23,43,48,6,3,3,27
S01006696,Fair health,80,2,0,2,6,10,5,7,19,23,8,3,5,0
S01006696,Bad health,27,1,1,0,5,2,1,2,4,8,4,4,0,0
S01006696,Very bad health,6,0,0,0,3,0,0,0,2,1,0,0,0,0
S01006697,All people aged 16 to 74,691,33,3,30,103,93,36,76,129,137,15,9,6,69
S01006697,Very good health,296,10,0,10,43,33,16,32,60,45,7,3,4,50
S01006697,Good health,282,18,2,16,39,43,16,32,52,61,3,2,1,18
S01006697,Fair health,77,2,1,1,18,15,4,8,12,16,2,1,1,0
S01006697,Bad health,26,2,0,2,2,2,0,4,3,10,3,3,0,0
S01006697,Very bad health,10,1,0,1,1,0,0,0,2,5,0,0,0,1
S01006698,All people aged 16 to 74,511,23,0,23,83,58,15,47,89,119,17,11,6,60
S01006698,Very good health,215,11,0,11,44,30,3,16,37,37,3,2,1,34
S01006698,Good health,182,11,0,11,28,15,7,18,28,48,6,3,3,21
S01006698,Fair health,76,1,0,1,8,7,3,9,14,24,6,4,2,4
S01006698,Bad health,26,0,0,0,2,5,1,4,5,8,1,1,0,0
S01006698,Very bad health,12,0,0,0,1,1,1,0,5,2,1,1,0,1
S01006699,All people aged 16 to 74,377,38,7,31,69,48,14,24,54,69,6,3,3,55
S01006699,Very good health,208,23,4,19,40,23,4,8,24,39,3,2,1,44
S01006699,Good health,131,11,1,10,25,20,9,12,21,21,1,0,1,11
S01006699,Fair health,30,2,1,1,4,5,1,2,6,8,2,1,1,0
S01006699,Bad health,5,0,0,0,0,0,0,2,3,0,0,0,0,0
S01006699,Very bad health,3,2,1,1,0,0,0,0,0,1,0,0,0,0
S01006700,All people aged 16 to 74,658,66,7,59,130,86,37,50,90,101,18,11,7,80
S01006700,Very good health,309,44,4,40,57,37,15,25,30,36,4,2,2,61
S01006700,Good health,242,13,2,11,58,39,15,17,42,33,8,4,4,17
S01006700,Fair health,76,8,1,7,11,9,4,5,12,22,3,2,1,2
S01006700,Bad health,23,1,0,1,2,1,1,3,6,7,2,2,0,0
S01006700,Very bad health,8,0,0,0,2,0,2,0,0,3,1,1,0,0
S01006701,All people aged 16 to 74,507,12,2,10,65,53,18,70,127,109,33,19,14,20
S01006701,Very good health,202,7,0,7,27,19,7,34,48,35,12,6,6,13
S01006701,Good health,198,3,1,2,32,26,9,24,48,41,12,5,7,3
S01006701,Fair health,65,1,1,0,4,7,1,5,20,20,3,2,1,4
S01006701,Bad health,26,1,0,1,1,1,1,4,8,7,3,3,0,0
S01006701,Very bad health,16,0,0,0,1,0,0,3,3,6,3,3,0,0
S01006702,All people aged 16 to 74,563,16,2,14,63,74,38,60,138,131,22,8,14,21
S01006702,Very good health,235,10,1,9,32,35,16,25,54,34,12,6,6,17
S01006702,Good health,217,5,1,4,24,29,9,24,53,64,5,1,4,4
S01006702,Fair health,88,1,0,1,6,9,10,10,18,29,5,1,4,0
S01006702,Bad health,17,0,0,0,1,1,1,1,10,3,0,0,0,0
S01006702,Very bad health,6,0,0,0,0,0,2,0,3,1,0,0,0,0
S01006703,All people aged 16 to 74,468,17,4,13,65,56,23,48,107,106,22,15,7,24
S01006703,Very good health,176,6,2,4,26,22,7,16,32,43,7,4,3,17
S01006703,Good health,192,9,2,7,28,25,11,21,45,36,10,7,3,7
S01006703,Fair health,66,1,0,1,6,5,4,10,19,17,4,3,1,0
S01006703,Bad health,24,1,0,1,4,3,1,0,6,8,1,1,0,0
S01006703,Very bad health,10,0,0,0,1,1,0,1,5,2,0,0,0,0
S01006704,All people aged 16 to 74,446,6,4,2,58,57,14,48,92,110,35,20,15,26
S01006704,Very good health,169,2,2,0,31,22,3,21,29,37,9,2,7,15
S01006704,Good health,159,4,2,2,21,25,7,16,34,32,12,7,5,8
S01006704,Fair health,78,0,0,0,5,8,3,7,21,25,7,4,3,2
S01006704,Bad health,30,0,0,0,0,2,1,3,7,12,4,4,0,1
S01006704,Very bad health,10,0,0,0,1,0,0,1,1,4,3,3,0,0
S01006705,All people aged 16 to 74,546,16,5,11,62,65,35,63,126,134,15,9,6,30
S01006705,Very good health,197,9,2,7,28,25,14,23,36,41,2,1,1,19
S01006705,Good health,225,6,2,4,23,34,13,25,56,52,7,2,5,9
S01006705,Fair health,83,1,1,0,8,5,5,11,20,27,4,4,0,2
S01006705,Bad health,27,0,0,0,1,1,2,3,9,10,1,1,0,0
S01006705,Very bad health,14,0,0,0,2,0,1,1,5,4,1,1,0,0
S01006706,All people aged 16 to 74,451,17,4,13,77,61,28,51,89,78,23,18,5,27
S01006706,Very good health,204,10,1,9,43,33,9,17,36,23,11,9,2,22
S01006706,Good health,170,5,2,3,24,18,10,22,39,38,10,7,3,4
S01006706,Fair health,48,2,1,1,5,10,6,6,10,8,1,1,0,0
S01006706,Bad health,23,0,0,0,3,0,1,6,3,8,1,1,0,1
S01006706,Very bad health,6,0,0,0,2,0,2,0,1,1,0,0,0,0
S01006707,All people aged 16 to 74,506,20,2,18,65,56,21,55,110,105,36,20,16,38
S01006707,Very good health,204,14,2,12,35,20,9,20,36,31,14,6,8,25
S01006707,Good health,198,6,0,6,23,24,6,25,51,44,8,6,2,11
S01006707,Fair health,66,0,0,0,5,9,3,8,12,18,9,6,3,2
S01006707,Bad health,33,0,0,0,2,3,3,2,8,10,5,2,3,0
S01006707,Very bad health,5,0,0,0,0,0,0,0,3,2,0,0,0,0
S01006708,All people aged 16 to 74,558,25,4,21,94,82,27,68,119,97,8,7,1,38
S01006708,Very good health,240,15,0,15,46,36,12,24,46,28,2,2,0,31
S01006708,Good health,203,10,4,6,33,34,9,26,42,38,5,4,1,6
S01006708,Fair health,85,0,0,0,9,11,3,15,25,20,1,1,0,1
S01006708,Bad health,23,0,0,0,5,1,2,2,6,7,0,0,0,0
S01006708,Very bad health,7,0,0,0,1,0,1,1,0,4,0,0,0,0
S01006709,All people aged 16 to 74,619,24,7,17,72,85,44,64,134,130,25,16,9,41
S01006709,Very good health,266,11,4,7,36,46,9,30,40,53,14,11,3,27
S01006709,Good health,234,10,1,9,24,27,18,22,65,46,9,3,6,13
S01006709,Fair health,76,1,1,0,7,8,15,7,18,18,1,1,0,1
S01006709,Bad health,33,1,0,1,5,3,0,3,9,11,1,1,0,0
S01006709,Very bad health,10,1,1,0,0,1,2,2,2,2,0,0,0,0
S01006710,All people aged 16 to 74,640,16,2,14,116,109,35,84,120,121,20,13,7,19
S01006710,Very good health,248,9,2,7,53,40,14,40,36,35,5,3,2,16
S01006710,Good health,262,3,0,3,44,46,10,29,61,57,9,5,4,3
S01006710,Fair health,82,3,0,3,9,15,7,11,14,19,4,3,1,0
S01006710,Bad health,37,1,0,1,7,7,3,3,7,7,2,2,0,0
S01006710,Very bad health,11,0,0,0,3,1,1,1,2,3,0,0,0,0
S01006711,All people aged 16 to 74,699,20,4,16,124,109,50,71,124,146,27,15,12,28
S01006711,Very good health,276,7,2,5,64,50,18,23,45,40,8,4,4,21
S01006711,Good health,256,11,2,9,41,38,25,32,42,51,10,7,3,6
S01006711,Fair health,117,1,0,1,13,18,6,11,30,30,7,3,4,1
S01006711,Bad health,38,1,0,1,4,3,1,2,5,22,0,0,0,0
S01006711,Very bad health,12,0,0,0,2,0,0,3,2,3,2,1,1,0
S01006712,All people aged 16 to 74,381,19,9,10,65,60,14,47,64,84,15,8,7,13
S01006712,Very good health,151,14,8,6,27,30,3,19,24,21,3,1,2,10
S01006712,Good health,148,4,1,3,26,25,7,16,22,38,7,2,5,3
S01006712,Fair health,52,1,0,1,9,3,3,8,7,18,3,3,0,0
S01006712,Bad health,25,0,0,0,1,2,1,2,10,7,2,2,0,0
S01006712,Very bad health,5,0,0,0,2,0,0,2,1,0,0,0,0,0
S01006713,All people aged 16 to 74,679,22,6,16,82,100,32,71,131,174,30,26,4,37
S01006713,Very good health,284,13,5,8,44,50,8,33,52,52,6,4,2,26
S01006713,Good health,229,9,1,8,29,28,16,20,51,58,8,6,2,10
S01006713,Fair health,107,0,0,0,5,16,6,12,22,35,10,10,0,1
S01006713,Bad health,45,0,0,0,3,5,0,4,5,23,5,5,0,0
S01006713,Very bad health,14,0,0,0,1,1,2,2,1,6,1,1,0,0
S01006714,All people aged 16 to 74,513,21,4,17,67,75,20,57,103,110,29,24,5,31
S01006714,Very good health,223,13,3,10,37,35,7,22,45,38,4,2,2,22
S01006714,Good health,206,5,0,5,25,28,10,22,43,49,15,13,2,9
S01006714,Fair health,54,3,1,2,5,6,2,8,10,11,9,8,1,0
S01006714,Bad health,24,0,0,0,0,5,0,5,4,9,1,1,0,0
S01006714,Very bad health,6,0,0,0,0,1,1,0,1,3,0,0,0,0
S01006715,All people aged 16 to 74,416,15,1,14,43,28,16,39,84,117,25,17,8,49
S01006715,Very good health,170,11,1,10,23,14,4,10,35,35,11,7,4,27
S01006715,Good health,161,4,0,4,14,9,9,16,31,49,10,7,3,19
S01006715,Fair health,66,0,0,0,6,4,2,11,10,26,4,3,1,3
S01006715,Bad health,16,0,0,0,0,0,1,1,7,7,0,0,0,0
S01006715,Very bad health,3,0,0,0,0,1,0,1,1,0,0,0,0,0
S01006716,All people aged 16 to 74,478,19,2,17,66,46,25,57,107,103,20,15,5,35
S01006716,Very good health,213,9,1,8,32,23,4,24,50,40,7,6,1,24
S01006716,Good health,153,9,0,9,24,12,15,15,34,32,6,5,1,6
S01006716,Fair health,80,0,0,0,5,8,3,14,17,25,6,4,2,2
S01006716,Bad health,26,1,1,0,3,2,3,4,4,6,0,0,0,3
S01006716,Very bad health,6,0,0,0,2,1,0,0,2,0,1,0,1,0
S01006717,All people aged 16 to 74,705,22,9,13,82,92,30,87,161,160,38,25,13,33
S01006717,Very good health,297,13,4,9,46,44,11,41,56,55,9,6,3,22
S01006717,Good health,255,6,3,3,27,30,13,30,68,57,15,11,4,9
S01006717,Fair health,107,1,1,0,8,12,4,11,26,33,11,6,5,1
S01006717,Bad health,36,2,1,1,1,4,1,5,8,12,2,1,1,1
S01006717,Very bad health,10,0,0,0,0,2,1,0,3,3,1,1,0,0
S01006718,All people aged 16 to 74,471,12,3,9,51,49,26,57,99,113,22,13,9,42
S01006718,Very good health,214,5,0,5,21,23,12,27,40,40,10,5,5,36
S01006718,Good health,175,5,2,3,19,21,9,20,42,47,7,4,3,5
S01006718,Fair health,57,1,1,0,10,4,4,4,11,20,2,1,1,1
S01006718,Bad health,23,1,0,1,1,1,1,5,6,5,3,3,0,0
S01006718,Very bad health,2,0,0,0,0,0,0,1,0,1,0,0,0,0
S01006719,All people aged 16 to 74,691,30,3,27,104,71,40,80,135,157,28,20,8,46
S01006719,Very good health,266,15,1,14,34,32,19,32,44,51,9,6,3,30
S01006719,Good health,257,13,2,11,45,24,14,33,50,55,8,7,1,15
S01006719,Fair health,109,1,0,1,17,9,5,11,31,27,7,4,3,1
S01006719,Bad health,51,1,0,1,8,6,1,3,9,19,4,3,1,0
S01006719,Very bad health,8,0,0,0,0,0,1,1,1,5,0,0,0,0
S01006720,All people aged 16 to 74,446,13,1,12,67,59,18,44,88,115,16,10,6,26
S01006720,Very good health,200,10,1,9,40,31,6,21,37,32,6,5,1,17
S01006720,Good health,163,3,0,3,18,19,9,19,35,46,6,3,3,8
S01006720,Fair health,55,0,0,0,6,7,3,2,12,21,3,1,2,1
S01006720,Bad health,26,0,0,0,2,2,0,2,4,15,1,1,0,0
S01006720,Very bad health,2,0,0,0,1,0,0,0,0,1,0,0,0,0
S01006721,All people aged 16 to 74,683,23,3,20,99,68,32,75,130,175,36,23,13,45
S01006721,Very good health,278,10,1,9,50,33,15,34,42,52,9,7,2,33
S01006721,Good health,256,11,2,9,40,21,9,32,56,63,14,8,6,10
S01006721,Fair health,99,0,0,0,5,13,6,6,23,38,7,4,3,1
S01006721,Bad health,39,1,0,1,4,1,1,3,7,16,5,4,1,1
S01006721,Very bad health,11,1,0,1,0,0,1,0,2,6,1,0,1,0
S01006722,All people aged 16 to 74,585,23,4,19,70,61,18,67,135,139,32,21,11,40
S01006722,Very good health,258,16,2,14,32,26,11,31,56,46,13,7,6,27
S01006722,Good health,197,6,2,4,28,27,4,17,50,46,8,5,3,11
S01006722,Fair health,92,0,0,0,8,6,3,13,19,31,10,8,2,2
S01006722,Bad health,27,1,0,1,0,2,0,4,8,11,1,1,0,0
S01006722,Very bad health,11,0,0,0,2,0,0,2,2,5,0,0,0,0
S01006723,All people aged 16 to 74,506,23,4,19,80,59,25,64,85,113,33,27,6,24
S01006723,Very good health,215,17,4,13,41,28,12,24,28,34,11,9,2,20
S01006723,Good health,178,4,0,4,26,22,10,28,35,41,8,5,3,4
S01006723,Fair health,78,1,0,1,11,7,3,10,11,24,11,10,1,0
S01006723,Bad health,25,1,0,1,2,2,0,1,6,10,3,3,0,0
S01006723,Very bad health,10,0,0,0,0,0,0,1,5,4,0,0,0,0
S01006724,All people aged 16 to 74,676,16,4,12,55,59,25,59,142,190,64,45,19,66
S01006724,Very good health,276,9,2,7,22,26,9,28,58,56,21,14,7,47
S01006724,Good health,244,5,2,3,26,24,10,15,47,86,17,10,7,14
S01006724,Fair health,115,2,0,2,4,6,6,11,28,40,15,10,5,3
S01006724,Bad health,30,0,0,0,3,3,0,3,8,5,7,7,0,1
S01006724,Very bad health,11,0,0,0,0,0,0,2,1,3,4,4,0,1
S01006725,All people aged 16 to 74,499,17,5,12,50,52,22,56,122,125,20,14,6,35
S01006725,Very good health,193,11,4,7,21,23,8,20,43,36,7,5,2,24
S01006725,Good health,178,6,1,5,13,15,7,25,56,44,5,2,3,7
S01006725,Fair health,91,0,0,0,12,13,5,10,15,28,4,3,1,4
S01006725,Bad health,26,0,0,0,3,1,2,1,6,11,2,2,0,0
S01006725,Very bad health,11,0,0,0,1,0,0,0,2,6,2,2,0,0
S01006726,All people aged 16 to 74,975,20,1,19,86,72,37,108,181,261,106,60,46,104
S01006726,Very good health,397,10,0,10,34,38,14,35,76,88,36,19,17,66
S01006726,Good health,376,7,0,7,40,24,13,44,76,103,36,22,14,33
S01006726,Fair health,149,3,1,2,8,8,5,24,20,49,28,14,14,4
S01006726,Bad health,42,0,0,0,4,2,4,4,5,19,3,2,1,1
S01006726,Very bad health,11,0,0,0,0,0,1,1,4,2,3,3,0,0
S01006727,All people aged 16 to 74,704,12,2,10,63,61,23,72,144,185,69,52,17,75
S01006727,Very good health,289,6,1,5,31,31,11,24,61,62,16,11,5,47
S01006727,Good health,245,4,1,3,20,25,6,25,46,65,34,23,11,20
S01006727,Fair health,108,2,0,2,9,4,4,14,24,33,13,12,1,5
S01006727,Bad health,48,0,0,0,3,1,2,5,11,20,3,3,0,3
S01006727,Very bad health,14,0,0,0,0,0,0,4,2,5,3,3,0,0
S01006728,All people aged 16 to 74,542,27,6,21,79,65,19,52,115,115,30,18,12,40
S01006728,Very good health,259,18,5,13,36,31,6,24,52,53,8,5,3,31
S01006728,Good health,188,6,0,6,31,26,9,22,45,36,8,3,5,5
S01006728,Fair health,64,3,1,2,7,4,3,4,13,18,8,5,3,4
S01006728,Bad health,26,0,0,0,4,4,1,1,4,6,6,5,1,0
S01006728,Very bad health,5,0,0,0,1,0,0,1,1,2,0,0,0,0
S01006729,All people aged 16 to 74,596,12,3,9,68,54,16,57,131,168,52,36,16,38
S01006729,Very good health,238,6,2,4,36,25,7,21,42,64,16,12,4,21
S01006729,Good health,230,4,1,3,24,20,4,24,63,53,23,16,7,15
S01006729,Fair health,95,1,0,1,6,7,2,8,20,38,12,7,5,1
S01006729,Bad health,18,1,0,1,1,0,2,2,4,7,1,1,0,0
S01006729,Very bad health,15,0,0,0,1,2,1,2,2,6,0,0,0,1
S01006730,All people aged 16 to 74,547,20,4,16,90,79,13,59,119,114,15,10,5,38
S01006730,Very good health,217,13,2,11,37,22,3,23,43,43,7,5,2,26
S01006730,Good health,233,7,2,5,39,38,9,27,54,43,5,2,3,11
S01006730,Fair health,78,0,0,0,14,14,1,6,18,22,2,2,0,1
S01006730,Bad health,16,0,0,0,0,4,0,1,4,6,1,1,0,0
S01006730,Very bad health,3,0,0,0,0,1,0,2,0,0,0,0,0,0
S01006731,All people aged 16 to 74,468,8,1,7,62,61,23,58,86,121,26,17,9,23
S01006731,Very good health,170,3,0,3,26,27,5,29,26,35,4,2,2,15
S01006731,Good health,195,5,1,4,30,26,14,19,34,50,9,7,2,8
S01006731,Fair health,66,0,0,0,4,6,4,8,16,22,6,2,4,0
S01006731,Bad health,30,0,0,0,2,1,0,2,9,10,6,5,1,0
S01006731,Very bad health,7,0,0,0,0,1,0,0,1,4,1,1,0,0
S01006732,All people aged 16 to 74,795,134,29,105,185,92,65,38,67,45,19,15,4,150
S01006732,Very good health,463,75,10,65,115,55,37,19,28,20,9,7,2,105
S01006732,Good health,260,53,15,38,63,29,20,10,23,19,4,3,1,39
S01006732,Fair health,53,4,3,1,4,6,7,5,12,4,6,5,1,5
S01006732,Bad health,15,1,1,0,2,2,1,3,3,2,0,0,0,1
S01006732,Very bad health,4,1,0,1,1,0,0,1,1,0,0,0,0,0
S01006733,All people aged 16 to 74,625,146,23,123,176,108,36,30,51,19,15,11,4,44
S01006733,Very good health,386,99,16,83,115,64,13,18,29,9,6,5,1,33
S01006733,Good health,201,44,6,38,50,37,20,10,15,8,8,5,3,9
S01006733,Fair health,31,3,1,2,9,7,2,2,4,2,0,0,0,2
S01006733,Bad health,5,0,0,0,2,0,0,0,2,0,1,1,0,0
S01006733,Very bad health,2,0,0,0,0,0,1,0,1,0,0,0,0,0
S01006734,All people aged 16 to 74,693,161,26,135,169,110,55,41,48,43,28,23,5,38
S01006734,Very good health,448,114,16,98,111,72,36,25,25,24,7,5,2,34
S01006734,Good health,186,41,9,32,49,33,16,11,15,13,5,2,3,3
S01006734,Fair health,47,4,1,3,9,5,2,5,5,2,14,14,0,1
S01006734,Bad health,10,2,0,2,0,0,1,0,2,4,1,1,0,0
S01006734,Very bad health,2,0,0,0,0,0,0,0,1,0,1,1,0,0
S01006735,All people aged 16 to 74,431,104,22,82,133,67,25,16,28,21,2,1,1,35
S01006735,Very good health,258,70,13,57,77,32,13,10,8,16,1,1,0,31
S01006735,Good health,138,25,6,19,49,27,10,5,16,4,0,0,0,2
S01006735,Fair health,22,6,2,4,6,4,1,0,2,1,1,0,1,1
S01006735,Bad health,10,2,1,1,1,3,1,1,1,0,0,0,0,1
S01006735,Very bad health,3,1,0,1,0,1,0,0,1,0,0,0,0,0
S01006736,All people aged 16 to 74,762,158,27,131,217,117,49,66,60,41,16,7,9,38
S01006736,Very good health,512,111,17,94,146,85,26,42,36,24,10,6,4,32
S01006736,Good health,202,36,6,30,68,26,16,14,20,12,6,1,5,4
S01006736,Fair health,37,7,3,4,3,5,5,9,3,4,0,0,0,1
S01006736,Bad health,6,3,1,2,0,1,0,1,0,1,0,0,0,0
S01006736,Very bad health,5,1,0,1,0,0,2,0,1,0,0,0,0,1
S01006737,All people aged 16 to 74,495,83,24,59,123,71,46,41,60,30,11,10,1,30
S01006737,Very good health,304,56,17,39,77,43,20,28,35,12,6,5,1,27
S01006737,Good health,153,24,6,18,40,22,20,7,21,13,3,3,0,3
S01006737,Fair health,30,3,1,2,6,6,5,4,3,2,1,1,0,0
S01006737,Bad health,7,0,0,0,0,0,1,1,1,3,1,1,0,0
S01006737,Very bad health,1,0,0,0,0,0,0,1,0,0,0,0,0,0
S01006738,All people aged 16 to 74,684,55,7,48,157,126,38,81,100,82,18,9,9,27
S01006738,Very good health,353,31,1,30,95,70,17,42,45,30,8,5,3,15
S01006738,Good health,246,21,5,16,47,41,15,32,43,33,6,1,5,8
S01006738,Fair health,64,1,1,0,14,10,5,6,8,14,3,2,1,3
S01006738,Bad health,15,2,0,2,1,5,1,1,2,2,0,0,0,1
S01006738,Very bad health,6,0,0,0,0,0,0,0,2,3,1,1,0,0
S01006739,All people aged 16 to 74,510,50,6,44,129,85,30,52,66,62,12,2,10,24
S01006739,Very good health,259,34,4,30,69,44,12,21,25,29,5,1,4,20
S01006739,Good health,180,15,2,13,47,33,11,21,23,25,4,0,4,1
S01006739,Fair health,55,1,0,1,11,5,4,5,16,7,3,1,2,3
S01006739,Bad health,13,0,0,0,2,2,3,4,1,1,0,0,0,0
S01006739,Very bad health,3,0,0,0,0,1,0,1,1,0,0,0,0,0
S01006740,All people aged 16 to 74,557,29,6,23,113,61,23,62,111,112,16,10,6,30
S01006740,Very good health,240,15,1,14,58,30,10,22,46,37,7,3,4,15
S01006740,Good health,231,12,4,8,42,25,11,29,49,45,4,3,1,14
S01006740,Fair health,60,2,1,1,9,5,2,8,13,17,3,2,1,1
S01006740,Bad health,21,0,0,0,3,1,0,2,3,11,1,1,0,0
S01006740,Very bad health,5,0,0,0,1,0,0,1,0,2,1,1,0,0
S01006741,All people aged 16 to 74,496,27,6,21,77,78,23,61,109,99,5,3,2,17
S01006741,Very good health,187,11,1,10,34,36,4,23,32,32,2,1,1,13
S01006741,Good health,209,14,5,9,32,32,12,27,45,43,1,0,1,3
S01006741,Fair health,69,0,0,0,9,6,6,5,23,18,1,1,0,1
S01006741,Bad health,16,1,0,1,1,3,0,2,6,3,0,0,0,0
S01006741,Very bad health,15,1,0,1,1,1,1,4,3,3,1,1,0,0
S01006742,All people aged 16 to 74,328,16,2,14,56,47,21,40,73,55,9,5,4,11
S01006742,Very good health,115,8,1,7,26,13,5,12,27,14,3,1,2,7
S01006742,Good health,150,6,1,5,23,23,12,20,33,27,2,0,2,4
S01006742,Fair health,49,1,0,1,6,9,1,7,10,12,3,3,0,0
S01006742,Bad health,11,0,0,0,1,2,3,0,3,1,1,1,0,0
S01006742,Very bad health,3,1,0,1,0,0,0,1,0,1,0,0,0,0
S01006743,All people aged 16 to 74,422,28,4,24,93,80,26,43,65,53,2,1,1,32
S01006743,Very good health,197,17,2,15,44,36,14,19,28,17,0,0,0,22
S01006743,Good health,160,8,1,7,38,33,6,19,25,22,1,0,1,8
S01006743,Fair health,46,3,1,2,8,8,5,4,8,10,0,0,0,0
S01006743,Bad health,15,0,0,0,2,3,0,1,4,3,0,0,0,2
S01006743,Very bad health,4,0,0,0,1,0,1,0,0,1,1,1,0,0
S01006744,All people aged 16 to 74,498,46,12,34,103,71,33,62,96,57,12,8,4,18
S01006744,Very good health,243,29,6,23,54,40,16,27,41,20,6,3,3,10
S01006744,Good health,182,15,5,10,35,22,9,32,39,20,3,2,1,7
S01006744,Fair health,56,2,1,1,14,9,5,2,9,12,2,2,0,1
S01006744,Bad health,15,0,0,0,0,0,3,0,7,4,1,1,0,0
S01006744,Very bad health,2,0,0,0,0,0,0,1,0,1,0,0,0,0
S01006745,All people aged 16 to 74,601,31,4,27,100,74,33,73,129,116,17,14,3,28
S01006745,Very good health,273,16,3,13,54,28,16,36,55,42,5,5,0,21
S01006745,Good health,214,12,1,11,35,37,10,24,41,43,6,3,3,6
S01006745,Fair health,84,2,0,2,8,5,6,10,24,23,5,5,0,1
S01006745,Bad health,23,1,0,1,3,3,0,2,6,7,1,1,0,0
S01006745,Very bad health,7,0,0,0,0,1,1,1,3,1,0,0,0,0
S01006746,All people aged 16 to 74,592,21,4,17,99,94,30,75,123,88,19,14,5,43
S01006746,Very good health,245,15,3,12,48,39,12,24,38,28,7,6,1,34
S01006746,Good health,251,4,0,4,38,45,12,38,59,36,11,7,4,8
S01006746,Fair health,74,2,1,1,9,8,6,10,19,19,0,0,0,1
S01006746,Bad health,17,0,0,0,4,1,0,3,5,3,1,1,0,0
S01006746,Very bad health,5,0,0,0,0,1,0,0,2,2,0,0,0,0
S01006747,All people aged 16 to 74,621,73,10,63,156,104,27,66,92,57,11,8,3,35
S01006747,Very good health,308,41,7,34,90,42,16,33,36,22,3,1,2,25
S01006747,Good health,236,27,2,25,48,48,9,25,41,24,4,4,0,10
S01006747,Fair health,64,3,1,2,16,12,1,7,12,9,4,3,1,0
S01006747,Bad health,6,2,0,2,0,0,0,1,2,1,0,0,0,0
S01006747,Very bad health,7,0,0,0,2,2,1,0,1,1,0,0,0,0
S01006748,All people aged 16 to 74,701,77,20,57,164,113,53,84,102,75,14,13,1,19
S01006748,Very good health,363,40,9,31,93,57,24,44,51,36,2,2,0,16
S01006748,Good health,237,25,7,18,54,42,18,32,34,25,5,5,0,2
S01006748,Fair health,73,10,3,7,12,10,10,6,10,10,4,3,1,1
S01006748,Bad health,20,2,1,1,3,2,0,2,7,2,2,2,0,0
S01006748,Very bad health,8,0,0,0,2,2,1,0,0,2,1,1,0,0
S01006749,All people aged 16 to 74,702,43,8,35,133,108,25,91,157,109,17,11,6,19
S01006749,Very good health,313,23,1,22,70,51,10,46,56,38,4,2,2,15
S01006749,Good health,266,16,5,11,43,46,13,28,68,44,4,2,2,4
S01006749,Fair health,92,4,2,2,13,9,1,12,27,20,6,4,2,0
S01006749,Bad health,20,0,0,0,5,2,1,4,3,3,2,2,0,0
S01006749,Very bad health,11,0,0,0,2,0,0,1,3,4,1,1,0,0
S01006750,All people aged 16 to 74,539,28,6,22,98,62,31,77,92,94,13,10,3,44
S01006750,Very good health,238,12,2,10,46,32,13,34,33,31,3,3,0,34
S01006750,Good health,217,13,4,9,45,20,12,32,44,36,5,3,2,10
S01006750,Fair health,63,2,0,2,5,9,3,8,12,20,4,3,1,0
S01006750,Bad health,13,1,0,1,1,1,2,3,2,3,0,0,0,0
S01006750,Very bad health,8,0,0,0,1,0,1,0,1,4,1,1,0,0
S01006751,All people aged 16 to 74,358,30,11,19,67,42,23,54,67,47,12,11,1,16
S01006751,Very good health,149,16,5,11,32,20,7,18,19,17,5,4,1,15
S01006751,Good health,142,13,6,7,29,12,11,22,34,17,4,4,0,0
S01006751,Fair health,44,0,0,0,4,7,3,8,10,9,2,2,0,1
S01006751,Bad health,18,0,0,0,2,2,2,5,4,2,1,1,0,0
S01006751,Very bad health,5,1,0,1,0,1,0,1,0,2,0,0,0,0
S01006752,All people aged 16 to 74,521,29,4,25,95,75,14,74,104,100,10,5,5,20
S01006752,Very good health,226,19,3,16,38,38,3,36,32,38,6,2,4,16
S01006752,Good health,201,8,1,7,45,26,7,24,47,38,2,1,1,4
S01006752,Fair health,73,2,0,2,8,8,3,10,21,20,1,1,0,0
S01006752,Bad health,14,0,0,0,2,2,0,1,4,4,1,1,0,0
S01006752,Very bad health,7,0,0,0,2,1,1,3,0,0,0,0,0,0
S01006753,All people aged 16 to 74,706,99,24,75,152,112,45,78,89,75,12,8,4,44
S01006753,Very good health,342,57,13,44,78,59,17,35,35,28,1,1,0,32
S01006753,Good health,271,37,11,26,62,36,19,30,41,33,4,2,2,9
S01006753,Fair health,77,5,0,5,9,14,6,11,10,13,6,4,2,3
S01006753,Bad health,11,0,0,0,0,2,3,2,2,1,1,1,0,0
S01006753,Very bad health,5,0,0,0,3,1,0,0,1,0,0,0,0,0
S01006754,All people aged 16 to 74,745,92,18,74,182,132,37,95,95,60,18,10,8,34
S01006754,Very good health,352,48,7,41,77,75,12,47,37,19,6,5,1,31
S01006754,Good health,317,43,11,32,83,47,19,40,47,30,6,1,5,2
S01006754,Fair health,59,0,0,0,17,8,5,7,10,8,3,1,2,1
S01006754,Bad health,13,1,0,1,5,1,1,0,0,3,2,2,0,0
S01006754,Very bad health,4,0,0,0,0,1,0,1,1,0,1,1,0,0
S01006755,All people aged 16 to 74,548,73,6,67,137,72,59,48,58,43,7,2,5,51
S01006755,Very good health,317,44,5,39,88,38,33,26,33,17,1,0,1,37
S01006755,Good health,184,25,0,25,38,30,19,18,18,18,6,2,4,12
S01006755,Fair health,39,3,1,2,9,3,7,4,5,6,0,0,0,2
S01006755,Bad health,8,1,0,1,2,1,0,0,2,2,0,0,0,0
S01006755,Very bad health,0,0,0,0,0,0,0,0,0,0,0,0,0,0
S01006756,All people aged 16 to 74,540,146,29,117,144,72,26,24,48,22,11,8,3,47
S01006756,Very good health,376,103,17,86,104,48,17,17,29,14,4,3,1,40
S01006756,Good health,137,40,12,28,33,20,8,7,15,6,4,3,1,4
S01006756,Fair health,24,3,0,3,6,4,1,0,2,2,3,2,1,3
S01006756,Bad health,2,0,0,0,1,0,0,0,1,0,0,0,0,0
S01006756,Very bad health,1,0,0,0,0,0,0,0,1,0,0,0,0,0
S01006757,All people aged 16 to 74,629,52,6,46,177,119,35,64,66,49,19,15,4,48
S01006757,Very good health,366,28,5,23,106,58,20,39,37,28,7,4,3,43
S01006757,Good health,192,19,1,18,58,43,8,15,25,15,4,3,1,5
S01006757,Fair health,55,5,0,5,9,17,5,8,4,3,4,4,0,0
S01006757,Bad health,10,0,0,0,3,1,1,1,0,2,2,2,0,0
S01006757,Very bad health,6,0,0,0,1,0,1,1,0,1,2,2,0,0
S01006758,All people aged 16 to 74,575,82,15,67,147,90,23,54,100,43,2,0,2,34
S01006758,Very good health,332,51,7,44,92,49,11,31,49,20,1,0,1,28
S01006758,Good health,190,27,6,21,48,31,7,15,42,15,0,0,0,5
S01006758,Fair health,42,2,1,1,6,8,4,7,8,6,0,0,0,1
S01006758,Bad health,10,2,1,1,1,1,1,1,1,2,1,0,1,0
S01006758,Very bad health,1,0,0,0,0,1,0,0,0,0,0,0,0,0
S01006759,All people aged 16 to 74,470,49,11,38,112,87,24,43,60,56,7,6,1,32
S01006759,Very good health,243,29,4,25,62,50,8,23,29,14,2,1,1,26
S01006759,Good health,182,16,7,9,41,32,14,17,22,32,2,2,0,6
S01006759,Fair health,35,4,0,4,5,4,1,3,7,9,2,2,0,0
S01006759,Bad health,7,0,0,0,2,1,1,0,1,1,1,1,0,0
S01006759,Very bad health,3,0,0,0,2,0,0,0,1,0,0,0,0,0
S01006760,All people aged 16 to 74,398,44,10,34,103,83,17,34,42,38,4,2,2,33
S01006760,Very good health,228,25,5,20,58,44,11,18,26,15,3,1,2,28
S01006760,Good health,139,18,5,13,40,31,4,12,13,16,0,0,0,5
S01006760,Fair health,25,1,0,1,3,7,1,3,3,6,1,1,0,0
S01006760,Bad health,5,0,0,0,1,1,1,1,0,1,0,0,0,0
S01006760,Very bad health,1,0,0,0,1,0,0,0,0,0,0,0,0,0
S01006761,All people aged 16 to 74,584,52,15,37,146,110,35,37,101,69,5,2,3,29
S01006761,Very good health,295,27,4,23,85,62,14,18,33,28,1,1,0,27
S01006761,Good health,230,23,10,13,52,38,18,11,52,30,4,1,3,2
S01006761,Fair health,45,2,1,1,8,8,2,7,8,10,0,0,0,0
S01006761,Bad health,10,0,0,0,1,1,1,1,5,1,0,0,0,0
S01006761,Very bad health,4,0,0,0,0,1,0,0,3,0,0,0,0,0
S01006762,All people aged 16 to 74,573,62,10,52,144,104,46,50,90,44,6,4,2,27
S01006762,Very good health,272,40,6,34,72,37,25,28,29,20,3,1,2,18
S01006762,Good health,205,17,1,16,53,50,13,18,36,12,0,0,0,6
S01006762,Fair health,61,3,2,1,14,12,3,2,13,8,3,3,0,3
S01006762,Bad health,23,1,0,1,3,4,2,1,10,2,0,0,0,0
S01006762,Very bad health,12,1,1,0,2,1,3,1,2,2,0,0,0,0
S01006763,All people aged 16 to 74,662,78,11,67,188,112,30,62,73,48,18,16,2,53
S01006763,Very good health,402,52,9,43,113,72,15,40,32,29,7,7,0,42
S01006763,Good health,223,24,2,22,67,37,13,19,32,14,7,5,2,10
S01006763,Fair health,29,2,0,2,7,2,2,3,7,3,2,2,0,1
S01006763,Bad health,5,0,0,0,1,0,0,0,1,1,2,2,0,0
S01006763,Very bad health,3,0,0,0,0,1,0,0,1,1,0,0,0,0
S01006764,All people aged 16 to 74,656,66,16,50,171,120,23,72,87,65,8,4,4,44
S01006764,Very good health,356,44,11,33,92,66,10,38,39,32,4,1,3,31
S01006764,Good health,238,21,5,16,59,44,8,28,40,22,3,2,1,13
S01006764,Fair health,49,1,0,1,15,10,2,6,5,9,1,1,0,0
S01006764,Bad health,11,0,0,0,4,0,2,0,3,2,0,0,0,0
S01006764,Very bad health,2,0,0,0,1,0,1,0,0,0,0,0,0,0
S01006765,All people aged 16 to 74,487,51,12,39,125,101,19,53,69,40,5,3,2,24
S01006765,Very good health,282,30,10,20,75,62,9,30,36,19,2,0,2,19
S01006765,Good health,166,17,2,15,45,30,7,19,26,15,2,2,0,5
S01006765,Fair health,27,4,0,4,1,7,1,3,5,5,1,1,0,0
S01006765,Bad health,8,0,0,0,3,1,1,1,2,0,0,0,0,0
S01006765,Very bad health,4,0,0,0,1,1,1,0,0,1,0,0,0,0
S01006766,All people aged 16 to 74,487,83,20,63,120,77,30,37,59,27,10,6,4,44
S01006766,Very good health,307,56,11,45,72,44,17,26,32,15,6,4,2,39
S01006766,Good health,142,24,7,17,40,24,7,10,21,11,2,1,1,3
S01006766,Fair health,31,2,2,0,7,9,6,1,3,1,1,0,1,1
S01006766,Bad health,6,1,0,1,0,0,0,0,3,0,1,1,0,1
S01006766,Very bad health,1,0,0,0,1,0,0,0,0,0,0,0,0,0
S01006767,All people aged 16 to 74,544,50,7,43,107,93,30,60,98,55,6,3,3,45
S01006767,Very good health,283,33,6,27,65,55,10,30,41,19,1,0,1,29
S01006767,Good health,191,13,1,12,33,29,14,19,44,26,3,2,1,10
S01006767,Fair health,57,4,0,4,7,7,5,9,12,7,1,1,0,5
S01006767,Bad health,9,0,0,0,2,1,0,0,1,3,1,0,1,1
S01006767,Very bad health,4,0,0,0,0,1,1,2,0,0,0,0,0,0
S01006768,All people aged 16 to 74,495,93,28,65,105,83,40,35,48,30,5,5,0,56
S01006768,Very good health,292,56,13,43,60,43,18,27,18,14,3,3,0,53
S01006768,Good health,160,34,15,19,32,32,14,6,27,12,0,0,0,3
S01006768,Fair health,36,2,0,2,12,6,8,1,3,3,1,1,0,0
S01006768,Bad health,5,1,0,1,0,2,0,1,0,0,1,1,0,0
S01006768,Very bad health,2,0,0,0,1,0,0,0,0,1,0,0,0,0
S01006769,All people aged 16 to 74,749,63,12,51,158,118,41,82,134,88,10,4,6,55
S01006769,Very good health,373,29,4,25,83,61,17,43,57,33,3,1,2,47
S01006769,Good health,284,31,7,24,57,43,16,30,62,34,3,1,2,8
S01006769,Fair health,74,2,1,1,17,12,6,8,11,15,3,1,2,0
S01006769,Bad health,13,1,0,1,1,2,2,1,4,2,0,0,0,0
S01006769,Very bad health,5,0,0,0,0,0,0,0,0,4,1,1,0,0
S01006770,All people aged 16 to 74,544,50,13,37,122,119,27,51,93,47,9,6,3,26
S01006770,Very good health,268,27,6,21,59,69,7,26,38,18,3,2,1,21
S01006770,Good health,225,18,6,12,52,43,17,19,43,23,5,3,2,5
S01006770,Fair health,40,5,1,4,10,7,2,5,8,3,0,0,0,0
S01006770,Bad health,10,0,0,0,1,0,1,1,4,2,1,1,0,0
S01006770,Very bad health,1,0,0,0,0,0,0,0,0,1,0,0,0,0
S01006771,All people aged 16 to 74,373,57,13,44,78,60,21,33,58,13,4,2,2,49
S01006771,Very good health,204,30,6,24,47,36,6,15,20,6,2,0,2,42
S01006771,Good health,138,23,6,17,29,21,11,15,28,4,1,1,0,6
S01006771,Fair health,28,4,1,3,2,3,3,2,9,3,1,1,0,1
S01006771,Bad health,2,0,0,0,0,0,0,1,1,0,0,0,0,0
S01006771,Very bad health,1,0,0,0,0,0,1,0,0,0,0,0,0,0
S01006772,All people aged 16 to 74,683,77,15,62,164,124,52,63,104,56,8,3,5,35
S01006772,Very good health,361,41,5,36,103,60,22,37,39,22,5,2,3,32
S01006772,Good health,258,33,10,23,52,50,24,22,50,22,2,0,2,3
S01006772,Fair health,55,3,0,3,9,12,5,3,15,8,0,0,0,0
S01006772,Bad health,5,0,0,0,0,1,0,1,0,2,1,1,0,0
S01006772,Very bad health,4,0,0,0,0,1,1,0,0,2,0,0,0,0
S01006773,All people aged 16 to 74,520,37,6,31,129,119,44,46,67,30,6,4,2,42
S01006773,Very good health,295,21,4,17,77,70,20,23,38,11,3,1,2,32
S01006773,Good health,177,16,2,14,39,34,20,22,24,10,2,2,0,10
S01006773,Fair health,36,0,0,0,10,12,3,1,2,7,1,1,0,0
S01006773,Bad health,10,0,0,0,3,3,1,0,2,1,0,0,0,0
S01006773,Very bad health,2,0,0,0,0,0,0,0,1,1,0,0,0,0
S01006774,All people aged 16 to 74,534,60,15,45,126,94,33,49,81,38,9,6,3,44
S01006774,Very good health,319,33,9,24,86,49,17,31,40,22,4,3,1,37
S01006774,Good health,175,20,6,14,32,39,16,13,33,13,2,0,2,7
S01006774,Fair health,38,7,0,7,7,6,0,5,8,3,2,2,0,0
S01006774,Bad health,1,0,0,0,1,0,0,0,0,0,0,0,0,0
S01006774,Very bad health,1,0,0,0,0,0,0,0,0,0,1,1,0,0
S01006775,All people aged 16 to 74,509,37,5,32,106,85,28,48,91,68,9,5,4,37
S01006775,Very good health,254,21,1,20,55,48,10,26,40,25,2,1,1,27
S01006775,Good health,183,11,3,8,37,26,16,16,34,28,5,3,2,10
S01006775,Fair health,58,5,1,4,13,8,2,4,13,11,2,1,1,0
S01006775,Bad health,13,0,0,0,1,3,0,2,3,4,0,0,0,0
S01006775,Very bad health,1,0,0,0,0,0,0,0,1,0,0,0,0,0
S01006776,All people aged 16 to 74,352,20,6,14,59,45,21,46,78,63,8,4,4,12
S01006776,Very good health,143,12,4,8,21,18,8,18,30,25,3,1,2,8
S01006776,Good health,143,6,1,5,25,20,7,19,33,26,3,2,1,4
S01006776,Fair health,43,1,0,1,8,6,1,8,11,7,1,0,1,0
S01006776,Bad health,17,1,1,0,4,0,5,1,2,4,0,0,0,0
S01006776,Very bad health,6,0,0,0,1,1,0,0,2,1,1,1,0,0
S01006777,All people aged 16 to 74,534,49,9,40,134,104,34,53,79,42,1,1,0,38
S01006777,Very good health,275,26,4,22,78,45,17,30,32,14,0,0,0,33
S01006777,Good health,206,21,5,16,46,51,13,15,39,18,0,0,0,3
S01006777,Fair health,38,2,0,2,6,6,3,5,7,7,0,0,0,2
S01006777,Bad health,10,0,0,0,2,2,0,2,1,3,0,0,0,0
S01006777,Very bad health,5,0,0,0,2,0,1,1,0,0,1,1,0,0
S01006778,All people aged 16 to 74,525,52,10,42,95,96,23,55,96,68,9,5,4,31
S01006778,Very good health,255,30,4,26,49,53,6,29,36,22,4,3,1,26
S01006778,Good health,191,20,6,14,31,33,9,20,42,28,3,1,2,5
S01006778,Fair health,58,2,0,2,13,4,8,4,13,13,1,1,0,0
S01006778,Bad health,16,0,0,0,2,5,0,1,4,3,1,0,1,0
S01006778,Very bad health,5,0,0,0,0,1,0,1,1,2,0,0,0,0
S01006779,All people aged 16 to 74,438,25,7,18,53,66,18,42,86,92,8,4,4,48
S01006779,Very good health,211,13,4,9,29,34,5,21,35,35,2,0,2,37
S01006779,Good health,143,9,2,7,20,15,10,14,32,31,3,2,1,9
S01006779,Fair health,62,1,0,1,4,12,3,4,16,19,1,0,1,2
S01006779,Bad health,16,2,1,1,0,4,0,1,2,6,1,1,0,0
S01006779,Very bad health,6,0,0,0,0,1,0,2,1,1,1,1,0,0
S01006780,All people aged 16 to 74,458,34,7,27,102,64,43,41,75,56,12,8,4,31
S01006780,Very good health,208,21,2,19,49,29,21,19,20,18,7,4,3,24
S01006780,Good health,185,10,5,5,42,31,15,14,39,23,5,4,1,6
S01006780,Fair health,57,3,0,3,11,3,6,5,16,12,0,0,0,1
S01006780,Bad health,6,0,0,0,0,1,0,2,0,3,0,0,0,0
S01006780,Very bad health,2,0,0,0,0,0,1,1,0,0,0,0,0,0
S01006781,All people aged 16 to 74,543,49,14,35,111,117,40,45,75,50,6,4,2,50
S01006781,Very good health,262,26,5,21,55,63,16,13,33,16,0,0,0,40
S01006781,Good health,220,18,9,9,48,40,19,23,36,25,3,2,1,8
S01006781,Fair health,47,4,0,4,6,9,4,8,4,7,3,2,1,2
S01006781,Bad health,9,1,0,1,0,3,1,1,2,1,0,0,0,0
S01006781,Very bad health,5,0,0,0,2,2,0,0,0,1,0,0,0,0
S01006782,All people aged 16 to 74,590,72,18,54,144,79,44,61,84,54,11,8,3,41
S01006782,Very good health,334,41,8,33,82,42,25,38,49,20,5,4,1,32
S01006782,Good health,208,24,7,17,56,30,15,19,27,25,3,2,1,9
S01006782,Fair health,36,7,3,4,5,4,4,2,5,8,1,0,1,0
S01006782,Bad health,8,0,0,0,1,1,0,2,3,0,1,1,0,0
S01006782,Very bad health,4,0,0,0,0,2,0,0,0,1,1,1,0,0
S01006783,All people aged 16 to 74,505,36,4,32,125,79,29,50,83,64,10,7,3,29
S01006783,Very good health,254,21,2,19,62,45,14,27,37,24,4,2,2,20
S01006783,Good health,178,10,1,9,46,25,11,16,30,29,3,2,1,8
S01006783,Fair health,58,4,1,3,14,6,4,6,11,9,3,3,0,1
S01006783,Bad health,12,1,0,1,1,3,0,0,5,2,0,0,0,0
S01006783,Very bad health,3,0,0,0,2,0,0,1,0,0,0,0,0,0
S01006784,All people aged 16 to 74,502,62,10,52,138,69,41,42,64,40,7,5,2,39
S01006784,Very good health,255,40,7,33,72,35,19,23,24,18,1,1,0,23
S01006784,Good health,193,19,3,16,52,30,17,15,29,15,2,1,1,14
S01006784,Fair health,44,3,0,3,12,3,4,4,8,4,4,3,1,2
S01006784,Bad health,6,0,0,0,1,1,1,0,1,2,0,0,0,0
S01006784,Very bad health,4,0,0,0,1,0,0,0,2,1,0,0,0,0
S01006785,All people aged 16 to 74,487,60,16,44,127,86,27,46,64,29,3,2,1,45
S01006785,Very good health,298,37,9,28,80,49,16,25,32,15,2,1,1,42
S01006785,Good health,151,19,5,14,36,33,7,16,26,11,1,1,0,2
S01006785,Fair health,32,4,2,2,9,3,3,5,4,3,0,0,0,1
S01006785,Bad health,3,0,0,0,2,1,0,0,0,0,0,0,0,0
S01006785,Very bad health,3,0,0,0,0,0,1,0,2,0,0,0,0,0
S01006786,All people aged 16 to 74,645,104,19,85,160,95,38,54,96,40,9,5,4,49
S01006786,Very good health,373,66,12,54,99,58,18,27,49,14,3,3,0,39
S01006786,Good health,215,32,4,28,49,31,16,25,37,12,4,2,2,9
S01006786,Fair health,42,3,1,2,9,3,3,2,7,12,2,0,2,1
S01006786,Bad health,10,2,2,0,2,1,1,0,2,2,0,0,0,0
S01006786,Very bad health,5,1,0,1,1,2,0,0,1,0,0,0,0,0
S01006787,All people aged 16 to 74,522,55,12,43,106,88,46,51,80,54,7,5,2,35
S01006787,Very good health,262,29,9,20,56,38,28,31,35,16,1,1,0,28
S01006787,Good health,190,25,3,22,39,37,11,14,30,24,3,2,1,7
S01006787,Fair health,55,1,0,1,6,12,6,5,11,12,2,2,0,0
S01006787,Bad health,12,0,0,0,4,1,1,1,3,2,0,0,0,0
S01006787,Very bad health,3,0,0,0,1,0,0,0,1,0,1,0,1,0
S01006788,All people aged 16 to 74,611,95,19,76,130,77,44,47,90,47,33,30,3,48
S01006788,Very good health,333,62,11,51,89,42,12,24,44,14,4,4,0,42
S01006788,Good health,218,29,7,22,35,29,24,18,33,19,25,23,2,6
S01006788,Fair health,50,4,1,3,4,4,8,5,10,11,4,3,1,0
S01006788,Bad health,8,0,0,0,1,1,0,0,3,3,0,0,0,0
S01006788,Very bad health,2,0,0,0,1,1,0,0,0,0,0,0,0,0
S01006789,All people aged 16 to 74,458,47,12,35,92,37,70,59,79,53,9,3,6,12
S01006789,Very good health,212,27,10,17,38,22,30,27,38,20,2,0,2,8
S01006789,Good health,194,18,1,17,39,13,29,24,38,25,5,1,4,3
S01006789,Fair health,40,2,1,1,10,2,10,5,2,6,2,2,0,1
S01006789,Bad health,10,0,0,0,5,0,1,2,0,2,0,0,0,0
S01006789,Very bad health,2,0,0,0,0,0,0,1,1,0,0,0,0,0
S01006790,All people aged 16 to 74,610,54,15,39,122,62,66,76,118,76,8,4,4,28
S01006790,Very good health,282,32,12,20,52,32,26,42,45,35,2,1,1,16
S01006790,Good health,246,16,3,13,53,22,32,31,48,31,5,3,2,8
S01006790,Fair health,61,6,0,6,14,6,5,3,17,8,1,0,1,1
S01006790,Bad health,20,0,0,0,3,2,3,0,7,2,0,0,0,3
S01006790,Very bad health,1,0,0,0,0,0,0,0,1,0,0,0,0,0
S01006791,All people aged 16 to 74,390,36,8,28,81,31,75,52,50,37,9,4,5,19
S01006791,Very good health,199,11,4,7,43,15,35,34,27,14,5,1,4,15
S01006791,Good health,151,22,3,19,31,15,32,12,19,16,1,0,1,3
S01006791,Fair health,30,2,0,2,6,0,7,5,3,5,2,2,0,0
S01006791,Bad health,9,1,1,0,1,1,1,1,1,2,0,0,0,1
S01006791,Very bad health,1,0,0,0,0,0,0,0,0,0,1,1,0,0
S01006792,All people aged 16 to 74,376,43,10,33,74,43,61,36,56,42,4,3,1,17
S01006792,Very good health,211,29,6,23,44,22,29,17,35,21,1,1,0,13
S01006792,Good health,123,11,3,8,25,12,26,15,15,13,2,1,1,4
S01006792,Fair health,31,2,1,1,4,7,3,2,5,8,0,0,0,0
S01006792,Bad health,9,1,0,1,1,2,2,1,1,0,1,1,0,0
S01006792,Very bad health,2,0,0,0,0,0,1,1,0,0,0,0,0,0
S01006793,All people aged 16 to 74,414,31,7,24,81,27,66,65,68,67,3,3,0,6
S01006793,Very good health,230,15,4,11,53,21,32,29,38,36,2,2,0,4
S01006793,Good health,135,12,3,9,25,3,27,29,15,23,0,0,0,1
S01006793,Fair health,45,4,0,4,2,3,7,7,13,8,1,1,0,0
S01006793,Bad health,2,0,0,0,1,0,0,0,1,0,0,0,0,0
S01006793,Very bad health,2,0,0,0,0,0,0,0,1,0,0,0,0,1
S01006794,All people aged 16 to 74,436,39,11,28,110,36,42,49,80,59,10,5,5,11
S01006794,Very good health,203,25,8,17,53,19,18,25,27,23,3,2,1,10
S01006794,Good health,162,9,2,7,40,11,17,19,39,24,2,1,1,1
S01006794,Fair health,55,4,0,4,14,5,7,4,9,8,4,1,3,0
S01006794,Bad health,12,1,1,0,2,1,0,1,4,3,0,0,0,0
S01006794,Very bad health,4,0,0,0,1,0,0,0,1,1,1,1,0,0
S01006795,All people aged 16 to 74,520,99,23,76,121,61,56,41,68,33,11,9,2,30
S01006795,Very good health,282,59,10,49,65,28,28,27,28,21,6,5,1,20
S01006795,Good health,173,30,11,19,41,25,20,10,27,8,4,3,1,8
S01006795,Fair health,49,8,1,7,12,7,6,3,9,2,0,0,0,2
S01006795,Bad health,10,2,1,1,1,1,2,0,2,1,1,1,0,0
S01006795,Very bad health,6,0,0,0,2,0,0,1,2,1,0,0,0,0
S01006796,All people aged 16 to 74,401,59,12,47,97,52,49,35,58,26,5,4,1,20
S01006796,Very good health,272,42,8,34,65,38,35,26,31,15,3,2,1,17
S01006796,Good health,97,13,2,11,26,11,7,7,24,6,1,1,0,2
S01006796,Fair health,30,4,2,2,5,3,7,2,3,4,1,1,0,1
S01006796,Bad health,2,0,0,0,1,0,0,0,0,1,0,0,0,0
S01006796,Very bad health,0,0,0,0,0,0,0,0,0,0,0,0,0,0
S01006797,All people aged 16 to 74,469,70,21,49,127,44,74,35,50,34,12,8,4,23
S01006797,Very good health,277,45,9,36,66,31,50,19,23,17,6,4,2,20
S01006797,Good health,153,22,11,11,50,9,20,11,21,12,5,3,2,3
S01006797,Fair health,34,2,0,2,8,4,3,5,6,5,1,1,0,0
S01006797,Bad health,5,1,1,0,3,0,1,0,0,0,0,0,0,0
S01006797,Very bad health,0,0,0,0,0,0,0,0,0,0,0,0,0,0
S01006798,All people aged 16 to 74,452,58,15,43,97,57,85,40,61,24,3,1,2,27
S01006798,Very good health,259,34,8,26,57,36,43,22,29,15,1,0,1,22
S01006798,Good health,144,18,5,13,32,18,27,12,26,6,1,0,1,4
S01006798,Fair health,40,5,1,4,6,2,15,5,4,1,1,1,0,1
S01006798,Bad health,7,1,1,0,1,0,0,1,2,2,0,0,0,0
S01006798,Very bad health,2,0,0,0,1,1,0,0,0,0,0,0,0,0
S01006799,All people aged 16 to 74,623,58,14,44,127,86,49,71,98,85,13,9,4,36
S01006799,Very good health,296,38,11,27,62,43,20,29,38,31,7,5,2,28
S01006799,Good health,248,19,2,17,55,27,27,29,39,39,5,3,2,8
S01006799,Fair health,58,0,0,0,8,12,1,9,16,11,1,1,0,0
S01006799,Bad health,18,1,1,0,2,2,1,3,5,4,0,0,0,0
S01006799,Very bad health,3,0,0,0,0,2,0,1,0,0,0,0,0,0
S01006800,All people aged 16 to 74,635,129,28,101,171,57,56,49,67,44,6,3,3,56
S01006800,Very good health,405,85,18,67,108,35,31,37,39,19,1,0,1,50
S01006800,Good health,190,39,9,30,53,17,21,9,22,21,4,2,2,4
S01006800,Fair health,28,4,1,3,6,3,4,2,3,3,1,1,0,2
S01006800,Bad health,9,1,0,1,3,1,0,1,3,0,0,0,0,0
S01006800,Very bad health,3,0,0,0,1,1,0,0,0,1,0,0,0,0
S01006801,All people aged 16 to 74,671,86,21,65,149,103,93,64,79,51,17,11,6,29
S01006801,Very good health,339,48,15,33,77,60,44,34,33,19,3,1,2,21
S01006801,Good health,252,30,3,27,60,35,37,23,30,22,9,5,4,6
S01006801,Fair health,58,8,3,5,9,6,8,5,11,5,4,4,0,2
S01006801,Bad health,11,0,0,0,2,2,2,1,1,3,0,0,0,0
S01006801,Very bad health,11,0,0,0,1,0,2,1,4,2,1,1,0,0
S01006802,All people aged 16 to 74,493,48,13,35,96,42,68,53,77,72,6,4,2,31
S01006802,Very good health,243,32,9,23,46,19,33,32,25,29,1,1,0,26
S01006802,Good health,190,12,4,8,38,19,24,19,36,34,3,2,1,5
S01006802,Fair health,48,3,0,3,10,3,9,1,13,8,1,0,1,0
S01006802,Bad health,12,1,0,1,2,1,2,1,3,1,1,1,0,0
S01006802,Very bad health,0,0,0,0,0,0,0,0,0,0,0,0,0,0
S01006803,All people aged 16 to 74,481,28,6,22,102,66,36,66,70,80,7,4,3,26
S01006803,Very good health,261,20,4,16,50,47,20,32,33,34,5,3,2,20
S01006803,Good health,173,8,2,6,42,14,13,27,32,30,1,0,1,6
S01006803,Fair health,38,0,0,0,8,4,2,6,3,14,1,1,0,0
S01006803,Bad health,5,0,0,0,1,1,1,1,1,0,0,0,0,0
S01006803,Very bad health,4,0,0,0,1,0,0,0,1,2,0,0,0,0
S01006804,All people aged 16 to 74,541,66,19,47,143,64,44,61,83,58,5,3,2,17
S01006804,Very good health,291,44,8,36,85,40,15,31,34,27,1,0,1,14
S01006804,Good health,189,21,10,11,40,17,24,25,38,19,3,2,1,2
S01006804,Fair health,56,1,1,0,17,7,4,5,10,10,1,1,0,1
S01006804,Bad health,5,0,0,0,1,0,1,0,1,2,0,0,0,0
S01006804,Very bad health,0,0,0,0,0,0,0,0,0,0,0,0,0,0
S01006805,All people aged 16 to 74,821,70,16,54,186,103,97,61,134,91,16,9,7,63
S01006805,Very good health,466,45,10,35,121,61,48,35,70,33,7,2,5,46
S01006805,Good health,285,19,6,13,52,35,41,18,57,39,7,6,1,17
S01006805,Fair health,57,6,0,6,11,4,7,7,5,15,2,1,1,0
S01006805,Bad health,10,0,0,0,2,2,1,1,1,3,0,0,0,0
S01006805,Very bad health,3,0,0,0,0,1,0,0,1,1,0,0,0,0
S01006806,All people aged 16 to 74,794,85,16,69,184,103,106,79,98,82,11,8,3,46
S01006806,Very good health,414,51,11,40,104,56,47,39,51,29,5,2,3,32
S01006806,Good health,277,24,3,21,66,32,46,30,30,33,5,5,0,11
S01006806,Fair health,78,8,2,6,10,13,9,7,12,16,1,1,0,2
S01006806,Bad health,19,2,0,2,2,2,4,3,3,2,0,0,0,1
S01006806,Very bad health,6,0,0,0,2,0,0,0,2,2,0,0,0,0
S01006807,All people aged 16 to 74,472,37,8,29,108,65,63,41,67,58,13,2,11,20
S01006807,Very good health,235,19,4,15,53,31,29,19,30,32,4,1,3,18
S01006807,Good health,175,12,3,9,44,27,28,19,26,14,3,1,2,2
S01006807,Fair health,50,6,1,5,10,7,3,3,8,9,4,0,4,0
S01006807,Bad health,9,0,0,0,1,0,1,0,3,3,1,0,1,0
S01006807,Very bad health,3,0,0,0,0,0,2,0,0,0,1,0,1,0
S01006808,All people aged 16 to 74,467,59,13,46,135,62,53,42,50,34,3,2,1,29
S01006808,Very good health,287,37,4,33,92,32,28,26,27,18,1,1,0,26
S01006808,Good health,133,20,9,11,33,18,18,10,16,14,1,0,1,3
S01006808,Fair health,37,2,0,2,9,11,3,4,6,2,0,0,0,0
S01006808,Bad health,6,0,0,0,1,1,2,1,1,0,0,0,0,0
S01006808,Very bad health,4,0,0,0,0,0,2,1,0,0,1,1,0,0
S01006809,All people aged 16 to 74,581,38,17,21,125,55,64,58,108,89,15,7,8,29
S01006809,Very good health,249,20,9,11,57,25,25,20,41,34,6,3,3,21
S01006809,Good health,234,15,6,9,50,22,33,25,50,32,3,1,2,4
S01006809,Fair health,68,2,1,1,13,2,6,9,11,18,4,1,3,3
S01006809,Bad health,21,1,1,0,3,5,0,3,4,4,1,1,0,0
S01006809,Very bad health,9,0,0,0,2,1,0,1,2,1,1,1,0,1
S01006810,All people aged 16 to 74,656,76,18,58,147,59,91,62,95,71,23,12,11,32
S01006810,Very good health,310,45,12,33,75,29,31,28,38,28,9,6,3,27
S01006810,Good health,240,26,4,22,57,19,41,22,39,21,11,4,7,4
S01006810,Fair health,73,3,1,2,11,6,16,7,10,17,2,1,1,1
S01006810,Bad health,24,2,1,1,4,2,2,4,6,3,1,1,0,0
S01006810,Very bad health,9,0,0,0,0,3,1,1,2,2,0,0,0,0
S01006811,All people aged 16 to 74,787,116,28,88,192,95,95,62,96,72,20,12,8,39
S01006811,Very good health,452,75,16,59,98,57,53,32,54,45,8,4,4,30
S01006811,Good health,261,39,12,27,75,28,32,23,29,18,8,5,3,9
S01006811,Fair health,58,2,0,2,19,6,7,3,10,8,3,2,1,0
S01006811,Bad health,10,0,0,0,0,4,1,2,2,0,1,1,0,0
S01006811,Very bad health,6,0,0,0,0,0,2,2,1,1,0,0,0,0
S01006812,All people aged 16 to 74,575,70,12,58,138,62,64,53,89,59,13,10,3,27
S01006812,Very good health,305,43,7,36,85,35,31,26,44,18,1,1,0,22
S01006812,Good health,218,25,5,20,44,21,27,22,36,29,9,6,3,5
S01006812,Fair health,40,1,0,1,7,6,5,4,6,10,1,1,0,0
S01006812,Bad health,8,0,0,0,2,0,0,0,2,2,2,2,0,0
S01006812,Very bad health,4,1,0,1,0,0,1,1,1,0,0,0,0,0
S01006813,All people aged 16 to 74,574,45,8,37,123,58,67,68,83,86,13,7,6,31
S01006813,Very good health,270,25,5,20,57,30,26,37,36,32,4,2,2,23
S01006813,Good health,226,18,3,15,51,22,33,24,30,34,6,4,2,8
S01006813,Fair health,57,1,0,1,8,6,6,7,12,15,2,1,1,0
S01006813,Bad health,16,1,0,1,5,0,2,0,4,3,1,0,1,0
S01006813,Very bad health,5,0,0,0,2,0,0,0,1,2,0,0,0,0
S01006814,All people aged 16 to 74,594,96,22,74,168,75,38,49,65,29,13,11,2,61
S01006814,Very good health,343,57,13,44,95,43,19,27,36,14,7,6,1,45
S01006814,Good health,186,32,6,26,55,23,15,17,20,10,3,2,1,11
S01006814,Fair health,49,6,3,3,14,7,3,5,6,3,0,0,0,5
S01006814,Bad health,14,1,0,1,3,2,0,0,3,2,3,3,0,0
S01006814,Very bad health,2,0,0,0,1,0,1,0,0,0,0,0,0,0
S01006815,All people aged 16 to 74,408,29,13,16,66,46,26,45,92,71,16,7,9,17
S01006815,Very good health,185,15,6,9,32,30,6,17,39,26,6,2,4,14
S01006815,Good health,161,10,5,5,25,11,15,18,44,29,6,3,3,3
S01006815,Fair health,42,2,0,2,6,3,2,8,7,12,2,0,2,0
S01006815,Bad health,12,1,1,0,2,1,1,2,2,3,0,0,0,0
S01006815,Very bad health,8,1,1,0,1,1,2,0,0,1,2,2,0,0
S01006816,All people aged 16 to 74,533,42,14,28,130,76,54,52,81,57,10,8,2,31
S01006816,Very good health,268,23,9,14,77,46,18,23,28,27,3,2,1,23
S01006816,Good health,184,16,5,11,40,24,21,20,31,23,2,1,1,7
S01006816,Fair health,57,0,0,0,11,3,10,5,17,6,4,4,0,1
S01006816,Bad health,17,1,0,1,2,3,3,3,4,1,0,0,0,0
S01006816,Very bad health,7,2,0,2,0,0,2,1,1,0,1,1,0,0
S01006817,All people aged 16 to 74,489,54,6,48,103,53,54,46,88,59,5,2,3,27
S01006817,Very good health,265,29,4,25,57,30,23,21,56,24,3,1,2,22
S01006817,Good health,165,21,2,19,34,14,26,15,24,25,2,1,1,4
S01006817,Fair health,40,2,0,2,7,6,3,9,5,7,0,0,0,1
S01006817,Bad health,15,2,0,2,3,3,2,1,2,2,0,0,0,0
S01006817,Very bad health,4,0,0,0,2,0,0,0,1,1,0,0,0,0
S01006818,All people aged 16 to 74,544,75,20,55,132,60,76,53,88,25,8,4,4,27
S01006818,Very good health,307,48,16,32,74,38,37,25,54,7,2,0,2,22
S01006818,Good health,174,16,2,14,45,17,29,23,21,13,5,3,2,5
S01006818,Fair health,49,9,2,7,12,5,6,4,9,4,0,0,0,0
S01006818,Bad health,13,2,0,2,1,0,4,1,3,1,1,1,0,0
S01006818,Very bad health,1,0,0,0,0,0,0,0,1,0,0,0,0,0
S01006819,All people aged 16 to 74,623,115,31,84,152,59,91,36,65,41,9,5,4,55
S01006819,Very good health,369,73,16,57,89,36,48,18,31,24,4,1,3,46
S01006819,Good health,194,36,13,23,52,21,34,14,17,10,1,1,0,9
S01006819,Fair health,50,4,1,3,11,2,7,3,14,6,3,2,1,0
S01006819,Bad health,7,1,0,1,0,0,1,1,2,1,1,1,0,0
S01006819,Very bad health,3,1,1,0,0,0,1,0,1,0,0,0,0,0
S01006820,All people aged 16 to 74,354,65,12,53,107,42,26,27,34,25,5,2,3,23
S01006820,Very good health,209,39,6,33,66,28,10,13,18,12,2,1,1,21
S01006820,Good health,121,19,4,15,36,12,12,14,13,11,2,1,1,2
S01006820,Fair health,17,6,2,4,4,2,2,0,3,0,0,0,0,0
S01006820,Bad health,4,0,0,0,0,0,2,0,0,1,1,0,1,0
S01006820,Very bad health,3,1,0,1,1,0,0,0,0,1,0,0,0,0
S01006821,All people aged 16 to 74,464,72,16,56,107,64,75,36,37,33,8,2,6,32
S01006821,Very good health,257,44,9,35,58,31,40,18,18,17,2,0,2,29
S01006821,Good health,164,24,6,18,38,28,28,14,14,11,5,2,3,2
S01006821,Fair health,36,3,1,2,11,5,7,2,4,3,1,0,1,0
S01006821,Bad health,6,1,0,1,0,0,0,2,0,2,0,0,0,1
S01006821,Very bad health,1,0,0,0,0,0,0,0,1,0,0,0,0,0
S01006822,All people aged 16 to 74,584,100,32,68,127,70,94,35,65,38,10,5,5,45
S01006822,Very good health,337,60,19,41,68,43,48,15,35,24,3,3,0,41
S01006822,Good health,193,31,10,21,50,22,38,15,23,7,3,1,2,4
S01006822,Fair health,44,8,3,5,6,4,6,5,5,7,3,1,2,0
S01006822,Bad health,8,1,0,1,2,1,1,0,2,0,1,0,1,0
S01006822,Very bad health,2,0,0,0,1,0,1,0,0,0,0,0,0,0
S01006823,All people aged 16 to 74,536,93,15,78,143,87,32,47,59,26,16,13,3,33
S01006823,Very good health,315,58,9,49,84,51,15,22,37,12,6,4,2,30
S01006823,Good health,173,28,3,25,49,32,13,18,17,10,4,3,1,2
S01006823,Fair health,40,4,1,3,10,4,3,4,5,3,6,6,0,1
S01006823,Bad health,7,2,2,0,0,0,1,3,0,1,0,0,0,0
S01006823,Very bad health,1,1,0,1,0,0,0,0,0,0,0,0,0,0
S01006824,All people aged 16 to 74,601,18,5,13,92,65,33,56,138,127,42,31,11,30
S01006824,Very good health,239,12,2,10,35,26,13,29,56,44,7,4,3,17
S01006824,Good health,272,5,3,2,46,33,17,18,63,58,23,21,2,9
S01006824,Fair health,63,1,0,1,7,4,2,6,14,14,12,6,6,3
S01006824,Bad health,18,0,0,0,2,1,1,2,3,8,0,0,0,1
S01006824,Very bad health,9,0,0,0,2,1,0,1,2,3,0,0,0,0
S01006825,All people aged 16 to 74,646,44,8,36,154,99,36,71,108,84,10,6,4,40
S01006825,Very good health,307,22,4,18,78,45,19,33,40,36,3,1,2,31
S01006825,Good health,270,17,4,13,65,40,15,32,53,34,6,4,2,8
S01006825,Fair health,59,3,0,3,10,13,2,5,14,11,0,0,0,1
S01006825,Bad health,8,2,0,2,1,0,0,1,1,3,0,0,0,0
S01006825,Very bad health,2,0,0,0,0,1,0,0,0,0,1,1,0,0
S01006826,All people aged 16 to 74,683,94,31,63,171,84,54,52,78,74,23,22,1,53
S01006826,Very good health,368,61,19,42,97,47,24,27,33,27,6,6,0,46
S01006826,Good health,236,29,11,18,60,33,23,19,33,29,4,3,1,6
S01006826,Fair health,60,4,1,3,12,3,6,6,11,11,6,6,0,1
S01006826,Bad health,17,0,0,0,2,0,1,0,1,6,7,7,0,0
S01006826,Very bad health,2,0,0,0,0,1,0,0,0,1,0,0,0,0
S01006827,All people aged 16 to 74,665,79,14,65,130,97,35,59,116,100,17,11,6,32
S01006827,Very good health,308,40,6,34,70,46,11,36,50,30,5,2,3,20
S01006827,Good health,251,30,6,24,52,41,15,14,37,42,11,8,3,9
S01006827,Fair health,82,7,1,6,7,9,8,6,23,18,1,1,0,3
S01006827,Bad health,18,1,1,0,1,0,1,3,4,8,0,0,0,0
S01006827,Very bad health,6,1,0,1,0,1,0,0,2,2,0,0,0,0
S01006828,All people aged 16 to 74,702,66,17,49,179,98,59,85,105,66,17,10,7,27
S01006828,Very good health,355,42,12,30,99,44,27,42,47,27,4,3,1,23
S01006828,Good health,256,18,5,13,59,41,24,31,42,29,8,2,6,4
S01006828,Fair health,74,5,0,5,17,10,6,9,16,7,4,4,0,0
S01006828,Bad health,14,1,0,1,4,3,1,2,0,3,0,0,0,0
S01006828,Very bad health,3,0,0,0,0,0,1,1,0,0,1,1,0,0
S01006829,All people aged 16 to 74,286,66,13,53,89,40,19,23,19,12,3,1,2,15
S01006829,Very good health,180,38,7,31,60,22,14,10,14,7,2,0,2,13
S01006829,Good health,94,28,6,22,24,15,5,13,3,4,0,0,0,2
S01006829,Fair health,9,0,0,0,4,2,0,0,1,1,1,1,0,0
S01006829,Bad health,3,0,0,0,1,1,0,0,1,0,0,0,0,0
S01006829,Very bad health,0,0,0,0,0,0,0,0,0,0,0,0,0,0
S01006830,All people aged 16 to 74,571,47,9,38,114,101,49,52,92,44,16,10,6,56
S01006830,Very good health,313,31,5,26,53,56,31,32,39,20,4,3,1,47
S01006830,Good health,195,12,3,9,48,31,14,15,41,19,9,6,3,6
S01006830,Fair health,47,4,1,3,9,10,3,3,11,4,1,1,0,2
S01006830,Bad health,12,0,0,0,2,3,1,2,1,1,2,0,2,0
S01006830,Very bad health,4,0,0,0,2,1,0,0,0,0,0,0,0,1
S01006831,All people aged 16 to 74,423,53,10,43,128,66,24,40,58,22,3,2,1,29
S01006831,Very good health,219,29,6,23,61,40,11,22,25,8,1,1,0,22
S01006831,Good health,162,20,4,16,59,19,10,13,24,11,1,0,1,5
S01006831,Fair health,33,4,0,4,6,4,2,4,8,2,1,1,0,2
S01006831,Bad health,6,0,0,0,2,2,0,1,0,1,0,0,0,0
S01006831,Very bad health,3,0,0,0,0,1,1,0,1,0,0,0,0,0
S01006832,All people aged 16 to 74,765,130,38,92,224,92,61,56,81,54,11,10,1,56
S01006832,Very good health,420,86,26,60,120,49,30,31,37,19,4,3,1,44
S01006832,Good health,259,36,10,26,79,36,21,18,34,20,4,4,0,11
S01006832,Fair health,62,6,2,4,20,5,8,5,8,7,2,2,0,1
S01006832,Bad health,18,2,0,2,4,1,2,1,0,7,1,1,0,0
S01006832,Very bad health,6,0,0,0,1,1,0,1,2,1,0,0,0,0
S01006833,All people aged 16 to 74,318,64,13,51,97,43,38,18,30,11,0,0,0,17
S01006833,Very good health,179,43,9,34,51,24,17,10,11,7,0,0,0,16
S01006833,Good health,111,18,4,14,38,15,16,6,14,3,0,0,0,1
S01006833,Fair health,28,3,0,3,8,4,5,2,5,1,0,0,0,0
S01006833,Bad health,0,0,0,0,0,0,0,0,0,0,0,0,0,0
S01006833,Very bad health,0,0,0,0,0,0,0,0,0,0,0,0,0,0
S01006834,All people aged 16 to 74,374,77,23,54,110,53,19,16,25,24,7,5,2,43
S01006834,Very good health,248,48,14,34,76,32,13,13,18,10,1,1,0,37
S01006834,Good health,106,26,7,19,30,16,5,3,6,11,4,4,0,5
S01006834,Fair health,17,3,2,1,4,4,1,0,1,1,2,0,2,1
S01006834,Bad health,1,0,0,0,0,1,0,0,0,0,0,0,0,0
S01006834,Very bad health,2,0,0,0,0,0,0,0,0,2,0,0,0,0
S01006835,All people aged 16 to 74,583,70,17,53,149,60,63,67,82,48,12,9,3,32
S01006835,Very good health,281,42,9,33,81,19,29,34,34,13,7,6,1,22
S01006835,Good health,211,24,7,17,51,25,26,20,33,22,2,1,1,8
S01006835,Fair health,70,1,0,1,14,12,5,10,12,11,3,2,1,2
S01006835,Bad health,17,2,1,1,2,4,2,2,3,2,0,0,0,0
S01006835,Very bad health,4,1,0,1,1,0,1,1,0,0,0,0,0,0
S01006836,All people aged 16 to 74,367,76,18,58,106,41,28,25,46,23,3,2,1,19
S01006836,Very good health,243,62,16,46,78,26,14,14,19,11,3,2,1,16
S01006836,Good health,97,11,2,9,23,13,12,9,17,9,0,0,0,3
S01006836,Fair health,22,1,0,1,4,2,2,2,9,2,0,0,0,0
S01006836,Bad health,4,2,0,2,0,0,0,0,1,1,0,0,0,0
S01006836,Very bad health,1,0,0,0,1,0,0,0,0,0,0,0,0,0
S01006837,All people aged 16 to 74,442,66,12,54,117,70,40,34,45,34,6,5,1,30
S01006837,Very good health,264,43,7,36,70,41,22,25,23,14,1,0,1,25
S01006837,Good health,132,17,5,12,33,24,11,7,15,16,4,4,0,5
S01006837,Fair health,37,6,0,6,11,4,6,0,5,4,1,1,0,0
S01006837,Bad health,7,0,0,0,2,1,1,2,1,0,0,0,0,0
S01006837,Very bad health,2,0,0,0,1,0,0,0,1,0,0,0,0,0
S01006838,All people aged 16 to 74,485,71,15,56,113,64,33,42,62,59,5,5,0,36
S01006838,Very good health,300,48,10,38,75,41,16,22,36,29,1,1,0,32
S01006838,Good health,137,19,4,15,30,20,12,15,18,20,1,1,0,2
S01006838,Fair health,40,4,1,3,8,3,2,5,8,6,2,2,0,2
S01006838,Bad health,7,0,0,0,0,0,3,0,0,3,1,1,0,0
S01006838,Very bad health,1,0,0,0,0,0,0,0,0,1,0,0,0,0
S01006839,All people aged 16 to 74,786,76,13,63,191,144,50,79,107,84,14,6,8,41
S01006839,Very good health,406,48,6,42,103,67,30,40,48,31,9,4,5,30
S01006839,Good health,280,23,4,19,67,59,18,30,40,28,4,1,3,11
S01006839,Fair health,77,5,3,2,16,13,1,7,15,19,1,1,0,0
S01006839,Bad health,18,0,0,0,4,4,1,1,4,4,0,0,0,0
S01006839,Very bad health,5,0,0,0,1,1,0,1,0,2,0,0,0,0
S01006840,All people aged 16 to 74,744,112,18,94,222,118,44,57,77,49,9,5,4,56
S01006840,Very good health,474,68,9,59,143,73,25,40,39,31,5,2,3,50
S01006840,Good health,219,39,9,30,62,39,12,14,30,16,2,1,1,5
S01006840,Fair health,43,4,0,4,14,5,4,3,8,2,2,2,0,1
S01006840,Bad health,6,1,0,1,3,0,2,0,0,0,0,0,0,0
S01006840,Very bad health,2,0,0,0,0,1,1,0,0,0,0,0,0,0
S01006841,All people aged 16 to 74,710,79,12,67,205,119,43,52,87,60,12,6,6,53
S01006841,Very good health,407,45,8,37,124,69,20,34,42,20,8,5,3,45
S01006841,Good health,243,26,4,22,74,39,19,15,30,29,3,1,2,8
S01006841,Fair health,52,7,0,7,6,8,4,3,13,10,1,0,1,0
S01006841,Bad health,2,1,0,1,1,0,0,0,0,0,0,0,0,0
S01006841,Very bad health,6,0,0,0,0,3,0,0,2,1,0,0,0,0
S01006842,All people aged 16 to 74,643,59,18,41,176,121,39,57,92,47,6,4,2,46
S01006842,Very good health,361,35,9,26,92,76,22,33,48,16,2,2,0,37
S01006842,Good health,234,19,7,12,69,41,13,22,35,24,3,1,2,8
S01006842,Fair health,35,2,1,1,11,3,4,1,8,5,0,0,0,1
S01006842,Bad health,10,3,1,2,2,1,0,0,1,2,1,1,0,0
S01006842,Very bad health,3,0,0,0,2,0,0,1,0,0,0,0,0,0
S01006843,All people aged 16 to 74,642,61,13,48,135,138,41,57,102,47,10,7,3,51
S01006843,Very good health,366,36,7,29,74,87,24,30,46,22,5,4,1,42
S01006843,Good health,212,21,6,15,52,38,15,20,36,17,5,3,2,8
S01006843,Fair health,50,2,0,2,8,12,2,5,14,6,0,0,0,1
S01006843,Bad health,9,1,0,1,0,1,0,0,5,2,0,0,0,0
S01006843,Very bad health,5,1,0,1,1,0,0,2,1,0,0,0,0,0
S01006844,All people aged 16 to 74,560,47,3,44,126,103,37,57,90,59,2,0,2,39
S01006844,Very good health,278,28,2,26,66,44,20,27,41,21,1,0,1,30
S01006844,Good health,225,15,1,14,51,49,12,25,36,27,1,0,1,9
S01006844,Fair health,45,3,0,3,9,7,5,4,9,8,0,0,0,0
S01006844,Bad health,12,1,0,1,0,3,0,1,4,3,0,0,0,0
S01006844,Very bad health,0,0,0,0,0,0,0,0,0,0,0,0,0,0
S01006845,All people aged 16 to 74,753,76,15,61,192,113,43,80,116,50,16,11,5,67
S01006845,Very good health,424,48,12,36,107,63,24,41,60,20,4,3,1,57
S01006845,Good health,266,23,2,21,69,38,13,34,44,27,9,5,4,9
S01006845,Fair health,52,5,1,4,13,10,6,4,8,3,2,2,0,1
S01006845,Bad health,9,0,0,0,2,2,0,1,3,0,1,1,0,0
S01006845,Very bad health,2,0,0,0,1,0,0,0,1,0,0,0,0,0
S01006846,All people aged 16 to 74,438,35,8,27,84,73,28,54,88,41,5,4,1,30
S01006846,Very good health,237,24,4,20,38,44,15,28,42,17,3,2,1,26
S01006846,Good health,148,9,4,5,35,23,11,20,30,15,1,1,0,4
S01006846,Fair health,42,2,0,2,8,5,2,5,12,7,1,1,0,0
S01006846,Bad health,10,0,0,0,3,1,0,1,3,2,0,0,0,0
S01006846,Very bad health,1,0,0,0,0,0,0,0,1,0,0,0,0,0
S01006847,All people aged 16 to 74,518,63,15,48,117,87,37,57,58,37,11,10,1,51
S01006847,Very good health,292,40,11,29,59,51,18,32,25,22,3,3,0,42
S01006847,Good health,172,19,2,17,47,28,13,19,23,10,4,3,1,9
S01006847,Fair health,40,3,2,1,8,6,4,5,7,5,2,2,0,0
S01006847,Bad health,13,1,0,1,3,2,2,1,3,0,1,1,0,0
S01006847,Very bad health,1,0,0,0,0,0,0,0,0,0,1,1,0,0
S01006848,All people aged 16 to 74,737,131,29,102,149,79,85,50,75,76,45,38,7,47
S01006848,Very good health,424,87,18,69,101,34,46,24,32,36,26,25,1,38
S01006848,Good health,236,36,9,27,35,32,29,18,35,27,16,10,6,8
S01006848,Fair health,61,8,2,6,9,10,9,5,7,9,3,3,0,1
S01006848,Bad health,10,0,0,0,0,2,1,3,1,3,0,0,0,0
S01006848,Very bad health,6,0,0,0,4,1,0,0,0,1,0,0,0,0
S01006849,All people aged 16 to 74,692,99,25,74,174,133,35,60,83,62,11,7,4,35
S01006849,Very good health,436,72,18,54,125,81,22,33,46,28,4,1,3,25
S01006849,Good health,202,20,6,14,42,44,8,24,25,25,5,5,0,9
S01006849,Fair health,41,6,0,6,6,3,5,2,11,6,1,1,0,1
S01006849,Bad health,11,1,1,0,1,4,0,1,1,2,1,0,1,0
S01006849,Very bad health,2,0,0,0,0,1,0,0,0,1,0,0,0,0
S01006850,All people aged 16 to 74,743,51,13,38,166,122,37,84,130,92,16,10,6,45
S01006850,Very good health,364,29,8,21,86,61,13,40,61,38,7,4,3,29
S01006850,Good health,292,15,5,10,62,47,22,37,47,41,6,4,2,15
S01006850,Fair health,64,4,0,4,15,11,2,6,15,8,3,2,1,0
S01006850,Bad health,18,2,0,2,2,3,0,1,6,3,0,0,0,1
S01006850,Very bad health,5,1,0,1,1,0,0,0,1,2,0,0,0,0
S01006851,All people aged 16 to 74,589,41,13,28,102,95,35,59,112,90,16,12,4,39
S01006851,Very good health,314,29,8,21,61,55,19,30,50,36,3,1,2,31
S01006851,Good health,170,9,3,6,26,28,14,16,36,29,5,4,1,7
S01006851,Fair health,83,3,2,1,13,11,2,11,16,20,6,6,0,1
S01006851,Bad health,12,0,0,0,1,1,0,0,7,2,1,0,1,0
S01006851,Very bad health,10,0,0,0,1,0,0,2,3,3,1,1,0,0
S01006852,All people aged 16 to 74,468,66,16,50,110,59,50,53,59,36,6,2,4,29
S01006852,Very good health,255,42,11,31,59,35,19,25,32,17,1,1,0,25
S01006852,Good health,145,19,4,15,35,15,25,21,17,8,2,1,1,3
S01006852,Fair health,55,5,1,4,12,8,5,4,8,9,3,0,3,1
S01006852,Bad health,8,0,0,0,4,1,0,1,1,1,0,0,0,0
S01006852,Very bad health,5,0,0,0,0,0,1,2,1,1,0,0,0,0
S01006853,All people aged 16 to 74,639,154,36,118,166,58,80,40,43,40,9,4,5,49
S01006853,Very good health,416,112,28,84,110,40,44,21,22,15,5,3,2,47
S01006853,Good health,171,37,7,30,39,14,27,14,15,20,3,0,3,2
S01006853,Fair health,38,3,1,2,14,3,7,2,4,4,1,1,0,0
S01006853,Bad health,10,1,0,1,3,0,1,3,1,1,0,0,0,0
S01006853,Very bad health,4,1,0,1,0,1,1,0,1,0,0,0,0,0
S01006854,All people aged 16 to 74,643,100,26,74,155,87,58,43,83,66,15,5,10,36
S01006854,Very good health,348,49,12,37,88,53,26,26,41,29,7,2,5,29
S01006854,Good health,228,44,13,31,50,26,26,13,33,27,3,0,3,6
S01006854,Fair health,45,6,1,5,9,6,4,3,6,7,3,1,2,1
S01006854,Bad health,16,1,0,1,7,1,2,1,2,2,0,0,0,0
S01006854,Very bad health,6,0,0,0,1,1,0,0,1,1,2,2,0,0
S01006855,All people aged 16 to 74,572,121,28,93,146,72,77,29,65,25,8,5,3,29
S01006855,Very good health,330,74,18,56,86,42,41,13,38,12,2,1,1,22
S01006855,Good health,191,41,9,32,46,24,29,11,21,9,4,3,1,6
S01006855,Fair health,40,6,1,5,12,4,5,3,4,3,2,1,1,1
S01006855,Bad health,9,0,0,0,1,2,2,1,2,1,0,0,0,0
S01006855,Very bad health,2,0,0,0,1,0,0,1,0,0,0,0,0,0
S01006856,All people aged 16 to 74,483,85,16,69,122,49,59,46,53,40,6,2,4,23
S01006856,Very good health,288,59,12,47,71,33,35,26,26,16,4,1,3,18
S01006856,Good health,151,20,3,17,37,14,20,16,22,17,1,0,1,4
S01006856,Fair health,34,4,0,4,13,2,2,4,3,6,0,0,0,0
S01006856,Bad health,8,2,1,1,1,0,1,0,2,0,1,1,0,1
S01006856,Very bad health,2,0,0,0,0,0,1,0,0,1,0,0,0,0
S01006857,All people aged 16 to 74,753,108,21,87,182,71,150,54,85,56,10,5,5,37
S01006857,Very good health,436,76,16,60,111,43,72,32,42,21,6,3,3,33
S01006857,Good health,260,25,4,21,58,25,65,17,36,29,3,1,2,2
S01006857,Fair health,49,5,0,5,12,3,13,4,5,6,0,0,0,1
S01006857,Bad health,8,2,1,1,1,0,0,1,2,0,1,1,0,1
S01006857,Very bad health,0,0,0,0,0,0,0,0,0,0,0,0,0,0
S01006858,All people aged 16 to 74,483,89,9,80,125,52,84,26,45,32,4,4,0,26
S01006858,Very good health,281,59,7,52,82,25,47,12,23,12,1,1,0,20
S01006858,Good health,163,30,2,28,38,18,28,12,13,15,3,3,0,6
S01006858,Fair health,31,0,0,0,4,8,7,2,5,5,0,0,0,0
S01006858,Bad health,4,0,0,0,1,1,2,0,0,0,0,0,0,0
S01006858,Very bad health,4,0,0,0,0,0,0,0,4,0,0,0,0,0
S01006859,All people aged 16 to 74,792,152,48,104,235,95,62,42,87,37,20,13,7,62
S01006859,Very good health,481,88,28,60,147,56,30,29,44,23,8,4,4,56
S01006859,Good health,254,56,16,40,67,37,25,11,35,8,9,6,3,6
S01006859,Fair health,46,7,4,3,19,1,7,0,8,3,1,1,0,0
S01006859,Bad health,9,0,0,0,2,0,0,2,0,3,2,2,0,0
S01006859,Very bad health,2,1,0,1,0,1,0,0,0,0,0,0,0,0
S01006860,All people aged 16 to 74,393,27,5,22,73,36,35,40,77,75,5,3,2,25
S01006860,Very good health,197,17,4,13,38,18,16,21,33,34,1,0,1,19
S01006860,Good health,140,8,0,8,26,15,10,13,32,29,1,1,0,6
S01006860,Fair health,38,1,0,1,5,3,6,5,7,8,3,2,1,0
S01006860,Bad health,15,1,1,0,4,0,2,1,3,4,0,0,0,0
S01006860,Very bad health,3,0,0,0,0,0,1,0,2,0,0,0,0,0
S01006861,All people aged 16 to 74,409,96,17,79,117,63,31,24,30,12,6,4,2,30
S01006861,Very good health,273,67,15,52,88,38,13,19,14,6,5,3,2,23
S01006861,Good health,120,28,2,26,24,23,16,5,11,5,1,1,0,7
S01006861,Fair health,13,1,0,1,4,2,0,0,5,1,0,0,0,0
S01006861,Bad health,2,0,0,0,1,0,1,0,0,0,0,0,0,0
S01006861,Very bad health,1,0,0,0,0,0,1,0,0,0,0,0,0,0
S01006862,All people aged 16 to 74,502,71,10,61,102,67,46,51,84,47,5,0,5,29
S01006862,Very good health,267,40,5,35,68,33,20,30,37,14,2,0,2,23
S01006862,Good health,195,29,4,25,29,28,22,19,39,23,1,0,1,5
S01006862,Fair health,34,2,1,1,4,4,3,2,7,9,2,0,2,1
S01006862,Bad health,5,0,0,0,1,2,1,0,0,1,0,0,0,0
S01006862,Very bad health,1,0,0,0,0,0,0,0,1,0,0,0,0,0
S01006863,All people aged 16 to 74,486,45,14,31,105,67,41,55,80,67,6,5,1,20
S01006863,Very good health,248,23,6,17,60,34,21,27,31,31,3,3,0,18
S01006863,Good health,185,18,8,10,38,26,14,25,31,29,2,1,1,2
S01006863,Fair health,40,3,0,3,5,5,4,2,13,7,1,1,0,0
S01006863,Bad health,11,0,0,0,2,2,2,1,4,0,0,0,0,0
S01006863,Very bad health,2,1,0,1,0,0,0,0,1,0,0,0,0,0
S01006864,All people aged 16 to 74,305,43,11,32,70,36,19,30,48,30,12,7,5,17
S01006864,Very good health,175,26,6,20,46,22,13,15,22,16,5,2,3,10
S01006864,Good health,107,16,5,11,19,11,5,11,19,13,6,5,1,7
S01006864,Fair health,18,1,0,1,5,2,0,4,4,1,1,0,1,0
S01006864,Bad health,4,0,0,0,0,1,1,0,2,0,0,0,0,0
S01006864,Very bad health,1,0,0,0,0,0,0,0,1,0,0,0,0,0
S01006865,All people aged 16 to 74,716,141,27,114,165,69,85,50,93,57,6,4,2,50
S01006865,Very good health,391,90,18,72,88,35,41,28,50,18,3,2,1,38
S01006865,Good health,257,41,8,33,64,26,38,16,34,26,1,0,1,11
S01006865,Fair health,54,9,1,8,10,5,5,6,8,9,1,1,0,1
S01006865,Bad health,12,1,0,1,3,2,1,0,1,3,1,1,0,0
S01006865,Very bad health,2,0,0,0,0,1,0,0,0,1,0,0,0,0
S01006866,All people aged 16 to 74,413,77,12,65,136,58,22,34,32,17,3,3,0,34
S01006866,Very good health,236,48,7,41,69,30,10,23,18,11,1,1,0,26
S01006866,Good health,143,24,5,19,54,25,10,8,11,4,0,0,0,7
S01006866,Fair health,27,5,0,5,11,3,1,2,2,2,1,1,0,0
S01006866,Bad health,5,0,0,0,2,0,1,0,1,0,1,1,0,0
S01006866,Very bad health,2,0,0,0,0,0,0,1,0,0,0,0,0,1
S01006867,All people aged 16 to 74,537,127,25,102,160,50,41,33,52,22,7,5,2,45
S01006867,Very good health,309,74,15,59,91,31,20,16,25,8,3,1,2,41
S01006867,Good health,175,44,9,35,49,15,16,11,21,12,3,3,0,4
S01006867,Fair health,34,7,1,6,13,4,3,3,3,1,0,0,0,0
S01006867,Bad health,14,2,0,2,6,0,0,1,3,1,1,1,0,0
S01006867,Very bad health,5,0,0,0,1,0,2,2,0,0,0,0,0,0
S01006868,All people aged 16 to 74,624,79,15,64,136,63,48,72,105,73,6,5,1,42
S01006868,Very good health,321,50,6,44,80,32,18,34,37,32,0,0,0,38
S01006868,Good health,229,24,8,16,47,23,23,30,44,31,4,3,1,3
S01006868,Fair health,49,2,0,2,6,5,5,7,14,8,2,2,0,0
S01006868,Bad health,19,2,0,2,2,3,2,1,6,2,0,0,0,1
S01006868,Very bad health,6,1,1,0,1,0,0,0,4,0,0,0,0,0
S01006869,All people aged 16 to 74,381,55,10,45,69,39,48,41,52,44,13,11,2,20
S01006869,Very good health,196,34,9,25,37,20,24,15,26,18,6,4,2,16
S01006869,Good health,126,11,0,11,24,11,17,19,16,19,6,6,0,3
S01006869,Fair health,46,9,0,9,7,7,6,5,7,5,0,0,0,0
S01006869,Bad health,12,1,1,0,1,1,1,2,3,1,1,1,0,1
S01006869,Very bad health,1,0,0,0,0,0,0,0,0,1,0,0,0,0
S01006870,All people aged 16 to 74,355,54,8,46,97,31,42,27,37,28,7,2,5,32
S01006870,Very good health,219,36,4,32,57,18,23,19,21,16,2,1,1,27
S01006870,Good health,101,14,3,11,27,12,13,6,13,9,4,1,3,3
S01006870,Fair health,25,2,0,2,9,1,5,1,2,2,1,0,1,2
S01006870,Bad health,10,2,1,1,4,0,1,1,1,1,0,0,0,0
S01006870,Very bad health,0,0,0,0,0,0,0,0,0,0,0,0,0,0
S01006871,All people aged 16 to 74,476,72,19,53,144,67,33,30,52,36,12,6,6,30
S01006871,Very good health,274,52,11,41,83,37,15,13,24,21,5,2,3,24
S01006871,Good health,147,16,5,11,46,19,16,13,20,7,5,3,2,5
S01006871,Fair health,47,4,3,1,13,10,1,3,7,6,2,1,1,1
S01006871,Bad health,4,0,0,0,1,0,0,1,0,2,0,0,0,0
S01006871,Very bad health,4,0,0,0,1,1,1,0,1,0,0,0,0,0
S01006872,All people aged 16 to 74,504,112,24,88,137,56,67,43,37,24,3,2,1,25
S01006872,Very good health,321,71,18,53,91,35,42,30,18,10,2,1,1,22
S01006872,Good health,142,36,5,31,35,15,18,7,17,10,1,1,0,3
S01006872,Fair health,39,4,1,3,11,6,7,6,1,4,0,0,0,0
S01006872,Bad health,0,0,0,0,0,0,0,0,0,0,0,0,0,0
S01006872,Very bad health,2,1,0,1,0,0,0,0,1,0,0,0,0,0
S01006873,All people aged 16 to 74,622,112,24,88,161,53,87,41,83,37,10,5,5,38
S01006873,Very good health,324,67,14,53,89,24,40,20,38,11,4,2,2,31
S01006873,Good health,226,37,7,30,59,22,31,16,34,17,5,2,3,5
S01006873,Fair health,57,6,3,3,10,5,14,5,8,7,0,0,0,2
S01006873,Bad health,13,1,0,1,3,1,2,0,3,2,1,1,0,0
S01006873,Very bad health,2,1,0,1,0,1,0,0,0,0,0,0,0,0
S01006874,All people aged 16 to 74,447,72,14,58,99,49,64,32,56,34,7,3,4,34
S01006874,Very good health,260,48,10,38,64,27,29,16,31,16,2,0,2,27
S01006874,Good health,154,19,4,15,29,18,32,15,17,15,3,1,2,6
S01006874,Fair health,27,4,0,4,5,2,2,1,7,3,2,2,0,1
S01006874,Bad health,6,1,0,1,1,2,1,0,1,0,0,0,0,0
S01006874,Very bad health,0,0,0,0,0,0,0,0,0,0,0,0,0,0
S01006875,All people aged 16 to 74,487,50,7,43,91,49,64,47,75,65,16,6,10,30
S01006875,Very good health,226,28,3,25,54,18,28,19,32,25,3,1,2,19
S01006875,Good health,186,19,4,15,26,20,27,18,26,29,11,4,7,10
S01006875,Fair health,60,3,0,3,9,7,7,9,13,10,1,0,1,1
S01006875,Bad health,14,0,0,0,2,3,2,1,4,1,1,1,0,0
S01006875,Very bad health,1,0,0,0,0,1,0,0,0,0,0,0,0,0
S01006876,All people aged 16 to 74,702,87,21,66,138,84,111,62,89,72,11,7,4,48
S01006876,Very good health,386,57,10,47,80,53,52,37,44,22,3,1,2,38
S01006876,Good health,249,24,8,16,52,26,44,22,33,34,5,4,1,9
S01006876,Fair health,43,3,1,2,5,3,11,2,8,10,1,0,1,0
S01006876,Bad health,19,3,2,1,1,2,3,1,3,3,2,2,0,1
S01006876,Very bad health,5,0,0,0,0,0,1,0,1,3,0,0,0,0
S01006877,All people aged 16 to 74,703,111,17,94,163,90,125,47,72,44,11,7,4,40
S01006877,Very good health,359,68,8,60,80,47,48,22,34,20,7,3,4,33
S01006877,Good health,263,39,9,30,65,23,60,19,31,18,2,2,0,6
S01006877,Fair health,64,2,0,2,13,18,14,5,7,4,1,1,0,0
S01006877,Bad health,13,2,0,2,4,2,2,0,0,2,0,0,0,1
S01006877,Very bad health,4,0,0,0,1,0,1,1,0,0,1,1,0,0
S01006878,All people aged 16 to 74,520,40,9,31,113,46,127,35,80,51,9,4,5,19
S01006878,Very good health,240,23,5,18,48,25,54,16,39,19,2,1,1,14
S01006878,Good health,197,13,2,11,50,16,49,12,28,20,4,1,3,5
S01006878,Fair health,60,4,2,2,11,5,19,4,10,5,2,2,0,0
S01006878,Bad health,17,0,0,0,4,0,2,3,1,6,1,0,1,0
S01006878,Very bad health,6,0,0,0,0,0,3,0,2,1,0,0,0,0
S01006879,All people aged 16 to 74,574,84,16,68,108,49,115,49,65,49,13,6,7,42
S01006879,Very good health,298,43,8,35,56,28,55,29,30,18,6,2,4,33
S01006879,Good health,206,32,7,25,40,15,44,14,27,22,4,1,3,8
S01006879,Fair health,59,7,1,6,10,5,14,5,6,8,3,3,0,1
S01006879,Bad health,10,1,0,1,2,1,2,1,2,1,0,0,0,0
S01006879,Very bad health,1,1,0,1,0,0,0,0,0,0,0,0,0,0
S01006880,All people aged 16 to 74,443,77,18,59,135,56,47,39,40,22,1,1,0,26
S01006880,Very good health,283,53,14,39,93,35,30,24,19,11,0,0,0,18
S01006880,Good health,128,22,4,18,35,16,12,14,14,7,1,1,0,7
S01006880,Fair health,24,2,0,2,5,4,4,1,4,3,0,0,0,1
S01006880,Bad health,6,0,0,0,1,0,1,0,3,1,0,0,0,0
S01006880,Very bad health,2,0,0,0,1,1,0,0,0,0,0,0,0,0
S01006881,All people aged 16 to 74,430,69,21,48,101,53,75,32,46,34,3,1,2,17
S01006881,Very good health,224,42,17,25,52,26,39,17,19,15,1,0,1,13
S01006881,Good health,158,24,3,21,42,18,26,9,22,13,0,0,0,4
S01006881,Fair health,43,2,1,1,6,9,9,5,5,5,2,1,1,0
S01006881,Bad health,3,0,0,0,0,0,1,1,0,1,0,0,0,0
S01006881,Very bad health,2,1,0,1,1,0,0,0,0,0,0,0,0,0
S01006882,All people aged 16 to 74,258,12,2,10,51,31,19,32,57,39,5,3,2,12
S01006882,Very good health,111,9,2,7,22,16,9,16,16,17,1,0,1,5
S01006882,Good health,107,3,0,3,25,11,7,12,26,16,1,0,1,6
S01006882,Fair health,33,0,0,0,2,3,2,2,14,6,3,3,0,1
S01006882,Bad health,6,0,0,0,2,1,1,1,1,0,0,0,0,0
S01006882,Very bad health,1,0,0,0,0,0,0,1,0,0,0,0,0,0
S01006883,All people aged 16 to 74,329,36,9,27,86,39,31,22,49,41,6,0,6,19
S01006883,Very good health,169,22,3,19,50,20,12,9,20,20,2,0,2,14
S01006883,Good health,120,12,5,7,27,16,12,6,24,14,4,0,4,5
S01006883,Fair health,27,1,1,0,6,3,5,3,4,5,0,0,0,0
S01006883,Bad health,12,1,0,1,3,0,2,3,1,2,0,0,0,0
S01006883,Very bad health,1,0,0,0,0,0,0,1,0,0,0,0,0,0
S01006884,All people aged 16 to 74,627,52,14,38,135,89,52,64,115,67,7,2,5,46
S01006884,Very good health,338,31,8,23,77,56,21,32,55,28,1,0,1,37
S01006884,Good health,217,19,5,14,45,24,23,21,44,31,4,1,3,6
S01006884,Fair health,52,1,1,0,12,6,7,6,12,6,1,0,1,1
S01006884,Bad health,16,1,0,1,1,3,0,3,4,2,0,0,0,2
S01006884,Very bad health,4,0,0,0,0,0,1,2,0,0,1,1,0,0
S01006885,All people aged 16 to 74,386,64,12,52,89,44,49,34,46,30,5,5,0,25
S01006885,Very good health,222,40,7,33,57,30,21,12,24,15,0,0,0,23
S01006885,Good health,118,20,5,15,23,12,20,16,18,6,1,1,0,2
S01006885,Fair health,42,4,0,4,7,2,7,6,4,9,3,3,0,0
S01006885,Bad health,4,0,0,0,2,0,1,0,0,0,1,1,0,0
S01006885,Very bad health,0,0,0,0,0,0,0,0,0,0,0,0,0,0
S01006886,All people aged 16 to 74,575,102,18,84,158,62,75,41,53,45,10,8,2,29
S01006886,Very good health,307,63,10,53,87,35,38,18,22,16,4,3,1,24
S01006886,Good health,206,31,6,25,58,23,30,16,20,21,3,3,0,4
S01006886,Fair health,47,7,2,5,8,4,3,6,10,8,1,1,0,0
S01006886,Bad health,14,0,0,0,5,0,4,1,1,0,2,1,1,1
S01006886,Very bad health,1,1,0,1,0,0,0,0,0,0,0,0,0,0
S01006887,All people aged 16 to 74,418,70,19,51,111,39,49,36,42,43,6,3,3,22
S01006887,Very good health,269,49,12,37,71,29,26,22,25,26,0,0,0,21
S01006887,Good health,115,18,7,11,31,8,17,8,13,15,4,2,2,1
S01006887,Fair health,29,3,0,3,8,2,5,5,3,1,2,1,1,0
S01006887,Bad health,4,0,0,0,1,0,1,1,1,0,0,0,0,0
S01006887,Very bad health,1,0,0,0,0,0,0,0,0,1,0,0,0,0
S01006888,All people aged 16 to 74,596,86,15,71,136,76,93,48,70,35,15,8,7,37
S01006888,Very good health,327,64,10,54,67,41,44,28,29,15,8,4,4,31
S01006888,Good health,201,20,5,15,54,25,35,16,28,15,4,3,1,4
S01006888,Fair health,48,2,0,2,12,7,10,3,8,2,2,1,1,2
S01006888,Bad health,14,0,0,0,1,2,3,1,4,3,0,0,0,0
S01006888,Very bad health,6,0,0,0,2,1,1,0,1,0,1,0,1,0
S01006889,All people aged 16 to 74,624,30,9,21,107,66,31,76,119,135,26,13,13,34
S01006889,Very good health,276,14,6,8,50,26,12,39,50,51,11,5,6,23
S01006889,Good health,240,13,3,10,38,27,12,25,48,58,9,4,5,10
S01006889,Fair health,78,2,0,2,14,11,4,7,17,19,3,1,2,1
S01006889,Bad health,26,1,0,1,2,2,3,4,4,7,3,3,0,0
S01006889,Very bad health,4,0,0,0,3,0,0,1,0,0,0,0,0,0
S01006890,All people aged 16 to 74,487,74,17,57,127,68,37,53,57,42,8,1,7,21
S01006890,Very good health,291,44,10,34,86,47,20,26,34,12,4,1,3,18
S01006890,Good health,153,26,6,20,33,16,12,19,20,24,0,0,0,3
S01006890,Fair health,34,4,1,3,6,5,2,6,1,6,4,0,4,0
S01006890,Bad health,7,0,0,0,1,0,2,2,2,0,0,0,0,0
S01006890,Very bad health,2,0,0,0,1,0,1,0,0,0,0,0,0,0
S01006891,All people aged 16 to 74,693,95,18,77,177,80,40,76,93,77,10,7,3,45
S01006891,Very good health,357,63,9,54,96,46,15,40,36,28,3,1,2,30
S01006891,Good health,249,26,8,18,67,25,15,26,42,33,5,4,1,10
S01006891,Fair health,68,4,1,3,14,6,8,7,10,13,2,2,0,4
S01006891,Bad health,14,1,0,1,0,3,2,2,5,1,0,0,0,0
S01006891,Very bad health,5,1,0,1,0,0,0,1,0,2,0,0,0,1
S01006892,All people aged 16 to 74,458,24,3,21,92,56,28,72,78,77,11,8,3,20
S01006892,Very good health,193,12,2,10,47,27,11,26,26,29,4,2,2,11
S01006892,Good health,186,10,1,9,32,22,11,34,34,32,3,2,1,8
S01006892,Fair health,54,1,0,1,11,5,3,7,14,11,1,1,0,1
S01006892,Bad health,19,1,0,1,2,2,2,3,4,4,1,1,0,0
S01006892,Very bad health,6,0,0,0,0,0,1,2,0,1,2,2,0,0
S01006893,All people aged 16 to 74,390,22,6,16,78,53,24,45,64,67,8,7,1,29
S01006893,Very good health,179,11,4,7,38,26,14,21,25,24,1,1,0,19
S01006893,Good health,160,7,1,6,30,23,6,18,30,31,5,4,1,10
S01006893,Fair health,40,2,0,2,8,4,4,4,7,9,2,2,0,0
S01006893,Bad health,10,2,1,1,2,0,0,2,2,2,0,0,0,0
S01006893,Very bad health,1,0,0,0,0,0,0,0,0,1,0,0,0,0
S01006894,All people aged 16 to 74,718,64,9,55,176,103,42,76,105,97,21,15,6,34
S01006894,Very good health,330,32,5,27,90,55,23,26,40,32,4,3,1,28
S01006894,Good health,291,29,4,25,68,41,14,34,43,46,10,7,3,6
S01006894,Fair health,73,3,0,3,14,4,4,14,18,12,4,2,2,0
S01006894,Bad health,19,0,0,0,2,3,0,2,3,6,3,3,0,0
S01006894,Very bad health,5,0,0,0,2,0,1,0,1,1,0,0,0,0
S01006895,All people aged 16 to 74,411,25,4,21,75,52,23,56,83,75,9,6,3,13
S01006895,Very good health,173,14,2,12,39,21,8,23,35,20,4,3,1,9
S01006895,Good health,182,9,2,7,31,26,10,26,32,42,3,2,1,3
S01006895,Fair health,42,2,0,2,3,3,3,6,12,10,2,1,1,1
S01006895,Bad health,10,0,0,0,1,2,1,1,3,2,0,0,0,0
S01006895,Very bad health,4,0,0,0,1,0,1,0,1,1,0,0,0,0
S01006896,All people aged 16 to 74,606,58,16,42,132,91,25,75,84,93,13,6,7,35
S01006896,Very good health,321,34,9,25,75,48,10,36,46,44,3,1,2,25
S01006896,Good health,223,23,7,16,46,34,10,34,27,35,6,2,4,8
S01006896,Fair health,46,1,0,1,9,5,3,5,9,10,2,1,1,2
S01006896,Bad health,14,0,0,0,2,4,2,0,1,3,2,2,0,0
S01006896,Very bad health,2,0,0,0,0,0,0,0,1,1,0,0,0,0
S01006897,All people aged 16 to 74,572,62,14,48,128,79,30,78,101,54,9,3,6,31
S01006897,Very good health,336,42,7,35,84,49,17,39,51,23,3,1,2,28
S01006897,Good health,188,17,7,10,39,25,11,34,35,20,5,2,3,2
S01006897,Fair health,34,1,0,1,4,5,2,5,8,8,0,0,0,1
S01006897,Bad health,10,2,0,2,1,0,0,0,4,2,1,0,1,0
S01006897,Very bad health,4,0,0,0,0,0,0,0,3,1,0,0,0,0
S01006898,All people aged 16 to 74,559,48,7,41,133,80,34,48,104,77,14,13,1,21
S01006898,Very good health,294,30,6,24,81,38,20,23,41,36,6,5,1,19
S01006898,Good health,194,15,0,15,44,32,7,20,44,29,2,2,0,1
S01006898,Fair health,54,2,1,1,8,8,6,4,12,11,3,3,0,0
S01006898,Bad health,16,1,0,1,0,2,1,1,6,1,3,3,0,1
S01006898,Very bad health,1,0,0,0,0,0,0,0,1,0,0,0,0,0
S01006899,All people aged 16 to 74,462,65,17,48,127,86,19,40,53,39,5,3,2,28
S01006899,Very good health,278,42,10,32,75,52,12,26,21,23,2,2,0,25
S01006899,Good health,146,19,7,12,43,27,4,14,22,13,2,1,1,2
S01006899,Fair health,28,3,0,3,8,4,2,0,8,2,1,0,1,0
S01006899,Bad health,7,1,0,1,1,1,1,0,2,0,0,0,0,1
S01006899,Very bad health,3,0,0,0,0,2,0,0,0,1,0,0,0,0
S01006900,All people aged 16 to 74,467,47,14,33,97,76,19,46,75,66,9,8,1,32
S01006900,Very good health,272,29,8,21,60,41,7,30,45,34,0,0,0,26
S01006900,Good health,160,15,5,10,31,28,10,15,25,27,5,4,1,4
S01006900,Fair health,31,3,1,2,4,7,2,1,5,4,3,3,0,2
S01006900,Bad health,2,0,0,0,2,0,0,0,0,0,0,0,0,0
S01006900,Very bad health,2,0,0,0,0,0,0,0,0,1,1,1,0,0
S01006901,All people aged 16 to 74,460,24,8,16,97,57,18,55,89,87,8,5,3,25
S01006901,Very good health,218,13,3,10,43,24,9,29,39,42,3,3,0,16
S01006901,Good health,178,8,4,4,47,25,6,16,34,29,4,2,2,9
S01006901,Fair health,47,3,1,2,7,5,3,5,11,12,1,0,1,0
S01006901,Bad health,17,0,0,0,0,3,0,5,5,4,0,0,0,0
S01006901,Very bad health,0,0,0,0,0,0,0,0,0,0,0,0,0,0
S01006902,All people aged 16 to 74,502,38,11,27,113,68,25,49,90,76,14,9,5,29
S01006902,Very good health,253,20,4,16,63,32,14,20,41,35,3,2,1,25
S01006902,Good health,180,14,5,9,38,29,9,20,35,29,4,3,1,2
S01006902,Fair health,52,3,1,2,11,4,2,5,12,9,4,2,2,2
S01006902,Bad health,13,0,0,0,1,1,0,4,2,3,2,2,0,0
S01006902,Very bad health,4,1,1,0,0,2,0,0,0,0,1,0,1,0
S01006903,All people aged 16 to 74,587,41,5,36,104,66,31,54,116,124,20,16,4,31
S01006903,Very good health,280,25,2,23,53,29,21,24,43,55,5,2,3,25
S01006903,Good health,225,14,3,11,41,28,10,20,52,46,9,9,0,5
S01006903,Fair health,60,2,0,2,6,6,0,7,18,16,4,3,1,1
S01006903,Bad health,17,0,0,0,3,2,0,2,2,7,1,1,0,0
S01006903,Very bad health,5,0,0,0,1,1,0,1,1,0,1,1,0,0
S01006904,All people aged 16 to 74,491,48,7,41,106,70,27,57,74,69,4,3,1,36
S01006904,Very good health,253,29,4,25,58,36,17,28,29,28,2,1,1,26
S01006904,Good health,175,18,3,15,41,23,6,23,25,31,1,1,0,7
S01006904,Fair health,43,1,0,1,4,8,2,3,14,9,1,1,0,1
S01006904,Bad health,15,0,0,0,2,2,2,3,5,0,0,0,0,1
S01006904,Very bad health,5,0,0,0,1,1,0,0,1,1,0,0,0,1
S01006905,All people aged 16 to 74,645,72,19,53,145,68,70,67,112,72,14,12,2,25
S01006905,Very good health,332,47,11,36,78,43,35,27,53,26,1,0,1,22
S01006905,Good health,227,24,8,16,50,17,28,29,39,31,7,6,1,2
S01006905,Fair health,63,1,0,1,13,4,5,8,14,13,4,4,0,1
S01006905,Bad health,21,0,0,0,3,4,2,2,6,2,2,2,0,0
S01006905,Very bad health,2,0,0,0,1,0,0,1,0,0,0,0,0,0
S01006906,All people aged 16 to 74,582,25,5,20,95,82,33,68,115,124,19,12,7,21
S01006906,Very good health,234,11,3,8,51,33,19,30,37,35,6,3,3,12
S01006906,Good health,237,10,2,8,31,31,8,27,54,62,7,5,2,7
S01006906,Fair health,86,3,0,3,11,14,5,9,16,21,5,3,2,2
S01006906,Bad health,18,1,0,1,2,3,1,1,4,5,1,1,0,0
S01006906,Very bad health,7,0,0,0,0,1,0,1,4,1,0,0,0,0
S01006907,All people aged 16 to 74,480,27,7,20,105,62,38,55,64,92,20,16,4,17
S01006907,Very good health,242,15,3,12,58,37,20,31,30,32,5,5,0,14
S01006907,Good health,178,11,3,8,34,18,15,14,28,46,9,7,2,3
S01006907,Fair health,51,1,1,0,11,7,3,10,6,8,5,3,2,0
S01006907,Bad health,4,0,0,0,0,0,0,0,0,3,1,1,0,0
S01006907,Very bad health,5,0,0,0,2,0,0,0,0,3,0,0,0,0
S01006908,All people aged 16 to 74,618,40,7,33,131,76,33,77,102,115,18,7,11,26
S01006908,Very good health,290,30,7,23,82,33,15,32,40,38,4,1,3,16
S01006908,Good health,225,9,0,9,35,35,6,27,43,52,9,3,6,9
S01006908,Fair health,80,1,0,1,11,6,10,17,12,19,3,1,2,1
S01006908,Bad health,18,0,0,0,3,1,1,1,5,5,2,2,0,0
S01006908,Very bad health,5,0,0,0,0,1,1,0,2,1,0,0,0,0
S01006909,All people aged 16 to 74,552,103,24,79,151,97,46,48,52,28,4,3,1,23
S01006909,Very good health,368,77,18,59,105,57,26,31,31,17,3,2,1,21
S01006909,Good health,158,22,6,16,44,32,15,15,18,9,1,1,0,2
S01006909,Fair health,22,4,0,4,2,7,3,2,2,2,0,0,0,0
S01006909,Bad health,3,0,0,0,0,1,2,0,0,0,0,0,0,0
S01006909,Very bad health,1,0,0,0,0,0,0,0,1,0,0,0,0,0
S01006910,All people aged 16 to 74,665,118,20,98,183,75,85,38,56,54,14,10,4,42
S01006910,Very good health,389,77,12,65,109,41,43,19,30,27,7,5,2,36
S01006910,Good health,234,35,7,28,65,30,31,18,24,19,6,4,2,6
S01006910,Fair health,29,6,1,5,6,4,8,1,0,4,0,0,0,0
S01006910,Bad health,12,0,0,0,3,0,3,0,2,3,1,1,0,0
S01006910,Very bad health,1,0,0,0,0,0,0,0,0,1,0,0,0,0
S01006911,All people aged 16 to 74,450,95,15,80,139,54,26,41,35,32,5,3,2,23
S01006911,Very good health,283,65,11,54,91,31,14,21,20,16,3,2,1,22
S01006911,Good health,141,26,3,23,43,18,11,16,12,12,2,1,1,1
S01006911,Fair health,23,4,1,3,4,5,1,2,3,4,0,0,0,0
S01006911,Bad health,3,0,0,0,1,0,0,2,0,0,0,0,0,0
S01006911,Very bad health,0,0,0,0,0,0,0,0,0,0,0,0,0,0
S01006912,All people aged 16 to 74,364,49,6,43,99,27,50,23,58,33,4,1,3,21
S01006912,Very good health,207,29,3,26,48,17,29,13,32,20,2,0,2,17
S01006912,Good health,122,17,1,16,40,9,16,7,19,10,1,1,0,3
S01006912,Fair health,29,3,2,1,9,1,4,3,6,1,1,0,1,1
S01006912,Bad health,6,0,0,0,2,0,1,0,1,2,0,0,0,0
S01006912,Very bad health,0,0,0,0,0,0,0,0,0,0,0,0,0,0
S01006913,All people aged 16 to 74,380,62,13,49,110,62,30,24,43,23,3,1,2,23
S01006913,Very good health,272,47,8,39,80,45,23,18,27,8,2,1,1,22
S01006913,Good health,90,14,5,9,26,15,5,5,13,10,1,0,1,1
S01006913,Fair health,16,1,0,1,4,2,2,1,2,4,0,0,0,0
S01006913,Bad health,2,0,0,0,0,0,0,0,1,1,0,0,0,0
S01006913,Very bad health,0,0,0,0,0,0,0,0,0,0,0,0,0,0
S01006914,All people aged 16 to 74,557,100,21,79,124,63,65,55,51,57,2,0,2,40
S01006914,Very good health,334,49,9,40,80,42,33,36,29,30,1,0,1,34
S01006914,Good health,177,42,8,34,39,16,27,14,16,17,1,0,1,5
S01006914,Fair health,39,8,3,5,5,2,5,3,5,10,0,0,0,1
S01006914,Bad health,7,1,1,0,0,3,0,2,1,0,0,0,0,0
S01006914,Very bad health,0,0,0,0,0,0,0,0,0,0,0,0,0,0
S01006915,All people aged 16 to 74,609,92,17,75,147,78,70,60,64,56,10,9,1,32
S01006915,Very good health,339,58,12,46,76,49,34,31,30,29,6,5,1,26
S01006915,Good health,210,31,4,27,54,21,30,19,25,22,2,2,0,6
S01006915,Fair health,49,2,1,1,15,6,4,8,7,5,2,2,0,0
S01006915,Bad health,6,0,0,0,2,1,1,0,2,0,0,0,0,0
S01006915,Very bad health,5,1,0,1,0,1,1,2,0,0,0,0,0,0
S01006916,All people aged 16 to 74,391,52,11,41,94,61,19,42,61,32,6,4,2,24
S01006916,Very good health,262,38,9,29,60,43,11,30,36,18,5,3,2,21
S01006916,Good health,101,13,2,11,29,14,7,9,18,9,0,0,0,2
S01006916,Fair health,20,1,0,1,5,3,1,3,4,2,1,1,0,0
S01006916,Bad health,6,0,0,0,0,0,0,0,3,2,0,0,0,1
S01006916,Very bad health,2,0,0,0,0,1,0,0,0,1,0,0,0,0
S01006917,All people aged 16 to 74,637,138,26,112,179,114,55,51,44,29,4,0,4,23
S01006917,Very good health,439,97,21,76,134,80,32,32,28,14,2,0,2,20
S01006917,Good health,175,37,5,32,42,29,20,16,15,11,2,0,2,3
S01006917,Fair health,17,3,0,3,3,2,3,3,1,2,0,0,0,0
S01006917,Bad health,4,1,0,1,0,1,0,0,0,2,0,0,0,0
S01006917,Very bad health,2,0,0,0,0,2,0,0,0,0,0,0,0,0
S01006918,All people aged 16 to 74,349,60,13,47,82,58,29,27,37,35,6,3,3,15
S01006918,Very good health,221,42,10,32,60,34,14,19,18,19,2,2,0,13
S01006918,Good health,94,17,3,14,18,15,13,5,13,10,1,1,0,2
S01006918,Fair health,26,1,0,1,4,7,1,3,3,4,3,0,3,0
S01006918,Bad health,7,0,0,0,0,2,1,0,3,1,0,0,0,0
S01006918,Very bad health,1,0,0,0,0,0,0,0,0,1,0,0,0,0
S01006919,All people aged 16 to 74,380,46,8,38,101,55,33,35,46,34,7,5,2,23
S01006919,Very good health,217,26,5,21,59,29,18,19,26,17,1,1,0,22
S01006919,Good health,130,17,3,14,33,25,8,13,16,13,4,3,1,1
S01006919,Fair health,25,2,0,2,6,1,5,3,3,3,2,1,1,0
S01006919,Bad health,7,1,0,1,2,0,2,0,1,1,0,0,0,0
S01006919,Very bad health,1,0,0,0,1,0,0,0,0,0,0,0,0,0
S01006920,All people aged 16 to 74,355,41,12,29,95,55,26,32,63,28,3,1,2,12
S01006920,Very good health,180,29,5,24,47,32,12,17,21,12,2,1,1,8
S01006920,Good health,135,9,4,5,43,21,11,10,28,8,1,0,1,4
S01006920,Fair health,31,3,3,0,3,2,3,3,10,7,0,0,0,0
S01006920,Bad health,9,0,0,0,2,0,0,2,4,1,0,0,0,0
S01006920,Very bad health,0,0,0,0,0,0,0,0,0,0,0,0,0,0
S01006921,All people aged 16 to 74,551,89,15,74,180,79,24,51,62,30,4,2,2,32
S01006921,Very good health,352,63,10,53,118,50,14,34,29,18,2,1,1,24
S01006921,Good health,172,24,5,19,53,28,9,15,28,10,1,0,1,4
S01006921,Fair health,21,2,0,2,7,0,1,2,5,1,1,1,0,2
S01006921,Bad health,3,0,0,0,0,1,0,0,0,1,0,0,0,1
S01006921,Very bad health,3,0,0,0,2,0,0,0,0,0,0,0,0,1
S01006922,All people aged 16 to 74,385,67,17,50,80,37,54,20,71,32,4,2,2,20
S01006922,Very good health,215,43,12,31,49,18,28,13,36,12,2,1,1,14
S01006922,Good health,140,22,4,18,25,19,19,5,27,18,0,0,0,5
S01006922,Fair health,23,2,1,1,5,0,6,2,4,2,1,0,1,1
S01006922,Bad health,5,0,0,0,1,0,1,0,2,0,1,1,0,0
S01006922,Very bad health,2,0,0,0,0,0,0,0,2,0,0,0,0,0
S01006923,All people aged 16 to 74,554,88,24,64,132,77,64,49,75,38,12,8,4,19
S01006923,Very good health,286,50,15,35,73,36,28,25,36,21,2,2,0,15
S01006923,Good health,214,32,9,23,53,30,31,18,31,10,5,3,2,4
S01006923,Fair health,42,6,0,6,4,5,3,4,8,7,5,3,2,0
S01006923,Bad health,9,0,0,0,0,6,2,1,0,0,0,0,0,0
S01006923,Very bad health,3,0,0,0,2,0,0,1,0,0,0,0,0,0
S01006924,All people aged 16 to 74,426,71,22,49,122,36,73,31,43,21,3,1,2,26
S01006924,Very good health,230,40,11,29,67,18,36,18,23,9,1,0,1,18
S01006924,Good health,165,28,11,17,49,18,26,10,13,11,2,1,1,8
S01006924,Fair health,26,3,0,3,4,0,10,2,6,1,0,0,0,0
S01006924,Bad health,5,0,0,0,2,0,1,1,1,0,0,0,0,0
S01006924,Very bad health,0,0,0,0,0,0,0,0,0,0,0,0,0,0
S01006925,All people aged 16 to 74,375,55,10,45,95,65,23,28,48,34,5,3,2,22
S01006925,Very good health,198,24,2,22,51,33,10,20,21,19,3,1,2,17
S01006925,Good health,148,26,6,20,37,28,9,6,24,11,2,2,0,5
S01006925,Fair health,20,2,2,0,5,4,3,1,1,4,0,0,0,0
S01006925,Bad health,8,3,0,3,1,0,1,1,2,0,0,0,0,0
S01006925,Very bad health,1,0,0,0,1,0,0,0,0,0,0,0,0,0
S01006926,All people aged 16 to 74,528,97,20,77,143,98,31,48,66,23,6,2,4,16
S01006926,Very good health,336,74,15,59,91,55,18,30,42,12,3,1,2,11
S01006926,Good health,150,17,5,12,41,35,10,15,18,7,2,1,1,5
S01006926,Fair health,27,4,0,4,8,3,3,2,4,2,1,0,1,0
S01006926,Bad health,7,1,0,1,1,2,0,1,0,2,0,0,0,0
S01006926,Very bad health,8,1,0,1,2,3,0,0,2,0,0,0,0,0
S01006927,All people aged 16 to 74,703,148,19,129,208,134,40,55,56,30,14,5,9,18
S01006927,Very good health,483,115,14,101,148,90,24,37,33,18,7,3,4,11
S01006927,Good health,183,28,4,24,53,38,11,13,17,9,7,2,5,7
S01006927,Fair health,30,5,1,4,6,5,4,5,4,1,0,0,0,0
S01006927,Bad health,5,0,0,0,0,1,1,0,2,1,0,0,0,0
S01006927,Very bad health,2,0,0,0,1,0,0,0,0,1,0,0,0,0
S01006928,All people aged 16 to 74,776,98,9,89,186,115,60,94,94,80,8,6,2,41
S01006928,Very good health,412,62,6,56,118,61,29,39,43,25,1,0,1,34
S01006928,Good health,273,31,2,29,57,41,25,39,36,35,2,1,1,7
S01006928,Fair health,67,4,0,4,6,10,5,13,10,17,2,2,0,0
S01006928,Bad health,19,1,1,0,4,1,1,3,5,2,2,2,0,0
S01006928,Very bad health,5,0,0,0,1,2,0,0,0,1,1,1,0,0
S01006929,All people aged 16 to 74,623,166,44,122,170,98,38,23,41,18,13,6,7,56
S01006929,Very good health,414,111,31,80,112,63,23,15,23,12,2,0,2,53
S01006929,Good health,171,48,10,38,51,30,10,7,12,4,6,4,2,3
S01006929,Fair health,31,7,3,4,6,3,5,1,5,0,4,1,3,0
S01006929,Bad health,5,0,0,0,1,2,0,0,1,1,0,0,0,0
S01006929,Very bad health,2,0,0,0,0,0,0,0,0,1,1,1,0,0
S01006930,All people aged 16 to 74,719,137,37,100,217,108,44,48,57,29,14,6,8,65
S01006930,Very good health,450,92,20,72,134,62,23,35,28,15,5,2,3,56
S01006930,Good health,211,36,13,23,68,39,17,9,20,10,5,1,4,7
S01006930,Fair health,48,9,4,5,12,5,4,3,7,3,3,2,1,2
S01006930,Bad health,7,0,0,0,3,1,0,1,1,1,0,0,0,0
S01006930,Very bad health,3,0,0,0,0,1,0,0,1,0,1,1,0,0
S01006931,All people aged 16 to 74,289,56,8,48,75,40,34,15,23,20,4,3,1,22
S01006931,Very good health,190,39,7,32,53,27,15,9,15,12,2,2,0,18
S01006931,Good health,81,15,1,14,19,10,14,4,7,7,2,1,1,3
S01006931,Fair health,15,2,0,2,3,3,3,2,1,1,0,0,0,0
S01006931,Bad health,3,0,0,0,0,0,2,0,0,0,0,0,0,1
S01006931,Very bad health,0,0,0,0,0,0,0,0,0,0,0,0,0,0
S01006932,All people aged 16 to 74,433,64,17,47,123,71,34,23,36,27,5,3,2,50
S01006932,Very good health,304,49,17,32,91,51,24,12,19,14,3,1,2,41
S01006932,Good health,103,14,0,14,25,17,9,8,13,9,2,2,0,6
S01006932,Fair health,21,1,0,1,7,3,1,2,2,3,0,0,0,2
S01006932,Bad health,4,0,0,0,0,0,0,1,2,0,0,0,0,1
S01006932,Very bad health,1,0,0,0,0,0,0,0,0,1,0,0,0,0
S01006933,All people aged 16 to 74,474,79,6,73,122,79,24,30,62,28,6,3,3,44
S01006933,Very good health,285,46,5,41,72,40,9,18,41,19,5,2,3,35
S01006933,Good health,159,29,1,28,43,31,11,11,17,9,1,1,0,7
S01006933,Fair health,24,4,0,4,6,8,2,1,3,0,0,0,0,0
S01006933,Bad health,5,0,0,0,0,0,2,0,1,0,0,0,0,2
S01006933,Very bad health,1,0,0,0,1,0,0,0,0,0,0,0,0,0
S01006934,All people aged 16 to 74,448,69,13,56,94,56,50,39,55,42,18,16,2,25
S01006934,Very good health,250,51,7,44,60,31,24,13,25,19,4,4,0,23
S01006934,Good health,148,17,5,12,27,23,21,15,21,15,7,6,1,2
S01006934,Fair health,36,1,1,0,5,1,3,10,4,5,7,6,1,0
S01006934,Bad health,13,0,0,0,1,1,2,1,5,3,0,0,0,0
S01006934,Very bad health,1,0,0,0,1,0,0,0,0,0,0,0,0,0
S01006935,All people aged 16 to 74,535,82,19,63,151,87,35,37,62,35,8,6,2,38
S01006935,Very good health,292,45,10,35,86,46,14,16,29,19,3,2,1,34
S01006935,Good health,187,30,9,21,51,30,14,18,25,12,4,3,1,3
S01006935,Fair health,47,7,0,7,11,10,7,3,4,3,1,1,0,1
S01006935,Bad health,8,0,0,0,2,1,0,0,4,1,0,0,0,0
S01006935,Very bad health,1,0,0,0,1,0,0,0,0,0,0,0,0,0
S01006936,All people aged 16 to 74,480,60,15,45,148,81,25,35,64,32,7,4,3,28
S01006936,Very good health,246,35,10,25,76,42,10,19,24,14,3,2,1,23
S01006936,Good health,188,20,4,16,59,37,10,12,27,16,2,0,2,5
S01006936,Fair health,38,4,1,3,13,1,5,4,8,1,2,2,0,0
S01006936,Bad health,5,0,0,0,0,1,0,0,3,1,0,0,0,0
S01006936,Very bad health,3,1,0,1,0,0,0,0,2,0,0,0,0,0
S01006937,All people aged 16 to 74,565,66,11,55,166,97,34,47,71,34,9,4,5,41
S01006937,Very good health,301,40,9,31,89,47,17,22,34,19,5,1,4,28
S01006937,Good health,204,20,1,19,65,38,13,21,25,9,1,0,1,12
S01006937,Fair health,47,6,1,5,10,9,3,4,9,4,1,1,0,1
S01006937,Bad health,13,0,0,0,2,3,1,0,3,2,2,2,0,0
S01006937,Very bad health,0,0,0,0,0,0,0,0,0,0,0,0,0,0
S01006938,All people aged 16 to 74,382,50,9,41,90,65,21,40,62,27,2,1,1,25
S01006938,Very good health,222,28,4,24,54,40,11,23,36,14,0,0,0,16
S01006938,Good health,123,19,5,14,29,20,8,13,16,10,1,0,1,7
S01006938,Fair health,29,3,0,3,5,4,2,2,7,3,1,1,0,2
S01006938,Bad health,4,0,0,0,1,1,0,1,1,0,0,0,0,0
S01006938,Very bad health,4,0,0,0,1,0,0,1,2,0,0,0,0,0
S01006939,All people aged 16 to 74,481,86,23,63,129,91,22,25,57,32,1,0,1,38
S01006939,Very good health,274,53,17,36,72,42,11,12,35,20,1,0,1,28
S01006939,Good health,176,31,6,25,50,41,8,10,20,9,0,0,0,7
S01006939,Fair health,27,2,0,2,6,8,1,3,2,3,0,0,0,2
S01006939,Bad health,3,0,0,0,1,0,1,0,0,0,0,0,0,1
S01006939,Very bad health,1,0,0,0,0,0,1,0,0,0,0,0,0,0
S01006940,All people aged 16 to 74,743,118,22,96,212,118,45,55,75,41,11,10,1,68
S01006940,Very good health,446,78,19,59,130,64,25,28,41,16,5,4,1,59
S01006940,Good health,240,34,3,31,73,41,16,22,26,14,5,5,0,9
S01006940,Fair health,45,3,0,3,6,12,4,4,6,9,1,1,0,0
S01006940,Bad health,9,1,0,1,3,1,0,1,1,2,0,0,0,0
S01006940,Very bad health,3,2,0,2,0,0,0,0,1,0,0,0,0,0
S01006941,All people aged 16 to 74,458,54,7,47,115,75,25,37,61,43,9,6,3,39
S01006941,Very good health,258,34,5,29,67,42,11,23,37,9,3,1,2,32
S01006941,Good health,153,15,1,14,41,25,8,9,21,22,6,5,1,6
S01006941,Fair health,38,2,1,1,5,7,6,4,2,11,0,0,0,1
S01006941,Bad health,6,2,0,2,2,1,0,0,0,1,0,0,0,0
S01006941,Very bad health,3,1,0,1,0,0,0,1,1,0,0,0,0,0
S01006942,All people aged 16 to 74,793,120,31,89,205,132,57,60,100,33,7,4,3,79
S01006942,Very good health,483,75,18,57,130,73,33,37,53,14,1,1,0,67
S01006942,Good health,246,37,12,25,62,48,19,18,33,15,4,1,3,10
S01006942,Fair health,50,7,1,6,10,8,5,4,9,4,2,2,0,1
S01006942,Bad health,11,1,0,1,2,2,0,0,5,0,0,0,0,1
S01006942,Very bad health,3,0,0,0,1,1,0,1,0,0,0,0,0,0
S01006943,All people aged 16 to 74,441,109,21,88,142,56,25,20,38,15,7,2,5,29
S01006943,Very good health,333,85,17,68,106,36,19,16,25,12,5,1,4,29
S01006943,Good health,95,23,4,19,33,14,6,3,12,2,2,1,1,0
S01006943,Fair health,10,1,0,1,2,5,0,1,0,1,0,0,0,0
S01006943,Bad health,2,0,0,0,1,1,0,0,0,0,0,0,0,0
S01006943,Very bad health,1,0,0,0,0,0,0,0,1,0,0,0,0,0
S01006944,All people aged 16 to 74,616,105,21,84,177,119,31,49,55,30,8,4,4,42
S01006944,Very good health,411,71,13,58,118,83,21,32,28,21,3,2,1,34
S01006944,Good health,175,28,6,22,57,32,9,12,23,5,3,2,1,6
S01006944,Fair health,22,4,1,3,1,3,1,4,3,2,2,0,2,2
S01006944,Bad health,8,2,1,1,1,1,0,1,1,2,0,0,0,0
S01006944,Very bad health,0,0,0,0,0,0,0,0,0,0,0,0,0,0
S01006945,All people aged 16 to 74,409,72,19,53,115,60,30,30,47,22,6,4,2,27
S01006945,Very good health,224,38,10,28,68,33,11,13,22,14,3,2,1,22
S01006945,Good health,152,31,7,24,33,23,17,14,18,8,3,2,1,5
S01006945,Fair health,24,2,1,1,11,3,1,2,5,0,0,0,0,0
S01006945,Bad health,8,0,0,0,3,1,1,1,2,0,0,0,0,0
S01006945,Very bad health,1,1,1,0,0,0,0,0,0,0,0,0,0,0
S01006946,All people aged 16 to 74,621,102,23,79,186,84,45,47,63,45,8,4,4,41
S01006946,Very good health,380,62,13,49,114,46,28,31,31,24,5,3,2,39
S01006946,Good health,198,33,10,23,63,30,14,13,27,15,2,0,2,1
S01006946,Fair health,35,7,0,7,7,7,3,2,3,4,1,1,0,1
S01006946,Bad health,8,0,0,0,2,1,0,1,2,2,0,0,0,0
S01006946,Very bad health,0,0,0,0,0,0,0,0,0,0,0,0,0,0
S01006947,All people aged 16 to 74,609,91,15,76,161,107,33,61,60,51,8,5,3,37
S01006947,Very good health,354,59,13,46,99,66,23,30,29,19,4,2,2,25
S01006947,Good health,211,28,1,27,51,37,9,25,26,22,3,2,1,10
S01006947,Fair health,38,4,1,3,10,2,1,6,5,7,1,1,0,2
S01006947,Bad health,5,0,0,0,0,2,0,0,0,3,0,0,0,0
S01006947,Very bad health,1,0,0,0,1,0,0,0,0,0,0,0,0,0
S01006948,All people aged 16 to 74,657,91,26,65,172,99,69,52,84,49,6,3,3,35
S01006948,Very good health,352,58,14,44,99,52,28,30,39,15,4,2,2,27
S01006948,Good health,221,29,12,17,52,35,28,16,34,20,0,0,0,7
S01006948,Fair health,69,4,0,4,17,10,11,4,10,11,1,0,1,1
S01006948,Bad health,14,0,0,0,4,1,2,2,1,3,1,1,0,0
S01006948,Very bad health,1,0,0,0,0,1,0,0,0,0,0,0,0,0
S01006949,All people aged 16 to 74,489,103,22,81,133,65,52,34,42,22,8,7,1,30
S01006949,Very good health,293,63,14,49,86,44,23,18,21,10,3,3,0,25
S01006949,Good health,154,33,7,26,38,19,21,15,12,8,5,4,1,3
S01006949,Fair health,32,6,1,5,7,1,5,1,6,4,0,0,0,2
S01006949,Bad health,8,1,0,1,1,1,2,0,3,0,0,0,0,0
S01006949,Very bad health,2,0,0,0,1,0,1,0,0,0,0,0,0,0
S01006950,All people aged 16 to 74,379,72,10,62,107,47,21,49,42,28,1,1,0,12
S01006950,Very good health,242,52,9,43,75,29,15,26,22,13,1,1,0,9
S01006950,Good health,106,16,1,15,28,14,5,15,15,10,0,0,0,3
S01006950,Fair health,20,3,0,3,3,1,1,5,4,3,0,0,0,0
S01006950,Bad health,7,1,0,1,0,3,0,0,1,2,0,0,0,0
S01006950,Very bad health,4,0,0,0,1,0,0,3,0,0,0,0,0,0
S01006951,All people aged 16 to 74,361,31,8,23,91,60,22,50,50,34,6,3,3,17
S01006951,Very good health,184,23,6,17,51,36,12,24,13,13,0,0,0,12
S01006951,Good health,140,4,1,3,33,21,8,21,31,14,3,1,2,5
S01006951,Fair health,33,4,1,3,6,3,2,5,3,7,3,2,1,0
S01006951,Bad health,3,0,0,0,1,0,0,0,2,0,0,0,0,0
S01006951,Very bad health,1,0,0,0,0,0,0,0,1,0,0,0,0,0
S01006952,All people aged 16 to 74,667,89,21,68,132,98,82,60,91,72,3,2,1,40
S01006952,Very good health,312,39,7,32,61,44,42,31,42,22,2,1,1,29
S01006952,Good health,265,42,13,29,54,43,29,20,36,31,1,1,0,9
S01006952,Fair health,73,6,1,5,17,10,9,4,11,14,0,0,0,2
S01006952,Bad health,14,1,0,1,0,1,1,4,2,5,0,0,0,0
S01006952,Very bad health,3,1,0,1,0,0,1,1,0,0,0,0,0,0
S01006953,All people aged 16 to 74,608,111,29,82,158,85,57,50,69,32,7,6,1,39
S01006953,Very good health,354,68,18,50,95,46,23,30,36,17,5,4,1,34
S01006953,Good health,208,37,9,28,55,28,25,18,26,13,2,2,0,4
S01006953,Fair health,39,6,2,4,7,8,8,2,6,1,0,0,0,1
S01006953,Bad health,7,0,0,0,1,3,1,0,1,1,0,0,0,0
S01006953,Very bad health,0,0,0,0,0,0,0,0,0,0,0,0,0,0
S01006954,All people aged 16 to 74,621,76,16,60,180,90,50,64,68,46,5,2,3,42
S01006954,Very good health,353,49,12,37,109,48,23,35,35,19,1,0,1,34
S01006954,Good health,211,23,3,20,63,34,16,19,22,22,4,2,2,8
S01006954,Fair health,43,4,1,3,6,6,7,9,8,3,0,0,0,0
S01006954,Bad health,13,0,0,0,2,2,4,0,3,2,0,0,0,0
S01006954,Very bad health,1,0,0,0,0,0,0,1,0,0,0,0,0,0
S01006955,All people aged 16 to 74,455,40,9,31,112,75,32,54,61,48,7,5,2,26
S01006955,Very good health,222,18,3,15,64,39,17,22,23,16,1,0,1,22
S01006955,Good health,165,19,6,13,41,28,10,22,23,18,2,1,1,2
S01006955,Fair health,51,3,0,3,6,6,2,7,13,11,1,1,0,2
S01006955,Bad health,12,0,0,0,1,1,2,2,2,2,2,2,0,0
S01006955,Very bad health,5,0,0,0,0,1,1,1,0,1,1,1,0,0
S01006956,All people aged 16 to 74,804,113,18,95,250,104,46,93,83,47,13,7,6,55
S01006956,Very good health,485,74,13,61,169,61,22,55,42,16,4,3,1,42
S01006956,Good health,249,32,2,30,67,31,17,34,34,18,4,2,2,12
S01006956,Fair health,50,6,2,4,10,8,5,4,4,8,4,1,3,1
S01006956,Bad health,16,0,0,0,4,4,2,0,2,3,1,1,0,0
S01006956,Very bad health,4,1,1,0,0,0,0,0,1,2,0,0,0,0
S01006957,All people aged 16 to 74,779,115,20,95,203,119,89,73,78,37,10,7,3,55
S01006957,Very good health,485,75,11,64,139,72,53,39,39,17,4,3,1,47
S01006957,Good health,241,34,6,28,55,35,30,27,33,13,6,4,2,8
S01006957,Fair health,44,4,2,2,8,10,6,6,5,5,0,0,0,0
S01006957,Bad health,7,1,1,0,1,2,0,1,1,1,0,0,0,0
S01006957,Very bad health,2,1,0,1,0,0,0,0,0,1,0,0,0,0
S01006958,All people aged 16 to 74,665,77,13,64,192,88,52,54,96,59,12,9,3,35
S01006958,Very good health,331,36,8,28,92,43,25,33,46,26,6,4,2,24
S01006958,Good health,259,33,5,28,78,36,21,15,35,26,5,4,1,10
S01006958,Fair health,57,5,0,5,15,8,5,5,14,3,1,1,0,1
S01006958,Bad health,13,3,0,3,5,0,1,0,1,3,0,0,0,0
S01006958,Very bad health,5,0,0,0,2,1,0,1,0,1,0,0,0,0
S01006959,All people aged 16 to 74,484,47,8,39,107,52,33,45,74,77,19,12,7,30
S01006959,Very good health,236,23,3,20,61,28,15,25,30,26,7,6,1,21
S01006959,Good health,170,18,5,13,33,17,9,15,31,31,7,4,3,9
S01006959,Fair health,56,4,0,4,9,5,7,5,7,15,4,1,3,0
S01006959,Bad health,16,1,0,1,3,2,1,0,5,3,1,1,0,0
S01006959,Very bad health,6,1,0,1,1,0,1,0,1,2,0,0,0,0
S01006960,All people aged 16 to 74,674,127,41,86,174,96,51,61,69,31,16,10,6,49
S01006960,Very good health,441,93,31,62,120,66,24,41,39,15,9,6,3,34
S01006960,Good health,189,30,10,20,46,24,20,17,22,14,3,2,1,13
S01006960,Fair health,32,3,0,3,5,6,4,2,4,2,4,2,2,2
S01006960,Bad health,10,1,0,1,3,0,2,1,3,0,0,0,0,0
S01006960,Very bad health,2,0,0,0,0,0,1,0,1,0,0,0,0,0
S01006961,All people aged 16 to 74,665,95,17,78,218,103,38,52,69,38,6,3,3,46
S01006961,Very good health,444,68,10,58,144,64,25,32,39,27,3,1,2,42
S01006961,Good health,198,26,7,19,65,38,12,18,24,9,2,1,1,4
S01006961,Fair health,23,1,0,1,9,1,1,2,6,2,1,1,0,0
S01006961,Bad health,0,0,0,0,0,0,0,0,0,0,0,0,0,0
S01006961,Very bad health,0,0,0,0,0,0,0,0,0,0,0,0,0,0
S01006962,All people aged 16 to 74,675,68,11,57,168,89,45,74,117,69,13,9,4,32
S01006962,Very good health,330,46,8,38,96,43,20,27,53,22,4,3,1,19
S01006962,Good health,270,17,2,15,58,33,15,44,52,34,7,4,3,10
S01006962,Fair health,67,5,1,4,12,11,10,2,12,11,1,1,0,3
S01006962,Bad health,8,0,0,0,2,2,0,1,0,2,1,1,0,0
S01006962,Very bad health,0,0,0,0,0,0,0,0,0,0,0,0,0,0
S01006963,All people aged 16 to 74,543,51,18,33,152,70,31,53,75,48,15,12,3,48
S01006963,Very good health,276,28,9,19,78,35,12,25,28,26,7,5,2,37
S01006963,Good health,206,20,8,12,56,32,12,22,37,15,3,3,0,9
S01006963,Fair health,51,3,1,2,14,3,5,4,9,6,5,4,1,2
S01006963,Bad health,5,0,0,0,2,0,2,0,0,1,0,0,0,0
S01006963,Very bad health,5,0,0,0,2,0,0,2,1,0,0,0,0,0
S01006964,All people aged 16 to 74,621,50,12,38,151,85,33,76,93,92,7,4,3,34
S01006964,Very good health,298,28,7,21,77,42,17,35,42,31,4,3,1,22
S01006964,Good health,251,21,4,17,59,35,9,33,35,47,2,0,2,10
S01006964,Fair health,59,1,1,0,14,8,4,6,14,10,0,0,0,2
S01006964,Bad health,10,0,0,0,1,0,3,2,1,2,1,1,0,0
S01006964,Very bad health,3,0,0,0,0,0,0,0,1,2,0,0,0,0
S01006965,All people aged 16 to 74,395,48,13,35,104,46,32,41,51,38,7,4,3,28
S01006965,Very good health,195,22,9,13,54,26,18,18,22,12,1,0,1,22
S01006965,Good health,149,24,4,20,38,16,10,16,20,18,3,2,1,4
S01006965,Fair health,41,2,0,2,12,3,2,7,8,5,1,0,1,1
S01006965,Bad health,7,0,0,0,0,1,2,0,0,2,1,1,0,1
S01006965,Very bad health,3,0,0,0,0,0,0,0,1,1,1,1,0,0
S01006966,All people aged 16 to 74,444,25,2,23,88,58,20,47,80,75,16,4,12,35
S01006966,Very good health,197,17,0,17,34,29,8,17,44,24,5,2,3,19
S01006966,Good health,180,7,2,5,39,21,8,21,26,38,6,0,6,14
S01006966,Fair health,50,1,0,1,12,5,3,8,8,8,3,0,3,2
S01006966,Bad health,13,0,0,0,3,3,0,0,2,4,1,1,0,0
S01006966,Very bad health,4,0,0,0,0,0,1,1,0,1,1,1,0,0
S01006967,All people aged 16 to 74,489,48,7,41,121,70,32,52,71,51,9,4,5,35
S01006967,Very good health,264,27,2,25,72,35,18,22,31,25,4,1,3,30
S01006967,Good health,191,20,5,15,43,27,12,28,34,19,3,2,1,5
S01006967,Fair health,27,0,0,0,6,4,2,2,4,7,2,1,1,0
S01006967,Bad health,7,1,0,1,0,4,0,0,2,0,0,0,0,0
S01006967,Very bad health,0,0,0,0,0,0,0,0,0,0,0,0,0,0
S01006968,All people aged 16 to 74,402,19,3,16,83,57,23,50,80,64,3,2,1,23
S01006968,Very good health,212,9,2,7,46,30,10,27,42,24,2,2,0,22
S01006968,Good health,137,8,1,7,27,15,8,18,28,31,1,0,1,1
S01006968,Fair health,40,2,0,2,7,10,2,3,8,8,0,0,0,0
S01006968,Bad health,12,0,0,0,3,1,3,2,2,1,0,0,0,0
S01006968,Very bad health,1,0,0,0,0,1,0,0,0,0,0,0,0,0
S01006969,All people aged 16 to 74,692,62,15,47,157,107,51,73,95,97,11,7,4,39
S01006969,Very good health,352,33,8,25,89,64,15,33,36,47,5,2,3,30
S01006969,Good health,248,22,5,17,55,35,21,27,43,34,3,2,1,8
S01006969,Fair health,74,7,2,5,11,6,9,12,13,13,2,2,0,1
S01006969,Bad health,14,0,0,0,2,2,4,0,3,3,0,0,0,0
S01006969,Very bad health,4,0,0,0,0,0,2,1,0,0,1,1,0,0
S01006970,All people aged 16 to 74,529,67,17,50,143,104,19,52,68,28,7,6,1,41
S01006970,Very good health,313,44,13,31,79,60,7,32,36,18,2,1,1,35
S01006970,Good health,173,20,4,16,57,33,11,17,23,8,0,0,0,4
S01006970,Fair health,35,1,0,1,7,9,1,2,8,1,5,5,0,1
S01006970,Bad health,6,2,0,2,0,0,0,1,1,1,0,0,0,1
S01006970,Very bad health,2,0,0,0,0,2,0,0,0,0,0,0,0,0
S01006971,All people aged 16 to 74,385,26,7,19,68,41,23,44,82,62,11,10,1,28
S01006971,Very good health,184,15,4,11,35,23,10,20,28,30,3,3,0,20
S01006971,Good health,143,8,2,6,29,12,11,18,34,19,6,5,1,6
S01006971,Fair health,46,2,1,1,3,5,1,6,16,9,2,2,0,2
S01006971,Bad health,9,1,0,1,1,1,1,0,3,2,0,0,0,0
S01006971,Very bad health,3,0,0,0,0,0,0,0,1,2,0,0,0,0
S01006972,All people aged 16 to 74,406,58,13,45,88,65,56,33,48,23,5,5,0,30
S01006972,Very good health,221,38,7,31,44,30,31,15,22,13,3,3,0,25
S01006972,Good health,139,19,5,14,32,24,22,9,21,6,1,1,0,5
S01006972,Fair health,37,1,1,0,9,9,3,9,4,2,0,0,0,0
S01006972,Bad health,8,0,0,0,2,2,0,0,1,2,1,1,0,0
S01006972,Very bad health,1,0,0,0,1,0,0,0,0,0,0,0,0,0
S01006973,All people aged 16 to 74,438,68,18,50,124,64,45,31,47,32,5,2,3,22
S01006973,Very good health,216,43,13,30,55,34,17,14,24,10,1,0,1,18
S01006973,Good health,159,20,4,16,48,24,21,12,12,15,3,2,1,4
S01006973,Fair health,46,4,1,3,15,4,5,3,9,6,0,0,0,0
S01006973,Bad health,13,1,0,1,5,1,1,2,1,1,1,0,1,0
S01006973,Very bad health,4,0,0,0,1,1,1,0,1,0,0,0,0,0
S01006974,All people aged 16 to 74,775,123,26,97,219,105,56,75,83,56,15,6,9,43
S01006974,Very good health,454,86,15,71,140,51,34,33,38,25,11,3,8,36
S01006974,Good health,257,35,10,25,68,44,17,35,32,17,4,3,1,5
S01006974,Fair health,57,2,1,1,11,10,4,7,10,11,0,0,0,2
S01006974,Bad health,6,0,0,0,0,0,1,0,2,3,0,0,0,0
S01006974,Very bad health,1,0,0,0,0,0,0,0,1,0,0,0,0,0
S01006975,All people aged 16 to 74,740,98,23,75,165,87,109,72,103,64,10,4,6,32
S01006975,Very good health,413,70,14,56,77,45,61,38,60,30,5,2,3,27
S01006975,Good health,259,26,7,19,75,34,32,30,28,26,3,1,2,5
S01006975,Fair health,49,2,2,0,11,6,13,2,8,5,2,1,1,0
S01006975,Bad health,18,0,0,0,2,2,3,1,7,3,0,0,0,0
S01006975,Very bad health,1,0,0,0,0,0,0,1,0,0,0,0,0,0
S01006976,All people aged 16 to 74,354,46,12,34,93,37,55,30,48,21,4,2,2,20
S01006976,Very good health,216,32,8,24,60,21,34,12,26,10,3,2,1,18
S01006976,Good health,112,10,3,7,27,15,18,15,18,6,1,0,1,2
S01006976,Fair health,19,4,1,3,4,1,3,2,2,3,0,0,0,0
S01006976,Bad health,4,0,0,0,2,0,0,0,1,1,0,0,0,0
S01006976,Very bad health,3,0,0,0,0,0,0,1,1,1,0,0,0,0
S01006977,All people aged 16 to 74,621,78,16,62,140,66,103,55,85,52,6,2,4,36
S01006977,Very good health,352,47,9,38,81,36,51,36,45,22,4,2,2,30
S01006977,Good health,199,27,6,21,44,24,39,11,29,18,2,0,2,5
S01006977,Fair health,56,3,1,2,13,4,9,8,9,9,0,0,0,1
S01006977,Bad health,13,1,0,1,1,2,4,0,2,3,0,0,0,0
S01006977,Very bad health,1,0,0,0,1,0,0,0,0,0,0,0,0,0
S01006978,All people aged 16 to 74,656,107,24,83,141,71,67,64,98,59,14,10,4,35
S01006978,Very good health,343,71,15,56,80,37,24,34,40,23,6,4,2,28
S01006978,Good health,216,31,8,23,43,24,27,19,39,24,3,2,1,6
S01006978,Fair health,71,4,1,3,14,6,11,9,14,9,3,3,0,1
S01006978,Bad health,21,1,0,1,4,4,2,1,5,3,1,0,1,0
S01006978,Very bad health,5,0,0,0,0,0,3,1,0,0,1,1,0,0
S01006979,All people aged 16 to 74,614,93,31,62,139,69,76,49,75,65,13,6,7,35
S01006979,Very good health,309,55,17,38,78,36,35,29,37,15,4,0,4,20
S01006979,Good health,231,31,10,21,54,23,31,14,30,29,6,3,3,13
S01006979,Fair health,56,7,4,3,4,8,9,4,7,13,2,2,0,2
S01006979,Bad health,14,0,0,0,3,0,1,1,1,7,1,1,0,0
S01006979,Very bad health,4,0,0,0,0,2,0,1,0,1,0,0,0,0
S01006980,All people aged 16 to 74,652,92,22,70,157,82,63,61,84,48,17,8,9,48
S01006980,Very good health,381,53,11,42,90,48,35,35,42,24,10,4,6,44
S01006980,Good health,218,35,10,25,58,26,19,19,35,18,5,3,2,3
S01006980,Fair health,40,2,1,1,7,7,4,6,6,5,2,1,1,1
S01006980,Bad health,11,2,0,2,2,1,3,1,1,1,0,0,0,0
S01006980,Very bad health,2,0,0,0,0,0,2,0,0,0,0,0,0,0
S01006981,All people aged 16 to 74,621,76,24,52,155,74,74,40,81,74,10,8,2,37
S01006981,Very good health,334,51,15,36,91,43,31,23,32,28,3,3,0,32
S01006981,Good health,222,23,9,14,53,23,36,12,37,31,3,2,1,4
S01006981,Fair health,49,2,0,2,9,5,7,3,10,8,4,3,1,1
S01006981,Bad health,12,0,0,0,1,3,0,1,1,6,0,0,0,0
S01006981,Very bad health,4,0,0,0,1,0,0,1,1,1,0,0,0,0
S01006982,All people aged 16 to 74,640,76,20,56,137,90,60,72,101,58,8,2,6,38
S01006982,Very good health,368,49,12,37,86,53,36,31,45,31,5,1,4,32
S01006982,Good health,217,23,6,17,46,26,19,32,47,18,1,0,1,5
S01006982,Fair health,50,4,2,2,5,9,5,8,8,8,2,1,1,1
S01006982,Bad health,5,0,0,0,0,2,0,1,1,1,0,0,0,0
S01006982,Very bad health,0,0,0,0,0,0,0,0,0,0,0,0,0,0
S01006983,All people aged 16 to 74,560,69,21,48,153,71,64,48,61,47,8,4,4,39
S01006983,Very good health,293,32,14,18,87,36,29,25,29,16,5,2,3,34
S01006983,Good health,190,28,6,22,48,27,28,14,18,21,1,0,1,5
S01006983,Fair health,48,6,0,6,12,6,5,4,10,5,0,0,0,0
S01006983,Bad health,20,3,1,2,3,1,1,5,2,3,2,2,0,0
S01006983,Very bad health,9,0,0,0,3,1,1,0,2,2,0,0,0,0
S01006984,All people aged 16 to 74,543,105,11,94,131,65,72,50,52,27,6,4,2,35
S01006984,Very good health,299,60,8,52,75,37,33,31,22,12,3,1,2,26
S01006984,Good health,202,41,3,38,50,21,28,16,23,12,3,3,0,8
S01006984,Fair health,33,2,0,2,5,7,10,1,5,2,0,0,0,1
S01006984,Bad health,6,1,0,1,0,0,0,2,2,1,0,0,0,0
S01006984,Very bad health,3,1,0,1,1,0,1,0,0,0,0,0,0,0
S01006985,All people aged 16 to 74,755,71,10,61,160,96,70,84,103,115,12,8,4,44
S01006985,Very good health,425,50,6,44,93,68,30,50,45,50,5,3,2,34
S01006985,Good health,256,20,4,16,53,19,33,26,42,51,5,4,1,7
S01006985,Fair health,61,1,0,1,10,5,7,8,13,13,1,0,1,3
S01006985,Bad health,12,0,0,0,3,4,0,0,3,1,1,1,0,0
S01006985,Very bad health,1,0,0,0,1,0,0,0,0,0,0,0,0,0
S01006986,All people aged 16 to 74,468,66,12,54,99,68,27,49,61,53,15,11,4,30
S01006986,Very good health,274,39,8,31,61,35,14,31,35,29,6,4,2,24
S01006986,Good health,144,24,3,21,27,28,11,11,15,18,4,3,1,6
S01006986,Fair health,36,1,1,0,8,3,2,5,9,3,5,4,1,0
S01006986,Bad health,9,2,0,2,3,2,0,0,2,0,0,0,0,0
S01006986,Very bad health,5,0,0,0,0,0,0,2,0,3,0,0,0,0
S01006987,All people aged 16 to 74,482,63,13,50,135,64,24,43,64,51,16,9,7,22
S01006987,Very good health,266,36,10,26,74,36,16,30,32,19,6,4,2,17
S01006987,Good health,170,22,3,19,50,24,7,8,24,23,8,5,3,4
S01006987,Fair health,34,4,0,4,9,3,1,3,4,7,2,0,2,1
S01006987,Bad health,10,1,0,1,2,1,0,1,4,1,0,0,0,0
S01006987,Very bad health,2,0,0,0,0,0,0,1,0,1,0,0,0,0
S01006988,All people aged 16 to 74,442,63,12,51,112,55,49,35,50,33,12,7,5,33
S01006988,Very good health,263,47,10,37,68,33,28,19,22,18,4,1,3,24
S01006988,Good health,128,15,2,13,38,13,16,7,17,10,4,3,1,8
S01006988,Fair health,37,1,0,1,4,8,4,6,9,2,2,2,0,1
S01006988,Bad health,12,0,0,0,2,1,1,2,2,2,2,1,1,0
S01006988,Very bad health,2,0,0,0,0,0,0,1,0,1,0,0,0,0
S01006989,All people aged 16 to 74,768,141,29,112,184,109,100,52,74,55,5,3,2,48
S01006989,Very good health,447,84,16,68,116,68,44,31,41,27,2,2,0,34
S01006989,Good health,258,42,10,32,55,33,44,17,28,23,3,1,2,13
S01006989,Fair health,52,11,3,8,12,8,8,4,4,5,0,0,0,0
S01006989,Bad health,8,2,0,2,1,0,3,0,1,0,0,0,0,1
S01006989,Very bad health,3,2,0,2,0,0,1,0,0,0,0,0,0,0
S01006990,All people aged 16 to 74,642,115,27,88,182,101,64,45,55,29,8,4,4,43
S01006990,Very good health,423,86,20,66,121,64,42,26,33,11,3,2,1,37
S01006990,Good health,174,22,5,17,53,34,16,12,18,11,2,0,2,6
S01006990,Fair health,32,6,2,4,8,2,3,4,4,4,1,0,1,0
S01006990,Bad health,12,1,0,1,0,1,2,3,0,3,2,2,0,0
S01006990,Very bad health,1,0,0,0,0,0,1,0,0,0,0,0,0,0
S01006991,All people aged 16 to 74,307,29,5,24,56,25,32,32,68,47,7,7,0,11
S01006991,Very good health,128,14,3,11,32,10,10,13,24,19,1,1,0,5
S01006991,Good health,127,13,2,11,19,10,8,15,34,19,3,3,0,6
S01006991,Fair health,41,1,0,1,5,4,12,4,7,7,1,1,0,0
S01006991,Bad health,9,1,0,1,0,1,1,0,3,2,1,1,0,0
S01006991,Very bad health,2,0,0,0,0,0,1,0,0,0,1,1,0,0
S01006992,All people aged 16 to 74,487,58,11,47,123,52,74,38,61,38,9,6,3,34
S01006992,Very good health,258,35,8,27,70,29,35,16,26,15,1,0,1,31
S01006992,Good health,171,17,1,16,43,17,29,16,23,19,5,3,2,2
S01006992,Fair health,47,5,1,4,10,6,6,4,9,3,3,3,0,1
S01006992,Bad health,7,1,1,0,0,0,3,1,1,1,0,0,0,0
S01006992,Very bad health,4,0,0,0,0,0,1,1,2,0,0,0,0,0
S01006993,All people aged 16 to 74,414,39,6,33,86,38,78,42,59,38,5,4,1,29
S01006993,Very good health,199,21,3,18,34,23,35,19,28,15,2,1,1,22
S01006993,Good health,167,15,3,12,40,9,38,19,22,15,2,2,0,7
S01006993,Fair health,36,1,0,1,9,5,5,3,7,5,1,1,0,0
S01006993,Bad health,10,2,0,2,2,0,0,1,2,3,0,0,0,0
S01006993,Very bad health,2,0,0,0,1,1,0,0,0,0,0,0,0,0
S01006994,All people aged 16 to 74,471,57,11,46,113,54,57,49,53,55,7,4,3,26
S01006994,Very good health,247,37,6,31,57,37,30,22,24,19,0,0,0,21
S01006994,Good health,173,13,3,10,45,13,21,18,27,28,4,2,2,4
S01006994,Fair health,40,5,1,4,9,4,4,6,2,6,3,2,1,1
S01006994,Bad health,10,1,1,0,2,0,2,3,0,2,0,0,0,0
S01006994,Very bad health,1,1,0,1,0,0,0,0,0,0,0,0,0,0
S01006995,All people aged 16 to 74,638,76,19,57,142,76,96,62,82,63,11,5,6,30
S01006995,Very good health,364,47,11,36,81,43,49,43,35,34,6,2,4,26
S01006995,Good health,211,24,7,17,47,27,33,16,33,23,4,2,2,4
S01006995,Fair health,49,4,1,3,11,6,11,3,10,3,1,1,0,0
S01006995,Bad health,11,1,0,1,2,0,3,0,3,2,0,0,0,0
S01006995,Very bad health,3,0,0,0,1,0,0,0,1,1,0,0,0,0
S01006996,All people aged 16 to 74,554,51,16,35,103,66,64,62,94,75,7,2,5,32
S01006996,Very good health,313,25,5,20,63,39,37,37,47,35,3,1,2,27
S01006996,Good health,177,19,8,11,35,22,19,15,37,23,3,1,2,4
S01006996,Fair health,52,7,3,4,5,4,7,8,7,13,1,0,1,0
S01006996,Bad health,10,0,0,0,0,1,1,1,2,4,0,0,0,1
S01006996,Very bad health,2,0,0,0,0,0,0,1,1,0,0,0,0,0
S01006997,All people aged 16 to 74,575,91,19,72,151,67,73,54,50,41,5,3,2,43
S01006997,Very good health,364,61,14,47,97,42,43,29,34,21,3,2,1,34
S01006997,Good health,174,30,5,25,44,21,26,19,10,16,1,0,1,7
S01006997,Fair health,28,0,0,0,8,4,3,5,3,2,1,1,0,2
S01006997,Bad health,6,0,0,0,2,0,0,1,2,1,0,0,0,0
S01006997,Very bad health,3,0,0,0,0,0,1,0,1,1,0,0,0,0
S01006998,All people aged 16 to 74,829,107,21,86,206,99,110,88,96,70,8,4,4,45
S01006998,Very good health,431,64,11,53,114,50,51,47,39,28,1,0,1,37
S01006998,Good health,327,39,10,29,78,42,45,33,50,32,2,1,1,6
S01006998,Fair health,57,4,0,4,10,5,13,8,5,6,4,3,1,2
S01006998,Bad health,13,0,0,0,3,2,1,0,2,4,1,0,1,0
S01006998,Very bad health,1,0,0,0,1,0,0,0,0,0,0,0,0,0
S01006999,All people aged 16 to 74,659,50,11,39,123,69,134,81,92,75,7,6,1,28
S01006999,Very good health,350,32,7,25,67,42,70,48,39,29,1,1,0,22
S01006999,Good health,224,13,2,11,44,17,49,24,32,37,3,2,1,5
S01006999,Fair health,63,5,2,3,9,5,9,8,18,6,2,2,0,1
S01006999,Bad health,18,0,0,0,2,4,6,1,2,2,1,1,0,0
S01006999,Very bad health,4,0,0,0,1,1,0,0,1,1,0,0,0,0
S01007000,All people aged 16 to 74,692,68,17,51,157,94,65,78,87,101,10,5,5,32
S01007000,Very good health,326,33,9,24,77,45,27,40,39,42,1,1,0,22
S01007000,Good health,284,29,8,21,63,40,31,25,37,45,5,3,2,9
S01007000,Fair health,61,5,0,5,13,7,5,11,7,10,3,1,2,0
S01007000,Bad health,20,1,0,1,4,2,2,2,3,4,1,0,1,1
S01007000,Very bad health,1,0,0,0,0,0,0,0,1,0,0,0,0,0
S01007001,All people aged 16 to 74,668,80,17,63,162,83,72,66,86,66,12,7,5,41
S01007001,Very good health,328,39,10,29,87,46,35,26,41,21,3,2,1,30
S01007001,Good health,260,35,5,30,58,30,27,28,34,31,7,5,2,10
S01007001,Fair health,62,5,2,3,13,5,8,11,9,8,2,0,2,1
S01007001,Bad health,14,1,0,1,2,1,1,1,2,6,0,0,0,0
S01007001,Very bad health,4,0,0,0,2,1,1,0,0,0,0,0,0,0
S01007002,All people aged 16 to 74,422,36,6,30,81,52,57,32,64,59,20,15,5,21
S01007002,Very good health,216,21,2,19,44,31,26,16,29,26,8,6,2,15
S01007002,Good health,156,13,4,9,30,18,25,13,23,25,5,4,1,4
S01007002,Fair health,32,2,0,2,5,1,5,1,5,6,5,4,1,2
S01007002,Bad health,13,0,0,0,1,2,1,2,4,1,2,1,1,0
S01007002,Very bad health,5,0,0,0,1,0,0,0,3,1,0,0,0,0
S01007003,All people aged 16 to 74,391,34,4,30,72,38,85,29,65,43,9,3,6,16
S01007003,Very good health,231,26,2,24,50,24,42,18,35,22,4,1,3,10
S01007003,Good health,123,6,1,5,16,11,35,8,24,15,3,2,1,5
S01007003,Fair health,28,1,1,0,5,2,8,2,5,3,2,0,2,0
S01007003,Bad health,6,0,0,0,1,1,0,0,1,2,0,0,0,1
S01007003,Very bad health,3,1,0,1,0,0,0,1,0,1,0,0,0,0
S01007004,All people aged 16 to 74,550,54,9,45,111,73,99,41,71,60,8,7,1,33
S01007004,Very good health,274,32,5,27,60,40,43,17,35,20,1,1,0,26
S01007004,Good health,205,20,4,16,46,25,41,14,21,32,3,2,1,3
S01007004,Fair health,51,1,0,1,3,6,11,6,10,7,3,3,0,4
S01007004,Bad health,15,1,0,1,0,2,4,2,5,0,1,1,0,0
S01007004,Very bad health,5,0,0,0,2,0,0,2,0,1,0,0,0,0
S01007005,All people aged 16 to 74,682,97,17,80,169,68,96,63,82,58,6,3,3,43
S01007005,Very good health,419,67,12,55,108,39,53,35,45,30,3,1,2,39
S01007005,Good health,211,24,5,19,53,24,33,20,34,19,1,1,0,3
S01007005,Fair health,37,6,0,6,6,3,9,3,3,5,1,1,0,1
S01007005,Bad health,14,0,0,0,2,2,0,5,0,4,1,0,1,0
S01007005,Very bad health,1,0,0,0,0,0,1,0,0,0,0,0,0,0
S01007006,All people aged 16 to 74,675,63,12,51,114,56,95,73,136,97,12,7,5,29
S01007006,Very good health,289,40,6,34,56,22,36,30,45,32,6,3,3,22
S01007006,Good health,269,16,4,12,46,24,41,31,64,38,4,2,2,5
S01007006,Fair health,83,6,2,4,7,9,13,9,21,18,0,0,0,0
S01007006,Bad health,31,1,0,1,5,1,4,3,5,8,2,2,0,2
S01007006,Very bad health,3,0,0,0,0,0,1,0,1,1,0,0,0,0
S01007007,All people aged 16 to 74,632,51,12,39,110,65,135,68,85,68,23,17,6,27
S01007007,Very good health,329,31,6,25,55,29,72,36,44,28,8,6,2,26
S01007007,Good health,222,16,4,12,44,27,46,22,31,24,12,8,4,0
S01007007,Fair health,52,4,2,2,8,2,12,5,7,11,2,2,0,1
S01007007,Bad health,19,0,0,0,2,4,3,4,1,4,1,1,0,0
S01007007,Very bad health,10,0,0,0,1,3,2,1,2,1,0,0,0,0
S01007008,All people aged 16 to 74,728,53,15,38,106,70,56,99,141,130,30,26,4,43
S01007008,Very good health,364,29,7,22,56,49,26,47,71,54,3,3,0,29
S01007008,Good health,251,16,8,8,42,15,22,39,45,49,9,6,3,14
S01007008,Fair health,78,5,0,5,5,5,5,9,18,20,11,10,1,0
S01007008,Bad health,28,3,0,3,2,1,3,3,5,7,4,4,0,0
S01007008,Very bad health,7,0,0,0,1,0,0,1,2,0,3,3,0,0
S01007009,All people aged 16 to 74,766,40,6,34,149,92,67,91,145,125,19,14,5,38
S01007009,Very good health,380,23,2,21,77,55,32,40,73,48,3,3,0,29
S01007009,Good health,276,11,4,7,58,28,26,37,44,55,10,6,4,7
S01007009,Fair health,88,4,0,4,11,6,7,11,24,19,5,4,1,1
S01007009,Bad health,16,2,0,2,3,3,2,2,1,2,1,1,0,0
S01007009,Very bad health,6,0,0,0,0,0,0,1,3,1,0,0,0,1
S01007010,All people aged 16 to 74,535,51,9,42,120,69,52,40,98,66,13,8,5,26
S01007010,Very good health,256,23,6,17,61,38,24,17,45,26,2,1,1,20
S01007010,Good health,219,21,3,18,53,24,21,19,37,33,7,4,3,4
S01007010,Fair health,43,3,0,3,6,3,5,4,12,4,4,3,1,2
S01007010,Bad health,16,4,0,4,0,4,2,0,3,3,0,0,0,0
S01007010,Very bad health,1,0,0,0,0,0,0,0,1,0,0,0,0,0
S01007011,All people aged 16 to 74,599,22,8,14,78,65,56,74,148,105,26,15,11,25
S01007011,Very good health,259,11,1,10,40,29,20,35,54,42,9,5,4,19
S01007011,Good health,249,7,5,2,25,28,28,32,70,45,9,3,6,5
S01007011,Fair health,69,4,2,2,8,7,6,4,19,13,7,6,1,1
S01007011,Bad health,18,0,0,0,4,1,1,3,5,3,1,1,0,0
S01007011,Very bad health,4,0,0,0,1,0,1,0,0,2,0,0,0,0
S01007012,All people aged 16 to 74,504,15,4,11,50,51,18,56,120,131,36,16,20,27
S01007012,Very good health,208,7,2,5,24,23,8,23,41,53,12,6,6,17
S01007012,Good health,194,6,2,4,20,20,6,18,50,54,13,7,6,7
S01007012,Fair health,80,2,0,2,5,6,3,9,24,18,11,3,8,2
S01007012,Bad health,19,0,0,0,1,2,1,6,4,4,0,0,0,1
S01007012,Very bad health,3,0,0,0,0,0,0,0,1,2,0,0,0,0
S01007013,All people aged 16 to 74,433,44,8,36,80,48,94,43,52,40,7,6,1,25
S01007013,Very good health,243,31,5,26,45,25,47,20,28,25,0,0,0,22
S01007013,Good health,142,12,3,9,28,18,36,16,15,9,5,4,1,3
S01007013,Fair health,39,1,0,1,7,5,9,4,6,5,2,2,0,0
S01007013,Bad health,8,0,0,0,0,0,2,2,3,1,0,0,0,0
S01007013,Very bad health,1,0,0,0,0,0,0,1,0,0,0,0,0,0
S01007014,All people aged 16 to 74,743,57,16,41,162,87,116,86,118,58,17,10,7,42
S01007014,Very good health,405,28,3,25,92,48,59,49,62,23,10,5,5,34
S01007014,Good health,265,25,12,13,59,29,46,31,37,28,3,3,0,7
S01007014,Fair health,55,3,1,2,10,7,8,5,14,5,2,1,1,1
S01007014,Bad health,12,1,0,1,1,2,0,1,4,2,1,1,0,0
S01007014,Very bad health,6,0,0,0,0,1,3,0,1,0,1,0,1,0
S01007015,All people aged 16 to 74,478,32,11,21,86,49,106,49,73,49,12,9,3,22
S01007015,Very good health,241,14,5,9,48,28,53,18,42,18,4,3,1,16
S01007015,Good health,181,13,5,8,33,16,42,25,21,22,3,2,1,6
S01007015,Fair health,44,3,1,2,5,4,11,4,8,6,3,2,1,0
S01007015,Bad health,12,2,0,2,0,1,0,2,2,3,2,2,0,0
S01007015,Very bad health,0,0,0,0,0,0,0,0,0,0,0,0,0,0
S01007016,All people aged 16 to 74,465,44,9,35,90,51,76,50,68,44,11,5,6,31
S01007016,Very good health,252,24,3,21,51,27,37,27,33,20,8,4,4,25
S01007016,Good health,170,16,5,11,33,20,32,19,28,15,2,0,2,5
S01007016,Fair health,30,3,1,2,3,3,6,3,3,8,0,0,0,1
S01007016,Bad health,9,0,0,0,2,1,1,0,4,1,0,0,0,0
S01007016,Very bad health,4,1,0,1,1,0,0,1,0,0,1,1,0,0
S01007017,All people aged 16 to 74,705,30,5,25,85,70,53,90,154,170,23,15,8,30
S01007017,Very good health,340,18,1,17,42,28,26,52,63,76,12,7,5,23
S01007017,Good health,248,9,3,6,33,34,19,27,57,60,5,2,3,4
S01007017,Fair health,85,1,1,0,4,6,7,8,27,25,5,5,0,2
S01007017,Bad health,23,0,0,0,5,1,0,3,3,9,1,1,0,1
S01007017,Very bad health,9,2,0,2,1,1,1,0,4,0,0,0,0,0
S01007018,All people aged 16 to 74,690,37,10,27,133,81,64,85,142,106,15,8,7,27
S01007018,Very good health,334,20,5,15,75,50,31,41,56,39,6,1,5,16
S01007018,Good health,271,14,5,9,43,17,27,37,70,50,4,2,2,9
S01007018,Fair health,64,3,0,3,11,11,4,5,14,14,1,1,0,1
S01007018,Bad health,12,0,0,0,2,1,2,1,1,1,3,3,0,1
S01007018,Very bad health,9,0,0,0,2,2,0,1,1,2,1,1,0,0
S01007019,All people aged 16 to 74,500,21,4,17,74,52,36,61,109,105,19,11,8,23
S01007019,Very good health,240,11,1,10,36,28,15,27,57,44,6,3,3,16
S01007019,Good health,187,8,2,6,24,21,16,26,34,46,6,3,3,6
S01007019,Fair health,51,1,1,0,12,2,4,5,11,12,4,2,2,0
S01007019,Bad health,17,1,0,1,2,1,1,3,6,0,2,2,0,1
S01007019,Very bad health,5,0,0,0,0,0,0,0,1,3,1,1,0,0
S01007020,All people aged 16 to 74,556,40,14,26,95,61,46,76,103,85,22,15,7,28
S01007020,Very good health,287,22,9,13,47,31,19,39,56,35,12,8,4,26
S01007020,Good health,197,13,3,10,34,24,21,31,32,35,6,4,2,1
S01007020,Fair health,52,3,1,2,10,4,6,4,12,9,3,2,1,1
S01007020,Bad health,13,1,0,1,3,1,0,1,2,5,0,0,0,0
S01007020,Very bad health,7,1,1,0,1,1,0,1,1,1,1,1,0,0
S01007021,All people aged 16 to 74,650,29,11,18,103,80,44,75,140,138,22,15,7,19
S01007021,Very good health,294,16,6,10,44,42,21,37,63,51,5,2,3,15
S01007021,Good health,255,9,3,6,42,29,19,28,55,63,9,6,3,1
S01007021,Fair health,75,1,0,1,14,7,2,7,16,21,6,5,1,1
S01007021,Bad health,20,2,1,1,2,2,2,3,4,2,1,1,0,2
S01007021,Very bad health,6,1,1,0,1,0,0,0,2,1,1,1,0,0
S01007022,All people aged 16 to 74,350,17,5,12,64,30,38,36,66,64,15,8,7,20
S01007022,Very good health,159,6,2,4,30,17,22,17,27,25,2,1,1,13
S01007022,Good health,136,6,2,4,25,11,14,13,30,25,6,1,5,6
S01007022,Fair health,40,3,1,2,5,1,2,4,7,10,7,6,1,1
S01007022,Bad health,8,0,0,0,3,0,0,2,2,1,0,0,0,0
S01007022,Very bad health,7,2,0,2,1,1,0,0,0,3,0,0,0,0
S01007023,All people aged 16 to 74,355,13,2,11,63,31,77,40,61,42,14,11,3,14
S01007023,Very good health,164,7,0,7,38,15,34,20,22,12,5,4,1,11
S01007023,Good health,129,5,2,3,22,8,33,12,23,17,7,7,0,2
S01007023,Fair health,43,1,0,1,3,8,7,5,13,5,0,0,0,1
S01007023,Bad health,15,0,0,0,0,0,2,2,3,6,2,0,2,0
S01007023,Very bad health,4,0,0,0,0,0,1,1,0,2,0,0,0,0
S01007024,All people aged 16 to 74,766,38,6,32,146,70,164,64,124,97,16,9,7,47
S01007024,Very good health,362,22,2,20,79,41,59,30,56,40,4,4,0,31
S01007024,Good health,275,13,4,9,42,22,75,20,44,37,8,2,6,14
S01007024,Fair health,92,2,0,2,17,5,24,11,16,13,3,2,1,1
S01007024,Bad health,24,1,0,1,6,0,4,2,7,4,0,0,0,0
S01007024,Very bad health,13,0,0,0,2,2,2,1,1,3,1,1,0,1
S01007025,All people aged 16 to 74,625,24,6,18,93,46,59,78,127,160,20,13,7,18
S01007025,Very good health,262,12,4,8,42,23,27,42,46,56,5,3,2,9
S01007025,Good health,233,8,1,7,35,14,15,24,55,69,5,2,3,8
S01007025,Fair health,85,3,1,2,10,7,12,9,16,20,7,6,1,1
S01007025,Bad health,30,0,0,0,4,2,2,2,6,12,2,1,1,0
S01007025,Very bad health,15,1,0,1,2,0,3,1,4,3,1,1,0,0
S01007026,All people aged 16 to 74,637,33,9,24,121,61,88,74,106,109,17,12,5,28
S01007026,Very good health,299,21,6,15,62,32,32,35,51,43,5,3,2,18
S01007026,Good health,231,10,2,8,40,22,36,25,37,45,7,5,2,9
S01007026,Fair health,82,1,0,1,14,6,14,11,13,17,5,4,1,1
S01007026,Bad health,19,1,1,0,4,0,6,2,3,3,0,0,0,0
S01007026,Very bad health,6,0,0,0,1,1,0,1,2,1,0,0,0,0
S01007027,All people aged 16 to 74,766,40,11,29,141,65,105,87,139,127,25,21,4,37
S01007027,Very good health,367,27,6,21,73,32,44,35,67,55,5,2,3,29
S01007027,Good health,270,8,4,4,51,28,42,33,47,45,10,9,1,6
S01007027,Fair health,95,4,1,3,11,5,15,14,16,24,4,4,0,2
S01007027,Bad health,24,0,0,0,4,0,4,2,7,2,5,5,0,0
S01007027,Very bad health,10,1,0,1,2,0,0,3,2,1,1,1,0,0
S01007028,All people aged 16 to 74,563,35,6,29,107,57,119,49,91,57,17,13,4,31
S01007028,Very good health,274,20,6,14,50,30,67,25,38,19,3,1,2,22
S01007028,Good health,202,10,0,10,39,15,38,22,40,24,7,6,1,7
S01007028,Fair health,63,4,0,4,14,6,9,2,10,10,6,5,1,2
S01007028,Bad health,19,1,0,1,3,5,4,0,1,4,1,1,0,0
S01007028,Very bad health,5,0,0,0,1,1,1,0,2,0,0,0,0,0
S01007029,All people aged 16 to 74,427,25,5,20,72,41,112,34,61,49,14,10,4,19
S01007029,Very good health,210,15,4,11,35,20,44,22,32,20,6,5,1,16
S01007029,Good health,147,9,1,8,22,18,44,6,21,20,5,3,2,2
S01007029,Fair health,53,1,0,1,12,1,20,4,7,5,2,1,1,1
S01007029,Bad health,16,0,0,0,3,2,4,2,1,3,1,1,0,0
S01007029,Very bad health,1,0,0,0,0,0,0,0,0,1,0,0,0,0
S01007030,All people aged 16 to 74,609,20,9,11,97,50,74,61,135,137,11,8,3,24
S01007030,Very good health,256,10,5,5,44,28,27,26,46,51,4,3,1,20
S01007030,Good health,271,8,3,5,47,18,34,25,68,63,4,2,2,4
S01007030,Fair health,56,2,1,1,3,1,7,7,16,18,2,2,0,0
S01007030,Bad health,15,0,0,0,1,0,5,2,3,3,1,1,0,0
S01007030,Very bad health,11,0,0,0,2,3,1,1,2,2,0,0,0,0
S01007031,All people aged 16 to 74,459,25,6,19,88,26,55,49,108,68,16,8,8,24
S01007031,Very good health,200,11,3,8,37,7,20,21,51,28,5,1,4,20
S01007031,Good health,183,8,3,5,36,10,24,20,44,30,9,5,4,2
S01007031,Fair health,51,4,0,4,9,5,9,5,10,7,1,1,0,1
S01007031,Bad health,15,2,0,2,4,2,1,1,0,3,1,1,0,1
S01007031,Very bad health,10,0,0,0,2,2,1,2,3,0,0,0,0,0
S01007032,All people aged 16 to 74,720,38,6,32,136,62,58,65,138,124,48,35,13,51
S01007032,Very good health,319,21,3,18,64,36,28,16,61,44,18,14,4,31
S01007032,Good health,256,13,2,11,54,17,19,34,46,41,14,9,5,18
S01007032,Fair health,104,3,1,2,12,9,8,11,25,25,9,5,4,2
S01007032,Bad health,29,1,0,1,6,0,3,2,5,7,5,5,0,0
S01007032,Very bad health,12,0,0,0,0,0,0,2,1,7,2,2,0,0
S01007033,All people aged 16 to 74,548,19,4,15,87,56,19,61,124,125,30,21,9,27
S01007033,Very good health,233,8,2,6,39,26,7,22,55,48,8,5,3,20
S01007033,Good health,216,10,2,8,34,21,7,32,50,48,9,5,4,5
S01007033,Fair health,71,1,0,1,8,5,4,6,15,25,6,6,0,1
S01007033,Bad health,20,0,0,0,3,3,0,1,3,4,6,4,2,0
S01007033,Very bad health,8,0,0,0,3,1,1,0,1,0,1,1,0,1
S01007034,All people aged 16 to 74,443,24,7,17,85,42,29,43,93,68,17,10,7,42
S01007034,Very good health,222,14,6,8,50,21,11,23,44,25,8,4,4,26
S01007034,Good health,140,8,1,7,28,12,12,14,29,20,6,5,1,11
S01007034,Fair health,57,2,0,2,7,7,4,4,13,14,3,1,2,3
S01007034,Bad health,24,0,0,0,0,2,2,2,7,9,0,0,0,2
S01007034,Very bad health,0,0,0,0,0,0,0,0,0,0,0,0,0,0
S01007035,All people aged 16 to 74,569,18,9,9,54,36,41,49,168,154,18,9,9,31
S01007035,Very good health,231,7,3,4,24,15,16,19,61,59,7,3,4,23
S01007035,Good health,211,10,6,4,20,15,14,18,65,55,8,3,5,6
S01007035,Fair health,93,1,0,1,8,5,8,8,32,28,2,2,0,1
S01007035,Bad health,28,0,0,0,2,1,3,4,8,9,0,0,0,1
S01007035,Very bad health,6,0,0,0,0,0,0,0,2,3,1,1,0,0
S01007036,All people aged 16 to 74,658,49,17,32,140,67,78,65,114,73,27,25,2,45
S01007036,Very good health,342,35,13,22,73,38,38,39,51,29,7,6,1,32
S01007036,Good health,230,12,4,8,51,24,31,20,43,34,7,6,1,8
S01007036,Fair health,70,2,0,2,14,4,7,3,17,8,10,10,0,5
S01007036,Bad health,14,0,0,0,2,1,2,2,2,2,3,3,0,0
S01007036,Very bad health,2,0,0,0,0,0,0,1,1,0,0,0,0,0
S01007037,All people aged 16 to 74,747,23,7,16,93,82,60,85,168,158,29,16,13,49
S01007037,Very good health,321,14,5,9,41,43,28,37,58,57,6,2,4,37
S01007037,Good health,294,7,2,5,36,25,20,29,82,73,12,4,8,10
S01007037,Fair health,88,2,0,2,10,8,9,14,18,19,6,5,1,2
S01007037,Bad health,34,0,0,0,4,4,3,4,8,7,4,4,0,0
S01007037,Very bad health,10,0,0,0,2,2,0,1,2,2,1,1,0,0
S01007038,All people aged 16 to 74,570,21,6,15,90,61,60,55,120,102,27,16,11,34
S01007038,Very good health,262,9,1,8,44,36,28,23,51,34,10,7,3,27
S01007038,Good health,213,9,4,5,32,17,22,25,44,49,9,4,5,6
S01007038,Fair health,72,3,1,2,9,7,7,4,20,17,4,2,2,1
S01007038,Bad health,17,0,0,0,4,0,2,2,4,2,3,2,1,0
S01007038,Very bad health,6,0,0,0,1,1,1,1,1,0,1,1,0,0
S01007039,All people aged 16 to 74,632,19,10,9,99,60,59,70,124,132,34,22,12,35
S01007039,Very good health,289,13,5,8,62,32,24,29,47,52,7,5,2,23
S01007039,Good health,242,6,5,1,32,23,25,31,51,48,15,11,4,11
S01007039,Fair health,71,0,0,0,3,2,7,6,17,25,10,5,5,1
S01007039,Bad health,21,0,0,0,1,2,2,4,6,5,1,0,1,0
S01007039,Very bad health,9,0,0,0,1,1,1,0,3,2,1,1,0,0
S01007040,All people aged 16 to 74,466,18,6,12,62,43,32,55,112,100,13,8,5,31
S01007040,Very good health,210,7,4,3,30,20,17,28,48,33,3,3,0,24
S01007040,Good health,177,10,2,8,25,18,11,12,49,44,4,3,1,4
S01007040,Fair health,64,1,0,1,6,5,2,9,14,19,5,1,4,3
S01007040,Bad health,13,0,0,0,1,0,2,5,1,3,1,1,0,0
S01007040,Very bad health,2,0,0,0,0,0,0,1,0,1,0,0,0,0
S01007041,All people aged 16 to 74,555,23,5,18,95,51,54,63,110,89,38,29,9,32
S01007041,Very good health,275,11,2,9,53,26,24,35,48,42,11,9,2,25
S01007041,Good health,194,12,3,9,33,17,19,23,45,27,11,10,1,7
S01007041,Fair health,59,0,0,0,5,6,8,4,12,10,14,8,6,0
S01007041,Bad health,18,0,0,0,3,0,2,1,5,5,2,2,0,0
S01007041,Very bad health,9,0,0,0,1,2,1,0,0,5,0,0,0,0
S01007042,All people aged 16 to 74,514,31,6,25,78,53,63,53,96,86,23,11,12,31
S01007042,Very good health,252,17,3,14,33,24,32,30,51,33,9,5,4,23
S01007042,Good health,194,14,3,11,28,23,25,17,32,39,9,4,5,7
S01007042,Fair health,50,0,0,0,15,5,4,4,9,7,5,2,3,1
S01007042,Bad health,15,0,0,0,2,1,2,2,4,4,0,0,0,0
S01007042,Very bad health,3,0,0,0,0,0,0,0,0,3,0,0,0,0
S01007043,All people aged 16 to 74,766,69,16,53,155,79,146,74,108,91,20,15,5,24
S01007043,Very good health,418,48,12,36,93,50,75,41,52,35,6,3,3,18
S01007043,Good health,263,20,4,16,48,20,57,24,40,41,7,6,1,6
S01007043,Fair health,58,1,0,1,11,6,8,6,12,11,3,3,0,0
S01007043,Bad health,19,0,0,0,2,2,4,3,3,2,3,3,0,0
S01007043,Very bad health,8,0,0,0,1,1,2,0,1,2,1,0,1,0
S01007044,All people aged 16 to 74,504,32,9,23,80,52,92,52,85,67,9,8,1,35
S01007044,Very good health,262,20,3,17,43,30,53,28,34,25,3,3,0,26
S01007044,Good health,159,5,2,3,27,14,30,18,33,22,3,2,1,7
S01007044,Fair health,47,3,2,1,6,6,5,4,11,8,3,3,0,1
S01007044,Bad health,26,4,2,2,4,1,3,1,6,6,0,0,0,1
S01007044,Very bad health,10,0,0,0,0,1,1,1,1,6,0,0,0,0
S01007045,All people aged 16 to 74,632,44,7,37,115,55,150,54,94,70,23,16,7,27
S01007045,Very good health,268,23,5,18,59,31,62,24,34,11,5,3,2,19
S01007045,Good health,260,15,1,14,43,20,62,16,46,44,7,2,5,7
S01007045,Fair health,72,4,0,4,11,3,21,8,9,8,7,7,0,1
S01007045,Bad health,23,2,1,1,1,1,2,4,4,6,3,3,0,0
S01007045,Very bad health,9,0,0,0,1,0,3,2,1,1,1,1,0,0
S01007046,All people aged 16 to 74,472,20,2,18,93,43,72,43,94,74,11,11,0,22
S01007046,Very good health,200,8,1,7,45,22,29,19,41,20,2,2,0,14
S01007046,Good health,164,8,1,7,29,14,24,16,31,29,6,6,0,7
S01007046,Fair health,68,2,0,2,13,5,13,4,16,13,1,1,0,1
S01007046,Bad health,29,2,0,2,4,1,5,3,5,8,1,1,0,0
S01007046,Very bad health,11,0,0,0,2,1,1,1,1,4,1,1,0,0
S01007047,All people aged 16 to 74,519,29,8,21,110,61,91,50,72,69,11,6,5,26
S01007047,Very good health,235,17,3,14,56,30,40,18,23,25,5,2,3,21
S01007047,Good health,203,10,4,6,43,21,40,22,29,32,3,2,1,3
S01007047,Fair health,60,2,1,1,9,7,9,9,13,9,1,1,0,1
S01007047,Bad health,18,0,0,0,2,3,1,0,6,3,2,1,1,1
S01007047,Very bad health,3,0,0,0,0,0,1,1,1,0,0,0,0,0
S01007048,All people aged 16 to 74,726,42,10,32,104,81,136,77,120,101,20,17,3,45
S01007048,Very good health,368,27,6,21,56,42,48,43,56,57,5,4,1,34
S01007048,Good health,249,11,3,8,37,30,59,22,41,32,7,7,0,10
S01007048,Fair health,80,3,0,3,8,7,20,10,18,9,5,3,2,0
S01007048,Bad health,18,1,1,0,2,1,4,1,4,2,2,2,0,1
S01007048,Very bad health,11,0,0,0,1,1,5,1,1,1,1,1,0,0
S01007049,All people aged 16 to 74,701,21,5,16,115,56,57,88,154,162,21,12,9,27
S01007049,Very good health,282,10,3,7,54,28,19,41,54,54,4,1,3,18
S01007049,Good health,274,9,2,7,46,17,19,32,75,61,7,4,3,8
S01007049,Fair health,104,2,0,2,9,10,19,7,16,34,6,4,2,1
S01007049,Bad health,38,0,0,0,5,1,0,7,8,13,4,3,1,0
S01007049,Very bad health,3,0,0,0,1,0,0,1,1,0,0,0,0,0
S01007050,All people aged 16 to 74,477,36,10,26,77,39,70,49,88,72,23,21,2,23
S01007050,Very good health,220,22,4,18,38,18,32,22,30,32,8,6,2,18
S01007050,Good health,184,12,6,6,29,19,26,19,40,25,9,9,0,5
S01007050,Fair health,57,1,0,1,9,1,10,8,12,13,3,3,0,0
S01007050,Bad health,10,0,0,0,1,0,2,0,4,2,1,1,0,0
S01007050,Very bad health,6,1,0,1,0,1,0,0,2,0,2,2,0,0
S01007051,All people aged 16 to 74,570,43,10,33,102,74,46,69,97,95,22,19,3,22
S01007051,Very good health,286,27,8,19,53,43,22,40,43,36,4,3,1,18
S01007051,Good health,226,13,2,11,40,29,16,22,45,42,15,13,2,4
S01007051,Fair health,43,3,0,3,4,2,8,6,7,11,2,2,0,0
S01007051,Bad health,8,0,0,0,3,0,0,1,1,2,1,1,0,0
S01007051,Very bad health,7,0,0,0,2,0,0,0,1,4,0,0,0,0
S01007052,All people aged 16 to 74,442,30,10,20,68,53,52,53,81,70,11,8,3,24
S01007052,Very good health,217,15,5,10,44,29,24,20,41,26,1,0,1,17
S01007052,Good health,166,14,5,9,18,20,24,23,29,28,5,3,2,5
S01007052,Fair health,49,1,0,1,5,2,4,9,9,14,3,3,0,2
S01007052,Bad health,4,0,0,0,0,1,0,0,1,1,1,1,0,0
S01007052,Very bad health,6,0,0,0,1,1,0,1,1,1,1,1,0,0
S01007053,All people aged 16 to 74,383,39,11,28,72,41,65,44,49,40,9,5,4,24
S01007053,Very good health,172,19,4,15,34,21,27,17,17,16,3,2,1,18
S01007053,Good health,143,17,5,12,24,13,26,19,21,16,2,0,2,5
S01007053,Fair health,51,3,2,1,10,5,8,5,8,7,4,3,1,1
S01007053,Bad health,14,0,0,0,4,1,3,3,3,0,0,0,0,0
S01007053,Very bad health,3,0,0,0,0,1,1,0,0,1,0,0,0,0
S01007054,All people aged 16 to 74,691,39,11,28,107,76,55,102,127,128,29,17,12,28
S01007054,Very good health,328,24,5,19,58,32,27,51,57,50,10,5,5,19
S01007054,Good health,247,9,3,6,34,30,19,37,47,53,9,5,4,9
S01007054,Fair health,87,4,1,3,10,10,7,12,17,18,9,6,3,0
S01007054,Bad health,21,2,2,0,4,4,2,0,5,4,0,0,0,0
S01007054,Very bad health,8,0,0,0,1,0,0,2,1,3,1,1,0,0
S01007055,All people aged 16 to 74,404,30,4,26,79,39,87,34,60,45,6,4,2,24
S01007055,Very good health,222,20,1,19,46,24,45,17,28,16,5,4,1,21
S01007055,Good health,135,7,3,4,28,14,35,11,22,15,0,0,0,3
S01007055,Fair health,34,2,0,2,3,0,6,5,9,9,0,0,0,0
S01007055,Bad health,11,1,0,1,1,1,0,1,1,5,1,0,1,0
S01007055,Very bad health,2,0,0,0,1,0,1,0,0,0,0,0,0,0
S01007056,All people aged 16 to 74,478,42,5,37,95,53,95,35,66,47,11,6,5,34
S01007056,Very good health,253,28,4,24,58,30,42,15,28,17,4,2,2,31
S01007056,Good health,165,9,1,8,31,19,35,17,24,24,4,2,2,2
S01007056,Fair health,45,3,0,3,5,2,14,3,9,6,3,2,1,0
S01007056,Bad health,12,2,0,2,0,2,4,0,3,0,0,0,0,1
S01007056,Very bad health,3,0,0,0,1,0,0,0,2,0,0,0,0,0
S01007057,All people aged 16 to 74,383,18,6,12,91,59,30,39,62,57,10,8,2,17
S01007057,Very good health,166,10,3,7,41,26,13,18,29,14,4,2,2,11
S01007057,Good health,160,7,2,5,38,25,13,16,20,30,5,5,0,6
S01007057,Fair health,48,1,1,0,11,8,3,4,10,10,1,1,0,0
S01007057,Bad health,8,0,0,0,1,0,1,1,3,2,0,0,0,0
S01007057,Very bad health,1,0,0,0,0,0,0,0,0,1,0,0,0,0
S01007058,All people aged 16 to 74,401,15,4,11,65,47,35,57,81,77,6,4,2,18
S01007058,Very good health,166,5,1,4,30,26,14,22,29,27,1,0,1,12
S01007058,Good health,158,8,3,5,27,17,10,24,34,29,4,3,1,5
S01007058,Fair health,55,0,0,0,5,3,10,6,14,15,1,1,0,1
S01007058,Bad health,18,2,0,2,3,1,1,2,3,6,0,0,0,0
S01007058,Very bad health,4,0,0,0,0,0,0,3,1,0,0,0,0,0
S01007059,All people aged 16 to 74,723,56,20,36,134,90,56,72,130,115,26,21,5,44
S01007059,Very good health,374,35,7,28,73,44,26,42,63,47,7,4,3,37
S01007059,Good health,249,19,11,8,43,32,21,20,45,51,13,11,2,5
S01007059,Fair health,69,1,1,0,14,7,8,8,17,11,2,2,0,1
S01007059,Bad health,21,1,1,0,2,6,1,1,4,3,2,2,0,1
S01007059,Very bad health,10,0,0,0,2,1,0,1,1,3,2,2,0,0
S01007060,All people aged 16 to 74,463,20,7,13,48,43,26,59,107,94,29,17,12,37
S01007060,Very good health,198,14,5,9,22,9,10,26,36,39,16,7,9,26
S01007060,Good health,176,5,2,3,18,24,11,22,48,32,7,5,2,9
S01007060,Fair health,63,1,0,1,5,8,2,9,17,17,3,3,0,1
S01007060,Bad health,21,0,0,0,3,1,2,2,4,5,3,2,1,1
S01007060,Very bad health,5,0,0,0,0,1,1,0,2,1,0,0,0,0
S01007061,All people aged 16 to 74,711,98,26,72,176,91,100,62,94,44,13,6,7,33
S01007061,Very good health,378,57,13,44,97,54,45,35,44,17,4,0,4,25
S01007061,Good health,257,34,10,24,66,30,40,22,36,17,5,2,3,7
S01007061,Fair health,58,7,3,4,11,5,10,3,12,6,3,3,0,1
S01007061,Bad health,12,0,0,0,1,2,3,2,2,2,0,0,0,0
S01007061,Very bad health,6,0,0,0,1,0,2,0,0,2,1,1,0,0
S01007062,All people aged 16 to 74,539,72,14,58,115,59,107,44,51,49,7,6,1,35
S01007062,Very good health,282,42,9,33,58,29,47,20,29,23,5,4,1,29
S01007062,Good health,189,23,4,19,42,26,38,18,14,21,2,2,0,5
S01007062,Fair health,51,5,1,4,10,4,17,5,4,5,0,0,0,1
S01007062,Bad health,13,1,0,1,3,0,4,1,4,0,0,0,0,0
S01007062,Very bad health,4,1,0,1,2,0,1,0,0,0,0,0,0,0
S01007063,All people aged 16 to 74,496,28,5,23,95,63,56,54,70,82,13,9,4,35
S01007063,Very good health,249,21,2,19,49,38,28,25,22,37,4,2,2,25
S01007063,Good health,166,6,3,3,35,18,19,20,27,30,3,2,1,8
S01007063,Fair health,56,1,0,1,9,4,7,7,15,8,3,3,0,2
S01007063,Bad health,20,0,0,0,2,2,2,2,4,5,3,2,1,0
S01007063,Very bad health,5,0,0,0,0,1,0,0,2,2,0,0,0,0
S01007064,All people aged 16 to 74,502,48,6,42,100,58,92,38,62,72,5,5,0,27
S01007064,Very good health,240,30,5,25,49,27,47,21,22,22,0,0,0,22
S01007064,Good health,183,15,0,15,36,21,33,12,26,35,3,3,0,2
S01007064,Fair health,57,2,0,2,13,8,9,5,10,8,0,0,0,2
S01007064,Bad health,19,1,1,0,1,2,3,0,3,6,2,2,0,1
S01007064,Very bad health,3,0,0,0,1,0,0,0,1,1,0,0,0,0
S01007065,All people aged 16 to 74,445,67,15,52,121,51,46,37,52,38,6,5,1,27
S01007065,Very good health,243,39,6,33,64,35,21,18,24,18,1,0,1,23
S01007065,Good health,149,26,9,17,45,14,19,14,16,11,1,1,0,3
S01007065,Fair health,44,2,0,2,8,2,6,4,11,7,3,3,0,1
S01007065,Bad health,7,0,0,0,4,0,0,1,0,2,0,0,0,0
S01007065,Very bad health,2,0,0,0,0,0,0,0,1,0,1,1,0,0
S01007066,All people aged 16 to 74,511,42,12,30,108,47,75,66,69,60,11,7,4,33
S01007066,Very good health,247,27,9,18,56,17,32,35,31,28,1,1,0,20
S01007066,Good health,190,10,2,8,38,23,33,21,29,23,4,3,1,9
S01007066,Fair health,60,5,1,4,12,6,9,10,5,5,4,2,2,4
S01007066,Bad health,9,0,0,0,1,1,1,0,3,1,2,1,1,0
S01007066,Very bad health,5,0,0,0,1,0,0,0,1,3,0,0,0,0
S01007067,All people aged 16 to 74,451,37,12,25,99,71,31,61,73,53,8,4,4,18
S01007067,Very good health,212,20,6,14,50,43,9,26,32,14,4,2,2,14
S01007067,Good health,177,14,5,9,39,21,13,26,29,29,2,1,1,4
S01007067,Fair health,48,2,1,1,10,2,8,9,7,8,2,1,1,0
S01007067,Bad health,13,1,0,1,0,4,1,0,5,2,0,0,0,0
S01007067,Very bad health,1,0,0,0,0,1,0,0,0,0,0,0,0,0
S01007068,All people aged 16 to 74,545,60,14,46,115,64,68,61,76,61,21,12,9,19
S01007068,Very good health,239,34,8,26,63,25,28,23,27,24,6,1,5,9
S01007068,Good health,199,22,5,17,37,25,22,28,33,19,8,4,4,5
S01007068,Fair health,75,3,1,2,11,10,12,6,11,13,4,4,0,5
S01007068,Bad health,26,1,0,1,3,4,4,3,4,5,2,2,0,0
S01007068,Very bad health,6,0,0,0,1,0,2,1,1,0,1,1,0,0
S01007069,All people aged 16 to 74,600,28,9,19,103,89,48,60,126,91,18,11,7,37
S01007069,Very good health,282,13,3,10,49,44,22,30,62,27,8,5,3,27
S01007069,Good health,221,13,6,7,42,35,17,22,44,37,3,2,1,8
S01007069,Fair health,67,1,0,1,6,8,5,6,14,21,4,1,3,2
S01007069,Bad health,25,1,0,1,4,1,4,2,5,5,3,3,0,0
S01007069,Very bad health,5,0,0,0,2,1,0,0,1,1,0,0,0,0
S01007070,All people aged 16 to 74,395,10,3,7,67,47,33,50,77,83,15,6,9,13
S01007070,Very good health,152,6,2,4,35,21,8,17,22,27,4,2,2,12
S01007070,Good health,145,4,1,3,22,14,16,18,34,31,5,1,4,1
S01007070,Fair health,69,0,0,0,9,8,6,9,15,18,4,2,2,0
S01007070,Bad health,18,0,0,0,1,3,3,4,2,4,1,1,0,0
S01007070,Very bad health,11,0,0,0,0,1,0,2,4,3,1,0,1,0
S01007071,All people aged 16 to 74,642,55,10,45,138,68,41,70,109,107,15,7,8,39
S01007071,Very good health,321,36,6,30,67,31,19,34,53,48,5,4,1,28
S01007071,Good health,236,14,4,10,58,27,17,23,44,38,4,0,4,11
S01007071,Fair health,61,4,0,4,10,9,3,10,8,13,4,2,2,0
S01007071,Bad health,18,1,0,1,3,1,2,2,2,5,2,1,1,0
S01007071,Very bad health,6,0,0,0,0,0,0,1,2,3,0,0,0,0
S01007072,All people aged 16 to 74,493,35,16,19,94,71,45,66,96,50,6,3,3,30
S01007072,Very good health,293,20,7,13,58,47,26,41,49,23,2,2,0,27
S01007072,Good health,145,12,6,6,29,19,14,21,31,15,1,0,1,3
S01007072,Fair health,39,2,2,0,6,4,2,4,12,6,3,1,2,0
S01007072,Bad health,13,1,1,0,1,1,3,0,3,4,0,0,0,0
S01007072,Very bad health,3,0,0,0,0,0,0,0,1,2,0,0,0,0
S01007073,All people aged 16 to 74,838,43,12,31,165,112,75,99,155,119,31,24,7,39
S01007073,Very good health,406,29,7,22,78,66,26,57,63,44,12,9,3,31
S01007073,Good health,284,10,3,7,67,32,34,24,61,39,11,8,3,6
S01007073,Fair health,112,4,2,2,17,8,11,13,27,25,6,6,0,1
S01007073,Bad health,28,0,0,0,3,5,4,3,2,9,1,0,1,1
S01007073,Very bad health,8,0,0,0,0,1,0,2,2,2,1,1,0,0
S01007074,All people aged 16 to 74,517,22,5,17,81,50,31,63,120,113,20,9,11,17
S01007074,Very good health,238,11,2,9,41,23,10,19,61,52,9,4,5,12
S01007074,Good health,205,10,2,8,30,23,14,34,42,40,8,3,5,4
S01007074,Fair health,58,1,1,0,8,3,4,6,16,17,2,1,1,1
S01007074,Bad health,13,0,0,0,2,1,2,3,1,3,1,1,0,0
S01007074,Very bad health,3,0,0,0,0,0,1,1,0,1,0,0,0,0
S01007075,All people aged 16 to 74,537,15,3,12,70,52,12,67,129,143,17,11,6,32
S01007075,Very good health,255,6,0,6,35,29,5,33,55,61,7,4,3,24
S01007075,Good health,189,5,1,4,24,18,3,24,50,54,5,3,2,6
S01007075,Fair health,66,4,2,2,6,5,4,4,15,23,3,2,1,2
S01007075,Bad health,21,0,0,0,5,0,0,2,8,4,2,2,0,0
S01007075,Very bad health,6,0,0,0,0,0,0,4,1,1,0,0,0,0
S01007076,All people aged 16 to 74,580,22,3,19,87,61,38,76,128,128,18,14,4,22
S01007076,Very good health,275,9,1,8,46,35,15,31,64,56,7,6,1,12
S01007076,Good health,216,8,2,6,27,21,17,31,43,53,6,4,2,10
S01007076,Fair health,68,2,0,2,10,4,6,8,18,15,5,4,1,0
S01007076,Bad health,15,1,0,1,2,1,0,6,2,3,0,0,0,0
S01007076,Very bad health,6,2,0,2,2,0,0,0,1,1,0,0,0,0
S01007077,All people aged 16 to 74,522,20,4,16,87,61,23,83,115,95,22,14,8,16
S01007077,Very good health,241,14,2,12,51,34,10,35,44,36,5,4,1,12
S01007077,Good health,206,5,1,4,30,20,9,33,52,42,11,5,6,4
S01007077,Fair health,51,1,1,0,6,5,3,7,15,11,3,2,1,0
S01007077,Bad health,17,0,0,0,0,2,1,5,2,6,1,1,0,0
S01007077,Very bad health,7,0,0,0,0,0,0,3,2,0,2,2,0,0
S01007078,All people aged 16 to 74,642,31,11,20,83,85,50,70,121,136,34,22,12,32
S01007078,Very good health,282,18,9,9,47,46,18,31,50,43,8,5,3,21
S01007078,Good health,216,11,2,9,30,25,18,30,36,46,10,5,5,10
S01007078,Fair health,111,1,0,1,4,10,10,8,29,33,15,11,4,1
S01007078,Bad health,26,1,0,1,2,2,4,1,5,11,0,0,0,0
S01007078,Very bad health,7,0,0,0,0,2,0,0,1,3,1,1,0,0
S01007079,All people aged 16 to 74,726,25,5,20,128,66,48,99,161,139,35,23,12,25
S01007079,Very good health,308,12,3,9,60,39,24,49,53,42,12,9,3,17
S01007079,Good health,266,9,0,9,44,22,15,36,68,58,8,3,5,6
S01007079,Fair health,104,4,2,2,16,4,5,9,26,26,13,9,4,1
S01007079,Bad health,35,0,0,0,7,1,3,4,12,5,2,2,0,1
S01007079,Very bad health,13,0,0,0,1,0,1,1,2,8,0,0,0,0
S01007080,All people aged 16 to 74,557,13,5,8,92,56,28,67,123,112,22,8,14,44
S01007080,Very good health,209,7,4,3,40,24,10,25,38,30,8,3,5,27
S01007080,Good health,232,5,1,4,35,23,8,31,59,52,7,3,4,12
S01007080,Fair health,89,0,0,0,12,6,7,9,24,19,7,2,5,5
S01007080,Bad health,21,0,0,0,4,2,2,2,2,9,0,0,0,0
S01007080,Very bad health,6,1,0,1,1,1,1,0,0,2,0,0,0,0
S01007081,All people aged 16 to 74,690,22,9,13,88,48,54,74,149,190,29,20,9,36
S01007081,Very good health,285,10,2,8,38,25,23,34,62,63,6,6,0,24
S01007081,Good health,281,10,7,3,40,15,19,29,58,86,15,7,8,9
S01007081,Fair health,82,1,0,1,8,6,8,8,16,30,3,3,0,2
S01007081,Bad health,33,0,0,0,2,2,3,2,11,9,3,2,1,1
S01007081,Very bad health,9,1,0,1,0,0,1,1,2,2,2,2,0,0
S01007082,All people aged 16 to 74,410,10,0,10,64,24,29,53,87,102,19,12,7,22
S01007082,Very good health,170,4,0,4,29,11,12,29,25,37,7,6,1,16
S01007082,Good health,155,6,0,6,26,8,13,17,38,37,6,2,4,4
S01007082,Fair health,50,0,0,0,2,4,2,2,17,16,5,3,2,2
S01007082,Bad health,32,0,0,0,5,1,2,4,7,12,1,1,0,0
S01007082,Very bad health,3,0,0,0,2,0,0,1,0,0,0,0,0,0
S01007083,All people aged 16 to 74,697,18,5,13,62,46,37,83,154,208,54,41,13,35
S01007083,Very good health,216,4,1,3,21,15,16,31,40,57,10,7,3,22
S01007083,Good health,316,10,3,7,24,22,13,31,79,97,30,23,7,10
S01007083,Fair health,106,3,1,2,8,5,6,13,24,36,8,6,2,3
S01007083,Bad health,52,1,0,1,9,4,1,7,8,16,6,5,1,0
S01007083,Very bad health,7,0,0,0,0,0,1,1,3,2,0,0,0,0
S01007084,All people aged 16 to 74,435,28,9,19,80,59,38,48,84,66,6,6,0,26
S01007084,Very good health,183,12,3,9,37,28,11,23,37,16,1,1,0,18
S01007084,Good health,172,11,5,6,36,27,17,15,25,34,0,0,0,7
S01007084,Fair health,58,4,1,3,4,4,8,6,15,14,2,2,0,1
S01007084,Bad health,15,0,0,0,1,0,1,4,5,2,2,2,0,0
S01007084,Very bad health,7,1,0,1,2,0,1,0,2,0,1,1,0,0
S01007085,All people aged 16 to 74,637,38,9,29,100,54,50,86,122,121,30,14,16,36
S01007085,Very good health,294,25,7,18,51,25,21,39,55,47,9,4,5,22
S01007085,Good health,240,12,2,10,38,24,18,30,49,47,9,4,5,13
S01007085,Fair health,71,1,0,1,7,3,4,9,17,20,9,4,5,1
S01007085,Bad health,26,0,0,0,3,1,6,8,1,4,3,2,1,0
S01007085,Very bad health,6,0,0,0,1,1,1,0,0,3,0,0,0,0
S01007086,All people aged 16 to 74,871,18,6,12,88,52,42,106,182,241,83,43,40,59
S01007086,Very good health,350,11,3,8,42,25,10,48,67,87,25,10,15,35
S01007086,Good health,339,3,2,1,31,19,20,40,77,100,28,15,13,21
S01007086,Fair health,130,3,0,3,10,5,7,14,27,39,22,10,12,3
S01007086,Bad health,36,0,0,0,2,3,1,3,11,11,5,5,0,0
S01007086,Very bad health,16,1,1,0,3,0,4,1,0,4,3,3,0,0
S01007087,All people aged 16 to 74,660,22,3,19,57,35,40,84,154,188,44,33,11,36
S01007087,Very good health,195,9,1,8,19,9,8,31,46,46,6,3,3,21
S01007087,Good health,323,11,2,9,27,18,20,37,86,95,17,12,5,12
S01007087,Fair health,100,0,0,0,8,4,7,14,17,33,15,13,2,2
S01007087,Bad health,37,2,0,2,1,4,5,1,5,13,5,4,1,1
S01007087,Very bad health,5,0,0,0,2,0,0,1,0,1,1,1,0,0
S01007088,All people aged 16 to 74,408,8,1,7,31,23,25,55,86,123,37,22,15,20
S01007088,Very good health,140,6,1,5,14,9,12,17,32,29,7,6,1,14
S01007088,Good health,159,1,0,1,10,12,6,22,29,54,19,11,8,6
S01007088,Fair health,63,0,0,0,7,2,4,5,13,24,8,4,4,0
S01007088,Bad health,35,0,0,0,0,0,3,8,8,14,2,0,2,0
S01007088,Very bad health,11,1,0,1,0,0,0,3,4,2,1,1,0,0
S01007089,All people aged 16 to 74,404,32,15,17,95,62,36,49,59,48,8,6,2,15
S01007089,Very good health,219,20,8,12,58,31,16,30,28,19,6,6,0,11
S01007089,Good health,137,11,6,5,28,28,15,12,25,15,1,0,1,2
S01007089,Fair health,42,1,1,0,8,3,4,6,6,11,1,0,1,2
S01007089,Bad health,5,0,0,0,1,0,1,0,0,3,0,0,0,0
S01007089,Very bad health,1,0,0,0,0,0,0,1,0,0,0,0,0,0
S01007090,All people aged 16 to 74,414,15,4,11,84,63,33,49,90,57,8,6,2,15
S01007090,Very good health,209,4,1,3,45,36,16,26,45,23,3,3,0,11
S01007090,Good health,160,7,2,5,34,22,14,18,30,27,4,2,2,4
S01007090,Fair health,36,3,1,2,4,5,1,5,10,7,1,1,0,0
S01007090,Bad health,9,1,0,1,1,0,2,0,5,0,0,0,0,0
S01007090,Very bad health,0,0,0,0,0,0,0,0,0,0,0,0,0,0
S01007091,All people aged 16 to 74,576,34,12,22,84,58,31,71,114,102,23,14,9,59
S01007091,Very good health,318,21,7,14,55,32,19,48,59,38,8,4,4,38
S01007091,Good health,198,11,5,6,24,19,10,18,41,45,10,6,4,20
S01007091,Fair health,46,2,0,2,4,6,2,4,11,12,4,3,1,1
S01007091,Bad health,9,0,0,0,1,1,0,1,1,4,1,1,0,0
S01007091,Very bad health,5,0,0,0,0,0,0,0,2,3,0,0,0,0
S01007092,All people aged 16 to 74,449,13,4,9,65,44,25,58,102,106,17,11,6,19
S01007092,Very good health,170,7,2,5,36,17,10,25,33,27,3,2,1,12
S01007092,Good health,167,4,0,4,18,15,9,20,46,44,7,3,4,4
S01007092,Fair health,79,2,2,0,7,9,5,11,14,25,4,3,1,2
S01007092,Bad health,28,0,0,0,4,2,1,1,8,9,3,3,0,0
S01007092,Very bad health,5,0,0,0,0,1,0,1,1,1,0,0,0,1
S01007093,All people aged 16 to 74,749,53,11,42,148,133,53,102,121,92,8,7,1,39
S01007093,Very good health,390,30,4,26,88,72,26,43,54,44,4,3,1,29
S01007093,Good health,262,21,7,14,42,48,19,42,42,37,2,2,0,9
S01007093,Fair health,73,1,0,1,15,11,5,12,18,8,2,2,0,1
S01007093,Bad health,18,0,0,0,2,2,1,4,6,3,0,0,0,0
S01007093,Very bad health,6,1,0,1,1,0,2,1,1,0,0,0,0,0
S01007094,All people aged 16 to 74,679,34,12,22,142,78,76,75,107,120,11,9,2,36
S01007094,Very good health,336,19,5,14,79,41,26,39,54,50,1,0,1,27
S01007094,Good health,225,12,6,6,47,26,29,27,32,42,3,3,0,7
S01007094,Fair health,91,3,1,2,12,11,15,7,16,21,5,4,1,1
S01007094,Bad health,20,0,0,0,2,0,5,2,4,4,2,2,0,1
S01007094,Very bad health,7,0,0,0,2,0,1,0,1,3,0,0,0,0
S01007095,All people aged 16 to 74,419,44,14,30,88,46,68,38,52,45,14,13,1,24
S01007095,Very good health,205,26,9,17,46,19,32,20,25,16,2,2,0,19
S01007095,Good health,158,16,4,12,32,23,32,12,14,16,9,9,0,4
S01007095,Fair health,44,1,0,1,7,4,3,6,12,8,2,2,0,1
S01007095,Bad health,10,1,1,0,2,0,1,0,1,4,1,0,1,0
S01007095,Very bad health,2,0,0,0,1,0,0,0,0,1,0,0,0,0
S01007096,All people aged 16 to 74,602,57,14,43,153,70,74,68,90,58,7,5,2,25
S01007096,Very good health,353,25,5,20,98,42,35,46,56,30,1,1,0,20
S01007096,Good health,189,26,7,19,45,23,27,18,26,17,3,3,0,4
S01007096,Fair health,45,4,1,3,8,5,8,3,6,7,3,1,2,1
S01007096,Bad health,10,1,0,1,2,0,3,0,1,3,0,0,0,0
S01007096,Very bad health,5,1,1,0,0,0,1,1,1,1,0,0,0,0
S01007097,All people aged 16 to 74,372,34,7,27,60,55,52,42,61,41,8,5,3,19
S01007097,Very good health,205,26,6,20,39,28,19,24,29,22,2,2,0,16
S01007097,Good health,127,6,1,5,19,21,25,15,21,14,3,1,2,3
S01007097,Fair health,31,2,0,2,2,5,8,3,7,2,2,2,0,0
S01007097,Bad health,7,0,0,0,0,1,0,0,3,2,1,0,1,0
S01007097,Very bad health,2,0,0,0,0,0,0,0,1,1,0,0,0,0
S01007098,All people aged 16 to 74,617,51,18,33,154,80,94,58,75,58,16,12,4,31
S01007098,Very good health,359,29,9,20,92,49,56,31,40,30,7,4,3,25
S01007098,Good health,196,18,7,11,48,24,30,20,26,22,3,3,0,5
S01007098,Fair health,44,3,1,2,11,6,5,6,4,4,4,3,1,1
S01007098,Bad health,11,1,1,0,2,1,1,1,3,1,1,1,0,0
S01007098,Very bad health,7,0,0,0,1,0,2,0,2,1,1,1,0,0
S01007099,All people aged 16 to 74,649,30,11,19,141,74,110,79,85,85,12,7,5,33
S01007099,Very good health,365,15,5,10,82,50,67,40,40,38,6,3,3,27
S01007099,Good health,206,11,5,6,46,15,36,27,29,32,4,3,1,6
S01007099,Fair health,58,3,1,2,9,7,5,7,13,12,2,1,1,0
S01007099,Bad health,15,0,0,0,3,1,2,4,2,3,0,0,0,0
S01007099,Very bad health,5,1,0,1,1,1,0,1,1,0,0,0,0,0
S01007100,All people aged 16 to 74,561,31,10,21,132,59,52,69,85,85,17,14,3,31
S01007100,Very good health,278,19,6,13,75,33,24,33,33,34,6,5,1,21
S01007100,Good health,196,10,4,6,41,18,20,25,39,29,6,4,2,8
S01007100,Fair health,58,1,0,1,13,5,5,9,9,14,2,2,0,0
S01007100,Bad health,22,0,0,0,3,3,2,2,3,5,2,2,0,2
S01007100,Very bad health,7,1,0,1,0,0,1,0,1,3,1,1,0,0
S01007101,All people aged 16 to 74,611,17,7,10,84,50,36,63,147,155,25,15,10,34
S01007101,Very good health,259,9,4,5,38,20,21,26,55,61,11,8,3,18
S01007101,Good health,238,4,1,3,28,26,8,25,60,64,8,4,4,15
S01007101,Fair health,80,3,2,1,16,2,5,8,22,18,5,2,3,1
S01007101,Bad health,25,1,0,1,0,2,0,3,10,8,1,1,0,0
S01007101,Very bad health,9,0,0,0,2,0,2,1,0,4,0,0,0,0
S01007102,All people aged 16 to 74,553,30,8,22,104,48,73,77,80,89,13,11,2,39
S01007102,Very good health,279,14,5,9,51,30,35,38,33,46,4,4,0,28
S01007102,Good health,177,12,2,10,37,12,27,24,28,24,6,4,2,7
S01007102,Fair health,69,3,0,3,14,5,9,8,12,13,2,2,0,3
S01007102,Bad health,21,0,0,0,2,1,2,5,4,5,1,1,0,1
S01007102,Very bad health,7,1,1,0,0,0,0,2,3,1,0,0,0,0
S01007103,All people aged 16 to 74,607,35,10,25,86,75,79,86,101,89,7,5,2,49
S01007103,Very good health,294,20,5,15,33,41,36,42,43,43,3,3,0,33
S01007103,Good health,216,12,4,8,41,32,25,27,36,26,3,2,1,14
S01007103,Fair health,70,2,1,1,9,2,13,13,18,10,1,0,1,2
S01007103,Bad health,17,0,0,0,2,0,4,3,2,6,0,0,0,0
S01007103,Very bad health,10,1,0,1,1,0,1,1,2,4,0,0,0,0
S01007104,All people aged 16 to 74,377,27,6,21,58,47,76,29,68,48,7,6,1,17
S01007104,Very good health,162,11,4,7,30,16,29,15,26,23,0,0,0,12
S01007104,Good health,141,12,1,11,23,15,32,10,29,12,4,3,1,4
S01007104,Fair health,52,4,1,3,4,11,8,4,10,8,2,2,0,1
S01007104,Bad health,19,0,0,0,1,5,7,0,2,4,0,0,0,0
S01007104,Very bad health,3,0,0,0,0,0,0,0,1,1,1,1,0,0
S01007105,All people aged 16 to 74,384,23,5,18,75,49,37,49,54,64,8,5,3,25
S01007105,Very good health,183,13,3,10,36,26,19,22,19,27,3,1,2,18
S01007105,Good health,131,7,2,5,24,17,10,17,22,23,5,4,1,6
S01007105,Fair health,44,3,0,3,9,5,4,7,7,8,0,0,0,1
S01007105,Bad health,25,0,0,0,6,1,3,3,6,6,0,0,0,0
S01007105,Very bad health,1,0,0,0,0,0,1,0,0,0,0,0,0,0
S01007106,All people aged 16 to 74,550,24,5,19,89,56,59,75,98,91,19,12,7,39
S01007106,Very good health,214,11,2,9,39,23,23,30,31,26,1,1,0,30
S01007106,Good health,211,12,2,10,35,22,24,26,35,41,9,3,6,7
S01007106,Fair health,83,1,1,0,12,8,8,15,17,14,6,5,1,2
S01007106,Bad health,29,0,0,0,2,1,2,3,12,7,2,2,0,0
S01007106,Very bad health,13,0,0,0,1,2,2,1,3,3,1,1,0,0
S01007107,All people aged 16 to 74,505,30,12,18,104,62,92,53,63,61,9,6,3,31
S01007107,Very good health,243,18,8,10,53,31,46,21,21,26,1,1,0,26
S01007107,Good health,182,9,3,6,35,24,27,22,32,22,7,5,2,4
S01007107,Fair health,63,3,1,2,12,7,15,8,6,10,1,0,1,1
S01007107,Bad health,14,0,0,0,3,0,4,2,3,2,0,0,0,0
S01007107,Very bad health,3,0,0,0,1,0,0,0,1,1,0,0,0,0
S01007108,All people aged 16 to 74,433,20,5,15,84,49,100,40,67,42,12,8,4,19
S01007108,Very good health,196,14,4,10,38,21,51,19,25,14,4,2,2,10
S01007108,Good health,162,4,1,3,39,17,37,11,24,19,4,3,1,7
S01007108,Fair health,52,2,0,2,5,5,10,7,13,6,2,1,1,2
S01007108,Bad health,18,0,0,0,2,6,2,3,3,1,1,1,0,0
S01007108,Very bad health,5,0,0,0,0,0,0,0,2,2,1,1,0,0
S01007109,All people aged 16 to 74,614,11,6,5,70,43,62,70,130,181,22,13,9,25
S01007109,Very good health,244,4,1,3,29,22,20,28,48,63,11,6,5,19
S01007109,Good health,223,6,4,2,26,13,24,29,56,59,4,3,1,6
S01007109,Fair health,92,0,0,0,12,7,9,9,16,35,4,2,2,0
S01007109,Bad health,44,1,1,0,3,0,8,3,7,19,3,2,1,0
S01007109,Very bad health,11,0,0,0,0,1,1,1,3,5,0,0,0,0
S01007110,All people aged 16 to 74,558,33,19,14,93,65,48,66,101,100,18,7,11,34
S01007110,Very good health,247,18,5,13,48,36,15,26,46,33,3,0,3,22
S01007110,Good health,226,11,10,1,30,19,26,31,42,44,12,4,8,11
S01007110,Fair health,61,4,4,0,11,6,6,8,11,12,2,2,0,1
S01007110,Bad health,22,0,0,0,3,4,1,1,1,11,1,1,0,0
S01007110,Very bad health,2,0,0,0,1,0,0,0,1,0,0,0,0,0
S01007111,All people aged 16 to 74,398,12,4,8,58,42,31,61,86,67,12,7,5,29
S01007111,Very good health,200,7,1,6,26,28,9,37,42,26,3,1,2,22
S01007111,Good health,132,3,2,1,23,10,14,13,28,31,4,1,3,6
S01007111,Fair health,44,0,0,0,8,1,6,8,10,6,4,4,0,1
S01007111,Bad health,17,2,1,1,1,3,0,3,4,3,1,1,0,0
S01007111,Very bad health,5,0,0,0,0,0,2,0,2,1,0,0,0,0
S01007112,All people aged 16 to 74,434,24,4,20,77,47,65,51,66,63,17,11,6,24
S01007112,Very good health,210,13,2,11,42,25,25,29,31,18,7,4,3,20
S01007112,Good health,160,8,2,6,25,18,25,15,28,33,5,4,1,3
S01007112,Fair health,49,3,0,3,8,3,11,6,6,9,2,0,2,1
S01007112,Bad health,13,0,0,0,1,1,3,1,1,3,3,3,0,0
S01007112,Very bad health,2,0,0,0,1,0,1,0,0,0,0,0,0,0
S01007113,All people aged 16 to 74,402,43,8,35,91,32,51,45,56,49,16,13,3,19
S01007113,Very good health,188,30,7,23,41,16,21,19,20,23,5,4,1,13
S01007113,Good health,137,10,1,9,35,12,22,15,22,14,3,3,0,4
S01007113,Fair health,59,1,0,1,11,3,6,10,13,8,5,3,2,2
S01007113,Bad health,15,2,0,2,3,1,1,1,1,3,3,3,0,0
S01007113,Very bad health,3,0,0,0,1,0,1,0,0,1,0,0,0,0
S01007114,All people aged 16 to 74,659,30,5,25,101,80,44,94,132,120,6,5,1,52
S01007114,Very good health,301,16,2,14,45,39,17,41,54,48,2,2,0,39
S01007114,Good health,277,13,2,11,48,32,22,39,61,49,1,1,0,12
S01007114,Fair health,54,1,1,0,5,6,3,8,13,16,1,0,1,1
S01007114,Bad health,26,0,0,0,3,3,2,6,4,6,2,2,0,0
S01007114,Very bad health,1,0,0,0,0,0,0,0,0,1,0,0,0,0
S01007115,All people aged 16 to 74,496,24,10,14,89,66,33,61,101,67,14,12,2,41
S01007115,Very good health,240,12,5,7,50,35,8,35,47,22,3,3,0,28
S01007115,Good health,180,10,4,6,31,23,18,17,41,24,5,3,2,11
S01007115,Fair health,60,2,1,1,7,7,7,8,11,13,4,4,0,1
S01007115,Bad health,8,0,0,0,1,1,0,0,1,3,2,2,0,0
S01007115,Very bad health,8,0,0,0,0,0,0,1,1,5,0,0,0,1
S01007116,All people aged 16 to 74,718,54,13,41,132,91,95,88,125,66,8,6,2,59
S01007116,Very good health,431,33,7,26,82,59,54,53,62,34,3,2,1,51
S01007116,Good health,232,21,6,15,42,28,34,29,48,23,1,0,1,6
S01007116,Fair health,41,0,0,0,8,3,6,4,11,7,0,0,0,2
S01007116,Bad health,12,0,0,0,0,1,0,2,4,2,3,3,0,0
S01007116,Very bad health,2,0,0,0,0,0,1,0,0,0,1,1,0,0
S01007117,All people aged 16 to 74,364,34,14,20,76,37,44,39,67,34,7,5,2,26
S01007117,Very good health,218,27,12,15,42,24,26,29,31,15,5,3,2,19
S01007117,Good health,109,7,2,5,28,11,15,8,22,14,0,0,0,4
S01007117,Fair health,29,0,0,0,3,2,3,2,11,4,2,2,0,2
S01007117,Bad health,8,0,0,0,3,0,0,0,3,1,0,0,0,1
S01007117,Very bad health,0,0,0,0,0,0,0,0,0,0,0,0,0,0
S01007118,All people aged 16 to 74,516,13,3,10,53,48,25,61,126,128,30,20,10,32
S01007118,Very good health,220,7,2,5,20,25,8,25,62,54,6,4,2,13
S01007118,Good health,173,4,0,4,18,13,11,25,35,41,13,7,6,13
S01007118,Fair health,85,1,1,0,7,8,5,9,20,21,8,6,2,6
S01007118,Bad health,27,1,0,1,6,0,1,2,6,9,2,2,0,0
S01007118,Very bad health,11,0,0,0,2,2,0,0,3,3,1,1,0,0
S01007119,All people aged 16 to 74,625,19,6,13,70,37,39,100,120,170,22,12,10,48
S01007119,Very good health,290,10,2,8,28,20,13,46,60,73,8,5,3,32
S01007119,Good health,222,8,4,4,25,13,17,38,43,57,10,4,6,11
S01007119,Fair health,76,1,0,1,9,3,4,12,12,29,2,1,1,4
S01007119,Bad health,32,0,0,0,5,1,4,3,5,11,2,2,0,1
S01007119,Very bad health,5,0,0,0,3,0,1,1,0,0,0,0,0,0
S01007120,All people aged 16 to 74,862,23,7,16,98,45,44,121,219,218,43,20,23,51
S01007120,Very good health,345,14,3,11,46,22,15,42,87,76,10,8,2,33
S01007120,Good health,332,9,4,5,35,15,18,49,82,84,23,7,16,17
S01007120,Fair health,129,0,0,0,14,7,3,15,40,42,7,2,5,1
S01007120,Bad health,39,0,0,0,2,1,6,14,6,8,2,2,0,0
S01007120,Very bad health,17,0,0,0,1,0,2,1,4,8,1,1,0,0
S01007121,All people aged 16 to 74,355,9,4,5,33,23,30,42,77,98,14,6,8,29
S01007121,Very good health,115,2,1,1,11,6,8,18,21,29,3,0,3,17
S01007121,Good health,151,3,0,3,15,12,12,18,27,47,6,2,4,11
S01007121,Fair health,64,2,2,0,6,3,5,5,20,18,4,3,1,1
S01007121,Bad health,17,1,1,0,0,2,4,0,7,3,0,0,0,0
S01007121,Very bad health,8,1,0,1,1,0,1,1,2,1,1,1,0,0
S01007122,All people aged 16 to 74,453,29,8,21,94,48,40,46,81,72,12,9,3,31
S01007122,Very good health,209,14,3,11,43,27,15,18,37,28,3,1,2,24
S01007122,Good health,175,13,5,8,42,17,16,23,26,27,5,4,1,6
S01007122,Fair health,49,1,0,1,7,3,7,2,14,11,3,3,0,1
S01007122,Bad health,14,1,0,1,1,1,2,2,2,4,1,1,0,0
S01007122,Very bad health,6,0,0,0,1,0,0,1,2,2,0,0,0,0
S01007123,All people aged 16 to 74,468,13,6,7,64,42,20,59,98,126,15,10,5,31
S01007123,Very good health,199,9,3,6,30,17,9,25,38,51,3,3,0,17
S01007123,Good health,170,3,3,0,27,21,8,22,30,41,6,3,3,12
S01007123,Fair health,69,1,0,1,6,2,3,8,19,24,4,3,1,2
S01007123,Bad health,27,0,0,0,0,2,0,4,11,9,1,0,1,0
S01007123,Very bad health,3,0,0,0,1,0,0,0,0,1,1,1,0,0
S01007124,All people aged 16 to 74,666,26,10,16,96,72,47,98,147,126,18,5,13,36
S01007124,Very good health,332,11,4,7,56,50,23,44,59,57,12,3,9,20
S01007124,Good health,239,12,5,7,31,21,14,37,57,47,6,2,4,14
S01007124,Fair health,70,2,0,2,7,1,7,11,23,17,0,0,0,2
S01007124,Bad health,20,1,1,0,2,0,3,4,5,5,0,0,0,0
S01007124,Very bad health,5,0,0,0,0,0,0,2,3,0,0,0,0,0
S01007125,All people aged 16 to 74,622,25,3,22,67,46,36,72,133,169,27,19,8,47
S01007125,Very good health,266,15,2,13,29,21,11,33,57,64,11,8,3,25
S01007125,Good health,222,9,1,8,24,18,18,23,49,58,9,6,3,14
S01007125,Fair health,92,1,0,1,13,2,4,9,24,27,4,2,2,8
S01007125,Bad health,33,0,0,0,1,5,1,5,3,16,2,2,0,0
S01007125,Very bad health,9,0,0,0,0,0,2,2,0,4,1,1,0,0
S01007126,All people aged 16 to 74,681,8,0,8,50,24,36,81,148,216,64,45,19,54
S01007126,Very good health,252,1,0,1,21,11,12,36,45,76,18,13,5,32
S01007126,Good health,267,6,0,6,20,8,9,34,53,91,28,22,6,18
S01007126,Fair health,113,0,0,0,3,3,8,8,39,32,16,8,8,4
S01007126,Bad health,39,1,0,1,4,1,6,3,9,14,1,1,0,0
S01007126,Very bad health,10,0,0,0,2,1,1,0,2,3,1,1,0,0
S01007127,All people aged 16 to 74,782,24,9,15,59,32,53,85,186,265,37,19,18,41
S01007127,Very good health,278,14,6,8,22,13,20,35,65,74,13,5,8,22
S01007127,Good health,340,5,2,3,29,12,16,31,89,128,16,7,9,14
S01007127,Fair health,115,3,0,3,7,6,8,11,22,48,6,5,1,4
S01007127,Bad health,36,2,1,1,1,0,8,7,9,7,2,2,0,0
S01007127,Very bad health,13,0,0,0,0,1,1,1,1,8,0,0,0,1
S01007128,All people aged 16 to 74,618,12,1,11,72,33,29,94,150,161,32,13,19,35
S01007128,Very good health,234,6,0,6,34,15,12,35,62,38,8,3,5,24
S01007128,Good health,226,5,1,4,21,12,8,41,50,63,15,4,11,11
S01007128,Fair health,105,1,0,1,11,4,7,10,27,38,7,5,2,0
S01007128,Bad health,39,0,0,0,4,1,2,5,8,17,2,1,1,0
S01007128,Very bad health,14,0,0,0,2,1,0,3,3,5,0,0,0,0
S01007129,All people aged 16 to 74,698,164,27,137,223,93,59,28,37,31,14,9,5,49
S01007129,Very good health,436,121,16,105,132,55,29,20,16,15,5,4,1,43
S01007129,Good health,215,41,10,31,73,30,22,8,16,13,7,4,3,5
S01007129,Fair health,34,2,1,1,9,7,8,0,5,3,0,0,0,0
S01007129,Bad health,8,0,0,0,4,1,0,0,0,0,2,1,1,1
S01007129,Very bad health,5,0,0,0,5,0,0,0,0,0,0,0,0,0
S01007130,All people aged 16 to 74,456,50,6,44,125,71,33,40,69,39,6,3,3,23
S01007130,Very good health,230,35,3,32,75,34,16,15,26,9,4,1,3,16
S01007130,Good health,165,13,2,11,36,27,14,21,27,20,1,1,0,6
S01007130,Fair health,44,1,1,0,11,6,2,2,13,8,0,0,0,1
S01007130,Bad health,14,1,0,1,1,4,1,1,3,2,1,1,0,0
S01007130,Very bad health,3,0,0,0,2,0,0,1,0,0,0,0,0,0
S01007131,All people aged 16 to 74,576,64,16,48,194,88,36,49,61,43,4,3,1,37
S01007131,Very good health,339,37,8,29,118,42,22,36,29,21,1,1,0,33
S01007131,Good health,166,21,7,14,54,32,10,10,23,13,0,0,0,3
S01007131,Fair health,53,5,0,5,17,11,4,2,7,5,1,0,1,1
S01007131,Bad health,13,0,0,0,4,2,0,1,2,3,1,1,0,0
S01007131,Very bad health,5,1,1,0,1,1,0,0,0,1,1,1,0,0
S01007132,All people aged 16 to 74,517,68,7,61,139,88,39,33,59,38,5,3,2,48
S01007132,Very good health,315,43,2,41,74,51,23,21,39,21,2,1,1,41
S01007132,Good health,159,19,4,15,53,27,14,10,17,10,2,1,1,7
S01007132,Fair health,31,5,0,5,8,7,1,2,2,5,1,1,0,0
S01007132,Bad health,11,1,1,0,4,3,1,0,1,1,0,0,0,0
S01007132,Very bad health,1,0,0,0,0,0,0,0,0,1,0,0,0,0
S01007133,All people aged 16 to 74,515,66,10,56,115,64,83,38,47,51,10,7,3,41
S01007133,Very good health,291,40,7,33,66,37,38,25,18,27,3,3,0,37
S01007133,Good health,155,20,3,17,41,16,33,8,20,11,3,2,1,3
S01007133,Fair health,48,4,0,4,6,9,8,4,6,8,2,0,2,1
S01007133,Bad health,15,1,0,1,2,2,3,1,1,4,1,1,0,0
S01007133,Very bad health,6,1,0,1,0,0,1,0,2,1,1,1,0,0
S01007134,All people aged 16 to 74,542,70,12,58,111,63,74,43,68,76,12,7,5,25
S01007134,Very good health,268,49,8,41,55,35,27,21,27,27,3,1,2,24
S01007134,Good health,191,14,2,12,44,22,35,9,30,31,5,2,3,1
S01007134,Fair health,51,7,2,5,7,4,8,9,5,9,2,2,0,0
S01007134,Bad health,27,0,0,0,3,2,4,4,4,8,2,2,0,0
S01007134,Very bad health,5,0,0,0,2,0,0,0,2,1,0,0,0,0
S01007135,All people aged 16 to 74,395,74,12,62,115,42,55,16,30,28,6,4,2,29
S01007135,Very good health,227,54,9,45,63,28,28,5,10,15,1,1,0,23
S01007135,Good health,130,17,3,14,40,13,22,7,16,8,2,1,1,5
S01007135,Fair health,28,3,0,3,10,1,5,2,3,2,1,0,1,1
S01007135,Bad health,7,0,0,0,2,0,0,1,1,2,1,1,0,0
S01007135,Very bad health,3,0,0,0,0,0,0,1,0,1,1,1,0,0
S01007136,All people aged 16 to 74,384,83,16,67,97,49,63,20,19,15,8,4,4,30
S01007136,Very good health,245,55,8,47,56,30,40,12,13,12,3,2,1,24
S01007136,Good health,109,25,7,18,30,17,15,5,5,3,4,1,3,5
S01007136,Fair health,22,2,0,2,9,0,6,2,1,0,1,1,0,1
S01007136,Bad health,7,1,1,0,2,1,2,1,0,0,0,0,0,0
S01007136,Very bad health,1,0,0,0,0,1,0,0,0,0,0,0,0,0
S01007137,All people aged 16 to 74,514,82,19,63,177,67,56,34,34,19,7,2,5,38
S01007137,Very good health,364,62,12,50,118,52,35,23,23,12,6,1,5,33
S01007137,Good health,121,18,6,12,51,11,17,7,9,7,0,0,0,1
S01007137,Fair health,22,2,1,1,5,4,4,4,2,0,0,0,0,1
S01007137,Bad health,6,0,0,0,3,0,0,0,0,0,1,1,0,2
S01007137,Very bad health,1,0,0,0,0,0,0,0,0,0,0,0,0,1
S01007138,All people aged 16 to 74,443,58,10,48,127,58,53,33,39,43,8,4,4,24
S01007138,Very good health,255,35,5,30,69,34,31,22,21,24,4,2,2,15
S01007138,Good health,131,14,3,11,38,17,17,8,14,11,4,2,2,8
S01007138,Fair health,39,9,2,7,13,5,4,2,3,2,0,0,0,1
S01007138,Bad health,14,0,0,0,5,2,0,0,1,6,0,0,0,0
S01007138,Very bad health,4,0,0,0,2,0,1,1,0,0,0,0,0,0
S01007139,All people aged 16 to 74,568,47,16,31,125,81,69,65,87,54,12,5,7,28
S01007139,Very good health,307,27,8,19,75,44,32,29,40,27,8,4,4,25
S01007139,Good health,183,13,4,9,35,30,30,22,29,20,2,0,2,2
S01007139,Fair health,58,5,2,3,14,6,3,11,11,5,2,1,1,1
S01007139,Bad health,17,2,2,0,0,1,3,3,6,2,0,0,0,0
S01007139,Very bad health,3,0,0,0,1,0,1,0,1,0,0,0,0,0
S01007140,All people aged 16 to 74,783,92,20,72,225,106,98,48,98,47,19,10,9,50
S01007140,Very good health,446,55,13,42,145,54,46,22,49,24,9,3,6,42
S01007140,Good health,235,25,6,19,60,38,32,16,35,16,5,2,3,8
S01007140,Fair health,72,10,1,9,16,12,14,5,10,3,2,2,0,0
S01007140,Bad health,19,2,0,2,3,1,3,3,4,2,1,1,0,0
S01007140,Very bad health,11,0,0,0,1,1,3,2,0,2,2,2,0,0
S01007141,All people aged 16 to 74,506,60,18,42,128,71,58,33,61,53,7,6,1,35
S01007141,Very good health,308,36,10,26,88,38,33,19,30,30,4,3,1,30
S01007141,Good health,148,20,8,12,34,25,19,9,22,12,2,2,0,5
S01007141,Fair health,30,4,0,4,1,5,5,3,7,5,0,0,0,0
S01007141,Bad health,15,0,0,0,5,2,1,1,2,3,1,1,0,0
S01007141,Very bad health,5,0,0,0,0,1,0,1,0,3,0,0,0,0
S01007142,All people aged 16 to 74,403,61,18,43,129,55,24,17,30,18,20,17,3,49
S01007142,Very good health,265,38,12,26,88,43,13,10,17,8,5,3,2,43
S01007142,Good health,95,20,5,15,31,9,9,4,8,6,2,1,1,6
S01007142,Fair health,24,2,1,1,8,2,0,2,2,3,5,5,0,0
S01007142,Bad health,15,1,0,1,1,1,1,0,3,1,7,7,0,0
S01007142,Very bad health,4,0,0,0,1,0,1,1,0,0,1,1,0,0
S01007143,All people aged 16 to 74,431,57,16,41,145,65,30,40,44,23,5,3,2,22
S01007143,Very good health,290,45,10,35,97,42,21,25,29,13,2,1,1,16
S01007143,Good health,115,12,6,6,40,16,9,12,12,8,1,1,0,5
S01007143,Fair health,19,0,0,0,6,5,0,2,3,0,2,1,1,1
S01007143,Bad health,5,0,0,0,1,2,0,1,0,1,0,0,0,0
S01007143,Very bad health,2,0,0,0,1,0,0,0,0,1,0,0,0,0
S01007144,All people aged 16 to 74,572,49,9,40,123,63,91,45,76,73,22,12,10,30
S01007144,Very good health,288,29,3,26,70,26,51,22,26,30,13,8,5,21
S01007144,Good health,190,18,6,12,40,22,31,18,34,21,3,1,2,3
S01007144,Fair health,69,2,0,2,8,9,8,4,13,15,5,2,3,5
S01007144,Bad health,20,0,0,0,5,4,1,1,3,4,1,1,0,1
S01007144,Very bad health,5,0,0,0,0,2,0,0,0,3,0,0,0,0
S01007145,All people aged 16 to 74,635,62,13,49,182,104,50,39,82,57,20,12,8,39
S01007145,Very good health,289,32,5,27,90,39,19,16,32,24,5,4,1,32
S01007145,Good health,253,26,7,19,69,42,23,17,36,23,10,3,7,7
S01007145,Fair health,66,2,1,1,16,16,5,5,12,5,5,5,0,0
S01007145,Bad health,21,2,0,2,6,7,1,1,0,4,0,0,0,0
S01007145,Very bad health,6,0,0,0,1,0,2,0,2,1,0,0,0,0
S01007146,All people aged 16 to 74,517,54,13,41,158,73,33,31,70,52,7,4,3,39
S01007146,Very good health,262,33,7,26,89,37,12,13,29,19,1,1,0,29
S01007146,Good health,180,15,5,10,47,27,15,14,29,22,4,1,3,7
S01007146,Fair health,50,6,1,5,15,5,4,2,6,9,1,1,0,2
S01007146,Bad health,20,0,0,0,5,3,2,2,5,2,1,1,0,0
S01007146,Very bad health,5,0,0,0,2,1,0,0,1,0,0,0,0,1
S01007147,All people aged 16 to 74,538,47,10,37,170,85,34,42,64,43,13,9,4,40
S01007147,Very good health,272,30,8,22,79,44,12,18,34,17,4,3,1,34
S01007147,Good health,189,13,1,12,73,26,15,16,16,19,5,3,2,6
S01007147,Fair health,56,3,0,3,15,9,6,6,10,5,2,1,1,0
S01007147,Bad health,13,0,0,0,1,6,0,1,3,1,1,1,0,0
S01007147,Very bad health,8,1,1,0,2,0,1,1,1,1,1,1,0,0
S01007148,All people aged 16 to 74,414,55,11,44,109,65,29,32,53,21,9,2,7,41
S01007148,Very good health,260,31,5,26,74,39,16,18,27,11,7,2,5,37
S01007148,Good health,118,19,4,15,27,19,12,9,20,7,2,0,2,3
S01007148,Fair health,27,5,2,3,6,4,1,3,5,2,0,0,0,1
S01007148,Bad health,7,0,0,0,2,2,0,2,0,1,0,0,0,0
S01007148,Very bad health,2,0,0,0,0,1,0,0,1,0,0,0,0,0
S01007149,All people aged 16 to 74,426,30,6,24,114,91,26,48,49,39,5,3,2,24
S01007149,Very good health,228,18,3,15,61,38,13,30,25,17,3,2,1,23
S01007149,Good health,134,9,2,7,35,35,7,10,17,18,2,1,1,1
S01007149,Fair health,46,1,1,0,14,12,5,8,3,3,0,0,0,0
S01007149,Bad health,15,2,0,2,3,5,1,0,4,0,0,0,0,0
S01007149,Very bad health,3,0,0,0,1,1,0,0,0,1,0,0,0,0
S01007150,All people aged 16 to 74,500,63,18,45,149,84,43,32,63,22,4,3,1,40
S01007150,Very good health,260,36,7,29,80,45,22,13,23,10,1,0,1,30
S01007150,Good health,173,21,9,12,50,29,16,12,25,9,2,2,0,9
S01007150,Fair health,49,5,2,3,11,9,3,5,13,1,1,1,0,1
S01007150,Bad health,16,1,0,1,6,1,2,2,2,2,0,0,0,0
S01007150,Very bad health,2,0,0,0,2,0,0,0,0,0,0,0,0,0
S01007151,All people aged 16 to 74,640,85,18,67,171,108,47,44,66,40,18,11,7,61
S01007151,Very good health,375,52,10,42,106,66,26,21,26,19,8,2,6,51
S01007151,Good health,196,26,7,19,48,35,14,18,25,15,5,4,1,10
S01007151,Fair health,53,6,0,6,14,5,5,5,10,4,4,4,0,0
S01007151,Bad health,11,1,1,0,2,2,2,0,3,1,0,0,0,0
S01007151,Very bad health,5,0,0,0,1,0,0,0,2,1,1,1,0,0
S01007152,All people aged 16 to 74,410,49,13,36,130,64,30,27,49,23,6,3,3,32
S01007152,Very good health,236,29,6,23,77,34,13,15,24,11,3,1,2,30
S01007152,Good health,121,16,5,11,40,20,13,10,14,5,1,0,1,2
S01007152,Fair health,44,4,2,2,11,9,3,2,9,5,1,1,0,0
S01007152,Bad health,7,0,0,0,2,1,1,0,0,2,1,1,0,0
S01007152,Very bad health,2,0,0,0,0,0,0,0,2,0,0,0,0,0
S01007153,All people aged 16 to 74,456,35,12,23,149,82,30,39,52,40,4,4,0,25
S01007153,Very good health,223,14,5,9,76,39,17,20,22,14,2,2,0,19
S01007153,Good health,168,16,6,10,54,35,9,13,19,16,0,0,0,6
S01007153,Fair health,45,3,0,3,12,7,3,6,7,6,1,1,0,0
S01007153,Bad health,20,2,1,1,7,1,1,0,4,4,1,1,0,0
S01007153,Very bad health,0,0,0,0,0,0,0,0,0,0,0,0,0,0
S01007154,All people aged 16 to 74,513,42,8,34,157,83,27,38,82,46,12,7,5,26
S01007154,Very good health,275,25,4,21,83,42,15,15,51,18,6,3,3,20
S01007154,Good health,161,13,4,9,47,30,9,18,20,18,2,1,1,4
S01007154,Fair health,48,3,0,3,16,10,0,2,7,7,1,1,0,2
S01007154,Bad health,23,1,0,1,8,0,3,3,2,3,3,2,1,0
S01007154,Very bad health,6,0,0,0,3,1,0,0,2,0,0,0,0,0
S01007155,All people aged 16 to 74,445,36,9,27,128,77,37,38,51,40,9,5,4,29
S01007155,Very good health,238,19,4,15,80,41,13,20,22,12,5,2,3,26
S01007155,Good health,148,14,4,10,33,30,16,11,22,19,2,1,1,1
S01007155,Fair health,39,1,1,0,13,5,7,3,4,3,2,2,0,1
S01007155,Bad health,12,1,0,1,1,0,0,2,2,5,0,0,0,1
S01007155,Very bad health,8,1,0,1,1,1,1,2,1,1,0,0,0,0
S01007156,All people aged 16 to 74,549,32,7,25,119,79,37,54,96,79,18,12,6,35
S01007156,Very good health,245,24,7,17,47,31,15,22,40,30,7,4,3,29
S01007156,Good health,222,7,0,7,58,39,15,23,38,31,6,4,2,5
S01007156,Fair health,59,1,0,1,13,5,6,7,13,11,2,1,1,1
S01007156,Bad health,18,0,0,0,1,2,1,2,5,4,3,3,0,0
S01007156,Very bad health,5,0,0,0,0,2,0,0,0,3,0,0,0,0
S01007157,All people aged 16 to 74,468,15,5,10,105,71,40,55,80,65,14,10,4,23
S01007157,Very good health,211,5,1,4,45,33,20,27,31,26,4,4,0,20
S01007157,Good health,181,6,2,4,51,28,11,23,31,22,6,2,4,3
S01007157,Fair health,57,4,2,2,6,6,8,3,14,12,4,4,0,0
S01007157,Bad health,15,0,0,0,3,4,0,1,4,3,0,0,0,0
S01007157,Very bad health,4,0,0,0,0,0,1,1,0,2,0,0,0,0
S01007158,All people aged 16 to 74,698,41,9,32,176,117,40,81,104,70,26,12,14,43
S01007158,Very good health,383,19,3,16,99,72,23,35,55,32,11,6,5,37
S01007158,Good health,241,19,5,14,64,38,11,33,35,25,11,4,7,5
S01007158,Fair health,54,2,1,1,10,6,5,11,9,8,3,1,2,0
S01007158,Bad health,17,1,0,1,3,1,1,2,3,5,1,1,0,0
S01007158,Very bad health,3,0,0,0,0,0,0,0,2,0,0,0,0,1
S01007159,All people aged 16 to 74,621,21,4,17,128,81,49,52,117,110,22,6,16,41
S01007159,Very good health,278,12,2,10,59,36,23,19,53,39,11,0,11,26
S01007159,Good health,225,5,1,4,55,30,16,22,38,40,5,4,1,14
S01007159,Fair health,84,4,1,3,12,10,9,6,18,21,4,1,3,0
S01007159,Bad health,26,0,0,0,2,4,0,3,5,9,2,1,1,1
S01007159,Very bad health,8,0,0,0,0,1,1,2,3,1,0,0,0,0
S01007160,All people aged 16 to 74,617,19,3,16,129,74,45,73,117,93,20,12,8,47
S01007160,Very good health,264,12,3,9,54,33,12,34,47,27,8,4,4,37
S01007160,Good health,239,6,0,6,47,33,28,21,51,36,9,5,4,8
S01007160,Fair health,74,0,0,0,20,7,5,9,12,17,2,2,0,2
S01007160,Bad health,29,1,0,1,6,1,0,4,6,10,1,1,0,0
S01007160,Very bad health,11,0,0,0,2,0,0,5,1,3,0,0,0,0
S01007161,All people aged 16 to 74,519,36,13,23,132,84,36,50,73,55,24,17,7,29
S01007161,Very good health,258,20,8,12,71,44,13,30,27,23,11,8,3,19
S01007161,Good health,191,16,5,11,45,27,19,15,32,24,5,4,1,8
S01007161,Fair health,47,0,0,0,10,8,1,4,10,6,6,4,2,2
S01007161,Bad health,18,0,0,0,3,5,3,1,2,2,2,1,1,0
S01007161,Very bad health,5,0,0,0,3,0,0,0,2,0,0,0,0,0
S01007162,All people aged 16 to 74,365,23,7,16,107,48,28,31,49,43,12,5,7,24
S01007162,Very good health,168,12,2,10,54,26,10,15,17,16,3,1,2,15
S01007162,Good health,135,11,5,6,36,15,9,10,26,15,6,2,4,7
S01007162,Fair health,38,0,0,0,9,5,7,2,5,6,2,1,1,2
S01007162,Bad health,15,0,0,0,7,1,2,3,0,1,1,1,0,0
S01007162,Very bad health,9,0,0,0,1,1,0,1,1,5,0,0,0,0
S01007163,All people aged 16 to 74,642,49,7,42,166,107,42,50,101,78,15,10,5,34
S01007163,Very good health,298,25,3,22,85,53,18,22,37,29,5,3,2,24
S01007163,Good health,246,21,4,17,54,38,20,22,47,30,7,4,3,7
S01007163,Fair health,73,2,0,2,22,11,3,5,12,14,1,1,0,3
S01007163,Bad health,23,1,0,1,4,5,1,1,5,4,2,2,0,0
S01007163,Very bad health,2,0,0,0,1,0,0,0,0,1,0,0,0,0
S01007164,All people aged 16 to 74,419,32,6,26,113,55,35,33,55,48,10,6,4,38
S01007164,Very good health,214,15,3,12,63,30,15,16,25,17,2,1,1,31
S01007164,Good health,156,12,1,11,41,21,16,14,22,20,4,2,2,6
S01007164,Fair health,35,4,2,2,6,3,2,2,7,8,3,3,0,0
S01007164,Bad health,13,1,0,1,3,1,2,0,1,3,1,0,1,1
S01007164,Very bad health,1,0,0,0,0,0,0,1,0,0,0,0,0,0
S01007165,All people aged 16 to 74,578,65,15,50,177,81,56,40,68,39,14,7,7,38
S01007165,Very good health,344,45,9,36,107,51,25,26,34,20,5,2,3,31
S01007165,Good health,176,20,6,14,51,25,25,8,24,10,7,3,4,6
S01007165,Fair health,40,0,0,0,17,3,5,3,7,4,1,1,0,0
S01007165,Bad health,16,0,0,0,2,1,1,3,3,4,1,1,0,1
S01007165,Very bad health,2,0,0,0,0,1,0,0,0,1,0,0,0,0
S01007166,All people aged 16 to 74,487,55,13,42,132,69,38,51,55,52,12,8,4,23
S01007166,Very good health,259,34,5,29,67,37,17,26,28,26,6,4,2,18
S01007166,Good health,164,19,7,12,37,24,19,21,18,19,3,1,2,4
S01007166,Fair health,52,0,0,0,25,5,2,3,7,6,3,3,0,1
S01007166,Bad health,9,2,1,1,3,2,0,0,1,1,0,0,0,0
S01007166,Very bad health,3,0,0,0,0,1,0,1,1,0,0,0,0,0
S01007167,All people aged 16 to 74,615,71,22,49,179,107,53,37,64,46,10,6,4,48
S01007167,Very good health,330,40,14,26,100,44,27,22,29,26,5,2,3,37
S01007167,Good health,211,23,6,17,62,46,19,9,26,15,1,0,1,10
S01007167,Fair health,57,3,0,3,16,13,6,4,9,4,1,1,0,1
S01007167,Bad health,16,5,2,3,1,3,1,2,0,1,3,3,0,0
S01007167,Very bad health,1,0,0,0,0,1,0,0,0,0,0,0,0,0
S01007168,All people aged 16 to 74,746,94,16,78,200,141,52,46,102,51,6,4,2,54
S01007168,Very good health,408,49,10,39,114,78,23,27,48,26,2,1,1,41
S01007168,Good health,268,33,4,29,72,50,23,18,37,22,3,2,1,10
S01007168,Fair health,54,7,1,6,11,11,5,1,15,1,0,0,0,3
S01007168,Bad health,12,4,0,4,3,1,1,0,1,2,0,0,0,0
S01007168,Very bad health,4,1,1,0,0,1,0,0,1,0,1,1,0,0
S01007169,All people aged 16 to 74,551,53,10,43,147,90,36,42,71,51,16,12,4,45
S01007169,Very good health,289,32,7,25,79,47,16,16,29,26,8,5,3,36
S01007169,Good health,193,17,2,15,55,26,17,23,26,20,2,2,0,7
S01007169,Fair health,52,2,0,2,8,14,2,3,13,3,5,4,1,2
S01007169,Bad health,17,2,1,1,5,3,1,0,3,2,1,1,0,0
S01007169,Very bad health,0,0,0,0,0,0,0,0,0,0,0,0,0,0
S01007170,All people aged 16 to 74,514,50,14,36,125,54,96,43,58,43,16,8,8,29
S01007170,Very good health,284,31,11,20,64,30,43,25,35,26,6,2,4,24
S01007170,Good health,175,15,2,13,43,17,47,14,18,11,6,4,2,4
S01007170,Fair health,39,3,1,2,13,5,5,3,5,2,2,1,1,1
S01007170,Bad health,13,1,0,1,4,1,1,1,0,3,2,1,1,0
S01007170,Very bad health,3,0,0,0,1,1,0,0,0,1,0,0,0,0
S01007171,All people aged 16 to 74,677,52,16,36,118,102,97,61,114,84,15,8,7,34
S01007171,Very good health,389,40,13,27,66,60,48,36,65,37,5,4,1,32
S01007171,Good health,211,10,3,7,42,34,36,20,34,27,6,2,4,2
S01007171,Fair health,54,2,0,2,6,5,11,4,9,14,3,2,1,0
S01007171,Bad health,16,0,0,0,3,3,0,1,5,3,1,0,1,0
S01007171,Very bad health,7,0,0,0,1,0,2,0,1,3,0,0,0,0
S01007172,All people aged 16 to 74,621,80,18,62,149,73,84,53,82,49,24,18,6,27
S01007172,Very good health,331,54,14,40,78,43,33,27,38,24,12,8,4,22
S01007172,Good health,200,20,2,18,47,21,35,17,35,14,8,6,2,3
S01007172,Fair health,67,5,2,3,17,6,15,8,5,7,2,2,0,2
S01007172,Bad health,17,1,0,1,6,2,1,1,2,3,1,1,0,0
S01007172,Very bad health,6,0,0,0,1,1,0,0,2,1,1,1,0,0
S01007173,All people aged 16 to 74,647,32,8,24,172,109,46,71,91,61,12,8,4,53
S01007173,Very good health,396,17,4,13,107,75,30,37,51,30,5,3,2,44
S01007173,Good health,189,13,4,9,52,22,13,26,27,23,5,4,1,8
S01007173,Fair health,45,2,0,2,8,9,3,6,10,6,0,0,0,1
S01007173,Bad health,16,0,0,0,4,3,0,2,3,2,2,1,1,0
S01007173,Very bad health,1,0,0,0,1,0,0,0,0,0,0,0,0,0
S01007174,All people aged 16 to 74,609,40,13,27,137,77,43,63,86,75,26,18,8,62
S01007174,Very good health,351,28,9,19,85,42,23,35,51,29,8,7,1,50
S01007174,Good health,190,8,2,6,45,28,14,20,27,28,10,4,6,10
S01007174,Fair health,45,2,1,1,5,5,5,5,6,11,5,4,1,1
S01007174,Bad health,18,1,1,0,2,2,1,1,1,6,3,3,0,1
S01007174,Very bad health,5,1,0,1,0,0,0,2,1,1,0,0,0,0
S01007175,All people aged 16 to 74,438,28,11,17,96,57,29,33,88,72,9,8,1,26
S01007175,Very good health,243,18,5,13,61,30,15,18,44,30,6,6,0,21
S01007175,Good health,142,8,4,4,29,23,4,8,32,31,2,1,1,5
S01007175,Fair health,38,2,2,0,4,3,10,4,6,9,0,0,0,0
S01007175,Bad health,11,0,0,0,1,1,0,2,5,2,0,0,0,0
S01007175,Very bad health,4,0,0,0,1,0,0,1,1,0,1,1,0,0
S01007176,All people aged 16 to 74,501,26,9,17,110,62,33,50,104,63,21,10,11,32
S01007176,Very good health,268,13,7,6,68,34,16,22,54,27,15,7,8,19
S01007176,Good health,175,11,1,10,39,26,11,18,31,29,0,0,0,10
S01007176,Fair health,43,1,0,1,3,2,5,8,13,4,4,2,2,3
S01007176,Bad health,8,0,0,0,0,0,1,0,4,1,2,1,1,0
S01007176,Very bad health,7,1,1,0,0,0,0,2,2,2,0,0,0,0
S01007177,All people aged 16 to 74,458,17,3,14,72,54,17,50,103,79,36,15,21,30
S01007177,Very good health,212,11,2,9,36,23,7,17,45,33,15,6,9,25
S01007177,Good health,153,4,0,4,21,23,10,19,35,30,9,2,7,2
S01007177,Fair health,70,2,1,1,14,5,0,12,16,12,6,2,4,3
S01007177,Bad health,21,0,0,0,1,3,0,2,7,3,5,4,1,0
S01007177,Very bad health,2,0,0,0,0,0,0,0,0,1,1,1,0,0
S01007178,All people aged 16 to 74,769,19,3,16,108,85,58,86,165,144,54,33,21,50
S01007178,Very good health,342,10,3,7,52,46,23,31,74,52,18,12,6,36
S01007178,Good health,284,6,0,6,36,27,25,35,69,55,19,11,8,12
S01007178,Fair health,89,1,0,1,14,6,6,15,17,14,14,7,7,2
S01007178,Bad health,44,0,0,0,6,6,2,4,5,20,1,1,0,0
S01007178,Very bad health,10,2,0,2,0,0,2,1,0,3,2,2,0,0
S01007179,All people aged 16 to 74,754,71,19,52,202,110,49,60,110,89,16,9,7,47
S01007179,Very good health,390,32,9,23,113,58,21,37,55,30,5,3,2,39
S01007179,Good health,260,26,5,21,72,37,16,18,39,37,7,3,4,8
S01007179,Fair health,75,11,3,8,14,12,10,2,12,12,2,1,1,0
S01007179,Bad health,20,2,2,0,1,1,1,3,3,8,1,1,0,0
S01007179,Very bad health,9,0,0,0,2,2,1,0,1,2,1,1,0,0
S01007180,All people aged 16 to 74,521,49,19,30,154,89,49,35,67,40,15,8,7,23
S01007180,Very good health,254,28,11,17,78,45,27,14,29,10,3,1,2,20
S01007180,Good health,204,16,6,10,60,38,16,15,25,22,9,4,5,3
S01007180,Fair health,43,5,2,3,10,4,3,6,11,4,0,0,0,0
S01007180,Bad health,14,0,0,0,6,2,2,0,1,2,1,1,0,0
S01007180,Very bad health,6,0,0,0,0,0,1,0,1,2,2,2,0,0
S01007181,All people aged 16 to 74,607,61,16,45,155,87,76,37,47,44,37,29,8,63
S01007181,Very good health,307,33,8,25,81,42,36,16,17,14,16,10,6,52
S01007181,Good health,226,24,8,16,56,35,30,19,18,18,16,15,1,10
S01007181,Fair health,54,4,0,4,15,7,7,1,8,6,5,4,1,1
S01007181,Bad health,17,0,0,0,2,3,2,1,4,5,0,0,0,0
S01007181,Very bad health,3,0,0,0,1,0,1,0,0,1,0,0,0,0
S01007182,All people aged 16 to 74,785,71,19,52,185,100,56,72,125,105,25,16,9,46
S01007182,Very good health,402,35,9,26,101,61,27,35,57,38,12,9,3,36
S01007182,Good health,273,29,9,20,62,24,24,26,45,47,7,4,3,9
S01007182,Fair health,76,6,1,5,15,14,3,7,17,11,2,0,2,1
S01007182,Bad health,29,1,0,1,5,1,2,4,6,7,3,2,1,0
S01007182,Very bad health,5,0,0,0,2,0,0,0,0,2,1,1,0,0
S01007183,All people aged 16 to 74,788,42,14,28,145,109,72,77,149,120,24,17,7,50
S01007183,Very good health,388,27,8,19,75,59,35,33,64,48,7,5,2,40
S01007183,Good health,258,10,4,6,51,38,21,24,53,47,10,6,4,4
S01007183,Fair health,101,4,2,2,11,6,12,14,27,16,6,5,1,5
S01007183,Bad health,29,1,0,1,7,4,2,5,3,5,1,1,0,1
S01007183,Very bad health,12,0,0,0,1,2,2,1,2,4,0,0,0,0
S01007184,All people aged 16 to 74,810,26,3,23,162,75,50,96,167,135,44,20,24,55
S01007184,Very good health,354,16,2,14,67,34,18,49,68,52,15,5,10,35
S01007184,Good health,301,4,0,4,68,30,18,31,60,59,17,8,9,14
S01007184,Fair health,101,2,1,1,23,7,9,9,24,14,8,5,3,5
S01007184,Bad health,38,2,0,2,3,4,3,5,10,7,3,1,2,1
S01007184,Very bad health,16,2,0,2,1,0,2,2,5,3,1,1,0,0
S01007185,All people aged 16 to 74,600,20,4,16,85,62,37,63,100,129,67,42,25,37
S01007185,Very good health,265,9,1,8,38,31,14,33,46,37,31,22,9,26
S01007185,Good health,194,9,3,6,32,19,15,17,30,43,21,11,10,8
S01007185,Fair health,96,2,0,2,10,7,7,8,19,28,13,8,5,2
S01007185,Bad health,37,0,0,0,4,2,0,3,5,20,2,1,1,1
S01007185,Very bad health,8,0,0,0,1,3,1,2,0,1,0,0,0,0
S01007186,All people aged 16 to 74,463,12,1,11,51,44,34,43,93,92,55,33,22,39
S01007186,Very good health,200,4,1,3,27,15,15,20,37,39,20,14,6,23
S01007186,Good health,160,5,0,5,16,25,9,14,38,28,13,7,6,12
S01007186,Fair health,62,3,0,3,4,2,4,7,11,14,13,4,9,4
S01007186,Bad health,25,0,0,0,1,2,2,0,5,9,6,5,1,0
S01007186,Very bad health,16,0,0,0,3,0,4,2,2,2,3,3,0,0
S01007187,All people aged 16 to 74,614,22,6,16,109,66,50,70,113,115,31,16,15,38
S01007187,Very good health,256,9,2,7,54,28,19,32,45,35,11,7,4,23
S01007187,Good health,220,8,4,4,44,24,17,22,47,37,11,5,6,10
S01007187,Fair health,87,2,0,2,9,10,9,12,14,23,5,1,4,3
S01007187,Bad health,36,2,0,2,0,2,3,1,7,16,3,2,1,2
S01007187,Very bad health,15,1,0,1,2,2,2,3,0,4,1,1,0,0
S01007188,All people aged 16 to 74,473,21,2,19,85,43,54,57,84,69,29,16,13,31
S01007188,Very good health,211,10,2,8,37,18,17,32,40,27,7,3,4,23
S01007188,Good health,173,10,0,10,32,15,26,15,30,28,12,5,7,5
S01007188,Fair health,56,0,0,0,11,8,7,6,11,6,5,3,2,2
S01007188,Bad health,24,1,0,1,3,1,3,2,3,8,2,2,0,1
S01007188,Very bad health,9,0,0,0,2,1,1,2,0,0,3,3,0,0
S01007189,All people aged 16 to 74,530,17,5,12,90,59,39,53,107,90,39,22,17,36
S01007189,Very good health,229,9,2,7,38,34,19,21,43,37,9,5,4,19
S01007189,Good health,188,8,3,5,33,17,11,17,40,31,20,10,10,11
S01007189,Fair health,72,0,0,0,10,5,8,11,13,12,8,5,3,5
S01007189,Bad health,30,0,0,0,7,3,1,2,7,7,2,2,0,1
S01007189,Very bad health,11,0,0,0,2,0,0,2,4,3,0,0,0,0
S01007190,All people aged 16 to 74,595,21,8,13,109,80,61,61,116,90,19,16,3,38
S01007190,Very good health,259,10,4,6,49,39,21,28,49,27,5,4,1,31
S01007190,Good health,236,9,3,6,46,31,29,22,47,39,7,6,1,6
S01007190,Fair health,74,2,1,1,10,6,9,9,14,17,6,5,1,1
S01007190,Bad health,19,0,0,0,3,3,2,1,5,5,0,0,0,0
S01007190,Very bad health,7,0,0,0,1,1,0,1,1,2,1,1,0,0
S01007191,All people aged 16 to 74,456,13,0,13,63,44,37,59,103,85,30,20,10,22
S01007191,Very good health,223,8,0,8,30,21,13,34,49,39,11,10,1,18
S01007191,Good health,156,3,0,3,24,19,16,15,33,34,10,7,3,2
S01007191,Fair health,58,2,0,2,8,3,5,6,18,9,6,2,4,1
S01007191,Bad health,18,0,0,0,1,1,3,3,3,3,3,1,2,1
S01007191,Very bad health,1,0,0,0,0,0,0,1,0,0,0,0,0,0
S01007192,All people aged 16 to 74,451,18,5,13,53,39,26,52,112,88,33,21,12,30
S01007192,Very good health,207,10,2,8,30,17,16,25,52,31,10,6,4,16
S01007192,Good health,162,7,3,4,19,12,6,19,37,40,10,5,5,12
S01007192,Fair health,57,1,0,1,3,8,4,7,16,9,7,4,3,2
S01007192,Bad health,17,0,0,0,1,2,0,1,6,6,1,1,0,0
S01007192,Very bad health,8,0,0,0,0,0,0,0,1,2,5,5,0,0
S01007193,All people aged 16 to 74,558,14,5,9,67,54,43,57,125,124,23,12,11,51
S01007193,Very good health,259,7,3,4,35,23,21,24,46,58,8,4,4,37
S01007193,Good health,189,6,2,4,22,19,12,22,50,41,6,2,4,11
S01007193,Fair health,81,1,0,1,8,9,5,9,22,16,8,5,3,3
S01007193,Bad health,23,0,0,0,2,2,4,1,5,9,0,0,0,0
S01007193,Very bad health,6,0,0,0,0,1,1,1,2,0,1,1,0,0
S01007194,All people aged 16 to 74,432,6,3,3,47,36,22,43,115,78,50,27,23,35
S01007194,Very good health,189,4,3,1,22,19,7,13,45,32,21,11,10,26
S01007194,Good health,151,1,0,1,23,9,10,17,41,26,17,10,7,7
S01007194,Fair health,57,0,0,0,1,6,3,11,15,11,8,4,4,2
S01007194,Bad health,28,1,0,1,1,2,2,2,11,7,2,0,2,0
S01007194,Very bad health,7,0,0,0,0,0,0,0,3,2,2,2,0,0
S01007195,All people aged 16 to 74,400,11,3,8,60,22,23,38,96,87,27,16,11,36
S01007195,Very good health,179,5,1,4,23,7,11,19,37,41,9,7,2,27
S01007195,Good health,139,5,2,3,25,9,9,9,36,29,11,5,6,6
S01007195,Fair health,57,1,0,1,8,3,1,9,16,9,7,4,3,3
S01007195,Bad health,21,0,0,0,3,3,1,0,7,7,0,0,0,0
S01007195,Very bad health,4,0,0,0,1,0,1,1,0,1,0,0,0,0
S01007196,All people aged 16 to 74,522,13,3,10,83,50,25,55,129,86,27,9,18,54
S01007196,Very good health,256,6,2,4,42,33,12,27,42,37,14,6,8,43
S01007196,Good health,183,5,0,5,24,12,9,23,61,34,6,1,5,9
S01007196,Fair health,57,2,1,1,11,3,3,5,16,11,5,1,4,1
S01007196,Bad health,20,0,0,0,3,2,1,0,9,4,1,0,1,0
S01007196,Very bad health,6,0,0,0,3,0,0,0,1,0,1,1,0,1
S01007197,All people aged 16 to 74,443,9,2,7,53,26,19,57,87,102,58,27,31,32
S01007197,Very good health,180,6,1,5,24,11,8,27,36,35,14,6,8,19
S01007197,Good health,170,1,1,0,23,9,8,20,33,35,32,12,20,9
S01007197,Fair health,52,2,0,2,5,3,1,6,6,19,7,5,2,3
S01007197,Bad health,30,0,0,0,1,3,0,3,10,9,3,2,1,1
S01007197,Very bad health,11,0,0,0,0,0,2,1,2,4,2,2,0,0
S01007198,All people aged 16 to 74,369,9,3,6,52,31,32,42,62,71,48,30,18,22
S01007198,Very good health,162,6,2,4,27,14,13,17,21,32,21,13,8,11
S01007198,Good health,149,3,1,2,18,13,15,19,29,28,15,9,6,9
S01007198,Fair health,40,0,0,0,3,3,2,3,10,9,8,6,2,2
S01007198,Bad health,11,0,0,0,2,0,1,3,2,1,2,0,2,0
S01007198,Very bad health,7,0,0,0,2,1,1,0,0,1,2,2,0,0
S01007199,All people aged 16 to 74,573,11,5,6,50,51,22,73,134,106,64,38,26,62
S01007199,Very good health,246,5,1,4,18,29,7,29,55,40,25,13,12,38
S01007199,Good health,211,4,2,2,23,14,9,32,53,37,20,9,11,19
S01007199,Fair health,69,0,0,0,4,5,4,3,20,17,13,11,2,3
S01007199,Bad health,34,2,2,0,4,2,2,4,6,8,4,3,1,2
S01007199,Very bad health,13,0,0,0,1,1,0,5,0,4,2,2,0,0
S01007200,All people aged 16 to 74,667,19,4,15,115,71,38,69,162,125,29,15,14,39
S01007200,Very good health,295,9,2,7,64,33,19,33,63,38,6,2,4,30
S01007200,Good health,272,9,2,7,40,31,13,27,67,63,13,7,6,9
S01007200,Fair health,65,0,0,0,9,6,4,5,17,18,6,2,4,0
S01007200,Bad health,25,0,0,0,1,1,2,3,10,4,4,4,0,0
S01007200,Very bad health,10,1,0,1,1,0,0,1,5,2,0,0,0,0
S01007201,All people aged 16 to 74,557,27,8,19,105,69,32,58,100,106,29,17,12,31
S01007201,Very good health,250,11,2,9,49,36,15,24,39,43,9,8,1,24
S01007201,Good health,216,11,4,7,41,26,10,26,44,43,9,5,4,6
S01007201,Fair health,63,3,1,2,12,5,5,6,11,14,7,3,4,0
S01007201,Bad health,19,1,0,1,3,1,1,1,3,6,2,1,1,1
S01007201,Very bad health,9,1,1,0,0,1,1,1,3,0,2,0,2,0
S01007202,All people aged 16 to 74,571,17,4,13,87,53,37,63,140,105,42,21,21,27
S01007202,Very good health,243,9,2,7,44,27,12,29,46,34,18,10,8,24
S01007202,Good health,213,4,1,3,28,17,15,25,61,50,11,3,8,2
S01007202,Fair health,81,2,1,1,12,8,7,6,23,13,9,5,4,1
S01007202,Bad health,27,2,0,2,2,1,1,3,8,6,4,3,1,0
S01007202,Very bad health,7,0,0,0,1,0,2,0,2,2,0,0,0,0
S01007203,All people aged 16 to 74,485,14,5,9,86,57,37,62,84,95,12,7,5,38
S01007203,Very good health,226,9,4,5,44,32,12,29,36,36,5,3,2,23
S01007203,Good health,180,4,1,3,33,17,15,23,31,41,4,2,2,12
S01007203,Fair health,57,1,0,1,6,6,8,6,12,12,3,2,1,3
S01007203,Bad health,13,0,0,0,2,1,2,3,2,3,0,0,0,0
S01007203,Very bad health,9,0,0,0,1,1,0,1,3,3,0,0,0,0
S01007204,All people aged 16 to 74,778,58,13,45,206,70,103,66,100,92,38,32,6,45
S01007204,Very good health,388,37,7,30,102,38,56,33,40,41,6,5,1,35
S01007204,Good health,252,12,3,9,72,24,31,17,40,30,16,13,3,10
S01007204,Fair health,98,6,2,4,24,8,11,11,13,13,12,10,2,0
S01007204,Bad health,32,3,1,2,7,0,5,3,6,7,1,1,0,0
S01007204,Very bad health,8,0,0,0,1,0,0,2,1,1,3,3,0,0
S01007205,All people aged 16 to 74,543,48,8,40,129,48,70,45,75,65,12,10,2,51
S01007205,Very good health,298,27,3,24,72,26,40,21,37,29,6,4,2,40
S01007205,Good health,179,16,4,12,45,20,22,17,27,20,5,5,0,7
S01007205,Fair health,49,5,1,4,12,1,5,3,7,14,1,1,0,1
S01007205,Bad health,14,0,0,0,0,1,2,3,3,2,0,0,0,3
S01007205,Very bad health,3,0,0,0,0,0,1,1,1,0,0,0,0,0
S01007206,All people aged 16 to 74,282,14,1,13,68,23,20,31,54,51,8,6,2,13
S01007206,Very good health,146,8,1,7,34,12,13,16,33,18,2,2,0,10
S01007206,Good health,84,4,0,4,22,9,5,9,17,13,3,1,2,2
S01007206,Fair health,39,2,0,2,11,2,1,4,3,14,1,1,0,1
S01007206,Bad health,11,0,0,0,1,0,1,1,1,5,2,2,0,0
S01007206,Very bad health,2,0,0,0,0,0,0,1,0,1,0,0,0,0
S01007207,All people aged 16 to 74,685,39,11,28,150,86,65,87,110,80,27,15,12,41
S01007207,Very good health,350,20,6,14,82,45,31,48,51,33,11,3,8,29
S01007207,Good health,233,15,4,11,57,28,21,26,43,23,9,7,2,11
S01007207,Fair health,74,4,1,3,9,10,11,9,13,14,3,1,2,1
S01007207,Bad health,19,0,0,0,2,3,1,3,3,4,3,3,0,0
S01007207,Very bad health,9,0,0,0,0,0,1,1,0,6,1,1,0,0
S01007208,All people aged 16 to 74,729,38,9,29,111,92,31,101,127,129,56,25,31,44
S01007208,Very good health,318,21,5,16,55,46,14,43,51,36,21,6,15,31
S01007208,Good health,274,10,2,8,35,35,11,38,57,63,14,7,7,11
S01007208,Fair health,92,5,1,4,12,10,3,14,11,21,15,8,7,1
S01007208,Bad health,34,2,1,1,8,0,0,5,6,7,5,3,2,1
S01007208,Very bad health,11,0,0,0,1,1,3,1,2,2,1,1,0,0
S01007209,All people aged 16 to 74,560,29,4,25,118,65,49,55,95,76,40,28,12,33
S01007209,Very good health,258,13,1,12,66,31,22,29,38,28,10,7,3,21
S01007209,Good health,204,14,2,12,33,31,20,21,36,27,14,7,7,8
S01007209,Fair health,70,1,1,0,18,2,6,4,15,15,6,5,1,3
S01007209,Bad health,20,1,0,1,1,1,1,1,5,5,4,3,1,1
S01007209,Very bad health,8,0,0,0,0,0,0,0,1,1,6,6,0,0
S01007210,All people aged 16 to 74,565,13,1,12,95,54,31,82,107,117,36,24,12,30
S01007210,Very good health,268,9,1,8,50,32,17,44,41,42,14,9,5,19
S01007210,Good health,209,2,0,2,38,14,12,28,45,49,12,7,5,9
S01007210,Fair health,61,1,0,1,4,6,1,7,12,20,9,8,1,1
S01007210,Bad health,20,0,0,0,3,2,1,1,7,6,0,0,0,0
S01007210,Very bad health,7,1,0,1,0,0,0,2,2,0,1,0,1,1
S01007211,All people aged 16 to 74,724,19,8,11,135,67,55,78,154,120,45,27,18,51
S01007211,Very good health,305,8,3,5,63,33,15,30,64,45,13,7,6,34
S01007211,Good health,270,5,3,2,50,23,26,34,58,44,17,10,7,13
S01007211,Fair health,96,3,1,2,16,7,8,10,21,18,11,6,5,2
S01007211,Bad health,41,2,1,1,3,3,6,4,9,11,2,2,0,1
S01007211,Very bad health,12,1,0,1,3,1,0,0,2,2,2,2,0,1
S01007212,All people aged 16 to 74,421,18,6,12,102,47,41,54,62,58,20,11,9,19
S01007212,Very good health,226,14,6,8,56,29,17,23,30,30,9,2,7,18
S01007212,Good health,133,4,0,4,39,13,17,17,23,17,3,2,1,0
S01007212,Fair health,48,0,0,0,5,4,5,12,7,7,7,6,1,1
S01007212,Bad health,9,0,0,0,0,1,2,2,1,2,1,1,0,0
S01007212,Very bad health,5,0,0,0,2,0,0,0,1,2,0,0,0,0
S01007213,All people aged 16 to 74,643,44,5,39,155,63,57,80,107,76,22,15,7,39
S01007213,Very good health,330,26,2,24,88,33,29,41,50,25,5,3,2,33
S01007213,Good health,221,15,2,13,51,23,11,34,40,33,9,6,3,5
S01007213,Fair health,64,2,1,1,12,4,12,3,13,12,5,3,2,1
S01007213,Bad health,21,1,0,1,3,3,3,2,3,4,2,2,0,0
S01007213,Very bad health,7,0,0,0,1,0,2,0,1,2,1,1,0,0
S01007214,All people aged 16 to 74,544,31,4,27,91,61,35,47,109,113,32,20,12,25
S01007214,Very good health,223,13,1,12,40,32,9,19,42,43,9,4,5,16
S01007214,Good health,190,13,1,12,32,16,19,17,39,43,8,3,5,3
S01007214,Fair health,88,4,1,3,15,8,4,9,15,17,11,9,2,5
S01007214,Bad health,39,0,0,0,4,4,3,2,12,10,3,3,0,1
S01007214,Very bad health,4,1,1,0,0,1,0,0,1,0,1,1,0,0
S01007215,All people aged 16 to 74,569,36,6,30,106,70,37,65,84,103,29,18,11,39
S01007215,Very good health,256,22,2,20,46,31,13,30,37,41,13,8,5,23
S01007215,Good health,210,12,4,8,39,31,16,24,26,40,9,4,5,13
S01007215,Fair health,71,1,0,1,16,4,6,7,15,16,3,2,1,3
S01007215,Bad health,29,1,0,1,3,4,2,4,6,5,4,4,0,0
S01007215,Very bad health,3,0,0,0,2,0,0,0,0,1,0,0,0,0
S01007216,All people aged 16 to 74,524,50,11,39,116,76,39,55,77,59,21,12,9,31
S01007216,Very good health,261,26,7,19,64,41,16,26,34,21,10,5,5,23
S01007216,Good health,189,19,3,16,37,28,14,25,28,23,8,4,4,7
S01007216,Fair health,50,4,1,3,10,4,6,4,12,7,2,2,0,1
S01007216,Bad health,22,1,0,1,4,3,3,0,3,7,1,1,0,0
S01007216,Very bad health,2,0,0,0,1,0,0,0,0,1,0,0,0,0
S01007217,All people aged 16 to 74,707,31,7,24,110,73,43,83,159,124,34,20,14,50
S01007217,Very good health,309,16,4,12,56,34,13,36,56,50,14,10,4,34
S01007217,Good health,262,13,3,10,34,22,18,33,75,45,12,6,6,10
S01007217,Fair health,97,1,0,1,16,12,8,9,20,19,7,4,3,5
S01007217,Bad health,33,1,0,1,3,4,4,4,8,7,1,0,1,1
S01007217,Very bad health,6,0,0,0,1,1,0,1,0,3,0,0,0,0
S01007218,All people aged 16 to 74,652,72,20,52,175,86,48,60,89,70,12,8,4,40
S01007218,Very good health,339,41,14,27,86,33,21,34,47,37,8,4,4,32
S01007218,Good health,257,27,6,21,74,44,20,23,33,26,3,3,0,7
S01007218,Fair health,41,3,0,3,11,8,6,2,6,5,0,0,0,0
S01007218,Bad health,12,1,0,1,3,1,1,1,3,1,0,0,0,1
S01007218,Very bad health,3,0,0,0,1,0,0,0,0,1,1,1,0,0
S01007219,All people aged 16 to 74,617,21,6,15,108,71,45,70,116,120,28,19,9,38
S01007219,Very good health,258,6,3,3,48,35,21,33,39,44,5,3,2,27
S01007219,Good health,245,13,3,10,44,29,15,20,50,51,14,7,7,9
S01007219,Fair health,87,2,0,2,13,5,7,14,22,14,8,8,0,2
S01007219,Bad health,22,0,0,0,2,2,2,2,4,9,1,1,0,0
S01007219,Very bad health,5,0,0,0,1,0,0,1,1,2,0,0,0,0
S01007220,All people aged 16 to 74,511,16,6,10,78,52,40,58,113,99,34,24,10,21
S01007220,Very good health,206,6,2,4,40,26,12,24,44,37,5,4,1,12
S01007220,Good health,218,8,2,6,29,21,22,19,55,32,23,19,4,9
S01007220,Fair health,52,0,0,0,4,3,3,10,8,20,4,1,3,0
S01007220,Bad health,26,1,1,0,4,2,2,4,5,6,2,0,2,0
S01007220,Very bad health,9,1,1,0,1,0,1,1,1,4,0,0,0,0
S01007221,All people aged 16 to 74,466,50,7,43,123,62,42,40,70,37,17,14,3,25
S01007221,Very good health,272,30,3,27,83,32,17,31,39,14,6,4,2,20
S01007221,Good health,155,17,4,13,35,25,19,6,22,19,7,6,1,5
S01007221,Fair health,24,3,0,3,4,1,2,3,6,3,2,2,0,0
S01007221,Bad health,11,0,0,0,1,3,3,0,3,1,0,0,0,0
S01007221,Very bad health,4,0,0,0,0,1,1,0,0,0,2,2,0,0
S01007222,All people aged 16 to 74,604,37,15,22,112,59,50,71,122,88,29,19,10,36
S01007222,Very good health,273,21,6,15,57,33,18,36,39,36,5,4,1,28
S01007222,Good health,241,13,6,7,41,21,20,31,58,35,15,8,7,7
S01007222,Fair health,59,2,2,0,8,5,4,3,17,12,7,5,2,1
S01007222,Bad health,27,1,1,0,3,0,7,1,8,5,2,2,0,0
S01007222,Very bad health,4,0,0,0,3,0,1,0,0,0,0,0,0,0
S01007223,All people aged 16 to 74,366,43,13,30,102,47,27,37,50,30,10,5,5,20
S01007223,Very good health,221,29,7,22,59,31,14,23,27,17,5,2,3,16
S01007223,Good health,108,12,5,7,33,14,12,7,13,11,3,1,2,3
S01007223,Fair health,29,2,1,1,8,1,1,5,7,2,2,2,0,1
S01007223,Bad health,4,0,0,0,1,1,0,1,1,0,0,0,0,0
S01007223,Very bad health,4,0,0,0,1,0,0,1,2,0,0,0,0,0
S01007224,All people aged 16 to 74,420,40,12,28,101,58,49,42,59,49,8,4,4,14
S01007224,Very good health,215,23,8,15,52,35,25,17,24,22,4,2,2,13
S01007224,Good health,142,15,4,11,36,15,17,14,21,22,1,1,0,1
S01007224,Fair health,50,2,0,2,8,7,5,10,10,5,3,1,2,0
S01007224,Bad health,9,0,0,0,3,1,2,1,2,0,0,0,0,0
S01007224,Very bad health,4,0,0,0,2,0,0,0,2,0,0,0,0,0
S01007225,All people aged 16 to 74,677,73,25,48,172,70,92,63,93,62,15,13,2,37
S01007225,Very good health,351,44,16,28,90,37,42,34,41,26,6,4,2,31
S01007225,Good health,240,23,8,15,64,25,43,17,36,23,4,4,0,5
S01007225,Fair health,66,6,1,5,15,6,6,11,13,8,1,1,0,0
S01007225,Bad health,17,0,0,0,2,2,1,1,3,4,3,3,0,1
S01007225,Very bad health,3,0,0,0,1,0,0,0,0,1,1,1,0,0
S01007226,All people aged 16 to 74,612,59,11,48,148,58,111,50,75,49,21,15,6,41
S01007226,Very good health,332,35,8,27,74,38,53,28,38,21,9,7,2,36
S01007226,Good health,211,17,3,14,63,14,47,18,24,18,5,4,1,5
S01007226,Fair health,46,6,0,6,6,5,8,3,7,5,6,4,2,0
S01007226,Bad health,20,1,0,1,5,1,2,1,6,3,1,0,1,0
S01007226,Very bad health,3,0,0,0,0,0,1,0,0,2,0,0,0,0
S01007227,All people aged 16 to 74,701,59,19,40,154,88,64,64,118,95,23,12,11,36
S01007227,Very good health,345,38,12,26,86,43,33,36,44,36,5,2,3,24
S01007227,Good health,238,19,6,13,52,23,20,20,49,35,10,6,4,10
S01007227,Fair health,84,2,1,1,15,14,7,7,17,15,5,3,2,2
S01007227,Bad health,26,0,0,0,1,6,4,1,5,7,2,0,2,0
S01007227,Very bad health,8,0,0,0,0,2,0,0,3,2,1,1,0,0
S01007228,All people aged 16 to 74,480,35,8,27,108,52,83,49,67,39,16,11,5,31
S01007228,Very good health,254,23,4,19,69,23,45,28,22,14,7,4,3,23
S01007228,Good health,160,9,4,5,31,23,27,10,32,15,5,3,2,8
S01007228,Fair health,45,3,0,3,6,4,7,7,9,6,3,3,0,0
S01007228,Bad health,19,0,0,0,2,2,4,2,4,4,1,1,0,0
S01007228,Very bad health,2,0,0,0,0,0,0,2,0,0,0,0,0,0
S01007229,All people aged 16 to 74,840,68,21,47,194,93,141,69,123,81,23,18,5,48
S01007229,Very good health,449,47,14,33,111,47,80,34,53,31,10,9,1,36
S01007229,Good health,289,18,7,11,59,37,43,25,46,39,11,7,4,11
S01007229,Fair health,80,3,0,3,19,6,14,10,20,6,1,1,0,1
S01007229,Bad health,16,0,0,0,4,3,3,0,3,3,0,0,0,0
S01007229,Very bad health,6,0,0,0,1,0,1,0,1,2,1,1,0,0
S01007230,All people aged 16 to 74,536,12,5,7,62,53,30,63,126,104,50,34,16,36
S01007230,Very good health,236,5,3,2,36,23,15,26,44,42,21,15,6,24
S01007230,Good health,217,2,1,1,21,20,9,22,64,45,22,14,8,12
S01007230,Fair health,59,4,1,3,5,5,5,9,14,12,5,3,2,0
S01007230,Bad health,20,1,0,1,0,4,1,6,3,3,2,2,0,0
S01007230,Very bad health,4,0,0,0,0,1,0,0,1,2,0,0,0,0
S01007231,All people aged 16 to 74,491,18,5,13,51,43,24,53,117,108,42,24,18,35
S01007231,Very good health,186,10,4,6,22,19,3,24,38,32,13,5,8,25
S01007231,Good health,197,7,1,6,23,11,15,15,51,48,17,11,6,10
S01007231,Fair health,84,1,0,1,5,10,4,8,23,22,11,7,4,0
S01007231,Bad health,16,0,0,0,1,3,1,5,2,4,0,0,0,0
S01007231,Very bad health,8,0,0,0,0,0,1,1,3,2,1,1,0,0
S01007232,All people aged 16 to 74,530,17,6,11,50,52,25,60,117,116,54,32,22,39
S01007232,Very good health,222,10,4,6,19,27,8,19,48,41,22,13,9,28
S01007232,Good health,200,3,1,2,24,17,12,23,45,51,17,8,9,8
S01007232,Fair health,79,3,1,2,4,4,5,14,17,19,12,8,4,1
S01007232,Bad health,20,1,0,1,1,4,0,3,3,4,2,2,0,2
S01007232,Very bad health,9,0,0,0,2,0,0,1,4,1,1,1,0,0
S01007233,All people aged 16 to 74,596,34,7,27,114,63,50,64,99,111,37,24,13,24
S01007233,Very good health,286,19,4,15,59,27,23,33,50,45,11,6,5,19
S01007233,Good health,214,10,1,9,40,28,22,23,34,36,18,12,6,3
S01007233,Fair health,73,5,2,3,13,7,3,5,9,24,7,5,2,0
S01007233,Bad health,19,0,0,0,2,0,2,3,4,5,1,1,0,2
S01007233,Very bad health,4,0,0,0,0,1,0,0,2,1,0,0,0,0
S01007234,All people aged 16 to 74,431,16,7,9,81,34,30,35,85,92,19,12,7,39
S01007234,Very good health,201,8,3,5,37,11,12,17,35,41,9,4,5,31
S01007234,Good health,153,7,3,4,29,18,12,11,31,35,4,4,0,6
S01007234,Fair health,63,1,1,0,12,5,6,6,13,15,4,2,2,1
S01007234,Bad health,12,0,0,0,3,0,0,1,5,1,1,1,0,1
S01007234,Very bad health,2,0,0,0,0,0,0,0,1,0,1,1,0,0
S01007235,All people aged 16 to 74,572,25,8,17,116,59,45,60,106,107,25,9,16,29
S01007235,Very good health,270,15,6,9,58,37,18,25,42,48,7,4,3,20
S01007235,Good health,211,5,1,4,39,13,24,28,45,41,9,1,8,7
S01007235,Fair health,69,4,1,3,16,8,3,5,15,9,8,3,5,1
S01007235,Bad health,18,1,0,1,2,1,0,1,4,7,1,1,0,1
S01007235,Very bad health,4,0,0,0,1,0,0,1,0,2,0,0,0,0
S01007236,All people aged 16 to 74,452,26,9,17,89,74,37,60,73,51,17,10,7,25
S01007236,Very good health,222,11,3,8,47,39,21,28,32,23,5,4,1,16
S01007236,Good health,169,11,5,6,30,25,16,19,31,23,8,4,4,6
S01007236,Fair health,47,4,1,3,6,9,0,11,8,5,3,1,2,1
S01007236,Bad health,12,0,0,0,6,1,0,2,2,0,0,0,0,1
S01007236,Very bad health,2,0,0,0,0,0,0,0,0,0,1,1,0,1
S01007237,All people aged 16 to 74,526,29,7,22,113,81,43,63,88,63,14,8,6,32
S01007237,Very good health,278,17,5,12,64,46,25,35,31,26,8,4,4,26
S01007237,Good health,198,9,2,7,40,28,16,21,45,31,2,2,0,6
S01007237,Fair health,38,1,0,1,8,6,2,5,8,6,2,1,1,0
S01007237,Bad health,9,2,0,2,1,1,0,2,2,0,1,0,1,0
S01007237,Very bad health,3,0,0,0,0,0,0,0,2,0,1,1,0,0
S01007238,All people aged 16 to 74,696,32,8,24,157,88,42,79,124,111,15,7,8,48
S01007238,Very good health,324,13,5,8,71,39,23,36,53,43,6,3,3,40
S01007238,Good health,262,14,2,12,67,32,15,31,45,47,5,2,3,6
S01007238,Fair health,82,4,1,3,15,13,2,8,22,13,4,2,2,1
S01007238,Bad health,18,0,0,0,3,3,0,3,4,4,0,0,0,1
S01007238,Very bad health,10,1,0,1,1,1,2,1,0,4,0,0,0,0
S01007239,All people aged 16 to 74,600,74,24,50,157,87,58,60,65,49,15,11,4,35
S01007239,Very good health,303,35,11,24,82,50,18,32,32,20,6,3,3,28
S01007239,Good health,214,29,12,17,55,23,29,23,25,18,5,5,0,7
S01007239,Fair health,70,10,1,9,17,13,8,2,8,9,3,2,1,0
S01007239,Bad health,11,0,0,0,2,1,3,3,0,2,0,0,0,0
S01007239,Very bad health,2,0,0,0,1,0,0,0,0,0,1,1,0,0
S01007240,All people aged 16 to 74,440,35,10,25,98,54,75,37,66,45,9,7,2,21
S01007240,Very good health,212,18,5,13,57,26,39,16,22,15,6,4,2,13
S01007240,Good health,150,13,3,10,25,16,25,15,31,16,2,2,0,7
S01007240,Fair health,54,1,0,1,12,11,9,2,8,9,1,1,0,1
S01007240,Bad health,18,3,2,1,3,1,1,3,4,3,0,0,0,0
S01007240,Very bad health,6,0,0,0,1,0,1,1,1,2,0,0,0,0
S01007241,All people aged 16 to 74,471,51,12,39,97,55,87,40,59,43,7,4,3,32
S01007241,Very good health,263,30,5,25,57,33,43,22,28,21,4,2,2,25
S01007241,Good health,162,18,5,13,30,19,36,14,22,15,2,1,1,6
S01007241,Fair health,34,2,2,0,5,2,7,4,7,5,1,1,0,1
S01007241,Bad health,8,1,0,1,4,1,0,0,1,1,0,0,0,0
S01007241,Very bad health,4,0,0,0,1,0,1,0,1,1,0,0,0,0
S01007242,All people aged 16 to 74,727,49,9,40,189,98,72,70,93,83,20,8,12,53
S01007242,Very good health,362,31,8,23,94,53,38,30,44,25,7,2,5,40
S01007242,Good health,261,11,1,10,69,31,24,25,41,37,11,6,5,12
S01007242,Fair health,79,6,0,6,19,11,5,12,7,16,2,0,2,1
S01007242,Bad health,19,0,0,0,7,3,3,2,1,3,0,0,0,0
S01007242,Very bad health,6,1,0,1,0,0,2,1,0,2,0,0,0,0
S01007243,All people aged 16 to 74,459,39,11,28,133,61,44,40,50,44,16,11,5,32
S01007243,Very good health,227,21,6,15,74,28,14,19,23,16,7,5,2,25
S01007243,Good health,163,15,4,11,45,22,21,13,20,18,5,2,3,4
S01007243,Fair health,48,2,1,1,11,7,5,3,5,9,3,3,0,3
S01007243,Bad health,16,1,0,1,1,3,3,4,2,1,1,1,0,0
S01007243,Very bad health,5,0,0,0,2,1,1,1,0,0,0,0,0,0
S01007244,All people aged 16 to 74,569,51,18,33,140,65,78,41,76,76,13,8,5,29
S01007244,Very good health,281,31,8,23,82,33,30,13,31,32,5,3,2,24
S01007244,Good health,206,16,7,9,41,27,35,18,28,34,4,2,2,3
S01007244,Fair health,54,3,2,1,9,4,8,6,15,6,2,1,1,1
S01007244,Bad health,23,1,1,0,7,1,4,3,2,3,1,1,0,1
S01007244,Very bad health,5,0,0,0,1,0,1,1,0,1,1,1,0,0
S01007245,All people aged 16 to 74,500,20,4,16,109,63,82,52,88,54,10,5,5,22
S01007245,Very good health,237,13,0,13,58,37,33,28,30,18,2,1,1,18
S01007245,Good health,183,5,3,2,43,19,32,17,38,21,4,2,2,4
S01007245,Fair health,52,0,0,0,3,7,14,3,9,13,3,2,1,0
S01007245,Bad health,17,2,1,1,3,0,1,1,7,2,1,0,1,0
S01007245,Very bad health,11,0,0,0,2,0,2,3,4,0,0,0,0,0
S01007246,All people aged 16 to 74,444,30,11,19,91,59,59,45,44,81,14,8,6,21
S01007246,Very good health,232,21,6,15,46,26,34,24,25,37,2,0,2,17
S01007246,Good health,147,4,3,1,33,26,16,15,15,29,5,2,3,4
S01007246,Fair health,41,4,1,3,7,5,5,4,2,9,5,4,1,0
S01007246,Bad health,15,0,0,0,3,2,2,1,2,4,1,1,0,0
S01007246,Very bad health,9,1,1,0,2,0,2,1,0,2,1,1,0,0
S01007247,All people aged 16 to 74,485,49,11,38,112,51,60,41,76,64,13,11,2,19
S01007247,Very good health,252,30,6,24,62,26,30,22,37,24,6,5,1,15
S01007247,Good health,166,17,5,12,43,19,22,10,25,24,3,2,1,3
S01007247,Fair health,51,2,0,2,6,5,5,8,11,11,2,2,0,1
S01007247,Bad health,14,0,0,0,1,0,3,0,3,5,2,2,0,0
S01007247,Very bad health,2,0,0,0,0,1,0,1,0,0,0,0,0,0
S01007248,All people aged 16 to 74,571,65,21,44,159,84,54,54,70,35,13,8,5,37
S01007248,Very good health,319,37,12,25,93,46,31,28,29,17,6,4,2,32
S01007248,Good health,188,26,9,17,48,30,16,14,32,12,5,3,2,5
S01007248,Fair health,47,2,0,2,14,4,6,9,8,4,0,0,0,0
S01007248,Bad health,14,0,0,0,3,3,1,3,1,1,2,1,1,0
S01007248,Very bad health,3,0,0,0,1,1,0,0,0,1,0,0,0,0
S01007249,All people aged 16 to 74,297,29,7,22,62,48,34,20,40,37,8,6,2,19
S01007249,Very good health,154,18,5,13,38,30,12,10,16,14,4,3,1,12
S01007249,Good health,111,10,1,9,19,13,18,5,17,19,4,3,1,6
S01007249,Fair health,27,1,1,0,4,5,4,4,5,3,0,0,0,1
S01007249,Bad health,5,0,0,0,1,0,0,1,2,1,0,0,0,0
S01007249,Very bad health,0,0,0,0,0,0,0,0,0,0,0,0,0,0
S01007250,All people aged 16 to 74,627,41,9,32,139,85,45,53,97,105,26,15,11,36
S01007250,Very good health,308,22,6,16,67,47,20,22,43,59,5,2,3,23
S01007250,Good health,235,15,3,12,52,29,18,23,39,35,12,8,4,12
S01007250,Fair health,63,4,0,4,12,7,5,6,13,8,7,5,2,1
S01007250,Bad health,15,0,0,0,5,2,2,1,1,2,2,0,2,0
S01007250,Very bad health,6,0,0,0,3,0,0,1,1,1,0,0,0,0
S01007251,All people aged 16 to 74,342,17,5,12,69,49,34,30,56,53,7,4,3,27
S01007251,Very good health,187,12,4,8,45,34,14,13,23,20,2,0,2,24
S01007251,Good health,104,2,1,1,21,10,17,9,18,24,2,1,1,1
S01007251,Fair health,33,2,0,2,2,4,1,7,10,4,2,2,0,1
S01007251,Bad health,17,1,0,1,1,1,2,1,4,5,1,1,0,1
S01007251,Very bad health,1,0,0,0,0,0,0,0,1,0,0,0,0,0
S01007252,All people aged 16 to 74,586,30,9,21,98,68,62,70,104,87,19,13,6,48
S01007252,Very good health,301,18,6,12,49,41,27,42,47,39,4,2,2,34
S01007252,Good health,213,11,2,9,37,21,27,16,42,38,9,7,2,12
S01007252,Fair health,60,1,1,0,9,6,6,11,13,8,4,3,1,2
S01007252,Bad health,11,0,0,0,3,0,1,1,2,2,2,1,1,0
S01007252,Very bad health,1,0,0,0,0,0,1,0,0,0,0,0,0,0
S01007253,All people aged 16 to 74,598,48,18,30,155,78,52,63,78,78,12,3,9,34
S01007253,Very good health,311,31,11,20,87,40,21,32,31,32,7,2,5,30
S01007253,Good health,198,14,6,8,49,25,21,23,33,26,3,0,3,4
S01007253,Fair health,61,3,1,2,14,10,8,5,10,11,0,0,0,0
S01007253,Bad health,21,0,0,0,3,2,2,2,3,8,1,0,1,0
S01007253,Very bad health,7,0,0,0,2,1,0,1,1,1,1,1,0,0
S01007254,All people aged 16 to 74,574,23,6,17,95,76,30,58,100,111,57,49,8,24
S01007254,Very good health,231,14,4,10,49,35,11,21,36,38,12,10,2,15
S01007254,Good health,204,8,1,7,28,27,10,23,32,38,32,28,4,6
S01007254,Fair health,97,1,1,0,12,11,4,9,23,23,12,10,2,2
S01007254,Bad health,35,0,0,0,4,3,5,4,8,10,1,1,0,0
S01007254,Very bad health,7,0,0,0,2,0,0,1,1,2,0,0,0,1
S01007255,All people aged 16 to 74,562,16,2,14,73,56,23,60,112,138,63,27,36,21
S01007255,Very good health,221,9,2,7,36,25,8,25,50,42,15,7,8,11
S01007255,Good health,218,4,0,4,23,23,9,23,43,56,30,10,20,7
S01007255,Fair health,86,1,0,1,10,3,5,9,15,27,13,5,8,3
S01007255,Bad health,32,1,0,1,4,4,1,3,3,11,5,5,0,0
S01007255,Very bad health,5,1,0,1,0,1,0,0,1,2,0,0,0,0
S01007256,All people aged 16 to 74,563,26,6,20,90,53,29,52,124,130,30,16,14,29
S01007256,Very good health,235,18,4,14,38,24,8,23,49,42,13,9,4,20
S01007256,Good health,235,6,2,4,43,21,14,23,52,61,9,3,6,6
S01007256,Fair health,68,2,0,2,5,7,5,4,18,17,7,3,4,3
S01007256,Bad health,19,0,0,0,3,1,1,2,3,9,0,0,0,0
S01007256,Very bad health,6,0,0,0,1,0,1,0,2,1,1,1,0,0
S01007257,All people aged 16 to 74,450,15,2,13,62,39,37,48,98,79,31,16,15,41
S01007257,Very good health,177,11,1,10,31,14,12,13,50,19,6,3,3,21
S01007257,Good health,179,2,1,1,22,18,15,29,27,41,11,4,7,14
S01007257,Fair health,61,2,0,2,7,5,4,3,13,15,9,6,3,3
S01007257,Bad health,27,0,0,0,1,2,6,3,8,4,3,2,1,0
S01007257,Very bad health,6,0,0,0,1,0,0,0,0,0,2,1,1,3
S01007258,All people aged 16 to 74,618,35,7,28,126,64,50,57,101,99,34,23,11,52
S01007258,Very good health,276,22,3,19,54,33,21,23,42,32,9,5,4,40
S01007258,Good health,250,12,3,9,58,22,22,25,37,46,18,13,5,10
S01007258,Fair health,67,1,1,0,12,7,6,6,13,14,6,4,2,2
S01007258,Bad health,21,0,0,0,2,1,1,3,7,6,1,1,0,0
S01007258,Very bad health,4,0,0,0,0,1,0,0,2,1,0,0,0,0
S01007259,All people aged 16 to 74,600,24,6,18,85,52,45,69,115,136,31,19,12,43
S01007259,Very good health,260,14,3,11,46,30,21,29,45,33,9,5,4,33
S01007259,Good health,211,9,3,6,27,17,15,23,46,55,10,3,7,9
S01007259,Fair health,84,1,0,1,10,3,4,12,15,33,6,5,1,0
S01007259,Bad health,36,0,0,0,2,2,3,3,8,14,3,3,0,1
S01007259,Very bad health,9,0,0,0,0,0,2,2,1,1,3,3,0,0
S01007260,All people aged 16 to 74,663,18,5,13,82,59,39,60,140,143,65,36,29,57
S01007260,Very good health,287,12,3,9,42,32,14,20,48,47,29,14,15,43
S01007260,Good health,263,4,2,2,24,20,18,29,70,66,19,9,10,13
S01007260,Fair health,79,2,0,2,10,5,4,6,16,23,13,10,3,0
S01007260,Bad health,26,0,0,0,5,2,2,3,5,5,3,3,0,1
S01007260,Very bad health,8,0,0,0,1,0,1,2,1,2,1,0,1,0
S01007261,All people aged 16 to 74,603,52,18,34,130,84,50,55,90,88,20,12,8,34
S01007261,Very good health,302,30,8,22,64,48,20,26,41,37,5,3,2,31
S01007261,Good health,209,20,8,12,52,24,18,16,32,37,7,5,2,3
S01007261,Fair health,70,2,2,0,11,8,10,9,15,9,6,2,4,0
S01007261,Bad health,17,0,0,0,2,3,2,4,2,4,0,0,0,0
S01007261,Very bad health,5,0,0,0,1,1,0,0,0,1,2,2,0,0
S01007262,All people aged 16 to 74,533,14,3,11,78,49,20,59,130,118,32,16,16,33
S01007262,Very good health,253,8,1,7,43,26,10,21,61,46,11,4,7,27
S01007262,Good health,186,4,2,2,25,15,7,28,48,46,8,5,3,5
S01007262,Fair health,67,2,0,2,8,7,2,7,13,15,12,7,5,1
S01007262,Bad health,21,0,0,0,2,1,1,2,4,10,1,0,1,0
S01007262,Very bad health,6,0,0,0,0,0,0,1,4,1,0,0,0,0
S01007263,All people aged 16 to 74,580,20,7,13,98,68,30,70,111,131,16,9,7,36
S01007263,Very good health,257,11,4,7,52,33,11,26,47,46,8,6,2,23
S01007263,Good health,234,9,3,6,35,27,13,34,49,57,2,0,2,8
S01007263,Fair health,66,0,0,0,9,5,5,7,10,21,5,3,2,4
S01007263,Bad health,12,0,0,0,1,2,0,2,3,3,0,0,0,1
S01007263,Very bad health,11,0,0,0,1,1,1,1,2,4,1,0,1,0
S01007264,All people aged 16 to 74,544,38,11,27,124,51,29,53,104,99,16,12,4,30
S01007264,Very good health,266,18,3,15,68,27,11,30,49,33,4,1,3,26
S01007264,Good health,194,16,7,9,42,21,12,14,39,40,7,7,0,3
S01007264,Fair health,60,4,1,3,14,2,4,4,9,19,3,2,1,1
S01007264,Bad health,19,0,0,0,0,1,1,5,4,6,2,2,0,0
S01007264,Very bad health,5,0,0,0,0,0,1,0,3,1,0,0,0,0
S01007265,All people aged 16 to 74,761,33,8,25,122,86,53,82,140,168,24,14,10,53
S01007265,Very good health,350,17,1,16,62,44,29,37,56,56,10,5,5,39
S01007265,Good health,269,9,3,6,42,31,19,32,57,64,5,1,4,10
S01007265,Fair health,96,6,3,3,13,7,4,9,20,30,5,4,1,2
S01007265,Bad health,36,1,1,0,5,4,0,4,5,13,2,2,0,2
S01007265,Very bad health,10,0,0,0,0,0,1,0,2,5,2,2,0,0
S01007266,All people aged 16 to 74,511,38,9,29,111,58,36,53,97,85,10,6,4,23
S01007266,Very good health,240,22,6,16,57,24,20,26,40,32,3,0,3,16
S01007266,Good health,179,11,2,9,36,23,13,19,42,27,3,2,1,5
S01007266,Fair health,71,5,1,4,15,8,2,6,12,20,1,1,0,2
S01007266,Bad health,17,0,0,0,3,1,1,2,2,5,3,3,0,0
S01007266,Very bad health,4,0,0,0,0,2,0,0,1,1,0,0,0,0
S01007267,All people aged 16 to 74,402,49,3,46,86,41,70,33,50,38,12,6,6,23
S01007267,Very good health,212,31,2,29,43,25,30,16,24,20,3,1,2,20
S01007267,Good health,148,15,1,14,36,11,32,14,16,13,8,4,4,3
S01007267,Fair health,30,2,0,2,4,5,6,2,7,4,0,0,0,0
S01007267,Bad health,10,1,0,1,2,0,2,1,2,1,1,1,0,0
S01007267,Very bad health,2,0,0,0,1,0,0,0,1,0,0,0,0,0
S01007268,All people aged 16 to 74,461,49,10,39,108,44,83,36,52,40,17,11,6,32
S01007268,Very good health,226,22,7,15,62,19,39,14,26,13,7,5,2,24
S01007268,Good health,172,18,2,16,32,20,35,18,18,16,8,4,4,7
S01007268,Fair health,45,7,1,6,10,5,6,4,7,5,0,0,0,1
S01007268,Bad health,13,1,0,1,3,0,2,0,1,5,1,1,0,0
S01007268,Very bad health,5,1,0,1,1,0,1,0,0,1,1,1,0,0
S01007269,All people aged 16 to 74,387,45,19,26,100,43,46,26,39,40,13,8,5,35
S01007269,Very good health,190,29,12,17,59,13,16,14,20,13,4,2,2,22
S01007269,Good health,133,13,5,8,30,19,15,9,15,18,4,1,3,10
S01007269,Fair health,40,0,0,0,8,8,10,3,3,4,3,3,0,1
S01007269,Bad health,17,2,1,1,2,2,3,0,1,4,2,2,0,1
S01007269,Very bad health,7,1,1,0,1,1,2,0,0,1,0,0,0,1
S01007270,All people aged 16 to 74,345,28,4,24,81,28,68,22,50,39,11,8,3,18
S01007270,Very good health,180,15,2,13,46,15,31,9,26,17,7,5,2,14
S01007270,Good health,116,10,1,9,28,9,26,9,16,14,2,1,1,2
S01007270,Fair health,36,2,0,2,3,3,9,1,7,7,2,2,0,2
S01007270,Bad health,9,1,1,0,4,0,1,2,0,1,0,0,0,0
S01007270,Very bad health,4,0,0,0,0,1,1,1,1,0,0,0,0,0
S01007271,All people aged 16 to 74,733,47,14,33,164,86,86,80,111,103,21,10,11,35
S01007271,Very good health,356,28,6,22,87,44,36,37,50,44,3,0,3,27
S01007271,Good health,275,16,7,9,68,25,34,30,49,39,8,4,4,6
S01007271,Fair health,76,2,0,2,7,12,12,11,8,16,7,4,3,1
S01007271,Bad health,20,1,1,0,1,5,4,2,3,1,3,2,1,0
S01007271,Very bad health,6,0,0,0,1,0,0,0,1,3,0,0,0,1
S01007272,All people aged 16 to 74,596,15,3,12,88,49,34,69,141,132,32,19,13,36
S01007272,Very good health,252,8,0,8,30,30,11,31,57,48,15,12,3,22
S01007272,Good health,240,4,3,1,42,13,18,29,62,49,11,4,7,12
S01007272,Fair health,71,1,0,1,10,5,4,4,16,25,5,3,2,1
S01007272,Bad health,26,2,0,2,4,1,1,4,5,7,1,0,1,1
S01007272,Very bad health,7,0,0,0,2,0,0,1,1,3,0,0,0,0
S01007273,All people aged 16 to 74,496,35,11,24,99,49,41,53,88,78,23,15,8,30
S01007273,Very good health,231,18,7,11,57,27,17,20,39,27,6,4,2,20
S01007273,Good health,200,12,3,9,35,18,17,26,33,42,7,2,5,10
S01007273,Fair health,45,4,0,4,6,3,5,5,8,7,7,6,1,0
S01007273,Bad health,14,1,1,0,0,0,2,2,6,1,2,2,0,0
S01007273,Very bad health,6,0,0,0,1,1,0,0,2,1,1,1,0,0
S01007274,All people aged 16 to 74,602,44,6,38,115,61,62,61,97,88,29,9,20,45
S01007274,Very good health,278,23,4,19,52,31,20,30,40,34,11,2,9,37
S01007274,Good health,218,16,0,16,43,21,33,23,30,33,12,2,10,7
S01007274,Fair health,77,5,2,3,18,4,6,6,22,13,3,3,0,0
S01007274,Bad health,21,0,0,0,1,4,3,1,2,7,2,1,1,1
S01007274,Very bad health,8,0,0,0,1,1,0,1,3,1,1,1,0,0
S01007275,All people aged 16 to 74,398,46,5,41,105,52,29,30,47,53,9,6,3,27
S01007275,Very good health,196,22,2,20,55,28,10,14,19,26,1,0,1,21
S01007275,Good health,148,19,3,16,40,17,13,9,18,19,7,5,2,6
S01007275,Fair health,41,4,0,4,10,6,3,5,6,6,1,1,0,0
S01007275,Bad health,9,1,0,1,0,0,3,1,3,1,0,0,0,0
S01007275,Very bad health,4,0,0,0,0,1,0,1,1,1,0,0,0,0
S01007276,All people aged 16 to 74,604,49,14,35,130,78,38,53,93,90,28,16,12,45
S01007276,Very good health,297,30,11,19,65,40,15,22,47,35,11,9,2,32
S01007276,Good health,219,14,1,13,50,29,16,22,30,34,13,5,8,11
S01007276,Fair health,68,5,2,3,12,7,5,7,8,18,4,2,2,2
S01007276,Bad health,14,0,0,0,2,1,1,2,5,3,0,0,0,0
S01007276,Very bad health,6,0,0,0,1,1,1,0,3,0,0,0,0,0
S01007277,All people aged 16 to 74,561,58,12,46,163,67,50,45,76,52,9,7,2,41
S01007277,Very good health,297,35,7,28,92,34,21,29,31,19,3,2,1,33
S01007277,Good health,203,17,4,13,55,26,21,10,38,25,4,3,1,7
S01007277,Fair health,44,5,1,4,12,7,6,4,4,5,0,0,0,1
S01007277,Bad health,9,1,0,1,3,0,1,1,2,1,0,0,0,0
S01007277,Very bad health,8,0,0,0,1,0,1,1,1,2,2,2,0,0
S01007278,All people aged 16 to 74,391,43,16,27,113,59,31,26,43,37,7,5,2,32
S01007278,Very good health,207,19,8,11,67,27,15,14,18,16,3,1,2,28
S01007278,Good health,141,20,7,13,37,23,13,11,19,15,2,2,0,1
S01007278,Fair health,33,3,1,2,6,7,3,0,5,5,1,1,0,3
S01007278,Bad health,9,1,0,1,3,2,0,1,1,0,1,1,0,0
S01007278,Very bad health,1,0,0,0,0,0,0,0,0,1,0,0,0,0
S01007279,All people aged 16 to 74,421,50,12,38,98,24,102,26,51,40,14,9,5,16
S01007279,Very good health,227,25,6,19,59,10,53,15,25,18,9,4,5,13
S01007279,Good health,143,18,5,13,25,11,41,9,19,16,1,1,0,3
S01007279,Fair health,35,5,1,4,10,2,5,1,5,4,3,3,0,0
S01007279,Bad health,11,2,0,2,1,1,2,1,2,2,0,0,0,0
S01007279,Very bad health,5,0,0,0,3,0,1,0,0,0,1,1,0,0
S01007280,All people aged 16 to 74,426,38,7,31,90,44,79,44,56,43,13,5,8,19
S01007280,Very good health,199,23,2,21,41,22,37,29,20,11,5,2,3,11
S01007280,Good health,162,11,4,7,32,18,34,8,25,21,6,2,4,7
S01007280,Fair health,48,4,1,3,13,2,5,6,8,8,1,1,0,1
S01007280,Bad health,15,0,0,0,3,2,3,1,2,3,1,0,1,0
S01007280,Very bad health,2,0,0,0,1,0,0,0,1,0,0,0,0,0
S01007281,All people aged 16 to 74,766,60,15,45,125,94,123,81,113,100,27,22,5,43
S01007281,Very good health,399,44,13,31,62,46,56,40,57,49,9,8,1,36
S01007281,Good health,281,14,2,12,49,41,46,34,39,39,13,10,3,6
S01007281,Fair health,66,2,0,2,13,7,16,6,12,8,1,1,0,1
S01007281,Bad health,15,0,0,0,0,0,4,1,4,4,2,1,1,0
S01007281,Very bad health,5,0,0,0,1,0,1,0,1,0,2,2,0,0
S01007282,All people aged 16 to 74,406,35,9,26,75,23,70,55,72,43,12,7,5,21
S01007282,Very good health,207,24,5,19,47,12,28,26,31,22,3,2,1,14
S01007282,Good health,136,9,3,6,19,9,25,20,27,14,7,3,4,6
S01007282,Fair health,50,2,1,1,6,2,14,7,10,7,1,1,0,1
S01007282,Bad health,11,0,0,0,3,0,2,2,3,0,1,1,0,0
S01007282,Very bad health,2,0,0,0,0,0,1,0,1,0,0,0,0,0
S01007283,All people aged 16 to 74,687,92,20,72,174,81,78,68,73,76,17,13,4,28
S01007283,Very good health,320,59,11,48,89,39,35,31,30,17,5,5,0,15
S01007283,Good health,264,27,9,18,62,31,34,23,33,38,4,3,1,12
S01007283,Fair health,72,5,0,5,17,8,5,12,6,12,6,3,3,1
S01007283,Bad health,25,1,0,1,5,3,3,2,4,5,2,2,0,0
S01007283,Very bad health,6,0,0,0,1,0,1,0,0,4,0,0,0,0
S01007284,All people aged 16 to 74,601,32,6,26,138,70,131,54,79,62,10,9,1,25
S01007284,Very good health,307,17,4,13,68,41,63,24,40,30,3,3,0,21
S01007284,Good health,200,9,2,7,52,21,46,20,22,23,3,2,1,4
S01007284,Fair health,74,5,0,5,15,6,15,8,14,7,4,4,0,0
S01007284,Bad health,17,1,0,1,3,2,6,2,1,2,0,0,0,0
S01007284,Very bad health,3,0,0,0,0,0,1,0,2,0,0,0,0,0
S01007285,All people aged 16 to 74,639,45,7,38,135,60,167,51,99,50,8,4,4,24
S01007285,Very good health,325,21,2,19,74,29,76,26,52,24,3,1,2,20
S01007285,Good health,225,17,4,13,46,19,70,17,33,16,3,2,1,4
S01007285,Fair health,59,4,0,4,10,7,13,6,11,7,1,1,0,0
S01007285,Bad health,26,2,1,1,5,4,8,1,3,2,1,0,1,0
S01007285,Very bad health,4,1,0,1,0,1,0,1,0,1,0,0,0,0
S01007286,All people aged 16 to 74,707,37,10,27,161,62,153,70,109,79,16,7,9,20
S01007286,Very good health,365,17,1,16,89,32,77,33,56,42,5,0,5,14
S01007286,Good health,248,14,7,7,56,18,55,26,41,25,8,4,4,5
S01007286,Fair health,66,5,2,3,7,12,14,7,10,9,1,1,0,1
S01007286,Bad health,25,1,0,1,9,0,7,3,1,3,1,1,0,0
S01007286,Very bad health,3,0,0,0,0,0,0,1,1,0,1,1,0,0
S01007287,All people aged 16 to 74,477,30,5,25,98,30,143,43,78,33,11,2,9,11
S01007287,Very good health,250,16,2,14,53,13,70,23,46,15,4,0,4,10
S01007287,Good health,167,13,3,10,34,9,53,16,22,13,6,1,5,1
S01007287,Fair health,45,1,0,1,7,8,14,3,7,4,1,1,0,0
S01007287,Bad health,14,0,0,0,3,0,6,1,3,1,0,0,0,0
S01007287,Very bad health,1,0,0,0,1,0,0,0,0,0,0,0,0,0
S01007288,All people aged 16 to 74,438,35,6,29,96,33,109,33,61,44,11,3,8,16
S01007288,Very good health,197,20,3,17,44,14,45,13,22,17,6,1,5,16
S01007288,Good health,184,11,3,8,39,16,51,13,31,19,4,1,3,0
S01007288,Fair health,48,2,0,2,11,3,12,5,6,8,1,1,0,0
S01007288,Bad health,7,1,0,1,1,0,1,2,2,0,0,0,0,0
S01007288,Very bad health,2,1,0,1,1,0,0,0,0,0,0,0,0,0
S01007289,All people aged 16 to 74,626,49,15,34,175,84,92,41,97,50,2,2,0,36
S01007289,Very good health,361,32,11,21,97,36,60,23,55,28,1,1,0,29
S01007289,Good health,201,15,4,11,65,34,24,12,32,13,0,0,0,6
S01007289,Fair health,50,2,0,2,12,12,6,4,8,6,0,0,0,0
S01007289,Bad health,13,0,0,0,0,2,2,2,2,3,1,1,0,1
S01007289,Very bad health,1,0,0,0,1,0,0,0,0,0,0,0,0,0
S01007290,All people aged 16 to 74,504,22,6,16,108,48,58,40,98,73,20,12,8,37
S01007290,Very good health,296,13,5,8,67,29,34,20,56,37,11,5,6,29
S01007290,Good health,138,4,0,4,31,13,15,13,30,23,2,1,1,7
S01007290,Fair health,50,2,1,1,4,6,7,6,9,10,5,4,1,1
S01007290,Bad health,12,2,0,2,3,0,1,0,2,2,2,2,0,0
S01007290,Very bad health,8,1,0,1,3,0,1,1,1,1,0,0,0,0
S01007291,All people aged 16 to 74,479,20,1,19,99,44,46,43,93,89,20,14,6,25
S01007291,Very good health,226,16,1,15,54,22,20,16,40,33,6,4,2,19
S01007291,Good health,152,2,0,2,32,12,19,21,32,23,6,4,2,5
S01007291,Fair health,64,1,0,1,10,3,5,4,14,21,5,4,1,1
S01007291,Bad health,30,1,0,1,3,5,0,2,6,11,2,1,1,0
S01007291,Very bad health,7,0,0,0,0,2,2,0,1,1,1,1,0,0
S01007292,All people aged 16 to 74,593,25,7,18,151,78,64,56,103,76,3,1,2,37
S01007292,Very good health,313,15,2,13,70,45,36,29,43,38,2,1,1,35
S01007292,Good health,191,9,4,5,64,21,18,13,39,25,0,0,0,2
S01007292,Fair health,67,1,1,0,12,11,8,11,14,9,1,0,1,0
S01007292,Bad health,15,0,0,0,3,0,1,3,6,2,0,0,0,0
S01007292,Very bad health,7,0,0,0,2,1,1,0,1,2,0,0,0,0
S01007293,All people aged 16 to 74,547,16,2,14,72,34,37,69,140,127,27,12,15,25
S01007293,Very good health,291,13,2,11,32,19,18,38,70,71,13,3,10,17
S01007293,Good health,191,3,0,3,25,11,18,27,49,45,5,2,3,8
S01007293,Fair health,52,0,0,0,10,4,1,2,17,10,8,6,2,0
S01007293,Bad health,9,0,0,0,3,0,0,2,3,1,0,0,0,0
S01007293,Very bad health,4,0,0,0,2,0,0,0,1,0,1,1,0,0
S01007294,All people aged 16 to 74,684,27,8,19,120,64,72,75,141,117,16,12,4,52
S01007294,Very good health,341,16,4,12,66,40,36,44,60,40,6,4,2,33
S01007294,Good health,226,7,2,5,44,19,25,19,49,45,3,3,0,15
S01007294,Fair health,77,4,2,2,4,4,6,8,20,20,7,5,2,4
S01007294,Bad health,32,0,0,0,4,1,4,4,11,8,0,0,0,0
S01007294,Very bad health,8,0,0,0,2,0,1,0,1,4,0,0,0,0
S01007295,All people aged 16 to 74,370,10,1,9,51,22,23,49,91,86,26,21,5,12
S01007295,Very good health,149,7,0,7,25,11,9,21,37,28,4,3,1,7
S01007295,Good health,133,1,1,0,21,8,9,18,33,28,11,8,3,4
S01007295,Fair health,66,0,0,0,4,2,3,8,16,25,7,6,1,1
S01007295,Bad health,15,1,0,1,0,0,1,1,5,4,3,3,0,0
S01007295,Very bad health,7,1,0,1,1,1,1,1,0,1,1,1,0,0
S01007296,All people aged 16 to 74,464,28,2,26,92,33,58,53,81,69,24,9,15,26
S01007296,Very good health,217,19,2,17,42,20,30,28,29,21,5,1,4,23
S01007296,Good health,170,6,0,6,38,9,14,20,36,32,12,5,7,3
S01007296,Fair health,56,2,0,2,11,4,10,4,11,11,3,2,1,0
S01007296,Bad health,17,1,0,1,1,0,4,1,4,3,3,0,3,0
S01007296,Very bad health,4,0,0,0,0,0,0,0,1,2,1,1,0,0
S01007297,All people aged 16 to 74,728,81,12,69,179,68,96,67,112,79,15,10,5,31
S01007297,Very good health,420,54,7,47,113,41,56,38,52,37,7,3,4,22
S01007297,Good health,227,22,4,18,51,19,27,19,45,31,5,4,1,8
S01007297,Fair health,67,5,1,4,13,7,9,8,12,10,2,2,0,1
S01007297,Bad health,11,0,0,0,2,1,3,2,1,1,1,1,0,0
S01007297,Very bad health,3,0,0,0,0,0,1,0,2,0,0,0,0,0
S01007298,All people aged 16 to 74,395,15,2,13,76,58,40,45,65,62,8,3,5,26
S01007298,Very good health,215,8,2,6,50,34,17,23,32,27,4,2,2,20
S01007298,Good health,117,5,0,5,19,17,16,16,22,17,2,1,1,3
S01007298,Fair health,47,2,0,2,5,4,5,5,9,13,1,0,1,3
S01007298,Bad health,13,0,0,0,2,1,1,1,2,5,1,0,1,0
S01007298,Very bad health,3,0,0,0,0,2,1,0,0,0,0,0,0,0
S01007299,All people aged 16 to 74,650,28,6,22,112,56,77,89,116,103,21,6,15,48
S01007299,Very good health,343,17,6,11,61,34,30,47,60,50,6,2,4,38
S01007299,Good health,226,11,0,11,40,16,37,28,40,38,8,2,6,8
S01007299,Fair health,63,0,0,0,7,6,7,11,15,12,3,0,3,2
S01007299,Bad health,15,0,0,0,3,0,1,3,1,3,4,2,2,0
S01007299,Very bad health,3,0,0,0,1,0,2,0,0,0,0,0,0,0
S01007300,All people aged 16 to 74,355,8,3,5,43,39,39,40,82,67,22,8,14,15
S01007300,Very good health,164,5,3,2,21,21,17,19,34,29,6,2,4,12
S01007300,Good health,125,2,0,2,15,11,17,15,32,25,8,1,7,0
S01007300,Fair health,52,1,0,1,6,6,2,4,12,12,6,4,2,3
S01007300,Bad health,12,0,0,0,1,1,2,2,3,1,2,1,1,0
S01007300,Very bad health,2,0,0,0,0,0,1,0,1,0,0,0,0,0
S01007301,All people aged 16 to 74,548,60,15,45,143,59,106,37,67,46,9,4,5,21
S01007301,Very good health,301,37,10,27,79,30,55,22,38,21,3,2,1,16
S01007301,Good health,185,17,1,16,52,25,38,11,17,16,5,2,3,4
S01007301,Fair health,47,5,4,1,9,2,13,3,7,6,1,0,1,1
S01007301,Bad health,12,1,0,1,2,1,0,1,4,3,0,0,0,0
S01007301,Very bad health,3,0,0,0,1,1,0,0,1,0,0,0,0,0
S01007302,All people aged 16 to 74,465,18,5,13,72,49,49,58,111,62,17,10,7,29
S01007302,Very good health,230,8,4,4,39,31,19,28,47,30,9,6,3,19
S01007302,Good health,132,8,1,7,18,12,15,14,35,17,4,2,2,9
S01007302,Fair health,67,2,0,2,13,4,12,10,15,7,3,1,2,1
S01007302,Bad health,26,0,0,0,2,1,3,3,8,8,1,1,0,0
S01007302,Very bad health,10,0,0,0,0,1,0,3,6,0,0,0,0,0
S01007303,All people aged 16 to 74,658,62,12,50,151,74,126,64,93,42,17,15,2,29
S01007303,Very good health,349,36,5,31,81,35,60,38,47,23,6,5,1,23
S01007303,Good health,216,20,5,15,54,32,41,15,35,11,3,2,1,5
S01007303,Fair health,66,5,2,3,11,6,18,10,8,6,2,2,0,0
S01007303,Bad health,21,1,0,1,3,1,5,1,3,1,5,5,0,1
S01007303,Very bad health,6,0,0,0,2,0,2,0,0,1,1,1,0,0
S01007304,All people aged 16 to 74,501,44,10,34,120,42,123,37,66,40,11,9,2,18
S01007304,Very good health,256,23,6,17,55,20,62,19,34,24,8,7,1,11
S01007304,Good health,175,16,4,12,47,15,44,12,21,12,1,0,1,7
S01007304,Fair health,59,3,0,3,16,5,16,5,9,4,1,1,0,0
S01007304,Bad health,6,1,0,1,1,1,1,0,1,0,1,1,0,0
S01007304,Very bad health,5,1,0,1,1,1,0,1,1,0,0,0,0,0
S01007305,All people aged 16 to 74,544,67,18,49,131,61,82,49,81,44,4,3,1,25
S01007305,Very good health,287,39,9,30,64,32,41,24,46,18,2,1,1,21
S01007305,Good health,182,19,5,14,49,23,31,21,24,12,0,0,0,3
S01007305,Fair health,64,8,4,4,14,5,9,3,10,12,2,2,0,1
S01007305,Bad health,6,1,0,1,1,1,0,1,1,1,0,0,0,0
S01007305,Very bad health,5,0,0,0,3,0,1,0,0,1,0,0,0,0
S01007306,All people aged 16 to 74,551,54,14,40,138,69,75,45,80,52,12,6,6,26
S01007306,Very good health,288,29,6,23,66,36,40,25,42,23,6,3,3,21
S01007306,Good health,184,21,6,15,54,24,25,11,26,17,1,0,1,5
S01007306,Fair health,59,3,2,1,16,8,7,7,8,7,3,1,2,0
S01007306,Bad health,16,1,0,1,1,1,3,2,4,4,0,0,0,0
S01007306,Very bad health,4,0,0,0,1,0,0,0,0,1,2,2,0,0
S01007307,All people aged 16 to 74,611,63,14,49,136,74,139,52,73,39,13,8,5,22
S01007307,Very good health,313,40,8,32,67,36,61,26,40,21,5,3,2,17
S01007307,Good health,225,19,5,14,55,32,57,18,22,13,4,3,1,5
S01007307,Fair health,55,2,1,1,11,5,16,4,9,5,3,1,2,0
S01007307,Bad health,17,2,0,2,3,1,4,4,2,0,1,1,0,0
S01007307,Very bad health,1,0,0,0,0,0,1,0,0,0,0,0,0,0
S01007308,All people aged 16 to 74,628,54,20,34,141,54,88,61,108,88,10,3,7,24
S01007308,Very good health,327,28,11,17,82,24,42,32,52,42,5,2,3,20
S01007308,Good health,207,21,9,12,42,18,23,23,39,36,3,0,3,2
S01007308,Fair health,57,1,0,1,12,7,17,4,9,4,1,0,1,2
S01007308,Bad health,29,2,0,2,4,5,3,2,6,6,1,1,0,0
S01007308,Very bad health,8,2,0,2,1,0,3,0,2,0,0,0,0,0
S01007309,All people aged 16 to 74,505,53,11,42,126,34,102,39,72,52,11,7,4,16
S01007309,Very good health,271,35,9,26,78,17,60,18,26,22,3,2,1,12
S01007309,Good health,154,14,2,12,35,13,28,14,27,16,5,2,3,2
S01007309,Fair health,64,3,0,3,11,3,12,7,15,10,1,1,0,2
S01007309,Bad health,9,1,0,1,1,1,1,0,1,2,2,2,0,0
S01007309,Very bad health,7,0,0,0,1,0,1,0,3,2,0,0,0,0
S01007310,All people aged 16 to 74,601,61,13,48,139,53,131,40,87,50,13,7,6,27
S01007310,Very good health,308,38,6,32,80,25,64,20,34,22,5,4,1,20
S01007310,Good health,206,17,7,10,44,18,46,14,39,17,7,3,4,4
S01007310,Fair health,60,5,0,5,12,6,12,4,9,8,1,0,1,3
S01007310,Bad health,24,1,0,1,2,3,8,2,5,3,0,0,0,0
S01007310,Very bad health,3,0,0,0,1,1,1,0,0,0,0,0,0,0
S01007311,All people aged 16 to 74,592,33,11,22,91,51,99,81,119,86,12,2,10,20
S01007311,Very good health,312,15,3,12,53,28,51,50,52,42,4,0,4,17
S01007311,Good health,182,16,6,10,25,18,32,19,38,26,5,0,5,3
S01007311,Fair health,70,2,2,0,10,3,13,7,21,12,2,1,1,0
S01007311,Bad health,21,0,0,0,3,2,2,5,5,3,1,1,0,0
S01007311,Very bad health,7,0,0,0,0,0,1,0,3,3,0,0,0,0
S01007312,All people aged 16 to 74,543,57,15,42,153,61,75,45,74,46,16,8,8,16
S01007312,Very good health,242,30,10,20,73,32,35,16,21,17,4,2,2,14
S01007312,Good health,219,23,4,19,54,21,32,21,36,24,6,2,4,2
S01007312,Fair health,56,2,0,2,19,4,6,6,12,4,3,2,1,0
S01007312,Bad health,20,2,1,1,7,2,2,1,4,0,2,1,1,0
S01007312,Very bad health,6,0,0,0,0,2,0,1,1,1,1,1,0,0
S01007313,All people aged 16 to 74,753,89,21,68,220,74,152,41,75,59,14,7,7,29
S01007313,Very good health,414,54,13,41,130,30,83,19,40,27,6,2,4,25
S01007313,Good health,240,28,6,22,62,30,55,14,25,18,5,3,2,3
S01007313,Fair health,84,5,1,4,24,11,14,8,6,14,1,1,0,1
S01007313,Bad health,10,1,1,0,2,3,0,0,3,0,1,0,1,0
S01007313,Very bad health,5,1,0,1,2,0,0,0,1,0,1,1,0,0
S01007314,All people aged 16 to 74,493,45,8,37,128,57,71,41,68,46,13,9,4,24
S01007314,Very good health,248,20,5,15,65,35,32,20,36,17,2,1,1,21
S01007314,Good health,189,16,1,15,49,16,33,19,27,20,7,5,2,2
S01007314,Fair health,47,9,2,7,11,6,4,1,5,7,3,2,1,1
S01007314,Bad health,9,0,0,0,3,0,2,1,0,2,1,1,0,0
S01007314,Very bad health,0,0,0,0,0,0,0,0,0,0,0,0,0,0
S01007315,All people aged 16 to 74,700,62,19,43,192,108,43,58,96,87,21,11,10,33
S01007315,Very good health,370,35,10,25,101,62,18,26,51,41,10,6,4,26
S01007315,Good health,220,19,5,14,70,29,18,18,31,26,3,1,2,6
S01007315,Fair health,86,6,3,3,18,15,5,10,9,17,5,3,2,1
S01007315,Bad health,16,1,1,0,2,2,2,3,1,2,3,1,2,0
S01007315,Very bad health,8,1,0,1,1,0,0,1,4,1,0,0,0,0
S01007316,All people aged 16 to 74,648,39,13,26,152,87,51,65,82,100,41,23,18,31
S01007316,Very good health,280,25,9,16,59,42,21,26,34,36,14,6,8,23
S01007316,Good health,238,11,3,8,69,28,22,25,24,38,16,10,6,5
S01007316,Fair health,84,1,1,0,17,10,4,11,17,16,5,4,1,3
S01007316,Bad health,38,1,0,1,6,6,4,3,6,6,6,3,3,0
S01007316,Very bad health,8,1,0,1,1,1,0,0,1,4,0,0,0,0
S01007317,All people aged 16 to 74,490,40,7,33,134,65,40,43,63,55,25,18,7,25
S01007317,Very good health,245,23,5,18,71,38,22,24,21,19,7,5,2,20
S01007317,Good health,165,13,1,12,39,19,13,16,26,24,10,7,3,5
S01007317,Fair health,69,3,1,2,19,7,4,3,15,12,6,4,2,0
S01007317,Bad health,10,1,0,1,4,1,1,0,1,0,2,2,0,0
S01007317,Very bad health,1,0,0,0,1,0,0,0,0,0,0,0,0,0
S01007318,All people aged 16 to 74,439,26,3,23,87,52,61,44,75,61,15,5,10,18
S01007318,Very good health,211,14,1,13,45,24,30,24,27,25,6,2,4,16
S01007318,Good health,147,9,2,7,22,17,27,12,30,25,3,1,2,2
S01007318,Fair health,57,1,0,1,14,6,3,7,13,9,4,1,3,0
S01007318,Bad health,21,2,0,2,4,5,1,1,4,2,2,1,1,0
S01007318,Very bad health,3,0,0,0,2,0,0,0,1,0,0,0,0,0
S01007319,All people aged 16 to 74,546,45,8,37,127,67,76,54,64,78,15,7,8,20
S01007319,Very good health,281,27,6,21,66,37,37,26,33,37,3,2,1,15
S01007319,Good health,189,17,2,15,47,23,29,15,20,30,6,0,6,2
S01007319,Fair health,52,1,0,1,10,6,6,12,7,7,2,2,0,1
S01007319,Bad health,17,0,0,0,3,1,3,0,4,2,4,3,1,0
S01007319,Very bad health,7,0,0,0,1,0,1,1,0,2,0,0,0,2
S01007320,All people aged 16 to 74,557,71,23,48,159,59,98,41,56,30,11,6,5,32
S01007320,Very good health,296,37,10,27,87,28,49,22,28,15,8,5,3,22
S01007320,Good health,210,31,13,18,57,23,37,15,23,13,2,0,2,9
S01007320,Fair health,35,2,0,2,12,5,8,2,2,2,1,1,0,1
S01007320,Bad health,15,1,0,1,3,3,3,2,3,0,0,0,0,0
S01007320,Very bad health,1,0,0,0,0,0,1,0,0,0,0,0,0,0
S01007321,All people aged 16 to 74,482,46,15,31,117,34,115,34,62,46,12,4,8,16
S01007321,Very good health,224,20,5,15,59,17,61,12,20,17,4,2,2,14
S01007321,Good health,168,19,8,11,40,12,33,13,26,17,6,1,5,2
S01007321,Fair health,65,4,0,4,12,4,19,6,10,8,2,1,1,0
S01007321,Bad health,20,3,2,1,6,1,1,2,3,4,0,0,0,0
S01007321,Very bad health,5,0,0,0,0,0,1,1,3,0,0,0,0,0
S01007322,All people aged 16 to 74,552,20,3,17,118,77,94,43,69,87,21,10,11,23
S01007322,Very good health,250,12,1,11,56,41,40,14,30,37,5,3,2,15
S01007322,Good health,203,5,2,3,48,26,36,20,25,30,8,1,7,5
S01007322,Fair health,71,2,0,2,10,6,11,3,12,16,8,6,2,3
S01007322,Bad health,23,1,0,1,4,3,7,3,2,3,0,0,0,0
S01007322,Very bad health,5,0,0,0,0,1,0,3,0,1,0,0,0,0
S01007323,All people aged 16 to 74,342,15,3,12,64,39,55,35,50,66,3,3,0,15
S01007323,Very good health,144,8,2,6,28,21,14,19,17,24,0,0,0,13
S01007323,Good health,141,5,1,4,26,14,27,13,24,28,2,2,0,2
S01007323,Fair health,38,2,0,2,7,2,12,2,7,6,0,0,0,0
S01007323,Bad health,17,0,0,0,3,2,2,0,1,8,1,1,0,0
S01007323,Very bad health,2,0,0,0,0,0,0,1,1,0,0,0,0,0
S01007324,All people aged 16 to 74,258,33,14,19,59,13,41,21,44,30,7,3,4,10
S01007324,Very good health,140,19,10,9,34,7,21,7,22,17,3,2,1,10
S01007324,Good health,83,12,3,9,17,5,13,10,16,8,2,1,1,0
S01007324,Fair health,25,2,1,1,7,1,3,3,3,4,2,0,2,0
S01007324,Bad health,9,0,0,0,1,0,3,1,3,1,0,0,0,0
S01007324,Very bad health,1,0,0,0,0,0,1,0,0,0,0,0,0,0
S01007325,All people aged 16 to 74,599,39,13,26,127,63,129,51,98,61,13,10,3,18
S01007325,Very good health,297,21,9,12,61,33,64,21,48,27,6,3,3,16
S01007325,Good health,205,15,4,11,43,22,44,20,31,26,3,3,0,1
S01007325,Fair health,73,3,0,3,16,7,16,7,14,6,3,3,0,1
S01007325,Bad health,17,0,0,0,4,1,5,1,4,1,1,1,0,0
S01007325,Very bad health,7,0,0,0,3,0,0,2,1,1,0,0,0,0
S01007326,All people aged 16 to 74,592,34,9,25,105,46,110,74,121,68,13,7,6,21
S01007326,Very good health,285,15,5,10,48,25,51,37,55,33,7,4,3,14
S01007326,Good health,207,13,3,10,38,16,38,26,46,20,3,1,2,7
S01007326,Fair health,74,5,1,4,15,3,16,6,16,11,2,1,1,0
S01007326,Bad health,22,1,0,1,4,2,4,4,3,4,0,0,0,0
S01007326,Very bad health,4,0,0,0,0,0,1,1,1,0,1,1,0,0
S01007327,All people aged 16 to 74,563,27,8,19,94,59,70,55,115,92,23,12,11,28
S01007327,Very good health,249,16,5,11,47,34,31,17,47,30,8,3,5,19
S01007327,Good health,194,6,2,4,36,20,26,22,39,32,6,2,4,7
S01007327,Fair health,90,2,1,1,7,2,12,14,25,20,7,5,2,1
S01007327,Bad health,22,3,0,3,2,3,1,1,2,9,0,0,0,1
S01007327,Very bad health,8,0,0,0,2,0,0,1,2,1,2,2,0,0
S01007328,All people aged 16 to 74,633,21,5,16,90,59,92,46,160,107,27,18,9,31
S01007328,Very good health,287,14,5,9,33,24,34,27,78,47,7,5,2,23
S01007328,Good health,236,4,0,4,44,25,35,12,59,41,9,3,6,7
S01007328,Fair health,83,1,0,1,9,8,19,2,19,14,10,9,1,1
S01007328,Bad health,22,2,0,2,3,2,4,5,3,2,1,1,0,0
S01007328,Very bad health,5,0,0,0,1,0,0,0,1,3,0,0,0,0
S01007329,All people aged 16 to 74,507,26,6,20,107,37,129,38,68,54,20,13,7,28
S01007329,Very good health,242,13,3,10,56,22,44,24,25,27,10,6,4,21
S01007329,Good health,172,12,3,9,38,7,52,7,30,15,6,4,2,5
S01007329,Fair health,64,1,0,1,9,6,24,5,6,8,4,3,1,1
S01007329,Bad health,21,0,0,0,3,1,7,1,5,3,0,0,0,1
S01007329,Very bad health,8,0,0,0,1,1,2,1,2,1,0,0,0,0
S01007330,All people aged 16 to 74,571,34,10,24,144,58,143,35,85,44,12,5,7,16
S01007330,Very good health,239,10,4,6,58,26,61,11,35,19,6,1,5,13
S01007330,Good health,234,19,5,14,65,23,61,12,36,13,2,1,1,3
S01007330,Fair health,71,4,1,3,16,6,14,9,10,9,3,2,1,0
S01007330,Bad health,20,1,0,1,3,1,6,3,4,1,1,1,0,0
S01007330,Very bad health,7,0,0,0,2,2,1,0,0,2,0,0,0,0
S01007331,All people aged 16 to 74,732,34,4,30,136,86,145,61,120,100,23,14,9,27
S01007331,Very good health,363,18,2,16,75,38,66,25,66,46,5,2,3,24
S01007331,Good health,260,12,2,10,45,34,65,23,41,31,7,2,5,2
S01007331,Fair health,71,3,0,3,12,10,10,8,8,13,7,6,1,0
S01007331,Bad health,29,1,0,1,2,4,2,5,4,7,3,3,0,1
S01007331,Very bad health,9,0,0,0,2,0,2,0,1,3,1,1,0,0
S01007332,All people aged 16 to 74,385,22,4,18,73,28,114,26,47,28,14,11,3,33
S01007332,Very good health,205,15,3,12,38,13,60,13,21,13,1,1,0,31
S01007332,Good health,120,5,0,5,23,11,41,5,19,10,6,4,2,0
S01007332,Fair health,47,1,1,0,10,3,11,5,5,4,6,5,1,2
S01007332,Bad health,12,1,0,1,2,1,2,3,2,1,0,0,0,0
S01007332,Very bad health,1,0,0,0,0,0,0,0,0,0,1,1,0,0
S01007333,All people aged 16 to 74,574,45,9,36,135,75,73,49,84,69,18,11,7,26
S01007333,Very good health,284,23,4,19,76,39,27,24,40,28,4,2,2,23
S01007333,Good health,197,16,4,12,45,28,27,21,32,19,8,4,4,1
S01007333,Fair health,67,2,1,1,10,8,12,3,7,18,5,4,1,2
S01007333,Bad health,19,4,0,4,1,0,6,1,4,3,0,0,0,0
S01007333,Very bad health,7,0,0,0,3,0,1,0,1,1,1,1,0,0
S01007334,All people aged 16 to 74,509,12,3,9,51,53,38,57,110,120,43,25,18,25
S01007334,Very good health,197,5,2,3,22,28,18,17,41,39,9,8,1,18
S01007334,Good health,173,4,1,3,18,17,8,22,40,44,15,5,10,5
S01007334,Fair health,98,2,0,2,5,6,7,12,21,27,16,10,6,2
S01007334,Bad health,30,0,0,0,6,2,1,4,7,9,1,0,1,0
S01007334,Very bad health,11,1,0,1,0,0,4,2,1,1,2,2,0,0
S01007335,All people aged 16 to 74,586,7,0,7,77,74,40,74,127,131,35,20,15,21
S01007335,Very good health,251,5,0,5,36,41,19,30,48,48,10,6,4,14
S01007335,Good health,212,1,0,1,31,22,14,24,52,50,14,8,6,4
S01007335,Fair health,81,1,0,1,8,9,2,12,18,21,7,4,3,3
S01007335,Bad health,34,0,0,0,2,2,4,7,8,8,3,2,1,0
S01007335,Very bad health,8,0,0,0,0,0,1,1,1,4,1,0,1,0
S01007336,All people aged 16 to 74,400,14,3,11,70,43,47,47,69,55,42,27,15,13
S01007336,Very good health,167,3,1,2,33,19,22,22,27,17,15,11,4,9
S01007336,Good health,139,4,1,3,33,16,14,13,24,21,12,6,6,2
S01007336,Fair health,62,5,1,4,2,4,5,8,13,12,11,7,4,2
S01007336,Bad health,25,2,0,2,1,4,5,4,3,3,3,3,0,0
S01007336,Very bad health,7,0,0,0,1,0,1,0,2,2,1,0,1,0
S01007337,All people aged 16 to 74,454,15,6,9,72,69,53,44,100,70,17,8,9,14
S01007337,Very good health,185,8,5,3,32,26,23,18,38,26,3,1,2,11
S01007337,Good health,161,6,1,5,25,26,19,14,39,23,6,1,5,3
S01007337,Fair health,67,0,0,0,9,10,9,6,13,12,8,6,2,0
S01007337,Bad health,31,1,0,1,6,6,2,4,9,3,0,0,0,0
S01007337,Very bad health,10,0,0,0,0,1,0,2,1,6,0,0,0,0
S01007338,All people aged 16 to 74,554,17,5,12,78,81,47,69,105,112,16,10,6,29
S01007338,Very good health,261,10,2,8,45,38,23,25,42,47,6,1,5,25
S01007338,Good health,190,5,3,2,24,29,17,29,43,37,3,3,0,3
S01007338,Fair health,70,1,0,1,6,10,2,11,18,17,4,3,1,1
S01007338,Bad health,27,1,0,1,1,4,5,1,2,10,3,3,0,0
S01007338,Very bad health,6,0,0,0,2,0,0,3,0,1,0,0,0,0
S01007339,All people aged 16 to 74,437,28,4,24,114,66,60,32,60,51,10,7,3,16
S01007339,Very good health,201,13,2,11,54,27,22,14,33,20,3,2,1,15
S01007339,Good health,157,8,2,6,50,26,28,8,16,17,3,2,1,1
S01007339,Fair health,63,6,0,6,6,13,9,7,7,11,4,3,1,0
S01007339,Bad health,11,1,0,1,4,0,1,2,1,2,0,0,0,0
S01007339,Very bad health,5,0,0,0,0,0,0,1,3,1,0,0,0,0
S01007340,All people aged 16 to 74,349,24,7,17,88,31,43,30,53,51,19,13,6,10
S01007340,Very good health,126,10,2,8,32,12,13,11,17,20,3,2,1,8
S01007340,Good health,130,10,5,5,32,13,21,8,23,15,7,2,5,1
S01007340,Fair health,63,2,0,2,17,5,7,7,9,10,5,5,0,1
S01007340,Bad health,25,1,0,1,6,1,2,4,3,4,4,4,0,0
S01007340,Very bad health,5,1,0,1,1,0,0,0,1,2,0,0,0,0
S01007341,All people aged 16 to 74,538,37,12,25,116,74,83,40,79,62,20,14,6,27
S01007341,Very good health,226,17,5,12,53,37,28,13,23,34,1,1,0,20
S01007341,Good health,190,14,5,9,40,22,30,15,34,18,12,9,3,5
S01007341,Fair health,92,4,1,3,16,9,20,8,18,9,6,3,3,2
S01007341,Bad health,25,2,1,1,5,6,4,3,3,1,1,1,0,0
S01007341,Very bad health,5,0,0,0,2,0,1,1,1,0,0,0,0,0
S01007342,All people aged 16 to 74,622,86,21,65,157,83,112,36,60,43,10,6,4,35
S01007342,Very good health,317,53,11,42,66,32,62,15,30,24,3,0,3,32
S01007342,Good health,211,23,6,17,61,33,39,16,22,11,4,3,1,2
S01007342,Fair health,69,10,4,6,22,13,9,5,4,4,2,2,0,0
S01007342,Bad health,16,0,0,0,5,3,1,0,3,3,0,0,0,1
S01007342,Very bad health,9,0,0,0,3,2,1,0,1,1,1,1,0,0
S01007343,All people aged 16 to 74,483,35,8,27,83,45,136,42,73,41,7,7,0,21
S01007343,Very good health,222,19,3,16,34,18,65,20,39,10,1,1,0,16
S01007343,Good health,168,8,3,5,38,18,44,12,24,16,3,3,0,5
S01007343,Fair health,69,7,1,6,7,6,22,10,7,8,2,2,0,0
S01007343,Bad health,21,0,0,0,4,3,5,0,3,5,1,1,0,0
S01007343,Very bad health,3,1,1,0,0,0,0,0,0,2,0,0,0,0
S01007344,All people aged 16 to 74,320,14,2,12,75,46,45,25,59,29,9,7,2,18
S01007344,Very good health,129,4,1,3,27,27,17,10,22,5,2,2,0,15
S01007344,Good health,119,9,1,8,36,11,15,7,23,13,2,1,1,3
S01007344,Fair health,42,0,0,0,10,4,9,4,10,2,3,2,1,0
S01007344,Bad health,25,1,0,1,1,3,4,3,3,8,2,2,0,0
S01007344,Very bad health,5,0,0,0,1,1,0,1,1,1,0,0,0,0
S01007345,All people aged 16 to 74,400,5,2,3,55,45,40,38,84,75,35,18,17,23
S01007345,Very good health,153,1,1,0,21,16,16,16,34,27,4,2,2,18
S01007345,Good health,138,3,0,3,23,16,11,13,29,21,18,7,11,4
S01007345,Fair health,74,1,1,0,5,10,11,7,15,15,9,5,4,1
S01007345,Bad health,30,0,0,0,6,3,2,2,4,10,3,3,0,0
S01007345,Very bad health,5,0,0,0,0,0,0,0,2,2,1,1,0,0
S01007346,All people aged 16 to 74,416,9,2,7,61,56,37,47,76,81,36,19,17,13
S01007346,Very good health,142,3,0,3,30,22,12,12,25,25,8,4,4,5
S01007346,Good health,157,4,1,3,20,26,15,20,30,23,17,8,9,2
S01007346,Fair health,82,2,1,1,6,5,7,8,17,23,8,4,4,6
S01007346,Bad health,25,0,0,0,5,2,1,5,4,6,2,2,0,0
S01007346,Very bad health,10,0,0,0,0,1,2,2,0,4,1,1,0,0
S01007347,All people aged 16 to 74,475,14,6,8,59,51,45,36,94,102,39,21,18,35
S01007347,Very good health,182,9,4,5,24,23,17,12,36,26,15,3,12,20
S01007347,Good health,159,4,1,3,28,16,18,9,32,31,10,6,4,11
S01007347,Fair health,92,1,1,0,3,9,6,9,21,30,11,9,2,2
S01007347,Bad health,30,0,0,0,3,3,2,4,3,10,3,3,0,2
S01007347,Very bad health,12,0,0,0,1,0,2,2,2,5,0,0,0,0
S01007348,All people aged 16 to 74,422,5,1,4,54,51,37,50,97,70,25,14,11,33
S01007348,Very good health,184,3,1,2,21,27,8,24,34,32,8,3,5,27
S01007348,Good health,146,1,0,1,22,18,19,15,43,18,6,3,3,4
S01007348,Fair health,58,1,0,1,5,3,6,9,12,13,7,4,3,2
S01007348,Bad health,24,0,0,0,4,3,3,0,6,5,3,3,0,0
S01007348,Very bad health,10,0,0,0,2,0,1,2,2,2,1,1,0,0
S01007349,All people aged 16 to 74,316,13,5,8,50,46,24,32,70,51,18,12,6,12
S01007349,Very good health,136,2,1,1,24,23,12,10,25,22,7,5,2,11
S01007349,Good health,114,8,2,6,16,12,7,13,30,18,9,5,4,1
S01007349,Fair health,42,2,2,0,7,10,3,4,10,5,1,1,0,0
S01007349,Bad health,18,1,0,1,3,0,2,4,2,5,1,1,0,0
S01007349,Very bad health,6,0,0,0,0,1,0,1,3,1,0,0,0,0
S01007350,All people aged 16 to 74,414,16,7,9,73,53,61,42,59,71,20,11,9,19
S01007350,Very good health,171,8,5,3,30,22,24,19,27,20,7,4,3,14
S01007350,Good health,160,6,2,4,34,23,19,16,18,33,7,2,5,4
S01007350,Fair health,64,2,0,2,8,7,16,5,10,14,1,1,0,1
S01007350,Bad health,15,0,0,0,1,0,2,1,2,4,5,4,1,0
S01007350,Very bad health,4,0,0,0,0,1,0,1,2,0,0,0,0,0
S01007351,All people aged 16 to 74,467,32,8,24,110,31,124,41,71,41,9,6,3,8
S01007351,Very good health,191,15,1,14,48,12,53,15,25,17,2,1,1,4
S01007351,Good health,177,11,5,6,44,14,47,20,21,14,4,2,2,2
S01007351,Fair health,59,4,2,2,10,4,14,3,17,5,0,0,0,2
S01007351,Bad health,34,2,0,2,8,1,8,3,7,2,3,3,0,0
S01007351,Very bad health,6,0,0,0,0,0,2,0,1,3,0,0,0,0
S01007352,All people aged 16 to 74,411,42,14,28,98,43,104,25,48,29,13,7,6,9
S01007352,Very good health,202,27,8,19,49,16,54,9,19,10,9,5,4,9
S01007352,Good health,133,13,6,7,36,16,28,11,19,8,2,0,2,0
S01007352,Fair health,50,2,0,2,10,4,18,1,8,7,0,0,0,0
S01007352,Bad health,19,0,0,0,3,3,4,2,2,4,1,1,0,0
S01007352,Very bad health,7,0,0,0,0,4,0,2,0,0,1,1,0,0
S01007353,All people aged 16 to 74,475,43,9,34,127,59,71,37,61,46,11,5,6,20
S01007353,Very good health,242,23,4,19,70,30,33,19,25,19,6,3,3,17
S01007353,Good health,159,16,4,12,43,20,27,9,21,16,5,2,3,2
S01007353,Fair health,59,3,1,2,10,8,9,8,11,9,0,0,0,1
S01007353,Bad health,11,1,0,1,2,1,2,0,3,2,0,0,0,0
S01007353,Very bad health,4,0,0,0,2,0,0,1,1,0,0,0,0,0
S01007354,All people aged 16 to 74,583,46,14,32,157,88,83,34,71,57,19,11,8,28
S01007354,Very good health,291,29,9,20,75,46,35,18,32,26,6,4,2,24
S01007354,Good health,165,13,1,12,45,24,23,6,27,16,7,4,3,4
S01007354,Fair health,91,3,3,0,30,11,21,6,8,9,3,1,2,0
S01007354,Bad health,27,1,1,0,7,4,4,3,1,4,3,2,1,0
S01007354,Very bad health,9,0,0,0,0,3,0,1,3,2,0,0,0,0
S01007355,All people aged 16 to 74,734,76,17,59,197,58,134,58,99,70,22,14,8,20
S01007355,Very good health,312,43,11,32,86,24,53,23,34,28,8,7,1,13
S01007355,Good health,266,23,2,21,70,21,59,20,38,22,6,3,3,7
S01007355,Fair health,112,6,2,4,32,10,15,11,18,14,6,2,4,0
S01007355,Bad health,34,3,2,1,7,3,6,3,5,6,1,1,0,0
S01007355,Very bad health,10,1,0,1,2,0,1,1,4,0,1,1,0,0
S01007356,All people aged 16 to 74,552,61,18,43,143,62,68,35,85,53,22,10,12,23
S01007356,Very good health,227,23,5,18,64,25,29,13,34,12,10,2,8,17
S01007356,Good health,193,26,9,17,48,22,24,12,28,23,5,3,2,5
S01007356,Fair health,88,9,3,6,25,10,10,6,15,10,2,1,1,1
S01007356,Bad health,35,1,0,1,6,2,4,3,6,8,5,4,1,0
S01007356,Very bad health,9,2,1,1,0,3,1,1,2,0,0,0,0,0
S01007357,All people aged 16 to 74,573,52,15,37,136,48,107,42,101,60,10,6,4,17
S01007357,Very good health,251,22,4,18,63,20,41,19,39,29,6,3,3,12
S01007357,Good health,229,23,8,15,57,19,46,17,38,22,3,2,1,4
S01007357,Fair health,64,7,3,4,11,8,12,3,17,5,0,0,0,1
S01007357,Bad health,19,0,0,0,3,1,4,1,6,4,0,0,0,0
S01007357,Very bad health,10,0,0,0,2,0,4,2,1,0,1,1,0,0
S01007358,All people aged 16 to 74,712,47,13,34,180,71,104,82,107,91,18,12,6,12
S01007358,Very good health,350,24,8,16,97,40,39,29,50,53,10,5,5,8
S01007358,Good health,254,18,5,13,62,23,48,40,38,21,2,1,1,2
S01007358,Fair health,73,3,0,3,17,4,12,7,13,13,2,2,0,2
S01007358,Bad health,30,2,0,2,3,4,5,5,4,4,3,3,0,0
S01007358,Very bad health,5,0,0,0,1,0,0,1,2,0,1,1,0,0
S01007359,All people aged 16 to 74,584,24,9,15,110,65,61,49,124,83,28,14,14,40
S01007359,Very good health,225,14,2,12,41,28,19,22,40,27,9,4,5,25
S01007359,Good health,211,6,4,2,45,22,19,15,55,28,10,3,7,11
S01007359,Fair health,95,3,2,1,18,10,12,6,18,19,7,5,2,2
S01007359,Bad health,37,1,1,0,3,4,7,4,9,6,1,1,0,2
S01007359,Very bad health,16,0,0,0,3,1,4,2,2,3,1,1,0,0
S01007360,All people aged 16 to 74,424,27,7,20,123,56,49,35,59,40,7,3,4,28
S01007360,Very good health,189,10,2,8,57,23,26,11,22,15,5,3,2,20
S01007360,Good health,149,10,2,8,49,20,17,13,18,13,2,0,2,7
S01007360,Fair health,55,4,2,2,13,12,3,6,11,6,0,0,0,0
S01007360,Bad health,24,2,1,1,3,1,1,4,8,5,0,0,0,0
S01007360,Very bad health,7,1,0,1,1,0,2,1,0,1,0,0,0,1
S01007361,All people aged 16 to 74,733,60,15,45,171,101,105,59,103,66,21,8,13,47
S01007361,Very good health,358,33,9,24,70,58,46,30,52,23,8,1,7,38
S01007361,Good health,247,23,4,19,69,28,40,16,33,25,5,3,2,8
S01007361,Fair health,97,3,1,2,24,13,15,9,10,14,8,4,4,1
S01007361,Bad health,20,1,1,0,7,2,1,2,4,3,0,0,0,0
S01007361,Very bad health,11,0,0,0,1,0,3,2,4,1,0,0,0,0
S01007362,All people aged 16 to 74,526,33,6,27,125,81,52,30,93,61,16,10,6,35
S01007362,Very good health,254,12,1,11,70,37,26,13,43,22,6,4,2,25
S01007362,Good health,182,18,4,14,32,31,19,13,31,22,6,4,2,10
S01007362,Fair health,63,3,1,2,13,7,6,3,17,12,2,1,1,0
S01007362,Bad health,20,0,0,0,8,4,1,1,0,4,2,1,1,0
S01007362,Very bad health,7,0,0,0,2,2,0,0,2,1,0,0,0,0
S01007363,All people aged 16 to 74,497,33,6,27,115,69,50,40,84,65,23,9,14,18
S01007363,Very good health,213,17,1,16,54,27,20,18,34,23,8,1,7,12
S01007363,Good health,171,12,4,8,40,31,19,12,30,17,5,1,4,5
S01007363,Fair health,79,3,1,2,15,7,6,6,13,21,7,4,3,1
S01007363,Bad health,24,1,0,1,5,4,4,1,4,3,2,2,0,0
S01007363,Very bad health,10,0,0,0,1,0,1,3,3,1,1,1,0,0
S01007364,All people aged 16 to 74,633,9,1,8,71,69,34,52,164,123,47,24,23,64
S01007364,Very good health,243,2,0,2,30,28,15,21,53,39,11,6,5,44
S01007364,Good health,226,3,0,3,25,26,10,12,55,52,25,13,12,18
S01007364,Fair health,99,3,0,3,11,8,7,13,27,20,8,3,5,2
S01007364,Bad health,52,1,1,0,5,6,2,4,23,8,3,2,1,0
S01007364,Very bad health,13,0,0,0,0,1,0,2,6,4,0,0,0,0
S01007365,All people aged 16 to 74,327,18,2,16,59,34,30,32,59,57,22,13,9,16
S01007365,Very good health,161,8,1,7,36,22,12,16,23,20,10,4,6,14
S01007365,Good health,109,7,1,6,19,9,11,12,19,24,6,3,3,2
S01007365,Fair health,38,2,0,2,4,1,7,3,10,9,2,2,0,0
S01007365,Bad health,17,1,0,1,0,2,0,1,5,4,4,4,0,0
S01007365,Very bad health,2,0,0,0,0,0,0,0,2,0,0,0,0,0
S01007366,All people aged 16 to 74,328,9,1,8,45,26,21,40,58,73,36,26,10,20
S01007366,Very good health,115,4,1,3,21,9,6,11,18,21,10,5,5,15
S01007366,Good health,100,4,0,4,15,8,6,14,12,23,13,9,4,5
S01007366,Fair health,68,1,0,1,7,8,8,9,14,18,3,2,1,0
S01007366,Bad health,31,0,0,0,1,1,1,4,9,8,7,7,0,0
S01007366,Very bad health,14,0,0,0,1,0,0,2,5,3,3,3,0,0
S01007367,All people aged 16 to 74,420,18,4,14,71,49,56,38,84,62,25,12,13,17
S01007367,Very good health,155,6,2,4,29,22,16,14,32,23,4,0,4,9
S01007367,Good health,156,8,2,6,23,17,26,14,32,25,5,2,3,6
S01007367,Fair health,76,2,0,2,12,8,9,7,14,10,12,6,6,2
S01007367,Bad health,19,1,0,1,4,1,3,1,4,3,2,2,0,0
S01007367,Very bad health,14,1,0,1,3,1,2,2,2,1,2,2,0,0
S01007368,All people aged 16 to 74,376,8,3,5,56,49,27,39,59,69,32,14,18,37
S01007368,Very good health,162,3,1,2,25,18,9,16,30,25,11,5,6,25
S01007368,Good health,120,4,2,2,12,15,14,12,15,24,16,7,9,8
S01007368,Fair health,56,0,0,0,10,12,4,5,7,11,4,2,2,3
S01007368,Bad health,31,1,0,1,7,4,0,4,6,7,1,0,1,1
S01007368,Very bad health,7,0,0,0,2,0,0,2,1,2,0,0,0,0
S01007369,All people aged 16 to 74,588,17,4,13,121,89,52,51,121,89,22,11,11,26
S01007369,Very good health,278,10,4,6,70,41,27,22,49,32,8,5,3,19
S01007369,Good health,188,2,0,2,30,33,17,17,46,28,10,2,8,5
S01007369,Fair health,80,4,0,4,13,12,7,6,16,17,3,3,0,2
S01007369,Bad health,35,1,0,1,7,3,1,4,9,9,1,1,0,0
S01007369,Very bad health,7,0,0,0,1,0,0,2,1,3,0,0,0,0
S01007370,All people aged 16 to 74,588,38,4,34,114,69,56,70,93,80,29,17,12,39
S01007370,Very good health,262,21,2,19,54,28,19,28,42,29,8,5,3,33
S01007370,Good health,196,9,0,9,35,26,25,24,34,30,8,4,4,5
S01007370,Fair health,96,7,2,5,20,10,11,14,14,12,7,3,4,1
S01007370,Bad health,26,1,0,1,2,5,0,4,2,6,6,5,1,0
S01007370,Very bad health,8,0,0,0,3,0,1,0,1,3,0,0,0,0
S01007371,All people aged 16 to 74,508,20,6,14,112,75,53,42,93,62,21,10,11,30
S01007371,Very good health,253,12,3,9,55,44,17,24,45,26,11,6,5,19
S01007371,Good health,158,5,2,3,36,18,25,12,29,21,5,2,3,7
S01007371,Fair health,60,1,0,1,15,9,6,3,12,9,4,1,3,1
S01007371,Bad health,28,1,1,0,4,3,5,2,6,4,0,0,0,3
S01007371,Very bad health,9,1,0,1,2,1,0,1,1,2,1,1,0,0
S01007372,All people aged 16 to 74,608,43,12,31,148,81,65,52,96,73,16,7,9,34
S01007372,Very good health,259,19,6,13,65,28,21,19,39,37,5,2,3,26
S01007372,Good health,236,16,4,12,56,36,33,19,37,23,9,5,4,7
S01007372,Fair health,83,7,1,6,20,16,8,8,12,9,2,0,2,1
S01007372,Bad health,23,1,1,0,6,1,2,5,7,1,0,0,0,0
S01007372,Very bad health,7,0,0,0,1,0,1,1,1,3,0,0,0,0
S01007373,All people aged 16 to 74,473,50,13,37,125,63,76,43,38,35,15,11,4,28
S01007373,Very good health,229,32,9,23,58,28,33,14,16,18,6,5,1,24
S01007373,Good health,147,14,3,11,38,21,27,14,14,11,5,4,1,3
S01007373,Fair health,66,2,1,1,23,11,8,11,4,4,3,2,1,0
S01007373,Bad health,24,1,0,1,6,2,5,3,3,2,1,0,1,1
S01007373,Very bad health,7,1,0,1,0,1,3,1,1,0,0,0,0,0
S01007374,All people aged 16 to 74,408,36,10,26,108,54,49,37,50,41,10,4,6,23
S01007374,Very good health,203,21,3,18,58,32,21,14,18,17,2,1,1,20
S01007374,Good health,151,12,5,7,36,18,21,15,23,17,6,2,4,3
S01007374,Fair health,37,2,1,1,13,2,5,6,4,3,2,1,1,0
S01007374,Bad health,11,0,0,0,1,0,2,0,4,4,0,0,0,0
S01007374,Very bad health,6,1,1,0,0,2,0,2,1,0,0,0,0,0
S01007375,All people aged 16 to 74,354,58,21,37,85,40,48,25,40,25,12,6,6,21
S01007375,Very good health,174,33,10,23,35,17,27,11,21,12,3,2,1,15
S01007375,Good health,126,19,8,11,37,16,15,9,13,9,3,0,3,5
S01007375,Fair health,42,5,3,2,11,7,3,2,6,4,3,2,1,1
S01007375,Bad health,8,0,0,0,2,0,2,2,0,0,2,1,1,0
S01007375,Very bad health,4,1,0,1,0,0,1,1,0,0,1,1,0,0
S01007376,All people aged 16 to 74,631,19,4,15,106,79,39,64,124,98,56,31,25,46
S01007376,Very good health,270,12,1,11,39,40,11,23,48,34,24,15,9,39
S01007376,Good health,225,4,1,3,49,28,14,25,46,36,17,5,12,6
S01007376,Fair health,86,2,1,1,14,6,7,9,20,16,11,7,4,1
S01007376,Bad health,37,0,0,0,1,5,4,7,9,9,2,2,0,0
S01007376,Very bad health,13,1,1,0,3,0,3,0,1,3,2,2,0,0
S01007377,All people aged 16 to 74,507,63,15,48,146,75,54,37,65,29,13,8,5,25
S01007377,Very good health,244,31,7,24,65,32,28,19,31,10,6,4,2,22
S01007377,Good health,184,25,5,20,52,34,17,13,22,12,6,4,2,3
S01007377,Fair health,52,6,3,3,19,5,6,3,8,4,1,0,1,0
S01007377,Bad health,23,1,0,1,7,4,3,2,4,2,0,0,0,0
S01007377,Very bad health,4,0,0,0,3,0,0,0,0,1,0,0,0,0
S01007378,All people aged 16 to 74,1330,110,62,48,334,686,46,29,53,31,13,10,3,28
S01007378,Very good health,893,78,46,32,217,502,17,16,25,13,5,4,1,20
S01007378,Good health,361,28,14,14,99,172,16,10,17,8,3,1,2,8
S01007378,Fair health,56,4,2,2,15,11,7,1,8,5,5,5,0,0
S01007378,Bad health,14,0,0,0,2,1,2,2,2,5,0,0,0,0
S01007378,Very bad health,6,0,0,0,1,0,4,0,1,0,0,0,0,0
S01007379,All people aged 16 to 74,338,8,3,5,49,34,17,46,70,73,24,8,16,17
S01007379,Very good health,141,4,1,3,25,10,8,22,33,21,5,3,2,13
S01007379,Good health,129,2,1,1,19,16,4,15,22,33,14,3,11,4
S01007379,Fair health,53,2,1,1,4,8,4,7,11,13,4,1,3,0
S01007379,Bad health,13,0,0,0,1,0,1,2,3,5,1,1,0,0
S01007379,Very bad health,2,0,0,0,0,0,0,0,1,1,0,0,0,0
S01007380,All people aged 16 to 74,425,27,10,17,85,57,26,44,74,69,18,10,8,25
S01007380,Very good health,210,13,5,8,49,29,11,21,26,34,7,3,4,20
S01007380,Good health,133,10,4,6,24,23,10,13,30,16,3,2,1,4
S01007380,Fair health,62,3,1,2,8,4,4,8,11,16,7,4,3,1
S01007380,Bad health,14,0,0,0,1,1,0,2,7,2,1,1,0,0
S01007380,Very bad health,6,1,0,1,3,0,1,0,0,1,0,0,0,0
S01007381,All people aged 16 to 74,343,82,32,50,94,45,32,9,31,20,9,6,3,21
S01007381,Very good health,222,61,23,38,62,29,18,6,13,11,4,2,2,18
S01007381,Good health,92,18,8,10,22,14,10,3,12,7,3,2,1,3
S01007381,Fair health,21,2,1,1,6,2,2,0,6,2,1,1,0,0
S01007381,Bad health,8,1,0,1,4,0,2,0,0,0,1,1,0,0
S01007381,Very bad health,0,0,0,0,0,0,0,0,0,0,0,0,0,0
S01007382,All people aged 16 to 74,494,72,22,50,145,75,44,25,49,37,11,5,6,36
S01007382,Very good health,263,45,13,32,83,31,23,16,15,17,5,1,4,28
S01007382,Good health,167,24,7,17,46,31,18,5,21,13,1,0,1,8
S01007382,Fair health,46,3,2,1,16,7,1,4,8,4,3,2,1,0
S01007382,Bad health,13,0,0,0,0,2,1,0,5,3,2,2,0,0
S01007382,Very bad health,5,0,0,0,0,4,1,0,0,0,0,0,0,0
S01007383,All people aged 16 to 74,571,89,23,66,169,69,49,42,75,40,13,9,4,25
S01007383,Very good health,284,47,8,39,87,29,26,24,36,14,2,1,1,19
S01007383,Good health,208,38,14,24,66,28,19,11,22,14,5,2,3,5
S01007383,Fair health,57,1,0,1,13,8,2,5,14,9,4,4,0,1
S01007383,Bad health,16,1,0,1,3,2,2,2,2,2,2,2,0,0
S01007383,Very bad health,6,2,1,1,0,2,0,0,1,1,0,0,0,0
S01007384,All people aged 16 to 74,557,79,39,40,152,91,27,31,79,47,14,6,8,37
S01007384,Very good health,319,58,30,28,95,56,15,15,37,14,1,1,0,28
S01007384,Good health,181,16,8,8,51,22,8,12,33,20,10,3,7,9
S01007384,Fair health,45,4,1,3,5,11,4,3,7,8,3,2,1,0
S01007384,Bad health,8,0,0,0,1,1,0,1,2,3,0,0,0,0
S01007384,Very bad health,4,1,0,1,0,1,0,0,0,2,0,0,0,0
S01007385,All people aged 16 to 74,611,63,16,47,163,93,55,38,76,61,11,4,7,51
S01007385,Very good health,295,33,10,23,82,41,19,17,30,28,3,1,2,42
S01007385,Good health,227,25,5,20,57,35,27,14,34,21,6,1,5,8
S01007385,Fair health,58,4,1,3,15,11,4,5,8,9,2,2,0,0
S01007385,Bad health,25,1,0,1,7,6,4,2,3,2,0,0,0,0
S01007385,Very bad health,6,0,0,0,2,0,1,0,1,1,0,0,0,1
S01007386,All people aged 16 to 74,599,131,27,104,190,67,53,28,59,12,12,7,5,47
S01007386,Very good health,353,80,17,63,111,30,29,16,32,8,4,3,1,43
S01007386,Good health,182,40,8,32,57,30,16,9,21,2,5,3,2,2
S01007386,Fair health,47,11,2,9,18,5,5,2,5,1,0,0,0,0
S01007386,Bad health,12,0,0,0,3,0,2,1,1,1,2,0,2,2
S01007386,Very bad health,5,0,0,0,1,2,1,0,0,0,1,1,0,0
S01007387,All people aged 16 to 74,600,131,31,100,195,65,52,29,49,24,9,5,4,46
S01007387,Very good health,333,78,18,60,103,36,29,16,23,7,2,2,0,39
S01007387,Good health,211,46,12,34,74,19,17,8,25,12,5,2,3,5
S01007387,Fair health,44,6,1,5,15,8,4,4,1,2,2,1,1,2
S01007387,Bad health,9,0,0,0,1,2,2,1,0,3,0,0,0,0
S01007387,Very bad health,3,1,0,1,2,0,0,0,0,0,0,0,0,0
S01007388,All people aged 16 to 74,530,71,25,46,164,102,36,17,52,24,18,9,9,46
S01007388,Very good health,317,43,14,29,96,56,19,8,33,16,9,5,4,37
S01007388,Good health,149,22,6,16,51,29,14,7,9,3,7,2,5,7
S01007388,Fair health,49,4,4,0,13,14,3,2,5,5,1,1,0,2
S01007388,Bad health,13,2,1,1,3,3,0,0,5,0,0,0,0,0
S01007388,Very bad health,2,0,0,0,1,0,0,0,0,0,1,1,0,0
S01007389,All people aged 16 to 74,383,12,2,10,109,55,14,35,78,30,17,9,8,33
S01007389,Very good health,235,9,1,8,61,36,7,20,52,18,7,6,1,25
S01007389,Good health,109,3,1,2,42,13,4,11,13,7,8,2,6,8
S01007389,Fair health,29,0,0,0,6,4,3,3,8,3,2,1,1,0
S01007389,Bad health,7,0,0,0,0,1,0,0,4,2,0,0,0,0
S01007389,Very bad health,3,0,0,0,0,1,0,1,1,0,0,0,0,0
S01007390,All people aged 16 to 74,362,13,3,10,87,78,25,24,57,41,12,8,4,25
S01007390,Very good health,198,8,3,5,64,38,16,10,27,13,2,1,1,20
S01007390,Good health,120,2,0,2,20,34,7,9,21,18,7,4,3,2
S01007390,Fair health,30,2,0,2,1,3,2,5,7,6,1,1,0,3
S01007390,Bad health,11,1,0,1,2,2,0,0,2,2,2,2,0,0
S01007390,Very bad health,3,0,0,0,0,1,0,0,0,2,0,0,0,0
S01007391,All people aged 16 to 74,444,51,15,36,147,73,33,30,46,24,9,6,3,31
S01007391,Very good health,272,34,8,26,96,41,17,15,25,13,5,4,1,26
S01007391,Good health,136,11,4,7,45,25,13,12,15,8,2,1,1,5
S01007391,Fair health,30,4,3,1,4,7,3,3,5,2,2,1,1,0
S01007391,Bad health,5,2,0,2,2,0,0,0,1,0,0,0,0,0
S01007391,Very bad health,1,0,0,0,0,0,0,0,0,1,0,0,0,0
S01007392,All people aged 16 to 74,345,63,17,46,101,50,31,21,30,22,9,4,5,18
S01007392,Very good health,194,34,10,24,62,21,14,15,12,14,6,2,4,16
S01007392,Good health,105,22,6,16,28,18,13,4,11,6,1,0,1,2
S01007392,Fair health,35,6,1,5,10,7,3,2,6,1,0,0,0,0
S01007392,Bad health,9,1,0,1,1,4,0,0,1,1,1,1,0,0
S01007392,Very bad health,2,0,0,0,0,0,1,0,0,0,1,1,0,0
S01007393,All people aged 16 to 74,485,94,21,73,131,64,40,19,40,26,8,6,2,63
S01007393,Very good health,291,66,18,48,67,33,25,8,20,14,5,4,1,53
S01007393,Good health,138,23,2,21,39,26,11,7,14,7,1,0,1,10
S01007393,Fair health,47,5,1,4,20,4,4,4,5,4,1,1,0,0
S01007393,Bad health,8,0,0,0,5,1,0,0,1,1,0,0,0,0
S01007393,Very bad health,1,0,0,0,0,0,0,0,0,0,1,1,0,0
S01007394,All people aged 16 to 74,429,70,22,48,140,62,33,23,43,18,17,8,9,23
S01007394,Very good health,224,40,13,27,77,30,14,8,19,10,6,3,3,20
S01007394,Good health,135,17,5,12,40,21,12,11,20,4,7,2,5,3
S01007394,Fair health,51,10,2,8,19,8,5,2,1,3,3,2,1,0
S01007394,Bad health,16,2,1,1,4,3,1,1,3,1,1,1,0,0
S01007394,Very bad health,3,1,1,0,0,0,1,1,0,0,0,0,0,0
S01007395,All people aged 16 to 74,610,33,8,25,129,89,59,63,115,70,28,16,12,24
S01007395,Very good health,260,16,5,11,67,41,24,31,43,21,4,2,2,13
S01007395,Good health,238,13,2,11,41,32,24,24,49,29,15,8,7,11
S01007395,Fair health,79,3,1,2,14,12,9,6,15,13,7,4,3,0
S01007395,Bad health,25,1,0,1,7,3,2,0,6,4,2,2,0,0
S01007395,Very bad health,8,0,0,0,0,1,0,2,2,3,0,0,0,0
S01007396,All people aged 16 to 74,614,44,10,34,137,76,48,58,108,82,30,20,10,31
S01007396,Very good health,267,21,6,15,71,30,18,22,46,36,7,5,2,16
S01007396,Good health,224,18,2,16,46,29,21,28,35,26,10,3,7,11
S01007396,Fair health,82,5,2,3,14,12,7,4,18,9,9,8,1,4
S01007396,Bad health,28,0,0,0,5,3,2,2,4,8,4,4,0,0
S01007396,Very bad health,13,0,0,0,1,2,0,2,5,3,0,0,0,0
S01007397,All people aged 16 to 74,698,98,22,76,207,96,53,49,73,49,18,10,8,55
S01007397,Very good health,382,66,11,55,113,52,25,26,34,19,7,4,3,40
S01007397,Good health,217,22,10,12,67,28,21,15,25,20,7,2,5,12
S01007397,Fair health,77,9,1,8,22,13,6,6,10,7,3,3,0,1
S01007397,Bad health,21,0,0,0,5,3,1,2,4,3,1,1,0,2
S01007397,Very bad health,1,1,0,1,0,0,0,0,0,0,0,0,0,0
S01007398,All people aged 16 to 74,492,9,3,6,50,42,30,56,108,125,41,25,16,31
S01007398,Very good health,210,6,1,5,24,23,14,26,36,46,17,12,5,18
S01007398,Good health,173,2,1,1,17,13,5,16,51,42,18,7,11,9
S01007398,Fair health,65,1,1,0,5,4,7,7,16,22,0,0,0,3
S01007398,Bad health,37,0,0,0,4,1,4,6,5,12,4,4,0,1
S01007398,Very bad health,7,0,0,0,0,1,0,1,0,3,2,2,0,0
S01007399,All people aged 16 to 74,485,24,5,19,73,34,33,44,81,100,70,39,31,26
S01007399,Very good health,171,9,1,8,39,13,8,11,24,33,21,11,10,13
S01007399,Good health,156,10,1,9,21,8,13,13,34,30,18,8,10,9
S01007399,Fair health,109,5,3,2,11,7,7,13,15,26,21,10,11,4
S01007399,Bad health,39,0,0,0,1,3,5,7,6,8,9,9,0,0
S01007399,Very bad health,10,0,0,0,1,3,0,0,2,3,1,1,0,0
S01007400,All people aged 16 to 74,522,50,13,37,129,75,40,29,90,49,19,8,11,41
S01007400,Very good health,258,28,9,19,77,29,16,15,35,16,8,3,5,34
S01007400,Good health,179,18,2,16,33,35,14,11,39,17,6,1,5,6
S01007400,Fair health,62,3,2,1,13,9,8,3,12,10,4,4,0,0
S01007400,Bad health,21,1,0,1,6,2,2,0,3,5,1,0,1,1
S01007400,Very bad health,2,0,0,0,0,0,0,0,1,1,0,0,0,0
S01007401,All people aged 16 to 74,514,35,7,28,148,86,34,39,78,32,20,14,6,42
S01007401,Very good health,282,22,3,19,87,46,14,21,34,14,9,7,2,35
S01007401,Good health,163,11,3,8,41,28,16,15,28,13,6,3,3,5
S01007401,Fair health,50,1,0,1,17,9,2,1,12,2,4,3,1,2
S01007401,Bad health,16,1,1,0,2,3,1,2,4,3,0,0,0,0
S01007401,Very bad health,3,0,0,0,1,0,1,0,0,0,1,1,0,0
S01007402,All people aged 16 to 74,458,41,11,30,125,78,36,38,65,28,7,7,0,40
S01007402,Very good health,235,19,4,15,62,42,16,17,36,9,1,1,0,33
S01007402,Good health,165,16,6,10,48,28,17,13,23,12,3,3,0,5
S01007402,Fair health,37,5,1,4,9,6,3,4,4,4,0,0,0,2
S01007402,Bad health,18,1,0,1,4,2,0,3,2,3,3,3,0,0
S01007402,Very bad health,3,0,0,0,2,0,0,1,0,0,0,0,0,0
S01007403,All people aged 16 to 74,534,27,10,17,212,77,25,28,74,36,15,4,11,40
S01007403,Very good health,329,17,5,12,139,50,10,15,47,16,5,1,4,30
S01007403,Good health,174,9,5,4,67,23,13,10,23,15,5,1,4,9
S01007403,Fair health,22,1,0,1,3,4,1,2,4,3,4,1,3,0
S01007403,Bad health,8,0,0,0,3,0,1,0,0,2,1,1,0,1
S01007403,Very bad health,1,0,0,0,0,0,0,1,0,0,0,0,0,0
S01007404,All people aged 16 to 74,326,38,8,30,71,29,72,35,28,28,8,5,3,17
S01007404,Very good health,166,26,6,20,39,13,38,13,14,11,0,0,0,12
S01007404,Good health,114,8,1,7,27,11,28,13,9,10,3,3,0,5
S01007404,Fair health,30,2,0,2,4,3,3,5,3,7,3,0,3,0
S01007404,Bad health,11,2,1,1,0,1,3,3,1,0,1,1,0,0
S01007404,Very bad health,5,0,0,0,1,1,0,1,1,0,1,1,0,0
S01007405,All people aged 16 to 74,505,92,22,70,170,63,64,17,39,21,11,7,4,28
S01007405,Very good health,296,58,14,44,105,34,35,8,20,13,0,0,0,23
S01007405,Good health,165,29,8,21,56,25,22,7,11,5,6,3,3,4
S01007405,Fair health,23,2,0,2,6,2,2,2,4,2,3,3,0,0
S01007405,Bad health,15,3,0,3,3,2,4,0,1,0,1,1,0,1
S01007405,Very bad health,6,0,0,0,0,0,1,0,3,1,1,0,1,0
S01007406,All people aged 16 to 74,458,79,20,59,146,70,45,19,36,22,13,6,7,28
S01007406,Very good health,279,45,12,33,87,47,23,12,22,13,6,2,4,24
S01007406,Good health,127,24,6,18,45,13,13,6,10,8,4,2,2,4
S01007406,Fair health,33,3,1,2,10,7,7,0,2,1,3,2,1,0
S01007406,Bad health,12,4,0,4,2,2,2,1,1,0,0,0,0,0
S01007406,Very bad health,7,3,1,2,2,1,0,0,1,0,0,0,0,0
S01007407,All people aged 16 to 74,516,76,22,54,143,89,49,29,40,37,11,6,5,42
S01007407,Very good health,286,45,15,30,83,47,20,16,23,15,5,2,3,32
S01007407,Good health,170,20,5,15,42,30,24,9,15,18,4,3,1,8
S01007407,Fair health,47,9,2,7,17,9,3,2,1,2,2,1,1,2
S01007407,Bad health,8,2,0,2,0,3,0,1,1,1,0,0,0,0
S01007407,Very bad health,5,0,0,0,1,0,2,1,0,1,0,0,0,0
S01007408,All people aged 16 to 74,443,34,8,26,92,68,40,47,63,50,24,11,13,25
S01007408,Very good health,217,17,5,12,49,35,11,27,36,17,5,2,3,20
S01007408,Good health,149,15,3,12,30,23,17,14,16,18,12,5,7,4
S01007408,Fair health,47,1,0,1,10,6,5,1,6,11,6,3,3,1
S01007408,Bad health,24,1,0,1,2,4,5,4,5,2,1,1,0,0
S01007408,Very bad health,6,0,0,0,1,0,2,1,0,2,0,0,0,0
S01007409,All people aged 16 to 74,534,32,6,26,107,85,37,63,88,75,16,13,3,31
S01007409,Very good health,260,14,2,12,51,43,17,23,37,43,5,3,2,27
S01007409,Good health,175,15,3,12,32,29,14,25,33,16,8,7,1,3
S01007409,Fair health,75,2,1,1,18,12,5,10,14,11,2,2,0,1
S01007409,Bad health,20,1,0,1,6,1,1,3,3,4,1,1,0,0
S01007409,Very bad health,4,0,0,0,0,0,0,2,1,1,0,0,0,0
S01007410,All people aged 16 to 74,502,7,3,4,37,46,18,63,110,140,45,28,17,36
S01007410,Very good health,184,4,1,3,18,19,8,24,32,40,12,6,6,27
S01007410,Good health,167,1,1,0,14,17,7,20,38,44,17,9,8,9
S01007410,Fair health,87,2,1,1,3,5,2,8,27,27,13,10,3,0
S01007410,Bad health,54,0,0,0,2,4,1,10,10,24,3,3,0,0
S01007410,Very bad health,10,0,0,0,0,1,0,1,3,5,0,0,0,0
S01007411,All people aged 16 to 74,639,18,7,11,78,74,38,64,122,146,60,39,21,39
S01007411,Very good health,231,8,3,5,45,32,7,25,31,41,15,9,6,27
S01007411,Good health,234,6,3,3,18,27,24,23,48,56,21,10,11,11
S01007411,Fair health,105,2,1,1,12,7,5,7,24,33,14,11,3,1
S01007411,Bad health,57,1,0,1,2,8,2,8,17,13,6,5,1,0
S01007411,Very bad health,12,1,0,1,1,0,0,1,2,3,4,4,0,0
S01007412,All people aged 16 to 74,348,11,1,10,49,44,16,38,71,79,21,12,9,19
S01007412,Very good health,148,5,0,5,27,18,7,16,29,28,7,4,3,11
S01007412,Good health,134,4,1,3,17,18,4,13,29,34,8,4,4,7
S01007412,Fair health,48,2,0,2,4,4,4,6,10,12,5,3,2,1
S01007412,Bad health,15,0,0,0,1,3,0,2,3,5,1,1,0,0
S01007412,Very bad health,3,0,0,0,0,1,1,1,0,0,0,0,0,0
S01007413,All people aged 16 to 74,704,53,11,42,165,111,47,79,107,71,20,8,12,51
S01007413,Very good health,381,33,5,28,90,67,30,41,47,32,8,2,6,33
S01007413,Good health,242,12,2,10,62,37,15,29,43,24,7,3,4,13
S01007413,Fair health,55,6,3,3,6,6,2,5,10,12,5,3,2,3
S01007413,Bad health,21,2,1,1,6,0,0,3,7,2,0,0,0,1
S01007413,Very bad health,5,0,0,0,1,1,0,1,0,1,0,0,0,1
S01007414,All people aged 16 to 74,512,77,23,54,151,70,33,42,56,34,13,7,6,36
S01007414,Very good health,288,39,12,27,91,44,17,22,24,17,3,2,1,31
S01007414,Good health,165,30,7,23,46,23,10,15,20,10,6,2,4,5
S01007414,Fair health,44,7,4,3,11,2,4,3,8,6,3,2,1,0
S01007414,Bad health,12,1,0,1,2,1,2,2,2,1,1,1,0,0
S01007414,Very bad health,3,0,0,0,1,0,0,0,2,0,0,0,0,0
S01007415,All people aged 16 to 74,634,16,3,13,82,61,31,67,128,175,38,16,22,36
S01007415,Very good health,234,6,0,6,37,27,14,21,40,51,14,5,9,24
S01007415,Good health,229,6,2,4,28,24,10,25,50,68,7,3,4,11
S01007415,Fair health,115,2,0,2,12,9,6,17,25,34,10,3,7,0
S01007415,Bad health,43,2,1,1,4,1,1,1,9,20,4,2,2,1
S01007415,Very bad health,13,0,0,0,1,0,0,3,4,2,3,3,0,0
S01007416,All people aged 16 to 74,411,7,2,5,36,31,16,34,90,113,49,27,22,35
S01007416,Very good health,143,2,1,1,16,14,1,10,30,32,15,8,7,23
S01007416,Good health,165,2,0,2,10,13,12,14,38,44,21,9,12,11
S01007416,Fair health,63,2,1,1,5,4,3,8,13,16,11,8,3,1
S01007416,Bad health,34,1,0,1,4,0,0,1,9,18,1,1,0,0
S01007416,Very bad health,6,0,0,0,1,0,0,1,0,3,1,1,0,0
S01007417,All people aged 16 to 74,767,93,21,72,222,140,43,66,84,53,24,13,11,42
S01007417,Very good health,425,52,10,42,131,75,27,37,45,22,6,4,2,30
S01007417,Good health,247,33,8,25,72,49,10,20,20,21,13,7,6,9
S01007417,Fair health,75,6,2,4,15,15,5,6,17,6,2,0,2,3
S01007417,Bad health,15,1,0,1,4,1,0,2,2,3,2,1,1,0
S01007417,Very bad health,5,1,1,0,0,0,1,1,0,1,1,1,0,0
S01007418,All people aged 16 to 74,500,14,1,13,62,51,20,47,114,122,36,20,16,34
S01007418,Very good health,207,8,1,7,38,28,9,17,42,34,12,9,3,19
S01007418,Good health,174,6,0,6,17,16,6,21,41,43,14,4,10,10
S01007418,Fair health,77,0,0,0,4,7,3,4,21,26,8,6,2,4
S01007418,Bad health,32,0,0,0,2,0,2,5,8,13,2,1,1,0
S01007418,Very bad health,10,0,0,0,1,0,0,0,2,6,0,0,0,1
S01007419,All people aged 16 to 74,632,11,4,7,61,74,30,49,132,153,70,41,29,52
S01007419,Very good health,245,6,1,5,29,32,8,14,53,42,27,16,11,34
S01007419,Good health,236,4,2,2,22,27,10,25,53,59,22,11,11,14
S01007419,Fair health,106,1,1,0,7,12,8,5,20,36,14,8,6,3
S01007419,Bad health,42,0,0,0,2,3,4,5,5,16,6,5,1,1
S01007419,Very bad health,3,0,0,0,1,0,0,0,1,0,1,1,0,0
S01007420,All people aged 16 to 74,1259,69,18,51,198,121,111,139,147,240,180,166,14,54
S01007420,Very good health,600,47,11,36,110,67,55,63,64,88,69,64,5,37
S01007420,Good health,412,18,7,11,55,45,27,53,46,91,65,58,7,12
S01007420,Fair health,183,4,0,4,21,7,23,16,29,46,34,33,1,3
S01007420,Bad health,50,0,0,0,10,2,4,6,5,11,10,9,1,2
S01007420,Very bad health,14,0,0,0,2,0,2,1,3,4,2,2,0,0
S01007421,All people aged 16 to 74,498,69,8,61,117,57,42,30,71,64,23,16,7,25
S01007421,Very good health,276,48,4,44,68,34,29,18,30,22,10,5,5,17
S01007421,Good health,155,20,4,16,38,14,9,8,29,24,7,5,2,6
S01007421,Fair health,47,1,0,1,9,8,3,2,4,13,5,5,0,2
S01007421,Bad health,16,0,0,0,2,1,1,0,8,3,1,1,0,0
S01007421,Very bad health,4,0,0,0,0,0,0,2,0,2,0,0,0,0
S01007422,All people aged 16 to 74,429,37,10,27,104,62,36,45,56,48,21,15,6,20
S01007422,Very good health,204,27,7,20,56,25,19,24,23,13,7,4,3,10
S01007422,Good health,149,10,3,7,37,24,9,18,16,20,6,4,2,9
S01007422,Fair health,50,0,0,0,7,8,6,2,10,10,6,5,1,1
S01007422,Bad health,22,0,0,0,3,5,2,1,5,4,2,2,0,0
S01007422,Very bad health,4,0,0,0,1,0,0,0,2,1,0,0,0,0
S01007423,All people aged 16 to 74,553,60,14,46,162,79,27,46,82,63,17,10,7,17
S01007423,Very good health,312,44,9,35,106,43,13,23,42,23,3,1,2,15
S01007423,Good health,175,13,4,9,47,27,11,16,26,24,9,5,4,2
S01007423,Fair health,56,3,1,2,9,8,2,6,12,12,4,3,1,0
S01007423,Bad health,10,0,0,0,0,1,1,1,2,4,1,1,0,0
S01007423,Very bad health,0,0,0,0,0,0,0,0,0,0,0,0,0,0
S01007424,All people aged 16 to 74,602,63,12,51,178,107,28,52,86,48,11,10,1,29
S01007424,Very good health,337,38,8,30,108,56,13,30,35,28,6,6,0,23
S01007424,Good health,195,23,4,19,50,34,10,16,40,16,3,2,1,3
S01007424,Fair health,56,2,0,2,16,14,3,6,7,4,2,2,0,2
S01007424,Bad health,14,0,0,0,4,3,2,0,4,0,0,0,0,1
S01007424,Very bad health,0,0,0,0,0,0,0,0,0,0,0,0,0,0
S01007425,All people aged 16 to 74,670,67,14,53,161,84,36,57,107,91,24,14,10,43
S01007425,Very good health,319,34,9,25,77,43,17,26,48,33,7,5,2,34
S01007425,Good health,250,27,5,22,63,34,12,22,42,31,12,4,8,7
S01007425,Fair health,80,5,0,5,18,5,7,7,12,20,4,4,0,2
S01007425,Bad health,13,1,0,1,1,1,0,2,3,5,0,0,0,0
S01007425,Very bad health,8,0,0,0,2,1,0,0,2,2,1,1,0,0
S01007426,All people aged 16 to 74,480,31,1,30,87,51,33,48,91,72,22,11,11,45
S01007426,Very good health,200,14,0,14,41,19,15,21,32,22,4,2,2,32
S01007426,Good health,188,13,1,12,31,22,12,18,39,30,12,4,8,11
S01007426,Fair health,62,1,0,1,12,6,5,6,13,14,3,2,1,2
S01007426,Bad health,23,3,0,3,1,2,1,3,5,6,2,2,0,0
S01007426,Very bad health,7,0,0,0,2,2,0,0,2,0,1,1,0,0
S01007427,All people aged 16 to 74,496,16,6,10,78,64,22,54,106,97,31,11,20,28
S01007427,Very good health,200,7,3,4,36,29,6,26,36,29,14,4,10,17
S01007427,Good health,192,8,2,6,36,19,9,19,41,41,12,4,8,7
S01007427,Fair health,72,0,0,0,2,15,1,6,20,19,5,3,2,4
S01007427,Bad health,27,1,1,0,3,0,6,3,7,7,0,0,0,0
S01007427,Very bad health,5,0,0,0,1,1,0,0,2,1,0,0,0,0
S01007428,All people aged 16 to 74,660,19,7,12,139,93,40,74,105,125,26,11,15,39
S01007428,Very good health,295,9,3,6,70,41,21,28,53,38,5,3,2,30
S01007428,Good health,243,7,3,4,52,43,12,35,33,46,9,1,8,6
S01007428,Fair health,81,3,1,2,10,7,3,8,11,28,9,4,5,2
S01007428,Bad health,35,0,0,0,7,2,3,2,7,10,3,3,0,1
S01007428,Very bad health,6,0,0,0,0,0,1,1,1,3,0,0,0,0
S01007429,All people aged 16 to 74,563,36,5,31,136,61,35,55,92,76,26,12,14,46
S01007429,Very good health,292,16,0,16,80,34,17,21,43,31,11,5,6,39
S01007429,Good health,169,10,3,7,42,17,11,23,31,23,7,1,6,5
S01007429,Fair health,75,8,2,6,12,9,7,6,14,13,6,4,2,0
S01007429,Bad health,21,2,0,2,1,1,0,4,3,8,2,2,0,0
S01007429,Very bad health,6,0,0,0,1,0,0,1,1,1,0,0,0,2
S01007430,All people aged 16 to 74,355,27,11,16,84,43,33,43,43,42,8,4,4,32
S01007430,Very good health,175,14,6,8,40,25,17,21,19,13,1,1,0,25
S01007430,Good health,121,8,3,5,31,11,12,16,16,20,1,0,1,6
S01007430,Fair health,47,5,2,3,11,6,3,2,7,8,4,1,3,1
S01007430,Bad health,9,0,0,0,1,1,1,2,1,1,2,2,0,0
S01007430,Very bad health,3,0,0,0,1,0,0,2,0,0,0,0,0,0
S01007431,All people aged 16 to 74,448,39,12,27,117,77,27,31,70,37,11,4,7,39
S01007431,Very good health,254,22,6,16,71,41,14,14,36,17,5,2,3,34
S01007431,Good health,142,16,6,10,34,26,10,14,22,12,3,1,2,5
S01007431,Fair health,38,1,0,1,10,5,2,2,7,8,3,1,2,0
S01007431,Bad health,12,0,0,0,2,4,1,1,4,0,0,0,0,0
S01007431,Very bad health,2,0,0,0,0,1,0,0,1,0,0,0,0,0
S01007432,All people aged 16 to 74,661,34,5,29,122,89,47,68,115,109,41,37,4,36
S01007432,Very good health,279,20,2,18,65,38,15,31,45,29,6,5,1,30
S01007432,Good health,227,8,2,6,39,30,20,26,42,43,13,13,0,6
S01007432,Fair health,110,5,1,4,11,19,8,8,23,23,13,11,2,0
S01007432,Bad health,32,1,0,1,4,0,4,2,4,12,5,4,1,0
S01007432,Very bad health,13,0,0,0,3,2,0,1,1,2,4,4,0,0
S01007433,All people aged 16 to 74,605,60,17,43,124,63,55,43,118,86,22,14,8,34
S01007433,Very good health,280,42,11,31,69,24,33,14,37,29,7,4,3,25
S01007433,Good health,198,16,6,10,38,25,15,11,49,31,6,2,4,7
S01007433,Fair health,83,2,0,2,15,11,3,11,23,13,5,5,0,0
S01007433,Bad health,36,0,0,0,2,1,4,3,8,12,4,3,1,2
S01007433,Very bad health,8,0,0,0,0,2,0,4,1,1,0,0,0,0
S01007434,All people aged 16 to 74,384,11,3,8,43,38,38,39,80,84,31,16,15,20
S01007434,Very good health,157,8,1,7,27,15,12,14,23,33,9,7,2,16
S01007434,Good health,133,2,1,1,11,14,15,13,33,28,13,5,8,4
S01007434,Fair health,66,1,1,0,4,2,9,7,21,14,8,3,5,0
S01007434,Bad health,20,0,0,0,0,2,2,5,3,8,0,0,0,0
S01007434,Very bad health,8,0,0,0,1,5,0,0,0,1,1,1,0,0
S01007435,All people aged 16 to 74,532,31,7,24,113,75,34,50,88,87,25,10,15,29
S01007435,Very good health,219,13,1,12,45,31,19,17,38,28,8,3,5,20
S01007435,Good health,215,11,3,8,54,35,10,22,32,32,13,5,8,6
S01007435,Fair health,66,5,3,2,9,7,3,7,13,18,2,1,1,2
S01007435,Bad health,27,2,0,2,5,2,1,3,3,9,2,1,1,0
S01007435,Very bad health,5,0,0,0,0,0,1,1,2,0,0,0,0,1
S01007436,All people aged 16 to 74,504,32,7,25,77,47,18,47,89,128,33,23,10,33
S01007436,Very good health,206,22,3,19,32,24,7,17,31,46,8,5,3,19
S01007436,Good health,183,7,3,4,36,14,5,20,36,47,8,5,3,10
S01007436,Fair health,75,3,1,2,5,8,2,6,18,23,9,7,2,1
S01007436,Bad health,31,0,0,0,3,1,3,4,3,8,6,4,2,3
S01007436,Very bad health,9,0,0,0,1,0,1,0,1,4,2,2,0,0
S01007437,All people aged 16 to 74,338,19,2,17,72,45,26,25,64,41,26,15,11,20
S01007437,Very good health,155,13,0,13,33,24,10,9,24,18,7,5,2,17
S01007437,Good health,126,6,2,4,25,14,12,11,32,12,11,4,7,3
S01007437,Fair health,43,0,0,0,12,3,4,4,6,7,7,5,2,0
S01007437,Bad health,12,0,0,0,2,3,0,1,2,3,1,1,0,0
S01007437,Very bad health,2,0,0,0,0,1,0,0,0,1,0,0,0,0
S01007438,All people aged 16 to 74,520,29,8,21,87,57,24,69,106,98,34,15,19,16
S01007438,Very good health,197,14,5,9,34,25,6,28,45,28,9,6,3,8
S01007438,Good health,218,13,1,12,41,23,16,25,37,39,17,4,13,7
S01007438,Fair health,82,1,1,0,8,7,2,12,19,26,6,3,3,1
S01007438,Bad health,17,1,1,0,4,2,0,2,3,4,1,1,0,0
S01007438,Very bad health,6,0,0,0,0,0,0,2,2,1,1,1,0,0
S01007439,All people aged 16 to 74,547,42,11,31,102,70,29,67,104,84,20,10,10,29
S01007439,Very good health,229,21,5,16,47,37,10,25,32,32,6,2,4,19
S01007439,Good health,209,12,4,8,41,22,13,27,46,32,7,6,1,9
S01007439,Fair health,74,7,1,6,11,9,4,11,19,8,5,0,5,0
S01007439,Bad health,24,2,1,1,3,2,1,4,5,7,0,0,0,0
S01007439,Very bad health,11,0,0,0,0,0,1,0,2,5,2,2,0,1
S01007440,All people aged 16 to 74,481,23,8,15,87,57,29,55,100,76,23,13,10,31
S01007440,Very good health,232,15,6,9,38,31,15,31,43,26,10,5,5,23
S01007440,Good health,177,5,2,3,40,16,12,14,41,35,7,4,3,7
S01007440,Fair health,47,2,0,2,7,8,1,4,11,11,3,1,2,0
S01007440,Bad health,20,1,0,1,2,1,1,5,4,3,2,2,0,1
S01007440,Very bad health,5,0,0,0,0,1,0,1,1,1,1,1,0,0
S01007441,All people aged 16 to 74,439,48,13,35,117,70,27,41,67,31,8,2,6,30
S01007441,Very good health,234,31,7,24,64,39,11,18,30,15,4,1,3,22
S01007441,Good health,163,12,4,8,41,27,13,20,28,11,3,0,3,8
S01007441,Fair health,29,3,1,2,10,3,2,2,7,2,0,0,0,0
S01007441,Bad health,10,2,1,1,2,1,0,1,2,2,0,0,0,0
S01007441,Very bad health,3,0,0,0,0,0,1,0,0,1,1,1,0,0
S01007442,All people aged 16 to 74,382,55,10,45,115,70,29,27,43,14,7,4,3,22
S01007442,Very good health,206,30,6,24,67,36,17,15,17,5,2,1,1,17
S01007442,Good health,135,24,4,20,37,25,9,7,20,5,3,1,2,5
S01007442,Fair health,29,1,0,1,9,5,2,4,5,1,2,2,0,0
S01007442,Bad health,11,0,0,0,2,3,1,1,1,3,0,0,0,0
S01007442,Very bad health,1,0,0,0,0,1,0,0,0,0,0,0,0,0
S01007443,All people aged 16 to 74,649,104,24,80,164,63,50,42,65,46,24,12,12,91
S01007443,Very good health,371,69,10,59,99,32,26,16,27,18,12,5,7,72
S01007443,Good health,188,24,10,14,44,25,16,15,26,13,9,5,4,16
S01007443,Fair health,65,10,4,6,15,6,6,10,6,8,1,1,0,3
S01007443,Bad health,21,1,0,1,4,0,2,1,5,6,2,1,1,0
S01007443,Very bad health,4,0,0,0,2,0,0,0,1,1,0,0,0,0
S01007444,All people aged 16 to 74,657,123,29,94,215,72,66,32,48,35,17,12,5,49
S01007444,Very good health,365,79,19,60,127,37,30,12,22,11,5,3,2,42
S01007444,Good health,202,33,9,24,63,22,26,14,18,11,8,5,3,7
S01007444,Fair health,69,7,1,6,19,13,8,4,5,10,3,3,0,0
S01007444,Bad health,12,2,0,2,4,0,1,2,2,1,0,0,0,0
S01007444,Very bad health,9,2,0,2,2,0,1,0,1,2,1,1,0,0
S01007445,All people aged 16 to 74,472,107,26,81,157,55,34,31,36,18,5,4,1,29
S01007445,Very good health,254,66,14,52,84,26,16,14,17,5,2,1,1,24
S01007445,Good health,170,32,10,22,59,21,14,15,10,12,2,2,0,5
S01007445,Fair health,39,8,2,6,12,7,3,2,6,0,1,1,0,0
S01007445,Bad health,7,1,0,1,2,1,0,0,2,1,0,0,0,0
S01007445,Very bad health,2,0,0,0,0,0,1,0,1,0,0,0,0,0
S01007446,All people aged 16 to 74,382,90,23,67,126,29,37,14,26,20,8,2,6,32
S01007446,Very good health,257,60,16,44,85,14,24,10,16,15,2,1,1,31
S01007446,Good health,96,25,7,18,34,14,8,4,4,3,3,0,3,1
S01007446,Fair health,23,3,0,3,5,1,5,0,5,1,3,1,2,0
S01007446,Bad health,5,2,0,2,2,0,0,0,1,0,0,0,0,0
S01007446,Very bad health,1,0,0,0,0,0,0,0,0,1,0,0,0,0
S01007447,All people aged 16 to 74,384,74,16,58,113,44,51,25,30,15,8,4,4,24
S01007447,Very good health,215,45,5,40,67,24,24,14,8,8,3,0,3,22
S01007447,Good health,134,21,9,12,35,16,26,11,14,5,4,3,1,2
S01007447,Fair health,24,7,2,5,7,3,0,0,6,1,0,0,0,0
S01007447,Bad health,8,1,0,1,2,1,1,0,1,1,1,1,0,0
S01007447,Very bad health,3,0,0,0,2,0,0,0,1,0,0,0,0,0
S01007448,All people aged 16 to 74,674,53,14,39,159,88,80,61,97,83,22,14,8,31
S01007448,Very good health,332,29,7,22,83,50,32,24,47,35,6,4,2,26
S01007448,Good health,235,18,5,13,51,31,36,22,31,34,8,4,4,4
S01007448,Fair health,85,6,2,4,19,7,9,9,16,11,7,5,2,1
S01007448,Bad health,16,0,0,0,6,0,1,5,2,1,1,1,0,0
S01007448,Very bad health,6,0,0,0,0,0,2,1,1,2,0,0,0,0
S01007449,All people aged 16 to 74,757,47,14,33,119,95,42,70,151,126,64,28,36,43
S01007449,Very good health,314,23,6,17,57,43,18,30,49,39,24,9,15,31
S01007449,Good health,293,18,7,11,48,34,18,25,72,48,19,9,10,11
S01007449,Fair health,100,5,1,4,13,9,5,13,21,20,14,7,7,0
S01007449,Bad health,32,1,0,1,0,6,1,1,6,10,6,2,4,1
S01007449,Very bad health,18,0,0,0,1,3,0,1,3,9,1,1,0,0
S01007450,All people aged 16 to 74,549,23,6,17,74,64,30,45,111,105,63,38,25,34
S01007450,Very good health,200,12,4,8,28,28,14,18,36,25,19,10,9,20
S01007450,Good health,194,6,1,5,25,22,9,14,40,47,22,11,11,9
S01007450,Fair health,101,5,1,4,12,7,5,9,22,21,16,11,5,4
S01007450,Bad health,41,0,0,0,6,7,2,2,12,8,3,3,0,1
S01007450,Very bad health,13,0,0,0,3,0,0,2,1,4,3,3,0,0
S01007451,All people aged 16 to 74,477,23,9,14,84,73,23,40,109,76,20,13,7,29
S01007451,Very good health,225,14,4,10,41,45,13,22,40,27,4,3,1,19
S01007451,Good health,155,6,3,3,32,16,6,10,42,28,9,5,4,6
S01007451,Fair health,69,2,2,0,9,8,4,8,16,15,3,1,2,4
S01007451,Bad health,18,1,0,1,2,4,0,0,6,3,2,2,0,0
S01007451,Very bad health,10,0,0,0,0,0,0,0,5,3,2,2,0,0
S01007452,All people aged 16 to 74,382,23,5,18,53,37,37,38,66,69,32,16,16,27
S01007452,Very good health,159,12,1,11,24,15,14,9,29,22,13,7,6,21
S01007452,Good health,152,7,3,4,22,18,14,17,26,25,17,7,10,6
S01007452,Fair health,47,2,1,1,5,3,7,9,10,10,1,1,0,0
S01007452,Bad health,20,2,0,2,0,1,2,3,1,10,1,1,0,0
S01007452,Very bad health,4,0,0,0,2,0,0,0,0,2,0,0,0,0
S01007453,All people aged 16 to 74,450,56,15,41,150,51,33,42,51,19,15,11,4,33
S01007453,Very good health,261,39,10,29,86,29,21,22,22,10,6,5,1,26
S01007453,Good health,155,16,5,11,54,18,10,16,22,8,5,2,3,6
S01007453,Fair health,23,1,0,1,5,4,2,3,5,0,2,2,0,1
S01007453,Bad health,6,0,0,0,4,0,0,0,0,1,1,1,0,0
S01007453,Very bad health,5,0,0,0,1,0,0,1,2,0,1,1,0,0
S01007454,All people aged 16 to 74,399,13,4,9,55,50,29,28,86,91,27,18,9,20
S01007454,Very good health,152,5,1,4,21,23,18,12,25,25,9,4,5,14
S01007454,Good health,154,6,2,4,28,21,7,9,35,34,9,6,3,5
S01007454,Fair health,55,0,0,0,3,4,3,6,12,20,6,5,1,1
S01007454,Bad health,33,2,1,1,2,2,1,1,12,11,2,2,0,0
S01007454,Very bad health,5,0,0,0,1,0,0,0,2,1,1,1,0,0
S01007455,All people aged 16 to 74,639,15,6,9,95,78,25,70,130,124,58,36,22,44
S01007455,Very good health,262,8,2,6,41,43,12,26,49,37,18,13,5,28
S01007455,Good health,202,6,3,3,40,17,6,22,45,36,21,10,11,9
S01007455,Fair health,119,1,1,0,9,12,7,11,28,32,14,9,5,5
S01007455,Bad health,46,0,0,0,5,5,0,11,7,12,5,4,1,1
S01007455,Very bad health,10,0,0,0,0,1,0,0,1,7,0,0,0,1
S01007456,All people aged 16 to 74,624,9,1,8,69,52,30,55,167,151,47,28,19,44
S01007456,Very good health,269,6,0,6,32,27,13,22,78,55,11,7,4,25
S01007456,Good health,236,1,0,1,26,15,13,24,62,54,23,10,13,18
S01007456,Fair health,80,2,1,1,5,5,3,6,21,28,9,8,1,1
S01007456,Bad health,28,0,0,0,5,3,1,1,6,9,3,2,1,0
S01007456,Very bad health,11,0,0,0,1,2,0,2,0,5,1,1,0,0
S01007457,All people aged 16 to 74,796,33,8,25,139,94,47,82,128,150,82,50,32,41
S01007457,Very good health,341,18,2,16,67,47,21,41,47,46,23,13,10,31
S01007457,Good health,288,15,6,9,42,29,13,34,58,56,35,21,14,6
S01007457,Fair health,112,0,0,0,17,13,9,7,19,27,16,9,7,4
S01007457,Bad health,42,0,0,0,10,5,3,0,3,15,6,5,1,0
S01007457,Very bad health,13,0,0,0,3,0,1,0,1,6,2,2,0,0
S01007458,All people aged 16 to 74,385,25,8,17,86,72,21,51,54,38,14,8,6,24
S01007458,Very good health,196,10,4,6,45,32,12,27,22,21,5,2,3,22
S01007458,Good health,141,10,3,7,36,32,7,16,28,7,4,3,1,1
S01007458,Fair health,42,5,1,4,5,8,1,7,3,8,4,2,2,1
S01007458,Bad health,5,0,0,0,0,0,1,1,1,1,1,1,0,0
S01007458,Very bad health,1,0,0,0,0,0,0,0,0,1,0,0,0,0
S01007459,All people aged 16 to 74,474,20,3,17,106,70,29,59,75,79,16,9,7,20
S01007459,Very good health,224,13,2,11,57,33,16,23,28,33,3,1,2,18
S01007459,Good health,155,5,1,4,32,29,9,22,33,18,6,3,3,1
S01007459,Fair health,65,2,0,2,11,5,2,10,10,18,6,4,2,1
S01007459,Bad health,23,0,0,0,5,2,2,3,2,9,0,0,0,0
S01007459,Very bad health,7,0,0,0,1,1,0,1,2,1,1,1,0,0
S01007460,All people aged 16 to 74,568,23,7,16,82,56,44,74,117,108,46,29,17,18
S01007460,Very good health,223,10,3,7,41,28,17,34,43,24,13,7,6,13
S01007460,Good health,199,6,1,5,28,21,18,25,41,42,14,7,7,4
S01007460,Fair health,96,6,3,3,9,5,6,11,19,24,15,11,4,1
S01007460,Bad health,38,1,0,1,3,2,3,3,10,14,2,2,0,0
S01007460,Very bad health,12,0,0,0,1,0,0,1,4,4,2,2,0,0
S01007461,All people aged 16 to 74,529,12,5,7,51,39,35,51,118,111,75,45,30,37
S01007461,Very good health,218,8,3,5,30,15,13,24,35,40,29,19,10,24
S01007461,Good health,171,0,0,0,17,14,8,11,49,33,27,12,15,12
S01007461,Fair health,77,1,1,0,4,4,9,8,23,18,9,6,3,1
S01007461,Bad health,51,2,0,2,0,6,5,6,10,15,7,5,2,0
S01007461,Very bad health,12,1,1,0,0,0,0,2,1,5,3,3,0,0
S01007462,All people aged 16 to 74,626,34,5,29,117,79,44,56,130,91,44,28,16,31
S01007462,Very good health,279,21,3,18,62,36,20,21,56,23,15,9,6,25
S01007462,Good health,238,11,2,9,41,33,19,23,56,35,15,8,7,5
S01007462,Fair health,73,2,0,2,8,9,3,8,15,21,6,4,2,1
S01007462,Bad health,30,0,0,0,6,1,1,3,2,11,6,5,1,0
S01007462,Very bad health,6,0,0,0,0,0,1,1,1,1,2,2,0,0
S01007463,All people aged 16 to 74,698,12,3,9,51,54,41,38,155,184,104,63,41,59
S01007463,Very good health,278,8,1,7,22,24,13,16,61,58,32,19,13,44
S01007463,Good health,230,3,2,1,17,20,16,11,55,56,41,22,19,11
S01007463,Fair health,101,1,0,1,5,5,7,5,27,31,18,11,7,2
S01007463,Bad health,59,0,0,0,4,4,4,2,8,25,10,8,2,2
S01007463,Very bad health,30,0,0,0,3,1,1,4,4,14,3,3,0,0
S01007464,All people aged 16 to 74,497,10,2,8,35,43,14,44,128,146,49,33,16,28
S01007464,Very good health,175,7,1,6,14,18,4,12,48,36,15,7,8,21
S01007464,Good health,189,1,0,1,17,17,9,24,46,60,11,6,5,4
S01007464,Fair health,93,2,1,1,4,7,1,3,25,37,12,9,3,2
S01007464,Bad health,28,0,0,0,0,1,0,4,6,10,6,6,0,1
S01007464,Very bad health,12,0,0,0,0,0,0,1,3,3,5,5,0,0
S01007465,All people aged 16 to 74,567,13,3,10,47,42,20,37,135,150,102,67,35,21
S01007465,Very good health,188,6,1,5,15,16,8,9,38,39,47,27,20,10
S01007465,Good health,204,5,0,5,21,17,8,16,55,46,27,15,12,9
S01007465,Fair health,94,1,1,0,4,5,2,7,22,36,16,13,3,1
S01007465,Bad health,64,1,1,0,6,3,1,4,18,20,10,10,0,1
S01007465,Very bad health,17,0,0,0,1,1,1,1,2,9,2,2,0,0
S01007466,All people aged 16 to 74,802,37,6,31,87,74,36,74,169,171,107,69,38,47
S01007466,Very good health,262,12,0,12,32,29,18,11,60,48,25,16,9,27
S01007466,Good health,295,19,2,17,41,32,11,29,60,59,30,14,16,14
S01007466,Fair health,161,2,2,0,9,10,4,18,33,47,33,21,12,5
S01007466,Bad health,61,3,2,1,3,3,1,13,12,11,14,13,1,1
S01007466,Very bad health,23,1,0,1,2,0,2,3,4,6,5,5,0,0
S01007467,All people aged 16 to 74,720,32,9,23,140,95,34,81,134,122,39,27,12,43
S01007467,Very good health,290,13,3,10,63,41,10,25,48,40,15,6,9,35
S01007467,Good health,261,17,4,13,52,38,18,33,53,33,11,8,3,6
S01007467,Fair health,100,1,1,0,14,12,3,15,19,26,8,8,0,2
S01007467,Bad health,54,0,0,0,10,4,3,4,11,20,2,2,0,0
S01007467,Very bad health,15,1,1,0,1,0,0,4,3,3,3,3,0,0
S01007468,All people aged 16 to 74,578,46,17,29,107,84,38,70,108,77,9,6,3,39
S01007468,Very good health,294,22,7,15,55,44,14,40,52,31,2,1,1,34
S01007468,Good health,206,18,9,9,47,30,15,20,30,38,3,1,2,5
S01007468,Fair health,54,5,1,4,4,8,7,5,16,8,1,1,0,0
S01007468,Bad health,16,1,0,1,1,1,1,3,7,0,2,2,0,0
S01007468,Very bad health,8,0,0,0,0,1,1,2,3,0,1,1,0,0
S01007469,All people aged 16 to 74,434,19,8,11,64,51,19,40,97,87,31,16,15,26
S01007469,Very good health,189,10,4,6,33,25,8,14,37,38,5,2,3,19
S01007469,Good health,159,4,1,3,21,20,8,19,39,26,15,8,7,7
S01007469,Fair health,62,4,2,2,6,6,3,4,16,17,6,2,4,0
S01007469,Bad health,18,0,0,0,3,0,0,3,3,6,3,2,1,0
S01007469,Very bad health,6,1,1,0,1,0,0,0,2,0,2,2,0,0
S01007470,All people aged 16 to 74,492,21,6,15,73,58,26,38,115,80,49,34,15,32
S01007470,Very good health,228,13,5,8,45,21,11,17,46,29,17,8,9,29
S01007470,Good health,149,6,1,5,19,19,10,13,40,22,18,14,4,2
S01007470,Fair health,65,2,0,2,5,12,3,5,16,13,9,8,1,0
S01007470,Bad health,36,0,0,0,3,3,2,3,7,12,5,4,1,1
S01007470,Very bad health,14,0,0,0,1,3,0,0,6,4,0,0,0,0
S01007471,All people aged 16 to 74,353,19,3,16,60,57,13,30,64,64,17,7,10,29
S01007471,Very good health,177,13,2,11,31,22,7,11,33,32,6,2,4,22
S01007471,Good health,121,5,1,4,23,29,3,16,19,14,6,3,3,6
S01007471,Fair health,35,0,0,0,4,4,2,2,8,11,4,1,3,0
S01007471,Bad health,15,0,0,0,1,2,0,1,3,6,1,1,0,1
S01007471,Very bad health,5,1,0,1,1,0,1,0,1,1,0,0,0,0
S01007472,All people aged 16 to 74,406,7,0,7,45,48,19,41,90,113,23,10,13,20
S01007472,Very good health,159,3,0,3,21,22,9,19,31,34,8,4,4,12
S01007472,Good health,131,2,0,2,17,14,8,10,32,34,8,2,6,6
S01007472,Fair health,79,1,0,1,6,9,1,8,19,28,5,3,2,2
S01007472,Bad health,25,1,0,1,1,3,1,4,6,8,1,1,0,0
S01007472,Very bad health,12,0,0,0,0,0,0,0,2,9,1,0,1,0
S01007473,All people aged 16 to 74,339,13,4,9,46,45,16,38,74,69,20,13,7,18
S01007473,Very good health,128,4,1,3,19,22,6,12,31,16,5,3,2,13
S01007473,Good health,125,3,0,3,20,16,5,18,25,26,8,6,2,4
S01007473,Fair health,59,5,3,2,6,5,4,4,15,13,7,4,3,0
S01007473,Bad health,20,1,0,1,0,2,1,2,2,11,0,0,0,1
S01007473,Very bad health,7,0,0,0,1,0,0,2,1,3,0,0,0,0
S01007474,All people aged 16 to 74,419,37,7,30,93,76,38,36,74,36,6,3,3,23
S01007474,Very good health,232,22,4,18,57,44,18,19,29,19,3,1,2,21
S01007474,Good health,127,13,2,11,24,22,11,13,30,11,1,1,0,2
S01007474,Fair health,49,2,1,1,10,9,7,4,12,4,1,0,1,0
S01007474,Bad health,9,0,0,0,1,1,1,0,3,2,1,1,0,0
S01007474,Very bad health,2,0,0,0,1,0,1,0,0,0,0,0,0,0
S01007475,All people aged 16 to 74,463,47,10,37,125,74,25,41,55,54,18,10,8,24
S01007475,Very good health,254,29,7,22,77,42,11,21,23,22,7,3,4,22
S01007475,Good health,129,15,3,12,32,17,8,9,21,21,5,2,3,1
S01007475,Fair health,57,3,0,3,11,9,6,9,7,7,4,3,1,1
S01007475,Bad health,18,0,0,0,5,5,0,2,3,1,2,2,0,0
S01007475,Very bad health,5,0,0,0,0,1,0,0,1,3,0,0,0,0
S01007476,All people aged 16 to 74,475,51,14,37,104,72,29,51,76,52,14,8,6,26
S01007476,Very good health,215,23,6,17,60,29,15,18,30,18,4,2,2,18
S01007476,Good health,185,24,7,17,35,38,9,19,32,17,5,2,3,6
S01007476,Fair health,50,2,1,1,5,3,3,11,12,9,4,3,1,1
S01007476,Bad health,18,2,0,2,2,2,1,3,1,6,1,1,0,0
S01007476,Very bad health,7,0,0,0,2,0,1,0,1,2,0,0,0,1
S01007477,All people aged 16 to 74,403,50,12,38,96,62,33,39,45,44,7,2,5,27
S01007477,Very good health,216,31,7,24,57,35,12,18,17,21,2,0,2,23
S01007477,Good health,125,15,4,11,26,18,12,16,17,13,4,1,3,4
S01007477,Fair health,47,3,1,2,13,5,9,2,6,8,1,1,0,0
S01007477,Bad health,9,0,0,0,0,2,0,3,4,0,0,0,0,0
S01007477,Very bad health,6,1,0,1,0,2,0,0,1,2,0,0,0,0
S01007478,All people aged 16 to 74,649,74,11,63,179,76,46,47,88,72,24,16,8,43
S01007478,Very good health,321,48,5,43,91,40,23,19,45,16,9,4,5,30
S01007478,Good health,228,19,5,14,69,27,17,16,28,33,10,7,3,9
S01007478,Fair health,72,7,1,6,12,4,5,10,11,16,4,4,0,3
S01007478,Bad health,22,0,0,0,6,5,0,2,2,5,1,1,0,1
S01007478,Very bad health,6,0,0,0,1,0,1,0,2,2,0,0,0,0
S01007479,All people aged 16 to 74,427,28,5,23,93,76,25,49,62,57,15,12,3,22
S01007479,Very good health,219,15,4,11,61,43,8,25,26,17,6,5,1,18
S01007479,Good health,138,12,1,11,22,26,6,16,27,22,3,2,1,4
S01007479,Fair health,48,0,0,0,9,6,5,6,4,13,5,4,1,0
S01007479,Bad health,20,1,0,1,1,1,5,2,5,5,0,0,0,0
S01007479,Very bad health,2,0,0,0,0,0,1,0,0,0,1,1,0,0
S01007480,All people aged 16 to 74,587,39,8,31,133,87,31,65,102,79,19,9,10,32
S01007480,Very good health,311,19,6,13,76,50,13,36,51,37,5,2,3,24
S01007480,Good health,197,16,1,15,47,25,12,21,39,25,5,2,3,7
S01007480,Fair health,56,4,1,3,8,10,6,5,6,11,5,2,3,1
S01007480,Bad health,16,0,0,0,2,1,0,1,5,5,2,2,0,0
S01007480,Very bad health,7,0,0,0,0,1,0,2,1,1,2,1,1,0
S01007481,All people aged 16 to 74,610,53,16,37,161,85,79,55,90,51,10,8,2,26
S01007481,Very good health,301,33,10,23,86,38,25,29,39,25,5,4,1,21
S01007481,Good health,228,17,6,11,53,36,37,19,38,20,4,4,0,4
S01007481,Fair health,60,1,0,1,17,8,13,5,12,2,1,0,1,1
S01007481,Bad health,18,2,0,2,3,3,4,2,1,3,0,0,0,0
S01007481,Very bad health,3,0,0,0,2,0,0,0,0,1,0,0,0,0
S01007482,All people aged 16 to 74,325,11,3,8,50,37,27,31,72,66,21,19,2,10
S01007482,Very good health,114,6,2,4,16,18,9,11,27,18,4,4,0,5
S01007482,Good health,131,5,1,4,25,10,14,9,29,25,9,8,1,5
S01007482,Fair health,59,0,0,0,6,7,3,9,14,17,3,2,1,0
S01007482,Bad health,12,0,0,0,2,2,0,2,2,2,2,2,0,0
S01007482,Very bad health,9,0,0,0,1,0,1,0,0,4,3,3,0,0
S01007483,All people aged 16 to 74,574,12,2,10,76,57,64,58,122,120,35,17,18,30
S01007483,Very good health,268,7,1,6,35,28,35,35,60,37,11,5,6,20
S01007483,Good health,184,5,1,4,28,20,18,10,29,52,14,6,8,8
S01007483,Fair health,84,0,0,0,10,5,5,7,25,22,8,4,4,2
S01007483,Bad health,34,0,0,0,3,3,6,5,8,7,2,2,0,0
S01007483,Very bad health,4,0,0,0,0,1,0,1,0,2,0,0,0,0
S01007484,All people aged 16 to 74,416,12,2,10,62,28,40,47,86,76,41,20,21,24
S01007484,Very good health,193,4,0,4,32,14,16,21,41,33,16,6,10,16
S01007484,Good health,140,7,1,6,22,11,19,15,21,23,15,7,8,7
S01007484,Fair health,52,0,0,0,3,2,5,7,17,12,5,3,2,1
S01007484,Bad health,22,1,1,0,4,1,0,2,6,6,2,1,1,0
S01007484,Very bad health,9,0,0,0,1,0,0,2,1,2,3,3,0,0
S01007485,All people aged 16 to 74,336,5,1,4,23,17,18,30,103,84,44,22,22,12
S01007485,Very good health,113,2,0,2,6,7,5,9,33,33,10,4,6,8
S01007485,Good health,111,2,1,1,12,3,7,9,33,21,21,13,8,3
S01007485,Fair health,75,1,0,1,4,5,3,10,22,19,11,4,7,0
S01007485,Bad health,27,0,0,0,1,0,3,2,11,7,2,1,1,1
S01007485,Very bad health,10,0,0,0,0,2,0,0,4,4,0,0,0,0
S01007486,All people aged 16 to 74,353,1,1,0,25,28,16,30,84,93,59,31,28,17
S01007486,Very good health,127,0,0,0,8,15,4,9,24,26,30,14,16,11
S01007486,Good health,127,1,1,0,10,6,4,14,31,35,20,12,8,6
S01007486,Fair health,61,0,0,0,5,5,4,5,18,17,7,3,4,0
S01007486,Bad health,27,0,0,0,2,2,2,0,7,13,1,1,0,0
S01007486,Very bad health,11,0,0,0,0,0,2,2,4,2,1,1,0,0
S01007487,All people aged 16 to 74,692,13,1,12,78,56,63,75,161,150,67,46,21,29
S01007487,Very good health,260,5,0,5,37,20,25,23,68,45,15,10,5,22
S01007487,Good health,247,4,0,4,33,24,19,38,52,50,22,13,9,5
S01007487,Fair health,125,3,1,2,4,6,13,10,27,35,25,19,6,2
S01007487,Bad health,44,0,0,0,3,4,5,4,12,14,2,1,1,0
S01007487,Very bad health,16,1,0,1,1,2,1,0,2,6,3,3,0,0
S01007488,All people aged 16 to 74,756,20,4,16,148,95,78,64,147,116,44,25,19,44
S01007488,Very good health,351,6,0,6,75,46,30,32,67,51,11,5,6,33
S01007488,Good health,262,12,3,9,56,36,35,14,48,30,21,10,11,10
S01007488,Fair health,99,2,1,1,17,10,11,12,21,17,8,6,2,1
S01007488,Bad health,35,0,0,0,0,3,2,5,7,15,3,3,0,0
S01007488,Very bad health,9,0,0,0,0,0,0,1,4,3,1,1,0,0
S01007489,All people aged 16 to 74,618,18,7,11,90,90,64,59,119,110,27,15,12,41
S01007489,Very good health,296,10,3,7,41,46,27,34,50,49,8,4,4,31
S01007489,Good health,204,6,3,3,36,32,24,15,41,33,8,4,4,9
S01007489,Fair health,78,2,1,1,10,11,10,5,19,17,4,2,2,0
S01007489,Bad health,32,0,0,0,3,1,3,3,8,9,4,3,1,1
S01007489,Very bad health,8,0,0,0,0,0,0,2,1,2,3,2,1,0
S01007490,All people aged 16 to 74,650,14,4,10,77,70,53,77,130,147,41,30,11,41
S01007490,Very good health,277,5,0,5,38,28,17,34,57,50,16,8,8,32
S01007490,Good health,222,4,2,2,31,29,25,25,46,49,7,5,2,6
S01007490,Fair health,113,3,2,1,7,10,9,14,21,33,13,12,1,3
S01007490,Bad health,31,1,0,1,0,2,2,3,5,13,5,5,0,0
S01007490,Very bad health,7,1,0,1,1,1,0,1,1,2,0,0,0,0
S01007491,All people aged 16 to 74,796,16,4,12,111,96,51,86,191,150,54,27,27,41
S01007491,Very good health,395,12,3,9,62,55,25,50,77,63,20,9,11,31
S01007491,Good health,252,4,1,3,37,27,15,22,71,50,17,8,9,9
S01007491,Fair health,97,0,0,0,6,8,7,12,27,23,13,8,5,1
S01007491,Bad health,34,0,0,0,2,3,2,2,11,12,2,1,1,0
S01007491,Very bad health,18,0,0,0,4,3,2,0,5,2,2,1,1,0
S01007492,All people aged 16 to 74,536,16,5,11,80,61,38,51,132,101,32,20,12,25
S01007492,Very good health,220,9,3,6,40,25,18,18,48,37,8,7,1,17
S01007492,Good health,180,6,2,4,29,22,12,23,41,28,11,6,5,8
S01007492,Fair health,80,0,0,0,8,9,4,6,25,23,5,1,4,0
S01007492,Bad health,40,1,0,1,3,4,4,2,15,5,6,5,1,0
S01007492,Very bad health,16,0,0,0,0,1,0,2,3,8,2,1,1,0
S01007493,All people aged 16 to 74,623,16,6,10,92,73,36,88,136,120,34,19,15,28
S01007493,Very good health,280,9,4,5,43,30,13,47,57,53,10,6,4,18
S01007493,Good health,215,5,1,4,31,30,16,25,50,37,13,4,9,8
S01007493,Fair health,81,2,1,1,9,9,4,10,18,21,7,5,2,1
S01007493,Bad health,34,0,0,0,6,3,3,5,7,6,4,4,0,0
S01007493,Very bad health,13,0,0,0,3,1,0,1,4,3,0,0,0,1
S01007494,All people aged 16 to 74,404,21,4,17,69,36,92,27,82,39,16,11,5,22
S01007494,Very good health,164,10,3,7,31,15,33,8,35,10,6,2,4,16
S01007494,Good health,146,5,0,5,19,14,47,10,33,10,3,3,0,5
S01007494,Fair health,58,5,0,5,9,3,10,5,10,11,4,3,1,1
S01007494,Bad health,29,1,1,0,8,4,1,4,3,6,2,2,0,0
S01007494,Very bad health,7,0,0,0,2,0,1,0,1,2,1,1,0,0
S01007495,All people aged 16 to 74,626,35,5,30,112,80,143,54,103,64,8,7,1,27
S01007495,Very good health,298,22,2,20,48,40,71,28,38,28,0,0,0,23
S01007495,Good health,200,6,1,5,37,23,47,18,42,22,3,2,1,2
S01007495,Fair health,93,4,2,2,23,14,20,4,13,11,2,2,0,2
S01007495,Bad health,32,2,0,2,4,3,4,4,10,3,2,2,0,0
S01007495,Very bad health,3,1,0,1,0,0,1,0,0,0,1,1,0,0
S01007496,All people aged 16 to 74,776,46,12,34,171,74,165,62,130,73,24,12,12,31
S01007496,Very good health,354,21,7,14,82,33,70,32,53,32,8,4,4,23
S01007496,Good health,269,17,3,14,66,29,56,17,42,24,13,5,8,5
S01007496,Fair health,110,4,1,3,15,12,31,10,25,10,1,1,0,2
S01007496,Bad health,35,4,1,3,6,0,7,3,7,6,1,1,0,1
S01007496,Very bad health,8,0,0,0,2,0,1,0,3,1,1,1,0,0
S01007497,All people aged 16 to 74,439,15,4,11,44,40,73,37,104,76,29,25,4,21
S01007497,Very good health,196,10,2,8,24,16,37,20,35,29,8,5,3,17
S01007497,Good health,148,5,2,3,11,19,22,11,39,28,9,8,1,4
S01007497,Fair health,67,0,0,0,7,4,8,4,22,15,7,7,0,0
S01007497,Bad health,27,0,0,0,1,1,6,2,8,4,5,5,0,0
S01007497,Very bad health,1,0,0,0,1,0,0,0,0,0,0,0,0,0
S01007498,All people aged 16 to 74,628,19,4,15,88,75,92,65,140,90,23,16,7,36
S01007498,Very good health,280,9,3,6,39,30,46,27,63,31,8,6,2,27
S01007498,Good health,203,8,1,7,32,31,26,15,45,34,5,1,4,7
S01007498,Fair health,92,1,0,1,12,10,15,12,16,18,6,6,0,2
S01007498,Bad health,31,1,0,1,4,4,5,4,5,5,3,3,0,0
S01007498,Very bad health,22,0,0,0,1,0,0,7,11,2,1,0,1,0
S01007499,All people aged 16 to 74,635,21,6,15,86,48,120,50,135,110,34,20,14,31
S01007499,Very good health,274,8,1,7,46,19,47,18,67,40,7,4,3,22
S01007499,Good health,223,10,5,5,29,19,49,20,37,38,14,6,8,7
S01007499,Fair health,90,2,0,2,8,5,19,9,20,19,6,4,2,2
S01007499,Bad health,32,0,0,0,2,4,2,2,8,9,5,4,1,0
S01007499,Very bad health,16,1,0,1,1,1,3,1,3,4,2,2,0,0
S01007500,All people aged 16 to 74,448,25,5,20,57,36,81,52,104,59,17,8,9,17
S01007500,Very good health,185,13,2,11,24,14,42,21,39,16,3,1,2,13
S01007500,Good health,150,7,0,7,22,13,28,19,35,15,8,3,5,3
S01007500,Fair health,78,4,3,1,7,6,7,10,18,22,3,2,1,1
S01007500,Bad health,27,1,0,1,3,2,3,2,10,3,3,2,1,0
S01007500,Very bad health,8,0,0,0,1,1,1,0,2,3,0,0,0,0
S01007501,All people aged 16 to 74,528,25,4,21,106,54,136,35,87,47,23,7,16,15
S01007501,Very good health,224,10,1,9,48,20,59,11,35,15,12,4,8,14
S01007501,Good health,168,6,2,4,31,20,51,13,28,11,7,1,6,1
S01007501,Fair health,95,5,0,5,20,9,22,8,12,16,3,1,2,0
S01007501,Bad health,24,3,0,3,5,3,1,2,6,3,1,1,0,0
S01007501,Very bad health,17,1,1,0,2,2,3,1,6,2,0,0,0,0
S01007502,All people aged 16 to 74,412,18,6,12,74,35,90,40,71,52,11,6,5,21
S01007502,Very good health,165,10,1,9,38,18,28,13,21,16,3,1,2,18
S01007502,Good health,143,5,2,3,25,9,37,14,24,24,3,1,2,2
S01007502,Fair health,64,2,2,0,5,5,15,9,13,11,3,3,0,1
S01007502,Bad health,29,1,1,0,4,2,8,2,10,1,1,1,0,0
S01007502,Very bad health,11,0,0,0,2,1,2,2,3,0,1,0,1,0
S01007503,All people aged 16 to 74,758,27,6,21,131,58,163,58,144,104,40,26,14,33
S01007503,Very good health,356,12,3,9,64,31,72,27,58,50,12,8,4,30
S01007503,Good health,224,10,2,8,36,16,50,16,54,28,12,7,5,2
S01007503,Fair health,130,4,0,4,23,7,35,7,21,20,12,7,5,1
S01007503,Bad health,40,1,1,0,6,4,5,6,10,6,2,2,0,0
S01007503,Very bad health,8,0,0,0,2,0,1,2,1,0,2,2,0,0
S01007504,All people aged 16 to 74,523,27,3,24,93,45,129,38,84,65,18,9,9,24
S01007504,Very good health,247,19,1,18,41,17,68,17,36,21,6,3,3,22
S01007504,Good health,166,5,1,4,31,21,44,12,26,20,5,2,3,2
S01007504,Fair health,69,3,1,2,15,3,12,4,13,15,4,1,3,0
S01007504,Bad health,27,0,0,0,4,2,5,4,6,4,2,2,0,0
S01007504,Very bad health,14,0,0,0,2,2,0,1,3,5,1,1,0,0
S01007505,All people aged 16 to 74,321,21,5,16,57,32,80,20,52,35,13,7,6,11
S01007505,Very good health,138,11,3,8,21,18,33,6,25,15,3,1,2,6
S01007505,Good health,107,7,2,5,26,9,28,5,13,9,6,2,4,4
S01007505,Fair health,52,2,0,2,6,5,12,6,9,9,2,2,0,1
S01007505,Bad health,18,1,0,1,3,0,6,1,4,2,1,1,0,0
S01007505,Very bad health,6,0,0,0,1,0,1,2,1,0,1,1,0,0
S01007506,All people aged 16 to 74,369,27,7,20,81,36,105,25,51,28,7,4,3,9
S01007506,Very good health,175,12,1,11,42,18,54,10,17,11,3,2,1,8
S01007506,Good health,126,11,4,7,33,13,31,10,15,11,1,1,0,1
S01007506,Fair health,42,3,1,2,5,4,16,3,10,1,0,0,0,0
S01007506,Bad health,21,1,1,0,1,1,2,2,8,3,3,1,2,0
S01007506,Very bad health,5,0,0,0,0,0,2,0,1,2,0,0,0,0
S01007507,All people aged 16 to 74,669,34,7,27,104,59,127,44,147,95,32,21,11,27
S01007507,Very good health,272,11,1,10,54,33,38,20,52,33,10,4,6,21
S01007507,Good health,238,14,3,11,34,17,54,17,52,36,9,7,2,5
S01007507,Fair health,110,9,3,6,12,8,25,4,28,16,7,6,1,1
S01007507,Bad health,37,0,0,0,2,0,9,3,12,6,5,3,2,0
S01007507,Very bad health,12,0,0,0,2,1,1,0,3,4,1,1,0,0
S01007508,All people aged 16 to 74,545,28,4,24,86,56,114,47,107,71,20,17,3,16
S01007508,Very good health,257,8,1,7,38,24,54,21,53,37,8,6,2,14
S01007508,Good health,162,14,3,11,25,15,41,14,27,18,6,6,0,2
S01007508,Fair health,78,4,0,4,15,9,14,5,20,8,3,2,1,0
S01007508,Bad health,38,2,0,2,7,6,4,5,6,7,1,1,0,0
S01007508,Very bad health,10,0,0,0,1,2,1,2,1,1,2,2,0,0
S01007509,All people aged 16 to 74,479,34,6,28,89,42,121,34,83,36,21,14,7,19
S01007509,Very good health,206,17,0,17,40,16,48,15,34,14,6,2,4,16
S01007509,Good health,181,10,2,8,36,20,51,10,30,16,6,5,1,2
S01007509,Fair health,62,3,2,1,10,2,19,6,12,2,7,5,2,1
S01007509,Bad health,22,3,1,2,3,1,3,3,3,4,2,2,0,0
S01007509,Very bad health,8,1,1,0,0,3,0,0,4,0,0,0,0,0
S01007510,All people aged 16 to 74,723,32,3,29,125,60,155,60,157,69,28,18,10,37
S01007510,Very good health,306,16,1,15,54,35,60,22,55,28,10,5,5,26
S01007510,Good health,246,9,1,8,38,19,55,24,56,28,8,6,2,9
S01007510,Fair health,113,5,1,4,18,5,28,10,32,8,5,3,2,2
S01007510,Bad health,42,2,0,2,11,1,9,1,11,4,3,2,1,0
S01007510,Very bad health,16,0,0,0,4,0,3,3,3,1,2,2,0,0
S01007511,All people aged 16 to 74,612,14,1,13,68,43,93,40,161,111,55,42,13,27
S01007511,Very good health,229,7,0,7,28,17,35,12,60,34,19,12,7,17
S01007511,Good health,212,6,1,5,27,14,38,16,45,36,22,18,4,8
S01007511,Fair health,121,0,0,0,10,11,17,8,34,28,11,9,2,2
S01007511,Bad health,38,1,0,1,2,1,2,4,16,10,2,2,0,0
S01007511,Very bad health,12,0,0,0,1,0,1,0,6,3,1,1,0,0
S01007512,All people aged 16 to 74,394,23,8,15,89,28,96,25,71,29,17,10,7,16
S01007512,Very good health,168,11,4,7,43,13,40,9,25,10,6,5,1,11
S01007512,Good health,136,8,3,5,31,11,39,4,24,13,3,2,1,3
S01007512,Fair health,59,4,1,3,9,3,9,7,15,4,7,2,5,1
S01007512,Bad health,24,0,0,0,6,1,6,4,5,1,1,1,0,0
S01007512,Very bad health,7,0,0,0,0,0,2,1,2,1,0,0,0,1
S01007513,All people aged 16 to 74,761,33,12,21,101,64,73,79,189,135,60,41,19,27
S01007513,Very good health,342,16,4,12,43,31,29,30,94,60,14,7,7,25
S01007513,Good health,267,11,7,4,48,23,23,27,63,46,25,16,9,1
S01007513,Fair health,103,6,1,5,8,9,17,15,17,19,11,9,2,1
S01007513,Bad health,39,0,0,0,2,0,3,5,13,9,7,6,1,0
S01007513,Very bad health,10,0,0,0,0,1,1,2,2,1,3,3,0,0
S01007514,All people aged 16 to 74,399,10,3,7,70,34,51,55,81,61,20,11,9,17
S01007514,Very good health,184,5,2,3,35,18,23,24,25,29,11,6,5,14
S01007514,Good health,141,4,1,3,22,15,15,21,39,18,5,1,4,2
S01007514,Fair health,51,1,0,1,9,1,11,6,8,11,3,3,0,1
S01007514,Bad health,13,0,0,0,3,0,2,3,3,1,1,1,0,0
S01007514,Very bad health,10,0,0,0,1,0,0,1,6,2,0,0,0,0
S01007515,All people aged 16 to 74,422,34,7,27,127,56,52,33,53,37,14,8,6,16
S01007515,Very good health,211,17,4,13,60,31,18,20,27,18,5,3,2,15
S01007515,Good health,150,11,2,9,47,21,25,10,19,12,4,3,1,1
S01007515,Fair health,41,3,1,2,14,3,7,2,3,5,4,1,3,0
S01007515,Bad health,15,2,0,2,4,1,2,0,3,2,1,1,0,0
S01007515,Very bad health,5,1,0,1,2,0,0,1,1,0,0,0,0,0
S01007516,All people aged 16 to 74,424,15,2,13,45,36,43,49,118,77,28,19,9,13
S01007516,Very good health,196,8,0,8,19,24,15,22,54,32,12,9,3,10
S01007516,Good health,156,5,2,3,23,10,19,20,42,24,10,6,4,3
S01007516,Fair health,44,1,0,1,2,0,5,3,15,15,3,1,2,0
S01007516,Bad health,21,1,0,1,1,1,3,2,7,5,1,1,0,0
S01007516,Very bad health,7,0,0,0,0,1,1,2,0,1,2,2,0,0
S01007517,All people aged 16 to 74,315,19,3,16,61,43,38,26,72,34,14,11,3,8
S01007517,Very good health,121,7,1,6,33,18,14,8,19,12,3,1,2,7
S01007517,Good health,104,8,2,6,13,11,13,11,31,10,6,6,0,1
S01007517,Fair health,60,2,0,2,11,6,7,5,18,9,2,1,1,0
S01007517,Bad health,20,2,0,2,3,4,4,1,4,2,0,0,0,0
S01007517,Very bad health,10,0,0,0,1,4,0,1,0,1,3,3,0,0
S01007518,All people aged 16 to 74,611,11,3,8,87,47,67,65,137,132,39,25,14,26
S01007518,Very good health,264,3,0,3,51,18,23,36,62,47,6,2,4,18
S01007518,Good health,206,7,3,4,19,20,25,20,45,51,14,8,6,5
S01007518,Fair health,103,1,0,1,15,7,15,6,19,20,17,13,4,3
S01007518,Bad health,29,0,0,0,1,2,2,3,9,11,1,1,0,0
S01007518,Very bad health,9,0,0,0,1,0,2,0,2,3,1,1,0,0
S01007519,All people aged 16 to 74,338,33,8,25,76,38,76,20,51,23,10,7,3,11
S01007519,Very good health,143,9,1,8,37,17,34,8,20,6,2,2,0,10
S01007519,Good health,126,14,7,7,25,13,31,8,20,10,4,1,3,1
S01007519,Fair health,53,9,0,9,11,6,10,3,6,5,3,3,0,0
S01007519,Bad health,13,1,0,1,3,2,1,0,3,2,1,1,0,0
S01007519,Very bad health,3,0,0,0,0,0,0,1,2,0,0,0,0,0
S01007520,All people aged 16 to 74,706,40,8,32,109,65,121,45,152,104,32,14,18,38
S01007520,Very good health,314,21,8,13,46,27,53,18,65,42,9,3,6,33
S01007520,Good health,258,11,0,11,45,22,46,21,55,39,14,9,5,5
S01007520,Fair health,81,2,0,2,15,9,11,1,21,15,7,1,6,0
S01007520,Bad health,38,5,0,5,2,5,9,3,6,6,2,1,1,0
S01007520,Very bad health,15,1,0,1,1,2,2,2,5,2,0,0,0,0
S01007521,All people aged 16 to 74,344,35,9,26,64,31,71,34,66,22,4,3,1,17
S01007521,Very good health,173,19,4,15,31,11,32,21,33,10,2,1,1,14
S01007521,Good health,109,13,5,8,19,11,30,5,20,9,1,1,0,1
S01007521,Fair health,41,1,0,1,9,3,7,5,13,0,1,1,0,2
S01007521,Bad health,16,2,0,2,5,4,1,2,0,2,0,0,0,0
S01007521,Very bad health,5,0,0,0,0,2,1,1,0,1,0,0,0,0
S01007522,All people aged 16 to 74,676,50,13,37,138,57,99,60,141,78,28,16,12,25
S01007522,Very good health,310,29,6,23,69,25,49,23,56,29,12,5,7,18
S01007522,Good health,244,18,7,11,50,23,36,25,52,25,8,4,4,7
S01007522,Fair health,96,3,0,3,13,7,13,6,30,19,5,4,1,0
S01007522,Bad health,17,0,0,0,5,0,1,5,2,2,2,2,0,0
S01007522,Very bad health,9,0,0,0,1,2,0,1,1,3,1,1,0,0
S01007523,All people aged 16 to 74,404,36,6,30,85,35,76,24,67,42,19,15,4,20
S01007523,Very good health,203,24,4,20,42,19,29,13,32,20,7,5,2,17
S01007523,Good health,146,10,2,8,30,12,36,8,26,15,6,5,1,3
S01007523,Fair health,46,2,0,2,10,3,8,3,7,7,6,5,1,0
S01007523,Bad health,7,0,0,0,3,0,3,0,1,0,0,0,0,0
S01007523,Very bad health,2,0,0,0,0,1,0,0,1,0,0,0,0,0
S01007524,All people aged 16 to 74,721,45,6,39,135,68,157,63,126,78,23,16,7,26
S01007524,Very good health,363,24,3,21,73,33,75,34,56,37,11,8,3,20
S01007524,Good health,234,13,2,11,45,22,56,14,46,27,7,3,4,4
S01007524,Fair health,82,6,1,5,8,10,20,8,16,10,2,2,0,2
S01007524,Bad health,32,2,0,2,8,2,5,5,5,3,2,2,0,0
S01007524,Very bad health,10,0,0,0,1,1,1,2,3,1,1,1,0,0
S01007525,All people aged 16 to 74,375,21,7,14,62,36,51,40,90,58,11,5,6,6
S01007525,Very good health,151,6,1,5,33,14,18,19,33,19,5,1,4,4
S01007525,Good health,146,10,4,6,22,17,20,13,38,22,2,1,1,2
S01007525,Fair health,55,4,2,2,6,3,9,7,12,10,4,3,1,0
S01007525,Bad health,21,1,0,1,0,2,4,1,7,6,0,0,0,0
S01007525,Very bad health,2,0,0,0,1,0,0,0,0,1,0,0,0,0
S01007526,All people aged 16 to 74,521,30,13,17,95,54,71,42,93,83,29,21,8,24
S01007526,Very good health,215,15,7,8,41,22,27,19,27,36,9,8,1,19
S01007526,Good health,192,11,5,6,33,24,30,13,41,26,9,3,6,5
S01007526,Fair health,77,2,1,1,11,5,12,5,20,17,5,4,1,0
S01007526,Bad health,24,2,0,2,8,1,1,3,4,2,3,3,0,0
S01007526,Very bad health,13,0,0,0,2,2,1,2,1,2,3,3,0,0
S01007527,All people aged 16 to 74,582,38,8,30,107,58,86,63,107,88,18,10,8,17
S01007527,Very good health,268,22,4,18,49,35,36,32,39,33,6,4,2,16
S01007527,Good health,231,10,3,7,50,18,43,21,44,37,8,4,4,0
S01007527,Fair health,62,5,0,5,6,4,4,7,19,14,3,1,2,0
S01007527,Bad health,17,1,1,0,2,1,3,3,4,2,0,0,0,1
S01007527,Very bad health,4,0,0,0,0,0,0,0,1,2,1,1,0,0
S01007528,All people aged 16 to 74,544,25,3,22,88,36,67,58,115,97,33,24,9,25
S01007528,Very good health,222,17,2,15,42,9,29,29,43,24,10,7,3,19
S01007528,Good health,235,6,0,6,33,22,31,23,52,49,15,11,4,4
S01007528,Fair health,71,1,0,1,11,5,4,5,18,20,5,4,1,2
S01007528,Bad health,14,1,1,0,2,0,3,1,2,4,1,0,1,0
S01007528,Very bad health,2,0,0,0,0,0,0,0,0,0,2,2,0,0
S01007529,All people aged 16 to 74,476,46,12,34,117,51,72,28,84,42,11,4,7,25
S01007529,Very good health,221,22,4,18,60,26,31,14,26,18,3,1,2,21
S01007529,Good health,177,17,7,10,40,21,26,9,40,16,4,1,3,4
S01007529,Fair health,61,5,1,4,15,4,13,2,14,6,2,0,2,0
S01007529,Bad health,15,2,0,2,2,0,1,3,3,2,2,2,0,0
S01007529,Very bad health,2,0,0,0,0,0,1,0,1,0,0,0,0,0
S01007530,All people aged 16 to 74,392,33,5,28,77,47,88,25,64,31,6,4,2,21
S01007530,Very good health,213,17,1,16,41,27,42,12,32,22,1,1,0,19
S01007530,Good health,126,12,3,9,28,13,37,8,20,5,1,0,1,2
S01007530,Fair health,44,4,1,3,7,6,6,5,10,4,2,2,0,0
S01007530,Bad health,7,0,0,0,1,0,3,0,1,0,2,1,1,0
S01007530,Very bad health,2,0,0,0,0,1,0,0,1,0,0,0,0,0
S01007531,All people aged 16 to 74,518,21,4,17,124,51,108,29,92,43,17,12,5,33
S01007531,Very good health,273,12,1,11,68,22,59,17,47,17,4,2,2,27
S01007531,Good health,168,5,1,4,46,17,39,7,28,12,11,9,2,3
S01007531,Fair health,62,3,2,1,8,9,9,4,14,10,2,1,1,3
S01007531,Bad health,13,1,0,1,2,2,0,1,3,4,0,0,0,0
S01007531,Very bad health,2,0,0,0,0,1,1,0,0,0,0,0,0,0
S01007532,All people aged 16 to 74,438,30,6,24,80,37,96,36,72,48,15,10,5,24
S01007532,Very good health,218,15,2,13,45,16,52,17,32,18,6,4,2,17
S01007532,Good health,150,12,4,8,23,14,30,14,28,20,3,2,1,6
S01007532,Fair health,48,2,0,2,9,6,8,3,10,7,3,1,2,0
S01007532,Bad health,17,1,0,1,3,1,6,1,2,2,1,1,0,0
S01007532,Very bad health,5,0,0,0,0,0,0,1,0,1,2,2,0,1
S01007533,All people aged 16 to 74,407,18,5,13,76,44,107,22,77,26,15,8,7,22
S01007533,Very good health,219,13,4,9,43,24,61,10,33,7,8,4,4,20
S01007533,Good health,126,5,1,4,20,14,32,8,28,13,4,2,2,2
S01007533,Fair health,48,0,0,0,10,3,12,4,13,4,2,1,1,0
S01007533,Bad health,11,0,0,0,1,2,2,0,3,2,1,1,0,0
S01007533,Very bad health,3,0,0,0,2,1,0,0,0,0,0,0,0,0
S01007534,All people aged 16 to 74,681,35,11,24,104,61,83,54,150,126,30,21,9,38
S01007534,Very good health,312,23,6,17,49,30,47,17,59,50,8,5,3,29
S01007534,Good health,259,10,4,6,44,21,29,21,62,49,16,13,3,7
S01007534,Fair health,71,1,1,0,9,7,5,10,19,14,4,2,2,2
S01007534,Bad health,35,0,0,0,2,3,2,6,9,11,2,1,1,0
S01007534,Very bad health,4,1,0,1,0,0,0,0,1,2,0,0,0,0
S01007535,All people aged 16 to 74,735,39,11,28,118,90,85,58,157,88,56,36,20,44
S01007535,Very good health,329,19,5,14,58,39,35,33,62,32,17,7,10,34
S01007535,Good health,242,13,5,8,42,33,34,11,60,25,17,12,5,7
S01007535,Fair health,127,6,1,5,12,16,14,10,25,25,19,15,4,0
S01007535,Bad health,33,1,0,1,5,2,2,4,8,6,3,2,1,2
S01007535,Very bad health,4,0,0,0,1,0,0,0,2,0,0,0,0,1
S01007536,All people aged 16 to 74,675,31,5,26,97,78,81,71,155,105,26,15,11,31
S01007536,Very good health,316,15,3,12,54,38,35,30,68,40,12,7,5,24
S01007536,Good health,229,13,2,11,31,32,26,30,46,38,6,4,2,7
S01007536,Fair health,94,3,0,3,10,5,16,9,31,14,6,3,3,0
S01007536,Bad health,27,0,0,0,1,3,2,1,10,8,2,1,1,0
S01007536,Very bad health,9,0,0,0,1,0,2,1,0,5,0,0,0,0
S01007537,All people aged 16 to 74,718,54,8,46,124,79,86,65,126,125,30,21,9,29
S01007537,Very good health,346,28,2,26,65,44,37,27,59,53,9,5,4,24
S01007537,Good health,254,22,4,18,41,27,33,28,45,48,6,5,1,4
S01007537,Fair health,87,4,2,2,14,5,10,6,18,17,12,9,3,1
S01007537,Bad health,25,0,0,0,4,3,5,4,2,6,1,1,0,0
S01007537,Very bad health,6,0,0,0,0,0,1,0,2,1,2,1,1,0
S01007538,All people aged 16 to 74,661,37,3,34,138,72,131,45,122,65,21,14,7,30
S01007538,Very good health,325,24,2,22,80,28,63,26,53,20,6,4,2,25
S01007538,Good health,242,11,1,10,38,34,54,12,50,31,8,5,3,4
S01007538,Fair health,63,1,0,1,13,8,8,6,13,9,5,3,2,0
S01007538,Bad health,22,1,0,1,6,1,4,0,4,4,2,2,0,0
S01007538,Very bad health,9,0,0,0,1,1,2,1,2,1,0,0,0,1
S01007539,All people aged 16 to 74,454,41,10,31,120,67,67,29,66,37,9,3,6,18
S01007539,Very good health,243,22,5,17,70,37,28,17,32,18,5,1,4,14
S01007539,Good health,148,16,2,14,40,21,21,10,24,12,2,2,0,2
S01007539,Fair health,47,3,3,0,9,5,14,2,6,4,2,0,2,2
S01007539,Bad health,11,0,0,0,0,4,1,0,3,3,0,0,0,0
S01007539,Very bad health,5,0,0,0,1,0,3,0,1,0,0,0,0,0
S01007540,All people aged 16 to 74,604,25,7,18,90,75,65,54,136,115,22,13,9,22
S01007540,Very good health,244,13,2,11,43,34,27,20,49,40,6,3,3,12
S01007540,Good health,211,9,4,5,29,29,23,25,39,39,9,5,4,9
S01007540,Fair health,105,3,1,2,14,10,7,5,36,24,6,4,2,0
S01007540,Bad health,35,0,0,0,4,2,7,3,8,10,0,0,0,1
S01007540,Very bad health,9,0,0,0,0,0,1,1,4,2,1,1,0,0
S01007541,All people aged 16 to 74,530,27,7,20,121,65,56,52,97,79,12,7,5,21
S01007541,Very good health,257,12,3,9,64,36,22,24,41,35,4,3,1,19
S01007541,Good health,196,11,3,8,46,25,23,21,42,22,6,2,4,0
S01007541,Fair health,52,4,1,3,9,2,9,5,11,10,0,0,0,2
S01007541,Bad health,19,0,0,0,1,2,2,1,2,11,0,0,0,0
S01007541,Very bad health,6,0,0,0,1,0,0,1,1,1,2,2,0,0
S01007542,All people aged 16 to 74,632,23,6,17,103,61,74,52,134,113,39,16,23,33
S01007542,Very good health,270,13,3,10,51,24,31,25,53,40,8,5,3,25
S01007542,Good health,261,6,2,4,44,29,32,22,56,44,21,7,14,7
S01007542,Fair health,76,4,1,3,6,6,7,3,19,23,7,1,6,1
S01007542,Bad health,19,0,0,0,1,1,3,1,5,5,3,3,0,0
S01007542,Very bad health,6,0,0,0,1,1,1,1,1,1,0,0,0,0
S01007543,All people aged 16 to 74,811,22,4,18,104,73,77,78,216,165,34,13,21,42
S01007543,Very good health,378,12,0,12,56,37,40,32,90,62,16,8,8,33
S01007543,Good health,265,8,3,5,37,20,21,28,73,58,12,3,9,8
S01007543,Fair health,118,0,0,0,7,13,10,12,37,34,5,1,4,0
S01007543,Bad health,42,2,1,1,3,3,4,5,15,9,0,0,0,1
S01007543,Very bad health,8,0,0,0,1,0,2,1,1,2,1,1,0,0
S01007544,All people aged 16 to 74,728,94,19,75,174,78,173,35,79,46,16,11,5,33
S01007544,Very good health,360,47,5,42,78,39,87,13,44,22,6,4,2,24
S01007544,Good health,269,39,12,27,67,31,59,17,26,17,7,4,3,6
S01007544,Fair health,80,6,2,4,25,7,22,3,6,6,2,2,0,3
S01007544,Bad health,17,2,0,2,4,1,3,2,3,1,1,1,0,0
S01007544,Very bad health,2,0,0,0,0,0,2,0,0,0,0,0,0,0
S01007545,All people aged 16 to 74,596,51,12,39,118,69,131,42,88,54,11,7,4,32
S01007545,Very good health,303,33,4,29,58,31,72,19,31,28,2,2,0,29
S01007545,Good health,205,16,7,9,43,25,40,17,39,16,6,4,2,3
S01007545,Fair health,62,2,1,1,14,11,13,2,12,7,1,0,1,0
S01007545,Bad health,17,0,0,0,2,1,4,3,4,1,2,1,1,0
S01007545,Very bad health,9,0,0,0,1,1,2,1,2,2,0,0,0,0
S01007546,All people aged 16 to 74,416,31,5,26,91,54,89,33,46,39,9,4,5,24
S01007546,Very good health,224,23,5,18,57,30,50,15,17,12,2,0,2,18
S01007546,Good health,123,8,0,8,24,17,19,11,20,16,3,1,2,5
S01007546,Fair health,53,0,0,0,8,5,16,6,6,7,4,3,1,1
S01007546,Bad health,13,0,0,0,1,1,4,1,3,3,0,0,0,0
S01007546,Very bad health,3,0,0,0,1,1,0,0,0,1,0,0,0,0
S01007547,All people aged 16 to 74,425,40,8,32,87,38,101,23,70,35,11,3,8,20
S01007547,Very good health,220,25,5,20,40,21,56,8,30,19,5,3,2,16
S01007547,Good health,135,10,2,8,35,9,34,7,22,11,4,0,4,3
S01007547,Fair health,47,3,0,3,7,7,6,5,14,3,2,0,2,0
S01007547,Bad health,15,2,1,1,4,1,3,0,3,2,0,0,0,0
S01007547,Very bad health,8,0,0,0,1,0,2,3,1,0,0,0,0,1
S01007548,All people aged 16 to 74,528,23,4,19,112,58,79,53,93,66,22,9,13,22
S01007548,Very good health,215,8,1,7,56,24,30,20,33,23,6,5,1,15
S01007548,Good health,215,10,1,9,41,27,34,20,42,24,11,1,10,6
S01007548,Fair health,76,3,1,2,11,4,13,10,16,14,4,2,2,1
S01007548,Bad health,20,2,1,1,3,3,2,2,2,5,1,1,0,0
S01007548,Very bad health,2,0,0,0,1,0,0,1,0,0,0,0,0,0
S01007549,All people aged 16 to 74,442,36,12,24,93,51,80,35,65,45,13,7,6,24
S01007549,Very good health,175,17,3,14,40,19,35,14,22,9,6,4,2,13
S01007549,Good health,179,13,6,7,37,21,33,11,29,20,5,2,3,10
S01007549,Fair health,71,5,2,3,13,8,10,9,11,12,2,1,1,1
S01007549,Bad health,16,1,1,0,3,3,1,1,3,4,0,0,0,0
S01007549,Very bad health,1,0,0,0,0,0,1,0,0,0,0,0,0,0
S01007550,All people aged 16 to 74,650,68,11,57,136,66,110,50,111,69,15,10,5,25
S01007550,Very good health,282,33,3,30,61,29,42,20,49,18,8,5,3,22
S01007550,Good health,225,23,6,17,51,20,43,18,34,30,3,2,1,3
S01007550,Fair health,91,8,1,7,13,10,21,6,17,13,3,2,1,0
S01007550,Bad health,40,4,1,3,9,5,3,3,9,6,1,1,0,0
S01007550,Very bad health,12,0,0,0,2,2,1,3,2,2,0,0,0,0
S01007551,All people aged 16 to 74,688,72,16,56,141,64,185,35,79,56,26,19,7,30
S01007551,Very good health,341,46,11,35,74,30,76,19,31,30,8,7,1,27
S01007551,Good health,217,21,3,18,51,23,67,7,22,14,10,6,4,2
S01007551,Fair health,100,3,2,1,13,8,34,6,18,11,6,4,2,1
S01007551,Bad health,23,2,0,2,3,2,6,1,7,1,1,1,0,0
S01007551,Very bad health,7,0,0,0,0,1,2,2,1,0,1,1,0,0
S01007552,All people aged 16 to 74,689,17,6,11,71,49,61,83,166,138,53,31,22,51
S01007552,Very good health,272,8,4,4,37,21,18,33,55,52,19,10,9,29
S01007552,Good health,243,6,1,5,23,17,19,25,72,41,21,10,11,19
S01007552,Fair health,113,2,1,1,8,10,17,21,23,21,9,7,2,2
S01007552,Bad health,47,1,0,1,3,1,7,4,9,18,3,3,0,1
S01007552,Very bad health,14,0,0,0,0,0,0,0,7,6,1,1,0,0
S01007553,All people aged 16 to 74,653,14,2,12,66,47,33,84,162,155,63,43,20,29
S01007553,Very good health,225,7,1,6,36,20,11,23,46,41,22,17,5,19
S01007553,Good health,213,5,0,5,18,19,9,27,64,45,20,14,6,6
S01007553,Fair health,133,1,1,0,7,5,8,18,34,43,14,6,8,3
S01007553,Bad health,62,1,0,1,2,3,4,13,15,17,6,5,1,1
S01007553,Very bad health,20,0,0,0,3,0,1,3,3,9,1,1,0,0
S01007554,All people aged 16 to 74,334,4,3,1,21,17,14,31,102,98,27,20,7,20
S01007554,Very good health,98,0,0,0,5,6,4,8,28,23,9,7,2,15
S01007554,Good health,115,1,0,1,10,11,7,9,38,22,15,10,5,2
S01007554,Fair health,66,2,2,0,2,0,2,8,24,27,0,0,0,1
S01007554,Bad health,42,0,0,0,2,0,0,4,9,23,3,3,0,1
S01007554,Very bad health,13,1,1,0,2,0,1,2,3,3,0,0,0,1
S01007555,All people aged 16 to 74,379,21,3,18,73,38,42,40,73,66,13,6,7,13
S01007555,Very good health,172,10,2,8,37,15,20,17,28,28,4,2,2,13
S01007555,Good health,144,9,1,8,26,14,17,13,35,24,6,3,3,0
S01007555,Fair health,53,2,0,2,10,5,5,8,8,13,2,0,2,0
S01007555,Bad health,8,0,0,0,0,4,0,1,1,1,1,1,0,0
S01007555,Very bad health,2,0,0,0,0,0,0,1,1,0,0,0,0,0
S01007556,All people aged 16 to 74,345,11,4,7,30,29,35,38,87,68,29,16,13,18
S01007556,Very good health,136,3,0,3,12,15,12,15,31,26,7,3,4,15
S01007556,Good health,127,5,2,3,11,7,17,14,34,22,14,10,4,3
S01007556,Fair health,54,3,2,1,4,6,3,4,15,12,7,2,5,0
S01007556,Bad health,22,0,0,0,2,1,3,4,4,7,1,1,0,0
S01007556,Very bad health,6,0,0,0,1,0,0,1,3,1,0,0,0,0
S01007557,All people aged 16 to 74,810,16,8,8,75,69,46,82,214,196,55,36,19,57
S01007557,Very good health,334,8,3,5,33,41,15,32,78,68,18,11,7,41
S01007557,Good health,281,5,3,2,25,21,19,29,86,66,17,10,7,13
S01007557,Fair health,121,2,2,0,12,4,7,14,36,32,12,8,4,2
S01007557,Bad health,58,1,0,1,3,2,4,7,12,23,6,5,1,0
S01007557,Very bad health,16,0,0,0,2,1,1,0,2,7,2,2,0,1
S01007558,All people aged 16 to 74,339,16,4,12,74,26,65,34,55,37,16,9,7,16
S01007558,Very good health,129,3,0,3,36,8,32,9,14,11,4,3,1,12
S01007558,Good health,133,11,3,8,23,17,17,19,26,11,5,1,4,4
S01007558,Fair health,53,2,1,1,11,1,12,4,12,8,3,2,1,0
S01007558,Bad health,20,0,0,0,4,0,3,1,2,6,4,3,1,0
S01007558,Very bad health,4,0,0,0,0,0,1,1,1,1,0,0,0,0
S01007559,All people aged 16 to 74,529,55,12,43,117,57,94,46,77,40,16,9,7,27
S01007559,Very good health,305,34,8,26,71,32,50,26,40,21,7,5,2,24
S01007559,Good health,156,18,4,14,30,17,32,16,27,11,3,2,1,2
S01007559,Fair health,51,3,0,3,9,6,10,4,7,6,5,2,3,1
S01007559,Bad health,15,0,0,0,6,1,2,0,3,2,1,0,1,0
S01007559,Very bad health,2,0,0,0,1,1,0,0,0,0,0,0,0,0
S01007560,All people aged 16 to 74,648,45,10,35,109,87,77,61,127,101,19,14,5,22
S01007560,Very good health,291,23,5,18,53,43,37,30,52,30,7,4,3,16
S01007560,Good health,235,14,1,13,48,33,26,13,49,42,5,3,2,5
S01007560,Fair health,85,5,3,2,6,5,9,13,19,24,3,3,0,1
S01007560,Bad health,28,3,1,2,2,4,4,1,6,4,4,4,0,0
S01007560,Very bad health,9,0,0,0,0,2,1,4,1,1,0,0,0,0
S01007561,All people aged 16 to 74,497,20,5,15,85,65,47,40,121,73,23,18,5,23
S01007561,Very good health,207,12,1,11,41,28,24,11,44,25,5,4,1,17
S01007561,Good health,186,6,3,3,30,26,17,19,48,29,5,3,2,6
S01007561,Fair health,73,1,0,1,11,7,4,8,20,12,10,8,2,0
S01007561,Bad health,22,0,0,0,3,3,1,2,6,6,1,1,0,0
S01007561,Very bad health,9,1,1,0,0,1,1,0,3,1,2,2,0,0
S01007562,All people aged 16 to 74,631,49,9,40,135,70,101,38,124,62,15,10,5,37
S01007562,Very good health,290,30,4,26,63,26,48,22,54,17,6,4,2,24
S01007562,Good health,231,17,4,13,46,29,36,5,56,24,6,3,3,12
S01007562,Fair health,76,1,0,1,20,12,12,8,10,12,1,1,0,0
S01007562,Bad health,28,1,1,0,5,3,5,2,4,5,2,2,0,1
S01007562,Very bad health,6,0,0,0,1,0,0,1,0,4,0,0,0,0
S01007563,All people aged 16 to 74,636,49,10,39,164,69,119,35,102,45,14,9,5,39
S01007563,Very good health,309,30,7,23,91,30,43,15,41,17,7,4,3,35
S01007563,Good health,220,13,2,11,49,24,55,11,44,18,3,2,1,3
S01007563,Fair health,69,5,1,4,14,13,14,6,9,5,2,1,1,1
S01007563,Bad health,26,1,0,1,5,1,6,2,6,3,2,2,0,0
S01007563,Very bad health,12,0,0,0,5,1,1,1,2,2,0,0,0,0
S01007564,All people aged 16 to 74,580,50,7,43,133,61,124,31,86,43,16,10,6,36
S01007564,Very good health,290,26,4,22,72,34,62,15,38,14,1,0,1,28
S01007564,Good health,190,17,3,14,36,19,40,14,31,19,7,2,5,7
S01007564,Fair health,72,7,0,7,19,7,15,2,11,5,6,6,0,0
S01007564,Bad health,23,0,0,0,6,1,6,0,2,5,2,2,0,1
S01007564,Very bad health,5,0,0,0,0,0,1,0,4,0,0,0,0,0
S01007565,All people aged 16 to 74,723,58,9,49,137,79,95,51,152,82,29,18,11,40
S01007565,Very good health,351,37,5,32,71,45,41,25,63,27,9,7,2,33
S01007565,Good health,245,16,3,13,50,24,36,15,50,36,11,4,7,7
S01007565,Fair health,88,5,1,4,9,8,14,6,25,15,6,4,2,0
S01007565,Bad health,33,0,0,0,6,1,3,4,13,3,3,3,0,0
S01007565,Very bad health,6,0,0,0,1,1,1,1,1,1,0,0,0,0
S01007566,All people aged 16 to 74,565,32,8,24,104,53,99,40,105,69,18,13,5,45
S01007566,Very good health,287,18,7,11,61,28,50,17,52,25,8,7,1,28
S01007566,Good health,198,9,0,9,33,16,38,12,36,35,3,2,1,16
S01007566,Fair health,55,3,0,3,5,6,7,6,15,8,4,2,2,1
S01007566,Bad health,18,2,1,1,4,2,2,3,2,0,3,2,1,0
S01007566,Very bad health,7,0,0,0,1,1,2,2,0,1,0,0,0,0
S01007567,All people aged 16 to 74,457,28,9,19,118,45,89,36,61,37,10,6,4,33
S01007567,Very good health,242,17,3,14,58,28,43,16,26,18,4,2,2,32
S01007567,Good health,159,8,5,3,49,13,35,16,23,13,1,1,0,1
S01007567,Fair health,40,3,1,2,9,2,8,2,8,4,4,3,1,0
S01007567,Bad health,13,0,0,0,2,1,3,2,3,1,1,0,1,0
S01007567,Very bad health,3,0,0,0,0,1,0,0,1,1,0,0,0,0
S01007568,All people aged 16 to 74,508,47,18,29,125,65,73,51,67,49,11,9,2,20
S01007568,Very good health,256,29,12,17,77,34,35,24,25,16,2,1,1,14
S01007568,Good health,178,16,6,10,37,22,30,16,30,18,4,3,1,5
S01007568,Fair health,54,1,0,1,7,6,7,10,9,9,4,4,0,1
S01007568,Bad health,16,1,0,1,3,2,1,1,3,4,1,1,0,0
S01007568,Very bad health,4,0,0,0,1,1,0,0,0,2,0,0,0,0
S01007569,All people aged 16 to 74,597,27,5,22,120,66,82,47,127,82,12,9,3,34
S01007569,Very good health,285,12,1,11,60,33,34,22,57,38,4,3,1,25
S01007569,Good health,205,11,4,7,41,23,38,14,45,26,1,1,0,6
S01007569,Fair health,77,4,0,4,13,8,7,7,18,11,7,5,2,2
S01007569,Bad health,23,0,0,0,4,2,3,3,5,5,0,0,0,1
S01007569,Very bad health,7,0,0,0,2,0,0,1,2,2,0,0,0,0
S01007570,All people aged 16 to 74,526,65,20,45,120,66,57,42,87,51,18,7,11,20
S01007570,Very good health,254,37,11,26,53,27,32,17,41,25,5,3,2,17
S01007570,Good health,177,23,8,15,42,29,12,14,27,20,8,1,7,2
S01007570,Fair health,70,3,1,2,22,8,9,8,11,6,3,2,1,0
S01007570,Bad health,18,2,0,2,2,1,2,2,7,0,1,1,0,1
S01007570,Very bad health,7,0,0,0,1,1,2,1,1,0,1,0,1,0
S01007571,All people aged 16 to 74,413,44,12,32,112,39,71,22,60,30,7,5,2,28
S01007571,Very good health,201,19,5,14,69,18,31,9,25,13,1,0,1,16
S01007571,Good health,136,20,5,15,26,16,26,9,21,7,3,2,1,8
S01007571,Fair health,59,5,2,3,14,4,11,2,11,7,2,2,0,3
S01007571,Bad health,10,0,0,0,1,1,1,1,2,2,1,1,0,1
S01007571,Very bad health,7,0,0,0,2,0,2,1,1,1,0,0,0,0
S01007572,All people aged 16 to 74,648,37,10,27,117,98,72,55,111,90,37,22,15,31
S01007572,Very good health,306,18,3,15,64,51,31,32,53,28,6,3,3,23
S01007572,Good health,246,14,5,9,38,39,36,17,40,39,17,6,11,6
S01007572,Fair health,64,3,1,2,8,6,3,4,13,16,9,8,1,2
S01007572,Bad health,23,2,1,1,7,2,1,1,4,2,4,4,0,0
S01007572,Very bad health,9,0,0,0,0,0,1,1,1,5,1,1,0,0
S01007573,All people aged 16 to 74,633,56,14,42,193,101,40,59,95,54,8,7,1,27
S01007573,Very good health,384,33,6,27,120,62,20,36,54,33,3,3,0,23
S01007573,Good health,191,19,6,13,54,30,17,19,33,13,3,2,1,3
S01007573,Fair health,46,2,2,0,18,6,2,2,7,6,2,2,0,1
S01007573,Bad health,11,2,0,2,1,2,1,2,1,2,0,0,0,0
S01007573,Very bad health,1,0,0,0,0,1,0,0,0,0,0,0,0,0
S01007574,All people aged 16 to 74,750,11,3,8,96,94,37,64,195,166,37,21,16,50
S01007574,Very good health,336,3,0,3,51,41,17,29,73,69,15,11,4,38
S01007574,Good health,237,5,2,3,28,29,11,14,77,50,12,7,5,11
S01007574,Fair health,125,2,0,2,14,14,6,12,35,33,8,1,7,1
S01007574,Bad health,40,1,1,0,3,7,2,6,8,11,2,2,0,0
S01007574,Very bad health,12,0,0,0,0,3,1,3,2,3,0,0,0,0
S01007575,All people aged 16 to 74,616,9,1,8,70,60,39,60,141,159,54,29,25,24
S01007575,Very good health,200,4,0,4,33,22,12,12,51,35,19,12,7,12
S01007575,Good health,249,3,1,2,23,26,15,33,53,65,22,14,8,9
S01007575,Fair health,117,1,0,1,9,9,6,13,27,41,8,3,5,3
S01007575,Bad health,41,1,0,1,3,3,5,2,6,16,5,0,5,0
S01007575,Very bad health,9,0,0,0,2,0,1,0,4,2,0,0,0,0
S01007576,All people aged 16 to 74,498,11,1,10,33,35,20,44,122,115,97,54,43,21
S01007576,Very good health,189,4,1,3,10,14,5,18,53,38,29,17,12,18
S01007576,Good health,163,6,0,6,12,12,7,12,43,35,34,18,16,2
S01007576,Fair health,101,1,0,1,7,8,6,8,19,29,22,10,12,1
S01007576,Bad health,30,0,0,0,2,1,1,2,6,11,7,4,3,0
S01007576,Very bad health,15,0,0,0,2,0,1,4,1,2,5,5,0,0
S01007577,All people aged 16 to 74,492,9,0,9,44,43,16,41,127,129,45,25,20,38
S01007577,Very good health,172,2,0,2,16,16,4,17,46,36,13,3,10,22
S01007577,Good health,194,4,0,4,20,18,9,13,49,47,21,13,8,13
S01007577,Fair health,79,2,0,2,6,3,2,8,19,33,3,2,1,3
S01007577,Bad health,33,1,0,1,0,4,1,2,10,9,6,5,1,0
S01007577,Very bad health,14,0,0,0,2,2,0,1,3,4,2,2,0,0
S01007578,All people aged 16 to 74,494,8,4,4,28,44,25,55,144,121,42,28,14,27
S01007578,Very good health,191,4,2,2,12,17,11,20,60,36,14,9,5,17
S01007578,Good health,169,2,1,1,10,19,7,20,45,45,13,10,3,8
S01007578,Fair health,86,2,1,1,5,5,4,8,26,26,8,4,4,2
S01007578,Bad health,37,0,0,0,1,3,3,4,10,11,5,3,2,0
S01007578,Very bad health,11,0,0,0,0,0,0,3,3,3,2,2,0,0
S01007579,All people aged 16 to 74,456,9,3,6,58,51,13,35,120,99,35,19,16,36
S01007579,Very good health,172,3,1,2,23,20,4,11,41,37,11,7,4,22
S01007579,Good health,180,5,2,3,21,20,5,14,55,37,11,5,6,12
S01007579,Fair health,70,0,0,0,13,5,0,7,18,14,11,5,6,2
S01007579,Bad health,27,1,0,1,1,4,3,2,5,9,2,2,0,0
S01007579,Very bad health,7,0,0,0,0,2,1,1,1,2,0,0,0,0
S01007580,All people aged 16 to 74,586,8,4,4,52,41,22,62,146,137,55,39,16,63
S01007580,Very good health,247,5,3,2,23,11,8,25,62,56,19,11,8,38
S01007580,Good health,214,1,0,1,19,18,8,25,53,54,16,9,7,20
S01007580,Fair health,82,1,1,0,8,9,4,8,19,16,13,13,0,4
S01007580,Bad health,32,0,0,0,2,3,1,3,9,9,5,5,0,0
S01007580,Very bad health,11,1,0,1,0,0,1,1,3,2,2,1,1,1
S01007581,All people aged 16 to 74,368,6,2,4,33,32,24,50,85,85,34,25,9,19
S01007581,Very good health,135,1,1,0,10,15,10,18,26,34,8,5,3,13
S01007581,Good health,156,3,0,3,15,13,10,22,43,31,14,9,5,5
S01007581,Fair health,51,2,1,1,5,3,3,7,9,12,9,8,1,1
S01007581,Bad health,19,0,0,0,3,1,1,0,6,5,3,3,0,0
S01007581,Very bad health,7,0,0,0,0,0,0,3,1,3,0,0,0,0
S01007582,All people aged 16 to 74,486,9,1,8,52,50,33,54,113,105,39,26,13,31
S01007582,Very good health,201,2,0,2,25,21,10,25,35,41,18,8,10,24
S01007582,Good health,182,5,1,4,18,18,16,20,50,33,16,13,3,6
S01007582,Fair health,72,2,0,2,5,9,3,7,22,20,3,3,0,1
S01007582,Bad health,27,0,0,0,4,2,4,1,5,9,2,2,0,0
S01007582,Very bad health,4,0,0,0,0,0,0,1,1,2,0,0,0,0
S01007583,All people aged 16 to 74,755,16,4,12,68,62,41,71,206,182,70,44,26,39
S01007583,Very good health,306,7,2,5,32,29,16,20,95,55,24,14,10,28
S01007583,Good health,257,6,2,4,18,22,14,35,67,63,22,9,13,10
S01007583,Fair health,108,1,0,1,9,8,6,11,22,39,12,9,3,0
S01007583,Bad health,65,1,0,1,5,3,5,3,20,18,9,9,0,1
S01007583,Very bad health,19,1,0,1,4,0,0,2,2,7,3,3,0,0
S01007584,All people aged 16 to 74,435,19,5,14,54,43,31,40,95,95,31,18,13,27
S01007584,Very good health,183,10,3,7,27,20,18,15,40,28,6,5,1,19
S01007584,Good health,166,8,2,6,17,16,10,17,41,37,14,7,7,6
S01007584,Fair health,57,0,0,0,10,5,2,7,9,15,8,4,4,1
S01007584,Bad health,22,1,0,1,0,1,1,1,4,11,2,1,1,1
S01007584,Very bad health,7,0,0,0,0,1,0,0,1,4,1,1,0,0
S01007585,All people aged 16 to 74,640,42,10,32,122,97,50,56,115,109,12,6,6,37
S01007585,Very good health,296,22,5,17,66,43,19,28,49,38,4,2,2,27
S01007585,Good health,249,16,4,12,43,45,22,17,48,47,3,1,2,8
S01007585,Fair health,73,4,1,3,10,5,6,9,16,17,4,2,2,2
S01007585,Bad health,16,0,0,0,2,2,3,2,1,5,1,1,0,0
S01007585,Very bad health,6,0,0,0,1,2,0,0,1,2,0,0,0,0
S01007586,All people aged 16 to 74,611,17,5,12,92,65,33,49,166,118,35,16,19,36
S01007586,Very good health,255,9,1,8,47,27,15,15,71,36,11,6,5,24
S01007586,Good health,227,6,2,4,32,25,15,17,67,47,9,2,7,9
S01007586,Fair health,73,1,1,0,7,7,2,7,13,21,13,6,7,2
S01007586,Bad health,40,1,1,0,4,4,1,8,10,11,1,1,0,0
S01007586,Very bad health,16,0,0,0,2,2,0,2,5,3,1,1,0,1
S01007587,All people aged 16 to 74,618,44,7,37,129,72,62,57,85,98,52,45,7,19
S01007587,Very good health,272,22,5,17,71,29,26,27,34,38,10,7,3,15
S01007587,Good health,236,16,1,15,49,33,17,19,32,41,25,22,3,4
S01007587,Fair health,77,4,1,3,8,7,10,7,13,14,14,13,1,0
S01007587,Bad health,20,2,0,2,1,2,5,2,4,4,0,0,0,0
S01007587,Very bad health,13,0,0,0,0,1,4,2,2,1,3,3,0,0
S01007588,All people aged 16 to 74,609,81,15,66,177,76,55,34,65,53,13,11,2,55
S01007588,Very good health,343,48,9,39,101,41,30,16,31,22,6,5,1,48
S01007588,Good health,196,27,3,24,55,29,21,11,29,15,5,4,1,4
S01007588,Fair health,54,6,3,3,17,6,3,4,3,11,2,2,0,2
S01007588,Bad health,13,0,0,0,4,0,1,2,1,4,0,0,0,1
S01007588,Very bad health,3,0,0,0,0,0,0,1,1,1,0,0,0,0
S01007589,All people aged 16 to 74,610,45,11,34,151,90,42,36,92,63,35,25,10,56
S01007589,Very good health,316,27,9,18,84,45,16,21,42,33,9,7,2,39
S01007589,Good health,214,14,2,12,46,35,19,10,32,23,20,14,6,15
S01007589,Fair health,63,4,0,4,15,7,6,3,15,6,5,3,2,2
S01007589,Bad health,14,0,0,0,6,3,1,1,1,1,1,1,0,0
S01007589,Very bad health,3,0,0,0,0,0,0,1,2,0,0,0,0,0
S01007590,All people aged 16 to 74,449,71,15,56,127,66,42,28,49,32,5,4,1,29
S01007590,Very good health,251,38,6,32,76,33,26,13,22,14,5,4,1,24
S01007590,Good health,150,29,9,20,43,25,11,10,17,11,0,0,0,4
S01007590,Fair health,40,4,0,4,6,6,4,5,9,5,0,0,0,1
S01007590,Bad health,7,0,0,0,2,2,1,0,0,2,0,0,0,0
S01007590,Very bad health,1,0,0,0,0,0,0,0,1,0,0,0,0,0
S01007591,All people aged 16 to 74,452,33,3,30,100,64,31,40,76,73,15,11,4,20
S01007591,Very good health,214,18,2,16,50,32,16,14,40,28,4,3,1,12
S01007591,Good health,164,13,1,12,38,17,6,23,26,28,5,3,2,8
S01007591,Fair health,57,1,0,1,11,12,8,3,8,12,2,2,0,0
S01007591,Bad health,10,0,0,0,0,2,0,0,1,4,3,2,1,0
S01007591,Very bad health,7,1,0,1,1,1,1,0,1,1,1,1,0,0
S01007592,All people aged 16 to 74,524,21,2,19,78,62,20,44,129,110,31,15,16,29
S01007592,Very good health,213,11,1,10,38,24,12,18,46,34,9,6,3,21
S01007592,Good health,185,7,1,6,21,26,5,11,46,46,15,3,12,8
S01007592,Fair health,85,3,0,3,16,6,1,7,27,21,4,4,0,0
S01007592,Bad health,34,0,0,0,3,5,1,5,9,9,2,2,0,0
S01007592,Very bad health,7,0,0,0,0,1,1,3,1,0,1,0,1,0
S01007593,All people aged 16 to 74,783,70,17,53,170,95,67,88,140,96,18,11,7,39
S01007593,Very good health,384,46,13,33,76,44,28,49,58,50,6,2,4,27
S01007593,Good health,268,22,4,18,68,31,32,27,45,27,8,5,3,8
S01007593,Fair health,91,2,0,2,15,14,6,8,28,13,2,2,0,3
S01007593,Bad health,32,0,0,0,9,4,1,4,7,4,2,2,0,1
S01007593,Very bad health,8,0,0,0,2,2,0,0,2,2,0,0,0,0
S01007594,All people aged 16 to 74,615,43,14,29,136,91,77,48,101,69,12,9,3,38
S01007594,Very good health,287,23,6,17,71,43,38,26,37,20,1,1,0,28
S01007594,Good health,234,15,5,10,49,40,22,18,44,31,6,3,3,9
S01007594,Fair health,61,4,2,2,14,6,10,3,11,11,1,1,0,1
S01007594,Bad health,26,1,1,0,2,0,5,1,9,6,2,2,0,0
S01007594,Very bad health,7,0,0,0,0,2,2,0,0,1,2,2,0,0
S01007595,All people aged 16 to 74,811,67,12,55,177,73,153,59,122,80,44,35,9,36
S01007595,Very good health,397,39,7,32,99,39,76,26,47,30,14,13,1,27
S01007595,Good health,287,22,4,18,56,24,52,23,51,32,20,14,6,7
S01007595,Fair health,85,4,1,3,16,8,19,8,11,10,7,5,2,2
S01007595,Bad health,25,0,0,0,3,2,5,1,7,4,3,3,0,0
S01007595,Very bad health,17,2,0,2,3,0,1,1,6,4,0,0,0,0
S01007596,All people aged 16 to 74,416,31,12,19,78,42,81,35,68,49,13,10,3,19
S01007596,Very good health,173,20,5,15,35,12,40,10,22,20,3,3,0,11
S01007596,Good health,141,7,5,2,22,14,30,12,26,19,7,5,2,4
S01007596,Fair health,60,2,2,0,10,13,7,8,12,3,2,1,1,3
S01007596,Bad health,36,2,0,2,9,2,3,5,7,6,1,1,0,1
S01007596,Very bad health,6,0,0,0,2,1,1,0,1,1,0,0,0,0
S01007597,All people aged 16 to 74,487,44,13,31,121,55,72,36,72,42,8,2,6,37
S01007597,Very good health,248,22,4,18,65,27,33,17,31,21,4,2,2,28
S01007597,Good health,178,20,7,13,44,21,26,14,24,16,4,0,4,9
S01007597,Fair health,45,1,1,0,11,6,10,3,11,3,0,0,0,0
S01007597,Bad health,12,1,1,0,1,1,3,1,4,1,0,0,0,0
S01007597,Very bad health,4,0,0,0,0,0,0,1,2,1,0,0,0,0
S01007598,All people aged 16 to 74,501,43,11,32,122,56,65,46,64,49,16,11,5,40
S01007598,Very good health,260,25,7,18,62,27,27,23,31,27,3,3,0,35
S01007598,Good health,164,13,3,10,35,21,31,17,22,17,6,3,3,2
S01007598,Fair health,58,3,1,2,20,7,6,5,8,2,4,2,2,3
S01007598,Bad health,14,2,0,2,4,1,1,1,1,2,2,2,0,0
S01007598,Very bad health,5,0,0,0,1,0,0,0,2,1,1,1,0,0
S01007599,All people aged 16 to 74,641,54,11,43,155,71,40,37,115,79,26,18,8,64
S01007599,Very good health,301,26,5,21,74,34,15,23,42,30,5,3,2,52
S01007599,Good health,214,23,6,17,51,26,20,7,44,21,12,8,4,10
S01007599,Fair health,79,4,0,4,20,6,3,4,23,13,5,3,2,1
S01007599,Bad health,35,1,0,1,9,4,1,2,5,10,2,2,0,1
S01007599,Very bad health,12,0,0,0,1,1,1,1,1,5,2,2,0,0
S01007600,All people aged 16 to 74,811,130,20,110,195,98,66,63,94,82,31,26,5,52
S01007600,Very good health,424,89,12,77,112,56,26,28,27,38,9,9,0,39
S01007600,Good health,230,30,6,24,45,24,30,23,36,24,11,6,5,7
S01007600,Fair health,104,11,2,9,24,14,7,7,19,12,6,6,0,4
S01007600,Bad health,39,0,0,0,7,2,2,4,10,8,4,4,0,2
S01007600,Very bad health,14,0,0,0,7,2,1,1,2,0,1,1,0,0
S01007601,All people aged 16 to 74,503,34,10,24,139,64,28,46,87,71,11,2,9,23
S01007601,Very good health,280,18,3,15,85,27,15,28,48,35,6,0,6,18
S01007601,Good health,168,12,5,7,44,29,11,11,31,24,2,0,2,4
S01007601,Fair health,40,4,2,2,6,7,2,5,6,8,1,1,0,1
S01007601,Bad health,12,0,0,0,4,1,0,0,2,4,1,0,1,0
S01007601,Very bad health,3,0,0,0,0,0,0,2,0,0,1,1,0,0
S01007602,All people aged 16 to 74,501,33,9,24,128,92,29,46,73,56,12,9,3,32
S01007602,Very good health,265,10,2,8,65,50,16,25,41,24,8,6,2,26
S01007602,Good health,181,16,6,10,48,36,9,17,26,23,2,2,0,4
S01007602,Fair health,42,6,1,5,12,5,3,4,5,5,1,0,1,1
S01007602,Bad health,9,1,0,1,2,0,0,0,1,3,1,1,0,1
S01007602,Very bad health,4,0,0,0,1,1,1,0,0,1,0,0,0,0
S01007603,All people aged 16 to 74,616,56,13,43,208,99,32,48,81,48,12,6,6,32
S01007603,Very good health,362,30,5,25,118,71,19,29,43,28,2,1,1,22
S01007603,Good health,195,21,8,13,79,19,11,14,26,14,3,3,0,8
S01007603,Fair health,49,5,0,5,8,8,1,4,11,4,7,2,5,1
S01007603,Bad health,9,0,0,0,3,0,1,1,1,2,0,0,0,1
S01007603,Very bad health,1,0,0,0,0,1,0,0,0,0,0,0,0,0
S01007604,All people aged 16 to 74,666,61,22,39,183,119,41,59,97,57,13,7,6,36
S01007604,Very good health,363,35,9,26,96,56,21,34,55,27,7,2,5,32
S01007604,Good health,227,20,11,9,71,46,15,20,28,19,5,4,1,3
S01007604,Fair health,52,4,1,3,13,11,4,2,10,6,1,1,0,1
S01007604,Bad health,18,2,1,1,1,6,1,2,3,3,0,0,0,0
S01007604,Very bad health,6,0,0,0,2,0,0,1,1,2,0,0,0,0
S01007605,All people aged 16 to 74,640,49,8,41,174,112,37,53,101,75,5,3,2,34
S01007605,Very good health,338,28,7,21,96,60,19,26,50,27,2,1,1,30
S01007605,Good health,223,15,1,14,60,38,11,18,36,40,3,2,1,2
S01007605,Fair health,60,4,0,4,14,11,6,6,13,4,0,0,0,2
S01007605,Bad health,15,2,0,2,3,2,1,1,2,4,0,0,0,0
S01007605,Very bad health,4,0,0,0,1,1,0,2,0,0,0,0,0,0
S01007606,All people aged 16 to 74,471,30,7,23,131,71,36,40,80,39,13,8,5,31
S01007606,Very good health,239,17,2,15,71,38,17,19,35,18,4,3,1,20
S01007606,Good health,166,10,3,7,47,25,10,13,30,15,6,3,3,10
S01007606,Fair health,49,3,2,1,6,6,7,7,12,4,3,2,1,1
S01007606,Bad health,15,0,0,0,6,2,1,1,3,2,0,0,0,0
S01007606,Very bad health,2,0,0,0,1,0,1,0,0,0,0,0,0,0
S01007607,All people aged 16 to 74,536,44,11,33,137,96,33,45,91,57,8,6,2,25
S01007607,Very good health,285,25,4,21,80,47,19,20,47,23,2,2,0,22
S01007607,Good health,178,15,6,9,44,31,12,21,28,20,4,3,1,3
S01007607,Fair health,57,2,1,1,8,13,1,4,15,12,2,1,1,0
S01007607,Bad health,12,2,0,2,3,4,1,0,0,2,0,0,0,0
S01007607,Very bad health,4,0,0,0,2,1,0,0,1,0,0,0,0,0
S01007608,All people aged 16 to 74,566,33,6,27,167,85,37,42,96,62,10,8,2,34
S01007608,Very good health,311,20,2,18,94,51,24,21,44,24,3,1,2,30
S01007608,Good health,186,10,3,7,54,23,9,16,43,26,2,2,0,3
S01007608,Fair health,55,3,1,2,16,10,3,3,7,12,0,0,0,1
S01007608,Bad health,8,0,0,0,0,0,1,2,1,0,4,4,0,0
S01007608,Very bad health,6,0,0,0,3,1,0,0,1,0,1,1,0,0
S01007609,All people aged 16 to 74,683,25,5,20,112,102,32,56,143,130,39,25,14,44
S01007609,Very good health,275,18,3,15,46,59,12,14,47,45,10,5,5,24
S01007609,Good health,257,4,2,2,37,33,14,28,62,48,12,8,4,19
S01007609,Fair health,104,2,0,2,21,6,4,10,21,24,15,10,5,1
S01007609,Bad health,40,1,0,1,7,4,0,3,12,12,1,1,0,0
S01007609,Very bad health,7,0,0,0,1,0,2,1,1,1,1,1,0,0
S01007610,All people aged 16 to 74,356,18,4,14,77,43,20,35,77,56,19,12,7,11
S01007610,Very good health,155,12,3,9,35,18,10,16,28,24,4,2,2,8
S01007610,Good health,122,5,1,4,32,14,6,12,25,18,8,4,4,2
S01007610,Fair health,58,1,0,1,7,9,3,6,16,10,5,5,0,1
S01007610,Bad health,17,0,0,0,3,2,1,1,7,2,1,0,1,0
S01007610,Very bad health,4,0,0,0,0,0,0,0,1,2,1,1,0,0
S01007611,All people aged 16 to 74,683,38,4,34,98,85,38,76,155,115,44,32,12,34
S01007611,Very good health,273,21,2,19,50,32,12,28,57,41,9,7,2,23
S01007611,Good health,228,11,2,9,32,34,13,22,47,40,21,12,9,8
S01007611,Fair health,125,6,0,6,10,11,9,19,36,21,10,10,0,3
S01007611,Bad health,44,0,0,0,4,7,4,5,13,9,2,1,1,0
S01007611,Very bad health,13,0,0,0,2,1,0,2,2,4,2,2,0,0
S01007612,All people aged 16 to 74,861,26,2,24,146,92,63,88,159,133,83,46,37,71
S01007612,Very good health,354,15,1,14,72,35,22,38,57,40,20,13,7,55
S01007612,Good health,306,8,0,8,52,38,21,23,63,60,30,14,16,11
S01007612,Fair health,138,3,1,2,15,13,11,16,25,28,22,9,13,5
S01007612,Bad health,46,0,0,0,5,3,8,8,10,4,8,7,1,0
S01007612,Very bad health,17,0,0,0,2,3,1,3,4,1,3,3,0,0
S01007613,All people aged 16 to 74,597,66,9,57,148,68,78,34,85,44,37,19,18,37
S01007613,Very good health,312,34,6,28,86,36,44,7,38,20,15,8,7,32
S01007613,Good health,190,25,2,23,45,17,23,20,30,15,13,4,9,2
S01007613,Fair health,77,7,1,6,14,11,9,5,14,7,7,5,2,3
S01007613,Bad health,16,0,0,0,3,4,1,2,3,1,2,2,0,0
S01007613,Very bad health,2,0,0,0,0,0,1,0,0,1,0,0,0,0
S01007614,All people aged 16 to 74,619,96,30,66,214,95,47,18,79,29,5,4,1,36
S01007614,Very good health,355,60,19,41,131,51,20,12,37,13,2,2,0,29
S01007614,Good health,185,24,6,18,62,34,20,2,26,11,2,1,1,4
S01007614,Fair health,59,9,3,6,19,7,7,4,8,2,0,0,0,3
S01007614,Bad health,16,2,1,1,1,3,0,0,6,3,1,1,0,0
S01007614,Very bad health,4,1,1,0,1,0,0,0,2,0,0,0,0,0
S01007615,All people aged 16 to 74,785,69,19,50,200,110,63,62,129,97,24,13,11,31
S01007615,Very good health,412,45,11,34,111,58,33,26,55,46,9,4,5,29
S01007615,Good health,247,19,7,12,64,36,17,22,51,29,7,5,2,2
S01007615,Fair health,94,3,0,3,19,13,8,9,20,17,5,3,2,0
S01007615,Bad health,24,2,1,1,4,3,3,4,3,3,2,1,1,0
S01007615,Very bad health,8,0,0,0,2,0,2,1,0,2,1,0,1,0
S01007616,All people aged 16 to 74,542,16,2,14,108,73,38,58,109,81,29,19,10,30
S01007616,Very good health,248,11,2,9,47,37,15,28,44,35,5,4,1,26
S01007616,Good health,187,4,0,4,55,22,13,16,38,22,13,10,3,4
S01007616,Fair health,71,0,0,0,4,11,7,7,19,15,8,3,5,0
S01007616,Bad health,22,1,0,1,1,3,1,4,6,4,2,1,1,0
S01007616,Very bad health,14,0,0,0,1,0,2,3,2,5,1,1,0,0
S01007617,All people aged 16 to 74,401,9,3,6,51,55,27,34,108,76,23,14,9,18
S01007617,Very good health,162,2,0,2,20,31,9,13,40,24,7,4,3,16
S01007617,Good health,143,4,1,3,18,16,14,11,39,29,10,8,2,2
S01007617,Fair health,70,2,2,0,9,5,2,6,24,18,4,0,4,0
S01007617,Bad health,18,1,0,1,3,2,2,2,4,3,1,1,0,0
S01007617,Very bad health,8,0,0,0,1,1,0,2,1,2,1,1,0,0
S01007618,All people aged 16 to 74,418,3,1,2,56,45,18,43,106,96,18,10,8,33
S01007618,Very good health,196,2,1,1,25,27,4,20,44,41,9,5,4,24
S01007618,Good health,140,1,0,1,25,16,7,11,34,35,2,0,2,9
S01007618,Fair health,55,0,0,0,6,0,6,9,17,13,4,3,1,0
S01007618,Bad health,20,0,0,0,0,2,1,3,7,6,1,0,1,0
S01007618,Very bad health,7,0,0,0,0,0,0,0,4,1,2,2,0,0
S01007619,All people aged 16 to 74,456,6,1,5,49,46,22,38,135,114,27,19,8,19
S01007619,Very good health,192,4,0,4,18,16,9,19,57,42,11,8,3,16
S01007619,Good health,161,2,1,1,20,22,9,7,47,44,9,5,4,1
S01007619,Fair health,71,0,0,0,6,6,3,7,20,21,6,5,1,2
S01007619,Bad health,25,0,0,0,4,1,1,5,7,6,1,1,0,0
S01007619,Very bad health,7,0,0,0,1,1,0,0,4,1,0,0,0,0
S01007620,All people aged 16 to 74,459,19,3,16,101,86,48,41,88,57,2,1,1,17
S01007620,Very good health,220,11,2,9,51,45,20,14,42,23,1,1,0,13
S01007620,Good health,173,6,1,5,38,34,18,16,34,23,0,0,0,4
S01007620,Fair health,48,2,0,2,7,3,9,7,10,10,0,0,0,0
S01007620,Bad health,13,0,0,0,3,3,1,3,2,0,1,0,1,0
S01007620,Very bad health,5,0,0,0,2,1,0,1,0,1,0,0,0,0
S01007621,All people aged 16 to 74,473,13,6,7,100,84,38,59,94,63,6,1,5,16
S01007621,Very good health,245,7,5,2,55,48,18,31,45,31,2,1,1,8
S01007621,Good health,168,5,1,4,34,24,17,23,36,20,2,0,2,7
S01007621,Fair health,51,1,0,1,8,10,3,5,13,8,2,0,2,1
S01007621,Bad health,7,0,0,0,3,1,0,0,0,3,0,0,0,0
S01007621,Very bad health,2,0,0,0,0,1,0,0,0,1,0,0,0,0
S01007622,All people aged 16 to 74,413,13,4,9,85,58,36,43,90,62,13,7,6,13
S01007622,Very good health,190,7,1,6,51,24,13,26,40,12,8,4,4,9
S01007622,Good health,136,4,3,1,23,16,14,9,29,34,4,2,2,3
S01007622,Fair health,60,1,0,1,9,11,9,7,13,10,0,0,0,0
S01007622,Bad health,17,0,0,0,2,6,0,1,6,2,0,0,0,0
S01007622,Very bad health,10,1,0,1,0,1,0,0,2,4,1,1,0,1
S01007623,All people aged 16 to 74,463,43,8,35,116,70,38,36,66,51,12,7,5,31
S01007623,Very good health,268,35,7,28,65,35,24,19,36,23,6,3,3,25
S01007623,Good health,136,8,1,7,37,27,10,10,23,15,0,0,0,6
S01007623,Fair health,49,0,0,0,12,7,4,5,6,9,6,4,2,0
S01007623,Bad health,9,0,0,0,2,1,0,2,1,3,0,0,0,0
S01007623,Very bad health,1,0,0,0,0,0,0,0,0,1,0,0,0,0
S01007624,All people aged 16 to 74,506,27,7,20,92,89,35,50,108,72,6,6,0,27
S01007624,Very good health,272,17,5,12,53,47,15,28,50,35,3,3,0,24
S01007624,Good health,164,9,2,7,29,30,13,16,41,22,1,1,0,3
S01007624,Fair health,47,1,0,1,6,7,5,4,13,10,1,1,0,0
S01007624,Bad health,20,0,0,0,3,4,2,2,3,5,1,1,0,0
S01007624,Very bad health,3,0,0,0,1,1,0,0,1,0,0,0,0,0
S01007625,All people aged 16 to 74,384,22,6,16,76,60,25,41,68,55,9,5,4,28
S01007625,Very good health,165,9,4,5,36,21,9,22,24,21,2,2,0,21
S01007625,Good health,162,8,2,6,34,24,14,15,33,23,5,2,3,6
S01007625,Fair health,41,5,0,5,4,10,2,3,7,8,1,1,0,1
S01007625,Bad health,13,0,0,0,2,4,0,1,3,2,1,0,1,0
S01007625,Very bad health,3,0,0,0,0,1,0,0,1,1,0,0,0,0
S01007626,All people aged 16 to 74,476,29,7,22,98,77,37,57,94,48,8,3,5,28
S01007626,Very good health,290,24,7,17,70,46,17,29,54,22,6,2,4,22
S01007626,Good health,135,4,0,4,22,22,12,24,26,19,1,1,0,5
S01007626,Fair health,38,1,0,1,5,6,7,3,10,5,0,0,0,1
S01007626,Bad health,10,0,0,0,0,3,1,1,2,2,1,0,1,0
S01007626,Very bad health,3,0,0,0,1,0,0,0,2,0,0,0,0,0
S01007627,All people aged 16 to 74,393,39,8,31,104,67,35,40,60,19,6,5,1,23
S01007627,Very good health,237,25,6,19,70,38,20,24,29,9,2,2,0,20
S01007627,Good health,124,13,2,11,28,25,9,14,22,7,3,2,1,3
S01007627,Fair health,22,1,0,1,4,3,6,1,5,2,0,0,0,0
S01007627,Bad health,10,0,0,0,2,1,0,1,4,1,1,1,0,0
S01007627,Very bad health,0,0,0,0,0,0,0,0,0,0,0,0,0,0
S01007628,All people aged 16 to 74,503,29,4,25,131,81,49,53,80,45,12,8,4,23
S01007628,Very good health,255,17,2,15,75,37,24,27,37,22,0,0,0,16
S01007628,Good health,188,10,2,8,44,33,19,18,34,16,7,4,3,7
S01007628,Fair health,47,2,0,2,10,6,5,6,9,5,4,3,1,0
S01007628,Bad health,8,0,0,0,1,4,0,1,0,2,0,0,0,0
S01007628,Very bad health,5,0,0,0,1,1,1,1,0,0,1,1,0,0
S01007629,All people aged 16 to 74,527,31,8,23,128,67,73,41,82,71,10,6,4,24
S01007629,Very good health,267,13,4,9,75,34,37,22,32,30,5,3,2,19
S01007629,Good health,190,16,4,12,43,27,25,14,32,26,3,2,1,4
S01007629,Fair health,49,2,0,2,7,3,9,4,12,9,2,1,1,1
S01007629,Bad health,17,0,0,0,2,1,1,1,6,6,0,0,0,0
S01007629,Very bad health,4,0,0,0,1,2,1,0,0,0,0,0,0,0
S01007630,All people aged 16 to 74,652,48,10,38,153,84,120,43,98,52,12,9,3,42
S01007630,Very good health,333,33,6,27,74,43,63,20,43,19,6,3,3,32
S01007630,Good health,231,11,3,8,59,31,44,15,37,23,3,3,0,8
S01007630,Fair health,57,1,1,0,15,7,10,5,10,6,2,2,0,1
S01007630,Bad health,24,3,0,3,4,3,3,2,7,1,0,0,0,1
S01007630,Very bad health,7,0,0,0,1,0,0,1,1,3,1,1,0,0
S01007631,All people aged 16 to 74,449,48,5,43,98,51,99,31,67,31,12,8,4,12
S01007631,Very good health,237,34,5,29,55,29,48,10,28,18,6,4,2,9
S01007631,Good health,160,11,0,11,32,17,36,15,30,11,5,3,2,3
S01007631,Fair health,41,2,0,2,10,3,13,5,6,1,1,1,0,0
S01007631,Bad health,10,1,0,1,1,2,2,1,3,0,0,0,0,0
S01007631,Very bad health,1,0,0,0,0,0,0,0,0,1,0,0,0,0
S01007632,All people aged 16 to 74,707,44,15,29,123,86,68,63,143,117,29,21,8,34
S01007632,Very good health,350,24,10,14,63,46,39,32,66,41,15,12,3,24
S01007632,Good health,259,16,5,11,44,28,19,21,55,58,9,5,4,9
S01007632,Fair health,65,3,0,3,11,6,7,7,17,11,3,2,1,0
S01007632,Bad health,26,1,0,1,3,6,3,2,4,6,1,1,0,0
S01007632,Very bad health,7,0,0,0,2,0,0,1,1,1,1,1,0,1
S01007633,All people aged 16 to 74,717,39,10,29,129,86,62,74,155,111,28,13,15,33
S01007633,Very good health,347,22,5,17,65,46,29,37,61,51,12,4,8,24
S01007633,Good health,233,8,4,4,43,26,20,28,58,38,6,3,3,6
S01007633,Fair health,100,7,1,6,19,12,9,5,24,13,8,4,4,3
S01007633,Bad health,30,1,0,1,2,1,3,3,10,8,2,2,0,0
S01007633,Very bad health,7,1,0,1,0,1,1,1,2,1,0,0,0,0
S01007634,All people aged 16 to 74,433,32,9,23,87,48,63,30,81,58,14,6,8,20
S01007634,Very good health,221,19,6,13,49,21,23,14,40,28,9,5,4,18
S01007634,Good health,161,10,2,8,34,22,26,11,30,21,5,1,4,2
S01007634,Fair health,42,3,1,2,2,5,13,5,8,6,0,0,0,0
S01007634,Bad health,8,0,0,0,1,0,1,0,3,3,0,0,0,0
S01007634,Very bad health,1,0,0,0,1,0,0,0,0,0,0,0,0,0
S01007635,All people aged 16 to 74,489,39,9,30,128,53,72,40,77,38,15,12,3,27
S01007635,Very good health,238,18,2,16,66,21,29,24,34,22,2,1,1,22
S01007635,Good health,176,14,4,10,47,23,28,10,30,10,10,9,1,4
S01007635,Fair health,60,5,3,2,11,9,14,5,7,5,3,2,1,1
S01007635,Bad health,14,2,0,2,3,0,1,1,6,1,0,0,0,0
S01007635,Very bad health,1,0,0,0,1,0,0,0,0,0,0,0,0,0
S01007636,All people aged 16 to 74,590,33,11,22,112,76,50,41,123,95,31,22,9,29
S01007636,Very good health,259,17,7,10,60,35,23,17,51,27,10,7,3,19
S01007636,Good health,216,14,4,10,28,24,20,18,47,42,13,9,4,10
S01007636,Fair health,82,2,0,2,16,13,6,6,14,18,7,5,2,0
S01007636,Bad health,25,0,0,0,4,3,1,0,8,8,1,1,0,0
S01007636,Very bad health,8,0,0,0,4,1,0,0,3,0,0,0,0,0
S01007637,All people aged 16 to 74,611,21,5,16,69,69,58,64,158,125,25,15,10,22
S01007637,Very good health,274,8,3,5,36,35,23,24,69,54,7,3,4,18
S01007637,Good health,226,9,2,7,26,27,26,29,53,47,6,4,2,3
S01007637,Fair health,73,3,0,3,4,4,8,6,22,17,8,5,3,1
S01007637,Bad health,28,1,0,1,3,3,1,1,11,6,2,2,0,0
S01007637,Very bad health,10,0,0,0,0,0,0,4,3,1,2,1,1,0
S01007638,All people aged 16 to 74,565,26,9,17,114,61,44,69,109,90,24,13,11,28
S01007638,Very good health,250,11,4,7,55,37,21,27,40,32,5,2,3,22
S01007638,Good health,191,11,5,6,34,12,19,27,42,33,10,5,5,3
S01007638,Fair health,88,3,0,3,20,10,4,10,13,19,7,4,3,2
S01007638,Bad health,30,1,0,1,4,1,0,3,12,6,2,2,0,1
S01007638,Very bad health,6,0,0,0,1,1,0,2,2,0,0,0,0,0
S01007639,All people aged 16 to 74,782,33,9,24,113,81,53,66,205,163,30,16,14,38
S01007639,Very good health,357,18,3,15,59,43,16,32,85,67,9,5,4,28
S01007639,Good health,296,13,4,9,39,24,23,23,94,62,11,4,7,7
S01007639,Fair health,82,2,2,0,9,10,10,7,12,23,8,7,1,1
S01007639,Bad health,39,0,0,0,3,4,3,4,13,8,2,0,2,2
S01007639,Very bad health,8,0,0,0,3,0,1,0,1,3,0,0,0,0
S01007640,All people aged 16 to 74,555,30,7,23,95,59,116,55,100,61,13,8,5,26
S01007640,Very good health,269,15,2,13,43,28,55,29,46,29,3,2,1,21
S01007640,Good health,195,13,5,8,39,18,41,21,30,24,4,2,2,5
S01007640,Fair health,61,2,0,2,8,8,15,3,15,6,4,2,2,0
S01007640,Bad health,19,0,0,0,3,3,5,2,4,1,1,1,0,0
S01007640,Very bad health,11,0,0,0,2,2,0,0,5,1,1,1,0,0
S01007641,All people aged 16 to 74,607,60,26,34,111,70,92,50,106,72,19,9,10,27
S01007641,Very good health,281,30,18,12,50,31,42,17,51,32,8,4,4,20
S01007641,Good health,218,23,6,17,46,27,36,18,29,27,7,2,5,5
S01007641,Fair health,78,7,2,5,10,9,10,10,17,12,1,1,0,2
S01007641,Bad health,24,0,0,0,4,2,4,5,8,1,0,0,0,0
S01007641,Very bad health,6,0,0,0,1,1,0,0,1,0,3,2,1,0
S01007642,All people aged 16 to 74,577,51,10,41,138,54,111,59,71,51,15,9,6,27
S01007642,Very good health,267,22,4,18,65,25,49,32,23,27,7,4,3,17
S01007642,Good health,213,22,5,17,52,18,44,18,34,13,3,2,1,9
S01007642,Fair health,74,6,0,6,16,8,14,6,8,10,5,3,2,1
S01007642,Bad health,15,1,1,0,4,2,1,3,4,0,0,0,0,0
S01007642,Very bad health,8,0,0,0,1,1,3,0,2,1,0,0,0,0
S01007643,All people aged 16 to 74,663,51,15,36,148,51,94,74,113,72,22,10,12,38
S01007643,Very good health,309,25,7,18,83,28,34,33,41,28,6,5,1,31
S01007643,Good health,240,22,4,18,50,17,41,27,42,26,9,4,5,6
S01007643,Fair health,86,3,3,0,13,3,17,10,24,10,5,0,5,1
S01007643,Bad health,27,1,1,0,2,3,2,4,6,7,2,1,1,0
S01007643,Very bad health,1,0,0,0,0,0,0,0,0,1,0,0,0,0
S01007644,All people aged 16 to 74,612,64,18,46,128,56,62,61,116,73,19,11,8,33
S01007644,Very good health,268,33,8,25,59,25,21,22,48,27,7,5,2,26
S01007644,Good health,224,23,9,14,51,25,23,27,38,25,5,3,2,7
S01007644,Fair health,84,7,1,6,10,3,16,9,21,15,3,0,3,0
S01007644,Bad health,27,1,0,1,6,1,2,3,5,6,3,2,1,0
S01007644,Very bad health,9,0,0,0,2,2,0,0,4,0,1,1,0,0
S01007645,All people aged 16 to 74,418,31,9,22,94,39,102,27,57,37,14,4,10,17
S01007645,Very good health,204,21,6,15,55,18,41,7,31,14,4,2,2,13
S01007645,Good health,153,7,2,5,25,15,46,9,20,20,7,0,7,4
S01007645,Fair health,51,2,1,1,12,3,14,9,6,2,3,2,1,0
S01007645,Bad health,7,1,0,1,0,2,1,2,0,1,0,0,0,0
S01007645,Very bad health,3,0,0,0,2,1,0,0,0,0,0,0,0,0
S01007646,All people aged 16 to 74,481,47,16,31,92,45,91,48,78,44,13,6,7,23
S01007646,Very good health,240,21,8,13,47,25,49,26,32,16,5,0,5,19
S01007646,Good health,150,12,5,7,31,13,26,17,28,15,6,4,2,2
S01007646,Fair health,59,7,2,5,10,5,10,4,12,9,1,1,0,1
S01007646,Bad health,23,5,0,5,1,2,5,1,4,3,1,1,0,1
S01007646,Very bad health,9,2,1,1,3,0,1,0,2,1,0,0,0,0
S01007647,All people aged 16 to 74,536,34,10,24,118,76,72,39,83,71,16,6,10,27
S01007647,Very good health,279,19,7,12,64,41,38,14,45,25,13,3,10,20
S01007647,Good health,163,7,1,6,40,23,17,20,20,30,1,1,0,5
S01007647,Fair health,69,5,1,4,11,9,14,3,14,11,1,1,0,1
S01007647,Bad health,23,2,0,2,3,3,3,2,4,4,1,1,0,1
S01007647,Very bad health,2,1,1,0,0,0,0,0,0,1,0,0,0,0
S01007648,All people aged 16 to 74,640,33,7,26,114,104,72,63,91,118,14,6,8,31
S01007648,Very good health,328,19,4,15,66,54,34,33,44,52,4,2,2,22
S01007648,Good health,223,12,3,9,34,40,28,22,36,38,5,3,2,8
S01007648,Fair health,66,2,0,2,7,9,5,8,9,23,2,0,2,1
S01007648,Bad health,17,0,0,0,4,0,5,0,2,4,2,1,1,0
S01007648,Very bad health,6,0,0,0,3,1,0,0,0,1,1,0,1,0
S01007649,All people aged 16 to 74,558,18,8,10,75,61,69,56,103,128,26,19,7,22
S01007649,Very good health,245,10,5,5,40,23,34,23,43,45,8,4,4,19
S01007649,Good health,202,6,3,3,24,26,23,18,39,54,9,8,1,3
S01007649,Fair health,87,2,0,2,9,10,9,11,18,20,8,6,2,0
S01007649,Bad health,23,0,0,0,2,2,3,3,3,9,1,1,0,0
S01007649,Very bad health,1,0,0,0,0,0,0,1,0,0,0,0,0,0
S01007650,All people aged 16 to 74,713,38,9,29,147,84,139,46,100,100,18,7,11,41
S01007650,Very good health,332,23,5,18,68,46,47,26,43,38,8,3,5,33
S01007650,Good health,251,13,4,9,50,27,64,13,34,40,5,2,3,5
S01007650,Fair health,103,2,0,2,22,10,27,3,19,15,2,0,2,3
S01007650,Bad health,19,0,0,0,3,1,1,2,4,5,3,2,1,0
S01007650,Very bad health,8,0,0,0,4,0,0,2,0,2,0,0,0,0
S01007651,All people aged 16 to 74,428,31,10,21,74,45,114,22,64,41,17,10,7,20
S01007651,Very good health,231,19,4,15,49,21,59,9,39,16,5,4,1,14
S01007651,Good health,145,9,3,6,18,17,42,7,19,21,6,3,3,6
S01007651,Fair health,40,2,2,0,7,5,10,5,4,2,5,2,3,0
S01007651,Bad health,8,1,1,0,0,2,2,0,1,1,1,1,0,0
S01007651,Very bad health,4,0,0,0,0,0,1,1,1,1,0,0,0,0
S01007652,All people aged 16 to 74,426,18,4,14,77,47,66,42,75,65,15,9,6,21
S01007652,Very good health,196,12,3,9,35,23,30,17,33,24,5,5,0,17
S01007652,Good health,153,4,1,3,26,16,25,15,30,26,8,3,5,3
S01007652,Fair health,51,1,0,1,11,6,8,4,9,10,2,1,1,0
S01007652,Bad health,18,1,0,1,4,1,3,3,2,3,0,0,0,1
S01007652,Very bad health,8,0,0,0,1,1,0,3,1,2,0,0,0,0
S01007653,All people aged 16 to 74,690,39,7,32,109,70,124,75,134,85,14,4,10,40
S01007653,Very good health,341,25,6,19,53,39,60,36,62,28,4,2,2,34
S01007653,Good health,233,6,0,6,38,22,47,26,48,35,5,0,5,6
S01007653,Fair health,95,7,1,6,11,6,14,10,23,19,5,2,3,0
S01007653,Bad health,16,1,0,1,5,2,3,3,1,1,0,0,0,0
S01007653,Very bad health,5,0,0,0,2,1,0,0,0,2,0,0,0,0
S01007654,All people aged 16 to 74,804,29,10,19,116,65,115,74,198,137,29,21,8,41
S01007654,Very good health,345,14,5,9,62,24,44,23,86,49,11,8,3,32
S01007654,Good health,294,9,4,5,34,25,46,35,71,57,8,5,3,9
S01007654,Fair health,116,3,0,3,15,12,17,8,32,21,8,7,1,0
S01007654,Bad health,32,1,0,1,3,2,5,6,6,7,2,1,1,0
S01007654,Very bad health,17,2,1,1,2,2,3,2,3,3,0,0,0,0
S01007655,All people aged 16 to 74,613,45,12,33,114,55,181,36,95,54,13,9,4,20
S01007655,Very good health,308,18,3,15,61,30,98,16,43,18,7,6,1,17
S01007655,Good health,187,16,5,11,33,17,56,12,30,18,3,1,2,2
S01007655,Fair health,84,7,3,4,15,8,21,7,11,13,2,2,0,0
S01007655,Bad health,25,4,1,3,2,0,3,0,10,4,1,0,1,1
S01007655,Very bad health,9,0,0,0,3,0,3,1,1,1,0,0,0,0
S01007656,All people aged 16 to 74,663,38,9,29,118,66,134,53,131,65,24,17,7,34
S01007656,Very good health,314,21,5,16,51,32,68,23,51,33,5,3,2,30
S01007656,Good health,218,8,1,7,44,22,44,22,46,16,12,7,5,4
S01007656,Fair health,92,7,2,5,16,8,18,4,28,6,5,5,0,0
S01007656,Bad health,25,1,0,1,6,2,2,1,3,9,1,1,0,0
S01007656,Very bad health,14,1,1,0,1,2,2,3,3,1,1,1,0,0
S01007657,All people aged 16 to 74,336,16,4,12,70,32,63,29,68,38,7,4,3,13
S01007657,Very good health,167,7,1,6,35,19,32,17,32,14,2,2,0,9
S01007657,Good health,123,6,2,4,26,10,24,9,27,17,1,0,1,3
S01007657,Fair health,32,3,1,2,8,1,4,2,8,5,0,0,0,1
S01007657,Bad health,13,0,0,0,1,2,3,1,1,2,3,2,1,0
S01007657,Very bad health,1,0,0,0,0,0,0,0,0,0,1,0,1,0
S01007658,All people aged 16 to 74,382,21,5,16,89,43,66,40,62,39,6,3,3,16
S01007658,Very good health,181,14,2,12,41,21,30,20,26,17,1,0,1,11
S01007658,Good health,127,5,3,2,29,12,23,8,27,14,5,3,2,4
S01007658,Fair health,53,1,0,1,14,10,12,7,5,4,0,0,0,0
S01007658,Bad health,15,1,0,1,4,0,0,2,3,4,0,0,0,1
S01007658,Very bad health,6,0,0,0,1,0,1,3,1,0,0,0,0,0
S01007659,All people aged 16 to 74,585,44,6,38,99,58,88,63,115,81,20,8,12,17
S01007659,Very good health,259,24,4,20,45,24,37,26,53,28,7,1,6,15
S01007659,Good health,220,16,2,14,41,27,36,26,42,24,6,2,4,2
S01007659,Fair health,70,3,0,3,11,4,8,5,15,19,5,4,1,0
S01007659,Bad health,26,1,0,1,2,1,6,4,4,6,2,1,1,0
S01007659,Very bad health,10,0,0,0,0,2,1,2,1,4,0,0,0,0
S01007660,All people aged 16 to 74,634,10,4,6,63,47,45,83,198,126,38,23,15,24
S01007660,Very good health,267,3,2,1,21,21,23,38,91,46,8,2,6,16
S01007660,Good health,213,4,2,2,22,16,17,27,63,42,15,11,4,7
S01007660,Fair health,111,3,0,3,14,6,4,11,29,29,14,9,5,1
S01007660,Bad health,36,0,0,0,4,4,1,6,13,7,1,1,0,0
S01007660,Very bad health,7,0,0,0,2,0,0,1,2,2,0,0,0,0
S01007661,All people aged 16 to 74,492,17,5,12,89,53,54,49,105,85,14,10,4,26
S01007661,Very good health,212,8,1,7,45,20,26,22,46,21,4,4,0,20
S01007661,Good health,176,7,3,4,26,22,14,18,39,42,4,2,2,4
S01007661,Fair health,77,1,0,1,14,10,11,5,15,15,4,2,2,2
S01007661,Bad health,25,1,1,0,4,1,2,3,5,7,2,2,0,0
S01007661,Very bad health,2,0,0,0,0,0,1,1,0,0,0,0,0,0
S01007662,All people aged 16 to 74,630,24,10,14,109,63,54,71,143,116,26,20,6,24
S01007662,Very good health,266,11,4,7,55,31,19,31,52,41,9,6,3,17
S01007662,Good health,232,10,4,6,35,24,25,27,60,39,5,4,1,7
S01007662,Fair health,86,3,2,1,14,5,7,7,16,23,11,9,2,0
S01007662,Bad health,35,0,0,0,4,3,2,3,14,9,0,0,0,0
S01007662,Very bad health,11,0,0,0,1,0,1,3,1,4,1,1,0,0
S01007663,All people aged 16 to 74,624,40,3,37,123,73,57,62,125,98,10,4,6,36
S01007663,Very good health,307,28,2,26,62,45,29,28,56,36,1,1,0,22
S01007663,Good health,204,9,1,8,47,20,17,21,42,35,5,1,4,8
S01007663,Fair health,76,3,0,3,11,5,7,10,18,13,3,2,1,6
S01007663,Bad health,29,0,0,0,3,3,2,3,8,9,1,0,1,0
S01007663,Very bad health,8,0,0,0,0,0,2,0,1,5,0,0,0,0
S01007664,All people aged 16 to 74,430,13,3,10,59,32,29,53,116,93,17,11,6,18
S01007664,Very good health,156,6,2,4,29,12,9,19,27,37,7,5,2,10
S01007664,Good health,165,5,1,4,24,13,13,17,55,27,6,2,4,5
S01007664,Fair health,73,1,0,1,5,5,4,12,25,17,2,2,0,2
S01007664,Bad health,29,1,0,1,1,2,2,5,7,9,1,1,0,1
S01007664,Very bad health,7,0,0,0,0,0,1,0,2,3,1,1,0,0
S01007665,All people aged 16 to 74,457,15,5,10,74,48,26,60,120,83,15,9,6,16
S01007665,Very good health,232,9,2,7,51,29,14,27,49,33,8,7,1,12
S01007665,Good health,157,6,3,3,13,14,8,25,49,34,4,0,4,4
S01007665,Fair health,51,0,0,0,8,3,3,5,17,12,3,2,1,0
S01007665,Bad health,15,0,0,0,2,2,1,2,4,4,0,0,0,0
S01007665,Very bad health,2,0,0,0,0,0,0,1,1,0,0,0,0,0
S01007666,All people aged 16 to 74,374,29,8,21,79,59,19,41,62,56,12,11,1,17
S01007666,Very good health,193,12,4,8,50,30,7,24,27,26,3,2,1,14
S01007666,Good health,115,12,2,10,20,21,10,10,21,17,2,2,0,2
S01007666,Fair health,47,5,2,3,6,5,1,5,9,10,5,5,0,1
S01007666,Bad health,15,0,0,0,3,3,0,1,3,3,2,2,0,0
S01007666,Very bad health,4,0,0,0,0,0,1,1,2,0,0,0,0,0
S01007667,All people aged 16 to 74,516,37,6,31,123,86,52,58,82,52,6,6,0,20
S01007667,Very good health,262,15,3,12,66,47,25,24,45,21,2,2,0,17
S01007667,Good health,175,14,2,12,47,29,12,23,25,20,2,2,0,3
S01007667,Fair health,64,8,1,7,9,8,12,9,9,8,1,1,0,0
S01007667,Bad health,10,0,0,0,0,1,2,2,3,2,0,0,0,0
S01007667,Very bad health,5,0,0,0,1,1,1,0,0,1,1,1,0,0
S01007668,All people aged 16 to 74,757,16,4,12,85,79,37,79,200,189,37,23,14,35
S01007668,Very good health,311,12,3,9,44,33,16,30,89,57,11,5,6,19
S01007668,Good health,284,4,1,3,29,31,13,30,74,75,15,11,4,13
S01007668,Fair health,104,0,0,0,9,10,5,9,24,36,8,5,3,3
S01007668,Bad health,48,0,0,0,2,5,2,8,10,18,3,2,1,0
S01007668,Very bad health,10,0,0,0,1,0,1,2,3,3,0,0,0,0
S01007669,All people aged 16 to 74,456,9,1,8,36,28,25,35,140,118,41,21,20,24
S01007669,Very good health,179,5,0,5,15,15,9,12,54,37,14,8,6,18
S01007669,Good health,173,1,1,0,12,8,11,14,53,50,19,8,11,5
S01007669,Fair health,68,2,0,2,7,2,5,3,24,19,5,3,2,1
S01007669,Bad health,24,0,0,0,2,3,0,5,6,7,1,1,0,0
S01007669,Very bad health,12,1,0,1,0,0,0,1,3,5,2,1,1,0
S01007670,All people aged 16 to 74,503,13,2,11,58,47,25,55,130,88,55,28,27,32
S01007670,Very good health,217,5,0,5,31,23,6,20,57,39,15,7,8,21
S01007670,Good health,171,3,1,2,21,16,12,23,38,32,19,10,9,7
S01007670,Fair health,78,3,1,2,6,3,4,9,25,11,15,6,9,2
S01007670,Bad health,31,1,0,1,0,4,2,1,9,6,6,5,1,2
S01007670,Very bad health,6,1,0,1,0,1,1,2,1,0,0,0,0,0
S01007671,All people aged 16 to 74,553,60,19,41,134,52,88,49,87,46,5,4,1,32
S01007671,Very good health,286,41,14,27,73,27,41,31,36,14,1,0,1,22
S01007671,Good health,193,12,2,10,52,18,38,13,32,17,3,3,0,8
S01007671,Fair health,50,7,3,4,4,5,8,3,13,8,1,1,0,1
S01007671,Bad health,19,0,0,0,3,2,1,2,4,6,0,0,0,1
S01007671,Very bad health,5,0,0,0,2,0,0,0,2,1,0,0,0,0
S01007672,All people aged 16 to 74,654,70,16,54,171,93,66,52,106,54,18,15,3,24
S01007672,Very good health,299,30,8,22,88,43,32,22,47,15,4,4,0,18
S01007672,Good health,244,24,5,19,61,35,20,20,41,27,11,8,3,5
S01007672,Fair health,84,13,2,11,20,10,11,6,13,9,2,2,0,0
S01007672,Bad health,18,3,1,2,1,4,2,1,4,2,0,0,0,1
S01007672,Very bad health,9,0,0,0,1,1,1,3,1,1,1,1,0,0
S01007673,All people aged 16 to 74,540,18,4,14,111,62,55,69,109,79,11,8,3,26
S01007673,Very good health,245,8,1,7,58,34,21,26,46,29,4,3,1,19
S01007673,Good health,211,7,2,5,41,20,26,33,47,28,4,3,1,5
S01007673,Fair health,59,2,1,1,10,6,6,8,8,15,2,2,0,2
S01007673,Bad health,20,1,0,1,2,2,2,1,7,4,1,0,1,0
S01007673,Very bad health,5,0,0,0,0,0,0,1,1,3,0,0,0,0
S01007674,All people aged 16 to 74,590,10,2,8,62,57,36,76,162,125,37,17,20,25
S01007674,Very good health,255,7,1,6,32,30,14,37,59,43,13,7,6,20
S01007674,Good health,202,2,0,2,18,18,12,23,64,45,15,4,11,5
S01007674,Fair health,93,1,1,0,11,7,7,8,30,24,5,3,2,0
S01007674,Bad health,30,0,0,0,1,2,2,4,8,9,4,3,1,0
S01007674,Very bad health,10,0,0,0,0,0,1,4,1,4,0,0,0,0
S01007675,All people aged 16 to 74,478,31,8,23,101,64,62,45,96,55,7,4,3,17
S01007675,Very good health,228,13,3,10,51,33,27,16,48,25,2,1,1,13
S01007675,Good health,160,12,2,10,29,19,21,19,32,21,3,2,1,4
S01007675,Fair health,64,5,3,2,16,6,11,8,11,6,1,1,0,0
S01007675,Bad health,19,1,0,1,4,5,1,1,4,2,1,0,1,0
S01007675,Very bad health,7,0,0,0,1,1,2,1,1,1,0,0,0,0
S01007676,All people aged 16 to 74,513,37,12,25,90,57,116,45,88,47,10,7,3,23
S01007676,Very good health,270,21,5,16,52,30,58,20,41,25,3,1,2,20
S01007676,Good health,175,13,4,9,29,23,42,19,33,11,2,2,0,3
S01007676,Fair health,52,3,3,0,7,4,9,4,12,8,5,4,1,0
S01007676,Bad health,11,0,0,0,1,0,6,1,0,3,0,0,0,0
S01007676,Very bad health,5,0,0,0,1,0,1,1,2,0,0,0,0,0
S01007677,All people aged 16 to 74,348,21,5,16,63,46,36,41,58,52,6,4,2,25
S01007677,Very good health,167,9,3,6,24,29,17,19,25,28,0,0,0,16
S01007677,Good health,131,8,2,6,26,16,13,16,24,17,2,1,1,9
S01007677,Fair health,36,3,0,3,11,1,5,5,6,4,1,0,1,0
S01007677,Bad health,11,1,0,1,2,0,1,1,2,2,2,2,0,0
S01007677,Very bad health,3,0,0,0,0,0,0,0,1,1,1,1,0,0
S01007678,All people aged 16 to 74,575,10,5,5,71,53,40,70,139,134,28,20,8,30
S01007678,Very good health,247,5,3,2,34,23,17,27,50,57,11,9,2,23
S01007678,Good health,189,3,1,2,26,17,14,25,49,42,8,5,3,5
S01007678,Fair health,95,0,0,0,5,11,8,12,25,26,6,3,3,2
S01007678,Bad health,35,1,1,0,3,1,1,6,14,7,2,2,0,0
S01007678,Very bad health,9,1,0,1,3,1,0,0,1,2,1,1,0,0
S01007679,All people aged 16 to 74,602,16,8,8,71,62,42,63,172,127,29,15,14,20
S01007679,Very good health,234,6,1,5,27,28,15,17,62,52,11,5,6,16
S01007679,Good health,217,4,4,0,23,24,13,31,70,41,7,4,3,4
S01007679,Fair health,105,5,2,3,12,9,12,10,32,19,6,1,5,0
S01007679,Bad health,34,1,1,0,4,1,0,5,7,12,4,4,0,0
S01007679,Very bad health,12,0,0,0,5,0,2,0,1,3,1,1,0,0
S01007680,All people aged 16 to 74,710,28,7,21,138,87,77,78,145,107,5,3,2,45
S01007680,Very good health,350,18,3,15,65,48,41,33,68,43,0,0,0,34
S01007680,Good health,271,5,1,4,64,30,30,28,59,42,4,3,1,9
S01007680,Fair health,70,5,3,2,7,6,4,16,14,15,1,0,1,2
S01007680,Bad health,16,0,0,0,1,3,1,1,4,6,0,0,0,0
S01007680,Very bad health,3,0,0,0,1,0,1,0,0,1,0,0,0,0
S01007681,All people aged 16 to 74,316,9,2,7,35,33,42,41,80,61,4,4,0,11
S01007681,Very good health,139,7,1,6,13,19,16,21,34,21,0,0,0,8
S01007681,Good health,121,2,1,1,18,11,16,16,28,24,3,3,0,3
S01007681,Fair health,40,0,0,0,3,2,5,3,14,13,0,0,0,0
S01007681,Bad health,15,0,0,0,1,1,4,1,4,3,1,1,0,0
S01007681,Very bad health,1,0,0,0,0,0,1,0,0,0,0,0,0,0
S01007682,All people aged 16 to 74,680,144,21,123,181,79,60,37,54,28,20,10,10,77
S01007682,Very good health,436,99,13,86,116,52,35,25,27,12,8,6,2,62
S01007682,Good health,185,36,6,30,51,20,21,9,16,10,9,3,6,13
S01007682,Fair health,42,8,2,6,5,4,3,2,9,6,3,1,2,2
S01007682,Bad health,12,1,0,1,5,3,1,0,2,0,0,0,0,0
S01007682,Very bad health,5,0,0,0,4,0,0,1,0,0,0,0,0,0
S01007683,All people aged 16 to 74,522,143,9,134,114,56,25,16,35,18,18,14,4,97
S01007683,Very good health,337,102,8,94,72,33,15,6,19,11,13,11,2,66
S01007683,Good health,146,34,1,33,30,21,6,6,9,6,4,2,2,30
S01007683,Fair health,30,4,0,4,8,2,4,4,5,1,1,1,0,1
S01007683,Bad health,8,3,0,3,3,0,0,0,2,0,0,0,0,0
S01007683,Very bad health,1,0,0,0,1,0,0,0,0,0,0,0,0,0
S01007684,All people aged 16 to 74,573,121,13,108,185,66,30,25,40,25,13,9,4,68
S01007684,Very good health,353,82,7,75,115,34,14,14,23,11,5,3,2,55
S01007684,Good health,177,37,6,31,56,27,10,9,13,9,5,3,2,11
S01007684,Fair health,33,2,0,2,13,3,4,1,4,4,1,1,0,1
S01007684,Bad health,8,0,0,0,1,1,2,1,0,1,1,1,0,1
S01007684,Very bad health,2,0,0,0,0,1,0,0,0,0,1,1,0,0
S01007685,All people aged 16 to 74,746,153,14,139,128,49,40,13,24,18,12,9,3,309
S01007685,Very good health,502,107,12,95,84,33,19,7,13,11,8,5,3,220
S01007685,Good health,193,35,2,33,32,11,12,6,8,4,4,4,0,81
S01007685,Fair health,37,7,0,7,9,2,6,0,3,2,0,0,0,8
S01007685,Bad health,10,4,0,4,1,2,2,0,0,1,0,0,0,0
S01007685,Very bad health,4,0,0,0,2,1,1,0,0,0,0,0,0,0
S01007686,All people aged 16 to 74,507,94,7,87,140,54,27,21,37,21,16,13,3,97
S01007686,Very good health,311,72,6,66,72,27,11,7,16,12,5,4,1,89
S01007686,Good health,145,18,0,18,52,21,9,9,15,7,7,5,2,7
S01007686,Fair health,39,4,1,3,13,3,6,5,3,1,4,4,0,0
S01007686,Bad health,11,0,0,0,3,3,0,0,3,1,0,0,0,1
S01007686,Very bad health,1,0,0,0,0,0,1,0,0,0,0,0,0,0
S01007687,All people aged 16 to 74,717,126,6,120,160,67,34,19,43,32,18,14,4,218
S01007687,Very good health,455,77,4,73,106,35,15,12,25,12,5,3,2,168
S01007687,Good health,214,40,1,39,45,23,15,6,17,18,7,5,2,43
S01007687,Fair health,39,7,0,7,8,5,4,1,1,1,5,5,0,7
S01007687,Bad health,8,2,1,1,1,4,0,0,0,1,0,0,0,0
S01007687,Very bad health,1,0,0,0,0,0,0,0,0,0,1,1,0,0
S01007688,All people aged 16 to 74,908,109,7,102,136,90,36,30,71,38,24,12,12,374
S01007688,Very good health,584,75,4,71,89,51,15,18,30,21,13,6,7,272
S01007688,Good health,257,31,2,29,36,24,17,10,30,14,8,3,5,87
S01007688,Fair health,41,3,1,2,7,9,1,0,6,0,2,2,0,13
S01007688,Bad health,19,0,0,0,1,6,2,1,5,2,0,0,0,2
S01007688,Very bad health,7,0,0,0,3,0,1,1,0,1,1,1,0,0
S01007689,All people aged 16 to 74,498,72,0,72,87,24,16,14,33,25,21,19,2,206
S01007689,Very good health,302,51,0,51,52,11,7,8,13,7,5,3,2,148
S01007689,Good health,147,18,0,18,30,10,7,4,11,12,4,4,0,51
S01007689,Fair health,28,2,0,2,5,1,2,1,7,3,2,2,0,5
S01007689,Bad health,11,1,0,1,0,2,0,1,1,0,5,5,0,1
S01007689,Very bad health,10,0,0,0,0,0,0,0,1,3,5,5,0,1
S01007690,All people aged 16 to 74,792,63,6,57,108,35,16,28,42,30,52,42,10,418
S01007690,Very good health,484,45,2,43,57,18,7,14,19,8,13,9,4,303
S01007690,Good health,233,17,4,13,33,13,7,9,13,13,26,20,6,102
S01007690,Fair health,48,1,0,1,12,2,2,3,4,4,10,10,0,10
S01007690,Bad health,23,0,0,0,5,2,0,2,5,3,3,3,0,3
S01007690,Very bad health,4,0,0,0,1,0,0,0,1,2,0,0,0,0
S01007691,All people aged 16 to 74,2798,64,3,61,115,58,27,28,78,56,66,37,29,2306
S01007691,Very good health,1818,46,0,46,65,31,14,11,31,17,22,16,6,1581
S01007691,Good health,776,14,1,13,34,16,7,5,24,19,25,11,14,632
S01007691,Fair health,161,3,1,2,14,7,5,8,13,12,13,5,8,86
S01007691,Bad health,29,1,1,0,2,2,1,3,5,6,5,4,1,4
S01007691,Very bad health,14,0,0,0,0,2,0,1,5,2,1,1,0,3
S01007692,All people aged 16 to 74,835,62,4,58,93,38,25,28,44,33,16,9,7,496
S01007692,Very good health,559,46,4,42,56,21,13,10,21,14,4,3,1,374
S01007692,Good health,189,11,0,11,30,9,4,11,13,11,5,1,4,95
S01007692,Fair health,64,4,0,4,4,5,6,6,7,5,5,3,2,22
S01007692,Bad health,21,1,0,1,1,3,2,1,3,3,2,2,0,5
S01007692,Very bad health,2,0,0,0,2,0,0,0,0,0,0,0,0,0
S01007693,All people aged 16 to 74,922,31,1,30,35,25,11,26,48,32,40,27,13,674
S01007693,Very good health,559,20,1,19,21,10,4,9,15,8,10,6,4,462
S01007693,Good health,268,8,0,8,10,7,5,8,22,16,10,8,2,182
S01007693,Fair health,66,2,0,2,3,5,1,5,7,4,12,6,6,27
S01007693,Bad health,20,0,0,0,1,2,1,3,3,1,7,6,1,2
S01007693,Very bad health,9,1,0,1,0,1,0,1,1,3,1,1,0,1
S01007694,All people aged 16 to 74,959,50,2,48,68,59,24,36,97,50,59,43,16,516
S01007694,Very good health,597,40,2,38,39,35,11,16,42,17,12,7,5,385
S01007694,Good health,260,9,0,9,21,16,6,13,34,17,28,19,9,116
S01007694,Fair health,65,1,0,1,6,6,3,6,12,7,12,11,1,12
S01007694,Bad health,27,0,0,0,1,2,4,0,8,6,3,3,0,3
S01007694,Very bad health,10,0,0,0,1,0,0,1,1,3,4,3,1,0
S01007695,All people aged 16 to 74,757,96,3,93,128,70,33,45,99,64,34,18,16,188
S01007695,Very good health,417,67,3,64,67,35,14,12,43,16,16,9,7,147
S01007695,Good health,225,24,0,24,41,26,11,20,30,25,11,5,6,37
S01007695,Fair health,71,4,0,4,13,7,4,9,16,14,0,0,0,4
S01007695,Bad health,37,1,0,1,6,1,3,4,9,7,6,3,3,0
S01007695,Very bad health,7,0,0,0,1,1,1,0,1,2,1,1,0,0
S01007696,All people aged 16 to 74,693,33,3,30,59,28,19,25,68,46,51,32,19,364
S01007696,Very good health,367,19,1,18,30,12,11,12,19,9,14,6,8,241
S01007696,Good health,241,10,1,9,20,10,5,11,22,28,24,16,8,111
S01007696,Fair health,58,2,1,1,6,4,3,1,18,4,9,6,3,11
S01007696,Bad health,21,1,0,1,2,2,0,1,8,4,3,3,0,0
S01007696,Very bad health,6,1,0,1,1,0,0,0,1,1,1,1,0,1
S01007697,All people aged 16 to 74,767,92,9,83,151,74,35,42,80,83,30,17,13,180
S01007697,Very good health,387,58,7,51,83,36,14,17,33,18,10,6,4,118
S01007697,Good health,249,30,2,28,48,23,16,12,26,29,16,7,9,49
S01007697,Fair health,78,4,0,4,13,9,2,2,12,25,2,2,0,9
S01007697,Bad health,40,0,0,0,5,3,1,9,7,9,2,2,0,4
S01007697,Very bad health,13,0,0,0,2,3,2,2,2,2,0,0,0,0
S01007698,All people aged 16 to 74,949,57,6,51,140,83,37,46,112,77,49,31,18,348
S01007698,Very good health,530,29,2,27,77,36,19,23,60,30,17,9,8,239
S01007698,Good health,315,22,2,20,48,35,10,18,42,28,16,7,9,96
S01007698,Fair health,58,5,2,3,8,6,4,2,6,8,12,11,1,7
S01007698,Bad health,41,0,0,0,7,6,4,3,4,9,2,2,0,6
S01007698,Very bad health,5,1,0,1,0,0,0,0,0,2,2,2,0,0
S01007699,All people aged 16 to 74,672,50,4,46,92,52,24,26,87,64,41,25,16,236
S01007699,Very good health,358,28,2,26,45,30,13,9,32,23,10,6,4,168
S01007699,Good health,214,16,1,15,37,14,6,8,30,23,18,8,10,62
S01007699,Fair health,55,4,1,3,2,5,2,5,12,10,11,9,2,4
S01007699,Bad health,36,2,0,2,6,3,2,4,12,4,1,1,0,2
S01007699,Very bad health,9,0,0,0,2,0,1,0,1,4,1,1,0,0
S01007700,All people aged 16 to 74,777,161,23,138,213,74,48,34,56,61,32,26,6,98
S01007700,Very good health,454,105,13,92,127,39,20,21,31,20,13,13,0,78
S01007700,Good health,236,48,7,41,63,28,20,8,17,27,8,5,3,17
S01007700,Fair health,59,8,3,5,15,5,7,1,6,8,7,4,3,2
S01007700,Bad health,24,0,0,0,8,1,1,3,2,5,3,3,0,1
S01007700,Very bad health,4,0,0,0,0,1,0,1,0,1,1,1,0,0
S01007701,All people aged 16 to 74,458,21,3,18,55,27,6,22,51,68,61,34,27,147
S01007701,Very good health,219,13,0,13,25,14,4,7,21,18,5,2,3,112
S01007701,Good health,134,4,2,2,18,8,0,7,12,22,33,21,12,30
S01007701,Fair health,71,1,1,0,9,5,2,7,10,16,17,6,11,4
S01007701,Bad health,26,1,0,1,3,0,0,1,5,10,6,5,1,0
S01007701,Very bad health,8,2,0,2,0,0,0,0,3,2,0,0,0,1
S01007702,All people aged 16 to 74,957,69,3,66,74,25,16,17,40,16,11,3,8,689
S01007702,Very good health,600,49,2,47,49,17,10,8,21,9,6,2,4,431
S01007702,Good health,304,16,1,15,19,6,3,7,14,5,3,0,3,231
S01007702,Fair health,39,3,0,3,4,1,3,1,2,2,1,0,1,22
S01007702,Bad health,10,1,0,1,0,1,0,1,2,0,0,0,0,5
S01007702,Very bad health,4,0,0,0,2,0,0,0,1,0,1,1,0,0
S01007703,All people aged 16 to 74,624,68,7,61,120,80,27,38,89,65,22,10,12,115
S01007703,Very good health,337,46,5,41,67,42,12,18,37,26,8,1,7,81
S01007703,Good health,188,17,2,15,37,26,10,8,30,21,7,3,4,32
S01007703,Fair health,73,5,0,5,13,8,4,10,15,11,5,4,1,2
S01007703,Bad health,17,0,0,0,0,4,1,1,4,5,2,2,0,0
S01007703,Very bad health,9,0,0,0,3,0,0,1,3,2,0,0,0,0
S01007704,All people aged 16 to 74,765,23,4,19,74,42,29,48,118,122,126,73,53,183
S01007704,Very good health,291,6,0,6,39,19,7,11,25,23,45,27,18,116
S01007704,Good health,266,12,2,10,23,16,10,22,51,40,36,13,23,56
S01007704,Fair health,121,2,1,1,8,2,7,10,22,37,25,17,8,8
S01007704,Bad health,65,3,1,2,2,5,3,3,15,16,16,13,3,2
S01007704,Very bad health,22,0,0,0,2,0,2,2,5,6,4,3,1,1
S01007705,All people aged 16 to 74,735,20,2,18,38,26,9,27,41,38,25,12,13,511
S01007705,Very good health,434,14,2,12,19,12,4,15,19,19,8,5,3,324
S01007705,Good health,247,4,0,4,16,9,2,10,13,14,14,4,10,165
S01007705,Fair health,43,1,0,1,3,5,2,1,7,4,2,2,0,18
S01007705,Bad health,5,0,0,0,0,0,0,0,2,0,1,1,0,2
S01007705,Very bad health,6,1,0,1,0,0,1,1,0,1,0,0,0,2
S01007706,All people aged 16 to 74,753,17,1,16,52,35,5,28,31,16,23,14,9,546
S01007706,Very good health,503,9,1,8,32,21,2,14,11,9,7,3,4,398
S01007706,Good health,199,6,0,6,14,11,1,10,13,5,8,4,4,131
S01007706,Fair health,31,0,0,0,2,3,2,3,5,0,4,4,0,12
S01007706,Bad health,19,2,0,2,4,0,0,1,2,2,4,3,1,4
S01007706,Very bad health,1,0,0,0,0,0,0,0,0,0,0,0,0,1
S01007707,All people aged 16 to 74,759,138,8,130,144,46,30,44,35,27,24,19,5,271
S01007707,Very good health,522,105,6,99,105,25,13,30,19,14,17,13,4,194
S01007707,Good health,196,29,2,27,32,18,14,12,11,5,4,4,0,71
S01007707,Fair health,30,3,0,3,4,3,2,2,2,6,3,2,1,5
S01007707,Bad health,9,1,0,1,3,0,0,0,2,2,0,0,0,1
S01007707,Very bad health,2,0,0,0,0,0,1,0,1,0,0,0,0,0
S01007708,All people aged 16 to 74,505,27,0,27,86,80,22,46,78,64,37,22,15,65
S01007708,Very good health,237,19,0,19,43,40,7,21,39,18,9,5,4,41
S01007708,Good health,163,5,0,5,30,24,9,10,26,22,17,9,8,20
S01007708,Fair health,65,2,0,2,7,11,4,8,8,14,7,4,3,4
S01007708,Bad health,27,1,0,1,5,3,2,2,3,7,4,4,0,0
S01007708,Very bad health,13,0,0,0,1,2,0,5,2,3,0,0,0,0
S01007709,All people aged 16 to 74,487,30,2,28,62,38,18,42,70,81,56,32,24,90
S01007709,Very good health,217,18,1,17,40,21,8,20,23,18,11,4,7,58
S01007709,Good health,157,9,0,9,14,12,4,11,32,27,21,13,8,27
S01007709,Fair health,69,0,0,0,5,4,4,7,9,20,15,8,7,5
S01007709,Bad health,38,3,1,2,3,1,1,3,5,14,8,6,2,0
S01007709,Very bad health,6,0,0,0,0,0,1,1,1,2,1,1,0,0
S01007710,All people aged 16 to 74,730,40,3,37,107,58,27,38,93,65,38,25,13,264
S01007710,Very good health,358,28,1,27,59,33,7,16,25,21,14,8,6,155
S01007710,Good health,247,8,1,7,22,15,12,16,44,23,10,8,2,97
S01007710,Fair health,85,2,1,1,17,7,4,5,13,14,11,6,5,12
S01007710,Bad health,31,2,0,2,6,3,2,1,7,7,3,3,0,0
S01007710,Very bad health,9,0,0,0,3,0,2,0,4,0,0,0,0,0
S01007711,All people aged 16 to 74,904,27,2,25,91,66,20,51,124,113,32,22,10,380
S01007711,Very good health,445,16,1,15,37,30,5,20,40,35,10,4,6,252
S01007711,Good health,322,6,1,5,38,25,11,24,51,47,13,10,3,107
S01007711,Fair health,94,4,0,4,14,7,3,5,16,18,6,5,1,21
S01007711,Bad health,32,1,0,1,2,2,1,1,14,9,2,2,0,0
S01007711,Very bad health,11,0,0,0,0,2,0,1,3,4,1,1,0,0
S01007712,All people aged 16 to 74,590,49,1,48,104,63,21,35,54,42,23,16,7,199
S01007712,Very good health,292,29,1,28,65,31,6,13,23,10,3,2,1,112
S01007712,Good health,209,20,0,20,27,16,9,16,20,18,7,4,3,76
S01007712,Fair health,68,0,0,0,11,14,4,5,5,12,9,7,2,8
S01007712,Bad health,17,0,0,0,1,2,1,0,5,2,3,2,1,3
S01007712,Very bad health,4,0,0,0,0,0,1,1,1,0,1,1,0,0
S01007713,All people aged 16 to 74,396,25,2,23,49,40,26,28,60,46,46,34,12,76
S01007713,Very good health,167,14,2,12,22,14,7,11,16,19,16,8,8,48
S01007713,Good health,153,10,0,10,14,20,11,10,27,14,21,18,3,26
S01007713,Fair health,54,0,0,0,11,4,6,6,9,10,7,6,1,1
S01007713,Bad health,18,0,0,0,2,1,2,1,7,2,2,2,0,1
S01007713,Very bad health,4,1,0,1,0,1,0,0,1,1,0,0,0,0
S01007714,All people aged 16 to 74,523,19,2,17,84,71,22,52,95,87,27,20,7,66
S01007714,Very good health,228,9,0,9,46,35,8,19,37,20,13,7,6,41
S01007714,Good health,199,9,2,7,31,24,8,21,38,40,6,5,1,22
S01007714,Fair health,63,1,0,1,6,8,4,6,16,14,6,6,0,2
S01007714,Bad health,29,0,0,0,0,4,2,6,3,11,2,2,0,1
S01007714,Very bad health,4,0,0,0,1,0,0,0,1,2,0,0,0,0
S01007715,All people aged 16 to 74,397,14,1,13,53,29,13,25,75,66,47,28,19,75
S01007715,Very good health,167,5,0,5,19,12,5,8,36,17,15,11,4,50
S01007715,Good health,153,6,0,6,23,7,6,9,28,28,22,7,15,24
S01007715,Fair health,50,2,0,2,7,10,1,2,8,14,5,5,0,1
S01007715,Bad health,20,1,1,0,3,0,1,4,1,6,4,4,0,0
S01007715,Very bad health,7,0,0,0,1,0,0,2,2,1,1,1,0,0
S01007716,All people aged 16 to 74,811,30,4,26,93,73,41,59,117,133,105,82,23,160
S01007716,Very good health,357,22,3,19,35,29,18,24,47,30,31,25,6,121
S01007716,Good health,252,7,1,6,36,26,9,12,46,54,29,17,12,33
S01007716,Fair health,140,0,0,0,15,11,8,15,18,32,36,32,4,5
S01007716,Bad health,54,0,0,0,5,7,6,6,6,14,9,8,1,1
S01007716,Very bad health,8,1,0,1,2,0,0,2,0,3,0,0,0,0
S01007717,All people aged 16 to 74,789,17,4,13,92,85,43,49,151,135,81,41,40,136
S01007717,Very good health,337,7,1,6,49,34,12,17,50,46,27,13,14,95
S01007717,Good health,283,8,3,5,32,32,19,24,63,39,36,19,17,30
S01007717,Fair health,97,0,0,0,8,13,9,5,22,19,12,5,7,9
S01007717,Bad health,45,2,0,2,2,4,1,1,10,18,5,3,2,2
S01007717,Very bad health,27,0,0,0,1,2,2,2,6,13,1,1,0,0
S01007718,All people aged 16 to 74,566,20,2,18,73,49,35,61,108,105,41,23,18,74
S01007718,Very good health,230,10,0,10,33,22,13,28,38,28,13,5,8,45
S01007718,Good health,176,6,2,4,23,16,9,17,38,31,13,9,4,23
S01007718,Fair health,112,3,0,3,10,5,9,12,26,29,13,7,6,5
S01007718,Bad health,37,1,0,1,5,4,4,3,4,14,1,1,0,1
S01007718,Very bad health,11,0,0,0,2,2,0,1,2,3,1,1,0,0
S01007719,All people aged 16 to 74,774,24,3,21,118,95,37,77,151,155,51,25,26,66
S01007719,Very good health,313,14,2,12,71,34,13,37,43,46,15,6,9,40
S01007719,Good health,257,8,1,7,35,38,16,20,56,47,17,7,10,20
S01007719,Fair health,130,2,0,2,7,16,3,14,35,32,15,10,5,6
S01007719,Bad health,57,0,0,0,5,5,5,5,12,22,3,1,2,0
S01007719,Very bad health,17,0,0,0,0,2,0,1,5,8,1,1,0,0
S01007720,All people aged 16 to 74,521,19,5,14,76,82,28,54,104,93,32,19,13,33
S01007720,Very good health,195,11,4,7,35,34,11,16,33,24,9,5,4,22
S01007720,Good health,186,2,0,2,27,31,10,17,46,32,11,5,6,10
S01007720,Fair health,85,6,1,5,11,9,6,13,12,21,6,4,2,1
S01007720,Bad health,41,0,0,0,2,4,1,5,11,15,3,2,1,0
S01007720,Very bad health,14,0,0,0,1,4,0,3,2,1,3,3,0,0
S01007721,All people aged 16 to 74,578,18,2,16,110,69,38,70,79,108,37,18,19,49
S01007721,Very good health,243,10,1,9,51,32,19,31,19,30,10,5,5,41
S01007721,Good health,217,5,1,4,40,25,13,22,38,47,20,9,11,7
S01007721,Fair health,77,2,0,2,12,10,6,6,14,20,7,4,3,0
S01007721,Bad health,29,1,0,1,6,1,0,7,6,7,0,0,0,1
S01007721,Very bad health,12,0,0,0,1,1,0,4,2,4,0,0,0,0
S01007722,All people aged 16 to 74,667,19,4,15,82,83,30,63,122,146,77,55,22,45
S01007722,Very good health,264,12,2,10,41,34,17,23,58,26,20,10,10,33
S01007722,Good health,196,6,2,4,27,29,7,18,29,49,22,15,7,9
S01007722,Fair health,131,1,0,1,8,10,5,14,23,44,24,19,5,2
S01007722,Bad health,61,0,0,0,5,8,0,6,10,23,8,8,0,1
S01007722,Very bad health,15,0,0,0,1,2,1,2,2,4,3,3,0,0
S01007723,All people aged 16 to 74,726,16,2,14,91,71,22,75,145,177,70,55,15,59
S01007723,Very good health,226,6,1,5,38,25,8,22,40,36,13,9,4,38
S01007723,Good health,272,6,1,5,31,28,8,28,61,63,28,20,8,19
S01007723,Fair health,139,3,0,3,13,15,2,13,25,49,17,15,2,2
S01007723,Bad health,61,0,0,0,7,3,4,8,10,22,7,6,1,0
S01007723,Very bad health,28,1,0,1,2,0,0,4,9,7,5,5,0,0
S01007724,All people aged 16 to 74,519,11,0,11,40,57,15,47,103,84,61,36,25,101
S01007724,Very good health,239,8,0,8,25,29,6,18,43,32,20,10,10,58
S01007724,Good health,170,3,0,3,9,21,5,13,38,19,24,12,12,38
S01007724,Fair health,69,0,0,0,6,5,2,13,15,18,6,5,1,4
S01007724,Bad health,29,0,0,0,0,1,2,3,6,11,6,5,1,0
S01007724,Very bad health,12,0,0,0,0,1,0,0,1,4,5,4,1,1
S01007725,All people aged 16 to 74,631,22,0,22,79,80,21,53,95,142,72,40,32,67
S01007725,Very good health,235,11,0,11,32,23,10,20,44,33,24,12,12,38
S01007725,Good health,245,9,0,9,30,37,10,26,36,50,28,11,17,19
S01007725,Fair health,99,2,0,2,12,12,0,4,8,37,15,13,2,9
S01007725,Bad health,40,0,0,0,5,4,1,3,7,17,3,2,1,0
S01007725,Very bad health,12,0,0,0,0,4,0,0,0,5,2,2,0,1
S01007726,All people aged 16 to 74,647,21,5,16,90,66,28,54,108,107,69,52,17,104
S01007726,Very good health,313,10,2,8,45,38,12,34,53,31,23,15,8,67
S01007726,Good health,186,8,1,7,30,16,6,12,29,43,16,13,3,26
S01007726,Fair health,94,3,2,1,9,8,6,5,14,22,18,13,5,9
S01007726,Bad health,42,0,0,0,6,2,3,2,8,9,10,9,1,2
S01007726,Very bad health,12,0,0,0,0,2,1,1,4,2,2,2,0,0
S01007727,All people aged 16 to 74,845,23,2,21,108,86,40,54,129,147,85,61,24,173
S01007727,Very good health,385,14,1,13,54,35,20,22,51,44,32,26,6,113
S01007727,Good health,286,9,1,8,37,32,13,17,43,58,28,16,12,49
S01007727,Fair health,102,0,0,0,7,12,4,11,21,25,13,8,5,9
S01007727,Bad health,54,0,0,0,6,5,2,2,12,17,9,8,1,1
S01007727,Very bad health,18,0,0,0,4,2,1,2,2,3,3,3,0,1
S01007728,All people aged 16 to 74,674,20,2,18,79,62,28,55,103,85,64,36,28,178
S01007728,Very good health,322,13,1,12,57,18,11,19,42,20,28,12,16,114
S01007728,Good health,233,4,1,3,15,26,11,24,37,38,18,12,6,60
S01007728,Fair health,77,1,0,1,3,13,2,8,15,18,14,10,4,3
S01007728,Bad health,28,1,0,1,4,3,2,4,5,7,1,0,1,1
S01007728,Very bad health,14,1,0,1,0,2,2,0,4,2,3,2,1,0
S01007729,All people aged 16 to 74,654,25,3,22,91,65,24,50,106,104,62,28,34,127
S01007729,Very good health,300,14,2,12,47,26,11,18,34,41,20,10,10,89
S01007729,Good health,232,9,1,8,34,27,6,16,44,37,28,13,15,31
S01007729,Fair health,92,2,0,2,8,8,6,10,21,20,11,4,7,6
S01007729,Bad health,27,0,0,0,1,4,1,6,6,5,3,1,2,1
S01007729,Very bad health,3,0,0,0,1,0,0,0,1,1,0,0,0,0
S01007730,All people aged 16 to 74,661,43,2,41,121,86,29,45,122,70,43,20,23,102
S01007730,Very good health,348,26,1,25,72,46,12,26,47,27,17,4,13,75
S01007730,Good health,205,12,1,11,38,24,10,12,46,25,14,8,6,24
S01007730,Fair health,70,2,0,2,7,10,7,4,20,9,9,6,3,2
S01007730,Bad health,28,3,0,3,4,5,0,1,8,6,0,0,0,1
S01007730,Very bad health,10,0,0,0,0,1,0,2,1,3,3,2,1,0
S01007731,All people aged 16 to 74,589,35,5,30,130,71,23,47,100,68,36,20,16,79
S01007731,Very good health,285,19,3,16,77,34,10,16,49,24,9,2,7,47
S01007731,Good health,214,13,2,11,47,28,8,21,29,21,18,11,7,29
S01007731,Fair health,58,2,0,2,3,5,5,7,16,13,4,3,1,3
S01007731,Bad health,26,1,0,1,1,3,0,0,6,10,5,4,1,0
S01007731,Very bad health,6,0,0,0,2,1,0,3,0,0,0,0,0,0
S01007732,All people aged 16 to 74,564,40,2,38,91,63,24,41,91,65,36,19,17,113
S01007732,Very good health,328,35,2,33,57,38,14,14,40,30,20,8,12,80
S01007732,Good health,145,3,0,3,23,19,6,15,30,18,4,3,1,27
S01007732,Fair health,65,1,0,1,10,6,2,9,10,10,11,7,4,6
S01007732,Bad health,19,1,0,1,1,0,2,2,7,5,1,1,0,0
S01007732,Very bad health,7,0,0,0,0,0,0,1,4,2,0,0,0,0
S01007733,All people aged 16 to 74,642,74,19,55,189,93,56,42,62,38,35,22,13,53
S01007733,Very good health,377,46,11,35,132,60,18,23,22,16,16,6,10,44
S01007733,Good health,197,22,7,15,49,24,27,12,29,16,10,8,2,8
S01007733,Fair health,52,6,1,5,6,7,10,4,8,4,6,5,1,1
S01007733,Bad health,10,0,0,0,2,1,0,2,2,1,2,2,0,0
S01007733,Very bad health,6,0,0,0,0,1,1,1,1,1,1,1,0,0
S01007734,All people aged 16 to 74,616,68,15,53,164,104,58,44,63,55,18,9,9,42
S01007734,Very good health,358,44,9,35,97,57,32,22,34,22,12,6,6,38
S01007734,Good health,185,20,6,14,53,35,21,11,18,19,4,2,2,4
S01007734,Fair health,59,4,0,4,14,9,5,7,8,11,1,1,0,0
S01007734,Bad health,12,0,0,0,0,3,0,4,2,2,1,0,1,0
S01007734,Very bad health,2,0,0,0,0,0,0,0,1,1,0,0,0,0
S01007735,All people aged 16 to 74,637,63,11,52,165,102,47,53,76,52,19,12,7,60
S01007735,Very good health,328,37,8,29,86,48,20,27,37,19,5,1,4,49
S01007735,Good health,214,20,2,18,59,42,19,17,28,13,8,6,2,8
S01007735,Fair health,78,6,1,5,16,10,8,8,9,15,3,3,0,3
S01007735,Bad health,15,0,0,0,4,1,0,1,2,4,3,2,1,0
S01007735,Very bad health,2,0,0,0,0,1,0,0,0,1,0,0,0,0
S01007736,All people aged 16 to 74,543,46,9,37,113,74,55,52,86,45,20,18,2,52
S01007736,Very good health,314,28,6,22,74,39,27,33,39,19,11,9,2,44
S01007736,Good health,148,16,3,13,27,26,12,17,31,8,3,3,0,8
S01007736,Fair health,60,1,0,1,12,6,10,2,12,14,3,3,0,0
S01007736,Bad health,19,1,0,1,0,3,5,0,3,4,3,3,0,0
S01007736,Very bad health,2,0,0,0,0,0,1,0,1,0,0,0,0,0
S01007737,All people aged 16 to 74,757,59,7,52,167,117,56,53,126,83,34,25,9,62
S01007737,Very good health,344,35,3,32,79,58,21,19,55,28,10,6,4,39
S01007737,Good health,282,19,4,15,69,40,20,20,47,32,13,10,3,22
S01007737,Fair health,88,3,0,3,11,15,9,8,18,16,7,5,2,1
S01007737,Bad health,34,2,0,2,5,2,6,5,5,6,3,3,0,0
S01007737,Very bad health,9,0,0,0,3,2,0,1,1,1,1,1,0,0
S01007738,All people aged 16 to 74,495,48,13,35,103,81,30,43,72,68,22,10,12,28
S01007738,Very good health,250,30,4,26,57,34,10,23,36,25,14,8,6,21
S01007738,Good health,180,13,6,7,38,39,15,11,26,28,3,0,3,7
S01007738,Fair health,42,4,2,2,3,3,5,6,8,10,3,0,3,0
S01007738,Bad health,14,1,1,0,3,4,0,3,0,2,1,1,0,0
S01007738,Very bad health,9,0,0,0,2,1,0,0,2,3,1,1,0,0
S01007739,All people aged 16 to 74,390,22,5,17,75,54,28,35,69,70,14,5,9,23
S01007739,Very good health,172,9,2,7,39,23,9,17,27,22,7,2,5,19
S01007739,Good health,130,9,2,7,20,21,12,12,23,24,5,1,4,4
S01007739,Fair health,57,2,0,2,10,8,5,3,12,16,1,1,0,0
S01007739,Bad health,24,2,1,1,5,2,2,3,5,5,0,0,0,0
S01007739,Very bad health,7,0,0,0,1,0,0,0,2,3,1,1,0,0
S01007740,All people aged 16 to 74,422,32,4,28,98,83,27,38,64,35,16,10,6,29
S01007740,Very good health,210,21,3,18,47,52,7,18,27,15,2,1,1,21
S01007740,Good health,128,9,1,8,34,19,11,14,24,8,5,1,4,4
S01007740,Fair health,62,2,0,2,12,9,6,2,11,10,6,5,1,4
S01007740,Bad health,17,0,0,0,5,3,1,3,1,2,2,2,0,0
S01007740,Very bad health,5,0,0,0,0,0,2,1,1,0,1,1,0,0
S01007741,All people aged 16 to 74,508,31,10,21,83,87,28,27,88,95,29,17,12,40
S01007741,Very good health,229,18,8,10,51,35,10,6,38,28,6,2,4,37
S01007741,Good health,152,10,0,10,24,33,13,10,25,30,5,4,1,2
S01007741,Fair health,76,3,2,1,5,7,4,5,18,20,13,6,7,1
S01007741,Bad health,42,0,0,0,2,11,1,6,6,13,3,3,0,0
S01007741,Very bad health,9,0,0,0,1,1,0,0,1,4,2,2,0,0
S01007742,All people aged 16 to 74,453,26,9,17,102,74,29,34,68,72,15,10,5,33
S01007742,Very good health,207,12,4,8,57,38,10,12,24,23,4,2,2,27
S01007742,Good health,147,12,3,9,31,24,9,11,26,24,4,2,2,6
S01007742,Fair health,61,1,1,0,12,8,6,6,10,15,3,3,0,0
S01007742,Bad health,28,1,1,0,1,3,4,3,5,8,3,2,1,0
S01007742,Very bad health,10,0,0,0,1,1,0,2,3,2,1,1,0,0
S01007743,All people aged 16 to 74,666,31,7,24,101,89,35,69,122,124,42,21,21,53
S01007743,Very good health,297,14,4,10,59,38,17,30,46,45,11,7,4,37
S01007743,Good health,228,11,2,9,22,39,15,28,40,43,17,8,9,13
S01007743,Fair health,97,3,1,2,14,6,3,4,24,29,11,5,6,3
S01007743,Bad health,33,2,0,2,6,6,0,6,9,3,1,0,1,0
S01007743,Very bad health,11,1,0,1,0,0,0,1,3,4,2,1,1,0
S01007744,All people aged 16 to 74,534,12,1,11,59,57,18,43,115,133,62,41,21,35
S01007744,Very good health,194,5,0,5,30,22,2,15,36,40,16,9,7,28
S01007744,Good health,187,5,1,4,17,26,8,13,46,43,24,15,9,5
S01007744,Fair health,91,1,0,1,10,6,6,6,13,35,12,7,5,2
S01007744,Bad health,42,0,0,0,0,2,1,6,12,14,7,7,0,0
S01007744,Very bad health,20,1,0,1,2,1,1,3,8,1,3,3,0,0
S01007745,All people aged 16 to 74,496,8,1,7,59,67,31,57,114,104,31,11,20,25
S01007745,Very good health,197,7,1,6,19,31,12,24,46,34,10,3,7,14
S01007745,Good health,172,1,0,1,24,24,15,17,41,36,5,1,4,9
S01007745,Fair health,88,0,0,0,7,11,1,10,20,23,14,5,9,2
S01007745,Bad health,28,0,0,0,6,1,3,4,5,7,2,2,0,0
S01007745,Very bad health,11,0,0,0,3,0,0,2,2,4,0,0,0,0
S01007746,All people aged 16 to 74,672,8,2,6,83,62,25,71,138,174,75,45,30,36
S01007746,Very good health,233,2,0,2,27,25,8,21,53,51,21,12,9,25
S01007746,Good health,270,4,1,3,38,25,14,31,54,61,35,20,15,8
S01007746,Fair health,109,2,1,1,13,8,3,13,19,37,11,5,6,3
S01007746,Bad health,44,0,0,0,4,3,0,5,8,16,8,8,0,0
S01007746,Very bad health,16,0,0,0,1,1,0,1,4,9,0,0,0,0
S01007747,All people aged 16 to 74,388,7,2,5,43,38,23,42,93,75,43,25,18,24
S01007747,Very good health,163,3,0,3,26,16,4,16,48,24,9,6,3,17
S01007747,Good health,135,2,1,1,13,14,9,14,28,26,23,10,13,6
S01007747,Fair health,55,2,1,1,2,3,8,6,12,14,7,6,1,1
S01007747,Bad health,27,0,0,0,2,5,1,5,2,9,3,2,1,0
S01007747,Very bad health,8,0,0,0,0,0,1,1,3,2,1,1,0,0
S01007748,All people aged 16 to 74,496,5,1,4,63,47,23,41,106,105,78,52,26,28
S01007748,Very good health,209,2,0,2,25,25,10,16,47,37,31,21,10,16
S01007748,Good health,152,1,0,1,22,14,6,12,37,25,25,16,9,10
S01007748,Fair health,82,1,1,0,7,5,2,7,13,30,15,9,6,2
S01007748,Bad health,45,1,0,1,7,2,5,5,7,11,7,6,1,0
S01007748,Very bad health,8,0,0,0,2,1,0,1,2,2,0,0,0,0
S01007749,All people aged 16 to 74,537,46,11,35,120,105,35,48,80,41,23,16,7,39
S01007749,Very good health,285,30,7,23,67,48,16,22,36,16,14,9,5,36
S01007749,Good health,167,14,4,10,41,37,13,17,28,12,3,1,2,2
S01007749,Fair health,64,2,0,2,10,18,5,6,12,8,2,2,0,1
S01007749,Bad health,13,0,0,0,2,1,1,1,2,3,3,3,0,0
S01007749,Very bad health,8,0,0,0,0,1,0,2,2,2,1,1,0,0
S01007750,All people aged 16 to 74,595,103,17,86,152,107,57,34,61,33,11,10,1,37
S01007750,Very good health,339,66,13,53,94,51,28,21,28,15,3,3,0,33
S01007750,Good health,196,32,4,28,44,45,22,10,24,15,1,1,0,3
S01007750,Fair health,46,4,0,4,12,9,5,3,7,2,3,2,1,1
S01007750,Bad health,12,1,0,1,1,1,2,0,2,1,4,4,0,0
S01007750,Very bad health,2,0,0,0,1,1,0,0,0,0,0,0,0,0
S01007751,All people aged 16 to 74,491,88,14,74,144,63,47,22,39,28,27,21,6,33
S01007751,Very good health,280,60,11,49,86,34,18,12,19,14,7,3,4,30
S01007751,Good health,152,24,2,22,41,23,15,7,14,7,18,16,2,3
S01007751,Fair health,47,3,1,2,14,5,11,3,4,5,2,2,0,0
S01007751,Bad health,8,1,0,1,1,0,3,0,1,2,0,0,0,0
S01007751,Very bad health,4,0,0,0,2,1,0,0,1,0,0,0,0,0
S01007752,All people aged 16 to 74,449,92,16,76,139,57,24,23,49,28,10,6,4,27
S01007752,Very good health,248,64,12,52,78,29,15,12,13,11,4,2,2,22
S01007752,Good health,147,21,3,18,50,21,8,6,24,11,1,0,1,5
S01007752,Fair health,40,7,1,6,8,7,1,3,6,4,4,3,1,0
S01007752,Bad health,12,0,0,0,2,0,0,2,5,2,1,1,0,0
S01007752,Very bad health,2,0,0,0,1,0,0,0,1,0,0,0,0,0
S01007753,All people aged 16 to 74,382,4,1,3,50,42,19,40,82,98,25,15,10,22
S01007753,Very good health,150,1,1,0,23,26,6,16,24,32,9,4,5,13
S01007753,Good health,126,2,0,2,16,9,11,12,33,31,6,4,2,6
S01007753,Fair health,59,0,0,0,6,4,1,5,17,16,8,5,3,2
S01007753,Bad health,33,0,0,0,3,3,1,6,6,12,1,1,0,1
S01007753,Very bad health,14,1,0,1,2,0,0,1,2,7,1,1,0,0
S01007754,All people aged 16 to 74,614,10,1,9,60,64,33,42,140,158,73,39,34,34
S01007754,Very good health,242,8,0,8,31,34,17,15,44,44,19,11,8,30
S01007754,Good health,203,2,1,1,17,16,8,13,57,56,31,13,18,3
S01007754,Fair health,94,0,0,0,6,8,3,5,24,31,16,9,7,1
S01007754,Bad health,60,0,0,0,4,5,3,8,12,23,5,5,0,0
S01007754,Very bad health,15,0,0,0,2,1,2,1,3,4,2,1,1,0
S01007755,All people aged 16 to 74,570,7,1,6,73,63,20,48,121,132,74,44,30,32
S01007755,Very good health,223,1,0,1,30,34,7,20,53,38,18,13,5,22
S01007755,Good health,197,4,0,4,26,22,8,13,40,49,30,17,13,5
S01007755,Fair health,103,2,1,1,13,5,3,11,16,29,20,9,11,4
S01007755,Bad health,38,0,0,0,3,1,2,3,10,14,4,3,1,1
S01007755,Very bad health,9,0,0,0,1,1,0,1,2,2,2,2,0,0
S01007756,All people aged 16 to 74,411,6,0,6,49,45,19,29,113,92,38,25,13,20
S01007756,Very good health,155,4,0,4,25,10,6,12,50,26,9,7,2,13
S01007756,Good health,146,2,0,2,13,22,8,8,36,33,17,8,9,7
S01007756,Fair health,76,0,0,0,9,6,5,4,21,22,9,7,2,0
S01007756,Bad health,24,0,0,0,1,7,0,1,5,10,0,0,0,0
S01007756,Very bad health,10,0,0,0,1,0,0,4,1,1,3,3,0,0
S01007757,All people aged 16 to 74,589,57,8,49,186,121,41,41,62,29,5,3,2,47
S01007757,Very good health,319,31,6,25,102,60,25,20,29,13,3,2,1,36
S01007757,Good health,205,20,2,18,63,44,14,19,25,9,1,1,0,10
S01007757,Fair health,46,4,0,4,14,13,1,2,6,5,0,0,0,1
S01007757,Bad health,14,2,0,2,5,2,1,0,2,2,0,0,0,0
S01007757,Very bad health,5,0,0,0,2,2,0,0,0,0,1,0,1,0
S01007758,All people aged 16 to 74,628,110,19,91,209,76,60,35,60,30,13,9,4,35
S01007758,Very good health,352,62,12,50,124,36,34,15,32,12,7,5,2,30
S01007758,Good health,197,38,6,32,64,24,17,15,20,11,4,2,2,4
S01007758,Fair health,64,8,0,8,20,15,6,4,6,4,0,0,0,1
S01007758,Bad health,11,1,0,1,1,1,1,1,2,2,2,2,0,0
S01007758,Very bad health,4,1,1,0,0,0,2,0,0,1,0,0,0,0
S01007759,All people aged 16 to 74,733,64,9,55,177,101,54,58,118,77,34,16,18,50
S01007759,Very good health,341,35,7,28,91,48,24,28,43,28,12,5,7,32
S01007759,Good health,251,25,2,23,65,28,16,20,45,25,12,3,9,15
S01007759,Fair health,90,3,0,3,15,17,10,6,16,15,7,5,2,1
S01007759,Bad health,31,1,0,1,4,5,3,1,7,7,2,2,0,1
S01007759,Very bad health,20,0,0,0,2,3,1,3,7,2,1,1,0,1
S01007760,All people aged 16 to 74,405,84,20,64,135,60,37,12,28,13,7,5,2,29
S01007760,Very good health,246,55,13,42,87,32,17,8,18,5,1,1,0,23
S01007760,Good health,121,24,5,19,36,23,15,2,6,6,4,3,1,5
S01007760,Fair health,26,3,2,1,8,3,4,1,4,1,2,1,1,0
S01007760,Bad health,8,1,0,1,3,1,1,1,0,1,0,0,0,0
S01007760,Very bad health,4,1,0,1,1,1,0,0,0,0,0,0,0,1
S01007761,All people aged 16 to 74,639,116,14,102,205,75,50,34,55,31,17,8,9,56
S01007761,Very good health,363,71,9,62,119,33,27,19,30,16,7,3,4,41
S01007761,Good health,212,38,4,34,67,34,16,10,18,9,7,4,3,13
S01007761,Fair health,51,6,1,5,17,8,6,1,4,4,3,1,2,2
S01007761,Bad health,10,1,0,1,2,0,1,4,0,2,0,0,0,0
S01007761,Very bad health,3,0,0,0,0,0,0,0,3,0,0,0,0,0
S01007762,All people aged 16 to 74,566,77,11,66,163,79,42,47,68,48,9,5,4,33
S01007762,Very good health,307,46,5,41,98,33,20,24,36,20,2,1,1,28
S01007762,Good health,187,25,5,20,48,29,17,15,24,22,4,2,2,3
S01007762,Fair health,46,5,1,4,10,11,3,4,7,3,1,1,0,2
S01007762,Bad health,17,0,0,0,5,4,1,3,1,1,2,1,1,0
S01007762,Very bad health,9,1,0,1,2,2,1,1,0,2,0,0,0,0
S01007763,All people aged 16 to 74,335,21,3,18,68,53,27,40,48,49,16,8,8,13
S01007763,Very good health,134,10,2,8,32,22,10,11,20,17,3,1,2,9
S01007763,Good health,114,7,0,7,21,14,12,19,13,19,6,2,4,3
S01007763,Fair health,55,3,1,2,12,11,2,5,10,6,5,4,1,1
S01007763,Bad health,26,1,0,1,2,5,3,3,5,5,2,1,1,0
S01007763,Very bad health,6,0,0,0,1,1,0,2,0,2,0,0,0,0
S01007764,All people aged 16 to 74,588,70,20,50,161,105,53,42,59,35,8,6,2,55
S01007764,Very good health,374,46,15,31,100,59,36,28,39,17,3,3,0,46
S01007764,Good health,155,20,4,16,41,33,16,12,11,15,2,0,2,5
S01007764,Fair health,43,3,1,2,14,9,0,1,8,2,3,3,0,3
S01007764,Bad health,12,1,0,1,4,4,0,1,1,0,0,0,0,1
S01007764,Very bad health,4,0,0,0,2,0,1,0,0,1,0,0,0,0
S01007765,All people aged 16 to 74,496,56,8,48,142,106,33,36,66,24,7,3,4,26
S01007765,Very good health,271,30,5,25,88,47,17,22,35,8,2,1,1,22
S01007765,Good health,159,24,3,21,39,42,9,10,20,11,0,0,0,4
S01007765,Fair health,45,2,0,2,7,12,4,4,8,4,4,2,2,0
S01007765,Bad health,17,0,0,0,6,5,2,0,2,1,1,0,1,0
S01007765,Very bad health,4,0,0,0,2,0,1,0,1,0,0,0,0,0
S01007766,All people aged 16 to 74,653,86,19,67,208,108,32,42,69,41,7,4,3,60
S01007766,Very good health,371,46,9,37,121,53,20,27,31,22,5,3,2,46
S01007766,Good health,216,30,8,22,67,41,9,12,28,15,1,0,1,13
S01007766,Fair health,52,9,2,7,15,11,3,1,8,4,0,0,0,1
S01007766,Bad health,13,1,0,1,5,2,0,2,2,0,1,1,0,0
S01007766,Very bad health,1,0,0,0,0,1,0,0,0,0,0,0,0,0
S01007767,All people aged 16 to 74,658,79,20,59,188,114,49,47,69,45,18,12,6,49
S01007767,Very good health,350,52,11,41,100,60,21,25,27,25,7,4,3,33
S01007767,Good health,227,17,6,11,67,39,21,15,31,15,6,3,3,16
S01007767,Fair health,58,9,3,6,17,11,5,4,9,2,1,1,0,0
S01007767,Bad health,16,1,0,1,2,1,0,3,2,3,4,4,0,0
S01007767,Very bad health,7,0,0,0,2,3,2,0,0,0,0,0,0,0
S01007768,All people aged 16 to 74,470,66,10,56,168,55,30,22,50,23,18,11,7,38
S01007768,Very good health,269,41,4,37,98,32,16,15,30,4,7,3,4,26
S01007768,Good health,136,19,6,13,47,15,11,3,17,9,4,2,2,11
S01007768,Fair health,36,4,0,4,13,6,3,2,2,5,1,1,0,0
S01007768,Bad health,22,2,0,2,9,1,0,1,1,5,2,1,1,1
S01007768,Very bad health,7,0,0,0,1,1,0,1,0,0,4,4,0,0
S01007769,All people aged 16 to 74,532,73,17,56,184,81,49,19,49,29,11,8,3,37
S01007769,Very good health,298,41,11,30,112,38,23,7,29,13,4,4,0,31
S01007769,Good health,176,28,5,23,53,33,20,6,15,11,4,2,2,6
S01007769,Fair health,45,4,1,3,15,8,5,4,3,4,2,2,0,0
S01007769,Bad health,8,0,0,0,3,2,0,1,2,0,0,0,0,0
S01007769,Very bad health,5,0,0,0,1,0,1,1,0,1,1,0,1,0
S01007770,All people aged 16 to 74,522,121,28,93,155,70,39,26,39,18,9,4,5,45
S01007770,Very good health,302,71,17,54,94,36,11,17,20,12,5,1,4,36
S01007770,Good health,185,47,11,36,53,26,24,8,14,3,2,1,1,8
S01007770,Fair health,29,3,0,3,6,7,4,1,3,2,2,2,0,1
S01007770,Bad health,3,0,0,0,1,0,0,0,2,0,0,0,0,0
S01007770,Very bad health,3,0,0,0,1,1,0,0,0,1,0,0,0,0
S01007771,All people aged 16 to 74,376,77,14,63,115,63,25,22,22,17,12,7,5,23
S01007771,Very good health,185,45,9,36,49,27,13,9,11,7,4,3,1,20
S01007771,Good health,144,26,4,22,51,21,10,12,7,8,7,4,3,2
S01007771,Fair health,37,6,1,5,10,12,1,1,4,1,1,0,1,1
S01007771,Bad health,7,0,0,0,3,3,1,0,0,0,0,0,0,0
S01007771,Very bad health,3,0,0,0,2,0,0,0,0,1,0,0,0,0
S01007772,All people aged 16 to 74,682,37,5,32,135,118,30,60,127,93,39,23,16,43
S01007772,Very good health,295,23,3,20,58,56,11,23,50,30,13,10,3,31
S01007772,Good health,231,7,0,7,47,46,15,19,43,31,14,6,8,9
S01007772,Fair health,103,5,1,4,20,10,1,13,25,19,7,2,5,3
S01007772,Bad health,38,2,1,1,9,5,2,3,4,11,2,2,0,0
S01007772,Very bad health,15,0,0,0,1,1,1,2,5,2,3,3,0,0
S01007773,All people aged 16 to 74,581,53,13,40,177,110,44,43,72,32,10,6,4,40
S01007773,Very good health,329,28,7,21,109,62,23,24,31,17,1,1,0,34
S01007773,Good health,184,17,4,13,52,40,10,17,29,7,6,3,3,6
S01007773,Fair health,49,8,2,6,11,5,4,1,11,6,3,2,1,0
S01007773,Bad health,12,0,0,0,3,2,5,1,0,1,0,0,0,0
S01007773,Very bad health,7,0,0,0,2,1,2,0,1,1,0,0,0,0
S01007774,All people aged 16 to 74,671,98,20,78,225,108,44,48,62,27,7,4,3,52
S01007774,Very good health,447,64,14,50,155,66,25,37,42,10,3,3,0,45
S01007774,Good health,174,28,6,22,54,31,16,8,11,15,4,1,3,7
S01007774,Fair health,41,5,0,5,14,10,1,3,6,2,0,0,0,0
S01007774,Bad health,6,1,0,1,2,0,1,0,2,0,0,0,0,0
S01007774,Very bad health,3,0,0,0,0,1,1,0,1,0,0,0,0,0
S01007775,All people aged 16 to 74,628,82,17,65,187,105,37,49,73,34,13,7,6,48
S01007775,Very good health,403,57,10,47,127,71,21,32,35,15,7,3,4,38
S01007775,Good health,165,22,5,17,40,27,13,15,26,11,1,0,1,10
S01007775,Fair health,42,3,2,1,11,6,3,2,10,5,2,1,1,0
S01007775,Bad health,16,0,0,0,8,1,0,0,2,3,2,2,0,0
S01007775,Very bad health,2,0,0,0,1,0,0,0,0,0,1,1,0,0
S01007776,All people aged 16 to 74,523,91,23,68,168,74,32,31,36,26,11,8,3,54
S01007776,Very good health,338,64,18,46,112,43,18,17,19,12,5,3,2,48
S01007776,Good health,147,23,4,19,42,27,12,10,13,11,3,3,0,6
S01007776,Fair health,27,2,1,1,10,3,2,4,3,1,2,1,1,0
S01007776,Bad health,8,2,0,2,3,1,0,0,1,1,0,0,0,0
S01007776,Very bad health,3,0,0,0,1,0,0,0,0,1,1,1,0,0
S01007777,All people aged 16 to 74,661,102,17,85,227,99,45,39,56,25,9,6,3,59
S01007777,Very good health,470,71,12,59,167,73,23,24,33,21,4,3,1,54
S01007777,Good health,165,29,5,24,52,23,18,12,19,4,3,2,1,5
S01007777,Fair health,15,1,0,1,5,2,2,2,1,0,2,1,1,0
S01007777,Bad health,9,0,0,0,3,1,2,1,2,0,0,0,0,0
S01007777,Very bad health,2,1,0,1,0,0,0,0,1,0,0,0,0,0
S01007778,All people aged 16 to 74,363,70,14,56,126,27,31,18,39,14,21,21,0,17
S01007778,Very good health,221,45,8,37,83,20,20,12,20,4,2,2,0,15
S01007778,Good health,76,21,6,15,28,4,4,3,9,3,3,3,0,1
S01007778,Fair health,36,3,0,3,12,0,5,2,0,3,10,10,0,1
S01007778,Bad health,20,0,0,0,2,2,2,1,5,3,5,5,0,0
S01007778,Very bad health,10,1,0,1,1,1,0,0,5,1,1,1,0,0
S01007779,All people aged 16 to 74,577,27,12,15,113,106,42,65,108,70,17,11,6,29
S01007779,Very good health,275,16,7,9,55,49,18,35,54,20,8,5,3,20
S01007779,Good health,210,10,5,5,41,48,15,18,35,30,5,3,2,8
S01007779,Fair health,63,1,0,1,12,8,6,9,13,12,2,1,1,0
S01007779,Bad health,21,0,0,0,4,1,2,1,4,7,1,1,0,1
S01007779,Very bad health,8,0,0,0,1,0,1,2,2,1,1,1,0,0
S01007780,All people aged 16 to 74,629,27,5,22,161,98,45,57,105,68,18,12,6,50
S01007780,Very good health,352,18,3,15,98,57,20,29,55,24,11,7,4,40
S01007780,Good health,197,8,2,6,50,31,18,19,32,29,2,1,1,8
S01007780,Fair health,50,1,0,1,8,7,4,7,13,5,4,3,1,1
S01007780,Bad health,21,0,0,0,4,3,2,1,2,7,1,1,0,1
S01007780,Very bad health,9,0,0,0,1,0,1,1,3,3,0,0,0,0
S01007781,All people aged 16 to 74,722,40,11,29,161,110,39,80,118,114,29,14,15,31
S01007781,Very good health,378,27,9,18,89,61,21,38,54,48,16,9,7,24
S01007781,Good health,248,9,2,7,55,39,13,29,49,40,8,4,4,6
S01007781,Fair health,63,2,0,2,10,6,3,8,10,18,5,1,4,1
S01007781,Bad health,30,1,0,1,7,3,2,5,5,7,0,0,0,0
S01007781,Very bad health,3,1,0,1,0,1,0,0,0,1,0,0,0,0
S01007782,All people aged 16 to 74,363,9,1,8,58,29,20,26,70,73,45,30,15,33
S01007782,Very good health,165,6,1,5,27,14,6,8,30,28,24,17,7,22
S01007782,Good health,120,1,0,1,19,9,10,11,26,27,8,6,2,9
S01007782,Fair health,54,0,0,0,8,5,2,5,9,12,11,6,5,2
S01007782,Bad health,16,2,0,2,4,0,1,1,3,4,1,0,1,0
S01007782,Very bad health,8,0,0,0,0,1,1,1,2,2,1,1,0,0
S01007783,All people aged 16 to 74,588,8,0,8,41,62,15,52,122,171,89,53,36,28
S01007783,Very good health,160,3,0,3,11,18,4,17,23,38,31,15,16,15
S01007783,Good health,202,4,0,4,13,29,3,10,54,56,27,18,9,6
S01007783,Fair health,126,1,0,1,11,6,4,10,27,46,17,9,8,4
S01007783,Bad health,73,0,0,0,4,7,3,10,11,24,12,9,3,2
S01007783,Very bad health,27,0,0,0,2,2,1,5,7,7,2,2,0,1
S01007784,All people aged 16 to 74,521,28,8,20,79,86,36,34,106,80,30,14,16,42
S01007784,Very good health,269,15,4,11,47,44,12,14,56,41,13,5,8,27
S01007784,Good health,179,8,4,4,26,30,15,13,40,27,10,3,7,10
S01007784,Fair health,52,4,0,4,6,9,5,6,5,8,5,4,1,4
S01007784,Bad health,14,1,0,1,0,3,1,1,3,2,2,2,0,1
S01007784,Very bad health,7,0,0,0,0,0,3,0,2,2,0,0,0,0
S01007785,All people aged 16 to 74,404,6,0,6,44,36,13,29,94,76,63,36,27,43
S01007785,Very good health,162,2,0,2,19,9,6,10,45,18,22,11,11,31
S01007785,Good health,128,1,0,1,16,14,5,12,22,28,21,10,11,9
S01007785,Fair health,70,3,0,3,5,7,1,4,19,16,13,10,3,2
S01007785,Bad health,33,0,0,0,3,3,1,3,7,10,5,3,2,1
S01007785,Very bad health,11,0,0,0,1,3,0,0,1,4,2,2,0,0
S01007786,All people aged 16 to 74,556,9,3,6,74,60,27,50,145,136,34,16,18,21
S01007786,Very good health,214,6,2,4,36,29,11,18,51,42,9,2,7,12
S01007786,Good health,212,1,1,0,23,20,8,22,58,53,18,10,8,9
S01007786,Fair health,89,1,0,1,10,9,6,5,23,30,5,2,3,0
S01007786,Bad health,35,1,0,1,4,2,1,4,12,9,2,2,0,0
S01007786,Very bad health,6,0,0,0,1,0,1,1,1,2,0,0,0,0
S01007787,All people aged 16 to 74,489,7,3,4,55,55,28,44,121,109,43,32,11,27
S01007787,Very good health,206,5,2,3,34,25,16,18,47,36,8,6,2,17
S01007787,Good health,195,2,1,1,21,23,11,18,49,41,21,15,6,9
S01007787,Fair health,68,0,0,0,0,5,1,8,18,26,9,6,3,1
S01007787,Bad health,13,0,0,0,0,1,0,0,5,5,2,2,0,0
S01007787,Very bad health,7,0,0,0,0,1,0,0,2,1,3,3,0,0
S01007788,All people aged 16 to 74,455,5,1,4,35,43,24,32,100,82,92,52,40,42
S01007788,Very good health,185,2,0,2,13,15,15,17,34,21,37,19,18,31
S01007788,Good health,140,1,1,0,11,19,7,8,33,22,30,13,17,9
S01007788,Fair health,78,1,0,1,7,7,1,4,15,23,18,14,4,2
S01007788,Bad health,37,1,0,1,4,2,0,2,11,13,4,3,1,0
S01007788,Very bad health,15,0,0,0,0,0,1,1,7,3,3,3,0,0
S01007789,All people aged 16 to 74,455,6,0,6,49,44,17,34,93,106,53,41,12,53
S01007789,Very good health,208,2,0,2,21,19,10,17,33,41,23,19,4,42
S01007789,Good health,137,1,0,1,9,21,6,9,42,26,17,11,6,6
S01007789,Fair health,67,0,0,0,15,2,0,5,7,24,9,7,2,5
S01007789,Bad health,28,2,0,2,2,2,1,1,5,13,2,2,0,0
S01007789,Very bad health,15,1,0,1,2,0,0,2,6,2,2,2,0,0
S01007790,All people aged 16 to 74,551,6,3,3,55,40,12,40,152,107,95,65,30,44
S01007790,Very good health,243,5,3,2,21,12,3,14,70,41,41,24,17,36
S01007790,Good health,188,0,0,0,26,14,7,21,47,38,29,21,8,6
S01007790,Fair health,85,1,0,1,6,11,1,2,24,21,18,14,4,1
S01007790,Bad health,30,0,0,0,0,3,1,2,11,5,7,6,1,1
S01007790,Very bad health,5,0,0,0,2,0,0,1,0,2,0,0,0,0
S01007791,All people aged 16 to 74,356,28,8,20,88,53,37,27,59,38,5,2,3,21
S01007791,Very good health,225,21,5,16,58,33,22,16,32,22,3,1,2,18
S01007791,Good health,102,7,3,4,29,17,11,5,17,11,2,1,1,3
S01007791,Fair health,20,0,0,0,0,2,3,5,6,4,0,0,0,0
S01007791,Bad health,5,0,0,0,0,1,1,0,2,1,0,0,0,0
S01007791,Very bad health,4,0,0,0,1,0,0,1,2,0,0,0,0,0
S01007792,All people aged 16 to 74,649,7,3,4,83,70,30,59,145,166,54,31,23,35
S01007792,Very good health,249,1,0,1,38,20,12,26,47,63,17,5,12,25
S01007792,Good health,228,4,2,2,35,33,7,16,48,61,17,9,8,7
S01007792,Fair health,99,1,1,0,8,8,9,6,28,24,12,9,3,3
S01007792,Bad health,51,0,0,0,1,7,1,9,18,10,5,5,0,0
S01007792,Very bad health,22,1,0,1,1,2,1,2,4,8,3,3,0,0
S01007793,All people aged 16 to 74,646,14,2,12,59,59,27,60,149,143,83,49,34,52
S01007793,Very good health,254,8,2,6,23,25,7,22,55,38,38,22,16,38
S01007793,Good health,209,5,0,5,21,22,9,21,58,46,17,11,6,10
S01007793,Fair health,113,1,0,1,8,8,5,12,25,31,20,10,10,3
S01007793,Bad health,50,0,0,0,4,1,5,4,8,22,6,4,2,0
S01007793,Very bad health,20,0,0,0,3,3,1,1,3,6,2,2,0,1
S01007794,All people aged 16 to 74,427,6,2,4,57,57,18,44,94,89,28,18,10,34
S01007794,Very good health,180,2,2,0,25,28,9,18,35,28,11,8,3,24
S01007794,Good health,164,4,0,4,22,19,6,19,41,36,9,4,5,8
S01007794,Fair health,63,0,0,0,8,10,1,5,12,18,8,6,2,1
S01007794,Bad health,18,0,0,0,2,0,2,2,4,7,0,0,0,1
S01007794,Very bad health,2,0,0,0,0,0,0,0,2,0,0,0,0,0
S01007795,All people aged 16 to 74,435,7,1,6,54,46,18,48,100,116,16,10,6,30
S01007795,Very good health,193,3,1,2,29,25,8,21,43,38,7,4,3,19
S01007795,Good health,162,3,0,3,18,15,6,21,42,44,6,3,3,7
S01007795,Fair health,55,1,0,1,5,4,3,2,7,28,1,1,0,4
S01007795,Bad health,18,0,0,0,2,2,1,4,7,0,2,2,0,0
S01007795,Very bad health,7,0,0,0,0,0,0,0,1,6,0,0,0,0
S01007796,All people aged 16 to 74,494,14,4,10,79,58,21,53,114,87,33,14,19,35
S01007796,Very good health,226,7,2,5,41,28,6,20,44,40,15,5,10,25
S01007796,Good health,160,6,2,4,29,20,9,15,42,24,8,3,5,7
S01007796,Fair health,72,1,0,1,5,8,6,10,21,13,5,2,3,3
S01007796,Bad health,25,0,0,0,3,1,0,7,3,8,3,2,1,0
S01007796,Very bad health,11,0,0,0,1,1,0,1,4,2,2,2,0,0
S01007797,All people aged 16 to 74,376,7,3,4,33,42,14,31,71,102,49,30,19,27
S01007797,Very good health,152,3,1,2,15,19,5,10,28,37,14,9,5,21
S01007797,Good health,114,4,2,2,9,14,1,9,26,30,15,7,8,6
S01007797,Fair health,70,0,0,0,5,8,4,8,13,19,13,9,4,0
S01007797,Bad health,28,0,0,0,1,1,3,4,1,13,5,3,2,0
S01007797,Very bad health,12,0,0,0,3,0,1,0,3,3,2,2,0,0
S01007798,All people aged 16 to 74,479,37,7,30,95,96,39,38,77,44,19,16,3,34
S01007798,Very good health,301,29,5,24,54,60,25,29,48,26,8,6,2,22
S01007798,Good health,127,6,1,5,31,26,11,8,20,11,4,4,0,10
S01007798,Fair health,39,2,1,1,8,9,3,0,6,4,5,4,1,2
S01007798,Bad health,10,0,0,0,2,1,0,1,1,3,2,2,0,0
S01007798,Very bad health,2,0,0,0,0,0,0,0,2,0,0,0,0,0
S01007799,All people aged 16 to 74,427,33,6,27,106,59,36,41,56,39,17,11,6,40
S01007799,Very good health,275,20,3,17,78,40,16,25,30,25,9,5,4,32
S01007799,Good health,108,9,3,6,23,12,14,11,18,10,4,3,1,7
S01007799,Fair health,36,4,0,4,4,6,5,4,7,2,3,2,1,1
S01007799,Bad health,7,0,0,0,1,0,1,1,1,2,1,1,0,0
S01007799,Very bad health,1,0,0,0,0,1,0,0,0,0,0,0,0,0
S01007800,All people aged 16 to 74,655,5,2,3,77,57,31,46,142,166,90,53,37,41
S01007800,Very good health,240,3,2,1,33,26,11,16,44,42,38,15,23,27
S01007800,Good health,212,1,0,1,23,14,14,21,46,63,21,13,8,9
S01007800,Fair health,124,1,0,1,10,9,4,4,34,36,21,15,6,5
S01007800,Bad health,70,0,0,0,9,5,2,5,16,23,10,10,0,0
S01007800,Very bad health,9,0,0,0,2,3,0,0,2,2,0,0,0,0
S01007801,All people aged 16 to 74,752,6,3,3,57,41,25,56,147,156,94,71,23,170
S01007801,Very good health,284,2,1,1,20,14,9,20,42,40,31,23,8,106
S01007801,Good health,225,2,1,1,16,11,9,12,44,45,31,23,8,55
S01007801,Fair health,146,0,0,0,17,6,5,12,38,42,19,15,4,7
S01007801,Bad health,76,2,1,1,3,10,2,11,17,22,7,6,1,2
S01007801,Very bad health,21,0,0,0,1,0,0,1,6,7,6,4,2,0
S01007802,All people aged 16 to 74,398,17,0,17,85,78,26,34,72,46,13,8,5,27
S01007802,Very good health,239,14,0,14,59,43,13,21,34,29,6,4,2,20
S01007802,Good health,121,3,0,3,18,26,11,10,31,11,4,2,2,7
S01007802,Fair health,28,0,0,0,7,7,2,3,3,4,2,1,1,0
S01007802,Bad health,10,0,0,0,1,2,0,0,4,2,1,1,0,0
S01007802,Very bad health,0,0,0,0,0,0,0,0,0,0,0,0,0,0
S01007803,All people aged 16 to 74,728,13,2,11,49,77,23,71,156,182,97,63,34,60
S01007803,Very good health,266,6,0,6,23,34,8,21,59,48,29,19,10,38
S01007803,Good health,220,6,2,4,17,19,9,27,49,49,29,18,11,15
S01007803,Fair health,145,1,0,1,6,13,4,17,25,42,30,17,13,7
S01007803,Bad health,73,0,0,0,3,9,1,4,20,30,6,6,0,0
S01007803,Very bad health,24,0,0,0,0,2,1,2,3,13,3,3,0,0
S01007804,All people aged 16 to 74,427,8,3,5,49,47,15,34,82,84,57,42,15,51
S01007804,Very good health,165,4,1,3,24,23,9,14,31,20,12,9,3,28
S01007804,Good health,134,1,0,1,15,11,5,11,28,26,22,14,8,15
S01007804,Fair health,76,3,2,1,7,8,1,5,16,17,13,10,3,6
S01007804,Bad health,32,0,0,0,3,3,0,2,6,9,7,7,0,2
S01007804,Very bad health,20,0,0,0,0,2,0,2,1,12,3,2,1,0
S01007805,All people aged 16 to 74,351,5,0,5,36,45,12,24,83,66,45,31,14,35
S01007805,Very good health,153,4,0,4,19,25,4,13,30,15,16,10,6,27
S01007805,Good health,123,1,0,1,11,16,4,5,33,31,15,10,5,7
S01007805,Fair health,56,0,0,0,5,4,4,2,16,14,10,7,3,1
S01007805,Bad health,12,0,0,0,1,0,0,3,2,2,4,4,0,0
S01007805,Very bad health,7,0,0,0,0,0,0,1,2,4,0,0,0,0
S01007806,All people aged 16 to 74,463,10,1,9,58,73,19,36,89,128,30,17,13,20
S01007806,Very good health,176,2,0,2,26,29,7,22,24,40,10,4,6,16
S01007806,Good health,171,6,0,6,25,27,7,7,41,41,13,9,4,4
S01007806,Fair health,73,1,1,0,4,11,3,3,15,31,5,3,2,0
S01007806,Bad health,32,0,0,0,3,6,2,2,5,12,2,1,1,0
S01007806,Very bad health,11,1,0,1,0,0,0,2,4,4,0,0,0,0
S01007807,All people aged 16 to 74,515,40,8,32,121,83,31,46,70,58,24,16,8,42
S01007807,Very good health,272,23,4,19,73,37,14,28,31,28,7,2,5,31
S01007807,Good health,163,10,2,8,35,35,15,7,26,18,8,6,2,9
S01007807,Fair health,53,2,1,1,10,6,1,9,9,6,8,7,1,2
S01007807,Bad health,20,2,0,2,2,5,0,1,4,5,1,1,0,0
S01007807,Very bad health,7,3,1,2,1,0,1,1,0,1,0,0,0,0
S01007808,All people aged 16 to 74,615,20,0,20,83,73,35,47,126,118,58,40,18,55
S01007808,Very good health,272,9,0,9,49,33,13,17,59,34,20,13,7,38
S01007808,Good health,222,10,0,10,27,28,11,22,43,48,19,11,8,14
S01007808,Fair health,76,1,0,1,5,11,6,5,16,22,8,5,3,2
S01007808,Bad health,33,0,0,0,2,0,4,2,8,8,9,9,0,0
S01007808,Very bad health,12,0,0,0,0,1,1,1,0,6,2,2,0,1
S01007809,All people aged 16 to 74,675,59,14,45,182,118,41,59,86,71,9,8,1,50
S01007809,Very good health,363,35,7,28,100,67,16,30,42,27,3,3,0,43
S01007809,Good health,235,20,6,14,65,41,17,18,30,32,5,4,1,7
S01007809,Fair health,57,2,0,2,13,7,7,8,10,9,1,1,0,0
S01007809,Bad health,15,2,1,1,3,3,1,2,3,1,0,0,0,0
S01007809,Very bad health,5,0,0,0,1,0,0,1,1,2,0,0,0,0
S01007810,All people aged 16 to 74,630,10,5,5,70,53,21,53,122,170,84,60,24,47
S01007810,Very good health,253,5,2,3,40,26,7,23,45,50,24,15,9,33
S01007810,Good health,198,2,1,1,21,17,9,14,45,52,26,18,8,12
S01007810,Fair health,105,1,0,1,7,6,2,6,22,39,20,13,7,2
S01007810,Bad health,50,2,2,0,2,4,3,4,8,16,11,11,0,0
S01007810,Very bad health,24,0,0,0,0,0,0,6,2,13,3,3,0,0
S01007811,All people aged 16 to 74,606,14,1,13,63,72,21,55,136,131,64,47,17,50
S01007811,Very good health,250,7,0,7,27,32,9,23,52,44,25,18,7,31
S01007811,Good health,223,6,1,5,25,24,9,19,49,53,23,16,7,15
S01007811,Fair health,92,0,0,0,9,12,1,10,26,22,8,6,2,4
S01007811,Bad health,31,1,0,1,2,2,2,2,7,9,6,5,1,0
S01007811,Very bad health,10,0,0,0,0,2,0,1,2,3,2,2,0,0
S01007812,All people aged 16 to 74,578,10,1,9,56,47,22,47,128,133,88,55,33,47
S01007812,Very good health,231,5,1,4,29,26,8,16,43,41,34,21,13,29
S01007812,Good health,200,4,0,4,20,10,8,12,44,54,31,14,17,17
S01007812,Fair health,95,0,0,0,5,6,4,14,30,20,15,12,3,1
S01007812,Bad health,39,1,0,1,2,3,1,4,10,14,4,4,0,0
S01007812,Very bad health,13,0,0,0,0,2,1,1,1,4,4,4,0,0
S01007813,All people aged 16 to 74,547,10,2,8,61,68,16,48,113,125,64,40,24,42
S01007813,Very good health,186,4,0,4,12,27,5,16,45,34,19,14,5,24
S01007813,Good health,219,3,1,2,32,32,7,18,40,50,22,10,12,15
S01007813,Fair health,102,0,0,0,9,9,3,11,17,34,16,11,5,3
S01007813,Bad health,31,1,0,1,8,0,0,2,6,7,7,5,2,0
S01007813,Very bad health,9,2,1,1,0,0,1,1,5,0,0,0,0,0
S01007814,All people aged 16 to 74,435,11,1,10,83,52,26,40,76,87,26,18,8,34
S01007814,Very good health,186,3,0,3,46,25,10,15,30,25,9,5,4,23
S01007814,Good health,152,7,1,6,25,13,10,17,28,33,10,7,3,9
S01007814,Fair health,59,0,0,0,8,7,5,4,10,19,4,4,0,2
S01007814,Bad health,29,1,0,1,4,6,1,2,6,8,1,1,0,0
S01007814,Very bad health,9,0,0,0,0,1,0,2,2,2,2,1,1,0
S01007815,All people aged 16 to 74,687,47,16,31,159,122,41,75,87,74,22,16,6,60
S01007815,Very good health,363,23,8,15,90,54,24,37,43,36,9,5,4,47
S01007815,Good health,234,18,7,11,52,54,13,26,27,26,7,6,1,11
S01007815,Fair health,65,6,1,5,14,8,3,7,13,8,4,3,1,2
S01007815,Bad health,21,0,0,0,2,5,1,5,4,2,2,2,0,0
S01007815,Very bad health,4,0,0,0,1,1,0,0,0,2,0,0,0,0
S01007816,All people aged 16 to 74,523,28,8,20,111,99,40,62,82,68,10,7,3,23
S01007816,Very good health,273,14,2,12,71,56,13,31,40,29,3,2,1,16
S01007816,Good health,177,9,3,6,28,28,19,26,32,25,4,2,2,6
S01007816,Fair health,53,3,1,2,7,12,7,5,10,6,3,3,0,0
S01007816,Bad health,14,2,2,0,3,2,1,0,0,6,0,0,0,0
S01007816,Very bad health,6,0,0,0,2,1,0,0,0,2,0,0,0,1
S01007817,All people aged 16 to 74,355,10,6,4,55,48,17,34,62,94,11,6,5,24
S01007817,Very good health,134,4,1,3,21,22,4,13,21,32,3,1,2,14
S01007817,Good health,143,5,4,1,22,18,9,13,28,36,6,5,1,6
S01007817,Fair health,53,1,1,0,9,4,2,6,10,16,2,0,2,3
S01007817,Bad health,17,0,0,0,1,2,2,1,3,7,0,0,0,1
S01007817,Very bad health,8,0,0,0,2,2,0,1,0,3,0,0,0,0
S01007818,All people aged 16 to 74,569,32,12,20,135,88,42,49,97,79,16,11,5,31
S01007818,Very good health,282,15,4,11,70,47,22,20,46,35,6,3,3,21
S01007818,Good health,202,12,6,6,53,28,12,22,28,30,7,5,2,10
S01007818,Fair health,53,5,2,3,6,9,6,6,14,6,1,1,0,0
S01007818,Bad health,27,0,0,0,6,2,2,1,6,8,2,2,0,0
S01007818,Very bad health,5,0,0,0,0,2,0,0,3,0,0,0,0,0
S01007819,All people aged 16 to 74,594,22,4,18,132,81,47,60,98,98,24,18,6,32
S01007819,Very good health,288,16,3,13,83,40,19,23,37,42,2,1,1,26
S01007819,Good health,202,3,0,3,41,33,19,25,40,32,8,6,2,1
S01007819,Fair health,75,3,1,2,6,8,5,12,13,17,7,5,2,4
S01007819,Bad health,25,0,0,0,1,0,4,0,8,5,6,5,1,1
S01007819,Very bad health,4,0,0,0,1,0,0,0,0,2,1,1,0,0
S01007820,All people aged 16 to 74,730,26,5,21,129,98,40,67,130,127,54,41,13,59
S01007820,Very good health,372,13,2,11,68,55,19,26,57,57,29,23,6,48
S01007820,Good health,224,11,3,8,39,31,16,26,40,37,13,7,6,11
S01007820,Fair health,91,2,0,2,17,9,4,12,24,16,7,7,0,0
S01007820,Bad health,34,0,0,0,4,2,0,2,8,15,3,2,1,0
S01007820,Very bad health,9,0,0,0,1,1,1,1,1,2,2,2,0,0
S01007821,All people aged 16 to 74,419,16,4,12,94,61,25,36,83,64,10,10,0,30
S01007821,Very good health,205,10,2,8,50,27,10,14,40,28,3,3,0,23
S01007821,Good health,154,6,2,4,33,25,11,18,30,22,3,3,0,6
S01007821,Fair health,45,0,0,0,10,3,3,3,11,12,2,2,0,1
S01007821,Bad health,13,0,0,0,1,6,1,1,2,1,1,1,0,0
S01007821,Very bad health,2,0,0,0,0,0,0,0,0,1,1,1,0,0
S01007822,All people aged 16 to 74,542,29,5,24,135,97,31,41,80,90,8,3,5,31
S01007822,Very good health,266,17,2,15,69,52,15,20,33,33,1,0,1,26
S01007822,Good health,194,10,2,8,52,31,12,14,32,36,3,0,3,4
S01007822,Fair health,51,2,1,1,10,7,3,6,8,12,2,2,0,1
S01007822,Bad health,21,0,0,0,2,5,1,1,5,7,0,0,0,0
S01007822,Very bad health,10,0,0,0,2,2,0,0,2,2,2,1,1,0
S01007823,All people aged 16 to 74,538,34,9,25,147,90,34,59,70,49,13,11,2,42
S01007823,Very good health,291,18,3,15,78,46,18,28,35,23,7,6,1,38
S01007823,Good health,173,12,4,8,50,34,14,20,26,12,1,1,0,4
S01007823,Fair health,49,4,2,2,12,9,2,7,6,7,2,1,1,0
S01007823,Bad health,18,0,0,0,6,0,0,4,2,3,3,3,0,0
S01007823,Very bad health,7,0,0,0,1,1,0,0,1,4,0,0,0,0
S01007824,All people aged 16 to 74,533,46,11,35,133,81,39,41,76,59,10,10,0,48
S01007824,Very good health,270,27,7,20,68,48,15,19,28,22,2,2,0,41
S01007824,Good health,193,16,3,13,46,27,19,14,34,28,2,2,0,7
S01007824,Fair health,52,3,1,2,12,4,5,7,11,5,5,5,0,0
S01007824,Bad health,13,0,0,0,6,2,0,0,2,2,1,1,0,0
S01007824,Very bad health,5,0,0,0,1,0,0,1,1,2,0,0,0,0
S01007825,All people aged 16 to 74,735,60,9,51,165,113,68,59,121,67,21,15,6,61
S01007825,Very good health,387,38,6,32,91,63,34,27,55,25,8,5,3,46
S01007825,Good health,227,16,2,14,49,33,26,21,38,25,7,5,2,12
S01007825,Fair health,97,6,1,5,21,12,6,7,24,13,5,4,1,3
S01007825,Bad health,18,0,0,0,2,5,2,4,2,3,0,0,0,0
S01007825,Very bad health,6,0,0,0,2,0,0,0,2,1,1,1,0,0
S01007826,All people aged 16 to 74,389,6,1,5,61,32,17,39,81,98,38,29,9,17
S01007826,Very good health,143,2,0,2,26,15,9,12,31,30,11,8,3,7
S01007826,Good health,131,2,1,1,26,11,6,13,26,31,10,5,5,6
S01007826,Fair health,59,1,0,1,5,4,1,7,14,18,7,6,1,2
S01007826,Bad health,40,0,0,0,4,1,0,5,8,15,6,6,0,1
S01007826,Very bad health,16,1,0,1,0,1,1,2,2,4,4,4,0,1
S01007827,All people aged 16 to 74,477,44,6,38,106,67,23,42,79,46,27,16,11,43
S01007827,Very good health,247,24,4,20,53,38,12,25,42,14,11,8,3,28
S01007827,Good health,162,16,2,14,41,24,9,11,17,21,9,4,5,14
S01007827,Fair health,50,4,0,4,10,3,2,4,14,6,6,3,3,1
S01007827,Bad health,16,0,0,0,2,1,0,1,6,5,1,1,0,0
S01007827,Very bad health,2,0,0,0,0,1,0,1,0,0,0,0,0,0
S01007828,All people aged 16 to 74,720,34,4,30,127,107,39,73,118,105,59,35,24,58
S01007828,Very good health,297,20,3,17,62,48,13,31,37,34,14,8,6,38
S01007828,Good health,247,11,1,10,44,37,18,23,43,33,21,12,9,17
S01007828,Fair health,114,2,0,2,10,18,7,12,22,19,22,13,9,2
S01007828,Bad health,45,1,0,1,7,3,1,6,12,14,0,0,0,1
S01007828,Very bad health,17,0,0,0,4,1,0,1,4,5,2,2,0,0
S01007829,All people aged 16 to 74,421,26,8,18,76,64,27,36,60,83,22,20,2,27
S01007829,Very good health,172,18,7,11,30,29,9,12,25,23,4,4,0,22
S01007829,Good health,153,4,0,4,32,31,11,17,16,32,6,6,0,4
S01007829,Fair health,56,0,0,0,10,4,4,4,10,17,6,4,2,1
S01007829,Bad health,28,3,1,2,2,0,2,3,7,7,4,4,0,0
S01007829,Very bad health,12,1,0,1,2,0,1,0,2,4,2,2,0,0
S01007830,All people aged 16 to 74,697,26,6,20,105,92,21,64,144,128,46,30,16,71
S01007830,Very good health,286,12,2,10,58,34,6,26,49,30,20,11,9,51
S01007830,Good health,234,11,2,9,29,33,11,18,48,56,11,6,5,17
S01007830,Fair health,101,1,1,0,13,19,2,15,23,17,9,8,1,2
S01007830,Bad health,58,2,1,1,5,5,2,4,19,15,6,5,1,0
S01007830,Very bad health,18,0,0,0,0,1,0,1,5,10,0,0,0,1
S01007831,All people aged 16 to 74,633,26,2,24,100,74,29,50,115,99,63,42,21,77
S01007831,Very good health,262,13,1,12,50,35,9,20,34,30,16,5,11,55
S01007831,Good health,191,7,1,6,32,19,8,18,41,29,19,13,6,18
S01007831,Fair health,113,6,0,6,11,12,7,8,23,26,16,14,2,4
S01007831,Bad health,52,0,0,0,6,7,4,1,14,10,10,9,1,0
S01007831,Very bad health,15,0,0,0,1,1,1,3,3,4,2,1,1,0
S01007832,All people aged 16 to 74,489,14,1,13,82,62,19,35,91,103,36,20,16,47
S01007832,Very good health,189,7,0,7,44,28,9,15,28,24,9,4,5,25
S01007832,Good health,180,6,1,5,22,25,8,11,32,49,11,4,7,16
S01007832,Fair health,68,0,0,0,12,4,1,4,19,16,8,5,3,4
S01007832,Bad health,35,1,0,1,3,4,0,3,7,9,6,5,1,2
S01007832,Very bad health,17,0,0,0,1,1,1,2,5,5,2,2,0,0
S01007833,All people aged 16 to 74,519,12,3,9,99,66,31,52,115,84,26,15,11,34
S01007833,Very good health,192,6,1,5,42,31,16,16,34,23,6,5,1,18
S01007833,Good health,186,4,1,3,35,22,8,18,39,33,13,5,8,14
S01007833,Fair health,93,2,1,1,14,9,4,12,28,19,3,3,0,2
S01007833,Bad health,37,0,0,0,6,3,2,3,10,9,4,2,2,0
S01007833,Very bad health,11,0,0,0,2,1,1,3,4,0,0,0,0,0
S01007834,All people aged 16 to 74,568,46,4,42,75,87,17,45,96,98,45,22,23,59
S01007834,Very good health,260,29,2,27,40,43,10,24,39,31,12,4,8,32
S01007834,Good health,188,16,2,14,24,24,4,14,31,36,14,6,8,25
S01007834,Fair health,70,1,0,1,7,13,2,4,17,15,9,5,4,2
S01007834,Bad health,42,0,0,0,3,7,1,3,6,13,9,6,3,0
S01007834,Very bad health,8,0,0,0,1,0,0,0,3,3,1,1,0,0
S01007835,All people aged 16 to 74,499,52,4,48,115,66,26,43,73,60,30,18,12,34
S01007835,Very good health,256,38,3,35,57,33,13,20,32,23,11,4,7,29
S01007835,Good health,159,11,1,10,42,21,11,11,24,24,10,6,4,5
S01007835,Fair health,56,1,0,1,13,9,2,9,13,5,4,3,1,0
S01007835,Bad health,21,1,0,1,1,3,0,3,4,6,3,3,0,0
S01007835,Very bad health,7,1,0,1,2,0,0,0,0,2,2,2,0,0
S01007836,All people aged 16 to 74,380,44,9,35,100,72,19,27,39,29,28,21,7,22
S01007836,Very good health,181,29,6,23,49,38,8,14,15,5,4,2,2,19
S01007836,Good health,131,12,2,10,34,26,7,6,22,13,9,5,4,2
S01007836,Fair health,47,2,0,2,10,5,2,5,2,8,12,11,1,1
S01007836,Bad health,16,0,0,0,5,2,1,2,0,3,3,3,0,0
S01007836,Very bad health,5,1,1,0,2,1,1,0,0,0,0,0,0,0
S01007837,All people aged 16 to 74,594,39,11,28,162,117,55,50,65,50,9,8,1,47
S01007837,Very good health,328,23,7,16,90,61,19,30,37,25,2,1,1,41
S01007837,Good health,193,12,3,9,58,39,25,17,18,15,3,3,0,6
S01007837,Fair health,50,2,0,2,11,12,6,3,8,7,1,1,0,0
S01007837,Bad health,17,2,1,1,1,4,5,0,2,2,1,1,0,0
S01007837,Very bad health,6,0,0,0,2,1,0,0,0,1,2,2,0,0
S01007838,All people aged 16 to 74,602,51,10,41,159,118,39,41,71,55,11,7,4,57
S01007838,Very good health,336,33,5,28,92,52,22,20,34,31,5,4,1,47
S01007838,Good health,187,14,4,10,47,46,11,12,31,13,3,1,2,10
S01007838,Fair health,49,4,1,3,13,15,5,3,3,5,1,0,1,0
S01007838,Bad health,26,0,0,0,6,4,1,5,3,6,1,1,0,0
S01007838,Very bad health,4,0,0,0,1,1,0,1,0,0,1,1,0,0
S01007839,All people aged 16 to 74,487,49,3,46,63,54,26,30,51,62,30,24,6,122
S01007839,Very good health,233,26,0,26,32,25,15,12,23,14,5,4,1,81
S01007839,Good health,161,19,2,17,22,17,8,10,17,19,12,8,4,37
S01007839,Fair health,65,4,1,3,7,10,2,6,7,18,7,7,0,4
S01007839,Bad health,20,0,0,0,2,1,1,2,1,9,4,3,1,0
S01007839,Very bad health,8,0,0,0,0,1,0,0,3,2,2,2,0,0
S01007840,All people aged 16 to 74,564,23,3,20,93,91,21,59,97,102,30,19,11,48
S01007840,Very good health,223,11,1,10,41,41,7,27,36,32,6,5,1,22
S01007840,Good health,234,10,2,8,37,41,8,21,41,44,9,6,3,23
S01007840,Fair health,76,2,0,2,14,7,5,7,15,16,7,4,3,3
S01007840,Bad health,23,0,0,0,0,2,1,2,5,7,6,3,3,0
S01007840,Very bad health,8,0,0,0,1,0,0,2,0,3,2,1,1,0
S01007841,All people aged 16 to 74,504,13,1,12,74,82,28,34,87,95,41,18,23,50
S01007841,Very good health,217,7,1,6,39,39,12,14,33,28,12,5,7,33
S01007841,Good health,194,4,0,4,31,28,7,15,40,37,18,6,12,14
S01007841,Fair health,58,1,0,1,1,13,5,4,9,19,5,3,2,1
S01007841,Bad health,34,1,0,1,3,2,4,1,5,10,6,4,2,2
S01007841,Very bad health,1,0,0,0,0,0,0,0,0,1,0,0,0,0
S01007842,All people aged 16 to 74,552,20,2,18,58,82,26,41,95,105,74,43,31,51
S01007842,Very good health,220,10,0,10,27,24,7,19,40,30,23,11,12,40
S01007842,Good health,208,6,2,4,24,39,14,13,38,40,25,14,11,9
S01007842,Fair health,73,1,0,1,4,9,3,6,8,20,21,15,6,1
S01007842,Bad health,40,1,0,1,2,9,1,2,8,11,5,3,2,1
S01007842,Very bad health,11,2,0,2,1,1,1,1,1,4,0,0,0,0
S01007843,All people aged 16 to 74,522,19,2,17,69,85,18,44,96,83,43,22,21,65
S01007843,Very good health,214,10,1,9,35,36,6,11,35,23,15,10,5,43
S01007843,Good health,194,8,1,7,23,34,6,12,38,37,18,6,12,18
S01007843,Fair health,75,0,0,0,8,11,3,12,16,18,5,2,3,2
S01007843,Bad health,26,1,0,1,3,3,1,2,6,3,5,4,1,2
S01007843,Very bad health,13,0,0,0,0,1,2,7,1,2,0,0,0,0
S01007844,All people aged 16 to 74,713,38,4,34,108,90,37,60,119,114,65,31,34,82
S01007844,Very good health,331,24,3,21,58,42,11,25,56,40,19,9,10,56
S01007844,Good health,246,9,0,9,41,33,19,25,40,36,23,2,21,20
S01007844,Fair health,83,2,0,2,5,11,4,7,15,20,17,15,2,2
S01007844,Bad health,35,2,0,2,3,4,2,2,3,11,5,4,1,3
S01007844,Very bad health,18,1,1,0,1,0,1,1,5,7,1,1,0,1
S01007845,All people aged 16 to 74,606,16,4,12,76,81,26,42,116,131,83,53,30,35
S01007845,Very good health,235,10,3,7,31,35,13,16,36,40,32,15,17,22
S01007845,Good health,222,5,1,4,31,35,8,15,49,47,23,18,5,9
S01007845,Fair health,89,1,0,1,8,7,1,7,18,22,22,14,8,3
S01007845,Bad health,47,0,0,0,3,3,3,3,12,16,6,6,0,1
S01007845,Very bad health,13,0,0,0,3,1,1,1,1,6,0,0,0,0
S01007846,All people aged 16 to 74,514,11,2,9,75,72,17,53,128,91,41,20,21,26
S01007846,Very good health,200,5,1,4,34,29,6,22,50,28,12,4,8,14
S01007846,Good health,183,4,1,3,26,32,6,11,44,33,18,10,8,9
S01007846,Fair health,83,1,0,1,8,4,4,12,25,19,9,4,5,1
S01007846,Bad health,34,0,0,0,4,5,1,6,9,6,2,2,0,1
S01007846,Very bad health,14,1,0,1,3,2,0,2,0,5,0,0,0,1
S01007847,All people aged 16 to 74,658,24,5,19,83,88,22,74,134,141,54,29,25,38
S01007847,Very good health,261,14,2,12,30,45,9,24,55,35,21,10,11,28
S01007847,Good health,237,6,3,3,37,25,11,21,48,61,20,11,9,8
S01007847,Fair health,93,3,0,3,11,9,0,15,20,26,7,3,4,2
S01007847,Bad health,51,1,0,1,5,6,2,11,9,13,4,3,1,0
S01007847,Very bad health,16,0,0,0,0,3,0,3,2,6,2,2,0,0
S01007848,All people aged 16 to 74,586,14,0,14,90,61,16,52,118,128,56,24,32,51
S01007848,Very good health,222,9,0,9,42,28,4,16,36,31,20,10,10,36
S01007848,Good health,189,5,0,5,28,15,4,17,47,38,23,5,18,12
S01007848,Fair health,116,0,0,0,15,13,6,13,23,37,8,4,4,1
S01007848,Bad health,47,0,0,0,3,3,2,6,8,19,4,4,0,2
S01007848,Very bad health,12,0,0,0,2,2,0,0,4,3,1,1,0,0
S01007849,All people aged 16 to 74,629,10,1,9,82,87,26,62,125,132,54,35,19,51
S01007849,Very good health,272,8,1,7,38,44,9,33,43,49,14,7,7,34
S01007849,Good health,225,1,0,1,29,29,10,19,51,53,23,14,9,10
S01007849,Fair health,78,0,0,0,7,10,4,7,20,13,13,10,3,4
S01007849,Bad health,41,1,0,1,6,3,2,3,8,12,3,3,0,3
S01007849,Very bad health,13,0,0,0,2,1,1,0,3,5,1,1,0,0
S01007850,All people aged 16 to 74,542,10,2,8,53,74,33,57,112,107,52,41,11,44
S01007850,Very good health,222,5,0,5,28,32,20,21,42,28,19,14,5,27
S01007850,Good health,191,3,2,1,15,30,6,24,38,47,18,14,4,10
S01007850,Fair health,85,1,0,1,7,9,5,7,20,20,11,9,2,5
S01007850,Bad health,28,1,0,1,2,3,2,4,8,5,2,2,0,1
S01007850,Very bad health,16,0,0,0,1,0,0,1,4,7,2,2,0,1
S01007851,All people aged 16 to 74,628,25,6,19,109,92,42,58,116,131,18,9,9,37
S01007851,Very good health,280,12,4,8,57,49,18,18,48,41,6,4,2,31
S01007851,Good health,219,11,2,9,38,28,14,25,39,54,5,0,5,5
S01007851,Fair health,78,1,0,1,8,8,6,10,17,22,5,3,2,1
S01007851,Bad health,40,1,0,1,4,4,3,4,10,13,1,1,0,0
S01007851,Very bad health,11,0,0,0,2,3,1,1,2,1,1,1,0,0
S01007852,All people aged 16 to 74,499,12,0,12,68,61,26,30,97,90,78,49,29,37
S01007852,Very good health,189,7,0,7,31,21,5,8,35,32,23,14,9,27
S01007852,Good health,206,3,0,3,26,32,15,15,50,27,31,17,14,7
S01007852,Fair health,70,1,0,1,9,5,5,3,8,18,18,13,5,3
S01007852,Bad health,24,0,0,0,2,2,0,3,4,10,3,3,0,0
S01007852,Very bad health,10,1,0,1,0,1,1,1,0,3,3,2,1,0
S01007853,All people aged 16 to 74,465,9,0,9,55,49,21,39,100,88,67,42,25,37
S01007853,Very good health,167,2,0,2,20,24,6,8,35,30,18,11,7,24
S01007853,Good health,142,6,0,6,21,16,6,13,32,15,22,11,11,11
S01007853,Fair health,94,0,0,0,8,8,4,10,21,23,19,12,7,1
S01007853,Bad health,48,1,0,1,4,0,4,6,11,16,5,5,0,1
S01007853,Very bad health,14,0,0,0,2,1,1,2,1,4,3,3,0,0
S01007854,All people aged 16 to 74,780,25,4,21,108,79,36,62,157,135,119,63,56,59
S01007854,Very good health,300,13,2,11,54,26,11,16,57,42,38,20,18,43
S01007854,Good health,272,8,2,6,34,42,16,23,52,43,41,15,26,13
S01007854,Fair health,130,4,0,4,12,5,7,17,26,33,23,12,11,3
S01007854,Bad health,61,0,0,0,7,6,0,5,19,13,11,10,1,0
S01007854,Very bad health,17,0,0,0,1,0,2,1,3,4,6,6,0,0
S01007855,All people aged 16 to 74,390,15,3,12,54,46,23,35,79,64,47,17,30,27
S01007855,Very good health,161,7,1,6,27,22,12,11,30,16,21,5,16,15
S01007855,Good health,123,3,2,1,16,16,8,11,24,23,10,3,7,12
S01007855,Fair health,58,2,0,2,6,6,1,8,12,12,11,4,7,0
S01007855,Bad health,38,2,0,2,5,1,2,5,10,9,4,4,0,0
S01007855,Very bad health,10,1,0,1,0,1,0,0,3,4,1,1,0,0
S01007856,All people aged 16 to 74,634,22,3,19,116,86,32,56,111,114,42,30,12,55
S01007856,Very good health,294,13,3,10,61,41,15,30,39,44,10,7,3,41
S01007856,Good health,215,6,0,6,40,31,10,14,49,34,19,13,6,12
S01007856,Fair health,79,3,0,3,11,8,4,8,13,24,7,5,2,1
S01007856,Bad health,39,0,0,0,3,4,3,4,9,11,4,3,1,1
S01007856,Very bad health,7,0,0,0,1,2,0,0,1,1,2,2,0,0
S01007857,All people aged 16 to 74,352,5,1,4,48,47,17,16,77,76,31,23,8,35
S01007857,Very good health,143,2,0,2,16,23,5,6,31,26,7,6,1,27
S01007857,Good health,121,1,0,1,22,13,7,5,25,27,13,9,4,8
S01007857,Fair health,56,2,1,1,10,7,2,3,11,13,8,5,3,0
S01007857,Bad health,27,0,0,0,0,4,3,1,8,8,3,3,0,0
S01007857,Very bad health,5,0,0,0,0,0,0,1,2,2,0,0,0,0
S01007858,All people aged 16 to 74,745,19,4,15,112,101,42,54,159,136,70,33,37,52
S01007858,Very good health,298,13,2,11,49,37,18,24,51,38,23,6,17,45
S01007858,Good health,244,4,0,4,36,35,14,15,62,52,20,9,11,6
S01007858,Fair health,138,0,0,0,24,18,7,10,30,27,21,12,9,1
S01007858,Bad health,50,0,0,0,2,10,3,4,14,14,3,3,0,0
S01007858,Very bad health,15,2,2,0,1,1,0,1,2,5,3,3,0,0
S01007859,All people aged 16 to 74,358,6,3,3,41,41,21,31,69,86,34,20,14,29
S01007859,Very good health,149,3,1,2,29,21,9,9,23,26,9,6,3,20
S01007859,Good health,99,2,2,0,7,11,4,13,15,29,13,7,6,5
S01007859,Fair health,61,0,0,0,4,5,5,5,16,15,7,4,3,4
S01007859,Bad health,36,1,0,1,0,4,2,2,12,13,2,1,1,0
S01007859,Very bad health,13,0,0,0,1,0,1,2,3,3,3,2,1,0
S01007860,All people aged 16 to 74,441,35,8,27,80,51,31,32,80,67,33,17,16,32
S01007860,Very good health,242,20,4,16,49,35,19,20,30,26,15,7,8,28
S01007860,Good health,112,6,1,5,18,10,7,10,28,20,9,3,6,4
S01007860,Fair health,61,6,3,3,12,5,2,0,15,13,8,6,2,0
S01007860,Bad health,18,1,0,1,1,0,2,2,5,6,1,1,0,0
S01007860,Very bad health,8,2,0,2,0,1,1,0,2,2,0,0,0,0
S01007861,All people aged 16 to 74,495,7,1,6,59,60,20,41,128,116,37,26,11,27
S01007861,Very good health,217,5,1,4,28,31,7,18,43,42,20,13,7,23
S01007861,Good health,160,0,0,0,18,16,5,14,49,47,8,4,4,3
S01007861,Fair health,74,1,0,1,8,7,5,7,22,17,6,6,0,1
S01007861,Bad health,31,1,0,1,3,4,3,2,9,7,2,2,0,0
S01007861,Very bad health,13,0,0,0,2,2,0,0,5,3,1,1,0,0
S01007862,All people aged 16 to 74,538,8,1,7,74,53,30,49,119,129,36,19,17,40
S01007862,Very good health,238,5,1,4,37,28,11,18,50,46,13,6,7,30
S01007862,Good health,188,2,0,2,24,17,9,19,43,50,15,8,7,9
S01007862,Fair health,82,1,0,1,10,7,8,10,16,23,6,3,3,1
S01007862,Bad health,22,0,0,0,2,1,2,2,7,7,1,1,0,0
S01007862,Very bad health,8,0,0,0,1,0,0,0,3,3,1,1,0,0
S01007863,All people aged 16 to 74,641,9,1,8,75,76,21,68,107,165,79,50,29,41
S01007863,Very good health,252,5,0,5,41,27,7,27,46,51,21,14,7,27
S01007863,Good health,230,2,0,2,22,31,9,18,37,72,29,15,14,10
S01007863,Fair health,114,2,1,1,10,13,2,14,16,27,27,19,8,3
S01007863,Bad health,36,0,0,0,2,3,2,7,7,13,1,1,0,1
S01007863,Very bad health,9,0,0,0,0,2,1,2,1,2,1,1,0,0
S01007864,All people aged 16 to 74,683,21,3,18,99,95,22,67,148,135,56,34,22,40
S01007864,Very good health,302,12,3,9,57,41,7,28,74,42,15,12,3,26
S01007864,Good health,230,9,0,9,31,32,10,24,43,52,18,11,7,11
S01007864,Fair health,103,0,0,0,7,15,3,9,20,28,20,8,12,1
S01007864,Bad health,34,0,0,0,2,6,1,5,8,8,3,3,0,1
S01007864,Very bad health,14,0,0,0,2,1,1,1,3,5,0,0,0,1
S01007865,All people aged 16 to 74,483,58,14,44,147,68,27,46,52,27,18,14,4,40
S01007865,Very good health,297,43,8,35,89,46,14,28,21,14,8,5,3,34
S01007865,Good health,154,13,5,8,54,20,9,17,28,6,3,3,0,4
S01007865,Fair health,24,2,1,1,4,2,2,0,3,6,3,2,1,2
S01007865,Bad health,6,0,0,0,0,0,2,1,0,0,3,3,0,0
S01007865,Very bad health,2,0,0,0,0,0,0,0,0,1,1,1,0,0
S01007866,All people aged 16 to 74,441,31,6,25,130,79,37,36,48,32,6,3,3,42
S01007866,Very good health,297,19,4,15,88,58,24,24,28,20,3,2,1,33
S01007866,Good health,116,8,2,6,35,18,10,11,16,8,3,1,2,7
S01007866,Fair health,21,3,0,3,7,3,2,1,2,1,0,0,0,2
S01007866,Bad health,5,1,0,1,0,0,1,0,1,2,0,0,0,0
S01007866,Very bad health,2,0,0,0,0,0,0,0,1,1,0,0,0,0
S01007867,All people aged 16 to 74,348,56,6,50,105,46,31,24,29,27,7,6,1,23
S01007867,Very good health,193,31,1,30,58,28,22,16,9,12,0,0,0,17
S01007867,Good health,111,22,3,19,30,14,9,6,14,7,3,2,1,6
S01007867,Fair health,31,2,1,1,15,4,0,0,3,5,2,2,0,0
S01007867,Bad health,12,1,1,0,2,0,0,2,2,3,2,2,0,0
S01007867,Very bad health,1,0,0,0,0,0,0,0,1,0,0,0,0,0
S01007868,All people aged 16 to 74,704,73,8,65,208,118,43,58,69,53,20,10,10,62
S01007868,Very good health,401,51,6,45,115,77,17,26,31,25,10,5,5,49
S01007868,Good health,244,15,2,13,75,32,21,27,32,21,8,4,4,13
S01007868,Fair health,39,6,0,6,13,4,4,4,2,5,1,0,1,0
S01007868,Bad health,20,1,0,1,5,5,1,1,4,2,1,1,0,0
S01007868,Very bad health,0,0,0,0,0,0,0,0,0,0,0,0,0,0
S01007869,All people aged 16 to 74,696,144,14,130,188,87,34,51,61,34,23,15,8,74
S01007869,Very good health,453,95,9,86,130,52,17,29,34,21,12,8,4,63
S01007869,Good health,184,39,4,35,45,29,14,14,18,7,8,4,4,10
S01007869,Fair health,47,9,1,8,12,5,3,6,5,5,2,2,0,0
S01007869,Bad health,9,1,0,1,0,1,0,2,3,1,0,0,0,1
S01007869,Very bad health,3,0,0,0,1,0,0,0,1,0,1,1,0,0
S01007870,All people aged 16 to 74,412,23,8,15,62,41,54,58,84,50,14,12,2,26
S01007870,Very good health,180,14,4,10,30,18,22,24,35,14,2,1,1,21
S01007870,Good health,134,5,2,3,15,18,19,20,31,17,5,4,1,4
S01007870,Fair health,53,2,1,1,12,4,9,5,8,10,3,3,0,0
S01007870,Bad health,37,2,1,1,5,1,4,5,8,8,3,3,0,1
S01007870,Very bad health,8,0,0,0,0,0,0,4,2,1,1,1,0,0
S01007871,All people aged 16 to 74,485,6,3,3,32,30,31,54,125,122,62,37,25,23
S01007871,Very good health,155,1,1,0,8,8,9,14,54,30,18,8,10,13
S01007871,Good health,158,2,0,2,10,11,16,13,35,45,16,7,9,10
S01007871,Fair health,94,1,1,0,8,5,6,15,18,20,21,16,5,0
S01007871,Bad health,56,1,0,1,4,4,0,9,10,21,7,6,1,0
S01007871,Very bad health,22,1,1,0,2,2,0,3,8,6,0,0,0,0
S01007872,All people aged 16 to 74,529,6,0,6,49,36,25,46,124,138,78,58,20,27
S01007872,Very good health,162,2,0,2,17,11,6,17,35,33,23,11,12,18
S01007872,Good health,187,3,0,3,24,15,8,18,48,42,22,17,5,7
S01007872,Fair health,99,0,0,0,4,6,10,5,28,23,21,18,3,2
S01007872,Bad health,56,1,0,1,3,3,1,6,9,27,6,6,0,0
S01007872,Very bad health,25,0,0,0,1,1,0,0,4,13,6,6,0,0
S01007873,All people aged 16 to 74,506,11,2,9,65,59,43,62,103,102,38,29,9,23
S01007873,Very good health,203,5,2,3,25,26,16,35,38,31,9,4,5,18
S01007873,Good health,168,5,0,5,29,19,17,19,28,36,10,7,3,5
S01007873,Fair health,83,1,0,1,6,13,7,4,19,19,14,13,1,0
S01007873,Bad health,39,0,0,0,3,0,3,3,13,14,3,3,0,0
S01007873,Very bad health,13,0,0,0,2,1,0,1,5,2,2,2,0,0
S01007874,All people aged 16 to 74,550,11,3,8,63,65,40,63,125,123,31,17,14,29
S01007874,Very good health,197,3,1,2,26,23,11,17,48,43,7,2,5,19
S01007874,Good health,190,7,1,6,18,25,12,29,40,40,12,5,7,7
S01007874,Fair health,97,1,1,0,10,9,13,9,23,24,6,4,2,2
S01007874,Bad health,43,0,0,0,8,4,2,6,10,9,3,3,0,1
S01007874,Very bad health,23,0,0,0,1,4,2,2,4,7,3,3,0,0
S01007875,All people aged 16 to 74,396,12,1,11,79,37,19,42,81,82,21,13,8,23
S01007875,Very good health,172,9,0,9,37,11,9,18,34,28,9,5,4,17
S01007875,Good health,150,2,1,1,31,22,6,14,31,32,6,3,3,6
S01007875,Fair health,47,1,0,1,8,3,3,8,11,11,2,1,1,0
S01007875,Bad health,20,0,0,0,3,1,1,2,4,7,2,2,0,0
S01007875,Very bad health,7,0,0,0,0,0,0,0,1,4,2,2,0,0
S01007876,All people aged 16 to 74,732,27,5,22,143,103,67,78,140,106,28,19,9,40
S01007876,Very good health,343,15,3,12,91,47,27,32,56,35,10,6,4,30
S01007876,Good health,233,9,1,8,37,30,27,25,50,40,5,4,1,10
S01007876,Fair health,110,1,1,0,14,21,11,15,20,21,7,3,4,0
S01007876,Bad health,27,1,0,1,0,2,1,5,6,7,5,5,0,0
S01007876,Very bad health,19,1,0,1,1,3,1,1,8,3,1,1,0,0
S01007877,All people aged 16 to 74,588,15,3,12,66,71,46,62,122,135,41,27,14,30
S01007877,Very good health,238,7,0,7,29,36,17,33,44,38,12,8,4,22
S01007877,Good health,190,5,2,3,23,21,21,14,44,43,14,5,9,5
S01007877,Fair health,96,2,0,2,10,12,5,11,22,22,9,8,1,3
S01007877,Bad health,52,1,1,0,3,2,3,4,8,27,4,4,0,0
S01007877,Very bad health,12,0,0,0,1,0,0,0,4,5,2,2,0,0
S01007878,All people aged 16 to 74,471,10,1,9,63,40,24,59,105,104,36,23,13,30
S01007878,Very good health,145,2,0,2,30,10,12,15,22,25,10,8,2,19
S01007878,Good health,179,6,1,5,18,19,8,22,54,32,13,6,7,7
S01007878,Fair health,95,0,0,0,8,10,4,13,21,29,8,6,2,2
S01007878,Bad health,35,2,0,2,6,1,0,5,3,11,5,3,2,2
S01007878,Very bad health,17,0,0,0,1,0,0,4,5,7,0,0,0,0
S01007879,All people aged 16 to 74,558,4,1,3,54,49,23,61,143,140,49,31,18,35
S01007879,Very good health,223,3,1,2,29,27,7,26,52,46,10,7,3,23
S01007879,Good health,181,1,0,1,16,12,6,16,53,51,18,9,9,8
S01007879,Fair health,92,0,0,0,6,6,6,11,26,23,12,9,3,2
S01007879,Bad health,49,0,0,0,3,2,3,7,9,17,6,3,3,2
S01007879,Very bad health,13,0,0,0,0,2,1,1,3,3,3,3,0,0
S01007880,All people aged 16 to 74,311,28,7,21,81,26,50,23,41,32,16,6,10,14
S01007880,Very good health,150,20,4,16,45,12,24,8,15,10,5,1,4,11
S01007880,Good health,94,6,3,3,25,7,22,8,11,9,4,0,4,2
S01007880,Fair health,44,2,0,2,7,5,3,4,6,11,5,3,2,1
S01007880,Bad health,17,0,0,0,3,2,1,3,6,1,1,1,0,0
S01007880,Very bad health,6,0,0,0,1,0,0,0,3,1,1,1,0,0
S01007881,All people aged 16 to 74,410,8,2,6,64,37,38,43,81,81,35,18,17,23
S01007881,Very good health,161,5,2,3,28,14,16,15,27,29,11,3,8,16
S01007881,Good health,139,3,0,3,26,10,13,18,26,22,15,7,8,6
S01007881,Fair health,59,0,0,0,5,4,4,5,16,18,6,5,1,1
S01007881,Bad health,38,0,0,0,5,7,4,2,9,8,3,3,0,0
S01007881,Very bad health,13,0,0,0,0,2,1,3,3,4,0,0,0,0
S01007882,All people aged 16 to 74,586,60,19,41,144,66,106,38,65,45,11,4,7,51
S01007882,Very good health,325,38,11,27,90,40,55,15,31,16,3,1,2,37
S01007882,Good health,178,16,8,8,34,15,40,15,25,15,5,1,4,13
S01007882,Fair health,60,3,0,3,17,10,8,5,8,7,2,1,1,0
S01007882,Bad health,18,3,0,3,3,1,2,2,0,5,1,1,0,1
S01007882,Very bad health,5,0,0,0,0,0,1,1,1,2,0,0,0,0
S01007883,All people aged 16 to 74,793,40,13,27,167,115,77,77,125,118,27,18,9,47
S01007883,Very good health,425,28,9,19,101,62,42,38,58,46,13,9,4,37
S01007883,Good health,243,10,3,7,55,41,22,26,39,37,4,2,2,9
S01007883,Fair health,79,2,1,1,8,4,10,7,19,21,8,5,3,0
S01007883,Bad health,34,0,0,0,1,5,3,5,8,10,1,1,0,1
S01007883,Very bad health,12,0,0,0,2,3,0,1,1,4,1,1,0,0
S01007884,All people aged 16 to 74,483,13,2,11,66,68,35,46,104,90,30,19,11,31
S01007884,Very good health,230,4,1,3,34,37,19,21,46,36,9,4,5,24
S01007884,Good health,153,6,0,6,24,24,11,14,34,25,9,5,4,6
S01007884,Fair health,63,3,1,2,5,3,4,6,17,16,9,7,2,0
S01007884,Bad health,30,0,0,0,2,2,1,5,6,11,2,2,0,1
S01007884,Very bad health,7,0,0,0,1,2,0,0,1,2,1,1,0,0
S01007885,All people aged 16 to 74,567,12,0,12,53,43,34,62,122,123,85,44,41,33
S01007885,Very good health,190,7,0,7,17,15,12,15,41,43,19,7,12,21
S01007885,Good health,205,4,0,4,30,20,14,23,40,33,31,17,14,10
S01007885,Fair health,108,0,0,0,2,5,5,15,21,31,27,14,13,2
S01007885,Bad health,45,0,0,0,3,3,2,8,13,12,4,2,2,0
S01007885,Very bad health,19,1,0,1,1,0,1,1,7,4,4,4,0,0
S01007886,All people aged 16 to 74,677,31,7,24,125,84,57,90,110,106,35,24,11,39
S01007886,Very good health,302,21,5,16,62,44,24,24,50,34,13,9,4,30
S01007886,Good health,202,6,0,6,42,28,21,28,34,26,10,5,5,7
S01007886,Fair health,109,3,1,2,16,9,8,20,19,26,7,5,2,1
S01007886,Bad health,49,1,1,0,4,1,3,16,7,14,3,3,0,0
S01007886,Very bad health,15,0,0,0,1,2,1,2,0,6,2,2,0,1
S01007887,All people aged 16 to 74,429,31,10,21,97,50,84,28,53,37,15,9,6,34
S01007887,Very good health,242,16,6,10,59,31,51,20,23,13,4,2,2,25
S01007887,Good health,126,14,4,10,27,14,18,7,18,14,7,5,2,7
S01007887,Fair health,42,1,0,1,7,2,15,0,8,4,3,1,2,2
S01007887,Bad health,13,0,0,0,3,1,0,1,4,4,0,0,0,0
S01007887,Very bad health,6,0,0,0,1,2,0,0,0,2,1,1,0,0
S01007888,All people aged 16 to 74,794,8,1,7,63,76,31,90,185,207,83,46,37,51
S01007888,Very good health,323,3,0,3,29,30,15,35,80,68,31,17,14,32
S01007888,Good health,265,5,1,4,22,30,9,35,52,70,29,13,16,13
S01007888,Fair health,136,0,0,0,8,11,7,11,36,44,15,12,3,4
S01007888,Bad health,57,0,0,0,4,5,0,7,13,20,6,3,3,2
S01007888,Very bad health,13,0,0,0,0,0,0,2,4,5,2,1,1,0
S01007889,All people aged 16 to 74,390,7,2,5,43,43,16,56,97,92,21,13,8,15
S01007889,Very good health,165,2,1,1,26,20,2,24,45,30,6,3,3,10
S01007889,Good health,132,2,1,1,13,13,7,14,33,37,8,5,3,5
S01007889,Fair health,63,2,0,2,2,6,4,10,16,18,5,3,2,0
S01007889,Bad health,26,1,0,1,2,3,3,7,3,5,2,2,0,0
S01007889,Very bad health,4,0,0,0,0,1,0,1,0,2,0,0,0,0
S01007890,All people aged 16 to 74,552,20,0,20,82,58,51,63,110,112,32,17,15,24
S01007890,Very good health,234,11,0,11,47,28,22,18,48,35,6,4,2,19
S01007890,Good health,194,5,0,5,24,23,20,28,37,40,12,4,8,5
S01007890,Fair health,76,2,0,2,5,5,6,12,16,19,11,8,3,0
S01007890,Bad health,39,1,0,1,5,2,3,5,8,13,2,1,1,0
S01007890,Very bad health,9,1,0,1,1,0,0,0,1,5,1,0,1,0
S01007891,All people aged 16 to 74,639,22,4,18,119,87,41,78,125,113,16,12,4,38
S01007891,Very good health,325,15,3,12,76,46,17,42,54,43,4,3,1,28
S01007891,Good health,192,4,1,3,31,28,18,19,45,35,4,2,2,8
S01007891,Fair health,72,2,0,2,9,9,4,8,16,17,5,5,0,2
S01007891,Bad health,42,1,0,1,2,4,1,7,8,16,3,2,1,0
S01007891,Very bad health,8,0,0,0,1,0,1,2,2,2,0,0,0,0
S01007892,All people aged 16 to 74,567,40,12,28,136,79,53,50,97,59,23,15,8,30
S01007892,Very good health,280,18,6,12,78,38,22,20,40,28,7,5,2,29
S01007892,Good health,190,17,4,13,42,30,24,18,33,17,9,4,5,0
S01007892,Fair health,75,4,2,2,12,11,4,10,18,11,4,3,1,1
S01007892,Bad health,21,1,0,1,4,0,2,2,6,3,3,3,0,0
S01007892,Very bad health,1,0,0,0,0,0,1,0,0,0,0,0,0,0
S01007893,All people aged 16 to 74,764,63,9,54,200,79,80,67,110,79,26,19,7,60
S01007893,Very good health,407,42,5,37,110,47,39,29,49,31,8,7,1,52
S01007893,Good health,240,19,4,15,69,21,35,21,40,19,10,5,5,6
S01007893,Fair health,81,2,0,2,15,10,5,13,17,13,4,3,1,2
S01007893,Bad health,30,0,0,0,6,1,1,3,3,15,1,1,0,0
S01007893,Very bad health,6,0,0,0,0,0,0,1,1,1,3,3,0,0
S01007894,All people aged 16 to 74,685,33,6,27,88,79,53,70,133,144,34,20,14,51
S01007894,Very good health,310,16,3,13,46,39,27,34,58,38,11,7,4,41
S01007894,Good health,265,14,2,12,32,28,19,23,53,73,13,7,6,10
S01007894,Fair health,78,2,1,1,7,9,5,10,18,19,8,4,4,0
S01007894,Bad health,26,1,0,1,3,2,2,2,3,13,0,0,0,0
S01007894,Very bad health,6,0,0,0,0,1,0,1,1,1,2,2,0,0
S01007895,All people aged 16 to 74,402,28,7,21,94,54,41,32,60,50,14,6,8,29
S01007895,Very good health,211,14,4,10,50,24,23,15,30,24,7,2,5,24
S01007895,Good health,130,11,2,9,28,20,14,10,19,18,5,2,3,5
S01007895,Fair health,39,2,0,2,12,8,1,4,6,4,2,2,0,0
S01007895,Bad health,16,1,1,0,2,2,2,3,4,2,0,0,0,0
S01007895,Very bad health,6,0,0,0,2,0,1,0,1,2,0,0,0,0
S01007896,All people aged 16 to 74,635,8,0,8,77,56,38,69,133,148,58,34,24,48
S01007896,Very good health,259,4,0,4,36,17,15,24,52,51,23,13,10,37
S01007896,Good health,225,2,0,2,25,25,12,24,58,48,21,13,8,10
S01007896,Fair health,88,1,0,1,8,8,8,12,15,26,9,5,4,1
S01007896,Bad health,44,1,0,1,5,3,2,8,7,14,4,2,2,0
S01007896,Very bad health,19,0,0,0,3,3,1,1,1,9,1,1,0,0
S01007897,All people aged 16 to 74,332,24,3,21,84,27,73,28,49,22,8,3,5,17
S01007897,Very good health,165,18,2,16,47,7,35,12,21,10,2,1,1,13
S01007897,Good health,104,5,1,4,24,13,26,7,17,6,3,1,2,3
S01007897,Fair health,51,0,0,0,9,7,10,8,10,4,2,0,2,1
S01007897,Bad health,10,1,0,1,4,0,2,1,0,1,1,1,0,0
S01007897,Very bad health,2,0,0,0,0,0,0,0,1,1,0,0,0,0
S01007898,All people aged 16 to 74,347,19,5,14,64,42,69,23,50,44,7,5,2,29
S01007898,Very good health,161,10,3,7,37,16,28,12,22,15,2,1,1,19
S01007898,Good health,133,8,2,6,20,21,27,8,22,17,2,2,0,8
S01007898,Fair health,33,1,0,1,2,1,10,3,5,8,2,1,1,1
S01007898,Bad health,15,0,0,0,4,3,3,0,0,3,1,1,0,1
S01007898,Very bad health,5,0,0,0,1,1,1,0,1,1,0,0,0,0
S01007899,All people aged 16 to 74,289,14,3,11,54,36,81,15,29,36,5,1,4,19
S01007899,Very good health,153,12,1,11,35,20,33,9,12,13,2,0,2,17
S01007899,Good health,91,2,2,0,15,13,31,4,10,13,1,1,0,2
S01007899,Fair health,30,0,0,0,3,2,13,2,6,4,0,0,0,0
S01007899,Bad health,12,0,0,0,0,1,3,0,1,5,2,0,2,0
S01007899,Very bad health,3,0,0,0,1,0,1,0,0,1,0,0,0,0
S01007900,All people aged 16 to 74,408,9,5,4,42,31,22,39,95,99,41,32,9,30
S01007900,Very good health,163,6,3,3,20,17,11,15,34,28,11,10,1,21
S01007900,Good health,147,1,1,0,19,10,7,12,43,38,10,8,2,7
S01007900,Fair health,63,2,1,1,1,2,2,9,15,17,13,8,5,2
S01007900,Bad health,25,0,0,0,1,2,2,2,2,11,5,4,1,0
S01007900,Very bad health,10,0,0,0,1,0,0,1,1,5,2,2,0,0
S01007901,All people aged 16 to 74,521,8,2,6,59,62,31,58,98,129,38,24,14,38
S01007901,Very good health,223,4,0,4,27,29,18,26,36,41,14,10,4,28
S01007901,Good health,170,4,2,2,20,17,8,19,38,42,13,7,6,9
S01007901,Fair health,83,0,0,0,7,12,3,7,18,28,7,4,3,1
S01007901,Bad health,36,0,0,0,5,4,1,3,3,16,4,3,1,0
S01007901,Very bad health,9,0,0,0,0,0,1,3,3,2,0,0,0,0
S01007902,All people aged 16 to 74,690,7,2,5,49,75,41,88,139,187,74,56,18,30
S01007902,Very good health,242,2,0,2,19,29,17,37,44,55,19,11,8,20
S01007902,Good health,209,2,0,2,15,29,13,22,47,48,27,20,7,6
S01007902,Fair health,149,2,1,1,9,12,5,19,32,46,22,19,3,2
S01007902,Bad health,72,1,1,0,4,5,5,9,13,29,4,4,0,2
S01007902,Very bad health,18,0,0,0,2,0,1,1,3,9,2,2,0,0
S01007903,All people aged 16 to 74,479,10,5,5,70,56,43,60,91,95,30,16,14,24
S01007903,Very good health,174,5,1,4,23,25,18,20,28,30,6,1,5,19
S01007903,Good health,153,3,3,0,25,17,17,19,31,28,8,4,4,5
S01007903,Fair health,92,2,1,1,13,10,6,11,20,19,11,6,5,0
S01007903,Bad health,46,0,0,0,8,1,1,8,9,14,5,5,0,0
S01007903,Very bad health,14,0,0,0,1,3,1,2,3,4,0,0,0,0
S01007904,All people aged 16 to 74,656,57,17,40,138,61,106,56,67,74,14,9,5,83
S01007904,Very good health,291,29,6,23,68,32,55,25,26,23,5,4,1,28
S01007904,Good health,243,20,8,12,54,23,30,21,26,25,5,1,4,39
S01007904,Fair health,76,5,2,3,12,5,14,5,7,13,3,3,0,12
S01007904,Bad health,36,1,1,0,3,1,7,3,5,11,1,1,0,4
S01007904,Very bad health,10,2,0,2,1,0,0,2,3,2,0,0,0,0
S01007905,All people aged 16 to 74,509,7,2,5,34,34,14,52,130,126,78,42,36,34
S01007905,Very good health,187,3,0,3,18,14,4,17,43,37,31,16,15,20
S01007905,Good health,168,2,1,1,9,9,6,24,47,43,18,9,9,10
S01007905,Fair health,105,2,1,1,6,9,4,2,28,31,20,10,10,3
S01007905,Bad health,34,0,0,0,1,2,0,8,5,10,7,5,2,1
S01007905,Very bad health,15,0,0,0,0,0,0,1,7,5,2,2,0,0
S01007906,All people aged 16 to 74,526,8,3,5,46,39,25,70,107,162,44,27,17,25
S01007906,Very good health,155,5,1,4,17,20,6,18,35,32,9,6,3,13
S01007906,Good health,185,3,2,1,19,11,13,27,32,49,20,10,10,11
S01007906,Fair health,119,0,0,0,4,5,3,15,26,53,12,8,4,1
S01007906,Bad health,50,0,0,0,3,2,3,9,10,20,3,3,0,0
S01007906,Very bad health,17,0,0,0,3,1,0,1,4,8,0,0,0,0
S01007907,All people aged 16 to 74,428,13,4,9,42,35,22,49,87,118,37,23,14,25
S01007907,Very good health,150,7,2,5,13,15,9,17,33,26,10,8,2,20
S01007907,Good health,155,5,1,4,15,14,8,15,36,45,12,3,9,5
S01007907,Fair health,73,0,0,0,11,4,3,10,11,24,10,8,2,0
S01007907,Bad health,37,1,1,0,1,2,0,6,6,16,5,4,1,0
S01007907,Very bad health,13,0,0,0,2,0,2,1,1,7,0,0,0,0
S01007908,All people aged 16 to 74,694,19,8,11,110,73,57,76,136,151,35,23,12,37
S01007908,Very good health,275,7,1,6,57,32,19,26,42,43,16,9,7,33
S01007908,Good health,217,4,3,1,31,24,20,22,54,50,9,6,3,3
S01007908,Fair health,137,7,3,4,16,12,10,17,31,37,6,4,2,1
S01007908,Bad health,48,1,1,0,4,4,6,6,7,17,3,3,0,0
S01007908,Very bad health,17,0,0,0,2,1,2,5,2,4,1,1,0,0
S01007909,All people aged 16 to 74,398,9,2,7,44,41,20,52,81,103,21,13,8,27
S01007909,Very good health,169,8,2,6,20,18,9,18,37,36,9,4,5,14
S01007909,Good health,134,0,0,0,15,12,6,21,28,33,7,4,3,12
S01007909,Fair health,61,1,0,1,6,9,4,9,9,19,3,3,0,1
S01007909,Bad health,30,0,0,0,3,2,1,4,6,13,1,1,0,0
S01007909,Very bad health,4,0,0,0,0,0,0,0,1,2,1,1,0,0
S01007910,All people aged 16 to 74,652,12,5,7,83,47,31,63,128,156,67,42,25,65
S01007910,Very good health,248,4,1,3,37,20,15,23,46,43,23,14,9,37
S01007910,Good health,249,4,3,1,28,20,14,25,47,69,21,13,8,21
S01007910,Fair health,104,3,1,2,14,6,1,8,20,26,19,11,8,7
S01007910,Bad health,43,0,0,0,3,1,0,6,15,15,3,3,0,0
S01007910,Very bad health,8,1,0,1,1,0,1,1,0,3,1,1,0,0
S01007911,All people aged 16 to 74,576,15,4,11,97,76,39,61,114,104,28,20,8,42
S01007911,Very good health,254,10,3,7,53,37,17,24,39,35,9,6,3,30
S01007911,Good health,184,2,1,1,30,24,13,16,48,33,7,5,2,11
S01007911,Fair health,89,2,0,2,8,9,5,11,16,26,11,8,3,1
S01007911,Bad health,41,1,0,1,5,4,3,9,10,8,1,1,0,0
S01007911,Very bad health,8,0,0,0,1,2,1,1,1,2,0,0,0,0
S01007912,All people aged 16 to 74,605,15,4,11,90,65,29,62,132,144,37,25,12,31
S01007912,Very good health,227,8,2,6,41,31,10,19,50,41,8,6,2,19
S01007912,Good health,199,4,1,3,30,19,12,21,48,43,13,5,8,9
S01007912,Fair health,130,3,1,2,16,11,5,16,25,43,8,6,2,3
S01007912,Bad health,40,0,0,0,2,4,2,5,6,15,6,6,0,0
S01007912,Very bad health,9,0,0,0,1,0,0,1,3,2,2,2,0,0
S01007913,All people aged 16 to 74,449,1,0,1,59,34,34,47,96,107,50,36,14,21
S01007913,Very good health,153,1,0,1,18,15,14,15,29,29,19,13,6,13
S01007913,Good health,184,0,0,0,24,15,13,20,42,42,20,14,6,8
S01007913,Fair health,71,0,0,0,13,3,5,7,14,24,5,4,1,0
S01007913,Bad health,31,0,0,0,4,0,0,5,7,10,5,4,1,0
S01007913,Very bad health,10,0,0,0,0,1,2,0,4,2,1,1,0,0
S01007914,All people aged 16 to 74,476,6,3,3,58,44,26,37,116,100,43,26,17,46
S01007914,Very good health,186,2,1,1,24,20,8,9,42,38,12,8,4,31
S01007914,Good health,187,2,0,2,19,17,11,16,50,37,22,11,11,13
S01007914,Fair health,65,0,0,0,12,4,4,7,15,18,3,2,1,2
S01007914,Bad health,28,0,0,0,2,1,3,5,7,5,5,4,1,0
S01007914,Very bad health,10,2,2,0,1,2,0,0,2,2,1,1,0,0
S01007915,All people aged 16 to 74,631,19,4,15,77,86,45,80,136,106,35,16,19,47
S01007915,Very good health,287,10,3,7,43,45,14,39,55,32,16,5,11,33
S01007915,Good health,199,5,1,4,19,21,20,21,47,40,13,7,6,13
S01007915,Fair health,86,4,0,4,9,11,7,8,25,19,2,2,0,1
S01007915,Bad health,46,0,0,0,6,8,4,6,5,13,4,2,2,0
S01007915,Very bad health,13,0,0,0,0,1,0,6,4,2,0,0,0,0
S01007916,All people aged 16 to 74,584,16,2,14,75,78,46,51,104,132,43,28,15,39
S01007916,Very good health,212,8,1,7,32,36,16,18,31,32,13,9,4,26
S01007916,Good health,204,6,0,6,31,24,18,19,44,38,11,5,6,13
S01007916,Fair health,114,1,0,1,7,14,7,10,20,45,10,6,4,0
S01007916,Bad health,41,1,1,0,2,3,4,3,8,12,8,7,1,0
S01007916,Very bad health,13,0,0,0,3,1,1,1,1,5,1,1,0,0
S01007917,All people aged 16 to 74,648,9,4,5,90,73,40,82,117,160,41,30,11,36
S01007917,Very good health,279,5,2,3,37,34,16,34,42,71,12,8,4,28
S01007917,Good health,208,0,0,0,40,26,12,24,49,37,13,8,5,7
S01007917,Fair health,101,3,2,1,11,8,8,16,17,27,11,10,1,0
S01007917,Bad health,46,0,0,0,2,3,3,7,6,21,3,2,1,1
S01007917,Very bad health,14,1,0,1,0,2,1,1,3,4,2,2,0,0
S01007918,All people aged 16 to 74,692,34,5,29,107,85,44,72,105,144,51,31,20,50
S01007918,Very good health,316,13,0,13,54,46,24,30,42,51,18,9,9,38
S01007918,Good health,221,14,3,11,46,30,16,22,35,36,14,9,5,8
S01007918,Fair health,90,5,2,3,4,6,1,14,17,33,7,5,2,3
S01007918,Bad health,46,2,0,2,1,0,3,5,5,20,9,5,4,1
S01007918,Very bad health,19,0,0,0,2,3,0,1,6,4,3,3,0,0
S01007919,All people aged 16 to 74,587,66,18,48,172,86,38,57,65,48,10,6,4,45
S01007919,Very good health,313,35,7,28,95,42,13,32,31,24,7,3,4,34
S01007919,Good health,205,29,9,20,59,32,16,19,24,16,1,1,0,9
S01007919,Fair health,48,1,1,0,11,8,6,5,6,7,2,2,0,2
S01007919,Bad health,15,1,1,0,5,3,3,0,2,1,0,0,0,0
S01007919,Very bad health,6,0,0,0,2,1,0,1,2,0,0,0,0,0
S01007920,All people aged 16 to 74,463,36,7,29,111,73,40,57,58,52,11,8,3,25
S01007920,Very good health,234,23,4,19,59,33,16,25,32,20,5,4,1,21
S01007920,Good health,156,9,1,8,36,27,15,24,17,23,2,1,1,3
S01007920,Fair health,51,3,2,1,12,8,5,6,7,6,3,2,1,1
S01007920,Bad health,16,0,0,0,4,4,3,1,2,1,1,1,0,0
S01007920,Very bad health,6,1,0,1,0,1,1,1,0,2,0,0,0,0
S01007921,All people aged 16 to 74,690,12,3,9,63,63,45,76,144,188,65,44,21,34
S01007921,Very good health,258,10,2,8,30,22,18,30,51,56,17,10,7,24
S01007921,Good health,240,1,0,1,21,19,18,24,53,67,28,15,13,9
S01007921,Fair health,122,1,1,0,10,15,4,18,24,38,11,10,1,1
S01007921,Bad health,50,0,0,0,2,6,3,4,11,19,5,5,0,0
S01007921,Very bad health,20,0,0,0,0,1,2,0,5,8,4,4,0,0
S01007922,All people aged 16 to 74,658,9,2,7,69,53,53,61,149,159,67,42,25,38
S01007922,Very good health,262,4,0,4,30,27,24,22,56,51,21,11,10,27
S01007922,Good health,201,2,0,2,23,14,18,21,55,41,16,10,6,11
S01007922,Fair health,116,2,2,0,7,9,7,10,23,40,18,10,8,0
S01007922,Bad health,67,1,0,1,7,3,4,7,14,21,10,9,1,0
S01007922,Very bad health,12,0,0,0,2,0,0,1,1,6,2,2,0,0
S01007923,All people aged 16 to 74,734,27,10,17,144,95,65,88,125,121,21,10,11,48
S01007923,Very good health,334,17,4,13,81,42,25,38,51,40,7,5,2,33
S01007923,Good health,265,5,2,3,46,36,32,27,50,47,10,3,7,12
S01007923,Fair health,93,5,4,1,14,9,7,18,16,19,4,2,2,1
S01007923,Bad health,32,0,0,0,2,7,1,5,5,10,0,0,0,2
S01007923,Very bad health,10,0,0,0,1,1,0,0,3,5,0,0,0,0
S01007924,All people aged 16 to 74,735,14,5,9,99,57,46,67,156,179,69,38,31,48
S01007924,Very good health,273,6,2,4,50,19,22,26,55,48,15,8,7,32
S01007924,Good health,251,3,1,2,33,25,11,22,59,53,32,14,18,13
S01007924,Fair health,139,3,2,1,9,9,9,7,33,52,16,10,6,1
S01007924,Bad health,61,2,0,2,6,3,3,10,6,23,6,6,0,2
S01007924,Very bad health,11,0,0,0,1,1,1,2,3,3,0,0,0,0
S01007925,All people aged 16 to 74,367,44,8,36,90,36,95,25,29,20,8,4,4,20
S01007925,Very good health,193,30,5,25,50,15,43,10,16,9,3,1,2,17
S01007925,Good health,127,13,2,11,33,18,36,9,8,5,2,1,1,3
S01007925,Fair health,35,1,1,0,5,0,14,5,4,3,3,2,1,0
S01007925,Bad health,10,0,0,0,2,3,2,1,1,1,0,0,0,0
S01007925,Very bad health,2,0,0,0,0,0,0,0,0,2,0,0,0,0
S01007926,All people aged 16 to 74,365,44,8,36,82,47,76,21,36,27,8,6,2,24
S01007926,Very good health,200,31,6,25,44,25,44,10,12,8,4,3,1,22
S01007926,Good health,112,10,2,8,29,17,19,9,17,8,1,1,0,2
S01007926,Fair health,47,3,0,3,9,5,11,2,6,8,3,2,1,0
S01007926,Bad health,4,0,0,0,0,0,1,0,0,3,0,0,0,0
S01007926,Very bad health,2,0,0,0,0,0,1,0,1,0,0,0,0,0
S01007927,All people aged 16 to 74,494,55,7,48,118,58,115,27,45,33,10,8,2,33
S01007927,Very good health,265,30,4,26,71,37,58,12,13,14,0,0,0,30
S01007927,Good health,168,20,3,17,37,17,41,10,22,14,4,3,1,3
S01007927,Fair health,35,4,0,4,8,2,9,1,5,3,3,3,0,0
S01007927,Bad health,16,0,0,0,2,2,4,3,3,1,1,1,0,0
S01007927,Very bad health,10,1,0,1,0,0,3,1,2,1,2,1,1,0
S01007928,All people aged 16 to 74,739,89,26,63,191,101,87,47,90,63,25,20,5,46
S01007928,Very good health,385,51,14,37,106,54,42,27,41,24,5,4,1,35
S01007928,Good health,251,30,11,19,66,34,36,10,35,21,10,7,3,9
S01007928,Fair health,72,5,0,5,13,10,7,9,9,12,5,4,1,2
S01007928,Bad health,20,1,1,0,3,3,1,1,5,3,3,3,0,0
S01007928,Very bad health,11,2,0,2,3,0,1,0,0,3,2,2,0,0
S01007929,All people aged 16 to 74,568,75,11,64,142,53,116,38,48,38,12,7,5,46
S01007929,Very good health,326,44,7,37,82,32,66,19,24,17,5,2,3,37
S01007929,Good health,166,28,3,25,48,13,30,12,16,9,3,2,1,7
S01007929,Fair health,57,3,1,2,7,6,17,5,4,12,1,0,1,2
S01007929,Bad health,16,0,0,0,5,2,3,2,3,0,1,1,0,0
S01007929,Very bad health,3,0,0,0,0,0,0,0,1,0,2,2,0,0
S01007930,All people aged 16 to 74,454,66,15,51,112,37,99,36,35,27,8,5,3,34
S01007930,Very good health,280,48,13,35,76,19,50,24,16,11,4,1,3,32
S01007930,Good health,134,18,2,16,27,16,38,8,12,12,1,1,0,2
S01007930,Fair health,30,0,0,0,5,2,10,2,6,3,2,2,0,0
S01007930,Bad health,7,0,0,0,3,0,1,1,1,1,0,0,0,0
S01007930,Very bad health,3,0,0,0,1,0,0,1,0,0,1,1,0,0
S01007931,All people aged 16 to 74,821,131,33,98,216,107,57,46,93,87,29,22,7,55
S01007931,Very good health,422,80,24,56,124,51,26,20,44,27,8,8,0,42
S01007931,Good health,265,40,9,31,72,36,15,19,31,33,10,5,5,9
S01007931,Fair health,91,8,0,8,18,12,14,4,12,14,5,4,1,4
S01007931,Bad health,31,2,0,2,2,8,1,1,5,9,3,3,0,0
S01007931,Very bad health,12,1,0,1,0,0,1,2,1,4,3,2,1,0
S01007932,All people aged 16 to 74,650,80,16,64,208,91,59,38,63,37,20,13,7,54
S01007932,Very good health,354,43,7,36,111,53,26,17,35,14,9,6,3,46
S01007932,Good health,216,29,6,23,74,30,22,16,21,15,4,2,2,5
S01007932,Fair health,67,7,3,4,21,7,10,4,4,7,4,3,1,3
S01007932,Bad health,10,1,0,1,1,1,1,1,2,0,3,2,1,0
S01007932,Very bad health,3,0,0,0,1,0,0,0,1,1,0,0,0,0
S01007933,All people aged 16 to 74,616,56,12,44,146,66,48,41,107,68,25,13,12,59
S01007933,Very good health,329,36,8,28,90,37,18,11,52,30,10,7,3,45
S01007933,Good health,205,12,0,12,45,16,25,20,39,22,12,4,8,14
S01007933,Fair health,59,3,1,2,10,6,5,6,14,12,3,2,1,0
S01007933,Bad health,19,5,3,2,1,6,0,2,2,3,0,0,0,0
S01007933,Very bad health,4,0,0,0,0,1,0,2,0,1,0,0,0,0
S01007934,All people aged 16 to 74,500,31,7,24,103,76,39,27,70,75,28,19,9,51
S01007934,Very good health,265,15,4,11,66,44,17,13,26,29,11,8,3,44
S01007934,Good health,168,13,3,10,31,26,15,12,28,28,9,6,3,6
S01007934,Fair health,42,2,0,2,3,3,5,1,12,11,5,3,2,0
S01007934,Bad health,23,1,0,1,2,3,1,1,4,7,3,2,1,1
S01007934,Very bad health,2,0,0,0,1,0,1,0,0,0,0,0,0,0
S01007935,All people aged 16 to 74,593,56,8,48,118,90,52,53,81,74,36,18,18,33
S01007935,Very good health,288,35,4,31,73,47,21,24,29,26,5,3,2,28
S01007935,Good health,208,17,2,15,33,30,22,26,29,28,18,10,8,5
S01007935,Fair health,60,3,1,2,8,9,8,3,10,11,8,2,6,0
S01007935,Bad health,23,0,0,0,0,2,1,0,10,6,4,3,1,0
S01007935,Very bad health,14,1,1,0,4,2,0,0,3,3,1,0,1,0
S01007936,All people aged 16 to 74,741,122,23,99,224,118,50,64,60,28,19,12,7,56
S01007936,Very good health,447,83,15,68,135,61,26,38,34,14,4,2,2,52
S01007936,Good health,227,34,7,27,67,50,19,19,16,11,7,3,4,4
S01007936,Fair health,49,4,1,3,17,6,5,5,6,3,3,2,1,0
S01007936,Bad health,16,1,0,1,5,0,0,1,4,0,5,5,0,0
S01007936,Very bad health,2,0,0,0,0,1,0,1,0,0,0,0,0,0
S01007937,All people aged 16 to 74,813,99,22,77,214,131,60,71,95,69,23,13,10,51
S01007937,Very good health,459,52,12,40,135,75,26,31,50,38,10,5,5,42
S01007937,Good health,257,42,8,34,53,42,26,31,31,19,7,3,4,6
S01007937,Fair health,74,5,2,3,21,10,5,8,9,9,5,4,1,2
S01007937,Bad health,15,0,0,0,2,3,0,1,5,3,0,0,0,1
S01007937,Very bad health,8,0,0,0,3,1,3,0,0,0,1,1,0,0
S01007938,All people aged 16 to 74,585,27,9,18,94,90,43,56,115,93,28,12,16,39
S01007938,Very good health,270,16,5,11,52,41,20,26,43,30,15,7,8,27
S01007938,Good health,187,9,2,7,25,34,14,18,43,28,5,0,5,11
S01007938,Fair health,80,1,1,0,12,11,5,9,16,19,6,3,3,1
S01007938,Bad health,40,1,1,0,3,2,4,3,12,14,1,1,0,0
S01007938,Very bad health,8,0,0,0,2,2,0,0,1,2,1,1,0,0
S01007939,All people aged 16 to 74,620,10,1,9,75,77,36,54,152,117,58,33,25,41
S01007939,Very good health,268,3,0,3,35,25,12,23,68,46,22,12,10,34
S01007939,Good health,228,5,0,5,27,38,17,20,56,36,23,14,9,6
S01007939,Fair health,90,2,1,1,10,11,5,9,19,23,10,4,6,1
S01007939,Bad health,28,0,0,0,2,3,2,1,7,11,2,2,0,0
S01007939,Very bad health,6,0,0,0,1,0,0,1,2,1,1,1,0,0
S01007940,All people aged 16 to 74,760,60,10,50,130,92,69,73,125,141,30,18,12,40
S01007940,Very good health,333,32,4,28,60,51,30,28,44,45,14,8,6,29
S01007940,Good health,275,20,3,17,46,28,27,27,57,50,11,7,4,9
S01007940,Fair health,93,7,3,4,19,8,9,11,17,19,1,0,1,2
S01007940,Bad health,37,0,0,0,5,3,2,7,5,13,2,1,1,0
S01007940,Very bad health,22,1,0,1,0,2,1,0,2,14,2,2,0,0
S01007941,All people aged 16 to 74,513,40,14,26,111,101,42,53,67,57,10,8,2,32
S01007941,Very good health,261,25,9,16,55,51,14,21,34,28,4,3,1,29
S01007941,Good health,179,7,3,4,46,38,21,19,24,17,5,4,1,2
S01007941,Fair health,58,5,2,3,9,12,5,11,6,9,1,1,0,0
S01007941,Bad health,13,3,0,3,1,0,2,1,2,3,0,0,0,1
S01007941,Very bad health,2,0,0,0,0,0,0,1,1,0,0,0,0,0
S01007942,All people aged 16 to 74,347,23,5,18,59,59,26,32,40,69,26,13,13,13
S01007942,Very good health,165,14,2,12,34,31,16,16,13,23,8,4,4,10
S01007942,Good health,117,6,1,5,18,18,8,12,18,26,9,3,6,2
S01007942,Fair health,42,1,0,1,5,5,0,4,5,16,5,3,2,1
S01007942,Bad health,18,2,2,0,2,4,2,0,3,2,3,2,1,0
S01007942,Very bad health,5,0,0,0,0,1,0,0,1,2,1,1,0,0
S01007943,All people aged 16 to 74,482,31,11,20,104,66,46,43,78,78,18,10,8,18
S01007943,Very good health,219,23,8,15,52,27,17,15,32,30,7,4,3,16
S01007943,Good health,171,7,3,4,33,29,17,18,32,28,6,2,4,1
S01007943,Fair health,62,0,0,0,13,8,9,9,8,12,3,2,1,0
S01007943,Bad health,24,1,0,1,5,2,3,0,3,7,2,2,0,1
S01007943,Very bad health,6,0,0,0,1,0,0,1,3,1,0,0,0,0
S01007944,All people aged 16 to 74,694,39,11,28,117,76,61,75,121,130,40,24,16,35
S01007944,Very good health,291,19,6,13,53,20,25,32,58,45,13,5,8,26
S01007944,Good health,252,18,4,14,49,29,21,29,36,48,15,8,7,7
S01007944,Fair health,107,2,1,1,12,18,9,9,24,26,6,5,1,1
S01007944,Bad health,38,0,0,0,3,9,6,4,3,7,6,6,0,0
S01007944,Very bad health,6,0,0,0,0,0,0,1,0,4,0,0,0,1
S01007945,All people aged 16 to 74,631,44,9,35,114,71,65,57,85,101,48,23,25,46
S01007945,Very good health,271,22,6,16,60,26,35,17,34,30,14,9,5,33
S01007945,Good health,201,13,2,11,32,27,20,23,31,28,19,6,13,8
S01007945,Fair health,99,6,1,5,18,13,7,7,14,22,9,4,5,3
S01007945,Bad health,45,1,0,1,3,4,3,9,4,17,2,1,1,2
S01007945,Very bad health,15,2,0,2,1,1,0,1,2,4,4,3,1,0
S01007946,All people aged 16 to 74,608,31,7,24,110,67,48,56,102,97,47,21,26,50
S01007946,Very good health,233,19,4,15,41,28,20,24,28,28,14,4,10,31
S01007946,Good health,223,4,0,4,52,28,14,10,40,37,21,8,13,17
S01007946,Fair health,97,4,2,2,13,8,10,11,20,19,10,7,3,2
S01007946,Bad health,45,2,1,1,4,3,4,9,11,10,2,2,0,0
S01007946,Very bad health,10,2,0,2,0,0,0,2,3,3,0,0,0,0
S01007947,All people aged 16 to 74,572,55,18,37,113,74,47,45,83,81,29,13,16,45
S01007947,Very good health,267,32,8,24,57,43,19,17,30,29,7,3,4,33
S01007947,Good health,186,15,8,7,43,21,20,17,30,19,12,4,8,9
S01007947,Fair health,88,6,1,5,8,8,7,8,18,23,8,4,4,2
S01007947,Bad health,22,1,1,0,5,2,1,2,3,6,1,1,0,1
S01007947,Very bad health,9,1,0,1,0,0,0,1,2,4,1,1,0,0
S01007948,All people aged 16 to 74,484,15,3,12,56,34,31,44,92,120,62,38,24,30
S01007948,Very good health,179,9,2,7,33,14,11,10,31,33,15,9,6,23
S01007948,Good health,165,4,1,3,18,10,14,15,32,44,23,15,8,5
S01007948,Fair health,88,0,0,0,4,6,3,10,18,25,20,10,10,2
S01007948,Bad health,38,2,0,2,1,4,2,7,6,13,3,3,0,0
S01007948,Very bad health,14,0,0,0,0,0,1,2,5,5,1,1,0,0
S01007949,All people aged 16 to 74,605,43,12,31,142,99,39,69,101,66,19,9,10,27
S01007949,Very good health,294,25,6,19,86,48,13,31,38,24,10,5,5,19
S01007949,Good health,223,13,6,7,45,36,19,29,48,23,5,0,5,5
S01007949,Fair health,66,4,0,4,9,12,6,5,13,12,2,2,0,3
S01007949,Bad health,21,1,0,1,2,2,1,4,2,7,2,2,0,0
S01007949,Very bad health,1,0,0,0,0,1,0,0,0,0,0,0,0,0
S01007950,All people aged 16 to 74,691,57,18,39,174,120,69,68,72,60,16,9,7,55
S01007950,Very good health,349,39,11,28,96,60,20,35,29,19,9,5,4,42
S01007950,Good health,243,14,4,10,57,45,31,25,30,29,3,2,1,9
S01007950,Fair health,67,3,2,1,13,11,13,5,8,8,3,2,1,3
S01007950,Bad health,26,1,1,0,4,4,4,2,5,4,1,0,1,1
S01007950,Very bad health,6,0,0,0,4,0,1,1,0,0,0,0,0,0
S01007951,All people aged 16 to 74,561,32,9,23,109,85,42,56,80,84,24,10,14,49
S01007951,Very good health,242,15,3,12,51,40,11,22,32,29,8,4,4,34
S01007951,Good health,223,12,3,9,45,37,21,18,37,31,10,4,6,12
S01007951,Fair health,66,4,3,1,11,6,5,10,7,15,5,2,3,3
S01007951,Bad health,22,1,0,1,2,2,3,5,2,6,1,0,1,0
S01007951,Very bad health,8,0,0,0,0,0,2,1,2,3,0,0,0,0
S01007952,All people aged 16 to 74,467,17,3,14,58,57,47,43,94,85,40,23,17,26
S01007952,Very good health,189,8,2,6,26,29,21,16,36,22,15,9,6,16
S01007952,Good health,147,6,1,5,18,17,17,13,28,33,9,4,5,6
S01007952,Fair health,82,3,0,3,8,9,4,9,21,16,10,4,6,2
S01007952,Bad health,36,0,0,0,3,2,3,5,6,10,6,6,0,1
S01007952,Very bad health,13,0,0,0,3,0,2,0,3,4,0,0,0,1
S01007953,All people aged 16 to 74,710,20,2,18,101,85,58,65,157,134,30,11,19,60
S01007953,Very good health,342,12,1,11,56,43,24,29,66,50,15,7,8,47
S01007953,Good health,219,7,1,6,33,25,22,21,48,40,13,3,10,10
S01007953,Fair health,97,1,0,1,10,9,8,14,27,24,1,1,0,3
S01007953,Bad health,34,0,0,0,1,5,2,0,10,15,1,0,1,0
S01007953,Very bad health,18,0,0,0,1,3,2,1,6,5,0,0,0,0
S01007954,All people aged 16 to 74,553,9,0,9,58,44,22,62,129,126,62,33,29,41
S01007954,Very good health,224,4,0,4,28,26,9,22,45,42,21,7,14,27
S01007954,Good health,170,4,0,4,19,10,8,22,46,34,20,10,10,7
S01007954,Fair health,103,1,0,1,8,5,4,11,27,28,14,10,4,5
S01007954,Bad health,42,0,0,0,2,3,1,3,8,16,7,6,1,2
S01007954,Very bad health,14,0,0,0,1,0,0,4,3,6,0,0,0,0
S01007955,All people aged 16 to 74,606,8,1,7,59,77,29,60,151,126,62,32,30,34
S01007955,Very good health,273,5,1,4,27,44,11,27,68,46,24,10,14,21
S01007955,Good health,205,2,0,2,20,22,9,19,55,50,20,9,11,8
S01007955,Fair health,91,1,0,1,9,10,7,8,21,18,14,9,5,3
S01007955,Bad health,25,0,0,0,3,1,1,4,4,7,3,3,0,2
S01007955,Very bad health,12,0,0,0,0,0,1,2,3,5,1,1,0,0
S01007956,All people aged 16 to 74,533,13,4,9,59,65,28,54,112,114,35,21,14,53
S01007956,Very good health,229,8,3,5,30,31,7,21,43,41,13,9,4,35
S01007956,Good health,202,5,1,4,19,21,15,23,48,45,12,6,6,14
S01007956,Fair health,73,0,0,0,5,10,5,9,13,18,9,5,4,4
S01007956,Bad health,21,0,0,0,3,2,1,1,6,7,1,1,0,0
S01007956,Very bad health,8,0,0,0,2,1,0,0,2,3,0,0,0,0
S01007957,All people aged 16 to 74,702,20,3,17,94,88,37,83,152,138,48,38,10,42
S01007957,Very good health,254,13,1,12,41,32,14,30,50,37,12,8,4,25
S01007957,Good health,271,5,2,3,36,37,16,29,66,51,18,14,4,13
S01007957,Fair health,113,1,0,1,13,14,5,12,23,33,9,7,2,3
S01007957,Bad health,48,0,0,0,4,5,2,7,9,13,7,7,0,1
S01007957,Very bad health,16,1,0,1,0,0,0,5,4,4,2,2,0,0
S01007958,All people aged 16 to 74,629,22,6,16,72,74,34,70,130,110,80,42,38,37
S01007958,Very good health,252,13,3,10,34,33,12,22,51,41,21,10,11,25
S01007958,Good health,224,6,3,3,26,24,16,28,51,30,34,14,20,9
S01007958,Fair health,97,2,0,2,6,12,3,9,17,26,19,12,7,3
S01007958,Bad health,43,1,0,1,5,1,2,8,9,11,6,6,0,0
S01007958,Very bad health,13,0,0,0,1,4,1,3,2,2,0,0,0,0
S01007959,All people aged 16 to 74,597,25,8,17,124,89,51,75,105,85,18,8,10,25
S01007959,Very good health,247,10,4,6,60,42,20,32,36,24,4,1,3,19
S01007959,Good health,252,12,4,8,49,32,22,34,50,39,9,4,5,5
S01007959,Fair health,66,2,0,2,12,10,5,4,11,16,5,3,2,1
S01007959,Bad health,27,0,0,0,3,5,3,4,7,5,0,0,0,0
S01007959,Very bad health,5,1,0,1,0,0,1,1,1,1,0,0,0,0
S01007960,All people aged 16 to 74,535,14,2,12,70,63,28,52,125,123,26,14,12,34
S01007960,Very good health,238,9,1,8,35,37,9,21,53,40,9,6,3,25
S01007960,Good health,175,5,1,4,23,15,11,18,42,41,11,4,7,9
S01007960,Fair health,75,0,0,0,6,7,6,8,23,22,3,1,2,0
S01007960,Bad health,40,0,0,0,5,4,1,4,7,16,3,3,0,0
S01007960,Very bad health,7,0,0,0,1,0,1,1,0,4,0,0,0,0
S01007961,All people aged 16 to 74,1061,57,12,45,139,76,178,100,155,168,148,143,5,40
S01007961,Very good health,428,28,6,22,77,38,79,37,68,52,21,20,1,28
S01007961,Good health,395,21,4,17,39,23,67,40,53,74,68,64,4,10
S01007961,Fair health,178,4,1,3,18,11,27,15,25,33,44,44,0,1
S01007961,Bad health,42,4,1,3,2,3,4,8,5,7,9,9,0,0
S01007961,Very bad health,18,0,0,0,3,1,1,0,4,2,6,6,0,1
S01007962,All people aged 16 to 74,418,18,8,10,40,56,29,44,80,85,29,18,11,37
S01007962,Very good health,208,7,1,6,26,34,12,26,35,36,9,5,4,23
S01007962,Good health,135,7,4,3,10,11,14,14,29,20,17,11,6,13
S01007962,Fair health,46,0,0,0,3,9,2,2,10,17,2,1,1,1
S01007962,Bad health,23,4,3,1,1,2,1,1,6,8,0,0,0,0
S01007962,Very bad health,6,0,0,0,0,0,0,1,0,4,1,1,0,0
S01007963,All people aged 16 to 74,668,10,4,6,37,60,44,62,138,150,133,80,53,34
S01007963,Very good health,221,4,0,4,20,21,12,15,52,33,41,27,14,23
S01007963,Good health,234,2,0,2,8,26,16,28,48,48,50,24,26,8
S01007963,Fair health,122,2,2,0,7,6,7,10,21,35,31,19,12,3
S01007963,Bad health,64,2,2,0,1,6,4,7,11,27,6,5,1,0
S01007963,Very bad health,27,0,0,0,1,1,5,2,6,7,5,5,0,0
S01007964,All people aged 16 to 74,569,14,3,11,57,55,26,69,122,129,49,28,21,48
S01007964,Very good health,245,6,2,4,27,24,10,26,50,44,19,11,8,39
S01007964,Good health,197,5,1,4,20,23,7,29,47,45,16,10,6,5
S01007964,Fair health,81,3,0,3,6,7,6,8,18,23,7,2,5,3
S01007964,Bad health,32,0,0,0,4,1,1,2,6,11,6,4,2,1
S01007964,Very bad health,14,0,0,0,0,0,2,4,1,6,1,1,0,0
S01007965,All people aged 16 to 74,414,8,2,6,45,52,18,40,96,80,42,26,16,33
S01007965,Very good health,156,4,1,3,20,19,12,13,37,22,10,8,2,19
S01007965,Good health,160,1,0,1,17,23,3,17,37,32,19,9,10,11
S01007965,Fair health,66,1,0,1,5,9,1,5,14,20,9,6,3,2
S01007965,Bad health,28,2,1,1,3,0,2,5,8,5,2,1,1,1
S01007965,Very bad health,4,0,0,0,0,1,0,0,0,1,2,2,0,0
S01007966,All people aged 16 to 74,661,21,4,17,71,66,24,53,147,139,86,43,43,54
S01007966,Very good health,249,9,1,8,27,23,4,27,57,41,21,11,10,40
S01007966,Good health,227,7,2,5,26,30,10,13,43,49,36,15,21,13
S01007966,Fair health,114,4,0,4,13,8,6,8,29,28,17,9,8,1
S01007966,Bad health,49,1,1,0,4,3,2,3,12,15,9,6,3,0
S01007966,Very bad health,22,0,0,0,1,2,2,2,6,6,3,2,1,0
S01007967,All people aged 16 to 74,444,2,0,2,44,45,21,22,118,92,65,41,24,35
S01007967,Very good health,181,2,0,2,20,20,6,8,45,35,22,12,10,23
S01007967,Good health,158,0,0,0,14,12,9,9,47,32,25,12,13,10
S01007967,Fair health,72,0,0,0,7,7,6,2,16,18,14,13,1,2
S01007967,Bad health,22,0,0,0,0,4,0,2,8,5,3,3,0,0
S01007967,Very bad health,11,0,0,0,3,2,0,1,2,2,1,1,0,0
S01007968,All people aged 16 to 74,614,14,3,11,83,102,32,64,123,116,34,16,18,46
S01007968,Very good health,253,9,2,7,43,36,9,29,45,43,6,2,4,33
S01007968,Good health,225,3,1,2,29,40,16,24,54,34,16,7,9,9
S01007968,Fair health,90,1,0,1,7,22,1,10,14,25,7,2,5,3
S01007968,Bad health,34,1,0,1,3,3,6,1,7,8,4,4,0,1
S01007968,Very bad health,12,0,0,0,1,1,0,0,3,6,1,1,0,0
S01007969,All people aged 16 to 74,590,11,2,9,96,95,29,51,146,93,33,17,16,36
S01007969,Very good health,265,4,2,2,49,45,15,22,57,32,14,4,10,27
S01007969,Good health,189,3,0,3,30,32,11,18,49,30,8,4,4,8
S01007969,Fair health,92,3,0,3,16,10,2,9,29,18,4,3,1,1
S01007969,Bad health,32,1,0,1,0,5,0,2,10,9,5,4,1,0
S01007969,Very bad health,12,0,0,0,1,3,1,0,1,4,2,2,0,0
S01007970,All people aged 16 to 74,625,17,3,14,106,85,33,63,134,113,41,16,25,33
S01007970,Very good health,285,11,3,8,55,42,16,25,59,39,13,6,7,25
S01007970,Good health,211,4,0,4,41,31,10,21,40,41,17,5,12,6
S01007970,Fair health,92,2,0,2,8,10,4,13,29,16,8,4,4,2
S01007970,Bad health,24,0,0,0,1,1,1,3,4,11,3,1,2,0
S01007970,Very bad health,13,0,0,0,1,1,2,1,2,6,0,0,0,0
S01007971,All people aged 16 to 74,659,15,8,7,85,86,30,74,130,131,57,30,27,51
S01007971,Very good health,274,8,4,4,43,43,9,30,53,41,14,5,9,33
S01007971,Good health,232,5,3,2,29,26,14,24,55,44,21,8,13,14
S01007971,Fair health,100,0,0,0,8,13,4,16,12,26,19,14,5,2
S01007971,Bad health,39,2,1,1,4,3,1,4,7,14,2,2,0,2
S01007971,Very bad health,14,0,0,0,1,1,2,0,3,6,1,1,0,0
S01007972,All people aged 16 to 74,600,13,4,9,86,70,28,72,127,133,31,19,12,40
S01007972,Very good health,260,7,1,6,40,30,12,33,51,42,9,7,2,36
S01007972,Good health,228,4,1,3,36,34,12,26,57,47,8,4,4,4
S01007972,Fair health,72,1,1,0,6,4,3,9,15,26,8,2,6,0
S01007972,Bad health,32,1,1,0,4,2,1,2,3,17,2,2,0,0
S01007972,Very bad health,8,0,0,0,0,0,0,2,1,1,4,4,0,0
S01007973,All people aged 16 to 74,678,44,13,31,175,131,39,64,102,78,9,5,4,36
S01007973,Very good health,368,24,7,17,93,75,19,36,42,46,4,2,2,29
S01007973,Good health,242,16,5,11,72,49,13,21,40,24,4,2,2,3
S01007973,Fair health,53,4,1,3,7,7,5,7,13,6,1,1,0,3
S01007973,Bad health,14,0,0,0,3,0,2,0,6,2,0,0,0,1
S01007973,Very bad health,1,0,0,0,0,0,0,0,1,0,0,0,0,0
S01007974,All people aged 16 to 74,610,21,3,18,74,76,31,59,128,130,55,36,19,36
S01007974,Very good health,241,13,1,12,38,28,11,27,49,46,6,1,5,23
S01007974,Good health,203,4,2,2,25,26,15,19,39,40,22,11,11,13
S01007974,Fair health,86,3,0,3,6,12,1,10,21,18,15,12,3,0
S01007974,Bad health,56,1,0,1,3,6,4,2,14,19,7,7,0,0
S01007974,Very bad health,24,0,0,0,2,4,0,1,5,7,5,5,0,0
S01007975,All people aged 16 to 74,470,7,2,5,72,65,33,49,98,81,30,15,15,35
S01007975,Very good health,216,5,1,4,38,35,12,24,35,32,10,5,5,25
S01007975,Good health,151,2,1,1,16,19,15,20,37,23,9,1,8,10
S01007975,Fair health,67,0,0,0,13,8,2,3,18,14,9,7,2,0
S01007975,Bad health,22,0,0,0,3,2,2,1,5,8,1,1,0,0
S01007975,Very bad health,14,0,0,0,2,1,2,1,3,4,1,1,0,0
S01007976,All people aged 16 to 74,536,24,4,20,81,72,23,48,109,113,42,14,28,24
S01007976,Very good health,204,12,2,10,40,36,10,20,33,23,15,2,13,15
S01007976,Good health,187,6,1,5,25,21,10,18,46,44,10,2,8,7
S01007976,Fair health,103,5,1,4,10,9,3,7,23,32,13,6,7,1
S01007976,Bad health,33,1,0,1,5,5,0,2,5,12,2,2,0,1
S01007976,Very bad health,9,0,0,0,1,1,0,1,2,2,2,2,0,0
S01007977,All people aged 16 to 74,518,40,10,30,126,66,30,64,96,43,11,6,5,42
S01007977,Very good health,290,21,1,20,80,45,14,28,45,19,3,2,1,35
S01007977,Good health,160,14,7,7,35,15,13,26,35,12,4,2,2,6
S01007977,Fair health,46,5,2,3,4,5,2,6,11,9,3,1,2,1
S01007977,Bad health,19,0,0,0,4,1,1,4,5,3,1,1,0,0
S01007977,Very bad health,3,0,0,0,3,0,0,0,0,0,0,0,0,0
S01007978,All people aged 16 to 74,456,22,6,16,93,65,25,52,81,68,22,11,11,28
S01007978,Very good health,214,10,0,10,52,43,10,19,34,24,4,2,2,18
S01007978,Good health,158,9,5,4,33,15,9,25,26,21,11,3,8,9
S01007978,Fair health,58,3,1,2,8,4,6,7,14,12,3,2,1,1
S01007978,Bad health,20,0,0,0,0,2,0,1,6,8,3,3,0,0
S01007978,Very bad health,6,0,0,0,0,1,0,0,1,3,1,1,0,0
S01007979,All people aged 16 to 74,639,73,12,61,200,91,40,42,71,45,21,10,11,56
S01007979,Very good health,344,45,9,36,115,43,22,23,30,16,6,4,2,44
S01007979,Good health,203,23,2,21,57,36,13,11,29,17,5,1,4,12
S01007979,Fair health,70,4,1,3,20,12,4,5,11,8,6,3,3,0
S01007979,Bad health,16,1,0,1,6,0,1,3,1,2,2,1,1,0
S01007979,Very bad health,6,0,0,0,2,0,0,0,0,2,2,1,1,0
S01007980,All people aged 16 to 74,528,38,12,26,111,78,37,48,82,74,20,11,9,40
S01007980,Very good health,267,22,7,15,67,43,15,18,36,27,6,5,1,33
S01007980,Good health,181,14,4,10,32,28,19,18,33,24,8,1,7,5
S01007980,Fair health,57,2,1,1,7,4,1,10,10,15,6,5,1,2
S01007980,Bad health,20,0,0,0,4,2,2,2,3,7,0,0,0,0
S01007980,Very bad health,3,0,0,0,1,1,0,0,0,1,0,0,0,0
S01007981,All people aged 16 to 74,426,21,6,15,109,92,40,33,65,36,13,7,6,17
S01007981,Very good health,211,14,5,9,61,45,18,16,23,17,3,2,1,14
S01007981,Good health,141,5,0,5,36,33,14,9,25,15,2,1,1,2
S01007981,Fair health,56,2,1,1,10,10,6,5,14,1,7,3,4,1
S01007981,Bad health,12,0,0,0,2,2,2,2,2,2,0,0,0,0
S01007981,Very bad health,6,0,0,0,0,2,0,1,1,1,1,1,0,0
S01007982,All people aged 16 to 74,400,30,7,23,100,66,29,36,66,34,6,3,3,33
S01007982,Very good health,198,16,3,13,52,36,11,18,25,14,0,0,0,26
S01007982,Good health,132,9,1,8,32,21,10,13,27,11,3,2,1,6
S01007982,Fair health,50,5,3,2,10,6,4,4,11,6,3,1,2,1
S01007982,Bad health,16,0,0,0,6,2,4,1,2,1,0,0,0,0
S01007982,Very bad health,4,0,0,0,0,1,0,0,1,2,0,0,0,0
S01007983,All people aged 16 to 74,556,15,3,12,66,64,29,55,118,119,42,20,22,48
S01007983,Very good health,213,8,0,8,29,25,12,26,37,33,11,5,6,32
S01007983,Good health,195,5,2,3,23,25,9,21,48,41,13,5,8,10
S01007983,Fair health,100,1,1,0,12,7,4,5,22,31,13,5,8,5
S01007983,Bad health,36,0,0,0,2,6,4,2,11,8,2,2,0,1
S01007983,Very bad health,12,1,0,1,0,1,0,1,0,6,3,3,0,0
S01007984,All people aged 16 to 74,615,38,8,30,122,81,31,51,122,98,32,22,10,40
S01007984,Very good health,266,22,4,18,67,35,13,19,42,28,10,7,3,30
S01007984,Good health,244,13,3,10,37,40,13,18,54,44,16,9,7,9
S01007984,Fair health,73,2,1,1,15,5,5,8,18,16,3,3,0,1
S01007984,Bad health,26,1,0,1,3,1,0,6,4,8,3,3,0,0
S01007984,Very bad health,6,0,0,0,0,0,0,0,4,2,0,0,0,0
S01007985,All people aged 16 to 74,698,19,10,9,61,81,36,71,169,142,66,32,34,53
S01007985,Very good health,263,8,3,5,26,42,10,28,50,43,21,11,10,35
S01007985,Good health,260,8,4,4,28,25,14,23,65,48,31,14,17,18
S01007985,Fair health,126,2,2,0,4,11,8,13,38,38,12,5,7,0
S01007985,Bad health,42,1,1,0,2,3,3,7,13,11,2,2,0,0
S01007985,Very bad health,7,0,0,0,1,0,1,0,3,2,0,0,0,0
S01007986,All people aged 16 to 74,437,22,6,16,71,67,21,41,90,72,16,11,5,37
S01007986,Very good health,219,12,2,10,39,38,6,13,34,34,11,7,4,32
S01007986,Good health,144,8,4,4,18,23,12,15,34,28,3,2,1,3
S01007986,Fair health,51,2,0,2,9,0,2,12,16,8,1,1,0,1
S01007986,Bad health,19,0,0,0,4,6,1,0,4,2,1,1,0,1
S01007986,Very bad health,4,0,0,0,1,0,0,1,2,0,0,0,0,0
S01007987,All people aged 16 to 74,586,41,4,37,114,92,33,52,93,86,26,10,16,49
S01007987,Very good health,293,26,2,24,58,41,12,26,43,39,8,2,6,40
S01007987,Good health,188,13,2,11,36,34,13,15,30,30,11,2,9,6
S01007987,Fair health,76,1,0,1,15,12,7,7,16,11,4,3,1,3
S01007987,Bad health,19,0,0,0,4,4,1,3,4,2,1,1,0,0
S01007987,Very bad health,10,1,0,1,1,1,0,1,0,4,2,2,0,0
S01007988,All people aged 16 to 74,632,16,3,13,86,84,30,59,164,115,44,29,15,34
S01007988,Very good health,249,11,1,10,40,37,15,25,57,31,10,8,2,23
S01007988,Good health,230,3,2,1,33,35,9,23,62,43,14,7,7,8
S01007988,Fair health,98,1,0,1,6,8,2,8,32,26,13,8,5,2
S01007988,Bad health,43,1,0,1,5,4,3,2,12,10,5,4,1,1
S01007988,Very bad health,12,0,0,0,2,0,1,1,1,5,2,2,0,0
S01007989,All people aged 16 to 74,532,10,3,7,81,52,38,47,123,93,38,23,15,50
S01007989,Very good health,241,6,3,3,39,25,18,18,47,43,12,7,5,33
S01007989,Good health,173,3,0,3,22,13,14,22,43,27,13,8,5,16
S01007989,Fair health,85,1,0,1,14,12,4,6,22,15,10,6,4,1
S01007989,Bad health,28,0,0,0,6,2,2,1,7,7,3,2,1,0
S01007989,Very bad health,5,0,0,0,0,0,0,0,4,1,0,0,0,0
S01007990,All people aged 16 to 74,665,28,7,21,106,94,32,79,127,102,37,14,23,60
S01007990,Very good health,308,17,5,12,54,54,15,34,43,33,15,4,11,43
S01007990,Good health,241,7,2,5,34,30,7,33,54,47,15,8,7,14
S01007990,Fair health,93,4,0,4,15,9,8,7,24,18,6,1,5,2
S01007990,Bad health,18,0,0,0,2,0,1,5,4,4,1,1,0,1
S01007990,Very bad health,5,0,0,0,1,1,1,0,2,0,0,0,0,0
S01007991,All people aged 16 to 74,699,92,22,70,232,122,48,40,65,31,18,9,9,51
S01007991,Very good health,432,60,13,47,155,80,19,22,29,18,6,3,3,43
S01007991,Good health,210,27,8,19,60,34,20,14,30,10,8,3,5,7
S01007991,Fair health,45,4,0,4,14,5,6,4,6,2,3,2,1,1
S01007991,Bad health,10,0,0,0,2,3,3,0,0,1,1,1,0,0
S01007991,Very bad health,2,1,1,0,1,0,0,0,0,0,0,0,0,0
S01007992,All people aged 16 to 74,484,50,6,44,129,73,44,52,36,30,6,3,3,64
S01007992,Very good health,313,35,3,32,83,49,26,30,20,13,5,3,2,52
S01007992,Good health,144,15,3,12,40,19,15,19,14,11,1,0,1,10
S01007992,Fair health,20,0,0,0,6,4,1,2,2,4,0,0,0,1
S01007992,Bad health,4,0,0,0,0,0,1,0,0,2,0,0,0,1
S01007992,Very bad health,3,0,0,0,0,1,1,1,0,0,0,0,0,0
S01007993,All people aged 16 to 74,676,54,11,43,174,106,53,64,115,54,13,8,5,43
S01007993,Very good health,373,32,8,24,97,61,30,35,56,21,7,5,2,34
S01007993,Good health,223,18,3,15,56,33,13,22,47,25,1,0,1,8
S01007993,Fair health,62,4,0,4,17,9,8,5,9,7,3,2,1,0
S01007993,Bad health,15,0,0,0,3,1,2,2,3,1,2,1,1,1
S01007993,Very bad health,3,0,0,0,1,2,0,0,0,0,0,0,0,0
S01007994,All people aged 16 to 74,596,91,21,70,195,99,43,33,53,30,9,5,4,43
S01007994,Very good health,373,55,13,42,140,58,24,19,23,17,5,4,1,32
S01007994,Good health,184,34,8,26,47,32,13,13,23,9,3,0,3,10
S01007994,Fair health,24,2,0,2,4,5,4,1,4,2,1,1,0,1
S01007994,Bad health,12,0,0,0,3,3,1,0,3,2,0,0,0,0
S01007994,Very bad health,3,0,0,0,1,1,1,0,0,0,0,0,0,0
S01007995,All people aged 16 to 74,674,75,13,62,183,114,32,65,84,48,15,10,5,58
S01007995,Very good health,420,52,10,42,114,81,19,40,41,20,5,2,3,48
S01007995,Good health,185,17,3,14,55,23,9,18,27,20,7,6,1,9
S01007995,Fair health,50,4,0,4,9,8,4,4,13,4,3,2,1,1
S01007995,Bad health,15,2,0,2,4,1,0,2,2,4,0,0,0,0
S01007995,Very bad health,4,0,0,0,1,1,0,1,1,0,0,0,0,0
S01007996,All people aged 16 to 74,361,42,10,32,106,43,44,27,34,26,12,8,4,27
S01007996,Very good health,189,26,4,22,59,19,22,10,17,9,1,0,1,26
S01007996,Good health,133,15,6,9,42,21,17,11,12,9,5,3,2,1
S01007996,Fair health,27,1,0,1,4,3,3,3,4,5,4,3,1,0
S01007996,Bad health,9,0,0,0,1,0,1,2,1,2,2,2,0,0
S01007996,Very bad health,3,0,0,0,0,0,1,1,0,1,0,0,0,0
S01007997,All people aged 16 to 74,515,65,12,53,175,71,45,37,48,27,17,10,7,30
S01007997,Very good health,292,39,5,34,107,42,22,22,18,8,9,6,3,25
S01007997,Good health,164,16,4,12,52,25,16,12,23,14,3,1,2,3
S01007997,Fair health,50,9,2,7,12,4,7,2,5,5,4,2,2,2
S01007997,Bad health,9,1,1,0,4,0,0,1,2,0,1,1,0,0
S01007997,Very bad health,0,0,0,0,0,0,0,0,0,0,0,0,0,0
S01007998,All people aged 16 to 74,399,53,11,42,116,54,44,26,43,22,11,6,5,30
S01007998,Very good health,221,31,7,24,68,30,23,11,21,8,4,2,2,25
S01007998,Good health,124,16,4,12,31,20,18,12,9,9,4,1,3,5
S01007998,Fair health,38,6,0,6,10,3,2,3,10,3,1,1,0,0
S01007998,Bad health,13,0,0,0,5,1,1,0,3,2,1,1,0,0
S01007998,Very bad health,3,0,0,0,2,0,0,0,0,0,1,1,0,0
S01007999,All people aged 16 to 74,496,7,1,6,52,46,33,43,139,103,34,16,18,39
S01007999,Very good health,222,5,1,4,24,19,13,16,63,43,15,4,11,24
S01007999,Good health,164,2,0,2,19,16,11,16,49,31,6,3,3,14
S01007999,Fair health,77,0,0,0,6,8,6,8,21,18,9,6,3,1
S01007999,Bad health,27,0,0,0,3,3,2,3,4,9,3,2,1,0
S01007999,Very bad health,6,0,0,0,0,0,1,0,2,2,1,1,0,0
S01008000,All people aged 16 to 74,627,14,1,13,66,70,31,57,141,140,60,38,22,48
S01008000,Very good health,260,9,0,9,28,31,14,25,48,44,26,19,7,35
S01008000,Good health,224,3,1,2,26,28,9,21,57,50,19,9,10,11
S01008000,Fair health,82,2,0,2,7,6,5,6,20,27,7,3,4,2
S01008000,Bad health,50,0,0,0,5,4,2,4,12,15,8,7,1,0
S01008000,Very bad health,11,0,0,0,0,1,1,1,4,4,0,0,0,0
S01008001,All people aged 16 to 74,610,11,1,10,46,50,22,55,141,150,89,52,37,46
S01008001,Very good health,230,5,1,4,14,26,8,22,54,47,25,14,11,29
S01008001,Good health,214,6,0,6,15,17,10,14,55,49,34,18,16,14
S01008001,Fair health,111,0,0,0,12,4,3,11,23,38,17,12,5,3
S01008001,Bad health,40,0,0,0,5,2,1,4,6,12,10,5,5,0
S01008001,Very bad health,15,0,0,0,0,1,0,4,3,4,3,3,0,0
S01008002,All people aged 16 to 74,584,9,4,5,47,48,45,56,128,103,107,68,39,41
S01008002,Very good health,229,5,1,4,26,24,22,28,39,33,31,20,11,21
S01008002,Good health,199,2,2,0,15,13,14,15,54,32,40,17,23,14
S01008002,Fair health,96,2,1,1,4,7,4,9,20,23,22,18,4,5
S01008002,Bad health,45,0,0,0,2,2,3,4,13,10,10,10,0,1
S01008002,Very bad health,15,0,0,0,0,2,2,0,2,5,4,3,1,0
S01008003,All people aged 16 to 74,447,17,3,14,78,46,33,41,96,70,26,13,13,40
S01008003,Very good health,222,9,3,6,48,26,14,23,43,25,8,3,5,26
S01008003,Good health,132,6,0,6,22,14,13,10,29,18,11,5,6,9
S01008003,Fair health,63,2,0,2,6,4,5,7,15,16,5,4,1,3
S01008003,Bad health,21,0,0,0,1,1,1,1,8,6,1,0,1,2
S01008003,Very bad health,9,0,0,0,1,1,0,0,1,5,1,1,0,0
S01008004,All people aged 16 to 74,454,36,3,33,101,65,22,45,68,59,16,9,7,42
S01008004,Very good health,253,23,2,21,62,45,7,21,37,23,5,3,2,30
S01008004,Good health,139,8,1,7,31,17,12,15,20,20,6,2,4,10
S01008004,Fair health,48,4,0,4,7,3,3,9,8,8,4,3,1,2
S01008004,Bad health,10,1,0,1,0,0,0,0,3,6,0,0,0,0
S01008004,Very bad health,4,0,0,0,1,0,0,0,0,2,1,1,0,0
S01008005,All people aged 16 to 74,396,37,4,33,87,60,29,34,61,34,26,14,12,28
S01008005,Very good health,225,23,3,20,59,35,13,22,32,9,11,4,7,21
S01008005,Good health,134,12,1,11,23,21,12,10,23,18,9,5,4,6
S01008005,Fair health,30,2,0,2,5,3,3,2,5,5,4,3,1,1
S01008005,Bad health,6,0,0,0,0,1,1,0,1,2,1,1,0,0
S01008005,Very bad health,1,0,0,0,0,0,0,0,0,0,1,1,0,0
S01008006,All people aged 16 to 74,413,10,4,6,30,27,19,42,92,95,69,51,18,29
S01008006,Very good health,166,8,3,5,16,11,10,16,38,28,23,17,6,16
S01008006,Good health,135,0,0,0,11,8,6,17,26,29,26,17,9,12
S01008006,Fair health,57,1,1,0,2,5,2,5,15,17,10,7,3,0
S01008006,Bad health,38,1,0,1,1,2,1,2,10,13,8,8,0,0
S01008006,Very bad health,17,0,0,0,0,1,0,2,3,8,2,2,0,1
S01008007,All people aged 16 to 74,327,6,0,6,34,33,9,35,62,72,53,32,21,23
S01008007,Very good health,137,5,0,5,19,18,2,10,25,25,18,11,7,15
S01008007,Good health,98,1,0,1,13,11,3,10,22,23,11,5,6,4
S01008007,Fair health,54,0,0,0,2,2,4,8,7,13,14,7,7,4
S01008007,Bad health,34,0,0,0,0,2,0,6,8,9,9,8,1,0
S01008007,Very bad health,4,0,0,0,0,0,0,1,0,2,1,1,0,0
S01008008,All people aged 16 to 74,439,14,0,14,60,37,27,41,78,91,63,42,21,28
S01008008,Very good health,200,6,0,6,32,18,17,22,29,32,25,12,13,19
S01008008,Good health,144,6,0,6,22,9,7,11,31,31,20,13,7,7
S01008008,Fair health,60,1,0,1,5,7,2,4,12,17,11,10,1,1
S01008008,Bad health,24,1,0,1,1,1,1,4,3,8,5,5,0,0
S01008008,Very bad health,11,0,0,0,0,2,0,0,3,3,2,2,0,1
S01008009,All people aged 16 to 74,568,27,8,19,86,74,37,48,97,97,65,44,21,37
S01008009,Very good health,245,14,4,10,39,46,16,18,35,34,20,12,8,23
S01008009,Good health,192,11,4,7,35,14,13,17,39,28,27,17,10,8
S01008009,Fair health,74,1,0,1,5,7,4,9,14,18,12,10,2,4
S01008009,Bad health,45,1,0,1,7,5,2,3,6,15,5,4,1,1
S01008009,Very bad health,12,0,0,0,0,2,2,1,3,2,1,1,0,1
S01008010,All people aged 16 to 74,722,29,11,18,116,87,52,72,132,90,100,59,41,44
S01008010,Very good health,325,23,7,16,57,44,22,28,55,37,30,15,15,29
S01008010,Good health,251,3,1,2,44,33,21,34,51,22,31,18,13,12
S01008010,Fair health,88,2,2,0,11,6,2,6,17,18,23,14,9,3
S01008010,Bad health,44,1,1,0,4,2,7,3,6,8,13,9,4,0
S01008010,Very bad health,14,0,0,0,0,2,0,1,3,5,3,3,0,0
S01008011,All people aged 16 to 74,477,15,1,14,87,51,22,33,95,97,60,36,24,17
S01008011,Very good health,178,5,0,5,45,26,10,13,32,25,12,5,7,10
S01008011,Good health,154,8,1,7,26,16,9,15,24,26,25,13,12,5
S01008011,Fair health,94,1,0,1,8,7,2,3,29,28,14,11,3,2
S01008011,Bad health,35,1,0,1,6,1,1,2,7,11,6,4,2,0
S01008011,Very bad health,16,0,0,0,2,1,0,0,3,7,3,3,0,0
S01008012,All people aged 16 to 74,646,40,8,32,138,90,46,57,97,83,42,26,16,53
S01008012,Very good health,300,23,5,18,85,46,20,25,31,27,8,4,4,35
S01008012,Good health,233,15,3,12,39,29,23,21,36,34,21,14,7,15
S01008012,Fair health,82,1,0,1,12,14,2,7,23,13,8,5,3,2
S01008012,Bad health,28,1,0,1,2,1,1,4,6,8,4,2,2,1
S01008012,Very bad health,3,0,0,0,0,0,0,0,1,1,1,1,0,0
S01008013,All people aged 16 to 74,470,40,9,31,90,83,39,34,70,71,19,12,7,24
S01008013,Very good health,211,19,3,16,52,40,19,14,21,19,6,4,2,21
S01008013,Good health,161,18,4,14,28,30,13,14,25,25,6,2,4,2
S01008013,Fair health,63,2,2,0,8,13,3,4,16,13,3,3,0,1
S01008013,Bad health,29,1,0,1,0,0,3,1,8,13,3,2,1,0
S01008013,Very bad health,6,0,0,0,2,0,1,1,0,1,1,1,0,0
S01008014,All people aged 16 to 74,487,40,9,31,123,62,36,46,70,60,16,11,5,34
S01008014,Very good health,256,26,6,20,70,35,16,22,28,26,6,3,3,27
S01008014,Good health,157,12,3,9,40,18,12,18,29,17,5,4,1,6
S01008014,Fair health,52,1,0,1,12,7,5,4,10,10,2,1,1,1
S01008014,Bad health,15,1,0,1,1,2,2,1,1,6,1,1,0,0
S01008014,Very bad health,7,0,0,0,0,0,1,1,2,1,2,2,0,0
S01008015,All people aged 16 to 74,585,25,1,24,102,82,26,70,113,99,39,20,19,29
S01008015,Very good health,255,14,1,13,56,45,9,23,38,35,14,7,7,21
S01008015,Good health,210,9,0,9,29,26,9,30,47,41,14,4,10,5
S01008015,Fair health,76,2,0,2,11,8,4,11,18,15,5,5,0,2
S01008015,Bad health,35,0,0,0,3,2,3,5,9,7,5,3,2,1
S01008015,Very bad health,9,0,0,0,3,1,1,1,1,1,1,1,0,0
S01008016,All people aged 16 to 74,587,23,3,20,101,84,52,59,114,88,40,23,17,26
S01008016,Very good health,240,15,2,13,47,42,12,22,50,25,10,5,5,17
S01008016,Good health,204,5,0,5,35,27,20,22,34,34,20,9,11,7
S01008016,Fair health,93,2,0,2,15,8,14,8,23,18,4,3,1,1
S01008016,Bad health,35,1,1,0,4,5,3,5,6,10,0,0,0,1
S01008016,Very bad health,15,0,0,0,0,2,3,2,1,1,6,6,0,0
S01008017,All people aged 16 to 74,638,76,19,57,204,100,43,41,68,34,14,7,7,58
S01008017,Very good health,358,43,13,30,117,46,25,19,34,14,9,4,5,51
S01008017,Good health,205,26,5,21,64,40,13,13,25,16,2,0,2,6
S01008017,Fair health,63,6,1,5,18,13,5,7,9,2,2,2,0,1
S01008017,Bad health,11,1,0,1,4,1,0,2,0,2,1,1,0,0
S01008017,Very bad health,1,0,0,0,1,0,0,0,0,0,0,0,0,0
S01008018,All people aged 16 to 74,489,59,16,43,141,78,39,33,64,35,3,2,1,37
S01008018,Very good health,270,35,7,28,87,40,17,18,33,12,2,1,1,26
S01008018,Good health,172,21,9,12,43,30,15,11,25,16,1,1,0,10
S01008018,Fair health,38,3,0,3,10,6,6,4,5,4,0,0,0,0
S01008018,Bad health,7,0,0,0,1,1,1,0,1,2,0,0,0,1
S01008018,Very bad health,2,0,0,0,0,1,0,0,0,1,0,0,0,0
S01008019,All people aged 16 to 74,537,79,11,68,168,59,39,32,68,37,10,7,3,45
S01008019,Very good health,356,56,9,47,116,33,26,18,41,17,7,5,2,42
S01008019,Good health,140,18,2,16,44,22,11,7,20,15,1,1,0,2
S01008019,Fair health,31,5,0,5,8,2,1,4,5,4,1,0,1,1
S01008019,Bad health,7,0,0,0,0,2,1,2,2,0,0,0,0,0
S01008019,Very bad health,3,0,0,0,0,0,0,1,0,1,1,1,0,0
S01008020,All people aged 16 to 74,475,39,8,31,108,88,40,47,56,50,8,5,3,39
S01008020,Very good health,279,28,6,22,71,53,22,21,27,21,2,1,1,34
S01008020,Good health,138,7,0,7,30,20,13,18,21,22,4,2,2,3
S01008020,Fair health,42,1,1,0,5,12,3,7,6,5,1,1,0,2
S01008020,Bad health,9,2,1,1,0,2,1,0,1,2,1,1,0,0
S01008020,Very bad health,7,1,0,1,2,1,1,1,1,0,0,0,0,0
S01008021,All people aged 16 to 74,426,53,14,39,132,68,39,26,51,16,9,4,5,32
S01008021,Very good health,240,37,9,28,73,44,19,13,21,5,4,1,3,24
S01008021,Good health,141,12,5,7,40,20,16,11,25,4,5,3,2,8
S01008021,Fair health,37,4,0,4,15,3,3,1,5,6,0,0,0,0
S01008021,Bad health,7,0,0,0,4,1,1,1,0,0,0,0,0,0
S01008021,Very bad health,1,0,0,0,0,0,0,0,0,1,0,0,0,0
S01008022,All people aged 16 to 74,550,54,16,38,180,78,49,40,61,30,8,5,3,50
S01008022,Very good health,309,30,5,25,113,41,21,17,32,10,4,2,2,41
S01008022,Good health,180,19,7,12,50,30,21,16,21,13,1,1,0,9
S01008022,Fair health,46,4,3,1,12,5,5,6,7,5,2,1,1,0
S01008022,Bad health,13,1,1,0,5,1,2,1,1,1,1,1,0,0
S01008022,Very bad health,2,0,0,0,0,1,0,0,0,1,0,0,0,0
S01008023,All people aged 16 to 74,529,72,16,56,142,77,43,46,66,18,8,3,5,57
S01008023,Very good health,319,47,11,36,88,45,24,20,36,8,2,1,1,49
S01008023,Good health,176,20,4,16,47,28,15,21,25,8,4,0,4,8
S01008023,Fair health,27,4,1,3,5,1,4,4,5,2,2,2,0,0
S01008023,Bad health,6,1,0,1,1,3,0,1,0,0,0,0,0,0
S01008023,Very bad health,1,0,0,0,1,0,0,0,0,0,0,0,0,0
S01008024,All people aged 16 to 74,477,90,16,74,174,63,36,31,32,17,5,3,2,29
S01008024,Very good health,344,70,13,57,127,42,23,23,22,10,5,3,2,22
S01008024,Good health,109,18,3,15,38,18,10,7,8,4,0,0,0,6
S01008024,Fair health,19,1,0,1,7,3,3,1,2,1,0,0,0,1
S01008024,Bad health,3,1,0,1,1,0,0,0,0,1,0,0,0,0
S01008024,Very bad health,2,0,0,0,1,0,0,0,0,1,0,0,0,0
S01008025,All people aged 16 to 74,565,36,6,30,120,109,40,60,79,69,17,13,4,35
S01008025,Very good health,266,16,1,15,64,54,15,21,35,30,4,3,1,27
S01008025,Good health,191,14,4,10,31,30,17,31,33,25,4,3,1,6
S01008025,Fair health,77,4,1,3,19,19,4,6,7,12,5,3,2,1
S01008025,Bad health,20,1,0,1,4,6,2,2,2,2,0,0,0,1
S01008025,Very bad health,11,1,0,1,2,0,2,0,2,0,4,4,0,0
S01008026,All people aged 16 to 74,761,38,10,28,134,101,53,76,141,137,42,25,17,39
S01008026,Very good health,317,23,7,16,65,43,22,39,49,38,10,6,4,28
S01008026,Good health,275,12,2,10,48,39,20,18,54,56,20,14,6,8
S01008026,Fair health,115,3,1,2,15,14,9,15,19,29,8,3,5,3
S01008026,Bad health,41,0,0,0,5,5,2,3,13,11,2,1,1,0
S01008026,Very bad health,13,0,0,0,1,0,0,1,6,3,2,1,1,0
S01008027,All people aged 16 to 74,433,21,2,19,78,75,10,50,59,88,22,11,11,30
S01008027,Very good health,190,14,2,12,44,33,5,24,21,25,4,3,1,20
S01008027,Good health,148,6,0,6,20,23,1,18,24,37,13,6,7,6
S01008027,Fair health,68,0,0,0,12,14,4,7,9,16,3,1,2,3
S01008027,Bad health,22,1,0,1,2,4,0,0,5,8,1,0,1,1
S01008027,Very bad health,5,0,0,0,0,1,0,1,0,2,1,1,0,0
S01008028,All people aged 16 to 74,439,23,5,18,91,66,39,46,72,61,13,9,4,28
S01008028,Very good health,239,20,4,16,45,45,15,23,36,26,9,5,4,20
S01008028,Good health,143,3,1,2,37,16,20,14,24,18,3,3,0,8
S01008028,Fair health,38,0,0,0,5,4,4,8,8,8,1,1,0,0
S01008028,Bad health,16,0,0,0,4,0,0,1,3,8,0,0,0,0
S01008028,Very bad health,3,0,0,0,0,1,0,0,1,1,0,0,0,0
S01008029,All people aged 16 to 74,675,65,6,59,145,78,103,44,101,56,39,31,8,44
S01008029,Very good health,335,39,5,34,89,41,47,19,36,21,9,8,1,34
S01008029,Good health,226,22,1,21,41,26,36,17,43,20,13,10,3,8
S01008029,Fair health,72,3,0,3,9,9,11,7,13,7,11,7,4,2
S01008029,Bad health,30,1,0,1,3,1,8,1,8,3,5,5,0,0
S01008029,Very bad health,12,0,0,0,3,1,1,0,1,5,1,1,0,0
S01008030,All people aged 16 to 74,811,70,11,59,234,111,83,59,88,92,16,10,6,58
S01008030,Very good health,422,43,8,35,139,47,40,28,40,32,3,2,1,50
S01008030,Good health,244,16,3,13,73,43,24,17,27,30,8,4,4,6
S01008030,Fair health,111,9,0,9,18,18,15,10,15,22,2,1,1,2
S01008030,Bad health,28,1,0,1,4,3,3,3,5,6,3,3,0,0
S01008030,Very bad health,6,1,0,1,0,0,1,1,1,2,0,0,0,0
S01008031,All people aged 16 to 74,662,43,6,37,107,93,46,59,123,107,39,23,16,45
S01008031,Very good health,297,30,5,25,57,49,21,27,41,30,8,4,4,34
S01008031,Good health,232,9,1,8,39,29,14,19,54,43,17,11,6,8
S01008031,Fair health,97,4,0,4,9,13,5,10,20,21,12,6,6,3
S01008031,Bad health,24,0,0,0,1,2,2,1,7,10,1,1,0,0
S01008031,Very bad health,12,0,0,0,1,0,4,2,1,3,1,1,0,0
S01008032,All people aged 16 to 74,691,34,9,25,126,104,49,67,112,127,18,9,9,54
S01008032,Very good health,292,16,6,10,68,36,19,23,42,37,7,3,4,44
S01008032,Good health,260,14,2,12,38,50,20,28,48,47,7,3,4,8
S01008032,Fair health,100,3,1,2,15,13,9,11,15,31,2,2,0,1
S01008032,Bad health,29,1,0,1,3,4,0,3,7,8,2,1,1,1
S01008032,Very bad health,10,0,0,0,2,1,1,2,0,4,0,0,0,0
S01008033,All people aged 16 to 74,600,121,24,97,179,70,53,28,37,23,7,3,4,82
S01008033,Very good health,417,81,15,66,121,48,32,19,26,12,3,1,2,75
S01008033,Good health,144,33,7,26,49,19,15,7,9,6,2,2,0,4
S01008033,Fair health,37,7,2,5,9,3,5,2,2,4,2,0,2,3
S01008033,Bad health,1,0,0,0,0,0,0,0,0,1,0,0,0,0
S01008033,Very bad health,1,0,0,0,0,0,1,0,0,0,0,0,0,0
S01008034,All people aged 16 to 74,578,122,22,100,177,72,57,20,35,14,9,7,2,72
S01008034,Very good health,390,88,18,70,114,47,37,10,20,6,2,2,0,66
S01008034,Good health,142,28,3,25,46,21,13,9,9,7,4,3,1,5
S01008034,Fair health,36,4,1,3,16,3,6,1,3,0,2,1,1,1
S01008034,Bad health,9,2,0,2,1,1,1,0,2,1,1,1,0,0
S01008034,Very bad health,1,0,0,0,0,0,0,0,1,0,0,0,0,0
S01008035,All people aged 16 to 74,485,65,15,50,133,109,29,33,39,21,15,9,6,41
S01008035,Very good health,277,44,9,35,73,58,17,16,20,5,9,5,4,35
S01008035,Good health,156,17,4,13,51,37,10,13,14,10,1,0,1,3
S01008035,Fair health,38,4,2,2,7,11,1,3,5,2,2,1,1,3
S01008035,Bad health,10,0,0,0,2,3,1,0,0,2,2,2,0,0
S01008035,Very bad health,4,0,0,0,0,0,0,1,0,2,1,1,0,0
S01008036,All people aged 16 to 74,515,70,10,60,161,74,35,31,57,25,13,8,5,49
S01008036,Very good health,297,43,7,36,98,30,19,21,32,7,4,2,2,43
S01008036,Good health,170,24,2,22,49,36,12,7,19,13,4,3,1,6
S01008036,Fair health,36,3,1,2,11,7,3,1,5,3,3,1,2,0
S01008036,Bad health,11,0,0,0,3,1,1,2,1,2,1,1,0,0
S01008036,Very bad health,1,0,0,0,0,0,0,0,0,0,1,1,0,0
S01008037,All people aged 16 to 74,752,46,7,39,141,100,56,76,169,85,19,7,12,60
S01008037,Very good health,315,20,1,19,64,41,28,26,59,30,8,2,6,39
S01008037,Good health,255,21,6,15,52,34,15,21,64,26,7,3,4,15
S01008037,Fair health,126,5,0,5,19,18,9,16,35,14,4,2,2,6
S01008037,Bad health,44,0,0,0,4,6,3,11,9,11,0,0,0,0
S01008037,Very bad health,12,0,0,0,2,1,1,2,2,4,0,0,0,0
S01008038,All people aged 16 to 74,530,33,4,29,95,73,42,52,103,72,21,10,11,39
S01008038,Very good health,248,15,1,14,51,28,18,24,45,33,7,2,5,27
S01008038,Good health,179,15,3,12,32,32,17,18,31,14,9,5,4,11
S01008038,Fair health,68,3,0,3,7,4,5,7,20,18,3,2,1,1
S01008038,Bad health,29,0,0,0,4,8,2,2,7,5,1,1,0,0
S01008038,Very bad health,6,0,0,0,1,1,0,1,0,2,1,0,1,0
S01008039,All people aged 16 to 74,656,49,12,37,146,77,46,61,121,64,17,7,10,75
S01008039,Very good health,326,25,7,18,84,41,21,22,53,21,10,4,6,49
S01008039,Good health,208,19,4,15,45,22,17,23,36,21,5,3,2,20
S01008039,Fair health,88,4,0,4,13,11,5,11,24,13,2,0,2,5
S01008039,Bad health,26,0,0,0,3,2,0,4,8,8,0,0,0,1
S01008039,Very bad health,8,1,1,0,1,1,3,1,0,1,0,0,0,0
S01008040,All people aged 16 to 74,568,100,16,84,154,85,48,29,61,31,10,4,6,50
S01008040,Very good health,326,67,8,59,90,44,27,12,24,18,3,0,3,41
S01008040,Good health,164,27,7,20,48,27,10,14,23,5,4,2,2,6
S01008040,Fair health,56,4,1,3,16,10,8,1,9,2,3,2,1,3
S01008040,Bad health,17,2,0,2,0,4,2,2,3,4,0,0,0,0
S01008040,Very bad health,5,0,0,0,0,0,1,0,2,2,0,0,0,0
S01008041,All people aged 16 to 74,485,85,12,73,140,70,34,26,56,31,9,5,4,34
S01008041,Very good health,241,50,5,45,85,29,14,10,15,11,4,2,2,23
S01008041,Good health,164,27,7,20,40,24,16,8,29,8,2,2,0,10
S01008041,Fair health,54,8,0,8,11,12,4,5,6,4,3,1,2,1
S01008041,Bad health,20,0,0,0,3,4,0,1,4,8,0,0,0,0
S01008041,Very bad health,6,0,0,0,1,1,0,2,2,0,0,0,0,0
S01008042,All people aged 16 to 74,397,102,10,92,127,46,32,8,33,11,7,4,3,31
S01008042,Very good health,245,66,6,60,87,24,19,4,13,4,2,0,2,26
S01008042,Good health,113,28,3,25,31,16,11,4,11,5,2,1,1,5
S01008042,Fair health,31,8,1,7,6,5,2,0,6,2,2,2,0,0
S01008042,Bad health,5,0,0,0,3,0,0,0,1,0,1,1,0,0
S01008042,Very bad health,3,0,0,0,0,1,0,0,2,0,0,0,0,0
S01008043,All people aged 16 to 74,640,163,19,144,200,74,79,16,37,17,9,6,3,45
S01008043,Very good health,411,111,15,96,131,43,40,11,20,7,5,4,1,43
S01008043,Good health,169,38,3,35,51,22,31,4,14,7,1,1,0,1
S01008043,Fair health,46,11,1,10,14,7,7,1,2,2,2,1,1,0
S01008043,Bad health,11,2,0,2,3,2,0,0,1,1,1,0,1,1
S01008043,Very bad health,3,1,0,1,1,0,1,0,0,0,0,0,0,0
S01008044,All people aged 16 to 74,686,139,20,119,238,78,52,30,58,15,9,7,2,67
S01008044,Very good health,444,90,10,80,159,48,30,19,32,6,4,2,2,56
S01008044,Good health,185,44,10,34,57,26,17,10,13,8,4,4,0,6
S01008044,Fair health,44,5,0,5,17,3,4,1,8,1,0,0,0,5
S01008044,Bad health,6,0,0,0,3,0,1,0,2,0,0,0,0,0
S01008044,Very bad health,7,0,0,0,2,1,0,0,3,0,1,1,0,0
S01008045,All people aged 16 to 74,698,146,13,133,197,82,79,34,48,34,30,19,11,48
S01008045,Very good health,374,98,8,90,112,42,31,12,15,13,9,5,4,42
S01008045,Good health,245,37,5,32,69,29,39,16,25,10,15,11,4,5
S01008045,Fair health,60,9,0,9,11,9,6,5,8,6,5,3,2,1
S01008045,Bad health,15,2,0,2,3,2,2,1,0,4,1,0,1,0
S01008045,Very bad health,4,0,0,0,2,0,1,0,0,1,0,0,0,0
S01008046,All people aged 16 to 74,549,64,14,50,124,88,22,37,81,60,45,31,14,28
S01008046,Very good health,202,35,7,28,49,33,9,13,23,16,6,4,2,18
S01008046,Good health,201,18,4,14,50,32,9,12,29,20,23,13,10,8
S01008046,Fair health,105,9,2,7,17,14,4,9,21,17,12,11,1,2
S01008046,Bad health,31,1,1,0,7,7,0,2,4,7,3,2,1,0
S01008046,Very bad health,10,1,0,1,1,2,0,1,4,0,1,1,0,0
S01008047,All people aged 16 to 74,489,94,8,86,142,71,46,20,38,18,8,5,3,52
S01008047,Very good health,304,62,5,57,92,38,22,13,17,9,4,2,2,47
S01008047,Good health,140,25,1,24,43,25,16,5,14,5,2,2,0,5
S01008047,Fair health,32,5,2,3,4,8,5,0,4,4,2,1,1,0
S01008047,Bad health,11,2,0,2,2,0,3,2,2,0,0,0,0,0
S01008047,Very bad health,2,0,0,0,1,0,0,0,1,0,0,0,0,0
S01008048,All people aged 16 to 74,425,77,17,60,135,68,25,19,35,13,11,7,4,42
S01008048,Very good health,234,41,9,32,66,41,12,10,18,5,2,2,0,39
S01008048,Good health,151,28,8,20,56,21,11,5,14,5,9,5,4,2
S01008048,Fair health,36,8,0,8,12,5,2,3,3,2,0,0,0,1
S01008048,Bad health,4,0,0,0,1,1,0,1,0,1,0,0,0,0
S01008048,Very bad health,0,0,0,0,0,0,0,0,0,0,0,0,0,0
S01008049,All people aged 16 to 74,596,112,17,95,203,110,51,19,34,14,7,3,4,46
S01008049,Very good health,327,60,9,51,110,53,25,10,17,8,4,2,2,40
S01008049,Good health,216,44,8,36,73,47,18,6,15,5,3,1,2,5
S01008049,Fair health,44,6,0,6,17,8,6,3,2,1,0,0,0,1
S01008049,Bad health,8,1,0,1,3,2,2,0,0,0,0,0,0,0
S01008049,Very bad health,1,1,0,1,0,0,0,0,0,0,0,0,0,0
S01008050,All people aged 16 to 74,437,108,23,85,130,69,36,6,15,15,14,10,4,44
S01008050,Very good health,250,60,12,48,81,32,14,3,7,7,7,4,3,39
S01008050,Good health,137,37,9,28,37,30,16,2,5,4,1,1,0,5
S01008050,Fair health,39,10,1,9,10,5,4,0,3,3,4,3,1,0
S01008050,Bad health,9,1,1,0,2,1,1,1,0,1,2,2,0,0
S01008050,Very bad health,2,0,0,0,0,1,1,0,0,0,0,0,0,0
S01008051,All people aged 16 to 74,619,148,25,123,196,92,30,29,38,21,13,11,2,52
S01008051,Very good health,393,107,14,93,121,48,16,16,21,12,6,5,1,46
S01008051,Good health,182,34,9,25,61,34,13,11,14,7,2,2,0,6
S01008051,Fair health,35,6,2,4,12,7,1,1,2,1,5,4,1,0
S01008051,Bad health,7,1,0,1,1,2,0,1,1,1,0,0,0,0
S01008051,Very bad health,2,0,0,0,1,1,0,0,0,0,0,0,0,0
S01008052,All people aged 16 to 74,602,161,21,140,219,73,38,11,34,13,9,7,2,44
S01008052,Very good health,383,107,15,92,140,49,23,5,18,4,3,1,2,34
S01008052,Good health,176,40,4,36,64,20,14,3,13,8,5,5,0,9
S01008052,Fair health,35,14,2,12,12,3,1,2,2,1,0,0,0,0
S01008052,Bad health,7,0,0,0,3,1,0,1,1,0,0,0,0,1
S01008052,Very bad health,1,0,0,0,0,0,0,0,0,0,1,1,0,0
S01008053,All people aged 16 to 74,419,97,10,87,152,54,30,10,22,19,1,0,1,34
S01008053,Very good health,240,67,8,59,82,18,20,6,9,8,1,0,1,29
S01008053,Good health,132,24,1,23,48,29,7,2,10,8,0,0,0,4
S01008053,Fair health,33,5,1,4,18,4,2,1,1,1,0,0,0,1
S01008053,Bad health,10,1,0,1,4,3,0,1,0,1,0,0,0,0
S01008053,Very bad health,4,0,0,0,0,0,1,0,2,1,0,0,0,0
S01008054,All people aged 16 to 74,528,129,24,105,164,63,50,17,24,20,10,5,5,51
S01008054,Very good health,338,88,16,72,116,35,26,8,7,8,4,2,2,46
S01008054,Good health,128,26,7,19,36,20,17,8,9,3,4,2,2,5
S01008054,Fair health,38,9,0,9,10,4,6,0,3,5,1,0,1,0
S01008054,Bad health,18,5,1,4,1,2,1,1,5,3,0,0,0,0
S01008054,Very bad health,6,1,0,1,1,2,0,0,0,1,1,1,0,0
S01008055,All people aged 16 to 74,748,208,33,175,250,82,47,17,38,10,13,10,3,83
S01008055,Very good health,505,143,24,119,166,50,23,10,24,7,9,7,2,73
S01008055,Good health,199,56,9,47,65,27,19,6,11,2,4,3,1,9
S01008055,Fair health,36,7,0,7,19,3,4,1,1,1,0,0,0,0
S01008055,Bad health,7,2,0,2,0,2,1,0,2,0,0,0,0,0
S01008055,Very bad health,1,0,0,0,0,0,0,0,0,0,0,0,0,1
S01008056,All people aged 16 to 74,494,130,14,116,141,55,35,21,36,14,6,4,2,56
S01008056,Very good health,304,92,10,82,77,33,13,9,20,7,4,2,2,49
S01008056,Good health,135,25,3,22,41,17,21,9,11,5,1,1,0,5
S01008056,Fair health,42,10,1,9,19,3,1,3,4,1,0,0,0,1
S01008056,Bad health,10,0,0,0,4,2,0,0,1,1,1,1,0,1
S01008056,Very bad health,3,3,0,3,0,0,0,0,0,0,0,0,0,0
S01008057,All people aged 16 to 74,637,145,25,120,215,88,54,17,41,11,6,5,1,60
S01008057,Very good health,395,90,19,71,132,48,34,9,21,7,2,1,1,52
S01008057,Good health,183,42,6,36,60,34,18,5,14,2,3,3,0,5
S01008057,Fair health,47,11,0,11,18,5,2,1,4,2,1,1,0,3
S01008057,Bad health,9,1,0,1,4,1,0,2,1,0,0,0,0,0
S01008057,Very bad health,3,1,0,1,1,0,0,0,1,0,0,0,0,0
S01008058,All people aged 16 to 74,695,170,24,146,191,65,82,18,59,14,15,10,5,81
S01008058,Very good health,462,113,13,100,117,48,42,14,38,11,7,5,2,72
S01008058,Good health,186,45,10,35,63,10,33,3,18,1,5,3,2,8
S01008058,Fair health,35,10,1,9,6,5,6,1,2,1,3,2,1,1
S01008058,Bad health,10,1,0,1,5,2,1,0,0,1,0,0,0,0
S01008058,Very bad health,2,1,0,1,0,0,0,0,1,0,0,0,0,0
S01008059,All people aged 16 to 74,527,78,7,71,159,91,47,24,40,21,9,8,1,58
S01008059,Very good health,308,46,2,44,90,52,24,11,23,9,2,2,0,51
S01008059,Good health,171,28,4,24,56,30,13,12,14,6,5,5,0,7
S01008059,Fair health,37,4,1,3,11,7,7,1,3,3,1,0,1,0
S01008059,Bad health,7,0,0,0,1,2,2,0,0,1,1,1,0,0
S01008059,Very bad health,4,0,0,0,1,0,1,0,0,2,0,0,0,0
S01008060,All people aged 16 to 74,696,116,20,96,196,132,50,31,54,26,14,8,6,77
S01008060,Very good health,435,74,15,59,115,72,36,17,29,17,8,4,4,67
S01008060,Good health,205,35,4,31,64,47,11,12,16,7,3,1,2,10
S01008060,Fair health,44,5,1,4,14,12,3,1,8,0,1,1,0,0
S01008060,Bad health,10,2,0,2,2,1,0,1,1,1,2,2,0,0
S01008060,Very bad health,2,0,0,0,1,0,0,0,0,1,0,0,0,0
S01008061,All people aged 16 to 74,495,80,12,68,149,81,40,24,46,19,12,8,4,44
S01008061,Very good health,290,56,6,50,97,38,14,14,20,8,5,4,1,38
S01008061,Good health,163,18,2,16,40,34,23,10,21,8,3,2,1,6
S01008061,Fair health,34,5,4,1,10,7,2,0,4,2,4,2,2,0
S01008061,Bad health,7,0,0,0,2,2,1,0,1,1,0,0,0,0
S01008061,Very bad health,1,1,0,1,0,0,0,0,0,0,0,0,0,0
S01008062,All people aged 16 to 74,638,69,11,58,189,140,44,51,67,33,8,5,3,37
S01008062,Very good health,352,43,4,39,114,59,23,25,35,17,6,3,3,30
S01008062,Good health,203,19,3,16,51,65,16,15,22,9,1,1,0,5
S01008062,Fair health,60,6,3,3,21,10,4,6,7,4,1,1,0,1
S01008062,Bad health,18,1,1,0,1,5,1,5,1,3,0,0,0,1
S01008062,Very bad health,5,0,0,0,2,1,0,0,2,0,0,0,0,0
S01008063,All people aged 16 to 74,655,128,16,112,195,104,47,29,60,7,14,10,4,71
S01008063,Very good health,404,86,8,78,114,56,28,16,33,5,6,5,1,60
S01008063,Good health,200,36,6,30,63,38,13,12,21,1,6,4,2,10
S01008063,Fair health,46,5,1,4,17,8,5,1,6,1,2,1,1,1
S01008063,Bad health,3,1,1,0,1,1,0,0,0,0,0,0,0,0
S01008063,Very bad health,2,0,0,0,0,1,1,0,0,0,0,0,0,0
S01008064,All people aged 16 to 74,522,41,3,38,106,79,32,40,79,51,39,24,15,55
S01008064,Very good health,247,22,2,20,56,42,10,18,35,17,9,6,3,38
S01008064,Good health,189,14,0,14,38,27,11,14,28,24,21,10,11,12
S01008064,Fair health,58,4,1,3,9,8,6,6,11,5,7,6,1,2
S01008064,Bad health,17,1,0,1,3,2,3,2,2,2,1,1,0,1
S01008064,Very bad health,11,0,0,0,0,0,2,0,3,3,1,1,0,2
S01008065,All people aged 16 to 74,720,173,25,148,232,87,45,22,45,22,12,7,5,82
S01008065,Very good health,470,112,19,93,152,47,23,15,34,11,5,3,2,71
S01008065,Good health,192,49,4,45,67,26,13,5,8,10,5,2,3,9
S01008065,Fair health,40,8,2,6,10,9,7,1,2,0,1,1,0,2
S01008065,Bad health,12,4,0,4,2,2,2,1,0,1,0,0,0,0
S01008065,Very bad health,6,0,0,0,1,3,0,0,1,0,1,1,0,0
S01008066,All people aged 16 to 74,659,225,28,197,191,43,54,9,31,10,15,7,8,81
S01008066,Very good health,456,159,21,138,125,29,33,4,22,7,7,2,5,70
S01008066,Good health,159,57,7,50,51,11,16,4,8,1,3,1,2,8
S01008066,Fair health,30,3,0,3,14,2,4,0,0,2,4,3,1,1
S01008066,Bad health,13,6,0,6,1,1,1,1,1,0,0,0,0,2
S01008066,Very bad health,1,0,0,0,0,0,0,0,0,0,1,1,0,0
S01008067,All people aged 16 to 74,466,131,13,118,140,44,32,16,34,14,5,5,0,50
S01008067,Very good health,285,79,5,74,90,26,18,7,16,6,2,2,0,41
S01008067,Good health,133,38,2,36,40,10,10,6,16,6,2,2,0,5
S01008067,Fair health,38,11,5,6,8,5,4,3,2,1,1,1,0,3
S01008067,Bad health,10,3,1,2,2,3,0,0,0,1,0,0,0,1
S01008067,Very bad health,0,0,0,0,0,0,0,0,0,0,0,0,0,0
S01008068,All people aged 16 to 74,701,122,23,99,209,101,56,42,64,41,9,8,1,57
S01008068,Very good health,428,85,17,68,131,54,32,21,34,19,0,0,0,52
S01008068,Good health,189,30,4,26,55,34,15,14,19,12,5,4,1,5
S01008068,Fair health,64,7,2,5,20,10,8,4,7,6,2,2,0,0
S01008068,Bad health,15,0,0,0,2,1,1,2,4,3,2,2,0,0
S01008068,Very bad health,5,0,0,0,1,2,0,1,0,1,0,0,0,0
S01008069,All people aged 16 to 74,699,62,9,53,187,141,46,47,90,54,17,8,9,55
S01008069,Very good health,387,35,7,28,115,74,21,26,41,22,6,3,3,47
S01008069,Good health,212,20,1,19,52,46,18,13,32,18,6,2,4,7
S01008069,Fair health,70,3,0,3,15,16,4,8,8,12,4,2,2,0
S01008069,Bad health,24,4,1,3,5,4,2,0,6,1,1,1,0,1
S01008069,Very bad health,6,0,0,0,0,1,1,0,3,1,0,0,0,0
S01008070,All people aged 16 to 74,686,49,11,38,170,147,40,55,102,47,15,4,11,61
S01008070,Very good health,362,24,4,20,97,78,19,24,48,16,7,1,6,49
S01008070,Good health,233,20,7,13,53,48,18,23,44,13,4,1,3,10
S01008070,Fair health,66,4,0,4,13,18,2,5,9,11,3,2,1,1
S01008070,Bad health,16,1,0,1,4,3,1,1,1,3,1,0,1,1
S01008070,Very bad health,9,0,0,0,3,0,0,2,0,4,0,0,0,0
S01008071,All people aged 16 to 74,518,65,8,57,171,84,35,39,41,25,9,6,3,49
S01008071,Very good health,318,45,7,38,107,45,20,15,27,13,3,1,2,43
S01008071,Good health,143,16,1,15,47,26,9,19,10,7,4,3,1,5
S01008071,Fair health,33,4,0,4,8,7,4,3,2,3,1,1,0,1
S01008071,Bad health,19,0,0,0,6,5,1,2,2,2,1,1,0,0
S01008071,Very bad health,5,0,0,0,3,1,1,0,0,0,0,0,0,0
S01008072,All people aged 16 to 74,603,150,22,128,202,69,44,20,31,16,14,8,6,57
S01008072,Very good health,372,104,18,86,122,40,25,10,16,9,7,3,4,39
S01008072,Good health,190,35,4,31,73,24,13,7,12,4,4,2,2,18
S01008072,Fair health,26,7,0,7,6,3,4,2,3,0,1,1,0,0
S01008072,Bad health,10,3,0,3,1,1,2,0,0,1,2,2,0,0
S01008072,Very bad health,5,1,0,1,0,1,0,1,0,2,0,0,0,0
S01008073,All people aged 16 to 74,345,109,17,92,100,31,34,8,16,10,6,5,1,31
S01008073,Very good health,233,78,16,62,70,20,16,4,6,7,3,2,1,29
S01008073,Good health,80,24,1,23,23,9,12,3,6,1,1,1,0,1
S01008073,Fair health,27,7,0,7,7,2,5,1,3,2,0,0,0,0
S01008073,Bad health,5,0,0,0,0,0,1,0,1,0,2,2,0,1
S01008073,Very bad health,0,0,0,0,0,0,0,0,0,0,0,0,0,0
S01008074,All people aged 16 to 74,719,154,23,131,228,102,60,27,48,14,13,11,2,73
S01008074,Very good health,420,100,18,82,126,56,35,11,24,4,6,6,0,58
S01008074,Good health,235,41,5,36,77,39,22,12,20,9,3,2,1,12
S01008074,Fair health,45,10,0,10,21,4,2,3,1,0,3,2,1,1
S01008074,Bad health,17,3,0,3,4,3,1,1,2,0,1,1,0,2
S01008074,Very bad health,2,0,0,0,0,0,0,0,1,1,0,0,0,0
S01008075,All people aged 16 to 74,401,94,9,85,123,60,37,7,19,9,8,6,2,44
S01008075,Very good health,253,51,4,47,80,38,24,3,13,3,3,1,2,38
S01008075,Good health,112,31,5,26,34,17,13,1,5,4,2,2,0,5
S01008075,Fair health,29,9,0,9,7,5,0,2,1,2,2,2,0,1
S01008075,Bad health,5,2,0,2,1,0,0,1,0,0,1,1,0,0
S01008075,Very bad health,2,1,0,1,1,0,0,0,0,0,0,0,0,0
S01008076,All people aged 16 to 74,418,107,13,94,127,67,33,15,25,5,11,9,2,28
S01008076,Very good health,228,73,9,64,65,26,15,7,11,4,3,1,2,24
S01008076,Good health,144,31,4,27,51,31,14,5,5,1,3,3,0,3
S01008076,Fair health,38,3,0,3,10,9,3,3,5,0,4,4,0,1
S01008076,Bad health,6,0,0,0,0,1,1,0,3,0,1,1,0,0
S01008076,Very bad health,2,0,0,0,1,0,0,0,1,0,0,0,0,0
S01008077,All people aged 16 to 74,570,162,23,139,177,66,51,16,26,12,16,10,6,44
S01008077,Very good health,369,110,14,96,123,37,25,6,15,7,8,4,4,38
S01008077,Good health,153,41,6,35,45,24,16,6,8,3,5,3,2,5
S01008077,Fair health,41,10,2,8,9,3,9,4,2,2,1,1,0,1
S01008077,Bad health,5,1,1,0,0,1,1,0,1,0,1,1,0,0
S01008077,Very bad health,2,0,0,0,0,1,0,0,0,0,1,1,0,0
S01008078,All people aged 16 to 74,595,128,21,107,172,76,55,23,47,15,15,11,4,64
S01008078,Very good health,387,82,15,67,114,47,30,14,26,8,11,7,4,55
S01008078,Good health,153,38,5,33,43,22,18,8,10,5,2,2,0,7
S01008078,Fair health,43,8,1,7,11,4,5,1,8,2,2,2,0,2
S01008078,Bad health,9,0,0,0,4,2,2,0,1,0,0,0,0,0
S01008078,Very bad health,3,0,0,0,0,1,0,0,2,0,0,0,0,0
S01008079,All people aged 16 to 74,648,135,23,112,237,77,64,21,45,10,20,11,9,39
S01008079,Very good health,369,94,17,77,136,32,33,11,20,3,7,4,3,33
S01008079,Good health,209,32,5,27,76,34,25,6,17,6,7,4,3,6
S01008079,Fair health,60,8,1,7,21,9,6,4,6,1,5,2,3,0
S01008079,Bad health,8,1,0,1,4,1,0,0,1,0,1,1,0,0
S01008079,Very bad health,2,0,0,0,0,1,0,0,1,0,0,0,0,0
S01008080,All people aged 16 to 74,497,94,16,78,147,76,52,26,40,19,9,5,4,34
S01008080,Very good health,292,59,7,52,94,39,28,12,21,9,2,1,1,28
S01008080,Good health,137,26,7,19,37,26,15,11,12,2,2,1,1,6
S01008080,Fair health,47,6,1,5,10,10,4,1,7,4,5,3,2,0
S01008080,Bad health,18,1,0,1,6,1,5,2,0,3,0,0,0,0
S01008080,Very bad health,3,2,1,1,0,0,0,0,0,1,0,0,0,0
S01008081,All people aged 16 to 74,441,93,17,76,130,57,35,17,42,11,11,8,3,45
S01008081,Very good health,294,73,14,59,80,31,21,10,28,6,5,4,1,40
S01008081,Good health,109,18,3,15,40,17,11,3,9,4,4,2,2,3
S01008081,Fair health,33,2,0,2,8,8,3,4,4,0,2,2,0,2
S01008081,Bad health,4,0,0,0,1,1,0,0,1,1,0,0,0,0
S01008081,Very bad health,1,0,0,0,1,0,0,0,0,0,0,0,0,0
S01008082,All people aged 16 to 74,607,107,18,89,202,84,51,26,44,23,15,13,2,55
S01008082,Very good health,360,67,13,54,124,46,25,17,20,11,4,4,0,46
S01008082,Good health,187,31,3,28,60,32,17,8,17,8,6,4,2,8
S01008082,Fair health,49,9,2,7,14,3,9,0,7,2,4,4,0,1
S01008082,Bad health,8,0,0,0,2,2,0,1,0,2,1,1,0,0
S01008082,Very bad health,3,0,0,0,2,1,0,0,0,0,0,0,0,0
S01008083,All people aged 16 to 74,540,101,19,82,167,80,44,22,48,15,10,8,2,53
S01008083,Very good health,323,69,12,57,95,44,18,8,28,6,5,4,1,50
S01008083,Good health,151,23,3,20,47,28,19,11,12,6,2,2,0,3
S01008083,Fair health,47,5,3,2,18,7,5,2,4,3,3,2,1,0
S01008083,Bad health,15,4,1,3,5,1,1,1,3,0,0,0,0,0
S01008083,Very bad health,4,0,0,0,2,0,1,0,1,0,0,0,0,0
S01008084,All people aged 16 to 74,654,88,15,73,170,103,68,41,68,31,16,8,8,69
S01008084,Very good health,356,51,8,43,93,54,33,21,25,13,7,4,3,59
S01008084,Good health,206,33,7,26,62,29,24,12,28,8,3,2,1,7
S01008084,Fair health,65,3,0,3,11,16,8,4,9,8,4,0,4,2
S01008084,Bad health,18,1,0,1,3,3,1,3,2,2,2,2,0,1
S01008084,Very bad health,9,0,0,0,1,1,2,1,4,0,0,0,0,0
S01008085,All people aged 16 to 74,744,102,13,89,240,93,84,34,66,27,12,10,2,86
S01008085,Very good health,437,64,7,57,136,48,35,18,39,16,7,7,0,74
S01008085,Good health,234,31,3,28,85,39,29,9,24,4,4,2,2,9
S01008085,Fair health,56,7,3,4,14,4,18,6,2,2,1,1,0,2
S01008085,Bad health,10,0,0,0,3,2,2,0,1,2,0,0,0,0
S01008085,Very bad health,7,0,0,0,2,0,0,1,0,3,0,0,0,1
S01008086,All people aged 16 to 74,812,116,20,96,206,121,80,55,87,63,16,8,8,68
S01008086,Very good health,456,75,14,61,119,64,41,30,37,28,6,3,3,56
S01008086,Good health,267,36,4,32,67,45,29,15,34,23,7,2,5,11
S01008086,Fair health,67,5,2,3,13,9,8,9,12,8,2,2,0,1
S01008086,Bad health,18,0,0,0,6,1,2,1,4,4,0,0,0,0
S01008086,Very bad health,4,0,0,0,1,2,0,0,0,0,1,1,0,0
S01008087,All people aged 16 to 74,582,88,21,67,160,114,33,29,58,34,13,11,2,53
S01008087,Very good health,306,57,13,44,100,49,12,12,25,10,3,1,2,38
S01008087,Good health,207,23,4,19,49,42,16,14,26,16,6,6,0,15
S01008087,Fair health,51,8,4,4,10,15,4,2,4,6,2,2,0,0
S01008087,Bad health,14,0,0,0,1,6,0,1,3,1,2,2,0,0
S01008087,Very bad health,4,0,0,0,0,2,1,0,0,1,0,0,0,0
S01008088,All people aged 16 to 74,682,84,13,71,185,127,38,53,74,41,19,14,5,61
S01008088,Very good health,362,44,6,38,102,66,21,24,29,15,9,6,3,52
S01008088,Good health,213,33,6,27,59,43,10,14,32,11,5,3,2,6
S01008088,Fair health,76,7,1,6,16,17,5,6,10,9,3,3,0,3
S01008088,Bad health,27,0,0,0,7,1,2,6,3,6,2,2,0,0
S01008088,Very bad health,4,0,0,0,1,0,0,3,0,0,0,0,0,0
S01008089,All people aged 16 to 74,494,52,15,37,144,82,37,32,58,21,15,11,4,53
S01008089,Very good health,276,39,12,27,81,37,16,12,27,5,9,7,2,50
S01008089,Good health,159,6,1,5,50,37,16,12,24,10,2,2,0,2
S01008089,Fair health,48,6,2,4,11,7,3,7,7,5,2,0,2,0
S01008089,Bad health,8,0,0,0,2,1,1,1,0,1,2,2,0,0
S01008089,Very bad health,3,1,0,1,0,0,1,0,0,0,0,0,0,1
S01008090,All people aged 16 to 74,541,78,13,65,122,98,33,30,52,56,15,8,7,57
S01008090,Very good health,301,51,8,43,77,45,23,10,24,15,7,3,4,49
S01008090,Good health,167,22,3,19,33,35,8,11,16,30,5,3,2,7
S01008090,Fair health,50,4,1,3,10,12,1,8,8,6,0,0,0,1
S01008090,Bad health,17,1,1,0,0,6,0,1,4,2,3,2,1,0
S01008090,Very bad health,6,0,0,0,2,0,1,0,0,3,0,0,0,0
S01008091,All people aged 16 to 74,289,35,4,31,82,40,19,13,38,26,7,6,1,29
S01008091,Very good health,167,19,3,16,48,25,10,7,19,12,1,0,1,26
S01008091,Good health,89,12,1,11,29,10,5,4,17,9,1,1,0,2
S01008091,Fair health,25,3,0,3,4,5,4,2,2,1,3,3,0,1
S01008091,Bad health,6,1,0,1,0,0,0,0,0,4,1,1,0,0
S01008091,Very bad health,2,0,0,0,1,0,0,0,0,0,1,1,0,0
S01008092,All people aged 16 to 74,630,98,12,86,188,107,47,28,57,23,8,5,3,74
S01008092,Very good health,351,51,6,45,112,51,20,14,29,9,1,1,0,64
S01008092,Good health,199,36,3,33,54,40,19,8,19,8,6,3,3,9
S01008092,Fair health,62,10,3,7,17,12,6,4,7,4,1,1,0,1
S01008092,Bad health,13,1,0,1,5,2,2,2,0,1,0,0,0,0
S01008092,Very bad health,5,0,0,0,0,2,0,0,2,1,0,0,0,0
S01008093,All people aged 16 to 74,558,73,18,55,154,115,42,35,51,21,8,6,2,59
S01008093,Very good health,302,38,9,29,94,56,10,19,29,6,4,3,1,46
S01008093,Good health,169,28,7,21,39,37,19,13,14,8,2,2,0,9
S01008093,Fair health,67,6,2,4,20,15,10,3,8,1,1,1,0,3
S01008093,Bad health,16,1,0,1,1,5,3,0,0,4,1,0,1,1
S01008093,Very bad health,4,0,0,0,0,2,0,0,0,2,0,0,0,0
S01008094,All people aged 16 to 74,488,73,7,66,148,67,50,27,39,19,13,6,7,52
S01008094,Very good health,267,46,4,42,83,32,18,13,21,7,4,2,2,43
S01008094,Good health,171,23,3,20,51,24,27,13,12,8,5,3,2,8
S01008094,Fair health,37,4,0,4,10,8,3,1,6,2,3,0,3,0
S01008094,Bad health,8,0,0,0,1,3,1,0,0,1,1,1,0,1
S01008094,Very bad health,5,0,0,0,3,0,1,0,0,1,0,0,0,0
S01008095,All people aged 16 to 74,557,49,9,40,138,114,36,41,60,48,14,6,8,57
S01008095,Very good health,274,29,6,23,70,53,13,12,28,18,6,2,4,45
S01008095,Good health,203,13,1,12,50,42,15,20,23,22,6,2,4,12
S01008095,Fair health,62,5,2,3,15,16,7,8,7,3,1,1,0,0
S01008095,Bad health,13,1,0,1,2,2,1,1,2,3,1,1,0,0
S01008095,Very bad health,5,1,0,1,1,1,0,0,0,2,0,0,0,0
S01008096,All people aged 16 to 74,554,74,18,56,162,93,37,31,62,36,7,5,2,52
S01008096,Very good health,318,53,12,41,94,53,18,17,29,10,2,2,0,42
S01008096,Good health,163,16,5,11,54,24,13,8,16,20,3,1,2,9
S01008096,Fair health,54,4,1,3,13,12,4,5,9,6,1,1,0,0
S01008096,Bad health,17,1,0,1,1,3,2,1,7,0,1,1,0,1
S01008096,Very bad health,2,0,0,0,0,1,0,0,1,0,0,0,0,0
S01008097,All people aged 16 to 74,433,45,15,30,123,76,41,23,46,23,6,2,4,50
S01008097,Very good health,234,27,9,18,73,34,16,11,20,9,5,2,3,39
S01008097,Good health,154,15,4,11,33,33,21,9,21,10,1,0,1,11
S01008097,Fair health,40,3,2,1,16,9,4,3,4,1,0,0,0,0
S01008097,Bad health,4,0,0,0,1,0,0,0,1,2,0,0,0,0
S01008097,Very bad health,1,0,0,0,0,0,0,0,0,1,0,0,0,0
S01008098,All people aged 16 to 74,539,68,16,52,152,95,34,35,47,41,14,12,2,53
S01008098,Very good health,307,43,6,37,90,52,13,15,24,20,4,4,0,46
S01008098,Good health,172,21,8,13,47,35,16,15,12,14,7,5,2,5
S01008098,Fair health,42,4,2,2,10,7,4,5,5,3,2,2,0,2
S01008098,Bad health,15,0,0,0,5,1,1,0,5,3,0,0,0,0
S01008098,Very bad health,3,0,0,0,0,0,0,0,1,1,1,1,0,0
S01008099,All people aged 16 to 74,408,37,6,31,92,73,29,38,50,32,10,6,4,47
S01008099,Very good health,217,17,2,15,66,35,10,14,21,15,6,3,3,33
S01008099,Good health,146,18,2,16,20,28,15,16,23,9,3,2,1,14
S01008099,Fair health,36,1,1,0,6,8,3,6,5,6,1,1,0,0
S01008099,Bad health,6,0,0,0,0,2,0,1,1,2,0,0,0,0
S01008099,Very bad health,3,1,1,0,0,0,1,1,0,0,0,0,0,0
S01008100,All people aged 16 to 74,671,120,16,104,199,88,63,33,50,37,16,8,8,65
S01008100,Very good health,365,76,11,65,113,45,20,14,22,19,9,4,5,47
S01008100,Good health,196,39,5,34,59,26,24,14,12,4,2,0,2,16
S01008100,Fair health,86,5,0,5,17,12,18,4,15,9,4,3,1,2
S01008100,Bad health,15,0,0,0,5,3,0,1,1,4,1,1,0,0
S01008100,Very bad health,9,0,0,0,5,2,1,0,0,1,0,0,0,0
S01008101,All people aged 16 to 74,599,77,13,64,171,83,43,45,66,46,19,11,8,49
S01008101,Very good health,321,51,7,44,106,37,19,20,29,19,4,2,2,36
S01008101,Good health,197,23,4,19,54,35,15,17,23,15,6,3,3,9
S01008101,Fair health,51,2,1,1,9,7,7,4,8,4,6,4,2,4
S01008101,Bad health,17,1,1,0,1,2,2,1,5,3,2,1,1,0
S01008101,Very bad health,13,0,0,0,1,2,0,3,1,5,1,1,0,0
S01008102,All people aged 16 to 74,607,42,9,33,142,103,47,42,81,72,31,19,12,47
S01008102,Very good health,284,21,4,17,73,52,19,17,28,25,9,6,3,40
S01008102,Good health,224,17,5,12,51,38,21,17,34,29,10,5,5,7
S01008102,Fair health,79,3,0,3,16,12,5,6,14,13,10,6,4,0
S01008102,Bad health,15,0,0,0,2,1,2,1,4,4,1,1,0,0
S01008102,Very bad health,5,1,0,1,0,0,0,1,1,1,1,1,0,0
S01008103,All people aged 16 to 74,452,36,9,27,100,58,38,24,76,63,30,17,13,27
S01008103,Very good health,209,25,5,20,53,23,21,14,27,23,7,3,4,16
S01008103,Good health,140,7,3,4,30,21,10,6,29,17,10,4,6,10
S01008103,Fair health,63,4,1,3,12,9,4,1,9,15,8,5,3,1
S01008103,Bad health,30,0,0,0,3,3,3,3,7,6,5,5,0,0
S01008103,Very bad health,10,0,0,0,2,2,0,0,4,2,0,0,0,0
S01008104,All people aged 16 to 74,659,33,5,28,103,124,41,59,105,93,51,32,19,50
S01008104,Very good health,299,17,3,14,53,56,18,30,42,30,17,9,8,36
S01008104,Good health,216,14,2,12,35,34,12,19,35,45,13,7,6,9
S01008104,Fair health,95,2,0,2,10,28,10,3,20,7,11,8,3,4
S01008104,Bad health,41,0,0,0,5,5,1,5,7,7,10,8,2,1
S01008104,Very bad health,8,0,0,0,0,1,0,2,1,4,0,0,0,0
S01008105,All people aged 16 to 74,780,38,10,28,140,127,52,64,126,122,58,32,26,53
S01008105,Very good health,309,17,4,13,66,48,23,21,43,37,16,8,8,38
S01008105,Good health,264,11,2,9,52,53,19,23,46,25,21,8,13,14
S01008105,Fair health,122,4,2,2,13,13,8,9,22,41,12,8,4,0
S01008105,Bad health,58,4,1,3,7,11,1,8,12,10,4,4,0,1
S01008105,Very bad health,27,2,1,1,2,2,1,3,3,9,5,4,1,0
S01008106,All people aged 16 to 74,575,20,2,18,94,83,31,42,113,104,51,30,21,37
S01008106,Very good health,217,11,2,9,39,28,6,19,43,28,15,8,7,28
S01008106,Good health,190,9,0,9,35,35,17,12,35,28,12,7,5,7
S01008106,Fair health,101,0,0,0,10,13,4,8,19,27,18,10,8,2
S01008106,Bad health,52,0,0,0,6,6,3,2,14,15,6,5,1,0
S01008106,Very bad health,15,0,0,0,4,1,1,1,2,6,0,0,0,0
S01008107,All people aged 16 to 74,614,85,15,70,152,82,81,44,65,29,15,11,4,61
S01008107,Very good health,401,64,12,52,107,52,47,22,36,12,6,5,1,55
S01008107,Good health,143,19,3,16,28,23,24,16,15,8,5,3,2,5
S01008107,Fair health,54,1,0,1,14,3,10,4,11,6,4,3,1,1
S01008107,Bad health,15,1,0,1,3,3,0,2,3,3,0,0,0,0
S01008107,Very bad health,1,0,0,0,0,1,0,0,0,0,0,0,0,0
S01008108,All people aged 16 to 74,531,68,16,52,130,92,43,33,67,41,11,7,4,46
S01008108,Very good health,294,41,12,29,63,54,18,16,37,20,4,3,1,41
S01008108,Good health,168,20,4,16,52,29,17,14,14,13,5,2,3,4
S01008108,Fair health,57,4,0,4,15,8,8,3,11,6,1,1,0,1
S01008108,Bad health,7,2,0,2,0,0,0,0,2,2,1,1,0,0
S01008108,Very bad health,5,1,0,1,0,1,0,0,3,0,0,0,0,0
S01008109,All people aged 16 to 74,726,59,18,41,167,150,57,56,102,53,17,10,7,65
S01008109,Very good health,394,35,10,25,100,87,23,26,44,21,5,2,3,53
S01008109,Good health,228,16,4,12,54,45,25,19,37,18,4,2,2,10
S01008109,Fair health,80,7,3,4,11,13,9,10,12,10,6,4,2,2
S01008109,Bad health,18,1,1,0,1,4,0,1,6,3,2,2,0,0
S01008109,Very bad health,6,0,0,0,1,1,0,0,3,1,0,0,0,0
S01008110,All people aged 16 to 74,652,42,6,36,194,118,50,53,72,44,14,4,10,65
S01008110,Very good health,375,26,2,24,119,66,27,24,30,22,7,2,5,54
S01008110,Good health,190,11,2,9,59,34,14,15,35,13,3,1,2,6
S01008110,Fair health,73,3,1,2,12,16,7,14,5,8,4,1,3,4
S01008110,Bad health,10,2,1,1,2,1,1,0,2,1,0,0,0,1
S01008110,Very bad health,4,0,0,0,2,1,1,0,0,0,0,0,0,0
S01008111,All people aged 16 to 74,638,89,20,69,177,123,41,38,67,32,4,4,0,67
S01008111,Very good health,355,55,11,44,102,58,19,18,34,11,2,2,0,56
S01008111,Good health,191,26,7,19,59,41,11,13,21,11,1,1,0,8
S01008111,Fair health,75,8,2,6,12,16,11,6,8,10,1,1,0,3
S01008111,Bad health,12,0,0,0,3,4,0,1,4,0,0,0,0,0
S01008111,Very bad health,5,0,0,0,1,4,0,0,0,0,0,0,0,0
S01008112,All people aged 16 to 74,614,52,12,40,163,128,36,54,88,29,11,10,1,53
S01008112,Very good health,336,33,7,26,98,66,14,29,38,12,6,5,1,40
S01008112,Good health,210,16,5,11,51,44,20,23,35,9,1,1,0,11
S01008112,Fair health,50,3,0,3,12,12,1,2,12,5,2,2,0,1
S01008112,Bad health,13,0,0,0,1,4,1,0,1,3,2,2,0,1
S01008112,Very bad health,5,0,0,0,1,2,0,0,2,0,0,0,0,0
S01008113,All people aged 16 to 74,683,82,12,70,184,142,38,49,75,40,7,5,2,66
S01008113,Very good health,359,45,7,38,97,66,16,27,40,15,6,4,2,47
S01008113,Good health,235,24,4,20,70,56,14,14,25,15,0,0,0,17
S01008113,Fair health,73,11,1,10,14,18,8,5,7,7,1,1,0,2
S01008113,Bad health,10,1,0,1,2,2,0,2,0,3,0,0,0,0
S01008113,Very bad health,6,1,0,1,1,0,0,1,3,0,0,0,0,0
S01008114,All people aged 16 to 74,510,54,11,43,126,92,37,42,63,41,13,6,7,42
S01008114,Very good health,278,37,9,28,70,51,18,19,26,17,4,1,3,36
S01008114,Good health,176,13,2,11,43,33,9,20,28,19,6,3,3,5
S01008114,Fair health,41,2,0,2,10,5,9,0,8,4,2,1,1,1
S01008114,Bad health,10,2,0,2,3,2,0,1,0,1,1,1,0,0
S01008114,Very bad health,5,0,0,0,0,1,1,2,1,0,0,0,0,0
S01008115,All people aged 16 to 74,734,47,9,38,165,154,57,73,84,53,20,10,10,81
S01008115,Very good health,409,30,5,25,97,73,30,39,44,25,8,2,6,63
S01008115,Good health,231,15,4,11,51,59,20,23,26,15,8,4,4,14
S01008115,Fair health,59,2,0,2,11,12,4,9,7,7,3,3,0,4
S01008115,Bad health,27,0,0,0,5,8,3,2,5,4,0,0,0,0
S01008115,Very bad health,8,0,0,0,1,2,0,0,2,2,1,1,0,0
S01008116,All people aged 16 to 74,703,99,18,81,204,130,39,30,69,42,15,10,5,75
S01008116,Very good health,418,54,13,41,120,81,24,16,37,20,5,2,3,61
S01008116,Good health,212,38,4,34,57,35,12,9,23,19,7,5,2,12
S01008116,Fair health,58,5,1,4,23,9,2,5,7,2,3,3,0,2
S01008116,Bad health,11,2,0,2,3,4,1,0,0,1,0,0,0,0
S01008116,Very bad health,4,0,0,0,1,1,0,0,2,0,0,0,0,0
S01008117,All people aged 16 to 74,582,100,22,78,189,82,42,23,51,19,18,9,9,58
S01008117,Very good health,291,52,13,39,92,37,18,10,23,4,5,3,2,50
S01008117,Good health,202,38,7,31,70,32,17,7,17,6,8,3,5,7
S01008117,Fair health,67,8,2,6,18,12,5,5,8,7,4,2,2,0
S01008117,Bad health,18,2,0,2,6,0,2,1,3,2,1,1,0,1
S01008117,Very bad health,4,0,0,0,3,1,0,0,0,0,0,0,0,0
S01008118,All people aged 16 to 74,587,59,8,51,154,99,45,50,82,41,17,6,11,40
S01008118,Very good health,317,43,5,38,90,53,23,22,37,12,6,1,5,31
S01008118,Good health,178,14,3,11,41,32,15,15,30,15,8,3,5,8
S01008118,Fair health,61,1,0,1,15,9,2,8,12,12,1,0,1,1
S01008118,Bad health,21,1,0,1,4,3,3,3,3,2,2,2,0,0
S01008118,Very bad health,10,0,0,0,4,2,2,2,0,0,0,0,0,0
S01008119,All people aged 16 to 74,496,19,3,16,82,62,25,50,101,78,32,22,10,47
S01008119,Very good health,175,12,3,9,26,17,6,16,38,22,9,9,0,29
S01008119,Good health,200,4,0,4,36,30,11,18,41,37,12,5,7,11
S01008119,Fair health,79,2,0,2,18,7,7,9,11,13,7,4,3,5
S01008119,Bad health,28,1,0,1,1,6,1,4,9,3,1,1,0,2
S01008119,Very bad health,14,0,0,0,1,2,0,3,2,3,3,3,0,0
S01008120,All people aged 16 to 74,431,66,12,54,131,77,27,17,52,21,12,6,6,28
S01008120,Very good health,220,43,8,35,71,30,12,8,22,7,7,3,4,20
S01008120,Good health,147,18,4,14,45,34,11,6,17,5,4,2,2,7
S01008120,Fair health,41,3,0,3,10,8,4,2,8,4,1,1,0,1
S01008120,Bad health,21,2,0,2,5,4,0,1,5,4,0,0,0,0
S01008120,Very bad health,2,0,0,0,0,1,0,0,0,1,0,0,0,0
S01008121,All people aged 16 to 74,475,112,21,91,148,74,30,23,36,12,5,3,2,35
S01008121,Very good health,283,66,13,53,87,50,16,13,16,5,3,2,1,27
S01008121,Good health,148,38,5,33,48,17,10,6,15,4,2,1,1,8
S01008121,Fair health,28,5,1,4,7,6,1,2,5,2,0,0,0,0
S01008121,Bad health,9,0,0,0,4,0,3,2,0,0,0,0,0,0
S01008121,Very bad health,7,3,2,1,2,1,0,0,0,1,0,0,0,0
S01008122,All people aged 16 to 74,529,133,15,118,165,60,43,14,23,16,14,8,6,61
S01008122,Very good health,365,93,8,85,111,37,31,10,15,8,6,2,4,54
S01008122,Good health,126,35,6,29,42,18,9,1,8,1,5,3,2,7
S01008122,Fair health,32,4,1,3,10,4,3,3,0,6,2,2,0,0
S01008122,Bad health,4,1,0,1,2,0,0,0,0,1,0,0,0,0
S01008122,Very bad health,2,0,0,0,0,1,0,0,0,0,1,1,0,0
S01008123,All people aged 16 to 74,675,167,26,141,222,85,48,17,41,14,11,8,3,70
S01008123,Very good health,414,105,15,90,133,46,26,9,22,8,3,2,1,62
S01008123,Good health,186,51,10,41,65,30,13,4,9,5,4,2,2,5
S01008123,Fair health,58,9,1,8,18,6,8,4,8,0,4,4,0,1
S01008123,Bad health,14,2,0,2,4,3,1,0,1,1,0,0,0,2
S01008123,Very bad health,3,0,0,0,2,0,0,0,1,0,0,0,0,0
S01008124,All people aged 16 to 74,635,82,14,68,196,121,41,30,53,32,7,4,3,73
S01008124,Very good health,380,44,7,37,126,67,26,18,26,14,1,0,1,58
S01008124,Good health,208,31,6,25,56,45,13,9,22,15,4,3,1,13
S01008124,Fair health,34,7,1,6,11,6,2,1,3,1,1,0,1,2
S01008124,Bad health,9,0,0,0,2,2,0,1,1,2,1,1,0,0
S01008124,Very bad health,4,0,0,0,1,1,0,1,1,0,0,0,0,0
S01008125,All people aged 16 to 74,659,94,29,65,200,117,42,30,69,39,7,5,2,61
S01008125,Very good health,367,64,19,45,119,54,21,17,28,16,2,1,1,46
S01008125,Good health,225,24,9,15,66,44,12,10,35,18,4,3,1,12
S01008125,Fair health,41,5,1,4,10,12,2,2,3,4,0,0,0,3
S01008125,Bad health,23,0,0,0,4,7,7,1,3,0,1,1,0,0
S01008125,Very bad health,3,1,0,1,1,0,0,0,0,1,0,0,0,0
S01008126,All people aged 16 to 74,644,114,19,95,191,112,41,39,49,19,11,4,7,68
S01008126,Very good health,400,72,9,63,111,67,23,19,33,11,7,3,4,57
S01008126,Good health,192,32,7,25,57,41,16,17,10,6,2,0,2,11
S01008126,Fair health,40,10,3,7,18,2,2,2,3,1,2,1,1,0
S01008126,Bad health,10,0,0,0,4,1,0,1,3,1,0,0,0,0
S01008126,Very bad health,2,0,0,0,1,1,0,0,0,0,0,0,0,0
S01008127,All people aged 16 to 74,367,69,13,56,131,56,16,16,28,16,9,4,5,26
S01008127,Very good health,202,40,8,32,73,33,8,7,8,5,3,2,1,25
S01008127,Good health,107,21,3,18,33,15,5,5,14,8,5,2,3,1
S01008127,Fair health,42,6,1,5,19,4,3,4,3,2,1,0,1,0
S01008127,Bad health,13,1,0,1,5,4,0,0,2,1,0,0,0,0
S01008127,Very bad health,3,1,1,0,1,0,0,0,1,0,0,0,0,0
S01008128,All people aged 16 to 74,695,89,14,75,199,124,43,39,60,44,17,5,12,80
S01008128,Very good health,388,52,5,47,95,63,22,23,31,25,9,2,7,68
S01008128,Good health,232,27,7,20,77,46,17,13,20,15,6,3,3,11
S01008128,Fair health,61,8,2,6,22,14,4,2,5,4,2,0,2,0
S01008128,Bad health,8,2,0,2,3,1,0,0,1,0,0,0,0,1
S01008128,Very bad health,6,0,0,0,2,0,0,1,3,0,0,0,0,0
S01008129,All people aged 16 to 74,684,35,9,26,161,104,46,58,116,82,45,25,20,37
S01008129,Very good health,299,21,6,15,82,49,21,26,42,18,11,6,5,29
S01008129,Good health,229,9,0,9,51,35,14,20,44,30,19,8,11,7
S01008129,Fair health,99,4,3,1,19,11,6,10,22,17,9,5,4,1
S01008129,Bad health,44,1,0,1,7,4,4,2,6,14,6,6,0,0
S01008129,Very bad health,13,0,0,0,2,5,1,0,2,3,0,0,0,0
S01008130,All people aged 16 to 74,748,46,10,36,169,118,40,49,122,84,61,35,26,59
S01008130,Very good health,361,26,9,17,96,63,21,20,50,30,16,12,4,39
S01008130,Good health,229,15,1,14,49,40,16,15,39,21,21,8,13,13
S01008130,Fair health,110,4,0,4,16,10,2,11,24,22,16,10,6,5
S01008130,Bad health,43,1,0,1,7,5,1,2,8,10,7,4,3,2
S01008130,Very bad health,5,0,0,0,1,0,0,1,1,1,1,1,0,0
S01008131,All people aged 16 to 74,596,36,3,33,127,95,38,43,101,72,38,19,19,46
S01008131,Very good health,258,20,1,19,53,44,18,21,40,16,16,5,11,30
S01008131,Good health,206,13,1,12,50,38,13,15,29,26,9,2,7,13
S01008131,Fair health,89,2,0,2,13,12,4,4,21,20,10,9,1,3
S01008131,Bad health,32,1,1,0,8,0,3,2,7,10,1,1,0,0
S01008131,Very bad health,11,0,0,0,3,1,0,1,4,0,2,2,0,0
S01008132,All people aged 16 to 74,716,110,22,88,223,127,53,45,62,31,14,6,8,51
S01008132,Very good health,390,60,12,48,117,60,24,31,38,12,5,1,4,43
S01008132,Good health,239,42,8,34,80,50,16,9,20,11,5,1,4,6
S01008132,Fair health,66,6,2,4,18,14,11,4,2,6,4,4,0,1
S01008132,Bad health,13,1,0,1,5,1,2,1,1,1,0,0,0,1
S01008132,Very bad health,8,1,0,1,3,2,0,0,1,1,0,0,0,0
S01008133,All people aged 16 to 74,450,55,9,46,115,52,30,27,69,46,27,21,6,29
S01008133,Very good health,196,30,6,24,58,21,11,14,21,14,7,5,2,20
S01008133,Good health,153,21,3,18,38,17,14,8,21,20,6,3,3,8
S01008133,Fair health,60,3,0,3,11,8,3,4,22,6,3,3,0,0
S01008133,Bad health,24,1,0,1,5,3,1,1,5,1,6,5,1,1
S01008133,Very bad health,17,0,0,0,3,3,1,0,0,5,5,5,0,0
S01008134,All people aged 16 to 74,470,63,10,53,126,73,31,41,58,31,21,12,9,26
S01008134,Very good health,264,47,7,40,75,45,18,16,24,17,6,0,6,16
S01008134,Good health,140,12,2,10,37,19,9,16,23,7,9,6,3,8
S01008134,Fair health,50,4,1,3,12,5,3,8,8,5,4,4,0,1
S01008134,Bad health,13,0,0,0,2,4,0,1,2,2,1,1,0,1
S01008134,Very bad health,3,0,0,0,0,0,1,0,1,0,1,1,0,0
S01008135,All people aged 16 to 74,861,75,17,58,223,121,61,70,127,62,60,44,16,62
S01008135,Very good health,428,45,10,35,120,69,24,29,50,28,13,6,7,50
S01008135,Good health,276,22,4,18,77,38,25,24,50,14,17,11,6,9
S01008135,Fair health,118,8,3,5,20,11,8,11,21,13,23,20,3,3
S01008135,Bad health,30,0,0,0,5,3,3,2,6,5,6,6,0,0
S01008135,Very bad health,9,0,0,0,1,0,1,4,0,2,1,1,0,0
S01008136,All people aged 16 to 74,681,48,8,40,133,106,36,58,129,100,42,30,12,29
S01008136,Very good health,290,24,2,22,55,48,12,28,51,32,17,11,6,23
S01008136,Good health,239,17,5,12,46,32,18,20,51,38,12,7,5,5
S01008136,Fair health,110,7,1,6,24,16,4,7,19,24,9,9,0,0
S01008136,Bad health,31,0,0,0,7,8,1,2,5,4,3,2,1,1
S01008136,Very bad health,11,0,0,0,1,2,1,1,3,2,1,1,0,0
S01008137,All people aged 16 to 74,634,21,5,16,60,66,24,59,150,122,84,49,35,48
S01008137,Very good health,248,15,3,12,30,27,9,12,58,39,23,13,10,35
S01008137,Good health,212,3,2,1,18,18,9,26,45,43,38,19,19,12
S01008137,Fair health,99,2,0,2,6,12,4,10,33,21,10,7,3,1
S01008137,Bad health,58,1,0,1,4,8,2,9,10,14,10,7,3,0
S01008137,Very bad health,17,0,0,0,2,1,0,2,4,5,3,3,0,0
S01008138,All people aged 16 to 74,613,18,4,14,81,58,30,57,143,118,65,41,24,43
S01008138,Very good health,223,8,1,7,29,28,9,20,48,29,21,11,10,31
S01008138,Good health,205,6,2,4,28,19,12,17,43,43,29,17,12,8
S01008138,Fair health,127,4,1,3,17,7,4,15,36,31,11,9,2,2
S01008138,Bad health,46,0,0,0,6,3,3,5,12,12,3,3,0,2
S01008138,Very bad health,12,0,0,0,1,1,2,0,4,3,1,1,0,0
S01008139,All people aged 16 to 74,647,25,4,21,117,102,42,60,95,102,47,21,26,57
S01008139,Very good health,259,16,1,15,51,35,15,24,39,25,18,7,11,36
S01008139,Good health,217,8,3,5,39,37,17,19,36,33,16,6,10,12
S01008139,Fair health,103,0,0,0,15,15,9,12,13,22,11,7,4,6
S01008139,Bad health,55,1,0,1,8,13,1,5,5,18,2,1,1,2
S01008139,Very bad health,13,0,0,0,4,2,0,0,2,4,0,0,0,1
S01008140,All people aged 16 to 74,344,27,6,21,50,52,18,22,66,65,26,17,9,18
S01008140,Very good health,163,17,4,13,25,28,7,12,25,20,16,10,6,13
S01008140,Good health,107,9,1,8,16,14,9,5,26,21,2,0,2,5
S01008140,Fair health,40,0,0,0,4,3,1,3,9,13,7,6,1,0
S01008140,Bad health,25,0,0,0,3,6,0,2,3,10,1,1,0,0
S01008140,Very bad health,9,1,1,0,2,1,1,0,3,1,0,0,0,0
S01008141,All people aged 16 to 74,643,52,7,45,166,110,52,62,86,41,13,9,4,61
S01008141,Very good health,340,23,2,21,90,52,24,32,43,18,7,4,3,51
S01008141,Good health,213,22,4,18,51,44,18,20,31,12,5,4,1,10
S01008141,Fair health,67,6,1,5,21,10,8,5,11,5,1,1,0,0
S01008141,Bad health,19,1,0,1,2,2,2,5,1,6,0,0,0,0
S01008141,Very bad health,4,0,0,0,2,2,0,0,0,0,0,0,0,0
S01008142,All people aged 16 to 74,636,51,15,36,178,111,34,51,76,53,18,8,10,64
S01008142,Very good health,362,26,7,19,103,60,15,29,38,25,9,4,5,57
S01008142,Good health,202,23,6,17,50,41,11,14,33,21,4,1,3,5
S01008142,Fair health,54,2,2,0,19,8,6,5,4,5,4,2,2,1
S01008142,Bad health,13,0,0,0,4,1,1,3,1,2,0,0,0,1
S01008142,Very bad health,5,0,0,0,2,1,1,0,0,0,1,1,0,0
S01008143,All people aged 16 to 74,674,35,1,34,155,100,33,48,120,96,43,25,18,44
S01008143,Very good health,295,14,0,14,76,34,23,19,52,31,14,10,4,32
S01008143,Good health,234,18,1,17,53,48,5,17,36,35,14,4,10,8
S01008143,Fair health,86,3,0,3,14,10,4,7,18,20,6,5,1,4
S01008143,Bad health,49,0,0,0,11,7,1,4,12,6,8,5,3,0
S01008143,Very bad health,10,0,0,0,1,1,0,1,2,4,1,1,0,0
S01008144,All people aged 16 to 74,468,45,9,36,127,83,55,24,50,25,5,4,1,54
S01008144,Very good health,263,27,5,22,72,41,21,15,28,8,3,2,1,48
S01008144,Good health,147,14,4,10,38,30,25,4,19,11,1,1,0,5
S01008144,Fair health,45,3,0,3,13,9,8,4,2,5,0,0,0,1
S01008144,Bad health,11,1,0,1,3,3,1,1,1,1,0,0,0,0
S01008144,Very bad health,2,0,0,0,1,0,0,0,0,0,1,1,0,0
S01008145,All people aged 16 to 74,600,24,6,18,93,57,41,71,110,128,36,20,16,40
S01008145,Very good health,256,9,0,9,46,24,19,27,48,44,10,6,4,29
S01008145,Good health,189,11,5,6,34,22,13,25,28,35,13,3,10,8
S01008145,Fair health,112,2,0,2,7,10,8,12,23,37,10,8,2,3
S01008145,Bad health,26,0,0,0,2,0,1,2,10,8,3,3,0,0
S01008145,Very bad health,17,2,1,1,4,1,0,5,1,4,0,0,0,0
S01008146,All people aged 16 to 74,376,21,5,16,56,44,28,32,63,78,21,11,10,33
S01008146,Very good health,159,12,2,10,31,15,13,7,25,23,7,3,4,26
S01008146,Good health,127,7,2,5,16,14,8,20,18,30,9,5,4,5
S01008146,Fair health,63,2,1,1,5,7,6,4,17,18,3,1,2,1
S01008146,Bad health,23,0,0,0,4,6,1,1,2,6,2,2,0,1
S01008146,Very bad health,4,0,0,0,0,2,0,0,1,1,0,0,0,0
S01008147,All people aged 16 to 74,621,32,9,23,121,97,41,58,133,77,23,13,10,39
S01008147,Very good health,257,11,2,9,59,48,9,22,50,21,10,4,6,27
S01008147,Good health,236,15,7,8,42,33,27,21,47,35,7,3,4,9
S01008147,Fair health,79,5,0,5,12,10,3,12,16,14,4,4,0,3
S01008147,Bad health,43,1,0,1,8,5,1,3,17,6,2,2,0,0
S01008147,Very bad health,6,0,0,0,0,1,1,0,3,1,0,0,0,0
S01008148,All people aged 16 to 74,620,41,3,38,147,114,40,53,93,67,17,13,4,48
S01008148,Very good health,302,23,1,22,66,56,21,27,42,24,5,3,2,38
S01008148,Good health,209,17,2,15,55,37,15,20,31,20,6,4,2,8
S01008148,Fair health,61,0,0,0,14,12,2,4,12,14,2,2,0,1
S01008148,Bad health,34,1,0,1,9,6,0,2,6,6,4,4,0,0
S01008148,Very bad health,14,0,0,0,3,3,2,0,2,3,0,0,0,1
S01008149,All people aged 16 to 74,528,20,4,16,109,95,34,41,99,69,21,6,15,40
S01008149,Very good health,223,12,2,10,52,41,10,11,36,25,7,1,6,29
S01008149,Good health,207,4,1,3,43,41,13,21,42,26,8,1,7,9
S01008149,Fair health,68,2,0,2,8,9,8,7,14,12,6,4,2,2
S01008149,Bad health,25,2,1,1,5,3,2,2,5,6,0,0,0,0
S01008149,Very bad health,5,0,0,0,1,1,1,0,2,0,0,0,0,0
S01008150,All people aged 16 to 74,686,33,9,24,117,114,35,61,125,123,34,21,13,44
S01008150,Very good health,302,22,5,17,58,41,16,28,50,40,12,8,4,35
S01008150,Good health,229,10,3,7,37,60,9,13,46,33,12,6,6,9
S01008150,Fair health,103,0,0,0,15,10,8,14,20,29,7,4,3,0
S01008150,Bad health,42,1,1,0,7,2,2,5,8,14,3,3,0,0
S01008150,Very bad health,10,0,0,0,0,1,0,1,1,7,0,0,0,0
S01008151,All people aged 16 to 74,509,25,3,22,85,67,33,61,105,57,26,16,10,50
S01008151,Very good health,237,18,2,16,39,23,10,21,45,26,10,7,3,45
S01008151,Good health,179,6,1,5,33,31,12,21,40,21,11,5,6,4
S01008151,Fair health,59,1,0,1,8,9,5,13,12,5,5,4,1,1
S01008151,Bad health,27,0,0,0,5,4,5,5,5,3,0,0,0,0
S01008151,Very bad health,7,0,0,0,0,0,1,1,3,2,0,0,0,0
S01008152,All people aged 16 to 74,755,41,8,33,149,116,48,68,150,93,39,23,16,51
S01008152,Very good health,320,24,7,17,73,42,17,30,57,32,11,9,2,34
S01008152,Good health,252,12,0,12,54,44,18,20,48,28,15,5,10,13
S01008152,Fair health,113,3,0,3,15,20,7,12,25,22,7,4,3,2
S01008152,Bad health,54,2,1,1,5,6,6,4,17,7,5,4,1,2
S01008152,Very bad health,16,0,0,0,2,4,0,2,3,4,1,1,0,0
S01008153,All people aged 16 to 74,667,72,11,61,187,117,46,46,68,47,16,8,8,68
S01008153,Very good health,376,42,9,33,103,65,21,26,33,22,10,6,4,54
S01008153,Good health,197,24,2,22,51,39,16,13,25,13,5,1,4,11
S01008153,Fair health,58,4,0,4,19,8,7,5,4,8,0,0,0,3
S01008153,Bad health,32,1,0,1,13,5,2,1,5,4,1,1,0,0
S01008153,Very bad health,4,1,0,1,1,0,0,1,1,0,0,0,0,0
S01008154,All people aged 16 to 74,635,89,18,71,174,109,46,33,72,54,11,5,6,47
S01008154,Very good health,325,49,12,37,83,60,17,19,35,19,4,1,3,39
S01008154,Good health,221,34,6,28,67,33,21,7,28,23,2,1,1,6
S01008154,Fair health,70,5,0,5,22,12,6,5,7,8,4,2,2,1
S01008154,Bad health,16,0,0,0,2,4,2,2,2,3,0,0,0,1
S01008154,Very bad health,3,1,0,1,0,0,0,0,0,1,1,1,0,0
S01008155,All people aged 16 to 74,537,58,14,44,147,95,32,37,63,33,23,13,10,49
S01008155,Very good health,300,37,10,27,80,57,18,15,22,17,12,5,7,42
S01008155,Good health,182,18,3,15,54,25,9,19,30,12,8,6,2,7
S01008155,Fair health,36,3,1,2,9,10,3,2,4,3,2,1,1,0
S01008155,Bad health,17,0,0,0,3,2,2,1,7,1,1,1,0,0
S01008155,Very bad health,2,0,0,0,1,1,0,0,0,0,0,0,0,0
S01008156,All people aged 16 to 74,704,54,8,46,156,94,76,55,106,71,32,12,20,60
S01008156,Very good health,339,29,3,26,89,47,37,23,40,20,9,0,9,45
S01008156,Good health,254,19,5,14,50,38,23,23,45,31,12,5,7,13
S01008156,Fair health,81,5,0,5,10,8,13,7,14,15,8,5,3,1
S01008156,Bad health,26,1,0,1,7,1,1,1,6,5,3,2,1,1
S01008156,Very bad health,4,0,0,0,0,0,2,1,1,0,0,0,0,0
S01008157,All people aged 16 to 74,564,73,7,66,148,85,41,45,71,30,14,5,9,57
S01008157,Very good health,321,45,4,41,78,54,17,27,35,10,8,2,6,47
S01008157,Good health,160,23,3,20,50,20,14,12,23,5,4,2,2,9
S01008157,Fair health,57,5,0,5,12,6,9,5,9,9,2,1,1,0
S01008157,Bad health,19,0,0,0,5,2,1,1,4,5,0,0,0,1
S01008157,Very bad health,7,0,0,0,3,3,0,0,0,1,0,0,0,0
S01008158,All people aged 16 to 74,602,48,9,39,174,111,43,55,65,38,13,5,8,55
S01008158,Very good health,374,28,5,23,98,65,30,33,35,26,9,2,7,50
S01008158,Good health,180,19,4,15,60,36,12,14,23,10,2,1,1,4
S01008158,Fair health,35,1,0,1,12,6,0,5,6,2,2,2,0,1
S01008158,Bad health,11,0,0,0,3,4,1,3,0,0,0,0,0,0
S01008158,Very bad health,2,0,0,0,1,0,0,0,1,0,0,0,0,0
S01008159,All people aged 16 to 74,713,39,8,31,113,86,42,67,151,101,63,34,29,51
S01008159,Very good health,273,15,3,12,51,42,15,18,49,30,15,8,7,38
S01008159,Good health,239,19,4,15,34,20,14,26,58,31,24,10,14,13
S01008159,Fair health,126,2,0,2,19,18,6,12,31,20,18,12,6,0
S01008159,Bad health,54,2,0,2,4,4,3,9,11,16,5,3,2,0
S01008159,Very bad health,21,1,1,0,5,2,4,2,2,4,1,1,0,0
S01008160,All people aged 16 to 74,663,40,8,32,113,75,38,62,130,92,60,30,30,53
S01008160,Very good health,281,19,4,15,47,27,15,34,50,33,16,10,6,40
S01008160,Good health,231,15,4,11,40,30,16,18,47,33,24,7,17,8
S01008160,Fair health,90,4,0,4,17,9,5,4,19,14,14,7,7,4
S01008160,Bad health,49,2,0,2,7,8,1,6,10,10,4,4,0,1
S01008160,Very bad health,12,0,0,0,2,1,1,0,4,2,2,2,0,0
S01008161,All people aged 16 to 74,778,80,16,64,256,98,82,62,87,43,18,11,7,52
S01008161,Very good health,437,53,9,44,146,48,45,33,47,20,4,3,1,41
S01008161,Good health,253,21,5,16,85,41,26,15,33,16,8,3,5,8
S01008161,Fair health,66,4,2,2,22,7,10,7,6,6,2,1,1,2
S01008161,Bad health,20,2,0,2,2,2,1,6,1,1,4,4,0,1
S01008161,Very bad health,2,0,0,0,1,0,0,1,0,0,0,0,0,0
S01008162,All people aged 16 to 74,756,89,14,75,203,87,56,63,116,93,11,8,3,38
S01008162,Very good health,404,64,6,58,111,48,33,35,47,31,6,5,1,29
S01008162,Good health,235,19,5,14,75,23,16,17,42,34,3,2,1,6
S01008162,Fair health,82,5,3,2,11,10,5,9,18,21,2,1,1,1
S01008162,Bad health,28,1,0,1,5,5,2,2,7,4,0,0,0,2
S01008162,Very bad health,7,0,0,0,1,1,0,0,2,3,0,0,0,0
S01008163,All people aged 16 to 74,544,25,4,21,73,69,43,59,110,105,31,21,10,29
S01008163,Very good health,214,15,3,12,36,24,15,20,32,36,16,10,6,20
S01008163,Good health,182,4,1,3,21,27,18,21,38,38,7,4,3,8
S01008163,Fair health,100,4,0,4,9,12,9,12,29,20,4,3,1,1
S01008163,Bad health,40,1,0,1,5,6,1,6,10,8,3,3,0,0
S01008163,Very bad health,8,1,0,1,2,0,0,0,1,3,1,1,0,0
S01008164,All people aged 16 to 74,1292,22,3,19,84,70,43,46,101,91,23,12,11,812
S01008164,Very good health,748,12,2,10,45,31,18,27,43,36,7,5,2,529
S01008164,Good health,418,9,1,8,29,25,16,14,38,31,12,5,7,244
S01008164,Fair health,83,1,0,1,6,10,4,2,11,16,1,0,1,32
S01008164,Bad health,32,0,0,0,2,2,5,2,6,6,3,2,1,6
S01008164,Very bad health,11,0,0,0,2,2,0,1,3,2,0,0,0,1
S01008165,All people aged 16 to 74,545,58,7,51,149,96,67,38,52,33,16,10,6,36
S01008165,Very good health,361,40,5,35,108,65,41,19,30,21,4,3,1,33
S01008165,Good health,145,16,1,15,35,25,23,15,11,10,7,3,4,3
S01008165,Fair health,34,2,1,1,6,5,3,4,9,1,4,3,1,0
S01008165,Bad health,5,0,0,0,0,1,0,0,2,1,1,1,0,0
S01008165,Very bad health,0,0,0,0,0,0,0,0,0,0,0,0,0,0
S01008166,All people aged 16 to 74,402,9,1,8,60,37,28,36,98,83,20,15,5,31
S01008166,Very good health,193,4,1,3,34,18,12,14,47,36,7,5,2,21
S01008166,Good health,121,4,0,4,16,10,10,14,27,24,7,4,3,9
S01008166,Fair health,60,1,0,1,10,7,6,5,14,11,5,5,0,1
S01008166,Bad health,23,0,0,0,0,2,0,3,8,9,1,1,0,0
S01008166,Very bad health,5,0,0,0,0,0,0,0,2,3,0,0,0,0
S01008167,All people aged 16 to 74,521,12,5,7,57,65,32,56,111,118,37,19,18,33
S01008167,Very good health,226,7,1,6,26,28,10,29,43,45,18,10,8,20
S01008167,Good health,190,5,4,1,27,25,8,13,46,44,14,4,10,8
S01008167,Fair health,62,0,0,0,1,8,8,6,14,20,1,1,0,4
S01008167,Bad health,38,0,0,0,3,4,6,5,7,8,4,4,0,1
S01008167,Very bad health,5,0,0,0,0,0,0,3,1,1,0,0,0,0
S01008168,All people aged 16 to 74,596,27,3,24,86,81,30,58,141,103,38,26,12,32
S01008168,Very good health,245,16,1,15,37,36,17,23,55,29,10,7,3,22
S01008168,Good health,219,7,1,6,33,29,6,22,51,50,13,6,7,8
S01008168,Fair health,90,3,1,2,15,10,3,6,26,14,11,9,2,2
S01008168,Bad health,27,1,0,1,1,5,2,5,6,5,2,2,0,0
S01008168,Very bad health,15,0,0,0,0,1,2,2,3,5,2,2,0,0
S01008169,All people aged 16 to 74,531,20,4,16,88,71,35,49,122,96,19,15,4,31
S01008169,Very good health,222,15,2,13,40,34,15,16,41,32,6,3,3,23
S01008169,Good health,202,3,1,2,37,22,13,25,48,39,8,7,1,7
S01008169,Fair health,86,2,1,1,7,14,7,7,29,17,2,2,0,1
S01008169,Bad health,13,0,0,0,2,1,0,0,3,5,2,2,0,0
S01008169,Very bad health,8,0,0,0,2,0,0,1,1,3,1,1,0,0
S01008170,All people aged 16 to 74,439,69,14,55,108,63,41,23,57,31,7,2,5,40
S01008170,Very good health,249,43,11,32,69,36,19,9,30,8,2,1,1,33
S01008170,Good health,131,19,2,17,26,22,17,11,18,10,2,0,2,6
S01008170,Fair health,45,7,1,6,10,4,5,2,6,7,3,1,2,1
S01008170,Bad health,9,0,0,0,3,1,0,0,2,3,0,0,0,0
S01008170,Very bad health,5,0,0,0,0,0,0,1,1,3,0,0,0,0
S01008171,All people aged 16 to 74,527,38,7,31,94,97,27,53,89,69,15,10,5,45
S01008171,Very good health,261,24,4,20,52,46,14,21,41,23,5,1,4,35
S01008171,Good health,171,10,1,9,32,29,10,18,30,27,6,5,1,9
S01008171,Fair health,58,3,2,1,7,14,2,10,9,9,3,3,0,1
S01008171,Bad health,30,1,0,1,3,8,1,4,5,8,0,0,0,0
S01008171,Very bad health,7,0,0,0,0,0,0,0,4,2,1,1,0,0
S01008172,All people aged 16 to 74,414,18,8,10,84,87,30,34,69,54,8,3,5,30
S01008172,Very good health,191,10,6,4,43,42,8,15,27,22,3,1,2,21
S01008172,Good health,157,7,1,6,30,33,14,11,33,20,3,1,2,6
S01008172,Fair health,45,1,1,0,8,8,7,4,8,5,2,1,1,2
S01008172,Bad health,17,0,0,0,2,3,1,3,1,6,0,0,0,1
S01008172,Very bad health,4,0,0,0,1,1,0,1,0,1,0,0,0,0
S01008173,All people aged 16 to 74,491,43,8,35,110,97,28,35,84,45,14,9,5,35
S01008173,Very good health,259,30,6,24,68,54,13,10,35,16,4,3,1,29
S01008173,Good health,159,12,2,10,32,31,11,17,26,18,7,4,3,5
S01008173,Fair health,59,1,0,1,8,10,4,6,17,10,2,2,0,1
S01008173,Bad health,10,0,0,0,1,1,0,2,5,1,0,0,0,0
S01008173,Very bad health,4,0,0,0,1,1,0,0,1,0,1,0,1,0
S01008174,All people aged 16 to 74,412,29,5,24,78,102,31,33,62,44,2,1,1,31
S01008174,Very good health,228,17,1,16,49,56,17,14,29,19,1,1,0,26
S01008174,Good health,131,11,4,7,25,32,10,16,17,15,1,0,1,4
S01008174,Fair health,38,1,0,1,1,10,3,2,13,7,0,0,0,1
S01008174,Bad health,13,0,0,0,3,4,1,0,3,2,0,0,0,0
S01008174,Very bad health,2,0,0,0,0,0,0,1,0,1,0,0,0,0
S01008175,All people aged 16 to 74,579,47,7,40,113,96,42,50,90,88,23,12,11,30
S01008175,Very good health,291,30,5,25,67,44,18,24,46,30,8,2,6,24
S01008175,Good health,196,13,2,11,37,41,17,14,29,32,7,4,3,6
S01008175,Fair health,61,3,0,3,8,9,4,7,9,18,3,2,1,0
S01008175,Bad health,23,0,0,0,1,1,3,5,5,7,1,1,0,0
S01008175,Very bad health,8,1,0,1,0,1,0,0,1,1,4,3,1,0
S01008176,All people aged 16 to 74,563,104,19,85,159,63,58,37,53,32,14,6,8,43
S01008176,Very good health,330,71,12,59,92,37,27,17,25,18,7,3,4,36
S01008176,Good health,180,25,6,19,57,18,22,16,24,9,2,0,2,7
S01008176,Fair health,36,7,1,6,7,6,4,2,3,3,4,2,2,0
S01008176,Bad health,13,1,0,1,2,2,3,2,0,2,1,1,0,0
S01008176,Very bad health,4,0,0,0,1,0,2,0,1,0,0,0,0,0
S01008177,All people aged 16 to 74,552,41,12,29,106,90,40,44,106,80,20,12,8,25
S01008177,Very good health,262,25,5,20,64,40,20,19,35,25,10,6,4,24
S01008177,Good health,169,11,5,6,29,31,12,12,42,26,5,3,2,1
S01008177,Fair health,89,5,2,3,7,14,6,11,24,17,5,3,2,0
S01008177,Bad health,23,0,0,0,5,2,2,1,4,9,0,0,0,0
S01008177,Very bad health,9,0,0,0,1,3,0,1,1,3,0,0,0,0
S01008178,All people aged 16 to 74,512,36,9,27,123,121,32,36,69,44,15,10,5,36
S01008178,Very good health,285,21,5,16,72,70,15,21,29,17,7,5,2,33
S01008178,Good health,166,13,4,9,42,40,13,10,26,17,3,2,1,2
S01008178,Fair health,45,1,0,1,8,10,4,4,9,4,4,2,2,1
S01008178,Bad health,12,1,0,1,1,0,0,1,5,3,1,1,0,0
S01008178,Very bad health,4,0,0,0,0,1,0,0,0,3,0,0,0,0
S01008179,All people aged 16 to 74,387,42,11,31,95,72,35,22,48,22,1,0,1,50
S01008179,Very good health,247,28,6,22,61,53,19,17,28,8,1,0,1,32
S01008179,Good health,107,12,4,8,25,13,11,5,16,9,0,0,0,16
S01008179,Fair health,27,2,1,1,7,5,3,0,4,4,0,0,0,2
S01008179,Bad health,3,0,0,0,1,1,0,0,0,1,0,0,0,0
S01008179,Very bad health,3,0,0,0,1,0,2,0,0,0,0,0,0,0
S01008180,All people aged 16 to 74,374,37,7,30,107,68,35,24,51,9,7,5,2,36
S01008180,Very good health,238,20,4,16,72,39,21,6,33,8,6,4,2,33
S01008180,Good health,107,15,3,12,32,20,8,14,14,1,0,0,0,3
S01008180,Fair health,20,2,0,2,3,6,4,3,2,0,0,0,0,0
S01008180,Bad health,8,0,0,0,0,2,2,1,2,0,1,1,0,0
S01008180,Very bad health,1,0,0,0,0,1,0,0,0,0,0,0,0,0
S01008181,All people aged 16 to 74,515,58,14,44,125,103,49,32,58,31,13,10,3,46
S01008181,Very good health,272,35,9,26,66,55,16,14,28,12,4,2,2,42
S01008181,Good health,170,15,3,12,46,34,22,13,18,13,6,5,1,3
S01008181,Fair health,56,7,2,5,12,9,9,4,11,3,1,1,0,0
S01008181,Bad health,12,1,0,1,1,4,2,0,1,2,0,0,0,1
S01008181,Very bad health,5,0,0,0,0,1,0,1,0,1,2,2,0,0
S01008182,All people aged 16 to 74,754,61,7,54,157,134,42,62,111,93,35,15,20,59
S01008182,Very good health,366,38,6,32,95,65,23,19,47,33,9,2,7,37
S01008182,Good health,256,16,0,16,49,50,12,25,44,28,16,7,9,16
S01008182,Fair health,102,6,1,5,10,12,5,15,17,23,8,4,4,6
S01008182,Bad health,21,1,0,1,3,4,2,3,2,5,1,1,0,0
S01008182,Very bad health,9,0,0,0,0,3,0,0,1,4,1,1,0,0
S01008183,All people aged 16 to 74,476,49,11,38,97,86,34,44,58,37,18,11,7,53
S01008183,Very good health,254,35,7,28,58,45,18,21,25,7,7,5,2,38
S01008183,Good health,174,14,4,10,31,34,11,21,24,17,8,6,2,14
S01008183,Fair health,37,0,0,0,7,6,3,2,7,8,3,0,3,1
S01008183,Bad health,9,0,0,0,1,0,2,0,2,4,0,0,0,0
S01008183,Very bad health,2,0,0,0,0,1,0,0,0,1,0,0,0,0
S01008184,All people aged 16 to 74,606,49,11,38,126,111,43,39,82,83,26,10,16,47
S01008184,Very good health,289,30,10,20,72,47,25,12,37,25,12,3,9,29
S01008184,Good health,199,14,1,13,32,47,10,18,26,32,6,3,3,14
S01008184,Fair health,83,2,0,2,19,13,7,3,15,15,7,3,4,2
S01008184,Bad health,23,3,0,3,2,2,0,5,2,7,0,0,0,2
S01008184,Very bad health,12,0,0,0,1,2,1,1,2,4,1,1,0,0
S01008185,All people aged 16 to 74,762,43,8,35,170,131,46,60,119,103,35,14,21,55
S01008185,Very good health,352,27,5,22,85,55,17,30,49,42,10,2,8,37
S01008185,Good health,275,13,2,11,68,54,19,17,44,31,15,6,9,14
S01008185,Fair health,86,3,1,2,10,15,4,7,17,20,7,4,3,3
S01008185,Bad health,35,0,0,0,3,4,4,4,9,8,3,2,1,0
S01008185,Very bad health,14,0,0,0,4,3,2,2,0,2,0,0,0,1
S01008186,All people aged 16 to 74,618,31,3,28,142,74,30,51,63,47,30,19,11,150
S01008186,Very good health,354,16,3,13,82,43,19,27,25,20,7,4,3,115
S01008186,Good health,174,12,0,12,43,23,5,12,25,13,9,4,5,32
S01008186,Fair health,67,1,0,1,12,6,5,9,12,11,9,6,3,2
S01008186,Bad health,18,2,0,2,5,2,0,3,1,1,3,3,0,1
S01008186,Very bad health,5,0,0,0,0,0,1,0,0,2,2,2,0,0
S01008187,All people aged 16 to 74,454,45,7,38,72,53,37,32,89,64,28,20,8,34
S01008187,Very good health,217,29,6,23,37,21,19,10,41,23,10,7,3,27
S01008187,Good health,150,12,1,11,26,21,11,12,28,22,13,10,3,5
S01008187,Fair health,51,3,0,3,5,7,5,4,13,7,5,3,2,2
S01008187,Bad health,29,1,0,1,3,4,2,4,5,10,0,0,0,0
S01008187,Very bad health,7,0,0,0,1,0,0,2,2,2,0,0,0,0
S01008188,All people aged 16 to 74,643,29,5,24,98,85,36,56,123,111,35,23,12,70
S01008188,Very good health,302,17,3,14,53,42,15,27,50,38,13,6,7,47
S01008188,Good health,210,8,0,8,31,22,17,17,39,43,11,7,4,22
S01008188,Fair health,93,3,2,1,9,14,3,6,28,22,8,7,1,0
S01008188,Bad health,33,1,0,1,5,6,1,6,5,6,2,2,0,1
S01008188,Very bad health,5,0,0,0,0,1,0,0,1,2,1,1,0,0
S01008189,All people aged 16 to 74,431,40,9,31,86,81,40,29,51,51,12,4,8,41
S01008189,Very good health,214,17,2,15,46,44,17,14,18,20,4,1,3,34
S01008189,Good health,157,18,6,12,30,30,19,11,23,18,4,0,4,4
S01008189,Fair health,35,3,0,3,7,5,3,3,4,8,1,0,1,1
S01008189,Bad health,20,2,1,1,3,2,0,1,6,4,0,0,0,2
S01008189,Very bad health,5,0,0,0,0,0,1,0,0,1,3,3,0,0
S01008190,All people aged 16 to 74,642,19,3,16,94,81,38,34,150,138,40,25,15,48
S01008190,Very good health,257,10,1,9,40,38,16,13,56,38,10,5,5,36
S01008190,Good health,244,8,2,6,35,31,11,11,61,61,17,10,7,9
S01008190,Fair health,114,1,0,1,15,12,8,9,26,29,11,8,3,3
S01008190,Bad health,22,0,0,0,3,0,2,1,7,7,2,2,0,0
S01008190,Very bad health,5,0,0,0,1,0,1,0,0,3,0,0,0,0
S01008191,All people aged 16 to 74,357,19,7,12,68,57,23,30,61,51,23,15,8,25
S01008191,Very good health,177,10,3,7,37,25,8,16,27,25,8,4,4,21
S01008191,Good health,120,8,4,4,23,22,9,7,25,15,9,6,3,2
S01008191,Fair health,44,1,0,1,5,10,6,3,6,6,5,4,1,2
S01008191,Bad health,10,0,0,0,2,0,0,4,0,3,1,1,0,0
S01008191,Very bad health,6,0,0,0,1,0,0,0,3,2,0,0,0,0
S01008192,All people aged 16 to 74,637,54,5,49,131,93,44,49,100,92,34,22,12,40
S01008192,Very good health,313,37,3,34,70,52,23,24,38,24,12,9,3,33
S01008192,Good health,214,14,2,12,47,30,15,17,34,37,14,9,5,6
S01008192,Fair health,67,1,0,1,10,7,5,3,16,24,0,0,0,1
S01008192,Bad health,32,2,0,2,2,3,1,5,10,4,5,1,4,0
S01008192,Very bad health,11,0,0,0,2,1,0,0,2,3,3,3,0,0
S01008193,All people aged 16 to 74,560,59,7,52,122,78,34,37,110,66,15,10,5,39
S01008193,Very good health,324,37,4,33,75,45,17,22,49,40,4,3,1,35
S01008193,Good health,171,17,3,14,40,26,11,12,39,15,9,5,4,2
S01008193,Fair health,43,4,0,4,5,2,5,2,15,7,1,1,0,2
S01008193,Bad health,16,1,0,1,2,3,1,0,6,2,1,1,0,0
S01008193,Very bad health,6,0,0,0,0,2,0,1,1,2,0,0,0,0
S01008194,All people aged 16 to 74,440,45,10,35,100,54,28,40,65,58,25,13,12,25
S01008194,Very good health,206,31,4,27,60,18,13,20,24,19,5,3,2,16
S01008194,Good health,137,10,3,7,27,21,9,11,22,22,9,3,6,6
S01008194,Fair health,75,2,2,0,11,12,6,6,16,13,7,5,2,2
S01008194,Bad health,18,2,1,1,1,2,0,3,3,2,4,2,2,1
S01008194,Very bad health,4,0,0,0,1,1,0,0,0,2,0,0,0,0
S01008195,All people aged 16 to 74,590,19,4,15,88,90,40,45,131,93,29,22,7,55
S01008195,Very good health,281,12,3,9,52,48,17,17,56,32,6,4,2,41
S01008195,Good health,194,6,1,5,25,28,14,19,51,28,12,10,2,11
S01008195,Fair health,71,0,0,0,8,6,6,6,14,20,9,7,2,2
S01008195,Bad health,33,0,0,0,0,6,3,1,9,11,2,1,1,1
S01008195,Very bad health,11,1,0,1,3,2,0,2,1,2,0,0,0,0
S01008196,All people aged 16 to 74,555,15,4,11,69,82,40,58,107,104,42,25,17,38
S01008196,Very good health,244,7,3,4,37,39,18,25,44,39,14,7,7,21
S01008196,Good health,198,6,1,5,24,31,13,23,42,27,17,11,6,15
S01008196,Fair health,83,2,0,2,6,8,5,6,16,30,8,4,4,2
S01008196,Bad health,27,0,0,0,2,4,3,3,5,8,2,2,0,0
S01008196,Very bad health,3,0,0,0,0,0,1,1,0,0,1,1,0,0
S01008197,All people aged 16 to 74,731,72,11,61,206,124,39,80,82,68,31,17,14,29
S01008197,Very good health,450,53,10,43,135,76,26,49,47,36,10,7,3,18
S01008197,Good health,220,17,1,16,54,44,9,21,27,21,18,9,9,9
S01008197,Fair health,42,1,0,1,15,3,4,6,5,5,2,1,1,1
S01008197,Bad health,14,1,0,1,1,0,0,4,2,4,1,0,1,1
S01008197,Very bad health,5,0,0,0,1,1,0,0,1,2,0,0,0,0
S01008198,All people aged 16 to 74,514,14,3,11,77,72,34,66,116,90,19,11,8,26
S01008198,Very good health,213,8,2,6,37,25,7,28,43,33,8,6,2,24
S01008198,Good health,195,4,0,4,31,35,15,24,48,31,5,2,3,2
S01008198,Fair health,78,1,1,0,8,9,9,7,20,20,4,3,1,0
S01008198,Bad health,21,1,0,1,1,2,2,5,3,5,2,0,2,0
S01008198,Very bad health,7,0,0,0,0,1,1,2,2,1,0,0,0,0
S01008199,All people aged 16 to 74,581,7,0,7,55,54,28,67,153,137,52,36,16,28
S01008199,Very good health,229,4,0,4,35,22,11,21,51,49,12,4,8,24
S01008199,Good health,195,2,0,2,17,16,13,25,58,38,22,16,6,4
S01008199,Fair health,92,1,0,1,2,9,3,11,28,31,7,6,1,0
S01008199,Bad health,43,0,0,0,1,4,0,6,11,13,8,7,1,0
S01008199,Very bad health,22,0,0,0,0,3,1,4,5,6,3,3,0,0
S01008200,All people aged 16 to 74,441,17,1,16,58,61,29,39,101,98,21,17,4,17
S01008200,Very good health,168,8,0,8,23,25,15,17,33,29,6,5,1,12
S01008200,Good health,153,7,0,7,20,22,9,10,36,40,4,3,1,5
S01008200,Fair health,70,1,1,0,10,9,2,9,16,14,9,7,2,0
S01008200,Bad health,38,0,0,0,5,2,2,3,12,12,2,2,0,0
S01008200,Very bad health,12,1,0,1,0,3,1,0,4,3,0,0,0,0
S01008201,All people aged 16 to 74,582,18,3,15,74,77,21,60,128,122,47,28,19,35
S01008201,Very good health,233,9,0,9,34,30,10,20,47,42,16,12,4,25
S01008201,Good health,201,9,3,6,23,28,7,21,48,43,13,5,8,9
S01008201,Fair health,83,0,0,0,11,7,3,9,21,22,10,5,5,0
S01008201,Bad health,54,0,0,0,6,9,1,10,10,12,5,4,1,1
S01008201,Very bad health,11,0,0,0,0,3,0,0,2,3,3,2,1,0
S01008202,All people aged 16 to 74,425,18,5,13,71,84,24,29,86,70,9,5,4,34
S01008202,Very good health,184,10,4,6,35,40,6,12,29,22,5,2,3,25
S01008202,Good health,150,5,1,4,23,34,12,8,38,21,3,2,1,6
S01008202,Fair health,64,2,0,2,10,10,5,7,12,15,1,1,0,2
S01008202,Bad health,20,1,0,1,2,0,1,1,4,10,0,0,0,1
S01008202,Very bad health,7,0,0,0,1,0,0,1,3,2,0,0,0,0
S01008203,All people aged 16 to 74,424,8,1,7,64,48,31,32,80,98,42,19,23,21
S01008203,Very good health,183,3,0,3,28,24,8,17,33,32,22,9,13,16
S01008203,Good health,143,3,0,3,19,17,17,7,29,39,8,3,5,4
S01008203,Fair health,70,0,0,0,13,5,5,5,15,17,9,4,5,1
S01008203,Bad health,20,1,0,1,3,2,0,2,3,7,2,2,0,0
S01008203,Very bad health,8,1,1,0,1,0,1,1,0,3,1,1,0,0
S01008204,All people aged 16 to 74,640,40,7,33,121,86,53,60,112,112,33,23,10,23
S01008204,Very good health,245,25,3,22,58,30,23,14,45,28,3,2,1,19
S01008204,Good health,204,10,3,7,41,33,19,21,34,35,10,5,5,1
S01008204,Fair health,122,1,0,1,15,13,6,17,22,33,13,10,3,2
S01008204,Bad health,50,3,1,2,6,6,4,6,7,10,7,6,1,1
S01008204,Very bad health,19,1,0,1,1,4,1,2,4,6,0,0,0,0
S01008205,All people aged 16 to 74,512,22,11,11,69,67,38,64,116,87,20,8,12,29
S01008205,Very good health,245,12,6,6,41,37,15,29,46,31,7,4,3,27
S01008205,Good health,166,10,5,5,18,23,13,21,45,29,5,2,3,2
S01008205,Fair health,76,0,0,0,9,5,5,12,17,20,8,2,6,0
S01008205,Bad health,19,0,0,0,0,2,3,2,5,7,0,0,0,0
S01008205,Very bad health,6,0,0,0,1,0,2,0,3,0,0,0,0,0
S01008206,All people aged 16 to 74,464,15,3,12,61,67,32,58,91,100,26,20,6,14
S01008206,Very good health,171,8,1,7,24,25,13,19,33,33,7,5,2,9
S01008206,Good health,172,5,2,3,25,28,13,21,33,35,8,7,1,4
S01008206,Fair health,89,1,0,1,10,9,5,13,20,26,5,3,2,0
S01008206,Bad health,28,0,0,0,2,5,1,5,5,3,6,5,1,1
S01008206,Very bad health,4,1,0,1,0,0,0,0,0,3,0,0,0,0
S01008207,All people aged 16 to 74,434,8,4,4,39,55,35,47,106,95,24,15,9,25
S01008207,Very good health,201,5,2,3,25,28,17,20,43,31,11,7,4,21
S01008207,Good health,143,2,1,1,14,20,12,14,41,32,5,2,3,3
S01008207,Fair health,64,1,1,0,0,4,4,11,16,22,5,3,2,1
S01008207,Bad health,21,0,0,0,0,3,1,1,4,10,2,2,0,0
S01008207,Very bad health,5,0,0,0,0,0,1,1,2,0,1,1,0,0
S01008208,All people aged 16 to 74,607,48,9,39,141,105,47,65,87,68,18,5,13,28
S01008208,Very good health,339,30,3,27,77,58,25,36,46,34,10,4,6,23
S01008208,Good health,197,14,3,11,50,31,15,22,31,25,4,0,4,5
S01008208,Fair health,48,3,2,1,11,10,5,6,7,3,3,1,2,0
S01008208,Bad health,19,1,1,0,3,3,2,1,3,5,1,0,1,0
S01008208,Very bad health,4,0,0,0,0,3,0,0,0,1,0,0,0,0
S01008209,All people aged 16 to 74,408,29,5,24,92,87,47,33,55,28,4,3,1,33
S01008209,Very good health,238,23,5,18,52,46,27,15,30,18,2,2,0,25
S01008209,Good health,134,4,0,4,33,35,16,13,18,7,0,0,0,8
S01008209,Fair health,28,1,0,1,4,5,4,4,6,2,2,1,1,0
S01008209,Bad health,7,1,0,1,3,0,0,1,1,1,0,0,0,0
S01008209,Very bad health,1,0,0,0,0,1,0,0,0,0,0,0,0,0
S01008210,All people aged 16 to 74,685,41,9,32,141,115,71,57,119,85,23,9,14,33
S01008210,Very good health,310,23,5,18,71,48,28,23,48,30,11,4,7,28
S01008210,Good health,223,12,3,9,46,40,26,15,45,29,6,1,5,4
S01008210,Fair health,112,5,1,4,19,20,14,12,19,17,5,3,2,1
S01008210,Bad health,31,1,0,1,4,5,3,4,6,7,1,1,0,0
S01008210,Very bad health,9,0,0,0,1,2,0,3,1,2,0,0,0,0
S01008211,All people aged 16 to 74,665,59,10,49,140,114,70,47,90,76,31,16,15,38
S01008211,Very good health,313,28,4,24,71,58,29,19,40,26,13,5,8,29
S01008211,Good health,231,27,4,23,48,41,20,18,29,31,12,7,5,5
S01008211,Fair health,77,4,2,2,10,11,15,6,13,12,3,1,2,3
S01008211,Bad health,34,0,0,0,10,3,2,3,7,5,3,3,0,1
S01008211,Very bad health,10,0,0,0,1,1,4,1,1,2,0,0,0,0
S01008212,All people aged 16 to 74,433,36,6,30,116,82,35,44,59,25,10,6,4,26
S01008212,Very good health,240,22,5,17,67,49,21,28,22,11,3,1,2,17
S01008212,Good health,160,12,0,12,42,25,12,14,30,12,5,3,2,8
S01008212,Fair health,28,2,1,1,6,7,2,2,5,2,1,1,0,1
S01008212,Bad health,3,0,0,0,1,0,0,0,2,0,0,0,0,0
S01008212,Very bad health,2,0,0,0,0,1,0,0,0,0,1,1,0,0
S01008213,All people aged 16 to 74,745,84,15,69,177,119,57,60,108,60,21,12,9,59
S01008213,Very good health,429,54,9,45,99,74,29,32,51,32,11,7,4,47
S01008213,Good health,236,27,5,22,64,32,16,22,43,15,8,4,4,9
S01008213,Fair health,61,3,1,2,10,11,8,5,11,9,2,1,1,2
S01008213,Bad health,16,0,0,0,4,1,3,1,2,4,0,0,0,1
S01008213,Very bad health,3,0,0,0,0,1,1,0,1,0,0,0,0,0
S01008214,All people aged 16 to 74,506,34,12,22,105,81,43,48,85,73,27,17,10,10
S01008214,Very good health,208,19,7,12,51,38,15,14,27,25,10,8,2,9
S01008214,Good health,174,9,4,5,39,25,16,19,25,30,10,4,6,1
S01008214,Fair health,77,5,1,4,9,15,7,8,19,9,5,3,2,0
S01008214,Bad health,32,0,0,0,5,3,2,5,9,6,2,2,0,0
S01008214,Very bad health,15,1,0,1,1,0,3,2,5,3,0,0,0,0
S01008215,All people aged 16 to 74,553,29,3,26,125,98,40,50,101,55,21,14,7,34
S01008215,Very good health,270,20,1,19,59,55,16,23,41,26,4,1,3,26
S01008215,Good health,198,8,2,6,51,33,20,13,37,18,11,7,4,7
S01008215,Fair health,58,1,0,1,8,7,3,12,16,8,3,3,0,0
S01008215,Bad health,22,0,0,0,4,3,1,1,7,2,3,3,0,1
S01008215,Very bad health,5,0,0,0,3,0,0,1,0,1,0,0,0,0
S01008216,All people aged 16 to 74,396,33,8,25,94,76,38,24,54,29,10,4,6,38
S01008216,Very good health,216,18,5,13,51,44,19,15,22,13,3,2,1,31
S01008216,Good health,138,12,2,10,39,21,13,6,23,13,5,1,4,6
S01008216,Fair health,33,3,1,2,3,9,5,2,6,2,2,1,1,1
S01008216,Bad health,5,0,0,0,1,1,1,0,1,1,0,0,0,0
S01008216,Very bad health,4,0,0,0,0,1,0,1,2,0,0,0,0,0
S01008217,All people aged 16 to 74,438,66,15,51,143,70,41,35,36,20,5,1,4,22
S01008217,Very good health,262,45,9,36,90,33,23,22,17,9,3,1,2,20
S01008217,Good health,127,16,6,10,41,29,11,4,15,7,2,0,2,2
S01008217,Fair health,39,3,0,3,8,7,7,7,4,3,0,0,0,0
S01008217,Bad health,6,0,0,0,3,1,0,1,0,1,0,0,0,0
S01008217,Very bad health,4,2,0,2,1,0,0,1,0,0,0,0,0,0
S01008218,All people aged 16 to 74,790,97,17,80,218,135,84,45,82,60,13,6,7,56
S01008218,Very good health,464,65,10,55,124,76,47,28,35,36,6,3,3,47
S01008218,Good health,252,32,7,25,71,44,27,13,33,20,4,2,2,8
S01008218,Fair health,59,0,0,0,20,12,9,3,10,3,2,0,2,0
S01008218,Bad health,14,0,0,0,3,3,1,1,3,1,1,1,0,1
S01008218,Very bad health,1,0,0,0,0,0,0,0,1,0,0,0,0,0
S01008219,All people aged 16 to 74,752,55,8,47,146,116,78,51,134,93,38,22,16,41
S01008219,Very good health,387,39,5,34,82,59,34,26,60,40,14,5,9,33
S01008219,Good health,235,12,3,9,44,38,29,17,43,36,9,6,3,7
S01008219,Fair health,87,3,0,3,11,15,13,1,22,11,10,8,2,1
S01008219,Bad health,39,1,0,1,8,3,2,7,9,5,4,2,2,0
S01008219,Very bad health,4,0,0,0,1,1,0,0,0,1,1,1,0,0
S01008220,All people aged 16 to 74,440,14,3,11,54,37,24,56,108,82,33,26,7,32
S01008220,Very good health,216,7,2,5,28,18,9,32,46,34,15,10,5,27
S01008220,Good health,138,4,0,4,17,9,10,14,41,29,10,9,1,4
S01008220,Fair health,60,2,0,2,6,6,5,7,15,12,6,5,1,1
S01008220,Bad health,20,0,0,0,3,3,0,3,6,4,1,1,0,0
S01008220,Very bad health,6,1,1,0,0,1,0,0,0,3,1,1,0,0
S01008221,All people aged 16 to 74,500,18,3,15,63,35,37,47,120,94,61,42,19,25
S01008221,Very good health,228,10,1,9,33,20,15,14,57,39,25,18,7,15
S01008221,Good health,161,6,1,5,16,11,15,22,34,34,19,11,8,4
S01008221,Fair health,85,1,1,0,12,3,6,9,22,15,12,9,3,5
S01008221,Bad health,16,1,0,1,1,1,1,2,2,4,3,2,1,1
S01008221,Very bad health,10,0,0,0,1,0,0,0,5,2,2,2,0,0
S01008222,All people aged 16 to 74,428,12,3,9,63,57,28,41,101,81,24,13,11,21
S01008222,Very good health,189,6,0,6,30,27,11,16,42,31,11,10,1,15
S01008222,Good health,143,5,2,3,24,17,8,16,35,25,8,1,7,5
S01008222,Fair health,66,0,0,0,7,8,4,3,18,20,5,2,3,1
S01008222,Bad health,24,1,1,0,1,3,4,4,6,5,0,0,0,0
S01008222,Very bad health,6,0,0,0,1,2,1,2,0,0,0,0,0,0
S01008223,All people aged 16 to 74,434,14,5,9,74,68,20,30,106,71,27,17,10,24
S01008223,Very good health,196,10,3,7,38,32,6,11,47,23,7,2,5,22
S01008223,Good health,133,4,2,2,27,25,6,10,28,21,11,6,5,1
S01008223,Fair health,68,0,0,0,5,6,7,2,18,21,8,8,0,1
S01008223,Bad health,26,0,0,0,4,5,0,5,8,3,1,1,0,0
S01008223,Very bad health,11,0,0,0,0,0,1,2,5,3,0,0,0,0
S01008224,All people aged 16 to 74,731,44,8,36,143,171,52,71,138,66,15,11,4,31
S01008224,Very good health,393,26,6,20,83,101,23,40,64,27,6,5,1,23
S01008224,Good health,239,17,2,15,39,53,20,24,48,26,6,3,3,6
S01008224,Fair health,81,1,0,1,18,14,7,7,21,11,0,0,0,2
S01008224,Bad health,12,0,0,0,2,3,0,0,3,1,3,3,0,0
S01008224,Very bad health,6,0,0,0,1,0,2,0,2,1,0,0,0,0
S01008225,All people aged 16 to 74,558,20,5,15,122,93,32,49,106,83,8,5,3,45
S01008225,Very good health,302,13,2,11,67,38,20,31,55,38,2,2,0,38
S01008225,Good health,166,5,2,3,35,42,8,6,37,21,6,3,3,6
S01008225,Fair health,67,2,1,1,16,12,4,7,7,19,0,0,0,0
S01008225,Bad health,18,0,0,0,3,0,0,4,7,3,0,0,0,1
S01008225,Very bad health,5,0,0,0,1,1,0,1,0,2,0,0,0,0
S01008226,All people aged 16 to 74,521,12,2,10,66,70,37,41,125,109,37,25,12,24
S01008226,Very good health,204,8,0,8,30,31,14,11,39,38,14,10,4,19
S01008226,Good health,206,3,1,2,26,29,15,18,57,41,13,8,5,4
S01008226,Fair health,62,1,1,0,6,5,5,5,17,17,5,3,2,1
S01008226,Bad health,39,0,0,0,4,3,3,5,9,11,4,3,1,0
S01008226,Very bad health,10,0,0,0,0,2,0,2,3,2,1,1,0,0
S01008227,All people aged 16 to 74,621,15,0,15,85,76,34,59,148,157,23,17,6,24
S01008227,Very good health,252,8,0,8,31,31,14,23,63,58,5,5,0,19
S01008227,Good health,239,6,0,6,42,32,15,24,52,55,9,5,4,4
S01008227,Fair health,80,0,0,0,10,7,3,10,24,19,6,4,2,1
S01008227,Bad health,31,1,0,1,0,6,0,1,6,17,0,0,0,0
S01008227,Very bad health,19,0,0,0,2,0,2,1,3,8,3,3,0,0
S01008228,All people aged 16 to 74,479,32,5,27,120,77,62,33,70,46,11,8,3,28
S01008228,Very good health,259,19,4,15,63,40,36,16,37,19,1,0,1,28
S01008228,Good health,150,13,1,12,41,24,22,11,21,16,2,1,1,0
S01008228,Fair health,49,0,0,0,9,11,3,4,8,7,7,6,1,0
S01008228,Bad health,17,0,0,0,7,1,0,1,4,3,1,1,0,0
S01008228,Very bad health,4,0,0,0,0,1,1,1,0,1,0,0,0,0
S01008229,All people aged 16 to 74,516,18,4,14,80,75,28,55,112,111,17,12,5,20
S01008229,Very good health,237,12,3,9,38,32,16,24,52,47,7,3,4,9
S01008229,Good health,170,5,1,4,31,32,8,14,37,34,1,0,1,8
S01008229,Fair health,78,0,0,0,8,10,4,13,16,19,5,5,0,3
S01008229,Bad health,22,1,0,1,2,1,0,2,4,10,2,2,0,0
S01008229,Very bad health,9,0,0,0,1,0,0,2,3,1,2,2,0,0
S01008230,All people aged 16 to 74,604,49,11,38,147,100,61,51,90,52,14,9,5,40
S01008230,Very good health,346,28,8,20,95,58,38,30,40,23,5,4,1,29
S01008230,Good health,198,19,3,16,45,33,16,17,33,21,6,3,3,8
S01008230,Fair health,48,2,0,2,6,6,7,3,14,4,3,2,1,3
S01008230,Bad health,10,0,0,0,1,3,0,1,2,3,0,0,0,0
S01008230,Very bad health,2,0,0,0,0,0,0,0,1,1,0,0,0,0
S01008231,All people aged 16 to 74,521,50,11,39,133,101,58,43,55,38,6,5,1,37
S01008231,Very good health,341,39,9,30,92,67,38,29,29,19,2,2,0,26
S01008231,Good health,150,11,2,9,35,30,18,12,14,17,2,1,1,11
S01008231,Fair health,24,0,0,0,4,3,2,2,10,2,1,1,0,0
S01008231,Bad health,5,0,0,0,2,1,0,0,1,0,1,1,0,0
S01008231,Very bad health,1,0,0,0,0,0,0,0,1,0,0,0,0,0
S01008232,All people aged 16 to 74,480,57,8,49,113,80,35,41,62,46,23,14,9,23
S01008232,Very good health,294,35,3,32,75,56,21,25,34,26,7,5,2,15
S01008232,Good health,139,17,4,13,31,24,11,10,19,13,8,1,7,6
S01008232,Fair health,34,4,1,3,7,0,1,4,7,4,6,6,0,1
S01008232,Bad health,10,1,0,1,0,0,1,2,2,2,1,1,0,1
S01008232,Very bad health,3,0,0,0,0,0,1,0,0,1,1,1,0,0
S01008233,All people aged 16 to 74,344,34,7,27,83,58,34,23,36,46,12,9,3,18
S01008233,Very good health,209,25,6,19,60,32,18,16,17,18,6,5,1,17
S01008233,Good health,109,7,0,7,21,24,14,5,15,19,3,2,1,1
S01008233,Fair health,20,2,1,1,2,2,2,1,3,6,2,1,1,0
S01008233,Bad health,4,0,0,0,0,0,0,1,1,1,1,1,0,0
S01008233,Very bad health,2,0,0,0,0,0,0,0,0,2,0,0,0,0
S01008234,All people aged 16 to 74,298,7,1,6,41,38,24,34,70,58,12,11,1,14
S01008234,Very good health,118,1,1,0,22,17,8,16,18,22,5,4,1,9
S01008234,Good health,98,5,0,5,16,14,10,8,26,15,2,2,0,2
S01008234,Fair health,60,1,0,1,2,6,5,6,18,14,5,5,0,3
S01008234,Bad health,16,0,0,0,1,1,1,2,7,4,0,0,0,0
S01008234,Very bad health,6,0,0,0,0,0,0,2,1,3,0,0,0,0
S01008235,All people aged 16 to 74,597,34,3,31,116,92,49,58,104,96,16,7,9,32
S01008235,Very good health,262,18,2,16,53,42,21,21,41,38,2,1,1,26
S01008235,Good health,204,13,1,12,48,33,16,23,37,26,3,1,2,5
S01008235,Fair health,81,2,0,2,7,10,9,12,16,17,7,2,5,1
S01008235,Bad health,38,1,0,1,7,6,3,2,5,11,3,2,1,0
S01008235,Very bad health,12,0,0,0,1,1,0,0,5,4,1,1,0,0
S01008236,All people aged 16 to 74,627,53,9,44,149,91,66,58,94,63,24,8,16,29
S01008236,Very good health,306,37,7,30,76,40,33,27,33,26,8,1,7,26
S01008236,Good health,214,12,0,12,54,36,21,19,40,16,13,6,7,3
S01008236,Fair health,83,2,1,1,14,14,10,7,15,19,2,0,2,0
S01008236,Bad health,17,0,0,0,5,1,2,4,4,1,0,0,0,0
S01008236,Very bad health,7,2,1,1,0,0,0,1,2,1,1,1,0,0
S01008237,All people aged 16 to 74,647,54,13,41,119,87,76,48,118,86,24,15,9,35
S01008237,Very good health,336,32,12,20,71,47,34,24,55,36,7,5,2,30
S01008237,Good health,215,20,0,20,35,27,27,19,44,28,10,4,6,5
S01008237,Fair health,61,1,1,0,9,9,11,4,13,11,3,2,1,0
S01008237,Bad health,27,1,0,1,2,3,2,1,4,10,4,4,0,0
S01008237,Very bad health,8,0,0,0,2,1,2,0,2,1,0,0,0,0
S01008238,All people aged 16 to 74,551,20,2,18,89,76,38,68,90,113,34,21,13,23
S01008238,Very good health,232,7,1,6,41,43,11,30,35,42,10,6,4,13
S01008238,Good health,208,9,0,9,34,23,19,28,41,37,10,5,5,7
S01008238,Fair health,75,1,0,1,9,6,5,7,9,25,10,6,4,3
S01008238,Bad health,30,3,1,2,4,4,2,2,5,6,4,4,0,0
S01008238,Very bad health,6,0,0,0,1,0,1,1,0,3,0,0,0,0
S01008239,All people aged 16 to 74,570,37,11,26,110,81,70,53,102,83,13,10,3,21
S01008239,Very good health,294,22,6,16,61,49,39,29,39,32,5,3,2,18
S01008239,Good health,198,10,3,7,42,26,22,13,44,34,4,3,1,3
S01008239,Fair health,63,5,2,3,6,5,7,8,15,14,3,3,0,0
S01008239,Bad health,10,0,0,0,1,1,2,2,2,2,0,0,0,0
S01008239,Very bad health,5,0,0,0,0,0,0,1,2,1,1,1,0,0
S01008240,All people aged 16 to 74,666,106,17,89,209,113,73,32,61,35,5,0,5,32
S01008240,Very good health,378,63,6,57,119,58,35,16,33,22,3,0,3,29
S01008240,Good health,223,39,9,30,69,43,26,13,19,9,2,0,2,3
S01008240,Fair health,47,3,2,1,15,9,9,1,7,3,0,0,0,0
S01008240,Bad health,17,1,0,1,5,3,3,2,2,1,0,0,0,0
S01008240,Very bad health,1,0,0,0,1,0,0,0,0,0,0,0,0,0
S01008241,All people aged 16 to 74,501,82,22,60,168,82,55,24,39,16,8,4,4,27
S01008241,Very good health,292,52,10,42,93,49,29,14,21,7,2,2,0,25
S01008241,Good health,168,23,9,14,64,27,19,9,15,6,4,1,3,1
S01008241,Fair health,29,7,3,4,7,5,5,0,1,2,1,1,0,1
S01008241,Bad health,11,0,0,0,4,1,2,0,2,1,1,0,1,0
S01008241,Very bad health,1,0,0,0,0,0,0,1,0,0,0,0,0,0
S01008242,All people aged 16 to 74,645,78,14,64,162,83,73,54,84,63,22,14,8,26
S01008242,Very good health,290,38,8,30,85,34,29,17,33,23,10,4,6,21
S01008242,Good health,228,31,5,26,54,38,27,17,28,20,8,6,2,5
S01008242,Fair health,85,3,0,3,16,8,13,17,15,10,3,3,0,0
S01008242,Bad health,32,5,1,4,2,3,4,3,6,8,1,1,0,0
S01008242,Very bad health,10,1,0,1,5,0,0,0,2,2,0,0,0,0
S01008243,All people aged 16 to 74,647,105,17,88,190,71,78,36,77,43,10,8,2,37
S01008243,Very good health,377,63,9,54,124,39,49,19,30,20,3,3,0,30
S01008243,Good health,198,35,8,27,52,20,21,11,35,12,5,4,1,7
S01008243,Fair health,58,5,0,5,12,10,7,3,10,9,2,1,1,0
S01008243,Bad health,10,1,0,1,2,0,1,3,1,2,0,0,0,0
S01008243,Very bad health,4,1,0,1,0,2,0,0,1,0,0,0,0,0
S01008244,All people aged 16 to 74,410,58,9,49,127,41,50,26,43,31,12,7,5,22
S01008244,Very good health,224,37,5,32,74,24,25,12,14,12,7,6,1,19
S01008244,Good health,134,18,4,14,38,14,21,8,18,12,2,0,2,3
S01008244,Fair health,33,2,0,2,11,3,3,3,7,2,2,0,2,0
S01008244,Bad health,14,1,0,1,2,0,0,3,4,3,1,1,0,0
S01008244,Very bad health,5,0,0,0,2,0,1,0,0,2,0,0,0,0
S01008245,All people aged 16 to 74,715,92,15,77,235,86,79,40,93,52,7,3,4,31
S01008245,Very good health,373,57,8,49,128,43,43,19,33,23,2,2,0,25
S01008245,Good health,233,24,4,20,77,32,25,12,40,14,3,0,3,6
S01008245,Fair health,81,9,1,8,20,10,10,6,14,12,0,0,0,0
S01008245,Bad health,23,2,2,0,6,1,1,2,6,3,2,1,1,0
S01008245,Very bad health,5,0,0,0,4,0,0,1,0,0,0,0,0,0
S01008246,All people aged 16 to 74,714,125,22,103,208,94,74,40,71,42,10,6,4,50
S01008246,Very good health,416,94,16,78,122,55,39,17,28,16,4,2,2,41
S01008246,Good health,225,30,6,24,70,28,25,16,32,16,1,0,1,7
S01008246,Fair health,60,1,0,1,14,9,9,5,9,7,4,4,0,2
S01008246,Bad health,8,0,0,0,1,0,0,2,1,3,1,0,1,0
S01008246,Very bad health,5,0,0,0,1,2,1,0,1,0,0,0,0,0
S01008247,All people aged 16 to 74,612,87,25,62,157,62,100,35,77,45,11,7,4,38
S01008247,Very good health,334,61,15,46,93,33,51,16,30,17,4,2,2,29
S01008247,Good health,199,22,8,14,53,17,39,10,34,13,3,2,1,8
S01008247,Fair health,60,4,2,2,7,10,6,7,11,11,3,2,1,1
S01008247,Bad health,15,0,0,0,3,2,2,2,2,3,1,1,0,0
S01008247,Very bad health,4,0,0,0,1,0,2,0,0,1,0,0,0,0
S01008248,All people aged 16 to 74,665,85,14,71,153,60,96,54,91,65,21,13,8,40
S01008248,Very good health,365,54,8,46,84,37,48,29,44,29,10,4,6,30
S01008248,Good health,219,28,5,23,57,18,33,16,33,23,4,2,2,7
S01008248,Fair health,56,2,1,1,9,2,11,7,10,9,3,3,0,3
S01008248,Bad health,21,1,0,1,1,3,4,1,4,4,3,3,0,0
S01008248,Very bad health,4,0,0,0,2,0,0,1,0,0,1,1,0,0
S01008249,All people aged 16 to 74,674,107,28,79,191,68,111,39,71,41,13,8,5,33
S01008249,Very good health,397,74,18,56,114,40,62,25,32,19,4,3,1,27
S01008249,Good health,194,25,8,17,57,23,33,9,22,16,6,3,3,3
S01008249,Fair health,65,6,1,5,15,4,15,5,11,5,2,1,1,2
S01008249,Bad health,13,1,0,1,4,1,1,0,4,1,0,0,0,1
S01008249,Very bad health,5,1,1,0,1,0,0,0,2,0,1,1,0,0
S01008250,All people aged 16 to 74,773,142,25,117,232,91,101,26,78,33,21,14,7,49
S01008250,Very good health,453,86,13,73,144,55,56,12,34,20,7,4,3,39
S01008250,Good health,238,48,9,39,65,26,36,8,31,7,9,7,2,8
S01008250,Fair health,70,7,3,4,21,7,7,4,13,4,5,3,2,2
S01008250,Bad health,7,0,0,0,1,2,1,1,0,2,0,0,0,0
S01008250,Very bad health,5,1,0,1,1,1,1,1,0,0,0,0,0,0
S01008251,All people aged 16 to 74,518,112,16,96,158,75,38,21,41,22,6,3,3,45
S01008251,Very good health,329,68,12,56,107,49,18,13,19,11,2,0,2,42
S01008251,Good health,149,37,2,35,38,16,19,5,19,9,3,2,1,3
S01008251,Fair health,37,7,2,5,13,8,1,3,2,2,1,1,0,0
S01008251,Bad health,2,0,0,0,0,2,0,0,0,0,0,0,0,0
S01008251,Very bad health,1,0,0,0,0,0,0,0,1,0,0,0,0,0
S01008252,All people aged 16 to 74,612,74,14,60,201,99,46,37,66,39,10,5,5,40
S01008252,Very good health,343,48,9,39,121,44,27,14,30,19,2,1,1,38
S01008252,Good health,213,18,4,14,66,45,16,18,26,17,6,2,4,1
S01008252,Fair health,43,7,1,6,13,7,3,5,3,2,2,2,0,1
S01008252,Bad health,9,1,0,1,1,1,0,0,5,1,0,0,0,0
S01008252,Very bad health,4,0,0,0,0,2,0,0,2,0,0,0,0,0
S01008253,All people aged 16 to 74,550,29,5,24,114,67,38,55,101,101,26,16,10,19
S01008253,Very good health,207,11,1,10,49,28,20,15,33,32,5,2,3,14
S01008253,Good health,205,14,2,12,36,22,14,29,39,41,7,3,4,3
S01008253,Fair health,90,4,2,2,19,9,2,7,18,22,8,5,3,1
S01008253,Bad health,31,0,0,0,6,6,2,0,8,4,4,4,0,1
S01008253,Very bad health,17,0,0,0,4,2,0,4,3,2,2,2,0,0
S01008254,All people aged 16 to 74,710,40,6,34,137,81,47,83,130,115,38,25,13,39
S01008254,Very good health,323,27,3,24,64,39,19,39,46,48,11,6,5,30
S01008254,Good health,270,10,2,8,51,28,16,32,63,47,16,11,5,7
S01008254,Fair health,82,3,1,2,17,8,6,9,19,11,8,5,3,1
S01008254,Bad health,20,0,0,0,4,3,3,2,2,4,1,1,0,1
S01008254,Very bad health,15,0,0,0,1,3,3,1,0,5,2,2,0,0
S01008255,All people aged 16 to 74,527,39,6,33,125,78,42,38,98,52,20,16,4,35
S01008255,Very good health,252,21,2,19,62,37,12,18,48,26,3,2,1,25
S01008255,Good health,195,15,3,12,49,32,20,15,33,17,5,5,0,9
S01008255,Fair health,59,2,1,1,11,6,10,2,15,4,8,5,3,1
S01008255,Bad health,16,1,0,1,3,3,0,1,1,3,4,4,0,0
S01008255,Very bad health,5,0,0,0,0,0,0,2,1,2,0,0,0,0
S01008256,All people aged 16 to 74,615,33,3,30,89,62,55,55,128,112,37,21,16,44
S01008256,Very good health,266,18,3,15,43,28,28,22,51,30,15,8,7,31
S01008256,Good health,236,13,0,13,38,24,17,26,49,43,13,7,6,13
S01008256,Fair health,74,2,0,2,7,6,8,4,15,27,5,3,2,0
S01008256,Bad health,32,0,0,0,1,4,2,2,12,9,2,2,0,0
S01008256,Very bad health,7,0,0,0,0,0,0,1,1,3,2,1,1,0
S01008257,All people aged 16 to 74,401,42,7,35,98,42,41,27,59,58,17,14,3,17
S01008257,Very good health,198,23,1,22,51,20,25,11,32,19,7,6,1,10
S01008257,Good health,136,16,5,11,36,17,11,12,14,18,6,4,2,6
S01008257,Fair health,49,2,0,2,9,4,4,2,9,15,3,3,0,1
S01008257,Bad health,13,1,1,0,1,0,1,2,4,3,1,1,0,0
S01008257,Very bad health,5,0,0,0,1,1,0,0,0,3,0,0,0,0
S01008258,All people aged 16 to 74,646,71,15,56,162,101,50,48,102,64,11,7,4,37
S01008258,Very good health,344,38,6,32,105,54,15,22,49,31,3,3,0,27
S01008258,Good health,225,22,6,16,46,32,26,20,38,26,6,3,3,9
S01008258,Fair health,55,9,3,6,8,11,7,3,10,5,2,1,1,0
S01008258,Bad health,14,2,0,2,3,2,1,2,3,0,0,0,0,1
S01008258,Very bad health,8,0,0,0,0,2,1,1,2,2,0,0,0,0
S01008259,All people aged 16 to 74,558,70,20,50,150,56,72,37,76,54,17,9,8,26
S01008259,Very good health,291,47,11,36,90,22,42,14,31,23,3,2,1,19
S01008259,Good health,187,20,8,12,41,30,20,16,29,17,8,5,3,6
S01008259,Fair health,61,2,1,1,15,3,7,6,13,9,5,2,3,1
S01008259,Bad health,14,0,0,0,3,1,3,1,2,3,1,0,1,0
S01008259,Very bad health,5,1,0,1,1,0,0,0,1,2,0,0,0,0
S01008260,All people aged 16 to 74,611,34,10,24,119,65,35,60,148,92,29,20,9,29
S01008260,Very good health,293,20,4,16,76,32,16,23,60,35,9,5,4,22
S01008260,Good health,204,11,4,7,31,25,14,27,57,21,11,8,3,7
S01008260,Fair health,80,2,1,1,10,6,3,8,23,21,7,5,2,0
S01008260,Bad health,29,1,1,0,2,2,2,1,6,13,2,2,0,0
S01008260,Very bad health,5,0,0,0,0,0,0,1,2,2,0,0,0,0
S01008261,All people aged 16 to 74,659,29,8,21,105,62,55,64,135,131,38,24,14,40
S01008261,Very good health,295,11,1,10,59,35,19,20,63,45,14,8,6,29
S01008261,Good health,230,15,6,9,30,19,18,30,47,51,10,4,6,10
S01008261,Fair health,75,2,0,2,8,4,13,11,8,21,7,6,1,1
S01008261,Bad health,45,0,0,0,8,3,3,3,13,11,4,3,1,0
S01008261,Very bad health,14,1,1,0,0,1,2,0,4,3,3,3,0,0
S01008262,All people aged 16 to 74,467,72,14,58,108,38,67,39,72,36,8,5,3,27
S01008262,Very good health,272,53,9,44,64,14,39,21,38,18,3,2,1,22
S01008262,Good health,136,13,3,10,31,16,18,14,25,11,3,2,1,5
S01008262,Fair health,42,5,1,4,6,6,8,4,7,4,2,1,1,0
S01008262,Bad health,13,1,1,0,4,1,2,0,2,3,0,0,0,0
S01008262,Very bad health,4,0,0,0,3,1,0,0,0,0,0,0,0,0
S01008263,All people aged 16 to 74,426,90,14,76,116,54,46,26,45,22,8,7,1,19
S01008263,Very good health,225,48,3,45,70,27,26,9,19,5,4,3,1,17
S01008263,Good health,137,35,10,25,33,16,13,11,20,7,1,1,0,1
S01008263,Fair health,37,5,1,4,6,6,6,5,3,4,2,2,0,0
S01008263,Bad health,21,2,0,2,6,4,0,0,2,6,0,0,0,1
S01008263,Very bad health,6,0,0,0,1,1,1,1,1,0,1,1,0,0
S01008264,All people aged 16 to 74,506,50,9,41,109,62,42,51,89,61,20,11,9,22
S01008264,Very good health,257,34,5,29,62,25,18,27,44,23,6,3,3,18
S01008264,Good health,166,14,4,10,23,26,18,18,31,24,9,3,6,3
S01008264,Fair health,67,2,0,2,19,10,5,4,9,12,5,5,0,1
S01008264,Bad health,15,0,0,0,5,1,1,1,5,2,0,0,0,0
S01008264,Very bad health,1,0,0,0,0,0,0,1,0,0,0,0,0,0
S01008265,All people aged 16 to 74,453,87,12,75,136,71,45,24,37,26,7,4,3,20
S01008265,Very good health,271,56,8,48,87,36,31,14,19,14,2,1,1,12
S01008265,Good health,144,28,3,25,39,28,11,6,14,9,3,2,1,6
S01008265,Fair health,29,3,1,2,7,5,2,3,3,3,2,1,1,1
S01008265,Bad health,7,0,0,0,2,2,1,0,1,0,0,0,0,1
S01008265,Very bad health,2,0,0,0,1,0,0,1,0,0,0,0,0,0
S01008266,All people aged 16 to 74,473,119,30,89,145,55,50,18,35,18,9,6,3,24
S01008266,Very good health,281,73,21,52,91,32,27,9,18,8,4,2,2,19
S01008266,Good health,154,38,9,29,45,19,16,6,15,7,3,3,0,5
S01008266,Fair health,32,7,0,7,9,2,7,1,1,3,2,1,1,0
S01008266,Bad health,5,1,0,1,0,2,0,1,1,0,0,0,0,0
S01008266,Very bad health,1,0,0,0,0,0,0,1,0,0,0,0,0,0
S01008267,All people aged 16 to 74,606,97,26,71,157,68,80,46,75,46,10,6,4,27
S01008267,Very good health,356,68,21,47,107,38,46,18,29,20,5,3,2,25
S01008267,Good health,177,19,3,16,37,20,27,19,32,20,1,0,1,2
S01008267,Fair health,52,7,1,6,11,5,4,6,11,4,4,3,1,0
S01008267,Bad health,17,1,0,1,1,5,3,2,3,2,0,0,0,0
S01008267,Very bad health,4,2,1,1,1,0,0,1,0,0,0,0,0,0
S01008268,All people aged 16 to 74,595,145,27,118,190,65,66,34,39,20,4,0,4,32
S01008268,Very good health,395,95,12,83,122,35,52,20,23,15,2,0,2,31
S01008268,Good health,163,42,12,30,58,21,13,12,11,4,1,0,1,1
S01008268,Fair health,29,7,3,4,6,7,1,2,4,1,1,0,1,0
S01008268,Bad health,5,1,0,1,2,2,0,0,0,0,0,0,0,0
S01008268,Very bad health,3,0,0,0,2,0,0,0,1,0,0,0,0,0
S01008269,All people aged 16 to 74,507,97,23,74,161,62,45,21,55,21,13,10,3,32
S01008269,Very good health,295,58,13,45,97,30,26,9,26,12,9,6,3,28
S01008269,Good health,163,34,8,26,47,24,13,10,23,6,2,2,0,4
S01008269,Fair health,39,4,2,2,15,6,4,2,4,2,2,2,0,0
S01008269,Bad health,7,0,0,0,2,1,1,0,2,1,0,0,0,0
S01008269,Very bad health,3,1,0,1,0,1,1,0,0,0,0,0,0,0
S01008270,All people aged 16 to 74,516,95,16,79,186,57,54,17,32,29,16,7,9,30
S01008270,Very good health,308,66,8,58,109,30,29,9,18,17,5,3,2,25
S01008270,Good health,145,25,7,18,52,19,16,5,8,8,8,2,6,4
S01008270,Fair health,46,3,1,2,19,5,8,3,4,2,1,0,1,1
S01008270,Bad health,14,1,0,1,4,3,1,0,2,2,1,1,0,0
S01008270,Very bad health,3,0,0,0,2,0,0,0,0,0,1,1,0,0
S01008271,All people aged 16 to 74,507,46,8,38,136,52,65,42,65,34,32,19,13,35
S01008271,Very good health,260,26,5,21,82,26,29,20,30,13,13,7,6,21
S01008271,Good health,158,12,3,9,40,19,26,14,19,12,9,4,5,7
S01008271,Fair health,66,5,0,5,8,5,9,5,13,8,7,5,2,6
S01008271,Bad health,16,0,0,0,4,2,1,2,3,1,3,3,0,0
S01008271,Very bad health,7,3,0,3,2,0,0,1,0,0,0,0,0,1
S01008272,All people aged 16 to 74,737,110,24,86,200,76,82,49,106,49,10,7,3,55
S01008272,Very good health,419,76,17,59,129,38,43,20,46,22,2,1,1,43
S01008272,Good health,217,26,6,20,53,29,25,17,40,13,4,3,1,10
S01008272,Fair health,68,5,0,5,11,8,10,6,15,10,2,2,0,1
S01008272,Bad health,27,3,1,2,5,1,3,4,5,4,2,1,1,0
S01008272,Very bad health,6,0,0,0,2,0,1,2,0,0,0,0,0,1
S01008273,All people aged 16 to 74,593,101,22,79,175,70,44,33,82,32,13,10,3,43
S01008273,Very good health,328,63,13,50,108,30,23,17,34,12,4,3,1,37
S01008273,Good health,196,31,8,23,48,28,16,10,37,15,5,3,2,6
S01008273,Fair health,59,7,1,6,16,9,5,4,11,5,2,2,0,0
S01008273,Bad health,7,0,0,0,2,2,0,1,0,0,2,2,0,0
S01008273,Very bad health,3,0,0,0,1,1,0,1,0,0,0,0,0,0
S01008274,All people aged 16 to 74,516,41,7,34,89,48,49,61,118,63,19,9,10,28
S01008274,Very good health,228,22,4,18,38,22,24,27,49,16,6,2,4,24
S01008274,Good health,193,14,2,12,30,20,18,21,46,31,9,5,4,4
S01008274,Fair health,69,3,1,2,15,5,5,9,16,14,2,0,2,0
S01008274,Bad health,19,1,0,1,4,1,1,3,5,2,2,2,0,0
S01008274,Very bad health,7,1,0,1,2,0,1,1,2,0,0,0,0,0
S01008275,All people aged 16 to 74,392,79,16,63,109,37,36,23,37,38,9,6,3,24
S01008275,Very good health,207,52,9,43,50,25,21,8,12,16,2,1,1,21
S01008275,Good health,128,17,3,14,48,9,12,11,15,12,2,0,2,2
S01008275,Fair health,41,9,3,6,7,1,3,2,7,8,3,3,0,1
S01008275,Bad health,12,0,0,0,3,1,0,2,3,1,2,2,0,0
S01008275,Very bad health,4,1,1,0,1,1,0,0,0,1,0,0,0,0
S01008276,All people aged 16 to 74,402,74,14,60,107,50,45,26,43,25,10,8,2,22
S01008276,Very good health,230,52,11,41,62,31,26,8,18,13,4,3,1,16
S01008276,Good health,128,21,3,18,31,14,12,14,18,10,3,2,1,5
S01008276,Fair health,34,1,0,1,12,5,5,3,4,1,2,2,0,1
S01008276,Bad health,7,0,0,0,1,0,2,0,3,0,1,1,0,0
S01008276,Very bad health,3,0,0,0,1,0,0,1,0,1,0,0,0,0
S01008277,All people aged 16 to 74,371,56,12,44,111,30,75,19,32,16,12,6,6,20
S01008277,Very good health,211,30,7,23,64,18,40,13,17,7,6,3,3,16
S01008277,Good health,132,24,5,19,40,8,30,4,11,7,5,2,3,3
S01008277,Fair health,26,2,0,2,6,4,5,2,4,1,1,1,0,1
S01008277,Bad health,2,0,0,0,1,0,0,0,0,1,0,0,0,0
S01008277,Very bad health,0,0,0,0,0,0,0,0,0,0,0,0,0,0
S01008278,All people aged 16 to 74,569,123,23,100,174,55,74,21,53,30,11,6,5,28
S01008278,Very good health,330,80,14,66,96,36,46,10,25,9,4,2,2,24
S01008278,Good health,185,36,5,31,66,12,23,8,22,12,3,1,2,3
S01008278,Fair health,40,4,2,2,8,7,5,1,5,6,3,2,1,1
S01008278,Bad health,9,3,2,1,3,0,0,1,1,1,0,0,0,0
S01008278,Very bad health,5,0,0,0,1,0,0,1,0,2,1,1,0,0
S01008279,All people aged 16 to 74,522,46,10,36,123,67,51,35,90,71,13,5,8,26
S01008279,Very good health,272,26,5,21,80,37,25,19,31,26,9,5,4,19
S01008279,Good health,176,16,4,12,33,18,17,12,41,32,2,0,2,5
S01008279,Fair health,46,3,1,2,5,10,5,3,10,7,2,0,2,1
S01008279,Bad health,21,1,0,1,4,2,4,0,5,5,0,0,0,0
S01008279,Very bad health,7,0,0,0,1,0,0,1,3,1,0,0,0,1
S01008280,All people aged 16 to 74,689,98,16,82,177,64,102,53,88,56,18,5,13,33
S01008280,Very good health,371,67,10,57,102,37,60,21,34,19,7,2,5,24
S01008280,Good health,221,23,4,19,60,20,32,17,36,19,8,1,7,6
S01008280,Fair health,76,7,2,5,11,5,8,13,12,16,2,1,1,2
S01008280,Bad health,15,1,0,1,3,2,1,2,3,1,1,1,0,1
S01008280,Very bad health,6,0,0,0,1,0,1,0,3,1,0,0,0,0
S01008281,All people aged 16 to 74,547,72,17,55,145,57,78,35,74,44,19,10,9,23
S01008281,Very good health,303,39,5,34,82,28,41,26,39,23,7,2,5,18
S01008281,Good health,176,24,11,13,49,18,31,4,26,14,7,3,4,3
S01008281,Fair health,45,6,1,5,10,9,5,2,5,3,3,3,0,2
S01008281,Bad health,18,3,0,3,4,0,0,3,3,3,2,2,0,0
S01008281,Very bad health,5,0,0,0,0,2,1,0,1,1,0,0,0,0
S01008282,All people aged 16 to 74,536,56,13,43,122,64,93,38,75,56,12,7,5,20
S01008282,Very good health,275,37,6,31,68,31,45,20,35,19,3,1,2,17
S01008282,Good health,182,16,6,10,36,27,29,10,27,29,5,5,0,3
S01008282,Fair health,64,2,0,2,13,3,18,8,12,5,3,0,3,0
S01008282,Bad health,10,1,1,0,5,2,1,0,0,1,0,0,0,0
S01008282,Very bad health,5,0,0,0,0,1,0,0,1,2,1,1,0,0
S01008283,All people aged 16 to 74,369,69,10,59,90,51,42,19,40,17,12,3,9,29
S01008283,Very good health,224,49,5,44,59,32,23,8,17,6,7,2,5,23
S01008283,Good health,114,20,5,15,24,14,15,8,19,6,3,1,2,5
S01008283,Fair health,21,0,0,0,5,4,3,2,2,3,1,0,1,1
S01008283,Bad health,10,0,0,0,2,1,1,1,2,2,1,0,1,0
S01008283,Very bad health,0,0,0,0,0,0,0,0,0,0,0,0,0,0
S01008284,All people aged 16 to 74,618,71,17,54,152,78,62,47,80,82,18,10,8,28
S01008284,Very good health,347,51,10,41,89,45,42,23,37,31,6,1,5,23
S01008284,Good health,189,17,5,12,54,24,13,16,27,28,5,2,3,5
S01008284,Fair health,56,1,0,1,5,8,4,6,9,19,4,4,0,0
S01008284,Bad health,20,2,2,0,3,0,2,2,6,4,1,1,0,0
S01008284,Very bad health,6,0,0,0,1,1,1,0,1,0,2,2,0,0
S01008285,All people aged 16 to 74,552,20,3,17,68,59,45,66,132,116,23,13,10,23
S01008285,Very good health,219,9,2,7,27,28,19,27,38,39,10,6,4,22
S01008285,Good health,194,8,1,7,29,19,14,20,58,40,5,2,3,1
S01008285,Fair health,96,3,0,3,7,7,9,15,27,24,4,2,2,0
S01008285,Bad health,35,0,0,0,4,3,3,4,6,11,4,3,1,0
S01008285,Very bad health,8,0,0,0,1,2,0,0,3,2,0,0,0,0
S01008286,All people aged 16 to 74,537,31,8,23,93,55,42,55,97,112,14,9,5,38
S01008286,Very good health,253,21,5,16,47,28,16,21,39,50,3,2,1,28
S01008286,Good health,201,6,2,4,36,18,18,26,41,42,6,4,2,8
S01008286,Fair health,64,3,1,2,10,7,4,6,11,16,5,3,2,2
S01008286,Bad health,12,1,0,1,0,1,2,2,4,2,0,0,0,0
S01008286,Very bad health,7,0,0,0,0,1,2,0,2,2,0,0,0,0
S01008287,All people aged 16 to 74,567,49,15,34,120,63,40,47,87,88,29,16,13,44
S01008287,Very good health,289,32,7,25,68,28,20,17,37,38,13,8,5,36
S01008287,Good health,191,15,6,9,33,25,15,23,32,29,11,6,5,8
S01008287,Fair health,69,1,1,0,16,8,4,5,14,18,3,0,3,0
S01008287,Bad health,15,1,1,0,2,2,1,2,4,2,1,1,0,0
S01008287,Very bad health,3,0,0,0,1,0,0,0,0,1,1,1,0,0
S01008288,All people aged 16 to 74,630,76,14,62,150,64,65,48,92,76,26,15,11,33
S01008288,Very good health,309,47,10,37,77,27,27,22,47,26,9,4,5,27
S01008288,Good health,213,21,3,18,53,29,25,18,25,31,6,4,2,5
S01008288,Fair health,83,5,0,5,13,6,10,7,18,15,9,6,3,0
S01008288,Bad health,17,1,0,1,5,1,3,1,2,4,0,0,0,0
S01008288,Very bad health,8,2,1,1,2,1,0,0,0,0,2,1,1,1
S01008289,All people aged 16 to 74,495,27,8,19,105,67,48,56,85,80,13,9,4,14
S01008289,Very good health,207,11,2,9,52,30,19,23,29,30,2,2,0,11
S01008289,Good health,186,14,6,8,33,27,20,21,33,31,5,2,3,2
S01008289,Fair health,67,2,0,2,11,5,8,9,15,12,5,4,1,0
S01008289,Bad health,29,0,0,0,8,5,1,2,8,5,0,0,0,0
S01008289,Very bad health,6,0,0,0,1,0,0,1,0,2,1,1,0,1
S01008290,All people aged 16 to 74,644,83,21,62,157,67,75,48,87,57,32,19,13,38
S01008290,Very good health,323,45,11,34,81,30,36,17,47,33,5,2,3,29
S01008290,Good health,229,28,8,20,63,25,29,20,26,14,15,12,3,9
S01008290,Fair health,69,5,1,4,11,10,9,8,12,6,8,3,5,0
S01008290,Bad health,13,2,0,2,1,1,1,3,1,2,2,0,2,0
S01008290,Very bad health,10,3,1,2,1,1,0,0,1,2,2,2,0,0
S01008291,All people aged 16 to 74,509,44,12,32,98,93,33,62,95,59,11,5,6,14
S01008291,Very good health,231,23,5,18,43,45,13,27,44,23,4,1,3,9
S01008291,Good health,196,15,5,10,42,38,14,25,34,20,5,3,2,3
S01008291,Fair health,64,6,2,4,10,7,4,7,14,12,2,1,1,2
S01008291,Bad health,15,0,0,0,3,3,2,3,2,2,0,0,0,0
S01008291,Very bad health,3,0,0,0,0,0,0,0,1,2,0,0,0,0
S01008292,All people aged 16 to 74,569,43,7,36,98,61,42,40,113,104,35,22,13,33
S01008292,Very good health,294,25,4,21,57,36,24,21,46,45,15,9,6,25
S01008292,Good health,183,15,2,13,25,18,11,14,45,40,8,4,4,7
S01008292,Fair health,55,2,0,2,12,5,4,4,15,7,5,2,3,1
S01008292,Bad health,30,0,0,0,4,2,2,1,6,10,5,5,0,0
S01008292,Very bad health,7,1,1,0,0,0,1,0,1,2,2,2,0,0
S01008293,All people aged 16 to 74,415,84,13,71,123,69,36,19,36,13,6,3,3,29
S01008293,Very good health,268,57,10,47,79,41,23,9,26,4,1,0,1,28
S01008293,Good health,122,20,3,17,38,24,12,9,6,8,4,2,2,1
S01008293,Fair health,24,7,0,7,6,4,1,1,3,1,1,1,0,0
S01008293,Bad health,1,0,0,0,0,0,0,0,1,0,0,0,0,0
S01008293,Very bad health,0,0,0,0,0,0,0,0,0,0,0,0,0,0
S01008294,All people aged 16 to 74,643,94,16,78,161,91,51,55,78,62,18,12,6,33
S01008294,Very good health,379,52,10,42,108,57,30,30,35,29,12,7,5,26
S01008294,Good health,200,39,6,33,39,27,18,18,31,20,3,3,0,5
S01008294,Fair health,48,2,0,2,12,5,1,5,9,11,2,2,0,1
S01008294,Bad health,13,1,0,1,2,2,2,1,3,1,1,0,1,0
S01008294,Very bad health,3,0,0,0,0,0,0,1,0,1,0,0,0,1
S01008295,All people aged 16 to 74,765,52,11,41,174,138,42,85,121,66,17,12,5,70
S01008295,Very good health,409,34,6,28,101,70,15,39,52,31,7,5,2,60
S01008295,Good health,257,13,3,10,55,51,15,40,46,21,7,4,3,9
S01008295,Fair health,75,4,2,2,13,10,9,5,21,10,2,2,0,1
S01008295,Bad health,19,0,0,0,5,7,2,1,0,3,1,1,0,0
S01008295,Very bad health,5,1,0,1,0,0,1,0,2,1,0,0,0,0
S01008296,All people aged 16 to 74,477,31,5,26,79,57,38,46,86,58,35,24,11,47
S01008296,Very good health,212,15,1,14,42,20,10,14,32,20,24,16,8,35
S01008296,Good health,172,15,4,11,24,27,16,20,34,19,7,4,3,10
S01008296,Fair health,69,0,0,0,10,8,10,6,16,14,3,3,0,2
S01008296,Bad health,13,1,0,1,2,2,1,0,3,3,1,1,0,0
S01008296,Very bad health,11,0,0,0,1,0,1,6,1,2,0,0,0,0
S01008297,All people aged 16 to 74,551,50,8,42,145,92,40,40,67,50,22,14,8,45
S01008297,Very good health,344,36,5,31,97,53,26,21,37,22,14,10,4,38
S01008297,Good health,134,11,3,8,37,23,8,13,18,13,4,1,3,7
S01008297,Fair health,44,3,0,3,6,12,4,3,9,5,2,1,1,0
S01008297,Bad health,26,0,0,0,5,4,1,2,3,9,2,2,0,0
S01008297,Very bad health,3,0,0,0,0,0,1,1,0,1,0,0,0,0
S01008298,All people aged 16 to 74,567,38,7,31,133,88,49,55,86,44,25,19,6,49
S01008298,Very good health,278,25,3,22,65,39,26,26,43,14,2,0,2,38
S01008298,Good health,209,10,3,7,53,33,17,24,34,17,12,8,4,9
S01008298,Fair health,55,1,0,1,15,13,5,1,7,8,4,4,0,1
S01008298,Bad health,21,2,1,1,0,3,1,3,2,4,5,5,0,1
S01008298,Very bad health,4,0,0,0,0,0,0,1,0,1,2,2,0,0
S01008299,All people aged 16 to 74,551,27,7,20,105,62,34,40,106,85,53,28,25,39
S01008299,Very good health,208,14,3,11,49,30,8,10,35,22,11,3,8,29
S01008299,Good health,200,9,2,7,39,21,16,20,32,31,24,13,11,8
S01008299,Fair health,88,3,1,2,11,9,6,4,22,19,13,8,5,1
S01008299,Bad health,42,1,1,0,6,2,3,5,14,7,3,2,1,1
S01008299,Very bad health,13,0,0,0,0,0,1,1,3,6,2,2,0,0
S01008300,All people aged 16 to 74,644,25,8,17,125,81,46,50,134,70,50,30,20,63
S01008300,Very good health,294,12,3,9,59,40,19,18,46,28,22,9,13,50
S01008300,Good health,203,8,2,6,45,25,18,15,54,17,9,6,3,12
S01008300,Fair health,90,1,1,0,16,8,8,13,20,11,12,8,4,1
S01008300,Bad health,40,3,1,2,4,6,0,4,10,8,5,5,0,0
S01008300,Very bad health,17,1,1,0,1,2,1,0,4,6,2,2,0,0
S01008301,All people aged 16 to 74,666,65,12,53,151,131,51,52,84,54,19,10,9,59
S01008301,Very good health,342,37,8,29,77,69,23,25,36,20,8,4,4,47
S01008301,Good health,235,24,4,20,56,51,22,19,29,19,6,2,4,9
S01008301,Fair health,61,3,0,3,12,9,4,5,15,8,3,3,0,2
S01008301,Bad health,19,1,0,1,3,1,0,3,2,7,2,1,1,0
S01008301,Very bad health,9,0,0,0,3,1,2,0,2,0,0,0,0,1
S01008302,All people aged 16 to 74,559,99,20,79,151,73,76,26,45,32,8,5,3,49
S01008302,Very good health,322,58,10,48,92,43,36,13,19,16,5,3,2,40
S01008302,Good health,173,33,8,25,41,21,30,11,17,10,1,0,1,9
S01008302,Fair health,48,6,1,5,17,6,6,0,8,3,2,2,0,0
S01008302,Bad health,12,2,1,1,1,0,3,2,1,3,0,0,0,0
S01008302,Very bad health,4,0,0,0,0,3,1,0,0,0,0,0,0,0
S01008303,All people aged 16 to 74,422,40,8,32,76,82,31,33,66,45,15,7,8,34
S01008303,Very good health,228,24,4,20,50,47,14,16,27,17,3,1,2,30
S01008303,Good health,114,14,4,10,20,19,7,8,22,13,7,4,3,4
S01008303,Fair health,51,1,0,1,3,11,8,7,9,9,3,0,3,0
S01008303,Bad health,21,0,0,0,2,3,1,2,7,4,2,2,0,0
S01008303,Very bad health,8,1,0,1,1,2,1,0,1,2,0,0,0,0
S01008304,All people aged 16 to 74,369,55,9,46,99,54,26,35,37,20,10,8,2,33
S01008304,Very good health,214,34,4,30,59,32,10,17,21,10,4,2,2,27
S01008304,Good health,112,16,4,12,35,16,9,13,9,6,2,2,0,6
S01008304,Fair health,27,4,0,4,3,4,6,3,4,0,3,3,0,0
S01008304,Bad health,12,1,1,0,2,2,0,1,2,3,1,1,0,0
S01008304,Very bad health,4,0,0,0,0,0,1,1,1,1,0,0,0,0
S01008305,All people aged 16 to 74,619,58,18,40,158,121,37,54,85,45,11,6,5,50
S01008305,Very good health,328,35,9,26,84,59,22,28,42,16,2,1,1,40
S01008305,Good health,211,14,6,8,62,44,10,12,34,20,5,2,3,10
S01008305,Fair health,59,6,2,4,11,12,5,9,7,5,4,3,1,0
S01008305,Bad health,18,2,0,2,1,5,0,4,2,4,0,0,0,0
S01008305,Very bad health,3,1,1,0,0,1,0,1,0,0,0,0,0,0
S01008306,All people aged 16 to 74,510,38,3,35,132,92,34,37,70,49,8,7,1,50
S01008306,Very good health,284,17,2,15,71,57,16,22,34,22,2,1,1,43
S01008306,Good health,169,18,0,18,47,26,14,13,26,17,3,3,0,5
S01008306,Fair health,41,3,1,2,9,6,4,2,8,6,1,1,0,2
S01008306,Bad health,14,0,0,0,5,3,0,0,2,3,1,1,0,0
S01008306,Very bad health,2,0,0,0,0,0,0,0,0,1,1,1,0,0
S01008307,All people aged 16 to 74,420,42,10,32,106,94,28,23,52,37,9,2,7,29
S01008307,Very good health,249,27,5,22,57,60,18,12,32,12,6,2,4,25
S01008307,Good health,118,13,4,9,32,27,4,10,14,13,1,0,1,4
S01008307,Fair health,39,2,1,1,14,6,4,0,4,7,2,0,2,0
S01008307,Bad health,10,0,0,0,2,1,1,1,0,5,0,0,0,0
S01008307,Very bad health,4,0,0,0,1,0,1,0,2,0,0,0,0,0
S01008308,All people aged 16 to 74,448,63,13,50,135,83,21,33,47,19,10,7,3,37
S01008308,Very good health,244,39,10,29,69,50,12,12,17,6,6,3,3,33
S01008308,Good health,150,16,2,14,51,27,5,18,20,6,3,3,0,4
S01008308,Fair health,43,8,1,7,13,5,2,3,8,3,1,1,0,0
S01008308,Bad health,11,0,0,0,2,1,2,0,2,4,0,0,0,0
S01008308,Very bad health,0,0,0,0,0,0,0,0,0,0,0,0,0,0
S01008309,All people aged 16 to 74,522,32,9,23,76,71,25,45,102,76,45,30,15,50
S01008309,Very good health,206,17,2,15,36,26,7,18,30,23,14,10,4,35
S01008309,Good health,178,10,3,7,25,24,12,11,39,29,15,7,8,13
S01008309,Fair health,86,4,3,1,10,15,5,7,19,14,11,9,2,1
S01008309,Bad health,39,1,1,0,3,6,1,3,12,8,4,3,1,1
S01008309,Very bad health,13,0,0,0,2,0,0,6,2,2,1,1,0,0
S01008310,All people aged 16 to 74,693,35,7,28,143,110,36,74,103,90,41,21,20,61
S01008310,Very good health,320,26,5,21,80,46,20,26,38,26,9,2,7,49
S01008310,Good health,240,7,1,6,48,45,11,28,42,33,17,7,10,9
S01008310,Fair health,93,0,0,0,15,15,4,14,14,21,9,6,3,1
S01008310,Bad health,33,2,1,1,0,4,1,5,8,5,6,6,0,2
S01008310,Very bad health,7,0,0,0,0,0,0,1,1,5,0,0,0,0
S01008311,All people aged 16 to 74,284,20,5,15,45,44,14,27,52,41,15,6,9,26
S01008311,Very good health,129,9,3,6,28,20,2,14,20,13,3,1,2,20
S01008311,Good health,96,8,2,6,13,16,6,9,22,14,3,1,2,5
S01008311,Fair health,40,2,0,2,3,8,2,1,6,8,9,4,5,1
S01008311,Bad health,14,1,0,1,0,0,4,2,4,3,0,0,0,0
S01008311,Very bad health,5,0,0,0,1,0,0,1,0,3,0,0,0,0
S01008312,All people aged 16 to 74,309,26,3,23,73,54,10,17,56,25,22,16,6,26
S01008312,Very good health,167,17,2,15,49,25,4,10,26,8,5,1,4,23
S01008312,Good health,97,7,1,6,19,21,4,5,17,12,11,10,1,1
S01008312,Fair health,30,2,0,2,5,5,0,0,7,4,5,4,1,2
S01008312,Bad health,14,0,0,0,0,3,2,2,5,1,1,1,0,0
S01008312,Very bad health,1,0,0,0,0,0,0,0,1,0,0,0,0,0
S01008313,All people aged 16 to 74,675,31,11,20,101,69,34,66,163,118,63,45,18,30
S01008313,Very good health,261,12,3,9,47,33,16,25,52,31,20,13,7,25
S01008313,Good health,197,13,6,7,31,21,10,17,59,25,17,10,7,4
S01008313,Fair health,135,5,2,3,13,9,6,16,30,37,18,15,3,1
S01008313,Bad health,63,1,0,1,8,4,1,7,16,22,4,3,1,0
S01008313,Very bad health,19,0,0,0,2,2,1,1,6,3,4,4,0,0
S01008314,All people aged 16 to 74,454,18,4,14,70,54,25,52,104,59,30,14,16,42
S01008314,Very good health,211,13,4,9,26,25,10,26,53,19,12,4,8,27
S01008314,Good health,136,5,0,5,24,16,7,16,31,15,11,5,6,11
S01008314,Fair health,54,0,0,0,12,10,3,4,9,13,3,3,0,0
S01008314,Bad health,43,0,0,0,7,3,4,2,10,10,3,2,1,4
S01008314,Very bad health,10,0,0,0,1,0,1,4,1,2,1,0,1,0
S01008315,All people aged 16 to 74,567,28,4,24,82,75,37,53,112,90,51,30,21,39
S01008315,Very good health,244,12,2,10,46,32,13,19,45,31,18,8,10,28
S01008315,Good health,185,13,2,11,21,24,9,16,43,24,25,16,9,10
S01008315,Fair health,82,2,0,2,10,11,10,10,18,16,5,3,2,0
S01008315,Bad health,41,0,0,0,3,7,5,5,6,11,3,3,0,1
S01008315,Very bad health,15,1,0,1,2,1,0,3,0,8,0,0,0,0
S01008316,All people aged 16 to 74,410,16,1,15,54,33,17,24,74,92,70,53,17,30
S01008316,Very good health,144,11,1,10,24,11,6,6,23,18,26,19,7,19
S01008316,Good health,135,2,0,2,14,14,8,8,29,35,19,13,6,6
S01008316,Fair health,59,2,0,2,8,3,1,6,10,16,11,9,2,2
S01008316,Bad health,50,1,0,1,6,3,1,4,10,15,9,7,2,1
S01008316,Very bad health,22,0,0,0,2,2,1,0,2,8,5,5,0,2
S01008317,All people aged 16 to 74,551,41,8,33,117,72,37,40,88,76,35,26,9,45
S01008317,Very good health,271,26,4,22,65,39,20,18,43,22,4,3,1,34
S01008317,Good health,164,6,1,5,37,23,7,14,31,25,13,9,4,8
S01008317,Fair health,78,7,2,5,12,5,6,4,10,18,15,11,4,1
S01008317,Bad health,30,1,1,0,0,5,3,4,3,10,2,2,0,2
S01008317,Very bad health,8,1,0,1,3,0,1,0,1,1,1,1,0,0
S01008318,All people aged 16 to 74,696,84,26,58,190,115,56,42,83,48,24,19,5,54
S01008318,Very good health,401,47,16,31,120,72,35,19,32,21,8,5,3,47
S01008318,Good health,217,30,8,22,57,30,19,17,39,16,4,3,1,5
S01008318,Fair health,58,3,1,2,10,10,2,5,9,8,10,9,1,1
S01008318,Bad health,14,3,0,3,2,2,0,1,1,3,1,1,0,1
S01008318,Very bad health,6,1,1,0,1,1,0,0,2,0,1,1,0,0
S01008319,All people aged 16 to 74,529,24,2,22,91,95,36,42,105,74,24,16,8,38
S01008319,Very good health,216,14,1,13,49,41,15,9,35,23,5,2,3,25
S01008319,Good health,180,7,1,6,27,36,9,18,41,26,6,2,4,10
S01008319,Fair health,81,2,0,2,11,16,4,12,15,15,4,3,1,2
S01008319,Bad health,34,1,0,1,2,1,5,1,9,6,8,8,0,1
S01008319,Very bad health,18,0,0,0,2,1,3,2,5,4,1,1,0,0
S01008320,All people aged 16 to 74,495,41,13,28,113,67,30,50,94,52,22,16,6,26
S01008320,Very good health,215,15,3,12,54,34,12,16,34,18,11,8,3,21
S01008320,Good health,170,18,4,14,40,20,12,25,32,15,3,0,3,5
S01008320,Fair health,76,7,6,1,15,8,3,6,17,13,7,7,0,0
S01008320,Bad health,29,1,0,1,4,4,3,2,9,5,1,1,0,0
S01008320,Very bad health,5,0,0,0,0,1,0,1,2,1,0,0,0,0
S01008321,All people aged 16 to 74,420,37,10,27,106,75,33,33,47,29,14,11,3,46
S01008321,Very good health,237,25,7,18,62,35,12,21,22,15,4,4,0,41
S01008321,Good health,132,9,2,7,38,28,12,7,19,7,8,5,3,4
S01008321,Fair health,39,2,1,1,5,8,5,4,5,7,2,2,0,1
S01008321,Bad health,9,1,0,1,0,3,3,1,1,0,0,0,0,0
S01008321,Very bad health,3,0,0,0,1,1,1,0,0,0,0,0,0,0
S01008322,All people aged 16 to 74,768,53,11,42,156,140,39,70,132,93,35,17,18,50
S01008322,Very good health,374,29,7,22,89,69,16,37,55,30,12,5,7,37
S01008322,Good health,244,13,2,11,44,54,16,22,46,32,7,3,4,10
S01008322,Fair health,101,6,0,6,19,12,4,7,24,14,14,7,7,1
S01008322,Bad health,38,4,1,3,2,5,2,3,6,13,1,1,0,2
S01008322,Very bad health,11,1,1,0,2,0,1,1,1,4,1,1,0,0
S01008323,All people aged 16 to 74,576,14,4,10,75,70,36,46,130,103,54,31,23,48
S01008323,Very good health,231,8,3,5,37,32,13,11,58,20,21,13,8,31
S01008323,Good health,203,3,0,3,23,23,13,18,45,41,22,12,10,15
S01008323,Fair health,84,2,1,1,9,10,5,7,17,24,8,4,4,2
S01008323,Bad health,48,1,0,1,5,4,3,8,8,17,2,1,1,0
S01008323,Very bad health,10,0,0,0,1,1,2,2,2,1,1,1,0,0
S01008324,All people aged 16 to 74,469,28,7,21,74,60,30,35,95,70,32,19,13,45
S01008324,Very good health,188,17,3,14,34,27,12,11,29,18,12,5,7,28
S01008324,Good health,184,9,2,7,27,25,13,17,41,25,15,11,4,12
S01008324,Fair health,51,1,1,0,10,3,2,6,8,14,3,1,2,4
S01008324,Bad health,34,0,0,0,3,4,2,0,12,12,1,1,0,0
S01008324,Very bad health,12,1,1,0,0,1,1,1,5,1,1,1,0,1
S01008325,All people aged 16 to 74,530,13,2,11,74,70,17,56,103,98,56,39,17,43
S01008325,Very good health,230,6,1,5,40,28,8,26,39,40,15,8,7,28
S01008325,Good health,184,5,0,5,22,28,7,14,41,33,21,14,7,13
S01008325,Fair health,77,0,0,0,9,10,0,10,17,18,11,9,2,2
S01008325,Bad health,34,2,1,1,3,4,1,5,5,7,7,6,1,0
S01008325,Very bad health,5,0,0,0,0,0,1,1,1,0,2,2,0,0
S01008326,All people aged 16 to 74,710,15,4,11,106,95,35,61,171,118,57,32,25,52
S01008326,Very good health,287,8,3,5,48,39,12,22,71,32,18,9,9,37
S01008326,Good health,262,3,0,3,40,41,15,27,69,34,20,12,8,13
S01008326,Fair health,100,4,1,3,14,7,7,6,21,26,15,7,8,0
S01008326,Bad health,50,0,0,0,3,7,0,5,10,20,4,4,0,1
S01008326,Very bad health,11,0,0,0,1,1,1,1,0,6,0,0,0,1
S01008327,All people aged 16 to 74,623,27,6,21,81,96,28,63,133,101,47,27,20,47
S01008327,Very good health,252,12,1,11,37,43,11,25,39,29,20,11,9,36
S01008327,Good health,225,11,3,8,25,37,11,23,58,35,15,7,8,10
S01008327,Fair health,96,1,0,1,13,10,3,10,24,28,6,3,3,1
S01008327,Bad health,43,2,2,0,6,6,2,4,11,8,4,4,0,0
S01008327,Very bad health,7,1,0,1,0,0,1,1,1,1,2,2,0,0
S01008328,All people aged 16 to 74,479,81,9,72,137,71,53,20,37,17,16,12,4,47
S01008328,Very good health,316,57,7,50,93,50,27,12,17,8,10,8,2,42
S01008328,Good health,114,20,1,19,29,16,17,6,11,8,4,3,1,3
S01008328,Fair health,36,4,1,3,12,4,4,2,6,1,2,1,1,1
S01008328,Bad health,9,0,0,0,2,1,3,0,2,0,0,0,0,1
S01008328,Very bad health,4,0,0,0,1,0,2,0,1,0,0,0,0,0
S01008329,All people aged 16 to 74,657,101,15,86,196,100,57,30,58,26,22,14,8,67
S01008329,Very good health,380,58,10,48,116,51,36,17,24,13,13,7,6,52
S01008329,Good health,211,34,5,29,68,32,11,9,29,9,4,3,1,15
S01008329,Fair health,52,4,0,4,8,15,8,4,5,4,4,3,1,0
S01008329,Bad health,11,5,0,5,3,1,2,0,0,0,0,0,0,0
S01008329,Very bad health,3,0,0,0,1,1,0,0,0,0,1,1,0,0
S01008330,All people aged 16 to 74,660,72,19,53,175,109,47,33,91,31,28,16,12,74
S01008330,Very good health,381,48,14,34,103,56,21,19,48,17,7,4,3,62
S01008330,Good health,204,19,3,16,56,42,21,11,30,10,8,4,4,7
S01008330,Fair health,48,5,2,3,11,7,2,2,5,3,9,4,5,4
S01008330,Bad health,21,0,0,0,4,3,3,1,7,0,2,2,0,1
S01008330,Very bad health,6,0,0,0,1,1,0,0,1,1,2,2,0,0
S01008331,All people aged 16 to 74,453,57,8,49,122,59,46,24,58,25,18,11,7,44
S01008331,Very good health,284,41,6,35,68,36,23,16,37,13,8,3,5,42
S01008331,Good health,133,15,2,13,42,17,19,8,17,7,6,4,2,2
S01008331,Fair health,26,1,0,1,9,4,4,0,2,4,2,2,0,0
S01008331,Bad health,8,0,0,0,3,2,0,0,1,1,1,1,0,0
S01008331,Very bad health,2,0,0,0,0,0,0,0,1,0,1,1,0,0
S01008332,All people aged 16 to 74,650,112,17,95,184,81,62,12,76,22,26,21,5,75
S01008332,Very good health,362,69,11,58,99,46,32,6,29,13,8,6,2,60
S01008332,Good health,216,35,6,29,67,27,22,5,35,5,10,8,2,10
S01008332,Fair health,57,8,0,8,15,7,6,1,7,2,6,5,1,5
S01008332,Bad health,13,0,0,0,2,1,2,0,4,2,2,2,0,0
S01008332,Very bad health,2,0,0,0,1,0,0,0,1,0,0,0,0,0
S01008333,All people aged 16 to 74,651,143,38,105,204,77,70,13,56,14,16,11,5,58
S01008333,Very good health,384,88,25,63,132,27,39,9,26,4,8,4,4,51
S01008333,Good health,173,40,9,31,45,33,22,4,13,5,4,3,1,7
S01008333,Fair health,61,10,1,9,22,10,7,0,9,1,2,2,0,0
S01008333,Bad health,26,3,3,0,4,6,1,0,7,3,2,2,0,0
S01008333,Very bad health,7,2,0,2,1,1,1,0,1,1,0,0,0,0
S01008334,All people aged 16 to 74,511,90,12,78,157,58,42,27,50,16,25,18,7,46
S01008334,Very good health,297,47,7,40,93,30,22,11,29,12,14,9,5,39
S01008334,Good health,147,32,4,28,43,15,13,9,18,3,7,5,2,7
S01008334,Fair health,55,10,1,9,18,11,5,5,2,1,3,3,0,0
S01008334,Bad health,8,1,0,1,3,0,2,0,1,0,1,1,0,0
S01008334,Very bad health,4,0,0,0,0,2,0,2,0,0,0,0,0,0
S01008335,All people aged 16 to 74,511,51,8,43,125,72,32,32,86,46,15,9,6,52
S01008335,Very good health,257,33,3,30,75,35,20,12,26,11,5,2,3,40
S01008335,Good health,155,15,5,10,33,21,10,10,34,21,4,2,2,7
S01008335,Fair health,63,3,0,3,13,12,2,4,14,6,5,4,1,4
S01008335,Bad health,25,0,0,0,3,4,0,2,8,6,1,1,0,1
S01008335,Very bad health,11,0,0,0,1,0,0,4,4,2,0,0,0,0
S01008336,All people aged 16 to 74,455,50,10,40,102,65,51,27,60,41,25,16,9,34
S01008336,Very good health,229,30,4,26,60,30,25,11,23,11,8,4,4,31
S01008336,Good health,140,15,3,12,32,21,16,4,25,12,13,9,4,2
S01008336,Fair health,59,5,3,2,6,10,9,3,11,12,2,1,1,1
S01008336,Bad health,20,0,0,0,2,4,1,6,0,5,2,2,0,0
S01008336,Very bad health,7,0,0,0,2,0,0,3,1,1,0,0,0,0
S01008337,All people aged 16 to 74,620,124,20,104,190,82,21,42,62,28,20,13,7,51
S01008337,Very good health,406,88,14,74,127,56,13,27,38,9,7,2,5,41
S01008337,Good health,148,26,3,23,43,20,6,10,13,14,8,7,1,8
S01008337,Fair health,48,8,2,6,13,5,1,4,8,4,4,3,1,1
S01008337,Bad health,13,2,1,1,5,1,0,1,2,0,1,1,0,1
S01008337,Very bad health,5,0,0,0,2,0,1,0,1,1,0,0,0,0
S01008338,All people aged 16 to 74,576,122,17,105,174,72,45,16,48,12,16,13,3,71
S01008338,Very good health,399,95,12,83,115,51,26,9,25,7,9,6,3,62
S01008338,Good health,141,26,4,22,49,18,14,4,17,3,3,3,0,7
S01008338,Fair health,27,1,1,0,6,2,5,3,5,1,2,2,0,2
S01008338,Bad health,6,0,0,0,4,0,0,0,0,1,1,1,0,0
S01008338,Very bad health,3,0,0,0,0,1,0,0,1,0,1,1,0,0
S01008339,All people aged 16 to 74,486,81,12,69,130,86,37,22,53,18,16,11,5,43
S01008339,Very good health,311,45,8,37,90,54,23,16,27,10,9,6,3,37
S01008339,Good health,134,30,3,27,28,22,11,6,21,7,4,4,0,5
S01008339,Fair health,27,4,1,3,9,9,0,0,4,0,1,0,1,0
S01008339,Bad health,10,1,0,1,1,1,3,0,0,1,2,1,1,1
S01008339,Very bad health,4,1,0,1,2,0,0,0,1,0,0,0,0,0
S01008340,All people aged 16 to 74,622,92,11,81,183,78,54,33,69,24,21,13,8,68
S01008340,Very good health,383,64,8,56,116,44,22,20,41,13,10,5,5,53
S01008340,Good health,181,22,3,19,55,27,22,8,20,9,6,4,2,12
S01008340,Fair health,44,5,0,5,9,6,8,2,7,2,2,1,1,3
S01008340,Bad health,9,0,0,0,3,0,1,3,0,0,2,2,0,0
S01008340,Very bad health,5,1,0,1,0,1,1,0,1,0,1,1,0,0
S01008341,All people aged 16 to 74,481,101,15,86,144,59,50,16,29,12,12,3,9,58
S01008341,Very good health,335,80,10,70,99,41,28,9,15,7,5,0,5,51
S01008341,Good health,117,21,5,16,39,12,17,4,10,4,4,1,3,6
S01008341,Fair health,20,0,0,0,4,4,4,0,3,1,3,2,1,1
S01008341,Bad health,8,0,0,0,2,2,0,3,1,0,0,0,0,0
S01008341,Very bad health,1,0,0,0,0,0,1,0,0,0,0,0,0,0
S01008342,All people aged 16 to 74,656,111,17,94,171,77,46,34,70,51,25,20,5,71
S01008342,Very good health,344,63,8,55,97,36,16,13,26,20,10,8,2,63
S01008342,Good health,213,40,6,34,53,30,20,18,26,15,3,3,0,8
S01008342,Fair health,76,6,1,5,17,9,8,3,16,7,10,7,3,0
S01008342,Bad health,20,2,2,0,4,2,1,0,1,8,2,2,0,0
S01008342,Very bad health,3,0,0,0,0,0,1,0,1,1,0,0,0,0
S01008343,All people aged 16 to 74,611,153,23,130,186,61,58,11,37,15,14,6,8,76
S01008343,Very good health,386,104,15,89,100,36,33,7,20,10,8,4,4,68
S01008343,Good health,173,42,7,35,66,17,22,3,10,3,3,0,3,7
S01008343,Fair health,46,7,1,6,18,5,3,1,7,1,3,2,1,1
S01008343,Bad health,6,0,0,0,2,3,0,0,0,1,0,0,0,0
S01008343,Very bad health,0,0,0,0,0,0,0,0,0,0,0,0,0,0
S01008344,All people aged 16 to 74,631,175,34,141,172,66,75,19,36,11,17,13,4,60
S01008344,Very good health,428,120,20,100,121,39,49,14,16,5,9,8,1,55
S01008344,Good health,162,47,12,35,40,20,16,4,18,6,7,5,2,4
S01008344,Fair health,37,8,2,6,9,7,9,0,2,0,1,0,1,1
S01008344,Bad health,3,0,0,0,2,0,1,0,0,0,0,0,0,0
S01008344,Very bad health,1,0,0,0,0,0,0,1,0,0,0,0,0,0
S01008345,All people aged 16 to 74,674,161,34,127,203,73,85,18,28,13,16,13,3,77
S01008345,Very good health,459,116,24,92,131,46,53,12,18,6,8,6,2,69
S01008345,Good health,165,37,7,30,59,17,25,3,8,4,7,6,1,5
S01008345,Fair health,41,7,3,4,11,8,5,3,2,2,1,1,0,2
S01008345,Bad health,8,1,0,1,1,2,2,0,0,1,0,0,0,1
S01008345,Very bad health,1,0,0,0,1,0,0,0,0,0,0,0,0,0
S01008346,All people aged 16 to 74,682,175,48,127,204,77,69,14,35,18,15,7,8,75
S01008346,Very good health,427,107,30,77,128,43,40,3,21,9,6,3,3,70
S01008346,Good health,199,57,16,41,61,23,21,9,10,7,8,4,4,3
S01008346,Fair health,41,8,2,6,10,9,6,2,1,2,1,0,1,2
S01008346,Bad health,10,2,0,2,4,1,1,0,2,0,0,0,0,0
S01008346,Very bad health,5,1,0,1,1,1,1,0,1,0,0,0,0,0
S01008347,All people aged 16 to 74,636,106,21,85,188,86,73,16,55,26,22,15,7,64
S01008347,Very good health,352,62,14,48,107,33,36,6,22,16,14,10,4,56
S01008347,Good health,202,34,6,28,63,35,24,6,20,10,3,2,1,7
S01008347,Fair health,62,6,1,5,12,14,10,3,12,0,4,2,2,1
S01008347,Bad health,16,4,0,4,5,3,1,1,1,0,1,1,0,0
S01008347,Very bad health,4,0,0,0,1,1,2,0,0,0,0,0,0,0
S01008348,All people aged 16 to 74,520,97,14,83,153,83,46,18,44,12,19,9,10,48
S01008348,Very good health,310,63,10,53,91,40,19,14,24,10,10,5,5,39
S01008348,Good health,150,31,4,27,44,29,18,3,13,1,5,2,3,6
S01008348,Fair health,46,2,0,2,17,8,5,1,6,1,3,1,2,3
S01008348,Bad health,9,1,0,1,1,3,3,0,0,0,1,1,0,0
S01008348,Very bad health,5,0,0,0,0,3,1,0,1,0,0,0,0,0
S01008349,All people aged 16 to 74,603,155,28,127,187,72,62,11,20,0,21,15,6,75
S01008349,Very good health,399,104,17,87,134,35,34,6,14,0,8,5,3,64
S01008349,Good health,150,43,10,33,43,26,19,3,3,0,6,4,2,7
S01008349,Fair health,43,6,0,6,8,10,8,2,2,0,4,3,1,3
S01008349,Bad health,6,2,1,1,1,0,1,0,1,0,1,1,0,0
S01008349,Very bad health,5,0,0,0,1,1,0,0,0,0,2,2,0,1
S01008350,All people aged 16 to 74,416,79,18,61,135,63,47,10,29,7,10,3,7,36
S01008350,Very good health,250,45,10,35,80,35,29,7,15,3,4,1,3,32
S01008350,Good health,124,27,6,21,47,20,13,2,7,2,3,1,2,3
S01008350,Fair health,28,3,1,2,7,5,4,1,5,0,2,1,1,1
S01008350,Bad health,10,4,1,3,1,3,0,0,0,1,1,0,1,0
S01008350,Very bad health,4,0,0,0,0,0,1,0,2,1,0,0,0,0
S01008351,All people aged 16 to 74,626,125,31,94,210,82,46,23,48,13,13,8,5,66
S01008351,Very good health,381,78,20,58,125,42,30,10,26,8,9,5,4,53
S01008351,Good health,176,36,7,29,62,28,12,9,16,4,3,2,1,6
S01008351,Fair health,55,10,3,7,20,7,4,3,5,1,0,0,0,5
S01008351,Bad health,13,1,1,0,3,4,0,1,1,0,1,1,0,2
S01008351,Very bad health,1,0,0,0,0,1,0,0,0,0,0,0,0,0
S01008352,All people aged 16 to 74,463,117,17,100,146,56,39,13,25,7,12,11,1,48
S01008352,Very good health,319,76,10,66,99,37,27,11,16,4,7,6,1,42
S01008352,Good health,102,30,5,25,36,16,7,1,4,1,2,2,0,5
S01008352,Fair health,29,6,0,6,8,2,4,1,3,1,3,3,0,1
S01008352,Bad health,10,4,2,2,1,1,1,0,2,1,0,0,0,0
S01008352,Very bad health,3,1,0,1,2,0,0,0,0,0,0,0,0,0
S01008353,All people aged 16 to 74,351,81,14,67,85,45,39,10,28,5,9,5,4,49
S01008353,Very good health,226,56,12,44,47,28,16,3,24,3,8,4,4,41
S01008353,Good health,94,19,1,18,30,13,17,5,2,1,0,0,0,7
S01008353,Fair health,25,4,1,3,8,3,5,2,2,0,0,0,0,1
S01008353,Bad health,6,2,0,2,0,1,1,0,0,1,1,1,0,0
S01008353,Very bad health,0,0,0,0,0,0,0,0,0,0,0,0,0,0
S01008354,All people aged 16 to 74,482,95,20,75,116,57,77,27,37,26,17,12,5,30
S01008354,Very good health,293,64,11,53,86,30,42,15,15,8,11,8,3,22
S01008354,Good health,133,26,8,18,23,20,28,5,11,9,4,2,2,7
S01008354,Fair health,43,3,1,2,7,4,6,4,11,6,1,1,0,1
S01008354,Bad health,12,2,0,2,0,2,1,3,0,3,1,1,0,0
S01008354,Very bad health,1,0,0,0,0,1,0,0,0,0,0,0,0,0
S01008355,All people aged 16 to 74,457,44,9,35,108,70,48,31,53,42,25,16,9,36
S01008355,Very good health,239,29,7,22,62,35,19,10,28,23,6,5,1,27
S01008355,Good health,134,12,2,10,34,18,19,11,15,9,9,5,4,7
S01008355,Fair health,60,3,0,3,7,12,9,5,9,7,6,3,3,2
S01008355,Bad health,18,0,0,0,3,3,1,4,1,3,3,2,1,0
S01008355,Very bad health,6,0,0,0,2,2,0,1,0,0,1,1,0,0
S01008356,All people aged 16 to 74,431,66,14,52,125,68,40,24,48,17,7,2,5,36
S01008356,Very good health,241,36,7,29,78,33,25,11,25,6,1,0,1,26
S01008356,Good health,139,24,6,18,38,27,12,7,13,8,4,1,3,6
S01008356,Fair health,38,4,1,3,5,7,2,5,6,3,2,1,1,4
S01008356,Bad health,12,2,0,2,3,1,1,1,4,0,0,0,0,0
S01008356,Very bad health,1,0,0,0,1,0,0,0,0,0,0,0,0,0
S01008357,All people aged 16 to 74,502,83,16,67,136,87,37,30,52,25,5,3,2,47
S01008357,Very good health,272,49,10,39,80,33,19,16,24,10,1,0,1,40
S01008357,Good health,166,31,6,25,47,37,13,4,23,6,1,0,1,4
S01008357,Fair health,46,3,0,3,6,14,4,7,3,7,1,1,0,1
S01008357,Bad health,15,0,0,0,3,3,0,3,2,0,2,2,0,2
S01008357,Very bad health,3,0,0,0,0,0,1,0,0,2,0,0,0,0
S01008358,All people aged 16 to 74,493,57,11,46,117,72,46,39,68,45,15,5,10,34
S01008358,Very good health,241,40,5,35,66,35,21,16,22,8,6,1,5,27
S01008358,Good health,160,14,5,9,41,26,16,8,27,15,7,3,4,6
S01008358,Fair health,59,1,0,1,6,5,7,8,15,14,2,1,1,1
S01008358,Bad health,23,2,1,1,2,5,2,6,3,3,0,0,0,0
S01008358,Very bad health,10,0,0,0,2,1,0,1,1,5,0,0,0,0
S01008359,All people aged 16 to 74,446,62,13,49,121,75,71,33,28,15,10,6,4,31
S01008359,Very good health,256,41,8,33,70,39,39,16,12,9,4,2,2,26
S01008359,Good health,138,19,4,15,43,20,26,9,8,4,4,3,1,5
S01008359,Fair health,42,1,0,1,7,10,6,7,8,1,2,1,1,0
S01008359,Bad health,8,1,1,0,1,5,0,0,0,1,0,0,0,0
S01008359,Very bad health,2,0,0,0,0,1,0,1,0,0,0,0,0,0
S01008360,All people aged 16 to 74,637,126,26,100,186,102,57,23,43,25,8,5,3,67
S01008360,Very good health,356,66,11,55,108,55,26,8,24,9,3,1,2,57
S01008360,Good health,216,49,12,37,61,36,25,12,14,7,3,2,1,9
S01008360,Fair health,44,8,3,5,10,7,4,2,4,7,2,2,0,0
S01008360,Bad health,17,2,0,2,6,4,1,1,1,1,0,0,0,1
S01008360,Very bad health,4,1,0,1,1,0,1,0,0,1,0,0,0,0
S01008361,All people aged 16 to 74,389,45,11,34,117,67,34,21,39,17,8,6,2,41
S01008361,Very good health,241,27,7,20,70,34,20,16,24,6,6,5,1,38
S01008361,Good health,109,16,4,12,38,22,6,3,14,6,1,0,1,3
S01008361,Fair health,26,0,0,0,6,7,8,1,1,3,0,0,0,0
S01008361,Bad health,12,1,0,1,3,4,0,1,0,2,1,1,0,0
S01008361,Very bad health,1,1,0,1,0,0,0,0,0,0,0,0,0,0
S01008362,All people aged 16 to 74,672,102,11,91,233,107,44,26,59,23,19,13,6,59
S01008362,Very good health,396,68,7,61,149,55,21,11,30,12,2,1,1,48
S01008362,Good health,190,25,4,21,58,35,17,9,22,6,11,7,4,7
S01008362,Fair health,66,8,0,8,17,12,6,5,4,5,5,4,1,4
S01008362,Bad health,15,1,0,1,5,4,0,1,3,0,1,1,0,0
S01008362,Very bad health,5,0,0,0,4,1,0,0,0,0,0,0,0,0
S01008363,All people aged 16 to 74,552,108,24,84,150,92,36,30,52,14,9,6,3,61
S01008363,Very good health,318,65,14,51,87,45,16,18,29,7,4,3,1,47
S01008363,Good health,165,27,7,20,46,37,13,10,17,2,3,1,2,10
S01008363,Fair health,46,11,2,9,8,6,5,1,5,5,2,2,0,3
S01008363,Bad health,19,5,1,4,7,3,2,1,0,0,0,0,0,1
S01008363,Very bad health,4,0,0,0,2,1,0,0,1,0,0,0,0,0
S01008364,All people aged 16 to 74,564,110,20,90,153,74,57,25,52,13,13,10,3,67
S01008364,Very good health,347,71,13,58,92,38,31,14,32,8,5,5,0,56
S01008364,Good health,162,35,7,28,43,26,16,6,15,5,5,2,3,11
S01008364,Fair health,42,3,0,3,13,9,7,4,4,0,2,2,0,0
S01008364,Bad health,10,1,0,1,3,1,2,1,1,0,1,1,0,0
S01008364,Very bad health,3,0,0,0,2,0,1,0,0,0,0,0,0,0
S01008365,All people aged 16 to 74,510,99,23,76,152,63,69,19,35,9,13,7,6,51
S01008365,Very good health,298,66,15,51,97,28,28,7,20,5,4,2,2,43
S01008365,Good health,149,25,7,18,36,26,27,11,11,1,5,2,3,7
S01008365,Fair health,44,4,0,4,14,8,9,1,2,2,4,3,1,0
S01008365,Bad health,12,3,1,2,4,0,2,0,2,0,0,0,0,1
S01008365,Very bad health,7,1,0,1,1,1,3,0,0,1,0,0,0,0
S01008366,All people aged 16 to 74,578,59,5,54,143,92,33,28,88,43,28,17,11,64
S01008366,Very good health,322,38,2,36,83,55,17,10,39,21,13,7,6,46
S01008366,Good health,169,19,3,16,37,24,10,15,30,10,7,3,4,17
S01008366,Fair health,56,1,0,1,12,9,4,1,15,8,5,4,1,1
S01008366,Bad health,25,1,0,1,9,4,1,1,2,4,3,3,0,0
S01008366,Very bad health,6,0,0,0,2,0,1,1,2,0,0,0,0,0
S01008367,All people aged 16 to 74,549,44,9,35,120,73,42,34,78,60,28,18,10,70
S01008367,Very good health,249,24,6,18,62,33,17,11,24,17,9,6,3,52
S01008367,Good health,187,13,3,10,43,20,17,13,37,20,8,3,5,16
S01008367,Fair health,76,7,0,7,12,13,4,7,8,15,8,6,2,2
S01008367,Bad health,31,0,0,0,2,7,3,2,7,8,2,2,0,0
S01008367,Very bad health,6,0,0,0,1,0,1,1,2,0,1,1,0,0
S01008368,All people aged 16 to 74,492,64,11,53,148,90,36,20,52,33,10,5,5,39
S01008368,Very good health,262,38,8,30,80,45,17,16,21,10,3,1,2,32
S01008368,Good health,161,20,2,18,50,34,10,1,21,14,6,3,3,5
S01008368,Fair health,57,6,1,5,16,11,8,3,7,3,1,1,0,2
S01008368,Bad health,9,0,0,0,2,0,1,0,2,4,0,0,0,0
S01008368,Very bad health,3,0,0,0,0,0,0,0,1,2,0,0,0,0
S01008369,All people aged 16 to 74,383,53,14,39,104,48,21,18,46,46,13,5,8,34
S01008369,Very good health,215,33,8,25,69,23,9,9,20,17,4,1,3,31
S01008369,Good health,121,16,4,12,28,16,10,8,18,16,6,2,4,3
S01008369,Fair health,30,4,2,2,4,6,2,1,6,5,2,1,1,0
S01008369,Bad health,10,0,0,0,1,1,0,0,2,5,1,1,0,0
S01008369,Very bad health,7,0,0,0,2,2,0,0,0,3,0,0,0,0
S01008370,All people aged 16 to 74,499,82,17,65,136,63,43,26,49,23,13,9,4,64
S01008370,Very good health,288,58,11,47,84,31,19,12,24,8,5,3,2,47
S01008370,Good health,158,20,3,17,39,26,18,8,16,9,6,4,2,16
S01008370,Fair health,42,4,3,1,8,5,6,5,7,4,2,2,0,1
S01008370,Bad health,10,0,0,0,5,1,0,1,1,2,0,0,0,0
S01008370,Very bad health,1,0,0,0,0,0,0,0,1,0,0,0,0,0
S01008371,All people aged 16 to 74,567,95,19,76,177,91,34,35,41,17,8,6,2,69
S01008371,Very good health,365,69,8,61,114,52,20,19,27,5,2,1,1,57
S01008371,Good health,161,25,11,14,48,32,8,13,12,11,3,2,1,9
S01008371,Fair health,27,1,0,1,11,5,4,2,1,1,0,0,0,2
S01008371,Bad health,8,0,0,0,3,1,2,0,1,0,1,1,0,0
S01008371,Very bad health,6,0,0,0,1,1,0,1,0,0,2,2,0,1
S01008372,All people aged 16 to 74,583,74,18,56,157,100,32,51,60,24,18,9,9,67
S01008372,Very good health,341,47,11,36,88,54,18,25,37,13,6,2,4,53
S01008372,Good health,178,22,6,16,56,33,9,16,16,8,8,5,3,10
S01008372,Fair health,52,5,1,4,12,9,3,7,6,3,3,2,1,4
S01008372,Bad health,9,0,0,0,1,3,1,2,1,0,1,0,1,0
S01008372,Very bad health,3,0,0,0,0,1,1,1,0,0,0,0,0,0
S01008373,All people aged 16 to 74,579,99,16,83,215,83,32,25,39,9,13,8,5,64
S01008373,Very good health,392,78,12,66,139,50,18,15,23,5,7,4,3,57
S01008373,Good health,143,18,3,15,60,25,12,7,11,1,2,1,1,7
S01008373,Fair health,30,2,0,2,10,5,2,3,2,2,4,3,1,0
S01008373,Bad health,10,0,0,0,3,3,0,0,3,1,0,0,0,0
S01008373,Very bad health,4,1,1,0,3,0,0,0,0,0,0,0,0,0
S01008374,All people aged 16 to 74,503,66,12,54,159,93,30,28,47,22,5,2,3,53
S01008374,Very good health,303,35,6,29,97,57,16,17,20,13,2,1,1,46
S01008374,Good health,158,27,5,22,47,28,10,8,25,6,2,0,2,5
S01008374,Fair health,34,2,1,1,11,8,4,3,1,2,1,1,0,2
S01008374,Bad health,7,2,0,2,3,0,0,0,1,1,0,0,0,0
S01008374,Very bad health,1,0,0,0,1,0,0,0,0,0,0,0,0,0
S01008375,All people aged 16 to 74,570,93,29,64,178,88,38,26,58,12,9,5,4,68
S01008375,Very good health,378,61,22,39,113,58,23,15,33,10,6,3,3,59
S01008375,Good health,146,24,5,19,52,22,10,8,18,2,1,1,0,9
S01008375,Fair health,39,8,2,6,10,8,3,2,7,0,1,0,1,0
S01008375,Bad health,4,0,0,0,2,0,1,0,0,0,1,1,0,0
S01008375,Very bad health,3,0,0,0,1,0,1,1,0,0,0,0,0,0
S01008376,All people aged 16 to 74,380,74,16,58,115,53,31,20,27,18,10,5,5,32
S01008376,Very good health,246,54,13,41,77,29,17,11,12,12,4,1,3,30
S01008376,Good health,92,17,2,15,25,18,8,6,9,2,5,3,2,2
S01008376,Fair health,28,2,0,2,10,3,4,2,5,2,0,0,0,0
S01008376,Bad health,14,1,1,0,3,3,2,1,1,2,1,1,0,0
S01008376,Very bad health,0,0,0,0,0,0,0,0,0,0,0,0,0,0
S01008377,All people aged 16 to 74,528,88,9,79,156,87,43,29,44,17,14,9,5,50
S01008377,Very good health,336,53,5,48,112,52,26,14,21,11,6,4,2,41
S01008377,Good health,149,30,2,28,36,19,14,12,19,5,5,2,3,9
S01008377,Fair health,33,3,1,2,8,13,3,2,2,1,1,1,0,0
S01008377,Bad health,8,2,1,1,0,3,0,1,1,0,1,1,0,0
S01008377,Very bad health,2,0,0,0,0,0,0,0,1,0,1,1,0,0
S01008378,All people aged 16 to 74,680,123,25,98,212,96,53,26,63,19,13,10,3,75
S01008378,Very good health,424,75,19,56,140,51,35,14,32,8,8,6,2,61
S01008378,Good health,191,39,6,33,58,31,11,6,24,6,3,2,1,13
S01008378,Fair health,52,5,0,5,12,12,6,5,7,4,1,1,0,0
S01008378,Bad health,7,2,0,2,2,0,1,1,0,0,0,0,0,1
S01008378,Very bad health,6,2,0,2,0,2,0,0,0,1,1,1,0,0
S01008379,All people aged 16 to 74,375,48,14,34,133,56,19,30,29,7,16,12,4,37
S01008379,Very good health,217,28,9,19,72,29,10,18,15,5,7,3,4,33
S01008379,Good health,124,16,4,12,51,21,7,9,8,2,6,6,0,4
S01008379,Fair health,27,4,1,3,8,4,1,3,4,0,3,3,0,0
S01008379,Bad health,6,0,0,0,1,2,1,0,2,0,0,0,0,0
S01008379,Very bad health,1,0,0,0,1,0,0,0,0,0,0,0,0,0
S01008380,All people aged 16 to 74,484,82,13,69,150,81,31,27,37,17,6,3,3,53
S01008380,Very good health,299,55,8,47,96,43,20,11,21,9,2,1,1,42
S01008380,Good health,143,23,4,19,46,27,9,14,12,3,2,0,2,7
S01008380,Fair health,33,3,1,2,8,7,1,1,4,5,0,0,0,4
S01008380,Bad health,5,1,0,1,0,3,1,0,0,0,0,0,0,0
S01008380,Very bad health,4,0,0,0,0,1,0,1,0,0,2,2,0,0
S01008381,All people aged 16 to 74,465,69,10,59,155,76,44,19,33,12,4,0,4,53
S01008381,Very good health,317,49,8,41,114,46,24,11,15,9,1,0,1,48
S01008381,Good health,116,15,1,14,33,24,16,4,13,3,3,0,3,5
S01008381,Fair health,26,5,1,4,7,5,2,3,4,0,0,0,0,0
S01008381,Bad health,5,0,0,0,1,1,1,1,1,0,0,0,0,0
S01008381,Very bad health,1,0,0,0,0,0,1,0,0,0,0,0,0,0
S01008382,All people aged 16 to 74,452,81,11,70,137,79,43,20,26,18,4,3,1,44
S01008382,Very good health,263,51,7,44,83,41,20,10,9,10,2,1,1,37
S01008382,Good health,132,25,4,21,41,29,10,7,12,3,2,2,0,3
S01008382,Fair health,39,3,0,3,8,7,10,2,4,3,0,0,0,2
S01008382,Bad health,12,1,0,1,3,1,2,0,1,2,0,0,0,2
S01008382,Very bad health,6,1,0,1,2,1,1,1,0,0,0,0,0,0
S01008383,All people aged 16 to 74,342,66,14,52,109,43,24,16,32,16,7,3,4,29
S01008383,Very good health,215,46,10,36,65,28,14,11,13,11,2,1,1,25
S01008383,Good health,103,17,3,14,31,13,10,4,17,4,4,1,3,3
S01008383,Fair health,18,2,1,1,10,0,0,1,2,1,1,1,0,1
S01008383,Bad health,5,0,0,0,3,2,0,0,0,0,0,0,0,0
S01008383,Very bad health,1,1,0,1,0,0,0,0,0,0,0,0,0,0
S01008384,All people aged 16 to 74,714,91,13,78,175,134,46,53,94,41,8,6,2,72
S01008384,Very good health,428,58,10,48,106,77,30,25,48,17,6,5,1,61
S01008384,Good health,195,24,3,21,49,40,9,17,30,15,1,0,1,10
S01008384,Fair health,62,6,0,6,16,12,7,9,4,7,1,1,0,0
S01008384,Bad health,21,3,0,3,3,3,0,2,8,2,0,0,0,0
S01008384,Very bad health,8,0,0,0,1,2,0,0,4,0,0,0,0,1
S01008385,All people aged 16 to 74,475,93,16,77,150,69,42,20,30,17,11,6,5,43
S01008385,Very good health,275,58,9,49,86,38,20,6,15,7,8,4,4,37
S01008385,Good health,146,27,5,22,45,20,19,11,11,7,2,1,1,4
S01008385,Fair health,43,7,2,5,17,9,2,2,2,2,0,0,0,2
S01008385,Bad health,9,1,0,1,2,2,1,1,1,1,0,0,0,0
S01008385,Very bad health,2,0,0,0,0,0,0,0,1,0,1,1,0,0
S01008386,All people aged 16 to 74,609,58,12,46,154,122,36,52,66,42,14,8,6,65
S01008386,Very good health,349,42,11,31,95,63,13,25,30,18,7,4,3,56
S01008386,Good health,188,13,0,13,45,46,13,19,23,18,2,1,1,9
S01008386,Fair health,61,3,1,2,12,8,10,8,11,5,4,2,2,0
S01008386,Bad health,10,0,0,0,2,5,0,0,2,0,1,1,0,0
S01008386,Very bad health,1,0,0,0,0,0,0,0,0,1,0,0,0,0
S01008387,All people aged 16 to 74,441,51,12,39,127,91,27,20,55,22,9,3,6,39
S01008387,Very good health,266,38,9,29,79,50,14,12,29,10,3,1,2,31
S01008387,Good health,124,7,1,6,39,35,11,7,11,6,2,0,2,6
S01008387,Fair health,41,4,1,3,6,6,2,1,12,6,3,2,1,1
S01008387,Bad health,8,1,1,0,3,0,0,0,2,0,1,0,1,1
S01008387,Very bad health,2,1,0,1,0,0,0,0,1,0,0,0,0,0
S01008388,All people aged 16 to 74,475,53,6,47,125,87,36,29,63,32,6,2,4,44
S01008388,Very good health,316,43,5,38,90,49,29,17,32,16,2,0,2,38
S01008388,Good health,110,9,1,8,27,22,4,9,21,9,3,1,2,6
S01008388,Fair health,26,1,0,1,5,5,3,2,4,5,1,1,0,0
S01008388,Bad health,17,0,0,0,3,9,0,0,4,1,0,0,0,0
S01008388,Very bad health,6,0,0,0,0,2,0,1,2,1,0,0,0,0
S01008389,All people aged 16 to 74,372,66,11,55,118,59,34,19,28,11,4,3,1,33
S01008389,Very good health,222,43,6,37,69,34,20,11,14,2,0,0,0,29
S01008389,Good health,100,18,4,14,34,17,9,4,9,6,0,0,0,3
S01008389,Fair health,35,5,1,4,12,4,3,3,3,2,2,1,1,1
S01008389,Bad health,11,0,0,0,1,3,2,0,2,1,2,2,0,0
S01008389,Very bad health,4,0,0,0,2,1,0,1,0,0,0,0,0,0
S01008390,All people aged 16 to 74,457,96,16,80,145,64,35,16,35,16,6,4,2,44
S01008390,Very good health,273,61,8,53,83,34,16,11,20,6,5,3,2,37
S01008390,Good health,142,29,7,22,54,22,14,3,10,5,0,0,0,5
S01008390,Fair health,37,6,1,5,7,8,4,2,4,4,0,0,0,2
S01008390,Bad health,5,0,0,0,1,0,1,0,1,1,1,1,0,0
S01008390,Very bad health,0,0,0,0,0,0,0,0,0,0,0,0,0,0
S01008391,All people aged 16 to 74,492,102,16,86,151,60,29,23,45,20,15,8,7,47
S01008391,Very good health,292,68,11,57,92,26,20,10,21,7,7,4,3,41
S01008391,Good health,152,27,3,24,48,23,7,9,18,9,6,3,3,5
S01008391,Fair health,38,6,2,4,7,10,1,3,5,4,1,0,1,1
S01008391,Bad health,8,0,0,0,3,1,1,1,1,0,1,1,0,0
S01008391,Very bad health,2,1,0,1,1,0,0,0,0,0,0,0,0,0
S01008392,All people aged 16 to 74,663,153,28,125,223,65,45,26,37,13,22,18,4,79
S01008392,Very good health,434,103,20,83,156,36,25,10,24,6,4,2,2,70
S01008392,Good health,163,40,8,32,51,19,15,12,7,4,6,5,1,9
S01008392,Fair health,53,7,0,7,12,10,5,3,4,2,10,9,1,0
S01008392,Bad health,8,0,0,0,3,0,0,1,2,1,1,1,0,0
S01008392,Very bad health,5,3,0,3,1,0,0,0,0,0,1,1,0,0
S01008393,All people aged 16 to 74,534,124,20,104,179,63,31,20,29,21,11,6,5,56
S01008393,Very good health,288,77,14,63,98,28,12,12,12,5,4,3,1,40
S01008393,Good health,182,37,4,33,62,28,14,4,12,8,2,1,1,15
S01008393,Fair health,51,9,2,7,17,5,3,4,4,4,4,1,3,1
S01008393,Bad health,8,1,0,1,2,1,1,0,1,2,0,0,0,0
S01008393,Very bad health,5,0,0,0,0,1,1,0,0,2,1,1,0,0
S01008394,All people aged 16 to 74,566,166,37,129,174,59,40,14,19,20,11,7,4,63
S01008394,Very good health,390,122,27,95,117,35,24,7,12,11,7,4,3,55
S01008394,Good health,140,38,9,29,50,16,11,5,3,7,2,1,1,8
S01008394,Fair health,31,5,1,4,5,7,5,1,4,2,2,2,0,0
S01008394,Bad health,4,1,0,1,1,1,0,1,0,0,0,0,0,0
S01008394,Very bad health,1,0,0,0,1,0,0,0,0,0,0,0,0,0
S01008395,All people aged 16 to 74,395,53,11,42,119,69,22,18,42,16,9,8,1,47
S01008395,Very good health,247,34,7,27,78,37,15,10,23,9,1,1,0,40
S01008395,Good health,103,16,4,12,31,23,5,6,11,3,2,2,0,6
S01008395,Fair health,36,3,0,3,6,8,1,1,8,4,4,4,0,1
S01008395,Bad health,8,0,0,0,3,1,1,1,0,0,2,1,1,0
S01008395,Very bad health,1,0,0,0,1,0,0,0,0,0,0,0,0,0
S01008396,All people aged 16 to 74,421,55,10,45,123,74,41,14,45,23,13,7,6,33
S01008396,Very good health,213,29,3,26,68,34,16,7,19,10,8,3,5,22
S01008396,Good health,149,20,7,13,44,28,13,4,18,10,3,2,1,9
S01008396,Fair health,42,6,0,6,7,8,10,2,6,1,1,1,0,1
S01008396,Bad health,15,0,0,0,4,3,1,1,2,2,1,1,0,1
S01008396,Very bad health,2,0,0,0,0,1,1,0,0,0,0,0,0,0
S01008397,All people aged 16 to 74,713,159,31,128,211,98,45,38,49,23,15,10,5,75
S01008397,Very good health,473,117,24,93,127,59,26,22,31,17,8,4,4,66
S01008397,Good health,179,35,5,30,67,26,15,8,12,5,3,2,1,8
S01008397,Fair health,48,5,2,3,14,10,3,7,4,1,3,3,0,1
S01008397,Bad health,8,2,0,2,2,1,0,0,2,0,1,1,0,0
S01008397,Very bad health,5,0,0,0,1,2,1,1,0,0,0,0,0,0
S01008398,All people aged 16 to 74,408,90,16,74,123,65,26,13,36,11,7,3,4,37
S01008398,Very good health,241,58,7,51,70,33,7,10,18,9,3,2,1,33
S01008398,Good health,117,27,7,20,36,20,12,3,12,1,2,0,2,4
S01008398,Fair health,41,5,2,3,12,11,6,0,5,0,2,1,1,0
S01008398,Bad health,8,0,0,0,4,1,1,0,1,1,0,0,0,0
S01008398,Very bad health,1,0,0,0,1,0,0,0,0,0,0,0,0,0
S01008399,All people aged 16 to 74,368,51,9,42,119,58,36,14,32,14,17,17,0,27
S01008399,Very good health,198,25,4,21,66,32,18,5,18,7,4,4,0,23
S01008399,Good health,123,22,5,17,35,18,13,7,14,5,6,6,0,3
S01008399,Fair health,42,4,0,4,16,7,4,2,0,2,6,6,0,1
S01008399,Bad health,4,0,0,0,2,1,1,0,0,0,0,0,0,0
S01008399,Very bad health,1,0,0,0,0,0,0,0,0,0,1,1,0,0
S01008400,All people aged 16 to 74,476,84,9,75,126,80,34,19,39,12,26,22,4,56
S01008400,Very good health,262,55,6,49,79,41,14,6,13,6,6,4,2,42
S01008400,Good health,156,25,3,22,39,25,17,11,16,2,10,9,1,11
S01008400,Fair health,42,3,0,3,8,10,3,1,5,3,7,7,0,2
S01008400,Bad health,14,1,0,1,0,4,0,1,4,1,2,1,1,1
S01008400,Very bad health,2,0,0,0,0,0,0,0,1,0,1,1,0,0
S01008401,All people aged 16 to 74,672,85,13,72,218,123,47,26,73,20,17,16,1,63
S01008401,Very good health,398,56,7,49,140,69,21,9,43,4,6,5,1,50
S01008401,Good health,201,23,5,18,60,41,17,10,21,10,7,7,0,12
S01008401,Fair health,57,3,0,3,13,11,9,6,8,5,1,1,0,1
S01008401,Bad health,12,2,1,1,4,2,0,0,1,1,2,2,0,0
S01008401,Very bad health,4,1,0,1,1,0,0,1,0,0,1,1,0,0
S01008402,All people aged 16 to 74,774,180,35,145,231,91,108,15,39,14,13,11,2,83
S01008402,Very good health,490,124,23,101,143,50,54,10,19,10,6,5,1,74
S01008402,Good health,199,43,8,35,64,34,33,4,10,0,3,2,1,8
S01008402,Fair health,64,9,2,7,22,5,15,0,7,2,3,3,0,1
S01008402,Bad health,18,3,2,1,1,2,5,1,3,2,1,1,0,0
S01008402,Very bad health,3,1,0,1,1,0,1,0,0,0,0,0,0,0
S01008403,All people aged 16 to 74,431,102,13,89,115,61,33,16,24,14,12,6,6,54
S01008403,Very good health,255,65,10,55,75,30,18,4,9,7,3,1,2,44
S01008403,Good health,137,30,2,28,30,26,15,6,12,6,5,1,4,7
S01008403,Fair health,29,6,1,5,7,5,0,5,1,1,2,2,0,2
S01008403,Bad health,9,1,0,1,2,0,0,1,2,0,2,2,0,1
S01008403,Very bad health,1,0,0,0,1,0,0,0,0,0,0,0,0,0
S01008404,All people aged 16 to 74,617,122,21,101,198,90,52,13,48,22,13,6,7,59
S01008404,Very good health,383,91,16,75,120,49,30,6,23,10,5,1,4,49
S01008404,Good health,166,20,3,17,54,28,16,7,18,10,5,3,2,8
S01008404,Fair health,55,10,2,8,18,8,6,0,6,2,3,2,1,2
S01008404,Bad health,10,0,0,0,6,3,0,0,1,0,0,0,0,0
S01008404,Very bad health,3,1,0,1,0,2,0,0,0,0,0,0,0,0
S01008405,All people aged 16 to 74,545,159,20,139,153,54,47,12,29,13,18,13,5,60
S01008405,Very good health,361,111,11,100,102,32,25,5,17,11,4,2,2,54
S01008405,Good health,144,41,8,33,43,19,16,5,7,1,6,5,1,6
S01008405,Fair health,30,7,1,6,8,2,5,1,3,0,4,2,2,0
S01008405,Bad health,8,0,0,0,0,1,0,1,1,1,4,4,0,0
S01008405,Very bad health,2,0,0,0,0,0,1,0,1,0,0,0,0,0
S01008406,All people aged 16 to 74,599,135,15,120,169,72,51,12,51,19,31,25,6,59
S01008406,Very good health,356,98,11,87,114,30,23,3,23,4,10,8,2,51
S01008406,Good health,149,28,4,24,35,23,16,4,16,8,13,9,4,6
S01008406,Fair health,67,7,0,7,15,14,9,3,8,5,4,4,0,2
S01008406,Bad health,22,1,0,1,5,5,3,1,3,1,3,3,0,0
S01008406,Very bad health,5,1,0,1,0,0,0,1,1,1,1,1,0,0
S01008407,All people aged 16 to 74,355,52,12,40,106,51,27,16,30,15,29,27,2,29
S01008407,Very good health,175,30,9,21,48,22,10,7,15,3,17,16,1,23
S01008407,Good health,117,16,3,13,42,19,14,3,9,5,4,3,1,5
S01008407,Fair health,46,5,0,5,11,8,3,5,4,1,8,8,0,1
S01008407,Bad health,6,0,0,0,3,2,0,0,1,0,0,0,0,0
S01008407,Very bad health,11,1,0,1,2,0,0,1,1,6,0,0,0,0
S01008408,All people aged 16 to 74,467,60,10,50,132,69,36,17,44,35,21,17,4,53
S01008408,Very good health,284,42,6,36,92,33,18,10,22,17,8,7,1,42
S01008408,Good health,142,16,4,12,33,30,14,4,17,12,6,3,3,10
S01008408,Fair health,32,2,0,2,6,5,4,3,3,4,5,5,0,0
S01008408,Bad health,9,0,0,0,1,1,0,0,2,2,2,2,0,1
S01008408,Very bad health,0,0,0,0,0,0,0,0,0,0,0,0,0,0
S01008409,All people aged 16 to 74,603,51,11,40,130,109,38,45,99,57,32,22,10,42
S01008409,Very good health,295,33,8,25,71,48,18,17,42,23,9,6,3,34
S01008409,Good health,194,17,3,14,41,39,10,16,31,19,13,6,7,8
S01008409,Fair health,73,1,0,1,10,15,7,12,14,6,8,8,0,0
S01008409,Bad health,27,0,0,0,7,4,1,0,9,5,1,1,0,0
S01008409,Very bad health,14,0,0,0,1,3,2,0,3,4,1,1,0,0
S01008410,All people aged 16 to 74,399,71,16,55,99,57,34,13,39,23,28,24,4,35
S01008410,Very good health,202,39,11,28,58,22,11,7,20,7,9,8,1,29
S01008410,Good health,125,20,4,16,28,22,20,5,12,5,7,6,1,6
S01008410,Fair health,52,11,1,10,10,10,2,1,3,10,5,3,2,0
S01008410,Bad health,17,0,0,0,3,1,1,0,4,1,7,7,0,0
S01008410,Very bad health,3,1,0,1,0,2,0,0,0,0,0,0,0,0
S01008411,All people aged 16 to 74,455,52,5,47,99,82,40,26,64,32,15,12,3,45
S01008411,Very good health,245,36,5,31,54,46,14,8,31,12,5,4,1,39
S01008411,Good health,149,12,0,12,35,25,18,14,24,13,2,1,1,6
S01008411,Fair health,44,3,0,3,9,8,7,2,7,5,3,3,0,0
S01008411,Bad health,15,1,0,1,1,2,1,2,2,2,4,4,0,0
S01008411,Very bad health,2,0,0,0,0,1,0,0,0,0,1,0,1,0
S01008412,All people aged 16 to 74,509,69,14,55,123,64,35,32,63,17,28,22,6,78
S01008412,Very good health,267,39,7,32,64,34,15,12,24,5,6,5,1,68
S01008412,Good health,165,24,7,17,47,18,15,15,20,7,10,7,3,9
S01008412,Fair health,56,4,0,4,9,7,4,5,13,4,9,8,1,1
S01008412,Bad health,17,2,0,2,3,2,1,0,6,0,3,2,1,0
S01008412,Very bad health,4,0,0,0,0,3,0,0,0,1,0,0,0,0
S01008413,All people aged 16 to 74,407,55,6,49,89,63,33,25,53,26,25,17,8,38
S01008413,Very good health,209,29,3,26,48,32,16,12,22,8,10,7,3,32
S01008413,Good health,117,20,2,18,26,17,9,6,14,12,10,5,5,3
S01008413,Fair health,53,3,1,2,9,10,6,5,11,4,4,4,0,1
S01008413,Bad health,23,2,0,2,5,4,2,2,4,1,1,1,0,2
S01008413,Very bad health,5,1,0,1,1,0,0,0,2,1,0,0,0,0
S01008414,All people aged 16 to 74,327,50,9,41,100,46,32,10,27,7,7,6,1,48
S01008414,Very good health,212,35,5,30,68,25,15,6,14,7,3,3,0,39
S01008414,Good health,90,12,3,9,26,18,13,3,10,0,1,1,0,7
S01008414,Fair health,14,3,1,2,1,3,2,1,1,0,1,0,1,2
S01008414,Bad health,9,0,0,0,5,0,1,0,1,0,2,2,0,0
S01008414,Very bad health,2,0,0,0,0,0,1,0,1,0,0,0,0,0
S01008415,All people aged 16 to 74,621,57,8,49,139,91,51,42,105,57,22,14,8,57
S01008415,Very good health,331,36,6,30,72,47,25,23,50,29,8,7,1,41
S01008415,Good health,209,17,2,15,52,31,16,11,40,17,9,6,3,16
S01008415,Fair health,52,4,0,4,11,10,2,5,11,6,3,0,3,0
S01008415,Bad health,23,0,0,0,4,3,7,2,3,2,2,1,1,0
S01008415,Very bad health,6,0,0,0,0,0,1,1,1,3,0,0,0,0
S01008416,All people aged 16 to 74,724,45,6,39,130,117,47,62,111,92,57,37,20,63
S01008416,Very good health,349,27,3,24,70,58,27,19,45,29,21,13,8,53
S01008416,Good health,232,12,1,11,41,38,12,28,41,30,21,13,8,9
S01008416,Fair health,82,5,1,4,8,13,2,9,17,18,9,6,3,1
S01008416,Bad health,47,1,1,0,8,8,4,5,7,8,6,5,1,0
S01008416,Very bad health,14,0,0,0,3,0,2,1,1,7,0,0,0,0
S01008417,All people aged 16 to 74,548,101,15,86,171,82,51,23,44,19,12,8,4,45
S01008417,Very good health,325,69,11,58,96,49,24,16,23,7,4,3,1,37
S01008417,Good health,166,30,4,26,53,27,21,5,13,7,3,1,2,7
S01008417,Fair health,41,2,0,2,15,4,5,1,8,2,4,4,0,0
S01008417,Bad health,13,0,0,0,5,2,1,1,0,2,1,0,1,1
S01008417,Very bad health,3,0,0,0,2,0,0,0,0,1,0,0,0,0
S01008418,All people aged 16 to 74,536,107,15,92,158,85,48,24,52,27,4,3,1,31
S01008418,Very good health,311,68,11,57,95,56,26,13,23,8,2,2,0,20
S01008418,Good health,165,32,3,29,46,22,17,7,24,11,0,0,0,6
S01008418,Fair health,46,6,1,5,12,6,3,4,3,6,2,1,1,4
S01008418,Bad health,10,1,0,1,4,1,1,0,1,2,0,0,0,0
S01008418,Very bad health,4,0,0,0,1,0,1,0,1,0,0,0,0,1
S01008419,All people aged 16 to 74,349,83,25,58,117,37,24,11,25,14,9,4,5,29
S01008419,Very good health,218,60,19,41,79,19,11,4,13,7,4,2,2,21
S01008419,Good health,93,18,5,13,31,9,10,2,7,6,3,1,2,7
S01008419,Fair health,27,4,1,3,5,8,1,3,4,1,1,0,1,0
S01008419,Bad health,10,1,0,1,2,1,2,1,1,0,1,1,0,1
S01008419,Very bad health,1,0,0,0,0,0,0,1,0,0,0,0,0,0
S01008420,All people aged 16 to 74,356,74,9,65,93,63,20,17,32,22,5,1,4,30
S01008420,Very good health,199,45,7,38,54,33,9,7,16,10,1,1,0,24
S01008420,Good health,115,24,1,23,30,23,6,9,9,7,3,0,3,4
S01008420,Fair health,33,5,1,4,6,7,2,1,5,4,1,0,1,2
S01008420,Bad health,9,0,0,0,3,0,3,0,2,1,0,0,0,0
S01008420,Very bad health,0,0,0,0,0,0,0,0,0,0,0,0,0,0
S01008421,All people aged 16 to 74,620,81,13,68,149,97,34,38,96,49,28,15,13,48
S01008421,Very good health,301,44,9,35,74,48,18,11,31,19,17,7,10,39
S01008421,Good health,233,30,4,26,53,38,14,16,47,17,9,7,2,9
S01008421,Fair health,58,7,0,7,14,7,1,7,12,8,2,1,1,0
S01008421,Bad health,25,0,0,0,7,4,1,4,6,3,0,0,0,0
S01008421,Very bad health,3,0,0,0,1,0,0,0,0,2,0,0,0,0
S01008422,All people aged 16 to 74,417,96,17,79,150,62,25,9,23,19,4,4,0,29
S01008422,Very good health,255,58,12,46,96,33,14,4,11,11,2,2,0,26
S01008422,Good health,136,34,4,30,48,25,7,4,9,6,1,1,0,2
S01008422,Fair health,21,4,1,3,6,3,2,1,2,1,1,1,0,1
S01008422,Bad health,4,0,0,0,0,1,2,0,1,0,0,0,0,0
S01008422,Very bad health,1,0,0,0,0,0,0,0,0,1,0,0,0,0
S01008423,All people aged 16 to 74,750,194,42,152,231,89,62,15,44,31,19,11,8,65
S01008423,Very good health,479,136,26,110,153,50,27,9,23,18,6,6,0,57
S01008423,Good health,223,53,15,38,65,29,29,2,18,10,9,2,7,8
S01008423,Fair health,31,5,1,4,8,9,3,1,0,3,2,2,0,0
S01008423,Bad health,15,0,0,0,5,1,3,3,2,0,1,0,1,0
S01008423,Very bad health,2,0,0,0,0,0,0,0,1,0,1,1,0,0
S01008424,All people aged 16 to 74,583,140,29,111,185,87,38,19,43,8,8,7,1,55
S01008424,Very good health,352,86,19,67,118,42,17,10,23,2,4,4,0,50
S01008424,Good health,181,41,9,32,57,35,13,7,16,6,2,1,1,4
S01008424,Fair health,41,10,0,10,10,8,7,0,3,0,2,2,0,1
S01008424,Bad health,7,2,1,1,0,2,0,2,1,0,0,0,0,0
S01008424,Very bad health,2,1,0,1,0,0,1,0,0,0,0,0,0,0
S01008425,All people aged 16 to 74,2209,118,17,101,190,142,59,36,69,37,18,12,6,1540
S01008425,Very good health,1395,74,9,65,106,79,29,17,38,19,8,5,3,1025
S01008425,Good health,682,33,6,27,65,47,23,14,21,10,6,5,1,463
S01008425,Fair health,105,7,2,5,16,12,5,4,8,4,3,1,2,46
S01008425,Bad health,21,4,0,4,2,2,1,1,1,4,1,1,0,5
S01008425,Very bad health,6,0,0,0,1,2,1,0,1,0,0,0,0,1
S01008426,All people aged 16 to 74,407,23,2,21,74,62,21,41,81,59,12,10,2,34
S01008426,Very good health,200,11,1,10,45,31,9,22,28,20,7,5,2,27
S01008426,Good health,140,9,1,8,23,25,11,14,33,19,1,1,0,5
S01008426,Fair health,53,2,0,2,5,4,1,5,16,15,3,3,0,2
S01008426,Bad health,8,1,0,1,0,2,0,0,3,2,0,0,0,0
S01008426,Very bad health,6,0,0,0,1,0,0,0,1,3,1,1,0,0
S01008427,All people aged 16 to 74,851,141,27,114,199,151,68,50,105,45,11,7,4,81
S01008427,Very good health,525,98,16,82,122,81,32,26,65,24,6,4,2,71
S01008427,Good health,259,34,8,26,59,58,28,15,36,18,3,2,1,8
S01008427,Fair health,51,6,3,3,14,9,7,7,4,2,1,1,0,1
S01008427,Bad health,15,3,0,3,4,3,1,1,0,1,1,0,1,1
S01008427,Very bad health,1,0,0,0,0,0,0,1,0,0,0,0,0,0
S01008428,All people aged 16 to 74,457,35,6,29,89,75,34,32,69,72,13,10,3,38
S01008428,Very good health,231,18,2,16,56,39,12,18,26,27,3,1,2,32
S01008428,Good health,142,11,3,8,20,28,16,7,27,24,6,5,1,3
S01008428,Fair health,50,4,1,3,9,5,3,2,10,12,2,2,0,3
S01008428,Bad health,25,2,0,2,3,2,2,4,4,6,2,2,0,0
S01008428,Very bad health,9,0,0,0,1,1,1,1,2,3,0,0,0,0
S01008429,All people aged 16 to 74,601,94,22,72,164,120,38,29,56,38,15,10,5,47
S01008429,Very good health,362,60,12,48,96,73,21,16,32,19,3,2,1,42
S01008429,Good health,175,27,8,19,45,35,15,11,17,13,7,5,2,5
S01008429,Fair health,47,6,2,4,18,6,2,2,7,4,2,0,2,0
S01008429,Bad health,14,1,0,1,3,5,0,0,0,2,3,3,0,0
S01008429,Very bad health,3,0,0,0,2,1,0,0,0,0,0,0,0,0
S01008430,All people aged 16 to 74,469,72,12,60,125,65,36,19,60,31,17,12,5,44
S01008430,Very good health,277,46,8,38,80,35,21,8,30,12,10,6,4,35
S01008430,Good health,148,22,2,20,34,26,14,8,20,12,4,3,1,8
S01008430,Fair health,38,3,1,2,9,3,1,3,8,7,3,3,0,1
S01008430,Bad health,5,1,1,0,2,0,0,0,2,0,0,0,0,0
S01008430,Very bad health,1,0,0,0,0,1,0,0,0,0,0,0,0,0
S01008431,All people aged 16 to 74,602,96,9,87,151,123,33,24,68,39,18,14,4,50
S01008431,Very good health,334,55,5,50,86,64,16,14,35,14,8,6,2,42
S01008431,Good health,205,34,3,31,55,45,12,8,21,19,3,2,1,8
S01008431,Fair health,46,6,1,5,6,9,4,1,8,5,7,6,1,0
S01008431,Bad health,13,1,0,1,4,4,0,1,3,0,0,0,0,0
S01008431,Very bad health,4,0,0,0,0,1,1,0,1,1,0,0,0,0
S01008432,All people aged 16 to 74,497,76,11,65,140,113,35,25,44,13,11,6,5,40
S01008432,Very good health,295,43,5,38,83,71,24,15,19,6,2,1,1,32
S01008432,Good health,167,32,6,26,47,33,10,6,19,6,7,3,4,7
S01008432,Fair health,30,0,0,0,10,7,0,4,6,0,2,2,0,1
S01008432,Bad health,4,1,0,1,0,2,0,0,0,1,0,0,0,0
S01008432,Very bad health,1,0,0,0,0,0,1,0,0,0,0,0,0,0
S01008433,All people aged 16 to 74,645,58,14,44,159,149,49,54,81,53,8,6,2,34
S01008433,Very good health,345,35,9,26,90,82,24,31,30,25,2,2,0,26
S01008433,Good health,213,16,4,12,50,51,19,13,40,20,1,0,1,3
S01008433,Fair health,70,6,1,5,15,13,5,10,8,5,4,3,1,4
S01008433,Bad health,14,1,0,1,4,2,1,0,2,2,1,1,0,1
S01008433,Very bad health,3,0,0,0,0,1,0,0,1,1,0,0,0,0
S01008434,All people aged 16 to 74,630,74,7,67,173,133,52,42,63,32,15,9,6,46
S01008434,Very good health,365,46,5,41,108,69,30,23,30,16,6,3,3,37
S01008434,Good health,199,25,2,23,50,45,15,15,24,14,5,3,2,6
S01008434,Fair health,52,1,0,1,9,15,5,4,9,2,4,3,1,3
S01008434,Bad health,11,2,0,2,5,3,1,0,0,0,0,0,0,0
S01008434,Very bad health,3,0,0,0,1,1,1,0,0,0,0,0,0,0
S01008435,All people aged 16 to 74,606,83,17,66,147,142,37,49,60,31,7,6,1,50
S01008435,Very good health,334,38,9,29,86,77,17,28,28,15,3,2,1,42
S01008435,Good health,223,40,7,33,48,57,18,16,22,13,3,3,0,6
S01008435,Fair health,39,5,1,4,12,8,2,4,5,0,1,1,0,2
S01008435,Bad health,6,0,0,0,1,0,0,0,3,2,0,0,0,0
S01008435,Very bad health,4,0,0,0,0,0,0,1,2,1,0,0,0,0
S01008436,All people aged 16 to 74,619,128,24,104,161,93,49,33,59,25,16,12,4,55
S01008436,Very good health,401,95,14,81,108,60,29,18,29,13,2,2,0,47
S01008436,Good health,170,27,8,19,42,29,15,12,24,8,8,6,2,5
S01008436,Fair health,37,5,2,3,9,4,5,3,4,1,3,3,0,3
S01008436,Bad health,8,1,0,1,2,0,0,0,1,2,2,0,2,0
S01008436,Very bad health,3,0,0,0,0,0,0,0,1,1,1,1,0,0
S01008437,All people aged 16 to 74,506,95,16,79,136,74,48,24,53,24,12,7,5,40
S01008437,Very good health,290,63,5,58,76,39,31,14,27,7,3,1,2,30
S01008437,Good health,156,25,8,17,45,20,15,7,19,10,6,3,3,9
S01008437,Fair health,37,4,1,3,10,12,1,2,2,4,1,1,0,1
S01008437,Bad health,20,2,2,0,5,2,1,1,4,3,2,2,0,0
S01008437,Very bad health,3,1,0,1,0,1,0,0,1,0,0,0,0,0
S01008438,All people aged 16 to 74,335,72,14,58,111,38,36,5,23,13,10,8,2,27
S01008438,Very good health,211,49,10,39,73,20,20,2,11,4,5,3,2,27
S01008438,Good health,93,20,3,17,32,12,12,2,7,5,3,3,0,0
S01008438,Fair health,23,2,0,2,5,3,3,0,5,3,2,2,0,0
S01008438,Bad health,6,1,1,0,1,2,1,1,0,0,0,0,0,0
S01008438,Very bad health,2,0,0,0,0,1,0,0,0,1,0,0,0,0
S01008439,All people aged 16 to 74,783,240,47,193,267,89,40,23,40,15,9,5,4,60
S01008439,Very good health,506,163,32,131,165,56,19,17,21,9,5,3,2,51
S01008439,Good health,227,61,14,47,86,29,19,4,13,6,2,0,2,7
S01008439,Fair health,39,14,1,13,13,3,0,0,5,0,2,2,0,2
S01008439,Bad health,6,2,0,2,1,0,2,1,0,0,0,0,0,0
S01008439,Very bad health,5,0,0,0,2,1,0,1,1,0,0,0,0,0
S01008440,All people aged 16 to 74,688,202,31,171,243,75,52,14,32,9,10,4,6,51
S01008440,Very good health,454,134,19,115,167,48,26,6,22,4,5,0,5,42
S01008440,Good health,181,56,11,45,55,24,21,6,7,2,2,1,1,8
S01008440,Fair health,38,8,0,8,19,2,1,1,2,3,1,1,0,1
S01008440,Bad health,12,3,1,2,2,1,2,1,1,0,2,2,0,0
S01008440,Very bad health,3,1,0,1,0,0,2,0,0,0,0,0,0,0
S01008441,All people aged 16 to 74,333,93,22,71,90,54,28,7,22,11,5,2,3,23
S01008441,Very good health,225,69,15,54,61,33,17,4,14,6,3,1,2,18
S01008441,Good health,84,18,6,12,26,15,9,2,6,5,1,0,1,2
S01008441,Fair health,17,4,1,3,2,4,1,1,2,0,0,0,0,3
S01008441,Bad health,7,2,0,2,1,2,1,0,0,0,1,1,0,0
S01008441,Very bad health,0,0,0,0,0,0,0,0,0,0,0,0,0,0
S01008442,All people aged 16 to 74,519,144,28,116,175,53,54,12,32,12,14,9,5,23
S01008442,Very good health,361,111,18,93,125,37,33,6,20,7,4,2,2,18
S01008442,Good health,132,31,9,22,42,13,17,5,10,3,6,5,1,5
S01008442,Fair health,20,2,1,1,6,3,4,0,2,1,2,0,2,0
S01008442,Bad health,4,0,0,0,2,0,0,1,0,1,0,0,0,0
S01008442,Very bad health,2,0,0,0,0,0,0,0,0,0,2,2,0,0
S01008443,All people aged 16 to 74,422,100,13,87,125,50,38,14,29,18,9,5,4,39
S01008443,Very good health,264,71,8,63,80,27,15,8,19,7,4,1,3,33
S01008443,Good health,119,23,4,19,37,15,14,5,9,8,4,4,0,4
S01008443,Fair health,29,2,0,2,7,6,7,1,1,2,1,0,1,2
S01008443,Bad health,10,4,1,3,1,2,2,0,0,1,0,0,0,0
S01008443,Very bad health,0,0,0,0,0,0,0,0,0,0,0,0,0,0
S01008444,All people aged 16 to 74,479,95,36,59,128,70,33,20,47,30,15,7,8,41
S01008444,Very good health,301,74,31,43,84,40,20,6,23,15,7,3,4,32
S01008444,Good health,130,19,5,14,35,26,7,10,14,9,3,2,1,7
S01008444,Fair health,35,2,0,2,7,3,4,3,8,3,3,1,2,2
S01008444,Bad health,10,0,0,0,2,0,2,1,1,2,2,1,1,0
S01008444,Very bad health,3,0,0,0,0,1,0,0,1,1,0,0,0,0
S01008445,All people aged 16 to 74,535,73,14,59,168,98,29,17,67,34,17,12,5,32
S01008445,Very good health,310,48,9,39,105,52,13,6,37,13,13,9,4,23
S01008445,Good health,153,20,5,15,45,34,14,5,18,9,0,0,0,8
S01008445,Fair health,48,5,0,5,14,10,2,1,4,9,3,2,1,0
S01008445,Bad health,20,0,0,0,4,2,0,3,7,2,1,1,0,1
S01008445,Very bad health,4,0,0,0,0,0,0,2,1,1,0,0,0,0
S01008446,All people aged 16 to 74,726,153,19,134,222,64,45,14,29,10,5,5,0,184
S01008446,Very good health,510,102,10,92,156,42,24,9,21,5,2,2,0,149
S01008446,Good health,178,47,8,39,53,18,16,3,7,2,1,1,0,31
S01008446,Fair health,29,4,1,3,12,3,2,1,1,2,1,1,0,3
S01008446,Bad health,5,0,0,0,0,1,2,0,0,1,0,0,0,1
S01008446,Very bad health,4,0,0,0,1,0,1,1,0,0,1,1,0,0
S01008447,All people aged 16 to 74,503,129,23,106,177,56,52,19,27,19,3,1,2,21
S01008447,Very good health,319,82,16,66,120,30,27,9,19,11,2,0,2,19
S01008447,Good health,153,42,6,36,48,21,19,7,6,8,1,1,0,1
S01008447,Fair health,23,3,1,2,8,5,3,1,2,0,0,0,0,1
S01008447,Bad health,4,1,0,1,0,0,2,1,0,0,0,0,0,0
S01008447,Very bad health,4,1,0,1,1,0,1,1,0,0,0,0,0,0
S01008448,All people aged 16 to 74,578,88,16,72,136,111,64,30,49,36,12,8,4,52
S01008448,Very good health,313,52,10,42,80,54,32,17,25,14,2,0,2,37
S01008448,Good health,194,29,2,27,39,43,24,9,17,16,4,3,1,13
S01008448,Fair health,51,4,3,1,15,9,5,3,5,6,4,3,1,0
S01008448,Bad health,16,1,0,1,1,5,2,1,2,0,2,2,0,2
S01008448,Very bad health,4,2,1,1,1,0,1,0,0,0,0,0,0,0
S01008449,All people aged 16 to 74,573,26,6,20,63,40,33,43,129,106,75,52,23,58
S01008449,Very good health,249,9,0,9,30,15,12,18,53,45,25,19,6,42
S01008449,Good health,184,15,5,10,26,17,13,11,44,25,20,13,7,13
S01008449,Fair health,91,0,0,0,3,5,5,8,21,23,24,15,9,2
S01008449,Bad health,40,2,1,1,4,3,3,5,7,10,5,5,0,1
S01008449,Very bad health,9,0,0,0,0,0,0,1,4,3,1,0,1,0
S01008450,All people aged 16 to 74,384,9,1,8,37,36,23,35,96,77,31,17,14,40
S01008450,Very good health,166,4,0,4,14,17,16,10,37,30,11,4,7,27
S01008450,Good health,147,5,1,4,17,15,5,16,42,23,13,7,6,11
S01008450,Fair health,41,0,0,0,3,2,2,4,8,16,4,3,1,2
S01008450,Bad health,25,0,0,0,3,1,0,4,7,7,3,3,0,0
S01008450,Very bad health,5,0,0,0,0,1,0,1,2,1,0,0,0,0
S01008451,All people aged 16 to 74,497,13,3,10,25,49,19,31,103,111,89,52,37,57
S01008451,Very good health,191,4,0,4,15,19,4,12,32,40,25,11,14,40
S01008451,Good health,178,5,3,2,8,23,12,13,35,37,29,20,9,16
S01008451,Fair health,91,2,0,2,2,5,3,5,25,25,23,15,8,1
S01008451,Bad health,31,0,0,0,0,2,0,1,10,7,11,6,5,0
S01008451,Very bad health,6,2,0,2,0,0,0,0,1,2,1,0,1,0
S01008452,All people aged 16 to 74,433,8,4,4,37,37,22,30,101,99,36,24,12,63
S01008452,Very good health,191,6,2,4,16,15,13,12,41,28,14,9,5,46
S01008452,Good health,137,1,1,0,12,15,4,7,35,32,17,12,5,14
S01008452,Fair health,70,1,1,0,5,5,3,3,20,26,4,2,2,3
S01008452,Bad health,22,0,0,0,3,2,0,6,5,5,1,1,0,0
S01008452,Very bad health,13,0,0,0,1,0,2,2,0,8,0,0,0,0
S01008453,All people aged 16 to 74,374,27,0,27,59,47,25,29,69,42,32,19,13,44
S01008453,Very good health,218,18,0,18,40,31,13,21,33,18,15,10,5,29
S01008453,Good health,106,8,0,8,13,9,10,7,21,12,11,5,6,15
S01008453,Fair health,28,1,0,1,3,4,2,0,7,8,3,2,1,0
S01008453,Bad health,16,0,0,0,3,2,0,1,5,3,2,1,1,0
S01008453,Very bad health,6,0,0,0,0,1,0,0,3,1,1,1,0,0
S01008454,All people aged 16 to 74,674,11,2,9,77,82,30,46,156,119,73,61,12,80
S01008454,Very good health,270,5,0,5,33,29,15,19,56,35,19,16,3,59
S01008454,Good health,229,3,1,2,26,29,7,17,59,41,30,27,3,17
S01008454,Fair health,103,1,0,1,10,15,5,6,24,24,15,11,4,3
S01008454,Bad health,62,2,1,1,6,6,3,3,16,16,9,7,2,1
S01008454,Very bad health,10,0,0,0,2,3,0,1,1,3,0,0,0,0
S01008455,All people aged 16 to 74,770,22,2,20,71,75,25,74,156,153,79,56,23,115
S01008455,Very good health,331,15,1,14,29,40,11,22,74,35,33,20,13,72
S01008455,Good health,272,4,1,3,31,22,9,25,54,62,24,16,8,41
S01008455,Fair health,111,1,0,1,7,11,3,15,20,34,19,17,2,1
S01008455,Bad health,42,1,0,1,2,2,0,11,8,16,1,1,0,1
S01008455,Very bad health,14,1,0,1,2,0,2,1,0,6,2,2,0,0
S01008456,All people aged 16 to 74,747,12,0,12,79,72,35,71,154,153,115,65,50,56
S01008456,Very good health,262,4,0,4,32,23,15,19,47,45,38,17,21,39
S01008456,Good health,280,8,0,8,28,34,10,29,63,57,40,23,17,11
S01008456,Fair health,129,0,0,0,10,10,7,15,31,27,25,14,11,4
S01008456,Bad health,52,0,0,0,5,5,3,5,10,15,7,6,1,2
S01008456,Very bad health,24,0,0,0,4,0,0,3,3,9,5,5,0,0
S01008457,All people aged 16 to 74,477,9,2,7,51,57,12,35,122,117,42,28,14,32
S01008457,Very good health,194,4,0,4,23,17,6,16,55,33,11,5,6,29
S01008457,Good health,159,4,1,3,16,25,4,13,45,35,15,11,4,2
S01008457,Fair health,73,1,1,0,7,11,1,2,13,27,11,9,2,0
S01008457,Bad health,40,0,0,0,2,4,1,3,7,17,5,3,2,1
S01008457,Very bad health,11,0,0,0,3,0,0,1,2,5,0,0,0,0
S01008458,All people aged 16 to 74,747,29,3,26,117,116,41,79,143,113,47,30,17,62
S01008458,Very good health,346,16,2,14,64,52,14,42,61,35,20,10,10,42
S01008458,Good health,260,9,1,8,32,43,14,24,55,54,15,11,4,14
S01008458,Fair health,97,3,0,3,16,16,6,7,22,16,7,6,1,4
S01008458,Bad health,37,1,0,1,4,4,5,6,5,6,4,2,2,2
S01008458,Very bad health,7,0,0,0,1,1,2,0,0,2,1,1,0,0
S01008459,All people aged 16 to 74,590,12,1,11,49,60,18,56,137,127,84,58,26,47
S01008459,Very good health,217,11,1,10,24,22,9,20,43,31,24,15,9,33
S01008459,Good health,214,1,0,1,14,22,6,23,60,54,24,14,10,10
S01008459,Fair health,103,0,0,0,4,10,2,7,19,32,25,21,4,4
S01008459,Bad health,39,0,0,0,5,3,0,5,11,6,9,6,3,0
S01008459,Very bad health,17,0,0,0,2,3,1,1,4,4,2,2,0,0
S01008460,All people aged 16 to 74,552,8,1,7,38,51,17,47,125,131,89,61,28,46
S01008460,Very good health,205,2,1,1,18,21,7,16,49,38,27,17,10,27
S01008460,Good health,197,3,0,3,13,19,6,13,43,48,34,21,13,18
S01008460,Fair health,90,1,0,1,6,5,3,10,18,27,19,14,5,1
S01008460,Bad health,49,1,0,1,0,6,1,7,15,13,6,6,0,0
S01008460,Very bad health,11,1,0,1,1,0,0,1,0,5,3,3,0,0
S01008461,All people aged 16 to 74,686,10,0,10,66,72,28,58,133,169,89,63,26,61
S01008461,Very good health,271,4,0,4,30,29,9,23,52,51,30,21,9,43
S01008461,Good health,229,6,0,6,24,21,10,22,46,60,29,21,8,11
S01008461,Fair health,127,0,0,0,9,18,5,7,26,39,18,11,7,5
S01008461,Bad health,51,0,0,0,3,4,4,6,8,17,7,5,2,2
S01008461,Very bad health,8,0,0,0,0,0,0,0,1,2,5,5,0,0
S01008462,All people aged 16 to 74,457,5,2,3,35,57,16,33,108,116,63,34,29,24
S01008462,Very good health,105,2,1,1,10,17,1,10,17,25,9,5,4,14
S01008462,Good health,155,0,0,0,13,19,2,9,38,38,28,14,14,8
S01008462,Fair health,128,1,0,1,5,15,7,8,37,35,19,12,7,1
S01008462,Bad health,58,2,1,1,7,4,4,5,16,12,7,3,4,1
S01008462,Very bad health,11,0,0,0,0,2,2,1,0,6,0,0,0,0
S01008463,All people aged 16 to 74,538,17,1,16,46,68,25,48,114,120,60,39,21,40
S01008463,Very good health,224,9,0,9,22,35,8,16,52,44,13,7,6,25
S01008463,Good health,176,6,1,5,14,20,13,15,36,37,23,15,8,12
S01008463,Fair health,84,2,0,2,8,10,1,8,16,24,12,7,5,3
S01008463,Bad health,46,0,0,0,2,3,2,7,10,13,9,8,1,0
S01008463,Very bad health,8,0,0,0,0,0,1,2,0,2,3,2,1,0
S01008464,All people aged 16 to 74,637,29,4,25,105,143,28,70,103,91,27,16,11,41
S01008464,Very good health,301,11,1,10,55,64,17,28,54,32,9,7,2,31
S01008464,Good health,240,15,2,13,32,58,10,30,35,42,10,1,9,8
S01008464,Fair health,73,3,1,2,16,17,1,10,11,6,7,7,0,2
S01008464,Bad health,18,0,0,0,1,4,0,1,3,8,1,1,0,0
S01008464,Very bad health,5,0,0,0,1,0,0,1,0,3,0,0,0,0
S01008465,All people aged 16 to 74,559,32,5,27,81,106,29,42,115,80,26,18,8,48
S01008465,Very good health,274,15,3,12,43,56,15,19,51,36,6,1,5,33
S01008465,Good health,211,15,2,13,27,37,10,19,47,29,14,12,2,13
S01008465,Fair health,64,1,0,1,10,13,4,4,16,12,3,3,0,1
S01008465,Bad health,8,1,0,1,1,0,0,0,1,1,3,2,1,1
S01008465,Very bad health,2,0,0,0,0,0,0,0,0,2,0,0,0,0
S01008466,All people aged 16 to 74,564,21,2,19,64,85,23,58,119,103,28,13,15,63
S01008466,Very good health,285,16,1,15,36,44,8,34,55,43,8,4,4,41
S01008466,Good health,197,5,1,4,20,27,7,16,49,42,14,4,10,17
S01008466,Fair health,57,0,0,0,4,11,7,7,10,9,5,4,1,4
S01008466,Bad health,21,0,0,0,4,2,1,1,5,8,0,0,0,0
S01008466,Very bad health,4,0,0,0,0,1,0,0,0,1,1,1,0,1
S01008467,All people aged 16 to 74,602,14,3,11,74,112,45,64,133,90,33,14,19,37
S01008467,Very good health,301,11,3,8,36,61,23,29,63,35,16,6,10,27
S01008467,Good health,203,3,0,3,23,35,17,25,46,38,8,3,5,8
S01008467,Fair health,65,0,0,0,9,11,5,6,17,12,3,3,0,2
S01008467,Bad health,25,0,0,0,4,5,0,3,5,3,5,1,4,0
S01008467,Very bad health,8,0,0,0,2,0,0,1,2,2,1,1,0,0
S01008468,All people aged 16 to 74,454,9,1,8,43,71,22,46,98,69,33,27,6,63
S01008468,Very good health,203,5,0,5,26,27,10,20,41,23,11,8,3,40
S01008468,Good health,159,3,1,2,9,32,8,14,36,26,14,11,3,17
S01008468,Fair health,58,0,0,0,4,8,4,6,15,12,6,6,0,3
S01008468,Bad health,23,0,0,0,3,2,0,4,5,5,2,2,0,2
S01008468,Very bad health,11,1,0,1,1,2,0,2,1,3,0,0,0,1
S01008469,All people aged 16 to 74,455,26,3,23,77,48,30,34,66,74,26,22,4,74
S01008469,Very good health,220,15,1,14,44,24,12,11,25,33,13,10,3,43
S01008469,Good health,169,8,2,6,26,20,10,14,30,22,11,10,1,28
S01008469,Fair health,48,3,0,3,5,3,8,6,7,12,2,2,0,2
S01008469,Bad health,11,0,0,0,0,0,0,2,4,5,0,0,0,0
S01008469,Very bad health,7,0,0,0,2,1,0,1,0,2,0,0,0,1
S01008470,All people aged 16 to 74,549,18,2,16,49,45,24,51,104,144,61,43,18,53
S01008470,Very good health,197,6,0,6,20,15,10,14,34,39,16,11,5,43
S01008470,Good health,189,9,1,8,16,14,6,19,46,47,25,17,8,7
S01008470,Fair health,99,1,0,1,6,10,5,12,16,35,11,8,3,3
S01008470,Bad health,50,0,0,0,6,5,1,5,6,20,7,5,2,0
S01008470,Very bad health,14,2,1,1,1,1,2,1,2,3,2,2,0,0
S01008471,All people aged 16 to 74,607,17,2,15,56,67,24,44,150,126,61,42,19,62
S01008471,Very good health,264,11,1,10,24,31,6,16,69,44,19,10,9,44
S01008471,Good health,209,4,0,4,22,22,8,20,57,46,18,13,5,12
S01008471,Fair health,86,2,1,1,5,13,4,5,15,20,16,12,4,6
S01008471,Bad health,37,0,0,0,4,1,6,2,8,12,4,3,1,0
S01008471,Very bad health,11,0,0,0,1,0,0,1,1,4,4,4,0,0
S01008472,All people aged 16 to 74,508,16,2,14,63,65,37,47,88,84,45,33,12,63
S01008472,Very good health,247,9,1,8,41,32,17,19,40,25,18,14,4,46
S01008472,Good health,157,4,0,4,19,23,12,18,25,29,12,8,4,15
S01008472,Fair health,69,3,1,2,2,6,7,5,16,18,10,7,3,2
S01008472,Bad health,27,0,0,0,1,2,1,4,6,9,4,3,1,0
S01008472,Very bad health,8,0,0,0,0,2,0,1,1,3,1,1,0,0
S01008473,All people aged 16 to 74,520,20,4,16,65,70,24,37,100,106,45,29,16,53
S01008473,Very good health,228,11,0,11,33,28,10,16,42,36,13,8,5,39
S01008473,Good health,170,6,2,4,20,29,9,12,35,33,17,11,6,9
S01008473,Fair health,73,2,1,1,7,6,3,4,13,25,10,6,4,3
S01008473,Bad health,41,1,1,0,3,7,2,3,8,10,5,4,1,2
S01008473,Very bad health,8,0,0,0,2,0,0,2,2,2,0,0,0,0
S01008474,All people aged 16 to 74,584,20,2,18,63,83,18,62,119,132,39,20,19,48
S01008474,Very good health,219,12,2,10,33,33,4,24,36,38,9,4,5,30
S01008474,Good health,208,8,0,8,15,27,8,22,51,49,13,7,6,15
S01008474,Fair health,89,0,0,0,8,11,4,5,21,27,10,4,6,3
S01008474,Bad health,56,0,0,0,6,9,1,7,11,16,6,4,2,0
S01008474,Very bad health,12,0,0,0,1,3,1,4,0,2,1,1,0,0
S01008475,All people aged 16 to 74,437,17,6,11,71,69,15,27,109,67,18,12,6,44
S01008475,Very good health,174,12,4,8,34,28,6,7,35,22,6,5,1,24
S01008475,Good health,176,4,2,2,28,28,6,15,49,22,5,3,2,19
S01008475,Fair health,61,1,0,1,4,9,2,3,19,17,5,3,2,1
S01008475,Bad health,17,0,0,0,1,4,0,1,5,4,2,1,1,0
S01008475,Very bad health,9,0,0,0,4,0,1,1,1,2,0,0,0,0
S01008476,All people aged 16 to 74,524,33,4,29,78,78,26,47,89,106,41,33,8,26
S01008476,Very good health,206,26,3,23,36,41,11,18,17,28,11,8,3,18
S01008476,Good health,195,4,1,3,32,27,12,14,48,44,8,6,2,6
S01008476,Fair health,68,1,0,1,8,6,1,9,16,19,7,5,2,1
S01008476,Bad health,47,2,0,2,1,4,2,3,7,15,12,11,1,1
S01008476,Very bad health,8,0,0,0,1,0,0,3,1,0,3,3,0,0
S01008477,All people aged 16 to 74,599,28,3,25,90,98,30,70,115,117,29,20,9,22
S01008477,Very good health,215,14,2,12,36,47,12,26,32,28,7,3,4,13
S01008477,Good health,218,11,1,10,35,34,9,26,48,43,4,4,0,8
S01008477,Fair health,108,3,0,3,14,12,5,13,22,26,12,7,5,1
S01008477,Bad health,41,0,0,0,2,4,0,4,11,14,6,6,0,0
S01008477,Very bad health,17,0,0,0,3,1,4,1,2,6,0,0,0,0
S01008478,All people aged 16 to 74,568,27,2,25,99,97,25,45,104,70,48,31,17,53
S01008478,Very good health,251,12,1,11,55,40,14,15,40,25,9,5,4,41
S01008478,Good health,198,12,1,11,37,40,7,15,38,21,16,9,7,12
S01008478,Fair health,64,2,0,2,3,9,2,12,11,11,14,10,4,0
S01008478,Bad health,44,1,0,1,2,6,2,3,13,10,7,5,2,0
S01008478,Very bad health,11,0,0,0,2,2,0,0,2,3,2,2,0,0
S01008479,All people aged 16 to 74,570,22,1,21,98,79,23,48,123,94,41,25,16,42
S01008479,Very good health,237,13,1,12,52,34,10,13,51,26,12,6,6,26
S01008479,Good health,200,7,0,7,32,28,9,20,40,35,16,7,9,13
S01008479,Fair health,94,1,0,1,11,12,3,10,21,24,9,8,1,3
S01008479,Bad health,27,0,0,0,3,2,0,4,9,5,4,4,0,0
S01008479,Very bad health,12,1,0,1,0,3,1,1,2,4,0,0,0,0
S01008480,All people aged 16 to 74,480,33,3,30,88,65,14,33,74,65,33,25,8,75
S01008480,Very good health,259,22,1,21,52,33,6,19,34,27,9,7,2,57
S01008480,Good health,140,7,0,7,28,21,5,12,18,20,13,7,6,16
S01008480,Fair health,56,2,1,1,8,9,2,1,15,11,6,6,0,2
S01008480,Bad health,15,1,1,0,0,1,0,1,6,5,1,1,0,0
S01008480,Very bad health,10,1,0,1,0,1,1,0,1,2,4,4,0,0
S01008481,All people aged 16 to 74,1351,46,7,39,144,133,125,158,238,261,173,160,13,73
S01008481,Very good health,541,23,3,20,70,59,47,58,79,86,68,61,7,51
S01008481,Good health,476,16,4,12,43,56,46,58,102,84,56,54,2,15
S01008481,Fair health,222,2,0,2,19,13,24,29,44,51,36,34,2,4
S01008481,Bad health,68,3,0,3,6,4,5,6,10,24,9,7,2,1
S01008481,Very bad health,44,2,0,2,6,1,3,7,3,16,4,4,0,2
S01008482,All people aged 16 to 74,446,26,8,18,65,75,25,41,86,64,25,17,8,39
S01008482,Very good health,207,13,4,9,42,34,9,18,33,25,7,4,3,26
S01008482,Good health,146,13,4,9,16,25,10,13,31,23,8,6,2,7
S01008482,Fair health,69,0,0,0,5,12,5,7,15,13,8,5,3,4
S01008482,Bad health,18,0,0,0,2,4,1,1,5,2,1,1,0,2
S01008482,Very bad health,6,0,0,0,0,0,0,2,2,1,1,1,0,0
S01008483,All people aged 16 to 74,463,19,1,18,64,73,34,35,92,71,19,14,5,56
S01008483,Very good health,186,12,1,11,25,30,11,10,26,19,6,3,3,47
S01008483,Good health,162,5,0,5,20,24,16,16,43,27,3,2,1,8
S01008483,Fair health,72,2,0,2,15,9,5,5,14,15,6,5,1,1
S01008483,Bad health,33,0,0,0,3,7,2,3,6,8,4,4,0,0
S01008483,Very bad health,10,0,0,0,1,3,0,1,3,2,0,0,0,0
S01008484,All people aged 16 to 74,556,42,14,28,93,108,47,54,84,58,33,19,14,37
S01008484,Very good health,266,27,8,19,50,54,26,19,36,20,8,5,3,26
S01008484,Good health,198,11,3,8,32,37,16,25,32,21,15,5,10,9
S01008484,Fair health,63,3,3,0,7,13,4,6,12,11,5,4,1,2
S01008484,Bad health,21,0,0,0,3,2,0,3,4,5,4,4,0,0
S01008484,Very bad health,8,1,0,1,1,2,1,1,0,1,1,1,0,0
S01008485,All people aged 16 to 74,753,45,14,31,173,147,53,60,105,60,21,12,9,89
S01008485,Very good health,418,29,7,22,109,77,27,27,52,26,12,7,5,59
S01008485,Good health,227,9,5,4,41,54,17,24,30,23,4,3,1,25
S01008485,Fair health,83,7,2,5,19,9,7,7,19,7,4,1,3,4
S01008485,Bad health,20,0,0,0,3,5,2,1,4,4,0,0,0,1
S01008485,Very bad health,5,0,0,0,1,2,0,1,0,0,1,1,0,0
S01008486,All people aged 16 to 74,656,42,9,33,147,115,50,51,97,73,19,12,7,62
S01008486,Very good health,311,26,5,21,81,50,25,22,38,20,9,5,4,40
S01008486,Good health,223,13,4,9,53,40,17,17,35,27,4,4,0,17
S01008486,Fair health,86,1,0,1,10,20,5,6,17,19,5,2,3,3
S01008486,Bad health,21,1,0,1,1,3,1,3,6,4,0,0,0,2
S01008486,Very bad health,15,1,0,1,2,2,2,3,1,3,1,1,0,0
S01008487,All people aged 16 to 74,642,127,22,105,168,89,41,43,54,34,12,6,6,74
S01008487,Very good health,400,83,14,69,109,55,22,23,28,18,3,1,2,59
S01008487,Good health,185,39,8,31,46,31,11,15,16,8,4,2,2,15
S01008487,Fair health,45,5,0,5,11,2,7,4,7,6,3,1,2,0
S01008487,Bad health,8,0,0,0,1,1,1,0,1,2,2,2,0,0
S01008487,Very bad health,4,0,0,0,1,0,0,1,2,0,0,0,0,0
S01008488,All people aged 16 to 74,611,63,6,57,118,97,32,44,75,65,26,20,6,91
S01008488,Very good health,330,44,5,39,70,50,20,18,27,25,11,8,3,65
S01008488,Good health,181,16,1,15,35,31,7,17,27,18,9,6,3,21
S01008488,Fair health,71,2,0,2,9,11,4,6,13,16,5,5,0,5
S01008488,Bad health,20,0,0,0,4,3,1,3,5,4,0,0,0,0
S01008488,Very bad health,9,1,0,1,0,2,0,0,3,2,1,1,0,0
S01008489,All people aged 16 to 74,494,36,6,30,73,98,28,31,71,64,32,18,14,61
S01008489,Very good health,233,22,2,20,32,49,12,15,30,20,9,6,3,44
S01008489,Good health,164,11,3,8,25,30,13,8,29,22,11,3,8,15
S01008489,Fair health,68,2,0,2,8,15,3,5,8,18,7,4,3,2
S01008489,Bad health,27,1,1,0,7,4,0,3,3,4,5,5,0,0
S01008489,Very bad health,2,0,0,0,1,0,0,0,1,0,0,0,0,0
S01008490,All people aged 16 to 74,734,96,9,87,161,124,29,56,98,64,24,13,11,82
S01008490,Very good health,360,61,7,54,89,55,12,28,42,18,3,2,1,52
S01008490,Good health,278,29,2,27,56,55,10,23,37,28,14,9,5,26
S01008490,Fair health,75,6,0,6,12,9,5,4,15,15,6,2,4,3
S01008490,Bad health,17,0,0,0,4,4,1,1,3,3,0,0,0,1
S01008490,Very bad health,4,0,0,0,0,1,1,0,1,0,1,0,1,0
S01008491,All people aged 16 to 74,777,98,7,91,137,107,32,33,94,59,28,19,9,189
S01008491,Very good health,434,67,5,62,80,58,14,20,44,27,6,4,2,118
S01008491,Good health,277,26,1,25,45,42,16,9,35,19,18,12,6,67
S01008491,Fair health,48,5,1,4,5,6,1,2,12,13,0,0,0,4
S01008491,Bad health,15,0,0,0,6,1,1,1,3,0,3,2,1,0
S01008491,Very bad health,3,0,0,0,1,0,0,1,0,0,1,1,0,0
S01008492,All people aged 16 to 74,806,93,7,86,199,114,30,42,89,66,61,52,9,112
S01008492,Very good health,449,69,6,63,127,57,14,27,43,31,7,4,3,74
S01008492,Good health,256,20,1,19,54,43,11,10,33,25,28,25,3,32
S01008492,Fair health,56,4,0,4,9,7,3,3,8,4,12,10,2,6
S01008492,Bad health,36,0,0,0,5,5,2,2,5,6,11,10,1,0
S01008492,Very bad health,9,0,0,0,4,2,0,0,0,0,3,3,0,0
S01008493,All people aged 16 to 74,608,47,7,40,121,102,26,28,90,68,23,17,6,103
S01008493,Very good health,292,26,3,23,70,46,14,10,26,29,5,3,2,66
S01008493,Good health,210,16,3,13,31,37,7,8,45,20,12,10,2,34
S01008493,Fair health,73,3,1,2,15,13,4,4,16,10,5,3,2,3
S01008493,Bad health,25,2,0,2,3,3,0,5,3,8,1,1,0,0
S01008493,Very bad health,8,0,0,0,2,3,1,1,0,1,0,0,0,0
S01008494,All people aged 16 to 74,558,52,2,50,121,86,30,32,64,63,34,24,10,76
S01008494,Very good health,293,32,2,30,75,45,11,14,34,23,13,8,5,46
S01008494,Good health,181,17,0,17,34,30,12,14,19,24,8,4,4,23
S01008494,Fair health,58,2,0,2,8,9,4,4,9,8,7,6,1,7
S01008494,Bad health,18,1,0,1,3,1,3,0,1,5,4,4,0,0
S01008494,Very bad health,8,0,0,0,1,1,0,0,1,3,2,2,0,0
S01008495,All people aged 16 to 74,841,96,3,93,174,122,22,55,90,62,45,27,18,175
S01008495,Very good health,438,55,2,53,105,67,9,30,40,23,15,6,9,94
S01008495,Good health,305,33,1,32,60,37,6,16,38,25,17,10,7,73
S01008495,Fair health,67,6,0,6,7,14,6,2,9,9,8,7,1,6
S01008495,Bad health,25,2,0,2,0,4,1,7,2,4,3,2,1,2
S01008495,Very bad health,6,0,0,0,2,0,0,0,1,1,2,2,0,0
S01008496,All people aged 16 to 74,910,137,11,126,207,126,31,56,77,62,37,13,24,177
S01008496,Very good health,538,100,9,91,141,67,11,25,31,26,17,5,12,120
S01008496,Good health,280,29,0,29,54,45,11,26,30,25,13,6,7,47
S01008496,Fair health,73,8,2,6,10,12,4,2,14,9,5,1,4,9
S01008496,Bad health,14,0,0,0,2,2,3,1,1,2,2,1,1,1
S01008496,Very bad health,5,0,0,0,0,0,2,2,1,0,0,0,0,0
S01008497,All people aged 16 to 74,738,110,7,103,167,103,23,42,95,60,28,16,12,110
S01008497,Very good health,411,73,5,68,94,57,8,20,52,21,17,9,8,69
S01008497,Good health,241,26,2,24,61,33,10,14,35,20,4,3,1,38
S01008497,Fair health,60,7,0,7,10,11,3,6,4,11,5,2,3,3
S01008497,Bad health,20,4,0,4,1,1,2,2,1,8,1,1,0,0
S01008497,Very bad health,6,0,0,0,1,1,0,0,3,0,1,1,0,0
S01008498,All people aged 16 to 74,709,91,9,82,149,86,32,70,87,50,31,18,13,113
S01008498,Very good health,385,57,6,51,97,36,16,30,48,20,12,9,3,69
S01008498,Good health,218,27,2,25,40,35,8,20,22,17,11,3,8,38
S01008498,Fair health,74,6,1,5,7,13,5,10,12,8,7,5,2,6
S01008498,Bad health,25,1,0,1,5,2,3,8,3,3,0,0,0,0
S01008498,Very bad health,7,0,0,0,0,0,0,2,2,2,1,1,0,0
S01008499,All people aged 16 to 74,919,127,11,116,177,112,36,54,79,70,38,22,16,226
S01008499,Very good health,521,90,7,83,116,61,18,25,31,18,8,4,4,154
S01008499,Good health,280,27,2,25,47,40,10,18,30,32,12,5,7,64
S01008499,Fair health,82,6,1,5,8,8,6,6,17,14,9,5,4,8
S01008499,Bad health,30,3,1,2,4,2,1,5,1,6,8,7,1,0
S01008499,Very bad health,6,1,0,1,2,1,1,0,0,0,1,1,0,0
S01008500,All people aged 16 to 74,347,37,2,35,46,42,11,19,43,40,33,23,10,76
S01008500,Very good health,191,23,1,22,33,24,7,9,17,12,9,5,4,57
S01008500,Good health,90,12,1,11,8,9,3,6,18,11,7,5,2,16
S01008500,Fair health,41,2,0,2,4,5,1,3,7,9,7,5,2,3
S01008500,Bad health,20,0,0,0,1,4,0,0,1,6,8,6,2,0
S01008500,Very bad health,5,0,0,0,0,0,0,1,0,2,2,2,0,0
S01008501,All people aged 16 to 74,553,131,6,125,135,45,9,23,28,27,26,20,6,129
S01008501,Very good health,373,93,6,87,100,29,4,12,14,8,11,10,1,102
S01008501,Good health,145,27,0,27,30,14,4,11,12,12,13,8,5,22
S01008501,Fair health,33,11,0,11,5,2,1,0,2,6,1,1,0,5
S01008501,Bad health,2,0,0,0,0,0,0,0,0,1,1,1,0,0
S01008501,Very bad health,0,0,0,0,0,0,0,0,0,0,0,0,0,0
S01008502,All people aged 16 to 74,597,102,9,93,145,84,13,24,44,12,17,11,6,156
S01008502,Very good health,387,68,5,63,98,56,4,19,22,7,11,7,4,102
S01008502,Good health,173,32,3,29,37,20,6,5,17,4,4,2,2,48
S01008502,Fair health,35,2,1,1,8,8,3,0,5,1,2,2,0,6
S01008502,Bad health,2,0,0,0,2,0,0,0,0,0,0,0,0,0
S01008502,Very bad health,0,0,0,0,0,0,0,0,0,0,0,0,0,0
S01008503,All people aged 16 to 74,728,141,7,134,233,76,27,32,55,25,11,5,6,128
S01008503,Very good health,484,101,4,97,164,45,18,19,26,15,6,2,4,90
S01008503,Good health,196,34,1,33,60,22,7,10,19,6,3,2,1,35
S01008503,Fair health,42,5,1,4,9,9,1,1,10,3,2,1,1,2
S01008503,Bad health,4,1,1,0,0,0,1,1,0,0,0,0,0,1
S01008503,Very bad health,2,0,0,0,0,0,0,1,0,1,0,0,0,0
S01008504,All people aged 16 to 74,916,227,23,204,279,103,33,37,57,27,23,15,8,130
S01008504,Very good health,579,155,15,140,183,57,18,17,33,18,6,4,2,92
S01008504,Good health,279,65,7,58,82,38,12,12,18,8,10,8,2,34
S01008504,Fair health,42,6,1,5,14,5,2,5,3,1,4,1,3,2
S01008504,Bad health,12,1,0,1,0,3,1,2,1,0,2,1,1,2
S01008504,Very bad health,4,0,0,0,0,0,0,1,2,0,1,1,0,0
S01008505,All people aged 16 to 74,571,136,17,119,182,54,29,24,41,22,9,2,7,74
S01008505,Very good health,341,93,13,80,119,32,12,15,15,7,2,1,1,46
S01008505,Good health,175,32,2,30,53,17,12,5,18,10,5,0,5,23
S01008505,Fair health,43,10,2,8,8,2,5,4,6,4,2,1,1,2
S01008505,Bad health,10,1,0,1,2,2,0,0,2,1,0,0,0,2
S01008505,Very bad health,2,0,0,0,0,1,0,0,0,0,0,0,0,1
S01008506,All people aged 16 to 74,591,155,20,135,189,56,31,18,43,20,7,4,3,72
S01008506,Very good health,370,115,13,102,107,27,15,12,24,10,4,2,2,56
S01008506,Good health,170,32,6,26,68,20,13,4,10,8,1,1,0,14
S01008506,Fair health,36,6,1,5,9,7,3,1,5,2,2,1,1,1
S01008506,Bad health,10,1,0,1,4,2,0,1,1,0,0,0,0,1
S01008506,Very bad health,5,1,0,1,1,0,0,0,3,0,0,0,0,0
S01008507,All people aged 16 to 74,780,145,11,134,215,70,28,24,43,20,12,9,3,223
S01008507,Very good health,512,106,8,98,139,51,18,11,23,8,7,4,3,149
S01008507,Good health,212,35,2,33,61,14,4,6,14,9,3,3,0,66
S01008507,Fair health,43,3,1,2,12,4,3,5,5,2,1,1,0,8
S01008507,Bad health,11,1,0,1,2,1,3,2,1,1,0,0,0,0
S01008507,Very bad health,2,0,0,0,1,0,0,0,0,0,1,1,0,0
S01008508,All people aged 16 to 74,627,168,22,146,200,71,52,17,40,19,10,7,3,50
S01008508,Very good health,401,108,11,97,135,41,30,11,22,8,5,3,2,41
S01008508,Good health,166,43,9,34,56,20,15,5,13,6,3,2,1,5
S01008508,Fair health,47,14,2,12,7,8,7,1,2,4,1,1,0,3
S01008508,Bad health,11,3,0,3,1,2,0,0,3,0,1,1,0,1
S01008508,Very bad health,2,0,0,0,1,0,0,0,0,1,0,0,0,0
S01008509,All people aged 16 to 74,730,196,27,169,240,85,47,26,43,22,11,6,5,60
S01008509,Very good health,471,142,17,125,160,46,28,14,23,14,4,2,2,40
S01008509,Good health,209,47,10,37,69,29,13,10,13,6,4,2,2,18
S01008509,Fair health,35,7,0,7,7,7,6,2,4,1,1,1,0,0
S01008509,Bad health,13,0,0,0,3,3,0,0,3,0,2,1,1,2
S01008509,Very bad health,2,0,0,0,1,0,0,0,0,1,0,0,0,0
S01008510,All people aged 16 to 74,671,124,24,100,207,88,57,28,55,20,11,8,3,81
S01008510,Very good health,425,78,11,67,137,46,36,16,28,9,5,2,3,70
S01008510,Good health,197,38,9,29,56,33,18,9,21,7,4,4,0,11
S01008510,Fair health,36,7,3,4,12,7,1,0,6,2,1,1,0,0
S01008510,Bad health,10,0,0,0,1,2,2,3,0,1,1,1,0,0
S01008510,Very bad health,3,1,1,0,1,0,0,0,0,1,0,0,0,0
S01008511,All people aged 16 to 74,626,166,25,141,177,69,58,22,37,25,13,11,2,59
S01008511,Very good health,406,113,16,97,115,40,36,10,24,13,6,5,1,49
S01008511,Good health,169,43,7,36,51,25,19,5,8,9,5,4,1,4
S01008511,Fair health,35,8,2,6,7,4,3,3,3,0,2,2,0,5
S01008511,Bad health,12,1,0,1,3,0,0,3,2,3,0,0,0,0
S01008511,Very bad health,4,1,0,1,1,0,0,1,0,0,0,0,0,1
S01008512,All people aged 16 to 74,356,95,16,79,106,49,29,9,19,10,9,5,4,30
S01008512,Very good health,220,61,10,51,65,20,21,6,11,6,4,3,1,26
S01008512,Good health,103,28,5,23,31,21,5,2,7,3,3,1,2,3
S01008512,Fair health,29,5,1,4,9,6,3,1,1,1,2,1,1,1
S01008512,Bad health,2,1,0,1,1,0,0,0,0,0,0,0,0,0
S01008512,Very bad health,2,0,0,0,0,2,0,0,0,0,0,0,0,0
S01008513,All people aged 16 to 74,465,140,30,110,147,48,32,8,39,8,6,4,2,37
S01008513,Very good health,299,97,18,79,94,27,18,7,17,4,1,1,0,34
S01008513,Good health,128,39,12,27,42,16,10,0,16,1,2,1,1,2
S01008513,Fair health,27,2,0,2,9,3,4,1,4,2,1,0,1,1
S01008513,Bad health,7,2,0,2,1,2,0,0,1,0,1,1,0,0
S01008513,Very bad health,4,0,0,0,1,0,0,0,1,1,1,1,0,0
S01008514,All people aged 16 to 74,588,187,17,170,193,44,35,13,28,18,18,14,4,52
S01008514,Very good health,375,139,11,128,117,25,23,7,17,8,2,0,2,37
S01008514,Good health,153,38,5,33,56,14,10,3,6,6,7,6,1,13
S01008514,Fair health,48,10,1,9,17,3,2,1,5,3,6,5,1,1
S01008514,Bad health,10,0,0,0,3,0,0,2,0,1,3,3,0,1
S01008514,Very bad health,2,0,0,0,0,2,0,0,0,0,0,0,0,0
S01008515,All people aged 16 to 74,522,159,18,141,159,54,34,16,38,9,9,3,6,44
S01008515,Very good health,362,116,12,104,103,38,23,12,27,3,5,2,3,35
S01008515,Good health,129,40,5,35,47,11,9,2,8,2,1,0,1,9
S01008515,Fair health,24,3,1,2,7,2,2,2,3,3,2,1,1,0
S01008515,Bad health,5,0,0,0,1,2,0,0,0,1,1,0,1,0
S01008515,Very bad health,2,0,0,0,1,1,0,0,0,0,0,0,0,0
S01008516,All people aged 16 to 74,775,154,17,137,204,86,30,30,63,36,18,6,12,154
S01008516,Very good health,463,92,7,85,133,48,11,13,33,24,7,3,4,102
S01008516,Good health,229,49,7,42,58,26,14,14,15,6,4,2,2,43
S01008516,Fair health,61,7,1,6,11,9,4,3,8,5,6,0,6,8
S01008516,Bad health,17,5,1,4,2,3,1,0,4,0,1,1,0,1
S01008516,Very bad health,5,1,1,0,0,0,0,0,3,1,0,0,0,0
S01008517,All people aged 16 to 74,681,139,11,128,192,72,24,19,32,13,10,5,5,180
S01008517,Very good health,414,86,8,78,124,41,12,9,18,5,5,3,2,114
S01008517,Good health,225,49,3,46,57,24,9,8,11,5,1,0,1,61
S01008517,Fair health,31,2,0,2,9,6,2,2,2,1,3,1,2,4
S01008517,Bad health,10,2,0,2,2,1,1,0,1,2,1,1,0,0
S01008517,Very bad health,1,0,0,0,0,0,0,0,0,0,0,0,0,1
S01008518,All people aged 16 to 74,672,208,17,191,215,57,25,16,37,12,3,2,1,99
S01008518,Very good health,449,147,12,135,120,34,14,14,20,9,2,1,1,89
S01008518,Good health,184,55,5,50,79,14,11,1,11,3,0,0,0,10
S01008518,Fair health,36,5,0,5,15,8,0,1,6,0,1,1,0,0
S01008518,Bad health,1,1,0,1,0,0,0,0,0,0,0,0,0,0
S01008518,Very bad health,2,0,0,0,1,1,0,0,0,0,0,0,0,0
S01008519,All people aged 16 to 74,564,185,21,164,184,49,34,6,35,10,11,7,4,50
S01008519,Very good health,359,133,18,115,120,23,12,3,18,5,3,1,2,42
S01008519,Good health,163,45,2,43,55,20,14,1,13,2,5,3,2,8
S01008519,Fair health,34,6,1,5,8,4,8,1,3,3,1,1,0,0
S01008519,Bad health,5,1,0,1,0,2,0,1,0,0,1,1,0,0
S01008519,Very bad health,3,0,0,0,1,0,0,0,1,0,1,1,0,0
S01008520,All people aged 16 to 74,751,222,42,180,246,78,65,19,42,10,10,6,4,59
S01008520,Very good health,515,160,32,128,160,51,42,13,28,5,5,1,4,51
S01008520,Good health,197,54,9,45,72,19,19,5,14,4,4,4,0,6
S01008520,Fair health,35,7,1,6,13,7,4,1,0,0,1,1,0,2
S01008520,Bad health,4,1,0,1,1,1,0,0,0,1,0,0,0,0
S01008520,Very bad health,0,0,0,0,0,0,0,0,0,0,0,0,0,0
S01008521,All people aged 16 to 74,640,212,29,183,205,69,43,14,29,11,9,7,2,48
S01008521,Very good health,420,148,23,125,131,43,21,10,13,10,3,2,1,41
S01008521,Good health,182,52,4,48,67,23,17,3,12,1,2,1,1,5
S01008521,Fair health,30,10,1,9,6,3,3,1,2,0,3,3,0,2
S01008521,Bad health,5,1,0,1,1,0,2,0,1,0,0,0,0,0
S01008521,Very bad health,3,1,1,0,0,0,0,0,1,0,1,1,0,0
S01008522,All people aged 16 to 74,398,127,21,106,134,41,31,5,14,3,4,2,2,39
S01008522,Very good health,267,94,16,78,77,27,20,3,8,2,2,0,2,34
S01008522,Good health,101,26,3,23,43,9,9,2,5,0,2,2,0,5
S01008522,Fair health,29,7,2,5,14,5,1,0,1,1,0,0,0,0
S01008522,Bad health,1,0,0,0,0,0,1,0,0,0,0,0,0,0
S01008522,Very bad health,0,0,0,0,0,0,0,0,0,0,0,0,0,0
S01008523,All people aged 16 to 74,701,231,42,189,239,77,43,13,32,10,8,6,2,48
S01008523,Very good health,477,166,27,139,168,49,24,8,12,8,2,2,0,40
S01008523,Good health,178,51,11,40,57,21,18,3,15,1,4,3,1,8
S01008523,Fair health,38,13,4,9,12,6,1,2,3,0,1,0,1,0
S01008523,Bad health,8,1,0,1,2,1,0,0,2,1,1,1,0,0
S01008523,Very bad health,0,0,0,0,0,0,0,0,0,0,0,0,0,0
S01008524,All people aged 16 to 74,647,29,11,18,87,90,38,58,130,93,49,30,19,73
S01008524,Very good health,286,16,7,9,47,40,12,22,55,28,14,6,8,52
S01008524,Good health,218,11,4,7,25,33,18,21,47,33,16,8,8,14
S01008524,Fair health,83,2,0,2,9,11,4,6,22,17,7,7,0,5
S01008524,Bad health,44,0,0,0,3,3,2,8,5,13,8,5,3,2
S01008524,Very bad health,16,0,0,0,3,3,2,1,1,2,4,4,0,0
S01008525,All people aged 16 to 74,500,20,2,18,78,75,20,45,105,79,32,20,12,46
S01008525,Very good health,229,9,0,9,39,35,8,16,47,27,10,7,3,38
S01008525,Good health,160,9,2,7,26,26,9,15,33,20,14,8,6,8
S01008525,Fair health,71,2,0,2,8,10,3,9,13,21,5,3,2,0
S01008525,Bad health,33,0,0,0,5,2,0,5,12,6,3,2,1,0
S01008525,Very bad health,7,0,0,0,0,2,0,0,0,5,0,0,0,0
S01008526,All people aged 16 to 74,629,46,7,39,126,105,43,48,99,85,28,18,10,49
S01008526,Very good health,314,28,4,24,72,51,19,20,37,39,10,7,3,38
S01008526,Good health,212,17,3,14,41,42,16,17,36,27,8,4,4,8
S01008526,Fair health,73,1,0,1,9,10,6,4,16,17,8,5,3,2
S01008526,Bad health,25,0,0,0,4,0,2,7,9,2,1,1,0,0
S01008526,Very bad health,5,0,0,0,0,2,0,0,1,0,1,1,0,1
S01008527,All people aged 16 to 74,545,41,9,32,126,103,23,45,85,58,16,13,3,48
S01008527,Very good health,300,21,4,17,73,62,13,22,37,28,4,3,1,40
S01008527,Good health,174,18,5,13,37,30,8,14,28,27,5,5,0,7
S01008527,Fair health,61,2,0,2,16,8,2,9,15,3,5,4,1,1
S01008527,Bad health,9,0,0,0,0,3,0,0,4,0,2,1,1,0
S01008527,Very bad health,1,0,0,0,0,0,0,0,1,0,0,0,0,0
S01008528,All people aged 16 to 74,505,35,5,30,128,89,40,30,93,35,23,7,16,32
S01008528,Very good health,255,22,1,21,71,48,20,10,38,15,9,2,7,22
S01008528,Good health,186,9,1,8,49,32,13,13,38,18,7,3,4,7
S01008528,Fair health,51,4,3,1,6,6,6,3,14,2,7,2,5,3
S01008528,Bad health,12,0,0,0,2,2,1,4,3,0,0,0,0,0
S01008528,Very bad health,1,0,0,0,0,1,0,0,0,0,0,0,0,0
S01008529,All people aged 16 to 74,532,32,11,21,111,97,35,43,92,57,24,12,12,41
S01008529,Very good health,266,21,9,12,65,52,13,23,35,18,8,3,5,31
S01008529,Good health,184,9,2,7,36,30,16,17,40,26,7,5,2,3
S01008529,Fair health,59,2,0,2,8,13,3,3,12,9,4,3,1,5
S01008529,Bad health,19,0,0,0,2,2,1,0,4,3,5,1,4,2
S01008529,Very bad health,4,0,0,0,0,0,2,0,1,1,0,0,0,0
S01008530,All people aged 16 to 74,516,17,1,16,75,71,27,45,112,102,39,25,14,28
S01008530,Very good health,209,9,1,8,41,28,9,15,52,28,11,8,3,16
S01008530,Good health,207,6,0,6,25,31,14,20,42,42,17,10,7,10
S01008530,Fair health,63,2,0,2,4,7,2,7,11,21,7,4,3,2
S01008530,Bad health,29,0,0,0,2,5,2,2,6,9,3,2,1,0
S01008530,Very bad health,8,0,0,0,3,0,0,1,1,2,1,1,0,0
S01008531,All people aged 16 to 74,547,25,4,21,75,88,31,45,114,104,40,30,10,25
S01008531,Very good health,224,16,3,13,33,37,14,13,40,44,12,5,7,15
S01008531,Good health,192,6,1,5,30,30,12,18,44,30,16,13,3,6
S01008531,Fair health,87,1,0,1,6,16,2,8,26,22,5,5,0,1
S01008531,Bad health,39,2,0,2,6,4,3,5,4,7,5,5,0,3
S01008531,Very bad health,5,0,0,0,0,1,0,1,0,1,2,2,0,0
S01008532,All people aged 16 to 74,317,19,3,16,48,57,25,19,55,48,24,14,10,22
S01008532,Very good health,120,11,1,10,26,20,12,7,21,10,2,1,1,11
S01008532,Good health,118,5,1,4,13,24,10,8,22,18,9,5,4,9
S01008532,Fair health,54,3,1,2,7,8,3,4,9,11,8,6,2,1
S01008532,Bad health,16,0,0,0,2,3,0,0,2,5,4,2,2,0
S01008532,Very bad health,9,0,0,0,0,2,0,0,1,4,1,0,1,1
S01008533,All people aged 16 to 74,360,18,2,16,116,77,15,21,48,25,24,20,4,16
S01008533,Very good health,249,13,2,11,90,54,11,17,28,14,10,7,3,12
S01008533,Good health,73,3,0,3,21,20,3,2,14,4,3,2,1,3
S01008533,Fair health,30,2,0,2,3,2,1,2,5,5,9,9,0,1
S01008533,Bad health,7,0,0,0,1,1,0,0,1,2,2,2,0,0
S01008533,Very bad health,1,0,0,0,1,0,0,0,0,0,0,0,0,0
S01008534,All people aged 16 to 74,549,59,15,44,148,120,34,21,62,28,16,8,8,61
S01008534,Very good health,339,35,8,27,91,82,16,9,36,13,9,5,4,48
S01008534,Good health,158,22,5,17,44,32,13,8,17,8,4,2,2,10
S01008534,Fair health,39,1,1,0,9,5,4,2,6,6,3,1,2,3
S01008534,Bad health,12,1,1,0,4,1,1,1,3,1,0,0,0,0
S01008534,Very bad health,1,0,0,0,0,0,0,1,0,0,0,0,0,0
S01008535,All people aged 16 to 74,543,96,17,79,157,97,49,15,33,26,11,5,6,59
S01008535,Very good health,348,61,12,49,106,66,26,5,16,11,8,4,4,49
S01008535,Good health,154,29,4,25,39,28,18,8,14,9,2,0,2,7
S01008535,Fair health,31,5,1,4,10,0,4,2,2,5,1,1,0,2
S01008535,Bad health,9,1,0,1,2,2,1,0,1,1,0,0,0,1
S01008535,Very bad health,1,0,0,0,0,1,0,0,0,0,0,0,0,0
S01008536,All people aged 16 to 74,391,88,10,78,125,62,30,16,29,14,2,1,1,25
S01008536,Very good health,257,59,5,54,84,39,17,14,16,3,1,1,0,24
S01008536,Good health,107,22,3,19,34,21,11,2,10,5,1,0,1,1
S01008536,Fair health,19,4,1,3,6,1,2,0,1,5,0,0,0,0
S01008536,Bad health,6,2,1,1,1,1,0,0,1,1,0,0,0,0
S01008536,Very bad health,2,1,0,1,0,0,0,0,1,0,0,0,0,0
S01008537,All people aged 16 to 74,508,121,18,103,169,76,30,15,42,9,7,4,3,39
S01008537,Very good health,323,79,10,69,109,45,20,7,21,5,3,2,1,34
S01008537,Good health,160,38,7,31,54,27,7,7,18,2,2,0,2,5
S01008537,Fair health,19,3,1,2,5,3,2,1,3,1,1,1,0,0
S01008537,Bad health,5,1,0,1,1,0,1,0,0,1,1,1,0,0
S01008537,Very bad health,1,0,0,0,0,1,0,0,0,0,0,0,0,0
S01008538,All people aged 16 to 74,373,80,14,66,145,46,29,10,13,6,7,4,3,37
S01008538,Very good health,243,58,10,48,93,31,13,4,6,4,3,1,2,31
S01008538,Good health,106,20,4,16,44,12,10,6,5,1,3,2,1,5
S01008538,Fair health,19,1,0,1,7,3,4,0,2,1,0,0,0,1
S01008538,Bad health,5,1,0,1,1,0,2,0,0,0,1,1,0,0
S01008538,Very bad health,0,0,0,0,0,0,0,0,0,0,0,0,0,0
S01008539,All people aged 16 to 74,613,157,24,133,196,84,42,18,40,20,9,6,3,47
S01008539,Very good health,377,98,13,85,122,54,26,11,19,9,3,2,1,35
S01008539,Good health,184,46,10,36,58,27,12,6,17,5,3,2,1,10
S01008539,Fair health,44,12,1,11,12,3,3,1,3,5,3,2,1,2
S01008539,Bad health,7,1,0,1,4,0,1,0,1,0,0,0,0,0
S01008539,Very bad health,1,0,0,0,0,0,0,0,0,1,0,0,0,0
S01008540,All people aged 16 to 74,598,141,21,120,198,84,60,20,33,14,3,0,3,45
S01008540,Very good health,372,89,15,74,118,54,35,8,22,8,2,0,2,36
S01008540,Good health,174,41,6,35,64,19,18,9,10,4,0,0,0,9
S01008540,Fair health,43,9,0,9,13,10,6,3,1,0,1,0,1,0
S01008540,Bad health,7,2,0,2,1,1,1,0,0,2,0,0,0,0
S01008540,Very bad health,2,0,0,0,2,0,0,0,0,0,0,0,0,0
S01008541,All people aged 16 to 74,618,119,14,105,200,116,38,12,44,24,11,8,3,54
S01008541,Very good health,391,79,12,67,128,68,22,6,28,14,1,0,1,45
S01008541,Good health,193,31,2,29,61,42,14,6,14,9,7,5,2,9
S01008541,Fair health,26,6,0,6,11,6,1,0,2,0,0,0,0,0
S01008541,Bad health,6,3,0,3,0,0,1,0,0,1,1,1,0,0
S01008541,Very bad health,2,0,0,0,0,0,0,0,0,0,2,2,0,0
S01008542,All people aged 16 to 74,670,136,25,111,211,126,39,18,46,23,10,5,5,61
S01008542,Very good health,406,87,10,77,128,69,18,8,29,10,6,3,3,51
S01008542,Good health,219,43,14,29,71,47,14,8,15,10,2,1,1,9
S01008542,Fair health,34,5,1,4,8,9,5,1,1,2,2,1,1,1
S01008542,Bad health,9,1,0,1,3,1,1,1,1,1,0,0,0,0
S01008542,Very bad health,2,0,0,0,1,0,1,0,0,0,0,0,0,0
S01008543,All people aged 16 to 74,542,88,15,73,174,86,43,34,39,25,11,8,3,42
S01008543,Very good health,347,57,10,47,121,52,23,19,23,14,3,2,1,35
S01008543,Good health,151,23,5,18,47,26,15,12,10,8,3,2,1,7
S01008543,Fair health,34,8,0,8,6,5,5,3,4,1,2,1,1,0
S01008543,Bad health,8,0,0,0,0,2,0,0,2,2,2,2,0,0
S01008543,Very bad health,2,0,0,0,0,1,0,0,0,0,1,1,0,0
S01008544,All people aged 16 to 74,467,125,16,109,144,49,33,18,18,12,7,2,5,61
S01008544,Very good health,341,95,12,83,97,40,24,11,11,10,3,0,3,50
S01008544,Good health,104,27,3,24,41,7,6,5,5,1,1,0,1,11
S01008544,Fair health,18,3,1,2,5,2,3,2,1,1,1,1,0,0
S01008544,Bad health,3,0,0,0,1,0,0,0,1,0,1,1,0,0
S01008544,Very bad health,1,0,0,0,0,0,0,0,0,0,1,0,1,0
S01008545,All people aged 16 to 74,626,175,29,146,195,73,58,14,30,10,11,7,4,60
S01008545,Very good health,415,124,17,107,120,46,36,9,17,6,4,1,3,53
S01008545,Good health,167,36,10,26,62,21,17,5,11,3,5,4,1,7
S01008545,Fair health,33,11,1,10,11,4,2,0,2,1,2,2,0,0
S01008545,Bad health,10,4,1,3,2,2,2,0,0,0,0,0,0,0
S01008545,Very bad health,1,0,0,0,0,0,1,0,0,0,0,0,0,0
S01008546,All people aged 16 to 74,621,164,35,129,211,83,49,15,34,12,9,6,3,44
S01008546,Very good health,379,95,16,79,129,45,33,10,19,5,3,2,1,40
S01008546,Good health,192,56,14,42,65,30,11,5,13,4,4,2,2,4
S01008546,Fair health,42,12,5,7,15,7,4,0,0,3,1,1,0,0
S01008546,Bad health,7,1,0,1,2,1,1,0,2,0,0,0,0,0
S01008546,Very bad health,1,0,0,0,0,0,0,0,0,0,1,1,0,0
S01008547,All people aged 16 to 74,786,100,14,86,211,129,68,56,87,56,31,19,12,48
S01008547,Very good health,463,73,10,63,132,79,30,27,40,28,15,8,7,39
S01008547,Good health,231,26,4,22,62,39,26,21,27,14,9,5,4,7
S01008547,Fair health,70,1,0,1,11,10,9,4,15,13,5,4,1,2
S01008547,Bad health,20,0,0,0,6,1,2,3,5,1,2,2,0,0
S01008547,Very bad health,2,0,0,0,0,0,1,1,0,0,0,0,0,0
S01008548,All people aged 16 to 74,641,71,17,54,161,93,55,55,74,64,29,17,12,39
S01008548,Very good health,367,46,10,36,103,57,26,25,36,33,11,5,6,30
S01008548,Good health,196,23,6,17,48,23,21,21,26,19,7,5,2,8
S01008548,Fair health,58,1,0,1,6,10,7,9,9,10,5,3,2,1
S01008548,Bad health,16,0,0,0,4,2,1,0,3,1,5,3,2,0
S01008548,Very bad health,4,1,1,0,0,1,0,0,0,1,1,1,0,0
S01008549,All people aged 16 to 74,736,63,14,49,167,116,77,69,99,68,31,22,9,46
S01008549,Very good health,346,31,6,25,79,53,40,29,47,23,7,6,1,37
S01008549,Good health,255,23,7,16,64,43,28,23,28,26,12,6,6,8
S01008549,Fair health,94,5,1,4,14,19,5,11,18,17,5,4,1,0
S01008549,Bad health,32,3,0,3,7,1,3,5,5,2,5,4,1,1
S01008549,Very bad health,9,1,0,1,3,0,1,1,1,0,2,2,0,0
S01008550,All people aged 16 to 74,630,113,21,92,186,94,45,33,68,26,17,14,3,48
S01008550,Very good health,371,76,12,64,123,49,20,14,29,12,6,4,2,42
S01008550,Good health,192,32,6,26,49,38,18,10,27,9,3,2,1,6
S01008550,Fair health,44,3,2,1,8,7,7,6,8,3,2,2,0,0
S01008550,Bad health,13,2,1,1,3,0,0,0,2,2,4,4,0,0
S01008550,Very bad health,10,0,0,0,3,0,0,3,2,0,2,2,0,0
S01008551,All people aged 16 to 74,771,96,12,84,190,145,80,44,90,54,22,15,7,50
S01008551,Very good health,410,58,8,50,117,74,37,16,45,21,9,6,3,33
S01008551,Good health,266,33,4,29,52,55,31,17,33,22,8,5,3,15
S01008551,Fair health,75,4,0,4,16,13,9,8,9,11,3,3,0,2
S01008551,Bad health,17,1,0,1,5,3,2,2,3,0,1,1,0,0
S01008551,Very bad health,3,0,0,0,0,0,1,1,0,0,1,0,1,0
S01008552,All people aged 16 to 74,676,91,11,80,173,104,64,39,87,38,19,13,6,61
S01008552,Very good health,376,58,4,54,102,55,30,17,38,13,8,6,2,55
S01008552,Good health,239,30,7,23,56,41,22,17,38,22,7,4,3,6
S01008552,Fair health,49,3,0,3,10,6,10,5,10,2,3,2,1,0
S01008552,Bad health,12,0,0,0,5,2,2,0,1,1,1,1,0,0
S01008552,Very bad health,0,0,0,0,0,0,0,0,0,0,0,0,0,0
S01008553,All people aged 16 to 74,411,39,7,32,77,74,37,28,53,56,17,13,4,30
S01008553,Very good health,194,21,5,16,40,31,15,13,22,25,3,1,2,24
S01008553,Good health,150,13,1,12,28,33,17,8,22,18,6,4,2,5
S01008553,Fair health,45,3,0,3,9,8,3,4,5,6,6,6,0,1
S01008553,Bad health,16,1,0,1,0,1,1,3,3,6,1,1,0,0
S01008553,Very bad health,6,1,1,0,0,1,1,0,1,1,1,1,0,0
S01008554,All people aged 16 to 74,738,34,5,29,71,64,52,56,148,155,101,75,26,57
S01008554,Very good health,339,22,2,20,35,39,25,27,66,53,32,27,5,40
S01008554,Good health,217,9,1,8,24,14,14,13,49,44,38,22,16,12
S01008554,Fair health,111,2,1,1,8,8,6,11,20,35,18,16,2,3
S01008554,Bad health,55,1,1,0,4,3,3,4,10,18,11,8,3,1
S01008554,Very bad health,16,0,0,0,0,0,4,1,3,5,2,2,0,1
S01008555,All people aged 16 to 74,755,33,4,29,101,85,38,48,148,142,94,68,26,66
S01008555,Very good health,290,20,1,19,50,38,12,19,40,42,21,11,10,48
S01008555,Good health,284,8,3,5,35,33,16,17,69,51,43,32,11,12
S01008555,Fair health,112,3,0,3,9,10,5,8,24,26,23,19,4,4
S01008555,Bad health,51,1,0,1,6,2,3,4,10,19,4,4,0,2
S01008555,Very bad health,18,1,0,1,1,2,2,0,5,4,3,2,1,0
S01008556,All people aged 16 to 74,522,16,2,14,75,60,30,48,90,101,59,39,20,43
S01008556,Very good health,219,10,2,8,36,24,12,22,33,39,18,11,7,25
S01008556,Good health,187,2,0,2,32,22,13,16,36,35,20,12,8,11
S01008556,Fair health,82,3,0,3,5,13,4,5,13,18,15,11,4,6
S01008556,Bad health,27,0,0,0,1,1,0,4,7,7,6,5,1,1
S01008556,Very bad health,7,1,0,1,1,0,1,1,1,2,0,0,0,0
S01008557,All people aged 16 to 74,584,17,3,14,74,60,28,60,124,122,61,43,18,38
S01008557,Very good health,218,10,2,8,35,24,9,20,48,33,16,12,4,23
S01008557,Good health,205,4,0,4,26,20,13,22,45,43,18,14,4,14
S01008557,Fair health,108,3,1,2,11,12,4,11,21,26,19,12,7,1
S01008557,Bad health,41,0,0,0,1,4,2,5,9,15,5,3,2,0
S01008557,Very bad health,12,0,0,0,1,0,0,2,1,5,3,2,1,0
S01008558,All people aged 16 to 74,618,27,6,21,88,86,38,58,119,108,51,39,12,43
S01008558,Very good health,276,20,4,16,51,36,13,27,40,36,23,17,6,30
S01008558,Good health,198,6,2,4,27,30,14,17,47,30,17,13,4,10
S01008558,Fair health,87,1,0,1,6,11,6,7,20,29,5,4,1,2
S01008558,Bad health,38,0,0,0,3,6,2,5,9,9,3,3,0,1
S01008558,Very bad health,19,0,0,0,1,3,3,2,3,4,3,2,1,0
S01008559,All people aged 16 to 74,495,18,4,14,63,64,30,52,93,101,36,27,9,38
S01008559,Very good health,192,6,0,6,36,23,7,20,33,31,12,9,3,24
S01008559,Good health,173,11,3,8,19,28,14,18,30,34,11,7,4,8
S01008559,Fair health,84,1,1,0,8,10,5,7,19,22,7,5,2,5
S01008559,Bad health,36,0,0,0,0,3,3,5,7,13,5,5,0,0
S01008559,Very bad health,10,0,0,0,0,0,1,2,4,1,1,1,0,1
S01008560,All people aged 16 to 74,492,19,4,15,76,64,26,53,98,85,39,30,9,32
S01008560,Very good health,236,13,2,11,40,32,8,27,48,31,12,8,4,25
S01008560,Good health,147,4,2,2,21,24,11,15,32,24,11,9,2,5
S01008560,Fair health,73,1,0,1,11,7,7,5,15,16,11,8,3,0
S01008560,Bad health,30,1,0,1,3,1,0,5,3,10,5,5,0,2
S01008560,Very bad health,6,0,0,0,1,0,0,1,0,4,0,0,0,0
S01008561,All people aged 16 to 74,472,26,5,21,75,71,32,33,98,75,18,11,7,44
S01008561,Very good health,234,17,4,13,40,35,14,13,42,30,6,5,1,37
S01008561,Good health,165,6,1,5,28,23,13,17,40,24,7,3,4,7
S01008561,Fair health,52,2,0,2,4,9,4,2,12,16,3,1,2,0
S01008561,Bad health,15,1,0,1,2,3,1,0,3,3,2,2,0,0
S01008561,Very bad health,6,0,0,0,1,1,0,1,1,2,0,0,0,0
S01008562,All people aged 16 to 74,430,17,1,16,52,62,24,35,93,84,40,23,17,23
S01008562,Very good health,144,9,0,9,24,24,9,15,30,12,8,2,6,13
S01008562,Good health,147,7,1,6,22,21,10,8,32,29,15,8,7,3
S01008562,Fair health,82,0,0,0,2,7,3,6,21,26,12,8,4,5
S01008562,Bad health,46,1,0,1,2,8,1,4,9,14,5,5,0,2
S01008562,Very bad health,11,0,0,0,2,2,1,2,1,3,0,0,0,0
S01008563,All people aged 16 to 74,612,32,6,26,88,66,30,53,129,113,51,36,15,50
S01008563,Very good health,253,20,5,15,42,28,12,14,48,33,19,15,4,37
S01008563,Good health,232,10,1,9,35,26,11,22,49,46,23,12,11,10
S01008563,Fair health,96,1,0,1,9,11,5,12,22,28,6,6,0,2
S01008563,Bad health,25,0,0,0,2,0,2,3,9,5,3,3,0,1
S01008563,Very bad health,6,1,0,1,0,1,0,2,1,1,0,0,0,0
S01008564,All people aged 16 to 74,467,22,4,18,77,67,30,56,84,83,25,19,6,23
S01008564,Very good health,194,13,2,11,39,28,12,21,32,23,5,2,3,21
S01008564,Good health,153,4,1,3,28,29,9,19,31,24,8,6,2,1
S01008564,Fair health,81,5,1,4,5,7,8,9,15,21,10,9,1,1
S01008564,Bad health,27,0,0,0,4,3,1,6,4,8,1,1,0,0
S01008564,Very bad health,12,0,0,0,1,0,0,1,2,7,1,1,0,0
S01008565,All people aged 16 to 74,653,19,5,14,91,102,41,57,113,127,55,35,20,48
S01008565,Very good health,294,8,1,7,38,47,23,23,47,51,27,19,8,30
S01008565,Good health,214,6,3,3,42,38,7,21,35,33,16,8,8,16
S01008565,Fair health,101,2,0,2,9,14,8,7,23,29,7,4,3,2
S01008565,Bad health,29,2,1,1,2,3,2,4,5,8,3,2,1,0
S01008565,Very bad health,15,1,0,1,0,0,1,2,3,6,2,2,0,0
S01008566,All people aged 16 to 74,774,29,6,23,98,102,57,88,154,138,68,53,15,40
S01008566,Very good health,331,17,3,14,52,54,26,31,65,37,24,16,8,25
S01008566,Good health,256,8,3,5,32,33,18,33,51,52,17,11,6,12
S01008566,Fair health,118,2,0,2,9,11,11,8,24,34,16,15,1,3
S01008566,Bad health,46,2,0,2,2,2,2,14,9,9,6,6,0,0
S01008566,Very bad health,23,0,0,0,3,2,0,2,5,6,5,5,0,0
S01008567,All people aged 16 to 74,541,28,4,24,87,65,38,50,101,88,42,34,8,42
S01008567,Very good health,268,19,2,17,45,36,13,25,51,30,14,9,5,35
S01008567,Good health,140,6,0,6,27,17,11,15,23,24,11,8,3,6
S01008567,Fair health,84,1,0,1,12,9,11,4,16,23,8,8,0,0
S01008567,Bad health,41,2,2,0,3,3,2,2,11,10,7,7,0,1
S01008567,Very bad health,8,0,0,0,0,0,1,4,0,1,2,2,0,0
S01008568,All people aged 16 to 74,593,47,6,41,138,98,43,38,106,49,34,25,9,40
S01008568,Very good health,319,33,3,30,85,55,18,12,50,20,13,9,4,33
S01008568,Good health,190,10,3,7,38,31,19,20,34,18,14,9,5,6
S01008568,Fair health,51,4,0,4,9,8,4,4,13,5,3,3,0,1
S01008568,Bad health,28,0,0,0,4,4,2,2,7,6,3,3,0,0
S01008568,Very bad health,5,0,0,0,2,0,0,0,2,0,1,1,0,0
S01008569,All people aged 16 to 74,492,33,0,33,38,29,27,35,88,104,94,53,41,44
S01008569,Very good health,186,14,0,14,23,10,11,14,26,31,28,22,6,29
S01008569,Good health,182,16,0,16,8,15,11,9,42,38,29,13,16,14
S01008569,Fair health,72,3,0,3,4,3,5,8,10,19,20,7,13,0
S01008569,Bad health,42,0,0,0,3,1,0,3,8,14,12,6,6,1
S01008569,Very bad health,10,0,0,0,0,0,0,1,2,2,5,5,0,0
S01008570,All people aged 16 to 74,665,20,3,17,79,69,53,66,130,116,81,57,24,51
S01008570,Very good health,280,11,2,9,37,34,18,22,51,42,33,25,8,32
S01008570,Good health,241,5,0,5,26,21,30,25,51,43,27,17,10,13
S01008570,Fair health,90,1,0,1,8,11,4,10,19,19,13,8,5,5
S01008570,Bad health,43,3,1,2,5,0,1,8,6,12,7,6,1,1
S01008570,Very bad health,11,0,0,0,3,3,0,1,3,0,1,1,0,0
S01008571,All people aged 16 to 74,492,27,4,23,71,73,36,32,113,81,24,16,8,35
S01008571,Very good health,213,14,0,14,38,32,16,19,43,22,9,7,2,20
S01008571,Good health,177,10,3,7,20,28,16,9,40,33,8,4,4,13
S01008571,Fair health,72,3,1,2,9,11,4,4,18,16,5,3,2,2
S01008571,Bad health,17,0,0,0,3,0,0,0,7,6,1,1,0,0
S01008571,Very bad health,13,0,0,0,1,2,0,0,5,4,1,1,0,0
S01008572,All people aged 16 to 74,629,39,6,33,112,80,48,50,123,96,31,23,8,50
S01008572,Very good health,295,30,4,26,56,37,20,26,43,31,14,12,2,38
S01008572,Good health,217,8,2,6,42,28,24,18,50,30,6,4,2,11
S01008572,Fair health,70,0,0,0,7,9,3,5,17,18,10,7,3,1
S01008572,Bad health,36,1,0,1,4,4,1,1,10,14,1,0,1,0
S01008572,Very bad health,11,0,0,0,3,2,0,0,3,3,0,0,0,0
S01008573,All people aged 16 to 74,606,93,14,79,129,99,67,50,61,37,21,19,2,49
S01008573,Very good health,321,54,5,49,75,54,35,20,26,11,9,7,2,37
S01008573,Good health,205,34,6,28,39,38,25,22,19,12,5,5,0,11
S01008573,Fair health,60,4,2,2,11,6,6,7,12,9,4,4,0,1
S01008573,Bad health,16,1,1,0,4,1,1,1,3,4,1,1,0,0
S01008573,Very bad health,4,0,0,0,0,0,0,0,1,1,2,2,0,0
S01008574,All people aged 16 to 74,576,97,12,85,137,90,44,39,58,37,15,12,3,59
S01008574,Very good health,337,62,5,57,87,50,16,18,28,21,7,6,1,48
S01008574,Good health,184,25,5,20,46,30,17,14,23,13,5,4,1,11
S01008574,Fair health,45,8,1,7,2,8,10,5,7,2,3,2,1,0
S01008574,Bad health,10,2,1,1,2,2,1,2,0,1,0,0,0,0
S01008574,Very bad health,0,0,0,0,0,0,0,0,0,0,0,0,0,0
S01008575,All people aged 16 to 74,594,124,25,99,158,90,59,29,50,14,17,14,3,53
S01008575,Very good health,364,88,20,68,103,49,34,13,20,5,8,8,0,44
S01008575,Good health,180,31,4,27,48,33,14,9,25,5,6,5,1,9
S01008575,Fair health,41,4,1,3,7,5,10,6,3,4,2,0,2,0
S01008575,Bad health,7,1,0,1,0,3,1,1,1,0,0,0,0,0
S01008575,Very bad health,2,0,0,0,0,0,0,0,1,0,1,1,0,0
S01008576,All people aged 16 to 74,648,82,7,75,159,96,60,36,85,46,13,8,5,71
S01008576,Very good health,377,50,4,46,92,60,34,17,42,24,7,3,4,51
S01008576,Good health,203,27,3,24,51,27,21,15,29,12,3,3,0,18
S01008576,Fair health,58,5,0,5,15,8,3,4,10,9,2,2,0,2
S01008576,Bad health,8,0,0,0,1,1,2,0,2,1,1,0,1,0
S01008576,Very bad health,2,0,0,0,0,0,0,0,2,0,0,0,0,0
S01008577,All people aged 16 to 74,575,94,10,84,172,82,55,26,56,30,19,14,5,41
S01008577,Very good health,296,53,3,50,89,37,32,16,24,9,6,5,1,30
S01008577,Good health,217,38,7,31,68,33,18,8,23,12,7,4,3,10
S01008577,Fair health,53,3,0,3,14,11,5,2,6,5,6,5,1,1
S01008577,Bad health,4,0,0,0,0,0,0,0,2,2,0,0,0,0
S01008577,Very bad health,5,0,0,0,1,1,0,0,1,2,0,0,0,0
S01008578,All people aged 16 to 74,527,158,22,136,173,50,50,8,22,9,8,6,2,49
S01008578,Very good health,346,113,16,97,111,32,24,3,17,8,2,2,0,36
S01008578,Good health,144,37,5,32,52,12,22,4,3,0,5,3,2,9
S01008578,Fair health,27,7,1,6,10,5,3,0,0,0,1,1,0,1
S01008578,Bad health,8,1,0,1,0,0,1,1,1,1,0,0,0,3
S01008578,Very bad health,2,0,0,0,0,1,0,0,1,0,0,0,0,0
S01008579,All people aged 16 to 74,506,111,13,98,154,58,63,20,28,17,16,14,2,39
S01008579,Very good health,266,66,8,58,81,26,29,10,14,4,4,2,2,32
S01008579,Good health,170,38,5,33,59,23,25,5,5,7,3,3,0,5
S01008579,Fair health,54,6,0,6,11,8,7,3,9,3,6,6,0,1
S01008579,Bad health,15,1,0,1,3,1,1,2,0,3,3,3,0,1
S01008579,Very bad health,1,0,0,0,0,0,1,0,0,0,0,0,0,0
S01008580,All people aged 16 to 74,417,66,9,57,90,67,25,24,50,34,11,6,5,50
S01008580,Very good health,232,43,6,37,53,36,9,13,19,15,4,2,2,40
S01008580,Good health,138,18,1,17,31,24,15,6,22,11,4,3,1,7
S01008580,Fair health,34,4,1,3,4,6,1,4,8,5,1,0,1,1
S01008580,Bad health,10,1,1,0,1,1,0,1,0,3,1,0,1,2
S01008580,Very bad health,3,0,0,0,1,0,0,0,1,0,1,1,0,0
S01008581,All people aged 16 to 74,672,37,4,33,108,92,34,57,138,106,38,18,20,62
S01008581,Very good health,296,23,1,22,58,34,14,23,52,39,15,7,8,38
S01008581,Good health,227,12,2,10,37,39,14,17,50,31,8,3,5,19
S01008581,Fair health,94,2,1,1,9,11,6,8,19,24,10,5,5,5
S01008581,Bad health,44,0,0,0,3,6,0,7,13,11,4,2,2,0
S01008581,Very bad health,11,0,0,0,1,2,0,2,4,1,1,1,0,0
S01008582,All people aged 16 to 74,749,67,8,59,119,113,53,57,111,115,48,28,20,66
S01008582,Very good health,339,39,3,36,63,58,26,15,40,37,13,5,8,48
S01008582,Good health,260,22,3,19,36,37,13,22,49,50,15,8,7,16
S01008582,Fair health,99,5,2,3,14,12,9,11,11,19,17,12,5,1
S01008582,Bad health,38,1,0,1,5,3,3,7,9,6,3,3,0,1
S01008582,Very bad health,13,0,0,0,1,3,2,2,2,3,0,0,0,0
S01008583,All people aged 16 to 74,519,47,2,45,83,62,35,41,75,73,28,22,6,75
S01008583,Very good health,261,30,1,29,40,31,15,20,32,27,9,7,2,57
S01008583,Good health,156,13,1,12,31,13,13,10,25,24,12,9,3,15
S01008583,Fair health,63,4,0,4,6,11,5,7,10,15,4,3,1,1
S01008583,Bad health,25,0,0,0,6,4,1,3,4,3,2,2,0,2
S01008583,Very bad health,14,0,0,0,0,3,1,1,4,4,1,1,0,0
S01008584,All people aged 16 to 74,607,60,9,51,95,86,37,36,89,84,34,24,10,86
S01008584,Very good health,319,31,6,25,58,55,15,15,41,35,11,8,3,58
S01008584,Good health,203,26,3,23,29,21,15,13,31,31,14,10,4,23
S01008584,Fair health,59,3,0,3,8,8,3,5,12,10,7,4,3,3
S01008584,Bad health,20,0,0,0,0,2,3,2,4,8,1,1,0,0
S01008584,Very bad health,6,0,0,0,0,0,1,1,1,0,1,1,0,2
S01008585,All people aged 16 to 74,433,26,2,24,75,53,23,38,81,64,29,21,8,44
S01008585,Very good health,213,16,0,16,43,28,12,13,34,25,14,12,2,28
S01008585,Good health,115,6,1,5,15,13,10,9,28,16,6,2,4,12
S01008585,Fair health,78,4,1,3,12,7,1,11,16,16,8,6,2,3
S01008585,Bad health,21,0,0,0,4,5,0,2,2,6,1,1,0,1
S01008585,Very bad health,6,0,0,0,1,0,0,3,1,1,0,0,0,0
S01008586,All people aged 16 to 74,582,37,5,32,83,73,35,62,102,100,41,28,13,49
S01008586,Very good health,248,23,2,21,41,25,12,30,42,35,8,4,4,32
S01008586,Good health,183,8,0,8,27,30,15,18,30,21,21,17,4,13
S01008586,Fair health,90,4,1,3,10,13,5,9,16,22,7,4,3,4
S01008586,Bad health,39,2,2,0,4,3,2,4,9,11,4,2,2,0
S01008586,Very bad health,22,0,0,0,1,2,1,1,5,11,1,1,0,0
S01008587,All people aged 16 to 74,718,155,23,132,152,70,45,23,32,11,29,26,3,201
S01008587,Very good health,429,102,13,89,90,44,22,6,15,2,9,8,1,139
S01008587,Good health,234,47,9,38,50,20,16,13,14,3,10,10,0,61
S01008587,Fair health,51,5,1,4,12,5,7,4,3,5,9,7,2,1
S01008587,Bad health,4,1,0,1,0,1,0,0,0,1,1,1,0,0
S01008587,Very bad health,0,0,0,0,0,0,0,0,0,0,0,0,0,0
S01008588,All people aged 16 to 74,539,129,6,123,161,46,28,17,32,17,14,8,6,95
S01008588,Very good health,346,94,3,91,101,25,15,9,14,9,8,4,4,71
S01008588,Good health,153,31,2,29,51,16,8,6,13,5,2,1,1,21
S01008588,Fair health,31,4,1,3,7,4,5,1,4,2,2,1,1,2
S01008588,Bad health,7,0,0,0,2,1,0,1,0,0,2,2,0,1
S01008588,Very bad health,2,0,0,0,0,0,0,0,1,1,0,0,0,0
S01008589,All people aged 16 to 74,255,54,7,47,66,47,14,10,27,8,7,7,0,22
S01008589,Very good health,145,35,5,30,32,26,9,5,15,2,2,2,0,19
S01008589,Good health,81,16,2,14,25,16,3,3,9,3,3,3,0,3
S01008589,Fair health,26,3,0,3,9,4,2,1,3,2,2,2,0,0
S01008589,Bad health,2,0,0,0,0,1,0,0,0,1,0,0,0,0
S01008589,Very bad health,1,0,0,0,0,0,0,1,0,0,0,0,0,0
S01008590,All people aged 16 to 74,511,116,18,98,140,66,23,12,39,11,8,5,3,96
S01008590,Very good health,310,78,10,68,89,33,10,4,13,5,3,1,2,75
S01008590,Good health,155,35,7,28,42,27,9,4,16,3,0,0,0,19
S01008590,Fair health,34,2,0,2,7,4,3,2,7,2,5,4,1,2
S01008590,Bad health,8,1,1,0,2,2,1,1,0,1,0,0,0,0
S01008590,Very bad health,4,0,0,0,0,0,0,1,3,0,0,0,0,0
S01008591,All people aged 16 to 74,627,130,11,119,157,52,41,29,40,17,24,20,4,137
S01008591,Very good health,396,93,7,86,109,33,25,5,20,1,7,7,0,103
S01008591,Good health,167,33,4,29,33,14,13,10,15,8,8,6,2,33
S01008591,Fair health,43,3,0,3,8,5,2,10,3,5,6,5,1,1
S01008591,Bad health,15,1,0,1,5,0,0,4,1,2,2,2,0,0
S01008591,Very bad health,6,0,0,0,2,0,1,0,1,1,1,0,1,0
S01008592,All people aged 16 to 74,534,67,5,62,113,61,34,30,62,42,17,13,4,108
S01008592,Very good health,333,54,4,50,74,38,20,14,28,14,11,8,3,80
S01008592,Good health,133,11,0,11,34,13,5,10,24,13,2,1,1,21
S01008592,Fair health,46,1,1,0,2,10,8,2,6,9,1,1,0,7
S01008592,Bad health,10,0,0,0,1,0,0,0,3,3,3,3,0,0
S01008592,Very bad health,12,1,0,1,2,0,1,4,1,3,0,0,0,0
S01008593,All people aged 16 to 74,544,193,29,164,160,39,51,13,18,7,12,10,2,51
S01008593,Very good health,379,140,23,117,107,30,30,9,12,6,5,4,1,40
S01008593,Good health,121,47,6,41,38,5,14,2,5,0,3,2,1,7
S01008593,Fair health,34,4,0,4,13,2,7,1,0,1,2,2,0,4
S01008593,Bad health,7,2,0,2,2,1,0,1,0,0,1,1,0,0
S01008593,Very bad health,3,0,0,0,0,1,0,0,1,0,1,1,0,0
S01008594,All people aged 16 to 74,808,255,27,228,186,64,58,8,36,18,17,10,7,166
S01008594,Very good health,497,169,20,149,110,31,29,4,15,4,11,5,6,124
S01008594,Good health,241,73,6,67,65,22,19,3,17,6,3,2,1,33
S01008594,Fair health,56,10,1,9,10,11,7,0,3,4,2,2,0,9
S01008594,Bad health,13,3,0,3,1,0,2,1,1,4,1,1,0,0
S01008594,Very bad health,1,0,0,0,0,0,1,0,0,0,0,0,0,0
S01008595,All people aged 16 to 74,661,64,8,56,115,88,28,49,95,97,49,39,10,76
S01008595,Very good health,277,36,5,31,66,34,10,19,30,23,14,12,2,45
S01008595,Good health,214,22,3,19,34,26,11,16,32,39,14,9,5,20
S01008595,Fair health,107,4,0,4,12,19,2,7,18,22,13,10,3,10
S01008595,Bad health,54,2,0,2,3,8,5,7,12,11,5,5,0,1
S01008595,Very bad health,9,0,0,0,0,1,0,0,3,2,3,3,0,0
S01008596,All people aged 16 to 74,674,55,1,54,90,79,31,49,79,95,56,40,16,140
S01008596,Very good health,335,39,0,39,45,43,11,20,31,21,20,16,4,105
S01008596,Good health,196,13,1,12,33,26,9,16,26,32,11,4,7,30
S01008596,Fair health,93,2,0,2,6,5,7,8,15,28,18,14,4,4
S01008596,Bad health,30,1,0,1,4,3,1,3,5,8,4,3,1,1
S01008596,Very bad health,20,0,0,0,2,2,3,2,2,6,3,3,0,0
S01008597,All people aged 16 to 74,638,110,20,90,175,108,53,28,64,41,9,6,3,50
S01008597,Very good health,351,72,13,59,99,56,24,8,30,17,6,4,2,39
S01008597,Good health,208,33,5,28,55,32,22,14,27,14,2,2,0,9
S01008597,Fair health,55,4,1,3,17,11,5,4,4,8,1,0,1,1
S01008597,Bad health,21,1,1,0,4,8,2,2,3,0,0,0,0,1
S01008597,Very bad health,3,0,0,0,0,1,0,0,0,2,0,0,0,0
S01008598,All people aged 16 to 74,706,82,3,79,114,55,28,23,54,27,20,18,2,303
S01008598,Very good health,444,52,2,50,71,32,14,11,29,10,7,5,2,218
S01008598,Good health,195,27,1,26,32,15,11,5,17,8,2,2,0,78
S01008598,Fair health,44,1,0,1,9,3,3,6,6,5,6,6,0,5
S01008598,Bad health,18,2,0,2,2,3,0,1,0,3,5,5,0,2
S01008598,Very bad health,5,0,0,0,0,2,0,0,2,1,0,0,0,0
S01008599,All people aged 16 to 74,754,181,21,160,166,53,40,18,41,14,12,7,5,229
S01008599,Very good health,525,120,13,107,112,34,29,11,24,9,8,4,4,178
S01008599,Good health,188,53,6,47,45,13,9,6,14,4,3,2,1,41
S01008599,Fair health,29,5,0,5,6,4,2,0,2,0,0,0,0,10
S01008599,Bad health,8,1,0,1,3,2,0,0,0,1,1,1,0,0
S01008599,Very bad health,4,2,2,0,0,0,0,1,1,0,0,0,0,0
S01008600,All people aged 16 to 74,597,144,18,126,116,39,60,18,28,13,30,21,9,149
S01008600,Very good health,395,102,11,91,70,22,34,15,14,5,19,13,6,114
S01008600,Good health,160,35,6,29,40,10,21,2,9,2,7,5,2,34
S01008600,Fair health,33,7,1,6,5,7,4,1,3,3,2,1,1,1
S01008600,Bad health,5,0,0,0,1,0,1,0,1,2,0,0,0,0
S01008600,Very bad health,4,0,0,0,0,0,0,0,1,1,2,2,0,0
S01008601,All people aged 16 to 74,2442,85,10,75,91,36,19,18,48,18,20,17,3,2107
S01008601,Very good health,1752,56,6,50,61,21,10,11,19,9,10,10,0,1555
S01008601,Good health,596,21,4,17,27,11,5,4,20,5,4,3,1,499
S01008601,Fair health,76,5,0,5,3,4,4,1,8,1,4,2,2,46
S01008601,Bad health,11,3,0,3,0,0,0,0,1,1,1,1,0,5
S01008601,Very bad health,7,0,0,0,0,0,0,2,0,2,1,1,0,2
S01008602,All people aged 16 to 74,586,79,9,70,88,35,25,14,35,22,20,15,5,268
S01008602,Very good health,367,52,2,50,53,16,12,5,19,8,6,5,1,196
S01008602,Good health,170,23,7,16,27,14,11,7,10,9,7,5,2,62
S01008602,Fair health,33,2,0,2,5,4,1,1,4,3,4,2,2,9
S01008602,Bad health,11,1,0,1,1,1,1,1,1,2,3,3,0,0
S01008602,Very bad health,5,1,0,1,2,0,0,0,1,0,0,0,0,1
S01008603,All people aged 16 to 74,1041,134,9,125,150,61,31,24,59,37,35,21,14,510
S01008603,Very good health,691,99,4,95,82,38,16,12,26,12,9,3,6,397
S01008603,Good health,250,32,4,28,46,14,10,9,20,13,9,6,3,97
S01008603,Fair health,66,3,1,2,11,6,4,2,11,7,10,6,4,12
S01008603,Bad health,27,0,0,0,8,2,1,1,2,3,7,6,1,3
S01008603,Very bad health,7,0,0,0,3,1,0,0,0,2,0,0,0,1
S01008604,All people aged 16 to 74,798,160,18,142,145,43,55,24,37,23,17,11,6,294
S01008604,Very good health,518,105,13,92,88,26,34,16,22,9,11,7,4,207
S01008604,Good health,224,47,5,42,45,14,15,4,10,8,3,1,2,78
S01008604,Fair health,46,7,0,7,9,2,5,4,3,6,2,2,0,8
S01008604,Bad health,10,1,0,1,3,1,1,0,2,0,1,1,0,1
S01008604,Very bad health,0,0,0,0,0,0,0,0,0,0,0,0,0,0
S01008605,All people aged 16 to 74,609,139,16,123,128,48,16,17,30,14,10,1,9,207
S01008605,Very good health,401,99,12,87,74,29,8,12,20,3,2,0,2,154
S01008605,Good health,170,33,3,30,40,16,6,3,7,10,5,0,5,50
S01008605,Fair health,31,3,1,2,13,3,2,2,3,1,2,0,2,2
S01008605,Bad health,7,4,0,4,1,0,0,0,0,0,1,1,0,1
S01008605,Very bad health,0,0,0,0,0,0,0,0,0,0,0,0,0,0
S01008606,All people aged 16 to 74,573,168,19,149,159,44,37,16,31,15,6,2,4,97
S01008606,Very good health,395,126,19,107,98,28,23,13,18,8,4,1,3,77
S01008606,Good health,143,32,0,32,48,14,13,1,12,6,1,0,1,16
S01008606,Fair health,29,9,0,9,11,1,1,1,1,1,1,1,0,3
S01008606,Bad health,4,0,0,0,2,1,0,0,0,0,0,0,0,1
S01008606,Very bad health,2,1,0,1,0,0,0,1,0,0,0,0,0,0
S01008607,All people aged 16 to 74,428,168,18,150,125,30,29,6,18,10,12,5,7,30
S01008607,Very good health,267,104,10,94,82,18,14,3,10,4,6,3,3,26
S01008607,Good health,123,52,5,47,35,7,11,2,7,4,2,0,2,3
S01008607,Fair health,25,6,3,3,6,5,3,1,0,2,1,0,1,1
S01008607,Bad health,10,5,0,5,1,0,0,0,1,0,3,2,1,0
S01008607,Very bad health,3,1,0,1,1,0,1,0,0,0,0,0,0,0
S01008608,All people aged 16 to 74,514,164,11,153,163,47,32,14,16,7,5,4,1,66
S01008608,Very good health,335,117,7,110,99,33,24,5,6,2,3,2,1,46
S01008608,Good health,133,31,1,30,47,11,7,9,4,4,0,0,0,20
S01008608,Fair health,36,14,2,12,14,2,0,0,4,1,1,1,0,0
S01008608,Bad health,8,2,1,1,3,0,1,0,2,0,0,0,0,0
S01008608,Very bad health,2,0,0,0,0,1,0,0,0,0,1,1,0,0
S01008609,All people aged 16 to 74,609,171,21,150,178,62,59,14,33,13,11,5,6,68
S01008609,Very good health,387,119,13,106,100,34,41,7,18,6,6,1,5,56
S01008609,Good health,172,38,6,32,67,20,17,4,10,2,2,2,0,12
S01008609,Fair health,36,12,2,10,7,6,1,1,5,3,1,0,1,0
S01008609,Bad health,11,2,0,2,2,2,0,1,0,2,2,2,0,0
S01008609,Very bad health,3,0,0,0,2,0,0,1,0,0,0,0,0,0
S01008610,All people aged 16 to 74,570,143,17,126,137,48,26,12,24,10,7,6,1,163
S01008610,Very good health,378,97,12,85,89,23,16,6,13,5,3,3,0,126
S01008610,Good health,153,36,3,33,34,16,9,6,10,4,3,2,1,35
S01008610,Fair health,30,9,2,7,9,6,1,0,1,1,1,1,0,2
S01008610,Bad health,9,1,0,1,5,3,0,0,0,0,0,0,0,0
S01008610,Very bad health,0,0,0,0,0,0,0,0,0,0,0,0,0,0
S01008611,All people aged 16 to 74,1286,173,9,164,179,84,30,21,39,24,25,17,8,711
S01008611,Very good health,876,132,6,126,103,54,19,15,18,12,7,5,2,516
S01008611,Good health,317,32,2,30,51,25,7,3,18,7,5,3,2,169
S01008611,Fair health,80,8,1,7,22,5,3,2,3,2,12,9,3,23
S01008611,Bad health,12,1,0,1,3,0,1,1,0,3,1,0,1,2
S01008611,Very bad health,1,0,0,0,0,0,0,0,0,0,0,0,0,1
S01008612,All people aged 16 to 74,713,110,4,106,108,45,26,18,43,18,22,15,7,323
S01008612,Very good health,454,69,1,68,58,20,16,10,18,5,7,4,3,251
S01008612,Good health,189,30,2,28,39,20,6,5,13,10,5,4,1,61
S01008612,Fair health,60,10,1,9,9,4,3,3,10,2,10,7,3,9
S01008612,Bad health,9,1,0,1,2,1,1,0,2,0,0,0,0,2
S01008612,Very bad health,1,0,0,0,0,0,0,0,0,1,0,0,0,0
S01008613,All people aged 16 to 74,627,134,8,126,129,47,16,10,31,20,15,10,5,225
S01008613,Very good health,435,101,6,95,75,33,9,9,15,12,7,6,1,174
S01008613,Good health,159,30,2,28,42,11,5,1,11,6,6,4,2,47
S01008613,Fair health,22,1,0,1,8,1,2,0,3,2,1,0,1,4
S01008613,Bad health,10,2,0,2,3,2,0,0,2,0,1,0,1,0
S01008613,Very bad health,1,0,0,0,1,0,0,0,0,0,0,0,0,0
S01008614,All people aged 16 to 74,624,102,7,95,75,21,17,15,19,21,16,9,7,338
S01008614,Very good health,446,68,6,62,55,15,10,8,11,8,9,4,5,262
S01008614,Good health,144,28,1,27,17,6,4,4,5,6,4,2,2,70
S01008614,Fair health,19,2,0,2,1,0,2,1,2,4,3,3,0,4
S01008614,Bad health,13,4,0,4,2,0,1,1,1,2,0,0,0,2
S01008614,Very bad health,2,0,0,0,0,0,0,1,0,1,0,0,0,0
S01008615,All people aged 16 to 74,739,122,4,118,110,25,21,9,31,13,14,13,1,394
S01008615,Very good health,536,78,3,75,75,17,13,4,16,8,4,4,0,321
S01008615,Good health,156,37,1,36,24,6,6,3,11,3,4,3,1,62
S01008615,Fair health,33,4,0,4,8,1,2,1,4,1,1,1,0,11
S01008615,Bad health,9,2,0,2,2,1,0,1,0,1,2,2,0,0
S01008615,Very bad health,5,1,0,1,1,0,0,0,0,0,3,3,0,0
S01008616,All people aged 16 to 74,671,83,2,81,91,22,22,7,18,9,9,7,2,410
S01008616,Very good health,503,63,2,61,50,17,9,5,13,8,5,5,0,333
S01008616,Good health,143,16,0,16,35,2,11,2,4,1,1,0,1,71
S01008616,Fair health,18,2,0,2,2,3,2,0,1,0,3,2,1,5
S01008616,Bad health,7,2,0,2,4,0,0,0,0,0,0,0,0,1
S01008616,Very bad health,0,0,0,0,0,0,0,0,0,0,0,0,0,0
S01008617,All people aged 16 to 74,735,79,7,72,95,25,23,13,11,4,5,3,2,480
S01008617,Very good health,556,60,7,53,58,14,14,4,6,3,2,1,1,395
S01008617,Good health,152,16,0,16,30,10,6,8,5,1,2,1,1,74
S01008617,Fair health,23,2,0,2,6,1,2,1,0,0,1,1,0,10
S01008617,Bad health,3,1,0,1,1,0,0,0,0,0,0,0,0,1
S01008617,Very bad health,1,0,0,0,0,0,1,0,0,0,0,0,0,0
S01008618,All people aged 16 to 74,669,84,6,78,69,26,11,8,32,6,5,3,2,428
S01008618,Very good health,489,55,5,50,45,15,8,2,20,4,1,0,1,339
S01008618,Good health,153,27,1,26,21,7,2,4,8,1,4,3,1,79
S01008618,Fair health,20,1,0,1,2,3,1,1,3,0,0,0,0,9
S01008618,Bad health,6,1,0,1,1,1,0,1,1,0,0,0,0,1
S01008618,Very bad health,1,0,0,0,0,0,0,0,0,1,0,0,0,0
S01008619,All people aged 16 to 74,474,64,6,58,82,17,17,12,26,8,8,7,1,240
S01008619,Very good health,334,44,5,39,54,12,8,5,19,5,1,0,1,186
S01008619,Good health,107,15,1,14,21,4,5,4,6,1,5,5,0,46
S01008619,Fair health,27,5,0,5,6,1,4,2,0,1,2,2,0,6
S01008619,Bad health,5,0,0,0,1,0,0,1,1,1,0,0,0,1
S01008619,Very bad health,1,0,0,0,0,0,0,0,0,0,0,0,0,1
S01008620,All people aged 16 to 74,756,105,9,96,99,37,23,16,24,14,9,7,2,429
S01008620,Very good health,553,63,4,59,73,22,15,14,14,7,5,4,1,340
S01008620,Good health,166,38,5,33,21,12,5,1,8,5,1,1,0,75
S01008620,Fair health,26,3,0,3,3,3,1,1,1,0,2,1,1,12
S01008620,Bad health,10,1,0,1,2,0,2,0,1,2,1,1,0,1
S01008620,Very bad health,1,0,0,0,0,0,0,0,0,0,0,0,0,1
S01008621,All people aged 16 to 74,699,80,3,77,83,30,30,13,22,9,10,5,5,422
S01008621,Very good health,512,55,2,53,55,19,19,8,13,3,5,1,4,335
S01008621,Good health,167,22,1,21,27,10,8,4,9,5,1,1,0,81
S01008621,Fair health,15,2,0,2,0,1,3,1,0,1,1,1,0,6
S01008621,Bad health,4,0,0,0,1,0,0,0,0,0,3,2,1,0
S01008621,Very bad health,1,1,0,1,0,0,0,0,0,0,0,0,0,0
S01008622,All people aged 16 to 74,456,84,8,76,85,31,16,14,24,14,3,0,3,185
S01008622,Very good health,314,60,5,55,56,15,10,7,14,6,2,0,2,144
S01008622,Good health,120,19,3,16,26,12,5,5,8,8,1,0,1,36
S01008622,Fair health,22,5,0,5,3,4,1,2,2,0,0,0,0,5
S01008622,Bad health,0,0,0,0,0,0,0,0,0,0,0,0,0,0
S01008622,Very bad health,0,0,0,0,0,0,0,0,0,0,0,0,0,0
S01008623,All people aged 16 to 74,800,157,17,140,132,30,44,5,29,15,15,10,5,373
S01008623,Very good health,540,106,6,100,90,12,22,3,19,9,4,1,3,275
S01008623,Good health,211,40,6,34,34,14,14,1,9,3,6,5,1,90
S01008623,Fair health,43,8,4,4,7,4,8,1,0,3,4,3,1,8
S01008623,Bad health,5,2,1,1,1,0,0,0,1,0,1,1,0,0
S01008623,Very bad health,1,1,0,1,0,0,0,0,0,0,0,0,0,0
S01008624,All people aged 16 to 74,486,144,14,130,139,47,61,20,19,19,9,7,2,28
S01008624,Very good health,286,101,7,94,85,27,30,9,7,4,3,1,2,20
S01008624,Good health,133,36,5,31,43,12,14,5,9,6,1,1,0,7
S01008624,Fair health,43,7,2,5,6,1,16,2,3,5,2,2,0,1
S01008624,Bad health,20,0,0,0,4,7,1,3,0,3,2,2,0,0
S01008624,Very bad health,4,0,0,0,1,0,0,1,0,1,1,1,0,0
S01008625,All people aged 16 to 74,417,161,29,132,131,28,28,3,14,9,10,6,4,33
S01008625,Very good health,268,108,16,92,84,19,18,2,7,4,1,1,0,25
S01008625,Good health,114,43,11,32,39,8,4,1,6,2,6,3,3,5
S01008625,Fair health,24,8,2,6,7,0,5,0,0,1,1,1,0,2
S01008625,Bad health,11,2,0,2,1,1,1,0,1,2,2,1,1,1
S01008625,Very bad health,0,0,0,0,0,0,0,0,0,0,0,0,0,0
S01008626,All people aged 16 to 74,684,224,22,202,189,63,39,19,29,19,11,8,3,91
S01008626,Very good health,470,167,17,150,128,36,20,11,16,12,7,4,3,73
S01008626,Good health,175,48,5,43,51,19,15,7,10,6,2,2,0,17
S01008626,Fair health,27,9,0,9,8,6,0,0,1,1,1,1,0,1
S01008626,Bad health,8,0,0,0,2,2,3,0,1,0,0,0,0,0
S01008626,Very bad health,4,0,0,0,0,0,1,1,1,0,1,1,0,0
S01008627,All people aged 16 to 74,475,147,19,128,161,35,36,7,21,8,11,6,5,49
S01008627,Very good health,351,110,12,98,116,26,20,5,16,3,8,5,3,47
S01008627,Good health,98,32,6,26,39,7,10,1,4,1,3,1,2,1
S01008627,Fair health,19,4,1,3,4,2,4,1,1,3,0,0,0,0
S01008627,Bad health,6,1,0,1,1,0,2,0,0,1,0,0,0,1
S01008627,Very bad health,1,0,0,0,1,0,0,0,0,0,0,0,0,0
S01008628,All people aged 16 to 74,491,115,7,108,151,35,28,9,21,13,15,11,4,104
S01008628,Very good health,338,86,4,82,111,20,17,7,14,6,4,3,1,73
S01008628,Good health,111,23,2,21,33,12,9,1,2,0,6,3,3,25
S01008628,Fair health,31,4,1,3,4,3,2,1,3,6,3,3,0,5
S01008628,Bad health,7,2,0,2,1,0,0,0,1,1,2,2,0,0
S01008628,Very bad health,4,0,0,0,2,0,0,0,1,0,0,0,0,1
S01008629,All people aged 16 to 74,438,102,10,92,124,48,12,9,34,16,6,3,3,87
S01008629,Very good health,278,73,8,65,73,18,8,7,18,5,3,1,2,73
S01008629,Good health,118,25,2,23,42,18,3,2,10,6,2,1,1,10
S01008629,Fair health,27,3,0,3,6,8,0,0,5,1,1,1,0,3
S01008629,Bad health,14,1,0,1,3,4,1,0,1,3,0,0,0,1
S01008629,Very bad health,1,0,0,0,0,0,0,0,0,1,0,0,0,0
S01008630,All people aged 16 to 74,460,76,10,66,115,39,24,6,24,10,8,5,3,158
S01008630,Very good health,286,48,6,42,75,16,9,2,14,5,2,2,0,115
S01008630,Good health,138,21,2,19,35,16,12,2,6,5,5,2,3,36
S01008630,Fair health,26,7,2,5,3,3,1,1,3,0,1,1,0,7
S01008630,Bad health,6,0,0,0,1,2,1,1,1,0,0,0,0,0
S01008630,Very bad health,4,0,0,0,1,2,1,0,0,0,0,0,0,0
S01008631,All people aged 16 to 74,695,171,15,156,191,68,36,19,42,23,15,4,11,130
S01008631,Very good health,449,130,8,122,123,26,19,9,29,11,4,1,3,98
S01008631,Good health,193,37,7,30,56,27,16,8,11,8,4,0,4,26
S01008631,Fair health,38,4,0,4,7,13,1,2,1,2,3,1,2,5
S01008631,Bad health,12,0,0,0,4,2,0,0,1,2,2,0,2,1
S01008631,Very bad health,3,0,0,0,1,0,0,0,0,0,2,2,0,0
S01008632,All people aged 16 to 74,780,146,9,137,201,63,34,20,65,45,114,106,8,92
S01008632,Very good health,393,98,6,92,123,30,15,6,20,18,17,12,5,66
S01008632,Good health,256,39,3,36,62,25,12,8,25,11,52,51,1,22
S01008632,Fair health,82,4,0,4,9,4,3,4,12,12,30,28,2,4
S01008632,Bad health,38,4,0,4,3,4,4,0,6,4,13,13,0,0
S01008632,Very bad health,11,1,0,1,4,0,0,2,2,0,2,2,0,0
S01008633,All people aged 16 to 74,642,188,35,153,192,62,40,9,26,11,22,15,7,92
S01008633,Very good health,423,133,21,112,125,31,24,7,14,4,8,5,3,77
S01008633,Good health,153,44,11,33,52,18,12,0,7,5,5,3,2,10
S01008633,Fair health,52,9,3,6,13,9,3,2,3,2,6,5,1,5
S01008633,Bad health,13,2,0,2,2,4,1,0,2,0,2,1,1,0
S01008633,Very bad health,1,0,0,0,0,0,0,0,0,0,1,1,0,0
S01008634,All people aged 16 to 74,571,153,21,132,141,34,43,7,24,6,12,10,2,151
S01008634,Very good health,371,104,12,92,92,21,22,5,9,4,2,0,2,112
S01008634,Good health,152,41,8,33,43,9,16,0,8,0,4,4,0,31
S01008634,Fair health,34,8,1,7,6,2,3,1,5,1,3,3,0,5
S01008634,Bad health,13,0,0,0,0,2,2,1,2,1,3,3,0,2
S01008634,Very bad health,1,0,0,0,0,0,0,0,0,0,0,0,0,1
S01008635,All people aged 16 to 74,681,178,16,162,159,41,55,11,30,10,20,12,8,177
S01008635,Very good health,457,120,11,109,104,27,26,8,21,7,7,4,3,137
S01008635,Good health,188,53,5,48,44,12,23,3,8,3,8,4,4,34
S01008635,Fair health,28,5,0,5,9,1,5,0,1,0,3,2,1,4
S01008635,Bad health,5,0,0,0,2,0,1,0,0,0,1,1,0,1
S01008635,Very bad health,3,0,0,0,0,1,0,0,0,0,1,1,0,1
S01008636,All people aged 16 to 74,683,161,21,140,173,56,30,12,28,19,7,5,2,197
S01008636,Very good health,469,123,17,106,110,37,18,5,16,12,2,2,0,146
S01008636,Good health,175,29,4,25,52,17,9,6,9,3,1,0,1,49
S01008636,Fair health,31,5,0,5,8,1,3,1,3,4,4,3,1,2
S01008636,Bad health,3,1,0,1,2,0,0,0,0,0,0,0,0,0
S01008636,Very bad health,5,3,0,3,1,1,0,0,0,0,0,0,0,0
S01008637,All people aged 16 to 74,527,136,12,124,148,45,40,11,25,13,8,6,2,101
S01008637,Very good health,317,85,6,79,93,27,18,8,12,6,3,1,2,65
S01008637,Good health,168,45,5,40,41,14,16,3,9,6,2,2,0,32
S01008637,Fair health,27,5,1,4,7,2,4,0,2,1,2,2,0,4
S01008637,Bad health,10,1,0,1,7,1,1,0,0,0,0,0,0,0
S01008637,Very bad health,5,0,0,0,0,1,1,0,2,0,1,1,0,0
S01008638,All people aged 16 to 74,649,102,9,93,122,53,34,35,51,32,12,10,2,208
S01008638,Very good health,401,73,5,68,78,25,16,14,20,14,4,4,0,157
S01008638,Good health,171,19,2,17,33,19,12,11,14,12,4,2,2,47
S01008638,Fair health,55,10,2,8,8,4,3,7,14,3,2,2,0,4
S01008638,Bad health,13,0,0,0,3,4,3,1,1,1,0,0,0,0
S01008638,Very bad health,9,0,0,0,0,1,0,2,2,2,2,2,0,0
S01008639,All people aged 16 to 74,765,183,14,169,185,76,44,26,43,21,21,14,7,166
S01008639,Very good health,498,127,13,114,121,40,27,17,22,10,9,7,2,125
S01008639,Good health,206,49,1,48,49,26,13,8,11,9,9,5,4,32
S01008639,Fair health,47,5,0,5,13,7,4,1,5,1,2,1,1,9
S01008639,Bad health,11,2,0,2,2,3,0,0,2,1,1,1,0,0
S01008639,Very bad health,3,0,0,0,0,0,0,0,3,0,0,0,0,0
S01008640,All people aged 16 to 74,687,155,6,149,145,47,27,19,43,16,6,1,5,229
S01008640,Very good health,463,99,3,96,93,36,15,11,24,9,4,1,3,172
S01008640,Good health,182,47,2,45,46,9,8,3,16,3,1,0,1,49
S01008640,Fair health,31,7,1,6,6,2,2,4,2,2,1,0,1,5
S01008640,Bad health,8,0,0,0,0,0,2,1,1,1,0,0,0,3
S01008640,Very bad health,3,2,0,2,0,0,0,0,0,1,0,0,0,0
S01008641,All people aged 16 to 74,765,133,8,125,143,49,21,19,55,14,12,8,4,319
S01008641,Very good health,565,108,6,102,90,34,16,9,25,8,5,3,2,270
S01008641,Good health,159,23,2,21,43,8,5,8,24,3,5,3,2,40
S01008641,Fair health,33,2,0,2,9,7,0,2,5,2,0,0,0,6
S01008641,Bad health,5,0,0,0,0,0,0,0,1,0,1,1,0,3
S01008641,Very bad health,3,0,0,0,1,0,0,0,0,1,1,1,0,0
S01008642,All people aged 16 to 74,806,206,18,188,217,63,26,16,34,18,2,1,1,224
S01008642,Very good health,574,159,14,145,141,43,14,11,21,13,0,0,0,172
S01008642,Good health,183,34,4,30,67,13,9,5,9,3,2,1,1,41
S01008642,Fair health,37,9,0,9,7,6,3,0,2,1,0,0,0,9
S01008642,Bad health,8,2,0,2,1,1,0,0,1,1,0,0,0,2
S01008642,Very bad health,4,2,0,2,1,0,0,0,1,0,0,0,0,0
S01008643,All people aged 16 to 74,590,152,11,141,169,50,33,20,34,10,12,6,6,110
S01008643,Very good health,373,108,8,100,105,27,17,11,20,4,3,2,1,78
S01008643,Good health,174,39,3,36,57,16,12,5,9,3,5,1,4,28
S01008643,Fair health,34,5,0,5,6,6,2,3,4,3,1,0,1,4
S01008643,Bad health,6,0,0,0,1,0,2,0,0,0,3,3,0,0
S01008643,Very bad health,3,0,0,0,0,1,0,1,1,0,0,0,0,0
S01008644,All people aged 16 to 74,644,95,13,82,164,48,28,23,36,24,20,13,7,206
S01008644,Very good health,434,67,9,58,104,30,10,13,16,13,10,6,4,171
S01008644,Good health,144,23,4,19,46,13,12,5,11,2,4,2,2,28
S01008644,Fair health,52,5,0,5,13,4,4,3,8,5,4,4,0,6
S01008644,Bad health,10,0,0,0,1,1,1,2,0,3,1,1,0,1
S01008644,Very bad health,4,0,0,0,0,0,1,0,1,1,1,0,1,0
S01008645,All people aged 16 to 74,690,116,13,103,139,61,23,22,41,34,19,13,6,235
S01008645,Very good health,488,83,8,75,99,39,14,13,27,20,9,6,3,184
S01008645,Good health,167,31,5,26,32,18,6,7,11,9,8,5,3,45
S01008645,Fair health,30,2,0,2,6,4,2,1,3,5,1,1,0,6
S01008645,Bad health,2,0,0,0,1,0,1,0,0,0,0,0,0,0
S01008645,Very bad health,3,0,0,0,1,0,0,1,0,0,1,1,0,0
S01008646,All people aged 16 to 74,707,136,12,124,180,69,27,33,70,31,12,8,4,149
S01008646,Very good health,454,89,10,79,136,36,13,21,38,12,10,6,4,99
S01008646,Good health,198,40,2,38,34,26,10,8,22,11,1,1,0,46
S01008646,Fair health,44,6,0,6,9,5,4,3,8,4,1,1,0,4
S01008646,Bad health,7,1,0,1,1,1,0,1,1,2,0,0,0,0
S01008646,Very bad health,4,0,0,0,0,1,0,0,1,2,0,0,0,0
S01008647,All people aged 16 to 74,537,117,8,109,135,49,20,21,41,30,8,3,5,116
S01008647,Very good health,340,88,7,81,87,32,10,9,22,16,1,1,0,75
S01008647,Good health,169,28,0,28,42,15,10,12,13,9,5,1,4,35
S01008647,Fair health,19,1,1,0,5,2,0,0,2,3,1,0,1,5
S01008647,Bad health,6,0,0,0,1,0,0,0,3,1,1,1,0,0
S01008647,Very bad health,3,0,0,0,0,0,0,0,1,1,0,0,0,1
S01008648,All people aged 16 to 74,548,106,8,98,111,58,14,32,53,44,9,7,2,121
S01008648,Very good health,343,78,7,71,78,30,8,13,28,21,3,3,0,84
S01008648,Good health,157,27,1,26,25,20,4,15,15,13,4,3,1,34
S01008648,Fair health,32,1,0,1,7,3,1,2,8,5,2,1,1,3
S01008648,Bad health,14,0,0,0,1,5,0,2,2,4,0,0,0,0
S01008648,Very bad health,2,0,0,0,0,0,1,0,0,1,0,0,0,0
S01008649,All people aged 16 to 74,792,123,14,109,201,103,14,53,81,66,21,13,8,130
S01008649,Very good health,465,81,12,69,123,62,10,21,33,28,8,6,2,99
S01008649,Good health,230,35,2,33,59,32,3,18,31,18,8,3,5,26
S01008649,Fair health,70,7,0,7,13,6,1,9,15,12,3,2,1,4
S01008649,Bad health,22,0,0,0,5,2,0,4,2,6,2,2,0,1
S01008649,Very bad health,5,0,0,0,1,1,0,1,0,2,0,0,0,0
S01008650,All people aged 16 to 74,693,133,10,123,143,95,19,36,76,39,8,8,0,144
S01008650,Very good health,414,97,9,88,90,49,12,18,31,19,1,1,0,97
S01008650,Good health,212,29,1,28,42,35,5,13,29,15,4,4,0,40
S01008650,Fair health,47,6,0,6,8,9,1,3,9,3,2,2,0,6
S01008650,Bad health,16,1,0,1,1,2,1,1,7,1,1,1,0,1
S01008650,Very bad health,4,0,0,0,2,0,0,1,0,1,0,0,0,0
S01008651,All people aged 16 to 74,930,119,9,110,133,71,30,33,52,48,38,30,8,406
S01008651,Very good health,526,80,5,75,76,41,14,13,13,22,11,5,6,256
S01008651,Good health,301,32,3,29,46,22,11,12,23,13,11,9,2,131
S01008651,Fair health,70,6,0,6,7,4,4,5,12,10,9,9,0,13
S01008651,Bad health,29,1,1,0,4,4,1,3,3,1,7,7,0,5
S01008651,Very bad health,4,0,0,0,0,0,0,0,1,2,0,0,0,1
S01008652,All people aged 16 to 74,538,69,4,65,105,58,21,35,85,49,27,15,12,89
S01008652,Very good health,290,53,4,49,57,33,6,12,34,19,11,4,7,65
S01008652,Good health,158,14,0,14,34,14,12,17,27,12,7,4,3,21
S01008652,Fair health,61,2,0,2,7,8,2,3,15,14,7,5,2,3
S01008652,Bad health,24,0,0,0,7,2,1,0,9,4,1,1,0,0
S01008652,Very bad health,5,0,0,0,0,1,0,3,0,0,1,1,0,0
S01008653,All people aged 16 to 74,614,82,3,79,108,52,15,43,71,53,39,30,9,151
S01008653,Very good health,315,56,2,54,62,29,2,19,23,12,8,6,2,104
S01008653,Good health,202,24,0,24,34,17,9,17,21,24,18,13,5,38
S01008653,Fair health,68,1,0,1,10,4,3,5,16,12,10,8,2,7
S01008653,Bad health,23,1,1,0,2,2,0,2,9,2,3,3,0,2
S01008653,Very bad health,6,0,0,0,0,0,1,0,2,3,0,0,0,0
S01008654,All people aged 16 to 74,871,132,8,124,187,95,26,45,89,52,37,22,15,208
S01008654,Very good health,503,89,2,87,116,50,11,20,36,18,14,9,5,149
S01008654,Good health,252,34,6,28,58,29,12,18,24,17,7,2,5,53
S01008654,Fair health,81,7,0,7,11,13,2,4,20,9,9,5,4,6
S01008654,Bad health,27,2,0,2,1,3,1,3,7,4,6,5,1,0
S01008654,Very bad health,8,0,0,0,1,0,0,0,2,4,1,1,0,0
S01008655,All people aged 16 to 74,732,151,7,144,142,83,29,39,44,40,18,17,1,186
S01008655,Very good health,441,99,5,94,93,44,12,22,19,10,4,4,0,138
S01008655,Good health,217,49,1,48,34,30,12,10,17,16,7,7,0,42
S01008655,Fair health,54,3,1,2,13,7,4,4,8,8,2,1,1,5
S01008655,Bad health,19,0,0,0,2,2,1,2,0,6,5,5,0,1
S01008655,Very bad health,1,0,0,0,0,0,0,1,0,0,0,0,0,0
S01008656,All people aged 16 to 74,591,66,2,64,112,69,22,30,86,49,35,20,15,122
S01008656,Very good health,301,48,2,46,65,35,7,19,35,11,13,7,6,68
S01008656,Good health,174,11,0,11,39,16,11,7,30,14,12,5,7,34
S01008656,Fair health,80,5,0,5,8,15,2,2,19,15,4,4,0,10
S01008656,Bad health,30,2,0,2,0,2,2,2,1,6,5,4,1,10
S01008656,Very bad health,6,0,0,0,0,1,0,0,1,3,1,0,1,0
S01008657,All people aged 16 to 74,670,81,13,68,130,72,26,35,40,48,34,28,6,204
S01008657,Very good health,400,56,8,48,76,37,11,16,13,18,12,9,3,161
S01008657,Good health,199,21,5,16,41,25,12,13,17,20,14,12,2,36
S01008657,Fair health,49,3,0,3,11,6,2,4,3,8,5,5,0,7
S01008657,Bad health,15,0,0,0,2,2,1,2,5,1,2,1,1,0
S01008657,Very bad health,7,1,0,1,0,2,0,0,2,1,1,1,0,0
S01008658,All people aged 16 to 74,1022,103,11,92,156,90,33,54,84,70,57,27,30,375
S01008658,Very good health,580,65,4,61,93,47,16,23,35,29,17,5,12,255
S01008658,Good health,294,23,5,18,46,25,10,18,24,27,21,11,10,100
S01008658,Fair health,102,10,0,10,12,14,3,4,15,13,14,8,6,17
S01008658,Bad health,34,3,2,1,5,2,4,8,5,1,4,2,2,2
S01008658,Very bad health,12,2,0,2,0,2,0,1,5,0,1,1,0,1
S01008659,All people aged 16 to 74,773,73,7,66,122,49,34,43,66,40,29,17,12,317
S01008659,Very good health,429,43,4,39,73,21,12,18,19,19,9,4,5,215
S01008659,Good health,265,21,0,21,41,21,16,16,30,13,13,7,6,94
S01008659,Fair health,50,8,2,6,7,5,6,4,7,3,3,2,1,7
S01008659,Bad health,26,1,1,0,1,1,0,5,10,3,4,4,0,1
S01008659,Very bad health,3,0,0,0,0,1,0,0,0,2,0,0,0,0
S01008660,All people aged 16 to 74,866,152,15,137,149,53,24,38,51,25,34,18,16,340
S01008660,Very good health,570,107,10,97,95,39,11,15,24,15,14,6,8,250
S01008660,Good health,224,40,3,37,39,8,7,18,15,7,14,8,6,76
S01008660,Fair health,47,3,0,3,8,3,4,5,9,0,3,1,2,12
S01008660,Bad health,21,2,2,0,5,3,2,0,2,2,3,3,0,2
S01008660,Very bad health,4,0,0,0,2,0,0,0,1,1,0,0,0,0
S01008661,All people aged 16 to 74,916,68,5,63,112,76,29,47,72,58,32,21,11,422
S01008661,Very good health,493,39,3,36,62,37,7,20,30,19,11,7,4,268
S01008661,Good health,308,27,2,25,36,19,16,18,22,22,11,7,4,137
S01008661,Fair health,78,1,0,1,8,13,5,6,10,12,9,6,3,14
S01008661,Bad health,28,1,0,1,5,4,1,1,8,5,1,1,0,2
S01008661,Very bad health,9,0,0,0,1,3,0,2,2,0,0,0,0,1
S01008662,All people aged 16 to 74,726,55,1,54,68,26,15,29,41,21,22,15,7,449
S01008662,Very good health,460,39,1,38,41,16,9,16,20,4,10,6,4,305
S01008662,Good health,216,16,0,16,21,6,6,8,14,9,7,6,1,129
S01008662,Fair health,32,0,0,0,5,1,0,3,5,2,2,0,2,14
S01008662,Bad health,15,0,0,0,1,3,0,2,1,4,3,3,0,1
S01008662,Very bad health,3,0,0,0,0,0,0,0,1,2,0,0,0,0
S01008663,All people aged 16 to 74,774,74,4,70,122,70,35,24,40,54,28,18,10,327
S01008663,Very good health,460,52,1,51,76,33,15,9,15,12,5,1,4,243
S01008663,Good health,219,19,3,16,34,29,11,8,12,20,12,7,5,74
S01008663,Fair health,59,2,0,2,10,6,5,2,10,11,5,5,0,8
S01008663,Bad health,27,0,0,0,2,2,2,5,2,8,5,4,1,1
S01008663,Very bad health,9,1,0,1,0,0,2,0,1,3,1,1,0,1
S01008664,All people aged 16 to 74,653,111,6,105,138,50,24,25,44,37,21,12,9,203
S01008664,Very good health,386,81,5,76,72,33,10,9,21,13,5,3,2,142
S01008664,Good health,200,27,1,26,59,10,9,11,13,10,9,3,6,52
S01008664,Fair health,46,1,0,1,4,6,5,3,6,10,3,2,1,8
S01008664,Bad health,14,1,0,1,3,1,0,1,3,1,3,3,0,1
S01008664,Very bad health,7,1,0,1,0,0,0,1,1,3,1,1,0,0
S01008665,All people aged 16 to 74,1099,117,8,109,195,66,49,52,65,66,50,36,14,439
S01008665,Very good health,665,92,6,86,113,41,32,24,26,24,9,6,3,304
S01008665,Good health,331,19,2,17,66,23,10,23,29,20,21,15,6,120
S01008665,Fair health,73,6,0,6,12,1,5,4,6,15,13,10,3,11
S01008665,Bad health,22,0,0,0,3,1,2,1,3,4,5,3,2,3
S01008665,Very bad health,8,0,0,0,1,0,0,0,1,3,2,2,0,1
S01008666,All people aged 16 to 74,925,91,5,86,125,45,19,22,37,17,11,6,5,558
S01008666,Very good health,631,59,2,57,91,25,11,10,22,7,6,3,3,400
S01008666,Good health,236,27,2,25,29,12,7,10,10,4,1,0,1,136
S01008666,Fair health,41,2,0,2,4,7,1,2,1,5,3,2,1,16
S01008666,Bad health,16,3,1,2,1,1,0,0,4,1,0,0,0,6
S01008666,Very bad health,1,0,0,0,0,0,0,0,0,0,1,1,0,0
S01008667,All people aged 16 to 74,893,99,11,88,111,42,20,20,43,34,18,9,9,506
S01008667,Very good health,581,71,9,62,58,16,10,8,21,17,10,5,5,370
S01008667,Good health,251,25,2,23,40,17,7,10,13,9,5,3,2,125
S01008667,Fair health,51,3,0,3,13,7,2,2,6,5,3,1,2,10
S01008667,Bad health,9,0,0,0,0,2,1,0,2,3,0,0,0,1
S01008667,Very bad health,1,0,0,0,0,0,0,0,1,0,0,0,0,0
S01008668,All people aged 16 to 74,578,80,2,78,78,40,19,15,24,11,5,3,2,306
S01008668,Very good health,355,52,0,52,51,17,10,8,11,6,3,1,2,197
S01008668,Good health,179,24,2,22,20,18,6,6,7,1,0,0,0,97
S01008668,Fair health,34,2,0,2,7,4,3,0,2,3,2,2,0,11
S01008668,Bad health,6,2,0,2,0,1,0,0,3,0,0,0,0,0
S01008668,Very bad health,4,0,0,0,0,0,0,1,1,1,0,0,0,1
S01008669,All people aged 16 to 74,541,20,1,19,38,19,9,8,23,10,11,9,2,403
S01008669,Very good health,394,12,1,11,24,12,4,4,10,2,7,6,1,319
S01008669,Good health,121,7,0,7,11,4,4,4,10,5,3,2,1,73
S01008669,Fair health,20,1,0,1,1,2,1,0,3,1,1,1,0,10
S01008669,Bad health,6,0,0,0,2,1,0,0,0,2,0,0,0,1
S01008669,Very bad health,0,0,0,0,0,0,0,0,0,0,0,0,0,0
S01008670,All people aged 16 to 74,822,44,3,41,59,34,18,16,26,12,15,9,6,598
S01008670,Very good health,570,28,2,26,35,16,6,7,18,5,5,1,4,450
S01008670,Good health,209,15,1,14,22,12,8,9,5,5,3,1,2,130
S01008670,Fair health,33,0,0,0,2,5,4,0,1,1,4,4,0,16
S01008670,Bad health,8,1,0,1,0,1,0,0,2,1,2,2,0,1
S01008670,Very bad health,2,0,0,0,0,0,0,0,0,0,1,1,0,1
S01008671,All people aged 16 to 74,717,52,1,51,65,28,13,17,25,21,17,9,8,479
S01008671,Very good health,489,34,0,34,35,12,4,5,13,6,9,3,6,371
S01008671,Good health,171,13,1,12,23,11,5,7,4,9,3,3,0,96
S01008671,Fair health,45,3,0,3,5,4,3,5,4,4,5,3,2,12
S01008671,Bad health,9,1,0,1,2,1,1,0,2,2,0,0,0,0
S01008671,Very bad health,3,1,0,1,0,0,0,0,2,0,0,0,0,0
S01008672,All people aged 16 to 74,620,74,5,69,66,44,12,13,40,26,10,7,3,335
S01008672,Very good health,414,54,3,51,35,15,7,7,18,14,7,5,2,257
S01008672,Good health,150,16,2,14,23,21,2,2,12,7,1,0,1,66
S01008672,Fair health,40,4,0,4,5,4,3,3,4,3,2,2,0,12
S01008672,Bad health,10,0,0,0,2,3,0,1,3,1,0,0,0,0
S01008672,Very bad health,6,0,0,0,1,1,0,0,3,1,0,0,0,0
S01008673,All people aged 16 to 74,967,106,10,96,137,61,39,18,59,32,30,18,12,485
S01008673,Very good health,595,69,9,60,91,31,21,4,22,15,12,7,5,330
S01008673,Good health,274,32,1,31,35,17,11,8,23,8,7,2,5,133
S01008673,Fair health,67,3,0,3,10,10,3,2,8,6,5,3,2,20
S01008673,Bad health,27,1,0,1,1,3,2,3,6,3,6,6,0,2
S01008673,Very bad health,4,1,0,1,0,0,2,1,0,0,0,0,0,0
S01008674,All people aged 16 to 74,911,63,1,62,106,41,27,24,42,44,25,10,15,539
S01008674,Very good health,567,44,1,43,68,28,12,13,20,21,8,3,5,353
S01008674,Good health,268,13,0,13,30,10,6,9,13,12,11,3,8,164
S01008674,Fair health,53,6,0,6,7,2,4,2,5,2,4,2,2,21
S01008674,Bad health,21,0,0,0,1,1,5,0,4,7,2,2,0,1
S01008674,Very bad health,2,0,0,0,0,0,0,0,0,2,0,0,0,0
S01008675,All people aged 16 to 74,665,93,15,78,133,63,37,23,58,47,36,22,14,175
S01008675,Very good health,384,62,13,49,78,28,15,11,24,15,20,13,7,131
S01008675,Good health,191,29,1,28,41,17,13,10,18,14,10,4,6,39
S01008675,Fair health,53,2,1,1,10,11,4,1,8,10,3,2,1,4
S01008675,Bad health,26,0,0,0,3,6,3,1,4,6,2,2,0,1
S01008675,Very bad health,11,0,0,0,1,1,2,0,4,2,1,1,0,0
S01008676,All people aged 16 to 74,722,100,4,96,168,45,39,23,37,33,19,12,7,258
S01008676,Very good health,474,65,1,64,111,31,22,7,17,16,11,5,6,194
S01008676,Good health,211,30,3,27,51,14,15,15,15,11,4,4,0,56
S01008676,Fair health,26,4,0,4,3,0,1,1,2,5,3,2,1,7
S01008676,Bad health,8,1,0,1,3,0,0,0,3,1,0,0,0,0
S01008676,Very bad health,3,0,0,0,0,0,1,0,0,0,1,1,0,1
S01008677,All people aged 16 to 74,768,85,4,81,145,50,30,33,69,46,20,15,5,290
S01008677,Very good health,486,60,3,57,86,26,13,13,38,17,4,1,3,229
S01008677,Good health,219,24,1,23,47,18,15,11,20,21,7,7,0,56
S01008677,Fair health,44,1,0,1,5,5,2,4,8,7,7,5,2,5
S01008677,Bad health,16,0,0,0,6,1,0,4,3,1,1,1,0,0
S01008677,Very bad health,3,0,0,0,1,0,0,1,0,0,1,1,0,0
S01008678,All people aged 16 to 74,1154,67,8,59,89,28,30,23,51,39,33,25,8,794
S01008678,Very good health,703,40,6,34,60,11,15,6,21,14,19,14,5,517
S01008678,Good health,361,21,2,19,22,14,9,9,16,14,7,5,2,249
S01008678,Fair health,66,3,0,3,3,2,4,5,9,9,4,3,1,27
S01008678,Bad health,20,3,0,3,3,1,1,3,4,1,3,3,0,1
S01008678,Very bad health,4,0,0,0,1,0,1,0,1,1,0,0,0,0
S01008679,All people aged 16 to 74,1078,59,7,52,102,52,34,37,86,68,42,27,15,598
S01008679,Very good health,605,33,4,29,52,23,15,9,26,32,10,7,3,405
S01008679,Good health,295,16,3,13,32,13,8,12,30,13,11,5,6,160
S01008679,Fair health,112,7,0,7,6,12,8,10,19,8,11,7,4,31
S01008679,Bad health,49,3,0,3,6,4,2,5,9,12,7,6,1,1
S01008679,Very bad health,17,0,0,0,6,0,1,1,2,3,3,2,1,1
S01008680,All people aged 16 to 74,590,53,2,51,52,44,17,20,39,32,32,23,9,301
S01008680,Very good health,335,30,1,29,28,20,9,9,11,13,6,5,1,209
S01008680,Good health,177,16,1,15,18,14,5,5,11,10,10,4,6,88
S01008680,Fair health,53,6,0,6,5,8,1,3,12,8,7,5,2,3
S01008680,Bad health,16,1,0,1,1,0,2,3,3,1,5,5,0,0
S01008680,Very bad health,9,0,0,0,0,2,0,0,2,0,4,4,0,1
S01008681,All people aged 16 to 74,870,66,5,61,91,50,24,35,55,49,42,31,11,458
S01008681,Very good health,513,42,2,40,52,26,8,16,13,10,6,2,4,340
S01008681,Good health,210,21,2,19,27,15,6,12,6,11,9,6,3,103
S01008681,Fair health,88,2,0,2,6,5,4,7,21,16,18,15,3,9
S01008681,Bad health,40,0,0,0,6,2,3,0,8,8,7,6,1,6
S01008681,Very bad health,19,1,1,0,0,2,3,0,7,4,2,2,0,0
S01008682,All people aged 16 to 74,690,80,5,75,107,47,28,32,61,50,35,28,7,250
S01008682,Very good health,384,49,3,46,56,22,8,7,27,17,11,11,0,187
S01008682,Good health,212,23,2,21,39,17,15,18,19,13,11,5,6,57
S01008682,Fair health,59,7,0,7,10,4,3,6,6,6,11,10,1,6
S01008682,Bad health,27,1,0,1,1,3,1,0,8,11,2,2,0,0
S01008682,Very bad health,8,0,0,0,1,1,1,1,1,3,0,0,0,0
S01008683,All people aged 16 to 74,1327,41,2,39,111,67,35,63,118,115,99,65,34,678
S01008683,Very good health,650,26,2,24,57,20,10,13,36,28,20,12,8,440
S01008683,Good health,450,10,0,10,35,25,15,37,47,40,35,22,13,206
S01008683,Fair health,143,5,0,5,14,14,7,3,17,24,30,19,11,29
S01008683,Bad health,57,0,0,0,3,5,1,6,11,18,10,8,2,3
S01008683,Very bad health,27,0,0,0,2,3,2,4,7,5,4,4,0,0
S01008684,All people aged 16 to 74,830,76,12,64,113,65,39,37,104,96,81,55,26,219
S01008684,Very good health,414,53,8,45,60,31,13,9,46,26,20,15,5,156
S01008684,Good health,243,18,3,15,33,18,12,11,34,29,32,22,10,56
S01008684,Fair health,113,4,1,3,12,9,10,6,17,31,17,8,9,7
S01008684,Bad health,46,1,0,1,7,6,4,7,6,5,10,8,2,0
S01008684,Very bad health,14,0,0,0,1,1,0,4,1,5,2,2,0,0
S01008685,All people aged 16 to 74,920,77,6,71,136,74,31,48,99,64,44,18,26,347
S01008685,Very good health,481,46,1,45,76,41,17,13,23,13,5,1,4,247
S01008685,Good health,274,23,4,19,42,23,5,15,38,30,13,4,9,85
S01008685,Fair health,101,7,1,6,12,5,5,15,16,9,17,7,10,15
S01008685,Bad health,49,1,0,1,5,5,3,2,17,10,6,3,3,0
S01008685,Very bad health,15,0,0,0,1,0,1,3,5,2,3,3,0,0
S01008686,All people aged 16 to 74,786,64,6,58,148,92,44,62,106,99,59,47,12,112
S01008686,Very good health,327,39,3,36,66,38,16,21,37,26,10,8,2,74
S01008686,Good health,278,20,2,18,50,36,19,19,39,36,23,16,7,36
S01008686,Fair health,119,4,1,3,19,13,5,17,24,16,19,16,3,2
S01008686,Bad health,47,1,0,1,11,4,4,4,5,15,3,3,0,0
S01008686,Very bad health,15,0,0,0,2,1,0,1,1,6,4,4,0,0
S01008687,All people aged 16 to 74,601,88,11,77,154,66,19,26,61,50,22,14,8,115
S01008687,Very good health,369,62,6,56,115,32,11,11,29,17,11,8,3,81
S01008687,Good health,182,22,5,17,35,27,4,9,28,20,5,4,1,32
S01008687,Fair health,36,4,0,4,4,6,2,4,4,6,5,1,4,1
S01008687,Bad health,10,0,0,0,0,1,0,2,0,6,0,0,0,1
S01008687,Very bad health,4,0,0,0,0,0,2,0,0,1,1,1,0,0
S01008688,All people aged 16 to 74,737,116,16,100,194,91,41,43,65,54,37,23,14,96
S01008688,Very good health,413,88,13,75,121,51,18,17,30,21,9,6,3,58
S01008688,Good health,242,22,3,19,60,35,18,18,23,21,12,7,5,33
S01008688,Fair health,58,5,0,5,7,2,4,6,8,8,14,10,4,4
S01008688,Bad health,18,1,0,1,5,2,1,1,3,3,1,0,1,1
S01008688,Very bad health,6,0,0,0,1,1,0,1,1,1,1,0,1,0
S01008689,All people aged 16 to 74,743,89,12,77,199,79,32,64,101,67,23,12,11,89
S01008689,Very good health,432,68,10,58,126,45,13,30,50,32,7,4,3,61
S01008689,Good health,226,16,1,15,59,23,15,27,34,21,9,3,6,22
S01008689,Fair health,58,5,1,4,10,7,4,3,10,8,6,4,2,5
S01008689,Bad health,24,0,0,0,4,4,0,3,6,6,0,0,0,1
S01008689,Very bad health,3,0,0,0,0,0,0,1,1,0,1,1,0,0
S01008690,All people aged 16 to 74,870,142,15,127,230,123,48,54,86,50,27,15,12,110
S01008690,Very good health,508,99,10,89,139,63,29,27,41,20,13,9,4,77
S01008690,Good health,273,34,3,31,74,48,8,22,29,18,11,5,6,29
S01008690,Fair health,68,8,2,6,13,8,10,3,11,9,2,0,2,4
S01008690,Bad health,18,1,0,1,3,4,1,2,4,3,0,0,0,0
S01008690,Very bad health,3,0,0,0,1,0,0,0,1,0,1,1,0,0
S01008691,All people aged 16 to 74,957,107,15,92,289,149,50,76,94,61,32,14,18,99
S01008691,Very good health,536,75,10,65,176,84,16,44,35,30,9,4,5,67
S01008691,Good health,304,23,2,21,90,57,27,18,42,13,8,2,6,26
S01008691,Fair health,79,6,2,4,18,4,6,10,12,8,11,4,7,4
S01008691,Bad health,28,2,1,1,5,3,0,3,3,7,3,3,0,2
S01008691,Very bad health,10,1,0,1,0,1,1,1,2,3,1,1,0,0
S01008692,All people aged 16 to 74,590,59,8,51,152,89,22,41,76,53,26,15,11,72
S01008692,Very good health,312,42,6,36,88,50,8,17,29,26,7,4,3,45
S01008692,Good health,196,13,1,12,55,27,9,15,31,12,9,5,4,25
S01008692,Fair health,56,3,1,2,6,8,1,8,10,11,7,3,4,2
S01008692,Bad health,20,1,0,1,3,3,3,1,4,3,2,2,0,0
S01008692,Very bad health,6,0,0,0,0,1,1,0,2,1,1,1,0,0
S01008693,All people aged 16 to 74,353,24,2,22,67,66,36,33,61,35,10,6,4,21
S01008693,Very good health,180,10,2,8,43,34,19,16,29,6,4,2,2,19
S01008693,Good health,125,12,0,12,20,24,12,11,25,18,3,2,1,0
S01008693,Fair health,34,1,0,1,4,6,4,4,4,8,1,0,1,2
S01008693,Bad health,12,0,0,0,0,2,1,2,3,2,2,2,0,0
S01008693,Very bad health,2,1,0,1,0,0,0,0,0,1,0,0,0,0
S01008694,All people aged 16 to 74,855,121,10,111,239,123,37,52,99,60,23,10,13,101
S01008694,Very good health,483,82,8,74,145,62,18,26,50,23,7,2,5,70
S01008694,Good health,283,31,2,29,78,46,13,19,37,23,8,4,4,28
S01008694,Fair health,59,3,0,3,9,12,4,4,9,9,6,3,3,3
S01008694,Bad health,24,4,0,4,6,2,1,2,3,4,2,1,1,0
S01008694,Very bad health,6,1,0,1,1,1,1,1,0,1,0,0,0,0
S01008695,All people aged 16 to 74,545,90,9,81,182,73,25,16,52,25,21,11,10,61
S01008695,Very good health,320,57,6,51,115,41,17,11,23,12,6,1,5,38
S01008695,Good health,183,28,2,26,62,26,6,4,21,7,8,5,3,21
S01008695,Fair health,31,3,1,2,3,6,2,0,7,2,6,4,2,2
S01008695,Bad health,9,2,0,2,2,0,0,1,1,3,0,0,0,0
S01008695,Very bad health,2,0,0,0,0,0,0,0,0,1,1,1,0,0
S01008696,All people aged 16 to 74,515,88,20,68,172,80,40,26,37,22,12,7,5,38
S01008696,Very good health,331,65,16,49,104,52,25,14,20,12,7,5,2,32
S01008696,Good health,133,17,2,15,47,20,11,9,13,7,5,2,3,4
S01008696,Fair health,37,6,2,4,18,5,3,1,2,2,0,0,0,0
S01008696,Bad health,11,0,0,0,3,1,1,1,2,1,0,0,0,2
S01008696,Very bad health,3,0,0,0,0,2,0,1,0,0,0,0,0,0
S01008697,All people aged 16 to 74,804,137,23,114,238,129,68,38,67,46,13,11,2,68
S01008697,Very good health,484,87,14,73,158,68,40,16,34,22,8,8,0,51
S01008697,Good health,243,44,6,38,61,41,18,20,26,16,3,1,2,14
S01008697,Fair health,57,4,2,2,13,15,6,2,6,6,2,2,0,3
S01008697,Bad health,16,2,1,1,6,4,2,0,0,2,0,0,0,0
S01008697,Very bad health,4,0,0,0,0,1,2,0,1,0,0,0,0,0
S01008698,All people aged 16 to 74,382,53,8,45,95,60,34,25,56,19,7,5,2,33
S01008698,Very good health,227,37,3,34,49,29,21,14,32,12,3,2,1,30
S01008698,Good health,118,13,4,9,35,21,10,8,21,4,4,3,1,2
S01008698,Fair health,28,2,1,1,9,10,1,1,1,3,0,0,0,1
S01008698,Bad health,9,1,0,1,2,0,2,2,2,0,0,0,0,0
S01008698,Very bad health,0,0,0,0,0,0,0,0,0,0,0,0,0,0
S01008699,All people aged 16 to 74,639,50,9,41,124,104,40,52,108,75,43,31,12,43
S01008699,Very good health,320,33,7,26,71,49,23,26,49,24,12,9,3,33
S01008699,Good health,196,13,1,12,38,36,11,12,36,28,16,9,7,6
S01008699,Fair health,79,4,1,3,11,11,4,8,13,13,11,9,2,4
S01008699,Bad health,31,0,0,0,3,4,1,5,7,8,3,3,0,0
S01008699,Very bad health,13,0,0,0,1,4,1,1,3,2,1,1,0,0
S01008700,All people aged 16 to 74,407,73,19,54,119,63,37,10,27,17,18,15,3,43
S01008700,Very good health,229,49,15,34,68,32,16,4,10,9,4,3,1,37
S01008700,Good health,128,21,4,17,36,24,18,3,12,2,6,4,2,6
S01008700,Fair health,39,1,0,1,13,6,3,1,5,6,4,4,0,0
S01008700,Bad health,10,2,0,2,2,1,0,2,0,0,3,3,0,0
S01008700,Very bad health,1,0,0,0,0,0,0,0,0,0,1,1,0,0
S01008701,All people aged 16 to 74,296,10,0,10,25,30,13,16,68,59,54,35,19,21
S01008701,Very good health,118,6,0,6,12,15,4,11,25,19,15,11,4,11
S01008701,Good health,100,3,0,3,8,10,5,3,22,17,24,12,12,8
S01008701,Fair health,46,1,0,1,5,2,2,2,12,16,5,3,2,1
S01008701,Bad health,27,0,0,0,0,3,1,0,7,6,9,8,1,1
S01008701,Very bad health,5,0,0,0,0,0,1,0,2,1,1,1,0,0
S01008702,All people aged 16 to 74,489,47,6,41,80,62,26,25,69,49,38,24,14,93
S01008702,Very good health,276,27,3,24,51,33,11,11,38,17,17,9,8,71
S01008702,Good health,151,17,3,14,26,20,7,12,23,20,7,4,3,19
S01008702,Fair health,41,3,0,3,3,7,4,1,5,7,8,5,3,3
S01008702,Bad health,16,0,0,0,0,2,2,1,3,3,5,5,0,0
S01008702,Very bad health,5,0,0,0,0,0,2,0,0,2,1,1,0,0
S01008703,All people aged 16 to 74,728,32,1,31,64,45,43,48,126,163,122,95,27,85
S01008703,Very good health,273,22,1,21,27,20,17,20,37,47,32,21,11,51
S01008703,Good health,236,6,0,6,26,20,17,13,45,50,39,30,9,20
S01008703,Fair health,147,2,0,2,9,2,8,11,30,44,28,21,7,13
S01008703,Bad health,59,1,0,1,2,2,1,3,11,20,18,18,0,1
S01008703,Very bad health,13,1,0,1,0,1,0,1,3,2,5,5,0,0
S01008704,All people aged 16 to 74,505,27,4,23,78,57,37,34,101,83,54,40,14,34
S01008704,Very good health,189,13,2,11,41,23,15,11,32,24,11,8,3,19
S01008704,Good health,157,7,0,7,24,25,9,15,27,29,9,5,4,12
S01008704,Fair health,107,7,2,5,10,7,7,7,31,12,23,16,7,3
S01008704,Bad health,37,0,0,0,3,1,3,1,8,12,9,9,0,0
S01008704,Very bad health,15,0,0,0,0,1,3,0,3,6,2,2,0,0
S01008705,All people aged 16 to 74,360,10,1,9,36,28,22,35,74,85,36,27,9,34
S01008705,Very good health,158,5,1,4,22,9,10,16,41,26,6,4,2,23
S01008705,Good health,112,3,0,3,11,11,8,11,17,24,18,12,6,9
S01008705,Fair health,54,2,0,2,2,5,3,7,9,20,5,4,1,1
S01008705,Bad health,25,0,0,0,1,3,1,1,5,11,2,2,0,1
S01008705,Very bad health,11,0,0,0,0,0,0,0,2,4,5,5,0,0
S01008706,All people aged 16 to 74,387,12,1,11,38,36,20,19,95,80,51,37,14,36
S01008706,Very good health,147,9,1,8,20,11,7,3,45,23,11,7,4,18
S01008706,Good health,139,3,0,3,14,14,6,9,25,31,22,16,6,15
S01008706,Fair health,61,0,0,0,2,9,7,1,17,14,9,6,3,2
S01008706,Bad health,30,0,0,0,2,2,0,2,7,9,7,6,1,1
S01008706,Very bad health,10,0,0,0,0,0,0,4,1,3,2,2,0,0
S01008707,All people aged 16 to 74,588,10,2,8,48,53,27,45,136,120,98,78,20,51
S01008707,Very good health,211,3,0,3,21,14,8,15,49,42,30,26,4,29
S01008707,Good health,214,6,1,5,15,26,13,16,53,39,29,18,11,17
S01008707,Fair health,99,1,1,0,7,11,5,10,20,22,19,16,3,4
S01008707,Bad health,51,0,0,0,5,1,1,3,13,14,13,11,2,1
S01008707,Very bad health,13,0,0,0,0,1,0,1,1,3,7,7,0,0
S01008708,All people aged 16 to 74,679,15,1,14,55,62,26,61,166,141,100,64,36,53
S01008708,Very good health,245,6,1,5,22,25,6,26,58,37,35,24,11,30
S01008708,Good health,200,4,0,4,13,16,8,18,51,46,30,15,15,14
S01008708,Fair health,129,4,0,4,11,13,7,6,34,31,20,13,7,3
S01008708,Bad health,80,1,0,1,8,6,4,11,17,22,9,7,2,2
S01008708,Very bad health,25,0,0,0,1,2,1,0,6,5,6,5,1,4
S01008709,All people aged 16 to 74,525,10,0,10,55,51,27,50,115,120,63,47,16,34
S01008709,Very good health,206,4,0,4,27,25,12,16,46,39,12,7,5,25
S01008709,Good health,175,5,0,5,19,18,11,17,38,36,23,15,8,8
S01008709,Fair health,88,1,0,1,4,6,3,10,23,24,16,14,2,1
S01008709,Bad health,42,0,0,0,4,2,1,4,8,15,8,8,0,0
S01008709,Very bad health,14,0,0,0,1,0,0,3,0,6,4,3,1,0
S01008710,All people aged 16 to 74,354,10,1,9,41,35,18,35,68,55,49,34,15,43
S01008710,Very good health,156,6,0,6,17,17,8,15,29,18,15,9,6,31
S01008710,Good health,107,1,0,1,15,11,6,12,20,18,15,9,6,9
S01008710,Fair health,56,3,1,2,6,1,1,4,13,12,13,10,3,3
S01008710,Bad health,25,0,0,0,2,4,3,3,4,6,3,3,0,0
S01008710,Very bad health,10,0,0,0,1,2,0,1,2,1,3,3,0,0
S01008711,All people aged 16 to 74,514,10,0,10,60,45,18,47,114,142,43,35,8,35
S01008711,Very good health,201,7,0,7,30,16,9,21,42,43,11,9,2,22
S01008711,Good health,184,0,0,0,21,18,4,15,51,54,11,8,3,10
S01008711,Fair health,85,2,0,2,4,7,5,8,14,31,11,8,3,3
S01008711,Bad health,42,1,0,1,4,4,0,3,6,14,10,10,0,0
S01008711,Very bad health,2,0,0,0,1,0,0,0,1,0,0,0,0,0
S01008712,All people aged 16 to 74,775,29,4,25,54,75,44,85,163,177,99,71,28,49
S01008712,Very good health,253,13,1,12,23,27,17,19,64,36,25,17,8,29
S01008712,Good health,248,8,2,6,23,26,13,37,53,45,32,16,16,11
S01008712,Fair health,165,4,1,3,5,14,9,18,28,52,29,27,2,6
S01008712,Bad health,82,3,0,3,3,5,4,7,17,33,9,7,2,1
S01008712,Very bad health,27,1,0,1,0,3,1,4,1,11,4,4,0,2
S01008713,All people aged 16 to 74,438,7,1,6,32,49,28,32,118,90,55,35,20,27
S01008713,Very good health,174,4,1,3,18,29,11,12,40,29,12,7,5,19
S01008713,Good health,155,2,0,2,9,16,11,12,49,34,16,9,7,6
S01008713,Fair health,82,0,0,0,2,3,3,7,22,20,23,15,8,2
S01008713,Bad health,19,1,0,1,1,1,1,0,5,6,4,4,0,0
S01008713,Very bad health,8,0,0,0,2,0,2,1,2,1,0,0,0,0
S01008714,All people aged 16 to 74,417,22,3,19,61,58,28,30,79,79,41,25,16,19
S01008714,Very good health,186,17,2,15,33,34,12,7,27,28,14,7,7,14
S01008714,Good health,129,4,1,3,16,14,9,13,38,22,10,6,4,3
S01008714,Fair health,74,1,0,1,7,6,7,8,10,23,10,6,4,2
S01008714,Bad health,17,0,0,0,2,2,0,2,3,3,5,4,1,0
S01008714,Very bad health,11,0,0,0,3,2,0,0,1,3,2,2,0,0
S01008715,All people aged 16 to 74,548,17,4,13,72,77,33,43,109,123,36,26,10,38
S01008715,Very good health,227,6,1,5,34,30,13,17,46,40,10,6,4,31
S01008715,Good health,183,7,2,5,24,26,12,12,37,45,14,10,4,6
S01008715,Fair health,83,1,0,1,10,15,4,9,13,21,9,7,2,1
S01008715,Bad health,39,1,1,0,2,5,3,4,7,15,2,2,0,0
S01008715,Very bad health,16,2,0,2,2,1,1,1,6,2,1,1,0,0
S01008716,All people aged 16 to 74,364,7,2,5,60,56,34,22,77,66,22,12,10,20
S01008716,Very good health,154,4,2,2,26,33,10,9,24,26,9,2,7,13
S01008716,Good health,124,0,0,0,25,14,15,5,33,23,6,6,0,3
S01008716,Fair health,49,2,0,2,7,5,4,3,14,9,5,2,3,0
S01008716,Bad health,24,0,0,0,2,3,5,3,5,5,1,1,0,0
S01008716,Very bad health,13,1,0,1,0,1,0,2,1,3,1,1,0,4
S01008717,All people aged 16 to 74,327,17,2,15,48,59,26,26,74,32,21,12,9,24
S01008717,Very good health,179,10,2,8,28,37,12,17,41,11,8,4,4,15
S01008717,Good health,110,6,0,6,14,16,13,8,27,12,11,6,5,3
S01008717,Fair health,27,1,0,1,5,3,1,1,5,5,1,1,0,5
S01008717,Bad health,9,0,0,0,1,3,0,0,1,2,1,1,0,1
S01008717,Very bad health,2,0,0,0,0,0,0,0,0,2,0,0,0,0
S01008718,All people aged 16 to 74,391,27,6,21,58,77,48,29,66,48,15,9,6,23
S01008718,Very good health,183,15,3,12,28,36,19,11,32,19,4,2,2,19
S01008718,Good health,143,10,3,7,21,26,16,17,22,21,7,4,3,3
S01008718,Fair health,48,2,0,2,7,12,10,1,7,4,4,3,1,1
S01008718,Bad health,11,0,0,0,2,1,2,0,3,3,0,0,0,0
S01008718,Very bad health,6,0,0,0,0,2,1,0,2,1,0,0,0,0
S01008719,All people aged 16 to 74,757,31,3,28,118,107,91,77,139,96,47,36,11,51
S01008719,Very good health,401,18,3,15,67,72,44,35,65,39,25,18,7,36
S01008719,Good health,243,11,0,11,40,30,32,21,53,32,11,8,3,13
S01008719,Fair health,70,2,0,2,11,4,12,13,10,13,3,2,1,2
S01008719,Bad health,39,0,0,0,0,1,3,7,10,11,7,7,0,0
S01008719,Very bad health,4,0,0,0,0,0,0,1,1,1,1,1,0,0
S01008720,All people aged 16 to 74,408,25,1,24,60,65,37,33,70,56,24,16,8,38
S01008720,Very good health,185,11,0,11,30,40,15,15,29,14,6,3,3,25
S01008720,Good health,127,8,0,8,21,15,14,6,25,19,7,4,3,12
S01008720,Fair health,70,4,1,3,9,6,6,7,12,19,6,4,2,1
S01008720,Bad health,21,2,0,2,0,4,1,3,3,4,4,4,0,0
S01008720,Very bad health,5,0,0,0,0,0,1,2,1,0,1,1,0,0
S01008721,All people aged 16 to 74,621,66,10,56,167,119,58,49,64,42,10,7,3,46
S01008721,Very good health,366,47,6,41,99,65,27,33,37,20,3,3,0,35
S01008721,Good health,195,16,4,12,52,48,20,12,22,13,1,0,1,11
S01008721,Fair health,46,3,0,3,13,4,8,4,5,5,4,3,1,0
S01008721,Bad health,12,0,0,0,3,1,3,0,0,3,2,1,1,0
S01008721,Very bad health,2,0,0,0,0,1,0,0,0,1,0,0,0,0
S01008722,All people aged 16 to 74,749,101,25,76,192,129,92,39,68,57,16,12,4,55
S01008722,Very good health,407,66,12,54,105,73,44,21,29,20,7,5,2,42
S01008722,Good health,236,26,11,15,66,46,36,9,26,16,1,1,0,10
S01008722,Fair health,68,8,2,6,13,7,9,3,7,13,5,5,0,3
S01008722,Bad health,25,1,0,1,6,1,2,5,3,6,1,1,0,0
S01008722,Very bad health,13,0,0,0,2,2,1,1,3,2,2,0,2,0
S01008723,All people aged 16 to 74,530,67,12,55,119,100,47,29,46,25,10,7,3,87
S01008723,Very good health,334,44,11,33,74,63,22,19,23,18,4,3,1,67
S01008723,Good health,151,17,1,16,38,27,18,9,16,7,2,0,2,17
S01008723,Fair health,34,6,0,6,6,8,5,1,3,0,3,3,0,2
S01008723,Bad health,11,0,0,0,1,2,2,0,4,0,1,1,0,1
S01008723,Very bad health,0,0,0,0,0,0,0,0,0,0,0,0,0,0
S01008724,All people aged 16 to 74,646,107,20,87,211,85,71,31,54,24,18,12,6,45
S01008724,Very good health,383,61,10,51,130,49,47,18,26,10,5,2,3,37
S01008724,Good health,200,41,10,31,69,26,16,9,19,11,5,4,1,4
S01008724,Fair health,49,4,0,4,8,6,8,3,8,2,6,5,1,4
S01008724,Bad health,11,1,0,1,2,3,0,1,1,1,2,1,1,0
S01008724,Very bad health,3,0,0,0,2,1,0,0,0,0,0,0,0,0
S01008725,All people aged 16 to 74,559,90,12,78,166,69,51,20,52,50,20,12,8,41
S01008725,Very good health,315,59,6,53,101,34,25,12,21,21,8,4,4,34
S01008725,Good health,180,27,6,21,50,27,20,6,20,19,5,3,2,6
S01008725,Fair health,46,4,0,4,12,5,5,1,9,5,5,3,2,0
S01008725,Bad health,14,0,0,0,2,3,1,1,1,4,2,2,0,0
S01008725,Very bad health,4,0,0,0,1,0,0,0,1,1,0,0,0,1
S01008726,All people aged 16 to 74,414,104,17,87,151,39,33,12,24,14,4,1,3,33
S01008726,Very good health,265,75,14,61,85,25,19,7,14,7,4,1,3,29
S01008726,Good health,117,25,2,23,51,11,12,4,6,5,0,0,0,3
S01008726,Fair health,23,3,1,2,12,2,1,1,2,1,0,0,0,1
S01008726,Bad health,5,1,0,1,1,1,0,0,1,1,0,0,0,0
S01008726,Very bad health,4,0,0,0,2,0,1,0,1,0,0,0,0,0
S01008727,All people aged 16 to 74,777,150,18,132,249,84,56,49,64,38,21,16,5,66
S01008727,Very good health,414,101,14,87,147,41,29,20,12,11,6,5,1,47
S01008727,Good health,261,41,4,37,75,34,17,19,36,17,8,5,3,14
S01008727,Fair health,78,6,0,6,19,5,10,7,13,8,5,4,1,5
S01008727,Bad health,14,1,0,1,5,2,0,3,1,1,1,1,0,0
S01008727,Very bad health,10,1,0,1,3,2,0,0,2,1,1,1,0,0
S01008728,All people aged 16 to 74,361,34,2,32,85,49,25,17,65,40,23,15,8,23
S01008728,Very good health,164,17,0,17,51,19,14,6,22,13,4,3,1,18
S01008728,Good health,138,13,1,12,22,22,8,9,31,15,15,8,7,3
S01008728,Fair health,35,2,0,2,6,4,2,1,8,9,2,2,0,1
S01008728,Bad health,15,2,1,1,4,3,0,1,2,2,0,0,0,1
S01008728,Very bad health,9,0,0,0,2,1,1,0,2,1,2,2,0,0
S01008729,All people aged 16 to 74,514,99,17,82,177,53,43,17,44,24,14,12,2,43
S01008729,Very good health,306,72,15,57,101,28,24,10,19,10,4,2,2,38
S01008729,Good health,143,21,1,20,63,16,11,5,12,7,4,4,0,4
S01008729,Fair health,43,5,1,4,10,6,3,1,8,6,4,4,0,0
S01008729,Bad health,18,1,0,1,3,2,3,1,5,0,2,2,0,1
S01008729,Very bad health,4,0,0,0,0,1,2,0,0,1,0,0,0,0
S01008730,All people aged 16 to 74,626,91,14,77,194,67,50,36,54,41,44,26,18,49
S01008730,Very good health,360,64,10,54,123,37,23,17,29,18,13,9,4,36
S01008730,Good health,202,21,4,17,59,21,21,16,21,12,20,10,10,11
S01008730,Fair health,46,5,0,5,10,5,3,2,4,7,8,5,3,2
S01008730,Bad health,15,1,0,1,2,4,3,0,0,4,1,1,0,0
S01008730,Very bad health,3,0,0,0,0,0,0,1,0,0,2,1,1,0
S01008731,All people aged 16 to 74,323,25,9,16,68,46,28,22,57,35,25,17,8,17
S01008731,Very good health,139,15,5,10,39,18,11,5,22,8,8,5,3,13
S01008731,Good health,111,10,4,6,20,17,13,10,18,13,8,3,5,2
S01008731,Fair health,33,0,0,0,6,8,1,3,7,5,3,3,0,0
S01008731,Bad health,28,0,0,0,2,2,3,2,7,8,3,3,0,1
S01008731,Very bad health,12,0,0,0,1,1,0,2,3,1,3,3,0,1
S01008732,All people aged 16 to 74,467,31,3,28,106,66,38,37,69,57,33,19,14,30
S01008732,Very good health,227,20,3,17,56,33,21,14,31,16,16,10,6,20
S01008732,Good health,147,8,0,8,40,22,9,14,22,18,6,1,5,8
S01008732,Fair health,60,2,0,2,5,6,6,8,14,11,6,3,3,2
S01008732,Bad health,22,0,0,0,4,2,2,1,1,8,4,4,0,0
S01008732,Very bad health,11,1,0,1,1,3,0,0,1,4,1,1,0,0
S01008733,All people aged 16 to 74,666,78,11,67,164,120,33,43,101,84,12,3,9,31
S01008733,Very good health,350,48,3,45,100,63,13,24,40,34,5,1,4,23
S01008733,Good health,234,23,7,16,47,47,14,12,44,35,5,1,4,7
S01008733,Fair health,56,4,0,4,9,7,2,6,15,11,1,0,1,1
S01008733,Bad health,20,2,0,2,6,3,2,1,1,4,1,1,0,0
S01008733,Very bad health,6,1,1,0,2,0,2,0,1,0,0,0,0,0
S01008734,All people aged 16 to 74,410,58,6,52,130,53,35,15,47,22,21,14,7,29
S01008734,Very good health,209,31,2,29,73,22,17,9,23,11,3,2,1,20
S01008734,Good health,150,19,2,17,51,26,14,4,16,9,7,2,5,4
S01008734,Fair health,33,7,2,5,3,2,3,1,5,1,6,5,1,5
S01008734,Bad health,14,1,0,1,1,2,1,1,3,1,4,4,0,0
S01008734,Very bad health,4,0,0,0,2,1,0,0,0,0,1,1,0,0
S01008735,All people aged 16 to 74,710,119,18,101,207,110,80,33,61,23,15,10,5,62
S01008735,Very good health,442,81,13,68,142,55,40,14,37,10,6,2,4,57
S01008735,Good health,202,34,4,30,54,41,25,14,17,10,4,4,0,3
S01008735,Fair health,51,1,0,1,10,9,11,4,6,3,5,4,1,2
S01008735,Bad health,12,3,1,2,1,5,2,1,0,0,0,0,0,0
S01008735,Very bad health,3,0,0,0,0,0,2,0,1,0,0,0,0,0
S01008736,All people aged 16 to 74,505,60,13,47,129,68,47,41,59,29,19,15,4,53
S01008736,Very good health,270,35,8,27,78,33,22,13,28,11,6,4,2,44
S01008736,Good health,171,21,4,17,42,24,17,22,18,12,9,8,1,6
S01008736,Fair health,45,4,1,3,5,9,6,4,9,2,3,2,1,3
S01008736,Bad health,15,0,0,0,4,2,1,2,3,2,1,1,0,0
S01008736,Very bad health,4,0,0,0,0,0,1,0,1,2,0,0,0,0
S01008737,All people aged 16 to 74,561,61,8,53,148,108,52,28,67,34,16,10,6,47
S01008737,Very good health,314,30,5,25,95,52,24,17,35,12,10,7,3,39
S01008737,Good health,185,25,3,22,42,45,19,7,23,14,4,2,2,6
S01008737,Fair health,47,4,0,4,8,7,8,1,9,7,2,1,1,1
S01008737,Bad health,8,2,0,2,0,3,0,2,0,0,0,0,0,1
S01008737,Very bad health,7,0,0,0,3,1,1,1,0,1,0,0,0,0
S01008738,All people aged 16 to 74,540,92,17,75,134,102,57,33,43,22,18,14,4,39
S01008738,Very good health,323,53,4,49,79,59,32,16,28,12,8,6,2,36
S01008738,Good health,167,37,12,25,41,30,20,11,12,6,7,5,2,3
S01008738,Fair health,37,1,0,1,12,10,3,5,3,3,0,0,0,0
S01008738,Bad health,12,1,1,0,2,2,2,1,0,1,3,3,0,0
S01008738,Very bad health,1,0,0,0,0,1,0,0,0,0,0,0,0,0
S01008739,All people aged 16 to 74,428,31,6,25,73,88,44,39,71,34,6,4,2,42
S01008739,Very good health,229,16,5,11,35,45,25,22,34,14,2,1,1,36
S01008739,Good health,145,13,1,12,30,31,8,14,25,16,2,1,1,6
S01008739,Fair health,38,2,0,2,8,7,6,1,9,4,1,1,0,0
S01008739,Bad health,13,0,0,0,0,4,4,2,2,0,1,1,0,0
S01008739,Very bad health,3,0,0,0,0,1,1,0,1,0,0,0,0,0
S01008740,All people aged 16 to 74,424,28,6,22,96,101,39,33,54,27,12,9,3,34
S01008740,Very good health,230,15,2,13,58,51,14,15,29,16,2,2,0,30
S01008740,Good health,147,9,4,5,32,38,13,16,20,7,8,6,2,4
S01008740,Fair health,36,4,0,4,4,9,9,2,4,4,0,0,0,0
S01008740,Bad health,7,0,0,0,2,1,2,0,0,0,2,1,1,0
S01008740,Very bad health,4,0,0,0,0,2,1,0,1,0,0,0,0,0
S01008741,All people aged 16 to 74,676,44,10,34,141,159,63,52,97,53,13,8,5,54
S01008741,Very good health,351,24,6,18,75,83,30,26,48,20,1,0,1,44
S01008741,Good health,250,19,4,15,52,60,25,15,36,25,9,5,4,9
S01008741,Fair health,59,1,0,1,11,14,6,8,10,5,3,3,0,1
S01008741,Bad health,11,0,0,0,3,1,1,2,3,1,0,0,0,0
S01008741,Very bad health,5,0,0,0,0,1,1,1,0,2,0,0,0,0
S01008742,All people aged 16 to 74,337,29,4,25,86,61,26,16,44,42,12,11,1,21
S01008742,Very good health,161,12,1,11,52,28,12,5,17,15,1,1,0,19
S01008742,Good health,121,11,3,8,26,23,10,5,19,19,6,6,0,2
S01008742,Fair health,41,6,0,6,6,8,3,5,6,5,2,1,1,0
S01008742,Bad health,10,0,0,0,0,2,1,1,2,2,2,2,0,0
S01008742,Very bad health,4,0,0,0,2,0,0,0,0,1,1,1,0,0
S01008743,All people aged 16 to 74,697,48,5,43,143,96,38,51,126,109,40,25,15,46
S01008743,Very good health,347,35,4,31,76,57,17,26,57,31,16,11,5,32
S01008743,Good health,214,9,1,8,43,29,11,16,39,42,13,7,6,12
S01008743,Fair health,90,4,0,4,16,10,5,7,17,23,7,3,4,1
S01008743,Bad health,35,0,0,0,6,0,3,2,10,9,4,4,0,1
S01008743,Very bad health,11,0,0,0,2,0,2,0,3,4,0,0,0,0
S01008744,All people aged 16 to 74,751,66,14,52,141,135,47,51,130,90,32,17,15,59
S01008744,Very good health,398,46,11,35,86,79,23,27,57,36,13,5,8,31
S01008744,Good health,241,16,3,13,36,41,16,16,50,31,13,7,6,22
S01008744,Fair health,87,4,0,4,15,13,7,6,15,19,5,4,1,3
S01008744,Bad health,18,0,0,0,3,2,1,2,3,4,0,0,0,3
S01008744,Very bad health,7,0,0,0,1,0,0,0,5,0,1,1,0,0
S01008745,All people aged 16 to 74,346,65,4,61,85,59,18,16,43,22,9,5,4,29
S01008745,Very good health,210,48,4,44,46,31,8,14,24,12,4,3,1,23
S01008745,Good health,108,16,0,16,31,21,8,1,15,9,2,0,2,5
S01008745,Fair health,23,1,0,1,5,6,2,1,3,1,3,2,1,1
S01008745,Bad health,4,0,0,0,3,1,0,0,0,0,0,0,0,0
S01008745,Very bad health,1,0,0,0,0,0,0,0,1,0,0,0,0,0
S01008746,All people aged 16 to 74,819,53,9,44,128,114,41,60,142,132,61,42,19,88
S01008746,Very good health,363,34,5,29,67,54,17,17,47,44,12,8,4,71
S01008746,Good health,286,15,4,11,50,35,17,20,55,51,26,16,10,17
S01008746,Fair health,100,1,0,1,10,16,3,13,24,18,15,10,5,0
S01008746,Bad health,51,2,0,2,1,4,2,6,14,14,8,8,0,0
S01008746,Very bad health,19,1,0,1,0,5,2,4,2,5,0,0,0,0
S01008747,All people aged 16 to 74,361,48,7,41,87,66,40,20,39,24,7,6,1,30
S01008747,Very good health,208,37,4,33,58,36,18,9,16,9,2,2,0,23
S01008747,Good health,122,11,3,8,26,22,15,9,20,9,4,3,1,6
S01008747,Fair health,25,0,0,0,3,7,5,2,2,5,0,0,0,1
S01008747,Bad health,6,0,0,0,0,1,2,0,1,1,1,1,0,0
S01008747,Very bad health,0,0,0,0,0,0,0,0,0,0,0,0,0,0
S01008748,All people aged 16 to 74,480,58,6,52,126,103,44,28,55,31,10,9,1,25
S01008748,Very good health,270,40,3,37,73,55,22,14,26,11,5,5,0,24
S01008748,Good health,153,15,3,12,43,39,19,9,17,9,1,1,0,1
S01008748,Fair health,47,2,0,2,10,7,3,5,7,11,2,1,1,0
S01008748,Bad health,9,1,0,1,0,1,0,0,5,0,2,2,0,0
S01008748,Very bad health,1,0,0,0,0,1,0,0,0,0,0,0,0,0
S01008749,All people aged 16 to 74,728,65,7,58,190,124,83,47,78,60,32,25,7,49
S01008749,Very good health,384,43,6,37,107,75,33,27,32,20,7,4,3,40
S01008749,Good health,261,17,1,16,68,42,38,13,37,28,11,8,3,7
S01008749,Fair health,63,4,0,4,11,5,11,4,7,10,9,9,0,2
S01008749,Bad health,16,1,0,1,3,2,1,3,2,1,3,2,1,0
S01008749,Very bad health,4,0,0,0,1,0,0,0,0,1,2,2,0,0
S01008750,All people aged 16 to 74,515,56,8,48,115,117,48,32,68,36,9,5,4,34
S01008750,Very good health,295,32,3,29,69,61,29,17,38,17,3,2,1,29
S01008750,Good health,158,19,4,15,37,41,15,8,19,10,5,2,3,4
S01008750,Fair health,42,3,0,3,5,13,2,4,9,5,0,0,0,1
S01008750,Bad health,12,1,1,0,2,1,1,2,2,2,1,1,0,0
S01008750,Very bad health,8,1,0,1,2,1,1,1,0,2,0,0,0,0
S01008751,All people aged 16 to 74,431,26,3,23,90,74,40,31,57,58,24,9,15,31
S01008751,Very good health,185,12,1,11,50,33,16,16,23,9,4,1,3,22
S01008751,Good health,148,10,1,9,28,26,14,9,23,23,8,2,6,7
S01008751,Fair health,58,2,0,2,9,9,4,4,7,15,7,1,6,1
S01008751,Bad health,25,2,1,1,2,2,3,2,3,8,2,2,0,1
S01008751,Very bad health,15,0,0,0,1,4,3,0,1,3,3,3,0,0
S01008752,All people aged 16 to 74,582,9,3,6,83,97,33,47,113,96,70,47,23,34
S01008752,Very good health,208,3,1,2,38,39,14,12,33,31,17,6,11,21
S01008752,Good health,209,4,1,3,33,37,9,17,41,28,28,17,11,12
S01008752,Fair health,101,1,1,0,5,13,7,11,26,22,15,14,1,1
S01008752,Bad health,43,1,0,1,4,5,0,3,11,11,8,8,0,0
S01008752,Very bad health,21,0,0,0,3,3,3,4,2,4,2,2,0,0
S01008753,All people aged 16 to 74,402,15,0,15,68,55,26,32,76,88,24,11,13,18
S01008753,Very good health,168,7,0,7,34,29,5,16,24,30,11,4,7,12
S01008753,Good health,123,5,0,5,19,17,11,7,33,22,6,2,4,3
S01008753,Fair health,60,2,0,2,7,5,4,5,9,21,4,3,1,3
S01008753,Bad health,37,1,0,1,6,2,2,4,9,11,2,1,1,0
S01008753,Very bad health,14,0,0,0,2,2,4,0,1,4,1,1,0,0
S01008754,All people aged 16 to 74,515,36,3,33,101,83,30,42,88,81,20,13,7,34
S01008754,Very good health,243,26,3,23,60,44,14,18,33,23,7,3,4,18
S01008754,Good health,175,8,0,8,34,29,9,11,30,31,7,5,2,16
S01008754,Fair health,64,2,0,2,4,7,5,9,16,17,4,3,1,0
S01008754,Bad health,22,0,0,0,2,1,2,2,6,8,1,1,0,0
S01008754,Very bad health,11,0,0,0,1,2,0,2,3,2,1,1,0,0
S01008755,All people aged 16 to 74,750,36,5,31,106,105,46,77,121,148,59,32,27,52
S01008755,Very good health,353,29,3,26,54,53,21,40,54,52,10,4,6,40
S01008755,Good health,249,5,2,3,36,31,16,27,45,56,24,12,12,9
S01008755,Fair health,99,1,0,1,11,15,5,6,14,28,16,7,9,3
S01008755,Bad health,31,1,0,1,5,3,1,3,8,7,3,3,0,0
S01008755,Very bad health,18,0,0,0,0,3,3,1,0,5,6,6,0,0
S01008756,All people aged 16 to 74,567,22,2,20,73,75,26,52,125,108,44,25,19,42
S01008756,Very good health,234,14,0,14,38,34,8,18,44,35,11,5,6,32
S01008756,Good health,177,6,1,5,25,31,13,12,46,27,11,4,7,6
S01008756,Fair health,99,2,1,1,6,7,2,11,21,30,17,11,6,3
S01008756,Bad health,48,0,0,0,3,3,3,11,10,13,4,4,0,1
S01008756,Very bad health,9,0,0,0,1,0,0,0,4,3,1,1,0,0
S01008757,All people aged 16 to 74,491,12,1,11,40,47,32,51,100,137,58,33,25,14
S01008757,Very good health,143,3,0,3,21,17,7,13,27,24,24,14,10,7
S01008757,Good health,161,5,0,5,9,16,12,17,27,49,21,9,12,5
S01008757,Fair health,106,3,1,2,4,9,7,14,22,36,10,7,3,1
S01008757,Bad health,60,1,0,1,5,4,6,1,18,22,2,2,0,1
S01008757,Very bad health,21,0,0,0,1,1,0,6,6,6,1,1,0,0
S01008758,All people aged 16 to 74,611,21,4,17,73,92,47,49,121,111,53,34,19,44
S01008758,Very good health,246,10,2,8,34,35,18,24,46,32,20,7,13,27
S01008758,Good health,214,9,2,7,23,42,20,13,45,38,13,10,3,11
S01008758,Fair health,76,1,0,1,7,6,6,7,15,25,5,3,2,4
S01008758,Bad health,56,1,0,1,7,8,3,4,10,9,12,11,1,2
S01008758,Very bad health,19,0,0,0,2,1,0,1,5,7,3,3,0,0
S01008759,All people aged 16 to 74,414,14,1,13,56,57,28,34,92,74,36,22,14,23
S01008759,Very good health,149,8,1,7,22,22,7,13,30,25,8,5,3,14
S01008759,Good health,144,6,0,6,24,20,8,10,35,25,11,4,7,5
S01008759,Fair health,66,0,0,0,7,7,8,3,16,12,10,6,4,3
S01008759,Bad health,42,0,0,0,3,7,3,5,9,9,5,5,0,1
S01008759,Very bad health,13,0,0,0,0,1,2,3,2,3,2,2,0,0
S01008760,All people aged 16 to 74,723,27,5,22,74,81,41,63,153,156,82,57,25,46
S01008760,Very good health,266,15,3,12,34,36,14,19,58,38,20,16,4,32
S01008760,Good health,245,11,2,9,23,27,18,21,44,60,30,15,15,11
S01008760,Fair health,141,1,0,1,9,11,7,17,37,37,20,15,5,2
S01008760,Bad health,52,0,0,0,4,4,2,5,8,19,9,8,1,1
S01008760,Very bad health,19,0,0,0,4,3,0,1,6,2,3,3,0,0
S01008761,All people aged 16 to 74,562,40,2,38,115,67,43,46,72,75,46,39,7,58
S01008761,Very good health,322,28,0,28,75,36,25,25,40,49,7,4,3,37
S01008761,Good health,162,8,1,7,34,25,14,17,22,17,8,6,2,17
S01008761,Fair health,63,4,1,3,6,6,3,2,6,5,27,25,2,4
S01008761,Bad health,9,0,0,0,0,0,1,1,1,4,2,2,0,0
S01008761,Very bad health,6,0,0,0,0,0,0,1,3,0,2,2,0,0
S01008762,All people aged 16 to 74,462,41,7,34,104,83,33,31,69,56,13,9,4,32
S01008762,Very good health,219,26,4,22,61,32,9,19,33,16,1,1,0,22
S01008762,Good health,178,14,3,11,40,34,18,11,25,22,6,3,3,8
S01008762,Fair health,45,1,0,1,2,12,5,1,7,13,3,3,0,1
S01008762,Bad health,16,0,0,0,1,3,1,0,4,3,3,2,1,1
S01008762,Very bad health,4,0,0,0,0,2,0,0,0,2,0,0,0,0
S01008763,All people aged 16 to 74,719,112,10,102,202,132,46,37,87,66,14,7,7,23
S01008763,Very good health,414,76,8,68,120,80,30,17,42,26,5,3,2,18
S01008763,Good health,240,34,2,32,64,40,14,16,33,29,5,1,4,5
S01008763,Fair health,49,1,0,1,15,10,2,4,7,8,2,2,0,0
S01008763,Bad health,13,1,0,1,2,2,0,0,4,2,2,1,1,0
S01008763,Very bad health,3,0,0,0,1,0,0,0,1,1,0,0,0,0
S01008764,All people aged 16 to 74,547,86,10,76,170,60,41,35,63,34,16,11,5,42
S01008764,Very good health,306,59,8,51,100,34,19,15,27,13,7,4,3,32
S01008764,Good health,169,22,2,20,54,17,11,13,24,13,6,4,2,9
S01008764,Fair health,49,4,0,4,15,3,8,2,8,6,2,2,0,1
S01008764,Bad health,19,0,0,0,1,6,2,5,2,2,1,1,0,0
S01008764,Very bad health,4,1,0,1,0,0,1,0,2,0,0,0,0,0
S01008765,All people aged 16 to 74,653,99,13,86,197,83,53,42,73,44,19,13,6,43
S01008765,Very good health,387,64,9,55,136,45,20,26,34,19,10,6,4,33
S01008765,Good health,198,24,3,21,44,31,28,10,29,22,3,2,1,7
S01008765,Fair health,51,9,0,9,13,7,4,4,7,1,3,3,0,3
S01008765,Bad health,12,2,1,1,3,0,1,1,1,2,2,1,1,0
S01008765,Very bad health,5,0,0,0,1,0,0,1,2,0,1,1,0,0
S01008766,All people aged 16 to 74,750,92,16,76,179,121,86,56,78,60,25,15,10,53
S01008766,Very good health,430,71,12,59,103,64,44,25,45,24,9,4,5,45
S01008766,Good health,252,18,4,14,65,47,33,19,26,24,12,7,5,8
S01008766,Fair health,46,3,0,3,8,6,7,8,5,5,4,4,0,0
S01008766,Bad health,18,0,0,0,1,3,2,4,1,7,0,0,0,0
S01008766,Very bad health,4,0,0,0,2,1,0,0,1,0,0,0,0,0
S01008767,All people aged 16 to 74,420,34,10,24,95,85,32,32,43,50,8,3,5,41
S01008767,Very good health,238,22,7,15,58,47,21,12,21,21,1,1,0,35
S01008767,Good health,119,10,2,8,27,24,4,15,16,15,3,1,2,5
S01008767,Fair health,43,2,1,1,10,10,4,4,2,8,2,0,2,1
S01008767,Bad health,15,0,0,0,0,3,1,1,2,6,2,1,1,0
S01008767,Very bad health,5,0,0,0,0,1,2,0,2,0,0,0,0,0
S01008768,All people aged 16 to 74,390,42,6,36,97,55,29,32,49,41,18,13,5,27
S01008768,Very good health,203,28,5,23,55,28,16,16,25,13,6,4,2,16
S01008768,Good health,112,11,0,11,27,18,10,12,9,11,7,5,2,7
S01008768,Fair health,53,1,0,1,10,4,3,4,12,13,3,2,1,3
S01008768,Bad health,14,2,1,1,3,4,0,0,2,1,1,1,0,1
S01008768,Very bad health,8,0,0,0,2,1,0,0,1,3,1,1,0,0
S01008769,All people aged 16 to 74,613,152,18,134,202,89,37,26,33,16,14,7,7,44
S01008769,Very good health,414,109,11,98,136,50,22,19,20,11,6,3,3,41
S01008769,Good health,166,41,6,35,57,33,11,4,10,4,4,0,4,2
S01008769,Fair health,27,2,1,1,8,4,4,3,3,1,2,2,0,0
S01008769,Bad health,2,0,0,0,0,1,0,0,0,0,0,0,0,1
S01008769,Very bad health,4,0,0,0,1,1,0,0,0,0,2,2,0,0
S01008770,All people aged 16 to 74,722,166,29,137,195,79,58,34,48,38,26,18,8,78
S01008770,Very good health,474,117,22,95,136,46,33,20,29,22,17,11,6,54
S01008770,Good health,205,40,6,34,51,28,23,13,14,13,4,2,2,19
S01008770,Fair health,36,8,1,7,6,5,2,0,4,2,5,5,0,4
S01008770,Bad health,6,1,0,1,2,0,0,1,1,0,0,0,0,1
S01008770,Very bad health,1,0,0,0,0,0,0,0,0,1,0,0,0,0
S01008771,All people aged 16 to 74,620,137,18,119,165,70,46,28,64,30,29,20,9,51
S01008771,Very good health,353,96,14,82,104,36,30,9,27,11,8,3,5,32
S01008771,Good health,176,34,3,31,44,29,11,13,20,9,6,6,0,10
S01008771,Fair health,69,6,1,5,12,5,5,3,12,5,13,9,4,8
S01008771,Bad health,14,0,0,0,2,0,0,3,4,2,2,2,0,1
S01008771,Very bad health,8,1,0,1,3,0,0,0,1,3,0,0,0,0
S01008772,All people aged 16 to 74,593,104,11,93,164,80,42,36,49,55,23,15,8,40
S01008772,Very good health,326,79,6,73,105,34,19,13,20,20,3,2,1,33
S01008772,Good health,195,20,5,15,49,36,20,15,18,24,7,6,1,6
S01008772,Fair health,45,5,0,5,8,8,1,4,6,5,7,3,4,1
S01008772,Bad health,22,0,0,0,2,2,2,3,4,5,4,3,1,0
S01008772,Very bad health,5,0,0,0,0,0,0,1,1,1,2,1,1,0
S01008773,All people aged 16 to 74,856,95,19,76,226,127,47,66,127,84,34,18,16,50
S01008773,Very good health,417,57,11,46,136,60,19,28,55,22,9,3,6,31
S01008773,Good health,291,28,7,21,63,53,17,28,49,29,12,4,8,12
S01008773,Fair health,86,9,1,8,14,9,5,5,14,19,6,4,2,5
S01008773,Bad health,38,1,0,1,10,1,2,2,5,11,4,4,0,2
S01008773,Very bad health,24,0,0,0,3,4,4,3,4,3,3,3,0,0
S01008774,All people aged 16 to 74,769,64,7,57,155,103,51,74,112,97,54,30,24,59
S01008774,Very good health,364,37,3,34,93,42,23,28,46,37,12,4,8,46
S01008774,Good health,263,18,2,16,48,40,22,37,37,31,18,9,9,12
S01008774,Fair health,94,9,2,7,8,12,5,6,19,22,13,8,5,0
S01008774,Bad health,41,0,0,0,3,6,1,3,9,7,11,9,2,1
S01008774,Very bad health,7,0,0,0,3,3,0,0,1,0,0,0,0,0
S01008775,All people aged 16 to 74,391,54,5,49,111,45,27,36,30,42,18,12,6,28
S01008775,Very good health,210,36,2,34,65,26,13,15,17,12,4,1,3,22
S01008775,Good health,129,18,3,15,33,12,11,15,9,18,8,7,1,5
S01008775,Fair health,41,0,0,0,11,4,1,6,2,11,5,3,2,1
S01008775,Bad health,10,0,0,0,2,3,2,0,1,1,1,1,0,0
S01008775,Very bad health,1,0,0,0,0,0,0,0,1,0,0,0,0,0
S01008776,All people aged 16 to 74,701,56,4,52,140,89,34,54,116,93,58,41,17,61
S01008776,Very good health,303,37,2,35,74,34,15,25,43,32,11,10,1,32
S01008776,Good health,237,13,2,11,41,38,13,18,42,33,19,7,12,20
S01008776,Fair health,96,3,0,3,14,10,6,6,17,12,20,17,3,8
S01008776,Bad health,50,1,0,1,9,6,0,2,10,13,8,7,1,1
S01008776,Very bad health,15,2,0,2,2,1,0,3,4,3,0,0,0,0
S01008777,All people aged 16 to 74,901,65,8,57,161,94,56,87,155,161,70,45,25,52
S01008777,Very good health,327,35,4,31,81,37,26,28,41,34,12,9,3,33
S01008777,Good health,301,22,0,22,57,31,11,27,52,62,26,16,10,13
S01008777,Fair health,168,7,3,4,15,15,11,19,38,40,17,10,7,6
S01008777,Bad health,84,1,1,0,6,10,6,10,20,19,12,9,3,0
S01008777,Very bad health,21,0,0,0,2,1,2,3,4,6,3,1,2,0
S01008778,All people aged 16 to 74,995,178,10,168,289,99,69,45,116,67,47,28,19,85
S01008778,Very good health,576,119,8,111,181,55,41,24,52,29,18,11,7,57
S01008778,Good health,305,48,2,46,89,28,21,12,45,22,16,9,7,24
S01008778,Fair health,80,9,0,9,15,6,4,6,17,8,11,6,5,4
S01008778,Bad health,28,2,0,2,4,9,2,2,2,6,1,1,0,0
S01008778,Very bad health,6,0,0,0,0,1,1,1,0,2,1,1,0,0
S01008779,All people aged 16 to 74,655,145,20,125,220,70,38,32,51,30,14,5,9,55
S01008779,Very good health,428,99,14,85,153,43,22,21,30,17,6,1,5,37
S01008779,Good health,185,43,6,37,58,21,13,8,17,9,2,2,0,14
S01008779,Fair health,33,3,0,3,7,5,3,1,2,2,6,2,4,4
S01008779,Bad health,7,0,0,0,2,1,0,1,2,1,0,0,0,0
S01008779,Very bad health,2,0,0,0,0,0,0,1,0,1,0,0,0,0
S01008780,All people aged 16 to 74,525,79,6,73,168,52,34,27,48,52,11,9,2,54
S01008780,Very good health,288,49,3,46,103,30,14,11,20,20,1,1,0,40
S01008780,Good health,172,25,1,24,48,18,14,12,16,21,6,4,2,12
S01008780,Fair health,44,3,1,2,14,3,4,3,8,5,2,2,0,2
S01008780,Bad health,17,1,1,0,3,1,2,1,3,4,2,2,0,0
S01008780,Very bad health,4,1,0,1,0,0,0,0,1,2,0,0,0,0
S01008781,All people aged 16 to 74,776,114,14,100,197,83,31,77,93,87,40,21,19,54
S01008781,Very good health,402,76,10,66,119,35,20,33,33,42,11,3,8,33
S01008781,Good health,248,33,3,30,62,39,8,32,26,21,12,6,6,15
S01008781,Fair health,85,2,0,2,12,2,2,10,21,16,14,9,5,6
S01008781,Bad health,33,2,0,2,4,5,1,2,10,6,3,3,0,0
S01008781,Very bad health,8,1,1,0,0,2,0,0,3,2,0,0,0,0
S01008782,All people aged 16 to 74,651,125,10,115,183,71,40,51,66,38,27,19,8,50
S01008782,Very good health,357,77,3,74,104,47,23,27,25,13,8,3,5,33
S01008782,Good health,222,38,7,31,64,14,14,16,33,16,11,8,3,16
S01008782,Fair health,48,7,0,7,8,9,2,5,6,7,3,3,0,1
S01008782,Bad health,15,1,0,1,6,0,1,1,2,1,3,3,0,0
S01008782,Very bad health,9,2,0,2,1,1,0,2,0,1,2,2,0,0
S01008783,All people aged 16 to 74,364,66,6,60,126,38,20,20,39,30,11,7,4,14
S01008783,Very good health,210,46,5,41,71,19,13,9,18,21,3,2,1,10
S01008783,Good health,113,18,1,17,45,12,4,8,17,6,1,0,1,2
S01008783,Fair health,34,2,0,2,8,7,3,1,2,3,7,5,2,1
S01008783,Bad health,6,0,0,0,2,0,0,1,2,0,0,0,0,1
S01008783,Very bad health,1,0,0,0,0,0,0,1,0,0,0,0,0,0
S01008784,All people aged 16 to 74,394,66,8,58,120,40,21,29,56,25,15,8,7,22
S01008784,Very good health,206,47,5,42,58,21,9,15,31,9,2,1,1,14
S01008784,Good health,144,18,3,15,53,13,12,12,17,8,3,2,1,8
S01008784,Fair health,36,1,0,1,8,6,0,1,6,6,8,3,5,0
S01008784,Bad health,8,0,0,0,1,0,0,1,2,2,2,2,0,0
S01008784,Very bad health,0,0,0,0,0,0,0,0,0,0,0,0,0,0
S01008785,All people aged 16 to 74,685,58,6,52,110,64,34,70,108,112,69,50,19,60
S01008785,Very good health,320,39,4,35,68,31,18,31,46,35,18,14,4,34
S01008785,Good health,217,12,2,10,30,24,13,23,33,33,25,16,9,24
S01008785,Fair health,105,4,0,4,7,7,1,13,23,29,19,14,5,2
S01008785,Bad health,33,3,0,3,4,1,1,3,5,10,6,5,1,0
S01008785,Very bad health,10,0,0,0,1,1,1,0,1,5,1,1,0,0
S01008786,All people aged 16 to 74,836,123,18,105,249,87,42,72,82,74,48,29,19,59
S01008786,Very good health,462,72,12,60,154,46,23,37,38,30,21,11,10,41
S01008786,Good health,260,40,5,35,76,32,14,21,30,21,11,7,4,15
S01008786,Fair health,85,9,1,8,14,7,4,12,11,17,10,6,4,1
S01008786,Bad health,26,2,0,2,5,2,1,2,2,6,4,4,0,2
S01008786,Very bad health,3,0,0,0,0,0,0,0,1,0,2,1,1,0
S01008787,All people aged 16 to 74,268,9,0,9,24,21,9,20,59,64,36,21,15,26
S01008787,Very good health,103,5,0,5,9,5,4,8,27,25,4,0,4,16
S01008787,Good health,107,3,0,3,14,10,4,7,15,22,23,15,8,9
S01008787,Fair health,40,0,0,0,1,3,1,2,12,12,9,6,3,0
S01008787,Bad health,13,1,0,1,0,3,0,1,4,3,0,0,0,1
S01008787,Very bad health,5,0,0,0,0,0,0,2,1,2,0,0,0,0
S01008788,All people aged 16 to 74,604,104,14,90,184,73,29,50,67,46,13,8,5,38
S01008788,Very good health,363,73,12,61,124,42,18,29,33,19,5,2,3,20
S01008788,Good health,185,27,1,26,46,23,7,12,27,22,4,4,0,17
S01008788,Fair health,38,3,0,3,12,4,3,6,4,5,1,0,1,0
S01008788,Bad health,13,1,1,0,1,3,0,3,3,0,1,0,1,1
S01008788,Very bad health,5,0,0,0,1,1,1,0,0,0,2,2,0,0
S01008789,All people aged 16 to 74,486,37,4,33,86,66,26,49,74,90,24,17,7,34
S01008789,Very good health,211,23,3,20,48,32,13,16,21,28,8,4,4,22
S01008789,Good health,169,12,1,11,24,23,10,21,31,28,9,7,2,11
S01008789,Fair health,72,0,0,0,11,7,2,9,14,24,4,3,1,1
S01008789,Bad health,23,1,0,1,2,3,0,2,7,6,2,2,0,0
S01008789,Very bad health,11,1,0,1,1,1,1,1,1,4,1,1,0,0
S01008790,All people aged 16 to 74,553,50,4,46,107,61,35,40,74,59,46,31,15,81
S01008790,Very good health,302,36,4,32,73,31,14,20,37,20,18,13,5,53
S01008790,Good health,170,9,0,9,27,21,14,9,24,29,13,7,6,24
S01008790,Fair health,46,3,0,3,3,6,4,3,9,7,9,5,4,2
S01008790,Bad health,30,2,0,2,4,3,2,6,4,3,6,6,0,0
S01008790,Very bad health,5,0,0,0,0,0,1,2,0,0,0,0,0,2
S01008791,All people aged 16 to 74,767,90,7,83,154,86,53,76,77,93,40,24,16,98
S01008791,Very good health,434,57,5,52,97,47,24,39,40,41,15,10,5,74
S01008791,Good health,253,27,2,25,46,28,24,29,26,37,14,8,6,22
S01008791,Fair health,58,4,0,4,8,9,3,6,7,12,7,5,2,2
S01008791,Bad health,16,2,0,2,3,0,2,0,2,3,4,1,3,0
S01008791,Very bad health,6,0,0,0,0,2,0,2,2,0,0,0,0,0
S01008792,All people aged 16 to 74,651,74,9,65,167,83,41,45,88,66,37,26,11,50
S01008792,Very good health,349,42,4,38,118,41,20,23,40,15,15,8,7,35
S01008792,Good health,208,26,5,21,36,32,11,19,30,28,13,11,2,13
S01008792,Fair health,65,4,0,4,8,9,8,1,12,18,3,2,1,2
S01008792,Bad health,25,1,0,1,5,0,2,2,5,5,5,4,1,0
S01008792,Very bad health,4,1,0,1,0,1,0,0,1,0,1,1,0,0
S01008793,All people aged 16 to 74,345,21,2,19,58,41,17,36,47,44,38,24,14,43
S01008793,Very good health,146,10,1,9,24,19,9,19,13,15,10,6,4,27
S01008793,Good health,135,9,1,8,28,15,5,13,17,22,14,8,6,12
S01008793,Fair health,44,1,0,1,5,3,3,3,9,6,10,6,4,4
S01008793,Bad health,14,1,0,1,1,2,0,0,7,0,3,3,0,0
S01008793,Very bad health,6,0,0,0,0,2,0,1,1,1,1,1,0,0
S01008794,All people aged 16 to 74,637,59,6,53,124,92,27,50,116,92,36,19,17,41
S01008794,Very good health,312,41,4,37,73,47,12,26,53,27,8,5,3,25
S01008794,Good health,205,14,2,12,38,29,12,16,36,33,18,8,10,9
S01008794,Fair health,87,4,0,4,11,10,1,7,19,23,7,4,3,5
S01008794,Bad health,23,0,0,0,2,4,2,1,4,6,2,1,1,2
S01008794,Very bad health,10,0,0,0,0,2,0,0,4,3,1,1,0,0
S01008795,All people aged 16 to 74,963,110,11,99,238,117,51,78,122,91,42,29,13,114
S01008795,Very good health,544,71,5,66,140,58,29,37,65,39,16,10,6,89
S01008795,Good health,321,32,4,28,75,45,19,35,45,37,14,9,5,19
S01008795,Fair health,69,6,1,5,16,10,0,4,11,10,6,4,2,6
S01008795,Bad health,23,1,1,0,7,2,2,2,1,5,3,3,0,0
S01008795,Very bad health,6,0,0,0,0,2,1,0,0,0,3,3,0,0
S01008796,All people aged 16 to 74,892,65,4,61,186,109,45,68,140,131,56,41,15,92
S01008796,Very good health,436,43,2,41,105,57,22,22,51,50,22,15,7,64
S01008796,Good health,289,20,2,18,65,38,13,26,54,39,14,9,5,20
S01008796,Fair health,117,1,0,1,12,11,8,16,24,27,11,9,2,7
S01008796,Bad health,39,0,0,0,4,3,1,2,11,11,6,5,1,1
S01008796,Very bad health,11,1,0,1,0,0,1,2,0,4,3,3,0,0
S01008797,All people aged 16 to 74,834,89,6,83,209,105,38,60,121,76,29,21,8,107
S01008797,Very good health,438,49,1,48,139,51,18,36,45,17,8,7,1,75
S01008797,Good health,277,30,3,27,63,38,10,16,50,31,11,6,5,28
S01008797,Fair health,77,7,1,6,5,8,7,7,17,17,6,4,2,3
S01008797,Bad health,33,2,1,1,2,6,3,1,6,9,3,3,0,1
S01008797,Very bad health,9,1,0,1,0,2,0,0,3,2,1,1,0,0
S01008798,All people aged 16 to 74,678,70,7,63,150,94,32,66,104,61,32,13,19,69
S01008798,Very good health,318,39,4,35,87,39,11,31,40,20,6,0,6,45
S01008798,Good health,244,28,2,26,43,38,11,29,44,19,11,5,6,21
S01008798,Fair health,83,2,0,2,16,12,6,2,13,16,13,6,7,3
S01008798,Bad health,23,1,1,0,2,5,3,4,4,3,1,1,0,0
S01008798,Very bad health,10,0,0,0,2,0,1,0,3,3,1,1,0,0
S01008799,All people aged 16 to 74,555,41,2,39,100,58,26,58,75,71,39,30,9,87
S01008799,Very good health,325,25,1,24,71,31,15,35,30,35,20,13,7,63
S01008799,Good health,168,15,1,14,26,21,9,16,33,19,8,6,2,21
S01008799,Fair health,39,1,0,1,2,5,1,2,6,11,8,8,0,3
S01008799,Bad health,12,0,0,0,0,1,1,1,4,3,2,2,0,0
S01008799,Very bad health,11,0,0,0,1,0,0,4,2,3,1,1,0,0
S01008800,All people aged 16 to 74,952,95,8,87,261,120,55,74,126,96,30,13,17,95
S01008800,Very good health,556,67,5,62,164,65,24,44,64,50,11,6,5,67
S01008800,Good health,318,23,1,22,80,43,30,22,47,33,14,4,10,26
S01008800,Fair health,53,5,2,3,14,9,1,2,10,8,2,2,0,2
S01008800,Bad health,18,0,0,0,3,0,0,5,3,5,2,0,2,0
S01008800,Very bad health,7,0,0,0,0,3,0,1,2,0,1,1,0,0
S01008801,All people aged 16 to 74,855,93,9,84,203,112,36,91,91,86,32,19,13,111
S01008801,Very good health,465,59,6,53,122,67,20,38,37,42,10,4,6,70
S01008801,Good health,275,27,2,25,66,34,12,31,35,22,12,7,5,36
S01008801,Fair health,86,6,1,5,14,8,2,18,13,14,8,7,1,3
S01008801,Bad health,23,1,0,1,1,3,1,4,4,7,1,0,1,1
S01008801,Very bad health,6,0,0,0,0,0,1,0,2,1,1,1,0,1
S01008802,All people aged 16 to 74,861,81,6,75,195,90,45,78,120,87,42,25,17,123
S01008802,Very good health,433,45,3,42,119,53,12,29,52,31,16,7,9,76
S01008802,Good health,310,29,3,26,64,31,24,39,41,30,17,12,5,35
S01008802,Fair health,85,7,0,7,11,5,6,6,17,15,7,4,3,11
S01008802,Bad health,21,0,0,0,1,0,2,3,6,7,1,1,0,1
S01008802,Very bad health,12,0,0,0,0,1,1,1,4,4,1,1,0,0
S01008803,All people aged 16 to 74,831,91,14,77,178,92,44,62,118,99,57,36,21,90
S01008803,Very good health,412,56,12,44,93,56,21,27,50,31,22,16,6,56
S01008803,Good health,287,24,1,23,63,25,16,25,45,42,16,7,9,31
S01008803,Fair health,82,7,1,6,11,6,6,6,15,13,15,9,6,3
S01008803,Bad health,36,3,0,3,9,4,0,3,5,10,2,2,0,0
S01008803,Very bad health,14,1,0,1,2,1,1,1,3,3,2,2,0,0
S01008804,All people aged 16 to 74,489,44,7,37,98,59,26,40,59,56,27,23,4,80
S01008804,Very good health,241,24,1,23,58,27,9,19,19,18,11,8,3,56
S01008804,Good health,161,11,6,5,29,21,9,13,27,19,9,8,1,23
S01008804,Fair health,56,6,0,6,5,7,6,5,10,11,5,5,0,1
S01008804,Bad health,23,3,0,3,6,2,2,2,1,5,2,2,0,0
S01008804,Very bad health,8,0,0,0,0,2,0,1,2,3,0,0,0,0
S01008805,All people aged 16 to 74,570,74,3,71,96,73,19,36,62,35,21,14,7,154
S01008805,Very good health,332,50,2,48,56,35,7,21,30,14,10,8,2,109
S01008805,Good health,187,16,0,16,36,30,9,8,25,16,6,4,2,41
S01008805,Fair health,41,8,1,7,3,6,2,5,5,4,4,1,3,4
S01008805,Bad health,9,0,0,0,0,2,1,2,2,1,1,1,0,0
S01008805,Very bad health,1,0,0,0,1,0,0,0,0,0,0,0,0,0
S01008806,All people aged 16 to 74,897,138,15,123,235,104,46,66,84,49,34,24,10,141
S01008806,Very good health,545,99,11,88,147,64,21,36,39,23,14,10,4,102
S01008806,Good health,275,34,2,32,74,30,14,26,32,19,12,9,3,34
S01008806,Fair health,60,4,2,2,11,9,10,3,9,4,5,3,2,5
S01008806,Bad health,14,1,0,1,3,1,1,1,3,2,2,1,1,0
S01008806,Very bad health,3,0,0,0,0,0,0,0,1,1,1,1,0,0
S01008807,All people aged 16 to 74,712,87,10,77,201,92,32,56,82,57,29,19,10,76
S01008807,Very good health,383,62,8,54,120,52,12,26,30,24,7,2,5,50
S01008807,Good health,229,23,2,21,64,25,15,23,32,15,12,9,3,20
S01008807,Fair health,66,2,0,2,10,14,2,3,11,12,7,7,0,5
S01008807,Bad health,22,0,0,0,6,0,2,4,4,2,3,1,2,1
S01008807,Very bad health,12,0,0,0,1,1,1,0,5,4,0,0,0,0
S01008808,All people aged 16 to 74,568,117,5,112,139,50,51,30,54,42,23,12,11,62
S01008808,Very good health,322,78,3,75,89,29,24,7,19,19,6,2,4,51
S01008808,Good health,176,35,2,33,42,15,16,16,25,11,7,3,4,9
S01008808,Fair health,46,4,0,4,4,5,9,5,7,6,5,2,3,1
S01008808,Bad health,20,0,0,0,2,1,2,2,3,5,4,4,0,1
S01008808,Very bad health,4,0,0,0,2,0,0,0,0,1,1,1,0,0
S01008809,All people aged 16 to 74,541,115,23,92,128,40,61,23,42,16,17,9,8,99
S01008809,Very good health,348,83,16,67,79,27,34,9,23,9,7,5,2,77
S01008809,Good health,154,25,5,20,44,12,23,11,12,5,2,0,2,20
S01008809,Fair health,30,7,2,5,5,1,2,3,6,1,3,0,3,2
S01008809,Bad health,8,0,0,0,0,0,1,0,1,1,5,4,1,0
S01008809,Very bad health,1,0,0,0,0,0,1,0,0,0,0,0,0,0
S01008810,All people aged 16 to 74,632,127,15,112,192,65,30,28,36,41,12,9,3,101
S01008810,Very good health,418,95,12,83,126,43,14,19,21,21,8,6,2,71
S01008810,Good health,176,28,3,25,59,17,13,8,9,16,3,2,1,23
S01008810,Fair health,35,4,0,4,7,5,2,0,6,3,1,1,0,7
S01008810,Bad health,1,0,0,0,0,0,0,0,0,1,0,0,0,0
S01008810,Very bad health,2,0,0,0,0,0,1,1,0,0,0,0,0,0
S01008811,All people aged 16 to 74,765,134,21,113,182,64,49,42,54,50,24,14,10,166
S01008811,Very good health,511,92,13,79,115,43,31,25,27,28,8,4,4,142
S01008811,Good health,201,34,7,27,61,15,13,14,17,14,11,6,5,22
S01008811,Fair health,39,8,1,7,4,4,5,1,7,6,3,2,1,1
S01008811,Bad health,10,0,0,0,1,2,0,1,2,2,1,1,0,1
S01008811,Very bad health,4,0,0,0,1,0,0,1,1,0,1,1,0,0
S01008812,All people aged 16 to 74,424,85,7,78,117,32,23,12,38,24,5,3,2,88
S01008812,Very good health,262,60,5,55,68,18,14,7,20,10,1,0,1,64
S01008812,Good health,136,21,2,19,42,12,8,5,12,10,2,2,0,24
S01008812,Fair health,19,2,0,2,5,1,1,0,5,3,2,1,1,0
S01008812,Bad health,6,1,0,1,2,1,0,0,1,1,0,0,0,0
S01008812,Very bad health,1,1,0,1,0,0,0,0,0,0,0,0,0,0
S01008813,All people aged 16 to 74,793,65,7,58,162,85,54,68,135,74,63,46,17,87
S01008813,Very good health,400,43,3,40,98,42,26,28,49,32,23,17,6,59
S01008813,Good health,254,18,4,14,47,33,22,17,50,21,20,13,7,26
S01008813,Fair health,89,2,0,2,8,7,6,14,22,13,16,13,3,1
S01008813,Bad health,39,1,0,1,7,3,0,7,13,5,2,1,1,1
S01008813,Very bad health,11,1,0,1,2,0,0,2,1,3,2,2,0,0
S01008814,All people aged 16 to 74,696,88,10,78,166,81,48,67,69,47,29,19,10,101
S01008814,Very good health,388,60,8,52,90,42,19,36,39,18,11,7,4,73
S01008814,Good health,240,26,2,24,59,30,22,23,25,24,7,2,5,24
S01008814,Fair health,49,1,0,1,12,7,5,4,4,4,9,8,1,3
S01008814,Bad health,16,1,0,1,5,1,2,3,1,0,2,2,0,1
S01008814,Very bad health,3,0,0,0,0,1,0,1,0,1,0,0,0,0
S01008815,All people aged 16 to 74,776,85,8,77,205,87,40,49,70,100,42,24,18,98
S01008815,Very good health,404,60,7,53,124,39,22,17,26,41,8,0,8,67
S01008815,Good health,265,21,0,21,67,40,7,19,30,37,20,13,7,24
S01008815,Fair health,76,2,1,1,12,5,8,8,12,12,11,8,3,6
S01008815,Bad health,18,1,0,1,1,1,3,3,1,7,1,1,0,0
S01008815,Very bad health,13,1,0,1,1,2,0,2,1,3,2,2,0,1
S01008816,All people aged 16 to 74,424,70,9,61,110,64,15,28,43,29,35,27,8,30
S01008816,Very good health,230,48,7,41,62,34,7,12,20,9,13,10,3,25
S01008816,Good health,120,11,1,10,36,19,6,11,12,10,11,9,2,4
S01008816,Fair health,54,10,1,9,8,6,2,3,9,7,8,6,2,1
S01008816,Bad health,12,1,0,1,3,3,0,1,0,2,2,2,0,0
S01008816,Very bad health,8,0,0,0,1,2,0,1,2,1,1,0,1,0
S01008817,All people aged 16 to 74,642,87,7,80,135,91,32,64,84,77,33,20,13,39
S01008817,Very good health,348,61,3,58,88,50,19,30,34,28,12,4,8,26
S01008817,Good health,183,18,2,16,37,32,9,20,29,20,9,5,4,9
S01008817,Fair health,73,7,2,5,6,5,3,7,14,16,11,10,1,4
S01008817,Bad health,23,1,0,1,2,4,0,5,2,9,0,0,0,0
S01008817,Very bad health,15,0,0,0,2,0,1,2,5,4,1,1,0,0
S01008818,All people aged 16 to 74,619,86,5,81,186,95,40,46,66,44,12,10,2,44
S01008818,Very good health,378,59,3,56,112,56,25,27,37,16,7,6,1,39
S01008818,Good health,187,22,2,20,61,27,9,13,19,26,5,4,1,5
S01008818,Fair health,44,5,0,5,10,9,6,5,7,2,0,0,0,0
S01008818,Bad health,9,0,0,0,3,3,0,1,2,0,0,0,0,0
S01008818,Very bad health,1,0,0,0,0,0,0,0,1,0,0,0,0,0
S01008819,All people aged 16 to 74,571,114,13,101,194,73,31,27,50,36,14,8,6,32
S01008819,Very good health,308,69,4,65,110,37,14,12,25,16,4,1,3,21
S01008819,Good health,204,41,8,33,70,26,14,12,16,10,5,3,2,10
S01008819,Fair health,45,4,1,3,13,9,0,2,6,7,3,2,1,1
S01008819,Bad health,12,0,0,0,1,0,2,1,3,3,2,2,0,0
S01008819,Very bad health,2,0,0,0,0,1,1,0,0,0,0,0,0,0
S01008820,All people aged 16 to 74,910,87,8,79,238,106,53,57,131,100,76,51,25,62
S01008820,Very good health,427,55,4,51,127,55,20,24,58,31,21,15,6,36
S01008820,Good health,312,26,3,23,81,38,24,21,42,38,20,12,8,22
S01008820,Fair health,121,2,1,1,23,10,7,8,23,21,23,12,11,4
S01008820,Bad health,39,4,0,4,6,1,1,4,5,7,11,11,0,0
S01008820,Very bad health,11,0,0,0,1,2,1,0,3,3,1,1,0,0
S01008821,All people aged 16 to 74,524,122,16,106,170,47,33,21,37,26,20,14,6,48
S01008821,Very good health,325,82,10,72,111,29,19,9,19,7,10,8,2,39
S01008821,Good health,155,32,5,27,53,15,9,6,14,11,7,4,3,8
S01008821,Fair health,35,8,1,7,5,3,5,3,4,5,2,1,1,0
S01008821,Bad health,9,0,0,0,1,0,0,3,0,3,1,1,0,1
S01008821,Very bad health,0,0,0,0,0,0,0,0,0,0,0,0,0,0
S01008822,All people aged 16 to 74,536,127,19,108,180,52,44,18,40,14,17,12,5,44
S01008822,Very good health,346,89,14,75,126,27,20,8,27,5,7,3,4,37
S01008822,Good health,144,33,4,29,45,13,19,7,10,6,5,5,0,6
S01008822,Fair health,42,5,1,4,9,11,5,2,3,1,5,4,1,1
S01008822,Bad health,3,0,0,0,0,0,0,1,0,2,0,0,0,0
S01008822,Very bad health,1,0,0,0,0,1,0,0,0,0,0,0,0,0
S01008823,All people aged 16 to 74,453,114,26,88,141,46,49,12,35,15,11,6,5,30
S01008823,Very good health,287,78,17,61,98,25,21,6,21,9,3,2,1,26
S01008823,Good health,130,34,8,26,38,12,22,4,11,1,5,2,3,3
S01008823,Fair health,24,2,1,1,4,5,4,2,3,3,0,0,0,1
S01008823,Bad health,6,0,0,0,1,2,0,0,0,1,2,1,1,0
S01008823,Very bad health,6,0,0,0,0,2,2,0,0,1,1,1,0,0
S01008824,All people aged 16 to 74,749,167,28,139,268,91,49,29,69,22,17,8,9,37
S01008824,Very good health,438,105,19,86,165,51,24,15,29,13,6,0,6,30
S01008824,Good health,220,56,9,47,68,28,17,12,28,3,4,2,2,4
S01008824,Fair health,74,5,0,5,30,11,6,1,8,6,4,3,1,3
S01008824,Bad health,12,1,0,1,2,0,1,1,4,0,3,3,0,0
S01008824,Very bad health,5,0,0,0,3,1,1,0,0,0,0,0,0,0
S01008825,All people aged 16 to 74,451,126,24,102,136,62,30,22,38,14,5,5,0,18
S01008825,Very good health,278,92,18,74,84,39,15,7,21,3,2,2,0,15
S01008825,Good health,131,33,6,27,42,15,10,11,10,6,1,1,0,3
S01008825,Fair health,31,1,0,1,9,8,3,4,3,2,1,1,0,0
S01008825,Bad health,6,0,0,0,1,0,2,0,1,2,0,0,0,0
S01008825,Very bad health,5,0,0,0,0,0,0,0,3,1,1,1,0,0
S01008826,All people aged 16 to 74,536,96,15,81,147,72,42,36,50,40,22,15,7,31
S01008826,Very good health,302,60,11,49,98,39,24,18,16,16,6,4,2,25
S01008826,Good health,150,29,3,26,40,25,10,11,18,11,2,1,1,4
S01008826,Fair health,55,6,1,5,6,6,6,3,10,6,10,6,4,2
S01008826,Bad health,22,1,0,1,2,2,2,1,5,5,4,4,0,0
S01008826,Very bad health,7,0,0,0,1,0,0,3,1,2,0,0,0,0
S01008827,All people aged 16 to 74,491,168,22,146,153,50,35,14,22,5,9,6,3,35
S01008827,Very good health,346,121,14,107,104,32,25,9,14,3,7,4,3,31
S01008827,Good health,114,37,7,30,39,15,5,4,7,2,1,1,0,4
S01008827,Fair health,24,8,1,7,6,3,4,1,1,0,1,1,0,0
S01008827,Bad health,5,1,0,1,3,0,1,0,0,0,0,0,0,0
S01008827,Very bad health,2,1,0,1,1,0,0,0,0,0,0,0,0,0
S01008828,All people aged 16 to 74,666,127,18,109,221,90,57,31,56,18,16,11,5,50
S01008828,Very good health,396,80,9,71,139,46,35,14,31,8,5,3,2,38
S01008828,Good health,216,42,8,34,68,34,17,15,17,8,6,5,1,9
S01008828,Fair health,34,5,1,4,11,4,2,1,6,1,2,1,1,2
S01008828,Bad health,15,0,0,0,2,5,2,1,1,1,2,1,1,1
S01008828,Very bad health,5,0,0,0,1,1,1,0,1,0,1,1,0,0
S01008829,All people aged 16 to 74,493,80,14,66,137,52,33,21,49,45,17,12,5,59
S01008829,Very good health,295,57,9,48,98,24,17,10,23,19,4,1,3,43
S01008829,Good health,133,17,3,14,28,21,10,8,18,14,6,4,2,11
S01008829,Fair health,47,4,2,2,7,6,5,3,5,6,6,6,0,5
S01008829,Bad health,13,1,0,1,3,1,1,0,2,5,0,0,0,0
S01008829,Very bad health,5,1,0,1,1,0,0,0,1,1,1,1,0,0
S01008830,All people aged 16 to 74,476,119,18,101,161,62,32,12,28,14,7,2,5,41
S01008830,Very good health,280,80,11,69,96,27,19,4,15,8,2,1,1,29
S01008830,Good health,151,30,6,24,56,27,9,5,9,3,3,1,2,9
S01008830,Fair health,34,8,1,7,6,6,2,2,4,2,1,0,1,3
S01008830,Bad health,9,1,0,1,2,1,2,1,0,1,1,0,1,0
S01008830,Very bad health,2,0,0,0,1,1,0,0,0,0,0,0,0,0
S01008831,All people aged 16 to 74,552,143,19,124,161,76,48,20,26,18,11,6,5,49
S01008831,Very good health,331,101,13,88,91,34,25,8,14,11,4,1,3,43
S01008831,Good health,175,34,5,29,52,34,19,10,11,5,5,3,2,5
S01008831,Fair health,41,8,1,7,17,4,4,2,1,2,2,2,0,1
S01008831,Bad health,3,0,0,0,0,3,0,0,0,0,0,0,0,0
S01008831,Very bad health,2,0,0,0,1,1,0,0,0,0,0,0,0,0
S01008832,All people aged 16 to 74,535,129,26,103,141,62,53,13,44,18,28,14,14,47
S01008832,Very good health,326,90,18,72,89,36,29,6,22,1,13,4,9,40
S01008832,Good health,148,26,4,22,41,21,18,5,16,9,7,4,3,5
S01008832,Fair health,47,11,4,7,9,5,3,1,5,6,6,4,2,1
S01008832,Bad health,10,2,0,2,2,0,3,0,1,2,0,0,0,0
S01008832,Very bad health,4,0,0,0,0,0,0,1,0,0,2,2,0,1
S01008833,All people aged 16 to 74,732,215,26,189,212,71,36,30,44,33,10,7,3,81
S01008833,Very good health,486,158,16,142,143,43,19,20,15,18,3,2,1,67
S01008833,Good health,186,46,9,37,54,23,12,8,19,7,5,3,2,12
S01008833,Fair health,47,10,1,9,14,3,3,2,7,5,1,1,0,2
S01008833,Bad health,10,1,0,1,1,1,2,0,1,3,1,1,0,0
S01008833,Very bad health,3,0,0,0,0,1,0,0,2,0,0,0,0,0
S01008834,All people aged 16 to 74,837,192,33,159,256,124,76,25,51,24,24,20,4,65
S01008834,Very good health,527,138,22,116,167,66,44,18,25,11,9,7,2,49
S01008834,Good health,241,44,9,35,72,49,26,4,16,7,10,8,2,13
S01008834,Fair health,58,9,2,7,14,9,5,2,10,4,4,4,0,1
S01008834,Bad health,10,1,0,1,3,0,1,1,0,1,1,1,0,2
S01008834,Very bad health,1,0,0,0,0,0,0,0,0,1,0,0,0,0
S01008835,All people aged 16 to 74,608,103,23,80,166,102,32,34,69,49,13,7,6,40
S01008835,Very good health,330,72,14,58,97,46,15,17,33,12,3,1,2,35
S01008835,Good health,198,28,9,19,52,35,12,13,23,24,7,3,4,4
S01008835,Fair health,58,3,0,3,12,17,2,4,9,8,2,2,0,1
S01008835,Bad health,16,0,0,0,4,4,2,0,2,4,0,0,0,0
S01008835,Very bad health,6,0,0,0,1,0,1,0,2,1,1,1,0,0
S01008836,All people aged 16 to 74,562,77,11,66,132,71,26,47,65,72,22,18,4,50
S01008836,Very good health,298,54,7,47,84,35,13,24,29,17,4,4,0,38
S01008836,Good health,161,18,2,16,41,23,7,11,18,22,9,6,3,12
S01008836,Fair health,61,4,2,2,5,11,4,7,10,16,4,3,1,0
S01008836,Bad health,28,1,0,1,2,0,2,3,7,12,1,1,0,0
S01008836,Very bad health,14,0,0,0,0,2,0,2,1,5,4,4,0,0
S01008837,All people aged 16 to 74,918,222,29,193,264,118,43,43,70,55,37,26,11,66
S01008837,Very good health,566,164,19,145,173,74,16,27,35,27,7,4,3,43
S01008837,Good health,259,51,9,42,66,35,18,10,23,18,17,12,5,21
S01008837,Fair health,67,7,1,6,14,7,7,4,9,6,11,8,3,2
S01008837,Bad health,20,0,0,0,9,1,1,2,3,4,0,0,0,0
S01008837,Very bad health,6,0,0,0,2,1,1,0,0,0,2,2,0,0
S01008838,All people aged 16 to 74,881,159,19,140,267,135,40,59,72,45,22,17,5,82
S01008838,Very good health,528,113,13,100,166,71,21,37,33,20,7,5,2,60
S01008838,Good health,266,41,4,37,79,51,14,17,21,18,5,5,0,20
S01008838,Fair health,63,4,2,2,17,11,5,5,11,3,6,3,3,1
S01008838,Bad health,21,1,0,1,5,1,0,0,7,3,3,3,0,1
S01008838,Very bad health,3,0,0,0,0,1,0,0,0,1,1,1,0,0
S01008839,All people aged 16 to 74,876,191,23,168,230,121,64,41,71,52,14,10,4,92
S01008839,Very good health,523,128,11,117,139,72,27,19,39,22,3,2,1,74
S01008839,Good health,267,53,8,45,76,38,31,16,17,14,7,5,2,15
S01008839,Fair health,64,8,2,6,15,8,6,4,10,7,3,2,1,3
S01008839,Bad health,14,2,2,0,0,2,0,1,4,5,0,0,0,0
S01008839,Very bad health,8,0,0,0,0,1,0,1,1,4,1,1,0,0
S01008840,All people aged 16 to 74,871,173,20,153,254,113,49,31,64,37,16,6,10,134
S01008840,Very good health,540,117,15,102,174,57,22,12,33,19,5,2,3,101
S01008840,Good health,261,52,5,47,64,42,18,16,24,13,6,2,4,26
S01008840,Fair health,57,3,0,3,13,10,9,3,5,4,4,2,2,6
S01008840,Bad health,10,1,0,1,3,4,0,0,1,0,1,0,1,0
S01008840,Very bad health,3,0,0,0,0,0,0,0,1,1,0,0,0,1
S01008841,All people aged 16 to 74,475,84,8,76,130,63,39,24,52,29,8,6,2,46
S01008841,Very good health,296,52,5,47,77,44,21,12,30,17,7,5,2,36
S01008841,Good health,139,26,2,24,41,18,12,10,14,10,0,0,0,8
S01008841,Fair health,29,4,0,4,11,1,2,2,5,2,0,0,0,2
S01008841,Bad health,8,2,1,1,1,0,3,0,2,0,0,0,0,0
S01008841,Very bad health,3,0,0,0,0,0,1,0,1,0,1,1,0,0
S01008842,All people aged 16 to 74,771,135,12,123,184,71,45,35,95,48,31,25,6,127
S01008842,Very good health,521,104,10,94,136,47,30,21,53,19,17,13,4,94
S01008842,Good health,209,29,1,28,44,19,12,11,29,24,12,11,1,29
S01008842,Fair health,32,2,1,1,4,3,2,3,10,3,1,0,1,4
S01008842,Bad health,7,0,0,0,0,1,1,0,3,2,0,0,0,0
S01008842,Very bad health,2,0,0,0,0,1,0,0,0,0,1,1,0,0
S01008843,All people aged 16 to 74,886,177,14,163,201,90,46,36,73,34,32,27,5,197
S01008843,Very good health,575,134,13,121,137,52,27,18,43,15,18,15,3,131
S01008843,Good health,239,34,1,33,49,30,8,15,21,10,10,9,1,62
S01008843,Fair health,53,4,0,4,12,7,8,3,8,4,3,2,1,4
S01008843,Bad health,15,5,0,5,3,1,1,0,1,4,0,0,0,0
S01008843,Very bad health,4,0,0,0,0,0,2,0,0,1,1,1,0,0
S01008844,All people aged 16 to 74,607,138,9,129,168,57,27,15,48,34,27,18,9,93
S01008844,Very good health,394,93,4,89,121,28,15,9,23,19,11,7,4,75
S01008844,Good health,158,36,3,33,34,23,6,4,16,12,12,7,5,15
S01008844,Fair health,39,9,2,7,9,5,4,1,6,2,1,1,0,2
S01008844,Bad health,14,0,0,0,3,1,2,1,3,0,3,3,0,1
S01008844,Very bad health,2,0,0,0,1,0,0,0,0,1,0,0,0,0
S01008845,All people aged 16 to 74,778,177,22,155,173,53,31,31,32,20,14,11,3,247
S01008845,Very good health,555,125,9,116,132,33,22,17,18,8,8,6,2,192
S01008845,Good health,187,49,13,36,33,15,6,10,10,10,2,2,0,52
S01008845,Fair health,27,2,0,2,6,5,3,4,3,0,3,2,1,1
S01008845,Bad health,8,1,0,1,2,0,0,0,1,1,1,1,0,2
S01008845,Very bad health,1,0,0,0,0,0,0,0,0,1,0,0,0,0
S01008846,All people aged 16 to 74,719,144,10,134,163,68,63,23,39,30,15,9,6,174
S01008846,Very good health,465,97,4,93,109,41,37,10,20,14,5,0,5,132
S01008846,Good health,189,36,5,31,42,21,18,8,9,11,6,5,1,38
S01008846,Fair health,49,10,1,9,8,4,5,3,8,4,3,3,0,4
S01008846,Bad health,13,1,0,1,4,2,2,2,0,1,1,1,0,0
S01008846,Very bad health,3,0,0,0,0,0,1,0,2,0,0,0,0,0
S01008847,All people aged 16 to 74,523,124,18,106,122,33,38,16,30,10,5,1,4,145
S01008847,Very good health,365,79,11,68,89,20,29,8,17,6,3,0,3,114
S01008847,Good health,133,39,6,33,29,9,8,5,11,2,1,0,1,29
S01008847,Fair health,20,5,0,5,2,4,1,3,2,1,0,0,0,2
S01008847,Bad health,3,1,1,0,1,0,0,0,0,1,0,0,0,0
S01008847,Very bad health,2,0,0,0,1,0,0,0,0,0,1,1,0,0
S01008848,All people aged 16 to 74,683,175,22,153,164,58,37,11,25,19,27,19,8,167
S01008848,Very good health,479,132,17,115,120,39,16,5,12,12,11,8,3,132
S01008848,Good health,153,35,5,30,35,13,17,5,8,5,4,1,3,31
S01008848,Fair health,35,6,0,6,9,3,3,1,2,2,5,3,2,4
S01008848,Bad health,13,2,0,2,0,3,0,0,2,0,6,6,0,0
S01008848,Very bad health,3,0,0,0,0,0,1,0,1,0,1,1,0,0
S01008849,All people aged 16 to 74,630,174,20,154,165,40,51,20,27,20,5,3,2,128
S01008849,Very good health,419,122,16,106,108,23,34,12,14,10,1,0,1,95
S01008849,Good health,174,46,4,42,48,13,14,6,12,8,1,0,1,26
S01008849,Fair health,29,5,0,5,8,4,2,1,1,1,0,0,0,7
S01008849,Bad health,6,0,0,0,0,0,1,1,0,1,3,3,0,0
S01008849,Very bad health,2,1,0,1,1,0,0,0,0,0,0,0,0,0
S01008850,All people aged 16 to 74,699,204,33,171,172,48,47,20,11,8,12,8,4,177
S01008850,Very good health,494,157,22,135,108,30,31,11,5,6,5,3,2,141
S01008850,Good health,169,41,9,32,56,16,11,6,5,2,2,1,1,30
S01008850,Fair health,29,5,2,3,6,2,5,3,1,0,2,1,1,5
S01008850,Bad health,7,1,0,1,2,0,0,0,0,0,3,3,0,1
S01008850,Very bad health,0,0,0,0,0,0,0,0,0,0,0,0,0,0
S01008851,All people aged 16 to 74,869,214,26,188,266,62,50,38,59,45,20,5,15,115
S01008851,Very good health,542,161,18,143,171,39,35,15,21,8,12,3,9,80
S01008851,Good health,218,43,7,36,70,14,7,11,20,17,5,1,4,31
S01008851,Fair health,82,8,1,7,19,6,7,9,14,12,3,1,2,4
S01008851,Bad health,15,2,0,2,4,2,0,2,2,3,0,0,0,0
S01008851,Very bad health,12,0,0,0,2,1,1,1,2,5,0,0,0,0
S01008852,All people aged 16 to 74,816,256,33,223,228,58,67,13,28,19,14,9,5,133
S01008852,Very good health,548,178,22,156,158,37,39,8,17,7,4,3,1,100
S01008852,Good health,215,62,9,53,55,17,21,4,8,8,9,5,4,31
S01008852,Fair health,42,13,2,11,11,3,5,0,3,4,1,1,0,2
S01008852,Bad health,10,3,0,3,3,1,2,1,0,0,0,0,0,0
S01008852,Very bad health,1,0,0,0,1,0,0,0,0,0,0,0,0,0
S01008853,All people aged 16 to 74,599,170,20,150,157,43,36,22,31,12,12,6,6,116
S01008853,Very good health,414,116,12,104,111,31,25,11,15,8,5,3,2,92
S01008853,Good health,138,42,6,36,35,9,5,10,13,3,3,1,2,18
S01008853,Fair health,38,10,2,8,8,3,4,1,3,1,3,1,2,5
S01008853,Bad health,7,2,0,2,2,0,1,0,0,0,1,1,0,1
S01008853,Very bad health,2,0,0,0,1,0,1,0,0,0,0,0,0,0
S01008854,All people aged 16 to 74,821,221,38,183,220,57,58,15,21,14,22,12,10,193
S01008854,Very good health,562,154,25,129,141,33,38,10,12,10,8,6,2,156
S01008854,Good health,205,59,12,47,58,22,14,5,7,2,10,3,7,28
S01008854,Fair health,43,6,1,5,16,1,5,0,2,0,4,3,1,9
S01008854,Bad health,8,1,0,1,4,1,0,0,0,2,0,0,0,0
S01008854,Very bad health,3,1,0,1,1,0,1,0,0,0,0,0,0,0
S01008855,All people aged 16 to 74,949,295,38,257,309,68,58,23,46,15,17,9,8,118
S01008855,Very good health,671,212,22,190,208,42,46,16,27,9,6,2,4,105
S01008855,Good health,216,66,9,57,80,21,7,5,12,6,7,4,3,12
S01008855,Fair health,46,13,6,7,15,3,5,2,5,0,2,1,1,1
S01008855,Bad health,10,4,1,3,4,0,0,0,0,0,2,2,0,0
S01008855,Very bad health,6,0,0,0,2,2,0,0,2,0,0,0,0,0
S01008856,All people aged 16 to 74,494,120,17,103,151,52,26,19,31,20,10,7,3,65
S01008856,Very good health,309,78,14,64,99,35,13,7,20,10,2,1,1,45
S01008856,Good health,146,33,3,30,45,12,10,7,9,7,4,3,1,19
S01008856,Fair health,30,8,0,8,6,4,2,4,0,2,3,2,1,1
S01008856,Bad health,7,1,0,1,0,1,1,0,2,1,1,1,0,0
S01008856,Very bad health,2,0,0,0,1,0,0,1,0,0,0,0,0,0
S01008857,All people aged 16 to 74,655,186,25,161,197,62,38,27,49,24,13,7,6,59
S01008857,Very good health,422,137,17,120,117,41,23,17,32,11,6,3,3,38
S01008857,Good health,185,39,8,31,70,18,15,7,9,6,4,2,2,17
S01008857,Fair health,38,10,0,10,8,2,0,2,6,6,2,1,1,2
S01008857,Bad health,6,0,0,0,1,0,0,1,1,1,1,1,0,1
S01008857,Very bad health,4,0,0,0,1,1,0,0,1,0,0,0,0,1
S01008858,All people aged 16 to 74,467,136,19,117,167,43,33,12,22,13,4,2,2,37
S01008858,Very good health,308,99,14,85,110,22,20,8,13,5,2,1,1,29
S01008858,Good health,123,29,4,25,45,16,11,3,6,4,1,1,0,8
S01008858,Fair health,27,6,1,5,10,4,1,1,2,3,0,0,0,0
S01008858,Bad health,7,1,0,1,2,1,1,0,1,1,0,0,0,0
S01008858,Very bad health,2,1,0,1,0,0,0,0,0,0,1,0,1,0
S01008859,All people aged 16 to 74,902,256,27,229,284,102,63,38,38,28,17,8,9,76
S01008859,Very good health,603,193,20,173,184,57,36,26,23,14,9,5,4,61
S01008859,Good health,222,47,3,44,81,28,23,10,7,7,6,2,4,13
S01008859,Fair health,63,13,3,10,17,15,3,1,4,7,2,1,1,1
S01008859,Bad health,11,3,1,2,2,1,0,1,3,0,0,0,0,1
S01008859,Very bad health,3,0,0,0,0,1,1,0,1,0,0,0,0,0
S01008860,All people aged 16 to 74,756,180,13,167,231,83,42,26,60,30,17,8,9,87
S01008860,Very good health,499,137,8,129,168,50,23,17,22,13,4,1,3,65
S01008860,Good health,186,35,5,30,47,21,13,5,29,9,8,3,5,19
S01008860,Fair health,49,8,0,8,10,9,6,2,5,4,4,3,1,1
S01008860,Bad health,18,0,0,0,6,3,0,1,3,3,1,1,0,1
S01008860,Very bad health,4,0,0,0,0,0,0,1,1,1,0,0,0,1
S01008861,All people aged 16 to 74,583,193,26,167,183,39,60,7,24,11,7,5,2,59
S01008861,Very good health,411,140,19,121,127,21,34,4,19,7,6,4,2,53
S01008861,Good health,129,44,5,39,42,15,14,2,4,2,0,0,0,6
S01008861,Fair health,36,9,2,7,11,1,11,0,1,2,1,1,0,0
S01008861,Bad health,4,0,0,0,2,1,0,1,0,0,0,0,0,0
S01008861,Very bad health,3,0,0,0,1,1,1,0,0,0,0,0,0,0
S01008862,All people aged 16 to 74,794,253,34,219,229,83,52,34,33,30,11,7,4,69
S01008862,Very good health,516,176,23,153,150,47,31,26,18,12,1,1,0,55
S01008862,Good health,215,61,10,51,59,28,18,6,10,12,7,4,3,14
S01008862,Fair health,43,11,1,10,18,1,2,1,2,5,3,2,1,0
S01008862,Bad health,18,5,0,5,2,5,1,1,3,1,0,0,0,0
S01008862,Very bad health,2,0,0,0,0,2,0,0,0,0,0,0,0,0
S01008863,All people aged 16 to 74,592,186,33,153,198,64,32,15,32,21,6,3,3,38
S01008863,Very good health,383,124,22,102,141,36,22,5,17,6,4,1,3,28
S01008863,Good health,160,50,8,42,47,24,6,6,8,8,1,1,0,10
S01008863,Fair health,30,9,3,6,6,2,3,4,4,2,0,0,0,0
S01008863,Bad health,13,2,0,2,3,1,1,0,1,4,1,1,0,0
S01008863,Very bad health,6,1,0,1,1,1,0,0,2,1,0,0,0,0
S01008864,All people aged 16 to 74,778,157,12,145,186,58,28,16,20,13,8,3,5,292
S01008864,Very good health,561,117,11,106,141,29,11,10,11,6,4,2,2,232
S01008864,Good health,172,29,1,28,33,24,15,5,6,3,2,0,2,55
S01008864,Fair health,37,9,0,9,11,5,2,0,2,3,1,0,1,4
S01008864,Bad health,6,1,0,1,1,0,0,1,1,0,1,1,0,1
S01008864,Very bad health,2,1,0,1,0,0,0,0,0,1,0,0,0,0
S01008865,All people aged 16 to 74,666,173,12,161,213,73,26,26,64,20,9,7,2,62
S01008865,Very good health,419,134,8,126,136,40,12,11,36,5,5,3,2,40
S01008865,Good health,204,35,4,31,66,27,9,12,21,10,3,3,0,21
S01008865,Fair health,33,3,0,3,9,4,2,3,5,5,1,1,0,1
S01008865,Bad health,9,1,0,1,1,2,3,0,2,0,0,0,0,0
S01008865,Very bad health,1,0,0,0,1,0,0,0,0,0,0,0,0,0
S01008866,All people aged 16 to 74,670,236,24,212,209,71,47,13,30,17,10,2,8,37
S01008866,Very good health,469,178,22,156,156,39,25,6,20,10,4,1,3,31
S01008866,Good health,160,51,2,49,47,21,15,6,5,4,6,1,5,5
S01008866,Fair health,31,7,0,7,5,10,3,1,3,1,0,0,0,1
S01008866,Bad health,6,0,0,0,1,0,3,0,1,1,0,0,0,0
S01008866,Very bad health,4,0,0,0,0,1,1,0,1,1,0,0,0,0
S01008867,All people aged 16 to 74,640,215,31,184,232,52,60,13,22,10,9,5,4,27
S01008867,Very good health,445,155,25,130,159,35,35,10,14,7,6,3,3,24
S01008867,Good health,154,49,4,45,57,16,17,2,7,1,2,1,1,3
S01008867,Fair health,29,7,1,6,13,1,5,0,1,2,0,0,0,0
S01008867,Bad health,12,4,1,3,3,0,3,1,0,0,1,1,0,0
S01008867,Very bad health,0,0,0,0,0,0,0,0,0,0,0,0,0,0
S01008868,All people aged 16 to 74,716,161,23,138,190,45,38,43,39,37,10,4,6,153
S01008868,Very good health,483,121,15,106,118,24,25,27,23,22,7,4,3,116
S01008868,Good health,192,36,6,30,64,13,10,13,12,13,1,0,1,30
S01008868,Fair health,33,2,1,1,7,7,3,3,2,2,1,0,1,6
S01008868,Bad health,4,1,1,0,1,1,0,0,0,0,1,0,1,0
S01008868,Very bad health,4,1,0,1,0,0,0,0,2,0,0,0,0,1
S01008869,All people aged 16 to 74,860,257,26,231,269,79,54,30,42,28,14,4,10,87
S01008869,Very good health,537,182,23,159,178,42,29,17,20,9,5,0,5,55
S01008869,Good health,254,67,3,64,71,30,18,12,13,10,5,1,4,28
S01008869,Fair health,56,6,0,6,15,5,6,1,7,9,3,2,1,4
S01008869,Bad health,10,1,0,1,5,1,1,0,2,0,0,0,0,0
S01008869,Very bad health,3,1,0,1,0,1,0,0,0,0,1,1,0,0
S01008870,All people aged 16 to 74,638,212,30,182,203,48,54,23,34,13,15,9,6,36
S01008870,Very good health,376,130,19,111,124,26,32,14,17,5,3,2,1,25
S01008870,Good health,191,59,9,50,63,18,15,7,12,4,4,1,3,9
S01008870,Fair health,56,19,1,18,13,3,6,2,3,2,6,5,1,2
S01008870,Bad health,13,2,0,2,3,1,1,0,2,2,2,1,1,0
S01008870,Very bad health,2,2,1,1,0,0,0,0,0,0,0,0,0,0
S01008871,All people aged 16 to 74,933,247,45,202,247,75,55,19,42,23,15,6,9,210
S01008871,Very good health,648,173,27,146,169,43,38,10,20,13,9,5,4,173
S01008871,Good health,227,58,15,43,65,21,13,9,15,7,6,1,5,33
S01008871,Fair health,45,13,2,11,10,8,3,0,6,2,0,0,0,3
S01008871,Bad health,9,1,0,1,3,1,1,0,1,1,0,0,0,1
S01008871,Very bad health,4,2,1,1,0,2,0,0,0,0,0,0,0,0
S01008872,All people aged 16 to 74,743,183,15,168,198,52,43,19,25,23,14,13,1,186
S01008872,Very good health,522,132,12,120,144,38,26,11,11,8,3,2,1,149
S01008872,Good health,183,46,3,43,52,10,14,6,9,10,3,3,0,33
S01008872,Fair health,28,5,0,5,1,2,2,2,3,4,5,5,0,4
S01008872,Bad health,9,0,0,0,1,2,1,0,2,1,2,2,0,0
S01008872,Very bad health,1,0,0,0,0,0,0,0,0,0,1,1,0,0
S01008873,All people aged 16 to 74,533,149,27,122,189,50,50,7,22,12,10,8,2,44
S01008873,Very good health,367,111,15,96,131,35,34,3,7,5,6,5,1,35
S01008873,Good health,136,32,9,23,46,12,12,3,13,7,2,2,0,9
S01008873,Fair health,17,4,1,3,6,2,3,1,0,0,1,0,1,0
S01008873,Bad health,8,1,1,0,5,0,0,0,2,0,0,0,0,0
S01008873,Very bad health,5,1,1,0,1,1,1,0,0,0,1,1,0,0
S01008874,All people aged 16 to 74,702,176,22,154,216,72,43,24,48,32,16,10,6,75
S01008874,Very good health,426,129,17,112,136,37,24,12,23,12,6,3,3,47
S01008874,Good health,214,39,5,34,68,26,13,8,18,9,6,3,3,27
S01008874,Fair health,41,4,0,4,10,7,2,3,7,5,2,2,0,1
S01008874,Bad health,18,4,0,4,1,2,3,1,0,6,1,1,0,0
S01008874,Very bad health,3,0,0,0,1,0,1,0,0,0,1,1,0,0
S01008875,All people aged 16 to 74,662,126,15,111,191,79,38,44,74,26,6,3,3,78
S01008875,Very good health,385,90,10,80,115,48,18,20,34,8,2,0,2,50
S01008875,Good health,215,32,4,28,58,26,16,23,23,12,2,1,1,23
S01008875,Fair health,49,3,1,2,18,4,2,1,10,5,2,2,0,4
S01008875,Bad health,12,1,0,1,0,1,2,0,6,1,0,0,0,1
S01008875,Very bad health,1,0,0,0,0,0,0,0,1,0,0,0,0,0
S01008876,All people aged 16 to 74,392,76,8,68,116,65,33,10,32,13,11,5,6,36
S01008876,Very good health,241,44,3,41,77,30,19,7,20,8,5,2,3,31
S01008876,Good health,110,23,3,20,29,25,11,3,11,1,2,1,1,5
S01008876,Fair health,30,7,2,5,8,8,2,0,0,3,2,1,1,0
S01008876,Bad health,5,1,0,1,0,2,0,0,1,0,1,0,1,0
S01008876,Very bad health,6,1,0,1,2,0,1,0,0,1,1,1,0,0
S01008877,All people aged 16 to 74,402,103,13,90,120,67,25,15,23,11,4,2,2,34
S01008877,Very good health,263,74,6,68,78,39,11,8,13,6,2,1,1,32
S01008877,Good health,111,25,5,20,32,21,10,6,10,3,2,1,1,2
S01008877,Fair health,24,4,2,2,9,6,2,1,0,2,0,0,0,0
S01008877,Bad health,3,0,0,0,1,1,1,0,0,0,0,0,0,0
S01008877,Very bad health,1,0,0,0,0,0,1,0,0,0,0,0,0,0
S01008878,All people aged 16 to 74,639,80,16,64,135,120,58,29,90,64,23,13,10,40
S01008878,Very good health,321,50,10,40,73,67,27,12,35,23,5,3,2,29
S01008878,Good health,226,25,4,21,47,41,25,10,36,23,9,3,6,10
S01008878,Fair health,56,3,1,2,7,11,5,3,12,11,4,2,2,0
S01008878,Bad health,24,0,0,0,4,0,1,4,5,6,3,3,0,1
S01008878,Very bad health,12,2,1,1,4,1,0,0,2,1,2,2,0,0
S01008879,All people aged 16 to 74,611,98,11,87,156,107,46,32,72,55,15,7,8,30
S01008879,Very good health,338,61,8,53,89,63,21,15,33,24,7,1,6,25
S01008879,Good health,203,33,2,31,47,34,20,14,27,19,4,2,2,5
S01008879,Fair health,54,1,0,1,16,9,3,3,11,10,1,1,0,0
S01008879,Bad health,12,3,1,2,3,1,1,0,1,1,2,2,0,0
S01008879,Very bad health,4,0,0,0,1,0,1,0,0,1,1,1,0,0
S01008880,All people aged 16 to 74,445,88,17,71,132,83,24,21,28,20,13,9,4,36
S01008880,Very good health,262,55,9,46,85,47,15,13,12,9,2,1,1,24
S01008880,Good health,133,25,7,18,34,25,6,6,13,6,7,5,2,11
S01008880,Fair health,37,5,1,4,10,11,3,1,1,2,3,2,1,1
S01008880,Bad health,11,2,0,2,3,0,0,1,2,3,0,0,0,0
S01008880,Very bad health,2,1,0,1,0,0,0,0,0,0,1,1,0,0
S01008881,All people aged 16 to 74,395,118,28,90,112,46,37,11,14,19,15,9,6,23
S01008881,Very good health,255,87,18,69,74,27,19,8,7,11,5,2,3,17
S01008881,Good health,104,24,8,16,30,16,11,3,6,4,4,2,2,6
S01008881,Fair health,29,3,0,3,8,3,5,0,1,3,6,5,1,0
S01008881,Bad health,6,3,1,2,0,0,2,0,0,1,0,0,0,0
S01008881,Very bad health,1,1,1,0,0,0,0,0,0,0,0,0,0,0
S01008882,All people aged 16 to 74,764,262,44,218,220,82,44,13,24,16,7,6,1,96
S01008882,Very good health,539,197,36,161,140,48,27,11,15,14,3,2,1,84
S01008882,Good health,181,55,8,47,70,23,15,1,5,1,2,2,0,9
S01008882,Fair health,33,9,0,9,7,8,2,0,3,1,1,1,0,2
S01008882,Bad health,8,1,0,1,3,1,0,1,1,0,0,0,0,1
S01008882,Very bad health,3,0,0,0,0,2,0,0,0,0,1,1,0,0
S01008883,All people aged 16 to 74,589,198,47,151,182,57,53,6,23,9,12,9,3,49
S01008883,Very good health,402,143,32,111,125,33,35,5,11,5,3,1,2,42
S01008883,Good health,148,43,11,32,46,20,15,1,11,3,3,2,1,6
S01008883,Fair health,31,10,3,7,9,3,3,0,1,1,3,3,0,1
S01008883,Bad health,5,1,0,1,2,1,0,0,0,0,1,1,0,0
S01008883,Very bad health,3,1,1,0,0,0,0,0,0,0,2,2,0,0
S01008884,All people aged 16 to 74,462,134,20,114,164,46,34,7,15,5,12,8,4,45
S01008884,Very good health,313,98,13,85,105,28,23,4,8,5,4,2,2,38
S01008884,Good health,115,30,5,25,48,11,10,3,3,0,4,2,2,6
S01008884,Fair health,25,5,1,4,10,5,1,0,1,0,2,2,0,1
S01008884,Bad health,6,0,0,0,1,1,0,0,3,0,1,1,0,0
S01008884,Very bad health,3,1,1,0,0,1,0,0,0,0,1,1,0,0
S01008885,All people aged 16 to 74,596,173,29,144,182,68,54,10,37,6,14,5,9,52
S01008885,Very good health,405,125,20,105,126,41,32,6,21,1,7,3,4,46
S01008885,Good health,164,41,6,35,52,24,18,3,13,2,5,2,3,6
S01008885,Fair health,20,5,1,4,2,2,3,1,2,3,2,0,2,0
S01008885,Bad health,7,2,2,0,2,1,1,0,1,0,0,0,0,0
S01008885,Very bad health,0,0,0,0,0,0,0,0,0,0,0,0,0,0
S01008886,All people aged 16 to 74,637,154,16,138,192,82,39,24,40,14,13,7,6,79
S01008886,Very good health,388,105,8,97,114,47,17,16,20,10,5,4,1,54
S01008886,Good health,190,36,4,32,62,23,17,7,14,2,7,2,5,22
S01008886,Fair health,48,12,3,9,15,8,3,1,5,0,1,1,0,3
S01008886,Bad health,7,1,1,0,1,1,1,0,1,2,0,0,0,0
S01008886,Very bad health,4,0,0,0,0,3,1,0,0,0,0,0,0,0
S01008887,All people aged 16 to 74,546,111,13,98,171,69,33,26,43,33,9,6,3,51
S01008887,Very good health,305,65,6,59,104,36,14,14,20,18,1,0,1,33
S01008887,Good health,187,43,7,36,59,24,11,8,10,14,4,2,2,14
S01008887,Fair health,42,3,0,3,6,7,7,3,9,0,3,3,0,4
S01008887,Bad health,11,0,0,0,2,1,1,1,4,1,1,1,0,0
S01008887,Very bad health,1,0,0,0,0,1,0,0,0,0,0,0,0,0
S01008888,All people aged 16 to 74,511,143,23,120,169,71,27,11,25,10,11,4,7,44
S01008888,Very good health,327,98,14,84,123,41,15,5,12,6,4,2,2,23
S01008888,Good health,152,40,9,31,36,25,10,4,9,3,5,2,3,20
S01008888,Fair health,28,4,0,4,10,4,2,2,2,1,2,0,2,1
S01008888,Bad health,4,1,0,1,0,1,0,0,2,0,0,0,0,0
S01008888,Very bad health,0,0,0,0,0,0,0,0,0,0,0,0,0,0
S01008889,All people aged 16 to 74,417,82,16,66,119,57,39,24,32,27,13,7,6,24
S01008889,Very good health,249,60,8,52,79,24,23,12,19,9,3,0,3,20
S01008889,Good health,127,16,7,9,32,25,13,9,9,13,6,4,2,4
S01008889,Fair health,32,3,0,3,7,7,3,2,4,3,3,2,1,0
S01008889,Bad health,7,3,1,2,0,0,0,1,0,2,1,1,0,0
S01008889,Very bad health,2,0,0,0,1,1,0,0,0,0,0,0,0,0
S01008890,All people aged 16 to 74,497,78,7,71,149,89,43,33,31,25,7,3,4,42
S01008890,Very good health,307,60,5,55,97,47,25,18,16,5,2,1,1,37
S01008890,Good health,136,16,2,14,36,26,14,11,10,15,4,1,3,4
S01008890,Fair health,37,1,0,1,14,10,4,1,3,3,1,1,0,0
S01008890,Bad health,13,1,0,1,1,3,0,3,2,2,0,0,0,1
S01008890,Very bad health,4,0,0,0,1,3,0,0,0,0,0,0,0,0
S01008891,All people aged 16 to 74,532,123,22,101,165,83,44,22,41,11,7,5,2,36
S01008891,Very good health,329,90,12,78,96,49,30,8,26,2,1,1,0,27
S01008891,Good health,157,30,8,22,53,24,10,9,14,5,4,3,1,8
S01008891,Fair health,38,3,2,1,14,7,4,3,1,3,2,1,1,1
S01008891,Bad health,8,0,0,0,2,3,0,2,0,1,0,0,0,0
S01008891,Very bad health,0,0,0,0,0,0,0,0,0,0,0,0,0,0
S01008892,All people aged 16 to 74,684,152,27,125,198,103,44,24,68,29,20,10,10,46
S01008892,Very good health,406,104,17,87,117,53,28,15,31,8,9,2,7,41
S01008892,Good health,211,37,8,29,61,35,14,9,29,14,8,6,2,4
S01008892,Fair health,48,9,2,7,16,11,1,0,7,2,1,0,1,1
S01008892,Bad health,16,2,0,2,4,4,1,0,0,5,0,0,0,0
S01008892,Very bad health,3,0,0,0,0,0,0,0,1,0,2,2,0,0
S01008893,All people aged 16 to 74,623,162,22,140,204,71,65,19,30,13,13,11,2,46
S01008893,Very good health,420,115,15,100,148,42,39,9,18,11,3,2,1,35
S01008893,Good health,152,38,6,32,41,24,20,6,8,2,3,3,0,10
S01008893,Fair health,35,8,1,7,11,4,3,3,1,0,5,4,1,0
S01008893,Bad health,14,1,0,1,3,1,3,1,3,0,1,1,0,1
S01008893,Very bad health,2,0,0,0,1,0,0,0,0,0,1,1,0,0
S01008894,All people aged 16 to 74,620,157,25,132,226,63,56,12,36,14,7,4,3,49
S01008894,Very good health,404,103,15,88,149,38,33,9,18,7,2,1,1,45
S01008894,Good health,166,42,5,37,60,19,20,1,13,4,3,2,1,4
S01008894,Fair health,40,9,5,4,15,5,2,1,4,3,1,0,1,0
S01008894,Bad health,9,2,0,2,2,1,1,1,1,0,1,1,0,0
S01008894,Very bad health,1,1,0,1,0,0,0,0,0,0,0,0,0,0
S01008895,All people aged 16 to 74,483,141,26,115,154,75,40,12,18,9,3,1,2,31
S01008895,Very good health,331,97,14,83,113,45,21,5,10,7,3,1,2,30
S01008895,Good health,114,33,10,23,27,23,17,6,6,1,0,0,0,1
S01008895,Fair health,31,9,1,8,12,4,2,1,2,1,0,0,0,0
S01008895,Bad health,5,2,1,1,1,2,0,0,0,0,0,0,0,0
S01008895,Very bad health,2,0,0,0,1,1,0,0,0,0,0,0,0,0
S01008896,All people aged 16 to 74,374,110,28,82,131,46,17,11,21,3,8,5,3,27
S01008896,Very good health,246,76,15,61,94,22,11,6,8,2,3,2,1,24
S01008896,Good health,101,31,13,18,29,17,3,5,11,1,1,0,1,3
S01008896,Fair health,20,3,0,3,5,5,3,0,2,0,2,1,1,0
S01008896,Bad health,7,0,0,0,3,2,0,0,0,0,2,2,0,0
S01008896,Very bad health,0,0,0,0,0,0,0,0,0,0,0,0,0,0
S01008897,All people aged 16 to 74,462,119,16,103,139,66,38,17,33,9,18,14,4,23
S01008897,Very good health,281,87,8,79,83,37,19,12,17,3,7,5,2,16
S01008897,Good health,149,29,8,21,40,25,18,4,13,4,9,7,2,7
S01008897,Fair health,21,2,0,2,11,1,1,1,2,1,2,2,0,0
S01008897,Bad health,9,1,0,1,4,2,0,0,1,1,0,0,0,0
S01008897,Very bad health,2,0,0,0,1,1,0,0,0,0,0,0,0,0
S01008898,All people aged 16 to 74,598,152,32,120,160,83,67,22,35,14,12,7,5,53
S01008898,Very good health,399,108,23,85,105,51,43,12,15,8,6,4,2,51
S01008898,Good health,154,36,8,28,41,28,20,5,16,3,3,1,2,2
S01008898,Fair health,35,6,0,6,12,4,3,4,2,2,2,1,1,0
S01008898,Bad health,4,1,1,0,2,0,0,0,0,1,0,0,0,0
S01008898,Very bad health,6,1,0,1,0,0,1,1,2,0,1,1,0,0
S01008899,All people aged 16 to 74,590,18,3,15,53,69,39,52,132,139,40,21,19,48
S01008899,Very good health,235,10,3,7,26,27,20,19,40,40,13,5,8,40
S01008899,Good health,210,6,0,6,19,31,12,24,54,50,9,3,6,5
S01008899,Fair health,96,2,0,2,5,8,4,5,24,32,14,9,5,2
S01008899,Bad health,39,0,0,0,2,3,3,4,12,10,4,4,0,1
S01008899,Very bad health,10,0,0,0,1,0,0,0,2,7,0,0,0,0
S01008900,All people aged 16 to 74,713,44,8,36,105,96,41,78,132,131,36,24,12,50
S01008900,Very good health,354,34,5,29,59,53,15,39,67,46,12,6,6,29
S01008900,Good health,214,6,2,4,41,28,14,20,35,45,6,6,0,19
S01008900,Fair health,106,4,1,3,4,12,11,11,21,29,12,9,3,2
S01008900,Bad health,33,0,0,0,1,3,1,6,7,9,6,3,3,0
S01008900,Very bad health,6,0,0,0,0,0,0,2,2,2,0,0,0,0
S01008901,All people aged 16 to 74,601,37,10,27,93,84,47,42,99,113,46,31,15,40
S01008901,Very good health,267,25,7,18,44,41,15,20,35,49,13,8,5,25
S01008901,Good health,203,8,3,5,36,24,17,14,32,43,17,10,7,12
S01008901,Fair health,87,2,0,2,11,8,10,5,22,16,12,9,3,1
S01008901,Bad health,34,1,0,1,2,7,5,3,8,5,1,1,0,2
S01008901,Very bad health,10,1,0,1,0,4,0,0,2,0,3,3,0,0
S01008902,All people aged 16 to 74,753,47,9,38,132,92,39,54,131,127,75,60,15,56
S01008902,Very good health,324,27,5,22,75,45,18,17,49,42,20,15,5,31
S01008902,Good health,282,14,3,11,44,36,18,26,44,48,34,24,10,18
S01008902,Fair health,95,6,1,5,8,8,3,9,25,21,11,11,0,4
S01008902,Bad health,43,0,0,0,3,2,0,2,11,14,8,8,0,3
S01008902,Very bad health,9,0,0,0,2,1,0,0,2,2,2,2,0,0
S01008903,All people aged 16 to 74,697,22,8,14,117,109,39,72,142,130,33,27,6,33
S01008903,Very good health,317,12,7,5,65,50,17,31,59,47,11,9,2,25
S01008903,Good health,241,10,1,9,41,35,15,30,48,40,14,10,4,8
S01008903,Fair health,105,0,0,0,7,18,6,7,29,33,5,5,0,0
S01008903,Bad health,25,0,0,0,4,4,1,4,3,9,0,0,0,0
S01008903,Very bad health,9,0,0,0,0,2,0,0,3,1,3,3,0,0
S01008904,All people aged 16 to 74,780,24,3,21,83,65,41,70,142,157,71,51,20,127
S01008904,Very good health,337,15,0,15,34,24,27,32,63,48,16,10,6,78
S01008904,Good health,269,6,3,3,36,27,4,25,55,47,30,20,10,39
S01008904,Fair health,117,3,0,3,11,10,9,7,13,40,18,16,2,6
S01008904,Bad health,47,0,0,0,1,3,1,4,10,19,5,3,2,4
S01008904,Very bad health,10,0,0,0,1,1,0,2,1,3,2,2,0,0
S01008905,All people aged 16 to 74,815,15,4,11,90,75,33,50,183,186,89,57,32,94
S01008905,Very good health,342,8,2,6,43,36,13,17,73,62,37,23,14,53
S01008905,Good health,265,5,1,4,26,26,11,18,61,59,26,15,11,33
S01008905,Fair health,144,2,1,1,18,8,5,8,41,36,21,14,7,5
S01008905,Bad health,54,0,0,0,3,5,3,7,7,24,2,2,0,3
S01008905,Very bad health,10,0,0,0,0,0,1,0,1,5,3,3,0,0
S01008906,All people aged 16 to 74,608,19,4,15,65,63,32,56,138,110,55,27,28,70
S01008906,Very good health,222,7,1,6,31,23,13,17,47,27,15,8,7,42
S01008906,Good health,234,10,3,7,24,29,9,26,52,46,17,6,11,21
S01008906,Fair health,101,1,0,1,7,7,7,8,28,21,19,10,9,3
S01008906,Bad health,41,1,0,1,2,4,1,4,9,14,2,1,1,4
S01008906,Very bad health,10,0,0,0,1,0,2,1,2,2,2,2,0,0
S01008907,All people aged 16 to 74,410,8,1,7,28,23,17,35,86,105,58,47,11,50
S01008907,Very good health,179,2,0,2,13,7,7,17,40,38,24,18,6,31
S01008907,Good health,129,1,0,1,9,8,7,10,28,32,20,15,5,14
S01008907,Fair health,61,2,0,2,4,4,2,5,10,25,5,5,0,4
S01008907,Bad health,30,2,1,1,1,3,1,1,6,7,8,8,0,1
S01008907,Very bad health,11,1,0,1,1,1,0,2,2,3,1,1,0,0
S01008908,All people aged 16 to 74,681,45,7,38,93,94,51,64,85,117,74,53,21,58
S01008908,Very good health,298,33,4,29,53,44,14,17,31,45,24,15,9,37
S01008908,Good health,239,8,2,6,31,31,26,30,33,37,29,20,9,14
S01008908,Fair health,94,3,0,3,6,13,10,8,12,23,12,9,3,7
S01008908,Bad health,33,1,1,0,3,2,1,7,6,9,4,4,0,0
S01008908,Very bad health,17,0,0,0,0,4,0,2,3,3,5,5,0,0
S01008909,All people aged 16 to 74,610,27,5,22,89,91,32,64,118,120,30,11,19,39
S01008909,Very good health,306,19,3,16,47,46,18,30,48,53,14,6,8,31
S01008909,Good health,224,7,2,5,31,36,12,20,52,46,13,4,9,7
S01008909,Fair health,60,0,0,0,8,8,1,13,10,17,2,1,1,1
S01008909,Bad health,12,1,0,1,2,0,1,0,6,2,0,0,0,0
S01008909,Very bad health,8,0,0,0,1,1,0,1,2,2,1,0,1,0
S01008910,All people aged 16 to 74,349,29,3,26,68,52,26,28,50,54,12,8,4,30
S01008910,Very good health,160,18,2,16,37,24,12,10,17,20,4,2,2,18
S01008910,Good health,131,9,1,8,22,19,11,12,21,21,4,3,1,12
S01008910,Fair health,44,2,0,2,7,8,3,3,9,9,3,2,1,0
S01008910,Bad health,10,0,0,0,2,1,0,1,3,2,1,1,0,0
S01008910,Very bad health,4,0,0,0,0,0,0,2,0,2,0,0,0,0
S01008911,All people aged 16 to 74,728,158,21,137,204,89,55,34,65,47,17,6,11,59
S01008911,Very good health,492,119,18,101,143,64,34,25,28,25,12,5,7,42
S01008911,Good health,185,32,3,29,54,17,17,6,25,17,3,0,3,14
S01008911,Fair health,36,5,0,5,5,6,4,3,8,1,1,0,1,3
S01008911,Bad health,11,1,0,1,2,1,0,0,3,3,1,1,0,0
S01008911,Very bad health,4,1,0,1,0,1,0,0,1,1,0,0,0,0
S01008912,All people aged 16 to 74,592,93,10,83,164,97,47,42,64,40,13,6,7,32
S01008912,Very good health,318,60,5,55,102,42,23,22,21,19,5,2,3,24
S01008912,Good health,204,29,5,24,53,36,17,12,32,11,6,2,4,8
S01008912,Fair health,46,3,0,3,6,14,5,7,6,4,1,1,0,0
S01008912,Bad health,18,1,0,1,1,5,1,1,3,6,0,0,0,0
S01008912,Very bad health,6,0,0,0,2,0,1,0,2,0,1,1,0,0
S01008913,All people aged 16 to 74,494,86,8,78,105,70,35,34,62,44,16,9,7,42
S01008913,Very good health,303,73,7,66,67,42,17,19,32,15,12,8,4,26
S01008913,Good health,148,10,1,9,31,20,14,12,23,21,3,0,3,14
S01008913,Fair health,30,1,0,1,5,6,4,2,4,6,0,0,0,2
S01008913,Bad health,11,2,0,2,2,1,0,1,2,2,1,1,0,0
S01008913,Very bad health,2,0,0,0,0,1,0,0,1,0,0,0,0,0
S01008914,All people aged 16 to 74,630,44,7,37,119,110,46,48,100,102,17,13,4,44
S01008914,Very good health,305,32,4,28,64,53,23,17,43,42,3,1,2,28
S01008914,Good health,201,11,2,9,43,40,17,17,32,29,4,2,2,8
S01008914,Fair health,82,1,1,0,9,11,5,9,18,19,4,4,0,6
S01008914,Bad health,27,0,0,0,2,2,0,4,6,9,3,3,0,1
S01008914,Very bad health,15,0,0,0,1,4,1,1,1,3,3,3,0,1
S01008915,All people aged 16 to 74,411,52,8,44,113,57,35,19,56,24,10,6,4,45
S01008915,Very good health,237,39,5,34,62,36,16,6,27,8,7,5,2,36
S01008915,Good health,128,10,3,7,44,17,12,6,23,6,3,1,2,7
S01008915,Fair health,33,3,0,3,3,3,5,5,5,8,0,0,0,1
S01008915,Bad health,11,0,0,0,4,1,1,1,1,2,0,0,0,1
S01008915,Very bad health,2,0,0,0,0,0,1,1,0,0,0,0,0,0
S01008916,All people aged 16 to 74,778,26,3,23,104,105,43,61,180,153,64,40,24,42
S01008916,Very good health,276,11,2,9,55,42,22,18,44,36,19,9,10,29
S01008916,Good health,276,8,1,7,32,37,11,26,76,54,19,12,7,13
S01008916,Fair health,152,4,0,4,13,18,6,9,41,44,17,12,5,0
S01008916,Bad health,56,2,0,2,4,7,4,6,13,13,7,5,2,0
S01008916,Very bad health,18,1,0,1,0,1,0,2,6,6,2,2,0,0
S01008917,All people aged 16 to 74,532,19,2,17,54,70,29,52,100,117,60,41,19,31
S01008917,Very good health,209,13,2,11,23,27,10,24,34,37,17,11,6,24
S01008917,Good health,180,4,0,4,19,32,12,8,41,40,18,11,7,6
S01008917,Fair health,85,2,0,2,7,4,5,9,18,25,14,9,5,1
S01008917,Bad health,43,0,0,0,3,6,1,9,5,11,8,7,1,0
S01008917,Very bad health,15,0,0,0,2,1,1,2,2,4,3,3,0,0
S01008918,All people aged 16 to 74,415,6,1,5,32,28,27,38,83,103,63,43,20,35
S01008918,Very good health,151,3,1,2,12,13,9,13,25,34,16,8,8,26
S01008918,Good health,149,1,0,1,13,10,13,16,29,36,26,18,8,5
S01008918,Fair health,73,1,0,1,1,3,2,6,20,20,16,13,3,4
S01008918,Bad health,35,1,0,1,6,2,3,2,7,9,5,4,1,0
S01008918,Very bad health,7,0,0,0,0,0,0,1,2,4,0,0,0,0
S01008919,All people aged 16 to 74,393,12,0,12,39,39,15,40,70,76,66,43,23,36
S01008919,Very good health,140,7,0,7,14,12,5,16,27,21,17,12,5,21
S01008919,Good health,134,3,0,3,18,16,5,11,16,27,28,18,10,10
S01008919,Fair health,86,1,0,1,6,10,4,9,17,18,16,9,7,5
S01008919,Bad health,24,0,0,0,0,1,1,4,8,6,4,3,1,0
S01008919,Very bad health,9,1,0,1,1,0,0,0,2,4,1,1,0,0
S01008920,All people aged 16 to 74,936,157,19,138,261,130,68,50,83,58,39,25,14,90
S01008920,Very good health,556,102,12,90,162,66,37,30,46,31,20,13,7,62
S01008920,Good health,286,46,6,40,84,52,25,15,20,14,10,6,4,20
S01008920,Fair health,65,8,1,7,13,8,6,4,10,8,5,3,2,3
S01008920,Bad health,23,1,0,1,2,3,0,1,4,4,3,2,1,5
S01008920,Very bad health,6,0,0,0,0,1,0,0,3,1,1,1,0,0
S01008921,All people aged 16 to 74,543,14,2,12,45,57,28,51,115,121,76,46,30,36
S01008921,Very good health,177,13,2,11,15,17,12,15,32,33,15,5,10,25
S01008921,Good health,203,0,0,0,17,26,6,21,48,40,36,21,15,9
S01008921,Fair health,100,1,0,1,8,9,4,11,22,28,15,11,4,2
S01008921,Bad health,47,0,0,0,5,3,3,3,12,14,7,7,0,0
S01008921,Very bad health,16,0,0,0,0,2,3,1,1,6,3,2,1,0
S01008922,All people aged 16 to 74,587,22,6,16,75,86,42,50,123,98,54,35,19,37
S01008922,Very good health,250,13,4,9,40,29,15,19,48,33,25,17,8,28
S01008922,Good health,204,6,2,4,25,39,17,17,44,33,17,9,8,6
S01008922,Fair health,85,2,0,2,6,10,5,11,21,18,9,6,3,3
S01008922,Bad health,34,1,0,1,1,5,4,2,9,11,1,1,0,0
S01008922,Very bad health,14,0,0,0,3,3,1,1,1,3,2,2,0,0
S01008923,All people aged 16 to 74,544,19,2,17,64,80,40,43,109,116,40,22,18,33
S01008923,Very good health,240,9,0,9,29,36,18,21,48,46,12,6,6,21
S01008923,Good health,177,8,1,7,20,30,11,10,41,37,11,7,4,9
S01008923,Fair health,94,2,1,1,13,11,6,9,14,23,13,6,7,3
S01008923,Bad health,24,0,0,0,2,1,5,2,5,6,3,2,1,0
S01008923,Very bad health,9,0,0,0,0,2,0,1,1,4,1,1,0,0
S01008924,All people aged 16 to 74,675,17,7,10,52,70,36,57,150,141,81,47,34,71
S01008924,Very good health,279,8,3,5,28,34,14,17,49,42,34,17,17,53
S01008924,Good health,241,5,3,2,18,20,14,29,64,54,22,12,10,15
S01008924,Fair health,101,3,1,2,4,11,5,9,22,29,16,9,7,2
S01008924,Bad health,44,1,0,1,2,5,3,2,10,13,7,7,0,1
S01008924,Very bad health,10,0,0,0,0,0,0,0,5,3,2,2,0,0
S01008925,All people aged 16 to 74,496,11,1,10,75,75,34,52,84,90,32,17,15,43
S01008925,Very good health,219,3,0,3,41,37,9,21,35,33,12,6,6,28
S01008925,Good health,189,6,0,6,27,30,15,25,33,36,9,3,6,8
S01008925,Fair health,56,1,1,0,7,7,3,4,12,12,6,3,3,4
S01008925,Bad health,26,0,0,0,0,1,7,1,3,7,4,4,0,3
S01008925,Very bad health,6,1,0,1,0,0,0,1,1,2,1,1,0,0
S01008926,All people aged 16 to 74,462,27,3,24,68,92,33,35,83,76,25,18,7,23
S01008926,Very good health,239,12,1,11,35,65,19,13,39,33,10,6,4,13
S01008926,Good health,157,13,2,11,23,20,10,16,29,31,5,3,2,10
S01008926,Fair health,46,1,0,1,7,4,3,5,11,9,6,5,1,0
S01008926,Bad health,18,1,0,1,3,3,1,1,4,1,4,4,0,0
S01008926,Very bad health,2,0,0,0,0,0,0,0,0,2,0,0,0,0
S01008927,All people aged 16 to 74,651,54,11,43,139,120,30,45,90,97,22,14,8,54
S01008927,Very good health,360,33,6,27,95,62,13,17,52,51,5,5,0,32
S01008927,Good health,217,15,3,12,37,51,14,19,24,28,12,5,7,17
S01008927,Fair health,51,4,1,3,1,6,2,5,8,15,5,4,1,5
S01008927,Bad health,13,1,1,0,4,0,1,3,2,2,0,0,0,0
S01008927,Very bad health,10,1,0,1,2,1,0,1,4,1,0,0,0,0
S01008928,All people aged 16 to 74,545,45,7,38,90,50,29,48,81,87,24,9,15,91
S01008928,Very good health,277,35,3,32,59,23,14,20,29,30,10,2,8,57
S01008928,Good health,150,6,3,3,17,15,8,19,24,25,6,3,3,30
S01008928,Fair health,72,2,1,1,8,8,5,5,15,19,6,2,4,4
S01008928,Bad health,37,2,0,2,4,4,1,3,11,12,0,0,0,0
S01008928,Very bad health,9,0,0,0,2,0,1,1,2,1,2,2,0,0
S01008929,All people aged 16 to 74,611,10,2,8,45,36,20,46,130,152,125,73,52,47
S01008929,Very good health,189,2,1,1,17,12,4,12,45,34,41,28,13,22
S01008929,Good health,214,2,1,1,15,16,7,17,44,51,41,17,24,21
S01008929,Fair health,124,3,0,3,6,4,6,12,22,39,29,18,11,3
S01008929,Bad health,60,0,0,0,5,3,3,3,13,22,11,8,3,0
S01008929,Very bad health,24,3,0,3,2,1,0,2,6,6,3,2,1,1
S01008930,All people aged 16 to 74,634,13,1,12,48,52,27,54,134,174,85,50,35,47
S01008930,Very good health,242,8,1,7,27,26,9,18,58,43,27,20,7,26
S01008930,Good health,207,3,0,3,10,16,7,15,47,66,26,11,15,17
S01008930,Fair health,109,2,0,2,7,8,4,10,19,37,20,10,10,2
S01008930,Bad health,58,0,0,0,3,2,7,8,5,22,9,6,3,2
S01008930,Very bad health,18,0,0,0,1,0,0,3,5,6,3,3,0,0
S01008931,All people aged 16 to 74,547,1,0,1,62,53,20,39,123,141,63,45,18,45
S01008931,Very good health,240,0,0,0,32,22,7,15,54,54,20,15,5,36
S01008931,Good health,173,1,0,1,20,15,3,12,45,43,25,17,8,9
S01008931,Fair health,89,0,0,0,7,13,7,8,18,23,13,8,5,0
S01008931,Bad health,41,0,0,0,3,3,2,4,3,21,5,5,0,0
S01008931,Very bad health,4,0,0,0,0,0,1,0,3,0,0,0,0,0
S01008932,All people aged 16 to 74,662,61,8,53,123,96,40,59,109,73,36,27,9,65
S01008932,Very good health,374,44,6,38,84,53,19,28,51,36,13,10,3,46
S01008932,Good health,197,14,0,14,31,33,11,18,44,18,11,6,5,17
S01008932,Fair health,66,3,2,1,4,9,7,10,12,12,7,6,1,2
S01008932,Bad health,20,0,0,0,3,1,1,3,2,5,5,5,0,0
S01008932,Very bad health,5,0,0,0,1,0,2,0,0,2,0,0,0,0
S01008933,All people aged 16 to 74,491,16,2,14,48,51,18,41,88,111,75,44,31,43
S01008933,Very good health,219,10,1,9,23,22,12,19,37,41,25,13,12,30
S01008933,Good health,155,3,1,2,19,20,5,12,31,36,21,9,12,8
S01008933,Fair health,77,2,0,2,3,6,0,7,15,22,18,14,4,4
S01008933,Bad health,30,1,0,1,3,3,1,2,5,8,6,3,3,1
S01008933,Very bad health,10,0,0,0,0,0,0,1,0,4,5,5,0,0
S01008934,All people aged 16 to 74,567,37,6,31,83,58,36,36,110,107,53,40,13,47
S01008934,Very good health,264,20,3,17,43,33,14,14,46,43,21,18,3,30
S01008934,Good health,201,14,3,11,32,16,10,13,42,39,22,13,9,13
S01008934,Fair health,67,3,0,3,6,5,9,5,15,14,7,7,0,3
S01008934,Bad health,27,0,0,0,2,3,3,2,6,8,2,1,1,1
S01008934,Very bad health,8,0,0,0,0,1,0,2,1,3,1,1,0,0
S01008935,All people aged 16 to 74,613,76,15,61,158,128,35,41,65,47,17,8,9,46
S01008935,Very good health,347,50,9,41,92,62,18,22,37,27,7,2,5,32
S01008935,Good health,200,23,6,17,51,48,13,13,21,14,4,3,1,13
S01008935,Fair health,53,3,0,3,12,15,2,5,5,5,5,2,3,1
S01008935,Bad health,8,0,0,0,1,2,1,1,2,1,0,0,0,0
S01008935,Very bad health,5,0,0,0,2,1,1,0,0,0,1,1,0,0
S01008936,All people aged 16 to 74,269,64,12,52,87,38,29,14,15,3,2,1,1,17
S01008936,Very good health,160,45,7,38,50,21,12,9,3,3,2,1,1,15
S01008936,Good health,85,16,4,12,29,12,14,5,7,0,0,0,0,2
S01008936,Fair health,22,3,1,2,7,4,3,0,5,0,0,0,0,0
S01008936,Bad health,2,0,0,0,1,1,0,0,0,0,0,0,0,0
S01008936,Very bad health,0,0,0,0,0,0,0,0,0,0,0,0,0,0
S01008937,All people aged 16 to 74,599,80,13,67,165,112,44,40,59,43,16,10,6,40
S01008937,Very good health,311,50,10,40,96,55,21,16,23,16,8,6,2,26
S01008937,Good health,204,24,3,21,47,42,13,17,28,19,3,1,2,11
S01008937,Fair health,57,4,0,4,13,14,7,4,4,4,4,2,2,3
S01008937,Bad health,19,2,0,2,5,1,3,3,3,2,0,0,0,0
S01008937,Very bad health,8,0,0,0,4,0,0,0,1,2,1,1,0,0
S01008938,All people aged 16 to 74,478,77,7,70,136,76,45,28,45,19,6,3,3,46
S01008938,Very good health,296,57,6,51,85,42,24,15,24,11,3,0,3,35
S01008938,Good health,143,16,1,15,40,24,18,11,17,5,1,1,0,11
S01008938,Fair health,31,3,0,3,8,9,3,1,3,3,1,1,0,0
S01008938,Bad health,7,1,0,1,3,1,0,0,1,0,1,1,0,0
S01008938,Very bad health,1,0,0,0,0,0,0,1,0,0,0,0,0,0
S01008939,All people aged 16 to 74,548,63,13,50,138,112,52,34,54,23,12,4,8,60
S01008939,Very good health,291,37,9,28,81,47,21,12,30,9,5,3,2,49
S01008939,Good health,186,21,2,19,46,49,19,11,17,9,5,0,5,9
S01008939,Fair health,49,4,2,2,9,11,7,8,4,3,2,1,1,1
S01008939,Bad health,18,1,0,1,2,4,4,3,1,2,0,0,0,1
S01008939,Very bad health,4,0,0,0,0,1,1,0,2,0,0,0,0,0
S01008940,All people aged 16 to 74,417,116,19,97,143,56,29,8,17,9,10,7,3,29
S01008940,Very good health,253,78,11,67,87,26,17,4,8,5,5,4,1,23
S01008940,Good health,129,28,5,23,52,22,9,2,8,1,3,1,2,4
S01008940,Fair health,29,9,2,7,3,6,3,2,0,2,2,2,0,2
S01008940,Bad health,4,1,1,0,1,1,0,0,1,0,0,0,0,0
S01008940,Very bad health,2,0,0,0,0,1,0,0,0,1,0,0,0,0
S01008941,All people aged 16 to 74,564,166,30,136,191,64,51,12,32,13,4,1,3,31
S01008941,Very good health,372,114,20,94,141,34,21,5,22,5,4,1,3,26
S01008941,Good health,156,41,6,35,41,24,27,5,9,4,0,0,0,5
S01008941,Fair health,24,8,2,6,6,5,2,1,0,2,0,0,0,0
S01008941,Bad health,8,2,1,1,3,0,1,1,0,1,0,0,0,0
S01008941,Very bad health,4,1,1,0,0,1,0,0,1,1,0,0,0,0
S01008942,All people aged 16 to 74,508,112,15,97,151,88,42,16,34,13,12,5,7,40
S01008942,Very good health,301,77,12,65,86,48,14,8,15,8,8,4,4,37
S01008942,Good health,161,30,2,28,51,32,18,6,14,4,3,0,3,3
S01008942,Fair health,34,5,1,4,10,5,8,1,4,0,1,1,0,0
S01008942,Bad health,12,0,0,0,4,3,2,1,1,1,0,0,0,0
S01008942,Very bad health,0,0,0,0,0,0,0,0,0,0,0,0,0,0
S01008943,All people aged 16 to 74,592,154,33,121,187,79,54,10,34,9,17,6,11,48
S01008943,Very good health,369,99,20,79,115,47,28,5,19,4,10,1,9,42
S01008943,Good health,181,49,10,39,60,26,20,1,11,3,6,4,2,5
S01008943,Fair health,35,5,3,2,10,5,5,4,3,2,0,0,0,1
S01008943,Bad health,5,1,0,1,1,1,0,0,1,0,1,1,0,0
S01008943,Very bad health,2,0,0,0,1,0,1,0,0,0,0,0,0,0
S01008944,All people aged 16 to 74,686,177,36,141,217,94,70,19,32,15,11,7,4,51
S01008944,Very good health,448,121,25,96,146,56,40,17,13,10,4,2,2,41
S01008944,Good health,184,43,9,34,57,26,26,1,14,3,6,4,2,8
S01008944,Fair health,45,12,2,10,11,11,2,1,5,0,1,1,0,2
S01008944,Bad health,7,1,0,1,2,1,1,0,0,2,0,0,0,0
S01008944,Very bad health,2,0,0,0,1,0,1,0,0,0,0,0,0,0
S01008945,All people aged 16 to 74,558,141,26,115,191,70,57,14,27,13,10,6,4,35
S01008945,Very good health,333,97,19,78,107,36,30,7,15,10,6,2,4,25
S01008945,Good health,167,35,5,30,67,23,19,5,8,1,1,1,0,8
S01008945,Fair health,42,5,1,4,16,7,6,1,2,2,1,1,0,2
S01008945,Bad health,9,3,1,2,0,2,2,1,1,0,0,0,0,0
S01008945,Very bad health,7,1,0,1,1,2,0,0,1,0,2,2,0,0
S01008946,All people aged 16 to 74,636,156,26,130,204,75,62,22,44,16,14,7,7,43
S01008946,Very good health,376,101,16,85,122,43,27,9,20,10,7,3,4,37
S01008946,Good health,193,46,9,37,52,28,29,11,15,2,6,4,2,4
S01008946,Fair health,51,7,0,7,24,4,5,2,5,1,1,0,1,2
S01008946,Bad health,13,1,1,0,5,0,1,0,4,2,0,0,0,0
S01008946,Very bad health,3,1,0,1,1,0,0,0,0,1,0,0,0,0
S01008947,All people aged 16 to 74,681,172,28,144,204,89,53,27,46,14,18,13,5,58
S01008947,Very good health,416,105,18,87,123,52,29,15,29,7,8,6,2,48
S01008947,Good health,201,52,10,42,70,25,17,10,14,3,2,2,0,8
S01008947,Fair health,54,12,0,12,9,11,6,2,2,3,7,4,3,2
S01008947,Bad health,6,3,0,3,1,1,1,0,0,0,0,0,0,0
S01008947,Very bad health,4,0,0,0,1,0,0,0,1,1,1,1,0,0
S01008948,All people aged 16 to 74,524,107,23,84,144,78,55,28,33,25,12,8,4,42
S01008948,Very good health,317,72,16,56,87,42,30,16,16,16,4,4,0,34
S01008948,Good health,162,29,4,25,46,28,23,7,13,5,4,1,3,7
S01008948,Fair health,34,5,2,3,11,6,1,4,1,2,3,2,1,1
S01008948,Bad health,9,1,1,0,0,1,1,1,2,2,1,1,0,0
S01008948,Very bad health,2,0,0,0,0,1,0,0,1,0,0,0,0,0
S01008949,All people aged 16 to 74,653,38,10,28,131,122,44,48,109,91,21,17,4,49
S01008949,Very good health,317,21,6,15,73,56,19,20,46,37,8,6,2,37
S01008949,Good health,221,16,4,12,41,49,19,18,34,26,7,5,2,11
S01008949,Fair health,81,0,0,0,14,10,5,6,22,20,3,3,0,1
S01008949,Bad health,17,1,0,1,0,5,0,1,3,4,3,3,0,0
S01008949,Very bad health,17,0,0,0,3,2,1,3,4,4,0,0,0,0
S01008950,All people aged 16 to 74,651,48,9,39,128,99,51,37,127,75,27,17,10,59
S01008950,Very good health,337,29,6,23,83,47,18,22,60,25,11,7,4,42
S01008950,Good health,211,13,2,11,36,35,24,7,47,28,8,4,4,13
S01008950,Fair health,74,6,1,5,4,11,7,3,14,20,5,4,1,4
S01008950,Bad health,22,0,0,0,3,6,2,3,3,2,3,2,1,0
S01008950,Very bad health,7,0,0,0,2,0,0,2,3,0,0,0,0,0
S01008951,All people aged 16 to 74,623,34,10,24,103,100,27,64,116,101,42,30,12,36
S01008951,Very good health,289,20,5,15,62,50,14,28,45,32,10,8,2,28
S01008951,Good health,210,13,4,9,25,27,7,24,42,48,16,12,4,8
S01008951,Fair health,79,0,0,0,10,17,5,5,18,13,11,5,6,0
S01008951,Bad health,35,1,1,0,6,3,1,5,8,7,4,4,0,0
S01008951,Very bad health,10,0,0,0,0,3,0,2,3,1,1,1,0,0
S01008952,All people aged 16 to 74,609,29,4,25,77,93,37,42,147,108,48,31,17,28
S01008952,Very good health,258,16,1,15,40,36,17,18,63,39,15,10,5,14
S01008952,Good health,218,8,2,6,26,36,14,17,60,31,17,12,5,9
S01008952,Fair health,85,3,1,2,6,14,4,3,18,22,11,5,6,4
S01008952,Bad health,37,2,0,2,4,7,2,3,6,10,2,2,0,1
S01008952,Very bad health,11,0,0,0,1,0,0,1,0,6,3,2,1,0
S01008953,All people aged 16 to 74,624,39,8,31,111,91,46,45,114,99,41,29,12,38
S01008953,Very good health,287,26,5,21,55,47,26,16,45,29,15,8,7,28
S01008953,Good health,216,10,2,8,32,34,14,21,41,42,12,8,4,10
S01008953,Fair health,71,0,0,0,13,3,5,4,22,16,8,7,1,0
S01008953,Bad health,39,3,1,2,8,6,0,2,5,10,5,5,0,0
S01008953,Very bad health,11,0,0,0,3,1,1,2,1,2,1,1,0,0
S01008954,All people aged 16 to 74,577,42,7,35,105,79,42,47,104,83,38,23,15,37
S01008954,Very good health,270,25,4,21,58,35,17,17,46,31,15,11,4,26
S01008954,Good health,196,14,3,11,37,31,17,18,32,30,8,2,6,9
S01008954,Fair health,69,3,0,3,6,7,5,7,15,13,12,7,5,1
S01008954,Bad health,31,0,0,0,3,4,2,3,10,7,1,1,0,1
S01008954,Very bad health,11,0,0,0,1,2,1,2,1,2,2,2,0,0
S01008955,All people aged 16 to 74,476,78,20,58,125,76,44,23,50,29,11,9,2,40
S01008955,Very good health,284,48,12,36,79,48,13,12,25,21,6,4,2,32
S01008955,Good health,148,23,7,16,37,26,21,7,23,4,1,1,0,6
S01008955,Fair health,35,6,1,5,6,2,8,4,2,2,3,3,0,2
S01008955,Bad health,9,1,0,1,3,0,2,0,0,2,1,1,0,0
S01008955,Very bad health,0,0,0,0,0,0,0,0,0,0,0,0,0,0
S01008956,All people aged 16 to 74,692,90,18,72,170,137,41,44,95,53,16,8,8,46
S01008956,Very good health,389,55,15,40,98,70,22,26,43,27,10,6,4,38
S01008956,Good health,231,27,2,25,59,52,16,11,36,21,3,2,1,6
S01008956,Fair health,56,7,1,6,10,12,1,7,12,2,3,0,3,2
S01008956,Bad health,10,0,0,0,3,1,2,0,2,2,0,0,0,0
S01008956,Very bad health,6,1,0,1,0,2,0,0,2,1,0,0,0,0
S01008957,All people aged 16 to 74,738,87,16,71,183,128,49,46,102,57,35,25,10,51
S01008957,Very good health,383,51,10,41,104,72,25,13,44,18,13,10,3,43
S01008957,Good health,247,28,3,25,61,44,16,22,34,26,10,5,5,6
S01008957,Fair health,71,7,3,4,12,9,7,5,14,7,8,6,2,2
S01008957,Bad health,30,1,0,1,6,3,0,5,9,3,3,3,0,0
S01008957,Very bad health,7,0,0,0,0,0,1,1,1,3,1,1,0,0
S01008958,All people aged 16 to 74,516,46,3,43,123,98,31,30,69,54,33,30,3,32
S01008958,Very good health,255,31,2,29,69,55,17,9,33,15,5,5,0,21
S01008958,Good health,171,13,1,12,44,25,9,17,26,15,16,13,3,6
S01008958,Fair health,57,2,0,2,6,10,4,2,7,16,7,7,0,3
S01008958,Bad health,18,0,0,0,1,4,0,2,1,6,2,2,0,2
S01008958,Very bad health,15,0,0,0,3,4,1,0,2,2,3,3,0,0
S01008959,All people aged 16 to 74,652,54,7,47,145,145,42,47,94,66,19,15,4,40
S01008959,Very good health,330,35,5,30,76,66,20,19,47,29,5,3,2,33
S01008959,Good health,224,15,2,13,62,54,14,20,25,25,4,3,1,5
S01008959,Fair health,64,4,0,4,7,10,5,5,19,8,4,3,1,2
S01008959,Bad health,24,0,0,0,0,11,2,3,1,3,4,4,0,0
S01008959,Very bad health,10,0,0,0,0,4,1,0,2,1,2,2,0,0
S01008960,All people aged 16 to 74,661,174,30,144,211,77,47,23,47,14,11,7,4,57
S01008960,Very good health,454,122,17,105,158,52,25,18,23,10,3,1,2,43
S01008960,Good health,173,49,13,36,43,19,19,3,22,3,3,1,2,12
S01008960,Fair health,25,3,0,3,8,6,3,0,0,1,4,4,0,0
S01008960,Bad health,8,0,0,0,2,0,0,1,2,0,1,1,0,2
S01008960,Very bad health,1,0,0,0,0,0,0,1,0,0,0,0,0,0
S01008961,All people aged 16 to 74,570,81,9,72,151,106,43,25,63,34,18,14,4,49
S01008961,Very good health,318,49,7,42,93,47,22,14,28,20,7,5,2,38
S01008961,Good health,189,25,2,23,48,46,15,6,26,11,5,4,1,7
S01008961,Fair health,50,6,0,6,8,10,3,4,8,3,4,3,1,4
S01008961,Bad health,9,1,0,1,2,3,2,0,0,0,1,1,0,0
S01008961,Very bad health,4,0,0,0,0,0,1,1,1,0,1,1,0,0
S01008962,All people aged 16 to 74,481,74,15,59,143,100,34,22,47,28,8,3,5,25
S01008962,Very good health,271,46,9,37,80,64,13,9,18,14,4,0,4,23
S01008962,Good health,151,21,5,16,44,25,16,10,22,10,2,1,1,1
S01008962,Fair health,41,5,1,4,13,11,3,1,3,2,2,2,0,1
S01008962,Bad health,13,0,0,0,5,0,2,2,3,1,0,0,0,0
S01008962,Very bad health,5,2,0,2,1,0,0,0,1,1,0,0,0,0
S01008963,All people aged 16 to 74,571,83,19,64,187,109,41,34,48,21,10,8,2,38
S01008963,Very good health,334,47,10,37,113,63,24,23,18,7,7,7,0,32
S01008963,Good health,177,31,8,23,51,35,12,6,22,12,2,1,1,6
S01008963,Fair health,43,4,1,3,17,9,4,3,6,0,0,0,0,0
S01008963,Bad health,11,1,0,1,4,2,1,0,1,1,1,0,1,0
S01008963,Very bad health,6,0,0,0,2,0,0,2,1,1,0,0,0,0
S01008964,All people aged 16 to 74,353,78,17,61,85,65,24,18,30,9,5,3,2,39
S01008964,Very good health,226,55,9,46,56,35,12,11,17,5,1,0,1,34
S01008964,Good health,93,21,7,14,21,25,7,2,7,4,3,2,1,3
S01008964,Fair health,30,2,1,1,6,5,3,5,6,0,1,1,0,2
S01008964,Bad health,4,0,0,0,2,0,2,0,0,0,0,0,0,0
S01008964,Very bad health,0,0,0,0,0,0,0,0,0,0,0,0,0,0
S01008965,All people aged 16 to 74,516,106,16,90,158,85,46,25,33,24,8,7,1,31
S01008965,Very good health,311,68,9,59,99,43,29,13,24,9,2,1,1,24
S01008965,Good health,151,33,7,26,48,27,14,4,5,11,2,2,0,7
S01008965,Fair health,43,4,0,4,8,12,3,5,4,4,3,3,0,0
S01008965,Bad health,11,1,0,1,3,3,0,3,0,0,1,1,0,0
S01008965,Very bad health,0,0,0,0,0,0,0,0,0,0,0,0,0,0
S01008966,All people aged 16 to 74,411,60,9,51,109,97,29,23,34,18,7,5,2,34
S01008966,Very good health,249,36,6,30,69,59,14,14,20,10,4,2,2,23
S01008966,Good health,127,19,3,16,31,32,11,7,13,4,1,1,0,9
S01008966,Fair health,28,4,0,4,7,5,4,0,1,3,2,2,0,2
S01008966,Bad health,7,1,0,1,2,1,0,2,0,1,0,0,0,0
S01008966,Very bad health,0,0,0,0,0,0,0,0,0,0,0,0,0,0
S01008967,All people aged 16 to 74,711,138,17,121,226,118,52,33,62,31,17,13,4,34
S01008967,Very good health,416,87,9,78,136,77,30,16,27,11,3,2,1,29
S01008967,Good health,242,42,7,35,80,31,17,15,26,17,9,7,2,5
S01008967,Fair health,39,4,0,4,10,8,3,2,7,2,3,2,1,0
S01008967,Bad health,11,4,1,3,0,2,2,0,2,0,1,1,0,0
S01008967,Very bad health,3,1,0,1,0,0,0,0,0,1,1,1,0,0
S01008968,All people aged 16 to 74,707,146,25,121,196,133,61,28,51,20,14,6,8,58
S01008968,Very good health,445,98,17,81,136,66,31,16,30,12,4,0,4,52
S01008968,Good health,204,38,8,30,51,53,23,8,16,6,4,2,2,5
S01008968,Fair health,47,9,0,9,7,12,6,3,3,2,4,2,2,1
S01008968,Bad health,11,1,0,1,2,2,1,1,2,0,2,2,0,0
S01008968,Very bad health,0,0,0,0,0,0,0,0,0,0,0,0,0,0
S01008969,All people aged 16 to 74,766,132,19,113,202,142,47,53,75,57,15,9,6,43
S01008969,Very good health,424,84,11,73,122,76,23,24,32,22,7,3,4,34
S01008969,Good health,252,42,5,37,62,50,19,18,31,20,2,2,0,8
S01008969,Fair health,68,5,2,3,13,10,5,9,9,11,5,3,2,1
S01008969,Bad health,19,0,0,0,4,6,0,2,3,3,1,1,0,0
S01008969,Very bad health,3,1,1,0,1,0,0,0,0,1,0,0,0,0
S01008970,All people aged 16 to 74,752,173,22,151,257,106,51,21,57,23,16,15,1,48
S01008970,Very good health,486,125,16,109,165,57,30,13,35,13,7,7,0,41
S01008970,Good health,206,36,4,32,77,36,18,7,14,6,5,5,0,7
S01008970,Fair health,43,9,2,7,9,10,2,1,7,3,2,1,1,0
S01008970,Bad health,15,3,0,3,5,3,1,0,1,0,2,2,0,0
S01008970,Very bad health,2,0,0,0,1,0,0,0,0,1,0,0,0,0
S01008971,All people aged 16 to 74,522,143,20,123,180,68,35,16,30,9,6,1,5,35
S01008971,Very good health,321,100,14,86,112,39,15,7,18,5,3,0,3,22
S01008971,Good health,159,35,6,29,56,23,13,4,12,3,1,0,1,12
S01008971,Fair health,37,8,0,8,10,3,7,5,0,1,2,1,1,1
S01008971,Bad health,4,0,0,0,2,2,0,0,0,0,0,0,0,0
S01008971,Very bad health,1,0,0,0,0,1,0,0,0,0,0,0,0,0
S01008972,All people aged 16 to 74,530,163,25,138,171,76,29,11,20,10,9,7,2,41
S01008972,Very good health,362,115,17,98,108,53,19,9,13,6,2,2,0,37
S01008972,Good health,140,40,8,32,50,20,10,2,6,4,4,2,2,4
S01008972,Fair health,23,6,0,6,11,2,0,0,1,0,3,3,0,0
S01008972,Bad health,5,2,0,2,2,1,0,0,0,0,0,0,0,0
S01008972,Very bad health,0,0,0,0,0,0,0,0,0,0,0,0,0,0
S01008973,All people aged 16 to 74,585,111,19,92,184,97,53,18,36,30,29,24,5,27
S01008973,Very good health,336,78,16,62,120,52,22,9,14,12,7,4,3,22
S01008973,Good health,171,26,3,23,53,35,20,4,14,10,4,2,2,5
S01008973,Fair health,51,4,0,4,8,5,10,3,6,5,10,10,0,0
S01008973,Bad health,22,3,0,3,2,3,1,2,2,2,7,7,0,0
S01008973,Very bad health,5,0,0,0,1,2,0,0,0,1,1,1,0,0
S01008974,All people aged 16 to 74,546,85,17,68,166,95,28,32,57,34,17,10,7,32
S01008974,Very good health,321,56,11,45,95,50,15,22,29,18,9,5,4,27
S01008974,Good health,158,22,4,18,53,34,10,7,16,11,2,0,2,3
S01008974,Fair health,45,7,2,5,11,9,1,2,6,2,5,5,0,2
S01008974,Bad health,21,0,0,0,7,2,2,1,6,2,1,0,1,0
S01008974,Very bad health,1,0,0,0,0,0,0,0,0,1,0,0,0,0
S01008975,All people aged 16 to 74,453,60,4,56,105,77,28,29,62,42,13,7,6,37
S01008975,Very good health,235,40,2,38,68,38,15,11,21,10,7,3,4,25
S01008975,Good health,130,15,1,14,23,24,9,10,24,15,3,2,1,7
S01008975,Fair health,58,4,1,3,7,12,2,6,11,9,2,1,1,5
S01008975,Bad health,23,1,0,1,5,2,2,2,3,7,1,1,0,0
S01008975,Very bad health,7,0,0,0,2,1,0,0,3,1,0,0,0,0
S01008976,All people aged 16 to 74,383,80,11,69,121,57,26,12,31,21,10,6,4,25
S01008976,Very good health,231,54,9,45,83,27,13,7,17,6,4,2,2,20
S01008976,Good health,121,24,2,22,29,24,9,5,10,11,4,2,2,5
S01008976,Fair health,26,2,0,2,6,6,4,0,3,3,2,2,0,0
S01008976,Bad health,4,0,0,0,3,0,0,0,1,0,0,0,0,0
S01008976,Very bad health,1,0,0,0,0,0,0,0,0,1,0,0,0,0
S01008977,All people aged 16 to 74,446,90,23,67,123,102,29,18,28,18,9,6,3,29
S01008977,Very good health,273,59,12,47,79,56,14,11,14,10,4,2,2,26
S01008977,Good health,130,27,11,16,33,35,13,5,10,5,1,0,1,1
S01008977,Fair health,31,3,0,3,6,10,2,2,2,2,2,2,0,2
S01008977,Bad health,11,1,0,1,5,1,0,0,1,1,2,2,0,0
S01008977,Very bad health,1,0,0,0,0,0,0,0,1,0,0,0,0,0
S01008978,All people aged 16 to 74,439,33,7,26,97,93,28,28,73,41,4,2,2,42
S01008978,Very good health,233,14,3,11,56,47,8,14,31,21,4,2,2,38
S01008978,Good health,166,16,4,12,35,36,18,10,33,15,0,0,0,3
S01008978,Fair health,33,3,0,3,6,8,2,3,7,4,0,0,0,0
S01008978,Bad health,7,0,0,0,0,2,0,1,2,1,0,0,0,1
S01008978,Very bad health,0,0,0,0,0,0,0,0,0,0,0,0,0,0
S01008979,All people aged 16 to 74,551,63,8,55,123,105,39,40,60,37,22,15,7,62
S01008979,Very good health,335,33,4,29,86,57,24,20,30,23,12,8,4,50
S01008979,Good health,163,24,4,20,30,37,11,15,20,8,7,4,3,11
S01008979,Fair health,43,3,0,3,7,10,2,4,9,5,2,2,0,1
S01008979,Bad health,6,2,0,2,0,1,1,0,1,1,0,0,0,0
S01008979,Very bad health,4,1,0,1,0,0,1,1,0,0,1,1,0,0
S01008980,All people aged 16 to 74,592,45,4,41,125,110,38,49,84,62,23,15,8,56
S01008980,Very good health,333,31,1,30,69,66,18,30,42,25,5,2,3,47
S01008980,Good health,187,10,2,8,43,31,14,14,32,25,12,9,3,6
S01008980,Fair health,53,3,1,2,11,9,4,5,10,6,4,2,2,1
S01008980,Bad health,15,1,0,1,2,3,2,0,0,5,0,0,0,2
S01008980,Very bad health,4,0,0,0,0,1,0,0,0,1,2,2,0,0
S01008981,All people aged 16 to 74,479,73,9,64,112,99,43,22,71,31,9,4,5,19
S01008981,Very good health,280,46,5,41,68,64,28,13,32,13,5,2,3,11
S01008981,Good health,159,25,4,21,35,30,13,4,29,13,4,2,2,6
S01008981,Fair health,33,2,0,2,6,4,2,5,8,5,0,0,0,1
S01008981,Bad health,5,0,0,0,2,1,0,0,1,0,0,0,0,1
S01008981,Very bad health,2,0,0,0,1,0,0,0,1,0,0,0,0,0
S01008982,All people aged 16 to 74,596,40,6,34,102,135,32,45,90,65,27,19,8,60
S01008982,Very good health,329,27,3,24,62,64,19,16,50,33,9,5,4,49
S01008982,Good health,200,10,2,8,29,59,11,21,28,19,13,9,4,10
S01008982,Fair health,48,3,1,2,8,10,2,4,7,10,3,3,0,1
S01008982,Bad health,15,0,0,0,2,1,0,4,5,2,1,1,0,0
S01008982,Very bad health,4,0,0,0,1,1,0,0,0,1,1,1,0,0
S01008983,All people aged 16 to 74,522,31,7,24,102,109,26,60,77,67,15,12,3,35
S01008983,Very good health,273,20,6,14,56,60,11,36,33,24,9,8,1,24
S01008983,Good health,196,10,1,9,37,41,14,16,34,32,1,0,1,11
S01008983,Fair health,41,1,0,1,7,5,1,7,7,10,3,2,1,0
S01008983,Bad health,8,0,0,0,1,2,0,1,2,0,2,2,0,0
S01008983,Very bad health,4,0,0,0,1,1,0,0,1,1,0,0,0,0
S01008984,All people aged 16 to 74,366,31,7,24,74,78,19,36,49,44,13,7,6,22
S01008984,Very good health,192,20,6,14,42,40,7,18,20,23,5,2,3,17
S01008984,Good health,121,10,1,9,20,29,10,12,16,16,5,2,3,3
S01008984,Fair health,36,0,0,0,9,7,1,4,8,4,1,1,0,2
S01008984,Bad health,14,0,0,0,3,2,1,2,4,0,2,2,0,0
S01008984,Very bad health,3,1,0,1,0,0,0,0,1,1,0,0,0,0
S01008985,All people aged 16 to 74,525,41,7,34,88,124,36,41,88,59,12,7,5,36
S01008985,Very good health,294,23,5,18,48,69,20,19,45,32,7,4,3,31
S01008985,Good health,179,17,2,15,32,43,11,14,32,24,2,1,1,4
S01008985,Fair health,43,1,0,1,7,8,4,7,9,3,3,2,1,1
S01008985,Bad health,5,0,0,0,1,3,0,0,1,0,0,0,0,0
S01008985,Very bad health,4,0,0,0,0,1,1,1,1,0,0,0,0,0
S01008986,All people aged 16 to 74,534,40,5,35,137,108,49,44,77,34,13,7,6,32
S01008986,Very good health,313,27,4,23,81,58,29,28,46,12,6,2,4,26
S01008986,Good health,174,11,1,10,45,41,13,12,26,15,5,4,1,6
S01008986,Fair health,37,2,0,2,9,7,6,3,4,4,2,1,1,0
S01008986,Bad health,9,0,0,0,2,2,1,1,1,2,0,0,0,0
S01008986,Very bad health,1,0,0,0,0,0,0,0,0,1,0,0,0,0
S01008987,All people aged 16 to 74,611,43,5,38,131,165,52,37,84,47,11,4,7,41
S01008987,Very good health,339,21,1,20,75,90,28,17,42,25,8,2,6,33
S01008987,Good health,213,19,3,16,51,62,14,17,28,15,1,1,0,6
S01008987,Fair health,49,3,1,2,3,11,7,3,11,7,2,1,1,2
S01008987,Bad health,10,0,0,0,2,2,3,0,3,0,0,0,0,0
S01008987,Very bad health,0,0,0,0,0,0,0,0,0,0,0,0,0,0
S01008988,All people aged 16 to 74,725,92,15,77,152,145,43,53,94,60,33,21,12,53
S01008988,Very good health,409,65,7,58,96,88,22,25,44,23,11,8,3,35
S01008988,Good health,229,25,7,18,39,48,14,19,31,18,18,9,9,17
S01008988,Fair health,70,1,0,1,11,8,6,8,15,16,4,4,0,1
S01008988,Bad health,14,1,1,0,4,1,1,1,4,2,0,0,0,0
S01008988,Very bad health,3,0,0,0,2,0,0,0,0,1,0,0,0,0
S01008989,All people aged 16 to 74,540,69,6,63,137,118,33,40,50,44,18,10,8,31
S01008989,Very good health,300,42,4,38,78,64,16,24,25,19,9,4,5,23
S01008989,Good health,189,25,2,23,48,42,14,14,17,19,6,5,1,4
S01008989,Fair health,42,2,0,2,9,12,2,2,7,3,2,0,2,3
S01008989,Bad health,6,0,0,0,2,0,0,0,0,2,1,1,0,1
S01008989,Very bad health,3,0,0,0,0,0,1,0,1,1,0,0,0,0
S01008990,All people aged 16 to 74,625,74,4,70,155,152,37,48,60,56,18,10,8,25
S01008990,Very good health,371,42,2,40,94,93,22,30,33,28,10,6,4,19
S01008990,Good health,208,28,2,26,54,46,12,13,22,20,8,4,4,5
S01008990,Fair health,37,3,0,3,6,11,2,3,4,7,0,0,0,1
S01008990,Bad health,8,1,0,1,1,1,1,2,1,1,0,0,0,0
S01008990,Very bad health,1,0,0,0,0,1,0,0,0,0,0,0,0,0
S01008991,All people aged 16 to 74,736,102,15,87,215,124,51,54,73,28,13,8,5,76
S01008991,Very good health,481,69,9,60,148,80,25,33,42,16,6,4,2,62
S01008991,Good health,204,30,5,25,57,40,18,13,23,7,4,2,2,12
S01008991,Fair health,36,2,1,1,8,3,6,5,6,4,1,1,0,1
S01008991,Bad health,12,1,0,1,1,0,2,3,2,0,2,1,1,1
S01008991,Very bad health,3,0,0,0,1,1,0,0,0,1,0,0,0,0
S01008992,All people aged 16 to 74,431,37,3,34,93,87,29,33,58,38,17,11,6,39
S01008992,Very good health,220,20,2,18,58,36,20,14,31,12,5,4,1,24
S01008992,Good health,143,13,1,12,23,37,7,16,14,15,5,4,1,13
S01008992,Fair health,49,3,0,3,11,9,2,3,9,6,4,0,4,2
S01008992,Bad health,16,1,0,1,0,5,0,0,3,5,2,2,0,0
S01008992,Very bad health,3,0,0,0,1,0,0,0,1,0,1,1,0,0
S01008993,All people aged 16 to 74,799,129,38,91,205,133,89,51,88,41,18,10,8,45
S01008993,Very good health,415,70,21,49,116,64,39,26,43,18,11,7,4,28
S01008993,Good health,283,49,13,36,69,50,39,16,28,15,4,1,3,13
S01008993,Fair health,80,8,3,5,15,13,11,8,15,5,2,1,1,3
S01008993,Bad health,15,1,0,1,4,4,0,1,1,3,0,0,0,1
S01008993,Very bad health,6,1,1,0,1,2,0,0,1,0,1,1,0,0
S01008994,All people aged 16 to 74,577,42,5,37,87,77,48,53,95,105,30,22,8,40
S01008994,Very good health,278,22,2,20,48,37,19,22,39,46,12,9,3,33
S01008994,Good health,209,17,2,15,32,32,19,20,35,39,9,6,3,6
S01008994,Fair health,68,2,1,1,4,5,8,10,17,15,7,5,2,0
S01008994,Bad health,18,0,0,0,2,3,2,1,3,4,2,2,0,1
S01008994,Very bad health,4,1,0,1,1,0,0,0,1,1,0,0,0,0
S01008995,All people aged 16 to 74,657,129,21,108,205,92,39,35,67,24,15,7,8,51
S01008995,Very good health,411,90,16,74,123,60,27,17,32,14,6,2,4,42
S01008995,Good health,186,32,3,29,69,22,10,12,21,5,6,4,2,9
S01008995,Fair health,44,6,2,4,10,7,2,3,11,4,1,0,1,0
S01008995,Bad health,15,1,0,1,3,3,0,3,3,0,2,1,1,0
S01008995,Very bad health,1,0,0,0,0,0,0,0,0,1,0,0,0,0
S01008996,All people aged 16 to 74,424,27,6,21,72,59,25,40,86,72,16,9,7,27
S01008996,Very good health,210,19,4,15,42,30,10,18,40,22,10,6,4,19
S01008996,Good health,144,7,2,5,22,21,10,16,30,27,4,2,2,7
S01008996,Fair health,50,0,0,0,6,4,4,4,13,16,2,1,1,1
S01008996,Bad health,19,1,0,1,1,4,1,2,3,7,0,0,0,0
S01008996,Very bad health,1,0,0,0,1,0,0,0,0,0,0,0,0,0
S01008997,All people aged 16 to 74,734,103,23,80,160,113,65,60,96,75,22,13,9,40
S01008997,Very good health,400,75,17,58,94,48,33,24,56,32,5,3,2,33
S01008997,Good health,230,21,6,15,54,45,20,24,27,23,10,4,6,6
S01008997,Fair health,71,5,0,5,9,17,7,9,5,15,4,3,1,0
S01008997,Bad health,27,1,0,1,3,2,5,2,7,4,2,2,0,1
S01008997,Very bad health,6,1,0,1,0,1,0,1,1,1,1,1,0,0
S01008998,All people aged 16 to 74,454,22,0,22,65,57,21,48,97,77,28,16,12,39
S01008998,Very good health,222,10,0,10,29,26,11,28,51,31,11,5,6,25
S01008998,Good health,148,8,0,8,27,20,6,8,28,28,10,6,4,13
S01008998,Fair health,54,3,0,3,3,7,2,10,10,13,5,3,2,1
S01008998,Bad health,23,1,0,1,4,4,2,2,5,3,2,2,0,0
S01008998,Very bad health,7,0,0,0,2,0,0,0,3,2,0,0,0,0
S01008999,All people aged 16 to 74,610,55,11,44,122,99,38,43,108,95,21,10,11,29
S01008999,Very good health,272,37,6,31,66,36,13,16,42,29,8,3,5,25
S01008999,Good health,227,11,4,7,41,44,19,19,46,34,9,5,4,4
S01008999,Fair health,79,4,1,3,10,18,2,2,14,25,4,2,2,0
S01008999,Bad health,28,3,0,3,3,1,4,6,4,7,0,0,0,0
S01008999,Very bad health,4,0,0,0,2,0,0,0,2,0,0,0,0,0
S01009000,All people aged 16 to 74,691,107,19,88,184,119,69,44,81,45,11,6,5,31
S01009000,Very good health,396,70,13,57,104,67,36,24,44,22,3,2,1,26
S01009000,Good health,225,27,4,23,67,41,25,15,24,18,5,2,3,3
S01009000,Fair health,55,9,2,7,9,9,7,5,9,2,3,2,1,2
S01009000,Bad health,14,1,0,1,3,2,1,0,4,3,0,0,0,0
S01009000,Very bad health,1,0,0,0,1,0,0,0,0,0,0,0,0,0
S01009001,All people aged 16 to 74,604,93,15,78,160,111,47,41,65,32,16,11,5,39
S01009001,Very good health,363,63,9,54,99,59,27,24,37,14,7,3,4,33
S01009001,Good health,189,26,6,20,50,40,16,11,21,14,5,5,0,6
S01009001,Fair health,46,4,0,4,11,10,3,6,6,3,3,2,1,0
S01009001,Bad health,4,0,0,0,0,2,1,0,0,0,1,1,0,0
S01009001,Very bad health,2,0,0,0,0,0,0,0,1,1,0,0,0,0
S01009002,All people aged 16 to 74,593,114,40,74,183,78,44,27,67,35,17,7,10,28
S01009002,Very good health,361,82,28,54,123,50,25,11,26,12,8,4,4,24
S01009002,Good health,169,25,9,16,48,19,17,13,25,14,6,3,3,2
S01009002,Fair health,48,5,3,2,10,7,2,2,12,5,3,0,3,2
S01009002,Bad health,12,2,0,2,1,1,0,1,3,4,0,0,0,0
S01009002,Very bad health,3,0,0,0,1,1,0,0,1,0,0,0,0,0
S01009003,All people aged 16 to 74,705,155,16,139,220,90,54,28,62,37,7,5,2,52
S01009003,Very good health,447,114,11,103,145,53,34,12,30,16,2,1,1,41
S01009003,Good health,191,32,4,28,62,28,17,12,18,12,3,2,1,7
S01009003,Fair health,53,8,1,7,12,9,2,2,8,7,2,2,0,3
S01009003,Bad health,9,0,0,0,1,0,1,1,3,2,0,0,0,1
S01009003,Very bad health,5,1,0,1,0,0,0,1,3,0,0,0,0,0
S01009004,All people aged 16 to 74,508,41,9,32,105,117,44,44,72,56,4,3,1,25
S01009004,Very good health,290,24,4,20,70,58,26,23,39,24,2,2,0,24
S01009004,Good health,152,13,3,10,25,46,8,15,21,21,2,1,1,1
S01009004,Fair health,56,3,2,1,10,10,10,5,11,7,0,0,0,0
S01009004,Bad health,9,1,0,1,0,2,0,1,1,4,0,0,0,0
S01009004,Very bad health,1,0,0,0,0,1,0,0,0,0,0,0,0,0
S01009005,All people aged 16 to 74,554,52,7,45,126,100,38,58,85,46,11,7,4,38
S01009005,Very good health,287,29,3,26,70,57,17,25,44,18,3,2,1,24
S01009005,Good health,198,18,3,15,45,32,17,24,29,20,4,1,3,9
S01009005,Fair health,55,5,1,4,6,9,3,7,10,6,4,4,0,5
S01009005,Bad health,13,0,0,0,5,2,1,1,2,2,0,0,0,0
S01009005,Very bad health,1,0,0,0,0,0,0,1,0,0,0,0,0,0
S01009006,All people aged 16 to 74,546,54,7,47,114,92,31,38,77,69,25,19,6,46
S01009006,Very good health,260,25,3,22,66,40,11,13,37,23,14,10,4,31
S01009006,Good health,196,24,3,21,35,36,15,15,23,28,5,4,1,15
S01009006,Fair health,61,5,1,4,11,10,4,4,10,14,3,2,1,0
S01009006,Bad health,23,0,0,0,1,6,1,5,6,3,1,1,0,0
S01009006,Very bad health,6,0,0,0,1,0,0,1,1,1,2,2,0,0
S01009007,All people aged 16 to 74,491,26,1,25,91,94,28,48,79,72,16,10,6,37
S01009007,Very good health,260,16,1,15,52,57,8,24,34,28,10,7,3,31
S01009007,Good health,161,8,0,8,30,28,14,12,27,32,5,2,3,5
S01009007,Fair health,51,1,0,1,5,9,5,7,15,8,0,0,0,1
S01009007,Bad health,14,1,0,1,1,0,1,4,2,4,1,1,0,0
S01009007,Very bad health,5,0,0,0,3,0,0,1,1,0,0,0,0,0
S01009008,All people aged 16 to 74,681,127,26,101,192,118,41,32,82,46,18,9,9,25
S01009008,Very good health,353,79,19,60,105,53,23,14,30,18,10,5,5,21
S01009008,Good health,237,43,6,37,67,48,14,15,29,14,3,1,2,4
S01009008,Fair health,69,4,1,3,15,14,4,2,15,11,4,2,2,0
S01009008,Bad health,19,1,0,1,5,3,0,1,7,2,0,0,0,0
S01009008,Very bad health,3,0,0,0,0,0,0,0,1,1,1,1,0,0
S01009009,All people aged 16 to 74,327,13,1,12,59,55,24,32,63,51,17,10,7,13
S01009009,Very good health,137,5,0,5,39,20,8,11,22,16,4,2,2,12
S01009009,Good health,120,6,0,6,12,21,10,16,31,15,8,4,4,1
S01009009,Fair health,47,1,1,0,6,10,5,0,7,17,1,0,1,0
S01009009,Bad health,16,1,0,1,2,2,1,4,3,1,2,2,0,0
S01009009,Very bad health,7,0,0,0,0,2,0,1,0,2,2,2,0,0
S01009010,All people aged 16 to 74,798,103,27,76,217,143,40,58,93,67,9,6,3,68
S01009010,Very good health,479,72,18,54,133,78,17,35,60,29,1,1,0,54
S01009010,Good health,249,24,9,15,70,53,20,16,22,27,4,2,2,13
S01009010,Fair health,55,7,0,7,11,10,2,6,7,9,2,1,1,1
S01009010,Bad health,11,0,0,0,1,2,1,1,3,2,1,1,0,0
S01009010,Very bad health,4,0,0,0,2,0,0,0,1,0,1,1,0,0
S01009011,All people aged 16 to 74,675,98,19,79,187,140,42,33,75,40,12,1,11,48
S01009011,Very good health,401,71,11,60,104,83,20,16,44,22,3,0,3,38
S01009011,Good health,222,24,7,17,69,46,18,11,23,14,7,0,7,10
S01009011,Fair health,43,1,0,1,11,11,4,6,5,3,2,1,1,0
S01009011,Bad health,7,2,1,1,2,0,0,0,3,0,0,0,0,0
S01009011,Very bad health,2,0,0,0,1,0,0,0,0,1,0,0,0,0
S01009012,All people aged 16 to 74,581,76,11,65,176,106,47,33,60,34,8,4,4,41
S01009012,Very good health,353,55,7,48,107,67,18,19,32,12,6,4,2,37
S01009012,Good health,178,20,3,17,53,32,22,10,17,19,1,0,1,4
S01009012,Fair health,43,1,1,0,14,5,5,4,10,3,1,0,1,0
S01009012,Bad health,6,0,0,0,2,1,2,0,1,0,0,0,0,0
S01009012,Very bad health,1,0,0,0,0,1,0,0,0,0,0,0,0,0
S01009013,All people aged 16 to 74,700,94,21,73,194,114,46,39,78,47,22,9,13,66
S01009013,Very good health,407,59,13,46,119,60,17,21,42,23,15,6,9,51
S01009013,Good health,228,29,6,23,66,42,18,13,25,15,5,1,4,15
S01009013,Fair health,49,5,1,4,7,9,9,4,8,6,1,1,0,0
S01009013,Bad health,8,0,0,0,0,2,1,1,1,2,1,1,0,0
S01009013,Very bad health,8,1,1,0,2,1,1,0,2,1,0,0,0,0
S01009014,All people aged 16 to 74,446,13,7,6,77,39,66,48,108,64,13,5,8,18
S01009014,Very good health,241,9,5,4,43,21,32,22,65,32,3,1,2,14
S01009014,Good health,134,3,1,2,21,15,24,17,25,19,6,3,3,4
S01009014,Fair health,54,1,1,0,5,3,9,8,14,11,3,0,3,0
S01009014,Bad health,12,0,0,0,5,0,1,1,4,1,0,0,0,0
S01009014,Very bad health,5,0,0,0,3,0,0,0,0,1,1,1,0,0
S01009015,All people aged 16 to 74,459,20,6,14,110,46,60,44,80,67,13,6,7,19
S01009015,Very good health,234,10,3,7,60,24,27,16,37,37,6,0,6,17
S01009015,Good health,157,4,2,2,37,14,20,21,33,23,3,2,1,2
S01009015,Fair health,53,6,1,5,9,6,10,6,10,2,4,4,0,0
S01009015,Bad health,8,0,0,0,3,1,3,0,0,1,0,0,0,0
S01009015,Very bad health,7,0,0,0,1,1,0,1,0,4,0,0,0,0
S01009016,All people aged 16 to 74,367,17,7,10,92,33,46,41,58,56,12,3,9,12
S01009016,Very good health,196,10,4,6,52,20,28,20,30,23,6,0,6,7
S01009016,Good health,118,6,3,3,32,8,14,14,14,24,2,1,1,4
S01009016,Fair health,39,1,0,1,5,2,3,6,11,7,4,2,2,0
S01009016,Bad health,11,0,0,0,3,1,1,1,2,2,0,0,0,1
S01009016,Very bad health,3,0,0,0,0,2,0,0,1,0,0,0,0,0
S01009017,All people aged 16 to 74,447,20,5,15,83,48,51,53,85,70,28,14,14,9
S01009017,Very good health,215,10,1,9,45,23,23,31,38,26,11,6,5,8
S01009017,Good health,141,5,3,2,24,24,18,14,26,21,8,1,7,1
S01009017,Fair health,63,3,0,3,10,1,7,4,13,17,8,6,2,0
S01009017,Bad health,21,2,1,1,0,0,2,4,8,4,1,1,0,0
S01009017,Very bad health,7,0,0,0,4,0,1,0,0,2,0,0,0,0
S01009018,All people aged 16 to 74,559,26,6,20,108,49,74,62,90,95,14,7,7,41
S01009018,Very good health,266,15,4,11,62,35,33,22,31,39,2,0,2,27
S01009018,Good health,193,8,2,6,34,10,23,25,38,37,5,4,1,13
S01009018,Fair health,79,3,0,3,10,3,15,11,15,15,6,2,4,1
S01009018,Bad health,17,0,0,0,1,1,3,4,4,3,1,1,0,0
S01009018,Very bad health,4,0,0,0,1,0,0,0,2,1,0,0,0,0
S01009019,All people aged 16 to 74,391,17,5,12,96,49,36,47,50,70,16,3,13,10
S01009019,Very good health,187,7,0,7,49,31,14,20,21,32,5,0,5,8
S01009019,Good health,143,8,5,3,38,12,13,18,19,27,7,1,6,1
S01009019,Fair health,48,2,0,2,6,6,8,7,8,7,3,2,1,1
S01009019,Bad health,11,0,0,0,3,0,1,2,1,3,1,0,1,0
S01009019,Very bad health,2,0,0,0,0,0,0,0,1,1,0,0,0,0
S01009020,All people aged 16 to 74,598,41,7,34,131,80,50,55,107,90,26,10,16,18
S01009020,Very good health,294,22,4,18,62,42,25,27,51,41,10,3,7,14
S01009020,Good health,196,15,2,13,47,27,16,15,33,30,9,2,7,4
S01009020,Fair health,86,3,0,3,16,9,7,9,19,17,6,4,2,0
S01009020,Bad health,18,1,1,0,5,2,2,1,4,2,1,1,0,0
S01009020,Very bad health,4,0,0,0,1,0,0,3,0,0,0,0,0,0
S01009021,All people aged 16 to 74,560,34,7,27,139,44,93,44,91,76,13,9,4,26
S01009021,Very good health,307,25,5,20,78,21,43,29,51,34,3,1,2,23
S01009021,Good health,183,6,2,4,46,18,33,11,26,36,4,3,1,3
S01009021,Fair health,57,2,0,2,14,4,13,2,12,5,5,4,1,0
S01009021,Bad health,6,1,0,1,0,1,1,1,1,1,0,0,0,0
S01009021,Very bad health,7,0,0,0,1,0,3,1,1,0,1,1,0,0
S01009022,All people aged 16 to 74,675,34,6,28,164,67,95,57,115,91,18,8,10,34
S01009022,Very good health,361,20,2,18,98,30,50,32,55,44,4,1,3,28
S01009022,Good health,211,12,4,8,47,28,28,17,37,29,9,4,5,4
S01009022,Fair health,82,2,0,2,15,5,16,7,19,13,3,1,2,2
S01009022,Bad health,15,0,0,0,3,3,0,1,2,4,2,2,0,0
S01009022,Very bad health,6,0,0,0,1,1,1,0,2,1,0,0,0,0
S01009023,All people aged 16 to 74,700,40,5,35,133,65,131,57,109,106,21,9,12,38
S01009023,Very good health,347,19,5,14,72,37,54,31,52,43,7,4,3,32
S01009023,Good health,234,15,0,15,40,21,56,16,38,33,9,2,7,6
S01009023,Fair health,93,6,0,6,14,5,18,10,17,19,4,2,2,0
S01009023,Bad health,23,0,0,0,6,2,3,0,2,9,1,1,0,0
S01009023,Very bad health,3,0,0,0,1,0,0,0,0,2,0,0,0,0
S01009024,All people aged 16 to 74,710,34,8,26,150,67,111,65,134,117,15,7,8,17
S01009024,Very good health,374,24,8,16,90,37,53,38,61,54,3,1,2,14
S01009024,Good health,214,8,0,8,42,26,31,17,41,37,9,4,5,3
S01009024,Fair health,86,1,0,1,11,2,22,5,20,22,3,2,1,0
S01009024,Bad health,28,1,0,1,6,2,3,4,10,2,0,0,0,0
S01009024,Very bad health,8,0,0,0,1,0,2,1,2,2,0,0,0,0
S01009025,All people aged 16 to 74,669,44,13,31,162,60,89,62,115,80,30,16,14,27
S01009025,Very good health,329,19,4,15,84,35,38,35,50,36,14,9,5,18
S01009025,Good health,220,18,7,11,56,17,29,17,40,26,8,3,5,9
S01009025,Fair health,99,6,1,5,17,8,21,7,21,14,5,2,3,0
S01009025,Bad health,17,0,0,0,5,0,1,3,4,3,1,0,1,0
S01009025,Very bad health,4,1,1,0,0,0,0,0,0,1,2,2,0,0
S01009026,All people aged 16 to 74,679,50,9,41,137,83,78,49,110,106,29,14,15,37
S01009026,Very good health,344,32,7,25,72,49,36,22,54,43,9,3,6,27
S01009026,Good health,207,14,2,12,49,26,28,14,32,28,9,4,5,7
S01009026,Fair health,94,4,0,4,11,7,10,9,20,23,7,5,2,3
S01009026,Bad health,24,0,0,0,4,1,2,2,3,10,2,1,1,0
S01009026,Very bad health,10,0,0,0,1,0,2,2,1,2,2,1,1,0
S01009027,All people aged 16 to 74,565,41,15,26,132,58,88,52,83,65,21,9,12,25
S01009027,Very good health,276,30,13,17,61,31,48,29,33,17,10,4,6,17
S01009027,Good health,191,10,2,8,47,20,29,12,32,25,8,3,5,8
S01009027,Fair health,72,1,0,1,16,4,10,7,11,21,2,1,1,0
S01009027,Bad health,19,0,0,0,6,3,1,2,5,1,1,1,0,0
S01009027,Very bad health,7,0,0,0,2,0,0,2,2,1,0,0,0,0
S01009028,All people aged 16 to 74,374,22,3,19,86,39,58,40,45,61,6,3,3,17
S01009028,Very good health,197,14,2,12,50,15,26,27,20,30,1,0,1,14
S01009028,Good health,117,4,0,4,27,17,21,9,18,19,0,0,0,2
S01009028,Fair health,44,3,1,2,7,3,8,3,5,10,4,2,2,1
S01009028,Bad health,12,1,0,1,1,3,3,0,1,2,1,1,0,0
S01009028,Very bad health,4,0,0,0,1,1,0,1,1,0,0,0,0,0
S01009029,All people aged 16 to 74,457,33,5,28,109,37,67,45,62,65,21,8,13,18
S01009029,Very good health,225,20,2,18,67,19,26,17,24,29,5,2,3,18
S01009029,Good health,144,12,3,9,26,12,27,15,24,21,7,4,3,0
S01009029,Fair health,61,0,0,0,13,2,9,11,7,11,8,2,6,0
S01009029,Bad health,21,0,0,0,3,3,5,2,5,3,0,0,0,0
S01009029,Very bad health,6,1,0,1,0,1,0,0,2,1,1,0,1,0
S01009030,All people aged 16 to 74,540,19,4,15,108,67,63,46,89,95,21,10,11,32
S01009030,Very good health,274,10,2,8,62,36,27,23,40,42,6,3,3,28
S01009030,Good health,172,7,1,6,39,22,22,13,25,31,10,5,5,3
S01009030,Fair health,76,1,1,0,6,7,12,9,20,19,1,0,1,1
S01009030,Bad health,13,0,0,0,0,2,2,1,1,3,4,2,2,0
S01009030,Very bad health,5,1,0,1,1,0,0,0,3,0,0,0,0,0
S01009031,All people aged 16 to 74,566,16,4,12,117,69,59,62,122,83,14,9,5,24
S01009031,Very good health,276,9,1,8,58,37,21,37,51,37,5,2,3,21
S01009031,Good health,179,5,3,2,45,19,24,15,42,24,3,2,1,2
S01009031,Fair health,89,1,0,1,13,10,10,8,25,18,3,3,0,1
S01009031,Bad health,20,0,0,0,1,3,3,2,4,4,3,2,1,0
S01009031,Very bad health,2,1,0,1,0,0,1,0,0,0,0,0,0,0
S01009032,All people aged 16 to 74,484,29,5,24,100,60,53,42,86,84,12,5,7,18
S01009032,Very good health,238,19,3,16,51,31,27,21,34,36,6,1,5,13
S01009032,Good health,156,7,0,7,29,17,20,18,31,28,2,1,1,4
S01009032,Fair health,76,3,2,1,17,10,4,2,18,17,4,3,1,1
S01009032,Bad health,13,0,0,0,3,2,2,1,2,3,0,0,0,0
S01009032,Very bad health,1,0,0,0,0,0,0,0,1,0,0,0,0,0
S01009033,All people aged 16 to 74,565,25,8,17,115,58,68,50,110,96,13,5,8,30
S01009033,Very good health,293,16,5,11,61,41,30,24,49,42,5,0,5,25
S01009033,Good health,177,7,2,5,35,10,31,12,36,36,5,2,3,5
S01009033,Fair health,68,2,1,1,12,7,7,8,17,13,2,2,0,0
S01009033,Bad health,21,0,0,0,6,0,0,6,5,4,0,0,0,0
S01009033,Very bad health,6,0,0,0,1,0,0,0,3,1,1,1,0,0
S01009034,All people aged 16 to 74,496,33,8,25,112,61,42,57,78,82,10,2,8,21
S01009034,Very good health,264,20,5,15,71,32,16,30,40,38,3,0,3,14
S01009034,Good health,146,10,2,8,29,17,16,17,24,24,3,0,3,6
S01009034,Fair health,62,2,1,1,6,12,4,8,12,14,3,1,2,1
S01009034,Bad health,16,0,0,0,2,0,4,1,2,6,1,1,0,0
S01009034,Very bad health,8,1,0,1,4,0,2,1,0,0,0,0,0,0
S01009035,All people aged 16 to 74,669,42,13,29,161,100,68,57,99,88,25,15,10,29
S01009035,Very good health,393,30,8,22,100,71,31,32,55,41,7,3,4,26
S01009035,Good health,183,8,3,5,40,22,20,21,29,33,8,5,3,2
S01009035,Fair health,61,2,1,1,14,6,7,3,14,9,5,2,3,1
S01009035,Bad health,27,1,1,0,7,1,8,1,1,5,3,3,0,0
S01009035,Very bad health,5,1,0,1,0,0,2,0,0,0,2,2,0,0
S01009036,All people aged 16 to 74,752,45,10,35,171,102,69,75,115,105,26,15,11,44
S01009036,Very good health,429,26,3,23,111,67,35,38,54,52,10,4,6,36
S01009036,Good health,205,13,4,9,36,26,18,17,40,40,8,5,3,7
S01009036,Fair health,79,5,3,2,17,9,12,9,16,5,5,3,2,1
S01009036,Bad health,31,1,0,1,4,0,3,11,5,5,2,2,0,0
S01009036,Very bad health,8,0,0,0,3,0,1,0,0,3,1,1,0,0
S01009037,All people aged 16 to 74,660,36,8,28,151,102,65,61,97,91,16,8,8,41
S01009037,Very good health,383,25,5,20,92,67,33,41,48,44,2,2,0,31
S01009037,Good health,199,8,1,7,49,25,24,13,33,31,8,2,6,8
S01009037,Fair health,58,3,2,1,8,7,7,5,10,11,5,3,2,2
S01009037,Bad health,13,0,0,0,0,3,1,1,4,3,1,1,0,0
S01009037,Very bad health,7,0,0,0,2,0,0,1,2,2,0,0,0,0
S01009038,All people aged 16 to 74,793,49,12,37,170,98,62,69,131,120,37,23,14,57
S01009038,Very good health,446,30,5,25,97,56,32,43,59,69,11,5,6,49
S01009038,Good health,217,9,3,6,52,29,13,19,47,29,12,8,4,7
S01009038,Fair health,90,6,3,3,18,6,10,3,19,17,10,6,4,1
S01009038,Bad health,26,2,1,1,2,4,5,4,3,3,3,3,0,0
S01009038,Very bad health,14,2,0,2,1,3,2,0,3,2,1,1,0,0
S01009039,All people aged 16 to 74,500,20,6,14,83,50,44,55,94,97,25,11,14,32
S01009039,Very good health,252,12,5,7,64,24,18,25,42,39,8,6,2,20
S01009039,Good health,156,6,0,6,13,18,16,25,34,27,8,1,7,9
S01009039,Fair health,64,2,1,1,5,5,6,4,14,19,8,3,5,1
S01009039,Bad health,21,0,0,0,0,2,3,1,2,11,0,0,0,2
S01009039,Very bad health,7,0,0,0,1,1,1,0,2,1,1,1,0,0
S01009040,All people aged 16 to 74,467,22,3,19,90,59,40,30,87,73,19,10,9,47
S01009040,Very good health,244,9,2,7,61,29,16,22,39,28,4,0,4,36
S01009040,Good health,149,12,1,11,19,22,15,4,29,30,8,5,3,10
S01009040,Fair health,55,1,0,1,9,7,6,2,17,7,6,4,2,0
S01009040,Bad health,14,0,0,0,0,1,3,2,1,6,0,0,0,1
S01009040,Very bad health,5,0,0,0,1,0,0,0,1,2,1,1,0,0
S01009041,All people aged 16 to 74,638,70,16,54,145,77,71,69,71,78,26,11,15,31
S01009041,Very good health,322,40,9,31,85,40,33,38,26,31,4,1,3,25
S01009041,Good health,206,24,6,18,44,21,21,19,29,33,9,5,4,6
S01009041,Fair health,67,5,1,4,9,8,11,5,13,9,7,4,3,0
S01009041,Bad health,30,1,0,1,6,6,4,5,1,4,3,0,3,0
S01009041,Very bad health,13,0,0,0,1,2,2,2,2,1,3,1,2,0
S01009042,All people aged 16 to 74,620,34,8,26,114,84,43,64,108,109,27,10,17,37
S01009042,Very good health,320,12,3,9,65,51,16,27,65,48,7,2,5,29
S01009042,Good health,214,19,5,14,37,23,18,20,29,48,15,7,8,5
S01009042,Fair health,61,1,0,1,7,6,7,12,11,10,4,1,3,3
S01009042,Bad health,17,1,0,1,3,4,1,2,3,2,1,0,1,0
S01009042,Very bad health,8,1,0,1,2,0,1,3,0,1,0,0,0,0
S01009043,All people aged 16 to 74,478,40,2,38,82,57,33,38,96,89,26,14,12,17
S01009043,Very good health,223,19,1,18,45,24,10,18,50,32,9,4,5,16
S01009043,Good health,159,14,0,14,27,21,17,10,26,34,9,5,4,1
S01009043,Fair health,63,7,1,6,7,4,4,8,15,13,5,3,2,0
S01009043,Bad health,26,0,0,0,2,6,2,2,3,8,3,2,1,0
S01009043,Very bad health,7,0,0,0,1,2,0,0,2,2,0,0,0,0
S01009044,All people aged 16 to 74,563,38,9,29,117,70,47,54,109,96,13,7,6,19
S01009044,Very good health,268,21,5,16,69,33,20,20,48,42,1,0,1,14
S01009044,Good health,175,13,4,9,31,24,13,19,39,24,7,3,4,5
S01009044,Fair health,84,2,0,2,14,6,9,9,19,21,4,3,1,0
S01009044,Bad health,25,1,0,1,2,5,2,5,2,8,0,0,0,0
S01009044,Very bad health,11,1,0,1,1,2,3,1,1,1,1,1,0,0
S01009045,All people aged 16 to 74,490,33,4,29,94,75,47,41,72,92,9,6,3,27
S01009045,Very good health,243,22,2,20,55,42,16,22,27,38,0,0,0,21
S01009045,Good health,150,8,1,7,26,20,16,10,26,30,8,5,3,6
S01009045,Fair health,67,2,0,2,9,9,12,4,14,16,1,1,0,0
S01009045,Bad health,24,1,1,0,4,3,2,4,5,5,0,0,0,0
S01009045,Very bad health,6,0,0,0,0,1,1,1,0,3,0,0,0,0
S01009046,All people aged 16 to 74,641,30,4,26,168,68,64,53,112,83,10,4,6,53
S01009046,Very good health,332,20,2,18,88,33,31,32,48,35,2,1,1,43
S01009046,Good health,201,7,0,7,58,25,21,14,36,30,4,1,3,6
S01009046,Fair health,81,2,2,0,16,9,10,3,21,12,4,2,2,4
S01009046,Bad health,23,0,0,0,4,1,2,4,7,5,0,0,0,0
S01009046,Very bad health,4,1,0,1,2,0,0,0,0,1,0,0,0,0
S01009047,All people aged 16 to 74,586,36,6,30,148,83,40,65,101,80,6,3,3,27
S01009047,Very good health,338,23,2,21,90,48,15,35,61,38,4,2,2,24
S01009047,Good health,164,12,3,9,41,24,18,15,28,23,1,0,1,2
S01009047,Fair health,58,0,0,0,14,10,4,8,9,12,1,1,0,0
S01009047,Bad health,20,1,1,0,1,1,3,7,2,4,0,0,0,1
S01009047,Very bad health,6,0,0,0,2,0,0,0,1,3,0,0,0,0
S01009048,All people aged 16 to 74,618,45,12,33,165,80,46,52,111,75,7,2,5,37
S01009048,Very good health,321,20,7,13,80,46,25,25,58,29,6,2,4,32
S01009048,Good health,203,18,3,15,63,23,15,18,35,26,1,0,1,4
S01009048,Fair health,72,6,2,4,15,8,4,7,14,17,0,0,0,1
S01009048,Bad health,17,1,0,1,7,1,1,1,3,3,0,0,0,0
S01009048,Very bad health,5,0,0,0,0,2,1,1,1,0,0,0,0,0
S01009049,All people aged 16 to 74,452,31,4,27,116,56,44,37,70,73,6,2,4,19
S01009049,Very good health,223,15,1,14,56,33,22,20,30,26,3,0,3,18
S01009049,Good health,153,11,2,9,37,17,17,11,27,30,2,2,0,1
S01009049,Fair health,55,3,1,2,19,4,4,3,10,11,1,0,1,0
S01009049,Bad health,15,2,0,2,4,2,0,1,2,4,0,0,0,0
S01009049,Very bad health,6,0,0,0,0,0,1,2,1,2,0,0,0,0
S01009050,All people aged 16 to 74,585,45,11,34,126,112,42,56,61,84,31,24,7,28
S01009050,Very good health,294,24,8,16,74,60,17,31,23,36,8,4,4,21
S01009050,Good health,190,11,3,8,40,42,15,20,26,27,5,3,2,4
S01009050,Fair health,79,9,0,9,9,7,10,2,7,16,17,16,1,2
S01009050,Bad health,19,1,0,1,3,3,0,3,4,4,0,0,0,1
S01009050,Very bad health,3,0,0,0,0,0,0,0,1,1,1,1,0,0
S01009051,All people aged 16 to 74,516,19,2,17,85,79,44,54,88,97,21,12,9,29
S01009051,Very good health,260,13,2,11,43,45,24,23,49,33,8,5,3,22
S01009051,Good health,181,5,0,5,28,29,14,27,31,37,6,2,4,4
S01009051,Fair health,53,1,0,1,10,4,5,2,6,18,5,5,0,2
S01009051,Bad health,19,0,0,0,4,1,0,2,2,7,2,0,2,1
S01009051,Very bad health,3,0,0,0,0,0,1,0,0,2,0,0,0,0
S01009052,All people aged 16 to 74,488,25,11,14,93,87,46,44,77,79,9,4,5,28
S01009052,Very good health,209,9,5,4,49,39,12,18,27,30,3,2,1,22
S01009052,Good health,195,14,6,8,31,41,19,19,36,26,4,1,3,5
S01009052,Fair health,53,1,0,1,10,4,7,6,10,13,2,1,1,0
S01009052,Bad health,25,1,0,1,1,3,5,0,4,10,0,0,0,1
S01009052,Very bad health,6,0,0,0,2,0,3,1,0,0,0,0,0,0
S01009053,All people aged 16 to 74,402,6,2,4,34,49,17,27,93,99,50,21,29,27
S01009053,Very good health,144,2,2,0,17,22,6,9,36,19,18,6,12,15
S01009053,Good health,146,1,0,1,12,12,10,12,39,36,15,5,10,9
S01009053,Fair health,66,3,0,3,4,11,0,2,11,22,10,5,5,3
S01009053,Bad health,36,0,0,0,1,3,1,3,5,19,4,2,2,0
S01009053,Very bad health,10,0,0,0,0,1,0,1,2,3,3,3,0,0
S01009054,All people aged 16 to 74,444,13,4,9,74,63,24,47,78,96,27,12,15,22
S01009054,Very good health,166,2,0,2,32,28,7,15,27,27,13,6,7,15
S01009054,Good health,182,11,4,7,26,18,7,20,39,46,11,5,6,4
S01009054,Fair health,68,0,0,0,8,13,8,9,9,15,3,1,2,3
S01009054,Bad health,25,0,0,0,7,4,1,3,3,7,0,0,0,0
S01009054,Very bad health,3,0,0,0,1,0,1,0,0,1,0,0,0,0
S01009055,All people aged 16 to 74,643,61,15,46,134,88,78,59,85,85,27,9,18,26
S01009055,Very good health,305,30,9,21,76,47,39,19,36,29,9,3,6,20
S01009055,Good health,248,22,4,18,49,30,25,26,40,38,15,4,11,3
S01009055,Fair health,62,4,1,3,6,7,11,8,7,14,2,1,1,3
S01009055,Bad health,25,3,1,2,3,4,3,5,2,4,1,1,0,0
S01009055,Very bad health,3,2,0,2,0,0,0,1,0,0,0,0,0,0
S01009056,All people aged 16 to 74,415,12,5,7,42,47,36,25,87,107,31,17,14,28
S01009056,Very good health,173,7,1,6,19,24,17,11,32,33,12,7,5,18
S01009056,Good health,128,2,2,0,14,16,13,9,32,25,10,4,6,7
S01009056,Fair health,64,3,2,1,3,4,2,3,13,29,5,3,2,2
S01009056,Bad health,38,0,0,0,4,3,4,2,7,14,4,3,1,0
S01009056,Very bad health,12,0,0,0,2,0,0,0,3,6,0,0,0,1
S01009057,All people aged 16 to 74,403,14,1,13,57,42,26,25,83,99,37,17,20,20
S01009057,Very good health,183,9,0,9,30,22,16,17,31,29,15,7,8,14
S01009057,Good health,140,3,1,2,20,12,6,5,33,40,17,5,12,4
S01009057,Fair health,53,2,0,2,5,3,1,2,14,23,2,2,0,1
S01009057,Bad health,21,0,0,0,2,3,3,1,5,6,1,1,0,0
S01009057,Very bad health,6,0,0,0,0,2,0,0,0,1,2,2,0,1
S01009058,All people aged 16 to 74,594,25,3,22,108,88,27,55,107,123,27,10,17,34
S01009058,Very good health,245,16,2,14,51,38,12,23,33,36,9,4,5,27
S01009058,Good health,213,6,0,6,35,30,7,20,46,52,11,1,10,6
S01009058,Fair health,86,3,1,2,12,12,4,8,18,25,4,3,1,0
S01009058,Bad health,36,0,0,0,8,6,4,4,5,6,2,1,1,1
S01009058,Very bad health,14,0,0,0,2,2,0,0,5,4,1,1,0,0
S01009059,All people aged 16 to 74,657,57,14,43,159,82,53,56,71,79,46,30,16,54
S01009059,Very good health,327,36,9,27,88,35,28,27,30,31,13,6,7,39
S01009059,Good health,240,18,5,13,58,32,23,22,29,27,19,11,8,12
S01009059,Fair health,69,2,0,2,10,10,2,5,9,15,13,12,1,3
S01009059,Bad health,17,0,0,0,3,4,0,1,3,5,1,1,0,0
S01009059,Very bad health,4,1,0,1,0,1,0,1,0,1,0,0,0,0
S01009060,All people aged 16 to 74,405,46,10,36,124,59,45,26,30,35,7,6,1,33
S01009060,Very good health,247,30,6,24,80,32,20,17,17,18,5,4,1,28
S01009060,Good health,123,11,3,8,37,22,20,5,9,16,0,0,0,3
S01009060,Fair health,31,4,1,3,6,5,4,4,3,1,2,2,0,2
S01009060,Bad health,2,0,0,0,1,0,1,0,0,0,0,0,0,0
S01009060,Very bad health,2,1,0,1,0,0,0,0,1,0,0,0,0,0
S01009061,All people aged 16 to 74,632,28,7,21,101,93,28,63,135,125,24,11,13,35
S01009061,Very good health,263,17,5,12,45,39,10,26,54,39,8,4,4,25
S01009061,Good health,253,8,1,7,40,41,13,22,54,55,11,4,7,9
S01009061,Fair health,85,3,1,2,12,10,3,13,16,22,5,3,2,1
S01009061,Bad health,23,0,0,0,2,2,2,2,8,7,0,0,0,0
S01009061,Very bad health,8,0,0,0,2,1,0,0,3,2,0,0,0,0
S01009062,All people aged 16 to 74,485,9,3,6,56,88,30,49,96,102,31,17,14,24
S01009062,Very good health,192,7,1,6,25,39,13,19,32,30,13,6,7,14
S01009062,Good health,190,1,1,0,21,39,10,19,41,43,8,4,4,8
S01009062,Fair health,70,0,0,0,8,4,5,10,17,16,9,6,3,1
S01009062,Bad health,25,1,1,0,1,4,2,1,3,11,1,1,0,1
S01009062,Very bad health,8,0,0,0,1,2,0,0,3,2,0,0,0,0
S01009063,All people aged 16 to 74,569,49,8,41,130,84,36,50,82,87,12,8,4,39
S01009063,Very good health,279,29,4,25,66,45,15,18,36,34,3,2,1,33
S01009063,Good health,206,20,4,16,48,22,15,23,34,31,7,5,2,6
S01009063,Fair health,63,0,0,0,12,15,4,6,9,17,0,0,0,0
S01009063,Bad health,19,0,0,0,4,1,2,3,3,4,2,1,1,0
S01009063,Very bad health,2,0,0,0,0,1,0,0,0,1,0,0,0,0
S01009064,All people aged 16 to 74,433,15,0,15,69,70,13,38,87,97,21,8,13,23
S01009064,Very good health,183,7,0,7,35,34,7,14,23,37,11,5,6,15
S01009064,Good health,160,5,0,5,23,22,3,17,41,35,7,1,6,7
S01009064,Fair health,63,3,0,3,6,10,2,4,14,20,3,2,1,1
S01009064,Bad health,25,0,0,0,4,3,1,3,9,5,0,0,0,0
S01009064,Very bad health,2,0,0,0,1,1,0,0,0,0,0,0,0,0
S01009065,All people aged 16 to 74,476,15,0,15,55,63,30,48,95,91,45,25,20,34
S01009065,Very good health,202,8,0,8,29,30,14,18,34,26,17,12,5,26
S01009065,Good health,186,6,0,6,21,25,12,22,38,36,18,6,12,8
S01009065,Fair health,49,1,0,1,2,3,2,6,13,17,5,3,2,0
S01009065,Bad health,31,0,0,0,2,4,1,1,8,10,5,4,1,0
S01009065,Very bad health,8,0,0,0,1,1,1,1,2,2,0,0,0,0
S01009066,All people aged 16 to 74,539,15,6,9,84,75,36,56,112,106,36,19,17,19
S01009066,Very good health,232,7,3,4,39,36,19,27,45,35,12,7,5,12
S01009066,Good health,203,5,2,3,35,30,11,19,41,41,15,7,8,6
S01009066,Fair health,72,2,1,1,7,8,3,7,16,22,6,3,3,1
S01009066,Bad health,24,0,0,0,3,0,2,2,9,5,3,2,1,0
S01009066,Very bad health,8,1,0,1,0,1,1,1,1,3,0,0,0,0
S01009067,All people aged 16 to 74,637,62,20,42,159,120,57,61,80,46,16,10,6,36
S01009067,Very good health,343,36,11,25,80,67,24,40,34,20,10,7,3,32
S01009067,Good health,228,23,7,16,67,41,24,15,32,16,6,3,3,4
S01009067,Fair health,48,1,1,0,9,10,7,5,10,6,0,0,0,0
S01009067,Bad health,12,1,0,1,3,2,1,1,3,1,0,0,0,0
S01009067,Very bad health,6,1,1,0,0,0,1,0,1,3,0,0,0,0
S01009068,All people aged 16 to 74,670,35,6,29,121,124,42,78,96,106,27,16,11,41
S01009068,Very good health,324,17,3,14,48,64,18,31,46,57,13,7,6,30
S01009068,Good health,233,13,0,13,54,41,13,34,31,35,6,2,4,6
S01009068,Fair health,76,3,3,0,11,15,9,7,11,11,6,5,1,3
S01009068,Bad health,29,2,0,2,6,2,2,3,7,3,2,2,0,2
S01009068,Very bad health,8,0,0,0,2,2,0,3,1,0,0,0,0,0
S01009069,All people aged 16 to 74,510,51,13,38,159,77,37,45,59,45,6,1,5,31
S01009069,Very good health,293,31,7,24,92,44,24,22,28,26,2,0,2,24
S01009069,Good health,167,15,4,11,54,26,11,20,22,10,3,0,3,6
S01009069,Fair health,42,5,2,3,11,6,2,2,7,7,1,1,0,1
S01009069,Bad health,5,0,0,0,2,0,0,1,2,0,0,0,0,0
S01009069,Very bad health,3,0,0,0,0,1,0,0,0,2,0,0,0,0
S01009070,All people aged 16 to 74,494,28,8,20,102,97,53,41,73,55,13,7,6,32
S01009070,Very good health,256,19,6,13,57,58,20,17,30,21,7,5,2,27
S01009070,Good health,171,7,2,5,29,33,23,21,30,19,4,2,2,5
S01009070,Fair health,52,2,0,2,12,6,6,2,9,13,2,0,2,0
S01009070,Bad health,13,0,0,0,4,0,2,1,4,2,0,0,0,0
S01009070,Very bad health,2,0,0,0,0,0,2,0,0,0,0,0,0,0
S01009071,All people aged 16 to 74,379,28,7,21,85,50,41,30,50,54,23,15,8,18
S01009071,Very good health,170,16,3,13,42,22,14,15,22,19,6,1,5,14
S01009071,Good health,137,9,3,6,33,16,20,8,19,19,10,8,2,3
S01009071,Fair health,49,1,1,0,8,10,7,6,3,10,4,3,1,0
S01009071,Bad health,17,2,0,2,2,1,0,1,3,5,3,3,0,0
S01009071,Very bad health,6,0,0,0,0,1,0,0,3,1,0,0,0,1
S01009072,All people aged 16 to 74,394,34,9,25,84,55,44,30,53,50,21,14,7,23
S01009072,Very good health,224,24,5,19,53,30,20,17,26,27,8,3,5,19
S01009072,Good health,101,7,2,5,25,13,14,7,15,14,2,1,1,4
S01009072,Fair health,48,3,2,1,4,9,8,2,8,6,8,7,1,0
S01009072,Bad health,17,0,0,0,1,3,1,4,3,3,2,2,0,0
S01009072,Very bad health,4,0,0,0,1,0,1,0,1,0,1,1,0,0
S01009073,All people aged 16 to 74,447,12,7,5,54,49,29,51,101,99,27,14,13,25
S01009073,Very good health,209,7,2,5,24,26,17,19,41,41,13,8,5,21
S01009073,Good health,143,4,4,0,14,14,9,19,40,31,9,2,7,3
S01009073,Fair health,53,1,1,0,8,4,3,7,12,14,3,2,1,1
S01009073,Bad health,36,0,0,0,7,5,0,4,6,12,2,2,0,0
S01009073,Very bad health,6,0,0,0,1,0,0,2,2,1,0,0,0,0
S01009074,All people aged 16 to 74,538,21,3,18,58,50,28,56,100,138,51,28,23,36
S01009074,Very good health,216,10,1,9,29,22,7,17,40,48,17,8,9,26
S01009074,Good health,198,10,1,9,19,18,13,27,37,50,19,8,11,5
S01009074,Fair health,78,1,1,0,8,8,5,6,13,20,13,10,3,4
S01009074,Bad health,34,0,0,0,2,2,3,3,9,12,2,2,0,1
S01009074,Very bad health,12,0,0,0,0,0,0,3,1,8,0,0,0,0
S01009075,All people aged 16 to 74,418,15,4,11,60,55,35,50,71,95,22,12,10,15
S01009075,Very good health,154,9,3,6,29,18,11,12,26,33,4,2,2,12
S01009075,Good health,156,5,1,4,19,22,18,21,25,31,12,6,6,3
S01009075,Fair health,66,0,0,0,10,10,4,11,12,17,2,0,2,0
S01009075,Bad health,38,1,0,1,2,4,2,5,7,13,4,4,0,0
S01009075,Very bad health,4,0,0,0,0,1,0,1,1,1,0,0,0,0
S01009076,All people aged 16 to 74,752,49,9,40,176,129,58,73,99,98,17,9,8,53
S01009076,Very good health,385,23,2,21,79,75,22,41,54,47,9,4,5,35
S01009076,Good health,248,22,5,17,71,34,26,20,22,30,6,4,2,17
S01009076,Fair health,85,2,1,1,18,16,7,9,17,14,1,0,1,1
S01009076,Bad health,24,1,0,1,4,3,2,3,3,7,1,1,0,0
S01009076,Very bad health,10,1,1,0,4,1,1,0,3,0,0,0,0,0
S01009077,All people aged 16 to 74,491,35,9,26,119,72,32,49,70,58,24,14,10,32
S01009077,Very good health,247,18,3,15,68,31,12,26,35,27,7,5,2,23
S01009077,Good health,167,13,4,9,38,32,14,15,21,17,8,1,7,9
S01009077,Fair health,54,4,2,2,11,6,4,5,11,7,6,5,1,0
S01009077,Bad health,19,0,0,0,2,2,2,3,3,5,2,2,0,0
S01009077,Very bad health,4,0,0,0,0,1,0,0,0,2,1,1,0,0
S01009078,All people aged 16 to 74,567,86,15,71,179,104,35,36,50,36,13,10,3,28
S01009078,Very good health,332,51,7,44,110,60,18,19,26,19,5,4,1,24
S01009078,Good health,178,29,7,22,54,37,13,13,14,9,5,4,1,4
S01009078,Fair health,47,5,1,4,14,7,4,3,6,5,3,2,1,0
S01009078,Bad health,8,1,0,1,1,0,0,0,3,3,0,0,0,0
S01009078,Very bad health,2,0,0,0,0,0,0,1,1,0,0,0,0,0
S01009079,All people aged 16 to 74,630,21,6,15,83,75,40,70,134,142,41,24,17,24
S01009079,Very good health,265,6,2,4,43,40,11,28,56,54,12,7,5,15
S01009079,Good health,213,11,3,8,28,24,15,25,38,52,13,5,8,7
S01009079,Fair health,100,2,1,1,8,8,10,9,30,21,11,8,3,1
S01009079,Bad health,40,2,0,2,3,3,2,7,7,11,4,3,1,1
S01009079,Very bad health,12,0,0,0,1,0,2,1,3,4,1,1,0,0
S01009080,All people aged 16 to 74,688,21,8,13,111,90,48,79,129,143,39,27,12,28
S01009080,Very good health,275,12,4,8,50,34,18,36,48,46,14,12,2,17
S01009080,Good health,248,9,4,5,39,40,22,27,48,47,8,2,6,8
S01009080,Fair health,114,0,0,0,16,15,6,9,24,31,11,10,1,2
S01009080,Bad health,42,0,0,0,5,1,2,4,8,17,4,1,3,1
S01009080,Very bad health,9,0,0,0,1,0,0,3,1,2,2,2,0,0
S01009081,All people aged 16 to 74,501,24,8,16,118,82,46,43,76,81,11,10,1,20
S01009081,Very good health,235,12,5,7,61,41,23,17,30,31,1,0,1,19
S01009081,Good health,168,6,1,5,39,27,17,16,30,27,5,5,0,1
S01009081,Fair health,70,6,2,4,14,10,4,6,12,15,3,3,0,0
S01009081,Bad health,21,0,0,0,3,3,2,1,3,7,2,2,0,0
S01009081,Very bad health,7,0,0,0,1,1,0,3,1,1,0,0,0,0
S01009082,All people aged 16 to 74,734,29,6,23,102,110,66,75,131,128,44,25,19,49
S01009082,Very good health,300,16,4,12,48,50,30,30,42,37,13,6,7,34
S01009082,Good health,270,12,2,10,47,38,21,30,54,40,17,9,8,11
S01009082,Fair health,101,1,0,1,4,16,9,8,20,27,12,8,4,4
S01009082,Bad health,49,0,0,0,2,6,6,4,11,18,2,2,0,0
S01009082,Very bad health,14,0,0,0,1,0,0,3,4,6,0,0,0,0
S01009083,All people aged 16 to 74,585,24,7,17,111,90,36,61,106,94,33,20,13,30
S01009083,Very good health,269,16,3,13,65,45,14,30,46,28,7,4,3,18
S01009083,Good health,185,7,4,3,25,26,11,22,37,33,13,6,7,11
S01009083,Fair health,81,1,0,1,13,10,7,6,14,21,8,5,3,1
S01009083,Bad health,37,0,0,0,5,7,3,3,8,7,4,4,0,0
S01009083,Very bad health,13,0,0,0,3,2,1,0,1,5,1,1,0,0
S01009084,All people aged 16 to 74,347,26,7,19,78,48,53,23,48,39,14,9,5,18
S01009084,Very good health,181,15,6,9,45,26,26,10,23,13,6,4,2,17
S01009084,Good health,122,9,1,8,25,17,20,8,15,22,5,3,2,1
S01009084,Fair health,29,2,0,2,6,2,5,4,7,1,2,1,1,0
S01009084,Bad health,10,0,0,0,1,2,1,1,3,1,1,1,0,0
S01009084,Very bad health,5,0,0,0,1,1,1,0,0,2,0,0,0,0
S01009085,All people aged 16 to 74,572,54,9,45,163,109,35,46,56,58,10,6,4,41
S01009085,Very good health,370,43,5,38,113,66,25,27,27,34,3,2,1,32
S01009085,Good health,168,9,4,5,40,37,9,16,22,20,6,3,3,9
S01009085,Fair health,27,2,0,2,8,4,1,2,6,3,1,1,0,0
S01009085,Bad health,6,0,0,0,2,1,0,1,1,1,0,0,0,0
S01009085,Very bad health,1,0,0,0,0,1,0,0,0,0,0,0,0,0
S01009086,All people aged 16 to 74,524,23,4,19,98,77,39,61,91,85,27,14,13,23
S01009086,Very good health,216,12,1,11,51,33,17,22,31,27,6,2,4,17
S01009086,Good health,186,7,2,5,34,31,12,25,39,25,7,4,3,6
S01009086,Fair health,71,4,1,3,7,7,8,8,14,17,6,2,4,0
S01009086,Bad health,43,0,0,0,5,6,2,3,6,13,8,6,2,0
S01009086,Very bad health,8,0,0,0,1,0,0,3,1,3,0,0,0,0
S01009087,All people aged 16 to 74,455,19,4,15,62,55,24,49,111,86,21,9,12,28
S01009087,Very good health,191,7,0,7,26,30,10,23,44,22,5,2,3,24
S01009087,Good health,156,7,3,4,21,13,7,14,48,35,8,4,4,3
S01009087,Fair health,87,4,1,3,12,7,5,11,16,24,7,2,5,1
S01009087,Bad health,14,0,0,0,2,4,2,1,2,2,1,1,0,0
S01009087,Very bad health,7,1,0,1,1,1,0,0,1,3,0,0,0,0
S01009088,All people aged 16 to 74,782,76,20,56,200,123,80,61,91,83,22,13,9,46
S01009088,Very good health,415,44,10,34,112,70,38,24,44,35,7,3,4,41
S01009088,Good health,256,24,7,17,67,35,30,26,35,25,10,6,4,4
S01009088,Fair health,79,7,3,4,17,13,8,8,7,14,4,3,1,1
S01009088,Bad health,26,1,0,1,2,5,4,2,3,9,0,0,0,0
S01009088,Very bad health,6,0,0,0,2,0,0,1,2,0,1,1,0,0
S01009089,All people aged 16 to 74,672,116,35,81,202,99,49,45,59,30,11,7,4,61
S01009089,Very good health,452,84,26,58,137,65,29,33,34,14,5,4,1,51
S01009089,Good health,175,28,8,20,46,28,16,11,20,12,4,1,3,10
S01009089,Fair health,35,4,1,3,14,6,2,1,4,3,1,1,0,0
S01009089,Bad health,8,0,0,0,4,0,2,0,1,1,0,0,0,0
S01009089,Very bad health,2,0,0,0,1,0,0,0,0,0,1,1,0,0
S01009090,All people aged 16 to 74,634,114,16,98,215,102,44,31,55,40,20,19,1,13
S01009090,Very good health,384,74,9,65,147,70,23,17,19,19,3,3,0,12
S01009090,Good health,189,35,5,30,57,26,18,8,22,13,9,8,1,1
S01009090,Fair health,48,5,2,3,9,6,2,2,10,7,7,7,0,0
S01009090,Bad health,8,0,0,0,2,0,1,3,1,1,0,0,0,0
S01009090,Very bad health,5,0,0,0,0,0,0,1,3,0,1,1,0,0
S01009091,All people aged 16 to 74,474,102,18,84,173,53,30,28,28,13,10,4,6,37
S01009091,Very good health,322,83,12,71,105,43,13,18,17,6,2,2,0,35
S01009091,Good health,122,15,4,11,53,7,15,10,9,5,6,1,5,2
S01009091,Fair health,19,3,1,2,10,2,1,0,2,1,0,0,0,0
S01009091,Bad health,7,0,0,0,4,1,1,0,0,0,1,1,0,0
S01009091,Very bad health,4,1,1,0,1,0,0,0,0,1,1,0,1,0
S01009092,All people aged 16 to 74,780,77,22,55,173,121,47,82,113,94,22,9,13,51
S01009092,Very good health,354,39,6,33,96,51,20,35,38,26,10,6,4,39
S01009092,Good health,264,27,11,16,48,47,16,29,43,35,8,0,8,11
S01009092,Fair health,116,8,4,4,22,18,11,12,22,20,2,1,1,1
S01009092,Bad health,33,3,1,2,7,4,0,3,5,10,1,1,0,0
S01009092,Very bad health,13,0,0,0,0,1,0,3,5,3,1,1,0,0
S01009093,All people aged 16 to 74,570,17,3,14,102,81,40,45,113,101,32,13,19,39
S01009093,Very good health,276,10,1,9,54,38,21,17,56,40,9,6,3,31
S01009093,Good health,172,6,1,5,30,28,11,17,32,32,9,2,7,7
S01009093,Fair health,84,1,1,0,10,11,8,7,19,18,9,2,7,1
S01009093,Bad health,31,0,0,0,7,3,0,3,6,8,4,2,2,0
S01009093,Very bad health,7,0,0,0,1,1,0,1,0,3,1,1,0,0
S01009094,All people aged 16 to 74,489,66,16,50,183,68,23,36,52,30,8,7,1,23
S01009094,Very good health,259,39,11,28,104,28,13,18,20,12,4,4,0,21
S01009094,Good health,178,21,4,17,64,30,7,14,26,14,0,0,0,2
S01009094,Fair health,39,6,1,5,13,7,2,4,2,2,3,2,1,0
S01009094,Bad health,9,0,0,0,1,2,0,0,4,2,0,0,0,0
S01009094,Very bad health,4,0,0,0,1,1,1,0,0,0,1,1,0,0
S01009095,All people aged 16 to 74,593,61,13,48,151,66,56,41,84,59,39,31,8,36
S01009095,Very good health,304,47,8,39,83,31,23,21,36,23,10,6,4,30
S01009095,Good health,190,7,1,6,52,24,25,8,31,15,24,22,2,4
S01009095,Fair health,69,5,3,2,11,6,6,11,11,13,4,2,2,2
S01009095,Bad health,26,2,1,1,4,4,2,1,6,6,1,1,0,0
S01009095,Very bad health,4,0,0,0,1,1,0,0,0,2,0,0,0,0
S01009096,All people aged 16 to 74,675,109,21,88,206,107,44,38,76,49,17,14,3,29
S01009096,Very good health,404,80,14,66,128,66,23,19,43,16,2,1,1,27
S01009096,Good health,187,27,7,20,63,31,12,11,18,16,8,7,1,1
S01009096,Fair health,57,2,0,2,11,7,6,6,8,13,3,2,1,1
S01009096,Bad health,21,0,0,0,4,2,3,2,7,2,1,1,0,0
S01009096,Very bad health,6,0,0,0,0,1,0,0,0,2,3,3,0,0
S01009097,All people aged 16 to 74,661,84,16,68,219,101,32,52,65,40,13,7,6,55
S01009097,Very good health,385,53,9,44,127,55,14,26,38,19,5,1,4,48
S01009097,Good health,199,25,6,19,73,36,12,17,16,12,2,1,1,6
S01009097,Fair health,57,5,0,5,16,9,3,7,7,6,3,3,0,1
S01009097,Bad health,17,0,0,0,2,1,3,2,3,3,3,2,1,0
S01009097,Very bad health,3,1,1,0,1,0,0,0,1,0,0,0,0,0
S01009098,All people aged 16 to 74,386,50,15,35,129,47,29,27,40,18,12,7,5,34
S01009098,Very good health,204,28,7,21,71,19,14,17,16,7,3,2,1,29
S01009098,Good health,135,18,7,11,47,20,12,6,16,6,5,1,4,5
S01009098,Fair health,36,4,1,3,10,5,3,3,5,5,1,1,0,0
S01009098,Bad health,11,0,0,0,1,3,0,1,3,0,3,3,0,0
S01009098,Very bad health,0,0,0,0,0,0,0,0,0,0,0,0,0,0
S01009099,All people aged 16 to 74,564,33,10,23,120,82,33,51,89,88,30,26,4,38
S01009099,Very good health,250,15,4,11,59,36,14,27,34,31,5,4,1,29
S01009099,Good health,211,14,3,11,46,34,11,16,35,37,11,11,0,7
S01009099,Fair health,78,3,2,1,11,11,5,6,14,14,13,10,3,1
S01009099,Bad health,20,1,1,0,3,0,2,2,5,5,1,1,0,1
S01009099,Very bad health,5,0,0,0,1,1,1,0,1,1,0,0,0,0
S01009100,All people aged 16 to 74,539,22,8,14,88,62,40,55,100,91,56,50,6,25
S01009100,Very good health,177,9,2,7,37,20,13,26,35,20,4,3,1,13
S01009100,Good health,215,8,4,4,37,31,13,21,38,43,14,10,4,10
S01009100,Fair health,102,3,2,1,10,9,11,6,19,17,26,25,1,1
S01009100,Bad health,37,2,0,2,4,1,2,2,7,8,10,10,0,1
S01009100,Very bad health,8,0,0,0,0,1,1,0,1,3,2,2,0,0
S01009101,All people aged 16 to 74,706,22,8,14,97,79,39,73,169,141,41,19,22,45
S01009101,Very good health,283,11,4,7,42,36,14,29,60,47,11,5,6,33
S01009101,Good health,259,7,3,4,40,30,14,27,67,48,18,6,12,8
S01009101,Fair health,98,4,1,3,9,5,6,8,26,30,8,6,2,2
S01009101,Bad health,55,0,0,0,6,8,5,7,15,9,3,1,2,2
S01009101,Very bad health,11,0,0,0,0,0,0,2,1,7,1,1,0,0
S01009102,All people aged 16 to 74,572,11,2,9,58,70,22,54,129,124,62,41,21,42
S01009102,Very good health,233,6,0,6,30,30,5,21,42,48,25,16,9,26
S01009102,Good health,205,2,0,2,19,28,12,22,52,46,11,8,3,13
S01009102,Fair health,91,3,2,1,8,10,3,7,23,15,19,10,9,3
S01009102,Bad health,35,0,0,0,1,2,2,3,11,9,7,7,0,0
S01009102,Very bad health,8,0,0,0,0,0,0,1,1,6,0,0,0,0
S01009103,All people aged 16 to 74,437,29,7,22,113,79,16,45,68,38,9,5,4,40
S01009103,Very good health,212,13,2,11,57,43,3,20,27,21,3,3,0,25
S01009103,Good health,164,12,4,8,46,19,13,17,31,10,3,1,2,13
S01009103,Fair health,45,2,1,1,8,13,0,5,9,5,2,0,2,1
S01009103,Bad health,12,2,0,2,1,3,0,3,1,2,0,0,0,0
S01009103,Very bad health,4,0,0,0,1,1,0,0,0,0,1,1,0,1
S01009104,All people aged 16 to 74,603,24,8,16,120,91,30,67,117,93,18,12,6,43
S01009104,Very good health,250,13,2,11,57,35,11,26,39,34,4,3,1,31
S01009104,Good health,229,9,6,3,43,33,15,29,51,33,8,4,4,8
S01009104,Fair health,77,1,0,1,15,15,2,8,15,17,1,1,0,3
S01009104,Bad health,33,0,0,0,3,7,1,2,8,9,2,2,0,1
S01009104,Very bad health,14,1,0,1,2,1,1,2,4,0,3,2,1,0
S01009105,All people aged 16 to 74,592,38,9,29,152,101,40,51,88,69,17,13,4,36
S01009105,Very good health,304,21,3,18,93,53,15,18,45,27,4,2,2,28
S01009105,Good health,180,15,5,10,41,29,14,22,26,21,5,5,0,7
S01009105,Fair health,66,0,0,0,12,13,5,5,12,12,6,4,2,1
S01009105,Bad health,35,2,1,1,5,6,5,4,5,7,1,1,0,0
S01009105,Very bad health,7,0,0,0,1,0,1,2,0,2,1,1,0,0
S01009106,All people aged 16 to 74,403,14,1,13,84,69,22,44,68,76,15,5,10,11
S01009106,Very good health,181,7,0,7,38,32,13,16,25,36,4,2,2,10
S01009106,Good health,144,6,1,5,30,28,6,15,27,23,8,2,6,1
S01009106,Fair health,53,0,0,0,9,5,3,10,12,12,2,0,2,0
S01009106,Bad health,23,1,0,1,7,3,0,3,3,5,1,1,0,0
S01009106,Very bad health,2,0,0,0,0,1,0,0,1,0,0,0,0,0
S01009107,All people aged 16 to 74,625,63,16,47,160,103,22,63,88,67,21,13,8,38
S01009107,Very good health,327,43,10,33,91,57,12,21,36,30,9,5,4,28
S01009107,Good health,215,20,6,14,54,36,6,33,32,23,1,0,1,10
S01009107,Fair health,58,0,0,0,10,5,4,5,16,12,6,4,2,0
S01009107,Bad health,20,0,0,0,3,5,0,2,4,2,4,3,1,0
S01009107,Very bad health,5,0,0,0,2,0,0,2,0,0,1,1,0,0
S01009108,All people aged 16 to 74,561,53,15,38,148,101,31,58,75,56,9,6,3,30
S01009108,Very good health,296,27,4,23,89,52,16,27,38,21,1,0,1,25
S01009108,Good health,206,19,10,9,49,38,14,25,26,25,5,3,2,5
S01009108,Fair health,45,4,0,4,9,10,0,5,7,8,2,2,0,0
S01009108,Bad health,12,3,1,2,1,1,1,1,4,0,1,1,0,0
S01009108,Very bad health,2,0,0,0,0,0,0,0,0,2,0,0,0,0
S01009109,All people aged 16 to 74,546,54,9,45,148,88,29,55,77,39,5,4,1,51
S01009109,Very good health,272,21,4,17,64,46,10,21,42,22,3,2,1,43
S01009109,Good health,208,25,5,20,69,31,15,21,24,14,2,2,0,7
S01009109,Fair health,47,3,0,3,11,9,3,7,11,2,0,0,0,1
S01009109,Bad health,17,4,0,4,4,2,1,5,0,1,0,0,0,0
S01009109,Very bad health,2,1,0,1,0,0,0,1,0,0,0,0,0,0
S01009110,All people aged 16 to 74,453,21,2,19,90,84,32,46,75,71,10,5,5,24
S01009110,Very good health,202,15,2,13,37,38,17,20,32,24,1,0,1,18
S01009110,Good health,157,4,0,4,31,37,9,14,27,25,6,2,4,4
S01009110,Fair health,70,1,0,1,15,9,3,8,11,19,2,2,0,2
S01009110,Bad health,18,1,0,1,3,0,2,4,5,3,0,0,0,0
S01009110,Very bad health,6,0,0,0,4,0,1,0,0,0,1,1,0,0
S01009111,All people aged 16 to 74,668,56,12,44,179,117,47,64,80,59,18,10,8,48
S01009111,Very good health,359,32,6,26,102,67,15,41,31,24,8,3,5,39
S01009111,Good health,224,20,5,15,57,38,22,20,33,21,5,2,3,8
S01009111,Fair health,54,3,0,3,13,8,8,1,9,9,3,3,0,0
S01009111,Bad health,22,1,1,0,5,3,0,2,5,5,1,1,0,0
S01009111,Very bad health,9,0,0,0,2,1,2,0,2,0,1,1,0,1
S01009112,All people aged 16 to 74,421,54,11,43,129,58,33,39,52,31,3,3,0,22
S01009112,Very good health,209,25,6,19,64,29,14,19,25,15,0,0,0,18
S01009112,Good health,151,24,5,19,48,19,10,17,18,9,3,3,0,3
S01009112,Fair health,52,3,0,3,15,8,9,3,7,6,0,0,0,1
S01009112,Bad health,8,2,0,2,2,1,0,0,2,1,0,0,0,0
S01009112,Very bad health,1,0,0,0,0,1,0,0,0,0,0,0,0,0
S01009113,All people aged 16 to 74,681,52,14,38,185,114,57,70,87,65,15,11,4,36
S01009113,Very good health,350,34,10,24,107,62,20,31,33,28,4,3,1,31
S01009113,Good health,234,13,3,10,59,36,24,31,39,22,5,2,3,5
S01009113,Fair health,72,5,1,4,13,11,10,5,10,12,6,6,0,0
S01009113,Bad health,21,0,0,0,4,5,2,3,4,3,0,0,0,0
S01009113,Very bad health,4,0,0,0,2,0,1,0,1,0,0,0,0,0
S01009114,All people aged 16 to 74,597,40,10,30,126,85,40,62,83,97,18,10,8,46
S01009114,Very good health,328,26,4,22,77,51,8,33,41,47,5,3,2,40
S01009114,Good health,176,10,5,5,36,23,21,22,28,26,4,1,3,6
S01009114,Fair health,72,4,1,3,12,8,10,4,11,17,6,3,3,0
S01009114,Bad health,17,0,0,0,1,3,0,3,2,6,2,2,0,0
S01009114,Very bad health,4,0,0,0,0,0,1,0,1,1,1,1,0,0
S01009115,All people aged 16 to 74,455,32,4,28,118,68,27,41,69,56,5,3,2,39
S01009115,Very good health,240,17,2,15,67,34,11,24,33,22,3,1,2,29
S01009115,Good health,146,12,2,10,37,24,8,12,23,19,1,1,0,10
S01009115,Fair health,49,3,0,3,10,7,6,2,10,11,0,0,0,0
S01009115,Bad health,15,0,0,0,2,3,2,1,3,3,1,1,0,0
S01009115,Very bad health,5,0,0,0,2,0,0,2,0,1,0,0,0,0
S01009116,All people aged 16 to 74,387,34,10,24,99,76,18,41,59,23,7,3,4,30
S01009116,Very good health,216,18,4,14,59,35,10,22,33,11,4,2,2,24
S01009116,Good health,127,13,4,9,28,33,5,12,20,9,2,1,1,5
S01009116,Fair health,35,3,2,1,10,6,3,5,4,2,1,0,1,1
S01009116,Bad health,8,0,0,0,1,2,0,2,2,1,0,0,0,0
S01009116,Very bad health,1,0,0,0,1,0,0,0,0,0,0,0,0,0
S01009117,All people aged 16 to 74,639,33,7,26,113,122,41,68,99,96,34,18,16,33
S01009117,Very good health,288,18,3,15,63,59,23,25,33,33,7,4,3,27
S01009117,Good health,229,11,3,8,41,38,11,25,41,41,16,6,10,5
S01009117,Fair health,90,4,1,3,4,21,3,15,17,16,9,6,3,1
S01009117,Bad health,26,0,0,0,4,3,2,3,8,4,2,2,0,0
S01009117,Very bad health,6,0,0,0,1,1,2,0,0,2,0,0,0,0
S01009118,All people aged 16 to 74,459,41,9,32,114,81,28,54,48,41,7,5,2,45
S01009118,Very good health,284,30,5,25,73,52,12,30,27,20,1,0,1,39
S01009118,Good health,138,11,4,7,34,23,11,19,16,16,4,3,1,4
S01009118,Fair health,26,0,0,0,6,3,2,5,3,4,1,1,0,2
S01009118,Bad health,8,0,0,0,1,2,2,0,2,0,1,1,0,0
S01009118,Very bad health,3,0,0,0,0,1,1,0,0,1,0,0,0,0
S01009119,All people aged 16 to 74,560,13,3,10,53,65,33,78,116,131,41,24,17,30
S01009119,Very good health,222,10,3,7,19,30,18,27,43,44,11,6,5,20
S01009119,Good health,201,2,0,2,17,23,8,31,42,50,20,10,10,8
S01009119,Fair health,96,1,0,1,12,10,6,14,19,28,5,3,2,1
S01009119,Bad health,28,0,0,0,2,1,1,6,9,6,2,2,0,1
S01009119,Very bad health,13,0,0,0,3,1,0,0,3,3,3,3,0,0
S01009120,All people aged 16 to 74,408,15,2,13,67,39,23,42,85,88,24,15,9,25
S01009120,Very good health,154,6,0,6,31,24,7,16,22,26,4,3,1,18
S01009120,Good health,158,5,0,5,24,9,9,19,47,31,9,5,4,5
S01009120,Fair health,58,3,1,2,8,5,4,3,10,18,6,3,3,1
S01009120,Bad health,28,0,0,0,4,0,3,4,3,11,2,1,1,1
S01009120,Very bad health,10,1,1,0,0,1,0,0,3,2,3,3,0,0
S01009121,All people aged 16 to 74,627,24,4,20,84,88,35,72,124,150,22,9,13,28
S01009121,Very good health,247,10,0,10,38,43,19,27,42,46,3,2,1,19
S01009121,Good health,236,7,2,5,31,34,14,25,51,54,12,4,8,8
S01009121,Fair health,100,5,1,4,11,9,1,15,21,35,2,1,1,1
S01009121,Bad health,38,2,1,1,3,2,1,5,9,11,5,2,3,0
S01009121,Very bad health,6,0,0,0,1,0,0,0,1,4,0,0,0,0
S01009122,All people aged 16 to 74,719,58,13,45,161,81,68,73,109,99,29,10,19,41
S01009122,Very good health,318,32,6,26,86,32,36,25,41,30,7,5,2,29
S01009122,Good health,247,15,2,13,52,32,21,29,37,38,16,3,13,7
S01009122,Fair health,111,10,4,6,17,12,10,9,24,19,5,1,4,5
S01009122,Bad health,33,1,1,0,4,4,1,8,6,8,1,1,0,0
S01009122,Very bad health,10,0,0,0,2,1,0,2,1,4,0,0,0,0
S01009123,All people aged 16 to 74,427,63,18,45,114,45,33,32,47,51,13,8,5,29
S01009123,Very good health,225,33,10,23,69,18,13,15,23,23,5,4,1,26
S01009123,Good health,134,24,6,18,31,20,17,7,13,15,5,2,3,2
S01009123,Fair health,54,5,2,3,9,6,3,10,8,11,1,0,1,1
S01009123,Bad health,12,1,0,1,5,1,0,0,2,2,1,1,0,0
S01009123,Very bad health,2,0,0,0,0,0,0,0,1,0,1,1,0,0
S01009124,All people aged 16 to 74,391,29,4,25,95,58,39,33,64,58,5,4,1,10
S01009124,Very good health,187,18,0,18,57,31,16,19,21,16,2,2,0,7
S01009124,Good health,141,8,3,5,28,20,18,9,26,27,2,1,1,3
S01009124,Fair health,44,2,0,2,7,6,4,4,11,10,0,0,0,0
S01009124,Bad health,17,0,0,0,3,1,1,1,6,4,1,1,0,0
S01009124,Very bad health,2,1,1,0,0,0,0,0,0,1,0,0,0,0
S01009125,All people aged 16 to 74,490,25,6,19,93,53,27,55,90,103,30,18,12,14
S01009125,Very good health,214,14,3,11,37,27,14,23,38,43,8,6,2,10
S01009125,Good health,163,8,1,7,39,16,5,16,29,38,10,3,7,2
S01009125,Fair health,78,3,2,1,11,8,7,6,15,16,10,7,3,2
S01009125,Bad health,31,0,0,0,5,2,1,9,8,6,0,0,0,0
S01009125,Very bad health,4,0,0,0,1,0,0,1,0,0,2,2,0,0
S01009126,All people aged 16 to 74,428,8,2,6,37,37,18,39,95,99,68,39,29,27
S01009126,Very good health,171,4,1,3,18,16,6,17,33,37,21,13,8,19
S01009126,Good health,151,3,1,2,11,15,9,12,35,35,23,11,12,8
S01009126,Fair health,69,1,0,1,7,6,3,4,17,15,16,8,8,0
S01009126,Bad health,28,0,0,0,1,0,0,6,7,8,6,5,1,0
S01009126,Very bad health,9,0,0,0,0,0,0,0,3,4,2,2,0,0
S01009127,All people aged 16 to 74,444,7,1,6,57,46,21,50,105,78,42,13,29,38
S01009127,Very good health,162,4,1,3,20,15,8,20,38,25,7,2,5,25
S01009127,Good health,160,3,0,3,26,23,9,15,37,21,16,4,12,10
S01009127,Fair health,86,0,0,0,6,6,1,12,19,26,14,2,12,2
S01009127,Bad health,24,0,0,0,2,0,2,2,7,5,5,5,0,1
S01009127,Very bad health,12,0,0,0,3,2,1,1,4,1,0,0,0,0
S01009128,All people aged 16 to 74,587,15,3,12,55,60,35,63,117,147,79,51,28,16
S01009128,Very good health,202,9,2,7,17,24,11,31,31,45,21,14,7,13
S01009128,Good health,206,3,0,3,24,25,16,23,46,40,27,14,13,2
S01009128,Fair health,113,2,1,1,8,8,5,8,27,34,20,12,8,1
S01009128,Bad health,53,0,0,0,5,2,3,1,12,21,9,9,0,0
S01009128,Very bad health,13,1,0,1,1,1,0,0,1,7,2,2,0,0
S01009129,All people aged 16 to 74,367,8,3,5,40,41,11,32,99,84,32,20,12,20
S01009129,Very good health,151,4,2,2,16,22,8,13,36,25,10,4,6,17
S01009129,Good health,125,2,1,1,17,12,0,10,39,30,12,9,3,3
S01009129,Fair health,54,2,0,2,6,3,3,4,11,18,7,5,2,0
S01009129,Bad health,34,0,0,0,1,4,0,5,11,10,3,2,1,0
S01009129,Very bad health,3,0,0,0,0,0,0,0,2,1,0,0,0,0
S01009130,All people aged 16 to 74,474,20,4,16,95,53,30,43,88,78,37,26,11,30
S01009130,Very good health,225,15,3,12,52,27,13,18,37,29,15,10,5,19
S01009130,Good health,181,3,1,2,36,19,14,14,38,33,13,9,4,11
S01009130,Fair health,43,2,0,2,6,5,1,6,10,7,6,4,2,0
S01009130,Bad health,20,0,0,0,1,0,2,4,2,9,2,2,0,0
S01009130,Very bad health,5,0,0,0,0,2,0,1,1,0,1,1,0,0
S01009131,All people aged 16 to 74,370,17,3,14,43,51,21,40,75,83,25,14,11,15
S01009131,Very good health,151,10,2,8,18,23,5,15,34,29,4,2,2,13
S01009131,Good health,130,6,1,5,15,20,8,15,27,29,9,6,3,1
S01009131,Fair health,67,0,0,0,10,6,4,7,11,20,8,2,6,1
S01009131,Bad health,19,1,0,1,0,2,4,2,3,4,3,3,0,0
S01009131,Very bad health,3,0,0,0,0,0,0,1,0,1,1,1,0,0
S01009132,All people aged 16 to 74,615,56,13,43,165,111,30,46,85,56,23,9,14,43
S01009132,Very good health,321,31,8,23,92,60,15,20,36,23,8,4,4,36
S01009132,Good health,222,22,4,18,62,36,10,22,33,23,10,4,6,4
S01009132,Fair health,55,2,1,1,8,11,5,4,14,6,3,0,3,2
S01009132,Bad health,15,1,0,1,3,4,0,0,1,3,2,1,1,1
S01009132,Very bad health,2,0,0,0,0,0,0,0,1,1,0,0,0,0
S01009133,All people aged 16 to 74,450,8,4,4,57,59,25,54,87,112,31,15,16,17
S01009133,Very good health,182,5,2,3,29,25,8,25,33,39,6,2,4,12
S01009133,Good health,151,3,2,1,18,23,9,18,32,32,12,6,6,4
S01009133,Fair health,65,0,0,0,4,7,6,8,12,18,9,3,6,1
S01009133,Bad health,38,0,0,0,4,3,1,2,6,18,4,4,0,0
S01009133,Very bad health,14,0,0,0,2,1,1,1,4,5,0,0,0,0
S01009134,All people aged 16 to 74,689,54,21,33,148,104,34,62,120,103,23,6,17,41
S01009134,Very good health,312,33,12,21,63,48,13,28,51,41,5,0,5,30
S01009134,Good health,269,16,6,10,65,38,12,26,49,42,11,4,7,10
S01009134,Fair health,73,3,1,2,13,11,8,6,14,12,5,1,4,1
S01009134,Bad health,24,2,2,0,4,5,0,0,4,7,2,1,1,0
S01009134,Very bad health,11,0,0,0,3,2,1,2,2,1,0,0,0,0
S01009135,All people aged 16 to 74,441,38,4,34,111,73,26,49,50,43,21,15,6,30
S01009135,Very good health,238,21,2,19,66,41,15,22,26,20,6,4,2,21
S01009135,Good health,162,14,1,13,43,26,7,22,19,18,6,3,3,7
S01009135,Fair health,34,2,1,1,1,5,3,4,5,5,7,7,0,2
S01009135,Bad health,6,1,0,1,1,1,0,1,0,0,2,1,1,0
S01009135,Very bad health,1,0,0,0,0,0,1,0,0,0,0,0,0,0
S01009136,All people aged 16 to 74,515,49,10,39,148,78,43,29,55,48,19,16,3,46
S01009136,Very good health,287,34,7,27,86,46,23,12,25,16,5,4,1,40
S01009136,Good health,171,13,2,11,47,23,15,14,24,19,10,9,1,6
S01009136,Fair health,43,2,1,1,12,7,4,3,2,10,3,2,1,0
S01009136,Bad health,11,0,0,0,3,1,1,0,2,3,1,1,0,0
S01009136,Very bad health,3,0,0,0,0,1,0,0,2,0,0,0,0,0
S01009137,All people aged 16 to 74,435,59,21,38,152,75,29,26,41,20,4,3,1,29
S01009137,Very good health,294,40,15,25,98,54,19,19,21,16,2,1,1,25
S01009137,Good health,126,19,6,13,51,19,8,6,15,3,1,1,0,4
S01009137,Fair health,13,0,0,0,3,2,2,1,4,1,0,0,0,0
S01009137,Bad health,1,0,0,0,0,0,0,0,0,0,1,1,0,0
S01009137,Very bad health,1,0,0,0,0,0,0,0,1,0,0,0,0,0
S01009138,All people aged 16 to 74,679,74,19,55,175,102,63,60,74,66,24,14,10,41
S01009138,Very good health,326,43,12,31,98,39,23,22,40,24,9,6,3,28
S01009138,Good health,269,27,5,22,60,45,32,25,27,32,9,4,5,12
S01009138,Fair health,67,3,1,2,16,15,7,9,7,7,3,1,2,0
S01009138,Bad health,13,1,1,0,0,2,1,4,0,2,3,3,0,0
S01009138,Very bad health,4,0,0,0,1,1,0,0,0,1,0,0,0,1
S01009139,All people aged 16 to 74,336,16,0,16,53,45,15,20,64,58,43,21,22,22
S01009139,Very good health,138,12,0,12,22,23,6,10,23,15,14,7,7,13
S01009139,Good health,132,2,0,2,23,17,6,9,23,28,15,5,10,9
S01009139,Fair health,37,0,0,0,6,3,3,0,6,9,10,6,4,0
S01009139,Bad health,26,2,0,2,2,2,0,1,10,6,3,2,1,0
S01009139,Very bad health,3,0,0,0,0,0,0,0,2,0,1,1,0,0
S01009140,All people aged 16 to 74,569,39,11,28,102,70,30,62,100,102,34,24,10,30
S01009140,Very good health,238,15,3,12,57,32,9,25,27,39,10,5,5,24
S01009140,Good health,206,19,5,14,30,24,10,27,46,33,12,7,5,5
S01009140,Fair health,72,3,2,1,8,9,8,5,18,15,6,6,0,0
S01009140,Bad health,37,1,1,0,2,2,2,4,7,13,5,5,0,1
S01009140,Very bad health,16,1,0,1,5,3,1,1,2,2,1,1,0,0
S01009141,All people aged 16 to 74,640,33,5,28,96,82,46,73,122,108,56,30,26,24
S01009141,Very good health,240,17,3,14,41,43,17,31,41,24,11,6,5,15
S01009141,Good health,219,11,0,11,38,26,10,21,41,47,19,9,10,6
S01009141,Fair health,100,2,1,1,9,7,14,9,23,18,16,8,8,2
S01009141,Bad health,58,1,0,1,6,6,3,9,12,15,5,3,2,1
S01009141,Very bad health,23,2,1,1,2,0,2,3,5,4,5,4,1,0
S01009142,All people aged 16 to 74,487,17,2,15,92,61,24,49,86,104,31,11,20,23
S01009142,Very good health,182,11,2,9,38,23,6,20,23,34,10,3,7,17
S01009142,Good health,196,3,0,3,38,24,15,19,34,45,12,6,6,6
S01009142,Fair health,73,3,0,3,9,9,3,6,17,18,8,1,7,0
S01009142,Bad health,31,0,0,0,5,4,0,4,11,6,1,1,0,0
S01009142,Very bad health,5,0,0,0,2,1,0,0,1,1,0,0,0,0
S01009143,All people aged 16 to 74,435,5,1,4,56,50,26,38,93,103,32,22,10,32
S01009143,Very good health,145,2,0,2,17,24,8,14,27,28,3,2,1,22
S01009143,Good health,151,2,1,1,24,12,11,14,31,35,15,9,6,7
S01009143,Fair health,89,0,0,0,10,10,6,6,16,28,10,7,3,3
S01009143,Bad health,39,1,0,1,3,2,1,3,18,8,3,3,0,0
S01009143,Very bad health,11,0,0,0,2,2,0,1,1,4,1,1,0,0
S01009144,All people aged 16 to 74,538,60,9,51,134,96,32,52,59,56,17,12,5,32
S01009144,Very good health,334,43,6,37,94,56,19,31,29,28,9,7,2,25
S01009144,Good health,165,16,2,14,33,30,9,18,25,20,8,5,3,6
S01009144,Fair health,28,1,1,0,6,6,4,2,4,5,0,0,0,0
S01009144,Bad health,8,0,0,0,0,3,0,1,1,2,0,0,0,1
S01009144,Very bad health,3,0,0,0,1,1,0,0,0,1,0,0,0,0
S01009145,All people aged 16 to 74,808,22,6,16,111,108,43,101,182,167,38,24,14,36
S01009145,Very good health,303,16,4,12,55,36,19,29,64,47,10,5,5,27
S01009145,Good health,311,2,0,2,40,53,14,40,75,61,17,10,7,9
S01009145,Fair health,126,3,1,2,14,11,7,20,27,36,8,7,1,0
S01009145,Bad health,49,1,1,0,1,6,2,9,11,17,2,1,1,0
S01009145,Very bad health,19,0,0,0,1,2,1,3,5,6,1,1,0,0
S01009146,All people aged 16 to 74,700,20,1,19,108,87,37,62,137,138,61,37,24,50
S01009146,Very good health,288,9,0,9,46,46,12,22,58,40,21,9,12,34
S01009146,Good health,267,7,1,6,46,28,15,25,50,60,23,17,6,13
S01009146,Fair health,95,4,0,4,14,8,6,8,17,24,11,6,5,3
S01009146,Bad health,41,0,0,0,1,4,4,7,11,10,4,4,0,0
S01009146,Very bad health,9,0,0,0,1,1,0,0,1,4,2,1,1,0
S01009147,All people aged 16 to 74,578,17,2,15,66,63,31,64,121,137,52,33,19,27
S01009147,Very good health,209,9,2,7,21,24,14,21,48,42,14,6,8,16
S01009147,Good health,212,7,0,7,34,25,8,19,37,56,18,12,6,8
S01009147,Fair health,99,1,0,1,8,10,6,18,22,20,12,7,5,2
S01009147,Bad health,36,0,0,0,2,2,1,3,8,13,6,6,0,1
S01009147,Very bad health,22,0,0,0,1,2,2,3,6,6,2,2,0,0
S01009148,All people aged 16 to 74,517,14,9,5,53,43,19,66,111,141,30,17,13,40
S01009148,Very good health,204,8,4,4,21,20,7,23,36,48,8,4,4,33
S01009148,Good health,198,4,3,1,14,14,8,25,48,65,14,8,6,6
S01009148,Fair health,88,2,2,0,13,7,2,15,20,22,6,4,2,1
S01009148,Bad health,22,0,0,0,4,2,1,1,6,6,2,1,1,0
S01009148,Very bad health,5,0,0,0,1,0,1,2,1,0,0,0,0,0
S01009149,All people aged 16 to 74,610,49,11,38,156,93,52,59,86,52,17,11,6,46
S01009149,Very good health,289,32,7,25,87,45,22,23,32,22,2,1,1,24
S01009149,Good health,219,14,3,11,55,30,21,22,29,20,7,4,3,21
S01009149,Fair health,76,2,0,2,14,11,7,10,18,7,6,4,2,1
S01009149,Bad health,16,0,0,0,0,4,1,2,6,2,1,1,0,0
S01009149,Very bad health,10,1,1,0,0,3,1,2,1,1,1,1,0,0
S01009150,All people aged 16 to 74,455,14,2,12,45,65,27,51,112,122,19,14,5,0
S01009150,Very good health,75,4,1,3,10,20,6,8,10,13,4,3,1,0
S01009150,Good health,164,3,1,2,14,23,10,17,47,43,7,5,2,0
S01009150,Fair health,129,3,0,3,11,17,5,14,38,37,4,2,2,0
S01009150,Bad health,71,2,0,2,9,4,4,10,14,24,4,4,0,0
S01009150,Very bad health,16,2,0,2,1,1,2,2,3,5,0,0,0,0
S01009151,All people aged 16 to 74,587,52,9,43,137,88,50,48,78,85,17,12,5,32
S01009151,Very good health,270,33,4,29,71,33,19,21,33,27,9,5,4,24
S01009151,Good health,210,15,4,11,50,39,22,16,28,27,5,4,1,8
S01009151,Fair health,62,2,0,2,11,9,7,8,7,17,1,1,0,0
S01009151,Bad health,34,2,1,1,3,6,2,3,8,10,0,0,0,0
S01009151,Very bad health,11,0,0,0,2,1,0,0,2,4,2,2,0,0
S01009152,All people aged 16 to 74,505,31,5,26,84,87,35,52,80,94,26,14,12,16
S01009152,Very good health,183,14,2,12,36,36,11,16,18,36,8,3,5,8
S01009152,Good health,199,12,2,10,30,33,12,24,34,37,9,2,7,8
S01009152,Fair health,85,4,0,4,12,14,8,8,17,17,5,5,0,0
S01009152,Bad health,33,1,1,0,4,4,4,4,9,4,3,3,0,0
S01009152,Very bad health,5,0,0,0,2,0,0,0,2,0,1,1,0,0
S01009153,All people aged 16 to 74,373,34,0,34,96,55,34,29,49,38,16,7,9,22
S01009153,Very good health,178,21,0,21,41,32,11,12,25,12,9,5,4,15
S01009153,Good health,137,10,0,10,39,14,17,13,17,16,5,0,5,6
S01009153,Fair health,40,3,0,3,11,7,4,2,5,6,1,1,0,1
S01009153,Bad health,16,0,0,0,5,2,2,2,2,2,1,1,0,0
S01009153,Very bad health,2,0,0,0,0,0,0,0,0,2,0,0,0,0
S01009154,All people aged 16 to 74,684,100,18,82,198,93,69,42,61,46,29,24,5,46
S01009154,Very good health,378,64,9,55,115,41,34,20,30,23,10,6,4,41
S01009154,Good health,220,35,9,26,68,37,21,12,23,13,7,6,1,4
S01009154,Fair health,67,1,0,1,12,10,12,9,7,8,8,8,0,0
S01009154,Bad health,13,0,0,0,2,3,2,0,1,2,3,3,0,0
S01009154,Very bad health,6,0,0,0,1,2,0,1,0,0,1,1,0,1
S01009155,All people aged 16 to 74,400,72,14,58,126,43,25,18,49,23,15,10,5,29
S01009155,Very good health,216,42,10,32,73,20,12,8,20,10,6,3,3,25
S01009155,Good health,133,26,4,22,45,17,9,8,12,8,4,4,0,4
S01009155,Fair health,29,4,0,4,5,3,3,1,7,1,5,3,2,0
S01009155,Bad health,14,0,0,0,2,2,0,1,7,2,0,0,0,0
S01009155,Very bad health,8,0,0,0,1,1,1,0,3,2,0,0,0,0
S01009156,All people aged 16 to 74,388,71,9,62,108,53,42,25,27,21,9,3,6,32
S01009156,Very good health,214,42,3,39,59,26,21,12,14,7,4,1,3,29
S01009156,Good health,127,24,6,18,39,18,16,9,8,9,2,1,1,2
S01009156,Fair health,41,5,0,5,9,8,4,3,4,4,3,1,2,1
S01009156,Bad health,6,0,0,0,1,1,1,1,1,1,0,0,0,0
S01009156,Very bad health,0,0,0,0,0,0,0,0,0,0,0,0,0,0
S01009157,All people aged 16 to 74,607,30,4,26,106,83,43,71,112,102,23,17,6,37
S01009157,Very good health,259,16,0,16,51,39,10,21,49,42,4,3,1,27
S01009157,Good health,233,12,2,10,43,33,21,36,39,30,12,8,4,7
S01009157,Fair health,88,1,1,0,11,11,10,8,18,23,4,3,1,2
S01009157,Bad health,23,1,1,0,1,0,2,5,6,5,2,2,0,1
S01009157,Very bad health,4,0,0,0,0,0,0,1,0,2,1,1,0,0
S01009158,All people aged 16 to 74,395,14,1,13,87,70,21,36,77,58,17,10,7,15
S01009158,Very good health,169,9,1,8,45,32,11,11,23,26,3,3,0,9
S01009158,Good health,144,4,0,4,30,26,6,17,34,17,7,2,5,3
S01009158,Fair health,59,1,0,1,9,11,2,6,13,11,4,2,2,2
S01009158,Bad health,18,0,0,0,2,1,2,1,7,3,1,1,0,1
S01009158,Very bad health,5,0,0,0,1,0,0,1,0,1,2,2,0,0
S01009159,All people aged 16 to 74,379,6,0,6,30,44,23,37,97,88,35,20,15,19
S01009159,Very good health,119,5,0,5,12,14,6,10,27,27,9,2,7,9
S01009159,Good health,132,1,0,1,10,18,7,9,34,37,9,4,5,7
S01009159,Fair health,84,0,0,0,4,8,7,11,27,14,11,8,3,2
S01009159,Bad health,29,0,0,0,3,2,2,7,7,5,2,2,0,1
S01009159,Very bad health,15,0,0,0,1,2,1,0,2,5,4,4,0,0
S01009160,All people aged 16 to 74,510,14,5,9,57,62,34,65,111,111,36,21,15,20
S01009160,Very good health,192,8,4,4,27,30,10,24,33,38,8,2,6,14
S01009160,Good health,178,2,0,2,19,19,7,26,50,36,15,8,7,4
S01009160,Fair health,95,3,0,3,6,9,13,8,21,25,9,8,1,1
S01009160,Bad health,41,1,1,0,5,4,3,7,6,11,4,3,1,0
S01009160,Very bad health,4,0,0,0,0,0,1,0,1,1,0,0,0,1
S01009161,All people aged 16 to 74,468,10,1,9,43,52,17,53,121,103,47,18,29,22
S01009161,Very good health,160,5,0,5,17,19,3,22,32,34,13,4,9,15
S01009161,Good health,180,3,1,2,17,17,8,17,49,41,21,6,15,7
S01009161,Fair health,79,2,0,2,5,9,4,8,29,12,10,5,5,0
S01009161,Bad health,40,0,0,0,3,7,2,6,8,11,3,3,0,0
S01009161,Very bad health,9,0,0,0,1,0,0,0,3,5,0,0,0,0
S01009162,All people aged 16 to 74,579,13,2,11,99,79,17,61,100,133,58,39,19,19
S01009162,Very good health,225,8,2,6,55,29,6,22,36,44,10,7,3,15
S01009162,Good health,212,3,0,3,32,36,8,20,31,51,28,19,9,3
S01009162,Fair health,100,2,0,2,9,11,3,10,21,26,17,11,6,1
S01009162,Bad health,30,0,0,0,3,2,0,7,10,7,1,1,0,0
S01009162,Very bad health,12,0,0,0,0,1,0,2,2,5,2,1,1,0
S01009163,All people aged 16 to 74,369,27,3,24,89,47,17,37,70,40,25,16,9,17
S01009163,Very good health,167,10,1,9,53,17,7,12,31,20,8,7,1,9
S01009163,Good health,131,13,1,12,24,25,8,11,23,9,11,3,8,7
S01009163,Fair health,54,3,1,2,10,3,1,11,13,8,4,4,0,1
S01009163,Bad health,13,1,0,1,1,2,1,2,3,2,1,1,0,0
S01009163,Very bad health,4,0,0,0,1,0,0,1,0,1,1,1,0,0
S01009164,All people aged 16 to 74,557,12,5,7,67,66,27,81,112,129,26,14,12,37
S01009164,Very good health,208,7,2,5,34,30,5,26,35,44,5,2,3,22
S01009164,Good health,221,4,3,1,30,25,9,30,44,52,15,8,7,12
S01009164,Fair health,91,1,0,1,1,9,9,17,24,23,4,2,2,3
S01009164,Bad health,27,0,0,0,2,1,3,3,8,8,2,2,0,0
S01009164,Very bad health,10,0,0,0,0,1,1,5,1,2,0,0,0,0
S01009165,All people aged 16 to 74,543,15,3,12,68,71,26,52,108,113,48,28,20,42
S01009165,Very good health,205,7,2,5,23,31,7,18,43,34,14,10,4,28
S01009165,Good health,207,7,1,6,29,25,10,25,41,42,15,6,9,13
S01009165,Fair health,89,1,0,1,7,11,3,7,18,25,16,9,7,1
S01009165,Bad health,29,0,0,0,7,4,3,2,3,7,3,3,0,0
S01009165,Very bad health,13,0,0,0,2,0,3,0,3,5,0,0,0,0
S01009166,All people aged 16 to 74,627,12,2,10,61,61,31,55,143,165,64,40,24,35
S01009166,Very good health,189,5,1,4,20,19,9,19,44,45,15,9,6,13
S01009166,Good health,240,4,1,3,24,26,10,21,52,63,20,9,11,20
S01009166,Fair health,124,2,0,2,14,12,7,11,25,29,22,16,6,2
S01009166,Bad health,51,1,0,1,2,4,3,1,15,20,5,4,1,0
S01009166,Very bad health,23,0,0,0,1,0,2,3,7,8,2,2,0,0
S01009167,All people aged 16 to 74,389,7,2,5,38,43,26,40,80,97,38,26,12,20
S01009167,Very good health,154,5,1,4,21,17,3,15,33,31,14,7,7,15
S01009167,Good health,136,2,1,1,9,15,17,17,34,28,9,6,3,5
S01009167,Fair health,67,0,0,0,4,7,5,6,10,29,6,4,2,0
S01009167,Bad health,23,0,0,0,3,3,0,2,3,5,7,7,0,0
S01009167,Very bad health,9,0,0,0,1,1,1,0,0,4,2,2,0,0
S01009168,All people aged 16 to 74,508,58,16,42,147,77,30,49,72,43,5,3,2,27
S01009168,Very good health,253,30,6,24,70,42,18,20,26,23,1,0,1,23
S01009168,Good health,191,20,6,14,64,29,7,19,37,10,2,1,1,3
S01009168,Fair health,53,8,4,4,12,6,5,9,5,7,1,1,0,0
S01009168,Bad health,8,0,0,0,0,0,0,1,3,3,0,0,0,1
S01009168,Very bad health,3,0,0,0,1,0,0,0,1,0,1,1,0,0
S01009169,All people aged 16 to 74,528,20,5,15,81,65,30,80,105,97,24,14,10,26
S01009169,Very good health,190,12,1,11,36,29,11,25,26,20,14,8,6,17
S01009169,Good health,167,6,3,3,30,14,9,27,40,30,3,2,1,8
S01009169,Fair health,104,0,0,0,12,15,6,16,25,24,5,2,3,1
S01009169,Bad health,49,1,1,0,2,7,3,10,12,13,1,1,0,0
S01009169,Very bad health,18,1,0,1,1,0,1,2,2,10,1,1,0,0
S01009170,All people aged 16 to 74,518,16,2,14,65,68,37,48,101,114,39,17,22,30
S01009170,Very good health,217,11,0,11,30,27,14,16,48,38,14,8,6,19
S01009170,Good health,193,3,1,2,27,29,17,18,29,45,15,4,11,10
S01009170,Fair health,73,2,1,1,4,7,5,10,16,19,9,4,5,1
S01009170,Bad health,31,0,0,0,3,3,1,4,8,12,0,0,0,0
S01009170,Very bad health,4,0,0,0,1,2,0,0,0,0,1,1,0,0
S01009171,All people aged 16 to 74,517,22,4,18,81,66,38,50,92,100,40,13,27,28
S01009171,Very good health,208,9,3,6,34,31,12,24,33,38,8,2,6,19
S01009171,Good health,220,9,1,8,37,26,19,21,39,44,16,4,12,9
S01009171,Fair health,64,4,0,4,6,8,6,4,14,12,10,4,6,0
S01009171,Bad health,14,0,0,0,0,1,1,1,5,2,4,2,2,0
S01009171,Very bad health,11,0,0,0,4,0,0,0,1,4,2,1,1,0
S01009172,All people aged 16 to 74,504,109,19,90,168,60,35,25,26,27,9,6,3,45
S01009172,Very good health,313,73,14,59,105,34,19,10,14,15,3,2,1,40
S01009172,Good health,142,24,3,21,53,19,13,9,10,6,4,3,1,4
S01009172,Fair health,39,10,2,8,8,7,2,4,2,3,2,1,1,1
S01009172,Bad health,9,2,0,2,2,0,1,2,0,2,0,0,0,0
S01009172,Very bad health,1,0,0,0,0,0,0,0,0,1,0,0,0,0
S01009173,All people aged 16 to 74,584,94,25,69,160,99,36,55,65,35,7,5,2,33
S01009173,Very good health,320,59,18,41,98,47,19,18,32,15,3,1,2,29
S01009173,Good health,207,26,6,20,53,39,12,32,24,13,4,4,0,4
S01009173,Fair health,47,8,0,8,9,10,5,3,6,6,0,0,0,0
S01009173,Bad health,6,1,1,0,0,3,0,1,0,1,0,0,0,0
S01009173,Very bad health,4,0,0,0,0,0,0,1,3,0,0,0,0,0
S01009174,All people aged 16 to 74,343,62,17,45,112,48,31,20,27,12,11,4,7,20
S01009174,Very good health,218,43,13,30,72,30,20,11,16,8,5,1,4,13
S01009174,Good health,109,17,4,13,35,12,11,7,10,4,6,3,3,7
S01009174,Fair health,15,2,0,2,5,5,0,2,1,0,0,0,0,0
S01009174,Bad health,0,0,0,0,0,0,0,0,0,0,0,0,0,0
S01009174,Very bad health,1,0,0,0,0,1,0,0,0,0,0,0,0,0
S01009175,All people aged 16 to 74,629,117,31,86,203,103,39,47,46,23,10,6,4,41
S01009175,Very good health,418,87,24,63,130,69,25,27,29,11,2,0,2,38
S01009175,Good health,172,26,7,19,61,31,8,17,14,9,3,1,2,3
S01009175,Fair health,32,4,0,4,10,1,5,3,2,2,5,5,0,0
S01009175,Bad health,6,0,0,0,1,2,1,0,1,1,0,0,0,0
S01009175,Very bad health,1,0,0,0,1,0,0,0,0,0,0,0,0,0
S01009176,All people aged 16 to 74,679,131,29,102,199,108,47,59,61,25,17,11,6,32
S01009176,Very good health,396,94,17,77,124,54,19,26,32,8,8,6,2,31
S01009176,Good health,215,28,9,19,61,41,23,25,19,10,7,3,4,1
S01009176,Fair health,58,7,3,4,13,13,4,7,7,6,1,1,0,0
S01009176,Bad health,8,2,0,2,0,0,0,1,3,1,1,1,0,0
S01009176,Very bad health,2,0,0,0,1,0,1,0,0,0,0,0,0,0
S01009177,All people aged 16 to 74,629,21,6,15,95,86,50,80,110,105,44,25,19,38
S01009177,Very good health,226,10,3,7,39,32,10,25,35,35,16,8,8,24
S01009177,Good health,247,7,0,7,36,38,29,31,41,39,14,8,6,12
S01009177,Fair health,103,4,3,1,13,9,7,17,24,19,8,4,4,2
S01009177,Bad health,38,0,0,0,6,4,3,5,8,8,4,3,1,0
S01009177,Very bad health,15,0,0,0,1,3,1,2,2,4,2,2,0,0
S01009178,All people aged 16 to 74,549,13,4,9,70,63,35,64,106,108,51,31,20,39
S01009178,Very good health,201,6,1,5,29,16,10,23,41,35,17,9,8,24
S01009178,Good health,236,7,3,4,32,37,12,30,43,38,22,11,11,15
S01009178,Fair health,79,0,0,0,6,5,9,5,18,28,8,7,1,0
S01009178,Bad health,24,0,0,0,1,4,3,4,2,7,3,3,0,0
S01009178,Very bad health,9,0,0,0,2,1,1,2,2,0,1,1,0,0
S01009179,All people aged 16 to 74,522,14,1,13,94,79,29,46,107,91,30,14,16,32
S01009179,Very good health,222,7,0,7,43,26,8,19,46,33,12,4,8,28
S01009179,Good health,189,4,0,4,37,35,11,18,38,36,7,2,5,3
S01009179,Fair health,80,2,0,2,10,13,9,9,14,15,7,4,3,1
S01009179,Bad health,25,1,1,0,4,5,1,0,7,5,2,2,0,0
S01009179,Very bad health,6,0,0,0,0,0,0,0,2,2,2,2,0,0
S01009180,All people aged 16 to 74,742,24,9,15,101,96,49,82,164,155,35,21,14,36
S01009180,Very good health,306,11,3,8,40,50,21,33,61,60,4,0,4,26
S01009180,Good health,260,9,4,5,32,29,14,27,67,58,14,7,7,10
S01009180,Fair health,127,3,1,2,20,11,9,18,29,27,10,7,3,0
S01009180,Bad health,42,1,1,0,8,6,4,4,5,9,5,5,0,0
S01009180,Very bad health,7,0,0,0,1,0,1,0,2,1,2,2,0,0
S01009181,All people aged 16 to 74,634,22,6,16,78,72,54,74,120,140,34,17,17,40
S01009181,Very good health,279,13,3,10,37,28,23,29,48,60,12,5,7,29
S01009181,Good health,225,7,2,5,32,30,19,28,48,39,14,8,6,8
S01009181,Fair health,95,1,0,1,8,11,11,13,16,28,5,2,3,2
S01009181,Bad health,23,1,1,0,0,1,1,4,6,9,1,0,1,0
S01009181,Very bad health,12,0,0,0,1,2,0,0,2,4,2,2,0,1
S01009182,All people aged 16 to 74,754,47,10,37,180,105,72,73,112,103,25,6,19,37
S01009182,Very good health,401,27,5,22,103,56,30,35,58,44,14,4,10,34
S01009182,Good health,243,15,3,12,55,37,29,24,40,34,7,0,7,2
S01009182,Fair health,79,2,2,0,15,10,9,12,13,15,2,1,1,1
S01009182,Bad health,24,2,0,2,6,2,3,1,1,7,2,1,1,0
S01009182,Very bad health,7,1,0,1,1,0,1,1,0,3,0,0,0,0
S01009183,All people aged 16 to 74,585,51,8,43,167,95,35,57,66,48,11,4,7,55
S01009183,Very good health,342,32,8,24,96,52,18,38,35,22,4,2,2,45
S01009183,Good health,185,14,0,14,54,33,16,15,21,19,4,0,4,9
S01009183,Fair health,45,4,0,4,15,7,1,3,7,4,3,2,1,1
S01009183,Bad health,11,1,0,1,2,3,0,0,3,2,0,0,0,0
S01009183,Very bad health,2,0,0,0,0,0,0,1,0,1,0,0,0,0
S01009184,All people aged 16 to 74,628,38,9,29,88,67,75,54,110,110,56,29,27,30
S01009184,Very good health,273,21,3,18,44,34,34,23,43,32,18,12,6,24
S01009184,Good health,203,10,3,7,27,22,27,20,38,37,19,10,9,3
S01009184,Fair health,98,7,3,4,9,6,9,7,19,24,14,4,10,3
S01009184,Bad health,45,0,0,0,8,5,5,3,7,13,4,2,2,0
S01009184,Very bad health,9,0,0,0,0,0,0,1,3,4,1,1,0,0
S01009185,All people aged 16 to 74,652,34,6,28,94,75,67,58,144,107,36,21,15,37
S01009185,Very good health,288,15,3,12,40,36,31,23,63,32,18,12,6,30
S01009185,Good health,210,13,2,11,33,25,23,19,49,34,8,4,4,6
S01009185,Fair health,104,5,1,4,14,12,9,9,23,24,8,3,5,0
S01009185,Bad health,39,1,0,1,5,2,2,6,9,12,1,1,0,1
S01009185,Very bad health,11,0,0,0,2,0,2,1,0,5,1,1,0,0
S01009186,All people aged 16 to 74,609,36,4,32,99,80,49,62,112,99,35,16,19,37
S01009186,Very good health,277,25,2,23,51,37,20,25,42,42,8,3,5,27
S01009186,Good health,221,10,2,8,39,30,19,24,46,30,15,6,9,8
S01009186,Fair health,77,1,0,1,8,8,9,8,13,20,8,4,4,2
S01009186,Bad health,24,0,0,0,1,4,1,3,6,7,2,2,0,0
S01009186,Very bad health,10,0,0,0,0,1,0,2,5,0,2,1,1,0
S01009187,All people aged 16 to 74,387,52,12,40,100,47,61,30,43,26,5,5,0,23
S01009187,Very good health,204,34,8,26,60,15,30,11,20,12,2,2,0,20
S01009187,Good health,121,12,2,10,30,23,25,10,12,7,1,1,0,1
S01009187,Fair health,43,4,1,3,5,4,5,7,10,4,2,2,0,2
S01009187,Bad health,16,2,1,1,5,5,0,1,1,2,0,0,0,0
S01009187,Very bad health,3,0,0,0,0,0,1,1,0,1,0,0,0,0
S01009188,All people aged 16 to 74,661,39,6,33,113,70,75,65,116,105,36,23,13,42
S01009188,Very good health,268,20,2,18,51,31,35,30,37,26,11,5,6,27
S01009188,Good health,243,13,2,11,36,26,23,18,53,49,13,9,4,12
S01009188,Fair health,108,5,2,3,23,9,14,10,17,16,11,8,3,3
S01009188,Bad health,31,1,0,1,2,3,2,5,6,11,1,1,0,0
S01009188,Very bad health,11,0,0,0,1,1,1,2,3,3,0,0,0,0
S01009189,All people aged 16 to 74,551,21,3,18,58,52,37,61,140,121,43,26,17,18
S01009189,Very good health,221,16,2,14,23,22,14,22,59,42,8,7,1,15
S01009189,Good health,197,4,0,4,22,19,12,22,51,49,16,6,10,2
S01009189,Fair health,84,1,1,0,6,7,7,13,17,20,12,8,4,1
S01009189,Bad health,42,0,0,0,7,3,3,3,13,7,6,4,2,0
S01009189,Very bad health,7,0,0,0,0,1,1,1,0,3,1,1,0,0
S01009190,All people aged 16 to 74,604,72,13,59,157,106,60,54,60,38,21,16,5,36
S01009190,Very good health,346,42,6,36,100,48,32,26,29,26,9,6,3,34
S01009190,Good health,204,22,6,16,50,49,25,23,20,7,6,5,1,2
S01009190,Fair health,36,7,1,6,5,5,1,2,8,3,5,5,0,0
S01009190,Bad health,13,0,0,0,0,3,2,3,3,2,0,0,0,0
S01009190,Very bad health,5,1,0,1,2,1,0,0,0,0,1,0,1,0
S01009191,All people aged 16 to 74,495,78,20,58,169,82,33,29,35,20,5,3,2,44
S01009191,Very good health,341,55,14,41,124,52,17,19,22,11,3,1,2,38
S01009191,Good health,128,19,5,14,39,23,15,10,10,5,1,1,0,6
S01009191,Fair health,21,3,1,2,5,5,1,0,3,4,0,0,0,0
S01009191,Bad health,4,0,0,0,1,2,0,0,0,0,1,1,0,0
S01009191,Very bad health,1,1,0,1,0,0,0,0,0,0,0,0,0,0
S01009192,All people aged 16 to 74,951,37,13,24,125,75,60,79,135,182,216,206,10,42
S01009192,Very good health,431,12,5,7,60,41,25,42,54,74,94,91,3,29
S01009192,Good health,401,22,6,16,49,24,26,29,63,82,99,95,4,7
S01009192,Fair health,88,2,1,1,12,5,7,6,15,18,19,18,1,4
S01009192,Bad health,29,0,0,0,4,4,2,2,3,8,4,2,2,2
S01009192,Very bad health,2,1,1,0,0,1,0,0,0,0,0,0,0,0
S01009193,All people aged 16 to 74,239,26,7,19,85,37,11,25,25,16,3,3,0,11
S01009193,Very good health,139,21,5,16,52,24,7,13,9,8,0,0,0,5
S01009193,Good health,80,4,2,2,30,10,2,9,14,7,1,1,0,3
S01009193,Fair health,17,1,0,1,3,2,2,2,1,1,2,2,0,3
S01009193,Bad health,3,0,0,0,0,1,0,1,1,0,0,0,0,0
S01009193,Very bad health,0,0,0,0,0,0,0,0,0,0,0,0,0,0
S01009194,All people aged 16 to 74,619,78,17,61,187,98,44,58,60,37,9,4,5,48
S01009194,Very good health,338,50,10,40,95,48,25,30,29,16,2,0,2,43
S01009194,Good health,207,22,7,15,74,38,12,19,22,12,3,1,2,5
S01009194,Fair health,59,5,0,5,12,10,7,6,7,8,4,3,1,0
S01009194,Bad health,11,1,0,1,4,2,0,2,2,0,0,0,0,0
S01009194,Very bad health,4,0,0,0,2,0,0,1,0,1,0,0,0,0
S01009195,All people aged 16 to 74,621,101,21,80,206,96,31,51,56,38,7,4,3,35
S01009195,Very good health,388,74,12,62,138,64,20,21,26,15,2,1,1,28
S01009195,Good health,170,23,9,14,52,27,8,18,23,10,2,1,1,7
S01009195,Fair health,51,4,0,4,13,3,3,11,6,10,1,1,0,0
S01009195,Bad health,8,0,0,0,2,1,0,1,0,3,1,0,1,0
S01009195,Very bad health,4,0,0,0,1,1,0,0,1,0,1,1,0,0
S01009196,All people aged 16 to 74,528,39,4,35,102,77,50,54,82,58,19,15,4,47
S01009196,Very good health,241,20,2,18,51,34,26,17,35,16,5,5,0,37
S01009196,Good health,201,13,2,11,40,30,16,28,31,26,7,3,4,10
S01009196,Fair health,64,4,0,4,8,10,6,7,9,14,6,6,0,0
S01009196,Bad health,16,1,0,1,2,3,0,2,5,2,1,1,0,0
S01009196,Very bad health,6,1,0,1,1,0,2,0,2,0,0,0,0,0
S01009197,All people aged 16 to 74,745,111,15,96,242,112,60,42,64,59,18,12,6,37
S01009197,Very good health,418,81,14,67,139,51,29,19,32,26,13,10,3,28
S01009197,Good health,256,27,1,26,85,50,22,17,22,24,3,1,2,6
S01009197,Fair health,50,3,0,3,11,9,6,5,7,5,2,1,1,2
S01009197,Bad health,18,0,0,0,7,2,3,1,1,3,0,0,0,1
S01009197,Very bad health,3,0,0,0,0,0,0,0,2,1,0,0,0,0
S01009198,All people aged 16 to 74,557,53,10,43,168,95,46,48,55,41,14,5,9,37
S01009198,Very good health,301,31,7,24,95,51,24,24,25,17,2,1,1,32
S01009198,Good health,188,17,3,14,56,34,16,16,25,12,7,4,3,5
S01009198,Fair health,49,3,0,3,15,9,3,4,4,6,5,0,5,0
S01009198,Bad health,16,2,0,2,2,1,1,4,1,5,0,0,0,0
S01009198,Very bad health,3,0,0,0,0,0,2,0,0,1,0,0,0,0
S01009199,All people aged 16 to 74,452,40,9,31,131,76,37,42,47,36,13,8,5,30
S01009199,Very good health,223,21,3,18,75,36,19,18,11,16,4,1,3,23
S01009199,Good health,165,14,4,10,44,28,13,14,27,14,5,4,1,6
S01009199,Fair health,39,4,1,3,8,7,3,2,7,4,3,2,1,1
S01009199,Bad health,19,1,1,0,4,3,1,7,2,1,0,0,0,0
S01009199,Very bad health,6,0,0,0,0,2,1,1,0,1,1,1,0,0
S01009200,All people aged 16 to 74,817,136,35,101,207,124,47,69,90,75,26,21,5,43
S01009200,Very good health,457,92,21,71,126,64,27,32,40,34,5,2,3,37
S01009200,Good health,262,34,10,24,61,45,12,30,39,24,11,10,1,6
S01009200,Fair health,73,7,2,5,16,7,8,6,8,13,8,7,1,0
S01009200,Bad health,19,2,1,1,3,6,0,1,2,3,2,2,0,0
S01009200,Very bad health,6,1,1,0,1,2,0,0,1,1,0,0,0,0
S01009201,All people aged 16 to 74,502,15,2,13,90,61,38,48,98,80,32,16,16,40
S01009201,Very good health,238,7,2,5,46,28,17,25,43,35,13,8,5,24
S01009201,Good health,175,8,0,8,28,22,17,16,31,26,12,5,7,15
S01009201,Fair health,63,0,0,0,12,9,4,5,17,9,6,2,4,1
S01009201,Bad health,18,0,0,0,4,2,0,2,2,7,1,1,0,0
S01009201,Very bad health,8,0,0,0,0,0,0,0,5,3,0,0,0,0
S01009202,All people aged 16 to 74,373,41,9,32,118,61,27,23,45,24,10,5,5,24
S01009202,Very good health,235,28,8,20,73,40,18,16,23,13,6,4,2,18
S01009202,Good health,110,11,1,10,39,16,6,4,19,7,3,1,2,5
S01009202,Fair health,24,1,0,1,5,5,3,2,3,3,1,0,1,1
S01009202,Bad health,3,0,0,0,1,0,0,1,0,1,0,0,0,0
S01009202,Very bad health,1,1,0,1,0,0,0,0,0,0,0,0,0,0
S01009203,All people aged 16 to 74,442,14,1,13,57,41,33,48,102,98,32,18,14,17
S01009203,Very good health,154,9,1,8,25,13,11,16,32,26,9,4,5,13
S01009203,Good health,142,4,0,4,15,14,13,15,36,30,11,5,6,4
S01009203,Fair health,76,0,0,0,7,8,5,12,13,23,8,5,3,0
S01009203,Bad health,46,1,0,1,6,4,3,3,15,11,3,3,0,0
S01009203,Very bad health,24,0,0,0,4,2,1,2,6,8,1,1,0,0
S01009204,All people aged 16 to 74,657,42,10,32,121,91,48,48,103,111,33,24,9,60
S01009204,Very good health,323,22,5,17,69,42,19,28,46,37,13,11,2,47
S01009204,Good health,218,13,3,10,34,38,20,14,32,47,11,8,3,9
S01009204,Fair health,81,5,2,3,10,8,7,3,22,17,6,3,3,3
S01009204,Bad health,25,2,0,2,5,2,1,2,3,7,2,1,1,1
S01009204,Very bad health,10,0,0,0,3,1,1,1,0,3,1,1,0,0
S01009205,All people aged 16 to 74,587,67,16,51,162,104,40,44,61,56,13,8,5,40
S01009205,Very good health,312,40,8,32,84,54,23,26,24,23,2,2,0,36
S01009205,Good health,209,22,7,15,61,40,13,11,27,24,7,2,5,4
S01009205,Fair health,48,3,1,2,14,6,2,6,7,7,3,3,0,0
S01009205,Bad health,14,2,0,2,3,3,1,1,2,1,1,1,0,0
S01009205,Very bad health,4,0,0,0,0,1,1,0,1,1,0,0,0,0
S01009206,All people aged 16 to 74,663,75,24,51,202,127,25,65,73,39,17,8,9,40
S01009206,Very good health,362,41,14,27,117,68,17,36,30,14,4,1,3,35
S01009206,Good health,232,29,8,21,70,47,4,20,32,16,9,3,6,5
S01009206,Fair health,55,5,2,3,14,10,2,5,8,9,2,2,0,0
S01009206,Bad health,12,0,0,0,1,2,2,2,3,0,2,2,0,0
S01009206,Very bad health,2,0,0,0,0,0,0,2,0,0,0,0,0,0
S01009207,All people aged 16 to 74,629,75,12,63,195,123,34,71,69,40,4,0,4,18
S01009207,Very good health,338,41,5,36,112,70,12,35,31,20,2,0,2,15
S01009207,Good health,218,25,6,19,63,44,11,26,28,16,2,0,2,3
S01009207,Fair health,59,8,0,8,19,8,8,6,8,2,0,0,0,0
S01009207,Bad health,10,1,1,0,1,1,1,3,2,1,0,0,0,0
S01009207,Very bad health,4,0,0,0,0,0,2,1,0,1,0,0,0,0
S01009208,All people aged 16 to 74,478,55,9,46,124,73,24,48,64,40,12,6,6,38
S01009208,Very good health,234,32,5,27,67,40,11,15,24,15,2,1,1,28
S01009208,Good health,147,18,2,16,39,19,8,15,24,13,2,0,2,9
S01009208,Fair health,73,5,2,3,13,8,3,14,13,8,8,5,3,1
S01009208,Bad health,17,0,0,0,4,6,2,2,2,1,0,0,0,0
S01009208,Very bad health,7,0,0,0,1,0,0,2,1,3,0,0,0,0
S01009209,All people aged 16 to 74,458,57,12,45,140,77,28,36,50,42,7,2,5,21
S01009209,Very good health,245,39,6,33,82,37,15,17,20,16,2,1,1,17
S01009209,Good health,147,13,4,9,44,26,9,15,19,13,4,0,4,4
S01009209,Fair health,55,4,2,2,10,14,2,4,9,11,1,1,0,0
S01009209,Bad health,10,1,0,1,4,0,2,0,2,1,0,0,0,0
S01009209,Very bad health,1,0,0,0,0,0,0,0,0,1,0,0,0,0
S01009210,All people aged 16 to 74,429,54,12,42,125,73,39,30,57,28,9,6,3,14
S01009210,Very good health,238,39,9,30,74,38,19,11,30,11,4,2,2,12
S01009210,Good health,142,12,3,9,41,29,15,15,17,10,2,2,0,1
S01009210,Fair health,32,3,0,3,5,4,4,3,6,5,2,1,1,0
S01009210,Bad health,12,0,0,0,5,1,1,0,2,2,0,0,0,1
S01009210,Very bad health,5,0,0,0,0,1,0,1,2,0,1,1,0,0
S01009211,All people aged 16 to 74,468,35,7,28,79,83,35,47,66,64,21,9,12,38
S01009211,Very good health,234,24,6,18,38,44,18,24,34,19,6,3,3,27
S01009211,Good health,166,8,0,8,30,30,8,20,22,27,11,2,9,10
S01009211,Fair health,47,2,1,1,9,8,3,3,7,13,1,1,0,1
S01009211,Bad health,19,1,0,1,2,1,6,0,3,4,2,2,0,0
S01009211,Very bad health,2,0,0,0,0,0,0,0,0,1,1,1,0,0
S01009212,All people aged 16 to 74,618,19,10,9,82,85,40,66,130,139,27,20,7,30
S01009212,Very good health,262,8,4,4,37,34,17,27,52,53,8,6,2,26
S01009212,Good health,210,6,4,2,25,32,8,26,52,48,10,6,4,3
S01009212,Fair health,92,2,2,0,14,8,11,8,14,25,9,8,1,1
S01009212,Bad health,38,2,0,2,3,10,2,5,7,9,0,0,0,0
S01009212,Very bad health,16,1,0,1,3,1,2,0,5,4,0,0,0,0
S01009213,All people aged 16 to 74,637,17,4,13,99,72,46,76,119,137,31,22,9,40
S01009213,Very good health,296,11,3,8,49,35,22,40,50,48,10,6,4,31
S01009213,Good health,200,4,0,4,30,24,15,21,46,46,7,4,3,7
S01009213,Fair health,104,2,1,1,16,7,6,13,19,29,12,11,1,0
S01009213,Bad health,29,0,0,0,4,4,3,1,4,10,1,0,1,2
S01009213,Very bad health,8,0,0,0,0,2,0,1,0,4,1,1,0,0
S01009214,All people aged 16 to 74,741,72,15,57,196,136,42,61,99,74,17,10,7,44
S01009214,Very good health,390,40,7,33,112,66,20,30,45,34,7,5,2,36
S01009214,Good health,265,24,5,19,64,58,16,26,36,26,7,3,4,8
S01009214,Fair health,56,6,3,3,14,8,3,2,12,9,2,1,1,0
S01009214,Bad health,24,2,0,2,5,3,2,3,4,5,0,0,0,0
S01009214,Very bad health,6,0,0,0,1,1,1,0,2,0,1,1,0,0
S01009215,All people aged 16 to 74,685,29,5,24,113,88,38,68,135,126,45,24,21,43
S01009215,Very good health,278,14,2,12,47,40,20,26,49,37,13,5,8,32
S01009215,Good health,267,14,3,11,51,37,12,22,55,47,19,11,8,10
S01009215,Fair health,84,1,0,1,13,6,4,10,22,20,8,5,3,0
S01009215,Bad health,45,0,0,0,1,5,1,7,8,17,5,3,2,1
S01009215,Very bad health,11,0,0,0,1,0,1,3,1,5,0,0,0,0
S01009216,All people aged 16 to 74,692,19,6,13,97,91,41,95,141,140,25,19,6,43
S01009216,Very good health,295,7,2,5,52,42,14,33,54,48,9,6,3,36
S01009216,Good health,245,9,3,6,33,34,18,34,50,58,4,3,1,5
S01009216,Fair health,105,2,0,2,10,13,8,19,22,21,8,7,1,2
S01009216,Bad health,36,0,0,0,2,2,1,7,13,9,2,2,0,0
S01009216,Very bad health,11,1,1,0,0,0,0,2,2,4,2,1,1,0
S01009217,All people aged 16 to 74,460,12,2,10,52,46,33,41,103,104,43,27,16,26
S01009217,Very good health,162,9,2,7,24,10,11,8,35,30,14,7,7,21
S01009217,Good health,168,2,0,2,18,23,9,21,50,28,14,7,7,3
S01009217,Fair health,83,1,0,1,4,9,7,9,11,27,13,11,2,2
S01009217,Bad health,36,0,0,0,4,4,4,2,6,14,2,2,0,0
S01009217,Very bad health,11,0,0,0,2,0,2,1,1,5,0,0,0,0
S01009218,All people aged 16 to 74,607,39,14,25,128,101,39,61,97,88,17,11,6,37
S01009218,Very good health,271,21,6,15,67,48,16,22,36,33,3,1,2,25
S01009218,Good health,237,14,6,8,37,41,19,32,38,34,10,7,3,12
S01009218,Fair health,67,4,2,2,20,10,2,3,16,10,2,1,1,0
S01009218,Bad health,25,0,0,0,2,2,2,4,5,9,1,1,0,0
S01009218,Very bad health,7,0,0,0,2,0,0,0,2,2,1,1,0,0
S01009219,All people aged 16 to 74,475,9,3,6,67,59,24,50,113,97,32,10,22,24
S01009219,Very good health,194,5,2,3,34,26,10,24,36,33,6,0,6,20
S01009219,Good health,171,3,0,3,21,24,8,15,49,32,15,4,11,4
S01009219,Fair health,78,0,0,0,9,6,1,7,22,24,9,5,4,0
S01009219,Bad health,25,1,1,0,3,3,5,2,2,7,2,1,1,0
S01009219,Very bad health,7,0,0,0,0,0,0,2,4,1,0,0,0,0
S01009220,All people aged 16 to 74,385,18,3,15,47,60,21,39,80,78,24,11,13,18
S01009220,Very good health,150,7,2,5,21,26,6,20,29,26,7,4,3,8
S01009220,Good health,151,7,0,7,16,23,10,13,30,30,14,6,8,8
S01009220,Fair health,61,2,0,2,9,10,3,3,16,14,3,1,2,1
S01009220,Bad health,19,1,1,0,1,1,1,2,5,7,0,0,0,1
S01009220,Very bad health,4,1,0,1,0,0,1,1,0,1,0,0,0,0
S01009221,All people aged 16 to 74,399,11,4,7,44,57,20,49,70,108,21,11,10,19
S01009221,Very good health,164,5,2,3,18,28,12,22,24,39,4,2,2,12
S01009221,Good health,157,3,0,3,13,21,6,21,31,41,14,7,7,7
S01009221,Fair health,57,2,1,1,8,7,2,6,9,20,3,2,1,0
S01009221,Bad health,17,1,1,0,4,1,0,0,5,6,0,0,0,0
S01009221,Very bad health,4,0,0,0,1,0,0,0,1,2,0,0,0,0
S01009222,All people aged 16 to 74,377,7,1,6,33,39,21,44,82,106,19,10,9,26
S01009222,Very good health,134,5,0,5,12,15,4,13,31,33,3,0,3,18
S01009222,Good health,165,0,0,0,17,21,11,16,37,48,9,5,4,6
S01009222,Fair health,50,2,1,1,3,2,5,9,8,12,7,5,2,2
S01009222,Bad health,24,0,0,0,1,1,0,5,5,12,0,0,0,0
S01009222,Very bad health,4,0,0,0,0,0,1,1,1,1,0,0,0,0
S01009223,All people aged 16 to 74,410,14,1,13,54,58,19,44,89,92,14,11,3,26
S01009223,Very good health,180,10,1,9,26,29,8,19,34,29,4,3,1,21
S01009223,Good health,135,2,0,2,18,16,8,15,33,34,4,3,1,5
S01009223,Fair health,66,2,0,2,7,10,1,5,17,21,3,2,1,0
S01009223,Bad health,20,0,0,0,2,3,1,4,3,5,2,2,0,0
S01009223,Very bad health,9,0,0,0,1,0,1,1,2,3,1,1,0,0
S01009224,All people aged 16 to 74,478,14,4,10,54,65,23,58,79,130,31,16,15,24
S01009224,Very good health,185,4,1,3,23,31,8,22,33,37,8,2,6,19
S01009224,Good health,176,5,1,4,22,23,11,20,27,54,10,5,5,4
S01009224,Fair health,72,2,1,1,3,7,2,10,9,28,11,7,4,0
S01009224,Bad health,30,1,0,1,1,3,2,4,9,8,1,1,0,1
S01009224,Very bad health,15,2,1,1,5,1,0,2,1,3,1,1,0,0
S01009225,All people aged 16 to 74,390,8,3,5,52,47,19,58,82,89,15,7,8,20
S01009225,Very good health,156,3,1,2,25,20,12,19,26,29,4,3,1,18
S01009225,Good health,151,2,0,2,19,22,4,26,35,35,6,1,5,2
S01009225,Fair health,54,2,1,1,6,3,0,9,13,17,4,2,2,0
S01009225,Bad health,23,1,1,0,2,1,3,3,5,7,1,1,0,0
S01009225,Very bad health,6,0,0,0,0,1,0,1,3,1,0,0,0,0
S01009226,All people aged 16 to 74,690,19,6,13,120,87,29,68,130,169,49,28,21,19
S01009226,Very good health,266,8,2,6,48,43,13,26,52,52,10,2,8,14
S01009226,Good health,235,6,2,4,45,29,12,23,47,53,16,7,9,4
S01009226,Fair health,98,3,1,2,13,9,2,10,12,38,10,6,4,1
S01009226,Bad health,68,2,1,1,11,4,2,7,15,19,8,8,0,0
S01009226,Very bad health,23,0,0,0,3,2,0,2,4,7,5,5,0,0
S01009227,All people aged 16 to 74,425,11,2,9,70,75,19,62,83,76,13,3,10,16
S01009227,Very good health,202,7,2,5,31,41,12,23,38,30,6,0,6,14
S01009227,Good health,130,3,0,3,24,22,3,20,27,23,6,3,3,2
S01009227,Fair health,63,1,0,1,11,9,1,13,13,14,1,0,1,0
S01009227,Bad health,20,0,0,0,4,2,2,4,3,5,0,0,0,0
S01009227,Very bad health,10,0,0,0,0,1,1,2,2,4,0,0,0,0
S01009228,All people aged 16 to 74,437,10,1,9,52,48,25,38,91,112,38,14,24,23
S01009228,Very good health,166,4,0,4,15,19,13,12,34,35,18,4,14,16
S01009228,Good health,155,5,1,4,22,18,6,15,27,46,9,4,5,7
S01009228,Fair health,79,1,0,1,11,6,2,8,22,21,8,3,5,0
S01009228,Bad health,29,0,0,0,3,5,3,3,6,7,2,2,0,0
S01009228,Very bad health,8,0,0,0,1,0,1,0,2,3,1,1,0,0
S01009229,All people aged 16 to 74,430,17,3,14,97,73,28,46,67,63,14,9,5,25
S01009229,Very good health,190,10,3,7,50,32,10,18,30,21,4,0,4,15
S01009229,Good health,164,5,0,5,32,28,14,19,22,30,5,4,1,9
S01009229,Fair health,48,1,0,1,12,11,4,4,7,6,2,2,0,1
S01009229,Bad health,22,1,0,1,3,0,0,5,6,5,2,2,0,0
S01009229,Very bad health,6,0,0,0,0,2,0,0,2,1,1,1,0,0
S01009230,All people aged 16 to 74,469,20,7,13,106,85,29,52,71,71,17,13,4,18
S01009230,Very good health,237,12,5,7,59,51,17,20,23,33,4,3,1,18
S01009230,Good health,153,5,1,4,34,29,7,20,29,23,6,4,2,0
S01009230,Fair health,55,2,1,1,9,5,1,8,14,10,6,5,1,0
S01009230,Bad health,17,1,0,1,3,0,2,2,3,5,1,1,0,0
S01009230,Very bad health,7,0,0,0,1,0,2,2,2,0,0,0,0,0
S01009231,All people aged 16 to 74,734,42,8,34,146,134,57,90,94,104,23,8,15,44
S01009231,Very good health,336,25,5,20,74,63,18,37,41,35,5,2,3,38
S01009231,Good health,279,12,3,9,53,57,29,36,38,39,9,2,7,6
S01009231,Fair health,83,5,0,5,15,9,8,10,10,22,4,2,2,0
S01009231,Bad health,33,0,0,0,4,4,2,6,4,8,5,2,3,0
S01009231,Very bad health,3,0,0,0,0,1,0,1,1,0,0,0,0,0
S01009232,All people aged 16 to 74,430,10,4,6,45,49,11,47,95,86,59,31,28,28
S01009232,Very good health,150,5,1,4,18,16,0,18,30,28,16,7,9,19
S01009232,Good health,162,4,3,1,20,23,6,17,36,32,16,6,10,8
S01009232,Fair health,86,1,0,1,7,8,2,9,19,17,22,14,8,1
S01009232,Bad health,25,0,0,0,0,2,3,1,8,7,4,4,0,0
S01009232,Very bad health,7,0,0,0,0,0,0,2,2,2,1,0,1,0
S01009233,All people aged 16 to 74,408,13,2,11,61,46,18,47,89,97,17,8,9,20
S01009233,Very good health,159,8,0,8,31,20,5,20,24,29,8,3,5,14
S01009233,Good health,151,5,2,3,17,18,9,15,37,40,4,2,2,6
S01009233,Fair health,68,0,0,0,8,6,2,10,17,22,3,2,1,0
S01009233,Bad health,24,0,0,0,5,1,2,1,8,5,2,1,1,0
S01009233,Very bad health,6,0,0,0,0,1,0,1,3,1,0,0,0,0
S01009234,All people aged 16 to 74,735,13,2,11,60,80,27,89,162,165,78,50,28,61
S01009234,Very good health,279,4,1,3,28,33,7,30,61,49,25,14,11,42
S01009234,Good health,281,9,1,8,21,31,10,35,67,64,30,21,9,14
S01009234,Fair health,118,0,0,0,5,9,7,17,23,36,18,11,7,3
S01009234,Bad health,47,0,0,0,6,5,3,6,7,15,4,4,0,1
S01009234,Very bad health,10,0,0,0,0,2,0,1,4,1,1,0,1,1
S01009235,All people aged 16 to 74,690,21,3,18,105,98,29,75,113,157,52,16,36,40
S01009235,Very good health,273,10,2,8,47,39,11,28,50,54,12,4,8,22
S01009235,Good health,266,7,1,6,38,37,10,29,41,67,24,8,16,13
S01009235,Fair health,103,3,0,3,11,16,5,14,15,25,12,1,11,2
S01009235,Bad health,36,1,0,1,7,6,3,4,3,7,4,3,1,1
S01009235,Very bad health,12,0,0,0,2,0,0,0,4,4,0,0,0,2
S01009236,All people aged 16 to 74,351,23,7,16,74,66,19,39,61,41,13,7,6,15
S01009236,Very good health,152,16,4,12,32,28,9,19,20,14,5,3,2,9
S01009236,Good health,131,5,2,3,27,28,6,14,28,15,2,0,2,6
S01009236,Fair health,54,1,1,0,12,9,4,4,9,12,3,1,2,0
S01009236,Bad health,10,1,0,1,3,1,0,0,3,0,2,2,0,0
S01009236,Very bad health,4,0,0,0,0,0,0,2,1,0,1,1,0,0
S01009237,All people aged 16 to 74,640,48,18,30,172,106,41,86,81,46,14,7,7,46
S01009237,Very good health,371,32,11,21,112,50,20,43,41,26,7,4,3,40
S01009237,Good health,187,14,6,8,50,38,15,24,26,12,3,2,1,5
S01009237,Fair health,60,2,1,1,7,16,3,15,8,5,3,1,2,1
S01009237,Bad health,16,0,0,0,2,1,2,3,4,3,1,0,1,0
S01009237,Very bad health,6,0,0,0,1,1,1,1,2,0,0,0,0,0
S01009238,All people aged 16 to 74,581,14,0,14,81,93,12,77,110,133,32,20,12,29
S01009238,Very good health,251,7,0,7,34,49,2,28,45,50,13,10,3,23
S01009238,Good health,211,4,0,4,33,29,8,33,37,49,14,7,7,4
S01009238,Fair health,84,3,0,3,12,10,2,12,21,18,5,3,2,1
S01009238,Bad health,29,0,0,0,1,5,0,4,6,12,0,0,0,1
S01009238,Very bad health,6,0,0,0,1,0,0,0,1,4,0,0,0,0
S01009239,All people aged 16 to 74,643,13,5,8,100,95,20,86,144,118,27,15,12,40
S01009239,Very good health,292,6,1,5,43,42,10,34,68,47,8,4,4,34
S01009239,Good health,239,7,4,3,42,39,6,38,48,42,12,5,7,5
S01009239,Fair health,73,0,0,0,9,12,4,9,18,16,4,4,0,1
S01009239,Bad health,31,0,0,0,4,2,0,3,10,10,2,2,0,0
S01009239,Very bad health,8,0,0,0,2,0,0,2,0,3,1,0,1,0
S01009240,All people aged 16 to 74,495,8,4,4,41,53,20,54,110,119,59,24,35,31
S01009240,Very good health,206,6,2,4,19,22,8,23,44,43,22,12,10,19
S01009240,Good health,168,1,1,0,11,17,8,20,39,43,20,7,13,9
S01009240,Fair health,84,1,1,0,8,8,4,9,18,20,14,3,11,2
S01009240,Bad health,28,0,0,0,2,6,0,2,7,7,3,2,1,1
S01009240,Very bad health,9,0,0,0,1,0,0,0,2,6,0,0,0,0
S01009241,All people aged 16 to 74,663,10,2,8,77,82,34,65,143,164,55,31,24,33
S01009241,Very good health,266,7,2,5,40,34,14,25,50,51,20,11,9,25
S01009241,Good health,214,2,0,2,21,27,10,20,57,52,17,5,12,8
S01009241,Fair health,127,1,0,1,12,17,8,12,27,36,14,11,3,0
S01009241,Bad health,43,0,0,0,2,3,1,7,7,19,4,4,0,0
S01009241,Very bad health,13,0,0,0,2,1,1,1,2,6,0,0,0,0
S01009242,All people aged 16 to 74,570,28,9,19,127,81,30,79,110,64,20,8,12,31
S01009242,Very good health,297,15,4,11,64,44,14,37,49,41,8,3,5,25
S01009242,Good health,199,11,4,7,47,27,10,33,43,14,8,3,5,6
S01009242,Fair health,61,2,1,1,13,8,6,8,14,8,2,1,1,0
S01009242,Bad health,11,0,0,0,3,1,0,1,4,0,2,1,1,0
S01009242,Very bad health,2,0,0,0,0,1,0,0,0,1,0,0,0,0
S01009243,All people aged 16 to 74,742,28,6,22,126,106,39,96,159,124,26,10,16,38
S01009243,Very good health,314,13,2,11,62,45,12,44,64,33,10,3,7,31
S01009243,Good health,282,13,3,10,43,48,21,30,56,54,10,2,8,7
S01009243,Fair health,92,1,0,1,15,8,2,11,24,27,4,3,1,0
S01009243,Bad health,41,0,0,0,4,3,3,7,13,9,2,2,0,0
S01009243,Very bad health,13,1,1,0,2,2,1,4,2,1,0,0,0,0
S01009244,All people aged 16 to 74,641,59,15,44,163,120,42,70,88,58,10,7,3,31
S01009244,Very good health,322,38,7,31,87,51,15,34,39,29,5,2,3,24
S01009244,Good health,246,19,8,11,64,51,16,29,37,19,4,4,0,7
S01009244,Fair health,49,2,0,2,6,14,6,4,9,8,0,0,0,0
S01009244,Bad health,16,0,0,0,2,2,3,3,3,2,1,1,0,0
S01009244,Very bad health,8,0,0,0,4,2,2,0,0,0,0,0,0,0
S01009245,All people aged 16 to 74,670,51,16,35,164,113,44,63,110,74,13,4,9,38
S01009245,Very good health,337,25,6,19,99,57,21,22,50,28,5,1,4,30
S01009245,Good health,232,17,7,10,47,44,15,21,45,30,6,2,4,7
S01009245,Fair health,75,7,2,5,15,12,5,14,8,11,2,1,1,1
S01009245,Bad health,18,2,1,1,3,0,2,3,5,3,0,0,0,0
S01009245,Very bad health,8,0,0,0,0,0,1,3,2,2,0,0,0,0
S01009246,All people aged 16 to 74,606,19,8,11,83,73,36,84,146,118,21,11,10,26
S01009246,Very good health,240,11,1,10,46,31,11,27,49,45,2,1,1,18
S01009246,Good health,233,6,5,1,27,26,18,37,62,43,8,3,5,6
S01009246,Fair health,86,2,2,0,7,12,4,14,24,17,6,4,2,0
S01009246,Bad health,36,0,0,0,2,3,3,5,9,9,5,3,2,0
S01009246,Very bad health,11,0,0,0,1,1,0,1,2,4,0,0,0,2
S01009247,All people aged 16 to 74,749,30,11,19,107,95,26,99,168,152,30,6,24,42
S01009247,Very good health,348,14,3,11,53,43,7,48,73,64,12,3,9,34
S01009247,Good health,255,10,5,5,40,37,11,37,54,47,13,3,10,6
S01009247,Fair health,102,6,3,3,8,13,7,10,26,27,4,0,4,1
S01009247,Bad health,40,0,0,0,5,2,1,4,15,11,1,0,1,1
S01009247,Very bad health,4,0,0,0,1,0,0,0,0,3,0,0,0,0
S01009248,All people aged 16 to 74,532,25,10,15,121,78,38,68,99,49,13,9,4,41
S01009248,Very good health,268,13,6,7,66,45,12,30,49,20,4,2,2,29
S01009248,Good health,187,8,2,6,45,25,21,21,37,15,3,2,1,12
S01009248,Fair health,56,3,1,2,10,6,4,11,10,8,4,3,1,0
S01009248,Bad health,17,1,1,0,0,1,1,6,2,4,2,2,0,0
S01009248,Very bad health,4,0,0,0,0,1,0,0,1,2,0,0,0,0
S01009249,All people aged 16 to 74,610,25,9,16,73,68,45,62,124,152,36,24,12,25
S01009249,Very good health,266,17,8,9,42,34,21,26,44,50,14,8,6,18
S01009249,Good health,201,6,1,5,21,18,16,21,47,57,8,5,3,7
S01009249,Fair health,98,2,0,2,7,7,5,8,29,30,10,8,2,0
S01009249,Bad health,33,0,0,0,1,9,3,3,3,13,1,1,0,0
S01009249,Very bad health,12,0,0,0,2,0,0,4,1,2,3,2,1,0
S01009250,All people aged 16 to 74,484,25,8,17,65,53,30,59,116,99,17,10,7,20
S01009250,Very good health,195,10,5,5,16,32,14,19,44,36,8,4,4,16
S01009250,Good health,168,11,3,8,36,12,7,20,44,30,4,2,2,4
S01009250,Fair health,85,3,0,3,13,4,8,14,20,20,3,3,0,0
S01009250,Bad health,32,1,0,1,0,4,1,5,7,12,2,1,1,0
S01009250,Very bad health,4,0,0,0,0,1,0,1,1,1,0,0,0,0
S01009251,All people aged 16 to 74,435,29,4,25,79,58,29,43,89,60,18,8,10,30
S01009251,Very good health,211,16,2,14,43,28,11,19,35,26,7,2,5,26
S01009251,Good health,138,10,1,9,27,17,10,12,33,18,7,3,4,4
S01009251,Fair health,64,2,1,1,6,12,5,9,14,13,3,2,1,0
S01009251,Bad health,20,1,0,1,3,1,2,3,7,2,1,1,0,0
S01009251,Very bad health,2,0,0,0,0,0,1,0,0,1,0,0,0,0
S01009252,All people aged 16 to 74,348,45,10,35,101,59,18,32,34,24,6,2,4,29
S01009252,Very good health,234,34,8,26,65,38,8,24,20,16,4,2,2,25
S01009252,Good health,99,10,2,8,33,16,9,7,10,8,2,0,2,4
S01009252,Fair health,13,1,0,1,2,4,1,1,4,0,0,0,0,0
S01009252,Bad health,1,0,0,0,0,1,0,0,0,0,0,0,0,0
S01009252,Very bad health,1,0,0,0,1,0,0,0,0,0,0,0,0,0
S01009253,All people aged 16 to 74,345,8,2,6,35,39,23,52,80,76,9,5,4,23
S01009253,Very good health,126,4,1,3,11,12,11,22,28,18,2,0,2,18
S01009253,Good health,115,2,1,1,13,14,5,14,31,27,4,2,2,5
S01009253,Fair health,65,2,0,2,4,7,4,12,14,21,1,1,0,0
S01009253,Bad health,36,0,0,0,7,5,3,4,6,9,2,2,0,0
S01009253,Very bad health,3,0,0,0,0,1,0,0,1,1,0,0,0,0
S01009254,All people aged 16 to 74,595,20,3,17,64,60,26,67,133,145,53,29,24,27
S01009254,Very good health,231,10,1,9,28,24,9,26,56,49,13,7,6,16
S01009254,Good health,200,9,2,7,22,20,11,27,38,44,19,9,10,10
S01009254,Fair health,99,0,0,0,8,9,4,8,22,30,17,9,8,1
S01009254,Bad health,49,1,0,1,4,5,1,3,16,17,2,2,0,0
S01009254,Very bad health,16,0,0,0,2,2,1,3,1,5,2,2,0,0
S01009255,All people aged 16 to 74,516,39,14,25,91,50,34,55,112,92,32,11,21,11
S01009255,Very good health,220,22,7,15,43,23,14,27,47,27,10,3,7,7
S01009255,Good health,195,14,7,7,36,24,10,16,38,38,16,4,12,3
S01009255,Fair health,74,2,0,2,10,2,8,11,19,17,4,2,2,1
S01009255,Bad health,23,1,0,1,2,1,2,0,6,9,2,2,0,0
S01009255,Very bad health,4,0,0,0,0,0,0,1,2,1,0,0,0,0
S01009256,All people aged 16 to 74,354,28,10,18,93,46,22,38,60,47,9,4,5,11
S01009256,Very good health,162,19,6,13,46,25,8,18,21,13,5,2,3,7
S01009256,Good health,122,7,3,4,31,15,8,10,26,21,2,1,1,2
S01009256,Fair health,45,1,1,0,11,5,3,8,8,5,2,1,1,2
S01009256,Bad health,19,1,0,1,5,1,3,0,3,6,0,0,0,0
S01009256,Very bad health,6,0,0,0,0,0,0,2,2,2,0,0,0,0
S01009257,All people aged 16 to 74,531,43,12,31,104,80,43,46,106,70,21,7,14,18
S01009257,Very good health,245,23,6,17,54,43,21,20,44,25,5,1,4,10
S01009257,Good health,198,15,6,9,40,26,18,17,43,25,8,4,4,6
S01009257,Fair health,61,4,0,4,6,8,4,6,13,14,4,1,3,2
S01009257,Bad health,20,1,0,1,3,3,0,1,5,4,3,0,3,0
S01009257,Very bad health,7,0,0,0,1,0,0,2,1,2,1,1,0,0
S01009258,All people aged 16 to 74,481,69,13,56,125,54,61,36,68,42,11,7,4,15
S01009258,Very good health,228,46,8,38,64,25,26,12,31,13,1,1,0,10
S01009258,Good health,181,17,3,14,47,23,26,17,24,18,4,3,1,5
S01009258,Fair health,51,3,1,2,9,5,9,6,10,6,3,1,2,0
S01009258,Bad health,16,2,1,1,5,0,0,1,2,3,3,2,1,0
S01009258,Very bad health,5,1,0,1,0,1,0,0,1,2,0,0,0,0
S01009259,All people aged 16 to 74,693,94,28,66,178,95,52,58,101,67,12,7,5,36
S01009259,Very good health,347,54,20,34,111,42,19,25,38,21,6,2,4,31
S01009259,Good health,256,35,7,28,55,38,25,21,44,29,4,3,1,5
S01009259,Fair health,70,4,1,3,7,13,7,11,14,13,1,1,0,0
S01009259,Bad health,17,1,0,1,4,2,1,1,4,3,1,1,0,0
S01009259,Very bad health,3,0,0,0,1,0,0,0,1,1,0,0,0,0
S01009260,All people aged 16 to 74,890,60,13,47,162,132,60,81,194,131,31,17,14,39
S01009260,Very good health,452,40,9,31,99,63,33,39,87,45,16,8,8,30
S01009260,Good health,309,17,3,14,45,52,21,28,70,61,7,5,2,8
S01009260,Fair health,97,3,1,2,16,14,5,10,25,17,6,2,4,1
S01009260,Bad health,24,0,0,0,0,2,1,3,10,6,2,2,0,0
S01009260,Very bad health,8,0,0,0,2,1,0,1,2,2,0,0,0,0
S01009261,All people aged 16 to 74,553,32,9,23,79,58,32,66,109,119,30,14,16,28
S01009261,Very good health,233,23,7,16,36,33,12,34,37,27,11,4,7,20
S01009261,Good health,200,6,1,5,31,18,13,22,49,41,13,6,7,7
S01009261,Fair health,78,3,1,2,7,4,1,9,15,34,5,3,2,0
S01009261,Bad health,32,0,0,0,4,2,5,1,7,11,1,1,0,1
S01009261,Very bad health,10,0,0,0,1,1,1,0,1,6,0,0,0,0
S01009262,All people aged 16 to 74,397,7,3,4,43,40,16,40,102,103,19,6,13,27
S01009262,Very good health,156,4,2,2,23,14,7,16,25,38,9,2,7,20
S01009262,Good health,144,3,1,2,15,21,6,11,46,33,6,3,3,3
S01009262,Fair health,59,0,0,0,3,4,3,10,18,17,4,1,3,0
S01009262,Bad health,33,0,0,0,2,0,0,3,11,13,0,0,0,4
S01009262,Very bad health,5,0,0,0,0,1,0,0,2,2,0,0,0,0
S01009263,All people aged 16 to 74,632,95,16,79,210,85,41,41,82,43,14,11,3,21
S01009263,Very good health,398,67,11,56,148,52,22,25,42,18,8,6,2,16
S01009263,Good health,163,25,5,20,50,21,13,13,23,11,2,1,1,5
S01009263,Fair health,57,3,0,3,10,12,4,3,12,11,2,2,0,0
S01009263,Bad health,11,0,0,0,2,0,2,0,4,2,1,1,0,0
S01009263,Very bad health,3,0,0,0,0,0,0,0,1,1,1,1,0,0
S01009264,All people aged 16 to 74,408,28,9,19,100,61,41,36,54,48,14,9,5,26
S01009264,Very good health,214,11,5,6,57,30,16,16,32,22,8,5,3,22
S01009264,Good health,147,16,4,12,35,21,19,16,14,18,4,2,2,4
S01009264,Fair health,32,0,0,0,5,8,5,3,4,5,2,2,0,0
S01009264,Bad health,12,1,0,1,2,2,1,1,3,2,0,0,0,0
S01009264,Very bad health,3,0,0,0,1,0,0,0,1,1,0,0,0,0
S01009265,All people aged 16 to 74,593,34,8,26,117,68,27,70,114,84,34,13,21,45
S01009265,Very good health,289,23,5,18,58,31,9,24,49,38,15,6,9,42
S01009265,Good health,212,9,3,6,41,28,12,29,46,30,14,6,8,3
S01009265,Fair health,70,2,0,2,14,8,4,12,15,11,4,0,4,0
S01009265,Bad health,20,0,0,0,4,1,2,4,3,5,1,1,0,0
S01009265,Very bad health,2,0,0,0,0,0,0,1,1,0,0,0,0,0
S01009266,All people aged 16 to 74,634,33,9,24,98,78,41,82,125,121,31,18,13,25
S01009266,Very good health,258,16,2,14,47,40,12,28,45,42,10,3,7,18
S01009266,Good health,243,10,4,6,36,32,23,31,52,40,13,7,6,6
S01009266,Fair health,90,4,1,3,9,3,5,18,18,29,3,3,0,1
S01009266,Bad health,35,2,2,0,4,3,1,5,8,8,4,4,0,0
S01009266,Very bad health,8,1,0,1,2,0,0,0,2,2,1,1,0,0
S01009267,All people aged 16 to 74,612,51,7,44,126,71,39,69,118,76,33,22,11,29
S01009267,Very good health,282,25,4,21,63,35,16,33,50,28,12,5,7,20
S01009267,Good health,219,18,3,15,45,26,18,20,46,30,10,7,3,6
S01009267,Fair health,86,7,0,7,15,8,4,14,17,12,7,6,1,2
S01009267,Bad health,21,1,0,1,3,2,1,2,2,6,4,4,0,0
S01009267,Very bad health,4,0,0,0,0,0,0,0,3,0,0,0,0,1
S01009268,All people aged 16 to 74,723,45,15,30,141,77,46,69,130,136,32,10,22,47
S01009268,Very good health,346,26,12,14,77,40,26,26,65,41,9,4,5,36
S01009268,Good health,243,13,2,11,50,26,10,32,38,50,15,4,11,9
S01009268,Fair health,89,4,1,3,10,6,7,7,20,28,6,0,6,1
S01009268,Bad health,38,1,0,1,4,5,3,4,7,11,2,2,0,1
S01009268,Very bad health,7,1,0,1,0,0,0,0,0,6,0,0,0,0
S01009269,All people aged 16 to 74,624,13,6,7,61,80,28,63,121,157,57,30,27,44
S01009269,Very good health,258,6,5,1,32,37,11,21,41,57,26,12,14,27
S01009269,Good health,218,6,1,5,21,30,13,22,39,53,20,11,9,14
S01009269,Fair health,113,1,0,1,7,12,4,17,27,34,8,4,4,3
S01009269,Bad health,28,0,0,0,1,1,0,2,12,10,2,2,0,0
S01009269,Very bad health,7,0,0,0,0,0,0,1,2,3,1,1,0,0
S01009270,All people aged 16 to 74,430,11,5,6,40,48,30,35,97,98,41,24,17,30
S01009270,Very good health,149,6,2,4,14,18,11,12,31,23,16,8,8,18
S01009270,Good health,158,5,3,2,16,15,9,15,39,39,12,8,4,8
S01009270,Fair health,89,0,0,0,9,8,9,7,21,23,11,6,5,1
S01009270,Bad health,28,0,0,0,0,6,0,1,6,10,2,2,0,3
S01009270,Very bad health,6,0,0,0,1,1,1,0,0,3,0,0,0,0
S01009271,All people aged 16 to 74,718,52,10,42,187,109,57,68,96,79,17,8,9,53
S01009271,Very good health,355,29,5,24,85,60,32,29,37,33,6,4,2,44
S01009271,Good health,273,21,4,17,78,35,19,30,44,33,6,0,6,7
S01009271,Fair health,64,1,0,1,18,11,6,5,8,10,4,3,1,1
S01009271,Bad health,19,1,1,0,2,3,0,3,7,3,0,0,0,0
S01009271,Very bad health,7,0,0,0,4,0,0,1,0,0,1,1,0,1
S01009272,All people aged 16 to 74,526,7,0,7,56,58,29,50,128,111,47,29,18,40
S01009272,Very good health,196,2,0,2,22,23,12,18,47,35,11,8,3,26
S01009272,Good health,195,2,0,2,24,18,8,16,50,46,19,11,8,12
S01009272,Fair health,98,3,0,3,8,13,5,14,21,20,13,7,6,1
S01009272,Bad health,29,0,0,0,2,4,3,1,9,6,3,3,0,1
S01009272,Very bad health,8,0,0,0,0,0,1,1,1,4,1,0,1,0
S01009273,All people aged 16 to 74,373,60,21,39,100,53,35,32,43,21,8,1,7,21
S01009273,Very good health,187,35,13,22,54,23,12,16,16,9,6,1,5,16
S01009273,Good health,140,19,6,13,36,23,17,9,22,8,1,0,1,5
S01009273,Fair health,35,5,2,3,8,4,6,5,2,4,1,0,1,0
S01009273,Bad health,8,0,0,0,2,3,0,1,2,0,0,0,0,0
S01009273,Very bad health,3,1,0,1,0,0,0,1,1,0,0,0,0,0
S01009274,All people aged 16 to 74,471,44,4,40,100,55,30,50,82,54,18,11,7,38
S01009274,Very good health,233,28,0,28,45,30,15,21,33,26,6,4,2,29
S01009274,Good health,158,11,3,8,45,17,10,18,32,14,7,3,4,4
S01009274,Fair health,56,4,1,3,8,7,3,6,11,10,3,2,1,4
S01009274,Bad health,20,1,0,1,2,1,2,4,5,4,1,1,0,0
S01009274,Very bad health,4,0,0,0,0,0,0,1,1,0,1,1,0,1
S01009275,All people aged 16 to 74,504,48,14,34,110,66,63,43,65,57,31,27,4,21
S01009275,Very good health,218,28,9,19,58,26,40,14,17,16,7,6,1,12
S01009275,Good health,180,12,3,9,36,22,16,18,29,29,9,8,1,9
S01009275,Fair health,70,5,0,5,8,16,5,4,12,11,9,7,2,0
S01009275,Bad health,31,3,2,1,6,1,2,5,7,1,6,6,0,0
S01009275,Very bad health,5,0,0,0,2,1,0,2,0,0,0,0,0,0
S01009276,All people aged 16 to 74,692,80,25,55,176,103,63,61,98,59,20,13,7,32
S01009276,Very good health,351,44,13,31,92,54,26,36,43,24,7,3,4,25
S01009276,Good health,237,29,10,19,66,33,32,17,31,17,7,4,3,5
S01009276,Fair health,71,6,1,5,13,12,4,7,15,8,4,4,0,2
S01009276,Bad health,26,1,1,0,4,3,1,1,8,7,1,1,0,0
S01009276,Very bad health,7,0,0,0,1,1,0,0,1,3,1,1,0,0
S01009277,All people aged 16 to 74,418,57,11,46,121,62,72,23,35,14,7,4,3,27
S01009277,Very good health,227,38,8,30,67,33,33,10,15,4,5,3,2,22
S01009277,Good health,139,15,2,13,45,19,26,9,14,7,1,0,1,3
S01009277,Fair health,40,4,1,3,6,8,10,3,4,2,1,1,0,2
S01009277,Bad health,9,0,0,0,2,1,2,1,2,1,0,0,0,0
S01009277,Very bad health,3,0,0,0,1,1,1,0,0,0,0,0,0,0
S01009278,All people aged 16 to 74,405,66,15,51,129,59,27,25,40,40,7,5,2,12
S01009278,Very good health,210,40,7,33,74,38,13,9,14,11,1,1,0,10
S01009278,Good health,144,18,3,15,46,19,9,13,15,22,1,0,1,1
S01009278,Fair health,41,8,5,3,6,2,5,3,6,5,5,4,1,1
S01009278,Bad health,8,0,0,0,2,0,0,0,4,2,0,0,0,0
S01009278,Very bad health,2,0,0,0,1,0,0,0,1,0,0,0,0,0
S01009279,All people aged 16 to 74,464,47,10,37,103,61,46,42,58,69,14,9,5,24
S01009279,Very good health,197,25,7,18,50,26,20,14,25,17,1,1,0,19
S01009279,Good health,177,14,1,13,38,25,20,17,20,30,10,5,5,3
S01009279,Fair health,59,4,2,2,11,8,5,9,10,8,3,3,0,1
S01009279,Bad health,29,3,0,3,4,2,1,2,3,13,0,0,0,1
S01009279,Very bad health,2,1,0,1,0,0,0,0,0,1,0,0,0,0
S01009280,All people aged 16 to 74,629,6,1,5,54,58,17,79,138,186,68,41,27,23
S01009280,Very good health,225,3,0,3,23,32,4,34,44,49,22,13,9,14
S01009280,Good health,212,1,1,0,17,16,7,19,49,65,32,17,15,6
S01009280,Fair health,108,2,0,2,5,8,3,14,25,41,10,7,3,0
S01009280,Bad health,75,0,0,0,8,2,1,12,17,28,4,4,0,3
S01009280,Very bad health,9,0,0,0,1,0,2,0,3,3,0,0,0,0
S01009281,All people aged 16 to 74,615,23,7,16,70,69,22,64,127,160,44,25,19,36
S01009281,Very good health,255,14,3,11,43,36,6,30,43,51,11,5,6,21
S01009281,Good health,175,5,1,4,12,24,10,18,37,34,22,11,11,13
S01009281,Fair health,110,3,2,1,8,6,4,12,31,39,7,5,2,0
S01009281,Bad health,58,0,0,0,6,2,2,4,11,28,3,3,0,2
S01009281,Very bad health,17,1,1,0,1,1,0,0,5,8,1,1,0,0
S01009282,All people aged 16 to 74,572,70,14,56,155,77,62,50,65,42,20,12,8,31
S01009282,Very good health,294,45,9,36,79,36,35,21,32,19,6,4,2,21
S01009282,Good health,177,20,4,16,53,25,18,18,15,11,9,3,6,8
S01009282,Fair health,76,5,1,4,16,12,5,11,11,10,4,4,0,2
S01009282,Bad health,22,0,0,0,7,3,4,0,6,2,0,0,0,0
S01009282,Very bad health,3,0,0,0,0,1,0,0,1,0,1,1,0,0
S01009283,All people aged 16 to 74,337,43,11,32,84,47,26,28,39,40,9,3,6,21
S01009283,Very good health,185,37,9,28,47,26,12,10,13,20,3,1,2,17
S01009283,Good health,115,6,2,4,30,18,11,13,16,13,5,1,4,3
S01009283,Fair health,27,0,0,0,6,3,3,2,6,6,1,1,0,0
S01009283,Bad health,9,0,0,0,0,0,0,3,4,1,0,0,0,1
S01009283,Very bad health,1,0,0,0,1,0,0,0,0,0,0,0,0,0
S01009284,All people aged 16 to 74,614,70,17,53,192,98,46,38,71,41,6,2,4,52
S01009284,Very good health,373,44,11,33,127,55,20,27,31,21,2,1,1,46
S01009284,Good health,178,22,6,16,56,33,17,6,28,10,2,0,2,4
S01009284,Fair health,44,3,0,3,7,7,8,4,9,4,1,0,1,1
S01009284,Bad health,15,1,0,1,2,2,1,0,3,5,0,0,0,1
S01009284,Very bad health,4,0,0,0,0,1,0,1,0,1,1,1,0,0
S01009285,All people aged 16 to 74,675,49,8,41,138,137,44,61,106,68,14,8,6,58
S01009285,Very good health,353,29,4,25,75,63,24,31,47,36,3,2,1,45
S01009285,Good health,238,17,3,14,47,50,12,22,48,24,6,3,3,12
S01009285,Fair health,69,3,1,2,11,21,7,5,10,8,3,1,2,1
S01009285,Bad health,14,0,0,0,4,3,1,3,1,0,2,2,0,0
S01009285,Very bad health,1,0,0,0,1,0,0,0,0,0,0,0,0,0
S01009286,All people aged 16 to 74,590,57,18,39,174,84,53,50,83,43,11,6,5,35
S01009286,Very good health,305,30,9,21,99,42,25,24,35,20,6,2,4,24
S01009286,Good health,202,24,9,15,59,33,16,21,23,14,3,3,0,9
S01009286,Fair health,56,3,0,3,10,3,10,3,17,7,1,0,1,2
S01009286,Bad health,21,0,0,0,6,4,2,1,5,2,1,1,0,0
S01009286,Very bad health,6,0,0,0,0,2,0,1,3,0,0,0,0,0
S01009287,All people aged 16 to 74,543,102,16,86,183,87,52,16,44,28,6,3,3,25
S01009287,Very good health,280,50,6,44,100,38,28,3,26,11,4,1,3,20
S01009287,Good health,197,45,9,36,59,37,20,9,9,11,2,2,0,5
S01009287,Fair health,57,5,1,4,22,10,4,4,8,4,0,0,0,0
S01009287,Bad health,9,2,0,2,2,2,0,0,1,2,0,0,0,0
S01009287,Very bad health,0,0,0,0,0,0,0,0,0,0,0,0,0,0
S01009288,All people aged 16 to 74,587,92,24,68,183,82,64,31,49,35,20,11,9,31
S01009288,Very good health,311,60,16,44,109,42,25,13,19,11,8,4,4,24
S01009288,Good health,202,28,8,20,56,32,27,12,15,18,9,4,5,5
S01009288,Fair health,57,0,0,0,17,5,9,5,11,5,3,3,0,2
S01009288,Bad health,16,4,0,4,1,3,3,0,4,1,0,0,0,0
S01009288,Very bad health,1,0,0,0,0,0,0,1,0,0,0,0,0,0
S01009289,All people aged 16 to 74,673,90,21,69,182,126,63,47,76,48,13,5,8,28
S01009289,Very good health,355,56,14,42,103,69,26,19,33,16,8,2,6,25
S01009289,Good health,226,24,5,19,63,36,29,23,26,20,3,1,2,2
S01009289,Fair health,68,8,2,6,10,16,8,5,11,8,2,2,0,0
S01009289,Bad health,21,2,0,2,6,4,0,0,6,3,0,0,0,0
S01009289,Very bad health,3,0,0,0,0,1,0,0,0,1,0,0,0,1
S01009290,All people aged 16 to 74,471,78,21,57,144,99,41,26,39,14,7,4,3,23
S01009290,Very good health,249,47,11,36,86,45,22,10,17,4,3,1,2,15
S01009290,Good health,170,29,9,20,42,42,13,11,17,9,1,0,1,6
S01009290,Fair health,35,1,0,1,10,10,4,4,2,1,2,2,0,1
S01009290,Bad health,14,1,1,0,5,2,2,1,2,0,0,0,0,1
S01009290,Very bad health,3,0,0,0,1,0,0,0,1,0,1,1,0,0
S01009291,All people aged 16 to 74,766,70,18,52,189,157,56,67,98,75,8,2,6,46
S01009291,Very good health,376,41,9,32,94,70,21,25,51,36,4,1,3,34
S01009291,Good health,292,21,6,15,73,67,26,29,36,28,3,1,2,9
S01009291,Fair health,79,7,2,5,17,18,8,8,10,8,1,0,1,2
S01009291,Bad health,14,1,1,0,3,2,1,3,1,2,0,0,0,1
S01009291,Very bad health,5,0,0,0,2,0,0,2,0,1,0,0,0,0
S01009292,All people aged 16 to 74,385,8,0,8,54,44,18,43,73,92,22,12,10,31
S01009292,Very good health,146,1,0,1,22,17,4,19,24,32,9,5,4,18
S01009292,Good health,149,3,0,3,21,14,8,17,33,32,9,5,4,12
S01009292,Fair health,66,2,0,2,7,12,3,4,11,22,4,2,2,1
S01009292,Bad health,20,2,0,2,4,0,2,2,5,5,0,0,0,0
S01009292,Very bad health,4,0,0,0,0,1,1,1,0,1,0,0,0,0
S01009293,All people aged 16 to 74,522,55,16,39,116,84,44,34,77,64,17,11,6,31
S01009293,Very good health,261,26,9,17,73,43,20,13,34,20,8,5,3,24
S01009293,Good health,176,21,7,14,34,30,19,10,31,26,1,1,0,4
S01009293,Fair health,59,7,0,7,8,8,2,8,7,12,5,2,3,2
S01009293,Bad health,23,0,0,0,1,3,3,3,4,6,2,2,0,1
S01009293,Very bad health,3,1,0,1,0,0,0,0,1,0,1,1,0,0
S01009294,All people aged 16 to 74,388,51,12,39,114,56,34,34,48,17,7,3,4,27
S01009294,Very good health,209,32,7,25,69,23,15,15,22,6,3,2,1,24
S01009294,Good health,141,18,4,14,39,27,13,13,21,5,2,1,1,3
S01009294,Fair health,28,0,0,0,5,4,5,5,4,4,1,0,1,0
S01009294,Bad health,10,1,1,0,1,2,1,1,1,2,1,0,1,0
S01009294,Very bad health,0,0,0,0,0,0,0,0,0,0,0,0,0,0
S01009295,All people aged 16 to 74,511,64,11,53,115,102,34,49,65,50,3,1,2,29
S01009295,Very good health,253,33,7,26,62,47,15,24,26,22,2,1,1,22
S01009295,Good health,189,27,4,23,39,44,11,15,27,20,1,0,1,5
S01009295,Fair health,56,4,0,4,12,7,5,9,11,6,0,0,0,2
S01009295,Bad health,9,0,0,0,2,2,2,1,1,1,0,0,0,0
S01009295,Very bad health,4,0,0,0,0,2,1,0,0,1,0,0,0,0
S01009296,All people aged 16 to 74,414,35,12,23,96,62,37,43,56,40,8,4,4,37
S01009296,Very good health,225,19,8,11,52,36,19,18,31,19,2,0,2,29
S01009296,Good health,143,12,4,8,38,17,15,19,14,17,4,2,2,7
S01009296,Fair health,34,3,0,3,5,6,3,5,7,3,1,1,0,1
S01009296,Bad health,10,1,0,1,1,2,0,1,3,1,1,1,0,0
S01009296,Very bad health,2,0,0,0,0,1,0,0,1,0,0,0,0,0
S01009297,All people aged 16 to 74,652,111,24,87,203,106,30,37,62,42,15,8,7,46
S01009297,Very good health,390,72,13,59,127,58,20,19,30,21,7,4,3,36
S01009297,Good health,202,33,9,24,57,37,10,12,23,15,6,2,4,9
S01009297,Fair health,47,6,2,4,13,10,0,4,7,4,2,2,0,1
S01009297,Bad health,10,0,0,0,3,1,0,2,2,2,0,0,0,0
S01009297,Very bad health,3,0,0,0,3,0,0,0,0,0,0,0,0,0
S01009298,All people aged 16 to 74,740,40,7,33,112,93,39,73,154,138,53,27,26,38
S01009298,Very good health,286,24,2,22,49,43,11,27,56,31,15,5,10,30
S01009298,Good health,246,10,3,7,47,30,15,28,48,46,15,9,6,7
S01009298,Fair health,140,5,2,3,10,15,11,7,36,40,16,7,9,0
S01009298,Bad health,49,1,0,1,3,5,2,8,9,14,6,5,1,1
S01009298,Very bad health,19,0,0,0,3,0,0,3,5,7,1,1,0,0
S01009299,All people aged 16 to 74,713,88,15,73,185,112,58,52,85,57,32,19,13,44
S01009299,Very good health,377,55,8,47,103,60,28,16,52,21,8,3,5,34
S01009299,Good health,253,26,7,19,66,40,21,24,24,27,16,10,6,9
S01009299,Fair health,54,7,0,7,12,10,6,5,3,3,7,5,2,1
S01009299,Bad health,24,0,0,0,2,2,2,6,6,5,1,1,0,0
S01009299,Very bad health,5,0,0,0,2,0,1,1,0,1,0,0,0,0
S01009300,All people aged 16 to 74,413,43,6,37,93,55,25,39,58,47,28,20,8,25
S01009300,Very good health,207,22,4,18,55,31,11,19,26,16,8,4,4,19
S01009300,Good health,137,17,2,15,31,18,9,15,17,15,10,10,0,5
S01009300,Fair health,56,4,0,4,4,5,4,5,12,13,8,4,4,1
S01009300,Bad health,10,0,0,0,2,1,0,0,3,3,1,1,0,0
S01009300,Very bad health,3,0,0,0,1,0,1,0,0,0,1,1,0,0
S01009301,All people aged 16 to 74,730,43,10,33,136,111,45,65,103,101,86,43,43,40
S01009301,Very good health,304,24,5,19,73,51,11,25,38,28,24,14,10,30
S01009301,Good health,266,14,5,9,37,42,21,17,40,49,39,15,24,7
S01009301,Fair health,99,3,0,3,17,11,8,9,15,17,18,9,9,1
S01009301,Bad health,46,1,0,1,8,5,5,8,7,7,3,3,0,2
S01009301,Very bad health,15,1,0,1,1,2,0,6,3,0,2,2,0,0
S01009302,All people aged 16 to 74,650,21,4,17,86,68,22,43,160,144,65,37,28,41
S01009302,Very good health,248,13,2,11,42,18,6,16,63,43,17,9,8,30
S01009302,Good health,230,7,2,5,31,34,10,13,53,47,25,12,13,10
S01009302,Fair health,113,1,0,1,7,15,4,11,24,34,17,11,6,0
S01009302,Bad health,44,0,0,0,5,0,1,3,14,16,4,3,1,1
S01009302,Very bad health,15,0,0,0,1,1,1,0,6,4,2,2,0,0
S01009303,All people aged 16 to 74,564,65,19,46,195,80,30,34,62,47,22,14,8,29
S01009303,Very good health,300,41,15,26,108,35,14,18,32,21,8,6,2,23
S01009303,Good health,173,20,4,16,60,28,5,12,20,15,7,4,3,6
S01009303,Fair health,68,4,0,4,18,14,10,3,9,5,5,3,2,0
S01009303,Bad health,19,0,0,0,8,2,0,1,1,6,1,1,0,0
S01009303,Very bad health,4,0,0,0,1,1,1,0,0,0,1,0,1,0
S01009304,All people aged 16 to 74,712,51,12,39,153,126,48,60,133,89,27,14,13,25
S01009304,Very good health,342,25,7,18,80,59,17,21,72,40,11,4,7,17
S01009304,Good health,269,23,5,18,59,51,24,23,44,30,7,5,2,8
S01009304,Fair health,76,1,0,1,11,13,6,12,14,11,8,5,3,0
S01009304,Bad health,20,2,0,2,2,3,1,3,3,5,1,0,1,0
S01009304,Very bad health,5,0,0,0,1,0,0,1,0,3,0,0,0,0
S01009305,All people aged 16 to 74,573,54,10,44,150,95,25,41,87,69,25,6,19,27
S01009305,Very good health,267,32,5,27,78,45,12,18,28,28,5,1,4,21
S01009305,Good health,192,13,3,10,54,31,10,13,33,18,16,3,13,4
S01009305,Fair health,79,4,0,4,14,15,1,8,18,15,2,1,1,2
S01009305,Bad health,26,2,0,2,2,4,2,2,6,6,2,1,1,0
S01009305,Very bad health,9,3,2,1,2,0,0,0,2,2,0,0,0,0
S01009306,All people aged 16 to 74,828,71,14,57,184,139,49,76,114,91,54,28,26,50
S01009306,Very good health,409,42,6,36,107,63,27,41,41,40,16,7,9,32
S01009306,Good health,279,25,7,18,60,56,14,23,47,28,13,7,6,13
S01009306,Fair health,99,3,1,2,12,12,6,8,22,11,20,10,10,5
S01009306,Bad health,31,0,0,0,3,7,1,2,3,11,4,3,1,0
S01009306,Very bad health,10,1,0,1,2,1,1,2,1,1,1,1,0,0
S01009307,All people aged 16 to 74,817,75,14,61,225,121,50,62,94,85,46,21,25,59
S01009307,Very good health,406,44,6,38,141,53,22,24,37,31,15,7,8,39
S01009307,Good health,285,27,7,20,66,48,25,24,36,30,13,5,8,16
S01009307,Fair health,98,4,1,3,14,16,3,10,14,18,15,7,8,4
S01009307,Bad health,20,0,0,0,2,2,0,4,5,6,1,0,1,0
S01009307,Very bad health,8,0,0,0,2,2,0,0,2,0,2,2,0,0
S01009308,All people aged 16 to 74,385,53,7,46,91,59,34,28,32,39,21,9,12,28
S01009308,Very good health,213,34,4,30,47,34,24,10,14,18,10,5,5,22
S01009308,Good health,124,17,3,14,36,18,6,12,10,11,8,3,5,6
S01009308,Fair health,39,2,0,2,5,6,3,6,6,8,3,1,2,0
S01009308,Bad health,8,0,0,0,2,1,1,0,2,2,0,0,0,0
S01009308,Very bad health,1,0,0,0,1,0,0,0,0,0,0,0,0,0
S01009309,All people aged 16 to 74,580,86,12,74,161,86,43,46,64,39,23,9,14,32
S01009309,Very good health,317,56,8,48,91,53,19,22,21,23,9,3,6,23
S01009309,Good health,188,25,3,22,50,26,16,20,26,12,6,3,3,7
S01009309,Fair health,59,4,1,3,18,4,5,4,10,4,8,3,5,2
S01009309,Bad health,13,1,0,1,2,2,2,0,6,0,0,0,0,0
S01009309,Very bad health,3,0,0,0,0,1,1,0,1,0,0,0,0,0
S01009310,All people aged 16 to 74,720,115,20,95,201,111,49,51,79,46,18,12,6,50
S01009310,Very good health,390,64,8,56,121,55,20,30,33,23,4,4,0,40
S01009310,Good health,244,41,9,32,61,40,24,16,33,12,7,1,6,10
S01009310,Fair health,61,10,3,7,14,13,5,2,12,2,3,3,0,0
S01009310,Bad health,15,0,0,0,2,2,0,3,1,7,0,0,0,0
S01009310,Very bad health,10,0,0,0,3,1,0,0,0,2,4,4,0,0
S01009311,All people aged 16 to 74,531,13,3,10,81,59,27,54,116,99,43,30,13,39
S01009311,Very good health,220,5,1,4,27,26,9,21,49,37,21,13,8,25
S01009311,Good health,181,6,2,4,34,21,9,20,34,37,13,9,4,7
S01009311,Fair health,83,2,0,2,13,11,6,8,20,14,4,3,1,5
S01009311,Bad health,38,0,0,0,5,1,1,5,12,9,3,3,0,2
S01009311,Very bad health,9,0,0,0,2,0,2,0,1,2,2,2,0,0
S01009312,All people aged 16 to 74,535,55,6,49,148,91,25,32,68,54,32,19,13,30
S01009312,Very good health,271,32,4,28,89,44,8,13,27,18,18,9,9,22
S01009312,Good health,189,21,2,19,47,33,8,16,27,23,6,3,3,8
S01009312,Fair health,54,2,0,2,8,10,6,1,13,10,4,3,1,0
S01009312,Bad health,16,0,0,0,4,4,3,2,1,1,1,1,0,0
S01009312,Very bad health,5,0,0,0,0,0,0,0,0,2,3,3,0,0
S01009313,All people aged 16 to 74,411,12,2,10,71,57,27,43,75,75,31,25,6,20
S01009313,Very good health,148,5,0,5,31,26,13,14,25,20,4,4,0,10
S01009313,Good health,170,3,1,2,27,20,9,18,35,35,14,9,5,9
S01009313,Fair health,54,3,1,2,9,8,2,5,8,10,9,8,1,0
S01009313,Bad health,31,1,0,1,2,2,3,5,7,8,2,2,0,1
S01009313,Very bad health,8,0,0,0,2,1,0,1,0,2,2,2,0,0
S01009314,All people aged 16 to 74,510,66,17,49,109,96,27,36,81,42,22,12,10,31
S01009314,Very good health,268,39,8,31,57,51,16,17,40,18,6,4,2,24
S01009314,Good health,169,23,7,16,37,36,9,10,30,14,5,2,3,5
S01009314,Fair health,46,4,2,2,11,8,1,4,3,6,7,4,3,2
S01009314,Bad health,20,0,0,0,4,1,1,2,6,4,2,0,2,0
S01009314,Very bad health,7,0,0,0,0,0,0,3,2,0,2,2,0,0
S01009315,All people aged 16 to 74,477,19,5,14,78,66,31,47,79,87,36,22,14,34
S01009315,Very good health,190,12,4,8,35,29,12,15,30,22,7,4,3,28
S01009315,Good health,168,6,1,5,30,26,11,14,26,33,17,7,10,5
S01009315,Fair health,83,1,0,1,11,5,6,12,17,22,8,7,1,1
S01009315,Bad health,19,0,0,0,0,3,0,4,4,6,2,2,0,0
S01009315,Very bad health,17,0,0,0,2,3,2,2,2,4,2,2,0,0
S01009316,All people aged 16 to 74,570,113,26,87,176,83,23,32,58,26,18,7,11,41
S01009316,Very good health,334,74,17,57,101,42,16,14,32,11,10,3,7,34
S01009316,Good health,189,30,7,23,63,33,6,12,22,10,6,3,3,7
S01009316,Fair health,39,8,2,6,11,7,1,4,4,2,2,1,1,0
S01009316,Bad health,7,1,0,1,1,0,0,2,0,3,0,0,0,0
S01009316,Very bad health,1,0,0,0,0,1,0,0,0,0,0,0,0,0
S01009317,All people aged 16 to 74,650,87,14,73,187,136,45,43,67,26,11,3,8,48
S01009317,Very good health,361,54,8,46,109,69,24,28,24,7,5,1,4,41
S01009317,Good health,216,26,5,21,65,49,16,11,27,13,3,0,3,6
S01009317,Fair health,61,4,0,4,12,16,4,3,13,6,2,2,0,1
S01009317,Bad health,9,2,0,2,1,1,1,1,2,0,1,0,1,0
S01009317,Very bad health,3,1,1,0,0,1,0,0,1,0,0,0,0,0
S01009318,All people aged 16 to 74,467,80,18,62,159,72,23,21,58,15,1,1,0,38
S01009318,Very good health,283,48,15,33,91,41,16,12,35,7,0,0,0,33
S01009318,Good health,143,27,3,24,57,24,4,7,15,5,0,0,0,4
S01009318,Fair health,28,4,0,4,9,4,2,2,4,2,0,0,0,1
S01009318,Bad health,13,1,0,1,2,3,1,0,4,1,1,1,0,0
S01009318,Very bad health,0,0,0,0,0,0,0,0,0,0,0,0,0,0
S01009319,All people aged 16 to 74,636,85,15,70,204,131,36,41,64,39,12,7,5,24
S01009319,Very good health,318,53,10,43,105,57,15,19,29,18,3,1,2,19
S01009319,Good health,226,26,2,24,73,58,15,17,20,9,3,1,2,5
S01009319,Fair health,69,4,3,1,18,12,5,4,10,10,6,5,1,0
S01009319,Bad health,14,1,0,1,5,1,1,1,4,1,0,0,0,0
S01009319,Very bad health,9,1,0,1,3,3,0,0,1,1,0,0,0,0
S01009320,All people aged 16 to 74,485,53,10,43,107,85,32,39,85,52,9,6,3,23
S01009320,Very good health,214,32,5,27,51,31,14,15,36,16,2,1,1,17
S01009320,Good health,174,17,5,12,42,40,14,15,21,16,4,2,2,5
S01009320,Fair health,58,3,0,3,13,9,2,5,16,8,1,1,0,1
S01009320,Bad health,35,1,0,1,1,5,2,4,9,11,2,2,0,0
S01009320,Very bad health,4,0,0,0,0,0,0,0,3,1,0,0,0,0
S01009321,All people aged 16 to 74,519,68,19,49,151,103,30,36,67,28,4,4,0,32
S01009321,Very good health,268,43,13,30,80,57,10,8,35,9,1,1,0,25
S01009321,Good health,185,23,6,17,52,33,12,25,21,14,1,1,0,4
S01009321,Fair health,48,1,0,1,13,10,6,3,10,2,0,0,0,3
S01009321,Bad health,15,1,0,1,4,3,2,0,1,3,1,1,0,0
S01009321,Very bad health,3,0,0,0,2,0,0,0,0,0,1,1,0,0
S01009322,All people aged 16 to 74,610,48,11,37,141,129,40,44,83,76,16,9,7,33
S01009322,Very good health,307,31,8,23,79,61,21,19,33,29,7,6,1,27
S01009322,Good health,189,13,2,11,45,45,11,14,30,22,5,2,3,4
S01009322,Fair health,76,3,1,2,10,16,8,8,12,17,1,0,1,1
S01009322,Bad health,33,0,0,0,7,7,0,2,7,7,2,0,2,1
S01009322,Very bad health,5,1,0,1,0,0,0,1,1,1,1,1,0,0
S01009323,All people aged 16 to 74,491,18,4,14,122,70,37,33,100,72,20,13,7,19
S01009323,Very good health,201,10,2,8,57,30,12,16,36,19,5,3,2,16
S01009323,Good health,196,7,2,5,43,35,14,12,42,31,9,5,4,3
S01009323,Fair health,67,1,0,1,14,4,9,1,17,16,5,5,0,0
S01009323,Bad health,16,0,0,0,6,0,1,2,4,3,0,0,0,0
S01009323,Very bad health,11,0,0,0,2,1,1,2,1,3,1,0,1,0
S01009324,All people aged 16 to 74,407,19,4,15,74,63,29,33,70,79,19,6,13,21
S01009324,Very good health,194,10,1,9,42,32,14,12,32,32,5,2,3,15
S01009324,Good health,133,7,2,5,28,22,7,10,28,21,5,0,5,5
S01009324,Fair health,52,1,0,1,2,7,5,7,6,17,6,3,3,1
S01009324,Bad health,23,1,1,0,2,2,2,3,2,8,3,1,2,0
S01009324,Very bad health,5,0,0,0,0,0,1,1,2,1,0,0,0,0
S01009325,All people aged 16 to 74,529,68,12,56,155,91,44,45,62,31,8,3,5,25
S01009325,Very good health,309,45,8,37,103,50,17,22,28,16,4,2,2,24
S01009325,Good health,159,18,2,16,37,33,17,18,24,10,1,0,1,1
S01009325,Fair health,39,4,2,2,8,6,6,2,9,2,2,0,2,0
S01009325,Bad health,20,1,0,1,6,2,3,3,1,3,1,1,0,0
S01009325,Very bad health,2,0,0,0,1,0,1,0,0,0,0,0,0,0
S01009326,All people aged 16 to 74,420,43,8,35,116,60,11,21,55,43,32,22,10,39
S01009326,Very good health,234,31,5,26,73,38,5,11,23,17,6,2,4,30
S01009326,Good health,129,10,3,7,35,16,5,8,21,14,11,7,4,9
S01009326,Fair health,45,2,0,2,7,3,1,1,9,9,13,11,2,0
S01009326,Bad health,7,0,0,0,0,2,0,0,1,3,1,1,0,0
S01009326,Very bad health,5,0,0,0,1,1,0,1,1,0,1,1,0,0
S01009327,All people aged 16 to 74,414,48,11,37,115,79,18,23,54,39,14,6,8,24
S01009327,Very good health,219,25,7,18,67,40,11,11,22,19,5,1,4,19
S01009327,Good health,142,18,2,16,39,30,5,9,20,11,6,3,3,4
S01009327,Fair health,38,2,1,1,7,7,2,3,9,5,2,2,0,1
S01009327,Bad health,13,3,1,2,2,2,0,0,2,3,1,0,1,0
S01009327,Very bad health,2,0,0,0,0,0,0,0,1,1,0,0,0,0
S01009328,All people aged 16 to 74,474,79,8,71,181,79,22,29,35,22,7,2,5,20
S01009328,Very good health,332,61,7,54,122,53,17,20,24,17,4,1,3,14
S01009328,Good health,119,16,1,15,45,22,4,9,9,5,3,1,2,6
S01009328,Fair health,19,2,0,2,12,3,1,0,1,0,0,0,0,0
S01009328,Bad health,3,0,0,0,2,1,0,0,0,0,0,0,0,0
S01009328,Very bad health,1,0,0,0,0,0,0,0,1,0,0,0,0,0
S01009329,All people aged 16 to 74,331,45,8,37,107,72,12,28,30,18,7,3,4,12
S01009329,Very good health,224,35,7,28,71,49,8,20,20,10,2,0,2,9
S01009329,Good health,83,9,1,8,30,20,4,3,6,6,2,1,1,3
S01009329,Fair health,19,1,0,1,5,3,0,4,3,1,2,1,1,0
S01009329,Bad health,3,0,0,0,1,0,0,0,1,1,0,0,0,0
S01009329,Very bad health,2,0,0,0,0,0,0,1,0,0,1,1,0,0
S01009330,All people aged 16 to 74,349,30,5,25,91,55,21,23,61,32,12,6,6,24
S01009330,Very good health,187,19,2,17,53,32,9,13,22,17,3,2,1,19
S01009330,Good health,111,9,3,6,24,17,8,7,27,11,5,2,3,3
S01009330,Fair health,31,2,0,2,8,6,1,0,11,1,1,0,1,1
S01009330,Bad health,10,0,0,0,2,0,2,0,1,2,2,1,1,1
S01009330,Very bad health,10,0,0,0,4,0,1,3,0,1,1,1,0,0
S01009331,All people aged 16 to 74,395,77,14,63,120,61,20,21,34,19,4,2,2,39
S01009331,Very good health,239,50,7,43,78,30,12,12,14,10,1,0,1,32
S01009331,Good health,119,24,5,19,31,25,8,6,12,6,2,1,1,5
S01009331,Fair health,32,3,2,1,10,5,0,3,6,2,1,1,0,2
S01009331,Bad health,4,0,0,0,1,1,0,0,1,1,0,0,0,0
S01009331,Very bad health,1,0,0,0,0,0,0,0,1,0,0,0,0,0
S01009332,All people aged 16 to 74,678,96,18,78,203,117,43,37,60,47,29,23,6,46
S01009332,Very good health,363,59,7,52,110,65,26,16,24,22,7,5,2,34
S01009332,Good health,222,29,11,18,69,38,8,16,24,15,12,10,2,11
S01009332,Fair health,76,7,0,7,20,12,8,4,8,8,8,8,0,1
S01009332,Bad health,13,0,0,0,4,2,1,1,2,1,2,0,2,0
S01009332,Very bad health,4,1,0,1,0,0,0,0,2,1,0,0,0,0
S01009333,All people aged 16 to 74,535,24,6,18,87,91,32,45,98,99,27,12,15,32
S01009333,Very good health,226,10,3,7,44,36,16,20,33,32,10,4,6,25
S01009333,Good health,211,11,2,9,32,39,10,17,40,45,11,6,5,6
S01009333,Fair health,63,2,0,2,4,9,6,3,20,12,6,2,4,1
S01009333,Bad health,28,1,1,0,6,6,0,4,4,7,0,0,0,0
S01009333,Very bad health,7,0,0,0,1,1,0,1,1,3,0,0,0,0
S01009334,All people aged 16 to 74,473,19,4,15,61,65,24,43,85,88,51,26,25,37
S01009334,Very good health,164,7,3,4,27,25,9,14,28,21,9,4,5,24
S01009334,Good health,192,10,1,9,26,24,9,19,32,34,27,10,17,11
S01009334,Fair health,76,2,0,2,5,13,2,5,14,25,8,6,2,2
S01009334,Bad health,33,0,0,0,3,1,4,4,8,7,6,5,1,0
S01009334,Very bad health,8,0,0,0,0,2,0,1,3,1,1,1,0,0
S01009335,All people aged 16 to 74,592,15,2,13,88,75,22,51,118,136,46,30,16,41
S01009335,Very good health,234,10,2,8,44,33,10,16,45,33,14,12,2,29
S01009335,Good health,209,5,0,5,33,26,9,19,40,51,18,9,9,8
S01009335,Fair health,112,0,0,0,7,12,2,9,24,41,13,8,5,4
S01009335,Bad health,29,0,0,0,3,3,1,2,9,10,1,1,0,0
S01009335,Very bad health,8,0,0,0,1,1,0,5,0,1,0,0,0,0
S01009336,All people aged 16 to 74,485,12,0,12,67,52,21,50,92,82,76,39,37,33
S01009336,Very good health,182,4,0,4,32,17,10,18,29,27,23,12,11,22
S01009336,Good health,180,5,0,5,26,19,7,19,40,26,32,13,19,6
S01009336,Fair health,87,2,0,2,7,13,1,11,17,15,16,10,6,5
S01009336,Bad health,21,0,0,0,2,2,1,2,3,8,3,2,1,0
S01009336,Very bad health,15,1,0,1,0,1,2,0,3,6,2,2,0,0
S01009337,All people aged 16 to 74,526,12,1,11,74,68,24,47,107,93,56,32,24,45
S01009337,Very good health,189,7,1,6,34,24,7,14,30,29,15,9,6,29
S01009337,Good health,200,4,0,4,25,27,8,19,45,37,23,11,12,12
S01009337,Fair health,81,1,0,1,6,8,8,10,18,15,14,9,5,1
S01009337,Bad health,43,0,0,0,8,9,1,3,9,9,1,0,1,3
S01009337,Very bad health,13,0,0,0,1,0,0,1,5,3,3,3,0,0
S01009338,All people aged 16 to 74,547,18,5,13,69,59,20,39,113,130,68,33,35,31
S01009338,Very good health,177,11,2,9,31,20,2,10,32,37,17,11,6,17
S01009338,Good health,194,3,0,3,17,27,7,14,46,44,24,6,18,12
S01009338,Fair health,115,3,2,1,14,9,7,9,20,31,20,10,10,2
S01009338,Bad health,49,1,1,0,7,2,4,3,14,12,6,5,1,0
S01009338,Very bad health,12,0,0,0,0,1,0,3,1,6,1,1,0,0
S01009339,All people aged 16 to 74,590,10,2,8,70,58,27,74,123,122,76,38,38,30
S01009339,Very good health,239,6,1,5,27,20,14,38,51,37,29,17,12,17
S01009339,Good health,197,4,1,3,25,18,9,22,38,39,32,14,18,10
S01009339,Fair health,107,0,0,0,14,12,3,7,23,33,12,5,7,3
S01009339,Bad health,39,0,0,0,1,7,1,7,10,10,3,2,1,0
S01009339,Very bad health,8,0,0,0,3,1,0,0,1,3,0,0,0,0
S01009340,All people aged 16 to 74,434,6,1,5,42,49,18,40,117,112,24,15,9,26
S01009340,Very good health,158,4,1,3,19,22,5,11,32,37,7,5,2,21
S01009340,Good health,168,1,0,1,15,21,9,19,51,37,12,8,4,3
S01009340,Fair health,69,1,0,1,4,3,2,8,24,20,5,2,3,2
S01009340,Bad health,34,0,0,0,4,2,1,2,10,15,0,0,0,0
S01009340,Very bad health,5,0,0,0,0,1,1,0,0,3,0,0,0,0
S01009341,All people aged 16 to 74,447,15,5,10,43,70,32,46,93,85,38,24,14,25
S01009341,Very good health,178,5,0,5,18,31,20,13,28,28,17,11,6,18
S01009341,Good health,171,7,2,5,18,30,6,23,37,32,12,7,5,6
S01009341,Fair health,65,2,2,0,7,5,4,7,19,15,5,2,3,1
S01009341,Bad health,27,1,1,0,0,4,2,2,8,7,3,3,0,0
S01009341,Very bad health,6,0,0,0,0,0,0,1,1,3,1,1,0,0
S01009342,All people aged 16 to 74,547,23,4,19,73,98,31,54,92,105,39,19,20,32
S01009342,Very good health,226,12,3,9,37,43,19,23,24,35,14,7,7,19
S01009342,Good health,212,7,1,6,26,42,6,21,47,37,16,7,9,10
S01009342,Fair health,76,2,0,2,8,8,2,8,13,28,5,1,4,2
S01009342,Bad health,20,1,0,1,1,3,2,0,6,4,2,2,0,1
S01009342,Very bad health,13,1,0,1,1,2,2,2,2,1,2,2,0,0
S01009343,All people aged 16 to 74,433,18,2,16,86,78,15,40,98,60,12,7,5,26
S01009343,Very good health,193,9,1,8,42,40,7,16,31,25,4,2,2,19
S01009343,Good health,163,8,1,7,31,27,5,17,50,13,7,4,3,5
S01009343,Fair health,55,0,0,0,7,9,3,6,12,15,1,1,0,2
S01009343,Bad health,18,0,0,0,5,2,0,1,5,5,0,0,0,0
S01009343,Very bad health,4,1,0,1,1,0,0,0,0,2,0,0,0,0
S01009344,All people aged 16 to 74,470,9,1,8,59,69,22,50,111,99,36,23,13,15
S01009344,Very good health,172,5,1,4,25,23,7,21,40,28,11,5,6,12
S01009344,Good health,178,3,0,3,24,35,8,16,43,33,13,8,5,3
S01009344,Fair health,76,0,0,0,4,6,6,9,19,29,3,2,1,0
S01009344,Bad health,38,1,0,1,5,5,1,2,9,7,8,7,1,0
S01009344,Very bad health,6,0,0,0,1,0,0,2,0,2,1,1,0,0
S01009345,All people aged 16 to 74,697,25,1,24,131,117,32,70,137,106,28,16,12,51
S01009345,Very good health,318,14,0,14,73,57,8,29,52,33,13,8,5,39
S01009345,Good health,267,8,1,7,47,44,15,28,63,43,9,5,4,10
S01009345,Fair health,79,2,0,2,8,12,6,11,13,21,4,1,3,2
S01009345,Bad health,28,0,0,0,3,4,3,2,7,7,2,2,0,0
S01009345,Very bad health,5,1,0,1,0,0,0,0,2,2,0,0,0,0
S01009346,All people aged 16 to 74,474,85,16,69,177,63,43,21,40,13,11,6,5,21
S01009346,Very good health,311,61,10,51,122,30,28,10,25,9,6,5,1,20
S01009346,Good health,129,23,6,17,45,23,11,9,13,2,2,0,2,1
S01009346,Fair health,29,1,0,1,10,8,3,2,2,2,1,0,1,0
S01009346,Bad health,5,0,0,0,0,2,1,0,0,0,2,1,1,0
S01009346,Very bad health,0,0,0,0,0,0,0,0,0,0,0,0,0,0
S01009347,All people aged 16 to 74,457,108,28,80,152,61,35,22,29,15,5,1,4,30
S01009347,Very good health,314,80,21,59,112,40,19,14,16,7,2,1,1,24
S01009347,Good health,121,27,7,20,33,18,15,6,9,6,2,0,2,5
S01009347,Fair health,20,1,0,1,7,2,1,2,4,1,1,0,1,1
S01009347,Bad health,0,0,0,0,0,0,0,0,0,0,0,0,0,0
S01009347,Very bad health,2,0,0,0,0,1,0,0,0,1,0,0,0,0
S01009348,All people aged 16 to 74,348,56,10,46,110,56,21,20,39,14,4,1,3,28
S01009348,Very good health,217,37,4,33,62,39,15,16,20,8,1,1,0,19
S01009348,Good health,113,14,5,9,42,16,4,4,17,6,2,0,2,8
S01009348,Fair health,16,5,1,4,5,1,2,0,1,0,1,0,1,1
S01009348,Bad health,1,0,0,0,1,0,0,0,0,0,0,0,0,0
S01009348,Very bad health,1,0,0,0,0,0,0,0,1,0,0,0,0,0
S01009349,All people aged 16 to 74,557,100,13,87,187,93,35,31,32,33,11,5,6,35
S01009349,Very good health,367,75,8,67,127,55,23,21,15,18,6,4,2,27
S01009349,Good health,155,21,5,16,51,32,10,8,12,12,3,0,3,6
S01009349,Fair health,28,3,0,3,8,5,2,1,3,3,2,1,1,1
S01009349,Bad health,6,1,0,1,0,1,0,1,2,0,0,0,0,1
S01009349,Very bad health,1,0,0,0,1,0,0,0,0,0,0,0,0,0
S01009350,All people aged 16 to 74,440,41,5,36,133,73,22,31,56,39,14,7,7,31
S01009350,Very good health,249,31,2,29,79,42,6,15,30,19,5,3,2,22
S01009350,Good health,153,9,3,6,46,25,15,12,19,15,5,3,2,7
S01009350,Fair health,34,1,0,1,8,5,1,3,6,4,4,1,3,2
S01009350,Bad health,3,0,0,0,0,1,0,1,1,0,0,0,0,0
S01009350,Very bad health,1,0,0,0,0,0,0,0,0,1,0,0,0,0
S01009351,All people aged 16 to 74,388,57,11,46,129,66,24,28,36,24,9,8,1,15
S01009351,Very good health,223,38,7,31,73,42,14,14,13,13,5,5,0,11
S01009351,Good health,137,18,4,14,45,16,8,14,20,9,3,2,1,4
S01009351,Fair health,25,1,0,1,10,6,2,0,3,2,1,1,0,0
S01009351,Bad health,2,0,0,0,0,2,0,0,0,0,0,0,0,0
S01009351,Very bad health,1,0,0,0,1,0,0,0,0,0,0,0,0,0
S01009352,All people aged 16 to 74,562,101,17,84,212,79,25,29,47,21,13,7,6,35
S01009352,Very good health,391,85,15,70,148,45,14,14,34,14,7,4,3,30
S01009352,Good health,149,15,2,13,56,31,10,12,11,5,4,2,2,5
S01009352,Fair health,19,1,0,1,8,3,1,1,2,2,1,1,0,0
S01009352,Bad health,3,0,0,0,0,0,0,2,0,0,1,0,1,0
S01009352,Very bad health,0,0,0,0,0,0,0,0,0,0,0,0,0,0
S01009353,All people aged 16 to 74,285,42,7,35,95,53,24,20,20,9,10,4,6,12
S01009353,Very good health,183,28,2,26,65,41,8,13,8,4,7,3,4,9
S01009353,Good health,80,14,5,9,27,12,10,5,5,1,3,1,2,3
S01009353,Fair health,19,0,0,0,3,0,5,2,6,3,0,0,0,0
S01009353,Bad health,3,0,0,0,0,0,1,0,1,1,0,0,0,0
S01009353,Very bad health,0,0,0,0,0,0,0,0,0,0,0,0,0,0
S01009354,All people aged 16 to 74,628,96,16,80,214,99,46,31,56,29,13,9,4,44
S01009354,Very good health,397,63,11,52,140,63,26,19,27,14,6,5,1,39
S01009354,Good health,192,31,4,27,61,32,16,9,25,9,5,2,3,4
S01009354,Fair health,29,1,1,0,12,4,3,2,2,3,1,1,0,1
S01009354,Bad health,10,1,0,1,1,0,1,1,2,3,1,1,0,0
S01009354,Very bad health,0,0,0,0,0,0,0,0,0,0,0,0,0,0
S01009355,All people aged 16 to 74,694,71,12,59,158,146,45,65,116,52,12,11,1,29
S01009355,Very good health,364,42,8,34,86,75,23,36,51,23,8,7,1,20
S01009355,Good health,243,21,3,18,53,54,18,25,40,24,1,1,0,7
S01009355,Fair health,67,8,1,7,15,15,3,3,16,4,1,1,0,2
S01009355,Bad health,14,0,0,0,3,2,0,1,6,0,2,2,0,0
S01009355,Very bad health,6,0,0,0,1,0,1,0,3,1,0,0,0,0
S01009356,All people aged 16 to 74,760,64,16,48,208,156,52,71,91,67,7,5,2,44
S01009356,Very good health,363,32,8,24,98,78,23,34,36,26,3,2,1,33
S01009356,Good health,294,27,8,19,85,61,20,26,41,23,3,2,1,8
S01009356,Fair health,84,3,0,3,20,17,8,9,10,13,1,1,0,3
S01009356,Bad health,18,2,0,2,4,0,1,2,4,5,0,0,0,0
S01009356,Very bad health,1,0,0,0,1,0,0,0,0,0,0,0,0,0
S01009357,All people aged 16 to 74,359,72,19,53,99,68,24,22,29,22,8,3,5,15
S01009357,Very good health,229,54,14,40,67,41,14,15,14,9,4,2,2,11
S01009357,Good health,100,16,5,11,26,23,7,5,8,9,2,0,2,4
S01009357,Fair health,26,2,0,2,6,4,1,1,6,4,2,1,1,0
S01009357,Bad health,2,0,0,0,0,0,1,1,0,0,0,0,0,0
S01009357,Very bad health,2,0,0,0,0,0,1,0,1,0,0,0,0,0
S01009358,All people aged 16 to 74,528,128,32,96,173,67,35,24,39,16,6,5,1,40
S01009358,Very good health,329,89,18,71,115,32,18,12,22,8,2,1,1,31
S01009358,Good health,151,29,11,18,41,30,14,6,16,3,4,4,0,8
S01009358,Fair health,36,8,3,5,13,4,1,5,1,3,0,0,0,1
S01009358,Bad health,9,2,0,2,3,1,1,1,0,1,0,0,0,0
S01009358,Very bad health,3,0,0,0,1,0,1,0,0,1,0,0,0,0
S01009359,All people aged 16 to 74,565,86,13,73,181,90,35,27,59,33,8,4,4,46
S01009359,Very good health,349,58,11,47,113,57,21,16,24,19,5,1,4,36
S01009359,Good health,189,27,2,25,58,30,12,10,28,13,3,3,0,8
S01009359,Fair health,23,0,0,0,9,2,2,1,6,1,0,0,0,2
S01009359,Bad health,4,1,0,1,1,1,0,0,1,0,0,0,0,0
S01009359,Very bad health,0,0,0,0,0,0,0,0,0,0,0,0,0,0
S01009360,All people aged 16 to 74,646,95,20,75,164,111,37,50,74,61,8,5,3,46
S01009360,Very good health,333,55,6,49,84,62,18,19,25,32,2,2,0,36
S01009360,Good health,220,37,12,25,57,31,12,17,34,20,3,2,1,9
S01009360,Fair health,68,2,1,1,17,11,6,10,10,8,3,1,2,1
S01009360,Bad health,19,1,1,0,6,5,1,3,3,0,0,0,0,0
S01009360,Very bad health,6,0,0,0,0,2,0,1,2,1,0,0,0,0
S01009361,All people aged 16 to 74,592,56,8,48,136,102,33,41,114,64,16,14,2,30
S01009361,Very good health,308,33,5,28,68,57,15,23,48,32,7,5,2,25
S01009361,Good health,209,19,3,16,52,35,11,13,48,23,3,3,0,5
S01009361,Fair health,54,4,0,4,14,8,4,3,15,4,2,2,0,0
S01009361,Bad health,13,0,0,0,2,2,1,1,2,3,2,2,0,0
S01009361,Very bad health,8,0,0,0,0,0,2,1,1,2,2,2,0,0
S01009362,All people aged 16 to 74,802,85,16,69,192,169,33,75,113,65,17,12,5,53
S01009362,Very good health,429,49,9,40,93,94,20,38,49,32,13,9,4,41
S01009362,Good health,285,24,5,19,80,58,10,28,50,21,3,2,1,11
S01009362,Fair health,74,11,2,9,16,16,3,9,12,6,0,0,0,1
S01009362,Bad health,11,1,0,1,1,1,0,0,1,6,1,1,0,0
S01009362,Very bad health,3,0,0,0,2,0,0,0,1,0,0,0,0,0
S01009363,All people aged 16 to 74,633,28,8,20,97,120,28,71,126,106,29,13,16,28
S01009363,Very good health,261,9,0,9,49,56,8,31,45,33,11,3,8,19
S01009363,Good health,253,14,3,11,38,53,11,24,52,44,10,5,5,7
S01009363,Fair health,85,5,5,0,6,11,8,13,20,18,2,1,1,2
S01009363,Bad health,26,0,0,0,1,0,0,3,7,9,6,4,2,0
S01009363,Very bad health,8,0,0,0,3,0,1,0,2,2,0,0,0,0
S01009364,All people aged 16 to 74,672,35,9,26,120,125,44,83,118,73,27,16,11,47
S01009364,Very good health,335,19,6,13,67,59,26,35,57,29,10,4,6,33
S01009364,Good health,234,12,1,11,43,46,12,33,39,29,11,8,3,9
S01009364,Fair health,71,2,2,0,7,14,1,11,17,12,4,2,2,3
S01009364,Bad health,27,1,0,1,3,4,4,4,5,2,2,2,0,2
S01009364,Very bad health,5,1,0,1,0,2,1,0,0,1,0,0,0,0
S01009365,All people aged 16 to 74,445,20,2,18,81,79,24,46,73,77,25,14,11,20
S01009365,Very good health,195,15,1,14,51,26,7,11,30,29,7,3,4,19
S01009365,Good health,155,2,1,1,25,36,11,22,21,28,9,5,4,1
S01009365,Fair health,72,1,0,1,2,16,5,11,17,15,5,4,1,0
S01009365,Bad health,20,1,0,1,3,1,1,2,5,4,3,1,2,0
S01009365,Very bad health,3,1,0,1,0,0,0,0,0,1,1,1,0,0
S01009366,All people aged 16 to 74,549,27,7,20,72,93,45,56,112,93,27,14,13,24
S01009366,Very good health,214,11,3,8,39,34,19,21,37,29,8,5,3,16
S01009366,Good health,208,14,4,10,19,41,13,23,52,31,10,4,6,5
S01009366,Fair health,86,2,0,2,9,12,11,9,17,16,7,4,3,3
S01009366,Bad health,33,0,0,0,5,4,2,3,4,13,2,1,1,0
S01009366,Very bad health,8,0,0,0,0,2,0,0,2,4,0,0,0,0
S01009367,All people aged 16 to 74,473,19,2,17,88,74,21,59,88,75,19,8,11,30
S01009367,Very good health,192,9,2,7,44,31,8,22,32,18,6,1,5,22
S01009367,Good health,179,8,0,8,26,35,11,21,33,34,6,3,3,5
S01009367,Fair health,75,2,0,2,12,6,2,11,20,15,5,2,3,2
S01009367,Bad health,22,0,0,0,5,1,0,5,2,7,1,1,0,1
S01009367,Very bad health,5,0,0,0,1,1,0,0,1,1,1,1,0,0
S01009368,All people aged 16 to 74,428,12,1,11,50,75,23,41,100,79,22,6,16,26
S01009368,Very good health,183,6,0,6,27,24,8,22,37,37,4,1,3,18
S01009368,Good health,151,3,0,3,15,33,12,10,41,25,8,2,6,4
S01009368,Fair health,70,2,1,1,6,15,3,7,14,13,6,1,5,4
S01009368,Bad health,20,0,0,0,2,3,0,2,6,4,3,1,2,0
S01009368,Very bad health,4,1,0,1,0,0,0,0,2,0,1,1,0,0
S01009369,All people aged 16 to 74,431,13,0,13,75,71,23,44,78,71,25,15,10,31
S01009369,Very good health,182,9,0,9,39,28,8,16,28,22,11,8,3,21
S01009369,Good health,174,1,0,1,28,30,10,20,30,37,8,4,4,10
S01009369,Fair health,53,1,0,1,5,10,4,6,13,11,3,0,3,0
S01009369,Bad health,18,2,0,2,1,3,1,2,5,1,3,3,0,0
S01009369,Very bad health,4,0,0,0,2,0,0,0,2,0,0,0,0,0
S01009370,All people aged 16 to 74,668,40,8,32,111,122,32,60,134,97,35,23,12,37
S01009370,Very good health,280,19,3,16,47,57,9,22,54,30,14,10,4,28
S01009370,Good health,238,15,2,13,46,39,14,18,45,42,11,7,4,8
S01009370,Fair health,111,4,2,2,13,17,6,16,26,19,9,5,4,1
S01009370,Bad health,32,1,1,0,5,7,3,4,7,4,1,1,0,0
S01009370,Very bad health,7,1,0,1,0,2,0,0,2,2,0,0,0,0
S01009371,All people aged 16 to 74,397,17,5,12,74,62,12,32,79,77,16,10,6,28
S01009371,Very good health,173,7,3,4,39,26,5,13,34,26,3,0,3,20
S01009371,Good health,149,7,1,6,24,28,6,15,27,27,8,5,3,7
S01009371,Fair health,54,3,1,2,9,6,1,2,12,17,3,3,0,1
S01009371,Bad health,16,0,0,0,2,2,0,2,3,5,2,2,0,0
S01009371,Very bad health,5,0,0,0,0,0,0,0,3,2,0,0,0,0
S01009372,All people aged 16 to 74,407,18,3,15,60,53,29,50,87,63,18,10,8,29
S01009372,Very good health,181,7,2,5,25,22,11,26,38,26,3,2,1,23
S01009372,Good health,155,9,0,9,29,17,11,17,32,23,11,5,6,6
S01009372,Fair health,56,2,1,1,6,12,4,4,13,11,4,3,1,0
S01009372,Bad health,13,0,0,0,0,2,2,3,3,3,0,0,0,0
S01009372,Very bad health,2,0,0,0,0,0,1,0,1,0,0,0,0,0
S01009373,All people aged 16 to 74,597,19,1,18,98,82,27,61,121,110,55,36,19,24
S01009373,Very good health,247,10,0,10,51,34,10,31,43,43,15,10,5,10
S01009373,Good health,202,6,0,6,33,29,9,13,41,36,24,12,12,11
S01009373,Fair health,94,2,1,1,9,13,5,8,26,17,12,10,2,2
S01009373,Bad health,38,0,0,0,4,4,1,5,8,12,3,3,0,1
S01009373,Very bad health,16,1,0,1,1,2,2,4,3,2,1,1,0,0
S01009374,All people aged 16 to 74,653,39,10,29,101,100,33,77,127,109,36,19,17,31
S01009374,Very good health,268,21,5,16,43,45,13,29,47,36,13,7,6,21
S01009374,Good health,223,10,1,9,35,37,13,26,44,38,12,4,8,8
S01009374,Fair health,108,6,3,3,13,14,4,10,27,24,9,7,2,1
S01009374,Bad health,38,2,1,1,6,2,3,9,4,10,1,0,1,1
S01009374,Very bad health,16,0,0,0,4,2,0,3,5,1,1,1,0,0
S01009375,All people aged 16 to 74,606,22,7,15,92,66,22,76,146,115,31,15,16,36
S01009375,Very good health,227,10,4,6,48,25,6,28,40,35,9,6,3,26
S01009375,Good health,240,7,2,5,28,26,13,28,68,46,16,5,11,8
S01009375,Fair health,98,4,0,4,10,9,2,12,27,27,5,3,2,2
S01009375,Bad health,31,0,0,0,4,3,1,7,9,6,1,1,0,0
S01009375,Very bad health,10,1,1,0,2,3,0,1,2,1,0,0,0,0
S01009376,All people aged 16 to 74,446,16,6,10,50,79,19,49,91,95,26,18,8,21
S01009376,Very good health,162,5,3,2,19,37,8,17,19,34,9,3,6,14
S01009376,Good health,166,9,2,7,19,29,9,16,33,37,8,6,2,6
S01009376,Fair health,85,1,0,1,10,9,2,12,26,18,6,6,0,1
S01009376,Bad health,27,1,1,0,1,1,0,4,13,6,1,1,0,0
S01009376,Very bad health,6,0,0,0,1,3,0,0,0,0,2,2,0,0
S01009377,All people aged 16 to 74,978,52,12,40,219,339,37,71,118,76,28,13,15,38
S01009377,Very good health,559,31,7,24,120,224,10,37,50,49,12,7,5,26
S01009377,Good health,332,18,4,14,82,105,14,25,49,22,7,0,7,10
S01009377,Fair health,69,2,1,1,15,10,10,6,18,2,4,1,3,2
S01009377,Bad health,14,1,0,1,2,0,2,2,1,2,4,4,0,0
S01009377,Very bad health,4,0,0,0,0,0,1,1,0,1,1,1,0,0
S01009378,All people aged 16 to 74,717,33,5,28,125,126,43,58,136,95,27,11,16,74
S01009378,Very good health,354,24,3,21,71,65,15,29,55,32,7,3,4,56
S01009378,Good health,260,8,1,7,39,42,23,22,58,38,17,6,11,13
S01009378,Fair health,68,1,1,0,13,8,4,3,15,18,2,1,1,4
S01009378,Bad health,31,0,0,0,2,10,1,4,7,6,0,0,0,1
S01009378,Very bad health,4,0,0,0,0,1,0,0,1,1,1,1,0,0
S01009379,All people aged 16 to 74,678,71,11,60,148,134,34,59,84,58,33,14,19,57
S01009379,Very good health,396,45,9,36,90,77,23,31,43,29,14,6,8,44
S01009379,Good health,205,18,1,17,48,43,7,23,26,18,10,2,8,12
S01009379,Fair health,57,6,1,5,8,10,4,4,10,7,7,4,3,1
S01009379,Bad health,16,2,0,2,2,3,0,1,3,3,2,2,0,0
S01009379,Very bad health,4,0,0,0,0,1,0,0,2,1,0,0,0,0
S01009380,All people aged 16 to 74,467,27,17,10,93,79,21,47,79,62,23,18,5,36
S01009380,Very good health,235,17,11,6,49,45,12,20,40,21,8,5,3,23
S01009380,Good health,158,8,5,3,33,23,5,15,28,27,8,6,2,11
S01009380,Fair health,56,1,1,0,9,9,3,8,8,11,5,5,0,2
S01009380,Bad health,11,0,0,0,2,1,1,1,2,2,2,2,0,0
S01009380,Very bad health,7,1,0,1,0,1,0,3,1,1,0,0,0,0
S01009381,All people aged 16 to 74,517,66,12,54,115,90,39,36,69,49,14,5,9,39
S01009381,Very good health,252,33,5,28,63,51,21,13,24,18,2,1,1,27
S01009381,Good health,187,26,7,19,35,31,13,17,31,18,6,3,3,10
S01009381,Fair health,59,6,0,6,13,6,3,4,11,10,5,0,5,1
S01009381,Bad health,13,1,0,1,3,1,1,0,3,3,1,1,0,0
S01009381,Very bad health,6,0,0,0,1,1,1,2,0,0,0,0,0,1
S01009382,All people aged 16 to 74,605,31,7,24,96,89,43,45,120,113,23,10,13,45
S01009382,Very good health,220,14,3,11,44,37,15,11,34,27,9,5,4,29
S01009382,Good health,249,14,3,11,37,34,19,26,50,51,6,3,3,12
S01009382,Fair health,89,2,1,1,9,12,4,6,25,24,4,1,3,3
S01009382,Bad health,38,1,0,1,5,5,4,1,8,10,3,0,3,1
S01009382,Very bad health,9,0,0,0,1,1,1,1,3,1,1,1,0,0
S01009383,All people aged 16 to 74,638,29,3,26,127,99,40,62,122,89,41,20,21,29
S01009383,Very good health,253,12,1,11,61,45,11,22,40,28,15,5,10,19
S01009383,Good health,246,11,2,9,45,37,19,26,54,32,14,6,8,8
S01009383,Fair health,94,3,0,3,15,10,9,9,17,19,10,7,3,2
S01009383,Bad health,35,1,0,1,5,5,1,4,8,9,2,2,0,0
S01009383,Very bad health,10,2,0,2,1,2,0,1,3,1,0,0,0,0
S01009384,All people aged 16 to 74,434,81,15,66,157,59,43,19,32,11,13,10,3,19
S01009384,Very good health,252,57,9,48,91,31,23,5,17,7,4,4,0,17
S01009384,Good health,126,21,5,16,48,18,13,6,10,2,7,5,2,1
S01009384,Fair health,39,3,1,2,14,6,4,6,4,0,1,0,1,1
S01009384,Bad health,13,0,0,0,3,4,2,1,1,2,0,0,0,0
S01009384,Very bad health,4,0,0,0,1,0,1,1,0,0,1,1,0,0
S01009385,All people aged 16 to 74,381,66,11,55,88,55,30,34,49,32,8,5,3,19
S01009385,Very good health,200,40,7,33,53,32,11,13,23,9,2,1,1,17
S01009385,Good health,126,18,3,15,27,16,14,14,18,13,5,3,2,1
S01009385,Fair health,35,5,0,5,5,3,5,5,5,5,1,1,0,1
S01009385,Bad health,15,2,0,2,2,2,0,2,2,5,0,0,0,0
S01009385,Very bad health,5,1,1,0,1,2,0,0,1,0,0,0,0,0
S01009386,All people aged 16 to 74,497,11,5,6,89,67,24,52,119,78,24,12,12,33
S01009386,Very good health,214,9,4,5,33,35,12,19,47,31,10,5,5,18
S01009386,Good health,181,1,0,1,40,21,11,21,43,22,9,3,6,13
S01009386,Fair health,68,1,1,0,10,8,1,8,15,20,4,3,1,1
S01009386,Bad health,23,0,0,0,4,2,0,3,9,3,1,1,0,1
S01009386,Very bad health,11,0,0,0,2,1,0,1,5,2,0,0,0,0
S01009387,All people aged 16 to 74,441,30,6,24,67,69,21,34,85,85,23,8,15,27
S01009387,Very good health,178,15,2,13,35,26,6,9,34,28,6,2,4,19
S01009387,Good health,176,10,3,7,23,30,9,16,36,34,10,4,6,8
S01009387,Fair health,52,3,1,2,4,9,5,4,8,13,6,1,5,0
S01009387,Bad health,28,2,0,2,5,1,1,5,5,8,1,1,0,0
S01009387,Very bad health,7,0,0,0,0,3,0,0,2,2,0,0,0,0
S01009388,All people aged 16 to 74,644,26,3,23,79,77,28,61,127,120,68,33,35,58
S01009388,Very good health,277,14,2,12,48,38,10,25,40,46,18,7,11,38
S01009388,Good health,232,8,0,8,22,30,16,22,48,44,26,13,13,16
S01009388,Fair health,96,3,1,2,7,6,1,10,26,20,19,9,10,4
S01009388,Bad health,29,1,0,1,2,3,1,2,12,6,2,1,1,0
S01009388,Very bad health,10,0,0,0,0,0,0,2,1,4,3,3,0,0
S01009389,All people aged 16 to 74,726,85,13,72,170,113,55,57,102,77,25,10,15,42
S01009389,Very good health,329,48,7,41,90,47,15,24,25,40,8,3,5,32
S01009389,Good health,268,29,5,24,60,47,30,17,46,24,8,3,5,7
S01009389,Fair health,84,6,0,6,11,14,7,14,15,8,8,4,4,1
S01009389,Bad health,35,2,1,1,6,4,1,1,15,3,1,0,1,2
S01009389,Very bad health,10,0,0,0,3,1,2,1,1,2,0,0,0,0
S01009390,All people aged 16 to 74,543,116,27,89,175,95,26,16,47,15,4,2,2,49
S01009390,Very good health,353,88,20,68,105,56,15,10,27,6,3,2,1,43
S01009390,Good health,162,25,7,18,62,35,11,4,16,5,0,0,0,4
S01009390,Fair health,24,3,0,3,7,4,0,2,4,2,1,0,1,1
S01009390,Bad health,2,0,0,0,0,0,0,0,0,1,0,0,0,1
S01009390,Very bad health,2,0,0,0,1,0,0,0,0,1,0,0,0,0
S01009391,All people aged 16 to 74,509,70,17,53,169,92,33,32,51,26,3,3,0,33
S01009391,Very good health,315,45,8,37,102,54,22,23,31,11,1,1,0,26
S01009391,Good health,148,21,8,13,51,30,9,8,14,9,0,0,0,6
S01009391,Fair health,39,4,1,3,12,7,2,1,5,5,2,2,0,1
S01009391,Bad health,7,0,0,0,4,1,0,0,1,1,0,0,0,0
S01009391,Very bad health,0,0,0,0,0,0,0,0,0,0,0,0,0,0
S01009392,All people aged 16 to 74,370,65,10,55,112,71,29,19,40,12,2,1,1,20
S01009392,Very good health,244,42,6,36,79,44,16,12,25,6,2,1,1,18
S01009392,Good health,99,16,3,13,24,23,11,6,12,5,0,0,0,2
S01009392,Fair health,19,5,0,5,8,3,0,0,2,1,0,0,0,0
S01009392,Bad health,6,2,1,1,1,1,2,0,0,0,0,0,0,0
S01009392,Very bad health,2,0,0,0,0,0,0,1,1,0,0,0,0,0
S01009393,All people aged 16 to 74,528,57,6,51,143,90,50,41,61,35,16,11,5,35
S01009393,Very good health,280,38,5,33,84,39,19,20,37,15,3,3,0,25
S01009393,Good health,188,14,1,13,48,39,29,17,15,13,5,2,3,8
S01009393,Fair health,45,3,0,3,7,8,2,3,8,6,6,5,1,2
S01009393,Bad health,14,1,0,1,4,4,0,1,1,1,2,1,1,0
S01009393,Very bad health,1,1,0,1,0,0,0,0,0,0,0,0,0,0
S01009394,All people aged 16 to 74,695,123,17,106,196,124,46,45,53,44,20,10,10,44
S01009394,Very good health,380,72,13,59,111,66,19,24,26,22,6,2,4,34
S01009394,Good health,244,41,2,39,66,51,16,21,19,16,6,1,5,8
S01009394,Fair health,50,9,2,7,12,5,9,0,6,2,5,5,0,2
S01009394,Bad health,16,0,0,0,6,2,1,0,2,2,3,2,1,0
S01009394,Very bad health,5,1,0,1,1,0,1,0,0,2,0,0,0,0
S01009395,All people aged 16 to 74,498,97,23,74,165,83,35,25,46,23,3,2,1,21
S01009395,Very good health,263,53,13,40,82,48,16,12,21,12,1,0,1,18
S01009395,Good health,175,39,10,29,65,27,13,7,13,8,1,1,0,2
S01009395,Fair health,50,4,0,4,15,7,3,6,10,3,1,1,0,1
S01009395,Bad health,8,1,0,1,2,1,3,0,1,0,0,0,0,0
S01009395,Very bad health,2,0,0,0,1,0,0,0,1,0,0,0,0,0
S01009396,All people aged 16 to 74,562,117,27,90,187,81,44,19,55,15,10,7,3,34
S01009396,Very good health,285,62,14,48,98,40,21,10,25,3,3,2,1,23
S01009396,Good health,210,43,12,31,67,30,19,6,23,8,4,3,1,10
S01009396,Fair health,52,10,1,9,18,8,3,3,6,1,2,1,1,1
S01009396,Bad health,12,2,0,2,3,2,0,0,1,3,1,1,0,0
S01009396,Very bad health,3,0,0,0,1,1,1,0,0,0,0,0,0,0
S01009397,All people aged 16 to 74,534,91,21,70,143,83,36,35,71,29,13,5,8,33
S01009397,Very good health,308,54,14,40,84,51,16,18,39,14,3,2,1,29
S01009397,Good health,165,31,6,25,46,21,17,12,18,10,6,2,4,4
S01009397,Fair health,47,5,1,4,10,11,3,4,9,1,4,1,3,0
S01009397,Bad health,11,1,0,1,3,0,0,1,3,3,0,0,0,0
S01009397,Very bad health,3,0,0,0,0,0,0,0,2,1,0,0,0,0
S01009398,All people aged 16 to 74,533,41,12,29,133,112,42,51,79,34,11,6,5,30
S01009398,Very good health,271,27,10,17,73,54,15,14,34,20,8,4,4,26
S01009398,Good health,191,11,1,10,51,42,18,24,29,11,2,1,1,3
S01009398,Fair health,52,3,1,2,8,13,6,8,10,3,0,0,0,1
S01009398,Bad health,14,0,0,0,1,2,2,4,5,0,0,0,0,0
S01009398,Very bad health,5,0,0,0,0,1,1,1,1,0,1,1,0,0
S01009399,All people aged 16 to 74,534,62,15,47,142,97,33,37,81,43,11,4,7,28
S01009399,Very good health,258,34,9,25,64,52,21,14,33,18,2,1,1,20
S01009399,Good health,217,27,6,21,61,38,6,18,35,19,5,0,5,8
S01009399,Fair health,44,1,0,1,11,5,5,5,10,4,3,2,1,0
S01009399,Bad health,12,0,0,0,6,1,1,0,2,1,1,1,0,0
S01009399,Very bad health,3,0,0,0,0,1,0,0,1,1,0,0,0,0
S01009400,All people aged 16 to 74,390,23,10,13,77,84,24,39,72,39,10,3,7,22
S01009400,Very good health,178,12,4,8,35,45,11,17,28,12,4,1,3,14
S01009400,Good health,147,5,2,3,34,27,7,17,31,15,5,2,3,6
S01009400,Fair health,54,5,3,2,7,9,5,4,12,9,1,0,1,2
S01009400,Bad health,7,1,1,0,1,2,1,0,0,2,0,0,0,0
S01009400,Very bad health,4,0,0,0,0,1,0,1,1,1,0,0,0,0
S01009401,All people aged 16 to 74,504,81,20,61,136,91,30,43,50,27,12,5,7,34
S01009401,Very good health,262,50,12,38,60,52,15,23,23,11,5,3,2,23
S01009401,Good health,169,23,5,18,52,27,8,16,20,12,2,1,1,9
S01009401,Fair health,60,6,2,4,20,9,7,4,6,3,3,1,2,2
S01009401,Bad health,10,1,1,0,3,2,0,0,1,1,2,0,2,0
S01009401,Very bad health,3,1,0,1,1,1,0,0,0,0,0,0,0,0
S01009402,All people aged 16 to 74,693,84,18,66,215,110,63,45,74,44,13,9,4,45
S01009402,Very good health,357,47,10,37,117,38,33,23,32,23,6,5,1,38
S01009402,Good health,238,26,6,20,74,50,19,16,29,13,4,2,2,7
S01009402,Fair health,70,10,2,8,17,14,8,2,11,6,2,1,1,0
S01009402,Bad health,21,1,0,1,5,5,3,3,1,2,1,1,0,0
S01009402,Very bad health,7,0,0,0,2,3,0,1,1,0,0,0,0,0
S01009403,All people aged 16 to 74,400,39,8,31,109,69,23,30,63,28,7,6,1,32
S01009403,Very good health,209,28,6,22,54,32,8,16,26,10,5,5,0,30
S01009403,Good health,143,8,2,6,40,29,10,12,32,9,1,0,1,2
S01009403,Fair health,39,3,0,3,14,6,4,2,5,5,0,0,0,0
S01009403,Bad health,7,0,0,0,0,2,1,0,0,3,1,1,0,0
S01009403,Very bad health,2,0,0,0,1,0,0,0,0,1,0,0,0,0
S01009404,All people aged 16 to 74,410,15,3,12,54,42,28,51,69,87,35,25,10,29
S01009404,Very good health,174,8,2,6,26,19,16,21,32,30,5,3,2,17
S01009404,Good health,146,6,1,5,23,16,9,19,25,27,13,9,4,8
S01009404,Fair health,55,0,0,0,3,4,3,5,9,15,13,10,3,3
S01009404,Bad health,28,0,0,0,2,3,0,3,2,13,4,3,1,1
S01009404,Very bad health,7,1,0,1,0,0,0,3,1,2,0,0,0,0
S01009405,All people aged 16 to 74,315,17,4,13,72,52,41,32,44,27,12,6,6,18
S01009405,Very good health,137,13,3,10,35,31,12,7,13,7,5,5,0,14
S01009405,Good health,129,3,1,2,29,14,19,20,24,12,4,1,3,4
S01009405,Fair health,34,1,0,1,6,4,7,4,5,5,2,0,2,0
S01009405,Bad health,10,0,0,0,1,2,3,1,1,1,1,0,1,0
S01009405,Very bad health,5,0,0,0,1,1,0,0,1,2,0,0,0,0
S01009406,All people aged 16 to 74,695,36,7,29,133,106,60,57,111,127,31,18,13,34
S01009406,Very good health,308,18,3,15,72,47,28,28,38,39,10,4,6,28
S01009406,Good health,252,13,4,9,44,43,22,15,46,53,11,6,5,5
S01009406,Fair health,93,5,0,5,13,13,4,11,19,22,5,5,0,1
S01009406,Bad health,37,0,0,0,4,3,5,3,5,12,5,3,2,0
S01009406,Very bad health,5,0,0,0,0,0,1,0,3,1,0,0,0,0
S01009407,All people aged 16 to 74,393,23,6,17,86,52,33,33,63,67,17,10,7,19
S01009407,Very good health,188,16,3,13,51,28,16,13,24,19,5,2,3,16
S01009407,Good health,134,7,3,4,22,21,11,12,24,29,6,4,2,2
S01009407,Fair health,54,0,0,0,11,3,5,4,12,14,4,2,2,1
S01009407,Bad health,11,0,0,0,1,0,1,3,2,3,1,1,0,0
S01009407,Very bad health,6,0,0,0,1,0,0,1,1,2,1,1,0,0
S01009408,All people aged 16 to 74,581,62,16,46,138,95,52,62,71,56,13,5,8,32
S01009408,Very good health,313,45,11,34,81,50,25,31,25,24,5,3,2,27
S01009408,Good health,190,14,4,10,48,35,13,22,31,18,4,2,2,5
S01009408,Fair health,65,3,1,2,9,7,12,7,14,9,4,0,4,0
S01009408,Bad health,11,0,0,0,0,3,2,1,1,4,0,0,0,0
S01009408,Very bad health,2,0,0,0,0,0,0,1,0,1,0,0,0,0
S01009409,All people aged 16 to 74,492,17,4,13,64,50,21,64,103,112,27,13,14,34
S01009409,Very good health,206,9,2,7,29,25,12,18,45,36,9,5,4,23
S01009409,Good health,169,3,0,3,29,16,6,26,29,41,10,4,6,9
S01009409,Fair health,83,4,1,3,6,7,3,15,18,23,7,3,4,0
S01009409,Bad health,22,1,1,0,0,1,0,4,9,6,0,0,0,1
S01009409,Very bad health,12,0,0,0,0,1,0,1,2,6,1,1,0,1
S01009410,All people aged 16 to 74,667,16,7,9,76,69,45,60,164,148,49,30,19,40
S01009410,Very good health,284,6,3,3,48,35,19,28,57,41,18,11,7,32
S01009410,Good health,224,6,2,4,17,20,10,22,76,52,15,10,5,6
S01009410,Fair health,111,4,2,2,8,10,11,5,24,36,11,5,6,2
S01009410,Bad health,40,0,0,0,3,3,5,5,6,13,5,4,1,0
S01009410,Very bad health,8,0,0,0,0,1,0,0,1,6,0,0,0,0
S01009411,All people aged 16 to 74,641,11,2,9,78,73,38,60,150,154,42,21,21,35
S01009411,Very good health,247,7,0,7,30,36,11,17,59,47,19,11,8,21
S01009411,Good health,231,3,2,1,26,25,17,30,52,53,13,5,8,12
S01009411,Fair health,108,1,0,1,14,7,7,9,23,36,9,4,5,2
S01009411,Bad health,46,0,0,0,8,5,3,3,12,15,0,0,0,0
S01009411,Very bad health,9,0,0,0,0,0,0,1,4,3,1,1,0,0
S01009412,All people aged 16 to 74,644,11,3,8,73,84,33,76,145,164,38,24,14,20
S01009412,Very good health,235,5,2,3,34,39,11,24,48,43,15,10,5,16
S01009412,Good health,245,6,1,5,25,28,10,32,63,69,11,5,6,1
S01009412,Fair health,106,0,0,0,11,12,10,12,21,30,9,6,3,1
S01009412,Bad health,49,0,0,0,2,4,1,8,12,17,3,3,0,2
S01009412,Very bad health,9,0,0,0,1,1,1,0,1,5,0,0,0,0
S01009413,All people aged 16 to 74,774,31,7,24,132,104,55,80,141,152,34,18,16,45
S01009413,Very good health,363,19,7,12,69,54,21,33,56,60,16,11,5,35
S01009413,Good health,263,8,0,8,45,38,24,28,55,48,9,4,5,8
S01009413,Fair health,104,3,0,3,10,9,6,12,25,30,7,3,4,2
S01009413,Bad health,38,1,0,1,8,2,4,6,4,11,2,0,2,0
S01009413,Very bad health,6,0,0,0,0,1,0,1,1,3,0,0,0,0
S01009414,All people aged 16 to 74,503,17,6,11,85,74,30,49,99,95,22,12,10,32
S01009414,Very good health,184,9,3,6,31,29,15,12,33,32,2,0,2,21
S01009414,Good health,204,6,2,4,43,32,7,23,35,37,13,7,6,8
S01009414,Fair health,76,1,0,1,7,11,5,10,21,14,5,3,2,2
S01009414,Bad health,28,1,1,0,3,2,2,3,8,6,2,2,0,1
S01009414,Very bad health,11,0,0,0,1,0,1,1,2,6,0,0,0,0
S01009415,All people aged 16 to 74,600,28,12,16,91,79,42,53,107,105,62,39,23,33
S01009415,Very good health,232,17,8,9,43,27,17,18,37,34,15,10,5,24
S01009415,Good health,214,9,3,6,31,34,16,21,40,39,16,10,6,8
S01009415,Fair health,109,2,1,1,11,11,7,9,21,22,25,15,10,1
S01009415,Bad health,40,0,0,0,6,7,1,5,8,8,5,3,2,0
S01009415,Very bad health,5,0,0,0,0,0,1,0,1,2,1,1,0,0
S01009416,All people aged 16 to 74,419,28,9,19,81,76,32,52,73,36,10,6,4,31
S01009416,Very good health,208,9,3,6,43,43,10,27,33,9,6,4,2,28
S01009416,Good health,146,14,5,9,30,25,15,18,27,15,0,0,0,2
S01009416,Fair health,52,4,1,3,7,6,4,5,10,12,3,2,1,1
S01009416,Bad health,11,1,0,1,1,2,1,2,3,0,1,0,1,0
S01009416,Very bad health,2,0,0,0,0,0,2,0,0,0,0,0,0,0
S01009417,All people aged 16 to 74,222,17,3,14,58,35,35,15,31,18,6,3,3,7
S01009417,Very good health,120,13,1,12,33,21,22,7,13,3,2,1,1,6
S01009417,Good health,67,3,2,1,16,10,8,6,14,7,2,1,1,1
S01009417,Fair health,25,1,0,1,6,3,5,2,2,5,1,1,0,0
S01009417,Bad health,8,0,0,0,2,1,0,0,2,2,1,0,1,0
S01009417,Very bad health,2,0,0,0,1,0,0,0,0,1,0,0,0,0
S01009418,All people aged 16 to 74,834,29,4,25,105,109,53,83,171,200,44,23,21,40
S01009418,Very good health,323,16,2,14,51,46,20,24,67,58,17,12,5,24
S01009418,Good health,290,10,2,8,34,42,14,39,59,64,14,5,9,14
S01009418,Fair health,150,2,0,2,14,12,12,12,36,48,12,5,7,2
S01009418,Bad health,56,0,0,0,4,6,7,7,7,25,0,0,0,0
S01009418,Very bad health,15,1,0,1,2,3,0,1,2,5,1,1,0,0
S01009419,All people aged 16 to 74,428,12,4,8,56,64,15,50,85,89,30,22,8,27
S01009419,Very good health,170,3,1,2,22,28,4,19,31,32,10,7,3,21
S01009419,Good health,152,8,3,5,21,27,6,16,33,27,9,7,2,5
S01009419,Fair health,74,1,0,1,8,6,5,11,15,18,9,6,3,1
S01009419,Bad health,24,0,0,0,3,3,0,1,5,11,1,1,0,0
S01009419,Very bad health,8,0,0,0,2,0,0,3,1,1,1,1,0,0
S01009420,All people aged 16 to 74,459,7,1,6,45,32,13,33,100,148,38,26,12,43
S01009420,Very good health,184,5,1,4,21,11,5,10,35,52,12,6,6,33
S01009420,Good health,158,2,0,2,16,12,3,11,35,56,13,8,5,10
S01009420,Fair health,68,0,0,0,4,5,2,6,22,25,4,3,1,0
S01009420,Bad health,43,0,0,0,4,3,2,4,8,14,8,8,0,0
S01009420,Very bad health,6,0,0,0,0,1,1,2,0,1,1,1,0,0
S01009421,All people aged 16 to 74,522,11,4,7,59,47,28,59,107,129,51,30,21,31
S01009421,Very good health,207,5,2,3,19,22,8,29,46,41,17,10,7,20
S01009421,Good health,194,4,2,2,26,17,10,22,38,46,22,10,12,9
S01009421,Fair health,85,2,0,2,7,6,7,7,16,31,7,5,2,2
S01009421,Bad health,32,0,0,0,6,2,3,1,7,10,3,3,0,0
S01009421,Very bad health,4,0,0,0,1,0,0,0,0,1,2,2,0,0
S01009422,All people aged 16 to 74,584,29,9,20,87,78,23,62,118,115,33,18,15,39
S01009422,Very good health,215,10,4,6,42,31,8,14,41,33,4,3,1,32
S01009422,Good health,242,15,3,12,29,37,10,27,48,53,17,4,13,6
S01009422,Fair health,91,2,1,1,13,5,4,15,20,25,6,5,1,1
S01009422,Bad health,27,1,1,0,2,5,0,4,7,4,4,4,0,0
S01009422,Very bad health,9,1,0,1,1,0,1,2,2,0,2,2,0,0
S01009423,All people aged 16 to 74,691,61,10,51,199,130,52,58,71,56,21,8,13,43
S01009423,Very good health,424,40,5,35,132,76,33,31,35,29,10,2,8,38
S01009423,Good health,211,19,5,14,58,41,15,21,28,19,7,4,3,3
S01009423,Fair health,42,2,0,2,7,11,3,4,6,4,3,1,2,2
S01009423,Bad health,11,0,0,0,1,2,1,1,2,4,0,0,0,0
S01009423,Very bad health,3,0,0,0,1,0,0,1,0,0,1,1,0,0
S01009424,All people aged 16 to 74,441,44,13,31,93,74,25,40,66,58,21,13,8,20
S01009424,Very good health,199,22,5,17,47,30,15,22,23,20,4,2,2,16
S01009424,Good health,150,15,6,9,30,34,6,7,27,21,8,6,2,2
S01009424,Fair health,69,6,2,4,10,8,4,6,14,13,7,3,4,1
S01009424,Bad health,19,1,0,1,4,2,0,5,2,4,0,0,0,1
S01009424,Very bad health,4,0,0,0,2,0,0,0,0,0,2,2,0,0
S01009425,All people aged 16 to 74,558,28,8,20,109,77,32,53,107,90,33,13,20,29
S01009425,Very good health,224,10,2,8,48,31,10,15,46,28,15,9,6,21
S01009425,Good health,209,11,3,8,43,29,15,25,39,32,8,1,7,7
S01009425,Fair health,82,5,3,2,13,10,4,12,12,16,9,2,7,1
S01009425,Bad health,37,2,0,2,5,6,3,1,9,10,1,1,0,0
S01009425,Very bad health,6,0,0,0,0,1,0,0,1,4,0,0,0,0
S01009426,All people aged 16 to 74,566,15,6,9,68,73,28,52,131,127,45,28,17,27
S01009426,Very good health,182,8,2,6,26,28,4,14,38,31,14,11,3,19
S01009426,Good health,224,6,4,2,30,29,16,22,51,47,16,6,10,7
S01009426,Fair health,105,1,0,1,8,11,6,12,30,26,10,6,4,1
S01009426,Bad health,42,0,0,0,3,4,2,4,9,17,3,3,0,0
S01009426,Very bad health,13,0,0,0,1,1,0,0,3,6,2,2,0,0
S01009427,All people aged 16 to 74,433,18,5,13,44,55,25,36,84,105,51,28,23,15
S01009427,Very good health,162,7,1,6,21,27,10,18,27,32,13,2,11,7
S01009427,Good health,142,5,1,4,15,20,6,10,29,33,19,13,6,5
S01009427,Fair health,93,4,3,1,6,6,7,6,17,31,14,9,5,2
S01009427,Bad health,28,1,0,1,1,1,2,2,7,9,4,4,0,1
S01009427,Very bad health,8,1,0,1,1,1,0,0,4,0,1,0,1,0
S01009428,All people aged 16 to 74,430,13,1,12,59,52,25,48,81,94,32,17,15,26
S01009428,Very good health,170,6,0,6,25,18,10,21,30,30,13,6,7,17
S01009428,Good health,152,5,0,5,25,15,11,15,26,34,14,9,5,7
S01009428,Fair health,71,2,1,1,6,13,4,7,20,15,3,0,3,1
S01009428,Bad health,32,0,0,0,2,6,0,5,4,13,1,1,0,1
S01009428,Very bad health,5,0,0,0,1,0,0,0,1,2,1,1,0,0
S01009429,All people aged 16 to 74,514,18,4,14,51,53,12,51,107,140,47,35,12,35
S01009429,Very good health,171,2,1,1,14,19,3,18,28,45,16,10,6,26
S01009429,Good health,169,8,3,5,26,16,7,17,38,31,17,12,5,9
S01009429,Fair health,107,6,0,6,8,9,2,11,21,41,9,8,1,0
S01009429,Bad health,50,2,0,2,2,9,0,2,17,16,2,2,0,0
S01009429,Very bad health,17,0,0,0,1,0,0,3,3,7,3,3,0,0
S01009430,All people aged 16 to 74,547,19,7,12,69,74,33,40,128,115,36,22,14,33
S01009430,Very good health,223,5,2,3,27,44,15,15,51,30,13,9,4,23
S01009430,Good health,180,9,4,5,24,15,10,16,52,36,11,3,8,7
S01009430,Fair health,94,2,0,2,11,11,5,5,16,31,10,8,2,3
S01009430,Bad health,38,3,1,2,5,3,2,3,5,15,2,2,0,0
S01009430,Very bad health,12,0,0,0,2,1,1,1,4,3,0,0,0,0
S01009431,All people aged 16 to 74,477,18,3,15,84,48,34,57,68,96,42,30,12,30
S01009431,Very good health,196,12,3,9,33,24,13,21,27,29,15,10,5,22
S01009431,Good health,167,3,0,3,37,16,13,25,25,24,18,12,6,6
S01009431,Fair health,74,3,0,3,8,5,5,9,10,26,6,5,1,2
S01009431,Bad health,32,0,0,0,5,2,2,1,6,13,3,3,0,0
S01009431,Very bad health,8,0,0,0,1,1,1,1,0,4,0,0,0,0
S01009432,All people aged 16 to 74,584,7,2,5,43,59,17,60,156,144,53,38,15,45
S01009432,Very good health,221,4,2,2,15,21,7,22,57,38,24,15,9,33
S01009432,Good health,182,2,0,2,13,26,4,20,53,39,16,12,4,9
S01009432,Fair health,102,1,0,1,8,5,5,11,27,35,7,5,2,3
S01009432,Bad health,63,0,0,0,5,7,1,6,13,26,5,5,0,0
S01009432,Very bad health,16,0,0,0,2,0,0,1,6,6,1,1,0,0
S01009433,All people aged 16 to 74,590,9,1,8,52,60,26,56,138,128,71,44,27,50
S01009433,Very good health,234,4,1,3,25,25,11,27,47,31,26,14,12,38
S01009433,Good health,192,2,0,2,19,23,5,20,52,44,18,13,5,9
S01009433,Fair health,120,3,0,3,3,7,9,7,26,41,21,14,7,3
S01009433,Bad health,35,0,0,0,4,3,1,2,11,9,5,3,2,0
S01009433,Very bad health,9,0,0,0,1,2,0,0,2,3,1,0,1,0
S01009434,All people aged 16 to 74,398,3,2,1,50,51,26,41,69,92,38,25,13,28
S01009434,Very good health,154,1,0,1,19,23,11,13,27,25,13,10,3,22
S01009434,Good health,127,1,1,0,18,17,8,12,22,33,14,7,7,2
S01009434,Fair health,85,1,1,0,10,9,7,9,18,19,10,8,2,2
S01009434,Bad health,25,0,0,0,3,2,0,6,1,10,1,0,1,2
S01009434,Very bad health,7,0,0,0,0,0,0,1,1,5,0,0,0,0
S01009435,All people aged 16 to 74,544,7,1,6,55,38,30,59,127,122,75,41,34,31
S01009435,Very good health,214,3,1,2,28,20,8,23,50,35,26,11,15,21
S01009435,Good health,182,3,0,3,20,14,11,19,45,40,22,10,12,8
S01009435,Fair health,95,1,0,1,4,1,7,10,22,31,18,12,6,1
S01009435,Bad health,46,0,0,0,3,2,4,6,9,14,8,7,1,0
S01009435,Very bad health,7,0,0,0,0,1,0,1,1,2,1,1,0,1
S01009436,All people aged 16 to 74,508,17,6,11,76,66,21,56,133,87,26,12,14,26
S01009436,Very good health,204,10,5,5,38,27,9,22,52,25,4,1,3,17
S01009436,Good health,178,4,0,4,26,25,8,18,45,34,10,3,7,8
S01009436,Fair health,89,2,1,1,5,10,4,9,30,20,8,4,4,1
S01009436,Bad health,31,1,0,1,7,4,0,6,5,6,2,2,0,0
S01009436,Very bad health,6,0,0,0,0,0,0,1,1,2,2,2,0,0
S01009437,All people aged 16 to 74,514,15,6,9,70,62,44,53,107,116,20,8,12,27
S01009437,Very good health,233,10,3,7,34,37,18,25,47,37,6,1,5,19
S01009437,Good health,163,5,3,2,21,14,18,15,35,40,8,3,5,7
S01009437,Fair health,68,0,0,0,11,7,6,9,12,18,4,2,2,1
S01009437,Bad health,44,0,0,0,4,4,2,4,9,19,2,2,0,0
S01009437,Very bad health,6,0,0,0,0,0,0,0,4,2,0,0,0,0
S01009438,All people aged 16 to 74,635,19,3,16,74,68,47,64,126,141,43,26,17,53
S01009438,Very good health,250,11,2,9,36,33,21,19,44,40,10,4,6,36
S01009438,Good health,204,5,1,4,24,20,13,24,43,46,17,10,7,12
S01009438,Fair health,118,3,0,3,10,11,9,13,28,29,11,7,4,4
S01009438,Bad health,46,0,0,0,4,3,3,5,7,21,2,2,0,1
S01009438,Very bad health,17,0,0,0,0,1,1,3,4,5,3,3,0,0
S01009439,All people aged 16 to 74,690,8,1,7,82,62,25,93,147,163,58,31,27,52
S01009439,Very good health,273,5,1,4,36,25,13,34,47,54,24,11,13,35
S01009439,Good health,221,2,0,2,30,26,5,29,39,52,24,11,13,14
S01009439,Fair health,126,1,0,1,8,6,6,19,36,39,9,8,1,2
S01009439,Bad health,57,0,0,0,7,5,1,10,19,13,1,1,0,1
S01009439,Very bad health,13,0,0,0,1,0,0,1,6,5,0,0,0,0
S01009440,All people aged 16 to 74,464,17,3,14,50,58,29,46,117,104,33,19,14,10
S01009440,Very good health,179,7,3,4,20,29,13,19,42,34,7,5,2,8
S01009440,Good health,165,7,0,7,19,23,12,16,46,25,15,8,7,2
S01009440,Fair health,81,3,0,3,8,3,3,7,19,28,10,6,4,0
S01009440,Bad health,32,0,0,0,3,2,1,2,8,15,1,0,1,0
S01009440,Very bad health,7,0,0,0,0,1,0,2,2,2,0,0,0,0
S01009441,All people aged 16 to 74,582,7,2,5,61,58,29,64,137,136,48,24,24,42
S01009441,Very good health,249,6,1,5,33,21,16,19,61,44,24,13,11,25
S01009441,Good health,196,0,0,0,20,25,7,26,42,48,14,6,8,14
S01009441,Fair health,93,1,1,0,8,6,3,14,20,30,8,4,4,3
S01009441,Bad health,34,0,0,0,0,6,3,5,10,9,1,0,1,0
S01009441,Very bad health,10,0,0,0,0,0,0,0,4,5,1,1,0,0
S01009442,All people aged 16 to 74,415,27,5,22,93,58,55,44,57,38,16,14,2,27
S01009442,Very good health,205,18,4,14,50,31,28,20,24,15,4,4,0,15
S01009442,Good health,144,7,1,6,28,20,18,19,22,14,7,5,2,9
S01009442,Fair health,43,1,0,1,9,7,7,4,5,6,3,3,0,1
S01009442,Bad health,15,0,0,0,3,0,2,1,4,2,1,1,0,2
S01009442,Very bad health,8,1,0,1,3,0,0,0,2,1,1,1,0,0
S01009443,All people aged 16 to 74,499,30,8,22,100,65,62,54,78,64,20,12,8,26
S01009443,Very good health,207,15,4,11,55,23,24,20,35,16,3,0,3,16
S01009443,Good health,169,10,4,6,32,28,19,18,30,21,4,1,3,7
S01009443,Fair health,78,4,0,4,7,8,15,6,12,17,7,5,2,2
S01009443,Bad health,39,1,0,1,3,5,4,9,1,9,6,6,0,1
S01009443,Very bad health,6,0,0,0,3,1,0,1,0,1,0,0,0,0
S01009444,All people aged 16 to 74,637,53,13,40,131,106,46,68,116,55,23,18,5,39
S01009444,Very good health,319,22,5,17,67,61,16,31,49,27,11,9,2,35
S01009444,Good health,220,22,6,16,50,29,23,25,43,18,6,4,2,4
S01009444,Fair health,74,7,1,6,12,10,7,6,20,8,4,4,0,0
S01009444,Bad health,21,2,1,1,1,6,0,5,4,2,1,0,1,0
S01009444,Very bad health,3,0,0,0,1,0,0,1,0,0,1,1,0,0
S01009445,All people aged 16 to 74,591,7,2,5,75,61,36,65,134,145,35,23,12,33
S01009445,Very good health,238,3,1,2,37,33,15,23,47,49,12,7,5,19
S01009445,Good health,195,3,1,2,25,18,10,23,42,47,16,11,5,11
S01009445,Fair health,105,1,0,1,10,8,8,10,26,35,5,3,2,2
S01009445,Bad health,40,0,0,0,3,1,2,6,14,11,2,2,0,1
S01009445,Very bad health,13,0,0,0,0,1,1,3,5,3,0,0,0,0
S01009446,All people aged 16 to 74,632,13,2,11,67,67,34,55,144,139,71,41,30,42
S01009446,Very good health,213,5,1,4,25,23,11,16,51,35,18,8,10,29
S01009446,Good health,227,6,1,5,22,27,13,19,51,50,27,12,15,12
S01009446,Fair health,129,1,0,1,13,13,6,14,26,38,18,16,2,0
S01009446,Bad health,53,1,0,1,6,4,3,6,12,12,8,5,3,1
S01009446,Very bad health,10,0,0,0,1,0,1,0,4,4,0,0,0,0
S01009447,All people aged 16 to 74,391,14,2,12,48,49,25,32,77,88,33,20,13,25
S01009447,Very good health,144,7,1,6,22,18,10,11,27,22,10,7,3,17
S01009447,Good health,142,5,1,4,18,20,8,14,31,28,11,4,7,7
S01009447,Fair health,62,1,0,1,5,7,4,4,13,19,8,5,3,1
S01009447,Bad health,36,1,0,1,2,3,3,2,6,16,3,3,0,0
S01009447,Very bad health,7,0,0,0,1,1,0,1,0,3,1,1,0,0
S01009448,All people aged 16 to 74,622,38,11,27,134,84,40,63,108,101,28,15,13,26
S01009448,Very good health,267,23,7,16,64,41,15,35,41,27,6,2,4,15
S01009448,Good health,213,12,4,8,44,31,18,14,40,36,9,3,6,9
S01009448,Fair health,101,2,0,2,22,9,6,11,18,24,8,5,3,1
S01009448,Bad health,30,0,0,0,2,3,0,3,9,7,5,5,0,1
S01009448,Very bad health,11,1,0,1,2,0,1,0,0,7,0,0,0,0
S01009449,All people aged 16 to 74,375,12,4,8,51,51,28,35,84,74,19,15,4,21
S01009449,Very good health,140,6,3,3,21,24,7,13,24,24,5,3,2,16
S01009449,Good health,135,3,0,3,22,23,12,10,33,22,6,5,1,4
S01009449,Fair health,60,3,1,2,4,3,6,7,17,15,4,3,1,1
S01009449,Bad health,28,0,0,0,4,1,2,2,10,7,2,2,0,0
S01009449,Very bad health,12,0,0,0,0,0,1,3,0,6,2,2,0,0
S01009450,All people aged 16 to 74,444,5,1,4,39,47,23,38,91,138,50,28,22,13
S01009450,Very good health,155,1,0,1,11,25,9,15,34,35,17,8,9,8
S01009450,Good health,153,2,0,2,21,12,8,15,35,42,14,9,5,4
S01009450,Fair health,97,2,1,1,6,8,4,6,18,34,18,10,8,1
S01009450,Bad health,28,0,0,0,1,2,2,0,3,20,0,0,0,0
S01009450,Very bad health,11,0,0,0,0,0,0,2,1,7,1,1,0,0
S01009451,All people aged 16 to 74,716,10,5,5,70,76,49,82,141,176,73,44,29,39
S01009451,Very good health,271,5,3,2,32,35,14,31,56,46,27,13,14,25
S01009451,Good health,268,4,2,2,29,33,19,31,49,67,24,15,9,12
S01009451,Fair health,119,0,0,0,6,2,12,14,26,38,19,14,5,2
S01009451,Bad health,41,1,0,1,3,5,4,6,6,15,1,0,1,0
S01009451,Very bad health,17,0,0,0,0,1,0,0,4,10,2,2,0,0
S01009452,All people aged 16 to 74,375,7,1,6,39,44,20,27,99,89,32,18,14,18
S01009452,Very good health,124,3,0,3,11,19,5,12,30,21,14,8,6,9
S01009452,Good health,157,3,0,3,18,15,8,8,51,39,9,4,5,6
S01009452,Fair health,54,1,1,0,7,6,5,2,10,16,5,2,3,2
S01009452,Bad health,30,0,0,0,2,4,1,4,6,9,3,3,0,1
S01009452,Very bad health,10,0,0,0,1,0,1,1,2,4,1,1,0,0
S01009453,All people aged 16 to 74,738,19,5,14,93,102,38,97,144,150,48,28,20,47
S01009453,Very good health,268,8,2,6,44,32,12,37,45,40,15,6,9,35
S01009453,Good health,279,9,3,6,26,53,15,34,58,58,16,11,5,10
S01009453,Fair health,115,2,0,2,15,10,6,14,25,26,15,9,6,2
S01009453,Bad health,63,0,0,0,8,5,4,8,14,23,1,1,0,0
S01009453,Very bad health,13,0,0,0,0,2,1,4,2,3,1,1,0,0
S01009454,All people aged 16 to 74,658,127,23,104,210,76,48,37,70,36,15,8,7,39
S01009454,Very good health,382,84,14,70,131,42,26,25,24,14,2,0,2,34
S01009454,Good health,195,32,6,26,63,27,15,8,24,13,8,3,5,5
S01009454,Fair health,57,6,2,4,9,5,5,2,19,7,4,4,0,0
S01009454,Bad health,20,4,1,3,6,2,2,2,3,0,1,1,0,0
S01009454,Very bad health,4,1,0,1,1,0,0,0,0,2,0,0,0,0
S01009455,All people aged 16 to 74,615,129,32,97,201,69,75,24,39,31,9,4,5,38
S01009455,Very good health,350,83,17,66,121,29,38,13,20,10,3,1,2,33
S01009455,Good health,190,36,14,22,69,25,21,8,12,13,2,0,2,4
S01009455,Fair health,50,8,0,8,5,12,12,1,3,7,1,0,1,1
S01009455,Bad health,19,2,1,1,4,3,3,2,4,1,0,0,0,0
S01009455,Very bad health,6,0,0,0,2,0,1,0,0,0,3,3,0,0
S01009456,All people aged 16 to 74,518,22,8,14,90,56,49,49,98,103,32,22,10,19
S01009456,Very good health,211,11,4,7,42,23,19,19,40,34,12,8,4,11
S01009456,Good health,177,7,2,5,30,17,18,19,30,34,14,10,4,8
S01009456,Fair health,87,4,2,2,11,9,11,9,18,21,4,2,2,0
S01009456,Bad health,33,0,0,0,5,6,0,2,8,11,1,1,0,0
S01009456,Very bad health,10,0,0,0,2,1,1,0,2,3,1,1,0,0
S01009457,All people aged 16 to 74,445,41,13,28,114,51,73,33,69,42,5,4,1,17
S01009457,Very good health,225,23,8,15,65,25,37,11,35,13,2,2,0,14
S01009457,Good health,150,13,4,9,37,18,29,12,20,17,2,2,0,2
S01009457,Fair health,50,5,1,4,8,7,3,5,11,9,1,0,1,1
S01009457,Bad health,15,0,0,0,2,1,2,5,3,2,0,0,0,0
S01009457,Very bad health,5,0,0,0,2,0,2,0,0,1,0,0,0,0
S01009458,All people aged 16 to 74,481,45,12,33,114,70,42,43,72,57,17,6,11,21
S01009458,Very good health,230,29,9,20,71,25,22,20,27,16,7,1,6,13
S01009458,Good health,173,10,2,8,33,33,16,18,32,19,7,4,3,5
S01009458,Fair health,50,3,0,3,7,8,3,3,7,14,2,1,1,3
S01009458,Bad health,21,3,1,2,1,3,0,2,4,8,0,0,0,0
S01009458,Very bad health,7,0,0,0,2,1,1,0,2,0,1,0,1,0
S01009459,All people aged 16 to 74,649,43,10,33,132,72,67,68,102,85,38,14,24,42
S01009459,Very good health,265,23,4,19,69,35,23,21,32,28,12,4,8,22
S01009459,Good health,240,12,5,7,52,28,26,28,43,23,14,4,10,14
S01009459,Fair health,98,5,0,5,6,7,14,14,16,23,7,3,4,6
S01009459,Bad health,37,3,1,2,4,2,4,4,7,8,5,3,2,0
S01009459,Very bad health,9,0,0,0,1,0,0,1,4,3,0,0,0,0
S01009460,All people aged 16 to 74,606,17,6,11,79,52,27,66,128,134,77,31,46,26
S01009460,Very good health,248,5,1,4,47,24,11,26,50,38,29,11,18,18
S01009460,Good health,210,6,1,5,20,18,9,25,43,54,29,13,16,6
S01009460,Fair health,109,4,3,1,8,8,3,11,31,28,14,4,10,2
S01009460,Bad health,36,2,1,1,4,1,3,4,3,14,5,3,2,0
S01009460,Very bad health,3,0,0,0,0,1,1,0,1,0,0,0,0,0
S01009461,All people aged 16 to 74,405,84,18,66,145,56,23,15,29,29,8,5,3,16
S01009461,Very good health,242,55,11,44,98,27,12,9,15,10,4,2,2,12
S01009461,Good health,115,24,6,18,33,21,7,5,12,10,0,0,0,3
S01009461,Fair health,31,3,1,2,8,4,3,1,2,5,4,3,1,1
S01009461,Bad health,15,1,0,1,6,3,1,0,0,4,0,0,0,0
S01009461,Very bad health,2,1,0,1,0,1,0,0,0,0,0,0,0,0
S01009462,All people aged 16 to 74,502,47,12,35,92,67,29,49,84,92,16,6,10,26
S01009462,Very good health,219,24,6,18,40,32,12,22,30,33,7,5,2,19
S01009462,Good health,188,18,6,12,35,21,10,19,39,31,8,0,8,7
S01009462,Fair health,73,4,0,4,13,10,7,5,14,19,1,1,0,0
S01009462,Bad health,16,0,0,0,4,2,0,2,1,7,0,0,0,0
S01009462,Very bad health,6,1,0,1,0,2,0,1,0,2,0,0,0,0
S01009463,All people aged 16 to 74,483,42,11,31,100,75,38,48,76,63,17,9,8,24
S01009463,Very good health,219,28,8,20,51,34,21,17,28,18,8,4,4,14
S01009463,Good health,188,9,3,6,34,31,10,21,38,33,4,3,1,8
S01009463,Fair health,55,4,0,4,12,7,5,8,7,8,3,1,2,1
S01009463,Bad health,15,1,0,1,1,2,2,1,2,3,2,1,1,1
S01009463,Very bad health,6,0,0,0,2,1,0,1,1,1,0,0,0,0
S01009464,All people aged 16 to 74,625,53,9,44,153,112,56,59,80,61,20,12,8,31
S01009464,Very good health,318,28,3,25,81,65,23,27,35,25,9,3,6,25
S01009464,Good health,226,21,6,15,54,40,22,22,32,25,4,3,1,6
S01009464,Fair health,57,4,0,4,11,5,9,8,9,6,5,4,1,0
S01009464,Bad health,22,0,0,0,6,2,2,2,4,4,2,2,0,0
S01009464,Very bad health,2,0,0,0,1,0,0,0,0,1,0,0,0,0
S01009465,All people aged 16 to 74,440,17,4,13,95,56,31,47,83,66,14,7,7,31
S01009465,Very good health,216,5,1,4,48,37,13,22,33,32,4,3,1,22
S01009465,Good health,152,11,2,9,35,14,11,17,34,18,4,1,3,8
S01009465,Fair health,60,0,0,0,11,5,7,6,14,11,5,3,2,1
S01009465,Bad health,12,1,1,0,1,0,0,2,2,5,1,0,1,0
S01009465,Very bad health,0,0,0,0,0,0,0,0,0,0,0,0,0,0
S01009466,All people aged 16 to 74,428,73,15,58,122,67,39,31,45,22,8,4,4,21
S01009466,Very good health,228,41,6,35,56,46,21,14,17,11,2,0,2,20
S01009466,Good health,143,24,7,17,52,16,12,11,17,7,3,1,2,1
S01009466,Fair health,47,7,2,5,10,5,6,4,9,3,3,3,0,0
S01009466,Bad health,6,0,0,0,4,0,0,1,1,0,0,0,0,0
S01009466,Very bad health,4,1,0,1,0,0,0,1,1,1,0,0,0,0
S01009467,All people aged 16 to 74,570,85,20,65,187,73,43,26,64,36,18,7,11,38
S01009467,Very good health,283,44,8,36,93,37,22,14,23,17,5,3,2,28
S01009467,Good health,219,34,10,24,79,25,16,9,29,11,6,1,5,10
S01009467,Fair health,55,7,2,5,13,9,5,3,8,4,6,2,4,0
S01009467,Bad health,9,0,0,0,1,2,0,0,3,2,1,1,0,0
S01009467,Very bad health,4,0,0,0,1,0,0,0,1,2,0,0,0,0
S01009468,All people aged 16 to 74,565,28,7,21,105,77,30,59,118,92,29,14,15,27
S01009468,Very good health,239,15,3,12,58,33,10,26,37,32,8,6,2,20
S01009468,Good health,175,6,1,5,27,27,12,17,41,24,15,4,11,6
S01009468,Fair health,105,4,2,2,11,11,6,12,30,26,4,2,2,1
S01009468,Bad health,36,3,1,2,7,5,2,3,7,8,1,1,0,0
S01009468,Very bad health,10,0,0,0,2,1,0,1,3,2,1,1,0,0
S01009469,All people aged 16 to 74,619,64,13,51,165,86,41,39,86,66,27,10,17,45
S01009469,Very good health,306,30,4,26,93,46,14,16,34,24,9,2,7,40
S01009469,Good health,227,26,6,20,58,28,19,16,37,28,10,4,6,5
S01009469,Fair health,66,6,3,3,12,10,7,4,13,8,6,2,4,0
S01009469,Bad health,16,2,0,2,2,2,1,2,1,4,2,2,0,0
S01009469,Very bad health,4,0,0,0,0,0,0,1,1,2,0,0,0,0
S01009470,All people aged 16 to 74,348,22,5,17,85,52,25,33,62,35,14,6,8,20
S01009470,Very good health,142,11,1,10,38,22,7,10,21,12,5,1,4,16
S01009470,Good health,151,11,4,7,35,20,13,15,27,18,8,4,4,4
S01009470,Fair health,42,0,0,0,9,7,3,7,12,4,0,0,0,0
S01009470,Bad health,11,0,0,0,3,3,1,1,2,1,0,0,0,0
S01009470,Very bad health,2,0,0,0,0,0,1,0,0,0,1,1,0,0
S01009471,All people aged 16 to 74,469,22,9,13,78,32,30,45,89,104,43,21,22,26
S01009471,Very good health,184,11,6,5,41,9,14,19,33,30,12,6,6,15
S01009471,Good health,121,8,2,6,15,6,9,7,31,23,14,6,8,8
S01009471,Fair health,106,2,0,2,12,13,3,9,20,30,15,7,8,2
S01009471,Bad health,45,1,1,0,8,4,3,10,3,14,2,2,0,0
S01009471,Very bad health,13,0,0,0,2,0,1,0,2,7,0,0,0,1
S01009472,All people aged 16 to 74,673,58,12,46,148,50,47,43,124,82,79,42,37,42
S01009472,Very good health,277,33,4,29,70,23,17,12,41,25,25,12,13,31
S01009472,Good health,235,17,5,12,63,17,17,18,44,27,23,11,12,9
S01009472,Fair health,119,4,1,3,14,8,9,9,29,20,25,14,11,1
S01009472,Bad health,30,2,0,2,0,1,3,4,7,8,4,3,1,1
S01009472,Very bad health,12,2,2,0,1,1,1,0,3,2,2,2,0,0
S01009473,All people aged 16 to 74,684,23,3,20,78,57,40,78,139,133,82,39,43,54
S01009473,Very good health,284,12,0,12,39,28,13,27,72,51,19,6,13,23
S01009473,Good health,252,8,2,6,28,18,18,31,41,48,35,20,15,25
S01009473,Fair health,113,3,1,2,7,8,8,13,19,28,21,10,11,6
S01009473,Bad health,27,0,0,0,2,2,1,3,6,6,7,3,4,0
S01009473,Very bad health,8,0,0,0,2,1,0,4,1,0,0,0,0,0
S01009474,All people aged 16 to 74,649,32,6,26,112,67,48,58,126,83,74,30,44,49
S01009474,Very good health,298,19,2,17,64,29,17,24,65,27,23,7,16,30
S01009474,Good health,245,10,3,7,38,29,24,24,41,35,32,11,21,12
S01009474,Fair health,79,3,1,2,7,5,5,5,18,14,15,9,6,7
S01009474,Bad health,17,0,0,0,1,1,2,3,2,4,4,3,1,0
S01009474,Very bad health,10,0,0,0,2,3,0,2,0,3,0,0,0,0
S01009475,All people aged 16 to 74,431,68,22,46,120,68,43,29,44,24,9,6,3,26
S01009475,Very good health,243,46,16,30,70,34,22,10,23,9,5,3,2,24
S01009475,Good health,152,20,6,14,44,28,11,17,17,10,4,3,1,1
S01009475,Fair health,27,2,0,2,4,3,7,2,4,4,0,0,0,1
S01009475,Bad health,9,0,0,0,2,3,3,0,0,1,0,0,0,0
S01009475,Very bad health,0,0,0,0,0,0,0,0,0,0,0,0,0,0
S01009476,All people aged 16 to 74,345,56,12,44,117,33,30,17,34,22,10,8,2,26
S01009476,Very good health,220,43,9,34,74,18,15,10,15,17,5,5,0,23
S01009476,Good health,100,12,3,9,37,13,11,6,12,4,2,1,1,3
S01009476,Fair health,18,0,0,0,5,2,4,1,3,1,2,1,1,0
S01009476,Bad health,7,1,0,1,1,0,0,0,4,0,1,1,0,0
S01009476,Very bad health,0,0,0,0,0,0,0,0,0,0,0,0,0,0
S01009477,All people aged 16 to 74,513,60,8,52,160,64,43,35,58,45,12,5,7,36
S01009477,Very good health,263,34,5,29,89,30,23,12,19,20,7,1,6,29
S01009477,Good health,180,25,3,22,50,23,17,17,27,12,3,3,0,6
S01009477,Fair health,49,0,0,0,19,7,1,4,8,7,2,1,1,1
S01009477,Bad health,17,1,0,1,2,3,0,2,4,5,0,0,0,0
S01009477,Very bad health,4,0,0,0,0,1,2,0,0,1,0,0,0,0
S01009478,All people aged 16 to 74,691,35,8,27,169,89,46,50,114,79,48,32,16,61
S01009478,Very good health,328,21,2,19,81,43,24,25,55,28,15,10,5,36
S01009478,Good health,259,14,6,8,66,31,16,14,40,33,21,12,9,24
S01009478,Fair health,74,0,0,0,17,12,5,9,12,12,6,4,2,1
S01009478,Bad health,21,0,0,0,4,1,1,1,6,4,4,4,0,0
S01009478,Very bad health,9,0,0,0,1,2,0,1,1,2,2,2,0,0
S01009479,All people aged 16 to 74,614,68,12,56,144,56,42,49,88,69,50,30,20,48
S01009479,Very good health,277,38,9,29,67,29,20,19,36,17,15,5,10,36
S01009479,Good health,238,25,2,23,60,18,18,23,35,34,17,12,5,8
S01009479,Fair health,77,5,1,4,12,9,2,4,13,11,17,13,4,4
S01009479,Bad health,14,0,0,0,5,0,2,1,1,5,0,0,0,0
S01009479,Very bad health,8,0,0,0,0,0,0,2,3,2,1,0,1,0
S01009480,All people aged 16 to 74,591,81,14,67,177,75,55,34,68,47,16,11,5,38
S01009480,Very good health,302,47,9,38,92,46,26,12,29,15,5,2,3,30
S01009480,Good health,203,28,4,24,58,21,26,18,23,20,3,3,0,6
S01009480,Fair health,61,4,1,3,22,4,3,4,8,8,6,4,2,2
S01009480,Bad health,18,1,0,1,4,2,0,0,6,4,1,1,0,0
S01009480,Very bad health,7,1,0,1,1,2,0,0,2,0,1,1,0,0
S01009481,All people aged 16 to 74,693,47,8,39,154,106,39,57,128,99,20,14,6,43
S01009481,Very good health,344,27,4,23,82,53,18,27,52,47,8,7,1,30
S01009481,Good health,253,13,2,11,55,36,16,21,54,38,10,5,5,10
S01009481,Fair health,75,6,2,4,13,14,4,5,19,9,2,2,0,3
S01009481,Bad health,17,1,0,1,4,3,1,2,2,4,0,0,0,0
S01009481,Very bad health,4,0,0,0,0,0,0,2,1,1,0,0,0,0
S01009482,All people aged 16 to 74,477,38,7,31,98,53,30,55,87,58,15,7,8,43
S01009482,Very good health,219,25,3,22,42,22,10,24,38,27,5,2,3,26
S01009482,Good health,197,11,4,7,48,25,12,24,41,14,7,4,3,15
S01009482,Fair health,48,2,0,2,6,6,7,5,8,12,2,0,2,0
S01009482,Bad health,12,0,0,0,2,0,1,1,0,5,1,1,0,2
S01009482,Very bad health,1,0,0,0,0,0,0,1,0,0,0,0,0,0
S01009483,All people aged 16 to 74,576,49,4,45,156,79,48,45,81,52,28,11,17,38
S01009483,Very good health,299,32,3,29,82,38,18,25,49,19,9,5,4,27
S01009483,Good health,206,15,1,14,64,29,19,16,22,21,11,4,7,9
S01009483,Fair health,56,2,0,2,8,10,9,4,5,10,6,2,4,2
S01009483,Bad health,13,0,0,0,1,2,1,0,5,2,2,0,2,0
S01009483,Very bad health,2,0,0,0,1,0,1,0,0,0,0,0,0,0
S01009484,All people aged 16 to 74,579,49,11,38,116,90,29,40,103,60,33,15,18,59
S01009484,Very good health,257,27,3,24,59,39,9,15,35,21,8,2,6,44
S01009484,Good health,191,16,6,10,44,35,11,14,34,17,9,3,6,11
S01009484,Fair health,85,5,1,4,10,9,7,7,22,12,9,7,2,4
S01009484,Bad health,31,1,1,0,3,5,2,2,9,7,2,1,1,0
S01009484,Very bad health,15,0,0,0,0,2,0,2,3,3,5,2,3,0
S01009485,All people aged 16 to 74,565,26,5,21,90,69,46,49,109,90,44,26,18,42
S01009485,Very good health,236,12,3,9,32,31,15,22,42,35,19,12,7,28
S01009485,Good health,205,10,1,9,42,24,20,15,39,36,8,4,4,11
S01009485,Fair health,86,4,1,3,12,10,9,8,13,12,15,8,7,3
S01009485,Bad health,29,0,0,0,2,4,2,4,11,4,2,2,0,0
S01009485,Very bad health,9,0,0,0,2,0,0,0,4,3,0,0,0,0
S01009486,All people aged 16 to 74,445,47,12,35,116,60,31,30,65,57,15,8,7,24
S01009486,Very good health,199,23,6,17,54,22,13,14,30,21,4,1,3,18
S01009486,Good health,177,20,5,15,47,31,15,9,19,21,9,5,4,6
S01009486,Fair health,55,3,0,3,10,6,3,6,13,12,2,2,0,0
S01009486,Bad health,12,1,1,0,5,0,0,1,3,2,0,0,0,0
S01009486,Very bad health,2,0,0,0,0,1,0,0,0,1,0,0,0,0
S01009487,All people aged 16 to 74,561,22,5,17,84,80,19,62,114,105,35,24,11,40
S01009487,Very good health,195,8,2,6,37,30,3,22,32,33,8,3,5,22
S01009487,Good health,239,11,2,9,30,34,10,25,56,46,11,6,5,16
S01009487,Fair health,102,3,1,2,15,14,5,11,21,17,14,13,1,2
S01009487,Bad health,22,0,0,0,1,2,1,4,4,8,2,2,0,0
S01009487,Very bad health,3,0,0,0,1,0,0,0,1,1,0,0,0,0
S01009488,All people aged 16 to 74,486,23,7,16,83,68,30,49,95,73,23,8,15,42
S01009488,Very good health,247,15,2,13,40,38,15,22,47,28,13,6,7,29
S01009488,Good health,168,5,3,2,30,23,12,13,39,29,7,2,5,10
S01009488,Fair health,54,3,2,1,9,6,2,10,7,11,3,0,3,3
S01009488,Bad health,14,0,0,0,4,1,1,3,1,4,0,0,0,0
S01009488,Very bad health,3,0,0,0,0,0,0,1,1,1,0,0,0,0
S01009489,All people aged 16 to 74,586,28,7,21,72,65,32,61,121,114,62,42,20,31
S01009489,Very good health,210,15,3,12,27,18,17,15,40,41,17,8,9,20
S01009489,Good health,213,10,3,7,31,26,9,28,44,36,21,16,5,8
S01009489,Fair health,103,3,1,2,8,14,5,15,24,20,11,7,4,3
S01009489,Bad health,45,0,0,0,5,5,0,3,11,12,9,7,2,0
S01009489,Very bad health,15,0,0,0,1,2,1,0,2,5,4,4,0,0
S01009490,All people aged 16 to 74,623,11,1,10,54,72,20,65,131,148,78,42,36,44
S01009490,Very good health,226,4,0,4,23,35,7,19,42,43,27,14,13,26
S01009490,Good health,228,3,0,3,18,25,7,27,48,56,30,14,16,14
S01009490,Fair health,109,4,1,3,6,7,4,14,28,29,14,8,6,3
S01009490,Bad health,41,0,0,0,5,4,1,3,8,13,6,5,1,1
S01009490,Very bad health,19,0,0,0,2,1,1,2,5,7,1,1,0,0
S01009491,All people aged 16 to 74,491,19,1,18,66,76,32,39,97,104,37,24,13,21
S01009491,Very good health,169,8,0,8,21,31,15,11,36,21,11,7,4,15
S01009491,Good health,172,5,0,5,31,31,12,15,30,31,12,7,5,5
S01009491,Fair health,91,3,1,2,9,10,4,8,19,30,7,4,3,1
S01009491,Bad health,50,3,0,3,5,4,1,5,9,17,6,5,1,0
S01009491,Very bad health,9,0,0,0,0,0,0,0,3,5,1,1,0,0
S01009492,All people aged 16 to 74,572,8,4,4,76,74,30,59,118,145,22,12,10,40
S01009492,Very good health,238,3,1,2,37,39,10,17,49,47,7,5,2,29
S01009492,Good health,214,4,2,2,29,27,14,25,44,52,9,3,6,10
S01009492,Fair health,80,1,1,0,8,5,3,12,19,28,3,2,1,1
S01009492,Bad health,37,0,0,0,2,3,3,5,5,16,3,2,1,0
S01009492,Very bad health,3,0,0,0,0,0,0,0,1,2,0,0,0,0
S01009493,All people aged 16 to 74,597,120,14,106,198,82,49,26,43,32,8,4,4,39
S01009493,Very good health,332,74,9,65,102,46,27,13,22,14,4,2,2,30
S01009493,Good health,215,41,5,36,78,32,17,9,18,11,3,1,2,6
S01009493,Fair health,41,4,0,4,17,4,3,3,1,5,1,1,0,3
S01009493,Bad health,7,1,0,1,1,0,2,0,1,2,0,0,0,0
S01009493,Very bad health,2,0,0,0,0,0,0,1,1,0,0,0,0,0
S01009494,All people aged 16 to 74,714,77,15,62,209,117,61,62,80,49,17,9,8,42
S01009494,Very good health,381,44,10,34,109,60,27,36,44,21,9,5,4,31
S01009494,Good health,236,23,4,19,76,42,24,18,21,16,6,2,4,10
S01009494,Fair health,78,9,0,9,21,11,8,6,14,9,0,0,0,0
S01009494,Bad health,13,0,0,0,2,3,1,1,1,3,1,1,0,1
S01009494,Very bad health,6,1,1,0,1,1,1,1,0,0,1,1,0,0
S01009495,All people aged 16 to 74,696,65,16,49,192,129,56,61,77,54,10,6,4,52
S01009495,Very good health,377,41,11,30,108,74,25,33,32,22,2,2,0,40
S01009495,Good health,239,22,5,17,68,38,21,22,31,22,4,2,2,11
S01009495,Fair health,72,1,0,1,14,16,10,6,12,9,3,1,2,1
S01009495,Bad health,5,1,0,1,1,1,0,0,2,0,0,0,0,0
S01009495,Very bad health,3,0,0,0,1,0,0,0,0,1,1,1,0,0
S01009496,All people aged 16 to 74,585,17,3,14,81,83,36,67,133,114,20,17,3,34
S01009496,Very good health,263,6,0,6,37,44,14,18,60,49,7,5,2,28
S01009496,Good health,202,9,3,6,26,23,16,36,43,37,7,6,1,5
S01009496,Fair health,82,1,0,1,14,13,5,7,22,15,4,4,0,1
S01009496,Bad health,32,1,0,1,2,2,1,4,7,13,2,2,0,0
S01009496,Very bad health,6,0,0,0,2,1,0,2,1,0,0,0,0,0
S01009497,All people aged 16 to 74,736,32,7,25,138,102,38,87,149,118,35,21,14,37
S01009497,Very good health,340,19,3,16,72,59,14,36,57,45,11,5,6,27
S01009497,Good health,269,12,3,9,51,28,16,37,62,44,13,9,4,6
S01009497,Fair health,92,1,1,0,15,10,5,12,23,17,7,4,3,2
S01009497,Bad health,24,0,0,0,0,2,3,0,7,7,4,3,1,1
S01009497,Very bad health,11,0,0,0,0,3,0,2,0,5,0,0,0,1
S01009498,All people aged 16 to 74,507,50,10,40,153,92,31,42,56,46,10,5,5,27
S01009498,Very good health,239,20,5,15,69,51,12,20,22,19,4,2,2,22
S01009498,Good health,201,27,4,23,63,32,11,18,23,18,4,2,2,5
S01009498,Fair health,52,3,1,2,19,8,7,3,8,3,1,0,1,0
S01009498,Bad health,13,0,0,0,1,1,1,1,2,6,1,1,0,0
S01009498,Very bad health,2,0,0,0,1,0,0,0,1,0,0,0,0,0
S01009499,All people aged 16 to 74,597,48,12,36,123,78,45,49,104,85,26,13,13,39
S01009499,Very good health,279,29,8,21,60,35,17,16,53,28,8,3,5,33
S01009499,Good health,211,15,2,13,47,30,18,20,30,32,13,7,6,6
S01009499,Fair health,75,4,2,2,14,11,7,7,14,13,5,3,2,0
S01009499,Bad health,25,0,0,0,2,2,1,4,5,11,0,0,0,0
S01009499,Very bad health,7,0,0,0,0,0,2,2,2,1,0,0,0,0
S01009500,All people aged 16 to 74,552,10,1,9,74,65,30,47,123,110,56,36,20,37
S01009500,Very good health,217,6,1,5,31,22,9,17,44,37,24,14,10,27
S01009500,Good health,205,1,0,1,29,28,13,18,52,41,14,8,6,9
S01009500,Fair health,94,3,0,3,8,11,6,9,20,23,13,10,3,1
S01009500,Bad health,29,0,0,0,5,3,1,3,7,6,4,3,1,0
S01009500,Very bad health,7,0,0,0,1,1,1,0,0,3,1,1,0,0
S01009501,All people aged 16 to 74,474,11,4,7,57,43,25,51,105,106,41,21,20,35
S01009501,Very good health,187,6,3,3,22,13,6,19,42,36,14,8,6,29
S01009501,Good health,173,4,1,3,26,22,11,17,40,34,15,4,11,4
S01009501,Fair health,85,0,0,0,9,8,3,12,20,26,7,4,3,0
S01009501,Bad health,23,0,0,0,0,0,3,3,3,8,5,5,0,1
S01009501,Very bad health,6,1,0,1,0,0,2,0,0,2,0,0,0,1
S01009502,All people aged 16 to 74,615,11,3,8,76,62,35,66,149,139,41,21,20,36
S01009502,Very good health,226,5,0,5,34,24,12,25,47,38,17,8,9,24
S01009502,Good health,249,4,1,3,29,27,14,25,63,60,17,9,8,10
S01009502,Fair health,95,2,2,0,7,6,7,10,31,27,4,1,3,1
S01009502,Bad health,34,0,0,0,3,5,1,6,7,9,2,2,0,1
S01009502,Very bad health,11,0,0,0,3,0,1,0,1,5,1,1,0,0
S01009503,All people aged 16 to 74,537,15,3,12,102,62,43,47,113,102,22,10,12,31
S01009503,Very good health,228,4,1,3,46,30,17,19,40,42,7,2,5,23
S01009503,Good health,202,8,2,6,41,21,18,17,49,34,8,4,4,6
S01009503,Fair health,80,1,0,1,13,8,5,7,20,17,7,4,3,2
S01009503,Bad health,22,2,0,2,2,2,2,2,3,9,0,0,0,0
S01009503,Very bad health,5,0,0,0,0,1,1,2,1,0,0,0,0,0
S01009504,All people aged 16 to 74,498,8,1,7,48,50,30,54,111,116,44,24,20,37
S01009504,Very good health,188,5,1,4,18,21,15,21,31,37,10,7,3,30
S01009504,Good health,177,2,0,2,22,16,9,20,47,37,21,8,13,3
S01009504,Fair health,99,1,0,1,6,11,4,6,26,33,8,5,3,4
S01009504,Bad health,31,0,0,0,2,1,2,6,6,9,5,4,1,0
S01009504,Very bad health,3,0,0,0,0,1,0,1,1,0,0,0,0,0
S01009505,All people aged 16 to 74,555,9,1,8,53,54,13,51,134,117,89,52,37,35
S01009505,Very good health,222,6,1,5,24,22,4,20,47,43,31,14,17,25
S01009505,Good health,195,2,0,2,17,19,6,20,50,42,30,16,14,9
S01009505,Fair health,99,0,0,0,9,12,1,9,26,25,16,10,6,1
S01009505,Bad health,32,0,0,0,3,1,2,2,11,6,7,7,0,0
S01009505,Very bad health,7,1,0,1,0,0,0,0,0,1,5,5,0,0
S01009506,All people aged 16 to 74,527,10,4,6,71,49,27,53,138,106,44,24,20,29
S01009506,Very good health,182,4,1,3,28,15,15,18,41,28,13,5,8,20
S01009506,Good health,192,3,1,2,26,24,6,13,57,39,19,9,10,5
S01009506,Fair health,93,1,0,1,11,6,2,14,23,24,9,7,2,3
S01009506,Bad health,49,1,1,0,5,4,3,7,14,12,2,2,0,1
S01009506,Very bad health,11,1,1,0,1,0,1,1,3,3,1,1,0,0
S01009507,All people aged 16 to 74,614,30,14,16,111,105,38,64,96,96,36,22,14,38
S01009507,Very good health,304,17,7,10,62,57,21,33,41,33,16,7,9,24
S01009507,Good health,213,7,4,3,35,42,8,21,38,38,12,8,4,12
S01009507,Fair health,73,6,3,3,9,3,7,8,15,18,5,4,1,2
S01009507,Bad health,18,0,0,0,3,3,2,1,2,5,2,2,0,0
S01009507,Very bad health,6,0,0,0,2,0,0,1,0,2,1,1,0,0
S01009508,All people aged 16 to 74,632,8,2,6,61,62,30,70,151,131,74,43,31,45
S01009508,Very good health,231,5,0,5,25,23,13,25,44,46,24,16,8,26
S01009508,Good health,251,1,1,0,26,30,9,28,74,46,24,12,12,13
S01009508,Fair health,106,2,1,1,5,5,5,11,22,29,21,12,9,6
S01009508,Bad health,33,0,0,0,3,4,3,4,8,7,4,2,2,0
S01009508,Very bad health,11,0,0,0,2,0,0,2,3,3,1,1,0,0
S01009509,All people aged 16 to 74,715,22,5,17,81,74,44,59,157,149,68,37,31,61
S01009509,Very good health,306,9,1,8,39,31,15,23,67,54,25,14,11,43
S01009509,Good health,265,10,3,7,24,29,19,21,62,62,24,15,9,14
S01009509,Fair health,104,3,1,2,13,8,6,10,18,27,16,8,8,3
S01009509,Bad health,30,0,0,0,4,5,0,5,7,5,3,0,3,1
S01009509,Very bad health,10,0,0,0,1,1,4,0,3,1,0,0,0,0
S01009510,All people aged 16 to 74,538,40,9,31,139,94,35,54,83,42,17,10,7,34
S01009510,Very good health,263,17,5,12,75,51,14,23,36,16,7,4,3,24
S01009510,Good health,217,18,4,14,52,36,12,26,36,20,8,4,4,9
S01009510,Fair health,50,4,0,4,11,6,8,2,10,6,2,2,0,1
S01009510,Bad health,7,1,0,1,0,1,1,3,1,0,0,0,0,0
S01009510,Very bad health,1,0,0,0,1,0,0,0,0,0,0,0,0,0
S01009511,All people aged 16 to 74,440,38,12,26,112,85,32,34,63,36,9,6,3,31
S01009511,Very good health,258,20,4,16,67,44,17,18,38,20,8,5,3,26
S01009511,Good health,136,15,7,8,37,29,13,13,19,7,0,0,0,3
S01009511,Fair health,37,2,0,2,7,11,1,1,5,7,1,1,0,2
S01009511,Bad health,7,0,0,0,1,0,1,2,1,2,0,0,0,0
S01009511,Very bad health,2,1,1,0,0,1,0,0,0,0,0,0,0,0
S01009512,All people aged 16 to 74,583,45,8,37,145,120,40,46,91,57,10,4,6,29
S01009512,Very good health,319,26,6,20,88,62,20,26,41,28,4,2,2,24
S01009512,Good health,197,16,1,15,42,48,14,16,36,18,3,1,2,4
S01009512,Fair health,54,3,1,2,12,6,6,4,12,7,3,1,2,1
S01009512,Bad health,11,0,0,0,2,3,0,0,2,4,0,0,0,0
S01009512,Very bad health,2,0,0,0,1,1,0,0,0,0,0,0,0,0
S01009513,All people aged 16 to 74,443,44,12,32,140,70,20,30,72,31,8,4,4,28
S01009513,Very good health,221,18,5,13,81,34,11,15,29,12,3,1,2,18
S01009513,Good health,156,20,5,15,41,27,5,8,30,11,4,2,2,10
S01009513,Fair health,43,5,2,3,15,3,2,5,10,3,0,0,0,0
S01009513,Bad health,20,1,0,1,3,5,2,2,2,4,1,1,0,0
S01009513,Very bad health,3,0,0,0,0,1,0,0,1,1,0,0,0,0
S01009514,All people aged 16 to 74,553,44,7,37,158,102,35,47,86,43,8,6,2,30
S01009514,Very good health,309,29,5,24,94,49,18,23,42,25,4,2,2,25
S01009514,Good health,177,13,1,12,47,43,10,17,31,11,1,1,0,4
S01009514,Fair health,55,2,1,1,15,9,6,7,9,5,2,2,0,0
S01009514,Bad health,9,0,0,0,0,1,1,0,4,2,1,1,0,0
S01009514,Very bad health,3,0,0,0,2,0,0,0,0,0,0,0,0,1
S01009515,All people aged 16 to 74,515,17,2,15,57,71,29,61,109,103,35,23,12,33
S01009515,Very good health,215,6,1,5,29,37,13,21,34,36,13,10,3,26
S01009515,Good health,176,8,1,7,20,22,10,20,42,38,14,7,7,2
S01009515,Fair health,86,3,0,3,4,5,3,12,25,23,6,5,1,5
S01009515,Bad health,27,0,0,0,2,5,3,6,6,4,1,1,0,0
S01009515,Very bad health,11,0,0,0,2,2,0,2,2,2,1,0,1,0
S01009516,All people aged 16 to 74,623,21,6,15,99,89,42,65,132,113,30,22,8,32
S01009516,Very good health,236,10,4,6,46,33,19,18,43,32,10,7,3,25
S01009516,Good health,226,8,1,7,32,40,13,29,54,37,9,6,3,4
S01009516,Fair health,117,3,1,2,13,12,8,14,24,35,6,4,2,2
S01009516,Bad health,35,0,0,0,4,3,2,3,8,9,5,5,0,1
S01009516,Very bad health,9,0,0,0,4,1,0,1,3,0,0,0,0,0
S01009517,All people aged 16 to 74,697,82,16,66,230,118,46,49,80,33,12,4,8,47
S01009517,Very good health,420,55,9,46,140,73,21,34,39,18,1,1,0,39
S01009517,Good health,222,23,7,16,75,39,18,14,33,7,7,2,5,6
S01009517,Fair health,38,3,0,3,8,5,4,1,7,4,4,1,3,2
S01009517,Bad health,13,1,0,1,6,1,1,0,1,3,0,0,0,0
S01009517,Very bad health,4,0,0,0,1,0,2,0,0,1,0,0,0,0
S01009518,All people aged 16 to 74,658,77,16,61,206,119,51,44,78,33,11,6,5,39
S01009518,Very good health,451,52,9,43,140,93,33,33,49,16,4,2,2,31
S01009518,Good health,159,23,6,17,55,16,13,10,21,11,5,3,2,5
S01009518,Fair health,36,2,1,1,7,7,5,0,8,4,2,1,1,1
S01009518,Bad health,9,0,0,0,2,3,0,1,0,2,0,0,0,1
S01009518,Very bad health,3,0,0,0,2,0,0,0,0,0,0,0,0,1
S01009519,All people aged 16 to 74,390,26,7,19,70,53,30,43,70,56,17,13,4,25
S01009519,Very good health,193,18,5,13,37,21,10,18,39,26,5,4,1,19
S01009519,Good health,132,6,0,6,23,18,18,16,19,17,10,7,3,5
S01009519,Fair health,48,1,1,0,10,12,2,5,7,9,1,1,0,1
S01009519,Bad health,15,1,1,0,0,2,0,4,5,3,0,0,0,0
S01009519,Very bad health,2,0,0,0,0,0,0,0,0,1,1,1,0,0
S01009520,All people aged 16 to 74,639,59,21,38,142,89,43,52,96,86,22,15,7,50
S01009520,Very good health,306,39,13,26,71,35,13,16,54,33,7,6,1,38
S01009520,Good health,214,15,6,9,49,36,18,26,24,30,6,1,5,10
S01009520,Fair health,90,4,2,2,16,12,9,6,15,20,6,5,1,2
S01009520,Bad health,22,1,0,1,4,6,2,2,3,2,2,2,0,0
S01009520,Very bad health,7,0,0,0,2,0,1,2,0,1,1,1,0,0
S01009521,All people aged 16 to 74,617,11,3,8,68,57,40,53,135,156,64,41,23,33
S01009521,Very good health,243,4,0,4,24,24,13,16,56,51,35,24,11,20
S01009521,Good health,205,5,2,3,26,18,16,21,46,51,12,8,4,10
S01009521,Fair health,110,1,0,1,15,11,5,10,20,35,10,6,4,3
S01009521,Bad health,47,1,1,0,2,3,3,5,11,15,7,3,4,0
S01009521,Very bad health,12,0,0,0,1,1,3,1,2,4,0,0,0,0
S01009522,All people aged 16 to 74,713,24,4,20,87,78,55,68,137,146,63,37,26,55
S01009522,Very good health,300,16,3,13,43,38,12,22,60,51,23,8,15,35
S01009522,Good health,255,7,1,6,29,26,27,30,52,44,23,16,7,17
S01009522,Fair health,108,1,0,1,11,10,14,7,18,33,12,8,4,2
S01009522,Bad health,40,0,0,0,2,4,2,7,6,13,5,5,0,1
S01009522,Very bad health,10,0,0,0,2,0,0,2,1,5,0,0,0,0
S01009523,All people aged 16 to 74,434,12,0,12,52,53,12,31,91,101,36,22,14,46
S01009523,Very good health,163,4,0,4,24,23,1,11,24,33,10,8,2,33
S01009523,Good health,145,4,0,4,22,11,3,10,45,26,16,6,10,8
S01009523,Fair health,75,2,0,2,6,13,3,4,11,28,4,3,1,4
S01009523,Bad health,41,1,0,1,0,5,5,5,9,10,5,4,1,1
S01009523,Very bad health,10,1,0,1,0,1,0,1,2,4,1,1,0,0
S01009524,All people aged 16 to 74,492,24,4,20,91,55,23,39,112,69,43,24,19,36
S01009524,Very good health,202,11,3,8,48,22,14,11,38,20,11,6,5,27
S01009524,Good health,172,7,0,7,31,19,5,18,47,19,18,9,9,8
S01009524,Fair health,73,4,0,4,6,11,3,5,17,20,7,3,4,0
S01009524,Bad health,36,2,1,1,4,2,1,5,8,8,5,4,1,1
S01009524,Very bad health,9,0,0,0,2,1,0,0,2,2,2,2,0,0
S01009525,All people aged 16 to 74,398,16,3,13,69,40,18,37,63,85,38,28,10,32
S01009525,Very good health,157,5,1,4,32,17,2,15,25,33,9,7,2,19
S01009525,Good health,142,7,2,5,24,16,12,10,23,27,11,5,6,12
S01009525,Fair health,75,3,0,3,12,6,4,8,10,18,13,11,2,1
S01009525,Bad health,21,1,0,1,1,1,0,4,3,7,4,4,0,0
S01009525,Very bad health,3,0,0,0,0,0,0,0,2,0,1,1,0,0
S01009526,All people aged 16 to 74,541,54,5,49,145,75,39,56,83,42,19,8,11,28
S01009526,Very good health,294,33,3,30,95,43,21,27,31,19,9,1,8,16
S01009526,Good health,183,18,2,16,37,27,13,24,36,12,5,4,1,11
S01009526,Fair health,45,2,0,2,9,4,2,5,11,7,5,3,2,0
S01009526,Bad health,15,1,0,1,3,1,2,0,4,4,0,0,0,0
S01009526,Very bad health,4,0,0,0,1,0,1,0,1,0,0,0,0,1
S01009527,All people aged 16 to 74,506,38,7,31,92,69,27,44,102,71,33,18,15,30
S01009527,Very good health,236,19,3,16,56,35,10,19,48,25,11,4,7,13
S01009527,Good health,172,15,4,11,28,22,8,13,34,27,11,6,5,14
S01009527,Fair health,71,2,0,2,8,9,8,7,14,11,9,6,3,3
S01009527,Bad health,16,1,0,1,0,2,1,3,4,4,1,1,0,0
S01009527,Very bad health,11,1,0,1,0,1,0,2,2,4,1,1,0,0
S01009528,All people aged 16 to 74,349,32,7,25,70,43,20,38,69,53,8,5,3,16
S01009528,Very good health,136,17,3,14,37,14,6,12,21,18,1,1,0,10
S01009528,Good health,132,7,3,4,22,15,12,18,33,18,1,0,1,6
S01009528,Fair health,56,7,1,6,7,10,2,6,7,13,4,2,2,0
S01009528,Bad health,18,1,0,1,3,4,0,0,7,2,1,1,0,0
S01009528,Very bad health,7,0,0,0,1,0,0,2,1,2,1,1,0,0
S01009529,All people aged 16 to 74,412,47,11,36,100,51,37,37,64,35,13,2,11,28
S01009529,Very good health,203,29,6,23,56,22,14,16,27,16,6,0,6,17
S01009529,Good health,156,15,4,11,35,28,19,13,23,11,2,2,0,10
S01009529,Fair health,34,2,0,2,6,1,3,7,7,2,5,0,5,1
S01009529,Bad health,15,1,1,0,2,0,1,0,6,5,0,0,0,0
S01009529,Very bad health,4,0,0,0,1,0,0,1,1,1,0,0,0,0
S01009530,All people aged 16 to 74,429,53,15,38,132,76,30,32,50,20,7,6,1,29
S01009530,Very good health,228,38,10,28,69,32,14,15,22,13,1,1,0,24
S01009530,Good health,155,10,3,7,52,34,15,12,19,4,4,3,1,5
S01009530,Fair health,35,5,2,3,9,8,0,4,6,3,0,0,0,0
S01009530,Bad health,9,0,0,0,1,1,1,1,3,0,2,2,0,0
S01009530,Very bad health,2,0,0,0,1,1,0,0,0,0,0,0,0,0
S01009531,All people aged 16 to 74,607,9,0,9,53,74,35,70,128,153,47,25,22,38
S01009531,Very good health,235,3,0,3,28,45,11,31,41,34,16,5,11,26
S01009531,Good health,214,3,0,3,19,18,16,21,51,58,17,11,6,11
S01009531,Fair health,98,2,0,2,5,5,3,12,23,37,10,6,4,1
S01009531,Bad health,47,1,0,1,0,5,3,5,11,18,4,3,1,0
S01009531,Very bad health,13,0,0,0,1,1,2,1,2,6,0,0,0,0
S01009532,All people aged 16 to 74,591,12,4,8,73,67,23,67,135,144,49,29,20,21
S01009532,Very good health,172,6,1,5,29,25,7,17,37,27,12,5,7,12
S01009532,Good health,230,4,2,2,27,27,11,24,58,57,15,7,8,7
S01009532,Fair health,113,1,0,1,9,8,3,19,23,37,12,8,4,1
S01009532,Bad health,58,1,1,0,7,4,2,6,15,15,7,6,1,1
S01009532,Very bad health,18,0,0,0,1,3,0,1,2,8,3,3,0,0
S01009533,All people aged 16 to 74,588,15,5,10,79,74,29,56,134,135,39,21,18,27
S01009533,Very good health,211,12,4,8,38,29,7,17,48,38,6,2,4,16
S01009533,Good health,205,1,0,1,20,26,12,17,51,57,14,6,8,7
S01009533,Fair health,113,1,0,1,12,13,6,16,27,23,12,7,5,3
S01009533,Bad health,41,1,1,0,7,5,1,3,7,10,6,5,1,1
S01009533,Very bad health,18,0,0,0,2,1,3,3,1,7,1,1,0,0
S01009534,All people aged 16 to 74,587,11,3,8,63,47,39,63,125,104,87,51,36,48
S01009534,Very good health,209,4,0,4,31,15,15,26,39,24,28,18,10,27
S01009534,Good health,218,4,1,3,23,18,15,23,49,41,29,14,15,16
S01009534,Fair health,102,1,1,0,5,8,8,8,21,25,22,15,7,4
S01009534,Bad health,50,1,0,1,3,6,1,5,15,11,7,3,4,1
S01009534,Very bad health,8,1,1,0,1,0,0,1,1,3,1,1,0,0
S01009535,All people aged 16 to 74,457,6,0,6,58,39,25,46,94,102,61,34,27,26
S01009535,Very good health,176,3,0,3,24,13,10,16,34,38,29,19,10,9
S01009535,Good health,167,1,0,1,19,19,9,22,33,31,19,7,12,14
S01009535,Fair health,65,2,0,2,7,3,5,5,14,21,5,1,4,3
S01009535,Bad health,44,0,0,0,7,4,0,2,13,12,6,5,1,0
S01009535,Very bad health,5,0,0,0,1,0,1,1,0,0,2,2,0,0
S01009536,All people aged 16 to 74,378,13,6,7,62,43,23,44,64,77,27,12,15,25
S01009536,Very good health,161,6,3,3,26,20,10,16,26,31,10,4,6,16
S01009536,Good health,143,7,3,4,28,12,10,15,28,26,10,5,5,7
S01009536,Fair health,48,0,0,0,5,6,3,9,5,12,6,2,4,2
S01009536,Bad health,23,0,0,0,2,5,0,3,4,8,1,1,0,0
S01009536,Very bad health,3,0,0,0,1,0,0,1,1,0,0,0,0,0
S01009537,All people aged 16 to 74,399,24,1,23,75,48,25,44,72,66,18,10,8,27
S01009537,Very good health,179,12,0,12,35,20,11,24,28,24,8,3,5,17
S01009537,Good health,132,10,0,10,29,22,8,10,24,18,3,2,1,8
S01009537,Fair health,60,2,1,1,7,6,2,7,15,15,4,2,2,2
S01009537,Bad health,24,0,0,0,4,0,3,2,5,7,3,3,0,0
S01009537,Very bad health,4,0,0,0,0,0,1,1,0,2,0,0,0,0
S01009538,All people aged 16 to 74,579,39,4,35,106,61,41,52,108,89,59,31,28,24
S01009538,Very good health,201,15,2,13,45,20,15,18,31,24,16,3,13,17
S01009538,Good health,212,18,2,16,35,24,15,18,43,31,23,14,9,5
S01009538,Fair health,122,4,0,4,20,14,10,10,26,22,14,9,5,2
S01009538,Bad health,32,2,0,2,2,3,1,6,4,10,4,3,1,0
S01009538,Very bad health,12,0,0,0,4,0,0,0,4,2,2,2,0,0
S01009539,All people aged 16 to 74,650,23,8,15,108,97,42,73,132,112,15,7,8,48
S01009539,Very good health,278,7,1,6,58,47,21,31,44,32,3,0,3,35
S01009539,Good health,226,8,3,5,37,38,11,26,49,45,4,1,3,8
S01009539,Fair health,101,4,3,1,10,10,6,12,25,24,5,3,2,5
S01009539,Bad health,32,2,0,2,2,1,3,4,8,9,3,3,0,0
S01009539,Very bad health,13,2,1,1,1,1,1,0,6,2,0,0,0,0
S01009540,All people aged 16 to 74,636,18,8,10,90,65,33,67,148,118,66,34,32,31
S01009540,Very good health,247,9,6,3,48,27,12,22,47,46,15,7,8,21
S01009540,Good health,243,7,2,5,30,25,11,26,66,39,32,15,17,7
S01009540,Fair health,99,2,0,2,8,11,6,14,22,20,13,6,7,3
S01009540,Bad health,40,0,0,0,4,1,3,5,11,10,6,6,0,0
S01009540,Very bad health,7,0,0,0,0,1,1,0,2,3,0,0,0,0
S01009541,All people aged 16 to 74,581,33,14,19,121,78,45,63,91,89,27,21,6,34
S01009541,Very good health,278,13,6,7,63,43,24,34,40,32,5,3,2,24
S01009541,Good health,199,18,7,11,45,24,13,19,33,33,6,3,3,8
S01009541,Fair health,76,1,1,0,11,7,6,8,14,15,12,11,1,2
S01009541,Bad health,18,1,0,1,1,3,1,1,2,7,2,2,0,0
S01009541,Very bad health,10,0,0,0,1,1,1,1,2,2,2,2,0,0
S01009542,All people aged 16 to 74,539,12,0,12,58,53,41,39,120,114,71,24,47,31
S01009542,Very good health,208,4,0,4,31,20,13,18,36,41,21,9,12,24
S01009542,Good health,195,5,0,5,19,26,14,11,55,37,22,7,15,6
S01009542,Fair health,91,2,0,2,6,3,7,6,21,20,25,6,19,1
S01009542,Bad health,34,1,0,1,2,2,6,3,6,12,2,1,1,0
S01009542,Very bad health,11,0,0,0,0,2,1,1,2,4,1,1,0,0
S01009543,All people aged 16 to 74,402,25,9,16,73,46,36,47,73,66,17,10,7,19
S01009543,Very good health,146,8,3,5,32,22,8,15,31,14,6,2,4,10
S01009543,Good health,150,10,5,5,25,15,21,17,24,26,3,2,1,9
S01009543,Fair health,73,4,1,3,13,5,5,10,13,16,7,5,2,0
S01009543,Bad health,25,2,0,2,1,4,0,4,4,9,1,1,0,0
S01009543,Very bad health,8,1,0,1,2,0,2,1,1,1,0,0,0,0
S01009544,All people aged 16 to 74,639,33,3,30,133,89,55,55,124,94,30,15,15,26
S01009544,Very good health,277,23,0,23,63,47,20,24,44,32,5,1,4,19
S01009544,Good health,205,6,2,4,47,27,19,19,37,31,14,7,7,5
S01009544,Fair health,111,2,1,1,15,12,10,8,30,22,10,6,4,2
S01009544,Bad health,35,1,0,1,4,2,4,3,12,8,1,1,0,0
S01009544,Very bad health,11,1,0,1,4,1,2,1,1,1,0,0,0,0
S01009545,All people aged 16 to 74,582,20,7,13,95,59,52,52,118,110,29,17,12,47
S01009545,Very good health,260,15,6,9,51,28,30,19,41,38,10,6,4,28
S01009545,Good health,198,2,0,2,29,22,15,20,48,37,10,5,5,15
S01009545,Fair health,82,3,1,2,7,5,4,9,15,27,9,6,3,3
S01009545,Bad health,37,0,0,0,8,4,3,4,13,4,0,0,0,1
S01009545,Very bad health,5,0,0,0,0,0,0,0,1,4,0,0,0,0
S01009546,All people aged 16 to 74,752,26,7,19,127,86,52,92,148,134,49,29,20,38
S01009546,Very good health,354,13,1,12,76,44,24,44,62,49,15,7,8,27
S01009546,Good health,259,10,6,4,40,32,16,26,57,54,14,8,6,10
S01009546,Fair health,102,2,0,2,8,7,9,14,23,21,17,11,6,1
S01009546,Bad health,26,0,0,0,2,3,1,6,6,7,1,1,0,0
S01009546,Very bad health,11,1,0,1,1,0,2,2,0,3,2,2,0,0
S01009547,All people aged 16 to 74,557,35,6,29,79,51,42,66,119,85,36,24,12,44
S01009547,Very good health,241,17,3,14,41,18,19,27,46,34,12,4,8,27
S01009547,Good health,206,14,3,11,27,21,15,24,47,32,14,13,1,12
S01009547,Fair health,77,3,0,3,6,9,5,12,15,14,8,5,3,5
S01009547,Bad health,21,0,0,0,1,2,3,2,8,4,1,1,0,0
S01009547,Very bad health,12,1,0,1,4,1,0,1,3,1,1,1,0,0
S01009548,All people aged 16 to 74,512,24,10,14,89,66,31,49,114,88,20,8,12,31
S01009548,Very good health,244,12,5,7,53,34,12,29,45,23,8,3,5,28
S01009548,Good health,176,8,3,5,23,22,14,11,47,41,8,3,5,2
S01009548,Fair health,58,3,2,1,7,7,3,7,13,15,2,1,1,1
S01009548,Bad health,29,1,0,1,6,2,2,2,8,7,1,1,0,0
S01009548,Very bad health,5,0,0,0,0,1,0,0,1,2,1,0,1,0
S01009549,All people aged 16 to 74,581,29,12,17,89,79,44,58,130,90,18,7,11,44
S01009549,Very good health,273,16,7,9,48,36,20,28,53,30,7,3,4,35
S01009549,Good health,225,10,3,7,32,31,19,21,55,43,6,2,4,8
S01009549,Fair health,64,3,2,1,8,8,5,8,14,14,3,0,3,1
S01009549,Bad health,13,0,0,0,1,2,0,1,6,2,1,1,0,0
S01009549,Very bad health,6,0,0,0,0,2,0,0,2,1,1,1,0,0
S01009550,All people aged 16 to 74,374,29,11,18,85,62,19,38,61,39,10,7,3,31
S01009550,Very good health,199,16,5,11,44,33,6,17,34,18,6,5,1,25
S01009550,Good health,128,10,5,5,30,24,8,15,19,15,1,0,1,6
S01009550,Fair health,31,3,1,2,7,4,3,3,7,4,0,0,0,0
S01009550,Bad health,13,0,0,0,3,0,2,3,1,1,3,2,1,0
S01009550,Very bad health,3,0,0,0,1,1,0,0,0,1,0,0,0,0
S01009551,All people aged 16 to 74,391,15,4,11,79,63,16,41,79,56,24,15,9,18
S01009551,Very good health,190,9,2,7,38,29,9,16,43,24,8,3,5,14
S01009551,Good health,130,3,2,1,25,23,5,14,26,20,10,8,2,4
S01009551,Fair health,50,2,0,2,12,9,2,9,5,6,5,3,2,0
S01009551,Bad health,16,1,0,1,3,1,0,2,4,5,0,0,0,0
S01009551,Very bad health,5,0,0,0,1,1,0,0,1,1,1,1,0,0
S01009552,All people aged 16 to 74,669,40,11,29,134,78,59,65,126,109,22,9,13,36
S01009552,Very good health,318,26,7,19,80,37,29,32,45,35,6,1,5,28
S01009552,Good health,223,8,0,8,36,31,19,19,46,49,9,4,5,6
S01009552,Fair health,89,6,4,2,14,7,8,13,22,15,3,1,2,1
S01009552,Bad health,34,0,0,0,4,3,3,1,11,9,2,2,0,1
S01009552,Very bad health,5,0,0,0,0,0,0,0,2,1,2,1,1,0
S01009553,All people aged 16 to 74,626,21,5,16,67,46,30,81,157,126,58,29,29,40
S01009553,Very good health,256,7,0,7,30,21,14,31,56,49,22,11,11,26
S01009553,Good health,216,10,4,6,24,19,12,32,53,36,17,8,9,13
S01009553,Fair health,104,3,1,2,8,5,3,13,33,21,17,8,9,1
S01009553,Bad health,40,1,0,1,4,1,1,3,13,16,1,1,0,0
S01009553,Very bad health,10,0,0,0,1,0,0,2,2,4,1,1,0,0
S01009554,All people aged 16 to 74,504,23,10,13,76,43,55,47,116,78,36,16,20,30
S01009554,Very good health,219,12,4,8,38,22,22,13,47,28,12,7,5,25
S01009554,Good health,186,9,5,4,27,16,22,24,38,33,12,3,9,5
S01009554,Fair health,63,1,1,0,9,1,7,6,18,11,10,4,6,0
S01009554,Bad health,30,1,0,1,2,3,4,3,11,4,2,2,0,0
S01009554,Very bad health,6,0,0,0,0,1,0,1,2,2,0,0,0,0
S01009555,All people aged 16 to 74,571,30,10,20,102,78,62,53,103,72,38,15,23,33
S01009555,Very good health,264,14,4,10,50,43,24,22,43,29,15,8,7,24
S01009555,Good health,214,14,4,10,34,29,27,23,37,28,16,4,12,6
S01009555,Fair health,71,2,2,0,12,5,10,7,14,12,6,2,4,3
S01009555,Bad health,17,0,0,0,4,1,0,1,9,2,0,0,0,0
S01009555,Very bad health,5,0,0,0,2,0,1,0,0,1,1,1,0,0
S01009556,All people aged 16 to 74,574,14,3,11,74,68,30,57,141,103,46,20,26,41
S01009556,Very good health,235,7,3,4,30,32,11,30,58,38,10,5,5,19
S01009556,Good health,225,6,0,6,35,25,12,16,59,39,18,8,10,15
S01009556,Fair health,72,1,0,1,4,10,6,6,13,14,12,2,10,6
S01009556,Bad health,34,0,0,0,4,1,0,5,8,10,6,5,1,0
S01009556,Very bad health,8,0,0,0,1,0,1,0,3,2,0,0,0,1
S01009557,All people aged 16 to 74,493,15,4,11,55,44,24,47,133,97,54,25,29,24
S01009557,Very good health,172,10,3,7,23,14,7,18,45,29,15,7,8,11
S01009557,Good health,190,5,1,4,21,21,9,13,49,39,24,13,11,9
S01009557,Fair health,98,0,0,0,5,7,6,14,25,23,14,4,10,4
S01009557,Bad health,26,0,0,0,5,2,1,1,11,5,1,1,0,0
S01009557,Very bad health,7,0,0,0,1,0,1,1,3,1,0,0,0,0
S01009558,All people aged 16 to 74,486,8,2,6,44,39,19,40,138,104,50,23,27,44
S01009558,Very good health,188,3,0,3,22,18,8,12,49,31,20,7,13,25
S01009558,Good health,183,4,2,2,14,15,7,19,51,42,18,10,8,13
S01009558,Fair health,85,1,0,1,6,5,4,6,28,20,10,4,6,5
S01009558,Bad health,24,0,0,0,1,0,0,3,10,8,1,1,0,1
S01009558,Very bad health,6,0,0,0,1,1,0,0,0,3,1,1,0,0
S01009559,All people aged 16 to 74,654,13,3,10,69,59,29,67,166,150,65,42,23,36
S01009559,Very good health,233,8,2,6,26,31,5,21,55,36,28,16,12,23
S01009559,Good health,254,4,1,3,31,17,14,26,68,64,22,14,8,8
S01009559,Fair health,119,0,0,0,8,8,8,18,24,35,13,10,3,5
S01009559,Bad health,38,1,0,1,1,3,2,1,16,12,2,2,0,0
S01009559,Very bad health,10,0,0,0,3,0,0,1,3,3,0,0,0,0
S01009560,All people aged 16 to 74,557,16,4,12,80,53,23,45,142,107,59,39,20,32
S01009560,Very good health,226,6,1,5,34,24,7,13,60,34,23,15,8,25
S01009560,Good health,194,7,3,4,29,21,10,11,56,38,15,9,6,7
S01009560,Fair health,84,3,0,3,9,7,5,10,16,24,10,5,5,0
S01009560,Bad health,39,0,0,0,4,0,1,9,8,10,7,6,1,0
S01009560,Very bad health,14,0,0,0,4,1,0,2,2,1,4,4,0,0
S01009561,All people aged 16 to 74,383,9,0,9,57,40,16,41,99,69,30,16,14,22
S01009561,Very good health,137,2,0,2,16,16,4,19,32,21,12,7,5,15
S01009561,Good health,147,4,0,4,28,13,8,16,38,25,11,4,7,4
S01009561,Fair health,73,3,0,3,10,9,2,3,21,16,6,4,2,3
S01009561,Bad health,21,0,0,0,2,2,1,2,7,6,1,1,0,0
S01009561,Very bad health,5,0,0,0,1,0,1,1,1,1,0,0,0,0
S01009562,All people aged 16 to 74,547,26,4,22,98,68,22,63,112,87,28,14,14,43
S01009562,Very good health,253,19,3,16,48,34,12,25,43,30,9,3,6,33
S01009562,Good health,191,4,0,4,33,24,6,24,40,39,11,5,6,10
S01009562,Fair health,80,2,1,1,12,6,2,13,24,14,7,5,2,0
S01009562,Bad health,18,0,0,0,5,4,1,1,3,3,1,1,0,0
S01009562,Very bad health,5,1,0,1,0,0,1,0,2,1,0,0,0,0
S01009563,All people aged 16 to 74,551,17,4,13,89,71,22,56,127,102,27,20,7,40
S01009563,Very good health,215,6,2,4,37,35,9,17,46,32,7,5,2,26
S01009563,Good health,215,9,2,7,33,28,9,25,54,39,9,6,3,9
S01009563,Fair health,88,2,0,2,17,8,3,8,19,19,7,6,1,5
S01009563,Bad health,22,0,0,0,0,0,1,5,6,9,1,0,1,0
S01009563,Very bad health,11,0,0,0,2,0,0,1,2,3,3,3,0,0
S01009564,All people aged 16 to 74,465,24,8,16,97,70,22,43,96,69,11,6,5,33
S01009564,Very good health,215,11,2,9,49,37,11,16,40,24,0,0,0,27
S01009564,Good health,162,11,6,5,39,21,6,13,39,24,5,3,2,4
S01009564,Fair health,64,0,0,0,6,9,4,12,12,15,5,2,3,1
S01009564,Bad health,23,1,0,1,3,3,1,2,5,6,1,1,0,1
S01009564,Very bad health,1,1,0,1,0,0,0,0,0,0,0,0,0,0
S01009565,All people aged 16 to 74,426,9,2,7,68,56,14,53,77,77,36,21,15,36
S01009565,Very good health,189,5,1,4,35,28,3,17,31,29,15,9,6,26
S01009565,Good health,153,3,1,2,22,17,7,22,35,28,10,3,7,9
S01009565,Fair health,54,1,0,1,5,7,3,10,6,15,6,4,2,1
S01009565,Bad health,25,0,0,0,6,3,1,3,4,5,3,3,0,0
S01009565,Very bad health,5,0,0,0,0,1,0,1,1,0,2,2,0,0
S01009566,All people aged 16 to 74,780,34,9,25,154,99,41,89,175,105,28,17,11,55
S01009566,Very good health,380,20,5,15,72,51,23,44,77,41,13,7,6,39
S01009566,Good health,273,10,2,8,57,35,15,31,68,40,5,3,2,12
S01009566,Fair health,96,4,2,2,23,9,2,7,24,16,8,5,3,3
S01009566,Bad health,21,0,0,0,2,3,1,3,4,7,0,0,0,1
S01009566,Very bad health,10,0,0,0,0,1,0,4,2,1,2,2,0,0
S01009567,All people aged 16 to 74,663,26,5,21,120,95,34,69,133,113,38,18,20,35
S01009567,Very good health,284,11,1,10,50,35,15,24,61,43,16,6,10,29
S01009567,Good health,258,12,4,8,52,36,16,34,43,49,12,4,8,4
S01009567,Fair health,87,3,0,3,14,17,3,10,21,10,7,5,2,2
S01009567,Bad health,23,0,0,0,2,6,0,1,7,5,2,2,0,0
S01009567,Very bad health,11,0,0,0,2,1,0,0,1,6,1,1,0,0
S01009568,All people aged 16 to 74,522,16,3,13,90,65,31,57,114,81,27,15,12,41
S01009568,Very good health,212,5,0,5,46,21,13,19,41,29,12,3,9,26
S01009568,Good health,177,7,2,5,31,30,10,20,40,23,6,4,2,10
S01009568,Fair health,86,2,0,2,10,8,4,11,23,18,6,5,1,4
S01009568,Bad health,38,2,1,1,2,5,3,4,9,9,3,3,0,1
S01009568,Very bad health,9,0,0,0,1,1,1,3,1,2,0,0,0,0
S01009569,All people aged 16 to 74,601,17,4,13,83,74,19,58,161,132,25,15,10,32
S01009569,Very good health,237,5,1,4,34,34,7,27,60,39,8,5,3,23
S01009569,Good health,229,7,1,6,35,28,7,19,64,55,7,5,2,7
S01009569,Fair health,96,4,1,3,13,11,3,6,26,24,7,2,5,2
S01009569,Bad health,31,1,1,0,1,1,2,5,10,10,1,1,0,0
S01009569,Very bad health,8,0,0,0,0,0,0,1,1,4,2,2,0,0
S01009570,All people aged 16 to 74,400,7,3,4,60,46,20,37,90,81,22,14,8,37
S01009570,Very good health,176,1,1,0,33,21,9,15,31,31,10,5,5,25
S01009570,Good health,140,4,1,3,20,20,8,9,30,33,9,7,2,7
S01009570,Fair health,56,2,1,1,5,4,2,8,20,9,2,1,1,4
S01009570,Bad health,21,0,0,0,2,1,1,3,6,7,1,1,0,0
S01009570,Very bad health,7,0,0,0,0,0,0,2,3,1,0,0,0,1
S01009571,All people aged 16 to 74,511,5,0,5,59,52,24,50,130,84,60,37,23,47
S01009571,Very good health,197,3,0,3,31,25,6,20,44,18,20,13,7,30
S01009571,Good health,184,1,0,1,22,17,8,21,52,29,22,13,9,12
S01009571,Fair health,95,1,0,1,4,8,5,5,29,23,15,8,7,5
S01009571,Bad health,28,0,0,0,1,1,4,3,4,14,1,1,0,0
S01009571,Very bad health,7,0,0,0,1,1,1,1,1,0,2,2,0,0
S01009572,All people aged 16 to 74,761,14,5,9,89,79,37,64,183,156,73,38,35,66
S01009572,Very good health,245,6,3,3,35,18,10,18,57,42,23,11,12,36
S01009572,Good health,318,7,2,5,37,48,21,33,78,54,23,8,15,17
S01009572,Fair health,140,0,0,0,14,10,4,11,34,38,18,10,8,11
S01009572,Bad health,47,0,0,0,3,3,2,1,9,19,8,8,0,2
S01009572,Very bad health,11,1,0,1,0,0,0,1,5,3,1,1,0,0
S01009573,All people aged 16 to 74,537,10,1,9,45,47,16,54,136,117,67,43,24,45
S01009573,Very good health,208,6,0,6,20,28,6,19,53,29,18,13,5,29
S01009573,Good health,185,2,1,1,19,13,7,20,51,39,22,14,8,12
S01009573,Fair health,83,2,0,2,6,5,3,9,19,21,16,7,9,2
S01009573,Bad health,47,0,0,0,0,1,0,4,9,20,11,9,2,2
S01009573,Very bad health,14,0,0,0,0,0,0,2,4,8,0,0,0,0
S01009574,All people aged 16 to 74,719,21,3,18,96,76,39,73,160,165,38,21,17,51
S01009574,Very good health,289,9,3,6,49,34,15,33,56,48,10,6,4,35
S01009574,Good health,245,7,0,7,31,21,14,18,67,66,10,4,6,11
S01009574,Fair health,134,2,0,2,12,13,6,13,30,39,15,8,7,4
S01009574,Bad health,39,2,0,2,3,6,3,8,4,10,2,2,0,1
S01009574,Very bad health,12,1,0,1,1,2,1,1,3,2,1,1,0,0
S01009575,All people aged 16 to 74,381,12,3,9,80,57,21,50,68,48,17,8,9,28
S01009575,Very good health,169,4,1,3,37,30,10,17,27,17,5,1,4,22
S01009575,Good health,132,7,1,6,29,22,8,21,25,12,5,3,2,3
S01009575,Fair health,62,0,0,0,8,5,2,10,12,17,5,2,3,3
S01009575,Bad health,13,1,1,0,4,0,0,1,4,2,1,1,0,0
S01009575,Very bad health,5,0,0,0,2,0,1,1,0,0,1,1,0,0
S01009576,All people aged 16 to 74,428,37,8,29,104,82,38,41,69,31,7,7,0,19
S01009576,Very good health,214,19,1,18,67,40,18,15,26,12,1,1,0,16
S01009576,Good health,155,11,7,4,32,29,15,16,35,15,1,1,0,1
S01009576,Fair health,43,6,0,6,3,10,3,6,6,3,4,4,0,2
S01009576,Bad health,14,1,0,1,1,3,1,4,2,1,1,1,0,0
S01009576,Very bad health,2,0,0,0,1,0,1,0,0,0,0,0,0,0
S01009577,All people aged 16 to 74,556,49,16,33,155,64,47,45,76,60,24,21,3,36
S01009577,Very good health,296,22,9,13,87,40,25,21,35,31,9,7,2,26
S01009577,Good health,189,23,4,19,51,19,19,18,28,18,4,4,0,9
S01009577,Fair health,49,4,3,1,13,5,1,3,12,8,2,1,1,1
S01009577,Bad health,16,0,0,0,4,0,0,3,1,3,5,5,0,0
S01009577,Very bad health,6,0,0,0,0,0,2,0,0,0,4,4,0,0
S01009578,All people aged 16 to 74,574,23,9,14,120,80,33,38,113,87,35,23,12,45
S01009578,Very good health,270,18,6,12,61,42,13,18,41,32,10,7,3,35
S01009578,Good health,187,5,3,2,36,20,11,17,48,29,13,7,6,8
S01009578,Fair health,82,0,0,0,15,15,7,0,15,20,8,6,2,2
S01009578,Bad health,29,0,0,0,5,2,2,3,7,6,4,3,1,0
S01009578,Very bad health,6,0,0,0,3,1,0,0,2,0,0,0,0,0
S01009579,All people aged 16 to 74,806,53,20,33,179,110,56,89,132,96,43,24,19,48
S01009579,Very good health,389,32,14,18,100,59,23,39,47,38,14,8,6,37
S01009579,Good health,270,15,5,10,61,40,21,30,56,23,15,5,10,9
S01009579,Fair health,86,3,0,3,11,7,5,14,20,16,8,6,2,2
S01009579,Bad health,43,3,1,2,5,4,4,3,5,14,5,5,0,0
S01009579,Very bad health,18,0,0,0,2,0,3,3,4,5,1,0,1,0
S01009580,All people aged 16 to 74,722,50,15,35,183,118,51,67,106,66,14,10,4,67
S01009580,Very good health,400,31,9,22,98,68,28,38,56,24,5,3,2,52
S01009580,Good health,249,16,5,11,68,46,17,22,32,31,5,4,1,12
S01009580,Fair health,62,2,0,2,16,3,5,5,16,9,4,3,1,2
S01009580,Bad health,9,1,1,0,1,1,1,1,2,1,0,0,0,1
S01009580,Very bad health,2,0,0,0,0,0,0,1,0,1,0,0,0,0
S01009581,All people aged 16 to 74,439,11,5,6,85,68,22,48,86,72,19,9,10,28
S01009581,Very good health,190,7,4,3,42,22,8,21,41,21,6,2,4,22
S01009581,Good health,136,2,1,1,22,26,10,13,28,25,6,2,4,4
S01009581,Fair health,73,1,0,1,16,14,3,9,14,9,5,4,1,2
S01009581,Bad health,30,0,0,0,4,5,1,4,3,12,1,0,1,0
S01009581,Very bad health,10,1,0,1,1,1,0,1,0,5,1,1,0,0
S01009582,All people aged 16 to 74,380,13,2,11,70,64,23,40,80,59,14,1,13,17
S01009582,Very good health,165,7,1,6,34,26,6,16,35,23,7,1,6,11
S01009582,Good health,152,4,0,4,27,30,14,14,29,24,5,0,5,5
S01009582,Fair health,45,2,1,1,6,3,3,7,13,9,1,0,1,1
S01009582,Bad health,13,0,0,0,3,3,0,3,2,1,1,0,1,0
S01009582,Very bad health,5,0,0,0,0,2,0,0,1,2,0,0,0,0
S01009583,All people aged 16 to 74,582,17,3,14,77,91,34,57,138,89,36,21,15,43
S01009583,Very good health,242,8,1,7,35,44,15,21,46,31,16,7,9,26
S01009583,Good health,235,8,2,6,30,33,10,24,64,39,13,9,4,14
S01009583,Fair health,72,1,0,1,7,8,8,6,19,15,5,3,2,3
S01009583,Bad health,25,0,0,0,3,6,1,4,6,3,2,2,0,0
S01009583,Very bad health,8,0,0,0,2,0,0,2,3,1,0,0,0,0
S01009584,All people aged 16 to 74,372,33,11,22,87,54,41,30,65,31,12,6,6,19
S01009584,Very good health,187,20,6,14,46,24,20,11,31,19,6,2,4,10
S01009584,Good health,136,11,5,6,33,19,18,10,23,10,5,3,2,7
S01009584,Fair health,34,2,0,2,6,9,2,5,6,2,0,0,0,2
S01009584,Bad health,11,0,0,0,1,2,1,2,5,0,0,0,0,0
S01009584,Very bad health,4,0,0,0,1,0,0,2,0,0,1,1,0,0
S01009585,All people aged 16 to 74,730,16,6,10,106,99,45,90,179,122,27,13,14,46
S01009585,Very good health,332,10,3,7,51,45,19,30,81,53,10,6,4,33
S01009585,Good health,261,2,2,0,42,34,20,39,66,36,11,3,8,11
S01009585,Fair health,90,3,0,3,10,15,4,12,20,20,5,3,2,1
S01009585,Bad health,36,1,1,0,2,5,1,7,9,10,1,1,0,0
S01009585,Very bad health,11,0,0,0,1,0,1,2,3,3,0,0,0,1
S01009586,All people aged 16 to 74,494,21,10,11,91,68,25,68,95,68,36,29,7,22
S01009586,Very good health,179,8,4,4,36,23,11,23,32,23,6,4,2,17
S01009586,Good health,195,10,5,5,36,29,9,32,43,18,14,11,3,4
S01009586,Fair health,71,3,1,2,10,10,4,7,12,11,13,11,2,1
S01009586,Bad health,35,0,0,0,7,4,1,3,6,11,3,3,0,0
S01009586,Very bad health,14,0,0,0,2,2,0,3,2,5,0,0,0,0
S01009587,All people aged 16 to 74,497,30,11,19,87,60,24,58,112,80,24,12,12,22
S01009587,Very good health,196,13,4,9,42,31,6,31,34,21,6,4,2,12
S01009587,Good health,180,10,5,5,30,20,11,22,43,28,8,4,4,8
S01009587,Fair health,93,4,1,3,12,5,5,4,28,26,7,2,5,2
S01009587,Bad health,19,2,0,2,2,3,2,1,4,3,2,1,1,0
S01009587,Very bad health,9,1,1,0,1,1,0,0,3,2,1,1,0,0
S01009588,All people aged 16 to 74,725,20,3,17,113,82,34,94,177,118,34,25,9,53
S01009588,Very good health,313,11,3,8,57,33,16,47,62,43,7,4,3,37
S01009588,Good health,236,8,0,8,33,33,13,27,61,37,13,8,5,11
S01009588,Fair health,125,1,0,1,19,13,3,12,36,27,10,10,0,4
S01009588,Bad health,41,0,0,0,4,3,2,5,14,9,4,3,1,0
S01009588,Very bad health,10,0,0,0,0,0,0,3,4,2,0,0,0,1
S01009589,All people aged 16 to 74,677,14,4,10,105,80,33,90,150,109,44,28,16,52
S01009589,Very good health,316,7,2,5,59,42,15,44,60,40,14,11,3,35
S01009589,Good health,228,7,2,5,29,30,10,27,57,39,18,8,10,11
S01009589,Fair health,102,0,0,0,15,4,4,16,30,21,8,6,2,4
S01009589,Bad health,27,0,0,0,2,3,4,3,3,7,3,2,1,2
S01009589,Very bad health,4,0,0,0,0,1,0,0,0,2,1,1,0,0
S01009590,All people aged 16 to 74,543,53,16,37,172,69,39,42,68,40,13,8,5,47
S01009590,Very good health,272,22,10,12,95,32,21,18,33,15,4,3,1,32
S01009590,Good health,209,25,5,20,61,31,15,16,27,15,4,1,3,15
S01009590,Fair health,47,5,1,4,15,5,3,5,4,6,4,3,1,0
S01009590,Bad health,14,1,0,1,1,1,0,2,4,4,1,1,0,0
S01009590,Very bad health,1,0,0,0,0,0,0,1,0,0,0,0,0,0
S01009591,All people aged 16 to 74,533,59,15,44,130,80,37,48,87,50,13,5,8,29
S01009591,Very good health,257,23,7,16,61,34,19,20,43,23,8,3,5,26
S01009591,Good health,197,24,6,18,47,40,15,17,30,19,2,1,1,3
S01009591,Fair health,56,9,2,7,14,5,3,7,10,5,3,1,2,0
S01009591,Bad health,19,3,0,3,6,1,0,3,3,3,0,0,0,0
S01009591,Very bad health,4,0,0,0,2,0,0,1,1,0,0,0,0,0
S01009592,All people aged 16 to 74,441,60,11,49,124,55,42,37,68,30,5,2,3,20
S01009592,Very good health,199,33,7,26,56,27,23,14,24,6,3,1,2,13
S01009592,Good health,185,21,1,20,56,19,16,18,33,13,2,1,1,7
S01009592,Fair health,41,5,3,2,9,5,3,5,7,7,0,0,0,0
S01009592,Bad health,12,1,0,1,2,3,0,0,2,4,0,0,0,0
S01009592,Very bad health,4,0,0,0,1,1,0,0,2,0,0,0,0,0
S01009593,All people aged 16 to 74,454,61,18,43,122,76,43,32,47,24,19,13,6,30
S01009593,Very good health,256,32,8,24,69,43,22,20,24,15,9,6,3,22
S01009593,Good health,162,27,10,17,47,27,16,11,14,7,6,5,1,7
S01009593,Fair health,26,1,0,1,4,5,2,1,8,2,2,1,1,1
S01009593,Bad health,8,1,0,1,2,1,3,0,1,0,0,0,0,0
S01009593,Very bad health,2,0,0,0,0,0,0,0,0,0,2,1,1,0
S01009594,All people aged 16 to 74,525,61,18,43,132,102,32,60,64,36,12,8,4,26
S01009594,Very good health,289,37,12,25,74,54,11,33,29,21,7,7,0,23
S01009594,Good health,167,14,3,11,44,37,14,21,19,10,5,1,4,3
S01009594,Fair health,42,7,2,5,8,6,6,4,8,3,0,0,0,0
S01009594,Bad health,24,3,1,2,3,5,1,2,8,2,0,0,0,0
S01009594,Very bad health,3,0,0,0,3,0,0,0,0,0,0,0,0,0
S01009595,All people aged 16 to 74,392,53,24,29,106,60,37,22,51,20,12,7,5,31
S01009595,Very good health,226,32,17,15,58,34,19,15,26,11,7,3,4,24
S01009595,Good health,124,18,5,13,40,22,12,3,18,6,1,1,0,4
S01009595,Fair health,31,2,2,0,7,3,4,4,2,3,3,2,1,3
S01009595,Bad health,10,1,0,1,1,1,2,0,4,0,1,1,0,0
S01009595,Very bad health,1,0,0,0,0,0,0,0,1,0,0,0,0,0
S01009596,All people aged 16 to 74,607,21,6,15,88,81,37,61,152,97,36,24,12,34
S01009596,Very good health,270,10,4,6,41,39,19,21,63,39,13,8,5,25
S01009596,Good health,221,6,1,5,37,33,12,28,56,31,12,6,6,6
S01009596,Fair health,73,4,0,4,9,7,1,8,19,15,7,6,1,3
S01009596,Bad health,33,0,0,0,1,2,3,2,11,11,3,3,0,0
S01009596,Very bad health,10,1,1,0,0,0,2,2,3,1,1,1,0,0
S01009597,All people aged 16 to 74,619,13,3,10,65,69,38,74,141,97,68,34,34,54
S01009597,Very good health,238,6,0,6,29,25,9,26,60,31,21,10,11,31
S01009597,Good health,230,4,2,2,26,26,18,29,43,31,35,18,17,18
S01009597,Fair health,101,2,1,1,6,13,9,10,26,22,8,5,3,5
S01009597,Bad health,44,1,0,1,3,4,1,7,12,12,4,1,3,0
S01009597,Very bad health,6,0,0,0,1,1,1,2,0,1,0,0,0,0
S01009598,All people aged 16 to 74,483,12,1,11,57,48,32,43,108,87,51,27,24,45
S01009598,Very good health,195,5,0,5,27,17,19,14,40,28,14,10,4,31
S01009598,Good health,154,5,1,4,16,17,7,14,40,27,15,6,9,13
S01009598,Fair health,90,1,0,1,9,9,6,12,19,16,17,8,9,1
S01009598,Bad health,35,0,0,0,4,3,0,3,8,14,3,2,1,0
S01009598,Very bad health,9,1,0,1,1,2,0,0,1,2,2,1,1,0
S01009599,All people aged 16 to 74,687,30,12,18,108,105,34,74,142,108,50,28,22,36
S01009599,Very good health,268,12,6,6,45,52,17,21,44,36,17,11,6,24
S01009599,Good health,240,10,4,6,39,31,10,28,61,33,19,9,10,9
S01009599,Fair health,120,4,1,3,14,14,6,19,25,25,10,5,5,3
S01009599,Bad health,50,3,1,2,9,7,1,5,12,11,2,1,1,0
S01009599,Very bad health,9,1,0,1,1,1,0,1,0,3,2,2,0,0
S01009600,All people aged 16 to 74,453,13,4,9,65,54,24,43,95,91,36,23,13,32
S01009600,Very good health,170,7,1,6,18,18,11,15,38,28,13,8,5,22
S01009600,Good health,155,4,3,1,28,17,6,16,29,33,15,9,6,7
S01009600,Fair health,82,2,0,2,12,9,5,7,20,18,6,4,2,3
S01009600,Bad health,29,0,0,0,6,6,2,3,3,7,2,2,0,0
S01009600,Very bad health,17,0,0,0,1,4,0,2,5,5,0,0,0,0
S01009601,All people aged 16 to 74,505,14,4,10,76,66,21,63,94,85,54,32,22,32
S01009601,Very good health,219,7,3,4,43,25,8,20,35,31,20,12,8,30
S01009601,Good health,175,4,0,4,23,26,7,26,38,35,14,5,9,2
S01009601,Fair health,71,1,0,1,6,12,3,11,14,12,12,8,4,0
S01009601,Bad health,30,2,1,1,2,2,2,4,5,5,8,7,1,0
S01009601,Very bad health,10,0,0,0,2,1,1,2,2,2,0,0,0,0
S01009602,All people aged 16 to 74,592,73,21,52,177,93,38,43,77,42,16,9,7,33
S01009602,Very good health,327,42,13,29,97,53,20,21,37,25,5,4,1,27
S01009602,Good health,209,27,8,19,65,36,14,19,32,8,4,0,4,4
S01009602,Fair health,32,2,0,2,9,3,3,1,4,5,5,3,2,0
S01009602,Bad health,18,2,0,2,5,1,0,2,3,3,0,0,0,2
S01009602,Very bad health,6,0,0,0,1,0,1,0,1,1,2,2,0,0
S01009603,All people aged 16 to 74,442,52,18,34,114,67,32,34,62,28,22,21,1,31
S01009603,Very good health,219,30,10,20,63,29,16,11,30,11,4,4,0,25
S01009603,Good health,147,11,5,6,38,32,12,14,17,8,9,9,0,6
S01009603,Fair health,59,8,3,5,10,3,3,7,11,8,9,8,1,0
S01009603,Bad health,14,1,0,1,2,3,1,2,4,1,0,0,0,0
S01009603,Very bad health,3,2,0,2,1,0,0,0,0,0,0,0,0,0
S01009604,All people aged 16 to 74,648,30,7,23,153,78,33,79,122,93,22,17,5,38
S01009604,Very good health,266,17,2,15,71,34,16,30,38,32,2,2,0,26
S01009604,Good health,251,9,5,4,52,38,13,28,53,38,10,7,3,10
S01009604,Fair health,88,1,0,1,22,4,3,13,21,13,9,7,2,2
S01009604,Bad health,31,1,0,1,7,2,1,5,7,8,0,0,0,0
S01009604,Very bad health,12,2,0,2,1,0,0,3,3,2,1,1,0,0
S01009605,All people aged 16 to 74,580,27,8,19,83,75,40,70,119,75,46,35,11,45
S01009605,Very good health,235,17,3,14,34,39,20,24,38,22,15,11,4,26
S01009605,Good health,196,8,4,4,27,24,10,25,41,26,20,14,6,15
S01009605,Fair health,93,2,1,1,15,8,7,13,25,14,5,4,1,4
S01009605,Bad health,42,0,0,0,3,3,2,8,12,10,4,4,0,0
S01009605,Very bad health,14,0,0,0,4,1,1,0,3,3,2,2,0,0
S01009606,All people aged 16 to 74,413,57,14,43,140,50,26,29,55,22,12,10,2,22
S01009606,Very good health,228,32,6,26,87,26,13,19,27,9,1,0,1,14
S01009606,Good health,136,22,7,15,39,21,9,8,17,9,4,4,0,7
S01009606,Fair health,35,3,1,2,11,3,3,1,7,3,3,2,1,1
S01009606,Bad health,8,0,0,0,2,0,1,0,3,0,2,2,0,0
S01009606,Very bad health,6,0,0,0,1,0,0,1,1,1,2,2,0,0
S01009607,All people aged 16 to 74,404,51,18,33,122,62,31,31,43,34,6,4,2,24
S01009607,Very good health,210,32,10,22,60,32,11,17,21,13,3,3,0,21
S01009607,Good health,147,16,7,9,49,21,10,12,16,19,2,1,1,2
S01009607,Fair health,37,3,1,2,9,6,10,2,4,2,1,0,1,0
S01009607,Bad health,8,0,0,0,3,2,0,0,2,0,0,0,0,1
S01009607,Very bad health,2,0,0,0,1,1,0,0,0,0,0,0,0,0
S01009608,All people aged 16 to 74,427,21,5,16,83,57,25,43,83,74,20,9,11,21
S01009608,Very good health,185,8,2,6,37,28,12,21,32,25,7,3,4,15
S01009608,Good health,169,12,3,9,38,20,9,18,33,28,7,2,5,4
S01009608,Fair health,50,0,0,0,4,7,4,3,12,14,4,3,1,2
S01009608,Bad health,18,1,0,1,3,1,0,1,4,6,2,1,1,0
S01009608,Very bad health,5,0,0,0,1,1,0,0,2,1,0,0,0,0
S01009609,All people aged 16 to 74,606,43,11,32,148,87,50,55,91,68,24,17,7,40
S01009609,Very good health,313,23,5,18,76,48,25,31,39,31,9,5,4,31
S01009609,Good health,205,17,5,12,58,25,16,18,33,26,5,5,0,7
S01009609,Fair health,67,3,1,2,10,9,8,4,14,8,10,7,3,1
S01009609,Bad health,17,0,0,0,2,5,1,2,4,2,0,0,0,1
S01009609,Very bad health,4,0,0,0,2,0,0,0,1,1,0,0,0,0
S01009610,All people aged 16 to 74,732,37,7,30,167,97,40,83,141,101,23,11,12,43
S01009610,Very good health,313,22,5,17,67,44,23,34,46,33,10,5,5,34
S01009610,Good health,268,10,2,8,73,38,13,29,51,43,5,2,3,6
S01009610,Fair health,106,3,0,3,23,6,3,15,29,18,8,4,4,1
S01009610,Bad health,38,1,0,1,4,9,1,4,12,6,0,0,0,1
S01009610,Very bad health,7,1,0,1,0,0,0,1,3,1,0,0,0,1
S01009611,All people aged 16 to 74,408,52,12,40,82,63,54,40,61,29,3,2,1,24
S01009611,Very good health,196,31,9,22,42,26,22,9,29,12,2,1,1,23
S01009611,Good health,150,17,2,15,32,24,23,24,18,11,1,1,0,0
S01009611,Fair health,39,3,1,2,6,8,5,6,7,3,0,0,0,1
S01009611,Bad health,16,1,0,1,1,5,3,1,3,2,0,0,0,0
S01009611,Very bad health,7,0,0,0,1,0,1,0,4,1,0,0,0,0
S01009612,All people aged 16 to 74,449,21,7,14,72,72,39,40,82,83,13,8,5,27
S01009612,Very good health,196,10,3,7,49,36,14,13,28,24,3,3,0,19
S01009612,Good health,174,9,3,6,16,27,21,19,37,32,5,1,4,8
S01009612,Fair health,58,2,1,1,5,6,3,7,10,20,5,4,1,0
S01009612,Bad health,15,0,0,0,2,3,0,0,6,4,0,0,0,0
S01009612,Very bad health,6,0,0,0,0,0,1,1,1,3,0,0,0,0
S01009613,All people aged 16 to 74,355,24,7,17,131,41,46,25,48,16,6,4,2,18
S01009613,Very good health,176,15,5,10,78,22,20,7,12,6,2,1,1,14
S01009613,Good health,139,8,2,6,45,18,16,12,26,7,3,2,1,4
S01009613,Fair health,28,1,0,1,5,1,8,4,9,0,0,0,0,0
S01009613,Bad health,9,0,0,0,2,0,2,2,0,2,1,1,0,0
S01009613,Very bad health,3,0,0,0,1,0,0,0,1,1,0,0,0,0
S01009614,All people aged 16 to 74,388,32,11,21,83,45,47,44,55,47,10,4,6,25
S01009614,Very good health,176,19,7,12,39,20,22,16,19,16,3,2,1,22
S01009614,Good health,134,9,2,7,31,19,13,20,22,14,3,0,3,3
S01009614,Fair health,58,4,2,2,11,6,8,4,12,10,3,1,2,0
S01009614,Bad health,16,0,0,0,1,0,3,4,2,5,1,1,0,0
S01009614,Very bad health,4,0,0,0,1,0,1,0,0,2,0,0,0,0
S01009615,All people aged 16 to 74,303,20,5,15,55,50,27,34,43,47,9,6,3,18
S01009615,Very good health,135,7,1,6,30,27,8,15,15,11,4,2,2,18
S01009615,Good health,97,9,4,5,19,15,9,9,13,19,4,3,1,0
S01009615,Fair health,55,4,0,4,6,7,7,8,13,9,1,1,0,0
S01009615,Bad health,15,0,0,0,0,1,2,2,2,8,0,0,0,0
S01009615,Very bad health,1,0,0,0,0,0,1,0,0,0,0,0,0,0
S01009616,All people aged 16 to 74,564,29,9,20,87,76,43,68,116,75,31,15,16,39
S01009616,Very good health,286,14,3,11,45,37,19,37,48,40,11,2,9,35
S01009616,Good health,172,12,4,8,27,26,12,16,47,19,9,5,4,4
S01009616,Fair health,70,2,1,1,7,9,9,8,19,10,6,4,2,0
S01009616,Bad health,30,1,1,0,8,3,2,5,2,5,4,3,1,0
S01009616,Very bad health,6,0,0,0,0,1,1,2,0,1,1,1,0,0
S01009617,All people aged 16 to 74,568,41,7,34,120,68,46,77,102,65,10,6,4,39
S01009617,Very good health,291,21,5,16,61,33,29,33,50,28,4,3,1,32
S01009617,Good health,187,15,1,14,44,25,10,34,30,23,2,1,1,4
S01009617,Fair health,56,4,1,3,11,5,5,8,12,9,0,0,0,2
S01009617,Bad health,26,1,0,1,2,5,2,2,9,1,3,1,2,1
S01009617,Very bad health,8,0,0,0,2,0,0,0,1,4,1,1,0,0
S01009618,All people aged 16 to 74,528,11,3,8,63,70,33,56,128,109,38,20,18,20
S01009618,Very good health,216,4,2,2,34,27,16,16,54,39,13,6,7,13
S01009618,Good health,183,4,0,4,21,32,11,26,37,35,12,6,6,5
S01009618,Fair health,80,3,1,2,5,7,4,9,24,18,8,4,4,2
S01009618,Bad health,46,0,0,0,3,4,2,4,13,15,5,4,1,0
S01009618,Very bad health,3,0,0,0,0,0,0,1,0,2,0,0,0,0
S01009619,All people aged 16 to 74,464,14,2,12,74,53,24,54,105,78,33,19,14,29
S01009619,Very good health,169,6,0,6,34,24,11,16,28,25,5,2,3,20
S01009619,Good health,137,4,1,3,14,15,10,18,39,16,15,9,6,6
S01009619,Fair health,97,3,1,2,16,11,3,10,21,22,8,5,3,3
S01009619,Bad health,54,1,0,1,9,1,0,9,17,14,3,1,2,0
S01009619,Very bad health,7,0,0,0,1,2,0,1,0,1,2,2,0,0
S01009620,All people aged 16 to 74,570,10,1,9,70,44,28,68,148,123,48,32,16,31
S01009620,Very good health,200,2,0,2,27,18,9,26,58,27,15,9,6,18
S01009620,Good health,201,3,0,3,32,16,11,22,60,35,11,6,5,11
S01009620,Fair health,116,5,1,4,8,6,5,14,19,40,17,12,5,2
S01009620,Bad health,35,0,0,0,1,3,2,3,10,13,3,3,0,0
S01009620,Very bad health,18,0,0,0,2,1,1,3,1,8,2,2,0,0
S01009621,All people aged 16 to 74,591,18,5,13,86,75,39,74,125,101,53,34,19,20
S01009621,Very good health,222,7,1,6,35,37,11,28,44,32,15,8,7,13
S01009621,Good health,212,9,3,6,32,24,17,24,46,35,20,15,5,5
S01009621,Fair health,110,1,0,1,17,11,8,15,25,19,12,5,7,2
S01009621,Bad health,35,0,0,0,1,3,2,5,8,12,4,4,0,0
S01009621,Very bad health,12,1,1,0,1,0,1,2,2,3,2,2,0,0
S01009622,All people aged 16 to 74,536,8,2,6,52,63,31,49,123,114,74,47,27,22
S01009622,Very good health,174,5,1,4,16,27,13,10,40,26,26,16,10,11
S01009622,Good health,206,1,1,0,28,22,10,21,49,40,25,15,10,10
S01009622,Fair health,115,0,0,0,6,13,7,11,26,33,18,13,5,1
S01009622,Bad health,36,2,0,2,0,1,0,6,7,15,5,3,2,0
S01009622,Very bad health,5,0,0,0,2,0,1,1,1,0,0,0,0,0
S01009623,All people aged 16 to 74,355,8,2,6,33,42,19,39,92,73,24,17,7,25
S01009623,Very good health,132,2,1,1,16,16,10,19,31,12,8,5,3,18
S01009623,Good health,137,4,0,4,12,21,6,15,44,21,8,6,2,6
S01009623,Fair health,58,1,1,0,4,4,2,4,13,22,7,5,2,1
S01009623,Bad health,22,1,0,1,1,1,1,0,4,13,1,1,0,0
S01009623,Very bad health,6,0,0,0,0,0,0,1,0,5,0,0,0,0
S01009624,All people aged 16 to 74,668,19,4,15,74,58,26,79,171,155,42,29,13,44
S01009624,Very good health,267,10,1,9,36,25,11,25,56,50,20,13,7,34
S01009624,Good health,208,4,1,3,18,25,12,34,54,43,10,8,2,8
S01009624,Fair health,136,5,2,3,15,6,2,15,46,36,9,5,4,2
S01009624,Bad health,43,0,0,0,5,1,0,1,14,20,2,2,0,0
S01009624,Very bad health,14,0,0,0,0,1,1,4,1,6,1,1,0,0
S01009625,All people aged 16 to 74,602,5,2,3,53,55,24,67,157,144,57,29,28,40
S01009625,Very good health,272,1,0,1,27,29,13,36,65,55,18,8,10,28
S01009625,Good health,198,3,2,1,15,13,7,22,61,49,20,9,11,8
S01009625,Fair health,91,0,0,0,8,13,3,4,20,29,11,6,5,3
S01009625,Bad health,32,1,0,1,2,0,1,2,8,10,7,6,1,1
S01009625,Very bad health,9,0,0,0,1,0,0,3,3,1,1,0,1,0
S01009626,All people aged 16 to 74,424,10,2,8,30,34,22,27,108,107,57,41,16,29
S01009626,Very good health,158,1,0,1,18,15,10,10,37,27,17,11,6,23
S01009626,Good health,132,5,1,4,8,10,6,10,44,24,21,14,7,4
S01009626,Fair health,81,1,0,1,1,7,3,5,15,36,11,8,3,2
S01009626,Bad health,38,2,1,1,1,1,3,2,8,15,6,6,0,0
S01009626,Very bad health,15,1,0,1,2,1,0,0,4,5,2,2,0,0
S01009627,All people aged 16 to 74,587,13,3,10,70,56,29,55,144,135,43,30,13,42
S01009627,Very good health,257,7,1,6,35,26,13,31,61,36,16,11,5,32
S01009627,Good health,181,4,1,3,22,21,9,12,48,49,8,5,3,8
S01009627,Fair health,98,1,0,1,10,8,3,8,25,29,12,9,3,2
S01009627,Bad health,38,0,0,0,3,1,2,4,7,17,4,2,2,0
S01009627,Very bad health,13,1,1,0,0,0,2,0,3,4,3,3,0,0
S01009628,All people aged 16 to 74,354,7,2,5,31,34,14,35,95,92,25,18,7,21
S01009628,Very good health,109,4,2,2,14,14,3,6,33,16,7,3,4,12
S01009628,Good health,117,3,0,3,11,10,5,14,27,34,7,5,2,6
S01009628,Fair health,81,0,0,0,3,6,4,10,23,26,6,6,0,3
S01009628,Bad health,38,0,0,0,2,3,2,4,10,13,4,3,1,0
S01009628,Very bad health,9,0,0,0,1,1,0,1,2,3,1,1,0,0
S01009629,All people aged 16 to 74,769,12,4,8,82,75,38,83,179,158,83,48,35,59
S01009629,Very good health,331,5,1,4,33,37,14,40,83,45,32,18,14,42
S01009629,Good health,265,5,2,3,38,26,19,31,59,51,21,4,17,15
S01009629,Fair health,115,2,1,1,7,9,5,5,23,43,19,15,4,2
S01009629,Bad health,47,0,0,0,1,3,0,4,12,18,9,9,0,0
S01009629,Very bad health,11,0,0,0,3,0,0,3,2,1,2,2,0,0
S01009630,All people aged 16 to 74,582,11,5,6,55,56,20,46,131,135,76,51,25,52
S01009630,Very good health,234,1,0,1,30,15,8,22,48,41,32,21,11,37
S01009630,Good health,191,7,4,3,13,27,9,15,42,43,26,18,8,9
S01009630,Fair health,102,1,0,1,8,11,1,6,28,29,13,7,6,5
S01009630,Bad health,49,1,0,1,3,3,2,2,12,20,5,5,0,1
S01009630,Very bad health,6,1,1,0,1,0,0,1,1,2,0,0,0,0
S01009631,All people aged 16 to 74,544,7,0,7,48,37,23,60,153,134,60,35,25,22
S01009631,Very good health,167,1,0,1,14,12,5,20,49,37,23,12,11,6
S01009631,Good health,183,4,0,4,13,16,14,22,44,39,20,11,9,11
S01009631,Fair health,130,2,0,2,11,7,3,10,41,40,12,8,4,4
S01009631,Bad health,47,0,0,0,7,2,1,6,13,14,4,3,1,0
S01009631,Very bad health,17,0,0,0,3,0,0,2,6,4,1,1,0,1
S01009632,All people aged 16 to 74,394,6,3,3,29,26,19,43,108,95,53,31,22,15
S01009632,Very good health,145,4,2,2,12,14,6,16,42,27,14,6,8,10
S01009632,Good health,130,2,1,1,8,9,6,17,37,25,22,14,8,4
S01009632,Fair health,83,0,0,0,5,1,5,8,18,33,13,8,5,0
S01009632,Bad health,28,0,0,0,3,1,2,2,10,7,2,1,1,1
S01009632,Very bad health,8,0,0,0,1,1,0,0,1,3,2,2,0,0
S01009633,All people aged 16 to 74,512,4,1,3,33,41,14,52,130,115,80,51,29,43
S01009633,Very good health,173,2,0,2,9,17,3,17,39,30,28,20,8,28
S01009633,Good health,203,1,0,1,14,17,8,19,59,43,30,16,14,12
S01009633,Fair health,89,0,0,0,8,6,2,11,20,24,15,10,5,3
S01009633,Bad health,33,0,0,0,1,1,1,5,8,13,4,2,2,0
S01009633,Very bad health,14,1,1,0,1,0,0,0,4,5,3,3,0,0
S01009634,All people aged 16 to 74,362,5,1,4,33,39,6,46,89,87,42,27,15,15
S01009634,Very good health,122,2,1,1,17,19,1,12,26,25,12,10,2,8
S01009634,Good health,128,2,0,2,9,14,1,21,38,24,13,7,6,6
S01009634,Fair health,79,1,0,1,6,5,2,10,20,24,10,5,5,1
S01009634,Bad health,26,0,0,0,1,0,2,2,4,11,6,4,2,0
S01009634,Very bad health,7,0,0,0,0,1,0,1,1,3,1,1,0,0
S01009635,All people aged 16 to 74,654,17,2,15,87,58,38,68,172,133,39,20,19,42
S01009635,Very good health,279,8,1,7,34,23,23,32,70,43,17,5,12,29
S01009635,Good health,220,5,0,5,37,25,10,21,57,45,9,4,5,11
S01009635,Fair health,91,4,1,3,11,6,2,5,32,22,7,5,2,2
S01009635,Bad health,48,0,0,0,4,3,2,8,12,14,5,5,0,0
S01009635,Very bad health,16,0,0,0,1,1,1,2,1,9,1,1,0,0
S01009636,All people aged 16 to 74,693,12,5,7,52,56,42,76,168,136,118,70,48,33
S01009636,Very good health,243,5,2,3,17,23,13,24,58,42,40,24,16,21
S01009636,Good health,258,5,1,4,24,18,16,33,62,50,43,24,19,7
S01009636,Fair health,140,2,2,0,6,10,8,15,36,34,26,13,13,3
S01009636,Bad health,39,0,0,0,4,4,3,4,8,8,7,7,0,1
S01009636,Very bad health,13,0,0,0,1,1,2,0,4,2,2,2,0,1
S01009637,All people aged 16 to 74,548,19,3,16,78,59,35,64,133,97,32,23,9,31
S01009637,Very good health,233,11,1,10,43,24,13,24,54,30,11,8,3,23
S01009637,Good health,178,4,1,3,22,26,11,22,46,30,10,7,3,7
S01009637,Fair health,94,2,0,2,7,7,9,9,23,29,8,6,2,0
S01009637,Bad health,30,2,1,1,4,1,2,2,10,7,1,1,0,1
S01009637,Very bad health,13,0,0,0,2,1,0,7,0,1,2,1,1,0
S01009638,All people aged 16 to 74,514,12,6,6,54,27,26,48,114,112,75,47,28,46
S01009638,Very good health,217,6,1,5,29,9,10,19,46,38,22,12,10,38
S01009638,Good health,155,1,1,0,17,11,11,8,36,33,30,17,13,8
S01009638,Fair health,93,4,3,1,4,4,3,14,24,24,16,11,5,0
S01009638,Bad health,40,1,1,0,3,3,2,5,7,12,7,7,0,0
S01009638,Very bad health,9,0,0,0,1,0,0,2,1,5,0,0,0,0
S01009639,All people aged 16 to 74,560,57,9,48,159,73,47,43,64,46,29,19,10,42
S01009639,Very good health,266,28,5,23,85,32,18,16,26,21,6,2,4,34
S01009639,Good health,209,22,3,19,59,30,21,21,23,15,11,7,4,7
S01009639,Fair health,64,4,0,4,13,9,7,6,11,5,8,7,1,1
S01009639,Bad health,19,3,1,2,1,2,1,0,4,5,3,2,1,0
S01009639,Very bad health,2,0,0,0,1,0,0,0,0,0,1,1,0,0
S01009640,All people aged 16 to 74,420,13,1,12,65,48,14,44,100,79,28,21,7,29
S01009640,Very good health,163,7,1,6,33,18,6,18,35,17,8,5,3,21
S01009640,Good health,134,4,0,4,16,23,5,11,36,23,10,7,3,6
S01009640,Fair health,69,1,0,1,11,5,1,7,18,22,3,2,1,1
S01009640,Bad health,41,0,0,0,2,2,2,8,7,15,4,4,0,1
S01009640,Very bad health,13,1,0,1,3,0,0,0,4,2,3,3,0,0
S01009641,All people aged 16 to 74,563,19,1,18,99,82,42,56,107,95,42,22,20,21
S01009641,Very good health,214,7,0,7,43,35,21,23,42,25,6,2,4,12
S01009641,Good health,195,10,1,9,29,23,15,17,41,36,16,6,10,8
S01009641,Fair health,100,1,0,1,20,17,4,9,16,20,12,7,5,1
S01009641,Bad health,44,1,0,1,6,4,1,6,8,11,7,6,1,0
S01009641,Very bad health,10,0,0,0,1,3,1,1,0,3,1,1,0,0
S01009642,All people aged 16 to 74,706,29,6,23,140,99,44,79,126,104,40,27,13,45
S01009642,Very good health,332,18,2,16,77,40,27,29,55,34,14,6,8,38
S01009642,Good health,230,10,3,7,42,40,11,23,44,45,9,7,2,6
S01009642,Fair health,107,1,1,0,15,16,6,19,21,15,13,10,3,1
S01009642,Bad health,25,0,0,0,3,3,0,6,6,5,2,2,0,0
S01009642,Very bad health,12,0,0,0,3,0,0,2,0,5,2,2,0,0
S01009643,All people aged 16 to 74,419,28,9,19,107,63,21,43,89,35,10,5,5,23
S01009643,Very good health,247,19,4,15,73,34,9,20,50,19,6,4,2,17
S01009643,Good health,139,8,5,3,26,24,10,18,34,13,2,0,2,4
S01009643,Fair health,28,1,0,1,8,5,1,5,3,2,2,1,1,1
S01009643,Bad health,3,0,0,0,0,0,1,0,1,1,0,0,0,0
S01009643,Very bad health,2,0,0,0,0,0,0,0,1,0,0,0,0,1
S01009644,All people aged 16 to 74,604,28,4,24,78,67,29,65,128,128,39,27,12,42
S01009644,Very good health,260,19,2,17,42,35,9,29,53,41,5,2,3,27
S01009644,Good health,208,8,2,6,26,18,11,29,49,46,10,6,4,11
S01009644,Fair health,89,0,0,0,6,12,8,4,18,24,13,10,3,4
S01009644,Bad health,37,1,0,1,4,1,1,1,7,12,10,8,2,0
S01009644,Very bad health,10,0,0,0,0,1,0,2,1,5,1,1,0,0
S01009645,All people aged 16 to 74,474,10,2,8,65,59,35,55,103,100,23,16,7,24
S01009645,Very good health,213,6,1,5,31,33,16,22,44,36,7,5,2,18
S01009645,Good health,160,1,0,1,28,20,14,17,36,31,8,5,3,5
S01009645,Fair health,69,3,1,2,4,3,3,11,16,21,7,5,2,1
S01009645,Bad health,26,0,0,0,2,2,2,4,5,10,1,1,0,0
S01009645,Very bad health,6,0,0,0,0,1,0,1,2,2,0,0,0,0
S01009646,All people aged 16 to 74,430,8,0,8,58,35,33,44,109,82,30,20,10,31
S01009646,Very good health,192,4,0,4,24,14,11,17,53,27,16,11,5,26
S01009646,Good health,142,3,0,3,24,13,13,14,35,30,7,4,3,3
S01009646,Fair health,62,1,0,1,8,5,5,8,16,13,4,2,2,2
S01009646,Bad health,28,0,0,0,2,3,2,4,4,11,2,2,0,0
S01009646,Very bad health,6,0,0,0,0,0,2,1,1,1,1,1,0,0
S01009647,All people aged 16 to 74,424,8,2,6,58,40,28,33,105,83,38,17,21,31
S01009647,Very good health,174,6,2,4,30,21,10,5,40,25,12,5,7,25
S01009647,Good health,130,1,0,1,15,9,12,13,35,28,12,3,9,5
S01009647,Fair health,86,0,0,0,10,9,6,12,20,22,7,4,3,0
S01009647,Bad health,26,1,0,1,3,1,0,1,8,4,7,5,2,1
S01009647,Very bad health,8,0,0,0,0,0,0,2,2,4,0,0,0,0
S01009648,All people aged 16 to 74,627,12,2,10,90,70,43,83,142,109,37,20,17,41
S01009648,Very good health,254,6,2,4,42,31,13,33,50,43,12,6,6,24
S01009648,Good health,227,6,0,6,33,25,19,33,52,37,12,7,5,10
S01009648,Fair health,101,0,0,0,12,12,5,9,25,25,8,4,4,5
S01009648,Bad health,41,0,0,0,3,2,4,8,13,4,5,3,2,2
S01009648,Very bad health,4,0,0,0,0,0,2,0,2,0,0,0,0,0
S01009649,All people aged 16 to 74,793,29,10,19,154,100,40,79,177,116,50,32,18,48
S01009649,Very good health,374,18,6,12,93,54,18,31,68,38,18,13,5,36
S01009649,Good health,247,7,2,5,35,31,15,33,59,38,19,12,7,10
S01009649,Fair health,109,3,2,1,21,11,4,8,32,22,6,2,4,2
S01009649,Bad health,48,0,0,0,4,3,2,6,14,12,7,5,2,0
S01009649,Very bad health,15,1,0,1,1,1,1,1,4,6,0,0,0,0
S01009650,All people aged 16 to 74,565,42,9,33,173,93,50,49,79,45,6,3,3,28
S01009650,Very good health,311,23,6,17,90,56,25,34,35,21,2,1,1,25
S01009650,Good health,180,15,3,12,63,27,17,10,32,13,1,1,0,2
S01009650,Fair health,60,3,0,3,16,10,8,4,9,7,2,1,1,1
S01009650,Bad health,8,0,0,0,2,0,0,0,3,2,1,0,1,0
S01009650,Very bad health,6,1,0,1,2,0,0,1,0,2,0,0,0,0
S01009651,All people aged 16 to 74,682,74,7,67,188,68,98,48,92,61,16,7,9,37
S01009651,Very good health,333,44,2,42,108,33,39,20,38,24,5,3,2,22
S01009651,Good health,231,23,3,20,68,21,39,19,25,20,5,2,3,11
S01009651,Fair health,80,5,1,4,9,12,13,7,17,9,5,1,4,3
S01009651,Bad health,28,1,0,1,3,2,6,1,7,6,1,1,0,1
S01009651,Very bad health,10,1,1,0,0,0,1,1,5,2,0,0,0,0
S01009652,All people aged 16 to 74,538,90,13,77,156,67,70,28,57,33,5,3,2,32
S01009652,Very good health,259,45,2,43,73,28,37,12,21,14,1,1,0,28
S01009652,Good health,208,41,10,31,64,24,22,11,25,15,2,1,1,4
S01009652,Fair health,50,3,1,2,15,11,6,2,8,3,2,1,1,0
S01009652,Bad health,16,0,0,0,2,3,4,3,3,1,0,0,0,0
S01009652,Very bad health,5,1,0,1,2,1,1,0,0,0,0,0,0,0
S01009653,All people aged 16 to 74,389,51,17,34,117,46,40,33,48,29,6,6,0,19
S01009653,Very good health,207,30,11,19,64,24,19,18,23,11,3,3,0,15
S01009653,Good health,141,17,5,12,44,20,13,14,16,12,1,1,0,4
S01009653,Fair health,28,4,1,3,8,1,5,1,5,3,1,1,0,0
S01009653,Bad health,9,0,0,0,1,1,2,0,4,1,0,0,0,0
S01009653,Very bad health,4,0,0,0,0,0,1,0,0,2,1,1,0,0
S01009654,All people aged 16 to 74,408,31,4,27,104,50,41,33,60,50,10,3,7,29
S01009654,Very good health,208,20,3,17,54,25,21,16,25,22,2,1,1,23
S01009654,Good health,126,8,1,7,36,17,19,8,20,13,4,0,4,1
S01009654,Fair health,50,3,0,3,11,8,1,3,6,10,4,2,2,4
S01009654,Bad health,17,0,0,0,2,0,0,3,8,4,0,0,0,0
S01009654,Very bad health,7,0,0,0,1,0,0,3,1,1,0,0,0,1
S01009655,All people aged 16 to 74,641,14,2,12,70,46,31,69,172,153,43,28,15,43
S01009655,Very good health,282,3,0,3,31,21,8,31,76,61,18,9,9,33
S01009655,Good health,197,6,0,6,20,18,17,26,48,43,11,7,4,8
S01009655,Fair health,109,3,1,2,11,6,4,5,35,31,12,10,2,2
S01009655,Bad health,39,0,0,0,4,0,2,6,10,15,2,2,0,0
S01009655,Very bad health,14,2,1,1,4,1,0,1,3,3,0,0,0,0
S01009656,All people aged 16 to 74,529,14,6,8,45,29,30,59,128,136,65,40,25,23
S01009656,Very good health,177,6,1,5,24,9,14,12,44,36,14,6,8,18
S01009656,Good health,176,4,3,1,16,11,9,21,43,44,26,17,9,2
S01009656,Fair health,104,2,0,2,3,6,4,14,30,29,14,6,8,2
S01009656,Bad health,57,2,2,0,2,3,3,8,9,20,9,9,0,1
S01009656,Very bad health,15,0,0,0,0,0,0,4,2,7,2,2,0,0
S01009657,All people aged 16 to 74,599,30,7,23,111,74,48,71,111,74,36,20,16,44
S01009657,Very good health,275,19,5,14,60,37,18,29,46,24,8,4,4,34
S01009657,Good health,225,9,1,8,36,27,23,31,45,28,17,8,9,9
S01009657,Fair health,80,2,1,1,10,7,6,8,18,18,10,7,3,1
S01009657,Bad health,14,0,0,0,4,3,0,3,2,2,0,0,0,0
S01009657,Very bad health,5,0,0,0,1,0,1,0,0,2,1,1,0,0
S01009658,All people aged 16 to 74,535,11,3,8,74,54,26,50,142,113,39,29,10,26
S01009658,Very good health,226,5,2,3,35,27,9,26,54,34,15,11,4,21
S01009658,Good health,170,4,0,4,21,15,10,17,53,36,9,5,4,5
S01009658,Fair health,89,1,0,1,10,7,6,5,21,32,7,5,2,0
S01009658,Bad health,38,0,0,0,8,4,0,1,11,7,7,7,0,0
S01009658,Very bad health,12,1,1,0,0,1,1,1,3,4,1,1,0,0
S01009659,All people aged 16 to 74,384,15,3,12,58,40,28,35,81,73,31,16,15,23
S01009659,Very good health,154,5,0,5,24,16,10,12,27,30,12,6,6,18
S01009659,Good health,139,7,2,5,21,15,11,13,37,20,12,4,8,3
S01009659,Fair health,65,2,0,2,11,8,5,9,10,12,6,5,1,2
S01009659,Bad health,20,0,0,0,1,1,1,1,7,8,1,1,0,0
S01009659,Very bad health,6,1,1,0,1,0,1,0,0,3,0,0,0,0
S01009660,All people aged 16 to 74,795,27,5,22,140,96,39,72,197,131,38,29,9,55
S01009660,Very good health,354,14,2,12,75,47,14,30,74,51,9,8,1,40
S01009660,Good health,252,11,3,8,39,31,16,25,74,31,11,8,3,14
S01009660,Fair health,126,2,0,2,15,13,8,12,31,31,13,9,4,1
S01009660,Bad health,49,0,0,0,9,2,1,5,16,11,5,4,1,0
S01009660,Very bad health,14,0,0,0,2,3,0,0,2,7,0,0,0,0
S01009661,All people aged 16 to 74,640,78,24,54,172,65,111,43,65,49,14,7,7,43
S01009661,Very good health,341,50,13,37,96,38,60,19,26,18,2,0,2,32
S01009661,Good health,207,25,9,16,54,18,38,14,25,16,6,3,3,11
S01009661,Fair health,73,3,2,1,17,7,8,8,12,12,6,4,2,0
S01009661,Bad health,19,0,0,0,5,2,5,2,2,3,0,0,0,0
S01009661,Very bad health,0,0,0,0,0,0,0,0,0,0,0,0,0,0
S01009662,All people aged 16 to 74,552,49,15,34,126,71,68,51,77,58,16,9,7,36
S01009662,Very good health,270,28,8,20,64,41,32,19,30,26,7,5,2,23
S01009662,Good health,204,18,6,12,50,21,24,26,26,21,5,1,4,13
S01009662,Fair health,53,3,1,2,5,8,9,4,16,5,3,3,0,0
S01009662,Bad health,23,0,0,0,7,1,3,2,4,5,1,0,1,0
S01009662,Very bad health,2,0,0,0,0,0,0,0,1,1,0,0,0,0
S01009663,All people aged 16 to 74,492,59,12,47,136,51,35,48,67,38,17,8,9,41
S01009663,Very good health,242,32,6,26,70,26,15,21,25,17,3,1,2,33
S01009663,Good health,172,21,6,15,52,17,13,16,28,12,7,1,6,6
S01009663,Fair health,49,6,0,6,9,5,7,5,8,3,4,3,1,2
S01009663,Bad health,24,0,0,0,4,3,0,5,5,5,2,2,0,0
S01009663,Very bad health,5,0,0,0,1,0,0,1,1,1,1,1,0,0
S01009664,All people aged 16 to 74,688,104,26,78,149,91,86,45,91,61,25,15,10,36
S01009664,Very good health,374,66,18,48,87,50,42,24,37,32,10,7,3,26
S01009664,Good health,236,29,2,27,48,33,35,15,38,18,12,6,6,8
S01009664,Fair health,60,7,4,3,10,8,7,4,10,10,3,2,1,1
S01009664,Bad health,17,1,1,0,4,0,2,2,6,1,0,0,0,1
S01009664,Very bad health,1,1,1,0,0,0,0,0,0,0,0,0,0,0
S01009665,All people aged 16 to 74,475,42,16,26,100,52,45,39,75,76,20,13,7,26
S01009665,Very good health,234,33,16,17,54,25,16,14,36,36,5,3,2,15
S01009665,Good health,173,6,0,6,31,20,21,21,31,26,8,4,4,9
S01009665,Fair health,50,2,0,2,11,6,5,2,7,11,4,3,1,2
S01009665,Bad health,14,1,0,1,3,1,3,2,1,2,1,1,0,0
S01009665,Very bad health,4,0,0,0,1,0,0,0,0,1,2,2,0,0
S01009666,All people aged 16 to 74,561,43,13,30,136,67,66,45,75,72,22,11,11,35
S01009666,Very good health,257,26,5,21,62,28,27,21,29,29,12,6,6,23
S01009666,Good health,204,15,7,8,53,29,27,13,27,25,7,3,4,8
S01009666,Fair health,63,2,1,1,14,8,5,7,10,12,2,1,1,3
S01009666,Bad health,29,0,0,0,6,2,6,3,7,3,1,1,0,1
S01009666,Very bad health,8,0,0,0,1,0,1,1,2,3,0,0,0,0
S01009667,All people aged 16 to 74,384,50,12,38,114,52,47,29,47,24,1,1,0,20
S01009667,Very good health,227,34,9,25,67,28,30,14,25,13,0,0,0,16
S01009667,Good health,113,10,3,7,37,20,11,10,14,7,0,0,0,4
S01009667,Fair health,32,4,0,4,6,2,6,4,7,2,1,1,0,0
S01009667,Bad health,10,2,0,2,3,2,0,1,0,2,0,0,0,0
S01009667,Very bad health,2,0,0,0,1,0,0,0,1,0,0,0,0,0
S01009668,All people aged 16 to 74,421,48,11,37,126,55,33,40,46,33,11,5,6,29
S01009668,Very good health,238,26,5,21,79,31,18,19,21,19,5,3,2,20
S01009668,Good health,139,16,5,11,38,19,13,14,17,9,5,1,4,8
S01009668,Fair health,35,4,1,3,7,4,2,6,5,5,1,1,0,1
S01009668,Bad health,8,2,0,2,2,1,0,1,2,0,0,0,0,0
S01009668,Very bad health,1,0,0,0,0,0,0,0,1,0,0,0,0,0
S01009669,All people aged 16 to 74,361,40,6,34,87,46,42,40,50,37,5,2,3,14
S01009669,Very good health,174,21,2,19,50,23,18,20,14,14,2,0,2,12
S01009669,Good health,136,13,3,10,31,16,17,14,27,15,1,0,1,2
S01009669,Fair health,42,5,1,4,6,6,6,5,7,5,2,2,0,0
S01009669,Bad health,7,1,0,1,0,0,1,0,2,3,0,0,0,0
S01009669,Very bad health,2,0,0,0,0,1,0,1,0,0,0,0,0,0
S01009670,All people aged 16 to 74,586,79,21,58,150,54,52,39,81,59,23,15,8,49
S01009670,Very good health,320,44,11,33,85,27,29,20,39,26,9,7,2,41
S01009670,Good health,182,26,10,16,54,20,17,13,24,15,8,4,4,5
S01009670,Fair health,63,7,0,7,8,5,3,5,15,14,4,2,2,2
S01009670,Bad health,15,2,0,2,1,2,3,0,2,3,1,1,0,1
S01009670,Very bad health,6,0,0,0,2,0,0,1,1,1,1,1,0,0
S01009671,All people aged 16 to 74,485,54,13,41,132,56,57,33,69,33,6,2,4,45
S01009671,Very good health,237,27,6,21,58,26,35,14,30,11,3,1,2,33
S01009671,Good health,190,23,7,16,59,22,17,15,28,14,1,0,1,11
S01009671,Fair health,47,3,0,3,14,8,4,3,5,7,2,1,1,1
S01009671,Bad health,9,1,0,1,1,0,1,1,4,1,0,0,0,0
S01009671,Very bad health,2,0,0,0,0,0,0,0,2,0,0,0,0,0
S01009672,All people aged 16 to 74,581,37,13,24,95,76,51,60,119,100,23,17,6,20
S01009672,Very good health,236,16,4,12,47,27,20,27,41,33,11,8,3,14
S01009672,Good health,219,17,8,9,33,31,15,22,48,40,8,5,3,5
S01009672,Fair health,83,3,1,2,11,11,11,7,19,16,4,4,0,1
S01009672,Bad health,33,1,0,1,3,6,3,3,8,9,0,0,0,0
S01009672,Very bad health,10,0,0,0,1,1,2,1,3,2,0,0,0,0
S01009673,All people aged 16 to 74,590,59,20,39,135,68,70,43,82,74,23,16,7,36
S01009673,Very good health,285,29,9,20,75,27,28,24,29,41,9,6,3,23
S01009673,Good health,217,22,7,15,44,33,28,15,34,22,10,6,4,9
S01009673,Fair health,61,7,3,4,10,6,10,2,12,7,4,4,0,3
S01009673,Bad health,19,0,0,0,4,1,2,1,6,4,0,0,0,1
S01009673,Very bad health,8,1,1,0,2,1,2,1,1,0,0,0,0,0
S01009674,All people aged 16 to 74,651,90,23,67,172,74,76,47,71,69,17,9,8,35
S01009674,Very good health,342,56,13,43,99,38,36,25,28,29,4,2,2,27
S01009674,Good health,215,28,8,20,51,25,31,17,27,25,5,4,1,6
S01009674,Fair health,61,0,0,0,16,8,5,4,12,10,5,1,4,1
S01009674,Bad health,30,6,2,4,5,2,4,1,4,5,2,1,1,1
S01009674,Very bad health,3,0,0,0,1,1,0,0,0,0,1,1,0,0
S01009675,All people aged 16 to 74,682,82,23,59,178,98,68,48,76,64,17,10,7,51
S01009675,Very good health,342,45,16,29,92,44,35,23,33,23,8,5,3,39
S01009675,Good health,242,29,6,23,72,36,29,16,27,19,4,1,3,10
S01009675,Fair health,79,5,1,4,13,14,3,6,12,19,5,4,1,2
S01009675,Bad health,15,2,0,2,1,4,0,3,4,1,0,0,0,0
S01009675,Very bad health,4,1,0,1,0,0,1,0,0,2,0,0,0,0
S01009676,All people aged 16 to 74,585,53,17,36,143,65,69,56,88,71,14,8,6,26
S01009676,Very good health,271,31,7,24,73,35,32,22,41,21,2,2,0,14
S01009676,Good health,227,17,9,8,50,27,31,22,31,29,8,3,5,12
S01009676,Fair health,65,4,1,3,14,3,4,8,15,14,3,2,1,0
S01009676,Bad health,18,1,0,1,5,0,1,4,1,5,1,1,0,0
S01009676,Very bad health,4,0,0,0,1,0,1,0,0,2,0,0,0,0
S01009677,All people aged 16 to 74,446,65,12,53,105,44,79,29,63,20,11,5,6,30
S01009677,Very good health,231,37,7,30,61,18,35,14,27,11,5,2,3,23
S01009677,Good health,142,19,3,16,33,20,26,9,19,6,5,2,3,5
S01009677,Fair health,52,7,2,5,7,5,13,6,11,2,0,0,0,1
S01009677,Bad health,15,2,0,2,3,1,4,0,4,0,0,0,0,1
S01009677,Very bad health,6,0,0,0,1,0,1,0,2,1,1,1,0,0
S01009678,All people aged 16 to 74,442,34,6,28,69,54,42,58,79,76,6,4,2,24
S01009678,Very good health,227,22,3,19,31,30,18,27,41,31,4,3,1,23
S01009678,Good health,140,11,2,9,26,19,16,17,25,24,1,0,1,1
S01009678,Fair health,59,0,0,0,8,4,8,11,9,18,1,1,0,0
S01009678,Bad health,13,1,1,0,3,1,0,2,3,3,0,0,0,0
S01009678,Very bad health,3,0,0,0,1,0,0,1,1,0,0,0,0,0
S01009679,All people aged 16 to 74,676,30,7,23,149,79,57,60,116,113,38,20,18,34
S01009679,Very good health,292,11,3,8,72,36,27,25,51,36,14,8,6,20
S01009679,Good health,248,15,4,11,47,32,19,27,40,48,10,4,6,10
S01009679,Fair health,90,4,0,4,19,6,6,5,15,19,12,7,5,4
S01009679,Bad health,37,0,0,0,10,4,3,1,10,8,1,0,1,0
S01009679,Very bad health,9,0,0,0,1,1,2,2,0,2,1,1,0,0
S01009680,All people aged 16 to 74,606,40,11,29,118,64,53,69,126,79,30,16,14,27
S01009680,Very good health,294,20,5,15,62,32,25,41,52,32,7,5,2,23
S01009680,Good health,223,13,4,9,43,26,23,19,48,32,15,7,8,4
S01009680,Fair health,67,5,0,5,12,3,3,8,19,10,7,3,4,0
S01009680,Bad health,17,1,1,0,1,1,2,1,6,4,1,1,0,0
S01009680,Very bad health,5,1,1,0,0,2,0,0,1,1,0,0,0,0
S01009681,All people aged 16 to 74,530,33,7,26,109,54,37,52,78,91,43,34,9,33
S01009681,Very good health,220,23,5,18,46,27,14,30,28,26,4,2,2,22
S01009681,Good health,171,5,2,3,37,17,13,15,32,29,13,11,2,10
S01009681,Fair health,101,3,0,3,20,8,7,3,14,23,22,17,5,1
S01009681,Bad health,31,1,0,1,4,2,2,3,4,11,4,4,0,0
S01009681,Very bad health,7,1,0,1,2,0,1,1,0,2,0,0,0,0
S01009682,All people aged 16 to 74,458,45,6,39,151,67,28,35,67,36,11,6,5,18
S01009682,Very good health,233,22,4,18,83,35,14,17,35,13,1,1,0,13
S01009682,Good health,171,17,1,16,54,21,12,14,23,20,5,2,3,5
S01009682,Fair health,42,4,1,3,11,9,2,3,8,2,3,1,2,0
S01009682,Bad health,8,1,0,1,3,0,0,0,1,1,2,2,0,0
S01009682,Very bad health,4,1,0,1,0,2,0,1,0,0,0,0,0,0
S01009683,All people aged 16 to 74,608,81,15,66,177,63,33,40,56,43,18,12,6,97
S01009683,Very good health,337,53,9,44,103,32,13,21,29,17,5,3,2,64
S01009683,Good health,201,21,3,18,59,25,14,13,20,13,10,7,3,26
S01009683,Fair health,58,5,3,2,10,6,6,5,7,9,3,2,1,7
S01009683,Bad health,10,2,0,2,3,0,0,1,0,4,0,0,0,0
S01009683,Very bad health,2,0,0,0,2,0,0,0,0,0,0,0,0,0
S01009684,All people aged 16 to 74,793,114,28,86,227,100,98,41,82,48,23,16,7,60
S01009684,Very good health,477,79,19,60,137,61,53,27,43,20,9,7,2,48
S01009684,Good health,240,33,7,26,71,32,37,10,24,17,7,4,3,9
S01009684,Fair health,58,2,2,0,17,5,5,3,12,6,6,4,2,2
S01009684,Bad health,13,0,0,0,1,2,3,1,2,3,0,0,0,1
S01009684,Very bad health,5,0,0,0,1,0,0,0,1,2,1,1,0,0
S01009685,All people aged 16 to 74,458,28,7,21,100,52,37,52,73,66,18,12,6,32
S01009685,Very good health,199,16,5,11,49,14,17,20,26,24,9,6,3,24
S01009685,Good health,187,12,2,10,40,28,16,24,28,30,3,1,2,6
S01009685,Fair health,49,0,0,0,6,5,3,6,14,9,5,4,1,1
S01009685,Bad health,17,0,0,0,4,3,0,2,5,1,1,1,0,1
S01009685,Very bad health,6,0,0,0,1,2,1,0,0,2,0,0,0,0
S01009686,All people aged 16 to 74,816,69,8,61,164,72,42,72,150,111,34,21,13,102
S01009686,Very good health,431,44,5,39,84,40,18,36,74,51,13,10,3,71
S01009686,Good health,248,17,3,14,51,26,17,21,48,29,10,6,4,29
S01009686,Fair health,99,7,0,7,17,4,6,9,23,24,8,4,4,1
S01009686,Bad health,33,1,0,1,9,2,0,5,5,7,3,1,2,1
S01009686,Very bad health,5,0,0,0,3,0,1,1,0,0,0,0,0,0
S01009687,All people aged 16 to 74,523,33,5,28,131,77,34,43,72,74,25,13,12,34
S01009687,Very good health,285,23,2,21,80,36,19,17,37,34,15,9,6,24
S01009687,Good health,160,7,3,4,36,27,10,17,27,23,6,1,5,7
S01009687,Fair health,58,3,0,3,9,12,3,7,5,13,3,2,1,3
S01009687,Bad health,16,0,0,0,3,2,2,2,3,3,1,1,0,0
S01009687,Very bad health,4,0,0,0,3,0,0,0,0,1,0,0,0,0
S01009688,All people aged 16 to 74,636,20,4,16,82,59,29,70,143,130,55,38,17,48
S01009688,Very good health,264,12,2,10,37,26,14,26,59,46,20,13,7,24
S01009688,Good health,241,7,2,5,25,26,8,29,57,55,15,8,7,19
S01009688,Fair health,92,0,0,0,12,3,6,11,23,21,13,11,2,3
S01009688,Bad health,25,1,0,1,5,3,0,2,2,6,5,5,0,1
S01009688,Very bad health,14,0,0,0,3,1,1,2,2,2,2,1,1,1
S01009689,All people aged 16 to 74,452,47,8,39,86,41,32,42,72,57,23,13,10,52
S01009689,Very good health,229,33,5,28,55,17,18,18,28,22,6,2,4,32
S01009689,Good health,150,11,3,8,21,16,10,15,30,21,8,6,2,18
S01009689,Fair health,57,1,0,1,8,8,3,7,11,12,5,3,2,2
S01009689,Bad health,14,2,0,2,1,0,1,1,3,2,4,2,2,0
S01009689,Very bad health,2,0,0,0,1,0,0,1,0,0,0,0,0,0
S01009690,All people aged 16 to 74,531,58,7,51,128,58,31,43,86,62,29,17,12,36
S01009690,Very good health,259,28,5,23,73,29,15,16,37,19,11,8,3,31
S01009690,Good health,202,21,2,19,42,23,12,20,39,31,10,6,4,4
S01009690,Fair health,47,5,0,5,7,4,3,4,8,8,8,3,5,0
S01009690,Bad health,20,4,0,4,4,2,1,2,2,4,0,0,0,1
S01009690,Very bad health,3,0,0,0,2,0,0,1,0,0,0,0,0,0
S01009691,All people aged 16 to 74,424,48,8,40,126,61,31,24,56,31,10,6,4,37
S01009691,Very good health,243,26,4,22,73,34,15,16,26,18,3,2,1,32
S01009691,Good health,131,17,4,13,35,19,12,6,25,8,5,3,2,4
S01009691,Fair health,42,4,0,4,16,5,4,2,5,5,1,1,0,0
S01009691,Bad health,6,1,0,1,2,2,0,0,0,0,1,0,1,0
S01009691,Very bad health,2,0,0,0,0,1,0,0,0,0,0,0,0,1
S01009692,All people aged 16 to 74,750,80,16,64,197,108,59,56,119,78,15,10,5,38
S01009692,Very good health,372,49,10,39,89,46,28,25,59,42,8,4,4,26
S01009692,Good health,268,27,5,22,80,49,20,20,38,19,5,4,1,10
S01009692,Fair health,88,3,1,2,23,7,11,8,19,14,1,1,0,2
S01009692,Bad health,16,1,0,1,4,6,0,1,2,2,0,0,0,0
S01009692,Very bad health,6,0,0,0,1,0,0,2,1,1,1,1,0,0
S01009693,All people aged 16 to 74,461,53,13,40,131,71,32,42,60,26,9,5,4,37
S01009693,Very good health,242,32,9,23,62,44,14,18,30,11,2,1,1,29
S01009693,Good health,158,16,3,13,56,17,11,18,21,10,3,2,1,6
S01009693,Fair health,38,5,1,4,7,7,5,3,5,2,3,2,1,1
S01009693,Bad health,17,0,0,0,6,2,0,3,2,3,1,0,1,0
S01009693,Very bad health,6,0,0,0,0,1,2,0,2,0,0,0,0,1
S01009694,All people aged 16 to 74,694,109,22,87,185,106,42,38,104,54,10,9,1,46
S01009694,Very good health,346,64,13,51,90,48,24,14,50,14,2,1,1,40
S01009694,Good health,245,35,6,29,72,39,7,18,42,23,5,5,0,4
S01009694,Fair health,81,8,2,6,16,16,11,5,8,12,3,3,0,2
S01009694,Bad health,15,1,1,0,4,3,0,1,3,3,0,0,0,0
S01009694,Very bad health,7,1,0,1,3,0,0,0,1,2,0,0,0,0
S01009695,All people aged 16 to 74,463,64,13,51,122,54,71,26,44,51,10,5,5,21
S01009695,Very good health,255,45,10,35,66,28,42,10,20,25,3,1,2,16
S01009695,Good health,149,13,2,11,44,15,21,14,18,15,4,2,2,5
S01009695,Fair health,48,6,1,5,11,6,6,2,5,10,2,1,1,0
S01009695,Bad health,8,0,0,0,0,3,2,0,1,1,1,1,0,0
S01009695,Very bad health,3,0,0,0,1,2,0,0,0,0,0,0,0,0
S01009696,All people aged 16 to 74,698,122,26,96,192,71,83,43,88,38,27,17,10,34
S01009696,Very good health,368,67,17,50,108,35,49,20,33,19,11,7,4,26
S01009696,Good health,235,44,7,37,68,21,22,17,31,17,7,4,3,8
S01009696,Fair health,73,8,2,6,11,12,7,4,20,2,9,6,3,0
S01009696,Bad health,15,1,0,1,4,2,3,2,3,0,0,0,0,0
S01009696,Very bad health,7,2,0,2,1,1,2,0,1,0,0,0,0,0
S01009697,All people aged 16 to 74,525,94,15,79,139,52,65,40,53,46,9,4,5,27
S01009697,Very good health,245,50,5,45,80,20,26,10,24,11,4,0,4,20
S01009697,Good health,208,31,6,25,47,23,28,22,22,24,4,3,1,7
S01009697,Fair health,52,8,3,5,10,7,11,3,6,7,0,0,0,0
S01009697,Bad health,14,3,0,3,2,2,0,3,1,3,0,0,0,0
S01009697,Very bad health,6,2,1,1,0,0,0,2,0,1,1,1,0,0
S01009698,All people aged 16 to 74,458,58,16,42,123,36,86,34,48,28,6,5,1,39
S01009698,Very good health,255,37,11,26,65,21,40,16,27,13,4,3,1,32
S01009698,Good health,143,18,5,13,36,11,35,13,13,10,1,1,0,6
S01009698,Fair health,39,2,0,2,15,3,7,2,5,5,0,0,0,0
S01009698,Bad health,18,1,0,1,5,1,4,3,2,0,1,1,0,1
S01009698,Very bad health,3,0,0,0,2,0,0,0,1,0,0,0,0,0
S01009699,All people aged 16 to 74,330,46,14,32,70,38,49,26,46,30,10,9,1,15
S01009699,Very good health,150,20,5,15,38,14,23,16,16,6,6,6,0,11
S01009699,Good health,131,19,9,10,21,19,23,7,21,15,2,1,1,4
S01009699,Fair health,33,6,0,6,8,4,0,2,7,5,1,1,0,0
S01009699,Bad health,9,0,0,0,3,1,2,0,1,2,0,0,0,0
S01009699,Very bad health,7,1,0,1,0,0,1,1,1,2,1,1,0,0
S01009700,All people aged 16 to 74,488,37,5,32,96,44,69,47,78,66,13,8,5,38
S01009700,Very good health,250,21,3,18,52,21,34,24,36,24,6,4,2,32
S01009700,Good health,150,11,1,10,31,15,25,13,26,19,5,2,3,5
S01009700,Fair health,61,3,1,2,10,6,7,9,9,16,1,1,0,0
S01009700,Bad health,24,2,0,2,3,1,2,1,7,6,1,1,0,1
S01009700,Very bad health,3,0,0,0,0,1,1,0,0,1,0,0,0,0
S01009701,All people aged 16 to 74,286,42,10,32,86,29,34,20,32,17,7,4,3,19
S01009701,Very good health,165,22,6,16,56,16,17,15,16,8,1,0,1,14
S01009701,Good health,79,15,3,12,21,6,15,4,6,5,3,1,2,4
S01009701,Fair health,27,4,1,3,5,6,1,0,6,3,1,1,0,1
S01009701,Bad health,14,1,0,1,3,1,1,1,4,1,2,2,0,0
S01009701,Very bad health,1,0,0,0,1,0,0,0,0,0,0,0,0,0
S01009702,All people aged 16 to 74,472,67,10,57,101,41,84,39,58,39,7,4,3,36
S01009702,Very good health,235,39,5,34,45,14,45,16,24,19,1,1,0,32
S01009702,Good health,164,22,3,19,39,20,24,16,21,14,5,3,2,3
S01009702,Fair health,52,6,2,4,13,4,12,3,9,4,1,0,1,0
S01009702,Bad health,13,0,0,0,2,2,2,2,3,1,0,0,0,1
S01009702,Very bad health,8,0,0,0,2,1,1,2,1,1,0,0,0,0
S01009703,All people aged 16 to 74,414,30,7,23,78,48,55,50,69,58,9,4,5,17
S01009703,Very good health,201,17,3,14,41,26,23,26,26,25,5,1,4,12
S01009703,Good health,126,7,3,4,29,14,21,13,19,17,2,1,1,4
S01009703,Fair health,59,4,0,4,7,5,9,7,13,11,2,2,0,1
S01009703,Bad health,20,2,1,1,0,2,2,3,7,4,0,0,0,0
S01009703,Very bad health,8,0,0,0,1,1,0,1,4,1,0,0,0,0
S01009704,All people aged 16 to 74,706,59,10,49,170,69,120,59,103,72,17,11,6,37
S01009704,Very good health,354,36,6,30,96,37,48,28,43,35,7,4,3,24
S01009704,Good health,241,12,2,10,51,23,48,15,47,26,7,4,3,12
S01009704,Fair health,81,8,1,7,16,6,19,14,8,7,2,2,0,1
S01009704,Bad health,22,1,1,0,6,2,3,2,4,3,1,1,0,0
S01009704,Very bad health,8,2,0,2,1,1,2,0,1,1,0,0,0,0
S01009705,All people aged 16 to 74,549,19,3,16,98,40,77,62,109,96,20,10,10,28
S01009705,Very good health,239,9,0,9,42,24,34,23,40,44,5,3,2,18
S01009705,Good health,182,6,1,5,37,11,31,22,37,29,4,2,2,5
S01009705,Fair health,96,4,2,2,18,2,10,11,23,15,8,2,6,5
S01009705,Bad health,25,0,0,0,1,3,2,6,8,5,0,0,0,0
S01009705,Very bad health,7,0,0,0,0,0,0,0,1,3,3,3,0,0
S01009706,All people aged 16 to 74,440,44,11,33,83,50,69,39,66,42,16,9,7,31
S01009706,Very good health,226,24,7,17,46,25,31,23,39,16,7,5,2,15
S01009706,Good health,146,12,3,9,25,17,32,11,15,16,7,2,5,11
S01009706,Fair health,45,5,1,4,4,6,5,2,11,6,1,1,0,5
S01009706,Bad health,20,3,0,3,6,2,0,3,1,4,1,1,0,0
S01009706,Very bad health,3,0,0,0,2,0,1,0,0,0,0,0,0,0
S01009707,All people aged 16 to 74,359,42,5,37,92,41,41,34,42,32,13,8,5,22
S01009707,Very good health,183,25,3,22,54,21,18,18,19,11,2,1,1,15
S01009707,Good health,126,14,2,12,29,16,14,15,10,16,6,2,4,6
S01009707,Fair health,34,3,0,3,5,3,5,1,10,3,3,3,0,1
S01009707,Bad health,13,0,0,0,4,1,2,0,2,2,2,2,0,0
S01009707,Very bad health,3,0,0,0,0,0,2,0,1,0,0,0,0,0
S01009708,All people aged 16 to 74,442,50,10,40,87,55,70,34,69,45,7,6,1,25
S01009708,Very good health,222,33,6,27,48,28,30,15,28,18,2,1,1,20
S01009708,Good health,132,12,4,8,25,19,27,13,16,15,1,1,0,4
S01009708,Fair health,55,2,0,2,9,4,8,2,18,8,3,3,0,1
S01009708,Bad health,24,1,0,1,3,3,4,3,5,4,1,1,0,0
S01009708,Very bad health,9,2,0,2,2,1,1,1,2,0,0,0,0,0
S01009709,All people aged 16 to 74,618,56,9,47,113,78,78,65,97,89,20,10,10,22
S01009709,Very good health,285,41,9,32,51,42,28,30,40,35,7,4,3,11
S01009709,Good health,217,12,0,12,40,25,32,23,34,36,8,3,5,7
S01009709,Fair health,83,2,0,2,14,10,13,10,17,12,2,2,0,3
S01009709,Bad health,25,1,0,1,6,1,4,1,5,4,3,1,2,0
S01009709,Very bad health,8,0,0,0,2,0,1,1,1,2,0,0,0,1
S01009710,All people aged 16 to 74,406,30,4,26,83,42,66,46,53,39,14,8,6,33
S01009710,Very good health,224,18,2,16,44,26,32,31,21,15,8,5,3,29
S01009710,Good health,134,9,2,7,31,12,26,13,23,13,3,0,3,4
S01009710,Fair health,30,2,0,2,6,2,6,1,5,6,2,2,0,0
S01009710,Bad health,13,1,0,1,2,1,2,1,1,4,1,1,0,0
S01009710,Very bad health,5,0,0,0,0,1,0,0,3,1,0,0,0,0
S01009711,All people aged 16 to 74,549,38,8,30,82,50,87,42,111,74,26,17,9,39
S01009711,Very good health,261,16,5,11,36,30,36,20,57,32,6,5,1,28
S01009711,Good health,186,14,1,13,36,13,35,14,28,21,17,11,6,8
S01009711,Fair health,64,4,0,4,3,5,9,4,18,17,2,0,2,2
S01009711,Bad health,27,2,2,0,5,2,5,3,5,4,0,0,0,1
S01009711,Very bad health,11,2,0,2,2,0,2,1,3,0,1,1,0,0
S01009712,All people aged 16 to 74,456,39,5,34,100,40,78,49,70,37,20,12,8,23
S01009712,Very good health,202,24,3,21,43,19,27,22,37,10,5,5,0,15
S01009712,Good health,158,11,2,9,39,16,30,19,20,9,8,4,4,6
S01009712,Fair health,64,2,0,2,11,2,16,7,8,12,4,1,3,2
S01009712,Bad health,27,2,0,2,6,3,5,0,3,6,2,1,1,0
S01009712,Very bad health,5,0,0,0,1,0,0,1,2,0,1,1,0,0
S01009713,All people aged 16 to 74,653,71,15,56,147,55,98,59,93,61,24,15,9,45
S01009713,Very good health,291,39,5,34,72,22,35,31,36,23,6,6,0,27
S01009713,Good health,243,23,7,16,55,27,42,15,34,16,15,8,7,16
S01009713,Fair health,88,7,2,5,13,5,15,9,19,16,3,1,2,1
S01009713,Bad health,20,1,0,1,5,0,5,2,3,3,0,0,0,1
S01009713,Very bad health,11,1,1,0,2,1,1,2,1,3,0,0,0,0
S01009714,All people aged 16 to 74,662,100,19,81,161,75,92,52,81,50,12,5,7,39
S01009714,Very good health,328,56,11,45,80,34,40,22,42,23,3,1,2,28
S01009714,Good health,238,36,7,29,57,28,34,23,29,16,6,1,5,9
S01009714,Fair health,74,4,1,3,18,10,14,7,8,8,3,3,0,2
S01009714,Bad health,20,4,0,4,6,3,4,0,1,2,0,0,0,0
S01009714,Very bad health,2,0,0,0,0,0,0,0,1,1,0,0,0,0
S01009715,All people aged 16 to 74,500,88,12,76,107,48,83,34,65,33,12,4,8,30
S01009715,Very good health,242,52,8,44,46,19,38,16,31,15,3,0,3,22
S01009715,Good health,184,25,3,22,47,22,34,12,25,9,3,2,1,7
S01009715,Fair health,61,9,1,8,12,7,9,3,7,7,6,2,4,1
S01009715,Bad health,8,1,0,1,2,0,1,3,0,1,0,0,0,0
S01009715,Very bad health,5,1,0,1,0,0,1,0,2,1,0,0,0,0
S01009716,All people aged 16 to 74,532,91,8,83,107,46,42,29,53,40,4,2,2,120
S01009716,Very good health,299,55,6,49,52,21,25,10,27,15,2,0,2,92
S01009716,Good health,172,28,0,28,47,18,11,13,13,18,0,0,0,24
S01009716,Fair health,44,7,2,5,5,5,6,3,8,5,2,2,0,3
S01009716,Bad health,12,1,0,1,2,2,0,2,2,2,0,0,0,1
S01009716,Very bad health,5,0,0,0,1,0,0,1,3,0,0,0,0,0
S01009717,All people aged 16 to 74,858,33,1,32,66,35,27,33,83,65,20,9,11,496
S01009717,Very good health,508,16,1,15,33,10,14,14,30,22,10,4,6,359
S01009717,Good health,235,13,0,13,16,16,7,12,27,26,3,1,2,115
S01009717,Fair health,87,3,0,3,12,6,5,7,18,12,5,2,3,19
S01009717,Bad health,18,0,0,0,3,2,1,0,6,1,2,2,0,3
S01009717,Very bad health,10,1,0,1,2,1,0,0,2,4,0,0,0,0
S01009718,All people aged 16 to 74,563,40,3,37,73,28,31,56,82,98,18,10,8,137
S01009718,Very good health,291,20,2,18,36,12,8,32,39,39,8,4,4,97
S01009718,Good health,187,15,0,15,23,13,12,20,27,39,6,2,4,32
S01009718,Fair health,65,3,1,2,9,3,10,3,12,16,3,3,0,6
S01009718,Bad health,15,2,0,2,4,0,1,0,3,4,0,0,0,1
S01009718,Very bad health,5,0,0,0,1,0,0,1,1,0,1,1,0,1
S01009719,All people aged 16 to 74,571,41,8,33,70,48,38,59,116,85,16,10,6,98
S01009719,Very good health,268,28,5,23,27,28,16,20,39,28,7,4,3,75
S01009719,Good health,198,10,2,8,32,12,11,25,54,32,5,3,2,17
S01009719,Fair health,83,2,1,1,8,7,10,13,16,20,2,1,1,5
S01009719,Bad health,17,1,0,1,1,1,1,1,6,4,2,2,0,0
S01009719,Very bad health,5,0,0,0,2,0,0,0,1,1,0,0,0,1
S01009720,All people aged 16 to 74,611,44,5,39,79,47,25,69,101,108,12,8,4,126
S01009720,Very good health,308,29,4,25,32,19,11,38,43,41,6,2,4,89
S01009720,Good health,187,12,1,11,28,13,6,22,33,38,5,5,0,30
S01009720,Fair health,76,3,0,3,12,8,6,6,17,16,1,1,0,7
S01009720,Bad health,29,0,0,0,5,6,2,0,6,10,0,0,0,0
S01009720,Very bad health,11,0,0,0,2,1,0,3,2,3,0,0,0,0
S01009721,All people aged 16 to 74,551,23,0,23,17,7,7,8,13,7,3,2,1,466
S01009721,Very good health,425,16,0,16,13,6,6,4,8,6,1,1,0,365
S01009721,Good health,103,7,0,7,2,1,1,3,3,1,2,1,1,83
S01009721,Fair health,19,0,0,0,1,0,0,1,2,0,0,0,0,15
S01009721,Bad health,4,0,0,0,1,0,0,0,0,0,0,0,0,3
S01009721,Very bad health,0,0,0,0,0,0,0,0,0,0,0,0,0,0
S01009722,All people aged 16 to 74,1012,54,7,47,63,20,27,11,30,20,4,3,1,783
S01009722,Very good health,726,36,5,31,33,12,15,3,11,8,1,1,0,607
S01009722,Good health,227,12,0,12,24,6,8,7,8,5,1,1,0,156
S01009722,Fair health,44,6,2,4,4,1,4,1,6,4,2,1,1,16
S01009722,Bad health,12,0,0,0,1,1,0,0,4,2,0,0,0,4
S01009722,Very bad health,3,0,0,0,1,0,0,0,1,1,0,0,0,0
S01009723,All people aged 16 to 74,703,44,1,43,35,18,12,12,15,13,9,8,1,545
S01009723,Very good health,470,24,0,24,17,10,3,9,6,4,3,3,0,394
S01009723,Good health,187,19,1,18,14,3,6,1,6,4,3,2,1,131
S01009723,Fair health,32,1,0,1,2,2,3,0,2,3,3,3,0,16
S01009723,Bad health,12,0,0,0,2,1,0,2,1,2,0,0,0,4
S01009723,Very bad health,2,0,0,0,0,2,0,0,0,0,0,0,0,0
S01009724,All people aged 16 to 74,813,56,2,54,60,31,39,56,90,87,45,37,8,349
S01009724,Very good health,421,36,2,34,29,7,17,16,37,28,10,6,4,241
S01009724,Good health,279,16,0,16,23,17,14,21,37,38,22,19,3,91
S01009724,Fair health,81,4,0,4,7,5,3,14,11,16,9,8,1,12
S01009724,Bad health,25,0,0,0,0,2,3,4,5,4,2,2,0,5
S01009724,Very bad health,7,0,0,0,1,0,2,1,0,1,2,2,0,0
S01009725,All people aged 16 to 74,627,33,4,29,38,11,16,17,22,19,16,10,6,455
S01009725,Very good health,450,19,3,16,21,9,9,9,15,5,9,4,5,354
S01009725,Good health,140,11,1,10,12,1,6,6,5,5,4,3,1,90
S01009725,Fair health,28,3,0,3,2,1,1,0,2,5,3,3,0,11
S01009725,Bad health,9,0,0,0,3,0,0,2,0,4,0,0,0,0
S01009725,Very bad health,0,0,0,0,0,0,0,0,0,0,0,0,0,0
S01009726,All people aged 16 to 74,988,29,5,24,36,12,38,10,7,4,5,3,2,847
S01009726,Very good health,737,17,4,13,19,3,29,2,0,2,2,1,1,663
S01009726,Good health,208,8,1,7,14,7,6,4,6,2,1,0,1,160
S01009726,Fair health,33,4,0,4,2,1,2,4,1,0,1,1,0,18
S01009726,Bad health,10,0,0,0,1,1,1,0,0,0,1,1,0,6
S01009726,Very bad health,0,0,0,0,0,0,0,0,0,0,0,0,0,0
S01009727,All people aged 16 to 74,635,112,24,88,149,53,50,36,69,40,10,3,7,116
S01009727,Very good health,378,75,16,59,94,30,25,21,34,20,1,1,0,78
S01009727,Good health,202,29,6,23,45,19,19,11,24,13,7,1,6,35
S01009727,Fair health,42,7,1,6,9,3,4,4,6,6,2,1,1,1
S01009727,Bad health,11,1,1,0,1,1,2,0,4,1,0,0,0,1
S01009727,Very bad health,2,0,0,0,0,0,0,0,1,0,0,0,0,1
S01009728,All people aged 16 to 74,562,98,17,81,182,72,42,28,41,27,10,6,4,62
S01009728,Very good health,314,52,11,41,103,36,18,15,18,15,6,4,2,51
S01009728,Good health,192,39,5,34,61,31,16,11,14,6,3,1,2,11
S01009728,Fair health,40,4,0,4,11,4,6,2,8,5,0,0,0,0
S01009728,Bad health,10,2,1,1,3,1,1,0,1,1,1,1,0,0
S01009728,Very bad health,6,1,0,1,4,0,1,0,0,0,0,0,0,0
S01009729,All people aged 16 to 74,454,97,7,90,146,53,32,27,31,19,9,5,4,40
S01009729,Very good health,261,58,4,54,86,29,12,16,12,9,5,3,2,34
S01009729,Good health,139,25,1,24,47,18,15,10,14,3,2,1,1,5
S01009729,Fair health,39,11,2,9,10,4,3,1,3,4,2,1,1,1
S01009729,Bad health,10,1,0,1,2,2,2,0,2,1,0,0,0,0
S01009729,Very bad health,5,2,0,2,1,0,0,0,0,2,0,0,0,0
S01009730,All people aged 16 to 74,423,52,6,46,55,62,28,32,46,45,8,3,5,95
S01009730,Very good health,217,28,2,26,25,27,12,11,17,19,5,2,3,73
S01009730,Good health,160,22,4,18,23,26,11,18,16,21,2,1,1,21
S01009730,Fair health,32,2,0,2,6,5,4,2,9,2,1,0,1,1
S01009730,Bad health,9,0,0,0,1,2,0,0,4,2,0,0,0,0
S01009730,Very bad health,5,0,0,0,0,2,1,1,0,1,0,0,0,0
S01009731,All people aged 16 to 74,410,76,6,70,107,48,37,13,29,16,4,3,1,80
S01009731,Very good health,252,45,4,41,56,24,24,11,15,7,1,1,0,69
S01009731,Good health,126,26,2,24,42,14,11,2,10,7,3,2,1,11
S01009731,Fair health,27,4,0,4,9,8,1,0,3,2,0,0,0,0
S01009731,Bad health,4,1,0,1,0,2,1,0,0,0,0,0,0,0
S01009731,Very bad health,1,0,0,0,0,0,0,0,1,0,0,0,0,0
S01009732,All people aged 16 to 74,661,72,7,65,79,21,43,21,34,20,13,9,4,358
S01009732,Very good health,425,45,4,41,39,8,21,10,15,11,9,6,3,267
S01009732,Good health,171,20,2,18,31,9,14,5,13,5,2,2,0,72
S01009732,Fair health,50,6,1,5,7,2,6,6,4,2,2,1,1,15
S01009732,Bad health,13,1,0,1,2,2,2,0,2,0,0,0,0,4
S01009732,Very bad health,2,0,0,0,0,0,0,0,0,2,0,0,0,0
S01009733,All people aged 16 to 74,397,62,8,54,90,37,46,24,61,49,4,2,2,24
S01009733,Very good health,195,43,4,39,51,16,18,11,24,16,0,0,0,16
S01009733,Good health,137,15,4,11,25,16,20,11,24,17,2,1,1,7
S01009733,Fair health,49,3,0,3,10,2,6,2,11,14,0,0,0,1
S01009733,Bad health,12,1,0,1,4,3,1,0,1,1,1,0,1,0
S01009733,Very bad health,4,0,0,0,0,0,1,0,1,1,1,1,0,0
S01009734,All people aged 16 to 74,653,130,23,107,153,66,71,49,57,34,9,5,4,84
S01009734,Very good health,373,73,14,59,79,44,39,25,35,14,4,2,2,60
S01009734,Good health,214,44,7,37,65,19,23,14,16,10,2,1,1,21
S01009734,Fair health,49,8,1,7,7,2,7,7,4,8,3,2,1,3
S01009734,Bad health,12,4,1,3,1,1,2,2,2,0,0,0,0,0
S01009734,Very bad health,5,1,0,1,1,0,0,1,0,2,0,0,0,0
S01009735,All people aged 16 to 74,975,151,22,129,149,57,54,10,17,5,6,5,1,526
S01009735,Very good health,630,102,11,91,85,30,33,5,11,2,1,1,0,361
S01009735,Good health,290,36,8,28,53,18,16,4,4,3,4,4,0,152
S01009735,Fair health,49,12,3,9,10,8,3,1,2,0,1,0,1,12
S01009735,Bad health,5,1,0,1,1,0,2,0,0,0,0,0,0,1
S01009735,Very bad health,1,0,0,0,0,1,0,0,0,0,0,0,0,0
S01009736,All people aged 16 to 74,2500,51,5,46,46,22,26,15,17,5,12,12,0,2306
S01009736,Very good health,1725,30,2,28,33,11,20,8,7,2,8,8,0,1606
S01009736,Good health,671,17,3,14,8,7,3,6,6,1,2,2,0,621
S01009736,Fair health,91,2,0,2,5,4,1,1,4,1,0,0,0,73
S01009736,Bad health,10,2,0,2,0,0,1,0,0,1,1,1,0,5
S01009736,Very bad health,3,0,0,0,0,0,1,0,0,0,1,1,0,1
S01009737,All people aged 16 to 74,590,17,5,12,179,108,34,45,97,76,10,6,4,24
S01009737,Very good health,303,10,4,6,107,68,16,13,42,25,4,3,1,18
S01009737,Good health,208,4,0,4,56,28,12,25,39,34,6,3,3,4
S01009737,Fair health,60,2,1,1,13,11,5,4,12,11,0,0,0,2
S01009737,Bad health,12,0,0,0,1,0,1,1,4,5,0,0,0,0
S01009737,Very bad health,7,1,0,1,2,1,0,2,0,1,0,0,0,0
S01009738,All people aged 16 to 74,343,21,3,18,76,41,31,44,55,42,9,6,3,24
S01009738,Very good health,186,15,3,12,44,21,15,24,27,17,3,2,1,20
S01009738,Good health,110,4,0,4,24,15,14,14,22,12,2,0,2,3
S01009738,Fair health,38,2,0,2,7,2,2,6,5,11,3,3,0,0
S01009738,Bad health,7,0,0,0,0,3,0,0,1,1,1,1,0,1
S01009738,Very bad health,2,0,0,0,1,0,0,0,0,1,0,0,0,0
S01009739,All people aged 16 to 74,566,76,43,33,180,77,37,33,55,37,16,5,11,55
S01009739,Very good health,378,62,40,22,124,50,17,17,35,16,11,3,8,46
S01009739,Good health,141,14,3,11,45,22,15,11,12,12,3,1,2,7
S01009739,Fair health,31,0,0,0,6,4,4,2,6,6,2,1,1,1
S01009739,Bad health,7,0,0,0,3,0,0,2,1,1,0,0,0,0
S01009739,Very bad health,9,0,0,0,2,1,1,1,1,2,0,0,0,1
S01009740,All people aged 16 to 74,402,17,7,10,79,49,32,51,66,56,17,10,7,35
S01009740,Very good health,205,13,5,8,43,22,20,20,32,20,5,4,1,30
S01009740,Good health,126,2,2,0,26,19,9,20,21,20,5,2,3,4
S01009740,Fair health,53,1,0,1,5,7,3,8,9,13,6,4,2,1
S01009740,Bad health,18,1,0,1,5,1,0,3,4,3,1,0,1,0
S01009740,Very bad health,0,0,0,0,0,0,0,0,0,0,0,0,0,0
S01009741,All people aged 16 to 74,681,42,38,4,227,273,9,18,46,35,8,4,4,23
S01009741,Very good health,504,35,34,1,167,216,5,12,26,19,6,3,3,18
S01009741,Good health,157,7,4,3,56,55,4,2,16,10,2,1,1,5
S01009741,Fair health,15,0,0,0,4,2,0,3,2,4,0,0,0,0
S01009741,Bad health,4,0,0,0,0,0,0,0,2,2,0,0,0,0
S01009741,Very bad health,1,0,0,0,0,0,0,1,0,0,0,0,0,0
S01009742,All people aged 16 to 74,391,75,15,60,131,49,36,24,33,16,8,4,4,19
S01009742,Very good health,230,49,8,41,68,25,27,14,19,8,3,2,1,17
S01009742,Good health,116,22,7,15,47,18,6,7,8,4,3,1,2,1
S01009742,Fair health,36,3,0,3,12,4,3,3,5,3,2,1,1,1
S01009742,Bad health,9,1,0,1,4,2,0,0,1,1,0,0,0,0
S01009742,Very bad health,0,0,0,0,0,0,0,0,0,0,0,0,0,0
S01009743,All people aged 16 to 74,694,123,17,106,182,86,78,57,65,53,15,8,7,35
S01009743,Very good health,364,75,7,68,108,33,32,31,29,23,7,4,3,26
S01009743,Good health,249,37,6,31,62,34,33,20,28,23,3,1,2,9
S01009743,Fair health,68,10,4,6,8,17,10,6,7,7,3,1,2,0
S01009743,Bad health,9,1,0,1,3,1,1,0,1,0,2,2,0,0
S01009743,Very bad health,4,0,0,0,1,1,2,0,0,0,0,0,0,0
S01009744,All people aged 16 to 74,536,76,20,56,142,88,52,39,56,37,8,7,1,38
S01009744,Very good health,289,47,7,40,71,48,30,18,28,17,4,3,1,26
S01009744,Good health,173,21,10,11,45,28,16,17,20,13,2,2,0,11
S01009744,Fair health,56,8,3,5,23,9,4,4,5,2,0,0,0,1
S01009744,Bad health,16,0,0,0,3,3,1,0,2,5,2,2,0,0
S01009744,Very bad health,2,0,0,0,0,0,1,0,1,0,0,0,0,0
S01009745,All people aged 16 to 74,803,104,22,82,233,120,61,56,120,45,13,8,5,51
S01009745,Very good health,441,72,14,58,140,64,34,28,47,15,3,2,1,38
S01009745,Good health,262,29,8,21,69,43,20,22,46,19,7,3,4,7
S01009745,Fair health,78,3,0,3,19,10,7,5,20,8,1,1,0,5
S01009745,Bad health,20,0,0,0,5,3,0,1,6,2,2,2,0,1
S01009745,Very bad health,2,0,0,0,0,0,0,0,1,1,0,0,0,0
S01009746,All people aged 16 to 74,431,66,10,56,118,37,74,24,48,28,10,6,4,26
S01009746,Very good health,233,43,6,37,60,16,42,9,27,15,3,1,2,18
S01009746,Good health,144,18,4,14,38,17,25,12,15,9,5,3,2,5
S01009746,Fair health,39,2,0,2,16,3,3,2,4,4,2,2,0,3
S01009746,Bad health,9,2,0,2,2,1,2,1,1,0,0,0,0,0
S01009746,Very bad health,6,1,0,1,2,0,2,0,1,0,0,0,0,0
S01009747,All people aged 16 to 74,506,51,8,43,121,79,40,45,64,58,19,11,8,29
S01009747,Very good health,221,25,3,22,63,39,12,24,22,11,6,5,1,19
S01009747,Good health,197,19,3,16,45,27,19,14,22,33,8,1,7,10
S01009747,Fair health,67,5,1,4,12,8,9,5,13,12,3,3,0,0
S01009747,Bad health,15,0,0,0,0,5,0,2,4,2,2,2,0,0
S01009747,Very bad health,6,2,1,1,1,0,0,0,3,0,0,0,0,0
S01009748,All people aged 16 to 74,550,85,16,69,143,83,37,41,73,44,10,4,6,34
S01009748,Very good health,267,44,13,31,77,43,16,18,26,13,6,2,4,24
S01009748,Good health,184,32,2,30,41,27,11,12,33,16,3,1,2,9
S01009748,Fair health,66,8,0,8,20,7,6,6,8,9,1,1,0,1
S01009748,Bad health,27,1,1,0,5,4,3,3,6,5,0,0,0,0
S01009748,Very bad health,6,0,0,0,0,2,1,2,0,1,0,0,0,0
S01009749,All people aged 16 to 74,721,109,15,94,191,97,41,57,78,73,21,13,8,54
S01009749,Very good health,379,66,11,55,104,47,19,25,40,33,9,6,3,36
S01009749,Good health,245,37,4,33,59,35,14,23,27,27,8,3,5,15
S01009749,Fair health,68,2,0,2,19,11,7,8,6,9,3,3,0,3
S01009749,Bad health,23,3,0,3,7,2,1,1,5,3,1,1,0,0
S01009749,Very bad health,6,1,0,1,2,2,0,0,0,1,0,0,0,0
S01009750,All people aged 16 to 74,488,38,4,34,118,50,36,50,76,70,17,5,12,33
S01009750,Very good health,235,25,3,22,64,23,11,27,32,23,4,1,3,26
S01009750,Good health,161,9,1,8,40,19,12,15,30,25,6,1,5,5
S01009750,Fair health,67,4,0,4,9,6,8,7,10,16,5,1,4,2
S01009750,Bad health,19,0,0,0,5,2,3,1,3,3,2,2,0,0
S01009750,Very bad health,6,0,0,0,0,0,2,0,1,3,0,0,0,0
S01009751,All people aged 16 to 74,627,42,6,36,129,80,27,66,115,90,26,12,14,52
S01009751,Very good health,283,28,6,22,63,35,13,21,39,38,12,4,8,34
S01009751,Good health,224,12,0,12,46,31,11,28,50,25,8,5,3,13
S01009751,Fair health,83,2,0,2,15,11,3,9,18,18,5,3,2,2
S01009751,Bad health,29,0,0,0,4,2,0,6,7,6,1,0,1,3
S01009751,Very bad health,8,0,0,0,1,1,0,2,1,3,0,0,0,0
S01009752,All people aged 16 to 74,438,131,12,119,140,46,28,12,29,17,6,2,4,29
S01009752,Very good health,252,71,6,65,80,27,14,7,13,10,2,0,2,28
S01009752,Good health,140,48,3,45,45,13,10,3,13,5,2,1,1,1
S01009752,Fair health,37,10,3,7,14,5,2,1,1,2,2,1,1,0
S01009752,Bad health,8,2,0,2,1,1,1,1,2,0,0,0,0,0
S01009752,Very bad health,1,0,0,0,0,0,1,0,0,0,0,0,0,0
S01009753,All people aged 16 to 74,461,87,10,77,139,52,47,19,49,31,9,4,5,28
S01009753,Very good health,249,62,6,56,67,21,28,10,22,15,3,0,3,21
S01009753,Good health,147,20,3,17,53,18,13,6,16,10,5,3,2,6
S01009753,Fair health,57,5,1,4,16,13,6,3,7,5,1,1,0,1
S01009753,Bad health,6,0,0,0,2,0,0,0,3,1,0,0,0,0
S01009753,Very bad health,2,0,0,0,1,0,0,0,1,0,0,0,0,0
S01009754,All people aged 16 to 74,603,122,17,105,147,61,44,38,66,45,23,12,11,57
S01009754,Very good health,321,75,9,66,77,29,20,20,28,21,7,3,4,44
S01009754,Good health,207,38,5,33,56,23,19,9,27,14,9,3,6,12
S01009754,Fair health,56,7,1,6,12,6,4,6,7,7,6,6,0,1
S01009754,Bad health,15,1,1,0,1,3,0,3,4,2,1,0,1,0
S01009754,Very bad health,4,1,1,0,1,0,1,0,0,1,0,0,0,0
S01009755,All people aged 16 to 74,495,96,13,83,155,58,32,39,36,22,19,16,3,38
S01009755,Very good health,286,69,7,62,88,32,13,19,17,11,8,5,3,29
S01009755,Good health,149,24,5,19,41,19,17,14,14,8,5,5,0,7
S01009755,Fair health,44,3,1,2,19,7,1,5,3,2,2,2,0,2
S01009755,Bad health,12,0,0,0,6,0,1,1,1,1,2,2,0,0
S01009755,Very bad health,4,0,0,0,1,0,0,0,1,0,2,2,0,0
S01009756,All people aged 16 to 74,566,132,23,109,170,58,32,31,51,37,14,9,5,41
S01009756,Very good health,319,75,13,62,102,23,20,15,23,18,10,6,4,33
S01009756,Good health,188,48,9,39,49,28,10,10,21,13,4,3,1,5
S01009756,Fair health,38,6,1,5,11,6,2,2,4,4,0,0,0,3
S01009756,Bad health,15,2,0,2,6,1,0,3,1,2,0,0,0,0
S01009756,Very bad health,6,1,0,1,2,0,0,1,2,0,0,0,0,0
S01009757,All people aged 16 to 74,495,135,16,119,157,45,44,18,34,10,8,5,3,44
S01009757,Very good health,304,91,12,79,94,26,23,9,18,1,5,4,1,37
S01009757,Good health,144,34,4,30,50,15,15,7,12,3,2,1,1,6
S01009757,Fair health,35,8,0,8,10,4,5,2,1,4,0,0,0,1
S01009757,Bad health,7,2,0,2,2,0,0,0,1,2,0,0,0,0
S01009757,Very bad health,5,0,0,0,1,0,1,0,2,0,1,0,1,0
S01009758,All people aged 16 to 74,447,37,6,31,101,73,25,36,68,53,13,7,6,41
S01009758,Very good health,236,15,2,13,67,40,11,15,36,18,3,1,2,31
S01009758,Good health,134,17,3,14,23,19,10,14,17,21,7,4,3,6
S01009758,Fair health,57,5,1,4,10,12,2,6,10,8,2,1,1,2
S01009758,Bad health,15,0,0,0,1,2,2,1,2,4,1,1,0,2
S01009758,Very bad health,5,0,0,0,0,0,0,0,3,2,0,0,0,0
S01009759,All people aged 16 to 74,661,7,2,5,37,46,30,45,159,154,105,71,34,78
S01009759,Very good health,279,4,0,4,17,18,6,22,55,62,42,29,13,53
S01009759,Good health,211,2,1,1,16,10,15,14,60,52,23,11,12,19
S01009759,Fair health,117,0,0,0,4,12,6,6,30,28,28,21,7,3
S01009759,Bad health,43,1,1,0,0,5,3,1,12,10,8,6,2,3
S01009759,Very bad health,11,0,0,0,0,1,0,2,2,2,4,4,0,0
S01009760,All people aged 16 to 74,615,13,0,13,53,83,31,48,127,143,67,50,17,50
S01009760,Very good health,243,5,0,5,29,30,13,12,59,38,25,17,8,32
S01009760,Good health,204,4,0,4,16,32,10,18,40,49,19,13,6,16
S01009760,Fair health,95,4,0,4,5,11,5,9,17,28,14,11,3,2
S01009760,Bad health,53,0,0,0,2,7,2,6,8,25,3,3,0,0
S01009760,Very bad health,20,0,0,0,1,3,1,3,3,3,6,6,0,0
S01009761,All people aged 16 to 74,699,47,10,37,119,121,44,69,124,81,35,21,14,59
S01009761,Very good health,326,26,4,22,64,58,20,29,46,27,10,3,7,46
S01009761,Good health,249,15,4,11,47,47,12,25,49,31,10,6,4,13
S01009761,Fair health,86,2,1,1,6,11,9,11,21,16,10,7,3,0
S01009761,Bad health,29,4,1,3,1,4,2,3,4,7,4,4,0,0
S01009761,Very bad health,9,0,0,0,1,1,1,1,4,0,1,1,0,0
S01009762,All people aged 16 to 74,711,7,2,5,59,52,13,65,176,179,86,56,30,74
S01009762,Very good health,297,3,2,1,26,22,9,32,66,60,31,17,14,48
S01009762,Good health,210,3,0,3,23,16,1,16,60,41,30,19,11,20
S01009762,Fair health,113,1,0,1,7,9,2,8,32,36,14,9,5,4
S01009762,Bad health,69,0,0,0,2,4,0,7,12,36,6,6,0,2
S01009762,Very bad health,22,0,0,0,1,1,1,2,6,6,5,5,0,0
S01009763,All people aged 16 to 74,572,94,21,73,147,64,69,23,52,24,28,24,4,71
S01009763,Very good health,337,62,12,50,85,38,36,11,22,11,13,12,1,59
S01009763,Good health,177,27,6,21,51,21,25,10,18,9,6,4,2,10
S01009763,Fair health,41,5,3,2,7,3,6,1,10,3,4,3,1,2
S01009763,Bad health,15,0,0,0,4,2,1,1,2,1,4,4,0,0
S01009763,Very bad health,2,0,0,0,0,0,1,0,0,0,1,1,0,0
S01009764,All people aged 16 to 74,483,13,2,11,63,55,24,43,111,85,61,36,25,28
S01009764,Very good health,200,7,1,6,29,30,7,9,46,24,26,14,12,22
S01009764,Good health,163,5,0,5,19,15,13,23,42,29,14,10,4,3
S01009764,Fair health,71,1,1,0,9,5,4,6,13,16,15,8,7,2
S01009764,Bad health,36,0,0,0,5,3,0,2,9,13,3,1,2,1
S01009764,Very bad health,13,0,0,0,1,2,0,3,1,3,3,3,0,0
S01009765,All people aged 16 to 74,668,30,4,26,95,111,47,72,131,75,50,31,19,57
S01009765,Very good health,282,18,3,15,47,48,18,30,43,17,20,10,10,41
S01009765,Good health,250,8,1,7,34,42,19,26,57,35,18,10,8,11
S01009765,Fair health,85,4,0,4,10,18,6,7,20,9,6,6,0,5
S01009765,Bad health,28,0,0,0,3,1,3,4,7,8,2,2,0,0
S01009765,Very bad health,23,0,0,0,1,2,1,5,4,6,4,3,1,0
S01009766,All people aged 16 to 74,445,19,5,14,100,71,21,48,82,47,10,5,5,47
S01009766,Very good health,231,7,1,6,62,36,11,30,35,12,6,3,3,32
S01009766,Good health,156,10,3,7,28,27,5,13,36,22,2,1,1,13
S01009766,Fair health,46,1,0,1,9,5,4,4,10,9,2,1,1,2
S01009766,Bad health,9,1,1,0,1,2,1,1,1,2,0,0,0,0
S01009766,Very bad health,3,0,0,0,0,1,0,0,0,2,0,0,0,0
S01009767,All people aged 16 to 74,413,9,3,6,42,51,19,34,91,78,59,46,13,30
S01009767,Very good health,167,4,1,3,18,20,11,13,27,23,27,20,7,24
S01009767,Good health,116,2,1,1,14,22,4,14,29,18,9,7,2,4
S01009767,Fair health,71,1,0,1,5,5,2,3,25,18,11,8,3,1
S01009767,Bad health,41,2,1,1,5,3,1,2,5,14,8,7,1,1
S01009767,Very bad health,18,0,0,0,0,1,1,2,5,5,4,4,0,0
S01009768,All people aged 16 to 74,456,27,3,24,71,52,35,26,98,64,53,30,23,30
S01009768,Very good health,204,21,3,18,40,18,20,13,38,18,16,10,6,20
S01009768,Good health,138,6,0,6,24,20,10,5,34,16,17,4,13,6
S01009768,Fair health,72,0,0,0,5,6,3,3,17,20,14,10,4,4
S01009768,Bad health,35,0,0,0,2,7,2,2,9,8,5,5,0,0
S01009768,Very bad health,7,0,0,0,0,1,0,3,0,2,1,1,0,0
S01009769,All people aged 16 to 74,491,41,6,35,113,77,36,36,81,51,17,5,12,39
S01009769,Very good health,280,31,4,27,72,39,19,20,40,20,8,1,7,31
S01009769,Good health,145,8,1,7,37,26,13,9,24,19,4,1,3,5
S01009769,Fair health,50,2,1,1,3,9,2,5,13,9,4,2,2,3
S01009769,Bad health,9,0,0,0,1,0,1,2,3,1,1,1,0,0
S01009769,Very bad health,7,0,0,0,0,3,1,0,1,2,0,0,0,0
S01009770,All people aged 16 to 74,545,31,9,22,105,82,37,56,96,40,40,38,2,58
S01009770,Very good health,273,20,8,12,67,42,15,25,37,16,8,8,0,43
S01009770,Good health,173,6,1,5,29,25,14,15,41,13,15,13,2,15
S01009770,Fair health,67,3,0,3,6,11,5,13,13,7,9,9,0,0
S01009770,Bad health,26,1,0,1,2,4,1,2,5,3,8,8,0,0
S01009770,Very bad health,6,1,0,1,1,0,2,1,0,1,0,0,0,0
S01009771,All people aged 16 to 74,652,36,7,29,129,113,60,54,94,45,51,40,11,70
S01009771,Very good health,336,20,4,16,66,66,26,30,43,20,15,9,6,50
S01009771,Good health,212,12,2,10,51,34,24,12,36,17,13,10,3,13
S01009771,Fair health,64,3,1,2,9,7,8,6,8,5,16,14,2,2
S01009771,Bad health,32,1,0,1,1,5,2,4,4,3,7,7,0,5
S01009771,Very bad health,8,0,0,0,2,1,0,2,3,0,0,0,0,0
S01009772,All people aged 16 to 74,488,33,8,25,105,89,32,35,80,61,17,6,11,36
S01009772,Very good health,243,16,2,14,65,42,16,21,30,23,5,1,4,25
S01009772,Good health,176,13,5,8,31,34,11,12,30,29,8,3,5,8
S01009772,Fair health,56,3,1,2,7,12,3,2,16,8,3,1,2,2
S01009772,Bad health,12,1,0,1,2,1,1,0,4,1,1,1,0,1
S01009772,Very bad health,1,0,0,0,0,0,1,0,0,0,0,0,0,0
S01009773,All people aged 16 to 74,415,50,4,46,84,46,51,29,37,17,29,26,3,72
S01009773,Very good health,232,30,1,29,50,19,33,19,16,10,6,5,1,49
S01009773,Good health,144,19,3,16,28,23,11,8,12,5,15,14,1,23
S01009773,Fair health,27,1,0,1,5,3,4,1,7,2,4,3,1,0
S01009773,Bad health,11,0,0,0,1,1,2,1,2,0,4,4,0,0
S01009773,Very bad health,1,0,0,0,0,0,1,0,0,0,0,0,0,0
S01009774,All people aged 16 to 74,353,43,3,40,85,42,33,23,35,23,25,21,4,44
S01009774,Very good health,207,30,3,27,55,23,15,14,18,14,8,6,2,30
S01009774,Good health,101,12,0,12,23,15,11,6,9,6,7,6,1,12
S01009774,Fair health,35,1,0,1,6,4,6,2,7,1,8,7,1,0
S01009774,Bad health,7,0,0,0,1,0,0,0,1,1,2,2,0,2
S01009774,Very bad health,3,0,0,0,0,0,1,1,0,1,0,0,0,0
S01009775,All people aged 16 to 74,631,18,5,13,42,46,14,58,153,143,86,65,21,71
S01009775,Very good health,209,10,2,8,21,19,4,23,43,24,25,15,10,40
S01009775,Good health,195,4,1,3,9,14,9,14,60,37,20,12,8,28
S01009775,Fair health,126,1,0,1,6,6,1,12,26,44,28,25,3,2
S01009775,Bad health,75,3,2,1,4,6,0,8,19,25,9,9,0,1
S01009775,Very bad health,26,0,0,0,2,1,0,1,5,13,4,4,0,0
S01009776,All people aged 16 to 74,470,7,0,7,37,31,8,46,107,110,95,58,37,29
S01009776,Very good health,165,3,0,3,18,11,3,16,38,41,17,10,7,18
S01009776,Good health,147,2,0,2,10,13,3,17,38,24,32,11,21,8
S01009776,Fair health,103,2,0,2,8,3,0,7,21,27,32,26,6,3
S01009776,Bad health,41,0,0,0,1,2,1,4,6,15,12,9,3,0
S01009776,Very bad health,14,0,0,0,0,2,1,2,4,3,2,2,0,0
S01009777,All people aged 16 to 74,366,8,0,8,36,50,16,31,93,68,29,19,10,35
S01009777,Very good health,139,4,0,4,21,18,6,11,31,21,4,2,2,23
S01009777,Good health,119,2,0,2,9,22,5,12,32,18,8,5,3,11
S01009777,Fair health,65,2,0,2,3,5,2,6,21,14,11,6,5,1
S01009777,Bad health,34,0,0,0,2,4,3,1,5,14,5,5,0,0
S01009777,Very bad health,9,0,0,0,1,1,0,1,4,1,1,1,0,0
S01009778,All people aged 16 to 74,623,16,4,12,45,58,23,58,159,158,57,43,14,49
S01009778,Very good health,201,5,2,3,20,22,7,19,36,44,19,11,8,29
S01009778,Good health,174,5,1,4,11,18,9,11,56,36,11,9,2,17
S01009778,Fair health,149,3,0,3,9,14,4,20,39,41,17,13,4,2
S01009778,Bad health,81,3,1,2,4,4,3,7,24,27,8,8,0,1
S01009778,Very bad health,18,0,0,0,1,0,0,1,4,10,2,2,0,0
S01009779,All people aged 16 to 74,375,3,1,2,22,39,12,37,88,90,44,24,20,40
S01009779,Very good health,137,2,1,1,6,13,9,13,32,25,14,6,8,23
S01009779,Good health,117,1,0,1,10,13,1,9,28,30,14,5,9,11
S01009779,Fair health,69,0,0,0,1,8,0,8,16,22,9,7,2,5
S01009779,Bad health,36,0,0,0,3,4,1,5,9,7,6,5,1,1
S01009779,Very bad health,16,0,0,0,2,1,1,2,3,6,1,1,0,0
S01009780,All people aged 16 to 74,435,4,1,3,27,34,10,20,104,98,92,58,34,46
S01009780,Very good health,168,2,1,1,7,15,6,7,41,33,26,16,10,31
S01009780,Good health,131,1,0,1,10,7,1,11,36,22,30,16,14,13
S01009780,Fair health,65,0,0,0,4,7,0,1,12,19,20,12,8,2
S01009780,Bad health,52,1,0,1,5,5,3,1,8,17,12,10,2,0
S01009780,Very bad health,19,0,0,0,1,0,0,0,7,7,4,4,0,0
S01009781,All people aged 16 to 74,392,2,1,1,36,42,6,33,95,94,57,41,16,27
S01009781,Very good health,124,1,1,0,13,21,0,12,24,26,10,6,4,17
S01009781,Good health,131,1,0,1,11,11,3,10,40,31,16,8,8,8
S01009781,Fair health,82,0,0,0,7,7,2,7,20,25,13,11,2,1
S01009781,Bad health,43,0,0,0,3,2,1,3,10,10,13,11,2,1
S01009781,Very bad health,12,0,0,0,2,1,0,1,1,2,5,5,0,0
S01009782,All people aged 16 to 74,392,24,1,23,60,47,28,31,71,54,45,28,17,32
S01009782,Very good health,191,19,1,18,37,26,15,15,30,17,11,5,6,21
S01009782,Good health,130,3,0,3,17,15,9,13,30,17,18,10,8,8
S01009782,Fair health,45,1,0,1,5,3,3,3,7,10,10,7,3,3
S01009782,Bad health,20,0,0,0,1,1,1,0,3,9,5,5,0,0
S01009782,Very bad health,6,1,0,1,0,2,0,0,1,1,1,1,0,0
S01009783,All people aged 16 to 74,544,7,2,5,64,53,21,45,137,112,75,58,17,30
S01009783,Very good health,216,6,1,5,33,27,7,21,54,36,11,8,3,21
S01009783,Good health,178,1,1,0,25,18,8,11,49,34,25,15,10,7
S01009783,Fair health,89,0,0,0,3,5,2,6,25,25,22,19,3,1
S01009783,Bad health,46,0,0,0,2,2,3,6,9,12,12,12,0,0
S01009783,Very bad health,15,0,0,0,1,1,1,1,0,5,5,4,1,1
S01009784,All people aged 16 to 74,559,12,3,9,54,55,14,48,141,116,66,42,24,53
S01009784,Very good health,196,5,0,5,19,18,7,13,53,23,23,12,11,35
S01009784,Good health,161,3,1,2,16,17,2,19,41,38,14,8,6,11
S01009784,Fair health,130,2,1,1,12,12,5,8,29,37,19,13,6,6
S01009784,Bad health,48,1,1,0,6,7,0,5,11,13,5,4,1,0
S01009784,Very bad health,24,1,0,1,1,1,0,3,7,5,5,5,0,1
S01009785,All people aged 16 to 74,588,9,2,7,53,63,25,40,145,130,80,67,13,43
S01009785,Very good health,209,5,0,5,23,31,7,13,51,32,20,14,6,27
S01009785,Good health,198,3,1,2,18,16,15,15,50,40,29,23,6,12
S01009785,Fair health,102,0,0,0,7,8,2,4,25,32,20,19,1,4
S01009785,Bad health,56,1,1,0,4,6,1,5,14,17,8,8,0,0
S01009785,Very bad health,23,0,0,0,1,2,0,3,5,9,3,3,0,0
S01009786,All people aged 16 to 74,684,13,4,9,56,81,23,39,179,148,90,53,37,55
S01009786,Very good health,245,0,0,0,22,27,8,12,62,41,33,16,17,40
S01009786,Good health,227,9,3,6,23,31,7,10,56,53,29,16,13,9
S01009786,Fair health,132,4,1,3,8,18,4,12,38,26,16,12,4,6
S01009786,Bad health,64,0,0,0,2,4,3,3,19,25,8,5,3,0
S01009786,Very bad health,16,0,0,0,1,1,1,2,4,3,4,4,0,0
S01009787,All people aged 16 to 74,642,10,3,7,57,76,27,51,154,131,92,59,33,44
S01009787,Very good health,228,5,1,4,24,29,5,22,46,34,30,16,14,33
S01009787,Good health,175,4,1,3,14,21,12,10,44,37,25,12,13,8
S01009787,Fair health,143,1,1,0,12,18,3,9,36,34,27,23,4,3
S01009787,Bad health,73,0,0,0,5,7,4,9,22,17,9,7,2,0
S01009787,Very bad health,23,0,0,0,2,1,3,1,6,9,1,1,0,0
S01009788,All people aged 16 to 74,600,21,3,18,72,90,33,40,137,128,37,24,13,42
S01009788,Very good health,237,9,1,8,34,38,17,15,47,36,10,7,3,31
S01009788,Good health,183,9,1,8,22,32,11,8,41,37,13,6,7,10
S01009788,Fair health,121,3,1,2,13,15,3,12,31,33,10,7,3,1
S01009788,Bad health,38,0,0,0,2,4,1,2,14,12,3,3,0,0
S01009788,Very bad health,21,0,0,0,1,1,1,3,4,10,1,1,0,0
S01009789,All people aged 16 to 74,648,23,5,18,77,78,27,60,144,138,46,35,11,55
S01009789,Very good health,265,13,5,8,32,33,9,25,59,47,7,6,1,40
S01009789,Good health,201,9,0,9,22,27,14,16,43,39,18,11,7,13
S01009789,Fair health,119,1,0,1,19,11,2,11,25,32,17,14,3,1
S01009789,Bad health,43,0,0,0,2,4,2,4,11,15,4,4,0,1
S01009789,Very bad health,20,0,0,0,2,3,0,4,6,5,0,0,0,0
S01009790,All people aged 16 to 74,468,14,6,8,60,65,13,48,108,90,38,26,12,32
S01009790,Very good health,191,8,4,4,32,23,5,17,44,27,12,9,3,23
S01009790,Good health,154,3,0,3,23,30,6,17,34,23,11,5,6,7
S01009790,Fair health,77,2,1,1,1,8,1,11,20,22,10,8,2,2
S01009790,Bad health,34,1,1,0,3,2,0,3,5,16,4,3,1,0
S01009790,Very bad health,12,0,0,0,1,2,1,0,5,2,1,1,0,0
S01009791,All people aged 16 to 74,478,11,2,9,47,41,26,39,118,85,73,49,24,38
S01009791,Very good health,200,4,1,3,24,20,13,12,45,28,25,17,8,29
S01009791,Good health,143,5,0,5,16,12,8,17,40,19,19,12,7,7
S01009791,Fair health,78,2,1,1,5,7,3,5,16,22,17,9,8,1
S01009791,Bad health,43,0,0,0,1,2,2,5,11,12,9,8,1,1
S01009791,Very bad health,14,0,0,0,1,0,0,0,6,4,3,3,0,0
S01009792,All people aged 16 to 74,706,98,22,76,172,83,53,42,77,46,42,36,6,93
S01009792,Very good health,420,69,13,56,107,52,24,25,39,20,11,8,3,73
S01009792,Good health,207,27,8,19,51,20,16,12,27,21,15,13,2,18
S01009792,Fair health,55,1,0,1,11,8,9,2,9,3,10,9,1,2
S01009792,Bad health,15,1,1,0,3,2,3,1,0,2,3,3,0,0
S01009792,Very bad health,9,0,0,0,0,1,1,2,2,0,3,3,0,0
S01009793,All people aged 16 to 74,684,47,11,36,149,126,50,61,104,74,25,14,11,48
S01009793,Very good health,357,26,8,18,77,73,18,34,50,32,8,5,3,39
S01009793,Good health,190,15,1,14,49,29,20,13,35,17,7,5,2,5
S01009793,Fair health,101,5,1,4,21,17,10,8,12,15,9,3,6,4
S01009793,Bad health,25,1,1,0,1,4,1,3,7,7,1,1,0,0
S01009793,Very bad health,11,0,0,0,1,3,1,3,0,3,0,0,0,0
S01009794,All people aged 16 to 74,387,42,7,35,109,83,20,29,47,27,7,3,4,23
S01009794,Very good health,254,33,6,27,72,48,14,18,33,17,2,0,2,17
S01009794,Good health,105,6,1,5,31,29,6,8,10,6,4,2,2,5
S01009794,Fair health,18,2,0,2,2,6,0,2,2,3,0,0,0,1
S01009794,Bad health,8,1,0,1,3,0,0,1,1,1,1,1,0,0
S01009794,Very bad health,2,0,0,0,1,0,0,0,1,0,0,0,0,0
S01009795,All people aged 16 to 74,632,76,20,56,154,132,47,45,56,38,15,7,8,69
S01009795,Very good health,389,53,13,40,104,70,24,29,26,17,8,5,3,58
S01009795,Good health,180,22,7,15,40,47,14,10,21,14,4,0,4,8
S01009795,Fair health,46,1,0,1,7,12,6,3,8,4,2,1,1,3
S01009795,Bad health,11,0,0,0,3,2,3,2,1,0,0,0,0,0
S01009795,Very bad health,6,0,0,0,0,1,0,1,0,3,1,1,0,0
S01009796,All people aged 16 to 74,565,49,14,35,146,88,49,44,95,37,19,17,2,38
S01009796,Very good health,324,36,6,30,87,58,19,20,44,16,8,8,0,36
S01009796,Good health,152,9,4,5,38,23,19,14,27,12,8,6,2,2
S01009796,Fair health,60,4,4,0,14,5,7,4,19,5,2,2,0,0
S01009796,Bad health,19,0,0,0,4,2,1,5,5,2,0,0,0,0
S01009796,Very bad health,10,0,0,0,3,0,3,1,0,2,1,1,0,0
S01009797,All people aged 16 to 74,590,54,8,46,150,106,45,49,62,46,26,16,10,52
S01009797,Very good health,301,25,5,20,82,58,21,15,33,28,10,4,6,29
S01009797,Good health,199,24,2,22,53,32,14,24,16,15,5,3,2,16
S01009797,Fair health,65,3,1,2,11,11,8,8,9,3,6,6,0,6
S01009797,Bad health,23,2,0,2,3,4,2,2,4,0,5,3,2,1
S01009797,Very bad health,2,0,0,0,1,1,0,0,0,0,0,0,0,0
S01009798,All people aged 16 to 74,538,49,10,39,149,91,46,35,65,32,12,8,4,59
S01009798,Very good health,338,25,5,20,92,54,26,22,43,20,5,3,2,51
S01009798,Good health,157,21,4,17,48,30,15,10,14,10,2,1,1,7
S01009798,Fair health,33,3,1,2,6,6,4,3,6,1,3,2,1,1
S01009798,Bad health,8,0,0,0,2,1,0,0,2,1,2,2,0,0
S01009798,Very bad health,2,0,0,0,1,0,1,0,0,0,0,0,0,0
S01009799,All people aged 16 to 74,600,7,2,5,48,74,16,42,149,135,87,51,36,42
S01009799,Very good health,230,4,1,3,23,31,6,17,48,47,21,8,13,33
S01009799,Good health,176,2,0,2,13,27,4,13,46,36,30,14,16,5
S01009799,Fair health,100,0,0,0,4,10,5,4,32,24,20,15,5,1
S01009799,Bad health,66,0,0,0,7,5,1,5,17,19,10,9,1,2
S01009799,Very bad health,28,1,1,0,1,1,0,3,6,9,6,5,1,1
S01009800,All people aged 16 to 74,807,19,5,14,89,112,44,65,173,148,79,55,24,78
S01009800,Very good health,345,12,2,10,51,50,12,25,72,46,25,19,6,52
S01009800,Good health,254,5,3,2,28,41,12,18,62,42,22,10,12,24
S01009800,Fair health,119,1,0,1,7,12,12,10,26,30,20,15,5,1
S01009800,Bad health,67,1,0,1,3,7,5,10,10,21,9,8,1,1
S01009800,Very bad health,22,0,0,0,0,2,3,2,3,9,3,3,0,0
S01009801,All people aged 16 to 74,640,8,1,7,59,87,21,50,139,153,68,43,25,55
S01009801,Very good health,245,4,1,3,29,28,3,21,49,48,22,12,10,41
S01009801,Good health,217,4,0,4,22,33,11,13,47,55,23,12,11,9
S01009801,Fair health,90,0,0,0,3,11,2,7,28,26,10,6,4,3
S01009801,Bad health,60,0,0,0,5,9,3,5,12,17,8,8,0,1
S01009801,Very bad health,28,0,0,0,0,6,2,4,3,7,5,5,0,1
S01009802,All people aged 16 to 74,735,21,5,16,104,110,29,69,149,106,75,52,23,72
S01009802,Very good health,346,15,4,11,56,56,15,29,65,35,21,9,12,54
S01009802,Good health,238,4,1,3,36,37,8,23,43,46,25,18,7,16
S01009802,Fair health,101,2,0,2,7,9,4,7,29,21,20,16,4,2
S01009802,Bad health,38,0,0,0,5,7,2,8,10,3,3,3,0,0
S01009802,Very bad health,12,0,0,0,0,1,0,2,2,1,6,6,0,0
S01009803,All people aged 16 to 74,576,13,4,9,79,60,28,33,124,104,65,45,20,70
S01009803,Very good health,245,7,2,5,42,26,12,13,48,32,21,11,10,44
S01009803,Good health,183,4,1,3,25,24,11,10,41,30,17,11,6,21
S01009803,Fair health,92,1,0,1,10,6,4,6,18,29,14,11,3,4
S01009803,Bad health,45,1,1,0,2,4,1,4,11,11,10,9,1,1
S01009803,Very bad health,11,0,0,0,0,0,0,0,6,2,3,3,0,0
S01009804,All people aged 16 to 74,427,57,5,52,103,41,16,31,61,40,60,56,4,18
S01009804,Very good health,190,31,2,29,67,15,7,16,28,7,7,5,2,12
S01009804,Good health,140,21,3,18,28,13,6,10,19,11,26,25,1,6
S01009804,Fair health,47,4,0,4,3,4,3,4,7,11,11,10,1,0
S01009804,Bad health,28,1,0,1,3,6,0,1,5,5,7,7,0,0
S01009804,Very bad health,22,0,0,0,2,3,0,0,2,6,9,9,0,0
S01009805,All people aged 16 to 74,696,29,2,27,68,90,19,44,162,133,74,48,26,77
S01009805,Very good health,296,16,1,15,31,36,11,16,59,42,32,20,12,53
S01009805,Good health,211,7,1,6,21,35,4,12,53,43,16,7,9,20
S01009805,Fair health,114,4,0,4,12,13,3,9,29,24,17,13,4,3
S01009805,Bad health,47,2,0,2,2,4,0,5,12,16,5,4,1,1
S01009805,Very bad health,28,0,0,0,2,2,1,2,9,8,4,4,0,0
S01009806,All people aged 16 to 74,605,25,3,22,107,98,28,45,133,93,30,18,12,46
S01009806,Very good health,268,9,2,7,55,41,12,19,61,30,9,3,6,32
S01009806,Good health,203,12,1,11,33,40,6,18,38,35,9,7,2,12
S01009806,Fair health,78,2,0,2,10,7,7,4,25,14,8,4,4,1
S01009806,Bad health,43,2,0,2,7,9,3,3,6,9,3,3,0,1
S01009806,Very bad health,13,0,0,0,2,1,0,1,3,5,1,1,0,0
S01009807,All people aged 16 to 74,727,20,3,17,98,113,28,82,164,85,84,60,24,53
S01009807,Very good health,316,8,1,7,43,50,9,45,71,33,20,10,10,37
S01009807,Good health,236,10,1,9,26,45,13,23,55,21,30,21,9,13
S01009807,Fair health,108,0,0,0,21,12,6,9,27,16,14,13,1,3
S01009807,Bad health,48,2,1,1,4,2,0,4,10,12,14,10,4,0
S01009807,Very bad health,19,0,0,0,4,4,0,1,1,3,6,6,0,0
S01009808,All people aged 16 to 74,637,7,3,4,69,58,34,50,144,98,109,76,33,68
S01009808,Very good health,258,6,3,3,21,28,13,26,59,26,34,22,12,45
S01009808,Good health,251,0,0,0,31,24,13,18,55,43,49,33,16,18
S01009808,Fair health,80,1,0,1,13,4,6,5,16,16,14,11,3,5
S01009808,Bad health,39,0,0,0,4,2,1,0,12,11,9,7,2,0
S01009808,Very bad health,9,0,0,0,0,0,1,1,2,2,3,3,0,0
S01009809,All people aged 16 to 74,509,23,3,20,93,82,23,40,117,72,27,18,9,32
S01009809,Very good health,219,10,2,8,47,41,7,19,45,24,8,5,3,18
S01009809,Good health,176,9,1,8,28,26,6,14,43,32,6,2,4,12
S01009809,Fair health,75,3,0,3,14,11,5,6,20,10,5,3,2,1
S01009809,Bad health,31,0,0,0,4,4,4,1,8,4,6,6,0,0
S01009809,Very bad health,8,1,0,1,0,0,1,0,1,2,2,2,0,1
S01009810,All people aged 16 to 74,596,11,3,8,83,86,20,57,130,105,68,40,28,36
S01009810,Very good health,226,7,2,5,37,35,13,22,33,34,21,12,9,24
S01009810,Good health,191,2,0,2,30,33,4,16,53,27,18,8,10,8
S01009810,Fair health,107,2,1,1,10,14,2,6,27,23,19,12,7,4
S01009810,Bad health,49,0,0,0,5,4,0,6,13,15,6,4,2,0
S01009810,Very bad health,23,0,0,0,1,0,1,7,4,6,4,4,0,0
S01009811,All people aged 16 to 74,793,23,5,18,103,103,34,53,190,149,88,66,22,50
S01009811,Very good health,314,16,3,13,61,38,12,25,66,41,27,19,8,28
S01009811,Good health,226,4,2,2,24,30,12,14,58,41,27,19,8,16
S01009811,Fair health,148,2,0,2,11,22,9,7,42,26,25,19,6,4
S01009811,Bad health,69,1,0,1,5,9,0,4,12,31,6,6,0,1
S01009811,Very bad health,36,0,0,0,2,4,1,3,12,10,3,3,0,1
S01009812,All people aged 16 to 74,538,19,3,16,78,96,28,48,104,86,48,32,16,31
S01009812,Very good health,217,14,2,12,37,45,9,14,39,25,13,8,5,21
S01009812,Good health,186,3,0,3,33,29,13,18,35,32,16,11,5,7
S01009812,Fair health,75,1,0,1,6,15,1,7,19,15,9,3,6,2
S01009812,Bad health,45,1,1,0,2,6,3,6,7,11,8,8,0,1
S01009812,Very bad health,15,0,0,0,0,1,2,3,4,3,2,2,0,0
S01009813,All people aged 16 to 74,494,5,0,5,33,46,22,31,111,81,97,76,21,68
S01009813,Very good health,159,4,0,4,10,16,7,9,37,18,23,17,6,35
S01009813,Good health,181,1,0,1,13,18,9,10,45,24,33,25,8,28
S01009813,Fair health,103,0,0,0,6,8,5,9,20,26,25,20,5,4
S01009813,Bad health,41,0,0,0,3,4,1,2,8,10,12,10,2,1
S01009813,Very bad health,10,0,0,0,1,0,0,1,1,3,4,4,0,0
S01009814,All people aged 16 to 74,614,40,6,34,134,85,34,52,80,91,37,28,9,61
S01009814,Very good health,297,29,4,25,71,34,17,19,31,33,12,8,4,51
S01009814,Good health,196,9,1,8,42,34,13,19,34,22,13,9,4,10
S01009814,Fair health,78,1,1,0,16,11,2,8,10,23,7,6,1,0
S01009814,Bad health,32,1,0,1,5,2,2,5,5,9,3,3,0,0
S01009814,Very bad health,11,0,0,0,0,4,0,1,0,4,2,2,0,0
S01009815,All people aged 16 to 74,547,28,7,21,118,91,25,36,90,84,25,19,6,50
S01009815,Very good health,280,15,3,12,70,47,14,16,43,32,5,2,3,38
S01009815,Good health,167,10,4,6,30,31,7,15,33,24,6,4,2,11
S01009815,Fair health,66,2,0,2,14,8,3,4,10,18,6,5,1,1
S01009815,Bad health,28,1,0,1,4,4,1,1,3,7,7,7,0,0
S01009815,Very bad health,6,0,0,0,0,1,0,0,1,3,1,1,0,0
S01009816,All people aged 16 to 74,545,29,2,27,110,85,30,56,107,62,16,10,6,50
S01009816,Very good health,273,15,0,15,64,39,14,24,39,33,5,2,3,40
S01009816,Good health,181,11,0,11,33,33,10,22,46,16,4,4,0,6
S01009816,Fair health,64,1,1,0,11,10,5,5,18,7,3,0,3,4
S01009816,Bad health,21,2,1,1,2,3,1,3,3,5,2,2,0,0
S01009816,Very bad health,6,0,0,0,0,0,0,2,1,1,2,2,0,0
S01009817,All people aged 16 to 74,486,23,6,17,95,78,15,49,97,60,35,21,14,34
S01009817,Very good health,219,14,2,12,42,37,4,15,42,30,9,3,6,26
S01009817,Good health,164,7,3,4,37,25,9,22,29,13,14,9,5,8
S01009817,Fair health,66,1,1,0,12,12,2,6,16,10,7,4,3,0
S01009817,Bad health,24,1,0,1,2,3,0,4,7,6,1,1,0,0
S01009817,Very bad health,13,0,0,0,2,1,0,2,3,1,4,4,0,0
S01009818,All people aged 16 to 74,716,65,12,53,198,139,49,54,84,45,25,19,6,57
S01009818,Very good health,381,43,6,37,115,74,25,18,39,14,7,3,4,46
S01009818,Good health,230,17,4,13,58,46,15,27,30,19,7,6,1,11
S01009818,Fair health,79,1,0,1,22,12,7,8,12,7,10,9,1,0
S01009818,Bad health,21,3,1,2,2,5,2,1,3,4,1,1,0,0
S01009818,Very bad health,5,1,1,0,1,2,0,0,0,1,0,0,0,0
S01009819,All people aged 16 to 74,456,40,5,35,104,80,32,31,67,50,20,14,6,32
S01009819,Very good health,223,28,3,25,59,43,18,11,23,11,4,3,1,26
S01009819,Good health,131,10,1,9,32,21,10,9,18,18,9,5,4,4
S01009819,Fair health,54,1,1,0,6,10,2,6,12,14,2,2,0,1
S01009819,Bad health,38,0,0,0,7,6,1,4,11,6,2,2,0,1
S01009819,Very bad health,10,1,0,1,0,0,1,1,3,1,3,2,1,0
S01009820,All people aged 16 to 74,686,38,9,29,150,132,37,59,122,69,36,26,10,43
S01009820,Very good health,344,27,5,22,86,64,19,25,49,21,15,12,3,38
S01009820,Good health,202,8,2,6,42,46,8,23,40,17,13,7,6,5
S01009820,Fair health,83,2,1,1,11,9,9,7,21,19,5,4,1,0
S01009820,Bad health,45,1,1,0,9,12,0,2,8,10,3,3,0,0
S01009820,Very bad health,12,0,0,0,2,1,1,2,4,2,0,0,0,0
S01009821,All people aged 16 to 74,490,50,14,36,120,68,31,28,66,49,20,13,7,58
S01009821,Very good health,266,28,9,19,69,32,15,11,35,25,10,6,4,41
S01009821,Good health,143,15,2,13,41,21,9,9,18,8,7,4,3,15
S01009821,Fair health,61,5,2,3,9,12,4,6,9,12,2,2,0,2
S01009821,Bad health,17,2,1,1,1,2,3,2,2,4,1,1,0,0
S01009821,Very bad health,3,0,0,0,0,1,0,0,2,0,0,0,0,0
S01009822,All people aged 16 to 74,334,16,2,14,64,48,12,28,64,55,25,13,12,22
S01009822,Very good health,151,7,2,5,35,27,7,12,24,14,6,2,4,19
S01009822,Good health,120,4,0,4,23,15,4,12,27,20,12,7,5,3
S01009822,Fair health,47,4,0,4,6,5,1,1,10,16,4,1,3,0
S01009822,Bad health,14,1,0,1,0,1,0,2,2,5,3,3,0,0
S01009822,Very bad health,2,0,0,0,0,0,0,1,1,0,0,0,0,0
S01009823,All people aged 16 to 74,501,13,5,8,61,60,13,46,103,97,61,45,16,47
S01009823,Very good health,193,4,1,3,28,29,7,15,31,29,16,9,7,34
S01009823,Good health,175,5,2,3,22,16,4,20,43,31,23,16,7,11
S01009823,Fair health,80,3,2,1,8,6,2,7,17,24,11,9,2,2
S01009823,Bad health,33,1,0,1,2,5,0,3,5,10,7,7,0,0
S01009823,Very bad health,20,0,0,0,1,4,0,1,7,3,4,4,0,0
S01009824,All people aged 16 to 74,594,19,2,17,90,78,21,68,113,119,48,33,15,38
S01009824,Very good health,273,13,1,12,51,29,9,30,44,50,17,10,7,30
S01009824,Good health,185,6,1,5,30,26,5,28,37,34,14,11,3,5
S01009824,Fair health,91,0,0,0,6,11,5,6,25,23,12,8,4,3
S01009824,Bad health,37,0,0,0,2,11,2,3,6,9,4,3,1,0
S01009824,Very bad health,8,0,0,0,1,1,0,1,1,3,1,1,0,0
S01009825,All people aged 16 to 74,723,24,8,16,107,98,34,52,145,148,62,46,16,53
S01009825,Very good health,290,10,3,7,56,46,14,14,50,50,16,11,5,34
S01009825,Good health,242,9,5,4,30,32,12,20,46,53,25,19,6,15
S01009825,Fair health,116,4,0,4,11,11,3,9,34,25,15,10,5,4
S01009825,Bad health,55,1,0,1,6,7,3,7,10,17,4,4,0,0
S01009825,Very bad health,20,0,0,0,4,2,2,2,5,3,2,2,0,0
S01009826,All people aged 16 to 74,402,8,2,6,45,43,17,38,97,74,45,27,18,35
S01009826,Very good health,165,4,1,3,18,26,8,11,33,30,14,6,8,21
S01009826,Good health,124,3,0,3,13,13,5,13,35,21,12,8,4,9
S01009826,Fair health,68,1,1,0,6,0,4,7,22,13,10,4,6,5
S01009826,Bad health,25,0,0,0,4,3,0,3,5,5,5,5,0,0
S01009826,Very bad health,20,0,0,0,4,1,0,4,2,5,4,4,0,0
S01009827,All people aged 16 to 74,624,9,5,4,67,82,19,45,141,156,47,35,12,58
S01009827,Very good health,258,5,3,2,37,35,7,10,56,52,20,14,6,36
S01009827,Good health,198,2,0,2,21,20,6,17,50,53,11,7,4,18
S01009827,Fair health,96,1,1,0,6,19,4,10,20,27,7,6,1,2
S01009827,Bad health,49,0,0,0,3,4,2,3,11,18,6,5,1,2
S01009827,Very bad health,23,1,1,0,0,4,0,5,4,6,3,3,0,0
S01009828,All people aged 16 to 74,551,17,3,14,73,65,19,56,112,110,72,53,19,27
S01009828,Very good health,186,11,1,10,24,27,9,15,34,29,18,13,5,19
S01009828,Good health,150,1,0,1,27,19,5,19,31,26,18,12,6,4
S01009828,Fair health,124,2,1,1,12,13,3,11,26,32,21,13,8,4
S01009828,Bad health,66,2,0,2,7,6,2,6,20,14,9,9,0,0
S01009828,Very bad health,25,1,1,0,3,0,0,5,1,9,6,6,0,0
S01009829,All people aged 16 to 74,712,33,6,27,123,132,29,75,122,93,60,38,22,45
S01009829,Very good health,312,19,2,17,68,67,9,34,43,32,15,6,9,25
S01009829,Good health,251,11,4,7,42,40,14,26,43,38,21,11,10,16
S01009829,Fair health,91,2,0,2,12,18,5,5,16,13,16,13,3,4
S01009829,Bad health,51,1,0,1,1,7,1,10,15,9,7,7,0,0
S01009829,Very bad health,7,0,0,0,0,0,0,0,5,1,1,1,0,0
S01009830,All people aged 16 to 74,576,12,4,8,84,112,23,45,115,104,39,22,17,42
S01009830,Very good health,269,8,3,5,43,58,13,15,48,39,11,6,5,34
S01009830,Good health,188,3,1,2,29,39,4,15,46,32,14,5,9,6
S01009830,Fair health,84,1,0,1,11,13,5,13,13,17,9,6,3,2
S01009830,Bad health,26,0,0,0,1,2,0,2,6,11,4,4,0,0
S01009830,Very bad health,9,0,0,0,0,0,1,0,2,5,1,1,0,0
S01009831,All people aged 16 to 74,560,22,4,18,107,116,15,39,110,70,31,17,14,50
S01009831,Very good health,277,9,0,9,57,60,6,22,42,29,13,7,6,39
S01009831,Good health,197,9,4,5,37,32,5,15,48,30,11,6,5,10
S01009831,Fair health,65,3,0,3,12,18,3,1,14,8,5,2,3,1
S01009831,Bad health,15,1,0,1,1,5,1,1,3,2,1,1,0,0
S01009831,Very bad health,6,0,0,0,0,1,0,0,3,1,1,1,0,0
S01009832,All people aged 16 to 74,717,44,9,35,146,120,33,64,136,91,35,22,13,48
S01009832,Very good health,339,24,4,20,77,53,14,23,70,27,13,7,6,38
S01009832,Good health,249,12,3,9,52,45,16,26,38,39,14,8,6,7
S01009832,Fair health,85,6,1,5,16,16,3,11,18,12,2,2,0,1
S01009832,Bad health,32,0,0,0,1,5,0,2,7,11,5,4,1,1
S01009832,Very bad health,12,2,1,1,0,1,0,2,3,2,1,1,0,1
S01009833,All people aged 16 to 74,441,18,4,14,115,58,26,34,65,65,28,23,5,32
S01009833,Very good health,230,9,2,7,79,29,13,21,31,20,2,2,0,26
S01009833,Good health,108,6,1,5,23,12,7,7,16,21,12,8,4,4
S01009833,Fair health,61,2,0,2,9,9,1,4,11,18,6,5,1,1
S01009833,Bad health,27,1,1,0,3,5,3,2,5,3,5,5,0,0
S01009833,Very bad health,15,0,0,0,1,3,2,0,2,3,3,3,0,1
S01009834,All people aged 16 to 74,606,19,6,13,91,97,27,40,113,111,58,33,25,50
S01009834,Very good health,277,12,3,9,50,46,15,14,47,44,17,12,5,32
S01009834,Good health,178,6,2,4,27,31,10,14,34,30,14,4,10,12
S01009834,Fair health,91,1,1,0,11,12,1,7,23,19,14,8,6,3
S01009834,Bad health,51,0,0,0,3,7,1,3,8,16,10,6,4,3
S01009834,Very bad health,9,0,0,0,0,1,0,2,1,2,3,3,0,0
S01009835,All people aged 16 to 74,376,10,2,8,24,44,13,25,97,98,33,20,13,32
S01009835,Very good health,132,4,1,3,8,14,7,12,32,27,10,6,4,18
S01009835,Good health,127,5,1,4,8,18,3,8,39,26,10,6,4,10
S01009835,Fair health,63,1,0,1,5,8,2,3,11,22,8,4,4,3
S01009835,Bad health,38,0,0,0,2,3,0,2,13,15,3,3,0,0
S01009835,Very bad health,16,0,0,0,1,1,1,0,2,8,2,1,1,1
S01009836,All people aged 16 to 74,723,31,11,20,121,102,36,64,132,133,56,43,13,48
S01009836,Very good health,319,18,2,16,62,51,11,29,47,46,18,13,5,37
S01009836,Good health,229,7,5,2,39,33,16,22,50,39,14,11,3,9
S01009836,Fair health,112,4,3,1,14,13,5,9,20,34,11,7,4,2
S01009836,Bad health,40,0,0,0,4,4,4,4,10,11,3,2,1,0
S01009836,Very bad health,23,2,1,1,2,1,0,0,5,3,10,10,0,0
S01009837,All people aged 16 to 74,481,10,3,7,58,71,16,40,101,118,44,36,8,23
S01009837,Very good health,176,7,2,5,24,40,4,15,35,26,11,7,4,14
S01009837,Good health,155,2,1,1,21,18,7,17,38,40,6,5,1,6
S01009837,Fair health,84,0,0,0,7,12,2,5,15,30,10,9,1,3
S01009837,Bad health,43,1,0,1,3,0,1,3,11,13,11,11,0,0
S01009837,Very bad health,23,0,0,0,3,1,2,0,2,9,6,4,2,0
S01009838,All people aged 16 to 74,563,20,3,17,91,71,22,51,96,107,69,38,31,36
S01009838,Very good health,214,13,3,10,56,22,8,15,39,30,13,8,5,18
S01009838,Good health,198,5,0,5,26,29,9,24,32,35,24,8,16,14
S01009838,Fair health,91,1,0,1,6,11,2,7,17,25,18,10,8,4
S01009838,Bad health,46,1,0,1,2,8,3,3,8,13,8,6,2,0
S01009838,Very bad health,14,0,0,0,1,1,0,2,0,4,6,6,0,0
S01009839,All people aged 16 to 74,795,23,3,20,95,115,21,61,171,150,98,54,44,61
S01009839,Very good health,305,12,1,11,57,44,8,18,63,46,18,7,11,39
S01009839,Good health,292,9,1,8,30,45,7,22,63,53,45,20,25,18
S01009839,Fair health,135,2,1,1,7,21,5,10,28,33,25,17,8,4
S01009839,Bad health,50,0,0,0,1,4,1,9,12,15,8,8,0,0
S01009839,Very bad health,13,0,0,0,0,1,0,2,5,3,2,2,0,0
S01009840,All people aged 16 to 74,731,27,5,22,88,110,32,61,150,154,70,48,22,39
S01009840,Very good health,271,12,3,9,43,41,9,25,57,38,17,8,9,29
S01009840,Good health,229,11,2,9,26,41,13,15,43,50,22,12,10,8
S01009840,Fair health,135,2,0,2,14,20,4,13,32,36,13,11,2,1
S01009840,Bad health,71,2,0,2,4,5,4,5,17,20,13,13,0,1
S01009840,Very bad health,25,0,0,0,1,3,2,3,1,10,5,4,1,0
S01009841,All people aged 16 to 74,651,18,8,10,87,67,16,60,125,128,91,58,33,59
S01009841,Very good health,255,10,3,7,33,25,5,19,41,36,46,32,14,40
S01009841,Good health,202,5,3,2,23,24,8,13,43,45,25,12,13,16
S01009841,Fair health,122,1,0,1,20,12,3,15,26,27,15,11,4,3
S01009841,Bad health,54,2,2,0,9,4,0,5,14,15,5,3,2,0
S01009841,Very bad health,18,0,0,0,2,2,0,8,1,5,0,0,0,0
S01009842,All people aged 16 to 74,511,15,3,12,52,42,19,43,94,89,88,60,28,69
S01009842,Very good health,215,4,1,3,28,13,8,10,46,32,27,17,10,47
S01009842,Good health,165,3,0,3,16,17,9,18,29,32,26,16,10,15
S01009842,Fair health,76,5,2,3,5,8,2,9,9,15,17,12,5,6
S01009842,Bad health,39,2,0,2,2,4,0,4,6,5,16,13,3,0
S01009842,Very bad health,16,1,0,1,1,0,0,2,4,5,2,2,0,1
S01009843,All people aged 16 to 74,467,8,0,8,39,52,9,37,83,111,94,68,26,34
S01009843,Very good health,167,3,0,3,22,21,2,12,27,33,21,17,4,26
S01009843,Good health,123,4,0,4,8,16,4,13,21,22,29,17,12,6
S01009843,Fair health,90,1,0,1,5,7,1,7,17,29,21,12,9,2
S01009843,Bad health,67,0,0,0,4,6,2,4,14,18,19,18,1,0
S01009843,Very bad health,20,0,0,0,0,2,0,1,4,9,4,4,0,0
S01009844,All people aged 16 to 74,426,10,0,10,35,36,27,37,74,84,92,65,27,31
S01009844,Very good health,140,5,0,5,9,14,11,13,19,25,30,19,11,14
S01009844,Good health,154,2,0,2,14,14,9,11,27,27,36,24,12,14
S01009844,Fair health,70,3,0,3,9,3,2,7,14,16,13,11,2,3
S01009844,Bad health,49,0,0,0,3,3,1,5,10,16,11,9,2,0
S01009844,Very bad health,13,0,0,0,0,2,4,1,4,0,2,2,0,0
S01009845,All people aged 16 to 74,603,14,2,12,52,53,24,55,114,113,128,86,42,50
S01009845,Very good health,213,6,0,6,22,14,8,24,41,26,39,25,14,33
S01009845,Good health,234,6,2,4,16,25,12,18,53,49,41,28,13,14
S01009845,Fair health,89,2,0,2,9,11,3,5,12,21,24,12,12,2
S01009845,Bad health,56,0,0,0,4,3,1,8,6,12,21,18,3,1
S01009845,Very bad health,11,0,0,0,1,0,0,0,2,5,3,3,0,0
S01009846,All people aged 16 to 74,691,20,4,16,86,77,35,53,136,147,85,57,28,52
S01009846,Very good health,243,7,2,5,36,33,10,18,39,41,23,14,9,36
S01009846,Good health,246,10,1,9,29,33,13,18,48,54,25,14,11,16
S01009846,Fair health,109,2,1,1,14,7,7,8,28,23,20,12,8,0
S01009846,Bad health,67,1,0,1,7,4,2,5,14,22,12,12,0,0
S01009846,Very bad health,26,0,0,0,0,0,3,4,7,7,5,5,0,0
S01009847,All people aged 16 to 74,452,7,3,4,55,67,10,35,98,101,42,28,14,37
S01009847,Very good health,187,4,2,2,24,27,6,15,37,33,15,10,5,26
S01009847,Good health,156,1,0,1,23,29,4,6,38,35,12,7,5,8
S01009847,Fair health,77,2,1,1,6,6,0,10,16,23,11,7,4,3
S01009847,Bad health,26,0,0,0,2,5,0,4,5,7,3,3,0,0
S01009847,Very bad health,6,0,0,0,0,0,0,0,2,3,1,1,0,0
S01009848,All people aged 16 to 74,666,17,5,12,65,77,23,57,148,130,93,69,24,56
S01009848,Very good health,284,13,2,11,27,45,8,29,66,38,20,11,9,38
S01009848,Good health,168,2,2,0,24,19,6,14,38,32,20,12,8,13
S01009848,Fair health,117,2,1,1,7,8,2,8,27,33,26,20,6,4
S01009848,Bad health,72,0,0,0,7,5,4,3,11,21,21,20,1,0
S01009848,Very bad health,25,0,0,0,0,0,3,3,6,6,6,6,0,1
S01009849,All people aged 16 to 74,518,26,2,24,95,66,18,44,106,96,36,25,11,31
S01009849,Very good health,201,13,1,12,47,28,5,20,34,21,10,6,4,23
S01009849,Good health,156,10,1,9,28,26,7,12,29,29,10,5,5,5
S01009849,Fair health,90,1,0,1,11,4,4,9,26,24,8,7,1,3
S01009849,Bad health,57,0,0,0,9,7,2,1,14,17,7,6,1,0
S01009849,Very bad health,14,2,0,2,0,1,0,2,3,5,1,1,0,0
S01009850,All people aged 16 to 74,654,36,5,31,106,97,29,56,130,117,42,29,13,41
S01009850,Very good health,254,20,4,16,51,41,11,12,45,38,8,5,3,28
S01009850,Good health,223,13,0,13,35,39,16,25,40,34,11,4,7,10
S01009850,Fair health,119,3,1,2,14,10,2,13,31,29,14,11,3,3
S01009850,Bad health,44,0,0,0,6,5,0,6,10,11,6,6,0,0
S01009850,Very bad health,14,0,0,0,0,2,0,0,4,5,3,3,0,0
S01009851,All people aged 16 to 74,595,26,5,21,75,76,33,55,136,120,41,21,20,33
S01009851,Very good health,228,11,0,11,31,30,14,18,55,32,15,9,6,22
S01009851,Good health,190,11,3,8,27,30,6,19,39,35,15,3,12,8
S01009851,Fair health,109,3,1,2,14,12,9,13,28,23,4,3,1,3
S01009851,Bad health,50,0,0,0,2,2,2,3,11,24,6,5,1,0
S01009851,Very bad health,18,1,1,0,1,2,2,2,3,6,1,1,0,0
S01009852,All people aged 16 to 74,416,23,6,17,77,73,13,29,77,49,33,24,9,42
S01009852,Very good health,170,14,5,9,40,24,6,14,19,12,11,7,4,30
S01009852,Good health,135,8,1,7,23,26,4,6,30,19,9,7,2,10
S01009852,Fair health,64,0,0,0,8,15,3,3,15,11,7,4,3,2
S01009852,Bad health,41,1,0,1,5,8,0,6,12,5,4,4,0,0
S01009852,Very bad health,6,0,0,0,1,0,0,0,1,2,2,2,0,0
S01009853,All people aged 16 to 74,592,27,5,22,88,113,31,34,114,95,41,26,15,49
S01009853,Very good health,261,13,3,10,50,47,12,17,44,22,20,14,6,36
S01009853,Good health,183,8,1,7,21,40,12,9,37,43,5,3,2,8
S01009853,Fair health,87,3,0,3,12,16,3,4,20,17,8,3,5,4
S01009853,Bad health,47,0,0,0,5,9,4,3,10,10,5,4,1,1
S01009853,Very bad health,14,3,1,2,0,1,0,1,3,3,3,2,1,0
S01009854,All people aged 16 to 74,657,21,4,17,102,91,26,54,137,120,64,35,29,42
S01009854,Very good health,291,13,2,11,61,43,15,33,55,30,16,5,11,25
S01009854,Good health,208,5,1,4,22,37,10,8,42,43,25,12,13,16
S01009854,Fair health,82,0,0,0,12,8,1,6,20,23,11,8,3,1
S01009854,Bad health,49,2,1,1,7,2,0,5,14,13,6,4,2,0
S01009854,Very bad health,27,1,0,1,0,1,0,2,6,11,6,6,0,0
S01009855,All people aged 16 to 74,426,33,6,27,95,58,21,36,71,52,15,8,7,45
S01009855,Very good health,216,16,3,13,48,27,10,16,37,19,7,3,4,36
S01009855,Good health,134,14,1,13,39,23,6,12,14,13,4,3,1,9
S01009855,Fair health,37,3,2,1,5,3,2,3,10,8,3,1,2,0
S01009855,Bad health,28,0,0,0,3,4,1,5,8,7,0,0,0,0
S01009855,Very bad health,11,0,0,0,0,1,2,0,2,5,1,1,0,0
S01009856,All people aged 16 to 74,460,33,4,29,92,68,22,31,72,53,32,21,11,57
S01009856,Very good health,216,14,2,12,48,28,6,15,29,20,9,6,3,47
S01009856,Good health,130,10,1,9,26,26,9,7,20,15,11,4,7,6
S01009856,Fair health,72,7,0,7,12,9,6,3,18,7,6,5,1,4
S01009856,Bad health,30,2,1,1,4,4,1,5,2,8,4,4,0,0
S01009856,Very bad health,12,0,0,0,2,1,0,1,3,3,2,2,0,0
S01009857,All people aged 16 to 74,629,41,4,37,141,106,29,46,109,73,35,27,8,49
S01009857,Very good health,301,19,4,15,73,47,16,26,40,30,14,12,2,36
S01009857,Good health,187,18,0,18,42,37,7,9,37,21,8,6,2,8
S01009857,Fair health,83,2,0,2,17,13,4,6,21,11,6,3,3,3
S01009857,Bad health,44,1,0,1,6,9,1,4,8,7,6,5,1,2
S01009857,Very bad health,14,1,0,1,3,0,1,1,3,4,1,1,0,0
S01009858,All people aged 16 to 74,550,22,4,18,96,92,26,50,116,66,28,20,8,54
S01009858,Very good health,250,15,1,14,49,43,7,18,41,22,13,6,7,42
S01009858,Good health,171,3,1,2,35,28,11,17,42,19,6,5,1,10
S01009858,Fair health,78,4,2,2,7,14,5,12,18,13,3,3,0,2
S01009858,Bad health,35,0,0,0,3,5,2,2,10,8,5,5,0,0
S01009858,Very bad health,16,0,0,0,2,2,1,1,5,4,1,1,0,0
S01009859,All people aged 16 to 74,806,27,4,23,77,90,22,52,166,184,131,89,42,57
S01009859,Very good health,311,16,0,16,36,44,9,23,58,43,46,25,21,36
S01009859,Good health,221,3,2,1,22,24,2,14,55,51,34,20,14,16
S01009859,Fair health,144,5,1,4,6,10,5,9,29,47,29,25,4,4
S01009859,Bad health,100,2,1,1,10,8,5,5,20,31,18,15,3,1
S01009859,Very bad health,30,1,0,1,3,4,1,1,4,12,4,4,0,0
S01009860,All people aged 16 to 74,715,12,1,11,64,88,11,65,139,172,111,85,26,53
S01009860,Very good health,220,6,0,6,27,29,5,16,36,37,27,16,11,37
S01009860,Good health,237,5,1,4,26,37,2,18,52,50,32,23,9,15
S01009860,Fair health,122,1,0,1,8,9,1,23,26,38,16,12,4,0
S01009860,Bad health,106,0,0,0,2,8,3,5,21,38,28,26,2,1
S01009860,Very bad health,30,0,0,0,1,5,0,3,4,9,8,8,0,0
S01009861,All people aged 16 to 74,802,21,0,21,108,70,32,64,130,157,145,116,29,75
S01009861,Very good health,301,9,0,9,60,24,16,15,39,48,44,37,7,46
S01009861,Good health,269,10,0,10,35,27,6,31,55,38,41,25,16,26
S01009861,Fair health,131,2,0,2,8,10,4,9,20,40,35,29,6,3
S01009861,Bad health,74,0,0,0,3,7,6,8,12,18,20,20,0,0
S01009861,Very bad health,27,0,0,0,2,2,0,1,4,13,5,5,0,0
S01009862,All people aged 16 to 74,866,30,4,26,96,114,42,84,143,168,113,70,43,76
S01009862,Very good health,330,16,3,13,42,42,18,32,51,52,25,15,10,52
S01009862,Good health,274,9,0,9,37,42,10,28,38,44,43,23,20,23
S01009862,Fair health,152,2,0,2,12,19,9,14,33,36,27,18,9,0
S01009862,Bad health,84,2,0,2,3,10,4,8,15,29,12,9,3,1
S01009862,Very bad health,26,1,1,0,2,1,1,2,6,7,6,5,1,0
S01009863,All people aged 16 to 74,662,32,5,27,85,80,38,54,139,87,78,61,17,69
S01009863,Very good health,300,20,4,16,47,37,17,26,60,30,17,11,6,46
S01009863,Good health,195,7,0,7,28,24,10,11,41,23,33,25,8,18
S01009863,Fair health,111,3,0,3,5,14,8,10,29,21,16,14,2,5
S01009863,Bad health,42,1,0,1,3,4,2,4,7,12,9,8,1,0
S01009863,Very bad health,14,1,1,0,2,1,1,3,2,1,3,3,0,0
S01009864,All people aged 16 to 74,494,40,3,37,75,53,21,31,55,75,73,59,14,71
S01009864,Very good health,219,21,2,19,47,24,8,10,15,21,25,19,6,48
S01009864,Good health,167,17,1,16,19,21,9,12,21,29,22,19,3,17
S01009864,Fair health,73,2,0,2,7,6,2,4,12,17,18,13,5,5
S01009864,Bad health,25,0,0,0,2,0,0,5,5,5,7,7,0,1
S01009864,Very bad health,10,0,0,0,0,2,2,0,2,3,1,1,0,0
S01009865,All people aged 16 to 74,375,23,2,21,51,54,27,32,67,45,44,32,12,32
S01009865,Very good health,151,17,1,16,29,16,5,15,32,10,6,5,1,21
S01009865,Good health,135,5,1,4,14,26,13,10,21,14,21,16,5,11
S01009865,Fair health,51,1,0,1,4,8,9,3,9,11,6,3,3,0
S01009865,Bad health,27,0,0,0,4,3,0,2,3,7,8,6,2,0
S01009865,Very bad health,11,0,0,0,0,1,0,2,2,3,3,2,1,0
S01009866,All people aged 16 to 74,723,37,5,32,116,110,35,74,112,113,58,40,18,68
S01009866,Very good health,317,22,5,17,69,49,16,27,42,31,14,8,6,47
S01009866,Good health,250,9,0,9,38,43,10,35,41,42,17,13,4,15
S01009866,Fair health,98,3,0,3,7,13,6,6,20,24,15,8,7,4
S01009866,Bad health,42,3,0,3,2,4,1,4,8,10,9,8,1,1
S01009866,Very bad health,16,0,0,0,0,1,2,2,1,6,3,3,0,1
S01009867,All people aged 16 to 74,877,137,17,120,207,143,54,40,87,79,36,24,12,94
S01009867,Very good health,494,99,11,88,124,81,25,22,48,25,10,4,6,60
S01009867,Good health,247,26,3,23,66,47,23,10,19,22,4,2,2,30
S01009867,Fair health,93,10,3,7,14,9,5,7,13,19,13,9,4,3
S01009867,Bad health,33,2,0,2,2,4,0,1,4,11,8,8,0,1
S01009867,Very bad health,10,0,0,0,1,2,1,0,3,2,1,1,0,0
S01009868,All people aged 16 to 74,558,61,5,56,97,70,27,41,73,76,43,33,10,70
S01009868,Very good health,278,36,1,35,50,32,13,17,43,29,17,11,6,41
S01009868,Good health,199,20,4,16,34,28,7,17,21,28,15,11,4,29
S01009868,Fair health,54,5,0,5,12,8,4,5,6,11,3,3,0,0
S01009868,Bad health,20,0,0,0,1,2,3,2,0,7,5,5,0,0
S01009868,Very bad health,7,0,0,0,0,0,0,0,3,1,3,3,0,0
S01009869,All people aged 16 to 74,455,32,6,26,77,55,27,38,61,34,36,24,12,95
S01009869,Very good health,263,20,3,17,49,29,12,16,30,15,20,13,7,72
S01009869,Good health,142,9,2,7,22,23,8,13,22,16,7,5,2,22
S01009869,Fair health,34,3,1,2,1,2,6,6,7,2,6,3,3,1
S01009869,Bad health,13,0,0,0,3,1,1,3,2,1,2,2,0,0
S01009869,Very bad health,3,0,0,0,2,0,0,0,0,0,1,1,0,0
S01009870,All people aged 16 to 74,481,25,0,25,74,52,27,36,59,66,71,59,12,71
S01009870,Very good health,240,14,0,14,41,30,11,15,30,21,32,28,4,46
S01009870,Good health,147,10,0,10,26,21,8,14,10,20,21,17,4,17
S01009870,Fair health,65,1,0,1,5,0,7,2,14,17,11,8,3,8
S01009870,Bad health,19,0,0,0,2,0,1,2,4,6,4,3,1,0
S01009870,Very bad health,10,0,0,0,0,1,0,3,1,2,3,3,0,0
S01009871,All people aged 16 to 74,719,60,10,50,120,91,53,44,105,95,68,50,18,83
S01009871,Very good health,279,37,4,33,59,36,25,14,35,14,17,9,8,42
S01009871,Good health,226,16,4,12,35,34,18,13,29,29,18,16,2,34
S01009871,Fair health,123,5,1,4,15,12,8,12,21,24,19,13,6,7
S01009871,Bad health,64,1,0,1,7,5,1,5,15,18,12,10,2,0
S01009871,Very bad health,27,1,1,0,4,4,1,0,5,10,2,2,0,0
S01009872,All people aged 16 to 74,580,44,6,38,108,71,40,45,69,56,61,43,18,86
S01009872,Very good health,281,24,1,23,61,34,18,13,27,24,21,14,7,59
S01009872,Good health,197,13,3,10,38,29,8,15,31,14,28,19,9,21
S01009872,Fair health,74,6,2,4,6,5,11,10,9,13,9,7,2,5
S01009872,Bad health,18,1,0,1,2,3,3,5,1,3,0,0,0,0
S01009872,Very bad health,10,0,0,0,1,0,0,2,1,2,3,3,0,1
S01009873,All people aged 16 to 74,684,96,9,87,150,76,74,29,58,65,74,55,19,62
S01009873,Very good health,350,74,7,67,78,41,32,11,25,17,21,11,10,51
S01009873,Good health,181,18,0,18,47,20,20,7,19,17,26,22,4,7
S01009873,Fair health,94,3,1,2,19,6,16,6,8,19,14,9,5,3
S01009873,Bad health,42,1,1,0,3,7,5,3,4,8,10,10,0,1
S01009873,Very bad health,17,0,0,0,3,2,1,2,2,4,3,3,0,0
S01009874,All people aged 16 to 74,782,89,14,75,150,98,55,46,125,92,54,30,24,73
S01009874,Very good health,379,54,11,43,77,45,27,20,62,34,16,5,11,44
S01009874,Good health,241,28,3,25,54,37,18,11,27,25,17,9,8,24
S01009874,Fair health,96,7,0,7,14,10,4,7,21,17,11,8,3,5
S01009874,Bad health,46,0,0,0,3,6,4,6,10,11,6,4,2,0
S01009874,Very bad health,20,0,0,0,2,0,2,2,5,5,4,4,0,0
S01009875,All people aged 16 to 74,504,31,3,28,61,51,34,27,58,48,102,91,11,92
S01009875,Very good health,254,20,2,18,36,28,14,9,36,17,25,25,0,69
S01009875,Good health,149,10,1,9,17,14,12,7,18,12,37,30,7,22
S01009875,Fair health,50,0,0,0,2,8,4,3,3,9,20,17,3,1
S01009875,Bad health,39,0,0,0,4,1,4,4,1,7,18,17,1,0
S01009875,Very bad health,12,1,0,1,2,0,0,4,0,3,2,2,0,0
S01009876,All people aged 16 to 74,506,8,0,8,52,46,18,32,92,64,110,88,22,84
S01009876,Very good health,208,4,0,4,31,13,7,12,37,17,39,31,8,48
S01009876,Good health,148,3,0,3,13,17,6,5,33,20,31,24,7,20
S01009876,Fair health,93,1,0,1,4,13,2,10,13,11,27,20,7,12
S01009876,Bad health,45,0,0,0,4,3,2,5,7,10,10,10,0,4
S01009876,Very bad health,12,0,0,0,0,0,1,0,2,6,3,3,0,0
S01009877,All people aged 16 to 74,684,145,16,129,190,52,73,17,42,25,69,62,7,71
S01009877,Very good health,399,99,9,90,116,30,37,13,22,12,16,12,4,54
S01009877,Good health,179,39,6,33,53,14,20,0,12,4,23,23,0,14
S01009877,Fair health,74,4,0,4,16,3,14,4,7,5,19,16,3,2
S01009877,Bad health,26,3,1,2,2,5,2,0,1,3,9,9,0,1
S01009877,Very bad health,6,0,0,0,3,0,0,0,0,1,2,2,0,0
S01009878,All people aged 16 to 74,517,38,4,34,66,42,52,34,55,46,100,93,7,84
S01009878,Very good health,244,27,2,25,36,24,25,17,27,20,24,24,0,44
S01009878,Good health,177,10,1,9,24,13,18,9,17,13,38,34,4,35
S01009878,Fair health,59,0,0,0,4,2,8,5,8,10,20,18,2,2
S01009878,Bad health,24,1,1,0,2,3,1,2,2,3,8,8,0,2
S01009878,Very bad health,13,0,0,0,0,0,0,1,1,0,10,9,1,1
S01009879,All people aged 16 to 74,661,199,36,163,170,46,71,18,39,15,38,34,4,65
S01009879,Very good health,425,144,28,116,115,29,39,10,16,5,15,12,3,52
S01009879,Good health,176,49,7,42,46,13,22,5,14,8,10,10,0,9
S01009879,Fair health,39,5,1,4,7,2,6,2,4,0,10,9,1,3
S01009879,Bad health,18,1,0,1,2,2,2,1,4,2,3,3,0,1
S01009879,Very bad health,3,0,0,0,0,0,2,0,1,0,0,0,0,0
S01009880,All people aged 16 to 74,568,106,15,91,94,48,56,18,56,12,97,91,6,81
S01009880,Very good health,278,65,10,55,56,23,18,6,21,5,22,18,4,62
S01009880,Good health,191,33,2,31,28,16,28,8,22,3,39,37,2,14
S01009880,Fair health,69,7,2,5,9,9,7,2,9,3,19,19,0,4
S01009880,Bad health,23,1,1,0,1,0,3,1,3,1,12,12,0,1
S01009880,Very bad health,7,0,0,0,0,0,0,1,1,0,5,5,0,0
S01009881,All people aged 16 to 74,391,23,2,21,54,39,33,24,28,41,80,76,4,69
S01009881,Very good health,173,16,1,15,27,19,17,9,10,13,25,24,1,37
S01009881,Good health,145,7,1,6,22,13,12,11,17,14,25,25,0,24
S01009881,Fair health,47,0,0,0,5,2,2,2,1,10,22,20,2,3
S01009881,Bad health,23,0,0,0,0,5,2,2,0,2,8,7,1,4
S01009881,Very bad health,3,0,0,0,0,0,0,0,0,2,0,0,0,1
S01009882,All people aged 16 to 74,925,147,11,136,227,99,68,50,90,49,77,52,25,118
S01009882,Very good health,527,106,7,99,149,55,33,34,40,13,28,22,6,69
S01009882,Good health,280,36,3,33,56,35,22,11,29,20,27,13,14,44
S01009882,Fair health,69,5,1,4,14,6,11,3,14,5,9,6,3,2
S01009882,Bad health,38,0,0,0,7,3,2,2,4,9,8,6,2,3
S01009882,Very bad health,11,0,0,0,1,0,0,0,3,2,5,5,0,0
S01009883,All people aged 16 to 74,590,41,5,36,101,42,47,34,76,42,112,100,12,95
S01009883,Very good health,295,24,1,23,65,19,17,13,33,13,41,37,4,70
S01009883,Good health,176,15,3,12,29,16,13,11,19,15,36,31,5,22
S01009883,Fair health,86,2,1,1,6,6,12,8,15,9,25,23,2,3
S01009883,Bad health,26,0,0,0,1,1,4,2,6,3,9,8,1,0
S01009883,Very bad health,7,0,0,0,0,0,1,0,3,2,1,1,0,0
S01009884,All people aged 16 to 74,615,59,6,53,144,57,48,30,71,42,90,82,8,74
S01009884,Very good health,320,39,5,34,97,30,23,12,31,7,26,22,4,55
S01009884,Good health,194,18,1,17,39,18,19,11,25,20,29,26,3,15
S01009884,Fair health,61,2,0,2,7,3,3,4,9,8,23,22,1,2
S01009884,Bad health,30,0,0,0,1,6,2,3,4,6,6,6,0,2
S01009884,Very bad health,10,0,0,0,0,0,1,0,2,1,6,6,0,0
S01009885,All people aged 16 to 74,621,64,7,57,113,59,63,29,68,23,102,88,14,100
S01009885,Very good health,297,37,5,32,72,27,27,7,27,6,27,21,6,67
S01009885,Good health,202,22,1,21,30,20,17,11,29,8,37,29,8,28
S01009885,Fair health,68,2,1,1,7,3,15,5,5,5,23,23,0,3
S01009885,Bad health,42,2,0,2,3,7,4,5,5,3,11,11,0,2
S01009885,Very bad health,12,1,0,1,1,2,0,1,2,1,4,4,0,0
S01009886,All people aged 16 to 74,571,51,1,50,103,40,39,26,60,41,98,91,7,113
S01009886,Very good health,305,37,0,37,65,22,19,5,19,12,39,35,4,87
S01009886,Good health,162,7,0,7,32,12,10,15,27,12,22,22,0,25
S01009886,Fair health,81,7,1,6,3,2,7,5,14,12,30,27,3,1
S01009886,Bad health,16,0,0,0,3,2,2,0,0,3,6,6,0,0
S01009886,Very bad health,7,0,0,0,0,2,1,1,0,2,1,1,0,0
S01009887,All people aged 16 to 74,749,30,2,28,120,70,51,56,102,83,104,78,26,133
S01009887,Very good health,357,17,1,16,73,34,28,24,41,25,35,23,12,80
S01009887,Good health,235,5,1,4,30,26,12,15,37,29,37,28,9,44
S01009887,Fair health,85,5,0,5,8,8,3,7,17,11,19,16,3,7
S01009887,Bad health,62,3,0,3,7,1,6,9,6,16,12,10,2,2
S01009887,Very bad health,10,0,0,0,2,1,2,1,1,2,1,1,0,0
S01009888,All people aged 16 to 74,506,29,6,23,73,42,42,38,73,50,82,70,12,77
S01009888,Very good health,211,19,2,17,31,18,14,17,28,17,23,22,1,44
S01009888,Good health,179,5,2,3,35,14,20,14,19,20,28,22,6,24
S01009888,Fair health,86,3,1,2,4,7,8,2,24,10,23,18,5,5
S01009888,Bad health,21,1,0,1,1,2,0,5,2,1,7,7,0,2
S01009888,Very bad health,9,1,1,0,2,1,0,0,0,2,1,1,0,2
S01009889,All people aged 16 to 74,601,37,1,36,105,51,44,52,90,56,87,76,11,79
S01009889,Very good health,293,24,1,23,59,27,22,26,37,26,21,17,4,51
S01009889,Good health,183,10,0,10,35,16,8,15,30,12,31,25,6,26
S01009889,Fair health,74,2,0,2,8,3,11,8,10,10,20,20,0,2
S01009889,Bad health,39,1,0,1,3,5,1,3,9,4,13,12,1,0
S01009889,Very bad health,12,0,0,0,0,0,2,0,4,4,2,2,0,0
S01009890,All people aged 16 to 74,419,13,1,12,47,36,22,38,76,74,71,49,22,42
S01009890,Very good health,151,7,1,6,18,12,8,14,24,23,19,8,11,26
S01009890,Good health,133,5,0,5,21,13,8,8,29,18,19,14,5,12
S01009890,Fair health,69,0,0,0,5,6,3,11,11,16,16,12,4,1
S01009890,Bad health,55,1,0,1,2,5,3,5,11,14,11,9,2,3
S01009890,Very bad health,11,0,0,0,1,0,0,0,1,3,6,6,0,0
S01009891,All people aged 16 to 74,577,28,2,26,113,78,38,47,74,83,64,47,17,52
S01009891,Very good health,245,18,1,17,55,40,14,12,30,22,21,15,6,33
S01009891,Good health,188,7,1,6,40,26,9,17,28,23,21,15,6,17
S01009891,Fair health,83,2,0,2,11,10,5,10,12,23,8,3,5,2
S01009891,Bad health,46,1,0,1,4,2,9,7,3,9,11,11,0,0
S01009891,Very bad health,15,0,0,0,3,0,1,1,1,6,3,3,0,0
S01009892,All people aged 16 to 74,675,26,6,20,93,71,21,60,118,127,102,82,20,57
S01009892,Very good health,265,16,5,11,50,28,9,27,38,34,32,24,8,31
S01009892,Good health,182,5,1,4,26,27,7,12,30,28,27,21,6,20
S01009892,Fair health,121,5,0,5,15,7,4,7,30,30,22,18,4,1
S01009892,Bad health,72,0,0,0,2,7,1,9,15,22,12,10,2,4
S01009892,Very bad health,35,0,0,0,0,2,0,5,5,13,9,9,0,1
S01009893,All people aged 16 to 74,650,44,4,40,113,78,45,55,86,66,83,68,15,80
S01009893,Very good health,298,28,2,26,62,39,21,23,31,19,24,20,4,51
S01009893,Good health,222,9,1,8,32,29,15,20,37,27,31,24,7,22
S01009893,Fair health,85,5,0,5,16,7,4,5,12,10,20,16,4,6
S01009893,Bad health,26,2,1,1,2,3,4,4,2,4,4,4,0,1
S01009893,Very bad health,19,0,0,0,1,0,1,3,4,6,4,4,0,0
S01009894,All people aged 16 to 74,623,23,3,20,89,64,32,50,118,95,78,56,22,74
S01009894,Very good health,217,11,1,10,37,17,17,13,33,21,20,8,12,48
S01009894,Good health,209,5,1,4,21,28,8,21,41,41,22,17,5,22
S01009894,Fair health,112,4,0,4,18,13,5,8,28,16,16,13,3,4
S01009894,Bad health,65,3,1,2,8,6,2,5,13,12,16,14,2,0
S01009894,Very bad health,20,0,0,0,5,0,0,3,3,5,4,4,0,0
S01009895,All people aged 16 to 74,595,24,3,21,70,63,24,38,119,111,81,59,22,65
S01009895,Very good health,221,12,2,10,32,25,7,9,39,24,21,16,5,52
S01009895,Good health,157,9,1,8,23,17,12,10,37,27,13,7,6,9
S01009895,Fair health,113,1,0,1,6,12,3,5,25,31,27,16,11,3
S01009895,Bad health,64,0,0,0,7,5,0,7,14,14,16,16,0,1
S01009895,Very bad health,40,2,0,2,2,4,2,7,4,15,4,4,0,0
S01009896,All people aged 16 to 74,727,21,2,19,83,68,56,51,131,128,116,90,26,73
S01009896,Very good health,249,9,0,9,37,22,24,15,37,30,31,21,10,44
S01009896,Good health,229,7,2,5,26,22,19,15,43,41,32,19,13,24
S01009896,Fair health,139,2,0,2,11,11,8,8,21,37,37,34,3,4
S01009896,Bad health,80,3,0,3,5,9,2,11,18,16,15,15,0,1
S01009896,Very bad health,30,0,0,0,4,4,3,2,12,4,1,1,0,0
S01009897,All people aged 16 to 74,715,41,9,32,146,91,44,60,117,101,57,35,22,58
S01009897,Very good health,327,21,4,17,77,40,17,23,54,26,26,16,10,43
S01009897,Good health,228,16,4,12,48,36,14,24,34,32,11,7,4,13
S01009897,Fair health,102,3,0,3,13,9,8,10,24,17,16,9,7,2
S01009897,Bad health,41,0,0,0,6,5,5,2,4,17,2,1,1,0
S01009897,Very bad health,17,1,1,0,2,1,0,1,1,9,2,2,0,0
S01009898,All people aged 16 to 74,432,16,1,15,35,47,41,30,91,62,68,51,17,42
S01009898,Very good health,153,10,0,10,17,21,10,9,28,10,18,11,7,30
S01009898,Good health,138,3,0,3,12,12,20,8,36,19,18,13,5,10
S01009898,Fair health,71,2,0,2,3,9,4,6,15,14,17,13,4,1
S01009898,Bad health,50,1,1,0,2,2,3,6,9,15,11,10,1,1
S01009898,Very bad health,20,0,0,0,1,3,4,1,3,4,4,4,0,0
S01009899,All people aged 16 to 74,632,71,3,68,188,97,36,42,72,44,33,20,13,49
S01009899,Very good health,348,47,1,46,120,57,15,18,34,14,6,4,2,37
S01009899,Good health,174,20,2,18,57,18,14,13,15,14,13,5,8,10
S01009899,Fair health,75,3,0,3,9,16,4,6,16,11,8,6,2,2
S01009899,Bad health,22,1,0,1,0,6,3,4,4,2,2,1,1,0
S01009899,Very bad health,13,0,0,0,2,0,0,1,3,3,4,4,0,0
S01009900,All people aged 16 to 74,715,123,13,110,269,102,26,27,79,33,25,12,13,31
S01009900,Very good health,426,90,8,82,171,64,14,14,39,16,5,1,4,13
S01009900,Good health,226,27,5,22,85,31,10,5,32,8,11,6,5,17
S01009900,Fair health,41,4,0,4,12,5,2,4,4,5,4,2,2,1
S01009900,Bad health,17,2,0,2,1,2,0,1,4,3,4,2,2,0
S01009900,Very bad health,5,0,0,0,0,0,0,3,0,1,1,1,0,0
S01009901,All people aged 16 to 74,717,123,7,116,256,97,41,39,60,30,32,18,14,39
S01009901,Very good health,436,89,7,82,169,53,20,18,29,14,16,8,8,28
S01009901,Good health,192,28,0,28,65,27,11,15,19,9,8,3,5,10
S01009901,Fair health,69,5,0,5,19,14,7,5,10,4,5,4,1,0
S01009901,Bad health,13,0,0,0,3,3,0,1,2,2,1,1,0,1
S01009901,Very bad health,7,1,0,1,0,0,3,0,0,1,2,2,0,0
S01009902,All people aged 16 to 74,680,41,2,39,114,88,47,52,96,108,73,50,23,61
S01009902,Very good health,276,29,0,29,62,38,15,15,32,22,17,8,9,46
S01009902,Good health,205,9,2,7,38,30,19,18,30,32,18,13,5,11
S01009902,Fair health,134,1,0,1,13,13,11,13,20,35,24,18,6,4
S01009902,Bad health,49,0,0,0,1,7,1,4,13,15,8,6,2,0
S01009902,Very bad health,16,2,0,2,0,0,1,2,1,4,6,5,1,0
S01009903,All people aged 16 to 74,639,101,17,84,173,54,53,29,66,38,63,60,3,62
S01009903,Very good health,344,72,9,63,109,23,18,11,27,14,23,22,1,47
S01009903,Good health,195,18,5,13,52,23,18,10,24,19,17,15,2,14
S01009903,Fair health,68,8,1,7,6,8,12,6,9,4,14,14,0,1
S01009903,Bad health,27,3,2,1,6,0,3,2,6,1,6,6,0,0
S01009903,Very bad health,5,0,0,0,0,0,2,0,0,0,3,3,0,0
S01009904,All people aged 16 to 74,614,99,15,84,205,79,36,27,42,42,25,18,7,59
S01009904,Very good health,346,71,12,59,122,45,17,9,17,14,12,10,2,39
S01009904,Good health,188,25,2,23,69,21,13,10,13,14,7,4,3,16
S01009904,Fair health,64,2,1,1,13,10,6,8,8,9,4,2,2,4
S01009904,Bad health,15,1,0,1,1,3,0,0,4,4,2,2,0,0
S01009904,Very bad health,1,0,0,0,0,0,0,0,0,1,0,0,0,0
S01009905,All people aged 16 to 74,605,56,3,53,136,58,26,34,73,43,71,50,21,108
S01009905,Very good health,309,36,1,35,81,29,15,14,33,27,25,17,8,49
S01009905,Good health,206,16,2,14,42,21,9,16,21,8,22,14,8,51
S01009905,Fair health,68,4,0,4,9,6,1,3,17,5,15,11,4,8
S01009905,Bad health,17,0,0,0,2,1,1,1,1,2,9,8,1,0
S01009905,Very bad health,5,0,0,0,2,1,0,0,1,1,0,0,0,0
S01009906,All people aged 16 to 74,543,59,6,53,134,67,31,42,57,49,42,34,8,62
S01009906,Very good health,277,37,4,33,71,36,16,17,33,13,15,13,2,39
S01009906,Good health,181,19,2,17,45,23,10,18,14,17,15,11,4,20
S01009906,Fair health,62,3,0,3,12,7,2,4,8,14,9,7,2,3
S01009906,Bad health,21,0,0,0,6,1,3,2,1,5,3,3,0,0
S01009906,Very bad health,2,0,0,0,0,0,0,1,1,0,0,0,0,0
S01009907,All people aged 16 to 74,711,41,4,37,142,85,39,34,87,64,72,46,26,147
S01009907,Very good health,325,29,0,29,83,45,17,13,33,19,18,9,9,68
S01009907,Good health,218,6,1,5,44,24,15,11,19,12,22,10,12,65
S01009907,Fair health,118,4,1,3,11,13,3,7,20,20,26,22,4,14
S01009907,Bad health,39,2,2,0,4,1,4,3,11,9,5,4,1,0
S01009907,Very bad health,11,0,0,0,0,2,0,0,4,4,1,1,0,0
S01009908,All people aged 16 to 74,827,142,13,129,264,69,58,48,89,36,40,35,5,81
S01009908,Very good health,485,105,12,93,165,36,27,26,47,12,8,7,1,59
S01009908,Good health,251,35,1,34,83,22,19,13,28,14,20,18,2,17
S01009908,Fair health,63,2,0,2,10,8,11,6,8,6,7,7,0,5
S01009908,Bad health,21,0,0,0,3,3,1,3,3,3,5,3,2,0
S01009908,Very bad health,7,0,0,0,3,0,0,0,3,1,0,0,0,0
S01009909,All people aged 16 to 74,743,112,12,100,195,106,50,35,82,45,55,36,19,63
S01009909,Very good health,407,78,8,70,127,61,23,12,35,17,14,8,6,40
S01009909,Good health,226,27,4,23,53,31,16,15,32,15,18,14,4,19
S01009909,Fair health,70,4,0,4,11,9,8,5,10,7,12,5,7,4
S01009909,Bad health,31,1,0,1,3,4,3,2,4,5,9,7,2,0
S01009909,Very bad health,9,2,0,2,1,1,0,1,1,1,2,2,0,0
S01009910,All people aged 16 to 74,444,64,10,54,142,58,21,16,49,29,22,13,9,43
S01009910,Very good health,254,42,6,36,83,33,7,10,24,14,7,6,1,34
S01009910,Good health,142,19,3,16,51,18,9,5,17,9,5,1,4,9
S01009910,Fair health,38,3,1,2,6,6,4,0,6,4,9,5,4,0
S01009910,Bad health,8,0,0,0,2,0,1,1,2,2,0,0,0,0
S01009910,Very bad health,2,0,0,0,0,1,0,0,0,0,1,1,0,0
S01009911,All people aged 16 to 74,747,137,18,119,238,77,46,34,63,49,45,34,11,58
S01009911,Very good health,407,80,10,70,147,43,18,17,29,23,9,6,3,41
S01009911,Good health,227,50,7,43,70,23,16,10,18,11,13,10,3,16
S01009911,Fair health,86,6,1,5,18,9,11,2,12,11,16,12,4,1
S01009911,Bad health,17,1,0,1,3,1,0,4,2,3,3,3,0,0
S01009911,Very bad health,10,0,0,0,0,1,1,1,2,1,4,3,1,0
S01009912,All people aged 16 to 74,660,160,21,139,172,55,67,27,38,23,50,47,3,68
S01009912,Very good health,392,107,13,94,108,30,28,14,19,12,16,14,2,58
S01009912,Good health,182,38,7,31,53,20,23,8,13,5,12,12,0,10
S01009912,Fair health,64,14,1,13,8,5,10,4,6,3,14,13,1,0
S01009912,Bad health,16,1,0,1,3,0,4,1,0,1,6,6,0,0
S01009912,Very bad health,6,0,0,0,0,0,2,0,0,2,2,2,0,0
S01009913,All people aged 16 to 74,568,96,8,88,118,53,87,19,38,22,68,61,7,67
S01009913,Very good health,346,72,5,67,79,33,43,10,22,8,23,18,5,56
S01009913,Good health,137,17,2,15,29,13,30,3,9,7,21,19,2,8
S01009913,Fair health,60,6,1,5,6,5,12,3,4,6,15,15,0,3
S01009913,Bad health,20,1,0,1,3,1,2,3,3,0,7,7,0,0
S01009913,Very bad health,5,0,0,0,1,1,0,0,0,1,2,2,0,0
S01009914,All people aged 16 to 74,733,168,25,143,197,78,90,19,48,21,37,30,7,75
S01009914,Very good health,451,102,16,86,126,42,50,10,29,14,16,11,5,62
S01009914,Good health,217,57,8,49,61,27,29,4,11,3,13,11,2,12
S01009914,Fair health,44,9,1,8,8,6,9,3,6,0,2,2,0,1
S01009914,Bad health,13,0,0,0,2,2,1,1,1,2,4,4,0,0
S01009914,Very bad health,8,0,0,0,0,1,1,1,1,2,2,2,0,0
S01009915,All people aged 16 to 74,686,166,16,150,203,63,65,21,42,21,37,31,6,68
S01009915,Very good health,410,120,12,108,124,38,33,7,21,3,9,7,2,55
S01009915,Good health,185,40,2,38,53,16,18,10,12,12,14,11,3,10
S01009915,Fair health,66,5,2,3,19,5,10,2,6,4,12,12,0,3
S01009915,Bad health,22,1,0,1,6,4,3,2,3,1,2,1,1,0
S01009915,Very bad health,3,0,0,0,1,0,1,0,0,1,0,0,0,0
S01009916,All people aged 16 to 74,703,83,7,76,137,76,109,31,62,16,105,97,8,84
S01009916,Very good health,357,54,7,47,82,33,40,11,25,3,37,31,6,72
S01009916,Good health,221,23,0,23,39,30,41,12,25,6,33,33,0,12
S01009916,Fair health,88,5,0,5,13,10,23,3,10,4,20,18,2,0
S01009916,Bad health,29,1,0,1,3,2,4,4,2,3,10,10,0,0
S01009916,Very bad health,8,0,0,0,0,1,1,1,0,0,5,5,0,0
S01009917,All people aged 16 to 74,536,122,20,102,178,67,34,18,38,20,26,22,4,33
S01009917,Very good health,317,88,14,74,117,31,15,8,16,10,8,7,1,24
S01009917,Good health,159,32,5,27,42,23,14,5,18,7,9,8,1,9
S01009917,Fair health,47,1,0,1,14,11,5,4,2,3,7,5,2,0
S01009917,Bad health,9,1,1,0,3,2,0,0,2,0,1,1,0,0
S01009917,Very bad health,4,0,0,0,2,0,0,1,0,0,1,1,0,0
S01009918,All people aged 16 to 74,546,115,9,106,177,55,43,15,39,25,32,26,6,45
S01009918,Very good health,310,75,6,69,110,29,17,9,13,9,7,5,2,41
S01009918,Good health,147,30,3,27,41,20,20,2,14,5,11,9,2,4
S01009918,Fair health,68,8,0,8,22,5,3,3,8,8,11,9,2,0
S01009918,Bad health,15,2,0,2,3,1,3,1,2,1,2,2,0,0
S01009918,Very bad health,6,0,0,0,1,0,0,0,2,2,1,1,0,0
S01009919,All people aged 16 to 74,851,85,9,76,196,126,46,44,128,81,52,36,16,93
S01009919,Very good health,413,54,6,48,113,47,22,20,52,24,15,10,5,66
S01009919,Good health,308,26,3,23,63,55,19,16,50,34,21,15,6,24
S01009919,Fair health,88,5,0,5,13,16,4,6,13,16,12,7,5,3
S01009919,Bad health,30,0,0,0,7,7,0,2,7,3,4,4,0,0
S01009919,Very bad health,12,0,0,0,0,1,1,0,6,4,0,0,0,0
S01009920,All people aged 16 to 74,741,159,11,148,236,105,34,38,59,42,21,16,5,47
S01009920,Very good health,446,117,8,109,162,59,12,14,20,20,10,7,3,32
S01009920,Good health,217,36,3,33,57,35,14,18,27,10,6,5,1,14
S01009920,Fair health,58,5,0,5,12,9,6,5,8,8,4,3,1,1
S01009920,Bad health,17,1,0,1,5,1,1,1,3,4,1,1,0,0
S01009920,Very bad health,3,0,0,0,0,1,1,0,1,0,0,0,0,0
S01009921,All people aged 16 to 74,576,96,5,91,183,95,21,36,52,16,26,14,12,51
S01009921,Very good health,321,60,3,57,111,50,11,16,24,10,5,3,2,34
S01009921,Good health,190,34,2,32,53,33,7,11,21,4,14,6,8,13
S01009921,Fair health,54,2,0,2,16,10,3,7,4,2,6,4,2,4
S01009921,Bad health,11,0,0,0,3,2,0,2,3,0,1,1,0,0
S01009921,Very bad health,0,0,0,0,0,0,0,0,0,0,0,0,0,0
S01009922,All people aged 16 to 74,893,191,19,172,283,135,40,50,65,33,29,21,8,67
S01009922,Very good health,545,148,13,135,185,68,24,24,24,18,9,6,3,45
S01009922,Good health,255,36,5,31,78,52,11,15,26,9,8,4,4,20
S01009922,Fair health,67,6,1,5,15,12,3,8,13,2,7,6,1,1
S01009922,Bad health,23,1,0,1,5,1,2,3,2,4,4,4,0,1
S01009922,Very bad health,3,0,0,0,0,2,0,0,0,0,1,1,0,0
S01009923,All people aged 16 to 74,728,74,6,68,218,119,40,49,81,62,34,19,15,51
S01009923,Very good health,350,50,2,48,114,55,14,23,36,18,10,7,3,30
S01009923,Good health,243,15,3,12,65,45,16,16,26,27,14,6,8,19
S01009923,Fair health,88,6,0,6,26,17,7,8,11,8,4,2,2,1
S01009923,Bad health,36,2,0,2,9,2,2,2,6,8,4,3,1,1
S01009923,Very bad health,11,1,1,0,4,0,1,0,2,1,2,1,1,0
S01009924,All people aged 16 to 74,850,139,18,121,230,134,43,43,84,55,43,34,9,79
S01009924,Very good health,457,98,9,89,138,75,18,20,30,24,10,7,3,44
S01009924,Good health,258,33,6,27,67,43,11,15,26,20,12,8,4,31
S01009924,Fair health,83,8,3,5,14,14,10,4,15,5,10,8,2,3
S01009924,Bad health,38,0,0,0,8,2,3,2,9,5,8,8,0,1
S01009924,Very bad health,14,0,0,0,3,0,1,2,4,1,3,3,0,0
S01009925,All people aged 16 to 74,584,111,10,101,177,103,17,22,58,26,24,14,10,46
S01009925,Very good health,334,80,9,71,111,55,6,14,24,11,6,2,4,27
S01009925,Good health,188,26,1,25,51,40,7,3,25,8,12,8,4,16
S01009925,Fair health,36,4,0,4,10,5,2,5,4,2,1,1,0,3
S01009925,Bad health,21,1,0,1,5,3,1,0,4,3,4,2,2,0
S01009925,Very bad health,5,0,0,0,0,0,1,0,1,2,1,1,0,0
S01009926,All people aged 16 to 74,606,81,8,73,205,66,33,30,61,42,40,33,7,48
S01009926,Very good health,335,50,7,43,134,36,19,10,26,14,12,8,4,34
S01009926,Good health,187,26,0,26,57,20,11,12,22,9,19,16,3,11
S01009926,Fair health,57,5,1,4,12,8,3,4,6,15,2,2,0,2
S01009926,Bad health,23,0,0,0,1,2,0,4,6,4,6,6,0,0
S01009926,Very bad health,4,0,0,0,1,0,0,0,1,0,1,1,0,1
S01009927,All people aged 16 to 74,399,68,8,60,94,51,26,21,55,33,22,11,11,29
S01009927,Very good health,210,44,5,39,56,26,10,10,23,14,5,2,3,22
S01009927,Good health,113,17,1,16,23,16,13,7,16,8,8,4,4,5
S01009927,Fair health,51,4,1,3,9,6,2,4,11,9,5,1,4,1
S01009927,Bad health,19,2,1,1,4,2,1,0,4,1,4,4,0,1
S01009927,Very bad health,6,1,0,1,2,1,0,0,1,1,0,0,0,0
S01009928,All people aged 16 to 74,701,192,31,161,254,66,51,16,46,18,20,10,10,38
S01009928,Very good health,408,137,17,120,138,36,22,11,21,8,6,2,4,29
S01009928,Good health,209,47,12,35,86,20,20,5,14,4,7,2,5,6
S01009928,Fair health,52,6,2,4,18,7,7,0,6,2,4,3,1,2
S01009928,Bad health,28,0,0,0,11,3,2,0,5,3,3,3,0,1
S01009928,Very bad health,4,2,0,2,1,0,0,0,0,1,0,0,0,0
S01009929,All people aged 16 to 74,378,83,11,72,114,52,31,19,22,22,12,7,5,23
S01009929,Very good health,202,50,4,46,66,22,14,12,7,6,4,1,3,21
S01009929,Good health,136,28,7,21,40,22,10,5,14,11,5,4,1,1
S01009929,Fair health,29,4,0,4,6,5,5,2,1,4,1,1,0,1
S01009929,Bad health,7,0,0,0,2,1,1,0,0,1,2,1,1,0
S01009929,Very bad health,4,1,0,1,0,2,1,0,0,0,0,0,0,0
S01009930,All people aged 16 to 74,726,116,13,103,222,105,49,41,80,27,30,12,18,56
S01009930,Very good health,432,81,8,73,148,59,21,20,39,12,16,5,11,36
S01009930,Good health,209,24,4,20,60,32,20,14,25,8,10,3,7,16
S01009930,Fair health,65,9,1,8,7,9,5,7,14,7,3,3,0,4
S01009930,Bad health,16,1,0,1,7,3,2,0,2,0,1,1,0,0
S01009930,Very bad health,4,1,0,1,0,2,1,0,0,0,0,0,0,0
S01009931,All people aged 16 to 74,671,143,19,124,243,99,37,30,40,18,12,5,7,49
S01009931,Very good health,437,119,14,105,157,53,21,19,23,5,7,1,6,33
S01009931,Good health,168,21,4,17,72,30,10,6,11,6,1,0,1,11
S01009931,Fair health,50,2,0,2,10,12,6,5,3,6,1,1,0,5
S01009931,Bad health,12,0,0,0,3,4,0,0,2,0,3,3,0,0
S01009931,Very bad health,4,1,1,0,1,0,0,0,1,1,0,0,0,0
S01009932,All people aged 16 to 74,539,88,9,79,179,80,35,25,45,34,16,9,7,37
S01009932,Very good health,304,59,6,53,113,40,18,11,19,19,3,1,2,22
S01009932,Good health,175,27,2,25,50,27,12,8,22,9,6,3,3,14
S01009932,Fair health,36,2,1,1,10,7,4,2,2,5,3,1,2,1
S01009932,Bad health,18,0,0,0,6,4,1,2,2,0,3,3,0,0
S01009932,Very bad health,6,0,0,0,0,2,0,2,0,1,1,1,0,0
S01009933,All people aged 16 to 74,721,48,4,44,139,82,29,62,98,122,84,49,35,57
S01009933,Very good health,269,30,2,28,77,32,7,18,27,29,19,8,11,30
S01009933,Good health,245,15,2,13,38,28,12,21,40,43,30,19,11,18
S01009933,Fair health,120,2,0,2,12,16,5,14,19,28,19,8,11,5
S01009933,Bad health,69,1,0,1,10,4,3,9,9,17,12,10,2,4
S01009933,Very bad health,18,0,0,0,2,2,2,0,3,5,4,4,0,0
S01009934,All people aged 16 to 74,696,126,21,105,204,94,43,38,77,36,30,27,3,48
S01009934,Very good health,406,90,13,77,123,61,23,20,34,9,9,8,1,37
S01009934,Good health,203,30,7,23,62,20,15,13,30,15,12,10,2,6
S01009934,Fair health,69,6,1,5,18,11,3,4,7,8,7,7,0,5
S01009934,Bad health,13,0,0,0,0,2,1,0,5,4,1,1,0,0
S01009934,Very bad health,5,0,0,0,1,0,1,1,1,0,1,1,0,0
S01009935,All people aged 16 to 74,399,16,1,15,50,45,14,39,96,78,49,33,16,12
S01009935,Very good health,99,11,1,10,17,16,1,10,20,12,6,2,4,6
S01009935,Good health,123,3,0,3,17,14,7,11,29,27,12,6,6,3
S01009935,Fair health,103,1,0,1,12,11,3,11,24,21,17,12,5,3
S01009935,Bad health,57,1,0,1,4,3,2,5,20,14,8,7,1,0
S01009935,Very bad health,17,0,0,0,0,1,1,2,3,4,6,6,0,0
S01009936,All people aged 16 to 74,518,50,4,46,103,63,27,32,77,80,48,31,17,38
S01009936,Very good health,203,30,1,29,53,25,7,10,24,20,9,7,2,25
S01009936,Good health,171,15,3,12,36,20,9,12,27,24,20,10,10,8
S01009936,Fair health,68,5,0,5,8,7,5,5,16,12,7,4,3,3
S01009936,Bad health,64,0,0,0,5,11,4,3,8,22,9,7,2,2
S01009936,Very bad health,12,0,0,0,1,0,2,2,2,2,3,3,0,0
S01009937,All people aged 16 to 74,336,9,4,5,38,35,13,24,48,57,66,47,19,46
S01009937,Very good health,113,2,1,1,12,12,4,13,20,14,15,10,5,21
S01009937,Good health,116,3,1,2,17,13,4,6,12,14,33,22,11,14
S01009937,Fair health,70,3,1,2,5,4,4,2,8,21,14,11,3,9
S01009937,Bad health,29,1,1,0,4,5,0,2,5,6,4,4,0,2
S01009937,Very bad health,8,0,0,0,0,1,1,1,3,2,0,0,0,0
S01009938,All people aged 16 to 74,681,33,4,29,106,71,38,61,141,125,62,46,16,44
S01009938,Very good health,250,18,2,16,57,26,21,16,34,27,15,11,4,36
S01009938,Good health,204,11,2,9,29,26,9,20,54,30,19,12,7,6
S01009938,Fair health,119,3,0,3,13,12,6,11,23,33,16,12,4,2
S01009938,Bad health,83,1,0,1,5,7,2,9,26,25,8,7,1,0
S01009938,Very bad health,25,0,0,0,2,0,0,5,4,10,4,4,0,0
S01009939,All people aged 16 to 74,664,8,0,8,44,51,21,40,118,116,217,160,57,49
S01009939,Very good health,197,6,0,6,17,21,5,15,41,25,52,29,23,15
S01009939,Good health,223,1,0,1,8,12,7,11,36,43,81,63,18,24
S01009939,Fair health,150,1,0,1,8,11,6,10,26,20,59,48,11,9
S01009939,Bad health,70,0,0,0,6,6,3,3,14,21,16,13,3,1
S01009939,Very bad health,24,0,0,0,5,1,0,1,1,7,9,7,2,0
S01009940,All people aged 16 to 74,636,9,1,8,49,65,28,57,160,151,85,61,24,32
S01009940,Very good health,171,5,1,4,19,20,8,19,38,29,19,14,5,14
S01009940,Good health,215,2,0,2,18,24,5,14,63,49,26,14,12,14
S01009940,Fair health,138,2,0,2,7,13,11,12,36,38,18,13,5,1
S01009940,Bad health,86,0,0,0,3,6,2,11,20,22,19,17,2,3
S01009940,Very bad health,26,0,0,0,2,2,2,1,3,13,3,3,0,0
S01009941,All people aged 16 to 74,739,39,2,37,129,99,70,48,114,60,68,54,14,112
S01009941,Very good health,348,27,1,26,63,58,23,16,45,23,20,15,5,73
S01009941,Good health,278,10,1,9,50,31,32,23,48,25,25,19,6,34
S01009941,Fair health,84,1,0,1,12,7,10,8,17,9,16,14,2,4
S01009941,Bad health,24,1,0,1,3,2,5,1,3,2,6,5,1,1
S01009941,Very bad health,5,0,0,0,1,1,0,0,1,1,1,1,0,0
S01009942,All people aged 16 to 74,763,8,0,8,66,80,29,53,158,191,115,91,24,63
S01009942,Very good health,280,6,0,6,32,34,11,21,60,50,26,21,5,40
S01009942,Good health,249,2,0,2,22,31,11,14,49,66,34,23,11,20
S01009942,Fair health,134,0,0,0,6,8,1,10,26,47,35,28,7,1
S01009942,Bad health,77,0,0,0,5,5,6,6,19,21,13,12,1,2
S01009942,Very bad health,23,0,0,0,1,2,0,2,4,7,7,7,0,0
S01009943,All people aged 16 to 74,631,9,4,5,46,63,24,50,147,168,81,56,25,43
S01009943,Very good health,229,6,3,3,21,27,10,17,47,45,24,18,6,32
S01009943,Good health,157,3,1,2,11,22,8,6,36,46,17,7,10,8
S01009943,Fair health,140,0,0,0,11,10,2,18,30,48,19,12,7,2
S01009943,Bad health,81,0,0,0,2,3,2,6,30,24,13,11,2,1
S01009943,Very bad health,24,0,0,0,1,1,2,3,4,5,8,8,0,0
S01009944,All people aged 16 to 74,590,31,1,30,83,93,38,49,112,80,35,21,14,69
S01009944,Very good health,280,23,0,23,42,48,19,21,37,28,17,7,10,45
S01009944,Good health,168,3,1,2,25,31,13,17,30,23,7,3,4,19
S01009944,Fair health,79,2,0,2,5,8,4,7,29,14,7,7,0,3
S01009944,Bad health,44,2,0,2,6,5,2,3,12,10,3,3,0,1
S01009944,Very bad health,19,1,0,1,5,1,0,1,4,5,1,1,0,1
S01009945,All people aged 16 to 74,683,26,4,22,96,109,31,48,154,96,64,38,26,59
S01009945,Very good health,285,22,3,19,44,45,15,23,44,33,16,8,8,43
S01009945,Good health,218,2,0,2,39,35,7,15,55,30,23,13,10,12
S01009945,Fair health,112,0,0,0,8,17,7,7,31,19,20,12,8,3
S01009945,Bad health,46,2,1,1,3,7,0,3,19,8,4,4,0,0
S01009945,Very bad health,22,0,0,0,2,5,2,0,5,6,1,1,0,1
S01009946,All people aged 16 to 74,619,26,7,19,112,85,29,42,113,113,45,33,12,54
S01009946,Very good health,272,14,3,11,52,40,11,17,46,40,17,12,5,35
S01009946,Good health,202,10,3,7,42,26,10,14,41,32,11,7,4,16
S01009946,Fair health,89,1,0,1,11,13,4,7,17,24,9,6,3,3
S01009946,Bad health,39,1,1,0,5,4,3,4,9,8,5,5,0,0
S01009946,Very bad health,17,0,0,0,2,2,1,0,0,9,3,3,0,0
S01009947,All people aged 16 to 74,416,31,4,27,73,48,21,31,82,57,45,30,15,28
S01009947,Very good health,178,26,4,22,38,17,8,7,33,14,15,9,6,20
S01009947,Good health,144,2,0,2,26,18,7,15,27,26,15,9,6,8
S01009947,Fair health,53,3,0,3,6,7,6,5,10,9,7,4,3,0
S01009947,Bad health,34,0,0,0,2,6,0,3,11,7,5,5,0,0
S01009947,Very bad health,7,0,0,0,1,0,0,1,1,1,3,3,0,0
S01009948,All people aged 16 to 74,595,23,6,17,73,68,38,42,123,110,61,35,26,57
S01009948,Very good health,212,14,1,13,33,31,7,12,39,21,22,9,13,33
S01009948,Good health,195,8,5,3,25,23,12,14,35,37,20,11,9,21
S01009948,Fair health,115,1,0,1,11,9,12,11,35,26,8,4,4,2
S01009948,Bad health,55,0,0,0,4,5,3,4,10,22,6,6,0,1
S01009948,Very bad health,18,0,0,0,0,0,4,1,4,4,5,5,0,0
S01009949,All people aged 16 to 74,590,42,1,41,103,93,27,56,101,67,49,24,25,52
S01009949,Very good health,293,29,0,29,52,51,14,23,40,23,25,9,16,36
S01009949,Good health,189,10,0,10,36,33,7,20,37,23,11,3,8,12
S01009949,Fair health,68,2,0,2,15,4,5,6,11,13,9,9,0,3
S01009949,Bad health,25,1,1,0,0,4,0,2,9,7,2,2,0,0
S01009949,Very bad health,15,0,0,0,0,1,1,5,4,1,2,1,1,1
S01009950,All people aged 16 to 74,547,132,21,111,165,49,42,15,36,23,21,13,8,64
S01009950,Very good health,337,91,13,78,101,29,20,5,21,11,7,2,5,52
S01009950,Good health,165,35,8,27,57,14,18,8,9,7,7,5,2,10
S01009950,Fair health,27,6,0,6,4,5,3,1,1,4,1,0,1,2
S01009950,Bad health,15,0,0,0,3,0,1,1,5,1,4,4,0,0
S01009950,Very bad health,3,0,0,0,0,1,0,0,0,0,2,2,0,0
S01009951,All people aged 16 to 74,576,180,18,162,142,32,67,7,33,15,32,28,4,68
S01009951,Very good health,370,131,12,119,93,20,25,5,19,9,12,10,2,56
S01009951,Good health,159,42,6,36,38,11,32,2,9,3,12,12,0,10
S01009951,Fair health,35,6,0,6,9,1,7,0,2,3,5,4,1,2
S01009951,Bad health,9,1,0,1,1,0,2,0,2,0,3,2,1,0
S01009951,Very bad health,3,0,0,0,1,0,1,0,1,0,0,0,0,0
S01009952,All people aged 16 to 74,525,110,22,88,155,75,32,22,44,21,20,13,7,46
S01009952,Very good health,308,81,14,67,94,40,8,12,19,9,7,3,4,38
S01009952,Good health,154,26,7,19,47,23,14,5,20,5,7,6,1,7
S01009952,Fair health,44,1,1,0,10,9,8,3,3,5,5,3,2,0
S01009952,Bad health,16,2,0,2,3,3,1,1,2,2,1,1,0,1
S01009952,Very bad health,3,0,0,0,1,0,1,1,0,0,0,0,0,0
S01009953,All people aged 16 to 74,669,118,18,100,183,87,46,39,69,53,26,22,4,48
S01009953,Very good health,398,77,10,67,116,45,28,17,37,22,12,8,4,44
S01009953,Good health,189,33,7,26,50,33,10,17,20,14,9,9,0,3
S01009953,Fair health,52,7,0,7,11,5,3,3,7,10,5,5,0,1
S01009953,Bad health,26,1,1,0,5,4,3,2,5,6,0,0,0,0
S01009953,Very bad health,4,0,0,0,1,0,2,0,0,1,0,0,0,0
S01009954,All people aged 16 to 74,493,68,14,54,103,61,55,15,56,25,48,40,8,62
S01009954,Very good health,270,42,11,31,68,29,21,10,24,7,15,9,6,54
S01009954,Good health,160,19,2,17,28,24,29,3,22,11,17,15,2,7
S01009954,Fair health,47,4,0,4,4,7,5,2,8,5,12,12,0,0
S01009954,Bad health,14,3,1,2,2,1,0,0,2,2,3,3,0,1
S01009954,Very bad health,2,0,0,0,1,0,0,0,0,0,1,1,0,0
S01009955,All people aged 16 to 74,716,108,12,96,151,102,41,38,101,62,48,36,12,65
S01009955,Very good health,366,71,8,63,89,46,21,20,40,16,14,9,5,49
S01009955,Good health,235,34,3,31,45,44,9,10,39,24,16,10,6,14
S01009955,Fair health,73,3,1,2,13,9,9,4,10,12,11,11,0,2
S01009955,Bad health,35,0,0,0,3,1,2,4,10,9,6,5,1,0
S01009955,Very bad health,7,0,0,0,1,2,0,0,2,1,1,1,0,0
S01009956,All people aged 16 to 74,539,47,7,40,114,82,38,39,68,50,45,29,16,56
S01009956,Very good health,282,32,5,27,70,46,23,16,27,11,13,8,5,44
S01009956,Good health,154,10,2,8,32,21,10,13,24,22,13,8,5,9
S01009956,Fair health,66,4,0,4,9,9,3,5,12,11,12,7,5,1
S01009956,Bad health,26,1,0,1,2,4,0,5,3,4,5,4,1,2
S01009956,Very bad health,11,0,0,0,1,2,2,0,2,2,2,2,0,0
S01009957,All people aged 16 to 74,558,150,15,135,161,66,50,25,36,19,8,5,3,43
S01009957,Very good health,375,113,13,100,115,39,30,12,13,13,4,2,2,36
S01009957,Good health,140,29,2,27,37,22,16,10,15,4,2,1,1,5
S01009957,Fair health,32,6,0,6,8,4,4,2,4,1,2,2,0,1
S01009957,Bad health,7,1,0,1,1,0,0,1,4,0,0,0,0,0
S01009957,Very bad health,4,1,0,1,0,1,0,0,0,1,0,0,0,1
S01009958,All people aged 16 to 74,694,136,14,122,223,107,47,34,64,27,14,8,6,42
S01009958,Very good health,385,94,10,84,134,45,18,18,27,17,4,1,3,28
S01009958,Good health,231,37,4,33,66,40,24,12,30,6,6,4,2,10
S01009958,Fair health,60,5,0,5,17,19,3,3,5,3,3,2,1,2
S01009958,Bad health,17,0,0,0,6,2,2,1,2,1,1,1,0,2
S01009958,Very bad health,1,0,0,0,0,1,0,0,0,0,0,0,0,0
S01009959,All people aged 16 to 74,468,102,13,89,137,55,43,15,37,16,19,17,2,44
S01009959,Very good health,280,72,10,62,74,24,23,10,16,11,9,8,1,41
S01009959,Good health,140,28,3,25,51,25,12,2,14,4,1,1,0,3
S01009959,Fair health,34,2,0,2,9,4,6,1,6,0,6,5,1,0
S01009959,Bad health,10,0,0,0,2,2,1,2,1,1,1,1,0,0
S01009959,Very bad health,4,0,0,0,1,0,1,0,0,0,2,2,0,0
S01009960,All people aged 16 to 74,611,131,21,110,175,85,45,17,44,18,29,25,4,67
S01009960,Very good health,385,101,13,88,108,54,20,8,17,6,9,5,4,62
S01009960,Good health,159,24,8,16,53,22,19,7,13,3,13,13,0,5
S01009960,Fair health,52,6,0,6,12,8,6,0,10,5,5,5,0,0
S01009960,Bad health,9,0,0,0,1,1,0,2,1,3,1,1,0,0
S01009960,Very bad health,6,0,0,0,1,0,0,0,3,1,1,1,0,0
S01009961,All people aged 16 to 74,508,35,7,28,127,82,41,38,67,48,25,18,7,45
S01009961,Very good health,270,22,5,17,70,43,18,19,33,20,6,3,3,39
S01009961,Good health,143,7,2,5,36,25,11,14,25,16,4,1,3,5
S01009961,Fair health,50,2,0,2,12,12,8,1,4,7,3,3,0,1
S01009961,Bad health,32,2,0,2,4,2,4,3,2,4,11,11,0,0
S01009961,Very bad health,13,2,0,2,5,0,0,1,3,1,1,0,1,0
S01009962,All people aged 16 to 74,810,93,11,82,206,145,50,70,113,62,32,19,13,39
S01009962,Very good health,444,66,8,58,129,85,22,36,49,26,4,2,2,27
S01009962,Good health,229,23,2,21,59,41,15,24,33,16,12,5,7,6
S01009962,Fair health,87,2,0,2,15,15,8,5,20,10,8,4,4,4
S01009962,Bad health,39,1,0,1,3,3,5,4,10,8,4,4,0,1
S01009962,Very bad health,11,1,1,0,0,1,0,1,1,2,4,4,0,1
S01009963,All people aged 16 to 74,605,56,11,45,159,103,58,54,61,45,12,9,3,57
S01009963,Very good health,344,38,10,28,83,58,31,36,34,18,2,1,1,44
S01009963,Good health,184,15,1,14,58,27,22,12,20,16,5,4,1,9
S01009963,Fair health,59,2,0,2,15,11,3,5,5,10,4,3,1,4
S01009963,Bad health,16,1,0,1,3,7,1,1,2,1,0,0,0,0
S01009963,Very bad health,2,0,0,0,0,0,1,0,0,0,1,1,0,0
S01009964,All people aged 16 to 74,701,109,19,90,219,94,56,39,59,32,32,22,10,61
S01009964,Very good health,392,68,10,58,137,46,28,17,25,11,12,9,3,48
S01009964,Good health,219,33,8,25,64,33,16,18,20,12,12,6,6,11
S01009964,Fair health,65,6,1,5,10,12,9,3,10,7,6,5,1,2
S01009964,Bad health,18,2,0,2,5,3,3,1,1,1,2,2,0,0
S01009964,Very bad health,7,0,0,0,3,0,0,0,3,1,0,0,0,0
S01009965,All people aged 16 to 74,546,44,11,33,142,99,37,40,75,49,18,9,9,42
S01009965,Very good health,292,20,5,15,83,48,17,23,35,22,6,2,4,38
S01009965,Good health,173,16,3,13,44,32,16,11,30,15,7,4,3,2
S01009965,Fair health,61,6,2,4,10,14,4,4,7,10,4,2,2,2
S01009965,Bad health,16,1,0,1,4,5,0,2,2,1,1,1,0,0
S01009965,Very bad health,4,1,1,0,1,0,0,0,1,1,0,0,0,0
S01009966,All people aged 16 to 74,597,47,15,32,129,113,31,55,89,60,18,9,9,55
S01009966,Very good health,270,22,5,17,64,49,11,22,38,20,7,2,5,37
S01009966,Good health,232,22,9,13,52,47,13,23,29,27,5,1,4,14
S01009966,Fair health,68,1,0,1,11,10,6,9,18,6,4,4,0,3
S01009966,Bad health,19,1,1,0,1,4,1,1,4,5,1,1,0,1
S01009966,Very bad health,8,1,0,1,1,3,0,0,0,2,1,1,0,0
S01009967,All people aged 16 to 74,626,116,27,89,222,90,42,25,49,19,12,5,7,51
S01009967,Very good health,388,78,15,63,145,51,21,13,17,8,8,3,5,47
S01009967,Good health,170,28,9,19,64,26,13,5,22,8,2,1,1,2
S01009967,Fair health,45,10,3,7,6,7,5,4,8,2,1,1,0,2
S01009967,Bad health,18,0,0,0,5,5,2,3,1,1,1,0,1,0
S01009967,Very bad health,5,0,0,0,2,1,1,0,1,0,0,0,0,0
S01009968,All people aged 16 to 74,468,17,7,10,103,106,34,34,75,45,15,11,4,39
S01009968,Very good health,239,10,4,6,55,58,11,15,33,18,7,4,3,32
S01009968,Good health,154,7,3,4,37,31,13,12,29,16,3,2,1,6
S01009968,Fair health,55,0,0,0,9,13,7,4,10,7,4,4,0,1
S01009968,Bad health,17,0,0,0,2,3,2,2,3,4,1,1,0,0
S01009968,Very bad health,3,0,0,0,0,1,1,1,0,0,0,0,0,0
S01009969,All people aged 16 to 74,626,117,24,93,164,90,54,34,58,29,24,14,10,56
S01009969,Very good health,343,71,16,55,103,48,25,14,19,8,6,2,4,49
S01009969,Good health,203,37,4,33,46,29,25,17,20,12,11,6,5,6
S01009969,Fair health,54,8,3,5,11,8,2,2,15,3,5,5,0,0
S01009969,Bad health,20,0,0,0,3,4,2,1,4,4,2,1,1,0
S01009969,Very bad health,6,1,1,0,1,1,0,0,0,2,0,0,0,1
S01009970,All people aged 16 to 74,655,10,2,8,52,89,23,53,142,135,95,53,42,56
S01009970,Very good health,221,4,0,4,23,37,8,14,45,33,22,10,12,35
S01009970,Good health,219,3,1,2,16,27,13,23,49,40,31,17,14,17
S01009970,Fair health,138,2,1,1,9,17,1,10,31,37,28,14,14,3
S01009970,Bad health,55,1,0,1,1,6,0,3,15,15,14,12,2,0
S01009970,Very bad health,22,0,0,0,3,2,1,3,2,10,0,0,0,1
S01009971,All people aged 16 to 74,834,28,6,22,109,84,52,67,160,189,92,53,39,53
S01009971,Very good health,320,17,3,14,60,37,28,27,48,47,17,10,7,39
S01009971,Good health,229,5,2,3,27,21,11,20,42,55,37,15,22,11
S01009971,Fair health,169,4,1,3,13,14,10,12,35,52,26,19,7,3
S01009971,Bad health,80,2,0,2,9,8,1,6,21,28,5,3,2,0
S01009971,Very bad health,36,0,0,0,0,4,2,2,14,7,7,6,1,0
S01009972,All people aged 16 to 74,578,36,6,30,133,81,46,54,73,68,41,31,10,46
S01009972,Very good health,297,21,4,17,81,43,26,29,35,17,11,6,5,34
S01009972,Good health,166,13,2,11,38,22,11,19,20,24,9,7,2,10
S01009972,Fair health,72,2,0,2,11,10,4,3,9,17,14,11,3,2
S01009972,Bad health,37,0,0,0,3,6,4,3,8,8,5,5,0,0
S01009972,Very bad health,6,0,0,0,0,0,1,0,1,2,2,2,0,0
S01009973,All people aged 16 to 74,553,20,3,17,86,73,26,47,109,116,37,23,14,39
S01009973,Very good health,259,14,3,11,43,43,10,21,41,44,11,7,4,32
S01009973,Good health,182,4,0,4,38,22,11,14,45,30,12,4,8,6
S01009973,Fair health,71,1,0,1,4,6,5,7,16,24,8,6,2,0
S01009973,Bad health,26,1,0,1,1,1,0,2,5,10,5,5,0,1
S01009973,Very bad health,15,0,0,0,0,1,0,3,2,8,1,1,0,0
S01009974,All people aged 16 to 74,434,8,0,8,24,49,18,31,105,114,68,43,25,17
S01009974,Very good health,137,1,0,1,9,23,4,9,34,23,21,10,11,13
S01009974,Good health,138,5,0,5,11,15,6,9,37,36,17,8,9,2
S01009974,Fair health,91,2,0,2,2,7,3,4,20,26,25,21,4,2
S01009974,Bad health,51,0,0,0,0,4,3,5,12,22,5,4,1,0
S01009974,Very bad health,17,0,0,0,2,0,2,4,2,7,0,0,0,0
S01009975,All people aged 16 to 74,580,5,0,5,35,47,23,40,149,137,113,94,19,31
S01009975,Very good health,174,3,0,3,14,17,8,14,42,27,31,25,6,18
S01009975,Good health,145,1,0,1,9,12,6,6,47,30,23,17,6,11
S01009975,Fair health,142,1,0,1,8,10,4,9,27,43,39,32,7,1
S01009975,Bad health,91,0,0,0,3,7,3,10,24,30,13,13,0,1
S01009975,Very bad health,28,0,0,0,1,1,2,1,9,7,7,7,0,0
S01009976,All people aged 16 to 74,372,4,0,4,36,43,14,27,82,99,49,37,12,18
S01009976,Very good health,110,2,0,2,14,21,7,7,16,24,7,2,5,12
S01009976,Good health,126,1,0,1,14,18,2,12,36,31,8,3,5,4
S01009976,Fair health,80,1,0,1,3,2,3,7,13,24,25,23,2,2
S01009976,Bad health,42,0,0,0,4,1,1,1,15,13,7,7,0,0
S01009976,Very bad health,14,0,0,0,1,1,1,0,2,7,2,2,0,0
S01009977,All people aged 16 to 74,738,13,1,12,67,60,17,54,141,206,135,88,47,45
S01009977,Very good health,171,7,1,6,15,15,4,7,37,29,31,19,12,26
S01009977,Good health,211,5,0,5,21,17,7,17,42,52,37,22,15,13
S01009977,Fair health,195,0,0,0,24,16,3,14,29,69,37,25,12,3
S01009977,Bad health,117,1,0,1,6,10,3,13,23,41,19,11,8,1
S01009977,Very bad health,44,0,0,0,1,2,0,3,10,15,11,11,0,2
S01009978,All people aged 16 to 74,747,16,6,10,77,64,27,59,177,158,103,69,34,66
S01009978,Very good health,269,8,3,5,32,28,8,22,63,40,26,17,9,42
S01009978,Good health,244,3,1,2,29,26,12,21,59,48,28,15,13,18
S01009978,Fair health,119,4,1,3,7,6,5,6,25,34,28,19,9,4
S01009978,Bad health,83,1,1,0,7,1,1,6,24,29,13,10,3,1
S01009978,Very bad health,32,0,0,0,2,3,1,4,6,7,8,8,0,1
S01009979,All people aged 16 to 74,408,4,0,4,31,39,16,31,96,122,54,40,14,15
S01009979,Very good health,111,2,0,2,16,12,5,10,19,28,9,4,5,10
S01009979,Good health,125,1,0,1,10,11,4,7,36,34,18,12,6,4
S01009979,Fair health,109,1,0,1,3,10,2,8,28,36,20,17,3,1
S01009979,Bad health,43,0,0,0,1,5,3,2,10,16,6,6,0,0
S01009979,Very bad health,20,0,0,0,1,1,2,4,3,8,1,1,0,0
S01009980,All people aged 16 to 74,481,6,2,4,33,47,10,30,98,124,94,69,25,39
S01009980,Very good health,161,3,1,2,8,16,2,11,42,27,20,11,9,32
S01009980,Good health,141,0,0,0,13,16,4,8,29,33,31,24,7,7
S01009980,Fair health,115,0,0,0,8,11,3,8,15,43,27,21,6,0
S01009980,Bad health,47,2,1,1,3,2,1,2,8,16,13,10,3,0
S01009980,Very bad health,17,1,0,1,1,2,0,1,4,5,3,3,0,0
S01009981,All people aged 16 to 74,496,17,3,14,52,47,12,35,100,121,83,53,30,29
S01009981,Very good health,173,11,0,11,17,17,6,9,30,36,25,7,18,22
S01009981,Good health,147,2,1,1,21,15,3,14,31,34,23,17,6,4
S01009981,Fair health,97,1,0,1,8,10,3,5,24,22,22,17,5,2
S01009981,Bad health,52,3,2,1,5,2,0,3,11,18,9,8,1,1
S01009981,Very bad health,27,0,0,0,1,3,0,4,4,11,4,4,0,0
S01009982,All people aged 16 to 74,748,27,4,23,99,78,43,43,132,164,93,68,25,69
S01009982,Very good health,332,14,2,12,65,38,13,19,52,55,29,19,10,47
S01009982,Good health,212,7,2,5,25,25,14,8,42,46,29,22,7,16
S01009982,Fair health,121,3,0,3,7,7,12,9,30,27,23,16,7,3
S01009982,Bad health,59,3,0,3,0,6,3,4,8,27,6,5,1,2
S01009982,Very bad health,24,0,0,0,2,2,1,3,0,9,6,6,0,1
S01009983,All people aged 16 to 74,418,10,0,10,25,29,7,21,88,82,117,84,33,39
S01009983,Very good health,163,5,0,5,14,13,3,9,33,20,38,30,8,28
S01009983,Good health,130,1,0,1,8,11,2,8,34,25,35,20,15,6
S01009983,Fair health,65,4,0,4,1,4,2,1,13,14,23,18,5,3
S01009983,Bad health,49,0,0,0,2,1,0,1,7,18,18,13,5,2
S01009983,Very bad health,11,0,0,0,0,0,0,2,1,5,3,3,0,0
S01009984,All people aged 16 to 74,567,16,2,14,63,74,39,57,97,114,63,42,21,44
S01009984,Very good health,258,13,1,12,34,42,22,25,39,36,16,8,8,31
S01009984,Good health,170,2,1,1,18,15,9,17,39,39,21,14,7,10
S01009984,Fair health,87,1,0,1,9,9,5,8,14,23,16,10,6,2
S01009984,Bad health,36,0,0,0,2,7,3,3,1,11,8,8,0,1
S01009984,Very bad health,16,0,0,0,0,1,0,4,4,5,2,2,0,0
S01009985,All people aged 16 to 74,456,5,1,4,30,35,16,42,115,90,96,65,31,27
S01009985,Very good health,178,4,1,3,15,17,12,16,42,29,25,15,10,18
S01009985,Good health,158,0,0,0,9,9,3,14,43,34,38,25,13,8
S01009985,Fair health,69,0,0,0,4,7,1,8,15,11,22,14,8,1
S01009985,Bad health,44,1,0,1,2,1,0,2,13,15,10,10,0,0
S01009985,Very bad health,7,0,0,0,0,1,0,2,2,1,1,1,0,0
S01009986,All people aged 16 to 74,409,10,0,10,34,55,7,28,80,110,68,43,25,17
S01009986,Very good health,122,5,0,5,14,17,4,9,27,18,17,8,9,11
S01009986,Good health,128,2,0,2,11,20,2,9,23,31,25,13,12,5
S01009986,Fair health,79,1,0,1,5,7,0,7,19,25,14,10,4,1
S01009986,Bad health,60,2,0,2,3,8,1,2,8,25,11,11,0,0
S01009986,Very bad health,20,0,0,0,1,3,0,1,3,11,1,1,0,0
S01009987,All people aged 16 to 74,618,12,1,11,55,87,31,61,151,132,62,37,25,27
S01009987,Very good health,211,4,1,3,26,31,9,16,57,30,22,12,10,16
S01009987,Good health,213,3,0,3,19,30,14,23,48,47,19,9,10,10
S01009987,Fair health,120,4,0,4,6,18,4,15,27,29,16,12,4,1
S01009987,Bad health,52,1,0,1,1,6,3,7,12,21,1,1,0,0
S01009987,Very bad health,22,0,0,0,3,2,1,0,7,5,4,3,1,0
S01009988,All people aged 16 to 74,388,5,0,5,31,45,8,30,88,93,59,38,21,29
S01009988,Very good health,121,3,0,3,13,17,3,8,20,23,17,12,5,17
S01009988,Good health,131,0,0,0,10,10,4,11,35,31,19,10,9,11
S01009988,Fair health,84,2,0,2,4,11,1,6,20,25,15,10,5,0
S01009988,Bad health,38,0,0,0,1,7,0,3,8,12,7,5,2,0
S01009988,Very bad health,14,0,0,0,3,0,0,2,5,2,1,1,0,1
S01009989,All people aged 16 to 74,612,23,2,21,95,105,33,38,128,97,42,26,16,51
S01009989,Very good health,274,11,1,10,43,54,10,22,49,33,14,7,7,38
S01009989,Good health,204,8,1,7,33,34,15,9,53,27,14,6,8,11
S01009989,Fair health,87,4,0,4,12,12,8,3,14,25,8,7,1,1
S01009989,Bad health,41,0,0,0,4,5,0,4,10,12,5,5,0,1
S01009989,Very bad health,6,0,0,0,3,0,0,0,2,0,1,1,0,0
S01009990,All people aged 16 to 74,524,28,5,23,81,105,22,44,100,81,19,10,9,44
S01009990,Very good health,266,18,1,17,47,58,13,18,39,29,8,3,5,36
S01009990,Good health,179,5,2,3,24,31,7,20,45,33,6,2,4,8
S01009990,Fair health,58,4,1,3,9,10,1,6,11,15,2,2,0,0
S01009990,Bad health,14,1,1,0,0,5,0,0,3,4,1,1,0,0
S01009990,Very bad health,7,0,0,0,1,1,1,0,2,0,2,2,0,0
S01009991,All people aged 16 to 74,601,30,8,22,103,121,31,59,107,63,30,20,10,57
S01009991,Very good health,314,17,5,12,58,66,14,32,51,28,9,5,4,39
S01009991,Good health,199,8,2,6,37,39,11,17,39,21,14,8,6,13
S01009991,Fair health,63,4,1,3,7,14,1,6,13,10,5,5,0,3
S01009991,Bad health,18,0,0,0,1,2,5,3,2,3,0,0,0,2
S01009991,Very bad health,7,1,0,1,0,0,0,1,2,1,2,2,0,0
S01009992,All people aged 16 to 74,512,6,1,5,47,65,19,42,134,104,71,39,32,24
S01009992,Very good health,153,4,1,3,19,22,6,18,31,22,17,8,9,14
S01009992,Good health,175,1,0,1,13,22,5,12,54,33,27,10,17,8
S01009992,Fair health,106,1,0,1,6,14,5,6,31,25,16,10,6,2
S01009992,Bad health,60,0,0,0,6,7,3,5,9,22,8,8,0,0
S01009992,Very bad health,18,0,0,0,3,0,0,1,9,2,3,3,0,0
S01009993,All people aged 16 to 74,626,44,3,41,126,102,42,50,105,92,16,8,8,49
S01009993,Very good health,331,25,1,24,79,52,24,27,50,31,7,4,3,36
S01009993,Good health,205,17,2,15,34,43,14,20,30,31,6,3,3,10
S01009993,Fair health,57,2,0,2,10,4,2,2,17,16,3,1,2,1
S01009993,Bad health,23,0,0,0,1,2,1,0,7,11,0,0,0,1
S01009993,Very bad health,10,0,0,0,2,1,1,1,1,3,0,0,0,1
S01009994,All people aged 16 to 74,512,21,5,16,99,100,26,53,97,60,21,12,9,35
S01009994,Very good health,250,9,2,7,50,52,8,22,43,28,6,5,1,32
S01009994,Good health,167,9,1,8,37,26,15,19,34,16,8,2,6,3
S01009994,Fair health,65,2,2,0,11,14,2,8,12,12,4,2,2,0
S01009994,Bad health,22,1,0,1,0,6,1,4,5,3,2,2,0,0
S01009994,Very bad health,8,0,0,0,1,2,0,0,3,1,1,1,0,0
S01009995,All people aged 16 to 74,517,26,4,22,90,111,25,50,89,57,19,11,8,50
S01009995,Very good health,273,12,1,11,51,45,11,29,43,31,10,5,5,41
S01009995,Good health,159,7,1,6,27,44,8,10,28,23,5,3,2,7
S01009995,Fair health,65,6,2,4,10,14,6,8,15,2,2,1,1,2
S01009995,Bad health,15,1,0,1,1,7,0,2,3,0,1,1,0,0
S01009995,Very bad health,5,0,0,0,1,1,0,1,0,1,1,1,0,0
S01009996,All people aged 16 to 74,542,26,6,20,90,82,29,54,100,83,27,15,12,51
S01009996,Very good health,254,15,5,10,48,40,14,24,34,35,8,5,3,36
S01009996,Good health,176,7,1,6,30,27,10,16,37,27,10,4,6,12
S01009996,Fair health,67,3,0,3,10,10,2,9,17,10,4,2,2,2
S01009996,Bad health,32,1,0,1,1,4,2,5,8,6,4,3,1,1
S01009996,Very bad health,13,0,0,0,1,1,1,0,4,5,1,1,0,0
S01009997,All people aged 16 to 74,441,23,4,19,88,85,20,33,82,42,26,17,9,42
S01009997,Very good health,241,11,3,8,45,49,12,17,35,25,9,4,5,38
S01009997,Good health,137,9,1,8,30,29,6,9,33,10,8,5,3,3
S01009997,Fair health,43,1,0,1,10,4,2,5,10,4,6,5,1,1
S01009997,Bad health,15,1,0,1,0,2,0,2,4,3,3,3,0,0
S01009997,Very bad health,5,1,0,1,3,1,0,0,0,0,0,0,0,0
S01009998,All people aged 16 to 74,458,51,13,38,102,62,49,26,41,42,35,28,7,50
S01009998,Very good health,255,34,10,24,53,37,21,15,19,22,14,10,4,40
S01009998,Good health,131,12,3,9,32,19,16,2,14,14,13,11,2,9
S01009998,Fair health,46,4,0,4,11,5,7,5,4,5,4,3,1,1
S01009998,Bad health,16,1,0,1,2,1,3,1,3,1,4,4,0,0
S01009998,Very bad health,10,0,0,0,4,0,2,3,1,0,0,0,0,0
S01009999,All people aged 16 to 74,540,42,7,35,121,102,25,49,85,44,25,15,10,47
S01009999,Very good health,284,23,6,17,69,50,13,32,37,19,8,4,4,33
S01009999,Good health,166,11,0,11,36,37,7,13,27,12,10,4,6,13
S01009999,Fair health,58,7,1,6,12,12,5,2,9,6,4,4,0,1
S01009999,Bad health,23,1,0,1,4,2,0,0,8,5,3,3,0,0
S01009999,Very bad health,9,0,0,0,0,1,0,2,4,2,0,0,0,0
S01010000,All people aged 16 to 74,476,16,1,15,99,84,22,36,102,55,27,12,15,35
S01010000,Very good health,240,5,1,4,57,43,10,17,43,21,12,3,9,32
S01010000,Good health,155,9,0,9,34,26,9,13,39,16,7,2,5,2
S01010000,Fair health,60,1,0,1,7,10,3,4,14,15,5,4,1,1
S01010000,Bad health,20,1,0,1,1,5,0,2,6,3,2,2,0,0
S01010000,Very bad health,1,0,0,0,0,0,0,0,0,0,1,1,0,0
S01010001,All people aged 16 to 74,567,42,7,35,108,96,28,44,96,69,31,23,8,53
S01010001,Very good health,285,31,3,28,57,45,10,20,38,34,10,6,4,40
S01010001,Good health,182,8,3,5,37,37,14,14,34,19,10,8,2,9
S01010001,Fair health,73,3,1,2,9,10,4,9,13,11,10,8,2,4
S01010001,Bad health,21,0,0,0,4,4,0,1,9,3,0,0,0,0
S01010001,Very bad health,6,0,0,0,1,0,0,0,2,2,1,1,0,0
S01010002,All people aged 16 to 74,608,30,2,28,120,104,34,51,106,69,35,22,13,59
S01010002,Very good health,309,20,0,20,75,53,16,21,46,24,13,8,5,41
S01010002,Good health,191,7,2,5,34,34,9,19,38,25,14,9,5,11
S01010002,Fair health,75,2,0,2,9,15,7,8,15,10,4,2,2,5
S01010002,Bad health,26,1,0,1,0,1,2,2,7,8,3,2,1,2
S01010002,Very bad health,7,0,0,0,2,1,0,1,0,2,1,1,0,0
S01010003,All people aged 16 to 74,546,48,11,37,122,98,29,48,94,48,18,10,8,41
S01010003,Very good health,289,26,4,22,69,52,14,26,36,21,8,5,3,37
S01010003,Good health,173,20,6,14,36,37,10,15,36,10,5,2,3,4
S01010003,Fair health,64,1,1,0,15,9,3,6,16,11,3,2,1,0
S01010003,Bad health,13,1,0,1,2,0,0,1,4,3,2,1,1,0
S01010003,Very bad health,7,0,0,0,0,0,2,0,2,3,0,0,0,0
S01010004,All people aged 16 to 74,546,60,10,50,153,84,44,19,57,41,23,18,5,65
S01010004,Very good health,308,40,6,34,88,39,26,11,22,25,8,6,2,49
S01010004,Good health,171,17,3,14,51,28,13,5,25,9,8,6,2,15
S01010004,Fair health,47,3,1,2,10,13,2,2,7,5,4,4,0,1
S01010004,Bad health,17,0,0,0,3,3,3,1,2,2,3,2,1,0
S01010004,Very bad health,3,0,0,0,1,1,0,0,1,0,0,0,0,0
S01010005,All people aged 16 to 74,620,51,7,44,135,119,30,48,89,56,53,26,27,39
S01010005,Very good health,308,34,2,32,68,67,19,17,32,23,18,10,8,30
S01010005,Good health,195,14,4,10,51,35,8,22,26,17,15,8,7,7
S01010005,Fair health,78,3,1,2,11,15,2,4,16,10,16,5,11,1
S01010005,Bad health,30,0,0,0,4,1,1,5,10,6,3,2,1,0
S01010005,Very bad health,9,0,0,0,1,1,0,0,5,0,1,1,0,1
S01010006,All people aged 16 to 74,727,80,9,71,204,115,22,48,87,85,37,18,19,49
S01010006,Very good health,368,54,4,50,121,59,8,22,30,20,12,6,6,42
S01010006,Good health,235,23,5,18,62,34,11,17,28,41,13,5,8,6
S01010006,Fair health,79,2,0,2,11,15,3,8,15,16,9,4,5,0
S01010006,Bad health,34,0,0,0,6,6,0,1,12,7,2,2,0,0
S01010006,Very bad health,11,1,0,1,4,1,0,0,2,1,1,1,0,1
S01010007,All people aged 16 to 74,719,94,16,78,213,117,48,36,70,55,18,10,8,68
S01010007,Very good health,408,67,9,58,127,59,18,16,37,24,6,5,1,54
S01010007,Good health,213,23,6,17,62,44,22,11,15,19,6,2,4,11
S01010007,Fair health,69,4,1,3,16,11,3,5,13,10,4,1,3,3
S01010007,Bad health,26,0,0,0,7,3,4,3,5,2,2,2,0,0
S01010007,Very bad health,3,0,0,0,1,0,1,1,0,0,0,0,0,0
S01010008,All people aged 16 to 74,537,80,8,72,164,88,28,32,62,36,21,12,9,26
S01010008,Very good health,292,64,6,58,93,49,12,14,20,14,10,6,4,16
S01010008,Good health,164,11,1,10,50,31,9,12,27,9,8,6,2,7
S01010008,Fair health,55,3,0,3,15,6,5,5,9,7,2,0,2,3
S01010008,Bad health,23,2,1,1,6,1,1,1,6,5,1,0,1,0
S01010008,Very bad health,3,0,0,0,0,1,1,0,0,1,0,0,0,0
S01010009,All people aged 16 to 74,505,46,5,41,132,76,24,38,73,51,33,19,14,32
S01010009,Very good health,258,33,2,31,76,35,9,21,31,22,9,7,2,22
S01010009,Good health,156,11,3,8,45,28,10,12,24,11,9,0,9,6
S01010009,Fair health,55,2,0,2,7,9,4,4,11,10,4,3,1,4
S01010009,Bad health,33,0,0,0,4,4,1,1,7,6,10,8,2,0
S01010009,Very bad health,3,0,0,0,0,0,0,0,0,2,1,1,0,0
S01010010,All people aged 16 to 74,773,110,18,92,238,98,57,33,99,44,25,20,5,69
S01010010,Very good health,407,71,13,58,145,40,24,16,38,16,7,4,3,50
S01010010,Good health,260,32,5,27,66,41,22,9,44,19,11,10,1,16
S01010010,Fair health,75,6,0,6,18,15,9,5,10,6,3,2,1,3
S01010010,Bad health,24,1,0,1,7,2,2,1,5,3,3,3,0,0
S01010010,Very bad health,7,0,0,0,2,0,0,2,2,0,1,1,0,0
S01010011,All people aged 16 to 74,601,64,13,51,177,99,26,44,71,65,34,14,20,21
S01010011,Very good health,260,41,8,33,98,35,7,15,30,12,15,7,8,7
S01010011,Good health,176,20,5,15,47,33,12,15,17,13,9,2,7,10
S01010011,Fair health,105,2,0,2,24,20,5,8,14,21,7,2,5,4
S01010011,Bad health,44,0,0,0,7,10,1,3,8,13,2,2,0,0
S01010011,Very bad health,16,1,0,1,1,1,1,3,2,6,1,1,0,0
S01010012,All people aged 16 to 74,624,39,6,33,133,121,44,45,84,62,40,33,7,56
S01010012,Very good health,310,25,4,21,75,56,14,17,35,33,15,12,3,40
S01010012,Good health,220,13,2,11,45,47,23,20,35,14,7,6,1,16
S01010012,Fair health,68,1,0,1,8,17,7,3,8,10,14,11,3,0
S01010012,Bad health,16,0,0,0,3,1,0,2,5,3,2,2,0,0
S01010012,Very bad health,10,0,0,0,2,0,0,3,1,2,2,2,0,0
S01010013,All people aged 16 to 74,659,76,12,64,190,95,33,46,83,50,34,17,17,52
S01010013,Very good health,347,50,10,40,109,54,8,24,35,19,12,5,7,36
S01010013,Good health,212,22,2,20,61,28,16,12,33,15,12,6,6,13
S01010013,Fair health,65,3,0,3,16,6,6,9,8,9,5,2,3,3
S01010013,Bad health,29,1,0,1,4,4,3,1,5,6,5,4,1,0
S01010013,Very bad health,6,0,0,0,0,3,0,0,2,1,0,0,0,0
S01010014,All people aged 16 to 74,830,112,20,92,223,127,50,49,94,66,51,39,12,58
S01010014,Very good health,434,76,12,64,129,65,21,22,50,23,10,8,2,38
S01010014,Good health,236,25,5,20,68,44,16,12,24,17,14,11,3,16
S01010014,Fair health,111,11,3,8,23,10,9,8,10,21,15,13,2,4
S01010014,Bad health,43,0,0,0,3,7,4,6,8,4,11,6,5,0
S01010014,Very bad health,6,0,0,0,0,1,0,1,2,1,1,1,0,0
S01010015,All people aged 16 to 74,696,115,13,102,195,102,41,39,57,33,32,20,12,82
S01010015,Very good health,406,80,11,69,127,58,22,17,25,11,11,7,4,55
S01010015,Good health,206,28,2,26,54,32,16,10,20,10,12,5,7,24
S01010015,Fair health,55,5,0,5,9,7,1,8,10,6,6,5,1,3
S01010015,Bad health,21,2,0,2,3,4,1,4,1,5,1,1,0,0
S01010015,Very bad health,8,0,0,0,2,1,1,0,1,1,2,2,0,0
S01010016,All people aged 16 to 74,513,11,3,8,77,70,31,43,108,96,38,25,13,39
S01010016,Very good health,213,7,2,5,42,24,14,20,39,32,10,6,4,25
S01010016,Good health,167,2,1,1,24,32,8,10,40,27,14,9,5,10
S01010016,Fair health,80,1,0,1,6,11,4,7,20,21,9,5,4,1
S01010016,Bad health,41,0,0,0,3,2,4,4,9,13,5,5,0,1
S01010016,Very bad health,12,1,0,1,2,1,1,2,0,3,0,0,0,2
S01010017,All people aged 16 to 74,555,11,5,6,49,72,19,33,117,122,76,39,37,56
S01010017,Very good health,224,6,3,3,18,30,11,10,38,44,24,15,9,43
S01010017,Good health,169,2,1,1,20,21,4,14,46,32,22,7,15,8
S01010017,Fair health,98,2,1,1,7,16,2,4,18,27,17,9,8,5
S01010017,Bad health,43,1,0,1,3,2,1,3,9,14,10,5,5,0
S01010017,Very bad health,21,0,0,0,1,3,1,2,6,5,3,3,0,0
S01010018,All people aged 16 to 74,695,24,4,20,111,103,31,57,136,145,44,34,10,44
S01010018,Very good health,255,15,0,15,47,46,12,20,47,27,8,7,1,33
S01010018,Good health,218,5,2,3,42,39,8,19,44,42,14,9,5,5
S01010018,Fair health,127,2,0,2,11,10,8,11,21,50,11,9,2,3
S01010018,Bad health,75,2,2,0,9,5,3,5,21,20,8,6,2,2
S01010018,Very bad health,20,0,0,0,2,3,0,2,3,6,3,3,0,1
S01010019,All people aged 16 to 74,522,3,2,1,53,56,18,42,121,107,91,55,36,31
S01010019,Very good health,155,1,1,0,25,17,9,10,31,24,18,8,10,20
S01010019,Good health,168,1,1,0,14,24,2,11,53,32,23,12,11,8
S01010019,Fair health,132,1,0,1,7,10,4,12,31,33,33,18,15,1
S01010019,Bad health,47,0,0,0,1,5,3,9,5,15,8,8,0,1
S01010019,Very bad health,20,0,0,0,6,0,0,0,1,3,9,9,0,1
S01010020,All people aged 16 to 74,547,15,5,10,62,90,24,48,115,114,38,31,7,41
S01010020,Very good health,207,10,3,7,24,40,8,20,44,21,9,7,2,31
S01010020,Good health,191,3,1,2,31,28,9,13,41,42,16,12,4,8
S01010020,Fair health,79,1,1,0,2,13,4,9,18,26,4,3,1,2
S01010020,Bad health,52,1,0,1,5,8,2,5,10,17,4,4,0,0
S01010020,Very bad health,18,0,0,0,0,1,1,1,2,8,5,5,0,0
S01010021,All people aged 16 to 74,597,15,0,15,43,43,26,46,115,116,120,91,29,73
S01010021,Very good health,217,11,0,11,22,16,8,6,37,33,34,23,11,50
S01010021,Good health,172,4,0,4,11,15,8,15,39,23,39,30,9,18
S01010021,Fair health,119,0,0,0,5,4,4,18,22,34,28,19,9,4
S01010021,Bad health,58,0,0,0,2,5,5,5,10,18,12,12,0,1
S01010021,Very bad health,31,0,0,0,3,3,1,2,7,8,7,7,0,0
S01010022,All people aged 16 to 74,735,32,1,31,103,90,27,61,133,146,90,60,30,53
S01010022,Very good health,292,23,1,22,56,48,17,14,49,36,17,9,8,32
S01010022,Good health,219,5,0,5,31,27,7,21,36,42,32,17,15,18
S01010022,Fair health,132,3,0,3,10,10,2,8,27,45,25,19,6,2
S01010022,Bad health,66,1,0,1,5,3,0,13,16,17,10,9,1,1
S01010022,Very bad health,26,0,0,0,1,2,1,5,5,6,6,6,0,0
S01010023,All people aged 16 to 74,455,6,2,4,43,38,14,50,100,115,67,50,17,22
S01010023,Very good health,111,3,1,2,12,12,5,11,26,11,14,9,5,17
S01010023,Good health,126,1,1,0,17,12,3,13,24,33,18,12,6,5
S01010023,Fair health,121,1,0,1,6,7,2,16,30,40,19,14,5,0
S01010023,Bad health,76,1,0,1,6,5,4,7,18,23,12,11,1,0
S01010023,Very bad health,21,0,0,0,2,2,0,3,2,8,4,4,0,0
S01010024,All people aged 16 to 74,586,35,1,34,86,58,17,38,116,117,52,36,16,67
S01010024,Very good health,258,23,0,23,53,26,5,15,42,32,17,11,6,45
S01010024,Good health,154,9,0,9,19,19,8,13,35,25,11,6,5,15
S01010024,Fair health,99,2,0,2,10,9,2,6,19,33,15,10,5,3
S01010024,Bad health,52,1,1,0,3,3,2,2,16,20,5,5,0,0
S01010024,Very bad health,23,0,0,0,1,1,0,2,4,7,4,4,0,4
S01010025,All people aged 16 to 74,438,17,0,17,54,39,25,37,72,87,70,53,17,37
S01010025,Very good health,165,8,0,8,27,16,11,16,20,23,16,11,5,28
S01010025,Good health,114,6,0,6,13,12,7,10,18,18,22,15,7,8
S01010025,Fair health,91,2,0,2,8,8,3,7,18,21,23,18,5,1
S01010025,Bad health,45,0,0,0,6,3,3,3,9,19,2,2,0,0
S01010025,Very bad health,23,1,0,1,0,0,1,1,7,6,7,7,0,0
S01010026,All people aged 16 to 74,725,55,9,46,135,59,29,43,115,130,77,53,24,82
S01010026,Very good health,336,36,6,30,86,29,10,18,45,28,16,10,6,68
S01010026,Good health,200,17,3,14,35,17,11,10,33,38,29,18,11,10
S01010026,Fair health,95,1,0,1,10,6,4,6,16,28,21,14,7,3
S01010026,Bad health,69,1,0,1,4,4,2,5,13,31,8,8,0,1
S01010026,Very bad health,25,0,0,0,0,3,2,4,8,5,3,3,0,0
S01010027,All people aged 16 to 74,719,59,7,52,160,77,29,42,83,91,59,43,16,119
S01010027,Very good health,366,48,6,42,98,37,11,10,37,23,17,11,6,85
S01010027,Good health,214,9,1,8,45,29,12,14,22,31,23,14,9,29
S01010027,Fair health,73,0,0,0,12,8,4,7,14,15,9,9,0,4
S01010027,Bad health,48,1,0,1,4,3,0,9,8,16,6,5,1,1
S01010027,Very bad health,18,1,0,1,1,0,2,2,2,6,4,4,0,0
S01010028,All people aged 16 to 74,471,34,1,33,77,46,11,44,71,85,55,36,19,48
S01010028,Very good health,180,20,1,19,41,29,5,8,19,19,12,3,9,27
S01010028,Good health,125,12,0,12,20,12,4,9,21,23,11,6,5,13
S01010028,Fair health,93,0,0,0,11,4,2,15,19,20,15,10,5,7
S01010028,Bad health,54,1,0,1,5,1,0,9,9,18,10,10,0,1
S01010028,Very bad health,19,1,0,1,0,0,0,3,3,5,7,7,0,0
S01010029,All people aged 16 to 74,485,12,4,8,57,50,16,49,89,126,55,42,13,31
S01010029,Very good health,157,6,2,4,24,16,2,15,27,28,15,8,7,24
S01010029,Good health,136,3,1,2,18,16,10,16,25,31,13,10,3,4
S01010029,Fair health,108,2,0,2,7,11,3,8,21,39,15,12,3,2
S01010029,Bad health,67,1,1,0,6,6,1,9,11,21,11,11,0,1
S01010029,Very bad health,17,0,0,0,2,1,0,1,5,7,1,1,0,0
S01010030,All people aged 16 to 74,676,116,15,101,140,74,15,50,82,79,29,23,6,91
S01010030,Very good health,361,89,11,78,86,33,5,23,27,21,13,12,1,64
S01010030,Good health,219,26,4,22,44,28,5,17,36,32,6,1,5,25
S01010030,Fair health,60,1,0,1,5,8,4,7,12,17,4,4,0,2
S01010030,Bad health,26,0,0,0,3,3,1,3,7,5,4,4,0,0
S01010030,Very bad health,10,0,0,0,2,2,0,0,0,4,2,2,0,0
S01010031,All people aged 16 to 74,725,132,11,121,163,68,21,46,40,31,49,33,16,175
S01010031,Very good health,464,98,9,89,104,41,15,25,17,10,16,11,5,138
S01010031,Good health,192,31,1,30,51,20,4,12,12,9,17,13,4,36
S01010031,Fair health,47,2,1,1,7,5,2,7,6,8,9,4,5,1
S01010031,Bad health,17,1,0,1,1,1,0,0,5,3,6,5,1,0
S01010031,Very bad health,5,0,0,0,0,1,0,2,0,1,1,0,1,0
S01010032,All people aged 16 to 74,802,76,4,72,111,62,21,32,51,42,90,76,14,317
S01010032,Very good health,442,63,4,59,72,37,6,19,24,10,16,12,4,195
S01010032,Good health,258,10,0,10,32,21,12,7,15,12,35,28,7,114
S01010032,Fair health,66,2,0,2,6,3,1,4,8,12,24,22,2,6
S01010032,Bad health,27,0,0,0,1,1,2,1,2,6,12,11,1,2
S01010032,Very bad health,9,1,0,1,0,0,0,1,2,2,3,3,0,0
S01010033,All people aged 16 to 74,728,48,4,44,107,82,36,47,118,93,100,74,26,97
S01010033,Very good health,304,29,3,26,55,31,12,25,46,24,31,23,8,51
S01010033,Good health,247,16,1,15,35,29,11,10,35,36,35,26,9,40
S01010033,Fair health,106,1,0,1,11,15,5,6,26,14,23,14,9,5
S01010033,Bad health,52,1,0,1,2,4,5,4,9,15,11,11,0,1
S01010033,Very bad health,19,1,0,1,4,3,3,2,2,4,0,0,0,0
S01010034,All people aged 16 to 74,799,40,5,35,89,54,18,57,109,166,77,57,20,189
S01010034,Very good health,319,26,2,24,36,19,5,16,38,42,22,17,5,115
S01010034,Good health,235,9,2,7,37,20,4,17,30,37,22,15,7,59
S01010034,Fair health,132,1,0,1,14,11,3,8,25,35,21,13,8,14
S01010034,Bad health,88,3,1,2,2,4,4,10,12,44,8,8,0,1
S01010034,Very bad health,25,1,0,1,0,0,2,6,4,8,4,4,0,0
S01010035,All people aged 16 to 74,545,15,1,14,41,39,14,61,95,83,112,85,27,85
S01010035,Very good health,184,7,0,7,18,16,2,18,41,16,27,20,7,39
S01010035,Good health,174,7,1,6,17,9,7,20,27,23,26,16,10,38
S01010035,Fair health,102,1,0,1,5,10,3,8,14,25,30,21,9,6
S01010035,Bad health,68,0,0,0,1,4,2,12,11,17,19,18,1,2
S01010035,Very bad health,17,0,0,0,0,0,0,3,2,2,10,10,0,0
S01010036,All people aged 16 to 74,767,67,8,59,117,58,24,32,52,29,30,25,5,358
S01010036,Very good health,503,44,5,39,78,36,13,21,39,20,14,13,1,238
S01010036,Good health,223,20,3,17,34,20,9,8,12,8,12,9,3,100
S01010036,Fair health,35,3,0,3,2,2,1,3,1,1,3,2,1,19
S01010036,Bad health,6,0,0,0,3,0,1,0,0,0,1,1,0,1
S01010036,Very bad health,0,0,0,0,0,0,0,0,0,0,0,0,0,0
S01010037,All people aged 16 to 74,476,15,0,15,41,54,14,38,92,124,63,45,18,35
S01010037,Very good health,138,10,0,10,21,21,6,12,23,16,12,7,5,17
S01010037,Good health,147,3,0,3,10,14,2,12,36,44,13,5,8,13
S01010037,Fair health,106,1,0,1,7,12,2,5,16,34,24,19,5,5
S01010037,Bad health,65,1,0,1,3,5,3,7,16,22,8,8,0,0
S01010037,Very bad health,20,0,0,0,0,2,1,2,1,8,6,6,0,0
S01010038,All people aged 16 to 74,782,28,1,27,101,64,31,58,143,161,79,63,16,117
S01010038,Very good health,305,16,1,15,47,30,11,21,45,44,16,7,9,75
S01010038,Good health,218,8,0,8,29,16,15,24,39,36,19,14,5,32
S01010038,Fair health,135,0,0,0,15,11,4,8,32,35,23,21,2,7
S01010038,Bad health,87,3,0,3,8,6,1,3,17,34,12,12,0,3
S01010038,Very bad health,37,1,0,1,2,1,0,2,10,12,9,9,0,0
S01010039,All people aged 16 to 74,921,143,12,131,186,73,37,44,49,39,35,28,7,315
S01010039,Very good health,643,110,10,100,136,42,21,29,24,16,10,7,3,255
S01010039,Good health,208,25,2,23,38,26,12,13,19,8,16,13,3,51
S01010039,Fair health,41,7,0,7,10,5,0,1,4,4,1,1,0,9
S01010039,Bad health,26,1,0,1,2,0,3,1,2,9,8,7,1,0
S01010039,Very bad health,3,0,0,0,0,0,1,0,0,2,0,0,0,0
S01010040,All people aged 16 to 74,651,74,8,66,158,81,34,33,83,72,43,28,15,73
S01010040,Very good health,332,52,5,47,93,36,20,17,27,22,15,8,7,50
S01010040,Good health,199,17,3,14,48,35,9,8,31,22,11,5,6,18
S01010040,Fair health,86,3,0,3,11,9,3,4,16,20,15,13,2,5
S01010040,Bad health,27,2,0,2,4,1,1,4,8,7,0,0,0,0
S01010040,Very bad health,7,0,0,0,2,0,1,0,1,1,2,2,0,0
S01010041,All people aged 16 to 74,608,88,4,84,116,49,27,42,49,45,55,45,10,137
S01010041,Very good health,340,49,3,46,79,19,11,24,24,8,9,7,2,117
S01010041,Good health,148,34,0,34,25,15,8,7,16,14,14,12,2,15
S01010041,Fair health,54,5,1,4,6,6,4,2,5,5,16,10,6,5
S01010041,Bad health,44,0,0,0,3,7,3,7,2,9,13,13,0,0
S01010041,Very bad health,22,0,0,0,3,2,1,2,2,9,3,3,0,0
S01010042,All people aged 16 to 74,955,77,7,70,196,122,40,66,100,102,62,38,24,190
S01010042,Very good health,549,48,1,47,125,83,17,35,44,42,20,12,8,135
S01010042,Good health,253,25,6,19,54,24,15,19,24,32,12,3,9,48
S01010042,Fair health,84,4,0,4,9,11,5,7,17,12,17,13,4,2
S01010042,Bad health,53,0,0,0,8,4,1,3,9,12,11,8,3,5
S01010042,Very bad health,16,0,0,0,0,0,2,2,6,4,2,2,0,0
S01010043,All people aged 16 to 74,615,31,4,27,81,61,19,45,111,121,93,55,38,53
S01010043,Very good health,243,15,3,12,38,21,7,19,43,37,25,14,11,38
S01010043,Good health,213,12,1,11,35,29,10,13,33,34,36,17,19,11
S01010043,Fair health,77,2,0,2,3,7,0,7,19,18,17,10,7,4
S01010043,Bad health,56,2,0,2,3,4,1,5,9,21,11,10,1,0
S01010043,Very bad health,26,0,0,0,2,0,1,1,7,11,4,4,0,0
S01010044,All people aged 16 to 74,890,51,6,45,143,114,32,83,135,167,93,74,19,72
S01010044,Very good health,372,33,1,32,83,64,7,26,50,39,17,11,6,53
S01010044,Good health,252,13,4,9,41,28,13,29,38,55,21,15,6,14
S01010044,Fair health,161,4,0,4,11,9,11,18,33,40,31,24,7,4
S01010044,Bad health,78,0,0,0,6,11,1,7,11,22,19,19,0,1
S01010044,Very bad health,27,1,1,0,2,2,0,3,3,11,5,5,0,0
S01010045,All people aged 16 to 74,381,4,1,3,15,30,10,28,89,114,65,50,15,26
S01010045,Very good health,123,2,1,1,10,18,3,8,22,26,19,13,6,15
S01010045,Good health,96,2,0,2,3,6,1,8,31,27,11,8,3,7
S01010045,Fair health,64,0,0,0,2,1,1,5,15,23,13,8,5,4
S01010045,Bad health,73,0,0,0,0,4,4,6,13,28,18,17,1,0
S01010045,Very bad health,25,0,0,0,0,1,1,1,8,10,4,4,0,0
S01010046,All people aged 16 to 74,606,15,3,12,78,75,33,51,115,128,77,53,24,34
S01010046,Very good health,196,8,1,7,35,37,10,18,34,27,12,9,3,15
S01010046,Good health,182,5,1,4,27,25,10,17,36,25,27,9,18,10
S01010046,Fair health,125,2,1,1,9,9,10,11,19,37,24,22,2,4
S01010046,Bad health,76,0,0,0,7,3,3,5,19,26,11,10,1,2
S01010046,Very bad health,27,0,0,0,0,1,0,0,7,13,3,3,0,3
S01010047,All people aged 16 to 74,615,11,4,7,47,61,29,47,127,161,97,74,23,35
S01010047,Very good health,196,3,1,2,18,21,8,16,39,36,31,18,13,24
S01010047,Good health,165,3,0,3,14,24,7,13,45,31,22,17,5,6
S01010047,Fair health,121,3,1,2,5,9,4,10,23,47,16,12,4,4
S01010047,Bad health,94,0,0,0,5,2,6,6,16,38,20,20,0,1
S01010047,Very bad health,39,2,2,0,5,5,4,2,4,9,8,7,1,0
S01010048,All people aged 16 to 74,727,11,2,9,66,75,19,66,152,203,81,54,27,54
S01010048,Very good health,218,9,1,8,26,38,2,18,41,31,21,12,9,32
S01010048,Good health,215,2,1,1,23,18,8,15,47,63,20,10,10,19
S01010048,Fair health,155,0,0,0,11,8,7,17,39,50,21,14,7,2
S01010048,Bad health,109,0,0,0,4,11,2,15,21,42,13,12,1,1
S01010048,Very bad health,30,0,0,0,2,0,0,1,4,17,6,6,0,0
S01010049,All people aged 16 to 74,561,8,3,5,32,35,19,41,144,147,95,65,30,40
S01010049,Very good health,174,3,1,2,11,15,6,16,47,26,23,19,4,27
S01010049,Good health,175,4,2,2,10,16,2,12,46,47,32,16,16,6
S01010049,Fair health,122,0,0,0,8,3,9,8,24,43,24,17,7,3
S01010049,Bad health,61,1,0,1,2,1,1,2,19,21,13,11,2,1
S01010049,Very bad health,29,0,0,0,1,0,1,3,8,10,3,2,1,3
S01010050,All people aged 16 to 74,733,19,1,18,45,63,22,58,147,187,134,95,39,58
S01010050,Very good health,243,7,1,6,22,34,8,25,47,45,18,5,13,37
S01010050,Good health,222,8,0,8,10,19,8,16,42,54,50,35,15,15
S01010050,Fair health,144,2,0,2,6,6,2,6,35,47,35,28,7,5
S01010050,Bad health,93,2,0,2,6,3,3,8,19,27,24,20,4,1
S01010050,Very bad health,31,0,0,0,1,1,1,3,4,14,7,7,0,0
S01010051,All people aged 16 to 74,528,7,2,5,40,48,21,33,107,149,82,63,19,41
S01010051,Very good health,146,2,0,2,13,11,6,8,30,30,11,8,3,35
S01010051,Good health,150,2,0,2,14,16,7,12,38,32,26,15,11,3
S01010051,Fair health,140,2,1,1,10,14,7,7,27,45,25,20,5,3
S01010051,Bad health,63,1,1,0,1,5,0,4,8,32,12,12,0,0
S01010051,Very bad health,29,0,0,0,2,2,1,2,4,10,8,8,0,0
S01010052,All people aged 16 to 74,515,15,2,13,54,61,20,32,116,107,72,47,25,38
S01010052,Very good health,183,9,0,9,28,29,5,8,35,32,14,5,9,23
S01010052,Good health,161,3,0,3,14,21,4,14,38,36,20,12,8,11
S01010052,Fair health,87,0,0,0,5,6,4,5,22,23,19,11,8,3
S01010052,Bad health,63,3,2,1,6,4,6,4,17,10,12,12,0,1
S01010052,Very bad health,21,0,0,0,1,1,1,1,4,6,7,7,0,0
S01010053,All people aged 16 to 74,666,21,2,19,59,55,19,58,145,138,86,74,12,85
S01010053,Very good health,271,10,0,10,36,22,8,26,54,31,29,27,2,55
S01010053,Good health,205,9,2,7,14,24,7,17,49,38,25,19,6,22
S01010053,Fair health,100,1,0,1,5,5,3,8,23,32,17,14,3,6
S01010053,Bad health,62,0,0,0,1,2,1,5,15,29,7,6,1,2
S01010053,Very bad health,28,1,0,1,3,2,0,2,4,8,8,8,0,0
S01010054,All people aged 16 to 74,398,4,0,4,23,30,9,16,90,101,96,77,19,29
S01010054,Very good health,139,3,0,3,10,15,6,4,37,27,24,15,9,13
S01010054,Good health,97,1,0,1,8,8,1,5,22,25,16,11,5,11
S01010054,Fair health,83,0,0,0,2,5,0,3,15,27,27,22,5,4
S01010054,Bad health,61,0,0,0,1,2,2,4,11,17,23,23,0,1
S01010054,Very bad health,18,0,0,0,2,0,0,0,5,5,6,6,0,0
S01010055,All people aged 16 to 74,874,21,2,19,94,98,37,63,173,167,133,89,44,88
S01010055,Very good health,282,10,1,9,44,42,14,15,36,45,21,15,6,55
S01010055,Good health,270,5,1,4,33,27,14,25,59,38,43,17,26,26
S01010055,Fair health,201,1,0,1,11,22,3,15,44,59,41,31,10,5
S01010055,Bad health,97,5,0,5,4,5,5,7,25,21,23,21,2,2
S01010055,Very bad health,24,0,0,0,2,2,1,1,9,4,5,5,0,0
S01010056,All people aged 16 to 74,351,5,0,5,22,32,8,32,93,87,45,29,16,27
S01010056,Very good health,138,2,0,2,4,11,4,9,45,29,16,7,9,18
S01010056,Good health,98,2,0,2,10,13,2,13,22,23,5,0,5,8
S01010056,Fair health,68,1,0,1,2,6,2,3,20,16,17,15,2,1
S01010056,Bad health,35,0,0,0,4,1,0,4,4,15,7,7,0,0
S01010056,Very bad health,12,0,0,0,2,1,0,3,2,4,0,0,0,0
S01010057,All people aged 16 to 74,293,12,2,10,37,29,10,29,58,55,36,26,10,27
S01010057,Very good health,119,9,2,7,19,15,4,15,20,14,9,5,4,14
S01010057,Good health,107,2,0,2,12,11,3,10,23,28,9,5,4,9
S01010057,Fair health,42,1,0,1,1,2,1,2,10,9,12,10,2,4
S01010057,Bad health,18,0,0,0,5,0,2,1,3,2,5,5,0,0
S01010057,Very bad health,7,0,0,0,0,1,0,1,2,2,1,1,0,0
S01010058,All people aged 16 to 74,590,19,7,12,59,57,17,46,121,157,69,46,23,45
S01010058,Very good health,220,6,2,4,30,26,5,15,57,45,9,3,6,27
S01010058,Good health,188,9,3,6,20,18,10,18,31,47,19,12,7,16
S01010058,Fair health,102,2,0,2,7,11,2,9,21,27,21,14,7,2
S01010058,Bad health,49,2,2,0,2,2,0,3,7,22,11,8,3,0
S01010058,Very bad health,31,0,0,0,0,0,0,1,5,16,9,9,0,0
S01010059,All people aged 16 to 74,506,26,3,23,86,73,29,43,79,92,32,13,19,46
S01010059,Very good health,210,15,1,14,44,27,8,19,33,29,10,4,6,25
S01010059,Good health,184,11,2,9,30,36,13,14,23,26,15,4,11,16
S01010059,Fair health,65,0,0,0,10,8,4,7,12,16,5,3,2,3
S01010059,Bad health,36,0,0,0,1,2,2,3,7,17,2,2,0,2
S01010059,Very bad health,11,0,0,0,1,0,2,0,4,4,0,0,0,0
S01010060,All people aged 16 to 74,713,21,6,15,89,81,33,55,140,160,83,58,25,51
S01010060,Very good health,265,15,6,9,45,42,12,18,43,41,15,6,9,34
S01010060,Good health,225,3,0,3,23,28,11,19,51,45,32,28,4,13
S01010060,Fair health,123,3,0,3,15,9,7,7,23,43,15,8,7,1
S01010060,Bad health,77,0,0,0,3,1,2,8,18,25,17,12,5,3
S01010060,Very bad health,23,0,0,0,3,1,1,3,5,6,4,4,0,0
S01010061,All people aged 16 to 74,395,13,1,12,76,70,25,27,65,54,23,13,10,42
S01010061,Very good health,213,10,1,9,55,41,15,14,28,20,7,3,4,23
S01010061,Good health,113,1,0,1,16,17,3,9,27,17,9,4,5,14
S01010061,Fair health,45,0,0,0,4,9,5,2,6,11,6,5,1,2
S01010061,Bad health,19,1,0,1,1,3,0,2,3,5,1,1,0,3
S01010061,Very bad health,5,1,0,1,0,0,2,0,1,1,0,0,0,0
S01010062,All people aged 16 to 74,525,14,0,14,68,62,25,42,119,112,50,38,12,33
S01010062,Very good health,179,12,0,12,29,30,8,10,30,23,17,12,5,20
S01010062,Good health,175,1,0,1,25,16,12,15,48,36,13,8,5,9
S01010062,Fair health,111,1,0,1,8,14,3,9,24,31,17,15,2,4
S01010062,Bad health,41,0,0,0,4,1,1,6,12,15,2,2,0,0
S01010062,Very bad health,19,0,0,0,2,1,1,2,5,7,1,1,0,0
S01010063,All people aged 16 to 74,778,26,7,19,74,80,27,77,167,168,105,66,39,54
S01010063,Very good health,277,17,5,12,33,36,9,21,53,41,31,19,12,36
S01010063,Good health,242,5,1,4,25,29,8,26,57,44,33,16,17,15
S01010063,Fair health,141,2,1,1,11,9,2,15,32,46,22,16,6,2
S01010063,Bad health,87,2,0,2,3,5,8,11,20,24,13,9,4,1
S01010063,Very bad health,31,0,0,0,2,1,0,4,5,13,6,6,0,0
S01010064,All people aged 16 to 74,398,11,2,9,64,47,17,34,78,75,41,28,13,31
S01010064,Very good health,152,3,1,2,31,23,4,17,22,16,11,4,7,25
S01010064,Good health,130,4,1,3,20,17,11,9,31,27,6,4,2,5
S01010064,Fair health,78,2,0,2,11,4,2,5,15,24,14,10,4,1
S01010064,Bad health,28,2,0,2,1,2,0,3,9,6,5,5,0,0
S01010064,Very bad health,10,0,0,0,1,1,0,0,1,2,5,5,0,0
S01010065,All people aged 16 to 74,635,11,4,7,66,53,31,57,162,152,65,49,16,38
S01010065,Very good health,199,6,2,4,24,18,8,15,54,35,12,7,5,27
S01010065,Good health,191,3,0,3,29,18,12,21,36,46,16,11,5,10
S01010065,Fair health,143,2,2,0,4,12,6,12,44,38,25,20,5,0
S01010065,Bad health,71,0,0,0,8,3,4,6,19,22,8,7,1,1
S01010065,Very bad health,31,0,0,0,1,2,1,3,9,11,4,4,0,0
S01010066,All people aged 16 to 74,570,5,0,5,43,44,24,47,131,151,68,53,15,57
S01010066,Very good health,191,5,0,5,12,15,11,13,38,40,20,15,5,37
S01010066,Good health,165,0,0,0,12,13,7,16,36,42,22,14,8,17
S01010066,Fair health,103,0,0,0,11,9,4,6,27,30,14,13,1,2
S01010066,Bad health,87,0,0,0,8,6,2,10,24,28,8,7,1,1
S01010066,Very bad health,24,0,0,0,0,1,0,2,6,11,4,4,0,0
S01010067,All people aged 16 to 74,438,4,1,3,31,37,15,30,109,105,74,42,32,33
S01010067,Very good health,149,2,0,2,12,14,5,10,30,26,25,8,17,25
S01010067,Good health,138,1,1,0,11,15,5,8,41,26,24,17,7,7
S01010067,Fair health,80,1,0,1,4,2,2,5,17,27,21,14,7,1
S01010067,Bad health,53,0,0,0,2,5,2,4,17,20,3,2,1,0
S01010067,Very bad health,18,0,0,0,2,1,1,3,4,6,1,1,0,0
S01010068,All people aged 16 to 74,474,27,3,24,63,49,26,46,111,77,32,20,12,43
S01010068,Very good health,235,18,1,17,43,30,9,27,36,28,13,5,8,31
S01010068,Good health,130,7,2,5,18,10,8,13,42,13,8,6,2,11
S01010068,Fair health,55,1,0,1,1,5,5,4,17,15,6,6,0,1
S01010068,Bad health,41,1,0,1,1,2,4,0,13,16,4,2,2,0
S01010068,Very bad health,13,0,0,0,0,2,0,2,3,5,1,1,0,0
S01010069,All people aged 16 to 74,656,27,8,19,129,106,55,50,128,96,18,11,7,47
S01010069,Very good health,313,16,5,11,74,56,20,24,53,32,4,2,2,34
S01010069,Good health,224,9,2,7,41,35,17,18,51,38,5,2,3,10
S01010069,Fair health,86,2,1,1,11,9,15,5,18,16,7,5,2,3
S01010069,Bad health,27,0,0,0,2,6,3,1,5,9,1,1,0,0
S01010069,Very bad health,6,0,0,0,1,0,0,2,1,1,1,1,0,0
S01010070,All people aged 16 to 74,546,35,11,24,101,81,49,50,92,63,15,8,7,60
S01010070,Very good health,289,21,6,15,55,38,18,25,50,24,5,1,4,53
S01010070,Good health,166,11,5,6,31,27,21,18,28,21,4,2,2,5
S01010070,Fair health,59,1,0,1,11,13,8,3,9,10,2,1,1,2
S01010070,Bad health,23,1,0,1,2,3,2,3,3,6,3,3,0,0
S01010070,Very bad health,9,1,0,1,2,0,0,1,2,2,1,1,0,0
S01010071,All people aged 16 to 74,593,27,10,17,93,85,57,62,96,90,41,30,11,42
S01010071,Very good health,247,17,6,11,47,42,21,20,28,32,10,4,6,30
S01010071,Good health,193,8,3,5,27,34,24,22,36,24,9,4,5,9
S01010071,Fair health,81,0,0,0,12,5,10,11,19,13,9,9,0,2
S01010071,Bad health,59,2,1,1,6,3,2,8,10,15,12,12,0,1
S01010071,Very bad health,13,0,0,0,1,1,0,1,3,6,1,1,0,0
S01010072,All people aged 16 to 74,610,33,5,28,89,75,34,58,141,114,29,17,12,37
S01010072,Very good health,253,19,2,17,50,33,10,19,57,27,8,5,3,30
S01010072,Good health,197,10,3,7,27,24,13,23,53,31,10,4,6,6
S01010072,Fair health,93,4,0,4,7,8,5,8,20,31,9,6,3,1
S01010072,Bad health,48,0,0,0,5,8,4,6,6,18,1,1,0,0
S01010072,Very bad health,19,0,0,0,0,2,2,2,5,7,1,1,0,0
S01010073,All people aged 16 to 74,555,28,7,21,116,98,34,56,85,85,13,9,4,40
S01010073,Very good health,239,12,4,8,56,38,18,19,35,27,0,0,0,34
S01010073,Good health,195,10,2,8,44,40,14,25,32,19,6,2,4,5
S01010073,Fair health,74,5,1,4,14,13,2,7,5,22,5,5,0,1
S01010073,Bad health,42,1,0,1,2,7,0,4,11,15,2,2,0,0
S01010073,Very bad health,5,0,0,0,0,0,0,1,2,2,0,0,0,0
S01010074,All people aged 16 to 74,573,43,4,39,137,97,41,46,81,55,31,20,11,42
S01010074,Very good health,286,24,1,23,71,52,16,19,35,28,10,6,4,31
S01010074,Good health,187,16,3,13,48,28,17,18,25,13,11,5,6,11
S01010074,Fair health,68,1,0,1,10,12,6,6,15,10,8,7,1,0
S01010074,Bad health,24,2,0,2,7,3,1,1,6,2,2,2,0,0
S01010074,Very bad health,8,0,0,0,1,2,1,2,0,2,0,0,0,0
S01010075,All people aged 16 to 74,444,8,3,5,50,54,21,37,112,99,36,25,11,27
S01010075,Very good health,126,2,0,2,26,24,7,9,24,15,4,2,2,15
S01010075,Good health,148,4,1,3,14,14,6,13,45,33,12,9,3,7
S01010075,Fair health,102,1,1,0,8,9,1,10,31,27,12,6,6,3
S01010075,Bad health,54,1,1,0,2,5,4,4,9,20,8,8,0,1
S01010075,Very bad health,14,0,0,0,0,2,3,1,3,4,0,0,0,1
S01010076,All people aged 16 to 74,507,17,2,15,62,65,34,43,103,116,30,22,8,37
S01010076,Very good health,189,11,1,10,30,26,11,13,37,29,6,3,3,26
S01010076,Good health,172,4,1,3,18,23,12,19,34,43,11,8,3,8
S01010076,Fair health,87,1,0,1,6,10,7,9,19,26,8,6,2,1
S01010076,Bad health,44,0,0,0,5,5,3,1,9,14,5,5,0,2
S01010076,Very bad health,15,1,0,1,3,1,1,1,4,4,0,0,0,0
S01010077,All people aged 16 to 74,472,7,3,4,59,58,37,37,108,97,32,28,4,37
S01010077,Very good health,174,4,0,4,27,20,10,11,33,26,12,10,2,31
S01010077,Good health,129,1,1,0,18,17,17,15,31,22,6,5,1,2
S01010077,Fair health,98,1,1,0,10,16,5,7,25,23,7,6,1,4
S01010077,Bad health,50,0,0,0,2,3,2,4,11,23,5,5,0,0
S01010077,Very bad health,21,1,1,0,2,2,3,0,8,3,2,2,0,0
S01010078,All people aged 16 to 74,490,35,12,23,114,83,31,39,74,49,17,11,6,48
S01010078,Very good health,243,23,8,15,54,49,10,15,28,20,5,2,3,39
S01010078,Good health,152,9,3,6,40,22,13,14,28,18,2,0,2,6
S01010078,Fair health,61,3,1,2,15,5,5,6,14,6,4,3,1,3
S01010078,Bad health,27,0,0,0,5,6,3,2,3,3,5,5,0,0
S01010078,Very bad health,7,0,0,0,0,1,0,2,1,2,1,1,0,0
S01010079,All people aged 16 to 74,710,86,25,61,176,114,80,42,65,58,17,13,4,72
S01010079,Very good health,401,53,13,40,108,65,36,21,30,20,9,6,3,59
S01010079,Good health,193,23,8,15,51,32,24,12,19,17,3,2,1,12
S01010079,Fair health,82,8,3,5,14,13,13,8,10,14,1,1,0,1
S01010079,Bad health,26,1,1,0,2,3,5,1,6,5,3,3,0,0
S01010079,Very bad health,8,1,0,1,1,1,2,0,0,2,1,1,0,0
S01010080,All people aged 16 to 74,499,54,16,38,108,102,40,43,62,42,8,2,6,40
S01010080,Very good health,252,38,9,29,63,42,20,16,27,13,2,0,2,31
S01010080,Good health,170,12,5,7,35,44,10,21,20,15,5,2,3,8
S01010080,Fair health,60,4,2,2,8,11,7,5,13,10,1,0,1,1
S01010080,Bad health,10,0,0,0,1,3,2,1,1,2,0,0,0,0
S01010080,Very bad health,7,0,0,0,1,2,1,0,1,2,0,0,0,0
S01010081,All people aged 16 to 74,546,56,13,43,122,96,75,25,57,43,15,14,1,57
S01010081,Very good health,278,34,6,28,65,39,31,12,25,23,4,4,0,45
S01010081,Good health,169,15,5,10,36,40,27,6,20,11,2,1,1,12
S01010081,Fair health,70,6,2,4,13,10,15,4,8,7,7,7,0,0
S01010081,Bad health,22,1,0,1,7,6,2,2,2,1,1,1,0,0
S01010081,Very bad health,7,0,0,0,1,1,0,1,2,1,1,1,0,0
S01010082,All people aged 16 to 74,656,66,11,55,170,101,64,41,77,56,27,18,9,54
S01010082,Very good health,363,34,6,28,101,61,34,21,28,28,10,5,5,46
S01010082,Good health,210,28,4,24,53,30,24,13,31,17,9,6,3,5
S01010082,Fair health,53,2,0,2,10,8,3,4,13,4,7,6,1,2
S01010082,Bad health,23,2,1,1,6,1,2,2,4,5,0,0,0,1
S01010082,Very bad health,7,0,0,0,0,1,1,1,1,2,1,1,0,0
S01010083,All people aged 16 to 74,541,15,1,14,55,83,28,48,105,111,50,37,13,46
S01010083,Very good health,195,8,1,7,21,35,13,20,35,30,8,4,4,25
S01010083,Good health,174,1,0,1,23,24,8,17,36,30,23,16,7,12
S01010083,Fair health,99,6,0,6,9,14,5,6,19,23,10,8,2,7
S01010083,Bad health,57,0,0,0,2,8,1,4,9,23,8,8,0,2
S01010083,Very bad health,16,0,0,0,0,2,1,1,6,5,1,1,0,0
S01010084,All people aged 16 to 74,654,6,1,5,64,96,26,66,156,155,57,43,14,28
S01010084,Very good health,233,1,1,0,31,38,13,31,47,44,10,6,4,18
S01010084,Good health,200,2,0,2,23,31,4,15,57,48,12,8,4,8
S01010084,Fair health,130,3,0,3,5,16,6,11,31,34,22,17,5,2
S01010084,Bad health,76,0,0,0,5,8,3,8,16,23,13,12,1,0
S01010084,Very bad health,15,0,0,0,0,3,0,1,5,6,0,0,0,0
S01010085,All people aged 16 to 74,599,39,6,33,123,119,31,65,94,70,18,4,14,40
S01010085,Very good health,280,17,3,14,64,57,9,26,40,27,8,2,6,32
S01010085,Good health,223,19,2,17,48,43,16,24,35,24,7,1,6,7
S01010085,Fair health,72,2,1,1,8,13,4,14,15,12,3,1,2,1
S01010085,Bad health,20,1,0,1,1,4,2,1,4,7,0,0,0,0
S01010085,Very bad health,4,0,0,0,2,2,0,0,0,0,0,0,0,0
S01010086,All people aged 16 to 74,702,8,4,4,89,69,28,67,170,160,54,34,20,57
S01010086,Very good health,216,1,1,0,29,18,3,24,45,37,15,5,10,44
S01010086,Good health,249,3,1,2,39,30,18,20,64,45,20,12,8,10
S01010086,Fair health,131,1,0,1,11,12,2,16,36,40,11,10,1,2
S01010086,Bad health,72,3,2,1,4,8,4,4,17,28,4,3,1,0
S01010086,Very bad health,34,0,0,0,6,1,1,3,8,10,4,4,0,1
S01010087,All people aged 16 to 74,449,44,11,33,96,76,56,33,70,34,13,8,5,27
S01010087,Very good health,193,23,8,15,51,28,24,8,23,10,4,1,3,22
S01010087,Good health,167,14,1,13,33,32,20,18,27,15,3,2,1,5
S01010087,Fair health,68,6,2,4,9,13,11,7,14,5,3,2,1,0
S01010087,Bad health,19,1,0,1,2,3,1,0,6,4,2,2,0,0
S01010087,Very bad health,2,0,0,0,1,0,0,0,0,0,1,1,0,0
S01010088,All people aged 16 to 74,604,92,14,78,176,73,63,37,64,28,19,11,8,52
S01010088,Very good health,373,68,12,56,115,40,30,21,32,16,9,4,5,42
S01010088,Good health,180,20,2,18,46,29,23,13,24,8,8,5,3,9
S01010088,Fair health,41,4,0,4,13,4,8,2,4,3,2,2,0,1
S01010088,Bad health,9,0,0,0,2,0,2,0,4,1,0,0,0,0
S01010088,Very bad health,1,0,0,0,0,0,0,1,0,0,0,0,0,0
S01010089,All people aged 16 to 74,546,22,6,16,69,86,37,49,98,85,31,18,13,69
S01010089,Very good health,209,8,0,8,35,34,10,13,36,20,8,1,7,45
S01010089,Good health,178,11,5,6,20,31,14,14,35,30,7,4,3,16
S01010089,Fair health,95,1,1,0,6,12,8,12,14,22,13,10,3,7
S01010089,Bad health,51,2,0,2,7,7,5,6,9,11,3,3,0,1
S01010089,Very bad health,13,0,0,0,1,2,0,4,4,2,0,0,0,0
S01010090,All people aged 16 to 74,810,50,18,32,183,133,54,73,115,82,34,25,9,86
S01010090,Very good health,407,33,10,23,96,63,24,27,52,37,4,2,2,71
S01010090,Good health,261,12,5,7,59,51,19,27,39,27,16,9,7,11
S01010090,Fair health,102,4,3,1,22,14,8,11,16,11,12,12,0,4
S01010090,Bad health,33,0,0,0,6,3,2,7,6,7,2,2,0,0
S01010090,Very bad health,7,1,0,1,0,2,1,1,2,0,0,0,0,0
S01010091,All people aged 16 to 74,654,49,9,40,151,89,56,47,106,68,28,14,14,60
S01010091,Very good health,337,32,7,25,86,47,29,20,34,31,9,3,6,49
S01010091,Good health,214,15,1,14,52,25,20,23,47,18,6,2,4,8
S01010091,Fair health,72,2,1,1,10,13,5,3,17,10,9,5,4,3
S01010091,Bad health,27,0,0,0,3,3,2,1,7,9,2,2,0,0
S01010091,Very bad health,4,0,0,0,0,1,0,0,1,0,2,2,0,0
S01010092,All people aged 16 to 74,715,30,5,25,83,92,34,54,149,136,79,63,16,58
S01010092,Very good health,226,15,1,14,36,38,5,20,29,33,12,5,7,38
S01010092,Good health,221,9,4,5,30,27,13,16,52,40,22,17,5,12
S01010092,Fair health,165,4,0,4,13,13,10,11,47,30,32,29,3,5
S01010092,Bad health,72,2,0,2,3,11,3,5,15,22,10,9,1,1
S01010092,Very bad health,31,0,0,0,1,3,3,2,6,11,3,3,0,2
S01010093,All people aged 16 to 74,676,42,14,28,123,114,47,69,103,83,28,18,10,67
S01010093,Very good health,334,26,7,19,62,54,22,37,42,31,11,4,7,49
S01010093,Good health,212,9,4,5,43,40,14,21,38,26,9,6,3,12
S01010093,Fair health,77,2,0,2,11,14,8,5,11,18,3,3,0,5
S01010093,Bad health,41,3,1,2,6,6,2,5,10,5,3,3,0,1
S01010093,Very bad health,12,2,2,0,1,0,1,1,2,3,2,2,0,0
S01010094,All people aged 16 to 74,497,27,5,22,119,102,28,40,66,62,19,13,6,34
S01010094,Very good health,250,11,1,10,63,45,11,19,34,34,4,1,3,29
S01010094,Good health,158,10,1,9,41,36,9,12,23,18,4,2,2,5
S01010094,Fair health,56,3,2,1,14,14,4,4,6,5,6,5,1,0
S01010094,Bad health,23,2,1,1,0,7,2,3,2,4,3,3,0,0
S01010094,Very bad health,10,1,0,1,1,0,2,2,1,1,2,2,0,0
S01010095,All people aged 16 to 74,534,36,8,28,116,102,37,55,77,63,14,5,9,34
S01010095,Very good health,268,21,5,16,53,55,17,24,39,26,6,2,4,27
S01010095,Good health,179,11,1,10,48,35,10,16,23,25,5,1,4,6
S01010095,Fair health,62,3,1,2,13,7,8,11,10,7,3,2,1,0
S01010095,Bad health,19,1,1,0,2,4,2,2,3,4,0,0,0,1
S01010095,Very bad health,6,0,0,0,0,1,0,2,2,1,0,0,0,0
S01010096,All people aged 16 to 74,567,32,5,27,147,94,39,35,90,53,17,10,7,60
S01010096,Very good health,297,23,4,19,88,40,14,18,37,21,6,4,2,50
S01010096,Good health,181,8,1,7,39,38,12,11,37,22,6,2,4,8
S01010096,Fair health,60,1,0,1,16,13,11,3,8,5,2,1,1,1
S01010096,Bad health,21,0,0,0,3,1,2,2,6,3,3,3,0,1
S01010096,Very bad health,8,0,0,0,1,2,0,1,2,2,0,0,0,0
S01010097,All people aged 16 to 74,543,24,6,18,111,87,47,42,96,65,27,19,8,44
S01010097,Very good health,252,14,4,10,52,44,22,23,36,19,8,7,1,34
S01010097,Good health,185,8,2,6,41,27,15,11,36,29,9,4,5,9
S01010097,Fair health,75,2,0,2,17,10,6,6,16,13,4,2,2,1
S01010097,Bad health,27,0,0,0,1,6,4,2,7,3,4,4,0,0
S01010097,Very bad health,4,0,0,0,0,0,0,0,1,1,2,2,0,0
S01010098,All people aged 16 to 74,534,38,8,30,120,84,46,41,72,62,16,9,7,55
S01010098,Very good health,278,21,4,17,68,40,20,20,30,27,8,5,3,44
S01010098,Good health,173,14,4,10,37,32,12,18,27,17,5,1,4,11
S01010098,Fair health,55,1,0,1,11,10,13,2,9,8,1,1,0,0
S01010098,Bad health,21,1,0,1,3,2,0,1,4,9,1,1,0,0
S01010098,Very bad health,7,1,0,1,1,0,1,0,2,1,1,1,0,0
S01010099,All people aged 16 to 74,511,36,4,32,129,93,41,39,60,49,13,8,5,51
S01010099,Very good health,272,20,2,18,65,48,14,26,27,22,4,2,2,46
S01010099,Good health,164,12,2,10,50,35,18,7,21,15,4,3,1,2
S01010099,Fair health,59,3,0,3,13,8,6,5,9,10,4,2,2,1
S01010099,Bad health,11,1,0,1,1,2,2,1,1,1,1,1,0,1
S01010099,Very bad health,5,0,0,0,0,0,1,0,2,1,0,0,0,1
S01010100,All people aged 16 to 74,675,41,5,36,142,94,49,69,111,95,20,17,3,54
S01010100,Very good health,326,24,3,21,77,41,30,26,43,37,7,5,2,41
S01010100,Good health,212,13,2,11,52,34,12,23,40,23,6,5,1,9
S01010100,Fair health,86,2,0,2,8,15,5,13,20,15,5,5,0,3
S01010100,Bad health,42,2,0,2,3,4,1,6,7,16,2,2,0,1
S01010100,Very bad health,9,0,0,0,2,0,1,1,1,4,0,0,0,0
S01010101,All people aged 16 to 74,566,26,8,18,123,101,40,49,98,75,15,6,9,39
S01010101,Very good health,295,14,5,9,60,56,19,27,44,32,8,1,7,35
S01010101,Good health,161,9,2,7,38,31,19,10,26,22,2,1,1,4
S01010101,Fair health,85,2,1,1,20,13,1,11,21,14,3,2,1,0
S01010101,Bad health,16,1,0,1,3,1,1,0,4,5,1,1,0,0
S01010101,Very bad health,9,0,0,0,2,0,0,1,3,2,1,1,0,0
S01010102,All people aged 16 to 74,738,60,9,51,200,128,39,69,73,52,17,12,5,100
S01010102,Very good health,404,33,6,27,110,71,16,34,32,25,5,4,1,78
S01010102,Good health,245,21,1,20,78,43,13,26,27,14,6,3,3,17
S01010102,Fair health,66,6,2,4,9,12,7,7,12,6,2,2,0,5
S01010102,Bad health,17,0,0,0,3,2,3,1,2,4,2,2,0,0
S01010102,Very bad health,6,0,0,0,0,0,0,1,0,3,2,1,1,0
S01010103,All people aged 16 to 74,758,41,5,36,160,129,72,87,96,72,12,6,6,89
S01010103,Very good health,437,27,5,22,90,82,30,49,54,28,3,2,1,74
S01010103,Good health,243,13,0,13,57,30,30,29,35,31,4,1,3,14
S01010103,Fair health,50,1,0,1,8,12,7,7,3,9,2,1,1,1
S01010103,Bad health,17,0,0,0,2,4,4,1,3,2,1,0,1,0
S01010103,Very bad health,11,0,0,0,3,1,1,1,1,2,2,2,0,0
S01010104,All people aged 16 to 74,548,37,8,29,142,85,42,46,67,57,11,7,4,61
S01010104,Very good health,305,25,6,19,76,43,16,25,35,25,5,3,2,55
S01010104,Good health,183,11,2,9,48,34,20,17,21,22,4,2,2,6
S01010104,Fair health,43,1,0,1,14,6,5,2,7,7,1,1,0,0
S01010104,Bad health,15,0,0,0,4,2,1,1,3,3,1,1,0,0
S01010104,Very bad health,2,0,0,0,0,0,0,1,1,0,0,0,0,0
S01010105,All people aged 16 to 74,311,8,4,4,36,30,6,16,71,70,47,30,17,27
S01010105,Very good health,120,4,0,4,18,19,1,5,25,21,15,6,9,12
S01010105,Good health,105,0,0,0,9,7,2,7,27,23,16,11,5,14
S01010105,Fair health,55,4,4,0,8,1,2,2,12,13,12,9,3,1
S01010105,Bad health,22,0,0,0,0,2,1,1,6,9,3,3,0,0
S01010105,Very bad health,9,0,0,0,1,1,0,1,1,4,1,1,0,0
S01010106,All people aged 16 to 74,316,3,0,3,35,18,14,22,72,88,41,25,16,23
S01010106,Very good health,104,3,0,3,17,5,5,9,20,16,12,6,6,17
S01010106,Good health,98,0,0,0,13,8,6,8,15,32,11,7,4,5
S01010106,Fair health,59,0,0,0,1,2,1,3,23,18,10,5,5,1
S01010106,Bad health,35,0,0,0,2,3,2,0,9,14,5,4,1,0
S01010106,Very bad health,20,0,0,0,2,0,0,2,5,8,3,3,0,0
S01010107,All people aged 16 to 74,604,8,1,7,55,57,29,58,122,138,62,36,26,75
S01010107,Very good health,243,6,1,5,26,28,11,24,37,43,15,7,8,53
S01010107,Good health,182,1,0,1,21,11,12,17,52,39,12,5,7,17
S01010107,Fair health,102,1,0,1,5,9,3,9,14,33,24,14,10,4
S01010107,Bad health,47,0,0,0,2,7,0,4,10,17,6,5,1,1
S01010107,Very bad health,30,0,0,0,1,2,3,4,9,6,5,5,0,0
S01010108,All people aged 16 to 74,571,16,2,14,55,65,39,65,126,133,44,32,12,28
S01010108,Very good health,209,6,1,5,24,29,19,22,42,35,10,7,3,22
S01010108,Good health,163,8,0,8,19,21,14,20,38,31,8,4,4,4
S01010108,Fair health,99,0,0,0,6,13,1,14,18,34,13,8,5,0
S01010108,Bad health,75,2,1,1,4,1,5,7,19,24,11,11,0,2
S01010108,Very bad health,25,0,0,0,2,1,0,2,9,9,2,2,0,0
S01010109,All people aged 16 to 74,590,31,4,27,61,63,33,51,112,109,66,51,15,64
S01010109,Very good health,278,21,3,18,39,35,18,26,45,36,18,12,6,40
S01010109,Good health,177,9,1,8,14,20,11,15,42,35,16,10,6,15
S01010109,Fair health,83,1,0,1,6,6,2,6,12,21,22,19,3,7
S01010109,Bad health,37,0,0,0,2,2,0,4,9,11,7,7,0,2
S01010109,Very bad health,15,0,0,0,0,0,2,0,4,6,3,3,0,0
S01010110,All people aged 16 to 74,595,8,1,7,42,58,21,45,119,172,85,60,25,45
S01010110,Very good health,156,4,1,3,14,17,6,9,29,24,22,11,11,31
S01010110,Good health,191,3,0,3,15,23,4,14,47,59,20,12,8,6
S01010110,Fair health,126,1,0,1,7,10,4,9,19,49,22,16,6,5
S01010110,Bad health,87,0,0,0,5,7,7,9,17,28,11,11,0,3
S01010110,Very bad health,35,0,0,0,1,1,0,4,7,12,10,10,0,0
S01010111,All people aged 16 to 74,722,8,1,7,60,50,27,56,142,190,132,102,30,57
S01010111,Very good health,231,2,0,2,27,17,7,14,45,48,33,27,6,38
S01010111,Good health,207,2,0,2,16,15,12,20,41,45,42,26,16,14
S01010111,Fair health,168,4,1,3,11,12,5,11,37,52,33,28,5,3
S01010111,Bad health,85,0,0,0,3,5,2,11,15,30,18,15,3,1
S01010111,Very bad health,31,0,0,0,3,1,1,0,4,15,6,6,0,1
S01010112,All people aged 16 to 74,711,6,2,4,59,48,22,50,159,170,126,90,36,71
S01010112,Very good health,260,3,0,3,30,21,6,22,50,51,28,15,13,49
S01010112,Good health,203,3,2,1,17,13,7,18,45,38,44,30,14,18
S01010112,Fair health,136,0,0,0,7,11,5,5,32,44,28,20,8,4
S01010112,Bad health,88,0,0,0,5,2,4,4,28,26,19,18,1,0
S01010112,Very bad health,24,0,0,0,0,1,0,1,4,11,7,7,0,0
S01010113,All people aged 16 to 74,374,8,3,5,27,40,12,20,80,93,69,41,28,25
S01010113,Very good health,142,3,0,3,17,15,4,9,31,25,20,12,8,18
S01010113,Good health,109,4,3,1,4,12,4,7,25,25,24,12,12,4
S01010113,Fair health,69,1,0,1,4,6,3,2,12,21,17,11,6,3
S01010113,Bad health,36,0,0,0,2,5,1,1,8,12,7,5,2,0
S01010113,Very bad health,18,0,0,0,0,2,0,1,4,10,1,1,0,0
S01010114,All people aged 16 to 74,569,9,3,6,33,48,15,44,139,152,94,68,26,35
S01010114,Very good health,178,5,1,4,7,15,4,9,47,37,31,20,11,23
S01010114,Good health,167,0,0,0,15,20,5,13,43,37,24,18,6,10
S01010114,Fair health,126,3,2,1,7,4,4,12,28,46,22,15,7,0
S01010114,Bad health,69,0,0,0,4,4,0,8,16,25,10,9,1,2
S01010114,Very bad health,29,1,0,1,0,5,2,2,5,7,7,6,1,0
S01010115,All people aged 16 to 74,473,11,1,10,74,56,35,49,88,77,35,24,11,48
S01010115,Very good health,202,9,1,8,30,23,9,23,36,25,10,8,2,37
S01010115,Good health,186,2,0,2,32,20,19,20,34,36,15,6,9,8
S01010115,Fair health,59,0,0,0,9,10,4,4,12,10,7,7,0,3
S01010115,Bad health,22,0,0,0,2,3,3,1,6,4,3,3,0,0
S01010115,Very bad health,4,0,0,0,1,0,0,1,0,2,0,0,0,0
S01010116,All people aged 16 to 74,779,39,7,32,149,113,45,72,128,108,34,20,14,91
S01010116,Very good health,412,25,4,21,93,57,17,38,61,39,9,6,3,73
S01010116,Good health,261,13,2,11,45,44,20,26,46,38,15,7,8,14
S01010116,Fair health,68,0,0,0,5,7,6,4,14,20,8,5,3,4
S01010116,Bad health,30,0,0,0,5,4,1,4,5,9,2,2,0,0
S01010116,Very bad health,8,1,1,0,1,1,1,0,2,2,0,0,0,0
S01010117,All people aged 16 to 74,488,50,10,40,123,63,39,38,61,62,20,11,9,32
S01010117,Very good health,278,35,7,28,80,31,20,23,35,22,10,6,4,22
S01010117,Good health,145,11,2,9,32,20,15,9,18,24,7,4,3,9
S01010117,Fair health,40,2,0,2,8,9,3,3,3,10,1,0,1,1
S01010117,Bad health,20,2,1,1,3,3,1,3,3,3,2,1,1,0
S01010117,Very bad health,5,0,0,0,0,0,0,0,2,3,0,0,0,0
S01010118,All people aged 16 to 74,456,4,0,4,34,37,12,31,108,93,104,77,27,33
S01010118,Very good health,150,3,0,3,15,13,6,11,36,18,28,17,11,20
S01010118,Good health,123,1,0,1,7,10,5,11,27,24,27,17,10,11
S01010118,Fair health,111,0,0,0,7,10,1,5,27,31,29,23,6,1
S01010118,Bad health,48,0,0,0,4,3,0,3,13,12,12,12,0,1
S01010118,Very bad health,24,0,0,0,1,1,0,1,5,8,8,8,0,0
S01010119,All people aged 16 to 74,380,12,0,12,40,25,12,35,83,92,47,30,17,34
S01010119,Very good health,172,9,0,9,22,18,5,18,37,23,14,11,3,26
S01010119,Good health,106,3,0,3,12,3,4,7,25,30,17,9,8,5
S01010119,Fair health,59,0,0,0,4,4,1,5,11,22,9,4,5,3
S01010119,Bad health,32,0,0,0,2,0,1,5,8,10,6,5,1,0
S01010119,Very bad health,11,0,0,0,0,0,1,0,2,7,1,1,0,0
S01010120,All people aged 16 to 74,744,7,3,4,53,62,20,44,168,177,155,109,46,58
S01010120,Very good health,260,4,1,3,18,30,5,16,56,55,39,28,11,37
S01010120,Good health,233,3,2,1,16,15,9,13,58,57,44,26,18,18
S01010120,Fair health,144,0,0,0,13,10,1,9,30,32,47,34,13,2
S01010120,Bad health,80,0,0,0,4,7,2,5,14,28,19,15,4,1
S01010120,Very bad health,27,0,0,0,2,0,3,1,10,5,6,6,0,0
S01010121,All people aged 16 to 74,497,3,0,3,35,43,19,41,148,95,86,65,21,27
S01010121,Very good health,191,3,0,3,21,23,7,17,53,30,14,11,3,23
S01010121,Good health,142,0,0,0,8,10,5,11,54,27,25,17,8,2
S01010121,Fair health,90,0,0,0,4,7,6,7,23,19,23,13,10,1
S01010121,Bad health,58,0,0,0,2,3,1,4,15,14,18,18,0,1
S01010121,Very bad health,16,0,0,0,0,0,0,2,3,5,6,6,0,0
S01010122,All people aged 16 to 74,345,5,3,2,23,24,10,28,71,97,63,44,19,24
S01010122,Very good health,96,1,1,0,7,5,4,9,18,19,14,10,4,19
S01010122,Good health,85,1,0,1,8,9,2,5,16,24,15,6,9,5
S01010122,Fair health,67,1,1,0,3,5,0,7,14,24,13,9,4,0
S01010122,Bad health,74,1,0,1,5,4,4,5,17,22,16,14,2,0
S01010122,Very bad health,23,1,1,0,0,1,0,2,6,8,5,5,0,0
S01010123,All people aged 16 to 74,513,11,2,9,46,50,18,28,127,130,71,53,18,32
S01010123,Very good health,199,6,1,5,23,22,13,6,47,44,18,10,8,20
S01010123,Good health,166,3,1,2,14,17,2,16,47,42,17,11,6,8
S01010123,Fair health,83,0,0,0,6,9,2,4,19,24,17,13,4,2
S01010123,Bad health,48,2,0,2,3,1,1,2,11,16,10,10,0,2
S01010123,Very bad health,17,0,0,0,0,1,0,0,3,4,9,9,0,0
S01010124,All people aged 16 to 74,495,14,6,8,80,65,33,60,101,75,27,14,13,40
S01010124,Very good health,247,5,3,2,51,40,8,21,48,34,9,6,3,31
S01010124,Good health,143,6,2,4,18,15,14,21,32,21,8,3,5,8
S01010124,Fair health,62,2,0,2,6,8,6,11,14,11,4,1,3,0
S01010124,Bad health,34,1,1,0,5,2,3,6,7,5,5,4,1,0
S01010124,Very bad health,9,0,0,0,0,0,2,1,0,4,1,0,1,1
S01010125,All people aged 16 to 74,395,9,3,6,44,49,19,33,79,84,54,34,20,24
S01010125,Very good health,145,4,0,4,20,20,8,13,27,27,13,7,6,13
S01010125,Good health,128,5,3,2,14,10,8,8,27,25,21,11,10,10
S01010125,Fair health,73,0,0,0,6,14,3,6,13,15,16,12,4,0
S01010125,Bad health,39,0,0,0,4,3,0,4,10,16,1,1,0,1
S01010125,Very bad health,10,0,0,0,0,2,0,2,2,1,3,3,0,0
S01010126,All people aged 16 to 74,563,21,6,15,77,57,46,52,109,118,45,31,14,38
S01010126,Very good health,222,9,2,7,45,30,15,21,35,28,10,6,4,29
S01010126,Good health,198,9,4,5,20,19,24,20,40,44,15,8,7,7
S01010126,Fair health,91,3,0,3,8,4,2,8,22,27,15,12,3,2
S01010126,Bad health,37,0,0,0,4,3,2,1,9,15,3,3,0,0
S01010126,Very bad health,15,0,0,0,0,1,3,2,3,4,2,2,0,0
S01010127,All people aged 16 to 74,462,14,6,8,58,60,25,35,94,103,48,33,15,25
S01010127,Very good health,146,8,2,6,19,23,13,8,28,20,11,4,7,16
S01010127,Good health,148,3,1,2,28,24,6,13,21,30,16,11,5,7
S01010127,Fair health,93,3,3,0,6,4,4,12,25,26,11,9,2,2
S01010127,Bad health,58,0,0,0,5,6,1,1,18,21,6,5,1,0
S01010127,Very bad health,17,0,0,0,0,3,1,1,2,6,4,4,0,0
S01010128,All people aged 16 to 74,336,4,3,1,25,28,13,17,83,80,55,37,18,31
S01010128,Very good health,116,3,2,1,11,7,3,6,30,26,13,8,5,17
S01010128,Good health,99,1,1,0,9,10,4,7,26,16,18,11,7,8
S01010128,Fair health,71,0,0,0,4,8,2,3,14,20,16,10,6,4
S01010128,Bad health,40,0,0,0,0,2,3,1,12,16,6,6,0,0
S01010128,Very bad health,10,0,0,0,1,1,1,0,1,2,2,2,0,2
S01010129,All people aged 16 to 74,530,6,0,6,41,40,16,48,113,127,97,67,30,42
S01010129,Very good health,197,2,0,2,17,16,6,19,42,33,29,18,11,33
S01010129,Good health,150,3,0,3,14,12,3,13,34,36,27,15,12,8
S01010129,Fair health,95,1,0,1,3,6,3,11,20,28,22,18,4,1
S01010129,Bad health,70,0,0,0,6,5,4,5,12,21,17,14,3,0
S01010129,Very bad health,18,0,0,0,1,1,0,0,5,9,2,2,0,0
S01010130,All people aged 16 to 74,299,5,2,3,28,29,16,30,79,70,25,16,9,17
S01010130,Very good health,88,2,1,1,15,12,5,11,18,9,4,1,3,12
S01010130,Good health,106,3,1,2,8,11,6,17,25,21,12,7,5,3
S01010130,Fair health,63,0,0,0,4,3,4,2,22,24,3,2,1,1
S01010130,Bad health,29,0,0,0,1,2,0,0,9,12,4,4,0,1
S01010130,Very bad health,13,0,0,0,0,1,1,0,5,4,2,2,0,0
S01010131,All people aged 16 to 74,733,49,8,41,142,117,75,75,94,102,23,14,9,56
S01010131,Very good health,340,32,6,26,73,54,31,37,30,30,7,2,5,46
S01010131,Good health,247,12,1,11,45,39,28,24,46,36,7,4,3,10
S01010131,Fair health,102,3,1,2,17,19,12,8,12,25,6,6,0,0
S01010131,Bad health,32,0,0,0,6,4,4,4,5,6,3,2,1,0
S01010131,Very bad health,12,2,0,2,1,1,0,2,1,5,0,0,0,0
S01010132,All people aged 16 to 74,713,11,4,7,56,84,29,47,152,182,88,63,25,64
S01010132,Very good health,241,3,2,1,21,32,9,11,47,52,17,10,7,49
S01010132,Good health,209,6,2,4,14,28,9,14,49,53,26,11,15,10
S01010132,Fair health,156,0,0,0,11,11,7,15,41,41,26,23,3,4
S01010132,Bad health,77,2,0,2,6,9,4,7,10,26,12,12,0,1
S01010132,Very bad health,30,0,0,0,4,4,0,0,5,10,7,7,0,0
S01010133,All people aged 16 to 74,530,6,0,6,57,68,19,43,119,135,47,28,19,36
S01010133,Very good health,163,2,0,2,23,20,7,8,29,33,16,6,10,25
S01010133,Good health,137,3,0,3,17,24,8,11,33,24,9,3,6,8
S01010133,Fair health,134,1,0,1,9,14,2,15,35,43,12,11,1,3
S01010133,Bad health,79,0,0,0,6,9,2,5,17,30,10,8,2,0
S01010133,Very bad health,17,0,0,0,2,1,0,4,5,5,0,0,0,0
S01010134,All people aged 16 to 74,743,26,4,22,82,86,39,69,142,197,66,42,24,36
S01010134,Very good health,234,17,1,16,34,34,14,19,45,33,12,6,6,26
S01010134,Good health,247,7,2,5,33,29,14,21,50,60,24,12,12,9
S01010134,Fair health,161,2,1,1,9,17,9,16,29,61,17,13,4,1
S01010134,Bad health,81,0,0,0,4,6,2,11,11,36,11,9,2,0
S01010134,Very bad health,20,0,0,0,2,0,0,2,7,7,2,2,0,0
S01010135,All people aged 16 to 74,544,8,2,6,58,63,19,45,134,138,49,38,11,30
S01010135,Very good health,176,1,0,1,18,20,8,17,51,30,12,9,3,19
S01010135,Good health,172,6,2,4,23,26,6,13,42,42,7,2,5,7
S01010135,Fair health,103,1,0,1,10,7,4,9,20,33,16,13,3,3
S01010135,Bad health,74,0,0,0,6,10,0,5,19,22,11,11,0,1
S01010135,Very bad health,19,0,0,0,1,0,1,1,2,11,3,3,0,0
S01010136,All people aged 16 to 74,608,23,6,17,96,89,36,48,117,103,43,21,22,53
S01010136,Very good health,261,12,5,7,52,40,16,19,43,31,7,3,4,41
S01010136,Good health,183,9,1,8,28,27,6,13,36,34,21,9,12,9
S01010136,Fair health,110,2,0,2,11,16,9,9,25,26,10,6,4,2
S01010136,Bad health,39,0,0,0,3,6,2,4,11,10,2,1,1,1
S01010136,Very bad health,15,0,0,0,2,0,3,3,2,2,3,2,1,0
S01010137,All people aged 16 to 74,666,29,7,22,106,96,38,63,129,110,47,30,17,48
S01010137,Very good health,270,15,3,12,48,41,13,31,44,30,11,7,4,37
S01010137,Good health,191,11,4,7,32,24,7,13,45,33,16,10,6,10
S01010137,Fair health,110,2,0,2,15,18,12,9,17,24,12,6,6,1
S01010137,Bad health,65,1,0,1,8,7,3,8,14,20,4,4,0,0
S01010137,Very bad health,30,0,0,0,3,6,3,2,9,3,4,3,1,0
S01010138,All people aged 16 to 74,760,16,8,8,68,79,50,77,160,158,124,65,59,28
S01010138,Very good health,188,7,2,5,30,29,8,11,32,21,30,12,18,20
S01010138,Good health,203,6,5,1,23,23,11,15,53,27,38,15,23,7
S01010138,Fair health,175,3,1,2,9,13,13,23,37,49,28,16,12,0
S01010138,Bad health,158,0,0,0,4,13,15,22,30,49,24,18,6,1
S01010138,Very bad health,36,0,0,0,2,1,3,6,8,12,4,4,0,0
S01010139,All people aged 16 to 74,780,21,3,18,96,111,38,77,158,155,77,51,26,47
S01010139,Very good health,276,10,1,9,44,37,14,23,54,41,22,15,7,31
S01010139,Good health,258,4,1,3,28,46,16,26,58,46,20,10,10,14
S01010139,Fair health,143,4,1,3,16,15,6,16,24,38,23,15,8,1
S01010139,Bad health,77,3,0,3,6,6,2,9,17,23,10,9,1,1
S01010139,Very bad health,26,0,0,0,2,7,0,3,5,7,2,2,0,0
S01010140,All people aged 16 to 74,582,30,7,23,100,106,29,51,104,87,36,25,11,39
S01010140,Very good health,291,18,4,14,57,54,13,22,46,38,20,15,5,23
S01010140,Good health,187,12,3,9,32,38,11,17,34,27,4,2,2,12
S01010140,Fair health,66,0,0,0,8,11,5,7,13,15,6,2,4,1
S01010140,Bad health,22,0,0,0,0,1,0,2,8,4,4,4,0,3
S01010140,Very bad health,16,0,0,0,3,2,0,3,3,3,2,2,0,0
S01010141,All people aged 16 to 74,613,12,3,9,58,45,25,62,123,158,91,67,24,39
S01010141,Very good health,192,7,2,5,28,20,11,15,32,31,17,5,12,31
S01010141,Good health,172,3,0,3,19,19,8,19,30,46,24,17,7,4
S01010141,Fair health,138,0,0,0,8,4,4,14,36,44,25,20,5,3
S01010141,Bad health,83,2,1,1,1,2,1,10,20,28,18,18,0,1
S01010141,Very bad health,28,0,0,0,2,0,1,4,5,9,7,7,0,0
S01010142,All people aged 16 to 74,458,13,7,6,54,47,30,32,102,85,51,36,15,44
S01010142,Very good health,184,6,2,4,22,25,16,17,27,29,11,6,5,31
S01010142,Good health,153,4,3,1,23,18,9,9,39,23,21,15,6,7
S01010142,Fair health,75,3,2,1,8,2,3,5,20,17,11,8,3,6
S01010142,Bad health,33,0,0,0,1,1,0,0,16,9,6,6,0,0
S01010142,Very bad health,13,0,0,0,0,1,2,1,0,7,2,1,1,0
S01010143,All people aged 16 to 74,517,17,4,13,61,62,28,52,121,116,35,23,12,25
S01010143,Very good health,175,7,0,7,24,25,9,8,40,29,15,9,6,18
S01010143,Good health,137,6,2,4,16,21,12,19,25,34,2,1,1,2
S01010143,Fair health,117,4,2,2,10,10,5,14,29,32,9,4,5,4
S01010143,Bad health,64,0,0,0,10,5,1,6,23,14,5,5,0,0
S01010143,Very bad health,24,0,0,0,1,1,1,5,4,7,4,4,0,1
S01010144,All people aged 16 to 74,557,15,2,13,79,67,25,44,112,123,57,34,23,35
S01010144,Very good health,226,10,1,9,41,28,11,18,49,36,13,6,7,20
S01010144,Good health,179,5,1,4,23,23,8,16,34,47,11,2,9,12
S01010144,Fair health,90,0,0,0,7,11,6,5,17,21,20,16,4,3
S01010144,Bad health,49,0,0,0,8,4,0,4,9,16,8,5,3,0
S01010144,Very bad health,13,0,0,0,0,1,0,1,3,3,5,5,0,0
S01010145,All people aged 16 to 74,586,16,3,13,96,71,31,46,119,115,52,33,19,40
S01010145,Very good health,233,10,1,9,47,32,14,19,37,27,18,11,7,29
S01010145,Good health,211,2,0,2,31,26,13,18,48,48,17,12,5,8
S01010145,Fair health,84,4,2,2,10,9,4,5,22,16,12,6,6,2
S01010145,Bad health,44,0,0,0,6,4,0,1,10,19,3,3,0,1
S01010145,Very bad health,14,0,0,0,2,0,0,3,2,5,2,1,1,0
S01010146,All people aged 16 to 74,614,9,1,8,60,57,25,52,136,131,92,65,27,52
S01010146,Very good health,216,3,1,2,34,27,9,13,41,34,20,15,5,35
S01010146,Good health,213,4,0,4,18,20,8,21,55,39,34,18,16,14
S01010146,Fair health,103,2,0,2,4,6,7,11,22,29,21,16,5,1
S01010146,Bad health,61,0,0,0,4,3,1,5,14,21,11,10,1,2
S01010146,Very bad health,21,0,0,0,0,1,0,2,4,8,6,6,0,0
S01010147,All people aged 16 to 74,718,10,4,6,59,68,31,58,173,156,119,79,40,44
S01010147,Very good health,235,5,3,2,27,33,14,19,39,37,27,22,5,34
S01010147,Good health,222,2,1,1,18,22,6,20,54,51,39,15,24,10
S01010147,Fair health,123,2,0,2,6,8,5,10,38,29,25,17,8,0
S01010147,Bad health,101,0,0,0,7,3,3,5,34,28,21,18,3,0
S01010147,Very bad health,37,1,0,1,1,2,3,4,8,11,7,7,0,0
S01010148,All people aged 16 to 74,565,9,2,7,50,47,19,53,114,134,99,74,25,40
S01010148,Very good health,223,4,1,3,21,27,4,20,44,43,26,21,5,34
S01010148,Good health,159,4,0,4,18,10,9,16,38,34,28,16,12,2
S01010148,Fair health,91,1,1,0,3,1,5,10,19,29,21,14,7,2
S01010148,Bad health,59,0,0,0,5,5,0,7,6,21,14,13,1,1
S01010148,Very bad health,33,0,0,0,3,4,1,0,7,7,10,10,0,1
S01010149,All people aged 16 to 74,408,16,0,16,87,53,33,31,57,70,36,33,3,25
S01010149,Very good health,203,10,0,10,59,29,13,16,22,29,5,4,1,20
S01010149,Good health,128,6,0,6,23,15,15,9,18,19,20,18,2,3
S01010149,Fair health,51,0,0,0,4,4,3,5,11,16,6,6,0,2
S01010149,Bad health,18,0,0,0,0,4,1,1,4,5,3,3,0,0
S01010149,Very bad health,8,0,0,0,1,1,1,0,2,1,2,2,0,0
S01010150,All people aged 16 to 74,464,11,2,9,41,53,26,40,111,107,57,41,16,18
S01010150,Very good health,133,8,1,7,19,16,5,11,27,21,13,8,5,13
S01010150,Good health,141,2,0,2,14,23,10,8,39,27,14,6,8,4
S01010150,Fair health,101,1,1,0,5,9,8,10,26,25,16,14,2,1
S01010150,Bad health,69,0,0,0,3,4,1,10,13,27,11,10,1,0
S01010150,Very bad health,20,0,0,0,0,1,2,1,6,7,3,3,0,0
S01010151,All people aged 16 to 74,431,8,0,8,41,57,13,39,89,102,49,36,13,33
S01010151,Very good health,130,3,0,3,17,23,5,12,20,19,10,6,4,21
S01010151,Good health,129,2,0,2,12,18,5,10,33,24,17,11,6,8
S01010151,Fair health,106,1,0,1,7,9,2,12,21,36,15,12,3,3
S01010151,Bad health,52,2,0,2,4,6,1,3,13,17,5,5,0,1
S01010151,Very bad health,14,0,0,0,1,1,0,2,2,6,2,2,0,0
S01010152,All people aged 16 to 74,620,18,5,13,67,101,20,59,109,144,52,32,20,50
S01010152,Very good health,248,8,4,4,30,49,10,21,36,40,15,7,8,39
S01010152,Good health,201,6,1,5,27,34,4,18,43,47,12,8,4,10
S01010152,Fair health,101,1,0,1,6,12,3,12,18,31,17,10,7,1
S01010152,Bad health,53,3,0,3,3,3,2,7,11,17,7,6,1,0
S01010152,Very bad health,17,0,0,0,1,3,1,1,1,9,1,1,0,0
S01010153,All people aged 16 to 74,688,25,9,16,87,81,36,62,134,146,71,59,12,46
S01010153,Very good health,240,11,4,7,45,35,8,23,46,32,7,5,2,33
S01010153,Good health,217,10,4,6,26,27,15,15,41,41,32,29,3,10
S01010153,Fair health,130,2,1,1,13,8,9,12,32,35,17,11,6,2
S01010153,Bad health,69,0,0,0,3,8,2,6,9,32,9,8,1,0
S01010153,Very bad health,32,2,0,2,0,3,2,6,6,6,6,6,0,1
S01010154,All people aged 16 to 74,629,17,4,13,87,86,18,43,138,146,54,46,8,40
S01010154,Very good health,192,8,2,6,34,29,5,13,37,32,10,7,3,24
S01010154,Good health,193,7,2,5,27,29,7,14,47,38,16,11,5,8
S01010154,Fair health,137,0,0,0,12,20,5,11,31,38,14,14,0,6
S01010154,Bad health,79,1,0,1,8,5,0,5,19,27,12,12,0,2
S01010154,Very bad health,28,1,0,1,6,3,1,0,4,11,2,2,0,0
S01010155,All people aged 16 to 74,511,16,3,13,58,68,21,44,111,117,46,34,12,30
S01010155,Very good health,165,10,2,8,17,19,7,19,38,24,12,9,3,19
S01010155,Good health,180,4,1,3,26,33,7,14,41,33,12,5,7,10
S01010155,Fair health,93,1,0,1,11,11,7,5,15,31,11,10,1,1
S01010155,Bad health,48,0,0,0,2,4,0,3,12,21,6,5,1,0
S01010155,Very bad health,25,1,0,1,2,1,0,3,5,8,5,5,0,0
S01010156,All people aged 16 to 74,396,15,1,14,27,50,33,26,79,98,46,29,17,22
S01010156,Very good health,140,10,1,9,10,22,12,8,26,22,13,8,5,17
S01010156,Good health,105,4,0,4,7,18,12,7,26,21,7,2,5,3
S01010156,Fair health,84,1,0,1,2,8,7,7,17,27,14,8,6,1
S01010156,Bad health,47,0,0,0,6,2,1,2,6,19,10,9,1,1
S01010156,Very bad health,20,0,0,0,2,0,1,2,4,9,2,2,0,0
S01010157,All people aged 16 to 74,423,6,1,5,26,50,19,27,90,117,64,45,19,24
S01010157,Very good health,139,4,1,3,11,19,6,9,24,29,21,16,5,16
S01010157,Good health,115,0,0,0,7,18,6,9,23,31,17,8,9,4
S01010157,Fair health,87,2,0,2,3,3,3,4,21,33,16,13,3,2
S01010157,Bad health,56,0,0,0,2,7,1,2,14,20,10,8,2,0
S01010157,Very bad health,26,0,0,0,3,3,3,3,8,4,0,0,0,2
S01010158,All people aged 16 to 74,667,12,1,11,82,95,36,58,137,140,61,39,22,46
S01010158,Very good health,220,6,1,5,28,45,10,24,35,29,17,10,7,26
S01010158,Good health,216,5,0,5,34,25,15,14,50,42,17,8,9,14
S01010158,Fair health,140,1,0,1,11,16,8,11,36,39,17,11,6,1
S01010158,Bad health,55,0,0,0,9,5,2,5,8,17,6,6,0,3
S01010158,Very bad health,36,0,0,0,0,4,1,4,8,13,4,4,0,2
S01010159,All people aged 16 to 74,513,11,1,10,71,56,27,53,111,118,44,34,10,22
S01010159,Very good health,152,4,0,4,24,17,5,16,34,28,9,3,6,15
S01010159,Good health,177,3,0,3,28,23,13,15,43,39,10,6,4,3
S01010159,Fair health,106,3,1,2,13,11,5,13,19,30,9,9,0,3
S01010159,Bad health,60,0,0,0,4,5,2,7,12,19,10,10,0,1
S01010159,Very bad health,18,1,0,1,2,0,2,2,3,2,6,6,0,0
S01010160,All people aged 16 to 74,465,4,0,4,18,28,30,46,96,112,88,57,31,43
S01010160,Very good health,135,4,0,4,7,10,9,14,24,28,20,14,6,19
S01010160,Good health,190,0,0,0,6,10,14,19,33,50,36,21,15,22
S01010160,Fair health,67,0,0,0,4,4,6,7,21,8,17,10,7,0
S01010160,Bad health,54,0,0,0,0,3,1,4,16,19,9,9,0,2
S01010160,Very bad health,19,0,0,0,1,1,0,2,2,7,6,3,3,0
S01010161,All people aged 16 to 74,469,16,4,12,51,48,25,44,112,94,46,34,12,33
S01010161,Very good health,216,9,4,5,30,26,13,19,51,27,17,12,5,24
S01010161,Good health,144,7,0,7,15,16,8,18,30,28,15,10,5,7
S01010161,Fair health,55,0,0,0,4,5,1,3,12,21,8,6,2,1
S01010161,Bad health,45,0,0,0,2,0,2,4,14,17,5,5,0,1
S01010161,Very bad health,9,0,0,0,0,1,1,0,5,1,1,1,0,0
S01010162,All people aged 16 to 74,542,7,1,6,32,52,16,32,117,122,117,80,37,47
S01010162,Very good health,198,5,1,4,20,21,6,10,39,37,31,20,11,29
S01010162,Good health,161,0,0,0,5,22,6,11,37,30,40,25,15,10
S01010162,Fair health,104,2,0,2,5,7,2,5,25,26,25,17,8,7
S01010162,Bad health,64,0,0,0,2,2,2,4,12,26,15,12,3,1
S01010162,Very bad health,15,0,0,0,0,0,0,2,4,3,6,6,0,0
S01010163,All people aged 16 to 74,442,7,1,6,37,51,13,28,96,100,70,53,17,40
S01010163,Very good health,171,3,0,3,22,18,8,8,39,29,20,16,4,24
S01010163,Good health,111,2,0,2,9,13,1,7,28,27,15,10,5,9
S01010163,Fair health,79,1,0,1,5,11,3,6,15,13,20,14,6,5
S01010163,Bad health,60,0,0,0,1,9,1,7,9,22,9,7,2,2
S01010163,Very bad health,21,1,1,0,0,0,0,0,5,9,6,6,0,0
S01010164,All people aged 16 to 74,550,11,6,5,55,51,29,53,108,124,68,51,17,51
S01010164,Very good health,195,2,0,2,26,24,8,15,34,32,17,12,5,37
S01010164,Good health,163,6,3,3,11,12,13,13,34,40,23,16,7,11
S01010164,Fair health,116,3,3,0,11,12,5,16,24,25,18,14,4,2
S01010164,Bad health,54,0,0,0,3,1,2,7,13,20,7,6,1,1
S01010164,Very bad health,22,0,0,0,4,2,1,2,3,7,3,3,0,0
S01010165,All people aged 16 to 74,459,2,0,2,37,42,8,31,101,118,82,60,22,38
S01010165,Very good health,153,0,0,0,22,13,1,9,28,35,23,14,9,22
S01010165,Good health,139,2,0,2,10,12,4,11,33,32,25,16,9,10
S01010165,Fair health,106,0,0,0,4,9,2,7,31,31,18,16,2,4
S01010165,Bad health,50,0,0,0,1,7,0,3,8,15,14,13,1,2
S01010165,Very bad health,11,0,0,0,0,1,1,1,1,5,2,1,1,0
S01010166,All people aged 16 to 74,551,7,2,5,51,53,23,50,140,126,67,49,18,34
S01010166,Very good health,178,3,0,3,24,21,7,19,44,25,15,10,5,20
S01010166,Good health,184,4,2,2,13,24,11,15,52,36,16,10,6,13
S01010166,Fair health,105,0,0,0,8,5,4,7,28,35,18,14,4,0
S01010166,Bad health,60,0,0,0,4,2,1,7,12,20,13,10,3,1
S01010166,Very bad health,24,0,0,0,2,1,0,2,4,10,5,5,0,0
S01010167,All people aged 16 to 74,612,6,1,5,36,65,25,47,142,194,72,40,32,25
S01010167,Very good health,175,2,1,1,9,22,9,24,32,40,16,7,9,21
S01010167,Good health,177,2,0,2,17,23,5,10,46,52,20,8,12,2
S01010167,Fair health,147,2,0,2,6,13,5,4,38,60,18,10,8,1
S01010167,Bad health,77,0,0,0,3,4,5,6,17,25,16,13,3,1
S01010167,Very bad health,36,0,0,0,1,3,1,3,9,17,2,2,0,0
S01010168,All people aged 16 to 74,375,7,2,5,44,54,22,27,83,66,46,26,20,26
S01010168,Very good health,160,4,1,3,27,27,10,11,26,23,13,6,7,19
S01010168,Good health,121,2,1,1,13,18,8,8,31,22,13,7,6,6
S01010168,Fair health,49,0,0,0,1,3,3,6,12,12,12,6,6,0
S01010168,Bad health,36,1,0,1,3,4,1,1,11,6,8,7,1,1
S01010168,Very bad health,9,0,0,0,0,2,0,1,3,3,0,0,0,0
S01010169,All people aged 16 to 74,611,5,0,5,92,57,24,44,152,113,84,60,24,40
S01010169,Very good health,238,1,0,1,42,25,14,16,65,33,22,13,9,20
S01010169,Good health,201,4,0,4,35,15,8,9,54,35,24,19,5,17
S01010169,Fair health,111,0,0,0,10,5,2,14,22,34,21,12,9,3
S01010169,Bad health,47,0,0,0,5,11,0,3,11,9,8,7,1,0
S01010169,Very bad health,14,0,0,0,0,1,0,2,0,2,9,9,0,0
S01010170,All people aged 16 to 74,416,4,0,4,42,37,21,36,96,112,45,28,17,23
S01010170,Very good health,146,1,0,1,15,14,10,11,36,31,14,7,7,14
S01010170,Good health,135,2,0,2,14,16,5,13,33,29,16,10,6,7
S01010170,Fair health,73,1,0,1,7,4,4,5,14,27,10,6,4,1
S01010170,Bad health,47,0,0,0,6,2,1,4,8,21,5,5,0,0
S01010170,Very bad health,15,0,0,0,0,1,1,3,5,4,0,0,0,1
S01010171,All people aged 16 to 74,726,10,2,8,36,51,24,57,163,171,166,125,41,48
S01010171,Very good health,252,8,2,6,17,31,5,11,56,43,50,35,15,31
S01010171,Good health,214,2,0,2,9,9,10,20,51,49,53,34,19,11
S01010171,Fair health,146,0,0,0,8,8,5,17,29,42,32,25,7,5
S01010171,Bad health,79,0,0,0,1,2,3,7,20,25,20,20,0,1
S01010171,Very bad health,35,0,0,0,1,1,1,2,7,12,11,11,0,0
S01010172,All people aged 16 to 74,501,14,1,13,84,73,22,46,80,114,55,38,17,13
S01010172,Very good health,157,7,0,7,40,24,7,18,16,26,12,7,5,7
S01010172,Good health,156,3,1,2,25,29,7,10,33,29,14,5,9,6
S01010172,Fair health,105,2,0,2,14,15,3,12,16,31,12,10,2,0
S01010172,Bad health,58,1,0,1,3,3,3,6,12,19,11,10,1,0
S01010172,Very bad health,25,1,0,1,2,2,2,0,3,9,6,6,0,0
S01010173,All people aged 16 to 74,529,12,1,11,69,75,33,50,125,85,42,31,11,38
S01010173,Very good health,227,6,0,6,30,35,12,24,47,27,15,13,2,31
S01010173,Good health,166,5,1,4,30,19,13,15,36,29,15,7,8,4
S01010173,Fair health,85,1,0,1,7,16,4,7,21,18,9,8,1,2
S01010173,Bad health,42,0,0,0,2,4,2,2,18,10,3,3,0,1
S01010173,Very bad health,9,0,0,0,0,1,2,2,3,1,0,0,0,0
S01010174,All people aged 16 to 74,1251,30,8,22,97,86,79,131,210,282,296,275,21,40
S01010174,Very good health,398,9,0,9,30,37,16,57,70,86,70,66,4,23
S01010174,Good health,483,12,3,9,32,32,38,45,88,108,116,108,8,12
S01010174,Fair health,257,5,2,3,25,12,19,19,40,63,70,61,9,4
S01010174,Bad health,91,3,2,1,8,5,5,7,11,21,30,30,0,1
S01010174,Very bad health,22,1,1,0,2,0,1,3,1,4,10,10,0,0
S01010175,All people aged 16 to 74,344,9,5,4,45,53,18,20,63,85,31,20,11,20
S01010175,Very good health,120,1,0,1,20,24,5,5,24,22,6,3,3,13
S01010175,Good health,123,6,3,3,14,20,6,8,23,31,10,6,4,5
S01010175,Fair health,59,0,0,0,7,5,5,5,10,15,10,6,4,2
S01010175,Bad health,29,1,1,0,4,2,1,2,5,11,3,3,0,0
S01010175,Very bad health,13,1,1,0,0,2,1,0,1,6,2,2,0,0
S01010176,All people aged 16 to 74,495,18,3,15,67,57,26,39,119,92,46,34,12,31
S01010176,Very good health,186,14,3,11,30,25,9,13,43,21,10,6,4,21
S01010176,Good health,155,3,0,3,18,20,7,13,40,31,16,10,6,7
S01010176,Fair health,90,0,0,0,12,8,8,8,19,23,10,8,2,2
S01010176,Bad health,43,1,0,1,4,3,2,4,10,11,7,7,0,1
S01010176,Very bad health,21,0,0,0,3,1,0,1,7,6,3,3,0,0
S01010177,All people aged 16 to 74,541,5,2,3,44,54,21,47,109,114,99,71,28,48
S01010177,Very good health,217,4,1,3,19,29,10,18,47,25,31,23,8,34
S01010177,Good health,156,1,1,0,11,10,6,12,34,32,41,22,19,9
S01010177,Fair health,98,0,0,0,11,10,4,8,15,28,19,19,0,3
S01010177,Bad health,48,0,0,0,2,2,1,4,11,21,6,6,0,1
S01010177,Very bad health,22,0,0,0,1,3,0,5,2,8,2,1,1,1
S01010178,All people aged 16 to 74,708,7,1,6,51,70,23,54,168,147,130,101,29,58
S01010178,Very good health,272,3,0,3,18,34,7,15,73,39,40,28,12,43
S01010178,Good health,207,2,1,1,18,17,10,20,53,36,37,26,11,14
S01010178,Fair health,142,2,0,2,12,13,5,10,25,40,34,28,6,1
S01010178,Bad health,67,0,0,0,2,5,1,5,12,28,14,14,0,0
S01010178,Very bad health,20,0,0,0,1,1,0,4,5,4,5,5,0,0
S01010179,All people aged 16 to 74,640,8,1,7,41,58,14,49,155,174,102,82,20,39
S01010179,Very good health,195,3,1,2,21,21,4,10,51,38,23,18,5,24
S01010179,Good health,210,3,0,3,12,24,7,19,53,51,27,17,10,14
S01010179,Fair health,126,2,0,2,5,6,2,9,25,47,29,24,5,1
S01010179,Bad health,85,0,0,0,3,5,1,9,21,26,20,20,0,0
S01010179,Very bad health,24,0,0,0,0,2,0,2,5,12,3,3,0,0
S01010180,All people aged 16 to 74,386,17,1,16,58,50,27,35,76,59,45,33,12,19
S01010180,Very good health,178,10,1,9,33,23,10,16,34,21,17,10,7,14
S01010180,Good health,138,5,0,5,23,21,11,12,29,23,9,5,4,5
S01010180,Fair health,43,1,0,1,2,5,4,5,6,7,13,12,1,0
S01010180,Bad health,22,0,0,0,0,1,1,2,6,6,6,6,0,0
S01010180,Very bad health,5,1,0,1,0,0,1,0,1,2,0,0,0,0
S01010181,All people aged 16 to 74,450,7,1,6,41,46,23,25,91,107,89,64,25,21
S01010181,Very good health,158,3,0,3,11,20,10,14,32,29,21,11,10,18
S01010181,Good health,117,3,0,3,17,12,5,3,28,23,25,11,14,1
S01010181,Fair health,94,1,1,0,9,9,7,2,17,28,20,20,0,1
S01010181,Bad health,54,0,0,0,2,2,0,3,10,17,19,18,1,1
S01010181,Very bad health,27,0,0,0,2,3,1,3,4,10,4,4,0,0
S01010182,All people aged 16 to 74,552,40,10,30,112,86,44,45,91,73,22,15,7,39
S01010182,Very good health,244,20,5,15,57,43,15,21,34,18,9,5,4,27
S01010182,Good health,201,12,4,8,38,29,21,15,40,26,9,6,3,11
S01010182,Fair health,71,6,1,5,13,13,6,3,10,17,2,2,0,1
S01010182,Bad health,25,1,0,1,4,1,1,3,6,7,2,2,0,0
S01010182,Very bad health,11,1,0,1,0,0,1,3,1,5,0,0,0,0
S01010183,All people aged 16 to 74,320,4,0,4,41,38,9,32,72,64,43,33,10,17
S01010183,Very good health,107,1,0,1,14,20,2,9,28,14,6,4,2,13
S01010183,Good health,96,2,0,2,13,11,3,10,23,20,11,5,6,3
S01010183,Fair health,67,0,0,0,9,3,3,4,12,24,12,10,2,0
S01010183,Bad health,37,1,0,1,4,3,1,6,8,4,10,10,0,0
S01010183,Very bad health,13,0,0,0,1,1,0,3,1,2,4,4,0,1
S01010184,All people aged 16 to 74,462,8,3,5,35,48,18,39,108,113,54,33,21,39
S01010184,Very good health,170,3,0,3,15,24,5,16,28,37,15,9,6,27
S01010184,Good health,150,5,3,2,13,9,9,14,47,31,14,5,9,8
S01010184,Fair health,90,0,0,0,3,11,3,7,18,28,17,12,5,3
S01010184,Bad health,38,0,0,0,4,2,0,2,9,13,7,6,1,1
S01010184,Very bad health,14,0,0,0,0,2,1,0,6,4,1,1,0,0
S01010185,All people aged 16 to 74,445,4,1,3,38,33,20,37,116,115,52,36,16,30
S01010185,Very good health,144,3,1,2,16,13,4,11,33,26,23,18,5,15
S01010185,Good health,142,0,0,0,16,10,7,16,32,41,12,7,5,8
S01010185,Fair health,95,1,0,1,4,7,7,5,31,23,12,6,6,5
S01010185,Bad health,48,0,0,0,2,3,2,4,11,21,3,3,0,2
S01010185,Very bad health,16,0,0,0,0,0,0,1,9,4,2,2,0,0
S01010186,All people aged 16 to 74,501,23,6,17,100,81,39,42,77,71,17,12,5,51
S01010186,Very good health,246,11,2,9,51,39,15,19,33,26,10,7,3,42
S01010186,Good health,167,11,3,8,35,26,12,18,23,30,5,3,2,7
S01010186,Fair health,66,1,1,0,11,13,10,4,15,10,0,0,0,2
S01010186,Bad health,16,0,0,0,2,3,2,1,5,2,1,1,0,0
S01010186,Very bad health,6,0,0,0,1,0,0,0,1,3,1,1,0,0
S01010187,All people aged 16 to 74,528,26,7,19,105,100,27,53,88,67,21,13,8,41
S01010187,Very good health,275,18,6,12,63,54,14,27,32,32,4,1,3,31
S01010187,Good health,159,7,0,7,28,29,7,15,34,22,8,5,3,9
S01010187,Fair health,61,1,1,0,10,8,5,7,16,8,5,4,1,1
S01010187,Bad health,24,0,0,0,3,6,1,3,5,3,3,2,1,0
S01010187,Very bad health,9,0,0,0,1,3,0,1,1,2,1,1,0,0
S01010188,All people aged 16 to 74,561,55,12,43,144,92,50,40,67,50,25,20,5,38
S01010188,Very good health,314,37,8,29,89,53,22,22,31,19,7,4,3,34
S01010188,Good health,153,14,4,10,44,28,19,9,16,17,3,2,1,3
S01010188,Fair health,67,4,0,4,8,9,8,6,14,8,9,8,1,1
S01010188,Bad health,22,0,0,0,3,2,1,2,4,6,4,4,0,0
S01010188,Very bad health,5,0,0,0,0,0,0,1,2,0,2,2,0,0
S01010189,All people aged 16 to 74,730,65,7,58,177,128,58,59,76,67,24,17,7,76
S01010189,Very good health,422,36,5,31,110,72,28,29,38,35,13,9,4,61
S01010189,Good health,232,28,1,27,55,48,22,22,28,15,4,1,3,10
S01010189,Fair health,52,1,1,0,9,7,6,6,4,10,5,5,0,4
S01010189,Bad health,15,0,0,0,2,1,1,2,4,3,1,1,0,1
S01010189,Very bad health,9,0,0,0,1,0,1,0,2,4,1,1,0,0
S01010190,All people aged 16 to 74,573,102,18,84,140,61,71,39,47,23,26,16,10,64
S01010190,Very good health,369,76,10,66,102,40,38,21,21,5,12,5,7,54
S01010190,Good health,161,19,5,14,30,19,28,15,21,10,9,6,3,10
S01010190,Fair health,34,6,3,3,6,1,5,3,4,6,3,3,0,0
S01010190,Bad health,7,1,0,1,1,1,0,0,1,1,2,2,0,0
S01010190,Very bad health,2,0,0,0,1,0,0,0,0,1,0,0,0,0
S01010191,All people aged 16 to 74,521,48,4,44,137,81,46,41,58,46,21,14,7,43
S01010191,Very good health,319,25,4,21,95,48,27,18,30,24,13,8,5,39
S01010191,Good health,146,20,0,20,33,23,16,16,15,18,2,0,2,3
S01010191,Fair health,39,3,0,3,6,8,1,6,9,2,3,3,0,1
S01010191,Bad health,11,0,0,0,2,1,1,1,3,2,1,1,0,0
S01010191,Very bad health,6,0,0,0,1,1,1,0,1,0,2,2,0,0
S01010192,All people aged 16 to 74,627,77,13,64,136,102,49,58,73,53,32,24,8,47
S01010192,Very good health,357,46,8,38,81,63,25,30,38,27,13,8,5,34
S01010192,Good health,189,24,5,19,41,29,18,22,24,13,9,6,3,9
S01010192,Fair health,58,6,0,6,8,6,6,6,9,11,4,4,0,2
S01010192,Bad health,12,1,0,1,4,1,0,0,1,1,3,3,0,1
S01010192,Very bad health,11,0,0,0,2,3,0,0,1,1,3,3,0,1
S01010193,All people aged 16 to 74,575,48,9,39,135,85,53,51,84,52,24,19,5,43
S01010193,Very good health,282,23,3,20,73,40,25,31,33,18,5,5,0,34
S01010193,Good health,207,20,4,16,47,29,20,16,33,20,14,9,5,8
S01010193,Fair health,60,5,2,3,12,11,4,3,15,7,2,2,0,1
S01010193,Bad health,18,0,0,0,3,4,3,0,2,4,2,2,0,0
S01010193,Very bad health,8,0,0,0,0,1,1,1,1,3,1,1,0,0
S01010194,All people aged 16 to 74,472,13,2,11,59,68,18,38,98,93,47,31,16,38
S01010194,Very good health,175,6,1,5,24,33,7,11,33,22,11,5,6,28
S01010194,Good health,168,5,0,5,21,25,6,14,31,38,21,12,9,7
S01010194,Fair health,81,2,1,1,11,9,3,7,22,17,8,7,1,2
S01010194,Bad health,31,0,0,0,0,0,1,4,8,12,5,5,0,1
S01010194,Very bad health,17,0,0,0,3,1,1,2,4,4,2,2,0,0
S01010195,All people aged 16 to 74,390,13,3,10,39,57,22,33,76,81,32,23,9,37
S01010195,Very good health,167,8,1,7,20,30,10,15,25,26,8,7,1,25
S01010195,Good health,124,4,2,2,15,18,5,9,21,32,11,7,4,9
S01010195,Fair health,54,1,0,1,2,4,4,5,15,12,9,6,3,2
S01010195,Bad health,34,0,0,0,1,4,3,2,12,8,3,2,1,1
S01010195,Very bad health,11,0,0,0,1,1,0,2,3,3,1,1,0,0
S01010196,All people aged 16 to 74,561,13,3,10,48,79,13,49,107,149,71,52,19,32
S01010196,Very good health,186,7,2,5,20,33,4,11,38,31,22,10,12,20
S01010196,Good health,193,3,0,3,18,30,5,19,35,49,22,20,2,12
S01010196,Fair health,101,2,0,2,4,11,3,8,20,35,18,14,4,0
S01010196,Bad health,56,1,1,0,3,4,1,9,10,23,5,4,1,0
S01010196,Very bad health,25,0,0,0,3,1,0,2,4,11,4,4,0,0
S01010197,All people aged 16 to 74,500,4,1,3,48,51,12,39,116,124,59,39,20,47
S01010197,Very good health,174,3,0,3,18,18,4,11,40,34,18,11,7,28
S01010197,Good health,166,0,0,0,19,24,4,19,33,36,18,10,8,13
S01010197,Fair health,95,1,1,0,7,6,1,4,24,36,14,9,5,2
S01010197,Bad health,50,0,0,0,2,2,3,5,15,13,7,7,0,3
S01010197,Very bad health,15,0,0,0,2,1,0,0,4,5,2,2,0,1
S01010198,All people aged 16 to 74,748,15,3,12,70,72,29,63,171,181,94,66,28,53
S01010198,Very good health,242,6,1,5,32,26,10,18,45,44,21,10,11,40
S01010198,Good health,261,8,2,6,20,32,10,19,66,63,37,25,12,6
S01010198,Fair health,151,1,0,1,15,8,7,17,32,42,23,19,4,6
S01010198,Bad health,64,0,0,0,1,5,1,6,21,19,10,9,1,1
S01010198,Very bad health,30,0,0,0,2,1,1,3,7,13,3,3,0,0
S01010199,All people aged 16 to 74,375,10,0,10,34,41,11,25,75,91,62,39,23,26
S01010199,Very good health,140,3,0,3,12,19,6,6,28,23,24,17,7,19
S01010199,Good health,121,5,0,5,14,17,2,10,24,32,14,7,7,3
S01010199,Fair health,72,1,0,1,5,4,1,7,16,20,14,5,9,4
S01010199,Bad health,31,1,0,1,2,0,2,2,2,14,8,8,0,0
S01010199,Very bad health,11,0,0,0,1,1,0,0,5,2,2,2,0,0
S01010200,All people aged 16 to 74,487,10,2,8,52,67,24,39,116,119,39,25,14,21
S01010200,Very good health,199,4,0,4,29,30,8,18,45,38,13,6,7,14
S01010200,Good health,142,4,1,3,15,15,10,12,37,32,11,7,4,6
S01010200,Fair health,84,2,1,1,4,11,3,6,20,25,13,10,3,0
S01010200,Bad health,36,0,0,0,4,8,1,2,9,10,1,1,0,1
S01010200,Very bad health,26,0,0,0,0,3,2,1,5,14,1,1,0,0
S01010201,All people aged 16 to 74,453,12,6,6,43,74,26,48,88,111,29,20,9,22
S01010201,Very good health,188,8,3,5,25,42,10,20,31,30,10,6,4,12
S01010201,Good health,155,2,1,1,12,20,9,17,31,44,10,6,4,10
S01010201,Fair health,71,1,1,0,3,7,5,7,21,24,3,2,1,0
S01010201,Bad health,28,0,0,0,2,3,1,4,5,9,4,4,0,0
S01010201,Very bad health,11,1,1,0,1,2,1,0,0,4,2,2,0,0
S01010202,All people aged 16 to 74,520,9,0,9,43,46,18,36,113,104,111,79,32,40
S01010202,Very good health,165,7,0,7,15,11,5,12,40,27,27,10,17,21
S01010202,Good health,180,2,0,2,12,23,6,14,37,30,41,32,9,15
S01010202,Fair health,94,0,0,0,8,5,3,5,22,24,24,19,5,3
S01010202,Bad health,55,0,0,0,7,3,3,4,11,14,12,11,1,1
S01010202,Very bad health,26,0,0,0,1,4,1,1,3,9,7,7,0,0
S01010203,All people aged 16 to 74,504,31,8,23,91,80,29,49,81,72,25,21,4,46
S01010203,Very good health,242,17,4,13,44,47,18,20,32,29,8,8,0,27
S01010203,Good health,180,11,2,9,36,24,9,19,32,24,11,8,3,14
S01010203,Fair health,53,2,2,0,6,4,2,9,13,12,1,1,0,4
S01010203,Bad health,23,1,0,1,3,5,0,1,4,6,2,1,1,1
S01010203,Very bad health,6,0,0,0,2,0,0,0,0,1,3,3,0,0
S01010204,All people aged 16 to 74,589,8,0,8,41,48,13,50,129,146,104,84,20,50
S01010204,Very good health,197,5,0,5,13,13,3,19,42,38,32,22,10,32
S01010204,Good health,171,3,0,3,13,22,1,11,39,48,21,16,5,13
S01010204,Fair health,123,0,0,0,6,10,1,12,28,32,31,26,5,3
S01010204,Bad health,74,0,0,0,7,1,7,5,20,17,15,15,0,2
S01010204,Very bad health,24,0,0,0,2,2,1,3,0,11,5,5,0,0
S01010205,All people aged 16 to 74,534,16,2,14,84,52,23,38,108,110,69,53,16,34
S01010205,Very good health,214,8,1,7,41,21,7,14,43,34,22,13,9,24
S01010205,Good health,165,5,1,4,27,20,11,9,32,34,22,15,7,5
S01010205,Fair health,85,2,0,2,9,6,3,10,22,22,10,10,0,1
S01010205,Bad health,49,1,0,1,7,5,1,3,8,12,9,9,0,3
S01010205,Very bad health,21,0,0,0,0,0,1,2,3,8,6,6,0,1
S01010206,All people aged 16 to 74,338,9,2,7,8,14,11,14,32,26,184,173,11,40
S01010206,Very good health,91,3,0,3,3,6,2,5,11,10,39,39,0,12
S01010206,Good health,155,5,2,3,2,6,8,4,11,10,95,86,9,14
S01010206,Fair health,52,1,0,1,1,1,1,4,2,2,29,27,2,11
S01010206,Bad health,32,0,0,0,2,1,0,1,5,3,19,19,0,1
S01010206,Very bad health,8,0,0,0,0,0,0,0,3,1,2,2,0,2
S01010207,All people aged 16 to 74,459,9,2,7,34,25,20,33,63,72,125,113,12,78
S01010207,Very good health,177,7,1,6,15,9,5,8,30,20,34,30,4,49
S01010207,Good health,129,2,1,1,6,8,11,8,14,21,41,37,4,18
S01010207,Fair health,75,0,0,0,8,5,4,9,7,12,23,20,3,7
S01010207,Bad health,57,0,0,0,4,2,0,1,12,16,18,17,1,4
S01010207,Very bad health,21,0,0,0,1,1,0,7,0,3,9,9,0,0
S01010208,All people aged 16 to 74,745,33,6,27,133,126,38,68,112,115,62,43,19,58
S01010208,Very good health,301,21,4,17,63,62,15,25,29,32,14,9,5,40
S01010208,Good health,256,6,1,5,45,40,14,22,49,44,21,11,10,15
S01010208,Fair health,114,4,1,3,17,15,6,12,22,24,11,9,2,3
S01010208,Bad health,54,1,0,1,7,6,2,5,8,12,13,11,2,0
S01010208,Very bad health,20,1,0,1,1,3,1,4,4,3,3,3,0,0
S01010209,All people aged 16 to 74,677,36,5,31,100,75,24,65,121,127,86,56,30,43
S01010209,Very good health,259,17,2,15,47,27,11,25,41,40,25,15,10,26
S01010209,Good health,214,15,3,12,33,29,9,15,37,33,29,18,11,14
S01010209,Fair health,118,1,0,1,13,13,3,13,23,29,22,16,6,1
S01010209,Bad health,65,1,0,1,5,5,1,12,15,14,10,7,3,2
S01010209,Very bad health,21,2,0,2,2,1,0,0,5,11,0,0,0,0
S01010210,All people aged 16 to 74,641,26,3,23,119,77,29,46,125,125,51,34,17,43
S01010210,Very good health,267,15,2,13,62,36,7,10,47,44,16,11,5,30
S01010210,Good health,195,9,1,8,40,18,13,16,38,37,12,4,8,12
S01010210,Fair health,108,0,0,0,11,13,5,11,26,30,11,8,3,1
S01010210,Bad health,51,1,0,1,3,9,4,7,9,11,7,6,1,0
S01010210,Very bad health,20,1,0,1,3,1,0,2,5,3,5,5,0,0
S01010211,All people aged 16 to 74,634,12,1,11,67,72,17,47,134,145,84,65,19,56
S01010211,Very good health,216,5,0,5,32,34,4,18,37,33,17,13,4,36
S01010211,Good health,181,5,1,4,22,21,6,15,36,37,24,15,9,15
S01010211,Fair health,131,0,0,0,8,7,4,7,30,44,28,22,6,3
S01010211,Bad health,85,2,0,2,4,8,2,4,27,25,12,12,0,1
S01010211,Very bad health,21,0,0,0,1,2,1,3,4,6,3,3,0,1
S01010212,All people aged 16 to 74,779,14,0,14,61,77,15,75,174,162,120,83,37,81
S01010212,Very good health,265,6,0,6,25,37,6,28,57,36,17,8,9,53
S01010212,Good health,236,3,0,3,21,18,3,19,50,54,44,25,19,24
S01010212,Fair health,151,3,0,3,9,10,4,13,41,37,31,23,8,3
S01010212,Bad health,92,2,0,2,6,10,1,9,17,28,18,17,1,1
S01010212,Very bad health,35,0,0,0,0,2,1,6,9,7,10,10,0,0
S01010213,All people aged 16 to 74,657,13,3,10,81,96,15,69,163,140,46,31,15,34
S01010213,Very good health,218,7,1,6,33,33,7,18,58,31,7,1,6,24
S01010213,Good health,227,4,2,2,31,35,4,26,59,45,14,9,5,9
S01010213,Fair health,117,2,0,2,11,20,2,16,20,28,17,14,3,1
S01010213,Bad health,73,0,0,0,5,7,2,6,21,26,6,5,1,0
S01010213,Very bad health,22,0,0,0,1,1,0,3,5,10,2,2,0,0
S01010214,All people aged 16 to 74,717,44,9,35,113,112,43,80,109,118,41,29,12,57
S01010214,Very good health,303,22,3,19,49,48,14,31,40,43,14,10,4,42
S01010214,Good health,258,18,5,13,47,45,17,31,37,41,10,6,4,12
S01010214,Fair health,111,4,1,3,12,12,9,13,24,21,13,9,4,3
S01010214,Bad health,32,0,0,0,3,5,1,2,7,12,2,2,0,0
S01010214,Very bad health,13,0,0,0,2,2,2,3,1,1,2,2,0,0
S01010215,All people aged 16 to 74,608,9,1,8,46,76,20,58,136,142,78,44,34,43
S01010215,Very good health,178,7,1,6,14,26,9,12,33,27,24,17,7,26
S01010215,Good health,200,1,0,1,18,28,6,25,40,39,31,9,22,12
S01010215,Fair health,149,0,0,0,11,10,4,13,43,50,15,11,4,3
S01010215,Bad health,62,1,0,1,2,8,1,7,18,18,5,4,1,2
S01010215,Very bad health,19,0,0,0,1,4,0,1,2,8,3,3,0,0
S01010216,All people aged 16 to 74,464,10,2,8,45,48,22,24,107,93,78,60,18,37
S01010216,Very good health,155,4,1,3,22,16,5,10,26,22,19,18,1,31
S01010216,Good health,142,5,1,4,11,14,10,7,38,26,26,14,12,5
S01010216,Fair health,95,1,0,1,8,11,5,2,25,28,14,11,3,1
S01010216,Bad health,54,0,0,0,2,7,2,4,12,13,14,12,2,0
S01010216,Very bad health,18,0,0,0,2,0,0,1,6,4,5,5,0,0
S01010217,All people aged 16 to 74,598,20,7,13,63,58,12,51,109,100,108,74,34,77
S01010217,Very good health,255,13,2,11,32,29,3,21,37,35,33,20,13,52
S01010217,Good health,181,7,5,2,17,15,5,10,41,32,35,24,11,19
S01010217,Fair health,107,0,0,0,10,9,3,13,21,20,25,17,8,6
S01010217,Bad health,47,0,0,0,3,5,1,7,6,12,13,11,2,0
S01010217,Very bad health,8,0,0,0,1,0,0,0,4,1,2,2,0,0
S01010218,All people aged 16 to 74,790,27,3,24,118,99,40,59,164,119,115,72,43,49
S01010218,Very good health,336,15,1,14,63,45,12,21,85,33,28,18,10,34
S01010218,Good health,242,8,1,7,38,41,13,15,41,26,50,29,21,10
S01010218,Fair health,116,1,0,1,10,7,8,16,17,34,19,11,8,4
S01010218,Bad health,73,3,1,2,4,4,6,7,14,20,14,10,4,1
S01010218,Very bad health,23,0,0,0,3,2,1,0,7,6,4,4,0,0
S01010219,All people aged 16 to 74,382,11,2,9,29,26,12,25,79,49,64,48,16,87
S01010219,Very good health,177,6,1,5,17,10,3,9,32,14,22,14,8,64
S01010219,Good health,115,4,1,3,5,8,3,8,26,18,24,19,5,19
S01010219,Fair health,45,0,0,0,5,2,2,6,12,6,8,6,2,4
S01010219,Bad health,32,1,0,1,1,5,2,1,8,8,6,5,1,0
S01010219,Very bad health,13,0,0,0,1,1,2,1,1,3,4,4,0,0
S01010220,All people aged 16 to 74,433,87,5,82,92,49,23,19,37,20,11,8,3,95
S01010220,Very good health,268,62,4,58,55,28,13,10,22,9,4,2,2,65
S01010220,Good health,132,24,1,23,29,18,8,8,9,8,5,4,1,23
S01010220,Fair health,26,1,0,1,5,2,2,1,5,2,1,1,0,7
S01010220,Bad health,5,0,0,0,3,1,0,0,0,0,1,1,0,0
S01010220,Very bad health,2,0,0,0,0,0,0,0,1,1,0,0,0,0
S01010221,All people aged 16 to 74,394,12,1,11,36,34,7,37,95,78,65,55,10,30
S01010221,Very good health,135,4,1,3,16,13,1,13,28,19,19,15,4,22
S01010221,Good health,118,4,0,4,11,10,3,11,31,24,19,17,2,5
S01010221,Fair health,74,3,0,3,7,4,2,8,19,15,14,13,1,2
S01010221,Bad health,52,1,0,1,1,3,1,3,15,17,11,8,3,0
S01010221,Very bad health,15,0,0,0,1,4,0,2,2,3,2,2,0,1
S01010222,All people aged 16 to 74,414,21,5,16,35,56,15,53,76,76,40,26,14,42
S01010222,Very good health,165,14,4,10,17,30,4,13,23,17,15,7,8,32
S01010222,Good health,145,6,1,5,14,15,7,23,32,29,12,8,4,7
S01010222,Fair health,72,1,0,1,2,10,2,13,14,20,8,6,2,2
S01010222,Bad health,20,0,0,0,1,0,0,3,6,8,1,1,0,1
S01010222,Very bad health,12,0,0,0,1,1,2,1,1,2,4,4,0,0
S01010223,All people aged 16 to 74,462,18,4,14,58,51,19,48,83,80,52,37,15,53
S01010223,Very good health,149,7,2,5,27,23,8,15,19,14,9,7,2,27
S01010223,Good health,157,8,2,6,20,14,8,12,33,26,24,12,12,12
S01010223,Fair health,91,2,0,2,6,9,1,12,13,27,15,14,1,6
S01010223,Bad health,51,0,0,0,5,4,2,6,14,10,3,3,0,7
S01010223,Very bad health,14,1,0,1,0,1,0,3,4,3,1,1,0,1
S01010224,All people aged 16 to 74,727,21,4,17,62,49,21,47,152,161,144,107,37,70
S01010224,Very good health,287,9,1,8,30,21,11,19,58,46,47,31,16,46
S01010224,Good health,203,6,2,4,18,16,4,6,49,47,39,22,17,18
S01010224,Fair health,118,5,1,4,5,5,3,9,22,32,34,31,3,3
S01010224,Bad health,89,1,0,1,8,7,3,9,16,22,20,19,1,3
S01010224,Very bad health,30,0,0,0,1,0,0,4,7,14,4,4,0,0
S01010225,All people aged 16 to 74,636,19,2,17,101,71,14,47,125,111,82,71,11,66
S01010225,Very good health,247,12,0,12,51,31,4,14,42,29,22,19,3,42
S01010225,Good health,199,3,0,3,38,21,5,17,39,30,27,23,4,19
S01010225,Fair health,109,3,1,2,7,10,4,7,28,26,20,18,2,4
S01010225,Bad health,60,0,0,0,5,8,1,5,9,20,11,9,2,1
S01010225,Very bad health,21,1,1,0,0,1,0,4,7,6,2,2,0,0
S01010226,All people aged 16 to 74,565,18,1,17,42,30,30,39,103,74,131,107,24,98
S01010226,Very good health,202,15,1,14,19,14,5,6,40,22,31,24,7,50
S01010226,Good health,222,1,0,1,13,9,20,20,33,23,62,51,11,41
S01010226,Fair health,79,0,0,0,5,6,4,6,17,18,17,12,5,6
S01010226,Bad health,47,1,0,1,5,1,1,6,9,7,16,15,1,1
S01010226,Very bad health,15,1,0,1,0,0,0,1,4,4,5,5,0,0
S01010227,All people aged 16 to 74,454,13,1,12,27,22,15,20,74,74,134,114,20,75
S01010227,Very good health,164,5,0,5,12,7,6,7,33,15,34,27,7,45
S01010227,Good health,163,7,1,6,12,9,8,8,16,34,45,41,4,24
S01010227,Fair health,78,0,0,0,1,2,0,5,17,14,35,29,6,4
S01010227,Bad health,31,1,0,1,1,1,0,0,7,7,13,13,0,1
S01010227,Very bad health,18,0,0,0,1,3,1,0,1,4,7,4,3,1
S01010228,All people aged 16 to 74,499,7,1,6,36,51,17,34,113,146,71,61,10,24
S01010228,Very good health,154,3,0,3,17,19,7,16,34,27,16,10,6,15
S01010228,Good health,142,2,1,1,11,15,4,7,42,41,14,12,2,6
S01010228,Fair health,103,2,0,2,2,6,3,7,14,44,23,21,2,2
S01010228,Bad health,77,0,0,0,6,8,3,3,18,21,17,17,0,1
S01010228,Very bad health,23,0,0,0,0,3,0,1,5,13,1,1,0,0
S01010229,All people aged 16 to 74,787,25,5,20,82,86,30,70,174,170,93,71,22,57
S01010229,Very good health,280,19,2,17,45,44,9,25,43,44,18,8,10,33
S01010229,Good health,256,5,2,3,29,25,11,26,64,46,33,23,10,17
S01010229,Fair health,137,1,1,0,4,11,7,13,35,39,21,20,1,6
S01010229,Bad health,85,0,0,0,4,6,3,5,24,33,10,9,1,0
S01010229,Very bad health,29,0,0,0,0,0,0,1,8,8,11,11,0,1
S01010230,All people aged 16 to 74,772,22,3,19,56,50,19,38,156,143,153,113,40,135
S01010230,Very good health,306,13,1,12,32,15,7,13,55,29,48,34,14,94
S01010230,Good health,225,5,0,5,10,16,6,11,54,48,39,25,14,36
S01010230,Fair health,138,1,0,1,7,12,3,13,20,33,44,34,10,5
S01010230,Bad health,69,1,1,0,5,5,3,1,19,19,16,14,2,0
S01010230,Very bad health,34,2,1,1,2,2,0,0,8,14,6,6,0,0
S01010231,All people aged 16 to 74,712,15,0,15,58,79,27,44,189,146,86,61,25,68
S01010231,Very good health,270,5,0,5,26,42,12,19,72,32,19,12,7,43
S01010231,Good health,230,8,0,8,18,22,10,15,62,47,29,14,15,19
S01010231,Fair health,132,2,0,2,9,9,4,5,28,48,23,20,3,4
S01010231,Bad health,63,0,0,0,4,5,1,3,20,15,14,14,0,1
S01010231,Very bad health,17,0,0,0,1,1,0,2,7,4,1,1,0,1
S01010232,All people aged 16 to 74,792,20,5,15,62,74,31,37,151,183,130,97,33,104
S01010232,Very good health,337,14,4,10,36,33,16,11,62,64,31,22,9,70
S01010232,Good health,235,4,0,4,18,18,9,15,47,53,42,24,18,29
S01010232,Fair health,116,1,0,1,4,7,4,5,24,29,38,34,4,4
S01010232,Bad health,77,1,1,0,3,12,1,4,15,27,13,12,1,1
S01010232,Very bad health,27,0,0,0,1,4,1,2,3,10,6,5,1,0
S01010233,All people aged 16 to 74,705,12,0,12,64,54,27,43,138,133,170,129,41,64
S01010233,Very good health,255,8,0,8,26,28,7,11,51,40,50,38,12,34
S01010233,Good health,245,4,0,4,24,16,12,15,53,39,58,36,22,24
S01010233,Fair health,114,0,0,0,12,3,6,5,15,29,39,33,6,5
S01010233,Bad health,78,0,0,0,1,6,2,10,16,20,22,21,1,1
S01010233,Very bad health,13,0,0,0,1,1,0,2,3,5,1,1,0,0
S01010234,All people aged 16 to 74,793,91,7,84,167,94,38,45,102,81,37,25,12,138
S01010234,Very good health,412,59,3,56,101,36,18,24,35,32,12,5,7,95
S01010234,Good health,269,29,3,26,53,41,15,12,43,25,10,6,4,41
S01010234,Fair health,63,1,0,1,9,7,3,5,17,16,4,3,1,1
S01010234,Bad health,36,1,1,0,3,6,2,2,5,7,9,9,0,1
S01010234,Very bad health,13,1,0,1,1,4,0,2,2,1,2,2,0,0
S01010235,All people aged 16 to 74,742,140,11,129,168,65,13,43,44,27,23,17,6,219
S01010235,Very good health,501,101,7,94,122,45,8,26,26,16,9,7,2,148
S01010235,Good health,197,37,4,33,39,17,4,13,10,4,13,9,4,60
S01010235,Fair health,28,1,0,1,5,3,1,2,2,3,0,0,0,11
S01010235,Bad health,12,1,0,1,2,0,0,2,5,1,1,1,0,0
S01010235,Very bad health,4,0,0,0,0,0,0,0,1,3,0,0,0,0
S01010236,All people aged 16 to 74,618,66,5,61,156,69,27,48,71,46,34,24,10,101
S01010236,Very good health,329,43,2,41,95,38,17,24,29,14,12,7,5,57
S01010236,Good health,189,13,2,11,42,23,9,14,22,19,10,8,2,37
S01010236,Fair health,60,8,1,7,11,4,0,8,11,5,8,5,3,5
S01010236,Bad health,28,0,0,0,6,4,1,1,5,5,4,4,0,2
S01010236,Very bad health,12,2,0,2,2,0,0,1,4,3,0,0,0,0
S01010237,All people aged 16 to 74,543,74,7,67,124,74,23,43,57,46,23,13,10,79
S01010237,Very good health,303,55,5,50,78,37,14,20,29,15,6,3,3,49
S01010237,Good health,152,14,1,13,33,23,4,15,14,15,8,5,3,26
S01010237,Fair health,56,5,1,4,6,11,4,3,8,10,5,1,4,4
S01010237,Bad health,26,0,0,0,6,3,0,4,6,4,3,3,0,0
S01010237,Very bad health,6,0,0,0,1,0,1,1,0,2,1,1,0,0
S01010238,All people aged 16 to 74,704,57,5,52,147,80,37,42,106,66,34,21,13,135
S01010238,Very good health,402,35,3,32,95,42,21,24,49,22,8,1,7,106
S01010238,Good health,192,20,2,18,37,25,10,8,32,18,15,10,5,27
S01010238,Fair health,69,1,0,1,10,12,5,7,13,15,5,4,1,1
S01010238,Bad health,26,0,0,0,3,1,1,2,8,6,4,4,0,1
S01010238,Very bad health,15,1,0,1,2,0,0,1,4,5,2,2,0,0
S01010239,All people aged 16 to 74,612,20,1,19,64,77,17,43,120,137,68,43,25,66
S01010239,Very good health,222,15,1,14,37,37,2,13,31,28,19,13,6,40
S01010239,Good health,200,4,0,4,11,31,11,17,39,41,23,10,13,23
S01010239,Fair health,104,1,0,1,12,5,2,5,29,35,14,11,3,1
S01010239,Bad health,62,0,0,0,3,3,2,7,18,19,8,6,2,2
S01010239,Very bad health,24,0,0,0,1,1,0,1,3,14,4,3,1,0
S01010240,All people aged 16 to 74,580,41,5,36,122,76,17,41,85,87,37,24,13,74
S01010240,Very good health,259,25,3,22,67,29,7,16,31,24,11,6,5,49
S01010240,Good health,202,12,1,11,40,39,8,13,29,29,9,5,4,23
S01010240,Fair health,76,3,1,2,10,5,1,6,15,20,15,11,4,1
S01010240,Bad health,32,1,0,1,5,3,0,4,5,11,2,2,0,1
S01010240,Very bad health,11,0,0,0,0,0,1,2,5,3,0,0,0,0
S01010241,All people aged 16 to 74,830,63,14,49,158,118,34,60,117,120,61,32,29,99
S01010241,Very good health,374,37,9,28,81,54,18,27,42,33,18,8,10,64
S01010241,Good health,279,22,5,17,57,40,10,15,42,41,20,10,10,32
S01010241,Fair health,104,4,0,4,9,17,2,8,19,30,12,4,8,3
S01010241,Bad health,57,0,0,0,9,6,3,8,10,12,9,8,1,0
S01010241,Very bad health,16,0,0,0,2,1,1,2,4,4,2,2,0,0
S01010242,All people aged 16 to 74,644,33,1,32,87,101,25,37,102,93,81,53,28,85
S01010242,Very good health,270,20,0,20,53,46,7,8,40,24,14,5,9,58
S01010242,Good health,203,10,1,9,22,29,6,10,40,39,22,9,13,25
S01010242,Fair health,93,2,0,2,5,15,8,10,9,12,30,25,5,2
S01010242,Bad health,57,1,0,1,4,9,3,5,11,12,12,11,1,0
S01010242,Very bad health,21,0,0,0,3,2,1,4,2,6,3,3,0,0
S01010243,All people aged 16 to 74,833,25,4,21,103,119,27,61,134,141,136,86,50,87
S01010243,Very good health,303,15,3,12,52,49,11,23,46,38,27,13,14,42
S01010243,Good health,318,7,1,6,36,41,9,20,64,54,47,24,23,40
S01010243,Fair health,133,3,0,3,9,22,3,14,11,29,37,29,8,5
S01010243,Bad health,51,0,0,0,2,6,4,4,10,9,16,13,3,0
S01010243,Very bad health,28,0,0,0,4,1,0,0,3,11,9,7,2,0
S01010244,All people aged 16 to 74,591,22,3,19,58,51,20,43,110,105,106,67,39,76
S01010244,Very good health,229,12,2,10,24,22,9,8,41,21,31,21,10,61
S01010244,Good health,160,7,0,7,21,12,8,13,33,26,29,12,17,11
S01010244,Fair health,112,0,0,0,7,6,2,17,25,30,23,16,7,2
S01010244,Bad health,69,2,0,2,4,6,1,3,9,23,19,15,4,2
S01010244,Very bad health,21,1,1,0,2,5,0,2,2,5,4,3,1,0
S01010245,All people aged 16 to 74,741,6,2,4,46,33,29,42,145,235,143,111,32,62
S01010245,Very good health,238,4,2,2,19,10,11,11,53,69,26,17,9,35
S01010245,Good health,192,1,0,1,14,8,6,10,46,53,38,27,11,16
S01010245,Fair health,154,1,0,1,4,7,4,11,20,65,33,24,9,9
S01010245,Bad health,123,0,0,0,6,6,8,5,24,41,32,29,3,1
S01010245,Very bad health,34,0,0,0,3,2,0,5,2,7,14,14,0,1
S01010246,All people aged 16 to 74,649,11,1,10,56,53,20,71,148,134,81,54,27,75
S01010246,Very good health,239,7,0,7,28,24,8,22,48,35,24,13,11,43
S01010246,Good health,225,4,1,3,19,18,8,28,57,40,22,12,10,29
S01010246,Fair health,113,0,0,0,5,6,4,13,24,34,25,19,6,2
S01010246,Bad health,46,0,0,0,1,3,0,5,15,17,5,5,0,0
S01010246,Very bad health,26,0,0,0,3,2,0,3,4,8,5,5,0,1
S01010247,All people aged 16 to 74,581,17,2,15,90,90,27,73,108,98,33,21,12,45
S01010247,Very good health,234,10,0,10,45,35,14,24,35,21,9,2,7,41
S01010247,Good health,198,4,2,2,34,38,10,27,37,38,7,3,4,3
S01010247,Fair health,94,2,0,2,9,12,3,15,23,22,7,6,1,1
S01010247,Bad health,48,1,0,1,2,5,0,5,11,15,9,9,0,0
S01010247,Very bad health,7,0,0,0,0,0,0,2,2,2,1,1,0,0
S01010248,All people aged 16 to 74,738,108,8,100,189,69,30,48,75,54,21,12,9,144
S01010248,Very good health,450,89,3,86,131,30,11,23,41,15,4,3,1,106
S01010248,Good health,194,18,5,13,47,25,8,17,20,18,9,2,7,32
S01010248,Fair health,58,1,0,1,7,11,5,1,12,12,3,3,0,6
S01010248,Bad health,29,0,0,0,3,2,6,5,0,9,4,3,1,0
S01010248,Very bad health,7,0,0,0,1,1,0,2,2,0,1,1,0,0
S01010249,All people aged 16 to 74,617,52,6,46,135,69,16,39,73,67,28,18,10,138
S01010249,Very good health,310,34,3,31,77,29,3,21,25,23,11,7,4,87
S01010249,Good health,208,14,3,11,41,24,8,12,30,27,6,3,3,46
S01010249,Fair health,77,4,0,4,16,13,3,3,13,11,9,6,3,5
S01010249,Bad health,19,0,0,0,1,3,2,3,3,5,2,2,0,0
S01010249,Very bad health,3,0,0,0,0,0,0,0,2,1,0,0,0,0
S01010250,All people aged 16 to 74,676,79,10,69,166,64,22,36,63,43,19,12,7,184
S01010250,Very good health,401,58,7,51,101,33,13,23,33,15,3,1,2,122
S01010250,Good health,198,16,3,13,53,23,4,9,20,12,6,4,2,55
S01010250,Fair health,49,4,0,4,7,6,3,4,9,6,5,4,1,5
S01010250,Bad health,20,1,0,1,4,0,2,0,1,6,4,2,2,2
S01010250,Very bad health,8,0,0,0,1,2,0,0,0,4,1,1,0,0
S01010251,All people aged 16 to 74,558,63,1,62,127,64,26,32,43,33,17,12,5,153
S01010251,Very good health,359,50,1,49,91,37,12,15,25,13,7,2,5,109
S01010251,Good health,163,10,0,10,29,23,12,14,12,16,5,5,0,42
S01010251,Fair health,25,2,0,2,5,3,2,1,4,4,3,3,0,1
S01010251,Bad health,8,1,0,1,1,1,0,2,2,0,1,1,0,0
S01010251,Very bad health,3,0,0,0,1,0,0,0,0,0,1,1,0,1
S01010252,All people aged 16 to 74,521,55,0,55,130,81,22,24,62,47,29,24,5,71
S01010252,Very good health,282,36,0,36,80,41,11,9,27,16,9,7,2,53
S01010252,Good health,173,14,0,14,44,32,8,10,23,18,9,8,1,15
S01010252,Fair health,41,4,0,4,3,7,3,3,7,4,7,6,1,3
S01010252,Bad health,20,1,0,1,3,1,0,2,4,5,4,3,1,0
S01010252,Very bad health,5,0,0,0,0,0,0,0,1,4,0,0,0,0
S01010253,All people aged 16 to 74,481,16,1,15,52,51,15,43,85,82,69,49,20,68
S01010253,Very good health,182,12,1,11,19,23,5,13,29,19,21,13,8,41
S01010253,Good health,145,3,0,3,18,17,1,13,31,24,13,7,6,25
S01010253,Fair health,90,0,0,0,12,4,5,12,18,27,11,7,4,1
S01010253,Bad health,49,1,0,1,2,6,1,5,7,7,20,18,2,0
S01010253,Very bad health,15,0,0,0,1,1,3,0,0,5,4,4,0,1
S01010254,All people aged 16 to 74,841,42,5,37,119,102,33,51,169,154,66,57,9,105
S01010254,Very good health,338,27,3,24,63,40,11,16,61,31,17,14,3,72
S01010254,Good health,273,12,1,11,45,36,12,20,49,49,20,15,5,30
S01010254,Fair health,127,1,0,1,5,13,5,9,36,43,12,11,1,3
S01010254,Bad health,79,2,1,1,4,8,4,5,20,24,12,12,0,0
S01010254,Very bad health,24,0,0,0,2,5,1,1,3,7,5,5,0,0
S01010255,All people aged 16 to 74,523,12,2,10,56,52,28,42,82,109,80,46,34,62
S01010255,Very good health,214,8,0,8,32,27,9,18,29,23,24,10,14,44
S01010255,Good health,143,3,1,2,13,11,7,10,25,29,28,14,14,17
S01010255,Fair health,89,1,1,0,4,8,7,5,14,35,14,9,5,1
S01010255,Bad health,52,0,0,0,5,6,5,6,9,13,8,7,1,0
S01010255,Very bad health,25,0,0,0,2,0,0,3,5,9,6,6,0,0
S01010256,All people aged 16 to 74,676,18,0,18,68,77,38,41,147,137,78,47,31,72
S01010256,Very good health,259,8,0,8,41,27,16,12,53,30,21,10,11,51
S01010256,Good health,191,7,0,7,15,31,8,14,38,45,16,7,9,17
S01010256,Fair health,143,1,0,1,10,12,10,9,41,36,21,12,9,3
S01010256,Bad health,61,2,0,2,0,5,2,6,10,20,15,13,2,1
S01010256,Very bad health,22,0,0,0,2,2,2,0,5,6,5,5,0,0
S01010257,All people aged 16 to 74,770,63,6,57,92,44,23,20,60,52,63,41,22,353
S01010257,Very good health,427,43,3,40,54,30,10,4,28,10,18,12,6,230
S01010257,Good health,212,15,2,13,27,9,7,7,12,8,16,5,11,111
S01010257,Fair health,75,2,1,1,7,3,2,4,13,16,17,13,4,11
S01010257,Bad health,37,1,0,1,3,1,1,4,7,12,7,6,1,1
S01010257,Very bad health,19,2,0,2,1,1,3,1,0,6,5,5,0,0
S01010258,All people aged 16 to 74,1461,99,7,92,99,40,11,13,24,19,21,15,6,1135
S01010258,Very good health,982,75,6,69,70,25,6,6,16,12,14,10,4,758
S01010258,Good health,412,22,1,21,23,13,5,7,6,5,6,4,2,325
S01010258,Fair health,62,2,0,2,6,2,0,0,2,0,0,0,0,50
S01010258,Bad health,5,0,0,0,0,0,0,0,0,2,1,1,0,2
S01010258,Very bad health,0,0,0,0,0,0,0,0,0,0,0,0,0,0
S01010259,All people aged 16 to 74,1089,21,2,19,43,43,17,37,106,114,84,61,23,624
S01010259,Very good health,579,13,0,13,28,20,9,10,39,20,27,19,8,413
S01010259,Good health,318,4,2,2,7,18,3,11,26,33,20,9,11,196
S01010259,Fair health,97,2,0,2,3,3,4,8,19,31,16,14,2,11
S01010259,Bad health,80,1,0,1,4,2,1,8,19,21,20,18,2,4
S01010259,Very bad health,15,1,0,1,1,0,0,0,3,9,1,1,0,0
S01010260,All people aged 16 to 74,1780,141,10,131,144,92,34,47,79,57,47,30,17,1139
S01010260,Very good health,1057,93,8,85,92,47,11,19,29,12,17,9,8,737
S01010260,Good health,558,40,2,38,40,27,17,18,24,19,14,7,7,359
S01010260,Fair health,108,4,0,4,7,11,4,8,15,12,9,7,2,38
S01010260,Bad health,44,4,0,4,5,7,1,1,6,12,4,4,0,4
S01010260,Very bad health,13,0,0,0,0,0,1,1,5,2,3,3,0,1
S01010261,All people aged 16 to 74,2373,19,2,17,52,67,16,43,94,121,75,54,21,1886
S01010261,Very good health,1426,15,2,13,29,31,3,16,29,26,23,19,4,1254
S01010261,Good health,718,3,0,3,14,22,5,12,30,41,27,12,15,564
S01010261,Fair health,156,0,0,0,4,6,0,10,20,31,19,18,1,66
S01010261,Bad health,54,1,0,1,3,4,5,3,14,17,5,4,1,2
S01010261,Very bad health,19,0,0,0,2,4,3,2,1,6,1,1,0,0
S01010262,All people aged 16 to 74,676,18,2,16,53,47,19,57,112,140,66,47,19,164
S01010262,Very good health,243,8,0,8,25,14,5,17,26,20,13,9,4,115
S01010262,Good health,195,8,2,6,15,24,7,10,37,40,13,9,4,41
S01010262,Fair health,127,1,0,1,7,5,4,12,27,40,24,14,10,7
S01010262,Bad health,85,1,0,1,6,3,2,13,17,31,11,10,1,1
S01010262,Very bad health,26,0,0,0,0,1,1,5,5,9,5,5,0,0
S01010263,All people aged 16 to 74,713,109,9,100,150,51,20,18,29,29,19,9,10,288
S01010263,Very good health,487,77,5,72,101,30,14,11,17,17,11,5,6,209
S01010263,Good health,175,22,2,20,43,14,5,6,8,3,4,2,2,70
S01010263,Fair health,32,6,1,5,4,5,1,1,2,2,3,1,2,8
S01010263,Bad health,13,3,1,2,2,1,0,0,2,3,1,1,0,1
S01010263,Very bad health,6,1,0,1,0,1,0,0,0,4,0,0,0,0
S01010264,All people aged 16 to 74,788,137,10,127,138,63,23,30,71,69,55,28,27,202
S01010264,Very good health,452,107,6,101,92,37,10,10,24,13,15,7,8,144
S01010264,Good health,194,19,3,16,33,16,10,9,21,23,16,5,11,47
S01010264,Fair health,76,9,1,8,6,6,1,7,13,10,13,5,8,11
S01010264,Bad health,59,2,0,2,6,3,2,4,12,21,9,9,0,0
S01010264,Very bad health,7,0,0,0,1,1,0,0,1,2,2,2,0,0
S01010265,All people aged 16 to 74,1014,175,21,154,180,60,29,28,28,11,14,9,5,489
S01010265,Very good health,684,127,12,115,127,39,20,16,17,8,3,3,0,327
S01010265,Good health,289,46,9,37,48,18,7,11,10,1,9,4,5,139
S01010265,Fair health,34,2,0,2,3,2,0,1,1,1,2,2,0,22
S01010265,Bad health,6,0,0,0,1,1,2,0,0,1,0,0,0,1
S01010265,Very bad health,1,0,0,0,1,0,0,0,0,0,0,0,0,0
S01010266,All people aged 16 to 74,474,52,6,46,76,25,25,17,21,15,32,25,7,211
S01010266,Very good health,315,34,5,29,58,12,15,10,13,5,9,6,3,159
S01010266,Good health,119,14,1,13,16,8,9,4,6,5,11,9,2,46
S01010266,Fair health,26,2,0,2,2,3,0,2,0,2,10,8,2,5
S01010266,Bad health,9,2,0,2,0,1,0,1,0,2,2,2,0,1
S01010266,Very bad health,5,0,0,0,0,1,1,0,2,1,0,0,0,0
S01010267,All people aged 16 to 74,582,63,2,61,78,26,13,32,24,23,13,7,6,310
S01010267,Very good health,374,46,1,45,49,18,7,15,12,7,4,2,2,216
S01010267,Good health,170,15,1,14,20,6,4,14,6,11,8,5,3,86
S01010267,Fair health,33,2,0,2,8,2,2,1,5,4,1,0,1,8
S01010267,Bad health,3,0,0,0,1,0,0,1,1,0,0,0,0,0
S01010267,Very bad health,2,0,0,0,0,0,0,1,0,1,0,0,0,0
S01010268,All people aged 16 to 74,753,62,4,58,127,52,30,26,60,41,49,39,10,306
S01010268,Very good health,430,38,1,37,80,30,11,9,26,11,16,11,5,209
S01010268,Good health,221,18,3,15,33,16,12,9,16,17,14,11,3,86
S01010268,Fair health,62,3,0,3,7,4,3,8,10,7,11,10,1,9
S01010268,Bad health,31,3,0,3,6,2,3,0,6,4,5,5,0,2
S01010268,Very bad health,9,0,0,0,1,0,1,0,2,2,3,2,1,0
S01010269,All people aged 16 to 74,498,50,5,45,63,38,19,31,35,21,38,29,9,203
S01010269,Very good health,285,39,2,37,41,17,9,11,15,5,9,6,3,139
S01010269,Good health,151,7,2,5,19,14,9,11,18,8,9,8,1,56
S01010269,Fair health,42,2,1,1,3,4,1,5,1,3,16,11,5,7
S01010269,Bad health,13,1,0,1,0,1,0,3,0,5,3,3,0,0
S01010269,Very bad health,7,1,0,1,0,2,0,1,1,0,1,1,0,1
S01010270,All people aged 16 to 74,972,62,5,57,148,82,50,74,115,158,79,56,23,204
S01010270,Very good health,386,37,2,35,64,30,15,20,25,19,18,10,8,158
S01010270,Good health,253,19,3,16,46,23,17,21,37,38,13,6,7,39
S01010270,Fair health,151,6,0,6,18,15,10,13,19,43,23,17,6,4
S01010270,Bad health,131,0,0,0,16,9,5,10,29,39,20,18,2,3
S01010270,Very bad health,51,0,0,0,4,5,3,10,5,19,5,5,0,0
S01010271,All people aged 16 to 74,695,48,6,42,82,38,23,40,43,31,51,44,7,339
S01010271,Very good health,408,33,2,31,49,14,10,19,20,5,8,7,1,250
S01010271,Good health,202,11,2,9,25,22,10,12,14,10,18,13,5,80
S01010271,Fair health,50,2,0,2,7,1,3,4,6,8,11,10,1,8
S01010271,Bad health,30,1,1,0,1,1,0,5,2,5,14,14,0,1
S01010271,Very bad health,5,1,1,0,0,0,0,0,1,3,0,0,0,0
S01010272,All people aged 16 to 74,891,94,5,89,135,69,33,48,118,88,128,97,31,178
S01010272,Very good health,408,64,5,59,83,29,11,13,37,13,21,14,7,137
S01010272,Good health,225,21,0,21,33,24,11,16,30,23,34,25,9,33
S01010272,Fair health,146,6,0,6,8,10,5,8,35,28,38,26,12,8
S01010272,Bad health,87,3,0,3,6,5,3,10,12,20,28,25,3,0
S01010272,Very bad health,25,0,0,0,5,1,3,1,4,4,7,7,0,0
S01010273,All people aged 16 to 74,641,106,7,99,137,58,20,24,26,13,25,23,2,232
S01010273,Very good health,403,75,6,69,84,37,9,20,10,4,6,6,0,158
S01010273,Good health,192,29,1,28,43,19,7,4,12,6,12,10,2,60
S01010273,Fair health,34,2,0,2,8,2,2,0,3,1,2,2,0,14
S01010273,Bad health,8,0,0,0,1,0,1,0,1,2,3,3,0,0
S01010273,Very bad health,4,0,0,0,1,0,1,0,0,0,2,2,0,0
S01010274,All people aged 16 to 74,548,108,6,102,105,39,20,17,36,23,15,11,4,185
S01010274,Very good health,358,77,4,73,70,23,16,12,15,6,3,1,2,136
S01010274,Good health,144,26,1,25,25,12,4,4,13,11,3,3,0,46
S01010274,Fair health,29,4,1,3,9,4,0,1,3,2,3,2,1,3
S01010274,Bad health,12,1,0,1,1,0,0,0,4,1,5,4,1,0
S01010274,Very bad health,5,0,0,0,0,0,0,0,1,3,1,1,0,0
S01010275,All people aged 16 to 74,575,88,10,78,108,37,24,23,23,11,12,6,6,249
S01010275,Very good health,374,63,5,58,65,22,13,11,12,4,2,1,1,182
S01010275,Good health,154,20,3,17,35,12,7,8,7,2,5,3,2,58
S01010275,Fair health,34,3,2,1,8,3,4,2,3,3,0,0,0,8
S01010275,Bad health,9,0,0,0,0,0,0,1,1,1,5,2,3,1
S01010275,Very bad health,4,2,0,2,0,0,0,1,0,1,0,0,0,0
S01010276,All people aged 16 to 74,920,223,27,196,260,82,48,33,42,20,26,11,15,186
S01010276,Very good health,619,164,19,145,165,49,29,19,22,15,13,7,6,143
S01010276,Good health,231,51,7,44,74,23,12,11,10,4,10,3,7,36
S01010276,Fair health,55,7,1,6,15,8,7,2,6,1,2,0,2,7
S01010276,Bad health,11,1,0,1,4,1,0,1,3,0,1,1,0,0
S01010276,Very bad health,4,0,0,0,2,1,0,0,1,0,0,0,0,0
S01010277,All people aged 16 to 74,464,19,2,17,56,55,16,35,80,92,41,32,9,70
S01010277,Very good health,209,11,1,10,33,24,7,13,28,31,9,6,3,53
S01010277,Good health,133,4,1,3,19,22,4,7,27,26,10,6,4,14
S01010277,Fair health,78,2,0,2,2,4,5,9,23,23,7,6,1,3
S01010277,Bad health,28,2,0,2,2,4,0,4,2,6,8,7,1,0
S01010277,Very bad health,16,0,0,0,0,1,0,2,0,6,7,7,0,0
S01010278,All people aged 16 to 74,472,27,2,25,76,34,20,44,90,60,58,46,12,63
S01010278,Very good health,210,18,1,17,39,14,10,22,33,17,13,9,4,44
S01010278,Good health,163,5,1,4,30,14,9,18,34,21,17,14,3,15
S01010278,Fair health,60,2,0,2,5,3,1,3,16,13,13,9,4,4
S01010278,Bad health,28,2,0,2,2,2,0,1,4,9,8,7,1,0
S01010278,Very bad health,11,0,0,0,0,1,0,0,3,0,7,7,0,0
S01010279,All people aged 16 to 74,526,35,5,30,75,47,29,40,64,42,31,19,12,163
S01010279,Very good health,271,24,4,20,44,21,14,16,20,9,6,0,6,117
S01010279,Good health,153,9,1,8,18,16,10,19,19,12,11,7,4,39
S01010279,Fair health,48,1,0,1,6,4,2,2,17,7,6,4,2,3
S01010279,Bad health,41,1,0,1,4,5,0,3,6,13,6,6,0,3
S01010279,Very bad health,13,0,0,0,3,1,3,0,2,1,2,2,0,1
S01010280,All people aged 16 to 74,719,100,12,88,146,87,20,30,55,49,27,21,6,205
S01010280,Very good health,437,73,7,66,81,59,10,20,29,20,6,6,0,139
S01010280,Good health,210,23,5,18,53,20,6,4,13,19,14,9,5,58
S01010280,Fair health,54,3,0,3,9,5,2,4,12,6,7,6,1,6
S01010280,Bad health,13,1,0,1,3,2,2,2,1,0,0,0,0,2
S01010280,Very bad health,5,0,0,0,0,1,0,0,0,4,0,0,0,0
S01010281,All people aged 16 to 74,719,98,6,92,149,61,30,29,52,38,31,20,11,231
S01010281,Very good health,439,69,0,69,93,32,15,12,22,17,15,11,4,164
S01010281,Good health,209,26,5,21,41,19,12,12,17,12,11,6,5,59
S01010281,Fair health,57,3,1,2,12,8,2,3,13,5,3,1,2,8
S01010281,Bad health,11,0,0,0,1,1,1,2,0,4,2,2,0,0
S01010281,Very bad health,3,0,0,0,2,1,0,0,0,0,0,0,0,0
S01010282,All people aged 16 to 74,841,104,4,100,173,67,25,51,86,98,51,32,19,186
S01010282,Very good health,434,78,4,74,103,31,10,20,27,27,14,10,4,124
S01010282,Good health,243,19,0,19,43,24,7,18,31,27,16,8,8,58
S01010282,Fair health,99,4,0,4,18,11,5,8,17,23,9,4,5,4
S01010282,Bad health,51,3,0,3,7,1,1,3,7,19,10,8,2,0
S01010282,Very bad health,14,0,0,0,2,0,2,2,4,2,2,2,0,0
S01010283,All people aged 16 to 74,489,83,5,78,113,39,19,21,39,20,33,24,9,122
S01010283,Very good health,298,61,3,58,82,22,11,11,13,6,11,6,5,81
S01010283,Good health,136,20,2,18,27,13,4,6,17,8,5,4,1,36
S01010283,Fair health,39,1,0,1,4,3,3,2,6,3,13,10,3,4
S01010283,Bad health,13,1,0,1,0,0,1,1,3,3,3,3,0,1
S01010283,Very bad health,3,0,0,0,0,1,0,1,0,0,1,1,0,0
S01010284,All people aged 16 to 74,1339,178,5,173,231,98,36,33,45,41,33,18,15,644
S01010284,Very good health,793,134,4,130,146,59,19,21,21,18,7,3,4,368
S01010284,Good health,428,35,1,34,66,30,11,8,14,7,12,6,6,245
S01010284,Fair health,82,4,0,4,18,5,4,2,6,4,8,4,4,31
S01010284,Bad health,25,3,0,3,1,2,1,1,4,9,4,3,1,0
S01010284,Very bad health,11,2,0,2,0,2,1,1,0,3,2,2,0,0
S01010285,All people aged 16 to 74,719,69,8,61,131,61,33,32,50,46,45,22,23,252
S01010285,Very good health,461,45,1,44,77,34,21,16,26,16,22,9,13,204
S01010285,Good health,184,19,5,14,43,19,9,11,13,18,11,5,6,41
S01010285,Fair health,51,4,1,3,4,5,3,4,8,8,8,4,4,7
S01010285,Bad health,17,1,1,0,5,2,0,1,3,3,2,2,0,0
S01010285,Very bad health,6,0,0,0,2,1,0,0,0,1,2,2,0,0
S01010286,All people aged 16 to 74,1443,114,9,105,107,48,19,21,42,45,49,38,11,998
S01010286,Very good health,895,86,4,82,81,31,11,12,29,17,19,12,7,609
S01010286,Good health,447,22,4,18,23,10,4,7,5,15,14,10,4,347
S01010286,Fair health,84,5,1,4,2,5,4,2,6,7,12,12,0,41
S01010286,Bad health,14,1,0,1,1,1,0,0,2,6,2,2,0,1
S01010286,Very bad health,3,0,0,0,0,1,0,0,0,0,2,2,0,0
S01010287,All people aged 16 to 74,810,93,6,87,147,34,34,30,37,30,23,16,7,382
S01010287,Very good health,540,79,5,74,95,20,16,17,21,11,7,5,2,274
S01010287,Good health,203,13,1,12,38,12,12,10,13,10,8,4,4,87
S01010287,Fair health,53,1,0,1,11,1,5,2,2,7,3,2,1,21
S01010287,Bad health,13,0,0,0,3,1,1,1,1,1,5,5,0,0
S01010287,Very bad health,1,0,0,0,0,0,0,0,0,1,0,0,0,0
S01010288,All people aged 16 to 74,745,131,14,117,141,54,41,19,36,15,18,11,7,290
S01010288,Very good health,480,97,11,86,90,34,25,9,17,7,4,2,2,197
S01010288,Good health,213,29,3,26,41,13,13,7,15,6,7,4,3,82
S01010288,Fair health,41,5,0,5,8,4,3,1,3,2,6,4,2,9
S01010288,Bad health,7,0,0,0,0,3,0,2,0,0,1,1,0,1
S01010288,Very bad health,4,0,0,0,2,0,0,0,1,0,0,0,0,1
S01010289,All people aged 16 to 74,687,204,25,179,191,38,55,26,21,10,20,13,7,122
S01010289,Very good health,474,153,20,133,131,21,38,14,14,3,11,6,5,89
S01010289,Good health,178,45,5,40,55,13,15,8,7,2,4,2,2,29
S01010289,Fair health,25,5,0,5,4,4,1,2,0,4,1,1,0,4
S01010289,Bad health,9,1,0,1,1,0,1,1,0,1,4,4,0,0
S01010289,Very bad health,1,0,0,0,0,0,0,1,0,0,0,0,0,0
S01010290,All people aged 16 to 74,485,63,10,53,95,40,17,25,25,21,32,30,2,167
S01010290,Very good health,297,47,6,41,60,20,11,13,10,7,5,5,0,124
S01010290,Good health,128,14,3,11,29,14,4,4,7,5,12,11,1,39
S01010290,Fair health,38,2,1,1,4,3,2,4,4,5,10,9,1,4
S01010290,Bad health,11,0,0,0,2,3,0,0,3,2,1,1,0,0
S01010290,Very bad health,11,0,0,0,0,0,0,4,1,2,4,4,0,0
S01010291,All people aged 16 to 74,975,72,4,68,136,65,24,37,74,49,46,38,8,472
S01010291,Very good health,569,53,1,52,86,28,10,12,26,18,11,8,3,325
S01010291,Good health,278,14,2,12,31,27,9,17,23,13,10,8,2,134
S01010291,Fair health,72,3,1,2,12,5,4,4,14,5,16,14,2,9
S01010291,Bad health,46,2,0,2,7,2,1,4,9,11,6,5,1,4
S01010291,Very bad health,10,0,0,0,0,3,0,0,2,2,3,3,0,0
S01010292,All people aged 16 to 74,831,121,5,116,166,53,31,29,44,28,30,21,9,329
S01010292,Very good health,565,86,2,84,113,36,12,14,25,14,13,8,5,252
S01010292,Good health,194,28,2,26,40,13,13,12,10,8,4,4,0,66
S01010292,Fair health,61,6,1,5,12,4,5,2,8,5,9,6,3,10
S01010292,Bad health,10,1,0,1,1,0,1,1,1,1,4,3,1,0
S01010292,Very bad health,1,0,0,0,0,0,0,0,0,0,0,0,0,1
S01010293,All people aged 16 to 74,723,59,4,55,98,48,25,38,51,25,53,40,13,326
S01010293,Very good health,414,43,3,40,60,24,9,14,20,8,14,11,3,222
S01010293,Good health,229,11,1,10,30,19,10,17,16,13,24,16,8,89
S01010293,Fair health,58,4,0,4,5,4,5,5,9,2,12,10,2,12
S01010293,Bad health,16,1,0,1,2,0,1,1,4,1,3,3,0,3
S01010293,Very bad health,6,0,0,0,1,1,0,1,2,1,0,0,0,0
S01010294,All people aged 16 to 74,631,56,3,53,71,33,15,23,29,23,36,32,4,345
S01010294,Very good health,415,45,2,43,47,19,5,10,15,6,10,9,1,258
S01010294,Good health,154,7,0,7,19,8,5,11,9,9,12,9,3,74
S01010294,Fair health,46,4,1,3,4,4,3,1,3,5,9,9,0,13
S01010294,Bad health,10,0,0,0,1,1,2,0,1,2,3,3,0,0
S01010294,Very bad health,6,0,0,0,0,1,0,1,1,1,2,2,0,0
S01010295,All people aged 16 to 74,870,87,5,82,117,41,38,36,65,30,45,37,8,411
S01010295,Very good health,534,58,2,56,77,18,20,16,32,14,14,12,2,285
S01010295,Good health,259,22,1,21,32,16,15,15,17,4,22,16,6,116
S01010295,Fair health,52,6,1,5,6,6,2,2,10,9,2,2,0,9
S01010295,Bad health,22,1,1,0,1,1,1,2,6,3,7,7,0,0
S01010295,Very bad health,3,0,0,0,1,0,0,1,0,0,0,0,0,1
S01010296,All people aged 16 to 74,560,50,2,48,76,49,21,22,52,40,47,36,11,203
S01010296,Very good health,322,36,1,35,44,25,10,10,15,18,15,10,5,149
S01010296,Good health,142,11,0,11,19,16,7,5,18,7,11,8,3,48
S01010296,Fair health,68,2,0,2,8,4,4,2,16,13,13,10,3,6
S01010296,Bad health,24,0,0,0,5,3,0,4,3,2,7,7,0,0
S01010296,Very bad health,4,1,1,0,0,1,0,1,0,0,1,1,0,0
S01010297,All people aged 16 to 74,894,63,7,56,126,84,34,68,119,124,94,68,26,182
S01010297,Very good health,347,34,3,31,68,35,15,20,31,29,13,7,6,102
S01010297,Good health,298,22,4,18,42,30,5,28,44,31,25,14,11,71
S01010297,Fair health,138,2,0,2,11,14,8,11,27,29,29,21,8,7
S01010297,Bad health,88,4,0,4,4,5,4,8,9,29,23,23,0,2
S01010297,Very bad health,23,1,0,1,1,0,2,1,8,6,4,3,1,0
S01010298,All people aged 16 to 74,677,60,4,56,122,70,28,42,95,59,44,37,7,157
S01010298,Very good health,323,34,0,34,62,31,17,19,26,15,13,9,4,106
S01010298,Good health,218,20,3,17,48,21,9,11,36,18,10,8,2,45
S01010298,Fair health,76,5,0,5,7,12,1,9,13,16,9,8,1,4
S01010298,Bad health,39,1,1,0,5,3,1,3,12,5,7,7,0,2
S01010298,Very bad health,21,0,0,0,0,3,0,0,8,5,5,5,0,0
S01010299,All people aged 16 to 74,404,23,1,22,43,42,24,29,74,50,65,51,14,54
S01010299,Very good health,140,14,0,14,18,18,3,6,21,7,18,11,7,35
S01010299,Good health,124,6,1,5,14,11,10,10,22,14,19,17,2,18
S01010299,Fair health,74,2,0,2,7,9,9,7,10,17,13,8,5,0
S01010299,Bad health,47,0,0,0,2,3,2,4,15,8,12,12,0,1
S01010299,Very bad health,19,1,0,1,2,1,0,2,6,4,3,3,0,0
S01010300,All people aged 16 to 74,764,63,9,54,123,76,22,33,100,66,71,64,7,210
S01010300,Very good health,393,36,3,33,55,41,9,11,37,20,21,19,2,163
S01010300,Good health,221,18,3,15,41,23,6,15,29,24,24,22,2,41
S01010300,Fair health,94,8,3,5,17,8,3,6,18,13,15,14,1,6
S01010300,Bad health,42,1,0,1,8,2,3,0,12,6,10,8,2,0
S01010300,Very bad health,14,0,0,0,2,2,1,1,4,3,1,1,0,0
S01010301,All people aged 16 to 74,457,39,4,35,73,35,20,23,40,24,36,23,13,167
S01010301,Very good health,276,20,2,18,42,22,8,10,20,18,10,5,5,126
S01010301,Good health,136,15,1,14,25,9,9,10,11,2,18,11,7,37
S01010301,Fair health,33,4,1,3,4,3,3,2,9,1,3,2,1,4
S01010301,Bad health,11,0,0,0,1,1,0,1,0,3,5,5,0,0
S01010301,Very bad health,1,0,0,0,1,0,0,0,0,0,0,0,0,0
S01010302,All people aged 16 to 74,495,17,1,16,41,36,24,52,79,72,114,82,32,60
S01010302,Very good health,167,9,0,9,14,13,13,16,13,15,32,26,6,42
S01010302,Good health,139,6,1,5,17,9,2,22,23,15,29,18,11,16
S01010302,Fair health,108,1,0,1,6,10,5,7,25,22,30,22,8,2
S01010302,Bad health,52,1,0,1,2,2,2,3,10,16,16,9,7,0
S01010302,Very bad health,29,0,0,0,2,2,2,4,8,4,7,7,0,0
S01010303,All people aged 16 to 74,387,7,1,6,35,21,22,23,57,53,113,99,14,56
S01010303,Very good health,149,4,1,3,16,5,5,11,20,13,36,30,6,39
S01010303,Good health,119,1,0,1,10,7,10,6,18,13,43,35,8,11
S01010303,Fair health,74,2,0,2,7,6,2,4,9,15,24,24,0,5
S01010303,Bad health,35,0,0,0,2,3,2,1,7,10,9,9,0,1
S01010303,Very bad health,10,0,0,0,0,0,3,1,3,2,1,1,0,0
S01010304,All people aged 16 to 74,456,27,1,26,58,38,8,34,74,56,59,42,17,102
S01010304,Very good health,211,12,0,12,33,23,2,14,25,14,14,10,4,74
S01010304,Good health,112,10,1,9,15,10,2,6,20,13,13,7,6,23
S01010304,Fair health,76,3,0,3,7,2,3,7,19,18,14,8,6,3
S01010304,Bad health,44,2,0,2,3,1,0,6,10,9,11,11,0,2
S01010304,Very bad health,13,0,0,0,0,2,1,1,0,2,7,6,1,0
S01010305,All people aged 16 to 74,694,64,6,58,107,68,33,54,80,89,65,51,14,134
S01010305,Very good health,307,37,4,33,67,31,14,23,26,16,11,6,5,82
S01010305,Good health,214,22,2,20,28,22,11,16,33,24,15,11,4,43
S01010305,Fair health,113,4,0,4,10,9,7,11,15,31,21,17,4,5
S01010305,Bad health,49,1,0,1,1,5,1,4,4,14,15,14,1,4
S01010305,Very bad health,11,0,0,0,1,1,0,0,2,4,3,3,0,0
S01010306,All people aged 16 to 74,675,90,5,85,148,57,12,27,58,31,49,27,22,203
S01010306,Very good health,406,65,3,62,92,27,3,16,27,11,16,9,7,149
S01010306,Good health,187,19,0,19,38,17,6,9,19,12,18,6,12,49
S01010306,Fair health,52,5,1,4,12,8,2,2,7,6,6,3,3,4
S01010306,Bad health,25,1,1,0,6,3,1,0,4,2,7,7,0,1
S01010306,Very bad health,5,0,0,0,0,2,0,0,1,0,2,2,0,0
S01010307,All people aged 16 to 74,732,145,6,139,184,71,36,21,46,26,17,9,8,186
S01010307,Very good health,511,116,4,112,120,38,21,17,27,12,8,4,4,152
S01010307,Good health,161,22,2,20,49,24,13,3,11,5,5,3,2,29
S01010307,Fair health,46,3,0,3,15,8,1,1,4,6,3,2,1,5
S01010307,Bad health,9,1,0,1,0,0,1,0,3,3,1,0,1,0
S01010307,Very bad health,5,3,0,3,0,1,0,0,1,0,0,0,0,0
S01010308,All people aged 16 to 74,858,160,12,148,215,63,31,27,51,25,36,27,9,250
S01010308,Very good health,545,117,10,107,139,42,18,16,26,12,14,11,3,161
S01010308,Good health,239,36,2,34,55,16,8,7,10,6,16,10,6,85
S01010308,Fair health,55,4,0,4,17,5,2,3,12,5,3,3,0,4
S01010308,Bad health,17,2,0,2,3,0,3,1,3,2,3,3,0,0
S01010308,Very bad health,2,1,0,1,1,0,0,0,0,0,0,0,0,0
S01010309,All people aged 16 to 74,356,10,3,7,26,36,10,29,63,100,56,43,13,26
S01010309,Very good health,106,1,0,1,15,11,1,13,17,26,5,4,1,17
S01010309,Good health,99,7,3,4,6,11,3,5,20,25,14,9,5,8
S01010309,Fair health,79,2,0,2,1,8,5,6,17,20,19,12,7,1
S01010309,Bad health,48,0,0,0,4,4,0,4,6,20,10,10,0,0
S01010309,Very bad health,24,0,0,0,0,2,1,1,3,9,8,8,0,0
S01010310,All people aged 16 to 74,540,12,3,9,41,53,15,57,97,104,88,61,27,73
S01010310,Very good health,199,7,2,5,16,27,6,17,36,27,19,8,11,44
S01010310,Good health,182,4,0,4,15,13,4,23,35,32,34,22,12,22
S01010310,Fair health,103,1,1,0,8,9,4,10,17,26,21,17,4,7
S01010310,Bad health,39,0,0,0,2,3,1,5,4,12,12,12,0,0
S01010310,Very bad health,17,0,0,0,0,1,0,2,5,7,2,2,0,0
S01010311,All people aged 16 to 74,556,5,0,5,37,42,17,45,104,134,118,89,29,54
S01010311,Very good health,149,2,0,2,12,17,2,10,25,29,25,14,11,27
S01010311,Good health,164,1,0,1,14,17,6,13,30,27,32,21,11,24
S01010311,Fair health,127,2,0,2,6,5,5,9,34,34,30,25,5,2
S01010311,Bad health,90,0,0,0,5,3,4,7,11,32,27,25,2,1
S01010311,Very bad health,26,0,0,0,0,0,0,6,4,12,4,4,0,0
S01010312,All people aged 16 to 74,647,5,1,4,46,48,18,42,154,157,128,94,34,49
S01010312,Very good health,218,3,0,3,15,22,9,17,50,34,37,28,9,31
S01010312,Good health,166,1,0,1,15,15,4,10,41,36,32,15,17,12
S01010312,Fair health,148,1,1,0,11,7,2,4,40,43,34,27,7,6
S01010312,Bad health,88,0,0,0,4,3,3,9,16,33,20,19,1,0
S01010312,Very bad health,27,0,0,0,1,1,0,2,7,11,5,5,0,0
S01010313,All people aged 16 to 74,529,18,4,14,33,30,23,38,128,131,86,56,30,42
S01010313,Very good health,173,12,3,9,12,13,7,11,40,35,23,13,10,20
S01010313,Good health,153,4,1,3,9,7,5,11,41,40,22,10,12,14
S01010313,Fair health,108,0,0,0,8,5,4,6,28,26,23,16,7,8
S01010313,Bad health,76,1,0,1,2,4,7,7,16,26,13,12,1,0
S01010313,Very bad health,19,1,0,1,2,1,0,3,3,4,5,5,0,0
S01010314,All people aged 16 to 74,1034,38,3,35,123,96,34,45,158,128,133,107,26,279
S01010314,Very good health,420,16,1,15,56,45,10,18,47,35,29,20,9,164
S01010314,Good health,347,17,0,17,43,29,10,14,49,38,49,38,11,98
S01010314,Fair health,148,2,1,1,8,11,7,6,36,31,33,27,6,14
S01010314,Bad health,86,3,1,2,15,6,6,6,18,17,13,13,0,2
S01010314,Very bad health,33,0,0,0,1,5,1,1,8,7,9,9,0,1
S01010315,All people aged 16 to 74,678,44,4,40,111,81,26,50,116,111,75,58,17,64
S01010315,Very good health,334,29,1,28,74,43,12,21,48,41,24,17,7,42
S01010315,Good health,215,8,1,7,28,28,11,19,39,34,30,23,7,18
S01010315,Fair health,77,6,2,4,6,5,3,5,17,17,16,13,3,2
S01010315,Bad health,33,1,0,1,3,4,0,2,5,12,5,5,0,1
S01010315,Very bad health,19,0,0,0,0,1,0,3,7,7,0,0,0,1
S01010316,All people aged 16 to 74,414,24,3,21,47,39,12,23,103,67,49,41,8,50
S01010316,Very good health,156,15,2,13,20,22,3,12,28,17,8,5,3,31
S01010316,Good health,130,8,1,7,16,9,7,3,34,25,16,13,3,12
S01010316,Fair health,63,1,0,1,7,3,1,2,16,16,11,10,1,6
S01010316,Bad health,45,0,0,0,3,5,1,5,15,6,10,9,1,0
S01010316,Very bad health,20,0,0,0,1,0,0,1,10,3,4,4,0,1
S01010317,All people aged 16 to 74,660,112,5,107,154,55,29,23,38,28,10,8,2,211
S01010317,Very good health,420,88,3,85,101,33,13,13,21,11,3,3,0,137
S01010317,Good health,175,22,2,20,44,17,9,7,8,8,2,1,1,58
S01010317,Fair health,44,2,0,2,6,2,3,3,6,4,3,2,1,15
S01010317,Bad health,15,0,0,0,3,2,3,0,2,3,1,1,0,1
S01010317,Very bad health,6,0,0,0,0,1,1,0,1,2,1,1,0,0
S01010318,All people aged 16 to 74,1497,23,2,21,57,37,26,37,81,44,47,18,29,1145
S01010318,Very good health,943,19,1,18,35,19,9,18,30,12,15,2,13,786
S01010318,Good health,438,3,0,3,17,12,7,7,28,14,16,6,10,334
S01010318,Fair health,85,0,0,0,1,5,7,7,16,10,15,9,6,24
S01010318,Bad health,24,1,1,0,4,0,3,5,5,4,1,1,0,1
S01010318,Very bad health,7,0,0,0,0,1,0,0,2,4,0,0,0,0
S01010319,All people aged 16 to 74,624,92,7,85,127,68,26,41,73,53,23,16,7,121
S01010319,Very good health,323,59,5,54,74,33,12,12,31,15,6,3,3,81
S01010319,Good health,197,25,1,24,42,22,8,19,28,15,7,6,1,31
S01010319,Fair health,63,4,1,3,7,9,4,5,6,14,7,5,2,7
S01010319,Bad health,27,3,0,3,3,3,2,4,5,4,1,0,1,2
S01010319,Very bad health,14,1,0,1,1,1,0,1,3,5,2,2,0,0
S01010320,All people aged 16 to 74,594,69,3,66,103,55,21,30,70,72,48,34,14,126
S01010320,Very good health,328,53,2,51,65,27,10,10,30,29,11,6,5,93
S01010320,Good health,138,13,0,13,27,17,4,6,16,14,11,8,3,30
S01010320,Fair health,65,3,1,2,5,6,6,3,10,14,16,10,6,2
S01010320,Bad health,42,0,0,0,4,4,1,5,9,11,7,7,0,1
S01010320,Very bad health,21,0,0,0,2,1,0,6,5,4,3,3,0,0
S01010321,All people aged 16 to 74,634,52,1,51,127,70,21,39,89,77,46,30,16,113
S01010321,Very good health,282,33,0,33,71,23,9,15,32,15,8,5,3,76
S01010321,Good health,195,14,0,14,41,26,11,10,25,25,15,7,8,28
S01010321,Fair health,105,4,1,3,13,18,0,9,20,18,16,11,5,7
S01010321,Bad health,36,0,0,0,2,3,1,3,9,13,4,4,0,1
S01010321,Very bad health,16,1,0,1,0,0,0,2,3,6,3,3,0,1
S01010322,All people aged 16 to 74,914,224,16,208,243,73,40,37,52,28,21,14,7,196
S01010322,Very good health,600,167,8,159,158,38,20,21,25,16,9,6,3,146
S01010322,Good health,243,47,5,42,61,26,17,13,21,6,6,3,3,46
S01010322,Fair health,50,8,2,6,19,7,2,1,2,3,4,3,1,4
S01010322,Bad health,15,2,1,1,3,2,1,1,3,1,2,2,0,0
S01010322,Very bad health,6,0,0,0,2,0,0,1,1,2,0,0,0,0
S01010323,All people aged 16 to 74,466,14,3,11,31,24,3,27,113,113,94,72,22,47
S01010323,Very good health,129,8,2,6,11,5,2,8,26,23,15,10,5,31
S01010323,Good health,141,2,1,1,13,13,1,11,29,32,28,18,10,12
S01010323,Fair health,114,4,0,4,4,4,0,3,34,31,31,24,7,3
S01010323,Bad health,62,0,0,0,2,1,0,4,17,23,14,14,0,1
S01010323,Very bad health,20,0,0,0,1,1,0,1,7,4,6,6,0,0
S01010324,All people aged 16 to 74,566,4,0,4,54,51,28,45,130,167,51,37,14,36
S01010324,Very good health,182,1,0,1,15,22,9,16,39,44,11,7,4,25
S01010324,Good health,162,1,0,1,17,19,8,11,37,49,13,7,6,7
S01010324,Fair health,122,1,0,1,15,5,5,9,29,39,17,13,4,2
S01010324,Bad health,69,1,0,1,3,3,5,7,19,25,4,4,0,2
S01010324,Very bad health,31,0,0,0,4,2,1,2,6,10,6,6,0,0
S01010325,All people aged 16 to 74,666,7,5,2,62,76,24,49,161,182,74,55,19,31
S01010325,Very good health,194,1,0,1,23,30,7,14,43,44,11,6,5,21
S01010325,Good health,219,6,5,1,24,25,9,16,58,50,22,14,8,9
S01010325,Fair health,141,0,0,0,12,13,3,12,36,42,22,16,6,1
S01010325,Bad health,73,0,0,0,0,7,2,6,16,27,15,15,0,0
S01010325,Very bad health,39,0,0,0,3,1,3,1,8,19,4,4,0,0
S01010326,All people aged 16 to 74,707,10,0,10,51,54,25,48,160,152,152,109,43,55
S01010326,Very good health,235,5,0,5,25,22,10,17,52,32,39,25,14,33
S01010326,Good health,192,1,0,1,15,19,9,10,48,36,40,27,13,14
S01010326,Fair health,148,2,0,2,5,8,5,10,26,42,44,28,16,6
S01010326,Bad health,96,2,0,2,4,5,0,10,24,31,18,18,0,2
S01010326,Very bad health,36,0,0,0,2,0,1,1,10,11,11,11,0,0
S01010327,All people aged 16 to 74,660,33,5,28,86,65,34,57,121,122,75,51,24,67
S01010327,Very good health,279,20,2,18,46,33,11,21,49,32,27,15,12,40
S01010327,Good health,207,11,2,9,21,24,11,14,41,41,22,12,10,22
S01010327,Fair health,98,0,0,0,9,4,10,12,14,30,14,13,1,5
S01010327,Bad health,52,2,1,1,4,2,1,8,13,15,7,7,0,0
S01010327,Very bad health,24,0,0,0,6,2,1,2,4,4,5,4,1,0
S01010328,All people aged 16 to 74,706,28,4,24,100,89,44,62,113,143,66,43,23,61
S01010328,Very good health,276,14,0,14,44,40,20,27,40,32,16,10,6,43
S01010328,Good health,222,7,2,5,41,25,10,19,40,40,24,12,12,16
S01010328,Fair health,135,4,1,3,11,17,10,12,21,43,15,11,4,2
S01010328,Bad health,57,2,1,1,3,7,1,4,9,24,7,6,1,0
S01010328,Very bad health,16,1,0,1,1,0,3,0,3,4,4,4,0,0
S01010329,All people aged 16 to 74,435,17,3,14,59,58,23,44,77,101,33,26,7,23
S01010329,Very good health,160,11,0,11,30,23,11,19,28,15,8,6,2,15
S01010329,Good health,135,2,0,2,22,24,8,10,19,37,8,4,4,5
S01010329,Fair health,89,3,2,1,1,8,4,9,22,29,10,9,1,3
S01010329,Bad health,30,1,1,0,5,2,0,3,3,12,4,4,0,0
S01010329,Very bad health,21,0,0,0,1,1,0,3,5,8,3,3,0,0
S01010330,All people aged 16 to 74,474,7,0,7,28,46,18,31,112,113,89,60,29,30
S01010330,Very good health,153,4,0,4,13,13,6,8,40,28,23,15,8,18
S01010330,Good health,155,1,0,1,8,22,6,12,37,31,30,16,14,8
S01010330,Fair health,99,2,0,2,6,9,4,3,22,28,21,16,5,4
S01010330,Bad health,51,0,0,0,1,2,2,7,10,17,12,10,2,0
S01010330,Very bad health,16,0,0,0,0,0,0,1,3,9,3,3,0,0
S01010331,All people aged 16 to 74,643,18,8,10,65,75,20,63,146,159,68,41,27,29
S01010331,Very good health,208,9,4,5,23,25,10,17,51,40,15,7,8,18
S01010331,Good health,177,5,4,1,19,27,3,17,39,37,20,11,9,10
S01010331,Fair health,133,4,0,4,14,16,6,10,32,35,15,7,8,1
S01010331,Bad health,91,0,0,0,7,6,1,13,21,31,12,10,2,0
S01010331,Very bad health,34,0,0,0,2,1,0,6,3,16,6,6,0,0
S01010332,All people aged 16 to 74,549,1,0,1,50,53,22,54,137,99,90,70,20,43
S01010332,Very good health,193,1,0,1,19,23,9,23,40,26,24,17,7,28
S01010332,Good health,158,0,0,0,18,16,6,7,51,28,23,18,5,9
S01010332,Fair health,111,0,0,0,10,9,4,13,23,23,24,19,5,5
S01010332,Bad health,59,0,0,0,2,1,3,8,17,14,14,11,3,0
S01010332,Very bad health,28,0,0,0,1,4,0,3,6,8,5,5,0,1
S01010333,All people aged 16 to 74,712,16,1,15,74,76,42,59,169,145,64,42,22,67
S01010333,Very good health,256,8,1,7,29,30,16,23,56,40,11,5,6,43
S01010333,Good health,238,5,0,5,32,33,16,21,49,45,19,9,10,18
S01010333,Fair health,140,2,0,2,10,11,8,8,40,36,20,16,4,5
S01010333,Bad health,62,1,0,1,2,2,2,4,20,21,10,9,1,0
S01010333,Very bad health,16,0,0,0,1,0,0,3,4,3,4,3,1,1
S01010334,All people aged 16 to 74,674,16,2,14,97,99,34,61,150,134,46,32,14,37
S01010334,Very good health,283,10,0,10,52,47,16,22,50,40,17,9,8,29
S01010334,Good health,217,5,1,4,34,36,8,20,52,46,9,3,6,7
S01010334,Fair health,98,0,0,0,8,5,7,10,31,25,11,11,0,1
S01010334,Bad health,58,1,1,0,2,6,3,8,16,17,5,5,0,0
S01010334,Very bad health,18,0,0,0,1,5,0,1,1,6,4,4,0,0
S01010335,All people aged 16 to 74,573,11,2,9,52,67,26,45,116,124,70,51,19,62
S01010335,Very good health,201,2,0,2,21,37,7,12,36,28,20,15,5,38
S01010335,Good health,176,7,2,5,19,17,7,13,40,37,17,10,7,19
S01010335,Fair health,119,2,0,2,7,10,7,12,23,32,22,16,6,4
S01010335,Bad health,57,0,0,0,4,3,4,6,10,19,10,9,1,1
S01010335,Very bad health,20,0,0,0,1,0,1,2,7,8,1,1,0,0
S01010336,All people aged 16 to 74,471,11,0,11,27,46,20,27,117,98,94,53,41,31
S01010336,Very good health,161,7,0,7,12,20,6,7,36,26,31,19,12,16
S01010336,Good health,122,1,0,1,6,8,7,4,35,25,28,13,15,8
S01010336,Fair health,106,2,0,2,4,11,3,10,24,24,25,13,12,3
S01010336,Bad health,61,0,0,0,3,5,2,4,16,19,9,7,2,3
S01010336,Very bad health,21,1,0,1,2,2,2,2,6,4,1,1,0,1
S01010337,All people aged 16 to 74,485,6,1,5,38,61,15,40,119,124,45,32,13,37
S01010337,Very good health,162,2,0,2,14,26,4,13,45,25,7,5,2,26
S01010337,Good health,135,3,1,2,14,16,6,6,33,33,16,8,8,8
S01010337,Fair health,101,1,0,1,3,13,2,9,21,41,9,7,2,2
S01010337,Bad health,65,0,0,0,5,3,3,9,13,20,11,10,1,1
S01010337,Very bad health,22,0,0,0,2,3,0,3,7,5,2,2,0,0
S01010338,All people aged 16 to 74,537,9,0,9,48,48,20,52,112,127,86,64,22,35
S01010338,Very good health,183,6,0,6,18,23,8,18,36,28,24,16,8,22
S01010338,Good health,155,1,0,1,16,17,8,14,36,30,22,16,6,11
S01010338,Fair health,121,2,0,2,6,7,4,8,26,41,25,17,8,2
S01010338,Bad health,65,0,0,0,7,1,0,8,12,24,13,13,0,0
S01010338,Very bad health,13,0,0,0,1,0,0,4,2,4,2,2,0,0
S01010339,All people aged 16 to 74,489,11,2,9,52,52,19,35,104,123,62,44,18,31
S01010339,Very good health,184,3,0,3,23,22,8,7,36,40,19,13,6,26
S01010339,Good health,148,7,2,5,15,16,4,11,34,40,18,11,7,3
S01010339,Fair health,84,0,0,0,9,9,3,10,20,22,10,6,4,1
S01010339,Bad health,51,1,0,1,4,4,1,6,8,16,11,10,1,0
S01010339,Very bad health,22,0,0,0,1,1,3,1,6,5,4,4,0,1
S01010340,All people aged 16 to 74,551,15,4,11,62,72,25,56,112,101,56,27,29,52
S01010340,Very good health,218,7,3,4,26,26,8,17,45,33,14,8,6,42
S01010340,Good health,170,6,1,5,25,21,10,15,35,31,20,3,17,7
S01010340,Fair health,106,2,0,2,7,19,5,14,22,26,9,5,4,2
S01010340,Bad health,45,0,0,0,4,6,1,7,4,11,11,9,2,1
S01010340,Very bad health,12,0,0,0,0,0,1,3,6,0,2,2,0,0
S01010341,All people aged 16 to 74,441,11,3,8,68,67,25,34,85,88,21,11,10,42
S01010341,Very good health,201,8,2,6,34,36,9,16,32,25,9,3,6,32
S01010341,Good health,132,1,0,1,19,25,9,9,23,32,6,3,3,8
S01010341,Fair health,73,2,1,1,12,3,3,6,26,17,2,1,1,2
S01010341,Bad health,28,0,0,0,2,2,2,2,4,13,3,3,0,0
S01010341,Very bad health,7,0,0,0,1,1,2,1,0,1,1,1,0,0
S01010342,All people aged 16 to 74,506,24,2,22,100,68,31,63,97,70,9,6,3,44
S01010342,Very good health,254,14,2,12,62,35,14,26,38,27,1,0,1,37
S01010342,Good health,173,9,0,9,28,26,15,23,38,25,3,2,1,6
S01010342,Fair health,53,1,0,1,10,4,2,9,11,12,3,2,1,1
S01010342,Bad health,16,0,0,0,0,3,0,2,6,4,1,1,0,0
S01010342,Very bad health,10,0,0,0,0,0,0,3,4,2,1,1,0,0
S01010343,All people aged 16 to 74,745,37,6,31,161,133,47,83,126,72,20,11,9,66
S01010343,Very good health,403,19,4,15,98,69,18,46,58,40,7,3,4,48
S01010343,Good health,240,14,2,12,45,45,23,24,48,17,8,4,4,16
S01010343,Fair health,71,2,0,2,12,17,2,11,13,8,5,4,1,1
S01010343,Bad health,23,1,0,1,4,2,4,2,5,4,0,0,0,1
S01010343,Very bad health,8,1,0,1,2,0,0,0,2,3,0,0,0,0
S01010344,All people aged 16 to 74,540,10,1,9,41,58,24,54,116,132,74,41,33,31
S01010344,Very good health,155,4,1,3,11,21,7,12,34,26,17,8,9,23
S01010344,Good health,173,3,0,3,20,15,10,19,31,44,26,13,13,5
S01010344,Fair health,105,2,0,2,4,13,2,4,31,26,22,14,8,1
S01010344,Bad health,81,1,0,1,4,8,5,18,12,26,5,3,2,2
S01010344,Very bad health,26,0,0,0,2,1,0,1,8,10,4,3,1,0
S01010345,All people aged 16 to 74,339,45,13,32,97,39,31,20,23,25,16,10,6,43
S01010345,Very good health,219,30,7,23,69,25,12,13,14,16,9,5,4,31
S01010345,Good health,90,13,6,7,24,11,12,5,9,6,1,1,0,9
S01010345,Fair health,24,2,0,2,3,2,6,2,0,3,4,2,2,2
S01010345,Bad health,3,0,0,0,1,0,1,0,0,0,0,0,0,1
S01010345,Very bad health,3,0,0,0,0,1,0,0,0,0,2,2,0,0
S01010346,All people aged 16 to 74,783,87,18,69,174,119,48,54,123,85,31,25,6,62
S01010346,Very good health,409,61,12,49,96,63,25,34,53,29,3,1,2,45
S01010346,Good health,243,20,6,14,60,39,14,12,52,27,7,4,3,12
S01010346,Fair health,78,6,0,6,14,12,7,4,11,15,6,6,0,3
S01010346,Bad health,43,0,0,0,4,5,2,4,6,11,10,9,1,1
S01010346,Very bad health,10,0,0,0,0,0,0,0,1,3,5,5,0,1
S01010347,All people aged 16 to 74,885,31,6,25,96,88,36,67,120,99,93,66,27,255
S01010347,Very good health,430,19,5,14,52,53,11,18,46,32,19,11,8,180
S01010347,Good health,279,10,0,10,27,19,20,31,37,22,47,30,17,66
S01010347,Fair health,112,1,0,1,9,10,4,12,24,24,20,19,1,8
S01010347,Bad health,52,1,1,0,7,4,1,5,9,17,7,6,1,1
S01010347,Very bad health,12,0,0,0,1,2,0,1,4,4,0,0,0,0
S01010348,All people aged 16 to 74,707,28,3,25,93,113,25,80,162,130,38,18,20,38
S01010348,Very good health,270,17,1,16,51,47,8,22,56,29,12,5,7,28
S01010348,Good health,242,10,2,8,29,41,13,34,58,39,11,2,9,7
S01010348,Fair health,131,1,0,1,10,18,4,13,32,39,11,8,3,3
S01010348,Bad health,49,0,0,0,3,4,0,8,12,19,3,2,1,0
S01010348,Very bad health,15,0,0,0,0,3,0,3,4,4,1,1,0,0
S01010349,All people aged 16 to 74,666,14,2,12,82,90,31,74,158,138,43,26,17,36
S01010349,Very good health,259,8,1,7,43,43,13,26,57,32,12,6,6,25
S01010349,Good health,217,3,0,3,30,26,9,28,49,54,8,3,5,10
S01010349,Fair health,114,2,0,2,7,13,7,11,31,30,12,6,6,1
S01010349,Bad health,56,0,0,0,1,5,2,6,14,21,7,7,0,0
S01010349,Very bad health,20,1,1,0,1,3,0,3,7,1,4,4,0,0
S01010350,All people aged 16 to 74,668,14,4,10,75,73,22,62,150,142,86,52,34,44
S01010350,Very good health,226,4,0,4,29,26,14,17,48,31,25,14,11,32
S01010350,Good health,227,8,3,5,30,28,6,23,44,49,29,11,18,10
S01010350,Fair health,127,2,1,1,13,14,0,9,36,31,20,15,5,2
S01010350,Bad health,62,0,0,0,2,5,1,8,17,20,9,9,0,0
S01010350,Very bad health,26,0,0,0,1,0,1,5,5,11,3,3,0,0
S01010351,All people aged 16 to 74,636,35,7,28,104,77,30,58,108,102,39,27,12,83
S01010351,Very good health,278,17,3,14,49,36,9,24,49,23,9,3,6,62
S01010351,Good health,216,14,3,11,37,27,15,20,36,40,10,5,5,17
S01010351,Fair health,99,2,1,1,10,8,5,9,18,30,13,12,1,4
S01010351,Bad health,36,2,0,2,7,3,1,5,4,8,6,6,0,0
S01010351,Very bad health,7,0,0,0,1,3,0,0,1,1,1,1,0,0
S01010352,All people aged 16 to 74,395,14,3,11,55,42,14,32,75,85,47,30,17,31
S01010352,Very good health,132,8,2,6,22,15,2,5,27,26,12,7,5,15
S01010352,Good health,146,3,0,3,20,19,5,17,27,26,17,7,10,12
S01010352,Fair health,73,2,1,1,9,4,4,6,13,18,13,11,2,4
S01010352,Bad health,26,0,0,0,4,3,2,2,5,9,1,1,0,0
S01010352,Very bad health,18,1,0,1,0,1,1,2,3,6,4,4,0,0
S01010353,All people aged 16 to 74,706,19,1,18,62,52,28,63,151,153,131,96,35,47
S01010353,Very good health,205,6,0,6,26,15,10,21,48,31,26,15,11,22
S01010353,Good health,220,6,0,6,17,13,12,15,41,46,48,34,14,22
S01010353,Fair health,142,5,0,5,11,8,2,15,26,40,33,25,8,2
S01010353,Bad health,99,2,1,1,5,13,2,10,25,27,14,12,2,1
S01010353,Very bad health,40,0,0,0,3,3,2,2,11,9,10,10,0,0
S01010354,All people aged 16 to 74,562,21,4,17,73,63,22,47,125,88,51,31,20,72
S01010354,Very good health,212,12,0,12,38,30,8,10,36,14,10,7,3,54
S01010354,Good health,168,6,4,2,19,12,5,14,43,26,27,13,14,16
S01010354,Fair health,96,3,0,3,9,12,6,8,23,24,10,8,2,1
S01010354,Bad health,69,0,0,0,5,8,2,11,17,22,3,2,1,1
S01010354,Very bad health,17,0,0,0,2,1,1,4,6,2,1,1,0,0
S01010355,All people aged 16 to 74,582,26,5,21,69,61,29,48,115,105,81,58,23,48
S01010355,Very good health,205,15,2,13,38,26,5,18,42,26,12,9,3,23
S01010355,Good health,196,10,3,7,24,22,13,14,37,31,23,9,14,22
S01010355,Fair health,108,0,0,0,7,9,6,9,18,30,26,22,4,3
S01010355,Bad health,52,1,0,1,0,2,5,6,12,10,16,14,2,0
S01010355,Very bad health,21,0,0,0,0,2,0,1,6,8,4,4,0,0
S01010356,All people aged 16 to 74,539,33,4,29,102,72,22,56,83,73,41,21,20,57
S01010356,Very good health,255,14,1,13,61,39,8,23,31,28,13,7,6,38
S01010356,Good health,193,14,2,12,32,22,10,27,30,32,8,4,4,18
S01010356,Fair health,56,4,1,3,5,9,3,3,13,6,12,5,7,1
S01010356,Bad health,26,1,0,1,3,2,0,2,7,5,6,4,2,0
S01010356,Very bad health,9,0,0,0,1,0,1,1,2,2,2,1,1,0
S01010357,All people aged 16 to 74,468,16,4,12,57,53,18,41,96,89,62,36,26,36
S01010357,Very good health,146,7,2,5,30,21,3,6,24,15,14,9,5,26
S01010357,Good health,164,8,2,6,20,21,7,18,37,32,13,5,8,8
S01010357,Fair health,96,1,0,1,4,6,5,6,20,26,27,15,12,1
S01010357,Bad health,44,0,0,0,2,4,3,6,13,10,5,4,1,1
S01010357,Very bad health,18,0,0,0,1,1,0,5,2,6,3,3,0,0
S01010358,All people aged 16 to 74,621,19,6,13,52,58,22,51,143,141,88,48,40,47
S01010358,Very good health,211,11,3,8,24,23,6,17,41,32,21,7,14,36
S01010358,Good health,191,6,2,4,14,20,6,18,46,37,36,18,18,8
S01010358,Fair health,132,1,0,1,10,8,5,8,33,46,19,11,8,2
S01010358,Bad health,60,1,1,0,3,5,5,4,13,20,9,9,0,0
S01010358,Very bad health,27,0,0,0,1,2,0,4,10,6,3,3,0,1
S01010359,All people aged 16 to 74,553,15,4,11,45,46,23,39,136,116,84,56,28,49
S01010359,Very good health,176,10,3,7,19,17,10,5,36,27,28,17,11,24
S01010359,Good health,192,3,1,2,17,12,7,17,55,40,22,12,10,19
S01010359,Fair health,107,2,0,2,4,8,5,13,23,28,18,13,5,6
S01010359,Bad health,58,0,0,0,5,8,1,4,14,17,9,7,2,0
S01010359,Very bad health,20,0,0,0,0,1,0,0,8,4,7,7,0,0
S01010360,All people aged 16 to 74,430,16,0,16,58,45,14,27,72,93,57,34,23,48
S01010360,Very good health,176,7,0,7,28,21,5,12,35,24,15,8,7,29
S01010360,Good health,121,7,0,7,21,5,5,10,16,26,16,8,8,15
S01010360,Fair health,59,2,0,2,4,9,2,3,7,17,11,7,4,4
S01010360,Bad health,59,0,0,0,4,9,2,2,12,19,11,8,3,0
S01010360,Very bad health,15,0,0,0,1,1,0,0,2,7,4,3,1,0
S01010361,All people aged 16 to 74,485,16,0,16,41,38,15,52,94,86,94,48,46,49
S01010361,Very good health,150,5,0,5,16,9,6,10,31,17,30,20,10,26
S01010361,Good health,169,8,0,8,12,14,7,16,29,29,35,13,22,19
S01010361,Fair health,102,3,0,3,11,10,1,16,21,24,13,4,9,3
S01010361,Bad health,49,0,0,0,2,4,1,7,9,13,12,7,5,1
S01010361,Very bad health,15,0,0,0,0,1,0,3,4,3,4,4,0,0
S01010362,All people aged 16 to 74,672,24,2,22,50,58,11,61,119,164,127,81,46,58
S01010362,Very good health,194,14,1,13,17,16,1,18,32,43,29,15,14,24
S01010362,Good health,247,7,1,6,19,25,3,13,44,54,50,31,19,32
S01010362,Fair health,137,0,0,0,10,12,2,20,25,29,37,25,12,2
S01010362,Bad health,67,3,0,3,4,3,3,8,15,24,7,6,1,0
S01010362,Very bad health,27,0,0,0,0,2,2,2,3,14,4,4,0,0
S01010363,All people aged 16 to 74,607,94,7,87,197,71,31,27,47,35,26,12,14,79
S01010363,Very good health,332,58,3,55,114,35,17,15,15,17,11,5,6,50
S01010363,Good health,194,26,2,24,59,22,10,5,22,13,10,5,5,27
S01010363,Fair health,53,8,2,6,12,10,3,6,6,2,4,1,3,2
S01010363,Bad health,23,2,0,2,10,3,1,1,3,2,1,1,0,0
S01010363,Very bad health,5,0,0,0,2,1,0,0,1,1,0,0,0,0
S01010364,All people aged 16 to 74,700,118,16,102,213,95,60,35,40,34,25,18,7,80
S01010364,Very good health,415,86,11,75,136,49,34,14,14,10,11,5,6,61
S01010364,Good health,193,25,5,20,51,34,14,17,15,16,7,6,1,14
S01010364,Fair health,71,5,0,5,19,9,11,3,8,7,5,5,0,4
S01010364,Bad health,14,2,0,2,4,1,1,0,2,1,2,2,0,1
S01010364,Very bad health,7,0,0,0,3,2,0,1,1,0,0,0,0,0
S01010365,All people aged 16 to 74,782,201,27,174,257,67,63,25,43,17,23,17,6,86
S01010365,Very good health,488,143,17,126,160,35,32,14,21,9,9,6,3,65
S01010365,Good health,224,51,8,43,71,22,24,9,19,5,6,3,3,17
S01010365,Fair health,52,5,1,4,21,7,6,1,1,2,5,5,0,4
S01010365,Bad health,12,2,1,1,2,2,1,1,2,0,2,2,0,0
S01010365,Very bad health,6,0,0,0,3,1,0,0,0,1,1,1,0,0
S01010366,All people aged 16 to 74,850,167,16,151,263,76,51,36,69,34,31,19,12,123
S01010366,Very good health,490,105,8,97,151,39,23,22,33,15,8,7,1,94
S01010366,Good health,270,51,7,44,83,30,17,10,25,15,15,10,5,24
S01010366,Fair health,63,9,1,8,20,5,5,2,11,2,5,1,4,4
S01010366,Bad health,20,0,0,0,6,2,6,2,0,1,2,1,1,1
S01010366,Very bad health,7,2,0,2,3,0,0,0,0,1,1,0,1,0
S01010367,All people aged 16 to 74,1413,217,20,197,258,71,48,23,47,22,15,9,6,712
S01010367,Very good health,881,147,10,137,157,34,26,15,24,15,3,2,1,460
S01010367,Good health,429,54,7,47,78,25,16,5,15,5,6,2,4,225
S01010367,Fair health,75,14,3,11,16,7,4,3,3,1,2,1,1,25
S01010367,Bad health,22,2,0,2,4,4,2,0,4,0,4,4,0,2
S01010367,Very bad health,6,0,0,0,3,1,0,0,1,1,0,0,0,0
S01010368,All people aged 16 to 74,543,177,25,152,160,58,34,15,21,12,11,6,5,55
S01010368,Very good health,338,124,15,109,85,34,17,9,15,5,5,2,3,44
S01010368,Good health,166,47,10,37,66,17,11,3,5,3,3,2,1,11
S01010368,Fair health,32,6,0,6,7,6,5,1,1,3,3,2,1,0
S01010368,Bad health,6,0,0,0,1,1,1,2,0,1,0,0,0,0
S01010368,Very bad health,1,0,0,0,1,0,0,0,0,0,0,0,0,0
S01010369,All people aged 16 to 74,654,116,9,107,182,60,35,21,58,38,40,28,12,104
S01010369,Very good health,382,86,3,83,101,37,20,9,25,16,12,6,6,76
S01010369,Good health,194,26,6,20,63,20,7,6,23,14,16,11,5,19
S01010369,Fair health,52,2,0,2,15,3,6,0,6,5,6,5,1,9
S01010369,Bad health,20,2,0,2,3,0,2,6,4,0,3,3,0,0
S01010369,Very bad health,6,0,0,0,0,0,0,0,0,3,3,3,0,0
S01010370,All people aged 16 to 74,618,157,19,138,177,40,44,18,21,20,18,10,8,123
S01010370,Very good health,420,123,10,113,116,24,33,9,13,8,6,2,4,88
S01010370,Good health,151,30,6,24,50,9,10,7,5,6,7,5,2,27
S01010370,Fair health,35,3,2,1,8,4,1,2,3,4,2,1,1,8
S01010370,Bad health,11,1,1,0,2,3,0,0,0,2,3,2,1,0
S01010370,Very bad health,1,0,0,0,1,0,0,0,0,0,0,0,0,0
S01010371,All people aged 16 to 74,872,182,19,163,244,59,40,23,26,20,27,19,8,251
S01010371,Very good health,576,129,12,117,160,39,21,11,13,8,9,5,4,186
S01010371,Good health,244,47,7,40,73,15,15,7,8,10,10,8,2,59
S01010371,Fair health,37,5,0,5,9,2,2,3,3,1,6,5,1,6
S01010371,Bad health,6,0,0,0,0,0,2,0,2,0,2,1,1,0
S01010371,Very bad health,9,1,0,1,2,3,0,2,0,1,0,0,0,0
S01010372,All people aged 16 to 74,431,99,13,86,125,41,19,19,25,17,11,7,4,75
S01010372,Very good health,262,71,8,63,77,22,9,11,11,5,3,2,1,53
S01010372,Good health,125,23,4,19,35,15,5,6,8,7,6,4,2,20
S01010372,Fair health,28,5,1,4,7,3,3,2,4,1,1,0,1,2
S01010372,Bad health,14,0,0,0,6,0,2,0,2,3,1,1,0,0
S01010372,Very bad health,2,0,0,0,0,1,0,0,0,1,0,0,0,0
S01010373,All people aged 16 to 74,654,140,11,129,186,53,27,21,36,35,16,9,7,140
S01010373,Very good health,401,98,9,89,116,27,12,11,14,13,6,1,5,104
S01010373,Good health,175,36,1,35,53,15,9,6,12,8,3,1,2,33
S01010373,Fair health,45,5,1,4,12,4,1,3,6,7,4,4,0,3
S01010373,Bad health,21,1,0,1,4,6,4,1,2,3,0,0,0,0
S01010373,Very bad health,12,0,0,0,1,1,1,0,2,4,3,3,0,0
S01010374,All people aged 16 to 74,792,210,22,188,199,48,41,24,26,18,20,15,5,206
S01010374,Very good health,527,159,12,147,123,27,28,17,14,5,9,7,2,145
S01010374,Good health,218,46,8,38,68,13,12,3,6,9,7,4,3,54
S01010374,Fair health,37,4,1,3,8,6,1,3,1,4,3,3,0,7
S01010374,Bad health,8,1,1,0,0,2,0,1,4,0,0,0,0,0
S01010374,Very bad health,2,0,0,0,0,0,0,0,1,0,1,1,0,0
S01010375,All people aged 16 to 74,492,58,3,55,58,18,16,4,21,12,9,4,5,296
S01010375,Very good health,364,42,1,41,39,9,9,2,10,5,6,1,5,242
S01010375,Good health,98,11,2,9,16,7,5,1,6,4,1,1,0,47
S01010375,Fair health,19,3,0,3,2,1,1,1,3,0,1,1,0,7
S01010375,Bad health,7,2,0,2,0,1,0,0,1,2,1,1,0,0
S01010375,Very bad health,4,0,0,0,1,0,1,0,1,1,0,0,0,0
S01010376,All people aged 16 to 74,659,83,6,77,125,39,23,20,32,15,16,13,3,306
S01010376,Very good health,425,62,3,59,73,23,13,8,15,6,10,8,2,215
S01010376,Good health,179,19,2,17,37,7,7,8,12,6,2,2,0,81
S01010376,Fair health,36,1,0,1,12,4,2,1,4,1,2,2,0,9
S01010376,Bad health,12,0,0,0,3,3,0,3,0,0,2,1,1,1
S01010376,Very bad health,7,1,1,0,0,2,1,0,1,2,0,0,0,0
S01010377,All people aged 16 to 74,851,95,8,87,101,52,33,16,48,28,45,35,10,433
S01010377,Very good health,538,67,4,63,66,19,17,8,19,13,17,14,3,312
S01010377,Good health,236,24,4,20,26,25,10,3,22,7,12,8,4,107
S01010377,Fair health,52,3,0,3,7,8,2,3,2,6,9,7,2,12
S01010377,Bad health,18,1,0,1,2,0,3,2,3,1,5,4,1,1
S01010377,Very bad health,7,0,0,0,0,0,1,0,2,1,2,2,0,1
S01010378,All people aged 16 to 74,678,100,8,92,69,26,13,9,15,13,20,10,10,413
S01010378,Very good health,500,76,5,71,46,13,7,4,9,8,6,3,3,331
S01010378,Good health,137,16,2,14,20,8,6,3,2,3,9,4,5,70
S01010378,Fair health,30,6,1,5,2,4,0,0,1,1,5,3,2,11
S01010378,Bad health,9,1,0,1,1,1,0,1,3,1,0,0,0,1
S01010378,Very bad health,2,1,0,1,0,0,0,1,0,0,0,0,0,0
S01010379,All people aged 16 to 74,1044,99,9,90,150,48,24,24,42,29,19,11,8,609
S01010379,Very good health,692,66,7,59,88,26,10,8,18,12,7,3,4,457
S01010379,Good health,270,30,2,28,44,19,10,7,17,8,4,3,1,131
S01010379,Fair health,54,2,0,2,13,1,2,3,3,6,4,1,3,20
S01010379,Bad health,26,1,0,1,5,2,2,6,3,3,3,3,0,1
S01010379,Very bad health,2,0,0,0,0,0,0,0,1,0,1,1,0,0
S01010380,All people aged 16 to 74,847,161,16,145,226,82,35,17,45,39,24,10,14,218
S01010380,Very good health,509,110,7,103,148,39,17,7,21,7,5,2,3,155
S01010380,Good health,239,40,4,36,65,29,11,5,13,17,10,3,7,49
S01010380,Fair health,72,8,3,5,7,11,6,4,5,10,7,4,3,14
S01010380,Bad health,21,3,2,1,4,2,1,0,5,4,2,1,1,0
S01010380,Very bad health,6,0,0,0,2,1,0,1,1,1,0,0,0,0
S01010381,All people aged 16 to 74,561,100,6,94,84,44,15,16,32,22,17,11,6,231
S01010381,Very good health,357,71,4,67,54,29,7,8,14,10,7,5,2,157
S01010381,Good health,157,22,2,20,23,10,7,4,12,10,5,2,3,64
S01010381,Fair health,32,6,0,6,5,3,0,3,3,2,2,1,1,8
S01010381,Bad health,10,0,0,0,1,1,1,1,3,0,2,2,0,1
S01010381,Very bad health,5,1,0,1,1,1,0,0,0,0,1,1,0,1
S01010382,All people aged 16 to 74,763,116,7,109,164,64,25,34,59,44,30,16,14,227
S01010382,Very good health,460,84,4,80,100,36,13,13,25,15,16,5,11,158
S01010382,Good health,225,24,2,22,52,23,10,14,20,12,8,5,3,62
S01010382,Fair health,50,7,1,6,8,4,1,4,6,9,5,5,0,6
S01010382,Bad health,20,1,0,1,4,1,1,2,5,5,0,0,0,1
S01010382,Very bad health,8,0,0,0,0,0,0,1,3,3,1,1,0,0
S01010383,All people aged 16 to 74,575,40,4,36,84,65,26,23,75,60,42,25,17,160
S01010383,Very good health,267,20,1,19,34,33,10,5,23,19,6,4,2,117
S01010383,Good health,169,15,1,14,29,14,8,13,24,19,11,5,6,36
S01010383,Fair health,77,4,2,2,13,11,3,3,13,12,13,5,8,5
S01010383,Bad health,48,1,0,1,7,5,5,2,11,7,8,8,0,2
S01010383,Very bad health,14,0,0,0,1,2,0,0,4,3,4,3,1,0
S01010384,All people aged 16 to 74,736,147,17,130,172,59,25,30,41,37,19,11,8,206
S01010384,Very good health,468,106,10,96,106,30,15,14,23,13,8,3,5,153
S01010384,Good health,191,33,6,27,48,19,7,12,9,10,5,4,1,48
S01010384,Fair health,46,6,1,5,13,7,2,3,5,5,0,0,0,5
S01010384,Bad health,19,1,0,1,4,1,1,1,2,5,4,3,1,0
S01010384,Very bad health,12,1,0,1,1,2,0,0,2,4,2,1,1,0
S01010385,All people aged 16 to 74,749,95,4,91,162,76,34,39,69,56,29,17,12,189
S01010385,Very good health,415,58,0,58,87,42,13,14,28,16,6,3,3,151
S01010385,Good health,206,30,3,27,52,22,14,14,19,13,11,4,7,31
S01010385,Fair health,77,4,0,4,12,10,4,7,10,17,6,5,1,7
S01010385,Bad health,34,2,1,1,5,1,3,2,10,5,6,5,1,0
S01010385,Very bad health,17,1,0,1,6,1,0,2,2,5,0,0,0,0
S01010386,All people aged 16 to 74,768,65,8,57,138,74,35,38,102,100,52,30,22,164
S01010386,Very good health,365,36,2,34,84,31,11,13,35,27,16,9,7,112
S01010386,Good health,207,23,5,18,36,19,14,15,25,23,13,6,7,39
S01010386,Fair health,122,6,1,5,13,14,5,8,23,25,17,9,8,11
S01010386,Bad health,53,0,0,0,5,6,3,2,13,18,4,4,0,2
S01010386,Very bad health,21,0,0,0,0,4,2,0,6,7,2,2,0,0
S01010387,All people aged 16 to 74,940,146,9,137,203,73,27,50,76,69,36,22,14,260
S01010387,Very good health,540,107,3,104,128,36,11,18,27,23,8,2,6,182
S01010387,Good health,258,31,6,25,55,22,8,17,30,18,6,3,3,71
S01010387,Fair health,87,8,0,8,13,11,5,12,7,15,9,6,3,7
S01010387,Bad health,42,0,0,0,5,3,3,3,11,8,9,8,1,0
S01010387,Very bad health,13,0,0,0,2,1,0,0,1,5,4,3,1,0
S01010388,All people aged 16 to 74,867,72,3,69,149,112,37,57,128,112,58,28,30,142
S01010388,Very good health,420,53,1,52,82,62,9,23,46,33,19,6,13,93
S01010388,Good health,235,11,1,10,45,29,11,16,39,28,18,5,13,38
S01010388,Fair health,117,4,0,4,13,9,9,9,27,26,12,8,4,8
S01010388,Bad health,70,4,1,3,4,10,7,6,11,18,7,7,0,3
S01010388,Very bad health,25,0,0,0,5,2,1,3,5,7,2,2,0,0
S01010389,All people aged 16 to 74,967,246,29,217,266,68,40,26,46,33,20,10,10,222
S01010389,Very good health,670,177,18,159,192,40,22,17,30,15,11,7,4,166
S01010389,Good health,240,58,9,49,61,21,14,5,12,10,8,2,6,51
S01010389,Fair health,35,8,1,7,9,4,1,2,1,5,0,0,0,5
S01010389,Bad health,15,2,1,1,4,2,1,1,2,2,1,1,0,0
S01010389,Very bad health,7,1,0,1,0,1,2,1,1,1,0,0,0,0
S01010390,All people aged 16 to 74,981,157,16,141,272,129,36,45,90,60,46,15,31,146
S01010390,Very good health,537,104,9,95,164,62,17,24,35,21,10,0,10,100
S01010390,Good health,324,45,5,40,79,53,17,10,42,21,17,4,13,40
S01010390,Fair health,75,6,1,5,19,10,1,8,8,7,10,3,7,6
S01010390,Bad health,34,2,1,1,10,1,0,3,5,5,8,7,1,0
S01010390,Very bad health,11,0,0,0,0,3,1,0,0,6,1,1,0,0
S01010391,All people aged 16 to 74,707,81,7,74,192,89,31,48,86,51,27,15,12,102
S01010391,Very good health,381,57,3,54,114,47,12,23,36,15,7,4,3,70
S01010391,Good health,210,21,2,19,57,23,11,10,34,19,9,4,5,26
S01010391,Fair health,70,2,1,1,14,12,3,12,8,11,4,1,3,4
S01010391,Bad health,29,0,0,0,4,3,3,1,6,3,7,6,1,2
S01010391,Very bad health,17,1,1,0,3,4,2,2,2,3,0,0,0,0
S01010392,All people aged 16 to 74,630,180,23,157,190,56,34,18,18,10,14,6,8,110
S01010392,Very good health,440,136,14,122,129,43,21,10,10,2,7,2,5,82
S01010392,Good health,158,37,6,31,50,12,9,7,6,5,4,2,2,28
S01010392,Fair health,25,7,3,4,8,0,4,0,1,3,2,1,1,0
S01010392,Bad health,5,0,0,0,2,1,0,0,1,0,1,1,0,0
S01010392,Very bad health,2,0,0,0,1,0,0,1,0,0,0,0,0,0
S01010393,All people aged 16 to 74,880,136,10,126,265,102,32,55,75,45,30,20,10,140
S01010393,Very good health,537,96,6,90,165,49,13,30,43,22,6,4,2,113
S01010393,Good health,239,34,4,30,76,37,11,12,19,13,13,7,6,24
S01010393,Fair health,70,6,0,6,16,12,5,7,8,5,8,6,2,3
S01010393,Bad health,21,0,0,0,5,3,2,4,2,3,2,2,0,0
S01010393,Very bad health,13,0,0,0,3,1,1,2,3,2,1,1,0,0
S01010394,All people aged 16 to 74,640,57,4,53,115,71,39,35,90,89,76,50,26,68
S01010394,Very good health,249,35,2,33,62,26,15,13,22,17,10,6,4,49
S01010394,Good health,171,15,0,15,24,17,13,4,31,19,31,16,15,17
S01010394,Fair health,115,5,1,4,15,13,6,9,22,24,19,12,7,2
S01010394,Bad health,75,1,1,0,10,8,3,7,12,24,10,10,0,0
S01010394,Very bad health,30,1,0,1,4,7,2,2,3,5,6,6,0,0
S01010395,All people aged 16 to 74,840,115,11,104,204,99,36,53,91,59,35,21,14,148
S01010395,Very good health,472,80,7,73,127,54,16,22,40,19,7,4,3,107
S01010395,Good health,232,29,2,27,51,29,13,18,31,17,10,5,5,34
S01010395,Fair health,85,5,1,4,20,5,4,8,16,13,9,6,3,5
S01010395,Bad health,38,1,1,0,5,8,3,3,2,7,7,4,3,2
S01010395,Very bad health,13,0,0,0,1,3,0,2,2,3,2,2,0,0
S01010396,All people aged 16 to 74,863,148,10,138,184,89,31,45,84,78,42,25,17,162
S01010396,Very good health,466,104,8,96,102,44,15,18,34,20,14,7,7,115
S01010396,Good health,258,36,2,34,62,28,10,16,27,23,17,9,8,39
S01010396,Fair health,81,8,0,8,11,11,4,5,13,16,5,4,1,8
S01010396,Bad health,45,0,0,0,8,6,2,5,9,12,3,2,1,0
S01010396,Very bad health,13,0,0,0,1,0,0,1,1,7,3,3,0,0
S01010397,All people aged 16 to 74,475,122,14,108,117,33,20,6,27,18,17,9,8,115
S01010397,Very good health,308,88,8,80,75,17,8,0,14,9,3,1,2,94
S01010397,Good health,121,29,5,24,35,11,8,5,6,6,4,0,4,17
S01010397,Fair health,32,4,1,3,5,2,4,1,4,1,7,6,1,4
S01010397,Bad health,13,1,0,1,2,3,0,0,3,2,2,1,1,0
S01010397,Very bad health,1,0,0,0,0,0,0,0,0,0,1,1,0,0
S01010398,All people aged 16 to 74,909,220,23,197,249,85,49,35,58,26,19,8,11,168
S01010398,Very good health,593,160,19,141,163,50,24,16,39,10,10,2,8,121
S01010398,Good health,250,50,2,48,74,23,17,13,15,10,5,2,3,43
S01010398,Fair health,48,6,0,6,8,11,7,5,4,3,1,1,0,3
S01010398,Bad health,15,4,2,2,3,0,1,1,0,2,3,3,0,1
S01010398,Very bad health,3,0,0,0,1,1,0,0,0,1,0,0,0,0
S01010399,All people aged 16 to 74,946,316,28,288,292,64,25,21,34,13,20,8,12,161
S01010399,Very good health,650,224,22,202,195,41,13,11,17,8,11,3,8,130
S01010399,Good health,242,83,5,78,78,17,7,9,12,3,6,2,4,27
S01010399,Fair health,38,7,1,6,12,2,5,1,4,2,2,2,0,3
S01010399,Bad health,11,2,0,2,5,2,0,0,1,0,0,0,0,1
S01010399,Very bad health,5,0,0,0,2,2,0,0,0,0,1,1,0,0
S01010400,All people aged 16 to 74,891,236,21,215,281,58,53,27,36,31,23,15,8,146
S01010400,Very good health,544,154,10,144,161,29,37,20,15,11,6,4,2,111
S01010400,Good health,264,66,9,57,97,22,10,4,14,8,12,7,5,31
S01010400,Fair health,62,13,2,11,17,5,5,1,5,10,3,2,1,3
S01010400,Bad health,13,3,0,3,5,1,0,1,1,0,1,1,0,1
S01010400,Very bad health,8,0,0,0,1,1,1,1,1,2,1,1,0,0
S01010401,All people aged 16 to 74,592,152,15,137,164,53,30,17,24,20,9,3,6,123
S01010401,Very good health,385,112,9,103,120,22,15,9,13,4,3,2,1,87
S01010401,Good health,153,31,6,25,32,21,12,6,4,8,4,1,3,35
S01010401,Fair health,41,8,0,8,8,7,3,0,6,7,1,0,1,1
S01010401,Bad health,12,1,0,1,4,3,0,1,1,1,1,0,1,0
S01010401,Very bad health,1,0,0,0,0,0,0,1,0,0,0,0,0,0
S01010402,All people aged 16 to 74,855,292,31,261,235,76,38,11,41,17,18,11,7,127
S01010402,Very good health,578,222,20,202,137,54,27,6,17,10,7,4,3,98
S01010402,Good health,211,57,10,47,77,13,11,5,18,2,6,3,3,22
S01010402,Fair health,50,11,1,10,17,8,0,0,4,5,2,2,0,3
S01010402,Bad health,13,2,0,2,4,1,0,0,1,0,1,0,1,4
S01010402,Very bad health,3,0,0,0,0,0,0,0,1,0,2,2,0,0
S01010403,All people aged 16 to 74,836,284,30,254,247,61,46,17,22,12,9,4,5,138
S01010403,Very good health,550,198,20,178,142,38,30,8,11,6,6,2,4,111
S01010403,Good health,221,70,7,63,81,14,13,4,10,3,0,0,0,26
S01010403,Fair health,53,15,3,12,15,8,2,5,1,3,3,2,1,1
S01010403,Bad health,11,1,0,1,8,1,1,0,0,0,0,0,0,0
S01010403,Very bad health,1,0,0,0,1,0,0,0,0,0,0,0,0,0
S01010404,All people aged 16 to 74,622,161,16,145,214,43,59,17,20,23,14,10,4,71
S01010404,Very good health,393,120,12,108,130,23,37,8,10,9,5,2,3,51
S01010404,Good health,176,35,3,32,66,15,16,8,3,6,7,6,1,20
S01010404,Fair health,38,5,1,4,14,3,5,1,3,5,2,2,0,0
S01010404,Bad health,8,0,0,0,3,1,1,0,2,1,0,0,0,0
S01010404,Very bad health,7,1,0,1,1,1,0,0,2,2,0,0,0,0
S01010405,All people aged 16 to 74,660,220,15,205,207,49,43,19,20,15,16,8,8,71
S01010405,Very good health,453,167,11,156,136,28,23,8,11,8,7,2,5,65
S01010405,Good health,152,41,3,38,53,12,15,9,6,4,8,5,3,4
S01010405,Fair health,39,9,1,8,14,6,4,2,0,2,1,1,0,1
S01010405,Bad health,14,3,0,3,3,3,0,0,3,1,0,0,0,1
S01010405,Very bad health,2,0,0,0,1,0,1,0,0,0,0,0,0,0
S01010406,All people aged 16 to 74,735,175,17,158,172,49,42,20,36,25,25,15,10,191
S01010406,Very good health,472,131,10,121,110,35,22,13,21,8,4,2,2,128
S01010406,Good health,182,36,6,30,44,11,19,5,8,10,3,1,2,46
S01010406,Fair health,64,5,0,5,15,3,1,2,6,2,15,10,5,15
S01010406,Bad health,15,3,1,2,2,0,0,0,1,4,3,2,1,2
S01010406,Very bad health,2,0,0,0,1,0,0,0,0,1,0,0,0,0
S01010407,All people aged 16 to 74,819,114,20,94,145,45,23,16,32,20,14,7,7,410
S01010407,Very good health,562,80,13,67,85,23,10,12,20,10,3,3,0,319
S01010407,Good health,206,29,7,22,52,14,8,2,7,6,6,1,5,82
S01010407,Fair health,41,3,0,3,7,7,5,2,4,3,4,2,2,6
S01010407,Bad health,7,2,0,2,0,1,0,0,1,0,0,0,0,3
S01010407,Very bad health,3,0,0,0,1,0,0,0,0,1,1,1,0,0
S01010408,All people aged 16 to 74,369,78,16,62,89,56,29,15,30,28,16,12,4,28
S01010408,Very good health,179,55,9,46,38,24,15,6,11,6,2,2,0,22
S01010408,Good health,112,16,6,10,33,22,8,3,9,11,8,4,4,2
S01010408,Fair health,52,1,0,1,14,6,5,4,8,7,3,3,0,4
S01010408,Bad health,20,4,1,3,3,4,1,1,2,3,2,2,0,0
S01010408,Very bad health,6,2,0,2,1,0,0,1,0,1,1,1,0,0
S01010409,All people aged 16 to 74,491,100,11,89,135,54,42,18,36,18,18,12,6,70
S01010409,Very good health,308,59,5,54,89,27,18,14,18,8,9,5,4,66
S01010409,Good health,122,30,3,27,35,22,13,2,8,5,4,2,2,3
S01010409,Fair health,47,9,3,6,9,4,9,1,7,4,3,3,0,1
S01010409,Bad health,11,1,0,1,2,1,1,1,2,1,2,2,0,0
S01010409,Very bad health,3,1,0,1,0,0,1,0,1,0,0,0,0,0
S01010410,All people aged 16 to 74,424,129,15,114,113,50,25,16,19,12,15,9,6,45
S01010410,Very good health,275,99,14,85,76,28,11,7,6,4,4,3,1,40
S01010410,Good health,110,23,1,22,25,18,10,6,12,6,6,2,4,4
S01010410,Fair health,30,5,0,5,11,3,4,2,1,1,3,2,1,0
S01010410,Bad health,9,2,0,2,1,1,0,1,0,1,2,2,0,1
S01010410,Very bad health,0,0,0,0,0,0,0,0,0,0,0,0,0,0
S01010411,All people aged 16 to 74,738,209,24,185,246,70,37,27,22,17,23,16,7,87
S01010411,Very good health,494,151,17,134,163,39,20,16,10,8,9,2,7,78
S01010411,Good health,204,48,4,44,74,25,12,10,10,7,9,9,0,9
S01010411,Fair health,31,10,3,7,7,5,4,1,1,1,2,2,0,0
S01010411,Bad health,8,0,0,0,1,1,1,0,1,1,3,3,0,0
S01010411,Very bad health,1,0,0,0,1,0,0,0,0,0,0,0,0,0
S01010412,All people aged 16 to 74,694,198,22,176,187,56,40,24,35,37,34,30,4,83
S01010412,Very good health,427,137,15,122,131,31,19,9,23,13,2,0,2,62
S01010412,Good health,182,49,6,43,47,18,16,7,4,11,11,10,1,19
S01010412,Fair health,39,10,1,9,4,4,3,5,2,5,5,4,1,1
S01010412,Bad health,30,2,0,2,3,1,0,2,4,4,13,13,0,1
S01010412,Very bad health,16,0,0,0,2,2,2,1,2,4,3,3,0,0
S01010413,All people aged 16 to 74,503,133,15,118,157,50,36,19,23,15,19,16,3,51
S01010413,Very good health,302,83,7,76,101,32,12,11,10,11,10,8,2,32
S01010413,Good health,146,39,5,34,44,14,10,6,9,1,7,6,1,16
S01010413,Fair health,43,9,2,7,9,4,10,1,4,2,2,2,0,2
S01010413,Bad health,12,2,1,1,3,0,4,1,0,1,0,0,0,1
S01010413,Very bad health,0,0,0,0,0,0,0,0,0,0,0,0,0,0
S01010414,All people aged 16 to 74,771,179,16,163,247,89,38,39,46,32,18,9,9,83
S01010414,Very good health,459,126,11,115,148,48,14,19,23,9,9,3,6,63
S01010414,Good health,204,42,4,38,63,22,15,12,15,13,5,3,2,17
S01010414,Fair health,84,9,1,8,29,15,7,6,5,7,3,2,1,3
S01010414,Bad health,19,2,0,2,5,2,2,1,3,3,1,1,0,0
S01010414,Very bad health,5,0,0,0,2,2,0,1,0,0,0,0,0,0
S01010415,All people aged 16 to 74,776,80,13,67,149,91,55,59,91,98,58,38,20,95
S01010415,Very good health,333,52,9,43,77,40,15,20,28,21,13,9,4,67
S01010415,Good health,236,19,3,16,48,29,23,18,36,24,20,8,12,19
S01010415,Fair health,149,9,1,8,14,16,16,18,16,36,15,12,3,9
S01010415,Bad health,46,0,0,0,7,6,0,3,7,16,7,6,1,0
S01010415,Very bad health,12,0,0,0,3,0,1,0,4,1,3,3,0,0
S01010416,All people aged 16 to 74,523,117,17,100,166,61,33,28,38,22,9,5,4,49
S01010416,Very good health,328,91,14,77,107,33,16,17,19,10,2,1,1,33
S01010416,Good health,150,21,3,18,46,21,12,9,16,5,4,2,2,16
S01010416,Fair health,31,5,0,5,9,6,5,1,2,2,1,1,0,0
S01010416,Bad health,10,0,0,0,3,1,0,0,0,5,1,0,1,0
S01010416,Very bad health,4,0,0,0,1,0,0,1,1,0,1,1,0,0
S01010417,All people aged 16 to 74,428,108,11,97,144,47,24,10,30,12,12,7,5,41
S01010417,Very good health,268,66,6,60,97,27,17,6,13,6,3,1,2,33
S01010417,Good health,110,31,5,26,36,15,4,1,11,3,2,0,2,7
S01010417,Fair health,32,7,0,7,9,4,1,2,4,1,3,2,1,1
S01010417,Bad health,16,4,0,4,2,1,2,1,2,1,3,3,0,0
S01010417,Very bad health,2,0,0,0,0,0,0,0,0,1,1,1,0,0
S01010418,All people aged 16 to 74,894,249,19,230,297,82,46,25,44,24,40,32,8,87
S01010418,Very good health,579,177,16,161,201,46,33,10,21,10,10,6,4,71
S01010418,Good health,245,62,1,61,80,28,11,11,18,10,12,9,3,13
S01010418,Fair health,50,8,2,6,9,7,2,4,4,1,12,11,1,3
S01010418,Bad health,15,0,0,0,6,1,0,0,1,2,5,5,0,0
S01010418,Very bad health,5,2,0,2,1,0,0,0,0,1,1,1,0,0
S01010419,All people aged 16 to 74,772,251,25,226,258,78,33,20,34,25,11,6,5,62
S01010419,Very good health,505,189,18,171,172,44,22,10,13,11,5,2,3,39
S01010419,Good health,200,52,7,45,64,26,7,5,11,9,3,2,1,23
S01010419,Fair health,49,10,0,10,15,6,4,3,7,2,2,1,1,0
S01010419,Bad health,13,0,0,0,6,1,0,1,2,3,0,0,0,0
S01010419,Very bad health,5,0,0,0,1,1,0,1,1,0,1,1,0,0
S01010420,All people aged 16 to 74,476,88,7,81,138,46,28,27,40,33,13,9,4,63
S01010420,Very good health,305,58,5,53,95,29,17,10,20,18,3,1,2,55
S01010420,Good health,115,24,1,23,36,10,6,11,7,9,5,3,2,7
S01010420,Fair health,49,4,0,4,7,5,5,5,12,6,4,4,0,1
S01010420,Bad health,5,1,0,1,0,1,0,1,1,0,1,1,0,0
S01010420,Very bad health,2,1,1,0,0,1,0,0,0,0,0,0,0,0
S01010421,All people aged 16 to 74,637,177,20,157,199,72,35,20,36,16,15,9,6,67
S01010421,Very good health,428,124,14,110,133,39,17,15,20,11,8,3,5,61
S01010421,Good health,151,45,6,39,51,27,12,3,2,2,4,3,1,5
S01010421,Fair health,40,7,0,7,11,6,2,2,10,1,0,0,0,1
S01010421,Bad health,14,1,0,1,2,0,3,0,3,2,3,3,0,0
S01010421,Very bad health,4,0,0,0,2,0,1,0,1,0,0,0,0,0
S01010422,All people aged 16 to 74,778,139,22,117,248,81,42,30,71,49,31,18,13,87
S01010422,Very good health,465,101,15,86,156,43,22,11,32,17,13,8,5,70
S01010422,Good health,218,36,7,29,67,24,16,11,21,17,11,6,5,15
S01010422,Fair health,58,2,0,2,15,8,4,3,13,8,4,1,3,1
S01010422,Bad health,24,0,0,0,9,4,0,1,4,3,2,2,0,1
S01010422,Very bad health,13,0,0,0,1,2,0,4,1,4,1,1,0,0
S01010423,All people aged 16 to 74,661,45,7,38,100,85,24,44,117,94,85,54,31,67
S01010423,Very good health,246,15,1,14,53,38,6,14,39,26,12,8,4,43
S01010423,Good health,240,26,6,20,32,26,13,20,47,25,34,19,15,17
S01010423,Fair health,100,3,0,3,8,12,3,3,20,24,22,14,8,5
S01010423,Bad health,58,0,0,0,5,8,1,6,9,15,12,9,3,2
S01010423,Very bad health,17,1,0,1,2,1,1,1,2,4,5,4,1,0
S01010424,All people aged 16 to 74,635,35,4,31,117,75,30,47,109,96,63,40,23,63
S01010424,Very good health,266,25,3,22,61,30,8,25,28,33,12,7,5,44
S01010424,Good health,181,4,0,4,37,26,8,11,40,23,17,7,10,15
S01010424,Fair health,120,5,1,4,13,15,7,8,27,22,22,15,7,1
S01010424,Bad health,50,0,0,0,5,3,6,2,9,14,10,9,1,1
S01010424,Very bad health,18,1,0,1,1,1,1,1,5,4,2,2,0,2
S01010425,All people aged 16 to 74,819,38,8,30,146,87,32,66,169,116,83,52,31,82
S01010425,Very good health,331,21,4,17,82,36,6,20,60,26,22,13,9,58
S01010425,Good health,240,14,3,11,38,30,11,19,63,25,19,9,10,21
S01010425,Fair health,124,3,1,2,20,12,9,12,24,25,16,6,10,3
S01010425,Bad health,92,0,0,0,5,4,5,11,13,34,20,18,2,0
S01010425,Very bad health,32,0,0,0,1,5,1,4,9,6,6,6,0,0
S01010426,All people aged 16 to 74,582,41,5,36,134,71,35,53,95,61,56,37,19,36
S01010426,Very good health,239,28,3,25,65,27,7,13,41,15,18,11,7,25
S01010426,Good health,216,12,2,10,51,32,18,26,32,19,18,11,7,8
S01010426,Fair health,69,0,0,0,9,7,9,11,10,12,8,4,4,3
S01010426,Bad health,44,0,0,0,7,4,1,2,10,11,9,8,1,0
S01010426,Very bad health,14,1,0,1,2,1,0,1,2,4,3,3,0,0
S01010427,All people aged 16 to 74,703,34,4,30,111,63,37,42,114,99,141,106,35,62
S01010427,Very good health,273,17,4,13,60,28,13,13,46,22,33,23,10,41
S01010427,Good health,229,9,0,9,31,20,16,15,36,35,51,37,14,16
S01010427,Fair health,115,5,0,5,15,4,2,9,20,21,36,31,5,3
S01010427,Bad health,61,3,0,3,5,8,4,4,6,16,13,11,2,2
S01010427,Very bad health,25,0,0,0,0,3,2,1,6,5,8,4,4,0
S01010428,All people aged 16 to 74,507,90,11,79,158,78,22,21,45,24,23,18,5,46
S01010428,Very good health,278,60,7,53,91,36,8,11,18,8,5,5,0,41
S01010428,Good health,158,25,4,21,55,22,9,8,14,6,16,11,5,3
S01010428,Fair health,53,4,0,4,9,15,5,2,10,6,0,0,0,2
S01010428,Bad health,15,0,0,0,3,5,0,0,3,3,1,1,0,0
S01010428,Very bad health,3,1,0,1,0,0,0,0,0,1,1,1,0,0
S01010429,All people aged 16 to 74,725,151,19,132,258,75,34,27,58,33,26,19,7,63
S01010429,Very good health,431,110,10,100,159,48,16,12,24,11,6,0,6,45
S01010429,Good health,203,34,6,28,77,16,12,11,28,7,5,4,1,13
S01010429,Fair health,70,5,2,3,21,8,4,4,4,7,13,13,0,4
S01010429,Bad health,17,2,1,1,0,3,2,0,2,6,2,2,0,0
S01010429,Very bad health,4,0,0,0,1,0,0,0,0,2,0,0,0,1
S01010430,All people aged 16 to 74,645,13,4,9,64,86,36,40,128,119,71,48,23,88
S01010430,Very good health,252,8,2,6,32,24,15,13,52,41,21,16,5,46
S01010430,Good health,216,2,1,1,20,33,10,20,42,42,22,9,13,25
S01010430,Fair health,108,2,0,2,8,16,5,4,22,16,20,15,5,15
S01010430,Bad health,46,1,1,0,3,4,2,3,11,16,5,5,0,1
S01010430,Very bad health,23,0,0,0,1,9,4,0,1,4,3,3,0,1
S01010431,All people aged 16 to 74,514,107,19,88,188,51,29,21,26,25,9,5,4,58
S01010431,Very good health,322,76,13,63,120,26,15,10,13,14,3,1,2,45
S01010431,Good health,136,26,6,20,48,18,8,8,8,7,2,0,2,11
S01010431,Fair health,42,5,0,5,18,4,5,1,0,4,3,3,0,2
S01010431,Bad health,12,0,0,0,2,2,1,2,4,0,1,1,0,0
S01010431,Very bad health,2,0,0,0,0,1,0,0,1,0,0,0,0,0
S01010432,All people aged 16 to 74,698,24,8,16,88,91,31,57,143,113,65,46,19,86
S01010432,Very good health,264,9,1,8,45,40,15,19,44,34,13,10,3,45
S01010432,Good health,256,12,5,7,32,33,9,20,51,42,21,13,8,36
S01010432,Fair health,103,3,2,1,8,13,2,11,24,21,19,13,6,2
S01010432,Bad health,65,0,0,0,3,4,4,7,21,14,9,8,1,3
S01010432,Very bad health,10,0,0,0,0,1,1,0,3,2,3,2,1,0
S01010433,All people aged 16 to 74,537,9,0,9,27,25,33,40,90,70,161,132,29,82
S01010433,Very good health,217,3,0,3,12,6,13,17,37,26,60,53,7,43
S01010433,Good health,198,4,0,4,11,14,15,15,30,29,51,35,16,29
S01010433,Fair health,74,0,0,0,2,3,1,8,13,7,33,27,6,7
S01010433,Bad health,37,2,0,2,2,1,3,0,9,6,11,11,0,3
S01010433,Very bad health,11,0,0,0,0,1,1,0,1,2,6,6,0,0
S01010434,All people aged 16 to 74,473,19,4,15,67,43,14,45,72,85,74,49,25,54
S01010434,Very good health,185,12,1,11,40,15,5,12,22,29,21,14,7,29
S01010434,Good health,158,4,2,2,16,16,7,22,23,23,25,16,9,22
S01010434,Fair health,69,3,1,2,10,8,0,5,15,13,14,8,6,1
S01010434,Bad health,51,0,0,0,1,3,1,5,10,17,12,9,3,2
S01010434,Very bad health,10,0,0,0,0,1,1,1,2,3,2,2,0,0
S01010435,All people aged 16 to 74,443,16,1,15,66,76,15,39,91,79,25,18,7,36
S01010435,Very good health,174,7,0,7,37,36,5,10,21,24,9,7,2,25
S01010435,Good health,149,5,1,4,18,22,4,18,43,23,7,4,3,9
S01010435,Fair health,76,3,0,3,9,10,4,7,19,17,6,4,2,1
S01010435,Bad health,29,1,0,1,2,4,2,2,5,9,3,3,0,1
S01010435,Very bad health,15,0,0,0,0,4,0,2,3,6,0,0,0,0
S01010436,All people aged 16 to 74,634,29,4,25,100,74,37,35,106,105,79,56,23,69
S01010436,Very good health,246,18,4,14,43,26,14,13,34,34,17,11,6,47
S01010436,Good health,198,6,0,6,39,31,14,13,36,22,20,8,12,17
S01010436,Fair health,106,3,0,3,12,10,5,4,16,27,24,21,3,5
S01010436,Bad health,57,1,0,1,3,6,3,2,14,16,12,11,1,0
S01010436,Very bad health,27,1,0,1,3,1,1,3,6,6,6,5,1,0
S01010437,All people aged 16 to 74,406,10,4,6,60,60,12,29,83,77,37,22,15,38
S01010437,Very good health,180,8,4,4,32,26,3,12,41,26,9,4,5,23
S01010437,Good health,111,1,0,1,21,15,7,7,20,20,7,2,5,13
S01010437,Fair health,80,1,0,1,6,17,0,7,14,19,14,9,5,2
S01010437,Bad health,28,0,0,0,1,1,2,3,8,7,6,6,0,0
S01010437,Very bad health,7,0,0,0,0,1,0,0,0,5,1,1,0,0
S01010438,All people aged 16 to 74,592,18,2,16,94,53,20,55,119,97,77,59,18,59
S01010438,Very good health,262,11,2,9,56,27,7,24,48,24,24,17,7,41
S01010438,Good health,187,4,0,4,26,14,12,20,38,33,27,21,6,13
S01010438,Fair health,81,1,0,1,6,8,1,6,25,18,12,8,4,4
S01010438,Bad health,44,1,0,1,5,3,0,1,5,18,10,9,1,1
S01010438,Very bad health,18,1,0,1,1,1,0,4,3,4,4,4,0,0
S01010439,All people aged 16 to 74,772,34,6,28,137,94,25,60,127,140,64,47,17,91
S01010439,Very good health,423,23,5,18,88,58,13,30,54,62,21,14,7,74
S01010439,Good health,214,10,1,9,36,24,9,16,41,46,18,10,8,14
S01010439,Fair health,71,1,0,1,9,7,1,12,17,11,11,10,1,2
S01010439,Bad health,56,0,0,0,4,5,2,2,14,16,12,12,0,1
S01010439,Very bad health,8,0,0,0,0,0,0,0,1,5,2,1,1,0
S01010440,All people aged 16 to 74,490,28,6,22,62,64,18,37,81,83,74,55,19,43
S01010440,Very good health,186,13,2,11,33,25,5,12,22,24,17,11,6,35
S01010440,Good health,165,9,3,6,23,32,11,8,35,23,18,13,5,6
S01010440,Fair health,78,4,0,4,4,4,1,10,13,17,23,17,6,2
S01010440,Bad health,42,1,1,0,2,3,0,1,8,16,11,9,2,0
S01010440,Very bad health,19,1,0,1,0,0,1,6,3,3,5,5,0,0
S01010441,All people aged 16 to 74,686,64,8,56,175,125,27,56,89,74,32,11,21,44
S01010441,Very good health,382,50,5,45,117,60,12,29,47,33,5,3,2,29
S01010441,Good health,207,12,3,9,41,42,12,20,31,19,17,3,14,13
S01010441,Fair health,70,1,0,1,15,19,2,5,5,14,7,3,4,2
S01010441,Bad health,16,0,0,0,2,3,0,1,2,5,3,2,1,0
S01010441,Very bad health,11,1,0,1,0,1,1,1,4,3,0,0,0,0
S01010442,All people aged 16 to 74,587,23,4,19,109,81,25,43,101,92,69,39,30,44
S01010442,Very good health,256,14,0,14,68,34,10,13,42,25,22,13,9,28
S01010442,Good health,216,5,3,2,36,36,9,26,36,33,24,8,16,11
S01010442,Fair health,67,3,1,2,4,8,5,1,15,18,10,5,5,3
S01010442,Bad health,36,0,0,0,1,1,1,3,8,9,12,12,0,1
S01010442,Very bad health,12,1,0,1,0,2,0,0,0,7,1,1,0,1
S01010443,All people aged 16 to 74,378,17,4,13,67,57,29,37,70,57,22,15,7,22
S01010443,Very good health,155,8,2,6,29,23,13,14,25,21,6,3,3,16
S01010443,Good health,130,7,1,6,25,20,8,12,23,22,9,6,3,4
S01010443,Fair health,57,1,0,1,8,6,6,5,15,9,7,6,1,0
S01010443,Bad health,29,1,1,0,5,7,0,6,5,4,0,0,0,1
S01010443,Very bad health,7,0,0,0,0,1,2,0,2,1,0,0,0,1
S01010444,All people aged 16 to 74,496,18,3,15,62,65,26,33,105,104,49,31,18,34
S01010444,Very good health,196,12,1,11,30,31,10,9,32,27,17,8,9,28
S01010444,Good health,152,6,2,4,17,19,11,8,41,30,15,9,6,5
S01010444,Fair health,90,0,0,0,11,12,2,11,17,26,10,7,3,1
S01010444,Bad health,37,0,0,0,3,1,2,2,11,13,5,5,0,0
S01010444,Very bad health,21,0,0,0,1,2,1,3,4,8,2,2,0,0
S01010445,All people aged 16 to 74,581,22,4,18,65,72,31,58,120,104,62,53,9,47
S01010445,Very good health,224,15,2,13,30,34,13,22,39,28,9,6,3,34
S01010445,Good health,187,5,1,4,26,20,11,17,47,35,14,12,2,12
S01010445,Fair health,110,1,0,1,4,13,5,10,26,26,24,20,4,1
S01010445,Bad health,31,0,0,0,4,3,1,4,5,9,5,5,0,0
S01010445,Very bad health,29,1,1,0,1,2,1,5,3,6,10,10,0,0
S01010446,All people aged 16 to 74,649,27,7,20,126,88,55,70,99,95,34,21,13,55
S01010446,Very good health,315,16,3,13,67,49,26,37,38,29,10,4,6,43
S01010446,Good health,177,10,4,6,33,20,20,18,31,31,7,5,2,7
S01010446,Fair health,93,0,0,0,20,8,7,7,17,18,11,6,5,5
S01010446,Bad health,44,1,0,1,6,8,1,7,9,10,2,2,0,0
S01010446,Very bad health,20,0,0,0,0,3,1,1,4,7,4,4,0,0
S01010447,All people aged 16 to 74,747,22,2,20,87,96,38,81,163,115,82,56,26,63
S01010447,Very good health,265,14,0,14,41,33,17,20,50,28,18,13,5,44
S01010447,Good health,226,5,1,4,29,23,9,24,63,28,32,16,16,13
S01010447,Fair health,133,3,1,2,8,24,7,23,25,24,13,9,4,6
S01010447,Bad health,93,0,0,0,6,14,3,12,22,25,11,10,1,0
S01010447,Very bad health,30,0,0,0,3,2,2,2,3,10,8,8,0,0
S01010448,All people aged 16 to 74,644,40,11,29,129,112,36,42,102,81,41,28,13,61
S01010448,Very good health,298,27,8,19,73,50,14,20,36,19,9,8,1,50
S01010448,Good health,201,10,2,8,38,39,14,12,32,32,17,8,9,7
S01010448,Fair health,82,2,1,1,7,16,5,6,20,15,9,6,3,2
S01010448,Bad health,39,1,0,1,8,4,1,1,12,8,2,2,0,2
S01010448,Very bad health,24,0,0,0,3,3,2,3,2,7,4,4,0,0
S01010449,All people aged 16 to 74,571,17,1,16,95,88,21,49,108,116,51,36,15,26
S01010449,Very good health,196,11,1,10,46,39,9,16,29,23,12,5,7,11
S01010449,Good health,186,5,0,5,32,26,7,10,39,40,16,9,7,11
S01010449,Fair health,103,1,0,1,12,13,4,9,22,29,9,9,0,4
S01010449,Bad health,63,0,0,0,5,7,1,13,12,17,8,7,1,0
S01010449,Very bad health,23,0,0,0,0,3,0,1,6,7,6,6,0,0
S01010450,All people aged 16 to 74,605,21,3,18,112,82,26,67,109,98,47,30,17,43
S01010450,Very good health,233,9,2,7,51,25,10,27,42,25,14,8,6,30
S01010450,Good health,189,9,1,8,43,32,5,23,26,30,9,5,4,12
S01010450,Fair health,117,3,0,3,13,16,8,12,29,21,15,10,5,0
S01010450,Bad health,52,0,0,0,4,6,3,3,10,18,8,6,2,0
S01010450,Very bad health,14,0,0,0,1,3,0,2,2,4,1,1,0,1
S01010451,All people aged 16 to 74,600,32,4,28,75,62,38,44,111,99,92,56,36,47
S01010451,Very good health,236,19,3,16,42,25,13,13,34,21,37,16,21,32
S01010451,Good health,176,11,1,10,20,17,12,18,31,27,29,19,10,11
S01010451,Fair health,114,1,0,1,10,12,9,5,33,26,16,11,5,2
S01010451,Bad health,60,0,0,0,3,6,4,6,10,22,7,7,0,2
S01010451,Very bad health,14,1,0,1,0,2,0,2,3,3,3,3,0,0
S01010452,All people aged 16 to 74,569,26,3,23,105,102,23,56,103,89,28,20,8,37
S01010452,Very good health,244,18,1,17,51,40,9,29,36,27,5,4,1,29
S01010452,Good health,175,3,0,3,41,37,8,17,33,23,7,3,4,6
S01010452,Fair health,88,3,1,2,9,17,4,4,14,25,11,8,3,1
S01010452,Bad health,54,2,1,1,4,8,2,6,17,10,4,4,0,1
S01010452,Very bad health,8,0,0,0,0,0,0,0,3,4,1,1,0,0
S01010453,All people aged 16 to 74,513,24,2,22,60,62,31,49,59,83,109,70,39,36
S01010453,Very good health,201,13,0,13,41,24,12,21,21,23,26,13,13,20
S01010453,Good health,178,8,2,6,12,24,12,12,24,34,40,25,15,12
S01010453,Fair health,67,2,0,2,2,8,5,11,8,9,19,12,7,3
S01010453,Bad health,50,1,0,1,5,5,1,4,6,10,17,13,4,1
S01010453,Very bad health,17,0,0,0,0,1,1,1,0,7,7,7,0,0
S01010454,All people aged 16 to 74,572,23,5,18,87,98,27,58,110,97,38,28,10,34
S01010454,Very good health,207,14,4,10,42,39,5,19,35,25,10,6,4,18
S01010454,Good health,198,6,1,5,27,34,15,22,40,33,11,8,3,10
S01010454,Fair health,104,2,0,2,15,21,4,8,20,18,13,11,2,3
S01010454,Bad health,46,0,0,0,3,2,3,7,10,16,3,2,1,2
S01010454,Very bad health,17,1,0,1,0,2,0,2,5,5,1,1,0,1
S01010455,All people aged 16 to 74,697,23,1,22,81,96,43,49,135,143,84,55,29,43
S01010455,Very good health,211,10,1,9,23,39,17,10,41,17,27,19,8,27
S01010455,Good health,235,8,0,8,34,29,11,13,42,51,33,17,16,14
S01010455,Fair health,142,3,0,3,15,19,8,19,30,32,14,11,3,2
S01010455,Bad health,72,0,0,0,5,7,6,4,16,26,8,6,2,0
S01010455,Very bad health,37,2,0,2,4,2,1,3,6,17,2,2,0,0
S01010456,All people aged 16 to 74,386,19,2,17,71,63,21,39,72,53,24,15,9,24
S01010456,Very good health,168,17,2,15,34,27,9,19,28,9,9,4,5,16
S01010456,Good health,116,2,0,2,23,19,10,14,19,14,8,4,4,7
S01010456,Fair health,54,0,0,0,5,10,1,3,15,14,5,5,0,1
S01010456,Bad health,31,0,0,0,4,5,0,2,7,12,1,1,0,0
S01010456,Very bad health,17,0,0,0,5,2,1,1,3,4,1,1,0,0
S01010457,All people aged 16 to 74,466,27,4,23,70,52,34,30,82,81,60,40,20,30
S01010457,Very good health,198,17,1,16,34,26,17,11,34,26,12,5,7,21
S01010457,Good health,142,7,2,5,29,14,5,14,32,17,21,10,11,3
S01010457,Fair health,76,3,1,2,4,7,6,2,9,23,18,16,2,4
S01010457,Bad health,40,0,0,0,3,5,6,3,4,10,7,7,0,2
S01010457,Very bad health,10,0,0,0,0,0,0,0,3,5,2,2,0,0
S01010458,All people aged 16 to 74,557,11,2,9,80,94,25,43,119,87,49,35,14,49
S01010458,Very good health,207,5,1,4,37,36,6,15,43,21,11,7,4,33
S01010458,Good health,192,3,0,3,30,40,12,12,35,31,17,9,8,12
S01010458,Fair health,87,2,1,1,7,8,3,9,20,23,12,10,2,3
S01010458,Bad health,58,1,0,1,4,10,4,5,17,11,5,5,0,1
S01010458,Very bad health,13,0,0,0,2,0,0,2,4,1,4,4,0,0
S01010459,All people aged 16 to 74,409,24,4,20,66,62,22,23,74,58,37,31,6,43
S01010459,Very good health,175,16,3,13,32,28,11,9,23,13,8,5,3,35
S01010459,Good health,119,4,0,4,20,19,8,7,24,18,12,11,1,7
S01010459,Fair health,70,2,0,2,8,10,3,5,18,12,12,10,2,0
S01010459,Bad health,33,1,1,0,5,4,0,2,5,11,4,4,0,1
S01010459,Very bad health,12,1,0,1,1,1,0,0,4,4,1,1,0,0
S01010460,All people aged 16 to 74,532,130,16,114,157,52,47,24,36,25,18,13,5,43
S01010460,Very good health,329,93,12,81,104,25,21,14,16,11,9,6,3,36
S01010460,Good health,142,27,1,26,45,22,17,5,11,5,3,2,1,7
S01010460,Fair health,41,7,2,5,4,2,7,4,5,7,5,5,0,0
S01010460,Bad health,14,2,0,2,3,2,1,1,3,1,1,0,1,0
S01010460,Very bad health,6,1,1,0,1,1,1,0,1,1,0,0,0,0
S01010461,All people aged 16 to 74,519,25,3,22,95,70,17,32,102,81,59,41,18,38
S01010461,Very good health,197,16,1,15,49,25,5,14,33,12,14,9,5,29
S01010461,Good health,154,4,2,2,25,21,7,7,33,28,21,11,10,8
S01010461,Fair health,100,2,0,2,12,15,1,7,24,22,16,13,3,1
S01010461,Bad health,55,3,0,3,8,5,3,3,9,18,6,6,0,0
S01010461,Very bad health,13,0,0,0,1,4,1,1,3,1,2,2,0,0
S01010462,All people aged 16 to 74,614,5,1,4,31,29,19,30,97,103,212,145,67,88
S01010462,Very good health,180,3,1,2,8,13,3,6,32,26,55,35,20,34
S01010462,Good health,246,2,0,2,18,7,14,7,35,40,78,53,25,45
S01010462,Fair health,101,0,0,0,2,2,0,9,17,22,43,26,17,6
S01010462,Bad health,67,0,0,0,3,5,1,7,9,13,27,23,4,2
S01010462,Very bad health,20,0,0,0,0,2,1,1,4,2,9,8,1,1
S01010463,All people aged 16 to 74,567,55,9,46,131,74,47,26,96,50,38,21,17,50
S01010463,Very good health,282,33,5,28,69,35,21,11,47,16,9,4,5,41
S01010463,Good health,175,19,3,16,39,23,18,8,27,22,14,7,7,5
S01010463,Fair health,74,3,1,2,17,8,7,5,11,9,11,7,4,3
S01010463,Bad health,27,0,0,0,4,6,0,2,7,3,4,3,1,1
S01010463,Very bad health,9,0,0,0,2,2,1,0,4,0,0,0,0,0
S01010464,All people aged 16 to 74,369,22,4,18,76,64,30,35,48,46,25,15,10,23
S01010464,Very good health,178,11,1,10,45,26,11,15,22,16,10,8,2,22
S01010464,Good health,116,9,3,6,23,25,11,16,14,10,7,2,5,1
S01010464,Fair health,48,2,0,2,5,8,4,2,8,13,6,3,3,0
S01010464,Bad health,18,0,0,0,3,4,1,0,2,7,1,1,0,0
S01010464,Very bad health,9,0,0,0,0,1,3,2,2,0,1,1,0,0
S01010465,All people aged 16 to 74,769,94,8,86,241,125,29,49,84,58,21,11,10,68
S01010465,Very good health,447,72,6,66,152,65,16,25,39,17,8,6,2,53
S01010465,Good health,213,18,2,16,62,41,8,13,29,23,5,1,4,14
S01010465,Fair health,73,4,0,4,19,15,4,6,7,10,7,4,3,1
S01010465,Bad health,25,0,0,0,4,4,1,4,6,5,1,0,1,0
S01010465,Very bad health,11,0,0,0,4,0,0,1,3,3,0,0,0,0
S01010466,All people aged 16 to 74,753,126,21,105,213,94,37,37,60,36,26,13,13,124
S01010466,Very good health,475,86,11,75,138,60,23,20,30,14,11,5,6,93
S01010466,Good health,197,29,9,20,60,27,5,10,17,10,10,7,3,29
S01010466,Fair health,55,6,1,5,11,5,5,3,9,10,4,0,4,2
S01010466,Bad health,20,2,0,2,3,1,4,3,4,2,1,1,0,0
S01010466,Very bad health,6,3,0,3,1,1,0,1,0,0,0,0,0,0
S01010467,All people aged 16 to 74,596,105,18,87,188,83,38,26,53,20,25,17,8,58
S01010467,Very good health,310,65,8,57,100,32,15,7,26,6,11,6,5,48
S01010467,Good health,193,29,6,23,63,33,17,8,19,8,7,6,1,9
S01010467,Fair health,66,5,1,4,19,13,4,10,5,4,5,4,1,1
S01010467,Bad health,20,3,2,1,5,3,2,1,3,1,2,1,1,0
S01010467,Very bad health,7,3,1,2,1,2,0,0,0,1,0,0,0,0
S01010468,All people aged 16 to 74,726,127,11,116,193,89,47,21,67,38,27,21,6,117
S01010468,Very good health,437,85,7,78,126,48,22,9,34,17,12,9,3,84
S01010468,Good health,204,33,1,32,52,29,16,4,20,13,10,7,3,27
S01010468,Fair health,57,6,3,3,8,8,6,5,12,5,3,3,0,4
S01010468,Bad health,21,3,0,3,5,3,2,2,0,3,1,1,0,2
S01010468,Very bad health,7,0,0,0,2,1,1,1,1,0,1,1,0,0
S01010469,All people aged 16 to 74,473,50,4,46,123,72,19,34,51,34,37,19,18,53
S01010469,Very good health,217,31,1,30,65,26,8,16,21,5,14,9,5,31
S01010469,Good health,151,16,3,13,44,24,7,9,15,6,13,4,9,17
S01010469,Fair health,68,2,0,2,12,14,2,5,10,13,5,2,3,5
S01010469,Bad health,28,1,0,1,2,6,1,3,4,8,3,2,1,0
S01010469,Very bad health,9,0,0,0,0,2,1,1,1,2,2,2,0,0
S01010470,All people aged 16 to 74,536,28,5,23,113,95,40,44,77,74,35,27,8,30
S01010470,Very good health,238,22,3,19,66,47,18,20,16,20,9,6,3,20
S01010470,Good health,166,3,1,2,32,35,11,12,34,25,5,3,2,9
S01010470,Fair health,77,2,0,2,11,7,6,4,13,22,12,9,3,0
S01010470,Bad health,48,1,1,0,4,5,2,6,13,7,9,9,0,1
S01010470,Very bad health,7,0,0,0,0,1,3,2,1,0,0,0,0,0
S01010471,All people aged 16 to 74,472,26,2,24,76,65,16,45,74,82,47,36,11,41
S01010471,Very good health,217,22,2,20,42,29,6,15,38,23,15,11,4,27
S01010471,Good health,134,3,0,3,22,25,5,14,17,26,8,5,3,14
S01010471,Fair health,61,1,0,1,8,5,4,11,10,14,8,6,2,0
S01010471,Bad health,43,0,0,0,4,3,1,3,4,15,13,11,2,0
S01010471,Very bad health,17,0,0,0,0,3,0,2,5,4,3,3,0,0
S01010472,All people aged 16 to 74,449,86,8,78,121,46,19,23,40,30,25,13,12,59
S01010472,Very good health,257,61,5,56,73,29,7,9,21,6,8,3,5,43
S01010472,Good health,133,21,3,18,39,10,7,11,10,9,11,7,4,15
S01010472,Fair health,35,3,0,3,5,4,2,2,4,9,5,2,3,1
S01010472,Bad health,20,1,0,1,3,3,2,1,4,5,1,1,0,0
S01010472,Very bad health,4,0,0,0,1,0,1,0,1,1,0,0,0,0
S01010473,All people aged 16 to 74,630,60,6,54,163,95,24,35,87,67,36,21,15,63
S01010473,Very good health,346,36,3,33,110,48,13,15,46,21,15,7,8,42
S01010473,Good health,182,21,3,18,36,32,7,12,21,27,10,6,4,16
S01010473,Fair health,66,3,0,3,13,13,0,5,10,10,8,5,3,4
S01010473,Bad health,26,0,0,0,2,2,1,3,7,8,2,2,0,1
S01010473,Very bad health,10,0,0,0,2,0,3,0,3,1,1,1,0,0
S01010474,All people aged 16 to 74,672,73,5,68,144,77,24,35,78,69,53,35,18,119
S01010474,Very good health,386,45,2,43,92,35,11,19,38,29,23,15,8,94
S01010474,Good health,193,23,3,20,41,31,11,4,24,17,17,12,5,25
S01010474,Fair health,67,4,0,4,8,8,1,7,15,14,10,6,4,0
S01010474,Bad health,22,1,0,1,2,3,0,4,1,8,3,2,1,0
S01010474,Very bad health,4,0,0,0,1,0,1,1,0,1,0,0,0,0
S01010475,All people aged 16 to 74,560,101,12,89,188,92,22,30,36,24,10,6,4,57
S01010475,Very good health,357,76,8,68,132,49,8,17,16,13,6,4,2,40
S01010475,Good health,160,21,2,19,47,35,8,10,12,9,2,1,1,16
S01010475,Fair health,27,1,0,1,6,7,3,3,5,1,0,0,0,1
S01010475,Bad health,12,2,1,1,2,1,1,0,3,1,2,1,1,0
S01010475,Very bad health,4,1,1,0,1,0,2,0,0,0,0,0,0,0
S01010476,All people aged 16 to 74,747,87,8,79,165,118,40,48,82,69,39,24,15,99
S01010476,Very good health,398,64,6,58,99,51,18,20,36,27,13,7,6,70
S01010476,Good health,221,17,1,16,51,40,16,21,25,15,11,6,5,25
S01010476,Fair health,82,6,1,5,13,20,3,3,14,11,10,6,4,2
S01010476,Bad health,33,0,0,0,2,7,3,4,7,6,3,3,0,1
S01010476,Very bad health,13,0,0,0,0,0,0,0,0,10,2,2,0,1
S01010477,All people aged 16 to 74,559,23,3,20,104,93,23,56,108,87,24,19,5,41
S01010477,Very good health,248,15,2,13,59,39,14,24,35,17,15,10,5,30
S01010477,Good health,170,5,0,5,33,28,9,17,38,31,0,0,0,9
S01010477,Fair health,78,3,1,2,9,11,0,7,24,17,5,5,0,2
S01010477,Bad health,45,0,0,0,2,12,0,4,7,19,1,1,0,0
S01010477,Very bad health,18,0,0,0,1,3,0,4,4,3,3,3,0,0
S01010478,All people aged 16 to 74,776,21,2,19,126,108,46,61,155,143,65,44,21,51
S01010478,Very good health,269,10,0,10,60,44,13,19,42,44,12,7,5,25
S01010478,Good health,259,6,0,6,35,32,16,16,60,44,26,14,12,24
S01010478,Fair health,124,3,2,1,14,16,8,12,32,23,15,12,3,1
S01010478,Bad health,94,1,0,1,12,14,6,11,17,24,9,8,1,0
S01010478,Very bad health,30,1,0,1,5,2,3,3,4,8,3,3,0,1
S01010479,All people aged 16 to 74,735,34,6,28,128,106,31,69,143,113,47,30,17,64
S01010479,Very good health,309,19,4,15,59,50,9,30,53,28,9,4,5,52
S01010479,Good health,237,9,0,9,46,38,14,27,42,37,15,9,6,9
S01010479,Fair health,123,4,2,2,17,15,5,8,31,27,13,8,5,3
S01010479,Bad health,49,1,0,1,5,1,2,4,14,15,7,6,1,0
S01010479,Very bad health,17,1,0,1,1,2,1,0,3,6,3,3,0,0
S01010480,All people aged 16 to 74,417,31,10,21,81,68,28,32,75,52,27,22,5,23
S01010480,Very good health,164,15,6,9,37,27,6,13,27,13,9,7,2,17
S01010480,Good health,133,14,4,10,28,26,12,11,15,20,2,1,1,5
S01010480,Fair health,62,1,0,1,10,12,5,0,14,8,11,10,1,1
S01010480,Bad health,34,0,0,0,3,3,2,3,11,9,3,3,0,0
S01010480,Very bad health,24,1,0,1,3,0,3,5,8,2,2,1,1,0
S01010481,All people aged 16 to 74,459,6,2,4,47,46,21,41,102,86,70,47,23,40
S01010481,Very good health,204,3,1,2,27,19,9,18,48,25,24,16,8,31
S01010481,Good health,126,2,1,1,9,8,8,16,28,23,23,14,9,9
S01010481,Fair health,71,0,0,0,6,11,3,3,16,23,9,6,3,0
S01010481,Bad health,46,1,0,1,5,6,1,2,7,14,10,9,1,0
S01010481,Very bad health,12,0,0,0,0,2,0,2,3,1,4,2,2,0
S01010482,All people aged 16 to 74,547,28,9,19,96,78,35,41,92,90,44,31,13,43
S01010482,Very good health,246,17,5,12,55,35,16,17,33,25,14,10,4,34
S01010482,Good health,159,10,3,7,22,26,9,11,37,23,15,8,7,6
S01010482,Fair health,86,1,1,0,14,11,10,7,12,24,5,4,1,2
S01010482,Bad health,46,0,0,0,5,4,0,4,9,15,8,7,1,1
S01010482,Very bad health,10,0,0,0,0,2,0,2,1,3,2,2,0,0
S01010483,All people aged 16 to 74,758,46,10,36,148,103,44,57,140,131,49,32,17,40
S01010483,Very good health,273,23,7,16,64,39,19,15,39,30,18,9,9,26
S01010483,Good health,253,17,2,15,54,39,14,19,48,40,12,8,4,10
S01010483,Fair health,150,6,1,5,18,11,10,13,38,39,12,8,4,3
S01010483,Bad health,57,0,0,0,10,9,1,8,9,13,6,6,0,1
S01010483,Very bad health,25,0,0,0,2,5,0,2,6,9,1,1,0,0
S01010484,All people aged 16 to 74,428,21,3,18,60,71,22,41,77,73,35,24,11,28
S01010484,Very good health,176,12,1,11,33,25,10,18,29,19,10,7,3,20
S01010484,Good health,137,8,2,6,22,26,8,13,27,18,8,4,4,7
S01010484,Fair health,73,0,0,0,4,8,1,8,13,23,15,11,4,1
S01010484,Bad health,36,1,0,1,1,9,3,2,8,10,2,2,0,0
S01010484,Very bad health,6,0,0,0,0,3,0,0,0,3,0,0,0,0
S01010485,All people aged 16 to 74,684,37,11,26,154,113,38,61,95,77,52,31,21,57
S01010485,Very good health,344,22,6,16,79,56,23,26,41,36,17,7,10,44
S01010485,Good health,211,12,4,8,57,37,7,18,28,22,19,10,9,11
S01010485,Fair health,87,2,1,1,11,16,7,9,17,10,13,11,2,2
S01010485,Bad health,33,1,0,1,5,4,1,6,6,8,2,2,0,0
S01010485,Very bad health,9,0,0,0,2,0,0,2,3,1,1,1,0,0
S01010486,All people aged 16 to 74,709,53,14,39,180,134,63,61,84,58,23,17,6,53
S01010486,Very good health,398,32,8,24,103,73,26,32,44,33,11,6,5,44
S01010486,Good health,224,18,5,13,58,47,26,20,27,13,6,5,1,9
S01010486,Fair health,55,1,0,1,14,8,10,4,9,7,2,2,0,0
S01010486,Bad health,21,2,1,1,2,6,0,2,2,3,4,4,0,0
S01010486,Very bad health,11,0,0,0,3,0,1,3,2,2,0,0,0,0
S01010487,All people aged 16 to 74,683,36,8,28,119,116,34,71,126,101,36,20,16,44
S01010487,Very good health,303,21,4,17,60,55,20,28,41,29,15,8,7,34
S01010487,Good health,259,15,4,11,46,45,9,25,53,48,9,3,6,9
S01010487,Fair health,72,0,0,0,9,12,4,11,15,13,7,4,3,1
S01010487,Bad health,41,0,0,0,3,4,1,6,14,9,4,4,0,0
S01010487,Very bad health,8,0,0,0,1,0,0,1,3,2,1,1,0,0
S01010488,All people aged 16 to 74,559,15,3,12,40,62,17,45,142,109,88,62,26,41
S01010488,Very good health,204,9,1,8,14,33,4,16,52,29,21,13,8,26
S01010488,Good health,183,5,2,3,16,16,3,17,57,28,29,14,15,12
S01010488,Fair health,88,0,0,0,4,3,4,6,23,32,14,11,3,2
S01010488,Bad health,64,1,0,1,1,7,5,6,9,15,19,19,0,1
S01010488,Very bad health,20,0,0,0,5,3,1,0,1,5,5,5,0,0
S01010489,All people aged 16 to 74,719,24,6,18,83,91,26,68,153,132,83,55,28,59
S01010489,Very good health,262,9,3,6,38,38,6,21,50,33,29,19,10,38
S01010489,Good health,236,7,1,6,26,29,8,25,58,38,30,16,14,15
S01010489,Fair health,147,5,1,4,9,17,7,18,29,42,16,12,4,4
S01010489,Bad health,55,1,1,0,9,7,4,3,10,14,5,5,0,2
S01010489,Very bad health,19,2,0,2,1,0,1,1,6,5,3,3,0,0
S01010490,All people aged 16 to 74,508,12,1,11,37,61,17,43,111,91,85,50,35,51
S01010490,Very good health,204,4,1,3,17,32,3,23,41,22,28,13,15,34
S01010490,Good health,169,8,0,8,13,15,8,11,38,37,25,10,15,14
S01010490,Fair health,67,0,0,0,4,10,3,5,18,11,13,9,4,3
S01010490,Bad health,46,0,0,0,3,3,1,3,11,13,12,11,1,0
S01010490,Very bad health,22,0,0,0,0,1,2,1,3,8,7,7,0,0
S01010491,All people aged 16 to 74,610,8,5,3,41,63,24,28,168,111,120,72,48,47
S01010491,Very good health,226,3,2,1,22,29,12,11,55,36,27,15,12,31
S01010491,Good health,195,5,3,2,7,15,8,9,63,33,41,21,20,14
S01010491,Fair health,109,0,0,0,4,10,3,5,29,22,34,18,16,2
S01010491,Bad health,56,0,0,0,7,8,0,3,13,17,8,8,0,0
S01010491,Very bad health,24,0,0,0,1,1,1,0,8,3,10,10,0,0
S01010492,All people aged 16 to 74,395,6,3,3,26,35,14,27,90,96,68,51,17,33
S01010492,Very good health,137,1,0,1,12,13,6,13,23,24,23,17,6,22
S01010492,Good health,121,2,1,1,10,10,4,5,34,27,22,15,7,7
S01010492,Fair health,68,3,2,1,2,4,2,6,12,26,10,7,3,3
S01010492,Bad health,49,0,0,0,2,6,2,2,12,14,10,9,1,1
S01010492,Very bad health,20,0,0,0,0,2,0,1,9,5,3,3,0,0
S01010493,All people aged 16 to 74,473,6,1,5,17,49,19,31,110,102,102,65,37,37
S01010493,Very good health,156,2,1,1,5,17,11,6,33,29,31,15,16,22
S01010493,Good health,157,3,0,3,6,16,5,9,40,32,34,21,13,12
S01010493,Fair health,101,1,0,1,4,13,2,8,28,23,19,12,7,3
S01010493,Bad health,40,0,0,0,2,2,1,4,7,10,14,13,1,0
S01010493,Very bad health,19,0,0,0,0,1,0,4,2,8,4,4,0,0
S01010494,All people aged 16 to 74,464,12,3,9,56,49,23,47,96,84,67,46,21,30
S01010494,Very good health,197,8,1,7,25,24,8,25,30,31,24,16,8,22
S01010494,Good health,153,4,2,2,21,17,12,11,39,26,16,6,10,7
S01010494,Fair health,64,0,0,0,9,4,2,5,15,12,16,13,3,1
S01010494,Bad health,39,0,0,0,1,4,1,6,8,10,9,9,0,0
S01010494,Very bad health,11,0,0,0,0,0,0,0,4,5,2,2,0,0
S01010495,All people aged 16 to 74,626,9,4,5,48,60,16,53,133,142,117,78,39,48
S01010495,Very good health,228,5,2,3,16,29,9,19,47,40,32,17,15,31
S01010495,Good health,173,2,1,1,17,15,4,13,39,42,29,16,13,12
S01010495,Fair health,137,0,0,0,7,10,1,16,33,40,26,17,9,4
S01010495,Bad health,65,0,0,0,6,6,1,4,10,16,21,19,2,1
S01010495,Very bad health,23,2,1,1,2,0,1,1,4,4,9,9,0,0
S01010496,All people aged 16 to 74,598,6,0,6,50,67,14,44,104,152,121,100,21,40
S01010496,Very good health,205,3,0,3,19,32,5,22,35,38,23,17,6,28
S01010496,Good health,201,3,0,3,19,26,6,16,34,48,41,33,8,8
S01010496,Fair health,111,0,0,0,7,6,3,3,23,37,31,25,6,1
S01010496,Bad health,56,0,0,0,2,3,0,2,9,20,17,16,1,3
S01010496,Very bad health,25,0,0,0,3,0,0,1,3,9,9,9,0,0
S01010497,All people aged 16 to 74,547,8,3,5,60,55,29,36,116,100,95,74,21,48
S01010497,Very good health,215,1,0,1,27,28,14,15,46,33,21,17,4,30
S01010497,Good health,176,3,2,1,27,15,7,12,32,30,34,25,9,16
S01010497,Fair health,83,2,1,1,3,8,5,6,17,16,24,17,7,2
S01010497,Bad health,61,1,0,1,3,2,2,2,19,19,13,12,1,0
S01010497,Very bad health,12,1,0,1,0,2,1,1,2,2,3,3,0,0
S01010498,All people aged 16 to 74,624,10,1,9,35,66,16,43,131,165,110,76,34,48
S01010498,Very good health,219,5,1,4,22,38,3,14,35,36,32,23,9,34
S01010498,Good health,193,2,0,2,9,18,7,12,54,45,34,17,17,12
S01010498,Fair health,111,2,0,2,1,5,4,9,28,43,19,12,7,0
S01010498,Bad health,70,1,0,1,0,5,1,6,8,31,16,15,1,2
S01010498,Very bad health,31,0,0,0,3,0,1,2,6,10,9,9,0,0
S01010499,All people aged 16 to 74,586,5,1,4,27,40,16,34,126,125,158,113,45,55
S01010499,Very good health,183,2,0,2,11,11,2,13,36,34,42,29,13,32
S01010499,Good health,184,1,0,1,11,13,5,6,41,31,56,38,18,20
S01010499,Fair health,119,2,1,1,4,12,5,9,28,23,33,21,12,3
S01010499,Bad health,72,0,0,0,0,2,1,4,17,24,24,22,2,0
S01010499,Very bad health,28,0,0,0,1,2,3,2,4,13,3,3,0,0
S01010500,All people aged 16 to 74,732,24,6,18,69,68,24,42,152,153,136,93,43,64
S01010500,Very good health,283,16,3,13,35,34,12,11,62,44,31,15,16,38
S01010500,Good health,235,6,3,3,25,19,8,18,54,40,46,28,18,19
S01010500,Fair health,113,0,0,0,7,11,1,6,20,26,36,29,7,6
S01010500,Bad health,77,2,0,2,1,2,2,6,11,35,17,16,1,1
S01010500,Very bad health,24,0,0,0,1,2,1,1,5,8,6,5,1,0
S01010501,All people aged 16 to 74,673,12,2,10,84,82,29,61,149,145,76,53,23,35
S01010501,Very good health,263,7,2,5,45,38,11,21,54,39,23,18,5,25
S01010501,Good health,202,4,0,4,20,26,8,19,52,43,23,12,11,7
S01010501,Fair health,111,0,0,0,10,9,9,8,27,29,17,12,5,2
S01010501,Bad health,70,0,0,0,7,7,1,9,14,22,9,7,2,1
S01010501,Very bad health,27,1,0,1,2,2,0,4,2,12,4,4,0,0
S01010502,All people aged 16 to 74,599,11,1,10,75,84,34,56,125,112,58,45,13,44
S01010502,Very good health,260,5,1,4,39,50,15,21,56,37,12,7,5,25
S01010502,Good health,198,4,0,4,28,24,14,23,37,30,22,16,6,16
S01010502,Fair health,80,0,0,0,6,7,1,7,22,22,14,12,2,1
S01010502,Bad health,45,2,0,2,1,3,3,4,8,18,6,6,0,0
S01010502,Very bad health,16,0,0,0,1,0,1,1,2,5,4,4,0,2
S01010503,All people aged 16 to 74,503,3,0,3,42,49,16,35,125,128,73,58,15,32
S01010503,Very good health,182,1,0,1,15,21,4,9,55,38,17,13,4,22
S01010503,Good health,151,1,0,1,17,15,8,10,37,37,20,15,5,6
S01010503,Fair health,93,1,0,1,8,9,1,10,21,24,15,13,2,4
S01010503,Bad health,51,0,0,0,1,4,3,3,5,20,15,11,4,0
S01010503,Very bad health,26,0,0,0,1,0,0,3,7,9,6,6,0,0
S01010504,All people aged 16 to 74,389,32,1,31,81,35,124,14,49,34,9,7,2,11
S01010504,Very good health,195,14,0,14,43,19,65,5,21,17,2,1,1,9
S01010504,Good health,141,15,1,14,29,11,47,3,21,11,2,2,0,2
S01010504,Fair health,38,2,0,2,7,5,8,4,4,5,3,2,1,0
S01010504,Bad health,14,1,0,1,2,0,4,2,3,1,1,1,0,0
S01010504,Very bad health,1,0,0,0,0,0,0,0,0,0,1,1,0,0
S01010505,All people aged 16 to 74,423,33,2,31,86,19,114,25,77,39,13,9,4,17
S01010505,Very good health,222,15,1,14,44,11,62,14,41,19,2,1,1,14
S01010505,Good health,137,14,1,13,30,6,35,8,24,11,6,4,2,3
S01010505,Fair health,50,3,0,3,11,2,13,1,7,9,4,3,1,0
S01010505,Bad health,12,1,0,1,1,0,4,0,5,0,1,1,0,0
S01010505,Very bad health,2,0,0,0,0,0,0,2,0,0,0,0,0,0
S01010506,All people aged 16 to 74,629,37,8,29,166,46,136,50,88,68,14,7,7,24
S01010506,Very good health,345,20,4,16,97,22,71,28,43,34,8,4,4,22
S01010506,Good health,203,16,4,12,47,18,48,16,29,23,5,2,3,1
S01010506,Fair health,63,1,0,1,16,3,13,6,16,7,0,0,0,1
S01010506,Bad health,16,0,0,0,6,3,3,0,0,3,1,1,0,0
S01010506,Very bad health,2,0,0,0,0,0,1,0,0,1,0,0,0,0
S01010507,All people aged 16 to 74,588,21,8,13,105,44,85,64,129,83,27,17,10,30
S01010507,Very good health,329,13,4,9,57,27,49,34,66,44,15,10,5,24
S01010507,Good health,175,5,3,2,37,11,27,18,42,24,7,4,3,4
S01010507,Fair health,56,1,0,1,9,6,5,8,13,11,2,1,1,1
S01010507,Bad health,17,0,0,0,0,0,3,3,7,2,1,0,1,1
S01010507,Very bad health,11,2,1,1,2,0,1,1,1,2,2,2,0,0
S01010508,All people aged 16 to 74,736,52,12,40,168,63,122,64,129,85,16,11,5,37
S01010508,Very good health,348,24,7,17,83,40,46,27,59,38,4,1,3,27
S01010508,Good health,263,16,3,13,58,18,55,23,49,30,6,4,2,8
S01010508,Fair health,88,7,1,6,16,2,17,10,14,15,5,5,0,2
S01010508,Bad health,30,5,1,4,7,2,4,4,6,1,1,1,0,0
S01010508,Very bad health,7,0,0,0,4,1,0,0,1,1,0,0,0,0
S01010509,All people aged 16 to 74,735,53,8,45,190,61,118,75,126,69,12,6,6,31
S01010509,Very good health,433,34,6,28,113,29,76,43,77,26,7,3,4,28
S01010509,Good health,201,13,2,11,58,24,26,21,29,24,3,2,1,3
S01010509,Fair health,74,5,0,5,15,6,12,7,14,14,1,0,1,0
S01010509,Bad health,23,1,0,1,4,0,4,3,6,4,1,1,0,0
S01010509,Very bad health,4,0,0,0,0,2,0,1,0,1,0,0,0,0
S01010510,All people aged 16 to 74,571,29,5,24,124,74,51,59,125,71,18,11,7,20
S01010510,Very good health,293,21,2,19,70,41,31,25,60,25,4,2,2,16
S01010510,Good health,174,7,3,4,38,22,17,20,40,22,5,2,3,3
S01010510,Fair health,73,1,0,1,13,9,2,8,19,14,6,5,1,1
S01010510,Bad health,25,0,0,0,2,1,1,6,4,9,2,2,0,0
S01010510,Very bad health,6,0,0,0,1,1,0,0,2,1,1,0,1,0
S01010511,All people aged 16 to 74,620,18,4,14,85,46,36,89,165,128,18,7,11,35
S01010511,Very good health,298,8,0,8,48,30,14,37,67,57,11,4,7,26
S01010511,Good health,204,8,3,5,23,13,15,26,59,49,5,2,3,6
S01010511,Fair health,80,2,1,1,9,1,6,15,29,15,1,0,1,2
S01010511,Bad health,33,0,0,0,4,1,1,10,9,6,1,1,0,1
S01010511,Very bad health,5,0,0,0,1,1,0,1,1,1,0,0,0,0
S01010512,All people aged 16 to 74,420,15,2,13,90,44,37,51,92,70,10,5,5,11
S01010512,Very good health,214,10,1,9,53,20,21,24,48,31,0,0,0,7
S01010512,Good health,133,4,1,3,25,15,10,19,32,21,4,1,3,3
S01010512,Fair health,52,1,0,1,9,8,5,5,8,13,2,1,1,1
S01010512,Bad health,14,0,0,0,2,1,0,3,1,4,3,2,1,0
S01010512,Very bad health,7,0,0,0,1,0,1,0,3,1,1,1,0,0
S01010513,All people aged 16 to 74,576,55,18,37,138,69,70,69,86,53,10,6,4,26
S01010513,Very good health,329,35,11,24,96,40,33,35,45,22,4,2,2,19
S01010513,Good health,180,13,4,9,35,22,26,27,30,20,2,2,0,5
S01010513,Fair health,48,6,3,3,4,5,10,3,7,9,2,0,2,2
S01010513,Bad health,12,0,0,0,0,2,1,2,3,2,2,2,0,0
S01010513,Very bad health,7,1,0,1,3,0,0,2,1,0,0,0,0,0
S01010514,All people aged 16 to 74,504,12,5,7,71,56,40,64,115,107,14,8,6,25
S01010514,Very good health,231,7,2,5,33,24,21,29,53,46,2,1,1,16
S01010514,Good health,188,5,3,2,26,23,10,28,43,39,7,4,3,7
S01010514,Fair health,53,0,0,0,10,5,5,5,11,12,4,3,1,1
S01010514,Bad health,26,0,0,0,2,4,3,2,7,6,1,0,1,1
S01010514,Very bad health,6,0,0,0,0,0,1,0,1,4,0,0,0,0
S01010515,All people aged 16 to 74,600,12,3,9,86,48,28,99,141,146,18,9,9,22
S01010515,Very good health,303,5,1,4,51,28,16,50,59,67,9,6,3,18
S01010515,Good health,194,3,0,3,18,15,8,28,58,54,6,1,5,4
S01010515,Fair health,70,4,2,2,15,5,2,12,16,13,3,2,1,0
S01010515,Bad health,24,0,0,0,2,0,2,6,7,7,0,0,0,0
S01010515,Very bad health,9,0,0,0,0,0,0,3,1,5,0,0,0,0
S01010516,All people aged 16 to 74,477,38,7,31,117,40,98,42,62,53,12,3,9,15
S01010516,Very good health,247,22,3,19,66,24,56,17,26,25,1,0,1,10
S01010516,Good health,155,9,3,6,42,13,30,10,22,15,9,3,6,5
S01010516,Fair health,52,3,1,2,7,1,9,11,9,10,2,0,2,0
S01010516,Bad health,17,2,0,2,2,2,1,4,4,2,0,0,0,0
S01010516,Very bad health,6,2,0,2,0,0,2,0,1,1,0,0,0,0
S01010517,All people aged 16 to 74,642,31,9,22,152,53,54,73,124,83,34,12,22,38
S01010517,Very good health,341,25,6,19,91,20,23,34,73,39,9,1,8,27
S01010517,Good health,213,5,3,2,46,26,17,25,37,28,19,8,11,10
S01010517,Fair health,58,1,0,1,7,4,7,9,11,14,4,1,3,1
S01010517,Bad health,21,0,0,0,6,3,7,2,1,1,1,1,0,0
S01010517,Very bad health,9,0,0,0,2,0,0,3,2,1,1,1,0,0
S01010518,All people aged 16 to 74,510,26,9,17,109,57,38,61,97,76,13,5,8,33
S01010518,Very good health,252,13,6,7,69,30,11,27,41,34,3,1,2,24
S01010518,Good health,181,9,3,6,31,16,21,28,37,28,4,1,3,7
S01010518,Fair health,64,2,0,2,7,11,6,3,16,13,4,1,3,2
S01010518,Bad health,11,2,0,2,2,0,0,2,2,1,2,2,0,0
S01010518,Very bad health,2,0,0,0,0,0,0,1,1,0,0,0,0,0
S01010519,All people aged 16 to 74,542,22,5,17,113,62,32,60,119,85,22,10,12,27
S01010519,Very good health,255,13,4,9,47,31,10,31,55,45,4,2,2,19
S01010519,Good health,204,6,0,6,49,22,16,19,47,28,9,2,7,8
S01010519,Fair health,56,3,1,2,11,8,4,4,14,7,5,3,2,0
S01010519,Bad health,20,0,0,0,5,1,2,6,3,0,3,2,1,0
S01010519,Very bad health,7,0,0,0,1,0,0,0,0,5,1,1,0,0
S01010520,All people aged 16 to 74,667,36,11,25,132,89,41,97,129,105,9,5,4,29
S01010520,Very good health,378,25,11,14,88,51,20,52,57,55,4,2,2,26
S01010520,Good health,196,5,0,5,34,26,18,33,47,29,2,2,0,2
S01010520,Fair health,52,4,0,4,6,10,1,6,12,12,0,0,0,1
S01010520,Bad health,28,2,0,2,4,1,0,6,9,3,3,1,2,0
S01010520,Very bad health,13,0,0,0,0,1,2,0,4,6,0,0,0,0
S01010521,All people aged 16 to 74,563,17,3,14,110,52,62,74,126,93,12,5,7,17
S01010521,Very good health,291,11,2,9,68,31,30,35,56,44,3,3,0,13
S01010521,Good health,192,4,0,4,34,17,24,30,47,26,6,0,6,4
S01010521,Fair health,52,1,0,1,5,3,6,5,16,14,2,1,1,0
S01010521,Bad health,22,1,1,0,1,1,2,4,5,7,1,1,0,0
S01010521,Very bad health,6,0,0,0,2,0,0,0,2,2,0,0,0,0
S01010522,All people aged 16 to 74,441,24,8,16,66,37,46,55,92,75,25,20,5,21
S01010522,Very good health,195,11,3,8,32,15,24,34,29,29,6,4,2,15
S01010522,Good health,158,9,4,5,25,14,14,15,43,24,9,8,1,5
S01010522,Fair health,64,3,0,3,7,5,7,2,15,15,9,7,2,1
S01010522,Bad health,19,0,0,0,2,3,1,4,2,6,1,1,0,0
S01010522,Very bad health,5,1,1,0,0,0,0,0,3,1,0,0,0,0
S01010523,All people aged 16 to 74,433,6,0,6,63,26,28,40,132,106,15,9,6,17
S01010523,Very good health,196,6,0,6,28,8,12,25,65,39,2,2,0,11
S01010523,Good health,150,0,0,0,23,8,8,10,49,39,9,3,6,4
S01010523,Fair health,66,0,0,0,10,9,7,5,11,18,4,4,0,2
S01010523,Bad health,17,0,0,0,0,1,1,0,6,9,0,0,0,0
S01010523,Very bad health,4,0,0,0,2,0,0,0,1,1,0,0,0,0
S01010524,All people aged 16 to 74,415,36,8,28,101,36,82,44,58,46,5,3,2,7
S01010524,Very good health,200,18,2,16,57,15,37,23,23,19,3,1,2,5
S01010524,Good health,163,15,5,10,33,14,37,17,28,16,1,1,0,2
S01010524,Fair health,42,2,1,1,9,6,6,2,7,9,1,1,0,0
S01010524,Bad health,9,1,0,1,2,1,2,2,0,1,0,0,0,0
S01010524,Very bad health,1,0,0,0,0,0,0,0,0,1,0,0,0,0
S01010525,All people aged 16 to 74,486,40,14,26,119,38,91,54,62,49,9,8,1,24
S01010525,Very good health,264,18,7,11,66,17,46,25,36,30,4,4,0,22
S01010525,Good health,158,16,6,10,39,14,32,21,18,14,2,1,1,2
S01010525,Fair health,47,5,1,4,12,4,11,5,6,3,1,1,0,0
S01010525,Bad health,13,0,0,0,2,3,1,2,2,2,1,1,0,0
S01010525,Very bad health,4,1,0,1,0,0,1,1,0,0,1,1,0,0
S01010526,All people aged 16 to 74,581,41,7,34,119,67,102,60,104,67,5,3,2,16
S01010526,Very good health,260,26,3,23,50,31,45,31,39,21,4,3,1,13
S01010526,Good health,211,8,2,6,46,24,36,23,44,26,1,0,1,3
S01010526,Fair health,78,4,1,3,13,9,16,5,17,14,0,0,0,0
S01010526,Bad health,26,3,1,2,6,2,5,1,3,6,0,0,0,0
S01010526,Very bad health,6,0,0,0,4,1,0,0,1,0,0,0,0,0
S01010527,All people aged 16 to 74,658,22,8,14,138,61,51,92,131,118,27,13,14,18
S01010527,Very good health,258,10,5,5,57,25,18,47,44,34,9,3,6,14
S01010527,Good health,241,11,2,9,51,20,22,26,53,47,9,3,6,2
S01010527,Fair health,119,1,1,0,25,11,7,13,23,29,8,6,2,2
S01010527,Bad health,29,0,0,0,5,4,3,4,6,7,0,0,0,0
S01010527,Very bad health,11,0,0,0,0,1,1,2,5,1,1,1,0,0
S01010528,All people aged 16 to 74,445,39,9,30,126,30,71,40,60,36,12,9,3,31
S01010528,Very good health,222,25,6,19,75,14,30,16,25,14,2,2,0,21
S01010528,Good health,153,11,3,8,37,9,26,18,23,13,7,4,3,9
S01010528,Fair health,54,2,0,2,11,6,12,5,7,7,3,3,0,1
S01010528,Bad health,13,1,0,1,2,0,2,1,5,2,0,0,0,0
S01010528,Very bad health,3,0,0,0,1,1,1,0,0,0,0,0,0,0
S01010529,All people aged 16 to 74,528,40,8,32,115,46,81,54,89,66,10,6,4,27
S01010529,Very good health,298,24,6,18,64,30,49,31,41,33,1,1,0,25
S01010529,Good health,155,10,2,8,38,12,21,22,28,20,2,1,1,2
S01010529,Fair health,57,4,0,4,11,3,9,0,15,12,3,1,2,0
S01010529,Bad health,17,2,0,2,1,1,2,1,5,1,4,3,1,0
S01010529,Very bad health,1,0,0,0,1,0,0,0,0,0,0,0,0,0
S01010530,All people aged 16 to 74,501,43,16,27,100,44,114,44,78,55,5,3,2,18
S01010530,Very good health,267,25,8,17,57,22,61,25,31,27,2,0,2,17
S01010530,Good health,174,14,6,8,37,18,37,13,31,22,1,1,0,1
S01010530,Fair health,45,3,1,2,6,2,13,5,13,1,2,2,0,0
S01010530,Bad health,13,1,1,0,0,1,3,1,2,5,0,0,0,0
S01010530,Very bad health,2,0,0,0,0,1,0,0,1,0,0,0,0,0
S01010531,All people aged 16 to 74,803,68,18,50,167,77,134,88,126,100,15,13,2,28
S01010531,Very good health,432,38,10,28,97,43,66,46,63,55,6,6,0,18
S01010531,Good health,268,26,7,19,48,22,51,31,47,32,4,2,2,7
S01010531,Fair health,78,3,1,2,17,9,13,10,12,10,1,1,0,3
S01010531,Bad health,21,0,0,0,5,2,4,1,3,3,3,3,0,0
S01010531,Very bad health,4,1,0,1,0,1,0,0,1,0,1,1,0,0
S01010532,All people aged 16 to 74,411,41,12,29,66,39,81,57,66,36,8,4,4,17
S01010532,Very good health,227,20,3,17,41,18,44,33,31,20,5,2,3,15
S01010532,Good health,140,17,8,9,17,16,28,21,24,12,3,2,1,2
S01010532,Fair health,36,4,1,3,6,5,7,2,9,3,0,0,0,0
S01010532,Bad health,8,0,0,0,2,0,2,1,2,1,0,0,0,0
S01010532,Very bad health,0,0,0,0,0,0,0,0,0,0,0,0,0,0
S01010533,All people aged 16 to 74,419,38,9,29,102,33,63,45,76,41,7,4,3,14
S01010533,Very good health,245,19,3,16,58,16,41,26,48,23,3,1,2,11
S01010533,Good health,118,14,5,9,32,15,12,13,14,12,3,2,1,3
S01010533,Fair health,42,5,1,4,9,2,7,4,11,3,1,1,0,0
S01010533,Bad health,13,0,0,0,2,0,3,2,3,3,0,0,0,0
S01010533,Very bad health,1,0,0,0,1,0,0,0,0,0,0,0,0,0
S01010534,All people aged 16 to 74,654,44,7,37,138,69,81,67,129,72,16,9,7,38
S01010534,Very good health,349,21,4,17,91,38,44,32,58,30,4,1,3,31
S01010534,Good health,221,20,3,17,30,21,32,27,50,28,8,5,3,5
S01010534,Fair health,56,3,0,3,17,5,4,2,11,11,1,0,1,2
S01010534,Bad health,23,0,0,0,0,5,1,6,6,3,2,2,0,0
S01010534,Very bad health,5,0,0,0,0,0,0,0,4,0,1,1,0,0
S01010535,All people aged 16 to 74,524,48,8,40,151,51,83,43,76,41,8,6,2,23
S01010535,Very good health,290,32,5,27,89,26,45,24,32,19,3,2,1,20
S01010535,Good health,170,12,3,9,48,15,32,12,30,15,3,2,1,3
S01010535,Fair health,43,3,0,3,11,5,5,5,11,2,1,1,0,0
S01010535,Bad health,17,0,0,0,3,5,1,1,3,3,1,1,0,0
S01010535,Very bad health,4,1,0,1,0,0,0,1,0,2,0,0,0,0
S01010536,All people aged 16 to 74,631,31,10,21,116,78,53,96,115,107,17,6,11,18
S01010536,Very good health,326,17,5,12,70,42,27,53,54,47,3,2,1,13
S01010536,Good health,198,10,3,7,30,23,17,26,43,36,8,1,7,5
S01010536,Fair health,72,2,1,1,12,10,4,12,12,16,4,1,3,0
S01010536,Bad health,24,1,0,1,3,2,3,4,4,6,1,1,0,0
S01010536,Very bad health,11,1,1,0,1,1,2,1,2,2,1,1,0,0
S01010537,All people aged 16 to 74,630,29,7,22,114,58,54,110,113,107,16,7,9,29
S01010537,Very good health,328,21,6,15,68,34,23,51,55,50,3,2,1,23
S01010537,Good health,217,6,0,6,37,21,20,42,35,43,9,3,6,4
S01010537,Fair health,63,1,0,1,5,3,8,14,16,13,2,0,2,1
S01010537,Bad health,17,1,1,0,3,0,2,1,6,1,2,2,0,1
S01010537,Very bad health,5,0,0,0,1,0,1,2,1,0,0,0,0,0
S01010538,All people aged 16 to 74,585,51,7,44,124,74,63,67,91,71,13,3,10,31
S01010538,Very good health,356,31,6,25,87,44,38,40,52,34,8,2,6,22
S01010538,Good health,173,20,1,19,26,27,20,17,29,23,3,1,2,8
S01010538,Fair health,38,0,0,0,6,2,3,8,7,10,1,0,1,1
S01010538,Bad health,13,0,0,0,4,1,0,1,3,3,1,0,1,0
S01010538,Very bad health,5,0,0,0,1,0,2,1,0,1,0,0,0,0
S01010539,All people aged 16 to 74,913,58,21,37,236,109,99,120,147,107,11,4,7,26
S01010539,Very good health,508,35,16,19,146,59,58,67,64,58,2,0,2,19
S01010539,Good health,295,17,3,14,76,40,23,36,60,34,3,1,2,6
S01010539,Fair health,85,5,2,3,11,10,14,14,15,11,4,3,1,1
S01010539,Bad health,21,1,0,1,2,0,4,2,6,4,2,0,2,0
S01010539,Very bad health,4,0,0,0,1,0,0,1,2,0,0,0,0,0
S01010540,All people aged 16 to 74,475,58,14,44,116,42,66,44,65,48,8,6,2,28
S01010540,Very good health,258,38,11,27,68,22,28,21,29,27,3,2,1,22
S01010540,Good health,144,17,3,14,29,13,26,16,24,12,4,3,1,3
S01010540,Fair health,58,2,0,2,16,4,10,7,9,7,0,0,0,3
S01010540,Bad health,12,1,0,1,3,3,1,0,1,2,1,1,0,0
S01010540,Very bad health,3,0,0,0,0,0,1,0,2,0,0,0,0,0
S01010541,All people aged 16 to 74,649,47,10,37,173,76,96,73,94,63,5,2,3,22
S01010541,Very good health,388,30,6,24,116,42,57,42,50,30,2,1,1,19
S01010541,Good health,199,14,4,10,48,22,27,23,34,25,3,1,2,3
S01010541,Fair health,46,3,0,3,4,10,10,7,10,2,0,0,0,0
S01010541,Bad health,12,0,0,0,4,2,2,1,0,3,0,0,0,0
S01010541,Very bad health,4,0,0,0,1,0,0,0,0,3,0,0,0,0
S01010542,All people aged 16 to 74,673,59,11,48,181,62,99,72,94,63,13,6,7,30
S01010542,Very good health,381,40,7,33,110,40,49,35,48,31,4,3,1,24
S01010542,Good health,212,13,3,10,55,14,33,28,34,26,3,1,2,6
S01010542,Fair health,55,5,1,4,10,6,11,6,10,3,4,1,3,0
S01010542,Bad health,19,0,0,0,5,2,5,2,2,1,2,1,1,0
S01010542,Very bad health,6,1,0,1,1,0,1,1,0,2,0,0,0,0
S01010543,All people aged 16 to 74,470,41,12,29,100,51,119,26,77,38,5,5,0,13
S01010543,Very good health,263,24,7,17,59,31,61,11,45,20,1,1,0,11
S01010543,Good health,151,10,3,7,27,16,45,13,23,13,2,2,0,2
S01010543,Fair health,36,6,2,4,11,1,7,2,5,3,1,1,0,0
S01010543,Bad health,15,0,0,0,2,3,5,0,3,2,0,0,0,0
S01010543,Very bad health,5,1,0,1,1,0,1,0,1,0,1,1,0,0
S01010544,All people aged 16 to 74,625,30,5,25,109,49,78,65,130,112,31,13,18,21
S01010544,Very good health,337,15,4,11,65,23,48,39,65,51,14,9,5,17
S01010544,Good health,206,10,1,9,34,20,27,20,44,36,11,3,8,4
S01010544,Fair health,61,4,0,4,8,2,3,6,13,21,4,1,3,0
S01010544,Bad health,17,0,0,0,1,4,0,0,8,4,0,0,0,0
S01010544,Very bad health,4,1,0,1,1,0,0,0,0,0,2,0,2,0
S01010545,All people aged 16 to 74,509,38,11,27,113,57,77,35,84,72,15,7,8,18
S01010545,Very good health,278,22,8,14,67,29,42,20,44,35,2,1,1,17
S01010545,Good health,165,14,2,12,31,17,29,7,27,31,8,3,5,1
S01010545,Fair health,47,2,1,1,12,9,2,5,10,3,4,2,2,0
S01010545,Bad health,14,0,0,0,3,2,4,2,1,2,0,0,0,0
S01010545,Very bad health,5,0,0,0,0,0,0,1,2,1,1,1,0,0
S01010546,All people aged 16 to 74,544,40,7,33,99,54,74,53,99,88,15,6,9,22
S01010546,Very good health,277,29,5,24,51,35,36,27,39,38,7,4,3,15
S01010546,Good health,209,10,2,8,36,17,32,19,46,38,5,1,4,6
S01010546,Fair health,48,1,0,1,11,2,5,6,11,8,3,1,2,1
S01010546,Bad health,10,0,0,0,1,0,1,1,3,4,0,0,0,0
S01010546,Very bad health,0,0,0,0,0,0,0,0,0,0,0,0,0,0
S01010547,All people aged 16 to 74,567,35,9,26,130,53,99,70,77,62,11,7,4,30
S01010547,Very good health,312,27,8,19,67,29,55,43,38,26,3,3,0,24
S01010547,Good health,180,6,1,5,47,19,30,22,30,23,0,0,0,3
S01010547,Fair health,58,2,0,2,9,3,12,3,8,11,8,4,4,2
S01010547,Bad health,11,0,0,0,4,2,2,1,1,0,0,0,0,1
S01010547,Very bad health,6,0,0,0,3,0,0,1,0,2,0,0,0,0
S01010548,All people aged 16 to 74,487,55,11,44,108,66,80,41,81,32,4,1,3,20
S01010548,Very good health,250,25,1,24,58,35,42,26,37,10,1,1,0,16
S01010548,Good health,171,24,8,16,38,22,24,14,30,13,2,0,2,4
S01010548,Fair health,54,6,2,4,10,7,13,0,10,7,1,0,1,0
S01010548,Bad health,11,0,0,0,2,2,0,1,4,2,0,0,0,0
S01010548,Very bad health,1,0,0,0,0,0,1,0,0,0,0,0,0,0
S01010549,All people aged 16 to 74,660,62,10,52,201,94,45,66,96,61,6,3,3,29
S01010549,Very good health,392,32,7,25,128,51,24,39,53,36,3,2,1,26
S01010549,Good health,204,22,3,19,52,35,11,20,38,20,3,1,2,3
S01010549,Fair health,47,6,0,6,15,5,8,5,4,4,0,0,0,0
S01010549,Bad health,13,2,0,2,4,3,2,0,1,1,0,0,0,0
S01010549,Very bad health,4,0,0,0,2,0,0,2,0,0,0,0,0,0
S01010550,All people aged 16 to 74,397,38,6,32,77,41,34,59,55,51,9,5,4,33
S01010550,Very good health,226,27,5,22,45,26,19,32,33,16,1,0,1,27
S01010550,Good health,132,9,1,8,25,13,12,18,17,29,3,2,1,6
S01010550,Fair health,31,2,0,2,6,1,2,5,5,6,4,2,2,0
S01010550,Bad health,3,0,0,0,0,1,0,2,0,0,0,0,0,0
S01010550,Very bad health,5,0,0,0,1,0,1,2,0,0,1,1,0,0
S01010551,All people aged 16 to 74,485,59,9,50,107,55,88,36,59,47,11,5,6,23
S01010551,Very good health,274,36,3,33,63,37,46,20,25,26,3,1,2,18
S01010551,Good health,166,19,5,14,32,14,32,14,30,15,5,3,2,5
S01010551,Fair health,33,3,0,3,8,3,10,2,1,3,3,1,2,0
S01010551,Bad health,8,1,1,0,2,1,0,0,2,2,0,0,0,0
S01010551,Very bad health,4,0,0,0,2,0,0,0,1,1,0,0,0,0
S01010552,All people aged 16 to 74,582,83,16,67,125,56,80,46,87,64,9,7,2,32
S01010552,Very good health,311,46,8,38,65,23,41,29,43,33,2,2,0,29
S01010552,Good health,192,28,5,23,44,26,29,15,31,16,1,1,0,2
S01010552,Fair health,58,5,2,3,12,6,10,0,9,10,5,4,1,1
S01010552,Bad health,17,4,1,3,2,1,0,1,4,4,1,0,1,0
S01010552,Very bad health,4,0,0,0,2,0,0,1,0,1,0,0,0,0
S01010553,All people aged 16 to 74,486,56,17,39,106,58,100,41,68,23,10,6,4,24
S01010553,Very good health,277,31,10,21,63,30,52,32,34,12,4,3,1,19
S01010553,Good health,135,15,6,9,25,18,32,7,21,8,5,2,3,4
S01010553,Fair health,57,7,0,7,13,9,15,1,8,2,1,1,0,1
S01010553,Bad health,15,3,1,2,4,1,1,1,4,1,0,0,0,0
S01010553,Very bad health,2,0,0,0,1,0,0,0,1,0,0,0,0,0
S01010554,All people aged 16 to 74,563,32,7,25,133,66,63,56,101,75,16,9,7,21
S01010554,Very good health,295,14,5,9,79,30,33,31,52,34,6,2,4,16
S01010554,Good health,188,15,2,13,33,24,19,18,42,25,7,5,2,5
S01010554,Fair health,49,3,0,3,18,7,6,5,4,6,0,0,0,0
S01010554,Bad health,26,0,0,0,3,5,5,2,1,8,2,1,1,0
S01010554,Very bad health,5,0,0,0,0,0,0,0,2,2,1,1,0,0
S01010555,All people aged 16 to 74,711,50,11,39,151,90,67,68,125,94,25,10,15,41
S01010555,Very good health,353,31,6,25,79,53,38,30,53,29,4,0,4,36
S01010555,Good health,242,16,3,13,50,26,18,27,45,42,15,7,8,3
S01010555,Fair health,90,3,2,1,22,8,8,6,23,14,5,2,3,1
S01010555,Bad health,18,0,0,0,0,2,3,5,0,7,0,0,0,1
S01010555,Very bad health,8,0,0,0,0,1,0,0,4,2,1,1,0,0
S01010556,All people aged 16 to 74,670,31,6,25,106,64,39,86,145,118,44,27,17,37
S01010556,Very good health,292,13,2,11,55,31,9,39,64,44,9,3,6,28
S01010556,Good health,212,11,3,8,31,14,18,30,44,41,16,10,6,7
S01010556,Fair health,123,4,0,4,16,18,10,13,23,21,16,11,5,2
S01010556,Bad health,31,0,0,0,2,1,1,1,13,10,3,3,0,0
S01010556,Very bad health,12,3,1,2,2,0,1,3,1,2,0,0,0,0
S01010557,All people aged 16 to 74,440,31,7,24,88,52,18,41,91,75,24,16,8,20
S01010557,Very good health,210,16,5,11,43,25,6,16,42,36,9,7,2,17
S01010557,Good health,171,13,2,11,34,22,10,18,38,23,10,4,6,3
S01010557,Fair health,43,2,0,2,9,4,2,4,9,10,3,3,0,0
S01010557,Bad health,12,0,0,0,2,0,0,2,0,6,2,2,0,0
S01010557,Very bad health,4,0,0,0,0,1,0,1,2,0,0,0,0,0
S01010558,All people aged 16 to 74,586,42,13,29,130,69,57,52,99,83,32,19,13,22
S01010558,Very good health,288,23,9,14,76,34,27,31,42,29,7,4,3,19
S01010558,Good health,204,15,3,12,40,27,22,16,40,31,11,8,3,2
S01010558,Fair health,54,3,0,3,9,8,5,3,9,10,6,2,4,1
S01010558,Bad health,32,0,0,0,5,0,2,2,7,11,5,2,3,0
S01010558,Very bad health,8,1,1,0,0,0,1,0,1,2,3,3,0,0
S01010559,All people aged 16 to 74,491,77,10,67,156,58,42,39,52,32,14,9,5,21
S01010559,Very good health,269,47,5,42,101,21,19,19,29,14,3,1,2,16
S01010559,Good health,165,25,5,20,41,25,20,12,17,11,9,7,2,5
S01010559,Fair health,41,4,0,4,10,8,2,7,3,6,1,0,1,0
S01010559,Bad health,14,1,0,1,4,3,1,1,3,1,0,0,0,0
S01010559,Very bad health,2,0,0,0,0,1,0,0,0,0,1,1,0,0
S01010560,All people aged 16 to 74,487,53,7,46,130,63,47,47,77,36,10,6,4,24
S01010560,Very good health,252,27,3,24,73,26,19,22,43,16,8,4,4,18
S01010560,Good health,175,21,4,17,46,28,19,18,21,15,1,1,0,6
S01010560,Fair health,46,4,0,4,10,8,7,6,7,3,1,1,0,0
S01010560,Bad health,12,1,0,1,1,1,1,1,5,2,0,0,0,0
S01010560,Very bad health,2,0,0,0,0,0,1,0,1,0,0,0,0,0
S01010561,All people aged 16 to 74,495,68,12,56,131,69,49,31,58,51,11,7,4,27
S01010561,Very good health,282,38,7,31,81,36,25,17,33,24,5,3,2,23
S01010561,Good health,162,23,4,19,39,23,19,14,15,23,3,3,0,3
S01010561,Fair health,40,5,1,4,9,8,3,0,9,2,3,1,2,1
S01010561,Bad health,10,2,0,2,2,1,2,0,1,2,0,0,0,0
S01010561,Very bad health,1,0,0,0,0,1,0,0,0,0,0,0,0,0
S01010562,All people aged 16 to 74,553,29,6,23,118,78,42,74,112,67,10,7,3,23
S01010562,Very good health,277,16,2,14,60,45,18,39,48,28,3,3,0,20
S01010562,Good health,203,11,2,9,39,26,16,21,52,28,7,4,3,3
S01010562,Fair health,51,0,0,0,13,7,3,11,8,9,0,0,0,0
S01010562,Bad health,19,2,2,0,4,0,5,3,3,2,0,0,0,0
S01010562,Very bad health,3,0,0,0,2,0,0,0,1,0,0,0,0,0
S01010563,All people aged 16 to 74,390,17,7,10,63,40,24,44,87,79,20,10,10,16
S01010563,Very good health,189,8,3,5,33,22,11,22,37,41,5,3,2,10
S01010563,Good health,138,6,3,3,23,12,10,17,33,25,10,4,6,2
S01010563,Fair health,41,1,0,1,5,5,3,4,9,7,4,2,2,3
S01010563,Bad health,17,1,0,1,2,1,0,1,7,3,1,1,0,1
S01010563,Very bad health,5,1,1,0,0,0,0,0,1,3,0,0,0,0
S01010564,All people aged 16 to 74,386,11,2,9,49,29,36,50,88,83,28,13,15,12
S01010564,Very good health,142,6,1,5,22,11,19,17,28,26,7,2,5,6
S01010564,Good health,136,2,0,2,16,9,11,22,33,27,11,5,6,5
S01010564,Fair health,76,3,1,2,8,8,4,6,21,20,6,3,3,0
S01010564,Bad health,20,0,0,0,1,0,2,2,4,8,2,1,1,1
S01010564,Very bad health,12,0,0,0,2,1,0,3,2,2,2,2,0,0
S01010565,All people aged 16 to 74,492,29,8,21,97,60,26,59,99,79,13,9,4,30
S01010565,Very good health,239,15,3,12,52,30,11,30,42,33,6,4,2,20
S01010565,Good health,168,12,4,8,34,16,9,21,37,28,3,1,2,8
S01010565,Fair health,53,0,0,0,8,11,2,5,10,13,2,2,0,2
S01010565,Bad health,27,2,1,1,1,3,3,3,10,4,1,1,0,0
S01010565,Very bad health,5,0,0,0,2,0,1,0,0,1,1,1,0,0
S01010566,All people aged 16 to 74,798,88,29,59,186,91,110,88,109,55,20,10,10,51
S01010566,Very good health,462,57,18,39,116,48,62,52,58,24,8,4,4,37
S01010566,Good health,253,25,6,19,52,29,32,29,40,25,9,6,3,12
S01010566,Fair health,65,6,5,1,13,11,13,4,9,5,3,0,3,1
S01010566,Bad health,17,0,0,0,5,3,3,3,1,1,0,0,0,1
S01010566,Very bad health,1,0,0,0,0,0,0,0,1,0,0,0,0,0
S01010567,All people aged 16 to 74,795,95,32,63,210,83,113,57,94,47,41,39,2,55
S01010567,Very good health,461,60,17,43,134,40,70,35,48,25,2,1,1,47
S01010567,Good health,248,30,12,18,57,35,36,18,28,14,23,23,0,7
S01010567,Fair health,70,4,3,1,14,6,6,4,14,7,14,13,1,1
S01010567,Bad health,13,1,0,1,4,1,1,0,3,1,2,2,0,0
S01010567,Very bad health,3,0,0,0,1,1,0,0,1,0,0,0,0,0
S01010568,All people aged 16 to 74,742,87,18,69,164,86,95,69,103,71,12,10,2,55
S01010568,Very good health,426,62,10,52,99,54,57,38,38,30,5,4,1,43
S01010568,Good health,201,20,7,13,43,21,24,16,38,27,3,2,1,9
S01010568,Fair health,78,2,1,1,16,8,11,12,18,9,0,0,0,2
S01010568,Bad health,27,3,0,3,5,3,2,2,7,2,2,2,0,1
S01010568,Very bad health,10,0,0,0,1,0,1,1,2,3,2,2,0,0
S01010569,All people aged 16 to 74,675,57,13,44,151,136,99,50,75,58,17,13,4,32
S01010569,Very good health,395,38,11,27,90,86,47,35,41,26,7,5,2,25
S01010569,Good health,206,18,2,16,46,38,36,10,22,25,4,3,1,7
S01010569,Fair health,54,1,0,1,13,10,12,4,7,3,4,3,1,0
S01010569,Bad health,15,0,0,0,1,2,2,1,3,4,2,2,0,0
S01010569,Very bad health,5,0,0,0,1,0,2,0,2,0,0,0,0,0
S01010570,All people aged 16 to 74,777,44,8,36,131,71,57,89,187,120,33,20,13,45
S01010570,Very good health,383,20,4,16,58,40,27,35,91,59,15,10,5,38
S01010570,Good health,254,16,3,13,54,20,19,36,57,35,12,6,6,5
S01010570,Fair health,101,6,1,5,13,7,5,14,27,22,5,3,2,2
S01010570,Bad health,29,2,0,2,5,2,5,3,9,2,1,1,0,0
S01010570,Very bad health,10,0,0,0,1,2,1,1,3,2,0,0,0,0
S01010571,All people aged 16 to 74,626,49,10,39,156,89,46,79,100,78,7,5,2,22
S01010571,Very good health,319,23,3,20,77,42,22,41,58,37,3,3,0,16
S01010571,Good health,220,21,6,15,67,38,9,29,29,21,1,1,0,5
S01010571,Fair health,59,4,1,3,9,8,10,5,9,12,2,0,2,0
S01010571,Bad health,26,1,0,1,3,1,4,4,4,7,1,1,0,1
S01010571,Very bad health,2,0,0,0,0,0,1,0,0,1,0,0,0,0
S01010572,All people aged 16 to 74,590,33,5,28,97,79,34,81,122,100,24,8,16,20
S01010572,Very good health,257,15,0,15,48,38,8,44,46,35,9,0,9,14
S01010572,Good health,216,15,4,11,30,27,14,26,52,38,10,5,5,4
S01010572,Fair health,80,1,0,1,14,10,9,8,10,23,3,2,1,2
S01010572,Bad health,33,2,1,1,5,4,3,2,13,3,1,0,1,0
S01010572,Very bad health,4,0,0,0,0,0,0,1,1,1,1,1,0,0
S01010573,All people aged 16 to 74,406,17,6,11,69,43,24,59,91,81,12,6,6,10
S01010573,Very good health,183,11,4,7,31,22,12,22,36,39,3,0,3,7
S01010573,Good health,152,4,2,2,29,15,10,24,38,23,6,4,2,3
S01010573,Fair health,55,1,0,1,7,5,1,8,14,16,3,2,1,0
S01010573,Bad health,14,1,0,1,2,1,1,4,2,3,0,0,0,0
S01010573,Very bad health,2,0,0,0,0,0,0,1,1,0,0,0,0,0
S01010574,All people aged 16 to 74,416,52,9,43,117,67,29,32,51,33,8,4,4,27
S01010574,Very good health,251,36,5,31,67,42,21,19,25,19,2,1,1,20
S01010574,Good health,123,12,3,9,42,19,5,9,19,5,5,3,2,7
S01010574,Fair health,30,4,1,3,7,4,1,3,4,7,0,0,0,0
S01010574,Bad health,10,0,0,0,1,2,1,1,3,1,1,0,1,0
S01010574,Very bad health,2,0,0,0,0,0,1,0,0,1,0,0,0,0
S01010575,All people aged 16 to 74,511,49,17,32,142,96,35,30,78,36,14,6,8,31
S01010575,Very good health,284,31,10,21,84,45,18,20,38,16,8,4,4,24
S01010575,Good health,171,15,5,10,46,40,14,6,27,14,4,2,2,5
S01010575,Fair health,39,2,2,0,9,8,3,3,11,2,0,0,0,1
S01010575,Bad health,13,1,0,1,2,2,0,1,1,3,2,0,2,1
S01010575,Very bad health,4,0,0,0,1,1,0,0,1,1,0,0,0,0
S01010576,All people aged 16 to 74,613,72,14,58,175,114,51,43,79,37,12,6,6,30
S01010576,Very good health,351,42,10,32,105,65,29,26,33,20,6,3,3,25
S01010576,Good health,181,22,3,19,51,40,9,10,30,13,2,1,1,4
S01010576,Fair health,68,7,0,7,15,8,12,5,14,3,3,1,2,1
S01010576,Bad health,10,1,1,0,2,1,1,2,2,0,1,1,0,0
S01010576,Very bad health,3,0,0,0,2,0,0,0,0,1,0,0,0,0
S01010577,All people aged 16 to 74,659,13,4,9,96,64,41,75,152,128,34,23,11,56
S01010577,Very good health,289,7,1,6,33,31,23,30,60,52,13,8,5,40
S01010577,Good health,243,4,2,2,49,24,11,29,59,44,11,7,4,12
S01010577,Fair health,94,2,1,1,9,7,5,10,25,25,8,7,1,3
S01010577,Bad health,28,0,0,0,4,2,1,5,8,5,2,1,1,1
S01010577,Very bad health,5,0,0,0,1,0,1,1,0,2,0,0,0,0
S01010578,All people aged 16 to 74,436,12,4,8,86,50,33,58,89,71,13,10,3,24
S01010578,Very good health,221,8,2,6,40,21,22,37,47,28,1,0,1,17
S01010578,Good health,133,4,2,2,32,18,5,15,25,23,7,6,1,4
S01010578,Fair health,60,0,0,0,8,7,6,5,12,16,4,4,0,2
S01010578,Bad health,19,0,0,0,5,4,0,1,4,3,1,0,1,1
S01010578,Very bad health,3,0,0,0,1,0,0,0,1,1,0,0,0,0
S01010579,All people aged 16 to 74,580,28,7,21,151,79,47,71,105,51,9,7,2,39
S01010579,Very good health,317,13,5,8,85,48,26,40,45,25,4,2,2,31
S01010579,Good health,188,13,2,11,49,17,12,22,42,23,2,2,0,8
S01010579,Fair health,41,2,0,2,8,6,6,5,11,1,2,2,0,0
S01010579,Bad health,25,0,0,0,5,8,1,3,6,2,0,0,0,0
S01010579,Very bad health,9,0,0,0,4,0,2,1,1,0,1,1,0,0
S01010580,All people aged 16 to 74,444,35,2,33,89,61,25,50,78,64,22,18,4,20
S01010580,Very good health,214,15,2,13,55,29,13,22,32,29,8,7,1,11
S01010580,Good health,159,15,0,15,24,24,10,21,31,21,8,6,2,5
S01010580,Fair health,54,3,0,3,8,8,1,7,9,10,4,3,1,4
S01010580,Bad health,13,2,0,2,2,0,1,0,5,2,1,1,0,0
S01010580,Very bad health,4,0,0,0,0,0,0,0,1,2,1,1,0,0
S01010581,All people aged 16 to 74,402,37,9,28,109,59,22,39,61,43,16,11,5,16
S01010581,Very good health,230,22,5,17,66,36,15,18,38,18,6,3,3,11
S01010581,Good health,128,12,4,8,34,19,4,16,17,16,7,6,1,3
S01010581,Fair health,34,3,0,3,6,4,3,3,6,6,2,1,1,1
S01010581,Bad health,6,0,0,0,2,0,0,0,0,2,1,1,0,1
S01010581,Very bad health,4,0,0,0,1,0,0,2,0,1,0,0,0,0
S01010582,All people aged 16 to 74,346,43,7,36,84,53,35,33,42,23,12,10,2,21
S01010582,Very good health,221,27,6,21,58,35,20,22,28,14,4,4,0,13
S01010582,Good health,84,11,1,10,17,11,9,9,9,8,7,5,2,3
S01010582,Fair health,32,3,0,3,6,7,4,2,3,1,1,1,0,5
S01010582,Bad health,7,2,0,2,3,0,0,0,2,0,0,0,0,0
S01010582,Very bad health,2,0,0,0,0,0,2,0,0,0,0,0,0,0
S01010583,All people aged 16 to 74,742,56,8,48,216,146,45,66,109,54,7,4,3,43
S01010583,Very good health,441,34,5,29,142,83,18,39,55,30,3,1,2,37
S01010583,Good health,230,15,2,13,61,48,19,19,40,21,1,1,0,6
S01010583,Fair health,58,7,1,6,12,13,7,5,11,0,3,2,1,0
S01010583,Bad health,9,0,0,0,0,2,1,3,2,1,0,0,0,0
S01010583,Very bad health,4,0,0,0,1,0,0,0,1,2,0,0,0,0
S01010584,All people aged 16 to 74,580,66,19,47,145,85,60,44,74,43,20,13,7,43
S01010584,Very good health,347,42,13,29,93,46,33,31,33,25,7,4,3,37
S01010584,Good health,175,19,5,14,39,31,22,9,25,17,7,4,3,6
S01010584,Fair health,39,3,1,2,10,6,3,1,10,0,6,5,1,0
S01010584,Bad health,18,1,0,1,3,2,2,3,6,1,0,0,0,0
S01010584,Very bad health,1,1,0,1,0,0,0,0,0,0,0,0,0,0
S01010585,All people aged 16 to 74,595,72,22,50,161,88,52,63,80,36,10,5,5,33
S01010585,Very good health,408,49,15,34,115,55,36,46,47,26,5,1,4,29
S01010585,Good health,153,20,6,14,42,29,10,14,24,9,1,1,0,4
S01010585,Fair health,21,2,1,1,3,1,5,1,6,1,2,1,1,0
S01010585,Bad health,9,1,0,1,1,3,1,1,1,0,1,1,0,0
S01010585,Very bad health,4,0,0,0,0,0,0,1,2,0,1,1,0,0
S01010586,All people aged 16 to 74,591,84,21,63,183,93,48,46,76,30,6,1,5,25
S01010586,Very good health,341,48,14,34,109,51,27,28,38,14,6,1,5,20
S01010586,Good health,197,28,7,21,57,38,19,15,26,9,0,0,0,5
S01010586,Fair health,39,7,0,7,12,3,1,3,8,5,0,0,0,0
S01010586,Bad health,14,1,0,1,5,1,1,0,4,2,0,0,0,0
S01010586,Very bad health,0,0,0,0,0,0,0,0,0,0,0,0,0,0
S01010587,All people aged 16 to 74,527,50,8,42,163,72,39,47,68,44,14,12,2,30
S01010587,Very good health,305,37,3,34,103,45,17,22,27,25,8,7,1,21
S01010587,Good health,176,11,4,7,50,18,18,20,34,16,3,2,1,6
S01010587,Fair health,33,2,1,1,9,7,3,2,6,1,0,0,0,3
S01010587,Bad health,9,0,0,0,1,0,1,3,1,1,2,2,0,0
S01010587,Very bad health,4,0,0,0,0,2,0,0,0,1,1,1,0,0
S01010588,All people aged 16 to 74,460,53,14,39,118,74,34,33,75,38,13,9,4,22
S01010588,Very good health,262,38,12,26,72,40,15,18,40,19,2,0,2,18
S01010588,Good health,152,14,1,13,37,24,17,12,27,11,7,5,2,3
S01010588,Fair health,32,0,0,0,8,8,2,2,5,6,1,1,0,0
S01010588,Bad health,11,1,1,0,1,1,0,1,2,2,2,2,0,1
S01010588,Very bad health,3,0,0,0,0,1,0,0,1,0,1,1,0,0
S01010589,All people aged 16 to 74,482,27,4,23,92,69,27,52,109,69,17,15,2,20
S01010589,Very good health,218,16,1,15,60,36,8,19,35,25,7,7,0,12
S01010589,Good health,180,9,3,6,22,23,13,21,52,28,5,3,2,7
S01010589,Fair health,53,1,0,1,7,5,4,7,14,10,4,4,0,1
S01010589,Bad health,24,1,0,1,3,3,1,5,5,5,1,1,0,0
S01010589,Very bad health,7,0,0,0,0,2,1,0,3,1,0,0,0,0
S01010590,All people aged 16 to 74,600,97,29,68,209,83,53,35,53,29,7,2,5,34
S01010590,Very good health,380,65,15,50,128,46,31,26,33,14,5,1,4,32
S01010590,Good health,171,24,11,13,66,30,16,7,15,10,1,0,1,2
S01010590,Fair health,38,7,3,4,13,4,4,1,4,5,0,0,0,0
S01010590,Bad health,9,0,0,0,2,3,2,1,0,0,1,1,0,0
S01010590,Very bad health,2,1,0,1,0,0,0,0,1,0,0,0,0,0
S01010591,All people aged 16 to 74,531,50,9,41,155,82,26,58,79,41,19,8,11,21
S01010591,Very good health,334,36,5,31,102,47,17,37,47,22,8,3,5,18
S01010591,Good health,159,12,4,8,39,29,6,19,27,17,7,3,4,3
S01010591,Fair health,26,1,0,1,12,1,2,2,2,2,4,2,2,0
S01010591,Bad health,9,1,0,1,2,4,1,0,1,0,0,0,0,0
S01010591,Very bad health,3,0,0,0,0,1,0,0,2,0,0,0,0,0
S01010592,All people aged 16 to 74,402,32,5,27,94,68,20,38,75,50,14,10,4,11
S01010592,Very good health,199,16,3,13,51,38,12,19,33,23,1,1,0,6
S01010592,Good health,152,13,2,11,38,21,6,13,27,17,12,8,4,5
S01010592,Fair health,42,3,0,3,5,5,1,6,13,8,1,1,0,0
S01010592,Bad health,8,0,0,0,0,3,1,0,2,2,0,0,0,0
S01010592,Very bad health,1,0,0,0,0,1,0,0,0,0,0,0,0,0
S01010593,All people aged 16 to 74,465,56,11,45,142,72,44,30,54,34,8,7,1,25
S01010593,Very good health,263,40,10,30,78,40,25,15,24,18,5,4,1,18
S01010593,Good health,157,16,1,15,52,23,14,9,25,11,1,1,0,6
S01010593,Fair health,39,0,0,0,12,7,5,6,3,3,2,2,0,1
S01010593,Bad health,5,0,0,0,0,1,0,0,2,2,0,0,0,0
S01010593,Very bad health,1,0,0,0,0,1,0,0,0,0,0,0,0,0
S01010594,All people aged 16 to 74,488,45,6,39,133,78,34,68,67,34,10,6,4,19
S01010594,Very good health,305,30,3,27,92,46,22,39,39,18,3,1,2,16
S01010594,Good health,155,14,3,11,33,26,12,27,23,13,4,3,1,3
S01010594,Fair health,19,1,0,1,6,3,0,2,3,2,2,1,1,0
S01010594,Bad health,9,0,0,0,2,3,0,0,2,1,1,1,0,0
S01010594,Very bad health,0,0,0,0,0,0,0,0,0,0,0,0,0,0
S01010595,All people aged 16 to 74,555,78,13,65,164,76,32,48,68,47,9,4,5,33
S01010595,Very good health,362,52,9,43,113,52,19,33,42,23,3,1,2,25
S01010595,Good health,152,21,3,18,38,20,12,13,19,18,4,1,3,7
S01010595,Fair health,30,3,1,2,12,4,0,2,2,4,2,2,0,1
S01010595,Bad health,9,2,0,2,1,0,1,0,3,2,0,0,0,0
S01010595,Very bad health,2,0,0,0,0,0,0,0,2,0,0,0,0,0
S01010596,All people aged 16 to 74,609,79,17,62,164,83,74,48,75,48,12,4,8,26
S01010596,Very good health,386,51,9,42,108,51,50,28,37,30,7,1,6,24
S01010596,Good health,173,20,6,14,46,27,16,17,27,13,5,3,2,2
S01010596,Fair health,41,7,2,5,10,4,6,2,9,3,0,0,0,0
S01010596,Bad health,5,0,0,0,0,0,2,1,0,2,0,0,0,0
S01010596,Very bad health,4,1,0,1,0,1,0,0,2,0,0,0,0,0
S01010597,All people aged 16 to 74,481,42,8,34,146,77,42,47,57,32,13,8,5,25
S01010597,Very good health,311,31,6,25,97,50,23,34,34,17,6,3,3,19
S01010597,Good health,132,11,2,9,43,24,11,9,17,9,3,2,1,5
S01010597,Fair health,24,0,0,0,5,3,5,3,3,3,2,1,1,0
S01010597,Bad health,12,0,0,0,0,0,3,1,3,2,2,2,0,1
S01010597,Very bad health,2,0,0,0,1,0,0,0,0,1,0,0,0,0
S01010598,All people aged 16 to 74,728,87,17,70,224,112,48,58,91,58,13,11,2,37
S01010598,Very good health,495,63,11,52,146,77,30,38,57,40,12,10,2,32
S01010598,Good health,196,21,6,15,71,31,12,17,27,12,1,1,0,4
S01010598,Fair health,30,2,0,2,7,3,5,1,7,4,0,0,0,1
S01010598,Bad health,5,1,0,1,0,1,1,1,0,1,0,0,0,0
S01010598,Very bad health,2,0,0,0,0,0,0,1,0,1,0,0,0,0
S01010599,All people aged 16 to 74,447,57,14,43,130,75,27,34,53,38,5,3,2,28
S01010599,Very good health,254,33,8,25,88,38,10,16,26,19,2,1,1,22
S01010599,Good health,153,21,6,15,36,29,12,14,22,12,2,2,0,5
S01010599,Fair health,30,1,0,1,5,6,3,3,4,7,0,0,0,1
S01010599,Bad health,8,2,0,2,1,1,2,1,0,0,1,0,1,0
S01010599,Very bad health,2,0,0,0,0,1,0,0,1,0,0,0,0,0
S01010600,All people aged 16 to 74,698,74,16,58,190,104,64,65,98,50,15,11,4,38
S01010600,Very good health,362,39,4,35,98,49,33,30,52,24,3,2,1,34
S01010600,Good health,242,27,10,17,67,43,23,23,31,19,5,4,1,4
S01010600,Fair health,66,5,1,4,19,10,4,8,10,5,5,3,2,0
S01010600,Bad health,23,3,1,2,5,1,3,4,3,2,2,2,0,0
S01010600,Very bad health,5,0,0,0,1,1,1,0,2,0,0,0,0,0
S01010601,All people aged 16 to 74,450,43,4,39,134,67,38,47,52,36,7,5,2,26
S01010601,Very good health,239,28,2,26,73,37,17,20,26,16,0,0,0,22
S01010601,Good health,137,9,2,7,42,23,7,16,15,17,4,2,2,4
S01010601,Fair health,51,2,0,2,14,5,8,9,8,2,3,3,0,0
S01010601,Bad health,21,4,0,4,5,2,5,1,3,1,0,0,0,0
S01010601,Very bad health,2,0,0,0,0,0,1,1,0,0,0,0,0,0
S01010602,All people aged 16 to 74,422,33,8,25,117,53,30,56,62,48,6,4,2,17
S01010602,Very good health,230,19,4,15,72,27,15,32,22,25,3,1,2,15
S01010602,Good health,150,7,1,6,36,24,11,18,29,21,2,2,0,2
S01010602,Fair health,36,5,3,2,7,2,4,5,10,2,1,1,0,0
S01010602,Bad health,5,2,0,2,1,0,0,1,1,0,0,0,0,0
S01010602,Very bad health,1,0,0,0,1,0,0,0,0,0,0,0,0,0
S01010603,All people aged 16 to 74,600,58,13,45,174,99,37,57,83,55,8,1,7,29
S01010603,Very good health,329,37,6,31,95,58,12,33,43,27,3,0,3,21
S01010603,Good health,210,18,7,11,64,31,19,20,22,25,5,1,4,6
S01010603,Fair health,52,3,0,3,13,8,6,2,15,3,0,0,0,2
S01010603,Bad health,9,0,0,0,2,2,0,2,3,0,0,0,0,0
S01010603,Very bad health,0,0,0,0,0,0,0,0,0,0,0,0,0,0
S01010604,All people aged 16 to 74,344,45,10,35,110,44,29,28,40,18,3,2,1,27
S01010604,Very good health,194,24,5,19,61,25,14,14,20,12,1,0,1,23
S01010604,Good health,122,19,5,14,44,11,12,10,17,4,1,1,0,4
S01010604,Fair health,26,2,0,2,4,7,3,4,3,2,1,1,0,0
S01010604,Bad health,1,0,0,0,0,1,0,0,0,0,0,0,0,0
S01010604,Very bad health,1,0,0,0,1,0,0,0,0,0,0,0,0,0
S01010605,All people aged 16 to 74,668,78,21,57,172,98,65,70,90,43,8,4,4,44
S01010605,Very good health,371,44,9,35,99,54,33,37,50,19,3,2,1,32
S01010605,Good health,219,28,8,20,54,34,26,24,28,14,3,1,2,8
S01010605,Fair health,62,5,3,2,13,9,6,9,9,6,1,1,0,4
S01010605,Bad health,14,1,1,0,5,1,0,0,3,3,1,0,1,0
S01010605,Very bad health,2,0,0,0,1,0,0,0,0,1,0,0,0,0
S01010606,All people aged 16 to 74,581,19,4,15,98,69,49,64,117,109,20,10,10,36
S01010606,Very good health,269,15,3,12,49,35,21,29,42,46,9,6,3,23
S01010606,Good health,229,4,1,3,39,26,18,26,54,43,10,4,6,9
S01010606,Fair health,58,0,0,0,6,6,6,7,16,13,1,0,1,3
S01010606,Bad health,19,0,0,0,1,2,3,2,5,5,0,0,0,1
S01010606,Very bad health,6,0,0,0,3,0,1,0,0,2,0,0,0,0
S01010607,All people aged 16 to 74,603,70,21,49,204,80,60,28,73,51,9,7,2,28
S01010607,Very good health,337,46,12,34,118,41,24,13,37,32,2,2,0,24
S01010607,Good health,212,20,8,12,68,33,31,13,24,14,6,4,2,3
S01010607,Fair health,43,3,0,3,15,5,4,2,10,3,0,0,0,1
S01010607,Bad health,10,1,1,0,2,1,1,0,2,2,1,1,0,0
S01010607,Very bad health,1,0,0,0,1,0,0,0,0,0,0,0,0,0
S01010608,All people aged 16 to 74,477,26,3,23,62,53,20,50,123,77,32,13,19,34
S01010608,Very good health,207,20,2,18,28,27,7,21,49,22,11,5,6,22
S01010608,Good health,160,5,1,4,19,17,6,19,47,29,10,3,7,8
S01010608,Fair health,88,0,0,0,12,9,7,6,21,20,10,5,5,3
S01010608,Bad health,17,1,0,1,3,0,0,4,3,5,0,0,0,1
S01010608,Very bad health,5,0,0,0,0,0,0,0,3,1,1,0,1,0
S01010609,All people aged 16 to 74,429,15,2,13,63,47,21,49,93,100,13,9,4,28
S01010609,Very good health,202,8,0,8,35,22,9,27,41,38,5,4,1,17
S01010609,Good health,151,4,2,2,18,19,8,16,35,38,5,2,3,8
S01010609,Fair health,53,1,0,1,9,2,2,5,12,17,2,2,0,3
S01010609,Bad health,19,2,0,2,0,3,1,1,5,6,1,1,0,0
S01010609,Very bad health,4,0,0,0,1,1,1,0,0,1,0,0,0,0
S01010610,All people aged 16 to 74,525,76,13,63,135,74,41,45,70,43,23,12,11,18
S01010610,Very good health,276,51,11,40,72,42,25,22,25,18,10,7,3,11
S01010610,Good health,171,22,2,20,45,18,7,18,31,14,10,3,7,6
S01010610,Fair health,60,3,0,3,13,13,6,3,10,9,2,2,0,1
S01010610,Bad health,12,0,0,0,3,0,1,1,4,2,1,0,1,0
S01010610,Very bad health,6,0,0,0,2,1,2,1,0,0,0,0,0,0
S01010611,All people aged 16 to 74,717,20,2,18,143,84,37,99,159,121,27,15,12,27
S01010611,Very good health,320,10,1,9,75,37,17,41,63,53,6,4,2,18
S01010611,Good health,263,6,0,6,46,32,19,38,66,40,8,2,6,8
S01010611,Fair health,97,4,1,3,17,13,1,14,23,16,8,5,3,1
S01010611,Bad health,29,0,0,0,4,2,0,5,5,9,4,3,1,0
S01010611,Very bad health,8,0,0,0,1,0,0,1,2,3,1,1,0,0
S01010612,All people aged 16 to 74,567,28,3,25,118,82,32,61,116,86,13,9,4,31
S01010612,Very good health,292,15,2,13,61,51,12,32,50,41,4,4,0,26
S01010612,Good health,193,10,1,9,39,25,16,18,51,28,4,4,0,2
S01010612,Fair health,63,2,0,2,14,5,0,9,12,13,5,1,4,3
S01010612,Bad health,17,1,0,1,3,1,3,2,3,4,0,0,0,0
S01010612,Very bad health,2,0,0,0,1,0,1,0,0,0,0,0,0,0
S01010613,All people aged 16 to 74,522,41,9,32,134,69,21,54,92,77,5,4,1,29
S01010613,Very good health,238,25,6,19,71,32,6,25,35,18,0,0,0,26
S01010613,Good health,171,6,1,5,41,28,11,19,30,33,0,0,0,3
S01010613,Fair health,79,6,0,6,14,6,2,9,20,19,3,2,1,0
S01010613,Bad health,28,4,2,2,6,3,1,1,7,5,1,1,0,0
S01010613,Very bad health,6,0,0,0,2,0,1,0,0,2,1,1,0,0
S01010614,All people aged 16 to 74,411,3,1,2,54,42,15,46,96,106,22,11,11,27
S01010614,Very good health,190,2,0,2,24,22,8,22,41,41,10,5,5,20
S01010614,Good health,142,1,1,0,22,14,4,15,30,40,10,4,6,6
S01010614,Fair health,42,0,0,0,4,5,2,6,15,9,0,0,0,1
S01010614,Bad health,31,0,0,0,3,1,1,0,9,15,2,2,0,0
S01010614,Very bad health,6,0,0,0,1,0,0,3,1,1,0,0,0,0
S01010615,All people aged 16 to 74,639,55,6,49,169,101,25,67,96,78,11,3,8,37
S01010615,Very good health,361,40,3,37,105,56,13,32,40,43,5,1,4,27
S01010615,Good health,201,12,3,9,48,32,11,28,40,21,2,0,2,7
S01010615,Fair health,61,3,0,3,13,11,1,6,14,10,0,0,0,3
S01010615,Bad health,11,0,0,0,2,2,0,0,0,3,4,2,2,0
S01010615,Very bad health,5,0,0,0,1,0,0,1,2,1,0,0,0,0
S01010616,All people aged 16 to 74,640,50,9,41,180,111,36,61,98,54,5,5,0,45
S01010616,Very good health,362,27,5,22,102,65,16,31,63,20,2,2,0,36
S01010616,Good health,216,16,1,15,61,32,14,26,29,28,1,1,0,9
S01010616,Fair health,42,5,2,3,14,10,2,2,3,5,1,1,0,0
S01010616,Bad health,11,2,1,1,1,2,4,2,0,0,0,0,0,0
S01010616,Very bad health,9,0,0,0,2,2,0,0,3,1,1,1,0,0
S01010617,All people aged 16 to 74,688,49,10,39,200,117,41,56,120,66,6,5,1,33
S01010617,Very good health,365,27,2,25,103,64,17,30,66,30,3,2,1,25
S01010617,Good health,256,16,6,10,82,44,19,20,36,30,1,1,0,8
S01010617,Fair health,57,4,1,3,10,8,5,5,17,6,2,2,0,0
S01010617,Bad health,7,2,1,1,3,0,0,1,1,0,0,0,0,0
S01010617,Very bad health,3,0,0,0,2,1,0,0,0,0,0,0,0,0
S01010618,All people aged 16 to 74,600,42,5,37,141,98,46,55,104,71,10,4,6,33
S01010618,Very good health,346,28,3,25,86,54,21,33,63,30,3,2,1,28
S01010618,Good health,194,13,1,12,41,36,16,18,29,31,5,1,4,5
S01010618,Fair health,49,1,1,0,12,7,9,4,8,7,1,1,0,0
S01010618,Bad health,9,0,0,0,1,1,0,0,3,3,1,0,1,0
S01010618,Very bad health,2,0,0,0,1,0,0,0,1,0,0,0,0,0
S01010619,All people aged 16 to 74,499,27,3,24,77,51,33,60,85,107,25,13,12,34
S01010619,Very good health,239,15,0,15,37,25,15,28,32,50,10,3,7,27
S01010619,Good health,184,8,2,6,33,20,10,21,37,42,9,6,3,4
S01010619,Fair health,53,3,1,2,3,6,2,9,11,13,3,2,1,3
S01010619,Bad health,18,1,0,1,2,0,6,1,4,1,3,2,1,0
S01010619,Very bad health,5,0,0,0,2,0,0,1,1,1,0,0,0,0
S01010620,All people aged 16 to 74,545,35,4,31,98,53,18,52,120,93,47,28,19,29
S01010620,Very good health,239,24,4,20,61,17,6,18,42,37,13,9,4,21
S01010620,Good health,215,8,0,8,26,29,7,24,61,32,21,12,9,7
S01010620,Fair health,61,3,0,3,10,4,4,6,11,14,9,6,3,0
S01010620,Bad health,23,0,0,0,0,3,1,4,5,6,3,0,3,1
S01010620,Very bad health,7,0,0,0,1,0,0,0,1,4,1,1,0,0
S01010621,All people aged 16 to 74,741,108,17,91,178,69,56,56,108,72,51,37,14,43
S01010621,Very good health,387,70,12,58,104,34,37,33,39,24,16,8,8,30
S01010621,Good health,261,33,5,28,54,27,11,21,47,31,27,21,6,10
S01010621,Fair health,65,5,0,5,15,7,5,2,17,9,3,3,0,2
S01010621,Bad health,21,0,0,0,5,1,2,0,4,6,3,3,0,0
S01010621,Very bad health,7,0,0,0,0,0,1,0,1,2,2,2,0,1
S01010622,All people aged 16 to 74,469,12,0,12,75,56,22,51,109,90,28,7,21,26
S01010622,Very good health,212,4,0,4,43,24,11,29,42,36,6,2,4,17
S01010622,Good health,149,7,0,7,17,24,7,15,35,30,6,1,5,8
S01010622,Fair health,74,1,0,1,8,5,2,5,22,18,12,2,10,1
S01010622,Bad health,30,0,0,0,6,3,2,2,9,6,2,2,0,0
S01010622,Very bad health,4,0,0,0,1,0,0,0,1,0,2,0,2,0
S01010623,All people aged 16 to 74,548,34,15,19,167,94,28,38,93,49,17,5,12,28
S01010623,Very good health,353,25,12,13,113,64,20,23,51,28,7,2,5,22
S01010623,Good health,152,8,3,5,46,25,6,12,32,13,5,0,5,5
S01010623,Fair health,28,1,0,1,4,2,2,1,9,6,2,0,2,1
S01010623,Bad health,14,0,0,0,4,3,0,1,1,2,3,3,0,0
S01010623,Very bad health,1,0,0,0,0,0,0,1,0,0,0,0,0,0
S01010624,All people aged 16 to 74,519,61,4,57,94,56,15,52,82,76,18,10,8,65
S01010624,Very good health,257,43,1,42,49,24,10,22,33,24,9,5,4,43
S01010624,Good health,163,13,1,12,32,22,3,20,25,26,5,4,1,17
S01010624,Fair health,64,4,2,2,9,8,2,6,17,10,4,1,3,4
S01010624,Bad health,20,0,0,0,4,2,0,3,4,7,0,0,0,0
S01010624,Very bad health,15,1,0,1,0,0,0,1,3,9,0,0,0,1
S01010625,All people aged 16 to 74,578,93,21,72,176,84,64,31,65,20,10,5,5,35
S01010625,Very good health,346,63,13,50,98,58,32,16,33,11,6,2,4,29
S01010625,Good health,168,26,6,20,61,16,18,11,22,5,4,3,1,5
S01010625,Fair health,50,4,2,2,14,8,11,4,7,1,0,0,0,1
S01010625,Bad health,12,0,0,0,3,2,2,0,2,3,0,0,0,0
S01010625,Very bad health,2,0,0,0,0,0,1,0,1,0,0,0,0,0
S01010626,All people aged 16 to 74,619,98,9,89,180,86,63,37,64,42,24,21,3,25
S01010626,Very good health,336,63,6,57,113,39,25,22,30,14,11,10,1,19
S01010626,Good health,202,28,3,25,52,30,27,8,24,18,10,8,2,5
S01010626,Fair health,66,6,0,6,12,13,10,5,8,10,1,1,0,1
S01010626,Bad health,12,1,0,1,2,4,1,2,2,0,0,0,0,0
S01010626,Very bad health,3,0,0,0,1,0,0,0,0,0,2,2,0,0
S01010627,All people aged 16 to 74,637,85,12,73,147,61,63,53,100,69,24,18,6,35
S01010627,Very good health,347,64,9,55,79,28,33,30,48,27,13,11,2,25
S01010627,Good health,214,17,3,14,50,26,19,15,42,29,6,2,4,10
S01010627,Fair health,55,4,0,4,14,5,8,5,9,7,3,3,0,0
S01010627,Bad health,20,0,0,0,3,2,3,3,1,6,2,2,0,0
S01010627,Very bad health,1,0,0,0,1,0,0,0,0,0,0,0,0,0
S01010628,All people aged 16 to 74,792,80,11,69,174,100,65,71,114,114,27,16,11,47
S01010628,Very good health,436,50,3,47,92,54,38,37,62,50,11,7,4,42
S01010628,Good health,273,27,7,20,68,38,20,25,36,48,7,5,2,4
S01010628,Fair health,61,2,1,1,11,6,7,6,12,12,4,1,3,1
S01010628,Bad health,16,1,0,1,1,2,0,3,3,2,4,2,2,0
S01010628,Very bad health,6,0,0,0,2,0,0,0,1,2,1,1,0,0
S01010629,All people aged 16 to 74,654,109,19,90,181,61,62,43,83,62,21,11,10,32
S01010629,Very good health,348,69,13,56,110,31,38,25,29,16,9,5,4,21
S01010629,Good health,218,34,6,28,53,22,19,11,33,30,7,1,6,9
S01010629,Fair health,70,6,0,6,14,6,5,4,17,13,3,3,0,2
S01010629,Bad health,14,0,0,0,3,2,0,3,3,1,2,2,0,0
S01010629,Very bad health,4,0,0,0,1,0,0,0,1,2,0,0,0,0
S01010630,All people aged 16 to 74,441,24,4,20,87,54,44,37,77,60,32,23,9,26
S01010630,Very good health,227,14,2,12,54,28,20,17,33,34,8,6,2,19
S01010630,Good health,144,9,2,7,22,17,17,13,26,19,14,10,4,7
S01010630,Fair health,48,1,0,1,9,9,5,5,10,2,7,5,2,0
S01010630,Bad health,16,0,0,0,2,0,2,1,4,4,3,2,1,0
S01010630,Very bad health,6,0,0,0,0,0,0,1,4,1,0,0,0,0
S01010631,All people aged 16 to 74,462,46,3,43,110,70,32,42,79,55,12,5,7,16
S01010631,Very good health,235,34,3,31,56,41,13,14,42,19,4,0,4,12
S01010631,Good health,146,10,0,10,41,18,10,23,21,19,2,1,1,2
S01010631,Fair health,61,1,0,1,8,7,6,5,13,14,5,3,2,2
S01010631,Bad health,13,0,0,0,4,3,3,0,1,1,1,1,0,0
S01010631,Very bad health,7,1,0,1,1,1,0,0,2,2,0,0,0,0
S01010632,All people aged 16 to 74,681,28,7,21,108,95,57,78,138,115,31,13,18,31
S01010632,Very good health,308,17,5,12,62,44,21,31,60,36,13,4,9,24
S01010632,Good health,230,9,2,7,27,32,26,27,44,50,10,5,5,5
S01010632,Fair health,88,1,0,1,16,11,6,10,23,14,5,1,4,2
S01010632,Bad health,47,1,0,1,3,8,4,9,9,11,2,2,0,0
S01010632,Very bad health,8,0,0,0,0,0,0,1,2,4,1,1,0,0
S01010633,All people aged 16 to 74,704,17,3,14,82,73,34,87,171,160,40,20,20,40
S01010633,Very good health,313,10,2,8,39,29,14,45,76,60,13,7,6,27
S01010633,Good health,235,6,0,6,26,29,8,21,59,62,12,3,9,12
S01010633,Fair health,108,0,0,0,8,10,8,16,26,27,12,7,5,1
S01010633,Bad health,40,1,1,0,7,3,3,5,10,8,3,3,0,0
S01010633,Very bad health,8,0,0,0,2,2,1,0,0,3,0,0,0,0
S01010634,All people aged 16 to 74,476,15,4,11,68,48,37,58,97,117,13,3,10,23
S01010634,Very good health,217,9,3,6,36,25,21,19,37,49,5,0,5,16
S01010634,Good health,168,3,0,3,25,12,9,30,37,40,5,2,3,7
S01010634,Fair health,62,3,1,2,5,8,4,7,13,20,2,0,2,0
S01010634,Bad health,21,0,0,0,2,3,1,1,8,6,0,0,0,0
S01010634,Very bad health,8,0,0,0,0,0,2,1,2,2,1,1,0,0
S01010635,All people aged 16 to 74,577,14,4,10,83,73,36,59,131,112,29,17,12,40
S01010635,Very good health,253,9,2,7,41,31,21,21,59,38,11,7,4,22
S01010635,Good health,200,4,2,2,25,20,9,25,45,48,9,5,4,15
S01010635,Fair health,83,1,0,1,11,16,5,8,20,13,6,3,3,3
S01010635,Bad health,36,0,0,0,3,6,1,5,6,12,3,2,1,0
S01010635,Very bad health,5,0,0,0,3,0,0,0,1,1,0,0,0,0
S01010636,All people aged 16 to 74,625,61,16,45,148,82,67,48,95,79,16,8,8,29
S01010636,Very good health,324,39,8,31,75,37,37,21,51,38,8,4,4,18
S01010636,Good health,216,16,5,11,58,34,18,20,30,26,6,2,4,8
S01010636,Fair health,62,3,0,3,12,6,10,7,11,9,2,2,0,2
S01010636,Bad health,18,3,3,0,3,4,1,0,3,3,0,0,0,1
S01010636,Very bad health,5,0,0,0,0,1,1,0,0,3,0,0,0,0
S01010637,All people aged 16 to 74,445,31,5,26,64,43,37,49,99,77,26,15,11,19
S01010637,Very good health,168,19,3,16,28,18,20,17,29,18,6,1,5,13
S01010637,Good health,173,11,2,9,28,19,12,17,41,31,10,6,4,4
S01010637,Fair health,83,1,0,1,7,5,5,12,21,22,8,6,2,2
S01010637,Bad health,15,0,0,0,1,1,0,2,7,3,1,1,0,0
S01010637,Very bad health,6,0,0,0,0,0,0,1,1,3,1,1,0,0
S01010638,All people aged 16 to 74,585,31,7,24,97,58,57,55,119,118,22,14,8,28
S01010638,Very good health,229,21,4,17,47,20,21,21,35,31,10,6,4,23
S01010638,Good health,208,8,3,5,31,25,20,22,46,45,6,4,2,5
S01010638,Fair health,101,0,0,0,15,10,11,9,30,21,5,4,1,0
S01010638,Bad health,38,1,0,1,3,2,4,2,7,18,1,0,1,0
S01010638,Very bad health,9,1,0,1,1,1,1,1,1,3,0,0,0,0
S01010639,All people aged 16 to 74,871,43,7,36,129,88,51,109,181,172,48,26,22,50
S01010639,Very good health,370,27,1,26,75,38,14,44,62,65,14,8,6,31
S01010639,Good health,306,7,1,6,37,31,20,42,80,58,16,6,10,15
S01010639,Fair health,126,6,4,2,9,12,11,13,27,30,14,9,5,4
S01010639,Bad health,45,1,1,0,3,5,6,8,7,12,3,2,1,0
S01010639,Very bad health,24,2,0,2,5,2,0,2,5,7,1,1,0,0
S01010640,All people aged 16 to 74,693,56,7,49,135,55,69,69,126,100,53,41,12,30
S01010640,Very good health,350,32,4,28,77,29,35,31,64,42,20,17,3,20
S01010640,Good health,251,18,3,15,44,20,30,29,46,42,16,11,5,6
S01010640,Fair health,73,5,0,5,9,6,4,8,11,11,15,11,4,4
S01010640,Bad health,15,1,0,1,3,0,0,1,5,4,1,1,0,0
S01010640,Very bad health,4,0,0,0,2,0,0,0,0,1,1,1,0,0
S01010641,All people aged 16 to 74,726,36,2,34,87,80,40,57,185,146,70,40,30,25
S01010641,Very good health,273,16,1,15,45,38,19,18,56,49,18,10,8,14
S01010641,Good health,247,13,1,12,35,23,11,16,70,48,22,10,12,9
S01010641,Fair health,138,7,0,7,4,7,4,16,39,36,23,14,9,2
S01010641,Bad health,51,0,0,0,1,11,2,6,15,10,6,5,1,0
S01010641,Very bad health,17,0,0,0,2,1,4,1,5,3,1,1,0,0
S01010642,All people aged 16 to 74,686,10,4,6,61,66,45,81,151,163,73,45,28,36
S01010642,Very good health,266,5,1,4,20,33,13,34,64,49,27,16,11,21
S01010642,Good health,257,3,1,2,30,20,17,32,56,66,21,10,11,12
S01010642,Fair health,107,2,2,0,10,6,13,8,22,33,10,5,5,3
S01010642,Bad health,44,0,0,0,1,4,2,4,8,11,14,13,1,0
S01010642,Very bad health,12,0,0,0,0,3,0,3,1,4,1,1,0,0
S01010643,All people aged 16 to 74,511,3,1,2,53,43,26,52,118,132,53,31,22,31
S01010643,Very good health,205,2,1,1,28,20,6,13,46,51,15,7,8,24
S01010643,Good health,175,0,0,0,17,14,8,27,43,43,18,9,9,5
S01010643,Fair health,93,1,0,1,6,9,11,7,21,26,11,7,4,1
S01010643,Bad health,27,0,0,0,1,0,1,4,5,10,5,4,1,1
S01010643,Very bad health,11,0,0,0,1,0,0,1,3,2,4,4,0,0
S01010644,All people aged 16 to 74,492,5,0,5,35,32,26,51,133,138,55,31,24,17
S01010644,Very good health,167,2,0,2,12,13,3,11,58,42,16,7,9,10
S01010644,Good health,154,3,0,3,14,9,6,18,35,42,22,9,13,5
S01010644,Fair health,96,0,0,0,4,4,10,10,25,29,12,11,1,2
S01010644,Bad health,57,0,0,0,5,5,5,9,12,19,2,2,0,0
S01010644,Very bad health,18,0,0,0,0,1,2,3,3,6,3,2,1,0
S01010645,All people aged 16 to 74,445,38,8,30,93,68,35,42,80,62,7,5,2,20
S01010645,Very good health,247,23,4,19,58,38,18,24,40,29,2,2,0,15
S01010645,Good health,141,12,3,9,23,22,9,15,29,24,3,1,2,4
S01010645,Fair health,47,2,0,2,12,7,6,2,10,6,1,1,0,1
S01010645,Bad health,9,1,1,0,0,1,2,0,1,3,1,1,0,0
S01010645,Very bad health,1,0,0,0,0,0,0,1,0,0,0,0,0,0
S01010646,All people aged 16 to 74,520,39,10,29,129,89,29,54,81,51,9,4,5,39
S01010646,Very good health,287,20,6,14,74,49,16,28,45,25,0,0,0,30
S01010646,Good health,167,11,2,9,43,28,8,23,24,20,4,1,3,6
S01010646,Fair health,50,5,1,4,9,9,3,3,10,3,5,3,2,3
S01010646,Bad health,10,3,1,2,2,2,1,0,0,2,0,0,0,0
S01010646,Very bad health,6,0,0,0,1,1,1,0,2,1,0,0,0,0
S01010647,All people aged 16 to 74,522,41,9,32,119,73,35,59,83,64,10,4,6,38
S01010647,Very good health,252,27,7,20,51,35,15,29,38,24,4,0,4,29
S01010647,Good health,209,11,2,9,58,25,14,27,31,34,4,2,2,5
S01010647,Fair health,40,3,0,3,5,7,5,3,9,4,2,2,0,2
S01010647,Bad health,16,0,0,0,3,4,1,0,4,2,0,0,0,2
S01010647,Very bad health,5,0,0,0,2,2,0,0,1,0,0,0,0,0
S01010648,All people aged 16 to 74,522,37,6,31,101,86,37,48,91,75,20,11,9,27
S01010648,Very good health,272,21,3,18,60,48,14,26,48,28,6,4,2,21
S01010648,Good health,171,9,2,7,34,33,12,15,29,30,5,2,3,4
S01010648,Fair health,51,4,1,3,4,5,9,4,6,11,6,3,3,2
S01010648,Bad health,21,2,0,2,2,0,2,2,6,4,3,2,1,0
S01010648,Very bad health,7,1,0,1,1,0,0,1,2,2,0,0,0,0
S01010649,All people aged 16 to 74,415,31,10,21,109,71,32,44,57,51,7,3,4,13
S01010649,Very good health,229,16,7,9,71,40,15,25,34,16,1,0,1,11
S01010649,Good health,127,11,3,8,26,24,11,11,16,23,3,2,1,2
S01010649,Fair health,45,4,0,4,9,7,4,6,6,7,2,0,2,0
S01010649,Bad health,7,0,0,0,3,0,0,1,0,3,0,0,0,0
S01010649,Very bad health,7,0,0,0,0,0,2,1,1,2,1,1,0,0
S01010650,All people aged 16 to 74,392,15,3,12,89,49,43,25,68,42,39,33,6,22
S01010650,Very good health,195,9,2,7,44,25,25,12,34,21,11,8,3,14
S01010650,Good health,122,4,0,4,26,15,13,10,20,6,20,18,2,8
S01010650,Fair health,55,1,1,0,14,9,5,1,11,7,7,6,1,0
S01010650,Bad health,15,1,0,1,3,0,0,1,3,6,1,1,0,0
S01010650,Very bad health,5,0,0,0,2,0,0,1,0,2,0,0,0,0
S01010651,All people aged 16 to 74,533,13,3,10,82,76,48,58,117,86,27,21,6,26
S01010651,Very good health,223,7,2,5,36,32,15,22,49,38,3,3,0,21
S01010651,Good health,192,5,1,4,29,33,23,24,33,23,18,13,5,4
S01010651,Fair health,89,1,0,1,11,9,10,8,25,19,5,4,1,1
S01010651,Bad health,19,0,0,0,2,2,0,2,7,5,1,1,0,0
S01010651,Very bad health,10,0,0,0,4,0,0,2,3,1,0,0,0,0
S01010652,All people aged 16 to 74,590,38,11,27,149,86,34,49,87,68,45,32,13,34
S01010652,Very good health,286,18,4,14,70,47,15,23,47,30,6,2,4,30
S01010652,Good health,202,18,6,12,59,26,8,17,26,24,21,17,4,3
S01010652,Fair health,80,1,1,0,16,11,8,7,10,11,15,11,4,1
S01010652,Bad health,17,1,0,1,3,1,3,2,4,2,1,1,0,0
S01010652,Very bad health,5,0,0,0,1,1,0,0,0,1,2,1,1,0
S01010653,All people aged 16 to 74,482,26,5,21,109,88,33,60,73,63,8,6,2,22
S01010653,Very good health,211,11,2,9,52,36,13,28,26,29,1,0,1,15
S01010653,Good health,201,9,2,7,42,40,13,26,36,25,4,4,0,6
S01010653,Fair health,53,4,1,3,10,9,6,5,8,7,3,2,1,1
S01010653,Bad health,15,1,0,1,5,3,1,1,3,1,0,0,0,0
S01010653,Very bad health,2,1,0,1,0,0,0,0,0,1,0,0,0,0
S01010654,All people aged 16 to 74,603,10,2,8,105,91,46,56,146,97,20,14,6,32
S01010654,Very good health,280,6,0,6,44,45,26,26,64,41,3,2,1,25
S01010654,Good health,207,2,1,1,44,30,12,17,55,33,8,6,2,6
S01010654,Fair health,67,0,0,0,9,10,5,12,17,8,5,3,2,1
S01010654,Bad health,39,1,1,0,6,4,3,1,8,13,3,2,1,0
S01010654,Very bad health,10,1,0,1,2,2,0,0,2,2,1,1,0,0
S01010655,All people aged 16 to 74,657,60,11,49,161,77,135,52,78,58,8,2,6,28
S01010655,Very good health,345,35,7,28,87,41,71,26,36,27,1,0,1,21
S01010655,Good health,224,19,3,16,56,27,41,19,31,22,3,1,2,6
S01010655,Fair health,64,5,0,5,15,6,18,5,4,6,4,1,3,1
S01010655,Bad health,21,1,1,0,3,2,4,2,7,2,0,0,0,0
S01010655,Very bad health,3,0,0,0,0,1,1,0,0,1,0,0,0,0
S01010656,All people aged 16 to 74,335,20,4,16,70,42,40,29,66,45,9,5,4,14
S01010656,Very good health,173,11,2,9,37,26,23,14,32,18,3,1,2,9
S01010656,Good health,116,7,1,6,22,12,12,14,26,16,3,1,2,4
S01010656,Fair health,31,2,1,1,9,4,1,1,5,7,2,2,0,0
S01010656,Bad health,12,0,0,0,1,0,4,0,2,3,1,1,0,1
S01010656,Very bad health,3,0,0,0,1,0,0,0,1,1,0,0,0,0
S01010657,All people aged 16 to 74,498,63,15,48,122,65,79,45,50,38,11,3,8,25
S01010657,Very good health,268,32,5,27,63,31,49,27,25,18,2,0,2,21
S01010657,Good health,170,26,8,18,41,26,26,13,17,12,5,2,3,4
S01010657,Fair health,45,4,2,2,13,4,3,4,7,7,3,0,3,0
S01010657,Bad health,10,0,0,0,2,4,1,0,1,1,1,1,0,0
S01010657,Very bad health,5,1,0,1,3,0,0,1,0,0,0,0,0,0
S01010658,All people aged 16 to 74,562,72,14,58,149,69,69,45,69,50,9,2,7,30
S01010658,Very good health,312,46,7,39,81,38,35,27,38,20,2,0,2,25
S01010658,Good health,180,23,7,16,52,20,27,8,20,21,4,1,3,5
S01010658,Fair health,50,2,0,2,11,7,5,6,7,9,3,1,2,0
S01010658,Bad health,18,1,0,1,4,4,2,4,3,0,0,0,0,0
S01010658,Very bad health,2,0,0,0,1,0,0,0,1,0,0,0,0,0
S01010659,All people aged 16 to 74,501,60,10,50,132,61,66,32,63,42,17,14,3,28
S01010659,Very good health,288,38,7,31,75,32,42,20,28,22,5,3,2,26
S01010659,Good health,153,16,2,14,42,21,16,10,25,13,9,8,1,1
S01010659,Fair health,51,5,1,4,13,7,7,2,8,5,3,3,0,1
S01010659,Bad health,6,1,0,1,1,1,1,0,0,2,0,0,0,0
S01010659,Very bad health,3,0,0,0,1,0,0,0,2,0,0,0,0,0
S01010660,All people aged 16 to 74,437,24,3,21,99,53,47,52,72,62,7,5,2,21
S01010660,Very good health,218,16,2,14,50,31,23,33,25,22,3,2,1,15
S01010660,Good health,143,5,1,4,34,14,15,10,26,32,1,1,0,6
S01010660,Fair health,48,2,0,2,10,6,6,7,11,3,3,2,1,0
S01010660,Bad health,22,1,0,1,4,1,2,2,7,5,0,0,0,0
S01010660,Very bad health,6,0,0,0,1,1,1,0,3,0,0,0,0,0
S01010661,All people aged 16 to 74,449,22,7,15,113,49,44,57,72,65,19,14,5,8
S01010661,Very good health,233,14,4,10,60,28,20,33,34,32,8,5,3,4
S01010661,Good health,139,4,0,4,37,16,14,16,27,17,5,5,0,3
S01010661,Fair health,54,4,3,1,12,4,8,6,6,9,4,3,1,1
S01010661,Bad health,20,0,0,0,4,1,1,2,4,6,2,1,1,0
S01010661,Very bad health,3,0,0,0,0,0,1,0,1,1,0,0,0,0
S01010662,All people aged 16 to 74,554,60,12,48,120,87,88,47,57,47,9,6,3,39
S01010662,Very good health,300,35,5,30,70,44,44,27,24,21,3,1,2,32
S01010662,Good health,188,23,6,17,38,34,28,17,23,17,2,1,1,6
S01010662,Fair health,46,2,1,1,7,6,12,3,6,7,2,2,0,1
S01010662,Bad health,14,0,0,0,4,2,2,0,3,1,2,2,0,0
S01010662,Very bad health,6,0,0,0,1,1,2,0,1,1,0,0,0,0
S01010663,All people aged 16 to 74,709,62,10,52,177,86,115,57,92,75,16,9,7,29
S01010663,Very good health,394,38,5,33,120,40,50,32,54,31,6,3,3,23
S01010663,Good health,224,20,5,15,37,37,44,21,27,28,5,2,3,5
S01010663,Fair health,74,3,0,3,15,9,18,3,11,11,4,3,1,0
S01010663,Bad health,14,0,0,0,4,0,3,1,0,4,1,1,0,1
S01010663,Very bad health,3,1,0,1,1,0,0,0,0,1,0,0,0,0
S01010664,All people aged 16 to 74,619,74,13,61,150,63,128,40,76,47,12,8,4,29
S01010664,Very good health,360,45,9,36,93,34,66,22,42,28,6,4,2,24
S01010664,Good health,188,22,2,20,43,20,48,12,22,14,3,1,2,4
S01010664,Fair health,57,6,2,4,12,5,12,4,12,3,2,2,0,1
S01010664,Bad health,8,1,0,1,1,2,2,0,0,2,0,0,0,0
S01010664,Very bad health,6,0,0,0,1,2,0,2,0,0,1,1,0,0
S01010665,All people aged 16 to 74,686,71,17,54,156,75,108,73,90,77,11,7,4,25
S01010665,Very good health,351,42,11,31,87,37,54,35,37,32,6,3,3,21
S01010665,Good health,223,17,3,14,46,23,39,26,39,26,4,3,1,3
S01010665,Fair health,81,10,3,7,14,10,15,4,12,15,0,0,0,1
S01010665,Bad health,22,1,0,1,8,3,0,5,1,3,1,1,0,0
S01010665,Very bad health,9,1,0,1,1,2,0,3,1,1,0,0,0,0
S01010666,All people aged 16 to 74,680,47,10,37,155,74,91,90,116,55,14,7,7,38
S01010666,Very good health,327,27,6,21,75,32,45,45,57,19,5,4,1,22
S01010666,Good health,256,15,3,12,63,32,36,33,41,19,4,1,3,13
S01010666,Fair health,74,3,1,2,15,8,9,8,12,12,5,2,3,2
S01010666,Bad health,20,2,0,2,2,0,1,4,6,4,0,0,0,1
S01010666,Very bad health,3,0,0,0,0,2,0,0,0,1,0,0,0,0
S01010667,All people aged 16 to 74,523,62,11,51,123,51,90,44,64,50,14,10,4,25
S01010667,Very good health,287,44,8,36,67,26,42,24,32,28,1,0,1,23
S01010667,Good health,164,12,3,9,46,16,30,12,26,15,6,5,1,1
S01010667,Fair health,54,5,0,5,8,7,14,5,5,5,4,2,2,1
S01010667,Bad health,14,1,0,1,2,2,4,1,1,1,2,2,0,0
S01010667,Very bad health,4,0,0,0,0,0,0,2,0,1,1,1,0,0
S01010668,All people aged 16 to 74,834,51,17,34,172,68,163,113,111,99,22,11,11,35
S01010668,Very good health,437,27,11,16,82,35,87,57,60,59,9,6,3,21
S01010668,Good health,272,19,5,14,60,26,54,36,33,28,3,1,2,13
S01010668,Fair health,102,3,1,2,20,7,21,16,16,11,7,3,4,1
S01010668,Bad health,19,1,0,1,9,0,0,4,2,1,2,0,2,0
S01010668,Very bad health,4,1,0,1,1,0,1,0,0,0,1,1,0,0
S01010669,All people aged 16 to 74,417,41,11,30,87,38,76,43,57,52,10,7,3,13
S01010669,Very good health,225,19,6,13,50,20,42,21,32,25,5,2,3,11
S01010669,Good health,131,18,5,13,27,14,22,19,16,14,0,0,0,1
S01010669,Fair health,49,2,0,2,8,2,10,2,8,11,5,5,0,1
S01010669,Bad health,11,2,0,2,2,2,2,0,1,2,0,0,0,0
S01010669,Very bad health,1,0,0,0,0,0,0,1,0,0,0,0,0,0
S01010670,All people aged 16 to 74,522,43,8,35,105,56,85,53,78,58,13,7,6,31
S01010670,Very good health,281,20,2,18,58,34,40,33,40,23,6,4,2,27
S01010670,Good health,172,17,5,12,31,12,32,16,32,25,4,1,3,3
S01010670,Fair health,49,4,1,3,11,6,11,2,3,9,2,1,1,1
S01010670,Bad health,12,1,0,1,3,2,1,2,1,1,1,1,0,0
S01010670,Very bad health,8,1,0,1,2,2,1,0,2,0,0,0,0,0
S01010671,All people aged 16 to 74,576,50,5,45,127,53,93,40,94,63,17,7,10,39
S01010671,Very good health,303,30,2,28,63,31,52,26,40,28,1,0,1,32
S01010671,Good health,205,13,2,11,46,17,35,12,43,20,13,6,7,6
S01010671,Fair health,44,6,1,5,14,3,5,2,7,5,1,0,1,1
S01010671,Bad health,19,1,0,1,4,2,0,0,3,8,1,0,1,0
S01010671,Very bad health,5,0,0,0,0,0,1,0,1,2,1,1,0,0
S01010672,All people aged 16 to 74,468,16,5,11,64,52,65,59,96,73,18,7,11,25
S01010672,Very good health,219,7,3,4,38,24,28,28,45,28,8,2,6,13
S01010672,Good health,162,9,2,7,21,21,20,19,30,28,5,1,4,9
S01010672,Fair health,63,0,0,0,4,7,14,10,11,11,4,3,1,2
S01010672,Bad health,19,0,0,0,0,0,2,2,9,4,1,1,0,1
S01010672,Very bad health,5,0,0,0,1,0,1,0,1,2,0,0,0,0
S01010673,All people aged 16 to 74,696,53,8,45,160,61,135,54,110,87,21,9,12,15
S01010673,Very good health,341,29,6,23,78,27,70,23,45,50,7,2,5,12
S01010673,Good health,234,19,2,17,60,24,46,18,42,15,7,1,6,3
S01010673,Fair health,77,5,0,5,19,5,14,7,11,14,2,2,0,0
S01010673,Bad health,35,0,0,0,3,5,4,4,9,6,4,3,1,0
S01010673,Very bad health,9,0,0,0,0,0,1,2,3,2,1,1,0,0
S01010674,All people aged 16 to 74,715,62,5,57,159,46,162,48,114,81,16,7,9,27
S01010674,Very good health,378,40,2,38,95,21,96,20,47,32,7,2,5,20
S01010674,Good health,250,14,2,12,53,19,52,22,49,30,6,2,4,5
S01010674,Fair health,67,5,0,5,11,4,13,5,13,11,3,3,0,2
S01010674,Bad health,17,3,1,2,0,2,1,1,4,6,0,0,0,0
S01010674,Very bad health,3,0,0,0,0,0,0,0,1,2,0,0,0,0
S01010675,All people aged 16 to 74,480,37,8,29,104,34,105,36,74,63,11,1,10,16
S01010675,Very good health,249,23,6,17,63,14,51,16,34,30,5,1,4,13
S01010675,Good health,159,12,2,10,20,13,43,15,29,21,4,0,4,2
S01010675,Fair health,59,2,0,2,15,6,11,4,10,9,2,0,2,0
S01010675,Bad health,9,0,0,0,3,1,0,1,1,2,0,0,0,1
S01010675,Very bad health,4,0,0,0,3,0,0,0,0,1,0,0,0,0
S01010676,All people aged 16 to 74,713,64,11,53,172,62,119,59,89,65,12,8,4,71
S01010676,Very good health,391,43,10,33,97,33,57,40,39,27,3,2,1,52
S01010676,Good health,224,14,1,13,53,20,47,15,32,22,5,3,2,16
S01010676,Fair health,72,5,0,5,15,8,13,2,12,12,2,1,1,3
S01010676,Bad health,23,2,0,2,7,1,2,1,5,3,2,2,0,0
S01010676,Very bad health,3,0,0,0,0,0,0,1,1,1,0,0,0,0
S01010677,All people aged 16 to 74,363,32,4,28,96,36,63,27,47,42,3,1,2,17
S01010677,Very good health,206,15,3,12,53,17,35,20,25,25,1,1,0,15
S01010677,Good health,117,13,1,12,34,12,22,5,17,11,2,0,2,1
S01010677,Fair health,32,2,0,2,8,5,5,1,4,6,0,0,0,1
S01010677,Bad health,5,2,0,2,0,1,1,1,0,0,0,0,0,0
S01010677,Very bad health,3,0,0,0,1,1,0,0,1,0,0,0,0,0
S01010678,All people aged 16 to 74,472,24,4,20,101,46,76,44,79,73,14,8,6,15
S01010678,Very good health,226,12,1,11,52,24,37,14,41,34,2,0,2,10
S01010678,Good health,166,10,2,8,38,17,30,20,23,20,6,3,3,2
S01010678,Fair health,60,1,0,1,10,3,5,8,10,15,6,5,1,2
S01010678,Bad health,16,1,1,0,1,2,1,2,4,4,0,0,0,1
S01010678,Very bad health,4,0,0,0,0,0,3,0,1,0,0,0,0,0
S01010679,All people aged 16 to 74,421,23,4,19,95,42,61,46,67,51,14,6,8,22
S01010679,Very good health,223,15,3,12,54,29,32,19,34,19,6,2,4,15
S01010679,Good health,122,6,0,6,25,8,17,15,23,18,5,3,2,5
S01010679,Fair health,59,2,1,1,10,4,10,9,6,14,3,1,2,1
S01010679,Bad health,12,0,0,0,4,1,1,3,3,0,0,0,0,0
S01010679,Very bad health,5,0,0,0,2,0,1,0,1,0,0,0,0,1
S01010680,All people aged 16 to 74,472,20,1,19,89,44,74,36,93,84,15,8,7,17
S01010680,Very good health,220,12,0,12,54,25,36,12,31,36,2,0,2,12
S01010680,Good health,151,6,0,6,21,12,28,11,39,24,7,4,3,3
S01010680,Fair health,68,1,0,1,10,4,6,7,19,14,6,4,2,1
S01010680,Bad health,27,1,1,0,3,3,4,4,4,7,0,0,0,1
S01010680,Very bad health,6,0,0,0,1,0,0,2,0,3,0,0,0,0
S01010681,All people aged 16 to 74,759,23,8,15,159,82,87,75,151,102,43,21,22,37
S01010681,Very good health,423,13,3,10,101,51,44,41,78,51,12,2,10,32
S01010681,Good health,216,7,4,3,34,26,31,23,46,29,15,7,8,5
S01010681,Fair health,92,2,0,2,22,2,8,5,24,16,13,9,4,0
S01010681,Bad health,24,1,1,0,2,3,4,5,2,4,3,3,0,0
S01010681,Very bad health,4,0,0,0,0,0,0,1,1,2,0,0,0,0
S01010682,All people aged 16 to 74,731,50,7,43,168,82,141,52,100,97,17,9,8,24
S01010682,Very good health,368,32,5,27,99,40,60,19,47,49,6,3,3,16
S01010682,Good health,268,12,2,10,53,36,57,25,40,33,5,2,3,7
S01010682,Fair health,73,3,0,3,13,6,19,6,7,13,5,3,2,1
S01010682,Bad health,19,2,0,2,3,0,4,2,5,2,1,1,0,0
S01010682,Very bad health,3,1,0,1,0,0,1,0,1,0,0,0,0,0
S01010683,All people aged 16 to 74,738,37,7,30,166,71,139,49,116,102,27,13,14,31
S01010683,Very good health,378,23,3,20,90,32,67,34,55,44,13,4,9,20
S01010683,Good health,243,12,4,8,58,28,49,10,44,30,6,4,2,6
S01010683,Fair health,90,1,0,1,15,9,17,5,10,21,8,5,3,4
S01010683,Bad health,20,1,0,1,2,1,5,0,6,4,0,0,0,1
S01010683,Very bad health,7,0,0,0,1,1,1,0,1,3,0,0,0,0
S01010684,All people aged 16 to 74,612,35,9,26,147,56,142,56,85,63,14,8,6,14
S01010684,Very good health,290,20,3,17,71,26,61,28,43,26,6,4,2,9
S01010684,Good health,234,8,2,6,56,27,61,20,29,26,5,1,4,2
S01010684,Fair health,65,7,4,3,16,1,14,5,10,8,1,1,0,3
S01010684,Bad health,17,0,0,0,4,2,3,2,2,2,2,2,0,0
S01010684,Very bad health,6,0,0,0,0,0,3,1,1,1,0,0,0,0
S01010685,All people aged 16 to 74,472,45,7,38,104,48,104,35,68,41,12,5,7,15
S01010685,Very good health,232,27,4,23,56,25,53,14,29,10,5,1,4,13
S01010685,Good health,152,11,2,9,30,16,39,13,23,14,4,1,3,2
S01010685,Fair health,66,5,0,5,14,5,8,5,14,13,2,2,0,0
S01010685,Bad health,17,2,1,1,2,2,4,3,1,3,0,0,0,0
S01010685,Very bad health,5,0,0,0,2,0,0,0,1,1,1,1,0,0
S01010686,All people aged 16 to 74,523,34,4,30,101,41,115,63,80,53,12,6,6,24
S01010686,Very good health,257,11,1,10,57,22,59,36,31,20,4,0,4,17
S01010686,Good health,165,15,2,13,29,12,39,19,28,17,3,1,2,3
S01010686,Fair health,77,5,0,5,11,4,14,8,15,14,4,4,0,2
S01010686,Bad health,17,1,1,0,3,3,2,0,5,1,1,1,0,1
S01010686,Very bad health,7,2,0,2,1,0,1,0,1,1,0,0,0,1
S01010687,All people aged 16 to 74,607,42,10,32,142,67,101,60,99,65,10,9,1,21
S01010687,Very good health,299,24,7,17,73,31,45,30,49,30,2,2,0,15
S01010687,Good health,211,12,1,11,54,29,36,21,32,22,1,1,0,4
S01010687,Fair health,57,5,2,3,6,3,16,4,9,8,4,3,1,2
S01010687,Bad health,30,1,0,1,6,4,3,2,9,3,2,2,0,0
S01010687,Very bad health,10,0,0,0,3,0,1,3,0,2,1,1,0,0
S01010688,All people aged 16 to 74,560,48,8,40,143,49,140,48,57,52,3,0,3,20
S01010688,Very good health,293,24,5,19,82,23,65,29,26,30,1,0,1,13
S01010688,Good health,198,21,3,18,42,19,52,15,26,15,2,0,2,6
S01010688,Fair health,57,3,0,3,16,3,20,3,4,7,0,0,0,1
S01010688,Bad health,9,0,0,0,3,3,1,1,1,0,0,0,0,0
S01010688,Very bad health,3,0,0,0,0,1,2,0,0,0,0,0,0,0
S01010689,All people aged 16 to 74,557,53,9,44,141,44,113,46,87,48,8,5,3,17
S01010689,Very good health,261,22,4,18,72,23,47,22,40,20,4,3,1,11
S01010689,Good health,207,26,5,21,54,15,48,17,30,11,2,1,1,4
S01010689,Fair health,66,5,0,5,11,2,14,7,10,13,2,1,1,2
S01010689,Bad health,15,0,0,0,3,4,4,0,2,2,0,0,0,0
S01010689,Very bad health,8,0,0,0,1,0,0,0,5,2,0,0,0,0
S01010690,All people aged 16 to 74,466,21,4,17,84,41,96,56,89,55,11,5,6,13
S01010690,Very good health,221,9,1,8,48,17,48,18,37,27,6,2,4,11
S01010690,Good health,177,8,0,8,28,19,30,29,40,18,4,2,2,1
S01010690,Fair health,52,3,3,0,8,5,11,6,11,7,0,0,0,1
S01010690,Bad health,12,1,0,1,0,0,3,3,1,3,1,1,0,0
S01010690,Very bad health,4,0,0,0,0,0,4,0,0,0,0,0,0,0
S01010691,All people aged 16 to 74,563,58,15,43,119,67,141,58,54,37,11,6,5,18
S01010691,Very good health,323,33,10,23,70,35,72,40,34,18,8,4,4,13
S01010691,Good health,172,19,3,16,34,22,54,12,10,14,2,2,0,5
S01010691,Fair health,50,2,0,2,13,6,13,6,6,3,1,0,1,0
S01010691,Bad health,14,2,1,1,2,3,2,0,3,2,0,0,0,0
S01010691,Very bad health,4,2,1,1,0,1,0,0,1,0,0,0,0,0
S01010692,All people aged 16 to 74,538,28,3,25,95,44,88,77,107,64,7,3,4,28
S01010692,Very good health,279,15,2,13,52,23,49,37,45,35,2,1,1,21
S01010692,Good health,172,10,1,9,28,17,32,22,42,16,2,1,1,3
S01010692,Fair health,68,1,0,1,10,3,6,15,14,12,3,1,2,4
S01010692,Bad health,10,1,0,1,2,1,0,2,4,0,0,0,0,0
S01010692,Very bad health,9,1,0,1,3,0,1,1,2,1,0,0,0,0
S01010693,All people aged 16 to 74,363,39,12,27,94,36,82,25,38,26,6,4,2,17
S01010693,Very good health,177,20,7,13,47,18,33,16,14,10,2,1,1,17
S01010693,Good health,135,14,5,9,31,14,38,5,20,10,3,2,1,0
S01010693,Fair health,38,3,0,3,13,4,11,1,2,3,1,1,0,0
S01010693,Bad health,9,2,0,2,2,0,0,3,1,1,0,0,0,0
S01010693,Very bad health,4,0,0,0,1,0,0,0,1,2,0,0,0,0
S01010694,All people aged 16 to 74,425,34,4,30,89,30,81,37,78,51,6,3,3,19
S01010694,Very good health,204,13,2,11,41,9,37,18,38,29,3,2,1,16
S01010694,Good health,133,13,1,12,26,13,31,8,25,14,1,0,1,2
S01010694,Fair health,62,5,1,4,17,5,12,7,12,2,1,1,0,1
S01010694,Bad health,18,1,0,1,5,3,1,2,2,3,1,0,1,0
S01010694,Very bad health,8,2,0,2,0,0,0,2,1,3,0,0,0,0
S01010695,All people aged 16 to 74,545,51,8,43,130,68,92,47,79,41,14,12,2,23
S01010695,Very good health,330,33,6,27,85,39,49,28,46,25,6,5,1,19
S01010695,Good health,161,17,2,15,33,26,35,13,17,10,6,5,1,4
S01010695,Fair health,45,1,0,1,11,3,8,5,13,3,1,1,0,0
S01010695,Bad health,4,0,0,0,0,0,0,0,1,3,0,0,0,0
S01010695,Very bad health,5,0,0,0,1,0,0,1,2,0,1,1,0,0
S01010696,All people aged 16 to 74,721,65,7,58,140,83,93,74,97,117,21,14,7,31
S01010696,Very good health,398,41,5,36,80,44,42,47,48,63,5,4,1,28
S01010696,Good health,237,16,2,14,48,30,44,18,34,36,8,6,2,3
S01010696,Fair health,71,6,0,6,8,8,7,8,13,15,6,2,4,0
S01010696,Bad health,12,2,0,2,2,1,0,1,2,2,2,2,0,0
S01010696,Very bad health,3,0,0,0,2,0,0,0,0,1,0,0,0,0
S01010697,All people aged 16 to 74,845,79,8,71,189,83,121,91,100,89,53,44,9,40
S01010697,Very good health,424,48,5,43,114,38,68,36,47,30,10,4,6,33
S01010697,Good health,268,22,2,20,55,36,34,37,36,42,4,2,2,2
S01010697,Fair health,83,5,1,4,15,6,11,11,16,12,4,3,1,3
S01010697,Bad health,37,1,0,1,5,1,7,4,1,1,16,16,0,1
S01010697,Very bad health,33,3,0,3,0,2,1,3,0,4,19,19,0,1
S01010698,All people aged 16 to 74,560,49,12,37,103,51,92,59,90,76,14,9,5,26
S01010698,Very good health,248,24,5,19,48,24,39,23,38,30,6,3,3,16
S01010698,Good health,199,18,5,13,36,16,34,23,36,24,3,1,2,9
S01010698,Fair health,83,3,0,3,15,9,11,7,15,17,5,5,0,1
S01010698,Bad health,24,3,2,1,3,1,6,6,1,4,0,0,0,0
S01010698,Very bad health,6,1,0,1,1,1,2,0,0,1,0,0,0,0
S01010699,All people aged 16 to 74,463,41,12,29,98,36,72,63,74,42,11,7,4,26
S01010699,Very good health,267,29,9,20,57,19,34,43,39,21,4,4,0,21
S01010699,Good health,139,9,2,7,30,11,31,13,24,12,4,1,3,5
S01010699,Fair health,39,3,1,2,7,6,5,4,9,5,0,0,0,0
S01010699,Bad health,13,0,0,0,3,0,1,1,1,4,3,2,1,0
S01010699,Very bad health,5,0,0,0,1,0,1,2,1,0,0,0,0,0
S01010700,All people aged 16 to 74,457,53,13,40,107,55,57,37,78,44,3,0,3,23
S01010700,Very good health,237,37,5,32,59,29,26,25,27,18,1,0,1,15
S01010700,Good health,156,12,7,5,40,17,18,9,39,15,1,0,1,5
S01010700,Fair health,47,4,1,3,7,6,13,1,6,7,1,0,1,2
S01010700,Bad health,16,0,0,0,1,2,0,2,6,4,0,0,0,1
S01010700,Very bad health,1,0,0,0,0,1,0,0,0,0,0,0,0,0
S01010701,All people aged 16 to 74,774,59,9,50,181,97,71,68,127,107,19,11,8,45
S01010701,Very good health,423,35,6,29,94,57,37,35,64,54,10,4,6,37
S01010701,Good health,244,20,2,18,62,28,25,22,40,34,5,3,2,8
S01010701,Fair health,72,2,1,1,16,9,5,8,18,12,2,2,0,0
S01010701,Bad health,29,2,0,2,9,3,3,3,4,4,1,1,0,0
S01010701,Very bad health,6,0,0,0,0,0,1,0,1,3,1,1,0,0
S01010702,All people aged 16 to 74,747,54,17,37,195,101,104,67,111,63,18,13,5,34
S01010702,Very good health,389,30,7,23,109,47,52,35,50,34,6,6,0,26
S01010702,Good health,241,17,6,11,60,38,35,23,41,15,6,2,4,6
S01010702,Fair health,84,5,2,3,20,12,16,7,14,6,2,2,0,2
S01010702,Bad health,31,2,2,0,6,4,1,2,6,8,2,1,1,0
S01010702,Very bad health,2,0,0,0,0,0,0,0,0,0,2,2,0,0
S01010703,All people aged 16 to 74,642,48,12,36,166,81,105,54,77,63,12,8,4,36
S01010703,Very good health,359,24,5,19,97,42,58,28,36,40,5,3,2,29
S01010703,Good health,190,17,4,13,47,29,28,20,25,16,4,2,2,4
S01010703,Fair health,74,5,2,3,17,8,15,5,14,5,2,2,0,3
S01010703,Bad health,15,2,1,1,3,2,2,1,2,2,1,1,0,0
S01010703,Very bad health,4,0,0,0,2,0,2,0,0,0,0,0,0,0
S01010704,All people aged 16 to 74,471,27,5,22,80,57,31,54,99,88,14,12,2,21
S01010704,Very good health,225,18,3,15,48,29,14,21,42,35,2,2,0,16
S01010704,Good health,151,7,1,6,21,19,10,24,39,23,4,3,1,4
S01010704,Fair health,68,2,1,1,9,8,4,6,15,18,5,4,1,1
S01010704,Bad health,20,0,0,0,2,1,2,3,2,8,2,2,0,0
S01010704,Very bad health,7,0,0,0,0,0,1,0,1,4,1,1,0,0
S01010705,All people aged 16 to 74,819,62,15,47,171,109,79,93,124,104,33,15,18,44
S01010705,Very good health,479,41,8,33,98,72,48,47,61,63,14,3,11,35
S01010705,Good health,225,16,7,9,54,30,21,28,38,24,6,4,2,8
S01010705,Fair health,89,3,0,3,16,5,7,13,19,14,11,7,4,1
S01010705,Bad health,18,1,0,1,2,2,1,5,3,3,1,0,1,0
S01010705,Very bad health,8,1,0,1,1,0,2,0,3,0,1,1,0,0
S01010706,All people aged 16 to 74,490,17,6,11,95,64,44,49,98,72,28,14,14,23
S01010706,Very good health,267,10,4,6,59,41,22,28,43,33,13,5,8,18
S01010706,Good health,150,4,1,3,25,18,14,16,36,23,10,6,4,4
S01010706,Fair health,50,2,0,2,9,5,5,2,15,7,4,2,2,1
S01010706,Bad health,19,1,1,0,1,0,2,3,3,8,1,1,0,0
S01010706,Very bad health,4,0,0,0,1,0,1,0,1,1,0,0,0,0
S01010707,All people aged 16 to 74,540,54,7,47,121,76,96,45,60,41,18,17,1,29
S01010707,Very good health,313,35,4,31,71,44,49,28,34,25,1,1,0,26
S01010707,Good health,145,13,3,10,36,21,31,11,13,9,10,9,1,1
S01010707,Fair health,63,4,0,4,13,9,11,4,11,5,5,5,0,1
S01010707,Bad health,15,2,0,2,1,1,4,1,2,2,1,1,0,1
S01010707,Very bad health,4,0,0,0,0,1,1,1,0,0,1,1,0,0
S01010708,All people aged 16 to 74,412,24,1,23,88,72,48,44,65,42,13,9,4,16
S01010708,Very good health,200,11,0,11,48,34,23,22,30,19,2,1,1,11
S01010708,Good health,160,11,1,10,34,33,18,16,25,12,6,4,2,5
S01010708,Fair health,38,1,0,1,6,4,7,4,7,6,3,2,1,0
S01010708,Bad health,12,1,0,1,0,0,0,1,3,5,2,2,0,0
S01010708,Very bad health,2,0,0,0,0,1,0,1,0,0,0,0,0,0
S01010709,All people aged 16 to 74,534,44,9,35,121,88,46,46,81,60,14,5,9,34
S01010709,Very good health,311,25,3,22,66,54,24,24,44,39,9,3,6,26
S01010709,Good health,164,13,3,10,42,26,14,20,25,15,3,2,1,6
S01010709,Fair health,46,6,3,3,11,6,7,1,9,4,1,0,1,1
S01010709,Bad health,9,0,0,0,0,2,0,1,3,1,1,0,1,1
S01010709,Very bad health,4,0,0,0,2,0,1,0,0,1,0,0,0,0
S01010710,All people aged 16 to 74,553,16,1,15,92,70,37,52,111,112,30,20,10,33
S01010710,Very good health,247,8,1,7,40,28,17,26,44,47,11,7,4,26
S01010710,Good health,186,7,0,7,34,27,8,17,43,36,10,4,6,4
S01010710,Fair health,87,1,0,1,15,10,8,5,15,23,7,7,0,3
S01010710,Bad health,23,0,0,0,2,4,3,3,6,4,1,1,0,0
S01010710,Very bad health,10,0,0,0,1,1,1,1,3,2,1,1,0,0
S01010711,All people aged 16 to 74,544,71,14,57,167,87,49,30,75,39,7,5,2,19
S01010711,Very good health,310,42,8,34,89,52,23,16,46,25,2,1,1,15
S01010711,Good health,180,25,4,21,63,26,18,9,25,10,1,0,1,3
S01010711,Fair health,43,3,1,2,12,8,5,4,4,3,3,3,0,1
S01010711,Bad health,6,0,0,0,3,0,1,1,0,0,1,1,0,0
S01010711,Very bad health,5,1,1,0,0,1,2,0,0,1,0,0,0,0
S01010712,All people aged 16 to 74,525,20,7,13,75,69,28,64,104,106,21,14,7,38
S01010712,Very good health,285,15,7,8,41,41,14,31,50,56,7,4,3,30
S01010712,Good health,156,5,0,5,24,22,6,24,39,25,5,2,3,6
S01010712,Fair health,56,0,0,0,7,6,6,6,10,14,5,4,1,2
S01010712,Bad health,18,0,0,0,2,0,2,3,3,6,2,2,0,0
S01010712,Very bad health,10,0,0,0,1,0,0,0,2,5,2,2,0,0
S01010713,All people aged 16 to 74,585,25,9,16,93,64,40,70,137,112,17,10,7,27
S01010713,Very good health,336,15,7,8,51,42,24,49,69,58,8,4,4,20
S01010713,Good health,172,4,0,4,32,19,6,17,47,39,3,1,2,5
S01010713,Fair health,55,6,2,4,7,1,6,4,15,12,3,2,1,1
S01010713,Bad health,16,0,0,0,3,0,3,0,3,3,3,3,0,1
S01010713,Very bad health,6,0,0,0,0,2,1,0,3,0,0,0,0,0
S01010714,All people aged 16 to 74,531,21,6,15,66,58,37,61,112,120,27,17,10,29
S01010714,Very good health,238,10,3,7,38,23,18,32,44,43,8,4,4,22
S01010714,Good health,165,9,1,8,17,25,13,17,39,35,7,4,3,3
S01010714,Fair health,87,1,1,0,10,9,4,7,19,25,8,6,2,4
S01010714,Bad health,27,1,1,0,1,1,2,2,7,11,2,1,1,0
S01010714,Very bad health,14,0,0,0,0,0,0,3,3,6,2,2,0,0
S01010715,All people aged 16 to 74,511,24,4,20,81,65,41,58,124,85,17,4,13,16
S01010715,Very good health,248,14,1,13,41,42,14,28,63,27,7,2,5,12
S01010715,Good health,177,9,3,6,33,14,21,14,40,37,5,0,5,4
S01010715,Fair health,62,1,0,1,6,5,5,10,15,16,4,1,3,0
S01010715,Bad health,18,0,0,0,1,4,1,5,5,2,0,0,0,0
S01010715,Very bad health,6,0,0,0,0,0,0,1,1,3,1,1,0,0
S01010716,All people aged 16 to 74,649,46,6,40,127,81,46,55,130,113,27,16,11,24
S01010716,Very good health,282,25,5,20,66,44,26,22,44,33,5,3,2,17
S01010716,Good health,257,16,1,15,39,25,11,21,67,59,13,8,5,6
S01010716,Fair health,76,4,0,4,15,7,7,7,15,13,7,3,4,1
S01010716,Bad health,28,1,0,1,6,4,2,3,4,7,1,1,0,0
S01010716,Very bad health,6,0,0,0,1,1,0,2,0,1,1,1,0,0
S01010717,All people aged 16 to 74,472,49,11,38,129,84,33,39,76,34,7,5,2,21
S01010717,Very good health,259,28,8,20,71,46,23,14,47,11,3,2,1,16
S01010717,Good health,163,19,3,16,46,31,9,18,15,18,2,1,1,5
S01010717,Fair health,44,2,0,2,11,7,0,7,11,5,1,1,0,0
S01010717,Bad health,4,0,0,0,0,0,1,0,2,0,1,1,0,0
S01010717,Very bad health,2,0,0,0,1,0,0,0,1,0,0,0,0,0
S01010718,All people aged 16 to 74,702,45,6,39,175,103,66,68,108,75,25,14,11,37
S01010718,Very good health,355,24,3,21,93,58,35,29,47,31,10,6,4,28
S01010718,Good health,267,19,3,16,65,27,29,27,46,32,14,7,7,8
S01010718,Fair health,64,2,0,2,15,12,2,8,12,11,1,1,0,1
S01010718,Bad health,11,0,0,0,1,4,0,3,3,0,0,0,0,0
S01010718,Very bad health,5,0,0,0,1,2,0,1,0,1,0,0,0,0
S01010719,All people aged 16 to 74,460,54,8,46,103,49,44,48,70,53,11,7,4,28
S01010719,Very good health,222,24,4,20,49,22,25,16,31,26,6,3,3,23
S01010719,Good health,181,26,4,22,44,20,16,24,28,17,3,3,0,3
S01010719,Fair health,41,3,0,3,8,5,0,5,10,8,2,1,1,0
S01010719,Bad health,15,1,0,1,1,2,3,3,1,2,0,0,0,2
S01010719,Very bad health,1,0,0,0,1,0,0,0,0,0,0,0,0,0
S01010720,All people aged 16 to 74,520,80,13,67,131,46,62,38,74,48,10,8,2,31
S01010720,Very good health,256,39,5,34,75,26,26,20,24,17,7,5,2,22
S01010720,Good health,191,36,8,28,40,18,22,14,30,21,3,3,0,7
S01010720,Fair health,59,4,0,4,14,2,13,4,14,6,0,0,0,2
S01010720,Bad health,10,1,0,1,2,0,1,0,4,2,0,0,0,0
S01010720,Very bad health,4,0,0,0,0,0,0,0,2,2,0,0,0,0
S01010721,All people aged 16 to 74,477,57,7,50,137,60,62,32,62,36,12,8,4,19
S01010721,Very good health,256,29,4,25,74,28,28,19,39,20,4,3,1,15
S01010721,Good health,165,18,3,15,53,25,24,9,20,11,2,0,2,3
S01010721,Fair health,41,6,0,6,8,5,7,3,3,4,5,5,0,0
S01010721,Bad health,14,4,0,4,2,2,2,1,0,1,1,0,1,1
S01010721,Very bad health,1,0,0,0,0,0,1,0,0,0,0,0,0,0
S01010722,All people aged 16 to 74,605,57,12,45,155,61,67,60,100,49,14,7,7,42
S01010722,Very good health,284,40,8,32,67,23,32,29,40,18,5,2,3,30
S01010722,Good health,232,12,3,9,68,32,23,23,35,26,4,2,2,9
S01010722,Fair health,75,5,1,4,14,5,12,7,21,3,5,3,2,3
S01010722,Bad health,10,0,0,0,5,0,0,1,3,1,0,0,0,0
S01010722,Very bad health,4,0,0,0,1,1,0,0,1,1,0,0,0,0
S01010723,All people aged 16 to 74,671,93,23,70,166,73,108,49,79,46,10,6,4,47
S01010723,Very good health,413,71,14,57,95,44,64,34,41,21,4,3,1,39
S01010723,Good health,208,19,7,12,62,23,33,12,27,20,5,3,2,7
S01010723,Fair health,35,3,2,1,6,3,10,0,8,4,0,0,0,1
S01010723,Bad health,12,0,0,0,3,3,1,2,2,0,1,0,1,0
S01010723,Very bad health,3,0,0,0,0,0,0,1,1,1,0,0,0,0
S01010724,All people aged 16 to 74,635,79,20,59,149,77,88,51,88,60,12,4,8,31
S01010724,Very good health,330,38,10,28,91,47,41,26,34,25,5,1,4,23
S01010724,Good health,225,33,8,25,46,21,32,21,40,18,6,3,3,8
S01010724,Fair health,61,7,1,6,11,8,10,2,11,11,1,0,1,0
S01010724,Bad health,14,1,1,0,1,1,3,0,3,5,0,0,0,0
S01010724,Very bad health,5,0,0,0,0,0,2,2,0,1,0,0,0,0
S01010725,All people aged 16 to 74,554,79,15,64,142,65,106,29,61,32,7,5,2,33
S01010725,Very good health,326,48,7,41,87,37,64,8,31,17,3,3,0,31
S01010725,Good health,165,25,6,19,41,18,32,16,21,10,1,1,0,1
S01010725,Fair health,54,6,2,4,12,9,7,4,9,4,2,0,2,1
S01010725,Bad health,8,0,0,0,2,1,3,1,0,0,1,1,0,0
S01010725,Very bad health,1,0,0,0,0,0,0,0,0,1,0,0,0,0
S01010726,All people aged 16 to 74,697,70,18,52,189,97,81,53,95,60,13,7,6,39
S01010726,Very good health,375,45,13,32,114,48,33,26,48,30,2,2,0,29
S01010726,Good health,226,19,3,16,58,40,29,22,29,17,3,1,2,9
S01010726,Fair health,72,3,2,1,14,7,14,2,13,11,7,3,4,1
S01010726,Bad health,21,3,0,3,3,1,5,2,4,2,1,1,0,0
S01010726,Very bad health,3,0,0,0,0,1,0,1,1,0,0,0,0,0
S01010727,All people aged 16 to 74,491,72,21,51,123,73,66,28,57,34,7,5,2,31
S01010727,Very good health,290,49,12,37,76,37,35,14,30,19,3,1,2,27
S01010727,Good health,127,14,3,11,34,22,19,8,17,10,0,0,0,3
S01010727,Fair health,46,6,3,3,8,8,8,5,5,2,3,3,0,1
S01010727,Bad health,20,2,2,0,3,5,3,1,3,3,0,0,0,0
S01010727,Very bad health,8,1,1,0,2,1,1,0,2,0,1,1,0,0
S01010728,All people aged 16 to 74,388,48,12,36,124,45,46,27,44,20,9,3,6,25
S01010728,Very good health,224,30,8,22,77,21,25,17,19,10,4,1,3,21
S01010728,Good health,117,14,4,10,35,19,15,7,17,5,3,0,3,2
S01010728,Fair health,38,4,0,4,10,4,4,3,7,3,2,2,0,1
S01010728,Bad health,8,0,0,0,2,1,2,0,1,1,0,0,0,1
S01010728,Very bad health,1,0,0,0,0,0,0,0,0,1,0,0,0,0
S01010729,All people aged 16 to 74,558,67,15,52,132,80,79,49,57,57,7,3,4,30
S01010729,Very good health,284,41,5,36,75,33,41,24,27,17,3,1,2,23
S01010729,Good health,190,19,7,12,39,39,29,15,18,21,3,1,2,7
S01010729,Fair health,65,6,3,3,13,8,8,7,10,13,0,0,0,0
S01010729,Bad health,18,1,0,1,5,0,0,3,2,6,1,1,0,0
S01010729,Very bad health,1,0,0,0,0,0,1,0,0,0,0,0,0,0
S01010730,All people aged 16 to 74,651,64,12,52,189,80,113,47,51,54,11,7,4,42
S01010730,Very good health,359,35,4,31,109,39,54,24,26,29,6,3,3,37
S01010730,Good health,232,23,8,15,68,32,47,19,18,17,3,2,1,5
S01010730,Fair health,44,3,0,3,11,7,8,3,5,6,1,1,0,0
S01010730,Bad health,16,3,0,3,1,2,4,1,2,2,1,1,0,0
S01010730,Very bad health,0,0,0,0,0,0,0,0,0,0,0,0,0,0
S01010731,All people aged 16 to 74,679,62,12,50,154,64,89,58,106,83,19,7,12,44
S01010731,Very good health,337,29,4,25,80,31,52,23,48,37,5,2,3,32
S01010731,Good health,237,28,5,23,54,27,27,27,32,24,8,3,5,10
S01010731,Fair health,75,5,3,2,16,5,4,6,16,17,4,2,2,2
S01010731,Bad health,23,0,0,0,4,1,6,2,6,3,1,0,1,0
S01010731,Very bad health,7,0,0,0,0,0,0,0,4,2,1,0,1,0
S01010732,All people aged 16 to 74,621,20,3,17,60,67,43,71,152,129,43,26,17,36
S01010732,Very good health,263,13,2,11,34,33,13,36,60,43,11,7,4,20
S01010732,Good health,202,3,1,2,14,20,22,16,48,47,17,5,12,15
S01010732,Fair health,99,4,0,4,8,10,5,12,28,26,5,5,0,1
S01010732,Bad health,40,0,0,0,3,2,1,6,11,10,7,6,1,0
S01010732,Very bad health,17,0,0,0,1,2,2,1,5,3,3,3,0,0
S01010733,All people aged 16 to 74,414,6,1,5,44,49,22,44,108,85,36,25,11,20
S01010733,Very good health,168,2,1,1,20,24,7,16,42,29,15,11,4,13
S01010733,Good health,145,2,0,2,16,16,11,12,39,31,13,7,6,5
S01010733,Fair health,65,1,0,1,5,6,3,12,18,14,5,4,1,1
S01010733,Bad health,31,1,0,1,3,3,1,4,5,11,3,3,0,0
S01010733,Very bad health,5,0,0,0,0,0,0,0,4,0,0,0,0,1
S01010734,All people aged 16 to 74,665,25,7,18,80,55,42,62,153,150,52,41,11,46
S01010734,Very good health,275,11,3,8,42,29,19,14,64,58,12,10,2,26
S01010734,Good health,235,9,2,7,27,20,18,27,52,49,15,9,6,18
S01010734,Fair health,102,4,2,2,9,4,4,11,22,28,18,15,3,2
S01010734,Bad health,39,1,0,1,2,1,0,8,12,8,7,7,0,0
S01010734,Very bad health,14,0,0,0,0,1,1,2,3,7,0,0,0,0
S01010735,All people aged 16 to 74,447,13,4,9,62,31,24,42,96,106,50,36,14,23
S01010735,Very good health,186,9,4,5,34,13,9,20,33,31,20,14,6,17
S01010735,Good health,165,4,0,4,18,8,7,12,42,51,19,13,6,4
S01010735,Fair health,61,0,0,0,7,8,6,6,13,15,4,2,2,2
S01010735,Bad health,26,0,0,0,2,2,2,3,8,7,2,2,0,0
S01010735,Very bad health,9,0,0,0,1,0,0,1,0,2,5,5,0,0
S01010736,All people aged 16 to 74,391,26,4,22,102,50,33,44,74,43,5,2,3,14
S01010736,Very good health,205,16,2,14,60,25,12,28,34,19,2,1,1,9
S01010736,Good health,131,9,2,7,31,18,15,9,30,12,2,1,1,5
S01010736,Fair health,42,1,0,1,10,7,4,6,7,6,1,0,1,0
S01010736,Bad health,11,0,0,0,1,0,1,1,2,6,0,0,0,0
S01010736,Very bad health,2,0,0,0,0,0,1,0,1,0,0,0,0,0
S01010737,All people aged 16 to 74,804,41,6,35,150,80,63,81,152,153,40,28,12,44
S01010737,Very good health,343,19,0,19,66,37,27,38,67,46,9,4,5,34
S01010737,Good health,258,17,4,13,66,28,19,25,40,48,8,5,3,7
S01010737,Fair health,132,4,1,3,12,11,12,9,32,39,10,8,2,3
S01010737,Bad health,60,0,0,0,4,4,5,9,12,17,9,7,2,0
S01010737,Very bad health,11,1,1,0,2,0,0,0,1,3,4,4,0,0
S01010738,All people aged 16 to 74,411,11,2,9,55,44,26,52,92,96,17,14,3,18
S01010738,Very good health,150,6,2,4,22,18,11,21,32,27,3,1,2,10
S01010738,Good health,155,3,0,3,23,19,8,23,38,31,4,4,0,6
S01010738,Fair health,82,2,0,2,6,5,7,4,16,32,8,7,1,2
S01010738,Bad health,19,0,0,0,4,1,0,3,5,5,1,1,0,0
S01010738,Very bad health,5,0,0,0,0,1,0,1,1,1,1,1,0,0
S01010739,All people aged 16 to 74,643,30,1,29,111,61,46,82,122,129,36,24,12,26
S01010739,Very good health,292,15,1,14,57,26,28,35,56,45,15,8,7,15
S01010739,Good health,223,14,0,14,38,22,12,24,50,44,12,9,3,7
S01010739,Fair health,89,1,0,1,14,9,3,14,12,27,5,4,1,4
S01010739,Bad health,32,0,0,0,1,4,3,7,3,11,3,2,1,0
S01010739,Very bad health,7,0,0,0,1,0,0,2,1,2,1,1,0,0
S01010740,All people aged 16 to 74,361,8,3,5,45,40,12,33,90,89,35,21,14,9
S01010740,Very good health,126,2,1,1,20,18,5,7,35,27,8,4,4,4
S01010740,Good health,123,4,2,2,15,17,5,12,23,27,15,8,7,5
S01010740,Fair health,73,1,0,1,7,3,1,11,17,23,10,8,2,0
S01010740,Bad health,35,1,0,1,3,2,1,2,13,11,2,1,1,0
S01010740,Very bad health,4,0,0,0,0,0,0,1,2,1,0,0,0,0
S01010741,All people aged 16 to 74,439,23,4,19,83,54,48,48,75,66,18,10,8,24
S01010741,Very good health,208,14,4,10,39,28,26,18,32,30,4,1,3,17
S01010741,Good health,147,7,0,7,35,15,12,16,26,22,8,3,5,6
S01010741,Fair health,62,2,0,2,9,9,8,11,11,8,3,3,0,1
S01010741,Bad health,17,0,0,0,0,2,2,1,5,6,1,1,0,0
S01010741,Very bad health,5,0,0,0,0,0,0,2,1,0,2,2,0,0
S01010742,All people aged 16 to 74,516,24,5,19,70,53,17,69,132,94,33,19,14,24
S01010742,Very good health,245,14,2,12,34,29,9,38,55,40,9,6,3,17
S01010742,Good health,165,7,3,4,27,15,1,20,47,33,9,4,5,6
S01010742,Fair health,87,3,0,3,9,7,7,8,25,18,9,4,5,1
S01010742,Bad health,16,0,0,0,0,2,0,3,5,3,3,3,0,0
S01010742,Very bad health,3,0,0,0,0,0,0,0,0,0,3,2,1,0
S01010743,All people aged 16 to 74,499,12,1,11,63,45,19,67,123,94,47,33,14,29
S01010743,Very good health,258,4,1,3,43,26,8,32,56,40,22,15,7,27
S01010743,Good health,143,8,0,8,13,14,7,20,38,29,12,8,4,2
S01010743,Fair health,67,0,0,0,6,4,2,9,21,15,10,7,3,0
S01010743,Bad health,24,0,0,0,1,1,2,4,6,8,2,2,0,0
S01010743,Very bad health,7,0,0,0,0,0,0,2,2,2,1,1,0,0
S01010744,All people aged 16 to 74,796,36,9,27,179,74,63,102,139,127,29,19,10,47
S01010744,Very good health,369,12,1,11,73,36,22,55,74,51,9,7,2,37
S01010744,Good health,295,21,7,14,75,22,28,35,45,49,13,7,6,7
S01010744,Fair health,91,1,0,1,21,14,9,10,12,17,4,2,2,3
S01010744,Bad health,28,2,1,1,7,2,4,2,5,6,0,0,0,0
S01010744,Very bad health,13,0,0,0,3,0,0,0,3,4,3,3,0,0
S01010745,All people aged 16 to 74,465,26,6,20,79,52,39,59,85,84,23,14,9,18
S01010745,Very good health,218,17,5,12,33,21,20,31,43,29,10,6,4,14
S01010745,Good health,161,7,1,6,36,25,14,17,20,33,6,3,3,3
S01010745,Fair health,54,2,0,2,9,4,4,5,13,11,5,3,2,1
S01010745,Bad health,25,0,0,0,0,1,1,5,7,10,1,1,0,0
S01010745,Very bad health,7,0,0,0,1,1,0,1,2,1,1,1,0,0
S01010746,All people aged 16 to 74,777,49,15,34,161,95,108,73,132,92,26,20,6,41
S01010746,Very good health,380,25,8,17,94,54,54,36,51,32,7,5,2,27
S01010746,Good health,280,18,3,15,55,33,39,26,48,37,12,8,4,12
S01010746,Fair health,88,4,3,1,10,5,13,8,29,13,5,5,0,1
S01010746,Bad health,20,1,0,1,2,2,1,1,2,8,2,2,0,1
S01010746,Very bad health,9,1,1,0,0,1,1,2,2,2,0,0,0,0
S01010747,All people aged 16 to 74,622,32,9,23,100,70,46,70,125,108,40,26,14,31
S01010747,Very good health,277,19,7,12,59,34,19,29,57,27,13,8,5,20
S01010747,Good health,207,11,2,9,31,21,20,24,43,37,11,6,5,9
S01010747,Fair health,94,2,0,2,7,11,5,11,19,29,9,5,4,1
S01010747,Bad health,30,0,0,0,1,2,2,3,3,13,5,5,0,1
S01010747,Very bad health,14,0,0,0,2,2,0,3,3,2,2,2,0,0
S01010748,All people aged 16 to 74,479,29,7,22,95,61,75,43,82,56,17,12,5,21
S01010748,Very good health,231,12,3,9,39,39,30,19,45,20,8,6,2,19
S01010748,Good health,160,10,3,7,40,18,29,18,14,24,6,3,3,1
S01010748,Fair health,64,6,1,5,13,4,12,2,14,11,2,2,0,0
S01010748,Bad health,17,0,0,0,1,0,2,4,8,1,1,1,0,0
S01010748,Very bad health,7,1,0,1,2,0,2,0,1,0,0,0,0,1
S01010749,All people aged 16 to 74,467,37,10,27,93,54,65,43,63,72,15,6,9,25
S01010749,Very good health,243,21,7,14,54,33,27,22,30,29,8,3,5,19
S01010749,Good health,145,12,2,10,25,15,25,18,23,18,4,3,1,5
S01010749,Fair health,49,2,1,1,8,1,10,2,7,15,3,0,3,1
S01010749,Bad health,27,1,0,1,6,4,3,1,3,9,0,0,0,0
S01010749,Very bad health,3,1,0,1,0,1,0,0,0,1,0,0,0,0
S01010750,All people aged 16 to 74,481,33,6,27,108,48,84,40,83,56,20,14,6,9
S01010750,Very good health,215,14,3,11,49,26,37,19,32,27,5,4,1,6
S01010750,Good health,173,14,1,13,39,15,34,19,23,17,9,6,3,3
S01010750,Fair health,69,4,2,2,16,7,8,2,23,6,3,1,2,0
S01010750,Bad health,19,1,0,1,3,0,4,0,4,5,2,2,0,0
S01010750,Very bad health,5,0,0,0,1,0,1,0,1,1,1,1,0,0
S01010751,All people aged 16 to 74,534,17,2,15,60,57,48,65,110,111,50,32,18,16
S01010751,Very good health,231,11,0,11,28,28,22,27,38,55,10,5,5,12
S01010751,Good health,171,5,2,3,16,20,11,21,46,27,23,11,12,2
S01010751,Fair health,68,0,0,0,10,6,10,10,12,14,6,6,0,0
S01010751,Bad health,51,0,0,0,5,2,3,6,11,13,9,8,1,2
S01010751,Very bad health,13,1,0,1,1,1,2,1,3,2,2,2,0,0
S01010752,All people aged 16 to 74,544,23,2,21,96,62,40,63,105,104,27,15,12,24
S01010752,Very good health,257,9,1,8,44,34,14,33,43,49,11,4,7,20
S01010752,Good health,182,9,0,9,32,16,21,18,46,31,6,4,2,3
S01010752,Fair health,69,4,1,3,16,10,3,5,10,15,6,3,3,0
S01010752,Bad health,26,1,0,1,3,2,2,2,5,7,3,3,0,1
S01010752,Very bad health,10,0,0,0,1,0,0,5,1,2,1,1,0,0
S01010753,All people aged 16 to 74,765,35,7,28,136,75,79,82,147,105,57,38,19,49
S01010753,Very good health,373,22,3,19,63,47,35,38,68,37,20,13,7,43
S01010753,Good health,245,10,4,6,52,21,28,29,44,38,18,10,8,5
S01010753,Fair health,97,3,0,3,15,2,9,10,25,21,11,8,3,1
S01010753,Bad health,40,0,0,0,4,5,5,5,7,7,7,7,0,0
S01010753,Very bad health,10,0,0,0,2,0,2,0,3,2,1,0,1,0
S01010754,All people aged 16 to 74,473,30,8,22,85,47,45,53,98,74,21,14,7,20
S01010754,Very good health,189,17,5,12,40,17,20,19,26,30,6,3,3,14
S01010754,Good health,160,10,2,8,25,19,16,15,44,20,7,6,1,4
S01010754,Fair health,83,2,1,1,11,8,6,14,20,14,7,4,3,1
S01010754,Bad health,32,1,0,1,5,3,2,3,7,9,1,1,0,1
S01010754,Very bad health,9,0,0,0,4,0,1,2,1,1,0,0,0,0
S01010755,All people aged 16 to 74,456,20,2,18,72,54,39,60,110,75,11,9,2,15
S01010755,Very good health,196,9,0,9,31,33,14,28,36,32,2,2,0,11
S01010755,Good health,168,7,1,6,28,15,13,20,49,28,4,3,1,4
S01010755,Fair health,58,3,1,2,5,4,10,9,15,10,2,1,1,0
S01010755,Bad health,22,0,0,0,5,2,2,3,6,4,0,0,0,0
S01010755,Very bad health,12,1,0,1,3,0,0,0,4,1,3,3,0,0
S01010756,All people aged 16 to 74,477,36,5,31,107,76,61,38,79,46,11,6,5,23
S01010756,Very good health,269,21,2,19,62,43,32,17,44,26,5,3,2,19
S01010756,Good health,159,11,2,9,35,26,20,18,28,15,2,0,2,4
S01010756,Fair health,43,3,1,2,8,7,9,3,7,4,2,1,1,0
S01010756,Bad health,4,0,0,0,2,0,0,0,0,1,1,1,0,0
S01010756,Very bad health,2,1,0,1,0,0,0,0,0,0,1,1,0,0
S01010757,All people aged 16 to 74,569,39,12,27,106,71,101,65,87,66,17,13,4,17
S01010757,Very good health,287,19,7,12,53,37,52,33,43,30,7,5,2,13
S01010757,Good health,189,18,5,13,36,25,33,19,31,19,5,4,1,3
S01010757,Fair health,72,2,0,2,13,6,11,11,12,11,5,4,1,1
S01010757,Bad health,17,0,0,0,1,3,5,2,1,5,0,0,0,0
S01010757,Very bad health,4,0,0,0,3,0,0,0,0,1,0,0,0,0
S01010758,All people aged 16 to 74,506,37,12,25,104,56,76,58,74,57,11,5,6,33
S01010758,Very good health,229,23,8,15,52,22,28,26,31,21,4,0,4,22
S01010758,Good health,179,7,3,4,38,21,31,24,26,22,4,3,1,6
S01010758,Fair health,73,5,0,5,9,7,13,6,16,10,3,2,1,4
S01010758,Bad health,17,2,1,1,4,4,3,1,1,1,0,0,0,1
S01010758,Very bad health,8,0,0,0,1,2,1,1,0,3,0,0,0,0
S01010759,All people aged 16 to 74,439,22,3,19,76,48,45,50,84,69,12,7,5,33
S01010759,Very good health,261,15,2,13,49,27,27,33,41,38,5,2,3,26
S01010759,Good health,110,3,0,3,15,14,13,10,26,19,3,1,2,7
S01010759,Fair health,54,3,0,3,10,5,5,6,14,9,2,2,0,0
S01010759,Bad health,11,1,1,0,1,1,0,1,2,3,2,2,0,0
S01010759,Very bad health,3,0,0,0,1,1,0,0,1,0,0,0,0,0
S01010760,All people aged 16 to 74,397,44,11,33,91,44,42,40,56,50,15,9,6,15
S01010760,Very good health,207,22,8,14,52,24,21,20,31,17,7,4,3,13
S01010760,Good health,126,18,3,15,29,17,14,13,16,15,3,2,1,1
S01010760,Fair health,45,4,0,4,7,2,5,5,6,12,3,1,2,1
S01010760,Bad health,14,0,0,0,3,1,1,1,3,4,1,1,0,0
S01010760,Very bad health,5,0,0,0,0,0,1,1,0,2,1,1,0,0
S01010761,All people aged 16 to 74,402,38,10,28,80,30,65,54,70,31,15,5,10,19
S01010761,Very good health,201,18,6,12,49,17,25,28,28,12,7,1,6,17
S01010761,Good health,140,15,3,12,26,7,25,18,28,15,5,4,1,1
S01010761,Fair health,40,4,1,3,5,4,10,3,9,3,2,0,2,0
S01010761,Bad health,14,1,0,1,0,0,3,4,4,0,1,0,1,1
S01010761,Very bad health,7,0,0,0,0,2,2,1,1,1,0,0,0,0
S01010762,All people aged 16 to 74,435,26,8,18,95,55,81,35,70,43,8,6,2,22
S01010762,Very good health,213,11,3,8,62,31,25,14,34,14,4,3,1,18
S01010762,Good health,137,13,5,8,22,16,33,14,15,17,3,3,0,4
S01010762,Fair health,59,2,0,2,7,4,18,4,14,9,1,0,1,0
S01010762,Bad health,20,0,0,0,3,4,3,1,6,3,0,0,0,0
S01010762,Very bad health,6,0,0,0,1,0,2,2,1,0,0,0,0,0
S01010763,All people aged 16 to 74,475,30,4,26,89,52,81,41,67,68,23,9,14,24
S01010763,Very good health,233,16,3,13,46,24,38,19,31,33,7,1,6,19
S01010763,Good health,162,11,0,11,30,22,29,12,23,21,9,4,5,5
S01010763,Fair health,57,1,0,1,13,3,11,5,9,12,3,2,1,0
S01010763,Bad health,20,2,1,1,0,1,3,5,3,2,4,2,2,0
S01010763,Very bad health,3,0,0,0,0,2,0,0,1,0,0,0,0,0
S01010764,All people aged 16 to 74,429,35,8,27,98,43,80,40,64,43,6,4,2,20
S01010764,Very good health,214,20,5,15,54,18,37,22,32,11,3,2,1,17
S01010764,Good health,137,9,1,8,32,16,24,11,22,20,1,1,0,2
S01010764,Fair health,57,4,2,2,10,6,17,3,8,8,1,0,1,0
S01010764,Bad health,12,1,0,1,1,3,0,2,1,2,1,1,0,1
S01010764,Very bad health,9,1,0,1,1,0,2,2,1,2,0,0,0,0
S01010765,All people aged 16 to 74,746,52,15,37,133,74,120,72,135,104,20,13,7,36
S01010765,Very good health,355,31,8,23,66,30,54,39,55,43,8,5,3,29
S01010765,Good health,255,18,7,11,47,30,44,19,50,34,8,4,4,5
S01010765,Fair health,93,2,0,2,15,9,17,9,21,14,4,4,0,2
S01010765,Bad health,30,0,0,0,3,5,4,2,7,9,0,0,0,0
S01010765,Very bad health,13,1,0,1,2,0,1,3,2,4,0,0,0,0
S01010766,All people aged 16 to 74,560,28,5,23,122,55,77,59,99,74,21,11,10,25
S01010766,Very good health,263,16,2,14,59,21,35,29,46,28,9,6,3,20
S01010766,Good health,184,7,3,4,39,22,25,15,40,26,5,1,4,5
S01010766,Fair health,77,3,0,3,17,9,12,8,9,14,5,2,3,0
S01010766,Bad health,30,2,0,2,7,2,3,7,2,6,1,1,0,0
S01010766,Very bad health,6,0,0,0,0,1,2,0,2,0,1,1,0,0
S01010767,All people aged 16 to 74,506,22,4,18,80,48,48,65,99,101,26,15,11,17
S01010767,Very good health,218,11,3,8,33,22,16,32,38,46,8,6,2,12
S01010767,Good health,191,8,1,7,34,19,20,20,41,35,10,4,6,4
S01010767,Fair health,64,3,0,3,10,7,8,5,15,10,5,3,2,1
S01010767,Bad health,28,0,0,0,2,0,4,7,5,8,2,1,1,0
S01010767,Very bad health,5,0,0,0,1,0,0,1,0,2,1,1,0,0
S01010768,All people aged 16 to 74,410,11,1,10,65,52,44,49,73,74,23,14,9,19
S01010768,Very good health,173,5,1,4,31,26,16,16,25,33,6,3,3,15
S01010768,Good health,147,5,0,5,23,17,16,19,27,27,9,4,5,4
S01010768,Fair health,74,1,0,1,11,7,8,14,18,11,4,4,0,0
S01010768,Bad health,11,0,0,0,0,0,4,0,2,1,4,3,1,0
S01010768,Very bad health,5,0,0,0,0,2,0,0,1,2,0,0,0,0
S01010769,All people aged 16 to 74,381,32,8,24,91,41,78,33,48,34,6,2,4,18
S01010769,Very good health,185,22,7,15,44,22,36,13,17,17,2,1,1,12
S01010769,Good health,144,7,1,6,32,13,32,15,22,14,4,1,3,5
S01010769,Fair health,34,2,0,2,12,4,5,3,7,0,0,0,0,1
S01010769,Bad health,16,1,0,1,3,1,5,2,1,3,0,0,0,0
S01010769,Very bad health,2,0,0,0,0,1,0,0,1,0,0,0,0,0
S01010770,All people aged 16 to 74,646,28,8,20,98,70,86,81,122,96,34,23,11,31
S01010770,Very good health,348,17,5,12,58,37,47,40,63,50,9,6,3,27
S01010770,Good health,189,10,3,7,27,21,24,27,40,25,12,8,4,3
S01010770,Fair health,74,1,0,1,9,9,11,12,9,12,10,6,4,1
S01010770,Bad health,27,0,0,0,3,2,3,1,8,8,2,2,0,0
S01010770,Very bad health,8,0,0,0,1,1,1,1,2,1,1,1,0,0
S01010771,All people aged 16 to 74,621,25,3,22,112,54,108,80,112,84,24,12,12,22
S01010771,Very good health,274,10,1,9,57,20,44,31,44,45,8,5,3,15
S01010771,Good health,215,12,2,10,38,22,43,31,40,18,5,1,4,6
S01010771,Fair health,82,2,0,2,13,5,14,10,17,13,7,2,5,1
S01010771,Bad health,36,0,0,0,4,6,5,6,7,5,3,3,0,0
S01010771,Very bad health,14,1,0,1,0,1,2,2,4,3,1,1,0,0
S01010772,All people aged 16 to 74,617,31,7,24,110,59,99,56,101,94,46,35,11,21
S01010772,Very good health,249,16,3,13,52,21,38,23,40,36,13,11,2,10
S01010772,Good health,210,8,3,5,31,22,44,20,33,28,14,8,6,10
S01010772,Fair health,100,4,0,4,18,12,12,6,20,14,13,12,1,1
S01010772,Bad health,39,2,1,1,2,3,5,3,7,12,5,3,2,0
S01010772,Very bad health,19,1,0,1,7,1,0,4,1,4,1,1,0,0
S01010773,All people aged 16 to 74,604,39,7,32,108,88,96,63,100,75,17,9,8,18
S01010773,Very good health,243,21,3,18,49,37,32,27,36,24,5,2,3,12
S01010773,Good health,230,13,2,11,42,38,38,19,41,28,6,3,3,5
S01010773,Fair health,85,3,1,2,9,9,16,12,16,16,4,2,2,0
S01010773,Bad health,37,2,1,1,7,4,8,4,5,6,0,0,0,1
S01010773,Very bad health,9,0,0,0,1,0,2,1,2,1,2,2,0,0
S01010774,All people aged 16 to 74,529,37,8,29,89,53,79,50,106,60,34,23,11,21
S01010774,Very good health,216,15,1,14,42,23,32,16,50,16,9,6,3,13
S01010774,Good health,187,17,6,11,29,14,28,20,37,22,14,9,5,6
S01010774,Fair health,85,3,0,3,10,12,12,10,15,14,7,6,1,2
S01010774,Bad health,29,2,1,1,3,4,6,3,2,5,4,2,2,0
S01010774,Very bad health,12,0,0,0,5,0,1,1,2,3,0,0,0,0
S01010775,All people aged 16 to 74,494,27,5,22,102,65,81,47,79,64,10,8,2,19
S01010775,Very good health,261,12,2,10,60,40,34,22,42,32,5,5,0,14
S01010775,Good health,163,9,2,7,31,19,34,19,26,18,4,2,2,3
S01010775,Fair health,51,3,0,3,8,5,10,5,10,7,1,1,0,2
S01010775,Bad health,10,2,0,2,1,0,2,0,1,4,0,0,0,0
S01010775,Very bad health,9,1,1,0,2,1,1,1,0,3,0,0,0,0
S01010776,All people aged 16 to 74,402,14,2,12,83,41,38,38,86,66,24,13,11,12
S01010776,Very good health,201,9,1,8,47,21,17,20,36,36,6,4,2,9
S01010776,Good health,128,1,0,1,25,15,11,12,31,20,12,6,6,1
S01010776,Fair health,55,3,1,2,7,4,8,4,14,8,5,2,3,2
S01010776,Bad health,13,0,0,0,2,1,2,2,4,1,1,1,0,0
S01010776,Very bad health,5,1,0,1,2,0,0,0,1,1,0,0,0,0
S01010777,All people aged 16 to 74,380,13,5,8,59,36,28,38,86,69,28,17,11,23
S01010777,Very good health,156,8,3,5,25,11,5,19,34,29,14,9,5,11
S01010777,Good health,139,3,1,2,24,17,14,12,30,24,8,3,5,7
S01010777,Fair health,63,1,1,0,9,4,6,5,16,12,6,5,1,4
S01010777,Bad health,18,1,0,1,1,4,3,2,4,3,0,0,0,0
S01010777,Very bad health,4,0,0,0,0,0,0,0,2,1,0,0,0,1
S01010778,All people aged 16 to 74,356,7,1,6,40,28,18,40,79,71,52,36,16,21
S01010778,Very good health,153,4,1,3,20,15,11,18,28,29,13,7,6,15
S01010778,Good health,107,2,0,2,15,9,2,12,25,22,15,12,3,5
S01010778,Fair health,63,0,0,0,5,1,3,9,17,12,15,11,4,1
S01010778,Bad health,25,1,0,1,0,2,2,1,8,5,6,4,2,0
S01010778,Very bad health,8,0,0,0,0,1,0,0,1,3,3,2,1,0
S01010779,All people aged 16 to 74,564,22,8,14,78,51,37,58,123,100,67,44,23,28
S01010779,Very good health,251,15,4,11,40,22,21,22,44,37,28,15,13,22
S01010779,Good health,199,6,4,2,31,21,11,24,54,33,15,10,5,4
S01010779,Fair health,73,0,0,0,4,5,4,11,15,15,17,12,5,2
S01010779,Bad health,31,0,0,0,3,2,1,1,9,10,5,5,0,0
S01010779,Very bad health,10,1,0,1,0,1,0,0,1,5,2,2,0,0
S01010780,All people aged 16 to 74,406,21,3,18,76,53,23,39,83,75,24,16,8,12
S01010780,Very good health,215,11,1,10,44,31,8,24,37,40,13,7,6,7
S01010780,Good health,116,6,1,5,20,12,10,12,29,20,4,2,2,3
S01010780,Fair health,54,2,1,1,10,6,4,2,14,11,3,3,0,2
S01010780,Bad health,17,2,0,2,2,4,1,1,2,3,2,2,0,0
S01010780,Very bad health,4,0,0,0,0,0,0,0,1,1,2,2,0,0
S01010781,All people aged 16 to 74,600,55,8,47,128,80,64,63,82,73,17,9,8,38
S01010781,Very good health,342,42,5,37,77,40,29,37,37,39,10,5,5,31
S01010781,Good health,185,11,2,9,41,32,24,17,29,22,3,1,2,6
S01010781,Fair health,55,2,1,1,9,6,10,5,12,8,3,2,1,0
S01010781,Bad health,12,0,0,0,1,2,1,2,3,2,0,0,0,1
S01010781,Very bad health,6,0,0,0,0,0,0,2,1,2,1,1,0,0
S01010782,All people aged 16 to 74,439,25,4,21,69,48,59,46,78,57,41,26,15,16
S01010782,Very good health,215,14,2,12,41,22,28,22,28,27,20,12,8,13
S01010782,Good health,144,9,2,7,20,17,25,14,29,17,10,6,4,3
S01010782,Fair health,46,2,0,2,2,7,2,6,11,8,8,5,3,0
S01010782,Bad health,26,0,0,0,5,2,3,1,8,4,3,3,0,0
S01010782,Very bad health,8,0,0,0,1,0,1,3,2,1,0,0,0,0
S01010783,All people aged 16 to 74,419,12,3,9,48,46,21,62,96,82,32,18,14,20
S01010783,Very good health,204,7,1,6,27,24,7,31,47,36,6,2,4,19
S01010783,Good health,133,3,0,3,8,14,10,18,34,32,14,6,8,0
S01010783,Fair health,57,2,2,0,7,7,3,10,11,10,6,4,2,1
S01010783,Bad health,18,0,0,0,4,1,0,3,3,3,4,4,0,0
S01010783,Very bad health,7,0,0,0,2,0,1,0,1,1,2,2,0,0
S01010784,All people aged 16 to 74,529,13,3,10,58,49,23,61,130,115,58,35,23,22
S01010784,Very good health,257,9,1,8,31,24,11,30,65,55,16,12,4,16
S01010784,Good health,167,1,0,1,17,17,9,25,46,24,24,10,14,4
S01010784,Fair health,72,1,1,0,5,5,3,5,14,26,11,6,5,2
S01010784,Bad health,19,1,1,0,5,2,0,1,2,6,2,2,0,0
S01010784,Very bad health,14,1,0,1,0,1,0,0,3,4,5,5,0,0
S01010785,All people aged 16 to 74,532,43,9,34,123,74,46,52,86,76,12,8,4,20
S01010785,Very good health,261,18,2,16,71,41,22,22,39,32,0,0,0,16
S01010785,Good health,203,23,7,16,34,31,15,25,35,30,6,4,2,4
S01010785,Fair health,50,2,0,2,13,1,9,3,9,9,4,3,1,0
S01010785,Bad health,15,0,0,0,5,1,0,1,3,3,2,1,1,0
S01010785,Very bad health,3,0,0,0,0,0,0,1,0,2,0,0,0,0
S01010786,All people aged 16 to 74,485,24,4,20,102,78,36,46,91,59,17,11,6,32
S01010786,Very good health,262,14,2,12,58,43,11,23,48,33,4,3,1,28
S01010786,Good health,150,8,2,6,31,32,16,17,28,13,4,1,3,1
S01010786,Fair health,56,2,0,2,10,2,6,6,13,8,7,5,2,2
S01010786,Bad health,12,0,0,0,3,1,3,0,2,1,1,1,0,1
S01010786,Very bad health,5,0,0,0,0,0,0,0,0,4,1,1,0,0
S01010787,All people aged 16 to 74,655,47,10,37,119,82,120,64,102,76,20,13,7,25
S01010787,Very good health,312,23,4,19,60,36,56,42,37,30,9,6,3,19
S01010787,Good health,235,16,3,13,46,33,47,15,40,29,4,2,2,5
S01010787,Fair health,71,7,3,4,9,10,11,2,16,9,6,4,2,1
S01010787,Bad health,26,1,0,1,2,1,6,4,6,5,1,1,0,0
S01010787,Very bad health,11,0,0,0,2,2,0,1,3,3,0,0,0,0
S01010788,All people aged 16 to 74,461,30,3,27,83,57,66,51,87,60,12,9,3,15
S01010788,Very good health,257,22,2,20,48,29,30,29,47,33,6,5,1,13
S01010788,Good health,138,7,1,6,21,19,25,15,29,18,3,2,1,1
S01010788,Fair health,46,0,0,0,9,8,7,5,10,5,1,1,0,1
S01010788,Bad health,14,1,0,1,5,1,2,2,0,1,2,1,1,0
S01010788,Very bad health,6,0,0,0,0,0,2,0,1,3,0,0,0,0
S01010789,All people aged 16 to 74,551,28,5,23,97,48,96,55,99,77,18,8,10,33
S01010789,Very good health,278,20,4,16,53,20,44,36,36,35,7,5,2,27
S01010789,Good health,189,7,1,6,31,18,38,15,42,28,6,1,5,4
S01010789,Fair health,59,0,0,0,9,10,10,3,11,11,4,1,3,1
S01010789,Bad health,24,1,0,1,3,0,4,1,10,3,1,1,0,1
S01010789,Very bad health,1,0,0,0,1,0,0,0,0,0,0,0,0,0
S01010790,All people aged 16 to 74,512,30,6,24,89,47,98,58,78,73,18,15,3,21
S01010790,Very good health,250,14,4,10,40,30,41,32,35,33,5,4,1,20
S01010790,Good health,163,14,1,13,32,10,34,18,29,21,4,3,1,1
S01010790,Fair health,72,1,1,0,13,7,17,7,7,13,7,6,1,0
S01010790,Bad health,20,1,0,1,3,0,5,1,4,5,1,1,0,0
S01010790,Very bad health,7,0,0,0,1,0,1,0,3,1,1,1,0,0
S01010791,All people aged 16 to 74,642,55,7,48,145,62,113,63,95,58,20,10,10,31
S01010791,Very good health,289,29,4,25,60,28,59,28,35,19,10,7,3,21
S01010791,Good health,245,20,3,17,74,26,36,19,39,16,8,2,6,7
S01010791,Fair health,77,5,0,5,7,4,14,10,16,16,2,1,1,3
S01010791,Bad health,25,1,0,1,0,3,4,6,5,6,0,0,0,0
S01010791,Very bad health,6,0,0,0,4,1,0,0,0,1,0,0,0,0
S01010792,All people aged 16 to 74,461,33,3,30,58,45,27,63,99,93,22,12,10,21
S01010792,Very good health,209,22,3,19,28,23,13,27,39,31,8,4,4,18
S01010792,Good health,170,9,0,9,25,19,9,23,41,33,8,5,3,3
S01010792,Fair health,65,2,0,2,3,2,3,12,14,23,6,3,3,0
S01010792,Bad health,14,0,0,0,2,1,1,1,4,5,0,0,0,0
S01010792,Very bad health,3,0,0,0,0,0,1,0,1,1,0,0,0,0
S01010793,All people aged 16 to 74,485,44,10,34,110,46,71,40,79,61,13,7,6,21
S01010793,Very good health,236,26,3,23,60,25,32,21,23,28,4,1,3,17
S01010793,Good health,181,15,5,10,40,15,23,15,42,23,5,2,3,3
S01010793,Fair health,55,3,2,1,9,5,13,4,12,6,2,2,0,1
S01010793,Bad health,9,0,0,0,0,1,3,0,1,2,2,2,0,0
S01010793,Very bad health,4,0,0,0,1,0,0,0,1,2,0,0,0,0
S01010794,All people aged 16 to 74,412,48,10,38,85,53,49,57,54,36,10,6,4,20
S01010794,Very good health,208,26,3,23,51,29,24,25,26,14,2,1,1,11
S01010794,Good health,139,19,7,12,29,15,20,18,16,12,4,2,2,6
S01010794,Fair health,35,2,0,2,2,3,2,9,6,6,2,1,1,3
S01010794,Bad health,26,1,0,1,2,6,3,5,5,3,1,1,0,0
S01010794,Very bad health,4,0,0,0,1,0,0,0,1,1,1,1,0,0
S01010795,All people aged 16 to 74,727,62,16,46,135,96,64,81,112,111,31,12,19,35
S01010795,Very good health,342,28,8,20,69,43,35,37,44,45,10,3,7,31
S01010795,Good health,264,29,5,24,50,38,18,29,46,41,10,5,5,3
S01010795,Fair health,97,4,2,2,14,12,8,12,19,17,11,4,7,0
S01010795,Bad health,17,0,0,0,2,2,3,1,2,6,0,0,0,1
S01010795,Very bad health,7,1,1,0,0,1,0,2,1,2,0,0,0,0
S01010796,All people aged 16 to 74,630,59,7,52,137,65,120,71,78,55,8,3,5,37
S01010796,Very good health,334,41,5,36,73,31,48,46,40,22,3,0,3,30
S01010796,Good health,214,13,1,12,51,26,49,17,26,24,3,1,2,5
S01010796,Fair health,59,3,0,3,8,8,18,5,9,5,1,1,0,2
S01010796,Bad health,18,0,0,0,5,0,5,3,2,3,0,0,0,0
S01010796,Very bad health,5,2,1,1,0,0,0,0,1,1,1,1,0,0
S01010797,All people aged 16 to 74,581,58,10,48,141,67,77,73,82,48,13,8,5,22
S01010797,Very good health,314,34,6,28,83,33,34,38,44,23,7,3,4,18
S01010797,Good health,194,22,3,19,45,27,33,27,22,14,2,1,1,2
S01010797,Fair health,50,2,1,1,7,7,8,5,10,9,1,1,0,1
S01010797,Bad health,18,0,0,0,4,0,2,1,5,2,3,3,0,1
S01010797,Very bad health,5,0,0,0,2,0,0,2,1,0,0,0,0,0
S01010798,All people aged 16 to 74,494,56,9,47,100,52,74,50,77,49,9,4,5,27
S01010798,Very good health,243,26,3,23,56,29,32,25,33,20,4,2,2,18
S01010798,Good health,188,24,6,18,33,14,34,20,29,23,3,1,2,8
S01010798,Fair health,51,2,0,2,9,7,7,4,13,6,2,1,1,1
S01010798,Bad health,11,4,0,4,2,1,1,1,2,0,0,0,0,0
S01010798,Very bad health,1,0,0,0,0,1,0,0,0,0,0,0,0,0
S01010799,All people aged 16 to 74,681,65,6,59,157,71,66,69,109,83,30,16,14,31
S01010799,Very good health,301,35,3,32,78,32,28,28,41,29,8,2,6,22
S01010799,Good health,235,24,2,22,55,25,23,25,44,25,7,3,4,7
S01010799,Fair health,94,5,1,4,14,9,14,10,16,14,12,8,4,0
S01010799,Bad health,33,1,0,1,4,3,0,5,8,7,3,3,0,2
S01010799,Very bad health,18,0,0,0,6,2,1,1,0,8,0,0,0,0
S01010800,All people aged 16 to 74,537,16,4,12,76,59,32,71,134,104,27,14,13,18
S01010800,Very good health,229,10,1,9,32,25,14,32,53,41,9,5,4,13
S01010800,Good health,208,4,3,1,33,22,12,27,57,37,11,6,5,5
S01010800,Fair health,77,1,0,1,8,11,3,10,18,20,6,3,3,0
S01010800,Bad health,16,0,0,0,3,1,2,2,3,5,0,0,0,0
S01010800,Very bad health,7,1,0,1,0,0,1,0,3,1,1,0,1,0
S01010801,All people aged 16 to 74,525,24,3,21,96,51,34,56,132,86,26,17,9,20
S01010801,Very good health,226,15,3,12,51,30,16,24,38,31,5,2,3,16
S01010801,Good health,195,8,0,8,32,18,11,17,63,33,10,4,6,3
S01010801,Fair health,75,1,0,1,8,1,6,10,22,17,10,10,0,0
S01010801,Bad health,23,0,0,0,4,2,1,4,6,4,1,1,0,1
S01010801,Very bad health,6,0,0,0,1,0,0,1,3,1,0,0,0,0
S01010802,All people aged 16 to 74,419,38,5,33,91,43,32,51,68,58,17,8,9,21
S01010802,Very good health,236,16,3,13,60,23,24,29,34,27,6,3,3,17
S01010802,Good health,145,21,2,19,25,15,6,19,27,22,7,2,5,3
S01010802,Fair health,26,1,0,1,4,4,2,2,4,5,3,2,1,1
S01010802,Bad health,9,0,0,0,1,1,0,1,2,3,1,1,0,0
S01010802,Very bad health,3,0,0,0,1,0,0,0,1,1,0,0,0,0
S01010803,All people aged 16 to 74,428,30,7,23,79,41,30,53,80,51,28,13,15,36
S01010803,Very good health,218,17,3,14,41,24,15,27,32,20,15,8,7,27
S01010803,Good health,130,9,2,7,28,12,9,18,28,14,6,1,5,6
S01010803,Fair health,56,3,1,2,7,5,3,5,14,10,6,3,3,3
S01010803,Bad health,16,1,1,0,3,0,2,3,3,4,0,0,0,0
S01010803,Very bad health,8,0,0,0,0,0,1,0,3,3,1,1,0,0
S01010804,All people aged 16 to 74,431,47,5,42,97,63,32,48,59,48,9,6,3,28
S01010804,Very good health,220,29,2,27,48,32,10,23,35,19,4,3,1,20
S01010804,Good health,157,11,1,10,38,27,15,21,18,20,1,0,1,6
S01010804,Fair health,35,5,2,3,8,3,5,2,2,4,4,3,1,2
S01010804,Bad health,16,1,0,1,2,1,2,2,4,4,0,0,0,0
S01010804,Very bad health,3,1,0,1,1,0,0,0,0,1,0,0,0,0
S01010805,All people aged 16 to 74,637,59,10,49,152,81,43,75,101,62,21,9,12,43
S01010805,Very good health,340,36,6,30,73,38,20,41,58,30,12,6,6,32
S01010805,Good health,208,17,4,13,54,30,15,28,28,21,4,0,4,11
S01010805,Fair health,66,5,0,5,18,8,7,4,9,10,5,3,2,0
S01010805,Bad health,17,1,0,1,4,4,1,1,5,1,0,0,0,0
S01010805,Very bad health,6,0,0,0,3,1,0,1,1,0,0,0,0,0
S01010806,All people aged 16 to 74,678,39,4,35,120,73,34,75,134,107,64,45,19,32
S01010806,Very good health,302,24,3,21,59,42,19,29,54,42,12,9,3,21
S01010806,Good health,220,10,1,9,41,17,10,28,48,36,23,16,7,7
S01010806,Fair health,106,3,0,3,11,11,3,12,21,20,21,15,6,4
S01010806,Bad health,37,2,0,2,6,2,2,2,7,8,8,5,3,0
S01010806,Very bad health,13,0,0,0,3,1,0,4,4,1,0,0,0,0
S01010807,All people aged 16 to 74,408,32,5,27,81,45,27,55,82,53,12,5,7,21
S01010807,Very good health,215,14,2,12,41,29,17,25,44,27,1,1,0,17
S01010807,Good health,128,10,2,8,32,12,6,19,25,18,4,2,2,2
S01010807,Fair health,50,6,1,5,5,3,4,9,10,6,5,1,4,2
S01010807,Bad health,12,2,0,2,2,0,0,2,2,2,2,1,1,0
S01010807,Very bad health,3,0,0,0,1,1,0,0,1,0,0,0,0,0
S01010808,All people aged 16 to 74,388,52,6,46,97,53,19,40,59,38,10,5,5,20
S01010808,Very good health,203,27,3,24,55,29,10,20,21,20,4,2,2,17
S01010808,Good health,126,19,2,17,36,17,6,10,23,9,3,1,2,3
S01010808,Fair health,50,5,1,4,6,7,2,8,14,6,2,1,1,0
S01010808,Bad health,7,1,0,1,0,0,0,2,1,3,0,0,0,0
S01010808,Very bad health,2,0,0,0,0,0,1,0,0,0,1,1,0,0
S01010809,All people aged 16 to 74,584,75,14,61,149,66,47,57,81,65,19,11,8,25
S01010809,Very good health,318,45,9,36,86,41,19,35,43,23,12,7,5,14
S01010809,Good health,187,21,2,19,46,21,18,16,23,28,4,2,2,10
S01010809,Fair health,67,8,2,6,16,4,7,5,15,8,3,2,1,1
S01010809,Bad health,9,1,1,0,0,0,2,1,0,5,0,0,0,0
S01010809,Very bad health,3,0,0,0,1,0,1,0,0,1,0,0,0,0
S01010810,All people aged 16 to 74,370,26,9,17,85,30,53,50,53,43,12,8,4,18
S01010810,Very good health,181,12,4,8,39,10,34,25,22,21,3,1,2,15
S01010810,Good health,115,10,2,8,33,16,12,14,15,10,2,2,0,3
S01010810,Fair health,54,3,2,1,8,3,5,8,12,9,6,4,2,0
S01010810,Bad health,17,1,1,0,5,0,2,3,2,3,1,1,0,0
S01010810,Very bad health,3,0,0,0,0,1,0,0,2,0,0,0,0,0
S01010811,All people aged 16 to 74,659,60,12,48,139,61,119,68,102,58,20,6,14,32
S01010811,Very good health,331,37,5,32,84,28,51,32,48,21,4,0,4,26
S01010811,Good health,230,19,4,15,41,24,50,23,33,24,10,4,6,6
S01010811,Fair health,72,4,3,1,11,6,14,6,16,10,5,1,4,0
S01010811,Bad health,23,0,0,0,3,3,4,6,5,2,0,0,0,0
S01010811,Very bad health,3,0,0,0,0,0,0,1,0,1,1,1,0,0
S01010812,All people aged 16 to 74,373,12,4,8,65,25,76,36,74,56,15,8,7,14
S01010812,Very good health,159,5,2,3,29,14,27,16,25,27,5,2,3,11
S01010812,Good health,155,4,1,3,28,8,37,12,35,22,6,4,2,3
S01010812,Fair health,41,3,1,2,5,1,10,5,9,6,2,0,2,0
S01010812,Bad health,14,0,0,0,3,2,2,3,2,1,1,1,0,0
S01010812,Very bad health,4,0,0,0,0,0,0,0,3,0,1,1,0,0
S01010813,All people aged 16 to 74,424,14,5,9,77,32,88,48,76,64,7,2,5,18
S01010813,Very good health,208,12,4,8,41,16,40,24,32,28,2,1,1,13
S01010813,Good health,141,2,1,1,23,15,31,18,29,17,2,0,2,4
S01010813,Fair health,55,0,0,0,9,1,14,5,10,14,2,1,1,0
S01010813,Bad health,19,0,0,0,4,0,2,1,5,5,1,0,1,1
S01010813,Very bad health,1,0,0,0,0,0,1,0,0,0,0,0,0,0
S01010814,All people aged 16 to 74,484,43,10,33,90,37,128,37,73,48,12,4,8,16
S01010814,Very good health,219,25,6,19,45,18,55,13,24,23,2,0,2,14
S01010814,Good health,196,13,3,10,35,13,60,21,32,17,4,2,2,1
S01010814,Fair health,49,1,0,1,7,5,10,1,14,6,4,1,3,1
S01010814,Bad health,14,3,0,3,3,1,3,0,1,2,1,0,1,0
S01010814,Very bad health,6,1,1,0,0,0,0,2,2,0,1,1,0,0
S01010815,All people aged 16 to 74,341,12,3,9,88,38,47,37,60,38,6,4,2,15
S01010815,Very good health,171,9,3,6,45,28,18,19,26,13,1,1,0,12
S01010815,Good health,108,3,0,3,31,5,19,10,24,11,3,2,1,2
S01010815,Fair health,47,0,0,0,10,4,8,6,7,10,1,0,1,1
S01010815,Bad health,12,0,0,0,2,1,1,2,3,2,1,1,0,0
S01010815,Very bad health,3,0,0,0,0,0,1,0,0,2,0,0,0,0
S01010816,All people aged 16 to 74,419,113,28,85,113,51,40,17,28,13,12,9,3,32
S01010816,Very good health,254,85,18,67,60,29,21,7,11,8,5,4,1,28
S01010816,Good health,122,22,10,12,45,17,15,5,9,3,3,3,0,3
S01010816,Fair health,32,5,0,5,7,2,4,3,5,1,4,2,2,1
S01010816,Bad health,9,1,0,1,1,3,0,2,1,1,0,0,0,0
S01010816,Very bad health,2,0,0,0,0,0,0,0,2,0,0,0,0,0
S01010817,All people aged 16 to 74,656,161,23,138,182,88,69,18,48,22,20,14,6,48
S01010817,Very good health,401,121,19,102,109,42,41,7,22,11,9,5,4,39
S01010817,Good health,181,31,3,28,59,34,20,9,12,5,5,4,1,6
S01010817,Fair health,51,6,1,5,11,8,8,1,10,4,2,1,1,1
S01010817,Bad health,15,3,0,3,1,2,0,1,3,0,3,3,0,2
S01010817,Very bad health,8,0,0,0,2,2,0,0,1,2,1,1,0,0
S01010818,All people aged 16 to 74,698,156,22,134,192,85,63,36,69,32,20,6,14,45
S01010818,Very good health,397,110,13,97,109,40,30,20,37,6,10,2,8,35
S01010818,Good health,206,39,8,31,53,33,23,5,27,14,5,1,4,7
S01010818,Fair health,71,5,0,5,20,9,10,9,3,9,4,2,2,2
S01010818,Bad health,22,2,1,1,9,3,0,2,1,3,1,1,0,1
S01010818,Very bad health,2,0,0,0,1,0,0,0,1,0,0,0,0,0
S01010819,All people aged 16 to 74,581,73,15,58,134,80,48,51,103,52,16,11,5,24
S01010819,Very good health,281,46,8,38,80,31,23,26,35,17,6,5,1,17
S01010819,Good health,184,23,6,17,40,32,14,13,34,19,5,2,3,4
S01010819,Fair health,76,4,1,3,10,10,7,8,25,7,3,2,1,2
S01010819,Bad health,29,0,0,0,4,6,4,4,5,5,0,0,0,1
S01010819,Very bad health,11,0,0,0,0,1,0,0,4,4,2,2,0,0
S01010820,All people aged 16 to 74,396,77,18,59,106,53,50,19,37,22,6,4,2,26
S01010820,Very good health,208,46,9,37,53,27,23,12,14,10,1,1,0,22
S01010820,Good health,140,24,7,17,36,20,20,7,19,9,2,1,1,3
S01010820,Fair health,34,7,2,5,12,5,4,0,3,2,0,0,0,1
S01010820,Bad health,10,0,0,0,3,0,3,0,1,1,2,1,1,0
S01010820,Very bad health,4,0,0,0,2,1,0,0,0,0,1,1,0,0
S01010821,All people aged 16 to 74,436,96,17,79,127,52,51,24,31,20,5,4,1,30
S01010821,Very good health,262,63,13,50,76,33,28,16,14,5,1,0,1,26
S01010821,Good health,118,26,4,22,39,11,18,3,12,5,0,0,0,4
S01010821,Fair health,38,5,0,5,12,4,4,3,3,6,1,1,0,0
S01010821,Bad health,14,2,0,2,0,4,0,2,2,2,2,2,0,0
S01010821,Very bad health,4,0,0,0,0,0,1,0,0,2,1,1,0,0
S01010822,All people aged 16 to 74,567,117,21,96,156,45,57,18,48,21,61,57,4,44
S01010822,Very good health,302,72,14,58,95,26,31,8,23,8,5,4,1,34
S01010822,Good health,171,36,7,29,48,14,19,5,15,3,26,25,1,5
S01010822,Fair health,70,7,0,7,8,4,4,2,7,7,27,26,1,4
S01010822,Bad health,18,2,0,2,2,1,3,3,1,3,3,2,1,0
S01010822,Very bad health,6,0,0,0,3,0,0,0,2,0,0,0,0,1
S01010823,All people aged 16 to 74,346,15,3,12,65,59,33,23,50,55,17,17,0,29
S01010823,Very good health,178,9,2,7,39,33,17,12,18,24,2,2,0,24
S01010823,Good health,104,6,1,5,19,18,10,8,22,13,4,4,0,4
S01010823,Fair health,36,0,0,0,3,4,3,2,7,11,6,6,0,0
S01010823,Bad health,21,0,0,0,4,3,3,1,1,4,5,5,0,0
S01010823,Very bad health,7,0,0,0,0,1,0,0,2,3,0,0,0,1
S01010824,All people aged 16 to 74,524,61,18,43,169,88,38,28,53,34,7,4,3,46
S01010824,Very good health,330,42,13,29,108,59,23,13,22,20,4,1,3,39
S01010824,Good health,148,16,4,12,47,23,13,11,19,10,2,2,0,7
S01010824,Fair health,31,3,1,2,10,4,2,2,9,1,0,0,0,0
S01010824,Bad health,9,0,0,0,3,1,0,2,3,0,0,0,0,0
S01010824,Very bad health,6,0,0,0,1,1,0,0,0,3,1,1,0,0
S01010825,All people aged 16 to 74,245,29,3,26,78,44,17,23,24,16,2,1,1,12
S01010825,Very good health,152,22,1,21,51,25,7,16,10,10,0,0,0,11
S01010825,Good health,72,7,2,5,22,14,9,5,10,3,1,0,1,1
S01010825,Fair health,17,0,0,0,5,4,1,2,2,2,1,1,0,0
S01010825,Bad health,4,0,0,0,0,1,0,0,2,1,0,0,0,0
S01010825,Very bad health,0,0,0,0,0,0,0,0,0,0,0,0,0,0
S01010826,All people aged 16 to 74,581,91,23,68,161,88,50,26,69,31,16,11,5,49
S01010826,Very good health,333,55,14,41,97,52,32,9,33,10,6,3,3,39
S01010826,Good health,185,28,8,20,49,29,9,14,27,14,6,4,2,9
S01010826,Fair health,51,6,1,5,13,6,8,3,6,5,3,3,0,1
S01010826,Bad health,9,1,0,1,2,0,1,0,3,2,0,0,0,0
S01010826,Very bad health,3,1,0,1,0,1,0,0,0,0,1,1,0,0
S01010827,All people aged 16 to 74,476,43,13,30,125,96,24,46,53,29,8,6,2,52
S01010827,Very good health,259,25,8,17,67,54,12,27,23,8,0,0,0,43
S01010827,Good health,153,13,5,8,41,29,10,12,19,14,6,4,2,9
S01010827,Fair health,44,5,0,5,11,6,2,5,7,7,1,1,0,0
S01010827,Bad health,17,0,0,0,6,5,0,2,4,0,0,0,0,0
S01010827,Very bad health,3,0,0,0,0,2,0,0,0,0,1,1,0,0
S01010828,All people aged 16 to 74,928,117,29,88,279,152,58,59,99,52,18,9,9,94
S01010828,Very good health,547,71,20,51,168,88,31,31,47,23,12,7,5,76
S01010828,Good health,283,38,9,29,88,49,18,15,37,20,4,1,3,14
S01010828,Fair health,70,6,0,6,17,10,6,11,10,6,1,0,1,3
S01010828,Bad health,15,2,0,2,4,2,1,2,3,1,0,0,0,0
S01010828,Very bad health,13,0,0,0,2,3,2,0,2,2,1,1,0,1
S01010829,All people aged 16 to 74,731,116,33,83,199,125,68,36,93,46,13,11,2,35
S01010829,Very good health,401,68,19,49,117,74,35,16,43,19,3,2,1,26
S01010829,Good health,216,38,10,28,62,37,27,11,22,11,1,0,1,7
S01010829,Fair health,79,8,3,5,13,10,2,7,22,9,6,6,0,2
S01010829,Bad health,24,2,1,1,4,0,4,2,4,5,3,3,0,0
S01010829,Very bad health,11,0,0,0,3,4,0,0,2,2,0,0,0,0
S01010830,All people aged 16 to 74,442,30,8,22,107,68,26,30,56,63,13,6,7,49
S01010830,Very good health,236,12,5,7,59,42,17,16,24,18,7,2,5,41
S01010830,Good health,151,15,3,12,36,22,7,10,22,30,3,2,1,6
S01010830,Fair health,39,3,0,3,6,3,2,3,7,11,3,2,1,1
S01010830,Bad health,12,0,0,0,6,1,0,1,1,2,0,0,0,1
S01010830,Very bad health,4,0,0,0,0,0,0,0,2,2,0,0,0,0
S01010831,All people aged 16 to 74,432,58,17,41,117,69,25,30,48,20,11,6,5,54
S01010831,Very good health,288,35,13,22,81,42,16,25,33,8,3,1,2,45
S01010831,Good health,114,21,4,17,31,22,6,3,11,7,5,2,3,8
S01010831,Fair health,20,2,0,2,3,4,2,2,1,3,2,2,0,1
S01010831,Bad health,7,0,0,0,2,0,0,0,3,1,1,1,0,0
S01010831,Very bad health,3,0,0,0,0,1,1,0,0,1,0,0,0,0
S01010832,All people aged 16 to 74,593,28,6,22,134,105,32,47,107,66,24,14,10,50
S01010832,Very good health,326,16,2,14,80,55,19,24,53,26,10,7,3,43
S01010832,Good health,181,11,4,7,43,32,8,14,34,26,8,4,4,5
S01010832,Fair health,58,1,0,1,7,12,3,6,15,10,2,1,1,2
S01010832,Bad health,23,0,0,0,2,6,2,3,5,1,4,2,2,0
S01010832,Very bad health,5,0,0,0,2,0,0,0,0,3,0,0,0,0
S01010833,All people aged 16 to 74,701,124,19,105,202,99,53,55,56,35,6,5,1,71
S01010833,Very good health,427,81,12,69,135,58,24,34,24,11,1,0,1,59
S01010833,Good health,196,33,5,28,51,33,19,12,20,16,2,2,0,10
S01010833,Fair health,57,7,2,5,12,6,7,6,11,5,1,1,0,2
S01010833,Bad health,13,2,0,2,3,2,0,3,0,2,1,1,0,0
S01010833,Very bad health,8,1,0,1,1,0,3,0,1,1,1,1,0,0
S01010834,All people aged 16 to 74,702,104,26,78,225,141,45,29,62,32,7,4,3,57
S01010834,Very good health,390,59,14,45,118,81,16,18,29,15,3,1,2,51
S01010834,Good health,224,39,10,29,78,44,20,7,18,10,2,2,0,6
S01010834,Fair health,68,5,2,3,24,12,6,3,12,5,1,0,1,0
S01010834,Bad health,18,1,0,1,5,4,2,0,3,2,1,1,0,0
S01010834,Very bad health,2,0,0,0,0,0,1,1,0,0,0,0,0,0
S01010835,All people aged 16 to 74,510,65,17,48,167,91,30,24,48,25,7,5,2,53
S01010835,Very good health,291,35,9,26,102,46,16,11,23,8,2,2,0,48
S01010835,Good health,157,20,6,14,49,36,12,8,17,7,3,1,2,5
S01010835,Fair health,51,8,1,7,14,7,2,4,7,8,1,1,0,0
S01010835,Bad health,10,2,1,1,2,1,0,1,1,2,1,1,0,0
S01010835,Very bad health,1,0,0,0,0,1,0,0,0,0,0,0,0,0
S01010836,All people aged 16 to 74,616,94,18,76,177,86,45,42,65,48,22,14,8,37
S01010836,Very good health,354,58,12,46,110,54,17,25,25,20,10,5,5,35
S01010836,Good health,178,27,4,23,47,28,19,13,22,14,6,3,3,2
S01010836,Fair health,61,9,2,7,17,3,6,4,13,8,1,1,0,0
S01010836,Bad health,20,0,0,0,3,1,3,0,5,3,5,5,0,0
S01010836,Very bad health,3,0,0,0,0,0,0,0,0,3,0,0,0,0
S01010837,All people aged 16 to 74,501,24,9,15,96,92,29,41,102,61,12,8,4,44
S01010837,Very good health,231,11,4,7,50,33,12,18,43,21,7,3,4,36
S01010837,Good health,166,10,4,6,34,40,9,15,32,18,1,1,0,7
S01010837,Fair health,74,3,1,2,7,13,6,7,22,15,0,0,0,1
S01010837,Bad health,21,0,0,0,3,3,1,1,4,5,4,4,0,0
S01010837,Very bad health,9,0,0,0,2,3,1,0,1,2,0,0,0,0
S01010838,All people aged 16 to 74,610,33,6,27,116,115,26,57,114,94,12,7,5,43
S01010838,Very good health,288,16,1,15,66,63,8,27,44,30,6,5,1,28
S01010838,Good health,229,12,3,9,32,41,14,22,44,46,3,1,2,15
S01010838,Fair health,55,2,0,2,13,5,3,6,17,8,1,1,0,0
S01010838,Bad health,29,3,2,1,4,2,1,2,8,7,2,0,2,0
S01010838,Very bad health,9,0,0,0,1,4,0,0,1,3,0,0,0,0
S01010839,All people aged 16 to 74,504,38,12,26,107,92,35,41,84,47,14,9,5,46
S01010839,Very good health,264,26,7,19,62,54,12,21,32,19,5,3,2,33
S01010839,Good health,165,10,4,6,35,29,15,12,36,15,3,1,2,10
S01010839,Fair health,53,1,1,0,8,7,7,6,8,9,4,3,1,3
S01010839,Bad health,18,1,0,1,1,2,1,1,8,2,2,2,0,0
S01010839,Very bad health,4,0,0,0,1,0,0,1,0,2,0,0,0,0
S01010840,All people aged 16 to 74,376,32,6,26,101,65,20,25,58,38,15,9,6,22
S01010840,Very good health,188,21,6,15,56,36,8,16,19,11,7,4,3,14
S01010840,Good health,112,8,0,8,35,13,8,4,23,11,2,2,0,8
S01010840,Fair health,46,2,0,2,7,11,2,4,8,9,3,0,3,0
S01010840,Bad health,25,1,0,1,3,3,2,0,8,6,2,2,0,0
S01010840,Very bad health,5,0,0,0,0,2,0,1,0,1,1,1,0,0
S01010841,All people aged 16 to 74,603,60,12,48,167,104,26,53,83,54,20,10,10,36
S01010841,Very good health,313,42,7,35,92,62,10,22,33,14,11,6,5,27
S01010841,Good health,210,15,5,10,56,30,15,19,41,22,5,2,3,7
S01010841,Fair health,59,2,0,2,13,9,1,11,7,11,3,1,2,2
S01010841,Bad health,18,0,0,0,6,3,0,0,2,6,1,1,0,0
S01010841,Very bad health,3,1,0,1,0,0,0,1,0,1,0,0,0,0
S01010842,All people aged 16 to 74,659,37,3,34,115,115,33,51,104,108,49,36,13,47
S01010842,Very good health,266,19,1,18,60,48,9,22,40,28,13,10,3,27
S01010842,Good health,210,16,1,15,36,39,16,15,30,31,12,8,4,15
S01010842,Fair health,118,2,1,1,15,20,6,6,20,30,16,12,4,3
S01010842,Bad health,45,0,0,0,3,6,1,5,10,13,5,3,2,2
S01010842,Very bad health,20,0,0,0,1,2,1,3,4,6,3,3,0,0
S01010843,All people aged 16 to 74,480,31,9,22,98,90,28,40,84,68,18,12,6,23
S01010843,Very good health,205,17,6,11,50,40,9,19,34,16,3,2,1,17
S01010843,Good health,171,9,2,7,33,29,9,15,33,31,7,3,4,5
S01010843,Fair health,60,5,1,4,13,10,7,3,7,11,3,2,1,1
S01010843,Bad health,34,0,0,0,2,8,2,2,9,7,4,4,0,0
S01010843,Very bad health,10,0,0,0,0,3,1,1,1,3,1,1,0,0
S01010844,All people aged 16 to 74,512,59,9,50,141,99,20,41,50,34,6,1,5,62
S01010844,Very good health,297,46,4,42,75,54,9,24,22,11,4,1,3,52
S01010844,Good health,153,9,3,6,48,33,6,10,21,15,1,0,1,10
S01010844,Fair health,39,4,2,2,12,7,3,4,4,4,1,0,1,0
S01010844,Bad health,20,0,0,0,6,5,2,2,2,3,0,0,0,0
S01010844,Very bad health,3,0,0,0,0,0,0,1,1,1,0,0,0,0
S01010845,All people aged 16 to 74,477,30,5,25,111,79,26,44,74,57,16,9,7,40
S01010845,Very good health,261,17,4,13,59,50,17,21,37,22,2,1,1,36
S01010845,Good health,137,13,1,12,44,15,5,15,22,14,5,3,2,4
S01010845,Fair health,55,0,0,0,6,11,3,6,11,11,7,3,4,0
S01010845,Bad health,16,0,0,0,0,2,1,1,2,8,2,2,0,0
S01010845,Very bad health,8,0,0,0,2,1,0,1,2,2,0,0,0,0
S01010846,All people aged 16 to 74,596,17,4,13,86,89,30,58,123,98,36,19,17,59
S01010846,Very good health,288,9,2,7,47,48,12,30,55,33,10,3,7,44
S01010846,Good health,199,7,2,5,26,28,11,16,47,36,14,7,7,14
S01010846,Fair health,84,1,0,1,11,10,6,10,17,20,8,6,2,1
S01010846,Bad health,17,0,0,0,1,3,1,1,3,5,3,2,1,0
S01010846,Very bad health,8,0,0,0,1,0,0,1,1,4,1,1,0,0
S01010847,All people aged 16 to 74,509,43,11,32,149,92,17,48,61,46,13,9,4,40
S01010847,Very good health,294,26,7,19,93,50,9,20,36,24,7,5,2,29
S01010847,Good health,155,13,4,9,45,33,5,20,14,14,2,1,1,9
S01010847,Fair health,43,2,0,2,11,7,2,5,7,5,3,2,1,1
S01010847,Bad health,16,2,0,2,0,2,1,2,4,3,1,1,0,1
S01010847,Very bad health,1,0,0,0,0,0,0,1,0,0,0,0,0,0
S01010848,All people aged 16 to 74,503,9,0,9,49,53,15,44,123,127,35,23,12,48
S01010848,Very good health,228,4,0,4,30,26,8,14,53,42,18,9,9,33
S01010848,Good health,160,5,0,5,14,18,4,17,38,44,9,7,2,11
S01010848,Fair health,71,0,0,0,3,9,3,7,21,20,5,4,1,3
S01010848,Bad health,31,0,0,0,2,0,0,5,7,16,1,1,0,0
S01010848,Very bad health,13,0,0,0,0,0,0,1,4,5,2,2,0,1
S01010849,All people aged 16 to 74,687,11,2,9,80,70,35,53,137,175,44,33,11,82
S01010849,Very good health,281,5,0,5,40,32,15,16,48,50,19,14,5,56
S01010849,Good health,209,3,0,3,26,24,11,14,47,57,8,7,1,19
S01010849,Fair health,126,3,2,1,8,13,3,16,25,43,10,5,5,5
S01010849,Bad health,50,0,0,0,3,1,3,6,12,19,5,5,0,1
S01010849,Very bad health,21,0,0,0,3,0,3,1,5,6,2,2,0,1
S01010850,All people aged 16 to 74,609,6,1,5,62,56,21,57,135,159,63,42,21,50
S01010850,Very good health,226,2,0,2,28,31,5,17,47,48,16,8,8,32
S01010850,Good health,199,2,0,2,19,14,9,20,47,49,24,18,6,15
S01010850,Fair health,91,1,1,0,8,8,2,9,19,27,15,8,7,2
S01010850,Bad health,65,1,0,1,4,1,3,7,16,26,7,7,0,0
S01010850,Very bad health,28,0,0,0,3,2,2,4,6,9,1,1,0,1
S01010851,All people aged 16 to 74,574,12,1,11,74,79,14,38,121,148,51,31,20,37
S01010851,Very good health,256,7,0,7,37,38,6,18,53,55,18,8,10,24
S01010851,Good health,190,3,1,2,25,29,4,13,39,50,18,13,5,9
S01010851,Fair health,87,1,0,1,8,10,3,2,18,32,10,5,5,3
S01010851,Bad health,31,1,0,1,2,1,1,3,10,8,4,4,0,1
S01010851,Very bad health,10,0,0,0,2,1,0,2,1,3,1,1,0,0
S01010852,All people aged 16 to 74,565,18,7,11,57,75,36,52,129,136,23,20,3,39
S01010852,Very good health,248,11,5,6,33,40,12,25,52,39,8,7,1,28
S01010852,Good health,191,6,2,4,17,26,16,14,45,50,7,6,1,10
S01010852,Fair health,83,1,0,1,7,7,4,9,15,35,5,4,1,0
S01010852,Bad health,33,0,0,0,0,1,4,3,13,8,3,3,0,1
S01010852,Very bad health,10,0,0,0,0,1,0,1,4,4,0,0,0,0
S01010853,All people aged 16 to 74,663,28,5,23,94,92,38,64,131,135,26,16,10,55
S01010853,Very good health,314,20,3,17,49,48,17,23,53,49,13,7,6,42
S01010853,Good health,190,5,1,4,24,29,14,22,39,40,5,2,3,12
S01010853,Fair health,104,0,0,0,12,12,5,13,26,29,6,6,0,1
S01010853,Bad health,44,1,0,1,9,3,1,4,12,12,2,1,1,0
S01010853,Very bad health,11,2,1,1,0,0,1,2,1,5,0,0,0,0
S01010854,All people aged 16 to 74,660,20,1,19,76,86,27,43,155,130,61,39,22,62
S01010854,Very good health,277,13,1,12,30,37,10,20,66,39,17,8,9,45
S01010854,Good health,228,5,0,5,30,32,13,12,56,48,19,10,9,13
S01010854,Fair health,83,2,0,2,11,11,1,6,18,20,12,8,4,2
S01010854,Bad health,58,0,0,0,4,5,3,3,13,20,9,9,0,1
S01010854,Very bad health,14,0,0,0,1,1,0,2,2,3,4,4,0,1
S01010855,All people aged 16 to 74,412,5,1,4,41,57,20,31,104,90,22,17,5,42
S01010855,Very good health,191,3,1,2,18,33,6,12,45,33,10,8,2,31
S01010855,Good health,134,1,0,1,16,17,6,13,37,27,8,5,3,9
S01010855,Fair health,52,1,0,1,4,2,6,4,14,18,2,2,0,1
S01010855,Bad health,25,0,0,0,3,4,1,1,4,9,2,2,0,1
S01010855,Very bad health,10,0,0,0,0,1,1,1,4,3,0,0,0,0
S01010856,All people aged 16 to 74,633,16,5,11,88,97,31,68,121,120,47,30,17,45
S01010856,Very good health,249,10,3,7,42,45,10,16,43,40,15,8,7,28
S01010856,Good health,199,4,1,3,33,24,12,24,43,35,12,7,5,12
S01010856,Fair health,115,1,0,1,8,15,6,18,24,29,12,8,4,2
S01010856,Bad health,48,1,1,0,4,9,2,8,7,10,6,5,1,1
S01010856,Very bad health,22,0,0,0,1,4,1,2,4,6,2,2,0,2
S01010857,All people aged 16 to 74,629,33,5,28,119,110,23,62,112,77,26,16,10,67
S01010857,Very good health,363,24,5,19,69,72,12,34,56,31,10,5,5,55
S01010857,Good health,170,6,0,6,39,29,8,16,35,20,7,3,4,10
S01010857,Fair health,61,3,0,3,8,4,1,10,11,18,6,6,0,0
S01010857,Bad health,26,0,0,0,2,4,2,1,7,5,3,2,1,2
S01010857,Very bad health,9,0,0,0,1,1,0,1,3,3,0,0,0,0
S01010858,All people aged 16 to 74,522,11,0,11,75,64,15,43,120,120,31,18,13,43
S01010858,Very good health,230,7,0,7,37,31,5,19,45,38,10,4,6,38
S01010858,Good health,157,3,0,3,24,18,5,12,45,34,12,7,5,4
S01010858,Fair health,86,0,0,0,7,10,4,9,22,28,5,3,2,1
S01010858,Bad health,42,1,0,1,6,4,1,3,8,16,3,3,0,0
S01010858,Very bad health,7,0,0,0,1,1,0,0,0,4,1,1,0,0
S01010859,All people aged 16 to 74,538,13,3,10,52,61,21,39,140,135,37,28,9,40
S01010859,Very good health,210,4,1,3,26,24,7,15,56,35,14,10,4,29
S01010859,Good health,183,5,1,4,22,23,8,14,48,49,8,4,4,6
S01010859,Fair health,78,2,1,1,3,7,4,5,16,29,9,8,1,3
S01010859,Bad health,53,0,0,0,1,4,1,4,19,17,5,5,0,2
S01010859,Very bad health,14,2,0,2,0,3,1,1,1,5,1,1,0,0
S01010860,All people aged 16 to 74,487,17,5,12,73,77,14,53,108,93,24,15,9,28
S01010860,Very good health,201,4,1,3,35,39,5,18,40,34,8,4,4,18
S01010860,Good health,180,11,3,8,27,23,5,25,41,34,6,3,3,8
S01010860,Fair health,57,2,1,1,7,9,0,5,12,15,5,5,0,2
S01010860,Bad health,38,0,0,0,3,4,3,4,14,7,3,1,2,0
S01010860,Very bad health,11,0,0,0,1,2,1,1,1,3,2,2,0,0
S01010861,All people aged 16 to 74,477,19,8,11,59,57,17,27,116,113,35,20,15,34
S01010861,Very good health,201,10,4,6,37,28,5,10,39,34,12,3,9,26
S01010861,Good health,137,6,2,4,16,18,5,8,34,32,11,6,5,7
S01010861,Fair health,75,1,1,0,2,8,5,4,22,27,5,4,1,1
S01010861,Bad health,42,1,1,0,3,2,2,2,14,12,6,6,0,0
S01010861,Very bad health,22,1,0,1,1,1,0,3,7,8,1,1,0,0
S01010862,All people aged 16 to 74,420,11,5,6,38,33,9,37,98,103,46,32,14,45
S01010862,Very good health,174,6,2,4,19,19,2,15,32,30,18,11,7,33
S01010862,Good health,120,2,1,1,7,6,3,11,32,31,17,11,6,11
S01010862,Fair health,74,2,1,1,7,6,2,4,21,27,4,4,0,1
S01010862,Bad health,39,1,1,0,3,2,2,6,9,11,5,5,0,0
S01010862,Very bad health,13,0,0,0,2,0,0,1,4,4,2,1,1,0
S01010863,All people aged 16 to 74,566,62,12,50,166,88,25,32,72,55,12,7,5,54
S01010863,Very good health,311,39,9,30,92,50,11,17,31,18,7,4,3,46
S01010863,Good health,173,15,1,14,57,26,12,9,26,21,1,0,1,6
S01010863,Fair health,57,6,1,5,15,10,1,5,9,7,2,2,0,2
S01010863,Bad health,16,2,1,1,0,2,1,0,4,6,1,0,1,0
S01010863,Very bad health,9,0,0,0,2,0,0,1,2,3,1,1,0,0
S01010864,All people aged 16 to 74,431,61,6,55,147,77,18,28,38,18,6,2,4,38
S01010864,Very good health,257,38,4,34,87,46,6,11,17,11,4,2,2,37
S01010864,Good health,134,16,1,15,51,24,8,14,14,5,2,0,2,0
S01010864,Fair health,33,6,1,5,5,6,4,2,7,2,0,0,0,1
S01010864,Bad health,4,1,0,1,2,1,0,0,0,0,0,0,0,0
S01010864,Very bad health,3,0,0,0,2,0,0,1,0,0,0,0,0,0
S01010865,All people aged 16 to 74,536,78,14,64,177,87,32,21,44,35,11,8,3,51
S01010865,Very good health,310,52,11,41,102,40,17,11,19,17,2,2,0,50
S01010865,Good health,171,23,3,20,60,41,14,6,13,9,4,2,2,1
S01010865,Fair health,41,1,0,1,13,6,1,2,9,5,4,3,1,0
S01010865,Bad health,12,1,0,1,2,0,0,2,3,3,1,1,0,0
S01010865,Very bad health,2,1,0,1,0,0,0,0,0,1,0,0,0,0
S01010866,All people aged 16 to 74,482,64,7,57,134,71,34,31,55,50,13,9,4,30
S01010866,Very good health,258,52,6,46,72,42,15,11,24,13,4,2,2,25
S01010866,Good health,138,7,0,7,45,20,16,8,21,13,3,3,0,5
S01010866,Fair health,56,4,1,3,12,5,2,8,8,13,4,2,2,0
S01010866,Bad health,21,1,0,1,4,2,1,3,2,6,2,2,0,0
S01010866,Very bad health,9,0,0,0,1,2,0,1,0,5,0,0,0,0
S01010867,All people aged 16 to 74,472,70,16,54,131,68,49,27,47,29,8,8,0,43
S01010867,Very good health,251,41,10,31,80,27,21,19,17,8,2,2,0,36
S01010867,Good health,147,24,5,19,32,30,19,5,17,12,2,2,0,6
S01010867,Fair health,44,3,0,3,10,9,6,1,8,3,3,3,0,1
S01010867,Bad health,25,1,1,0,9,2,3,2,2,5,1,1,0,0
S01010867,Very bad health,5,1,0,1,0,0,0,0,3,1,0,0,0,0
S01010868,All people aged 16 to 74,580,66,5,61,161,96,29,32,64,50,37,35,2,45
S01010868,Very good health,285,38,3,35,84,47,15,14,30,15,7,7,0,35
S01010868,Good health,185,22,2,20,61,30,9,9,17,16,11,9,2,10
S01010868,Fair health,76,3,0,3,12,15,5,6,10,11,14,14,0,0
S01010868,Bad health,28,2,0,2,4,3,0,3,5,7,4,4,0,0
S01010868,Very bad health,6,1,0,1,0,1,0,0,2,1,1,1,0,0
S01010869,All people aged 16 to 74,565,73,15,58,164,104,40,30,48,30,20,14,6,56
S01010869,Very good health,337,49,12,37,99,62,18,11,28,14,6,5,1,50
S01010869,Good health,190,20,2,18,54,38,20,17,17,10,9,5,4,5
S01010869,Fair health,29,4,1,3,10,3,2,2,2,2,3,2,1,1
S01010869,Bad health,5,0,0,0,0,1,0,0,0,2,2,2,0,0
S01010869,Very bad health,4,0,0,0,1,0,0,0,1,2,0,0,0,0
S01010870,All people aged 16 to 74,565,56,12,44,170,90,34,32,85,49,14,9,5,35
S01010870,Very good health,288,37,8,29,99,48,13,9,36,17,1,1,0,28
S01010870,Good health,188,15,4,11,54,31,16,11,33,15,7,3,4,6
S01010870,Fair health,68,4,0,4,15,9,4,10,9,11,5,4,1,1
S01010870,Bad health,17,0,0,0,1,2,1,2,6,4,1,1,0,0
S01010870,Very bad health,4,0,0,0,1,0,0,0,1,2,0,0,0,0
S01010871,All people aged 16 to 74,626,62,10,52,160,96,51,41,78,57,19,10,9,62
S01010871,Very good health,347,35,9,26,101,49,23,21,36,26,7,3,4,49
S01010871,Good health,206,23,1,22,48,34,21,15,27,21,7,2,5,10
S01010871,Fair health,59,3,0,3,10,10,5,5,9,9,5,5,0,3
S01010871,Bad health,13,1,0,1,1,3,1,0,6,1,0,0,0,0
S01010871,Very bad health,1,0,0,0,0,0,1,0,0,0,0,0,0,0
S01010872,All people aged 16 to 74,571,35,5,30,112,104,32,49,95,72,20,16,4,52
S01010872,Very good health,272,22,3,19,64,52,12,23,33,23,5,3,2,38
S01010872,Good health,168,12,2,10,35,36,10,13,31,18,4,3,1,9
S01010872,Fair health,95,1,0,1,12,14,6,6,21,23,8,7,1,4
S01010872,Bad health,28,0,0,0,1,2,2,6,6,8,2,2,0,1
S01010872,Very bad health,8,0,0,0,0,0,2,1,4,0,1,1,0,0
S01010873,All people aged 16 to 74,364,11,1,10,50,42,13,35,81,82,30,16,14,20
S01010873,Very good health,99,4,0,4,15,10,3,8,28,12,9,3,6,10
S01010873,Good health,137,5,1,4,23,20,4,16,23,28,10,6,4,8
S01010873,Fair health,60,0,0,0,6,5,3,7,13,19,7,5,2,0
S01010873,Bad health,53,1,0,1,1,7,2,3,15,18,4,2,2,2
S01010873,Very bad health,15,1,0,1,5,0,1,1,2,5,0,0,0,0
S01010874,All people aged 16 to 74,589,61,12,49,154,109,37,31,65,44,17,10,7,71
S01010874,Very good health,377,42,7,35,97,68,21,25,39,24,5,3,2,56
S01010874,Good health,142,12,4,8,40,29,8,3,17,14,6,3,3,13
S01010874,Fair health,46,7,1,6,13,7,4,2,7,3,2,1,1,1
S01010874,Bad health,19,0,0,0,3,5,4,1,1,2,3,2,1,0
S01010874,Very bad health,5,0,0,0,1,0,0,0,1,1,1,1,0,1
S01010875,All people aged 16 to 74,395,31,5,26,95,65,20,21,58,54,15,8,7,36
S01010875,Very good health,225,19,4,15,62,40,12,6,25,26,5,3,2,30
S01010875,Good health,118,8,1,7,22,22,8,9,21,17,6,2,4,5
S01010875,Fair health,42,3,0,3,10,2,0,3,10,9,4,3,1,1
S01010875,Bad health,7,1,0,1,1,1,0,3,0,1,0,0,0,0
S01010875,Very bad health,3,0,0,0,0,0,0,0,2,1,0,0,0,0
S01010876,All people aged 16 to 74,552,21,4,17,102,99,11,48,96,83,30,23,7,62
S01010876,Very good health,247,9,2,7,57,53,3,13,32,27,5,2,3,48
S01010876,Good health,177,10,2,8,27,32,5,16,33,32,10,9,1,12
S01010876,Fair health,69,2,0,2,12,8,2,8,12,13,10,7,3,2
S01010876,Bad health,50,0,0,0,4,6,0,10,17,9,4,4,0,0
S01010876,Very bad health,9,0,0,0,2,0,1,1,2,2,1,1,0,0
S01010877,All people aged 16 to 74,733,56,12,44,151,148,35,51,105,93,42,29,13,52
S01010877,Very good health,365,30,5,25,82,81,17,25,39,40,11,9,2,40
S01010877,Good health,213,19,3,16,50,42,11,15,32,20,18,11,7,6
S01010877,Fair health,96,2,2,0,12,19,4,6,22,21,6,3,3,4
S01010877,Bad health,45,3,0,3,7,5,0,5,10,8,5,4,1,2
S01010877,Very bad health,14,2,2,0,0,1,3,0,2,4,2,2,0,0
S01010878,All people aged 16 to 74,892,28,5,23,127,143,40,80,162,181,87,72,15,44
S01010878,Very good health,392,18,4,14,76,71,18,28,62,59,25,21,4,35
S01010878,Good health,297,7,1,6,35,47,13,29,60,69,31,27,4,6
S01010878,Fair health,141,3,0,3,10,19,5,14,34,33,23,19,4,0
S01010878,Bad health,48,0,0,0,4,4,3,6,4,20,6,3,3,1
S01010878,Very bad health,14,0,0,0,2,2,1,3,2,0,2,2,0,2
S01010879,All people aged 16 to 74,655,31,7,24,129,116,46,53,118,94,26,17,9,42
S01010879,Very good health,339,16,3,13,82,60,23,21,55,40,9,2,7,33
S01010879,Good health,203,9,4,5,38,42,14,21,34,29,9,7,2,7
S01010879,Fair health,68,6,0,6,6,8,6,6,15,15,5,5,0,1
S01010879,Bad health,39,0,0,0,3,5,3,3,13,9,2,2,0,1
S01010879,Very bad health,6,0,0,0,0,1,0,2,1,1,1,1,0,0
S01010880,All people aged 16 to 74,403,10,2,8,57,52,11,47,85,81,31,19,12,29
S01010880,Very good health,179,4,1,3,29,28,6,21,31,28,14,6,8,18
S01010880,Good health,134,6,1,5,20,13,4,15,29,33,4,3,1,10
S01010880,Fair health,60,0,0,0,5,8,1,6,18,10,11,9,2,1
S01010880,Bad health,28,0,0,0,3,3,0,4,7,9,2,1,1,0
S01010880,Very bad health,2,0,0,0,0,0,0,1,0,1,0,0,0,0
S01010881,All people aged 16 to 74,455,17,3,14,84,81,21,42,79,71,18,11,7,42
S01010881,Very good health,212,9,3,6,43,41,8,19,32,23,5,2,3,32
S01010881,Good health,158,6,0,6,29,23,9,15,28,33,6,4,2,9
S01010881,Fair health,66,2,0,2,10,13,4,5,13,11,7,5,2,1
S01010881,Bad health,13,0,0,0,1,1,0,2,5,4,0,0,0,0
S01010881,Very bad health,6,0,0,0,1,3,0,1,1,0,0,0,0,0
S01010882,All people aged 16 to 74,441,18,6,12,94,68,10,46,83,58,18,9,9,46
S01010882,Very good health,236,9,4,5,60,32,5,19,38,28,6,3,3,39
S01010882,Good health,140,4,2,2,24,26,5,17,37,16,5,1,4,6
S01010882,Fair health,38,3,0,3,7,6,0,7,6,4,5,3,2,0
S01010882,Bad health,20,1,0,1,3,1,0,3,2,8,1,1,0,1
S01010882,Very bad health,7,1,0,1,0,3,0,0,0,2,1,1,0,0
S01010883,All people aged 16 to 74,664,37,13,24,136,97,28,57,110,86,31,20,11,82
S01010883,Very good health,379,24,7,17,88,60,15,28,49,34,10,7,3,71
S01010883,Good health,184,10,5,5,35,28,7,17,38,33,7,3,4,9
S01010883,Fair health,74,1,0,1,12,6,3,10,17,14,9,5,4,2
S01010883,Bad health,25,2,1,1,1,3,3,2,6,3,5,5,0,0
S01010883,Very bad health,2,0,0,0,0,0,0,0,0,2,0,0,0,0
S01010884,All people aged 16 to 74,534,9,3,6,60,61,23,47,123,123,57,42,15,31
S01010884,Very good health,168,5,2,3,22,17,5,17,37,22,20,15,5,23
S01010884,Good health,188,2,0,2,21,24,13,19,45,40,18,11,7,6
S01010884,Fair health,112,1,0,1,13,13,2,9,25,38,10,7,3,1
S01010884,Bad health,51,1,1,0,3,6,0,2,13,17,8,8,0,1
S01010884,Very bad health,15,0,0,0,1,1,3,0,3,6,1,1,0,0
S01010885,All people aged 16 to 74,709,20,6,14,108,81,19,53,157,135,84,55,29,52
S01010885,Very good health,255,14,5,9,49,35,7,19,48,31,17,11,6,35
S01010885,Good health,228,2,0,2,42,29,3,16,60,39,23,13,10,14
S01010885,Fair health,140,3,1,2,7,12,5,10,37,31,33,22,11,2
S01010885,Bad health,59,1,0,1,9,3,4,4,7,23,8,7,1,0
S01010885,Very bad health,27,0,0,0,1,2,0,4,5,11,3,2,1,1
S01010886,All people aged 16 to 74,383,11,1,10,54,53,18,29,77,61,42,32,10,38
S01010886,Very good health,157,8,1,7,35,25,8,12,26,15,7,6,1,21
S01010886,Good health,143,2,0,2,15,19,8,10,33,17,24,16,8,15
S01010886,Fair health,48,0,0,0,2,5,2,5,12,17,5,5,0,0
S01010886,Bad health,27,1,0,1,2,3,0,1,6,9,5,4,1,0
S01010886,Very bad health,8,0,0,0,0,1,0,1,0,3,1,1,0,2
S01010887,All people aged 16 to 74,604,6,0,6,62,60,31,38,142,145,67,45,22,53
S01010887,Very good health,220,3,0,3,37,24,8,10,43,39,17,10,7,39
S01010887,Good health,161,2,0,2,15,16,9,13,48,33,16,7,9,9
S01010887,Fair health,132,1,0,1,6,14,11,7,28,40,22,16,6,3
S01010887,Bad health,68,0,0,0,4,5,1,8,17,27,6,6,0,0
S01010887,Very bad health,23,0,0,0,0,1,2,0,6,6,6,6,0,2
S01010888,All people aged 16 to 74,630,28,2,26,93,74,26,55,134,130,45,24,21,45
S01010888,Very good health,258,17,1,16,50,31,8,22,59,34,13,4,9,24
S01010888,Good health,219,10,1,9,35,28,11,15,44,46,13,4,9,17
S01010888,Fair health,103,1,0,1,7,15,3,13,20,28,14,11,3,2
S01010888,Bad health,34,0,0,0,1,0,3,4,7,13,5,5,0,1
S01010888,Very bad health,16,0,0,0,0,0,1,1,4,9,0,0,0,1
S01010889,All people aged 16 to 74,438,15,3,12,51,54,20,30,99,111,44,32,12,14
S01010889,Very good health,158,8,1,7,24,24,9,11,26,38,7,6,1,11
S01010889,Good health,122,4,1,3,13,17,4,6,35,28,13,5,8,2
S01010889,Fair health,100,2,1,1,8,10,3,7,22,29,19,16,3,0
S01010889,Bad health,40,1,0,1,5,3,4,2,12,10,3,3,0,0
S01010889,Very bad health,18,0,0,0,1,0,0,4,4,6,2,2,0,1
S01010890,All people aged 16 to 74,515,10,1,9,58,69,17,50,126,133,31,23,8,21
S01010890,Very good health,149,4,0,4,29,23,4,14,39,17,7,4,3,12
S01010890,Good health,155,5,1,4,19,21,6,16,31,47,5,2,3,5
S01010890,Fair health,131,1,0,1,5,17,5,13,39,42,6,5,1,3
S01010890,Bad health,60,0,0,0,3,4,2,7,14,22,7,6,1,1
S01010890,Very bad health,20,0,0,0,2,4,0,0,3,5,6,6,0,0
S01010891,All people aged 16 to 74,308,7,1,6,20,27,12,27,61,77,43,39,4,34
S01010891,Very good health,87,3,0,3,3,10,2,6,12,19,11,10,1,21
S01010891,Good health,93,2,0,2,10,6,7,8,20,21,10,9,1,9
S01010891,Fair health,73,0,0,0,5,8,2,6,14,23,14,12,2,1
S01010891,Bad health,43,1,0,1,2,2,0,5,11,12,7,7,0,3
S01010891,Very bad health,12,1,1,0,0,1,1,2,4,2,1,1,0,0
S01010892,All people aged 16 to 74,646,20,2,18,83,90,20,56,140,150,55,42,13,32
S01010892,Very good health,225,12,1,11,36,35,4,20,53,35,6,2,4,24
S01010892,Good health,217,5,0,5,27,35,7,18,50,52,16,12,4,7
S01010892,Fair health,129,2,1,1,14,16,5,13,22,41,15,13,2,1
S01010892,Bad health,62,1,0,1,4,4,4,4,14,18,13,10,3,0
S01010892,Very bad health,13,0,0,0,2,0,0,1,1,4,5,5,0,0
S01010893,All people aged 16 to 74,386,9,1,8,28,51,13,34,95,93,33,25,8,30
S01010893,Very good health,120,5,1,4,12,22,5,10,22,27,3,3,0,14
S01010893,Good health,122,2,0,2,11,13,3,13,30,25,15,10,5,10
S01010893,Fair health,93,2,0,2,2,9,4,7,29,24,11,8,3,5
S01010893,Bad health,42,0,0,0,3,6,1,2,13,13,4,4,0,0
S01010893,Very bad health,9,0,0,0,0,1,0,2,1,4,0,0,0,1
S01010894,All people aged 16 to 74,464,26,1,25,86,66,17,41,77,89,31,16,15,31
S01010894,Very good health,234,17,0,17,62,41,5,23,37,23,10,5,5,16
S01010894,Good health,134,5,0,5,15,18,9,13,22,29,10,4,6,13
S01010894,Fair health,60,4,1,3,8,6,1,4,11,15,9,6,3,2
S01010894,Bad health,27,0,0,0,1,1,0,1,6,16,2,1,1,0
S01010894,Very bad health,9,0,0,0,0,0,2,0,1,6,0,0,0,0
S01010895,All people aged 16 to 74,324,8,1,7,48,44,12,16,59,78,40,30,10,19
S01010895,Very good health,125,5,0,5,24,25,4,7,14,22,9,7,2,15
S01010895,Good health,94,2,0,2,14,14,2,5,18,26,10,7,3,3
S01010895,Fair health,59,0,0,0,7,2,5,2,11,17,14,9,5,1
S01010895,Bad health,35,1,1,0,3,2,1,2,13,8,5,5,0,0
S01010895,Very bad health,11,0,0,0,0,1,0,0,3,5,2,2,0,0
S01010896,All people aged 16 to 74,525,10,2,8,66,60,20,46,111,125,44,27,17,43
S01010896,Very good health,216,6,2,4,37,26,7,21,33,42,11,3,8,33
S01010896,Good health,164,3,0,3,17,22,6,17,37,43,12,8,4,7
S01010896,Fair health,85,0,0,0,7,11,6,3,18,26,12,9,3,2
S01010896,Bad health,47,1,0,1,3,0,1,4,21,10,6,4,2,1
S01010896,Very bad health,13,0,0,0,2,1,0,1,2,4,3,3,0,0
S01010897,All people aged 16 to 74,622,14,3,11,60,61,27,52,137,166,64,40,24,41
S01010897,Very good health,235,5,1,4,34,25,5,16,56,52,16,9,7,26
S01010897,Good health,205,4,1,3,18,26,10,19,42,50,23,10,13,13
S01010897,Fair health,110,2,0,2,4,6,6,10,29,38,13,9,4,2
S01010897,Bad health,55,3,1,2,2,3,6,5,8,19,9,9,0,0
S01010897,Very bad health,17,0,0,0,2,1,0,2,2,7,3,3,0,0
S01010898,All people aged 16 to 74,473,7,3,4,44,48,33,45,93,116,53,35,18,34
S01010898,Very good health,194,3,1,2,13,29,14,22,36,37,15,7,8,25
S01010898,Good health,153,2,1,1,21,14,9,14,28,40,18,11,7,7
S01010898,Fair health,75,0,0,0,6,2,6,7,18,23,11,8,3,2
S01010898,Bad health,41,2,1,1,2,1,4,1,10,14,7,7,0,0
S01010898,Very bad health,10,0,0,0,2,2,0,1,1,2,2,2,0,0
S01010899,All people aged 16 to 74,455,16,4,12,79,59,17,39,89,84,22,13,9,50
S01010899,Very good health,243,11,3,8,52,26,9,23,40,33,8,5,3,41
S01010899,Good health,138,5,1,4,21,25,5,9,31,26,8,4,4,8
S01010899,Fair health,42,0,0,0,2,6,1,5,12,13,2,1,1,1
S01010899,Bad health,21,0,0,0,3,2,1,0,4,8,3,2,1,0
S01010899,Very bad health,11,0,0,0,1,0,1,2,2,4,1,1,0,0
S01010900,All people aged 16 to 74,493,14,1,13,59,50,17,48,115,120,41,23,18,29
S01010900,Very good health,214,9,1,8,28,29,7,19,51,43,11,7,4,17
S01010900,Good health,173,3,0,3,18,16,6,19,41,42,16,6,10,12
S01010900,Fair health,75,1,0,1,11,2,2,3,19,27,10,6,4,0
S01010900,Bad health,22,0,0,0,1,1,2,4,3,7,4,4,0,0
S01010900,Very bad health,9,1,0,1,1,2,0,3,1,1,0,0,0,0
S01010901,All people aged 16 to 74,325,5,1,4,21,25,9,28,87,107,26,19,7,17
S01010901,Very good health,127,4,1,3,10,19,5,6,29,30,12,6,6,12
S01010901,Good health,100,0,0,0,8,0,1,6,38,35,7,7,0,5
S01010901,Fair health,53,1,0,1,2,4,3,6,9,24,4,3,1,0
S01010901,Bad health,35,0,0,0,1,2,0,7,6,17,2,2,0,0
S01010901,Very bad health,10,0,0,0,0,0,0,3,5,1,1,1,0,0
S01010902,All people aged 16 to 74,742,35,11,24,109,92,28,75,154,149,52,37,15,48
S01010902,Very good health,292,11,2,9,61,46,6,26,51,40,15,11,4,36
S01010902,Good health,263,15,6,9,27,37,18,23,59,55,20,12,8,9
S01010902,Fair health,112,5,2,3,12,7,2,15,24,34,11,8,3,2
S01010902,Bad health,59,3,1,2,7,2,1,8,17,18,3,3,0,0
S01010902,Very bad health,16,1,0,1,2,0,1,3,3,2,3,3,0,1
S01010903,All people aged 16 to 74,603,9,3,6,54,52,21,60,157,149,69,49,20,32
S01010903,Very good health,185,5,2,3,23,22,8,14,46,42,10,6,4,15
S01010903,Good health,190,1,0,1,17,15,7,20,50,40,25,13,12,15
S01010903,Fair health,134,1,0,1,8,7,6,11,43,38,18,15,3,2
S01010903,Bad health,77,1,0,1,4,7,0,14,12,25,14,13,1,0
S01010903,Very bad health,17,1,1,0,2,1,0,1,6,4,2,2,0,0
S01010904,All people aged 16 to 74,430,12,1,11,32,45,15,33,106,96,54,38,16,37
S01010904,Very good health,150,7,1,6,12,21,1,9,33,32,11,8,3,24
S01010904,Good health,160,5,0,5,12,20,10,12,43,33,15,6,9,10
S01010904,Fair health,73,0,0,0,3,2,0,6,19,23,17,13,4,3
S01010904,Bad health,32,0,0,0,3,2,2,5,9,5,6,6,0,0
S01010904,Very bad health,15,0,0,0,2,0,2,1,2,3,5,5,0,0
S01010905,All people aged 16 to 74,486,28,4,24,94,76,18,28,85,69,43,37,6,45
S01010905,Very good health,226,19,2,17,64,38,8,11,32,20,5,3,2,29
S01010905,Good health,170,8,2,6,24,30,6,13,34,27,14,12,2,14
S01010905,Fair health,49,1,0,1,2,4,3,2,7,14,15,14,1,1
S01010905,Bad health,27,0,0,0,2,3,0,1,7,6,7,6,1,1
S01010905,Very bad health,14,0,0,0,2,1,1,1,5,2,2,2,0,0
S01010906,All people aged 16 to 74,724,29,6,23,95,74,25,54,147,185,59,38,21,56
S01010906,Very good health,352,20,6,14,61,47,11,30,61,56,22,11,11,44
S01010906,Good health,222,5,0,5,26,15,11,19,50,71,16,9,7,9
S01010906,Fair health,92,4,0,4,5,7,3,2,31,29,9,6,3,2
S01010906,Bad health,37,0,0,0,3,5,0,2,5,15,7,7,0,0
S01010906,Very bad health,21,0,0,0,0,0,0,1,0,14,5,5,0,1
S01010907,All people aged 16 to 74,391,41,11,30,105,72,23,24,57,36,13,7,6,20
S01010907,Very good health,240,26,6,20,74,43,7,16,32,17,8,4,4,17
S01010907,Good health,113,11,2,9,26,21,13,7,18,11,3,1,2,3
S01010907,Fair health,29,4,3,1,5,5,2,1,5,5,2,2,0,0
S01010907,Bad health,6,0,0,0,0,2,0,0,1,3,0,0,0,0
S01010907,Very bad health,3,0,0,0,0,1,1,0,1,0,0,0,0,0
S01010908,All people aged 16 to 74,455,27,5,22,78,71,17,32,90,86,23,16,7,31
S01010908,Very good health,208,8,3,5,48,38,8,9,38,30,3,1,2,26
S01010908,Good health,145,13,1,12,24,19,8,16,27,25,8,5,3,5
S01010908,Fair health,56,6,1,5,3,7,0,4,13,16,7,5,2,0
S01010908,Bad health,31,0,0,0,3,5,1,2,9,10,1,1,0,0
S01010908,Very bad health,15,0,0,0,0,2,0,1,3,5,4,4,0,0
S01010909,All people aged 16 to 74,551,33,12,21,127,95,33,43,91,62,17,11,6,50
S01010909,Very good health,298,18,7,11,75,55,10,23,44,22,4,2,2,47
S01010909,Good health,175,11,4,7,41,33,18,15,31,20,4,4,0,2
S01010909,Fair health,52,1,0,1,7,7,2,3,12,15,4,2,2,1
S01010909,Bad health,20,3,1,2,3,0,2,2,2,4,4,2,2,0
S01010909,Very bad health,6,0,0,0,1,0,1,0,2,1,1,1,0,0
S01010910,All people aged 16 to 74,376,10,2,8,48,51,9,26,84,75,48,22,26,25
S01010910,Very good health,173,7,2,5,25,30,3,12,32,23,20,10,10,21
S01010910,Good health,94,0,0,0,10,15,3,7,25,17,15,3,12,2
S01010910,Fair health,70,3,0,3,8,5,3,2,19,20,8,5,3,2
S01010910,Bad health,34,0,0,0,4,1,0,5,6,13,5,4,1,0
S01010910,Very bad health,5,0,0,0,1,0,0,0,2,2,0,0,0,0
S01010911,All people aged 16 to 74,399,10,3,7,59,42,11,33,97,111,18,9,9,18
S01010911,Very good health,122,7,1,6,25,13,3,8,23,21,7,3,4,15
S01010911,Good health,135,2,1,1,28,13,7,11,38,29,4,1,3,3
S01010911,Fair health,88,0,0,0,4,10,1,9,24,36,4,2,2,0
S01010911,Bad health,38,1,1,0,2,4,0,2,9,20,0,0,0,0
S01010911,Very bad health,16,0,0,0,0,2,0,3,3,5,3,3,0,0
S01010912,All people aged 16 to 74,483,19,0,19,49,46,29,34,103,118,42,30,12,43
S01010912,Very good health,164,10,0,10,25,17,10,8,26,24,11,8,3,33
S01010912,Good health,129,8,0,8,12,14,7,14,31,28,9,4,5,6
S01010912,Fair health,101,0,0,0,9,3,4,5,32,36,8,6,2,4
S01010912,Bad health,64,1,0,1,3,8,5,5,7,23,12,10,2,0
S01010912,Very bad health,25,0,0,0,0,4,3,2,7,7,2,2,0,0
S01010913,All people aged 16 to 74,504,27,4,23,109,87,33,33,75,78,17,13,4,45
S01010913,Very good health,247,17,1,16,54,48,13,17,32,23,6,5,1,37
S01010913,Good health,166,7,2,5,40,27,12,12,29,29,2,1,1,8
S01010913,Fair health,55,2,1,1,10,8,6,4,7,14,4,2,2,0
S01010913,Bad health,24,1,0,1,3,3,1,0,6,8,2,2,0,0
S01010913,Very bad health,12,0,0,0,2,1,1,0,1,4,3,3,0,0
S01010914,All people aged 16 to 74,528,16,4,12,87,106,30,47,102,82,16,6,10,42
S01010914,Very good health,266,9,1,8,46,54,10,23,49,37,7,2,5,31
S01010914,Good health,187,5,2,3,31,36,16,15,34,35,7,3,4,8
S01010914,Fair health,54,2,1,1,7,14,4,5,14,4,2,1,1,2
S01010914,Bad health,20,0,0,0,2,2,0,4,5,6,0,0,0,1
S01010914,Very bad health,1,0,0,0,1,0,0,0,0,0,0,0,0,0
S01010915,All people aged 16 to 74,575,26,7,19,85,72,26,53,141,99,18,12,6,55
S01010915,Very good health,304,15,4,11,51,42,16,23,68,40,6,2,4,43
S01010915,Good health,169,9,3,6,24,20,8,17,43,32,8,6,2,8
S01010915,Fair health,67,2,0,2,7,5,1,10,22,15,1,1,0,4
S01010915,Bad health,29,0,0,0,3,5,1,3,7,9,1,1,0,0
S01010915,Very bad health,6,0,0,0,0,0,0,0,1,3,2,2,0,0
S01010916,All people aged 16 to 74,433,5,1,4,32,57,18,27,87,121,37,24,13,49
S01010916,Very good health,148,2,0,2,7,20,5,9,31,25,9,7,2,40
S01010916,Good health,162,3,1,2,20,26,4,12,26,54,13,7,6,4
S01010916,Fair health,56,0,0,0,3,6,4,4,12,17,7,3,4,3
S01010916,Bad health,43,0,0,0,1,3,5,1,12,15,5,4,1,1
S01010916,Very bad health,24,0,0,0,1,2,0,1,6,10,3,3,0,1
S01010917,All people aged 16 to 74,537,22,5,17,83,83,19,57,118,92,34,24,10,29
S01010917,Very good health,233,15,3,12,46,37,9,23,46,28,6,5,1,23
S01010917,Good health,178,5,1,4,28,26,5,23,37,34,15,8,7,5
S01010917,Fair health,71,1,0,1,3,13,3,11,15,16,9,7,2,0
S01010917,Bad health,44,1,1,0,6,6,2,0,17,9,2,2,0,1
S01010917,Very bad health,11,0,0,0,0,1,0,0,3,5,2,2,0,0
S01010918,All people aged 16 to 74,532,7,3,4,66,50,19,51,136,128,34,25,9,41
S01010918,Very good health,237,4,1,3,34,29,10,25,53,40,12,10,2,30
S01010918,Good health,161,1,0,1,22,16,6,14,42,41,10,6,4,9
S01010918,Fair health,89,2,2,0,8,3,2,9,24,31,10,7,3,0
S01010918,Bad health,35,0,0,0,2,2,1,3,15,9,1,1,0,2
S01010918,Very bad health,10,0,0,0,0,0,0,0,2,7,1,1,0,0
S01010919,All people aged 16 to 74,613,12,1,11,74,63,21,56,145,155,40,28,12,47
S01010919,Very good health,249,5,0,5,28,34,7,23,57,43,14,7,7,38
S01010919,Good health,191,5,0,5,32,17,9,21,34,58,7,4,3,8
S01010919,Fair health,105,1,1,0,9,8,3,9,35,30,9,7,2,1
S01010919,Bad health,50,1,0,1,5,3,2,3,11,17,8,8,0,0
S01010919,Very bad health,18,0,0,0,0,1,0,0,8,7,2,2,0,0
S01010920,All people aged 16 to 74,439,20,4,16,36,43,22,34,86,111,50,32,18,37
S01010920,Very good health,175,16,3,13,22,18,14,10,23,26,19,13,6,27
S01010920,Good health,130,3,1,2,11,15,5,14,34,27,16,9,7,5
S01010920,Fair health,78,1,0,1,2,7,2,4,17,28,12,7,5,5
S01010920,Bad health,42,0,0,0,1,3,0,6,7,22,3,3,0,0
S01010920,Very bad health,14,0,0,0,0,0,1,0,5,8,0,0,0,0
S01010921,All people aged 16 to 74,486,7,1,6,43,58,15,49,107,139,34,27,7,34
S01010921,Very good health,190,4,0,4,22,18,5,18,40,49,11,9,2,23
S01010921,Good health,160,2,0,2,17,29,6,15,34,42,6,6,0,9
S01010921,Fair health,84,1,1,0,3,10,3,13,20,24,10,6,4,0
S01010921,Bad health,45,0,0,0,1,1,1,3,11,23,4,3,1,1
S01010921,Very bad health,7,0,0,0,0,0,0,0,2,1,3,3,0,1
S01010922,All people aged 16 to 74,630,15,2,13,70,53,21,57,145,156,48,39,9,65
S01010922,Very good health,250,11,1,10,37,21,8,22,44,47,12,9,3,48
S01010922,Good health,196,0,0,0,24,21,6,18,56,41,15,12,3,15
S01010922,Fair health,122,3,1,2,8,9,6,8,27,45,14,11,3,2
S01010922,Bad health,50,1,0,1,1,2,1,7,15,18,5,5,0,0
S01010922,Very bad health,12,0,0,0,0,0,0,2,3,5,2,2,0,0
S01010923,All people aged 16 to 74,687,14,2,12,80,99,30,53,157,172,42,27,15,40
S01010923,Very good health,263,9,1,8,34,42,14,22,59,45,11,7,4,27
S01010923,Good health,230,4,1,3,27,34,3,19,59,62,12,4,8,10
S01010923,Fair health,130,1,0,1,14,21,9,8,26,36,12,9,3,3
S01010923,Bad health,47,0,0,0,4,2,4,3,10,20,4,4,0,0
S01010923,Very bad health,17,0,0,0,1,0,0,1,3,9,3,3,0,0
S01010924,All people aged 16 to 74,472,4,3,1,54,51,16,52,116,128,24,16,8,27
S01010924,Very good health,190,1,1,0,28,28,7,22,45,28,8,4,4,23
S01010924,Good health,150,2,1,1,15,15,5,14,46,42,7,4,3,4
S01010924,Fair health,79,1,1,0,8,4,2,9,18,32,5,4,1,0
S01010924,Bad health,44,0,0,0,3,4,1,5,6,23,2,2,0,0
S01010924,Very bad health,9,0,0,0,0,0,1,2,1,3,2,2,0,0
S01010925,All people aged 16 to 74,619,6,0,6,70,75,26,45,147,175,37,17,20,38
S01010925,Very good health,251,5,0,5,37,35,8,14,54,51,18,10,8,29
S01010925,Good health,216,1,0,1,22,26,9,20,57,63,10,3,7,8
S01010925,Fair health,106,0,0,0,10,9,6,9,26,40,5,1,4,1
S01010925,Bad health,38,0,0,0,0,5,2,1,10,16,4,3,1,0
S01010925,Very bad health,8,0,0,0,1,0,1,1,0,5,0,0,0,0
S01010926,All people aged 16 to 74,614,7,2,5,56,77,26,57,133,182,32,22,10,44
S01010926,Very good health,257,4,0,4,29,38,10,24,48,62,11,8,3,31
S01010926,Good health,199,2,1,1,19,29,9,18,48,57,11,7,4,6
S01010926,Fair health,95,0,0,0,5,8,3,10,23,32,8,5,3,6
S01010926,Bad health,48,1,1,0,2,2,4,4,11,22,1,1,0,1
S01010926,Very bad health,15,0,0,0,1,0,0,1,3,9,1,1,0,0
S01010927,All people aged 16 to 74,418,9,4,5,53,41,17,38,112,92,35,25,10,21
S01010927,Very good health,172,5,3,2,30,19,5,13,43,32,12,6,6,13
S01010927,Good health,124,1,0,1,12,15,9,15,35,28,3,1,2,6
S01010927,Fair health,76,3,1,2,6,4,1,8,18,21,13,11,2,2
S01010927,Bad health,39,0,0,0,4,3,1,2,15,10,4,4,0,0
S01010927,Very bad health,7,0,0,0,1,0,1,0,1,1,3,3,0,0
S01010928,All people aged 16 to 74,526,10,2,8,50,49,27,39,123,147,41,27,14,40
S01010928,Very good health,213,3,1,2,23,20,13,11,45,53,20,11,9,25
S01010928,Good health,164,4,0,4,18,19,7,17,43,39,9,5,4,8
S01010928,Fair health,98,2,1,1,6,4,3,5,26,37,9,8,1,6
S01010928,Bad health,39,1,0,1,0,3,3,6,9,14,2,2,0,1
S01010928,Very bad health,12,0,0,0,3,3,1,0,0,4,1,1,0,0
S01010929,All people aged 16 to 74,483,5,1,4,38,42,16,53,116,145,27,16,11,41
S01010929,Very good health,194,4,1,3,20,22,5,21,41,41,11,6,5,29
S01010929,Good health,145,1,0,1,11,15,8,10,40,46,6,3,3,8
S01010929,Fair health,76,0,0,0,5,3,1,13,16,30,5,2,3,3
S01010929,Bad health,59,0,0,0,1,2,2,7,17,25,4,4,0,1
S01010929,Very bad health,9,0,0,0,1,0,0,2,2,3,1,1,0,0
S01010930,All people aged 16 to 74,666,132,19,113,200,72,95,26,49,36,15,3,12,41
S01010930,Very good health,410,93,16,77,124,50,52,14,22,15,5,0,5,35
S01010930,Good health,196,33,3,30,57,19,32,8,21,15,5,0,5,6
S01010930,Fair health,43,4,0,4,14,2,9,4,5,3,2,0,2,0
S01010930,Bad health,14,1,0,1,5,1,2,0,1,3,1,1,0,0
S01010930,Very bad health,3,1,0,1,0,0,0,0,0,0,2,2,0,0
S01010931,All people aged 16 to 74,331,44,12,32,73,44,56,18,51,23,5,2,3,17
S01010931,Very good health,168,22,7,15,44,22,30,7,19,10,0,0,0,14
S01010931,Good health,115,20,5,15,18,15,19,10,18,9,5,2,3,1
S01010931,Fair health,33,2,0,2,6,4,6,1,9,3,0,0,0,2
S01010931,Bad health,11,0,0,0,3,2,1,0,4,1,0,0,0,0
S01010931,Very bad health,4,0,0,0,2,1,0,0,1,0,0,0,0,0
S01010932,All people aged 16 to 74,413,21,7,14,79,51,37,36,78,71,25,19,6,15
S01010932,Very good health,182,12,4,8,41,24,19,14,31,21,10,6,4,10
S01010932,Good health,129,7,2,5,26,21,8,10,26,20,9,8,1,2
S01010932,Fair health,67,2,1,1,10,6,6,7,13,20,3,3,0,0
S01010932,Bad health,25,0,0,0,1,0,3,3,5,8,3,2,1,2
S01010932,Very bad health,10,0,0,0,1,0,1,2,3,2,0,0,0,1
S01010933,All people aged 16 to 74,560,102,14,88,155,81,63,28,53,33,16,13,3,29
S01010933,Very good health,339,81,8,73,101,42,32,17,21,13,5,5,0,27
S01010933,Good health,153,19,5,14,41,34,21,6,18,11,2,1,1,1
S01010933,Fair health,48,2,1,1,8,4,7,4,11,4,8,6,2,0
S01010933,Bad health,15,0,0,0,3,1,3,1,3,4,0,0,0,0
S01010933,Very bad health,5,0,0,0,2,0,0,0,0,1,1,1,0,1
S01010934,All people aged 16 to 74,779,125,22,103,227,133,57,43,88,44,20,11,9,42
S01010934,Very good health,451,79,14,65,152,72,34,26,33,16,4,1,3,35
S01010934,Good health,237,34,6,28,60,43,17,11,37,22,8,4,4,5
S01010934,Fair health,62,9,1,8,11,12,3,4,13,3,6,4,2,1
S01010934,Bad health,23,3,1,2,4,5,2,0,3,3,2,2,0,1
S01010934,Very bad health,6,0,0,0,0,1,1,2,2,0,0,0,0,0
S01010935,All people aged 16 to 74,473,70,11,59,125,86,41,25,58,37,8,7,1,23
S01010935,Very good health,245,34,5,29,62,43,27,8,31,17,3,3,0,20
S01010935,Good health,158,27,3,24,44,27,6,17,19,12,3,2,1,3
S01010935,Fair health,45,7,2,5,12,10,5,0,6,5,0,0,0,0
S01010935,Bad health,16,0,0,0,5,4,2,0,2,1,2,2,0,0
S01010935,Very bad health,9,2,1,1,2,2,1,0,0,2,0,0,0,0
S01010936,All people aged 16 to 74,526,39,4,35,110,110,46,45,66,65,15,6,9,30
S01010936,Very good health,258,27,1,26,62,56,19,20,27,22,3,2,1,22
S01010936,Good health,192,12,3,9,44,42,19,14,25,20,8,2,6,8
S01010936,Fair health,58,0,0,0,3,9,4,8,13,18,3,1,2,0
S01010936,Bad health,14,0,0,0,1,3,3,1,1,4,1,1,0,0
S01010936,Very bad health,4,0,0,0,0,0,1,2,0,1,0,0,0,0
S01010937,All people aged 16 to 74,573,49,14,35,140,116,42,48,81,54,10,3,7,33
S01010937,Very good health,287,28,7,21,66,52,20,27,37,24,4,1,3,29
S01010937,Good health,202,14,5,9,50,53,16,12,29,23,2,1,1,3
S01010937,Fair health,66,6,2,4,21,7,5,6,12,6,2,0,2,1
S01010937,Bad health,15,1,0,1,3,2,0,3,3,1,2,1,1,0
S01010937,Very bad health,3,0,0,0,0,2,1,0,0,0,0,0,0,0
S01010938,All people aged 16 to 74,572,16,3,13,79,79,34,60,111,118,46,23,23,29
S01010938,Very good health,238,9,3,6,41,29,13,22,34,46,23,13,10,21
S01010938,Good health,203,5,0,5,19,27,10,28,53,45,10,3,7,6
S01010938,Fair health,101,2,0,2,17,18,8,8,16,22,9,5,4,1
S01010938,Bad health,21,0,0,0,0,3,3,2,5,3,4,2,2,1
S01010938,Very bad health,9,0,0,0,2,2,0,0,3,2,0,0,0,0
S01010939,All people aged 16 to 74,402,27,3,24,78,76,29,43,68,38,10,5,5,33
S01010939,Very good health,210,17,1,16,40,38,7,21,38,16,5,2,3,28
S01010939,Good health,138,9,2,7,25,28,17,18,19,14,3,1,2,5
S01010939,Fair health,44,1,0,1,12,9,4,3,8,6,1,1,0,0
S01010939,Bad health,8,0,0,0,1,0,0,1,3,2,1,1,0,0
S01010939,Very bad health,2,0,0,0,0,1,1,0,0,0,0,0,0,0
S01010940,All people aged 16 to 74,520,76,17,59,148,103,28,27,60,30,6,3,3,42
S01010940,Very good health,301,42,9,33,87,57,15,17,30,12,2,1,1,39
S01010940,Good health,175,26,7,19,50,39,8,7,24,16,2,2,0,3
S01010940,Fair health,35,5,0,5,10,6,4,2,6,1,1,0,1,0
S01010940,Bad health,7,3,1,2,0,1,1,0,0,1,1,0,1,0
S01010940,Very bad health,2,0,0,0,1,0,0,1,0,0,0,0,0,0
S01010941,All people aged 16 to 74,668,73,15,58,189,131,54,42,77,29,12,7,5,61
S01010941,Very good health,395,42,6,36,106,74,26,24,50,17,7,5,2,49
S01010941,Good health,205,24,9,15,59,48,21,11,21,7,4,1,3,10
S01010941,Fair health,58,6,0,6,21,9,7,5,4,4,1,1,0,1
S01010941,Bad health,8,1,0,1,2,0,0,1,2,1,0,0,0,1
S01010941,Very bad health,2,0,0,0,1,0,0,1,0,0,0,0,0,0
S01010942,All people aged 16 to 74,523,68,17,51,151,109,30,29,65,28,6,4,2,37
S01010942,Very good health,275,36,10,26,84,49,19,11,31,12,4,3,1,29
S01010942,Good health,186,23,6,17,51,46,9,13,25,10,2,1,1,7
S01010942,Fair health,49,8,1,7,14,10,1,5,7,4,0,0,0,0
S01010942,Bad health,8,1,0,1,1,1,1,0,2,1,0,0,0,1
S01010942,Very bad health,5,0,0,0,1,3,0,0,0,1,0,0,0,0
S01010943,All people aged 16 to 74,469,22,3,19,88,63,21,54,95,67,29,12,17,30
S01010943,Very good health,204,12,1,11,42,29,8,23,34,25,11,4,7,20
S01010943,Good health,179,8,1,7,34,26,9,21,39,20,14,6,8,8
S01010943,Fair health,56,0,0,0,11,4,1,7,15,14,3,2,1,1
S01010943,Bad health,22,2,1,1,0,3,1,2,5,7,1,0,1,1
S01010943,Very bad health,8,0,0,0,1,1,2,1,2,1,0,0,0,0
S01010944,All people aged 16 to 74,431,13,1,12,71,65,20,38,94,87,21,9,12,22
S01010944,Very good health,175,7,0,7,34,29,8,12,37,24,9,4,5,15
S01010944,Good health,161,5,1,4,25,28,7,15,35,32,8,3,5,6
S01010944,Fair health,64,1,0,1,9,6,3,7,15,19,3,1,2,1
S01010944,Bad health,27,0,0,0,2,2,2,4,4,12,1,1,0,0
S01010944,Very bad health,4,0,0,0,1,0,0,0,3,0,0,0,0,0
S01010945,All people aged 16 to 74,415,15,2,13,66,75,31,43,76,74,15,8,7,20
S01010945,Very good health,195,10,2,8,34,32,16,15,36,28,11,6,5,13
S01010945,Good health,158,4,0,4,27,30,8,22,28,31,2,0,2,6
S01010945,Fair health,55,0,0,0,5,11,6,6,11,14,1,1,0,1
S01010945,Bad health,4,1,0,1,0,1,1,0,0,0,1,1,0,0
S01010945,Very bad health,3,0,0,0,0,1,0,0,1,1,0,0,0,0
S01010946,All people aged 16 to 74,600,19,4,15,92,87,46,61,112,111,39,27,12,33
S01010946,Very good health,263,11,2,9,40,37,23,26,46,42,15,11,4,23
S01010946,Good health,242,7,2,5,38,36,14,31,52,44,15,10,5,5
S01010946,Fair health,72,1,0,1,7,11,7,3,8,22,8,5,3,5
S01010946,Bad health,22,0,0,0,7,3,2,1,6,3,0,0,0,0
S01010946,Very bad health,1,0,0,0,0,0,0,0,0,0,1,1,0,0
S01010947,All people aged 16 to 74,404,15,4,11,66,64,26,36,108,57,17,11,6,15
S01010947,Very good health,169,11,3,8,29,24,10,13,44,23,8,6,2,7
S01010947,Good health,162,4,1,3,25,23,12,18,50,21,5,2,3,4
S01010947,Fair health,56,0,0,0,10,11,4,2,12,10,3,2,1,4
S01010947,Bad health,13,0,0,0,2,4,0,2,1,3,1,1,0,0
S01010947,Very bad health,4,0,0,0,0,2,0,1,1,0,0,0,0,0
S01010948,All people aged 16 to 74,510,23,4,19,71,90,36,41,110,95,16,8,8,28
S01010948,Very good health,227,12,1,11,28,41,16,14,49,28,13,6,7,26
S01010948,Good health,184,8,2,6,31,34,14,16,39,39,2,2,0,1
S01010948,Fair health,68,2,0,2,7,13,5,7,12,20,1,0,1,1
S01010948,Bad health,27,1,1,0,4,2,1,4,9,6,0,0,0,0
S01010948,Very bad health,4,0,0,0,1,0,0,0,1,2,0,0,0,0
S01010949,All people aged 16 to 74,732,77,15,62,180,149,54,61,100,43,11,6,5,57
S01010949,Very good health,422,40,7,33,101,84,32,38,53,19,7,5,2,48
S01010949,Good health,231,30,7,23,65,51,15,16,29,16,3,1,2,6
S01010949,Fair health,54,5,1,4,10,10,6,3,11,5,1,0,1,3
S01010949,Bad health,21,1,0,1,2,4,1,4,6,3,0,0,0,0
S01010949,Very bad health,4,1,0,1,2,0,0,0,1,0,0,0,0,0
S01010950,All people aged 16 to 74,616,49,8,41,139,101,35,56,113,81,16,8,8,26
S01010950,Very good health,307,32,4,28,69,56,13,25,49,34,7,2,5,22
S01010950,Good health,202,13,3,10,45,31,13,20,39,33,5,3,2,3
S01010950,Fair health,71,2,0,2,18,11,6,8,14,7,4,3,1,1
S01010950,Bad health,29,2,1,1,7,2,2,2,8,6,0,0,0,0
S01010950,Very bad health,7,0,0,0,0,1,1,1,3,1,0,0,0,0
S01010951,All people aged 16 to 74,469,25,5,20,87,91,22,48,82,67,13,6,7,34
S01010951,Very good health,223,17,3,14,42,44,9,26,26,30,6,4,2,23
S01010951,Good health,181,7,1,6,32,37,11,14,39,29,6,1,5,6
S01010951,Fair health,59,1,1,0,11,9,2,7,16,7,1,1,0,5
S01010951,Bad health,5,0,0,0,2,0,0,1,1,1,0,0,0,0
S01010951,Very bad health,1,0,0,0,0,1,0,0,0,0,0,0,0,0
S01010952,All people aged 16 to 74,392,38,9,29,69,70,27,41,66,39,14,11,3,28
S01010952,Very good health,206,25,6,19,38,34,9,23,35,18,5,3,2,19
S01010952,Good health,138,12,2,10,24,26,18,10,21,14,5,4,1,8
S01010952,Fair health,31,0,0,0,5,8,0,5,6,5,1,1,0,1
S01010952,Bad health,13,1,1,0,1,0,0,2,4,2,3,3,0,0
S01010952,Very bad health,4,0,0,0,1,2,0,1,0,0,0,0,0,0
S01010953,All people aged 16 to 74,438,23,7,16,82,93,25,33,84,59,8,5,3,31
S01010953,Very good health,213,13,3,10,40,56,8,17,32,21,2,1,1,24
S01010953,Good health,149,8,2,6,24,29,12,12,34,23,2,1,1,5
S01010953,Fair health,55,2,2,0,13,7,4,2,13,9,4,3,1,1
S01010953,Bad health,19,0,0,0,4,0,1,2,5,6,0,0,0,1
S01010953,Very bad health,2,0,0,0,1,1,0,0,0,0,0,0,0,0
S01010954,All people aged 16 to 74,517,39,15,24,113,149,32,31,66,41,5,3,2,41
S01010954,Very good health,307,26,10,16,64,95,15,20,33,20,3,1,2,31
S01010954,Good health,153,11,5,6,40,35,12,8,24,15,1,1,0,7
S01010954,Fair health,46,2,0,2,7,15,3,3,8,6,1,1,0,1
S01010954,Bad health,4,0,0,0,1,2,1,0,0,0,0,0,0,0
S01010954,Very bad health,7,0,0,0,1,2,1,0,1,0,0,0,0,2
S01010955,All people aged 16 to 74,691,91,21,70,199,116,53,32,93,34,23,12,11,50
S01010955,Very good health,451,59,14,45,143,73,29,23,51,21,11,7,4,41
S01010955,Good health,194,26,4,22,49,37,17,5,34,8,11,5,6,7
S01010955,Fair health,34,5,2,3,6,5,5,2,6,3,1,0,1,1
S01010955,Bad health,9,1,1,0,1,1,0,2,1,2,0,0,0,1
S01010955,Very bad health,3,0,0,0,0,0,2,0,1,0,0,0,0,0
S01010956,All people aged 16 to 74,545,88,9,79,134,54,84,32,61,51,15,11,4,26
S01010956,Very good health,280,59,7,52,75,22,43,15,24,15,5,4,1,22
S01010956,Good health,200,25,1,24,45,26,33,13,26,22,6,3,3,4
S01010956,Fair health,52,4,1,3,12,6,7,3,7,12,1,1,0,0
S01010956,Bad health,10,0,0,0,2,0,1,1,2,2,2,2,0,0
S01010956,Very bad health,3,0,0,0,0,0,0,0,2,0,1,1,0,0
S01010957,All people aged 16 to 74,443,65,13,52,111,91,30,35,62,23,6,4,2,20
S01010957,Very good health,222,36,4,32,54,44,16,14,34,9,0,0,0,15
S01010957,Good health,160,26,9,17,41,33,10,13,20,10,2,2,0,5
S01010957,Fair health,48,3,0,3,11,10,3,6,8,3,4,2,2,0
S01010957,Bad health,11,0,0,0,4,4,1,1,0,1,0,0,0,0
S01010957,Very bad health,2,0,0,0,1,0,0,1,0,0,0,0,0,0
S01010958,All people aged 16 to 74,364,51,11,40,88,48,31,20,58,43,9,4,5,16
S01010958,Very good health,200,36,9,27,56,22,19,9,26,13,4,3,1,15
S01010958,Good health,114,12,1,11,30,17,9,7,18,18,3,0,3,0
S01010958,Fair health,32,3,1,2,1,6,2,3,9,6,1,0,1,1
S01010958,Bad health,13,0,0,0,1,1,1,0,5,5,0,0,0,0
S01010958,Very bad health,5,0,0,0,0,2,0,1,0,1,1,1,0,0
S01010959,All people aged 16 to 74,442,51,9,42,119,60,31,29,63,40,13,4,9,36
S01010959,Very good health,233,28,4,24,73,26,17,20,24,14,6,1,5,25
S01010959,Good health,142,19,5,14,32,25,9,6,23,15,3,0,3,10
S01010959,Fair health,54,4,0,4,11,9,3,2,13,8,3,2,1,1
S01010959,Bad health,10,0,0,0,3,0,1,1,2,3,0,0,0,0
S01010959,Very bad health,3,0,0,0,0,0,1,0,1,0,1,1,0,0
S01010960,All people aged 16 to 74,812,57,11,46,135,95,65,65,134,151,54,28,26,56
S01010960,Very good health,420,38,8,30,78,52,34,30,56,61,27,12,15,44
S01010960,Good health,243,16,3,13,46,27,24,26,40,43,10,6,4,11
S01010960,Fair health,90,2,0,2,6,12,3,4,22,31,9,4,5,1
S01010960,Bad health,41,1,0,1,3,3,3,4,9,13,5,4,1,0
S01010960,Very bad health,18,0,0,0,2,1,1,1,7,3,3,2,1,0
S01010961,All people aged 16 to 74,411,21,2,19,65,63,29,38,85,75,15,11,4,20
S01010961,Very good health,217,13,0,13,34,34,16,15,38,37,13,10,3,17
S01010961,Good health,130,8,2,6,24,22,8,14,29,21,2,1,1,2
S01010961,Fair health,38,0,0,0,4,5,4,6,12,6,0,0,0,1
S01010961,Bad health,18,0,0,0,3,2,0,1,3,9,0,0,0,0
S01010961,Very bad health,8,0,0,0,0,0,1,2,3,2,0,0,0,0
S01010962,All people aged 16 to 74,462,18,3,15,75,61,43,43,92,106,9,4,5,15
S01010962,Very good health,174,11,2,9,35,25,13,15,30,32,3,1,2,10
S01010962,Good health,165,5,1,4,27,18,19,16,37,34,4,1,3,5
S01010962,Fair health,77,1,0,1,5,11,10,7,16,25,2,2,0,0
S01010962,Bad health,34,1,0,1,4,6,0,2,8,13,0,0,0,0
S01010962,Very bad health,12,0,0,0,4,1,1,3,1,2,0,0,0,0
S01010963,All people aged 16 to 74,699,65,19,46,151,109,63,50,114,79,23,12,11,45
S01010963,Very good health,370,40,13,27,88,63,35,21,50,29,9,4,5,35
S01010963,Good health,234,20,5,15,46,41,21,18,42,28,9,4,5,9
S01010963,Fair health,63,5,1,4,11,3,5,8,15,12,3,2,1,1
S01010963,Bad health,22,0,0,0,6,1,2,2,4,5,2,2,0,0
S01010963,Very bad health,10,0,0,0,0,1,0,1,3,5,0,0,0,0
S01010964,All people aged 16 to 74,406,25,1,24,75,67,29,36,66,83,5,2,3,20
S01010964,Very good health,180,10,0,10,35,33,14,11,29,33,0,0,0,15
S01010964,Good health,149,12,0,12,27,27,8,16,26,26,4,1,3,3
S01010964,Fair health,49,2,1,1,11,5,7,5,5,13,0,0,0,1
S01010964,Bad health,25,1,0,1,2,2,0,4,4,10,1,1,0,1
S01010964,Very bad health,3,0,0,0,0,0,0,0,2,1,0,0,0,0
S01010965,All people aged 16 to 74,393,17,4,13,56,46,18,39,61,94,36,25,11,26
S01010965,Very good health,161,15,4,11,30,17,7,14,14,34,14,6,8,16
S01010965,Good health,139,2,0,2,15,19,6,16,28,31,12,9,3,10
S01010965,Fair health,51,0,0,0,5,7,4,5,11,14,5,5,0,0
S01010965,Bad health,32,0,0,0,4,3,1,3,7,12,2,2,0,0
S01010965,Very bad health,10,0,0,0,2,0,0,1,1,3,3,3,0,0
S01010966,All people aged 16 to 74,536,20,4,16,88,70,44,61,102,98,15,6,9,38
S01010966,Very good health,232,11,4,7,40,35,17,24,39,34,6,3,3,26
S01010966,Good health,191,7,0,7,33,18,17,21,44,39,5,2,3,7
S01010966,Fair health,79,2,0,2,10,13,6,10,15,15,4,1,3,4
S01010966,Bad health,26,0,0,0,4,4,3,6,4,5,0,0,0,0
S01010966,Very bad health,8,0,0,0,1,0,1,0,0,5,0,0,0,1
S01010967,All people aged 16 to 74,487,25,1,24,65,75,29,52,92,90,22,16,6,37
S01010967,Very good health,210,14,1,13,30,36,18,15,39,21,7,7,0,30
S01010967,Good health,167,7,0,7,24,27,9,24,31,32,8,3,5,5
S01010967,Fair health,76,3,0,3,9,9,1,11,14,23,4,3,1,2
S01010967,Bad health,27,1,0,1,1,3,1,1,7,10,3,3,0,0
S01010967,Very bad health,7,0,0,0,1,0,0,1,1,4,0,0,0,0
S01010968,All people aged 16 to 74,535,32,5,27,106,112,43,46,78,75,15,10,5,28
S01010968,Very good health,281,20,3,17,64,56,26,19,39,30,6,5,1,21
S01010968,Good health,170,12,2,10,30,45,9,20,23,24,4,0,4,3
S01010968,Fair health,52,0,0,0,8,10,4,4,8,14,2,2,0,2
S01010968,Bad health,28,0,0,0,4,1,4,2,7,7,1,1,0,2
S01010968,Very bad health,4,0,0,0,0,0,0,1,1,0,2,2,0,0
S01010969,All people aged 16 to 74,444,36,4,32,99,92,44,33,53,43,21,11,10,23
S01010969,Very good health,224,18,2,16,56,50,20,12,21,18,7,2,5,22
S01010969,Good health,158,16,2,14,27,39,20,16,21,13,5,2,3,1
S01010969,Fair health,45,2,0,2,10,3,4,5,5,8,8,6,2,0
S01010969,Bad health,12,0,0,0,4,0,0,0,5,2,1,1,0,0
S01010969,Very bad health,5,0,0,0,2,0,0,0,1,2,0,0,0,0
S01010970,All people aged 16 to 74,704,61,12,49,133,110,60,76,97,104,24,13,11,39
S01010970,Very good health,353,37,7,30,75,55,26,32,43,48,7,3,4,30
S01010970,Good health,230,22,5,17,36,38,25,27,33,35,8,3,5,6
S01010970,Fair health,83,2,0,2,17,11,7,12,14,11,6,4,2,3
S01010970,Bad health,29,0,0,0,4,5,2,3,6,7,2,2,0,0
S01010970,Very bad health,9,0,0,0,1,1,0,2,1,3,1,1,0,0
S01010971,All people aged 16 to 74,772,62,14,48,183,150,64,73,97,73,20,12,8,50
S01010971,Very good health,409,38,6,32,95,84,31,37,35,40,11,8,3,38
S01010971,Good health,262,21,7,14,64,50,22,29,42,17,7,3,4,10
S01010971,Fair health,84,2,0,2,21,12,9,5,16,15,2,1,1,2
S01010971,Bad health,15,1,1,0,2,4,2,1,4,1,0,0,0,0
S01010971,Very bad health,2,0,0,0,1,0,0,1,0,0,0,0,0,0
S01010972,All people aged 16 to 74,613,20,4,16,61,86,30,57,144,124,46,29,17,45
S01010972,Very good health,279,10,1,9,35,35,19,26,54,48,20,11,9,32
S01010972,Good health,199,4,0,4,20,32,8,21,52,44,9,6,3,9
S01010972,Fair health,85,6,3,3,4,13,3,6,23,18,10,7,3,2
S01010972,Bad health,35,0,0,0,2,3,0,1,12,11,5,3,2,1
S01010972,Very bad health,15,0,0,0,0,3,0,3,3,3,2,2,0,1
S01010973,All people aged 16 to 74,389,15,4,11,59,86,28,41,64,56,11,8,3,29
S01010973,Very good health,158,6,1,5,22,37,11,10,24,22,5,4,1,21
S01010973,Good health,165,8,3,5,25,40,9,27,23,22,4,2,2,7
S01010973,Fair health,42,0,0,0,8,7,5,3,11,6,1,1,0,1
S01010973,Bad health,16,1,0,1,3,1,2,1,4,3,1,1,0,0
S01010973,Very bad health,8,0,0,0,1,1,1,0,2,3,0,0,0,0
S01010974,All people aged 16 to 74,522,9,1,8,56,71,40,46,124,125,25,13,12,26
S01010974,Very good health,211,7,1,6,24,29,16,15,45,54,6,2,4,15
S01010974,Good health,176,2,0,2,24,24,12,14,48,35,8,6,2,9
S01010974,Fair health,89,0,0,0,6,14,5,11,21,25,6,2,4,1
S01010974,Bad health,34,0,0,0,2,3,4,5,7,8,4,2,2,1
S01010974,Very bad health,12,0,0,0,0,1,3,1,3,3,1,1,0,0
S01010975,All people aged 16 to 74,350,8,2,6,37,43,26,36,80,75,25,19,6,20
S01010975,Very good health,146,4,2,2,18,18,11,14,38,25,9,7,2,9
S01010975,Good health,117,4,0,4,9,14,9,14,28,22,10,8,2,7
S01010975,Fair health,57,0,0,0,7,6,6,5,7,19,3,2,1,4
S01010975,Bad health,26,0,0,0,3,5,0,2,6,8,2,2,0,0
S01010975,Very bad health,4,0,0,0,0,0,0,1,1,1,1,0,1,0
S01010976,All people aged 16 to 74,399,20,7,13,64,63,22,33,92,59,23,18,5,23
S01010976,Very good health,168,12,3,9,38,27,12,12,32,15,6,3,3,14
S01010976,Good health,153,7,4,3,21,27,9,13,38,27,5,5,0,6
S01010976,Fair health,59,1,0,1,3,6,1,4,18,13,10,9,1,3
S01010976,Bad health,14,0,0,0,2,3,0,4,1,2,2,1,1,0
S01010976,Very bad health,5,0,0,0,0,0,0,0,3,2,0,0,0,0
S01010977,All people aged 16 to 74,535,30,5,25,93,91,32,47,108,80,17,14,3,37
S01010977,Very good health,284,16,3,13,55,51,12,25,54,35,5,5,0,31
S01010977,Good health,171,11,1,10,31,28,16,14,35,27,4,4,0,5
S01010977,Fair health,58,3,1,2,5,9,2,7,12,11,8,5,3,1
S01010977,Bad health,12,0,0,0,1,1,0,1,4,5,0,0,0,0
S01010977,Very bad health,10,0,0,0,1,2,2,0,3,2,0,0,0,0
S01010978,All people aged 16 to 74,518,19,6,13,77,81,34,51,114,81,33,18,15,28
S01010978,Very good health,250,11,2,9,45,38,17,23,40,35,17,7,10,24
S01010978,Good health,161,5,1,4,24,27,11,18,45,23,5,2,3,3
S01010978,Fair health,71,3,3,0,7,12,5,6,17,14,6,4,2,1
S01010978,Bad health,27,0,0,0,1,2,0,2,9,8,5,5,0,0
S01010978,Very bad health,9,0,0,0,0,2,1,2,3,1,0,0,0,0
S01010979,All people aged 16 to 74,592,23,4,19,82,82,35,58,133,92,41,21,20,46
S01010979,Very good health,253,5,1,4,41,34,17,18,57,33,18,7,11,30
S01010979,Good health,245,17,3,14,29,38,14,27,47,44,15,8,7,14
S01010979,Fair health,65,0,0,0,11,5,4,10,17,11,5,3,2,2
S01010979,Bad health,22,1,0,1,0,4,0,3,10,3,1,1,0,0
S01010979,Very bad health,7,0,0,0,1,1,0,0,2,1,2,2,0,0
S01010980,All people aged 16 to 74,538,39,4,35,86,89,42,34,115,74,23,15,8,36
S01010980,Very good health,232,26,3,23,40,35,16,10,48,27,5,4,1,25
S01010980,Good health,199,10,1,9,34,40,18,13,44,22,8,4,4,10
S01010980,Fair health,66,3,0,3,6,7,7,5,15,16,6,3,3,1
S01010980,Bad health,32,0,0,0,5,5,1,5,6,7,3,3,0,0
S01010980,Very bad health,9,0,0,0,1,2,0,1,2,2,1,1,0,0
S01010981,All people aged 16 to 74,535,26,7,19,88,81,40,53,95,93,30,21,9,29
S01010981,Very good health,231,10,2,8,41,35,23,19,38,35,9,5,4,21
S01010981,Good health,181,12,4,8,31,32,11,21,31,25,11,6,5,7
S01010981,Fair health,86,4,1,3,14,11,5,9,17,19,7,7,0,0
S01010981,Bad health,26,0,0,0,1,3,1,3,5,10,3,3,0,0
S01010981,Very bad health,11,0,0,0,1,0,0,1,4,4,0,0,0,1
S01010982,All people aged 16 to 74,884,143,21,122,237,124,95,64,92,63,34,21,13,32
S01010982,Very good health,447,81,15,66,132,64,47,24,35,26,11,7,4,27
S01010982,Good health,283,49,3,46,72,38,33,22,33,24,7,4,3,5
S01010982,Fair health,113,9,3,6,26,15,11,14,19,9,10,5,5,0
S01010982,Bad health,23,2,0,2,4,4,3,1,3,1,5,4,1,0
S01010982,Very bad health,18,2,0,2,3,3,1,3,2,3,1,1,0,0
S01010983,All people aged 16 to 74,578,49,9,40,111,111,50,53,91,71,18,12,6,24
S01010983,Very good health,272,33,5,28,51,53,20,21,38,31,7,4,3,18
S01010983,Good health,211,14,4,10,50,37,24,19,36,22,4,2,2,5
S01010983,Fair health,71,2,0,2,7,15,3,8,12,18,6,5,1,0
S01010983,Bad health,19,0,0,0,2,6,1,4,5,0,0,0,0,1
S01010983,Very bad health,5,0,0,0,1,0,2,1,0,0,1,1,0,0
S01010984,All people aged 16 to 74,506,48,13,35,117,107,40,36,62,54,20,15,5,22
S01010984,Very good health,221,20,5,15,58,47,13,14,30,18,3,2,1,18
S01010984,Good health,196,20,4,16,44,48,21,14,21,21,5,4,1,2
S01010984,Fair health,66,8,4,4,12,9,3,7,7,11,8,5,3,1
S01010984,Bad health,19,0,0,0,3,3,2,1,3,3,4,4,0,0
S01010984,Very bad health,4,0,0,0,0,0,1,0,1,1,0,0,0,1
S01010985,All people aged 16 to 74,444,25,4,21,74,81,28,45,80,68,16,12,4,27
S01010985,Very good health,215,15,3,12,38,39,16,20,32,30,6,5,1,19
S01010985,Good health,165,8,1,7,29,33,8,19,33,21,7,4,3,7
S01010985,Fair health,51,2,0,2,5,9,2,5,13,11,3,3,0,1
S01010985,Bad health,8,0,0,0,1,0,1,0,1,5,0,0,0,0
S01010985,Very bad health,5,0,0,0,1,0,1,1,1,1,0,0,0,0
S01010986,All people aged 16 to 74,386,47,11,36,100,85,34,27,41,18,6,6,0,28
S01010986,Very good health,258,32,5,27,68,51,15,20,28,14,3,3,0,27
S01010986,Good health,109,11,4,7,30,30,14,5,13,4,1,1,0,1
S01010986,Fair health,14,2,2,0,2,3,4,2,0,0,1,1,0,0
S01010986,Bad health,4,2,0,2,0,0,1,0,0,0,1,1,0,0
S01010986,Very bad health,1,0,0,0,0,1,0,0,0,0,0,0,0,0
S01010987,All people aged 16 to 74,433,61,13,48,143,80,42,24,37,12,4,3,1,30
S01010987,Very good health,278,45,9,36,95,46,24,16,21,5,1,1,0,25
S01010987,Good health,123,16,4,12,36,25,15,4,15,5,3,2,1,4
S01010987,Fair health,18,0,0,0,7,6,3,0,1,1,0,0,0,0
S01010987,Bad health,11,0,0,0,4,3,0,2,0,1,0,0,0,1
S01010987,Very bad health,3,0,0,0,1,0,0,2,0,0,0,0,0,0
S01010988,All people aged 16 to 74,442,57,15,42,132,81,29,17,54,22,7,4,3,43
S01010988,Very good health,306,43,10,33,93,56,21,12,29,15,2,0,2,35
S01010988,Good health,103,12,5,7,33,17,7,3,18,5,3,2,1,5
S01010988,Fair health,23,2,0,2,6,3,1,1,5,2,0,0,0,3
S01010988,Bad health,8,0,0,0,0,4,0,1,2,0,1,1,0,0
S01010988,Very bad health,2,0,0,0,0,1,0,0,0,0,1,1,0,0
S01010989,All people aged 16 to 74,689,95,10,85,220,142,49,52,69,28,6,4,2,28
S01010989,Very good health,489,67,8,59,168,102,34,36,38,20,3,2,1,21
S01010989,Good health,165,23,0,23,47,33,12,13,23,6,1,0,1,7
S01010989,Fair health,27,5,2,3,4,6,1,2,8,1,0,0,0,0
S01010989,Bad health,7,0,0,0,1,1,2,1,0,0,2,2,0,0
S01010989,Very bad health,1,0,0,0,0,0,0,0,0,1,0,0,0,0
S01010990,All people aged 16 to 74,596,28,3,25,84,119,43,64,124,95,15,10,5,24
S01010990,Very good health,259,15,1,14,44,51,20,32,45,30,4,3,1,18
S01010990,Good health,221,10,1,9,31,54,19,17,48,32,4,2,2,6
S01010990,Fair health,72,2,1,1,6,8,3,13,18,18,4,2,2,0
S01010990,Bad health,30,0,0,0,2,4,0,1,10,10,3,3,0,0
S01010990,Very bad health,14,1,0,1,1,2,1,1,3,5,0,0,0,0
S01010991,All people aged 16 to 74,413,45,8,37,87,73,33,35,64,39,9,1,8,28
S01010991,Very good health,228,35,6,29,52,38,15,20,27,16,4,0,4,21
S01010991,Good health,125,9,2,7,30,28,14,4,22,9,4,1,3,5
S01010991,Fair health,44,1,0,1,3,6,2,10,11,8,1,0,1,2
S01010991,Bad health,13,0,0,0,1,0,2,1,3,6,0,0,0,0
S01010991,Very bad health,3,0,0,0,1,1,0,0,1,0,0,0,0,0
S01010992,All people aged 16 to 74,394,82,11,71,124,49,37,23,32,12,7,5,2,28
S01010992,Very good health,259,58,8,50,82,30,21,17,19,5,2,1,1,25
S01010992,Good health,109,22,3,19,35,14,12,4,12,5,2,2,0,3
S01010992,Fair health,19,2,0,2,3,5,3,2,1,1,2,1,1,0
S01010992,Bad health,6,0,0,0,3,0,1,0,0,1,1,1,0,0
S01010992,Very bad health,1,0,0,0,1,0,0,0,0,0,0,0,0,0
S01010993,All people aged 16 to 74,471,35,7,28,128,85,30,36,69,54,8,2,6,26
S01010993,Very good health,243,18,5,13,77,50,17,14,33,16,1,0,1,17
S01010993,Good health,144,11,1,10,33,22,6,14,25,20,6,1,5,7
S01010993,Fair health,63,5,1,4,14,12,5,6,6,12,1,1,0,2
S01010993,Bad health,14,1,0,1,3,0,1,2,2,5,0,0,0,0
S01010993,Very bad health,7,0,0,0,1,1,1,0,3,1,0,0,0,0
S01010994,All people aged 16 to 74,781,158,24,134,243,109,53,32,72,34,16,11,5,64
S01010994,Very good health,468,100,16,84,154,60,27,16,39,15,9,6,3,48
S01010994,Good health,236,47,5,42,76,35,19,13,20,9,5,3,2,12
S01010994,Fair health,56,9,2,7,9,11,5,2,8,7,1,1,0,4
S01010994,Bad health,20,2,1,1,4,2,2,1,5,3,1,1,0,0
S01010994,Very bad health,1,0,0,0,0,1,0,0,0,0,0,0,0,0
S01010995,All people aged 16 to 74,575,51,13,38,155,111,47,42,79,38,9,7,2,43
S01010995,Very good health,331,31,7,24,89,61,27,23,40,17,4,4,0,39
S01010995,Good health,183,16,5,11,56,38,14,15,23,14,3,2,1,4
S01010995,Fair health,49,4,1,3,10,10,5,2,10,6,2,1,1,0
S01010995,Bad health,9,0,0,0,0,1,1,2,5,0,0,0,0,0
S01010995,Very bad health,3,0,0,0,0,1,0,0,1,1,0,0,0,0
S01010996,All people aged 16 to 74,432,72,8,64,116,71,50,26,42,21,4,3,1,30
S01010996,Very good health,244,48,5,43,75,35,26,9,20,5,1,1,0,25
S01010996,Good health,137,22,3,19,29,28,17,12,13,11,0,0,0,5
S01010996,Fair health,35,2,0,2,8,7,5,2,6,3,2,1,1,0
S01010996,Bad health,12,0,0,0,4,1,1,2,1,2,1,1,0,0
S01010996,Very bad health,4,0,0,0,0,0,1,1,2,0,0,0,0,0
S01010997,All people aged 16 to 74,482,84,12,72,142,93,48,21,44,15,4,2,2,31
S01010997,Very good health,271,53,9,44,77,50,26,10,19,6,4,2,2,26
S01010997,Good health,165,26,3,23,52,36,13,10,21,4,0,0,0,3
S01010997,Fair health,36,3,0,3,12,5,7,1,3,3,0,0,0,2
S01010997,Bad health,9,2,0,2,1,2,1,0,1,2,0,0,0,0
S01010997,Very bad health,1,0,0,0,0,0,1,0,0,0,0,0,0,0
S01010998,All people aged 16 to 74,419,97,15,82,132,50,49,13,28,10,8,3,5,32
S01010998,Very good health,268,70,9,61,77,31,30,9,17,6,4,2,2,24
S01010998,Good health,117,20,5,15,47,11,17,4,7,2,2,0,2,7
S01010998,Fair health,29,7,1,6,7,7,2,0,3,0,2,1,1,1
S01010998,Bad health,3,0,0,0,1,1,0,0,0,1,0,0,0,0
S01010998,Very bad health,2,0,0,0,0,0,0,0,1,1,0,0,0,0
S01010999,All people aged 16 to 74,650,110,25,85,183,100,48,37,64,55,24,24,0,29
S01010999,Very good health,328,70,11,59,114,44,23,17,22,13,7,7,0,18
S01010999,Good health,221,27,7,20,54,42,16,17,30,19,5,5,0,11
S01010999,Fair health,75,10,5,5,12,12,7,2,7,14,11,11,0,0
S01010999,Bad health,20,2,1,1,3,0,1,1,5,7,1,1,0,0
S01010999,Very bad health,6,1,1,0,0,2,1,0,0,2,0,0,0,0
S01011000,All people aged 16 to 74,645,70,11,59,139,90,89,52,76,82,11,6,5,36
S01011000,Very good health,329,44,7,37,85,46,36,26,39,27,0,0,0,26
S01011000,Good health,219,17,1,16,39,34,37,18,25,34,5,2,3,10
S01011000,Fair health,74,8,3,5,11,7,13,6,10,14,5,3,2,0
S01011000,Bad health,18,1,0,1,3,2,3,2,2,4,1,1,0,0
S01011000,Very bad health,5,0,0,0,1,1,0,0,0,3,0,0,0,0
S01011001,All people aged 16 to 74,482,10,1,9,75,74,33,46,98,98,18,17,1,30
S01011001,Very good health,218,6,0,6,31,34,18,22,40,37,6,5,1,24
S01011001,Good health,173,3,1,2,29,35,4,14,35,39,8,8,0,6
S01011001,Fair health,58,1,0,1,9,2,8,9,17,9,3,3,0,0
S01011001,Bad health,29,0,0,0,6,3,3,1,5,10,1,1,0,0
S01011001,Very bad health,4,0,0,0,0,0,0,0,1,3,0,0,0,0
S01011002,All people aged 16 to 74,521,14,2,12,71,90,34,59,99,109,17,13,4,28
S01011002,Very good health,226,6,1,5,40,35,17,25,41,40,2,2,0,20
S01011002,Good health,177,7,1,6,16,34,11,23,33,42,7,4,3,4
S01011002,Fair health,83,1,0,1,11,14,5,8,17,18,5,4,1,4
S01011002,Bad health,29,0,0,0,4,6,0,3,7,6,3,3,0,0
S01011002,Very bad health,6,0,0,0,0,1,1,0,1,3,0,0,0,0
S01011003,All people aged 16 to 74,485,11,6,5,63,75,36,60,106,76,18,13,5,40
S01011003,Very good health,234,6,3,3,28,35,16,30,47,32,9,7,2,31
S01011003,Good health,152,4,3,1,23,24,11,18,37,26,3,1,2,6
S01011003,Fair health,67,0,0,0,8,10,7,5,17,13,5,4,1,2
S01011003,Bad health,25,1,0,1,2,4,1,7,5,3,1,1,0,1
S01011003,Very bad health,7,0,0,0,2,2,1,0,0,2,0,0,0,0
S01011004,All people aged 16 to 74,452,42,8,34,98,77,39,31,71,53,14,5,9,27
S01011004,Very good health,219,23,3,20,53,37,19,15,34,16,2,1,1,20
S01011004,Good health,166,17,5,12,33,29,16,11,24,23,7,1,6,6
S01011004,Fair health,47,1,0,1,9,9,3,1,9,10,4,2,2,1
S01011004,Bad health,14,1,0,1,1,1,1,3,3,3,1,1,0,0
S01011004,Very bad health,6,0,0,0,2,1,0,1,1,1,0,0,0,0
S01011005,All people aged 16 to 74,500,17,0,17,80,84,28,56,99,87,18,13,5,31
S01011005,Very good health,196,12,0,12,40,40,11,15,29,26,1,1,0,22
S01011005,Good health,175,4,0,4,26,26,8,23,36,32,11,8,3,9
S01011005,Fair health,92,0,0,0,9,11,7,13,25,21,6,4,2,0
S01011005,Bad health,33,1,0,1,5,5,2,5,8,7,0,0,0,0
S01011005,Very bad health,4,0,0,0,0,2,0,0,1,1,0,0,0,0
S01011006,All people aged 16 to 74,746,55,15,40,175,126,61,62,116,85,34,24,10,32
S01011006,Very good health,409,37,11,26,117,67,27,32,59,34,20,16,4,16
S01011006,Good health,213,16,4,12,43,37,22,18,31,28,8,4,4,10
S01011006,Fair health,85,2,0,2,12,14,7,6,21,13,4,2,2,6
S01011006,Bad health,28,0,0,0,3,6,2,4,4,8,1,1,0,0
S01011006,Very bad health,11,0,0,0,0,2,3,2,1,2,1,1,0,0
S01011007,All people aged 16 to 74,480,13,2,11,47,61,34,62,93,116,18,13,5,36
S01011007,Very good health,188,4,0,4,21,28,10,23,31,40,10,8,2,21
S01011007,Good health,178,6,2,4,17,18,13,27,41,40,4,2,2,12
S01011007,Fair health,75,2,0,2,6,10,9,6,14,24,3,2,1,1
S01011007,Bad health,30,1,0,1,2,4,2,4,6,9,1,1,0,1
S01011007,Very bad health,9,0,0,0,1,1,0,2,1,3,0,0,0,1
S01011008,All people aged 16 to 74,600,22,4,18,86,74,36,75,139,106,31,16,15,31
S01011008,Very good health,246,7,0,7,37,29,15,30,55,43,8,6,2,22
S01011008,Good health,234,13,4,9,41,32,14,28,50,36,13,5,8,7
S01011008,Fair health,82,1,0,1,6,11,7,7,23,20,6,2,4,1
S01011008,Bad health,29,1,0,1,2,2,0,6,10,4,3,2,1,1
S01011008,Very bad health,9,0,0,0,0,0,0,4,1,3,1,1,0,0
S01011009,All people aged 16 to 74,395,10,6,4,51,60,24,50,83,81,21,16,5,15
S01011009,Very good health,156,5,2,3,23,26,7,22,37,23,4,4,0,9
S01011009,Good health,164,5,4,1,18,29,10,21,30,37,10,7,3,4
S01011009,Fair health,46,0,0,0,6,3,4,5,9,16,2,2,0,1
S01011009,Bad health,23,0,0,0,3,2,2,2,5,3,5,3,2,1
S01011009,Very bad health,6,0,0,0,1,0,1,0,2,2,0,0,0,0
S01011010,All people aged 16 to 74,450,25,5,20,76,56,19,29,86,80,56,41,15,23
S01011010,Very good health,182,19,4,15,34,28,12,13,27,24,11,8,3,14
S01011010,Good health,158,5,1,4,34,19,3,9,40,22,19,13,6,7
S01011010,Fair health,77,1,0,1,5,7,1,4,14,24,19,13,6,2
S01011010,Bad health,23,0,0,0,3,1,1,1,4,9,4,4,0,0
S01011010,Very bad health,10,0,0,0,0,1,2,2,1,1,3,3,0,0
S01011011,All people aged 16 to 74,586,21,4,17,63,95,27,52,132,105,61,50,11,30
S01011011,Very good health,229,13,3,10,32,48,9,17,45,29,18,15,3,18
S01011011,Good health,184,6,1,5,22,20,6,16,46,44,16,12,4,8
S01011011,Fair health,116,2,0,2,7,18,5,14,30,15,21,18,3,4
S01011011,Bad health,43,0,0,0,1,8,7,4,7,11,5,4,1,0
S01011011,Very bad health,14,0,0,0,1,1,0,1,4,6,1,1,0,0
S01011012,All people aged 16 to 74,506,17,0,17,48,47,20,53,111,126,52,29,23,32
S01011012,Very good health,205,9,0,9,23,19,10,25,44,32,15,10,5,28
S01011012,Good health,159,6,0,6,20,12,4,13,37,48,17,8,9,2
S01011012,Fair health,87,2,0,2,1,11,4,13,21,20,14,6,8,1
S01011012,Bad health,45,0,0,0,2,5,1,2,6,23,5,4,1,1
S01011012,Very bad health,10,0,0,0,2,0,1,0,3,3,1,1,0,0
S01011013,All people aged 16 to 74,583,21,5,16,83,102,34,54,121,129,15,8,7,24
S01011013,Very good health,224,10,2,8,38,48,9,22,41,37,4,2,2,15
S01011013,Good health,235,6,1,5,33,34,22,21,47,57,8,5,3,7
S01011013,Fair health,92,3,2,1,9,14,3,9,25,24,3,1,2,2
S01011013,Bad health,21,2,0,2,2,3,0,1,5,8,0,0,0,0
S01011013,Very bad health,11,0,0,0,1,3,0,1,3,3,0,0,0,0
S01011014,All people aged 16 to 74,657,38,9,29,111,141,36,66,135,74,18,7,11,38
S01011014,Very good health,320,20,3,17,63,74,19,26,52,31,8,2,6,27
S01011014,Good health,218,14,4,10,35,48,11,22,49,23,6,3,3,10
S01011014,Fair health,89,3,1,2,11,14,4,14,26,14,2,0,2,1
S01011014,Bad health,23,1,1,0,2,5,2,3,6,3,1,1,0,0
S01011014,Very bad health,7,0,0,0,0,0,0,1,2,3,1,1,0,0
S01011015,All people aged 16 to 74,350,20,1,19,72,51,32,22,71,46,22,11,11,14
S01011015,Very good health,172,14,1,13,38,24,18,10,30,15,11,4,7,12
S01011015,Good health,107,4,0,4,24,17,5,7,23,20,5,3,2,2
S01011015,Fair health,53,1,0,1,7,8,6,4,16,7,4,2,2,0
S01011015,Bad health,13,1,0,1,2,1,3,1,1,2,2,2,0,0
S01011015,Very bad health,5,0,0,0,1,1,0,0,1,2,0,0,0,0
S01011016,All people aged 16 to 74,626,70,12,58,181,95,64,49,61,45,19,12,7,42
S01011016,Very good health,398,48,8,40,119,63,35,37,35,17,8,7,1,36
S01011016,Good health,172,18,3,15,54,23,22,10,16,18,7,2,5,4
S01011016,Fair health,41,4,1,3,6,5,5,2,7,8,3,2,1,1
S01011016,Bad health,13,0,0,0,2,4,1,0,3,1,1,1,0,1
S01011016,Very bad health,2,0,0,0,0,0,1,0,0,1,0,0,0,0
S01011017,All people aged 16 to 74,630,103,20,83,161,94,93,37,58,37,10,5,5,37
S01011017,Very good health,357,64,15,49,86,50,55,16,33,17,3,1,2,33
S01011017,Good health,187,27,4,23,59,32,26,14,11,9,6,3,3,3
S01011017,Fair health,58,11,1,10,12,8,7,4,7,7,1,1,0,1
S01011017,Bad health,20,1,0,1,3,3,4,2,4,3,0,0,0,0
S01011017,Very bad health,8,0,0,0,1,1,1,1,3,1,0,0,0,0
S01011018,All people aged 16 to 74,625,37,2,35,130,82,57,50,118,96,18,8,10,37
S01011018,Very good health,321,26,1,25,76,43,26,29,49,36,7,2,5,29
S01011018,Good health,207,9,0,9,36,31,18,15,50,36,4,2,2,8
S01011018,Fair health,73,1,1,0,15,5,8,4,17,18,5,2,3,0
S01011018,Bad health,20,1,0,1,3,2,4,2,2,4,2,2,0,0
S01011018,Very bad health,4,0,0,0,0,1,1,0,0,2,0,0,0,0
S01011019,All people aged 16 to 74,736,102,23,79,157,82,95,62,97,71,32,19,13,38
S01011019,Very good health,413,70,15,55,95,46,50,35,42,33,14,8,6,28
S01011019,Good health,223,21,4,17,49,24,34,17,35,26,10,3,7,7
S01011019,Fair health,76,9,4,5,10,9,9,8,16,10,3,3,0,2
S01011019,Bad health,18,1,0,1,3,2,2,1,3,1,4,4,0,1
S01011019,Very bad health,6,1,0,1,0,1,0,1,1,1,1,1,0,0
S01011020,All people aged 16 to 74,351,59,5,54,91,55,36,31,28,33,7,3,4,11
S01011020,Very good health,196,38,4,34,63,28,18,15,15,9,3,0,3,7
S01011020,Good health,107,18,1,17,22,18,9,11,10,15,2,2,0,2
S01011020,Fair health,31,1,0,1,6,5,9,2,1,3,2,1,1,2
S01011020,Bad health,11,1,0,1,0,2,0,2,2,4,0,0,0,0
S01011020,Very bad health,6,1,0,1,0,2,0,1,0,2,0,0,0,0
S01011021,All people aged 16 to 74,646,14,3,11,93,85,47,65,133,116,52,40,12,41
S01011021,Very good health,296,7,1,6,45,41,23,31,56,40,20,18,2,33
S01011021,Good health,216,6,2,4,32,32,15,23,49,35,16,12,4,8
S01011021,Fair health,95,1,0,1,10,10,8,8,18,29,11,6,5,0
S01011021,Bad health,27,0,0,0,3,1,1,1,9,7,5,4,1,0
S01011021,Very bad health,12,0,0,0,3,1,0,2,1,5,0,0,0,0
S01011022,All people aged 16 to 74,414,7,1,6,38,47,29,53,84,104,24,16,8,28
S01011022,Very good health,179,1,0,1,22,23,15,17,33,42,5,2,3,21
S01011022,Good health,144,4,0,4,12,18,9,20,31,35,8,6,2,7
S01011022,Fair health,59,1,0,1,4,5,3,12,13,14,7,4,3,0
S01011022,Bad health,25,0,0,0,0,1,1,4,5,12,2,2,0,0
S01011022,Very bad health,7,1,1,0,0,0,1,0,2,1,2,2,0,0
S01011023,All people aged 16 to 74,614,32,7,25,90,84,60,58,109,102,41,29,12,38
S01011023,Very good health,275,17,4,13,43,40,22,24,41,44,16,12,4,28
S01011023,Good health,200,10,2,8,34,27,23,21,39,24,13,7,6,9
S01011023,Fair health,97,2,0,2,10,14,10,8,20,23,9,7,2,1
S01011023,Bad health,37,3,1,2,2,3,4,5,8,9,3,3,0,0
S01011023,Very bad health,5,0,0,0,1,0,1,0,1,2,0,0,0,0
S01011024,All people aged 16 to 74,547,12,2,10,67,67,30,52,113,116,51,34,17,39
S01011024,Very good health,228,5,1,4,26,26,13,24,43,39,23,15,8,29
S01011024,Good health,195,6,1,5,30,27,8,16,46,42,13,9,4,7
S01011024,Fair health,88,1,0,1,8,10,4,8,18,26,10,5,5,3
S01011024,Bad health,28,0,0,0,3,3,4,2,6,8,2,2,0,0
S01011024,Very bad health,8,0,0,0,0,1,1,2,0,1,3,3,0,0
S01011025,All people aged 16 to 74,536,10,4,6,57,75,22,60,119,122,40,22,18,31
S01011025,Very good health,238,4,2,2,27,29,12,28,50,46,18,9,9,24
S01011025,Good health,189,6,2,4,23,33,6,22,42,44,8,5,3,5
S01011025,Fair health,68,0,0,0,4,10,3,6,17,18,9,5,4,1
S01011025,Bad health,37,0,0,0,3,3,1,4,8,12,5,3,2,1
S01011025,Very bad health,4,0,0,0,0,0,0,0,2,2,0,0,0,0
S01011026,All people aged 16 to 74,449,5,0,5,45,69,28,54,96,103,27,12,15,22
S01011026,Very good health,175,4,0,4,23,26,9,17,38,33,10,4,6,15
S01011026,Good health,172,0,0,0,17,31,12,21,38,38,9,2,7,6
S01011026,Fair health,63,1,0,1,4,6,6,11,11,17,6,4,2,1
S01011026,Bad health,32,0,0,0,1,4,1,4,6,14,2,2,0,0
S01011026,Very bad health,7,0,0,0,0,2,0,1,3,1,0,0,0,0
S01011027,All people aged 16 to 74,626,13,1,12,54,78,31,54,147,158,55,35,20,36
S01011027,Very good health,235,6,0,6,27,33,11,19,43,53,20,13,7,23
S01011027,Good health,222,4,1,3,18,27,12,24,59,53,15,9,6,10
S01011027,Fair health,118,2,0,2,9,14,7,6,33,32,12,6,6,3
S01011027,Bad health,38,1,0,1,0,3,1,2,12,14,5,5,0,0
S01011027,Very bad health,13,0,0,0,0,1,0,3,0,6,3,2,1,0
S01011028,All people aged 16 to 74,689,14,5,9,74,83,37,70,171,153,52,33,19,35
S01011028,Very good health,267,5,2,3,33,38,20,24,60,46,18,11,7,23
S01011028,Good health,264,7,3,4,29,28,11,21,66,72,21,12,9,9
S01011028,Fair health,101,2,0,2,9,11,5,14,28,22,7,6,1,3
S01011028,Bad health,42,0,0,0,1,4,1,10,12,9,5,3,2,0
S01011028,Very bad health,15,0,0,0,2,2,0,1,5,4,1,1,0,0
S01011029,All people aged 16 to 74,473,18,4,14,67,72,27,39,110,88,25,18,7,27
S01011029,Very good health,218,9,2,7,35,31,19,16,41,38,11,6,5,18
S01011029,Good health,162,5,0,5,21,26,5,16,44,27,11,10,1,7
S01011029,Fair health,72,1,0,1,9,12,2,7,22,14,3,2,1,2
S01011029,Bad health,19,3,2,1,2,2,1,0,2,9,0,0,0,0
S01011029,Very bad health,2,0,0,0,0,1,0,0,1,0,0,0,0,0
S01011030,All people aged 16 to 74,766,43,13,30,153,150,54,69,124,101,12,7,5,60
S01011030,Very good health,385,30,7,23,78,81,23,32,57,40,1,1,0,43
S01011030,Good health,261,8,4,4,49,54,23,28,40,39,6,3,3,14
S01011030,Fair health,84,4,1,3,18,12,5,5,22,12,3,1,2,3
S01011030,Bad health,34,1,1,0,8,3,2,4,4,10,2,2,0,0
S01011030,Very bad health,2,0,0,0,0,0,1,0,1,0,0,0,0,0
S01011031,All people aged 16 to 74,515,21,3,18,55,76,21,49,120,113,42,30,12,18
S01011031,Very good health,193,14,2,12,25,33,8,19,40,32,13,9,4,9
S01011031,Good health,181,5,1,4,16,28,9,15,40,44,18,10,8,6
S01011031,Fair health,97,2,0,2,10,11,4,9,26,28,5,5,0,2
S01011031,Bad health,32,0,0,0,2,2,0,5,9,9,4,4,0,1
S01011031,Very bad health,12,0,0,0,2,2,0,1,5,0,2,2,0,0
S01011032,All people aged 16 to 74,594,21,5,16,84,80,37,43,124,125,42,29,13,38
S01011032,Very good health,253,4,1,3,41,34,12,18,44,52,21,15,6,27
S01011032,Good health,205,12,4,8,26,27,17,16,55,31,13,8,5,8
S01011032,Fair health,95,4,0,4,14,13,6,5,18,26,6,5,1,3
S01011032,Bad health,35,1,0,1,3,5,2,3,7,13,1,0,1,0
S01011032,Very bad health,6,0,0,0,0,1,0,1,0,3,1,1,0,0
S01011033,All people aged 16 to 74,480,37,6,31,101,87,27,46,76,74,11,6,5,21
S01011033,Very good health,222,20,3,17,52,36,10,22,33,23,7,4,3,19
S01011033,Good health,170,13,1,12,38,37,13,16,28,22,1,0,1,2
S01011033,Fair health,66,4,2,2,10,9,4,4,12,21,2,1,1,0
S01011033,Bad health,18,0,0,0,1,4,0,3,2,7,1,1,0,0
S01011033,Very bad health,4,0,0,0,0,1,0,1,1,1,0,0,0,0
S01011034,All people aged 16 to 74,477,30,11,19,74,65,36,44,114,74,26,18,8,14
S01011034,Very good health,196,20,8,12,33,29,17,20,42,17,9,4,5,9
S01011034,Good health,169,9,2,7,26,32,11,12,43,26,6,4,2,4
S01011034,Fair health,64,0,0,0,7,0,4,8,17,22,5,4,1,1
S01011034,Bad health,39,1,1,0,6,4,3,4,11,6,4,4,0,0
S01011034,Very bad health,9,0,0,0,2,0,1,0,1,3,2,2,0,0
S01011035,All people aged 16 to 74,486,27,10,17,67,50,34,47,110,93,32,23,9,26
S01011035,Very good health,214,14,7,7,37,30,11,20,43,31,9,5,4,19
S01011035,Good health,156,9,2,7,19,14,13,14,42,22,19,14,5,4
S01011035,Fair health,75,2,1,1,7,2,8,7,16,30,2,2,0,1
S01011035,Bad health,30,1,0,1,4,3,1,6,6,6,2,2,0,1
S01011035,Very bad health,11,1,0,1,0,1,1,0,3,4,0,0,0,1
S01011036,All people aged 16 to 74,495,38,9,29,108,78,34,40,78,66,15,7,8,38
S01011036,Very good health,233,23,7,16,50,38,18,14,36,24,4,1,3,26
S01011036,Good health,168,14,2,12,40,24,10,13,29,24,6,2,4,8
S01011036,Fair health,62,1,0,1,13,11,2,10,10,11,2,1,1,2
S01011036,Bad health,23,0,0,0,5,5,4,3,0,4,1,1,0,1
S01011036,Very bad health,9,0,0,0,0,0,0,0,3,3,2,2,0,1
S01011037,All people aged 16 to 74,685,24,6,18,94,91,49,72,137,122,56,38,18,40
S01011037,Very good health,322,15,2,13,49,47,25,35,65,39,20,11,9,27
S01011037,Good health,227,8,3,5,31,32,13,25,49,36,21,14,7,12
S01011037,Fair health,104,1,1,0,14,10,8,9,17,33,11,9,2,1
S01011037,Bad health,25,0,0,0,0,2,2,3,4,13,1,1,0,0
S01011037,Very bad health,7,0,0,0,0,0,1,0,2,1,3,3,0,0
S01011038,All people aged 16 to 74,622,10,3,7,55,70,38,75,115,151,64,40,24,44
S01011038,Very good health,274,5,2,3,35,34,10,26,49,51,30,18,12,34
S01011038,Good health,201,4,0,4,15,21,19,28,36,51,18,10,8,9
S01011038,Fair health,93,0,0,0,4,10,5,14,18,33,8,6,2,1
S01011038,Bad health,40,0,0,0,0,2,3,5,10,13,7,5,2,0
S01011038,Very bad health,14,1,1,0,1,3,1,2,2,3,1,1,0,0
S01011039,All people aged 16 to 74,598,30,2,28,107,108,51,61,81,102,27,18,9,31
S01011039,Very good health,298,19,1,18,57,54,21,28,41,38,15,10,5,25
S01011039,Good health,183,10,1,9,32,33,18,23,24,31,7,5,2,5
S01011039,Fair health,78,1,0,1,11,17,8,7,10,21,2,1,1,1
S01011039,Bad health,30,0,0,0,5,4,4,2,4,9,2,1,1,0
S01011039,Very bad health,9,0,0,0,2,0,0,1,2,3,1,1,0,0
S01011040,All people aged 16 to 74,523,18,5,13,64,72,25,55,115,102,30,19,11,42
S01011040,Very good health,222,12,4,8,32,31,8,23,40,35,10,7,3,31
S01011040,Good health,192,3,1,2,24,27,11,22,49,33,14,8,6,9
S01011040,Fair health,66,2,0,2,5,6,3,7,16,20,5,3,2,2
S01011040,Bad health,32,0,0,0,2,5,2,1,9,12,1,1,0,0
S01011040,Very bad health,11,1,0,1,1,3,1,2,1,2,0,0,0,0
S01011041,All people aged 16 to 74,523,17,2,15,67,61,27,33,122,97,51,32,19,48
S01011041,Very good health,247,10,1,9,39,29,10,16,57,40,9,4,5,37
S01011041,Good health,149,4,1,3,15,21,12,8,34,25,21,13,8,9
S01011041,Fair health,73,3,0,3,10,6,2,6,14,18,12,6,6,2
S01011041,Bad health,43,0,0,0,2,3,3,3,15,11,6,6,0,0
S01011041,Very bad health,11,0,0,0,1,2,0,0,2,3,3,3,0,0
S01011042,All people aged 16 to 74,603,53,13,40,131,102,47,58,88,68,22,10,12,34
S01011042,Very good health,317,25,7,18,66,61,27,33,42,29,11,5,6,23
S01011042,Good health,201,24,4,20,48,28,14,14,36,21,9,3,6,7
S01011042,Fair health,62,3,1,2,13,10,6,9,5,12,1,1,0,3
S01011042,Bad health,20,1,1,0,3,3,0,2,5,5,0,0,0,1
S01011042,Very bad health,3,0,0,0,1,0,0,0,0,1,1,1,0,0
S01011043,All people aged 16 to 74,503,22,8,14,84,67,32,53,88,104,27,17,10,26
S01011043,Very good health,225,12,4,8,38,31,12,26,40,43,8,5,3,15
S01011043,Good health,182,8,4,4,34,27,13,18,33,33,9,5,4,7
S01011043,Fair health,71,2,0,2,9,8,6,4,12,17,9,6,3,4
S01011043,Bad health,22,0,0,0,3,1,1,4,3,10,0,0,0,0
S01011043,Very bad health,3,0,0,0,0,0,0,1,0,1,1,1,0,0
S01011044,All people aged 16 to 74,530,26,9,17,72,72,43,48,112,94,31,20,11,32
S01011044,Very good health,240,15,6,9,33,41,16,20,50,28,13,8,5,24
S01011044,Good health,181,6,3,3,27,16,17,16,47,34,11,7,4,7
S01011044,Fair health,66,4,0,4,7,10,6,6,9,20,4,2,2,0
S01011044,Bad health,35,1,0,1,4,3,3,6,5,11,2,2,0,0
S01011044,Very bad health,8,0,0,0,1,2,1,0,1,1,1,1,0,1
S01011045,All people aged 16 to 74,582,39,9,30,95,64,112,59,112,52,23,10,13,26
S01011045,Very good health,327,20,3,17,59,42,59,38,60,23,9,5,4,17
S01011045,Good health,181,12,4,8,28,19,37,14,38,21,7,3,4,5
S01011045,Fair health,52,4,2,2,6,2,14,6,6,7,4,1,3,3
S01011045,Bad health,18,1,0,1,2,1,2,0,7,1,3,1,2,1
S01011045,Very bad health,4,2,0,2,0,0,0,1,1,0,0,0,0,0
S01011046,All people aged 16 to 74,680,40,19,21,115,77,131,77,108,83,22,13,9,27
S01011046,Very good health,338,26,11,15,70,36,51,47,51,35,7,4,3,15
S01011046,Good health,228,10,6,4,28,27,57,17,42,37,5,3,2,5
S01011046,Fair health,83,2,0,2,13,12,20,8,11,10,6,3,3,1
S01011046,Bad health,25,1,1,0,4,2,2,4,3,1,3,3,0,5
S01011046,Very bad health,6,1,1,0,0,0,1,1,1,0,1,0,1,1
S01011047,All people aged 16 to 74,724,49,19,30,150,67,97,94,120,105,12,6,6,30
S01011047,Very good health,376,33,13,20,82,39,39,53,57,48,3,1,2,22
S01011047,Good health,255,15,6,9,53,20,41,28,45,38,7,4,3,8
S01011047,Fair health,67,1,0,1,12,6,14,7,15,11,1,0,1,0
S01011047,Bad health,22,0,0,0,3,1,3,5,1,8,1,1,0,0
S01011047,Very bad health,4,0,0,0,0,1,0,1,2,0,0,0,0,0
S01011048,All people aged 16 to 74,709,27,9,18,106,73,83,85,145,133,21,12,9,36
S01011048,Very good health,331,17,5,12,52,37,36,40,63,54,7,2,5,25
S01011048,Good health,270,7,2,5,42,29,32,30,58,55,7,4,3,10
S01011048,Fair health,83,2,2,0,9,5,12,12,20,16,6,5,1,1
S01011048,Bad health,21,1,0,1,3,2,2,3,4,5,1,1,0,0
S01011048,Very bad health,4,0,0,0,0,0,1,0,0,3,0,0,0,0
S01011049,All people aged 16 to 74,512,24,6,18,64,50,38,64,144,104,9,3,6,15
S01011049,Very good health,229,9,2,7,32,22,14,27,63,50,3,2,1,9
S01011049,Good health,213,12,3,9,24,21,15,30,61,41,4,0,4,5
S01011049,Fair health,54,2,1,1,6,4,5,5,19,10,2,1,1,1
S01011049,Bad health,12,1,0,1,2,2,2,1,1,3,0,0,0,0
S01011049,Very bad health,4,0,0,0,0,1,2,1,0,0,0,0,0,0
S01011050,All people aged 16 to 74,595,35,11,24,119,49,81,69,129,70,16,12,4,27
S01011050,Very good health,294,19,5,14,60,22,38,40,51,37,6,3,3,21
S01011050,Good health,224,10,5,5,44,21,28,22,61,25,7,6,1,6
S01011050,Fair health,54,5,1,4,11,5,9,3,13,6,2,2,0,0
S01011050,Bad health,19,1,0,1,4,1,6,3,3,1,0,0,0,0
S01011050,Very bad health,4,0,0,0,0,0,0,1,1,1,1,1,0,0
S01011051,All people aged 16 to 74,687,48,15,33,120,76,88,88,112,118,14,8,6,23
S01011051,Very good health,328,21,4,17,55,42,33,48,49,56,6,4,2,18
S01011051,Good health,254,20,8,12,49,24,38,31,42,40,5,2,3,5
S01011051,Fair health,78,5,3,2,13,7,16,6,16,13,2,1,1,0
S01011051,Bad health,19,1,0,1,3,1,0,2,4,8,0,0,0,0
S01011051,Very bad health,8,1,0,1,0,2,1,1,1,1,1,1,0,0
S01011052,All people aged 16 to 74,572,44,19,25,107,54,57,72,107,95,13,8,5,23
S01011052,Very good health,271,25,10,15,62,18,26,35,46,40,3,0,3,16
S01011052,Good health,217,15,7,8,33,25,24,27,43,38,5,4,1,7
S01011052,Fair health,67,4,2,2,8,10,6,9,12,15,3,2,1,0
S01011052,Bad health,15,0,0,0,3,1,1,1,5,2,2,2,0,0
S01011052,Very bad health,2,0,0,0,1,0,0,0,1,0,0,0,0,0
S01011053,All people aged 16 to 74,478,15,3,12,68,49,28,68,108,89,23,13,10,30
S01011053,Very good health,215,8,0,8,39,25,14,24,46,30,6,3,3,23
S01011053,Good health,194,6,3,3,18,20,12,30,48,43,10,5,5,7
S01011053,Fair health,53,0,0,0,9,3,2,10,12,12,5,3,2,0
S01011053,Bad health,13,1,0,1,2,1,0,2,2,3,2,2,0,0
S01011053,Very bad health,3,0,0,0,0,0,0,2,0,1,0,0,0,0
S01011054,All people aged 16 to 74,400,38,14,24,69,40,43,51,86,47,8,6,2,18
S01011054,Very good health,219,26,11,15,43,26,20,30,38,22,1,1,0,13
S01011054,Good health,123,11,3,8,16,9,15,13,35,15,4,3,1,5
S01011054,Fair health,44,1,0,1,7,5,7,5,10,8,1,1,0,0
S01011054,Bad health,10,0,0,0,2,0,1,1,3,2,1,0,1,0
S01011054,Very bad health,4,0,0,0,1,0,0,2,0,0,1,1,0,0
S01011055,All people aged 16 to 74,428,30,6,24,90,43,54,49,81,53,11,8,3,17
S01011055,Very good health,216,14,4,10,48,28,26,24,32,28,3,2,1,13
S01011055,Good health,146,12,2,10,29,15,19,19,27,18,4,3,1,3
S01011055,Fair health,51,4,0,4,10,0,6,4,18,5,3,2,1,1
S01011055,Bad health,12,0,0,0,3,0,3,2,2,2,0,0,0,0
S01011055,Very bad health,3,0,0,0,0,0,0,0,2,0,1,1,0,0
S01011056,All people aged 16 to 74,501,45,15,30,81,35,114,37,97,59,7,4,3,26
S01011056,Very good health,265,23,7,16,47,22,50,22,53,26,1,0,1,21
S01011056,Good health,169,18,5,13,27,12,49,12,24,20,2,0,2,5
S01011056,Fair health,50,4,3,1,6,1,13,2,13,10,1,1,0,0
S01011056,Bad health,13,0,0,0,1,0,0,1,6,3,2,2,0,0
S01011056,Very bad health,4,0,0,0,0,0,2,0,1,0,1,1,0,0
S01011057,All people aged 16 to 74,439,16,5,11,61,43,71,44,89,94,7,4,3,14
S01011057,Very good health,223,8,3,5,37,19,33,23,48,41,2,0,2,12
S01011057,Good health,142,6,2,4,16,19,20,15,28,35,1,0,1,2
S01011057,Fair health,51,2,0,2,5,1,12,5,12,12,2,2,0,0
S01011057,Bad health,15,0,0,0,2,3,3,1,1,5,0,0,0,0
S01011057,Very bad health,8,0,0,0,1,1,3,0,0,1,2,2,0,0
S01011058,All people aged 16 to 74,487,24,7,17,103,55,111,31,79,42,8,4,4,34
S01011058,Very good health,248,14,5,9,53,33,45,14,38,20,4,2,2,27
S01011058,Good health,176,9,1,8,38,17,42,12,31,17,3,1,2,7
S01011058,Fair health,43,1,1,0,7,2,16,4,8,4,1,1,0,0
S01011058,Bad health,15,0,0,0,3,3,6,1,2,0,0,0,0,0
S01011058,Very bad health,5,0,0,0,2,0,2,0,0,1,0,0,0,0
S01011059,All people aged 16 to 74,476,31,8,23,96,56,83,36,75,67,15,8,7,17
S01011059,Very good health,220,16,5,11,44,27,39,15,32,28,4,2,2,15
S01011059,Good health,189,13,3,10,41,19,31,15,36,26,6,3,3,2
S01011059,Fair health,47,1,0,1,9,9,8,3,6,7,4,2,2,0
S01011059,Bad health,11,1,0,1,1,1,2,1,0,4,1,1,0,0
S01011059,Very bad health,9,0,0,0,1,0,3,2,1,2,0,0,0,0
S01011060,All people aged 16 to 74,594,39,7,32,107,75,54,55,113,106,16,9,7,29
S01011060,Very good health,286,23,3,20,54,37,23,30,52,40,4,1,3,23
S01011060,Good health,204,9,4,5,36,31,20,15,37,48,4,2,2,4
S01011060,Fair health,76,5,0,5,14,3,9,4,19,14,6,4,2,2
S01011060,Bad health,22,2,0,2,1,2,2,5,5,3,2,2,0,0
S01011060,Very bad health,6,0,0,0,2,2,0,1,0,1,0,0,0,0
S01011061,All people aged 16 to 74,619,13,4,9,61,52,38,91,151,157,27,14,13,29
S01011061,Very good health,258,5,2,3,27,28,18,42,54,54,9,5,4,21
S01011061,Good health,256,6,2,4,23,14,13,38,67,75,13,6,7,7
S01011061,Fair health,81,1,0,1,9,8,5,9,23,21,4,2,2,1
S01011061,Bad health,23,1,0,1,2,2,2,2,7,6,1,1,0,0
S01011061,Very bad health,1,0,0,0,0,0,0,0,0,1,0,0,0,0
S01011062,All people aged 16 to 74,660,26,9,17,84,64,69,77,146,146,15,11,4,33
S01011062,Very good health,317,17,7,10,45,38,30,37,65,54,4,2,2,27
S01011062,Good health,253,5,2,3,32,22,26,33,57,63,10,8,2,5
S01011062,Fair health,67,4,0,4,5,3,13,4,16,20,1,1,0,1
S01011062,Bad health,17,0,0,0,1,1,0,3,5,7,0,0,0,0
S01011062,Very bad health,6,0,0,0,1,0,0,0,3,2,0,0,0,0
S01011063,All people aged 16 to 74,736,28,3,25,90,74,49,90,185,152,32,20,12,36
S01011063,Very good health,347,17,1,16,44,43,21,53,79,59,9,5,4,22
S01011063,Good health,257,6,2,4,36,19,17,23,77,61,7,3,4,11
S01011063,Fair health,88,4,0,4,4,7,7,12,21,21,10,6,4,2
S01011063,Bad health,29,1,0,1,3,4,3,1,5,8,3,3,0,1
S01011063,Very bad health,15,0,0,0,3,1,1,1,3,3,3,3,0,0
S01011064,All people aged 16 to 74,750,39,12,27,114,89,72,88,158,144,21,11,10,25
S01011064,Very good health,379,26,9,17,64,39,45,38,81,64,5,1,4,17
S01011064,Good health,261,8,1,7,37,39,17,41,52,52,9,5,4,6
S01011064,Fair health,83,3,1,2,8,6,9,6,20,23,6,4,2,2
S01011064,Bad health,19,2,1,1,4,4,0,2,3,3,1,1,0,0
S01011064,Very bad health,8,0,0,0,1,1,1,1,2,2,0,0,0,0
S01011065,All people aged 16 to 74,524,38,9,29,88,59,75,54,95,68,16,10,6,31
S01011065,Very good health,234,16,8,8,41,28,36,18,33,27,8,3,5,27
S01011065,Good health,216,12,1,11,34,25,30,27,48,32,5,4,1,3
S01011065,Fair health,59,10,0,10,12,4,7,5,11,6,3,3,0,1
S01011065,Bad health,10,0,0,0,1,1,1,3,2,2,0,0,0,0
S01011065,Very bad health,5,0,0,0,0,1,1,1,1,1,0,0,0,0
S01011066,All people aged 16 to 74,374,26,6,20,79,51,64,34,49,44,14,8,6,13
S01011066,Very good health,196,21,4,17,41,22,37,20,22,20,4,4,0,9
S01011066,Good health,129,4,1,3,29,21,20,11,17,18,7,2,5,2
S01011066,Fair health,40,1,1,0,9,7,6,3,6,5,2,2,0,1
S01011066,Bad health,6,0,0,0,0,0,0,0,3,1,1,0,1,1
S01011066,Very bad health,3,0,0,0,0,1,1,0,1,0,0,0,0,0
S01011067,All people aged 16 to 74,394,30,10,20,62,47,55,50,70,54,14,8,6,12
S01011067,Very good health,169,10,3,7,36,16,23,23,28,19,6,2,4,8
S01011067,Good health,164,14,4,10,23,20,25,21,26,27,5,5,0,3
S01011067,Fair health,45,4,1,3,3,5,5,5,12,7,3,1,2,1
S01011067,Bad health,14,2,2,0,0,5,2,1,3,1,0,0,0,0
S01011067,Very bad health,2,0,0,0,0,1,0,0,1,0,0,0,0,0
S01011068,All people aged 16 to 74,389,14,3,11,63,34,45,43,91,71,9,5,4,19
S01011068,Very good health,171,8,2,6,27,15,20,17,37,29,3,2,1,15
S01011068,Good health,165,4,1,3,27,13,21,18,47,31,1,1,0,3
S01011068,Fair health,39,1,0,1,7,3,4,5,5,8,5,2,3,1
S01011068,Bad health,10,1,0,1,2,2,0,2,1,2,0,0,0,0
S01011068,Very bad health,4,0,0,0,0,1,0,1,1,1,0,0,0,0
S01011069,All people aged 16 to 74,418,20,5,15,84,34,40,47,93,69,12,7,5,19
S01011069,Very good health,184,13,4,9,40,17,14,26,33,21,8,6,2,12
S01011069,Good health,154,5,0,5,31,9,17,13,41,30,2,0,2,6
S01011069,Fair health,56,2,1,1,10,4,5,7,12,15,0,0,0,1
S01011069,Bad health,18,0,0,0,3,2,3,1,5,2,2,1,1,0
S01011069,Very bad health,6,0,0,0,0,2,1,0,2,1,0,0,0,0
S01011070,All people aged 16 to 74,455,23,7,16,93,52,43,55,88,80,3,2,1,18
S01011070,Very good health,220,12,4,8,48,30,16,26,38,36,1,0,1,13
S01011070,Good health,178,7,1,6,34,16,22,23,41,30,0,0,0,5
S01011070,Fair health,43,4,2,2,11,4,4,6,3,10,1,1,0,0
S01011070,Bad health,9,0,0,0,0,2,1,0,4,2,0,0,0,0
S01011070,Very bad health,5,0,0,0,0,0,0,0,2,2,1,1,0,0
S01011071,All people aged 16 to 74,637,35,8,27,147,75,82,67,106,75,17,9,8,33
S01011071,Very good health,326,17,6,11,82,34,37,40,43,39,8,4,4,26
S01011071,Good health,228,13,2,11,52,28,36,18,48,24,5,2,3,4
S01011071,Fair health,57,2,0,2,8,10,8,5,10,8,3,2,1,3
S01011071,Bad health,23,3,0,3,5,1,1,4,5,3,1,1,0,0
S01011071,Very bad health,3,0,0,0,0,2,0,0,0,1,0,0,0,0
S01011072,All people aged 16 to 74,740,33,12,21,156,91,88,92,135,92,22,12,10,31
S01011072,Very good health,387,18,8,10,97,50,44,47,68,40,5,3,2,18
S01011072,Good health,262,13,3,10,44,31,34,33,47,38,10,4,6,12
S01011072,Fair health,77,2,1,1,15,8,8,9,18,10,6,4,2,1
S01011072,Bad health,12,0,0,0,0,1,2,2,2,4,1,1,0,0
S01011072,Very bad health,2,0,0,0,0,1,0,1,0,0,0,0,0,0
S01011073,All people aged 16 to 74,528,26,7,19,83,60,54,65,113,92,7,4,3,28
S01011073,Very good health,268,14,5,9,35,39,20,34,59,42,1,1,0,24
S01011073,Good health,181,10,2,8,34,15,23,22,38,33,4,2,2,2
S01011073,Fair health,62,1,0,1,11,5,9,7,12,13,2,1,1,2
S01011073,Bad health,13,0,0,0,3,1,2,1,2,4,0,0,0,0
S01011073,Very bad health,4,1,0,1,0,0,0,1,2,0,0,0,0,0
S01011074,All people aged 16 to 74,456,18,5,13,78,45,45,58,113,63,14,12,2,22
S01011074,Very good health,241,9,3,6,49,26,21,30,53,28,8,7,1,17
S01011074,Good health,166,6,1,5,22,18,17,22,48,24,5,4,1,4
S01011074,Fair health,34,1,1,0,6,1,5,4,9,7,1,1,0,0
S01011074,Bad health,13,2,0,2,1,0,1,2,2,4,0,0,0,1
S01011074,Very bad health,2,0,0,0,0,0,1,0,1,0,0,0,0,0
S01011075,All people aged 16 to 74,507,8,5,3,40,33,36,62,147,127,38,25,13,16
S01011075,Very good health,196,2,1,1,15,17,15,31,55,43,8,5,3,10
S01011075,Good health,215,5,3,2,18,10,12,27,64,54,19,12,7,6
S01011075,Fair health,78,1,1,0,4,5,8,3,23,26,8,5,3,0
S01011075,Bad health,13,0,0,0,2,1,0,1,4,3,2,2,0,0
S01011075,Very bad health,5,0,0,0,1,0,1,0,1,1,1,1,0,0
S01011076,All people aged 16 to 74,517,13,3,10,62,43,40,84,126,96,34,19,15,19
S01011076,Very good health,233,7,2,5,38,28,11,39,49,40,7,3,4,14
S01011076,Good health,196,4,1,3,20,9,20,33,55,35,16,7,9,4
S01011076,Fair health,73,2,0,2,4,6,8,10,19,15,8,6,2,1
S01011076,Bad health,14,0,0,0,0,0,1,1,3,6,3,3,0,0
S01011076,Very bad health,1,0,0,0,0,0,0,1,0,0,0,0,0,0
S01011077,All people aged 16 to 74,537,4,0,4,57,34,25,57,148,150,40,24,16,22
S01011077,Very good health,241,1,0,1,25,24,6,31,67,55,16,9,7,16
S01011077,Good health,202,2,0,2,25,6,12,22,52,67,12,7,5,4
S01011077,Fair health,62,1,0,1,5,2,3,3,21,19,7,3,4,1
S01011077,Bad health,25,0,0,0,2,1,2,0,7,7,5,5,0,1
S01011077,Very bad health,7,0,0,0,0,1,2,1,1,2,0,0,0,0
S01011078,All people aged 16 to 74,795,43,13,30,141,96,86,103,153,97,28,19,9,48
S01011078,Very good health,420,23,7,16,79,52,37,59,81,40,11,9,2,38
S01011078,Good health,259,16,6,10,42,30,33,36,49,40,5,4,1,8
S01011078,Fair health,91,3,0,3,17,12,13,5,18,10,11,5,6,2
S01011078,Bad health,23,1,0,1,3,2,3,3,5,6,0,0,0,0
S01011078,Very bad health,2,0,0,0,0,0,0,0,0,1,1,1,0,0
S01011079,All people aged 16 to 74,775,26,10,16,135,61,73,127,145,150,28,14,14,30
S01011079,Very good health,388,13,8,5,76,31,31,68,68,65,10,5,5,26
S01011079,Good health,294,8,2,6,39,27,30,46,61,65,14,8,6,4
S01011079,Fair health,65,3,0,3,12,3,10,10,12,12,3,0,3,0
S01011079,Bad health,22,2,0,2,6,0,1,2,4,7,0,0,0,0
S01011079,Very bad health,6,0,0,0,2,0,1,1,0,1,1,1,0,0
S01011080,All people aged 16 to 74,733,26,8,18,98,84,59,115,151,119,43,34,9,38
S01011080,Very good health,353,15,5,10,51,36,23,57,66,57,18,12,6,30
S01011080,Good health,258,7,2,5,34,33,22,41,60,44,9,6,3,8
S01011080,Fair health,91,2,1,1,10,9,8,16,21,14,11,11,0,0
S01011080,Bad health,21,2,0,2,3,3,3,1,2,3,4,4,0,0
S01011080,Very bad health,10,0,0,0,0,3,3,0,2,1,1,1,0,0
S01011081,All people aged 16 to 74,598,15,4,11,64,54,38,95,161,111,23,14,9,37
S01011081,Very good health,305,11,3,8,38,30,12,55,75,50,8,5,3,26
S01011081,Good health,201,4,1,3,22,13,12,24,71,41,5,0,5,9
S01011081,Fair health,64,0,0,0,3,6,10,11,11,13,8,7,1,2
S01011081,Bad health,21,0,0,0,0,5,3,4,3,4,2,2,0,0
S01011081,Very bad health,7,0,0,0,1,0,1,1,1,3,0,0,0,0
S01011082,All people aged 16 to 74,336,9,3,6,36,27,17,53,77,89,16,11,5,12
S01011082,Very good health,155,6,2,4,18,12,5,27,35,38,4,2,2,10
S01011082,Good health,116,1,1,0,13,7,8,17,25,37,6,3,3,2
S01011082,Fair health,42,1,0,1,2,6,3,7,12,7,4,4,0,0
S01011082,Bad health,14,1,0,1,1,2,1,2,4,3,0,0,0,0
S01011082,Very bad health,9,0,0,0,2,0,0,0,1,4,2,2,0,0
S01011083,All people aged 16 to 74,570,29,9,20,118,55,47,80,124,82,19,11,8,16
S01011083,Very good health,265,16,4,12,59,27,19,37,56,33,5,4,1,13
S01011083,Good health,196,10,4,6,44,17,17,28,43,26,8,3,5,3
S01011083,Fair health,76,3,1,2,10,5,9,8,18,17,6,4,2,0
S01011083,Bad health,22,0,0,0,2,4,2,5,5,4,0,0,0,0
S01011083,Very bad health,11,0,0,0,3,2,0,2,2,2,0,0,0,0
S01011084,All people aged 16 to 74,591,43,11,32,150,82,85,54,81,52,16,9,7,28
S01011084,Very good health,304,21,6,15,72,49,32,33,42,24,9,5,4,22
S01011084,Good health,211,17,4,13,63,28,36,16,24,18,4,2,2,5
S01011084,Fair health,59,2,0,2,13,4,12,5,10,9,3,2,1,1
S01011084,Bad health,15,3,1,2,2,1,5,0,4,0,0,0,0,0
S01011084,Very bad health,2,0,0,0,0,0,0,0,1,1,0,0,0,0
S01011085,All people aged 16 to 74,675,61,20,41,185,96,63,54,98,61,16,13,3,41
S01011085,Very good health,365,34,9,25,110,49,30,24,53,23,9,8,1,33
S01011085,Good health,226,21,10,11,60,38,25,18,30,24,2,1,1,8
S01011085,Fair health,63,5,1,4,8,8,6,9,13,9,5,4,1,0
S01011085,Bad health,14,1,0,1,4,1,1,2,2,3,0,0,0,0
S01011085,Very bad health,7,0,0,0,3,0,1,1,0,2,0,0,0,0
S01011086,All people aged 16 to 74,475,43,15,28,105,59,41,58,85,53,10,10,0,21
S01011086,Very good health,214,14,4,10,55,27,15,31,32,17,3,3,0,20
S01011086,Good health,172,16,8,8,34,23,17,19,38,21,3,3,0,1
S01011086,Fair health,63,11,3,8,10,5,5,6,11,13,2,2,0,0
S01011086,Bad health,22,1,0,1,5,4,4,1,4,1,2,2,0,0
S01011086,Very bad health,4,1,0,1,1,0,0,1,0,1,0,0,0,0
S01011087,All people aged 16 to 74,429,15,7,8,74,43,33,66,90,81,13,9,4,14
S01011087,Very good health,165,6,4,2,35,17,10,22,35,28,3,1,2,9
S01011087,Good health,174,6,2,4,29,16,12,30,39,34,4,2,2,4
S01011087,Fair health,71,3,1,2,8,7,5,12,15,16,4,4,0,1
S01011087,Bad health,13,0,0,0,2,2,4,1,1,2,1,1,0,0
S01011087,Very bad health,6,0,0,0,0,1,2,1,0,1,1,1,0,0
S01011088,All people aged 16 to 74,697,47,13,34,173,92,62,54,110,98,25,18,7,36
S01011088,Very good health,336,26,8,18,95,44,26,25,38,47,6,3,3,29
S01011088,Good health,262,14,3,11,58,38,23,23,50,38,14,10,4,4
S01011088,Fair health,73,4,1,3,16,7,7,6,19,9,3,3,0,2
S01011088,Bad health,15,2,1,1,1,1,4,0,2,2,2,2,0,1
S01011088,Very bad health,11,1,0,1,3,2,2,0,1,2,0,0,0,0
S01011089,All people aged 16 to 74,462,15,3,12,82,42,33,44,105,81,31,18,13,29
S01011089,Very good health,187,9,0,9,36,18,14,19,33,28,8,5,3,22
S01011089,Good health,182,4,3,1,32,18,11,13,50,35,12,7,5,7
S01011089,Fair health,71,1,0,1,12,5,5,8,19,13,8,3,5,0
S01011089,Bad health,19,0,0,0,2,0,2,4,3,5,3,3,0,0
S01011089,Very bad health,3,1,0,1,0,1,1,0,0,0,0,0,0,0
S01011090,All people aged 16 to 74,548,46,15,31,118,61,83,55,93,56,8,4,4,28
S01011090,Very good health,303,26,7,19,65,39,42,32,49,27,5,2,3,18
S01011090,Good health,175,16,6,10,43,19,20,18,30,17,3,2,1,9
S01011090,Fair health,50,3,2,1,8,1,15,4,9,10,0,0,0,0
S01011090,Bad health,18,1,0,1,2,1,6,1,4,2,0,0,0,1
S01011090,Very bad health,2,0,0,0,0,1,0,0,1,0,0,0,0,0
S01011091,All people aged 16 to 74,491,44,13,31,104,61,69,57,77,53,11,5,6,15
S01011091,Very good health,269,29,7,22,59,33,36,36,36,22,6,3,3,12
S01011091,Good health,161,13,6,7,33,18,27,15,32,18,3,2,1,2
S01011091,Fair health,53,2,0,2,10,8,5,5,9,11,2,0,2,1
S01011091,Bad health,6,0,0,0,2,1,1,0,0,2,0,0,0,0
S01011091,Very bad health,2,0,0,0,0,1,0,1,0,0,0,0,0,0
S01011092,All people aged 16 to 74,316,11,3,8,49,38,20,27,52,64,27,17,10,28
S01011092,Very good health,135,6,2,4,25,19,7,8,24,28,3,1,2,15
S01011092,Good health,109,5,1,4,16,11,7,9,15,18,15,10,5,13
S01011092,Fair health,49,0,0,0,5,7,4,6,6,15,6,3,3,0
S01011092,Bad health,20,0,0,0,2,1,1,4,7,2,3,3,0,0
S01011092,Very bad health,3,0,0,0,1,0,1,0,0,1,0,0,0,0
S01011093,All people aged 16 to 74,475,46,17,29,121,53,69,55,55,41,9,5,4,26
S01011093,Very good health,294,26,10,16,81,38,33,33,31,24,4,3,1,24
S01011093,Good health,140,18,7,11,34,12,28,16,16,11,3,1,2,2
S01011093,Fair health,31,2,0,2,2,3,6,6,5,5,2,1,1,0
S01011093,Bad health,5,0,0,0,2,0,1,0,1,1,0,0,0,0
S01011093,Very bad health,5,0,0,0,2,0,1,0,2,0,0,0,0,0
S01011094,All people aged 16 to 74,370,40,12,28,103,39,54,33,48,26,7,5,2,20
S01011094,Very good health,227,29,10,19,70,23,29,22,24,12,2,1,1,16
S01011094,Good health,103,8,2,6,28,14,15,9,17,8,2,2,0,2
S01011094,Fair health,30,0,0,0,4,1,8,1,5,6,3,2,1,2
S01011094,Bad health,8,3,0,3,1,0,2,1,1,0,0,0,0,0
S01011094,Very bad health,2,0,0,0,0,1,0,0,1,0,0,0,0,0
S01011095,All people aged 16 to 74,598,57,22,35,147,71,92,59,78,43,13,4,9,38
S01011095,Very good health,338,33,13,20,84,42,53,31,44,20,5,1,4,26
S01011095,Good health,185,20,8,12,47,20,24,22,22,15,6,2,4,9
S01011095,Fair health,54,4,1,3,12,7,10,4,7,6,1,1,0,3
S01011095,Bad health,15,0,0,0,4,0,4,2,4,1,0,0,0,0
S01011095,Very bad health,6,0,0,0,0,2,1,0,1,1,1,0,1,0
S01011096,All people aged 16 to 74,433,38,14,24,105,50,48,47,56,48,8,5,3,33
S01011096,Very good health,258,26,10,16,70,30,21,24,28,29,4,2,2,26
S01011096,Good health,124,7,4,3,28,12,20,15,21,14,0,0,0,7
S01011096,Fair health,35,5,0,5,5,6,4,5,7,1,2,2,0,0
S01011096,Bad health,7,0,0,0,0,1,1,1,0,4,0,0,0,0
S01011096,Very bad health,9,0,0,0,2,1,2,2,0,0,2,1,1,0
S01011097,All people aged 16 to 74,518,50,11,39,129,59,72,51,76,46,9,5,4,26
S01011097,Very good health,298,33,6,27,85,38,36,24,36,23,3,2,1,20
S01011097,Good health,167,16,5,11,34,16,26,19,32,15,4,2,2,5
S01011097,Fair health,35,1,0,1,5,4,8,5,6,5,0,0,0,1
S01011097,Bad health,15,0,0,0,5,1,1,3,2,1,2,1,1,0
S01011097,Very bad health,3,0,0,0,0,0,1,0,0,2,0,0,0,0
S01011098,All people aged 16 to 74,577,27,6,21,138,78,42,55,117,83,9,7,2,28
S01011098,Very good health,309,14,2,12,75,42,17,35,57,46,4,2,2,19
S01011098,Good health,189,12,4,8,43,25,21,15,42,21,2,2,0,8
S01011098,Fair health,47,1,0,1,14,6,0,5,11,7,2,2,0,1
S01011098,Bad health,26,0,0,0,5,4,4,0,6,7,0,0,0,0
S01011098,Very bad health,6,0,0,0,1,1,0,0,1,2,1,1,0,0
S01011099,All people aged 16 to 74,627,12,6,6,87,66,36,75,136,149,28,16,12,38
S01011099,Very good health,271,4,3,1,35,26,18,30,57,57,15,7,8,29
S01011099,Good health,241,7,3,4,41,29,12,32,48,58,7,5,2,7
S01011099,Fair health,89,0,0,0,8,10,4,8,27,24,6,4,2,2
S01011099,Bad health,17,0,0,0,3,1,2,1,2,8,0,0,0,0
S01011099,Very bad health,9,1,0,1,0,0,0,4,2,2,0,0,0,0
S01011100,All people aged 16 to 74,321,12,0,12,55,45,24,35,71,52,9,5,4,18
S01011100,Very good health,150,10,0,10,34,27,9,19,21,17,0,0,0,13
S01011100,Good health,119,1,0,1,14,10,12,14,36,23,6,4,2,3
S01011100,Fair health,37,0,0,0,5,7,3,2,9,7,3,1,2,1
S01011100,Bad health,12,1,0,1,2,1,0,0,4,4,0,0,0,0
S01011100,Very bad health,3,0,0,0,0,0,0,0,1,1,0,0,0,1
S01011101,All people aged 16 to 74,459,10,6,4,36,43,18,68,111,123,24,17,7,26
S01011101,Very good health,176,4,1,3,15,17,3,27,43,44,8,5,3,15
S01011101,Good health,189,2,1,1,15,17,11,29,48,52,8,7,1,7
S01011101,Fair health,70,2,2,0,4,6,2,7,16,23,7,5,2,3
S01011101,Bad health,19,2,2,0,2,1,2,3,4,3,1,0,1,1
S01011101,Very bad health,5,0,0,0,0,2,0,2,0,1,0,0,0,0
S01011102,All people aged 16 to 74,503,10,2,8,70,30,13,60,145,126,33,18,15,16
S01011102,Very good health,193,8,1,7,35,12,4,14,53,50,10,5,5,7
S01011102,Good health,217,1,0,1,28,15,5,34,67,49,10,6,4,8
S01011102,Fair health,63,1,1,0,3,2,2,3,22,19,10,4,6,1
S01011102,Bad health,21,0,0,0,3,0,1,6,3,6,2,2,0,0
S01011102,Very bad health,9,0,0,0,1,1,1,3,0,2,1,1,0,0
S01011103,All people aged 16 to 74,441,16,6,10,75,27,23,49,101,91,34,23,11,25
S01011103,Very good health,190,11,4,7,43,11,4,19,43,39,5,3,2,15
S01011103,Good health,169,3,1,2,22,14,13,25,41,30,12,8,4,9
S01011103,Fair health,62,1,0,1,7,1,4,4,15,16,13,8,5,1
S01011103,Bad health,16,1,1,0,2,1,2,1,1,4,4,4,0,0
S01011103,Very bad health,4,0,0,0,1,0,0,0,1,2,0,0,0,0
S01011104,All people aged 16 to 74,456,39,7,32,118,42,38,42,69,48,33,26,7,27
S01011104,Very good health,200,20,2,18,67,23,12,22,18,14,7,5,2,17
S01011104,Good health,166,14,5,9,41,13,16,16,33,16,9,6,3,8
S01011104,Fair health,68,3,0,3,8,6,7,3,14,13,12,10,2,2
S01011104,Bad health,20,2,0,2,2,0,2,1,3,5,5,5,0,0
S01011104,Very bad health,2,0,0,0,0,0,1,0,1,0,0,0,0,0
S01011105,All people aged 16 to 74,613,27,10,17,106,53,43,69,128,139,22,13,9,26
S01011105,Very good health,300,14,5,9,63,29,21,32,60,57,8,5,3,16
S01011105,Good health,206,8,4,4,27,18,17,26,41,57,6,4,2,6
S01011105,Fair health,80,3,0,3,14,4,4,7,21,18,5,2,3,4
S01011105,Bad health,18,2,1,1,0,1,1,3,5,4,2,1,1,0
S01011105,Very bad health,9,0,0,0,2,1,0,1,1,3,1,1,0,0
S01011106,All people aged 16 to 74,637,17,4,13,174,92,26,54,130,85,32,14,18,27
S01011106,Very good health,361,9,1,8,114,64,13,32,66,36,12,1,11,15
S01011106,Good health,214,5,1,4,50,21,11,17,54,36,12,6,6,8
S01011106,Fair health,42,2,1,1,6,6,1,3,6,8,6,5,1,4
S01011106,Bad health,17,1,1,0,4,0,0,2,4,4,2,2,0,0
S01011106,Very bad health,3,0,0,0,0,1,1,0,0,1,0,0,0,0
S01011107,All people aged 16 to 74,633,28,10,18,150,61,30,66,136,98,17,7,10,47
S01011107,Very good health,370,21,9,12,98,41,16,38,74,39,8,4,4,35
S01011107,Good health,200,5,1,4,45,15,9,25,42,41,7,2,5,11
S01011107,Fair health,46,2,0,2,7,4,2,2,15,12,1,0,1,1
S01011107,Bad health,13,0,0,0,0,1,1,1,5,4,1,1,0,0
S01011107,Very bad health,4,0,0,0,0,0,2,0,0,2,0,0,0,0
S01011108,All people aged 16 to 74,418,15,4,11,74,40,25,52,83,69,19,13,6,41
S01011108,Very good health,211,11,1,10,35,26,13,22,33,27,12,9,3,32
S01011108,Good health,149,3,2,1,31,9,10,24,33,25,5,3,2,9
S01011108,Fair health,37,0,0,0,3,2,2,2,17,10,1,0,1,0
S01011108,Bad health,18,1,1,0,4,3,0,4,0,5,1,1,0,0
S01011108,Very bad health,3,0,0,0,1,0,0,0,0,2,0,0,0,0
S01011109,All people aged 16 to 74,619,32,8,24,109,89,44,76,124,112,16,10,6,17
S01011109,Very good health,319,19,4,15,63,42,20,42,66,46,6,3,3,15
S01011109,Good health,210,12,4,8,35,37,18,25,43,36,3,1,2,1
S01011109,Fair health,65,1,0,1,9,6,5,7,9,24,4,3,1,0
S01011109,Bad health,19,0,0,0,1,2,1,2,4,6,2,2,0,1
S01011109,Very bad health,6,0,0,0,1,2,0,0,2,0,1,1,0,0
S01011110,All people aged 16 to 74,539,13,4,9,77,69,22,70,122,105,26,16,10,35
S01011110,Very good health,249,8,2,6,42,31,9,31,55,42,7,4,3,24
S01011110,Good health,198,4,2,2,25,26,8,26,46,41,12,7,5,10
S01011110,Fair health,66,1,0,1,7,10,4,7,14,15,7,5,2,1
S01011110,Bad health,20,0,0,0,3,1,0,5,5,6,0,0,0,0
S01011110,Very bad health,6,0,0,0,0,1,1,1,2,1,0,0,0,0
S01011111,All people aged 16 to 74,648,11,4,7,77,54,32,70,172,152,48,42,6,32
S01011111,Very good health,285,5,1,4,44,27,17,21,71,67,12,10,2,21
S01011111,Good health,219,2,0,2,23,19,9,35,57,54,12,8,4,8
S01011111,Fair health,102,3,2,1,9,4,2,10,34,25,12,12,0,3
S01011111,Bad health,34,1,1,0,1,3,4,4,7,5,9,9,0,0
S01011111,Very bad health,8,0,0,0,0,1,0,0,3,1,3,3,0,0
S01011112,All people aged 16 to 74,624,34,8,26,148,91,37,86,107,71,15,10,5,35
S01011112,Very good health,380,25,7,18,105,51,25,54,56,27,9,6,3,28
S01011112,Good health,202,8,1,7,42,33,9,25,45,29,4,3,1,7
S01011112,Fair health,33,1,0,1,1,6,2,5,5,11,2,1,1,0
S01011112,Bad health,4,0,0,0,0,1,0,0,0,3,0,0,0,0
S01011112,Very bad health,5,0,0,0,0,0,1,2,1,1,0,0,0,0
S01011113,All people aged 16 to 74,696,28,5,23,123,79,39,87,171,122,18,14,4,29
S01011113,Very good health,334,18,3,15,65,41,19,47,70,48,4,2,2,22
S01011113,Good health,245,8,1,7,44,26,15,31,61,51,3,3,0,6
S01011113,Fair health,89,1,1,0,12,12,3,6,32,13,10,8,2,0
S01011113,Bad health,23,1,0,1,2,0,2,2,5,9,1,1,0,1
S01011113,Very bad health,5,0,0,0,0,0,0,1,3,1,0,0,0,0
S01011114,All people aged 16 to 74,575,21,3,18,122,85,42,78,110,68,14,8,6,35
S01011114,Very good health,306,15,1,14,56,52,19,46,51,33,6,3,3,28
S01011114,Good health,202,4,1,3,54,24,17,24,47,24,3,0,3,5
S01011114,Fair health,45,2,1,1,9,5,5,6,8,7,1,1,0,2
S01011114,Bad health,18,0,0,0,3,3,1,2,4,3,2,2,0,0
S01011114,Very bad health,4,0,0,0,0,1,0,0,0,1,2,2,0,0
S01011115,All people aged 16 to 74,691,12,5,7,84,68,45,100,151,159,31,20,11,41
S01011115,Very good health,299,4,3,1,52,28,23,46,59,58,4,3,1,25
S01011115,Good health,240,4,2,2,22,23,15,38,57,55,15,8,7,11
S01011115,Fair health,106,2,0,2,7,14,3,9,20,35,11,8,3,5
S01011115,Bad health,39,1,0,1,2,2,4,6,13,10,1,1,0,0
S01011115,Very bad health,7,1,0,1,1,1,0,1,2,1,0,0,0,0
S01011116,All people aged 16 to 74,501,19,5,14,89,70,28,64,99,84,12,8,4,36
S01011116,Very good health,252,11,2,9,51,34,15,29,44,39,2,2,0,27
S01011116,Good health,174,5,2,3,25,29,13,28,31,31,6,4,2,6
S01011116,Fair health,54,2,1,1,11,6,0,4,15,9,4,2,2,3
S01011116,Bad health,12,1,0,1,2,1,0,2,4,2,0,0,0,0
S01011116,Very bad health,9,0,0,0,0,0,0,1,5,3,0,0,0,0
S01011117,All people aged 16 to 74,546,68,9,59,137,55,59,44,77,49,16,14,2,41
S01011117,Very good health,269,39,4,35,78,24,21,20,34,24,6,6,0,23
S01011117,Good health,211,23,5,18,48,25,26,17,33,16,7,7,0,16
S01011117,Fair health,54,5,0,5,9,6,7,5,9,8,3,1,2,2
S01011117,Bad health,7,0,0,0,2,0,2,2,1,0,0,0,0,0
S01011117,Very bad health,5,1,0,1,0,0,3,0,0,1,0,0,0,0
S01011118,All people aged 16 to 74,597,88,20,68,169,71,45,43,80,50,11,6,5,40
S01011118,Very good health,359,62,12,50,107,37,26,23,44,29,3,0,3,28
S01011118,Good health,177,22,7,15,50,25,12,15,27,12,5,4,1,9
S01011118,Fair health,49,4,1,3,9,5,5,4,8,9,2,2,0,3
S01011118,Bad health,12,0,0,0,3,4,2,1,1,0,1,0,1,0
S01011118,Very bad health,0,0,0,0,0,0,0,0,0,0,0,0,0,0
S01011119,All people aged 16 to 74,666,83,23,60,196,102,52,43,75,66,11,11,0,38
S01011119,Very good health,365,58,17,41,127,46,27,23,27,28,1,1,0,28
S01011119,Good health,225,19,5,14,55,46,17,16,37,20,5,5,0,10
S01011119,Fair health,58,5,1,4,11,8,6,2,8,16,2,2,0,0
S01011119,Bad health,14,1,0,1,3,1,1,1,3,1,3,3,0,0
S01011119,Very bad health,4,0,0,0,0,1,1,1,0,1,0,0,0,0
S01011120,All people aged 16 to 74,510,68,19,49,165,78,42,32,62,26,13,10,3,24
S01011120,Very good health,259,36,12,24,85,43,21,15,26,12,2,1,1,19
S01011120,Good health,188,27,7,20,64,22,15,15,25,9,7,6,1,4
S01011120,Fair health,50,3,0,3,13,10,5,2,10,4,2,2,0,1
S01011120,Bad health,10,1,0,1,3,3,0,0,1,1,1,0,1,0
S01011120,Very bad health,3,1,0,1,0,0,1,0,0,0,1,1,0,0
S01011121,All people aged 16 to 74,408,25,2,23,65,47,25,48,95,72,12,7,5,19
S01011121,Very good health,176,20,2,18,33,23,8,21,36,20,2,0,2,13
S01011121,Good health,156,5,0,5,20,19,14,18,41,33,3,1,2,3
S01011121,Fair health,57,0,0,0,11,3,2,7,12,13,6,5,1,3
S01011121,Bad health,15,0,0,0,1,1,0,1,6,6,0,0,0,0
S01011121,Very bad health,4,0,0,0,0,1,1,1,0,0,1,1,0,0
S01011122,All people aged 16 to 74,480,25,5,20,113,55,33,54,92,73,9,7,2,26
S01011122,Very good health,235,16,4,12,61,34,15,27,36,24,1,0,1,21
S01011122,Good health,180,7,1,6,43,16,13,18,40,34,5,4,1,4
S01011122,Fair health,50,2,0,2,7,3,4,6,12,12,3,3,0,1
S01011122,Bad health,11,0,0,0,1,2,1,3,2,2,0,0,0,0
S01011122,Very bad health,4,0,0,0,1,0,0,0,2,1,0,0,0,0
S01011123,All people aged 16 to 74,811,21,10,11,118,88,45,112,183,184,24,15,9,36
S01011123,Very good health,386,13,7,6,63,42,21,59,67,87,8,6,2,26
S01011123,Good health,296,6,1,5,45,35,16,37,79,62,8,4,4,8
S01011123,Fair health,102,2,2,0,6,11,4,12,28,31,6,4,2,2
S01011123,Bad health,24,0,0,0,2,0,4,3,9,4,2,1,1,0
S01011123,Very bad health,3,0,0,0,2,0,0,1,0,0,0,0,0,0
S01011124,All people aged 16 to 74,449,20,7,13,97,57,27,46,68,92,9,5,4,33
S01011124,Very good health,248,17,7,10,54,28,16,28,34,43,4,1,3,24
S01011124,Good health,135,2,0,2,30,22,10,11,24,27,1,0,1,8
S01011124,Fair health,49,1,0,1,10,5,1,5,7,16,3,3,0,1
S01011124,Bad health,13,0,0,0,3,2,0,0,2,5,1,1,0,0
S01011124,Very bad health,4,0,0,0,0,0,0,2,1,1,0,0,0,0
S01011125,All people aged 16 to 74,374,9,3,6,50,34,18,50,95,74,21,16,5,23
S01011125,Very good health,161,3,1,2,22,13,9,19,48,29,3,3,0,15
S01011125,Good health,149,4,0,4,24,17,6,23,32,29,7,5,2,7
S01011125,Fair health,38,1,1,0,2,2,3,5,8,9,7,5,2,1
S01011125,Bad health,18,1,1,0,1,1,0,2,5,5,3,2,1,0
S01011125,Very bad health,8,0,0,0,1,1,0,1,2,2,1,1,0,0
S01011126,All people aged 16 to 74,337,10,3,7,69,53,25,36,72,48,10,3,7,14
S01011126,Very good health,174,8,2,6,41,27,12,16,36,20,4,2,2,10
S01011126,Good health,121,1,1,0,23,18,12,17,23,20,3,0,3,4
S01011126,Fair health,29,1,0,1,4,7,1,2,8,4,2,0,2,0
S01011126,Bad health,11,0,0,0,1,1,0,1,4,3,1,1,0,0
S01011126,Very bad health,2,0,0,0,0,0,0,0,1,1,0,0,0,0
S01011127,All people aged 16 to 74,324,4,1,3,119,82,11,12,59,15,5,4,1,17
S01011127,Very good health,242,4,1,3,94,66,6,8,34,11,4,3,1,15
S01011127,Good health,64,0,0,0,17,14,4,3,22,4,0,0,0,0
S01011127,Fair health,17,0,0,0,8,2,1,0,3,0,1,1,0,2
S01011127,Bad health,1,0,0,0,0,0,0,1,0,0,0,0,0,0
S01011127,Very bad health,0,0,0,0,0,0,0,0,0,0,0,0,0,0
S01011128,All people aged 16 to 74,562,29,5,24,111,68,28,59,106,102,23,16,7,36
S01011128,Very good health,289,20,4,16,69,39,16,28,44,40,8,7,1,25
S01011128,Good health,181,8,1,7,32,21,7,20,44,36,4,2,2,9
S01011128,Fair health,61,0,0,0,6,6,4,10,13,15,5,2,3,2
S01011128,Bad health,26,1,0,1,3,2,1,1,5,8,5,4,1,0
S01011128,Very bad health,5,0,0,0,1,0,0,0,0,3,1,1,0,0
S01011129,All people aged 16 to 74,679,128,92,36,190,88,49,47,83,49,13,9,4,32
S01011129,Very good health,452,112,84,28,123,53,25,28,47,31,5,2,3,28
S01011129,Good health,162,11,6,5,52,26,18,15,22,12,4,3,1,2
S01011129,Fair health,46,5,2,3,11,7,5,2,11,3,1,1,0,1
S01011129,Bad health,18,0,0,0,4,2,1,1,3,3,3,3,0,1
S01011129,Very bad health,1,0,0,0,0,0,0,1,0,0,0,0,0,0
S01011130,All people aged 16 to 74,444,15,4,11,94,59,20,33,97,82,26,15,11,18
S01011130,Very good health,197,8,3,5,46,29,13,14,37,30,6,4,2,14
S01011130,Good health,153,5,1,4,36,21,3,13,32,28,12,8,4,3
S01011130,Fair health,58,2,0,2,9,6,3,4,17,12,5,2,3,0
S01011130,Bad health,27,0,0,0,3,1,0,2,8,9,3,1,2,1
S01011130,Very bad health,9,0,0,0,0,2,1,0,3,3,0,0,0,0
S01011131,All people aged 16 to 74,508,32,18,14,134,65,35,46,91,58,14,7,7,33
S01011131,Very good health,265,21,11,10,73,35,12,31,45,22,2,0,2,24
S01011131,Good health,182,8,6,2,51,26,13,12,34,21,8,4,4,9
S01011131,Fair health,40,3,1,2,2,3,7,1,8,12,4,3,1,0
S01011131,Bad health,14,0,0,0,3,1,2,2,4,2,0,0,0,0
S01011131,Very bad health,7,0,0,0,5,0,1,0,0,1,0,0,0,0
S01011132,All people aged 16 to 74,683,61,24,37,175,105,54,73,105,50,16,12,4,44
S01011132,Very good health,351,39,16,23,100,47,22,36,44,24,6,4,2,33
S01011132,Good health,241,18,7,11,52,44,27,23,39,21,7,5,2,10
S01011132,Fair health,69,3,1,2,18,11,4,11,15,4,2,2,0,1
S01011132,Bad health,13,0,0,0,2,0,0,3,7,0,1,1,0,0
S01011132,Very bad health,9,1,0,1,3,3,1,0,0,1,0,0,0,0
S01011133,All people aged 16 to 74,338,17,5,12,53,38,23,43,74,70,7,5,2,13
S01011133,Very good health,151,12,5,7,23,19,10,20,30,24,3,1,2,10
S01011133,Good health,128,5,0,5,21,17,9,17,27,29,3,3,0,0
S01011133,Fair health,45,0,0,0,8,2,3,4,13,11,1,1,0,3
S01011133,Bad health,12,0,0,0,1,0,1,2,3,5,0,0,0,0
S01011133,Very bad health,2,0,0,0,0,0,0,0,1,1,0,0,0,0
S01011134,All people aged 16 to 74,589,21,9,12,158,71,70,49,116,76,11,5,6,17
S01011134,Very good health,274,10,6,4,78,37,22,23,47,38,4,1,3,15
S01011134,Good health,217,7,2,5,70,23,29,16,46,21,3,0,3,2
S01011134,Fair health,76,3,1,2,9,7,17,7,20,10,3,3,0,0
S01011134,Bad health,17,0,0,0,1,3,1,2,3,6,1,1,0,0
S01011134,Very bad health,5,1,0,1,0,1,1,1,0,1,0,0,0,0
S01011135,All people aged 16 to 74,567,14,2,12,89,58,40,77,117,109,27,14,13,36
S01011135,Very good health,281,7,1,6,48,31,21,33,51,54,12,7,5,24
S01011135,Good health,214,5,0,5,29,23,16,33,46,42,9,4,5,11
S01011135,Fair health,53,2,1,1,8,2,2,8,14,11,5,2,3,1
S01011135,Bad health,16,0,0,0,4,1,1,2,6,1,1,1,0,0
S01011135,Very bad health,3,0,0,0,0,1,0,1,0,1,0,0,0,0
S01011136,All people aged 16 to 74,487,29,11,18,102,68,30,72,79,65,14,9,5,28
S01011136,Very good health,236,16,8,8,52,36,16,38,27,26,4,3,1,21
S01011136,Good health,178,8,1,7,36,27,9,25,35,29,4,2,2,5
S01011136,Fair health,53,4,2,2,10,2,2,6,14,8,5,3,2,2
S01011136,Bad health,15,1,0,1,4,2,3,2,1,2,0,0,0,0
S01011136,Very bad health,5,0,0,0,0,1,0,1,2,0,1,1,0,0
S01011137,All people aged 16 to 74,343,24,12,12,82,35,30,39,52,41,13,5,8,27
S01011137,Very good health,189,17,10,7,51,18,17,21,20,21,6,3,3,18
S01011137,Good health,121,5,2,3,27,16,9,16,24,14,4,2,2,6
S01011137,Fair health,29,2,0,2,3,1,4,2,7,5,2,0,2,3
S01011137,Bad health,3,0,0,0,0,0,0,0,1,1,1,0,1,0
S01011137,Very bad health,1,0,0,0,1,0,0,0,0,0,0,0,0,0
S01011138,All people aged 16 to 74,450,6,3,3,84,52,30,55,104,77,22,13,9,20
S01011138,Very good health,227,5,3,2,62,27,11,27,49,30,5,4,1,11
S01011138,Good health,156,1,0,1,17,17,10,21,39,33,11,7,4,7
S01011138,Fair health,50,0,0,0,3,4,8,6,13,9,5,1,4,2
S01011138,Bad health,14,0,0,0,2,3,1,1,2,4,1,1,0,0
S01011138,Very bad health,3,0,0,0,0,1,0,0,1,1,0,0,0,0
S01011139,All people aged 16 to 74,1102,78,71,7,308,466,24,59,76,47,13,4,9,31
S01011139,Very good health,760,66,63,3,219,329,11,36,44,23,7,2,5,25
S01011139,Good health,278,10,7,3,76,114,6,17,25,21,3,1,2,6
S01011139,Fair health,49,2,1,1,10,14,6,5,6,3,3,1,2,0
S01011139,Bad health,14,0,0,0,2,9,1,1,1,0,0,0,0,0
S01011139,Very bad health,1,0,0,0,1,0,0,0,0,0,0,0,0,0
S01011140,All people aged 16 to 74,407,11,2,9,74,48,29,43,80,79,14,8,6,29
S01011140,Very good health,198,6,0,6,44,26,10,22,39,28,7,5,2,16
S01011140,Good health,123,4,2,2,15,16,10,15,26,26,4,1,3,7
S01011140,Fair health,55,1,0,1,11,5,5,5,8,14,3,2,1,3
S01011140,Bad health,21,0,0,0,3,1,3,0,5,7,0,0,0,2
S01011140,Very bad health,10,0,0,0,1,0,1,1,2,4,0,0,0,1
S01011141,All people aged 16 to 74,414,6,3,3,81,51,19,47,94,82,15,6,9,19
S01011141,Very good health,192,2,1,1,40,25,11,23,43,35,4,2,2,9
S01011141,Good health,138,3,2,1,22,13,6,14,36,30,6,2,4,8
S01011141,Fair health,56,0,0,0,10,8,0,10,10,11,5,2,3,2
S01011141,Bad health,23,1,0,1,7,5,2,0,4,4,0,0,0,0
S01011141,Very bad health,5,0,0,0,2,0,0,0,1,2,0,0,0,0
S01011142,All people aged 16 to 74,870,51,16,35,204,74,64,57,80,45,14,6,8,281
S01011142,Very good health,536,37,13,24,121,38,34,29,41,16,6,2,4,214
S01011142,Good health,259,12,3,9,66,30,24,20,29,16,3,1,2,59
S01011142,Fair health,57,1,0,1,11,4,5,6,8,9,5,3,2,8
S01011142,Bad health,11,1,0,1,5,0,1,1,2,1,0,0,0,0
S01011142,Very bad health,7,0,0,0,1,2,0,1,0,3,0,0,0,0
S01011143,All people aged 16 to 74,694,50,19,31,169,82,60,69,137,66,13,8,5,48
S01011143,Very good health,340,26,7,19,92,35,18,37,63,24,5,3,2,40
S01011143,Good health,258,16,7,9,61,35,27,27,53,29,5,2,3,5
S01011143,Fair health,75,7,5,2,12,10,11,5,15,10,2,2,0,3
S01011143,Bad health,16,1,0,1,4,1,3,0,5,2,0,0,0,0
S01011143,Very bad health,5,0,0,0,0,1,1,0,1,1,1,1,0,0
S01011144,All people aged 16 to 74,534,41,16,25,131,80,48,51,85,57,7,6,1,34
S01011144,Very good health,287,27,9,18,80,45,15,24,41,24,3,2,1,28
S01011144,Good health,167,11,6,5,39,21,24,18,27,19,2,2,0,6
S01011144,Fair health,54,3,1,2,7,8,6,6,13,10,1,1,0,0
S01011144,Bad health,20,0,0,0,4,4,2,3,4,3,0,0,0,0
S01011144,Very bad health,6,0,0,0,1,2,1,0,0,1,1,1,0,0
S01011145,All people aged 16 to 74,482,54,19,35,150,47,35,43,78,48,11,7,4,16
S01011145,Very good health,266,35,11,24,93,25,17,25,32,24,2,0,2,13
S01011145,Good health,152,15,6,9,45,13,12,10,35,15,5,3,2,2
S01011145,Fair health,51,2,1,1,11,8,5,7,7,7,3,3,0,1
S01011145,Bad health,11,1,1,0,1,1,1,1,3,2,1,1,0,0
S01011145,Very bad health,2,1,0,1,0,0,0,0,1,0,0,0,0,0
S01011146,All people aged 16 to 74,553,31,9,22,118,68,43,50,114,77,20,9,11,32
S01011146,Very good health,269,19,6,13,65,33,16,23,45,41,4,1,3,23
S01011146,Good health,167,10,2,8,36,25,9,14,39,19,9,3,6,6
S01011146,Fair health,89,2,1,1,13,7,15,9,23,12,6,5,1,2
S01011146,Bad health,24,0,0,0,3,3,2,3,7,4,1,0,1,1
S01011146,Very bad health,4,0,0,0,1,0,1,1,0,1,0,0,0,0
S01011147,All people aged 16 to 74,770,45,14,31,183,96,58,86,159,96,17,9,8,30
S01011147,Very good health,372,27,8,19,99,50,29,38,66,39,2,1,1,22
S01011147,Good health,255,11,4,7,60,31,12,33,62,34,6,3,3,6
S01011147,Fair health,108,4,1,3,15,9,16,12,25,19,6,2,4,2
S01011147,Bad health,28,3,1,2,8,5,1,0,6,2,3,3,0,0
S01011147,Very bad health,7,0,0,0,1,1,0,3,0,2,0,0,0,0
S01011148,All people aged 16 to 74,607,74,20,54,140,47,95,62,75,72,20,15,5,22
S01011148,Very good health,326,40,10,30,86,20,53,29,45,28,7,5,2,18
S01011148,Good health,200,29,8,21,39,23,30,20,21,25,9,6,3,4
S01011148,Fair health,61,4,2,2,12,1,11,11,7,12,3,3,0,0
S01011148,Bad health,12,1,0,1,3,0,1,1,1,5,0,0,0,0
S01011148,Very bad health,8,0,0,0,0,3,0,1,1,2,1,1,0,0
S01011149,All people aged 16 to 74,690,71,31,40,216,186,68,35,35,35,13,7,6,31
S01011149,Very good health,420,40,21,19,136,128,34,21,18,15,4,1,3,24
S01011149,Good health,213,22,9,13,63,49,25,12,12,16,7,4,3,7
S01011149,Fair health,46,7,1,6,14,9,7,2,3,3,1,1,0,0
S01011149,Bad health,10,2,0,2,3,0,2,0,1,1,1,1,0,0
S01011149,Very bad health,1,0,0,0,0,0,0,0,1,0,0,0,0,0
S01011150,All people aged 16 to 74,318,35,22,13,107,31,11,36,43,34,11,4,7,10
S01011150,Very good health,211,29,19,10,66,25,8,24,25,20,5,2,3,9
S01011150,Good health,83,5,3,2,33,5,2,8,14,11,4,1,3,1
S01011150,Fair health,20,0,0,0,7,0,0,4,4,3,2,1,1,0
S01011150,Bad health,3,0,0,0,1,1,1,0,0,0,0,0,0,0
S01011150,Very bad health,1,1,0,1,0,0,0,0,0,0,0,0,0,0
S01011151,All people aged 16 to 74,412,24,12,12,134,68,22,19,56,44,19,4,15,26
S01011151,Very good health,241,14,9,5,100,42,11,9,23,23,5,1,4,14
S01011151,Good health,129,8,2,6,26,23,8,7,24,15,7,2,5,11
S01011151,Fair health,31,2,1,1,7,3,1,2,6,4,6,1,5,0
S01011151,Bad health,9,0,0,0,1,0,2,1,1,2,1,0,1,1
S01011151,Very bad health,2,0,0,0,0,0,0,0,2,0,0,0,0,0
S01011152,All people aged 16 to 74,509,67,18,49,147,62,63,44,60,34,14,10,4,18
S01011152,Very good health,265,40,10,30,77,31,29,23,27,18,5,5,0,15
S01011152,Good health,175,21,6,15,55,21,27,12,19,9,8,5,3,3
S01011152,Fair health,47,5,2,3,11,9,4,4,8,5,1,0,1,0
S01011152,Bad health,19,1,0,1,4,1,3,3,5,2,0,0,0,0
S01011152,Very bad health,3,0,0,0,0,0,0,2,1,0,0,0,0,0
S01011153,All people aged 16 to 74,642,40,8,32,148,68,66,67,117,76,30,18,12,30
S01011153,Very good health,307,21,4,17,81,29,33,23,60,24,10,6,4,26
S01011153,Good health,215,16,4,12,47,27,17,22,34,34,15,8,7,3
S01011153,Fair health,83,2,0,2,14,7,13,12,18,14,2,1,1,1
S01011153,Bad health,25,1,0,1,5,3,1,8,3,3,1,1,0,0
S01011153,Very bad health,12,0,0,0,1,2,2,2,2,1,2,2,0,0
S01011154,All people aged 16 to 74,418,17,6,11,75,48,38,32,89,79,24,12,12,16
S01011154,Very good health,169,7,3,4,32,22,17,6,37,30,4,3,1,14
S01011154,Good health,144,6,2,4,27,18,11,18,33,20,10,4,6,1
S01011154,Fair health,80,4,1,3,9,6,6,6,14,28,6,1,5,1
S01011154,Bad health,18,0,0,0,5,1,3,2,3,1,3,3,0,0
S01011154,Very bad health,7,0,0,0,2,1,1,0,2,0,1,1,0,0
S01011155,All people aged 16 to 74,457,32,5,27,93,51,45,39,89,53,37,15,22,18
S01011155,Very good health,203,18,3,15,50,26,23,16,29,18,10,4,6,13
S01011155,Good health,169,11,1,10,33,19,18,17,34,23,11,4,7,3
S01011155,Fair health,66,2,1,1,7,3,4,5,20,11,12,6,6,2
S01011155,Bad health,17,1,0,1,2,3,0,1,5,1,4,1,3,0
S01011155,Very bad health,2,0,0,0,1,0,0,0,1,0,0,0,0,0
S01011156,All people aged 16 to 74,451,21,1,20,116,67,37,51,75,48,7,6,1,29
S01011156,Very good health,244,12,1,11,69,31,24,24,35,22,3,2,1,24
S01011156,Good health,168,7,0,7,41,31,9,22,33,17,4,4,0,4
S01011156,Fair health,34,2,0,2,6,5,3,4,4,9,0,0,0,1
S01011156,Bad health,3,0,0,0,0,0,0,1,2,0,0,0,0,0
S01011156,Very bad health,2,0,0,0,0,0,1,0,1,0,0,0,0,0
S01011157,All people aged 16 to 74,461,23,5,18,130,76,35,64,77,35,7,3,4,14
S01011157,Very good health,240,11,5,6,71,44,22,29,33,13,5,2,3,12
S01011157,Good health,174,9,0,9,45,28,12,31,33,13,2,1,1,1
S01011157,Fair health,36,3,0,3,13,3,1,3,7,5,0,0,0,1
S01011157,Bad health,8,0,0,0,1,0,0,0,4,3,0,0,0,0
S01011157,Very bad health,3,0,0,0,0,1,0,1,0,1,0,0,0,0
S01011158,All people aged 16 to 74,374,64,17,47,109,48,34,25,54,26,6,6,0,8
S01011158,Very good health,206,48,12,36,56,26,16,12,29,13,3,3,0,3
S01011158,Good health,111,13,4,9,34,16,10,9,17,8,2,2,0,2
S01011158,Fair health,41,3,1,2,14,4,4,2,5,5,1,1,0,3
S01011158,Bad health,10,0,0,0,4,2,2,1,1,0,0,0,0,0
S01011158,Very bad health,6,0,0,0,1,0,2,1,2,0,0,0,0,0
S01011159,All people aged 16 to 74,389,14,5,9,62,61,16,47,82,85,13,6,7,9
S01011159,Very good health,165,9,5,4,29,29,6,17,33,32,3,1,2,7
S01011159,Good health,130,4,0,4,20,26,5,17,28,24,4,1,3,2
S01011159,Fair health,58,1,0,1,7,3,3,8,14,19,3,2,1,0
S01011159,Bad health,22,0,0,0,2,2,0,3,3,9,3,2,1,0
S01011159,Very bad health,14,0,0,0,4,1,2,2,4,1,0,0,0,0
S01011160,All people aged 16 to 74,680,31,8,23,122,108,40,64,160,88,32,17,15,35
S01011160,Very good health,335,18,4,14,64,62,13,36,66,39,13,4,9,24
S01011160,Good health,251,11,4,7,38,32,20,26,71,30,12,9,3,11
S01011160,Fair health,79,2,0,2,18,12,6,2,17,17,5,2,3,0
S01011160,Bad health,12,0,0,0,2,2,1,0,5,1,1,1,0,0
S01011160,Very bad health,3,0,0,0,0,0,0,0,1,1,1,1,0,0
S01011161,All people aged 16 to 74,469,10,2,8,62,45,30,57,123,98,21,9,12,23
S01011161,Very good health,220,6,1,5,30,19,16,18,58,49,5,3,2,19
S01011161,Good health,183,3,1,2,24,16,13,26,53,34,10,3,7,4
S01011161,Fair health,46,0,0,0,6,9,0,8,8,10,5,2,3,0
S01011161,Bad health,16,0,0,0,2,1,1,5,2,4,1,1,0,0
S01011161,Very bad health,4,1,0,1,0,0,0,0,2,1,0,0,0,0
S01011162,All people aged 16 to 74,343,13,3,10,65,48,16,39,69,50,17,6,11,26
S01011162,Very good health,193,7,2,5,35,30,8,21,38,27,6,3,3,21
S01011162,Good health,112,5,1,4,25,12,6,15,22,16,8,2,6,3
S01011162,Fair health,26,1,0,1,3,3,1,3,8,4,2,1,1,1
S01011162,Bad health,8,0,0,0,2,1,1,0,1,1,1,0,1,1
S01011162,Very bad health,4,0,0,0,0,2,0,0,0,2,0,0,0,0
S01011163,All people aged 16 to 74,619,8,6,2,73,72,29,85,159,124,30,17,13,39
S01011163,Very good health,265,2,2,0,36,32,13,28,59,55,12,6,6,28
S01011163,Good health,259,3,2,1,27,32,10,42,70,52,13,8,5,10
S01011163,Fair health,68,1,0,1,9,7,4,11,21,11,3,1,2,1
S01011163,Bad health,18,1,1,0,0,0,1,3,9,4,0,0,0,0
S01011163,Very bad health,9,1,1,0,1,1,1,1,0,2,2,2,0,0
S01011164,All people aged 16 to 74,515,26,6,20,140,73,33,46,97,50,14,4,10,36
S01011164,Very good health,319,16,3,13,92,45,22,23,54,29,6,2,4,32
S01011164,Good health,136,8,2,6,34,16,6,19,30,15,4,0,4,4
S01011164,Fair health,39,2,1,1,9,8,5,2,8,2,3,1,2,0
S01011164,Bad health,12,0,0,0,3,3,0,1,2,2,1,1,0,0
S01011164,Very bad health,9,0,0,0,2,1,0,1,3,2,0,0,0,0
S01011165,All people aged 16 to 74,541,12,1,11,86,59,43,58,120,100,32,17,15,31
S01011165,Very good health,203,2,0,2,36,24,13,18,41,37,9,5,4,23
S01011165,Good health,233,8,1,7,31,25,18,29,57,43,16,6,10,6
S01011165,Fair health,74,0,0,0,15,5,8,8,18,15,3,3,0,2
S01011165,Bad health,24,1,0,1,4,4,4,3,3,3,2,2,0,0
S01011165,Very bad health,7,1,0,1,0,1,0,0,1,2,2,1,1,0
S01011166,All people aged 16 to 74,373,41,8,33,83,64,32,32,56,28,10,7,3,27
S01011166,Very good health,196,24,7,17,45,38,13,17,25,11,3,1,2,20
S01011166,Good health,128,15,1,14,29,17,15,10,21,12,2,2,0,7
S01011166,Fair health,33,2,0,2,7,6,3,4,5,4,2,2,0,0
S01011166,Bad health,12,0,0,0,1,2,1,1,3,1,3,2,1,0
S01011166,Very bad health,4,0,0,0,1,1,0,0,2,0,0,0,0,0
S01011167,All people aged 16 to 74,566,86,24,62,160,72,77,39,61,33,12,10,2,26
S01011167,Very good health,321,53,13,40,96,52,40,16,29,14,4,3,1,17
S01011167,Good health,191,29,10,19,54,20,25,17,25,11,4,4,0,6
S01011167,Fair health,36,3,0,3,7,0,10,2,6,3,3,2,1,2
S01011167,Bad health,11,0,0,0,2,0,1,3,1,3,1,1,0,0
S01011167,Very bad health,7,1,1,0,1,0,1,1,0,2,0,0,0,1
S01011168,All people aged 16 to 74,656,56,20,36,142,68,125,65,89,60,14,8,6,37
S01011168,Very good health,349,30,13,17,79,32,55,40,40,34,10,6,4,29
S01011168,Good health,231,21,5,16,50,27,55,18,34,16,2,1,1,8
S01011168,Fair health,55,4,1,3,12,5,13,3,12,4,2,1,1,0
S01011168,Bad health,17,0,0,0,1,3,2,4,2,5,0,0,0,0
S01011168,Very bad health,4,1,1,0,0,1,0,0,1,1,0,0,0,0
S01011169,All people aged 16 to 74,682,53,19,34,206,95,47,62,100,55,16,8,8,48
S01011169,Very good health,408,33,15,18,134,49,22,30,58,32,5,3,2,45
S01011169,Good health,212,16,4,12,61,38,18,24,31,14,7,3,4,3
S01011169,Fair health,51,4,0,4,8,6,7,6,9,7,4,2,2,0
S01011169,Bad health,7,0,0,0,2,2,0,2,1,0,0,0,0,0
S01011169,Very bad health,4,0,0,0,1,0,0,0,1,2,0,0,0,0
S01011170,All people aged 16 to 74,692,72,24,48,194,79,79,62,92,57,22,13,9,35
S01011170,Very good health,383,48,14,34,118,42,40,28,45,25,10,7,3,27
S01011170,Good health,202,17,5,12,54,25,24,22,30,18,6,1,5,6
S01011170,Fair health,78,7,5,2,18,11,11,7,14,6,2,1,1,2
S01011170,Bad health,19,0,0,0,3,1,4,2,3,5,1,1,0,0
S01011170,Very bad health,10,0,0,0,1,0,0,3,0,3,3,3,0,0
S01011171,All people aged 16 to 74,677,52,12,40,169,61,133,57,105,65,14,6,8,21
S01011171,Very good health,368,30,6,24,95,29,68,31,56,34,9,3,6,16
S01011171,Good health,229,12,4,8,53,25,51,22,34,24,4,2,2,4
S01011171,Fair health,60,5,2,3,17,6,11,3,12,5,0,0,0,1
S01011171,Bad health,17,4,0,4,4,1,3,1,2,1,1,1,0,0
S01011171,Very bad health,3,1,0,1,0,0,0,0,1,1,0,0,0,0
S01011172,All people aged 16 to 74,570,39,8,31,128,46,124,62,82,57,14,6,8,18
S01011172,Very good health,268,15,3,12,66,16,56,26,44,27,3,1,2,15
S01011172,Good health,215,16,2,14,47,20,50,27,25,19,9,4,5,2
S01011172,Fair health,68,4,2,2,14,8,13,7,11,8,2,1,1,1
S01011172,Bad health,18,3,1,2,1,2,5,2,2,3,0,0,0,0
S01011172,Very bad health,1,1,0,1,0,0,0,0,0,0,0,0,0,0
S01011173,All people aged 16 to 74,407,47,9,38,86,41,86,30,57,26,8,4,4,26
S01011173,Very good health,223,23,5,18,47,25,39,16,34,15,1,0,1,23
S01011173,Good health,125,15,2,13,26,11,33,13,13,8,4,1,3,2
S01011173,Fair health,43,9,2,7,8,5,10,1,6,1,2,2,0,1
S01011173,Bad health,10,0,0,0,2,0,3,0,3,1,1,1,0,0
S01011173,Very bad health,6,0,0,0,3,0,1,0,1,1,0,0,0,0
S01011174,All people aged 16 to 74,319,31,7,24,63,34,73,30,44,28,6,5,1,10
S01011174,Very good health,160,14,5,9,31,21,35,14,20,15,3,3,0,7
S01011174,Good health,105,9,2,7,22,10,22,9,19,10,2,1,1,2
S01011174,Fair health,34,4,0,4,6,1,12,5,2,3,0,0,0,1
S01011174,Bad health,17,3,0,3,3,2,4,2,2,0,1,1,0,0
S01011174,Very bad health,3,1,0,1,1,0,0,0,1,0,0,0,0,0
S01011175,All people aged 16 to 74,366,22,2,20,54,42,44,46,65,61,16,9,7,16
S01011175,Very good health,161,11,1,10,18,24,17,24,29,14,11,6,5,13
S01011175,Good health,119,7,1,6,23,9,15,14,18,28,2,0,2,3
S01011175,Fair health,64,3,0,3,10,6,8,6,13,15,3,3,0,0
S01011175,Bad health,17,1,0,1,3,1,3,2,4,3,0,0,0,0
S01011175,Very bad health,5,0,0,0,0,2,1,0,1,1,0,0,0,0
S01011176,All people aged 16 to 74,401,34,10,24,106,35,76,34,35,48,9,5,4,24
S01011176,Very good health,195,20,5,15,50,17,42,13,14,16,0,0,0,23
S01011176,Good health,144,11,4,7,42,14,26,14,10,23,4,1,3,0
S01011176,Fair health,52,3,1,2,13,4,6,6,10,7,2,1,1,1
S01011176,Bad health,8,0,0,0,1,0,2,0,0,2,3,3,0,0
S01011176,Very bad health,2,0,0,0,0,0,0,1,1,0,0,0,0,0
S01011177,All people aged 16 to 74,628,40,11,29,130,60,110,64,109,78,14,9,5,23
S01011177,Very good health,343,21,5,16,63,34,65,35,55,43,6,3,3,21
S01011177,Good health,195,14,5,9,52,16,27,21,34,24,5,4,1,2
S01011177,Fair health,66,5,1,4,13,7,12,5,14,9,1,0,1,0
S01011177,Bad health,19,0,0,0,2,2,5,2,5,2,1,1,0,0
S01011177,Very bad health,5,0,0,0,0,1,1,1,1,0,1,1,0,0
S01011178,All people aged 16 to 74,359,21,10,11,79,48,30,33,67,42,17,7,10,22
S01011178,Very good health,174,16,8,8,46,23,11,10,26,17,7,3,4,18
S01011178,Good health,121,4,2,2,22,16,12,14,27,16,6,1,5,4
S01011178,Fair health,44,1,0,1,6,7,3,6,12,6,3,2,1,0
S01011178,Bad health,12,0,0,0,3,1,2,1,1,3,1,1,0,0
S01011178,Very bad health,8,0,0,0,2,1,2,2,1,0,0,0,0,0
S01011179,All people aged 16 to 74,476,13,3,10,50,54,31,57,82,124,31,21,10,34
S01011179,Very good health,196,6,0,6,23,23,11,25,29,41,10,6,4,28
S01011179,Good health,161,6,2,4,16,19,12,21,30,42,10,6,4,5
S01011179,Fair health,70,1,1,0,6,8,7,2,14,25,6,4,2,1
S01011179,Bad health,31,0,0,0,5,2,1,4,5,12,2,2,0,0
S01011179,Very bad health,18,0,0,0,0,2,0,5,4,4,3,3,0,0
S01011180,All people aged 16 to 74,502,10,2,8,52,34,20,50,104,144,56,35,21,32
S01011180,Very good health,191,5,1,4,22,14,9,19,38,38,26,18,8,20
S01011180,Good health,173,5,1,4,22,14,8,11,39,47,17,8,9,10
S01011180,Fair health,80,0,0,0,2,4,1,13,15,35,8,5,3,2
S01011180,Bad health,48,0,0,0,6,2,1,6,9,19,5,4,1,0
S01011180,Very bad health,10,0,0,0,0,0,1,1,3,5,0,0,0,0
S01011181,All people aged 16 to 74,382,31,10,21,88,50,84,19,42,44,7,5,2,17
S01011181,Very good health,171,14,5,9,45,22,40,4,14,16,1,1,0,15
S01011181,Good health,146,12,2,10,31,18,33,13,17,17,3,1,2,2
S01011181,Fair health,43,5,3,2,7,7,9,2,5,5,3,3,0,0
S01011181,Bad health,18,0,0,0,4,3,2,0,4,5,0,0,0,0
S01011181,Very bad health,4,0,0,0,1,0,0,0,2,1,0,0,0,0
S01011182,All people aged 16 to 74,330,25,5,20,77,36,49,31,52,30,14,11,3,16
S01011182,Very good health,141,8,3,5,35,17,20,16,16,12,5,4,1,12
S01011182,Good health,126,14,1,13,30,15,24,7,19,10,3,1,2,4
S01011182,Fair health,45,3,1,2,10,4,4,3,12,6,3,3,0,0
S01011182,Bad health,18,0,0,0,2,0,1,5,5,2,3,3,0,0
S01011182,Very bad health,0,0,0,0,0,0,0,0,0,0,0,0,0,0
S01011183,All people aged 16 to 74,430,29,9,20,83,46,46,48,64,44,38,20,18,32
S01011183,Very good health,201,17,3,14,42,30,19,22,27,18,9,5,4,17
S01011183,Good health,159,8,5,3,34,11,20,20,28,15,9,4,5,14
S01011183,Fair health,50,4,1,3,5,2,5,5,6,8,14,6,8,1
S01011183,Bad health,10,0,0,0,1,1,2,1,0,2,3,2,1,0
S01011183,Very bad health,10,0,0,0,1,2,0,0,3,1,3,3,0,0
S01011184,All people aged 16 to 74,605,62,15,47,188,94,47,59,67,27,16,9,7,45
S01011184,Very good health,361,37,8,29,113,55,19,37,40,17,5,3,2,38
S01011184,Good health,186,18,5,13,64,31,17,19,17,7,6,3,3,7
S01011184,Fair health,44,7,2,5,7,7,11,3,4,2,3,1,2,0
S01011184,Bad health,12,0,0,0,4,1,0,0,5,1,1,1,0,0
S01011184,Very bad health,2,0,0,0,0,0,0,0,1,0,1,1,0,0
S01011185,All people aged 16 to 74,518,34,8,26,120,82,28,60,82,61,21,15,6,30
S01011185,Very good health,250,17,2,15,58,43,9,29,34,31,6,4,2,23
S01011185,Good health,189,14,5,9,47,28,15,16,34,21,9,6,3,5
S01011185,Fair health,63,3,1,2,14,9,3,9,13,6,5,4,1,1
S01011185,Bad health,14,0,0,0,1,2,1,6,0,2,1,1,0,1
S01011185,Very bad health,2,0,0,0,0,0,0,0,1,1,0,0,0,0
S01011186,All people aged 16 to 74,686,45,11,34,123,101,39,65,120,114,36,24,12,43
S01011186,Very good health,295,22,5,17,59,52,16,25,42,33,11,7,4,35
S01011186,Good health,244,19,4,15,48,33,16,26,50,35,12,7,5,5
S01011186,Fair health,94,4,2,2,10,12,4,11,15,30,5,4,1,3
S01011186,Bad health,35,0,0,0,3,4,3,2,7,9,7,5,2,0
S01011186,Very bad health,18,0,0,0,3,0,0,1,6,7,1,1,0,0
S01011187,All people aged 16 to 74,573,40,13,27,147,97,26,77,86,45,11,2,9,44
S01011187,Very good health,305,26,7,19,83,51,15,34,42,18,2,1,1,34
S01011187,Good health,186,14,6,8,45,31,7,26,30,17,8,1,7,8
S01011187,Fair health,65,0,0,0,16,13,2,15,12,4,1,0,1,2
S01011187,Bad health,11,0,0,0,2,1,1,2,0,5,0,0,0,0
S01011187,Very bad health,6,0,0,0,1,1,1,0,2,1,0,0,0,0
S01011188,All people aged 16 to 74,714,28,7,21,107,101,42,80,152,113,39,15,24,52
S01011188,Very good health,317,9,0,9,56,45,20,32,61,39,13,5,8,42
S01011188,Good health,260,10,5,5,36,43,15,34,58,41,16,4,12,7
S01011188,Fair health,96,6,2,4,13,9,3,10,24,22,7,3,4,2
S01011188,Bad health,34,3,0,3,2,4,3,4,7,7,3,3,0,1
S01011188,Very bad health,7,0,0,0,0,0,1,0,2,4,0,0,0,0
S01011189,All people aged 16 to 74,616,36,9,27,123,100,51,79,89,70,29,11,18,39
S01011189,Very good health,307,27,6,21,64,49,21,30,44,29,14,5,9,29
S01011189,Good health,197,6,2,4,40,35,22,32,28,19,6,1,5,9
S01011189,Fair health,76,2,1,1,11,13,4,12,11,16,6,3,3,1
S01011189,Bad health,29,1,0,1,7,2,2,4,5,5,3,2,1,0
S01011189,Very bad health,7,0,0,0,1,1,2,1,1,1,0,0,0,0
S01011190,All people aged 16 to 74,466,6,2,4,67,66,44,44,96,83,28,18,10,32
S01011190,Very good health,191,3,1,2,27,28,21,17,35,23,11,10,1,26
S01011190,Good health,167,3,1,2,35,27,15,16,32,25,9,2,7,5
S01011190,Fair health,67,0,0,0,2,7,4,6,24,19,4,2,2,1
S01011190,Bad health,30,0,0,0,2,4,3,4,4,11,2,2,0,0
S01011190,Very bad health,11,0,0,0,1,0,1,1,1,5,2,2,0,0
S01011191,All people aged 16 to 74,398,17,6,11,58,45,20,49,79,92,23,12,11,15
S01011191,Very good health,166,9,3,6,26,23,9,19,25,33,11,4,7,11
S01011191,Good health,149,4,2,2,25,18,7,16,37,34,5,3,2,3
S01011191,Fair health,56,3,1,2,6,2,2,10,14,14,4,2,2,1
S01011191,Bad health,22,1,0,1,1,2,2,4,2,8,2,2,0,0
S01011191,Very bad health,5,0,0,0,0,0,0,0,1,3,1,1,0,0
S01011192,All people aged 16 to 74,537,11,2,9,85,64,17,58,121,101,37,15,22,43
S01011192,Very good health,234,5,1,4,37,27,8,28,38,51,10,1,9,30
S01011192,Good health,210,5,1,4,37,24,7,17,58,32,19,7,12,11
S01011192,Fair health,62,1,0,1,7,8,1,12,17,11,3,2,1,2
S01011192,Bad health,27,0,0,0,3,4,1,0,8,6,5,5,0,0
S01011192,Very bad health,4,0,0,0,1,1,0,1,0,1,0,0,0,0
S01011193,All people aged 16 to 74,531,16,5,11,64,56,23,49,117,114,44,30,14,48
S01011193,Very good health,214,4,0,4,38,34,5,17,37,39,14,9,5,26
S01011193,Good health,185,7,3,4,15,13,9,18,48,39,15,7,8,21
S01011193,Fair health,81,3,2,1,8,6,6,8,18,21,10,9,1,1
S01011193,Bad health,44,2,0,2,2,3,3,5,13,13,3,3,0,0
S01011193,Very bad health,7,0,0,0,1,0,0,1,1,2,2,2,0,0
S01011194,All people aged 16 to 74,533,15,4,11,63,51,27,54,107,103,51,21,30,62
S01011194,Very good health,228,5,1,4,31,22,10,17,34,45,19,8,11,45
S01011194,Good health,177,7,2,5,20,15,11,19,43,36,16,3,13,10
S01011194,Fair health,93,3,1,2,10,9,5,8,19,20,13,8,5,6
S01011194,Bad health,27,0,0,0,0,4,1,8,10,1,2,1,1,1
S01011194,Very bad health,8,0,0,0,2,1,0,2,1,1,1,1,0,0
S01011195,All people aged 16 to 74,570,12,3,9,75,74,17,70,136,97,44,17,27,45
S01011195,Very good health,248,4,0,4,37,29,5,23,55,42,21,6,15,32
S01011195,Good health,210,8,3,5,26,37,9,28,50,29,12,3,9,11
S01011195,Fair health,79,0,0,0,8,7,3,15,18,15,11,8,3,2
S01011195,Bad health,21,0,0,0,2,1,0,2,10,6,0,0,0,0
S01011195,Very bad health,12,0,0,0,2,0,0,2,3,5,0,0,0,0
S01011196,All people aged 16 to 74,657,16,4,12,88,72,33,62,141,142,56,28,28,47
S01011196,Very good health,248,9,0,9,36,32,14,23,48,41,12,8,4,33
S01011196,Good health,242,4,2,2,34,31,10,26,51,48,27,14,13,11
S01011196,Fair health,111,2,2,0,14,7,8,10,28,28,11,5,6,3
S01011196,Bad health,41,1,0,1,3,1,1,3,11,15,6,1,5,0
S01011196,Very bad health,15,0,0,0,1,1,0,0,3,10,0,0,0,0
S01011197,All people aged 16 to 74,630,17,4,13,71,70,40,54,138,124,54,33,21,62
S01011197,Very good health,262,8,1,7,35,33,19,20,50,42,13,7,6,42
S01011197,Good health,181,6,2,4,19,21,13,19,47,32,12,5,7,12
S01011197,Fair health,116,1,0,1,14,11,4,5,30,27,18,10,8,6
S01011197,Bad health,55,2,1,1,2,5,3,8,7,18,8,8,0,2
S01011197,Very bad health,16,0,0,0,1,0,1,2,4,5,3,3,0,0
S01011198,All people aged 16 to 74,463,13,2,11,61,49,34,54,90,90,33,19,14,39
S01011198,Very good health,195,6,2,4,31,23,9,27,26,41,3,1,2,29
S01011198,Good health,166,6,0,6,21,15,16,19,44,19,18,12,6,8
S01011198,Fair health,59,1,0,1,6,6,5,5,11,12,11,5,6,2
S01011198,Bad health,31,0,0,0,1,4,3,3,5,14,1,1,0,0
S01011198,Very bad health,12,0,0,0,2,1,1,0,4,4,0,0,0,0
S01011199,All people aged 16 to 74,595,18,3,15,98,84,41,50,130,90,34,17,17,50
S01011199,Very good health,278,7,0,7,46,42,19,22,64,26,11,5,6,41
S01011199,Good health,193,7,2,5,37,31,16,16,37,32,9,3,6,8
S01011199,Fair health,84,3,1,2,10,6,4,10,19,20,11,6,5,1
S01011199,Bad health,29,1,0,1,3,5,2,2,7,7,2,2,0,0
S01011199,Very bad health,11,0,0,0,2,0,0,0,3,5,1,1,0,0
S01011200,All people aged 16 to 74,582,31,9,22,101,83,32,58,108,96,31,17,14,42
S01011200,Very good health,246,13,2,11,52,40,13,24,47,18,12,5,7,27
S01011200,Good health,207,11,5,6,35,29,15,21,33,38,10,5,5,15
S01011200,Fair health,75,4,1,3,10,10,4,7,15,18,7,5,2,0
S01011200,Bad health,45,3,1,2,4,3,0,6,12,15,2,2,0,0
S01011200,Very bad health,9,0,0,0,0,1,0,0,1,7,0,0,0,0
S01011201,All people aged 16 to 74,472,19,3,16,84,72,27,60,90,62,20,15,5,38
S01011201,Very good health,218,10,3,7,43,33,11,22,36,23,8,5,3,32
S01011201,Good health,162,5,0,5,20,30,10,25,34,30,3,2,1,5
S01011201,Fair health,59,4,0,4,14,7,4,5,12,6,6,5,1,1
S01011201,Bad health,24,0,0,0,4,2,2,3,7,3,3,3,0,0
S01011201,Very bad health,9,0,0,0,3,0,0,5,1,0,0,0,0,0
S01011202,All people aged 16 to 74,630,19,7,12,100,82,38,95,111,114,32,18,14,39
S01011202,Very good health,257,11,4,7,43,46,10,44,36,35,10,7,3,22
S01011202,Good health,215,5,2,3,42,26,18,29,41,32,10,3,7,12
S01011202,Fair health,101,3,1,2,9,8,6,12,22,28,8,6,2,5
S01011202,Bad health,48,0,0,0,6,1,3,8,9,17,4,2,2,0
S01011202,Very bad health,9,0,0,0,0,1,1,2,3,2,0,0,0,0
S01011203,All people aged 16 to 74,596,33,6,27,106,83,31,67,130,69,25,13,12,52
S01011203,Very good health,284,16,2,14,62,46,18,23,52,20,9,6,3,38
S01011203,Good health,211,14,3,11,34,27,9,27,47,31,9,5,4,13
S01011203,Fair health,67,3,1,2,5,7,3,9,20,14,5,1,4,1
S01011203,Bad health,27,0,0,0,2,3,1,4,11,4,2,1,1,0
S01011203,Very bad health,7,0,0,0,3,0,0,4,0,0,0,0,0,0
S01011204,All people aged 16 to 74,436,50,8,42,119,69,29,39,60,28,7,3,4,35
S01011204,Very good health,232,26,3,23,68,41,10,17,28,10,1,0,1,31
S01011204,Good health,159,21,3,18,42,21,14,14,26,13,4,2,2,4
S01011204,Fair health,31,3,2,1,5,4,5,6,4,2,2,1,1,0
S01011204,Bad health,11,0,0,0,3,3,0,2,2,1,0,0,0,0
S01011204,Very bad health,3,0,0,0,1,0,0,0,0,2,0,0,0,0
S01011205,All people aged 16 to 74,495,57,12,45,129,77,28,50,63,34,14,3,11,43
S01011205,Very good health,326,44,9,35,94,51,16,31,34,19,3,1,2,34
S01011205,Good health,133,12,3,9,27,22,10,14,23,9,7,2,5,9
S01011205,Fair health,23,1,0,1,5,3,2,2,5,3,2,0,2,0
S01011205,Bad health,10,0,0,0,2,0,0,3,1,2,2,0,2,0
S01011205,Very bad health,3,0,0,0,1,1,0,0,0,1,0,0,0,0
S01011206,All people aged 16 to 74,548,40,13,27,150,69,39,58,77,46,20,5,15,49
S01011206,Very good health,310,19,4,15,83,38,18,33,46,22,13,2,11,38
S01011206,Good health,173,18,7,11,48,23,16,19,20,16,4,2,2,9
S01011206,Fair health,42,2,1,1,10,7,3,4,7,6,2,1,1,1
S01011206,Bad health,16,1,1,0,5,0,2,2,3,1,1,0,1,1
S01011206,Very bad health,7,0,0,0,4,1,0,0,1,1,0,0,0,0
S01011207,All people aged 16 to 74,570,44,9,35,114,80,34,59,96,61,39,28,11,43
S01011207,Very good health,272,33,6,27,57,42,13,29,36,23,7,4,3,32
S01011207,Good health,171,9,2,7,28,26,11,18,35,21,15,9,6,8
S01011207,Fair health,75,0,0,0,16,7,7,8,13,8,14,12,2,2
S01011207,Bad health,40,1,0,1,10,3,2,4,9,7,3,3,0,1
S01011207,Very bad health,12,1,1,0,3,2,1,0,3,2,0,0,0,0
S01011208,All people aged 16 to 74,691,67,26,41,169,117,47,56,92,58,19,9,10,66
S01011208,Very good health,387,34,11,23,105,62,23,33,48,28,6,1,5,48
S01011208,Good health,232,25,13,12,55,42,20,18,32,19,9,4,5,12
S01011208,Fair health,54,6,2,4,7,10,3,3,6,11,2,2,0,6
S01011208,Bad health,15,2,0,2,1,2,1,2,5,0,2,2,0,0
S01011208,Very bad health,3,0,0,0,1,1,0,0,1,0,0,0,0,0
S01011209,All people aged 16 to 74,477,22,6,16,67,73,24,60,94,82,25,13,12,30
S01011209,Very good health,227,13,4,9,36,37,11,21,41,30,11,7,4,27
S01011209,Good health,145,6,1,5,18,20,7,20,35,28,8,4,4,3
S01011209,Fair health,57,1,0,1,5,8,5,10,13,12,3,1,2,0
S01011209,Bad health,33,1,0,1,5,8,0,5,2,9,3,1,2,0
S01011209,Very bad health,15,1,1,0,3,0,1,4,3,3,0,0,0,0
S01011210,All people aged 16 to 74,583,76,28,48,146,77,64,45,63,30,19,12,7,63
S01011210,Very good health,321,49,14,35,87,34,33,22,28,8,7,4,3,53
S01011210,Good health,183,22,11,11,46,23,26,14,25,11,7,4,3,9
S01011210,Fair health,46,3,2,1,7,14,3,3,6,5,4,3,1,1
S01011210,Bad health,23,2,1,1,5,3,1,5,2,4,1,1,0,0
S01011210,Very bad health,10,0,0,0,1,3,1,1,2,2,0,0,0,0
S01011211,All people aged 16 to 74,527,49,10,39,128,77,34,49,72,40,25,16,9,53
S01011211,Very good health,288,30,3,27,80,42,14,19,33,16,10,5,5,44
S01011211,Good health,165,18,7,11,38,27,14,20,21,12,9,6,3,6
S01011211,Fair health,57,1,0,1,8,8,2,7,15,12,3,2,1,1
S01011211,Bad health,11,0,0,0,2,0,3,2,2,0,2,2,0,0
S01011211,Very bad health,6,0,0,0,0,0,1,1,1,0,1,1,0,2
S01011212,All people aged 16 to 74,406,7,1,6,38,32,23,50,95,96,33,22,11,32
S01011212,Very good health,166,3,0,3,17,18,10,17,27,38,10,5,5,26
S01011212,Good health,150,3,1,2,15,10,9,21,48,28,12,7,5,4
S01011212,Fair health,63,1,0,1,5,2,3,7,16,20,8,8,0,1
S01011212,Bad health,20,0,0,0,0,2,0,3,4,8,2,1,1,1
S01011212,Very bad health,7,0,0,0,1,0,1,2,0,2,1,1,0,0
S01011213,All people aged 16 to 74,772,26,7,19,108,74,36,89,155,148,64,39,25,72
S01011213,Very good health,340,18,5,13,49,31,21,29,66,53,24,10,14,49
S01011213,Good health,265,4,1,3,37,31,13,36,55,46,26,17,9,17
S01011213,Fair health,116,3,1,2,14,8,1,16,27,33,9,7,2,5
S01011213,Bad health,42,0,0,0,5,3,1,7,7,14,4,4,0,1
S01011213,Very bad health,9,1,0,1,3,1,0,1,0,2,1,1,0,0
S01011214,All people aged 16 to 74,629,7,1,6,75,78,28,61,123,142,71,41,30,44
S01011214,Very good health,247,3,0,3,35,29,13,18,40,48,26,16,10,35
S01011214,Good health,213,3,1,2,20,34,11,29,49,44,16,9,7,7
S01011214,Fair health,118,1,0,1,13,10,2,8,27,38,19,7,12,0
S01011214,Bad health,43,0,0,0,6,4,2,4,6,9,10,9,1,2
S01011214,Very bad health,8,0,0,0,1,1,0,2,1,3,0,0,0,0
S01011215,All people aged 16 to 74,432,2,0,2,44,44,26,32,102,92,58,28,30,32
S01011215,Very good health,144,0,0,0,20,14,8,8,31,27,15,7,8,21
S01011215,Good health,144,2,0,2,19,15,8,10,34,31,18,5,13,7
S01011215,Fair health,104,0,0,0,2,12,8,9,27,21,21,13,8,4
S01011215,Bad health,33,0,0,0,2,0,2,5,8,12,4,3,1,0
S01011215,Very bad health,7,0,0,0,1,3,0,0,2,1,0,0,0,0
S01011216,All people aged 16 to 74,341,6,1,5,42,42,19,30,82,69,27,7,20,24
S01011216,Very good health,138,3,0,3,16,21,9,15,30,22,11,3,8,11
S01011216,Good health,123,1,1,0,14,14,6,8,35,28,9,1,8,8
S01011216,Fair health,56,2,0,2,7,6,2,4,13,11,6,2,4,5
S01011216,Bad health,17,0,0,0,3,1,2,2,1,7,1,1,0,0
S01011216,Very bad health,7,0,0,0,2,0,0,1,3,1,0,0,0,0
S01011217,All people aged 16 to 74,585,12,1,11,66,67,28,50,136,101,76,36,40,49
S01011217,Very good health,239,8,1,7,32,31,15,20,52,23,26,11,15,32
S01011217,Good health,212,2,0,2,25,25,8,18,54,34,31,13,18,15
S01011217,Fair health,89,2,0,2,8,6,3,7,19,28,14,8,6,2
S01011217,Bad health,36,0,0,0,1,4,2,3,7,16,3,2,1,0
S01011217,Very bad health,9,0,0,0,0,1,0,2,4,0,2,2,0,0
S01011218,All people aged 16 to 74,471,8,1,7,50,40,18,53,87,108,70,42,28,37
S01011218,Very good health,193,5,1,4,29,20,4,19,32,31,27,15,12,26
S01011218,Good health,156,1,0,1,15,13,8,18,34,35,22,10,12,10
S01011218,Fair health,73,1,0,1,5,5,4,10,10,24,13,11,2,1
S01011218,Bad health,40,0,0,0,1,2,2,6,11,13,5,3,2,0
S01011218,Very bad health,9,1,0,1,0,0,0,0,0,5,3,3,0,0
S01011219,All people aged 16 to 74,600,13,1,12,61,67,30,57,139,132,57,28,29,44
S01011219,Very good health,206,4,0,4,29,18,9,19,45,38,13,10,3,31
S01011219,Good health,220,7,1,6,21,25,18,18,53,41,24,8,16,13
S01011219,Fair health,108,1,0,1,7,16,1,7,28,34,14,6,8,0
S01011219,Bad health,45,1,0,1,3,6,2,9,11,10,3,2,1,0
S01011219,Very bad health,21,0,0,0,1,2,0,4,2,9,3,2,1,0
S01011220,All people aged 16 to 74,677,13,4,9,90,67,39,75,160,132,64,39,25,37
S01011220,Very good health,270,10,3,7,50,32,13,21,57,40,19,9,10,28
S01011220,Good health,221,2,0,2,30,22,14,32,64,37,13,7,6,7
S01011220,Fair health,128,0,0,0,8,10,9,19,26,33,22,14,8,1
S01011220,Bad health,46,1,1,0,2,2,1,2,13,17,7,7,0,1
S01011220,Very bad health,12,0,0,0,0,1,2,1,0,5,3,2,1,0
S01011221,All people aged 16 to 74,696,15,2,13,86,87,33,80,152,147,43,24,19,53
S01011221,Very good health,304,7,1,6,50,45,17,26,55,50,13,2,11,41
S01011221,Good health,243,7,1,6,24,30,11,34,54,61,12,10,2,10
S01011221,Fair health,96,0,0,0,10,6,3,15,30,18,12,6,6,2
S01011221,Bad health,41,1,0,1,2,5,1,5,9,12,6,6,0,0
S01011221,Very bad health,12,0,0,0,0,1,1,0,4,6,0,0,0,0
S01011222,All people aged 16 to 74,496,11,5,6,67,75,23,46,108,107,27,13,14,32
S01011222,Very good health,183,3,1,2,28,34,10,14,31,31,11,4,7,21
S01011222,Good health,187,7,4,3,28,26,7,13,44,45,9,3,6,8
S01011222,Fair health,94,0,0,0,8,14,4,14,25,21,5,4,1,3
S01011222,Bad health,24,1,0,1,2,1,2,3,5,9,1,1,0,0
S01011222,Very bad health,8,0,0,0,1,0,0,2,3,1,1,1,0,0
S01011223,All people aged 16 to 74,570,25,3,22,100,101,39,52,96,90,25,11,14,42
S01011223,Very good health,255,14,2,12,53,46,16,20,45,22,6,1,5,33
S01011223,Good health,203,9,1,8,36,41,13,22,31,36,9,3,6,6
S01011223,Fair health,79,1,0,1,9,9,7,8,16,21,5,4,1,3
S01011223,Bad health,28,1,0,1,2,5,1,2,2,10,5,3,2,0
S01011223,Very bad health,5,0,0,0,0,0,2,0,2,1,0,0,0,0
S01011224,All people aged 16 to 74,506,16,5,11,65,49,41,54,104,97,37,25,12,43
S01011224,Very good health,199,9,3,6,27,28,13,21,33,26,9,6,3,33
S01011224,Good health,149,3,0,3,27,11,13,13,35,30,10,5,5,7
S01011224,Fair health,98,3,1,2,9,6,11,14,20,23,10,7,3,2
S01011224,Bad health,45,1,1,0,1,3,3,4,11,15,6,5,1,1
S01011224,Very bad health,15,0,0,0,1,1,1,2,5,3,2,2,0,0
S01011225,All people aged 16 to 74,513,22,7,15,71,55,22,40,107,102,55,33,22,39
S01011225,Very good health,164,7,3,4,36,20,5,13,27,22,9,4,5,25
S01011225,Good health,197,10,3,7,22,20,9,16,49,35,24,13,11,12
S01011225,Fair health,105,4,1,3,9,9,5,3,21,34,18,12,6,2
S01011225,Bad health,41,1,0,1,2,6,3,7,9,9,4,4,0,0
S01011225,Very bad health,6,0,0,0,2,0,0,1,1,2,0,0,0,0
S01011226,All people aged 16 to 74,703,65,15,50,153,100,60,91,105,56,32,19,13,41
S01011226,Very good health,359,35,4,31,95,52,24,38,51,16,13,3,10,35
S01011226,Good health,234,24,10,14,44,35,28,35,32,21,10,8,2,5
S01011226,Fair health,71,4,1,3,8,11,7,11,13,9,7,6,1,1
S01011226,Bad health,30,2,0,2,6,1,1,4,7,7,2,2,0,0
S01011226,Very bad health,9,0,0,0,0,1,0,3,2,3,0,0,0,0
S01011227,All people aged 16 to 74,545,33,6,27,130,60,38,50,87,79,36,21,15,32
S01011227,Very good health,261,19,1,18,64,30,18,26,32,31,14,10,4,27
S01011227,Good health,167,14,5,9,45,18,12,9,33,19,12,6,6,5
S01011227,Fair health,67,0,0,0,13,6,6,7,12,18,5,1,4,0
S01011227,Bad health,41,0,0,0,6,5,2,8,7,8,5,4,1,0
S01011227,Very bad health,9,0,0,0,2,1,0,0,3,3,0,0,0,0
S01011228,All people aged 16 to 74,595,22,7,15,105,85,32,63,115,97,38,23,15,38
S01011228,Very good health,257,7,2,5,62,47,12,26,37,29,12,6,6,25
S01011228,Good health,207,6,3,3,33,24,12,21,48,40,11,4,7,12
S01011228,Fair health,89,7,1,6,6,9,4,12,21,18,11,9,2,1
S01011228,Bad health,30,1,0,1,2,4,4,3,8,5,3,3,0,0
S01011228,Very bad health,12,1,1,0,2,1,0,1,1,5,1,1,0,0
S01011229,All people aged 16 to 74,383,15,3,12,61,45,22,40,63,61,50,31,19,26
S01011229,Very good health,151,7,1,6,32,20,11,16,22,15,10,4,6,18
S01011229,Good health,114,4,1,3,14,17,7,10,19,24,12,8,4,7
S01011229,Fair health,81,4,1,3,8,6,3,8,15,16,20,12,8,1
S01011229,Bad health,33,0,0,0,5,2,1,6,7,4,8,7,1,0
S01011229,Very bad health,4,0,0,0,2,0,0,0,0,2,0,0,0,0
S01011230,All people aged 16 to 74,698,10,1,9,61,52,32,56,176,164,116,70,46,31
S01011230,Very good health,218,2,0,2,21,20,13,18,53,41,34,21,13,16
S01011230,Good health,206,2,1,1,19,21,10,14,50,43,35,13,22,12
S01011230,Fair health,172,4,0,4,12,5,7,14,45,49,33,24,9,3
S01011230,Bad health,82,2,0,2,7,4,2,9,24,23,11,10,1,0
S01011230,Very bad health,20,0,0,0,2,2,0,1,4,8,3,2,1,0
S01011231,All people aged 16 to 74,440,8,2,6,48,40,21,41,125,95,43,29,14,19
S01011231,Very good health,156,4,0,4,24,18,8,10,45,27,7,5,2,13
S01011231,Good health,131,4,2,2,14,14,5,10,39,23,17,10,7,5
S01011231,Fair health,94,0,0,0,9,6,2,10,25,27,14,9,5,1
S01011231,Bad health,44,0,0,0,1,0,5,7,12,15,4,4,0,0
S01011231,Very bad health,15,0,0,0,0,2,1,4,4,3,1,1,0,0
S01011232,All people aged 16 to 74,777,40,6,34,166,72,61,73,140,123,65,39,26,37
S01011232,Very good health,307,14,0,14,84,31,29,24,51,32,16,6,10,26
S01011232,Good health,268,22,4,18,58,23,23,36,47,29,22,10,12,8
S01011232,Fair health,122,4,2,2,16,6,4,8,31,36,15,12,3,2
S01011232,Bad health,51,0,0,0,6,7,2,5,6,19,5,4,1,1
S01011232,Very bad health,29,0,0,0,2,5,3,0,5,7,7,7,0,0
S01011233,All people aged 16 to 74,295,12,0,12,48,36,16,28,42,47,37,29,8,29
S01011233,Very good health,117,6,0,6,27,16,4,11,12,10,11,8,3,20
S01011233,Good health,106,5,0,5,13,14,10,8,18,18,15,10,5,5
S01011233,Fair health,46,1,0,1,4,4,2,3,7,12,9,9,0,4
S01011233,Bad health,20,0,0,0,4,2,0,5,4,4,1,1,0,0
S01011233,Very bad health,6,0,0,0,0,0,0,1,1,3,1,1,0,0
S01011234,All people aged 16 to 74,751,19,8,11,100,58,32,80,132,155,97,56,41,78
S01011234,Very good health,281,7,2,5,38,26,9,24,57,33,27,12,15,60
S01011234,Good health,265,9,3,6,41,23,14,32,43,55,36,18,18,12
S01011234,Fair health,116,2,2,0,11,6,7,11,20,31,23,15,8,5
S01011234,Bad health,71,1,1,0,8,1,2,10,11,27,10,10,0,1
S01011234,Very bad health,18,0,0,0,2,2,0,3,1,9,1,1,0,0
S01011235,All people aged 16 to 74,297,7,1,6,32,36,16,32,59,59,29,19,10,27
S01011235,Very good health,99,1,0,1,14,13,10,7,15,13,6,1,5,20
S01011235,Good health,102,3,0,3,11,11,5,14,20,23,10,6,4,5
S01011235,Fair health,56,3,1,2,7,5,1,3,12,13,10,9,1,2
S01011235,Bad health,28,0,0,0,0,3,0,7,10,5,3,3,0,0
S01011235,Very bad health,12,0,0,0,0,4,0,1,2,5,0,0,0,0
S01011236,All people aged 16 to 74,438,14,3,11,71,38,28,40,106,90,35,23,12,16
S01011236,Very good health,161,6,1,5,32,16,9,12,45,24,5,2,3,12
S01011236,Good health,163,6,2,4,29,14,12,12,32,40,14,8,6,4
S01011236,Fair health,75,1,0,1,7,4,5,12,18,16,12,9,3,0
S01011236,Bad health,27,1,0,1,2,3,1,3,7,8,2,2,0,0
S01011236,Very bad health,12,0,0,0,1,1,1,1,4,2,2,2,0,0
S01011237,All people aged 16 to 74,552,12,2,10,83,57,25,59,86,110,68,42,26,52
S01011237,Very good health,230,8,1,7,36,26,11,23,33,30,23,13,10,40
S01011237,Good health,179,3,1,2,31,23,6,25,31,36,15,9,6,9
S01011237,Fair health,95,1,0,1,11,7,7,5,14,28,20,12,8,2
S01011237,Bad health,34,0,0,0,5,0,1,4,4,12,7,5,2,1
S01011237,Very bad health,14,0,0,0,0,1,0,2,4,4,3,3,0,0
S01011238,All people aged 16 to 74,480,12,2,10,51,52,22,43,97,95,80,50,30,28
S01011238,Very good health,172,4,0,4,21,24,7,14,31,33,20,11,9,18
S01011238,Good health,155,6,2,4,18,14,11,14,31,23,29,15,14,9
S01011238,Fair health,93,1,0,1,8,6,2,8,24,22,21,14,7,1
S01011238,Bad health,42,1,0,1,4,7,2,5,10,8,5,5,0,0
S01011238,Very bad health,18,0,0,0,0,1,0,2,1,9,5,5,0,0
S01011239,All people aged 16 to 74,546,13,4,9,68,59,41,52,109,100,69,34,35,35
S01011239,Very good health,185,5,2,3,29,24,16,14,32,29,14,5,9,22
S01011239,Good health,191,7,1,6,26,17,10,19,44,31,28,7,21,9
S01011239,Fair health,97,0,0,0,11,11,8,7,22,22,13,9,4,3
S01011239,Bad health,54,0,0,0,1,3,5,8,8,16,12,11,1,1
S01011239,Very bad health,19,1,1,0,1,4,2,4,3,2,2,2,0,0
S01011240,All people aged 16 to 74,564,17,5,12,84,57,34,64,106,83,91,42,49,28
S01011240,Very good health,200,8,1,7,44,22,14,20,32,14,28,8,20,18
S01011240,Good health,185,6,2,4,21,22,14,18,34,28,32,13,19,10
S01011240,Fair health,104,2,2,0,15,8,3,10,22,24,20,14,6,0
S01011240,Bad health,58,0,0,0,3,4,2,12,14,12,11,7,4,0
S01011240,Very bad health,17,1,0,1,1,1,1,4,4,5,0,0,0,0
S01011241,All people aged 16 to 74,783,43,13,30,171,77,66,93,118,108,63,34,29,44
S01011241,Very good health,323,17,4,13,78,37,32,35,40,31,21,10,11,32
S01011241,Good health,246,21,6,15,60,20,19,35,39,29,13,5,8,10
S01011241,Fair health,130,4,2,2,20,14,11,13,24,29,14,8,6,1
S01011241,Bad health,65,1,1,0,12,4,4,8,14,11,10,6,4,1
S01011241,Very bad health,19,0,0,0,1,2,0,2,1,8,5,5,0,0
S01011242,All people aged 16 to 74,570,31,6,25,109,82,38,57,112,67,37,22,15,37
S01011242,Very good health,218,21,3,18,42,49,11,15,33,15,6,1,5,26
S01011242,Good health,214,6,1,5,44,21,17,24,52,29,10,5,5,11
S01011242,Fair health,84,4,2,2,18,8,6,7,16,12,13,10,3,0
S01011242,Bad health,40,0,0,0,5,3,3,9,6,8,6,4,2,0
S01011242,Very bad health,14,0,0,0,0,1,1,2,5,3,2,2,0,0
S01011243,All people aged 16 to 74,675,22,2,20,86,64,43,66,140,112,113,66,47,29
S01011243,Very good health,220,6,1,5,32,23,12,22,56,25,29,20,9,15
S01011243,Good health,228,12,1,11,32,17,10,25,45,34,46,20,26,7
S01011243,Fair health,152,2,0,2,17,18,13,14,23,30,28,16,12,7
S01011243,Bad health,62,2,0,2,5,5,5,5,15,19,6,6,0,0
S01011243,Very bad health,13,0,0,0,0,1,3,0,1,4,4,4,0,0
S01011244,All people aged 16 to 74,535,15,3,12,54,64,16,43,118,102,89,48,41,34
S01011244,Very good health,184,6,1,5,24,26,7,17,34,35,13,8,5,22
S01011244,Good health,184,8,2,6,16,24,5,14,48,24,35,17,18,10
S01011244,Fair health,106,0,0,0,12,6,3,4,21,29,29,13,16,2
S01011244,Bad health,47,1,0,1,2,8,1,6,11,11,7,5,2,0
S01011244,Very bad health,14,0,0,0,0,0,0,2,4,3,5,5,0,0
S01011245,All people aged 16 to 74,659,20,5,15,74,75,35,62,146,122,88,49,39,37
S01011245,Very good health,235,11,3,8,37,30,17,19,46,36,18,8,10,21
S01011245,Good health,228,6,1,5,17,30,10,23,52,42,39,20,19,9
S01011245,Fair health,124,3,1,2,12,9,7,14,26,26,20,12,8,7
S01011245,Bad health,54,0,0,0,7,5,0,4,14,16,8,6,2,0
S01011245,Very bad health,18,0,0,0,1,1,1,2,8,2,3,3,0,0
S01011246,All people aged 16 to 74,681,54,11,43,162,80,70,55,111,80,34,8,26,35
S01011246,Very good health,286,31,6,25,79,26,24,16,44,29,13,2,11,24
S01011246,Good health,248,16,3,13,55,36,31,28,33,29,13,1,12,7
S01011246,Fair health,101,5,0,5,18,13,12,7,22,13,7,4,3,4
S01011246,Bad health,36,1,1,0,8,5,2,3,9,7,1,1,0,0
S01011246,Very bad health,10,1,1,0,2,0,1,1,3,2,0,0,0,0
S01011247,All people aged 16 to 74,587,70,13,57,152,91,43,67,66,54,12,8,4,32
S01011247,Very good health,279,41,4,37,79,37,17,26,27,25,7,4,3,20
S01011247,Good health,193,17,5,12,50,39,18,21,23,13,1,0,1,11
S01011247,Fair health,76,9,2,7,15,11,8,11,11,7,3,3,0,1
S01011247,Bad health,33,2,1,1,7,4,0,8,5,6,1,1,0,0
S01011247,Very bad health,6,1,1,0,1,0,0,1,0,3,0,0,0,0
S01011248,All people aged 16 to 74,588,36,10,26,116,80,35,56,119,85,15,11,4,46
S01011248,Very good health,292,22,7,15,63,47,21,21,44,31,5,4,1,38
S01011248,Good health,177,14,3,11,42,20,7,20,43,20,4,4,0,7
S01011248,Fair health,75,0,0,0,8,11,5,10,18,19,3,0,3,1
S01011248,Bad health,39,0,0,0,3,1,2,4,11,15,3,3,0,0
S01011248,Very bad health,5,0,0,0,0,1,0,1,3,0,0,0,0,0
S01011249,All people aged 16 to 74,568,44,10,34,112,112,33,70,76,56,18,7,11,47
S01011249,Very good health,306,30,6,24,70,60,11,36,34,21,7,3,4,37
S01011249,Good health,180,11,3,8,34,38,15,24,29,21,4,0,4,4
S01011249,Fair health,54,3,1,2,7,8,5,4,10,9,3,0,3,5
S01011249,Bad health,20,0,0,0,1,5,1,5,1,3,4,4,0,0
S01011249,Very bad health,8,0,0,0,0,1,1,1,2,2,0,0,0,1
S01011250,All people aged 16 to 74,767,25,3,22,98,81,41,71,188,118,82,45,37,63
S01011250,Very good health,339,7,1,6,48,40,16,27,89,34,33,20,13,45
S01011250,Good health,275,11,1,10,41,28,17,32,63,38,32,15,17,13
S01011250,Fair health,102,6,1,5,8,11,4,7,25,26,10,4,6,5
S01011250,Bad health,42,1,0,1,0,2,4,4,9,16,6,5,1,0
S01011250,Very bad health,9,0,0,0,1,0,0,1,2,4,1,1,0,0
S01011251,All people aged 16 to 74,659,11,3,8,99,60,36,73,144,131,46,32,14,59
S01011251,Very good health,253,4,1,3,45,26,13,21,49,39,21,13,8,35
S01011251,Good health,259,6,1,5,34,24,17,27,66,49,15,10,5,21
S01011251,Fair health,91,1,1,0,14,5,5,13,20,26,6,5,1,1
S01011251,Bad health,42,0,0,0,4,4,1,8,9,12,2,2,0,2
S01011251,Very bad health,14,0,0,0,2,1,0,4,0,5,2,2,0,0
S01011252,All people aged 16 to 74,612,8,2,6,60,63,17,53,157,130,63,36,27,61
S01011252,Very good health,252,5,2,3,24,31,4,15,62,42,21,14,7,48
S01011252,Good health,204,3,0,3,26,23,10,24,47,46,16,6,10,9
S01011252,Fair health,102,0,0,0,7,8,2,9,38,22,12,6,6,4
S01011252,Bad health,41,0,0,0,1,0,1,3,9,15,12,8,4,0
S01011252,Very bad health,13,0,0,0,2,1,0,2,1,5,2,2,0,0
S01011253,All people aged 16 to 74,638,8,1,7,50,56,23,80,162,130,65,46,19,64
S01011253,Very good health,263,3,0,3,24,22,11,27,67,46,18,11,7,45
S01011253,Good health,212,4,0,4,18,20,7,30,55,40,24,13,11,14
S01011253,Fair health,92,0,0,0,7,10,4,10,23,25,10,10,0,3
S01011253,Bad health,56,1,1,0,1,1,1,11,15,12,12,11,1,2
S01011253,Very bad health,15,0,0,0,0,3,0,2,2,7,1,1,0,0
S01011254,All people aged 16 to 74,756,60,17,43,172,121,44,82,115,63,22,10,12,77
S01011254,Very good health,409,40,8,32,92,78,10,44,49,24,8,3,5,64
S01011254,Good health,252,19,9,10,63,28,24,29,44,27,7,2,5,11
S01011254,Fair health,69,1,0,1,12,10,8,7,15,11,5,3,2,0
S01011254,Bad health,20,0,0,0,4,5,2,2,4,1,1,1,0,1
S01011254,Very bad health,6,0,0,0,1,0,0,0,3,0,1,1,0,1
S01011255,All people aged 16 to 74,567,71,14,57,175,85,32,65,64,20,12,8,4,43
S01011255,Very good health,359,48,5,43,111,57,16,41,34,12,6,5,1,34
S01011255,Good health,156,16,4,12,53,18,11,17,22,6,4,1,3,9
S01011255,Fair health,38,5,3,2,10,9,3,4,5,1,1,1,0,0
S01011255,Bad health,12,2,2,0,1,1,2,1,3,1,1,1,0,0
S01011255,Very bad health,2,0,0,0,0,0,0,2,0,0,0,0,0,0
S01011256,All people aged 16 to 74,331,21,10,11,91,53,26,32,46,32,8,6,2,22
S01011256,Very good health,191,7,2,5,60,36,12,18,21,15,3,3,0,19
S01011256,Good health,112,12,8,4,26,13,13,11,19,12,3,2,1,3
S01011256,Fair health,15,1,0,1,3,3,1,2,2,2,1,0,1,0
S01011256,Bad health,9,1,0,1,1,0,0,1,3,3,0,0,0,0
S01011256,Very bad health,4,0,0,0,1,1,0,0,1,0,1,1,0,0
S01011257,All people aged 16 to 74,325,33,8,25,91,48,23,35,43,18,13,6,7,21
S01011257,Very good health,140,16,6,10,39,23,8,12,12,7,5,2,3,18
S01011257,Good health,117,12,1,11,38,17,9,11,21,3,3,2,1,3
S01011257,Fair health,51,4,1,3,10,5,5,9,8,6,4,1,3,0
S01011257,Bad health,14,1,0,1,3,3,1,3,2,1,0,0,0,0
S01011257,Very bad health,3,0,0,0,1,0,0,0,0,1,1,1,0,0
S01011258,All people aged 16 to 74,445,48,10,38,121,44,26,46,61,36,15,8,7,48
S01011258,Very good health,218,25,5,20,66,25,8,21,24,11,5,3,2,33
S01011258,Good health,138,17,5,12,38,13,13,13,19,9,3,1,2,13
S01011258,Fair health,60,6,0,6,15,6,3,7,11,9,2,0,2,1
S01011258,Bad health,24,0,0,0,2,0,2,5,4,6,5,4,1,0
S01011258,Very bad health,5,0,0,0,0,0,0,0,3,1,0,0,0,1
S01011259,All people aged 16 to 74,564,28,5,23,121,91,48,48,99,72,28,16,12,29
S01011259,Very good health,244,16,3,13,61,38,19,17,43,23,6,2,4,21
S01011259,Good health,190,10,2,8,36,32,19,19,27,26,15,8,7,6
S01011259,Fair health,78,2,0,2,15,10,8,6,17,14,4,4,0,2
S01011259,Bad health,44,0,0,0,8,10,1,5,10,8,2,1,1,0
S01011259,Very bad health,8,0,0,0,1,1,1,1,2,1,1,1,0,0
S01011260,All people aged 16 to 74,549,38,7,31,138,86,34,55,75,53,24,15,9,46
S01011260,Very good health,254,17,4,13,81,37,16,22,21,19,4,4,0,37
S01011260,Good health,208,17,3,14,44,39,15,23,36,18,8,3,5,8
S01011260,Fair health,56,3,0,3,7,6,2,7,16,6,8,5,3,1
S01011260,Bad health,26,1,0,1,5,3,0,3,2,9,3,2,1,0
S01011260,Very bad health,5,0,0,0,1,1,1,0,0,1,1,1,0,0
S01011261,All people aged 16 to 74,579,9,2,7,61,49,33,72,116,116,75,53,22,48
S01011261,Very good health,218,4,0,4,22,21,14,17,39,39,33,26,7,29
S01011261,Good health,211,3,2,1,17,18,12,30,53,40,21,13,8,17
S01011261,Fair health,102,2,0,2,12,9,6,20,16,22,13,7,6,2
S01011261,Bad health,35,0,0,0,9,1,0,3,5,13,4,3,1,0
S01011261,Very bad health,13,0,0,0,1,0,1,2,3,2,4,4,0,0
S01011262,All people aged 16 to 74,367,13,2,11,61,49,25,31,91,45,31,21,10,21
S01011262,Very good health,136,10,2,8,22,14,6,11,41,14,7,5,2,11
S01011262,Good health,152,2,0,2,23,24,16,16,29,18,16,11,5,8
S01011262,Fair health,51,1,0,1,9,6,1,3,13,9,7,4,3,2
S01011262,Bad health,20,0,0,0,6,5,2,0,4,3,0,0,0,0
S01011262,Very bad health,8,0,0,0,1,0,0,1,4,1,1,1,0,0
S01011263,All people aged 16 to 74,796,39,7,32,144,125,40,84,149,109,53,34,19,53
S01011263,Very good health,446,24,4,20,99,77,20,44,72,46,20,13,7,44
S01011263,Good health,236,10,1,9,34,37,12,27,54,37,17,7,10,8
S01011263,Fair health,75,3,2,1,9,9,6,8,14,15,10,8,2,1
S01011263,Bad health,32,2,0,2,2,1,1,5,8,10,3,3,0,0
S01011263,Very bad health,7,0,0,0,0,1,1,0,1,1,3,3,0,0
S01011264,All people aged 16 to 74,485,9,4,5,67,45,24,59,90,105,47,24,23,39
S01011264,Very good health,206,4,2,2,31,19,8,19,37,37,22,11,11,29
S01011264,Good health,173,5,2,3,23,18,7,22,39,37,13,4,9,9
S01011264,Fair health,61,0,0,0,5,7,7,8,10,16,8,5,3,0
S01011264,Bad health,31,0,0,0,3,1,2,8,3,11,3,3,0,0
S01011264,Very bad health,14,0,0,0,5,0,0,2,1,4,1,1,0,1
S01011265,All people aged 16 to 74,750,13,5,8,67,71,50,52,165,150,107,51,56,75
S01011265,Very good health,332,4,2,2,42,37,24,18,70,57,35,14,21,45
S01011265,Good health,236,7,3,4,14,22,14,25,45,51,33,13,20,25
S01011265,Fair health,117,2,0,2,4,8,8,5,35,28,23,9,14,4
S01011265,Bad health,56,0,0,0,6,3,4,3,13,12,14,13,1,1
S01011265,Very bad health,9,0,0,0,1,1,0,1,2,2,2,2,0,0
S01011266,All people aged 16 to 74,662,19,5,14,86,80,33,90,147,117,39,23,16,51
S01011266,Very good health,250,10,2,8,40,29,8,32,59,26,12,5,7,34
S01011266,Good health,255,7,1,6,30,36,16,34,56,47,15,12,3,14
S01011266,Fair health,91,2,2,0,8,9,6,11,19,27,7,2,5,2
S01011266,Bad health,47,0,0,0,6,6,2,7,11,10,4,3,1,1
S01011266,Very bad health,19,0,0,0,2,0,1,6,2,7,1,1,0,0
S01011267,All people aged 16 to 74,445,28,2,26,116,63,27,50,60,53,22,11,11,26
S01011267,Very good health,178,12,0,12,46,29,8,19,20,16,6,2,4,22
S01011267,Good health,162,12,2,10,53,16,14,16,25,16,8,2,6,2
S01011267,Fair health,71,4,0,4,12,12,4,8,9,15,5,4,1,2
S01011267,Bad health,25,0,0,0,4,3,1,5,5,4,3,3,0,0
S01011267,Very bad health,9,0,0,0,1,3,0,2,1,2,0,0,0,0
S01011268,All people aged 16 to 74,293,18,5,13,61,37,19,35,40,51,21,12,9,11
S01011268,Very good health,142,11,4,7,39,20,6,12,15,21,8,6,2,10
S01011268,Good health,97,6,0,6,19,12,8,8,19,16,8,2,6,1
S01011268,Fair health,38,1,1,0,1,1,3,10,6,12,4,4,0,0
S01011268,Bad health,13,0,0,0,2,4,2,2,0,2,1,0,1,0
S01011268,Very bad health,3,0,0,0,0,0,0,3,0,0,0,0,0,0
S01011269,All people aged 16 to 74,389,12,4,8,71,46,17,47,56,83,36,18,18,21
S01011269,Very good health,151,6,3,3,30,24,4,14,23,23,12,5,7,15
S01011269,Good health,131,5,1,4,27,15,8,15,18,27,10,2,8,6
S01011269,Fair health,63,1,0,1,9,6,3,9,6,21,8,5,3,0
S01011269,Bad health,37,0,0,0,5,1,2,7,7,10,5,5,0,0
S01011269,Very bad health,7,0,0,0,0,0,0,2,2,2,1,1,0,0
S01011270,All people aged 16 to 74,523,12,2,10,70,62,27,60,105,94,44,17,27,49
S01011270,Very good health,213,6,2,4,24,28,12,24,34,31,16,6,10,38
S01011270,Good health,173,3,0,3,27,25,12,14,35,31,15,6,9,11
S01011270,Fair health,92,2,0,2,12,8,2,12,25,22,9,2,7,0
S01011270,Bad health,36,1,0,1,6,0,1,9,6,9,4,3,1,0
S01011270,Very bad health,9,0,0,0,1,1,0,1,5,1,0,0,0,0
S01011271,All people aged 16 to 74,598,26,3,23,71,74,29,74,116,107,49,23,26,52
S01011271,Very good health,240,16,1,15,26,28,9,25,44,34,19,10,9,39
S01011271,Good health,204,7,2,5,30,28,8,33,41,31,17,4,13,9
S01011271,Fair health,96,1,0,1,8,9,5,11,26,23,10,6,4,3
S01011271,Bad health,47,1,0,1,5,8,7,4,4,15,2,2,0,1
S01011271,Very bad health,11,1,0,1,2,1,0,1,1,4,1,1,0,0
S01011272,All people aged 16 to 74,576,19,3,16,73,63,26,73,97,126,62,27,35,37
S01011272,Very good health,227,11,1,10,40,28,8,25,36,32,19,6,13,28
S01011272,Good health,201,7,2,5,19,22,11,23,40,49,22,8,14,8
S01011272,Fair health,89,1,0,1,9,4,5,16,14,23,16,9,7,1
S01011272,Bad health,43,0,0,0,4,7,1,7,6,14,4,3,1,0
S01011272,Very bad health,16,0,0,0,1,2,1,2,1,8,1,1,0,0
S01011273,All people aged 16 to 74,626,10,1,9,70,69,24,69,125,120,77,43,34,62
S01011273,Very good health,261,7,1,6,29,32,8,25,50,38,28,13,15,44
S01011273,Good health,213,1,0,1,29,21,8,23,42,46,29,13,16,14
S01011273,Fair health,99,1,0,1,8,11,6,11,23,22,13,11,2,4
S01011273,Bad health,44,1,0,1,3,5,2,10,7,11,5,4,1,0
S01011273,Very bad health,9,0,0,0,1,0,0,0,3,3,2,2,0,0
S01011274,All people aged 16 to 74,637,16,3,13,59,75,33,89,137,101,61,38,23,66
S01011274,Very good health,298,10,2,8,28,33,14,47,66,34,14,12,2,52
S01011274,Good health,191,5,1,4,19,25,13,23,38,31,25,11,14,12
S01011274,Fair health,89,1,0,1,5,11,3,10,24,22,12,7,5,1
S01011274,Bad health,44,0,0,0,6,4,2,7,6,10,8,6,2,1
S01011274,Very bad health,15,0,0,0,1,2,1,2,3,4,2,2,0,0
S01011275,All people aged 16 to 74,496,11,2,9,52,41,24,45,119,99,62,43,19,43
S01011275,Very good health,204,1,0,1,26,18,9,16,44,35,25,18,7,30
S01011275,Good health,163,6,2,4,14,11,11,15,45,34,16,9,7,11
S01011275,Fair health,94,2,0,2,11,7,2,12,21,22,15,11,4,2
S01011275,Bad health,25,1,0,1,1,4,1,2,6,6,4,3,1,0
S01011275,Very bad health,10,1,0,1,0,1,1,0,3,2,2,2,0,0
S01011276,All people aged 16 to 74,698,21,4,17,70,74,29,86,147,115,92,51,41,64
S01011276,Very good health,282,10,2,8,33,38,7,33,49,30,32,18,14,50
S01011276,Good health,252,7,0,7,27,21,9,31,69,46,33,14,19,9
S01011276,Fair health,87,3,2,1,6,10,5,12,14,24,11,7,4,2
S01011276,Bad health,58,1,0,1,3,4,7,8,12,11,10,8,2,2
S01011276,Very bad health,19,0,0,0,1,1,1,2,3,4,6,4,2,1
S01011277,All people aged 16 to 74,554,30,8,22,128,101,34,67,91,49,11,7,4,43
S01011277,Very good health,277,15,3,12,67,43,12,35,41,25,6,4,2,33
S01011277,Good health,199,13,5,8,44,47,16,21,34,14,2,0,2,8
S01011277,Fair health,54,2,0,2,14,8,4,7,10,6,1,1,0,2
S01011277,Bad health,21,0,0,0,3,3,2,4,5,3,1,1,0,0
S01011277,Very bad health,3,0,0,0,0,0,0,0,1,1,1,1,0,0
S01011278,All people aged 16 to 74,400,32,9,23,91,81,15,53,55,43,13,9,4,17
S01011278,Very good health,213,15,5,10,54,47,8,24,26,18,7,4,3,14
S01011278,Good health,132,17,4,13,25,26,5,23,19,13,1,1,0,3
S01011278,Fair health,39,0,0,0,9,5,1,5,7,8,4,4,0,0
S01011278,Bad health,13,0,0,0,3,3,1,1,3,1,1,0,1,0
S01011278,Very bad health,3,0,0,0,0,0,0,0,0,3,0,0,0,0
S01011279,All people aged 16 to 74,504,32,8,24,127,99,21,54,81,37,22,17,5,31
S01011279,Very good health,250,19,5,14,63,44,12,26,28,18,15,11,4,25
S01011279,Good health,164,9,2,7,45,41,6,15,29,9,4,3,1,6
S01011279,Fair health,72,3,1,2,15,14,1,9,20,8,2,2,0,0
S01011279,Bad health,15,1,0,1,3,0,2,4,2,2,1,1,0,0
S01011279,Very bad health,3,0,0,0,1,0,0,0,2,0,0,0,0,0
S01011280,All people aged 16 to 74,487,48,12,36,138,76,32,49,57,34,10,5,5,43
S01011280,Very good health,255,18,3,15,72,41,16,17,29,18,4,0,4,40
S01011280,Good health,155,24,8,16,48,18,9,23,20,6,4,3,1,3
S01011280,Fair health,52,3,1,2,12,13,7,5,6,5,1,1,0,0
S01011280,Bad health,20,3,0,3,5,3,0,3,2,4,0,0,0,0
S01011280,Very bad health,5,0,0,0,1,1,0,1,0,1,1,1,0,0
S01011281,All people aged 16 to 74,495,48,12,36,143,70,36,50,48,41,9,4,5,50
S01011281,Very good health,291,35,9,26,79,47,15,23,26,18,5,2,3,43
S01011281,Good health,156,12,3,9,50,19,18,19,14,15,4,2,2,5
S01011281,Fair health,30,1,0,1,11,2,0,5,5,4,0,0,0,2
S01011281,Bad health,14,0,0,0,2,2,3,3,2,2,0,0,0,0
S01011281,Very bad health,4,0,0,0,1,0,0,0,1,2,0,0,0,0
S01011282,All people aged 16 to 74,671,51,13,38,174,115,43,57,89,63,13,9,4,66
S01011282,Very good health,360,26,6,20,102,69,25,29,36,25,3,3,0,45
S01011282,Good health,210,19,6,13,52,35,13,19,38,12,6,2,4,16
S01011282,Fair health,73,5,1,4,16,7,4,6,12,17,2,2,0,4
S01011282,Bad health,23,1,0,1,4,2,1,3,3,7,1,1,0,1
S01011282,Very bad health,5,0,0,0,0,2,0,0,0,2,1,1,0,0
S01011283,All people aged 16 to 74,543,52,8,44,151,93,38,51,60,47,9,6,3,42
S01011283,Very good health,334,31,3,28,103,58,23,24,29,23,6,4,2,37
S01011283,Good health,162,20,5,15,38,29,13,22,20,15,1,0,1,4
S01011283,Fair health,31,1,0,1,8,5,2,2,7,5,1,1,0,0
S01011283,Bad health,15,0,0,0,2,1,0,3,4,4,0,0,0,1
S01011283,Very bad health,1,0,0,0,0,0,0,0,0,0,1,1,0,0
S01011284,All people aged 16 to 74,406,53,17,36,132,63,32,39,27,25,3,0,3,32
S01011284,Very good health,250,34,11,23,91,36,17,23,16,10,1,0,1,22
S01011284,Good health,137,18,6,12,35,24,13,15,10,12,2,0,2,8
S01011284,Fair health,11,1,0,1,3,3,0,0,1,2,0,0,0,1
S01011284,Bad health,7,0,0,0,3,0,2,0,0,1,0,0,0,1
S01011284,Very bad health,1,0,0,0,0,0,0,1,0,0,0,0,0,0
S01011285,All people aged 16 to 74,528,8,1,7,68,63,30,52,134,101,38,17,21,34
S01011285,Very good health,207,4,1,3,26,32,13,19,48,25,18,9,9,22
S01011285,Good health,197,4,0,4,30,20,9,14,59,37,15,6,9,9
S01011285,Fair health,78,0,0,0,10,5,8,9,17,23,3,0,3,3
S01011285,Bad health,34,0,0,0,1,5,0,6,9,12,1,1,0,0
S01011285,Very bad health,12,0,0,0,1,1,0,4,1,4,1,1,0,0
S01011286,All people aged 16 to 74,515,7,0,7,67,70,25,53,97,93,42,22,20,61
S01011286,Very good health,206,6,0,6,26,24,9,21,42,25,14,6,8,39
S01011286,Good health,186,1,0,1,29,28,11,17,31,32,20,9,11,17
S01011286,Fair health,81,0,0,0,9,12,4,11,19,21,3,2,1,2
S01011286,Bad health,33,0,0,0,2,5,0,3,4,13,4,4,0,2
S01011286,Very bad health,9,0,0,0,1,1,1,1,1,2,1,1,0,1
S01011287,All people aged 16 to 74,601,21,7,14,82,72,31,54,136,91,50,25,25,64
S01011287,Very good health,268,10,3,7,44,35,13,22,55,28,20,9,11,41
S01011287,Good health,185,7,2,5,24,20,8,19,40,33,16,5,11,18
S01011287,Fair health,97,3,2,1,12,10,5,6,30,17,10,8,2,4
S01011287,Bad health,37,1,0,1,1,6,3,6,10,6,3,2,1,1
S01011287,Very bad health,14,0,0,0,1,1,2,1,1,7,1,1,0,0
S01011288,All people aged 16 to 74,555,10,2,8,76,66,21,54,136,98,47,27,20,47
S01011288,Very good health,225,5,1,4,35,32,5,17,50,27,20,12,8,34
S01011288,Good health,209,3,0,3,30,22,11,25,51,41,15,5,10,11
S01011288,Fair health,78,2,1,1,8,6,4,5,24,18,9,7,2,2
S01011288,Bad health,30,0,0,0,2,5,1,6,7,7,2,2,0,0
S01011288,Very bad health,13,0,0,0,1,1,0,1,4,5,1,1,0,0
S01011289,All people aged 16 to 74,682,13,3,10,84,74,35,80,158,129,44,24,20,65
S01011289,Very good health,286,6,0,6,38,40,19,29,60,39,16,8,8,39
S01011289,Good health,237,6,3,3,31,17,10,31,60,44,16,7,9,22
S01011289,Fair health,94,1,0,1,7,12,4,10,26,22,10,7,3,2
S01011289,Bad health,48,0,0,0,7,5,1,7,8,18,0,0,0,2
S01011289,Very bad health,17,0,0,0,1,0,1,3,4,6,2,2,0,0
S01011290,All people aged 16 to 74,826,26,6,20,108,94,72,86,165,155,68,37,31,52
S01011290,Very good health,329,13,6,7,56,34,31,34,50,46,26,15,11,39
S01011290,Good health,269,9,0,9,29,38,22,26,62,48,24,10,14,11
S01011290,Fair health,138,3,0,3,14,12,13,20,31,33,11,6,5,1
S01011290,Bad health,69,1,0,1,8,8,5,4,18,19,5,4,1,1
S01011290,Very bad health,21,0,0,0,1,2,1,2,4,9,2,2,0,0
S01011291,All people aged 16 to 74,619,24,7,17,87,78,31,77,115,124,38,15,23,45
S01011291,Very good health,233,12,2,10,46,32,6,25,34,33,14,5,9,31
S01011291,Good health,208,6,3,3,26,30,11,25,54,35,11,3,8,10
S01011291,Fair health,112,5,2,3,11,9,6,19,19,32,8,2,6,3
S01011291,Bad health,51,0,0,0,2,7,5,8,8,17,3,3,0,1
S01011291,Very bad health,15,1,0,1,2,0,3,0,0,7,2,2,0,0
S01011292,All people aged 16 to 74,512,7,2,5,43,40,28,53,137,93,74,37,37,37
S01011292,Very good health,204,4,0,4,25,13,13,18,50,22,31,14,17,28
S01011292,Good health,166,2,2,0,11,19,8,20,45,34,20,9,11,7
S01011292,Fair health,79,1,0,1,4,2,3,6,21,22,18,10,8,2
S01011292,Bad health,46,0,0,0,2,4,3,6,19,9,3,2,1,0
S01011292,Very bad health,17,0,0,0,1,2,1,3,2,6,2,2,0,0
S01011293,All people aged 16 to 74,529,12,2,10,64,43,20,68,105,136,36,17,19,45
S01011293,Very good health,181,3,0,3,26,20,7,21,24,39,14,6,8,27
S01011293,Good health,210,5,0,5,25,16,5,28,46,58,11,6,5,16
S01011293,Fair health,91,3,2,1,10,4,3,9,27,29,5,2,3,1
S01011293,Bad health,43,0,0,0,3,3,5,9,8,9,5,3,2,1
S01011293,Very bad health,4,1,0,1,0,0,0,1,0,1,1,0,1,0
S01011294,All people aged 16 to 74,609,14,2,12,90,70,44,67,103,135,62,31,31,24
S01011294,Very good health,211,7,2,5,46,28,11,19,35,27,20,12,8,18
S01011294,Good health,194,4,0,4,25,24,16,24,37,38,23,7,16,3
S01011294,Fair health,129,3,0,3,13,9,15,12,19,41,14,8,6,3
S01011294,Bad health,55,0,0,0,4,7,1,11,11,17,4,3,1,0
S01011294,Very bad health,20,0,0,0,2,2,1,1,1,12,1,1,0,0
S01011295,All people aged 16 to 74,741,70,9,61,203,121,49,78,71,72,21,9,12,56
S01011295,Very good health,372,34,3,31,117,59,17,38,34,20,6,3,3,47
S01011295,Good health,248,27,4,23,71,46,22,25,22,21,6,2,4,8
S01011295,Fair health,87,7,2,5,11,11,10,13,10,17,7,2,5,1
S01011295,Bad health,30,2,0,2,4,4,0,1,4,13,2,2,0,0
S01011295,Very bad health,4,0,0,0,0,1,0,1,1,1,0,0,0,0
S01011296,All people aged 16 to 74,434,11,3,8,72,61,37,47,67,73,30,12,18,36
S01011296,Very good health,182,9,2,7,29,32,14,20,26,23,6,1,5,23
S01011296,Good health,131,2,1,1,27,19,14,8,16,21,12,3,9,12
S01011296,Fair health,73,0,0,0,10,6,7,9,16,16,8,5,3,1
S01011296,Bad health,31,0,0,0,4,3,2,6,8,6,2,1,1,0
S01011296,Very bad health,17,0,0,0,2,1,0,4,1,7,2,2,0,0
S01011297,All people aged 16 to 74,622,15,3,12,76,70,34,62,125,130,45,26,19,65
S01011297,Very good health,251,13,2,11,36,39,10,17,46,39,11,6,5,40
S01011297,Good health,221,0,0,0,26,23,20,26,47,43,15,8,7,21
S01011297,Fair health,99,1,1,0,8,5,3,13,18,33,15,8,7,3
S01011297,Bad health,38,0,0,0,5,2,1,5,11,9,4,4,0,1
S01011297,Very bad health,13,1,0,1,1,1,0,1,3,6,0,0,0,0
S01011298,All people aged 16 to 74,460,11,5,6,54,41,21,40,107,80,51,30,21,55
S01011298,Very good health,203,6,3,3,24,14,11,17,38,22,30,18,12,41
S01011298,Good health,165,3,1,2,20,14,7,16,49,34,12,5,7,10
S01011298,Fair health,53,2,1,1,5,8,1,4,9,17,4,2,2,3
S01011298,Bad health,32,0,0,0,5,5,2,3,7,4,5,5,0,1
S01011298,Very bad health,7,0,0,0,0,0,0,0,4,3,0,0,0,0
S01011299,All people aged 16 to 74,388,33,10,23,91,38,92,30,41,31,6,4,2,26
S01011299,Very good health,216,20,7,13,62,17,45,15,16,19,2,1,1,20
S01011299,Good health,115,10,3,7,20,10,39,11,13,5,1,1,0,6
S01011299,Fair health,41,3,0,3,6,9,7,3,8,3,2,1,1,0
S01011299,Bad health,15,0,0,0,3,2,1,1,3,4,1,1,0,0
S01011299,Very bad health,1,0,0,0,0,0,0,0,1,0,0,0,0,0
S01011300,All people aged 16 to 74,708,17,3,14,67,76,37,64,153,182,75,36,39,37
S01011300,Very good health,277,10,1,9,36,39,15,18,53,55,23,8,15,28
S01011300,Good health,239,6,2,4,16,24,15,24,50,71,25,9,16,8
S01011300,Fair health,122,0,0,0,11,8,4,13,38,30,17,10,7,1
S01011300,Bad health,52,0,0,0,3,4,1,6,12,20,6,5,1,0
S01011300,Very bad health,18,1,0,1,1,1,2,3,0,6,4,4,0,0
S01011301,All people aged 16 to 74,543,51,13,38,121,91,44,45,68,59,23,11,12,41
S01011301,Very good health,300,35,5,30,65,50,15,24,35,28,14,6,8,34
S01011301,Good health,173,13,5,8,43,33,17,14,23,20,4,1,3,6
S01011301,Fair health,48,2,2,0,10,3,9,7,5,6,5,4,1,1
S01011301,Bad health,13,1,1,0,1,4,1,0,2,4,0,0,0,0
S01011301,Very bad health,9,0,0,0,2,1,2,0,3,1,0,0,0,0
S01011302,All people aged 16 to 74,639,20,7,13,88,85,39,69,108,132,68,39,29,30
S01011302,Very good health,227,8,5,3,38,37,14,19,28,39,19,11,8,25
S01011302,Good health,205,9,1,8,29,29,8,23,40,49,15,7,8,3
S01011302,Fair health,138,2,1,1,12,15,12,14,27,29,25,15,10,2
S01011302,Bad health,49,0,0,0,4,1,3,10,12,11,8,5,3,0
S01011302,Very bad health,20,1,0,1,5,3,2,3,1,4,1,1,0,0
S01011303,All people aged 16 to 74,754,64,11,53,180,125,57,92,101,72,15,7,8,48
S01011303,Very good health,399,35,7,28,105,60,30,47,43,31,10,3,7,38
S01011303,Good health,266,26,4,22,65,49,20,34,36,24,3,2,1,9
S01011303,Fair health,70,2,0,2,9,13,6,9,17,11,2,2,0,1
S01011303,Bad health,13,1,0,1,1,3,0,2,3,3,0,0,0,0
S01011303,Very bad health,6,0,0,0,0,0,1,0,2,3,0,0,0,0
S01011304,All people aged 16 to 74,497,16,8,8,58,48,21,66,85,98,53,34,19,52
S01011304,Very good health,209,9,5,4,23,18,7,27,35,36,13,6,7,41
S01011304,Good health,173,6,3,3,25,22,9,28,28,27,19,11,8,9
S01011304,Fair health,73,1,0,1,5,6,3,8,16,18,14,10,4,2
S01011304,Bad health,32,0,0,0,5,2,2,3,4,12,4,4,0,0
S01011304,Very bad health,10,0,0,0,0,0,0,0,2,5,3,3,0,0
S01011305,All people aged 16 to 74,608,33,3,30,105,65,44,69,95,89,64,36,28,44
S01011305,Very good health,285,22,3,19,60,24,16,28,42,36,20,7,13,37
S01011305,Good health,200,9,0,9,35,29,17,24,28,31,20,12,8,7
S01011305,Fair health,92,0,0,0,8,9,7,13,21,17,17,11,6,0
S01011305,Bad health,19,1,0,1,1,3,3,1,1,4,5,4,1,0
S01011305,Very bad health,12,1,0,1,1,0,1,3,3,1,2,2,0,0
S01011306,All people aged 16 to 74,411,14,4,10,87,43,12,58,68,64,38,16,22,27
S01011306,Very good health,178,6,1,5,40,20,4,22,26,22,17,8,9,21
S01011306,Good health,159,5,2,3,38,16,6,23,26,21,19,7,12,5
S01011306,Fair health,44,3,1,2,6,5,1,7,9,13,0,0,0,0
S01011306,Bad health,23,0,0,0,2,1,1,5,6,5,2,1,1,1
S01011306,Very bad health,7,0,0,0,1,1,0,1,1,3,0,0,0,0
S01011307,All people aged 16 to 74,350,32,6,26,77,55,68,26,44,22,5,5,0,21
S01011307,Very good health,155,16,6,10,33,26,32,13,15,3,1,1,0,16
S01011307,Good health,125,12,0,12,28,17,27,10,15,11,0,0,0,5
S01011307,Fair health,47,2,0,2,9,10,7,1,9,6,3,3,0,0
S01011307,Bad health,19,2,0,2,6,2,2,1,3,2,1,1,0,0
S01011307,Very bad health,4,0,0,0,1,0,0,1,2,0,0,0,0,0
S01011308,All people aged 16 to 74,358,57,17,40,92,30,73,17,30,19,13,7,6,27
S01011308,Very good health,162,27,5,22,47,9,27,5,11,10,4,4,0,22
S01011308,Good health,138,23,6,17,31,15,33,7,13,5,7,2,5,4
S01011308,Fair health,39,5,4,1,8,3,12,3,5,2,1,0,1,0
S01011308,Bad health,12,1,1,0,3,2,1,1,1,1,1,1,0,1
S01011308,Very bad health,7,1,1,0,3,1,0,1,0,1,0,0,0,0
S01011309,All people aged 16 to 74,522,96,21,75,158,77,55,31,49,19,10,6,4,27
S01011309,Very good health,285,54,9,45,85,42,23,18,21,11,5,4,1,26
S01011309,Good health,171,32,10,22,60,26,19,6,20,5,2,0,2,1
S01011309,Fair health,46,6,2,4,10,7,6,4,8,3,2,1,1,0
S01011309,Bad health,18,3,0,3,3,2,7,2,0,0,1,1,0,0
S01011309,Very bad health,2,1,0,1,0,0,0,1,0,0,0,0,0,0
S01011310,All people aged 16 to 74,502,40,3,37,131,61,54,46,69,37,21,12,9,43
S01011310,Very good health,273,21,1,20,74,36,26,19,37,18,10,5,5,32
S01011310,Good health,149,13,2,11,41,18,19,20,17,12,1,0,1,8
S01011310,Fair health,53,6,0,6,11,4,5,5,11,3,6,4,2,2
S01011310,Bad health,19,0,0,0,4,2,4,1,2,3,2,1,1,1
S01011310,Very bad health,8,0,0,0,1,1,0,1,2,1,2,2,0,0
S01011311,All people aged 16 to 74,527,74,13,61,178,71,57,39,54,24,6,3,3,24
S01011311,Very good health,268,42,8,34,87,35,35,16,27,9,0,0,0,17
S01011311,Good health,188,27,5,22,68,26,15,17,17,8,3,1,2,7
S01011311,Fair health,61,5,0,5,21,9,5,4,8,7,2,1,1,0
S01011311,Bad health,8,0,0,0,2,1,2,1,1,0,1,1,0,0
S01011311,Very bad health,2,0,0,0,0,0,0,1,1,0,0,0,0,0
S01011312,All people aged 16 to 74,828,173,34,139,248,97,92,60,56,28,24,12,12,50
S01011312,Very good health,479,102,21,81,149,50,53,32,30,13,9,4,5,41
S01011312,Good health,256,53,9,44,75,41,27,18,16,11,7,2,5,8
S01011312,Fair health,75,14,4,10,21,4,11,7,6,4,7,5,2,1
S01011312,Bad health,9,2,0,2,1,1,1,2,1,0,1,1,0,0
S01011312,Very bad health,9,2,0,2,2,1,0,1,3,0,0,0,0,0
S01011313,All people aged 16 to 74,524,54,8,46,146,74,62,45,65,37,11,6,5,30
S01011313,Very good health,252,31,6,25,70,30,27,20,30,20,3,1,2,21
S01011313,Good health,178,14,2,12,51,34,22,19,15,12,3,3,0,8
S01011313,Fair health,66,9,0,9,21,7,6,4,11,4,3,1,2,1
S01011313,Bad health,20,0,0,0,2,2,5,1,8,0,2,1,1,0
S01011313,Very bad health,8,0,0,0,2,1,2,1,1,1,0,0,0,0
S01011314,All people aged 16 to 74,807,115,21,94,218,95,71,74,89,64,27,11,16,54
S01011314,Very good health,426,71,11,60,123,50,33,32,36,21,9,3,6,51
S01011314,Good health,258,33,8,25,69,31,24,28,34,28,10,3,7,1
S01011314,Fair health,89,8,2,6,17,12,7,10,16,12,5,2,3,2
S01011314,Bad health,25,3,0,3,7,2,5,4,1,3,0,0,0,0
S01011314,Very bad health,9,0,0,0,2,0,2,0,2,0,3,3,0,0
S01011315,All people aged 16 to 74,289,19,4,15,48,22,26,32,55,50,17,10,7,20
S01011315,Very good health,139,10,2,8,28,14,8,17,27,17,2,1,1,16
S01011315,Good health,95,7,1,6,13,4,10,13,17,19,9,6,3,3
S01011315,Fair health,35,1,0,1,4,3,6,2,6,10,3,0,3,0
S01011315,Bad health,16,1,1,0,3,1,2,0,4,3,1,1,0,1
S01011315,Very bad health,4,0,0,0,0,0,0,0,1,1,2,2,0,0
S01011316,All people aged 16 to 74,521,24,5,19,85,51,36,54,97,84,53,34,19,37
S01011316,Very good health,215,12,1,11,49,22,11,25,33,24,15,8,7,24
S01011316,Good health,178,8,3,5,20,19,15,18,38,27,23,13,10,10
S01011316,Fair health,79,3,1,2,8,8,9,8,12,18,10,8,2,3
S01011316,Bad health,36,1,0,1,5,0,1,2,12,11,4,4,0,0
S01011316,Very bad health,13,0,0,0,3,2,0,1,2,4,1,1,0,0
S01011317,All people aged 16 to 74,522,67,11,56,145,89,71,22,43,32,18,8,10,35
S01011317,Very good health,270,40,8,32,71,42,40,11,15,13,9,2,7,29
S01011317,Good health,179,20,3,17,56,26,25,6,20,15,5,2,3,6
S01011317,Fair health,53,6,0,6,12,18,5,4,5,3,0,0,0,0
S01011317,Bad health,19,1,0,1,6,3,0,1,3,1,4,4,0,0
S01011317,Very bad health,1,0,0,0,0,0,1,0,0,0,0,0,0,0
S01011318,All people aged 16 to 74,636,89,15,74,164,93,65,38,90,51,15,8,7,31
S01011318,Very good health,318,47,7,40,87,49,31,19,31,26,4,2,2,24
S01011318,Good health,238,36,8,28,63,28,26,13,40,20,6,2,4,6
S01011318,Fair health,56,4,0,4,12,12,7,5,11,3,2,1,1,0
S01011318,Bad health,16,2,0,2,1,2,1,1,5,2,1,1,0,1
S01011318,Very bad health,8,0,0,0,1,2,0,0,3,0,2,2,0,0
S01011319,All people aged 16 to 74,566,78,13,65,162,82,45,42,66,35,11,7,4,45
S01011319,Very good health,314,44,8,36,87,47,16,23,31,17,7,4,3,42
S01011319,Good health,189,27,5,22,57,26,18,15,27,14,3,2,1,2
S01011319,Fair health,51,5,0,5,16,7,9,3,7,2,1,1,0,1
S01011319,Bad health,9,1,0,1,1,1,2,1,1,2,0,0,0,0
S01011319,Very bad health,3,1,0,1,1,1,0,0,0,0,0,0,0,0
S01011320,All people aged 16 to 74,376,19,2,17,82,55,32,37,64,46,14,10,4,27
S01011320,Very good health,169,11,1,10,45,25,10,14,26,10,7,5,2,21
S01011320,Good health,133,5,1,4,28,20,9,14,27,22,4,3,1,4
S01011320,Fair health,53,2,0,2,7,8,7,7,9,11,2,1,1,0
S01011320,Bad health,16,1,0,1,2,0,5,2,2,2,1,1,0,1
S01011320,Very bad health,5,0,0,0,0,2,1,0,0,1,0,0,0,1
S01011321,All people aged 16 to 74,465,38,5,33,108,67,29,37,90,57,9,4,5,30
S01011321,Very good health,230,19,3,16,66,29,9,18,41,23,4,2,2,21
S01011321,Good health,170,13,0,13,27,34,15,11,39,20,3,0,3,8
S01011321,Fair health,45,4,2,2,11,4,4,7,6,9,0,0,0,0
S01011321,Bad health,18,1,0,1,3,0,1,1,4,5,2,2,0,1
S01011321,Very bad health,2,1,0,1,1,0,0,0,0,0,0,0,0,0
S01011322,All people aged 16 to 74,468,36,7,29,105,75,36,36,67,53,19,9,10,41
S01011322,Very good health,262,20,4,16,60,38,24,23,28,25,10,3,7,34
S01011322,Good health,140,11,3,8,34,25,7,8,28,17,4,2,2,6
S01011322,Fair health,46,3,0,3,8,8,5,5,10,5,1,0,1,1
S01011322,Bad health,16,2,0,2,0,4,0,0,1,5,4,4,0,0
S01011322,Very bad health,4,0,0,0,3,0,0,0,0,1,0,0,0,0
S01011323,All people aged 16 to 74,674,47,8,39,112,76,51,74,138,81,41,21,20,54
S01011323,Very good health,352,27,3,24,55,45,22,40,77,26,19,12,7,41
S01011323,Good health,197,14,4,10,36,21,19,22,40,28,10,2,8,7
S01011323,Fair health,71,4,0,4,13,5,3,10,9,18,4,1,3,5
S01011323,Bad health,40,2,1,1,5,3,5,2,9,7,6,4,2,1
S01011323,Very bad health,14,0,0,0,3,2,2,0,3,2,2,2,0,0
S01011324,All people aged 16 to 74,330,26,7,19,73,50,27,27,51,34,18,12,6,24
S01011324,Very good health,151,9,2,7,36,30,11,13,14,13,7,4,3,18
S01011324,Good health,110,11,4,7,24,14,11,10,20,11,4,3,1,5
S01011324,Fair health,45,3,0,3,7,2,4,2,12,9,5,4,1,1
S01011324,Bad health,19,3,1,2,5,3,1,1,4,1,1,0,1,0
S01011324,Very bad health,5,0,0,0,1,1,0,1,1,0,1,1,0,0
S01011325,All people aged 16 to 74,563,24,3,21,79,66,60,74,95,98,37,16,21,30
S01011325,Very good health,219,8,2,6,35,26,21,26,38,36,7,4,3,22
S01011325,Good health,185,8,1,7,28,24,18,26,30,27,16,4,12,8
S01011325,Fair health,100,5,0,5,12,11,11,13,18,19,11,5,6,0
S01011325,Bad health,46,2,0,2,4,5,8,6,5,13,3,3,0,0
S01011325,Very bad health,13,1,0,1,0,0,2,3,4,3,0,0,0,0
S01011326,All people aged 16 to 74,544,31,8,23,99,56,61,63,113,64,31,15,16,26
S01011326,Very good health,181,17,4,13,41,20,23,11,27,15,9,3,6,18
S01011326,Good health,211,8,0,8,37,26,17,27,57,23,12,5,7,4
S01011326,Fair health,104,4,2,2,16,7,15,15,18,17,8,5,3,4
S01011326,Bad health,36,2,2,0,4,3,5,5,9,7,1,1,0,0
S01011326,Very bad health,12,0,0,0,1,0,1,5,2,2,1,1,0,0
S01011327,All people aged 16 to 74,516,24,7,17,92,64,64,58,83,64,51,37,14,16
S01011327,Very good health,167,9,4,5,40,16,20,19,26,17,8,3,5,12
S01011327,Good health,193,10,3,7,35,31,20,16,31,23,24,19,5,3
S01011327,Fair health,110,3,0,3,13,14,18,17,15,12,18,14,4,0
S01011327,Bad health,41,2,0,2,4,3,5,6,10,10,0,0,0,1
S01011327,Very bad health,5,0,0,0,0,0,1,0,1,2,1,1,0,0
S01011328,All people aged 16 to 74,501,36,4,32,100,52,96,46,74,56,17,11,6,24
S01011328,Very good health,209,20,3,17,41,16,40,15,32,23,5,3,2,17
S01011328,Good health,186,12,1,11,34,23,40,18,26,22,5,4,1,6
S01011328,Fair health,78,3,0,3,17,8,10,11,13,10,5,3,2,1
S01011328,Bad health,24,1,0,1,7,5,4,2,3,1,1,0,1,0
S01011328,Very bad health,4,0,0,0,1,0,2,0,0,0,1,1,0,0
S01011329,All people aged 16 to 74,634,55,8,47,152,85,55,60,104,51,27,10,17,45
S01011329,Very good health,302,28,3,25,84,42,21,27,44,19,10,2,8,27
S01011329,Good health,222,16,3,13,46,29,26,24,39,18,8,2,6,16
S01011329,Fair health,87,8,1,7,18,11,6,8,19,9,7,4,3,1
S01011329,Bad health,19,2,1,1,3,2,1,1,2,5,2,2,0,1
S01011329,Very bad health,4,1,0,1,1,1,1,0,0,0,0,0,0,0
S01011330,All people aged 16 to 74,519,73,19,54,136,95,32,33,67,40,12,8,4,31
S01011330,Very good health,270,42,11,31,76,41,18,18,24,20,7,3,4,24
S01011330,Good health,183,24,6,18,44,39,11,13,32,12,2,2,0,6
S01011330,Fair health,45,5,1,4,12,11,2,1,6,4,3,3,0,1
S01011330,Bad health,16,2,1,1,4,3,0,1,4,2,0,0,0,0
S01011330,Very bad health,5,0,0,0,0,1,1,0,1,2,0,0,0,0
S01011331,All people aged 16 to 74,527,81,21,60,168,81,36,38,58,22,14,11,3,29
S01011331,Very good health,290,48,12,36,99,47,17,15,28,7,7,5,2,22
S01011331,Good health,172,28,7,21,51,25,12,16,23,8,2,1,1,7
S01011331,Fair health,55,5,2,3,15,8,7,4,6,5,5,5,0,0
S01011331,Bad health,9,0,0,0,3,1,0,3,1,1,0,0,0,0
S01011331,Very bad health,1,0,0,0,0,0,0,0,0,1,0,0,0,0
S01011332,All people aged 16 to 74,636,101,18,83,190,93,54,42,68,36,14,7,7,38
S01011332,Very good health,356,63,12,51,108,49,22,23,43,15,7,3,4,26
S01011332,Good health,201,29,3,26,54,36,22,13,18,14,4,3,1,11
S01011332,Fair health,60,7,3,4,19,7,10,6,5,4,2,1,1,0
S01011332,Bad health,15,2,0,2,7,1,0,0,2,2,0,0,0,1
S01011332,Very bad health,4,0,0,0,2,0,0,0,0,1,1,0,1,0
S01011333,All people aged 16 to 74,520,82,15,67,173,84,55,23,42,28,6,1,5,27
S01011333,Very good health,271,48,8,40,94,40,25,9,22,9,2,0,2,22
S01011333,Good health,178,26,5,21,57,30,23,8,14,13,3,0,3,4
S01011333,Fair health,57,7,2,5,20,11,4,6,4,3,1,1,0,1
S01011333,Bad health,10,1,0,1,1,3,2,0,0,3,0,0,0,0
S01011333,Very bad health,4,0,0,0,1,0,1,0,2,0,0,0,0,0
S01011334,All people aged 16 to 74,550,81,16,65,115,73,117,22,51,44,19,11,8,28
S01011334,Very good health,303,53,6,47,71,45,53,10,25,16,7,3,4,23
S01011334,Good health,188,25,9,16,37,20,49,8,19,17,9,5,4,4
S01011334,Fair health,42,2,1,1,6,6,14,3,4,6,1,1,0,0
S01011334,Bad health,14,1,0,1,1,1,1,0,3,5,1,1,0,1
S01011334,Very bad health,3,0,0,0,0,1,0,1,0,0,1,1,0,0
S01011335,All people aged 16 to 74,703,119,27,92,209,109,65,42,57,29,13,7,6,60
S01011335,Very good health,337,63,17,46,92,55,31,16,23,6,6,3,3,45
S01011335,Good health,257,42,8,34,86,40,24,17,20,12,4,2,2,12
S01011335,Fair health,85,9,2,7,26,13,7,8,9,9,1,0,1,3
S01011335,Bad health,19,3,0,3,5,1,2,1,3,2,2,2,0,0
S01011335,Very bad health,5,2,0,2,0,0,1,0,2,0,0,0,0,0
S01011336,All people aged 16 to 74,437,36,11,25,78,59,33,46,84,50,22,13,9,29
S01011336,Very good health,205,17,4,13,41,30,13,16,34,21,5,4,1,28
S01011336,Good health,140,13,3,10,23,18,15,21,28,14,7,3,4,1
S01011336,Fair health,63,3,2,1,10,10,4,7,14,10,5,1,4,0
S01011336,Bad health,25,3,2,1,3,1,1,1,8,4,4,4,0,0
S01011336,Very bad health,4,0,0,0,1,0,0,1,0,1,1,1,0,0
S01011337,All people aged 16 to 74,545,106,26,80,170,75,55,27,32,33,12,7,5,35
S01011337,Very good health,271,54,16,38,78,33,27,12,18,15,5,3,2,29
S01011337,Good health,201,39,8,31,69,32,20,11,9,13,5,2,3,3
S01011337,Fair health,58,8,2,6,19,8,8,3,3,5,1,1,0,3
S01011337,Bad health,11,3,0,3,3,2,0,0,2,0,1,1,0,0
S01011337,Very bad health,4,2,0,2,1,0,0,1,0,0,0,0,0,0
S01011338,All people aged 16 to 74,488,33,5,28,89,54,22,64,74,82,33,11,22,37
S01011338,Very good health,246,21,3,18,58,34,10,26,29,28,11,3,8,29
S01011338,Good health,154,11,1,10,23,16,6,23,28,32,10,2,8,5
S01011338,Fair health,58,1,1,0,6,4,3,10,11,14,7,3,4,2
S01011338,Bad health,27,0,0,0,2,0,3,3,6,8,4,2,2,1
S01011338,Very bad health,3,0,0,0,0,0,0,2,0,0,1,1,0,0
S01011339,All people aged 16 to 74,421,12,2,10,63,45,22,43,93,54,47,38,9,42
S01011339,Very good health,183,7,1,6,25,15,11,19,36,18,18,13,5,34
S01011339,Good health,152,3,1,2,25,19,6,18,40,20,16,12,4,5
S01011339,Fair health,64,2,0,2,9,10,3,5,11,11,10,10,0,3
S01011339,Bad health,17,0,0,0,3,1,0,1,5,5,2,2,0,0
S01011339,Very bad health,5,0,0,0,1,0,2,0,1,0,1,1,0,0
S01011340,All people aged 16 to 74,504,12,6,6,48,62,28,55,119,93,44,19,25,43
S01011340,Very good health,207,8,3,5,20,30,8,16,55,26,14,6,8,30
S01011340,Good health,168,4,3,1,18,23,11,16,34,37,15,4,11,10
S01011340,Fair health,86,0,0,0,5,6,6,17,25,16,9,5,4,2
S01011340,Bad health,33,0,0,0,4,1,1,4,4,13,5,3,2,1
S01011340,Very bad health,10,0,0,0,1,2,2,2,1,1,1,1,0,0
S01011341,All people aged 16 to 74,552,28,6,22,94,65,24,67,100,86,41,22,19,47
S01011341,Very good health,268,12,4,8,57,38,13,31,38,29,16,8,8,34
S01011341,Good health,169,14,2,12,31,17,6,22,31,30,11,5,6,7
S01011341,Fair health,82,2,0,2,4,9,5,7,23,18,8,4,4,6
S01011341,Bad health,29,0,0,0,2,1,0,7,5,8,6,5,1,0
S01011341,Very bad health,4,0,0,0,0,0,0,0,3,1,0,0,0,0
S01011342,All people aged 16 to 74,539,35,14,21,100,100,37,61,90,51,22,9,13,43
S01011342,Very good health,273,21,9,12,53,54,20,23,43,17,11,5,6,31
S01011342,Good health,184,12,4,8,42,35,13,25,28,16,7,2,5,6
S01011342,Fair health,55,2,1,1,5,8,3,9,9,10,4,2,2,5
S01011342,Bad health,20,0,0,0,0,3,1,2,7,6,0,0,0,1
S01011342,Very bad health,7,0,0,0,0,0,0,2,3,2,0,0,0,0
S01011343,All people aged 16 to 74,626,13,5,8,86,59,34,76,140,120,67,39,28,31
S01011343,Very good health,253,6,2,4,44,24,15,26,58,35,21,13,8,24
S01011343,Good health,203,3,0,3,26,17,9,28,45,40,29,15,14,6
S01011343,Fair health,106,4,3,1,7,11,4,12,26,30,11,8,3,1
S01011343,Bad health,53,0,0,0,6,6,5,8,10,13,5,2,3,0
S01011343,Very bad health,11,0,0,0,3,1,1,2,1,2,1,1,0,0
S01011344,All people aged 16 to 74,636,12,2,10,63,66,32,74,130,155,64,30,34,40
S01011344,Very good health,222,5,0,5,26,29,10,19,40,40,26,16,10,27
S01011344,Good health,236,5,1,4,27,20,13,28,57,52,24,11,13,10
S01011344,Fair health,122,2,1,1,7,12,6,18,21,43,11,1,10,2
S01011344,Bad health,44,0,0,0,2,3,3,8,8,17,2,1,1,1
S01011344,Very bad health,12,0,0,0,1,2,0,1,4,3,1,1,0,0
S01011345,All people aged 16 to 74,558,8,1,7,63,37,24,57,138,123,66,29,37,42
S01011345,Very good health,223,6,1,5,30,19,8,16,49,42,24,12,12,29
S01011345,Good health,209,2,0,2,23,10,10,24,59,45,25,9,16,11
S01011345,Fair health,78,0,0,0,5,5,2,8,21,25,10,3,7,2
S01011345,Bad health,38,0,0,0,3,3,3,8,8,8,5,3,2,0
S01011345,Very bad health,10,0,0,0,2,0,1,1,1,3,2,2,0,0
S01011346,All people aged 16 to 74,509,12,4,8,65,66,34,51,97,109,44,29,15,31
S01011346,Very good health,197,5,2,3,41,25,16,14,32,27,16,12,4,21
S01011346,Good health,179,6,2,4,19,28,6,23,39,40,13,5,8,5
S01011346,Fair health,92,1,0,1,3,9,5,11,13,31,14,11,3,5
S01011346,Bad health,31,0,0,0,2,2,5,3,10,8,1,1,0,0
S01011346,Very bad health,10,0,0,0,0,2,2,0,3,3,0,0,0,0
S01011347,All people aged 16 to 74,780,37,10,27,126,103,56,87,163,122,50,27,23,36
S01011347,Very good health,324,24,5,19,62,43,26,32,65,34,11,6,5,27
S01011347,Good health,258,9,3,6,33,39,19,37,56,43,14,3,11,8
S01011347,Fair health,127,2,1,1,19,16,7,10,32,26,14,9,5,1
S01011347,Bad health,54,1,1,0,9,4,3,7,8,14,8,6,2,0
S01011347,Very bad health,17,1,0,1,3,1,1,1,2,5,3,3,0,0
S01011348,All people aged 16 to 74,669,30,9,21,110,96,31,66,115,108,65,31,34,48
S01011348,Very good health,279,17,5,12,58,42,10,25,34,29,28,13,15,36
S01011348,Good health,226,9,1,8,40,34,14,25,38,34,23,10,13,9
S01011348,Fair health,109,3,3,0,9,12,2,13,30,26,11,6,5,3
S01011348,Bad health,44,1,0,1,1,5,5,3,12,15,2,1,1,0
S01011348,Very bad health,11,0,0,0,2,3,0,0,1,4,1,1,0,0
S01011349,All people aged 16 to 74,717,62,18,44,166,125,61,65,93,80,18,5,13,47
S01011349,Very good health,392,42,10,32,97,65,26,31,48,33,7,3,4,43
S01011349,Good health,239,15,6,9,53,51,25,28,30,32,2,0,2,3
S01011349,Fair health,63,4,2,2,12,6,9,3,10,12,7,1,6,0
S01011349,Bad health,15,1,0,1,0,1,1,3,3,3,2,1,1,1
S01011349,Very bad health,8,0,0,0,4,2,0,0,2,0,0,0,0,0
S01011350,All people aged 16 to 74,503,53,13,40,133,85,54,27,60,35,15,10,5,41
S01011350,Very good health,271,25,7,18,76,46,22,16,33,12,8,5,3,33
S01011350,Good health,157,19,5,14,47,27,18,6,18,12,3,2,1,7
S01011350,Fair health,52,4,0,4,5,9,10,5,8,7,3,2,1,1
S01011350,Bad health,17,3,0,3,4,3,1,0,1,4,1,1,0,0
S01011350,Very bad health,6,2,1,1,1,0,3,0,0,0,0,0,0,0
S01011351,All people aged 16 to 74,526,11,2,9,63,61,26,53,111,117,51,25,26,33
S01011351,Very good health,166,6,1,5,21,31,7,18,27,25,11,3,8,20
S01011351,Good health,205,4,1,3,25,21,11,20,46,45,22,11,11,11
S01011351,Fair health,106,1,0,1,10,6,5,10,26,30,16,10,6,2
S01011351,Bad health,37,0,0,0,5,1,2,5,10,12,2,1,1,0
S01011351,Very bad health,12,0,0,0,2,2,1,0,2,5,0,0,0,0
S01011352,All people aged 16 to 74,474,23,4,19,89,68,29,46,83,65,53,30,23,18
S01011352,Very good health,219,12,2,10,47,33,16,18,40,26,14,8,6,13
S01011352,Good health,164,10,1,9,32,25,9,22,25,18,19,5,14,4
S01011352,Fair health,60,0,0,0,6,6,2,4,13,12,16,13,3,1
S01011352,Bad health,27,1,1,0,4,4,1,0,5,8,4,4,0,0
S01011352,Very bad health,4,0,0,0,0,0,1,2,0,1,0,0,0,0
S01011353,All people aged 16 to 74,487,22,8,14,73,64,34,50,86,96,34,24,10,28
S01011353,Very good health,190,13,3,10,31,27,12,22,25,29,10,6,4,21
S01011353,Good health,184,3,2,1,29,25,15,20,39,39,8,5,3,6
S01011353,Fair health,81,4,2,2,9,8,6,6,15,20,13,11,2,0
S01011353,Bad health,26,1,0,1,4,4,1,1,6,6,2,1,1,1
S01011353,Very bad health,6,1,1,0,0,0,0,1,1,2,1,1,0,0
S01011354,All people aged 16 to 74,542,47,7,40,116,83,42,47,78,68,20,6,14,41
S01011354,Very good health,237,26,3,23,52,30,16,22,31,23,7,2,5,30
S01011354,Good health,208,18,4,14,47,40,20,17,27,21,8,1,7,10
S01011354,Fair health,76,3,0,3,17,9,4,6,13,19,4,2,2,1
S01011354,Bad health,16,0,0,0,0,4,2,2,6,1,1,1,0,0
S01011354,Very bad health,5,0,0,0,0,0,0,0,1,4,0,0,0,0
S01011355,All people aged 16 to 74,698,33,12,21,126,116,47,75,126,96,26,13,13,53
S01011355,Very good health,305,18,6,12,63,54,19,27,45,29,8,4,4,42
S01011355,Good health,263,12,4,8,52,38,16,28,53,43,11,3,8,10
S01011355,Fair health,95,2,1,1,9,16,9,15,21,18,4,3,1,1
S01011355,Bad health,25,1,1,0,0,7,2,3,6,4,2,2,0,0
S01011355,Very bad health,10,0,0,0,2,1,1,2,1,2,1,1,0,0
S01011356,All people aged 16 to 74,735,81,13,68,194,65,143,64,82,50,24,17,7,32
S01011356,Very good health,389,50,7,43,121,37,61,29,33,18,14,11,3,26
S01011356,Good health,241,21,4,17,57,22,63,22,28,15,8,4,4,5
S01011356,Fair health,74,6,0,6,13,5,12,10,15,11,2,2,0,0
S01011356,Bad health,24,4,2,2,1,1,4,3,5,5,0,0,0,1
S01011356,Very bad health,7,0,0,0,2,0,3,0,1,1,0,0,0,0
S01011357,All people aged 16 to 74,646,39,6,33,143,103,41,71,87,98,21,13,8,43
S01011357,Very good health,291,23,4,19,79,54,17,30,30,20,4,2,2,34
S01011357,Good health,194,13,2,11,38,26,18,25,27,32,6,3,3,9
S01011357,Fair health,93,2,0,2,19,13,2,10,17,22,8,5,3,0
S01011357,Bad health,52,1,0,1,5,9,3,6,9,17,2,2,0,0
S01011357,Very bad health,16,0,0,0,2,1,1,0,4,7,1,1,0,0
S01011358,All people aged 16 to 74,426,48,13,35,122,75,13,22,52,30,13,7,6,51
S01011358,Very good health,240,27,4,23,62,45,8,11,25,13,7,4,3,42
S01011358,Good health,131,13,4,9,48,18,5,6,22,9,3,1,2,7
S01011358,Fair health,39,6,5,1,8,9,0,5,2,5,2,1,1,2
S01011358,Bad health,13,2,0,2,3,2,0,0,3,3,0,0,0,0
S01011358,Very bad health,3,0,0,0,1,1,0,0,0,0,1,1,0,0
S01011359,All people aged 16 to 74,564,27,5,22,93,66,37,56,109,113,40,24,16,23
S01011359,Very good health,211,12,3,9,36,31,13,16,38,37,11,7,4,17
S01011359,Good health,183,9,1,8,38,23,18,20,31,26,15,8,7,3
S01011359,Fair health,102,3,0,3,12,10,5,11,26,29,4,3,1,2
S01011359,Bad health,56,2,1,1,6,1,1,7,12,16,10,6,4,1
S01011359,Very bad health,12,1,0,1,1,1,0,2,2,5,0,0,0,0
S01011360,All people aged 16 to 74,565,8,1,7,55,51,28,49,133,148,56,30,26,37
S01011360,Very good health,236,4,0,4,29,26,8,16,57,48,22,14,8,26
S01011360,Good health,198,2,0,2,17,18,11,22,47,53,19,7,12,9
S01011360,Fair health,74,1,0,1,7,4,4,6,13,28,9,5,4,2
S01011360,Bad health,42,0,0,0,1,3,5,5,11,11,6,4,2,0
S01011360,Very bad health,15,1,1,0,1,0,0,0,5,8,0,0,0,0
S01011361,All people aged 16 to 74,427,7,1,6,27,31,22,34,90,122,76,40,36,18
S01011361,Very good health,125,3,0,3,7,11,7,10,29,32,15,9,6,11
S01011361,Good health,162,3,1,2,14,14,7,11,31,55,25,9,16,2
S01011361,Fair health,100,1,0,1,5,5,6,7,23,22,27,17,10,4
S01011361,Bad health,33,0,0,0,0,1,2,5,6,11,7,4,3,1
S01011361,Very bad health,7,0,0,0,1,0,0,1,1,2,2,1,1,0
S01011362,All people aged 16 to 74,403,38,10,28,99,69,59,39,45,28,4,2,2,22
S01011362,Very good health,233,24,7,17,57,46,25,23,23,15,2,1,1,18
S01011362,Good health,125,10,3,7,34,19,24,12,14,7,2,1,1,3
S01011362,Fair health,31,3,0,3,4,3,7,4,6,3,0,0,0,1
S01011362,Bad health,12,1,0,1,3,1,3,0,1,3,0,0,0,0
S01011362,Very bad health,2,0,0,0,1,0,0,0,1,0,0,0,0,0
S01011363,All people aged 16 to 74,660,39,14,25,135,91,48,54,112,95,54,39,15,32
S01011363,Very good health,268,23,6,17,62,40,19,24,44,23,9,3,6,24
S01011363,Good health,219,12,6,6,53,31,15,16,46,31,14,9,5,1
S01011363,Fair health,103,4,2,2,11,14,10,8,10,26,17,15,2,3
S01011363,Bad health,43,0,0,0,6,5,3,4,6,9,8,6,2,2
S01011363,Very bad health,27,0,0,0,3,1,1,2,6,6,6,6,0,2
S01011364,All people aged 16 to 74,475,26,5,21,111,79,20,46,79,70,17,7,10,27
S01011364,Very good health,228,15,1,14,59,44,9,13,35,27,7,2,5,19
S01011364,Good health,165,6,3,3,41,23,10,16,26,29,7,3,4,7
S01011364,Fair health,47,2,1,1,8,6,0,10,12,6,2,1,1,1
S01011364,Bad health,27,2,0,2,3,5,0,4,6,6,1,1,0,0
S01011364,Very bad health,8,1,0,1,0,1,1,3,0,2,0,0,0,0
S01011365,All people aged 16 to 74,442,34,14,20,147,76,25,34,47,45,11,6,5,23
S01011365,Very good health,267,22,7,15,91,48,17,20,25,20,3,2,1,21
S01011365,Good health,122,8,4,4,42,28,4,8,13,15,3,0,3,1
S01011365,Fair health,36,3,2,1,11,0,2,2,8,6,3,2,1,1
S01011365,Bad health,12,1,1,0,1,0,2,2,0,4,2,2,0,0
S01011365,Very bad health,5,0,0,0,2,0,0,2,1,0,0,0,0,0
S01011366,All people aged 16 to 74,342,14,1,13,57,64,13,31,65,70,19,14,5,9
S01011366,Very good health,129,6,1,5,24,25,8,14,19,22,5,4,1,6
S01011366,Good health,109,6,0,6,20,25,4,8,15,22,7,4,3,2
S01011366,Fair health,69,1,0,1,10,8,1,7,22,15,4,3,1,1
S01011366,Bad health,26,0,0,0,2,4,0,1,8,8,3,3,0,0
S01011366,Very bad health,9,1,0,1,1,2,0,1,1,3,0,0,0,0
S01011367,All people aged 16 to 74,628,31,3,28,99,84,31,64,153,106,26,16,10,34
S01011367,Very good health,261,11,0,11,49,44,7,23,58,32,11,4,7,26
S01011367,Good health,210,14,1,13,32,18,14,28,50,44,3,2,1,7
S01011367,Fair health,88,5,2,3,13,15,5,3,24,14,8,6,2,1
S01011367,Bad health,52,1,0,1,3,5,4,5,19,13,2,2,0,0
S01011367,Very bad health,17,0,0,0,2,2,1,5,2,3,2,2,0,0
S01011368,All people aged 16 to 74,628,64,11,53,212,114,41,46,52,43,15,10,5,41
S01011368,Very good health,428,38,7,31,154,76,28,30,34,26,8,5,3,34
S01011368,Good health,160,24,3,21,48,30,10,15,13,12,3,3,0,5
S01011368,Fair health,29,2,1,1,8,5,2,1,4,4,2,1,1,1
S01011368,Bad health,9,0,0,0,1,2,1,0,1,1,2,1,1,1
S01011368,Very bad health,2,0,0,0,1,1,0,0,0,0,0,0,0,0
S01011369,All people aged 16 to 74,606,16,1,15,96,90,29,63,117,104,40,19,21,51
S01011369,Very good health,278,10,1,9,48,51,11,22,38,42,12,5,7,44
S01011369,Good health,183,4,0,4,33,30,12,24,45,20,12,8,4,3
S01011369,Fair health,102,0,0,0,8,6,4,12,22,32,15,6,9,3
S01011369,Bad health,32,2,0,2,4,3,0,4,9,8,1,0,1,1
S01011369,Very bad health,11,0,0,0,3,0,2,1,3,2,0,0,0,0
S01011370,All people aged 16 to 74,598,67,16,51,169,104,18,51,79,67,16,12,4,27
S01011370,Very good health,362,53,13,40,118,63,11,30,34,24,6,4,2,23
S01011370,Good health,161,10,0,10,42,31,6,12,31,21,4,3,1,4
S01011370,Fair health,54,4,3,1,6,10,0,6,10,15,3,3,0,0
S01011370,Bad health,14,0,0,0,2,0,1,2,2,4,3,2,1,0
S01011370,Very bad health,7,0,0,0,1,0,0,1,2,3,0,0,0,0
S01011371,All people aged 16 to 74,680,17,1,16,106,86,30,65,140,129,67,25,42,40
S01011371,Very good health,300,10,0,10,51,39,13,24,61,53,20,7,13,29
S01011371,Good health,236,3,0,3,37,30,11,23,49,40,32,14,18,11
S01011371,Fair health,97,3,1,2,12,14,4,13,21,19,11,2,9,0
S01011371,Bad health,33,1,0,1,3,3,2,2,7,12,3,1,2,0
S01011371,Very bad health,14,0,0,0,3,0,0,3,2,5,1,1,0,0
S01011372,All people aged 16 to 74,504,9,2,7,52,51,15,52,102,117,72,38,34,34
S01011372,Very good health,172,2,0,2,29,19,7,17,27,35,21,13,8,15
S01011372,Good health,201,5,2,3,15,21,4,22,48,48,24,9,15,14
S01011372,Fair health,86,2,0,2,7,6,3,6,22,15,21,10,11,4
S01011372,Bad health,37,0,0,0,1,4,1,5,4,16,5,5,0,1
S01011372,Very bad health,8,0,0,0,0,1,0,2,1,3,1,1,0,0
S01011373,All people aged 16 to 74,509,14,3,11,59,51,29,41,122,85,52,22,30,56
S01011373,Very good health,192,7,1,6,23,23,12,17,47,21,17,6,11,25
S01011373,Good health,199,3,1,2,25,19,8,14,44,38,19,11,8,29
S01011373,Fair health,73,1,1,0,7,8,3,7,20,12,13,3,10,2
S01011373,Bad health,36,2,0,2,4,1,5,1,9,12,2,1,1,0
S01011373,Very bad health,9,1,0,1,0,0,1,2,2,2,1,1,0,0
S01011374,All people aged 16 to 74,526,31,8,23,124,116,21,45,75,55,18,13,5,41
S01011374,Very good health,263,14,3,11,75,53,13,23,33,14,7,6,1,31
S01011374,Good health,197,16,5,11,40,50,5,18,26,28,5,1,4,9
S01011374,Fair health,42,1,0,1,7,11,2,3,8,8,1,1,0,1
S01011374,Bad health,18,0,0,0,2,2,1,0,8,3,2,2,0,0
S01011374,Very bad health,6,0,0,0,0,0,0,1,0,2,3,3,0,0
S01011375,All people aged 16 to 74,493,41,13,28,89,89,29,44,75,53,23,5,18,50
S01011375,Very good health,238,18,7,11,43,48,15,17,32,19,10,3,7,36
S01011375,Good health,173,16,5,11,29,25,13,19,27,21,10,1,9,13
S01011375,Fair health,58,6,1,5,14,11,1,4,7,11,3,1,2,1
S01011375,Bad health,22,1,0,1,3,5,0,3,8,2,0,0,0,0
S01011375,Very bad health,2,0,0,0,0,0,0,1,1,0,0,0,0,0
S01011376,All people aged 16 to 74,352,10,1,9,54,51,18,31,82,73,19,6,13,14
S01011376,Very good health,132,8,0,8,22,22,7,17,26,17,3,0,3,10
S01011376,Good health,117,1,0,1,23,17,7,5,26,29,6,1,5,3
S01011376,Fair health,70,0,0,0,7,10,3,5,21,18,6,3,3,0
S01011376,Bad health,27,1,1,0,2,1,1,2,8,7,4,2,2,1
S01011376,Very bad health,6,0,0,0,0,1,0,2,1,2,0,0,0,0
S01011377,All people aged 16 to 74,451,77,13,64,148,79,30,16,30,20,11,7,4,40
S01011377,Very good health,260,52,10,42,86,40,19,7,12,10,2,0,2,32
S01011377,Good health,140,20,3,17,44,30,10,6,12,6,4,2,2,8
S01011377,Fair health,34,4,0,4,11,4,0,3,6,3,3,3,0,0
S01011377,Bad health,15,0,0,0,7,5,1,0,0,1,1,1,0,0
S01011377,Very bad health,2,1,0,1,0,0,0,0,0,0,1,1,0,0
S01011378,All people aged 16 to 74,570,45,17,28,125,122,33,41,95,53,18,9,9,38
S01011378,Very good health,246,24,11,13,65,51,12,15,27,14,5,1,4,33
S01011378,Good health,204,13,4,9,38,46,15,18,45,18,8,5,3,3
S01011378,Fair health,105,8,2,6,18,24,6,6,20,16,5,3,2,2
S01011378,Bad health,9,0,0,0,4,0,0,0,3,2,0,0,0,0
S01011378,Very bad health,6,0,0,0,0,1,0,2,0,3,0,0,0,0
S01011379,All people aged 16 to 74,703,88,12,76,214,140,43,37,54,43,11,5,6,73
S01011379,Very good health,406,58,7,51,131,73,20,20,25,15,3,1,2,61
S01011379,Good health,229,25,5,20,65,57,19,12,19,20,3,1,2,9
S01011379,Fair health,48,4,0,4,11,7,3,4,7,6,3,1,2,3
S01011379,Bad health,14,1,0,1,4,2,1,1,2,2,1,1,0,0
S01011379,Very bad health,6,0,0,0,3,1,0,0,1,0,1,1,0,0
S01011380,All people aged 16 to 74,525,39,7,32,97,115,26,42,67,76,33,25,8,30
S01011380,Very good health,238,21,5,16,58,56,8,13,21,31,8,5,3,22
S01011380,Good health,188,13,1,12,20,41,18,17,33,29,12,10,2,5
S01011380,Fair health,71,5,1,4,14,13,0,9,8,11,10,8,2,1
S01011380,Bad health,21,0,0,0,5,3,0,2,4,3,2,1,1,2
S01011380,Very bad health,7,0,0,0,0,2,0,1,1,2,1,1,0,0
S01011381,All people aged 16 to 74,482,34,8,26,116,99,30,33,68,48,20,8,12,34
S01011381,Very good health,251,23,2,21,76,52,14,15,23,11,8,1,7,29
S01011381,Good health,143,9,4,5,31,30,11,12,27,15,5,3,2,3
S01011381,Fair health,62,1,1,0,7,14,5,4,12,13,4,3,1,2
S01011381,Bad health,20,0,0,0,1,2,0,2,6,7,2,0,2,0
S01011381,Very bad health,6,1,1,0,1,1,0,0,0,2,1,1,0,0
S01011382,All people aged 16 to 74,422,19,6,13,80,39,33,30,74,84,30,18,12,33
S01011382,Very good health,203,16,6,10,44,20,16,12,25,35,10,7,3,25
S01011382,Good health,116,2,0,2,27,12,10,9,28,18,3,1,2,7
S01011382,Fair health,53,1,0,1,6,3,4,7,9,16,6,3,3,1
S01011382,Bad health,37,0,0,0,0,3,2,1,9,11,11,7,4,0
S01011382,Very bad health,13,0,0,0,3,1,1,1,3,4,0,0,0,0
S01011383,All people aged 16 to 74,523,7,0,7,55,61,12,39,128,134,59,32,27,28
S01011383,Very good health,181,2,0,2,22,34,4,12,47,27,13,3,10,20
S01011383,Good health,131,2,0,2,9,11,3,13,30,37,18,8,10,8
S01011383,Fair health,110,0,0,0,19,11,4,9,18,33,16,10,6,0
S01011383,Bad health,78,1,0,1,4,5,0,5,23,30,10,9,1,0
S01011383,Very bad health,23,2,0,2,1,0,1,0,10,7,2,2,0,0
S01011384,All people aged 16 to 74,502,6,0,6,39,34,25,32,119,131,96,55,41,20
S01011384,Very good health,190,1,0,1,21,18,6,13,43,39,35,21,14,14
S01011384,Good health,149,3,0,3,11,7,10,9,38,41,25,9,16,5
S01011384,Fair health,101,1,0,1,6,7,4,7,25,26,24,14,10,1
S01011384,Bad health,49,1,0,1,1,1,4,3,10,19,10,9,1,0
S01011384,Very bad health,13,0,0,0,0,1,1,0,3,6,2,2,0,0
S01011385,All people aged 16 to 74,702,15,2,13,69,68,33,72,142,188,74,43,31,41
S01011385,Very good health,282,6,1,5,34,23,13,31,54,70,22,14,8,29
S01011385,Good health,219,7,1,6,19,29,11,16,49,53,25,9,16,10
S01011385,Fair health,115,1,0,1,10,13,4,15,22,33,16,10,6,1
S01011385,Bad health,58,1,0,1,3,2,3,8,11,22,8,7,1,0
S01011385,Very bad health,28,0,0,0,3,1,2,2,6,10,3,3,0,1
S01011386,All people aged 16 to 74,403,6,4,2,23,26,14,47,103,87,76,44,32,21
S01011386,Very good health,172,5,4,1,11,9,9,16,47,34,25,16,9,16
S01011386,Good health,125,1,0,1,10,12,3,20,24,25,26,9,17,4
S01011386,Fair health,66,0,0,0,1,2,2,8,21,15,16,12,4,1
S01011386,Bad health,31,0,0,0,1,2,0,1,8,12,7,5,2,0
S01011386,Very bad health,9,0,0,0,0,1,0,2,3,1,2,2,0,0
S01011387,All people aged 16 to 74,608,34,5,29,65,58,21,44,133,139,89,54,35,25
S01011387,Very good health,248,21,5,16,39,24,7,14,51,43,31,19,12,18
S01011387,Good health,194,10,0,10,16,18,8,21,41,40,34,17,17,6
S01011387,Fair health,93,2,0,2,7,11,3,5,25,22,18,13,5,0
S01011387,Bad health,59,1,0,1,2,5,2,3,13,27,5,4,1,1
S01011387,Very bad health,14,0,0,0,1,0,1,1,3,7,1,1,0,0
S01011388,All people aged 16 to 74,797,57,19,38,216,131,37,76,107,87,28,16,12,58
S01011388,Very good health,434,39,15,24,140,71,21,38,41,34,9,5,4,41
S01011388,Good health,239,13,2,11,60,37,11,25,41,30,7,2,5,15
S01011388,Fair health,89,4,2,2,8,16,4,8,21,16,11,8,3,1
S01011388,Bad health,32,1,0,1,7,7,1,4,4,6,1,1,0,1
S01011388,Very bad health,3,0,0,0,1,0,0,1,0,1,0,0,0,0
S01011389,All people aged 16 to 74,590,20,6,14,92,84,35,46,101,109,49,32,17,54
S01011389,Very good health,254,12,3,9,45,42,16,16,35,45,17,12,5,26
S01011389,Good health,181,5,3,2,34,28,13,17,35,28,18,10,8,3
S01011389,Fair health,107,3,0,3,8,7,5,10,20,18,11,7,4,25
S01011389,Bad health,38,0,0,0,3,6,1,1,10,15,2,2,0,0
S01011389,Very bad health,10,0,0,0,2,1,0,2,1,3,1,1,0,0
S01011390,All people aged 16 to 74,609,20,7,13,72,70,18,67,138,141,50,28,22,33
S01011390,Very good health,244,10,4,6,37,30,7,23,53,49,10,5,5,25
S01011390,Good health,202,9,3,6,18,24,8,20,52,45,20,6,14,6
S01011390,Fair health,96,1,0,1,15,13,3,13,18,23,8,6,2,2
S01011390,Bad health,51,0,0,0,1,2,0,8,13,18,9,8,1,0
S01011390,Very bad health,16,0,0,0,1,1,0,3,2,6,3,3,0,0
S01011391,All people aged 16 to 74,484,8,4,4,57,52,22,35,133,105,33,21,12,39
S01011391,Very good health,178,3,1,2,23,16,9,12,44,34,10,6,4,27
S01011391,Good health,189,4,3,1,23,24,8,12,54,40,14,7,7,10
S01011391,Fair health,87,0,0,0,4,7,3,6,31,25,9,8,1,2
S01011391,Bad health,27,1,0,1,6,5,2,4,3,6,0,0,0,0
S01011391,Very bad health,3,0,0,0,1,0,0,1,1,0,0,0,0,0
S01011392,All people aged 16 to 74,511,7,2,5,46,45,29,59,125,103,60,28,32,37
S01011392,Very good health,201,2,0,2,17,25,16,22,43,33,17,10,7,26
S01011392,Good health,194,4,1,3,18,8,11,24,53,39,27,9,18,10
S01011392,Fair health,79,1,1,0,5,9,1,10,20,21,11,5,6,1
S01011392,Bad health,27,0,0,0,5,1,1,2,7,7,4,3,1,0
S01011392,Very bad health,10,0,0,0,1,2,0,1,2,3,1,1,0,0
S01011393,All people aged 16 to 74,603,19,7,12,88,90,56,62,117,104,31,13,18,36
S01011393,Very good health,239,9,3,6,46,38,26,19,32,33,8,4,4,28
S01011393,Good health,216,8,3,5,28,34,18,25,50,33,13,2,11,7
S01011393,Fair health,96,2,1,1,11,14,8,8,18,26,9,6,3,0
S01011393,Bad health,33,0,0,0,2,3,2,7,9,9,1,1,0,0
S01011393,Very bad health,19,0,0,0,1,1,2,3,8,3,0,0,0,1
S01011394,All people aged 16 to 74,399,60,15,45,96,71,25,30,35,34,9,5,4,39
S01011394,Very good health,241,38,11,27,62,49,14,15,17,10,2,0,2,34
S01011394,Good health,117,17,3,14,32,15,7,9,11,18,4,2,2,4
S01011394,Fair health,34,5,1,4,0,6,4,6,5,4,3,3,0,1
S01011394,Bad health,7,0,0,0,2,1,0,0,2,2,0,0,0,0
S01011394,Very bad health,0,0,0,0,0,0,0,0,0,0,0,0,0,0
S01011395,All people aged 16 to 74,567,20,3,17,101,77,34,54,121,104,39,26,13,17
S01011395,Very good health,228,13,1,12,54,34,10,19,36,35,11,6,5,16
S01011395,Good health,176,5,2,3,31,25,15,21,42,26,10,6,4,1
S01011395,Fair health,95,2,0,2,10,11,4,10,20,22,16,12,4,0
S01011395,Bad health,50,0,0,0,4,6,4,3,16,16,1,1,0,0
S01011395,Very bad health,18,0,0,0,2,1,1,1,7,5,1,1,0,0
S01011396,All people aged 16 to 74,555,24,8,16,104,86,27,46,111,78,44,30,14,35
S01011396,Very good health,227,9,3,6,47,42,13,18,46,18,8,4,4,26
S01011396,Good health,175,8,2,6,34,23,9,16,31,28,18,11,7,8
S01011396,Fair health,94,6,2,4,15,17,3,8,21,17,6,5,1,1
S01011396,Bad health,43,1,1,0,5,3,1,2,11,12,8,7,1,0
S01011396,Very bad health,16,0,0,0,3,1,1,2,2,3,4,3,1,0
S01011397,All people aged 16 to 74,548,23,7,16,103,65,30,60,85,91,48,30,18,43
S01011397,Very good health,252,14,5,9,58,33,10,20,33,28,20,11,9,36
S01011397,Good health,161,4,1,3,29,25,8,20,28,31,10,4,6,6
S01011397,Fair health,87,3,1,2,9,5,6,12,17,22,12,9,3,1
S01011397,Bad health,30,2,0,2,5,2,6,4,4,5,2,2,0,0
S01011397,Very bad health,18,0,0,0,2,0,0,4,3,5,4,4,0,0
S01011398,All people aged 16 to 74,540,8,1,7,66,59,25,59,102,120,72,39,33,29
S01011398,Very good health,205,6,0,6,31,25,13,20,30,39,19,12,7,22
S01011398,Good health,181,0,0,0,23,18,8,21,39,39,27,10,17,6
S01011398,Fair health,80,0,0,0,7,9,1,8,14,26,14,7,7,1
S01011398,Bad health,48,2,1,1,3,4,2,6,12,8,11,9,2,0
S01011398,Very bad health,26,0,0,0,2,3,1,4,7,8,1,1,0,0
S01011399,All people aged 16 to 74,391,10,2,8,39,56,16,35,92,86,37,21,16,20
S01011399,Very good health,153,3,1,2,19,34,6,11,39,19,9,4,5,13
S01011399,Good health,133,4,1,3,16,11,4,9,31,39,14,7,7,5
S01011399,Fair health,67,3,0,3,2,7,4,7,17,16,9,6,3,2
S01011399,Bad health,33,0,0,0,2,2,2,6,4,12,5,4,1,0
S01011399,Very bad health,5,0,0,0,0,2,0,2,1,0,0,0,0,0
S01011400,All people aged 16 to 74,529,43,11,32,128,91,30,32,81,66,28,14,14,30
S01011400,Very good health,250,25,5,20,73,47,10,16,28,15,10,4,6,26
S01011400,Good health,167,14,5,9,42,34,10,7,24,28,7,1,6,1
S01011400,Fair health,69,3,0,3,8,7,4,7,14,17,7,6,1,2
S01011400,Bad health,30,1,1,0,3,3,3,1,12,3,3,2,1,1
S01011400,Very bad health,13,0,0,0,2,0,3,1,3,3,1,1,0,0
S01011401,All people aged 16 to 74,471,32,13,19,123,78,24,33,60,63,25,22,3,33
S01011401,Very good health,204,17,7,10,54,35,9,18,24,15,8,6,2,24
S01011401,Good health,156,13,6,7,45,28,10,5,19,23,5,5,0,8
S01011401,Fair health,72,1,0,1,16,11,3,6,12,16,6,5,1,1
S01011401,Bad health,29,1,0,1,7,4,1,3,4,5,4,4,0,0
S01011401,Very bad health,10,0,0,0,1,0,1,1,1,4,2,2,0,0
S01011402,All people aged 16 to 74,647,42,11,31,116,117,44,66,115,89,32,18,14,26
S01011402,Very good health,249,23,6,17,51,52,13,23,38,21,10,4,6,18
S01011402,Good health,249,14,4,10,37,45,17,32,50,34,13,7,6,7
S01011402,Fair health,99,5,1,4,16,13,10,10,15,25,4,2,2,1
S01011402,Bad health,36,0,0,0,6,6,4,0,10,8,2,2,0,0
S01011402,Very bad health,14,0,0,0,6,1,0,1,2,1,3,3,0,0
S01011403,All people aged 16 to 74,400,20,6,14,79,56,17,35,64,67,30,23,7,32
S01011403,Very good health,183,16,5,11,42,30,3,11,27,19,9,7,2,26
S01011403,Good health,132,4,1,3,28,20,7,15,19,25,8,4,4,6
S01011403,Fair health,54,0,0,0,7,4,5,7,12,12,7,6,1,0
S01011403,Bad health,25,0,0,0,2,2,2,1,4,8,6,6,0,0
S01011403,Very bad health,6,0,0,0,0,0,0,1,2,3,0,0,0,0
S01011404,All people aged 16 to 74,710,25,5,20,130,109,30,53,139,127,50,30,20,47
S01011404,Very good health,303,13,1,12,62,45,16,19,56,39,20,12,8,33
S01011404,Good health,213,11,4,7,39,42,7,13,32,42,15,8,7,12
S01011404,Fair health,122,1,0,1,20,13,5,13,29,28,11,6,5,2
S01011404,Bad health,53,0,0,0,7,7,1,4,21,10,3,3,0,0
S01011404,Very bad health,19,0,0,0,2,2,1,4,1,8,1,1,0,0
S01011405,All people aged 16 to 74,443,41,11,30,105,69,24,33,66,46,42,29,13,17
S01011405,Very good health,219,31,9,22,57,27,8,16,31,18,14,11,3,17
S01011405,Good health,142,8,2,6,38,32,12,10,13,18,11,6,5,0
S01011405,Fair health,56,2,0,2,3,9,3,4,19,5,11,7,4,0
S01011405,Bad health,18,0,0,0,5,1,0,1,1,4,6,5,1,0
S01011405,Very bad health,8,0,0,0,2,0,1,2,2,1,0,0,0,0
S01011406,All people aged 16 to 74,475,18,7,11,89,53,25,44,101,93,26,14,12,26
S01011406,Very good health,214,8,3,5,46,29,13,17,36,34,12,6,6,19
S01011406,Good health,162,7,3,4,33,20,9,13,44,26,7,3,4,3
S01011406,Fair health,70,3,1,2,9,4,3,7,13,22,6,4,2,3
S01011406,Bad health,24,0,0,0,1,0,0,6,5,11,0,0,0,1
S01011406,Very bad health,5,0,0,0,0,0,0,1,3,0,1,1,0,0
S01011407,All people aged 16 to 74,807,41,9,32,183,142,52,61,110,127,40,20,20,51
S01011407,Very good health,383,30,7,23,85,78,21,26,43,50,14,6,8,36
S01011407,Good health,279,8,1,7,69,48,20,24,44,44,13,6,7,9
S01011407,Fair health,95,2,1,1,20,12,9,5,12,20,10,5,5,5
S01011407,Bad health,39,1,0,1,7,3,2,5,7,10,3,3,0,1
S01011407,Very bad health,11,0,0,0,2,1,0,1,4,3,0,0,0,0
S01011408,All people aged 16 to 74,589,11,4,7,72,79,24,47,157,123,37,19,18,39
S01011408,Very good health,251,5,2,3,36,31,12,16,58,44,19,7,12,30
S01011408,Good health,208,4,1,3,25,35,9,13,61,46,8,6,2,7
S01011408,Fair health,85,2,1,1,7,9,3,12,26,20,4,0,4,2
S01011408,Bad health,38,0,0,0,3,4,0,6,11,10,4,4,0,0
S01011408,Very bad health,7,0,0,0,1,0,0,0,1,3,2,2,0,0
S01011409,All people aged 16 to 74,587,17,1,16,87,74,32,51,120,114,50,29,21,42
S01011409,Very good health,233,11,1,10,30,36,8,15,41,39,21,10,11,32
S01011409,Good health,192,5,0,5,34,19,14,21,40,36,14,8,6,9
S01011409,Fair health,95,1,0,1,13,14,4,9,28,18,7,3,4,1
S01011409,Bad health,55,0,0,0,10,5,5,5,7,18,5,5,0,0
S01011409,Very bad health,12,0,0,0,0,0,1,1,4,3,3,3,0,0
S01011410,All people aged 16 to 74,455,14,1,13,66,80,19,44,107,86,20,11,9,19
S01011410,Very good health,209,8,1,7,37,38,11,19,44,34,5,3,2,13
S01011410,Good health,156,6,0,6,22,34,7,12,40,22,8,2,6,5
S01011410,Fair health,57,0,0,0,4,6,1,8,14,18,5,4,1,1
S01011410,Bad health,26,0,0,0,3,2,0,4,8,8,1,1,0,0
S01011410,Very bad health,7,0,0,0,0,0,0,1,1,4,1,1,0,0
S01011411,All people aged 16 to 74,470,13,3,10,72,69,25,48,98,91,27,12,15,27
S01011411,Very good health,226,5,1,4,37,36,11,19,43,45,10,5,5,20
S01011411,Good health,156,6,1,5,22,24,9,22,39,19,12,4,8,3
S01011411,Fair health,62,1,0,1,9,6,3,6,13,16,4,2,2,4
S01011411,Bad health,19,1,1,0,2,1,1,1,3,9,1,1,0,0
S01011411,Very bad health,7,0,0,0,2,2,1,0,0,2,0,0,0,0
S01011412,All people aged 16 to 74,659,61,20,41,198,113,49,48,83,41,21,12,9,45
S01011412,Very good health,338,31,9,22,112,53,26,25,28,18,7,4,3,38
S01011412,Good health,227,24,9,15,64,44,15,13,36,16,8,4,4,7
S01011412,Fair health,70,5,2,3,18,13,5,8,11,6,4,2,2,0
S01011412,Bad health,22,1,0,1,4,3,3,2,6,1,2,2,0,0
S01011412,Very bad health,2,0,0,0,0,0,0,0,2,0,0,0,0,0
S01011413,All people aged 16 to 74,445,28,6,22,108,87,24,31,59,47,13,10,3,48
S01011413,Very good health,245,15,4,11,60,52,11,12,27,22,4,3,1,42
S01011413,Good health,147,10,1,9,35,25,6,17,25,19,4,3,1,6
S01011413,Fair health,43,2,0,2,12,8,7,2,4,4,4,3,1,0
S01011413,Bad health,6,0,0,0,0,1,0,0,2,2,1,1,0,0
S01011413,Very bad health,4,1,1,0,1,1,0,0,1,0,0,0,0,0
S01011414,All people aged 16 to 74,605,26,6,20,98,98,27,67,101,104,49,30,19,35
S01011414,Very good health,250,12,4,8,42,47,15,26,36,27,16,9,7,29
S01011414,Good health,230,8,1,7,43,33,9,30,44,39,18,10,8,6
S01011414,Fair health,92,5,1,4,9,15,3,8,14,27,11,7,4,0
S01011414,Bad health,26,1,0,1,4,1,0,3,6,8,3,3,0,0
S01011414,Very bad health,7,0,0,0,0,2,0,0,1,3,1,1,0,0
S01011415,All people aged 16 to 74,667,39,12,27,148,112,36,56,109,101,29,15,14,37
S01011415,Very good health,317,23,7,16,74,57,17,26,44,35,11,7,4,30
S01011415,Good health,217,12,3,9,49,42,8,16,41,37,5,4,1,7
S01011415,Fair health,89,2,0,2,18,7,8,9,16,20,9,2,7,0
S01011415,Bad health,36,2,2,0,6,3,2,4,7,8,4,2,2,0
S01011415,Very bad health,8,0,0,0,1,3,1,1,1,1,0,0,0,0
S01011416,All people aged 16 to 74,517,35,8,27,141,99,37,54,59,39,16,12,4,37
S01011416,Very good health,280,21,4,17,80,47,17,28,30,16,6,4,2,35
S01011416,Good health,158,12,4,8,47,39,10,14,18,13,3,3,0,2
S01011416,Fair health,59,1,0,1,11,11,7,9,10,5,5,3,2,0
S01011416,Bad health,19,1,0,1,3,2,2,3,1,5,2,2,0,0
S01011416,Very bad health,1,0,0,0,0,0,1,0,0,0,0,0,0,0
S01011417,All people aged 16 to 74,594,20,4,16,93,99,43,64,106,109,29,17,12,31
S01011417,Very good health,251,8,0,8,46,43,18,28,38,39,9,4,5,22
S01011417,Good health,186,12,4,8,26,36,19,15,33,32,6,3,3,7
S01011417,Fair health,107,0,0,0,16,15,5,14,21,29,5,4,1,2
S01011417,Bad health,40,0,0,0,5,4,1,5,10,7,8,5,3,0
S01011417,Very bad health,10,0,0,0,0,1,0,2,4,2,1,1,0,0
S01011418,All people aged 16 to 74,429,11,3,8,53,44,17,47,100,101,28,13,15,28
S01011418,Very good health,164,6,2,4,19,20,9,19,39,27,7,1,6,18
S01011418,Good health,132,3,1,2,17,19,6,12,30,26,12,5,7,7
S01011418,Fair health,77,1,0,1,10,3,0,12,21,23,6,4,2,1
S01011418,Bad health,43,1,0,1,7,2,2,2,7,18,3,3,0,1
S01011418,Very bad health,13,0,0,0,0,0,0,2,3,7,0,0,0,1
S01011419,All people aged 16 to 74,425,19,1,18,60,72,16,47,74,89,29,17,12,19
S01011419,Very good health,168,11,0,11,26,37,4,16,26,28,4,3,1,16
S01011419,Good health,130,4,0,4,23,19,6,13,24,31,9,4,5,1
S01011419,Fair health,79,3,1,2,5,12,4,10,17,19,8,5,3,1
S01011419,Bad health,37,1,0,1,4,2,2,7,5,9,7,4,3,0
S01011419,Very bad health,11,0,0,0,2,2,0,1,2,2,1,1,0,1
S01011420,All people aged 16 to 74,380,10,1,9,41,33,19,28,84,93,42,23,19,30
S01011420,Very good health,156,8,1,7,15,13,4,9,31,39,16,10,6,21
S01011420,Good health,119,1,0,1,16,15,10,5,25,20,18,6,12,9
S01011420,Fair health,64,1,0,1,7,4,3,12,15,18,4,3,1,0
S01011420,Bad health,30,0,0,0,1,0,1,2,9,13,4,4,0,0
S01011420,Very bad health,11,0,0,0,2,1,1,0,4,3,0,0,0,0
S01011421,All people aged 16 to 74,441,32,10,22,127,77,22,41,54,41,32,21,11,15
S01011421,Very good health,236,14,3,11,82,39,8,24,27,23,10,3,7,9
S01011421,Good health,138,12,5,7,33,25,9,11,19,10,13,11,2,6
S01011421,Fair health,46,4,1,3,10,11,2,3,6,6,4,3,1,0
S01011421,Bad health,13,0,0,0,1,1,1,3,2,2,3,2,1,0
S01011421,Very bad health,8,2,1,1,1,1,2,0,0,0,2,2,0,0
S01011422,All people aged 16 to 74,505,18,3,15,67,61,21,46,105,119,41,23,18,27
S01011422,Very good health,180,11,1,10,23,26,6,19,34,23,18,6,12,20
S01011422,Good health,179,6,2,4,25,21,13,15,28,50,15,9,6,6
S01011422,Fair health,91,1,0,1,15,8,2,10,23,28,3,3,0,1
S01011422,Bad health,47,0,0,0,4,4,0,2,16,16,5,5,0,0
S01011422,Very bad health,8,0,0,0,0,2,0,0,4,2,0,0,0,0
S01011423,All people aged 16 to 74,381,19,3,16,54,34,12,29,78,77,60,41,19,18
S01011423,Very good health,145,8,1,7,32,12,5,13,22,21,17,9,8,15
S01011423,Good health,125,5,1,4,13,11,5,7,29,27,25,17,8,3
S01011423,Fair health,63,5,0,5,6,8,1,6,13,15,9,7,2,0
S01011423,Bad health,41,1,1,0,3,3,1,2,12,11,8,7,1,0
S01011423,Very bad health,7,0,0,0,0,0,0,1,2,3,1,1,0,0
S01011424,All people aged 16 to 74,424,8,2,6,64,55,22,49,86,99,25,14,11,16
S01011424,Very good health,180,3,0,3,32,24,9,22,39,34,6,3,3,11
S01011424,Good health,144,3,1,2,19,18,10,15,25,38,12,4,8,4
S01011424,Fair health,59,2,1,1,11,6,3,5,16,14,2,2,0,0
S01011424,Bad health,32,0,0,0,2,6,0,6,5,8,4,4,0,1
S01011424,Very bad health,9,0,0,0,0,1,0,1,1,5,1,1,0,0
S01011425,All people aged 16 to 74,640,30,8,22,117,64,45,57,114,102,62,39,23,49
S01011425,Very good health,261,9,1,8,53,34,17,24,44,26,24,11,13,30
S01011425,Good health,231,16,5,11,47,19,21,15,41,32,25,16,9,15
S01011425,Fair health,91,3,2,1,10,8,4,12,11,31,8,7,1,4
S01011425,Bad health,47,2,0,2,7,3,2,6,12,12,3,3,0,0
S01011425,Very bad health,10,0,0,0,0,0,1,0,6,1,2,2,0,0
S01011426,All people aged 16 to 74,719,85,16,69,198,97,74,58,76,65,15,8,7,51
S01011426,Very good health,430,53,8,45,125,58,50,35,39,26,5,1,4,39
S01011426,Good health,208,23,6,17,57,34,18,16,22,25,1,0,1,12
S01011426,Fair health,60,8,2,6,13,3,4,5,12,9,6,4,2,0
S01011426,Bad health,16,1,0,1,3,2,1,1,3,4,1,1,0,0
S01011426,Very bad health,5,0,0,0,0,0,1,1,0,1,2,2,0,0
S01011427,All people aged 16 to 74,524,22,3,19,99,57,39,44,94,111,25,14,11,33
S01011427,Very good health,224,14,3,11,57,13,12,18,43,30,10,8,2,27
S01011427,Good health,156,7,0,7,24,19,12,12,29,38,9,2,7,6
S01011427,Fair health,91,1,0,1,12,20,7,6,16,25,4,2,2,0
S01011427,Bad health,39,0,0,0,5,3,6,4,6,13,2,2,0,0
S01011427,Very bad health,14,0,0,0,1,2,2,4,0,5,0,0,0,0
S01011428,All people aged 16 to 74,387,17,6,11,62,51,21,42,65,90,20,14,6,19
S01011428,Very good health,138,7,4,3,26,19,7,16,21,24,3,3,0,15
S01011428,Good health,137,7,1,6,24,19,7,17,16,35,9,6,3,3
S01011428,Fair health,75,2,1,1,9,10,3,7,21,17,5,2,3,1
S01011428,Bad health,25,1,0,1,2,2,1,2,6,9,2,2,0,0
S01011428,Very bad health,12,0,0,0,1,1,3,0,1,5,1,1,0,0
S01011429,All people aged 16 to 74,1021,48,11,37,152,72,108,116,136,217,110,106,4,62
S01011429,Very good health,426,26,5,21,76,28,42,42,58,81,34,34,0,39
S01011429,Good health,372,19,5,14,52,32,47,38,51,79,38,35,3,16
S01011429,Fair health,170,3,1,2,20,5,13,30,19,44,31,30,1,5
S01011429,Bad health,32,0,0,0,2,5,3,4,4,7,5,5,0,2
S01011429,Very bad health,21,0,0,0,2,2,3,2,4,6,2,2,0,0
S01011430,All people aged 16 to 74,680,43,8,35,137,108,51,54,116,103,28,17,11,40
S01011430,Very good health,336,27,4,23,77,61,21,28,43,42,8,5,3,29
S01011430,Good health,245,10,2,8,50,36,23,21,44,33,17,10,7,11
S01011430,Fair health,61,6,2,4,7,9,5,4,15,14,1,1,0,0
S01011430,Bad health,32,0,0,0,3,1,2,1,13,11,1,1,0,0
S01011430,Very bad health,6,0,0,0,0,1,0,0,1,3,1,0,1,0
S01011431,All people aged 16 to 74,798,29,10,19,118,89,44,80,166,161,52,31,21,59
S01011431,Very good health,321,14,5,9,48,41,18,36,55,52,12,5,7,45
S01011431,Good health,254,12,5,7,41,28,17,27,44,52,20,8,12,13
S01011431,Fair health,134,2,0,2,21,13,5,12,38,33,10,8,2,0
S01011431,Bad health,76,1,0,1,7,6,4,4,26,20,7,7,0,1
S01011431,Very bad health,13,0,0,0,1,1,0,1,3,4,3,3,0,0
S01011432,All people aged 16 to 74,819,21,9,12,127,120,30,88,166,183,44,22,22,40
S01011432,Very good health,334,8,1,7,52,55,11,27,70,70,14,5,9,27
S01011432,Good health,298,7,5,2,56,38,15,36,62,61,14,7,7,9
S01011432,Fair health,126,4,2,2,13,17,3,17,24,33,12,7,5,3
S01011432,Bad health,48,2,1,1,5,8,1,6,10,13,2,1,1,1
S01011432,Very bad health,13,0,0,0,1,2,0,2,0,6,2,2,0,0
S01011433,All people aged 16 to 74,640,11,3,8,49,62,23,56,149,163,80,45,35,47
S01011433,Very good health,286,5,1,4,24,26,9,28,62,67,36,20,16,29
S01011433,Good health,217,4,2,2,19,23,11,14,52,57,21,9,12,16
S01011433,Fair health,83,2,0,2,3,9,0,9,24,19,16,9,7,1
S01011433,Bad health,43,0,0,0,2,3,3,4,9,16,6,6,0,0
S01011433,Very bad health,11,0,0,0,1,1,0,1,2,4,1,1,0,1
S01011434,All people aged 16 to 74,423,15,6,9,85,65,24,45,81,71,19,11,8,18
S01011434,Very good health,185,4,2,2,45,35,10,23,18,31,5,3,2,14
S01011434,Good health,130,9,3,6,26,20,6,9,30,19,10,4,6,1
S01011434,Fair health,82,1,0,1,10,10,7,8,25,16,2,2,0,3
S01011434,Bad health,19,1,1,0,2,0,1,2,6,5,2,2,0,0
S01011434,Very bad health,7,0,0,0,2,0,0,3,2,0,0,0,0,0
S01011435,All people aged 16 to 74,712,51,17,34,191,105,48,56,96,83,23,13,10,59
S01011435,Very good health,379,36,13,23,97,65,22,25,49,26,8,4,4,51
S01011435,Good health,217,9,3,6,66,30,15,20,28,37,4,3,1,8
S01011435,Fair health,73,5,1,4,18,8,8,6,11,12,5,2,3,0
S01011435,Bad health,32,0,0,0,7,2,2,5,6,4,6,4,2,0
S01011435,Very bad health,11,1,0,1,3,0,1,0,2,4,0,0,0,0
S01011436,All people aged 16 to 74,544,9,1,8,76,66,33,47,117,118,53,24,29,25
S01011436,Very good health,222,7,0,7,33,33,21,15,45,35,18,7,11,15
S01011436,Good health,181,1,1,0,27,22,6,22,42,38,14,5,9,9
S01011436,Fair health,95,1,0,1,12,9,6,3,25,27,12,3,9,0
S01011436,Bad health,33,0,0,0,2,1,0,5,3,15,6,6,0,1
S01011436,Very bad health,13,0,0,0,2,1,0,2,2,3,3,3,0,0
S01011437,All people aged 16 to 74,552,15,5,10,70,63,36,59,114,120,46,31,15,29
S01011437,Very good health,228,9,2,7,33,23,17,30,44,36,15,9,6,21
S01011437,Good health,164,5,2,3,27,23,11,18,30,29,14,10,4,7
S01011437,Fair health,96,0,0,0,3,10,5,10,25,29,13,9,4,1
S01011437,Bad health,46,0,0,0,7,6,2,0,13,16,2,2,0,0
S01011437,Very bad health,18,1,1,0,0,1,1,1,2,10,2,1,1,0
S01011438,All people aged 16 to 74,406,4,2,2,32,36,20,39,111,95,52,35,17,17
S01011438,Very good health,155,1,1,0,9,19,6,20,44,26,18,14,4,12
S01011438,Good health,145,2,1,1,17,9,7,10,39,36,23,13,10,2
S01011438,Fair health,64,1,0,1,5,5,5,7,15,17,6,4,2,3
S01011438,Bad health,33,0,0,0,1,3,1,2,9,13,4,3,1,0
S01011438,Very bad health,9,0,0,0,0,0,1,0,4,3,1,1,0,0
S01011439,All people aged 16 to 74,657,24,6,18,107,70,51,63,124,137,50,31,19,31
S01011439,Very good health,291,10,2,8,59,24,26,30,55,48,15,7,8,24
S01011439,Good health,196,8,2,6,19,27,16,20,40,47,13,6,7,6
S01011439,Fair health,109,5,2,3,16,16,6,7,22,25,12,10,2,0
S01011439,Bad health,39,0,0,0,10,2,2,4,4,9,8,6,2,0
S01011439,Very bad health,22,1,0,1,3,1,1,2,3,8,2,2,0,1
S01011440,All people aged 16 to 74,443,10,2,8,41,58,21,47,109,124,22,13,9,11
S01011440,Very good health,173,5,2,3,18,23,5,21,36,47,8,5,3,10
S01011440,Good health,146,4,0,4,12,22,12,15,42,32,6,3,3,1
S01011440,Fair health,80,1,0,1,5,9,2,6,22,31,4,1,3,0
S01011440,Bad health,36,0,0,0,5,4,2,4,5,12,4,4,0,0
S01011440,Very bad health,8,0,0,0,1,0,0,1,4,2,0,0,0,0
S01011441,All people aged 16 to 74,603,15,5,10,62,75,33,56,141,138,58,28,30,25
S01011441,Very good health,242,8,3,5,28,37,12,17,52,50,21,13,8,17
S01011441,Good health,189,6,1,5,21,28,9,18,42,43,17,5,12,5
S01011441,Fair health,117,1,1,0,9,8,7,12,32,29,17,9,8,2
S01011441,Bad health,39,0,0,0,2,0,3,7,10,14,3,1,2,0
S01011441,Very bad health,16,0,0,0,2,2,2,2,5,2,0,0,0,1
S01011442,All people aged 16 to 74,492,6,2,4,50,77,35,50,94,119,27,16,11,34
S01011442,Very good health,201,4,1,3,23,35,13,18,38,34,10,4,6,26
S01011442,Good health,139,2,1,1,14,26,13,16,26,32,4,3,1,6
S01011442,Fair health,102,0,0,0,10,11,7,10,23,31,9,6,3,1
S01011442,Bad health,38,0,0,0,3,4,2,3,5,17,3,3,0,1
S01011442,Very bad health,12,0,0,0,0,1,0,3,2,5,1,0,1,0
S01011443,All people aged 16 to 74,464,14,7,7,53,52,26,43,94,116,23,12,11,43
S01011443,Very good health,170,7,5,2,19,16,7,15,33,36,3,2,1,34
S01011443,Good health,154,5,2,3,18,23,11,12,27,38,11,5,6,9
S01011443,Fair health,87,2,0,2,9,10,4,8,21,27,6,2,4,0
S01011443,Bad health,42,0,0,0,5,2,4,6,12,10,3,3,0,0
S01011443,Very bad health,11,0,0,0,2,1,0,2,1,5,0,0,0,0
S01011444,All people aged 16 to 74,570,8,2,6,64,65,33,59,118,147,53,30,23,23
S01011444,Very good health,205,5,1,4,29,32,10,22,35,39,18,12,6,15
S01011444,Good health,194,1,0,1,17,25,15,16,41,50,22,10,12,7
S01011444,Fair health,108,1,0,1,13,7,4,12,27,36,7,2,5,1
S01011444,Bad health,45,1,1,0,2,1,4,7,11,14,5,5,0,0
S01011444,Very bad health,18,0,0,0,3,0,0,2,4,8,1,1,0,0
S01011445,All people aged 16 to 74,406,25,4,21,80,50,23,31,56,94,24,8,16,23
S01011445,Very good health,193,17,3,14,47,25,15,11,27,27,9,3,6,15
S01011445,Good health,118,7,1,6,25,17,3,11,15,30,7,2,5,3
S01011445,Fair health,65,1,0,1,4,8,4,6,13,20,7,3,4,2
S01011445,Bad health,22,0,0,0,4,0,1,3,0,10,1,0,1,3
S01011445,Very bad health,8,0,0,0,0,0,0,0,1,7,0,0,0,0
S01011446,All people aged 16 to 74,387,28,6,22,66,62,53,32,51,53,17,13,4,25
S01011446,Very good health,174,15,5,10,36,29,21,13,19,19,6,4,2,16
S01011446,Good health,112,10,1,9,15,16,22,9,15,17,2,1,1,6
S01011446,Fair health,62,2,0,2,10,11,7,6,8,9,6,5,1,3
S01011446,Bad health,30,1,0,1,4,3,3,3,6,7,3,3,0,0
S01011446,Very bad health,9,0,0,0,1,3,0,1,3,1,0,0,0,0
S01011447,All people aged 16 to 74,636,15,5,10,87,117,41,45,98,147,46,26,20,40
S01011447,Very good health,291,5,4,1,50,57,18,23,41,55,13,4,9,29
S01011447,Good health,182,8,1,7,18,36,11,12,34,43,10,3,7,10
S01011447,Fair health,100,2,0,2,11,19,9,4,14,29,11,7,4,1
S01011447,Bad health,44,0,0,0,6,3,1,5,6,17,6,6,0,0
S01011447,Very bad health,19,0,0,0,2,2,2,1,3,3,6,6,0,0
S01011448,All people aged 16 to 74,705,36,9,27,148,95,61,68,109,97,42,28,14,49
S01011448,Very good health,318,20,6,14,69,48,27,28,51,29,12,7,5,34
S01011448,Good health,253,14,2,12,65,34,23,20,42,32,9,4,5,14
S01011448,Fair health,96,1,1,0,11,11,6,15,15,23,13,9,4,1
S01011448,Bad health,25,0,0,0,2,2,5,2,1,7,6,6,0,0
S01011448,Very bad health,13,1,0,1,1,0,0,3,0,6,2,2,0,0
S01011449,All people aged 16 to 74,393,13,2,11,57,53,25,48,69,86,32,22,10,10
S01011449,Very good health,155,9,1,8,27,25,12,21,18,27,9,4,5,7
S01011449,Good health,134,4,1,3,16,18,7,14,30,33,9,6,3,3
S01011449,Fair health,64,0,0,0,9,4,5,10,14,15,7,6,1,0
S01011449,Bad health,30,0,0,0,4,4,1,3,5,8,5,4,1,0
S01011449,Very bad health,10,0,0,0,1,2,0,0,2,3,2,2,0,0
S01011450,All people aged 16 to 74,471,48,11,37,119,74,40,32,46,55,24,19,5,33
S01011450,Very good health,238,23,3,20,74,33,18,13,18,21,7,6,1,31
S01011450,Good health,144,18,4,14,30,25,16,7,16,22,9,6,3,1
S01011450,Fair health,67,7,4,3,10,13,5,8,10,7,6,5,1,1
S01011450,Bad health,15,0,0,0,3,3,1,3,0,4,1,1,0,0
S01011450,Very bad health,7,0,0,0,2,0,0,1,2,1,1,1,0,0
S01011451,All people aged 16 to 74,540,64,17,47,114,61,77,26,54,32,29,20,9,83
S01011451,Very good health,329,45,12,33,76,33,35,19,31,13,14,8,6,63
S01011451,Good health,156,14,5,9,28,21,33,4,17,12,9,7,2,18
S01011451,Fair health,39,3,0,3,7,7,7,1,4,4,4,3,1,2
S01011451,Bad health,11,2,0,2,3,0,1,1,2,2,0,0,0,0
S01011451,Very bad health,5,0,0,0,0,0,1,1,0,1,2,2,0,0
S01011452,All people aged 16 to 74,737,52,16,36,162,117,62,70,123,83,22,13,9,46
S01011452,Very good health,355,32,9,23,89,58,23,25,58,28,6,4,2,36
S01011452,Good health,244,18,7,11,46,41,23,29,41,34,5,0,5,7
S01011452,Fair health,96,2,0,2,22,11,11,8,16,16,8,6,2,2
S01011452,Bad health,28,0,0,0,3,4,4,5,4,4,3,3,0,1
S01011452,Very bad health,14,0,0,0,2,3,1,3,4,1,0,0,0,0
S01011453,All people aged 16 to 74,525,18,7,11,93,79,27,56,92,102,26,18,8,32
S01011453,Very good health,253,11,5,6,52,42,13,26,38,32,10,5,5,29
S01011453,Good health,156,4,2,2,29,23,7,16,32,37,6,4,2,2
S01011453,Fair health,70,2,0,2,7,10,6,11,14,15,4,4,0,1
S01011453,Bad health,37,1,0,1,5,3,1,2,7,13,5,4,1,0
S01011453,Very bad health,9,0,0,0,0,1,0,1,1,5,1,1,0,0
S01011454,All people aged 16 to 74,571,18,4,14,94,67,29,62,121,111,32,18,14,37
S01011454,Very good health,251,11,4,7,48,30,13,27,43,34,16,6,10,29
S01011454,Good health,185,4,0,4,33,19,12,23,45,37,9,6,3,3
S01011454,Fair health,106,2,0,2,10,14,2,10,26,32,6,5,1,4
S01011454,Bad health,21,1,0,1,1,3,1,1,6,6,1,1,0,1
S01011454,Very bad health,8,0,0,0,2,1,1,1,1,2,0,0,0,0
S01011455,All people aged 16 to 74,559,9,1,8,63,68,29,54,139,106,58,35,23,33
S01011455,Very good health,206,8,1,7,23,28,9,24,46,29,19,7,12,20
S01011455,Good health,187,1,0,1,26,22,9,14,51,38,17,11,6,9
S01011455,Fair health,112,0,0,0,8,13,8,7,29,28,17,12,5,2
S01011455,Bad health,45,0,0,0,5,5,3,7,11,10,2,2,0,2
S01011455,Very bad health,9,0,0,0,1,0,0,2,2,1,3,3,0,0
S01011456,All people aged 16 to 74,642,15,3,12,81,75,50,68,120,143,50,40,10,40
S01011456,Very good health,283,10,2,8,47,38,19,29,46,44,17,13,4,33
S01011456,Good health,179,3,1,2,24,23,16,18,33,47,9,5,4,6
S01011456,Fair health,100,2,0,2,5,8,9,13,18,32,12,10,2,1
S01011456,Bad health,61,0,0,0,4,5,6,6,17,14,9,9,0,0
S01011456,Very bad health,19,0,0,0,1,1,0,2,6,6,3,3,0,0
S01011457,All people aged 16 to 74,691,14,0,14,74,87,25,66,166,166,55,34,21,38
S01011457,Very good health,280,6,0,6,31,45,13,23,59,57,15,9,6,31
S01011457,Good health,244,6,0,6,31,31,8,25,66,57,14,7,7,6
S01011457,Fair health,113,2,0,2,10,8,2,11,29,30,21,13,8,0
S01011457,Bad health,38,0,0,0,2,2,1,7,10,13,2,2,0,1
S01011457,Very bad health,16,0,0,0,0,1,1,0,2,9,3,3,0,0
S01011458,All people aged 16 to 74,855,65,12,53,191,143,57,80,115,93,32,25,7,79
S01011458,Very good health,513,43,6,37,121,92,30,44,58,47,12,10,2,66
S01011458,Good health,238,18,5,13,48,42,15,22,38,33,10,8,2,12
S01011458,Fair health,80,4,1,3,15,7,12,10,13,10,8,6,2,1
S01011458,Bad health,18,0,0,0,4,2,0,2,6,2,2,1,1,0
S01011458,Very bad health,6,0,0,0,3,0,0,2,0,1,0,0,0,0
S01011459,All people aged 16 to 74,765,50,7,43,181,144,43,67,119,101,30,20,10,30
S01011459,Very good health,433,35,5,30,109,91,26,38,52,46,13,8,5,23
S01011459,Good health,205,12,0,12,49,41,11,14,34,26,11,6,5,7
S01011459,Fair health,77,2,1,1,15,6,4,9,24,15,2,2,0,0
S01011459,Bad health,33,0,0,0,4,3,1,3,8,11,3,3,0,0
S01011459,Very bad health,17,1,1,0,4,3,1,3,1,3,1,1,0,0
S01011460,All people aged 16 to 74,525,25,5,20,101,59,31,42,83,108,43,32,11,33
S01011460,Very good health,269,17,3,14,61,37,16,16,41,43,15,11,4,23
S01011460,Good health,147,6,2,4,31,15,7,18,21,28,12,7,5,9
S01011460,Fair health,75,2,0,2,7,4,7,6,11,24,13,11,2,1
S01011460,Bad health,30,0,0,0,2,3,1,1,9,11,3,3,0,0
S01011460,Very bad health,4,0,0,0,0,0,0,1,1,2,0,0,0,0
S01011461,All people aged 16 to 74,548,9,2,7,68,82,25,46,120,110,49,28,21,39
S01011461,Very good health,224,4,1,3,33,40,11,19,47,27,13,7,6,30
S01011461,Good health,195,2,1,1,23,27,8,19,45,50,12,5,7,9
S01011461,Fair health,86,1,0,1,9,14,3,2,20,21,16,9,7,0
S01011461,Bad health,34,1,0,1,3,1,3,5,7,9,5,4,1,0
S01011461,Very bad health,9,1,0,1,0,0,0,1,1,3,3,3,0,0
S01011462,All people aged 16 to 74,701,60,16,44,120,110,42,74,120,99,24,13,11,52
S01011462,Very good health,335,37,11,26,67,47,15,34,47,37,8,4,4,43
S01011462,Good health,207,18,4,14,38,40,14,19,36,29,6,2,4,7
S01011462,Fair health,97,3,1,2,11,14,11,13,23,15,6,4,2,1
S01011462,Bad health,52,2,0,2,4,7,1,8,11,15,4,3,1,0
S01011462,Very bad health,10,0,0,0,0,2,1,0,3,3,0,0,0,1
S01011463,All people aged 16 to 74,513,15,2,13,103,94,39,42,92,78,19,11,8,31
S01011463,Very good health,233,8,1,7,47,45,20,15,38,25,9,4,5,26
S01011463,Good health,159,6,0,6,37,28,15,14,24,26,4,1,3,5
S01011463,Fair health,82,1,1,0,15,16,3,4,20,22,1,1,0,0
S01011463,Bad health,29,0,0,0,3,5,0,6,8,2,5,5,0,0
S01011463,Very bad health,10,0,0,0,1,0,1,3,2,3,0,0,0,0
S01011464,All people aged 16 to 74,431,56,13,43,131,57,33,35,37,36,9,7,2,37
S01011464,Very good health,284,44,8,36,89,33,18,21,22,18,5,4,1,34
S01011464,Good health,104,9,3,6,33,20,9,11,9,8,3,2,1,2
S01011464,Fair health,30,3,2,1,7,2,4,2,5,6,0,0,0,1
S01011464,Bad health,12,0,0,0,1,2,2,1,1,4,1,1,0,0
S01011464,Very bad health,1,0,0,0,1,0,0,0,0,0,0,0,0,0
S01011465,All people aged 16 to 74,383,7,2,5,44,40,22,34,82,81,50,32,18,23
S01011465,Very good health,143,4,1,3,21,19,7,7,30,27,10,6,4,18
S01011465,Good health,136,2,1,1,12,17,6,18,32,26,19,10,9,4
S01011465,Fair health,74,0,0,0,9,3,7,6,16,16,16,11,5,1
S01011465,Bad health,23,1,0,1,1,0,1,3,3,10,4,4,0,0
S01011465,Very bad health,7,0,0,0,1,1,1,0,1,2,1,1,0,0
S01011466,All people aged 16 to 74,448,20,4,16,63,51,19,22,92,108,40,21,19,33
S01011466,Very good health,171,12,1,11,31,23,10,6,29,29,9,5,4,22
S01011466,Good health,150,5,3,2,22,16,5,11,33,34,15,6,9,9
S01011466,Fair health,63,0,0,0,6,6,1,3,16,20,9,3,6,2
S01011466,Bad health,45,1,0,1,2,2,3,2,11,21,3,3,0,0
S01011466,Very bad health,19,2,0,2,2,4,0,0,3,4,4,4,0,0
S01011467,All people aged 16 to 74,403,35,8,27,78,64,18,30,71,59,27,16,11,21
S01011467,Very good health,203,25,6,19,44,35,5,16,29,21,9,6,3,19
S01011467,Good health,122,10,2,8,21,15,9,9,23,23,10,4,6,2
S01011467,Fair health,47,0,0,0,9,9,3,4,8,9,5,3,2,0
S01011467,Bad health,22,0,0,0,1,5,0,1,9,4,2,2,0,0
S01011467,Very bad health,9,0,0,0,3,0,1,0,2,2,1,1,0,0
S01011468,All people aged 16 to 74,614,73,21,52,179,112,41,49,65,37,18,13,5,40
S01011468,Very good health,422,56,14,42,126,76,25,31,46,24,7,5,2,31
S01011468,Good health,147,16,7,9,42,29,12,13,14,7,6,4,2,8
S01011468,Fair health,38,1,0,1,11,5,3,4,4,4,5,4,1,1
S01011468,Bad health,4,0,0,0,0,1,0,1,1,1,0,0,0,0
S01011468,Very bad health,3,0,0,0,0,1,1,0,0,1,0,0,0,0
S01011469,All people aged 16 to 74,620,24,6,18,79,74,25,55,106,119,89,66,23,49
S01011469,Very good health,285,18,5,13,47,39,9,23,48,36,37,29,8,28
S01011469,Good health,205,5,0,5,21,20,10,19,36,42,33,24,9,19
S01011469,Fair health,76,1,1,0,8,7,4,6,14,23,11,6,5,2
S01011469,Bad health,43,0,0,0,3,8,2,4,7,14,5,4,1,0
S01011469,Very bad health,11,0,0,0,0,0,0,3,1,4,3,3,0,0
S01011470,All people aged 16 to 74,840,43,12,31,148,131,56,70,145,131,44,30,14,72
S01011470,Very good health,367,21,7,14,77,60,17,29,56,43,9,5,4,55
S01011470,Good health,253,14,5,9,46,38,23,23,42,39,12,5,7,16
S01011470,Fair health,138,5,0,5,15,25,11,12,33,26,11,9,2,0
S01011470,Bad health,63,2,0,2,8,6,5,4,13,18,6,6,0,1
S01011470,Very bad health,19,1,0,1,2,2,0,2,1,5,6,5,1,0
S01011471,All people aged 16 to 74,664,53,16,37,141,84,36,56,122,107,15,7,8,50
S01011471,Very good health,279,28,9,19,70,35,13,21,38,35,6,2,4,33
S01011471,Good health,238,19,4,15,45,37,15,20,45,36,4,3,1,17
S01011471,Fair health,96,4,1,3,18,9,4,10,23,23,5,2,3,0
S01011471,Bad health,42,1,1,0,8,3,3,4,11,12,0,0,0,0
S01011471,Very bad health,9,1,1,0,0,0,1,1,5,1,0,0,0,0
S01011472,All people aged 16 to 74,693,20,5,15,103,93,28,75,125,131,70,33,37,48
S01011472,Very good health,251,13,2,11,47,36,11,31,44,22,21,6,15,26
S01011472,Good health,245,4,2,2,36,46,7,21,47,44,22,7,15,18
S01011472,Fair health,129,3,1,2,14,2,8,11,27,43,18,11,7,3
S01011472,Bad health,54,0,0,0,6,7,2,11,5,15,7,7,0,1
S01011472,Very bad health,14,0,0,0,0,2,0,1,2,7,2,2,0,0
S01011473,All people aged 16 to 74,493,11,1,10,60,77,16,48,120,105,38,24,14,18
S01011473,Very good health,144,7,0,7,22,25,7,13,27,22,5,2,3,16
S01011473,Good health,161,1,0,1,23,24,2,20,48,31,10,6,4,2
S01011473,Fair health,113,2,1,1,12,18,3,9,22,32,15,9,6,0
S01011473,Bad health,56,0,0,0,2,8,4,4,17,15,6,5,1,0
S01011473,Very bad health,19,1,0,1,1,2,0,2,6,5,2,2,0,0
S01011474,All people aged 16 to 74,582,23,5,18,92,83,15,60,119,116,52,26,26,22
S01011474,Very good health,218,13,1,12,45,36,9,24,34,26,13,2,11,18
S01011474,Good health,173,7,3,4,23,28,1,17,35,39,19,7,12,4
S01011474,Fair health,111,3,1,2,12,11,4,14,28,27,12,10,2,0
S01011474,Bad health,61,0,0,0,11,7,1,5,16,16,5,4,1,0
S01011474,Very bad health,19,0,0,0,1,1,0,0,6,8,3,3,0,0
S01011475,All people aged 16 to 74,409,11,1,10,56,63,18,40,81,83,37,18,19,20
S01011475,Very good health,129,4,0,4,23,28,3,11,24,16,9,2,7,11
S01011475,Good health,121,3,0,3,16,18,6,10,25,24,11,5,6,8
S01011475,Fair health,87,3,1,2,9,11,6,10,19,19,10,7,3,0
S01011475,Bad health,57,1,0,1,7,4,2,8,12,18,4,3,1,1
S01011475,Very bad health,15,0,0,0,1,2,1,1,1,6,3,1,2,0
S01011476,All people aged 16 to 74,379,50,8,42,101,89,16,30,36,22,4,2,2,31
S01011476,Very good health,225,35,4,31,65,54,7,15,15,7,1,0,1,26
S01011476,Good health,110,12,4,8,31,26,7,12,8,9,0,0,0,5
S01011476,Fair health,34,2,0,2,4,7,2,3,8,6,2,1,1,0
S01011476,Bad health,7,1,0,1,1,2,0,0,2,0,1,1,0,0
S01011476,Very bad health,3,0,0,0,0,0,0,0,3,0,0,0,0,0
S01011477,All people aged 16 to 74,670,78,19,59,195,143,43,45,67,36,15,10,5,48
S01011477,Very good health,372,51,13,38,102,81,16,17,32,21,7,5,2,45
S01011477,Good health,224,21,4,17,74,52,15,19,24,12,4,1,3,3
S01011477,Fair health,55,5,2,3,15,10,8,8,5,1,3,3,0,0
S01011477,Bad health,15,0,0,0,4,0,3,0,5,2,1,1,0,0
S01011477,Very bad health,4,1,0,1,0,0,1,1,1,0,0,0,0,0
S01011478,All people aged 16 to 74,784,122,32,90,257,132,53,45,62,26,11,3,8,76
S01011478,Very good health,458,75,20,55,159,69,24,20,27,10,4,1,3,70
S01011478,Good health,238,43,12,31,65,47,21,17,24,12,4,1,3,5
S01011478,Fair health,66,4,0,4,29,12,6,4,7,0,3,1,2,1
S01011478,Bad health,19,0,0,0,3,3,2,3,4,4,0,0,0,0
S01011478,Very bad health,3,0,0,0,1,1,0,1,0,0,0,0,0,0
S01011479,All people aged 16 to 74,616,61,13,48,183,124,41,49,67,39,16,13,3,36
S01011479,Very good health,329,34,7,27,108,59,23,20,32,19,4,3,1,30
S01011479,Good health,201,23,5,18,59,47,11,17,26,8,5,4,1,5
S01011479,Fair health,56,4,1,3,13,13,5,9,4,6,1,1,0,1
S01011479,Bad health,24,0,0,0,2,4,1,3,4,5,5,4,1,0
S01011479,Very bad health,6,0,0,0,1,1,1,0,1,1,1,1,0,0
S01011480,All people aged 16 to 74,738,129,22,107,233,117,56,32,73,35,11,8,3,52
S01011480,Very good health,426,80,12,68,133,68,25,16,39,18,3,2,1,44
S01011480,Good health,232,44,10,34,80,35,22,12,24,8,3,3,0,4
S01011480,Fair health,68,5,0,5,17,11,9,3,8,8,4,2,2,3
S01011480,Bad health,12,0,0,0,3,3,0,1,2,1,1,1,0,1
S01011480,Very bad health,0,0,0,0,0,0,0,0,0,0,0,0,0,0
S01011481,All people aged 16 to 74,597,50,9,41,155,97,39,55,77,67,18,10,8,39
S01011481,Very good health,350,30,2,28,115,62,18,22,36,27,6,1,5,34
S01011481,Good health,146,16,5,11,29,15,13,21,16,26,7,4,3,3
S01011481,Fair health,72,2,0,2,8,16,6,7,19,9,3,3,0,2
S01011481,Bad health,23,2,2,0,2,4,2,3,5,4,1,1,0,0
S01011481,Very bad health,6,0,0,0,1,0,0,2,1,1,1,1,0,0
S01011482,All people aged 16 to 74,666,36,6,30,124,101,25,62,119,116,42,24,18,41
S01011482,Very good health,291,21,6,15,60,45,12,23,40,39,20,9,11,31
S01011482,Good health,206,10,0,10,40,36,7,25,40,26,14,9,5,8
S01011482,Fair health,109,4,0,4,22,16,5,7,19,29,5,3,2,2
S01011482,Bad health,44,1,0,1,2,4,1,5,14,15,2,2,0,0
S01011482,Very bad health,16,0,0,0,0,0,0,2,6,7,1,1,0,0
S01011483,All people aged 16 to 74,421,36,6,30,145,64,26,27,44,29,19,11,8,31
S01011483,Very good health,210,20,4,16,73,34,9,11,23,10,3,2,1,27
S01011483,Good health,151,15,2,13,52,26,10,13,14,10,9,5,4,2
S01011483,Fair health,43,0,0,0,14,2,7,0,5,7,7,4,3,1
S01011483,Bad health,16,1,0,1,5,2,0,3,2,2,0,0,0,1
S01011483,Very bad health,1,0,0,0,1,0,0,0,0,0,0,0,0,0
S01011484,All people aged 16 to 74,642,13,1,12,80,88,25,53,157,134,50,37,13,42
S01011484,Very good health,256,6,1,5,36,38,11,24,63,41,7,5,2,30
S01011484,Good health,198,7,0,7,30,30,10,11,53,31,18,14,4,8
S01011484,Fair health,106,0,0,0,7,11,1,10,17,34,22,15,7,4
S01011484,Bad health,60,0,0,0,6,5,2,7,14,24,2,2,0,0
S01011484,Very bad health,22,0,0,0,1,4,1,1,10,4,1,1,0,0
S01011485,All people aged 16 to 74,705,21,7,14,72,76,19,72,153,153,79,45,34,60
S01011485,Very good health,278,14,6,8,35,43,4,28,53,34,24,10,14,43
S01011485,Good health,210,4,0,4,22,19,7,26,44,48,27,15,12,13
S01011485,Fair health,133,3,1,2,9,12,3,11,30,47,17,9,8,1
S01011485,Bad health,65,0,0,0,6,1,4,6,20,20,6,6,0,2
S01011485,Very bad health,19,0,0,0,0,1,1,1,6,4,5,5,0,1
S01011486,All people aged 16 to 74,389,4,2,2,40,40,17,34,82,103,34,21,13,35
S01011486,Very good health,171,1,1,0,15,21,6,13,36,38,12,8,4,29
S01011486,Good health,114,2,0,2,13,14,7,12,24,29,12,5,7,1
S01011486,Fair health,60,0,0,0,6,4,2,6,10,18,9,7,2,5
S01011486,Bad health,33,1,1,0,5,1,2,3,9,11,1,1,0,0
S01011486,Very bad health,11,0,0,0,1,0,0,0,3,7,0,0,0,0
S01011487,All people aged 16 to 74,809,30,5,25,85,108,42,71,180,152,79,61,18,62
S01011487,Very good health,343,20,2,18,41,56,13,22,71,58,17,8,9,45
S01011487,Good health,280,9,3,6,32,37,17,28,63,50,32,27,5,12
S01011487,Fair health,114,0,0,0,8,7,7,13,25,27,22,18,4,5
S01011487,Bad health,52,1,0,1,3,7,4,7,14,12,4,4,0,0
S01011487,Very bad health,20,0,0,0,1,1,1,1,7,5,4,4,0,0
S01011488,All people aged 16 to 74,484,10,3,7,45,44,23,54,107,114,57,36,21,30
S01011488,Very good health,168,4,1,3,21,20,7,26,29,25,13,6,7,23
S01011488,Good health,176,5,2,3,14,17,9,16,45,40,24,13,11,6
S01011488,Fair health,80,1,0,1,5,3,4,7,25,24,11,8,3,0
S01011488,Bad health,46,0,0,0,5,4,1,4,6,20,5,5,0,1
S01011488,Very bad health,14,0,0,0,0,0,2,1,2,5,4,4,0,0
S01011489,All people aged 16 to 74,540,38,13,25,122,97,38,48,70,61,26,15,11,40
S01011489,Very good health,299,24,8,16,70,50,19,34,31,29,11,5,6,31
S01011489,Good health,181,12,4,8,41,38,15,9,27,23,8,4,4,8
S01011489,Fair health,43,2,1,1,10,7,3,4,6,6,4,4,0,1
S01011489,Bad health,14,0,0,0,1,2,1,0,4,3,3,2,1,0
S01011489,Very bad health,3,0,0,0,0,0,0,1,2,0,0,0,0,0
S01011490,All people aged 16 to 74,747,22,5,17,145,111,42,66,133,160,42,26,16,26
S01011490,Very good health,312,15,3,12,77,50,19,27,52,43,8,3,5,21
S01011490,Good health,263,4,1,3,44,45,14,23,47,61,22,16,6,3
S01011490,Fair health,102,3,1,2,15,8,4,9,24,28,9,5,4,2
S01011490,Bad health,56,0,0,0,9,6,3,3,9,23,3,2,1,0
S01011490,Very bad health,14,0,0,0,0,2,2,4,1,5,0,0,0,0
S01011491,All people aged 16 to 74,385,9,1,8,45,51,9,40,92,78,46,28,18,15
S01011491,Very good health,142,4,1,3,21,22,5,11,32,21,16,10,6,10
S01011491,Good health,137,4,0,4,20,14,3,14,36,31,12,9,3,3
S01011491,Fair health,60,1,0,1,4,9,1,9,13,12,10,5,5,1
S01011491,Bad health,38,0,0,0,0,6,0,4,10,11,6,3,3,1
S01011491,Very bad health,8,0,0,0,0,0,0,2,1,3,2,1,1,0
S01011492,All people aged 16 to 74,566,13,0,13,72,55,21,51,105,138,64,40,24,47
S01011492,Very good health,256,8,0,8,40,26,8,23,37,56,19,9,10,39
S01011492,Good health,174,5,0,5,23,16,11,13,46,37,17,9,8,6
S01011492,Fair health,90,0,0,0,6,10,2,9,13,24,24,18,6,2
S01011492,Bad health,36,0,0,0,3,3,0,4,5,17,4,4,0,0
S01011492,Very bad health,10,0,0,0,0,0,0,2,4,4,0,0,0,0
S01011493,All people aged 16 to 74,394,35,12,23,111,75,24,38,33,27,4,4,0,47
S01011493,Very good health,248,27,10,17,79,45,10,20,18,10,2,2,0,37
S01011493,Good health,121,8,2,6,27,25,12,11,14,13,1,1,0,10
S01011493,Fair health,16,0,0,0,3,3,1,6,0,2,1,1,0,0
S01011493,Bad health,9,0,0,0,2,2,1,1,1,2,0,0,0,0
S01011493,Very bad health,0,0,0,0,0,0,0,0,0,0,0,0,0,0
S01011494,All people aged 16 to 74,544,22,4,18,85,87,24,46,103,113,32,18,14,32
S01011494,Very good health,239,11,2,9,45,40,11,16,44,36,11,6,5,25
S01011494,Good health,176,10,1,9,28,32,6,12,39,37,6,2,4,6
S01011494,Fair health,85,1,1,0,8,12,6,12,13,25,7,3,4,1
S01011494,Bad health,29,0,0,0,4,3,1,3,4,11,3,2,1,0
S01011494,Very bad health,15,0,0,0,0,0,0,3,3,4,5,5,0,0
S01011495,All people aged 16 to 74,605,21,5,16,79,81,19,56,130,115,58,37,21,46
S01011495,Very good health,258,11,2,9,37,35,8,27,52,34,18,12,6,36
S01011495,Good health,197,7,2,5,26,23,7,18,46,45,19,10,9,6
S01011495,Fair health,97,1,1,0,12,16,2,7,23,24,8,3,5,4
S01011495,Bad health,40,2,0,2,1,4,2,3,8,9,11,10,1,0
S01011495,Very bad health,13,0,0,0,3,3,0,1,1,3,2,2,0,0
S01011496,All people aged 16 to 74,472,10,3,7,43,30,23,47,129,119,46,30,16,25
S01011496,Very good health,182,5,2,3,19,18,7,19,43,36,15,12,3,20
S01011496,Good health,158,1,0,1,14,9,7,24,45,39,14,7,7,5
S01011496,Fair health,61,2,1,1,6,1,6,0,19,18,9,5,4,0
S01011496,Bad health,59,2,0,2,4,1,3,4,18,24,3,2,1,0
S01011496,Very bad health,12,0,0,0,0,1,0,0,4,2,5,4,1,0
S01011497,All people aged 16 to 74,483,39,11,28,110,83,37,36,74,42,27,17,10,35
S01011497,Very good health,271,25,6,19,70,40,17,25,38,19,10,6,4,27
S01011497,Good health,149,8,2,6,30,34,11,8,28,17,7,4,3,6
S01011497,Fair health,48,3,1,2,7,7,7,3,7,3,9,6,3,2
S01011497,Bad health,11,2,1,1,2,2,1,0,1,2,1,1,0,0
S01011497,Very bad health,4,1,1,0,1,0,1,0,0,1,0,0,0,0
S01011498,All people aged 16 to 74,533,26,7,19,134,98,33,51,74,51,10,5,5,56
S01011498,Very good health,329,19,5,14,81,58,20,28,40,28,7,3,4,48
S01011498,Good health,155,7,2,5,47,32,8,15,26,10,2,1,1,8
S01011498,Fair health,33,0,0,0,6,7,3,7,3,6,1,1,0,0
S01011498,Bad health,11,0,0,0,0,1,1,1,3,5,0,0,0,0
S01011498,Very bad health,5,0,0,0,0,0,1,0,2,2,0,0,0,0
S01011499,All people aged 16 to 74,619,30,8,22,124,120,47,67,92,82,22,13,9,35
S01011499,Very good health,319,13,3,10,66,64,23,35,43,34,7,4,3,34
S01011499,Good health,187,16,4,12,44,35,12,19,26,26,9,5,4,0
S01011499,Fair health,77,0,0,0,11,17,7,8,14,15,4,2,2,1
S01011499,Bad health,32,1,1,0,2,3,5,4,9,7,1,1,0,0
S01011499,Very bad health,4,0,0,0,1,1,0,1,0,0,1,1,0,0
S01011500,All people aged 16 to 74,391,15,5,10,65,59,17,38,68,83,18,4,14,28
S01011500,Very good health,171,5,2,3,37,26,7,16,32,21,7,1,6,20
S01011500,Good health,133,6,2,4,16,22,8,15,23,33,3,1,2,7
S01011500,Fair health,55,4,1,3,8,7,1,3,9,17,5,1,4,1
S01011500,Bad health,24,0,0,0,4,3,1,3,2,8,3,1,2,0
S01011500,Very bad health,8,0,0,0,0,1,0,1,2,4,0,0,0,0
S01011501,All people aged 16 to 74,498,13,2,11,41,49,30,43,112,144,48,24,24,18
S01011501,Very good health,187,8,1,7,17,18,13,23,35,46,16,8,8,11
S01011501,Good health,169,2,0,2,11,19,9,14,40,49,18,9,9,7
S01011501,Fair health,79,3,1,2,7,7,4,2,21,29,6,3,3,0
S01011501,Bad health,50,0,0,0,6,4,4,3,11,16,6,2,4,0
S01011501,Very bad health,13,0,0,0,0,1,0,1,5,4,2,2,0,0
S01011502,All people aged 16 to 74,566,13,7,6,63,87,25,67,128,116,37,21,16,30
S01011502,Very good health,243,3,2,1,28,37,9,24,53,53,14,8,6,22
S01011502,Good health,194,7,4,3,23,35,12,20,38,41,12,7,5,6
S01011502,Fair health,88,3,1,2,7,7,4,14,27,16,9,5,4,1
S01011502,Bad health,31,0,0,0,4,7,0,6,9,2,2,1,1,1
S01011502,Very bad health,10,0,0,0,1,1,0,3,1,4,0,0,0,0
S01011503,All people aged 16 to 74,479,15,4,11,69,64,26,39,98,107,34,21,13,27
S01011503,Very good health,208,6,1,5,36,29,10,18,38,43,9,4,5,19
S01011503,Good health,146,6,2,4,19,19,14,10,36,31,8,5,3,3
S01011503,Fair health,70,1,0,1,6,12,2,6,16,17,7,4,3,3
S01011503,Bad health,42,2,1,1,6,2,0,5,5,13,7,5,2,2
S01011503,Very bad health,13,0,0,0,2,2,0,0,3,3,3,3,0,0
S01011504,All people aged 16 to 74,434,19,4,15,69,67,34,42,73,77,22,14,8,31
S01011504,Very good health,180,11,3,8,37,24,12,19,29,25,1,0,1,22
S01011504,Good health,148,6,1,5,19,28,14,12,21,34,9,6,3,5
S01011504,Fair health,60,0,0,0,8,11,3,7,16,7,6,3,3,2
S01011504,Bad health,36,2,0,2,4,3,4,4,6,7,5,4,1,1
S01011504,Very bad health,10,0,0,0,1,1,1,0,1,4,1,1,0,1
S01011505,All people aged 16 to 74,518,25,5,20,77,61,20,50,98,106,49,24,25,32
S01011505,Very good health,232,15,3,12,48,33,8,21,33,38,12,4,8,24
S01011505,Good health,159,6,0,6,20,15,8,12,39,33,19,7,12,7
S01011505,Fair health,72,3,1,2,4,9,4,12,16,12,11,6,5,1
S01011505,Bad health,40,1,1,0,2,4,0,3,7,17,6,6,0,0
S01011505,Very bad health,15,0,0,0,3,0,0,2,3,6,1,1,0,0
S01011506,All people aged 16 to 74,358,19,7,12,69,46,21,31,66,68,17,11,6,21
S01011506,Very good health,152,9,2,7,34,24,9,11,24,24,2,1,1,15
S01011506,Good health,126,9,5,4,23,17,8,14,24,23,5,2,3,3
S01011506,Fair health,56,1,0,1,8,5,3,2,12,14,8,6,2,3
S01011506,Bad health,21,0,0,0,3,0,1,3,5,7,2,2,0,0
S01011506,Very bad health,3,0,0,0,1,0,0,1,1,0,0,0,0,0
S01011507,All people aged 16 to 74,463,15,7,8,80,51,28,51,91,86,43,32,11,18
S01011507,Very good health,182,10,5,5,40,21,14,16,30,27,10,8,2,14
S01011507,Good health,170,4,1,3,27,17,9,25,40,29,15,11,4,4
S01011507,Fair health,73,1,1,0,8,11,3,4,12,21,13,8,5,0
S01011507,Bad health,29,0,0,0,3,2,2,5,7,7,3,3,0,0
S01011507,Very bad health,9,0,0,0,2,0,0,1,2,2,2,2,0,0
S01011508,All people aged 16 to 74,755,53,13,40,154,108,47,80,97,138,37,21,16,41
S01011508,Very good health,370,30,5,25,93,57,12,25,43,64,12,6,6,34
S01011508,Good health,240,19,7,12,45,34,22,38,35,33,10,5,5,4
S01011508,Fair health,100,4,1,3,13,13,9,11,9,27,12,7,5,2
S01011508,Bad health,30,0,0,0,1,4,1,3,9,8,3,3,0,1
S01011508,Very bad health,15,0,0,0,2,0,3,3,1,6,0,0,0,0
S01011509,All people aged 16 to 74,489,23,9,14,70,82,24,65,83,82,29,19,10,31
S01011509,Very good health,198,8,4,4,22,35,11,25,29,37,10,6,4,21
S01011509,Good health,193,8,4,4,34,37,11,28,28,32,7,3,4,8
S01011509,Fair health,66,4,1,3,12,6,1,11,18,9,4,2,2,1
S01011509,Bad health,24,2,0,2,1,3,1,1,4,3,8,8,0,1
S01011509,Very bad health,8,1,0,1,1,1,0,0,4,1,0,0,0,0
S01011510,All people aged 16 to 74,779,16,6,10,109,95,41,79,189,126,65,37,28,59
S01011510,Very good health,369,8,5,3,54,46,19,40,74,53,31,18,13,44
S01011510,Good health,259,6,1,5,40,32,15,16,70,44,26,11,15,10
S01011510,Fair health,100,1,0,1,11,9,5,17,32,19,4,4,0,2
S01011510,Bad health,33,0,0,0,2,5,1,4,7,9,2,2,0,3
S01011510,Very bad health,18,1,0,1,2,3,1,2,6,1,2,2,0,0
S01011511,All people aged 16 to 74,394,4,0,4,39,37,16,27,100,119,36,16,20,16
S01011511,Very good health,165,2,0,2,21,18,9,8,38,43,15,6,9,11
S01011511,Good health,119,1,0,1,12,12,3,9,31,34,12,4,8,5
S01011511,Fair health,61,0,0,0,2,7,3,7,17,21,4,2,2,0
S01011511,Bad health,43,1,0,1,4,0,1,3,13,16,5,4,1,0
S01011511,Very bad health,6,0,0,0,0,0,0,0,1,5,0,0,0,0
S01011512,All people aged 16 to 74,669,11,1,10,57,91,22,68,149,158,77,48,29,36
S01011512,Very good health,250,5,0,5,24,37,11,24,52,44,28,13,15,25
S01011512,Good health,214,5,1,4,20,33,5,16,56,48,25,14,11,6
S01011512,Fair health,115,1,0,1,7,14,5,10,23,38,14,11,3,3
S01011512,Bad health,69,0,0,0,4,6,1,16,13,21,8,8,0,0
S01011512,Very bad health,21,0,0,0,2,1,0,2,5,7,2,2,0,2
S01011513,All people aged 16 to 74,572,6,1,5,66,64,20,68,123,131,66,37,29,28
S01011513,Very good health,203,2,1,1,31,26,3,27,41,35,22,9,13,16
S01011513,Good health,203,4,0,4,14,20,6,22,50,53,25,16,9,9
S01011513,Fair health,97,0,0,0,13,11,7,9,19,26,10,5,5,2
S01011513,Bad health,61,0,0,0,8,7,3,9,12,14,7,5,2,1
S01011513,Very bad health,8,0,0,0,0,0,1,1,1,3,2,2,0,0
S01011514,All people aged 16 to 74,685,13,2,11,65,71,39,71,147,168,54,32,22,57
S01011514,Very good health,284,8,2,6,36,34,14,25,53,65,11,6,5,38
S01011514,Good health,217,1,0,1,18,22,11,26,44,56,26,16,10,13
S01011514,Fair health,126,2,0,2,4,13,8,15,38,28,13,6,7,5
S01011514,Bad health,39,0,0,0,6,2,5,3,6,13,3,3,0,1
S01011514,Very bad health,19,2,0,2,1,0,1,2,6,6,1,1,0,0
S01011515,All people aged 16 to 74,436,20,4,16,82,80,28,51,74,61,22,15,7,18
S01011515,Very good health,202,9,1,8,42,33,14,25,36,25,4,3,1,14
S01011515,Good health,145,8,2,6,24,32,7,18,25,19,9,5,4,3
S01011515,Fair health,63,3,1,2,13,11,6,5,9,9,6,4,2,1
S01011515,Bad health,24,0,0,0,3,3,1,3,3,8,3,3,0,0
S01011515,Very bad health,2,0,0,0,0,1,0,0,1,0,0,0,0,0
S01011516,All people aged 16 to 74,705,50,14,36,182,134,47,66,94,52,22,15,7,58
S01011516,Very good health,381,27,8,19,105,75,24,38,43,24,6,3,3,39
S01011516,Good health,225,18,6,12,57,41,15,19,38,13,8,5,3,16
S01011516,Fair health,65,5,0,5,14,10,7,5,9,10,2,1,1,3
S01011516,Bad health,25,0,0,0,4,7,1,3,3,5,2,2,0,0
S01011516,Very bad health,9,0,0,0,2,1,0,1,1,0,4,4,0,0
S01011517,All people aged 16 to 74,406,15,3,12,58,57,25,42,87,80,19,7,12,23
S01011517,Very good health,172,9,1,8,35,26,6,24,25,24,5,3,2,18
S01011517,Good health,124,2,0,2,15,21,12,9,33,24,5,1,4,3
S01011517,Fair health,77,3,2,1,7,7,5,6,21,19,7,3,4,2
S01011517,Bad health,22,1,0,1,0,2,0,2,5,11,1,0,1,0
S01011517,Very bad health,11,0,0,0,1,1,2,1,3,2,1,0,1,0
S01011518,All people aged 16 to 74,487,9,2,7,49,39,29,57,109,132,42,27,15,21
S01011518,Very good health,163,4,2,2,19,14,9,23,32,38,13,5,8,11
S01011518,Good health,173,4,0,4,20,20,12,12,38,45,15,9,6,7
S01011518,Fair health,85,1,0,1,4,4,5,14,19,31,6,6,0,1
S01011518,Bad health,53,0,0,0,5,1,2,8,15,15,6,5,1,1
S01011518,Very bad health,13,0,0,0,1,0,1,0,5,3,2,2,0,1
S01011519,All people aged 16 to 74,593,13,5,8,83,67,20,58,122,149,41,21,20,40
S01011519,Very good health,242,8,2,6,31,34,8,24,49,43,15,5,10,30
S01011519,Good health,221,4,3,1,34,19,10,20,50,59,17,12,5,8
S01011519,Fair health,75,1,0,1,11,9,1,7,12,27,7,2,5,0
S01011519,Bad health,44,0,0,0,6,3,1,6,9,17,1,1,0,1
S01011519,Very bad health,11,0,0,0,1,2,0,1,2,3,1,1,0,1
S01011520,All people aged 16 to 74,422,7,0,7,41,42,15,41,81,109,61,43,18,25
S01011520,Very good health,158,3,0,3,12,19,7,13,28,38,20,11,9,18
S01011520,Good health,131,3,0,3,15,13,3,14,26,30,22,16,6,5
S01011520,Fair health,77,1,0,1,7,5,3,10,15,22,13,11,2,1
S01011520,Bad health,44,0,0,0,6,2,2,4,9,17,3,2,1,1
S01011520,Very bad health,12,0,0,0,1,3,0,0,3,2,3,3,0,0
S01011521,All people aged 16 to 74,700,26,7,19,93,89,34,62,144,132,81,51,30,39
S01011521,Very good health,269,17,4,13,41,31,17,29,44,41,21,13,8,28
S01011521,Good health,245,5,3,2,43,32,10,18,61,39,30,15,15,7
S01011521,Fair health,122,2,0,2,7,19,2,9,26,33,21,16,5,3
S01011521,Bad health,44,1,0,1,2,4,3,5,9,13,6,4,2,1
S01011521,Very bad health,20,1,0,1,0,3,2,1,4,6,3,3,0,0
S01011522,All people aged 16 to 74,681,20,4,16,107,91,31,64,163,122,48,27,21,35
S01011522,Very good health,270,7,2,5,51,44,9,19,64,36,15,4,11,25
S01011522,Good health,203,6,1,5,33,23,13,25,50,32,12,6,6,9
S01011522,Fair health,135,4,0,4,17,19,6,13,33,27,15,11,4,1
S01011522,Bad health,57,1,0,1,5,4,3,7,13,19,5,5,0,0
S01011522,Very bad health,16,2,1,1,1,1,0,0,3,8,1,1,0,0
S01011523,All people aged 16 to 74,586,15,3,12,71,57,34,61,131,145,40,25,15,32
S01011523,Very good health,240,12,3,9,33,29,14,15,47,51,12,9,3,27
S01011523,Good health,199,3,0,3,26,17,10,29,51,41,17,11,6,5
S01011523,Fair health,96,0,0,0,8,6,6,11,25,31,9,3,6,0
S01011523,Bad health,35,0,0,0,2,5,3,3,7,13,2,2,0,0
S01011523,Very bad health,16,0,0,0,2,0,1,3,1,9,0,0,0,0
S01011524,All people aged 16 to 74,720,49,10,39,133,118,43,71,130,108,26,15,11,42
S01011524,Very good health,332,29,4,25,62,58,16,32,50,42,8,3,5,35
S01011524,Good health,253,16,5,11,50,43,24,26,48,37,2,1,1,7
S01011524,Fair health,103,3,1,2,16,13,2,11,20,25,13,8,5,0
S01011524,Bad health,26,1,0,1,5,2,1,2,9,4,2,2,0,0
S01011524,Very bad health,6,0,0,0,0,2,0,0,3,0,1,1,0,0
S01011525,All people aged 16 to 74,689,41,12,29,141,92,36,76,137,98,26,24,2,42
S01011525,Very good health,304,24,6,18,71,49,14,33,43,34,5,4,1,31
S01011525,Good health,228,15,6,9,51,28,14,20,48,31,11,10,1,10
S01011525,Fair health,91,2,0,2,14,9,6,10,26,19,5,5,0,0
S01011525,Bad health,45,0,0,0,4,6,1,9,12,9,3,3,0,1
S01011525,Very bad health,21,0,0,0,1,0,1,4,8,5,2,2,0,0
S01011526,All people aged 16 to 74,781,29,4,25,124,125,35,89,153,138,45,28,17,43
S01011526,Very good health,361,17,3,14,64,66,13,38,69,49,15,7,8,30
S01011526,Good health,236,10,1,9,42,36,15,31,44,35,13,9,4,10
S01011526,Fair health,122,2,0,2,12,15,6,13,29,33,10,5,5,2
S01011526,Bad health,47,0,0,0,5,6,0,5,11,15,5,5,0,0
S01011526,Very bad health,15,0,0,0,1,2,1,2,0,6,2,2,0,1
S01011527,All people aged 16 to 74,557,44,20,24,102,100,41,53,93,72,16,9,7,36
S01011527,Very good health,273,21,10,11,55,45,19,25,45,24,7,1,6,32
S01011527,Good health,180,18,10,8,32,39,14,15,27,26,6,5,1,3
S01011527,Fair health,80,5,0,5,13,11,6,8,16,17,3,3,0,1
S01011527,Bad health,19,0,0,0,2,3,2,5,4,3,0,0,0,0
S01011527,Very bad health,5,0,0,0,0,2,0,0,1,2,0,0,0,0
S01011528,All people aged 16 to 74,719,28,13,15,105,89,32,73,159,134,53,26,27,46
S01011528,Very good health,287,13,5,8,51,38,14,29,54,37,13,5,8,38
S01011528,Good health,239,10,5,5,33,32,13,26,54,42,21,8,13,8
S01011528,Fair health,132,3,1,2,18,12,3,12,38,32,14,9,5,0
S01011528,Bad health,46,2,2,0,2,3,2,4,9,19,5,4,1,0
S01011528,Very bad health,15,0,0,0,1,4,0,2,4,4,0,0,0,0
S01011529,All people aged 16 to 74,362,10,3,7,41,48,20,24,89,71,39,19,20,20
S01011529,Very good health,135,6,2,4,23,11,4,8,39,21,11,7,4,12
S01011529,Good health,122,3,1,2,15,19,10,8,25,20,16,5,11,6
S01011529,Fair health,56,0,0,0,1,12,4,3,12,19,5,2,3,0
S01011529,Bad health,34,1,0,1,1,5,2,2,12,6,4,2,2,1
S01011529,Very bad health,15,0,0,0,1,1,0,3,1,5,3,3,0,1
S01011530,All people aged 16 to 74,728,33,7,26,88,96,34,67,144,160,68,41,27,38
S01011530,Very good health,302,22,5,17,41,40,15,32,54,55,15,3,12,28
S01011530,Good health,214,7,2,5,32,33,8,16,52,42,17,10,7,7
S01011530,Fair health,141,3,0,3,10,15,8,9,22,46,25,17,8,3
S01011530,Bad health,57,1,0,1,3,8,3,9,11,12,10,10,0,0
S01011530,Very bad health,14,0,0,0,2,0,0,1,5,5,1,1,0,0
S01011531,All people aged 16 to 74,803,71,12,59,208,117,71,57,100,96,29,20,9,54
S01011531,Very good health,421,49,6,43,129,54,30,29,43,35,14,9,5,38
S01011531,Good health,239,20,5,15,62,37,25,15,28,29,9,7,2,14
S01011531,Fair health,97,1,1,0,12,19,13,10,18,19,4,2,2,1
S01011531,Bad health,31,0,0,0,2,6,2,1,9,8,2,2,0,1
S01011531,Very bad health,15,1,0,1,3,1,1,2,2,5,0,0,0,0
S01011532,All people aged 16 to 74,468,54,14,40,114,65,48,40,51,44,12,5,7,40
S01011532,Very good health,259,34,10,24,67,28,27,20,24,22,4,2,2,33
S01011532,Good health,133,13,3,10,33,26,10,14,13,12,6,1,5,6
S01011532,Fair health,56,5,1,4,8,8,11,4,10,7,2,2,0,1
S01011532,Bad health,16,2,0,2,5,1,0,2,3,3,0,0,0,0
S01011532,Very bad health,4,0,0,0,1,2,0,0,1,0,0,0,0,0
S01011533,All people aged 16 to 74,475,19,6,13,43,52,30,51,93,113,57,36,21,17
S01011533,Very good health,170,13,4,9,18,20,9,22,27,33,16,12,4,12
S01011533,Good health,144,2,0,2,13,20,11,17,26,33,18,11,7,4
S01011533,Fair health,94,3,2,1,8,9,5,7,22,25,14,5,9,1
S01011533,Bad health,48,1,0,1,2,3,5,5,9,16,7,6,1,0
S01011533,Very bad health,19,0,0,0,2,0,0,0,9,6,2,2,0,0
S01011534,All people aged 16 to 74,553,30,4,26,89,99,37,51,98,90,32,18,14,27
S01011534,Very good health,251,17,2,15,49,52,14,18,41,38,4,1,3,18
S01011534,Good health,165,9,1,8,23,31,15,18,27,23,12,5,7,7
S01011534,Fair health,73,3,0,3,13,8,4,6,16,13,9,5,4,1
S01011534,Bad health,52,1,1,0,2,5,3,8,12,13,7,7,0,1
S01011534,Very bad health,12,0,0,0,2,3,1,1,2,3,0,0,0,0
S01011535,All people aged 16 to 74,640,14,5,9,70,76,23,64,135,142,77,48,29,39
S01011535,Very good health,208,5,1,4,28,26,7,21,40,33,24,15,9,24
S01011535,Good health,209,4,1,3,25,31,11,15,35,52,26,12,14,10
S01011535,Fair health,133,4,3,1,12,8,3,15,36,32,18,14,4,5
S01011535,Bad health,60,1,0,1,2,5,2,8,17,18,7,5,2,0
S01011535,Very bad health,30,0,0,0,3,6,0,5,7,7,2,2,0,0
S01011536,All people aged 16 to 74,555,61,15,46,147,99,49,37,62,48,12,5,7,40
S01011536,Very good health,310,33,6,27,89,55,22,22,35,20,5,2,3,29
S01011536,Good health,167,24,6,18,44,32,19,5,20,12,3,2,1,8
S01011536,Fair health,60,4,3,1,13,8,5,7,5,12,3,1,2,3
S01011536,Bad health,14,0,0,0,1,3,2,3,2,2,1,0,1,0
S01011536,Very bad health,4,0,0,0,0,1,1,0,0,2,0,0,0,0
S01011537,All people aged 16 to 74,435,46,11,35,107,94,19,38,49,43,11,6,5,28
S01011537,Very good health,269,32,5,27,69,61,9,24,24,23,5,2,3,22
S01011537,Good health,116,11,4,7,30,26,6,10,12,15,3,1,2,3
S01011537,Fair health,35,1,1,0,5,6,2,3,9,4,2,2,0,3
S01011537,Bad health,12,1,1,0,3,1,1,0,4,1,1,1,0,0
S01011537,Very bad health,3,1,0,1,0,0,1,1,0,0,0,0,0,0
S01011538,All people aged 16 to 74,532,72,20,52,142,84,33,30,70,35,8,3,5,58
S01011538,Very good health,304,44,9,35,89,42,15,19,27,17,3,0,3,48
S01011538,Good health,164,18,6,12,45,29,12,10,28,12,2,1,1,8
S01011538,Fair health,47,9,4,5,4,6,4,0,13,6,3,2,1,2
S01011538,Bad health,11,1,1,0,2,4,1,1,2,0,0,0,0,0
S01011538,Very bad health,6,0,0,0,2,3,1,0,0,0,0,0,0,0
S01011539,All people aged 16 to 74,568,24,5,19,64,55,25,55,121,133,50,30,20,41
S01011539,Very good health,228,14,2,12,29,32,8,22,38,43,18,11,7,24
S01011539,Good health,179,5,3,2,21,19,12,17,40,32,18,7,11,15
S01011539,Fair health,96,2,0,2,11,2,4,10,24,33,10,8,2,0
S01011539,Bad health,55,2,0,2,2,2,1,6,15,21,4,4,0,2
S01011539,Very bad health,10,1,0,1,1,0,0,0,4,4,0,0,0,0
S01011540,All people aged 16 to 74,791,28,3,25,130,104,49,80,154,163,37,22,15,46
S01011540,Very good health,334,18,0,18,64,52,16,30,63,47,14,4,10,30
S01011540,Good health,263,10,3,7,41,34,22,28,46,61,9,6,3,12
S01011540,Fair health,122,0,0,0,16,13,7,11,27,35,9,7,2,4
S01011540,Bad health,56,0,0,0,9,3,4,8,16,12,4,4,0,0
S01011540,Very bad health,16,0,0,0,0,2,0,3,2,8,1,1,0,0
S01011541,All people aged 16 to 74,678,16,6,10,57,56,37,63,169,172,48,30,18,60
S01011541,Very good health,281,10,4,6,23,25,15,25,57,65,22,11,11,39
S01011541,Good health,242,2,0,2,25,22,14,21,65,63,13,9,4,17
S01011541,Fair health,101,3,2,1,8,7,6,12,24,28,9,6,3,4
S01011541,Bad health,42,1,0,1,1,1,2,3,19,13,2,2,0,0
S01011541,Very bad health,12,0,0,0,0,1,0,2,4,3,2,2,0,0
S01011542,All people aged 16 to 74,699,20,8,12,67,86,34,74,173,162,48,23,25,35
S01011542,Very good health,299,12,3,9,32,42,13,37,59,61,16,3,13,27
S01011542,Good health,235,5,3,2,20,35,11,20,68,57,12,10,2,7
S01011542,Fair health,98,2,1,1,8,4,7,11,27,24,14,5,9,1
S01011542,Bad health,57,0,0,0,6,5,3,6,17,16,4,3,1,0
S01011542,Very bad health,10,1,1,0,1,0,0,0,2,4,2,2,0,0
S01011543,All people aged 16 to 74,591,10,3,7,54,66,27,56,145,142,53,35,18,38
S01011543,Very good health,265,5,1,4,24,42,13,22,58,55,18,14,4,28
S01011543,Good health,181,2,0,2,21,16,9,23,44,46,11,5,6,9
S01011543,Fair health,82,1,0,1,6,4,3,7,23,20,17,9,8,1
S01011543,Bad health,50,2,2,0,3,4,2,3,13,18,5,5,0,0
S01011543,Very bad health,13,0,0,0,0,0,0,1,7,3,2,2,0,0
S01011544,All people aged 16 to 74,515,11,3,8,60,49,23,38,137,135,33,20,13,29
S01011544,Very good health,192,7,2,5,26,19,11,12,40,41,16,8,8,20
S01011544,Good health,159,2,1,1,22,15,8,16,48,33,7,3,4,8
S01011544,Fair health,99,2,0,2,8,10,3,7,34,30,5,4,1,0
S01011544,Bad health,46,0,0,0,4,3,0,3,12,20,3,3,0,1
S01011544,Very bad health,19,0,0,0,0,2,1,0,3,11,2,2,0,0
S01011545,All people aged 16 to 74,452,12,5,7,45,50,20,59,113,107,22,13,9,24
S01011545,Very good health,166,10,4,6,20,19,5,20,41,29,7,6,1,15
S01011545,Good health,161,2,1,1,16,18,8,27,38,38,7,2,5,7
S01011545,Fair health,82,0,0,0,4,9,4,9,23,25,6,3,3,2
S01011545,Bad health,34,0,0,0,3,2,2,3,11,11,2,2,0,0
S01011545,Very bad health,9,0,0,0,2,2,1,0,0,4,0,0,0,0
S01011546,All people aged 16 to 74,547,59,18,41,152,91,53,31,57,32,9,5,4,63
S01011546,Very good health,322,33,12,21,101,46,24,14,32,20,3,1,2,49
S01011546,Good health,173,20,5,15,42,36,20,12,20,8,3,1,2,12
S01011546,Fair health,42,3,1,2,7,7,8,5,5,4,2,2,0,1
S01011546,Bad health,5,2,0,2,1,1,0,0,0,0,0,0,0,1
S01011546,Very bad health,5,1,0,1,1,1,1,0,0,0,1,1,0,0
S01011547,All people aged 16 to 74,432,41,7,34,133,66,34,30,43,36,12,7,5,37
S01011547,Very good health,276,31,6,25,84,43,20,17,23,20,8,5,3,30
S01011547,Good health,108,10,1,9,37,18,8,9,11,7,2,1,1,6
S01011547,Fair health,34,0,0,0,9,4,4,3,5,7,1,0,1,1
S01011547,Bad health,12,0,0,0,2,1,1,1,4,2,1,1,0,0
S01011547,Very bad health,2,0,0,0,1,0,1,0,0,0,0,0,0,0
S01011548,All people aged 16 to 74,543,31,10,21,79,95,34,50,102,100,12,6,6,40
S01011548,Very good health,261,16,4,12,42,48,17,24,46,31,4,2,2,33
S01011548,Good health,149,11,3,8,25,28,8,9,28,30,5,1,4,5
S01011548,Fair health,88,3,3,0,11,16,5,10,19,22,0,0,0,2
S01011548,Bad health,34,1,0,1,1,2,4,4,8,11,3,3,0,0
S01011548,Very bad health,11,0,0,0,0,1,0,3,1,6,0,0,0,0
S01011549,All people aged 16 to 74,625,47,10,37,148,104,38,50,91,87,21,8,13,39
S01011549,Very good health,287,22,8,14,79,46,16,25,31,23,11,4,7,34
S01011549,Good health,233,21,2,19,53,44,13,18,41,35,6,2,4,2
S01011549,Fair health,71,3,0,3,11,7,7,6,15,16,3,1,2,3
S01011549,Bad health,26,1,0,1,3,5,2,0,3,11,1,1,0,0
S01011549,Very bad health,8,0,0,0,2,2,0,1,1,2,0,0,0,0
S01011550,All people aged 16 to 74,564,63,8,55,157,120,45,31,58,33,10,2,8,47
S01011550,Very good health,312,46,5,41,85,65,23,15,29,12,1,0,1,36
S01011550,Good health,185,14,2,12,53,43,15,12,19,13,7,2,5,9
S01011550,Fair health,49,1,0,1,16,9,5,3,6,5,2,0,2,2
S01011550,Bad health,16,2,1,1,3,2,1,1,4,3,0,0,0,0
S01011550,Very bad health,2,0,0,0,0,1,1,0,0,0,0,0,0,0
S01011551,All people aged 16 to 74,406,20,5,15,79,62,33,45,64,54,22,12,10,27
S01011551,Very good health,181,11,3,8,38,37,8,17,25,21,4,2,2,20
S01011551,Good health,130,5,2,3,31,15,16,16,17,15,10,5,5,5
S01011551,Fair health,62,4,0,4,6,8,6,5,16,9,7,4,3,1
S01011551,Bad health,28,0,0,0,3,1,2,7,6,8,0,0,0,1
S01011551,Very bad health,5,0,0,0,1,1,1,0,0,1,1,1,0,0
S01011552,All people aged 16 to 74,568,32,3,29,121,101,40,54,90,50,20,10,10,60
S01011552,Very good health,271,14,1,13,53,47,15,24,35,23,10,3,7,50
S01011552,Good health,194,15,1,14,49,36,19,19,31,9,6,4,2,10
S01011552,Fair health,71,2,1,1,14,13,3,7,20,10,2,1,1,0
S01011552,Bad health,25,0,0,0,4,4,2,3,3,8,1,1,0,0
S01011552,Very bad health,7,1,0,1,1,1,1,1,1,0,1,1,0,0
S01011553,All people aged 16 to 74,615,90,14,76,190,60,72,32,51,29,22,12,10,69
S01011553,Very good health,406,62,9,53,126,38,44,20,24,18,11,6,5,63
S01011553,Good health,150,23,5,18,53,19,18,7,11,8,6,2,4,5
S01011553,Fair health,34,4,0,4,7,3,5,4,7,2,2,2,0,0
S01011553,Bad health,17,1,0,1,2,0,3,1,6,1,3,2,1,0
S01011553,Very bad health,8,0,0,0,2,0,2,0,3,0,0,0,0,1
S01011554,All people aged 16 to 74,657,23,5,18,84,105,43,61,127,158,30,21,9,26
S01011554,Very good health,254,10,2,8,40,48,10,24,41,53,7,4,3,21
S01011554,Good health,236,8,1,7,27,35,20,25,50,59,8,4,4,4
S01011554,Fair health,117,3,0,3,12,14,10,11,31,26,9,8,1,1
S01011554,Bad health,39,1,1,0,3,5,2,1,4,19,4,3,1,0
S01011554,Very bad health,11,1,1,0,2,3,1,0,1,1,2,2,0,0
S01011555,All people aged 16 to 74,438,8,2,6,39,61,18,43,96,100,31,24,7,42
S01011555,Very good health,180,2,0,2,14,35,11,15,32,27,14,11,3,30
S01011555,Good health,155,5,2,3,17,16,4,18,36,40,9,5,4,10
S01011555,Fair health,57,0,0,0,4,8,2,7,10,23,2,2,0,1
S01011555,Bad health,33,1,0,1,0,1,1,3,15,6,5,5,0,1
S01011555,Very bad health,13,0,0,0,4,1,0,0,3,4,1,1,0,0
S01011556,All people aged 16 to 74,378,8,3,5,42,56,26,32,89,64,34,19,15,27
S01011556,Very good health,153,4,1,3,18,26,14,9,33,21,6,3,3,22
S01011556,Good health,126,2,1,1,18,23,7,9,32,17,14,5,9,4
S01011556,Fair health,42,0,0,0,1,2,4,6,12,9,7,4,3,1
S01011556,Bad health,38,2,1,1,3,2,1,8,9,9,4,4,0,0
S01011556,Very bad health,19,0,0,0,2,3,0,0,3,8,3,3,0,0
S01011557,All people aged 16 to 74,550,9,6,3,80,68,25,47,139,122,35,21,14,25
S01011557,Very good health,225,3,2,1,33,35,11,21,52,44,11,7,4,15
S01011557,Good health,189,3,2,1,34,24,11,15,38,41,13,6,7,10
S01011557,Fair health,84,2,2,0,11,7,2,9,27,21,5,3,2,0
S01011557,Bad health,35,0,0,0,2,0,1,2,14,13,3,2,1,0
S01011557,Very bad health,17,1,0,1,0,2,0,0,8,3,3,3,0,0
S01011558,All people aged 16 to 74,428,13,5,8,44,58,27,45,88,92,32,16,16,29
S01011558,Very good health,190,4,2,2,19,23,16,22,32,38,10,3,7,26
S01011558,Good health,140,5,3,2,17,20,6,16,41,28,6,4,2,1
S01011558,Fair health,72,4,0,4,6,15,3,3,8,19,13,6,7,1
S01011558,Bad health,21,0,0,0,2,0,2,4,6,5,1,1,0,1
S01011558,Very bad health,5,0,0,0,0,0,0,0,1,2,2,2,0,0
S01011559,All people aged 16 to 74,471,8,2,6,52,45,25,56,109,102,46,24,22,28
S01011559,Very good health,173,2,1,1,23,20,7,28,36,26,11,3,8,20
S01011559,Good health,151,3,1,2,13,13,10,13,34,37,20,10,10,8
S01011559,Fair health,79,1,0,1,8,6,3,5,28,21,7,6,1,0
S01011559,Bad health,43,2,0,2,5,5,2,9,7,9,4,2,2,0
S01011559,Very bad health,25,0,0,0,3,1,3,1,4,9,4,3,1,0
S01011560,All people aged 16 to 74,580,15,9,6,72,64,17,47,136,157,41,22,19,31
S01011560,Very good health,235,8,4,4,39,32,6,16,48,55,14,6,8,17
S01011560,Good health,199,5,4,1,22,20,7,21,47,55,11,2,9,11
S01011560,Fair health,90,0,0,0,8,10,1,5,24,30,9,7,2,3
S01011560,Bad health,46,1,0,1,3,2,2,3,14,15,6,6,0,0
S01011560,Very bad health,10,1,1,0,0,0,1,2,3,2,1,1,0,0
S01011561,All people aged 16 to 74,602,7,1,6,72,66,20,59,132,134,57,34,23,55
S01011561,Very good health,242,5,1,4,26,35,7,27,42,48,15,6,9,37
S01011561,Good health,184,1,0,1,28,17,5,13,40,45,24,16,8,11
S01011561,Fair health,105,0,0,0,12,10,2,11,30,24,10,5,5,6
S01011561,Bad health,51,1,0,1,5,3,3,6,16,11,5,5,0,1
S01011561,Very bad health,20,0,0,0,1,1,3,2,4,6,3,2,1,0
S01011562,All people aged 16 to 74,466,10,0,10,47,68,24,38,84,96,58,40,18,41
S01011562,Very good health,197,4,0,4,28,38,6,17,33,32,13,7,6,26
S01011562,Good health,159,5,0,5,13,21,8,10,30,38,23,13,10,11
S01011562,Fair health,73,1,0,1,5,6,8,8,8,21,13,11,2,3
S01011562,Bad health,29,0,0,0,1,2,2,2,12,3,7,7,0,0
S01011562,Very bad health,8,0,0,0,0,1,0,1,1,2,2,2,0,1
S01011563,All people aged 16 to 74,556,10,4,6,78,68,25,39,109,112,51,40,11,64
S01011563,Very good health,195,4,1,3,34,27,7,14,31,23,11,9,2,44
S01011563,Good health,190,4,2,2,31,28,12,11,38,34,17,9,8,15
S01011563,Fair health,108,2,1,1,8,11,3,7,23,35,16,15,1,3
S01011563,Bad health,49,0,0,0,5,2,2,5,14,14,5,5,0,2
S01011563,Very bad health,14,0,0,0,0,0,1,2,3,6,2,2,0,0
S01011564,All people aged 16 to 74,711,28,7,21,115,114,45,79,113,141,35,15,20,41
S01011564,Very good health,325,19,4,15,63,61,22,32,34,45,14,7,7,35
S01011564,Good health,234,7,3,4,37,37,14,31,47,42,14,4,10,5
S01011564,Fair health,99,1,0,1,12,13,6,9,25,28,4,3,1,1
S01011564,Bad health,42,1,0,1,3,2,3,5,4,22,2,1,1,0
S01011564,Very bad health,11,0,0,0,0,1,0,2,3,4,1,0,1,0
S01011565,All people aged 16 to 74,705,17,5,12,94,99,31,77,154,146,41,22,19,46
S01011565,Very good health,312,11,3,8,53,49,15,30,58,45,15,11,4,36
S01011565,Good health,233,6,2,4,29,35,11,28,56,50,10,3,7,8
S01011565,Fair health,109,0,0,0,10,9,3,9,27,35,14,6,8,2
S01011565,Bad health,43,0,0,0,2,4,1,7,13,15,1,1,0,0
S01011565,Very bad health,8,0,0,0,0,2,1,3,0,1,1,1,0,0
S01011566,All people aged 16 to 74,673,19,5,14,59,92,32,69,136,149,63,34,29,54
S01011566,Very good health,290,5,0,5,27,37,12,33,59,54,25,13,12,38
S01011566,Good health,203,12,3,9,20,37,12,22,35,37,14,3,11,14
S01011566,Fair health,113,2,2,0,5,15,4,6,25,37,18,12,6,1
S01011566,Bad health,50,0,0,0,5,1,4,7,14,15,4,4,0,0
S01011566,Very bad health,17,0,0,0,2,2,0,1,3,6,2,2,0,1
S01011567,All people aged 16 to 74,715,23,3,20,72,113,43,65,148,157,56,46,10,38
S01011567,Very good health,277,12,0,12,36,57,15,23,47,40,19,14,5,28
S01011567,Good health,226,5,2,3,18,35,15,21,53,58,13,9,4,8
S01011567,Fair health,125,6,1,5,11,13,8,11,30,29,15,14,1,2
S01011567,Bad health,61,0,0,0,6,3,3,7,14,24,4,4,0,0
S01011567,Very bad health,26,0,0,0,1,5,2,3,4,6,5,5,0,0
S01011568,All people aged 16 to 74,612,35,9,26,106,97,41,53,117,92,37,25,12,34
S01011568,Very good health,285,18,5,13,61,45,16,21,51,34,19,10,9,20
S01011568,Good health,192,13,2,11,31,33,12,21,35,33,4,3,1,10
S01011568,Fair health,86,3,1,2,9,14,8,6,23,14,6,5,1,3
S01011568,Bad health,34,1,1,0,3,3,4,4,7,9,3,3,0,0
S01011568,Very bad health,15,0,0,0,2,2,1,1,1,2,5,4,1,1
S01011569,All people aged 16 to 74,743,45,13,32,126,109,32,75,152,128,36,26,10,40
S01011569,Very good health,309,21,5,16,65,50,11,28,56,41,9,4,5,28
S01011569,Good health,257,18,6,12,46,41,12,28,44,46,13,8,5,9
S01011569,Fair health,112,3,2,1,6,14,7,15,34,25,5,5,0,3
S01011569,Bad health,50,3,0,3,5,2,1,4,14,15,6,6,0,0
S01011569,Very bad health,15,0,0,0,4,2,1,0,4,1,3,3,0,0
S01011570,All people aged 16 to 74,537,17,7,10,63,89,24,48,129,107,29,19,10,31
S01011570,Very good health,206,7,3,4,27,40,9,13,47,35,7,3,4,21
S01011570,Good health,177,9,4,5,21,21,7,23,51,30,11,6,5,4
S01011570,Fair health,91,1,0,1,11,13,5,4,23,25,4,4,0,5
S01011570,Bad health,46,0,0,0,1,14,3,6,4,11,6,5,1,1
S01011570,Very bad health,17,0,0,0,3,1,0,2,4,6,1,1,0,0
S01011571,All people aged 16 to 74,498,10,1,9,68,65,26,46,112,114,32,18,14,25
S01011571,Very good health,170,5,0,5,28,20,6,18,39,35,6,2,4,13
S01011571,Good health,168,4,1,3,24,24,7,13,41,39,8,4,4,8
S01011571,Fair health,99,0,0,0,9,15,5,8,20,28,10,5,5,4
S01011571,Bad health,49,1,0,1,5,5,7,5,10,10,6,5,1,0
S01011571,Very bad health,12,0,0,0,2,1,1,2,2,2,2,2,0,0
S01011572,All people aged 16 to 74,451,25,7,18,87,65,28,36,78,71,36,21,15,25
S01011572,Very good health,183,15,4,11,46,30,7,8,28,20,11,6,5,18
S01011572,Good health,146,6,2,4,25,18,12,17,24,26,13,4,9,5
S01011572,Fair health,87,2,1,1,11,14,6,7,20,17,8,7,1,2
S01011572,Bad health,26,2,0,2,4,3,3,3,2,5,4,4,0,0
S01011572,Very bad health,9,0,0,0,1,0,0,1,4,3,0,0,0,0
S01011573,All people aged 16 to 74,783,55,10,45,175,123,59,62,111,109,37,21,16,52
S01011573,Very good health,410,34,4,30,107,63,35,29,50,43,13,7,6,36
S01011573,Good health,233,16,4,12,51,42,15,20,31,32,10,5,5,16
S01011573,Fair health,84,5,2,3,7,12,7,10,16,16,11,6,5,0
S01011573,Bad health,40,0,0,0,6,6,1,2,11,12,2,2,0,0
S01011573,Very bad health,16,0,0,0,4,0,1,1,3,6,1,1,0,0
S01011574,All people aged 16 to 74,570,33,13,20,101,91,43,62,94,103,18,13,5,25
S01011574,Very good health,265,20,8,12,52,45,17,32,36,37,6,5,1,20
S01011574,Good health,191,6,3,3,36,34,19,18,33,33,8,4,4,4
S01011574,Fair health,69,6,2,4,9,10,5,7,15,16,0,0,0,1
S01011574,Bad health,37,1,0,1,3,2,1,4,9,13,4,4,0,0
S01011574,Very bad health,8,0,0,0,1,0,1,1,1,4,0,0,0,0
S01011575,All people aged 16 to 74,381,12,3,9,63,39,19,36,78,68,33,18,15,33
S01011575,Very good health,169,6,2,4,35,22,7,20,26,28,9,4,5,16
S01011575,Good health,100,4,0,4,17,9,7,9,22,15,15,7,8,2
S01011575,Fair health,75,0,0,0,11,5,1,3,24,13,3,1,2,15
S01011575,Bad health,27,0,0,0,0,3,3,3,6,8,4,4,0,0
S01011575,Very bad health,10,2,1,1,0,0,1,1,0,4,2,2,0,0
S01011576,All people aged 16 to 74,576,6,1,5,43,66,23,48,140,156,62,34,28,32
S01011576,Very good health,190,2,1,1,18,19,4,15,42,49,20,10,10,21
S01011576,Good health,152,2,0,2,8,26,8,14,41,35,9,5,4,9
S01011576,Fair health,144,1,0,1,10,14,7,14,34,40,22,9,13,2
S01011576,Bad health,79,1,0,1,7,4,4,3,22,27,11,10,1,0
S01011576,Very bad health,11,0,0,0,0,3,0,2,1,5,0,0,0,0
S01011577,All people aged 16 to 74,547,32,5,27,110,81,31,42,98,85,33,23,10,35
S01011577,Very good health,246,19,3,16,49,42,9,20,40,32,8,6,2,27
S01011577,Good health,160,8,1,7,35,20,15,12,35,20,9,4,5,6
S01011577,Fair health,75,5,1,4,16,10,2,6,12,15,8,6,2,1
S01011577,Bad health,53,0,0,0,9,7,4,4,9,13,6,5,1,1
S01011577,Very bad health,13,0,0,0,1,2,1,0,2,5,2,2,0,0
S01011578,All people aged 16 to 74,642,22,6,16,99,87,24,48,131,123,50,29,21,58
S01011578,Very good health,282,10,4,6,56,43,10,21,44,35,19,11,8,44
S01011578,Good health,222,11,2,9,32,29,9,17,54,45,15,4,11,10
S01011578,Fair health,79,1,0,1,7,11,2,5,17,23,10,8,2,3
S01011578,Bad health,36,0,0,0,2,2,2,1,9,15,4,4,0,1
S01011578,Very bad health,23,0,0,0,2,2,1,4,7,5,2,2,0,0
S01011579,All people aged 16 to 74,820,96,22,74,245,135,70,57,82,35,18,8,10,82
S01011579,Very good health,458,65,16,49,134,63,36,31,33,20,4,1,3,72
S01011579,Good health,270,27,5,22,100,49,23,16,31,8,8,4,4,8
S01011579,Fair health,59,4,1,3,6,15,7,8,10,5,2,1,1,2
S01011579,Bad health,28,0,0,0,4,6,4,2,6,2,4,2,2,0
S01011579,Very bad health,5,0,0,0,1,2,0,0,2,0,0,0,0,0
S01011580,All people aged 16 to 74,537,31,5,26,85,81,33,48,84,87,46,31,15,42
S01011580,Very good health,258,20,3,17,53,43,11,22,28,34,18,13,5,29
S01011580,Good health,153,8,1,7,24,23,12,12,30,20,14,6,8,10
S01011580,Fair health,72,0,0,0,6,5,7,9,14,18,11,9,2,2
S01011580,Bad health,44,3,1,2,2,8,2,5,10,11,3,3,0,0
S01011580,Very bad health,10,0,0,0,0,2,1,0,2,4,0,0,0,1
S01011581,All people aged 16 to 74,567,23,4,19,66,68,28,62,127,116,58,38,20,19
S01011581,Very good health,184,15,1,14,22,26,10,19,37,26,16,8,8,13
S01011581,Good health,185,5,2,3,28,30,8,18,42,31,18,9,9,5
S01011581,Fair health,118,2,0,2,10,6,5,15,28,36,15,12,3,1
S01011581,Bad health,54,1,1,0,5,4,4,4,14,18,4,4,0,0
S01011581,Very bad health,26,0,0,0,1,2,1,6,6,5,5,5,0,0
S01011582,All people aged 16 to 74,848,107,24,83,250,140,61,47,114,58,8,6,2,63
S01011582,Very good health,479,75,17,58,141,70,35,27,50,24,3,2,1,54
S01011582,Good health,251,23,5,18,80,42,18,14,43,22,2,1,1,7
S01011582,Fair health,87,7,1,6,22,19,7,4,16,9,2,2,0,1
S01011582,Bad health,19,2,1,1,4,5,0,2,1,3,1,1,0,1
S01011582,Very bad health,12,0,0,0,3,4,1,0,4,0,0,0,0,0
S01011583,All people aged 16 to 74,524,28,8,20,117,70,18,57,101,81,27,13,14,25
S01011583,Very good health,238,17,5,12,62,34,9,27,36,26,9,4,5,18
S01011583,Good health,161,9,2,7,32,23,6,15,34,26,10,7,3,6
S01011583,Fair health,80,0,0,0,17,10,2,8,22,16,4,1,3,1
S01011583,Bad health,37,2,1,1,6,1,1,7,7,9,4,1,3,0
S01011583,Very bad health,8,0,0,0,0,2,0,0,2,4,0,0,0,0
S01011584,All people aged 16 to 74,536,12,2,10,68,95,15,52,114,124,35,25,10,21
S01011584,Very good health,215,6,1,5,29,41,4,22,49,35,13,10,3,16
S01011584,Good health,169,4,0,4,24,26,8,13,39,47,4,0,4,4
S01011584,Fair health,94,1,0,1,9,18,2,11,16,30,7,5,2,0
S01011584,Bad health,49,1,1,0,5,9,1,5,9,9,10,9,1,0
S01011584,Very bad health,9,0,0,0,1,1,0,1,1,3,1,1,0,1
S01011585,All people aged 16 to 74,513,15,4,11,72,86,24,46,119,88,26,17,9,37
S01011585,Very good health,213,12,4,8,39,32,7,20,38,31,9,7,2,25
S01011585,Good health,182,0,0,0,24,33,13,18,41,35,7,4,3,11
S01011585,Fair health,72,2,0,2,7,12,3,4,23,15,6,2,4,0
S01011585,Bad health,34,1,0,1,1,8,0,4,12,5,2,2,0,1
S01011585,Very bad health,12,0,0,0,1,1,1,0,5,2,2,2,0,0
S01011586,All people aged 16 to 74,425,8,3,5,59,59,14,42,81,95,34,17,17,33
S01011586,Very good health,168,2,1,1,31,20,4,19,29,30,8,6,2,25
S01011586,Good health,147,5,2,3,24,26,6,10,30,26,15,4,11,5
S01011586,Fair health,73,1,0,1,3,12,4,8,11,26,8,4,4,0
S01011586,Bad health,29,0,0,0,1,1,0,5,8,11,1,1,0,2
S01011586,Very bad health,8,0,0,0,0,0,0,0,3,2,2,2,0,1
S01011587,All people aged 16 to 74,417,9,4,5,53,44,16,48,99,85,27,16,11,36
S01011587,Very good health,180,6,3,3,23,25,4,17,36,35,10,8,2,24
S01011587,Good health,143,3,1,2,21,12,6,22,33,25,11,4,7,10
S01011587,Fair health,60,0,0,0,7,3,6,8,20,12,3,1,2,1
S01011587,Bad health,28,0,0,0,2,4,0,1,10,8,3,3,0,0
S01011587,Very bad health,6,0,0,0,0,0,0,0,0,5,0,0,0,1
S01011588,All people aged 16 to 74,568,21,9,12,61,82,38,52,124,99,45,31,14,46
S01011588,Very good health,249,12,3,9,30,39,18,22,43,33,15,7,8,37
S01011588,Good health,164,5,4,1,20,27,10,19,36,26,12,10,2,9
S01011588,Fair health,103,3,2,1,6,13,8,9,35,21,8,5,3,0
S01011588,Bad health,39,1,0,1,3,2,2,2,10,13,6,5,1,0
S01011588,Very bad health,13,0,0,0,2,1,0,0,0,6,4,4,0,0
S01011589,All people aged 16 to 74,637,22,8,14,98,93,35,55,138,118,34,28,6,44
S01011589,Very good health,278,11,2,9,38,44,18,18,50,49,14,11,3,36
S01011589,Good health,210,5,3,2,37,31,10,21,64,29,7,4,3,6
S01011589,Fair health,103,6,3,3,19,16,5,9,15,25,7,7,0,1
S01011589,Bad health,32,0,0,0,2,2,1,5,7,11,3,3,0,1
S01011589,Very bad health,14,0,0,0,2,0,1,2,2,4,3,3,0,0
S01011590,All people aged 16 to 74,511,17,3,14,64,72,29,57,107,96,42,24,18,27
S01011590,Very good health,192,8,0,8,29,36,10,20,38,22,14,9,5,15
S01011590,Good health,176,6,3,3,26,21,15,21,35,32,11,3,8,9
S01011590,Fair health,99,3,0,3,8,10,2,10,23,30,11,7,4,2
S01011590,Bad health,35,0,0,0,1,5,2,3,9,9,6,5,1,0
S01011590,Very bad health,9,0,0,0,0,0,0,3,2,3,0,0,0,1
S01011591,All people aged 16 to 74,477,12,0,12,55,51,27,43,88,119,54,31,23,28
S01011591,Very good health,176,5,0,5,26,20,10,14,25,43,16,11,5,17
S01011591,Good health,147,6,0,6,19,19,8,10,32,32,13,4,9,8
S01011591,Fair health,78,1,0,1,7,6,5,10,13,21,13,6,7,2
S01011591,Bad health,49,0,0,0,2,6,2,6,12,14,6,4,2,1
S01011591,Very bad health,27,0,0,0,1,0,2,3,6,9,6,6,0,0
S01011592,All people aged 16 to 74,508,14,2,12,60,60,26,49,110,111,56,35,21,22
S01011592,Very good health,209,10,0,10,28,28,6,26,40,33,22,16,6,16
S01011592,Good health,153,4,2,2,18,20,10,12,35,32,17,7,10,5
S01011592,Fair health,85,0,0,0,9,8,9,5,23,24,6,3,3,1
S01011592,Bad health,49,0,0,0,3,3,1,6,12,14,10,8,2,0
S01011592,Very bad health,12,0,0,0,2,1,0,0,0,8,1,1,0,0
S01011593,All people aged 16 to 74,536,32,9,23,97,91,29,40,92,91,25,15,10,39
S01011593,Very good health,242,21,4,17,51,42,13,18,28,30,7,6,1,32
S01011593,Good health,182,6,2,4,33,29,12,17,41,31,8,2,6,5
S01011593,Fair health,83,4,3,1,10,19,3,3,18,16,8,5,3,2
S01011593,Bad health,19,0,0,0,2,1,1,2,4,9,0,0,0,0
S01011593,Very bad health,10,1,0,1,1,0,0,0,1,5,2,2,0,0
S01011594,All people aged 16 to 74,344,14,4,10,50,45,33,38,66,63,6,4,2,29
S01011594,Very good health,151,8,2,6,28,20,13,17,24,15,3,1,2,23
S01011594,Good health,102,3,2,1,11,17,9,11,21,23,2,2,0,5
S01011594,Fair health,58,2,0,2,8,5,7,8,11,15,1,1,0,1
S01011594,Bad health,23,1,0,1,0,2,3,1,8,8,0,0,0,0
S01011594,Very bad health,10,0,0,0,3,1,1,1,2,2,0,0,0,0
S01011595,All people aged 16 to 74,475,51,8,43,123,86,44,27,42,58,10,2,8,34
S01011595,Very good health,240,28,4,24,72,47,23,16,17,13,5,1,4,19
S01011595,Good health,168,18,2,16,38,32,14,6,16,25,4,1,3,15
S01011595,Fair health,48,5,2,3,9,6,3,2,8,14,1,0,1,0
S01011595,Bad health,17,0,0,0,4,1,4,2,1,5,0,0,0,0
S01011595,Very bad health,2,0,0,0,0,0,0,1,0,1,0,0,0,0
S01011596,All people aged 16 to 74,779,65,14,51,187,122,38,42,127,93,47,31,16,58
S01011596,Very good health,370,35,8,27,97,64,17,16,47,34,15,10,5,45
S01011596,Good health,270,21,4,17,74,43,10,17,39,36,19,13,6,11
S01011596,Fair health,97,8,1,7,13,11,8,5,26,16,9,5,4,1
S01011596,Bad health,36,1,1,0,3,3,2,3,13,6,4,3,1,1
S01011596,Very bad health,6,0,0,0,0,1,1,1,2,1,0,0,0,0
S01011597,All people aged 16 to 74,436,25,6,19,100,67,22,45,82,44,16,9,7,35
S01011597,Very good health,206,13,2,11,57,32,8,17,33,17,4,2,2,25
S01011597,Good health,158,11,4,7,34,20,13,23,24,17,7,5,2,9
S01011597,Fair health,51,1,0,1,4,11,1,3,18,8,4,2,2,1
S01011597,Bad health,17,0,0,0,5,3,0,1,5,2,1,0,1,0
S01011597,Very bad health,4,0,0,0,0,1,0,1,2,0,0,0,0,0
S01011598,All people aged 16 to 74,646,10,1,9,43,70,31,54,144,143,114,52,62,37
S01011598,Very good health,205,5,1,4,14,25,8,20,48,29,35,19,16,21
S01011598,Good health,214,4,0,4,17,29,10,10,56,43,35,12,23,10
S01011598,Fair health,127,1,0,1,8,10,8,10,24,36,26,6,20,4
S01011598,Bad health,73,0,0,0,3,3,4,10,13,26,13,10,3,1
S01011598,Very bad health,27,0,0,0,1,3,1,4,3,9,5,5,0,1
S01011599,All people aged 16 to 74,596,20,4,16,106,92,25,50,113,125,34,18,16,31
S01011599,Very good health,241,9,3,6,46,42,15,18,43,36,10,6,4,22
S01011599,Good health,203,7,0,7,37,33,6,17,36,46,15,7,8,6
S01011599,Fair health,94,4,1,3,17,10,2,8,20,23,7,4,3,3
S01011599,Bad health,48,0,0,0,2,6,1,6,12,19,2,1,1,0
S01011599,Very bad health,10,0,0,0,4,1,1,1,2,1,0,0,0,0
S01011600,All people aged 16 to 74,561,21,2,19,86,84,27,64,116,108,24,19,5,31
S01011600,Very good health,242,12,2,10,44,37,14,27,45,31,11,10,1,21
S01011600,Good health,174,5,0,5,24,33,3,20,34,40,8,4,4,7
S01011600,Fair health,86,3,0,3,10,10,7,8,22,19,4,4,0,3
S01011600,Bad health,49,1,0,1,6,3,2,8,13,16,0,0,0,0
S01011600,Very bad health,10,0,0,0,2,1,1,1,2,2,1,1,0,0
S01011601,All people aged 16 to 74,644,52,14,38,152,116,39,62,82,71,15,10,5,55
S01011601,Very good health,366,32,8,24,97,60,25,28,39,32,7,5,2,46
S01011601,Good health,199,16,4,12,42,42,12,27,27,22,4,3,1,7
S01011601,Fair health,55,2,0,2,9,9,2,3,12,15,2,1,1,1
S01011601,Bad health,22,2,2,0,4,4,0,4,3,2,2,1,1,1
S01011601,Very bad health,2,0,0,0,0,1,0,0,1,0,0,0,0,0
S01011602,All people aged 16 to 74,442,22,6,16,66,48,28,32,97,94,37,24,13,18
S01011602,Very good health,178,10,2,8,27,21,10,18,42,23,13,8,5,14
S01011602,Good health,154,8,2,6,30,15,14,8,27,35,13,5,8,4
S01011602,Fair health,74,3,2,1,5,7,1,3,17,29,9,9,0,0
S01011602,Bad health,26,1,0,1,2,3,2,2,8,6,2,2,0,0
S01011602,Very bad health,10,0,0,0,2,2,1,1,3,1,0,0,0,0
S01011603,All people aged 16 to 74,566,8,1,7,75,86,26,53,123,121,45,27,18,29
S01011603,Very good health,200,6,1,5,32,38,9,21,37,30,10,5,5,17
S01011603,Good health,182,2,0,2,24,24,8,13,49,41,12,5,7,9
S01011603,Fair health,107,0,0,0,14,14,6,9,16,32,13,10,3,3
S01011603,Bad health,58,0,0,0,5,6,2,6,16,15,8,5,3,0
S01011603,Very bad health,19,0,0,0,0,4,1,4,5,3,2,2,0,0
S01011604,All people aged 16 to 74,460,5,2,3,52,59,22,43,102,105,43,22,21,29
S01011604,Very good health,192,1,0,1,18,28,12,22,41,38,13,5,8,19
S01011604,Good health,159,1,0,1,22,21,9,15,27,36,19,10,9,9
S01011604,Fair health,71,2,1,1,10,7,1,1,25,17,8,4,4,0
S01011604,Bad health,24,1,1,0,1,0,0,4,6,9,2,2,0,1
S01011604,Very bad health,14,0,0,0,1,3,0,1,3,5,1,1,0,0
S01011605,All people aged 16 to 74,622,12,3,9,89,93,46,64,142,108,31,15,16,37
S01011605,Very good health,262,9,2,7,37,37,20,27,57,33,10,6,4,32
S01011605,Good health,180,2,0,2,29,31,12,19,37,34,12,5,7,4
S01011605,Fair health,126,1,1,0,15,19,9,14,33,25,9,4,5,1
S01011605,Bad health,42,0,0,0,6,6,3,3,11,13,0,0,0,0
S01011605,Very bad health,12,0,0,0,2,0,2,1,4,3,0,0,0,0
S01011606,All people aged 16 to 74,725,71,15,56,208,127,39,55,83,73,12,7,5,57
S01011606,Very good health,427,45,7,38,126,78,18,28,51,32,3,2,1,46
S01011606,Good health,213,21,7,14,70,35,16,21,15,22,4,1,3,9
S01011606,Fair health,62,4,0,4,10,11,5,5,11,12,3,2,1,1
S01011606,Bad health,16,1,1,0,1,3,0,1,5,4,1,1,0,0
S01011606,Very bad health,7,0,0,0,1,0,0,0,1,3,1,1,0,1
S01011607,All people aged 16 to 74,469,38,11,27,104,86,33,48,66,42,15,5,10,37
S01011607,Very good health,240,16,4,12,57,46,14,22,27,14,10,2,8,34
S01011607,Good health,162,17,6,11,33,35,11,18,24,19,2,2,0,3
S01011607,Fair health,46,5,1,4,7,3,6,6,9,7,3,1,2,0
S01011607,Bad health,14,0,0,0,5,0,1,1,6,1,0,0,0,0
S01011607,Very bad health,7,0,0,0,2,2,1,1,0,1,0,0,0,0
S01011608,All people aged 16 to 74,726,59,17,42,167,144,55,64,102,77,18,12,6,40
S01011608,Very good health,366,30,6,24,92,83,25,24,53,27,8,5,3,24
S01011608,Good health,232,25,10,15,52,38,22,29,29,24,3,2,1,10
S01011608,Fair health,99,4,1,3,19,16,4,7,17,20,6,5,1,6
S01011608,Bad health,20,0,0,0,2,6,2,2,2,5,1,0,1,0
S01011608,Very bad health,9,0,0,0,2,1,2,2,1,1,0,0,0,0
S01011609,All people aged 16 to 74,722,17,0,17,55,61,38,73,147,180,96,60,36,55
S01011609,Very good health,262,6,0,6,22,35,14,29,44,54,24,12,12,34
S01011609,Good health,231,6,0,6,20,15,15,23,44,63,27,11,16,18
S01011609,Fair health,118,2,0,2,7,8,6,8,37,27,21,15,6,2
S01011609,Bad health,79,3,0,3,4,2,2,5,16,28,19,17,2,0
S01011609,Very bad health,32,0,0,0,2,1,1,8,6,8,5,5,0,1
S01011610,All people aged 16 to 74,598,12,2,10,64,71,22,40,144,137,72,51,21,36
S01011610,Very good health,243,9,1,8,31,39,10,12,48,47,22,17,5,25
S01011610,Good health,196,3,1,2,19,22,7,18,50,50,18,8,10,9
S01011610,Fair health,87,0,0,0,8,5,3,4,23,23,20,14,6,1
S01011610,Bad health,50,0,0,0,2,4,2,4,15,12,10,10,0,1
S01011610,Very bad health,22,0,0,0,4,1,0,2,8,5,2,2,0,0
S01011611,All people aged 16 to 74,516,28,9,19,120,96,30,49,70,63,18,10,8,42
S01011611,Very good health,268,18,7,11,71,46,13,25,32,27,4,2,2,32
S01011611,Good health,160,6,0,6,33,31,17,15,26,16,7,5,2,9
S01011611,Fair health,52,2,2,0,10,11,0,5,10,9,4,1,3,1
S01011611,Bad health,26,1,0,1,5,6,0,4,2,5,3,2,1,0
S01011611,Very bad health,10,1,0,1,1,2,0,0,0,6,0,0,0,0
S01011612,All people aged 16 to 74,451,67,11,56,155,72,40,24,35,27,11,9,2,20
S01011612,Very good health,282,45,6,39,96,49,23,15,16,14,6,4,2,18
S01011612,Good health,133,17,4,13,48,17,12,7,17,12,3,3,0,0
S01011612,Fair health,28,4,0,4,8,4,4,1,2,1,2,2,0,2
S01011612,Bad health,6,1,1,0,1,2,1,1,0,0,0,0,0,0
S01011612,Very bad health,2,0,0,0,2,0,0,0,0,0,0,0,0,0
S01011613,All people aged 16 to 74,753,81,18,63,209,138,62,54,73,75,16,10,6,45
S01011613,Very good health,370,42,6,36,100,66,21,23,39,33,8,5,3,38
S01011613,Good health,254,26,7,19,76,45,29,26,21,23,3,1,2,5
S01011613,Fair health,89,11,3,8,24,20,7,1,8,13,3,3,0,2
S01011613,Bad health,26,2,2,0,5,2,4,4,3,5,1,0,1,0
S01011613,Very bad health,14,0,0,0,4,5,1,0,2,1,1,1,0,0
S01011614,All people aged 16 to 74,339,20,7,13,79,61,21,22,44,52,16,9,7,24
S01011614,Very good health,175,11,4,7,37,36,10,15,21,22,5,3,2,18
S01011614,Good health,100,6,2,4,28,16,10,3,11,15,6,4,2,5
S01011614,Fair health,47,2,0,2,11,7,1,1,10,9,5,2,3,1
S01011614,Bad health,14,0,0,0,3,2,0,2,2,5,0,0,0,0
S01011614,Very bad health,3,1,1,0,0,0,0,1,0,1,0,0,0,0
S01011615,All people aged 16 to 74,526,21,8,13,81,71,31,47,108,102,31,20,11,34
S01011615,Very good health,233,11,4,7,38,35,15,19,42,37,10,6,4,26
S01011615,Good health,157,9,4,5,26,22,8,13,33,32,10,3,7,4
S01011615,Fair health,80,1,0,1,10,9,5,10,19,20,3,3,0,3
S01011615,Bad health,45,0,0,0,6,4,3,2,12,10,7,7,0,1
S01011615,Very bad health,11,0,0,0,1,1,0,3,2,3,1,1,0,0
S01011616,All people aged 16 to 74,307,11,2,9,35,39,21,30,58,68,35,22,13,10
S01011616,Very good health,104,6,0,6,13,14,7,9,20,17,11,3,8,7
S01011616,Good health,112,3,1,2,21,15,8,8,22,24,10,6,4,1
S01011616,Fair health,58,1,1,0,1,6,4,9,12,17,7,6,1,1
S01011616,Bad health,25,1,0,1,0,3,1,3,3,7,6,6,0,1
S01011616,Very bad health,8,0,0,0,0,1,1,1,1,3,1,1,0,0
S01011617,All people aged 16 to 74,645,13,4,9,59,102,35,59,131,162,48,30,18,36
S01011617,Very good health,250,10,3,7,29,45,14,15,51,42,18,11,7,26
S01011617,Good health,211,2,1,1,22,31,16,21,44,49,17,10,7,9
S01011617,Fair health,118,0,0,0,7,20,4,13,22,48,3,1,2,1
S01011617,Bad health,51,1,0,1,0,4,1,7,14,15,9,7,2,0
S01011617,Very bad health,15,0,0,0,1,2,0,3,0,8,1,1,0,0
S01011618,All people aged 16 to 74,437,14,3,11,65,53,19,42,99,98,27,21,6,20
S01011618,Very good health,177,8,3,5,25,29,7,14,39,28,12,9,3,15
S01011618,Good health,162,6,0,6,28,12,7,17,39,44,4,4,0,5
S01011618,Fair health,65,0,0,0,8,9,3,6,14,17,8,6,2,0
S01011618,Bad health,20,0,0,0,1,1,2,3,4,7,2,1,1,0
S01011618,Very bad health,13,0,0,0,3,2,0,2,3,2,1,1,0,0
S01011619,All people aged 16 to 74,795,69,16,53,198,159,39,61,112,89,23,12,11,45
S01011619,Very good health,437,45,12,33,117,86,19,32,63,37,9,5,4,29
S01011619,Good health,250,21,3,18,57,55,15,22,29,35,6,2,4,10
S01011619,Fair health,66,3,1,2,20,10,1,6,11,8,4,1,3,3
S01011619,Bad health,33,0,0,0,4,6,4,1,7,8,1,1,0,2
S01011619,Very bad health,9,0,0,0,0,2,0,0,2,1,3,3,0,1
S01011620,All people aged 16 to 74,796,82,14,68,216,139,62,72,86,73,12,8,4,54
S01011620,Very good health,519,54,9,45,157,90,31,53,40,44,4,3,1,46
S01011620,Good health,210,21,4,17,47,39,25,12,34,18,6,3,3,8
S01011620,Fair health,50,7,1,6,9,8,5,3,8,9,1,1,0,0
S01011620,Bad health,16,0,0,0,3,2,1,4,4,1,1,1,0,0
S01011620,Very bad health,1,0,0,0,0,0,0,0,0,1,0,0,0,0
S01011621,All people aged 16 to 74,572,33,11,22,122,93,31,52,108,73,25,15,10,35
S01011621,Very good health,252,17,6,11,65,37,17,18,35,24,9,3,6,30
S01011621,Good health,204,13,3,10,42,42,7,21,40,28,7,4,3,4
S01011621,Fair health,78,2,2,0,7,9,5,11,25,15,3,2,1,1
S01011621,Bad health,29,1,0,1,6,2,1,2,7,5,5,5,0,0
S01011621,Very bad health,9,0,0,0,2,3,1,0,1,1,1,1,0,0
S01011622,All people aged 16 to 74,468,59,12,47,134,81,46,30,44,39,8,4,4,27
S01011622,Very good health,292,41,8,33,89,49,28,16,23,21,3,3,0,22
S01011622,Good health,128,10,1,9,37,23,14,10,16,10,4,1,3,4
S01011622,Fair health,30,6,2,4,6,7,3,2,1,4,0,0,0,1
S01011622,Bad health,15,2,1,1,2,2,1,2,2,3,1,0,1,0
S01011622,Very bad health,3,0,0,0,0,0,0,0,2,1,0,0,0,0
S01011623,All people aged 16 to 74,514,16,4,12,70,83,46,42,97,96,35,24,11,29
S01011623,Very good health,210,8,2,6,23,46,13,16,45,30,7,5,2,22
S01011623,Good health,168,7,2,5,32,27,18,19,21,29,11,6,5,4
S01011623,Fair health,85,0,0,0,8,7,11,4,18,22,12,8,4,3
S01011623,Bad health,29,0,0,0,4,3,3,2,5,8,4,4,0,0
S01011623,Very bad health,22,1,0,1,3,0,1,1,8,7,1,1,0,0
S01011624,All people aged 16 to 74,528,35,12,23,127,93,35,40,73,68,23,12,11,34
S01011624,Very good health,273,22,9,13,70,47,17,19,30,30,11,5,6,27
S01011624,Good health,161,10,3,7,41,35,14,9,21,20,5,2,3,6
S01011624,Fair health,73,3,0,3,12,9,4,8,17,14,5,4,1,1
S01011624,Bad health,16,0,0,0,4,2,0,3,4,2,1,0,1,0
S01011624,Very bad health,5,0,0,0,0,0,0,1,1,2,1,1,0,0
S01011625,All people aged 16 to 74,428,13,2,11,73,74,21,42,76,73,23,9,14,33
S01011625,Very good health,171,7,0,7,27,30,8,19,29,25,2,1,1,24
S01011625,Good health,154,6,2,4,28,30,10,12,24,27,11,5,6,6
S01011625,Fair health,64,0,0,0,10,10,1,8,10,14,9,2,7,2
S01011625,Bad health,30,0,0,0,7,2,2,3,10,5,0,0,0,1
S01011625,Very bad health,9,0,0,0,1,2,0,0,3,2,1,1,0,0
S01011626,All people aged 16 to 74,617,58,15,43,157,103,45,51,62,54,14,5,9,73
S01011626,Very good health,397,36,11,25,112,61,25,25,37,28,7,4,3,66
S01011626,Good health,173,21,4,17,38,33,15,19,19,18,5,1,4,5
S01011626,Fair health,33,1,0,1,6,5,5,5,4,4,1,0,1,2
S01011626,Bad health,12,0,0,0,1,4,0,0,2,4,1,0,1,0
S01011626,Very bad health,2,0,0,0,0,0,0,2,0,0,0,0,0,0
S01011627,All people aged 16 to 74,516,46,11,35,155,92,32,41,63,41,7,5,2,39
S01011627,Very good health,317,31,9,22,102,65,14,22,34,17,4,2,2,28
S01011627,Good health,148,13,2,11,41,22,15,13,17,17,2,2,0,8
S01011627,Fair health,38,2,0,2,10,4,2,6,7,5,1,1,0,1
S01011627,Bad health,9,0,0,0,2,0,1,0,3,2,0,0,0,1
S01011627,Very bad health,4,0,0,0,0,1,0,0,2,0,0,0,0,1
S01011628,All people aged 16 to 74,822,70,15,55,200,150,62,61,106,91,17,12,5,65
S01011628,Very good health,437,39,8,31,100,83,32,37,44,37,4,2,2,61
S01011628,Good health,248,23,5,18,66,50,16,19,38,31,2,1,1,3
S01011628,Fair health,98,5,1,4,27,11,11,4,18,17,4,2,2,1
S01011628,Bad health,30,3,1,2,5,4,3,1,6,4,4,4,0,0
S01011628,Very bad health,9,0,0,0,2,2,0,0,0,2,3,3,0,0
S01011629,All people aged 16 to 74,450,5,3,2,53,59,21,51,94,102,36,19,17,29
S01011629,Very good health,177,2,1,1,27,20,10,16,34,37,12,6,6,19
S01011629,Good health,156,2,1,1,16,27,7,17,32,34,15,6,9,6
S01011629,Fair health,72,0,0,0,7,9,3,11,21,17,3,2,1,1
S01011629,Bad health,32,1,1,0,3,3,1,5,3,11,2,1,1,3
S01011629,Very bad health,13,0,0,0,0,0,0,2,4,3,4,4,0,0
S01011630,All people aged 16 to 74,469,17,4,13,52,75,28,50,82,100,37,18,19,28
S01011630,Very good health,207,9,2,7,25,38,13,26,28,34,11,6,5,23
S01011630,Good health,138,2,1,1,14,23,11,14,33,25,12,3,9,4
S01011630,Fair health,85,5,1,4,8,11,2,4,15,28,11,6,5,1
S01011630,Bad health,30,1,0,1,4,1,2,3,6,10,3,3,0,0
S01011630,Very bad health,9,0,0,0,1,2,0,3,0,3,0,0,0,0
S01011631,All people aged 16 to 74,439,6,3,3,26,50,18,52,82,114,56,34,22,35
S01011631,Very good health,180,5,3,2,14,27,5,24,31,35,16,10,6,23
S01011631,Good health,120,1,0,1,6,14,7,15,22,30,16,8,8,9
S01011631,Fair health,83,0,0,0,5,4,3,8,21,27,12,4,8,3
S01011631,Bad health,39,0,0,0,0,5,3,3,6,17,5,5,0,0
S01011631,Very bad health,17,0,0,0,1,0,0,2,2,5,7,7,0,0
S01011632,All people aged 16 to 74,541,10,1,9,58,62,41,41,120,132,51,34,17,26
S01011632,Very good health,232,5,1,4,29,33,16,14,48,52,18,8,10,17
S01011632,Good health,180,4,0,4,23,17,6,16,44,44,18,12,6,8
S01011632,Fair health,88,1,0,1,4,7,12,8,16,26,14,13,1,0
S01011632,Bad health,26,0,0,0,1,3,3,3,8,6,1,1,0,1
S01011632,Very bad health,15,0,0,0,1,2,4,0,4,4,0,0,0,0
S01011633,All people aged 16 to 74,515,18,4,14,54,68,20,50,94,129,47,28,19,35
S01011633,Very good health,216,10,1,9,27,28,7,17,40,47,15,10,5,25
S01011633,Good health,172,6,2,4,17,24,10,17,25,46,18,11,7,9
S01011633,Fair health,81,2,1,1,7,6,2,7,23,23,10,5,5,1
S01011633,Bad health,36,0,0,0,3,7,1,7,6,9,3,1,2,0
S01011633,Very bad health,10,0,0,0,0,3,0,2,0,4,1,1,0,0
S01011634,All people aged 16 to 74,417,11,3,8,45,65,12,42,79,88,44,32,12,31
S01011634,Very good health,162,8,3,5,20,23,4,15,32,32,10,5,5,18
S01011634,Good health,132,2,0,2,17,22,5,14,23,31,10,8,2,8
S01011634,Fair health,71,0,0,0,7,12,2,7,13,13,13,10,3,4
S01011634,Bad health,40,1,0,1,1,6,1,5,8,10,7,7,0,1
S01011634,Very bad health,12,0,0,0,0,2,0,1,3,2,4,2,2,0
S01011635,All people aged 16 to 74,506,9,3,6,64,58,29,46,123,95,56,47,9,26
S01011635,Very good health,172,5,2,3,32,26,8,17,24,31,14,10,4,15
S01011635,Good health,200,4,1,3,23,22,10,17,62,32,20,17,3,10
S01011635,Fair health,80,0,0,0,4,6,7,9,18,22,13,11,2,1
S01011635,Bad health,41,0,0,0,4,3,3,3,16,7,5,5,0,0
S01011635,Very bad health,13,0,0,0,1,1,1,0,3,3,4,4,0,0
S01011636,All people aged 16 to 74,520,12,2,10,47,70,20,55,115,122,48,33,15,31
S01011636,Very good health,231,7,2,5,21,37,10,26,54,37,15,10,5,24
S01011636,Good health,154,2,0,2,17,21,7,8,33,41,21,12,9,4
S01011636,Fair health,88,2,0,2,6,9,2,16,17,28,6,5,1,2
S01011636,Bad health,36,1,0,1,3,3,1,3,10,12,2,2,0,1
S01011636,Very bad health,11,0,0,0,0,0,0,2,1,4,4,4,0,0
S01011637,All people aged 16 to 74,525,8,0,8,90,64,31,45,104,92,52,30,22,39
S01011637,Very good health,230,4,0,4,47,31,12,19,32,30,19,6,13,36
S01011637,Good health,157,3,0,3,28,22,10,10,41,24,18,12,6,1
S01011637,Fair health,85,1,0,1,8,7,9,7,15,27,9,6,3,2
S01011637,Bad health,39,0,0,0,5,4,0,4,14,9,3,3,0,0
S01011637,Very bad health,14,0,0,0,2,0,0,5,2,2,3,3,0,0
S01011638,All people aged 16 to 74,382,15,5,10,64,61,25,24,77,77,21,11,10,18
S01011638,Very good health,168,10,2,8,40,31,13,10,22,19,6,5,1,17
S01011638,Good health,109,2,1,1,16,17,5,9,21,31,8,1,7,0
S01011638,Fair health,72,3,2,1,7,8,5,0,25,18,5,3,2,1
S01011638,Bad health,25,0,0,0,1,4,2,3,6,8,1,1,0,0
S01011638,Very bad health,8,0,0,0,0,1,0,2,3,1,1,1,0,0
S01011639,All people aged 16 to 74,420,13,2,11,54,63,12,38,89,89,39,25,14,23
S01011639,Very good health,176,8,1,7,23,30,6,19,30,30,11,7,4,19
S01011639,Good health,127,4,1,3,18,23,3,10,25,24,16,8,8,4
S01011639,Fair health,68,0,0,0,9,7,1,5,22,18,6,5,1,0
S01011639,Bad health,39,0,0,0,4,2,2,3,10,15,3,2,1,0
S01011639,Very bad health,10,1,0,1,0,1,0,1,2,2,3,3,0,0
S01011640,All people aged 16 to 74,508,16,6,10,60,63,19,55,101,108,45,26,19,41
S01011640,Very good health,214,6,2,4,24,31,13,24,35,37,12,6,6,32
S01011640,Good health,153,5,2,3,21,15,2,17,37,37,13,7,6,6
S01011640,Fair health,89,1,1,0,10,9,1,7,20,24,14,8,6,3
S01011640,Bad health,46,4,1,3,5,8,3,6,8,7,5,4,1,0
S01011640,Very bad health,6,0,0,0,0,0,0,1,1,3,1,1,0,0
S01011641,All people aged 16 to 74,367,29,4,25,88,75,25,28,55,37,5,4,1,25
S01011641,Very good health,181,14,1,13,44,38,12,14,23,15,2,1,1,19
S01011641,Good health,127,11,1,10,31,28,6,10,20,15,1,1,0,5
S01011641,Fair health,40,2,0,2,9,6,6,3,6,5,2,2,0,1
S01011641,Bad health,16,2,2,0,4,3,0,1,5,1,0,0,0,0
S01011641,Very bad health,3,0,0,0,0,0,1,0,1,1,0,0,0,0
S01011642,All people aged 16 to 74,622,48,11,37,126,132,37,51,96,63,31,9,22,38
S01011642,Very good health,318,23,4,19,65,67,14,25,51,30,12,2,10,31
S01011642,Good health,207,23,6,17,46,43,17,17,22,24,10,3,7,5
S01011642,Fair health,68,2,1,1,11,17,4,8,12,7,6,1,5,1
S01011642,Bad health,23,0,0,0,3,3,2,1,11,1,2,2,0,0
S01011642,Very bad health,6,0,0,0,1,2,0,0,0,1,1,1,0,1
S01011643,All people aged 16 to 74,422,44,8,36,115,64,40,28,50,47,14,10,4,20
S01011643,Very good health,231,26,5,21,70,36,21,14,21,21,6,4,2,16
S01011643,Good health,122,13,3,10,33,19,13,5,18,17,2,0,2,2
S01011643,Fair health,47,5,0,5,9,6,4,6,6,5,4,4,0,2
S01011643,Bad health,18,0,0,0,2,3,1,3,5,3,1,1,0,0
S01011643,Very bad health,4,0,0,0,1,0,1,0,0,1,1,1,0,0
S01011644,All people aged 16 to 74,487,36,6,30,116,85,36,38,78,56,7,3,4,35
S01011644,Very good health,229,21,4,17,64,40,15,15,28,17,5,3,2,24
S01011644,Good health,165,9,2,7,34,30,15,15,35,18,1,0,1,8
S01011644,Fair health,70,5,0,5,13,13,4,5,11,15,1,0,1,3
S01011644,Bad health,18,1,0,1,2,1,1,3,4,6,0,0,0,0
S01011644,Very bad health,5,0,0,0,3,1,1,0,0,0,0,0,0,0
S01011645,All people aged 16 to 74,382,13,3,10,79,73,24,34,68,63,10,6,4,18
S01011645,Very good health,162,8,2,6,41,30,11,13,25,18,3,1,2,13
S01011645,Good health,129,2,1,1,25,25,6,9,26,27,4,2,2,5
S01011645,Fair health,64,2,0,2,9,13,4,11,10,15,0,0,0,0
S01011645,Bad health,20,1,0,1,4,4,2,0,5,3,1,1,0,0
S01011645,Very bad health,7,0,0,0,0,1,1,1,2,0,2,2,0,0
S01011646,All people aged 16 to 74,550,65,14,51,141,114,33,39,59,39,11,7,4,49
S01011646,Very good health,316,47,11,36,92,61,11,17,22,15,5,4,1,46
S01011646,Good health,153,15,3,12,40,36,14,11,19,11,4,2,2,3
S01011646,Fair health,57,3,0,3,6,11,7,9,9,12,0,0,0,0
S01011646,Bad health,20,0,0,0,3,5,1,1,8,1,1,1,0,0
S01011646,Very bad health,4,0,0,0,0,1,0,1,1,0,1,0,1,0
S01011647,All people aged 16 to 74,673,63,23,40,177,120,38,46,89,53,22,14,8,65
S01011647,Very good health,393,46,17,29,102,63,16,26,45,25,11,8,3,59
S01011647,Good health,206,11,3,8,61,45,18,14,33,13,5,3,2,6
S01011647,Fair health,52,5,3,2,12,10,2,4,8,7,4,1,3,0
S01011647,Bad health,17,0,0,0,1,2,2,2,3,5,2,2,0,0
S01011647,Very bad health,5,1,0,1,1,0,0,0,0,3,0,0,0,0
S01011648,All people aged 16 to 74,502,53,11,42,126,68,32,36,73,57,30,17,13,27
S01011648,Very good health,255,41,10,31,80,36,13,14,25,17,8,3,5,21
S01011648,Good health,157,9,1,8,33,23,15,12,28,28,5,3,2,4
S01011648,Fair health,56,2,0,2,8,6,1,6,11,8,12,6,6,2
S01011648,Bad health,28,1,0,1,5,3,3,2,6,3,5,5,0,0
S01011648,Very bad health,6,0,0,0,0,0,0,2,3,1,0,0,0,0
S01011649,All people aged 16 to 74,360,13,7,6,65,62,20,40,59,65,14,7,7,22
S01011649,Very good health,158,9,4,5,44,25,6,18,21,15,6,4,2,14
S01011649,Good health,122,2,1,1,16,23,10,11,16,32,6,3,3,6
S01011649,Fair health,54,1,1,0,3,9,4,8,16,11,2,0,2,0
S01011649,Bad health,20,1,1,0,1,4,0,2,4,6,0,0,0,2
S01011649,Very bad health,6,0,0,0,1,1,0,1,2,1,0,0,0,0
S01011650,All people aged 16 to 74,528,53,12,41,137,88,40,31,68,59,27,19,8,25
S01011650,Very good health,259,31,6,25,78,35,20,16,32,19,10,7,3,18
S01011650,Good health,165,19,5,14,41,32,11,8,24,18,6,4,2,6
S01011650,Fair health,72,3,1,2,13,15,7,6,4,15,8,5,3,1
S01011650,Bad health,20,0,0,0,2,5,0,0,6,5,2,2,0,0
S01011650,Very bad health,12,0,0,0,3,1,2,1,2,2,1,1,0,0
S01011651,All people aged 16 to 74,693,46,8,38,146,115,34,58,104,108,32,15,17,50
S01011651,Very good health,325,23,2,21,81,52,17,22,41,43,12,5,7,34
S01011651,Good health,227,19,4,15,40,41,9,24,40,29,12,5,7,13
S01011651,Fair health,92,3,1,2,14,14,5,8,16,24,5,2,3,3
S01011651,Bad health,37,1,1,0,9,4,2,3,6,10,2,2,0,0
S01011651,Very bad health,12,0,0,0,2,4,1,1,1,2,1,1,0,0
S01011652,All people aged 16 to 74,612,52,12,40,136,107,33,48,88,69,26,19,7,53
S01011652,Very good health,335,32,6,26,76,61,17,23,51,29,10,7,3,36
S01011652,Good health,177,13,5,8,45,31,7,20,21,21,7,4,3,12
S01011652,Fair health,68,5,1,4,12,10,7,2,9,13,5,4,1,5
S01011652,Bad health,27,2,0,2,1,5,1,3,7,5,3,3,0,0
S01011652,Very bad health,5,0,0,0,2,0,1,0,0,1,1,1,0,0
S01011653,All people aged 16 to 74,661,15,3,12,86,89,35,66,119,132,71,41,30,48
S01011653,Very good health,282,5,1,4,39,45,16,28,52,43,20,14,6,34
S01011653,Good health,212,8,2,6,33,28,16,21,36,40,19,5,14,11
S01011653,Fair health,113,1,0,1,11,11,1,11,21,31,23,14,9,3
S01011653,Bad health,40,1,0,1,3,3,1,5,9,13,5,4,1,0
S01011653,Very bad health,14,0,0,0,0,2,1,1,1,5,4,4,0,0
S01011654,All people aged 16 to 74,723,46,8,38,128,86,52,49,125,107,87,51,36,43
S01011654,Very good health,318,31,6,25,70,40,21,24,53,28,20,11,9,31
S01011654,Good health,230,12,0,12,36,29,19,18,41,38,29,17,12,8
S01011654,Fair health,109,2,1,1,18,10,6,1,18,22,28,13,15,4
S01011654,Bad health,52,0,0,0,4,5,6,4,10,15,8,8,0,0
S01011654,Very bad health,14,1,1,0,0,2,0,2,3,4,2,2,0,0
S01011655,All people aged 16 to 74,646,15,2,13,79,79,40,68,119,148,80,35,45,18
S01011655,Very good health,267,12,2,10,42,40,7,34,44,56,23,8,15,9
S01011655,Good health,193,2,0,2,22,26,20,17,33,35,31,11,20,7
S01011655,Fair health,123,1,0,1,10,10,7,9,28,39,17,8,9,2
S01011655,Bad health,52,0,0,0,3,2,5,6,11,17,8,7,1,0
S01011655,Very bad health,11,0,0,0,2,1,1,2,3,1,1,1,0,0
S01011656,All people aged 16 to 74,464,8,2,6,48,51,21,44,79,113,64,34,30,36
S01011656,Very good health,164,3,1,2,19,21,8,21,24,36,13,6,7,19
S01011656,Good health,154,2,0,2,16,12,4,12,37,32,25,12,13,14
S01011656,Fair health,92,2,0,2,11,11,4,6,10,28,17,7,10,3
S01011656,Bad health,39,0,0,0,1,7,3,3,7,10,8,8,0,0
S01011656,Very bad health,15,1,1,0,1,0,2,2,1,7,1,1,0,0
S01011657,All people aged 16 to 74,405,14,4,10,54,36,19,31,82,88,54,31,23,27
S01011657,Very good health,158,6,1,5,24,18,6,10,33,25,12,4,8,24
S01011657,Good health,125,4,1,3,23,11,7,9,26,27,17,7,10,1
S01011657,Fair health,71,2,1,1,3,5,2,6,15,19,17,12,5,2
S01011657,Bad health,33,1,1,0,2,1,3,5,7,9,5,5,0,0
S01011657,Very bad health,18,1,0,1,2,1,1,1,1,8,3,3,0,0
S01011658,All people aged 16 to 74,498,15,3,12,48,47,40,49,113,103,49,27,22,34
S01011658,Very good health,225,8,1,7,26,30,19,21,47,32,18,9,9,24
S01011658,Good health,152,4,2,2,13,10,15,17,36,34,15,7,8,8
S01011658,Fair health,80,3,0,3,5,7,4,6,19,22,12,7,5,2
S01011658,Bad health,31,0,0,0,3,0,2,3,9,11,3,3,0,0
S01011658,Very bad health,10,0,0,0,1,0,0,2,2,4,1,1,0,0
S01011659,All people aged 16 to 74,584,17,5,12,71,78,32,61,110,144,37,20,17,34
S01011659,Very good health,251,13,4,9,36,39,10,19,49,49,10,3,7,26
S01011659,Good health,182,2,0,2,23,20,11,21,32,48,18,10,8,7
S01011659,Fair health,103,2,1,1,8,11,8,16,23,27,7,5,2,1
S01011659,Bad health,35,0,0,0,3,5,3,4,4,16,0,0,0,0
S01011659,Very bad health,13,0,0,0,1,3,0,1,2,4,2,2,0,0
S01011660,All people aged 16 to 74,733,45,13,32,148,108,51,62,113,106,31,15,16,69
S01011660,Very good health,352,26,10,16,78,45,22,26,54,34,8,3,5,59
S01011660,Good health,249,16,2,14,47,37,18,24,41,43,15,7,8,8
S01011660,Fair health,92,2,1,1,17,21,7,9,10,19,5,2,3,2
S01011660,Bad health,35,1,0,1,5,4,3,3,8,8,3,3,0,0
S01011660,Very bad health,5,0,0,0,1,1,1,0,0,2,0,0,0,0
S01011661,All people aged 16 to 74,406,13,3,10,51,68,34,40,71,89,21,13,8,19
S01011661,Very good health,171,8,2,6,25,31,14,15,24,29,11,6,5,14
S01011661,Good health,136,2,1,1,17,26,11,13,24,32,6,4,2,5
S01011661,Fair health,72,2,0,2,7,6,6,10,18,20,3,2,1,0
S01011661,Bad health,23,0,0,0,1,5,3,2,5,6,1,1,0,0
S01011661,Very bad health,4,1,0,1,1,0,0,0,0,2,0,0,0,0
S01011662,All people aged 16 to 74,473,41,6,35,126,86,40,31,67,45,9,7,2,28
S01011662,Very good health,264,29,5,24,75,40,18,18,35,18,5,4,1,26
S01011662,Good health,143,10,0,10,38,33,16,11,17,16,1,1,0,1
S01011662,Fair health,47,2,1,1,10,7,4,1,11,9,2,1,1,1
S01011662,Bad health,10,0,0,0,2,4,0,0,2,2,0,0,0,0
S01011662,Very bad health,9,0,0,0,1,2,2,1,2,0,1,1,0,0
S01011663,All people aged 16 to 74,735,14,0,14,79,87,35,85,125,169,93,52,41,48
S01011663,Very good health,311,7,0,7,43,41,10,34,55,57,29,13,16,35
S01011663,Good health,256,4,0,4,22,31,18,32,46,60,33,17,16,10
S01011663,Fair health,102,2,0,2,10,9,4,11,13,30,20,13,7,3
S01011663,Bad health,49,0,0,0,2,2,2,7,10,18,8,6,2,0
S01011663,Very bad health,17,1,0,1,2,4,1,1,1,4,3,3,0,0
S01011664,All people aged 16 to 74,789,11,3,8,75,85,35,73,168,210,85,67,18,47
S01011664,Very good health,295,6,3,3,30,42,19,24,52,58,30,24,6,34
S01011664,Good health,236,2,0,2,19,26,8,23,56,66,25,16,9,11
S01011664,Fair health,145,3,0,3,14,12,7,16,35,39,18,15,3,1
S01011664,Bad health,83,0,0,0,9,3,1,7,17,35,11,11,0,0
S01011664,Very bad health,30,0,0,0,3,2,0,3,8,12,1,1,0,1
S01011665,All people aged 16 to 74,657,22,2,20,116,87,26,41,126,130,57,32,25,52
S01011665,Very good health,280,8,1,7,72,40,11,12,45,40,18,6,12,34
S01011665,Good health,198,9,0,9,28,27,11,13,41,39,13,6,7,17
S01011665,Fair health,105,3,1,2,7,14,1,9,23,30,17,14,3,1
S01011665,Bad health,55,0,0,0,6,4,1,6,13,18,7,4,3,0
S01011665,Very bad health,19,2,0,2,3,2,2,1,4,3,2,2,0,0
S01011666,All people aged 16 to 74,655,17,3,14,85,92,31,57,122,131,76,37,39,44
S01011666,Very good health,241,10,1,9,40,40,8,16,49,34,18,9,9,26
S01011666,Good health,226,5,2,3,28,30,8,24,37,50,30,12,18,14
S01011666,Fair health,112,0,0,0,13,10,10,6,21,30,19,7,12,3
S01011666,Bad health,61,2,0,2,3,11,3,9,12,15,5,5,0,1
S01011666,Very bad health,15,0,0,0,1,1,2,2,3,2,4,4,0,0
S01011667,All people aged 16 to 74,580,38,6,32,73,85,39,53,95,120,47,37,10,30
S01011667,Very good health,213,26,4,22,34,37,14,10,30,33,9,7,2,20
S01011667,Good health,181,5,0,5,23,30,13,23,31,38,12,6,6,6
S01011667,Fair health,104,4,1,3,10,11,7,13,14,30,13,11,2,2
S01011667,Bad health,59,2,0,2,5,4,5,5,16,9,11,11,0,2
S01011667,Very bad health,23,1,1,0,1,3,0,2,4,10,2,2,0,0
S01011668,All people aged 16 to 74,756,13,2,11,74,80,20,77,170,191,77,49,28,54
S01011668,Very good health,303,7,2,5,36,40,7,34,59,63,22,15,7,35
S01011668,Good health,257,5,0,5,27,23,7,30,62,63,27,17,10,13
S01011668,Fair health,116,1,0,1,8,11,2,7,31,34,18,10,8,4
S01011668,Bad health,62,0,0,0,1,4,2,6,12,27,9,6,3,1
S01011668,Very bad health,18,0,0,0,2,2,2,0,6,4,1,1,0,1
S01011669,All people aged 16 to 74,496,48,10,38,112,79,45,34,68,58,21,12,9,31
S01011669,Very good health,234,23,4,19,54,41,21,16,28,19,6,2,4,26
S01011669,Good health,160,20,5,15,36,29,13,10,25,17,5,3,2,5
S01011669,Fair health,76,4,1,3,18,8,9,7,12,12,6,4,2,0
S01011669,Bad health,19,1,0,1,3,1,2,1,2,7,2,1,1,0
S01011669,Very bad health,7,0,0,0,1,0,0,0,1,3,2,2,0,0
S01011670,All people aged 16 to 74,379,7,0,7,50,57,20,30,82,80,30,16,14,23
S01011670,Very good health,170,4,0,4,23,29,10,11,31,33,11,6,5,18
S01011670,Good health,127,3,0,3,19,17,7,12,32,22,11,5,6,4
S01011670,Fair health,49,0,0,0,4,5,1,3,16,15,5,2,3,0
S01011670,Bad health,26,0,0,0,2,5,1,3,3,8,3,3,0,1
S01011670,Very bad health,7,0,0,0,2,1,1,1,0,2,0,0,0,0
S01011671,All people aged 16 to 74,493,40,7,33,107,88,41,30,80,68,13,5,8,26
S01011671,Very good health,216,22,3,19,62,32,13,11,30,21,3,1,2,22
S01011671,Good health,165,15,3,12,31,33,15,10,25,26,6,2,4,4
S01011671,Fair health,72,1,0,1,10,13,8,5,16,16,3,1,2,0
S01011671,Bad health,35,1,0,1,3,10,4,3,8,5,1,1,0,0
S01011671,Very bad health,5,1,1,0,1,0,1,1,1,0,0,0,0,0
S01011672,All people aged 16 to 74,429,29,6,23,75,47,27,32,80,69,34,22,12,36
S01011672,Very good health,205,17,4,13,41,25,15,10,37,20,11,7,4,29
S01011672,Good health,137,8,2,6,24,13,6,12,29,25,14,9,5,6
S01011672,Fair health,57,2,0,2,6,8,5,5,7,16,7,4,3,1
S01011672,Bad health,23,1,0,1,4,1,0,4,5,7,1,1,0,0
S01011672,Very bad health,7,1,0,1,0,0,1,1,2,1,1,1,0,0
S01011673,All people aged 16 to 74,502,19,3,16,53,71,25,53,81,114,48,30,18,38
S01011673,Very good health,188,11,1,10,20,34,9,22,30,30,11,4,7,21
S01011673,Good health,191,5,0,5,17,25,15,20,24,50,21,12,9,14
S01011673,Fair health,75,2,1,1,8,8,1,6,19,19,10,9,1,2
S01011673,Bad health,37,1,1,0,8,4,0,4,5,10,4,3,1,1
S01011673,Very bad health,11,0,0,0,0,0,0,1,3,5,2,2,0,0
S01011674,All people aged 16 to 74,761,44,7,37,155,129,28,59,137,124,42,25,17,43
S01011674,Very good health,361,25,3,22,93,69,16,26,54,43,10,5,5,25
S01011674,Good health,249,15,2,13,41,43,9,15,46,41,23,11,12,16
S01011674,Fair health,96,4,2,2,14,10,2,12,22,27,3,3,0,2
S01011674,Bad health,44,0,0,0,6,7,1,4,14,8,4,4,0,0
S01011674,Very bad health,11,0,0,0,1,0,0,2,1,5,2,2,0,0
S01011675,All people aged 16 to 74,685,31,9,22,98,79,37,60,139,146,60,42,18,35
S01011675,Very good health,271,15,6,9,53,39,15,19,48,39,14,8,6,29
S01011675,Good health,225,15,3,12,20,29,18,15,46,57,20,13,7,5
S01011675,Fair health,118,1,0,1,17,7,3,18,28,30,14,9,5,0
S01011675,Bad health,52,0,0,0,6,3,1,8,13,15,6,6,0,0
S01011675,Very bad health,19,0,0,0,2,1,0,0,4,5,6,6,0,1
S01011676,All people aged 16 to 74,516,10,0,10,44,55,19,61,100,142,54,32,22,31
S01011676,Very good health,232,7,0,7,22,33,8,29,39,51,17,10,7,26
S01011676,Good health,147,1,0,1,13,16,5,15,32,44,16,6,10,5
S01011676,Fair health,81,2,0,2,9,3,5,8,20,21,13,8,5,0
S01011676,Bad health,49,0,0,0,0,2,1,9,8,23,6,6,0,0
S01011676,Very bad health,7,0,0,0,0,1,0,0,1,3,2,2,0,0
S01011677,All people aged 16 to 74,449,29,8,21,108,70,29,33,51,59,39,23,16,31
S01011677,Very good health,246,17,4,13,71,44,15,19,24,21,8,3,5,27
S01011677,Good health,133,10,2,8,31,19,10,6,16,24,14,9,5,3
S01011677,Fair health,36,2,2,0,1,5,4,1,4,6,12,7,5,1
S01011677,Bad health,25,0,0,0,3,1,0,6,7,4,4,3,1,0
S01011677,Very bad health,9,0,0,0,2,1,0,1,0,4,1,1,0,0
S01011678,All people aged 16 to 74,352,11,2,9,34,39,26,41,61,78,43,33,10,19
S01011678,Very good health,132,7,1,6,19,13,11,10,19,25,16,13,3,12
S01011678,Good health,109,2,1,1,10,13,10,12,20,25,14,8,6,3
S01011678,Fair health,59,1,0,1,0,8,2,5,14,17,8,7,1,4
S01011678,Bad health,37,1,0,1,1,1,3,11,6,9,5,5,0,0
S01011678,Very bad health,15,0,0,0,4,4,0,3,2,2,0,0,0,0
S01011679,All people aged 16 to 74,407,22,7,15,110,74,23,50,50,41,12,8,4,25
S01011679,Very good health,246,14,6,8,76,40,13,26,22,27,5,3,2,23
S01011679,Good health,118,3,0,3,30,26,8,19,20,8,2,2,0,2
S01011679,Fair health,33,4,1,3,4,7,0,4,4,6,4,2,2,0
S01011679,Bad health,9,1,0,1,0,0,2,1,4,0,1,1,0,0
S01011679,Very bad health,1,0,0,0,0,1,0,0,0,0,0,0,0,0
S01011680,All people aged 16 to 74,771,27,10,17,89,93,43,61,145,187,79,50,29,47
S01011680,Very good health,328,15,6,9,43,46,17,22,62,56,28,16,12,39
S01011680,Good health,239,11,4,7,26,28,22,24,36,69,17,8,9,6
S01011680,Fair health,117,0,0,0,14,11,2,8,28,31,21,17,4,2
S01011680,Bad health,59,0,0,0,3,7,1,4,15,23,6,2,4,0
S01011680,Very bad health,28,1,0,1,3,1,1,3,4,8,7,7,0,0
S01011681,All people aged 16 to 74,615,29,5,24,93,82,33,58,123,123,35,19,16,39
S01011681,Very good health,280,18,3,15,59,44,12,26,48,37,14,7,7,22
S01011681,Good health,175,6,0,6,22,24,14,19,40,34,5,1,4,11
S01011681,Fair health,94,4,2,2,7,10,2,7,25,27,6,2,4,6
S01011681,Bad health,52,1,0,1,3,3,5,5,8,20,7,6,1,0
S01011681,Very bad health,14,0,0,0,2,1,0,1,2,5,3,3,0,0
S01011682,All people aged 16 to 74,404,29,8,21,76,41,65,36,42,57,40,31,9,18
S01011682,Very good health,145,14,5,9,34,15,23,11,14,15,7,2,5,12
S01011682,Good health,142,11,3,8,28,16,24,12,12,18,16,14,2,5
S01011682,Fair health,77,1,0,1,8,7,14,11,10,15,10,9,1,1
S01011682,Bad health,28,2,0,2,4,2,4,2,4,7,3,3,0,0
S01011682,Very bad health,12,1,0,1,2,1,0,0,2,2,4,3,1,0
S01011683,All people aged 16 to 74,577,12,2,10,66,73,52,71,100,127,37,25,12,39
S01011683,Very good health,253,9,2,7,39,30,32,25,42,42,12,7,5,22
S01011683,Good health,193,2,0,2,16,22,13,31,42,44,9,4,5,14
S01011683,Fair health,88,1,0,1,10,17,6,7,8,25,12,10,2,2
S01011683,Bad health,34,0,0,0,0,2,1,6,6,15,3,3,0,1
S01011683,Very bad health,9,0,0,0,1,2,0,2,2,1,1,1,0,0
S01011684,All people aged 16 to 74,400,18,5,13,76,58,31,37,65,73,13,7,6,29
S01011684,Very good health,188,11,3,8,38,22,19,14,25,33,3,2,1,23
S01011684,Good health,136,5,0,5,27,22,8,13,31,21,5,2,3,4
S01011684,Fair health,52,2,2,0,8,12,3,7,7,8,4,2,2,1
S01011684,Bad health,18,0,0,0,3,2,1,2,1,7,1,1,0,1
S01011684,Very bad health,6,0,0,0,0,0,0,1,1,4,0,0,0,0
S01011685,All people aged 16 to 74,585,54,16,38,150,90,58,38,71,70,9,6,3,45
S01011685,Very good health,356,40,14,26,99,54,31,18,37,30,3,3,0,44
S01011685,Good health,152,10,1,9,41,25,15,14,22,21,3,0,3,1
S01011685,Fair health,60,4,1,3,10,10,10,4,8,12,2,2,0,0
S01011685,Bad health,14,0,0,0,0,1,1,2,4,6,0,0,0,0
S01011685,Very bad health,3,0,0,0,0,0,1,0,0,1,1,1,0,0
S01011686,All people aged 16 to 74,657,55,15,40,162,113,66,54,67,74,9,5,4,57
S01011686,Very good health,362,32,9,23,94,61,29,25,40,34,3,0,3,44
S01011686,Good health,205,15,5,10,49,39,23,19,18,29,3,3,0,10
S01011686,Fair health,63,5,1,4,14,8,10,7,8,9,1,0,1,1
S01011686,Bad health,23,2,0,2,5,4,4,2,1,2,2,2,0,1
S01011686,Very bad health,4,1,0,1,0,1,0,1,0,0,0,0,0,1
S01011687,All people aged 16 to 74,649,28,4,24,94,95,30,56,137,117,55,35,20,37
S01011687,Very good health,282,11,2,9,49,48,12,25,45,44,18,9,9,30
S01011687,Good health,204,13,0,13,29,24,12,19,49,34,21,15,6,3
S01011687,Fair health,111,1,0,1,12,17,4,6,29,25,13,9,4,4
S01011687,Bad health,38,2,2,0,3,3,1,5,9,12,3,2,1,0
S01011687,Very bad health,14,1,0,1,1,3,1,1,5,2,0,0,0,0
S01011688,All people aged 16 to 74,602,58,16,42,132,83,69,39,71,74,26,17,9,50
S01011688,Very good health,331,39,11,28,80,39,37,20,40,29,11,7,4,36
S01011688,Good health,177,16,4,12,40,32,24,13,19,19,4,2,2,10
S01011688,Fair health,63,3,1,2,7,7,6,5,6,15,11,8,3,3
S01011688,Bad health,26,0,0,0,5,3,2,1,4,10,0,0,0,1
S01011688,Very bad health,5,0,0,0,0,2,0,0,2,1,0,0,0,0
S01011689,All people aged 16 to 74,509,62,17,45,120,81,62,38,40,48,14,8,6,44
S01011689,Very good health,284,36,9,27,71,40,32,19,18,26,7,5,2,35
S01011689,Good health,160,23,8,15,34,31,24,13,13,13,3,0,3,6
S01011689,Fair health,47,3,0,3,13,8,4,3,6,5,2,1,1,3
S01011689,Bad health,14,0,0,0,0,2,2,3,3,4,0,0,0,0
S01011689,Very bad health,4,0,0,0,2,0,0,0,0,0,2,2,0,0
S01011690,All people aged 16 to 74,715,72,16,56,151,105,72,58,103,72,44,29,15,38
S01011690,Very good health,375,44,11,33,93,51,42,33,47,23,13,8,5,29
S01011690,Good health,217,22,4,18,43,37,24,14,26,29,17,10,7,5
S01011690,Fair health,91,5,1,4,10,15,4,7,26,11,10,7,3,3
S01011690,Bad health,22,1,0,1,4,1,1,2,2,8,3,3,0,0
S01011690,Very bad health,10,0,0,0,1,1,1,2,2,1,1,1,0,1
S01011691,All people aged 16 to 74,444,44,12,32,103,72,30,29,67,63,10,8,2,26
S01011691,Very good health,224,23,6,17,65,40,9,12,26,24,5,4,1,20
S01011691,Good health,145,17,5,12,23,26,17,15,23,19,1,0,1,4
S01011691,Fair health,51,3,1,2,11,4,4,1,13,13,0,0,0,2
S01011691,Bad health,13,0,0,0,3,1,0,0,4,3,2,2,0,0
S01011691,Very bad health,11,1,0,1,1,1,0,1,1,4,2,2,0,0
S01011692,All people aged 16 to 74,813,19,4,15,95,118,39,77,173,183,60,38,22,49
S01011692,Very good health,305,9,1,8,44,48,17,24,67,46,16,6,10,34
S01011692,Good health,266,8,2,6,32,41,12,29,51,63,17,10,7,13
S01011692,Fair health,154,2,1,1,9,21,6,14,39,41,20,15,5,2
S01011692,Bad health,70,0,0,0,9,5,3,8,13,27,5,5,0,0
S01011692,Very bad health,18,0,0,0,1,3,1,2,3,6,2,2,0,0
S01011693,All people aged 16 to 74,624,61,8,53,162,108,40,48,76,67,22,14,8,40
S01011693,Very good health,309,37,4,33,90,51,21,25,31,28,7,2,5,19
S01011693,Good health,204,17,4,13,51,41,11,11,21,22,11,9,2,19
S01011693,Fair health,75,5,0,5,16,14,6,6,16,8,2,1,1,2
S01011693,Bad health,24,1,0,1,2,1,2,5,4,7,2,2,0,0
S01011693,Very bad health,12,1,0,1,3,1,0,1,4,2,0,0,0,0
S01011694,All people aged 16 to 74,376,49,15,34,110,47,24,25,45,42,14,9,5,20
S01011694,Very good health,209,25,10,15,66,26,16,7,25,20,7,4,3,17
S01011694,Good health,120,20,4,16,33,18,6,11,14,9,6,4,2,3
S01011694,Fair health,32,3,1,2,9,3,1,4,4,7,1,1,0,0
S01011694,Bad health,11,1,0,1,2,0,1,2,1,4,0,0,0,0
S01011694,Very bad health,4,0,0,0,0,0,0,1,1,2,0,0,0,0
S01011695,All people aged 16 to 74,662,80,24,56,192,110,55,49,72,61,12,10,2,31
S01011695,Very good health,381,57,17,40,110,59,31,33,37,28,3,3,0,23
S01011695,Good health,184,19,5,14,55,37,19,13,17,16,3,2,1,5
S01011695,Fair health,70,3,2,1,22,9,4,2,14,12,3,2,1,1
S01011695,Bad health,18,1,0,1,5,3,0,0,2,4,1,1,0,2
S01011695,Very bad health,9,0,0,0,0,2,1,1,2,1,2,2,0,0
S01011696,All people aged 16 to 74,722,151,24,127,238,90,73,34,54,30,13,8,5,39
S01011696,Very good health,462,108,19,89,156,60,32,25,29,16,3,2,1,33
S01011696,Good health,211,40,5,35,76,23,27,7,20,9,5,3,2,4
S01011696,Fair health,43,3,0,3,5,6,14,2,4,3,4,2,2,2
S01011696,Bad health,6,0,0,0,1,1,0,0,1,2,1,1,0,0
S01011696,Very bad health,0,0,0,0,0,0,0,0,0,0,0,0,0,0
S01011697,All people aged 16 to 74,723,87,17,70,200,120,51,46,87,60,30,18,12,42
S01011697,Very good health,399,60,14,46,122,63,26,23,41,18,14,7,7,32
S01011697,Good health,222,27,3,24,61,43,20,14,24,17,7,4,3,9
S01011697,Fair health,65,0,0,0,13,8,3,3,15,14,8,6,2,1
S01011697,Bad health,27,0,0,0,4,5,0,4,5,8,1,1,0,0
S01011697,Very bad health,10,0,0,0,0,1,2,2,2,3,0,0,0,0
S01011698,All people aged 16 to 74,505,9,1,8,95,65,40,61,92,82,24,8,16,37
S01011698,Very good health,187,4,1,3,48,24,13,27,18,21,9,2,7,23
S01011698,Good health,188,4,0,4,33,27,19,19,37,29,10,3,7,10
S01011698,Fair health,91,1,0,1,9,8,7,13,23,24,4,2,2,2
S01011698,Bad health,31,0,0,0,3,5,1,2,11,7,1,1,0,1
S01011698,Very bad health,8,0,0,0,2,1,0,0,3,1,0,0,0,1
S01011699,All people aged 16 to 74,707,72,18,54,154,139,52,66,82,64,16,11,5,62
S01011699,Very good health,375,44,11,33,87,71,24,26,47,24,7,5,2,45
S01011699,Good health,230,24,5,19,55,42,24,25,20,19,7,4,3,14
S01011699,Fair health,74,3,2,1,10,23,4,10,13,8,0,0,0,3
S01011699,Bad health,25,0,0,0,2,2,0,5,1,13,2,2,0,0
S01011699,Very bad health,3,1,0,1,0,1,0,0,1,0,0,0,0,0
S01011700,All people aged 16 to 74,578,47,12,35,112,108,44,52,81,67,13,7,6,54
S01011700,Very good health,273,29,7,22,58,41,22,19,28,22,4,2,2,50
S01011700,Good health,192,13,4,9,40,41,14,17,36,23,7,3,4,1
S01011700,Fair health,68,4,1,3,9,18,7,8,7,15,0,0,0,0
S01011700,Bad health,36,1,0,1,4,6,1,5,7,7,2,2,0,3
S01011700,Very bad health,9,0,0,0,1,2,0,3,3,0,0,0,0,0
S01011701,All people aged 16 to 74,757,111,21,90,209,121,69,53,70,57,18,11,7,49
S01011701,Very good health,415,70,11,59,114,67,33,29,33,21,9,3,6,39
S01011701,Good health,243,32,9,23,75,41,25,16,22,21,4,3,1,7
S01011701,Fair health,75,8,1,7,18,9,9,8,12,9,1,1,0,1
S01011701,Bad health,14,1,0,1,0,2,1,0,2,3,4,4,0,1
S01011701,Very bad health,10,0,0,0,2,2,1,0,1,3,0,0,0,1
S01011702,All people aged 16 to 74,548,70,19,51,123,80,45,38,77,57,21,12,9,37
S01011702,Very good health,270,43,10,33,71,34,19,11,36,20,9,5,4,27
S01011702,Good health,171,19,6,13,38,25,14,19,22,17,7,3,4,10
S01011702,Fair health,61,6,3,3,5,13,8,4,12,11,2,1,1,0
S01011702,Bad health,36,2,0,2,7,5,3,4,7,6,2,2,0,0
S01011702,Very bad health,10,0,0,0,2,3,1,0,0,3,1,1,0,0
S01011703,All people aged 16 to 74,453,64,10,54,133,55,65,31,32,27,12,7,5,34
S01011703,Very good health,243,38,6,32,71,26,32,15,14,13,6,3,3,28
S01011703,Good health,166,20,2,18,50,23,27,10,13,11,6,4,2,6
S01011703,Fair health,40,6,2,4,11,5,5,6,5,2,0,0,0,0
S01011703,Bad health,4,0,0,0,1,1,1,0,0,1,0,0,0,0
S01011703,Very bad health,0,0,0,0,0,0,0,0,0,0,0,0,0,0
S01011704,All people aged 16 to 74,515,68,9,59,133,86,35,37,63,32,10,6,4,51
S01011704,Very good health,303,47,4,43,81,48,20,22,31,11,2,0,2,41
S01011704,Good health,165,15,4,11,43,34,12,11,26,11,5,4,1,8
S01011704,Fair health,30,4,0,4,8,3,1,2,4,6,1,0,1,1
S01011704,Bad health,14,2,1,1,1,1,2,1,2,3,1,1,0,1
S01011704,Very bad health,3,0,0,0,0,0,0,1,0,1,1,1,0,0
S01011705,All people aged 16 to 74,558,32,6,26,82,78,46,46,92,88,38,20,18,56
S01011705,Very good health,246,20,4,16,31,40,18,19,36,28,17,7,10,37
S01011705,Good health,191,7,2,5,41,24,19,10,32,30,11,5,6,17
S01011705,Fair health,82,4,0,4,7,12,4,10,16,21,7,6,1,1
S01011705,Bad health,27,1,0,1,3,2,2,6,5,6,2,1,1,0
S01011705,Very bad health,12,0,0,0,0,0,3,1,3,3,1,1,0,1
S01011706,All people aged 16 to 74,752,46,9,37,148,114,51,73,129,102,35,22,13,54
S01011706,Very good health,349,28,6,22,75,53,21,31,53,32,11,8,3,45
S01011706,Good health,249,16,3,13,47,37,22,27,46,35,11,4,7,8
S01011706,Fair health,102,2,0,2,17,17,5,12,20,22,7,4,3,0
S01011706,Bad health,44,0,0,0,7,6,3,3,10,11,3,3,0,1
S01011706,Very bad health,8,0,0,0,2,1,0,0,0,2,3,3,0,0
S01011707,All people aged 16 to 74,548,46,10,36,158,110,37,44,69,44,12,5,7,28
S01011707,Very good health,270,25,6,19,90,50,12,21,24,22,6,1,5,20
S01011707,Good health,176,17,3,14,43,41,13,13,28,11,4,2,2,6
S01011707,Fair health,72,4,1,3,20,11,9,6,12,8,1,1,0,1
S01011707,Bad health,22,0,0,0,5,5,2,3,4,1,1,1,0,1
S01011707,Very bad health,8,0,0,0,0,3,1,1,1,2,0,0,0,0
S01011708,All people aged 16 to 74,726,33,6,27,137,119,42,56,139,113,38,25,13,49
S01011708,Very good health,321,24,5,19,63,56,15,18,48,41,15,10,5,41
S01011708,Good health,221,6,1,5,49,41,16,19,44,31,8,4,4,7
S01011708,Fair health,105,0,0,0,14,17,7,7,27,25,7,5,2,1
S01011708,Bad health,57,1,0,1,6,5,4,8,13,13,7,5,2,0
S01011708,Very bad health,22,2,0,2,5,0,0,4,7,3,1,1,0,0
S01011709,All people aged 16 to 74,729,54,13,41,144,94,54,66,110,107,32,18,14,68
S01011709,Very good health,354,32,6,26,74,46,21,29,51,39,8,5,3,54
S01011709,Good health,220,15,5,10,50,25,25,20,34,31,11,2,9,9
S01011709,Fair health,99,5,1,4,13,16,2,13,16,23,7,5,2,4
S01011709,Bad health,47,2,1,1,7,5,4,4,7,12,5,5,0,1
S01011709,Very bad health,9,0,0,0,0,2,2,0,2,2,1,1,0,0
S01011710,All people aged 16 to 74,459,5,1,4,53,60,22,38,111,98,42,17,25,30
S01011710,Very good health,185,5,1,4,20,24,10,16,40,33,14,6,8,23
S01011710,Good health,161,0,0,0,23,23,7,12,46,31,13,6,7,6
S01011710,Fair health,81,0,0,0,9,8,4,4,19,22,14,4,10,1
S01011710,Bad health,25,0,0,0,1,3,0,6,4,10,1,1,0,0
S01011710,Very bad health,7,0,0,0,0,2,1,0,2,2,0,0,0,0
S01011711,All people aged 16 to 74,497,13,1,12,54,70,27,42,93,125,45,23,22,28
S01011711,Very good health,181,8,1,7,18,30,13,17,27,31,17,7,10,20
S01011711,Good health,166,1,0,1,17,20,7,18,39,42,16,5,11,6
S01011711,Fair health,98,2,0,2,15,14,4,2,18,35,6,5,1,2
S01011711,Bad health,40,1,0,1,2,5,3,2,7,15,5,5,0,0
S01011711,Very bad health,12,1,0,1,2,1,0,3,2,2,1,1,0,0
S01011712,All people aged 16 to 74,422,25,5,20,68,69,25,48,84,59,21,8,13,23
S01011712,Very good health,179,14,1,13,44,29,7,20,27,15,6,4,2,17
S01011712,Good health,141,7,2,5,15,24,13,15,32,20,9,2,7,6
S01011712,Fair health,71,3,2,1,7,12,4,9,14,16,6,2,4,0
S01011712,Bad health,22,1,0,1,2,2,1,2,8,6,0,0,0,0
S01011712,Very bad health,9,0,0,0,0,2,0,2,3,2,0,0,0,0
S01011713,All people aged 16 to 74,690,46,10,36,127,128,52,56,124,98,21,13,8,38
S01011713,Very good health,320,25,3,22,71,60,18,24,46,39,4,3,1,33
S01011713,Good health,217,14,5,9,36,43,20,18,52,27,4,2,2,3
S01011713,Fair health,101,4,1,3,15,18,10,10,19,17,6,2,4,2
S01011713,Bad health,41,3,1,2,4,6,2,3,3,13,7,6,1,0
S01011713,Very bad health,11,0,0,0,1,1,2,1,4,2,0,0,0,0
S01011714,All people aged 16 to 74,390,35,3,32,94,62,36,38,52,38,9,4,5,26
S01011714,Very good health,241,23,3,20,60,41,18,19,30,22,4,1,3,24
S01011714,Good health,106,11,0,11,26,14,13,16,13,10,2,0,2,1
S01011714,Fair health,33,1,0,1,7,6,4,2,7,2,3,3,0,1
S01011714,Bad health,10,0,0,0,1,1,1,1,2,4,0,0,0,0
S01011714,Very bad health,0,0,0,0,0,0,0,0,0,0,0,0,0,0
S01011715,All people aged 16 to 74,456,18,0,18,62,66,20,53,80,96,33,17,16,28
S01011715,Very good health,186,9,0,9,38,29,8,18,32,27,12,7,5,13
S01011715,Good health,146,7,0,7,19,24,3,18,18,38,6,1,5,13
S01011715,Fair health,72,1,0,1,3,5,2,10,21,18,10,5,5,2
S01011715,Bad health,37,1,0,1,1,6,4,6,7,8,4,3,1,0
S01011715,Very bad health,15,0,0,0,1,2,3,1,2,5,1,1,0,0
S01011716,All people aged 16 to 74,686,48,10,38,187,140,55,42,87,57,17,11,6,53
S01011716,Very good health,397,26,6,20,118,81,29,31,40,25,9,5,4,38
S01011716,Good health,205,17,3,14,57,48,18,6,25,20,2,1,1,12
S01011716,Fair health,54,5,1,4,9,10,4,1,13,5,4,3,1,3
S01011716,Bad health,17,0,0,0,0,0,3,1,7,5,1,1,0,0
S01011716,Very bad health,13,0,0,0,3,1,1,3,2,2,1,1,0,0
S01011717,All people aged 16 to 74,584,37,7,30,135,110,45,50,90,69,16,8,8,32
S01011717,Very good health,285,23,6,17,72,55,18,22,41,24,4,2,2,26
S01011717,Good health,190,10,1,9,41,38,16,17,29,28,5,2,3,6
S01011717,Fair health,72,4,0,4,14,15,7,6,15,7,4,2,2,0
S01011717,Bad health,33,0,0,0,8,2,4,5,4,8,2,1,1,0
S01011717,Very bad health,4,0,0,0,0,0,0,0,1,2,1,1,0,0
S01011718,All people aged 16 to 74,567,69,14,55,176,90,50,45,49,42,19,12,7,27
S01011718,Very good health,361,51,8,43,103,53,33,28,31,28,13,7,6,21
S01011718,Good health,149,14,4,10,59,30,11,12,14,4,2,2,0,3
S01011718,Fair health,35,3,1,2,14,4,3,1,2,5,1,0,1,2
S01011718,Bad health,15,1,1,0,0,3,1,4,2,1,2,2,0,1
S01011718,Very bad health,7,0,0,0,0,0,2,0,0,4,1,1,0,0
S01011719,All people aged 16 to 74,524,53,17,36,137,108,40,35,48,33,2,0,2,68
S01011719,Very good health,326,39,15,24,78,69,20,14,27,20,0,0,0,59
S01011719,Good health,153,11,2,9,47,30,14,14,17,10,2,0,2,8
S01011719,Fair health,37,3,0,3,10,9,5,5,3,1,0,0,0,1
S01011719,Bad health,5,0,0,0,1,0,1,2,0,1,0,0,0,0
S01011719,Very bad health,3,0,0,0,1,0,0,0,1,1,0,0,0,0
S01011720,All people aged 16 to 74,442,46,13,33,138,88,32,23,41,34,4,3,1,36
S01011720,Very good health,212,24,10,14,62,42,20,9,12,12,3,2,1,28
S01011720,Good health,164,15,1,14,59,37,9,7,20,11,0,0,0,6
S01011720,Fair health,40,4,1,3,7,6,2,7,6,6,1,1,0,1
S01011720,Bad health,19,1,0,1,9,3,0,0,2,3,0,0,0,1
S01011720,Very bad health,7,2,1,1,1,0,1,0,1,2,0,0,0,0
S01011721,All people aged 16 to 74,540,21,4,17,78,112,24,54,98,97,26,11,15,30
S01011721,Very good health,217,11,3,8,32,40,10,15,36,33,14,5,9,26
S01011721,Good health,184,5,0,5,28,39,7,23,33,38,7,3,4,4
S01011721,Fair health,94,5,1,4,12,19,6,10,18,19,5,3,2,0
S01011721,Bad health,33,0,0,0,4,10,0,4,10,5,0,0,0,0
S01011721,Very bad health,12,0,0,0,2,4,1,2,1,2,0,0,0,0
S01011722,All people aged 16 to 74,525,24,4,20,93,93,33,46,98,71,29,17,12,38
S01011722,Very good health,216,10,2,8,40,36,15,17,38,24,9,5,4,27
S01011722,Good health,197,9,1,8,37,41,13,14,37,23,15,8,7,8
S01011722,Fair health,71,5,1,4,8,13,3,7,13,15,5,4,1,2
S01011722,Bad health,30,0,0,0,6,3,2,6,7,6,0,0,0,0
S01011722,Very bad health,11,0,0,0,2,0,0,2,3,3,0,0,0,1
S01011723,All people aged 16 to 74,715,44,9,35,139,125,46,69,109,115,25,13,12,43
S01011723,Very good health,335,29,4,25,76,58,17,31,39,48,7,4,3,30
S01011723,Good health,208,11,4,7,43,39,14,22,32,32,9,5,4,6
S01011723,Fair health,110,4,1,3,10,22,9,8,22,23,6,2,4,6
S01011723,Bad health,44,0,0,0,6,3,4,5,13,10,2,1,1,1
S01011723,Very bad health,18,0,0,0,4,3,2,3,3,2,1,1,0,0
S01011724,All people aged 16 to 74,519,45,7,38,111,91,32,43,60,55,25,17,8,57
S01011724,Very good health,291,34,6,28,54,50,26,28,29,20,5,2,3,45
S01011724,Good health,154,8,1,7,44,30,4,12,20,15,13,9,4,8
S01011724,Fair health,52,2,0,2,11,7,2,3,9,10,5,4,1,3
S01011724,Bad health,16,1,0,1,2,2,0,0,1,8,1,1,0,1
S01011724,Very bad health,6,0,0,0,0,2,0,0,1,2,1,1,0,0
S01011725,All people aged 16 to 74,489,51,15,36,129,79,45,32,50,39,8,4,4,56
S01011725,Very good health,294,30,9,21,86,40,26,21,30,14,4,2,2,43
S01011725,Good health,144,16,6,10,35,27,13,9,12,18,4,2,2,10
S01011725,Fair health,38,4,0,4,5,8,5,0,7,6,0,0,0,3
S01011725,Bad health,10,0,0,0,2,3,1,2,1,1,0,0,0,0
S01011725,Very bad health,3,1,0,1,1,1,0,0,0,0,0,0,0,0
S01011726,All people aged 16 to 74,418,46,12,34,106,95,27,34,35,36,9,8,1,30
S01011726,Very good health,237,27,6,21,59,55,12,21,13,22,4,4,0,24
S01011726,Good health,131,17,4,13,37,27,13,8,13,7,3,3,0,6
S01011726,Fair health,35,2,2,0,6,11,2,3,5,6,0,0,0,0
S01011726,Bad health,13,0,0,0,3,2,0,2,4,1,1,0,1,0
S01011726,Very bad health,2,0,0,0,1,0,0,0,0,0,1,1,0,0
S01011727,All people aged 16 to 74,553,91,21,70,163,83,56,34,53,21,10,3,7,42
S01011727,Very good health,361,65,16,49,102,55,33,21,28,13,7,1,6,37
S01011727,Good health,145,19,5,14,49,26,14,9,16,5,2,2,0,5
S01011727,Fair health,39,4,0,4,11,2,7,4,8,2,1,0,1,0
S01011727,Bad health,7,2,0,2,1,0,2,0,1,1,0,0,0,0
S01011727,Very bad health,1,1,0,1,0,0,0,0,0,0,0,0,0,0
S01011728,All people aged 16 to 74,717,26,7,19,124,133,53,68,135,104,22,16,6,52
S01011728,Very good health,329,8,2,6,65,59,28,36,58,31,7,5,2,37
S01011728,Good health,262,16,5,11,46,53,19,22,47,40,8,4,4,11
S01011728,Fair health,87,1,0,1,8,18,4,6,19,26,3,3,0,2
S01011728,Bad health,29,1,0,1,4,1,2,1,8,6,4,4,0,2
S01011728,Very bad health,10,0,0,0,1,2,0,3,3,1,0,0,0,0
S01011729,All people aged 16 to 74,518,21,4,17,82,70,23,65,78,98,37,20,17,44
S01011729,Very good health,209,10,2,8,37,31,12,20,26,34,10,6,4,29
S01011729,Good health,168,9,2,7,31,24,7,16,26,26,18,7,11,11
S01011729,Fair health,87,0,0,0,10,12,3,14,20,19,5,3,2,4
S01011729,Bad health,41,2,0,2,3,3,1,13,3,14,2,2,0,0
S01011729,Very bad health,13,0,0,0,1,0,0,2,3,5,2,2,0,0
S01011730,All people aged 16 to 74,713,54,10,44,166,139,54,68,101,84,6,2,4,41
S01011730,Very good health,323,29,3,26,85,65,19,22,40,29,3,1,2,31
S01011730,Good health,236,18,3,15,60,46,21,25,35,25,1,1,0,5
S01011730,Fair health,113,6,4,2,18,14,11,17,22,24,1,0,1,0
S01011730,Bad health,31,1,0,1,2,10,3,2,4,4,1,0,1,4
S01011730,Very bad health,10,0,0,0,1,4,0,2,0,2,0,0,0,1
S01011731,All people aged 16 to 74,630,20,4,16,102,102,45,64,121,108,24,17,7,44
S01011731,Very good health,253,11,4,7,51,38,11,27,46,31,5,4,1,33
S01011731,Good health,244,6,0,6,36,45,20,27,50,43,9,5,4,8
S01011731,Fair health,98,3,0,3,12,15,9,7,19,24,7,5,2,2
S01011731,Bad health,25,0,0,0,3,3,5,1,5,6,1,1,0,1
S01011731,Very bad health,10,0,0,0,0,1,0,2,1,4,2,2,0,0
S01011732,All people aged 16 to 74,658,55,15,40,188,140,43,50,70,51,12,7,5,49
S01011732,Very good health,338,24,7,17,105,67,17,28,28,25,4,2,2,40
S01011732,Good health,223,23,8,15,61,50,19,15,29,16,3,2,1,7
S01011732,Fair health,74,6,0,6,18,16,7,5,8,9,3,1,2,2
S01011732,Bad health,18,2,0,2,4,6,0,0,4,1,1,1,0,0
S01011732,Very bad health,5,0,0,0,0,1,0,2,1,0,1,1,0,0
S01011733,All people aged 16 to 74,650,24,6,18,122,131,40,52,102,117,23,8,15,39
S01011733,Very good health,278,15,5,10,53,53,18,28,27,43,8,2,6,33
S01011733,Good health,242,8,1,7,49,58,9,11,46,46,11,4,7,4
S01011733,Fair health,94,1,0,1,16,14,11,8,19,20,3,1,2,2
S01011733,Bad health,23,0,0,0,1,1,2,5,7,6,1,1,0,0
S01011733,Very bad health,13,0,0,0,3,5,0,0,3,2,0,0,0,0
S01011734,All people aged 16 to 74,585,39,9,30,127,89,44,57,102,67,14,8,6,46
S01011734,Very good health,275,19,5,14,64,45,16,29,39,21,4,2,2,38
S01011734,Good health,181,14,2,12,43,27,20,12,28,23,6,2,4,8
S01011734,Fair health,84,4,1,3,16,13,5,8,20,15,3,3,0,0
S01011734,Bad health,36,2,1,1,3,2,2,8,14,5,0,0,0,0
S01011734,Very bad health,9,0,0,0,1,2,1,0,1,3,1,1,0,0
S01011735,All people aged 16 to 74,576,53,14,39,162,98,45,34,69,46,16,6,10,53
S01011735,Very good health,274,27,9,18,75,51,20,12,25,17,3,1,2,44
S01011735,Good health,200,24,5,19,53,28,19,13,31,17,6,3,3,9
S01011735,Fair health,75,1,0,1,25,15,6,8,7,7,6,1,5,0
S01011735,Bad health,22,1,0,1,7,4,0,1,6,3,0,0,0,0
S01011735,Very bad health,5,0,0,0,2,0,0,0,0,2,1,1,0,0
S01011736,All people aged 16 to 74,549,19,2,17,91,106,28,44,111,86,20,12,8,44
S01011736,Very good health,254,12,1,11,39,51,12,19,50,33,7,3,4,31
S01011736,Good health,199,5,0,5,38,41,12,15,40,38,4,1,3,6
S01011736,Fair health,67,1,1,0,14,9,2,7,13,11,5,4,1,5
S01011736,Bad health,20,1,0,1,0,2,1,1,7,2,4,4,0,2
S01011736,Very bad health,9,0,0,0,0,3,1,2,1,2,0,0,0,0
S01011737,All people aged 16 to 74,505,18,5,13,75,83,36,28,87,84,41,28,13,53
S01011737,Very good health,240,11,3,8,39,33,15,10,40,36,18,13,5,38
S01011737,Good health,158,4,0,4,23,23,16,11,22,30,16,10,6,13
S01011737,Fair health,77,1,0,1,10,18,3,6,17,14,6,5,1,2
S01011737,Bad health,22,2,2,0,3,4,2,1,6,3,1,0,1,0
S01011737,Very bad health,8,0,0,0,0,5,0,0,2,1,0,0,0,0
S01011738,All people aged 16 to 74,779,42,14,28,139,117,55,57,142,131,43,27,16,53
S01011738,Very good health,350,23,6,17,75,44,22,22,64,46,13,8,5,41
S01011738,Good health,268,13,5,8,49,48,22,18,49,45,13,6,7,11
S01011738,Fair health,105,5,3,2,10,17,8,9,18,23,14,11,3,1
S01011738,Bad health,46,1,0,1,3,6,2,8,8,16,2,1,1,0
S01011738,Very bad health,10,0,0,0,2,2,1,0,3,1,1,1,0,0
S01011739,All people aged 16 to 74,383,6,1,5,53,61,21,41,96,60,19,8,11,26
S01011739,Very good health,149,5,1,4,15,26,8,18,32,21,6,3,3,18
S01011739,Good health,141,0,0,0,25,24,5,9,46,19,8,1,7,5
S01011739,Fair health,71,1,0,1,8,9,5,11,15,15,4,3,1,3
S01011739,Bad health,17,0,0,0,4,2,2,1,3,4,1,1,0,0
S01011739,Very bad health,5,0,0,0,1,0,1,2,0,1,0,0,0,0
S01011740,All people aged 16 to 74,572,15,3,12,84,61,22,54,116,100,61,36,25,59
S01011740,Very good health,226,9,2,7,33,25,7,17,42,40,21,11,10,32
S01011740,Good health,188,6,1,5,30,15,9,16,34,33,27,17,10,18
S01011740,Fair health,98,0,0,0,13,16,3,11,24,17,7,3,4,7
S01011740,Bad health,45,0,0,0,6,4,1,8,12,8,5,4,1,1
S01011740,Very bad health,15,0,0,0,2,1,2,2,4,2,1,1,0,1
S01011741,All people aged 16 to 74,493,18,5,13,50,96,19,43,104,98,32,16,16,33
S01011741,Very good health,178,6,3,3,25,38,7,11,31,27,9,2,7,24
S01011741,Good health,190,10,1,9,12,37,8,19,42,42,11,3,8,9
S01011741,Fair health,91,2,1,1,11,19,3,11,24,15,6,5,1,0
S01011741,Bad health,26,0,0,0,2,2,1,1,6,9,5,5,0,0
S01011741,Very bad health,8,0,0,0,0,0,0,1,1,5,1,1,0,0
S01011742,All people aged 16 to 74,561,26,3,23,100,93,28,48,117,70,29,13,16,50
S01011742,Very good health,270,15,2,13,52,45,16,22,42,21,14,3,11,43
S01011742,Good health,182,8,0,8,32,29,10,13,51,30,4,2,2,5
S01011742,Fair health,68,2,0,2,10,13,1,8,13,10,9,6,3,2
S01011742,Bad health,33,1,1,0,5,5,0,4,10,7,1,1,0,0
S01011742,Very bad health,8,0,0,0,1,1,1,1,1,2,1,1,0,0
S01011743,All people aged 16 to 74,595,29,3,26,111,137,29,56,89,85,16,8,8,43
S01011743,Very good health,259,12,2,10,55,56,14,19,39,29,4,2,2,31
S01011743,Good health,234,12,1,11,39,62,12,23,28,40,7,3,4,11
S01011743,Fair health,73,3,0,3,13,14,0,12,16,12,2,0,2,1
S01011743,Bad health,26,2,0,2,4,5,3,2,4,3,3,3,0,0
S01011743,Very bad health,3,0,0,0,0,0,0,0,2,1,0,0,0,0
S01011744,All people aged 16 to 74,603,32,6,26,121,99,34,45,101,98,41,19,22,32
S01011744,Very good health,239,14,4,10,55,44,15,13,35,28,14,4,10,21
S01011744,Good health,216,14,1,13,47,33,11,16,42,34,9,5,4,10
S01011744,Fair health,96,4,1,3,12,12,7,10,17,18,16,9,7,0
S01011744,Bad health,38,0,0,0,5,9,1,3,2,16,1,0,1,1
S01011744,Very bad health,14,0,0,0,2,1,0,3,5,2,1,1,0,0
S01011745,All people aged 16 to 74,488,14,6,8,75,70,23,44,86,124,25,20,5,27
S01011745,Very good health,174,6,3,3,31,22,10,8,42,31,4,3,1,20
S01011745,Good health,170,7,3,4,29,32,8,19,21,41,8,6,2,5
S01011745,Fair health,88,1,0,1,11,12,4,10,14,28,6,4,2,2
S01011745,Bad health,38,0,0,0,1,2,0,5,7,19,4,4,0,0
S01011745,Very bad health,18,0,0,0,3,2,1,2,2,5,3,3,0,0
S01011746,All people aged 16 to 74,388,5,2,3,42,39,21,30,115,83,28,11,17,25
S01011746,Very good health,154,2,1,1,17,12,7,11,43,34,11,3,8,17
S01011746,Good health,132,2,1,1,16,14,4,14,41,24,10,4,6,7
S01011746,Fair health,63,1,0,1,7,5,5,3,23,15,4,2,2,0
S01011746,Bad health,28,0,0,0,1,6,3,0,6,8,3,2,1,1
S01011746,Very bad health,11,0,0,0,1,2,2,2,2,2,0,0,0,0
S01011747,All people aged 16 to 74,704,13,4,9,76,86,31,66,153,150,67,28,39,62
S01011747,Very good health,264,6,2,4,27,35,14,19,52,44,26,10,16,41
S01011747,Good health,259,6,1,5,36,28,13,31,54,53,22,9,13,16
S01011747,Fair health,114,1,1,0,5,14,3,9,31,31,16,6,10,4
S01011747,Bad health,55,0,0,0,7,6,1,6,13,19,2,2,0,1
S01011747,Very bad health,12,0,0,0,1,3,0,1,3,3,1,1,0,0
S01011748,All people aged 16 to 74,619,13,3,10,75,80,27,57,157,107,51,28,23,52
S01011748,Very good health,253,3,0,3,29,44,13,20,58,37,20,11,9,29
S01011748,Good health,221,5,2,3,33,22,5,18,54,47,17,8,9,20
S01011748,Fair health,93,3,1,2,7,12,6,13,27,15,7,6,1,3
S01011748,Bad health,43,2,0,2,5,1,3,4,14,8,6,3,3,0
S01011748,Very bad health,9,0,0,0,1,1,0,2,4,0,1,0,1,0
S01011749,All people aged 16 to 74,552,12,2,10,58,55,21,42,125,111,83,56,27,45
S01011749,Very good health,214,6,1,5,21,24,6,17,56,32,34,22,12,18
S01011749,Good health,198,4,1,3,22,23,8,10,40,36,30,19,11,25
S01011749,Fair health,97,2,0,2,11,5,3,8,22,31,13,10,3,2
S01011749,Bad health,35,0,0,0,3,1,4,6,4,12,5,4,1,0
S01011749,Very bad health,8,0,0,0,1,2,0,1,3,0,1,1,0,0
S01011750,All people aged 16 to 74,642,21,6,15,98,117,40,51,112,116,32,16,16,55
S01011750,Very good health,278,9,4,5,48,47,17,19,46,44,13,6,7,35
S01011750,Good health,221,9,2,7,34,43,15,23,30,41,11,5,6,15
S01011750,Fair health,93,3,0,3,10,19,6,4,25,18,3,0,3,5
S01011750,Bad health,40,0,0,0,4,7,2,5,9,11,2,2,0,0
S01011750,Very bad health,10,0,0,0,2,1,0,0,2,2,3,3,0,0
S01011751,All people aged 16 to 74,745,20,5,15,86,94,27,67,178,144,68,31,37,61
S01011751,Very good health,317,15,4,11,45,38,16,21,71,53,21,11,10,37
S01011751,Good health,235,2,1,1,23,27,4,32,55,43,27,10,17,22
S01011751,Fair health,126,3,0,3,10,18,6,7,36,31,14,5,9,1
S01011751,Bad health,59,0,0,0,8,8,1,7,13,15,6,5,1,1
S01011751,Very bad health,8,0,0,0,0,3,0,0,3,2,0,0,0,0
S01011752,All people aged 16 to 74,687,24,5,19,137,109,36,79,123,119,25,13,12,35
S01011752,Very good health,291,14,2,12,71,49,16,27,54,29,10,6,4,21
S01011752,Good health,248,9,3,6,50,41,9,23,47,46,11,5,6,12
S01011752,Fair health,104,0,0,0,10,14,8,21,14,34,1,0,1,2
S01011752,Bad health,38,0,0,0,6,4,3,7,7,9,2,1,1,0
S01011752,Very bad health,6,1,0,1,0,1,0,1,1,1,1,1,0,0
S01011753,All people aged 16 to 74,602,47,13,34,165,100,33,45,92,56,20,7,13,44
S01011753,Very good health,249,16,6,10,68,43,17,18,31,22,6,4,2,28
S01011753,Good health,241,19,5,14,75,38,8,16,45,16,9,2,7,15
S01011753,Fair health,78,10,2,8,17,16,8,4,8,12,3,0,3,0
S01011753,Bad health,27,1,0,1,3,3,0,6,7,4,2,1,1,1
S01011753,Very bad health,7,1,0,1,2,0,0,1,1,2,0,0,0,0
S01011754,All people aged 16 to 74,543,21,7,14,86,95,29,62,107,77,19,8,11,47
S01011754,Very good health,239,11,4,7,41,42,14,24,47,25,2,2,0,33
S01011754,Good health,186,6,2,4,28,33,9,20,35,31,11,3,8,13
S01011754,Fair health,81,2,0,2,13,16,4,12,20,9,4,2,2,1
S01011754,Bad health,27,2,1,1,3,3,2,4,3,8,2,1,1,0
S01011754,Very bad health,10,0,0,0,1,1,0,2,2,4,0,0,0,0
S01011755,All people aged 16 to 74,728,29,8,21,118,119,42,63,149,123,41,22,19,44
S01011755,Very good health,319,15,5,10,65,52,17,21,59,47,11,5,6,32
S01011755,Good health,249,9,2,7,34,47,10,22,55,46,16,3,13,10
S01011755,Fair health,96,3,1,2,12,14,7,14,22,17,5,5,0,2
S01011755,Bad health,46,1,0,1,6,4,6,3,10,10,6,6,0,0
S01011755,Very bad health,18,1,0,1,1,2,2,3,3,3,3,3,0,0
S01011756,All people aged 16 to 74,745,24,6,18,117,128,37,67,141,125,38,13,25,68
S01011756,Very good health,337,8,4,4,45,62,13,25,61,55,15,4,11,53
S01011756,Good health,256,15,2,13,51,44,14,22,48,36,13,5,8,13
S01011756,Fair health,102,1,0,1,14,11,4,15,21,26,8,3,5,2
S01011756,Bad health,37,0,0,0,6,10,4,2,8,5,2,1,1,0
S01011756,Very bad health,13,0,0,0,1,1,2,3,3,3,0,0,0,0
S01011757,All people aged 16 to 74,520,16,3,13,80,86,28,46,111,84,28,15,13,41
S01011757,Very good health,204,6,2,4,32,40,3,23,39,27,5,1,4,29
S01011757,Good health,186,6,1,5,32,28,14,13,42,34,7,4,3,10
S01011757,Fair health,87,2,0,2,12,16,8,4,16,14,13,7,6,2
S01011757,Bad health,26,2,0,2,3,1,3,2,8,6,1,1,0,0
S01011757,Very bad health,17,0,0,0,1,1,0,4,6,3,2,2,0,0
S01011758,All people aged 16 to 74,479,25,8,17,65,99,22,38,96,79,25,16,9,30
S01011758,Very good health,202,12,4,8,27,46,5,13,33,32,8,6,2,26
S01011758,Good health,180,8,3,5,27,35,13,14,43,27,9,4,5,4
S01011758,Fair health,66,4,1,3,8,16,2,7,11,12,6,4,2,0
S01011758,Bad health,22,0,0,0,3,1,0,2,7,7,2,2,0,0
S01011758,Very bad health,9,1,0,1,0,1,2,2,2,1,0,0,0,0
S01011759,All people aged 16 to 74,627,27,7,20,78,123,31,63,121,113,30,17,13,41
S01011759,Very good health,234,11,1,10,25,43,11,27,37,37,9,3,6,34
S01011759,Good health,216,9,4,5,32,48,8,20,51,35,8,5,3,5
S01011759,Fair health,113,6,2,4,12,25,5,8,22,23,10,6,4,2
S01011759,Bad health,48,1,0,1,8,6,5,4,7,14,3,3,0,0
S01011759,Very bad health,16,0,0,0,1,1,2,4,4,4,0,0,0,0
S01011760,All people aged 16 to 74,697,19,3,16,105,134,35,62,141,124,32,17,15,45
S01011760,Very good health,312,10,2,8,47,59,11,26,59,43,18,8,10,39
S01011760,Good health,227,6,0,6,33,43,15,22,48,47,8,4,4,5
S01011760,Fair health,96,2,1,1,17,22,6,8,21,15,4,3,1,1
S01011760,Bad health,46,1,0,1,5,7,2,5,13,11,2,2,0,0
S01011760,Very bad health,16,0,0,0,3,3,1,1,0,8,0,0,0,0
S01011761,All people aged 16 to 74,492,28,7,21,81,69,26,37,97,95,17,10,7,42
S01011761,Very good health,247,18,6,12,50,33,12,16,48,36,2,1,1,32
S01011761,Good health,143,9,1,8,20,19,8,10,28,35,7,2,5,7
S01011761,Fair health,64,1,0,1,6,11,5,8,12,15,4,3,1,2
S01011761,Bad health,24,0,0,0,2,5,0,1,7,6,3,3,0,0
S01011761,Very bad health,14,0,0,0,3,1,1,2,2,3,1,1,0,1
S01011762,All people aged 16 to 74,503,23,5,18,72,86,25,41,107,71,29,18,11,49
S01011762,Very good health,209,18,4,14,26,25,6,17,47,25,7,4,3,38
S01011762,Good health,176,2,1,1,22,39,10,14,40,27,12,9,3,10
S01011762,Fair health,84,3,0,3,20,16,5,9,12,11,7,4,3,1
S01011762,Bad health,27,0,0,0,4,6,2,1,5,6,3,1,2,0
S01011762,Very bad health,7,0,0,0,0,0,2,0,3,2,0,0,0,0
S01011763,All people aged 16 to 74,603,22,7,15,94,107,43,65,118,89,21,10,11,44
S01011763,Very good health,267,15,3,12,45,57,9,27,46,30,5,5,0,33
S01011763,Good health,187,6,4,2,27,34,22,16,36,27,10,3,7,9
S01011763,Fair health,87,0,0,0,13,11,6,18,22,14,1,1,0,2
S01011763,Bad health,51,1,0,1,6,5,6,4,11,13,5,1,4,0
S01011763,Very bad health,11,0,0,0,3,0,0,0,3,5,0,0,0,0
S01011764,All people aged 16 to 74,326,13,4,9,63,50,15,38,64,40,10,6,4,33
S01011764,Very good health,140,3,2,1,32,22,4,17,24,8,3,2,1,27
S01011764,Good health,121,6,1,5,22,18,8,16,23,17,5,2,3,6
S01011764,Fair health,42,4,1,3,6,7,3,2,11,9,0,0,0,0
S01011764,Bad health,17,0,0,0,2,2,0,2,4,6,1,1,0,0
S01011764,Very bad health,6,0,0,0,1,1,0,1,2,0,1,1,0,0
S01011765,All people aged 16 to 74,799,68,12,56,202,157,58,46,94,71,14,10,4,89
S01011765,Very good health,452,43,9,34,108,84,28,25,43,37,6,3,3,78
S01011765,Good health,246,18,3,15,70,57,20,15,33,23,1,1,0,9
S01011765,Fair health,72,5,0,5,17,10,8,4,15,7,4,3,1,2
S01011765,Bad health,27,2,0,2,7,6,2,2,3,2,3,3,0,0
S01011765,Very bad health,2,0,0,0,0,0,0,0,0,2,0,0,0,0
S01011766,All people aged 16 to 74,395,45,17,28,97,71,40,19,41,53,6,3,3,23
S01011766,Very good health,185,21,8,13,52,32,18,7,15,20,2,0,2,18
S01011766,Good health,144,17,5,12,34,27,15,10,16,18,3,2,1,4
S01011766,Fair health,44,5,3,2,7,7,5,1,6,13,0,0,0,0
S01011766,Bad health,16,1,1,0,3,5,1,0,3,2,0,0,0,1
S01011766,Very bad health,6,1,0,1,1,0,1,1,1,0,1,1,0,0
S01011767,All people aged 16 to 74,663,27,9,18,114,81,45,61,129,119,42,19,23,45
S01011767,Very good health,276,8,1,7,54,41,18,19,48,45,14,8,6,29
S01011767,Good health,220,13,5,8,39,27,13,29,52,25,13,4,9,9
S01011767,Fair health,112,4,2,2,12,10,11,7,21,33,10,5,5,4
S01011767,Bad health,46,2,1,1,8,1,3,6,7,13,4,1,3,2
S01011767,Very bad health,9,0,0,0,1,2,0,0,1,3,1,1,0,1
S01011768,All people aged 16 to 74,530,15,2,13,73,84,25,48,89,114,45,20,25,37
S01011768,Very good health,230,4,1,3,46,35,12,16,33,41,19,8,11,24
S01011768,Good health,176,9,1,8,19,36,8,19,29,40,8,2,6,8
S01011768,Fair health,83,1,0,1,6,11,2,6,18,21,13,6,7,5
S01011768,Bad health,32,0,0,0,1,2,2,7,5,11,4,3,1,0
S01011768,Very bad health,9,1,0,1,1,0,1,0,4,1,1,1,0,0
S01011769,All people aged 16 to 74,466,22,4,18,74,80,39,39,87,76,23,12,11,26
S01011769,Very good health,179,9,1,8,32,29,14,10,32,30,6,2,4,17
S01011769,Good health,159,4,2,2,26,32,16,16,31,20,7,4,3,7
S01011769,Fair health,82,6,1,5,9,12,5,10,14,16,8,5,3,2
S01011769,Bad health,32,0,0,0,4,5,4,3,7,8,1,1,0,0
S01011769,Very bad health,14,3,0,3,3,2,0,0,3,2,1,0,1,0
S01011770,All people aged 16 to 74,606,27,5,22,83,99,30,53,131,103,46,24,22,34
S01011770,Very good health,226,14,2,12,38,38,6,11,45,36,15,7,8,23
S01011770,Good health,226,10,3,7,26,36,15,23,54,39,15,8,7,8
S01011770,Fair health,106,1,0,1,10,16,7,17,24,22,7,2,5,2
S01011770,Bad health,37,1,0,1,8,6,1,2,6,5,7,5,2,1
S01011770,Very bad health,11,1,0,1,1,3,1,0,2,1,2,2,0,0
S01011771,All people aged 16 to 74,522,63,10,53,149,82,39,34,50,39,12,8,4,54
S01011771,Very good health,290,39,6,33,84,38,21,20,24,17,3,2,1,44
S01011771,Good health,185,19,3,16,50,38,13,13,21,17,4,1,3,10
S01011771,Fair health,30,5,1,4,9,4,3,1,3,1,4,4,0,0
S01011771,Bad health,13,0,0,0,4,2,2,0,2,3,0,0,0,0
S01011771,Very bad health,4,0,0,0,2,0,0,0,0,1,1,1,0,0
S01011772,All people aged 16 to 74,848,131,35,96,246,120,92,40,74,35,23,16,7,87
S01011772,Very good health,500,87,23,64,155,71,42,18,30,14,8,4,4,75
S01011772,Good health,268,35,10,25,72,37,43,15,30,15,9,7,2,12
S01011772,Fair health,61,6,1,5,15,7,7,7,10,4,5,5,0,0
S01011772,Bad health,17,2,1,1,4,5,0,0,4,1,1,0,1,0
S01011772,Very bad health,2,1,0,1,0,0,0,0,0,1,0,0,0,0
S01011773,All people aged 16 to 74,439,59,15,44,118,81,30,37,43,20,7,5,2,44
S01011773,Very good health,280,40,11,29,80,49,20,18,23,10,1,0,1,39
S01011773,Good health,136,17,4,13,34,27,9,17,17,8,2,2,0,5
S01011773,Fair health,18,1,0,1,4,4,1,2,2,2,2,2,0,0
S01011773,Bad health,5,1,0,1,0,1,0,0,1,0,2,1,1,0
S01011773,Very bad health,0,0,0,0,0,0,0,0,0,0,0,0,0,0
S01011774,All people aged 16 to 74,678,70,11,59,170,116,54,46,77,55,20,12,8,70
S01011774,Very good health,400,50,5,45,111,75,27,28,24,29,8,6,2,48
S01011774,Good health,180,15,5,10,44,30,20,13,26,12,3,1,2,17
S01011774,Fair health,69,5,1,4,12,7,5,5,16,8,7,5,2,4
S01011774,Bad health,21,0,0,0,1,4,1,0,9,5,1,0,1,0
S01011774,Very bad health,8,0,0,0,2,0,1,0,2,1,1,0,1,1
S01011775,All people aged 16 to 74,463,83,27,56,138,72,35,24,46,17,11,10,1,37
S01011775,Very good health,252,52,15,37,68,39,19,10,21,10,4,3,1,29
S01011775,Good health,184,28,12,16,64,30,14,11,20,6,6,6,0,5
S01011775,Fair health,25,3,0,3,5,3,2,3,5,1,1,1,0,2
S01011775,Bad health,2,0,0,0,1,0,0,0,0,0,0,0,0,1
S01011775,Very bad health,0,0,0,0,0,0,0,0,0,0,0,0,0,0
S01011776,All people aged 16 to 74,729,121,31,90,229,118,67,34,60,32,19,13,6,49
S01011776,Very good health,505,89,25,64,161,80,37,23,39,20,10,5,5,46
S01011776,Good health,166,29,6,23,51,27,23,8,13,7,5,4,1,3
S01011776,Fair health,39,2,0,2,15,4,6,2,6,3,1,1,0,0
S01011776,Bad health,15,1,0,1,2,7,1,0,2,1,1,1,0,0
S01011776,Very bad health,4,0,0,0,0,0,0,1,0,1,2,2,0,0
S01011777,All people aged 16 to 74,460,62,10,52,149,97,24,23,46,26,7,2,5,26
S01011777,Very good health,289,44,8,36,100,55,17,7,24,15,5,1,4,22
S01011777,Good health,113,16,1,15,40,25,3,9,15,2,1,1,0,2
S01011777,Fair health,42,1,1,0,9,13,4,4,7,3,0,0,0,1
S01011777,Bad health,13,1,0,1,0,2,0,2,0,6,1,0,1,1
S01011777,Very bad health,3,0,0,0,0,2,0,1,0,0,0,0,0,0
S01011778,All people aged 16 to 74,465,72,15,57,139,76,38,25,41,20,8,1,7,46
S01011778,Very good health,280,45,12,33,85,44,25,9,19,7,4,1,3,42
S01011778,Good health,135,24,2,22,40,24,10,7,14,8,4,0,4,4
S01011778,Fair health,31,1,0,1,11,6,2,6,4,1,0,0,0,0
S01011778,Bad health,15,2,1,1,2,1,1,3,3,3,0,0,0,0
S01011778,Very bad health,4,0,0,0,1,1,0,0,1,1,0,0,0,0
S01011779,All people aged 16 to 74,595,75,15,60,170,111,50,44,61,32,10,2,8,42
S01011779,Very good health,333,57,11,46,107,51,23,23,25,10,3,0,3,34
S01011779,Good health,184,13,4,9,49,42,16,16,28,9,5,1,4,6
S01011779,Fair health,57,4,0,4,12,12,9,4,5,7,2,1,1,2
S01011779,Bad health,18,1,0,1,2,6,2,1,2,4,0,0,0,0
S01011779,Very bad health,3,0,0,0,0,0,0,0,1,2,0,0,0,0
S01011780,All people aged 16 to 74,709,116,29,87,190,105,71,38,70,39,14,8,6,66
S01011780,Very good health,390,77,19,58,97,58,34,14,32,13,5,1,4,60
S01011780,Good health,227,32,9,23,73,28,28,16,24,16,5,4,1,5
S01011780,Fair health,62,6,1,5,16,11,7,4,9,5,3,2,1,1
S01011780,Bad health,26,1,0,1,4,7,2,4,3,5,0,0,0,0
S01011780,Very bad health,4,0,0,0,0,1,0,0,2,0,1,1,0,0
S01011781,All people aged 16 to 74,437,50,12,38,112,71,26,31,58,35,3,0,3,51
S01011781,Very good health,247,26,6,20,69,37,11,13,29,16,2,0,2,44
S01011781,Good health,132,14,2,12,31,23,12,13,17,15,1,0,1,6
S01011781,Fair health,38,7,2,5,7,9,1,4,8,1,0,0,0,1
S01011781,Bad health,14,1,0,1,4,1,1,1,3,3,0,0,0,0
S01011781,Very bad health,6,2,2,0,1,1,1,0,1,0,0,0,0,0
S01011782,All people aged 16 to 74,556,67,18,49,151,90,43,38,68,34,11,5,6,54
S01011782,Very good health,317,42,11,31,80,53,19,18,39,14,3,0,3,49
S01011782,Good health,162,22,5,17,52,28,22,12,14,5,2,1,1,5
S01011782,Fair health,61,2,1,1,16,9,1,7,9,12,5,3,2,0
S01011782,Bad health,8,0,0,0,1,0,0,0,4,2,1,1,0,0
S01011782,Very bad health,8,1,1,0,2,0,1,1,2,1,0,0,0,0
S01011783,All people aged 16 to 74,464,53,9,44,127,77,37,30,53,35,11,7,4,41
S01011783,Very good health,259,35,4,31,77,37,20,15,25,10,3,2,1,37
S01011783,Good health,137,11,1,10,38,26,10,10,20,13,5,3,2,4
S01011783,Fair health,50,5,3,2,11,11,5,3,5,9,1,0,1,0
S01011783,Bad health,11,2,1,1,1,3,1,2,2,0,0,0,0,0
S01011783,Very bad health,7,0,0,0,0,0,1,0,1,3,2,2,0,0
S01011784,All people aged 16 to 74,615,24,5,19,100,119,33,49,119,84,28,18,10,59
S01011784,Very good health,276,11,2,9,59,55,10,18,39,32,10,5,5,42
S01011784,Good health,197,5,1,4,25,35,15,19,49,28,7,3,4,14
S01011784,Fair health,87,5,1,4,8,19,6,5,20,14,7,6,1,3
S01011784,Bad health,38,2,1,1,5,7,2,6,7,6,3,3,0,0
S01011784,Very bad health,17,1,0,1,3,3,0,1,4,4,1,1,0,0
S01011785,All people aged 16 to 74,634,38,10,28,121,135,34,45,122,88,20,14,6,31
S01011785,Very good health,268,22,5,17,54,53,11,19,41,43,1,1,0,24
S01011785,Good health,202,13,5,8,39,49,14,12,40,20,9,5,4,6
S01011785,Fair health,117,3,0,3,18,22,6,8,33,19,7,5,2,1
S01011785,Bad health,39,0,0,0,8,9,2,6,7,6,1,1,0,0
S01011785,Very bad health,8,0,0,0,2,2,1,0,1,0,2,2,0,0
S01011786,All people aged 16 to 74,293,48,10,38,84,47,23,21,13,11,10,6,4,36
S01011786,Very good health,189,29,7,22,56,33,13,15,5,3,4,3,1,31
S01011786,Good health,80,14,2,12,24,11,10,5,4,4,4,3,1,4
S01011786,Fair health,18,5,1,4,4,3,0,1,2,1,2,0,2,0
S01011786,Bad health,4,0,0,0,0,0,0,0,2,1,0,0,0,1
S01011786,Very bad health,2,0,0,0,0,0,0,0,0,2,0,0,0,0
S01011787,All people aged 16 to 74,751,22,7,15,89,80,59,70,150,161,61,34,27,59
S01011787,Very good health,321,13,2,11,51,38,32,29,52,46,13,5,8,47
S01011787,Good health,224,7,3,4,24,24,15,20,55,57,15,7,8,7
S01011787,Fair health,114,1,1,0,9,12,6,14,27,25,17,7,10,3
S01011787,Bad health,68,0,0,0,4,3,4,3,14,28,12,11,1,0
S01011787,Very bad health,24,1,1,0,1,3,2,4,2,5,4,4,0,2
S01011788,All people aged 16 to 74,496,105,27,78,146,56,82,11,28,15,8,2,6,45
S01011788,Very good health,324,75,22,53,88,38,46,6,19,5,6,1,5,41
S01011788,Good health,141,24,4,20,50,15,28,5,8,7,0,0,0,4
S01011788,Fair health,25,6,1,5,7,2,7,0,1,1,1,0,1,0
S01011788,Bad health,5,0,0,0,1,1,1,0,0,2,0,0,0,0
S01011788,Very bad health,1,0,0,0,0,0,0,0,0,0,1,1,0,0
S01011789,All people aged 16 to 74,501,31,6,25,98,76,63,59,63,71,10,8,2,30
S01011789,Very good health,207,19,2,17,42,28,24,25,16,21,6,4,2,26
S01011789,Good health,184,10,3,7,41,28,27,26,23,25,2,2,0,2
S01011789,Fair health,73,1,0,1,9,16,7,6,14,18,1,1,0,1
S01011789,Bad health,29,1,1,0,6,2,5,2,7,5,1,1,0,0
S01011789,Very bad health,8,0,0,0,0,2,0,0,3,2,0,0,0,1
S01011790,All people aged 16 to 74,749,40,11,29,125,87,82,60,129,112,53,35,18,61
S01011790,Very good health,345,26,6,20,71,52,38,17,44,40,15,10,5,42
S01011790,Good health,215,11,4,7,36,24,26,19,43,28,18,12,6,10
S01011790,Fair health,128,2,1,1,14,5,13,15,26,34,14,9,5,5
S01011790,Bad health,42,1,0,1,2,3,3,7,11,9,5,3,2,1
S01011790,Very bad health,19,0,0,0,2,3,2,2,5,1,1,1,0,3
S01011791,All people aged 16 to 74,547,16,2,14,75,80,43,55,99,115,28,22,6,36
S01011791,Very good health,232,8,0,8,38,29,15,24,39,42,8,6,2,29
S01011791,Good health,167,4,1,3,20,27,15,15,39,33,9,8,1,5
S01011791,Fair health,94,4,1,3,12,18,9,11,10,21,7,4,3,2
S01011791,Bad health,48,0,0,0,5,5,4,5,10,16,3,3,0,0
S01011791,Very bad health,6,0,0,0,0,1,0,0,1,3,1,1,0,0
S01011792,All people aged 16 to 74,638,36,9,27,133,88,53,53,105,117,29,16,13,24
S01011792,Very good health,241,17,2,15,71,36,17,19,28,26,7,3,4,20
S01011792,Good health,223,16,6,10,41,32,22,18,36,43,12,6,6,3
S01011792,Fair health,113,2,1,1,15,15,9,5,26,34,7,5,2,0
S01011792,Bad health,51,1,0,1,6,2,5,9,13,11,3,2,1,1
S01011792,Very bad health,10,0,0,0,0,3,0,2,2,3,0,0,0,0
S01011793,All people aged 16 to 74,518,51,10,41,115,79,46,48,73,57,11,7,4,38
S01011793,Very good health,234,30,5,25,52,41,17,21,24,20,2,1,1,27
S01011793,Good health,175,14,4,10,45,25,22,15,27,17,4,2,2,6
S01011793,Fair health,69,4,1,3,12,9,5,7,16,11,1,0,1,4
S01011793,Bad health,35,3,0,3,6,3,2,4,4,8,4,4,0,1
S01011793,Very bad health,5,0,0,0,0,1,0,1,2,1,0,0,0,0
S01011794,All people aged 16 to 74,669,16,5,11,104,107,56,60,115,130,36,20,16,45
S01011794,Very good health,232,8,3,5,50,40,15,17,31,33,7,4,3,31
S01011794,Good health,251,7,2,5,37,43,27,18,45,50,15,5,10,9
S01011794,Fair health,125,1,0,1,11,15,6,16,27,32,12,10,2,5
S01011794,Bad health,52,0,0,0,6,9,6,7,10,12,2,1,1,0
S01011794,Very bad health,9,0,0,0,0,0,2,2,2,3,0,0,0,0
S01011795,All people aged 16 to 74,477,15,3,12,76,61,32,57,102,94,26,13,13,14
S01011795,Very good health,165,7,2,5,26,24,10,23,36,21,7,4,3,11
S01011795,Good health,165,7,1,6,32,25,12,15,29,36,8,4,4,1
S01011795,Fair health,105,0,0,0,11,7,9,11,26,29,10,4,6,2
S01011795,Bad health,35,1,0,1,7,4,1,6,9,6,1,1,0,0
S01011795,Very bad health,7,0,0,0,0,1,0,2,2,2,0,0,0,0
S01011796,All people aged 16 to 74,554,18,2,16,80,69,32,55,105,108,44,19,25,43
S01011796,Very good health,227,12,1,11,37,26,10,27,39,32,17,8,9,27
S01011796,Good health,192,4,0,4,25,29,14,15,38,42,11,4,7,14
S01011796,Fair health,82,2,1,1,8,7,8,8,17,20,10,4,6,2
S01011796,Bad health,48,0,0,0,9,6,0,5,9,13,6,3,3,0
S01011796,Very bad health,5,0,0,0,1,1,0,0,2,1,0,0,0,0
S01011797,All people aged 16 to 74,801,80,24,56,207,135,75,56,94,71,13,8,5,70
S01011797,Very good health,418,41,8,33,106,64,34,28,49,35,3,2,1,58
S01011797,Good health,300,33,14,19,84,52,35,21,36,24,5,3,2,10
S01011797,Fair health,65,4,1,3,16,14,6,7,8,7,3,1,2,0
S01011797,Bad health,18,2,1,1,1,5,0,0,1,5,2,2,0,2
S01011797,Very bad health,0,0,0,0,0,0,0,0,0,0,0,0,0,0
S01011798,All people aged 16 to 74,411,14,1,13,67,45,36,43,83,71,29,18,11,23
S01011798,Very good health,172,9,1,8,33,14,9,20,34,30,8,4,4,15
S01011798,Good health,120,5,0,5,22,17,13,12,18,16,10,6,4,7
S01011798,Fair health,67,0,0,0,6,9,7,6,15,15,8,5,3,1
S01011798,Bad health,35,0,0,0,4,1,5,5,12,6,2,2,0,0
S01011798,Very bad health,17,0,0,0,2,4,2,0,4,4,1,1,0,0
S01011799,All people aged 16 to 74,704,50,13,37,157,99,48,73,111,98,24,18,6,44
S01011799,Very good health,348,26,5,21,88,48,22,27,54,42,9,6,3,32
S01011799,Good health,240,18,6,12,52,35,18,29,38,32,7,5,2,11
S01011799,Fair health,85,5,2,3,10,11,8,13,15,16,6,5,1,1
S01011799,Bad health,27,1,0,1,6,5,0,4,4,7,0,0,0,0
S01011799,Very bad health,4,0,0,0,1,0,0,0,0,1,2,2,0,0
S01011800,All people aged 16 to 74,378,11,2,9,47,57,28,47,76,84,13,7,6,15
S01011800,Very good health,148,6,0,6,19,23,12,16,21,33,4,2,2,14
S01011800,Good health,159,4,1,3,21,27,13,23,37,27,6,3,3,1
S01011800,Fair health,48,1,1,0,4,4,1,5,12,21,0,0,0,0
S01011800,Bad health,19,0,0,0,2,2,2,3,4,3,3,2,1,0
S01011800,Very bad health,4,0,0,0,1,1,0,0,2,0,0,0,0,0
S01011801,All people aged 16 to 74,440,13,6,7,63,58,21,34,96,80,38,23,15,37
S01011801,Very good health,190,7,2,5,29,27,10,13,32,22,22,12,10,28
S01011801,Good health,153,5,4,1,25,19,8,15,37,27,9,7,2,8
S01011801,Fair health,60,0,0,0,3,8,2,4,14,22,6,3,3,1
S01011801,Bad health,33,1,0,1,5,2,1,2,13,8,1,1,0,0
S01011801,Very bad health,4,0,0,0,1,2,0,0,0,1,0,0,0,0
S01011802,All people aged 16 to 74,494,17,9,8,73,67,39,56,102,86,26,9,17,28
S01011802,Very good health,221,11,6,5,43,37,18,20,42,26,7,1,6,17
S01011802,Good health,177,4,2,2,21,17,15,25,41,31,14,6,8,9
S01011802,Fair health,63,1,0,1,7,4,4,8,13,19,5,2,3,2
S01011802,Bad health,28,1,1,0,2,7,2,3,6,7,0,0,0,0
S01011802,Very bad health,5,0,0,0,0,2,0,0,0,3,0,0,0,0
S01011803,All people aged 16 to 74,435,22,8,14,54,53,43,52,92,71,23,11,12,25
S01011803,Very good health,168,14,5,9,23,19,12,20,28,23,10,7,3,19
S01011803,Good health,145,6,2,4,21,19,12,17,38,24,2,1,1,6
S01011803,Fair health,87,1,1,0,9,9,13,13,20,17,5,1,4,0
S01011803,Bad health,20,0,0,0,0,5,3,1,4,3,4,0,4,0
S01011803,Very bad health,15,1,0,1,1,1,3,1,2,4,2,2,0,0
S01011804,All people aged 16 to 74,547,30,6,24,112,46,58,57,103,105,17,10,7,19
S01011804,Very good health,261,18,3,15,62,27,31,24,43,39,6,3,3,11
S01011804,Good health,222,11,3,8,41,14,20,27,52,48,7,4,3,2
S01011804,Fair health,39,0,0,0,5,1,4,4,5,11,3,2,1,6
S01011804,Bad health,18,1,0,1,3,3,1,2,3,4,1,1,0,0
S01011804,Very bad health,7,0,0,0,1,1,2,0,0,3,0,0,0,0
S01011805,All people aged 16 to 74,418,31,1,30,90,33,54,46,74,53,6,4,2,31
S01011805,Very good health,237,23,1,22,56,18,25,20,41,28,2,2,0,24
S01011805,Good health,150,8,0,8,28,10,23,24,29,21,1,1,0,6
S01011805,Fair health,24,0,0,0,5,4,5,1,3,2,3,1,2,1
S01011805,Bad health,6,0,0,0,1,1,1,1,1,1,0,0,0,0
S01011805,Very bad health,1,0,0,0,0,0,0,0,0,1,0,0,0,0
S01011806,All people aged 16 to 74,560,40,11,29,125,47,75,66,100,73,13,6,7,21
S01011806,Very good health,284,25,8,17,72,27,35,30,46,30,4,2,2,15
S01011806,Good health,208,13,1,12,45,15,28,26,45,28,2,2,0,6
S01011806,Fair health,46,1,1,0,6,2,8,5,7,11,6,1,5,0
S01011806,Bad health,15,1,1,0,2,0,3,3,2,3,1,1,0,0
S01011806,Very bad health,7,0,0,0,0,3,1,2,0,1,0,0,0,0
S01011807,All people aged 16 to 74,831,63,13,50,183,65,199,63,133,74,11,10,1,40
S01011807,Very good health,471,45,11,34,114,38,108,36,61,37,2,2,0,30
S01011807,Good health,260,14,2,12,57,18,64,21,47,27,4,3,1,8
S01011807,Fair health,84,4,0,4,11,7,25,3,22,6,4,4,0,2
S01011807,Bad health,13,0,0,0,1,1,1,3,3,3,1,1,0,0
S01011807,Very bad health,3,0,0,0,0,1,1,0,0,1,0,0,0,0
S01011808,All people aged 16 to 74,455,28,8,20,101,39,44,43,97,61,13,7,6,29
S01011808,Very good health,262,17,5,12,62,23,20,24,51,33,6,2,4,26
S01011808,Good health,137,7,1,6,30,11,17,13,32,20,4,2,2,3
S01011808,Fair health,43,3,2,1,8,4,4,4,14,6,0,0,0,0
S01011808,Bad health,11,1,0,1,1,1,2,1,0,2,3,3,0,0
S01011808,Very bad health,2,0,0,0,0,0,1,1,0,0,0,0,0,0
S01011809,All people aged 16 to 74,556,53,13,40,105,69,108,43,88,61,10,7,3,19
S01011809,Very good health,319,37,9,28,66,45,54,26,43,30,3,2,1,15
S01011809,Good health,177,12,4,8,32,19,39,12,32,23,4,3,1,4
S01011809,Fair health,43,4,0,4,4,3,13,4,8,5,2,2,0,0
S01011809,Bad health,13,0,0,0,3,1,2,1,3,2,1,0,1,0
S01011809,Very bad health,4,0,0,0,0,1,0,0,2,1,0,0,0,0
S01011810,All people aged 16 to 74,709,47,11,36,138,72,134,74,114,97,15,9,6,18
S01011810,Very good health,349,31,9,22,72,38,54,41,54,45,3,2,1,11
S01011810,Good health,254,10,2,8,55,18,50,27,40,40,8,4,4,6
S01011810,Fair health,83,4,0,4,9,12,26,4,14,10,4,3,1,0
S01011810,Bad health,17,2,0,2,1,2,2,2,6,2,0,0,0,0
S01011810,Very bad health,6,0,0,0,1,2,2,0,0,0,0,0,0,1
S01011811,All people aged 16 to 74,776,48,12,36,163,62,180,72,127,83,12,8,4,29
S01011811,Very good health,404,28,7,21,100,34,76,40,60,45,5,2,3,16
S01011811,Good health,272,16,4,12,46,20,71,27,52,25,5,4,1,10
S01011811,Fair health,79,3,1,2,13,7,27,2,13,9,2,2,0,3
S01011811,Bad health,17,1,0,1,2,0,5,3,2,4,0,0,0,0
S01011811,Very bad health,4,0,0,0,2,1,1,0,0,0,0,0,0,0
S01011812,All people aged 16 to 74,491,52,7,45,124,40,104,37,65,35,10,6,4,24
S01011812,Very good health,272,32,3,29,69,27,47,23,31,18,4,1,3,21
S01011812,Good health,152,14,3,11,41,8,42,10,24,10,1,1,0,2
S01011812,Fair health,52,3,0,3,11,3,15,4,6,6,3,3,0,1
S01011812,Bad health,10,1,1,0,2,2,0,0,3,1,1,0,1,0
S01011812,Very bad health,5,2,0,2,1,0,0,0,1,0,1,1,0,0
S01011813,All people aged 16 to 74,572,34,8,26,103,57,106,57,109,68,11,8,3,27
S01011813,Very good health,329,23,7,16,69,37,42,31,58,43,6,3,3,20
S01011813,Good health,192,9,1,8,25,15,55,18,39,21,3,3,0,7
S01011813,Fair health,40,1,0,1,8,4,8,7,9,2,1,1,0,0
S01011813,Bad health,7,1,0,1,1,0,0,0,3,2,0,0,0,0
S01011813,Very bad health,4,0,0,0,0,1,1,1,0,0,1,1,0,0
S01011814,All people aged 16 to 74,517,35,8,27,117,49,106,27,90,64,6,2,4,23
S01011814,Very good health,286,22,6,16,72,28,48,15,46,32,2,1,1,21
S01011814,Good health,183,10,2,8,37,16,50,10,35,22,2,1,1,1
S01011814,Fair health,38,2,0,2,6,4,6,2,8,8,2,0,2,0
S01011814,Bad health,8,0,0,0,2,1,1,0,1,2,0,0,0,1
S01011814,Very bad health,2,1,0,1,0,0,1,0,0,0,0,0,0,0
S01011815,All people aged 16 to 74,579,30,6,24,137,62,82,46,104,76,9,5,4,33
S01011815,Very good health,344,14,3,11,98,38,36,28,52,45,5,2,3,28
S01011815,Good health,180,13,1,12,36,17,31,15,40,22,3,2,1,3
S01011815,Fair health,46,3,2,1,3,7,12,3,10,5,1,1,0,2
S01011815,Bad health,9,0,0,0,0,0,3,0,2,4,0,0,0,0
S01011815,Very bad health,0,0,0,0,0,0,0,0,0,0,0,0,0,0
S01011816,All people aged 16 to 74,476,44,17,27,139,66,60,39,69,34,3,2,1,22
S01011816,Very good health,282,34,12,22,78,41,31,25,38,16,2,1,1,17
S01011816,Good health,159,9,4,5,54,21,25,11,21,13,0,0,0,5
S01011816,Fair health,30,1,1,0,7,4,3,3,7,5,0,0,0,0
S01011816,Bad health,5,0,0,0,0,0,1,0,3,0,1,1,0,0
S01011816,Very bad health,0,0,0,0,0,0,0,0,0,0,0,0,0,0
S01011817,All people aged 16 to 74,550,38,13,25,128,41,93,66,87,59,6,2,4,32
S01011817,Very good health,332,24,9,15,80,27,50,37,50,36,3,1,2,25
S01011817,Good health,170,11,4,7,38,10,35,22,32,15,3,1,2,4
S01011817,Fair health,36,2,0,2,8,3,7,4,5,5,0,0,0,2
S01011817,Bad health,9,1,0,1,1,1,1,3,0,1,0,0,0,1
S01011817,Very bad health,3,0,0,0,1,0,0,0,0,2,0,0,0,0
S01011818,All people aged 16 to 74,800,44,12,32,170,101,72,82,158,119,14,10,4,40
S01011818,Very good health,433,28,5,23,101,52,32,44,81,54,6,4,2,35
S01011818,Good health,285,14,6,8,55,38,29,31,61,46,7,6,1,4
S01011818,Fair health,66,2,1,1,13,8,8,4,15,14,1,0,1,1
S01011818,Bad health,14,0,0,0,1,3,2,2,1,5,0,0,0,0
S01011818,Very bad health,2,0,0,0,0,0,1,1,0,0,0,0,0,0
S01011819,All people aged 16 to 74,665,23,5,18,94,80,56,87,140,156,11,8,3,18
S01011819,Very good health,311,10,1,9,52,47,23,34,48,77,4,4,0,16
S01011819,Good health,275,10,2,8,33,31,24,42,73,55,5,4,1,2
S01011819,Fair health,68,3,2,1,7,2,6,10,18,20,2,0,2,0
S01011819,Bad health,10,0,0,0,2,0,3,1,0,4,0,0,0,0
S01011819,Very bad health,1,0,0,0,0,0,0,0,1,0,0,0,0,0
S01011820,All people aged 16 to 74,518,35,4,31,107,62,49,54,78,70,23,17,6,40
S01011820,Very good health,276,20,3,17,60,36,30,21,40,30,6,4,2,33
S01011820,Good health,160,11,1,10,35,18,15,20,22,27,5,3,2,7
S01011820,Fair health,52,3,0,3,8,5,3,8,9,10,6,5,1,0
S01011820,Bad health,20,1,0,1,2,1,1,4,5,3,3,2,1,0
S01011820,Very bad health,10,0,0,0,2,2,0,1,2,0,3,3,0,0
S01011821,All people aged 16 to 74,335,9,2,7,56,30,23,29,75,65,25,13,12,23
S01011821,Very good health,172,5,1,4,40,17,14,16,35,22,6,0,6,17
S01011821,Good health,103,4,1,3,12,9,3,8,24,26,11,6,5,6
S01011821,Fair health,37,0,0,0,1,3,6,4,10,10,3,2,1,0
S01011821,Bad health,20,0,0,0,3,1,0,0,5,7,4,4,0,0
S01011821,Very bad health,3,0,0,0,0,0,0,1,1,0,1,1,0,0
S01011822,All people aged 16 to 74,544,26,6,20,89,46,58,89,113,93,15,11,4,15
S01011822,Very good health,245,13,2,11,43,23,22,35,52,40,7,6,1,10
S01011822,Good health,222,10,4,6,36,16,27,45,43,35,5,3,2,5
S01011822,Fair health,54,3,0,3,5,1,7,5,17,14,2,1,1,0
S01011822,Bad health,19,0,0,0,5,6,1,2,1,4,0,0,0,0
S01011822,Very bad health,4,0,0,0,0,0,1,2,0,0,1,1,0,0
S01011823,All people aged 16 to 74,456,18,6,12,85,51,42,46,103,81,10,8,2,20
S01011823,Very good health,238,9,1,8,55,30,22,22,48,34,2,1,1,16
S01011823,Good health,159,6,2,4,24,18,16,20,36,31,4,3,1,4
S01011823,Fair health,47,2,2,0,5,3,4,2,19,9,3,3,0,0
S01011823,Bad health,11,1,1,0,1,0,0,2,0,6,1,1,0,0
S01011823,Very bad health,1,0,0,0,0,0,0,0,0,1,0,0,0,0
S01011824,All people aged 16 to 74,520,11,2,9,88,57,39,61,118,113,16,9,7,17
S01011824,Very good health,233,9,2,7,45,22,15,32,44,51,5,4,1,10
S01011824,Good health,214,2,0,2,37,28,20,18,50,44,8,2,6,7
S01011824,Fair health,59,0,0,0,6,5,4,11,18,12,3,3,0,0
S01011824,Bad health,10,0,0,0,0,2,0,0,5,3,0,0,0,0
S01011824,Very bad health,4,0,0,0,0,0,0,0,1,3,0,0,0,0
S01011825,All people aged 16 to 74,409,22,4,18,95,39,37,44,84,56,11,10,1,21
S01011825,Very good health,218,19,4,15,55,24,21,23,36,18,3,3,0,19
S01011825,Good health,145,2,0,2,34,10,16,17,34,26,5,4,1,1
S01011825,Fair health,41,1,0,1,6,4,0,4,12,11,2,2,0,1
S01011825,Bad health,4,0,0,0,0,1,0,0,1,1,1,1,0,0
S01011825,Very bad health,1,0,0,0,0,0,0,0,1,0,0,0,0,0
S01011826,All people aged 16 to 74,495,36,10,26,94,54,47,53,100,79,8,5,3,24
S01011826,Very good health,267,25,8,17,62,23,20,28,45,38,4,2,2,22
S01011826,Good health,180,10,2,8,31,24,19,21,42,29,2,1,1,2
S01011826,Fair health,38,0,0,0,1,3,8,3,11,11,1,1,0,0
S01011826,Bad health,7,0,0,0,0,4,0,0,2,0,1,1,0,0
S01011826,Very bad health,3,1,0,1,0,0,0,1,0,1,0,0,0,0
S01011827,All people aged 16 to 74,417,18,4,14,85,24,84,46,83,53,18,10,8,6
S01011827,Very good health,134,6,1,5,27,12,24,15,24,16,5,1,4,5
S01011827,Good health,169,5,0,5,34,9,44,18,39,15,4,1,3,1
S01011827,Fair health,70,5,2,3,12,2,12,8,11,13,7,6,1,0
S01011827,Bad health,27,2,1,1,6,1,1,2,6,7,2,2,0,0
S01011827,Very bad health,17,0,0,0,6,0,3,3,3,2,0,0,0,0
S01011828,All people aged 16 to 74,692,45,9,36,124,69,165,57,124,70,10,5,5,28
S01011828,Very good health,329,27,7,20,63,36,67,28,58,28,4,1,3,18
S01011828,Good health,275,14,2,12,47,27,69,22,52,29,5,3,2,10
S01011828,Fair health,64,3,0,3,10,4,24,4,11,7,1,1,0,0
S01011828,Bad health,14,1,0,1,3,1,3,2,1,3,0,0,0,0
S01011828,Very bad health,10,0,0,0,1,1,2,1,2,3,0,0,0,0
S01011829,All people aged 16 to 74,321,23,6,17,68,35,56,33,52,39,4,2,2,11
S01011829,Very good health,177,16,3,13,42,16,25,20,31,16,0,0,0,11
S01011829,Good health,105,5,2,3,17,13,24,9,17,17,3,1,2,0
S01011829,Fair health,26,1,1,0,6,5,4,2,3,4,1,1,0,0
S01011829,Bad health,11,1,0,1,3,1,3,1,1,1,0,0,0,0
S01011829,Very bad health,2,0,0,0,0,0,0,1,0,1,0,0,0,0
S01011830,All people aged 16 to 74,439,22,6,16,76,34,140,32,70,42,14,9,5,9
S01011830,Very good health,170,11,2,9,27,13,55,16,24,18,1,1,0,5
S01011830,Good health,193,6,2,4,37,15,57,13,39,14,8,5,3,4
S01011830,Fair health,64,4,1,3,11,4,25,2,7,8,3,1,2,0
S01011830,Bad health,7,0,0,0,0,1,2,1,0,1,2,2,0,0
S01011830,Very bad health,5,1,1,0,1,1,1,0,0,1,0,0,0,0
S01011831,All people aged 16 to 74,666,47,7,40,100,44,204,36,139,41,27,17,10,28
S01011831,Very good health,274,19,1,18,35,21,76,14,70,13,9,7,2,17
S01011831,Good health,267,21,3,18,35,19,85,18,46,19,14,10,4,10
S01011831,Fair health,90,5,3,2,23,1,32,2,16,6,4,0,4,1
S01011831,Bad health,25,2,0,2,5,3,7,2,4,2,0,0,0,0
S01011831,Very bad health,10,0,0,0,2,0,4,0,3,1,0,0,0,0
S01011832,All people aged 16 to 74,628,24,7,17,118,38,183,54,125,56,13,11,2,17
S01011832,Very good health,290,13,4,9,57,16,79,22,61,24,3,3,0,15
S01011832,Good health,224,8,2,6,37,16,74,24,36,22,5,5,0,2
S01011832,Fair health,71,1,0,1,9,3,24,4,18,9,3,2,1,0
S01011832,Bad health,29,1,1,0,8,3,5,3,7,1,1,0,1,0
S01011832,Very bad health,14,1,0,1,7,0,1,1,3,0,1,1,0,0
S01011833,All people aged 16 to 74,712,119,33,86,217,70,90,34,61,41,23,15,8,57
S01011833,Very good health,415,73,23,50,136,42,52,15,27,11,11,6,5,48
S01011833,Good health,200,33,6,27,67,21,24,7,23,12,7,4,3,6
S01011833,Fair health,64,10,3,7,9,4,11,8,8,9,3,3,0,2
S01011833,Bad health,25,3,1,2,5,3,2,3,2,5,1,1,0,1
S01011833,Very bad health,8,0,0,0,0,0,1,1,1,4,1,1,0,0
S01011834,All people aged 16 to 74,347,72,15,57,102,45,33,22,28,15,7,4,3,23
S01011834,Very good health,205,51,11,40,73,22,14,5,15,8,2,0,2,15
S01011834,Good health,104,17,1,16,25,19,12,12,8,5,0,0,0,6
S01011834,Fair health,32,4,3,1,3,4,6,4,4,2,4,4,0,1
S01011834,Bad health,5,0,0,0,1,0,1,1,1,0,1,0,1,0
S01011834,Very bad health,1,0,0,0,0,0,0,0,0,0,0,0,0,1
S01011835,All people aged 16 to 74,516,90,19,71,152,67,77,23,39,28,14,9,5,26
S01011835,Very good health,313,62,10,52,93,35,48,12,23,12,5,4,1,23
S01011835,Good health,158,24,7,17,50,23,23,8,10,12,5,2,3,3
S01011835,Fair health,34,2,1,1,8,4,5,2,5,4,4,3,1,0
S01011835,Bad health,7,2,1,1,0,3,1,1,0,0,0,0,0,0
S01011835,Very bad health,4,0,0,0,1,2,0,0,1,0,0,0,0,0
S01011836,All people aged 16 to 74,609,109,20,89,180,74,70,34,64,25,16,11,5,37
S01011836,Very good health,335,62,13,49,92,36,34,26,33,10,10,6,4,32
S01011836,Good health,188,32,4,28,69,29,26,4,17,3,4,3,1,4
S01011836,Fair health,67,12,3,9,14,6,10,3,9,10,2,2,0,1
S01011836,Bad health,14,2,0,2,4,2,0,1,4,1,0,0,0,0
S01011836,Very bad health,5,1,0,1,1,1,0,0,1,1,0,0,0,0
S01011837,All people aged 16 to 74,502,73,12,61,143,55,76,33,46,26,20,19,1,30
S01011837,Very good health,285,46,6,40,83,37,40,14,20,10,9,8,1,26
S01011837,Good health,150,23,5,18,43,14,30,8,18,7,5,5,0,2
S01011837,Fair health,53,3,1,2,16,4,6,8,6,7,1,1,0,2
S01011837,Bad health,11,1,0,1,0,0,0,2,1,2,5,5,0,0
S01011837,Very bad health,3,0,0,0,1,0,0,1,1,0,0,0,0,0
S01011838,All people aged 16 to 74,641,114,24,90,190,89,58,43,69,35,4,3,1,39
S01011838,Very good health,385,68,14,54,122,50,33,25,37,16,3,2,1,31
S01011838,Good health,192,39,9,30,55,28,16,14,21,11,1,1,0,7
S01011838,Fair health,50,6,1,5,10,8,8,4,7,6,0,0,0,1
S01011838,Bad health,14,1,0,1,3,3,1,0,4,2,0,0,0,0
S01011838,Very bad health,0,0,0,0,0,0,0,0,0,0,0,0,0,0
S01011839,All people aged 16 to 74,735,89,22,67,209,93,66,56,103,62,15,9,6,42
S01011839,Very good health,435,51,12,39,120,52,32,36,55,41,10,6,4,38
S01011839,Good health,236,33,9,24,72,33,27,13,34,17,3,2,1,4
S01011839,Fair health,52,4,1,3,14,6,6,5,12,3,2,1,1,0
S01011839,Bad health,10,0,0,0,2,2,1,2,2,1,0,0,0,0
S01011839,Very bad health,2,1,0,1,1,0,0,0,0,0,0,0,0,0
S01011840,All people aged 16 to 74,738,77,26,51,195,102,58,63,107,79,13,6,7,44
S01011840,Very good health,391,50,13,37,96,56,31,29,54,35,5,2,3,35
S01011840,Good health,265,16,7,9,80,38,22,26,37,33,4,2,2,9
S01011840,Fair health,63,11,6,5,16,5,3,6,12,7,3,2,1,0
S01011840,Bad health,15,0,0,0,2,2,2,2,3,3,1,0,1,0
S01011840,Very bad health,4,0,0,0,1,1,0,0,1,1,0,0,0,0
S01011841,All people aged 16 to 74,662,63,21,42,176,89,64,55,83,80,24,15,9,28
S01011841,Very good health,334,41,12,29,99,38,28,27,33,38,12,7,5,18
S01011841,Good health,211,15,6,9,56,33,22,18,29,22,8,4,4,8
S01011841,Fair health,84,3,2,1,14,15,11,5,16,15,3,3,0,2
S01011841,Bad health,23,2,1,1,6,3,2,2,4,4,0,0,0,0
S01011841,Very bad health,10,2,0,2,1,0,1,3,1,1,1,1,0,0
S01011842,All people aged 16 to 74,700,47,11,36,141,72,46,78,118,128,27,12,15,43
S01011842,Very good health,347,34,5,29,79,25,20,40,51,45,17,7,10,36
S01011842,Good health,227,10,4,6,39,36,18,26,33,54,5,3,2,6
S01011842,Fair health,101,3,2,1,19,10,6,9,27,23,3,0,3,1
S01011842,Bad health,21,0,0,0,4,1,2,2,5,5,2,2,0,0
S01011842,Very bad health,4,0,0,0,0,0,0,1,2,1,0,0,0,0
S01011843,All people aged 16 to 74,754,116,28,88,211,75,149,39,67,42,14,10,4,41
S01011843,Very good health,417,78,22,56,118,34,79,17,32,20,7,4,3,32
S01011843,Good health,249,30,5,25,75,27,51,14,24,19,3,2,1,6
S01011843,Fair health,69,8,1,7,12,10,16,7,8,2,3,3,0,3
S01011843,Bad health,15,0,0,0,4,4,3,0,2,1,1,1,0,0
S01011843,Very bad health,4,0,0,0,2,0,0,1,1,0,0,0,0,0
S01011844,All people aged 16 to 74,512,121,20,101,155,47,59,18,37,29,5,4,1,41
S01011844,Very good health,318,78,12,66,102,23,35,12,18,14,1,1,0,35
S01011844,Good health,149,37,5,32,44,18,16,4,16,8,1,1,0,5
S01011844,Fair health,37,5,2,3,6,6,5,2,3,6,3,2,1,1
S01011844,Bad health,6,1,1,0,3,0,1,0,0,1,0,0,0,0
S01011844,Very bad health,2,0,0,0,0,0,2,0,0,0,0,0,0,0
S01011845,All people aged 16 to 74,614,52,20,32,156,84,62,50,93,68,10,6,4,39
S01011845,Very good health,295,34,12,22,76,37,28,24,39,26,5,2,3,26
S01011845,Good health,235,16,7,9,62,36,25,19,34,29,3,2,1,11
S01011845,Fair health,65,2,1,1,13,9,6,5,17,10,1,1,0,2
S01011845,Bad health,13,0,0,0,4,2,2,1,2,2,0,0,0,0
S01011845,Very bad health,6,0,0,0,1,0,1,1,1,1,1,1,0,0
S01011846,All people aged 16 to 74,648,108,29,79,177,70,74,33,66,63,11,8,3,46
S01011846,Very good health,354,66,17,49,104,40,32,13,33,27,2,2,0,37
S01011846,Good health,198,33,8,25,47,20,27,16,21,22,5,3,2,7
S01011846,Fair health,73,7,4,3,22,8,10,3,8,9,4,3,1,2
S01011846,Bad health,22,2,0,2,4,2,5,0,4,5,0,0,0,0
S01011846,Very bad health,1,0,0,0,0,0,0,1,0,0,0,0,0,0
S01011847,All people aged 16 to 74,327,57,16,41,120,34,47,14,28,13,2,2,0,12
S01011847,Very good health,186,40,14,26,75,13,19,8,14,8,0,0,0,9
S01011847,Good health,110,13,1,12,38,17,21,6,8,4,0,0,0,3
S01011847,Fair health,23,4,1,3,5,3,5,0,3,1,2,2,0,0
S01011847,Bad health,7,0,0,0,2,1,2,0,2,0,0,0,0,0
S01011847,Very bad health,1,0,0,0,0,0,0,0,1,0,0,0,0,0
S01011848,All people aged 16 to 74,532,77,7,70,133,61,85,27,75,38,2,1,1,34
S01011848,Very good health,308,47,5,42,88,33,49,11,32,16,1,1,0,31
S01011848,Good health,163,23,2,21,37,20,28,10,29,14,0,0,0,2
S01011848,Fair health,45,7,0,7,5,4,6,4,12,6,1,0,1,0
S01011848,Bad health,13,0,0,0,3,3,2,2,0,2,0,0,0,1
S01011848,Very bad health,3,0,0,0,0,1,0,0,2,0,0,0,0,0
S01011849,All people aged 16 to 74,597,77,20,57,135,62,61,66,107,53,12,6,6,24
S01011849,Very good health,341,51,11,40,83,35,36,36,56,22,2,2,0,20
S01011849,Good health,192,23,9,14,40,22,20,21,40,18,4,0,4,4
S01011849,Fair health,50,3,0,3,7,4,4,8,10,9,5,3,2,0
S01011849,Bad health,10,0,0,0,4,0,0,1,0,4,1,1,0,0
S01011849,Very bad health,4,0,0,0,1,1,1,0,1,0,0,0,0,0
S01011850,All people aged 16 to 74,524,67,24,43,143,59,94,35,60,35,6,3,3,25
S01011850,Very good health,325,39,15,24,104,40,56,20,28,16,3,2,1,19
S01011850,Good health,165,24,8,16,31,16,32,11,26,17,2,0,2,6
S01011850,Fair health,30,4,1,3,8,2,6,3,5,1,1,1,0,0
S01011850,Bad health,3,0,0,0,0,0,0,1,1,1,0,0,0,0
S01011850,Very bad health,1,0,0,0,0,1,0,0,0,0,0,0,0,0
S01011851,All people aged 16 to 74,639,54,7,47,143,49,87,63,105,82,23,8,15,33
S01011851,Very good health,355,32,4,28,96,25,51,34,53,31,6,3,3,27
S01011851,Good health,192,15,3,12,32,16,27,23,26,38,10,4,6,5
S01011851,Fair health,70,5,0,5,12,8,9,3,15,12,5,0,5,1
S01011851,Bad health,16,0,0,0,2,0,0,1,10,1,2,1,1,0
S01011851,Very bad health,6,2,0,2,1,0,0,2,1,0,0,0,0,0
S01011852,All people aged 16 to 74,702,52,11,41,136,82,86,80,96,109,23,15,8,38
S01011852,Very good health,373,36,5,31,75,46,44,45,41,53,6,5,1,27
S01011852,Good health,243,14,6,8,44,28,28,29,39,42,12,6,6,7
S01011852,Fair health,73,1,0,1,14,7,13,4,16,11,4,3,1,3
S01011852,Bad health,11,1,0,1,2,1,1,2,0,2,1,1,0,1
S01011852,Very bad health,2,0,0,0,1,0,0,0,0,1,0,0,0,0
S01011853,All people aged 16 to 74,525,63,13,50,126,56,62,56,70,57,13,7,6,22
S01011853,Very good health,296,35,6,29,84,24,28,33,42,27,4,3,1,19
S01011853,Good health,177,23,6,17,31,28,28,18,23,20,4,0,4,2
S01011853,Fair health,37,5,1,4,8,3,3,3,5,6,3,2,1,1
S01011853,Bad health,9,0,0,0,1,1,2,2,0,1,2,2,0,0
S01011853,Very bad health,6,0,0,0,2,0,1,0,0,3,0,0,0,0
S01011854,All people aged 16 to 74,564,53,10,43,134,63,62,60,86,59,10,5,5,37
S01011854,Very good health,304,31,6,25,75,34,33,33,46,18,6,2,4,28
S01011854,Good health,192,19,3,16,50,18,22,18,24,32,3,2,1,6
S01011854,Fair health,54,2,1,1,6,10,4,7,14,7,1,1,0,3
S01011854,Bad health,8,1,0,1,2,1,1,2,0,1,0,0,0,0
S01011854,Very bad health,6,0,0,0,1,0,2,0,2,1,0,0,0,0
S01011855,All people aged 16 to 74,615,31,5,26,84,60,57,78,115,140,19,10,9,31
S01011855,Very good health,322,19,3,16,53,36,33,37,52,59,6,4,2,27
S01011855,Good health,199,10,1,9,23,17,15,27,49,47,7,2,5,4
S01011855,Fair health,59,2,1,1,6,6,2,11,9,21,2,1,1,0
S01011855,Bad health,22,0,0,0,1,1,4,2,4,7,3,2,1,0
S01011855,Very bad health,13,0,0,0,1,0,3,1,1,6,1,1,0,0
S01011856,All people aged 16 to 74,494,85,25,60,154,49,78,23,42,20,9,5,4,34
S01011856,Very good health,275,41,15,26,97,28,35,11,19,12,3,1,2,29
S01011856,Good health,169,32,7,25,48,15,36,9,15,6,3,2,1,5
S01011856,Fair health,35,9,3,6,5,3,7,1,7,0,3,2,1,0
S01011856,Bad health,12,3,0,3,4,2,0,1,1,1,0,0,0,0
S01011856,Very bad health,3,0,0,0,0,1,0,1,0,1,0,0,0,0
S01011857,All people aged 16 to 74,494,45,13,32,127,49,86,40,71,37,14,9,5,25
S01011857,Very good health,270,26,4,22,81,27,40,24,32,18,4,2,2,18
S01011857,Good health,161,13,7,6,31,19,40,9,28,12,4,2,2,5
S01011857,Fair health,40,5,2,3,10,2,4,4,5,4,4,3,1,2
S01011857,Bad health,19,1,0,1,4,1,2,2,6,2,1,1,0,0
S01011857,Very bad health,4,0,0,0,1,0,0,1,0,1,1,1,0,0
S01011858,All people aged 16 to 74,564,80,19,61,154,60,75,30,72,38,16,12,4,39
S01011858,Very good health,302,41,9,32,85,24,38,16,35,21,5,3,2,37
S01011858,Good health,190,36,10,26,49,24,25,10,28,13,3,1,2,2
S01011858,Fair health,53,3,0,3,15,8,10,2,7,3,5,5,0,0
S01011858,Bad health,16,0,0,0,4,4,2,1,2,0,3,3,0,0
S01011858,Very bad health,3,0,0,0,1,0,0,1,0,1,0,0,0,0
S01011859,All people aged 16 to 74,586,51,12,39,131,60,82,54,108,57,14,11,3,29
S01011859,Very good health,273,25,2,23,58,31,38,21,39,30,8,7,1,23
S01011859,Good health,209,16,7,9,58,19,27,17,48,19,0,0,0,5
S01011859,Fair health,72,7,2,5,12,8,12,11,9,7,6,4,2,0
S01011859,Bad health,17,0,0,0,2,2,3,2,6,1,0,0,0,1
S01011859,Very bad health,15,3,1,2,1,0,2,3,6,0,0,0,0,0
S01011860,All people aged 16 to 74,484,39,8,31,104,38,69,61,71,59,13,9,4,30
S01011860,Very good health,265,26,4,22,61,21,30,33,33,33,5,4,1,23
S01011860,Good health,166,11,3,8,29,13,29,20,31,22,5,2,3,6
S01011860,Fair health,36,1,1,0,10,1,6,6,5,4,3,3,0,0
S01011860,Bad health,14,0,0,0,4,3,3,2,2,0,0,0,0,0
S01011860,Very bad health,3,1,0,1,0,0,1,0,0,0,0,0,0,1
S01011861,All people aged 16 to 74,565,60,15,45,143,41,123,44,61,53,15,8,7,25
S01011861,Very good health,295,30,8,22,72,18,59,24,31,32,6,3,3,23
S01011861,Good health,202,24,6,18,54,17,50,16,20,12,7,3,4,2
S01011861,Fair health,56,4,1,3,16,5,12,3,7,7,2,2,0,0
S01011861,Bad health,8,0,0,0,1,1,1,1,3,1,0,0,0,0
S01011861,Very bad health,4,2,0,2,0,0,1,0,0,1,0,0,0,0
S01011862,All people aged 16 to 74,699,92,23,69,222,76,62,59,98,34,11,4,7,45
S01011862,Very good health,388,55,15,40,113,43,32,33,49,18,6,1,5,39
S01011862,Good health,223,32,6,26,74,23,21,13,37,13,4,2,2,6
S01011862,Fair health,63,4,1,3,28,6,7,9,8,1,0,0,0,0
S01011862,Bad health,20,1,1,0,6,2,1,4,3,2,1,1,0,0
S01011862,Very bad health,5,0,0,0,1,2,1,0,1,0,0,0,0,0
S01011863,All people aged 16 to 74,552,103,23,80,145,48,49,40,53,49,26,20,6,39
S01011863,Very good health,329,69,18,51,91,27,25,23,23,26,10,7,3,35
S01011863,Good health,147,27,4,23,36,13,12,16,21,14,5,2,3,3
S01011863,Fair health,59,5,0,5,16,8,8,0,7,6,8,8,0,1
S01011863,Bad health,16,2,1,1,2,0,4,1,2,3,2,2,0,0
S01011863,Very bad health,1,0,0,0,0,0,0,0,0,0,1,1,0,0
S01011864,All people aged 16 to 74,521,65,18,47,154,63,61,34,69,38,5,4,1,32
S01011864,Very good health,286,38,8,30,94,35,30,14,36,18,0,0,0,21
S01011864,Good health,191,22,8,14,49,21,25,18,26,17,3,2,1,10
S01011864,Fair health,28,3,0,3,5,4,5,1,5,3,2,2,0,0
S01011864,Bad health,12,2,2,0,4,3,0,1,1,0,0,0,0,1
S01011864,Very bad health,4,0,0,0,2,0,1,0,1,0,0,0,0,0
S01011865,All people aged 16 to 74,431,35,10,25,94,58,41,52,59,58,12,6,6,22
S01011865,Very good health,208,17,7,10,53,27,19,26,23,19,3,1,2,21
S01011865,Good health,149,16,3,13,28,20,18,20,22,19,5,1,4,1
S01011865,Fair health,56,2,0,2,8,10,3,4,11,15,3,3,0,0
S01011865,Bad health,14,0,0,0,5,0,1,2,2,4,0,0,0,0
S01011865,Very bad health,4,0,0,0,0,1,0,0,1,1,1,1,0,0
S01011866,All people aged 16 to 74,563,41,7,34,119,69,69,60,87,76,16,8,8,26
S01011866,Very good health,279,25,5,20,61,37,31,31,38,30,6,2,4,20
S01011866,Good health,203,14,2,12,38,19,33,18,37,29,10,6,4,5
S01011866,Fair health,54,1,0,1,11,5,4,7,11,14,0,0,0,1
S01011866,Bad health,22,1,0,1,6,6,1,4,1,3,0,0,0,0
S01011866,Very bad health,5,0,0,0,3,2,0,0,0,0,0,0,0,0
S01011867,All people aged 16 to 74,666,28,5,23,114,58,59,82,139,132,15,10,5,39
S01011867,Very good health,294,17,2,15,67,25,20,41,53,43,5,2,3,23
S01011867,Good health,227,8,2,6,38,18,23,30,45,49,2,2,0,14
S01011867,Fair health,102,2,1,1,9,10,10,6,26,32,5,3,2,2
S01011867,Bad health,30,1,0,1,0,5,1,4,10,6,3,3,0,0
S01011867,Very bad health,13,0,0,0,0,0,5,1,5,2,0,0,0,0
S01011868,All people aged 16 to 74,610,49,8,41,140,62,71,62,107,61,19,10,9,39
S01011868,Very good health,333,27,4,23,79,34,36,32,59,28,6,2,4,32
S01011868,Good health,196,17,1,16,48,23,23,21,31,21,6,3,3,6
S01011868,Fair health,59,5,3,2,10,3,8,6,16,7,3,1,2,1
S01011868,Bad health,17,0,0,0,3,1,4,2,1,4,2,2,0,0
S01011868,Very bad health,5,0,0,0,0,1,0,1,0,1,2,2,0,0
S01011869,All people aged 16 to 74,601,55,7,48,125,57,77,70,96,72,16,10,6,33
S01011869,Very good health,306,35,4,31,72,21,34,29,50,34,4,3,1,27
S01011869,Good health,200,14,2,12,41,23,25,32,30,26,4,2,2,5
S01011869,Fair health,67,5,1,4,6,8,13,6,10,10,8,5,3,1
S01011869,Bad health,16,0,0,0,4,4,1,1,4,2,0,0,0,0
S01011869,Very bad health,12,1,0,1,2,1,4,2,2,0,0,0,0,0
S01011870,All people aged 16 to 74,508,32,7,25,87,47,40,62,105,77,19,16,3,39
S01011870,Very good health,231,17,5,12,44,21,16,27,44,24,7,6,1,31
S01011870,Good health,183,14,2,12,23,16,18,21,40,37,6,4,2,8
S01011870,Fair health,57,1,0,1,13,8,2,9,13,8,3,3,0,0
S01011870,Bad health,28,0,0,0,6,2,3,2,6,7,2,2,0,0
S01011870,Very bad health,9,0,0,0,1,0,1,3,2,1,1,1,0,0
S01011871,All people aged 16 to 74,799,88,21,67,192,72,137,71,98,65,25,16,9,51
S01011871,Very good health,450,54,10,44,116,42,70,27,60,37,6,4,2,38
S01011871,Good health,242,20,6,14,60,15,49,31,27,16,13,7,6,11
S01011871,Fair health,80,11,3,8,10,13,16,9,9,7,3,2,1,2
S01011871,Bad health,18,2,1,1,4,1,2,3,2,4,0,0,0,0
S01011871,Very bad health,9,1,1,0,2,1,0,1,0,1,3,3,0,0
S01011872,All people aged 16 to 74,674,102,19,83,177,87,124,37,64,33,10,6,4,40
S01011872,Very good health,399,70,13,57,106,45,73,20,31,19,4,2,2,31
S01011872,Good health,211,21,3,18,61,35,33,13,28,10,3,2,1,7
S01011872,Fair health,49,10,3,7,9,4,13,4,3,2,2,1,1,2
S01011872,Bad health,14,1,0,1,1,3,5,0,1,2,1,1,0,0
S01011872,Very bad health,1,0,0,0,0,0,0,0,1,0,0,0,0,0
S01011873,All people aged 16 to 74,608,76,16,60,169,96,64,45,73,44,8,8,0,33
S01011873,Very good health,341,48,6,42,108,46,31,24,29,22,7,7,0,26
S01011873,Good health,207,22,9,13,46,46,24,15,32,16,0,0,0,6
S01011873,Fair health,42,4,1,3,10,2,7,4,11,3,0,0,0,1
S01011873,Bad health,16,2,0,2,4,2,1,2,1,3,1,1,0,0
S01011873,Very bad health,2,0,0,0,1,0,1,0,0,0,0,0,0,0
S01011874,All people aged 16 to 74,496,39,10,29,127,82,60,47,69,38,8,3,5,26
S01011874,Very good health,257,24,8,16,65,39,36,22,29,21,2,1,1,19
S01011874,Good health,171,12,2,10,48,31,16,18,29,9,2,0,2,6
S01011874,Fair health,48,1,0,1,10,10,6,3,8,6,4,2,2,0
S01011874,Bad health,17,2,0,2,4,2,2,3,2,1,0,0,0,1
S01011874,Very bad health,3,0,0,0,0,0,0,1,1,1,0,0,0,0
S01011875,All people aged 16 to 74,470,39,8,31,98,78,33,39,77,77,15,12,3,14
S01011875,Very good health,246,27,2,25,58,42,15,18,33,37,5,3,2,11
S01011875,Good health,143,9,4,5,28,27,10,11,25,25,5,4,1,3
S01011875,Fair health,53,3,2,1,9,6,3,7,14,9,2,2,0,0
S01011875,Bad health,18,0,0,0,3,3,4,2,2,4,0,0,0,0
S01011875,Very bad health,10,0,0,0,0,0,1,1,3,2,3,3,0,0
S01011876,All people aged 16 to 74,698,99,24,75,196,79,103,43,86,48,9,6,3,35
S01011876,Very good health,379,62,16,46,111,45,52,22,43,13,5,3,2,26
S01011876,Good health,222,30,7,23,60,24,35,14,27,23,1,1,0,8
S01011876,Fair health,71,6,0,6,20,6,14,3,11,8,2,1,1,1
S01011876,Bad health,16,1,1,0,1,2,1,3,4,3,1,1,0,0
S01011876,Very bad health,10,0,0,0,4,2,1,1,1,1,0,0,0,0
S01011877,All people aged 16 to 74,418,36,10,26,97,62,52,41,56,53,9,8,1,12
S01011877,Very good health,194,21,7,14,48,24,21,23,27,20,1,1,0,9
S01011877,Good health,160,12,3,9,37,29,23,14,20,18,4,4,0,3
S01011877,Fair health,41,2,0,2,8,5,6,2,7,10,1,1,0,0
S01011877,Bad health,17,1,0,1,3,3,2,2,0,3,3,2,1,0
S01011877,Very bad health,6,0,0,0,1,1,0,0,2,2,0,0,0,0
S01011878,All people aged 16 to 74,917,106,29,77,221,84,88,52,79,53,14,7,7,220
S01011878,Very good health,540,61,12,49,136,39,44,25,37,25,8,3,5,165
S01011878,Good health,290,36,14,22,64,39,33,19,27,16,3,2,1,53
S01011878,Fair health,64,7,3,4,18,3,9,5,10,9,1,1,0,2
S01011878,Bad health,17,1,0,1,3,3,1,2,4,2,1,0,1,0
S01011878,Very bad health,6,1,0,1,0,0,1,1,1,1,1,1,0,0
S01011879,All people aged 16 to 74,415,69,20,49,111,45,51,24,39,21,13,9,4,42
S01011879,Very good health,232,35,8,27,61,27,29,12,16,13,7,4,3,32
S01011879,Good health,140,28,8,20,37,13,17,11,19,8,0,0,0,7
S01011879,Fair health,32,5,4,1,11,1,5,1,3,0,3,2,1,3
S01011879,Bad health,6,0,0,0,2,3,0,0,1,0,0,0,0,0
S01011879,Very bad health,5,1,0,1,0,1,0,0,0,0,3,3,0,0
S01011880,All people aged 16 to 74,444,77,20,57,111,37,76,21,54,33,12,8,4,23
S01011880,Very good health,244,53,16,37,55,21,33,15,24,16,5,4,1,22
S01011880,Good health,143,18,2,16,45,11,29,4,18,12,6,3,3,0
S01011880,Fair health,40,5,2,3,10,2,8,2,8,5,0,0,0,0
S01011880,Bad health,12,1,0,1,0,2,4,0,3,0,1,1,0,1
S01011880,Very bad health,5,0,0,0,1,1,2,0,1,0,0,0,0,0
S01011881,All people aged 16 to 74,549,56,11,45,137,77,55,35,77,67,12,5,7,33
S01011881,Very good health,299,31,5,26,83,47,24,16,34,36,2,1,1,26
S01011881,Good health,188,18,4,14,46,23,23,15,29,21,8,4,4,5
S01011881,Fair health,50,6,2,4,6,5,7,2,11,9,2,0,2,2
S01011881,Bad health,9,1,0,1,2,0,1,1,3,1,0,0,0,0
S01011881,Very bad health,3,0,0,0,0,2,0,1,0,0,0,0,0,0
S01011882,All people aged 16 to 74,679,42,10,32,139,114,55,63,113,93,27,20,7,33
S01011882,Very good health,316,23,5,18,62,58,28,24,60,31,5,4,1,25
S01011882,Good health,245,13,4,9,60,42,17,25,35,36,11,7,4,6
S01011882,Fair health,85,5,1,4,13,10,6,9,14,19,9,8,1,0
S01011882,Bad health,21,1,0,1,3,3,2,3,2,4,2,1,1,1
S01011882,Very bad health,12,0,0,0,1,1,2,2,2,3,0,0,0,1
S01011883,All people aged 16 to 74,857,102,20,82,245,119,73,52,93,51,16,9,7,106
S01011883,Very good health,523,62,9,53,149,69,44,29,51,26,7,5,2,86
S01011883,Good health,270,33,9,24,75,44,20,16,34,20,9,4,5,19
S01011883,Fair health,48,7,2,5,16,5,7,3,7,3,0,0,0,0
S01011883,Bad health,15,0,0,0,5,1,2,4,1,1,0,0,0,1
S01011883,Very bad health,1,0,0,0,0,0,0,0,0,1,0,0,0,0
S01011884,All people aged 16 to 74,325,42,8,34,95,42,55,14,30,29,5,3,2,13
S01011884,Very good health,185,27,3,24,52,24,34,8,12,14,2,2,0,12
S01011884,Good health,105,14,5,9,30,14,16,4,15,10,2,1,1,0
S01011884,Fair health,27,1,0,1,7,4,4,2,3,4,1,0,1,1
S01011884,Bad health,5,0,0,0,3,0,1,0,0,1,0,0,0,0
S01011884,Very bad health,3,0,0,0,3,0,0,0,0,0,0,0,0,0
S01011885,All people aged 16 to 74,479,83,9,74,173,60,60,17,42,18,3,1,2,23
S01011885,Very good health,278,54,7,47,103,39,27,9,15,12,3,1,2,16
S01011885,Good health,146,19,2,17,54,13,22,6,22,4,0,0,0,6
S01011885,Fair health,39,8,0,8,13,5,5,1,4,2,0,0,0,1
S01011885,Bad health,14,2,0,2,2,2,6,1,1,0,0,0,0,0
S01011885,Very bad health,2,0,0,0,1,1,0,0,0,0,0,0,0,0
S01011886,All people aged 16 to 74,637,96,14,82,145,88,59,55,74,68,8,5,3,44
S01011886,Very good health,320,52,7,45,86,43,28,28,27,25,2,1,1,29
S01011886,Good health,237,39,7,32,47,30,21,19,34,30,5,3,2,12
S01011886,Fair health,69,4,0,4,12,13,8,6,10,12,1,1,0,3
S01011886,Bad health,10,1,0,1,0,2,1,2,3,1,0,0,0,0
S01011886,Very bad health,1,0,0,0,0,0,1,0,0,0,0,0,0,0
S01011887,All people aged 16 to 74,419,36,6,30,77,56,44,41,77,52,8,6,2,28
S01011887,Very good health,220,22,3,19,48,26,25,20,38,16,3,1,2,22
S01011887,Good health,148,11,3,8,25,22,14,14,29,26,3,3,0,4
S01011887,Fair health,36,3,0,3,2,7,5,3,8,4,2,2,0,2
S01011887,Bad health,7,0,0,0,2,0,0,1,1,3,0,0,0,0
S01011887,Very bad health,8,0,0,0,0,1,0,3,1,3,0,0,0,0
S01011888,All people aged 16 to 74,606,24,3,21,109,77,46,60,118,97,30,17,13,45
S01011888,Very good health,278,11,0,11,52,40,20,29,45,36,11,5,6,34
S01011888,Good health,227,7,2,5,37,31,17,21,57,38,11,6,5,8
S01011888,Fair health,60,2,0,2,10,6,5,6,11,12,6,4,2,2
S01011888,Bad health,29,2,1,1,7,0,3,3,3,8,2,2,0,1
S01011888,Very bad health,12,2,0,2,3,0,1,1,2,3,0,0,0,0
S01011889,All people aged 16 to 74,628,88,18,70,171,105,58,38,71,52,14,11,3,31
S01011889,Very good health,377,62,15,47,117,57,32,19,35,24,5,3,2,26
S01011889,Good health,174,18,3,15,43,34,18,13,21,18,5,4,1,4
S01011889,Fair health,49,7,0,7,6,8,4,5,9,6,3,3,0,1
S01011889,Bad health,22,1,0,1,4,4,4,0,6,2,1,1,0,0
S01011889,Very bad health,6,0,0,0,1,2,0,1,0,2,0,0,0,0
S01011890,All people aged 16 to 74,514,60,14,46,131,69,31,48,62,63,15,10,5,35
S01011890,Very good health,260,40,9,31,63,31,15,20,32,27,2,1,1,30
S01011890,Good health,197,18,5,13,55,34,12,17,19,30,7,7,0,5
S01011890,Fair health,36,0,0,0,8,2,3,6,8,6,3,1,2,0
S01011890,Bad health,16,2,0,2,4,1,1,4,2,0,2,0,2,0
S01011890,Very bad health,5,0,0,0,1,1,0,1,1,0,1,1,0,0
S01011891,All people aged 16 to 74,1049,32,3,29,110,82,75,139,176,237,165,149,16,33
S01011891,Very good health,379,14,3,11,44,26,30,51,65,72,55,48,7,22
S01011891,Good health,451,12,0,12,56,47,28,49,69,113,69,64,5,8
S01011891,Fair health,134,3,0,3,9,6,5,25,24,31,30,26,4,1
S01011891,Bad health,54,2,0,2,1,2,8,9,9,17,6,6,0,0
S01011891,Very bad health,31,1,0,1,0,1,4,5,9,4,5,5,0,2
S01011892,All people aged 16 to 74,771,97,13,84,216,123,60,56,99,66,13,6,7,41
S01011892,Very good health,451,61,6,55,141,66,26,31,52,34,6,4,2,34
S01011892,Good health,251,33,7,26,54,45,27,20,39,23,4,1,3,6
S01011892,Fair health,53,2,0,2,16,11,5,3,6,7,2,0,2,1
S01011892,Bad health,13,1,0,1,4,1,2,2,1,2,0,0,0,0
S01011892,Very bad health,3,0,0,0,1,0,0,0,1,0,1,1,0,0
S01011893,All people aged 16 to 74,708,69,14,55,163,145,39,63,105,82,18,8,10,24
S01011893,Very good health,378,35,5,30,90,77,20,33,57,43,6,3,3,17
S01011893,Good health,226,25,7,18,58,47,11,21,28,23,6,2,4,7
S01011893,Fair health,67,2,0,2,10,16,5,7,12,10,5,2,3,0
S01011893,Bad health,31,7,2,5,3,4,2,1,7,6,1,1,0,0
S01011893,Very bad health,6,0,0,0,2,1,1,1,1,0,0,0,0,0
S01011894,All people aged 16 to 74,483,38,7,31,107,76,27,43,82,64,11,6,5,35
S01011894,Very good health,248,25,4,21,58,41,13,21,36,30,6,2,4,18
S01011894,Good health,159,9,2,7,39,22,9,13,29,22,2,1,1,14
S01011894,Fair health,55,3,1,2,8,8,2,7,13,9,2,2,0,3
S01011894,Bad health,17,1,0,1,1,3,3,2,4,2,1,1,0,0
S01011894,Very bad health,4,0,0,0,1,2,0,0,0,1,0,0,0,0
S01011895,All people aged 16 to 74,448,84,9,75,122,61,51,26,36,19,7,6,1,42
S01011895,Very good health,252,53,8,45,73,33,31,12,10,10,3,2,1,27
S01011895,Good health,155,29,1,28,40,21,15,10,18,6,1,1,0,15
S01011895,Fair health,31,1,0,1,6,5,4,4,7,2,2,2,0,0
S01011895,Bad health,10,1,0,1,3,2,1,0,1,1,1,1,0,0
S01011895,Very bad health,0,0,0,0,0,0,0,0,0,0,0,0,0,0
S01011896,All people aged 16 to 74,625,87,12,75,158,108,43,55,71,54,16,12,4,33
S01011896,Very good health,342,53,7,46,97,55,23,34,31,16,7,6,1,26
S01011896,Good health,227,29,5,24,49,47,15,17,27,30,7,5,2,6
S01011896,Fair health,42,4,0,4,8,4,4,3,10,6,2,1,1,1
S01011896,Bad health,10,0,0,0,3,2,1,0,2,2,0,0,0,0
S01011896,Very bad health,4,1,0,1,1,0,0,1,1,0,0,0,0,0
S01011897,All people aged 16 to 74,710,90,15,75,207,120,49,47,80,51,19,14,5,47
S01011897,Very good health,424,53,6,47,127,66,31,29,48,30,6,4,2,34
S01011897,Good health,220,29,8,21,64,47,11,17,23,12,5,4,1,12
S01011897,Fair health,53,7,1,6,14,7,5,1,6,6,6,4,2,1
S01011897,Bad health,9,1,0,1,2,0,1,0,2,2,1,1,0,0
S01011897,Very bad health,4,0,0,0,0,0,1,0,1,1,1,1,0,0
S01011898,All people aged 16 to 74,494,105,15,90,161,76,46,14,30,17,4,3,1,41
S01011898,Very good health,349,71,11,60,114,49,34,8,22,13,2,1,1,36
S01011898,Good health,119,29,4,25,39,22,8,4,7,4,1,1,0,5
S01011898,Fair health,23,4,0,4,8,3,4,2,1,0,1,1,0,0
S01011898,Bad health,3,1,0,1,0,2,0,0,0,0,0,0,0,0
S01011898,Very bad health,0,0,0,0,0,0,0,0,0,0,0,0,0,0
S01011899,All people aged 16 to 74,601,59,14,45,168,128,29,43,86,48,8,7,1,32
S01011899,Very good health,328,39,8,31,90,70,16,20,38,23,6,5,1,26
S01011899,Good health,219,19,6,13,62,45,11,16,41,19,1,1,0,5
S01011899,Fair health,37,1,0,1,12,7,1,5,5,4,1,1,0,1
S01011899,Bad health,12,0,0,0,4,4,1,1,1,1,0,0,0,0
S01011899,Very bad health,5,0,0,0,0,2,0,1,1,1,0,0,0,0
S01011900,All people aged 16 to 74,549,91,13,78,155,106,44,26,70,21,8,6,2,28
S01011900,Very good health,308,58,6,52,85,62,20,17,34,11,2,1,1,19
S01011900,Good health,189,23,6,17,51,38,21,7,30,7,3,2,1,9
S01011900,Fair health,45,9,1,8,18,6,2,2,4,3,1,1,0,0
S01011900,Bad health,4,1,0,1,1,0,1,0,1,0,0,0,0,0
S01011900,Very bad health,3,0,0,0,0,0,0,0,1,0,2,2,0,0
S01011901,All people aged 16 to 74,651,97,23,74,178,105,70,34,86,40,11,5,6,30
S01011901,Very good health,388,59,12,47,118,53,41,19,40,25,6,4,2,27
S01011901,Good health,214,32,7,25,51,43,26,11,35,11,3,1,2,2
S01011901,Fair health,39,4,2,2,6,8,3,4,7,4,2,0,2,1
S01011901,Bad health,8,2,2,0,2,1,0,0,3,0,0,0,0,0
S01011901,Very bad health,2,0,0,0,1,0,0,0,1,0,0,0,0,0
S01011902,All people aged 16 to 74,787,113,20,93,250,129,55,39,94,44,13,11,2,50
S01011902,Very good health,404,66,8,58,124,65,22,24,36,20,3,2,1,44
S01011902,Good health,302,41,11,30,98,49,25,12,44,21,6,6,0,6
S01011902,Fair health,63,3,0,3,23,13,7,1,11,2,3,2,1,0
S01011902,Bad health,13,1,0,1,4,2,1,1,2,1,1,1,0,0
S01011902,Very bad health,5,2,1,1,1,0,0,1,1,0,0,0,0,0
S01011903,All people aged 16 to 74,573,63,15,48,185,115,44,33,64,33,12,10,2,24
S01011903,Very good health,323,35,9,26,113,64,21,18,35,16,3,2,1,18
S01011903,Good health,189,25,5,20,56,37,16,10,23,12,4,3,1,6
S01011903,Fair health,46,1,0,1,14,8,6,4,5,3,5,5,0,0
S01011903,Bad health,15,2,1,1,2,6,1,1,1,2,0,0,0,0
S01011903,Very bad health,0,0,0,0,0,0,0,0,0,0,0,0,0,0
S01011904,All people aged 16 to 74,559,67,16,51,172,101,40,30,68,39,13,10,3,29
S01011904,Very good health,327,44,12,32,106,61,26,16,33,14,2,2,0,25
S01011904,Good health,188,19,4,15,52,30,12,13,32,20,6,4,2,4
S01011904,Fair health,33,4,0,4,12,8,2,1,1,2,3,2,1,0
S01011904,Bad health,9,0,0,0,2,2,0,0,1,2,2,2,0,0
S01011904,Very bad health,2,0,0,0,0,0,0,0,1,1,0,0,0,0
S01011905,All people aged 16 to 74,559,91,21,70,148,97,52,30,50,28,10,8,2,53
S01011905,Very good health,357,63,16,47,87,62,33,21,30,14,6,5,1,41
S01011905,Good health,157,24,3,21,48,29,15,5,16,8,2,1,1,10
S01011905,Fair health,38,4,2,2,13,4,3,3,2,5,2,2,0,2
S01011905,Bad health,6,0,0,0,0,2,1,0,2,1,0,0,0,0
S01011905,Very bad health,1,0,0,0,0,0,0,1,0,0,0,0,0,0
S01011906,All people aged 16 to 74,325,31,5,26,106,58,21,25,43,23,6,3,3,12
S01011906,Very good health,192,19,1,18,63,37,8,10,27,15,3,2,1,10
S01011906,Good health,105,10,2,8,38,16,10,9,11,8,1,0,1,2
S01011906,Fair health,21,1,1,0,4,5,3,4,3,0,1,0,1,0
S01011906,Bad health,6,1,1,0,1,0,0,1,2,0,1,1,0,0
S01011906,Very bad health,1,0,0,0,0,0,0,1,0,0,0,0,0,0
S01011907,All people aged 16 to 74,585,48,6,42,156,107,31,72,90,49,5,2,3,27
S01011907,Very good health,313,25,5,20,90,59,16,36,39,24,2,2,0,22
S01011907,Good health,202,14,0,14,50,35,12,28,40,17,2,0,2,4
S01011907,Fair health,52,5,0,5,11,11,2,6,10,5,1,0,1,1
S01011907,Bad health,16,3,1,2,5,1,1,2,1,3,0,0,0,0
S01011907,Very bad health,2,1,0,1,0,1,0,0,0,0,0,0,0,0
S01011908,All people aged 16 to 74,286,25,6,19,82,50,14,29,48,20,5,2,3,13
S01011908,Very good health,160,17,2,15,51,28,7,16,22,7,3,2,1,9
S01011908,Good health,96,6,3,3,26,18,6,10,17,8,1,0,1,4
S01011908,Fair health,22,2,1,1,4,3,0,3,5,4,1,0,1,0
S01011908,Bad health,6,0,0,0,0,1,1,0,3,1,0,0,0,0
S01011908,Very bad health,2,0,0,0,1,0,0,0,1,0,0,0,0,0
S01011909,All people aged 16 to 74,775,64,12,52,235,142,46,73,111,59,10,6,4,35
S01011909,Very good health,458,43,10,33,147,86,19,49,51,30,4,1,3,29
S01011909,Good health,261,19,1,18,75,46,23,19,48,25,2,2,0,4
S01011909,Fair health,42,2,1,1,12,7,4,2,9,2,2,1,1,2
S01011909,Bad health,9,0,0,0,1,3,0,3,2,0,0,0,0,0
S01011909,Very bad health,5,0,0,0,0,0,0,0,1,2,2,2,0,0
S01011910,All people aged 16 to 74,659,22,5,17,74,74,40,69,143,149,54,30,24,34
S01011910,Very good health,283,9,1,8,31,35,18,26,60,63,22,12,10,19
S01011910,Good health,247,9,3,6,28,30,11,27,62,46,22,10,12,12
S01011910,Fair health,79,2,1,1,8,7,5,7,17,25,6,4,2,2
S01011910,Bad health,38,1,0,1,5,2,4,8,1,13,3,3,0,1
S01011910,Very bad health,12,1,0,1,2,0,2,1,3,2,1,1,0,0
S01011911,All people aged 16 to 74,462,17,5,12,85,67,24,51,91,85,23,18,5,19
S01011911,Very good health,230,11,2,9,45,37,15,28,39,35,8,6,2,12
S01011911,Good health,153,4,2,2,28,23,7,17,33,27,8,7,1,6
S01011911,Fair health,54,1,0,1,9,4,1,5,16,11,6,4,2,1
S01011911,Bad health,16,1,1,0,1,1,0,1,2,10,0,0,0,0
S01011911,Very bad health,9,0,0,0,2,2,1,0,1,2,1,1,0,0
S01011912,All people aged 16 to 74,515,15,3,12,73,63,31,61,109,116,21,12,9,26
S01011912,Very good health,219,9,2,7,34,30,15,23,41,46,5,2,3,16
S01011912,Good health,200,5,1,4,31,26,9,25,47,40,9,5,4,8
S01011912,Fair health,70,1,0,1,7,5,6,10,15,19,5,4,1,2
S01011912,Bad health,18,0,0,0,1,1,1,2,5,6,2,1,1,0
S01011912,Very bad health,8,0,0,0,0,1,0,1,1,5,0,0,0,0
S01011913,All people aged 16 to 74,534,20,4,16,83,59,26,54,124,116,33,19,14,19
S01011913,Very good health,216,10,1,9,33,28,11,16,50,44,12,7,5,12
S01011913,Good health,188,5,0,5,33,22,9,17,44,43,9,5,4,6
S01011913,Fair health,94,4,3,1,13,7,2,13,26,19,9,5,4,1
S01011913,Bad health,20,1,0,1,2,1,4,7,1,3,1,0,1,0
S01011913,Very bad health,16,0,0,0,2,1,0,1,3,7,2,2,0,0
S01011914,All people aged 16 to 74,586,10,2,8,70,76,42,58,134,114,43,27,16,39
S01011914,Very good health,251,6,2,4,23,32,21,19,67,44,16,11,5,23
S01011914,Good health,238,3,0,3,33,30,17,29,46,42,24,14,10,14
S01011914,Fair health,74,0,0,0,10,13,3,5,18,20,3,2,1,2
S01011914,Bad health,17,1,0,1,3,1,1,4,1,6,0,0,0,0
S01011914,Very bad health,6,0,0,0,1,0,0,1,2,2,0,0,0,0
S01011915,All people aged 16 to 74,591,23,4,19,75,76,35,62,125,124,34,25,9,37
S01011915,Very good health,267,14,3,11,42,29,15,26,48,45,18,12,6,30
S01011915,Good health,207,6,1,5,23,36,10,24,52,45,5,3,2,6
S01011915,Fair health,69,3,0,3,6,7,6,7,16,20,3,3,0,1
S01011915,Bad health,31,0,0,0,3,0,3,3,6,11,5,4,1,0
S01011915,Very bad health,17,0,0,0,1,4,1,2,3,3,3,3,0,0
S01011916,All people aged 16 to 74,420,9,3,6,50,56,22,45,85,97,27,18,9,29
S01011916,Very good health,187,4,1,3,26,30,8,16,40,35,10,6,4,18
S01011916,Good health,148,4,2,2,13,20,7,18,28,37,12,8,4,9
S01011916,Fair health,59,0,0,0,8,6,3,9,13,15,3,3,0,2
S01011916,Bad health,21,1,0,1,1,0,4,2,3,9,1,0,1,0
S01011916,Very bad health,5,0,0,0,2,0,0,0,1,1,1,1,0,0
S01011917,All people aged 16 to 74,372,5,1,4,55,53,20,36,87,76,16,11,5,24
S01011917,Very good health,159,2,0,2,21,22,7,11,44,31,8,5,3,13
S01011917,Good health,149,2,0,2,23,24,5,15,34,32,7,5,2,7
S01011917,Fair health,44,1,1,0,7,7,5,6,6,9,1,1,0,2
S01011917,Bad health,17,0,0,0,3,0,3,3,3,3,0,0,0,2
S01011917,Very bad health,3,0,0,0,1,0,0,1,0,1,0,0,0,0
S01011918,All people aged 16 to 74,564,17,2,15,66,44,39,41,128,135,57,36,21,37
S01011918,Very good health,243,10,1,9,33,17,16,17,55,52,23,15,8,20
S01011918,Good health,202,6,1,5,19,18,17,13,48,51,15,8,7,15
S01011918,Fair health,79,0,0,0,12,6,3,7,13,21,15,9,6,2
S01011918,Bad health,29,1,0,1,2,3,3,2,8,8,2,2,0,0
S01011918,Very bad health,11,0,0,0,0,0,0,2,4,3,2,2,0,0
S01011919,All people aged 16 to 74,724,36,8,28,111,81,33,71,124,105,40,28,12,123
S01011919,Very good health,348,24,4,20,55,40,17,31,54,33,15,11,4,79
S01011919,Good health,267,8,1,7,37,36,10,28,44,45,18,12,6,41
S01011919,Fair health,73,2,2,0,13,4,5,7,19,14,6,4,2,3
S01011919,Bad health,31,2,1,1,4,1,1,5,4,13,1,1,0,0
S01011919,Very bad health,5,0,0,0,2,0,0,0,3,0,0,0,0,0
S01011920,All people aged 16 to 74,475,14,1,13,59,60,32,48,102,106,23,14,9,31
S01011920,Very good health,196,7,0,7,26,31,10,21,43,31,5,2,3,22
S01011920,Good health,194,7,1,6,24,19,18,19,37,53,8,4,4,9
S01011920,Fair health,62,0,0,0,9,9,2,6,17,11,8,6,2,0
S01011920,Bad health,17,0,0,0,0,1,2,0,3,9,2,2,0,0
S01011920,Very bad health,6,0,0,0,0,0,0,2,2,2,0,0,0,0
S01011921,All people aged 16 to 74,419,17,1,16,53,52,22,41,93,95,22,10,12,24
S01011921,Very good health,189,9,1,8,26,31,5,18,41,35,11,4,7,13
S01011921,Good health,145,6,0,6,20,11,13,15,36,32,4,1,3,8
S01011921,Fair health,59,2,0,2,5,3,4,5,14,18,5,3,2,3
S01011921,Bad health,20,0,0,0,1,7,0,3,1,6,2,2,0,0
S01011921,Very bad health,6,0,0,0,1,0,0,0,1,4,0,0,0,0
S01011922,All people aged 16 to 74,581,15,3,12,61,71,27,58,151,146,30,19,11,22
S01011922,Very good health,239,8,2,6,25,38,9,26,62,47,10,7,3,14
S01011922,Good health,216,5,0,5,23,23,13,22,55,61,11,5,6,3
S01011922,Fair health,92,1,1,0,11,7,5,8,25,23,7,6,1,5
S01011922,Bad health,24,0,0,0,1,2,0,1,6,12,2,1,1,0
S01011922,Very bad health,10,1,0,1,1,1,0,1,3,3,0,0,0,0
S01011923,All people aged 16 to 74,643,13,3,10,87,84,31,68,149,125,47,30,17,39
S01011923,Very good health,274,7,0,7,40,40,17,22,61,46,16,10,6,25
S01011923,Good health,243,5,2,3,33,27,9,33,56,50,19,10,9,11
S01011923,Fair health,69,1,1,0,10,8,2,8,15,16,8,6,2,1
S01011923,Bad health,37,0,0,0,3,6,2,4,9,9,2,2,0,2
S01011923,Very bad health,20,0,0,0,1,3,1,1,8,4,2,2,0,0
S01011924,All people aged 16 to 74,329,8,3,5,47,49,20,34,69,66,10,3,7,26
S01011924,Very good health,158,3,2,1,26,25,11,20,29,24,3,0,3,17
S01011924,Good health,107,2,0,2,16,18,6,6,24,27,2,0,2,6
S01011924,Fair health,42,2,1,1,1,5,3,4,12,11,2,2,0,2
S01011924,Bad health,17,1,0,1,2,0,0,2,4,4,3,1,2,1
S01011924,Very bad health,5,0,0,0,2,1,0,2,0,0,0,0,0,0
S01011925,All people aged 16 to 74,544,62,14,48,144,76,47,50,70,47,17,13,4,31
S01011925,Very good health,318,39,9,30,88,41,19,30,36,30,10,7,3,25
S01011925,Good health,184,19,5,14,50,29,25,18,22,12,3,3,0,6
S01011925,Fair health,29,3,0,3,4,4,3,2,7,2,4,3,1,0
S01011925,Bad health,11,1,0,1,2,2,0,0,4,2,0,0,0,0
S01011925,Very bad health,2,0,0,0,0,0,0,0,1,1,0,0,0,0
S01011926,All people aged 16 to 74,483,18,3,15,60,74,31,41,128,91,19,13,6,21
S01011926,Very good health,197,8,1,7,29,35,10,18,51,28,3,3,0,15
S01011926,Good health,177,6,2,4,20,27,13,18,45,33,9,3,6,6
S01011926,Fair health,75,3,0,3,8,6,5,3,24,20,6,6,0,0
S01011926,Bad health,23,0,0,0,1,6,1,2,7,6,0,0,0,0
S01011926,Very bad health,11,1,0,1,2,0,2,0,1,4,1,1,0,0
S01011927,All people aged 16 to 74,468,11,3,8,64,76,28,43,112,86,17,12,5,31
S01011927,Very good health,193,5,1,4,30,35,10,12,48,28,3,2,1,22
S01011927,Good health,181,3,0,3,24,30,13,20,44,34,6,3,3,7
S01011927,Fair health,54,2,1,1,7,7,2,5,12,12,6,5,1,1
S01011927,Bad health,36,1,1,0,3,4,3,5,7,10,2,2,0,1
S01011927,Very bad health,4,0,0,0,0,0,0,1,1,2,0,0,0,0
S01011928,All people aged 16 to 74,565,31,8,23,80,73,45,75,105,116,15,10,5,25
S01011928,Very good health,246,18,4,14,34,36,16,31,43,42,4,1,3,22
S01011928,Good health,209,11,3,8,35,30,17,25,37,46,5,4,1,3
S01011928,Fair health,77,2,1,1,3,5,8,15,17,23,4,3,1,0
S01011928,Bad health,30,0,0,0,8,2,4,4,6,4,2,2,0,0
S01011928,Very bad health,3,0,0,0,0,0,0,0,2,1,0,0,0,0
S01011929,All people aged 16 to 74,531,11,2,9,76,87,15,59,119,113,23,15,8,28
S01011929,Very good health,233,6,1,5,34,47,6,23,46,43,6,4,2,22
S01011929,Good health,196,2,0,2,24,28,4,29,50,44,9,4,5,6
S01011929,Fair health,71,2,1,1,15,9,4,3,17,18,3,3,0,0
S01011929,Bad health,22,1,0,1,2,2,0,3,6,4,4,3,1,0
S01011929,Very bad health,9,0,0,0,1,1,1,1,0,4,1,1,0,0
S01011930,All people aged 16 to 74,476,15,6,9,73,70,29,43,94,107,14,9,5,31
S01011930,Very good health,206,8,4,4,36,33,16,19,33,40,1,1,0,20
S01011930,Good health,174,6,1,5,23,30,8,17,32,43,5,3,2,10
S01011930,Fair health,65,1,1,0,9,7,3,6,20,14,5,3,2,0
S01011930,Bad health,22,0,0,0,3,0,2,1,8,6,1,1,0,1
S01011930,Very bad health,9,0,0,0,2,0,0,0,1,4,2,1,1,0
S01011931,All people aged 16 to 74,457,12,2,10,59,40,27,40,92,113,43,29,14,31
S01011931,Very good health,196,8,2,6,29,14,11,15,38,41,16,8,8,24
S01011931,Good health,156,3,0,3,22,17,10,17,33,38,11,9,2,5
S01011931,Fair health,60,1,0,1,5,6,3,5,8,23,8,5,3,1
S01011931,Bad health,30,0,0,0,2,3,1,2,9,8,4,4,0,1
S01011931,Very bad health,15,0,0,0,1,0,2,1,4,3,4,3,1,0
S01011932,All people aged 16 to 74,497,35,2,33,104,74,20,49,77,73,29,21,8,36
S01011932,Very good health,238,19,2,17,64,29,6,26,36,29,8,5,3,21
S01011932,Good health,195,12,0,12,32,40,10,15,30,31,10,6,4,15
S01011932,Fair health,45,4,0,4,7,4,3,6,5,9,7,6,1,0
S01011932,Bad health,17,0,0,0,1,1,1,2,5,4,3,3,0,0
S01011932,Very bad health,2,0,0,0,0,0,0,0,1,0,1,1,0,0
S01011933,All people aged 16 to 74,516,26,3,23,79,66,27,63,89,98,25,15,10,43
S01011933,Very good health,263,18,1,17,43,34,11,32,41,44,7,4,3,33
S01011933,Good health,176,7,2,5,29,25,14,22,31,30,10,5,5,8
S01011933,Fair health,47,0,0,0,6,5,1,2,12,17,4,2,2,0
S01011933,Bad health,26,1,0,1,1,2,1,6,3,7,3,3,0,2
S01011933,Very bad health,4,0,0,0,0,0,0,1,2,0,1,1,0,0
S01011934,All people aged 16 to 74,821,62,16,46,163,99,60,57,137,113,28,16,12,102
S01011934,Very good health,415,29,5,24,98,51,28,35,67,47,9,4,5,51
S01011934,Good health,312,25,6,19,51,37,22,15,55,47,11,7,4,49
S01011934,Fair health,67,3,0,3,13,9,9,3,10,13,5,2,3,2
S01011934,Bad health,22,4,4,0,1,2,1,4,3,4,3,3,0,0
S01011934,Very bad health,5,1,1,0,0,0,0,0,2,2,0,0,0,0
S01011935,All people aged 16 to 74,686,40,4,36,95,72,52,61,118,145,29,14,15,74
S01011935,Very good health,313,24,2,22,56,29,27,26,45,50,4,2,2,52
S01011935,Good health,273,10,1,9,27,35,17,25,53,66,19,9,10,21
S01011935,Fair health,68,5,1,4,6,8,6,6,15,18,4,2,2,0
S01011935,Bad health,23,1,0,1,6,0,1,3,4,7,0,0,0,1
S01011935,Very bad health,9,0,0,0,0,0,1,1,1,4,2,1,1,0
S01011936,All people aged 16 to 74,554,70,7,63,123,68,35,45,80,56,23,12,11,54
S01011936,Very good health,297,46,5,41,71,34,19,26,42,15,7,3,4,37
S01011936,Good health,193,21,1,20,42,29,11,11,26,34,5,3,2,14
S01011936,Fair health,46,2,1,1,7,3,4,5,7,7,8,5,3,3
S01011936,Bad health,16,0,0,0,3,2,1,3,4,0,3,1,2,0
S01011936,Very bad health,2,1,0,1,0,0,0,0,1,0,0,0,0,0
S01011937,All people aged 16 to 74,542,60,9,51,103,70,34,46,82,76,24,19,5,47
S01011937,Very good health,274,40,5,35,53,36,17,23,38,29,8,5,3,30
S01011937,Good health,189,18,4,14,35,25,14,18,25,32,8,6,2,14
S01011937,Fair health,59,1,0,1,11,5,2,5,14,11,7,7,0,3
S01011937,Bad health,13,1,0,1,3,2,1,0,3,3,0,0,0,0
S01011937,Very bad health,7,0,0,0,1,2,0,0,2,1,1,1,0,0
S01011938,All people aged 16 to 74,539,59,13,46,141,66,59,30,69,71,14,8,6,30
S01011938,Very good health,295,35,6,29,81,40,38,17,31,27,5,2,3,21
S01011938,Good health,165,17,6,11,42,21,11,11,24,27,4,2,2,8
S01011938,Fair health,47,5,1,4,13,2,5,1,5,12,3,2,1,1
S01011938,Bad health,27,2,0,2,5,2,2,1,8,5,2,2,0,0
S01011938,Very bad health,5,0,0,0,0,1,3,0,1,0,0,0,0,0
S01011939,All people aged 16 to 74,641,39,7,32,119,73,34,61,119,92,46,21,25,58
S01011939,Very good health,282,27,6,21,68,42,7,24,43,30,10,5,5,31
S01011939,Good health,236,9,0,9,35,21,18,24,54,36,18,4,14,21
S01011939,Fair health,77,3,1,2,8,7,4,9,14,14,14,9,5,4
S01011939,Bad health,34,0,0,0,7,2,4,3,7,6,3,2,1,2
S01011939,Very bad health,12,0,0,0,1,1,1,1,1,6,1,1,0,0
S01011940,All people aged 16 to 74,338,25,6,19,54,35,18,32,66,59,23,12,11,26
S01011940,Very good health,161,15,4,11,32,16,8,16,25,21,10,3,7,18
S01011940,Good health,127,8,1,7,17,14,5,11,28,29,8,7,1,7
S01011940,Fair health,35,1,0,1,5,3,4,3,7,7,4,1,3,1
S01011940,Bad health,12,0,0,0,0,2,1,1,5,2,1,1,0,0
S01011940,Very bad health,3,1,1,0,0,0,0,1,1,0,0,0,0,0
S01011941,All people aged 16 to 74,627,48,6,42,111,72,32,69,124,96,27,11,16,48
S01011941,Very good health,311,30,3,27,65,39,11,35,51,37,9,4,5,34
S01011941,Good health,203,12,0,12,32,17,8,20,57,37,7,5,2,13
S01011941,Fair health,75,5,3,2,9,11,8,7,14,14,6,0,6,1
S01011941,Bad health,29,1,0,1,3,2,2,7,1,8,5,2,3,0
S01011941,Very bad health,9,0,0,0,2,3,3,0,1,0,0,0,0,0
S01011942,All people aged 16 to 74,661,34,3,31,112,74,33,63,117,127,28,16,12,73
S01011942,Very good health,326,20,2,18,62,38,11,27,50,63,11,7,4,44
S01011942,Good health,231,9,1,8,40,28,12,28,48,36,9,5,4,21
S01011942,Fair health,76,4,0,4,8,7,4,7,15,18,6,2,4,7
S01011942,Bad health,24,1,0,1,2,1,6,0,3,10,1,1,0,0
S01011942,Very bad health,4,0,0,0,0,0,0,1,1,0,1,1,0,1
S01011943,All people aged 16 to 74,946,47,7,40,158,98,52,87,187,159,79,49,30,79
S01011943,Very good health,386,23,3,20,71,40,20,36,69,56,21,7,14,50
S01011943,Good health,370,20,2,18,60,47,17,29,74,63,34,22,12,26
S01011943,Fair health,120,4,2,2,18,6,9,12,25,25,18,15,3,3
S01011943,Bad health,65,0,0,0,8,4,5,9,18,15,6,5,1,0
S01011943,Very bad health,5,0,0,0,1,1,1,1,1,0,0,0,0,0
S01011944,All people aged 16 to 74,340,59,10,49,95,35,47,20,37,14,8,4,4,25
S01011944,Very good health,194,41,7,34,61,15,19,7,19,10,4,1,3,18
S01011944,Good health,110,9,1,8,29,17,19,12,12,4,3,2,1,5
S01011944,Fair health,31,9,2,7,4,2,7,1,6,0,1,1,0,1
S01011944,Bad health,4,0,0,0,0,1,2,0,0,0,0,0,0,1
S01011944,Very bad health,1,0,0,0,1,0,0,0,0,0,0,0,0,0
S01011945,All people aged 16 to 74,605,128,26,102,192,75,54,21,50,27,30,29,1,28
S01011945,Very good health,357,84,19,65,127,39,30,10,29,8,5,4,1,25
S01011945,Good health,183,37,5,32,50,30,21,8,18,9,7,7,0,3
S01011945,Fair health,45,5,2,3,10,3,3,2,3,6,13,13,0,0
S01011945,Bad health,18,2,0,2,4,3,0,1,0,4,4,4,0,0
S01011945,Very bad health,2,0,0,0,1,0,0,0,0,0,1,1,0,0
S01011946,All people aged 16 to 74,561,63,15,48,103,69,42,58,99,65,22,10,12,40
S01011946,Very good health,267,48,9,39,56,38,19,29,29,16,4,2,2,28
S01011946,Good health,204,8,3,5,33,16,19,25,51,32,11,5,6,9
S01011946,Fair health,67,7,3,4,9,11,4,3,15,11,4,1,3,3
S01011946,Bad health,19,0,0,0,5,3,0,1,2,5,3,2,1,0
S01011946,Very bad health,4,0,0,0,0,1,0,0,2,1,0,0,0,0
S01011947,All people aged 16 to 74,354,27,2,25,89,63,22,36,59,34,5,4,1,19
S01011947,Very good health,182,18,0,18,44,32,9,15,30,15,1,0,1,18
S01011947,Good health,125,7,2,5,36,21,11,15,19,12,3,3,0,1
S01011947,Fair health,30,1,0,1,4,9,0,4,6,5,1,1,0,0
S01011947,Bad health,12,1,0,1,3,1,2,2,2,1,0,0,0,0
S01011947,Very bad health,5,0,0,0,2,0,0,0,2,1,0,0,0,0
S01011948,All people aged 16 to 74,789,109,14,95,211,89,70,49,86,60,79,65,14,36
S01011948,Very good health,421,67,5,62,127,47,32,32,43,19,23,17,6,31
S01011948,Good health,258,36,8,28,58,32,29,10,28,32,30,26,4,3
S01011948,Fair health,81,4,1,3,18,5,7,7,10,5,23,19,4,2
S01011948,Bad health,19,2,0,2,5,4,1,0,4,2,1,1,0,0
S01011948,Very bad health,10,0,0,0,3,1,1,0,1,2,2,2,0,0
S01011949,All people aged 16 to 74,545,78,20,58,171,90,55,31,68,27,4,2,2,21
S01011949,Very good health,284,40,12,28,100,46,30,11,30,10,1,1,0,16
S01011949,Good health,192,28,6,22,54,33,15,15,30,10,3,1,2,4
S01011949,Fair health,56,10,2,8,11,10,8,5,5,6,0,0,0,1
S01011949,Bad health,11,0,0,0,6,1,1,0,2,1,0,0,0,0
S01011949,Very bad health,2,0,0,0,0,0,1,0,1,0,0,0,0,0
S01011950,All people aged 16 to 74,514,55,12,43,115,88,35,45,83,58,13,8,5,22
S01011950,Very good health,267,31,8,23,65,46,22,20,35,23,8,4,4,17
S01011950,Good health,156,21,4,17,34,28,6,13,28,19,3,2,1,4
S01011950,Fair health,63,3,0,3,15,10,6,6,13,10,0,0,0,0
S01011950,Bad health,17,0,0,0,1,2,1,3,6,3,0,0,0,1
S01011950,Very bad health,11,0,0,0,0,2,0,3,1,3,2,2,0,0
S01011951,All people aged 16 to 74,484,35,7,28,126,87,49,37,70,44,10,5,5,26
S01011951,Very good health,257,17,5,12,77,51,16,21,33,16,5,2,3,21
S01011951,Good health,166,13,1,12,42,27,24,13,23,18,3,1,2,3
S01011951,Fair health,45,4,1,3,7,7,5,3,8,7,2,2,0,2
S01011951,Bad health,14,0,0,0,0,2,3,0,6,3,0,0,0,0
S01011951,Very bad health,2,1,0,1,0,0,1,0,0,0,0,0,0,0
S01011952,All people aged 16 to 74,354,61,13,48,105,64,30,22,43,13,4,3,1,12
S01011952,Very good health,224,41,8,33,71,43,19,10,23,6,1,1,0,10
S01011952,Good health,103,17,4,13,27,19,7,10,16,3,2,1,1,2
S01011952,Fair health,20,3,1,2,5,1,4,1,2,4,0,0,0,0
S01011952,Bad health,7,0,0,0,2,1,0,1,2,0,1,1,0,0
S01011952,Very bad health,0,0,0,0,0,0,0,0,0,0,0,0,0,0
S01011953,All people aged 16 to 74,524,71,14,57,155,79,50,34,55,38,6,2,4,36
S01011953,Very good health,317,45,10,35,97,41,29,18,30,24,2,0,2,31
S01011953,Good health,169,22,3,19,55,27,13,15,23,9,1,1,0,4
S01011953,Fair health,30,4,1,3,2,8,7,1,1,4,3,1,2,0
S01011953,Bad health,7,0,0,0,1,3,1,0,0,1,0,0,0,1
S01011953,Very bad health,1,0,0,0,0,0,0,0,1,0,0,0,0,0
S01011954,All people aged 16 to 74,350,16,6,10,79,71,19,41,57,47,7,3,4,13
S01011954,Very good health,191,11,2,9,48,39,10,25,26,19,2,2,0,11
S01011954,Good health,93,5,4,1,15,22,5,11,18,15,0,0,0,2
S01011954,Fair health,45,0,0,0,12,5,3,4,8,8,5,1,4,0
S01011954,Bad health,18,0,0,0,4,5,0,1,4,4,0,0,0,0
S01011954,Very bad health,3,0,0,0,0,0,1,0,1,1,0,0,0,0
S01011955,All people aged 16 to 74,686,44,6,38,152,103,65,61,118,89,17,11,6,37
S01011955,Very good health,351,27,4,23,72,51,32,34,60,37,10,5,5,28
S01011955,Good health,234,16,2,14,57,39,27,15,40,29,2,1,1,9
S01011955,Fair health,61,1,0,1,12,6,3,7,9,21,2,2,0,0
S01011955,Bad health,29,0,0,0,7,6,2,5,6,2,1,1,0,0
S01011955,Very bad health,11,0,0,0,4,1,1,0,3,0,2,2,0,0
S01011956,All people aged 16 to 74,717,112,18,94,198,111,63,44,91,57,8,7,1,33
S01011956,Very good health,422,80,14,66,123,64,32,22,41,27,3,3,0,30
S01011956,Good health,222,28,4,24,63,30,26,17,37,15,3,2,1,3
S01011956,Fair health,61,3,0,3,10,14,4,5,12,12,1,1,0,0
S01011956,Bad health,11,1,0,1,2,2,1,0,1,3,1,1,0,0
S01011956,Very bad health,1,0,0,0,0,1,0,0,0,0,0,0,0,0
S01011957,All people aged 16 to 74,721,74,21,53,156,67,89,74,131,56,29,19,10,45
S01011957,Very good health,421,47,13,34,92,44,35,42,87,27,7,4,3,40
S01011957,Good health,212,24,8,16,48,19,38,25,30,12,11,6,5,5
S01011957,Fair health,59,3,0,3,10,3,14,3,6,12,8,6,2,0
S01011957,Bad health,27,0,0,0,5,1,1,4,8,5,3,3,0,0
S01011957,Very bad health,2,0,0,0,1,0,1,0,0,0,0,0,0,0
S01011958,All people aged 16 to 74,799,82,12,70,204,84,144,61,104,78,11,5,6,31
S01011958,Very good health,410,53,6,47,110,41,80,30,45,29,4,2,2,18
S01011958,Good health,276,18,4,14,78,28,45,26,34,35,2,1,1,10
S01011958,Fair health,80,8,1,7,15,12,12,2,16,12,1,0,1,2
S01011958,Bad health,29,3,1,2,1,3,5,3,8,1,4,2,2,1
S01011958,Very bad health,4,0,0,0,0,0,2,0,1,1,0,0,0,0
S01011959,All people aged 16 to 74,665,66,15,51,146,85,93,57,78,58,45,42,3,37
S01011959,Very good health,337,46,9,37,87,52,45,19,40,15,1,1,0,32
S01011959,Good health,233,17,6,11,44,26,33,29,26,33,22,21,1,3
S01011959,Fair health,63,1,0,1,8,6,9,8,7,7,15,14,1,2
S01011959,Bad health,25,0,0,0,6,0,5,1,3,3,7,6,1,0
S01011959,Very bad health,7,2,0,2,1,1,1,0,2,0,0,0,0,0
S01011960,All people aged 16 to 74,603,116,17,99,176,71,62,50,57,44,7,5,2,20
S01011960,Very good health,353,82,11,71,110,42,28,30,24,16,4,3,1,17
S01011960,Good health,199,30,6,24,58,26,24,15,22,18,3,2,1,3
S01011960,Fair health,40,4,0,4,5,3,9,4,7,8,0,0,0,0
S01011960,Bad health,10,0,0,0,2,0,1,1,4,2,0,0,0,0
S01011960,Very bad health,1,0,0,0,1,0,0,0,0,0,0,0,0,0
S01011961,All people aged 16 to 74,531,66,11,55,139,72,38,48,72,56,8,2,6,32
S01011961,Very good health,292,37,6,31,78,47,25,21,32,24,3,2,1,25
S01011961,Good health,186,23,4,19,54,19,9,21,30,22,2,0,2,6
S01011961,Fair health,41,5,1,4,5,5,2,6,6,8,3,0,3,1
S01011961,Bad health,9,1,0,1,2,1,0,0,3,2,0,0,0,0
S01011961,Very bad health,3,0,0,0,0,0,2,0,1,0,0,0,0,0
S01011962,All people aged 16 to 74,512,95,21,74,147,67,69,29,40,30,6,6,0,29
S01011962,Very good health,278,60,15,45,85,34,35,11,14,14,2,2,0,23
S01011962,Good health,184,30,6,24,51,28,25,13,20,10,4,4,0,3
S01011962,Fair health,38,3,0,3,9,4,6,5,4,4,0,0,0,3
S01011962,Bad health,11,2,0,2,1,1,3,0,2,2,0,0,0,0
S01011962,Very bad health,1,0,0,0,1,0,0,0,0,0,0,0,0,0
S01011963,All people aged 16 to 74,359,47,7,40,90,48,23,24,60,42,9,4,5,16
S01011963,Very good health,185,32,4,28,50,30,10,11,22,17,2,1,1,11
S01011963,Good health,123,12,3,9,36,17,7,7,24,13,2,0,2,5
S01011963,Fair health,35,3,0,3,4,1,4,4,11,4,4,3,1,0
S01011963,Bad health,12,0,0,0,0,0,2,1,2,6,1,0,1,0
S01011963,Very bad health,4,0,0,0,0,0,0,1,1,2,0,0,0,0
S01011964,All people aged 16 to 74,759,106,20,86,195,113,49,75,96,74,19,11,8,32
S01011964,Very good health,385,60,8,52,112,53,26,33,41,28,7,5,2,25
S01011964,Good health,276,37,10,27,63,41,15,32,41,32,8,5,3,7
S01011964,Fair health,73,6,2,4,11,17,6,9,10,11,3,1,2,0
S01011964,Bad health,20,2,0,2,8,2,1,0,4,2,1,0,1,0
S01011964,Very bad health,5,1,0,1,1,0,1,1,0,1,0,0,0,0
S01011965,All people aged 16 to 74,549,88,18,70,142,75,32,52,54,51,10,8,2,45
S01011965,Very good health,311,51,14,37,87,41,16,31,26,20,4,3,1,35
S01011965,Good health,180,32,3,29,43,25,12,13,20,22,3,2,1,10
S01011965,Fair health,46,5,1,4,10,8,3,5,8,5,2,2,0,0
S01011965,Bad health,8,0,0,0,2,1,0,3,0,2,0,0,0,0
S01011965,Very bad health,4,0,0,0,0,0,1,0,0,2,1,1,0,0
S01011966,All people aged 16 to 74,600,112,22,90,157,93,47,37,59,43,16,11,5,36
S01011966,Very good health,311,68,12,56,92,48,18,19,28,14,3,3,0,21
S01011966,Good health,204,36,8,28,47,33,18,14,23,14,6,2,4,13
S01011966,Fair health,63,6,2,4,14,9,11,3,5,9,4,3,1,2
S01011966,Bad health,16,2,0,2,3,2,0,1,1,4,3,3,0,0
S01011966,Very bad health,6,0,0,0,1,1,0,0,2,2,0,0,0,0
S01011967,All people aged 16 to 74,909,146,25,121,207,101,126,57,102,92,30,28,2,48
S01011967,Very good health,475,105,16,89,112,39,60,25,47,37,11,9,2,39
S01011967,Good health,291,32,8,24,69,39,49,21,36,34,6,6,0,5
S01011967,Fair health,104,8,1,7,20,15,14,8,14,15,7,7,0,3
S01011967,Bad health,27,1,0,1,5,4,3,2,3,4,4,4,0,1
S01011967,Very bad health,12,0,0,0,1,4,0,1,2,2,2,2,0,0
S01011968,All people aged 16 to 74,752,117,14,103,182,127,54,57,87,62,15,6,9,51
S01011968,Very good health,445,82,8,74,115,69,28,30,49,24,8,4,4,40
S01011968,Good health,220,30,6,24,55,42,12,18,25,23,7,2,5,8
S01011968,Fair health,64,3,0,3,9,12,11,5,8,13,0,0,0,3
S01011968,Bad health,14,1,0,1,1,3,2,4,3,0,0,0,0,0
S01011968,Very bad health,9,1,0,1,2,1,1,0,2,2,0,0,0,0
S01011969,All people aged 16 to 74,762,55,10,45,147,88,52,88,146,136,20,11,9,30
S01011969,Very good health,347,30,7,23,67,39,20,40,72,51,4,2,2,24
S01011969,Good health,261,18,2,16,47,36,18,32,50,48,8,3,5,4
S01011969,Fair health,101,4,1,3,20,11,9,9,21,24,3,1,2,0
S01011969,Bad health,40,3,0,3,12,2,4,3,1,11,4,4,0,0
S01011969,Very bad health,13,0,0,0,1,0,1,4,2,2,1,1,0,2
S01011970,All people aged 16 to 74,711,26,8,18,70,62,54,92,191,145,41,25,16,30
S01011970,Very good health,307,13,5,8,36,30,20,43,79,59,11,5,6,16
S01011970,Good health,278,12,3,9,24,23,27,31,78,55,15,9,6,13
S01011970,Fair health,82,1,0,1,3,9,5,12,22,20,9,6,3,1
S01011970,Bad health,26,0,0,0,5,0,1,2,7,5,6,5,1,0
S01011970,Very bad health,18,0,0,0,2,0,1,4,5,6,0,0,0,0
S01011971,All people aged 16 to 74,392,47,12,35,91,45,47,35,56,41,10,2,8,20
S01011971,Very good health,226,28,7,21,54,24,24,21,32,20,6,1,5,17
S01011971,Good health,125,17,5,12,25,19,14,9,20,14,4,1,3,3
S01011971,Fair health,28,2,0,2,10,1,6,5,2,2,0,0,0,0
S01011971,Bad health,12,0,0,0,2,1,3,0,2,4,0,0,0,0
S01011971,Very bad health,1,0,0,0,0,0,0,0,0,1,0,0,0,0
S01011972,All people aged 16 to 74,886,75,16,59,218,84,169,61,126,81,27,19,8,45
S01011972,Very good health,455,45,9,36,116,42,86,30,49,41,10,6,4,36
S01011972,Good health,308,22,5,17,80,29,65,21,51,25,6,3,3,9
S01011972,Fair health,88,6,1,5,13,10,16,9,17,10,7,7,0,0
S01011972,Bad health,23,1,0,1,7,2,2,1,4,2,4,3,1,0
S01011972,Very bad health,12,1,1,0,2,1,0,0,5,3,0,0,0,0
S01011973,All people aged 16 to 74,463,60,19,41,106,56,62,24,73,49,10,5,5,23
S01011973,Very good health,241,40,13,27,51,30,31,14,36,18,3,2,1,18
S01011973,Good health,149,12,2,10,42,19,25,6,22,15,3,1,2,5
S01011973,Fair health,57,7,4,3,10,7,4,3,11,14,1,1,0,0
S01011973,Bad health,14,1,0,1,2,0,2,1,3,2,3,1,2,0
S01011973,Very bad health,2,0,0,0,1,0,0,0,1,0,0,0,0,0
S01011974,All people aged 16 to 74,591,68,19,49,146,79,79,56,83,46,11,8,3,23
S01011974,Very good health,356,58,14,44,86,53,40,36,41,18,4,2,2,20
S01011974,Good health,167,5,2,3,46,21,31,18,25,14,4,4,0,3
S01011974,Fair health,59,5,3,2,13,4,6,2,14,13,2,1,1,0
S01011974,Bad health,8,0,0,0,1,1,1,0,3,1,1,1,0,0
S01011974,Very bad health,1,0,0,0,0,0,1,0,0,0,0,0,0,0
S01011975,All people aged 16 to 74,352,40,6,34,80,26,49,37,60,39,6,5,1,15
S01011975,Very good health,183,25,4,21,42,16,20,20,29,16,3,2,1,12
S01011975,Good health,120,10,1,9,31,5,19,13,22,17,1,1,0,2
S01011975,Fair health,35,5,1,4,6,5,7,3,5,3,1,1,0,0
S01011975,Bad health,11,0,0,0,0,0,3,1,4,2,0,0,0,1
S01011975,Very bad health,3,0,0,0,1,0,0,0,0,1,1,1,0,0
S01011976,All people aged 16 to 74,573,51,13,38,127,63,80,61,76,65,17,10,7,33
S01011976,Very good health,281,34,7,27,73,28,35,24,24,32,7,3,4,24
S01011976,Good health,205,12,5,7,41,29,32,24,34,18,7,5,2,8
S01011976,Fair health,63,4,1,3,9,4,10,12,13,8,2,1,1,1
S01011976,Bad health,16,1,0,1,4,2,1,0,3,4,1,1,0,0
S01011976,Very bad health,8,0,0,0,0,0,2,1,2,3,0,0,0,0
S01011977,All people aged 16 to 74,880,67,15,52,191,80,113,87,135,123,40,28,12,44
S01011977,Very good health,407,42,9,33,92,41,51,35,59,44,9,6,3,34
S01011977,Good health,335,21,4,17,72,28,46,35,50,56,20,13,7,7
S01011977,Fair health,99,2,1,1,18,10,11,12,20,15,8,6,2,3
S01011977,Bad health,28,2,1,1,7,1,4,3,3,6,2,2,0,0
S01011977,Very bad health,11,0,0,0,2,0,1,2,3,2,1,1,0,0
S01011978,All people aged 16 to 74,470,19,4,15,106,42,43,48,102,82,8,5,3,20
S01011978,Very good health,219,9,1,8,50,19,20,19,47,36,4,1,3,15
S01011978,Good health,166,7,3,4,35,19,12,24,31,32,2,2,0,4
S01011978,Fair health,55,2,0,2,12,3,9,2,18,8,1,1,0,0
S01011978,Bad health,22,0,0,0,8,0,2,0,6,5,1,1,0,0
S01011978,Very bad health,8,1,0,1,1,1,0,3,0,1,0,0,0,1
S01011979,All people aged 16 to 74,724,74,15,59,194,74,123,45,105,62,15,12,3,32
S01011979,Very good health,419,52,12,40,119,46,51,24,61,30,7,4,3,29
S01011979,Good health,219,20,3,17,58,23,45,16,32,18,5,5,0,2
S01011979,Fair health,64,2,0,2,11,5,18,4,11,11,1,1,0,1
S01011979,Bad health,17,0,0,0,6,0,6,0,1,2,2,2,0,0
S01011979,Very bad health,5,0,0,0,0,0,3,1,0,1,0,0,0,0
S01011980,All people aged 16 to 74,318,38,13,25,67,29,69,28,32,31,6,3,3,18
S01011980,Very good health,167,19,8,11,38,16,33,14,13,17,4,2,2,13
S01011980,Good health,119,17,5,12,26,11,27,8,14,12,0,0,0,4
S01011980,Fair health,24,1,0,1,2,2,8,4,3,2,1,0,1,1
S01011980,Bad health,7,1,0,1,1,0,1,2,1,0,1,1,0,0
S01011980,Very bad health,1,0,0,0,0,0,0,0,1,0,0,0,0,0
S01011981,All people aged 16 to 74,716,60,12,48,148,70,139,89,106,63,12,7,5,29
S01011981,Very good health,385,37,7,30,88,31,68,53,50,25,8,4,4,25
S01011981,Good health,234,18,5,13,42,28,54,28,37,25,0,0,0,2
S01011981,Fair health,76,5,0,5,15,7,14,5,16,9,3,3,0,2
S01011981,Bad health,15,0,0,0,0,2,2,3,3,4,1,0,1,0
S01011981,Very bad health,6,0,0,0,3,2,1,0,0,0,0,0,0,0
S01011982,All people aged 16 to 74,717,72,21,51,170,66,140,61,111,57,13,8,5,27
S01011982,Very good health,402,46,12,34,95,38,80,35,61,26,4,2,2,17
S01011982,Good health,215,17,7,10,48,18,44,21,36,18,5,3,2,8
S01011982,Fair health,66,6,2,4,21,9,8,3,8,7,2,1,1,2
S01011982,Bad health,21,2,0,2,4,1,4,0,5,4,1,1,0,0
S01011982,Very bad health,13,1,0,1,2,0,4,2,1,2,1,1,0,0
S01011983,All people aged 16 to 74,548,47,6,41,107,52,111,71,82,53,12,9,3,13
S01011983,Very good health,273,26,4,22,55,25,62,34,37,21,5,4,1,8
S01011983,Good health,216,18,2,16,42,24,38,30,34,21,6,5,1,3
S01011983,Fair health,50,2,0,2,10,1,11,6,9,10,1,0,1,0
S01011983,Bad health,8,1,0,1,0,2,0,1,1,1,0,0,0,2
S01011983,Very bad health,1,0,0,0,0,0,0,0,1,0,0,0,0,0
S01011984,All people aged 16 to 74,468,14,2,12,82,44,37,44,93,109,28,23,5,17
S01011984,Very good health,204,6,0,6,39,26,17,20,38,38,8,7,1,12
S01011984,Good health,170,7,2,5,28,12,15,17,31,46,9,7,2,5
S01011984,Fair health,63,0,0,0,11,3,5,3,13,19,9,7,2,0
S01011984,Bad health,28,1,0,1,3,3,0,4,9,6,2,2,0,0
S01011984,Very bad health,3,0,0,0,1,0,0,0,2,0,0,0,0,0
S01011985,All people aged 16 to 74,526,25,5,20,118,55,74,45,95,62,26,23,3,26
S01011985,Very good health,255,11,1,10,71,27,35,21,44,26,3,2,1,17
S01011985,Good health,192,11,3,8,33,21,32,20,33,23,10,8,2,9
S01011985,Fair health,63,1,0,1,12,6,5,3,15,10,11,11,0,0
S01011985,Bad health,12,2,1,1,2,1,2,1,0,2,2,2,0,0
S01011985,Very bad health,4,0,0,0,0,0,0,0,3,1,0,0,0,0
S01011986,All people aged 16 to 74,480,11,2,9,77,38,43,53,111,93,34,18,16,20
S01011986,Very good health,192,7,1,6,36,16,15,22,35,40,7,2,5,14
S01011986,Good health,179,3,1,2,27,14,17,14,50,35,14,8,6,5
S01011986,Fair health,71,0,0,0,8,5,8,12,15,13,9,4,5,1
S01011986,Bad health,28,0,0,0,4,2,1,5,9,4,3,3,0,0
S01011986,Very bad health,10,1,0,1,2,1,2,0,2,1,1,1,0,0
S01011987,All people aged 16 to 74,703,36,11,25,138,88,67,61,142,98,27,17,10,46
S01011987,Very good health,355,16,4,12,69,46,37,31,72,39,11,8,3,34
S01011987,Good health,231,16,6,10,45,26,18,21,50,35,9,2,7,11
S01011987,Fair health,81,3,1,2,14,10,10,5,16,16,6,6,0,1
S01011987,Bad health,29,1,0,1,9,4,2,3,3,7,0,0,0,0
S01011987,Very bad health,7,0,0,0,1,2,0,1,1,1,1,1,0,0
S01011988,All people aged 16 to 74,501,37,8,29,144,60,54,31,63,45,32,30,2,35
S01011988,Very good health,241,20,1,19,72,34,29,18,22,16,1,1,0,29
S01011988,Good health,151,12,5,7,44,12,17,8,24,20,8,7,1,6
S01011988,Fair health,78,3,0,3,19,10,8,4,13,4,17,16,1,0
S01011988,Bad health,24,2,2,0,5,3,0,1,3,5,5,5,0,0
S01011988,Very bad health,7,0,0,0,4,1,0,0,1,0,1,1,0,0
S01011989,All people aged 16 to 74,616,40,9,31,126,87,68,71,101,79,14,10,4,30
S01011989,Very good health,333,27,6,21,68,46,36,39,52,35,6,5,1,24
S01011989,Good health,200,7,1,6,44,30,23,24,31,33,4,2,2,4
S01011989,Fair health,59,4,1,3,10,9,5,3,16,8,2,1,1,2
S01011989,Bad health,16,2,1,1,1,0,2,5,2,2,2,2,0,0
S01011989,Very bad health,8,0,0,0,3,2,2,0,0,1,0,0,0,0
S01011990,All people aged 16 to 74,527,43,11,32,119,91,57,52,78,57,9,6,3,21
S01011990,Very good health,293,26,5,21,71,58,33,24,38,24,1,1,0,18
S01011990,Good health,171,16,5,11,37,23,17,21,31,19,5,4,1,2
S01011990,Fair health,45,1,1,0,4,7,6,6,7,10,3,1,2,1
S01011990,Bad health,10,0,0,0,4,1,1,0,1,3,0,0,0,0
S01011990,Very bad health,8,0,0,0,3,2,0,1,1,1,0,0,0,0
S01011991,All people aged 16 to 74,521,22,7,15,108,58,52,41,101,86,17,10,7,36
S01011991,Very good health,263,12,3,9,60,18,25,19,52,37,8,3,5,32
S01011991,Good health,182,8,4,4,39,26,20,13,37,34,2,2,0,3
S01011991,Fair health,52,1,0,1,7,8,5,6,7,13,4,3,1,1
S01011991,Bad health,15,1,0,1,1,2,2,3,4,1,1,0,1,0
S01011991,Very bad health,9,0,0,0,1,4,0,0,1,1,2,2,0,0
S01011992,All people aged 16 to 74,673,84,10,74,180,80,73,45,103,58,18,8,10,32
S01011992,Very good health,381,58,7,51,97,45,35,25,64,24,9,3,6,24
S01011992,Good health,209,20,2,18,65,24,26,13,26,22,5,4,1,8
S01011992,Fair health,60,5,0,5,14,9,11,6,7,6,2,1,1,0
S01011992,Bad health,16,1,1,0,2,2,0,1,4,4,2,0,2,0
S01011992,Very bad health,7,0,0,0,2,0,1,0,2,2,0,0,0,0
S01011993,All people aged 16 to 74,625,26,9,17,98,69,36,80,133,123,31,18,13,29
S01011993,Very good health,287,19,6,13,54,33,18,39,50,48,5,2,3,21
S01011993,Good health,221,5,2,3,29,25,8,21,61,49,16,10,6,7
S01011993,Fair health,69,1,0,1,9,7,7,11,12,15,7,3,4,0
S01011993,Bad health,33,1,1,0,6,2,1,7,6,8,2,2,0,0
S01011993,Very bad health,15,0,0,0,0,2,2,2,4,3,1,1,0,1
S01011994,All people aged 16 to 74,518,89,23,66,169,62,67,27,37,28,12,8,4,27
S01011994,Very good health,286,50,12,38,94,35,32,17,20,12,4,1,3,22
S01011994,Good health,162,33,6,27,56,18,27,7,9,8,1,0,1,3
S01011994,Fair health,53,5,4,1,15,9,6,3,4,7,3,3,0,1
S01011994,Bad health,16,1,1,0,4,0,2,0,4,1,4,4,0,0
S01011994,Very bad health,1,0,0,0,0,0,0,0,0,0,0,0,0,1
S01011995,All people aged 16 to 74,613,77,16,61,155,68,98,50,81,53,6,6,0,25
S01011995,Very good health,371,50,8,42,96,44,65,26,36,28,2,2,0,24
S01011995,Good health,188,22,5,17,49,16,29,19,34,18,1,1,0,0
S01011995,Fair health,36,3,2,1,10,5,2,4,3,5,3,3,0,1
S01011995,Bad health,17,1,0,1,0,3,2,1,8,2,0,0,0,0
S01011995,Very bad health,1,1,1,0,0,0,0,0,0,0,0,0,0,0
S01011996,All people aged 16 to 74,404,24,9,15,82,51,35,46,58,64,20,19,1,24
S01011996,Very good health,207,13,6,7,47,30,21,26,27,25,4,4,0,14
S01011996,Good health,138,8,2,6,22,17,12,13,23,26,9,8,1,8
S01011996,Fair health,36,1,1,0,10,1,1,4,3,10,5,5,0,1
S01011996,Bad health,19,2,0,2,3,3,1,1,3,3,2,2,0,1
S01011996,Very bad health,4,0,0,0,0,0,0,2,2,0,0,0,0,0
S01011997,All people aged 16 to 74,668,71,16,55,146,76,63,66,98,86,17,8,9,45
S01011997,Very good health,359,40,6,34,80,43,21,37,49,44,9,5,4,36
S01011997,Good health,204,17,7,10,45,24,26,21,35,28,2,0,2,6
S01011997,Fair health,76,10,2,8,15,8,8,8,11,8,6,3,3,2
S01011997,Bad health,26,4,1,3,6,1,7,0,3,4,0,0,0,1
S01011997,Very bad health,3,0,0,0,0,0,1,0,0,2,0,0,0,0
S01011998,All people aged 16 to 74,382,54,13,41,107,72,44,29,42,20,3,1,2,11
S01011998,Very good health,215,36,13,23,54,50,23,10,21,10,2,1,1,9
S01011998,Good health,130,14,0,14,41,14,19,16,16,7,1,0,1,2
S01011998,Fair health,25,4,0,4,6,7,1,2,3,2,0,0,0,0
S01011998,Bad health,9,0,0,0,4,1,1,0,2,1,0,0,0,0
S01011998,Very bad health,3,0,0,0,2,0,0,1,0,0,0,0,0,0
S01011999,All people aged 16 to 74,477,45,8,37,97,54,76,56,70,46,6,2,4,27
S01011999,Very good health,251,25,4,21,55,32,39,30,30,16,0,0,0,24
S01011999,Good health,170,15,2,13,36,14,32,17,31,20,3,2,1,2
S01011999,Fair health,35,5,2,3,3,4,2,6,7,5,2,0,2,1
S01011999,Bad health,17,0,0,0,1,4,3,3,2,3,1,0,1,0
S01011999,Very bad health,4,0,0,0,2,0,0,0,0,2,0,0,0,0
S01012000,All people aged 16 to 74,335,27,4,23,86,63,36,34,41,36,0,0,0,12
S01012000,Very good health,174,18,4,14,44,30,17,22,17,19,0,0,0,7
S01012000,Good health,127,8,0,8,30,28,17,9,18,12,0,0,0,5
S01012000,Fair health,29,1,0,1,11,4,2,3,5,3,0,0,0,0
S01012000,Bad health,4,0,0,0,0,1,0,0,1,2,0,0,0,0
S01012000,Very bad health,1,0,0,0,1,0,0,0,0,0,0,0,0,0
S01012001,All people aged 16 to 74,459,31,9,22,86,69,61,52,64,76,9,4,5,11
S01012001,Very good health,242,23,7,16,46,34,27,21,36,40,5,2,3,10
S01012001,Good health,163,8,2,6,29,28,29,26,20,19,3,1,2,1
S01012001,Fair health,39,0,0,0,8,6,4,3,5,12,1,1,0,0
S01012001,Bad health,12,0,0,0,2,1,1,1,3,4,0,0,0,0
S01012001,Very bad health,3,0,0,0,1,0,0,1,0,1,0,0,0,0
S01012002,All people aged 16 to 74,391,25,5,20,72,62,42,51,65,49,9,7,2,16
S01012002,Very good health,165,9,0,9,30,32,15,24,25,17,1,1,0,12
S01012002,Good health,150,12,5,7,27,22,19,17,29,17,4,2,2,3
S01012002,Fair health,49,2,0,2,13,5,3,4,7,11,3,3,0,1
S01012002,Bad health,20,1,0,1,2,3,4,4,2,3,1,1,0,0
S01012002,Very bad health,7,1,0,1,0,0,1,2,2,1,0,0,0,0
S01012003,All people aged 16 to 74,419,16,5,11,103,55,43,34,64,67,13,3,10,24
S01012003,Very good health,218,8,0,8,56,31,19,22,33,31,3,0,3,15
S01012003,Good health,139,6,4,2,39,15,15,6,23,23,4,1,3,8
S01012003,Fair health,47,2,1,1,6,6,5,5,7,10,5,1,4,1
S01012003,Bad health,12,0,0,0,2,1,3,1,1,3,1,1,0,0
S01012003,Very bad health,3,0,0,0,0,2,1,0,0,0,0,0,0,0
S01012004,All people aged 16 to 74,638,66,18,48,136,107,65,47,86,74,13,9,4,44
S01012004,Very good health,340,40,10,30,75,47,31,26,44,38,2,0,2,37
S01012004,Good health,213,21,7,14,50,43,25,12,29,20,6,5,1,7
S01012004,Fair health,58,3,0,3,6,14,6,7,8,10,4,3,1,0
S01012004,Bad health,17,2,1,1,2,2,2,2,3,3,1,1,0,0
S01012004,Very bad health,10,0,0,0,3,1,1,0,2,3,0,0,0,0
S01012005,All people aged 16 to 74,644,74,16,58,162,109,53,50,88,60,15,8,7,33
S01012005,Very good health,383,52,12,40,107,62,25,31,48,24,3,1,2,31
S01012005,Good health,205,20,3,17,45,38,22,14,30,26,8,5,3,2
S01012005,Fair health,38,2,1,1,7,6,2,4,8,6,3,1,2,0
S01012005,Bad health,13,0,0,0,3,1,3,1,1,3,1,1,0,0
S01012005,Very bad health,5,0,0,0,0,2,1,0,1,1,0,0,0,0
S01012006,All people aged 16 to 74,708,60,13,47,166,41,91,40,46,38,11,7,4,215
S01012006,Very good health,457,41,9,32,116,29,44,24,22,14,5,4,1,162
S01012006,Good health,195,17,4,13,40,9,34,11,16,18,3,2,1,47
S01012006,Fair health,37,0,0,0,6,2,10,3,6,4,1,0,1,5
S01012006,Bad health,15,1,0,1,4,1,2,2,1,1,2,1,1,1
S01012006,Very bad health,4,1,0,1,0,0,1,0,1,1,0,0,0,0
S01012007,All people aged 16 to 74,580,59,7,52,149,59,78,57,84,51,15,6,9,28
S01012007,Very good health,298,25,4,21,88,33,44,26,36,20,5,1,4,21
S01012007,Good health,198,25,2,23,42,16,21,22,38,23,5,1,4,6
S01012007,Fair health,59,5,1,4,15,5,10,5,7,7,4,3,1,1
S01012007,Bad health,24,4,0,4,4,5,2,4,3,1,1,1,0,0
S01012007,Very bad health,1,0,0,0,0,0,1,0,0,0,0,0,0,0
S01012008,All people aged 16 to 74,707,75,20,55,173,59,104,70,90,60,37,35,2,39
S01012008,Very good health,378,50,15,35,106,26,53,33,33,29,16,15,1,32
S01012008,Good health,249,21,4,17,55,22,38,30,44,21,14,13,1,4
S01012008,Fair health,65,4,1,3,9,7,11,6,12,7,6,6,0,3
S01012008,Bad health,12,0,0,0,3,4,2,1,1,1,0,0,0,0
S01012008,Very bad health,3,0,0,0,0,0,0,0,0,2,1,1,0,0
S01012009,All people aged 16 to 74,557,54,11,43,144,40,81,42,86,76,11,7,4,23
S01012009,Very good health,318,37,9,28,88,19,44,25,45,39,3,2,1,18
S01012009,Good health,172,13,2,11,43,14,25,8,28,33,4,2,2,4
S01012009,Fair health,48,2,0,2,11,2,8,8,11,2,4,3,1,0
S01012009,Bad health,17,1,0,1,1,5,4,1,2,2,0,0,0,1
S01012009,Very bad health,2,1,0,1,1,0,0,0,0,0,0,0,0,0
S01012010,All people aged 16 to 74,872,90,14,76,207,72,123,108,115,111,11,8,3,35
S01012010,Very good health,480,52,8,44,111,40,64,68,54,59,5,5,0,27
S01012010,Good health,278,29,3,26,66,27,46,26,39,34,5,2,3,6
S01012010,Fair health,77,8,2,6,18,3,9,11,17,9,0,0,0,2
S01012010,Bad health,29,1,1,0,7,2,4,3,5,7,0,0,0,0
S01012010,Very bad health,8,0,0,0,5,0,0,0,0,2,1,1,0,0
S01012011,All people aged 16 to 74,824,59,9,50,166,58,104,103,168,97,15,5,10,54
S01012011,Very good health,425,27,6,21,94,27,51,53,89,37,6,0,6,41
S01012011,Good health,290,23,3,20,54,24,38,38,58,40,5,1,4,10
S01012011,Fair health,74,6,0,6,13,5,13,8,11,16,1,1,0,1
S01012011,Bad health,26,3,0,3,4,2,1,4,7,3,2,2,0,0
S01012011,Very bad health,9,0,0,0,1,0,1,0,3,1,1,1,0,2
S01012012,All people aged 16 to 74,477,43,9,34,128,45,94,39,63,40,7,3,4,18
S01012012,Very good health,220,18,2,16,68,22,38,21,21,16,1,0,1,15
S01012012,Good health,187,18,6,12,42,14,47,12,29,17,5,2,3,3
S01012012,Fair health,52,6,1,5,14,6,8,5,8,5,0,0,0,0
S01012012,Bad health,14,1,0,1,3,3,0,1,4,1,1,1,0,0
S01012012,Very bad health,4,0,0,0,1,0,1,0,1,1,0,0,0,0
S01012013,All people aged 16 to 74,580,61,17,44,117,52,131,53,72,66,11,8,3,17
S01012013,Very good health,291,35,6,29,66,27,73,25,25,20,6,4,2,14
S01012013,Good health,220,17,6,11,39,17,47,22,37,33,5,4,1,3
S01012013,Fair health,46,7,5,2,9,6,8,4,7,5,0,0,0,0
S01012013,Bad health,21,2,0,2,3,2,3,2,2,7,0,0,0,0
S01012013,Very bad health,2,0,0,0,0,0,0,0,1,1,0,0,0,0
S01012014,All people aged 16 to 74,600,38,12,26,117,35,77,72,122,100,16,9,7,23
S01012014,Very good health,281,23,6,17,58,18,34,29,52,44,7,4,3,16
S01012014,Good health,229,10,4,6,42,12,29,35,58,37,0,0,0,6
S01012014,Fair health,70,4,1,3,15,4,12,5,9,14,6,3,3,1
S01012014,Bad health,14,1,1,0,2,1,1,2,3,3,1,1,0,0
S01012014,Very bad health,6,0,0,0,0,0,1,1,0,2,2,1,1,0
S01012015,All people aged 16 to 74,655,41,13,28,146,67,89,67,118,73,12,4,8,42
S01012015,Very good health,361,28,10,18,88,37,45,40,48,36,4,0,4,35
S01012015,Good health,216,7,1,6,44,26,28,19,52,29,4,0,4,7
S01012015,Fair health,57,6,2,4,9,3,13,5,13,6,2,2,0,0
S01012015,Bad health,17,0,0,0,3,1,3,1,5,2,2,2,0,0
S01012015,Very bad health,4,0,0,0,2,0,0,2,0,0,0,0,0,0
S01012016,All people aged 16 to 74,667,64,11,53,135,60,101,89,106,70,17,8,9,25
S01012016,Very good health,344,35,6,29,82,27,48,47,49,31,7,5,2,18
S01012016,Good health,227,17,5,12,37,22,32,33,43,30,7,1,6,6
S01012016,Fair health,76,9,0,9,12,11,18,6,11,7,2,1,1,0
S01012016,Bad health,19,3,0,3,3,0,3,3,3,2,1,1,0,1
S01012016,Very bad health,1,0,0,0,1,0,0,0,0,0,0,0,0,0
S01012017,All people aged 16 to 74,400,52,8,44,100,26,98,33,36,24,11,9,2,20
S01012017,Very good health,218,24,2,22,63,15,49,19,18,12,4,3,1,14
S01012017,Good health,124,23,5,18,30,8,33,6,12,5,2,1,1,5
S01012017,Fair health,39,4,1,3,3,2,15,4,4,4,3,3,0,0
S01012017,Bad health,13,0,0,0,2,0,1,3,2,3,2,2,0,0
S01012017,Very bad health,6,1,0,1,2,1,0,1,0,0,0,0,0,1
S01012018,All people aged 16 to 74,657,64,11,53,171,34,120,77,92,54,16,8,8,29
S01012018,Very good health,348,43,7,36,95,17,57,42,39,27,4,3,1,24
S01012018,Good health,224,15,2,13,61,11,40,24,41,21,7,3,4,4
S01012018,Fair health,68,5,2,3,15,3,19,7,9,4,5,2,3,1
S01012018,Bad health,14,1,0,1,0,3,3,4,2,1,0,0,0,0
S01012018,Very bad health,3,0,0,0,0,0,1,0,1,1,0,0,0,0
S01012019,All people aged 16 to 74,616,85,11,74,183,96,56,45,63,40,15,7,8,33
S01012019,Very good health,356,64,10,54,111,50,34,22,31,17,2,1,1,25
S01012019,Good health,189,18,1,17,59,30,16,17,23,13,6,1,5,7
S01012019,Fair health,53,3,0,3,11,12,3,4,6,8,5,3,2,1
S01012019,Bad health,13,0,0,0,2,3,2,2,2,1,1,1,0,0
S01012019,Very bad health,5,0,0,0,0,1,1,0,1,1,1,1,0,0
S01012020,All people aged 16 to 74,509,63,3,60,127,65,31,33,63,73,15,11,4,39
S01012020,Very good health,230,37,1,36,63,27,11,16,23,18,3,1,2,32
S01012020,Good health,169,19,2,17,47,29,10,15,16,23,3,1,2,7
S01012020,Fair health,66,4,0,4,9,6,7,1,20,14,5,5,0,0
S01012020,Bad health,30,1,0,1,6,2,2,0,3,14,2,2,0,0
S01012020,Very bad health,14,2,0,2,2,1,1,1,1,4,2,2,0,0
S01012021,All people aged 16 to 74,437,72,14,58,103,53,28,31,51,36,16,7,9,47
S01012021,Very good health,244,46,9,37,59,23,13,17,24,10,8,1,7,44
S01012021,Good health,153,22,3,19,38,25,14,10,19,18,5,3,2,2
S01012021,Fair health,27,3,1,2,3,3,1,3,8,5,0,0,0,1
S01012021,Bad health,9,1,1,0,3,0,0,0,0,3,2,2,0,0
S01012021,Very bad health,4,0,0,0,0,2,0,1,0,0,1,1,0,0
S01012022,All people aged 16 to 74,495,39,10,29,112,69,42,47,83,60,14,8,6,29
S01012022,Very good health,233,25,6,19,53,36,23,19,30,21,2,1,1,24
S01012022,Good health,185,13,4,9,46,21,16,22,38,17,7,3,4,5
S01012022,Fair health,45,0,0,0,8,8,2,2,10,12,3,2,1,0
S01012022,Bad health,28,0,0,0,4,4,1,4,5,8,2,2,0,0
S01012022,Very bad health,4,1,0,1,1,0,0,0,0,2,0,0,0,0
S01012023,All people aged 16 to 74,418,78,19,59,117,45,70,25,23,22,13,9,4,25
S01012023,Very good health,233,54,14,40,63,31,40,11,6,6,2,0,2,20
S01012023,Good health,124,20,5,15,38,11,19,10,7,9,6,4,2,4
S01012023,Fair health,44,2,0,2,13,2,8,3,6,5,4,4,0,1
S01012023,Bad health,14,2,0,2,3,1,3,1,3,1,0,0,0,0
S01012023,Very bad health,3,0,0,0,0,0,0,0,1,1,1,1,0,0
S01012024,All people aged 16 to 74,654,96,15,81,176,112,47,42,68,55,19,9,10,39
S01012024,Very good health,354,62,7,55,94,65,21,19,33,23,9,4,5,28
S01012024,Good health,217,26,6,20,60,35,18,14,29,19,7,3,4,9
S01012024,Fair health,58,5,1,4,18,10,6,4,3,9,2,1,1,1
S01012024,Bad health,17,2,0,2,3,2,0,5,2,2,1,1,0,0
S01012024,Very bad health,8,1,1,0,1,0,2,0,1,2,0,0,0,1
S01012025,All people aged 16 to 74,524,46,8,38,121,87,37,46,92,59,10,4,6,26
S01012025,Very good health,259,30,5,25,66,37,14,19,42,26,3,1,2,22
S01012025,Good health,162,10,2,8,39,31,14,17,31,14,3,2,1,3
S01012025,Fair health,65,3,0,3,12,10,9,6,10,11,3,0,3,1
S01012025,Bad health,28,3,1,2,2,7,0,4,6,6,0,0,0,0
S01012025,Very bad health,10,0,0,0,2,2,0,0,3,2,1,1,0,0
S01012026,All people aged 16 to 74,454,79,23,56,125,69,41,24,41,17,11,8,3,47
S01012026,Very good health,304,60,18,42,84,48,22,18,20,8,6,4,2,38
S01012026,Good health,119,18,5,13,33,18,16,4,13,5,4,3,1,8
S01012026,Fair health,26,1,0,1,7,2,3,2,8,1,1,1,0,1
S01012026,Bad health,5,0,0,0,1,1,0,0,0,3,0,0,0,0
S01012026,Very bad health,0,0,0,0,0,0,0,0,0,0,0,0,0,0
S01012027,All people aged 16 to 74,665,92,24,68,170,94,71,43,70,55,32,23,9,38
S01012027,Very good health,353,55,19,36,97,45,37,23,34,22,8,3,5,32
S01012027,Good health,195,26,2,24,54,35,26,11,15,15,7,5,2,6
S01012027,Fair health,79,8,2,6,12,10,7,8,11,11,12,10,2,0
S01012027,Bad health,24,3,1,2,3,3,1,1,7,5,1,1,0,0
S01012027,Very bad health,14,0,0,0,4,1,0,0,3,2,4,4,0,0
S01012028,All people aged 16 to 74,711,153,43,110,231,98,54,24,50,27,8,3,5,66
S01012028,Very good health,426,89,20,69,138,60,28,13,22,15,4,1,3,57
S01012028,Good health,221,54,18,36,68,29,20,8,21,11,2,1,1,8
S01012028,Fair health,51,8,4,4,19,8,5,3,5,1,1,1,0,1
S01012028,Bad health,10,1,1,0,5,1,1,0,1,0,1,0,1,0
S01012028,Very bad health,3,1,0,1,1,0,0,0,1,0,0,0,0,0
S01012029,All people aged 16 to 74,810,94,28,66,175,109,84,68,108,71,26,19,7,75
S01012029,Very good health,418,63,19,44,98,56,38,27,45,25,12,8,4,54
S01012029,Good health,237,22,7,15,52,29,31,26,38,15,6,5,1,18
S01012029,Fair health,99,6,1,5,20,10,9,11,16,20,5,4,1,2
S01012029,Bad health,41,3,1,2,2,10,4,4,6,8,3,2,1,1
S01012029,Very bad health,15,0,0,0,3,4,2,0,3,3,0,0,0,0
S01012030,All people aged 16 to 74,512,68,13,55,128,60,79,27,43,51,15,9,6,41
S01012030,Very good health,274,42,4,38,74,25,36,12,20,27,8,5,3,30
S01012030,Good health,170,20,6,14,38,28,33,12,15,11,3,1,2,10
S01012030,Fair health,50,6,3,3,13,5,8,0,6,8,3,2,1,1
S01012030,Bad health,13,0,0,0,3,2,2,1,1,4,0,0,0,0
S01012030,Very bad health,5,0,0,0,0,0,0,2,1,1,1,1,0,0
S01012031,All people aged 16 to 74,418,100,20,80,147,53,40,19,23,12,9,6,3,15
S01012031,Very good health,227,60,12,48,90,22,19,8,7,7,2,2,0,12
S01012031,Good health,143,26,5,21,48,21,17,9,13,3,3,0,3,3
S01012031,Fair health,36,12,3,9,7,6,4,0,2,1,4,4,0,0
S01012031,Bad health,7,1,0,1,2,2,0,1,0,1,0,0,0,0
S01012031,Very bad health,5,1,0,1,0,2,0,1,1,0,0,0,0,0
S01012032,All people aged 16 to 74,273,47,9,38,83,35,46,12,15,12,5,4,1,18
S01012032,Very good health,171,29,5,24,51,19,28,8,8,8,3,2,1,17
S01012032,Good health,74,15,4,11,26,9,13,3,4,2,1,1,0,1
S01012032,Fair health,18,2,0,2,4,4,4,0,2,2,0,0,0,0
S01012032,Bad health,10,1,0,1,2,3,1,1,1,0,1,1,0,0
S01012032,Very bad health,0,0,0,0,0,0,0,0,0,0,0,0,0,0
S01012033,All people aged 16 to 74,622,63,15,48,147,106,29,51,87,74,27,16,11,38
S01012033,Very good health,284,44,7,37,70,42,9,20,38,24,11,6,5,26
S01012033,Good health,223,13,4,9,50,44,13,17,34,33,9,5,4,10
S01012033,Fair health,71,4,3,1,15,8,5,10,10,12,5,3,2,2
S01012033,Bad health,28,0,0,0,9,6,2,4,2,3,2,2,0,0
S01012033,Very bad health,16,2,1,1,3,6,0,0,3,2,0,0,0,0
S01012034,All people aged 16 to 74,602,68,13,55,143,78,47,40,75,80,29,15,14,42
S01012034,Very good health,303,41,8,33,84,38,24,17,27,32,10,6,4,30
S01012034,Good health,190,20,5,15,37,25,13,15,28,26,15,7,8,11
S01012034,Fair health,81,6,0,6,20,9,8,6,14,14,3,1,2,1
S01012034,Bad health,21,1,0,1,1,5,2,2,4,5,1,1,0,0
S01012034,Very bad health,7,0,0,0,1,1,0,0,2,3,0,0,0,0
S01012035,All people aged 16 to 74,694,90,16,74,184,102,49,48,98,57,28,20,8,38
S01012035,Very good health,339,60,7,53,95,45,19,21,45,16,9,7,2,29
S01012035,Good health,252,21,5,16,76,39,23,23,33,20,8,4,4,9
S01012035,Fair health,77,7,4,3,12,12,7,4,14,12,9,7,2,0
S01012035,Bad health,23,2,0,2,1,6,0,0,5,8,1,1,0,0
S01012035,Very bad health,3,0,0,0,0,0,0,0,1,1,1,1,0,0
S01012036,All people aged 16 to 74,665,78,15,63,186,113,38,43,71,56,20,14,6,60
S01012036,Very good health,355,43,6,37,109,54,16,25,32,22,5,5,0,49
S01012036,Good health,224,27,8,19,50,44,16,14,31,22,13,7,6,7
S01012036,Fair health,63,7,1,6,19,12,6,3,6,6,1,1,0,3
S01012036,Bad health,20,0,0,0,8,3,0,1,1,6,0,0,0,1
S01012036,Very bad health,3,1,0,1,0,0,0,0,1,0,1,1,0,0
S01012037,All people aged 16 to 74,697,25,4,21,98,99,24,67,135,134,56,28,28,59
S01012037,Very good health,285,12,2,10,40,46,11,23,52,38,23,10,13,40
S01012037,Good health,232,6,2,4,40,31,7,22,44,46,19,10,9,17
S01012037,Fair health,113,3,0,3,13,15,2,11,30,28,9,4,5,2
S01012037,Bad health,49,4,0,4,5,4,2,10,6,15,3,2,1,0
S01012037,Very bad health,18,0,0,0,0,3,2,1,3,7,2,2,0,0
S01012038,All people aged 16 to 74,607,10,1,9,49,55,20,53,134,154,84,54,30,48
S01012038,Very good health,253,5,0,5,23,25,6,16,49,61,35,24,11,33
S01012038,Good health,181,5,1,4,16,17,11,17,42,38,23,10,13,12
S01012038,Fair health,101,0,0,0,3,11,1,9,23,32,19,13,6,3
S01012038,Bad health,50,0,0,0,6,0,1,9,12,17,5,5,0,0
S01012038,Very bad health,22,0,0,0,1,2,1,2,8,6,2,2,0,0
S01012039,All people aged 16 to 74,740,21,7,14,88,101,39,81,147,159,54,37,17,50
S01012039,Very good health,309,11,0,11,45,55,16,24,46,51,19,11,8,42
S01012039,Good health,261,8,5,3,31,23,13,30,67,63,20,15,5,6
S01012039,Fair health,104,2,2,0,6,18,9,13,22,23,9,7,2,2
S01012039,Bad health,46,0,0,0,5,3,1,9,8,16,4,2,2,0
S01012039,Very bad health,20,0,0,0,1,2,0,5,4,6,2,2,0,0
S01012040,All people aged 16 to 74,524,46,16,30,132,86,36,43,66,42,18,13,5,55
S01012040,Very good health,283,23,7,16,66,51,14,29,31,20,8,7,1,41
S01012040,Good health,156,19,7,12,44,25,14,11,14,13,4,1,3,12
S01012040,Fair health,52,1,0,1,18,7,3,2,11,5,3,2,1,2
S01012040,Bad health,25,2,1,1,3,3,5,0,6,3,3,3,0,0
S01012040,Very bad health,8,1,1,0,1,0,0,1,4,1,0,0,0,0
S01012041,All people aged 16 to 74,646,27,9,18,121,96,33,62,122,96,29,15,14,60
S01012041,Very good health,285,13,3,10,61,46,18,27,41,31,9,4,5,39
S01012041,Good health,215,10,5,5,32,34,6,22,47,40,12,7,5,12
S01012041,Fair health,106,2,0,2,18,14,8,11,20,18,7,3,4,8
S01012041,Bad health,27,2,1,1,6,1,1,2,8,5,1,1,0,1
S01012041,Very bad health,13,0,0,0,4,1,0,0,6,2,0,0,0,0
S01012042,All people aged 16 to 74,675,23,2,21,101,88,47,68,142,125,36,22,14,45
S01012042,Very good health,310,12,0,12,45,48,24,26,59,45,15,9,6,36
S01012042,Good health,224,6,1,5,29,30,18,23,55,48,9,4,5,6
S01012042,Fair health,98,3,0,3,19,7,5,15,19,22,5,2,3,3
S01012042,Bad health,35,2,1,1,6,1,0,3,9,9,5,5,0,0
S01012042,Very bad health,8,0,0,0,2,2,0,1,0,1,2,2,0,0
S01012043,All people aged 16 to 74,658,22,6,16,103,68,30,65,131,137,66,46,20,36
S01012043,Very good health,286,12,5,7,54,26,10,27,58,45,27,18,9,27
S01012043,Good health,218,6,1,5,31,35,13,23,49,39,17,8,9,5
S01012043,Fair health,101,3,0,3,12,3,5,11,17,29,17,16,1,4
S01012043,Bad health,38,1,0,1,3,3,1,3,5,19,3,2,1,0
S01012043,Very bad health,15,0,0,0,3,1,1,1,2,5,2,2,0,0
S01012044,All people aged 16 to 74,654,22,10,12,87,83,32,40,144,158,51,29,22,37
S01012044,Very good health,234,12,3,9,39,34,11,9,41,36,21,11,10,31
S01012044,Good health,208,7,4,3,32,29,13,14,46,45,18,8,10,4
S01012044,Fair health,126,2,2,0,10,12,5,11,38,41,5,3,2,2
S01012044,Bad health,57,1,1,0,2,6,3,3,12,26,4,4,0,0
S01012044,Very bad health,29,0,0,0,4,2,0,3,7,10,3,3,0,0
S01012045,All people aged 16 to 74,828,51,13,38,141,116,41,79,137,125,77,48,29,61
S01012045,Very good health,371,34,9,25,81,60,14,34,45,40,20,14,6,43
S01012045,Good health,257,10,2,8,47,38,16,18,49,37,28,16,12,14
S01012045,Fair health,128,3,1,2,8,13,9,17,24,25,25,16,9,4
S01012045,Bad health,55,3,1,2,4,5,1,8,14,16,4,2,2,0
S01012045,Very bad health,17,1,0,1,1,0,1,2,5,7,0,0,0,0
S01012046,All people aged 16 to 74,502,13,2,11,59,63,21,56,99,94,61,43,18,36
S01012046,Very good health,197,7,1,6,30,31,7,15,36,30,12,9,3,29
S01012046,Good health,154,5,1,4,17,16,10,17,34,25,26,17,9,4
S01012046,Fair health,85,1,0,1,6,15,3,11,14,17,15,9,6,3
S01012046,Bad health,49,0,0,0,5,1,1,10,13,14,5,5,0,0
S01012046,Very bad health,17,0,0,0,1,0,0,3,2,8,3,3,0,0
S01012047,All people aged 16 to 74,667,16,4,12,97,82,36,64,129,140,65,40,25,38
S01012047,Very good health,284,11,1,10,50,43,19,28,54,40,18,9,9,21
S01012047,Good health,198,4,3,1,25,26,9,18,41,45,20,11,9,10
S01012047,Fair health,105,0,0,0,7,7,4,12,22,34,14,8,6,5
S01012047,Bad health,62,1,0,1,14,5,2,5,11,16,6,5,1,2
S01012047,Very bad health,18,0,0,0,1,1,2,1,1,5,7,7,0,0
S01012048,All people aged 16 to 74,512,16,1,15,63,80,27,55,114,85,45,35,10,27
S01012048,Very good health,207,9,0,9,27,30,8,19,52,24,18,13,5,20
S01012048,Good health,169,7,1,6,21,34,13,18,30,24,15,10,5,7
S01012048,Fair health,87,0,0,0,10,11,4,11,18,24,9,9,0,0
S01012048,Bad health,34,0,0,0,2,5,1,5,12,7,2,2,0,0
S01012048,Very bad health,15,0,0,0,3,0,1,2,2,6,1,1,0,0
S01012049,All people aged 16 to 74,527,31,8,23,104,90,34,48,91,71,25,16,9,33
S01012049,Very good health,238,17,3,14,54,46,14,27,35,20,4,1,3,21
S01012049,Good health,184,10,4,6,40,34,15,10,37,22,8,5,3,8
S01012049,Fair health,76,3,1,2,9,8,4,9,12,20,7,6,1,4
S01012049,Bad health,20,0,0,0,0,2,1,2,6,7,2,2,0,0
S01012049,Very bad health,9,1,0,1,1,0,0,0,1,2,4,2,2,0
S01012050,All people aged 16 to 74,776,48,17,31,161,147,41,62,113,98,43,25,18,63
S01012050,Very good health,388,25,8,17,93,83,19,32,46,30,11,7,4,49
S01012050,Good health,235,18,7,11,50,48,9,18,39,26,16,6,10,11
S01012050,Fair health,105,3,1,2,13,12,11,9,19,22,13,9,4,3
S01012050,Bad health,38,1,0,1,4,4,2,1,8,16,2,2,0,0
S01012050,Very bad health,10,1,1,0,1,0,0,2,1,4,1,1,0,0
S01012051,All people aged 16 to 74,365,30,5,25,94,65,28,24,46,35,15,10,5,28
S01012051,Very good health,186,18,4,14,57,23,17,13,17,11,7,4,3,23
S01012051,Good health,110,10,1,9,27,24,5,4,20,9,6,4,2,5
S01012051,Fair health,47,2,0,2,7,13,4,5,5,10,1,1,0,0
S01012051,Bad health,18,0,0,0,1,3,2,2,4,5,1,1,0,0
S01012051,Very bad health,4,0,0,0,2,2,0,0,0,0,0,0,0,0
S01012052,All people aged 16 to 74,660,25,6,19,124,100,28,67,144,104,30,17,13,38
S01012052,Very good health,280,14,4,10,61,54,10,22,56,32,6,2,4,25
S01012052,Good health,234,10,2,8,40,30,12,23,54,44,11,5,6,10
S01012052,Fair health,91,1,0,1,18,12,5,14,20,12,6,3,3,3
S01012052,Bad health,44,0,0,0,4,3,0,6,10,16,5,5,0,0
S01012052,Very bad health,11,0,0,0,1,1,1,2,4,0,2,2,0,0
S01012053,All people aged 16 to 74,662,17,4,13,97,90,28,91,147,104,45,23,22,43
S01012053,Very good health,287,10,2,8,52,38,9,32,61,36,16,7,9,33
S01012053,Good health,234,4,2,2,34,29,11,35,59,35,19,9,10,8
S01012053,Fair health,93,2,0,2,6,18,2,15,20,22,7,4,3,1
S01012053,Bad health,34,0,0,0,4,4,3,8,6,5,3,3,0,1
S01012053,Very bad health,14,1,0,1,1,1,3,1,1,6,0,0,0,0
S01012054,All people aged 16 to 74,615,14,2,12,67,61,27,66,131,122,81,32,49,46
S01012054,Very good health,261,6,1,5,32,26,12,21,52,52,29,11,18,31
S01012054,Good health,197,7,1,6,21,23,7,19,50,31,26,9,17,13
S01012054,Fair health,103,1,0,1,11,4,4,13,22,29,18,7,11,1
S01012054,Bad health,42,0,0,0,2,7,4,11,5,7,5,3,2,1
S01012054,Very bad health,12,0,0,0,1,1,0,2,2,3,3,2,1,0
S01012055,All people aged 16 to 74,622,22,5,17,86,84,29,73,131,130,33,14,19,34
S01012055,Very good health,243,11,1,10,41,37,9,30,50,31,7,1,6,27
S01012055,Good health,207,8,3,5,31,26,13,23,50,43,7,2,5,6
S01012055,Fair health,103,2,0,2,8,14,5,11,21,27,14,7,7,1
S01012055,Bad health,56,1,1,0,4,6,2,7,10,21,5,4,1,0
S01012055,Very bad health,13,0,0,0,2,1,0,2,0,8,0,0,0,0
S01012056,All people aged 16 to 74,592,51,8,43,125,98,37,57,83,68,16,11,5,57
S01012056,Very good health,314,26,2,24,75,55,22,27,29,27,4,2,2,49
S01012056,Good health,177,16,2,14,36,32,9,19,32,19,6,3,3,8
S01012056,Fair health,69,5,3,2,12,9,6,7,15,13,2,2,0,0
S01012056,Bad health,24,3,0,3,2,2,0,3,6,5,3,3,0,0
S01012056,Very bad health,8,1,1,0,0,0,0,1,1,4,1,1,0,0
S01012057,All people aged 16 to 74,576,65,17,48,177,107,33,40,53,34,17,7,10,50
S01012057,Very good health,304,37,7,30,89,60,10,24,24,16,3,0,3,41
S01012057,Good health,200,21,7,14,70,29,19,9,25,10,9,2,7,8
S01012057,Fair health,60,4,1,3,18,14,3,7,4,6,3,3,0,1
S01012057,Bad health,10,3,2,1,0,2,1,0,0,2,2,2,0,0
S01012057,Very bad health,2,0,0,0,0,2,0,0,0,0,0,0,0,0
S01012058,All people aged 16 to 74,558,57,12,45,157,94,46,30,68,44,14,8,6,48
S01012058,Very good health,281,28,5,23,89,49,16,13,31,17,2,1,1,36
S01012058,Good health,197,24,7,17,50,33,20,8,24,18,8,4,4,12
S01012058,Fair health,60,4,0,4,15,8,6,6,10,7,4,3,1,0
S01012058,Bad health,18,1,0,1,3,4,3,3,2,2,0,0,0,0
S01012058,Very bad health,2,0,0,0,0,0,1,0,1,0,0,0,0,0
S01012059,All people aged 16 to 74,628,21,5,16,82,84,43,57,120,130,44,27,17,47
S01012059,Very good health,238,10,3,7,30,36,19,24,37,40,14,7,7,28
S01012059,Good health,221,10,2,8,34,32,13,22,42,41,11,5,6,16
S01012059,Fair health,113,1,0,1,10,9,6,3,34,35,12,9,3,3
S01012059,Bad health,40,0,0,0,6,4,5,7,3,9,6,5,1,0
S01012059,Very bad health,16,0,0,0,2,3,0,1,4,5,1,1,0,0
S01012060,All people aged 16 to 74,620,37,8,29,118,84,36,48,111,96,50,35,15,40
S01012060,Very good health,278,23,5,18,68,39,18,16,40,27,13,6,7,34
S01012060,Good health,202,12,3,9,37,27,9,16,42,37,18,10,8,4
S01012060,Fair health,93,1,0,1,10,13,8,11,20,15,14,14,0,1
S01012060,Bad health,36,1,0,1,2,4,0,3,8,14,4,4,0,0
S01012060,Very bad health,11,0,0,0,1,1,1,2,1,3,1,1,0,1
S01012061,All people aged 16 to 74,760,100,26,74,221,108,45,51,80,62,41,26,15,52
S01012061,Very good health,388,67,14,53,115,61,19,22,31,21,9,3,6,43
S01012061,Good health,265,25,10,15,86,37,14,12,31,27,26,18,8,7
S01012061,Fair health,76,6,1,5,14,7,9,13,11,10,4,4,0,2
S01012061,Bad health,26,2,1,1,5,3,1,4,5,4,2,1,1,0
S01012061,Very bad health,5,0,0,0,1,0,2,0,2,0,0,0,0,0
S01012062,All people aged 16 to 74,656,51,16,35,172,110,50,61,89,51,9,5,4,63
S01012062,Very good health,346,30,9,21,89,53,25,29,42,19,6,3,3,53
S01012062,Good health,233,15,4,11,66,40,19,25,32,24,3,2,1,9
S01012062,Fair health,52,5,3,2,13,11,3,6,7,6,0,0,0,1
S01012062,Bad health,19,1,0,1,4,5,3,1,4,1,0,0,0,0
S01012062,Very bad health,6,0,0,0,0,1,0,0,4,1,0,0,0,0
S01012063,All people aged 16 to 74,398,24,3,21,89,56,29,41,77,44,14,8,6,24
S01012063,Very good health,188,13,1,12,49,33,16,15,25,18,2,0,2,17
S01012063,Good health,154,9,2,7,28,17,9,22,37,17,9,5,4,6
S01012063,Fair health,36,2,0,2,7,5,1,3,8,7,2,2,0,1
S01012063,Bad health,17,0,0,0,4,1,2,1,6,2,1,1,0,0
S01012063,Very bad health,3,0,0,0,1,0,1,0,1,0,0,0,0,0
S01012064,All people aged 16 to 74,468,15,4,11,33,41,11,41,69,114,105,75,30,39
S01012064,Very good health,192,8,2,6,23,22,6,15,23,32,38,22,16,25
S01012064,Good health,149,6,1,5,8,13,3,14,31,35,29,18,11,10
S01012064,Fair health,74,0,0,0,1,3,0,5,8,32,23,20,3,2
S01012064,Bad health,45,1,1,0,1,3,2,6,6,13,11,11,0,2
S01012064,Very bad health,8,0,0,0,0,0,0,1,1,2,4,4,0,0
S01012065,All people aged 16 to 74,409,4,1,3,21,21,5,24,89,105,99,80,19,41
S01012065,Very good health,143,2,0,2,9,10,2,7,31,24,31,24,7,27
S01012065,Good health,132,2,1,1,8,7,2,6,32,33,29,26,3,13
S01012065,Fair health,64,0,0,0,1,0,0,7,15,22,19,12,7,0
S01012065,Bad health,54,0,0,0,3,3,1,4,8,16,18,16,2,1
S01012065,Very bad health,16,0,0,0,0,1,0,0,3,10,2,2,0,0
S01012066,All people aged 16 to 74,619,16,5,11,65,67,23,47,146,141,66,45,21,48
S01012066,Very good health,261,11,4,7,38,31,6,25,61,34,25,17,8,30
S01012066,Good health,194,4,1,3,19,24,12,12,48,51,11,3,8,13
S01012066,Fair health,91,0,0,0,6,9,3,5,24,27,16,12,4,1
S01012066,Bad health,50,0,0,0,2,0,2,3,10,21,11,10,1,1
S01012066,Very bad health,23,1,0,1,0,3,0,2,3,8,3,3,0,3
S01012067,All people aged 16 to 74,405,3,0,3,36,30,7,25,110,96,69,43,26,29
S01012067,Very good health,145,0,0,0,17,11,4,9,38,29,18,10,8,19
S01012067,Good health,120,1,0,1,10,7,0,11,34,29,20,11,9,8
S01012067,Fair health,90,1,0,1,4,10,3,5,23,26,16,8,8,2
S01012067,Bad health,40,1,0,1,5,2,0,0,10,9,13,12,1,0
S01012067,Very bad health,10,0,0,0,0,0,0,0,5,3,2,2,0,0
S01012068,All people aged 16 to 74,403,3,1,2,17,36,12,32,71,96,91,70,21,45
S01012068,Very good health,138,0,0,0,8,20,6,11,20,19,27,21,6,27
S01012068,Good health,103,1,0,1,2,11,1,7,23,25,21,13,8,12
S01012068,Fair health,94,0,0,0,4,3,5,8,15,25,29,22,7,5
S01012068,Bad health,60,2,1,1,2,1,0,6,11,24,13,13,0,1
S01012068,Very bad health,8,0,0,0,1,1,0,0,2,3,1,1,0,0
S01012069,All people aged 16 to 74,387,7,3,4,63,39,14,23,80,79,57,32,25,25
S01012069,Very good health,125,2,1,1,40,13,8,6,20,7,16,4,12,13
S01012069,Good health,122,4,2,2,16,18,4,5,25,28,15,9,6,7
S01012069,Fair health,85,1,0,1,4,4,2,8,20,25,17,11,6,4
S01012069,Bad health,40,0,0,0,3,3,0,3,12,12,7,6,1,0
S01012069,Very bad health,15,0,0,0,0,1,0,1,3,7,2,2,0,1
S01012070,All people aged 16 to 74,546,14,4,10,48,58,19,41,105,131,81,43,38,49
S01012070,Very good health,185,2,2,0,26,20,4,11,30,39,24,14,10,29
S01012070,Good health,183,10,2,8,13,13,8,15,34,48,35,16,19,7
S01012070,Fair health,110,1,0,1,6,15,5,9,24,23,17,9,8,10
S01012070,Bad health,52,0,0,0,2,9,2,4,12,17,5,4,1,1
S01012070,Very bad health,16,1,0,1,1,1,0,2,5,4,0,0,0,2
S01012071,All people aged 16 to 74,836,28,2,26,104,98,38,85,152,177,89,59,30,65
S01012071,Very good health,311,11,1,10,45,46,15,29,47,49,30,14,16,39
S01012071,Good health,267,9,0,9,35,31,9,24,62,50,30,19,11,17
S01012071,Fair health,173,5,0,5,18,10,9,17,35,53,17,16,1,9
S01012071,Bad health,62,3,1,2,4,7,4,14,6,16,8,8,0,0
S01012071,Very bad health,23,0,0,0,2,4,1,1,2,9,4,2,2,0
S01012072,All people aged 16 to 74,863,45,5,40,116,81,42,53,173,160,118,82,36,75
S01012072,Very good health,341,24,3,21,65,39,11,22,56,56,29,17,12,39
S01012072,Good health,275,17,1,16,35,24,17,14,49,47,39,25,14,33
S01012072,Fair health,162,2,1,1,10,14,10,8,44,36,35,27,8,3
S01012072,Bad health,61,1,0,1,4,4,3,8,18,12,11,9,2,0
S01012072,Very bad health,24,1,0,1,2,0,1,1,6,9,4,4,0,0
S01012073,All people aged 16 to 74,538,54,8,46,142,74,29,47,74,51,24,12,12,43
S01012073,Very good health,306,40,5,35,80,40,15,27,38,22,8,4,4,36
S01012073,Good health,156,10,3,7,49,20,11,11,25,19,6,1,5,5
S01012073,Fair health,52,3,0,3,8,10,2,7,6,8,8,6,2,0
S01012073,Bad health,17,1,0,1,5,2,0,2,2,2,1,1,0,2
S01012073,Very bad health,7,0,0,0,0,2,1,0,3,0,1,0,1,0
S01012074,All people aged 16 to 74,545,49,16,33,153,105,39,50,47,39,14,9,5,49
S01012074,Very good health,314,34,11,23,97,57,19,27,20,15,6,3,3,39
S01012074,Good health,178,12,4,8,52,37,12,18,20,14,4,2,2,9
S01012074,Fair health,38,3,1,2,4,4,7,4,3,9,3,3,0,1
S01012074,Bad health,13,0,0,0,0,5,1,1,4,1,1,1,0,0
S01012074,Very bad health,2,0,0,0,0,2,0,0,0,0,0,0,0,0
S01012075,All people aged 16 to 74,574,65,22,43,138,108,49,47,46,42,7,3,4,72
S01012075,Very good health,374,41,13,28,94,66,28,34,24,23,2,0,2,62
S01012075,Good health,147,18,5,13,37,32,12,9,16,12,2,0,2,9
S01012075,Fair health,39,5,4,1,4,8,6,4,4,5,2,2,0,1
S01012075,Bad health,11,1,0,1,2,2,2,0,2,1,1,1,0,0
S01012075,Very bad health,3,0,0,0,1,0,1,0,0,1,0,0,0,0
S01012076,All people aged 16 to 74,531,38,8,30,130,93,29,41,94,54,24,17,7,28
S01012076,Very good health,263,21,3,18,72,55,10,20,37,18,12,7,5,18
S01012076,Good health,152,10,3,7,39,24,10,13,31,13,6,4,2,6
S01012076,Fair health,76,6,2,4,14,10,6,6,19,11,3,3,0,1
S01012076,Bad health,29,1,0,1,5,4,2,1,4,8,2,2,0,2
S01012076,Very bad health,11,0,0,0,0,0,1,1,3,4,1,1,0,1
S01012077,All people aged 16 to 74,561,20,2,18,84,84,22,39,119,113,36,21,15,44
S01012077,Very good health,255,9,0,9,49,45,11,13,51,34,14,6,8,29
S01012077,Good health,195,10,2,8,21,26,5,18,44,45,13,8,5,13
S01012077,Fair health,73,1,0,1,8,10,3,3,16,22,8,6,2,2
S01012077,Bad health,27,0,0,0,5,3,2,3,5,8,1,1,0,0
S01012077,Very bad health,11,0,0,0,1,0,1,2,3,4,0,0,0,0
S01012078,All people aged 16 to 74,673,42,13,29,146,125,36,51,81,95,45,26,19,52
S01012078,Very good health,310,24,9,15,69,55,14,27,33,39,16,7,9,33
S01012078,Good health,251,13,4,9,59,52,18,12,32,35,13,8,5,17
S01012078,Fair health,90,5,0,5,14,16,2,9,15,17,11,7,4,1
S01012078,Bad health,12,0,0,0,3,2,0,3,1,1,2,1,1,0
S01012078,Very bad health,10,0,0,0,1,0,2,0,0,3,3,3,0,1
S01012079,All people aged 16 to 74,671,30,10,20,78,104,38,68,122,140,46,26,20,45
S01012079,Very good health,249,13,4,9,36,39,12,25,42,41,16,7,9,25
S01012079,Good health,265,11,3,8,33,42,16,24,56,54,13,9,4,16
S01012079,Fair health,106,6,3,3,6,17,6,11,17,27,12,5,7,4
S01012079,Bad health,38,0,0,0,3,4,2,4,6,14,5,5,0,0
S01012079,Very bad health,13,0,0,0,0,2,2,4,1,4,0,0,0,0
S01012080,All people aged 16 to 74,549,16,3,13,70,66,22,44,121,100,67,41,26,43
S01012080,Very good health,235,9,1,8,31,30,7,21,55,30,22,14,8,30
S01012080,Good health,186,6,2,4,22,26,10,15,34,39,25,13,12,9
S01012080,Fair health,97,1,0,1,13,9,4,5,23,23,15,11,4,4
S01012080,Bad health,22,0,0,0,3,0,0,2,7,6,4,2,2,0
S01012080,Very bad health,9,0,0,0,1,1,1,1,2,2,1,1,0,0
S01012081,All people aged 16 to 74,542,8,2,6,64,61,25,53,125,114,61,34,27,31
S01012081,Very good health,204,7,2,5,27,22,12,19,49,38,14,10,4,16
S01012081,Good health,181,0,0,0,23,23,8,18,41,38,21,6,15,9
S01012081,Fair health,107,1,0,1,10,12,5,12,26,21,16,11,5,4
S01012081,Bad health,36,0,0,0,3,4,0,1,6,13,8,6,2,1
S01012081,Very bad health,14,0,0,0,1,0,0,3,3,4,2,1,1,1
S01012082,All people aged 16 to 74,451,9,0,9,54,58,18,46,101,97,49,29,20,19
S01012082,Very good health,158,4,0,4,18,26,3,19,34,28,12,8,4,14
S01012082,Good health,159,2,0,2,24,18,8,16,40,34,12,3,9,5
S01012082,Fair health,92,2,0,2,6,7,7,9,21,24,16,9,7,0
S01012082,Bad health,31,1,0,1,5,6,0,1,4,8,6,6,0,0
S01012082,Very bad health,11,0,0,0,1,1,0,1,2,3,3,3,0,0
S01012083,All people aged 16 to 74,532,12,3,9,78,70,18,52,120,116,35,13,22,31
S01012083,Very good health,182,7,2,5,34,23,7,13,46,22,9,3,6,21
S01012083,Good health,179,3,1,2,31,26,7,17,41,39,10,1,9,5
S01012083,Fair health,99,2,0,2,7,16,3,6,18,31,12,7,5,4
S01012083,Bad health,50,0,0,0,4,4,1,12,9,17,3,2,1,0
S01012083,Very bad health,22,0,0,0,2,1,0,4,6,7,1,0,1,1
S01012084,All people aged 16 to 74,440,22,10,12,97,82,29,48,62,62,9,6,3,29
S01012084,Very good health,246,14,8,6,44,49,18,32,27,35,4,2,2,23
S01012084,Good health,135,5,0,5,34,28,10,13,23,17,1,1,0,4
S01012084,Fair health,43,2,2,0,15,1,1,2,11,6,4,3,1,1
S01012084,Bad health,14,1,0,1,3,3,0,1,1,4,0,0,0,1
S01012084,Very bad health,2,0,0,0,1,1,0,0,0,0,0,0,0,0
S01012085,All people aged 16 to 74,539,39,12,27,106,110,22,45,94,75,13,8,5,35
S01012085,Very good health,253,21,4,17,56,46,9,27,37,27,6,3,3,24
S01012085,Good health,193,15,6,9,35,49,5,15,35,25,4,3,1,10
S01012085,Fair health,65,2,1,1,10,11,6,2,17,14,2,1,1,1
S01012085,Bad health,25,0,0,0,5,4,2,1,4,8,1,1,0,0
S01012085,Very bad health,3,1,1,0,0,0,0,0,1,1,0,0,0,0
S01012086,All people aged 16 to 74,670,18,6,12,104,106,24,64,140,120,57,32,25,37
S01012086,Very good health,258,8,1,7,52,52,13,27,44,33,8,3,5,21
S01012086,Good health,265,7,4,3,30,39,5,29,68,43,30,14,16,14
S01012086,Fair health,90,1,0,1,17,11,4,5,15,24,12,8,4,1
S01012086,Bad health,41,1,1,0,5,4,1,2,10,15,2,2,0,1
S01012086,Very bad health,16,1,0,1,0,0,1,1,3,5,5,5,0,0
S01012087,All people aged 16 to 74,504,19,9,10,96,80,22,41,100,85,29,13,16,32
S01012087,Very good health,221,6,2,4,46,36,12,23,40,28,5,2,3,25
S01012087,Good health,182,8,3,5,37,28,3,14,40,32,13,5,8,7
S01012087,Fair health,67,4,3,1,7,9,6,4,16,14,7,2,5,0
S01012087,Bad health,29,0,0,0,5,7,1,0,4,10,2,2,0,0
S01012087,Very bad health,5,1,1,0,1,0,0,0,0,1,2,2,0,0
S01012088,All people aged 16 to 74,535,51,15,36,145,83,32,51,65,41,24,16,8,43
S01012088,Very good health,295,28,9,19,94,42,19,27,36,12,6,3,3,31
S01012088,Good health,169,17,6,11,43,33,11,11,21,15,8,5,3,10
S01012088,Fair health,52,4,0,4,5,6,2,9,6,9,9,7,2,2
S01012088,Bad health,13,2,0,2,3,1,0,4,1,1,1,1,0,0
S01012088,Very bad health,6,0,0,0,0,1,0,0,1,4,0,0,0,0
S01012089,All people aged 16 to 74,648,58,15,43,212,140,38,49,59,36,16,9,7,40
S01012089,Very good health,366,33,6,27,128,74,22,24,28,17,8,4,4,32
S01012089,Good health,200,17,7,10,55,52,10,18,21,16,3,1,2,8
S01012089,Fair health,61,5,1,4,22,13,6,4,8,2,1,0,1,0
S01012089,Bad health,17,2,0,2,6,1,0,2,2,0,4,4,0,0
S01012089,Very bad health,4,1,1,0,1,0,0,1,0,1,0,0,0,0
S01012090,All people aged 16 to 74,708,105,21,84,248,117,47,41,49,33,13,6,7,55
S01012090,Very good health,386,64,11,53,135,67,25,15,21,14,7,3,4,38
S01012090,Good health,242,31,7,24,81,37,16,21,21,15,5,3,2,15
S01012090,Fair health,57,7,2,5,26,11,4,3,1,2,1,0,1,2
S01012090,Bad health,21,3,1,2,6,2,2,1,6,1,0,0,0,0
S01012090,Very bad health,2,0,0,0,0,0,0,1,0,1,0,0,0,0
S01012091,All people aged 16 to 74,429,27,10,17,106,78,22,41,70,36,14,10,4,35
S01012091,Very good health,233,14,6,8,62,40,11,24,30,15,4,3,1,33
S01012091,Good health,136,10,3,7,35,27,6,11,28,13,4,3,1,2
S01012091,Fair health,45,3,1,2,7,9,3,6,6,7,4,2,2,0
S01012091,Bad health,13,0,0,0,2,2,2,0,5,0,2,2,0,0
S01012091,Very bad health,2,0,0,0,0,0,0,0,1,1,0,0,0,0
S01012092,All people aged 16 to 74,407,48,16,32,100,78,27,34,52,35,7,4,3,26
S01012092,Very good health,197,26,9,17,55,34,13,7,26,15,1,0,1,20
S01012092,Good health,154,17,7,10,34,35,10,18,23,11,2,1,1,4
S01012092,Fair health,45,4,0,4,10,8,3,6,3,8,1,0,1,2
S01012092,Bad health,6,0,0,0,1,1,1,1,0,0,2,2,0,0
S01012092,Very bad health,5,1,0,1,0,0,0,2,0,1,1,1,0,0
S01012093,All people aged 16 to 74,435,49,10,39,110,82,32,33,54,50,10,4,6,15
S01012093,Very good health,223,26,5,21,66,38,13,16,27,21,3,0,3,13
S01012093,Good health,146,20,4,16,33,31,14,11,17,17,2,0,2,1
S01012093,Fair health,48,3,1,2,8,10,4,5,5,10,2,1,1,1
S01012093,Bad health,16,0,0,0,2,3,1,0,5,2,3,3,0,0
S01012093,Very bad health,2,0,0,0,1,0,0,1,0,0,0,0,0,0
S01012094,All people aged 16 to 74,582,94,20,74,195,88,51,32,50,25,6,3,3,41
S01012094,Very good health,340,64,11,53,111,55,25,18,23,8,5,2,3,31
S01012094,Good health,182,24,7,17,66,23,19,12,16,14,1,1,0,7
S01012094,Fair health,50,6,2,4,16,9,5,1,8,2,0,0,0,3
S01012094,Bad health,9,0,0,0,2,1,1,1,3,1,0,0,0,0
S01012094,Very bad health,1,0,0,0,0,0,1,0,0,0,0,0,0,0
S01012095,All people aged 16 to 74,838,53,16,37,167,127,44,74,126,116,41,26,15,90
S01012095,Very good health,423,27,9,18,95,69,17,36,53,50,10,3,7,66
S01012095,Good health,278,21,4,17,54,42,18,18,50,37,17,12,5,21
S01012095,Fair health,96,3,2,1,12,11,5,14,19,18,11,8,3,3
S01012095,Bad health,33,2,1,1,4,5,2,6,3,9,2,2,0,0
S01012095,Very bad health,8,0,0,0,2,0,2,0,1,2,1,1,0,0
S01012096,All people aged 16 to 74,667,14,3,11,102,82,31,60,166,120,39,20,19,53
S01012096,Very good health,265,8,3,5,42,32,10,22,61,40,14,7,7,36
S01012096,Good health,219,4,0,4,38,26,11,19,60,39,13,3,10,9
S01012096,Fair health,117,2,0,2,14,19,8,11,24,24,7,5,2,8
S01012096,Bad health,50,0,0,0,7,3,1,7,17,12,3,3,0,0
S01012096,Very bad health,16,0,0,0,1,2,1,1,4,5,2,2,0,0
S01012097,All people aged 16 to 74,489,12,3,9,69,80,24,44,105,90,35,18,17,30
S01012097,Very good health,189,7,2,5,33,29,4,18,37,33,7,5,2,21
S01012097,Good health,191,3,0,3,31,29,17,17,40,33,13,4,9,8
S01012097,Fair health,76,2,1,1,4,14,3,6,22,14,11,5,6,0
S01012097,Bad health,22,0,0,0,0,7,0,3,2,8,2,2,0,0
S01012097,Very bad health,11,0,0,0,1,1,0,0,4,2,2,2,0,1
S01012098,All people aged 16 to 74,466,11,5,6,69,59,21,41,97,100,26,13,13,42
S01012098,Very good health,201,5,3,2,35,30,8,17,31,30,11,7,4,34
S01012098,Good health,156,2,1,1,18,23,5,15,38,42,7,2,5,6
S01012098,Fair health,77,2,1,1,12,4,4,7,21,19,6,2,4,2
S01012098,Bad health,27,1,0,1,3,2,3,2,6,8,2,2,0,0
S01012098,Very bad health,5,1,0,1,1,0,1,0,1,1,0,0,0,0
S01012099,All people aged 16 to 74,583,16,6,10,63,75,16,50,143,126,45,22,23,49
S01012099,Very good health,230,9,3,6,28,35,5,21,52,34,15,7,8,31
S01012099,Good health,203,6,2,4,17,24,5,17,55,50,15,5,10,14
S01012099,Fair health,93,1,1,0,13,9,2,6,22,23,13,9,4,4
S01012099,Bad health,39,0,0,0,4,5,2,4,11,11,2,1,1,0
S01012099,Very bad health,18,0,0,0,1,2,2,2,3,8,0,0,0,0
S01012100,All people aged 16 to 74,759,20,8,12,128,103,46,62,180,116,63,47,16,41
S01012100,Very good health,312,11,5,6,65,45,13,29,63,36,20,13,7,30
S01012100,Good health,270,5,1,4,36,39,22,22,67,42,27,18,9,10
S01012100,Fair health,112,2,2,0,21,16,4,7,29,25,8,8,0,0
S01012100,Bad health,47,2,0,2,5,2,4,3,17,8,6,6,0,0
S01012100,Very bad health,18,0,0,0,1,1,3,1,4,5,2,2,0,1
S01012101,All people aged 16 to 74,604,83,10,73,167,79,28,45,93,32,22,15,7,55
S01012101,Very good health,334,50,5,45,99,39,19,23,39,11,11,7,4,43
S01012101,Good health,196,30,4,26,48,29,8,14,39,13,7,6,1,8
S01012101,Fair health,51,2,1,1,13,8,0,7,10,5,3,2,1,3
S01012101,Bad health,22,1,0,1,7,2,1,1,5,3,1,0,1,1
S01012101,Very bad health,1,0,0,0,0,1,0,0,0,0,0,0,0,0
S01012102,All people aged 16 to 74,474,14,3,11,79,62,12,37,111,76,36,19,17,47
S01012102,Very good health,203,7,1,6,44,28,5,18,33,23,15,5,10,30
S01012102,Good health,166,5,2,3,20,21,3,10,56,26,8,5,3,17
S01012102,Fair health,78,2,0,2,14,11,4,3,17,17,10,7,3,0
S01012102,Bad health,22,0,0,0,0,2,0,6,4,7,3,2,1,0
S01012102,Very bad health,5,0,0,0,1,0,0,0,1,3,0,0,0,0
S01012103,All people aged 16 to 74,722,41,7,34,161,136,43,51,129,85,26,7,19,50
S01012103,Very good health,378,23,5,18,88,75,21,27,68,30,9,3,6,37
S01012103,Good health,233,14,2,12,51,47,16,14,44,25,11,3,8,11
S01012103,Fair health,73,3,0,3,12,12,5,7,11,15,6,1,5,2
S01012103,Bad health,25,1,0,1,6,0,0,3,5,10,0,0,0,0
S01012103,Very bad health,13,0,0,0,4,2,1,0,1,5,0,0,0,0
S01012104,All people aged 16 to 74,676,125,53,72,193,89,51,42,72,32,12,7,5,60
S01012104,Very good health,454,90,42,48,127,67,30,25,44,13,7,3,4,51
S01012104,Good health,163,27,8,19,54,17,16,10,19,10,2,1,1,8
S01012104,Fair health,46,8,3,5,9,4,5,6,7,5,1,1,0,1
S01012104,Bad health,11,0,0,0,3,1,0,1,1,3,2,2,0,0
S01012104,Very bad health,2,0,0,0,0,0,0,0,1,1,0,0,0,0
S01012105,All people aged 16 to 74,841,103,32,71,234,135,56,58,99,68,20,10,10,68
S01012105,Very good health,466,66,25,41,130,75,27,26,47,37,9,6,3,49
S01012105,Good health,267,34,7,27,74,42,20,20,34,20,5,1,4,18
S01012105,Fair health,78,3,0,3,23,13,9,5,9,9,6,3,3,1
S01012105,Bad health,23,0,0,0,6,4,0,6,6,1,0,0,0,0
S01012105,Very bad health,7,0,0,0,1,1,0,1,3,1,0,0,0,0
S01012106,All people aged 16 to 74,832,112,24,88,254,156,65,48,66,48,14,11,3,69
S01012106,Very good health,499,62,11,51,162,87,38,28,36,21,4,4,0,61
S01012106,Good health,242,43,10,33,66,50,22,13,17,18,6,3,3,7
S01012106,Fair health,70,6,2,4,18,16,5,5,12,6,2,2,0,0
S01012106,Bad health,16,1,1,0,6,2,0,2,1,2,1,1,0,1
S01012106,Very bad health,5,0,0,0,2,1,0,0,0,1,1,1,0,0
S01012107,All people aged 16 to 74,510,80,14,66,161,73,42,31,39,25,21,13,8,38
S01012107,Very good health,270,53,11,42,87,33,17,13,20,12,5,3,2,30
S01012107,Good health,165,23,3,20,53,24,21,11,10,7,10,7,3,6
S01012107,Fair health,51,2,0,2,20,11,2,3,4,3,4,2,2,2
S01012107,Bad health,13,2,0,2,0,3,1,0,4,2,1,0,1,0
S01012107,Very bad health,11,0,0,0,1,2,1,4,1,1,1,1,0,0
S01012108,All people aged 16 to 74,610,33,7,26,107,85,36,47,108,128,39,13,26,27
S01012108,Very good health,220,19,2,17,60,19,9,15,36,36,8,2,6,18
S01012108,Good health,196,10,4,6,31,37,10,12,31,42,16,4,12,7
S01012108,Fair health,130,4,1,3,11,24,10,15,22,33,9,2,7,2
S01012108,Bad health,48,0,0,0,5,5,5,4,12,12,5,4,1,0
S01012108,Very bad health,16,0,0,0,0,0,2,1,7,5,1,1,0,0
S01012109,All people aged 16 to 74,714,35,4,31,124,90,32,76,134,102,70,39,31,51
S01012109,Very good health,295,22,3,19,61,40,12,27,48,28,21,10,11,36
S01012109,Good health,257,13,1,12,42,29,15,26,53,43,22,13,9,14
S01012109,Fair health,97,0,0,0,10,15,4,15,16,15,21,12,9,1
S01012109,Bad health,52,0,0,0,7,5,0,8,13,13,6,4,2,0
S01012109,Very bad health,13,0,0,0,4,1,1,0,4,3,0,0,0,0
S01012110,All people aged 16 to 74,541,50,9,41,81,102,24,54,103,77,29,15,14,21
S01012110,Very good health,208,26,4,22,38,43,3,26,36,14,8,2,6,14
S01012110,Good health,182,22,4,18,30,34,13,15,35,20,8,4,4,5
S01012110,Fair health,101,2,1,1,9,17,4,9,21,28,9,5,4,2
S01012110,Bad health,38,0,0,0,2,7,3,3,10,11,2,2,0,0
S01012110,Very bad health,12,0,0,0,2,1,1,1,1,4,2,2,0,0
S01012111,All people aged 16 to 74,417,20,6,14,58,61,19,37,65,66,46,24,22,45
S01012111,Very good health,156,11,3,8,26,33,5,11,22,18,10,4,6,20
S01012111,Good health,150,8,3,5,20,17,8,15,31,20,15,8,7,16
S01012111,Fair health,80,1,0,1,7,7,4,6,7,21,18,9,9,9
S01012111,Bad health,24,0,0,0,4,4,2,2,2,7,3,3,0,0
S01012111,Very bad health,7,0,0,0,1,0,0,3,3,0,0,0,0,0
S01012112,All people aged 16 to 74,535,48,10,38,95,106,26,46,77,89,23,11,12,25
S01012112,Very good health,214,22,3,19,52,49,10,18,22,20,6,2,4,15
S01012112,Good health,193,21,4,17,34,36,8,17,29,36,4,1,3,8
S01012112,Fair health,85,4,2,2,7,13,6,8,19,20,7,3,4,1
S01012112,Bad health,29,1,1,0,2,7,2,2,3,7,4,3,1,1
S01012112,Very bad health,14,0,0,0,0,1,0,1,4,6,2,2,0,0
S01012113,All people aged 16 to 74,738,42,8,34,154,131,46,70,119,102,15,4,11,59
S01012113,Very good health,339,27,8,19,89,47,18,29,46,31,6,1,5,46
S01012113,Good health,245,13,0,13,43,61,17,23,39,35,3,0,3,11
S01012113,Fair health,89,1,0,1,16,14,8,11,17,15,6,3,3,1
S01012113,Bad health,43,0,0,0,4,7,1,4,13,13,0,0,0,1
S01012113,Very bad health,22,1,0,1,2,2,2,3,4,8,0,0,0,0
S01012114,All people aged 16 to 74,757,82,12,70,187,97,46,30,58,28,17,11,6,212
S01012114,Very good health,442,50,7,43,103,51,21,15,30,14,5,2,3,153
S01012114,Good health,234,29,5,24,67,31,17,9,18,4,6,4,2,53
S01012114,Fair health,66,3,0,3,13,12,7,6,8,7,4,3,1,6
S01012114,Bad health,12,0,0,0,3,3,1,0,1,3,1,1,0,0
S01012114,Very bad health,3,0,0,0,1,0,0,0,1,0,1,1,0,0
S01012115,All people aged 16 to 74,379,16,4,12,52,70,11,43,89,66,12,10,2,20
S01012115,Very good health,162,11,3,8,31,32,2,18,32,21,2,1,1,13
S01012115,Good health,131,4,1,3,14,25,3,13,39,28,1,0,1,4
S01012115,Fair health,64,0,0,0,7,12,5,8,11,14,4,4,0,3
S01012115,Bad health,14,1,0,1,0,1,0,4,2,2,4,4,0,0
S01012115,Very bad health,8,0,0,0,0,0,1,0,5,1,1,1,0,0
S01012116,All people aged 16 to 74,431,14,4,10,82,69,21,46,82,71,15,6,9,31
S01012116,Very good health,195,8,2,6,38,30,9,24,29,25,5,2,3,27
S01012116,Good health,156,4,1,3,31,25,9,11,35,30,7,2,5,4
S01012116,Fair health,59,1,0,1,7,11,2,7,16,13,2,1,1,0
S01012116,Bad health,17,1,1,0,4,2,1,3,2,3,1,1,0,0
S01012116,Very bad health,4,0,0,0,2,1,0,1,0,0,0,0,0,0
S01012117,All people aged 16 to 74,559,63,22,41,189,103,40,46,53,28,4,3,1,33
S01012117,Very good health,346,40,13,27,119,64,22,31,24,11,3,2,1,32
S01012117,Good health,164,19,7,12,57,32,13,11,20,10,1,1,0,1
S01012117,Fair health,36,3,1,2,10,5,3,4,9,2,0,0,0,0
S01012117,Bad health,11,1,1,0,3,2,2,0,0,3,0,0,0,0
S01012117,Very bad health,2,0,0,0,0,0,0,0,0,2,0,0,0,0
S01012118,All people aged 16 to 74,482,48,13,35,135,82,34,36,60,33,9,4,5,45
S01012118,Very good health,278,30,8,22,61,49,23,23,31,17,5,2,3,39
S01012118,Good health,141,16,4,12,56,25,6,7,18,10,0,0,0,3
S01012118,Fair health,47,1,0,1,15,7,4,5,7,3,2,0,2,3
S01012118,Bad health,14,1,1,0,3,1,1,1,4,1,2,2,0,0
S01012118,Very bad health,2,0,0,0,0,0,0,0,0,2,0,0,0,0
S01012119,All people aged 16 to 74,705,74,14,60,176,139,48,47,84,64,20,18,2,53
S01012119,Very good health,348,41,9,32,84,57,24,22,40,32,8,7,1,40
S01012119,Good health,242,20,4,16,61,63,19,17,31,17,5,4,1,9
S01012119,Fair health,90,11,1,10,28,14,3,7,11,10,4,4,0,2
S01012119,Bad health,21,1,0,1,3,3,2,1,1,5,3,3,0,2
S01012119,Very bad health,4,1,0,1,0,2,0,0,1,0,0,0,0,0
S01012120,All people aged 16 to 74,435,21,5,16,64,58,15,38,77,89,31,21,10,42
S01012120,Very good health,209,12,5,7,31,34,7,20,25,33,15,10,5,32
S01012120,Good health,140,9,0,9,24,16,5,13,32,26,7,6,1,8
S01012120,Fair health,57,0,0,0,6,3,3,1,16,18,8,4,4,2
S01012120,Bad health,18,0,0,0,2,1,0,3,3,8,1,1,0,0
S01012120,Very bad health,11,0,0,0,1,4,0,1,1,4,0,0,0,0
S01012121,All people aged 16 to 74,665,22,5,17,89,97,22,71,142,116,57,35,22,49
S01012121,Very good health,279,16,3,13,46,41,6,27,50,40,15,11,4,38
S01012121,Good health,205,3,1,2,31,34,8,25,39,38,18,11,7,9
S01012121,Fair health,120,2,1,1,9,18,5,10,29,28,17,7,10,2
S01012121,Bad health,49,1,0,1,2,4,3,6,20,7,6,5,1,0
S01012121,Very bad health,12,0,0,0,1,0,0,3,4,3,1,1,0,0
S01012122,All people aged 16 to 74,617,26,3,23,73,83,25,66,127,139,28,20,8,50
S01012122,Very good health,261,15,2,13,33,30,9,29,57,43,12,8,4,33
S01012122,Good health,217,10,0,10,26,34,10,22,44,50,8,5,3,13
S01012122,Fair health,82,1,1,0,7,10,5,10,15,29,2,2,0,3
S01012122,Bad health,39,0,0,0,6,4,1,3,10,13,1,1,0,1
S01012122,Very bad health,18,0,0,0,1,5,0,2,1,4,5,4,1,0
S01012123,All people aged 16 to 74,393,30,4,26,75,56,28,32,58,50,24,14,10,40
S01012123,Very good health,196,20,3,17,39,31,15,17,16,17,9,3,6,32
S01012123,Good health,128,7,0,7,26,14,8,11,29,18,10,6,4,5
S01012123,Fair health,47,2,1,1,4,11,4,2,10,10,3,3,0,1
S01012123,Bad health,21,1,0,1,6,0,1,2,2,5,2,2,0,2
S01012123,Very bad health,1,0,0,0,0,0,0,0,1,0,0,0,0,0
S01012124,All people aged 16 to 74,430,23,1,22,104,80,21,32,64,58,9,4,5,39
S01012124,Very good health,218,16,1,15,57,40,8,19,18,29,3,1,2,28
S01012124,Good health,128,7,0,7,28,20,11,6,27,19,5,2,3,5
S01012124,Fair health,60,0,0,0,14,15,2,4,14,5,0,0,0,6
S01012124,Bad health,18,0,0,0,2,4,0,3,4,5,0,0,0,0
S01012124,Very bad health,6,0,0,0,3,1,0,0,1,0,1,1,0,0
S01012125,All people aged 16 to 74,618,18,4,14,114,70,25,60,108,115,58,30,28,50
S01012125,Very good health,248,9,3,6,55,30,9,20,36,36,19,6,13,34
S01012125,Good health,191,4,1,3,36,24,5,18,34,40,19,9,10,11
S01012125,Fair health,121,5,0,5,7,15,4,14,27,29,16,11,5,4
S01012125,Bad health,43,0,0,0,11,1,6,6,10,5,4,4,0,0
S01012125,Very bad health,15,0,0,0,5,0,1,2,1,5,0,0,0,1
S01012126,All people aged 16 to 74,628,74,12,62,172,101,37,64,62,44,21,9,12,53
S01012126,Very good health,324,47,10,37,87,61,19,29,31,14,7,2,5,29
S01012126,Good health,221,20,2,18,67,29,13,26,15,23,7,3,4,21
S01012126,Fair health,55,7,0,7,12,11,2,7,7,3,5,2,3,1
S01012126,Bad health,21,0,0,0,6,0,1,2,6,2,2,2,0,2
S01012126,Very bad health,7,0,0,0,0,0,2,0,3,2,0,0,0,0
S01012127,All people aged 16 to 74,713,46,9,37,112,110,37,51,102,88,76,40,36,91
S01012127,Very good health,344,25,3,22,65,55,14,19,43,26,20,11,9,77
S01012127,Good health,225,13,4,9,30,35,17,24,35,28,33,17,16,10
S01012127,Fair health,99,7,2,5,12,16,5,6,15,19,18,8,10,1
S01012127,Bad health,33,1,0,1,4,4,1,1,7,11,1,1,0,3
S01012127,Very bad health,12,0,0,0,1,0,0,1,2,4,4,3,1,0
S01012128,All people aged 16 to 74,414,36,7,29,91,52,15,43,69,53,27,17,10,28
S01012128,Very good health,209,23,4,19,53,26,9,15,29,26,10,7,3,18
S01012128,Good health,133,9,2,7,32,17,4,19,21,14,9,2,7,8
S01012128,Fair health,46,2,0,2,4,5,2,7,13,8,4,4,0,1
S01012128,Bad health,17,1,0,1,1,4,0,2,3,3,2,2,0,1
S01012128,Very bad health,9,1,1,0,1,0,0,0,3,2,2,2,0,0
S01012129,All people aged 16 to 74,558,37,7,30,104,89,27,51,86,73,53,37,16,38
S01012129,Very good health,241,23,4,19,45,44,14,20,31,20,17,9,8,27
S01012129,Good health,180,6,0,6,38,31,5,22,32,24,14,12,2,8
S01012129,Fair health,92,6,2,4,15,9,4,6,17,18,14,8,6,3
S01012129,Bad health,29,1,1,0,5,3,2,3,3,6,6,6,0,0
S01012129,Very bad health,16,1,0,1,1,2,2,0,3,5,2,2,0,0
S01012130,All people aged 16 to 74,774,45,13,32,158,118,41,58,117,135,62,39,23,40
S01012130,Very good health,285,32,9,23,72,53,13,20,19,36,12,8,4,28
S01012130,Good health,278,11,4,7,63,42,10,19,59,46,21,10,11,7
S01012130,Fair health,150,2,0,2,17,21,6,14,32,35,18,12,6,5
S01012130,Bad health,44,0,0,0,5,2,8,3,4,13,9,7,2,0
S01012130,Very bad health,17,0,0,0,1,0,4,2,3,5,2,2,0,0
S01012131,All people aged 16 to 74,935,34,5,29,134,108,21,74,128,134,82,50,32,220
S01012131,Very good health,379,16,1,15,69,44,8,22,43,31,22,18,4,124
S01012131,Good health,335,10,2,8,41,44,7,27,42,48,30,10,20,86
S01012131,Fair health,146,7,1,6,16,15,6,15,31,32,16,8,8,8
S01012131,Bad health,58,1,1,0,6,2,0,6,11,18,13,13,0,1
S01012131,Very bad health,17,0,0,0,2,3,0,4,1,5,1,1,0,1
S01012132,All people aged 16 to 74,561,32,6,26,87,59,31,32,101,79,47,33,14,93
S01012132,Very good health,252,15,1,14,45,27,14,16,45,25,12,8,4,53
S01012132,Good health,184,13,5,8,23,18,8,13,31,26,18,11,7,34
S01012132,Fair health,76,2,0,2,12,11,7,1,7,20,10,7,3,6
S01012132,Bad health,42,2,0,2,5,3,1,2,17,6,6,6,0,0
S01012132,Very bad health,7,0,0,0,2,0,1,0,1,2,1,1,0,0
S01012133,All people aged 16 to 74,778,63,9,54,137,74,31,58,88,78,38,20,18,211
S01012133,Very good health,407,39,5,34,82,40,13,28,41,28,10,6,4,126
S01012133,Good health,249,16,2,14,36,27,13,20,25,22,13,4,9,77
S01012133,Fair health,77,7,2,5,15,6,1,6,13,13,8,3,5,8
S01012133,Bad health,29,1,0,1,4,1,3,3,7,9,1,1,0,0
S01012133,Very bad health,16,0,0,0,0,0,1,1,2,6,6,6,0,0
S01012134,All people aged 16 to 74,861,100,21,79,245,130,51,46,83,59,29,17,12,118
S01012134,Very good health,459,68,15,53,146,65,25,24,33,11,8,6,2,79
S01012134,Good health,266,22,3,19,76,43,21,9,28,30,9,1,8,28
S01012134,Fair health,93,6,2,4,21,16,5,10,13,9,6,4,2,7
S01012134,Bad health,29,4,1,3,2,6,0,2,5,5,2,2,0,3
S01012134,Very bad health,14,0,0,0,0,0,0,1,4,4,4,4,0,1
S01012135,All people aged 16 to 74,702,23,4,19,77,86,30,67,157,124,80,51,29,58
S01012135,Very good health,265,10,2,8,34,48,12,21,45,34,22,12,10,39
S01012135,Good health,216,9,2,7,24,21,8,23,55,36,28,20,8,12
S01012135,Fair health,120,2,0,2,12,8,3,12,29,27,21,11,10,6
S01012135,Bad health,77,2,0,2,6,6,5,7,24,22,5,5,0,0
S01012135,Very bad health,24,0,0,0,1,3,2,4,4,5,4,3,1,1
S01012136,All people aged 16 to 74,699,26,2,24,94,87,24,58,133,105,56,25,31,116
S01012136,Very good health,297,12,1,11,48,34,6,28,47,33,15,9,6,74
S01012136,Good health,229,11,0,11,36,24,11,20,45,32,18,2,16,32
S01012136,Fair health,83,3,1,2,5,17,4,1,26,14,13,5,8,0
S01012136,Bad health,76,0,0,0,3,11,3,6,13,23,7,6,1,10
S01012136,Very bad health,14,0,0,0,2,1,0,3,2,3,3,3,0,0
S01012137,All people aged 16 to 74,514,14,3,11,109,71,20,53,85,67,39,24,15,56
S01012137,Very good health,201,8,1,7,52,24,10,16,37,16,15,10,5,23
S01012137,Good health,164,4,1,3,35,24,8,21,25,15,7,3,4,25
S01012137,Fair health,81,1,1,0,12,12,2,10,15,15,10,6,4,4
S01012137,Bad health,54,1,0,1,9,8,0,6,8,13,5,3,2,4
S01012137,Very bad health,14,0,0,0,1,3,0,0,0,8,2,2,0,0
S01012138,All people aged 16 to 74,681,88,15,73,171,116,32,47,63,72,16,9,7,76
S01012138,Very good health,357,50,10,40,94,53,18,23,30,22,7,4,3,60
S01012138,Good health,213,31,5,26,55,43,9,16,22,22,3,0,3,12
S01012138,Fair health,74,3,0,3,16,15,4,5,7,18,3,2,1,3
S01012138,Bad health,25,2,0,2,4,4,1,3,1,7,2,2,0,1
S01012138,Very bad health,12,2,0,2,2,1,0,0,3,3,1,1,0,0
S01012139,All people aged 16 to 74,656,55,14,41,143,119,37,43,106,87,25,14,11,41
S01012139,Very good health,328,35,7,28,77,64,22,17,42,32,8,2,6,31
S01012139,Good health,201,14,7,7,49,36,6,15,41,24,7,4,3,9
S01012139,Fair health,82,2,0,2,14,13,8,6,15,18,5,4,1,1
S01012139,Bad health,34,4,0,4,3,5,1,2,5,10,4,3,1,0
S01012139,Very bad health,11,0,0,0,0,1,0,3,3,3,1,1,0,0
S01012140,All people aged 16 to 74,397,60,7,53,142,56,20,20,38,24,7,2,5,30
S01012140,Very good health,229,32,2,30,86,35,9,9,20,8,4,0,4,26
S01012140,Good health,125,21,4,17,47,17,8,8,14,9,0,0,0,1
S01012140,Fair health,35,6,1,5,8,3,3,3,3,5,1,0,1,3
S01012140,Bad health,5,1,0,1,1,0,0,0,1,1,1,1,0,0
S01012140,Very bad health,3,0,0,0,0,1,0,0,0,1,1,1,0,0
S01012141,All people aged 16 to 74,755,79,20,59,225,133,50,56,84,40,23,11,12,65
S01012141,Very good health,420,56,14,42,127,67,17,30,42,15,11,5,6,55
S01012141,Good health,242,18,4,14,79,45,24,15,29,15,8,4,4,9
S01012141,Fair health,69,5,2,3,15,13,7,10,9,6,4,2,2,0
S01012141,Bad health,20,0,0,0,3,7,1,1,4,3,0,0,0,1
S01012141,Very bad health,4,0,0,0,1,1,1,0,0,1,0,0,0,0
S01012142,All people aged 16 to 74,693,93,31,62,213,124,51,48,74,35,8,4,4,47
S01012142,Very good health,391,65,21,44,121,61,25,24,40,12,3,1,2,40
S01012142,Good health,215,25,10,15,65,43,19,19,19,16,4,2,2,5
S01012142,Fair health,67,3,0,3,22,16,7,2,11,4,1,1,0,1
S01012142,Bad health,16,0,0,0,5,4,0,1,4,2,0,0,0,0
S01012142,Very bad health,4,0,0,0,0,0,0,2,0,1,0,0,0,1
S01012143,All people aged 16 to 74,633,102,18,84,186,107,50,35,50,19,19,13,6,65
S01012143,Very good health,352,57,11,46,109,54,17,19,25,6,8,5,3,57
S01012143,Good health,206,37,6,31,53,44,24,11,15,8,6,3,3,8
S01012143,Fair health,55,6,1,5,18,7,8,5,6,3,2,2,0,0
S01012143,Bad health,18,1,0,1,6,2,1,0,4,1,3,3,0,0
S01012143,Very bad health,2,1,0,1,0,0,0,0,0,1,0,0,0,0
S01012144,All people aged 16 to 74,743,99,27,72,184,145,57,54,84,47,20,16,4,53
S01012144,Very good health,393,58,14,44,112,73,28,23,31,16,8,5,3,44
S01012144,Good health,249,32,10,22,58,46,21,22,36,21,6,5,1,7
S01012144,Fair health,68,9,3,6,11,18,6,3,10,7,2,2,0,2
S01012144,Bad health,27,0,0,0,3,7,1,6,5,1,4,4,0,0
S01012144,Very bad health,6,0,0,0,0,1,1,0,2,2,0,0,0,0
S01012145,All people aged 16 to 74,732,116,16,100,234,126,45,41,58,24,18,12,6,70
S01012145,Very good health,411,74,10,64,143,53,17,21,27,11,5,3,2,60
S01012145,Good health,241,35,6,29,63,55,24,17,24,7,7,3,4,9
S01012145,Fair health,49,4,0,4,16,14,3,2,3,4,2,2,0,1
S01012145,Bad health,26,3,0,3,11,4,1,1,4,0,2,2,0,0
S01012145,Very bad health,5,0,0,0,1,0,0,0,0,2,2,2,0,0
S01012146,All people aged 16 to 74,701,24,2,22,102,86,31,70,141,142,40,23,17,65
S01012146,Very good health,288,14,1,13,58,39,7,27,41,41,12,4,8,49
S01012146,Good health,237,8,1,7,31,26,13,28,61,45,14,9,5,11
S01012146,Fair health,111,2,0,2,4,11,8,4,31,40,8,5,3,3
S01012146,Bad health,47,0,0,0,6,7,3,7,5,13,4,3,1,2
S01012146,Very bad health,18,0,0,0,3,3,0,4,3,3,2,2,0,0
S01012147,All people aged 16 to 74,572,18,5,13,63,81,21,52,127,113,58,35,23,39
S01012147,Very good health,217,12,4,8,30,28,4,19,47,32,18,12,6,27
S01012147,Good health,180,3,0,3,21,33,7,15,43,34,17,5,12,7
S01012147,Fair health,117,3,1,2,4,15,9,12,27,27,15,10,5,5
S01012147,Bad health,46,0,0,0,8,3,1,5,5,16,8,8,0,0
S01012147,Very bad health,12,0,0,0,0,2,0,1,5,4,0,0,0,0
S01012148,All people aged 16 to 74,540,12,5,7,61,63,17,53,116,112,69,46,23,37
S01012148,Very good health,190,4,3,1,30,24,7,16,39,27,18,11,7,25
S01012148,Good health,192,5,1,4,18,24,7,21,40,43,25,12,13,9
S01012148,Fair health,97,2,1,1,5,9,2,8,24,30,14,11,3,3
S01012148,Bad health,47,1,0,1,8,6,0,7,9,8,8,8,0,0
S01012148,Very bad health,14,0,0,0,0,0,1,1,4,4,4,4,0,0
S01012149,All people aged 16 to 74,620,43,5,38,124,97,48,59,94,61,36,31,5,58
S01012149,Very good health,342,25,4,21,76,51,23,33,47,27,10,6,4,50
S01012149,Good health,171,16,1,15,36,31,14,14,26,19,9,8,1,6
S01012149,Fair health,69,2,0,2,10,11,5,8,16,10,6,6,0,1
S01012149,Bad health,31,0,0,0,1,4,5,4,3,4,9,9,0,1
S01012149,Very bad health,7,0,0,0,1,0,1,0,2,1,2,2,0,0
S01012150,All people aged 16 to 74,553,11,2,9,66,84,21,52,118,125,48,29,19,28
S01012150,Very good health,204,6,0,6,27,39,6,21,35,35,17,11,6,18
S01012150,Good health,210,5,2,3,24,25,13,20,52,46,16,7,9,9
S01012150,Fair health,87,0,0,0,10,11,1,7,20,26,11,8,3,1
S01012150,Bad health,35,0,0,0,4,5,1,3,9,12,1,0,1,0
S01012150,Very bad health,17,0,0,0,1,4,0,1,2,6,3,3,0,0
S01012151,All people aged 16 to 74,552,25,6,19,71,64,18,52,119,129,47,29,18,27
S01012151,Very good health,206,14,2,12,32,26,8,12,44,36,16,11,5,18
S01012151,Good health,181,6,1,5,23,22,4,20,44,42,13,6,7,7
S01012151,Fair health,101,4,2,2,12,8,2,14,17,33,9,4,5,2
S01012151,Bad health,43,1,1,0,3,6,2,3,12,9,7,6,1,0
S01012151,Very bad health,21,0,0,0,1,2,2,3,2,9,2,2,0,0
S01012152,All people aged 16 to 74,565,20,4,16,54,74,24,59,128,101,65,42,23,40
S01012152,Very good health,206,9,1,8,19,28,10,20,44,30,12,5,7,34
S01012152,Good health,194,7,3,4,20,23,8,16,47,37,30,21,9,6
S01012152,Fair health,95,2,0,2,9,15,2,14,26,16,11,7,4,0
S01012152,Bad health,59,2,0,2,6,5,4,7,10,14,11,8,3,0
S01012152,Very bad health,11,0,0,0,0,3,0,2,1,4,1,1,0,0
S01012153,All people aged 16 to 74,433,14,2,12,66,54,19,61,83,61,39,28,11,36
S01012153,Very good health,183,9,1,8,31,28,10,25,27,21,9,2,7,23
S01012153,Good health,125,3,1,2,17,17,5,15,29,21,6,5,1,12
S01012153,Fair health,74,2,0,2,8,7,3,11,13,12,17,15,2,1
S01012153,Bad health,36,0,0,0,8,2,1,5,13,3,4,3,1,0
S01012153,Very bad health,15,0,0,0,2,0,0,5,1,4,3,3,0,0
S01012154,All people aged 16 to 74,637,26,1,25,78,83,24,76,120,122,61,35,26,47
S01012154,Very good health,238,13,1,12,36,32,9,19,42,46,16,9,7,25
S01012154,Good health,219,9,0,9,27,31,11,24,45,37,20,8,12,15
S01012154,Fair health,111,2,0,2,10,13,4,16,19,28,16,11,5,3
S01012154,Bad health,52,1,0,1,4,3,0,16,8,7,9,7,2,4
S01012154,Very bad health,17,1,0,1,1,4,0,1,6,4,0,0,0,0
S01012155,All people aged 16 to 74,461,9,1,8,73,53,25,46,77,96,41,19,22,41
S01012155,Very good health,184,5,0,5,30,25,7,23,26,27,15,8,7,26
S01012155,Good health,141,1,0,1,23,10,8,12,23,37,14,6,8,13
S01012155,Fair health,85,2,0,2,17,10,5,6,18,17,8,1,7,2
S01012155,Bad health,36,1,1,0,2,7,4,4,8,8,2,2,0,0
S01012155,Very bad health,15,0,0,0,1,1,1,1,2,7,2,2,0,0
S01012156,All people aged 16 to 74,474,9,2,7,68,47,20,40,102,114,52,33,19,22
S01012156,Very good health,166,3,0,3,40,12,9,13,39,31,7,7,0,12
S01012156,Good health,148,4,1,3,19,20,6,14,26,30,22,10,12,7
S01012156,Fair health,99,1,0,1,4,11,3,8,21,29,19,14,5,3
S01012156,Bad health,43,1,1,0,4,3,2,2,14,14,3,1,2,0
S01012156,Very bad health,18,0,0,0,1,1,0,3,2,10,1,1,0,0
S01012157,All people aged 16 to 74,742,40,7,33,146,101,29,72,127,134,39,25,14,54
S01012157,Very good health,332,26,5,21,78,56,8,25,48,41,13,10,3,37
S01012157,Good health,271,14,2,12,51,31,16,32,51,50,14,8,6,12
S01012157,Fair health,95,0,0,0,12,10,4,7,18,30,11,6,5,3
S01012157,Bad health,33,0,0,0,5,4,0,6,6,11,1,1,0,0
S01012157,Very bad health,11,0,0,0,0,0,1,2,4,2,0,0,0,2
S01012158,All people aged 16 to 74,843,69,10,59,219,125,61,75,104,69,38,24,14,83
S01012158,Very good health,451,46,4,42,128,71,27,37,45,28,11,6,5,58
S01012158,Good health,274,19,4,15,67,44,24,26,33,29,12,6,6,20
S01012158,Fair health,97,4,2,2,22,9,10,10,18,7,12,9,3,5
S01012158,Bad health,16,0,0,0,2,0,0,2,7,2,3,3,0,0
S01012158,Very bad health,5,0,0,0,0,1,0,0,1,3,0,0,0,0
S01012159,All people aged 16 to 74,411,30,6,24,88,73,23,56,65,38,9,7,2,29
S01012159,Very good health,172,17,0,17,50,26,9,16,20,11,2,2,0,21
S01012159,Good health,159,9,6,3,25,36,9,26,27,14,6,4,2,7
S01012159,Fair health,67,3,0,3,12,9,3,12,16,11,0,0,0,1
S01012159,Bad health,9,0,0,0,1,1,2,1,2,1,1,1,0,0
S01012159,Very bad health,4,1,0,1,0,1,0,1,0,1,0,0,0,0
S01012160,All people aged 16 to 74,525,44,8,36,108,118,36,53,75,57,7,2,5,27
S01012160,Very good health,247,25,4,21,53,58,16,20,32,19,2,1,1,22
S01012160,Good health,202,17,3,14,45,42,14,23,28,25,3,0,3,5
S01012160,Fair health,58,2,1,1,8,13,3,9,11,12,0,0,0,0
S01012160,Bad health,16,0,0,0,2,4,3,1,4,1,1,0,1,0
S01012160,Very bad health,2,0,0,0,0,1,0,0,0,0,1,1,0,0
S01012161,All people aged 16 to 74,322,12,2,10,50,23,11,19,96,75,20,14,6,16
S01012161,Very good health,117,7,1,6,25,10,4,6,33,16,6,5,1,10
S01012161,Good health,118,4,1,3,15,9,4,6,36,28,10,6,4,6
S01012161,Fair health,49,0,0,0,7,3,2,4,16,16,1,1,0,0
S01012161,Bad health,34,1,0,1,3,1,1,2,10,14,2,1,1,0
S01012161,Very bad health,4,0,0,0,0,0,0,1,1,1,1,1,0,0
S01012162,All people aged 16 to 74,663,33,6,27,114,73,24,77,134,92,63,48,15,53
S01012162,Very good health,324,26,3,23,69,45,10,30,54,35,16,12,4,39
S01012162,Good health,191,5,2,3,33,19,5,27,45,27,20,13,7,10
S01012162,Fair health,105,1,0,1,6,5,8,14,30,17,21,17,4,3
S01012162,Bad health,28,1,1,0,4,3,0,5,5,7,3,3,0,0
S01012162,Very bad health,15,0,0,0,2,1,1,1,0,6,3,3,0,1
S01012163,All people aged 16 to 74,561,34,4,30,100,78,25,56,95,90,50,39,11,33
S01012163,Very good health,271,24,2,22,46,43,13,25,51,30,12,7,5,27
S01012163,Good health,179,10,2,8,40,24,7,21,26,30,16,12,4,5
S01012163,Fair health,69,0,0,0,10,6,3,3,9,21,17,15,2,0
S01012163,Bad health,34,0,0,0,2,5,1,3,9,8,5,5,0,1
S01012163,Very bad health,8,0,0,0,2,0,1,4,0,1,0,0,0,0
S01012164,All people aged 16 to 74,794,64,17,47,226,146,42,73,109,60,16,13,3,58
S01012164,Very good health,474,46,10,36,142,90,18,42,59,25,5,4,1,47
S01012164,Good health,247,13,5,8,67,50,17,26,37,23,5,3,2,9
S01012164,Fair health,56,5,2,3,13,4,7,3,9,9,4,4,0,2
S01012164,Bad health,13,0,0,0,2,2,0,2,2,3,2,2,0,0
S01012164,Very bad health,4,0,0,0,2,0,0,0,2,0,0,0,0,0
S01012165,All people aged 16 to 74,670,19,6,13,66,87,25,70,156,141,66,40,26,40
S01012165,Very good health,255,10,2,8,36,38,6,23,57,41,16,8,8,28
S01012165,Good health,237,5,2,3,22,30,14,26,58,43,31,17,14,8
S01012165,Fair health,115,3,1,2,5,14,3,12,24,35,16,12,4,3
S01012165,Bad health,50,1,1,0,3,5,2,7,15,14,2,2,0,1
S01012165,Very bad health,13,0,0,0,0,0,0,2,2,8,1,1,0,0
S01012166,All people aged 16 to 74,473,7,2,5,71,64,22,56,105,91,20,13,7,37
S01012166,Very good health,220,2,1,1,32,28,15,24,51,39,4,1,3,25
S01012166,Good health,155,2,0,2,30,24,4,19,32,28,8,6,2,8
S01012166,Fair health,65,1,0,1,4,8,1,8,18,16,7,5,2,2
S01012166,Bad health,21,1,0,1,2,3,2,2,4,6,0,0,0,1
S01012166,Very bad health,12,1,1,0,3,1,0,3,0,2,1,1,0,1
S01012167,All people aged 16 to 74,649,29,6,23,102,113,32,79,125,113,23,9,14,33
S01012167,Very good health,284,12,2,10,60,50,15,28,54,36,8,1,7,21
S01012167,Good health,218,12,1,11,31,37,10,32,46,29,10,3,7,11
S01012167,Fair health,97,4,2,2,8,19,3,14,16,31,2,2,0,0
S01012167,Bad health,36,0,0,0,1,6,3,5,7,11,2,2,0,1
S01012167,Very bad health,14,1,1,0,2,1,1,0,2,6,1,1,0,0
S01012168,All people aged 16 to 74,611,47,15,32,153,119,36,57,88,55,15,9,6,41
S01012168,Very good health,296,21,6,15,80,54,7,23,45,26,5,2,3,35
S01012168,Good health,216,17,7,10,51,42,22,27,25,21,5,4,1,6
S01012168,Fair health,72,6,1,5,15,20,5,5,15,2,4,2,2,0
S01012168,Bad health,20,2,1,1,6,3,1,2,2,3,1,1,0,0
S01012168,Very bad health,7,1,0,1,1,0,1,0,1,3,0,0,0,0
S01012169,All people aged 16 to 74,639,24,10,14,115,119,28,55,143,80,23,19,4,52
S01012169,Very good health,266,16,8,8,56,47,9,20,48,30,4,3,1,36
S01012169,Good health,212,5,2,3,42,46,9,15,49,24,8,6,2,14
S01012169,Fair health,106,3,0,3,8,18,5,12,33,17,8,7,1,2
S01012169,Bad health,42,0,0,0,7,5,3,6,10,9,2,2,0,0
S01012169,Very bad health,13,0,0,0,2,3,2,2,3,0,1,1,0,0
S01012170,All people aged 16 to 74,697,26,8,18,112,130,32,83,136,124,24,14,10,30
S01012170,Very good health,268,17,5,12,47,55,11,32,41,38,5,1,4,22
S01012170,Good health,238,7,3,4,39,44,15,30,47,39,13,8,5,4
S01012170,Fair health,118,1,0,1,18,15,4,12,34,30,1,0,1,3
S01012170,Bad health,61,1,0,1,7,13,1,8,11,15,4,4,0,1
S01012170,Very bad health,12,0,0,0,1,3,1,1,3,2,1,1,0,0
S01012171,All people aged 16 to 74,762,25,3,22,121,103,21,72,204,151,25,16,9,40
S01012171,Very good health,318,11,1,10,61,42,7,30,75,51,10,6,4,31
S01012171,Good health,290,12,1,11,45,44,6,28,81,60,8,5,3,6
S01012171,Fair health,104,2,1,1,9,11,7,9,31,27,6,4,2,2
S01012171,Bad health,37,0,0,0,6,4,1,5,8,13,0,0,0,0
S01012171,Very bad health,13,0,0,0,0,2,0,0,9,0,1,1,0,1
S01012172,All people aged 16 to 74,550,11,2,9,68,93,20,57,123,112,36,27,9,30
S01012172,Very good health,217,3,1,2,28,51,7,27,37,26,16,12,4,22
S01012172,Good health,198,5,1,4,27,29,9,19,57,39,7,4,3,6
S01012172,Fair health,90,2,0,2,8,13,2,10,19,25,9,7,2,2
S01012172,Bad health,35,1,0,1,4,0,1,1,8,16,4,4,0,0
S01012172,Very bad health,10,0,0,0,1,0,1,0,2,6,0,0,0,0
S01012173,All people aged 16 to 74,482,42,10,32,134,92,30,36,59,37,12,11,1,40
S01012173,Very good health,234,27,6,21,70,42,12,17,18,15,1,1,0,32
S01012173,Good health,174,8,3,5,46,36,13,14,28,15,6,5,1,8
S01012173,Fair health,59,6,1,5,15,13,3,4,11,5,2,2,0,0
S01012173,Bad health,12,1,0,1,2,0,2,1,2,1,3,3,0,0
S01012173,Very bad health,3,0,0,0,1,1,0,0,0,1,0,0,0,0
S01012174,All people aged 16 to 74,657,64,12,52,172,113,50,42,83,48,12,7,5,73
S01012174,Very good health,391,37,4,33,104,53,26,29,46,27,7,6,1,62
S01012174,Good health,207,21,6,15,54,48,14,13,31,13,5,1,4,8
S01012174,Fair health,44,4,2,2,12,9,10,0,4,3,0,0,0,2
S01012174,Bad health,10,2,0,2,1,2,0,0,2,2,0,0,0,1
S01012174,Very bad health,5,0,0,0,1,1,0,0,0,3,0,0,0,0
S01012175,All people aged 16 to 74,656,61,8,53,176,126,28,51,95,63,9,6,3,47
S01012175,Very good health,347,40,5,35,110,64,11,22,46,14,2,1,1,38
S01012175,Good health,212,17,3,14,46,44,13,20,35,27,2,0,2,8
S01012175,Fair health,65,4,0,4,16,11,3,5,8,13,4,4,0,1
S01012175,Bad health,24,0,0,0,3,3,1,4,6,6,1,1,0,0
S01012175,Very bad health,8,0,0,0,1,4,0,0,0,3,0,0,0,0
S01012176,All people aged 16 to 74,704,40,14,26,153,127,47,78,126,73,13,9,4,47
S01012176,Very good health,363,20,7,13,85,67,21,30,64,34,4,3,1,38
S01012176,Good health,220,17,7,10,44,38,17,36,36,19,4,2,2,9
S01012176,Fair health,88,3,0,3,16,14,8,7,22,15,3,2,1,0
S01012176,Bad health,25,0,0,0,7,8,1,2,3,3,1,1,0,0
S01012176,Very bad health,8,0,0,0,1,0,0,3,1,2,1,1,0,0
S01012177,All people aged 16 to 74,502,38,7,31,101,103,37,57,66,41,12,8,4,47
S01012177,Very good health,246,19,5,14,51,50,16,23,23,19,3,1,2,42
S01012177,Good health,176,11,1,10,41,37,13,23,34,12,2,2,0,3
S01012177,Fair health,54,7,1,6,5,14,7,6,7,4,2,0,2,2
S01012177,Bad health,18,1,0,1,4,1,0,3,2,5,2,2,0,0
S01012177,Very bad health,8,0,0,0,0,1,1,2,0,1,3,3,0,0
S01012178,All people aged 16 to 74,431,33,4,29,94,113,27,40,46,42,7,4,3,29
S01012178,Very good health,222,20,3,17,49,53,14,20,19,19,3,1,2,25
S01012178,Good health,156,11,0,11,29,46,9,17,23,17,0,0,0,4
S01012178,Fair health,46,2,1,1,14,14,3,3,4,4,2,1,1,0
S01012178,Bad health,7,0,0,0,2,0,1,0,0,2,2,2,0,0
S01012178,Very bad health,0,0,0,0,0,0,0,0,0,0,0,0,0,0
S01012179,All people aged 16 to 74,429,31,9,22,83,66,23,43,66,54,29,19,10,34
S01012179,Very good health,211,18,5,13,46,28,12,20,32,16,11,7,4,28
S01012179,Good health,132,9,3,6,26,28,7,14,22,15,7,4,3,4
S01012179,Fair health,64,2,0,2,10,8,4,8,7,17,7,4,3,1
S01012179,Bad health,18,2,1,1,0,2,0,0,4,5,4,4,0,1
S01012179,Very bad health,4,0,0,0,1,0,0,1,1,1,0,0,0,0
S01012180,All people aged 16 to 74,407,31,5,26,89,67,25,34,70,57,13,7,6,21
S01012180,Very good health,146,12,3,9,37,28,10,10,21,11,3,0,3,14
S01012180,Good health,148,12,2,10,28,27,11,12,24,23,5,2,3,6
S01012180,Fair health,74,4,0,4,15,8,3,12,13,16,2,2,0,1
S01012180,Bad health,29,2,0,2,6,2,1,0,9,6,3,3,0,0
S01012180,Very bad health,10,1,0,1,3,2,0,0,3,1,0,0,0,0
S01012181,All people aged 16 to 74,553,42,16,26,116,84,37,47,89,71,31,17,14,36
S01012181,Very good health,228,22,8,14,53,35,16,17,30,19,7,2,5,29
S01012181,Good health,190,15,5,10,41,35,11,15,34,25,10,6,4,4
S01012181,Fair health,86,2,1,1,17,10,9,9,14,11,13,8,5,1
S01012181,Bad health,41,3,2,1,4,3,1,5,8,14,1,1,0,2
S01012181,Very bad health,8,0,0,0,1,1,0,1,3,2,0,0,0,0
S01012182,All people aged 16 to 74,831,101,17,84,217,128,51,79,116,40,19,16,3,80
S01012182,Very good health,509,68,10,58,149,86,16,45,50,20,7,5,2,68
S01012182,Good health,224,26,4,22,56,32,19,22,41,12,6,5,1,10
S01012182,Fair health,73,6,3,3,9,6,15,8,19,6,4,4,0,0
S01012182,Bad health,21,1,0,1,1,4,1,3,5,2,2,2,0,2
S01012182,Very bad health,4,0,0,0,2,0,0,1,1,0,0,0,0,0
S01012183,All people aged 16 to 74,571,36,9,27,115,85,28,58,96,76,39,31,8,38
S01012183,Very good health,283,22,3,19,63,43,12,33,46,29,7,5,2,28
S01012183,Good health,166,8,3,5,31,27,9,10,34,29,11,7,4,7
S01012183,Fair health,76,6,3,3,12,10,5,9,11,7,13,12,1,3
S01012183,Bad health,39,0,0,0,9,4,2,5,3,9,7,6,1,0
S01012183,Very bad health,7,0,0,0,0,1,0,1,2,2,1,1,0,0
S01012184,All people aged 16 to 74,435,75,10,65,122,66,23,30,42,28,9,4,5,40
S01012184,Very good health,259,55,6,49,73,37,6,18,25,15,1,1,0,29
S01012184,Good health,117,11,1,10,42,19,6,8,11,7,5,2,3,8
S01012184,Fair health,44,9,3,6,6,8,7,3,3,3,2,0,2,3
S01012184,Bad health,15,0,0,0,1,2,4,1,3,3,1,1,0,0
S01012184,Very bad health,0,0,0,0,0,0,0,0,0,0,0,0,0,0
S01012185,All people aged 16 to 74,613,25,4,21,98,91,33,59,80,114,88,59,29,25
S01012185,Very good health,220,12,0,12,51,53,13,19,22,28,12,1,11,10
S01012185,Good health,224,10,4,6,34,24,11,23,38,38,33,23,10,13
S01012185,Fair health,122,3,0,3,10,9,7,9,12,35,35,29,6,2
S01012185,Bad health,41,0,0,0,2,5,2,7,6,12,7,6,1,0
S01012185,Very bad health,6,0,0,0,1,0,0,1,2,1,1,0,1,0
S01012186,All people aged 16 to 74,501,29,15,14,100,61,20,46,101,81,39,20,19,24
S01012186,Very good health,200,17,9,8,53,21,8,16,32,19,12,7,5,22
S01012186,Good health,176,9,5,4,29,19,7,20,44,33,14,4,10,1
S01012186,Fair health,78,1,0,1,10,11,4,6,18,20,8,7,1,0
S01012186,Bad health,38,2,1,1,7,10,1,4,5,6,3,1,2,0
S01012186,Very bad health,9,0,0,0,1,0,0,0,2,3,2,1,1,1
S01012187,All people aged 16 to 74,517,11,3,8,62,81,17,57,113,97,40,24,16,39
S01012187,Very good health,219,3,0,3,29,40,7,25,48,26,15,7,8,26
S01012187,Good health,166,7,2,5,26,22,5,15,39,31,10,6,4,11
S01012187,Fair health,83,1,1,0,5,12,2,11,20,21,9,5,4,2
S01012187,Bad health,37,0,0,0,1,4,3,2,5,16,6,6,0,0
S01012187,Very bad health,12,0,0,0,1,3,0,4,1,3,0,0,0,0
S01012188,All people aged 16 to 74,398,24,9,15,94,79,21,36,65,41,9,5,4,29
S01012188,Very good health,194,14,6,8,58,26,9,17,30,14,4,2,2,22
S01012188,Good health,132,7,3,4,25,40,8,10,19,15,2,2,0,6
S01012188,Fair health,50,3,0,3,5,10,4,5,13,7,2,1,1,1
S01012188,Bad health,14,0,0,0,4,2,0,3,1,3,1,0,1,0
S01012188,Very bad health,8,0,0,0,2,1,0,1,2,2,0,0,0,0
S01012189,All people aged 16 to 74,421,36,10,26,107,70,19,56,58,46,10,7,3,19
S01012189,Very good health,197,22,8,14,58,41,7,23,20,10,1,1,0,15
S01012189,Good health,147,11,2,9,35,20,7,21,26,21,3,1,2,3
S01012189,Fair health,46,3,0,3,7,4,4,6,7,10,4,3,1,1
S01012189,Bad health,22,0,0,0,4,3,1,3,4,5,2,2,0,0
S01012189,Very bad health,9,0,0,0,3,2,0,3,1,0,0,0,0,0
S01012190,All people aged 16 to 74,393,47,8,39,118,79,16,22,51,29,2,2,0,29
S01012190,Very good health,241,38,6,32,74,50,5,15,26,10,0,0,0,23
S01012190,Good health,109,8,2,6,35,21,11,6,10,12,0,0,0,6
S01012190,Fair health,31,1,0,1,6,7,0,1,10,6,0,0,0,0
S01012190,Bad health,8,0,0,0,2,1,0,0,3,1,1,1,0,0
S01012190,Very bad health,4,0,0,0,1,0,0,0,2,0,1,1,0,0
S01012191,All people aged 16 to 74,693,85,22,63,167,131,44,62,95,38,15,9,6,56
S01012191,Very good health,399,56,16,40,107,62,21,29,48,24,5,3,2,47
S01012191,Good health,207,23,5,18,44,49,14,28,32,5,6,2,4,6
S01012191,Fair health,63,5,1,4,12,16,5,4,10,6,3,3,0,2
S01012191,Bad health,16,1,0,1,3,2,2,0,3,3,1,1,0,1
S01012191,Very bad health,8,0,0,0,1,2,2,1,2,0,0,0,0,0
S01012192,All people aged 16 to 74,397,41,10,31,105,66,30,34,41,31,10,5,5,39
S01012192,Very good health,215,23,7,16,59,29,15,19,20,11,3,1,2,36
S01012192,Good health,135,17,3,14,34,29,12,12,15,10,4,2,2,2
S01012192,Fair health,34,1,0,1,10,7,2,2,4,6,2,1,1,0
S01012192,Bad health,12,0,0,0,1,1,1,1,2,4,1,1,0,1
S01012192,Very bad health,1,0,0,0,1,0,0,0,0,0,0,0,0,0
S01012193,All people aged 16 to 74,422,64,19,45,114,68,30,33,49,21,2,1,1,41
S01012193,Very good health,271,43,14,29,76,38,16,22,24,13,1,0,1,38
S01012193,Good health,123,21,5,16,30,23,11,9,20,6,0,0,0,3
S01012193,Fair health,20,0,0,0,6,5,3,1,3,2,0,0,0,0
S01012193,Bad health,6,0,0,0,1,1,0,1,2,0,1,1,0,0
S01012193,Very bad health,2,0,0,0,1,1,0,0,0,0,0,0,0,0
S01012194,All people aged 16 to 74,425,52,10,42,123,78,14,29,49,16,7,1,6,57
S01012194,Very good health,254,34,7,27,77,42,6,16,28,6,1,0,1,44
S01012194,Good health,135,17,3,14,33,29,6,9,18,7,4,0,4,12
S01012194,Fair health,34,1,0,1,12,7,2,4,3,2,2,1,1,1
S01012194,Bad health,2,0,0,0,1,0,0,0,0,1,0,0,0,0
S01012194,Very bad health,0,0,0,0,0,0,0,0,0,0,0,0,0,0
S01012195,All people aged 16 to 74,843,71,17,54,231,178,38,80,88,54,22,14,8,81
S01012195,Very good health,478,42,11,31,142,95,21,40,43,22,6,5,1,67
S01012195,Good health,258,24,5,19,71,56,11,27,27,23,7,3,4,12
S01012195,Fair health,74,5,1,4,14,18,3,8,13,4,7,4,3,2
S01012195,Bad health,26,0,0,0,3,7,3,4,4,3,2,2,0,0
S01012195,Very bad health,7,0,0,0,1,2,0,1,1,2,0,0,0,0
S01012196,All people aged 16 to 74,424,54,12,42,110,79,26,21,52,27,10,6,4,45
S01012196,Very good health,259,34,7,27,67,53,14,10,27,11,2,0,2,41
S01012196,Good health,124,15,5,10,34,21,10,9,20,7,4,3,1,4
S01012196,Fair health,29,5,0,5,8,3,0,2,3,6,2,1,1,0
S01012196,Bad health,8,0,0,0,1,2,1,0,1,3,0,0,0,0
S01012196,Very bad health,4,0,0,0,0,0,1,0,1,0,2,2,0,0
S01012197,All people aged 16 to 74,529,28,5,23,95,88,23,59,106,80,19,9,10,31
S01012197,Very good health,242,17,2,15,50,35,12,25,43,25,9,3,6,26
S01012197,Good health,161,10,3,7,32,32,7,18,31,23,5,2,3,3
S01012197,Fair health,75,0,0,0,6,16,3,9,22,15,2,1,1,2
S01012197,Bad health,43,0,0,0,6,5,1,6,9,13,3,3,0,0
S01012197,Very bad health,8,1,0,1,1,0,0,1,1,4,0,0,0,0
S01012198,All people aged 16 to 74,647,42,12,30,141,130,30,50,95,68,30,21,9,61
S01012198,Very good health,314,29,7,22,69,69,17,22,32,22,6,1,5,48
S01012198,Good health,208,11,5,6,50,41,10,16,31,26,11,8,3,12
S01012198,Fair health,80,1,0,1,15,14,3,6,18,12,11,10,1,0
S01012198,Bad health,32,1,0,1,4,3,0,4,11,7,1,1,0,1
S01012198,Very bad health,13,0,0,0,3,3,0,2,3,1,1,1,0,0
S01012199,All people aged 16 to 74,568,28,9,19,99,107,21,60,112,83,15,8,7,43
S01012199,Very good health,278,12,2,10,47,54,3,33,59,27,7,4,3,36
S01012199,Good health,157,13,5,8,36,30,7,9,28,23,5,2,3,6
S01012199,Fair health,84,3,2,1,11,17,6,10,15,21,0,0,0,1
S01012199,Bad health,34,0,0,0,2,3,2,6,8,11,2,1,1,0
S01012199,Very bad health,15,0,0,0,3,3,3,2,2,1,1,1,0,0
S01012200,All people aged 16 to 74,486,23,5,18,82,96,25,48,93,66,18,9,9,35
S01012200,Very good health,222,13,0,13,38,47,11,21,36,23,8,3,5,25
S01012200,Good health,144,6,3,3,34,28,7,8,34,14,5,3,2,8
S01012200,Fair health,82,3,1,2,7,13,4,15,14,21,3,2,1,2
S01012200,Bad health,30,1,1,0,2,7,3,3,7,6,1,0,1,0
S01012200,Very bad health,8,0,0,0,1,1,0,1,2,2,1,1,0,0
S01012201,All people aged 16 to 74,556,29,8,21,112,84,28,66,104,71,18,9,9,44
S01012201,Very good health,225,10,1,9,50,40,12,17,33,23,6,2,4,34
S01012201,Good health,202,14,5,9,44,25,10,29,41,27,5,1,4,7
S01012201,Fair health,83,2,1,1,13,14,5,13,17,13,5,4,1,1
S01012201,Bad health,29,2,1,1,2,4,0,6,10,4,1,1,0,0
S01012201,Very bad health,17,1,0,1,3,1,1,1,3,4,1,1,0,2
S01012202,All people aged 16 to 74,441,33,7,26,108,66,16,52,81,50,7,6,1,28
S01012202,Very good health,215,24,5,19,51,29,8,21,36,18,5,4,1,23
S01012202,Good health,150,7,2,5,41,24,4,17,31,20,1,1,0,5
S01012202,Fair health,49,2,0,2,9,10,2,11,6,9,0,0,0,0
S01012202,Bad health,20,0,0,0,6,2,2,2,5,3,0,0,0,0
S01012202,Very bad health,7,0,0,0,1,1,0,1,3,0,1,1,0,0
S01012203,All people aged 16 to 74,617,61,16,45,165,123,39,48,76,41,15,12,3,49
S01012203,Very good health,332,34,11,23,103,57,14,28,38,13,2,2,0,43
S01012203,Good health,206,24,5,19,49,45,18,15,28,17,5,2,3,5
S01012203,Fair health,63,2,0,2,12,14,7,4,9,8,6,6,0,1
S01012203,Bad health,12,1,0,1,1,5,0,0,1,3,1,1,0,0
S01012203,Very bad health,4,0,0,0,0,2,0,1,0,0,1,1,0,0
S01012204,All people aged 16 to 74,646,51,8,43,171,126,40,54,69,41,18,8,10,76
S01012204,Very good health,404,36,5,31,107,74,22,27,45,18,10,3,7,65
S01012204,Good health,183,14,3,11,48,41,12,20,17,18,4,3,1,9
S01012204,Fair health,43,1,0,1,10,7,5,6,5,3,4,2,2,2
S01012204,Bad health,11,0,0,0,5,3,1,1,1,0,0,0,0,0
S01012204,Very bad health,5,0,0,0,1,1,0,0,1,2,0,0,0,0
S01012205,All people aged 16 to 74,548,67,19,48,144,85,51,41,75,32,6,4,2,47
S01012205,Very good health,291,36,7,29,86,45,21,17,35,10,2,1,1,39
S01012205,Good health,190,25,10,15,37,31,23,21,29,14,3,2,1,7
S01012205,Fair health,49,5,1,4,13,7,5,3,8,7,0,0,0,1
S01012205,Bad health,14,1,1,0,5,2,2,0,3,0,1,1,0,0
S01012205,Very bad health,4,0,0,0,3,0,0,0,0,1,0,0,0,0
S01012206,All people aged 16 to 74,650,46,9,37,155,101,34,53,119,65,10,2,8,67
S01012206,Very good health,360,25,6,19,83,56,14,35,62,31,2,0,2,52
S01012206,Good health,210,19,3,16,55,34,11,12,38,22,6,0,6,13
S01012206,Fair health,55,2,0,2,11,7,7,5,13,7,1,1,0,2
S01012206,Bad health,19,0,0,0,6,3,1,0,5,3,1,1,0,0
S01012206,Very bad health,6,0,0,0,0,1,1,1,1,2,0,0,0,0
S01012207,All people aged 16 to 74,642,24,9,15,120,131,26,56,129,88,16,11,5,52
S01012207,Very good health,273,13,3,10,54,45,8,24,60,30,6,5,1,33
S01012207,Good health,239,10,6,4,42,55,13,20,38,39,4,0,4,18
S01012207,Fair health,88,1,0,1,13,21,4,10,22,15,1,1,0,1
S01012207,Bad health,34,0,0,0,9,8,0,2,8,3,4,4,0,0
S01012207,Very bad health,8,0,0,0,2,2,1,0,1,1,1,1,0,0
S01012208,All people aged 16 to 74,731,27,3,24,139,130,47,87,112,109,28,17,11,52
S01012208,Very good health,328,13,1,12,67,52,20,41,38,43,16,9,7,38
S01012208,Good health,261,11,2,9,48,45,15,32,47,42,9,6,3,12
S01012208,Fair health,90,2,0,2,15,22,8,7,21,11,3,2,1,1
S01012208,Bad health,44,1,0,1,9,9,2,7,5,10,0,0,0,1
S01012208,Very bad health,8,0,0,0,0,2,2,0,1,3,0,0,0,0
S01012209,All people aged 16 to 74,537,25,5,20,106,89,37,53,96,65,24,11,13,42
S01012209,Very good health,248,16,4,12,60,42,12,19,37,23,11,5,6,28
S01012209,Good health,175,6,1,5,39,31,12,22,32,17,7,2,5,9
S01012209,Fair health,73,3,0,3,7,8,8,7,17,15,4,2,2,4
S01012209,Bad health,26,0,0,0,0,5,3,2,7,7,2,2,0,0
S01012209,Very bad health,15,0,0,0,0,3,2,3,3,3,0,0,0,1
S01012210,All people aged 16 to 74,527,22,7,15,85,110,21,71,97,63,21,16,5,37
S01012210,Very good health,239,15,4,11,43,54,11,30,29,22,6,4,2,29
S01012210,Good health,172,6,3,3,28,36,6,22,38,20,10,8,2,6
S01012210,Fair health,80,0,0,0,13,14,3,12,21,14,1,1,0,2
S01012210,Bad health,31,1,0,1,1,4,1,6,9,5,4,3,1,0
S01012210,Very bad health,5,0,0,0,0,2,0,1,0,2,0,0,0,0
S01012211,All people aged 16 to 74,664,60,19,41,154,104,41,57,93,78,19,8,11,58
S01012211,Very good health,368,40,13,27,85,55,22,29,47,34,5,1,4,51
S01012211,Good health,182,14,5,9,48,28,13,17,32,20,5,0,5,5
S01012211,Fair health,77,3,1,2,18,14,3,7,7,17,6,4,2,2
S01012211,Bad health,32,2,0,2,3,5,3,3,7,7,2,2,0,0
S01012211,Very bad health,5,1,0,1,0,2,0,1,0,0,1,1,0,0
S01012212,All people aged 16 to 74,619,77,18,59,195,119,28,50,76,22,10,6,4,42
S01012212,Very good health,327,41,7,34,101,65,13,24,35,9,2,0,2,37
S01012212,Good health,214,28,9,19,71,44,12,15,29,8,2,1,1,5
S01012212,Fair health,54,6,2,4,19,7,3,6,7,3,3,2,1,0
S01012212,Bad health,19,2,0,2,4,3,0,5,3,2,0,0,0,0
S01012212,Very bad health,5,0,0,0,0,0,0,0,2,0,3,3,0,0
S01012213,All people aged 16 to 74,669,72,17,55,206,132,32,44,94,39,3,1,2,47
S01012213,Very good health,368,32,8,24,115,82,18,22,45,19,3,1,2,32
S01012213,Good health,235,30,8,22,75,36,10,18,38,14,0,0,0,14
S01012213,Fair health,52,9,1,8,12,11,2,2,11,4,0,0,0,1
S01012213,Bad health,13,1,0,1,4,2,2,2,0,2,0,0,0,0
S01012213,Very bad health,1,0,0,0,0,1,0,0,0,0,0,0,0,0
S01012214,All people aged 16 to 74,502,65,13,52,172,103,39,22,43,21,7,3,4,30
S01012214,Very good health,285,39,7,32,96,55,19,13,24,11,2,1,1,26
S01012214,Good health,154,22,6,16,52,33,15,6,10,7,5,2,3,4
S01012214,Fair health,48,4,0,4,20,12,3,2,4,3,0,0,0,0
S01012214,Bad health,12,0,0,0,4,1,1,1,5,0,0,0,0,0
S01012214,Very bad health,3,0,0,0,0,2,1,0,0,0,0,0,0,0
S01012215,All people aged 16 to 74,687,81,16,65,227,132,22,52,62,35,13,7,6,63
S01012215,Very good health,398,54,11,43,134,70,12,28,27,16,5,3,2,52
S01012215,Good health,228,25,5,20,76,45,8,19,30,12,5,2,3,8
S01012215,Fair health,53,2,0,2,14,15,2,4,5,6,3,2,1,2
S01012215,Bad health,6,0,0,0,2,2,0,1,0,0,0,0,0,1
S01012215,Very bad health,2,0,0,0,1,0,0,0,0,1,0,0,0,0
S01012216,All people aged 16 to 74,551,93,22,71,158,88,36,24,53,33,9,6,3,57
S01012216,Very good health,326,65,15,50,99,43,17,12,22,13,3,2,1,52
S01012216,Good health,174,23,4,19,48,36,12,8,24,15,5,3,2,3
S01012216,Fair health,39,5,3,2,10,5,5,2,6,3,1,1,0,2
S01012216,Bad health,8,0,0,0,1,2,2,1,1,1,0,0,0,0
S01012216,Very bad health,4,0,0,0,0,2,0,1,0,1,0,0,0,0
S01012217,All people aged 16 to 74,410,8,2,6,48,48,10,46,82,84,47,31,16,37
S01012217,Very good health,172,4,0,4,28,23,4,24,32,29,11,7,4,17
S01012217,Good health,135,3,2,1,17,14,2,9,33,32,11,7,4,14
S01012217,Fair health,57,1,0,1,2,8,2,6,7,16,12,5,7,3
S01012217,Bad health,35,0,0,0,1,3,1,7,7,4,10,10,0,2
S01012217,Very bad health,11,0,0,0,0,0,1,0,3,3,3,2,1,1
S01012218,All people aged 16 to 74,332,6,1,5,40,27,10,29,73,77,35,15,20,35
S01012218,Very good health,148,2,0,2,20,11,6,17,30,25,13,3,10,24
S01012218,Good health,114,2,0,2,16,6,4,6,25,28,16,7,9,11
S01012218,Fair health,41,2,1,1,3,6,0,4,9,14,3,2,1,0
S01012218,Bad health,21,0,0,0,1,0,0,1,9,8,2,2,0,0
S01012218,Very bad health,8,0,0,0,0,4,0,1,0,2,1,1,0,0
S01012219,All people aged 16 to 74,611,19,5,14,68,81,22,64,113,142,52,40,12,50
S01012219,Very good health,226,7,1,6,27,34,6,20,40,42,13,9,4,37
S01012219,Good health,215,9,4,5,32,31,10,26,38,45,21,16,5,3
S01012219,Fair health,105,3,0,3,6,11,4,8,19,37,12,9,3,5
S01012219,Bad health,51,0,0,0,2,4,1,8,12,14,5,5,0,5
S01012219,Very bad health,14,0,0,0,1,1,1,2,4,4,1,1,0,0
S01012220,All people aged 16 to 74,470,7,0,7,56,57,24,55,106,102,49,27,22,14
S01012220,Very good health,151,2,0,2,21,18,5,21,37,28,11,6,5,8
S01012220,Good health,159,4,0,4,19,22,13,20,35,25,16,7,9,5
S01012220,Fair health,96,0,0,0,11,11,2,9,20,29,14,7,7,0
S01012220,Bad health,49,1,0,1,3,2,4,5,12,16,6,5,1,0
S01012220,Very bad health,15,0,0,0,2,4,0,0,2,4,2,2,0,1
S01012221,All people aged 16 to 74,468,9,2,7,60,69,20,60,90,93,39,26,13,28
S01012221,Very good health,187,7,2,5,26,33,6,21,31,28,10,5,5,25
S01012221,Good health,160,2,0,2,21,17,9,19,39,37,13,10,3,3
S01012221,Fair health,78,0,0,0,9,15,3,11,16,15,9,5,4,0
S01012221,Bad health,35,0,0,0,3,4,1,7,4,12,4,4,0,0
S01012221,Very bad health,8,0,0,0,1,0,1,2,0,1,3,2,1,0
S01012222,All people aged 16 to 74,602,16,7,9,75,102,29,73,124,117,26,18,8,40
S01012222,Very good health,246,10,6,4,46,47,9,22,46,25,5,2,3,36
S01012222,Good health,193,3,1,2,14,36,9,26,39,51,11,6,5,4
S01012222,Fair health,93,2,0,2,9,11,4,11,25,27,4,4,0,0
S01012222,Bad health,58,0,0,0,5,7,6,13,14,9,4,4,0,0
S01012222,Very bad health,12,1,0,1,1,1,1,1,0,5,2,2,0,0
S01012223,All people aged 16 to 74,510,17,7,10,57,82,16,56,107,107,37,21,16,31
S01012223,Very good health,192,6,0,6,23,30,5,22,37,42,10,5,5,17
S01012223,Good health,165,7,4,3,21,23,9,18,38,27,13,7,6,9
S01012223,Fair health,103,4,3,1,9,15,2,9,26,26,9,6,3,3
S01012223,Bad health,43,0,0,0,3,13,0,5,5,10,5,3,2,2
S01012223,Very bad health,7,0,0,0,1,1,0,2,1,2,0,0,0,0
S01012224,All people aged 16 to 74,544,27,6,21,68,82,23,64,106,91,33,25,8,50
S01012224,Very good health,246,16,3,13,34,32,12,26,51,34,4,3,1,37
S01012224,Good health,198,10,2,8,22,35,7,26,33,39,16,10,6,10
S01012224,Fair health,62,1,1,0,8,8,4,7,15,10,8,7,1,1
S01012224,Bad health,32,0,0,0,4,6,0,5,5,7,4,4,0,1
S01012224,Very bad health,6,0,0,0,0,1,0,0,2,1,1,1,0,1
S01012225,All people aged 16 to 74,750,24,7,17,109,100,35,80,157,150,44,29,15,51
S01012225,Very good health,361,11,0,11,63,48,20,43,73,49,15,7,8,39
S01012225,Good health,226,4,1,3,30,35,7,25,44,53,19,13,6,9
S01012225,Fair health,110,8,5,3,13,11,8,5,28,30,4,3,1,3
S01012225,Bad health,44,1,1,0,2,4,0,6,10,16,5,5,0,0
S01012225,Very bad health,9,0,0,0,1,2,0,1,2,2,1,1,0,0
S01012226,All people aged 16 to 74,538,21,6,15,95,105,27,52,99,76,18,7,11,45
S01012226,Very good health,234,13,4,9,48,34,7,21,40,31,7,3,4,33
S01012226,Good health,190,7,2,5,35,49,13,18,32,23,5,0,5,8
S01012226,Fair health,73,0,0,0,6,16,6,6,16,15,4,2,2,4
S01012226,Bad health,26,1,0,1,5,3,1,4,7,4,1,1,0,0
S01012226,Very bad health,15,0,0,0,1,3,0,3,4,3,1,1,0,0
S01012227,All people aged 16 to 74,496,14,4,10,90,91,15,61,77,82,24,10,14,42
S01012227,Very good health,237,6,1,5,46,40,6,30,36,34,8,4,4,31
S01012227,Good health,174,5,1,4,25,35,8,20,30,33,10,3,7,8
S01012227,Fair health,59,3,2,1,16,13,1,6,7,5,6,3,3,2
S01012227,Bad health,23,0,0,0,3,3,0,5,4,7,0,0,0,1
S01012227,Very bad health,3,0,0,0,0,0,0,0,0,3,0,0,0,0
S01012228,All people aged 16 to 74,511,35,7,28,62,97,27,46,101,86,14,9,5,43
S01012228,Very good health,231,17,4,13,30,43,13,19,39,28,5,2,3,37
S01012228,Good health,177,12,2,10,24,34,6,19,43,30,4,2,2,5
S01012228,Fair health,61,6,1,5,7,12,4,6,8,15,3,3,0,0
S01012228,Bad health,31,0,0,0,1,7,4,1,9,7,2,2,0,0
S01012228,Very bad health,11,0,0,0,0,1,0,1,2,6,0,0,0,1
S01012229,All people aged 16 to 74,542,68,12,56,153,90,31,46,58,40,16,5,11,40
S01012229,Very good health,288,39,7,32,80,52,13,18,37,12,5,1,4,32
S01012229,Good health,184,22,3,19,59,30,13,15,15,16,9,2,7,5
S01012229,Fair health,43,6,2,4,10,5,2,8,5,5,0,0,0,2
S01012229,Bad health,20,0,0,0,3,2,3,5,1,5,0,0,0,1
S01012229,Very bad health,7,1,0,1,1,1,0,0,0,2,2,2,0,0
S01012230,All people aged 16 to 74,692,102,25,77,206,137,39,50,57,31,12,6,6,58
S01012230,Very good health,437,60,13,47,129,95,21,31,31,12,5,1,4,53
S01012230,Good health,192,33,11,22,59,31,12,17,18,15,4,3,1,3
S01012230,Fair health,52,9,1,8,14,8,5,2,7,3,2,1,1,2
S01012230,Bad health,10,0,0,0,4,3,1,0,1,1,0,0,0,0
S01012230,Very bad health,1,0,0,0,0,0,0,0,0,0,1,1,0,0
S01012231,All people aged 16 to 74,619,105,19,86,183,88,54,34,50,24,13,8,5,68
S01012231,Very good health,401,65,12,53,107,53,33,23,35,15,7,4,3,63
S01012231,Good health,185,37,7,30,65,32,19,9,10,5,4,3,1,4
S01012231,Fair health,21,3,0,3,5,3,1,1,3,2,2,1,1,1
S01012231,Bad health,10,0,0,0,5,0,1,1,2,1,0,0,0,0
S01012231,Very bad health,2,0,0,0,1,0,0,0,0,1,0,0,0,0
S01012232,All people aged 16 to 74,637,101,14,87,212,91,39,36,56,26,10,4,6,66
S01012232,Very good health,391,58,6,52,132,47,22,18,39,11,8,2,6,56
S01012232,Good health,185,35,6,29,62,32,11,16,11,9,2,2,0,7
S01012232,Fair health,48,8,2,6,14,10,3,2,4,4,0,0,0,3
S01012232,Bad health,13,0,0,0,4,2,3,0,2,2,0,0,0,0
S01012232,Very bad health,0,0,0,0,0,0,0,0,0,0,0,0,0,0
S01012233,All people aged 16 to 74,714,120,27,93,231,115,44,35,57,37,13,6,7,62
S01012233,Very good health,437,80,18,62,140,72,18,17,27,20,7,3,4,56
S01012233,Good health,201,28,5,23,72,31,18,12,21,12,3,2,1,4
S01012233,Fair health,60,11,3,8,14,10,8,2,6,4,3,1,2,2
S01012233,Bad health,14,1,1,0,4,2,0,4,3,0,0,0,0,0
S01012233,Very bad health,2,0,0,0,1,0,0,0,0,1,0,0,0,0
S01012234,All people aged 16 to 74,811,138,32,106,245,115,57,48,61,47,19,13,6,81
S01012234,Very good health,504,87,20,67,157,69,29,27,32,24,10,6,4,69
S01012234,Good health,230,45,12,33,72,35,21,13,17,12,6,4,2,9
S01012234,Fair health,53,6,0,6,13,7,6,4,8,6,2,2,0,1
S01012234,Bad health,22,0,0,0,1,4,1,4,4,5,1,1,0,2
S01012234,Very bad health,2,0,0,0,2,0,0,0,0,0,0,0,0,0
S01012235,All people aged 16 to 74,356,67,16,51,112,71,24,19,21,11,4,3,1,27
S01012235,Very good health,213,34,8,26,72,44,12,11,11,3,2,1,1,24
S01012235,Good health,103,27,8,19,26,19,10,5,6,6,1,1,0,3
S01012235,Fair health,24,4,0,4,10,4,1,1,3,1,0,0,0,0
S01012235,Bad health,14,2,0,2,3,4,1,1,1,1,1,1,0,0
S01012235,Very bad health,2,0,0,0,1,0,0,1,0,0,0,0,0,0
S01012236,All people aged 16 to 74,451,52,13,39,105,72,28,37,55,46,21,11,10,35
S01012236,Very good health,219,29,6,23,51,38,12,12,21,18,7,2,5,31
S01012236,Good health,160,17,7,10,38,26,14,16,23,16,6,3,3,4
S01012236,Fair health,49,4,0,4,11,6,1,7,7,8,5,3,2,0
S01012236,Bad health,17,2,0,2,4,2,0,2,2,3,2,2,0,0
S01012236,Very bad health,6,0,0,0,1,0,1,0,2,1,1,1,0,0
S01012237,All people aged 16 to 74,580,136,32,104,185,78,43,14,32,24,14,9,5,54
S01012237,Very good health,331,93,24,69,97,38,23,7,13,10,7,3,4,43
S01012237,Good health,194,39,6,33,68,32,12,5,16,8,4,4,0,10
S01012237,Fair health,42,3,2,1,14,7,5,2,2,5,3,2,1,1
S01012237,Bad health,10,1,0,1,5,1,2,0,0,1,0,0,0,0
S01012237,Very bad health,3,0,0,0,1,0,1,0,1,0,0,0,0,0
S01012238,All people aged 16 to 74,455,46,13,33,98,51,32,43,67,62,22,11,11,34
S01012238,Very good health,208,26,6,20,46,26,15,15,31,18,4,1,3,27
S01012238,Good health,136,14,4,10,33,15,9,18,22,13,7,3,4,5
S01012238,Fair health,76,3,1,2,14,8,8,6,8,19,9,5,4,1
S01012238,Bad health,20,0,0,0,4,2,0,3,4,4,2,2,0,1
S01012238,Very bad health,15,3,2,1,1,0,0,1,2,8,0,0,0,0
S01012239,All people aged 16 to 74,444,28,6,22,66,59,26,38,78,81,30,20,10,38
S01012239,Very good health,190,13,3,10,31,29,5,12,31,35,10,7,3,24
S01012239,Good health,150,8,0,8,20,20,13,16,31,16,13,7,6,13
S01012239,Fair health,65,4,2,2,10,8,6,4,11,18,3,2,1,1
S01012239,Bad health,30,2,0,2,4,2,2,5,4,8,3,3,0,0
S01012239,Very bad health,9,1,1,0,1,0,0,1,1,4,1,1,0,0
S01012240,All people aged 16 to 74,616,58,13,45,128,63,38,64,96,87,31,19,12,51
S01012240,Very good health,294,30,6,24,80,29,16,24,38,28,10,6,4,39
S01012240,Good health,187,20,5,15,36,18,16,24,27,25,9,3,6,12
S01012240,Fair health,87,6,2,4,10,12,4,8,19,23,5,4,1,0
S01012240,Bad health,38,0,0,0,1,3,2,6,10,11,5,4,1,0
S01012240,Very bad health,10,2,0,2,1,1,0,2,2,0,2,2,0,0
S01012241,All people aged 16 to 74,418,126,15,111,126,49,38,12,21,15,10,8,2,21
S01012241,Very good health,233,75,11,64,74,23,23,3,8,3,7,5,2,17
S01012241,Good health,142,38,3,35,43,23,13,7,9,6,2,2,0,1
S01012241,Fair health,37,12,1,11,7,2,1,2,4,6,1,1,0,2
S01012241,Bad health,5,1,0,1,2,1,1,0,0,0,0,0,0,0
S01012241,Very bad health,1,0,0,0,0,0,0,0,0,0,0,0,0,1
S01012242,All people aged 16 to 74,587,118,12,106,179,93,51,21,32,19,10,6,4,64
S01012242,Very good health,345,70,9,61,106,52,27,9,17,6,7,6,1,51
S01012242,Good health,191,41,1,40,60,36,15,10,11,6,2,0,2,10
S01012242,Fair health,36,5,2,3,9,4,6,1,3,4,1,0,1,3
S01012242,Bad health,11,2,0,2,3,0,3,1,0,2,0,0,0,0
S01012242,Very bad health,4,0,0,0,1,1,0,0,1,1,0,0,0,0
S01012243,All people aged 16 to 74,449,73,16,57,138,68,27,27,42,29,14,9,5,31
S01012243,Very good health,240,45,9,36,74,32,12,13,22,11,8,6,2,23
S01012243,Good health,139,19,6,13,46,22,10,10,11,10,3,1,2,8
S01012243,Fair health,54,8,1,7,13,11,5,3,7,4,3,2,1,0
S01012243,Bad health,10,0,0,0,4,3,0,0,1,2,0,0,0,0
S01012243,Very bad health,6,1,0,1,1,0,0,1,1,2,0,0,0,0
S01012244,All people aged 16 to 74,709,184,38,146,182,57,95,17,64,24,46,45,1,40
S01012244,Very good health,449,132,27,105,112,38,51,12,43,14,9,8,1,38
S01012244,Good health,213,42,7,35,59,16,36,5,19,7,27,27,0,2
S01012244,Fair health,40,10,4,6,8,2,6,0,2,2,10,10,0,0
S01012244,Bad health,7,0,0,0,3,1,2,0,0,1,0,0,0,0
S01012244,Very bad health,0,0,0,0,0,0,0,0,0,0,0,0,0,0
S01012245,All people aged 16 to 74,503,103,13,90,155,57,46,24,51,30,12,4,8,25
S01012245,Very good health,274,67,11,56,80,30,28,11,20,14,2,1,1,22
S01012245,Good health,164,31,1,30,58,23,11,4,20,11,4,1,3,2
S01012245,Fair health,52,4,0,4,14,4,6,6,11,1,5,1,4,1
S01012245,Bad health,10,1,1,0,3,0,0,2,0,4,0,0,0,0
S01012245,Very bad health,3,0,0,0,0,0,1,1,0,0,1,1,0,0
S01012246,All people aged 16 to 74,550,131,24,107,162,62,68,25,40,22,5,3,2,35
S01012246,Very good health,341,87,18,69,101,34,42,12,17,14,3,2,1,31
S01012246,Good health,165,37,6,31,53,15,19,10,18,7,2,1,1,4
S01012246,Fair health,34,5,0,5,7,12,2,3,4,1,0,0,0,0
S01012246,Bad health,7,2,0,2,1,1,3,0,0,0,0,0,0,0
S01012246,Very bad health,3,0,0,0,0,0,2,0,1,0,0,0,0,0
S01012247,All people aged 16 to 74,553,111,20,91,158,47,60,45,62,25,13,10,3,32
S01012247,Very good health,335,72,14,58,100,26,34,28,34,12,3,2,1,26
S01012247,Good health,161,31,4,27,42,15,21,14,21,6,6,4,2,5
S01012247,Fair health,44,6,2,4,14,5,4,1,6,5,2,2,0,1
S01012247,Bad health,9,2,0,2,1,0,1,2,1,1,1,1,0,0
S01012247,Very bad health,4,0,0,0,1,1,0,0,0,1,1,1,0,0
S01012248,All people aged 16 to 74,607,91,22,69,138,57,113,42,69,41,15,6,9,41
S01012248,Very good health,358,56,12,44,85,30,66,19,39,21,8,3,5,34
S01012248,Good health,183,27,6,21,41,23,35,17,22,11,4,1,3,3
S01012248,Fair health,53,7,3,4,8,3,10,5,8,6,2,1,1,4
S01012248,Bad health,10,1,1,0,2,1,2,0,0,3,1,1,0,0
S01012248,Very bad health,3,0,0,0,2,0,0,1,0,0,0,0,0,0
S01012249,All people aged 16 to 74,641,109,20,89,135,48,125,40,80,48,19,11,8,37
S01012249,Very good health,365,73,13,60,79,27,70,25,39,18,5,4,1,29
S01012249,Good health,191,29,6,23,43,13,38,9,24,19,10,4,6,6
S01012249,Fair health,60,4,0,4,12,5,10,4,12,10,1,1,0,2
S01012249,Bad health,20,2,1,1,1,3,5,2,4,1,2,1,1,0
S01012249,Very bad health,5,1,0,1,0,0,2,0,1,0,1,1,0,0
S01012250,All people aged 16 to 74,511,57,19,38,140,50,101,34,53,42,14,9,5,20
S01012250,Very good health,289,36,13,23,86,32,54,17,17,20,9,6,3,18
S01012250,Good health,184,19,6,13,48,12,38,14,27,21,4,2,2,1
S01012250,Fair health,28,1,0,1,2,5,9,2,6,1,1,1,0,1
S01012250,Bad health,8,1,0,1,2,1,0,1,3,0,0,0,0,0
S01012250,Very bad health,2,0,0,0,2,0,0,0,0,0,0,0,0,0
S01012251,All people aged 16 to 74,671,35,3,32,113,66,64,78,133,115,30,14,16,37
S01012251,Very good health,333,19,1,18,64,37,32,37,59,43,14,5,9,28
S01012251,Good health,234,10,1,9,38,21,21,28,56,41,10,5,5,9
S01012251,Fair health,67,5,1,4,6,4,9,10,11,17,5,3,2,0
S01012251,Bad health,30,1,0,1,4,3,2,3,6,10,1,1,0,0
S01012251,Very bad health,7,0,0,0,1,1,0,0,1,4,0,0,0,0
S01012252,All people aged 16 to 74,510,34,7,27,94,56,53,50,99,65,29,10,19,30
S01012252,Very good health,252,22,4,18,51,31,29,23,40,28,6,2,4,22
S01012252,Good health,184,8,2,6,31,20,18,16,40,25,19,6,13,7
S01012252,Fair health,55,4,1,3,8,4,5,10,11,8,4,2,2,1
S01012252,Bad health,14,0,0,0,3,1,0,1,5,4,0,0,0,0
S01012252,Very bad health,5,0,0,0,1,0,1,0,3,0,0,0,0,0
S01012253,All people aged 16 to 74,665,62,10,52,142,74,63,57,112,98,25,15,10,32
S01012253,Very good health,298,34,3,31,73,32,28,27,39,31,7,3,4,27
S01012253,Good health,233,22,4,18,52,28,22,22,39,39,6,2,4,3
S01012253,Fair health,99,6,3,3,16,10,7,6,22,20,10,8,2,2
S01012253,Bad health,27,0,0,0,1,4,5,2,9,5,1,1,0,0
S01012253,Very bad health,8,0,0,0,0,0,1,0,3,3,1,1,0,0
S01012254,All people aged 16 to 74,621,62,13,49,163,73,62,61,95,58,17,6,11,30
S01012254,Very good health,339,42,8,34,97,37,31,23,50,27,5,2,3,27
S01012254,Good health,207,17,4,13,53,30,22,30,25,19,8,2,6,3
S01012254,Fair health,60,3,1,2,10,5,9,5,17,9,2,1,1,0
S01012254,Bad health,11,0,0,0,2,0,0,2,3,3,1,0,1,0
S01012254,Very bad health,4,0,0,0,1,1,0,1,0,0,1,1,0,0
S01012255,All people aged 16 to 74,627,99,17,82,161,62,68,49,76,66,16,7,9,30
S01012255,Very good health,333,73,10,63,87,36,27,21,33,28,7,4,3,21
S01012255,Good health,209,20,5,15,57,18,30,18,30,28,3,2,1,5
S01012255,Fair health,65,4,1,3,13,5,9,7,12,5,6,1,5,4
S01012255,Bad health,16,2,1,1,2,3,2,2,1,4,0,0,0,0
S01012255,Very bad health,4,0,0,0,2,0,0,1,0,1,0,0,0,0
S01012256,All people aged 16 to 74,619,82,21,61,180,89,50,38,74,52,17,8,9,37
S01012256,Very good health,357,50,11,39,110,49,26,23,36,29,4,2,2,30
S01012256,Good health,205,24,9,15,55,34,17,12,28,18,10,6,4,7
S01012256,Fair health,44,7,1,6,15,4,5,2,7,1,3,0,3,0
S01012256,Bad health,11,1,0,1,0,2,0,1,3,4,0,0,0,0
S01012256,Very bad health,2,0,0,0,0,0,2,0,0,0,0,0,0,0
S01012257,All people aged 16 to 74,698,64,12,52,165,81,53,58,111,107,25,14,11,34
S01012257,Very good health,358,42,9,33,91,38,31,29,48,37,13,6,7,29
S01012257,Good health,267,17,3,14,62,35,13,23,48,56,8,5,3,5
S01012257,Fair health,63,5,0,5,11,7,8,6,13,10,3,3,0,0
S01012257,Bad health,10,0,0,0,1,1,1,0,2,4,1,0,1,0
S01012257,Very bad health,0,0,0,0,0,0,0,0,0,0,0,0,0,0
S01012258,All people aged 16 to 74,517,104,15,89,201,69,43,19,26,18,12,7,5,25
S01012258,Very good health,316,71,10,61,129,43,17,8,14,10,3,2,1,21
S01012258,Good health,167,28,3,25,58,21,23,9,10,7,7,3,4,4
S01012258,Fair health,24,5,2,3,10,3,1,2,1,0,2,2,0,0
S01012258,Bad health,9,0,0,0,4,2,2,0,1,0,0,0,0,0
S01012258,Very bad health,1,0,0,0,0,0,0,0,0,1,0,0,0,0
S01012259,All people aged 16 to 74,428,76,15,61,156,40,56,11,37,19,11,4,7,22
S01012259,Very good health,256,47,9,38,98,18,33,5,21,10,4,3,1,20
S01012259,Good health,134,24,4,20,44,18,17,6,12,6,5,0,5,2
S01012259,Fair health,31,5,2,3,11,3,6,0,2,2,2,1,1,0
S01012259,Bad health,6,0,0,0,3,1,0,0,1,1,0,0,0,0
S01012259,Very bad health,1,0,0,0,0,0,0,0,1,0,0,0,0,0
S01012260,All people aged 16 to 74,597,67,15,52,140,62,73,39,100,76,16,10,6,24
S01012260,Very good health,299,42,9,33,73,39,34,17,34,37,8,5,3,15
S01012260,Good health,214,20,5,15,52,18,26,15,46,26,4,2,2,7
S01012260,Fair health,63,5,1,4,12,3,10,4,15,11,2,1,1,1
S01012260,Bad health,17,0,0,0,1,2,1,3,5,2,2,2,0,1
S01012260,Very bad health,4,0,0,0,2,0,2,0,0,0,0,0,0,0
S01012261,All people aged 16 to 74,596,96,29,67,199,81,50,30,65,28,9,3,6,38
S01012261,Very good health,379,68,19,49,121,43,38,20,36,17,3,1,2,33
S01012261,Good health,170,23,8,15,63,28,11,8,22,8,3,0,3,4
S01012261,Fair health,36,5,2,3,12,7,1,1,5,1,3,2,1,1
S01012261,Bad health,9,0,0,0,3,2,0,1,2,1,0,0,0,0
S01012261,Very bad health,2,0,0,0,0,1,0,0,0,1,0,0,0,0
S01012262,All people aged 16 to 74,609,96,24,72,144,76,118,40,76,28,10,5,5,21
S01012262,Very good health,369,60,13,47,85,50,69,27,41,14,4,2,2,19
S01012262,Good health,175,28,8,20,44,21,34,7,26,11,2,0,2,2
S01012262,Fair health,50,7,2,5,9,4,13,6,8,1,2,1,1,0
S01012262,Bad health,10,0,0,0,5,0,0,0,1,2,2,2,0,0
S01012262,Very bad health,5,1,1,0,1,1,2,0,0,0,0,0,0,0
S01012263,All people aged 16 to 74,547,27,7,20,106,47,78,55,102,90,17,7,10,25
S01012263,Very good health,271,18,4,14,60,21,47,23,38,40,7,3,4,17
S01012263,Good health,188,8,2,6,33,11,24,17,50,35,2,0,2,8
S01012263,Fair health,71,1,1,0,11,11,6,14,13,8,7,4,3,0
S01012263,Bad health,15,0,0,0,2,3,1,1,1,6,1,0,1,0
S01012263,Very bad health,2,0,0,0,0,1,0,0,0,1,0,0,0,0
S01012264,All people aged 16 to 74,339,52,10,42,92,41,29,14,55,38,5,2,3,13
S01012264,Very good health,172,34,4,30,53,19,11,5,20,18,2,1,1,10
S01012264,Good health,120,12,5,7,30,15,13,7,22,16,3,1,2,2
S01012264,Fair health,37,4,1,3,7,5,5,2,11,2,0,0,0,1
S01012264,Bad health,7,1,0,1,1,2,0,0,2,1,0,0,0,0
S01012264,Very bad health,3,1,0,1,1,0,0,0,0,1,0,0,0,0
S01012265,All people aged 16 to 74,564,19,5,14,81,43,51,64,115,134,24,15,9,33
S01012265,Very good health,271,10,4,6,43,24,25,36,51,49,7,4,3,26
S01012265,Good health,192,3,1,2,27,12,16,22,40,56,10,6,4,6
S01012265,Fair health,66,3,0,3,6,4,6,4,16,20,6,4,2,1
S01012265,Bad health,29,1,0,1,5,1,4,2,7,8,1,1,0,0
S01012265,Very bad health,6,2,0,2,0,2,0,0,1,1,0,0,0,0
S01012266,All people aged 16 to 74,770,74,19,55,181,112,79,82,103,90,18,8,10,31
S01012266,Very good health,379,46,10,36,95,55,42,37,44,30,6,3,3,24
S01012266,Good health,274,22,6,16,65,40,32,31,41,37,3,1,2,3
S01012266,Fair health,74,5,2,3,14,10,3,8,11,13,6,3,3,4
S01012266,Bad health,35,1,1,0,7,5,2,5,6,7,2,0,2,0
S01012266,Very bad health,8,0,0,0,0,2,0,1,1,3,1,1,0,0
S01012267,All people aged 16 to 74,533,74,20,54,155,61,75,35,61,49,7,3,4,16
S01012267,Very good health,300,46,10,36,95,33,35,23,27,22,4,2,2,15
S01012267,Good health,183,24,9,15,51,23,33,9,21,20,1,1,0,1
S01012267,Fair health,39,4,1,3,8,4,4,3,10,4,2,0,2,0
S01012267,Bad health,9,0,0,0,1,1,3,0,1,3,0,0,0,0
S01012267,Very bad health,2,0,0,0,0,0,0,0,2,0,0,0,0,0
S01012268,All people aged 16 to 74,470,59,16,43,123,38,95,22,63,35,9,3,6,26
S01012268,Very good health,270,34,11,23,79,26,48,10,31,17,2,0,2,23
S01012268,Good health,143,19,4,15,31,12,33,10,20,10,5,3,2,3
S01012268,Fair health,42,5,1,4,11,0,11,1,8,5,1,0,1,0
S01012268,Bad health,12,1,0,1,2,0,1,0,4,3,1,0,1,0
S01012268,Very bad health,3,0,0,0,0,0,2,1,0,0,0,0,0,0
S01012269,All people aged 16 to 74,711,60,11,49,163,86,89,55,104,98,22,12,10,34
S01012269,Very good health,387,36,10,26,89,45,45,34,57,42,11,6,5,28
S01012269,Good health,238,18,0,18,61,30,32,16,34,36,7,4,3,4
S01012269,Fair health,65,5,1,4,9,9,5,3,12,17,3,1,2,2
S01012269,Bad health,16,1,0,1,4,1,5,2,0,2,1,1,0,0
S01012269,Very bad health,5,0,0,0,0,1,2,0,1,1,0,0,0,0
S01012270,All people aged 16 to 74,550,27,9,18,104,63,46,36,116,91,27,15,12,40
S01012270,Very good health,272,12,1,11,55,34,24,18,55,35,7,2,5,32
S01012270,Good health,187,14,8,6,31,19,18,11,38,39,11,6,5,6
S01012270,Fair health,66,1,0,1,15,7,2,5,18,11,5,3,2,2
S01012270,Bad health,22,0,0,0,3,2,2,1,4,6,4,4,0,0
S01012270,Very bad health,3,0,0,0,0,1,0,1,1,0,0,0,0,0
S01012271,All people aged 16 to 74,780,93,20,73,216,88,154,49,80,32,22,16,6,46
S01012271,Very good health,477,67,16,51,136,46,91,27,44,18,10,10,0,38
S01012271,Good health,230,24,4,20,60,37,46,18,22,9,9,3,6,5
S01012271,Fair health,58,1,0,1,18,2,16,2,12,3,3,3,0,1
S01012271,Bad health,13,1,0,1,2,3,1,1,2,1,0,0,0,2
S01012271,Very bad health,2,0,0,0,0,0,0,1,0,1,0,0,0,0
S01012272,All people aged 16 to 74,513,78,19,59,153,62,50,28,67,33,10,4,6,32
S01012272,Very good health,290,47,9,38,89,34,25,15,31,18,5,2,3,26
S01012272,Good health,148,25,8,17,41,16,17,7,22,13,2,1,1,5
S01012272,Fair health,62,5,1,4,19,10,8,3,13,1,2,1,1,1
S01012272,Bad health,9,1,1,0,2,2,0,2,1,0,1,0,1,0
S01012272,Very bad health,4,0,0,0,2,0,0,1,0,1,0,0,0,0
S01012273,All people aged 16 to 74,543,74,22,52,143,88,62,32,72,29,10,6,4,33
S01012273,Very good health,310,39,7,32,89,45,35,15,42,16,4,2,2,25
S01012273,Good health,171,25,12,13,41,30,22,14,21,8,3,2,1,7
S01012273,Fair health,54,9,3,6,11,11,5,3,8,5,2,1,1,0
S01012273,Bad health,7,1,0,1,2,2,0,0,1,0,0,0,0,1
S01012273,Very bad health,1,0,0,0,0,0,0,0,0,0,1,1,0,0
S01012274,All people aged 16 to 74,718,53,7,46,161,113,67,63,103,89,26,12,14,43
S01012274,Very good health,358,30,4,26,86,59,35,30,42,34,10,4,6,32
S01012274,Good health,270,18,2,16,57,44,22,28,44,38,9,5,4,10
S01012274,Fair health,67,4,1,3,14,7,7,3,15,11,5,1,4,1
S01012274,Bad health,20,1,0,1,3,3,2,2,2,6,1,1,0,0
S01012274,Very bad health,3,0,0,0,1,0,1,0,0,0,1,1,0,0
S01012275,All people aged 16 to 74,681,33,8,25,112,65,50,60,106,96,40,21,19,119
S01012275,Very good health,325,16,4,12,59,26,19,29,45,42,11,3,8,78
S01012275,Good health,263,13,2,11,41,31,24,18,46,36,17,10,7,37
S01012275,Fair health,62,3,1,2,8,7,4,6,13,10,7,4,3,4
S01012275,Bad health,22,0,0,0,4,1,1,6,1,6,3,3,0,0
S01012275,Very bad health,9,1,1,0,0,0,2,1,1,2,2,1,1,0
S01012276,All people aged 16 to 74,703,58,14,44,177,88,53,54,114,82,33,19,14,44
S01012276,Very good health,368,33,9,24,105,53,28,30,44,33,10,5,5,32
S01012276,Good health,239,22,5,17,61,27,17,15,44,34,7,3,4,12
S01012276,Fair health,71,2,0,2,6,7,8,6,19,12,11,6,5,0
S01012276,Bad health,20,1,0,1,4,1,0,2,5,3,4,4,0,0
S01012276,Very bad health,5,0,0,0,1,0,0,1,2,0,1,1,0,0
S01012277,All people aged 16 to 74,774,41,12,29,174,84,72,63,136,116,34,16,18,54
S01012277,Very good health,395,23,9,14,112,47,31,34,60,44,11,3,8,33
S01012277,Good health,268,15,2,13,45,30,32,21,50,43,11,5,6,21
S01012277,Fair health,79,0,0,0,12,4,6,5,21,22,9,6,3,0
S01012277,Bad health,29,3,1,2,5,3,2,2,4,7,3,2,1,0
S01012277,Very bad health,3,0,0,0,0,0,1,1,1,0,0,0,0,0
S01012278,All people aged 16 to 74,530,35,8,27,105,62,40,28,95,70,19,11,8,76
S01012278,Very good health,267,23,5,18,51,32,17,15,46,24,3,2,1,56
S01012278,Good health,156,9,2,7,39,18,12,8,35,15,5,1,4,15
S01012278,Fair health,63,3,1,2,11,9,4,3,7,16,7,4,3,3
S01012278,Bad health,32,0,0,0,4,2,6,2,4,10,2,2,0,2
S01012278,Very bad health,12,0,0,0,0,1,1,0,3,5,2,2,0,0
S01012279,All people aged 16 to 74,600,33,10,23,115,74,33,69,99,84,37,28,9,56
S01012279,Very good health,297,20,7,13,61,38,13,34,41,37,12,8,4,41
S01012279,Good health,212,10,3,7,37,30,14,25,36,35,10,8,2,15
S01012279,Fair health,57,2,0,2,9,4,4,6,16,4,12,9,3,0
S01012279,Bad health,27,1,0,1,7,1,2,4,4,6,2,2,0,0
S01012279,Very bad health,7,0,0,0,1,1,0,0,2,2,1,1,0,0
S01012280,All people aged 16 to 74,698,23,3,20,99,92,50,62,151,128,39,19,20,54
S01012280,Very good health,337,13,1,12,47,47,24,26,63,60,15,10,5,42
S01012280,Good health,254,9,2,7,39,32,21,29,53,45,17,8,9,9
S01012280,Fair health,78,1,0,1,10,10,4,5,24,18,4,1,3,2
S01012280,Bad health,23,0,0,0,2,3,1,1,8,4,3,0,3,1
S01012280,Very bad health,6,0,0,0,1,0,0,1,3,1,0,0,0,0
S01012281,All people aged 16 to 74,527,19,9,10,107,74,38,57,120,65,19,13,6,28
S01012281,Very good health,260,14,7,7,57,36,21,31,54,27,3,3,0,17
S01012281,Good health,209,5,2,3,37,36,11,22,51,28,9,4,5,10
S01012281,Fair health,43,0,0,0,13,1,6,2,10,6,4,3,1,1
S01012281,Bad health,13,0,0,0,0,1,0,2,4,3,3,3,0,0
S01012281,Very bad health,2,0,0,0,0,0,0,0,1,1,0,0,0,0
S01012282,All people aged 16 to 74,833,63,17,46,158,112,69,36,103,53,22,18,4,217
S01012282,Very good health,438,31,10,21,95,53,25,20,40,19,7,5,2,148
S01012282,Good health,295,24,5,19,53,43,38,9,40,20,9,8,1,59
S01012282,Fair health,83,7,2,5,8,15,4,6,18,12,4,3,1,9
S01012282,Bad health,12,1,0,1,1,0,2,1,2,2,2,2,0,1
S01012282,Very bad health,5,0,0,0,1,1,0,0,3,0,0,0,0,0
S01012283,All people aged 16 to 74,629,68,23,45,136,89,65,44,79,70,22,8,14,56
S01012283,Very good health,369,42,12,30,87,48,34,31,44,26,8,2,6,49
S01012283,Good health,171,18,7,11,36,30,21,8,20,23,8,1,7,7
S01012283,Fair health,55,5,4,1,8,8,5,2,7,17,3,2,1,0
S01012283,Bad health,27,1,0,1,4,1,5,3,7,4,2,2,0,0
S01012283,Very bad health,7,2,0,2,1,2,0,0,1,0,1,1,0,0
S01012284,All people aged 16 to 74,569,37,12,25,91,67,43,40,103,89,46,28,18,53
S01012284,Very good health,257,16,3,13,45,28,19,21,38,33,24,15,9,33
S01012284,Good health,223,14,5,9,34,35,14,15,41,35,17,8,9,18
S01012284,Fair health,61,4,1,3,9,4,7,2,18,13,2,2,0,2
S01012284,Bad health,23,3,3,0,2,0,3,2,4,7,2,2,0,0
S01012284,Very bad health,5,0,0,0,1,0,0,0,2,1,1,1,0,0
S01012285,All people aged 16 to 74,416,35,9,26,133,70,29,26,52,42,8,7,1,21
S01012285,Very good health,217,22,7,15,77,41,12,8,20,16,2,2,0,19
S01012285,Good health,137,7,2,5,41,26,14,11,23,13,1,1,0,1
S01012285,Fair health,46,6,0,6,13,3,2,5,5,8,3,2,1,1
S01012285,Bad health,12,0,0,0,1,0,0,2,4,5,0,0,0,0
S01012285,Very bad health,4,0,0,0,1,0,1,0,0,0,2,2,0,0
S01012286,All people aged 16 to 74,821,33,10,23,115,69,55,73,168,161,43,22,21,104
S01012286,Very good health,383,21,7,14,58,28,26,31,72,50,18,10,8,79
S01012286,Good health,284,8,1,7,40,29,20,30,68,53,14,4,10,22
S01012286,Fair health,111,4,2,2,14,8,7,8,16,45,7,4,3,2
S01012286,Bad health,35,0,0,0,3,3,2,4,9,11,2,2,0,1
S01012286,Very bad health,8,0,0,0,0,1,0,0,3,2,2,2,0,0
S01012287,All people aged 16 to 74,698,15,3,12,83,52,45,48,173,164,70,31,39,48
S01012287,Very good health,280,5,0,5,41,22,12,21,70,56,20,12,8,33
S01012287,Good health,275,8,3,5,25,15,22,17,74,71,30,9,21,13
S01012287,Fair health,90,1,0,1,10,8,8,7,18,24,12,4,8,2
S01012287,Bad health,45,1,0,1,6,6,3,3,10,11,5,3,2,0
S01012287,Very bad health,8,0,0,0,1,1,0,0,1,2,3,3,0,0
S01012288,All people aged 16 to 74,573,11,4,7,62,56,31,54,135,134,57,24,33,33
S01012288,Very good health,212,7,2,5,27,27,9,19,49,33,21,7,14,20
S01012288,Good health,241,2,1,1,25,16,16,23,60,65,22,9,13,12
S01012288,Fair health,81,0,0,0,7,10,3,9,19,23,10,5,5,0
S01012288,Bad health,27,0,0,0,2,2,1,1,5,13,2,1,1,1
S01012288,Very bad health,12,2,1,1,1,1,2,2,2,0,2,2,0,0
S01012289,All people aged 16 to 74,621,125,18,107,178,63,76,28,56,25,34,29,5,36
S01012289,Very good health,340,75,8,67,102,33,36,18,27,13,9,6,3,27
S01012289,Good health,190,35,6,29,56,21,32,6,15,8,14,14,0,3
S01012289,Fair health,76,13,3,10,15,9,6,2,11,3,11,9,2,6
S01012289,Bad health,14,2,1,1,5,0,2,2,3,0,0,0,0,0
S01012289,Very bad health,1,0,0,0,0,0,0,0,0,1,0,0,0,0
S01012290,All people aged 16 to 74,381,31,11,20,83,50,47,20,63,57,14,8,6,16
S01012290,Very good health,177,20,8,12,57,16,25,9,16,22,3,2,1,9
S01012290,Good health,149,7,1,6,20,27,14,7,37,26,7,4,3,4
S01012290,Fair health,39,2,1,1,4,5,6,2,5,8,4,2,2,3
S01012290,Bad health,11,1,1,0,0,1,2,1,5,1,0,0,0,0
S01012290,Very bad health,5,1,0,1,2,1,0,1,0,0,0,0,0,0
S01012291,All people aged 16 to 74,687,99,19,80,206,87,67,31,83,51,30,24,6,33
S01012291,Very good health,386,65,13,52,135,49,31,17,40,17,8,5,3,24
S01012291,Good health,220,26,5,21,52,31,22,12,32,24,13,12,1,8
S01012291,Fair health,57,5,1,4,11,6,11,1,8,6,8,6,2,1
S01012291,Bad health,19,3,0,3,7,0,3,0,3,3,0,0,0,0
S01012291,Very bad health,5,0,0,0,1,1,0,1,0,1,1,1,0,0
S01012292,All people aged 16 to 74,484,95,22,73,141,53,75,20,50,20,10,10,0,20
S01012292,Very good health,289,58,11,47,98,31,39,13,22,10,1,1,0,17
S01012292,Good health,144,30,9,21,30,13,30,6,20,8,4,4,0,3
S01012292,Fair health,38,6,2,4,9,7,5,0,6,2,3,3,0,0
S01012292,Bad health,10,1,0,1,3,1,0,1,2,0,2,2,0,0
S01012292,Very bad health,3,0,0,0,1,1,1,0,0,0,0,0,0,0
S01012293,All people aged 16 to 74,344,33,9,24,92,55,34,23,50,32,9,6,3,16
S01012293,Very good health,174,17,3,14,44,33,16,10,25,15,3,2,1,11
S01012293,Good health,113,9,5,4,33,18,11,5,18,10,4,3,1,5
S01012293,Fair health,43,6,1,5,10,2,7,7,5,5,1,0,1,0
S01012293,Bad health,9,1,0,1,3,1,0,1,1,2,0,0,0,0
S01012293,Very bad health,5,0,0,0,2,1,0,0,1,0,1,1,0,0
S01012294,All people aged 16 to 74,667,31,9,22,140,105,46,62,133,87,25,18,7,38
S01012294,Very good health,314,18,5,13,66,58,19,32,54,31,9,6,3,27
S01012294,Good health,237,9,3,6,45,36,19,22,58,32,9,5,4,7
S01012294,Fair health,81,3,1,2,20,9,5,5,14,17,5,5,0,3
S01012294,Bad health,27,1,0,1,6,1,2,3,4,7,2,2,0,1
S01012294,Very bad health,8,0,0,0,3,1,1,0,3,0,0,0,0,0
S01012295,All people aged 16 to 74,538,40,13,27,142,89,47,31,71,54,29,15,14,35
S01012295,Very good health,310,29,8,21,99,50,22,16,36,21,7,2,5,30
S01012295,Good health,163,9,5,4,37,29,20,8,25,18,15,8,7,2
S01012295,Fair health,43,2,0,2,3,6,5,4,6,9,6,4,2,2
S01012295,Bad health,15,0,0,0,1,3,0,2,2,5,1,1,0,1
S01012295,Very bad health,7,0,0,0,2,1,0,1,2,1,0,0,0,0
S01012296,All people aged 16 to 74,606,81,19,62,198,64,81,50,57,33,2,1,1,40
S01012296,Very good health,356,48,11,37,130,41,40,25,28,15,0,0,0,29
S01012296,Good health,183,28,7,21,51,21,29,18,19,9,1,0,1,7
S01012296,Fair health,47,5,1,4,13,1,8,2,8,6,0,0,0,4
S01012296,Bad health,15,0,0,0,3,1,3,4,1,2,1,1,0,0
S01012296,Very bad health,5,0,0,0,1,0,1,1,1,1,0,0,0,0
S01012297,All people aged 16 to 74,439,68,19,49,111,48,124,14,31,21,10,5,5,12
S01012297,Very good health,264,56,16,40,68,29,65,4,17,8,5,2,3,12
S01012297,Good health,137,9,3,6,36,12,45,10,11,10,4,2,2,0
S01012297,Fair health,32,2,0,2,6,7,13,0,2,2,0,0,0,0
S01012297,Bad health,5,0,0,0,1,0,1,0,1,1,1,1,0,0
S01012297,Very bad health,1,1,0,1,0,0,0,0,0,0,0,0,0,0
S01012298,All people aged 16 to 74,600,73,11,62,153,86,83,38,84,48,7,3,4,28
S01012298,Very good health,306,49,7,42,79,42,35,17,37,20,3,2,1,24
S01012298,Good health,215,22,4,18,57,29,34,18,31,18,2,1,1,4
S01012298,Fair health,57,1,0,1,14,11,9,1,12,8,1,0,1,0
S01012298,Bad health,17,1,0,1,2,4,4,1,2,2,1,0,1,0
S01012298,Very bad health,5,0,0,0,1,0,1,1,2,0,0,0,0,0
S01012299,All people aged 16 to 74,475,69,10,59,118,47,81,41,64,31,5,5,0,19
S01012299,Very good health,265,48,5,43,59,23,48,19,33,14,4,4,0,17
S01012299,Good health,157,18,4,14,40,15,29,21,22,10,0,0,0,2
S01012299,Fair health,35,3,1,2,10,4,4,1,8,4,1,1,0,0
S01012299,Bad health,14,0,0,0,8,3,0,0,1,2,0,0,0,0
S01012299,Very bad health,4,0,0,0,1,2,0,0,0,1,0,0,0,0
S01012300,All people aged 16 to 74,480,27,11,16,92,41,71,37,94,71,17,14,3,30
S01012300,Very good health,231,13,5,8,49,20,34,19,38,26,7,5,2,25
S01012300,Good health,150,8,4,4,31,11,25,12,34,21,5,4,1,3
S01012300,Fair health,65,2,1,1,7,8,10,5,14,15,2,2,0,2
S01012300,Bad health,27,3,0,3,4,1,2,1,6,7,3,3,0,0
S01012300,Very bad health,7,1,1,0,1,1,0,0,2,2,0,0,0,0
S01012301,All people aged 16 to 74,718,74,19,55,164,69,114,60,105,80,23,14,9,29
S01012301,Very good health,390,42,11,31,94,42,60,27,52,35,13,8,5,25
S01012301,Good health,226,26,6,20,49,14,40,20,39,29,6,3,3,3
S01012301,Fair health,75,5,2,3,17,8,14,8,7,14,2,1,1,0
S01012301,Bad health,25,1,0,1,4,4,0,5,7,1,2,2,0,1
S01012301,Very bad health,2,0,0,0,0,1,0,0,0,1,0,0,0,0
S01012302,All people aged 16 to 74,455,43,9,34,93,41,82,44,84,36,14,8,6,18
S01012302,Very good health,228,20,2,18,54,20,47,20,30,16,5,4,1,16
S01012302,Good health,140,19,6,13,27,14,21,14,32,8,3,1,2,2
S01012302,Fair health,61,4,1,3,8,4,9,7,15,9,5,2,3,0
S01012302,Bad health,25,0,0,0,4,3,4,3,7,3,1,1,0,0
S01012302,Very bad health,1,0,0,0,0,0,1,0,0,0,0,0,0,0
S01012303,All people aged 16 to 74,664,87,12,75,162,64,130,39,91,37,16,8,8,38
S01012303,Very good health,390,65,8,57,90,32,74,20,48,23,6,3,3,32
S01012303,Good health,197,18,4,14,57,21,38,13,30,9,6,2,4,5
S01012303,Fair health,67,4,0,4,12,11,15,4,12,5,3,2,1,1
S01012303,Bad health,8,0,0,0,2,0,3,1,1,0,1,1,0,0
S01012303,Very bad health,2,0,0,0,1,0,0,1,0,0,0,0,0,0
S01012304,All people aged 16 to 74,727,57,17,40,154,77,140,52,121,81,16,9,7,29
S01012304,Very good health,377,35,10,25,85,39,74,20,49,42,9,4,5,24
S01012304,Good health,247,18,5,13,50,26,49,21,49,25,5,3,2,4
S01012304,Fair health,77,3,1,2,15,8,13,5,18,13,1,1,0,1
S01012304,Bad health,18,0,0,0,2,2,4,5,4,1,0,0,0,0
S01012304,Very bad health,8,1,1,0,2,2,0,1,1,0,1,1,0,0
S01012305,All people aged 16 to 74,506,27,7,20,123,59,59,42,81,54,25,21,4,36
S01012305,Very good health,250,17,5,12,60,33,28,23,32,23,6,5,1,28
S01012305,Good health,180,8,2,6,44,22,22,12,35,21,10,7,3,6
S01012305,Fair health,54,1,0,1,13,3,5,5,9,8,8,8,0,2
S01012305,Bad health,16,1,0,1,5,1,2,1,3,2,1,1,0,0
S01012305,Very bad health,6,0,0,0,1,0,2,1,2,0,0,0,0,0
S01012306,All people aged 16 to 74,387,16,11,5,65,31,41,32,94,75,15,10,5,18
S01012306,Very good health,171,9,6,3,34,12,20,8,41,30,4,3,1,13
S01012306,Good health,143,6,4,2,23,13,11,18,37,25,5,3,2,5
S01012306,Fair health,59,1,1,0,7,4,6,6,15,15,5,3,2,0
S01012306,Bad health,10,0,0,0,1,1,3,0,1,4,0,0,0,0
S01012306,Very bad health,4,0,0,0,0,1,1,0,0,1,1,1,0,0
S01012307,All people aged 16 to 74,458,35,5,30,81,59,34,43,84,81,23,14,9,18
S01012307,Very good health,216,20,4,16,48,29,14,23,32,30,4,0,4,16
S01012307,Good health,150,9,1,8,26,17,13,16,32,30,5,4,1,2
S01012307,Fair health,60,4,0,4,5,10,4,3,15,16,3,2,1,0
S01012307,Bad health,27,2,0,2,1,3,0,1,4,5,11,8,3,0
S01012307,Very bad health,5,0,0,0,1,0,3,0,1,0,0,0,0,0
S01012308,All people aged 16 to 74,620,30,10,20,111,78,54,62,133,104,7,6,1,41
S01012308,Very good health,316,18,7,11,61,37,26,32,66,43,3,2,1,30
S01012308,Good health,234,11,3,8,36,35,22,22,54,42,2,2,0,10
S01012308,Fair health,53,1,0,1,7,6,6,6,9,16,1,1,0,1
S01012308,Bad health,15,0,0,0,6,0,0,2,3,3,1,1,0,0
S01012308,Very bad health,2,0,0,0,1,0,0,0,1,0,0,0,0,0
S01012309,All people aged 16 to 74,398,35,11,24,81,43,50,28,68,70,10,7,3,13
S01012309,Very good health,188,23,7,16,44,20,20,10,34,25,3,2,1,9
S01012309,Good health,136,10,4,6,23,15,21,14,23,23,3,2,1,4
S01012309,Fair health,54,2,0,2,11,5,8,3,8,14,3,2,1,0
S01012309,Bad health,15,0,0,0,2,2,1,1,2,6,1,1,0,0
S01012309,Very bad health,5,0,0,0,1,1,0,0,1,2,0,0,0,0
S01012310,All people aged 16 to 74,692,69,15,54,160,54,161,35,110,68,14,10,4,21
S01012310,Very good health,328,36,9,27,80,23,77,13,43,36,6,5,1,14
S01012310,Good health,242,22,6,16,59,20,51,16,48,16,4,4,0,6
S01012310,Fair health,93,10,0,10,17,7,24,4,16,11,3,0,3,1
S01012310,Bad health,25,0,0,0,3,4,7,2,3,5,1,1,0,0
S01012310,Very bad health,4,1,0,1,1,0,2,0,0,0,0,0,0,0
S01012311,All people aged 16 to 74,415,35,8,27,106,41,54,44,63,34,14,9,5,24
S01012311,Very good health,185,22,5,17,52,19,20,14,22,12,6,4,2,18
S01012311,Good health,142,10,2,8,39,12,16,19,26,12,3,1,2,5
S01012311,Fair health,59,3,1,2,12,6,13,6,9,8,1,1,0,1
S01012311,Bad health,27,0,0,0,3,2,5,5,6,2,4,3,1,0
S01012311,Very bad health,2,0,0,0,0,2,0,0,0,0,0,0,0,0
S01012312,All people aged 16 to 74,793,59,8,51,155,79,159,66,135,68,20,14,6,52
S01012312,Very good health,396,33,4,29,72,44,78,30,59,27,11,8,3,42
S01012312,Good health,251,20,4,16,49,25,49,25,43,29,4,2,2,7
S01012312,Fair health,99,5,0,5,24,5,25,5,21,9,3,2,1,2
S01012312,Bad health,31,0,0,0,7,4,6,4,7,1,2,2,0,0
S01012312,Very bad health,16,1,0,1,3,1,1,2,5,2,0,0,0,1
S01012313,All people aged 16 to 74,598,55,14,41,119,64,90,55,97,75,12,7,5,31
S01012313,Very good health,303,32,11,21,62,32,39,25,49,38,7,3,4,19
S01012313,Good health,191,17,2,15,39,26,31,15,24,27,2,1,1,10
S01012313,Fair health,73,3,0,3,16,4,17,8,16,6,2,2,0,1
S01012313,Bad health,23,3,1,2,1,1,2,6,5,3,1,1,0,1
S01012313,Very bad health,8,0,0,0,1,1,1,1,3,1,0,0,0,0
S01012314,All people aged 16 to 74,605,18,6,12,71,54,57,65,161,132,27,17,10,20
S01012314,Very good health,280,5,1,4,43,30,26,28,73,51,7,4,3,17
S01012314,Good health,203,9,4,5,18,17,22,23,55,49,7,3,4,3
S01012314,Fair health,81,2,0,2,8,6,6,5,20,25,9,6,3,0
S01012314,Bad health,32,1,0,1,0,0,3,9,9,6,4,4,0,0
S01012314,Very bad health,9,1,1,0,2,1,0,0,4,1,0,0,0,0
S01012315,All people aged 16 to 74,527,17,4,13,92,46,80,53,108,77,28,18,10,26
S01012315,Very good health,225,12,3,9,48,19,31,14,38,36,7,4,3,20
S01012315,Good health,187,2,1,1,31,17,27,24,47,23,12,7,5,4
S01012315,Fair health,79,2,0,2,9,7,16,10,15,11,8,7,1,1
S01012315,Bad health,29,1,0,1,3,2,5,4,6,7,1,0,1,0
S01012315,Very bad health,7,0,0,0,1,1,1,1,2,0,0,0,0,1
S01012316,All people aged 16 to 74,456,13,6,7,65,27,44,53,120,107,16,3,13,11
S01012316,Very good health,189,6,2,4,31,10,14,23,50,37,8,3,5,10
S01012316,Good health,169,5,4,1,21,12,20,22,47,37,4,0,4,1
S01012316,Fair health,65,2,0,2,12,2,5,6,13,23,2,0,2,0
S01012316,Bad health,25,0,0,0,1,3,5,0,9,5,2,0,2,0
S01012316,Very bad health,8,0,0,0,0,0,0,2,1,5,0,0,0,0
S01012317,All people aged 16 to 74,366,14,5,9,97,36,43,36,59,41,11,4,7,29
S01012317,Very good health,192,8,2,6,51,20,22,15,27,19,6,3,3,24
S01012317,Good health,125,6,3,3,29,13,16,14,25,15,3,1,2,4
S01012317,Fair health,36,0,0,0,13,3,5,5,5,3,1,0,1,1
S01012317,Bad health,12,0,0,0,4,0,0,2,2,4,0,0,0,0
S01012317,Very bad health,1,0,0,0,0,0,0,0,0,0,1,0,1,0
S01012318,All people aged 16 to 74,602,14,6,8,93,46,46,64,148,132,24,16,8,35
S01012318,Very good health,276,6,5,1,46,18,14,35,62,60,9,6,3,26
S01012318,Good health,211,3,0,3,29,17,22,19,61,44,7,5,2,9
S01012318,Fair health,73,2,0,2,12,7,9,4,16,19,4,2,2,0
S01012318,Bad health,32,2,1,1,3,2,1,5,8,8,3,2,1,0
S01012318,Very bad health,10,1,0,1,3,2,0,1,1,1,1,1,0,0
S01012319,All people aged 16 to 74,578,55,11,44,121,56,99,50,89,68,14,7,7,26
S01012319,Very good health,304,38,8,30,65,31,53,24,37,31,5,3,2,20
S01012319,Good health,205,12,2,10,46,13,34,17,42,30,7,3,4,4
S01012319,Fair health,49,3,0,3,6,5,10,6,10,7,1,1,0,1
S01012319,Bad health,16,2,1,1,3,5,2,2,0,0,1,0,1,1
S01012319,Very bad health,4,0,0,0,1,2,0,1,0,0,0,0,0,0
S01012320,All people aged 16 to 74,492,16,6,10,69,40,48,46,129,93,22,16,6,29
S01012320,Very good health,240,8,2,6,36,21,23,19,58,47,6,4,2,22
S01012320,Good health,178,5,2,3,23,14,20,23,55,24,9,5,4,5
S01012320,Fair health,48,1,0,1,6,3,5,3,14,10,5,5,0,1
S01012320,Bad health,19,1,1,0,3,1,0,0,1,10,2,2,0,1
S01012320,Very bad health,7,1,1,0,1,1,0,1,1,2,0,0,0,0
S01012321,All people aged 16 to 74,546,42,11,31,89,57,62,48,130,73,14,5,9,31
S01012321,Very good health,255,23,7,16,51,26,33,22,50,24,3,1,2,23
S01012321,Good health,212,15,4,11,28,24,21,21,57,32,8,1,7,6
S01012321,Fair health,58,4,0,4,7,4,7,5,16,11,3,3,0,1
S01012321,Bad health,18,0,0,0,3,2,1,0,5,6,0,0,0,1
S01012321,Very bad health,3,0,0,0,0,1,0,0,2,0,0,0,0,0
S01012322,All people aged 16 to 74,742,85,22,63,186,93,141,36,84,63,21,14,7,33
S01012322,Very good health,359,45,13,32,102,41,67,19,24,27,9,6,3,25
S01012322,Good health,281,28,7,21,62,38,58,13,42,25,7,4,3,8
S01012322,Fair health,70,9,2,7,14,6,14,3,14,6,4,3,1,0
S01012322,Bad health,27,3,0,3,8,6,2,1,2,4,1,1,0,0
S01012322,Very bad health,5,0,0,0,0,2,0,0,2,1,0,0,0,0
S01012323,All people aged 16 to 74,676,75,20,55,162,80,130,45,87,53,22,11,11,22
S01012323,Very good health,343,44,9,35,85,36,68,19,41,17,16,7,9,17
S01012323,Good health,223,22,7,15,51,35,46,14,29,19,3,1,2,4
S01012323,Fair health,82,8,4,4,20,6,12,8,12,12,3,3,0,1
S01012323,Bad health,23,1,0,1,6,1,4,3,5,3,0,0,0,0
S01012323,Very bad health,5,0,0,0,0,2,0,1,0,2,0,0,0,0
S01012324,All people aged 16 to 74,601,56,21,35,107,69,131,52,97,54,12,6,6,23
S01012324,Very good health,292,30,13,17,54,35,64,26,40,20,4,2,2,19
S01012324,Good health,209,21,6,15,41,19,47,15,34,24,5,1,4,3
S01012324,Fair health,69,4,2,2,9,8,14,7,18,7,1,1,0,1
S01012324,Bad health,19,1,0,1,3,4,3,2,2,3,1,1,0,0
S01012324,Very bad health,12,0,0,0,0,3,3,2,3,0,1,1,0,0
S01012325,All people aged 16 to 74,422,30,9,21,73,62,32,30,97,70,14,6,8,14
S01012325,Very good health,174,13,4,9,38,25,16,12,35,18,3,0,3,14
S01012325,Good health,162,12,4,8,25,27,10,16,31,33,8,4,4,0
S01012325,Fair health,69,4,1,3,8,9,5,1,26,13,3,2,1,0
S01012325,Bad health,14,1,0,1,1,1,1,1,3,6,0,0,0,0
S01012325,Very bad health,3,0,0,0,1,0,0,0,2,0,0,0,0,0
S01012326,All people aged 16 to 74,412,21,4,17,60,42,46,53,89,58,31,16,15,12
S01012326,Very good health,161,10,1,9,26,22,16,26,26,19,9,5,4,7
S01012326,Good health,152,6,2,4,18,16,20,15,41,22,10,5,5,4
S01012326,Fair health,69,1,0,1,13,3,8,6,13,14,10,4,6,1
S01012326,Bad health,25,3,0,3,3,1,2,5,6,3,2,2,0,0
S01012326,Very bad health,5,1,1,0,0,0,0,1,3,0,0,0,0,0
S01012327,All people aged 16 to 74,570,30,8,22,94,57,65,57,121,101,20,15,5,25
S01012327,Very good health,258,20,4,16,50,21,28,22,43,45,8,6,2,21
S01012327,Good health,220,6,2,4,31,25,24,26,55,41,8,6,2,4
S01012327,Fair health,65,3,2,1,8,7,9,7,16,13,2,1,1,0
S01012327,Bad health,18,1,0,1,1,3,4,1,4,2,2,2,0,0
S01012327,Very bad health,9,0,0,0,4,1,0,1,3,0,0,0,0,0
S01012328,All people aged 16 to 74,405,50,13,37,108,41,53,30,58,46,12,5,7,7
S01012328,Very good health,178,26,5,21,48,21,19,13,24,21,2,0,2,4
S01012328,Good health,166,17,5,12,46,17,23,11,26,17,6,2,4,3
S01012328,Fair health,48,3,1,2,10,3,9,6,7,7,3,2,1,0
S01012328,Bad health,9,2,2,0,3,0,2,0,1,1,0,0,0,0
S01012328,Very bad health,4,2,0,2,1,0,0,0,0,0,1,1,0,0
S01012329,All people aged 16 to 74,613,49,14,35,122,61,132,58,101,55,15,8,7,20
S01012329,Very good health,293,28,8,20,53,25,74,32,34,23,7,3,4,17
S01012329,Good health,227,15,4,11,56,24,42,18,45,20,5,4,1,2
S01012329,Fair health,60,5,2,3,8,6,10,6,15,8,1,0,1,1
S01012329,Bad health,27,1,0,1,3,4,6,2,7,3,1,0,1,0
S01012329,Very bad health,6,0,0,0,2,2,0,0,0,1,1,1,0,0
S01012330,All people aged 16 to 74,429,43,13,30,96,50,59,30,70,44,10,7,3,27
S01012330,Very good health,213,27,5,22,52,27,27,14,29,15,2,0,2,20
S01012330,Good health,148,10,6,4,36,15,21,9,28,20,3,3,0,6
S01012330,Fair health,54,6,2,4,7,6,9,4,11,8,3,2,1,0
S01012330,Bad health,13,0,0,0,1,2,2,3,1,1,2,2,0,1
S01012330,Very bad health,1,0,0,0,0,0,0,0,1,0,0,0,0,0
S01012331,All people aged 16 to 74,446,47,13,34,128,55,46,33,64,49,9,4,5,15
S01012331,Very good health,253,33,11,22,82,32,23,18,28,21,3,1,2,13
S01012331,Good health,142,12,1,11,34,18,19,11,26,16,4,2,2,2
S01012331,Fair health,38,2,1,1,8,4,4,3,8,8,1,1,0,0
S01012331,Bad health,10,0,0,0,4,0,0,0,2,4,0,0,0,0
S01012331,Very bad health,3,0,0,0,0,1,0,1,0,0,1,0,1,0
S01012332,All people aged 16 to 74,744,75,15,60,161,79,142,70,110,56,11,8,3,40
S01012332,Very good health,408,49,11,38,83,51,75,32,56,26,7,5,2,29
S01012332,Good health,256,21,3,18,61,23,54,32,34,20,3,3,0,8
S01012332,Fair health,68,4,1,3,13,4,10,6,17,10,1,0,1,3
S01012332,Bad health,8,1,0,1,3,0,2,0,2,0,0,0,0,0
S01012332,Very bad health,4,0,0,0,1,1,1,0,1,0,0,0,0,0
S01012333,All people aged 16 to 74,720,53,12,41,166,83,135,53,119,63,23,11,12,25
S01012333,Very good health,396,29,6,23,96,47,72,27,65,30,9,7,2,21
S01012333,Good health,234,16,5,11,46,28,51,22,39,18,10,3,7,4
S01012333,Fair health,70,7,1,6,21,5,9,3,12,9,4,1,3,0
S01012333,Bad health,14,0,0,0,2,2,3,0,3,4,0,0,0,0
S01012333,Very bad health,6,1,0,1,1,1,0,1,0,2,0,0,0,0
S01012334,All people aged 16 to 74,589,14,5,9,83,64,58,75,140,113,21,7,14,21
S01012334,Very good health,293,8,3,5,46,39,33,38,58,47,8,2,6,16
S01012334,Good health,202,5,2,3,28,19,21,26,48,46,7,3,4,2
S01012334,Fair health,67,1,0,1,4,6,3,8,25,13,5,2,3,2
S01012334,Bad health,21,0,0,0,4,0,1,2,6,7,0,0,0,1
S01012334,Very bad health,6,0,0,0,1,0,0,1,3,0,1,0,1,0
S01012335,All people aged 16 to 74,745,42,19,23,136,100,46,71,168,124,23,11,12,35
S01012335,Very good health,410,22,13,9,80,61,26,42,84,60,10,6,4,25
S01012335,Good health,256,18,5,13,45,32,16,20,64,47,6,2,4,8
S01012335,Fair health,61,2,1,1,9,5,4,6,16,12,5,2,3,2
S01012335,Bad health,7,0,0,0,1,1,0,1,3,1,0,0,0,0
S01012335,Very bad health,11,0,0,0,1,1,0,2,1,4,2,1,1,0
S01012336,All people aged 16 to 74,427,10,4,6,65,39,38,43,106,98,11,6,5,17
S01012336,Very good health,200,4,0,4,35,26,13,24,41,37,4,3,1,16
S01012336,Good health,162,6,4,2,22,12,20,14,44,41,2,1,1,1
S01012336,Fair health,55,0,0,0,8,1,3,4,17,17,5,2,3,0
S01012336,Bad health,9,0,0,0,0,0,2,1,3,3,0,0,0,0
S01012336,Very bad health,1,0,0,0,0,0,0,0,1,0,0,0,0,0
S01012337,All people aged 16 to 74,596,23,9,14,83,59,49,78,143,92,45,26,19,24
S01012337,Very good health,264,12,4,8,40,26,16,34,67,34,15,12,3,20
S01012337,Good health,216,9,4,5,33,24,24,28,47,32,16,8,8,3
S01012337,Fair health,83,2,1,1,4,9,7,13,17,19,11,5,6,1
S01012337,Bad health,27,0,0,0,6,0,2,3,9,5,2,1,1,0
S01012337,Very bad health,6,0,0,0,0,0,0,0,3,2,1,0,1,0
S01012338,All people aged 16 to 74,502,31,6,25,114,58,59,41,93,63,18,7,11,25
S01012338,Very good health,246,21,4,17,52,31,28,20,36,31,5,0,5,22
S01012338,Good health,169,8,1,7,44,22,22,16,34,13,8,4,4,2
S01012338,Fair health,62,2,1,1,15,2,7,3,15,14,3,2,1,1
S01012338,Bad health,20,0,0,0,2,3,1,2,7,3,2,1,1,0
S01012338,Very bad health,5,0,0,0,1,0,1,0,1,2,0,0,0,0
S01012339,All people aged 16 to 74,432,37,7,30,93,48,37,42,75,54,23,10,13,23
S01012339,Very good health,221,26,3,23,51,21,20,25,31,24,8,5,3,15
S01012339,Good health,134,8,1,7,28,19,13,12,26,16,7,3,4,5
S01012339,Fair health,54,3,3,0,10,7,3,1,10,11,6,1,5,3
S01012339,Bad health,19,0,0,0,4,0,1,4,5,3,2,1,1,0
S01012339,Very bad health,4,0,0,0,0,1,0,0,3,0,0,0,0,0
S01012340,All people aged 16 to 74,696,56,21,35,158,72,69,59,138,84,29,19,10,31
S01012340,Very good health,356,22,10,12,91,34,35,29,70,37,15,11,4,23
S01012340,Good health,266,26,9,17,58,29,30,22,51,33,11,5,6,6
S01012340,Fair health,58,6,1,5,6,8,3,6,13,11,3,3,0,2
S01012340,Bad health,14,2,1,1,3,1,1,1,4,2,0,0,0,0
S01012340,Very bad health,2,0,0,0,0,0,0,1,0,1,0,0,0,0
S01012341,All people aged 16 to 74,740,71,20,51,148,80,187,43,89,68,19,8,11,35
S01012341,Very good health,425,44,11,33,82,49,115,26,33,36,10,5,5,30
S01012341,Good health,240,21,7,14,52,22,58,10,43,23,6,2,4,5
S01012341,Fair health,54,6,2,4,9,6,10,4,9,8,2,0,2,0
S01012341,Bad health,18,0,0,0,4,3,3,2,4,1,1,1,0,0
S01012341,Very bad health,3,0,0,0,1,0,1,1,0,0,0,0,0,0
S01012342,All people aged 16 to 74,661,58,17,41,154,69,112,44,113,67,16,11,5,28
S01012342,Very good health,375,34,10,24,90,39,66,25,63,30,4,3,1,24
S01012342,Good health,220,16,5,11,53,24,40,13,40,24,6,4,2,4
S01012342,Fair health,48,8,2,6,8,5,5,5,4,10,3,1,2,0
S01012342,Bad health,13,0,0,0,3,0,1,0,6,2,1,1,0,0
S01012342,Very bad health,5,0,0,0,0,1,0,1,0,1,2,2,0,0
S01012343,All people aged 16 to 74,760,74,21,53,183,79,151,54,114,56,25,13,12,24
S01012343,Very good health,397,48,14,34,86,40,83,30,54,26,10,4,6,20
S01012343,Good health,271,20,6,14,75,32,55,17,38,22,8,4,4,4
S01012343,Fair health,69,5,1,4,16,5,12,2,16,7,6,4,2,0
S01012343,Bad health,18,1,0,1,6,2,0,5,2,1,1,1,0,0
S01012343,Very bad health,5,0,0,0,0,0,1,0,4,0,0,0,0,0
S01012344,All people aged 16 to 74,454,17,3,14,80,59,45,40,89,87,24,14,10,13
S01012344,Very good health,203,8,2,6,36,28,23,23,34,33,11,7,4,7
S01012344,Good health,168,5,1,4,39,22,18,10,36,31,5,2,3,2
S01012344,Fair health,61,3,0,3,4,6,3,6,13,18,5,4,1,3
S01012344,Bad health,20,1,0,1,0,3,1,1,5,5,3,1,2,1
S01012344,Very bad health,2,0,0,0,1,0,0,0,1,0,0,0,0,0
S01012345,All people aged 16 to 74,520,30,11,19,111,61,60,67,64,82,8,6,2,37
S01012345,Very good health,250,16,2,14,57,24,31,37,23,32,4,2,2,26
S01012345,Good health,207,9,6,3,46,32,20,21,34,32,4,4,0,9
S01012345,Fair health,49,5,3,2,6,4,8,7,4,13,0,0,0,2
S01012345,Bad health,9,0,0,0,1,0,1,1,1,5,0,0,0,0
S01012345,Very bad health,5,0,0,0,1,1,0,1,2,0,0,0,0,0
S01012346,All people aged 16 to 74,615,72,7,65,134,61,117,48,77,57,14,10,4,35
S01012346,Very good health,328,39,3,36,81,35,60,17,40,31,2,2,0,23
S01012346,Good health,211,25,3,22,40,21,38,26,24,18,9,5,4,10
S01012346,Fair health,56,7,1,6,10,3,16,2,9,5,3,3,0,1
S01012346,Bad health,17,1,0,1,3,2,2,2,4,2,0,0,0,1
S01012346,Very bad health,3,0,0,0,0,0,1,1,0,1,0,0,0,0
S01012347,All people aged 16 to 74,552,58,23,35,123,75,56,46,88,76,16,9,7,14
S01012347,Very good health,270,35,13,22,71,41,19,22,35,25,8,3,5,14
S01012347,Good health,199,16,7,9,40,25,29,12,36,36,5,3,2,0
S01012347,Fair health,65,4,2,2,11,6,7,11,11,13,2,2,0,0
S01012347,Bad health,16,3,1,2,1,3,1,1,5,1,1,1,0,0
S01012347,Very bad health,2,0,0,0,0,0,0,0,1,1,0,0,0,0
S01012348,All people aged 16 to 74,509,72,21,51,143,65,57,35,47,48,17,9,8,25
S01012348,Very good health,274,42,11,31,82,35,30,12,25,21,6,2,4,21
S01012348,Good health,165,23,8,15,44,25,17,16,14,17,7,4,3,2
S01012348,Fair health,53,5,2,3,12,5,5,6,6,9,3,2,1,2
S01012348,Bad health,14,2,0,2,4,0,4,1,1,1,1,1,0,0
S01012348,Very bad health,3,0,0,0,1,0,1,0,1,0,0,0,0,0
S01012349,All people aged 16 to 74,679,19,7,12,90,51,57,72,152,177,22,12,10,39
S01012349,Very good health,315,10,5,5,45,27,31,27,67,69,7,5,2,32
S01012349,Good health,248,7,2,5,28,18,18,31,60,70,9,4,5,7
S01012349,Fair health,80,1,0,1,14,5,6,9,18,24,3,1,2,0
S01012349,Bad health,28,1,0,1,1,0,2,2,6,13,3,2,1,0
S01012349,Very bad health,8,0,0,0,2,1,0,3,1,1,0,0,0,0
S01012350,All people aged 16 to 74,553,39,18,21,97,57,70,42,105,96,17,9,8,30
S01012350,Very good health,264,17,5,12,52,29,33,19,43,41,6,3,3,24
S01012350,Good health,204,17,10,7,31,24,31,15,40,35,5,4,1,6
S01012350,Fair health,63,3,1,2,10,3,4,7,17,13,6,2,4,0
S01012350,Bad health,14,1,1,0,3,1,1,1,2,5,0,0,0,0
S01012350,Very bad health,8,1,1,0,1,0,1,0,3,2,0,0,0,0
S01012351,All people aged 16 to 74,610,23,6,17,90,57,47,77,142,120,18,11,7,36
S01012351,Very good health,324,13,6,7,59,30,23,41,66,59,10,5,5,23
S01012351,Good health,193,7,0,7,22,17,19,27,45,42,5,4,1,9
S01012351,Fair health,65,2,0,2,9,5,4,5,20,14,3,2,1,3
S01012351,Bad health,21,1,0,1,0,2,1,2,9,5,0,0,0,1
S01012351,Very bad health,7,0,0,0,0,3,0,2,2,0,0,0,0,0
S01012352,All people aged 16 to 74,547,31,11,20,96,50,75,46,108,94,16,10,6,31
S01012352,Very good health,284,15,5,10,58,27,47,24,42,40,7,4,3,24
S01012352,Good health,178,13,5,8,27,12,22,11,49,36,5,3,2,3
S01012352,Fair health,54,2,1,1,5,8,4,8,10,11,2,2,0,4
S01012352,Bad health,25,1,0,1,4,2,2,3,6,5,2,1,1,0
S01012352,Very bad health,6,0,0,0,2,1,0,0,1,2,0,0,0,0
S01012353,All people aged 16 to 74,561,35,8,27,102,57,71,53,103,80,27,14,13,33
S01012353,Very good health,295,23,6,17,70,31,34,22,43,43,10,7,3,19
S01012353,Good health,183,8,2,6,25,17,27,18,47,20,9,4,5,12
S01012353,Fair health,53,4,0,4,3,7,8,8,8,8,5,3,2,2
S01012353,Bad health,19,0,0,0,0,2,1,4,4,7,1,0,1,0
S01012353,Very bad health,11,0,0,0,4,0,1,1,1,2,2,0,2,0
S01012354,All people aged 16 to 74,545,27,4,23,98,47,91,60,85,97,16,10,6,24
S01012354,Very good health,232,14,3,11,50,22,32,22,30,37,6,6,0,19
S01012354,Good health,213,9,1,8,30,15,44,25,36,41,8,3,5,5
S01012354,Fair health,76,2,0,2,13,7,11,9,15,18,1,0,1,0
S01012354,Bad health,13,1,0,1,1,2,3,1,3,1,1,1,0,0
S01012354,Very bad health,11,1,0,1,4,1,1,3,1,0,0,0,0,0
S01012355,All people aged 16 to 74,714,68,19,49,154,68,176,38,94,71,11,9,2,34
S01012355,Very good health,386,48,14,34,86,35,84,17,45,33,6,5,1,32
S01012355,Good health,218,13,3,10,46,21,65,12,36,21,3,2,1,1
S01012355,Fair health,88,6,2,4,18,10,21,7,11,12,2,2,0,1
S01012355,Bad health,16,1,0,1,4,1,5,2,2,1,0,0,0,0
S01012355,Very bad health,6,0,0,0,0,1,1,0,0,4,0,0,0,0
S01012356,All people aged 16 to 74,478,37,10,27,102,70,67,32,73,71,11,9,2,15
S01012356,Very good health,236,21,6,15,57,38,30,17,33,26,2,2,0,12
S01012356,Good health,162,10,2,8,33,21,33,10,24,27,2,0,2,2
S01012356,Fair health,66,5,2,3,8,11,4,5,12,14,6,6,0,1
S01012356,Bad health,11,1,0,1,2,0,0,0,4,3,1,1,0,0
S01012356,Very bad health,3,0,0,0,2,0,0,0,0,1,0,0,0,0
S01012357,All people aged 16 to 74,654,72,18,54,171,65,156,27,78,44,13,9,4,28
S01012357,Very good health,352,37,8,29,103,39,74,15,40,17,4,1,3,23
S01012357,Good health,219,28,7,21,50,23,61,9,25,17,3,3,0,3
S01012357,Fair health,66,5,3,2,17,3,20,0,8,8,5,4,1,0
S01012357,Bad health,15,2,0,2,1,0,0,3,4,2,1,1,0,2
S01012357,Very bad health,2,0,0,0,0,0,1,0,1,0,0,0,0,0
S01012358,All people aged 16 to 74,609,55,10,45,122,36,170,40,73,69,16,13,3,28
S01012358,Very good health,314,34,6,28,66,15,84,18,35,33,5,5,0,24
S01012358,Good health,194,17,3,14,40,13,60,14,23,18,5,4,1,4
S01012358,Fair health,70,3,0,3,10,5,23,3,12,11,3,2,1,0
S01012358,Bad health,27,1,1,0,5,2,3,5,2,7,2,1,1,0
S01012358,Very bad health,4,0,0,0,1,1,0,0,1,0,1,1,0,0
S01012359,All people aged 16 to 74,570,8,6,2,53,47,34,49,140,173,42,27,15,24
S01012359,Very good health,212,5,4,1,24,27,22,14,41,52,9,5,4,18
S01012359,Good health,196,3,2,1,11,13,4,15,54,75,16,10,6,5
S01012359,Fair health,95,0,0,0,10,3,4,13,25,28,11,7,4,1
S01012359,Bad health,49,0,0,0,5,2,2,5,16,14,5,4,1,0
S01012359,Very bad health,18,0,0,0,3,2,2,2,4,4,1,1,0,0
S01012360,All people aged 16 to 74,561,11,2,9,47,49,37,41,143,140,57,42,15,36
S01012360,Very good health,254,6,1,5,25,26,13,19,58,55,32,28,4,20
S01012360,Good health,184,3,1,2,17,16,18,10,49,47,11,4,7,13
S01012360,Fair health,86,1,0,1,2,5,4,6,29,26,10,6,4,3
S01012360,Bad health,28,1,0,1,3,2,2,3,6,8,3,3,0,0
S01012360,Very bad health,9,0,0,0,0,0,0,3,1,4,1,1,0,0
S01012361,All people aged 16 to 74,447,7,4,3,47,23,33,50,104,115,39,16,23,29
S01012361,Very good health,182,2,1,1,22,10,13,17,49,33,15,7,8,21
S01012361,Good health,159,3,1,2,21,9,10,21,30,41,18,6,12,6
S01012361,Fair health,66,0,0,0,2,2,6,9,17,24,4,1,3,2
S01012361,Bad health,29,2,2,0,1,2,2,1,6,13,2,2,0,0
S01012361,Very bad health,11,0,0,0,1,0,2,2,2,4,0,0,0,0
S01012362,All people aged 16 to 74,556,7,2,5,53,33,35,49,129,152,53,35,18,45
S01012362,Very good health,247,3,1,2,31,10,17,19,62,54,19,12,7,32
S01012362,Good health,180,2,1,1,13,16,12,14,38,56,18,12,6,11
S01012362,Fair health,86,2,0,2,5,6,4,5,16,34,13,9,4,1
S01012362,Bad health,35,0,0,0,4,1,1,8,11,6,3,2,1,1
S01012362,Very bad health,8,0,0,0,0,0,1,3,2,2,0,0,0,0
S01012363,All people aged 16 to 74,729,25,9,16,116,67,75,62,121,153,59,37,22,51
S01012363,Very good health,309,13,5,8,57,28,29,23,46,59,27,16,11,27
S01012363,Good health,262,8,4,4,42,34,25,29,40,52,14,10,4,18
S01012363,Fair health,110,3,0,3,12,4,13,8,23,28,16,9,7,3
S01012363,Bad health,37,1,0,1,3,1,5,1,10,11,2,2,0,3
S01012363,Very bad health,11,0,0,0,2,0,3,1,2,3,0,0,0,0
S01012364,All people aged 16 to 74,510,17,7,10,88,62,39,54,102,104,18,8,10,26
S01012364,Very good health,231,9,4,5,49,32,17,25,39,36,4,2,2,20
S01012364,Good health,191,7,3,4,33,23,14,20,36,44,10,3,7,4
S01012364,Fair health,68,1,0,1,5,5,6,7,23,17,2,2,0,2
S01012364,Bad health,18,0,0,0,1,2,2,2,4,6,1,1,0,0
S01012364,Very bad health,2,0,0,0,0,0,0,0,0,1,1,0,1,0
S01012365,All people aged 16 to 74,696,45,18,27,140,105,69,66,95,130,16,11,5,30
S01012365,Very good health,396,27,8,19,92,60,39,34,51,57,8,4,4,28
S01012365,Good health,221,13,8,5,42,37,23,23,26,51,4,3,1,2
S01012365,Fair health,66,4,2,2,5,7,6,9,16,18,1,1,0,0
S01012365,Bad health,10,1,0,1,1,1,1,0,1,2,3,3,0,0
S01012365,Very bad health,3,0,0,0,0,0,0,0,1,2,0,0,0,0
S01012366,All people aged 16 to 74,671,28,8,20,115,74,59,55,127,154,23,15,8,36
S01012366,Very good health,298,11,4,7,68,36,22,25,49,56,7,3,4,24
S01012366,Good health,271,14,3,11,37,30,28,17,60,67,8,7,1,10
S01012366,Fair health,74,3,1,2,6,4,5,8,11,27,8,5,3,2
S01012366,Bad health,23,0,0,0,4,2,4,3,7,3,0,0,0,0
S01012366,Very bad health,5,0,0,0,0,2,0,2,0,1,0,0,0,0
S01012367,All people aged 16 to 74,685,41,12,29,117,88,50,57,120,151,17,6,11,44
S01012367,Very good health,349,27,7,20,65,51,18,25,58,63,6,1,5,36
S01012367,Good health,225,14,5,9,34,30,23,24,36,51,6,2,4,7
S01012367,Fair health,75,0,0,0,11,5,6,6,19,23,4,2,2,1
S01012367,Bad health,26,0,0,0,4,1,3,2,4,12,0,0,0,0
S01012367,Very bad health,10,0,0,0,3,1,0,0,3,2,1,1,0,0
S01012368,All people aged 16 to 74,448,42,10,32,109,63,50,28,63,63,8,2,6,22
S01012368,Very good health,216,21,4,17,57,24,26,12,31,26,3,0,3,16
S01012368,Good health,171,16,5,11,41,33,19,10,21,22,3,0,3,6
S01012368,Fair health,46,4,1,3,9,6,5,3,8,11,0,0,0,0
S01012368,Bad health,14,1,0,1,2,0,0,3,3,4,1,1,0,0
S01012368,Very bad health,1,0,0,0,0,0,0,0,0,0,1,1,0,0
S01012369,All people aged 16 to 74,658,49,20,29,134,79,79,43,103,120,17,10,7,34
S01012369,Very good health,313,22,8,14,72,34,39,21,40,52,5,2,3,28
S01012369,Good health,238,18,8,10,45,37,24,14,42,46,7,3,4,5
S01012369,Fair health,84,8,3,5,14,6,13,3,16,19,4,4,0,1
S01012369,Bad health,16,0,0,0,3,1,3,3,3,2,1,1,0,0
S01012369,Very bad health,7,1,1,0,0,1,0,2,2,1,0,0,0,0
S01012370,All people aged 16 to 74,711,33,8,25,108,70,67,56,136,195,23,16,7,23
S01012370,Very good health,332,15,3,12,64,38,32,26,69,67,4,3,1,17
S01012370,Good health,221,16,4,12,26,18,22,15,37,73,9,6,3,5
S01012370,Fair health,115,1,1,0,14,11,10,11,23,36,8,6,2,1
S01012370,Bad health,30,1,0,1,4,1,3,2,4,14,1,0,1,0
S01012370,Very bad health,13,0,0,0,0,2,0,2,3,5,1,1,0,0
S01012371,All people aged 16 to 74,672,28,12,16,103,64,49,60,131,174,34,22,12,29
S01012371,Very good health,313,12,3,9,56,35,30,33,55,62,8,5,3,22
S01012371,Good health,220,8,4,4,28,18,8,13,51,67,20,13,7,7
S01012371,Fair health,95,8,5,3,16,8,6,8,15,30,4,3,1,0
S01012371,Bad health,35,0,0,0,3,3,4,5,9,9,2,1,1,0
S01012371,Very bad health,9,0,0,0,0,0,1,1,1,6,0,0,0,0
S01012372,All people aged 16 to 74,551,17,3,14,63,62,45,52,106,149,29,16,13,28
S01012372,Very good health,231,9,3,6,32,32,19,21,48,42,8,4,4,20
S01012372,Good health,201,6,0,6,20,20,17,25,32,63,11,7,4,7
S01012372,Fair health,81,2,0,2,5,8,7,3,21,27,7,3,4,1
S01012372,Bad health,32,0,0,0,3,2,2,3,4,15,3,2,1,0
S01012372,Very bad health,6,0,0,0,3,0,0,0,1,2,0,0,0,0
S01012373,All people aged 16 to 74,746,43,14,29,134,101,53,55,117,163,42,30,12,38
S01012373,Very good health,338,21,6,15,64,52,25,26,47,61,12,7,5,30
S01012373,Good health,275,16,6,10,52,35,20,16,47,65,18,13,5,6
S01012373,Fair health,86,4,2,2,11,8,6,10,15,22,9,7,2,1
S01012373,Bad health,32,1,0,1,4,6,2,1,5,9,3,3,0,1
S01012373,Very bad health,15,1,0,1,3,0,0,2,3,6,0,0,0,0
S01012374,All people aged 16 to 74,659,22,11,11,108,78,59,52,145,140,21,12,9,34
S01012374,Very good health,332,11,5,6,58,47,29,26,69,57,9,6,3,26
S01012374,Good health,230,9,5,4,33,22,21,20,56,57,6,1,5,6
S01012374,Fair health,83,2,1,1,15,9,5,6,17,21,6,5,1,2
S01012374,Bad health,11,0,0,0,2,0,3,0,3,3,0,0,0,0
S01012374,Very bad health,3,0,0,0,0,0,1,0,0,2,0,0,0,0
S01012375,All people aged 16 to 74,668,20,8,12,88,68,42,64,121,196,34,17,17,35
S01012375,Very good health,328,13,6,7,45,34,16,27,65,83,15,8,7,30
S01012375,Good health,235,6,1,5,31,26,18,25,37,78,10,5,5,4
S01012375,Fair health,70,0,0,0,8,4,5,9,13,25,5,2,3,1
S01012375,Bad health,28,0,0,0,2,3,3,2,5,10,3,1,2,0
S01012375,Very bad health,7,1,1,0,2,1,0,1,1,0,1,1,0,0
S01012376,All people aged 16 to 74,731,93,26,67,184,72,143,41,86,51,14,5,9,47
S01012376,Very good health,390,58,9,49,97,42,74,16,39,23,7,2,5,34
S01012376,Good health,239,27,12,15,69,20,49,10,35,15,2,1,1,12
S01012376,Fair health,75,7,4,3,16,8,16,7,9,8,3,2,1,1
S01012376,Bad health,23,0,0,0,2,2,4,7,3,3,2,0,2,0
S01012376,Very bad health,4,1,1,0,0,0,0,1,0,2,0,0,0,0
S01012377,All people aged 16 to 74,543,86,20,66,134,65,93,32,53,41,13,11,2,26
S01012377,Very good health,294,56,15,41,79,29,55,13,23,17,5,5,0,17
S01012377,Good health,179,24,5,19,40,27,33,14,15,18,4,3,1,4
S01012377,Fair health,50,5,0,5,11,6,5,1,12,4,1,1,0,5
S01012377,Bad health,13,1,0,1,3,1,0,3,2,0,3,2,1,0
S01012377,Very bad health,7,0,0,0,1,2,0,1,1,2,0,0,0,0
S01012378,All people aged 16 to 74,456,41,11,30,104,45,102,29,54,46,13,9,4,22
S01012378,Very good health,239,23,6,17,51,21,55,9,32,22,7,5,2,19
S01012378,Good health,160,13,3,10,41,21,35,15,16,13,3,2,1,3
S01012378,Fair health,45,4,2,2,6,3,11,3,6,9,3,2,1,0
S01012378,Bad health,7,0,0,0,4,0,1,0,0,2,0,0,0,0
S01012378,Very bad health,5,1,0,1,2,0,0,2,0,0,0,0,0,0
S01012379,All people aged 16 to 74,398,33,11,22,99,40,67,29,68,27,14,10,4,21
S01012379,Very good health,220,22,7,15,60,25,34,11,33,14,6,5,1,15
S01012379,Good health,127,11,4,7,30,8,22,10,30,6,6,4,2,4
S01012379,Fair health,37,0,0,0,6,6,9,8,1,6,1,1,0,0
S01012379,Bad health,10,0,0,0,1,0,2,0,3,1,1,0,1,2
S01012379,Very bad health,4,0,0,0,2,1,0,0,1,0,0,0,0,0
S01012380,All people aged 16 to 74,673,27,12,15,131,93,64,77,112,117,22,15,7,30
S01012380,Very good health,305,11,3,8,68,41,24,30,52,46,7,4,3,26
S01012380,Good health,255,14,8,6,48,42,28,30,41,41,7,6,1,4
S01012380,Fair health,78,2,1,1,10,8,7,10,15,20,6,3,3,0
S01012380,Bad health,27,0,0,0,4,2,2,6,3,8,2,2,0,0
S01012380,Very bad health,8,0,0,0,1,0,3,1,1,2,0,0,0,0
S01012381,All people aged 16 to 74,573,26,9,17,107,73,53,46,119,104,20,12,8,25
S01012381,Very good health,259,11,4,7,57,45,20,21,47,32,7,4,3,19
S01012381,Good health,193,8,2,6,34,22,22,15,43,39,5,3,2,5
S01012381,Fair health,82,6,3,3,10,5,7,7,22,21,3,0,3,1
S01012381,Bad health,30,1,0,1,5,1,3,2,7,7,4,4,0,0
S01012381,Very bad health,9,0,0,0,1,0,1,1,0,5,1,1,0,0
S01012382,All people aged 16 to 74,725,50,16,34,201,123,94,52,96,69,18,15,3,22
S01012382,Very good health,406,28,7,21,129,69,47,27,44,37,10,7,3,15
S01012382,Good health,236,16,7,9,59,45,32,15,38,24,1,1,0,6
S01012382,Fair health,68,6,2,4,12,7,13,8,13,5,4,4,0,0
S01012382,Bad health,13,0,0,0,1,2,2,2,1,2,2,2,0,1
S01012382,Very bad health,2,0,0,0,0,0,0,0,0,1,1,1,0,0
S01012383,All people aged 16 to 74,601,34,5,29,125,89,52,55,94,111,19,12,7,22
S01012383,Very good health,283,23,3,20,71,47,24,17,38,41,5,4,1,17
S01012383,Good health,223,8,2,6,44,35,18,26,38,42,7,4,3,5
S01012383,Fair health,77,1,0,1,7,6,10,10,17,22,4,2,2,0
S01012383,Bad health,14,1,0,1,2,1,0,2,1,4,3,2,1,0
S01012383,Very bad health,4,1,0,1,1,0,0,0,0,2,0,0,0,0
S01012384,All people aged 16 to 74,380,29,8,21,99,51,36,32,60,48,13,5,8,12
S01012384,Very good health,168,16,5,11,42,26,12,20,22,18,2,1,1,10
S01012384,Good health,149,12,3,9,48,15,18,9,25,14,6,2,4,2
S01012384,Fair health,49,1,0,1,9,6,6,2,10,12,3,1,2,0
S01012384,Bad health,9,0,0,0,0,3,0,1,0,4,1,0,1,0
S01012384,Very bad health,5,0,0,0,0,1,0,0,3,0,1,1,0,0
S01012385,All people aged 16 to 74,554,40,9,31,146,76,66,42,81,53,20,10,10,30
S01012385,Very good health,272,22,3,19,75,31,32,22,37,20,9,4,5,24
S01012385,Good health,197,17,6,11,54,31,22,13,26,22,6,2,4,6
S01012385,Fair health,74,1,0,1,16,13,11,6,16,8,3,2,1,0
S01012385,Bad health,6,0,0,0,0,1,1,1,0,2,1,1,0,0
S01012385,Very bad health,5,0,0,0,1,0,0,0,2,1,1,1,0,0
S01012386,All people aged 16 to 74,714,36,7,29,81,91,53,66,163,132,55,32,23,37
S01012386,Very good health,334,25,6,19,48,44,28,34,63,53,14,11,3,25
S01012386,Good health,250,6,0,6,24,34,16,21,67,51,20,10,10,11
S01012386,Fair health,95,4,1,3,6,11,7,7,21,21,17,7,10,1
S01012386,Bad health,25,1,0,1,2,1,2,4,9,4,2,2,0,0
S01012386,Very bad health,10,0,0,0,1,1,0,0,3,3,2,2,0,0
S01012387,All people aged 16 to 74,692,47,11,36,154,85,68,104,131,68,9,5,4,26
S01012387,Very good health,344,26,5,21,80,45,30,56,56,29,5,2,3,17
S01012387,Good health,263,18,5,13,55,31,29,39,48,33,2,2,0,8
S01012387,Fair health,64,2,0,2,11,7,7,9,22,5,1,1,0,0
S01012387,Bad health,17,1,1,0,6,0,2,0,5,1,1,0,1,1
S01012387,Very bad health,4,0,0,0,2,2,0,0,0,0,0,0,0,0
S01012388,All people aged 16 to 74,516,55,14,41,139,53,61,39,87,55,6,6,0,21
S01012388,Very good health,272,28,5,23,81,33,26,20,41,24,1,1,0,18
S01012388,Good health,176,20,6,14,40,9,28,13,36,25,3,3,0,2
S01012388,Fair health,49,7,3,4,14,8,5,4,6,3,2,2,0,0
S01012388,Bad health,16,0,0,0,4,3,1,2,2,3,0,0,0,1
S01012388,Very bad health,3,0,0,0,0,0,1,0,2,0,0,0,0,0
S01012389,All people aged 16 to 74,630,34,16,18,149,63,58,71,122,92,8,5,3,33
S01012389,Very good health,328,21,9,12,89,30,22,34,57,46,2,1,1,27
S01012389,Good health,220,11,6,5,49,25,26,27,49,24,3,1,2,6
S01012389,Fair health,65,1,1,0,7,7,8,8,13,18,3,3,0,0
S01012389,Bad health,10,1,0,1,1,0,2,2,2,2,0,0,0,0
S01012389,Very bad health,7,0,0,0,3,1,0,0,1,2,0,0,0,0
S01012390,All people aged 16 to 74,583,49,11,38,127,66,44,61,119,87,4,4,0,26
S01012390,Very good health,289,23,5,18,76,33,16,28,49,42,2,2,0,20
S01012390,Good health,207,22,6,16,38,25,19,22,46,30,0,0,0,5
S01012390,Fair health,68,4,0,4,11,7,6,11,17,10,1,1,0,1
S01012390,Bad health,16,0,0,0,2,1,2,0,7,3,1,1,0,0
S01012390,Very bad health,3,0,0,0,0,0,1,0,0,2,0,0,0,0
S01012391,All people aged 16 to 74,752,65,23,42,187,104,72,80,109,83,13,8,5,39
S01012391,Very good health,452,44,17,27,120,64,32,50,60,44,5,2,3,33
S01012391,Good health,218,16,5,11,51,27,29,22,39,26,2,0,2,6
S01012391,Fair health,55,4,1,3,14,8,8,5,6,6,4,4,0,0
S01012391,Bad health,21,1,0,1,2,4,2,2,3,6,1,1,0,0
S01012391,Very bad health,6,0,0,0,0,1,1,1,1,1,1,1,0,0
S01012392,All people aged 16 to 74,569,40,16,24,144,70,29,58,117,70,11,9,2,30
S01012392,Very good health,323,26,9,17,93,40,17,31,55,33,5,5,0,23
S01012392,Good health,175,12,6,6,43,24,6,16,44,22,2,1,1,6
S01012392,Fair health,59,1,1,0,7,6,4,9,17,11,3,2,1,1
S01012392,Bad health,9,1,0,1,1,0,2,2,0,2,1,1,0,0
S01012392,Very bad health,3,0,0,0,0,0,0,0,1,2,0,0,0,0
S01012393,All people aged 16 to 74,684,43,11,32,163,65,70,75,129,102,12,10,2,25
S01012393,Very good health,329,24,7,17,86,23,36,31,61,44,3,2,1,21
S01012393,Good health,267,12,3,9,70,33,27,32,49,37,3,3,0,4
S01012393,Fair health,70,3,1,2,7,7,7,8,16,16,6,5,1,0
S01012393,Bad health,14,4,0,4,0,1,0,3,3,3,0,0,0,0
S01012393,Very bad health,4,0,0,0,0,1,0,1,0,2,0,0,0,0
S01012394,All people aged 16 to 74,475,17,6,11,81,51,27,50,107,95,20,10,10,27
S01012394,Very good health,209,12,4,8,33,29,13,20,40,38,6,3,3,18
S01012394,Good health,179,3,1,2,40,19,10,17,44,34,5,1,4,7
S01012394,Fair health,72,2,1,1,7,3,3,12,18,19,6,4,2,2
S01012394,Bad health,14,0,0,0,1,0,1,0,5,4,3,2,1,0
S01012394,Very bad health,1,0,0,0,0,0,0,1,0,0,0,0,0,0
S01012395,All people aged 16 to 74,439,22,3,19,92,51,36,38,98,77,6,3,3,19
S01012395,Very good health,206,14,2,12,43,29,12,20,42,27,3,1,2,16
S01012395,Good health,175,7,1,6,42,18,16,13,36,39,2,2,0,2
S01012395,Fair health,48,1,0,1,6,4,7,3,17,8,1,0,1,1
S01012395,Bad health,7,0,0,0,0,0,1,2,1,3,0,0,0,0
S01012395,Very bad health,3,0,0,0,1,0,0,0,2,0,0,0,0,0
S01012396,All people aged 16 to 74,468,25,7,18,95,57,33,60,92,77,12,10,2,17
S01012396,Very good health,234,13,2,11,57,31,17,31,39,31,2,2,0,13
S01012396,Good health,161,9,5,4,32,16,11,23,31,31,5,4,1,3
S01012396,Fair health,48,2,0,2,4,8,3,4,14,9,3,2,1,1
S01012396,Bad health,21,1,0,1,2,2,2,1,8,3,2,2,0,0
S01012396,Very bad health,4,0,0,0,0,0,0,1,0,3,0,0,0,0
S01012397,All people aged 16 to 74,636,49,10,39,159,59,56,82,114,79,14,8,6,24
S01012397,Very good health,294,27,4,23,80,29,23,40,49,26,3,1,2,17
S01012397,Good health,224,16,5,11,52,21,28,29,39,33,4,2,2,2
S01012397,Fair health,80,4,1,3,22,7,4,8,16,12,2,0,2,5
S01012397,Bad health,29,1,0,1,3,2,1,5,6,8,3,3,0,0
S01012397,Very bad health,9,1,0,1,2,0,0,0,4,0,2,2,0,0
S01012398,All people aged 16 to 74,665,56,9,47,152,74,32,67,128,119,12,10,2,25
S01012398,Very good health,357,38,7,31,89,39,13,39,62,55,3,3,0,19
S01012398,Good health,218,15,2,13,51,25,15,20,46,35,5,5,0,6
S01012398,Fair health,67,3,0,3,11,8,2,5,15,20,3,1,2,0
S01012398,Bad health,19,0,0,0,0,1,1,3,5,8,1,1,0,0
S01012398,Very bad health,4,0,0,0,1,1,1,0,0,1,0,0,0,0
S01012399,All people aged 16 to 74,451,17,5,12,70,55,15,59,112,98,3,2,1,22
S01012399,Very good health,209,9,4,5,34,26,9,31,54,35,2,1,1,9
S01012399,Good health,159,6,1,5,20,23,4,20,37,37,1,1,0,11
S01012399,Fair health,62,1,0,1,13,3,1,7,16,20,0,0,0,1
S01012399,Bad health,18,1,0,1,3,2,1,1,5,5,0,0,0,0
S01012399,Very bad health,3,0,0,0,0,1,0,0,0,1,0,0,0,1
S01012400,All people aged 16 to 74,455,11,3,8,64,44,36,66,104,98,13,7,6,19
S01012400,Very good health,197,5,2,3,32,23,10,29,47,36,3,1,2,12
S01012400,Good health,192,4,0,4,24,12,19,29,49,45,4,2,2,6
S01012400,Fair health,51,1,0,1,6,7,5,6,7,13,5,3,2,1
S01012400,Bad health,10,1,1,0,1,2,0,1,1,4,0,0,0,0
S01012400,Very bad health,5,0,0,0,1,0,2,1,0,0,1,1,0,0
S01012401,All people aged 16 to 74,619,19,6,13,101,55,38,76,134,155,27,14,13,14
S01012401,Very good health,257,9,2,7,47,24,6,37,60,61,5,1,4,8
S01012401,Good health,243,8,3,5,38,24,17,29,46,66,9,4,5,6
S01012401,Fair health,83,2,1,1,11,5,9,8,20,19,9,6,3,0
S01012401,Bad health,33,0,0,0,4,2,5,2,8,8,4,3,1,0
S01012401,Very bad health,3,0,0,0,1,0,1,0,0,1,0,0,0,0
S01012402,All people aged 16 to 74,335,18,2,16,72,39,35,42,66,44,5,2,3,14
S01012402,Very good health,199,16,2,14,47,22,20,24,37,22,0,0,0,11
S01012402,Good health,94,2,0,2,14,12,11,15,20,14,4,2,2,2
S01012402,Fair health,35,0,0,0,8,5,4,3,7,7,1,0,1,0
S01012402,Bad health,7,0,0,0,3,0,0,0,2,1,0,0,0,1
S01012402,Very bad health,0,0,0,0,0,0,0,0,0,0,0,0,0,0
S01012403,All people aged 16 to 74,793,59,12,47,175,89,105,70,143,111,10,8,2,31
S01012403,Very good health,409,25,4,21,92,60,50,34,69,52,4,3,1,23
S01012403,Good health,290,29,7,22,58,20,43,26,59,45,2,2,0,8
S01012403,Fair health,73,5,1,4,20,6,10,8,13,10,1,1,0,0
S01012403,Bad health,13,0,0,0,2,1,2,1,1,4,2,1,1,0
S01012403,Very bad health,8,0,0,0,3,2,0,1,1,0,1,1,0,0
S01012404,All people aged 16 to 74,736,35,7,28,167,71,62,84,143,124,15,6,9,35
S01012404,Very good health,371,23,2,21,94,41,27,38,53,63,4,1,3,28
S01012404,Good health,246,9,3,6,49,23,24,33,59,39,3,0,3,7
S01012404,Fair health,89,2,1,1,20,5,7,12,20,16,7,5,2,0
S01012404,Bad health,24,1,1,0,3,2,4,1,8,5,0,0,0,0
S01012404,Very bad health,6,0,0,0,1,0,0,0,3,1,1,0,1,0
S01012405,All people aged 16 to 74,529,42,12,30,138,64,61,66,73,52,5,4,1,28
S01012405,Very good health,330,28,9,19,83,41,36,37,47,29,3,2,1,26
S01012405,Good health,151,14,3,11,45,19,19,22,16,13,1,1,0,2
S01012405,Fair health,39,0,0,0,8,4,5,4,9,9,0,0,0,0
S01012405,Bad health,6,0,0,0,2,0,1,0,1,1,1,1,0,0
S01012405,Very bad health,3,0,0,0,0,0,0,3,0,0,0,0,0,0
S01012406,All people aged 16 to 74,461,36,6,30,109,38,49,55,78,69,5,3,2,22
S01012406,Very good health,247,19,2,17,69,23,30,24,33,33,0,0,0,16
S01012406,Good health,156,11,3,8,30,15,11,21,37,22,3,1,2,6
S01012406,Fair health,41,5,1,4,6,0,5,7,4,14,0,0,0,0
S01012406,Bad health,6,0,0,0,2,0,1,1,1,0,1,1,0,0
S01012406,Very bad health,11,1,0,1,2,0,2,2,3,0,1,1,0,0
S01012407,All people aged 16 to 74,589,43,6,37,122,64,65,62,117,82,13,8,5,21
S01012407,Very good health,311,23,3,20,77,35,31,36,54,33,7,4,3,15
S01012407,Good health,190,16,2,14,32,22,22,20,43,27,3,1,2,5
S01012407,Fair health,68,4,1,3,9,6,5,4,17,19,3,3,0,1
S01012407,Bad health,19,0,0,0,3,1,7,2,3,3,0,0,0,0
S01012407,Very bad health,1,0,0,0,1,0,0,0,0,0,0,0,0,0
S01012408,All people aged 16 to 74,460,27,6,21,93,47,60,47,83,63,3,2,1,37
S01012408,Very good health,236,12,4,8,46,29,29,21,42,27,0,0,0,30
S01012408,Good health,174,15,2,13,34,17,22,22,33,23,2,1,1,6
S01012408,Fair health,44,0,0,0,12,1,7,4,7,11,1,1,0,1
S01012408,Bad health,5,0,0,0,1,0,1,0,1,2,0,0,0,0
S01012408,Very bad health,1,0,0,0,0,0,1,0,0,0,0,0,0,0
S01012409,All people aged 16 to 74,497,37,10,27,104,35,68,46,93,87,10,7,3,17
S01012409,Very good health,230,17,5,12,52,23,24,21,38,39,2,1,1,14
S01012409,Good health,195,15,4,11,39,7,32,21,36,37,5,4,1,3
S01012409,Fair health,58,5,1,4,9,3,9,2,17,10,3,2,1,0
S01012409,Bad health,10,0,0,0,1,2,3,2,1,1,0,0,0,0
S01012409,Very bad health,4,0,0,0,3,0,0,0,1,0,0,0,0,0
S01012410,All people aged 16 to 74,795,42,10,32,186,82,57,108,156,107,17,8,9,40
S01012410,Very good health,416,25,5,20,109,47,23,63,62,45,8,4,4,34
S01012410,Good health,284,17,5,12,59,27,26,36,63,46,5,2,3,5
S01012410,Fair health,75,0,0,0,14,6,7,7,27,11,2,0,2,1
S01012410,Bad health,15,0,0,0,2,2,1,2,2,4,2,2,0,0
S01012410,Very bad health,5,0,0,0,2,0,0,0,2,1,0,0,0,0
S01012411,All people aged 16 to 74,718,36,10,26,108,80,43,105,151,134,22,16,6,39
S01012411,Very good health,351,19,4,15,49,37,14,62,75,55,12,8,4,28
S01012411,Good health,256,14,5,9,43,31,18,34,45,60,3,2,1,8
S01012411,Fair health,89,3,1,2,14,10,8,8,22,14,7,6,1,3
S01012411,Bad health,17,0,0,0,0,2,2,1,7,5,0,0,0,0
S01012411,Very bad health,5,0,0,0,2,0,1,0,2,0,0,0,0,0
S01012412,All people aged 16 to 74,487,25,2,23,70,40,68,66,110,71,13,6,7,24
S01012412,Very good health,216,10,1,9,32,16,32,32,48,25,5,2,3,16
S01012412,Good health,194,11,1,10,29,22,24,28,39,30,4,2,2,7
S01012412,Fair health,54,3,0,3,7,0,9,5,17,9,3,1,2,1
S01012412,Bad health,16,1,0,1,2,2,3,0,4,4,0,0,0,0
S01012412,Very bad health,7,0,0,0,0,0,0,1,2,3,1,1,0,0
S01012413,All people aged 16 to 74,696,32,8,24,170,52,66,81,144,130,9,7,2,12
S01012413,Very good health,324,16,4,12,87,29,25,33,60,62,3,3,0,9
S01012413,Good health,245,11,3,8,58,14,24,36,57,39,3,1,2,3
S01012413,Fair health,97,5,1,4,19,8,11,9,22,21,2,2,0,0
S01012413,Bad health,24,0,0,0,5,0,5,1,4,8,1,1,0,0
S01012413,Very bad health,6,0,0,0,1,1,1,2,1,0,0,0,0,0
S01012414,All people aged 16 to 74,522,22,4,18,106,34,66,63,130,72,14,7,7,15
S01012414,Very good health,246,12,1,11,50,17,29,31,65,35,1,0,1,6
S01012414,Good health,194,7,3,4,40,13,28,15,48,26,9,3,6,8
S01012414,Fair health,64,2,0,2,11,4,8,14,13,8,3,3,0,1
S01012414,Bad health,14,1,0,1,5,0,1,1,4,2,0,0,0,0
S01012414,Very bad health,4,0,0,0,0,0,0,2,0,1,1,1,0,0
S01012415,All people aged 16 to 74,402,11,1,10,62,32,85,36,93,59,4,1,3,20
S01012415,Very good health,215,5,0,5,44,19,49,18,44,22,2,0,2,12
S01012415,Good health,147,1,0,1,14,9,27,15,44,29,2,1,1,6
S01012415,Fair health,30,2,1,1,2,3,8,3,5,5,0,0,0,2
S01012415,Bad health,8,2,0,2,2,1,1,0,0,2,0,0,0,0
S01012415,Very bad health,2,1,0,1,0,0,0,0,0,1,0,0,0,0
S01012416,All people aged 16 to 74,408,12,3,9,83,28,73,45,81,62,5,4,1,19
S01012416,Very good health,205,3,0,3,51,14,28,32,36,25,1,1,0,15
S01012416,Good health,158,5,1,4,29,11,35,8,35,30,2,1,1,3
S01012416,Fair health,38,3,2,1,3,3,8,4,7,7,2,2,0,1
S01012416,Bad health,4,0,0,0,0,0,2,1,1,0,0,0,0,0
S01012416,Very bad health,3,1,0,1,0,0,0,0,2,0,0,0,0,0
S01012417,All people aged 16 to 74,469,17,5,12,76,44,79,49,103,70,14,9,5,17
S01012417,Very good health,194,10,2,8,34,18,36,21,40,18,6,3,3,11
S01012417,Good health,152,4,1,3,25,17,27,17,32,23,2,1,1,5
S01012417,Fair health,77,3,2,1,6,7,11,9,16,21,3,2,1,1
S01012417,Bad health,36,0,0,0,8,2,4,1,12,7,2,2,0,0
S01012417,Very bad health,10,0,0,0,3,0,1,1,3,1,1,1,0,0
S01012418,All people aged 16 to 74,610,27,10,17,94,56,153,51,109,62,33,19,14,25
S01012418,Very good health,289,14,2,12,53,30,66,21,47,24,12,5,7,22
S01012418,Good health,202,10,7,3,27,14,55,19,41,20,13,9,4,3
S01012418,Fair health,81,2,0,2,7,8,26,9,13,12,4,2,2,0
S01012418,Bad health,28,1,1,0,5,3,6,1,7,4,1,1,0,0
S01012418,Very bad health,10,0,0,0,2,1,0,1,1,2,3,2,1,0
S01012419,All people aged 16 to 74,572,40,11,29,97,50,144,52,80,47,26,13,13,36
S01012419,Very good health,283,16,4,12,46,25,76,30,34,16,14,7,7,26
S01012419,Good health,188,16,5,11,35,17,48,11,27,21,5,1,4,8
S01012419,Fair health,77,7,1,6,13,4,17,9,15,7,4,2,2,1
S01012419,Bad health,16,1,1,0,2,3,2,1,2,3,2,2,0,0
S01012419,Very bad health,8,0,0,0,1,1,1,1,2,0,1,1,0,1
S01012420,All people aged 16 to 74,625,23,11,12,72,51,50,75,151,131,30,21,9,42
S01012420,Very good health,264,12,6,6,33,21,16,34,54,48,11,7,4,35
S01012420,Good health,217,7,4,3,30,21,20,25,65,37,9,5,4,3
S01012420,Fair health,104,3,1,2,5,6,10,11,25,32,8,7,1,4
S01012420,Bad health,31,1,0,1,3,2,3,4,4,12,2,2,0,0
S01012420,Very bad health,9,0,0,0,1,1,1,1,3,2,0,0,0,0
S01012421,All people aged 16 to 74,555,27,5,22,114,47,87,69,88,72,14,11,3,37
S01012421,Very good health,273,15,1,14,61,22,38,36,40,28,1,0,1,32
S01012421,Good health,178,8,2,6,34,17,36,23,32,20,4,3,1,4
S01012421,Fair health,69,3,2,1,12,6,10,6,11,16,5,5,0,0
S01012421,Bad health,23,1,0,1,6,2,1,1,3,6,3,2,1,0
S01012421,Very bad health,12,0,0,0,1,0,2,3,2,2,1,1,0,1
S01012422,All people aged 16 to 74,645,47,14,33,133,55,102,64,104,77,28,13,15,35
S01012422,Very good health,304,32,12,20,58,32,39,30,50,32,10,7,3,21
S01012422,Good health,224,9,1,8,51,18,39,21,39,27,8,1,7,12
S01012422,Fair health,73,4,1,3,18,2,14,4,8,14,8,4,4,1
S01012422,Bad health,30,2,0,2,4,3,5,6,4,3,2,1,1,1
S01012422,Very bad health,14,0,0,0,2,0,5,3,3,1,0,0,0,0
S01012423,All people aged 16 to 74,624,41,12,29,139,59,94,67,97,75,22,11,11,30
S01012423,Very good health,300,25,6,19,82,24,47,30,37,27,9,3,6,19
S01012423,Good health,226,14,6,8,44,27,35,24,33,31,10,5,5,8
S01012423,Fair health,72,2,0,2,9,4,9,10,20,13,2,2,0,3
S01012423,Bad health,20,0,0,0,2,4,1,2,6,4,1,1,0,0
S01012423,Very bad health,6,0,0,0,2,0,2,1,1,0,0,0,0,0
S01012424,All people aged 16 to 74,671,21,4,17,78,73,49,85,161,136,35,12,23,33
S01012424,Very good health,306,11,1,10,37,35,16,38,65,67,12,4,8,25
S01012424,Good health,232,7,2,5,26,22,21,29,61,43,16,5,11,7
S01012424,Fair health,80,2,1,1,11,9,6,13,21,13,4,1,3,1
S01012424,Bad health,44,1,0,1,4,5,5,3,13,10,3,2,1,0
S01012424,Very bad health,9,0,0,0,0,2,1,2,1,3,0,0,0,0
S01012425,All people aged 16 to 74,433,5,2,3,38,25,25,34,113,127,38,32,6,28
S01012425,Very good health,137,3,1,2,14,10,6,13,29,34,8,8,0,20
S01012425,Good health,139,1,0,1,13,7,8,9,43,42,10,7,3,6
S01012425,Fair health,101,1,1,0,5,5,11,9,24,33,12,11,1,1
S01012425,Bad health,43,0,0,0,5,3,0,2,13,14,6,4,2,0
S01012425,Very bad health,13,0,0,0,1,0,0,1,4,4,2,2,0,1
S01012426,All people aged 16 to 74,343,1,1,0,36,38,20,45,76,70,29,13,16,28
S01012426,Very good health,138,1,1,0,18,13,7,20,30,26,4,1,3,19
S01012426,Good health,125,0,0,0,15,11,8,16,27,24,15,3,12,9
S01012426,Fair health,56,0,0,0,2,9,4,7,17,10,7,7,0,0
S01012426,Bad health,16,0,0,0,0,3,1,1,1,9,1,0,1,0
S01012426,Very bad health,8,0,0,0,1,2,0,1,1,1,2,2,0,0
S01012427,All people aged 16 to 74,485,7,1,6,53,27,28,49,131,119,36,23,13,35
S01012427,Very good health,202,2,1,1,23,11,11,21,58,44,11,6,5,21
S01012427,Good health,157,5,0,5,19,9,5,13,47,34,13,7,6,12
S01012427,Fair health,87,0,0,0,7,4,10,10,18,26,10,8,2,2
S01012427,Bad health,28,0,0,0,3,1,1,5,6,11,1,1,0,0
S01012427,Very bad health,11,0,0,0,1,2,1,0,2,4,1,1,0,0
S01012428,All people aged 16 to 74,486,15,3,12,54,64,35,51,127,96,19,11,8,25
S01012428,Very good health,207,6,2,4,26,35,7,12,54,40,8,1,7,19
S01012428,Good health,187,8,1,7,18,23,16,24,49,38,7,6,1,4
S01012428,Fair health,66,1,0,1,5,5,9,10,19,13,3,3,0,1
S01012428,Bad health,21,0,0,0,4,1,2,4,4,5,1,1,0,0
S01012428,Very bad health,5,0,0,0,1,0,1,1,1,0,0,0,0,1
S01012429,All people aged 16 to 74,407,13,3,10,73,53,29,47,79,68,24,15,9,21
S01012429,Very good health,155,8,1,7,34,24,15,17,17,18,7,4,3,15
S01012429,Good health,144,5,2,3,26,19,7,15,37,23,6,5,1,6
S01012429,Fair health,64,0,0,0,9,9,5,8,14,12,7,3,4,0
S01012429,Bad health,32,0,0,0,2,1,2,7,7,10,3,2,1,0
S01012429,Very bad health,12,0,0,0,2,0,0,0,4,5,1,1,0,0
S01012430,All people aged 16 to 74,414,18,6,12,84,45,39,42,88,53,19,14,5,26
S01012430,Very good health,203,14,4,10,47,24,16,18,32,25,5,5,0,22
S01012430,Good health,127,3,1,2,20,13,15,16,37,15,4,1,3,4
S01012430,Fair health,53,1,1,0,9,4,7,4,13,9,6,4,2,0
S01012430,Bad health,23,0,0,0,7,3,0,3,4,4,2,2,0,0
S01012430,Very bad health,8,0,0,0,1,1,1,1,2,0,2,2,0,0
S01012431,All people aged 16 to 74,652,46,10,36,121,60,97,55,124,76,36,24,12,37
S01012431,Very good health,304,27,5,22,71,31,34,24,51,28,10,4,6,28
S01012431,Good health,206,11,2,9,31,22,39,20,40,22,14,11,3,7
S01012431,Fair health,99,4,1,3,15,4,18,5,27,15,9,7,2,2
S01012431,Bad health,39,4,2,2,3,2,5,6,6,10,3,2,1,0
S01012431,Very bad health,4,0,0,0,1,1,1,0,0,1,0,0,0,0
S01012432,All people aged 16 to 74,513,19,4,15,105,52,45,51,94,89,21,12,9,37
S01012432,Very good health,214,6,0,6,43,30,12,15,38,34,7,3,4,29
S01012432,Good health,168,6,2,4,35,15,24,15,30,27,9,5,4,7
S01012432,Fair health,84,6,1,5,19,6,4,14,16,13,5,4,1,1
S01012432,Bad health,37,1,1,0,7,1,4,6,7,11,0,0,0,0
S01012432,Very bad health,10,0,0,0,1,0,1,1,3,4,0,0,0,0
S01012433,All people aged 16 to 74,391,8,0,8,55,48,33,53,82,77,19,15,4,16
S01012433,Very good health,157,6,0,6,33,20,11,20,31,20,3,3,0,13
S01012433,Good health,135,1,0,1,13,17,14,16,32,32,8,5,3,2
S01012433,Fair health,67,0,0,0,7,10,6,10,14,13,6,5,1,1
S01012433,Bad health,23,1,0,1,2,1,1,5,3,8,2,2,0,0
S01012433,Very bad health,9,0,0,0,0,0,1,2,2,4,0,0,0,0
S01012434,All people aged 16 to 74,512,19,7,12,70,56,30,68,104,97,36,20,16,32
S01012434,Very good health,219,8,3,5,37,29,12,21,38,36,16,8,8,22
S01012434,Good health,178,6,2,4,22,21,11,26,42,29,15,10,5,6
S01012434,Fair health,83,3,2,1,9,4,6,16,16,23,3,2,1,3
S01012434,Bad health,25,2,0,2,1,2,1,4,5,7,2,0,2,1
S01012434,Very bad health,7,0,0,0,1,0,0,1,3,2,0,0,0,0
S01012435,All people aged 16 to 74,485,17,3,14,61,52,39,52,114,87,26,9,17,37
S01012435,Very good health,210,13,2,11,24,29,16,22,40,28,9,4,5,29
S01012435,Good health,172,4,1,3,24,16,16,19,50,27,11,3,8,5
S01012435,Fair health,53,0,0,0,4,5,6,8,10,15,3,1,2,2
S01012435,Bad health,38,0,0,0,8,1,0,1,11,14,3,1,2,0
S01012435,Very bad health,12,0,0,0,1,1,1,2,3,3,0,0,0,1
S01012436,All people aged 16 to 74,542,19,7,12,65,62,37,56,127,87,45,24,21,44
S01012436,Very good health,230,10,2,8,34,22,17,23,56,24,10,6,4,34
S01012436,Good health,194,7,4,3,17,27,9,21,48,42,16,7,9,7
S01012436,Fair health,78,0,0,0,9,9,10,6,16,13,13,7,6,2
S01012436,Bad health,25,1,0,1,4,1,1,3,6,6,2,0,2,1
S01012436,Very bad health,15,1,1,0,1,3,0,3,1,2,4,4,0,0
S01012437,All people aged 16 to 74,565,17,8,9,87,70,43,79,103,102,31,24,7,33
S01012437,Very good health,233,9,4,5,43,33,17,29,40,28,9,8,1,25
S01012437,Good health,204,4,0,4,27,26,20,33,36,42,10,9,1,6
S01012437,Fair health,101,4,4,0,14,11,5,12,22,22,9,4,5,2
S01012437,Bad health,18,0,0,0,1,0,1,3,3,9,1,1,0,0
S01012437,Very bad health,9,0,0,0,2,0,0,2,2,1,2,2,0,0
S01012438,All people aged 16 to 74,506,21,5,16,91,61,48,57,103,74,23,11,12,28
S01012438,Very good health,263,14,2,12,51,40,24,21,50,32,9,4,5,22
S01012438,Good health,166,4,3,1,31,18,19,22,34,27,7,3,4,4
S01012438,Fair health,45,1,0,1,8,1,5,9,10,7,3,0,3,1
S01012438,Bad health,28,2,0,2,0,2,0,4,7,8,4,4,0,1
S01012438,Very bad health,4,0,0,0,1,0,0,1,2,0,0,0,0,0
S01012439,All people aged 16 to 74,559,26,7,19,106,71,45,64,95,75,35,17,18,42
S01012439,Very good health,261,17,6,11,45,39,20,31,42,27,9,4,5,31
S01012439,Good health,213,7,1,6,44,26,21,19,30,35,20,11,9,11
S01012439,Fair health,57,1,0,1,10,6,2,7,17,11,3,1,2,0
S01012439,Bad health,20,0,0,0,5,0,2,5,5,1,2,0,2,0
S01012439,Very bad health,8,1,0,1,2,0,0,2,1,1,1,1,0,0
S01012440,All people aged 16 to 74,407,26,6,20,116,56,40,43,51,38,9,5,4,28
S01012440,Very good health,222,16,2,14,62,23,23,17,27,22,6,2,4,26
S01012440,Good health,127,7,3,4,38,23,11,18,16,10,2,2,0,2
S01012440,Fair health,41,2,0,2,12,6,4,5,7,4,1,1,0,0
S01012440,Bad health,14,1,1,0,3,4,0,3,1,2,0,0,0,0
S01012440,Very bad health,3,0,0,0,1,0,2,0,0,0,0,0,0,0
S01012441,All people aged 16 to 74,688,70,14,56,160,62,129,63,87,62,20,12,8,35
S01012441,Very good health,370,36,7,29,87,38,63,28,43,35,12,6,6,28
S01012441,Good health,207,25,5,20,50,12,44,23,24,16,7,5,2,6
S01012441,Fair health,76,7,2,5,13,11,16,8,13,6,1,1,0,1
S01012441,Bad health,33,2,0,2,9,1,6,4,6,5,0,0,0,0
S01012441,Very bad health,2,0,0,0,1,0,0,0,1,0,0,0,0,0
S01012442,All people aged 16 to 74,749,72,16,56,217,72,113,47,101,51,31,19,12,45
S01012442,Very good health,406,49,11,38,124,41,60,27,44,23,8,3,5,30
S01012442,Good health,238,15,4,11,73,22,35,15,38,18,11,6,5,11
S01012442,Fair health,74,8,1,7,17,7,13,3,11,5,6,4,2,4
S01012442,Bad health,23,0,0,0,3,2,2,0,6,4,6,6,0,0
S01012442,Very bad health,8,0,0,0,0,0,3,2,2,1,0,0,0,0
S01012443,All people aged 16 to 74,571,41,13,28,132,76,83,54,73,51,22,13,9,39
S01012443,Very good health,292,24,7,17,69,43,29,35,27,32,5,3,2,28
S01012443,Good health,192,13,5,8,47,19,40,15,29,12,7,3,4,10
S01012443,Fair health,66,2,1,1,13,11,12,1,14,5,7,5,2,1
S01012443,Bad health,15,2,0,2,2,0,1,2,3,2,3,2,1,0
S01012443,Very bad health,6,0,0,0,1,3,1,1,0,0,0,0,0,0
S01012444,All people aged 16 to 74,627,74,16,58,160,78,51,45,75,51,60,51,9,33
S01012444,Very good health,314,51,11,40,94,45,24,19,25,17,12,5,7,27
S01012444,Good health,189,16,2,14,55,24,17,13,25,13,20,18,2,6
S01012444,Fair health,94,6,3,3,10,7,9,9,19,13,21,21,0,0
S01012444,Bad health,23,1,0,1,1,1,1,3,4,6,6,6,0,0
S01012444,Very bad health,7,0,0,0,0,1,0,1,2,2,1,1,0,0
S01012445,All people aged 16 to 74,387,78,14,64,107,39,37,30,33,22,16,12,4,25
S01012445,Very good health,252,56,11,45,74,21,24,21,19,12,7,5,2,18
S01012445,Good health,88,18,3,15,24,12,7,5,9,6,1,1,0,6
S01012445,Fair health,36,4,0,4,7,5,2,3,3,4,7,5,2,1
S01012445,Bad health,8,0,0,0,1,1,4,0,2,0,0,0,0,0
S01012445,Very bad health,3,0,0,0,1,0,0,1,0,0,1,1,0,0
S01012446,All people aged 16 to 74,370,17,4,13,69,57,20,36,75,62,13,7,6,21
S01012446,Very good health,174,10,1,9,35,30,8,13,33,26,5,2,3,14
S01012446,Good health,116,5,1,4,18,15,9,13,24,21,4,1,3,7
S01012446,Fair health,56,2,2,0,10,10,1,8,13,8,4,4,0,0
S01012446,Bad health,18,0,0,0,5,2,1,1,4,5,0,0,0,0
S01012446,Very bad health,6,0,0,0,1,0,1,1,1,2,0,0,0,0
S01012447,All people aged 16 to 74,649,57,9,48,189,103,55,57,72,46,16,11,5,54
S01012447,Very good health,341,29,6,23,96,60,25,22,41,21,5,3,2,42
S01012447,Good health,212,23,2,21,70,31,21,22,14,14,9,6,3,8
S01012447,Fair health,71,2,0,2,19,9,8,10,11,9,2,2,0,1
S01012447,Bad health,19,2,0,2,4,2,0,2,5,1,0,0,0,3
S01012447,Very bad health,6,1,1,0,0,1,1,1,1,1,0,0,0,0
S01012448,All people aged 16 to 74,667,56,16,40,187,103,74,57,70,36,33,22,11,51
S01012448,Very good health,376,32,11,21,129,62,32,28,32,14,7,3,4,40
S01012448,Good health,202,19,4,15,43,34,29,19,27,12,10,8,2,9
S01012448,Fair health,67,4,1,3,13,5,10,5,8,8,12,9,3,2
S01012448,Bad health,14,1,0,1,1,2,2,1,2,2,3,2,1,0
S01012448,Very bad health,8,0,0,0,1,0,1,4,1,0,1,0,1,0
S01012449,All people aged 16 to 74,444,28,8,20,88,72,36,37,79,63,13,6,7,28
S01012449,Very good health,222,19,5,14,47,37,18,17,37,23,2,1,1,22
S01012449,Good health,156,7,2,5,32,30,13,15,28,23,2,0,2,6
S01012449,Fair health,46,2,1,1,6,4,4,4,11,10,5,1,4,0
S01012449,Bad health,16,0,0,0,3,1,1,0,3,7,1,1,0,0
S01012449,Very bad health,4,0,0,0,0,0,0,1,0,0,3,3,0,0
S01012450,All people aged 16 to 74,654,61,10,51,189,65,91,43,64,57,23,19,4,61
S01012450,Very good health,356,39,6,33,112,33,53,18,26,21,6,5,1,48
S01012450,Good health,188,16,1,15,53,18,22,16,25,21,4,3,1,13
S01012450,Fair health,76,6,3,3,16,12,13,7,8,10,4,3,1,0
S01012450,Bad health,27,0,0,0,8,1,1,0,5,5,7,6,1,0
S01012450,Very bad health,7,0,0,0,0,1,2,2,0,0,2,2,0,0
S01012451,All people aged 16 to 74,623,113,19,94,207,98,55,24,48,22,21,17,4,35
S01012451,Very good health,320,55,11,44,127,42,25,14,18,7,5,4,1,27
S01012451,Good health,219,43,6,37,63,39,21,4,23,9,10,8,2,7
S01012451,Fair health,69,13,2,11,15,13,7,6,5,4,5,4,1,1
S01012451,Bad health,8,1,0,1,1,2,2,0,1,1,0,0,0,0
S01012451,Very bad health,7,1,0,1,1,2,0,0,1,1,1,1,0,0
S01012452,All people aged 16 to 74,404,48,11,37,125,64,38,32,52,17,7,3,4,21
S01012452,Very good health,221,29,7,22,75,27,19,15,27,13,1,0,1,15
S01012452,Good health,128,12,1,11,35,28,15,11,19,1,2,0,2,5
S01012452,Fair health,42,6,2,4,10,8,4,5,5,2,2,2,0,0
S01012452,Bad health,11,1,1,0,3,1,0,1,1,1,2,1,1,1
S01012452,Very bad health,2,0,0,0,2,0,0,0,0,0,0,0,0,0
S01012453,All people aged 16 to 74,599,116,35,81,219,75,69,20,40,23,9,4,5,28
S01012453,Very good health,393,80,26,54,142,48,38,16,24,14,4,2,2,27
S01012453,Good health,158,32,8,24,58,20,25,3,9,6,4,1,3,1
S01012453,Fair health,39,2,1,1,17,6,6,1,4,3,0,0,0,0
S01012453,Bad health,8,1,0,1,2,1,0,0,3,0,1,1,0,0
S01012453,Very bad health,1,1,0,1,0,0,0,0,0,0,0,0,0,0
S01012454,All people aged 16 to 74,474,60,13,47,165,82,35,21,49,17,14,8,6,31
S01012454,Very good health,244,28,3,25,82,39,17,10,24,8,9,5,4,27
S01012454,Good health,178,28,8,20,65,35,12,9,18,6,2,0,2,3
S01012454,Fair health,42,3,2,1,17,6,4,1,4,3,3,3,0,1
S01012454,Bad health,8,0,0,0,1,1,2,1,3,0,0,0,0,0
S01012454,Very bad health,2,1,0,1,0,1,0,0,0,0,0,0,0,0
S01012455,All people aged 16 to 74,430,86,16,70,144,62,53,14,19,15,8,3,5,29
S01012455,Very good health,271,53,13,40,89,39,30,8,14,10,2,1,1,26
S01012455,Good health,121,22,3,19,43,19,19,3,3,4,6,2,4,2
S01012455,Fair health,30,10,0,10,9,4,4,1,1,1,0,0,0,0
S01012455,Bad health,6,0,0,0,3,0,0,1,1,0,0,0,0,1
S01012455,Very bad health,2,1,0,1,0,0,0,1,0,0,0,0,0,0
S01012456,All people aged 16 to 74,546,100,30,70,196,70,46,32,37,18,13,6,7,34
S01012456,Very good health,309,62,23,39,115,33,23,16,15,6,9,2,7,30
S01012456,Good health,171,22,5,17,64,28,21,10,17,4,1,1,0,4
S01012456,Fair health,53,14,2,12,12,8,2,5,5,5,2,2,0,0
S01012456,Bad health,8,1,0,1,3,0,0,0,0,3,1,1,0,0
S01012456,Very bad health,5,1,0,1,2,1,0,1,0,0,0,0,0,0
S01012457,All people aged 16 to 74,658,129,34,95,235,90,60,28,57,19,11,6,5,29
S01012457,Very good health,364,80,24,56,126,52,32,13,22,11,4,2,2,24
S01012457,Good health,203,40,8,32,74,25,16,12,24,4,3,0,3,5
S01012457,Fair health,72,9,2,7,26,11,9,3,9,2,3,3,0,0
S01012457,Bad health,14,0,0,0,7,1,2,0,2,1,1,1,0,0
S01012457,Very bad health,5,0,0,0,2,1,1,0,0,1,0,0,0,0
S01012458,All people aged 16 to 74,566,113,19,94,200,58,57,16,43,14,16,10,6,49
S01012458,Very good health,351,79,13,66,113,41,35,7,17,6,10,6,4,43
S01012458,Good health,167,28,5,23,70,13,17,6,21,5,2,2,0,5
S01012458,Fair health,44,6,1,5,17,2,5,3,5,2,3,1,2,1
S01012458,Bad health,3,0,0,0,0,2,0,0,0,1,0,0,0,0
S01012458,Very bad health,1,0,0,0,0,0,0,0,0,0,1,1,0,0
S01012459,All people aged 16 to 74,540,53,9,44,146,98,43,36,71,41,8,4,4,44
S01012459,Very good health,326,42,7,35,91,58,23,20,34,17,6,3,3,35
S01012459,Good health,163,8,1,7,41,34,14,12,31,14,0,0,0,9
S01012459,Fair health,40,2,1,1,11,5,6,4,4,6,2,1,1,0
S01012459,Bad health,9,1,0,1,2,1,0,0,1,4,0,0,0,0
S01012459,Very bad health,2,0,0,0,1,0,0,0,1,0,0,0,0,0
S01012460,All people aged 16 to 74,410,43,8,35,127,74,35,32,48,21,8,4,4,22
S01012460,Very good health,206,24,5,19,69,33,13,15,21,12,4,2,2,15
S01012460,Good health,156,15,2,13,46,31,17,9,21,7,3,1,2,7
S01012460,Fair health,38,3,1,2,10,8,5,5,5,1,1,1,0,0
S01012460,Bad health,9,1,0,1,2,2,0,2,1,1,0,0,0,0
S01012460,Very bad health,1,0,0,0,0,0,0,1,0,0,0,0,0,0
S01012461,All people aged 16 to 74,376,24,1,23,83,45,23,35,71,60,14,10,4,21
S01012461,Very good health,181,13,0,13,43,27,6,16,32,23,4,4,0,17
S01012461,Good health,125,9,1,8,32,12,12,8,23,17,8,5,3,4
S01012461,Fair health,52,1,0,1,7,4,3,9,10,16,2,1,1,0
S01012461,Bad health,13,1,0,1,1,1,2,0,6,2,0,0,0,0
S01012461,Very bad health,5,0,0,0,0,1,0,2,0,2,0,0,0,0
S01012462,All people aged 16 to 74,556,14,1,13,99,44,26,62,117,115,39,24,15,40
S01012462,Very good health,244,8,1,7,47,26,10,25,47,47,8,4,4,26
S01012462,Good health,193,4,0,4,33,12,10,25,48,31,17,8,9,13
S01012462,Fair health,76,1,0,1,16,5,4,9,14,20,6,5,1,1
S01012462,Bad health,31,0,0,0,3,0,1,3,6,13,5,4,1,0
S01012462,Very bad health,12,1,0,1,0,1,1,0,2,4,3,3,0,0
S01012463,All people aged 16 to 74,451,15,3,12,71,56,28,41,94,81,36,20,16,29
S01012463,Very good health,194,10,3,7,31,21,14,18,48,22,14,10,4,16
S01012463,Good health,152,4,0,4,27,16,9,14,28,29,14,6,8,11
S01012463,Fair health,75,1,0,1,11,14,3,6,10,22,6,2,4,2
S01012463,Bad health,28,0,0,0,2,5,2,2,8,7,2,2,0,0
S01012463,Very bad health,2,0,0,0,0,0,0,1,0,1,0,0,0,0
S01012464,All people aged 16 to 74,476,9,2,7,63,50,27,49,114,81,40,23,17,43
S01012464,Very good health,205,5,0,5,34,19,11,21,48,30,11,8,3,26
S01012464,Good health,158,3,1,2,19,20,7,17,42,28,10,2,8,12
S01012464,Fair health,68,0,0,0,6,8,4,5,14,13,14,9,5,4
S01012464,Bad health,35,1,1,0,2,3,4,5,8,8,4,4,0,0
S01012464,Very bad health,10,0,0,0,2,0,1,1,2,2,1,0,1,1
S01012465,All people aged 16 to 74,542,11,4,7,88,58,30,62,109,108,33,16,17,43
S01012465,Very good health,220,5,1,4,34,22,11,27,34,43,12,3,9,32
S01012465,Good health,211,6,3,3,42,21,13,22,47,35,15,9,6,10
S01012465,Fair health,73,0,0,0,7,10,4,9,21,18,4,2,2,0
S01012465,Bad health,32,0,0,0,4,4,2,3,7,9,2,2,0,1
S01012465,Very bad health,6,0,0,0,1,1,0,1,0,3,0,0,0,0
S01012466,All people aged 16 to 74,582,45,9,36,140,67,63,36,89,63,37,24,13,42
S01012466,Very good health,289,26,5,21,75,25,33,16,41,30,14,6,8,29
S01012466,Good health,186,13,4,9,46,28,22,7,35,17,9,5,4,9
S01012466,Fair health,76,5,0,5,13,12,7,6,10,11,8,7,1,4
S01012466,Bad health,27,0,0,0,5,2,1,6,2,5,6,6,0,0
S01012466,Very bad health,4,1,0,1,1,0,0,1,1,0,0,0,0,0
S01012467,All people aged 16 to 74,496,19,2,17,111,61,39,42,106,65,11,3,8,42
S01012467,Very good health,245,11,1,10,56,26,19,23,51,23,6,2,4,30
S01012467,Good health,160,5,0,5,31,30,16,10,31,25,3,0,3,9
S01012467,Fair health,64,3,1,2,17,4,3,9,15,10,0,0,0,3
S01012467,Bad health,18,0,0,0,6,0,0,0,5,6,1,1,0,0
S01012467,Very bad health,9,0,0,0,1,1,1,0,4,1,1,0,1,0
S01012468,All people aged 16 to 74,550,33,9,24,119,84,34,69,94,58,19,7,12,40
S01012468,Very good health,261,21,5,16,59,39,16,26,33,23,7,4,3,37
S01012468,Good health,183,9,2,7,41,28,11,28,38,20,6,0,6,2
S01012468,Fair health,75,1,0,1,14,15,5,13,13,10,3,1,2,1
S01012468,Bad health,22,1,1,0,4,1,1,2,8,3,2,1,1,0
S01012468,Very bad health,9,1,1,0,1,1,1,0,2,2,1,1,0,0
S01012469,All people aged 16 to 74,556,104,23,81,189,78,58,22,46,19,10,7,3,30
S01012469,Very good health,316,65,16,49,110,39,28,13,21,8,4,2,2,28
S01012469,Good health,174,30,5,25,62,30,18,7,14,6,5,4,1,2
S01012469,Fair health,47,6,1,5,12,6,10,2,7,3,1,1,0,0
S01012469,Bad health,17,3,1,2,5,2,2,0,3,2,0,0,0,0
S01012469,Very bad health,2,0,0,0,0,1,0,0,1,0,0,0,0,0
S01012470,All people aged 16 to 74,683,54,12,42,141,93,38,58,132,85,44,27,17,38
S01012470,Very good health,317,30,6,24,73,40,13,27,57,35,15,9,6,27
S01012470,Good health,237,18,4,14,53,35,16,17,46,26,17,10,7,9
S01012470,Fair health,82,4,2,2,9,9,6,8,25,12,7,5,2,2
S01012470,Bad health,33,2,0,2,1,8,3,2,3,10,4,2,2,0
S01012470,Very bad health,14,0,0,0,5,1,0,4,1,2,1,1,0,0
S01012471,All people aged 16 to 74,605,104,18,86,207,76,79,23,43,26,6,5,1,41
S01012471,Very good health,364,63,10,53,124,49,46,14,22,10,1,1,0,35
S01012471,Good health,192,33,7,26,71,23,31,4,13,9,2,1,1,6
S01012471,Fair health,36,7,0,7,7,4,2,5,4,4,3,3,0,0
S01012471,Bad health,10,1,1,0,4,0,0,0,3,2,0,0,0,0
S01012471,Very bad health,3,0,0,0,1,0,0,0,1,1,0,0,0,0
S01012472,All people aged 16 to 74,498,69,14,55,158,84,44,28,53,23,7,4,3,32
S01012472,Very good health,245,37,12,25,80,33,20,14,18,11,3,1,2,29
S01012472,Good health,198,27,0,27,61,40,15,12,29,11,2,2,0,1
S01012472,Fair health,33,2,0,2,8,10,4,1,4,0,2,1,1,2
S01012472,Bad health,16,2,1,1,7,1,4,1,1,0,0,0,0,0
S01012472,Very bad health,6,1,1,0,2,0,1,0,1,1,0,0,0,0
S01012473,All people aged 16 to 74,414,53,10,43,130,59,23,38,48,23,12,8,4,28
S01012473,Very good health,209,25,5,20,71,27,12,22,17,8,4,3,1,23
S01012473,Good health,157,23,3,20,42,25,8,14,24,11,5,3,2,5
S01012473,Fair health,36,5,2,3,13,5,1,2,5,2,3,2,1,0
S01012473,Bad health,8,0,0,0,2,2,1,0,2,1,0,0,0,0
S01012473,Very bad health,4,0,0,0,2,0,1,0,0,1,0,0,0,0
S01012474,All people aged 16 to 74,534,39,8,31,144,70,40,47,78,54,29,21,8,33
S01012474,Very good health,257,19,3,16,75,38,22,20,32,15,11,6,5,25
S01012474,Good health,171,13,4,9,48,21,10,19,25,20,9,7,2,6
S01012474,Fair health,69,5,1,4,15,9,6,6,13,10,4,3,1,1
S01012474,Bad health,22,2,0,2,5,1,1,0,5,6,1,1,0,1
S01012474,Very bad health,15,0,0,0,1,1,1,2,3,3,4,4,0,0
S01012475,All people aged 16 to 74,450,46,9,37,121,83,29,48,54,34,11,6,5,24
S01012475,Very good health,225,20,4,16,70,36,12,28,22,12,7,4,3,18
S01012475,Good health,167,20,3,17,43,33,14,13,23,16,2,1,1,3
S01012475,Fair health,38,3,1,2,4,11,2,6,6,3,1,0,1,2
S01012475,Bad health,16,1,0,1,3,3,1,0,3,3,1,1,0,1
S01012475,Very bad health,4,2,1,1,1,0,0,1,0,0,0,0,0,0
S01012476,All people aged 16 to 74,676,22,4,18,129,104,37,84,136,78,35,19,16,51
S01012476,Very good health,312,13,2,11,70,51,15,36,54,22,11,4,7,40
S01012476,Good health,226,9,2,7,34,41,13,25,49,33,13,6,7,9
S01012476,Fair health,91,0,0,0,22,8,5,14,23,11,6,4,2,2
S01012476,Bad health,34,0,0,0,3,4,2,7,5,10,3,3,0,0
S01012476,Very bad health,13,0,0,0,0,0,2,2,5,2,2,2,0,0
S01012477,All people aged 16 to 74,524,54,13,41,140,101,31,45,68,40,6,4,2,39
S01012477,Very good health,287,32,7,25,84,52,17,20,36,15,1,1,0,30
S01012477,Good health,183,16,5,11,46,38,11,16,25,20,4,2,2,7
S01012477,Fair health,44,5,1,4,8,9,2,8,7,2,1,1,0,2
S01012477,Bad health,10,1,0,1,2,2,1,1,0,3,0,0,0,0
S01012477,Very bad health,0,0,0,0,0,0,0,0,0,0,0,0,0,0
S01012478,All people aged 16 to 74,607,27,8,19,106,94,44,59,129,84,16,10,6,48
S01012478,Very good health,297,13,3,10,66,43,20,24,55,29,7,4,3,40
S01012478,Good health,207,9,3,6,33,39,15,21,48,29,6,3,3,7
S01012478,Fair health,75,3,0,3,5,8,7,11,17,21,2,2,0,1
S01012478,Bad health,20,0,0,0,2,4,1,3,6,3,1,1,0,0
S01012478,Very bad health,8,2,2,0,0,0,1,0,3,2,0,0,0,0
S01012479,All people aged 16 to 74,533,57,11,46,140,80,42,52,66,45,6,3,3,45
S01012479,Very good health,280,31,5,26,73,37,20,25,35,23,2,2,0,34
S01012479,Good health,205,21,5,16,52,33,20,24,27,18,3,0,3,7
S01012479,Fair health,35,3,1,2,10,7,2,3,4,2,1,1,0,3
S01012479,Bad health,12,2,0,2,5,2,0,0,0,2,0,0,0,1
S01012479,Very bad health,1,0,0,0,0,1,0,0,0,0,0,0,0,0
S01012480,All people aged 16 to 74,450,52,14,38,105,46,29,42,57,54,18,10,8,47
S01012480,Very good health,226,25,9,16,60,33,14,16,18,19,6,2,4,35
S01012480,Good health,124,14,3,11,31,6,11,13,21,18,3,2,1,7
S01012480,Fair health,56,6,2,4,11,5,3,7,6,9,4,2,2,5
S01012480,Bad health,38,5,0,5,3,2,1,6,11,6,4,3,1,0
S01012480,Very bad health,6,2,0,2,0,0,0,0,1,2,1,1,0,0
S01012481,All people aged 16 to 74,671,55,10,45,147,76,42,61,101,74,55,39,16,60
S01012481,Very good health,331,30,4,26,91,40,23,28,38,18,21,17,4,42
S01012481,Good health,225,17,4,13,46,26,7,25,42,32,17,9,8,13
S01012481,Fair health,76,6,2,4,5,4,7,7,14,15,13,9,4,5
S01012481,Bad health,29,1,0,1,4,4,4,0,5,7,4,4,0,0
S01012481,Very bad health,10,1,0,1,1,2,1,1,2,2,0,0,0,0
S01012482,All people aged 16 to 74,561,67,17,50,136,63,66,39,68,39,46,29,17,37
S01012482,Very good health,256,34,7,27,68,27,34,13,25,15,13,10,3,27
S01012482,Good health,197,24,6,18,51,24,15,15,27,14,19,8,11,8
S01012482,Fair health,83,8,4,4,13,8,14,9,10,8,11,8,3,2
S01012482,Bad health,19,1,0,1,3,1,3,2,4,2,3,3,0,0
S01012482,Very bad health,6,0,0,0,1,3,0,0,2,0,0,0,0,0
S01012483,All people aged 16 to 74,698,42,14,28,139,52,48,68,132,99,54,32,22,64
S01012483,Very good health,290,25,6,19,67,21,22,17,43,32,19,10,9,44
S01012483,Good health,239,12,5,7,44,18,16,33,55,27,19,10,9,15
S01012483,Fair health,113,5,3,2,21,7,5,7,23,30,11,8,3,4
S01012483,Bad health,41,0,0,0,5,4,4,9,7,8,3,2,1,1
S01012483,Very bad health,15,0,0,0,2,2,1,2,4,2,2,2,0,0
S01012484,All people aged 16 to 74,579,102,27,75,188,66,62,31,48,22,22,15,7,38
S01012484,Very good health,332,67,17,50,111,35,31,17,27,11,5,1,4,28
S01012484,Good health,146,21,8,13,48,18,21,6,12,4,9,6,3,7
S01012484,Fair health,76,12,2,10,24,10,8,6,7,2,5,5,0,2
S01012484,Bad health,20,1,0,1,4,3,1,1,2,5,2,2,0,1
S01012484,Very bad health,5,1,0,1,1,0,1,1,0,0,1,1,0,0
S01012485,All people aged 16 to 74,588,112,20,92,211,71,62,27,45,16,16,11,5,28
S01012485,Very good health,339,72,17,55,112,41,37,16,28,7,7,4,3,19
S01012485,Good health,196,31,2,29,79,25,20,8,12,6,7,5,2,8
S01012485,Fair health,37,8,1,7,13,3,4,1,4,3,1,1,0,0
S01012485,Bad health,14,1,0,1,6,2,1,1,1,0,1,1,0,1
S01012485,Very bad health,2,0,0,0,1,0,0,1,0,0,0,0,0,0
S01012486,All people aged 16 to 74,368,72,22,50,123,44,40,14,32,11,7,6,1,25
S01012486,Very good health,188,42,12,30,65,27,16,4,10,5,2,1,1,17
S01012486,Good health,130,20,8,12,45,10,19,9,14,3,2,2,0,8
S01012486,Fair health,35,9,2,7,9,3,3,1,4,3,3,3,0,0
S01012486,Bad health,10,1,0,1,1,3,2,0,3,0,0,0,0,0
S01012486,Very bad health,5,0,0,0,3,1,0,0,1,0,0,0,0,0
S01012487,All people aged 16 to 74,476,24,6,18,88,55,42,46,85,88,20,12,8,28
S01012487,Very good health,211,16,4,12,47,28,17,18,31,29,5,2,3,20
S01012487,Good health,175,8,2,6,31,17,19,20,30,38,6,2,4,6
S01012487,Fair health,52,0,0,0,5,9,3,4,14,13,3,2,1,1
S01012487,Bad health,28,0,0,0,4,1,3,4,8,4,3,3,0,1
S01012487,Very bad health,10,0,0,0,1,0,0,0,2,4,3,3,0,0
S01012488,All people aged 16 to 74,693,32,7,25,146,110,46,68,132,84,36,22,14,39
S01012488,Very good health,296,20,4,16,71,48,20,30,44,26,9,4,5,28
S01012488,Good health,247,10,3,7,51,41,17,22,58,29,8,4,4,11
S01012488,Fair health,93,2,0,2,21,15,4,9,16,16,10,6,4,0
S01012488,Bad health,43,0,0,0,2,4,4,4,12,9,8,7,1,0
S01012488,Very bad health,14,0,0,0,1,2,1,3,2,4,1,1,0,0
S01012489,All people aged 16 to 74,801,17,1,16,109,56,44,111,172,165,84,53,31,43
S01012489,Very good health,317,8,0,8,52,23,19,35,73,53,27,19,8,27
S01012489,Good health,262,8,1,7,41,21,10,32,49,67,23,12,11,11
S01012489,Fair health,143,1,0,1,9,9,11,22,37,27,24,13,11,3
S01012489,Bad health,66,0,0,0,5,2,4,16,10,17,10,9,1,2
S01012489,Very bad health,13,0,0,0,2,1,0,6,3,1,0,0,0,0
S01012490,All people aged 16 to 74,779,33,5,28,126,81,37,94,140,147,76,44,32,45
S01012490,Very good health,316,17,2,15,54,40,21,30,54,44,25,12,13,31
S01012490,Good health,236,7,1,6,49,27,3,28,42,43,27,14,13,10
S01012490,Fair health,124,4,2,2,16,9,6,21,26,29,10,8,2,3
S01012490,Bad health,80,3,0,3,6,5,5,11,13,23,13,9,4,1
S01012490,Very bad health,23,2,0,2,1,0,2,4,5,8,1,1,0,0
S01012491,All people aged 16 to 74,343,7,2,5,27,28,12,34,74,88,53,30,23,20
S01012491,Very good health,136,7,2,5,14,15,6,10,28,23,20,15,5,13
S01012491,Good health,116,0,0,0,7,7,4,12,25,38,17,3,14,6
S01012491,Fair health,58,0,0,0,5,3,2,6,16,15,10,6,4,1
S01012491,Bad health,28,0,0,0,1,2,0,5,5,10,5,5,0,0
S01012491,Very bad health,5,0,0,0,0,1,0,1,0,2,1,1,0,0
S01012492,All people aged 16 to 74,631,10,5,5,69,58,32,77,130,106,87,51,36,62
S01012492,Very good health,214,4,2,2,30,21,9,29,30,24,21,9,12,46
S01012492,Good health,193,3,1,2,24,17,11,19,46,36,24,12,12,13
S01012492,Fair health,142,1,1,0,9,12,8,11,39,28,31,20,11,3
S01012492,Bad health,52,1,0,1,4,7,0,15,7,13,5,4,1,0
S01012492,Very bad health,30,1,1,0,2,1,4,3,8,5,6,6,0,0
S01012493,All people aged 16 to 74,463,33,5,28,104,51,33,35,73,85,19,15,4,30
S01012493,Very good health,177,20,2,18,56,19,9,14,21,7,6,4,2,25
S01012493,Good health,132,7,2,5,32,18,13,7,20,23,7,6,1,5
S01012493,Fair health,91,3,1,2,12,9,6,8,20,28,5,4,1,0
S01012493,Bad health,54,2,0,2,3,5,5,4,10,24,1,1,0,0
S01012493,Very bad health,9,1,0,1,1,0,0,2,2,3,0,0,0,0
S01012494,All people aged 16 to 74,720,12,4,8,108,66,40,76,145,119,25,13,12,129
S01012494,Very good health,323,6,1,5,55,34,15,27,61,34,10,4,6,81
S01012494,Good health,267,4,2,2,37,16,17,28,60,55,9,6,3,41
S01012494,Fair health,95,2,1,1,12,13,6,15,18,20,4,1,3,5
S01012494,Bad health,27,0,0,0,1,3,2,4,5,8,2,2,0,2
S01012494,Very bad health,8,0,0,0,3,0,0,2,1,2,0,0,0,0
S01012495,All people aged 16 to 74,757,12,4,8,107,100,40,69,161,152,58,31,27,58
S01012495,Very good health,324,8,3,5,53,45,15,32,62,54,20,9,11,35
S01012495,Good health,264,4,1,3,35,29,16,27,63,50,23,12,11,17
S01012495,Fair health,99,0,0,0,12,16,4,7,21,28,6,5,1,5
S01012495,Bad health,56,0,0,0,6,9,4,1,13,16,6,2,4,1
S01012495,Very bad health,14,0,0,0,1,1,1,2,2,4,3,3,0,0
S01012496,All people aged 16 to 74,571,14,7,7,57,54,28,62,131,120,54,41,13,51
S01012496,Very good health,233,7,4,3,27,21,15,28,52,37,15,10,5,31
S01012496,Good health,198,3,1,2,20,23,8,24,49,38,19,13,6,14
S01012496,Fair health,90,4,2,2,6,9,4,5,18,26,13,12,1,5
S01012496,Bad health,31,0,0,0,1,1,0,3,7,16,3,2,1,0
S01012496,Very bad health,19,0,0,0,3,0,1,2,5,3,4,4,0,1
S01012497,All people aged 16 to 74,378,5,2,3,32,26,17,48,87,102,35,25,10,26
S01012497,Very good health,127,2,1,1,13,10,3,21,34,18,7,5,2,19
S01012497,Good health,140,2,0,2,14,9,10,14,26,47,13,6,7,5
S01012497,Fair health,67,1,1,0,4,7,3,8,16,19,7,6,1,2
S01012497,Bad health,34,0,0,0,1,0,0,4,9,12,8,8,0,0
S01012497,Very bad health,10,0,0,0,0,0,1,1,2,6,0,0,0,0
S01012498,All people aged 16 to 74,592,8,3,5,48,38,26,65,141,139,73,45,28,54
S01012498,Very good health,231,3,0,3,21,10,7,24,56,42,31,17,14,37
S01012498,Good health,200,5,3,2,11,21,10,24,44,54,23,12,11,8
S01012498,Fair health,104,0,0,0,10,2,4,7,28,31,13,10,3,9
S01012498,Bad health,47,0,0,0,6,4,5,10,9,10,3,3,0,0
S01012498,Very bad health,10,0,0,0,0,1,0,0,4,2,3,3,0,0
S01012499,All people aged 16 to 74,499,21,7,14,47,62,30,52,111,88,46,30,16,42
S01012499,Very good health,230,14,4,10,18,28,11,26,46,35,18,11,7,34
S01012499,Good health,156,5,1,4,22,19,13,17,40,26,8,5,3,6
S01012499,Fair health,72,2,2,0,5,9,4,8,13,16,13,8,5,2
S01012499,Bad health,35,0,0,0,1,5,1,1,10,10,7,6,1,0
S01012499,Very bad health,6,0,0,0,1,1,1,0,2,1,0,0,0,0
S01012500,All people aged 16 to 74,347,2,1,1,41,33,19,33,67,100,31,19,12,21
S01012500,Very good health,125,0,0,0,18,14,8,5,20,33,13,9,4,14
S01012500,Good health,139,1,0,1,14,14,7,16,32,41,10,5,5,4
S01012500,Fair health,59,1,1,0,4,4,2,10,13,16,6,3,3,3
S01012500,Bad health,22,0,0,0,5,1,2,1,2,9,2,2,0,0
S01012500,Very bad health,2,0,0,0,0,0,0,1,0,1,0,0,0,0
S01012501,All people aged 16 to 74,428,6,2,4,38,22,5,51,109,104,62,36,26,31
S01012501,Very good health,161,1,0,1,18,4,1,17,48,34,23,15,8,15
S01012501,Good health,134,4,2,2,10,9,1,16,32,30,23,9,14,9
S01012501,Fair health,85,0,0,0,7,7,3,9,21,24,9,5,4,5
S01012501,Bad health,34,1,0,1,2,2,0,7,4,11,5,5,0,2
S01012501,Very bad health,14,0,0,0,1,0,0,2,4,5,2,2,0,0
S01012502,All people aged 16 to 74,574,6,0,6,48,35,31,42,139,137,89,58,31,47
S01012502,Very good health,236,2,0,2,27,15,12,14,53,50,30,22,8,33
S01012502,Good health,200,4,0,4,12,14,10,18,50,48,31,16,15,13
S01012502,Fair health,78,0,0,0,6,6,3,4,21,20,18,10,8,0
S01012502,Bad health,43,0,0,0,3,0,3,5,11,15,6,6,0,0
S01012502,Very bad health,17,0,0,0,0,0,3,1,4,4,4,4,0,1
S01012503,All people aged 16 to 74,467,10,1,9,47,38,25,60,107,109,40,23,17,31
S01012503,Very good health,164,7,1,6,16,17,10,19,34,26,12,8,4,23
S01012503,Good health,161,2,0,2,19,12,8,24,42,39,10,3,7,5
S01012503,Fair health,95,0,0,0,8,5,5,12,23,29,12,6,6,1
S01012503,Bad health,34,1,0,1,3,3,1,5,5,10,5,5,0,1
S01012503,Very bad health,13,0,0,0,1,1,1,0,3,5,1,1,0,1
S01012504,All people aged 16 to 74,446,10,3,7,52,43,21,53,105,90,38,12,26,34
S01012504,Very good health,183,4,1,3,17,19,5,21,39,33,17,5,12,28
S01012504,Good health,151,3,2,1,22,17,10,17,39,25,12,4,8,6
S01012504,Fair health,70,2,0,2,5,6,4,9,19,19,6,0,6,0
S01012504,Bad health,29,0,0,0,6,1,2,4,4,11,1,1,0,0
S01012504,Very bad health,13,1,0,1,2,0,0,2,4,2,2,2,0,0
S01012505,All people aged 16 to 74,783,22,10,12,110,96,50,83,170,142,67,38,29,43
S01012505,Very good health,311,15,9,6,55,40,18,34,55,39,21,8,13,34
S01012505,Good health,269,5,1,4,41,43,18,22,64,46,22,13,9,8
S01012505,Fair health,124,1,0,1,9,10,11,12,29,36,16,10,6,0
S01012505,Bad health,60,1,0,1,4,2,2,12,18,13,7,6,1,1
S01012505,Very bad health,19,0,0,0,1,1,1,3,4,8,1,1,0,0
S01012506,All people aged 16 to 74,360,24,5,19,82,51,28,37,65,32,13,7,6,28
S01012506,Very good health,179,19,4,15,45,24,13,16,26,11,3,2,1,22
S01012506,Good health,114,4,1,3,25,17,12,8,23,11,8,4,4,6
S01012506,Fair health,46,1,0,1,8,7,3,10,11,5,1,0,1,0
S01012506,Bad health,17,0,0,0,3,2,0,2,5,4,1,1,0,0
S01012506,Very bad health,4,0,0,0,1,1,0,1,0,1,0,0,0,0
S01012507,All people aged 16 to 74,730,31,8,23,154,97,45,79,150,95,50,31,19,29
S01012507,Very good health,307,13,3,10,78,42,16,36,51,35,12,5,7,24
S01012507,Good health,258,11,1,10,47,35,16,26,58,39,22,12,10,4
S01012507,Fair health,115,3,2,1,24,16,6,11,31,12,12,10,2,0
S01012507,Bad health,38,0,0,0,5,4,5,4,9,7,3,3,0,1
S01012507,Very bad health,12,4,2,2,0,0,2,2,1,2,1,1,0,0
S01012508,All people aged 16 to 74,558,33,6,27,103,72,32,60,114,73,38,20,18,33
S01012508,Very good health,254,19,3,16,62,33,14,27,40,19,12,3,9,28
S01012508,Good health,190,13,3,10,33,29,14,22,47,20,9,4,5,3
S01012508,Fair health,75,0,0,0,8,9,4,6,16,18,12,8,4,2
S01012508,Bad health,31,1,0,1,0,1,0,2,11,13,3,3,0,0
S01012508,Very bad health,8,0,0,0,0,0,0,3,0,3,2,2,0,0
S01012509,All people aged 16 to 74,401,29,4,25,97,56,39,36,67,40,11,7,4,26
S01012509,Very good health,206,15,1,14,55,24,22,18,29,17,4,2,2,22
S01012509,Good health,128,8,2,6,28,20,14,11,25,13,5,3,2,4
S01012509,Fair health,48,5,1,4,10,11,2,5,10,3,2,2,0,0
S01012509,Bad health,15,1,0,1,4,0,1,1,2,6,0,0,0,0
S01012509,Very bad health,4,0,0,0,0,1,0,1,1,1,0,0,0,0
S01012510,All people aged 16 to 74,659,30,6,24,159,110,35,72,106,78,32,17,15,37
S01012510,Very good health,336,22,5,17,90,53,20,42,42,32,7,6,1,28
S01012510,Good health,208,6,1,5,46,42,9,21,39,27,9,4,5,9
S01012510,Fair health,81,2,0,2,17,13,4,7,19,9,10,4,6,0
S01012510,Bad health,22,0,0,0,4,1,0,2,5,6,4,2,2,0
S01012510,Very bad health,12,0,0,0,2,1,2,0,1,4,2,1,1,0
S01012511,All people aged 16 to 74,514,29,5,24,109,88,26,49,103,55,12,11,1,43
S01012511,Very good health,236,12,2,10,53,42,7,30,42,16,3,3,0,31
S01012511,Good health,178,13,2,11,42,31,12,11,33,21,4,3,1,11
S01012511,Fair health,72,4,1,3,8,13,5,4,21,13,3,3,0,1
S01012511,Bad health,17,0,0,0,3,1,2,2,6,2,1,1,0,0
S01012511,Very bad health,11,0,0,0,3,1,0,2,1,3,1,1,0,0
S01012512,All people aged 16 to 74,480,37,13,24,88,51,39,48,86,53,54,37,17,24
S01012512,Very good health,253,25,9,16,52,19,17,28,42,24,26,17,9,20
S01012512,Good health,148,10,3,7,27,25,16,8,28,18,15,9,6,1
S01012512,Fair health,54,2,1,1,7,5,4,8,12,5,10,9,1,1
S01012512,Bad health,20,0,0,0,2,2,2,2,2,5,3,2,1,2
S01012512,Very bad health,5,0,0,0,0,0,0,2,2,1,0,0,0,0
S01012513,All people aged 16 to 74,423,36,10,26,119,75,24,40,71,23,10,8,2,25
S01012513,Very good health,226,18,5,13,66,46,8,21,37,7,2,2,0,21
S01012513,Good health,154,15,5,10,46,24,14,14,22,11,4,4,0,4
S01012513,Fair health,34,1,0,1,6,4,2,4,11,4,2,1,1,0
S01012513,Bad health,8,2,0,2,1,1,0,1,1,1,1,0,1,0
S01012513,Very bad health,1,0,0,0,0,0,0,0,0,0,1,1,0,0
S01012514,All people aged 16 to 74,719,68,11,57,212,125,42,65,86,46,14,7,7,61
S01012514,Very good health,457,49,9,40,135,81,28,39,47,17,8,3,5,53
S01012514,Good health,199,16,2,14,59,33,10,22,29,21,3,1,2,6
S01012514,Fair health,48,3,0,3,14,8,3,3,8,6,2,2,0,1
S01012514,Bad health,12,0,0,0,3,2,1,1,2,2,0,0,0,1
S01012514,Very bad health,3,0,0,0,1,1,0,0,0,0,1,1,0,0
S01012515,All people aged 16 to 74,434,18,5,13,70,65,36,40,94,65,15,9,6,31
S01012515,Very good health,182,13,2,11,25,31,16,12,31,25,5,4,1,24
S01012515,Good health,138,5,3,2,27,20,10,15,36,15,7,4,3,3
S01012515,Fair health,72,0,0,0,12,8,4,7,22,14,2,0,2,3
S01012515,Bad health,32,0,0,0,6,4,2,4,5,10,1,1,0,0
S01012515,Very bad health,10,0,0,0,0,2,4,2,0,1,0,0,0,1
S01012516,All people aged 16 to 74,466,35,7,28,107,62,27,51,79,53,21,13,8,31
S01012516,Very good health,219,24,5,19,55,36,11,22,23,18,5,3,2,25
S01012516,Good health,174,9,2,7,37,20,13,20,39,21,9,7,2,6
S01012516,Fair health,48,2,0,2,9,5,1,5,14,6,6,2,4,0
S01012516,Bad health,18,0,0,0,5,1,1,2,3,5,1,1,0,0
S01012516,Very bad health,7,0,0,0,1,0,1,2,0,3,0,0,0,0
S01012517,All people aged 16 to 74,640,33,7,26,144,72,40,74,122,70,41,22,19,44
S01012517,Very good health,289,19,3,16,71,29,15,25,49,29,17,6,11,35
S01012517,Good health,221,11,3,8,56,25,13,32,44,21,11,8,3,8
S01012517,Fair health,86,1,1,0,10,15,9,15,18,11,6,2,4,1
S01012517,Bad health,38,2,0,2,7,3,3,2,11,4,6,5,1,0
S01012517,Very bad health,6,0,0,0,0,0,0,0,0,5,1,1,0,0
S01012518,All people aged 16 to 74,428,50,8,42,129,57,36,34,40,28,17,8,9,37
S01012518,Very good health,238,28,4,24,70,32,19,19,21,13,6,3,3,30
S01012518,Good health,135,17,3,14,43,17,13,12,13,10,6,2,4,4
S01012518,Fair health,33,4,1,3,9,5,3,1,3,1,4,2,2,3
S01012518,Bad health,17,1,0,1,6,2,1,1,1,4,1,1,0,0
S01012518,Very bad health,5,0,0,0,1,1,0,1,2,0,0,0,0,0
S01012519,All people aged 16 to 74,386,22,5,17,93,56,43,50,45,40,15,8,7,22
S01012519,Very good health,176,9,2,7,48,26,19,22,17,14,5,3,2,16
S01012519,Good health,139,12,3,9,33,24,15,15,15,15,6,3,3,4
S01012519,Fair health,49,1,0,1,10,4,8,7,9,7,2,0,2,1
S01012519,Bad health,14,0,0,0,1,2,1,4,2,2,1,1,0,1
S01012519,Very bad health,8,0,0,0,1,0,0,2,2,2,1,1,0,0
S01012520,All people aged 16 to 74,564,84,17,67,176,69,44,43,59,26,17,11,6,46
S01012520,Very good health,335,48,12,36,112,42,23,28,25,10,8,2,6,39
S01012520,Good health,165,31,5,26,49,19,14,12,22,9,3,3,0,6
S01012520,Fair health,45,4,0,4,12,5,6,2,8,5,2,2,0,1
S01012520,Bad health,12,1,0,1,1,3,0,1,2,1,3,3,0,0
S01012520,Very bad health,7,0,0,0,2,0,1,0,2,1,1,1,0,0
S01012521,All people aged 16 to 74,371,46,6,40,95,51,33,39,52,28,11,6,5,16
S01012521,Very good health,211,31,6,25,54,33,21,17,26,12,3,1,2,14
S01012521,Good health,111,14,0,14,33,9,8,17,17,8,4,1,3,1
S01012521,Fair health,36,1,0,1,6,7,4,2,5,7,3,3,0,1
S01012521,Bad health,12,0,0,0,1,2,0,3,4,1,1,1,0,0
S01012521,Very bad health,1,0,0,0,1,0,0,0,0,0,0,0,0,0
S01012522,All people aged 16 to 74,651,85,14,71,199,91,75,51,61,32,12,6,6,45
S01012522,Very good health,351,55,7,48,102,48,36,25,26,15,5,3,2,39
S01012522,Good health,214,24,6,18,76,27,29,19,27,5,3,1,2,4
S01012522,Fair health,63,3,0,3,18,10,9,4,5,9,3,1,2,2
S01012522,Bad health,16,1,0,1,3,5,0,2,2,2,1,1,0,0
S01012522,Very bad health,7,2,1,1,0,1,1,1,1,1,0,0,0,0
S01012523,All people aged 16 to 74,638,64,7,57,176,102,42,54,84,45,21,12,9,50
S01012523,Very good health,354,39,6,33,100,56,25,30,41,17,6,4,2,40
S01012523,Good health,187,17,1,16,52,37,11,13,30,12,7,5,2,8
S01012523,Fair health,76,8,0,8,19,7,3,7,12,12,6,2,4,2
S01012523,Bad health,18,0,0,0,5,2,3,2,0,4,2,1,1,0
S01012523,Very bad health,3,0,0,0,0,0,0,2,1,0,0,0,0,0
S01012524,All people aged 16 to 74,630,61,18,43,190,106,53,59,78,32,16,11,5,35
S01012524,Very good health,313,37,5,32,100,56,23,28,32,11,1,0,1,25
S01012524,Good health,229,17,10,7,59,42,21,20,36,16,10,9,1,8
S01012524,Fair health,59,4,1,3,26,5,6,7,3,2,4,2,2,2
S01012524,Bad health,26,3,2,1,4,3,2,4,6,3,1,0,1,0
S01012524,Very bad health,3,0,0,0,1,0,1,0,1,0,0,0,0,0
S01012525,All people aged 16 to 74,564,50,10,40,175,92,41,54,65,36,16,7,9,35
S01012525,Very good health,295,25,3,22,104,47,21,24,24,15,7,1,6,28
S01012525,Good health,196,18,5,13,56,31,14,21,31,13,7,4,3,5
S01012525,Fair health,65,6,2,4,15,12,6,7,9,8,2,2,0,0
S01012525,Bad health,7,1,0,1,0,1,0,2,1,0,0,0,0,2
S01012525,Very bad health,1,0,0,0,0,1,0,0,0,0,0,0,0,0
S01012526,All people aged 16 to 74,574,85,14,71,214,80,43,35,54,18,6,2,4,39
S01012526,Very good health,316,47,7,40,120,42,20,16,25,6,3,0,3,37
S01012526,Good health,191,32,6,26,73,31,14,10,21,7,1,1,0,2
S01012526,Fair health,50,6,1,5,14,6,7,6,5,4,2,1,1,0
S01012526,Bad health,14,0,0,0,5,1,1,3,3,1,0,0,0,0
S01012526,Very bad health,3,0,0,0,2,0,1,0,0,0,0,0,0,0
S01012527,All people aged 16 to 74,448,43,10,33,119,71,38,37,71,43,12,9,3,14
S01012527,Very good health,224,23,5,18,70,38,15,16,30,15,5,4,1,12
S01012527,Good health,159,16,5,11,35,20,19,13,33,19,2,1,1,2
S01012527,Fair health,53,4,0,4,13,9,2,6,7,7,5,4,1,0
S01012527,Bad health,9,0,0,0,0,3,2,1,1,2,0,0,0,0
S01012527,Very bad health,3,0,0,0,1,1,0,1,0,0,0,0,0,0
S01012528,All people aged 16 to 74,616,32,6,26,87,67,31,81,129,109,31,24,7,49
S01012528,Very good health,297,19,5,14,42,39,13,32,54,48,10,8,2,40
S01012528,Good health,198,12,1,11,25,20,10,33,47,34,10,9,1,7
S01012528,Fair health,83,1,0,1,13,5,4,13,23,17,5,4,1,2
S01012528,Bad health,32,0,0,0,6,2,4,0,5,9,6,3,3,0
S01012528,Very bad health,6,0,0,0,1,1,0,3,0,1,0,0,0,0
S01012529,All people aged 16 to 74,539,39,10,29,136,60,25,58,89,73,17,11,6,42
S01012529,Very good health,282,17,3,14,88,33,8,24,43,29,7,4,3,33
S01012529,Good health,169,14,3,11,36,20,13,22,30,26,4,2,2,4
S01012529,Fair health,62,8,4,4,10,3,3,8,11,12,4,3,1,3
S01012529,Bad health,20,0,0,0,1,4,0,2,4,6,2,2,0,1
S01012529,Very bad health,6,0,0,0,1,0,1,2,1,0,0,0,0,1
S01012530,All people aged 16 to 74,608,49,13,36,156,122,37,64,71,54,17,8,9,38
S01012530,Very good health,321,27,8,19,90,66,17,33,26,24,7,4,3,31
S01012530,Good health,218,17,5,12,49,45,14,26,34,24,4,1,3,5
S01012530,Fair health,56,5,0,5,10,9,6,4,9,5,6,3,3,2
S01012530,Bad health,11,0,0,0,6,2,0,1,2,0,0,0,0,0
S01012530,Very bad health,2,0,0,0,1,0,0,0,0,1,0,0,0,0
S01012531,All people aged 16 to 74,566,79,20,59,130,76,51,49,67,55,25,20,5,34
S01012531,Very good health,288,43,10,33,75,36,29,24,23,20,13,11,2,25
S01012531,Good health,191,23,7,16,41,30,16,15,31,22,7,4,3,6
S01012531,Fair health,70,13,3,10,12,5,4,8,12,10,3,3,0,3
S01012531,Bad health,10,0,0,0,1,1,2,2,1,2,1,1,0,0
S01012531,Very bad health,7,0,0,0,1,4,0,0,0,1,1,1,0,0
S01012532,All people aged 16 to 74,597,40,14,26,132,77,69,61,102,63,15,7,8,38
S01012532,Very good health,298,28,9,19,68,40,31,26,49,19,8,4,4,29
S01012532,Good health,180,9,3,6,45,21,25,19,30,20,3,1,2,8
S01012532,Fair health,78,3,2,1,12,11,10,6,15,17,3,1,2,1
S01012532,Bad health,30,0,0,0,5,4,2,7,6,6,0,0,0,0
S01012532,Very bad health,11,0,0,0,2,1,1,3,2,1,1,1,0,0
S01012533,All people aged 16 to 74,420,32,8,24,105,64,29,47,63,40,13,7,6,27
S01012533,Very good health,212,16,4,12,64,32,13,26,22,11,5,2,3,23
S01012533,Good health,158,14,3,11,33,26,11,12,28,25,5,3,2,4
S01012533,Fair health,37,2,1,1,5,6,2,8,10,3,1,0,1,0
S01012533,Bad health,7,0,0,0,2,0,1,1,1,0,2,2,0,0
S01012533,Very bad health,6,0,0,0,1,0,2,0,2,1,0,0,0,0
S01012534,All people aged 16 to 74,421,15,5,10,88,65,20,46,77,66,25,17,8,19
S01012534,Very good health,198,12,4,8,48,34,11,22,29,22,4,2,2,16
S01012534,Good health,132,3,1,2,23,19,5,17,32,19,12,6,6,2
S01012534,Fair health,60,0,0,0,12,8,4,6,12,12,5,5,0,1
S01012534,Bad health,23,0,0,0,3,3,0,1,2,10,4,4,0,0
S01012534,Very bad health,8,0,0,0,2,1,0,0,2,3,0,0,0,0
S01012535,All people aged 16 to 74,626,13,4,9,94,71,38,79,137,131,18,9,9,45
S01012535,Very good health,313,7,2,5,52,39,18,41,58,59,7,3,4,32
S01012535,Good health,197,4,1,3,33,18,16,24,48,38,7,3,4,9
S01012535,Fair health,78,2,1,1,2,12,3,9,22,22,2,2,0,4
S01012535,Bad health,24,0,0,0,3,1,1,2,7,8,2,1,1,0
S01012535,Very bad health,14,0,0,0,4,1,0,3,2,4,0,0,0,0
S01012536,All people aged 16 to 74,576,19,4,15,83,65,50,49,110,111,32,20,12,57
S01012536,Very good health,281,13,4,9,42,29,26,19,49,42,13,10,3,48
S01012536,Good health,196,5,0,5,25,27,19,17,45,42,10,5,5,6
S01012536,Fair health,64,0,0,0,8,6,2,9,10,18,8,4,4,3
S01012536,Bad health,30,1,0,1,6,2,3,4,5,9,0,0,0,0
S01012536,Very bad health,5,0,0,0,2,1,0,0,1,0,1,1,0,0
S01012537,All people aged 16 to 74,620,13,3,10,70,54,35,65,114,127,37,15,22,105
S01012537,Very good health,277,4,2,2,28,26,16,25,41,47,16,7,9,74
S01012537,Good health,193,6,0,6,25,18,9,22,41,34,11,3,8,27
S01012537,Fair health,95,1,0,1,12,4,8,10,22,29,5,2,3,4
S01012537,Bad health,40,2,1,1,5,3,2,4,6,13,5,3,2,0
S01012537,Very bad health,15,0,0,0,0,3,0,4,4,4,0,0,0,0
S01012538,All people aged 16 to 74,791,36,15,21,115,92,63,97,162,131,44,24,20,51
S01012538,Very good health,346,16,8,8,58,57,27,35,61,48,6,2,4,38
S01012538,Good health,269,14,5,9,34,25,20,39,68,41,20,9,11,8
S01012538,Fair health,108,4,2,2,13,7,14,11,21,24,10,8,2,4
S01012538,Bad health,54,0,0,0,8,2,2,7,10,16,8,5,3,1
S01012538,Very bad health,14,2,0,2,2,1,0,5,2,2,0,0,0,0
S01012539,All people aged 16 to 74,523,29,8,21,85,55,77,50,101,75,21,13,8,30
S01012539,Very good health,237,13,3,10,48,24,43,17,41,26,9,6,3,16
S01012539,Good health,180,10,4,6,21,23,26,22,33,28,6,3,3,11
S01012539,Fair health,71,5,1,4,9,7,7,8,16,14,3,1,2,2
S01012539,Bad health,26,1,0,1,6,1,0,3,8,4,2,2,0,1
S01012539,Very bad health,9,0,0,0,1,0,1,0,3,3,1,1,0,0
S01012540,All people aged 16 to 74,528,15,2,13,44,50,38,60,130,121,35,22,13,35
S01012540,Very good health,217,4,0,4,25,21,18,33,49,32,10,4,6,25
S01012540,Good health,190,6,1,5,11,20,14,14,55,50,12,9,3,8
S01012540,Fair health,80,5,1,4,5,6,5,8,17,24,8,5,3,2
S01012540,Bad health,29,0,0,0,3,2,1,3,6,10,4,3,1,0
S01012540,Very bad health,12,0,0,0,0,1,0,2,3,5,1,1,0,0
S01012541,All people aged 16 to 74,808,53,13,40,139,85,137,61,153,97,30,18,12,53
S01012541,Very good health,408,33,7,26,85,38,68,34,67,29,11,8,3,43
S01012541,Good health,267,13,3,10,41,39,48,15,58,31,15,9,6,7
S01012541,Fair health,94,2,0,2,10,5,18,9,22,22,4,1,3,2
S01012541,Bad health,27,2,1,1,1,2,2,1,5,13,0,0,0,1
S01012541,Very bad health,12,3,2,1,2,1,1,2,1,2,0,0,0,0
S01012542,All people aged 16 to 74,702,74,14,60,166,75,68,61,91,60,76,70,6,31
S01012542,Very good health,337,46,7,39,96,37,39,19,36,19,16,14,2,29
S01012542,Good health,236,21,6,15,50,24,22,32,37,22,27,23,4,1
S01012542,Fair health,94,4,0,4,16,9,4,8,12,13,27,27,0,1
S01012542,Bad health,28,3,1,2,3,4,2,2,4,6,4,4,0,0
S01012542,Very bad health,7,0,0,0,1,1,1,0,2,0,2,2,0,0
S01012543,All people aged 16 to 74,522,66,8,58,119,73,79,43,58,45,11,4,7,28
S01012543,Very good health,282,42,3,39,67,35,40,20,27,21,7,3,4,23
S01012543,Good health,174,17,5,12,43,26,25,16,26,14,3,0,3,4
S01012543,Fair health,50,6,0,6,6,10,11,4,4,7,1,1,0,1
S01012543,Bad health,15,1,0,1,3,2,3,3,1,2,0,0,0,0
S01012543,Very bad health,1,0,0,0,0,0,0,0,0,1,0,0,0,0
S01012544,All people aged 16 to 74,581,58,13,45,146,65,59,58,84,63,20,11,9,28
S01012544,Very good health,260,35,7,28,81,24,25,26,27,17,7,3,4,18
S01012544,Good health,213,18,5,13,49,26,24,14,37,29,9,5,4,7
S01012544,Fair health,82,4,1,3,12,12,9,12,13,14,3,3,0,3
S01012544,Bad health,23,1,0,1,3,1,1,6,7,3,1,0,1,0
S01012544,Very bad health,3,0,0,0,1,2,0,0,0,0,0,0,0,0
S01012545,All people aged 16 to 74,335,11,5,6,65,27,28,34,68,70,21,10,11,11
S01012545,Very good health,151,7,3,4,37,9,19,12,30,24,8,6,2,5
S01012545,Good health,123,3,2,1,19,12,6,16,27,26,9,2,7,5
S01012545,Fair health,41,1,0,1,6,4,2,3,5,16,3,1,2,1
S01012545,Bad health,14,0,0,0,2,2,0,2,5,2,1,1,0,0
S01012545,Very bad health,6,0,0,0,1,0,1,1,1,2,0,0,0,0
S01012546,All people aged 16 to 74,602,34,5,29,124,95,62,69,93,61,18,10,8,46
S01012546,Very good health,280,25,4,21,56,43,25,37,34,22,5,5,0,33
S01012546,Good health,216,7,0,7,52,37,25,17,40,24,2,0,2,12
S01012546,Fair health,64,1,0,1,13,9,10,9,6,8,8,4,4,0
S01012546,Bad health,37,1,1,0,3,5,0,6,12,6,3,1,2,1
S01012546,Very bad health,5,0,0,0,0,1,2,0,1,1,0,0,0,0
S01012547,All people aged 16 to 74,565,70,13,57,153,79,41,36,83,46,26,19,7,31
S01012547,Very good health,252,38,5,33,69,40,15,16,30,14,7,5,2,23
S01012547,Good health,213,24,7,17,63,33,18,12,29,15,11,6,5,8
S01012547,Fair health,74,6,1,5,16,5,6,6,16,12,7,7,0,0
S01012547,Bad health,19,2,0,2,3,1,1,1,5,5,1,1,0,0
S01012547,Very bad health,7,0,0,0,2,0,1,1,3,0,0,0,0,0
S01012548,All people aged 16 to 74,630,79,17,62,168,97,49,60,84,49,17,11,6,27
S01012548,Very good health,298,44,10,34,86,45,25,22,30,18,6,3,3,22
S01012548,Good health,221,26,4,22,60,34,16,23,33,21,6,4,2,2
S01012548,Fair health,85,8,3,5,16,11,8,12,17,7,4,3,1,2
S01012548,Bad health,18,0,0,0,6,7,0,1,1,2,1,1,0,0
S01012548,Very bad health,8,1,0,1,0,0,0,2,3,1,0,0,0,1
S01012549,All people aged 16 to 74,399,13,2,11,82,35,19,44,95,67,25,13,12,19
S01012549,Very good health,166,9,1,8,40,17,9,20,31,21,8,3,5,11
S01012549,Good health,143,4,1,3,31,14,7,15,39,21,7,3,4,5
S01012549,Fair health,62,0,0,0,9,2,3,6,16,14,9,6,3,3
S01012549,Bad health,23,0,0,0,1,2,0,2,9,9,0,0,0,0
S01012549,Very bad health,5,0,0,0,1,0,0,1,0,2,1,1,0,0
S01012550,All people aged 16 to 74,621,31,8,23,146,67,43,67,112,70,32,13,19,53
S01012550,Very good health,300,20,6,14,68,31,19,34,42,26,16,6,10,44
S01012550,Good health,200,7,1,6,53,20,16,23,44,22,9,3,6,6
S01012550,Fair health,82,4,1,3,17,11,7,5,17,13,5,2,3,3
S01012550,Bad health,31,0,0,0,7,3,0,5,9,7,0,0,0,0
S01012550,Very bad health,8,0,0,0,1,2,1,0,0,2,2,2,0,0
S01012551,All people aged 16 to 74,624,53,11,42,192,116,48,55,84,32,6,2,4,38
S01012551,Very good health,354,28,6,22,107,71,24,25,43,18,6,2,4,32
S01012551,Good health,194,16,5,11,61,35,17,23,28,9,0,0,0,5
S01012551,Fair health,54,6,0,6,19,5,5,5,9,4,0,0,0,1
S01012551,Bad health,21,3,0,3,4,5,2,2,4,1,0,0,0,0
S01012551,Very bad health,1,0,0,0,1,0,0,0,0,0,0,0,0,0
S01012552,All people aged 16 to 74,706,91,17,74,223,112,55,46,75,37,8,4,4,59
S01012552,Very good health,423,58,11,47,141,56,31,28,37,18,3,2,1,51
S01012552,Good health,194,26,6,20,59,38,19,9,23,12,2,0,2,6
S01012552,Fair health,74,5,0,5,17,15,5,9,13,7,3,2,1,0
S01012552,Bad health,12,2,0,2,6,1,0,0,1,0,0,0,0,2
S01012552,Very bad health,3,0,0,0,0,2,0,0,1,0,0,0,0,0
S01012553,All people aged 16 to 74,623,74,11,63,183,110,41,48,79,31,15,6,9,42
S01012553,Very good health,372,49,8,41,108,64,18,30,43,21,7,4,3,32
S01012553,Good health,191,23,3,20,59,30,17,13,29,5,6,0,6,9
S01012553,Fair health,43,1,0,1,10,13,5,3,6,3,1,1,0,1
S01012553,Bad health,11,0,0,0,4,3,1,0,1,1,1,1,0,0
S01012553,Very bad health,6,1,0,1,2,0,0,2,0,1,0,0,0,0
S01012554,All people aged 16 to 74,357,37,12,25,93,62,27,33,42,18,6,4,2,39
S01012554,Very good health,163,15,4,11,50,20,12,14,16,8,0,0,0,28
S01012554,Good health,163,21,7,14,38,36,12,14,25,6,3,2,1,8
S01012554,Fair health,25,0,0,0,4,6,2,5,1,3,1,0,1,3
S01012554,Bad health,2,0,0,0,0,0,1,0,0,1,0,0,0,0
S01012554,Very bad health,4,1,1,0,1,0,0,0,0,0,2,2,0,0
S01012555,All people aged 16 to 74,416,46,8,38,126,76,23,36,40,21,6,1,5,42
S01012555,Very good health,239,33,6,27,65,36,12,19,24,12,2,0,2,36
S01012555,Good health,139,10,2,8,48,30,9,16,11,8,1,0,1,6
S01012555,Fair health,34,3,0,3,11,8,2,1,5,1,3,1,2,0
S01012555,Bad health,3,0,0,0,1,2,0,0,0,0,0,0,0,0
S01012555,Very bad health,1,0,0,0,1,0,0,0,0,0,0,0,0,0
S01012556,All people aged 16 to 74,437,63,16,47,137,54,32,30,48,21,8,5,3,44
S01012556,Very good health,268,44,11,33,87,28,16,13,28,11,4,4,0,37
S01012556,Good health,125,14,3,11,41,20,13,11,13,7,3,1,2,3
S01012556,Fair health,38,4,2,2,9,6,1,5,7,1,1,0,1,4
S01012556,Bad health,5,1,0,1,0,0,2,0,0,2,0,0,0,0
S01012556,Very bad health,1,0,0,0,0,0,0,1,0,0,0,0,0,0
S01012557,All people aged 16 to 74,447,63,15,48,137,63,32,34,45,25,14,7,7,34
S01012557,Very good health,262,41,7,34,80,37,15,16,20,14,7,5,2,32
S01012557,Good health,139,18,8,10,40,22,14,13,19,8,3,0,3,2
S01012557,Fair health,35,4,0,4,11,3,2,5,5,1,4,2,2,0
S01012557,Bad health,9,0,0,0,4,1,1,0,1,2,0,0,0,0
S01012557,Very bad health,2,0,0,0,2,0,0,0,0,0,0,0,0,0
S01012558,All people aged 16 to 74,454,16,2,14,92,54,22,56,91,74,27,14,13,22
S01012558,Very good health,167,6,0,6,47,21,2,22,29,20,6,4,2,14
S01012558,Good health,204,8,1,7,31,26,17,23,44,36,11,4,7,8
S01012558,Fair health,57,2,1,1,11,6,2,9,12,8,7,4,3,0
S01012558,Bad health,17,0,0,0,1,1,1,1,4,7,2,2,0,0
S01012558,Very bad health,9,0,0,0,2,0,0,1,2,3,1,0,1,0
S01012559,All people aged 16 to 74,538,31,12,19,105,65,34,70,104,74,36,19,17,19
S01012559,Very good health,213,15,6,9,47,26,11,22,38,27,15,6,9,12
S01012559,Good health,188,12,4,8,37,15,14,29,38,25,11,6,5,7
S01012559,Fair health,93,2,1,1,13,15,7,18,21,13,4,4,0,0
S01012559,Bad health,34,2,1,1,5,7,2,1,7,6,4,3,1,0
S01012559,Very bad health,10,0,0,0,3,2,0,0,0,3,2,0,2,0
S01012560,All people aged 16 to 74,392,28,5,23,76,68,20,48,63,57,15,7,8,17
S01012560,Very good health,155,15,3,12,37,26,8,14,19,18,4,3,1,14
S01012560,Good health,152,10,1,9,29,30,8,16,31,19,7,2,5,2
S01012560,Fair health,58,3,1,2,6,7,3,13,10,13,3,1,2,0
S01012560,Bad health,20,0,0,0,2,4,1,3,2,7,0,0,0,1
S01012560,Very bad health,7,0,0,0,2,1,0,2,1,0,1,1,0,0
S01012561,All people aged 16 to 74,549,39,9,30,130,80,29,52,86,58,29,18,11,46
S01012561,Very good health,254,20,5,15,67,31,12,23,36,23,7,3,4,35
S01012561,Good health,188,15,4,11,44,29,12,20,31,19,10,4,6,8
S01012561,Fair health,71,2,0,2,14,14,3,5,13,10,8,7,1,2
S01012561,Bad health,30,1,0,1,5,5,2,4,4,4,4,4,0,1
S01012561,Very bad health,6,1,0,1,0,1,0,0,2,2,0,0,0,0
S01012562,All people aged 16 to 74,568,32,5,27,126,68,31,79,86,79,35,20,15,32
S01012562,Very good health,235,18,3,15,55,30,15,33,28,21,10,6,4,25
S01012562,Good health,204,9,2,7,51,27,11,32,31,24,15,5,10,4
S01012562,Fair health,89,4,0,4,16,8,5,8,19,20,6,5,1,3
S01012562,Bad health,31,1,0,1,4,2,0,4,8,9,3,3,0,0
S01012562,Very bad health,9,0,0,0,0,1,0,2,0,5,1,1,0,0
S01012563,All people aged 16 to 74,475,90,20,70,156,70,41,18,38,9,8,5,3,45
S01012563,Very good health,271,56,9,47,87,35,20,9,19,6,3,2,1,36
S01012563,Good health,159,30,9,21,56,28,14,6,13,2,2,2,0,8
S01012563,Fair health,37,4,2,2,12,6,3,3,5,1,2,0,2,1
S01012563,Bad health,6,0,0,0,0,0,4,0,1,0,1,1,0,0
S01012563,Very bad health,2,0,0,0,1,1,0,0,0,0,0,0,0,0
S01012564,All people aged 16 to 74,608,84,15,69,188,75,73,41,68,31,12,8,4,36
S01012564,Very good health,324,50,12,38,109,34,34,20,29,14,5,3,2,29
S01012564,Good health,221,29,3,26,58,34,31,12,31,13,6,4,2,7
S01012564,Fair health,45,3,0,3,18,4,5,7,6,2,0,0,0,0
S01012564,Bad health,14,2,0,2,2,3,3,1,2,1,0,0,0,0
S01012564,Very bad health,4,0,0,0,1,0,0,1,0,1,1,1,0,0
S01012565,All people aged 16 to 74,538,79,10,69,155,75,50,33,64,38,6,5,1,38
S01012565,Very good health,278,47,4,43,89,33,19,17,29,10,1,1,0,33
S01012565,Good health,182,27,5,22,49,27,21,12,23,17,3,2,1,3
S01012565,Fair health,55,3,1,2,13,12,7,2,7,9,0,0,0,2
S01012565,Bad health,19,2,0,2,2,2,3,1,5,2,2,2,0,0
S01012565,Very bad health,4,0,0,0,2,1,0,1,0,0,0,0,0,0
S01012566,All people aged 16 to 74,544,54,11,43,148,64,52,43,79,53,26,14,12,25
S01012566,Very good health,273,31,8,23,87,25,25,22,36,22,7,3,4,18
S01012566,Good health,160,18,2,16,38,27,16,12,21,14,10,6,4,4
S01012566,Fair health,78,4,1,3,17,7,11,5,14,9,8,4,4,3
S01012566,Bad health,21,0,0,0,4,2,0,2,7,5,1,1,0,0
S01012566,Very bad health,12,1,0,1,2,3,0,2,1,3,0,0,0,0
S01012567,All people aged 16 to 74,792,73,20,53,168,100,62,79,139,71,46,23,23,54
S01012567,Very good health,359,37,12,25,81,41,30,33,52,31,15,7,8,39
S01012567,Good health,281,25,6,19,60,39,23,33,48,20,19,6,13,14
S01012567,Fair health,96,7,1,6,21,14,7,8,21,9,8,7,1,1
S01012567,Bad health,46,3,0,3,6,6,2,4,14,8,3,2,1,0
S01012567,Very bad health,10,1,1,0,0,0,0,1,4,3,1,1,0,0
S01012568,All people aged 16 to 74,436,83,18,65,147,46,47,18,30,16,15,9,6,34
S01012568,Very good health,254,52,15,37,79,25,27,11,18,8,4,2,2,30
S01012568,Good health,113,26,3,23,40,13,11,5,9,2,3,2,1,4
S01012568,Fair health,49,5,0,5,23,6,7,1,1,3,3,1,2,0
S01012568,Bad health,12,0,0,0,4,2,2,1,0,1,2,1,1,0
S01012568,Very bad health,8,0,0,0,1,0,0,0,2,2,3,3,0,0
S01012569,All people aged 16 to 74,559,124,25,99,167,59,77,18,36,17,11,8,3,50
S01012569,Very good health,351,77,16,61,99,37,47,9,23,9,5,2,3,45
S01012569,Good health,155,39,6,33,53,15,21,5,9,4,4,4,0,5
S01012569,Fair health,45,7,3,4,12,6,7,3,4,4,2,2,0,0
S01012569,Bad health,7,1,0,1,2,1,2,1,0,0,0,0,0,0
S01012569,Very bad health,1,0,0,0,1,0,0,0,0,0,0,0,0,0
S01012570,All people aged 16 to 74,367,27,3,24,66,44,51,48,64,33,14,10,4,20
S01012570,Very good health,170,17,2,15,34,23,22,21,25,12,6,5,1,10
S01012570,Good health,136,7,1,6,18,13,21,16,30,16,7,4,3,8
S01012570,Fair health,42,1,0,1,9,6,6,9,7,3,0,0,0,1
S01012570,Bad health,15,2,0,2,5,2,2,2,0,1,1,1,0,0
S01012570,Very bad health,4,0,0,0,0,0,0,0,2,1,0,0,0,1
S01012571,All people aged 16 to 74,624,35,4,31,130,58,98,56,109,84,21,10,11,33
S01012571,Very good health,289,22,3,19,67,29,46,24,41,26,6,3,3,28
S01012571,Good health,215,11,1,10,43,19,41,18,42,28,8,2,6,5
S01012571,Fair health,87,2,0,2,15,7,8,12,17,20,6,5,1,0
S01012571,Bad health,25,0,0,0,4,2,3,2,8,5,1,0,1,0
S01012571,Very bad health,8,0,0,0,1,1,0,0,1,5,0,0,0,0
S01012572,All people aged 16 to 74,408,31,5,26,74,42,58,36,71,55,20,14,6,21
S01012572,Very good health,214,20,2,18,42,22,32,15,31,26,12,9,3,14
S01012572,Good health,122,9,3,6,18,14,21,13,21,17,4,3,1,5
S01012572,Fair health,50,1,0,1,10,4,5,6,12,10,1,1,0,1
S01012572,Bad health,13,1,0,1,3,2,0,1,4,0,2,1,1,0
S01012572,Very bad health,9,0,0,0,1,0,0,1,3,2,1,0,1,1
S01012573,All people aged 16 to 74,633,94,17,77,168,65,104,43,80,37,19,17,2,23
S01012573,Very good health,320,50,10,40,94,27,49,23,34,15,7,6,1,21
S01012573,Good health,225,34,6,28,57,32,40,14,26,15,5,4,1,2
S01012573,Fair health,62,9,1,8,11,4,9,3,17,3,6,6,0,0
S01012573,Bad health,18,1,0,1,4,1,4,2,3,2,1,1,0,0
S01012573,Very bad health,8,0,0,0,2,1,2,1,0,2,0,0,0,0
S01012574,All people aged 16 to 74,654,69,24,45,199,80,89,50,68,59,14,7,7,26
S01012574,Very good health,359,43,15,28,111,41,48,23,34,31,7,3,4,21
S01012574,Good health,212,19,7,12,63,29,29,19,28,18,4,1,3,3
S01012574,Fair health,59,4,2,2,17,6,10,6,6,6,2,2,0,2
S01012574,Bad health,18,2,0,2,7,2,2,2,0,2,1,1,0,0
S01012574,Very bad health,6,1,0,1,1,2,0,0,0,2,0,0,0,0
S01012575,All people aged 16 to 74,474,64,12,52,114,55,56,32,79,35,11,5,6,28
S01012575,Very good health,267,36,8,28,66,30,36,20,37,18,5,3,2,19
S01012575,Good health,153,23,4,19,41,18,16,7,28,12,2,0,2,6
S01012575,Fair health,37,4,0,4,4,2,3,3,13,3,4,2,2,1
S01012575,Bad health,7,1,0,1,2,3,0,1,0,0,0,0,0,0
S01012575,Very bad health,10,0,0,0,1,2,1,1,1,2,0,0,0,2
S01012576,All people aged 16 to 74,545,83,16,67,144,60,75,41,68,46,7,2,5,21
S01012576,Very good health,277,51,9,42,74,25,41,20,29,16,4,0,4,17
S01012576,Good health,202,26,7,19,55,23,27,15,27,25,1,1,0,3
S01012576,Fair health,50,5,0,5,13,7,5,5,8,4,2,1,1,1
S01012576,Bad health,15,1,0,1,2,5,2,1,4,0,0,0,0,0
S01012576,Very bad health,1,0,0,0,0,0,0,0,0,1,0,0,0,0
S01012577,All people aged 16 to 74,569,53,7,46,130,55,81,51,94,72,10,4,6,23
S01012577,Very good health,302,32,4,28,68,25,53,21,48,32,2,0,2,21
S01012577,Good health,204,20,2,18,50,22,25,23,34,26,3,0,3,1
S01012577,Fair health,45,1,1,0,10,6,2,5,8,9,3,2,1,1
S01012577,Bad health,11,0,0,0,2,0,1,0,2,5,1,1,0,0
S01012577,Very bad health,7,0,0,0,0,2,0,2,2,0,1,1,0,0
S01012578,All people aged 16 to 74,661,73,20,53,166,63,86,49,84,86,20,16,4,34
S01012578,Very good health,343,48,13,35,97,28,34,22,37,41,7,6,1,29
S01012578,Good health,204,22,6,16,44,25,33,15,30,26,6,4,2,3
S01012578,Fair health,89,3,1,2,21,9,15,7,13,15,4,3,1,2
S01012578,Bad health,15,0,0,0,1,1,3,2,3,3,2,2,0,0
S01012578,Very bad health,10,0,0,0,3,0,1,3,1,1,1,1,0,0
S01012579,All people aged 16 to 74,522,60,13,47,108,52,67,47,77,61,21,8,13,29
S01012579,Very good health,256,32,7,25,61,27,32,20,27,25,10,4,6,22
S01012579,Good health,173,21,4,17,32,17,21,17,35,17,7,1,6,6
S01012579,Fair health,68,7,2,5,12,7,13,7,9,11,1,0,1,1
S01012579,Bad health,18,0,0,0,2,1,0,2,5,6,2,2,0,0
S01012579,Very bad health,7,0,0,0,1,0,1,1,1,2,1,1,0,0
S01012580,All people aged 16 to 74,588,90,19,71,144,56,106,42,63,39,23,13,10,25
S01012580,Very good health,337,56,10,46,82,36,54,23,39,13,10,6,4,24
S01012580,Good health,181,28,8,20,53,14,39,8,15,14,9,3,6,1
S01012580,Fair health,50,5,1,4,9,3,9,8,5,10,1,1,0,0
S01012580,Bad health,13,1,0,1,0,2,2,2,2,2,2,2,0,0
S01012580,Very bad health,7,0,0,0,0,1,2,1,2,0,1,1,0,0
S01012581,All people aged 16 to 74,521,17,5,12,84,67,36,56,102,76,51,25,26,32
S01012581,Very good health,233,14,5,9,37,28,14,24,48,26,22,9,13,20
S01012581,Good health,181,3,0,3,34,24,15,21,31,26,17,10,7,10
S01012581,Fair health,68,0,0,0,6,10,3,6,16,18,8,3,5,1
S01012581,Bad health,32,0,0,0,4,5,4,5,5,5,3,2,1,1
S01012581,Very bad health,7,0,0,0,3,0,0,0,2,1,1,1,0,0
S01012582,All people aged 16 to 74,690,74,16,58,175,78,100,48,89,62,20,11,9,44
S01012582,Very good health,383,47,11,36,116,42,52,25,33,25,7,4,3,36
S01012582,Good health,213,25,4,21,40,29,36,9,33,23,10,4,6,8
S01012582,Fair health,64,2,1,1,14,6,8,10,13,9,2,2,0,0
S01012582,Bad health,24,0,0,0,2,1,4,3,9,5,0,0,0,0
S01012582,Very bad health,6,0,0,0,3,0,0,1,1,0,1,1,0,0
S01012583,All people aged 16 to 74,525,32,10,22,107,63,38,59,85,91,28,15,13,22
S01012583,Very good health,230,17,6,11,54,30,13,33,28,26,11,3,8,18
S01012583,Good health,185,8,1,7,40,19,12,12,38,41,11,8,3,4
S01012583,Fair health,82,3,1,2,11,11,10,11,15,18,3,1,2,0
S01012583,Bad health,22,3,2,1,2,2,2,3,3,4,3,3,0,0
S01012583,Very bad health,6,1,0,1,0,1,1,0,1,2,0,0,0,0
S01012584,All people aged 16 to 74,555,49,13,36,129,70,75,45,64,69,17,13,4,37
S01012584,Very good health,258,26,7,19,58,35,36,15,22,31,4,3,1,31
S01012584,Good health,188,15,4,11,43,23,30,17,27,21,7,4,3,5
S01012584,Fair health,69,6,1,5,22,8,5,10,8,8,2,2,0,0
S01012584,Bad health,31,2,1,1,5,3,4,3,6,6,2,2,0,0
S01012584,Very bad health,9,0,0,0,1,1,0,0,1,3,2,2,0,1
S01012585,All people aged 16 to 74,610,24,7,17,115,50,46,71,114,117,44,25,19,29
S01012585,Very good health,261,12,3,9,46,26,24,32,39,41,18,9,9,23
S01012585,Good health,235,9,2,7,47,18,17,23,51,49,16,7,9,5
S01012585,Fair health,77,1,1,0,12,4,5,10,18,18,8,7,1,1
S01012585,Bad health,27,2,1,1,9,1,0,1,6,7,1,1,0,0
S01012585,Very bad health,10,0,0,0,1,1,0,5,0,2,1,1,0,0
S01012586,All people aged 16 to 74,751,67,14,53,157,81,88,55,100,93,62,56,6,48
S01012586,Very good health,342,40,7,33,78,35,41,24,41,30,20,18,2,33
S01012586,Good health,268,21,6,15,55,28,32,24,30,42,23,19,4,13
S01012586,Fair health,96,5,1,4,19,10,13,6,18,10,14,14,0,1
S01012586,Bad health,36,0,0,0,5,6,2,1,9,9,4,4,0,0
S01012586,Very bad health,9,1,0,1,0,2,0,0,2,2,1,1,0,1
S01012587,All people aged 16 to 74,655,61,14,47,177,69,117,47,76,58,13,10,3,37
S01012587,Very good health,321,36,6,30,81,31,54,18,34,29,6,4,2,32
S01012587,Good health,224,17,4,13,73,27,43,21,24,13,1,1,0,5
S01012587,Fair health,87,8,4,4,20,10,15,4,14,12,4,4,0,0
S01012587,Bad health,15,0,0,0,2,1,4,1,4,2,1,0,1,0
S01012587,Very bad health,8,0,0,0,1,0,1,3,0,2,1,1,0,0
S01012588,All people aged 16 to 74,493,49,13,36,99,69,79,33,66,58,12,7,5,28
S01012588,Very good health,240,30,8,22,48,31,29,15,33,24,7,3,4,23
S01012588,Good health,159,14,4,10,33,22,32,10,23,21,2,2,0,2
S01012588,Fair health,63,2,1,1,11,10,16,6,7,7,1,0,1,3
S01012588,Bad health,22,3,0,3,6,4,2,1,1,3,2,2,0,0
S01012588,Very bad health,9,0,0,0,1,2,0,1,2,3,0,0,0,0
S01012589,All people aged 16 to 74,510,19,2,17,71,86,22,62,89,110,23,16,7,28
S01012589,Very good health,227,13,1,12,25,43,12,32,36,37,9,6,3,20
S01012589,Good health,162,4,1,3,30,29,5,13,27,41,7,4,3,6
S01012589,Fair health,86,2,0,2,12,10,3,12,18,22,6,5,1,1
S01012589,Bad health,29,0,0,0,3,4,2,3,6,9,1,1,0,1
S01012589,Very bad health,6,0,0,0,1,0,0,2,2,1,0,0,0,0
S01012590,All people aged 16 to 74,592,32,7,25,83,63,34,58,129,130,35,25,10,28
S01012590,Very good health,238,14,2,12,40,28,13,22,46,52,6,4,2,17
S01012590,Good health,194,11,3,8,26,24,10,18,41,36,18,12,6,10
S01012590,Fair health,111,5,1,4,13,9,6,10,27,33,8,6,2,0
S01012590,Bad health,40,2,1,1,4,2,3,7,13,6,2,2,0,1
S01012590,Very bad health,9,0,0,0,0,0,2,1,2,3,1,1,0,0
S01012591,All people aged 16 to 74,577,15,5,10,75,59,28,59,136,136,51,35,16,18
S01012591,Very good health,194,11,2,9,32,17,3,18,38,44,21,15,6,10
S01012591,Good health,211,4,3,1,25,28,13,20,52,45,18,11,7,6
S01012591,Fair health,126,0,0,0,16,11,7,16,33,33,9,8,1,1
S01012591,Bad health,33,0,0,0,2,2,2,4,11,8,3,1,2,1
S01012591,Very bad health,13,0,0,0,0,1,3,1,2,6,0,0,0,0
S01012592,All people aged 16 to 74,431,72,18,54,110,72,46,29,44,24,13,7,6,21
S01012592,Very good health,250,49,12,37,71,37,24,11,20,14,3,2,1,21
S01012592,Good health,124,19,6,13,30,25,13,9,17,5,6,2,4,0
S01012592,Fair health,42,4,0,4,8,5,7,7,5,4,2,2,0,0
S01012592,Bad health,12,0,0,0,1,5,1,2,1,0,2,1,1,0
S01012592,Very bad health,3,0,0,0,0,0,1,0,1,1,0,0,0,0
S01012593,All people aged 16 to 74,647,63,14,49,189,115,39,54,62,67,8,3,5,50
S01012593,Very good health,333,31,3,28,89,61,23,33,27,26,1,0,1,42
S01012593,Good health,223,26,8,18,80,37,12,12,25,24,2,1,1,5
S01012593,Fair health,61,5,3,2,12,12,4,4,9,9,3,1,2,3
S01012593,Bad health,24,1,0,1,7,4,0,3,1,7,1,1,0,0
S01012593,Very bad health,6,0,0,0,1,1,0,2,0,1,1,0,1,0
S01012594,All people aged 16 to 74,361,27,6,21,87,54,19,31,54,51,13,10,3,25
S01012594,Very good health,152,14,3,11,42,19,7,13,23,14,2,2,0,18
S01012594,Good health,139,11,2,9,29,26,8,14,18,23,5,2,3,5
S01012594,Fair health,48,2,1,1,9,8,3,3,10,7,4,4,0,2
S01012594,Bad health,19,0,0,0,5,1,1,1,3,6,2,2,0,0
S01012594,Very bad health,3,0,0,0,2,0,0,0,0,1,0,0,0,0
S01012595,All people aged 16 to 74,492,23,2,21,108,79,41,50,77,73,22,14,8,19
S01012595,Very good health,192,14,2,12,47,35,13,15,23,24,6,3,3,15
S01012595,Good health,181,6,0,6,36,25,19,22,34,30,6,3,3,3
S01012595,Fair health,74,3,0,3,14,15,6,7,10,12,7,5,2,0
S01012595,Bad health,37,0,0,0,9,2,2,5,10,5,3,3,0,1
S01012595,Very bad health,8,0,0,0,2,2,1,1,0,2,0,0,0,0
S01012596,All people aged 16 to 74,566,21,7,14,82,79,31,52,86,139,41,25,16,35
S01012596,Very good health,249,15,4,11,50,37,15,26,32,40,15,9,6,19
S01012596,Good health,189,4,3,1,18,31,11,16,36,53,8,3,5,12
S01012596,Fair health,87,2,0,2,12,9,2,8,14,24,13,8,5,3
S01012596,Bad health,28,0,0,0,1,1,2,2,2,18,2,2,0,0
S01012596,Very bad health,13,0,0,0,1,1,1,0,2,4,3,3,0,1
S01012597,All people aged 16 to 74,334,28,1,27,95,47,23,41,37,33,17,11,6,13
S01012597,Very good health,198,14,0,14,62,25,11,26,18,18,13,8,5,11
S01012597,Good health,85,9,0,9,24,16,6,11,9,7,1,0,1,2
S01012597,Fair health,41,4,1,3,6,6,4,4,7,7,3,3,0,0
S01012597,Bad health,9,1,0,1,3,0,2,0,2,1,0,0,0,0
S01012597,Very bad health,1,0,0,0,0,0,0,0,1,0,0,0,0,0
S01012598,All people aged 16 to 74,530,77,11,66,167,85,32,41,45,38,10,7,3,35
S01012598,Very good health,297,50,5,45,90,48,16,20,22,17,2,2,0,32
S01012598,Good health,174,20,4,16,63,26,13,15,17,11,6,4,2,3
S01012598,Fair health,42,5,2,3,10,8,1,5,6,5,2,1,1,0
S01012598,Bad health,13,2,0,2,3,2,1,1,0,4,0,0,0,0
S01012598,Very bad health,4,0,0,0,1,1,1,0,0,1,0,0,0,0
S01012599,All people aged 16 to 74,494,57,13,44,134,73,33,29,58,51,24,16,8,35
S01012599,Very good health,221,28,7,21,63,33,15,12,18,21,7,3,4,24
S01012599,Good health,179,21,6,15,55,25,14,11,25,11,8,6,2,9
S01012599,Fair health,65,6,0,6,9,13,4,4,10,13,5,3,2,1
S01012599,Bad health,25,1,0,1,5,2,0,2,4,6,4,4,0,1
S01012599,Very bad health,4,1,0,1,2,0,0,0,1,0,0,0,0,0
S01012600,All people aged 16 to 74,571,55,17,38,173,116,32,35,64,45,18,12,6,33
S01012600,Very good health,327,35,10,25,112,61,13,17,26,23,10,8,2,30
S01012600,Good health,165,13,4,9,47,39,11,10,24,13,5,2,3,3
S01012600,Fair health,63,5,1,4,10,15,7,6,11,6,3,2,1,0
S01012600,Bad health,14,2,2,0,3,1,1,2,3,2,0,0,0,0
S01012600,Very bad health,2,0,0,0,1,0,0,0,0,1,0,0,0,0
S01012601,All people aged 16 to 74,691,78,14,64,209,126,41,51,68,53,15,9,6,50
S01012601,Very good health,386,38,6,32,130,65,16,23,37,25,6,4,2,46
S01012601,Good health,219,30,6,24,54,44,23,20,20,18,6,3,3,4
S01012601,Fair health,62,7,1,6,19,14,2,5,7,6,2,1,1,0
S01012601,Bad health,17,2,1,1,4,3,0,3,2,2,1,1,0,0
S01012601,Very bad health,7,1,0,1,2,0,0,0,2,2,0,0,0,0
S01012602,All people aged 16 to 74,434,24,5,19,95,56,16,44,63,75,38,28,10,23
S01012602,Very good health,175,5,1,4,52,20,3,21,22,25,7,4,3,20
S01012602,Good health,133,12,3,9,26,18,6,14,21,26,7,3,4,3
S01012602,Fair health,78,4,0,4,10,9,4,5,13,14,19,16,3,0
S01012602,Bad health,37,2,1,1,5,7,2,4,6,8,3,3,0,0
S01012602,Very bad health,11,1,0,1,2,2,1,0,1,2,2,2,0,0
S01012603,All people aged 16 to 74,531,19,4,15,99,87,32,41,81,105,37,22,15,30
S01012603,Very good health,207,9,1,8,41,35,14,15,27,33,13,9,4,20
S01012603,Good health,185,5,1,4,39,25,10,16,38,37,6,3,3,9
S01012603,Fair health,86,3,1,2,13,19,3,5,9,19,14,6,8,1
S01012603,Bad health,39,1,1,0,4,7,3,4,5,12,3,3,0,0
S01012603,Very bad health,14,1,0,1,2,1,2,1,2,4,1,1,0,0
S01012604,All people aged 16 to 74,514,31,10,21,96,56,21,37,114,104,23,15,8,32
S01012604,Very good health,205,12,4,8,42,30,6,10,40,34,8,5,3,23
S01012604,Good health,198,13,5,8,45,16,9,18,47,38,7,3,4,5
S01012604,Fair health,71,5,1,4,6,7,4,7,17,17,6,5,1,2
S01012604,Bad health,27,1,0,1,3,3,0,0,7,10,1,1,0,2
S01012604,Very bad health,13,0,0,0,0,0,2,2,3,5,1,1,0,0
S01012605,All people aged 16 to 74,386,31,6,25,80,59,18,33,64,55,15,10,5,31
S01012605,Very good health,170,21,5,16,35,18,9,14,23,22,6,5,1,22
S01012605,Good health,137,9,1,8,31,26,6,11,26,16,5,2,3,7
S01012605,Fair health,56,0,0,0,8,10,1,5,12,15,3,2,1,2
S01012605,Bad health,18,1,0,1,4,3,2,3,3,1,1,1,0,0
S01012605,Very bad health,5,0,0,0,2,2,0,0,0,1,0,0,0,0
S01012606,All people aged 16 to 74,547,96,18,78,197,93,20,29,49,25,5,3,2,33
S01012606,Very good health,377,65,12,53,141,64,12,23,26,15,3,2,1,28
S01012606,Good health,143,27,5,22,48,26,8,4,18,8,1,0,1,3
S01012606,Fair health,23,4,1,3,7,3,0,1,4,2,1,1,0,1
S01012606,Bad health,3,0,0,0,1,0,0,0,1,0,0,0,0,1
S01012606,Very bad health,1,0,0,0,0,0,0,1,0,0,0,0,0,0
S01012607,All people aged 16 to 74,596,47,8,39,135,79,46,49,93,70,31,15,16,46
S01012607,Very good health,318,29,5,24,77,46,20,23,41,30,12,3,9,40
S01012607,Good health,189,15,3,12,45,22,19,20,35,18,9,4,5,6
S01012607,Fair health,58,3,0,3,8,8,6,5,11,10,7,6,1,0
S01012607,Bad health,27,0,0,0,5,2,0,1,6,10,3,2,1,0
S01012607,Very bad health,4,0,0,0,0,1,1,0,0,2,0,0,0,0
S01012608,All people aged 16 to 74,613,22,3,19,118,83,30,52,104,133,35,21,14,36
S01012608,Very good health,292,14,2,12,57,51,15,27,50,34,15,10,5,29
S01012608,Good health,191,8,1,7,42,21,5,18,33,46,12,8,4,6
S01012608,Fair health,90,0,0,0,17,9,5,2,14,36,6,3,3,1
S01012608,Bad health,29,0,0,0,2,2,3,4,5,11,2,0,2,0
S01012608,Very bad health,11,0,0,0,0,0,2,1,2,6,0,0,0,0
S01012609,All people aged 16 to 74,614,12,2,10,74,91,29,61,126,151,50,34,16,20
S01012609,Very good health,248,5,2,3,33,41,13,27,47,53,16,10,6,13
S01012609,Good health,203,5,0,5,20,31,6,19,45,50,21,11,10,6
S01012609,Fair health,106,1,0,1,11,13,6,13,22,36,3,3,0,1
S01012609,Bad health,45,1,0,1,7,4,3,1,10,11,8,8,0,0
S01012609,Very bad health,12,0,0,0,3,2,1,1,2,1,2,2,0,0
S01012610,All people aged 16 to 74,691,29,7,22,103,90,43,63,125,119,70,50,20,49
S01012610,Very good health,276,16,4,12,44,40,17,22,43,42,13,7,6,39
S01012610,Good health,218,7,2,5,38,32,12,22,42,32,27,20,7,6
S01012610,Fair health,105,5,1,4,12,10,6,9,24,21,15,10,5,3
S01012610,Bad health,68,1,0,1,7,6,7,9,12,20,5,4,1,1
S01012610,Very bad health,24,0,0,0,2,2,1,1,4,4,10,9,1,0
S01012611,All people aged 16 to 74,659,60,11,49,167,82,45,47,110,81,15,9,6,52
S01012611,Very good health,316,30,5,25,88,42,23,18,43,24,7,4,3,41
S01012611,Good health,215,24,4,20,53,25,13,17,38,29,5,3,2,11
S01012611,Fair health,77,4,2,2,22,8,7,6,14,14,2,1,1,0
S01012611,Bad health,41,1,0,1,3,6,2,3,13,13,0,0,0,0
S01012611,Very bad health,10,1,0,1,1,1,0,3,2,1,1,1,0,0
S01012612,All people aged 16 to 74,569,29,7,22,93,93,42,48,71,94,46,28,18,53
S01012612,Very good health,225,13,2,11,33,35,15,23,23,29,15,8,7,39
S01012612,Good health,204,8,3,5,42,35,16,14,24,34,18,9,9,13
S01012612,Fair health,77,8,2,6,8,8,7,9,15,16,5,5,0,1
S01012612,Bad health,48,0,0,0,9,11,4,2,6,10,6,4,2,0
S01012612,Very bad health,15,0,0,0,1,4,0,0,3,5,2,2,0,0
S01012613,All people aged 16 to 74,521,32,6,26,102,73,29,45,86,100,30,20,10,24
S01012613,Very good health,233,15,4,11,47,32,10,22,32,42,19,15,4,14
S01012613,Good health,177,14,2,12,33,24,14,12,32,35,6,2,4,7
S01012613,Fair health,66,0,0,0,13,15,5,4,11,15,3,2,1,0
S01012613,Bad health,30,2,0,2,3,2,0,4,9,7,2,1,1,1
S01012613,Very bad health,15,1,0,1,6,0,0,3,2,1,0,0,0,2
S01012614,All people aged 16 to 74,799,57,17,40,204,131,46,71,113,83,31,18,13,63
S01012614,Very good health,374,23,5,18,117,66,17,25,43,27,10,4,6,46
S01012614,Good health,267,26,10,16,51,41,15,30,46,33,13,8,5,12
S01012614,Fair health,93,7,2,5,20,11,7,9,19,12,5,4,1,3
S01012614,Bad health,50,1,0,1,11,11,6,6,4,7,2,1,1,2
S01012614,Very bad health,15,0,0,0,5,2,1,1,1,4,1,1,0,0
S01012615,All people aged 16 to 74,515,77,16,61,140,62,54,22,57,47,22,11,11,34
S01012615,Very good health,265,48,10,38,61,38,32,13,20,24,6,3,3,23
S01012615,Good health,156,23,4,19,56,15,11,3,16,13,9,1,8,10
S01012615,Fair health,69,5,1,4,19,7,9,5,16,7,0,0,0,1
S01012615,Bad health,22,1,1,0,4,2,1,1,5,2,6,6,0,0
S01012615,Very bad health,3,0,0,0,0,0,1,0,0,1,1,1,0,0
S01012616,All people aged 16 to 74,688,99,25,74,155,87,86,41,87,60,28,20,8,45
S01012616,Very good health,337,50,13,37,83,42,39,15,35,25,11,8,3,37
S01012616,Good health,239,39,10,29,54,31,29,21,31,19,8,5,3,7
S01012616,Fair health,73,7,2,5,13,9,10,2,15,13,3,3,0,1
S01012616,Bad health,27,2,0,2,3,4,6,3,5,1,3,2,1,0
S01012616,Very bad health,12,1,0,1,2,1,2,0,1,2,3,2,1,0
S01012617,All people aged 16 to 74,305,32,7,25,87,52,43,22,21,17,8,7,1,23
S01012617,Very good health,179,17,4,13,58,30,22,9,11,10,4,3,1,18
S01012617,Good health,91,13,3,10,21,18,16,10,4,5,1,1,0,3
S01012617,Fair health,29,2,0,2,7,4,5,3,4,2,1,1,0,1
S01012617,Bad health,3,0,0,0,1,0,0,0,1,0,0,0,0,1
S01012617,Very bad health,3,0,0,0,0,0,0,0,1,0,2,2,0,0
S01012618,All people aged 16 to 74,420,35,7,28,101,47,34,36,64,50,19,13,6,34
S01012618,Very good health,229,22,4,18,59,25,17,22,27,19,9,7,2,29
S01012618,Good health,128,9,2,7,27,17,14,10,21,20,7,4,3,3
S01012618,Fair health,51,3,0,3,13,5,1,3,14,8,3,2,1,1
S01012618,Bad health,10,1,1,0,1,0,2,1,2,2,0,0,0,1
S01012618,Very bad health,2,0,0,0,1,0,0,0,0,1,0,0,0,0
S01012619,All people aged 16 to 74,407,27,6,21,64,57,31,35,68,70,40,29,11,15
S01012619,Very good health,152,12,4,8,29,27,11,7,23,18,11,6,5,14
S01012619,Good health,160,14,2,12,26,22,15,18,21,25,18,13,5,1
S01012619,Fair health,62,1,0,1,6,5,4,6,16,18,6,5,1,0
S01012619,Bad health,29,0,0,0,3,3,0,4,7,7,5,5,0,0
S01012619,Very bad health,4,0,0,0,0,0,1,0,1,2,0,0,0,0
S01012620,All people aged 16 to 74,566,84,12,72,174,88,55,30,64,24,11,8,3,36
S01012620,Very good health,297,48,6,42,99,40,17,17,31,7,6,3,3,32
S01012620,Good health,183,29,4,25,57,35,21,10,19,5,3,3,0,4
S01012620,Fair health,67,5,1,4,13,9,13,3,14,9,1,1,0,0
S01012620,Bad health,16,2,1,1,3,4,4,0,0,2,1,1,0,0
S01012620,Very bad health,3,0,0,0,2,0,0,0,0,1,0,0,0,0
S01012621,All people aged 16 to 74,437,59,11,48,122,67,35,21,46,30,32,22,10,25
S01012621,Very good health,223,37,9,28,64,35,12,13,21,11,9,5,4,21
S01012621,Good health,147,19,2,17,48,25,14,5,14,8,12,9,3,2
S01012621,Fair health,52,3,0,3,8,5,7,1,9,8,9,7,2,2
S01012621,Bad health,12,0,0,0,1,1,2,2,1,3,2,1,1,0
S01012621,Very bad health,3,0,0,0,1,1,0,0,1,0,0,0,0,0
S01012622,All people aged 16 to 74,540,38,9,29,130,72,46,47,98,61,23,16,7,25
S01012622,Very good health,248,23,4,19,58,34,23,18,44,19,9,7,2,20
S01012622,Good health,194,9,2,7,54,25,17,18,37,21,11,7,4,2
S01012622,Fair health,73,4,1,3,15,10,6,9,12,12,2,1,1,3
S01012622,Bad health,15,0,0,0,2,1,0,2,4,6,0,0,0,0
S01012622,Very bad health,10,2,2,0,1,2,0,0,1,3,1,1,0,0
S01012623,All people aged 16 to 74,506,26,4,22,83,65,35,56,100,93,25,16,9,23
S01012623,Very good health,196,15,2,13,36,34,14,17,30,27,8,6,2,15
S01012623,Good health,198,11,2,9,31,19,16,21,47,36,9,6,3,8
S01012623,Fair health,73,0,0,0,13,11,3,12,12,16,6,2,4,0
S01012623,Bad health,31,0,0,0,2,1,1,6,9,10,2,2,0,0
S01012623,Very bad health,8,0,0,0,1,0,1,0,2,4,0,0,0,0
S01012624,All people aged 16 to 74,522,20,6,14,92,73,35,46,105,84,32,17,15,35
S01012624,Very good health,224,9,3,6,50,36,15,25,33,33,6,4,2,17
S01012624,Good health,203,9,3,6,30,24,15,14,52,32,12,5,7,15
S01012624,Fair health,71,2,0,2,9,11,4,7,13,14,10,5,5,1
S01012624,Bad health,19,0,0,0,2,2,0,0,7,3,3,2,1,2
S01012624,Very bad health,5,0,0,0,1,0,1,0,0,2,1,1,0,0
S01012625,All people aged 16 to 74,401,17,4,13,76,51,28,37,73,70,25,20,5,24
S01012625,Very good health,162,7,2,5,41,18,12,11,30,21,5,4,1,17
S01012625,Good health,144,7,2,5,26,19,9,14,21,31,12,9,3,5
S01012625,Fair health,61,1,0,1,7,6,3,8,16,13,5,5,0,2
S01012625,Bad health,26,2,0,2,2,7,2,3,5,3,2,1,1,0
S01012625,Very bad health,8,0,0,0,0,1,2,1,1,2,1,1,0,0
S01012626,All people aged 16 to 74,374,32,4,28,102,57,24,33,55,30,10,8,2,31
S01012626,Very good health,183,16,2,14,56,31,13,15,15,11,1,1,0,25
S01012626,Good health,140,13,2,11,34,14,8,13,31,14,7,6,1,6
S01012626,Fair health,35,3,0,3,8,10,1,1,8,3,1,0,1,0
S01012626,Bad health,13,0,0,0,3,2,2,3,1,1,1,1,0,0
S01012626,Very bad health,3,0,0,0,1,0,0,1,0,1,0,0,0,0
S01012627,All people aged 16 to 74,412,36,11,25,84,49,30,33,56,59,43,23,20,22
S01012627,Very good health,179,21,7,14,41,24,7,13,18,18,22,12,10,15
S01012627,Good health,154,15,4,11,30,21,11,11,25,21,16,7,9,4
S01012627,Fair health,61,0,0,0,9,3,9,7,9,19,2,2,0,3
S01012627,Bad health,15,0,0,0,4,1,2,2,3,1,2,1,1,0
S01012627,Very bad health,3,0,0,0,0,0,1,0,1,0,1,1,0,0
S01012628,All people aged 16 to 74,670,104,26,78,208,103,58,35,65,36,18,13,5,43
S01012628,Very good health,427,69,19,50,137,62,41,24,33,16,7,4,3,38
S01012628,Good health,186,30,5,25,55,32,14,10,26,11,6,4,2,2
S01012628,Fair health,46,4,2,2,13,7,3,0,5,8,3,3,0,3
S01012628,Bad health,9,1,0,1,2,2,0,0,1,1,2,2,0,0
S01012628,Very bad health,2,0,0,0,1,0,0,1,0,0,0,0,0,0
S01012629,All people aged 16 to 74,351,60,15,45,117,42,28,22,28,20,11,7,4,23
S01012629,Very good health,194,32,8,24,71,22,11,8,13,12,3,2,1,22
S01012629,Good health,111,21,6,15,36,13,12,9,8,6,5,4,1,1
S01012629,Fair health,38,6,1,5,9,6,4,3,7,1,2,1,1,0
S01012629,Bad health,5,1,0,1,0,1,1,0,0,1,1,0,1,0
S01012629,Very bad health,3,0,0,0,1,0,0,2,0,0,0,0,0,0
S01012630,All people aged 16 to 74,614,52,9,43,145,79,51,58,79,78,43,25,18,29
S01012630,Very good health,272,17,4,13,77,28,25,22,37,33,11,4,7,22
S01012630,Good health,234,28,5,23,43,35,16,27,28,27,25,15,10,5
S01012630,Fair health,77,4,0,4,19,12,8,7,10,13,2,1,1,2
S01012630,Bad health,26,3,0,3,4,3,1,2,3,5,5,5,0,0
S01012630,Very bad health,5,0,0,0,2,1,1,0,1,0,0,0,0,0
S01012631,All people aged 16 to 74,681,31,5,26,128,71,42,66,124,115,57,32,25,47
S01012631,Very good health,299,19,3,16,68,38,18,34,42,33,10,5,5,37
S01012631,Good health,238,12,2,10,44,22,17,14,56,36,27,12,15,10
S01012631,Fair health,89,0,0,0,8,7,5,10,20,24,15,11,4,0
S01012631,Bad health,40,0,0,0,6,2,1,7,5,14,5,4,1,0
S01012631,Very bad health,15,0,0,0,2,2,1,1,1,8,0,0,0,0
S01012632,All people aged 16 to 74,551,53,6,47,114,85,101,34,69,63,13,12,1,19
S01012632,Very good health,275,24,1,23,74,36,46,17,34,25,2,2,0,17
S01012632,Good health,170,22,2,20,29,34,30,13,24,16,0,0,0,2
S01012632,Fair health,77,6,3,3,8,10,20,1,8,16,8,7,1,0
S01012632,Bad health,23,1,0,1,2,3,4,3,3,4,3,3,0,0
S01012632,Very bad health,6,0,0,0,1,2,1,0,0,2,0,0,0,0
S01012633,All people aged 16 to 74,527,66,16,50,130,53,90,40,71,32,19,14,5,26
S01012633,Very good health,247,35,8,27,63,22,41,15,35,10,6,4,2,20
S01012633,Good health,201,28,8,20,44,22,39,15,24,14,9,7,2,6
S01012633,Fair health,57,2,0,2,15,6,9,10,8,4,3,2,1,0
S01012633,Bad health,17,1,0,1,7,3,1,0,3,1,1,1,0,0
S01012633,Very bad health,5,0,0,0,1,0,0,0,1,3,0,0,0,0
S01012634,All people aged 16 to 74,526,25,5,20,87,77,56,40,87,92,35,19,16,27
S01012634,Very good health,233,17,3,14,41,37,21,16,33,35,12,6,6,21
S01012634,Good health,167,6,2,4,23,24,24,12,34,25,14,7,7,5
S01012634,Fair health,75,2,0,2,13,11,8,5,12,15,8,5,3,1
S01012634,Bad health,39,0,0,0,6,4,3,6,3,16,1,1,0,0
S01012634,Very bad health,12,0,0,0,4,1,0,1,5,1,0,0,0,0
S01012635,All people aged 16 to 74,824,94,17,77,218,104,82,60,117,78,23,10,13,48
S01012635,Very good health,427,63,11,52,124,59,39,32,39,24,13,4,9,34
S01012635,Good health,264,24,5,19,62,34,33,19,50,27,4,4,0,11
S01012635,Fair health,103,7,1,6,26,9,8,7,22,16,5,2,3,3
S01012635,Bad health,21,0,0,0,5,1,1,2,4,7,1,0,1,0
S01012635,Very bad health,9,0,0,0,1,1,1,0,2,4,0,0,0,0
S01012636,All people aged 16 to 74,466,43,7,36,122,49,74,29,62,57,12,10,2,18
S01012636,Very good health,243,26,5,21,66,20,40,16,26,31,4,3,1,14
S01012636,Good health,159,13,2,11,43,21,27,9,28,12,4,3,1,2
S01012636,Fair health,49,4,0,4,10,8,5,3,5,9,3,3,0,2
S01012636,Bad health,11,0,0,0,1,0,2,0,2,5,1,1,0,0
S01012636,Very bad health,4,0,0,0,2,0,0,1,1,0,0,0,0,0
S01012637,All people aged 16 to 74,612,12,2,10,67,66,30,62,125,160,61,37,24,29
S01012637,Very good health,255,7,1,6,37,33,10,24,35,65,25,15,10,19
S01012637,Good health,199,2,1,1,17,23,9,22,57,49,14,5,9,6
S01012637,Fair health,102,3,0,3,7,5,7,9,21,31,16,11,5,3
S01012637,Bad health,42,0,0,0,5,4,3,2,9,13,5,5,0,1
S01012637,Very bad health,14,0,0,0,1,1,1,5,3,2,1,1,0,0
S01012638,All people aged 16 to 74,630,40,8,32,106,77,44,61,108,127,35,17,18,32
S01012638,Very good health,281,28,5,23,54,35,22,24,42,47,9,4,5,20
S01012638,Good health,216,9,2,7,33,32,11,23,39,45,14,4,10,10
S01012638,Fair health,85,3,1,2,13,6,8,10,14,22,7,4,3,2
S01012638,Bad health,37,0,0,0,5,4,2,2,9,11,4,4,0,0
S01012638,Very bad health,11,0,0,0,1,0,1,2,4,2,1,1,0,0
S01012639,All people aged 16 to 74,620,21,5,16,82,74,42,45,160,138,30,18,12,28
S01012639,Very good health,254,14,4,10,38,27,17,20,57,49,11,7,4,21
S01012639,Good health,225,5,0,5,32,30,18,15,63,46,10,4,6,6
S01012639,Fair health,98,2,1,1,9,8,5,6,29,34,5,3,2,0
S01012639,Bad health,22,0,0,0,1,6,1,1,7,4,1,1,0,1
S01012639,Very bad health,21,0,0,0,2,3,1,3,4,5,3,3,0,0
S01012640,All people aged 16 to 74,703,8,3,5,92,59,69,60,146,146,91,47,44,32
S01012640,Very good health,265,3,2,1,35,27,26,23,65,43,25,16,9,18
S01012640,Good health,228,3,1,2,29,15,20,23,44,53,30,14,16,11
S01012640,Fair health,149,1,0,1,21,12,15,8,27,33,30,13,17,2
S01012640,Bad health,46,1,0,1,4,5,6,5,6,14,4,2,2,1
S01012640,Very bad health,15,0,0,0,3,0,2,1,4,3,2,2,0,0
S01012641,All people aged 16 to 74,678,28,10,18,124,66,55,66,146,114,45,22,23,34
S01012641,Very good health,298,14,5,9,55,27,24,31,58,47,18,8,10,24
S01012641,Good health,228,9,3,6,49,24,20,19,55,30,15,8,7,7
S01012641,Fair health,102,2,0,2,11,8,10,12,22,27,8,3,5,2
S01012641,Bad health,35,1,0,1,5,6,1,3,10,5,3,2,1,1
S01012641,Very bad health,15,2,2,0,4,1,0,1,1,5,1,1,0,0
S01012642,All people aged 16 to 74,601,10,2,8,54,45,25,62,146,162,70,49,21,27
S01012642,Very good health,214,8,2,6,18,22,11,19,51,45,24,16,8,16
S01012642,Good health,216,0,0,0,23,11,10,24,57,60,21,13,8,10
S01012642,Fair health,104,1,0,1,9,7,1,7,29,31,18,14,4,1
S01012642,Bad health,53,1,0,1,3,5,2,9,9,20,4,4,0,0
S01012642,Very bad health,14,0,0,0,1,0,1,3,0,6,3,2,1,0
S01012643,All people aged 16 to 74,339,2,0,2,53,31,18,34,76,84,26,16,10,15
S01012643,Very good health,142,1,0,1,20,17,11,16,22,34,9,7,2,12
S01012643,Good health,111,0,0,0,17,8,4,6,33,31,9,3,6,3
S01012643,Fair health,63,0,0,0,11,6,3,5,17,14,7,6,1,0
S01012643,Bad health,19,1,0,1,3,0,0,6,4,5,0,0,0,0
S01012643,Very bad health,4,0,0,0,2,0,0,1,0,0,1,0,1,0
S01012644,All people aged 16 to 74,477,16,3,13,81,45,32,44,118,84,41,32,9,16
S01012644,Very good health,207,9,1,8,44,24,12,20,49,25,11,7,4,13
S01012644,Good health,174,4,1,3,27,16,14,14,46,34,16,14,2,3
S01012644,Fair health,67,3,1,2,6,5,4,7,17,15,10,7,3,0
S01012644,Bad health,25,0,0,0,4,0,1,3,5,8,4,4,0,0
S01012644,Very bad health,4,0,0,0,0,0,1,0,1,2,0,0,0,0
S01012645,All people aged 16 to 74,576,44,8,36,134,68,68,49,73,86,29,16,13,25
S01012645,Very good health,284,27,3,24,74,36,28,20,36,35,6,3,3,22
S01012645,Good health,174,12,4,8,36,21,23,19,19,29,12,6,6,3
S01012645,Fair health,78,5,1,4,15,8,11,8,12,16,3,1,2,0
S01012645,Bad health,33,0,0,0,9,2,5,1,5,5,6,4,2,0
S01012645,Very bad health,7,0,0,0,0,1,1,1,1,1,2,2,0,0
S01012646,All people aged 16 to 74,706,67,15,52,162,95,80,66,109,71,23,14,9,33
S01012646,Very good health,345,41,8,33,79,48,42,35,48,26,5,2,3,21
S01012646,Good health,238,19,5,14,61,29,25,22,35,29,10,6,4,8
S01012646,Fair health,86,4,2,2,18,15,7,4,21,11,5,4,1,1
S01012646,Bad health,31,3,0,3,4,2,5,4,5,5,1,0,1,2
S01012646,Very bad health,6,0,0,0,0,1,1,1,0,0,2,2,0,1
S01012647,All people aged 16 to 74,525,52,11,41,158,90,35,37,57,54,10,5,5,32
S01012647,Very good health,322,36,9,27,103,57,20,21,23,31,7,4,3,24
S01012647,Good health,154,13,2,11,48,24,10,12,21,16,2,1,1,8
S01012647,Fair health,31,3,0,3,3,7,3,2,8,4,1,0,1,0
S01012647,Bad health,16,0,0,0,4,2,1,2,4,3,0,0,0,0
S01012647,Very bad health,2,0,0,0,0,0,1,0,1,0,0,0,0,0
S01012648,All people aged 16 to 74,411,8,2,6,62,38,24,28,110,78,31,17,14,32
S01012648,Very good health,149,5,1,4,24,18,6,7,38,25,10,6,4,16
S01012648,Good health,160,2,1,1,28,13,11,14,38,27,12,5,7,15
S01012648,Fair health,79,1,0,1,8,7,5,5,26,19,7,4,3,1
S01012648,Bad health,14,0,0,0,2,0,2,1,5,4,0,0,0,0
S01012648,Very bad health,9,0,0,0,0,0,0,1,3,3,2,2,0,0
S01012649,All people aged 16 to 74,505,46,10,36,83,56,42,31,96,65,51,45,6,35
S01012649,Very good health,210,25,7,18,36,28,19,8,42,22,7,5,2,23
S01012649,Good health,188,13,0,13,27,20,13,18,35,23,32,31,1,7
S01012649,Fair health,73,5,1,4,14,5,7,4,14,13,8,6,2,3
S01012649,Bad health,27,2,1,1,5,2,3,1,5,4,3,2,1,2
S01012649,Very bad health,7,1,1,0,1,1,0,0,0,3,1,1,0,0
S01012650,All people aged 16 to 74,466,46,11,35,112,71,47,35,60,61,15,8,7,19
S01012650,Very good health,206,26,5,21,50,32,15,17,21,25,3,1,2,17
S01012650,Good health,151,17,5,12,38,23,19,9,21,19,4,1,3,1
S01012650,Fair health,69,1,1,0,16,12,8,5,11,10,5,5,0,1
S01012650,Bad health,33,1,0,1,7,4,4,3,6,5,3,1,2,0
S01012650,Very bad health,7,1,0,1,1,0,1,1,1,2,0,0,0,0
S01012651,All people aged 16 to 74,472,10,2,8,49,49,21,46,104,140,37,22,15,16
S01012651,Very good health,190,5,0,5,25,23,7,20,43,44,13,7,6,10
S01012651,Good health,162,5,2,3,12,17,9,15,34,47,19,11,8,4
S01012651,Fair health,83,0,0,0,9,5,4,7,21,30,5,4,1,2
S01012651,Bad health,33,0,0,0,3,3,1,4,5,17,0,0,0,0
S01012651,Very bad health,4,0,0,0,0,1,0,0,1,2,0,0,0,0
S01012652,All people aged 16 to 74,828,93,28,65,225,140,50,73,100,78,20,8,12,49
S01012652,Very good health,440,44,12,32,118,67,26,38,55,42,7,2,5,43
S01012652,Good health,273,38,14,24,73,61,16,24,27,22,6,3,3,6
S01012652,Fair health,86,10,2,8,26,9,5,9,13,9,5,2,3,0
S01012652,Bad health,24,1,0,1,7,3,2,1,3,5,2,1,1,0
S01012652,Very bad health,5,0,0,0,1,0,1,1,2,0,0,0,0,0
S01012653,All people aged 16 to 74,671,26,6,20,110,67,59,61,121,108,74,52,22,45
S01012653,Very good health,298,16,5,11,53,37,28,31,47,29,21,12,9,36
S01012653,Good health,227,7,1,6,40,18,19,22,47,41,26,18,8,7
S01012653,Fair health,94,2,0,2,12,7,9,4,16,21,21,17,4,2
S01012653,Bad health,39,1,0,1,3,2,2,4,11,12,4,3,1,0
S01012653,Very bad health,13,0,0,0,2,3,1,0,0,5,2,2,0,0
S01012654,All people aged 16 to 74,576,55,13,42,136,101,67,32,74,56,22,12,10,33
S01012654,Very good health,273,33,8,25,73,46,28,15,32,18,5,3,2,23
S01012654,Good health,205,17,4,13,48,39,29,13,20,22,7,4,3,10
S01012654,Fair health,72,4,1,3,12,9,8,4,15,13,7,2,5,0
S01012654,Bad health,20,1,0,1,3,5,2,0,5,2,2,2,0,0
S01012654,Very bad health,6,0,0,0,0,2,0,0,2,1,1,1,0,0
S01012655,All people aged 16 to 74,816,36,14,22,133,111,77,71,140,144,64,46,18,40
S01012655,Very good health,356,20,7,13,71,50,32,29,53,54,16,8,8,31
S01012655,Good health,249,12,6,6,39,35,26,22,49,37,21,18,3,8
S01012655,Fair health,138,2,1,1,17,17,13,10,31,31,16,10,6,1
S01012655,Bad health,53,1,0,1,6,7,3,9,4,13,10,9,1,0
S01012655,Very bad health,20,1,0,1,0,2,3,1,3,9,1,1,0,0
S01012656,All people aged 16 to 74,595,22,5,17,90,77,43,57,124,117,37,23,14,28
S01012656,Very good health,210,13,2,11,40,35,13,26,36,26,6,4,2,15
S01012656,Good health,206,5,1,4,30,29,22,11,45,39,14,7,7,11
S01012656,Fair health,108,3,2,1,13,7,4,15,26,30,9,5,4,1
S01012656,Bad health,57,1,0,1,6,5,3,4,12,19,6,5,1,1
S01012656,Very bad health,14,0,0,0,1,1,1,1,5,3,2,2,0,0
S01012657,All people aged 16 to 74,395,11,1,10,71,64,24,27,71,80,21,13,8,26
S01012657,Very good health,181,6,1,5,33,31,6,14,36,26,8,5,3,21
S01012657,Good health,122,3,0,3,19,18,15,8,23,29,4,2,2,3
S01012657,Fair health,63,1,0,1,15,11,2,4,9,16,5,2,3,0
S01012657,Bad health,22,0,0,0,4,3,1,1,2,8,2,2,0,1
S01012657,Very bad health,7,1,0,1,0,1,0,0,1,1,2,2,0,1
S01012658,All people aged 16 to 74,747,55,13,42,178,140,59,81,106,69,18,12,6,41
S01012658,Very good health,336,26,5,21,89,62,28,30,41,24,4,2,2,32
S01012658,Good health,273,22,4,18,62,54,21,26,48,20,12,8,4,8
S01012658,Fair health,97,7,4,3,20,17,7,17,11,16,1,1,0,1
S01012658,Bad health,37,0,0,0,7,5,3,7,6,8,1,1,0,0
S01012658,Very bad health,4,0,0,0,0,2,0,1,0,1,0,0,0,0
S01012659,All people aged 16 to 74,746,82,16,66,222,128,43,55,86,56,14,9,5,60
S01012659,Very good health,433,51,8,43,141,83,22,29,34,20,9,6,3,44
S01012659,Good health,241,24,8,16,66,35,16,23,38,21,3,2,1,15
S01012659,Fair health,50,7,0,7,11,6,3,2,10,11,0,0,0,0
S01012659,Bad health,17,0,0,0,3,4,1,0,2,4,2,1,1,1
S01012659,Very bad health,5,0,0,0,1,0,1,1,2,0,0,0,0,0
S01012660,All people aged 16 to 74,532,42,7,35,102,63,29,54,102,90,24,11,13,26
S01012660,Very good health,237,21,4,17,57,29,15,23,33,30,11,5,6,18
S01012660,Good health,163,15,1,14,31,20,7,16,34,26,7,3,4,7
S01012660,Fair health,87,5,2,3,12,9,5,5,21,25,4,2,2,1
S01012660,Bad health,32,1,0,1,2,4,2,7,8,7,1,0,1,0
S01012660,Very bad health,13,0,0,0,0,1,0,3,6,2,1,1,0,0
S01012661,All people aged 16 to 74,582,51,12,39,122,87,59,50,79,80,16,8,8,38
S01012661,Very good health,300,36,11,25,58,46,28,23,32,40,7,3,4,30
S01012661,Good health,185,13,1,12,49,28,22,16,27,18,7,3,4,5
S01012661,Fair health,67,2,0,2,8,11,5,8,14,16,2,2,0,1
S01012661,Bad health,24,0,0,0,5,2,4,3,3,5,0,0,0,2
S01012661,Very bad health,6,0,0,0,2,0,0,0,3,1,0,0,0,0
S01012662,All people aged 16 to 74,567,23,7,16,85,62,44,56,120,116,26,17,9,35
S01012662,Very good health,218,11,2,9,39,36,16,21,38,28,4,3,1,25
S01012662,Good health,199,9,4,5,33,17,17,20,45,43,8,6,2,7
S01012662,Fair health,89,3,1,2,7,5,5,10,23,23,11,6,5,2
S01012662,Bad health,45,0,0,0,4,3,4,4,13,15,2,1,1,0
S01012662,Very bad health,16,0,0,0,2,1,2,1,1,7,1,1,0,1
S01012663,All people aged 16 to 74,545,39,7,32,117,88,52,49,81,71,19,10,9,29
S01012663,Very good health,239,18,3,15,54,33,23,26,27,25,6,4,2,27
S01012663,Good health,179,18,3,15,39,27,16,8,31,29,9,3,6,2
S01012663,Fair health,100,3,1,2,16,25,12,9,20,13,2,1,1,0
S01012663,Bad health,24,0,0,0,6,3,1,6,3,3,2,2,0,0
S01012663,Very bad health,3,0,0,0,2,0,0,0,0,1,0,0,0,0
S01012664,All people aged 16 to 74,691,37,9,28,128,87,72,73,111,111,31,17,14,41
S01012664,Very good health,329,17,3,14,62,53,44,37,32,45,7,1,6,32
S01012664,Good health,233,14,5,9,42,28,16,22,54,35,15,10,5,7
S01012664,Fair health,94,4,1,3,20,4,10,9,18,19,8,6,2,2
S01012664,Bad health,25,2,0,2,3,2,1,2,6,8,1,0,1,0
S01012664,Very bad health,10,0,0,0,1,0,1,3,1,4,0,0,0,0
S01012665,All people aged 16 to 74,521,10,3,7,59,62,35,49,107,130,45,30,15,24
S01012665,Very good health,181,4,1,3,25,29,8,21,33,29,14,9,5,18
S01012665,Good health,178,4,2,2,24,14,19,13,38,45,17,11,6,4
S01012665,Fair health,99,2,0,2,6,13,6,9,23,30,8,5,3,2
S01012665,Bad health,49,0,0,0,3,5,2,6,10,18,5,4,1,0
S01012665,Very bad health,14,0,0,0,1,1,0,0,3,8,1,1,0,0
S01012666,All people aged 16 to 74,497,11,6,5,56,53,27,50,106,146,36,19,17,12
S01012666,Very good health,152,6,2,4,22,17,9,15,26,41,10,5,5,6
S01012666,Good health,182,4,3,1,27,26,12,18,33,45,11,2,9,6
S01012666,Fair health,104,1,1,0,3,6,5,11,29,37,12,9,3,0
S01012666,Bad health,47,0,0,0,4,3,1,3,12,22,2,2,0,0
S01012666,Very bad health,12,0,0,0,0,1,0,3,6,1,1,1,0,0
S01012667,All people aged 16 to 74,445,12,5,7,52,50,37,51,79,86,48,25,23,30
S01012667,Very good health,170,6,2,4,23,22,16,19,28,24,15,6,9,17
S01012667,Good health,146,3,1,2,14,17,9,22,33,24,18,10,8,6
S01012667,Fair health,77,2,1,1,9,7,7,8,9,20,10,4,6,5
S01012667,Bad health,35,1,1,0,2,3,5,2,5,14,3,3,0,0
S01012667,Very bad health,17,0,0,0,4,1,0,0,4,4,2,2,0,2
S01012668,All people aged 16 to 74,547,10,2,8,76,81,44,53,95,116,42,26,16,30
S01012668,Very good health,218,4,0,4,34,39,17,19,39,32,16,9,7,18
S01012668,Good health,181,6,2,4,24,29,16,13,30,41,14,8,6,8
S01012668,Fair health,95,0,0,0,14,10,5,12,20,28,5,2,3,1
S01012668,Bad health,43,0,0,0,4,1,6,7,5,13,4,4,0,3
S01012668,Very bad health,10,0,0,0,0,2,0,2,1,2,3,3,0,0
S01012669,All people aged 16 to 74,569,38,11,27,161,102,20,47,88,60,8,5,3,45
S01012669,Very good health,294,24,9,15,85,46,6,19,43,25,6,4,2,40
S01012669,Good health,181,10,2,8,56,39,8,16,29,19,1,0,1,3
S01012669,Fair health,67,4,0,4,16,11,5,7,10,11,1,1,0,2
S01012669,Bad health,23,0,0,0,2,5,1,5,6,4,0,0,0,0
S01012669,Very bad health,4,0,0,0,2,1,0,0,0,1,0,0,0,0
S01012670,All people aged 16 to 74,545,50,10,40,136,97,34,48,81,47,14,9,5,38
S01012670,Very good health,252,19,3,16,70,49,13,16,28,18,7,3,4,32
S01012670,Good health,203,23,7,16,53,34,12,22,35,19,2,1,1,3
S01012670,Fair health,63,4,0,4,11,11,7,8,14,4,1,1,0,3
S01012670,Bad health,24,4,0,4,2,3,1,2,3,6,3,3,0,0
S01012670,Very bad health,3,0,0,0,0,0,1,0,1,0,1,1,0,0
S01012671,All people aged 16 to 74,685,14,4,10,89,82,47,73,144,158,46,29,17,32
S01012671,Very good health,306,10,2,8,53,46,23,32,61,44,13,6,7,24
S01012671,Good health,217,3,1,2,21,24,18,22,46,60,17,9,8,6
S01012671,Fair health,103,1,1,0,11,11,2,13,23,33,7,6,1,2
S01012671,Bad health,48,0,0,0,4,1,4,6,12,13,8,7,1,0
S01012671,Very bad health,11,0,0,0,0,0,0,0,2,8,1,1,0,0
S01012672,All people aged 16 to 74,547,6,3,3,52,55,25,70,121,154,45,25,20,19
S01012672,Very good health,148,2,1,1,17,15,12,14,33,32,11,9,2,12
S01012672,Good health,194,4,2,2,19,27,8,26,41,51,12,3,9,6
S01012672,Fair health,106,0,0,0,11,8,4,13,27,32,10,6,4,1
S01012672,Bad health,80,0,0,0,2,5,1,14,17,31,10,6,4,0
S01012672,Very bad health,19,0,0,0,3,0,0,3,3,8,2,1,1,0
S01012673,All people aged 16 to 74,456,7,0,7,31,52,16,54,109,122,38,20,18,27
S01012673,Very good health,164,4,0,4,11,22,7,19,37,35,11,8,3,18
S01012673,Good health,155,0,0,0,11,18,4,20,37,42,15,4,11,8
S01012673,Fair health,89,3,0,3,5,10,3,7,29,25,7,3,4,0
S01012673,Bad health,41,0,0,0,4,1,2,7,5,18,4,4,0,0
S01012673,Very bad health,7,0,0,0,0,1,0,1,1,2,1,1,0,1
S01012674,All people aged 16 to 74,414,3,2,1,49,41,18,37,77,98,68,43,25,23
S01012674,Very good health,135,2,1,1,17,13,4,10,31,22,20,11,9,16
S01012674,Good health,130,0,0,0,18,10,9,13,22,31,21,11,10,6
S01012674,Fair health,95,1,1,0,6,15,5,10,14,23,20,14,6,1
S01012674,Bad health,37,0,0,0,4,2,0,3,7,17,4,4,0,0
S01012674,Very bad health,17,0,0,0,4,1,0,1,3,5,3,3,0,0
S01012675,All people aged 16 to 74,604,12,1,11,71,64,35,54,129,159,50,33,17,30
S01012675,Very good health,215,6,0,6,36,20,16,18,37,38,25,12,13,19
S01012675,Good health,212,3,0,3,20,30,11,22,48,58,10,8,2,10
S01012675,Fair health,97,2,0,2,9,9,6,6,21,35,8,6,2,1
S01012675,Bad health,58,1,1,0,4,3,2,7,17,20,4,4,0,0
S01012675,Very bad health,22,0,0,0,2,2,0,1,6,8,3,3,0,0
S01012676,All people aged 16 to 74,595,16,4,12,90,91,36,69,114,108,32,16,16,39
S01012676,Very good health,252,8,2,6,42,40,16,24,46,36,15,7,8,25
S01012676,Good health,220,6,1,5,30,36,13,29,40,42,10,5,5,14
S01012676,Fair health,91,2,1,1,15,13,5,11,20,21,4,2,2,0
S01012676,Bad health,24,0,0,0,1,2,0,5,7,7,2,1,1,0
S01012676,Very bad health,8,0,0,0,2,0,2,0,1,2,1,1,0,0
S01012677,All people aged 16 to 74,439,12,3,9,62,48,29,42,79,112,37,24,13,18
S01012677,Very good health,156,3,1,2,28,20,14,10,26,32,11,5,6,12
S01012677,Good health,162,3,1,2,21,14,10,17,33,42,17,12,5,5
S01012677,Fair health,73,5,1,4,8,9,2,6,15,22,5,4,1,1
S01012677,Bad health,41,0,0,0,5,5,3,8,3,14,3,2,1,0
S01012677,Very bad health,7,1,0,1,0,0,0,1,2,2,1,1,0,0
S01012678,All people aged 16 to 74,553,38,8,30,151,79,47,48,69,66,16,10,6,39
S01012678,Very good health,293,18,2,16,81,37,22,29,31,35,5,2,3,35
S01012678,Good health,174,14,5,9,52,29,18,15,19,18,6,3,3,3
S01012678,Fair health,54,4,1,3,12,11,6,1,10,8,1,1,0,1
S01012678,Bad health,28,2,0,2,4,1,1,3,9,4,4,4,0,0
S01012678,Very bad health,4,0,0,0,2,1,0,0,0,1,0,0,0,0
S01012679,All people aged 16 to 74,594,39,12,27,122,79,46,56,95,114,23,13,10,20
S01012679,Very good health,257,26,7,19,59,31,22,23,42,31,8,5,3,15
S01012679,Good health,194,8,1,7,45,23,9,17,39,45,7,4,3,1
S01012679,Fair health,89,4,3,1,11,15,13,9,8,21,4,1,3,4
S01012679,Bad health,45,1,1,0,7,8,2,6,4,13,4,3,1,0
S01012679,Very bad health,9,0,0,0,0,2,0,1,2,4,0,0,0,0
S01012680,All people aged 16 to 74,406,50,4,46,104,55,30,31,53,44,10,6,4,29
S01012680,Very good health,221,31,3,28,60,28,16,12,30,16,5,2,3,23
S01012680,Good health,122,13,0,13,32,21,8,7,14,18,3,2,1,6
S01012680,Fair health,37,4,1,3,9,4,6,5,5,4,0,0,0,0
S01012680,Bad health,20,2,0,2,2,2,0,6,4,3,1,1,0,0
S01012680,Very bad health,6,0,0,0,1,0,0,1,0,3,1,1,0,0
S01012681,All people aged 16 to 74,518,22,5,17,109,81,69,35,60,70,27,13,14,45
S01012681,Very good health,244,15,4,11,57,39,27,17,22,21,12,7,5,34
S01012681,Good health,188,6,1,5,44,31,19,15,23,28,14,5,9,8
S01012681,Fair health,54,1,0,1,7,4,18,2,8,12,0,0,0,2
S01012681,Bad health,26,0,0,0,1,4,5,1,6,8,0,0,0,1
S01012681,Very bad health,6,0,0,0,0,3,0,0,1,1,1,1,0,0
S01012682,All people aged 16 to 74,520,52,15,37,120,82,45,39,77,63,13,8,5,29
S01012682,Very good health,253,35,8,27,64,48,18,17,29,21,4,1,3,17
S01012682,Good health,160,14,6,8,32,25,17,13,27,21,2,1,1,9
S01012682,Fair health,69,3,1,2,16,7,7,4,10,13,6,5,1,3
S01012682,Bad health,33,0,0,0,7,2,3,4,8,8,1,1,0,0
S01012682,Very bad health,5,0,0,0,1,0,0,1,3,0,0,0,0,0
S01012683,All people aged 16 to 74,568,35,9,26,96,72,33,51,127,74,38,16,22,42
S01012683,Very good health,238,20,7,13,48,34,17,17,38,25,12,5,7,27
S01012683,Good health,213,11,1,10,38,27,13,21,52,26,14,4,10,11
S01012683,Fair health,70,1,0,1,7,7,2,9,25,11,8,4,4,0
S01012683,Bad health,34,2,0,2,3,4,1,2,9,7,3,2,1,3
S01012683,Very bad health,13,1,1,0,0,0,0,2,3,5,1,1,0,1
S01012684,All people aged 16 to 74,406,43,10,33,104,61,36,28,48,48,19,14,5,19
S01012684,Very good health,192,26,7,19,57,31,17,13,16,15,1,0,1,16
S01012684,Good health,136,15,2,13,37,24,15,5,18,14,6,3,3,2
S01012684,Fair health,40,2,1,1,4,5,2,3,9,12,3,2,1,0
S01012684,Bad health,31,0,0,0,5,1,1,4,5,6,8,8,0,1
S01012684,Very bad health,7,0,0,0,1,0,1,3,0,1,1,1,0,0
S01012685,All people aged 16 to 74,579,24,6,18,100,76,37,48,115,106,34,11,23,39
S01012685,Very good health,249,11,4,7,53,31,19,18,48,29,12,3,9,28
S01012685,Good health,207,12,2,10,35,33,11,20,38,39,11,5,6,8
S01012685,Fair health,67,0,0,0,8,4,4,8,19,17,6,1,5,1
S01012685,Bad health,43,1,0,1,3,5,2,1,10,17,3,1,2,1
S01012685,Very bad health,13,0,0,0,1,3,1,1,0,4,2,1,1,1
S01012686,All people aged 16 to 74,711,114,22,92,201,111,69,43,68,45,22,14,8,38
S01012686,Very good health,391,76,15,61,106,63,36,25,27,21,7,6,1,30
S01012686,Good health,227,25,4,21,72,36,20,12,29,20,9,3,6,4
S01012686,Fair health,65,10,3,7,14,7,9,4,10,2,5,4,1,4
S01012686,Bad health,20,1,0,1,8,4,2,1,2,2,0,0,0,0
S01012686,Very bad health,8,2,0,2,1,1,2,1,0,0,1,1,0,0
S01012687,All people aged 16 to 74,384,73,12,61,138,65,40,12,19,10,2,2,0,25
S01012687,Very good health,211,37,7,30,79,34,17,6,8,5,0,0,0,25
S01012687,Good health,126,26,1,25,47,26,14,5,6,1,1,1,0,0
S01012687,Fair health,38,8,4,4,8,5,7,1,5,4,0,0,0,0
S01012687,Bad health,7,2,0,2,3,0,1,0,0,0,1,1,0,0
S01012687,Very bad health,2,0,0,0,1,0,1,0,0,0,0,0,0,0
S01012688,All people aged 16 to 74,591,75,16,59,159,94,44,39,62,65,23,11,12,30
S01012688,Very good health,265,40,9,31,71,37,18,14,29,24,8,1,7,24
S01012688,Good health,218,30,7,23,64,37,18,18,21,21,3,2,1,6
S01012688,Fair health,73,4,0,4,18,17,6,3,5,11,9,6,3,0
S01012688,Bad health,31,1,0,1,6,2,2,3,5,9,3,2,1,0
S01012688,Very bad health,4,0,0,0,0,1,0,1,2,0,0,0,0,0
S01012689,All people aged 16 to 74,358,64,14,50,104,31,37,24,37,30,4,3,1,27
S01012689,Very good health,210,46,8,38,57,15,19,16,20,13,2,1,1,22
S01012689,Good health,110,12,3,9,39,13,14,8,11,9,1,1,0,3
S01012689,Fair health,27,5,2,3,8,3,2,0,2,5,1,1,0,1
S01012689,Bad health,6,0,0,0,0,0,1,0,4,1,0,0,0,0
S01012689,Very bad health,5,1,1,0,0,0,1,0,0,2,0,0,0,1
S01012690,All people aged 16 to 74,391,43,9,34,101,57,26,33,59,39,12,7,5,21
S01012690,Very good health,193,27,4,23,53,27,16,14,27,12,2,1,1,15
S01012690,Good health,135,11,4,7,35,21,8,15,22,12,7,4,3,4
S01012690,Fair health,47,5,1,4,9,6,1,3,6,12,3,2,1,2
S01012690,Bad health,11,0,0,0,4,3,0,0,2,2,0,0,0,0
S01012690,Very bad health,5,0,0,0,0,0,1,1,2,1,0,0,0,0
S01012691,All people aged 16 to 74,548,106,21,85,187,63,37,34,45,16,12,9,3,48
S01012691,Very good health,314,63,12,51,119,33,18,13,18,7,4,3,1,39
S01012691,Good health,166,37,8,29,49,18,12,14,21,4,4,3,1,7
S01012691,Fair health,47,4,1,3,15,7,3,4,5,4,3,2,1,2
S01012691,Bad health,15,2,0,2,3,5,1,2,0,1,1,1,0,0
S01012691,Very bad health,6,0,0,0,1,0,3,1,1,0,0,0,0,0
S01012692,All people aged 16 to 74,557,60,14,46,132,74,38,53,82,56,29,23,6,33
S01012692,Very good health,250,39,11,28,66,33,15,24,28,20,5,4,1,20
S01012692,Good health,195,16,3,13,42,28,16,15,37,21,10,8,2,10
S01012692,Fair health,80,5,0,5,21,8,5,9,10,10,11,8,3,1
S01012692,Bad health,24,0,0,0,3,4,2,3,6,3,1,1,0,2
S01012692,Very bad health,8,0,0,0,0,1,0,2,1,2,2,2,0,0
S01012693,All people aged 16 to 74,662,131,28,103,201,98,56,26,56,20,9,2,7,65
S01012693,Very good health,415,83,20,63,133,60,24,16,26,13,3,1,2,57
S01012693,Good health,191,41,6,35,54,30,24,8,19,3,5,1,4,7
S01012693,Fair health,42,7,2,5,11,6,4,1,7,4,1,0,1,1
S01012693,Bad health,10,0,0,0,2,2,4,1,1,0,0,0,0,0
S01012693,Very bad health,4,0,0,0,1,0,0,0,3,0,0,0,0,0
S01012694,All people aged 16 to 74,328,32,7,25,82,45,23,30,66,26,7,5,2,17
S01012694,Very good health,142,22,7,15,36,19,7,11,23,8,4,3,1,12
S01012694,Good health,125,8,0,8,38,18,9,12,28,7,1,1,0,4
S01012694,Fair health,44,1,0,1,5,6,4,4,13,9,1,0,1,1
S01012694,Bad health,15,1,0,1,3,1,2,3,2,2,1,1,0,0
S01012694,Very bad health,2,0,0,0,0,1,1,0,0,0,0,0,0,0
S01012695,All people aged 16 to 74,612,58,11,47,130,75,114,33,81,66,17,10,7,38
S01012695,Very good health,317,37,6,31,84,29,55,14,32,24,8,5,3,34
S01012695,Good health,180,16,4,12,27,32,29,10,37,20,5,2,3,4
S01012695,Fair health,68,4,1,3,10,6,17,7,8,14,2,2,0,0
S01012695,Bad health,37,1,0,1,7,8,11,2,3,4,1,1,0,0
S01012695,Very bad health,10,0,0,0,2,0,2,0,1,4,1,0,1,0
S01012696,All people aged 16 to 74,702,77,19,58,128,67,126,31,67,55,56,55,1,95
S01012696,Very good health,405,55,14,41,79,40,59,23,30,29,27,26,1,63
S01012696,Good health,215,14,3,11,40,19,46,4,25,18,20,20,0,29
S01012696,Fair health,71,7,1,6,7,8,18,4,10,6,9,9,0,2
S01012696,Bad health,9,1,1,0,2,0,3,0,1,1,0,0,0,1
S01012696,Very bad health,2,0,0,0,0,0,0,0,1,1,0,0,0,0
S01012697,All people aged 16 to 74,380,53,12,41,94,39,72,26,38,27,9,8,1,22
S01012697,Very good health,208,34,7,27,53,22,34,15,18,15,1,1,0,16
S01012697,Good health,122,14,4,10,33,12,29,9,10,5,4,4,0,6
S01012697,Fair health,34,5,1,4,6,1,8,1,7,4,2,1,1,0
S01012697,Bad health,12,0,0,0,1,3,1,0,3,3,1,1,0,0
S01012697,Very bad health,4,0,0,0,1,1,0,1,0,0,1,1,0,0
S01012698,All people aged 16 to 74,590,61,12,49,168,86,74,34,85,36,19,12,7,27
S01012698,Very good health,280,33,7,26,82,35,35,20,33,15,5,4,1,22
S01012698,Good health,212,19,2,17,63,36,29,9,33,10,8,4,4,5
S01012698,Fair health,72,8,3,5,20,12,6,3,11,8,4,2,2,0
S01012698,Bad health,20,1,0,1,3,3,4,1,5,1,2,2,0,0
S01012698,Very bad health,6,0,0,0,0,0,0,1,3,2,0,0,0,0
S01012699,All people aged 16 to 74,786,99,19,80,181,99,125,50,91,65,28,18,10,48
S01012699,Very good health,387,57,14,43,103,49,54,20,32,21,10,6,4,41
S01012699,Good health,272,34,4,30,55,36,44,23,38,25,11,5,6,6
S01012699,Fair health,91,7,1,6,15,10,16,6,14,15,7,7,0,1
S01012699,Bad health,27,1,0,1,4,3,10,0,5,4,0,0,0,0
S01012699,Very bad health,9,0,0,0,4,1,1,1,2,0,0,0,0,0
S01012700,All people aged 16 to 74,614,67,24,43,139,93,67,45,89,49,13,9,4,52
S01012700,Very good health,320,42,14,28,77,31,37,23,37,22,4,3,1,47
S01012700,Good health,203,19,7,12,50,43,18,17,34,14,4,2,2,4
S01012700,Fair health,66,3,0,3,11,12,10,4,13,9,4,3,1,0
S01012700,Bad health,21,3,3,0,1,6,2,1,3,3,1,1,0,1
S01012700,Very bad health,4,0,0,0,0,1,0,0,2,1,0,0,0,0
S01012701,All people aged 16 to 74,431,53,10,43,107,90,28,34,53,24,8,6,2,34
S01012701,Very good health,243,28,7,21,60,54,14,20,25,11,2,1,1,29
S01012701,Good health,133,19,2,17,31,26,10,8,21,10,4,4,0,4
S01012701,Fair health,45,6,1,5,15,6,4,4,6,2,2,1,1,0
S01012701,Bad health,8,0,0,0,1,3,0,2,1,1,0,0,0,0
S01012701,Very bad health,2,0,0,0,0,1,0,0,0,0,0,0,0,1
S01012702,All people aged 16 to 74,451,68,13,55,121,58,42,36,45,46,14,6,8,21
S01012702,Very good health,257,51,11,40,85,25,18,13,23,20,4,1,3,18
S01012702,Good health,124,13,1,12,24,21,12,16,13,17,6,3,3,2
S01012702,Fair health,51,4,1,3,11,9,9,4,4,5,4,2,2,1
S01012702,Bad health,17,0,0,0,1,3,3,3,3,4,0,0,0,0
S01012702,Very bad health,2,0,0,0,0,0,0,0,2,0,0,0,0,0
S01012703,All people aged 16 to 74,456,43,8,35,115,61,32,37,62,45,15,7,8,46
S01012703,Very good health,281,32,6,26,77,41,18,16,26,21,8,1,7,42
S01012703,Good health,122,8,1,7,31,14,12,15,26,11,3,2,1,2
S01012703,Fair health,37,2,1,1,6,5,2,4,7,8,1,1,0,2
S01012703,Bad health,14,0,0,0,1,1,0,2,3,4,3,3,0,0
S01012703,Very bad health,2,1,0,1,0,0,0,0,0,1,0,0,0,0
S01012704,All people aged 16 to 74,563,13,7,6,67,68,39,59,118,117,52,28,24,30
S01012704,Very good health,245,7,3,4,40,38,21,19,48,35,17,7,10,20
S01012704,Good health,186,2,2,0,12,23,13,25,40,49,16,9,7,6
S01012704,Fair health,85,4,2,2,11,6,3,10,21,17,10,4,6,3
S01012704,Bad health,31,0,0,0,3,0,2,4,7,9,5,4,1,1
S01012704,Very bad health,16,0,0,0,1,1,0,1,2,7,4,4,0,0
S01012705,All people aged 16 to 74,574,73,19,54,154,111,44,44,55,33,9,8,1,51
S01012705,Very good health,341,42,9,33,97,73,17,23,30,14,4,4,0,41
S01012705,Good health,180,27,10,17,48,28,20,16,13,18,1,0,1,9
S01012705,Fair health,44,4,0,4,9,7,6,4,8,1,4,4,0,1
S01012705,Bad health,9,0,0,0,0,3,1,1,4,0,0,0,0,0
S01012705,Very bad health,0,0,0,0,0,0,0,0,0,0,0,0,0,0
S01012706,All people aged 16 to 74,516,18,6,12,58,56,29,42,125,120,35,21,14,33
S01012706,Very good health,219,8,2,6,25,26,10,18,52,40,16,5,11,24
S01012706,Good health,164,7,2,5,17,24,14,8,37,43,8,6,2,6
S01012706,Fair health,83,0,0,0,10,5,4,4,21,28,8,7,1,3
S01012706,Bad health,31,0,0,0,3,1,1,6,12,5,3,3,0,0
S01012706,Very bad health,19,3,2,1,3,0,0,6,3,4,0,0,0,0
S01012707,All people aged 16 to 74,699,93,18,75,211,132,52,42,73,31,14,9,5,51
S01012707,Very good health,362,48,7,41,111,67,28,21,24,14,4,3,1,45
S01012707,Good health,238,33,7,26,74,49,14,16,29,12,5,2,3,6
S01012707,Fair health,87,11,4,7,24,13,9,5,19,2,4,3,1,0
S01012707,Bad health,10,1,0,1,1,3,1,0,1,3,0,0,0,0
S01012707,Very bad health,2,0,0,0,1,0,0,0,0,0,1,1,0,0
S01012708,All people aged 16 to 74,548,16,4,12,85,73,32,44,105,115,44,17,27,34
S01012708,Very good health,237,10,1,9,53,32,14,22,28,34,17,3,14,27
S01012708,Good health,149,3,2,1,21,26,6,12,34,28,13,4,9,6
S01012708,Fair health,90,1,0,1,2,8,8,6,25,29,10,6,4,1
S01012708,Bad health,59,2,1,1,8,4,1,4,16,20,4,4,0,0
S01012708,Very bad health,13,0,0,0,1,3,3,0,2,4,0,0,0,0
S01012709,All people aged 16 to 74,379,22,6,16,74,71,21,37,66,51,16,7,9,21
S01012709,Very good health,149,10,2,8,33,26,3,16,19,20,6,1,5,16
S01012709,Good health,131,11,4,7,27,27,9,10,26,14,3,2,1,4
S01012709,Fair health,61,1,0,1,11,15,7,6,10,7,3,1,2,1
S01012709,Bad health,22,0,0,0,1,1,1,3,7,7,2,2,0,0
S01012709,Very bad health,16,0,0,0,2,2,1,2,4,3,2,1,1,0
S01012710,All people aged 16 to 74,534,33,11,22,102,74,42,56,99,80,24,17,7,24
S01012710,Very good health,230,17,3,14,52,39,13,19,32,31,6,5,1,21
S01012710,Good health,186,12,7,5,37,25,16,19,38,24,12,8,4,3
S01012710,Fair health,68,2,1,1,7,6,8,11,15,14,5,3,2,0
S01012710,Bad health,35,1,0,1,5,4,3,6,9,7,0,0,0,0
S01012710,Very bad health,15,1,0,1,1,0,2,1,5,4,1,1,0,0
S01012711,All people aged 16 to 74,626,30,11,19,92,70,38,61,105,143,65,37,28,22
S01012711,Very good health,220,15,4,11,48,27,8,21,37,38,11,6,5,15
S01012711,Good health,187,12,5,7,24,26,12,11,30,45,22,8,14,5
S01012711,Fair health,134,3,2,1,13,13,11,13,28,31,21,14,7,1
S01012711,Bad health,58,0,0,0,5,3,3,13,7,19,7,5,2,1
S01012711,Very bad health,27,0,0,0,2,1,4,3,3,10,4,4,0,0
S01012712,All people aged 16 to 74,613,89,14,75,180,103,43,41,67,24,16,8,8,50
S01012712,Very good health,350,57,10,47,105,58,18,23,30,8,10,4,6,41
S01012712,Good health,185,24,4,20,52,36,17,12,26,8,3,1,2,7
S01012712,Fair health,58,7,0,7,16,8,7,4,6,7,1,1,0,2
S01012712,Bad health,13,1,0,1,5,0,1,1,2,1,2,2,0,0
S01012712,Very bad health,7,0,0,0,2,1,0,1,3,0,0,0,0,0
S01012713,All people aged 16 to 74,526,69,19,50,149,94,35,33,63,39,10,6,4,34
S01012713,Very good health,274,38,6,32,85,49,19,19,23,14,2,0,2,25
S01012713,Good health,173,26,11,15,49,34,13,8,20,12,4,3,1,7
S01012713,Fair health,60,4,1,3,13,8,3,6,15,6,3,2,1,2
S01012713,Bad health,13,1,1,0,2,2,0,0,4,3,1,1,0,0
S01012713,Very bad health,6,0,0,0,0,1,0,0,1,4,0,0,0,0
S01012714,All people aged 16 to 74,441,66,13,53,140,83,33,26,46,16,8,5,3,23
S01012714,Very good health,231,30,8,22,80,40,13,15,21,8,4,2,2,20
S01012714,Good health,159,30,4,26,46,31,15,11,16,7,1,1,0,2
S01012714,Fair health,42,6,1,5,10,10,4,0,9,1,1,1,0,1
S01012714,Bad health,9,0,0,0,4,2,1,0,0,0,2,1,1,0
S01012714,Very bad health,0,0,0,0,0,0,0,0,0,0,0,0,0,0
S01012715,All people aged 16 to 74,556,49,9,40,120,93,38,46,75,77,30,13,17,28
S01012715,Very good health,241,29,2,27,61,37,16,13,25,25,13,5,8,22
S01012715,Good health,181,19,6,13,41,32,13,14,21,28,9,3,6,4
S01012715,Fair health,93,1,1,0,14,19,6,12,21,12,6,4,2,2
S01012715,Bad health,33,0,0,0,4,4,3,5,7,8,2,1,1,0
S01012715,Very bad health,8,0,0,0,0,1,0,2,1,4,0,0,0,0
S01012716,All people aged 16 to 74,611,125,25,100,179,94,66,25,44,21,15,8,7,42
S01012716,Very good health,324,80,15,65,92,49,35,7,17,6,6,2,4,32
S01012716,Good health,211,37,7,30,63,33,23,14,19,8,6,4,2,8
S01012716,Fair health,54,7,3,4,16,8,6,2,5,5,3,2,1,2
S01012716,Bad health,17,1,0,1,5,4,2,2,2,1,0,0,0,0
S01012716,Very bad health,5,0,0,0,3,0,0,0,1,1,0,0,0,0
S01012717,All people aged 16 to 74,725,73,11,62,163,125,49,50,104,88,44,24,20,29
S01012717,Very good health,308,35,5,30,82,60,21,18,38,18,18,7,11,18
S01012717,Good health,244,26,4,22,63,39,18,21,33,27,9,5,4,8
S01012717,Fair health,121,9,2,7,14,22,7,9,22,26,11,6,5,1
S01012717,Bad health,42,3,0,3,4,2,2,2,7,16,4,4,0,2
S01012717,Very bad health,10,0,0,0,0,2,1,0,4,1,2,2,0,0
S01012718,All people aged 16 to 74,726,90,19,71,219,92,52,55,93,64,23,14,9,38
S01012718,Very good health,378,66,10,56,124,47,22,22,40,20,9,5,4,28
S01012718,Good health,222,20,6,14,73,25,22,23,28,19,6,3,3,6
S01012718,Fair health,77,4,3,1,16,11,6,6,16,10,4,2,2,4
S01012718,Bad health,38,0,0,0,3,8,2,3,8,11,3,3,0,0
S01012718,Very bad health,11,0,0,0,3,1,0,1,1,4,1,1,0,0
S01012719,All people aged 16 to 74,644,66,13,53,144,94,48,48,90,70,28,12,16,56
S01012719,Very good health,309,37,10,27,80,49,17,21,37,16,7,1,6,45
S01012719,Good health,198,23,1,22,47,29,19,14,27,20,10,5,5,9
S01012719,Fair health,96,3,2,1,13,10,10,9,20,26,4,1,3,1
S01012719,Bad health,28,1,0,1,3,5,0,3,5,6,5,4,1,0
S01012719,Very bad health,13,2,0,2,1,1,2,1,1,2,2,1,1,1
S01012720,All people aged 16 to 74,447,55,8,47,105,53,33,31,57,44,23,11,12,46
S01012720,Very good health,243,40,5,35,60,40,12,11,21,12,4,0,4,43
S01012720,Good health,139,13,3,10,35,11,17,12,20,20,8,5,3,3
S01012720,Fair health,36,2,0,2,6,2,2,3,11,3,7,4,3,0
S01012720,Bad health,24,0,0,0,4,0,2,3,5,7,3,1,2,0
S01012720,Very bad health,5,0,0,0,0,0,0,2,0,2,1,1,0,0
S01012721,All people aged 16 to 74,472,28,7,21,98,76,28,42,82,77,15,10,5,26
S01012721,Very good health,209,16,5,11,54,29,14,14,29,27,6,3,3,20
S01012721,Good health,171,8,1,7,32,33,12,18,35,22,5,3,2,6
S01012721,Fair health,56,4,1,3,7,9,1,7,12,15,1,1,0,0
S01012721,Bad health,26,0,0,0,5,4,1,3,4,8,1,1,0,0
S01012721,Very bad health,10,0,0,0,0,1,0,0,2,5,2,2,0,0
S01012722,All people aged 16 to 74,576,20,3,17,68,72,20,64,121,133,47,26,21,31
S01012722,Very good health,216,11,1,10,33,28,13,28,40,27,13,6,7,23
S01012722,Good health,164,6,1,5,19,32,5,12,42,29,11,5,6,8
S01012722,Fair health,111,2,1,1,10,8,0,17,26,35,13,8,5,0
S01012722,Bad health,64,1,0,1,6,3,2,4,10,30,8,5,3,0
S01012722,Very bad health,21,0,0,0,0,1,0,3,3,12,2,2,0,0
S01012723,All people aged 16 to 74,510,14,3,11,71,64,36,49,104,103,39,26,13,30
S01012723,Very good health,194,11,3,8,36,34,16,13,26,33,6,3,3,19
S01012723,Good health,160,2,0,2,19,20,9,17,40,32,13,6,7,8
S01012723,Fair health,93,0,0,0,9,8,6,11,23,23,10,8,2,3
S01012723,Bad health,50,1,0,1,5,2,5,6,12,13,6,5,1,0
S01012723,Very bad health,13,0,0,0,2,0,0,2,3,2,4,4,0,0
S01012724,All people aged 16 to 74,551,43,7,36,134,76,41,38,110,74,15,10,5,20
S01012724,Very good health,269,35,6,29,82,44,16,15,34,26,4,1,3,13
S01012724,Good health,169,7,0,7,34,23,16,9,43,26,5,4,1,6
S01012724,Fair health,77,1,1,0,14,4,5,10,23,16,3,2,1,1
S01012724,Bad health,26,0,0,0,3,4,4,2,8,3,2,2,0,0
S01012724,Very bad health,10,0,0,0,1,1,0,2,2,3,1,1,0,0
S01012725,All people aged 16 to 74,698,73,18,55,159,115,44,55,82,85,36,21,15,49
S01012725,Very good health,356,45,13,32,96,61,22,23,35,32,9,3,6,33
S01012725,Good health,210,23,5,18,49,36,14,17,34,20,8,4,4,9
S01012725,Fair health,86,3,0,3,12,14,4,7,9,19,13,10,3,5
S01012725,Bad health,34,2,0,2,0,4,3,6,4,8,5,3,2,2
S01012725,Very bad health,12,0,0,0,2,0,1,2,0,6,1,1,0,0
S01012726,All people aged 16 to 74,431,23,4,19,65,71,29,36,87,71,24,12,12,25
S01012726,Very good health,198,14,3,11,32,39,9,15,36,26,8,4,4,19
S01012726,Good health,149,6,1,5,22,23,11,12,34,26,11,5,6,4
S01012726,Fair health,55,3,0,3,9,6,8,6,9,12,0,0,0,2
S01012726,Bad health,20,0,0,0,1,2,1,2,4,6,4,2,2,0
S01012726,Very bad health,9,0,0,0,1,1,0,1,4,1,1,1,0,0
S01012727,All people aged 16 to 74,528,8,2,6,75,49,25,58,110,117,62,43,19,24
S01012727,Very good health,188,3,0,3,35,18,11,21,34,31,17,13,4,18
S01012727,Good health,175,4,2,2,22,17,13,20,42,34,20,11,9,3
S01012727,Fair health,98,0,0,0,12,7,1,7,22,27,19,13,6,3
S01012727,Bad health,52,1,0,1,4,6,0,6,9,21,5,5,0,0
S01012727,Very bad health,15,0,0,0,2,1,0,4,3,4,1,1,0,0
S01012728,All people aged 16 to 74,556,11,3,8,68,63,27,39,131,129,64,36,28,24
S01012728,Very good health,191,4,1,3,28,25,7,8,57,31,16,9,7,15
S01012728,Good health,190,6,2,4,19,22,10,13,38,53,25,10,15,4
S01012728,Fair health,110,1,0,1,14,9,7,7,23,26,18,12,6,5
S01012728,Bad health,52,0,0,0,5,6,3,9,9,15,5,5,0,0
S01012728,Very bad health,13,0,0,0,2,1,0,2,4,4,0,0,0,0
S01012729,All people aged 16 to 74,638,53,9,44,147,95,46,66,98,61,25,16,9,47
S01012729,Very good health,300,33,5,28,77,44,15,31,29,22,9,5,4,40
S01012729,Good health,217,14,3,11,51,37,16,23,38,24,8,3,5,6
S01012729,Fair health,70,5,1,4,12,7,8,8,17,9,3,3,0,1
S01012729,Bad health,40,1,0,1,6,6,3,2,12,5,5,5,0,0
S01012729,Very bad health,11,0,0,0,1,1,4,2,2,1,0,0,0,0
S01012730,All people aged 16 to 74,428,13,5,8,56,51,23,42,102,93,28,14,14,20
S01012730,Very good health,175,6,1,5,27,21,7,19,35,37,10,6,4,13
S01012730,Good health,141,5,3,2,19,19,10,18,37,20,7,4,3,6
S01012730,Fair health,78,1,1,0,8,8,4,4,22,22,8,3,5,1
S01012730,Bad health,23,1,0,1,1,3,2,1,4,9,2,1,1,0
S01012730,Very bad health,11,0,0,0,1,0,0,0,4,5,1,0,1,0
S01012731,All people aged 16 to 74,571,21,2,19,80,82,30,63,116,124,35,24,11,20
S01012731,Very good health,240,13,1,12,44,32,10,24,50,42,9,6,3,16
S01012731,Good health,192,7,0,7,23,35,11,23,35,43,12,7,5,3
S01012731,Fair health,97,1,1,0,10,9,7,13,25,21,10,7,3,1
S01012731,Bad health,38,0,0,0,3,6,2,3,6,14,4,4,0,0
S01012731,Very bad health,4,0,0,0,0,0,0,0,0,4,0,0,0,0
S01012732,All people aged 16 to 74,520,26,7,19,67,77,25,54,121,101,29,10,19,20
S01012732,Very good health,225,15,5,10,29,28,16,21,45,42,14,5,9,15
S01012732,Good health,174,8,1,7,25,27,5,16,47,34,7,2,5,5
S01012732,Fair health,82,3,1,2,8,12,4,11,21,17,6,1,5,0
S01012732,Bad health,31,0,0,0,5,7,0,4,6,7,2,2,0,0
S01012732,Very bad health,8,0,0,0,0,3,0,2,2,1,0,0,0,0
S01012733,All people aged 16 to 74,755,107,24,83,237,133,78,44,60,33,6,3,3,57
S01012733,Very good health,489,73,14,59,172,83,51,25,27,14,1,0,1,43
S01012733,Good health,204,31,9,22,57,36,17,13,22,13,5,3,2,10
S01012733,Fair health,46,3,1,2,7,11,8,6,4,4,0,0,0,3
S01012733,Bad health,13,0,0,0,1,2,2,0,7,1,0,0,0,0
S01012733,Very bad health,3,0,0,0,0,1,0,0,0,1,0,0,0,1
S01012734,All people aged 16 to 74,422,83,17,66,140,60,28,29,27,15,3,1,2,37
S01012734,Very good health,308,65,13,52,105,49,18,20,14,6,1,0,1,30
S01012734,Good health,89,18,4,14,27,7,8,8,9,5,1,0,1,6
S01012734,Fair health,18,0,0,0,6,2,1,1,4,2,1,1,0,1
S01012734,Bad health,4,0,0,0,0,1,1,0,0,2,0,0,0,0
S01012734,Very bad health,3,0,0,0,2,1,0,0,0,0,0,0,0,0
S01012735,All people aged 16 to 74,376,17,2,15,51,58,13,44,71,79,21,11,10,22
S01012735,Very good health,148,6,1,5,30,25,5,10,23,23,10,6,4,16
S01012735,Good health,134,8,1,7,16,18,3,18,30,31,5,1,4,5
S01012735,Fair health,57,2,0,2,2,7,4,12,11,13,5,3,2,1
S01012735,Bad health,29,1,0,1,3,5,1,3,5,10,1,1,0,0
S01012735,Very bad health,8,0,0,0,0,3,0,1,2,2,0,0,0,0
S01012736,All people aged 16 to 74,707,45,10,35,144,116,34,77,137,94,27,21,6,33
S01012736,Very good health,337,20,3,17,83,54,15,37,59,39,8,5,3,22
S01012736,Good health,237,16,5,11,44,39,14,26,45,31,13,11,2,9
S01012736,Fair health,81,6,1,5,10,15,3,8,20,14,3,2,1,2
S01012736,Bad health,42,3,1,2,7,7,2,6,8,7,2,2,0,0
S01012736,Very bad health,10,0,0,0,0,1,0,0,5,3,1,1,0,0
S01012737,All people aged 16 to 74,608,50,8,42,139,104,42,57,97,67,20,14,6,32
S01012737,Very good health,324,27,6,21,90,64,21,23,39,25,10,7,3,25
S01012737,Good health,175,17,1,16,31,30,15,20,33,16,7,4,3,6
S01012737,Fair health,74,6,1,5,9,7,5,9,18,18,1,1,0,1
S01012737,Bad health,23,0,0,0,3,2,1,3,7,6,1,1,0,0
S01012737,Very bad health,12,0,0,0,6,1,0,2,0,2,1,1,0,0
S01012738,All people aged 16 to 74,474,15,1,14,75,54,33,51,85,93,33,22,11,35
S01012738,Very good health,212,5,0,5,40,27,6,19,37,33,16,8,8,29
S01012738,Good health,153,9,0,9,24,16,17,18,27,29,8,5,3,5
S01012738,Fair health,55,0,0,0,6,6,8,7,11,13,4,4,0,0
S01012738,Bad health,44,0,0,0,3,5,1,6,8,15,5,5,0,1
S01012738,Very bad health,10,1,1,0,2,0,1,1,2,3,0,0,0,0
S01012739,All people aged 16 to 74,612,111,18,93,174,102,64,34,41,27,13,7,6,46
S01012739,Very good health,367,72,11,61,114,54,25,14,28,18,6,3,3,36
S01012739,Good health,199,31,2,29,53,39,31,16,7,8,5,2,3,9
S01012739,Fair health,37,7,4,3,6,7,8,1,5,1,1,1,0,1
S01012739,Bad health,5,1,1,0,1,2,0,0,1,0,0,0,0,0
S01012739,Very bad health,4,0,0,0,0,0,0,3,0,0,1,1,0,0
S01012740,All people aged 16 to 74,621,90,16,74,180,87,62,42,62,43,14,6,8,41
S01012740,Very good health,373,65,12,53,113,53,32,19,33,20,5,1,4,33
S01012740,Good health,189,22,3,19,56,28,27,12,20,10,7,3,4,7
S01012740,Fair health,41,2,1,1,10,6,3,5,9,5,0,0,0,1
S01012740,Bad health,12,0,0,0,1,0,0,2,0,7,2,2,0,0
S01012740,Very bad health,6,1,0,1,0,0,0,4,0,1,0,0,0,0
S01012741,All people aged 16 to 74,471,58,15,43,133,98,29,29,53,34,5,1,4,32
S01012741,Very good health,261,39,11,28,78,50,15,12,19,19,3,1,2,26
S01012741,Good health,154,14,4,10,40,35,13,12,23,9,2,0,2,6
S01012741,Fair health,48,5,0,5,14,10,1,3,9,6,0,0,0,0
S01012741,Bad health,7,0,0,0,0,3,0,2,2,0,0,0,0,0
S01012741,Very bad health,1,0,0,0,1,0,0,0,0,0,0,0,0,0
S01012742,All people aged 16 to 74,551,67,13,54,163,112,40,32,66,31,7,6,1,33
S01012742,Very good health,319,42,7,35,100,65,14,18,32,13,5,4,1,30
S01012742,Good health,176,23,5,18,50,40,19,9,21,11,0,0,0,3
S01012742,Fair health,43,1,1,0,9,6,6,3,9,7,2,2,0,0
S01012742,Bad health,9,0,0,0,3,1,1,2,2,0,0,0,0,0
S01012742,Very bad health,4,1,0,1,1,0,0,0,2,0,0,0,0,0
S01012743,All people aged 16 to 74,449,43,9,34,130,92,31,35,54,21,1,1,0,42
S01012743,Very good health,233,22,4,18,74,44,10,15,25,7,1,1,0,35
S01012743,Good health,161,16,3,13,39,36,18,15,21,10,0,0,0,6
S01012743,Fair health,40,3,2,1,15,8,1,4,7,1,0,0,0,1
S01012743,Bad health,14,2,0,2,2,4,1,1,1,3,0,0,0,0
S01012743,Very bad health,1,0,0,0,0,0,1,0,0,0,0,0,0,0
S01012744,All people aged 16 to 74,556,78,12,66,141,111,37,50,50,45,11,5,6,33
S01012744,Very good health,302,51,6,45,82,60,12,24,23,19,3,2,1,28
S01012744,Good health,175,22,5,17,47,34,15,16,18,15,4,0,4,4
S01012744,Fair health,54,4,1,3,8,13,7,7,7,6,2,1,1,0
S01012744,Bad health,21,1,0,1,4,4,2,2,2,4,1,1,0,1
S01012744,Very bad health,4,0,0,0,0,0,1,1,0,1,1,1,0,0
S01012745,All people aged 16 to 74,532,72,16,56,129,101,41,42,60,36,16,10,6,35
S01012745,Very good health,266,41,12,29,65,53,20,19,22,11,6,3,3,29
S01012745,Good health,208,25,3,22,54,35,15,18,30,17,9,6,3,5
S01012745,Fair health,44,5,1,4,5,11,4,4,6,8,1,1,0,0
S01012745,Bad health,12,1,0,1,5,2,0,1,2,0,0,0,0,1
S01012745,Very bad health,2,0,0,0,0,0,2,0,0,0,0,0,0,0
S01012746,All people aged 16 to 74,614,61,16,45,155,97,46,50,81,64,16,9,7,44
S01012746,Very good health,333,40,9,31,93,53,23,24,38,28,6,2,4,28
S01012746,Good health,198,19,6,13,49,35,16,14,26,21,7,4,3,11
S01012746,Fair health,50,2,1,1,10,6,6,5,7,7,3,3,0,4
S01012746,Bad health,26,0,0,0,1,2,1,6,7,8,0,0,0,1
S01012746,Very bad health,7,0,0,0,2,1,0,1,3,0,0,0,0,0
S01012747,All people aged 16 to 74,629,34,5,29,119,87,37,49,115,96,42,25,17,50
S01012747,Very good health,283,19,2,17,53,42,13,17,55,31,16,12,4,37
S01012747,Good health,227,15,3,12,48,33,15,19,37,36,14,8,6,10
S01012747,Fair health,77,0,0,0,8,8,6,10,16,17,9,3,6,3
S01012747,Bad health,34,0,0,0,9,3,2,3,6,9,2,1,1,0
S01012747,Very bad health,8,0,0,0,1,1,1,0,1,3,1,1,0,0
S01012748,All people aged 16 to 74,591,11,3,8,60,52,28,52,127,159,64,43,21,38
S01012748,Very good health,217,4,0,4,20,22,10,17,53,49,15,8,7,27
S01012748,Good health,179,3,2,1,25,18,10,14,35,49,18,11,7,7
S01012748,Fair health,109,2,0,2,8,7,4,14,26,31,14,10,4,3
S01012748,Bad health,65,2,1,1,7,4,4,5,11,21,10,7,3,1
S01012748,Very bad health,21,0,0,0,0,1,0,2,2,9,7,7,0,0
S01012749,All people aged 16 to 74,645,8,2,6,74,66,44,63,126,125,87,52,35,52
S01012749,Very good health,254,2,0,2,35,32,17,25,46,44,22,11,11,31
S01012749,Good health,240,2,0,2,27,20,22,22,51,43,38,22,16,15
S01012749,Fair health,92,4,2,2,8,9,3,8,20,18,19,11,8,3
S01012749,Bad health,48,0,0,0,4,5,2,7,6,14,7,7,0,3
S01012749,Very bad health,11,0,0,0,0,0,0,1,3,6,1,1,0,0
S01012750,All people aged 16 to 74,588,11,5,6,52,61,27,41,155,136,65,33,32,40
S01012750,Very good health,225,6,3,3,30,27,17,12,45,45,19,14,5,24
S01012750,Good health,207,5,2,3,12,22,4,16,75,44,17,7,10,12
S01012750,Fair health,94,0,0,0,6,8,3,9,20,24,22,7,15,2
S01012750,Bad health,45,0,0,0,4,3,2,2,8,18,7,5,2,1
S01012750,Very bad health,17,0,0,0,0,1,1,2,7,5,0,0,0,1
S01012751,All people aged 16 to 74,596,19,5,14,83,84,26,66,138,115,45,22,23,20
S01012751,Very good health,216,12,4,8,35,48,8,25,37,27,11,6,5,13
S01012751,Good health,202,2,0,2,34,22,11,27,47,34,20,7,13,5
S01012751,Fair health,116,3,1,2,11,7,3,7,39,36,9,5,4,1
S01012751,Bad health,43,1,0,1,3,3,2,4,12,14,3,2,1,1
S01012751,Very bad health,19,1,0,1,0,4,2,3,3,4,2,2,0,0
S01012752,All people aged 16 to 74,638,42,9,33,113,69,39,63,116,122,38,18,20,36
S01012752,Very good health,297,30,7,23,70,37,20,17,40,47,15,6,9,21
S01012752,Good health,207,8,2,6,30,20,10,32,43,33,16,7,9,15
S01012752,Fair health,76,3,0,3,6,9,7,6,18,23,4,2,2,0
S01012752,Bad health,47,0,0,0,6,3,1,5,13,17,2,2,0,0
S01012752,Very bad health,11,1,0,1,1,0,1,3,2,2,1,1,0,0
S01012753,All people aged 16 to 74,371,12,6,6,41,35,18,36,84,97,32,20,12,16
S01012753,Very good health,131,7,4,3,18,13,5,14,30,24,9,5,4,11
S01012753,Good health,126,1,0,1,13,12,6,8,32,35,14,6,8,5
S01012753,Fair health,67,2,0,2,6,6,5,9,14,22,3,3,0,0
S01012753,Bad health,36,2,2,0,3,3,1,5,6,12,4,4,0,0
S01012753,Very bad health,11,0,0,0,1,1,1,0,2,4,2,2,0,0
S01012754,All people aged 16 to 74,438,21,1,20,68,47,27,46,82,91,30,18,12,26
S01012754,Very good health,166,15,1,14,27,20,8,12,26,26,15,9,6,17
S01012754,Good health,131,5,0,5,21,14,10,16,25,27,8,4,4,5
S01012754,Fair health,78,1,0,1,13,7,5,7,19,21,5,3,2,0
S01012754,Bad health,50,0,0,0,5,5,3,9,10,12,2,2,0,4
S01012754,Very bad health,13,0,0,0,2,1,1,2,2,5,0,0,0,0
S01012755,All people aged 16 to 74,387,13,3,10,48,50,15,33,95,71,44,32,12,18
S01012755,Very good health,121,6,1,5,24,17,0,9,24,16,10,8,2,15
S01012755,Good health,115,5,1,4,14,19,5,9,26,19,16,8,8,2
S01012755,Fair health,81,1,1,0,7,7,4,5,29,18,9,8,1,1
S01012755,Bad health,50,1,0,1,2,7,5,6,10,13,6,5,1,0
S01012755,Very bad health,20,0,0,0,1,0,1,4,6,5,3,3,0,0
S01012756,All people aged 16 to 74,378,15,6,9,57,65,25,39,74,66,26,23,3,11
S01012756,Very good health,141,6,2,4,25,24,12,11,34,16,3,2,1,10
S01012756,Good health,108,8,4,4,16,21,5,15,14,20,9,8,1,0
S01012756,Fair health,78,1,0,1,10,14,3,6,16,17,11,10,1,0
S01012756,Bad health,38,0,0,0,4,4,5,6,8,8,2,2,0,1
S01012756,Very bad health,13,0,0,0,2,2,0,1,2,5,1,1,0,0
S01012757,All people aged 16 to 74,359,7,2,5,49,42,26,33,75,94,18,11,7,15
S01012757,Very good health,136,3,1,2,24,24,8,16,24,24,4,1,3,9
S01012757,Good health,103,2,1,1,12,11,8,8,26,29,4,3,1,3
S01012757,Fair health,70,0,0,0,8,6,3,4,16,22,8,6,2,3
S01012757,Bad health,45,2,0,2,4,0,7,5,8,17,2,1,1,0
S01012757,Very bad health,5,0,0,0,1,1,0,0,1,2,0,0,0,0
S01012758,All people aged 16 to 74,450,31,6,25,75,70,38,32,80,61,31,20,11,32
S01012758,Very good health,211,17,1,16,33,41,23,15,31,12,12,7,5,27
S01012758,Good health,134,7,2,5,28,17,9,11,27,21,10,6,4,4
S01012758,Fair health,60,5,2,3,4,9,4,1,16,19,2,1,1,0
S01012758,Bad health,31,2,1,1,5,2,2,4,3,7,5,4,1,1
S01012758,Very bad health,14,0,0,0,5,1,0,1,3,2,2,2,0,0
S01012759,All people aged 16 to 74,549,12,1,11,66,67,27,52,134,110,51,37,14,30
S01012759,Very good health,185,8,1,7,25,21,11,21,38,31,11,10,1,19
S01012759,Good health,206,3,0,3,24,28,8,19,58,35,23,13,10,8
S01012759,Fair health,93,1,0,1,12,11,4,8,24,19,12,9,3,2
S01012759,Bad health,46,0,0,0,4,7,4,4,8,15,3,3,0,1
S01012759,Very bad health,19,0,0,0,1,0,0,0,6,10,2,2,0,0
S01012760,All people aged 16 to 74,696,20,9,11,100,104,29,67,123,130,72,47,25,51
S01012760,Very good health,265,11,4,7,51,39,11,27,42,28,19,13,6,37
S01012760,Good health,227,6,4,2,34,38,12,13,41,50,23,11,12,10
S01012760,Fair health,121,2,1,1,9,19,4,14,20,28,21,14,7,4
S01012760,Bad health,56,0,0,0,4,4,2,9,12,16,9,9,0,0
S01012760,Very bad health,27,1,0,1,2,4,0,4,8,8,0,0,0,0
S01012761,All people aged 16 to 74,599,32,8,24,90,93,40,69,101,104,39,17,22,31
S01012761,Very good health,236,9,3,6,43,40,16,30,34,31,9,3,6,24
S01012761,Good health,204,19,3,16,31,34,15,21,35,32,10,2,8,7
S01012761,Fair health,111,3,2,1,14,12,5,15,23,24,15,8,7,0
S01012761,Bad health,39,1,0,1,2,7,2,3,9,11,4,3,1,0
S01012761,Very bad health,9,0,0,0,0,0,2,0,0,6,1,1,0,0
S01012762,All people aged 16 to 74,567,25,6,19,91,93,32,74,108,93,18,10,8,33
S01012762,Very good health,240,13,5,8,37,45,7,26,52,26,5,3,2,29
S01012762,Good health,200,12,1,11,35,27,16,26,36,39,5,2,3,4
S01012762,Fair health,97,0,0,0,15,17,6,12,16,25,6,4,2,0
S01012762,Bad health,24,0,0,0,2,3,3,7,4,3,2,1,1,0
S01012762,Very bad health,6,0,0,0,2,1,0,3,0,0,0,0,0,0
S01012763,All people aged 16 to 74,326,11,6,5,46,33,14,38,76,67,22,17,5,19
S01012763,Very good health,124,2,2,0,25,17,6,14,23,18,6,5,1,13
S01012763,Good health,115,7,2,5,14,12,6,14,30,20,7,4,3,5
S01012763,Fair health,53,2,2,0,5,3,2,4,11,20,5,4,1,1
S01012763,Bad health,27,0,0,0,2,0,0,6,10,6,3,3,0,0
S01012763,Very bad health,7,0,0,0,0,1,0,0,2,3,1,1,0,0
S01012764,All people aged 16 to 74,569,26,10,16,87,83,27,56,102,117,35,24,11,36
S01012764,Very good health,234,11,4,7,49,38,8,28,34,30,11,7,4,25
S01012764,Good health,179,9,4,5,22,32,8,14,28,46,11,7,4,9
S01012764,Fair health,105,5,2,3,11,7,8,8,31,24,9,6,3,2
S01012764,Bad health,36,0,0,0,5,2,2,5,8,11,3,3,0,0
S01012764,Very bad health,15,1,0,1,0,4,1,1,1,6,1,1,0,0
S01012765,All people aged 16 to 74,553,30,8,22,113,67,32,52,111,84,29,20,9,35
S01012765,Very good health,248,15,3,12,64,35,11,25,35,23,12,8,4,28
S01012765,Good health,170,13,4,9,30,17,13,16,46,28,3,1,2,4
S01012765,Fair health,77,1,1,0,12,13,6,9,17,15,2,1,1,2
S01012765,Bad health,39,0,0,0,5,2,1,2,8,12,8,6,2,1
S01012765,Very bad health,19,1,0,1,2,0,1,0,5,6,4,4,0,0
S01012766,All people aged 16 to 74,642,29,10,19,102,86,40,76,124,107,40,20,20,38
S01012766,Very good health,299,20,7,13,66,51,15,31,40,38,12,6,6,26
S01012766,Good health,196,6,2,4,25,26,9,31,49,27,12,4,8,11
S01012766,Fair health,84,3,1,2,7,5,12,9,19,20,8,5,3,1
S01012766,Bad health,45,0,0,0,4,3,1,4,13,13,7,5,2,0
S01012766,Very bad health,18,0,0,0,0,1,3,1,3,9,1,0,1,0
S01012767,All people aged 16 to 74,458,34,8,26,109,78,32,45,77,50,7,5,2,26
S01012767,Very good health,233,19,5,14,58,40,13,21,34,24,3,3,0,21
S01012767,Good health,155,13,3,10,35,28,11,15,26,21,2,1,1,4
S01012767,Fair health,49,2,0,2,11,8,7,6,11,2,1,0,1,1
S01012767,Bad health,18,0,0,0,4,1,1,3,5,3,1,1,0,0
S01012767,Very bad health,3,0,0,0,1,1,0,0,1,0,0,0,0,0
S01012768,All people aged 16 to 74,592,39,8,31,127,132,37,68,103,49,6,4,2,31
S01012768,Very good health,260,10,2,8,58,57,20,26,42,17,2,1,1,28
S01012768,Good health,227,24,5,19,48,52,13,30,36,18,3,2,1,3
S01012768,Fair health,74,2,0,2,16,15,3,10,20,7,1,1,0,0
S01012768,Bad health,23,3,1,2,3,7,1,2,2,5,0,0,0,0
S01012768,Very bad health,8,0,0,0,2,1,0,0,3,2,0,0,0,0
S01012769,All people aged 16 to 74,342,41,9,32,88,50,31,21,42,35,10,8,2,24
S01012769,Very good health,196,25,7,18,55,26,15,12,21,15,3,1,2,24
S01012769,Good health,97,13,2,11,26,16,10,4,13,12,3,3,0,0
S01012769,Fair health,34,3,0,3,4,6,5,3,5,7,1,1,0,0
S01012769,Bad health,11,0,0,0,2,1,0,1,3,1,3,3,0,0
S01012769,Very bad health,4,0,0,0,1,1,1,1,0,0,0,0,0,0
S01012770,All people aged 16 to 74,628,29,5,24,121,110,37,58,113,96,27,17,10,37
S01012770,Very good health,273,18,2,16,56,55,16,24,33,34,10,4,6,27
S01012770,Good health,207,7,1,6,47,28,14,25,39,30,10,7,3,7
S01012770,Fair health,87,1,1,0,9,14,5,7,25,22,2,2,0,2
S01012770,Bad health,46,2,0,2,7,10,1,2,12,9,2,1,1,1
S01012770,Very bad health,15,1,1,0,2,3,1,0,4,1,3,3,0,0
S01012771,All people aged 16 to 74,554,46,9,37,104,72,28,48,100,78,38,22,16,40
S01012771,Very good health,234,29,7,22,50,40,12,14,25,23,14,8,6,27
S01012771,Good health,186,10,2,8,45,17,10,20,37,24,11,3,8,12
S01012771,Fair health,90,7,0,7,8,11,4,9,21,24,6,4,2,0
S01012771,Bad health,35,0,0,0,0,4,2,3,13,7,5,5,0,1
S01012771,Very bad health,9,0,0,0,1,0,0,2,4,0,2,2,0,0
S01012772,All people aged 16 to 74,505,8,3,5,46,67,28,56,116,119,36,22,14,29
S01012772,Very good health,198,7,3,4,19,24,8,16,42,44,14,8,6,24
S01012772,Good health,152,1,0,1,11,23,9,20,44,31,9,5,4,4
S01012772,Fair health,93,0,0,0,12,13,5,15,16,23,9,5,4,0
S01012772,Bad health,48,0,0,0,2,7,6,3,11,17,1,1,0,1
S01012772,Very bad health,14,0,0,0,2,0,0,2,3,4,3,3,0,0
S01012773,All people aged 16 to 74,674,35,7,28,110,93,45,64,135,126,39,25,14,27
S01012773,Very good health,300,22,6,16,56,42,22,31,51,40,16,11,5,20
S01012773,Good health,204,7,0,7,33,32,17,21,43,36,11,4,7,4
S01012773,Fair health,107,4,0,4,14,14,4,8,25,28,8,6,2,2
S01012773,Bad health,50,2,1,1,4,5,1,3,11,20,4,4,0,0
S01012773,Very bad health,13,0,0,0,3,0,1,1,5,2,0,0,0,1
S01012774,All people aged 16 to 74,676,41,14,27,121,99,36,69,125,101,45,24,21,39
S01012774,Very good health,287,25,9,16,48,44,12,31,46,40,11,6,5,30
S01012774,Good health,244,12,4,8,54,36,10,22,55,30,17,5,12,8
S01012774,Fair health,96,3,1,2,10,14,11,12,15,19,11,8,3,1
S01012774,Bad health,37,1,0,1,8,3,2,4,5,10,4,3,1,0
S01012774,Very bad health,12,0,0,0,1,2,1,0,4,2,2,2,0,0
S01012775,All people aged 16 to 74,329,18,4,14,62,47,28,28,72,36,22,10,12,16
S01012775,Very good health,159,12,1,11,34,21,12,15,33,11,7,3,4,14
S01012775,Good health,107,5,3,2,24,14,12,7,23,14,6,2,4,2
S01012775,Fair health,44,1,0,1,3,5,3,5,14,7,6,2,4,0
S01012775,Bad health,14,0,0,0,1,6,1,1,1,3,1,1,0,0
S01012775,Very bad health,5,0,0,0,0,1,0,0,1,1,2,2,0,0
S01012776,All people aged 16 to 74,594,13,0,13,71,71,26,57,142,136,42,18,24,36
S01012776,Very good health,224,7,0,7,34,34,12,23,45,34,8,2,6,27
S01012776,Good health,218,5,0,5,28,26,11,22,53,48,16,6,10,9
S01012776,Fair health,82,1,0,1,6,9,2,7,21,24,12,4,8,0
S01012776,Bad health,53,0,0,0,3,2,1,3,15,23,6,6,0,0
S01012776,Very bad health,17,0,0,0,0,0,0,2,8,7,0,0,0,0
S01012777,All people aged 16 to 74,699,50,10,40,167,114,51,72,104,57,30,25,5,54
S01012777,Very good health,409,33,5,28,108,64,33,39,56,25,9,5,4,42
S01012777,Good health,198,14,4,10,50,34,15,20,27,16,13,12,1,9
S01012777,Fair health,65,2,1,1,7,9,2,9,16,12,5,5,0,3
S01012777,Bad health,22,0,0,0,1,6,1,3,5,4,2,2,0,0
S01012777,Very bad health,5,1,0,1,1,1,0,1,0,0,1,1,0,0
S01012778,All people aged 16 to 74,527,31,7,24,95,84,24,41,76,87,48,34,14,41
S01012778,Very good health,258,19,5,14,60,48,11,21,28,23,16,8,8,32
S01012778,Good health,142,9,2,7,21,27,6,8,26,29,9,6,3,7
S01012778,Fair health,78,2,0,2,11,3,5,9,14,18,14,12,2,2
S01012778,Bad health,36,0,0,0,3,5,2,2,5,12,7,6,1,0
S01012778,Very bad health,13,1,0,1,0,1,0,1,3,5,2,2,0,0
S01012779,All people aged 16 to 74,332,15,3,12,51,36,20,27,61,67,35,19,16,20
S01012779,Very good health,149,12,2,10,28,17,10,9,29,19,12,7,5,13
S01012779,Good health,100,2,1,1,13,10,8,11,13,24,13,7,6,6
S01012779,Fair health,52,1,0,1,5,4,1,4,15,14,7,2,5,1
S01012779,Bad health,28,0,0,0,5,5,1,2,3,9,3,3,0,0
S01012779,Very bad health,3,0,0,0,0,0,0,1,1,1,0,0,0,0
S01012780,All people aged 16 to 74,524,17,5,12,64,59,26,45,126,98,57,34,23,32
S01012780,Very good health,221,14,4,10,32,28,14,18,50,26,13,6,7,26
S01012780,Good health,164,2,0,2,20,21,9,16,37,39,17,8,9,3
S01012780,Fair health,89,1,1,0,5,8,2,7,29,17,18,12,6,2
S01012780,Bad health,31,0,0,0,3,1,1,3,9,10,3,3,0,1
S01012780,Very bad health,19,0,0,0,4,1,0,1,1,6,6,5,1,0
S01012781,All people aged 16 to 74,514,31,5,26,133,74,48,42,78,51,17,10,7,40
S01012781,Very good health,224,17,2,15,67,34,18,18,30,12,6,3,3,22
S01012781,Good health,183,10,1,9,46,22,19,17,25,25,4,2,2,15
S01012781,Fair health,73,3,2,1,13,14,5,6,16,10,5,3,2,1
S01012781,Bad health,30,1,0,1,6,4,5,1,7,3,1,1,0,2
S01012781,Very bad health,4,0,0,0,1,0,1,0,0,1,1,1,0,0
S01012782,All people aged 16 to 74,464,6,1,5,41,62,22,41,105,110,54,33,21,23
S01012782,Very good health,171,2,1,1,15,34,6,17,44,26,11,7,4,16
S01012782,Good health,140,2,0,2,17,12,8,11,34,29,23,12,11,4
S01012782,Fair health,85,1,0,1,5,10,5,7,18,27,10,5,5,2
S01012782,Bad health,48,1,0,1,4,3,3,4,8,19,5,4,1,1
S01012782,Very bad health,20,0,0,0,0,3,0,2,1,9,5,5,0,0
S01012783,All people aged 16 to 74,524,12,2,10,54,59,26,54,115,116,59,34,25,29
S01012783,Very good health,196,4,1,3,28,26,7,21,39,37,14,7,7,20
S01012783,Good health,171,5,0,5,9,25,13,19,36,37,19,10,9,8
S01012783,Fair health,92,1,0,1,11,5,3,8,21,25,18,11,7,0
S01012783,Bad health,48,2,1,1,5,0,3,3,19,10,5,4,1,1
S01012783,Very bad health,17,0,0,0,1,3,0,3,0,7,3,2,1,0
S01012784,All people aged 16 to 74,565,22,3,19,94,80,21,65,121,103,34,16,18,25
S01012784,Very good health,243,10,0,10,53,41,6,27,45,32,16,4,12,13
S01012784,Good health,192,6,2,4,24,30,7,17,45,45,10,6,4,8
S01012784,Fair health,83,2,0,2,10,6,6,12,19,18,6,4,2,4
S01012784,Bad health,38,4,1,3,4,2,2,6,11,7,2,2,0,0
S01012784,Very bad health,9,0,0,0,3,1,0,3,1,1,0,0,0,0
S01012785,All people aged 16 to 74,543,10,3,7,61,52,30,55,131,123,67,39,28,14
S01012785,Very good health,194,7,2,5,23,27,9,17,54,28,19,13,6,10
S01012785,Good health,182,1,1,0,23,14,10,15,50,47,19,8,11,3
S01012785,Fair health,111,1,0,1,10,9,4,14,18,31,23,12,11,1
S01012785,Bad health,37,1,0,1,4,0,6,7,6,12,1,1,0,0
S01012785,Very bad health,19,0,0,0,1,2,1,2,3,5,5,5,0,0
S01012786,All people aged 16 to 74,551,10,1,9,55,59,21,59,117,104,75,38,37,51
S01012786,Very good health,182,2,0,2,19,26,7,18,30,25,21,10,11,34
S01012786,Good health,183,5,1,4,18,17,6,18,55,29,26,11,15,9
S01012786,Fair health,105,1,0,1,14,13,4,4,20,29,18,9,9,2
S01012786,Bad health,66,2,0,2,3,3,3,15,9,17,8,6,2,6
S01012786,Very bad health,15,0,0,0,1,0,1,4,3,4,2,2,0,0
S01012787,All people aged 16 to 74,433,32,8,24,110,63,25,33,74,46,20,13,7,30
S01012787,Very good health,239,23,6,17,75,34,13,18,29,20,6,3,3,21
S01012787,Good health,116,7,1,6,26,21,8,8,26,9,6,3,3,5
S01012787,Fair health,49,1,1,0,6,6,3,3,14,10,3,2,1,3
S01012787,Bad health,18,1,0,1,1,1,0,3,3,4,5,5,0,0
S01012787,Very bad health,11,0,0,0,2,1,1,1,2,3,0,0,0,1
S01012788,All people aged 16 to 74,477,20,2,18,53,37,26,47,72,128,62,42,20,32
S01012788,Very good health,189,12,1,11,18,18,6,13,26,52,19,12,7,25
S01012788,Good health,162,6,1,5,21,12,13,23,26,40,15,7,8,6
S01012788,Fair health,73,2,0,2,7,4,4,7,11,21,16,13,3,1
S01012788,Bad health,42,0,0,0,4,3,3,4,7,12,9,7,2,0
S01012788,Very bad health,11,0,0,0,3,0,0,0,2,3,3,3,0,0
S01012789,All people aged 16 to 74,586,55,9,46,114,93,46,46,92,71,29,17,12,40
S01012789,Very good health,254,31,6,25,56,42,22,19,24,21,9,5,4,30
S01012789,Good health,203,18,0,18,43,27,16,15,40,23,11,6,5,10
S01012789,Fair health,84,6,3,3,12,16,4,9,18,13,6,3,3,0
S01012789,Bad health,34,0,0,0,3,6,1,3,8,10,3,3,0,0
S01012789,Very bad health,11,0,0,0,0,2,3,0,2,4,0,0,0,0
S01012790,All people aged 16 to 74,438,83,9,74,137,67,23,18,34,35,11,9,2,30
S01012790,Very good health,270,60,7,53,93,41,9,13,16,15,4,4,0,19
S01012790,Good health,126,20,1,19,36,18,12,2,10,14,4,3,1,10
S01012790,Fair health,27,2,1,1,6,5,1,1,7,3,1,0,1,1
S01012790,Bad health,13,0,0,0,2,2,1,2,1,3,2,2,0,0
S01012790,Very bad health,2,1,0,1,0,1,0,0,0,0,0,0,0,0
S01012791,All people aged 16 to 74,523,76,17,59,155,90,39,21,68,28,7,3,4,39
S01012791,Very good health,277,48,10,38,89,43,21,9,23,13,1,1,0,30
S01012791,Good health,175,22,7,15,45,32,13,9,35,7,4,1,3,8
S01012791,Fair health,52,5,0,5,18,9,4,2,5,6,2,1,1,1
S01012791,Bad health,11,0,0,0,1,4,1,0,3,2,0,0,0,0
S01012791,Very bad health,8,1,0,1,2,2,0,1,2,0,0,0,0,0
S01012792,All people aged 16 to 74,696,52,8,44,144,117,44,56,98,113,36,20,16,36
S01012792,Very good health,303,32,5,27,79,52,19,17,25,47,8,5,3,24
S01012792,Good health,210,16,3,13,41,37,15,17,34,28,17,5,12,5
S01012792,Fair health,115,2,0,2,14,22,7,14,27,22,6,5,1,1
S01012792,Bad health,56,2,0,2,9,5,2,8,10,10,4,4,0,6
S01012792,Very bad health,12,0,0,0,1,1,1,0,2,6,1,1,0,0
S01012793,All people aged 16 to 74,624,22,6,16,81,59,33,31,116,107,55,41,14,120
S01012793,Very good health,235,10,0,10,34,21,10,6,33,25,12,7,5,84
S01012793,Good health,220,8,6,2,34,21,9,13,45,38,21,13,8,31
S01012793,Fair health,99,3,0,3,8,10,7,2,23,31,10,9,1,5
S01012793,Bad health,53,1,0,1,5,5,3,7,11,9,12,12,0,0
S01012793,Very bad health,17,0,0,0,0,2,4,3,4,4,0,0,0,0
S01012794,All people aged 16 to 74,494,76,12,64,153,61,39,32,53,50,12,6,6,18
S01012794,Very good health,247,46,7,39,89,33,18,13,17,15,2,1,1,14
S01012794,Good health,177,27,5,22,52,20,16,13,18,22,6,4,2,3
S01012794,Fair health,50,3,0,3,10,7,5,6,8,6,4,1,3,1
S01012794,Bad health,18,0,0,0,1,1,0,0,10,6,0,0,0,0
S01012794,Very bad health,2,0,0,0,1,0,0,0,0,1,0,0,0,0
S01012795,All people aged 16 to 74,787,19,6,13,73,83,50,64,195,176,69,43,26,58
S01012795,Very good health,304,9,1,8,32,39,25,19,65,50,22,12,10,43
S01012795,Good health,252,5,2,3,24,32,20,25,73,40,21,13,8,12
S01012795,Fair health,136,2,2,0,9,7,4,13,32,51,15,7,8,3
S01012795,Bad health,73,2,1,1,5,5,1,7,17,29,7,7,0,0
S01012795,Very bad health,22,1,0,1,3,0,0,0,8,6,4,4,0,0
S01012796,All people aged 16 to 74,581,28,3,25,114,88,37,42,113,95,36,18,18,28
S01012796,Very good health,262,15,2,13,65,46,17,18,40,34,7,2,5,20
S01012796,Good health,199,12,1,11,38,30,14,14,44,23,19,10,9,5
S01012796,Fair health,83,0,0,0,6,7,6,9,21,23,8,4,4,3
S01012796,Bad health,26,1,0,1,4,5,0,1,4,11,0,0,0,0
S01012796,Very bad health,11,0,0,0,1,0,0,0,4,4,2,2,0,0
S01012797,All people aged 16 to 74,528,20,4,16,91,53,28,44,108,97,51,29,22,36
S01012797,Very good health,228,14,2,12,54,21,9,22,37,26,23,9,14,22
S01012797,Good health,177,6,2,4,29,18,13,11,41,40,11,7,4,8
S01012797,Fair health,83,0,0,0,5,9,4,8,25,15,12,8,4,5
S01012797,Bad health,30,0,0,0,3,3,2,3,3,11,4,4,0,1
S01012797,Very bad health,10,0,0,0,0,2,0,0,2,5,1,1,0,0
S01012798,All people aged 16 to 74,518,107,29,78,144,61,55,21,37,33,11,6,5,49
S01012798,Very good health,293,68,19,49,79,35,30,8,13,15,4,3,1,41
S01012798,Good health,155,35,8,27,49,19,17,6,9,11,4,2,2,5
S01012798,Fair health,48,3,2,1,9,6,6,4,11,5,1,0,1,3
S01012798,Bad health,17,1,0,1,5,1,1,3,3,2,1,0,1,0
S01012798,Very bad health,5,0,0,0,2,0,1,0,1,0,1,1,0,0
S01012799,All people aged 16 to 74,555,122,25,97,184,69,57,23,31,25,8,4,4,36
S01012799,Very good health,325,83,20,63,118,40,25,9,11,7,0,0,0,32
S01012799,Good health,162,29,4,25,46,22,23,10,13,9,6,3,3,4
S01012799,Fair health,47,6,0,6,12,5,8,4,5,7,0,0,0,0
S01012799,Bad health,16,3,0,3,6,2,1,0,1,2,1,0,1,0
S01012799,Very bad health,5,1,1,0,2,0,0,0,1,0,1,1,0,0
S01012800,All people aged 16 to 74,674,135,21,114,220,79,69,30,50,22,12,7,5,57
S01012800,Very good health,413,86,15,71,135,44,44,13,25,12,2,1,1,52
S01012800,Good health,187,34,5,29,63,26,20,11,17,7,5,1,4,4
S01012800,Fair health,55,13,1,12,13,8,5,3,6,3,3,3,0,1
S01012800,Bad health,11,1,0,1,6,1,0,2,0,0,1,1,0,0
S01012800,Very bad health,8,1,0,1,3,0,0,1,2,0,1,1,0,0
S01012801,All people aged 16 to 74,297,65,8,57,93,41,22,12,21,15,6,3,3,22
S01012801,Very good health,162,44,3,41,53,14,13,6,7,7,2,0,2,16
S01012801,Good health,97,16,2,14,28,24,7,5,7,5,0,0,0,5
S01012801,Fair health,26,4,2,2,8,2,2,0,6,2,1,0,1,1
S01012801,Bad health,10,0,0,0,4,1,0,1,1,1,2,2,0,0
S01012801,Very bad health,2,1,1,0,0,0,0,0,0,0,1,1,0,0
S01012802,All people aged 16 to 74,461,114,25,89,109,60,57,20,27,9,10,8,2,55
S01012802,Very good health,303,69,16,53,77,31,37,13,14,6,5,4,1,51
S01012802,Good health,123,38,6,32,24,20,16,6,11,2,3,2,1,3
S01012802,Fair health,26,6,2,4,7,7,0,1,2,0,2,2,0,1
S01012802,Bad health,7,1,1,0,1,2,2,0,0,1,0,0,0,0
S01012802,Very bad health,2,0,0,0,0,0,2,0,0,0,0,0,0,0
S01012803,All people aged 16 to 74,544,72,14,58,160,111,29,31,44,25,4,1,3,68
S01012803,Very good health,314,35,4,31,105,55,13,18,23,9,0,0,0,56
S01012803,Good health,170,31,7,24,42,40,10,11,12,10,2,1,1,12
S01012803,Fair health,44,5,3,2,11,13,3,1,7,3,1,0,1,0
S01012803,Bad health,11,1,0,1,1,3,2,0,1,2,1,0,1,0
S01012803,Very bad health,5,0,0,0,1,0,1,1,1,1,0,0,0,0
S01012804,All people aged 16 to 74,561,33,2,31,117,82,43,48,102,69,30,19,11,37
S01012804,Very good health,274,18,0,18,66,40,14,27,40,29,10,6,4,30
S01012804,Good health,175,13,2,11,37,27,21,10,31,20,10,6,4,6
S01012804,Fair health,72,2,0,2,10,10,6,6,17,13,8,5,3,0
S01012804,Bad health,28,0,0,0,3,4,2,2,12,3,2,2,0,0
S01012804,Very bad health,12,0,0,0,1,1,0,3,2,4,0,0,0,1
S01012805,All people aged 16 to 74,664,36,10,26,109,102,35,51,137,100,37,20,17,57
S01012805,Very good health,294,18,4,14,56,49,16,21,50,31,14,8,6,39
S01012805,Good health,233,12,5,7,33,36,12,15,56,41,14,6,8,14
S01012805,Fair health,98,6,1,5,13,11,7,9,21,22,5,3,2,4
S01012805,Bad health,30,0,0,0,7,5,0,3,7,5,3,2,1,0
S01012805,Very bad health,9,0,0,0,0,1,0,3,3,1,1,1,0,0
S01012806,All people aged 16 to 74,550,54,11,43,125,86,36,35,77,65,30,20,10,42
S01012806,Very good health,277,38,9,29,76,41,14,15,34,15,9,5,4,35
S01012806,Good health,175,12,1,11,37,29,14,9,26,32,9,6,3,7
S01012806,Fair health,71,4,1,3,8,10,6,8,13,11,11,9,2,0
S01012806,Bad health,19,0,0,0,3,5,1,2,3,4,1,0,1,0
S01012806,Very bad health,8,0,0,0,1,1,1,1,1,3,0,0,0,0
S01012807,All people aged 16 to 74,436,96,24,72,119,58,59,18,19,16,5,2,3,46
S01012807,Very good health,296,71,15,56,80,37,33,9,12,12,3,1,2,39
S01012807,Good health,103,17,7,10,29,14,19,7,5,4,1,0,1,7
S01012807,Fair health,31,8,2,6,9,5,5,2,2,0,0,0,0,0
S01012807,Bad health,6,0,0,0,1,2,2,0,0,0,1,1,0,0
S01012807,Very bad health,0,0,0,0,0,0,0,0,0,0,0,0,0,0
S01012808,All people aged 16 to 74,757,132,28,104,194,109,60,51,84,52,24,12,12,51
S01012808,Very good health,406,92,16,76,107,46,34,24,36,18,7,1,6,42
S01012808,Good health,240,35,12,23,53,47,21,16,30,18,11,7,4,9
S01012808,Fair health,79,2,0,2,31,10,3,5,14,10,4,2,2,0
S01012808,Bad health,24,3,0,3,2,2,2,5,4,4,2,2,0,0
S01012808,Very bad health,8,0,0,0,1,4,0,1,0,2,0,0,0,0
S01012809,All people aged 16 to 74,494,68,12,56,139,60,35,37,60,35,19,9,10,41
S01012809,Very good health,264,49,8,41,78,29,13,19,22,11,5,3,2,38
S01012809,Good health,161,14,2,12,49,23,16,13,20,16,7,3,4,3
S01012809,Fair health,45,5,2,3,9,6,4,3,8,5,5,1,4,0
S01012809,Bad health,21,0,0,0,2,1,2,2,10,3,1,1,0,0
S01012809,Very bad health,3,0,0,0,1,1,0,0,0,0,1,1,0,0
S01012810,All people aged 16 to 74,648,48,15,33,98,103,42,53,116,112,31,18,13,45
S01012810,Very good health,267,22,7,15,57,40,17,14,35,33,12,6,6,37
S01012810,Good health,199,18,6,12,20,38,11,22,36,40,8,2,6,6
S01012810,Fair health,112,6,1,5,16,19,13,7,24,21,5,5,0,1
S01012810,Bad health,56,2,1,1,5,5,1,7,17,13,5,4,1,1
S01012810,Very bad health,14,0,0,0,0,1,0,3,4,5,1,1,0,0
S01012811,All people aged 16 to 74,587,57,10,47,133,80,30,50,96,76,21,13,8,44
S01012811,Very good health,279,31,3,28,76,40,13,28,26,25,7,3,4,33
S01012811,Good health,190,24,7,17,40,25,9,14,40,24,5,4,1,9
S01012811,Fair health,76,1,0,1,13,10,7,7,15,16,6,4,2,1
S01012811,Bad health,35,1,0,1,3,4,1,0,13,10,2,1,1,1
S01012811,Very bad health,7,0,0,0,1,1,0,1,2,1,1,1,0,0
S01012812,All people aged 16 to 74,520,53,10,43,118,76,34,42,80,66,19,10,9,32
S01012812,Very good health,287,31,6,25,68,46,24,18,40,25,11,5,6,24
S01012812,Good health,154,13,2,11,39,22,7,18,19,24,5,3,2,7
S01012812,Fair health,61,8,2,6,8,4,3,6,16,14,2,1,1,0
S01012812,Bad health,14,1,0,1,3,4,0,0,3,2,1,1,0,0
S01012812,Very bad health,4,0,0,0,0,0,0,0,2,1,0,0,0,1
S01012813,All people aged 16 to 74,693,139,27,112,217,115,52,33,58,22,12,10,2,45
S01012813,Very good health,373,86,12,74,117,55,22,18,23,12,3,3,0,37
S01012813,Good health,236,44,12,32,77,40,25,10,25,6,6,4,2,3
S01012813,Fair health,68,7,2,5,17,19,4,5,6,2,3,3,0,5
S01012813,Bad health,12,2,1,1,5,1,1,0,1,2,0,0,0,0
S01012813,Very bad health,4,0,0,0,1,0,0,0,3,0,0,0,0,0
S01012814,All people aged 16 to 74,624,50,5,45,188,108,49,55,71,55,16,3,13,32
S01012814,Very good health,336,30,3,27,113,62,24,27,29,20,4,1,3,27
S01012814,Good health,200,14,1,13,51,39,20,17,28,19,7,1,6,5
S01012814,Fair health,63,5,1,4,18,5,4,7,10,12,2,0,2,0
S01012814,Bad health,22,1,0,1,6,2,0,3,3,4,3,1,2,0
S01012814,Very bad health,3,0,0,0,0,0,1,1,1,0,0,0,0,0
S01012815,All people aged 16 to 74,620,84,17,67,178,101,45,52,67,37,18,6,12,38
S01012815,Very good health,366,48,10,38,115,63,18,32,33,19,9,1,8,29
S01012815,Good health,197,30,6,24,52,33,21,16,20,11,7,5,2,7
S01012815,Fair health,45,6,1,5,9,4,6,3,11,3,2,0,2,1
S01012815,Bad health,8,0,0,0,2,1,0,0,3,2,0,0,0,0
S01012815,Very bad health,4,0,0,0,0,0,0,1,0,2,0,0,0,1
S01012816,All people aged 16 to 74,425,35,10,25,102,68,39,37,54,44,17,11,6,29
S01012816,Very good health,250,27,7,20,63,41,21,21,25,21,7,4,3,24
S01012816,Good health,117,8,3,5,34,18,10,13,17,10,5,2,3,2
S01012816,Fair health,40,0,0,0,4,6,5,3,9,9,2,2,0,2
S01012816,Bad health,15,0,0,0,1,3,3,0,3,4,1,1,0,0
S01012816,Very bad health,3,0,0,0,0,0,0,0,0,0,2,2,0,1
S01012817,All people aged 16 to 74,382,56,10,46,95,83,33,17,36,27,11,7,4,24
S01012817,Very good health,235,31,3,28,59,48,16,11,25,16,5,3,2,24
S01012817,Good health,123,20,7,13,29,31,14,5,10,10,4,2,2,0
S01012817,Fair health,18,4,0,4,2,4,3,1,1,1,2,2,0,0
S01012817,Bad health,3,1,0,1,2,0,0,0,0,0,0,0,0,0
S01012817,Very bad health,3,0,0,0,3,0,0,0,0,0,0,0,0,0
S01012818,All people aged 16 to 74,614,60,8,52,161,104,40,42,91,41,17,12,5,58
S01012818,Very good health,328,33,3,30,104,46,17,17,42,17,9,4,5,43
S01012818,Good health,185,21,5,16,35,39,15,17,33,10,4,4,0,11
S01012818,Fair health,71,5,0,5,18,14,7,6,9,8,1,1,0,3
S01012818,Bad health,19,1,0,1,2,4,0,1,5,4,2,2,0,0
S01012818,Very bad health,11,0,0,0,2,1,1,1,2,2,1,1,0,1
S01012819,All people aged 16 to 74,555,16,3,13,68,66,21,60,128,110,53,33,20,33
S01012819,Very good health,177,6,0,6,35,21,4,26,34,18,12,7,5,21
S01012819,Good health,189,7,1,6,22,23,11,17,36,41,22,13,9,10
S01012819,Fair health,110,2,1,1,8,15,4,10,36,23,10,6,4,2
S01012819,Bad health,56,1,1,0,2,6,1,1,18,21,6,4,2,0
S01012819,Very bad health,23,0,0,0,1,1,1,6,4,7,3,3,0,0
S01012820,All people aged 16 to 74,772,79,14,65,195,133,76,54,101,56,25,16,9,53
S01012820,Very good health,430,49,7,42,119,75,39,28,53,20,10,6,4,37
S01012820,Good health,251,24,6,18,61,46,28,21,27,22,11,7,4,11
S01012820,Fair health,74,4,0,4,12,8,8,4,18,12,3,2,1,5
S01012820,Bad health,13,2,1,1,2,3,0,1,2,2,1,1,0,0
S01012820,Very bad health,4,0,0,0,1,1,1,0,1,0,0,0,0,0
S01012821,All people aged 16 to 74,549,63,9,54,116,85,59,49,57,36,42,34,8,42
S01012821,Very good health,316,41,5,36,75,54,32,22,26,20,12,9,3,34
S01012821,Good health,176,19,3,16,34,25,21,18,23,11,17,13,4,8
S01012821,Fair health,37,2,0,2,6,5,5,5,5,4,5,4,1,0
S01012821,Bad health,16,1,1,0,0,1,1,4,3,1,5,5,0,0
S01012821,Very bad health,4,0,0,0,1,0,0,0,0,0,3,3,0,0
S01012822,All people aged 16 to 74,345,11,1,10,29,38,17,41,82,68,41,19,22,18
S01012822,Very good health,130,8,0,8,14,25,8,10,25,18,11,2,9,11
S01012822,Good health,112,2,0,2,10,9,6,13,27,25,17,7,10,3
S01012822,Fair health,53,1,1,0,4,3,2,9,16,12,5,3,2,1
S01012822,Bad health,41,0,0,0,0,1,1,7,12,11,6,5,1,3
S01012822,Very bad health,9,0,0,0,1,0,0,2,2,2,2,2,0,0
S01012823,All people aged 16 to 74,626,46,10,36,133,101,42,61,112,51,31,20,11,49
S01012823,Very good health,329,29,8,21,78,57,15,32,49,24,7,2,5,38
S01012823,Good health,226,16,2,14,39,35,21,24,45,20,16,10,6,10
S01012823,Fair health,55,1,0,1,10,6,6,4,16,5,6,6,0,1
S01012823,Bad health,14,0,0,0,6,2,0,1,2,1,2,2,0,0
S01012823,Very bad health,2,0,0,0,0,1,0,0,0,1,0,0,0,0
S01012824,All people aged 16 to 74,492,26,6,20,115,83,33,40,81,59,18,11,7,37
S01012824,Very good health,230,13,4,9,57,40,12,17,32,25,7,6,1,27
S01012824,Good health,173,10,0,10,45,27,16,11,30,22,7,3,4,5
S01012824,Fair health,61,1,1,0,10,11,3,8,17,5,3,1,2,3
S01012824,Bad health,22,2,1,1,2,4,2,3,2,4,1,1,0,2
S01012824,Very bad health,6,0,0,0,1,1,0,1,0,3,0,0,0,0
S01012825,All people aged 16 to 74,380,21,4,17,67,46,19,37,61,77,27,13,14,25
S01012825,Very good health,142,9,2,7,30,24,2,15,19,21,6,3,3,16
S01012825,Good health,115,7,1,6,21,13,6,8,20,26,10,4,6,4
S01012825,Fair health,73,2,1,1,9,5,9,4,15,20,6,4,2,3
S01012825,Bad health,40,3,0,3,6,4,1,7,6,7,4,1,3,2
S01012825,Very bad health,10,0,0,0,1,0,1,3,1,3,1,1,0,0
S01012826,All people aged 16 to 74,436,11,4,7,46,46,21,29,85,87,69,50,19,42
S01012826,Very good health,201,8,3,5,27,25,9,12,40,30,19,13,6,31
S01012826,Good health,121,3,1,2,11,10,7,6,25,27,27,16,11,5
S01012826,Fair health,65,0,0,0,4,7,2,8,11,16,14,12,2,3
S01012826,Bad health,37,0,0,0,3,3,3,2,8,9,6,6,0,3
S01012826,Very bad health,12,0,0,0,1,1,0,1,1,5,3,3,0,0
S01012827,All people aged 16 to 74,475,46,11,35,129,74,40,39,49,51,23,18,5,24
S01012827,Very good health,282,26,4,22,80,48,16,22,32,23,14,11,3,21
S01012827,Good health,144,18,7,11,42,18,17,13,14,15,4,2,2,3
S01012827,Fair health,37,2,0,2,7,8,4,3,2,7,4,4,0,0
S01012827,Bad health,11,0,0,0,0,0,3,1,1,5,1,1,0,0
S01012827,Very bad health,1,0,0,0,0,0,0,0,0,1,0,0,0,0
S01012828,All people aged 16 to 74,456,41,7,34,147,82,31,29,62,40,6,3,3,18
S01012828,Very good health,280,27,4,23,91,50,20,16,37,23,2,1,1,14
S01012828,Good health,138,11,1,10,47,27,8,11,17,11,3,1,2,3
S01012828,Fair health,26,2,2,0,6,4,3,1,4,5,0,0,0,1
S01012828,Bad health,8,1,0,1,2,1,0,1,1,1,1,1,0,0
S01012828,Very bad health,4,0,0,0,1,0,0,0,3,0,0,0,0,0
S01012829,All people aged 16 to 74,607,16,1,15,63,75,39,44,137,145,65,43,22,23
S01012829,Very good health,241,6,0,6,30,32,13,18,47,55,21,13,8,19
S01012829,Good health,185,7,0,7,21,26,16,13,36,41,22,10,12,3
S01012829,Fair health,102,3,1,2,6,12,5,7,35,22,11,9,2,1
S01012829,Bad health,59,0,0,0,2,5,4,5,15,21,7,7,0,0
S01012829,Very bad health,20,0,0,0,4,0,1,1,4,6,4,4,0,0
S01012830,All people aged 16 to 74,526,23,9,14,93,71,42,50,105,79,42,32,10,21
S01012830,Very good health,209,12,4,8,52,32,16,19,33,17,11,8,3,17
S01012830,Good health,160,6,2,4,27,23,15,15,35,25,10,7,3,4
S01012830,Fair health,90,5,3,2,6,11,9,11,20,17,11,9,2,0
S01012830,Bad health,51,0,0,0,6,5,2,3,10,15,10,8,2,0
S01012830,Very bad health,16,0,0,0,2,0,0,2,7,5,0,0,0,0
S01012831,All people aged 16 to 74,466,18,6,12,80,54,32,48,89,105,22,14,8,18
S01012831,Very good health,156,7,2,5,34,20,9,13,34,24,4,1,3,11
S01012831,Good health,148,9,4,5,27,19,8,18,20,36,6,2,4,5
S01012831,Fair health,86,2,0,2,8,8,9,12,15,25,5,5,0,2
S01012831,Bad health,59,0,0,0,9,6,5,4,13,16,6,5,1,0
S01012831,Very bad health,17,0,0,0,2,1,1,1,7,4,1,1,0,0
S01012832,All people aged 16 to 74,407,26,6,20,66,58,37,34,72,56,30,20,10,28
S01012832,Very good health,209,16,3,13,38,38,16,16,31,19,11,7,4,24
S01012832,Good health,127,7,2,5,21,16,8,13,22,29,8,4,4,3
S01012832,Fair health,42,2,1,1,7,2,8,1,14,3,4,2,2,1
S01012832,Bad health,20,1,0,1,0,2,4,2,3,3,5,5,0,0
S01012832,Very bad health,9,0,0,0,0,0,1,2,2,2,2,2,0,0
S01012833,All people aged 16 to 74,529,21,1,20,60,57,21,37,132,112,56,38,18,33
S01012833,Very good health,200,8,1,7,25,27,10,10,44,35,16,9,7,25
S01012833,Good health,157,7,0,7,20,15,6,12,37,33,21,14,7,6
S01012833,Fair health,116,5,0,5,9,12,3,14,34,24,13,9,4,2
S01012833,Bad health,42,0,0,0,4,2,2,0,13,17,4,4,0,0
S01012833,Very bad health,14,1,0,1,2,1,0,1,4,3,2,2,0,0
S01012834,All people aged 16 to 74,491,38,4,34,76,64,41,46,81,77,49,31,18,19
S01012834,Very good health,200,27,4,23,41,32,17,15,24,22,9,5,4,13
S01012834,Good health,162,8,0,8,28,13,15,13,24,33,22,11,11,6
S01012834,Fair health,88,3,0,3,4,14,8,9,24,15,11,9,2,0
S01012834,Bad health,29,0,0,0,2,5,1,7,7,3,4,3,1,0
S01012834,Very bad health,12,0,0,0,1,0,0,2,2,4,3,3,0,0
S01012835,All people aged 16 to 74,679,52,10,42,155,99,35,63,92,110,46,34,12,27
S01012835,Very good health,266,33,7,26,81,48,6,21,25,29,7,3,4,16
S01012835,Good health,234,16,3,13,54,36,19,15,34,36,17,10,7,7
S01012835,Fair health,115,3,0,3,15,7,6,16,18,29,17,16,1,4
S01012835,Bad health,43,0,0,0,2,5,2,7,10,13,4,4,0,0
S01012835,Very bad health,21,0,0,0,3,3,2,4,5,3,1,1,0,0
S01012836,All people aged 16 to 74,495,60,13,47,132,70,54,39,48,30,16,11,5,46
S01012836,Very good health,302,37,7,30,82,40,26,27,27,18,7,4,3,38
S01012836,Good health,140,19,5,14,40,23,19,10,13,7,3,2,1,6
S01012836,Fair health,42,4,1,3,8,6,7,2,6,4,3,3,0,2
S01012836,Bad health,9,0,0,0,2,1,2,0,2,0,2,1,1,0
S01012836,Very bad health,2,0,0,0,0,0,0,0,0,1,1,1,0,0
S01012837,All people aged 16 to 74,565,8,2,6,48,69,28,52,128,103,87,41,46,42
S01012837,Very good health,188,2,1,1,14,25,8,24,40,24,29,13,16,22
S01012837,Good health,189,5,0,5,17,28,12,14,51,33,17,5,12,12
S01012837,Fair health,116,1,1,0,9,11,6,9,23,22,27,12,15,8
S01012837,Bad health,54,0,0,0,5,5,1,3,11,18,11,8,3,0
S01012837,Very bad health,18,0,0,0,3,0,1,2,3,6,3,3,0,0
S01012838,All people aged 16 to 74,686,17,3,14,74,66,24,67,159,134,114,55,59,31
S01012838,Very good health,206,11,2,9,24,25,5,20,44,32,27,15,12,18
S01012838,Good health,231,4,0,4,21,20,11,21,56,46,42,15,27,10
S01012838,Fair health,155,2,1,1,18,16,2,13,37,34,30,14,16,3
S01012838,Bad health,79,0,0,0,10,4,4,12,19,18,12,8,4,0
S01012838,Very bad health,15,0,0,0,1,1,2,1,3,4,3,3,0,0
S01012839,All people aged 16 to 74,551,45,8,37,130,100,52,53,90,46,10,4,6,25
S01012839,Very good health,266,23,3,20,63,56,22,26,32,19,5,1,4,20
S01012839,Good health,189,18,3,15,44,35,17,19,36,14,2,1,1,4
S01012839,Fair health,71,3,1,2,15,7,12,7,14,10,3,2,1,0
S01012839,Bad health,22,1,1,0,6,2,1,1,7,3,0,0,0,1
S01012839,Very bad health,3,0,0,0,2,0,0,0,1,0,0,0,0,0
S01012840,All people aged 16 to 74,580,86,19,67,159,106,45,30,72,32,13,8,5,37
S01012840,Very good health,367,62,13,49,104,62,25,16,43,15,8,6,2,32
S01012840,Good health,166,22,5,17,44,35,17,8,21,11,4,2,2,4
S01012840,Fair health,34,2,1,1,7,7,3,3,6,5,0,0,0,1
S01012840,Bad health,13,0,0,0,4,2,0,3,2,1,1,0,1,0
S01012840,Very bad health,0,0,0,0,0,0,0,0,0,0,0,0,0,0
S01012841,All people aged 16 to 74,461,47,9,38,129,76,39,48,53,35,7,4,3,27
S01012841,Very good health,249,31,5,26,77,40,14,27,26,11,2,1,1,21
S01012841,Good health,130,7,2,5,37,27,15,15,10,11,2,1,1,6
S01012841,Fair health,56,8,2,6,10,8,7,5,11,6,1,1,0,0
S01012841,Bad health,20,1,0,1,4,1,2,1,5,5,1,0,1,0
S01012841,Very bad health,6,0,0,0,1,0,1,0,1,2,1,1,0,0
S01012842,All people aged 16 to 74,393,39,7,32,100,67,20,39,56,36,10,7,3,26
S01012842,Very good health,190,24,3,21,49,30,10,14,21,18,1,0,1,23
S01012842,Good health,142,12,2,10,41,28,8,13,24,10,4,2,2,2
S01012842,Fair health,41,1,1,0,8,7,2,8,6,5,3,3,0,1
S01012842,Bad health,13,1,1,0,2,2,0,2,2,3,1,1,0,0
S01012842,Very bad health,7,1,0,1,0,0,0,2,3,0,1,1,0,0
S01012843,All people aged 16 to 74,707,118,21,97,219,107,64,31,61,29,20,15,5,58
S01012843,Very good health,420,80,12,68,133,51,29,17,38,11,10,7,3,51
S01012843,Good health,196,30,8,22,60,34,28,8,14,9,7,5,2,6
S01012843,Fair health,69,7,1,6,20,18,5,4,6,6,2,2,0,1
S01012843,Bad health,19,1,0,1,5,2,2,2,3,3,1,1,0,0
S01012843,Very bad health,3,0,0,0,1,2,0,0,0,0,0,0,0,0
S01012844,All people aged 16 to 74,521,110,20,90,165,60,45,17,34,25,9,5,4,56
S01012844,Very good health,309,70,15,55,98,31,16,10,18,10,5,2,3,51
S01012844,Good health,158,32,5,27,50,24,18,4,13,11,2,1,1,4
S01012844,Fair health,37,7,0,7,11,5,8,2,1,2,0,0,0,1
S01012844,Bad health,13,1,0,1,4,0,3,1,2,1,1,1,0,0
S01012844,Very bad health,4,0,0,0,2,0,0,0,0,1,1,1,0,0
S01012845,All people aged 16 to 74,511,90,13,77,139,64,50,23,45,24,31,24,7,45
S01012845,Very good health,267,53,7,46,70,30,27,9,23,12,7,3,4,36
S01012845,Good health,162,28,4,24,44,20,17,9,11,8,18,16,2,7
S01012845,Fair health,63,8,1,7,21,9,4,3,8,3,5,4,1,2
S01012845,Bad health,15,1,1,0,2,3,2,2,3,1,1,1,0,0
S01012845,Very bad health,4,0,0,0,2,2,0,0,0,0,0,0,0,0
S01012846,All people aged 16 to 74,695,26,3,23,104,107,42,66,120,131,56,36,20,43
S01012846,Very good health,256,14,3,11,44,46,13,27,31,33,14,11,3,34
S01012846,Good health,201,9,0,9,34,33,14,13,27,44,20,9,11,7
S01012846,Fair health,153,2,0,2,19,20,11,15,35,34,15,9,6,2
S01012846,Bad health,72,1,0,1,7,6,4,7,22,18,7,7,0,0
S01012846,Very bad health,13,0,0,0,0,2,0,4,5,2,0,0,0,0
S01012847,All people aged 16 to 74,403,21,4,17,85,65,39,40,65,40,12,9,3,36
S01012847,Very good health,200,14,2,12,46,34,15,17,25,17,2,0,2,30
S01012847,Good health,134,5,1,4,30,21,19,15,21,13,4,3,1,6
S01012847,Fair health,43,2,1,1,7,6,3,5,9,7,4,4,0,0
S01012847,Bad health,20,0,0,0,2,2,1,2,8,3,2,2,0,0
S01012847,Very bad health,6,0,0,0,0,2,1,1,2,0,0,0,0,0
S01012848,All people aged 16 to 74,541,60,11,49,141,85,47,43,70,48,20,10,10,27
S01012848,Very good health,317,45,6,39,84,44,28,26,33,22,11,3,8,24
S01012848,Good health,146,14,4,10,39,30,12,11,21,14,3,3,0,2
S01012848,Fair health,56,1,1,0,14,7,6,3,12,8,4,2,2,1
S01012848,Bad health,18,0,0,0,3,3,1,3,2,4,2,2,0,0
S01012848,Very bad health,4,0,0,0,1,1,0,0,2,0,0,0,0,0
S01012849,All people aged 16 to 74,528,43,9,34,96,96,27,47,83,79,34,23,11,23
S01012849,Very good health,255,27,5,22,56,55,8,26,32,28,10,4,6,13
S01012849,Good health,156,14,4,10,29,23,7,13,31,21,10,6,4,8
S01012849,Fair health,67,1,0,1,4,11,9,4,11,13,12,11,1,2
S01012849,Bad health,41,0,0,0,5,7,3,3,8,13,2,2,0,0
S01012849,Very bad health,9,1,0,1,2,0,0,1,1,4,0,0,0,0
S01012850,All people aged 16 to 74,529,15,4,11,72,73,27,45,114,130,26,19,7,27
S01012850,Very good health,180,9,3,6,22,34,9,12,32,35,7,4,3,20
S01012850,Good health,160,2,1,1,28,21,10,15,36,33,9,6,3,6
S01012850,Fair health,116,2,0,2,16,12,6,9,31,34,6,6,0,0
S01012850,Bad health,54,0,0,0,3,6,2,9,11,20,3,2,1,0
S01012850,Very bad health,19,2,0,2,3,0,0,0,4,8,1,1,0,1
S01012851,All people aged 16 to 74,611,41,9,32,126,90,40,47,105,84,28,24,4,50
S01012851,Very good health,259,24,5,19,59,38,20,17,35,20,11,7,4,35
S01012851,Good health,186,13,4,9,46,35,9,14,29,24,4,4,0,12
S01012851,Fair health,116,4,0,4,15,9,6,14,31,25,10,10,0,2
S01012851,Bad health,37,0,0,0,6,4,5,1,9,8,3,3,0,1
S01012851,Very bad health,13,0,0,0,0,4,0,1,1,7,0,0,0,0
S01012852,All people aged 16 to 74,534,81,15,66,162,103,34,33,47,16,9,4,5,49
S01012852,Very good health,301,53,5,48,79,61,16,21,26,6,6,4,2,33
S01012852,Good health,176,20,6,14,67,32,12,9,15,7,2,0,2,12
S01012852,Fair health,43,4,2,2,13,8,4,2,5,2,1,0,1,4
S01012852,Bad health,11,3,2,1,2,2,2,1,0,1,0,0,0,0
S01012852,Very bad health,3,1,0,1,1,0,0,0,1,0,0,0,0,0
S01012853,All people aged 16 to 74,593,46,12,34,174,100,45,43,86,48,16,9,7,35
S01012853,Very good health,317,29,5,24,90,53,24,20,45,20,9,3,6,27
S01012853,Good health,177,11,4,7,57,32,14,13,25,13,4,3,1,8
S01012853,Fair health,69,5,2,3,22,8,6,6,9,10,3,3,0,0
S01012853,Bad health,24,1,1,0,4,5,1,3,5,5,0,0,0,0
S01012853,Very bad health,6,0,0,0,1,2,0,1,2,0,0,0,0,0
S01012854,All people aged 16 to 74,646,89,11,78,178,123,44,34,73,44,12,9,3,49
S01012854,Very good health,343,59,9,50,101,59,19,16,25,21,3,1,2,40
S01012854,Good health,228,26,2,24,62,54,17,15,31,11,4,3,1,8
S01012854,Fair health,52,3,0,3,14,6,6,2,13,7,1,1,0,0
S01012854,Bad health,15,0,0,0,0,3,2,1,3,2,3,3,0,1
S01012854,Very bad health,8,1,0,1,1,1,0,0,1,3,1,1,0,0
S01012855,All people aged 16 to 74,517,69,13,56,154,78,30,35,74,31,20,12,8,26
S01012855,Very good health,294,51,11,40,91,38,14,20,38,15,3,0,3,24
S01012855,Good health,147,11,1,10,49,27,12,10,23,8,5,3,2,2
S01012855,Fair health,53,5,1,4,11,7,2,4,12,5,7,6,1,0
S01012855,Bad health,20,2,0,2,2,5,2,1,1,3,4,2,2,0
S01012855,Very bad health,3,0,0,0,1,1,0,0,0,0,1,1,0,0
S01012856,All people aged 16 to 74,506,23,5,18,95,83,31,32,89,89,42,28,14,22
S01012856,Very good health,203,11,2,9,55,26,11,8,32,32,11,6,5,17
S01012856,Good health,145,3,0,3,22,32,13,14,25,23,8,4,4,5
S01012856,Fair health,95,6,3,3,10,22,7,5,17,20,8,4,4,0
S01012856,Bad health,49,3,0,3,7,1,0,4,15,8,11,10,1,0
S01012856,Very bad health,14,0,0,0,1,2,0,1,0,6,4,4,0,0
S01012857,All people aged 16 to 74,578,17,3,14,97,107,26,54,118,85,53,41,12,21
S01012857,Very good health,175,7,2,5,37,31,6,15,32,20,10,5,5,17
S01012857,Good health,233,9,1,8,38,49,14,22,44,33,21,18,3,3
S01012857,Fair health,97,0,0,0,14,14,4,8,28,17,11,7,4,1
S01012857,Bad health,57,1,0,1,7,11,2,8,12,9,7,7,0,0
S01012857,Very bad health,16,0,0,0,1,2,0,1,2,6,4,4,0,0
S01012858,All people aged 16 to 74,571,34,6,28,83,94,24,49,116,93,43,29,14,35
S01012858,Very good health,226,24,3,21,40,52,8,11,37,23,8,4,4,23
S01012858,Good health,197,8,3,5,29,25,11,19,38,36,22,15,7,9
S01012858,Fair health,78,1,0,1,5,11,2,9,23,15,10,7,3,2
S01012858,Bad health,53,1,0,1,7,6,2,7,13,14,2,2,0,1
S01012858,Very bad health,17,0,0,0,2,0,1,3,5,5,1,1,0,0
S01012859,All people aged 16 to 74,797,34,3,31,144,131,61,60,122,120,46,27,19,79
S01012859,Very good health,365,21,2,19,83,67,26,24,48,45,12,5,7,39
S01012859,Good health,257,12,1,11,44,47,15,15,44,37,12,4,8,31
S01012859,Fair health,90,1,0,1,6,10,16,14,14,15,7,5,2,7
S01012859,Bad health,63,0,0,0,6,7,4,6,10,18,10,8,2,2
S01012859,Very bad health,22,0,0,0,5,0,0,1,6,5,5,5,0,0
S01012860,All people aged 16 to 74,669,51,17,34,150,115,69,30,96,75,28,19,9,55
S01012860,Very good health,289,32,9,23,75,37,23,10,28,29,11,6,5,44
S01012860,Good health,205,12,4,8,54,44,17,11,32,19,6,3,3,10
S01012860,Fair health,95,5,3,2,10,17,21,4,16,15,6,5,1,1
S01012860,Bad health,49,2,1,1,3,7,6,5,13,9,4,4,0,0
S01012860,Very bad health,31,0,0,0,8,10,2,0,7,3,1,1,0,0
S01012861,All people aged 16 to 74,539,46,10,36,141,71,52,40,71,53,17,9,8,48
S01012861,Very good health,264,28,6,22,85,35,23,11,21,19,5,3,2,37
S01012861,Good health,193,16,4,12,45,28,19,20,31,16,8,4,4,10
S01012861,Fair health,58,1,0,1,9,6,6,8,10,13,4,2,2,1
S01012861,Bad health,17,1,0,1,2,1,2,0,7,4,0,0,0,0
S01012861,Very bad health,7,0,0,0,0,1,2,1,2,1,0,0,0,0
S01012862,All people aged 16 to 74,461,6,3,3,56,56,26,49,104,79,46,25,21,39
S01012862,Very good health,168,4,2,2,36,25,9,17,32,18,10,4,6,17
S01012862,Good health,152,1,0,1,14,17,11,16,34,25,15,7,8,19
S01012862,Fair health,94,0,0,0,5,10,3,13,25,24,11,4,7,3
S01012862,Bad health,35,1,1,0,1,2,2,2,10,11,6,6,0,0
S01012862,Very bad health,12,0,0,0,0,2,1,1,3,1,4,4,0,0
S01012863,All people aged 16 to 74,527,17,2,15,81,67,16,46,97,110,72,32,40,21
S01012863,Very good health,174,5,1,4,37,26,3,18,33,27,16,5,11,9
S01012863,Good health,182,7,0,7,30,26,5,14,40,31,19,5,14,10
S01012863,Fair health,105,2,0,2,8,11,7,10,11,27,28,14,14,1
S01012863,Bad health,53,3,1,2,6,3,0,4,12,19,6,5,1,0
S01012863,Very bad health,13,0,0,0,0,1,1,0,1,6,3,3,0,1
S01012864,All people aged 16 to 74,635,19,2,17,86,96,38,50,109,119,77,44,33,41
S01012864,Very good health,238,12,1,11,52,44,15,13,42,28,18,11,7,14
S01012864,Good health,227,4,1,3,27,34,16,20,33,46,25,9,16,22
S01012864,Fair health,97,3,0,3,5,15,7,8,20,20,16,8,8,3
S01012864,Bad health,55,0,0,0,2,1,0,5,13,18,14,12,2,2
S01012864,Very bad health,18,0,0,0,0,2,0,4,1,7,4,4,0,0
S01012865,All people aged 16 to 74,557,34,5,29,87,94,42,42,106,86,24,17,7,42
S01012865,Very good health,214,16,3,13,41,38,13,10,36,20,7,3,4,33
S01012865,Good health,215,12,1,11,30,42,23,17,42,33,8,6,2,8
S01012865,Fair health,75,6,1,5,13,10,2,6,19,12,6,5,1,1
S01012865,Bad health,45,0,0,0,3,4,3,7,9,18,1,1,0,0
S01012865,Very bad health,8,0,0,0,0,0,1,2,0,3,2,2,0,0
S01012866,All people aged 16 to 74,589,28,9,19,101,92,36,50,95,95,36,16,20,56
S01012866,Very good health,252,20,6,14,62,36,14,20,31,26,13,7,6,30
S01012866,Good health,193,7,3,4,23,43,9,21,29,28,12,3,9,21
S01012866,Fair health,91,1,0,1,14,6,7,5,23,27,6,2,4,2
S01012866,Bad health,46,0,0,0,2,6,5,1,11,13,5,4,1,3
S01012866,Very bad health,7,0,0,0,0,1,1,3,1,1,0,0,0,0
S01012867,All people aged 16 to 74,559,6,3,3,60,56,23,68,110,161,55,37,18,20
S01012867,Very good health,159,2,2,0,29,21,5,15,29,28,16,9,7,14
S01012867,Good health,184,1,1,0,19,21,8,21,39,52,19,11,8,4
S01012867,Fair health,117,2,0,2,8,9,5,13,30,39,10,7,3,1
S01012867,Bad health,78,1,0,1,2,5,4,17,12,31,5,5,0,1
S01012867,Very bad health,21,0,0,0,2,0,1,2,0,11,5,5,0,0
S01012868,All people aged 16 to 74,458,9,1,8,66,62,22,53,101,95,30,17,13,20
S01012868,Very good health,142,6,1,5,32,20,6,14,26,20,5,4,1,13
S01012868,Good health,163,3,0,3,26,31,4,15,33,32,12,6,6,7
S01012868,Fair health,94,0,0,0,5,5,8,14,27,26,9,4,5,0
S01012868,Bad health,47,0,0,0,3,6,3,7,14,12,2,1,1,0
S01012868,Very bad health,12,0,0,0,0,0,1,3,1,5,2,2,0,0
S01012869,All people aged 16 to 74,405,7,2,5,28,43,18,39,82,95,68,45,23,25
S01012869,Very good health,139,3,0,3,8,14,5,14,28,36,16,11,5,15
S01012869,Good health,146,0,0,0,9,14,5,11,34,26,37,20,17,10
S01012869,Fair health,75,3,1,2,7,9,2,10,15,20,9,8,1,0
S01012869,Bad health,31,1,1,0,4,5,3,4,4,6,4,4,0,0
S01012869,Very bad health,14,0,0,0,0,1,3,0,1,7,2,2,0,0
S01012870,All people aged 16 to 74,729,38,10,28,150,127,63,57,131,98,26,20,6,39
S01012870,Very good health,323,20,6,14,69,60,31,26,52,32,6,4,2,27
S01012870,Good health,249,13,3,10,48,47,25,23,42,35,7,4,3,9
S01012870,Fair health,107,4,0,4,24,15,4,7,24,19,7,6,1,3
S01012870,Bad health,40,1,1,0,7,3,1,0,13,10,5,5,0,0
S01012870,Very bad health,10,0,0,0,2,2,2,1,0,2,1,1,0,0
S01012871,All people aged 16 to 74,635,37,7,30,158,131,45,43,96,65,25,13,12,35
S01012871,Very good health,298,31,7,24,78,63,15,21,31,26,9,5,4,24
S01012871,Good health,207,4,0,4,54,44,18,17,36,16,9,5,4,9
S01012871,Fair health,93,2,0,2,17,15,7,4,23,18,6,2,4,1
S01012871,Bad health,29,0,0,0,8,5,4,1,6,3,1,1,0,1
S01012871,Very bad health,8,0,0,0,1,4,1,0,0,2,0,0,0,0
S01012872,All people aged 16 to 74,552,27,5,22,100,122,31,44,94,69,25,13,12,40
S01012872,Very good health,280,18,4,14,59,62,14,19,35,28,14,6,8,31
S01012872,Good health,187,7,0,7,31,39,9,16,41,29,6,5,1,9
S01012872,Fair health,59,2,1,1,8,14,6,4,14,8,3,0,3,0
S01012872,Bad health,21,0,0,0,2,6,2,4,3,3,1,1,0,0
S01012872,Very bad health,5,0,0,0,0,1,0,1,1,1,1,1,0,0
S01012873,All people aged 16 to 74,621,33,7,26,123,138,36,54,91,74,24,17,7,48
S01012873,Very good health,319,19,2,17,67,80,11,23,38,32,11,10,1,38
S01012873,Good health,184,8,4,4,42,38,15,19,31,19,4,3,1,8
S01012873,Fair health,83,3,1,2,11,14,10,8,15,15,6,2,4,1
S01012873,Bad health,23,2,0,2,3,3,0,3,5,4,3,2,1,0
S01012873,Very bad health,12,1,0,1,0,3,0,1,2,4,0,0,0,1
S01012874,All people aged 16 to 74,583,26,5,21,90,76,32,47,124,104,45,20,25,39
S01012874,Very good health,232,11,1,10,50,28,12,20,46,24,11,4,7,30
S01012874,Good health,201,9,2,7,24,35,13,14,51,31,20,5,15,4
S01012874,Fair health,97,2,1,1,7,12,5,10,19,26,12,9,3,4
S01012874,Bad health,43,4,1,3,8,1,2,3,6,16,2,2,0,1
S01012874,Very bad health,10,0,0,0,1,0,0,0,2,7,0,0,0,0
S01012875,All people aged 16 to 74,455,18,0,18,76,60,29,34,74,87,38,21,17,39
S01012875,Very good health,198,8,0,8,34,35,14,16,23,25,18,10,8,25
S01012875,Good health,148,8,0,8,27,13,11,9,33,32,9,4,5,6
S01012875,Fair health,78,1,0,1,12,12,2,5,14,18,6,3,3,8
S01012875,Bad health,27,1,0,1,3,0,2,2,3,11,5,4,1,0
S01012875,Very bad health,4,0,0,0,0,0,0,2,1,1,0,0,0,0
S01012876,All people aged 16 to 74,584,17,8,9,70,76,34,51,148,114,35,24,11,39
S01012876,Very good health,242,8,4,4,37,42,13,20,45,36,9,5,4,32
S01012876,Good health,169,8,3,5,21,19,8,20,49,31,9,4,5,4
S01012876,Fair health,99,1,1,0,5,7,8,8,33,25,9,8,1,3
S01012876,Bad health,59,0,0,0,6,6,5,3,15,19,5,5,0,0
S01012876,Very bad health,15,0,0,0,1,2,0,0,6,3,3,2,1,0
S01012877,All people aged 16 to 74,552,8,3,5,67,107,31,51,113,122,23,13,10,30
S01012877,Very good health,211,1,1,0,29,48,15,23,35,32,5,2,3,23
S01012877,Good health,194,3,1,2,26,36,10,21,40,42,9,5,4,7
S01012877,Fair health,82,3,0,3,5,17,4,2,20,28,3,2,1,0
S01012877,Bad health,49,1,1,0,5,5,2,4,13,15,4,2,2,0
S01012877,Very bad health,16,0,0,0,2,1,0,1,5,5,2,2,0,0
S01012878,All people aged 16 to 74,726,99,25,74,193,148,52,46,81,42,8,3,5,57
S01012878,Very good health,436,70,19,51,104,92,29,22,47,18,3,0,3,51
S01012878,Good health,213,25,5,20,75,39,17,13,20,18,3,1,2,3
S01012878,Fair health,54,0,0,0,10,14,4,7,12,3,2,2,0,2
S01012878,Bad health,20,4,1,3,3,2,2,4,2,2,0,0,0,1
S01012878,Very bad health,3,0,0,0,1,1,0,0,0,1,0,0,0,0
S01012879,All people aged 16 to 74,535,76,12,64,143,82,37,33,49,44,17,7,10,54
S01012879,Very good health,313,46,7,39,86,48,22,19,19,18,6,4,2,49
S01012879,Good health,161,28,4,24,45,28,8,9,17,16,6,0,6,4
S01012879,Fair health,42,2,1,1,10,4,5,2,7,7,5,3,2,0
S01012879,Bad health,13,0,0,0,2,1,1,2,3,3,0,0,0,1
S01012879,Very bad health,6,0,0,0,0,1,1,1,3,0,0,0,0,0
S01012880,All people aged 16 to 74,659,129,18,111,188,96,41,34,62,21,16,11,5,72
S01012880,Very good health,379,78,9,69,117,49,23,17,28,6,5,2,3,56
S01012880,Good health,203,36,8,28,58,32,14,13,23,8,5,4,1,14
S01012880,Fair health,60,12,1,11,10,13,3,2,10,5,3,3,0,2
S01012880,Bad health,15,3,0,3,2,2,1,2,1,1,3,2,1,0
S01012880,Very bad health,2,0,0,0,1,0,0,0,0,1,0,0,0,0
S01012881,All people aged 16 to 74,604,87,17,70,162,113,43,34,65,36,18,14,4,46
S01012881,Very good health,346,57,11,46,107,54,22,17,32,11,4,2,2,42
S01012881,Good health,169,21,5,16,41,41,16,10,19,11,7,6,1,3
S01012881,Fair health,62,8,1,7,10,14,4,4,9,7,6,5,1,0
S01012881,Bad health,17,1,0,1,3,1,1,2,3,4,1,1,0,1
S01012881,Very bad health,10,0,0,0,1,3,0,1,2,3,0,0,0,0
S01012882,All people aged 16 to 74,452,20,5,15,61,55,31,47,92,81,29,18,11,36
S01012882,Very good health,160,10,2,8,23,24,8,15,26,25,4,4,0,25
S01012882,Good health,172,7,2,5,26,19,7,17,45,27,13,8,5,11
S01012882,Fair health,80,2,1,1,8,10,9,9,16,17,9,4,5,0
S01012882,Bad health,36,0,0,0,4,2,5,6,5,11,3,2,1,0
S01012882,Very bad health,4,1,0,1,0,0,2,0,0,1,0,0,0,0
S01012883,All people aged 16 to 74,456,17,4,13,49,48,34,31,103,100,54,28,26,20
S01012883,Very good health,139,9,2,7,21,12,10,5,34,19,17,4,13,12
S01012883,Good health,149,4,0,4,19,15,12,8,34,34,16,9,7,7
S01012883,Fair health,91,3,1,2,7,10,5,9,21,22,13,8,5,1
S01012883,Bad health,64,1,1,0,1,8,4,9,13,23,5,4,1,0
S01012883,Very bad health,13,0,0,0,1,3,3,0,1,2,3,3,0,0
S01012884,All people aged 16 to 74,352,41,11,30,81,35,26,23,46,52,21,13,8,27
S01012884,Very good health,160,22,8,14,50,25,9,5,15,11,2,1,1,21
S01012884,Good health,106,12,2,10,23,6,10,5,21,15,8,4,4,6
S01012884,Fair health,55,6,1,5,7,1,6,5,7,15,8,5,3,0
S01012884,Bad health,22,1,0,1,1,1,0,6,3,8,2,2,0,0
S01012884,Very bad health,9,0,0,0,0,2,1,2,0,3,1,1,0,0
S01012885,All people aged 16 to 74,347,4,1,3,28,47,20,24,86,81,42,27,15,15
S01012885,Very good health,121,4,1,3,16,20,9,7,35,16,6,3,3,8
S01012885,Good health,126,0,0,0,9,16,7,5,33,35,14,7,7,7
S01012885,Fair health,49,0,0,0,0,5,3,7,7,18,9,6,3,0
S01012885,Bad health,44,0,0,0,3,6,1,3,10,10,11,9,2,0
S01012885,Very bad health,7,0,0,0,0,0,0,2,1,2,2,2,0,0
S01012886,All people aged 16 to 74,573,71,10,61,169,97,38,48,57,38,13,9,4,42
S01012886,Very good health,318,49,5,44,98,45,12,23,29,17,9,5,4,36
S01012886,Good health,183,13,4,9,61,35,16,20,17,15,1,1,0,5
S01012886,Fair health,56,8,1,7,7,12,7,5,10,4,3,3,0,0
S01012886,Bad health,10,0,0,0,2,3,2,0,1,1,0,0,0,1
S01012886,Very bad health,6,1,0,1,1,2,1,0,0,1,0,0,0,0
S01012887,All people aged 16 to 74,542,83,17,66,151,94,30,38,62,34,15,9,6,35
S01012887,Very good health,286,55,7,48,78,44,14,16,30,14,5,3,2,30
S01012887,Good health,185,19,8,11,59,40,11,15,21,11,5,2,3,4
S01012887,Fair health,53,8,2,6,13,8,5,2,8,4,4,3,1,1
S01012887,Bad health,10,0,0,0,1,0,0,2,3,3,1,1,0,0
S01012887,Very bad health,8,1,0,1,0,2,0,3,0,2,0,0,0,0
S01012888,All people aged 16 to 74,588,125,20,105,176,80,46,29,30,34,11,7,4,57
S01012888,Very good health,340,78,14,64,101,40,28,15,15,11,6,2,4,46
S01012888,Good health,170,34,5,29,60,24,15,7,8,12,1,1,0,9
S01012888,Fair health,58,12,1,11,12,13,2,5,4,6,2,2,0,2
S01012888,Bad health,15,0,0,0,3,2,0,2,2,4,2,2,0,0
S01012888,Very bad health,5,1,0,1,0,1,1,0,1,1,0,0,0,0
S01012889,All people aged 16 to 74,651,75,15,60,173,87,55,47,85,75,19,18,1,35
S01012889,Very good health,372,51,9,42,115,48,24,27,45,24,8,7,1,30
S01012889,Good health,169,15,1,14,43,30,20,15,22,18,2,2,0,4
S01012889,Fair health,62,7,4,3,9,6,6,3,10,19,1,1,0,1
S01012889,Bad health,39,2,1,1,5,3,5,2,4,11,7,7,0,0
S01012889,Very bad health,9,0,0,0,1,0,0,0,4,3,1,1,0,0
S01012890,All people aged 16 to 74,529,26,7,19,70,60,29,43,105,106,49,36,13,41
S01012890,Very good health,203,15,5,10,34,22,11,17,28,34,14,10,4,28
S01012890,Good health,176,9,2,7,26,20,10,9,39,41,13,8,5,9
S01012890,Fair health,87,2,0,2,5,11,5,8,21,17,14,10,4,4
S01012890,Bad health,52,0,0,0,4,5,3,7,15,11,7,7,0,0
S01012890,Very bad health,11,0,0,0,1,2,0,2,2,3,1,1,0,0
S01012891,All people aged 16 to 74,408,14,3,11,56,51,39,32,93,85,19,9,10,19
S01012891,Very good health,152,8,1,7,30,16,21,14,24,17,9,5,4,13
S01012891,Good health,135,4,1,3,18,24,10,11,32,28,5,1,4,3
S01012891,Fair health,75,2,1,1,4,7,5,5,22,24,4,3,1,2
S01012891,Bad health,36,0,0,0,3,4,2,1,10,14,1,0,1,1
S01012891,Very bad health,10,0,0,0,1,0,1,1,5,2,0,0,0,0
S01012892,All people aged 16 to 74,834,29,6,23,84,110,42,93,181,180,75,34,41,40
S01012892,Very good health,297,11,3,8,38,56,10,33,56,42,19,9,10,32
S01012892,Good health,297,14,2,12,28,38,22,25,65,61,37,11,26,7
S01012892,Fair health,135,3,1,2,13,13,4,17,32,38,14,9,5,1
S01012892,Bad health,88,1,0,1,5,2,5,15,26,31,3,3,0,0
S01012892,Very bad health,17,0,0,0,0,1,1,3,2,8,2,2,0,0
S01012893,All people aged 16 to 74,529,13,3,10,48,62,23,55,144,104,44,25,19,36
S01012893,Very good health,208,5,0,5,21,24,7,18,63,35,14,5,9,21
S01012893,Good health,177,5,2,3,21,18,8,19,51,27,15,8,7,13
S01012893,Fair health,92,2,0,2,4,15,5,9,20,24,11,8,3,2
S01012893,Bad health,45,1,1,0,2,4,2,7,9,16,4,4,0,0
S01012893,Very bad health,7,0,0,0,0,1,1,2,1,2,0,0,0,0
S01012894,All people aged 16 to 74,568,72,14,58,152,75,45,28,66,55,26,18,8,49
S01012894,Very good health,331,53,9,44,107,41,24,17,30,18,8,4,4,33
S01012894,Good health,151,17,4,13,31,24,15,5,19,22,5,2,3,13
S01012894,Fair health,42,0,0,0,12,3,3,1,9,6,5,4,1,3
S01012894,Bad health,32,2,1,1,1,5,2,2,5,7,8,8,0,0
S01012894,Very bad health,12,0,0,0,1,2,1,3,3,2,0,0,0,0
S01012895,All people aged 16 to 74,388,50,13,37,105,46,49,26,42,28,11,7,4,31
S01012895,Very good health,247,40,11,29,67,28,29,17,24,11,5,3,2,26
S01012895,Good health,113,9,2,7,34,14,16,8,13,11,3,1,2,5
S01012895,Fair health,17,1,0,1,3,2,1,0,2,5,3,3,0,0
S01012895,Bad health,9,0,0,0,1,1,3,1,2,1,0,0,0,0
S01012895,Very bad health,2,0,0,0,0,1,0,0,1,0,0,0,0,0
S01012896,All people aged 16 to 74,681,39,10,29,127,113,44,62,134,92,34,20,14,36
S01012896,Very good health,236,14,1,13,53,42,11,12,37,27,12,6,6,28
S01012896,Good health,251,18,7,11,37,45,21,23,56,38,5,3,2,8
S01012896,Fair health,124,5,2,3,25,20,8,18,23,17,8,3,5,0
S01012896,Bad health,59,2,0,2,9,5,3,8,15,9,8,7,1,0
S01012896,Very bad health,11,0,0,0,3,1,1,1,3,1,1,1,0,0
S01012897,All people aged 16 to 74,451,54,8,46,112,72,35,38,71,27,12,10,2,30
S01012897,Very good health,253,38,6,32,63,48,16,22,26,13,6,5,1,21
S01012897,Good health,139,12,1,11,44,16,12,11,24,7,4,3,1,9
S01012897,Fair health,41,3,0,3,5,4,7,4,15,2,1,1,0,0
S01012897,Bad health,12,1,1,0,0,2,0,1,5,2,1,1,0,0
S01012897,Very bad health,6,0,0,0,0,2,0,0,1,3,0,0,0,0
S01012898,All people aged 16 to 74,397,71,16,55,104,59,32,28,36,20,8,3,5,39
S01012898,Very good health,265,59,13,46,64,39,16,17,21,10,3,1,2,36
S01012898,Good health,103,10,3,7,33,14,12,8,12,7,4,1,3,3
S01012898,Fair health,21,2,0,2,5,5,3,2,2,1,1,1,0,0
S01012898,Bad health,6,0,0,0,2,1,1,1,1,0,0,0,0,0
S01012898,Very bad health,2,0,0,0,0,0,0,0,0,2,0,0,0,0
S01012899,All people aged 16 to 74,444,13,2,11,69,70,32,48,82,87,27,8,19,16
S01012899,Very good health,164,7,0,7,38,20,9,13,28,35,4,0,4,10
S01012899,Good health,151,2,1,1,19,30,11,20,26,28,11,3,8,4
S01012899,Fair health,79,3,1,2,9,14,8,8,16,12,9,3,6,0
S01012899,Bad health,37,1,0,1,2,3,2,6,9,9,3,2,1,2
S01012899,Very bad health,13,0,0,0,1,3,2,1,3,3,0,0,0,0
S01012900,All people aged 16 to 74,457,53,9,44,123,67,56,36,37,43,15,11,4,27
S01012900,Very good health,230,37,7,30,64,32,23,20,13,13,6,4,2,22
S01012900,Good health,150,11,2,9,43,23,19,11,17,17,6,5,1,3
S01012900,Fair health,57,5,0,5,7,9,11,5,6,10,3,2,1,1
S01012900,Bad health,18,0,0,0,8,3,2,0,1,3,0,0,0,1
S01012900,Very bad health,2,0,0,0,1,0,1,0,0,0,0,0,0,0
S01012901,All people aged 16 to 74,523,29,9,20,102,92,39,44,87,69,22,7,15,39
S01012901,Very good health,239,15,3,12,59,37,13,14,33,30,11,1,10,27
S01012901,Good health,184,10,5,5,31,32,19,20,37,20,4,1,3,11
S01012901,Fair health,79,3,1,2,8,17,6,9,13,16,6,4,2,1
S01012901,Bad health,20,1,0,1,4,6,1,1,3,3,1,1,0,0
S01012901,Very bad health,1,0,0,0,0,0,0,0,1,0,0,0,0,0
S01012902,All people aged 16 to 74,585,33,8,25,143,105,34,52,91,71,23,9,14,33
S01012902,Very good health,276,22,5,17,74,64,13,20,29,20,10,6,4,24
S01012902,Good health,207,7,3,4,53,27,16,23,40,27,9,2,7,5
S01012902,Fair health,70,4,0,4,12,8,5,6,15,15,1,0,1,4
S01012902,Bad health,30,0,0,0,4,5,0,3,7,9,2,0,2,0
S01012902,Very bad health,2,0,0,0,0,1,0,0,0,0,1,1,0,0
S01012903,All people aged 16 to 74,619,28,6,22,103,112,32,62,112,86,28,9,19,56
S01012903,Very good health,279,15,4,11,52,50,13,28,48,30,8,1,7,35
S01012903,Good health,203,8,1,7,31,37,14,20,40,27,12,3,9,14
S01012903,Fair health,92,1,0,1,13,19,5,9,14,19,7,4,3,5
S01012903,Bad health,35,3,0,3,5,4,0,3,10,8,1,1,0,1
S01012903,Very bad health,10,1,1,0,2,2,0,2,0,2,0,0,0,1
S01012904,All people aged 16 to 74,573,23,4,19,105,116,39,57,97,58,35,21,14,43
S01012904,Very good health,263,12,2,10,52,51,19,23,37,22,11,5,6,36
S01012904,Good health,217,8,1,7,42,48,14,22,36,21,19,13,6,7
S01012904,Fair health,64,2,0,2,8,11,4,10,16,10,3,2,1,0
S01012904,Bad health,23,1,1,0,3,4,0,1,7,5,2,1,1,0
S01012904,Very bad health,6,0,0,0,0,2,2,1,1,0,0,0,0,0
S01012905,All people aged 16 to 74,465,15,3,12,68,79,24,45,95,67,24,11,13,48
S01012905,Very good health,195,6,1,5,28,33,8,22,40,20,9,5,4,29
S01012905,Good health,173,5,0,5,35,26,8,12,35,26,8,6,2,18
S01012905,Fair health,68,3,1,2,3,15,6,7,14,15,5,0,5,0
S01012905,Bad health,21,1,1,0,1,5,1,3,4,4,1,0,1,1
S01012905,Very bad health,8,0,0,0,1,0,1,1,2,2,1,0,1,0
S01012906,All people aged 16 to 74,693,57,9,48,197,121,39,66,100,55,18,6,12,40
S01012906,Very good health,340,25,5,20,98,68,23,34,38,19,7,2,5,28
S01012906,Good health,256,23,2,21,79,38,11,21,46,25,5,1,4,8
S01012906,Fair health,68,7,2,5,14,13,3,5,12,7,3,1,2,4
S01012906,Bad health,20,1,0,1,5,2,2,4,1,3,2,1,1,0
S01012906,Very bad health,9,1,0,1,1,0,0,2,3,1,1,1,0,0
S01012907,All people aged 16 to 74,607,23,4,19,116,116,36,60,110,86,22,12,10,38
S01012907,Very good health,284,17,3,14,67,50,16,28,38,31,7,4,3,30
S01012907,Good health,200,4,1,3,32,43,17,23,40,31,6,3,3,4
S01012907,Fair health,80,0,0,0,13,11,1,6,20,17,8,4,4,4
S01012907,Bad health,32,1,0,1,3,7,2,3,10,5,1,1,0,0
S01012907,Very bad health,11,1,0,1,1,5,0,0,2,2,0,0,0,0
S01012908,All people aged 16 to 74,524,18,3,15,85,88,30,50,89,83,38,18,20,43
S01012908,Very good health,216,8,1,7,47,32,8,23,38,22,11,3,8,27
S01012908,Good health,171,6,1,5,28,40,14,11,26,28,11,5,6,7
S01012908,Fair health,87,2,0,2,6,10,7,11,15,16,13,7,6,7
S01012908,Bad health,35,1,1,0,2,6,0,2,7,13,2,2,0,2
S01012908,Very bad health,15,1,0,1,2,0,1,3,3,4,1,1,0,0
S01012909,All people aged 16 to 74,411,22,5,17,95,85,16,32,68,55,22,13,9,16
S01012909,Very good health,175,11,0,11,53,31,9,12,24,18,4,2,2,13
S01012909,Good health,151,5,3,2,31,37,4,15,29,15,13,7,6,2
S01012909,Fair health,52,2,0,2,6,14,1,3,9,11,5,4,1,1
S01012909,Bad health,27,3,1,2,3,3,2,1,4,11,0,0,0,0
S01012909,Very bad health,6,1,1,0,2,0,0,1,2,0,0,0,0,0
S01012910,All people aged 16 to 74,654,24,6,18,112,100,52,56,129,113,34,15,19,34
S01012910,Very good health,239,12,3,9,48,38,19,22,41,33,6,3,3,20
S01012910,Good health,249,10,3,7,44,37,21,18,48,40,19,5,14,12
S01012910,Fair health,105,1,0,1,13,17,7,13,22,26,4,3,1,2
S01012910,Bad health,41,0,0,0,5,5,3,3,13,8,4,3,1,0
S01012910,Very bad health,20,1,0,1,2,3,2,0,5,6,1,1,0,0
S01012911,All people aged 16 to 74,536,40,7,33,118,78,29,56,97,52,15,12,3,51
S01012911,Very good health,288,26,5,21,65,32,16,31,46,20,7,5,2,45
S01012911,Good health,172,9,0,9,42,35,11,17,34,15,3,2,1,6
S01012911,Fair health,49,2,2,0,6,8,1,6,14,12,0,0,0,0
S01012911,Bad health,17,1,0,1,4,3,0,1,3,4,1,1,0,0
S01012911,Very bad health,10,2,0,2,1,0,1,1,0,1,4,4,0,0
S01012912,All people aged 16 to 74,476,26,10,16,85,89,29,37,87,70,24,10,14,29
S01012912,Very good health,211,9,4,5,39,45,18,15,35,21,6,2,4,23
S01012912,Good health,150,13,5,8,27,22,6,15,30,25,6,2,4,6
S01012912,Fair health,82,3,1,2,12,17,4,5,13,18,10,4,6,0
S01012912,Bad health,25,1,0,1,7,4,0,1,7,5,0,0,0,0
S01012912,Very bad health,8,0,0,0,0,1,1,1,2,1,2,2,0,0
S01012913,All people aged 16 to 74,623,49,7,42,111,120,29,49,106,96,21,8,13,42
S01012913,Very good health,296,27,2,25,57,63,13,19,38,42,4,3,1,33
S01012913,Good health,198,17,2,15,44,37,7,20,35,25,9,2,7,4
S01012913,Fair health,91,4,3,1,7,17,4,8,22,21,5,0,5,3
S01012913,Bad health,30,1,0,1,2,3,5,1,11,5,1,1,0,1
S01012913,Very bad health,8,0,0,0,1,0,0,1,0,3,2,2,0,1
S01012914,All people aged 16 to 74,636,63,8,55,142,90,41,68,93,75,25,12,13,39
S01012914,Very good health,294,51,5,46,63,46,21,28,30,25,6,3,3,24
S01012914,Good health,225,10,3,7,61,33,14,27,33,26,9,3,6,12
S01012914,Fair health,75,2,0,2,13,6,3,9,18,14,7,4,3,3
S01012914,Bad health,31,0,0,0,3,4,3,3,9,7,2,1,1,0
S01012914,Very bad health,11,0,0,0,2,1,0,1,3,3,1,1,0,0
S01012915,All people aged 16 to 74,745,74,21,53,196,125,47,72,96,70,25,6,19,40
S01012915,Very good health,412,54,11,43,111,76,22,39,41,31,10,1,9,28
S01012915,Good health,234,16,8,8,60,35,20,22,39,22,8,2,6,12
S01012915,Fair health,73,3,1,2,21,11,2,7,11,13,5,1,4,0
S01012915,Bad health,24,1,1,0,3,3,3,4,5,3,2,2,0,0
S01012915,Very bad health,2,0,0,0,1,0,0,0,0,1,0,0,0,0
S01012916,All people aged 16 to 74,510,42,7,35,124,87,28,44,63,58,10,7,3,54
S01012916,Very good health,257,22,3,19,69,46,9,16,23,31,2,2,0,39
S01012916,Good health,161,13,1,12,34,32,13,18,23,16,3,1,2,9
S01012916,Fair health,59,6,3,3,11,6,3,9,10,8,4,3,1,2
S01012916,Bad health,26,1,0,1,8,2,2,1,4,3,1,1,0,4
S01012916,Very bad health,7,0,0,0,2,1,1,0,3,0,0,0,0,0
S01012917,All people aged 16 to 74,537,57,6,51,139,100,41,35,68,31,5,5,0,61
S01012917,Very good health,303,31,2,29,72,54,21,18,37,14,2,2,0,54
S01012917,Good health,176,22,3,19,49,35,15,14,22,10,2,2,0,7
S01012917,Fair health,44,3,1,2,13,9,4,3,7,4,1,1,0,0
S01012917,Bad health,12,1,0,1,4,1,1,0,2,3,0,0,0,0
S01012917,Very bad health,2,0,0,0,1,1,0,0,0,0,0,0,0,0
S01012918,All people aged 16 to 74,352,24,7,17,63,70,20,40,51,51,11,4,7,22
S01012918,Very good health,174,17,5,12,25,36,10,16,22,26,4,2,2,18
S01012918,Good health,121,4,1,3,30,27,7,15,19,14,2,1,1,3
S01012918,Fair health,40,3,1,2,5,7,2,6,5,7,4,0,4,1
S01012918,Bad health,14,0,0,0,3,0,1,2,4,4,0,0,0,0
S01012918,Very bad health,3,0,0,0,0,0,0,1,1,0,1,1,0,0
S01012919,All people aged 16 to 74,334,15,2,13,77,64,17,38,51,42,18,10,8,12
S01012919,Very good health,159,8,1,7,34,33,8,24,16,16,9,5,4,11
S01012919,Good health,112,5,1,4,25,23,9,10,20,17,2,0,2,1
S01012919,Fair health,39,2,0,2,12,6,0,2,11,2,4,2,2,0
S01012919,Bad health,19,0,0,0,4,2,0,2,2,7,2,2,0,0
S01012919,Very bad health,5,0,0,0,2,0,0,0,2,0,1,1,0,0
S01012920,All people aged 16 to 74,466,63,11,52,146,83,49,22,42,14,9,3,6,38
S01012920,Very good health,233,35,6,29,74,34,19,12,18,5,4,1,3,32
S01012920,Good health,163,22,4,18,51,35,21,7,17,3,3,1,2,4
S01012920,Fair health,53,6,1,5,15,12,4,1,6,6,2,1,1,1
S01012920,Bad health,14,0,0,0,4,2,4,2,1,0,0,0,0,1
S01012920,Very bad health,3,0,0,0,2,0,1,0,0,0,0,0,0,0
S01012921,All people aged 16 to 74,511,24,9,15,91,97,24,44,95,69,24,13,11,43
S01012921,Very good health,221,12,5,7,48,42,8,13,36,23,9,5,4,30
S01012921,Good health,199,7,2,5,30,47,14,16,37,26,11,4,7,11
S01012921,Fair health,62,4,2,2,8,6,1,12,14,13,2,2,0,2
S01012921,Bad health,23,0,0,0,4,2,1,2,7,6,1,1,0,0
S01012921,Very bad health,6,1,0,1,1,0,0,1,1,1,1,1,0,0
S01012922,All people aged 16 to 74,719,60,14,46,171,114,36,58,119,84,19,10,9,58
S01012922,Very good health,363,38,9,29,93,59,21,22,39,32,8,3,5,51
S01012922,Good health,237,19,5,14,56,36,9,24,48,36,4,2,2,5
S01012922,Fair health,77,3,0,3,13,13,6,5,19,10,6,4,2,2
S01012922,Bad health,32,0,0,0,8,5,0,5,9,4,1,1,0,0
S01012922,Very bad health,10,0,0,0,1,1,0,2,4,2,0,0,0,0
S01012923,All people aged 16 to 74,541,41,12,29,112,97,35,48,78,61,14,12,2,55
S01012923,Very good health,302,23,7,16,71,51,16,22,37,33,5,5,0,44
S01012923,Good health,170,12,4,8,33,38,11,13,31,19,3,3,0,10
S01012923,Fair health,52,5,1,4,6,5,5,9,9,7,5,4,1,1
S01012923,Bad health,16,1,0,1,2,3,3,3,1,2,1,0,1,0
S01012923,Very bad health,1,0,0,0,0,0,0,1,0,0,0,0,0,0
S01012924,All people aged 16 to 74,395,31,10,21,83,72,37,36,51,39,13,4,9,33
S01012924,Very good health,187,20,5,15,39,37,18,13,17,14,2,0,2,27
S01012924,Good health,140,10,4,6,29,26,13,15,21,15,5,0,5,6
S01012924,Fair health,46,1,1,0,12,5,4,3,12,6,3,1,2,0
S01012924,Bad health,20,0,0,0,3,4,2,4,1,3,3,3,0,0
S01012924,Very bad health,2,0,0,0,0,0,0,1,0,1,0,0,0,0
S01012925,All people aged 16 to 74,378,42,12,30,108,74,22,19,36,23,7,1,6,47
S01012925,Very good health,243,31,10,21,65,47,9,11,18,15,5,1,4,42
S01012925,Good health,101,10,2,8,34,15,9,6,16,6,2,0,2,3
S01012925,Fair health,27,1,0,1,8,7,4,1,2,2,0,0,0,2
S01012925,Bad health,7,0,0,0,1,5,0,1,0,0,0,0,0,0
S01012925,Very bad health,0,0,0,0,0,0,0,0,0,0,0,0,0,0
S01012926,All people aged 16 to 74,558,45,10,35,126,99,45,49,71,52,21,7,14,50
S01012926,Very good health,279,25,6,19,54,52,15,24,35,26,10,2,8,38
S01012926,Good health,198,19,4,15,57,33,19,14,25,14,6,2,4,11
S01012926,Fair health,58,0,0,0,12,11,7,6,9,8,4,2,2,1
S01012926,Bad health,21,1,0,1,3,3,4,5,1,3,1,1,0,0
S01012926,Very bad health,2,0,0,0,0,0,0,0,1,1,0,0,0,0
S01012927,All people aged 16 to 74,582,41,2,39,121,91,29,52,97,79,14,7,7,58
S01012927,Very good health,271,21,1,20,58,53,15,23,25,23,8,5,3,45
S01012927,Good health,198,11,1,10,47,28,11,20,37,30,3,1,2,11
S01012927,Fair health,73,7,0,7,10,6,2,5,22,17,2,0,2,2
S01012927,Bad health,26,0,0,0,4,2,1,2,10,7,0,0,0,0
S01012927,Very bad health,14,2,0,2,2,2,0,2,3,2,1,1,0,0
S01012928,All people aged 16 to 74,596,43,11,32,158,111,33,39,79,55,16,8,8,62
S01012928,Very good health,320,26,9,17,86,59,17,23,31,23,5,1,4,50
S01012928,Good health,202,12,2,10,53,37,16,13,33,22,7,3,4,9
S01012928,Fair health,49,3,0,3,11,11,0,2,10,7,2,2,0,3
S01012928,Bad health,18,1,0,1,6,3,0,1,5,2,0,0,0,0
S01012928,Very bad health,7,1,0,1,2,1,0,0,0,1,2,2,0,0
S01012929,All people aged 16 to 74,541,44,9,35,117,113,27,51,74,61,9,6,3,45
S01012929,Very good health,284,27,4,23,71,54,10,24,35,23,3,2,1,37
S01012929,Good health,174,14,5,9,36,38,12,14,23,26,4,3,1,7
S01012929,Fair health,62,3,0,3,9,19,3,5,11,10,1,0,1,1
S01012929,Bad health,17,0,0,0,1,2,2,8,2,1,1,1,0,0
S01012929,Very bad health,4,0,0,0,0,0,0,0,3,1,0,0,0,0
S01012930,All people aged 16 to 74,607,60,9,51,155,103,39,48,68,81,28,10,18,25
S01012930,Very good health,290,37,4,33,88,43,24,16,27,26,9,1,8,20
S01012930,Good health,189,20,3,17,45,39,11,14,22,26,7,3,4,5
S01012930,Fair health,90,2,1,1,15,18,2,12,13,17,11,6,5,0
S01012930,Bad health,32,1,1,0,6,2,2,4,6,10,1,0,1,0
S01012930,Very bad health,6,0,0,0,1,1,0,2,0,2,0,0,0,0
S01012931,All people aged 16 to 74,649,48,11,37,138,127,37,62,99,77,21,11,10,40
S01012931,Very good health,316,33,6,27,79,63,15,24,46,26,3,1,2,27
S01012931,Good health,216,13,5,8,36,48,15,21,32,29,11,5,6,11
S01012931,Fair health,81,2,0,2,18,14,4,8,14,15,5,3,2,1
S01012931,Bad health,22,0,0,0,4,0,2,7,2,4,2,2,0,1
S01012931,Very bad health,14,0,0,0,1,2,1,2,5,3,0,0,0,0
S01012932,All people aged 16 to 74,368,57,13,44,90,45,37,32,41,23,8,6,2,35
S01012932,Very good health,199,32,10,22,56,21,22,20,12,5,3,2,1,28
S01012932,Good health,128,22,3,19,25,16,12,9,22,12,3,2,1,7
S01012932,Fair health,31,3,0,3,6,6,2,1,6,5,2,2,0,0
S01012932,Bad health,8,0,0,0,2,2,1,2,0,1,0,0,0,0
S01012932,Very bad health,2,0,0,0,1,0,0,0,1,0,0,0,0,0
S01012933,All people aged 16 to 74,597,41,7,34,111,107,39,55,97,70,35,23,12,42
S01012933,Very good health,305,24,2,22,69,58,18,23,38,29,12,8,4,34
S01012933,Good health,188,13,4,9,33,34,17,19,38,17,12,7,5,5
S01012933,Fair health,75,4,1,3,6,7,3,12,13,19,8,5,3,3
S01012933,Bad health,24,0,0,0,3,7,1,1,7,4,1,1,0,0
S01012933,Very bad health,5,0,0,0,0,1,0,0,1,1,2,2,0,0
S01012934,All people aged 16 to 74,500,36,5,31,108,85,39,45,82,60,27,14,13,18
S01012934,Very good health,200,17,2,15,53,47,17,17,23,9,3,1,2,14
S01012934,Good health,181,11,3,8,41,29,11,19,38,17,14,4,10,1
S01012934,Fair health,84,8,0,8,10,3,10,7,13,25,6,5,1,2
S01012934,Bad health,20,0,0,0,3,6,0,1,4,3,2,2,0,1
S01012934,Very bad health,15,0,0,0,1,0,1,1,4,6,2,2,0,0
S01012935,All people aged 16 to 74,616,51,11,40,124,109,33,41,108,68,26,10,16,56
S01012935,Very good health,294,28,7,21,71,57,9,20,44,16,5,3,2,44
S01012935,Good health,209,17,3,14,33,39,16,13,38,28,14,5,9,11
S01012935,Fair health,83,4,1,3,12,9,6,6,20,20,6,1,5,0
S01012935,Bad health,27,2,0,2,7,4,2,2,5,3,1,1,0,1
S01012935,Very bad health,3,0,0,0,1,0,0,0,1,1,0,0,0,0
S01012936,All people aged 16 to 74,524,51,10,41,111,77,43,48,68,60,31,19,12,35
S01012936,Very good health,251,26,4,22,59,33,21,27,26,24,7,1,6,28
S01012936,Good health,161,18,4,14,39,29,11,13,27,13,6,4,2,5
S01012936,Fair health,84,7,2,5,9,11,9,4,13,14,15,11,4,2
S01012936,Bad health,21,0,0,0,4,2,2,2,2,8,1,1,0,0
S01012936,Very bad health,7,0,0,0,0,2,0,2,0,1,2,2,0,0
S01012937,All people aged 16 to 74,526,53,14,39,118,90,19,41,73,52,30,15,15,50
S01012937,Very good health,238,31,7,24,62,38,8,10,29,15,7,5,2,38
S01012937,Good health,197,18,4,14,46,37,9,19,30,13,14,7,7,11
S01012937,Fair health,64,3,2,1,6,11,2,8,10,18,5,1,4,1
S01012937,Bad health,22,1,1,0,3,4,0,3,4,3,4,2,2,0
S01012937,Very bad health,5,0,0,0,1,0,0,1,0,3,0,0,0,0
S01012938,All people aged 16 to 74,528,97,21,76,142,69,39,31,47,33,11,5,6,59
S01012938,Very good health,287,58,15,43,83,33,19,10,15,11,7,2,5,51
S01012938,Good health,176,36,5,31,45,24,11,15,24,10,3,2,1,8
S01012938,Fair health,40,2,0,2,7,9,7,5,4,6,0,0,0,0
S01012938,Bad health,20,0,0,0,5,3,2,1,4,4,1,1,0,0
S01012938,Very bad health,5,1,1,0,2,0,0,0,0,2,0,0,0,0
S01012939,All people aged 16 to 74,477,71,11,60,129,82,29,29,48,17,9,6,3,63
S01012939,Very good health,299,46,3,43,69,54,14,21,28,9,3,2,1,55
S01012939,Good health,142,23,8,15,49,23,12,6,13,4,4,2,2,8
S01012939,Fair health,27,1,0,1,10,4,3,0,5,2,2,2,0,0
S01012939,Bad health,6,1,0,1,1,0,0,1,1,2,0,0,0,0
S01012939,Very bad health,3,0,0,0,0,1,0,1,1,0,0,0,0,0
S01012940,All people aged 16 to 74,555,83,13,70,148,109,49,33,55,22,5,4,1,51
S01012940,Very good health,338,49,7,42,89,62,29,17,30,14,3,3,0,45
S01012940,Good health,165,26,4,22,50,35,14,8,19,5,2,1,1,6
S01012940,Fair health,45,6,1,5,9,10,5,6,6,3,0,0,0,0
S01012940,Bad health,5,0,0,0,0,2,1,2,0,0,0,0,0,0
S01012940,Very bad health,2,2,1,1,0,0,0,0,0,0,0,0,0,0
S01012941,All people aged 16 to 74,592,107,27,80,177,99,44,24,39,20,11,9,2,71
S01012941,Very good health,368,63,17,46,114,59,27,15,17,8,3,3,0,62
S01012941,Good health,166,35,7,28,47,28,16,6,14,9,5,4,1,6
S01012941,Fair health,42,7,3,4,10,8,1,2,7,2,2,2,0,3
S01012941,Bad health,13,2,0,2,5,3,0,0,1,1,1,0,1,0
S01012941,Very bad health,3,0,0,0,1,1,0,1,0,0,0,0,0,0
S01012942,All people aged 16 to 74,555,27,4,23,86,88,19,60,112,87,30,13,17,46
S01012942,Very good health,247,19,3,16,42,39,15,22,43,30,10,6,4,27
S01012942,Good health,190,6,1,5,28,31,4,22,45,26,14,3,11,14
S01012942,Fair health,84,1,0,1,11,11,0,11,21,21,5,3,2,3
S01012942,Bad health,26,1,0,1,5,3,0,4,3,8,0,0,0,2
S01012942,Very bad health,8,0,0,0,0,4,0,1,0,2,1,1,0,0
S01012943,All people aged 16 to 74,538,64,14,50,143,84,35,46,68,40,13,4,9,45
S01012943,Very good health,314,39,10,29,91,51,19,26,30,15,6,1,5,37
S01012943,Good health,167,21,4,17,39,28,10,14,30,13,5,2,3,7
S01012943,Fair health,36,4,0,4,8,2,4,5,4,7,1,0,1,1
S01012943,Bad health,15,0,0,0,4,3,2,1,3,1,1,1,0,0
S01012943,Very bad health,6,0,0,0,1,0,0,0,1,4,0,0,0,0
S01012944,All people aged 16 to 74,379,52,7,45,135,66,26,15,24,15,10,6,4,36
S01012944,Very good health,207,30,3,27,72,32,10,10,12,5,6,4,2,30
S01012944,Good health,137,20,4,16,51,27,8,5,10,9,2,0,2,5
S01012944,Fair health,23,2,0,2,9,5,2,0,2,1,1,1,0,1
S01012944,Bad health,5,0,0,0,0,1,3,0,0,0,1,1,0,0
S01012944,Very bad health,7,0,0,0,3,1,3,0,0,0,0,0,0,0
S01012945,All people aged 16 to 74,538,98,22,76,159,89,45,29,33,17,10,5,5,58
S01012945,Very good health,349,65,14,51,100,60,22,19,20,12,4,1,3,47
S01012945,Good health,148,28,7,21,46,25,16,8,10,4,3,2,1,8
S01012945,Fair health,29,3,0,3,10,2,6,2,3,0,1,1,0,2
S01012945,Bad health,10,1,1,0,2,2,1,0,0,1,2,1,1,1
S01012945,Very bad health,2,1,0,1,1,0,0,0,0,0,0,0,0,0
S01012946,All people aged 16 to 74,658,78,13,65,202,116,46,45,54,39,5,5,0,73
S01012946,Very good health,396,50,10,40,133,61,25,18,27,19,1,1,0,62
S01012946,Good health,191,24,3,21,52,39,14,20,19,14,0,0,0,9
S01012946,Fair health,56,4,0,4,14,12,6,3,7,4,4,4,0,2
S01012946,Bad health,12,0,0,0,2,3,1,3,1,2,0,0,0,0
S01012946,Very bad health,3,0,0,0,1,1,0,1,0,0,0,0,0,0
S01012947,All people aged 16 to 74,365,68,12,56,99,52,36,13,17,19,9,5,4,52
S01012947,Very good health,239,44,9,35,60,31,22,8,10,12,5,3,2,47
S01012947,Good health,94,20,3,17,30,13,11,2,5,7,2,1,1,4
S01012947,Fair health,24,3,0,3,8,5,2,2,2,0,1,0,1,1
S01012947,Bad health,8,1,0,1,1,3,1,1,0,0,1,1,0,0
S01012947,Very bad health,0,0,0,0,0,0,0,0,0,0,0,0,0,0
S01012948,All people aged 16 to 74,553,55,15,40,135,107,49,31,73,43,7,6,1,53
S01012948,Very good health,315,33,11,22,85,57,21,13,42,17,2,1,1,45
S01012948,Good health,173,15,4,11,45,37,19,11,21,17,2,2,0,6
S01012948,Fair health,51,7,0,7,4,12,7,2,10,5,2,2,0,2
S01012948,Bad health,11,0,0,0,1,1,1,4,0,4,0,0,0,0
S01012948,Very bad health,3,0,0,0,0,0,1,1,0,0,1,1,0,0
S01012949,All people aged 16 to 74,562,52,9,43,147,104,50,45,56,43,15,10,5,50
S01012949,Very good health,321,38,7,31,80,54,22,31,28,21,8,5,3,39
S01012949,Good health,162,13,2,11,48,32,17,8,18,13,4,2,2,9
S01012949,Fair health,62,1,0,1,17,13,7,4,9,9,0,0,0,2
S01012949,Bad health,14,0,0,0,2,3,4,2,1,0,2,2,0,0
S01012949,Very bad health,3,0,0,0,0,2,0,0,0,0,1,1,0,0
S01012950,All people aged 16 to 74,672,109,22,87,198,113,46,23,53,27,16,7,9,87
S01012950,Very good health,460,70,15,55,144,69,25,13,31,19,9,3,6,80
S01012950,Good health,165,33,7,26,41,39,15,8,15,5,3,1,2,6
S01012950,Fair health,38,5,0,5,12,3,5,1,7,1,3,2,1,1
S01012950,Bad health,8,0,0,0,1,2,1,1,0,2,1,1,0,0
S01012950,Very bad health,1,1,0,1,0,0,0,0,0,0,0,0,0,0
S01012951,All people aged 16 to 74,646,137,34,103,228,80,62,20,44,19,11,8,3,45
S01012951,Very good health,473,108,25,83,169,60,42,10,29,10,9,7,2,36
S01012951,Good health,138,25,7,18,45,17,17,7,10,6,2,1,1,9
S01012951,Fair health,28,4,2,2,14,3,3,0,3,1,0,0,0,0
S01012951,Bad health,7,0,0,0,0,0,0,3,2,2,0,0,0,0
S01012951,Very bad health,0,0,0,0,0,0,0,0,0,0,0,0,0,0
S01012952,All people aged 16 to 74,463,94,19,75,128,56,81,15,22,12,8,6,2,47
S01012952,Very good health,301,66,11,55,81,29,54,10,11,7,4,2,2,39
S01012952,Good health,122,23,6,17,39,17,22,2,7,3,2,2,0,7
S01012952,Fair health,27,5,2,3,6,5,3,3,2,1,1,1,0,1
S01012952,Bad health,10,0,0,0,1,4,1,0,2,1,1,1,0,0
S01012952,Very bad health,3,0,0,0,1,1,1,0,0,0,0,0,0,0
S01012953,All people aged 16 to 74,541,57,12,45,139,131,38,24,58,42,13,10,3,39
S01012953,Very good health,312,37,9,28,82,71,19,13,34,17,6,4,2,33
S01012953,Good health,169,15,3,12,43,44,14,6,19,18,4,4,0,6
S01012953,Fair health,45,4,0,4,9,14,4,2,5,5,2,1,1,0
S01012953,Bad health,11,1,0,1,4,2,0,3,0,1,0,0,0,0
S01012953,Very bad health,4,0,0,0,1,0,1,0,0,1,1,1,0,0
S01012954,All people aged 16 to 74,380,31,2,29,94,78,26,26,54,33,7,1,6,31
S01012954,Very good health,216,21,1,20,55,41,11,17,25,19,4,1,3,23
S01012954,Good health,128,8,1,7,33,26,11,9,23,11,2,0,2,5
S01012954,Fair health,22,2,0,2,2,7,3,0,5,2,1,0,1,0
S01012954,Bad health,10,0,0,0,3,4,1,0,1,0,0,0,0,1
S01012954,Very bad health,4,0,0,0,1,0,0,0,0,1,0,0,0,2
S01012955,All people aged 16 to 74,697,123,28,95,205,117,41,43,54,34,17,10,7,63
S01012955,Very good health,420,87,16,71,122,70,22,28,26,15,4,3,1,46
S01012955,Good health,187,29,12,17,62,29,8,11,16,10,8,3,5,14
S01012955,Fair health,58,3,0,3,15,11,10,3,6,6,3,2,1,1
S01012955,Bad health,27,4,0,4,6,7,1,1,3,2,1,1,0,2
S01012955,Very bad health,5,0,0,0,0,0,0,0,3,1,1,1,0,0
S01012956,All people aged 16 to 74,683,50,5,45,116,125,39,63,96,96,38,27,11,60
S01012956,Very good health,323,28,1,27,66,51,23,27,36,35,10,6,4,47
S01012956,Good health,209,15,3,12,34,38,10,23,35,28,15,10,5,11
S01012956,Fair health,109,3,0,3,13,28,6,9,18,20,10,8,2,2
S01012956,Bad health,34,3,1,2,2,6,0,3,5,12,3,3,0,0
S01012956,Very bad health,8,1,0,1,1,2,0,1,2,1,0,0,0,0
S01012957,All people aged 16 to 74,483,28,8,20,89,78,28,43,82,69,28,11,17,38
S01012957,Very good health,210,14,6,8,42,32,8,19,35,27,8,3,5,25
S01012957,Good health,169,10,1,9,37,27,14,11,33,17,8,1,7,12
S01012957,Fair health,79,2,0,2,8,15,5,13,8,22,6,2,4,0
S01012957,Bad health,24,2,1,1,2,4,1,0,6,2,6,5,1,1
S01012957,Very bad health,1,0,0,0,0,0,0,0,0,1,0,0,0,0
S01012958,All people aged 16 to 74,416,30,4,26,87,74,33,31,64,49,19,16,3,29
S01012958,Very good health,201,21,2,19,54,36,15,11,24,12,9,7,2,19
S01012958,Good health,144,7,1,6,23,29,11,15,25,23,3,2,1,8
S01012958,Fair health,53,1,0,1,10,5,6,4,11,11,3,3,0,2
S01012958,Bad health,16,0,0,0,0,4,1,1,4,3,3,3,0,0
S01012958,Very bad health,2,1,1,0,0,0,0,0,0,0,1,1,0,0
S01012959,All people aged 16 to 74,455,39,11,28,111,86,31,28,67,39,9,8,1,45
S01012959,Very good health,256,28,7,21,61,44,11,16,29,19,7,6,1,41
S01012959,Good health,146,8,2,6,40,29,18,7,28,11,2,2,0,3
S01012959,Fair health,42,2,1,1,7,12,2,4,9,5,0,0,0,1
S01012959,Bad health,6,0,0,0,2,1,0,0,0,3,0,0,0,0
S01012959,Very bad health,5,1,1,0,1,0,0,1,1,1,0,0,0,0
S01012960,All people aged 16 to 74,478,50,6,44,107,74,28,31,81,48,18,8,10,41
S01012960,Very good health,247,30,5,25,56,37,19,11,36,20,7,3,4,31
S01012960,Good health,151,16,1,15,37,26,6,12,25,16,6,2,4,7
S01012960,Fair health,52,2,0,2,12,8,1,3,14,6,4,2,2,2
S01012960,Bad health,20,2,0,2,1,2,2,2,5,4,1,1,0,1
S01012960,Very bad health,8,0,0,0,1,1,0,3,1,2,0,0,0,0
S01012961,All people aged 16 to 74,400,52,15,37,106,80,32,18,39,33,4,1,3,36
S01012961,Very good health,217,36,12,24,58,42,16,7,18,14,0,0,0,26
S01012961,Good health,128,13,2,11,35,29,9,6,14,10,3,0,3,9
S01012961,Fair health,40,2,1,1,9,6,6,3,4,8,1,1,0,1
S01012961,Bad health,14,1,0,1,4,3,1,1,3,1,0,0,0,0
S01012961,Very bad health,1,0,0,0,0,0,0,1,0,0,0,0,0,0
S01012962,All people aged 16 to 74,526,69,13,56,146,106,32,35,56,26,5,2,3,51
S01012962,Very good health,303,40,9,31,89,55,15,15,28,13,3,1,2,45
S01012962,Good health,184,23,2,21,50,41,12,20,22,10,1,0,1,5
S01012962,Fair health,31,3,1,2,6,8,5,0,4,3,1,1,0,1
S01012962,Bad health,5,1,1,0,1,1,0,0,2,0,0,0,0,0
S01012962,Very bad health,3,2,0,2,0,1,0,0,0,0,0,0,0,0
S01012963,All people aged 16 to 74,590,88,24,64,166,98,43,41,63,32,9,5,4,50
S01012963,Very good health,366,62,17,45,101,56,25,25,32,20,4,2,2,41
S01012963,Good health,167,22,5,17,48,31,12,13,26,4,4,3,1,7
S01012963,Fair health,49,4,2,2,16,10,6,3,3,5,0,0,0,2
S01012963,Bad health,7,0,0,0,1,0,0,0,2,3,1,0,1,0
S01012963,Very bad health,1,0,0,0,0,1,0,0,0,0,0,0,0,0
S01012964,All people aged 16 to 74,443,65,16,49,123,63,41,40,32,27,7,2,5,45
S01012964,Very good health,279,42,8,34,74,44,25,27,15,16,2,0,2,34
S01012964,Good health,137,20,8,12,46,14,11,9,12,10,4,1,3,11
S01012964,Fair health,23,3,0,3,3,5,5,2,4,1,0,0,0,0
S01012964,Bad health,4,0,0,0,0,0,0,2,1,0,1,1,0,0
S01012964,Very bad health,0,0,0,0,0,0,0,0,0,0,0,0,0,0
S01012965,All people aged 16 to 74,458,66,9,57,107,65,23,33,66,40,12,5,7,46
S01012965,Very good health,257,49,4,45,60,35,11,19,28,15,3,1,2,37
S01012965,Good health,128,14,4,10,34,17,9,10,19,13,3,0,3,9
S01012965,Fair health,54,3,1,2,5,13,3,2,11,11,6,4,2,0
S01012965,Bad health,11,0,0,0,3,0,0,2,5,1,0,0,0,0
S01012965,Very bad health,8,0,0,0,5,0,0,0,3,0,0,0,0,0
S01012966,All people aged 16 to 74,518,43,7,36,122,68,40,44,79,64,16,7,9,42
S01012966,Very good health,277,25,3,22,72,33,24,25,34,21,7,3,4,36
S01012966,Good health,173,14,3,11,38,29,14,13,33,24,3,0,3,5
S01012966,Fair health,44,3,0,3,7,4,1,5,7,13,3,2,1,1
S01012966,Bad health,19,1,1,0,3,2,1,1,4,4,3,2,1,0
S01012966,Very bad health,5,0,0,0,2,0,0,0,1,2,0,0,0,0
S01012967,All people aged 16 to 74,383,16,2,14,62,60,22,40,75,64,16,8,8,28
S01012967,Very good health,164,8,1,7,26,23,5,16,34,24,5,3,2,23
S01012967,Good health,133,6,0,6,19,24,11,16,27,20,6,2,4,4
S01012967,Fair health,63,1,1,0,12,9,4,6,12,15,3,1,2,1
S01012967,Bad health,19,1,0,1,5,2,2,1,2,4,2,2,0,0
S01012967,Very bad health,4,0,0,0,0,2,0,1,0,1,0,0,0,0
S01012968,All people aged 16 to 74,504,20,1,19,83,90,29,36,107,99,12,9,3,28
S01012968,Very good health,241,11,1,10,42,43,14,21,48,39,2,1,1,21
S01012968,Good health,179,7,0,7,32,30,9,11,43,35,5,4,1,7
S01012968,Fair health,54,1,0,1,4,9,4,2,15,16,3,3,0,0
S01012968,Bad health,21,0,0,0,5,6,1,0,1,7,1,0,1,0
S01012968,Very bad health,9,1,0,1,0,2,1,2,0,2,1,1,0,0
S01012969,All people aged 16 to 74,512,30,6,24,81,82,26,42,97,96,13,5,8,45
S01012969,Very good health,218,17,2,15,38,31,14,13,34,34,3,1,2,34
S01012969,Good health,185,10,2,8,25,38,8,19,41,29,7,3,4,8
S01012969,Fair health,71,3,2,1,9,9,3,7,14,22,2,0,2,2
S01012969,Bad health,24,0,0,0,6,2,1,1,6,7,0,0,0,1
S01012969,Very bad health,14,0,0,0,3,2,0,2,2,4,1,1,0,0
S01012970,All people aged 16 to 74,449,21,5,16,83,60,35,38,94,78,16,9,7,24
S01012970,Very good health,200,12,4,8,54,22,20,16,33,27,1,0,1,15
S01012970,Good health,158,9,1,8,22,25,11,9,36,30,11,6,5,5
S01012970,Fair health,58,0,0,0,5,8,2,9,16,12,2,2,0,4
S01012970,Bad health,22,0,0,0,2,5,2,2,6,5,0,0,0,0
S01012970,Very bad health,11,0,0,0,0,0,0,2,3,4,2,1,1,0
S01012971,All people aged 16 to 74,628,27,6,21,93,78,35,53,114,120,43,27,16,65
S01012971,Very good health,307,13,4,9,48,44,19,29,44,51,10,9,1,49
S01012971,Good health,200,9,0,9,26,26,9,12,46,38,19,9,10,15
S01012971,Fair health,84,5,2,3,12,5,5,9,17,20,11,6,5,0
S01012971,Bad health,23,0,0,0,5,2,0,1,5,7,2,2,0,1
S01012971,Very bad health,14,0,0,0,2,1,2,2,2,4,1,1,0,0
S01012972,All people aged 16 to 74,572,14,4,10,70,94,37,67,113,119,28,16,12,30
S01012972,Very good health,235,7,1,6,32,46,7,29,47,36,11,6,5,20
S01012972,Good health,204,5,2,3,26,28,18,23,42,43,11,5,6,8
S01012972,Fair health,91,2,1,1,9,17,9,11,14,23,5,4,1,1
S01012972,Bad health,30,0,0,0,3,2,2,4,6,12,0,0,0,1
S01012972,Very bad health,12,0,0,0,0,1,1,0,4,5,1,1,0,0
S01012973,All people aged 16 to 74,587,35,11,24,97,101,29,61,126,84,25,18,7,29
S01012973,Very good health,248,19,5,14,34,48,9,25,48,34,7,6,1,24
S01012973,Good health,212,13,4,9,45,35,15,20,40,27,12,7,5,5
S01012973,Fair health,96,2,1,1,14,13,3,9,31,20,4,4,0,0
S01012973,Bad health,22,1,1,0,2,4,1,3,7,2,2,1,1,0
S01012973,Very bad health,9,0,0,0,2,1,1,4,0,1,0,0,0,0
S01012974,All people aged 16 to 74,703,36,6,30,112,87,44,65,151,127,46,25,21,35
S01012974,Very good health,276,17,3,14,51,28,16,28,57,43,15,4,11,21
S01012974,Good health,248,13,1,12,43,39,14,15,56,41,15,9,6,12
S01012974,Fair health,131,5,1,4,13,18,12,15,30,23,13,9,4,2
S01012974,Bad health,39,0,0,0,4,2,2,6,5,17,3,3,0,0
S01012974,Very bad health,9,1,1,0,1,0,0,1,3,3,0,0,0,0
S01012975,All people aged 16 to 74,431,18,6,12,51,71,19,45,103,78,22,12,10,24
S01012975,Very good health,169,9,2,7,19,25,7,21,32,26,11,5,6,19
S01012975,Good health,163,8,4,4,24,30,6,15,42,23,10,7,3,5
S01012975,Fair health,67,1,0,1,7,14,3,6,18,17,1,0,1,0
S01012975,Bad health,21,0,0,0,1,2,2,3,7,6,0,0,0,0
S01012975,Very bad health,11,0,0,0,0,0,1,0,4,6,0,0,0,0
S01012976,All people aged 16 to 74,401,22,6,16,63,64,18,26,99,61,13,6,7,35
S01012976,Very good health,178,14,2,12,25,22,3,11,53,21,2,0,2,27
S01012976,Good health,155,5,1,4,27,30,10,11,31,28,6,2,4,7
S01012976,Fair health,48,3,3,0,7,8,4,4,11,8,2,1,1,1
S01012976,Bad health,16,0,0,0,4,4,1,0,2,4,1,1,0,0
S01012976,Very bad health,4,0,0,0,0,0,0,0,2,0,2,2,0,0
S01012977,All people aged 16 to 74,541,21,5,16,80,63,34,59,116,92,26,17,9,50
S01012977,Very good health,226,10,1,9,36,27,11,17,38,39,14,11,3,34
S01012977,Good health,218,10,3,7,35,26,12,29,54,29,9,3,6,14
S01012977,Fair health,67,1,1,0,4,7,7,7,16,20,3,3,0,2
S01012977,Bad health,26,0,0,0,4,3,3,6,6,4,0,0,0,0
S01012977,Very bad health,4,0,0,0,1,0,1,0,2,0,0,0,0,0
S01012978,All people aged 16 to 74,618,25,8,17,79,81,37,60,108,125,39,30,9,64
S01012978,Very good health,254,16,6,10,34,34,7,24,45,38,13,12,1,43
S01012978,Good health,226,6,2,4,34,32,21,20,39,44,10,5,5,20
S01012978,Fair health,90,2,0,2,8,8,6,13,14,28,11,9,2,0
S01012978,Bad health,39,1,0,1,3,6,3,1,9,10,5,4,1,1
S01012978,Very bad health,9,0,0,0,0,1,0,2,1,5,0,0,0,0
S01012979,All people aged 16 to 74,476,24,5,19,88,57,32,46,97,72,18,13,5,42
S01012979,Very good health,239,15,1,14,44,30,17,23,43,25,8,6,2,34
S01012979,Good health,150,7,4,3,27,20,8,14,39,27,3,3,0,5
S01012979,Fair health,67,2,0,2,12,5,5,7,12,17,5,3,2,2
S01012979,Bad health,14,0,0,0,2,2,2,2,2,2,1,1,0,1
S01012979,Very bad health,6,0,0,0,3,0,0,0,1,1,1,0,1,0
S01012980,All people aged 16 to 74,494,20,3,17,86,84,21,49,85,77,34,15,19,38
S01012980,Very good health,244,11,2,9,50,49,9,22,47,20,12,3,9,24
S01012980,Good health,158,8,1,7,25,24,6,17,24,33,9,4,5,12
S01012980,Fair health,65,0,0,0,6,10,2,7,11,17,11,6,5,1
S01012980,Bad health,24,1,0,1,5,1,3,3,2,6,2,2,0,1
S01012980,Very bad health,3,0,0,0,0,0,1,0,1,1,0,0,0,0
S01012981,All people aged 16 to 74,585,30,10,20,107,95,24,57,100,98,18,7,11,56
S01012981,Very good health,278,19,5,14,58,44,8,27,39,31,6,1,5,46
S01012981,Good health,202,9,4,5,36,38,8,18,36,43,5,3,2,9
S01012981,Fair health,68,2,1,1,5,10,6,7,15,18,4,1,3,1
S01012981,Bad health,31,0,0,0,6,2,2,3,10,5,3,2,1,0
S01012981,Very bad health,6,0,0,0,2,1,0,2,0,1,0,0,0,0
S01012982,All people aged 16 to 74,619,22,7,15,115,118,29,70,105,105,20,11,9,35
S01012982,Very good health,278,10,4,6,49,59,15,27,54,34,8,6,2,22
S01012982,Good health,240,11,3,8,52,43,7,31,36,42,8,2,6,10
S01012982,Fair health,71,1,0,1,9,11,5,10,7,22,3,2,1,3
S01012982,Bad health,21,0,0,0,2,4,1,2,6,6,0,0,0,0
S01012982,Very bad health,9,0,0,0,3,1,1,0,2,1,1,1,0,0
S01012983,All people aged 16 to 74,566,50,6,44,127,118,35,35,85,51,10,2,8,55
S01012983,Very good health,312,29,4,25,76,54,21,15,40,26,7,1,6,44
S01012983,Good health,172,17,2,15,37,48,11,14,25,9,3,1,2,8
S01012983,Fair health,58,4,0,4,10,12,3,5,11,11,0,0,0,2
S01012983,Bad health,17,0,0,0,1,2,0,1,8,4,0,0,0,1
S01012983,Very bad health,7,0,0,0,3,2,0,0,1,1,0,0,0,0
S01012984,All people aged 16 to 74,472,29,5,24,115,78,22,38,82,51,15,5,10,42
S01012984,Very good health,249,16,1,15,60,44,11,19,37,18,6,3,3,38
S01012984,Good health,147,8,2,6,37,27,7,9,32,21,3,0,3,3
S01012984,Fair health,55,4,2,2,13,5,4,6,10,9,4,1,3,0
S01012984,Bad health,18,1,0,1,4,2,0,4,3,3,1,0,1,0
S01012984,Very bad health,3,0,0,0,1,0,0,0,0,0,1,1,0,1
S01012985,All people aged 16 to 74,574,24,4,20,107,101,42,66,89,81,15,11,4,49
S01012985,Very good health,289,18,2,16,54,51,15,26,43,37,7,5,2,38
S01012985,Good health,214,4,2,2,45,37,16,33,33,29,7,5,2,10
S01012985,Fair health,54,1,0,1,6,11,6,5,12,12,0,0,0,1
S01012985,Bad health,13,1,0,1,1,1,5,2,1,2,0,0,0,0
S01012985,Very bad health,4,0,0,0,1,1,0,0,0,1,1,1,0,0
S01012986,All people aged 16 to 74,560,19,5,14,109,104,27,47,96,99,24,12,12,35
S01012986,Very good health,251,13,2,11,55,50,11,19,45,24,5,1,4,29
S01012986,Good health,192,4,2,2,41,35,13,21,22,41,10,4,6,5
S01012986,Fair health,71,2,1,1,7,13,2,5,15,23,3,1,2,1
S01012986,Bad health,32,0,0,0,3,5,0,1,11,6,6,6,0,0
S01012986,Very bad health,14,0,0,0,3,1,1,1,3,5,0,0,0,0
S01012987,All people aged 16 to 74,539,24,2,22,93,87,44,43,96,86,21,11,10,45
S01012987,Very good health,250,18,1,17,52,42,15,12,39,31,7,2,5,34
S01012987,Good health,183,4,0,4,29,33,16,18,39,31,4,1,3,9
S01012987,Fair health,72,0,0,0,4,10,11,7,11,18,9,7,2,2
S01012987,Bad health,24,2,1,1,7,1,2,2,7,2,1,1,0,0
S01012987,Very bad health,10,0,0,0,1,1,0,4,0,4,0,0,0,0
S01012988,All people aged 16 to 74,620,30,7,23,125,95,30,73,110,90,21,11,10,46
S01012988,Very good health,263,17,4,13,63,38,11,32,31,26,6,6,0,39
S01012988,Good health,234,8,2,6,46,42,15,25,50,37,7,2,5,4
S01012988,Fair health,87,3,1,2,11,12,1,12,21,19,6,1,5,2
S01012988,Bad health,33,2,0,2,4,3,3,3,8,7,2,2,0,1
S01012988,Very bad health,3,0,0,0,1,0,0,1,0,1,0,0,0,0
S01012989,All people aged 16 to 74,663,35,7,28,135,132,34,65,100,81,33,15,18,48
S01012989,Very good health,311,18,4,14,76,61,11,33,40,24,13,4,9,35
S01012989,Good health,222,13,1,12,44,40,15,20,39,31,12,5,7,8
S01012989,Fair health,96,3,2,1,9,25,7,10,17,16,6,4,2,3
S01012989,Bad health,26,1,0,1,5,4,1,1,3,8,1,1,0,2
S01012989,Very bad health,8,0,0,0,1,2,0,1,1,2,1,1,0,0
S01012990,All people aged 16 to 74,429,16,8,8,71,85,20,42,65,74,20,8,12,36
S01012990,Very good health,188,7,5,2,33,35,8,21,24,25,7,1,6,28
S01012990,Good health,154,9,3,6,25,35,7,11,26,28,8,4,4,5
S01012990,Fair health,59,0,0,0,9,10,3,7,11,13,3,2,1,3
S01012990,Bad health,20,0,0,0,4,2,1,3,3,5,2,1,1,0
S01012990,Very bad health,8,0,0,0,0,3,1,0,1,3,0,0,0,0
S01012991,All people aged 16 to 74,561,28,3,25,116,97,32,59,84,87,26,10,16,32
S01012991,Very good health,269,14,1,13,65,48,14,21,40,33,7,2,5,27
S01012991,Good health,191,10,2,8,37,35,11,23,29,29,13,6,7,4
S01012991,Fair health,71,3,0,3,11,11,6,11,11,12,5,1,4,1
S01012991,Bad health,23,1,0,1,3,2,1,4,4,7,1,1,0,0
S01012991,Very bad health,7,0,0,0,0,1,0,0,0,6,0,0,0,0
S01012992,All people aged 16 to 74,549,31,6,25,114,87,29,45,103,67,22,9,13,51
S01012992,Very good health,272,17,4,13,57,45,11,20,48,27,9,3,6,38
S01012992,Good health,186,12,2,10,44,31,13,17,35,18,3,0,3,13
S01012992,Fair health,62,1,0,1,9,9,3,5,13,15,7,3,4,0
S01012992,Bad health,24,0,0,0,3,2,2,3,7,6,1,1,0,0
S01012992,Very bad health,5,1,0,1,1,0,0,0,0,1,2,2,0,0
S01012993,All people aged 16 to 74,494,24,3,21,89,92,27,50,86,64,26,12,14,36
S01012993,Very good health,221,16,3,13,43,39,12,17,36,24,7,2,5,27
S01012993,Good health,164,6,0,6,29,31,9,22,31,18,10,6,4,8
S01012993,Fair health,74,2,0,2,12,15,3,8,15,12,7,2,5,0
S01012993,Bad health,26,0,0,0,5,6,0,1,4,8,1,1,0,1
S01012993,Very bad health,9,0,0,0,0,1,3,2,0,2,1,1,0,0
S01012994,All people aged 16 to 74,656,36,6,30,108,104,46,61,114,108,29,9,20,50
S01012994,Very good health,294,15,1,14,57,51,19,23,46,40,7,2,5,36
S01012994,Good health,217,16,4,12,40,32,13,22,38,35,11,3,8,10
S01012994,Fair health,102,3,0,3,11,15,9,12,17,24,9,3,6,2
S01012994,Bad health,32,2,1,1,0,4,4,3,9,7,2,1,1,1
S01012994,Very bad health,11,0,0,0,0,2,1,1,4,2,0,0,0,1
S01012995,All people aged 16 to 74,628,55,14,41,131,118,37,67,95,83,13,8,5,29
S01012995,Very good health,310,32,10,22,62,58,17,33,38,43,6,4,2,21
S01012995,Good health,214,16,2,14,51,45,13,21,38,25,2,1,1,3
S01012995,Fair health,55,3,1,2,10,9,6,6,8,6,3,2,1,4
S01012995,Bad health,37,3,1,2,5,5,1,3,8,9,2,1,1,1
S01012995,Very bad health,12,1,0,1,3,1,0,4,3,0,0,0,0,0
S01012996,All people aged 16 to 74,533,13,1,12,107,81,36,52,106,65,21,8,13,52
S01012996,Very good health,286,10,1,9,67,34,17,24,52,32,8,4,4,42
S01012996,Good health,157,3,0,3,23,34,9,21,36,17,6,1,5,8
S01012996,Fair health,61,0,0,0,12,11,6,4,13,8,6,2,4,1
S01012996,Bad health,22,0,0,0,4,0,4,2,4,6,1,1,0,1
S01012996,Very bad health,7,0,0,0,1,2,0,1,1,2,0,0,0,0
S01012997,All people aged 16 to 74,364,27,3,24,73,62,11,29,70,49,14,5,9,29
S01012997,Very good health,163,12,0,12,30,26,2,11,35,19,6,2,4,22
S01012997,Good health,139,9,2,7,29,27,7,9,23,24,6,2,4,5
S01012997,Fair health,44,4,0,4,7,8,2,7,11,3,1,0,1,1
S01012997,Bad health,16,2,1,1,6,1,0,1,1,3,1,1,0,1
S01012997,Very bad health,2,0,0,0,1,0,0,1,0,0,0,0,0,0
S01012998,All people aged 16 to 74,771,65,19,46,166,126,48,62,112,108,14,7,7,70
S01012998,Very good health,416,36,7,29,111,69,31,27,44,41,6,3,3,51
S01012998,Good health,249,25,11,14,40,43,8,21,50,37,7,3,4,18
S01012998,Fair health,72,1,1,0,14,8,5,12,14,17,0,0,0,1
S01012998,Bad health,26,3,0,3,1,4,3,2,2,10,1,1,0,0
S01012998,Very bad health,8,0,0,0,0,2,1,0,2,3,0,0,0,0
S01012999,All people aged 16 to 74,346,17,3,14,52,49,22,36,62,67,13,7,6,28
S01012999,Very good health,170,10,1,9,26,24,10,18,29,27,8,4,4,18
S01012999,Good health,108,5,1,4,15,18,8,7,17,27,2,1,1,9
S01012999,Fair health,50,2,1,1,8,5,4,7,10,12,2,1,1,0
S01012999,Bad health,17,0,0,0,2,2,0,4,6,1,1,1,0,1
S01012999,Very bad health,1,0,0,0,1,0,0,0,0,0,0,0,0,0
S01013000,All people aged 16 to 74,475,24,2,22,74,70,29,57,111,75,14,4,10,21
S01013000,Very good health,187,12,1,11,37,35,8,12,38,28,3,1,2,14
S01013000,Good health,188,11,0,11,29,21,17,28,41,30,6,1,5,5
S01013000,Fair health,71,1,1,0,6,12,2,13,23,8,4,1,3,2
S01013000,Bad health,21,0,0,0,1,1,2,3,7,6,1,1,0,0
S01013000,Very bad health,8,0,0,0,1,1,0,1,2,3,0,0,0,0
S01013001,All people aged 16 to 74,282,51,15,36,85,20,51,22,24,7,3,1,2,19
S01013001,Very good health,149,23,6,17,46,9,26,10,12,5,1,0,1,17
S01013001,Good health,98,25,9,16,29,10,14,7,8,1,2,1,1,2
S01013001,Fair health,26,1,0,1,9,1,8,3,3,1,0,0,0,0
S01013001,Bad health,8,2,0,2,1,0,2,2,1,0,0,0,0,0
S01013001,Very bad health,1,0,0,0,0,0,1,0,0,0,0,0,0,0
S01013002,All people aged 16 to 74,367,81,8,73,80,33,63,18,32,19,5,2,3,36
S01013002,Very good health,216,57,5,52,40,21,34,12,13,9,1,0,1,29
S01013002,Good health,109,23,3,20,22,7,22,5,16,5,3,2,1,6
S01013002,Fair health,32,1,0,1,13,2,6,1,2,5,1,0,1,1
S01013002,Bad health,9,0,0,0,4,3,1,0,1,0,0,0,0,0
S01013002,Very bad health,1,0,0,0,1,0,0,0,0,0,0,0,0,0
S01013003,All people aged 16 to 74,454,131,19,112,146,47,34,14,31,10,4,1,3,37
S01013003,Very good health,280,85,13,72,90,28,16,8,17,5,2,1,1,29
S01013003,Good health,144,36,5,31,49,15,15,5,12,2,2,0,2,8
S01013003,Fair health,21,8,1,7,5,1,3,1,2,1,0,0,0,0
S01013003,Bad health,8,2,0,2,2,3,0,0,0,1,0,0,0,0
S01013003,Very bad health,1,0,0,0,0,0,0,0,0,1,0,0,0,0
S01013004,All people aged 16 to 74,474,84,10,74,142,45,60,23,41,21,14,7,7,44
S01013004,Very good health,259,42,2,40,83,25,38,5,17,11,5,2,3,33
S01013004,Good health,169,37,7,30,52,18,19,9,16,6,4,2,2,8
S01013004,Fair health,37,5,1,4,7,2,3,7,6,3,3,1,2,1
S01013004,Bad health,5,0,0,0,0,0,0,1,2,0,1,1,0,1
S01013004,Very bad health,4,0,0,0,0,0,0,1,0,1,1,1,0,1
S01013005,All people aged 16 to 74,517,122,21,101,157,46,70,23,33,19,10,6,4,37
S01013005,Very good health,308,74,13,61,105,26,36,12,13,7,3,1,2,32
S01013005,Good health,163,36,6,30,40,17,26,10,16,8,6,4,2,4
S01013005,Fair health,32,10,1,9,7,0,7,1,3,2,1,1,0,1
S01013005,Bad health,10,2,1,1,4,1,1,0,1,1,0,0,0,0
S01013005,Very bad health,4,0,0,0,1,2,0,0,0,1,0,0,0,0
S01013006,All people aged 16 to 74,457,124,23,101,142,37,37,17,30,13,13,8,5,44
S01013006,Very good health,297,83,10,73,95,18,22,7,16,5,10,8,2,41
S01013006,Good health,129,33,12,21,39,15,13,5,10,8,3,0,3,3
S01013006,Fair health,24,6,1,5,6,2,2,5,3,0,0,0,0,0
S01013006,Bad health,4,1,0,1,1,1,0,0,1,0,0,0,0,0
S01013006,Very bad health,3,1,0,1,1,1,0,0,0,0,0,0,0,0
S01013007,All people aged 16 to 74,654,123,22,101,218,78,62,33,54,30,14,9,5,42
S01013007,Very good health,377,78,13,65,125,42,29,19,32,12,5,2,3,35
S01013007,Good health,194,38,8,30,73,27,20,8,11,9,4,3,1,4
S01013007,Fair health,61,5,1,4,13,5,10,4,9,8,5,4,1,2
S01013007,Bad health,17,1,0,1,6,4,1,2,1,1,0,0,0,1
S01013007,Very bad health,5,1,0,1,1,0,2,0,1,0,0,0,0,0
S01013008,All people aged 16 to 74,570,119,34,85,148,57,58,39,51,44,18,8,10,36
S01013008,Very good health,318,74,18,56,92,27,38,19,20,14,11,5,6,23
S01013008,Good health,170,31,9,22,42,24,14,14,17,13,5,2,3,10
S01013008,Fair health,65,13,6,7,12,3,5,4,10,13,2,1,1,3
S01013008,Bad health,16,1,1,0,2,3,1,2,4,3,0,0,0,0
S01013008,Very bad health,1,0,0,0,0,0,0,0,0,1,0,0,0,0
S01013009,All people aged 16 to 74,439,45,8,37,126,59,49,34,64,34,8,6,2,20
S01013009,Very good health,218,28,6,22,61,30,20,15,30,14,6,4,2,14
S01013009,Good health,168,15,2,13,55,24,21,15,23,9,1,1,0,5
S01013009,Fair health,38,1,0,1,7,2,8,4,7,7,1,1,0,1
S01013009,Bad health,10,0,0,0,2,3,0,0,3,2,0,0,0,0
S01013009,Very bad health,5,1,0,1,1,0,0,0,1,2,0,0,0,0
S01013010,All people aged 16 to 74,438,83,20,63,108,41,90,18,37,25,10,4,6,26
S01013010,Very good health,270,60,16,44,73,18,55,7,17,13,7,3,4,20
S01013010,Good health,121,18,3,15,29,19,23,6,12,8,0,0,0,6
S01013010,Fair health,32,4,0,4,4,4,8,3,6,1,2,1,1,0
S01013010,Bad health,12,1,1,0,1,0,4,2,2,1,1,0,1,0
S01013010,Very bad health,3,0,0,0,1,0,0,0,0,2,0,0,0,0
S01013011,All people aged 16 to 74,477,68,9,59,136,48,68,26,54,22,11,5,6,44
S01013011,Very good health,299,47,5,42,88,30,34,15,30,12,4,1,3,39
S01013011,Good health,141,16,4,12,39,15,28,8,13,10,7,4,3,5
S01013011,Fair health,29,3,0,3,7,3,5,3,8,0,0,0,0,0
S01013011,Bad health,8,2,0,2,2,0,1,0,3,0,0,0,0,0
S01013011,Very bad health,0,0,0,0,0,0,0,0,0,0,0,0,0,0
S01013012,All people aged 16 to 74,476,48,8,40,102,54,40,41,78,45,22,13,9,46
S01013012,Very good health,248,26,3,23,51,25,19,20,42,18,7,4,3,40
S01013012,Good health,145,13,2,11,37,18,16,12,23,15,5,4,1,6
S01013012,Fair health,60,7,1,6,11,7,4,5,10,8,8,4,4,0
S01013012,Bad health,18,2,2,0,2,4,1,4,2,2,1,1,0,0
S01013012,Very bad health,5,0,0,0,1,0,0,0,1,2,1,0,1,0
S01013013,All people aged 16 to 74,510,80,20,60,126,55,78,18,67,43,12,7,5,31
S01013013,Very good health,303,54,14,40,84,31,46,12,29,19,5,2,3,23
S01013013,Good health,171,22,4,18,36,21,30,6,30,15,3,2,1,8
S01013013,Fair health,23,4,2,2,4,1,1,0,6,6,1,0,1,0
S01013013,Bad health,9,0,0,0,2,0,1,0,2,2,2,2,0,0
S01013013,Very bad health,4,0,0,0,0,2,0,0,0,1,1,1,0,0
S01013014,All people aged 16 to 74,523,48,11,37,132,53,85,42,70,51,18,11,7,24
S01013014,Very good health,279,30,6,24,79,26,39,23,29,24,9,6,3,20
S01013014,Good health,167,13,3,10,39,10,31,16,28,20,6,3,3,4
S01013014,Fair health,48,5,2,3,9,9,8,2,10,3,2,1,1,0
S01013014,Bad health,26,0,0,0,5,8,7,1,2,2,1,1,0,0
S01013014,Very bad health,3,0,0,0,0,0,0,0,1,2,0,0,0,0
S01013015,All people aged 16 to 74,531,76,17,59,143,55,100,42,29,36,7,4,3,43
S01013015,Very good health,316,46,12,34,88,32,60,18,15,21,3,1,2,33
S01013015,Good health,170,23,3,20,49,19,28,16,10,13,2,1,1,10
S01013015,Fair health,35,4,2,2,5,3,12,7,2,1,1,1,0,0
S01013015,Bad health,9,3,0,3,0,1,0,1,2,1,1,1,0,0
S01013015,Very bad health,1,0,0,0,1,0,0,0,0,0,0,0,0,0
S01013016,All people aged 16 to 74,459,99,19,80,122,43,92,21,32,17,5,3,2,28
S01013016,Very good health,256,57,10,47,70,26,41,13,12,7,3,3,0,27
S01013016,Good health,155,34,7,27,43,14,36,6,15,4,2,0,2,1
S01013016,Fair health,33,6,1,5,4,2,13,2,3,3,0,0,0,0
S01013016,Bad health,11,2,1,1,4,1,1,0,1,2,0,0,0,0
S01013016,Very bad health,4,0,0,0,1,0,1,0,1,1,0,0,0,0
S01013017,All people aged 16 to 74,596,91,22,69,150,58,64,45,86,47,16,9,7,39
S01013017,Very good health,301,55,12,43,79,31,37,26,27,12,2,1,1,32
S01013017,Good health,201,29,7,22,49,22,21,9,36,24,7,2,5,4
S01013017,Fair health,70,7,3,4,18,2,4,9,15,8,4,3,1,3
S01013017,Bad health,17,0,0,0,3,2,2,1,4,2,3,3,0,0
S01013017,Very bad health,7,0,0,0,1,1,0,0,4,1,0,0,0,0
S01013018,All people aged 16 to 74,687,123,23,100,199,82,88,45,52,34,21,10,11,43
S01013018,Very good health,403,77,14,63,121,43,51,24,26,13,13,5,8,35
S01013018,Good health,216,37,8,29,58,34,28,17,15,15,5,3,2,7
S01013018,Fair health,56,8,1,7,17,4,7,3,8,6,2,1,1,1
S01013018,Bad health,8,1,0,1,2,0,2,1,1,0,1,1,0,0
S01013018,Very bad health,4,0,0,0,1,1,0,0,2,0,0,0,0,0
S01013019,All people aged 16 to 74,634,137,30,107,218,76,51,23,53,23,4,0,4,49
S01013019,Very good health,432,98,17,81,154,44,27,16,35,10,1,0,1,47
S01013019,Good health,168,32,12,20,58,26,19,5,15,8,3,0,3,2
S01013019,Fair health,25,6,1,5,5,2,5,2,1,4,0,0,0,0
S01013019,Bad health,8,1,0,1,1,3,0,0,2,1,0,0,0,0
S01013019,Very bad health,1,0,0,0,0,1,0,0,0,0,0,0,0,0
S01013020,All people aged 16 to 74,333,22,3,19,69,43,21,30,52,71,12,8,4,13
S01013020,Very good health,155,15,2,13,37,22,13,16,23,17,1,0,1,11
S01013020,Good health,120,6,1,5,28,16,3,6,20,33,6,3,3,2
S01013020,Fair health,38,0,0,0,3,3,4,4,7,13,4,4,0,0
S01013020,Bad health,18,1,0,1,1,2,1,2,2,8,1,1,0,0
S01013020,Very bad health,2,0,0,0,0,0,0,2,0,0,0,0,0,0
S01013021,All people aged 16 to 74,342,23,3,20,59,50,28,30,61,55,14,12,2,22
S01013021,Very good health,156,14,1,13,33,23,11,12,21,19,5,4,1,18
S01013021,Good health,129,5,2,3,22,20,12,16,27,20,3,2,1,4
S01013021,Fair health,37,2,0,2,1,5,4,1,10,9,5,5,0,0
S01013021,Bad health,14,1,0,1,2,2,0,1,2,5,1,1,0,0
S01013021,Very bad health,6,1,0,1,1,0,1,0,1,2,0,0,0,0
S01013022,All people aged 16 to 74,310,28,5,23,81,44,18,20,52,32,15,8,7,20
S01013022,Very good health,174,19,4,15,55,25,8,8,23,16,4,2,2,16
S01013022,Good health,100,7,1,6,22,13,7,10,23,9,6,2,4,3
S01013022,Fair health,24,1,0,1,3,3,3,1,6,4,2,1,1,1
S01013022,Bad health,10,1,0,1,1,3,0,0,0,3,2,2,0,0
S01013022,Very bad health,2,0,0,0,0,0,0,1,0,0,1,1,0,0
S01013023,All people aged 16 to 74,642,123,26,97,243,76,45,21,56,28,9,7,2,41
S01013023,Very good health,414,80,15,65,162,40,28,13,34,15,4,3,1,38
S01013023,Good health,156,30,8,22,63,23,11,4,11,7,4,4,0,3
S01013023,Fair health,59,13,3,10,16,11,2,2,9,5,1,0,1,0
S01013023,Bad health,9,0,0,0,1,1,3,1,2,1,0,0,0,0
S01013023,Very bad health,4,0,0,0,1,1,1,1,0,0,0,0,0,0
S01013024,All people aged 16 to 74,365,59,17,42,110,50,34,23,35,21,4,2,2,29
S01013024,Very good health,231,40,12,28,71,39,21,16,12,5,2,1,1,25
S01013024,Good health,93,16,4,12,28,7,9,5,15,7,2,1,1,4
S01013024,Fair health,34,2,1,1,10,4,3,2,6,7,0,0,0,0
S01013024,Bad health,6,1,0,1,1,0,1,0,1,2,0,0,0,0
S01013024,Very bad health,1,0,0,0,0,0,0,0,1,0,0,0,0,0
S01013025,All people aged 16 to 74,413,50,12,38,94,33,101,23,26,44,13,9,4,29
S01013025,Very good health,222,28,7,21,51,16,56,14,11,16,5,3,2,25
S01013025,Good health,136,15,3,12,35,14,34,5,9,17,3,2,1,4
S01013025,Fair health,38,4,1,3,6,3,8,3,3,8,3,3,0,0
S01013025,Bad health,13,3,1,2,2,0,1,1,1,3,2,1,1,0
S01013025,Very bad health,4,0,0,0,0,0,2,0,2,0,0,0,0,0
S01013026,All people aged 16 to 74,760,67,11,56,148,104,43,70,124,135,41,24,17,28
S01013026,Very good health,345,51,8,43,86,49,17,30,47,41,5,3,2,19
S01013026,Good health,254,13,2,11,47,41,15,22,45,42,23,14,9,6
S01013026,Fair health,114,3,1,2,10,11,7,9,22,39,10,6,4,3
S01013026,Bad health,39,0,0,0,4,3,1,7,9,12,3,1,2,0
S01013026,Very bad health,8,0,0,0,1,0,3,2,1,1,0,0,0,0
S01013027,All people aged 16 to 74,726,19,6,13,63,70,29,72,162,189,79,46,33,43
S01013027,Very good health,294,8,1,7,26,33,9,25,58,81,25,12,13,29
S01013027,Good health,227,7,4,3,22,22,11,26,60,44,26,12,14,9
S01013027,Fair health,131,3,1,2,10,11,8,10,29,36,19,14,5,5
S01013027,Bad health,57,1,0,1,3,3,1,9,11,20,9,8,1,0
S01013027,Very bad health,17,0,0,0,2,1,0,2,4,8,0,0,0,0
S01013028,All people aged 16 to 74,367,38,10,28,68,32,43,34,61,53,10,5,5,28
S01013028,Very good health,196,22,4,18,41,16,21,17,31,25,2,0,2,21
S01013028,Good health,112,8,2,6,20,12,17,13,19,15,3,1,2,5
S01013028,Fair health,42,7,3,4,5,2,4,3,8,8,3,2,1,2
S01013028,Bad health,14,1,1,0,1,1,1,1,3,5,1,1,0,0
S01013028,Very bad health,3,0,0,0,1,1,0,0,0,0,1,1,0,0
S01013029,All people aged 16 to 74,435,13,2,11,44,41,14,42,110,127,22,15,7,22
S01013029,Very good health,169,3,1,2,29,16,7,18,38,32,8,6,2,18
S01013029,Good health,125,5,1,4,11,16,3,16,31,38,2,1,1,3
S01013029,Fair health,93,3,0,3,3,7,1,5,29,38,6,2,4,1
S01013029,Bad health,33,2,0,2,1,2,2,2,9,9,6,6,0,0
S01013029,Very bad health,15,0,0,0,0,0,1,1,3,10,0,0,0,0
S01013030,All people aged 16 to 74,454,11,1,10,46,54,31,51,83,106,48,32,16,24
S01013030,Very good health,187,6,0,6,15,31,15,26,34,32,11,7,4,17
S01013030,Good health,158,4,1,3,22,13,9,14,34,31,24,15,9,7
S01013030,Fair health,70,1,0,1,6,6,5,9,8,26,9,6,3,0
S01013030,Bad health,31,0,0,0,2,3,2,2,5,14,3,3,0,0
S01013030,Very bad health,8,0,0,0,1,1,0,0,2,3,1,1,0,0
S01013031,All people aged 16 to 74,479,5,1,4,44,46,27,55,107,141,27,11,16,27
S01013031,Very good health,214,2,0,2,16,24,17,29,48,49,7,0,7,22
S01013031,Good health,150,2,0,2,16,13,5,16,38,43,13,7,6,4
S01013031,Fair health,72,1,1,0,9,5,4,4,12,32,5,2,3,0
S01013031,Bad health,35,0,0,0,3,3,1,3,8,14,2,2,0,1
S01013031,Very bad health,8,0,0,0,0,1,0,3,1,3,0,0,0,0
S01013032,All people aged 16 to 74,564,48,12,36,123,84,51,56,87,81,8,5,3,26
S01013032,Very good health,317,36,9,27,78,49,27,32,38,35,2,1,1,20
S01013032,Good health,186,10,3,7,35,27,19,21,35,31,3,1,2,5
S01013032,Fair health,41,1,0,1,6,4,3,3,13,9,2,2,0,0
S01013032,Bad health,17,1,0,1,2,3,2,0,1,6,1,1,0,1
S01013032,Very bad health,3,0,0,0,2,1,0,0,0,0,0,0,0,0
S01013033,All people aged 16 to 74,496,19,3,16,98,64,35,56,92,90,18,10,8,24
S01013033,Very good health,268,16,3,13,57,43,18,23,48,34,8,5,3,21
S01013033,Good health,154,1,0,1,30,15,13,24,30,34,5,2,3,2
S01013033,Fair health,46,2,0,2,9,4,4,6,9,9,2,0,2,1
S01013033,Bad health,21,0,0,0,2,1,0,2,4,10,2,2,0,0
S01013033,Very bad health,7,0,0,0,0,1,0,1,1,3,1,1,0,0
S01013034,All people aged 16 to 74,537,14,3,11,49,60,17,76,133,133,30,22,8,25
S01013034,Very good health,206,8,1,7,26,26,9,28,43,43,6,4,2,17
S01013034,Good health,186,5,2,3,15,22,4,27,51,41,15,11,4,6
S01013034,Fair health,88,1,0,1,5,10,4,16,25,21,4,2,2,2
S01013034,Bad health,40,0,0,0,2,2,0,3,10,19,4,4,0,0
S01013034,Very bad health,17,0,0,0,1,0,0,2,4,9,1,1,0,0
S01013035,All people aged 16 to 74,506,8,3,5,48,41,18,62,110,154,37,23,14,28
S01013035,Very good health,209,3,0,3,27,16,8,23,48,51,9,5,4,24
S01013035,Good health,175,1,0,1,16,21,4,22,37,55,16,7,9,3
S01013035,Fair health,69,1,1,0,4,3,3,5,15,31,6,6,0,1
S01013035,Bad health,38,3,2,1,0,1,1,8,9,13,3,3,0,0
S01013035,Very bad health,15,0,0,0,1,0,2,4,1,4,3,2,1,0
S01013036,All people aged 16 to 74,585,8,1,7,60,45,30,73,132,145,59,39,20,33
S01013036,Very good health,238,2,0,2,27,17,10,27,52,56,23,13,10,24
S01013036,Good health,202,4,1,3,18,18,13,20,50,53,18,15,3,8
S01013036,Fair health,84,1,0,1,8,6,3,12,17,24,12,5,7,1
S01013036,Bad health,46,0,0,0,4,2,4,13,11,8,4,4,0,0
S01013036,Very bad health,15,1,0,1,3,2,0,1,2,4,2,2,0,0
S01013037,All people aged 16 to 74,567,42,9,33,142,98,41,59,76,49,16,9,7,44
S01013037,Very good health,294,25,4,21,73,56,18,23,37,22,5,5,0,35
S01013037,Good health,204,14,5,9,54,36,17,23,28,16,9,2,7,7
S01013037,Fair health,52,2,0,2,9,5,4,12,10,7,1,1,0,2
S01013037,Bad health,13,0,0,0,4,1,2,1,1,3,1,1,0,0
S01013037,Very bad health,4,1,0,1,2,0,0,0,0,1,0,0,0,0
S01013038,All people aged 16 to 74,701,36,7,29,118,85,39,70,140,116,44,33,11,53
S01013038,Very good health,304,23,4,19,57,42,12,28,49,39,17,12,5,37
S01013038,Good health,264,12,3,9,46,34,18,26,58,45,14,8,6,11
S01013038,Fair health,92,1,0,1,9,3,4,14,25,24,7,7,0,5
S01013038,Bad health,36,0,0,0,5,6,5,2,8,7,3,3,0,0
S01013038,Very bad health,5,0,0,0,1,0,0,0,0,1,3,3,0,0
S01013039,All people aged 16 to 74,416,45,10,35,95,78,19,34,47,28,6,6,0,64
S01013039,Very good health,240,25,7,18,54,47,8,19,21,14,3,3,0,49
S01013039,Good health,143,20,3,17,35,28,8,8,19,11,0,0,0,14
S01013039,Fair health,25,0,0,0,5,3,2,4,6,2,2,2,0,1
S01013039,Bad health,6,0,0,0,1,0,0,2,1,1,1,1,0,0
S01013039,Very bad health,2,0,0,0,0,0,1,1,0,0,0,0,0,0
S01013040,All people aged 16 to 74,480,29,1,28,82,77,36,57,106,57,12,8,4,24
S01013040,Very good health,211,15,1,14,40,46,12,23,37,18,3,1,2,17
S01013040,Good health,167,11,0,11,25,17,17,23,44,19,5,3,2,6
S01013040,Fair health,64,2,0,2,11,9,3,6,17,13,2,2,0,1
S01013040,Bad health,28,1,0,1,5,3,2,3,6,6,2,2,0,0
S01013040,Very bad health,10,0,0,0,1,2,2,2,2,1,0,0,0,0
S01013041,All people aged 16 to 74,445,24,5,19,91,61,31,41,81,70,18,8,10,28
S01013041,Very good health,231,19,4,15,55,30,15,20,36,26,11,5,6,19
S01013041,Good health,129,3,0,3,26,19,10,17,27,17,3,0,3,7
S01013041,Fair health,59,2,1,1,9,9,4,0,11,19,3,2,1,2
S01013041,Bad health,24,0,0,0,1,3,2,3,7,7,1,1,0,0
S01013041,Very bad health,2,0,0,0,0,0,0,1,0,1,0,0,0,0
S01013042,All people aged 16 to 74,613,54,14,40,128,85,54,53,78,86,22,14,8,53
S01013042,Very good health,349,39,10,29,90,51,29,27,26,38,8,5,3,41
S01013042,Good health,176,15,4,11,28,29,21,18,31,20,4,1,3,10
S01013042,Fair health,54,0,0,0,6,4,4,5,12,12,9,7,2,2
S01013042,Bad health,27,0,0,0,3,1,0,2,7,13,1,1,0,0
S01013042,Very bad health,7,0,0,0,1,0,0,1,2,3,0,0,0,0
S01013043,All people aged 16 to 74,510,16,4,12,68,53,30,49,100,118,45,32,13,31
S01013043,Very good health,196,8,1,7,31,21,13,17,34,41,11,5,6,20
S01013043,Good health,177,4,2,2,24,16,9,18,42,39,18,14,4,7
S01013043,Fair health,89,4,1,3,6,9,5,11,19,22,10,7,3,3
S01013043,Bad health,41,0,0,0,5,5,3,3,5,14,5,5,0,1
S01013043,Very bad health,7,0,0,0,2,2,0,0,0,2,1,1,0,0
S01013044,All people aged 16 to 74,610,12,1,11,92,65,31,55,144,129,38,23,15,44
S01013044,Very good health,238,7,0,7,41,34,11,25,49,29,11,6,5,31
S01013044,Good health,230,2,1,1,34,23,15,20,58,57,11,4,7,10
S01013044,Fair health,91,1,0,1,12,5,4,4,26,26,11,8,3,2
S01013044,Bad health,38,1,0,1,4,3,0,4,8,12,5,5,0,1
S01013044,Very bad health,13,1,0,1,1,0,1,2,3,5,0,0,0,0
S01013045,All people aged 16 to 74,490,42,6,36,95,69,34,41,83,71,20,13,7,35
S01013045,Very good health,224,21,4,17,53,32,11,22,34,21,7,2,5,23
S01013045,Good health,167,17,1,16,31,25,14,14,30,23,4,3,1,9
S01013045,Fair health,72,4,1,3,8,7,5,5,16,19,5,5,0,3
S01013045,Bad health,24,0,0,0,3,3,4,0,3,7,4,3,1,0
S01013045,Very bad health,3,0,0,0,0,2,0,0,0,1,0,0,0,0
S01013046,All people aged 16 to 74,392,9,5,4,56,55,23,36,82,75,20,12,8,36
S01013046,Very good health,171,8,4,4,29,24,8,18,33,22,3,1,2,26
S01013046,Good health,120,1,1,0,13,20,6,13,31,22,7,5,2,7
S01013046,Fair health,69,0,0,0,9,9,6,4,12,21,5,3,2,3
S01013046,Bad health,24,0,0,0,1,1,2,1,5,9,5,3,2,0
S01013046,Very bad health,8,0,0,0,4,1,1,0,1,1,0,0,0,0
S01013047,All people aged 16 to 74,685,81,20,61,194,111,47,53,84,53,12,9,3,50
S01013047,Very good health,413,55,11,44,115,70,27,27,46,30,4,2,2,39
S01013047,Good health,216,21,7,14,68,31,16,22,27,16,6,5,1,9
S01013047,Fair health,42,4,2,2,9,7,3,2,8,5,2,2,0,2
S01013047,Bad health,12,1,0,1,1,3,1,1,3,2,0,0,0,0
S01013047,Very bad health,2,0,0,0,1,0,0,1,0,0,0,0,0,0
S01013048,All people aged 16 to 74,646,54,15,39,176,110,24,68,96,66,14,3,11,38
S01013048,Very good health,356,36,8,28,105,57,9,43,39,24,8,1,7,35
S01013048,Good health,213,12,5,7,56,42,11,18,43,25,3,0,3,3
S01013048,Fair health,63,4,1,3,13,10,4,5,10,14,3,2,1,0
S01013048,Bad health,12,2,1,1,1,1,0,2,3,3,0,0,0,0
S01013048,Very bad health,2,0,0,0,1,0,0,0,1,0,0,0,0,0
S01013049,All people aged 16 to 74,639,75,13,62,178,109,41,58,88,41,11,6,5,38
S01013049,Very good health,323,40,7,33,99,59,15,26,37,12,3,2,1,32
S01013049,Good health,240,26,5,21,60,43,17,26,37,23,3,1,2,5
S01013049,Fair health,55,4,0,4,15,7,8,5,10,4,1,0,1,1
S01013049,Bad health,18,5,1,4,3,0,0,1,3,2,4,3,1,0
S01013049,Very bad health,3,0,0,0,1,0,1,0,1,0,0,0,0,0
S01013050,All people aged 16 to 74,608,38,11,27,105,87,46,65,91,96,49,35,14,31
S01013050,Very good health,230,14,5,9,37,35,14,32,37,28,12,6,6,21
S01013050,Good health,205,17,3,14,47,35,13,14,27,32,14,9,5,6
S01013050,Fair health,112,6,2,4,16,10,9,14,15,23,17,14,3,2
S01013050,Bad health,45,1,1,0,5,3,8,4,9,9,5,5,0,1
S01013050,Very bad health,16,0,0,0,0,4,2,1,3,4,1,1,0,1
S01013051,All people aged 16 to 74,667,28,5,23,100,106,43,69,132,117,41,25,16,31
S01013051,Very good health,311,13,1,12,51,49,19,32,67,43,12,8,4,25
S01013051,Good health,201,9,2,7,35,32,12,28,37,34,9,5,4,5
S01013051,Fair health,101,2,1,1,6,19,7,3,22,27,15,7,8,0
S01013051,Bad health,43,4,1,3,8,6,0,5,3,12,4,4,0,1
S01013051,Very bad health,11,0,0,0,0,0,5,1,3,1,1,1,0,0
S01013052,All people aged 16 to 74,522,28,4,24,87,76,31,52,100,88,34,28,6,26
S01013052,Very good health,233,19,1,18,44,35,11,20,44,25,11,8,3,24
S01013052,Good health,191,7,2,5,31,28,13,21,37,42,10,7,3,2
S01013052,Fair health,64,0,0,0,7,10,4,9,12,10,12,12,0,0
S01013052,Bad health,26,1,1,0,5,2,2,1,5,9,1,1,0,0
S01013052,Very bad health,8,1,0,1,0,1,1,1,2,2,0,0,0,0
S01013053,All people aged 16 to 74,465,19,4,15,58,59,38,46,89,95,44,32,12,17
S01013053,Very good health,170,6,0,6,32,21,14,16,30,22,19,15,4,10
S01013053,Good health,161,8,2,6,13,27,14,17,33,34,9,5,4,6
S01013053,Fair health,88,4,1,3,9,7,4,8,20,24,12,8,4,0
S01013053,Bad health,30,1,1,0,3,2,4,3,4,8,4,4,0,1
S01013053,Very bad health,16,0,0,0,1,2,2,2,2,7,0,0,0,0
S01013054,All people aged 16 to 74,504,41,9,32,105,69,37,53,86,70,20,12,8,23
S01013054,Very good health,240,24,5,19,59,39,13,27,31,22,9,4,5,16
S01013054,Good health,184,12,3,9,35,27,19,18,29,33,5,3,2,6
S01013054,Fair health,52,3,1,2,4,3,3,5,19,11,3,2,1,1
S01013054,Bad health,23,2,0,2,6,0,2,3,5,4,1,1,0,0
S01013054,Very bad health,5,0,0,0,1,0,0,0,2,0,2,2,0,0
S01013055,All people aged 16 to 74,512,17,2,15,78,58,45,50,102,100,30,17,13,32
S01013055,Very good health,217,12,2,10,38,23,15,22,51,25,13,6,7,18
S01013055,Good health,167,2,0,2,29,19,24,13,21,40,8,5,3,11
S01013055,Fair health,98,3,0,3,10,14,4,13,24,21,6,4,2,3
S01013055,Bad health,23,0,0,0,1,1,2,2,4,11,2,2,0,0
S01013055,Very bad health,7,0,0,0,0,1,0,0,2,3,1,0,1,0
S01013056,All people aged 16 to 74,677,29,5,24,98,80,50,78,117,139,41,31,10,45
S01013056,Very good health,274,14,3,11,50,31,21,29,45,42,11,10,1,31
S01013056,Good health,250,11,1,10,32,33,21,33,44,53,13,6,7,10
S01013056,Fair health,97,2,1,1,12,11,5,12,14,24,13,11,2,4
S01013056,Bad health,47,2,0,2,2,4,3,3,12,17,4,4,0,0
S01013056,Very bad health,9,0,0,0,2,1,0,1,2,3,0,0,0,0
S01013057,All people aged 16 to 74,602,19,4,15,71,69,39,60,122,108,70,39,31,44
S01013057,Very good health,234,10,3,7,34,29,16,21,44,32,19,10,9,29
S01013057,Good health,222,6,1,5,28,24,13,22,42,45,28,15,13,14
S01013057,Fair health,98,2,0,2,6,10,4,12,23,25,15,8,7,1
S01013057,Bad health,33,1,0,1,2,4,5,4,7,3,7,5,2,0
S01013057,Very bad health,15,0,0,0,1,2,1,1,6,3,1,1,0,0
S01013058,All people aged 16 to 74,414,64,18,46,132,61,26,24,40,26,11,7,4,30
S01013058,Very good health,277,49,12,37,91,37,20,13,20,16,7,5,2,24
S01013058,Good health,107,13,5,8,33,22,4,8,15,4,2,1,1,6
S01013058,Fair health,22,2,1,1,5,2,1,3,4,3,2,1,1,0
S01013058,Bad health,6,0,0,0,2,0,0,0,1,3,0,0,0,0
S01013058,Very bad health,2,0,0,0,1,0,1,0,0,0,0,0,0,0
S01013059,All people aged 16 to 74,521,111,24,87,138,72,38,25,46,40,20,14,6,31
S01013059,Very good health,271,65,12,53,82,34,18,15,15,13,9,6,3,20
S01013059,Good health,191,38,10,28,44,34,17,6,21,17,4,3,1,10
S01013059,Fair health,43,7,2,5,7,3,2,4,5,8,7,5,2,0
S01013059,Bad health,10,0,0,0,4,1,1,0,3,1,0,0,0,0
S01013059,Very bad health,6,1,0,1,1,0,0,0,2,1,0,0,0,1
S01013060,All people aged 16 to 74,381,76,16,60,125,46,26,17,25,13,24,15,9,29
S01013060,Very good health,217,49,11,38,76,18,15,11,15,7,6,3,3,20
S01013060,Good health,114,22,4,18,35,18,6,4,8,3,9,4,5,9
S01013060,Fair health,40,4,1,3,12,7,4,0,2,3,8,7,1,0
S01013060,Bad health,6,1,0,1,1,3,0,1,0,0,0,0,0,0
S01013060,Very bad health,4,0,0,0,1,0,1,1,0,0,1,1,0,0
S01013061,All people aged 16 to 74,563,107,23,84,206,76,39,26,45,19,6,3,3,39
S01013061,Very good health,313,74,12,62,106,42,23,10,19,9,1,0,1,29
S01013061,Good health,188,24,7,17,74,28,12,12,19,7,2,2,0,10
S01013061,Fair health,51,8,3,5,20,5,4,3,6,3,2,0,2,0
S01013061,Bad health,7,1,1,0,3,1,0,1,0,0,1,1,0,0
S01013061,Very bad health,4,0,0,0,3,0,0,0,1,0,0,0,0,0
S01013062,All people aged 16 to 74,573,144,23,121,187,59,52,25,27,13,12,8,4,54
S01013062,Very good health,350,90,19,71,121,35,23,12,17,7,6,4,2,39
S01013062,Good health,177,48,4,44,52,16,23,11,6,5,4,2,2,12
S01013062,Fair health,42,6,0,6,13,8,4,2,4,0,2,2,0,3
S01013062,Bad health,4,0,0,0,1,0,2,0,0,1,0,0,0,0
S01013062,Very bad health,0,0,0,0,0,0,0,0,0,0,0,0,0,0
S01013063,All people aged 16 to 74,580,181,30,151,163,53,48,9,26,20,11,6,5,69
S01013063,Very good health,342,122,16,106,95,33,21,7,7,4,6,3,3,47
S01013063,Good health,173,48,11,37,48,16,17,1,8,12,3,2,1,20
S01013063,Fair health,48,8,3,5,16,2,8,1,7,2,2,1,1,2
S01013063,Bad health,12,2,0,2,4,2,0,0,4,0,0,0,0,0
S01013063,Very bad health,5,1,0,1,0,0,2,0,0,2,0,0,0,0
S01013064,All people aged 16 to 74,634,26,5,21,106,93,41,60,138,114,31,22,9,25
S01013064,Very good health,282,17,4,13,62,48,22,27,54,28,7,3,4,17
S01013064,Good health,213,8,1,7,31,32,12,23,48,45,9,6,3,5
S01013064,Fair health,90,1,0,1,9,9,6,7,23,23,11,10,1,1
S01013064,Bad health,38,0,0,0,2,4,0,3,11,13,3,2,1,2
S01013064,Very bad health,11,0,0,0,2,0,1,0,2,5,1,1,0,0
S01013065,All people aged 16 to 74,661,29,6,23,108,93,35,61,111,110,39,22,17,75
S01013065,Very good health,307,20,4,16,59,54,15,23,34,36,7,3,4,59
S01013065,Good health,199,7,1,6,26,28,12,19,46,31,14,5,9,16
S01013065,Fair health,97,1,0,1,14,8,4,14,19,27,10,6,4,0
S01013065,Bad health,47,0,0,0,8,3,4,4,9,13,6,6,0,0
S01013065,Very bad health,11,1,1,0,1,0,0,1,3,3,2,2,0,0
S01013066,All people aged 16 to 74,552,42,12,30,118,68,45,47,80,63,42,21,21,47
S01013066,Very good health,269,27,8,19,68,34,19,20,32,21,14,4,10,34
S01013066,Good health,190,15,4,11,42,24,17,18,23,25,15,8,7,11
S01013066,Fair health,66,0,0,0,7,9,5,5,19,12,7,5,2,2
S01013066,Bad health,21,0,0,0,1,1,3,4,3,3,6,4,2,0
S01013066,Very bad health,6,0,0,0,0,0,1,0,3,2,0,0,0,0
S01013067,All people aged 16 to 74,768,52,3,49,89,39,21,41,49,47,33,19,14,397
S01013067,Very good health,477,29,3,26,54,19,7,21,18,25,15,11,4,289
S01013067,Good health,226,20,0,20,28,14,10,18,19,13,12,4,8,92
S01013067,Fair health,49,3,0,3,4,3,4,2,10,6,1,0,1,16
S01013067,Bad health,14,0,0,0,2,2,0,0,2,3,5,4,1,0
S01013067,Very bad health,2,0,0,0,1,1,0,0,0,0,0,0,0,0
S01013068,All people aged 16 to 74,636,37,4,33,79,52,21,40,88,100,51,25,26,168
S01013068,Very good health,323,25,2,23,44,18,10,18,37,36,17,7,10,118
S01013068,Good health,203,11,2,9,24,20,7,12,32,32,19,12,7,46
S01013068,Fair health,77,0,0,0,9,12,3,6,12,22,9,1,8,4
S01013068,Bad health,21,1,0,1,0,1,1,2,5,7,4,3,1,0
S01013068,Very bad health,12,0,0,0,2,1,0,2,2,3,2,2,0,0
S01013069,All people aged 16 to 74,648,45,9,36,69,34,23,31,59,43,42,28,14,302
S01013069,Very good health,369,28,6,22,44,16,10,14,26,19,15,8,7,197
S01013069,Good health,205,13,2,11,19,15,9,12,20,11,16,10,6,90
S01013069,Fair health,55,2,1,1,3,2,1,4,9,10,11,10,1,13
S01013069,Bad health,13,2,0,2,3,0,3,1,2,0,0,0,0,2
S01013069,Very bad health,6,0,0,0,0,1,0,0,2,3,0,0,0,0
S01013070,All people aged 16 to 74,546,19,2,17,53,36,23,26,65,46,33,23,10,245
S01013070,Very good health,285,13,1,12,29,21,15,13,29,11,6,3,3,148
S01013070,Good health,179,4,1,3,18,9,5,9,22,17,16,11,5,79
S01013070,Fair health,60,1,0,1,4,5,2,4,11,12,6,5,1,15
S01013070,Bad health,18,1,0,1,1,1,0,0,2,5,5,4,1,3
S01013070,Very bad health,4,0,0,0,1,0,1,0,1,1,0,0,0,0
S01013071,All people aged 16 to 74,914,25,5,20,85,31,20,39,60,59,26,20,6,569
S01013071,Very good health,516,15,3,12,49,19,5,17,22,25,7,7,0,357
S01013071,Good health,315,9,2,7,25,10,12,14,27,19,12,9,3,187
S01013071,Fair health,60,1,0,1,7,1,2,6,9,9,3,2,1,22
S01013071,Bad health,16,0,0,0,3,1,1,0,1,6,3,2,1,1
S01013071,Very bad health,7,0,0,0,1,0,0,2,1,0,1,0,1,2
S01013072,All people aged 16 to 74,408,8,2,6,31,32,14,38,98,116,42,30,12,29
S01013072,Very good health,134,2,0,2,16,10,5,7,35,24,16,11,5,19
S01013072,Good health,133,2,2,0,6,14,3,15,33,47,7,4,3,6
S01013072,Fair health,83,3,0,3,7,7,5,5,19,24,10,8,2,3
S01013072,Bad health,41,1,0,1,2,1,0,9,5,16,6,4,2,1
S01013072,Very bad health,17,0,0,0,0,0,1,2,6,5,3,3,0,0
S01013073,All people aged 16 to 74,585,26,3,23,100,46,24,40,103,112,68,47,21,66
S01013073,Very good health,277,16,1,15,66,30,5,14,40,39,23,14,9,44
S01013073,Good health,186,8,2,6,25,9,11,17,41,36,20,13,7,19
S01013073,Fair health,76,2,0,2,4,2,5,5,15,23,17,14,3,3
S01013073,Bad health,35,0,0,0,4,4,3,1,4,11,8,6,2,0
S01013073,Very bad health,11,0,0,0,1,1,0,3,3,3,0,0,0,0
S01013074,All people aged 16 to 74,493,8,0,8,28,22,39,52,113,119,68,44,24,44
S01013074,Very good health,177,5,0,5,7,9,13,14,44,37,21,10,11,27
S01013074,Good health,169,3,0,3,13,6,17,18,39,47,14,6,8,12
S01013074,Fair health,85,0,0,0,5,2,7,13,21,17,15,11,4,5
S01013074,Bad health,45,0,0,0,1,5,1,5,4,15,14,13,1,0
S01013074,Very bad health,17,0,0,0,2,0,1,2,5,3,4,4,0,0
S01013075,All people aged 16 to 74,657,21,3,18,73,50,40,54,123,162,77,52,25,57
S01013075,Very good health,205,12,1,11,28,18,12,13,36,35,18,12,6,33
S01013075,Good health,228,4,1,3,26,16,15,16,46,54,27,16,11,24
S01013075,Fair health,117,3,1,2,7,11,9,12,18,31,26,18,8,0
S01013075,Bad health,83,2,0,2,8,4,4,10,18,33,4,4,0,0
S01013075,Very bad health,24,0,0,0,4,1,0,3,5,9,2,2,0,0
S01013076,All people aged 16 to 74,641,45,8,37,73,33,37,19,43,24,10,6,4,357
S01013076,Very good health,385,29,6,23,45,19,24,14,20,9,1,0,1,224
S01013076,Good health,212,15,2,13,21,13,8,5,18,11,2,1,1,119
S01013076,Fair health,35,1,0,1,6,0,5,0,5,2,2,2,0,14
S01013076,Bad health,6,0,0,0,1,1,0,0,0,1,3,1,2,0
S01013076,Very bad health,3,0,0,0,0,0,0,0,0,1,2,2,0,0
S01013077,All people aged 16 to 74,504,20,3,17,53,58,15,51,105,115,55,27,28,32
S01013077,Very good health,193,12,2,10,24,21,5,23,34,29,20,7,13,25
S01013077,Good health,168,6,1,5,17,26,4,18,33,41,17,10,7,6
S01013077,Fair health,93,0,0,0,9,7,3,4,25,31,13,5,8,1
S01013077,Bad health,40,2,0,2,2,2,3,6,10,10,5,5,0,0
S01013077,Very bad health,10,0,0,0,1,2,0,0,3,4,0,0,0,0
S01013078,All people aged 16 to 74,417,6,1,5,49,47,20,45,78,100,41,29,12,31
S01013078,Very good health,160,4,0,4,23,18,8,18,33,25,11,8,3,20
S01013078,Good health,146,1,0,1,15,18,5,16,27,40,16,9,7,8
S01013078,Fair health,80,0,0,0,6,9,6,8,15,25,8,6,2,3
S01013078,Bad health,24,1,1,0,4,2,1,2,3,8,3,3,0,0
S01013078,Very bad health,7,0,0,0,1,0,0,1,0,2,3,3,0,0
S01013079,All people aged 16 to 74,1022,122,11,111,229,103,68,53,120,103,123,108,15,101
S01013079,Very good health,516,91,10,81,143,44,37,23,44,32,28,24,4,74
S01013079,Good health,331,23,1,22,72,47,19,20,48,37,46,40,6,19
S01013079,Fair health,133,6,0,6,12,9,8,8,21,21,41,38,3,7
S01013079,Bad health,35,2,0,2,2,3,3,2,6,10,7,5,2,0
S01013079,Very bad health,7,0,0,0,0,0,1,0,1,3,1,1,0,1
S01013080,All people aged 16 to 74,645,104,23,81,156,61,51,37,47,33,16,9,7,140
S01013080,Very good health,378,76,20,56,89,27,26,14,22,10,8,5,3,106
S01013080,Good health,192,18,3,15,52,27,18,15,16,14,4,1,3,28
S01013080,Fair health,57,9,0,9,12,6,4,6,7,6,2,2,0,5
S01013080,Bad health,13,1,0,1,2,0,2,2,2,3,0,0,0,1
S01013080,Very bad health,5,0,0,0,1,1,1,0,0,0,2,1,1,0
S01013081,All people aged 16 to 74,498,100,11,89,135,81,36,27,50,30,9,5,4,30
S01013081,Very good health,282,65,7,58,87,43,19,10,18,13,4,2,2,23
S01013081,Good health,166,29,4,25,34,31,13,13,27,11,2,0,2,6
S01013081,Fair health,37,6,0,6,9,5,4,1,4,4,3,3,0,1
S01013081,Bad health,9,0,0,0,4,2,0,1,1,1,0,0,0,0
S01013081,Very bad health,4,0,0,0,1,0,0,2,0,1,0,0,0,0
S01013082,All people aged 16 to 74,660,75,11,64,186,127,44,43,98,36,12,7,5,39
S01013082,Very good health,344,49,4,45,97,66,19,23,46,9,7,3,4,28
S01013082,Good health,218,22,6,16,63,39,19,15,33,17,2,2,0,8
S01013082,Fair health,75,4,1,3,19,21,3,4,14,5,2,1,1,3
S01013082,Bad health,19,0,0,0,5,1,3,1,3,5,1,1,0,0
S01013082,Very bad health,4,0,0,0,2,0,0,0,2,0,0,0,0,0
S01013083,All people aged 16 to 74,2163,56,10,46,111,49,27,18,38,20,7,4,3,1837
S01013083,Very good health,1423,37,5,32,66,27,15,8,21,10,3,3,0,1236
S01013083,Good health,638,16,3,13,32,14,7,8,12,7,3,1,2,539
S01013083,Fair health,87,3,2,1,11,8,5,1,4,1,0,0,0,54
S01013083,Bad health,13,0,0,0,0,0,0,1,1,2,1,0,1,8
S01013083,Very bad health,2,0,0,0,2,0,0,0,0,0,0,0,0,0
S01013084,All people aged 16 to 74,530,101,23,78,167,73,40,25,51,27,10,6,4,36
S01013084,Very good health,316,63,18,45,109,36,20,14,24,15,4,2,2,31
S01013084,Good health,158,26,4,22,46,24,18,10,22,6,2,1,1,4
S01013084,Fair health,44,11,1,10,8,12,2,0,3,4,3,2,1,1
S01013084,Bad health,7,1,0,1,3,0,0,1,1,0,1,1,0,0
S01013084,Very bad health,5,0,0,0,1,1,0,0,1,2,0,0,0,0
S01013085,All people aged 16 to 74,486,34,9,25,64,46,32,27,55,39,12,8,4,177
S01013085,Very good health,225,20,8,12,40,15,16,10,16,16,3,1,2,89
S01013085,Good health,195,13,1,12,14,24,11,8,26,15,5,4,1,79
S01013085,Fair health,34,0,0,0,5,4,2,5,5,4,1,1,0,8
S01013085,Bad health,24,1,0,1,4,3,3,2,5,4,1,0,1,1
S01013085,Very bad health,8,0,0,0,1,0,0,2,3,0,2,2,0,0
S01013086,All people aged 16 to 74,679,134,15,119,155,71,45,34,63,37,24,15,9,116
S01013086,Very good health,402,96,13,83,90,40,20,17,32,14,10,6,4,83
S01013086,Good health,201,32,1,31,48,19,13,15,18,17,6,2,4,33
S01013086,Fair health,61,5,0,5,17,8,9,2,10,5,5,5,0,0
S01013086,Bad health,15,1,1,0,0,4,3,0,3,1,3,2,1,0
S01013086,Very bad health,0,0,0,0,0,0,0,0,0,0,0,0,0,0
S01013087,All people aged 16 to 74,610,155,37,118,172,53,47,10,25,16,12,4,8,120
S01013087,Very good health,377,106,21,85,109,22,27,6,13,10,4,2,2,80
S01013087,Good health,195,42,13,29,51,27,19,4,5,3,6,2,4,38
S01013087,Fair health,31,6,2,4,8,3,1,0,7,2,2,0,2,2
S01013087,Bad health,5,1,1,0,3,1,0,0,0,0,0,0,0,0
S01013087,Very bad health,2,0,0,0,1,0,0,0,0,1,0,0,0,0
S01013088,All people aged 16 to 74,687,159,36,123,242,72,77,25,35,9,12,6,6,56
S01013088,Very good health,440,102,21,81,160,38,45,16,23,3,6,3,3,47
S01013088,Good health,197,45,10,35,69,29,24,7,8,3,3,1,2,9
S01013088,Fair health,39,11,4,7,10,4,5,2,4,0,3,2,1,0
S01013088,Bad health,9,1,1,0,2,1,2,0,0,3,0,0,0,0
S01013088,Very bad health,2,0,0,0,1,0,1,0,0,0,0,0,0,0
S01013089,All people aged 16 to 74,563,65,12,53,124,67,35,43,73,75,24,13,11,57
S01013089,Very good health,269,36,7,29,62,30,14,15,31,34,10,8,2,37
S01013089,Good health,202,21,4,17,49,27,17,19,21,24,6,2,4,18
S01013089,Fair health,65,5,0,5,7,7,3,8,18,9,6,2,4,2
S01013089,Bad health,17,1,1,0,3,2,1,0,2,7,1,0,1,0
S01013089,Very bad health,10,2,0,2,3,1,0,1,1,1,1,1,0,0
S01013090,All people aged 16 to 74,651,84,13,71,138,50,47,35,58,26,20,13,7,193
S01013090,Very good health,394,51,8,43,89,25,24,25,25,12,3,2,1,140
S01013090,Good health,199,27,4,23,42,21,17,8,18,7,7,2,5,52
S01013090,Fair health,45,6,1,5,7,2,5,2,12,5,5,4,1,1
S01013090,Bad health,12,0,0,0,0,2,1,0,3,2,4,4,0,0
S01013090,Very bad health,1,0,0,0,0,0,0,0,0,0,1,1,0,0
S01013091,All people aged 16 to 74,448,45,6,39,96,38,17,22,24,24,14,11,3,168
S01013091,Very good health,293,29,3,26,66,23,9,12,13,15,9,7,2,117
S01013091,Good health,126,15,3,12,23,11,5,7,10,4,2,1,1,49
S01013091,Fair health,22,1,0,1,6,3,3,2,1,4,1,1,0,1
S01013091,Bad health,5,0,0,0,1,0,0,1,0,0,2,2,0,1
S01013091,Very bad health,2,0,0,0,0,1,0,0,0,1,0,0,0,0
S01013092,All people aged 16 to 74,676,94,14,80,163,77,37,46,66,67,32,18,14,94
S01013092,Very good health,372,62,10,52,97,35,19,19,33,29,13,7,6,65
S01013092,Good health,221,26,3,23,49,33,11,19,20,24,13,9,4,26
S01013092,Fair health,60,4,0,4,14,7,4,7,9,8,5,1,4,2
S01013092,Bad health,20,1,1,0,3,1,3,1,3,6,1,1,0,1
S01013092,Very bad health,3,1,0,1,0,1,0,0,1,0,0,0,0,0
S01013093,All people aged 16 to 74,357,68,20,48,109,48,52,20,19,14,2,2,0,25
S01013093,Very good health,203,39,11,28,52,29,29,12,14,7,0,0,0,21
S01013093,Good health,103,25,7,18,33,16,16,4,4,3,0,0,0,2
S01013093,Fair health,44,4,2,2,20,2,7,4,1,2,2,2,0,2
S01013093,Bad health,5,0,0,0,3,0,0,0,0,2,0,0,0,0
S01013093,Very bad health,2,0,0,0,1,1,0,0,0,0,0,0,0,0
S01013094,All people aged 16 to 74,446,104,16,88,164,60,21,11,33,15,6,4,2,32
S01013094,Very good health,293,71,11,60,100,37,15,5,21,10,4,2,2,30
S01013094,Good health,113,25,4,21,48,17,4,5,9,3,1,1,0,1
S01013094,Fair health,31,6,1,5,12,6,2,1,2,1,0,0,0,1
S01013094,Bad health,9,2,0,2,4,0,0,0,1,1,1,1,0,0
S01013094,Very bad health,0,0,0,0,0,0,0,0,0,0,0,0,0,0
S01013095,All people aged 16 to 74,607,181,47,134,200,53,39,19,30,21,6,2,4,58
S01013095,Very good health,421,127,36,91,135,34,28,12,21,12,4,1,3,48
S01013095,Good health,160,48,11,37,54,17,10,7,8,6,1,0,1,9
S01013095,Fair health,20,5,0,5,8,2,1,0,1,2,1,1,0,0
S01013095,Bad health,6,1,0,1,3,0,0,0,0,1,0,0,0,1
S01013095,Very bad health,0,0,0,0,0,0,0,0,0,0,0,0,0,0
S01013096,All people aged 16 to 74,420,29,11,18,83,45,20,31,62,52,10,4,6,88
S01013096,Very good health,231,16,6,10,47,30,7,12,23,21,4,2,2,71
S01013096,Good health,130,10,3,7,30,9,7,15,23,17,5,1,4,14
S01013096,Fair health,42,2,1,1,3,5,4,1,12,13,0,0,0,2
S01013096,Bad health,13,1,1,0,3,1,1,2,3,0,1,1,0,1
S01013096,Very bad health,4,0,0,0,0,0,1,1,1,1,0,0,0,0
S01013097,All people aged 16 to 74,466,92,17,75,154,33,63,27,37,26,9,7,2,25
S01013097,Very good health,280,58,13,45,93,25,37,12,21,9,3,2,1,22
S01013097,Good health,142,28,3,25,50,4,22,12,10,10,3,2,1,3
S01013097,Fair health,37,6,1,5,11,3,3,2,5,6,1,1,0,0
S01013097,Bad health,3,0,0,0,0,0,0,1,1,0,1,1,0,0
S01013097,Very bad health,4,0,0,0,0,1,1,0,0,1,1,1,0,0
S01013098,All people aged 16 to 74,416,131,37,94,143,33,25,9,22,13,5,3,2,35
S01013098,Very good health,318,104,27,77,108,26,17,4,14,10,1,0,1,34
S01013098,Good health,87,25,9,16,31,7,7,5,6,2,3,2,1,1
S01013098,Fair health,7,2,1,1,3,0,0,0,1,1,0,0,0,0
S01013098,Bad health,3,0,0,0,0,0,1,0,1,0,1,1,0,0
S01013098,Very bad health,1,0,0,0,1,0,0,0,0,0,0,0,0,0
S01013099,All people aged 16 to 74,645,110,15,95,219,51,61,49,65,32,17,9,8,41
S01013099,Very good health,355,66,11,55,127,27,29,24,33,12,3,1,2,34
S01013099,Good health,202,33,2,31,66,14,18,18,22,16,8,4,4,7
S01013099,Fair health,64,10,2,8,14,8,9,6,9,3,5,3,2,0
S01013099,Bad health,16,1,0,1,7,1,3,1,1,1,1,1,0,0
S01013099,Very bad health,8,0,0,0,5,1,2,0,0,0,0,0,0,0
S01013100,All people aged 16 to 74,416,114,28,86,149,46,31,12,19,9,16,12,4,20
S01013100,Very good health,276,87,20,67,104,25,20,6,12,4,4,0,4,14
S01013100,Good health,109,24,8,16,38,14,8,5,6,3,7,7,0,4
S01013100,Fair health,26,3,0,3,6,6,3,1,0,1,5,5,0,1
S01013100,Bad health,3,0,0,0,1,1,0,0,0,0,0,0,0,1
S01013100,Very bad health,2,0,0,0,0,0,0,0,1,1,0,0,0,0
S01013101,All people aged 16 to 74,716,63,14,49,146,82,54,82,124,81,41,24,17,43
S01013101,Very good health,307,28,4,24,68,33,24,33,55,24,10,5,5,32
S01013101,Good health,263,23,6,17,59,36,21,26,45,31,13,8,5,9
S01013101,Fair health,98,8,1,7,15,12,9,13,17,17,6,3,3,1
S01013101,Bad health,33,4,3,1,4,1,0,8,4,5,7,4,3,0
S01013101,Very bad health,15,0,0,0,0,0,0,2,3,4,5,4,1,1
S01013102,All people aged 16 to 74,409,79,16,63,149,42,14,18,56,20,7,4,3,24
S01013102,Very good health,215,47,10,37,70,22,9,9,27,7,3,1,2,21
S01013102,Good health,141,26,5,21,61,16,3,6,17,6,3,2,1,3
S01013102,Fair health,36,4,1,3,14,2,1,2,7,6,0,0,0,0
S01013102,Bad health,14,1,0,1,4,2,1,1,4,1,0,0,0,0
S01013102,Very bad health,3,1,0,1,0,0,0,0,1,0,1,1,0,0
S01013103,All people aged 16 to 74,590,98,25,73,201,76,48,36,56,16,11,5,6,48
S01013103,Very good health,378,65,18,47,134,45,27,23,32,8,4,1,3,40
S01013103,Good health,154,28,6,22,48,20,17,6,16,5,6,3,3,8
S01013103,Fair health,45,4,1,3,14,9,3,6,7,2,0,0,0,0
S01013103,Bad health,9,1,0,1,5,1,1,0,0,1,0,0,0,0
S01013103,Very bad health,4,0,0,0,0,1,0,1,1,0,1,1,0,0
S01013104,All people aged 16 to 74,718,126,24,102,243,96,66,32,70,25,17,9,8,43
S01013104,Very good health,398,77,9,68,139,45,36,16,32,7,8,2,6,38
S01013104,Good health,254,42,13,29,84,41,23,13,28,16,4,2,2,3
S01013104,Fair health,55,6,1,5,19,7,7,3,7,2,2,2,0,2
S01013104,Bad health,6,1,1,0,1,1,0,0,1,0,2,2,0,0
S01013104,Very bad health,5,0,0,0,0,2,0,0,2,0,1,1,0,0
S01013105,All people aged 16 to 74,658,154,30,124,221,80,42,23,55,29,16,11,5,38
S01013105,Very good health,388,104,19,85,127,43,26,16,22,12,2,0,2,36
S01013105,Good health,207,41,10,31,72,29,11,5,21,14,12,10,2,2
S01013105,Fair health,43,7,1,6,17,6,3,2,7,0,1,0,1,0
S01013105,Bad health,14,1,0,1,3,2,1,0,5,2,0,0,0,0
S01013105,Very bad health,6,1,0,1,2,0,1,0,0,1,1,1,0,0
S01013106,All people aged 16 to 74,577,56,8,48,134,58,76,50,77,67,17,11,6,42
S01013106,Very good health,305,34,5,29,83,30,39,21,35,26,4,0,4,33
S01013106,Good health,194,19,2,17,41,20,27,19,28,27,5,4,1,8
S01013106,Fair health,58,2,1,1,7,6,8,10,11,7,6,6,0,1
S01013106,Bad health,18,1,0,1,3,2,2,0,3,6,1,0,1,0
S01013106,Very bad health,2,0,0,0,0,0,0,0,0,1,1,1,0,0
S01013107,All people aged 16 to 74,512,90,19,71,160,65,69,31,40,22,8,7,1,27
S01013107,Very good health,295,55,13,42,95,37,34,10,22,12,5,5,0,25
S01013107,Good health,165,28,4,24,46,23,28,14,16,7,2,1,1,1
S01013107,Fair health,37,6,1,5,15,3,6,3,0,3,1,1,0,0
S01013107,Bad health,13,1,1,0,3,2,1,3,2,0,0,0,0,1
S01013107,Very bad health,2,0,0,0,1,0,0,1,0,0,0,0,0,0
S01013108,All people aged 16 to 74,436,59,10,49,94,49,52,31,70,49,11,6,5,21
S01013108,Very good health,231,41,8,33,50,25,24,11,31,26,6,3,3,17
S01013108,Good health,147,13,2,11,36,14,19,17,27,15,2,1,1,4
S01013108,Fair health,42,5,0,5,5,4,7,3,11,6,1,0,1,0
S01013108,Bad health,13,0,0,0,2,6,1,0,1,1,2,2,0,0
S01013108,Very bad health,3,0,0,0,1,0,1,0,0,1,0,0,0,0
S01013109,All people aged 16 to 74,824,110,22,88,174,87,141,53,106,59,49,43,6,45
S01013109,Very good health,471,82,16,66,94,47,83,26,51,26,22,20,2,40
S01013109,Good health,260,23,5,18,58,27,44,19,43,20,21,18,3,5
S01013109,Fair health,70,4,0,4,16,11,12,6,9,9,3,2,1,0
S01013109,Bad health,17,1,1,0,2,2,2,2,3,2,3,3,0,0
S01013109,Very bad health,6,0,0,0,4,0,0,0,0,2,0,0,0,0
S01013110,All people aged 16 to 74,437,50,6,44,124,33,96,26,47,25,13,8,5,23
S01013110,Very good health,260,35,3,32,73,16,61,18,19,11,6,3,3,21
S01013110,Good health,130,15,3,12,37,12,30,4,18,9,4,3,1,1
S01013110,Fair health,32,0,0,0,9,5,4,3,5,4,1,0,1,1
S01013110,Bad health,12,0,0,0,4,0,1,1,4,1,1,1,0,0
S01013110,Very bad health,3,0,0,0,1,0,0,0,1,0,1,1,0,0
S01013111,All people aged 16 to 74,341,52,3,49,103,31,56,14,29,20,2,1,1,34
S01013111,Very good health,220,35,2,33,71,18,28,11,18,11,0,0,0,28
S01013111,Good health,85,11,1,10,24,10,21,1,7,6,1,0,1,4
S01013111,Fair health,20,6,0,6,5,2,4,1,1,1,0,0,0,0
S01013111,Bad health,11,0,0,0,3,1,2,1,2,2,0,0,0,0
S01013111,Very bad health,5,0,0,0,0,0,1,0,1,0,1,1,0,2
S01013112,All people aged 16 to 74,457,47,11,36,97,57,49,38,75,46,17,8,9,31
S01013112,Very good health,240,31,6,25,56,30,22,18,37,22,5,1,4,19
S01013112,Good health,158,13,3,10,30,22,19,14,27,17,5,2,3,11
S01013112,Fair health,40,2,1,1,6,5,5,6,7,3,5,3,2,1
S01013112,Bad health,12,1,1,0,4,0,1,0,2,3,1,1,0,0
S01013112,Very bad health,7,0,0,0,1,0,2,0,2,1,1,1,0,0
S01013113,All people aged 16 to 74,572,30,10,20,112,49,66,51,129,85,24,18,6,26
S01013113,Very good health,277,17,5,12,53,22,33,23,62,39,6,6,0,22
S01013113,Good health,182,11,4,7,38,14,22,13,47,26,9,5,4,2
S01013113,Fair health,80,2,1,1,18,8,6,12,11,15,6,4,2,2
S01013113,Bad health,25,0,0,0,2,5,4,3,7,4,0,0,0,0
S01013113,Very bad health,8,0,0,0,1,0,1,0,2,1,3,3,0,0
S01013114,All people aged 16 to 74,620,68,15,53,134,67,101,51,83,61,21,11,10,34
S01013114,Very good health,351,43,7,36,84,32,53,28,38,36,7,3,4,30
S01013114,Good health,192,14,6,8,36,26,37,16,34,19,7,3,4,3
S01013114,Fair health,52,8,1,7,11,6,8,3,5,5,5,3,2,1
S01013114,Bad health,18,3,1,2,3,2,2,3,4,0,1,1,0,0
S01013114,Very bad health,7,0,0,0,0,1,1,1,2,1,1,1,0,0
S01013115,All people aged 16 to 74,465,27,5,22,105,49,74,46,88,37,15,9,6,24
S01013115,Very good health,210,11,2,9,41,22,36,20,39,20,1,1,0,20
S01013115,Good health,175,12,2,10,43,22,28,16,34,9,7,5,2,4
S01013115,Fair health,59,3,1,2,17,5,6,7,10,5,6,2,4,0
S01013115,Bad health,16,1,0,1,4,0,2,2,4,2,1,1,0,0
S01013115,Very bad health,5,0,0,0,0,0,2,1,1,1,0,0,0,0
S01013116,All people aged 16 to 74,559,78,21,57,187,62,80,26,62,25,9,7,2,30
S01013116,Very good health,312,41,11,30,107,38,41,10,32,13,5,4,1,25
S01013116,Good health,189,33,8,25,65,18,27,13,20,7,1,1,0,5
S01013116,Fair health,40,2,0,2,12,3,8,2,7,5,1,1,0,0
S01013116,Bad health,11,2,2,0,2,2,0,1,2,0,2,1,1,0
S01013116,Very bad health,7,0,0,0,1,1,4,0,1,0,0,0,0,0
S01013117,All people aged 16 to 74,477,29,6,23,121,39,48,65,82,51,11,9,2,31
S01013117,Very good health,275,20,5,15,78,25,26,34,40,22,7,6,1,23
S01013117,Good health,139,6,0,6,28,9,17,24,30,18,0,0,0,7
S01013117,Fair health,41,2,1,1,9,3,3,5,10,6,2,1,1,1
S01013117,Bad health,17,0,0,0,5,2,2,2,1,4,1,1,0,0
S01013117,Very bad health,5,1,0,1,1,0,0,0,1,1,1,1,0,0
S01013118,All people aged 16 to 74,418,55,11,44,110,26,60,41,45,60,5,3,2,16
S01013118,Very good health,248,38,6,32,67,17,37,20,24,29,1,1,0,15
S01013118,Good health,130,14,4,10,36,7,16,18,15,20,3,2,1,1
S01013118,Fair health,30,3,1,2,7,1,6,3,5,4,1,0,1,0
S01013118,Bad health,8,0,0,0,0,1,0,0,0,7,0,0,0,0
S01013118,Very bad health,2,0,0,0,0,0,1,0,1,0,0,0,0,0
S01013119,All people aged 16 to 74,607,61,18,43,148,43,145,41,69,61,11,7,4,28
S01013119,Very good health,295,36,8,28,77,14,71,17,31,23,3,2,1,23
S01013119,Good health,229,21,10,11,54,22,52,18,27,25,5,3,2,5
S01013119,Fair health,57,4,0,4,15,5,13,5,6,8,1,0,1,0
S01013119,Bad health,18,0,0,0,2,1,5,1,4,4,1,1,0,0
S01013119,Very bad health,8,0,0,0,0,1,4,0,1,1,1,1,0,0
S01013120,All people aged 16 to 74,736,61,11,50,141,62,140,78,125,79,9,4,5,41
S01013120,Very good health,379,29,2,27,79,32,60,42,67,39,1,1,0,30
S01013120,Good health,239,22,6,16,45,19,48,29,38,25,3,1,2,10
S01013120,Fair health,83,8,3,5,15,8,24,4,12,8,3,1,2,1
S01013120,Bad health,30,2,0,2,2,2,7,3,7,5,2,1,1,0
S01013120,Very bad health,5,0,0,0,0,1,1,0,1,2,0,0,0,0
S01013121,All people aged 16 to 74,314,15,2,13,49,18,70,37,57,41,17,7,10,10
S01013121,Very good health,156,9,1,8,26,7,40,16,24,18,8,4,4,8
S01013121,Good health,103,4,1,3,17,6,18,15,26,9,6,0,6,2
S01013121,Fair health,45,2,0,2,6,5,9,2,5,14,2,2,0,0
S01013121,Bad health,7,0,0,0,0,0,3,2,2,0,0,0,0,0
S01013121,Very bad health,3,0,0,0,0,0,0,2,0,0,1,1,0,0
S01013122,All people aged 16 to 74,446,12,4,8,48,50,14,33,97,94,69,37,32,29
S01013122,Very good health,155,6,2,4,24,13,6,11,37,29,14,3,11,15
S01013122,Good health,169,5,2,3,16,21,3,14,36,27,34,19,15,13
S01013122,Fair health,64,0,0,0,5,8,2,8,13,18,9,7,2,1
S01013122,Bad health,44,0,0,0,1,7,2,0,10,19,5,2,3,0
S01013122,Very bad health,14,1,0,1,2,1,1,0,1,1,7,6,1,0
S01013123,All people aged 16 to 74,568,23,5,18,99,102,18,53,114,75,46,25,21,38
S01013123,Very good health,236,17,4,13,45,40,5,20,41,26,14,6,8,28
S01013123,Good health,211,3,1,2,40,43,12,25,45,18,17,7,10,8
S01013123,Fair health,73,2,0,2,10,15,1,5,13,17,8,6,2,2
S01013123,Bad health,39,1,0,1,4,4,0,3,12,11,4,3,1,0
S01013123,Very bad health,9,0,0,0,0,0,0,0,3,3,3,3,0,0
S01013124,All people aged 16 to 74,537,22,10,12,94,90,18,57,109,84,27,17,10,36
S01013124,Very good health,238,12,4,8,46,42,9,23,46,29,4,1,3,27
S01013124,Good health,164,8,4,4,37,30,5,12,32,21,14,8,6,5
S01013124,Fair health,83,0,0,0,8,16,1,14,16,20,5,4,1,3
S01013124,Bad health,34,2,2,0,1,2,1,7,11,8,1,1,0,1
S01013124,Very bad health,18,0,0,0,2,0,2,1,4,6,3,3,0,0
S01013125,All people aged 16 to 74,587,33,15,18,110,117,48,34,96,76,32,24,8,41
S01013125,Very good health,246,18,7,11,62,56,14,9,37,18,5,3,2,27
S01013125,Good health,180,9,2,7,32,36,17,14,31,23,6,4,2,12
S01013125,Fair health,107,4,4,0,11,17,10,6,18,22,18,14,4,1
S01013125,Bad health,41,2,2,0,4,6,6,5,7,9,1,1,0,1
S01013125,Very bad health,13,0,0,0,1,2,1,0,3,4,2,2,0,0
S01013126,All people aged 16 to 74,547,14,3,11,60,71,20,39,127,97,67,37,30,52
S01013126,Very good health,210,7,2,5,31,31,8,16,34,28,20,12,8,35
S01013126,Good health,172,4,0,4,20,20,3,10,47,31,24,7,17,13
S01013126,Fair health,95,3,1,2,6,10,4,7,26,25,11,7,4,3
S01013126,Bad health,56,0,0,0,3,6,4,4,19,11,8,7,1,1
S01013126,Very bad health,14,0,0,0,0,4,1,2,1,2,4,4,0,0
S01013127,All people aged 16 to 74,585,10,2,8,60,66,25,53,145,111,76,45,31,39
S01013127,Very good health,189,3,1,2,18,17,7,18,49,24,27,18,9,26
S01013127,Good health,228,6,1,5,29,29,11,16,49,53,24,7,17,11
S01013127,Fair health,102,1,0,1,6,13,5,12,25,23,16,12,4,1
S01013127,Bad health,52,0,0,0,7,4,2,7,18,8,5,4,1,1
S01013127,Very bad health,14,0,0,0,0,3,0,0,4,3,4,4,0,0
S01013128,All people aged 16 to 74,517,18,6,12,91,93,10,52,96,88,47,22,25,22
S01013128,Very good health,208,12,4,8,40,49,6,18,36,22,12,6,6,13
S01013128,Good health,156,3,2,1,37,24,1,19,30,26,11,3,8,5
S01013128,Fair health,98,2,0,2,10,17,1,8,20,19,18,9,9,3
S01013128,Bad health,51,1,0,1,4,3,2,7,7,21,5,3,2,1
S01013128,Very bad health,4,0,0,0,0,0,0,0,3,0,1,1,0,0
S01013129,All people aged 16 to 74,858,33,10,23,179,143,38,84,156,110,59,37,22,56
S01013129,Very good health,380,21,7,14,95,63,12,34,59,37,17,8,9,42
S01013129,Good health,253,7,1,6,60,46,16,24,40,28,20,12,8,12
S01013129,Fair health,137,3,0,3,16,16,5,16,40,29,11,7,4,1
S01013129,Bad health,63,2,2,0,6,15,4,5,12,12,6,5,1,1
S01013129,Very bad health,25,0,0,0,2,3,1,5,5,4,5,5,0,0
S01013130,All people aged 16 to 74,515,18,3,15,79,63,22,40,105,62,78,49,29,48
S01013130,Very good health,214,9,0,9,39,30,12,14,36,16,24,7,17,34
S01013130,Good health,182,8,3,5,33,22,5,19,35,27,21,14,7,12
S01013130,Fair health,75,0,0,0,5,9,1,5,20,12,21,18,3,2
S01013130,Bad health,36,1,0,1,2,1,4,1,12,6,9,7,2,0
S01013130,Very bad health,8,0,0,0,0,1,0,1,2,1,3,3,0,0
S01013131,All people aged 16 to 74,484,21,6,15,67,86,18,43,98,86,29,12,17,36
S01013131,Very good health,211,11,2,9,33,37,8,12,43,28,10,5,5,29
S01013131,Good health,169,6,2,4,28,31,6,20,31,31,11,3,8,5
S01013131,Fair health,71,3,1,2,3,12,4,10,15,16,7,4,3,1
S01013131,Bad health,25,1,1,0,2,5,0,1,7,8,0,0,0,1
S01013131,Very bad health,8,0,0,0,1,1,0,0,2,3,1,0,1,0
S01013132,All people aged 16 to 74,429,13,0,13,54,53,25,42,97,69,42,24,18,34
S01013132,Very good health,186,10,0,10,20,22,10,14,44,26,14,10,4,26
S01013132,Good health,130,0,0,0,20,20,6,17,28,21,12,6,6,6
S01013132,Fair health,71,1,0,1,10,7,5,7,14,14,12,6,6,1
S01013132,Bad health,36,2,0,2,3,4,2,3,10,7,4,2,2,1
S01013132,Very bad health,6,0,0,0,1,0,2,1,1,1,0,0,0,0
S01013133,All people aged 16 to 74,611,24,5,19,88,95,27,52,122,100,69,38,31,34
S01013133,Very good health,232,16,4,12,45,41,11,20,40,27,7,4,3,25
S01013133,Good health,187,8,1,7,29,28,8,17,49,26,16,4,12,6
S01013133,Fair health,102,0,0,0,6,12,6,6,17,27,25,14,11,3
S01013133,Bad health,85,0,0,0,5,14,2,9,15,19,21,16,5,0
S01013133,Very bad health,5,0,0,0,3,0,0,0,1,1,0,0,0,0
S01013134,All people aged 16 to 74,601,44,12,32,123,94,39,50,97,81,26,16,10,47
S01013134,Very good health,278,25,5,20,69,35,14,24,43,21,10,6,4,37
S01013134,Good health,199,15,7,8,40,39,17,13,35,22,9,6,3,9
S01013134,Fair health,89,3,0,3,11,16,6,7,14,25,6,4,2,1
S01013134,Bad health,26,1,0,1,2,4,2,4,3,9,1,0,1,0
S01013134,Very bad health,9,0,0,0,1,0,0,2,2,4,0,0,0,0
S01013135,All people aged 16 to 74,559,10,1,9,52,71,25,40,134,121,62,43,19,44
S01013135,Very good health,193,4,0,4,25,29,8,14,40,25,19,12,7,29
S01013135,Good health,209,3,0,3,16,25,14,19,60,45,19,14,5,8
S01013135,Fair health,87,1,0,1,4,10,3,3,21,28,12,6,6,5
S01013135,Bad health,46,2,1,1,4,5,0,4,9,13,8,7,1,1
S01013135,Very bad health,24,0,0,0,3,2,0,0,4,10,4,4,0,1
S01013136,All people aged 16 to 74,699,10,3,7,101,107,23,65,159,151,43,27,16,40
S01013136,Very good health,272,5,2,3,54,47,8,25,56,38,10,6,4,29
S01013136,Good health,256,4,0,4,33,38,10,25,63,56,17,10,7,10
S01013136,Fair health,114,0,0,0,11,15,5,11,24,36,11,6,5,1
S01013136,Bad health,47,1,1,0,3,5,0,2,14,17,5,5,0,0
S01013136,Very bad health,10,0,0,0,0,2,0,2,2,4,0,0,0,0
S01013137,All people aged 16 to 74,565,12,3,9,71,89,31,53,109,130,32,19,13,38
S01013137,Very good health,212,7,3,4,32,36,13,17,34,35,7,3,4,31
S01013137,Good health,193,5,0,5,25,30,11,19,44,39,14,8,6,6
S01013137,Fair health,101,0,0,0,11,18,2,10,12,38,9,6,3,1
S01013137,Bad health,36,0,0,0,2,2,2,7,12,10,1,1,0,0
S01013137,Very bad health,23,0,0,0,1,3,3,0,7,8,1,1,0,0
S01013138,All people aged 16 to 74,492,6,1,5,60,71,22,42,117,81,53,30,23,40
S01013138,Very good health,177,4,1,3,26,28,8,15,36,23,12,8,4,25
S01013138,Good health,183,2,0,2,19,26,11,14,42,31,24,10,14,14
S01013138,Fair health,83,0,0,0,10,13,3,7,24,13,12,9,3,1
S01013138,Bad health,37,0,0,0,4,3,0,5,12,9,4,2,2,0
S01013138,Very bad health,12,0,0,0,1,1,0,1,3,5,1,1,0,0
S01013139,All people aged 16 to 74,647,23,6,17,70,96,32,49,148,118,58,35,23,53
S01013139,Very good health,257,11,1,10,30,39,11,18,49,34,26,14,12,39
S01013139,Good health,194,8,4,4,26,29,14,15,52,26,14,9,5,10
S01013139,Fair health,112,3,1,2,6,19,3,5,28,34,12,7,5,2
S01013139,Bad health,62,1,0,1,7,9,2,9,15,12,5,4,1,2
S01013139,Very bad health,22,0,0,0,1,0,2,2,4,12,1,1,0,0
S01013140,All people aged 16 to 74,598,18,5,13,73,73,31,46,127,118,58,45,13,54
S01013140,Very good health,234,9,4,5,40,31,14,22,34,22,23,18,5,39
S01013140,Good health,198,8,1,7,22,21,9,13,45,52,16,9,7,12
S01013140,Fair health,91,1,0,1,6,14,5,6,29,19,9,9,0,2
S01013140,Bad health,56,0,0,0,4,6,3,4,14,18,6,5,1,1
S01013140,Very bad health,19,0,0,0,1,1,0,1,5,7,4,4,0,0
S01013141,All people aged 16 to 74,461,14,6,8,65,77,20,23,87,101,44,28,16,30
S01013141,Very good health,193,8,3,5,37,36,9,8,30,29,13,7,6,23
S01013141,Good health,148,6,3,3,18,25,6,6,34,31,15,9,6,7
S01013141,Fair health,79,0,0,0,3,14,3,8,17,26,8,4,4,0
S01013141,Bad health,34,0,0,0,6,2,2,1,6,11,6,6,0,0
S01013141,Very bad health,7,0,0,0,1,0,0,0,0,4,2,2,0,0
S01013142,All people aged 16 to 74,566,11,4,7,63,78,26,54,122,113,60,43,17,39
S01013142,Very good health,183,6,1,5,22,28,8,17,45,23,11,6,5,23
S01013142,Good health,188,2,1,1,23,15,10,14,49,40,22,14,8,13
S01013142,Fair health,115,2,2,0,12,26,6,12,16,26,12,9,3,3
S01013142,Bad health,60,1,0,1,2,8,2,7,9,23,8,7,1,0
S01013142,Very bad health,20,0,0,0,4,1,0,4,3,1,7,7,0,0
S01013143,All people aged 16 to 74,651,26,5,21,116,102,32,70,123,98,31,22,9,53
S01013143,Very good health,291,18,4,14,58,50,13,22,50,28,10,7,3,42
S01013143,Good health,200,5,1,4,37,25,11,27,39,37,11,8,3,8
S01013143,Fair health,108,3,0,3,16,19,5,14,19,26,4,3,1,2
S01013143,Bad health,35,0,0,0,3,5,3,5,9,6,3,1,2,1
S01013143,Very bad health,17,0,0,0,2,3,0,2,6,1,3,3,0,0
S01013144,All people aged 16 to 74,666,23,8,15,105,108,32,71,139,95,42,22,20,51
S01013144,Very good health,272,10,2,8,48,52,9,31,48,26,19,11,8,29
S01013144,Good health,216,6,2,4,37,27,14,20,55,25,13,4,9,19
S01013144,Fair health,120,4,2,2,15,25,3,12,25,27,6,3,3,3
S01013144,Bad health,46,2,1,1,4,4,6,6,7,13,4,4,0,0
S01013144,Very bad health,12,1,1,0,1,0,0,2,4,4,0,0,0,0
S01013145,All people aged 16 to 74,528,26,7,19,97,82,26,52,96,77,29,18,11,43
S01013145,Very good health,231,9,2,7,54,37,15,17,40,19,11,4,7,29
S01013145,Good health,154,11,2,9,25,22,8,23,21,26,5,3,2,13
S01013145,Fair health,90,4,2,2,11,16,1,8,22,19,8,6,2,1
S01013145,Bad health,37,2,1,1,5,3,1,2,11,9,4,4,0,0
S01013145,Very bad health,16,0,0,0,2,4,1,2,2,4,1,1,0,0
S01013146,All people aged 16 to 74,327,15,3,12,50,47,25,23,75,57,18,14,4,17
S01013146,Very good health,145,10,3,7,21,26,14,11,31,18,3,2,1,11
S01013146,Good health,97,5,0,5,23,13,5,8,22,12,3,2,1,6
S01013146,Fair health,60,0,0,0,6,6,5,2,16,18,7,5,2,0
S01013146,Bad health,17,0,0,0,0,2,0,2,5,8,0,0,0,0
S01013146,Very bad health,8,0,0,0,0,0,1,0,1,1,5,5,0,0
S01013147,All people aged 16 to 74,515,29,4,25,79,89,37,42,96,63,17,13,4,63
S01013147,Very good health,269,18,3,15,48,48,12,15,41,23,8,5,3,56
S01013147,Good health,150,9,1,8,20,24,19,19,26,23,5,4,1,5
S01013147,Fair health,65,1,0,1,9,11,6,2,21,11,3,3,0,1
S01013147,Bad health,21,0,0,0,1,5,0,4,4,5,1,1,0,1
S01013147,Very bad health,10,1,0,1,1,1,0,2,4,1,0,0,0,0
S01013148,All people aged 16 to 74,565,32,8,24,129,110,33,52,96,57,32,18,14,24
S01013148,Very good health,282,21,5,16,79,62,16,22,37,19,6,2,4,20
S01013148,Good health,170,8,3,5,37,34,8,13,36,19,12,6,6,3
S01013148,Fair health,74,3,0,3,10,9,6,10,19,8,8,5,3,1
S01013148,Bad health,29,0,0,0,2,4,2,6,3,8,4,3,1,0
S01013148,Very bad health,10,0,0,0,1,1,1,1,1,3,2,2,0,0
S01013149,All people aged 16 to 74,619,40,11,29,122,124,26,59,90,77,25,13,12,56
S01013149,Very good health,283,26,6,20,68,66,7,26,28,24,4,2,2,34
S01013149,Good health,227,14,5,9,41,44,8,21,37,31,13,5,8,18
S01013149,Fair health,74,0,0,0,8,13,7,8,15,14,5,4,1,4
S01013149,Bad health,30,0,0,0,5,1,4,4,7,6,3,2,1,0
S01013149,Very bad health,5,0,0,0,0,0,0,0,3,2,0,0,0,0
S01013150,All people aged 16 to 74,646,34,8,26,106,128,34,53,123,92,25,16,9,51
S01013150,Very good health,262,17,4,13,47,64,10,20,39,19,7,2,5,39
S01013150,Good health,225,11,2,9,38,37,12,22,46,38,10,7,3,11
S01013150,Fair health,98,3,2,1,15,20,6,7,23,18,5,5,0,1
S01013150,Bad health,48,1,0,1,6,7,4,4,11,14,1,0,1,0
S01013150,Very bad health,13,2,0,2,0,0,2,0,4,3,2,2,0,0
S01013151,All people aged 16 to 74,424,33,8,25,106,88,38,36,48,38,14,9,5,23
S01013151,Very good health,240,22,5,17,65,51,21,20,17,18,7,3,4,19
S01013151,Good health,127,9,2,7,27,26,11,10,23,14,4,3,1,3
S01013151,Fair health,41,2,1,1,11,7,5,5,5,4,1,1,0,1
S01013151,Bad health,14,0,0,0,2,3,1,1,3,2,2,2,0,0
S01013151,Very bad health,2,0,0,0,1,1,0,0,0,0,0,0,0,0
S01013152,All people aged 16 to 74,659,47,10,37,114,106,38,58,106,96,43,29,14,51
S01013152,Very good health,311,34,8,26,55,52,20,20,46,35,11,5,6,38
S01013152,Good health,216,13,2,11,44,33,11,28,42,21,14,10,4,10
S01013152,Fair health,90,0,0,0,11,14,3,8,15,20,16,12,4,3
S01013152,Bad health,34,0,0,0,2,7,2,1,3,17,2,2,0,0
S01013152,Very bad health,8,0,0,0,2,0,2,1,0,3,0,0,0,0
S01013153,All people aged 16 to 74,621,19,4,15,65,80,28,56,137,114,68,41,27,54
S01013153,Very good health,221,7,0,7,19,27,13,16,51,24,25,17,8,39
S01013153,Good health,221,9,3,6,29,33,8,23,50,38,19,6,13,12
S01013153,Fair health,114,1,0,1,12,14,4,10,24,30,16,11,5,3
S01013153,Bad health,50,1,0,1,2,5,2,5,9,18,8,7,1,0
S01013153,Very bad health,15,1,1,0,3,1,1,2,3,4,0,0,0,0
S01013154,All people aged 16 to 74,702,22,5,17,102,105,30,66,137,126,57,28,29,57
S01013154,Very good health,307,11,3,8,50,49,8,30,53,44,25,12,13,37
S01013154,Good health,247,9,2,7,39,33,10,19,61,42,21,8,13,13
S01013154,Fair health,100,2,0,2,7,16,7,11,16,28,8,5,3,5
S01013154,Bad health,36,0,0,0,4,6,3,5,5,11,1,1,0,1
S01013154,Very bad health,12,0,0,0,2,1,2,1,2,1,2,2,0,1
S01013155,All people aged 16 to 74,651,15,2,13,69,75,23,43,168,116,75,44,31,67
S01013155,Very good health,275,6,1,5,30,33,10,12,66,39,29,17,12,50
S01013155,Good health,233,7,1,6,31,29,9,16,64,40,27,15,12,10
S01013155,Fair health,99,1,0,1,7,9,2,8,29,24,13,7,6,6
S01013155,Bad health,33,1,0,1,1,4,1,7,6,8,4,3,1,1
S01013155,Very bad health,11,0,0,0,0,0,1,0,3,5,2,2,0,0
S01013156,All people aged 16 to 74,619,8,2,6,75,67,16,70,138,117,68,35,33,60
S01013156,Very good health,239,3,0,3,25,25,8,29,43,43,17,9,8,46
S01013156,Good health,219,3,1,2,37,29,3,22,53,35,25,8,17,12
S01013156,Fair health,94,2,1,1,7,9,4,10,20,26,15,7,8,1
S01013156,Bad health,49,0,0,0,5,3,1,7,18,9,5,5,0,1
S01013156,Very bad health,18,0,0,0,1,1,0,2,4,4,6,6,0,0
S01013157,All people aged 16 to 74,694,14,4,10,72,93,19,71,145,118,92,57,35,70
S01013157,Very good health,279,7,2,5,38,43,8,25,55,37,25,18,7,41
S01013157,Good health,241,4,1,3,20,28,5,25,55,40,38,21,17,26
S01013157,Fair health,116,2,0,2,9,19,5,14,26,19,19,11,8,3
S01013157,Bad health,48,1,1,0,3,3,1,7,7,19,7,4,3,0
S01013157,Very bad health,10,0,0,0,2,0,0,0,2,3,3,3,0,0
S01013158,All people aged 16 to 74,419,28,5,23,124,80,35,28,51,26,15,10,5,32
S01013158,Very good health,223,17,4,13,70,38,17,17,23,7,8,4,4,26
S01013158,Good health,144,8,1,7,42,32,14,6,21,12,3,3,0,6
S01013158,Fair health,37,2,0,2,9,6,4,4,6,4,2,1,1,0
S01013158,Bad health,10,1,0,1,2,3,0,1,1,1,1,1,0,0
S01013158,Very bad health,5,0,0,0,1,1,0,0,0,2,1,1,0,0
S01013159,All people aged 16 to 74,553,32,11,21,138,117,44,35,77,54,10,5,5,46
S01013159,Very good health,290,19,7,12,72,61,18,16,38,29,1,0,1,36
S01013159,Good health,183,11,3,8,49,38,20,13,27,13,6,3,3,6
S01013159,Fair health,65,2,1,1,13,15,4,6,10,11,1,0,1,3
S01013159,Bad health,11,0,0,0,3,2,2,0,2,1,0,0,0,1
S01013159,Very bad health,4,0,0,0,1,1,0,0,0,0,2,2,0,0
S01013160,All people aged 16 to 74,558,58,14,44,127,137,48,32,72,36,12,5,7,36
S01013160,Very good health,328,36,8,28,79,74,25,19,42,20,4,2,2,29
S01013160,Good health,169,14,3,11,39,51,16,9,20,11,4,1,3,5
S01013160,Fair health,47,6,3,3,8,10,5,4,6,4,3,1,2,1
S01013160,Bad health,9,1,0,1,1,1,0,0,3,1,1,1,0,1
S01013160,Very bad health,5,1,0,1,0,1,2,0,1,0,0,0,0,0
S01013161,All people aged 16 to 74,765,39,4,35,140,144,45,71,128,116,38,21,17,44
S01013161,Very good health,374,22,2,20,82,76,23,28,49,46,15,5,10,33
S01013161,Good health,245,14,0,14,42,46,13,28,45,33,13,8,5,11
S01013161,Fair health,96,1,0,1,11,17,7,8,26,23,3,2,1,0
S01013161,Bad health,43,2,2,0,3,5,2,7,4,13,7,6,1,0
S01013161,Very bad health,7,0,0,0,2,0,0,0,4,1,0,0,0,0
S01013162,All people aged 16 to 74,610,23,7,16,99,107,32,59,112,102,43,18,25,33
S01013162,Very good health,252,10,1,9,46,49,14,25,36,36,14,3,11,22
S01013162,Good health,198,9,4,5,38,37,14,15,42,22,10,5,5,11
S01013162,Fair health,98,2,1,1,8,12,3,14,21,27,11,2,9,0
S01013162,Bad health,56,1,0,1,6,9,1,4,13,16,6,6,0,0
S01013162,Very bad health,6,1,1,0,1,0,0,1,0,1,2,2,0,0
S01013163,All people aged 16 to 74,561,35,8,27,125,106,31,70,76,54,14,7,7,50
S01013163,Very good health,282,21,5,16,58,55,9,35,39,18,5,2,3,42
S01013163,Good health,197,9,2,7,50,43,14,24,26,18,7,3,4,6
S01013163,Fair health,66,5,1,4,15,6,6,10,10,12,1,1,0,1
S01013163,Bad health,14,0,0,0,2,1,2,1,1,6,0,0,0,1
S01013163,Very bad health,2,0,0,0,0,1,0,0,0,0,1,1,0,0
S01013164,All people aged 16 to 74,783,60,10,50,145,118,63,68,119,104,45,24,21,61
S01013164,Very good health,326,27,6,21,68,52,32,25,35,30,12,6,6,45
S01013164,Good health,264,25,4,21,52,46,17,26,38,33,15,6,9,12
S01013164,Fair health,123,6,0,6,17,13,10,10,30,22,11,6,5,4
S01013164,Bad health,54,2,0,2,7,6,4,5,10,14,6,6,0,0
S01013164,Very bad health,16,0,0,0,1,1,0,2,6,5,1,0,1,0
S01013165,All people aged 16 to 74,643,50,7,43,137,118,45,49,93,77,26,16,10,48
S01013165,Very good health,305,26,3,23,66,60,27,21,33,27,8,5,3,37
S01013165,Good health,195,14,2,12,43,37,12,13,38,19,10,5,5,9
S01013165,Fair health,97,7,2,5,20,13,4,13,16,17,5,3,2,2
S01013165,Bad health,35,3,0,3,7,6,1,1,5,11,1,1,0,0
S01013165,Very bad health,11,0,0,0,1,2,1,1,1,3,2,2,0,0
S01013166,All people aged 16 to 74,502,11,3,8,44,71,26,42,107,104,64,36,28,33
S01013166,Very good health,167,3,0,3,19,28,7,11,34,28,20,9,11,17
S01013166,Good health,178,5,3,2,17,21,13,20,42,30,17,9,8,13
S01013166,Fair health,92,2,0,2,4,13,2,4,25,21,18,10,8,3
S01013166,Bad health,44,0,0,0,0,8,1,3,5,21,6,5,1,0
S01013166,Very bad health,21,1,0,1,4,1,3,4,1,4,3,3,0,0
S01013167,All people aged 16 to 74,503,10,1,9,53,68,23,43,109,91,80,26,54,26
S01013167,Very good health,179,6,1,5,25,26,9,8,36,29,24,8,16,16
S01013167,Good health,177,3,0,3,13,28,7,22,38,26,32,9,23,8
S01013167,Fair health,83,1,0,1,8,7,3,9,21,16,17,5,12,1
S01013167,Bad health,45,0,0,0,4,5,3,2,10,15,5,2,3,1
S01013167,Very bad health,19,0,0,0,3,2,1,2,4,5,2,2,0,0
S01013168,All people aged 16 to 74,658,10,0,10,71,114,28,82,133,102,70,38,32,48
S01013168,Very good health,250,8,0,8,31,50,9,34,40,22,25,12,13,31
S01013168,Good health,226,1,0,1,20,42,12,32,50,36,19,8,11,14
S01013168,Fair health,111,1,0,1,11,13,3,14,29,22,17,10,7,1
S01013168,Bad health,50,0,0,0,8,8,4,1,10,13,4,3,1,2
S01013168,Very bad health,21,0,0,0,1,1,0,1,4,9,5,5,0,0
S01013169,All people aged 16 to 74,596,11,2,9,96,101,34,60,122,93,43,33,10,36
S01013169,Very good health,223,6,1,5,44,39,14,22,32,26,14,11,3,26
S01013169,Good health,190,3,0,3,26,38,10,21,39,30,15,10,5,8
S01013169,Fair health,106,2,1,1,17,12,5,11,28,20,9,7,2,2
S01013169,Bad health,61,0,0,0,6,8,4,4,23,12,4,4,0,0
S01013169,Very bad health,16,0,0,0,3,4,1,2,0,5,1,1,0,0
S01013170,All people aged 16 to 74,387,7,0,7,47,61,18,35,80,63,58,33,25,18
S01013170,Very good health,162,2,0,2,23,28,5,14,32,20,22,10,12,16
S01013170,Good health,125,4,0,4,15,17,7,9,32,20,19,11,8,2
S01013170,Fair health,54,0,0,0,4,13,6,3,7,13,8,4,4,0
S01013170,Bad health,34,1,0,1,3,3,0,7,7,7,6,5,1,0
S01013170,Very bad health,12,0,0,0,2,0,0,2,2,3,3,3,0,0
S01013171,All people aged 16 to 74,493,49,10,39,108,93,30,32,60,49,21,11,10,51
S01013171,Very good health,260,31,7,24,53,58,11,18,20,22,3,1,2,44
S01013171,Good health,162,13,2,11,42,26,15,11,23,14,13,6,7,5
S01013171,Fair health,51,4,1,3,7,8,3,3,12,8,5,4,1,1
S01013171,Bad health,18,1,0,1,4,1,1,0,5,5,0,0,0,1
S01013171,Very bad health,2,0,0,0,2,0,0,0,0,0,0,0,0,0
S01013172,All people aged 16 to 74,574,29,8,21,100,113,26,43,115,75,30,18,12,43
S01013172,Very good health,253,15,4,11,44,57,9,19,45,20,12,9,3,32
S01013172,Good health,188,13,3,10,36,36,11,13,36,25,9,2,7,9
S01013172,Fair health,82,1,1,0,11,12,4,6,24,20,3,2,1,1
S01013172,Bad health,43,0,0,0,6,7,2,5,9,9,5,5,0,0
S01013172,Very bad health,8,0,0,0,3,1,0,0,1,1,1,0,1,1
S01013173,All people aged 16 to 74,624,47,17,30,131,106,33,48,105,86,25,13,12,43
S01013173,Very good health,321,30,11,19,63,61,8,22,48,36,15,7,8,38
S01013173,Good health,206,14,4,10,50,30,16,13,43,30,7,3,4,3
S01013173,Fair health,56,2,2,0,11,9,6,8,7,10,1,1,0,2
S01013173,Bad health,30,1,0,1,5,4,3,2,5,9,1,1,0,0
S01013173,Very bad health,11,0,0,0,2,2,0,3,2,1,1,1,0,0
S01013174,All people aged 16 to 74,600,62,13,49,170,105,33,58,81,38,8,5,3,45
S01013174,Very good health,367,39,10,29,101,65,13,40,42,22,5,4,1,40
S01013174,Good health,173,18,2,16,55,29,12,10,34,9,1,0,1,5
S01013174,Fair health,46,3,1,2,13,7,6,6,5,5,1,1,0,0
S01013174,Bad health,12,2,0,2,1,3,2,2,0,1,1,0,1,0
S01013174,Very bad health,2,0,0,0,0,1,0,0,0,1,0,0,0,0
S01013175,All people aged 16 to 74,613,63,10,53,171,109,30,66,73,51,12,5,7,38
S01013175,Very good health,336,43,8,35,94,62,12,33,27,27,7,2,5,31
S01013175,Good health,181,15,2,13,51,36,13,23,23,12,3,2,1,5
S01013175,Fair health,65,5,0,5,16,5,3,7,17,9,1,0,1,2
S01013175,Bad health,25,0,0,0,8,5,2,3,4,2,1,1,0,0
S01013175,Very bad health,6,0,0,0,2,1,0,0,2,1,0,0,0,0
S01013176,All people aged 16 to 74,584,44,10,34,135,108,35,57,86,66,21,12,9,32
S01013176,Very good health,271,28,8,20,61,55,17,25,33,24,4,3,1,24
S01013176,Good health,199,12,2,10,52,41,11,19,26,22,10,4,6,6
S01013176,Fair health,78,4,0,4,15,10,3,8,19,13,5,3,2,1
S01013176,Bad health,27,0,0,0,6,2,4,2,6,4,2,2,0,1
S01013176,Very bad health,9,0,0,0,1,0,0,3,2,3,0,0,0,0
S01013177,All people aged 16 to 74,485,29,6,23,135,106,25,32,64,56,8,5,3,30
S01013177,Very good health,262,17,4,13,81,56,13,19,23,24,5,3,2,24
S01013177,Good health,167,12,2,10,41,39,8,12,31,20,0,0,0,4
S01013177,Fair health,42,0,0,0,9,11,1,1,8,8,2,1,1,2
S01013177,Bad health,12,0,0,0,3,0,2,0,2,4,1,1,0,0
S01013177,Very bad health,2,0,0,0,1,0,1,0,0,0,0,0,0,0
S01013178,All people aged 16 to 74,575,42,10,32,142,92,30,54,85,73,12,5,7,45
S01013178,Very good health,272,28,6,22,61,49,7,22,33,26,5,1,4,41
S01013178,Good health,188,11,2,9,55,23,16,20,36,21,3,1,2,3
S01013178,Fair health,75,2,2,0,18,15,3,5,12,15,4,3,1,1
S01013178,Bad health,32,1,0,1,8,3,3,5,4,8,0,0,0,0
S01013178,Very bad health,8,0,0,0,0,2,1,2,0,3,0,0,0,0
S01013179,All people aged 16 to 74,653,34,9,25,146,117,51,54,105,76,25,18,7,45
S01013179,Very good health,298,19,5,14,71,58,22,28,36,21,8,4,4,35
S01013179,Good health,229,11,4,7,50,43,18,19,43,24,11,8,3,10
S01013179,Fair health,82,4,0,4,18,13,8,6,17,14,2,2,0,0
S01013179,Bad health,37,0,0,0,6,1,3,1,8,15,3,3,0,0
S01013179,Very bad health,7,0,0,0,1,2,0,0,1,2,1,1,0,0
S01013180,All people aged 16 to 74,354,21,4,17,95,63,21,34,41,31,12,6,6,36
S01013180,Very good health,189,13,3,10,56,27,5,17,23,14,4,1,3,30
S01013180,Good health,114,6,0,6,30,25,11,11,13,6,7,4,3,5
S01013180,Fair health,36,2,1,1,8,8,4,3,4,6,0,0,0,1
S01013180,Bad health,13,0,0,0,1,2,1,3,1,5,0,0,0,0
S01013180,Very bad health,2,0,0,0,0,1,0,0,0,0,1,1,0,0
S01013181,All people aged 16 to 74,546,37,13,24,122,87,24,64,85,76,15,5,10,36
S01013181,Very good health,250,22,7,15,60,42,10,31,33,18,2,2,0,32
S01013181,Good health,192,11,4,7,47,32,9,21,30,34,5,0,5,3
S01013181,Fair health,63,3,1,2,10,5,3,6,16,16,3,0,3,1
S01013181,Bad health,32,1,1,0,3,7,1,6,4,6,4,2,2,0
S01013181,Very bad health,9,0,0,0,2,1,1,0,2,2,1,1,0,0
S01013182,All people aged 16 to 74,536,22,4,18,82,74,24,47,122,103,31,14,17,31
S01013182,Very good health,217,13,2,11,40,28,9,24,39,29,8,3,5,27
S01013182,Good health,168,7,2,5,30,30,7,8,40,33,10,3,7,3
S01013182,Fair health,95,2,0,2,5,11,5,9,28,26,8,4,4,1
S01013182,Bad health,39,0,0,0,6,3,2,4,12,10,2,1,1,0
S01013182,Very bad health,17,0,0,0,1,2,1,2,3,5,3,3,0,0
S01013183,All people aged 16 to 74,657,60,14,46,184,116,23,58,88,59,21,10,11,48
S01013183,Very good health,339,32,7,25,113,63,12,25,35,15,3,2,1,41
S01013183,Good health,207,22,6,16,49,38,7,23,31,24,9,3,6,4
S01013183,Fair health,76,6,1,5,17,10,4,2,13,15,6,4,2,3
S01013183,Bad health,31,0,0,0,4,5,0,7,9,3,3,1,2,0
S01013183,Very bad health,4,0,0,0,1,0,0,1,0,2,0,0,0,0
S01013184,All people aged 16 to 74,416,5,1,4,37,59,18,33,106,65,68,44,24,25
S01013184,Very good health,185,3,1,2,13,24,11,15,48,23,30,19,11,18
S01013184,Good health,128,1,0,1,10,22,2,12,37,18,20,15,5,6
S01013184,Fair health,68,0,0,0,8,12,4,5,8,17,13,6,7,1
S01013184,Bad health,30,1,0,1,5,1,1,1,10,7,4,3,1,0
S01013184,Very bad health,5,0,0,0,1,0,0,0,3,0,1,1,0,0
S01013185,All people aged 16 to 74,562,16,4,12,103,77,18,57,122,92,39,15,24,38
S01013185,Very good health,232,12,3,9,38,30,6,22,44,33,18,7,11,29
S01013185,Good health,201,2,1,1,46,36,7,23,47,22,10,2,8,8
S01013185,Fair health,90,2,0,2,15,9,5,6,20,25,7,2,5,1
S01013185,Bad health,27,0,0,0,4,1,0,6,3,10,3,3,0,0
S01013185,Very bad health,12,0,0,0,0,1,0,0,8,2,1,1,0,0
S01013186,All people aged 16 to 74,496,5,3,2,51,67,20,52,144,81,50,23,27,26
S01013186,Very good health,219,4,2,2,22,37,5,23,63,25,25,10,15,15
S01013186,Good health,177,1,1,0,20,21,10,17,53,33,11,4,7,11
S01013186,Fair health,72,0,0,0,8,9,3,9,18,14,11,7,4,0
S01013186,Bad health,23,0,0,0,1,0,2,3,8,7,2,2,0,0
S01013186,Very bad health,5,0,0,0,0,0,0,0,2,2,1,0,1,0
S01013187,All people aged 16 to 74,617,23,7,16,110,76,29,65,123,86,53,30,23,52
S01013187,Very good health,262,9,4,5,62,37,8,26,46,26,13,8,5,35
S01013187,Good health,211,10,2,8,35,29,9,18,49,27,22,10,12,12
S01013187,Fair health,88,4,1,3,7,8,7,11,16,18,12,6,6,5
S01013187,Bad health,39,0,0,0,5,2,2,7,6,12,5,5,0,0
S01013187,Very bad health,17,0,0,0,1,0,3,3,6,3,1,1,0,0
S01013188,All people aged 16 to 74,675,42,11,31,152,108,33,70,110,81,23,16,7,56
S01013188,Very good health,346,23,6,17,89,59,14,30,52,25,8,3,5,46
S01013188,Good health,229,17,4,13,51,39,10,24,42,27,9,7,2,10
S01013188,Fair health,71,1,0,1,9,7,6,11,13,22,2,2,0,0
S01013188,Bad health,25,1,1,0,3,3,3,4,2,5,4,4,0,0
S01013188,Very bad health,4,0,0,0,0,0,0,1,1,2,0,0,0,0
S01013189,All people aged 16 to 74,480,37,8,29,113,68,22,39,91,56,11,7,4,43
S01013189,Very good health,250,20,5,15,64,37,9,18,45,19,3,1,2,35
S01013189,Good health,153,14,2,12,38,23,9,15,24,23,3,1,2,4
S01013189,Fair health,52,1,1,0,6,7,2,5,14,8,5,5,0,4
S01013189,Bad health,18,2,0,2,4,1,1,1,4,5,0,0,0,0
S01013189,Very bad health,7,0,0,0,1,0,1,0,4,1,0,0,0,0
S01013190,All people aged 16 to 74,596,38,10,28,127,91,39,63,97,76,25,14,11,40
S01013190,Very good health,287,20,6,14,79,53,16,28,33,17,5,0,5,36
S01013190,Good health,175,8,1,7,34,21,14,18,39,30,8,5,3,3
S01013190,Fair health,82,8,2,6,8,10,6,13,18,16,2,0,2,1
S01013190,Bad health,34,0,0,0,5,6,1,4,4,10,4,3,1,0
S01013190,Very bad health,18,2,1,1,1,1,2,0,3,3,6,6,0,0
S01013191,All people aged 16 to 74,789,94,24,70,216,139,44,69,77,56,16,11,5,78
S01013191,Very good health,449,61,16,45,124,70,20,35,40,24,7,5,2,68
S01013191,Good health,259,23,6,17,72,52,21,26,28,23,5,4,1,9
S01013191,Fair health,61,5,2,3,16,14,3,7,7,6,2,1,1,1
S01013191,Bad health,17,5,0,5,2,3,0,1,2,2,2,1,1,0
S01013191,Very bad health,3,0,0,0,2,0,0,0,0,1,0,0,0,0
S01013192,All people aged 16 to 74,706,54,9,45,174,123,40,50,117,62,28,18,10,58
S01013192,Very good health,332,32,3,29,92,63,15,19,38,19,6,3,3,48
S01013192,Good health,221,17,5,12,58,39,11,14,48,16,10,3,7,8
S01013192,Fair health,91,4,1,3,19,16,6,12,15,13,4,4,0,2
S01013192,Bad health,44,1,0,1,3,3,5,5,12,8,7,7,0,0
S01013192,Very bad health,18,0,0,0,2,2,3,0,4,6,1,1,0,0
S01013193,All people aged 16 to 74,504,35,11,24,122,105,27,40,79,59,15,9,6,22
S01013193,Very good health,247,16,3,13,65,55,11,16,37,27,4,3,1,16
S01013193,Good health,173,18,8,10,39,33,12,18,26,18,5,2,3,4
S01013193,Fair health,55,1,0,1,15,11,2,4,10,8,2,0,2,2
S01013193,Bad health,21,0,0,0,3,3,2,2,5,3,3,3,0,0
S01013193,Very bad health,8,0,0,0,0,3,0,0,1,3,1,1,0,0
S01013194,All people aged 16 to 74,471,32,6,26,93,76,26,54,86,56,13,4,9,35
S01013194,Very good health,217,19,2,17,41,45,11,20,28,23,3,1,2,27
S01013194,Good health,171,11,3,8,39,21,12,22,38,16,5,2,3,7
S01013194,Fair health,60,2,1,1,9,9,3,7,14,11,5,1,4,0
S01013194,Bad health,16,0,0,0,4,1,0,2,3,5,0,0,0,1
S01013194,Very bad health,7,0,0,0,0,0,0,3,3,1,0,0,0,0
S01013195,All people aged 16 to 74,763,54,3,51,162,132,33,63,136,101,20,12,8,62
S01013195,Very good health,347,31,2,29,86,64,12,35,43,35,5,3,2,36
S01013195,Good health,246,19,1,18,54,37,15,18,52,28,6,3,3,17
S01013195,Fair health,108,1,0,1,13,21,3,7,25,27,4,1,3,7
S01013195,Bad health,48,1,0,1,6,7,3,2,16,7,4,4,0,2
S01013195,Very bad health,14,2,0,2,3,3,0,1,0,4,1,1,0,0
S01013196,All people aged 16 to 74,504,38,13,25,139,72,34,54,78,55,10,5,5,24
S01013196,Very good health,271,24,7,17,79,36,20,30,33,25,3,1,2,21
S01013196,Good health,166,10,4,6,46,29,9,12,36,17,4,2,2,3
S01013196,Fair health,48,2,1,1,12,6,4,11,5,7,1,1,0,0
S01013196,Bad health,15,2,1,1,2,1,1,1,3,4,1,0,1,0
S01013196,Very bad health,4,0,0,0,0,0,0,0,1,2,1,1,0,0
S01013197,All people aged 16 to 74,412,32,10,22,121,72,21,35,57,34,13,9,4,27
S01013197,Very good health,198,19,6,13,69,29,12,13,24,10,3,2,1,19
S01013197,Good health,155,11,3,8,41,35,7,15,24,13,3,1,2,6
S01013197,Fair health,35,0,0,0,9,6,0,6,5,5,2,1,1,2
S01013197,Bad health,20,2,1,1,2,2,2,0,3,5,4,4,0,0
S01013197,Very bad health,4,0,0,0,0,0,0,1,1,1,1,1,0,0
S01013198,All people aged 16 to 74,601,29,10,19,100,87,44,53,105,95,46,31,15,42
S01013198,Very good health,245,19,5,14,41,40,21,15,40,25,11,5,6,33
S01013198,Good health,203,8,5,3,41,36,12,21,32,28,16,8,8,9
S01013198,Fair health,87,2,0,2,10,8,9,13,16,20,9,8,1,0
S01013198,Bad health,52,0,0,0,7,3,1,4,14,15,8,8,0,0
S01013198,Very bad health,14,0,0,0,1,0,1,0,3,7,2,2,0,0
S01013199,All people aged 16 to 74,687,68,15,53,178,85,59,51,105,71,30,15,15,40
S01013199,Very good health,326,37,7,30,106,41,25,16,35,23,9,5,4,34
S01013199,Good health,201,22,5,17,49,28,20,16,34,18,8,2,6,6
S01013199,Fair health,109,8,3,5,18,13,11,9,26,14,10,5,5,0
S01013199,Bad health,42,1,0,1,4,3,3,6,8,15,2,2,0,0
S01013199,Very bad health,9,0,0,0,1,0,0,4,2,1,1,1,0,0
S01013200,All people aged 16 to 74,529,30,6,24,111,74,28,34,90,72,54,44,10,36
S01013200,Very good health,242,17,2,15,64,42,12,13,36,17,13,7,6,28
S01013200,Good health,167,9,3,6,31,22,9,15,34,26,15,13,2,6
S01013200,Fair health,81,3,1,2,11,7,6,2,14,18,18,17,1,2
S01013200,Bad health,28,1,0,1,3,3,1,2,6,6,6,5,1,0
S01013200,Very bad health,11,0,0,0,2,0,0,2,0,5,2,2,0,0
S01013201,All people aged 16 to 74,557,20,3,17,62,63,24,36,134,112,82,53,29,24
S01013201,Very good health,200,11,2,9,30,29,8,13,36,25,28,19,9,20
S01013201,Good health,170,6,0,6,19,20,10,11,41,35,25,14,11,3
S01013201,Fair health,99,3,1,2,6,10,5,9,23,26,17,11,6,0
S01013201,Bad health,74,0,0,0,4,3,1,2,30,22,11,8,3,1
S01013201,Very bad health,14,0,0,0,3,1,0,1,4,4,1,1,0,0
S01013202,All people aged 16 to 74,428,18,4,14,66,44,18,31,75,78,57,34,23,41
S01013202,Very good health,189,12,1,11,30,19,6,14,30,31,17,9,8,30
S01013202,Good health,140,3,1,2,22,12,10,10,27,22,26,19,7,8
S01013202,Fair health,59,2,1,1,8,8,2,3,12,11,10,2,8,3
S01013202,Bad health,30,1,1,0,4,5,0,4,4,10,2,2,0,0
S01013202,Very bad health,10,0,0,0,2,0,0,0,2,4,2,2,0,0
S01013203,All people aged 16 to 74,538,26,2,24,83,62,18,44,111,108,53,32,21,33
S01013203,Very good health,226,10,0,10,46,35,8,22,40,29,17,6,11,19
S01013203,Good health,167,8,1,7,23,18,4,10,41,36,20,13,7,7
S01013203,Fair health,99,6,1,5,12,8,4,10,18,26,11,8,3,4
S01013203,Bad health,37,2,0,2,0,1,1,2,10,15,4,4,0,2
S01013203,Very bad health,9,0,0,0,2,0,1,0,2,2,1,1,0,1
S01013204,All people aged 16 to 74,610,31,5,26,146,96,17,61,102,88,24,12,12,45
S01013204,Very good health,301,14,2,12,83,46,7,22,49,38,10,5,5,32
S01013204,Good health,201,14,1,13,48,33,7,25,29,26,6,3,3,13
S01013204,Fair health,79,2,2,0,12,12,2,9,20,15,7,4,3,0
S01013204,Bad health,22,1,0,1,2,4,0,4,3,7,1,0,1,0
S01013204,Very bad health,7,0,0,0,1,1,1,1,1,2,0,0,0,0
S01013205,All people aged 16 to 74,440,4,1,3,49,39,21,38,104,85,64,46,18,36
S01013205,Very good health,180,3,1,2,22,15,2,16,46,23,25,14,11,28
S01013205,Good health,136,1,0,1,16,15,8,12,29,32,17,13,4,6
S01013205,Fair health,69,0,0,0,7,6,10,5,15,13,12,10,2,1
S01013205,Bad health,43,0,0,0,4,2,1,4,10,14,7,6,1,1
S01013205,Very bad health,12,0,0,0,0,1,0,1,4,3,3,3,0,0
S01013206,All people aged 16 to 74,489,14,4,10,64,60,18,46,113,102,35,18,17,37
S01013206,Very good health,176,7,1,6,27,25,8,15,37,22,8,4,4,27
S01013206,Good health,185,5,3,2,22,25,7,17,44,42,15,4,11,8
S01013206,Fair health,81,1,0,1,10,7,2,9,19,23,8,7,1,2
S01013206,Bad health,39,1,0,1,3,3,1,2,12,13,4,3,1,0
S01013206,Very bad health,8,0,0,0,2,0,0,3,1,2,0,0,0,0
S01013207,All people aged 16 to 74,596,19,6,13,103,81,53,49,117,102,40,27,13,32
S01013207,Very good health,231,11,3,8,58,37,19,17,38,21,7,3,4,23
S01013207,Good health,187,3,2,1,27,26,20,17,44,34,9,6,3,7
S01013207,Fair health,112,5,1,4,14,9,12,6,26,27,12,7,5,1
S01013207,Bad health,51,0,0,0,4,8,1,7,6,15,9,8,1,1
S01013207,Very bad health,15,0,0,0,0,1,1,2,3,5,3,3,0,0
S01013208,All people aged 16 to 74,717,20,6,14,102,80,37,74,149,125,86,63,23,44
S01013208,Very good health,287,9,4,5,54,31,11,38,51,41,17,7,10,35
S01013208,Good health,221,6,1,5,34,29,6,21,54,34,31,23,8,6
S01013208,Fair health,127,3,0,3,8,8,13,10,29,31,23,18,5,2
S01013208,Bad health,70,2,1,1,6,11,6,4,13,15,12,12,0,1
S01013208,Very bad health,12,0,0,0,0,1,1,1,2,4,3,3,0,0
S01013209,All people aged 16 to 74,621,30,3,27,123,98,40,60,116,96,28,15,13,30
S01013209,Very good health,257,15,0,15,56,52,14,27,41,20,11,5,6,21
S01013209,Good health,197,13,3,10,44,27,14,17,41,30,7,4,3,4
S01013209,Fair health,106,2,0,2,14,13,9,9,24,23,8,4,4,4
S01013209,Bad health,44,0,0,0,7,3,2,6,7,16,2,2,0,1
S01013209,Very bad health,17,0,0,0,2,3,1,1,3,7,0,0,0,0
S01013210,All people aged 16 to 74,475,51,9,42,97,95,40,33,63,43,12,6,6,41
S01013210,Very good health,234,26,4,22,49,42,18,12,30,15,5,1,4,37
S01013210,Good health,172,19,3,16,36,44,17,12,23,14,4,4,0,3
S01013210,Fair health,48,5,1,4,11,7,4,4,8,6,2,1,1,1
S01013210,Bad health,16,1,1,0,0,2,1,4,1,7,0,0,0,0
S01013210,Very bad health,5,0,0,0,1,0,0,1,1,1,1,0,1,0
S01013211,All people aged 16 to 74,680,37,11,26,113,112,33,84,140,95,31,20,11,35
S01013211,Very good health,330,21,5,16,53,70,16,39,63,40,5,2,3,23
S01013211,Good health,206,15,6,9,43,31,8,21,45,23,9,3,6,11
S01013211,Fair health,83,1,0,1,15,8,8,8,19,17,7,5,2,0
S01013211,Bad health,52,0,0,0,2,2,1,14,11,11,10,10,0,1
S01013211,Very bad health,9,0,0,0,0,1,0,2,2,4,0,0,0,0
S01013212,All people aged 16 to 74,468,32,7,25,109,82,31,41,72,42,7,5,2,52
S01013212,Very good health,285,16,2,14,66,51,8,29,39,24,4,2,2,48
S01013212,Good health,133,13,3,10,31,24,14,10,27,9,1,1,0,4
S01013212,Fair health,36,3,2,1,10,5,9,2,2,5,0,0,0,0
S01013212,Bad health,12,0,0,0,2,2,0,0,3,3,2,2,0,0
S01013212,Very bad health,2,0,0,0,0,0,0,0,1,1,0,0,0,0
S01013213,All people aged 16 to 74,449,34,6,28,94,86,42,45,54,35,9,4,5,50
S01013213,Very good health,249,18,2,16,49,44,19,28,25,18,5,3,2,43
S01013213,Good health,152,11,4,7,33,36,17,13,22,13,1,0,1,6
S01013213,Fair health,36,4,0,4,9,4,5,3,5,2,3,1,2,1
S01013213,Bad health,10,1,0,1,3,2,0,1,2,1,0,0,0,0
S01013213,Very bad health,2,0,0,0,0,0,1,0,0,1,0,0,0,0
S01013214,All people aged 16 to 74,339,16,4,12,90,63,23,40,46,25,9,6,3,27
S01013214,Very good health,204,12,3,9,57,38,11,22,27,10,4,3,1,23
S01013214,Good health,86,4,1,3,26,11,8,9,10,11,3,2,1,4
S01013214,Fair health,37,0,0,0,7,10,1,7,7,3,2,1,1,0
S01013214,Bad health,9,0,0,0,0,2,3,1,2,1,0,0,0,0
S01013214,Very bad health,3,0,0,0,0,2,0,1,0,0,0,0,0,0
S01013215,All people aged 16 to 74,636,26,7,19,112,115,35,84,125,91,20,6,14,28
S01013215,Very good health,272,15,5,10,53,56,8,33,43,36,8,2,6,20
S01013215,Good health,221,9,2,7,40,31,18,30,51,25,11,3,8,6
S01013215,Fair health,106,2,0,2,16,19,8,17,24,18,1,1,0,1
S01013215,Bad health,30,0,0,0,2,6,1,4,6,11,0,0,0,0
S01013215,Very bad health,7,0,0,0,1,3,0,0,1,1,0,0,0,1
S01013216,All people aged 16 to 74,441,8,2,6,50,65,19,51,101,78,36,25,11,33
S01013216,Very good health,200,4,1,3,29,31,5,22,39,34,15,9,6,21
S01013216,Good health,143,2,0,2,11,22,7,21,31,28,11,8,3,10
S01013216,Fair health,73,1,0,1,7,8,7,6,23,12,7,6,1,2
S01013216,Bad health,16,1,1,0,0,2,0,2,4,4,3,2,1,0
S01013216,Very bad health,9,0,0,0,3,2,0,0,4,0,0,0,0,0
S01013217,All people aged 16 to 74,521,17,5,12,63,74,22,50,125,100,32,15,17,38
S01013217,Very good health,234,5,1,4,42,29,10,22,56,39,9,6,3,22
S01013217,Good health,174,9,3,6,15,25,7,20,38,36,12,4,8,12
S01013217,Fair health,80,1,0,1,6,16,3,5,22,16,9,4,5,2
S01013217,Bad health,31,2,1,1,0,3,1,3,9,9,2,1,1,2
S01013217,Very bad health,2,0,0,0,0,1,1,0,0,0,0,0,0,0
S01013218,All people aged 16 to 74,445,3,2,1,42,39,22,46,117,102,43,28,15,31
S01013218,Very good health,163,1,1,0,18,11,9,14,43,25,17,8,9,25
S01013218,Good health,162,0,0,0,16,17,8,19,45,39,13,9,4,5
S01013218,Fair health,85,1,1,0,5,9,5,10,24,22,8,6,2,1
S01013218,Bad health,25,0,0,0,2,2,0,1,3,15,2,2,0,0
S01013218,Very bad health,10,1,0,1,1,0,0,2,2,1,3,3,0,0
S01013219,All people aged 16 to 74,405,7,1,6,55,42,16,43,105,78,29,12,17,30
S01013219,Very good health,141,2,0,2,23,16,0,12,35,24,11,3,8,18
S01013219,Good health,154,4,1,3,15,15,10,20,47,25,8,3,5,10
S01013219,Fair health,71,1,0,1,7,8,4,10,18,16,5,2,3,2
S01013219,Bad health,31,0,0,0,9,1,1,1,5,10,4,3,1,0
S01013219,Very bad health,8,0,0,0,1,2,1,0,0,3,1,1,0,0
S01013220,All people aged 16 to 74,491,9,1,8,52,58,21,52,130,97,46,20,26,26
S01013220,Very good health,180,5,1,4,23,18,9,15,52,30,9,6,3,19
S01013220,Good health,172,3,0,3,20,23,6,19,43,34,20,7,13,4
S01013220,Fair health,82,0,0,0,7,12,3,10,18,15,15,5,10,2
S01013220,Bad health,43,1,0,1,1,4,2,7,14,11,2,2,0,1
S01013220,Very bad health,14,0,0,0,1,1,1,1,3,7,0,0,0,0
S01013221,All people aged 16 to 74,677,28,6,22,78,85,56,73,144,111,46,25,21,56
S01013221,Very good health,272,12,2,10,29,35,27,27,43,40,16,5,11,43
S01013221,Good health,250,14,4,10,30,30,17,27,65,42,16,10,6,9
S01013221,Fair health,103,1,0,1,13,14,7,13,19,21,13,9,4,2
S01013221,Bad health,41,0,0,0,4,5,3,5,15,7,0,0,0,2
S01013221,Very bad health,11,1,0,1,2,1,2,1,2,1,1,1,0,0
S01013222,All people aged 16 to 74,433,13,3,10,48,55,22,31,98,104,35,24,11,27
S01013222,Very good health,154,8,2,6,19,28,8,12,27,21,11,8,3,20
S01013222,Good health,132,4,1,3,17,10,5,13,34,28,14,7,7,7
S01013222,Fair health,91,0,0,0,11,9,5,5,27,26,8,7,1,0
S01013222,Bad health,43,0,0,0,1,8,2,1,9,20,2,2,0,0
S01013222,Very bad health,13,1,0,1,0,0,2,0,1,9,0,0,0,0
S01013223,All people aged 16 to 74,785,41,11,30,141,110,42,86,130,112,78,50,28,45
S01013223,Very good health,353,29,7,22,66,59,20,38,57,28,23,13,10,33
S01013223,Good health,223,9,2,7,52,28,15,17,33,42,18,11,7,9
S01013223,Fair health,128,3,2,1,16,19,4,12,26,23,23,13,10,2
S01013223,Bad health,65,0,0,0,5,4,1,16,12,15,11,10,1,1
S01013223,Very bad health,16,0,0,0,2,0,2,3,2,4,3,3,0,0
S01013224,All people aged 16 to 74,638,31,5,26,108,91,39,74,128,91,37,22,15,39
S01013224,Very good health,282,18,4,14,47,41,12,30,60,32,14,7,7,28
S01013224,Good health,207,10,1,9,46,32,12,22,42,29,9,4,5,5
S01013224,Fair health,86,2,0,2,6,11,10,12,13,16,10,9,1,6
S01013224,Bad health,48,1,0,1,6,3,5,9,9,12,3,1,2,0
S01013224,Very bad health,15,0,0,0,3,4,0,1,4,2,1,1,0,0
S01013225,All people aged 16 to 74,589,20,2,18,79,65,24,63,124,113,60,39,21,41
S01013225,Very good health,251,11,1,10,39,32,9,29,46,39,15,9,6,31
S01013225,Good health,186,8,1,7,25,19,9,14,42,35,27,13,14,7
S01013225,Fair health,103,1,0,1,11,8,4,14,22,29,12,11,1,2
S01013225,Bad health,33,0,0,0,3,2,2,5,9,9,2,2,0,1
S01013225,Very bad health,16,0,0,0,1,4,0,1,5,1,4,4,0,0
S01013226,All people aged 16 to 74,388,30,11,19,96,59,22,35,63,43,12,6,6,28
S01013226,Very good health,193,20,7,13,53,35,10,15,23,14,2,1,1,21
S01013226,Good health,143,6,2,4,31,20,9,18,27,17,8,3,5,7
S01013226,Fair health,36,2,2,0,9,3,2,2,11,6,1,1,0,0
S01013226,Bad health,14,2,0,2,3,1,0,0,2,5,1,1,0,0
S01013226,Very bad health,2,0,0,0,0,0,1,0,0,1,0,0,0,0
S01013227,All people aged 16 to 74,507,13,1,12,71,57,20,80,113,85,35,24,11,33
S01013227,Very good health,206,9,0,9,30,29,12,25,37,29,11,9,2,24
S01013227,Good health,167,0,0,0,29,16,4,26,45,29,11,7,4,7
S01013227,Fair health,71,2,0,2,5,8,1,15,15,16,8,3,5,1
S01013227,Bad health,46,1,1,0,3,3,3,12,11,8,4,4,0,1
S01013227,Very bad health,17,1,0,1,4,1,0,2,5,3,1,1,0,0
S01013228,All people aged 16 to 74,575,28,10,18,99,73,38,52,129,91,45,19,26,20
S01013228,Very good health,222,14,5,9,40,33,10,22,41,30,16,6,10,16
S01013228,Good health,214,11,3,8,38,26,18,21,53,35,8,0,8,4
S01013228,Fair health,83,2,1,1,16,7,6,7,18,15,12,6,6,0
S01013228,Bad health,42,1,1,0,4,7,3,1,15,6,5,3,2,0
S01013228,Very bad health,14,0,0,0,1,0,1,1,2,5,4,4,0,0
S01013229,All people aged 16 to 74,580,26,5,21,79,88,23,64,113,108,46,28,18,33
S01013229,Very good health,224,15,2,13,40,28,10,25,38,37,9,6,3,22
S01013229,Good health,189,6,0,6,27,32,6,22,35,37,15,6,9,9
S01013229,Fair health,113,2,1,1,7,20,3,11,28,22,18,13,5,2
S01013229,Bad health,41,3,2,1,4,7,3,4,9,8,3,2,1,0
S01013229,Very bad health,13,0,0,0,1,1,1,2,3,4,1,1,0,0
S01013230,All people aged 16 to 74,479,17,2,15,76,95,14,56,91,93,14,11,3,23
S01013230,Very good health,199,12,1,11,29,39,7,24,26,40,5,4,1,17
S01013230,Good health,169,3,1,2,35,35,5,17,42,24,4,2,2,4
S01013230,Fair health,64,2,0,2,7,12,1,9,12,17,3,3,0,1
S01013230,Bad health,32,0,0,0,4,5,1,6,8,8,0,0,0,0
S01013230,Very bad health,15,0,0,0,1,4,0,0,3,4,2,2,0,1
S01013231,All people aged 16 to 74,559,15,5,10,101,97,26,56,107,94,37,26,11,26
S01013231,Very good health,240,6,2,4,49,42,10,23,45,37,8,6,2,20
S01013231,Good health,183,9,3,6,36,39,12,19,28,25,10,5,5,5
S01013231,Fair health,70,0,0,0,8,12,1,8,17,12,12,10,2,0
S01013231,Bad health,47,0,0,0,7,1,2,3,11,17,6,4,2,0
S01013231,Very bad health,19,0,0,0,1,3,1,3,6,3,1,1,0,1
S01013232,All people aged 16 to 74,527,20,8,12,78,76,36,43,116,107,26,17,9,25
S01013232,Very good health,208,9,4,5,37,31,12,16,46,33,7,3,4,17
S01013232,Good health,183,7,1,6,26,28,14,14,47,31,10,7,3,6
S01013232,Fair health,75,3,2,1,4,9,4,9,14,25,5,3,2,2
S01013232,Bad health,45,1,1,0,7,7,4,3,6,16,1,1,0,0
S01013232,Very bad health,16,0,0,0,4,1,2,1,3,2,3,3,0,0
S01013233,All people aged 16 to 74,435,24,5,19,96,66,30,43,86,50,17,13,4,23
S01013233,Very good health,198,13,3,10,47,38,11,19,33,17,4,3,1,16
S01013233,Good health,154,8,1,7,37,19,12,15,34,17,6,6,0,6
S01013233,Fair health,53,2,0,2,8,5,5,6,8,12,6,4,2,1
S01013233,Bad health,24,0,0,0,1,4,2,3,9,4,1,0,1,0
S01013233,Very bad health,6,1,1,0,3,0,0,0,2,0,0,0,0,0
S01013234,All people aged 16 to 74,303,30,10,20,110,49,26,21,28,11,5,4,1,23
S01013234,Very good health,170,16,6,10,59,30,14,14,12,6,0,0,0,19
S01013234,Good health,104,12,4,8,35,17,9,7,13,3,4,3,1,4
S01013234,Fair health,18,2,0,2,11,2,1,0,1,0,1,1,0,0
S01013234,Bad health,9,0,0,0,4,0,1,0,2,2,0,0,0,0
S01013234,Very bad health,2,0,0,0,1,0,1,0,0,0,0,0,0,0
S01013235,All people aged 16 to 74,612,40,7,33,120,107,41,66,118,73,16,11,5,31
S01013235,Very good health,288,24,3,21,67,51,13,27,53,24,6,4,2,23
S01013235,Good health,203,10,4,6,34,42,17,27,42,20,4,2,2,7
S01013235,Fair health,76,6,0,6,16,9,7,8,7,19,4,3,1,0
S01013235,Bad health,32,0,0,0,2,5,4,2,11,6,1,1,0,1
S01013235,Very bad health,13,0,0,0,1,0,0,2,5,4,1,1,0,0
S01013236,All people aged 16 to 74,675,53,10,43,166,113,71,70,85,50,23,18,5,44
S01013236,Very good health,351,28,5,23,88,66,34,33,46,13,8,4,4,35
S01013236,Good health,230,19,4,15,61,32,21,27,31,22,8,7,1,9
S01013236,Fair health,70,5,1,4,14,9,13,8,6,11,4,4,0,0
S01013236,Bad health,15,1,0,1,2,3,2,2,0,3,2,2,0,0
S01013236,Very bad health,9,0,0,0,1,3,1,0,2,1,1,1,0,0
S01013237,All people aged 16 to 74,617,36,10,26,134,112,41,52,96,68,19,13,6,59
S01013237,Very good health,346,21,6,15,83,71,15,28,49,36,3,3,0,40
S01013237,Good health,184,14,4,10,38,28,19,15,30,17,10,5,5,13
S01013237,Fair health,52,1,0,1,12,5,5,3,10,6,6,5,1,4
S01013237,Bad health,25,0,0,0,1,5,1,6,5,5,0,0,0,2
S01013237,Very bad health,10,0,0,0,0,3,1,0,2,4,0,0,0,0
S01013238,All people aged 16 to 74,563,12,2,10,64,58,29,60,133,110,63,41,22,34
S01013238,Very good health,204,5,1,4,32,20,10,26,37,40,12,10,2,22
S01013238,Good health,175,7,1,6,22,22,7,13,46,28,21,10,11,9
S01013238,Fair health,104,0,0,0,5,12,7,8,32,21,16,10,6,3
S01013238,Bad health,60,0,0,0,3,3,2,7,16,19,10,8,2,0
S01013238,Very bad health,20,0,0,0,2,1,3,6,2,2,4,3,1,0
S01013239,All people aged 16 to 74,660,13,2,11,98,63,25,67,150,134,67,37,30,43
S01013239,Very good health,243,8,1,7,42,25,8,26,50,35,19,9,10,30
S01013239,Good health,248,4,1,3,34,26,7,28,60,52,26,12,14,11
S01013239,Fair health,111,1,0,1,11,8,6,10,29,28,17,12,5,1
S01013239,Bad health,45,0,0,0,7,3,2,3,10,15,4,3,1,1
S01013239,Very bad health,13,0,0,0,4,1,2,0,1,4,1,1,0,0
S01013240,All people aged 16 to 74,403,7,4,3,42,37,16,36,95,91,53,32,21,26
S01013240,Very good health,167,5,2,3,21,14,7,16,30,36,19,10,9,19
S01013240,Good health,115,2,2,0,14,11,3,10,32,22,15,8,7,6
S01013240,Fair health,88,0,0,0,5,7,6,6,28,20,15,11,4,1
S01013240,Bad health,23,0,0,0,2,3,0,3,3,9,3,2,1,0
S01013240,Very bad health,10,0,0,0,0,2,0,1,2,4,1,1,0,0
S01013241,All people aged 16 to 74,665,65,22,43,203,132,48,52,77,34,11,6,5,43
S01013241,Very good health,361,43,15,28,103,69,25,33,34,14,7,3,4,33
S01013241,Good health,225,18,6,12,79,54,11,11,32,13,0,0,0,7
S01013241,Fair health,62,4,1,3,16,8,9,6,8,7,2,1,1,2
S01013241,Bad health,13,0,0,0,3,0,2,2,3,0,2,2,0,1
S01013241,Very bad health,4,0,0,0,2,1,1,0,0,0,0,0,0,0
S01013242,All people aged 16 to 74,451,53,9,44,101,53,84,33,49,30,10,7,3,38
S01013242,Very good health,257,35,4,31,63,28,46,15,26,9,3,0,3,32
S01013242,Good health,140,14,5,9,26,17,32,11,20,11,5,5,0,4
S01013242,Fair health,41,3,0,3,10,7,4,4,3,6,2,2,0,2
S01013242,Bad health,12,1,0,1,2,1,1,3,0,4,0,0,0,0
S01013242,Very bad health,1,0,0,0,0,0,1,0,0,0,0,0,0,0
S01013243,All people aged 16 to 74,569,25,7,18,73,66,34,49,131,128,37,22,15,26
S01013243,Very good health,241,14,3,11,34,27,15,14,49,50,16,12,4,22
S01013243,Good health,197,6,2,4,29,24,18,19,49,36,12,3,9,4
S01013243,Fair health,92,5,2,3,8,9,1,13,20,28,8,6,2,0
S01013243,Bad health,28,0,0,0,0,3,0,2,10,12,1,1,0,0
S01013243,Very bad health,11,0,0,0,2,3,0,1,3,2,0,0,0,0
S01013244,All people aged 16 to 74,544,13,2,11,75,66,43,47,107,129,33,20,13,31
S01013244,Very good health,213,7,1,6,42,24,10,19,37,41,10,6,4,23
S01013244,Good health,163,5,1,4,21,29,16,15,32,30,11,6,5,4
S01013244,Fair health,102,1,0,1,9,10,11,5,28,25,9,5,4,4
S01013244,Bad health,52,0,0,0,3,3,5,6,8,25,2,2,0,0
S01013244,Very bad health,14,0,0,0,0,0,1,2,2,8,1,1,0,0
S01013245,All people aged 16 to 74,753,61,16,45,119,112,62,82,121,134,30,15,15,32
S01013245,Very good health,327,32,8,24,61,48,26,30,46,48,11,7,4,25
S01013245,Good health,284,27,8,19,45,45,24,35,44,47,12,4,8,5
S01013245,Fair health,99,2,0,2,8,11,9,12,24,27,4,1,3,2
S01013245,Bad health,34,0,0,0,5,8,2,3,5,10,1,1,0,0
S01013245,Very bad health,9,0,0,0,0,0,1,2,2,2,2,2,0,0
S01013246,All people aged 16 to 74,345,29,9,20,46,52,31,40,64,62,8,7,1,13
S01013246,Very good health,158,16,5,11,26,25,15,20,24,21,2,1,1,9
S01013246,Good health,106,7,1,6,13,20,8,13,20,20,3,3,0,2
S01013246,Fair health,60,5,2,3,5,7,5,6,13,14,3,3,0,2
S01013246,Bad health,18,1,1,0,2,0,2,1,6,6,0,0,0,0
S01013246,Very bad health,3,0,0,0,0,0,1,0,1,1,0,0,0,0
S01013247,All people aged 16 to 74,557,16,3,13,66,62,36,52,133,128,43,28,15,21
S01013247,Very good health,228,10,3,7,30,28,11,25,44,47,19,12,7,14
S01013247,Good health,173,5,0,5,22,24,16,10,51,33,8,4,4,4
S01013247,Fair health,88,1,0,1,8,5,4,9,23,24,13,9,4,1
S01013247,Bad health,56,0,0,0,5,5,3,8,12,18,3,3,0,2
S01013247,Very bad health,12,0,0,0,1,0,2,0,3,6,0,0,0,0
S01013248,All people aged 16 to 74,471,10,4,6,54,65,28,31,110,114,35,14,21,24
S01013248,Very good health,180,4,2,2,23,21,9,10,41,44,11,7,4,17
S01013248,Good health,164,3,1,2,19,31,16,8,35,33,13,2,11,6
S01013248,Fair health,83,1,0,1,11,8,2,9,19,25,7,2,5,1
S01013248,Bad health,35,2,1,1,0,4,1,3,11,10,4,3,1,0
S01013248,Very bad health,9,0,0,0,1,1,0,1,4,2,0,0,0,0
S01013249,All people aged 16 to 74,337,6,1,5,55,43,21,33,74,69,19,12,7,17
S01013249,Very good health,150,3,1,2,29,21,9,14,33,21,10,5,5,10
S01013249,Good health,106,3,0,3,20,14,5,12,19,26,3,2,1,4
S01013249,Fair health,55,0,0,0,4,5,4,6,15,14,5,4,1,2
S01013249,Bad health,21,0,0,0,2,2,3,0,6,6,1,1,0,1
S01013249,Very bad health,5,0,0,0,0,1,0,1,1,2,0,0,0,0
S01013250,All people aged 16 to 74,668,61,9,52,159,60,100,48,89,87,24,16,8,40
S01013250,Very good health,354,29,3,26,101,34,48,23,41,38,9,5,4,31
S01013250,Good health,210,24,5,19,44,19,36,16,32,22,11,7,4,6
S01013250,Fair health,76,7,1,6,11,6,15,6,14,12,2,2,0,3
S01013250,Bad health,21,1,0,1,1,0,1,3,1,12,2,2,0,0
S01013250,Very bad health,7,0,0,0,2,1,0,0,1,3,0,0,0,0
S01013251,All people aged 16 to 74,531,16,5,11,62,61,16,48,120,131,41,25,16,36
S01013251,Very good health,201,10,3,7,27,23,4,17,35,46,12,7,5,27
S01013251,Good health,183,6,2,4,19,26,9,14,46,38,17,8,9,8
S01013251,Fair health,96,0,0,0,12,6,2,11,25,28,11,9,2,1
S01013251,Bad health,40,0,0,0,4,4,1,4,12,14,1,1,0,0
S01013251,Very bad health,11,0,0,0,0,2,0,2,2,5,0,0,0,0
S01013252,All people aged 16 to 74,521,30,14,16,87,54,42,47,87,119,24,15,9,31
S01013252,Very good health,251,12,4,8,48,27,23,27,38,40,10,5,5,26
S01013252,Good health,151,13,6,7,27,19,9,11,17,45,5,3,2,5
S01013252,Fair health,70,4,3,1,10,3,7,4,20,18,4,3,1,0
S01013252,Bad health,43,1,1,0,1,4,2,5,12,14,4,3,1,0
S01013252,Very bad health,6,0,0,0,1,1,1,0,0,2,1,1,0,0
S01013253,All people aged 16 to 74,537,28,5,23,94,80,30,49,103,106,20,9,11,27
S01013253,Very good health,252,14,2,12,54,44,9,21,46,35,7,4,3,22
S01013253,Good health,177,12,2,10,26,19,13,22,32,42,7,0,7,4
S01013253,Fair health,89,1,1,0,13,12,7,5,22,24,4,3,1,1
S01013253,Bad health,13,0,0,0,1,4,0,1,2,3,2,2,0,0
S01013253,Very bad health,6,1,0,1,0,1,1,0,1,2,0,0,0,0
S01013254,All people aged 16 to 74,469,20,4,16,43,48,35,51,80,130,38,26,12,24
S01013254,Very good health,168,11,1,10,17,20,14,19,27,33,10,5,5,17
S01013254,Good health,160,4,1,3,16,23,14,15,25,45,12,6,6,6
S01013254,Fair health,94,4,1,3,6,4,3,9,16,42,9,8,1,1
S01013254,Bad health,33,0,0,0,1,0,4,6,8,10,4,4,0,0
S01013254,Very bad health,14,1,1,0,3,1,0,2,4,0,3,3,0,0
S01013255,All people aged 16 to 74,1158,33,10,23,114,103,106,133,170,288,166,149,17,45
S01013255,Very good health,469,21,8,13,49,50,37,73,65,101,45,40,5,28
S01013255,Good health,416,10,1,9,37,27,45,43,71,91,78,68,10,14
S01013255,Fair health,173,2,1,1,19,17,13,11,22,60,27,26,1,2
S01013255,Bad health,78,0,0,0,5,7,11,5,9,27,13,12,1,1
S01013255,Very bad health,22,0,0,0,4,2,0,1,3,9,3,3,0,0
S01013256,All people aged 16 to 74,516,52,13,39,116,67,48,43,93,45,31,24,7,21
S01013256,Very good health,255,40,11,29,70,33,21,25,27,17,6,3,3,16
S01013256,Good health,145,12,2,10,34,19,17,9,33,11,6,2,4,4
S01013256,Fair health,75,0,0,0,10,14,7,4,18,8,14,14,0,0
S01013256,Bad health,30,0,0,0,2,1,2,5,11,4,4,4,0,1
S01013256,Very bad health,11,0,0,0,0,0,1,0,4,5,1,1,0,0
S01013257,All people aged 16 to 74,574,37,8,29,115,79,52,47,104,84,18,7,11,38
S01013257,Very good health,288,22,6,16,67,36,23,27,45,37,6,1,5,25
S01013257,Good health,169,10,1,9,35,31,14,12,29,24,5,1,4,9
S01013257,Fair health,76,3,1,2,9,8,10,5,19,13,6,4,2,3
S01013257,Bad health,31,2,0,2,3,2,5,3,10,5,0,0,0,1
S01013257,Very bad health,10,0,0,0,1,2,0,0,1,5,1,1,0,0
S01013258,All people aged 16 to 74,588,59,18,41,131,103,50,52,86,55,19,15,4,33
S01013258,Very good health,305,35,12,23,63,53,26,31,39,20,7,4,3,31
S01013258,Good health,213,22,5,17,57,37,15,13,36,21,10,9,1,2
S01013258,Fair health,52,1,0,1,6,12,7,8,9,8,1,1,0,0
S01013258,Bad health,16,1,1,0,5,1,2,0,2,4,1,1,0,0
S01013258,Very bad health,2,0,0,0,0,0,0,0,0,2,0,0,0,0
S01013259,All people aged 16 to 74,622,26,5,21,108,108,36,69,115,104,21,12,9,35
S01013259,Very good health,279,13,3,10,48,53,18,34,45,37,7,3,4,24
S01013259,Good health,213,8,1,7,43,36,8,25,37,37,9,6,3,10
S01013259,Fair health,89,5,1,4,12,11,7,6,20,22,5,3,2,1
S01013259,Bad health,32,0,0,0,5,7,2,3,9,6,0,0,0,0
S01013259,Very bad health,9,0,0,0,0,1,1,1,4,2,0,0,0,0
S01013260,All people aged 16 to 74,633,26,8,18,71,84,22,62,134,145,53,34,19,36
S01013260,Very good health,260,15,6,9,34,44,9,19,53,43,23,16,7,20
S01013260,Good health,224,7,1,6,23,33,7,29,50,46,15,6,9,14
S01013260,Fair health,93,2,1,1,9,5,2,11,21,33,8,5,3,2
S01013260,Bad health,39,1,0,1,5,2,2,3,7,16,3,3,0,0
S01013260,Very bad health,17,1,0,1,0,0,2,0,3,7,4,4,0,0
S01013261,All people aged 16 to 74,575,18,2,16,51,77,28,73,137,127,30,16,14,34
S01013261,Very good health,234,7,1,6,25,37,7,29,47,49,11,7,4,22
S01013261,Good health,205,6,1,5,15,26,13,23,54,51,7,4,3,10
S01013261,Fair health,79,1,0,1,8,11,4,10,22,12,9,2,7,2
S01013261,Bad health,46,2,0,2,3,3,4,10,10,11,3,3,0,0
S01013261,Very bad health,11,2,0,2,0,0,0,1,4,4,0,0,0,0
S01013262,All people aged 16 to 74,485,21,5,16,56,68,37,64,102,95,25,13,12,17
S01013262,Very good health,203,11,2,9,28,33,15,24,35,39,8,3,5,10
S01013262,Good health,154,6,2,4,17,23,12,26,35,23,6,2,4,6
S01013262,Fair health,85,3,0,3,5,10,8,11,21,19,7,4,3,1
S01013262,Bad health,39,1,1,0,4,2,2,3,11,12,4,4,0,0
S01013262,Very bad health,4,0,0,0,2,0,0,0,0,2,0,0,0,0
S01013263,All people aged 16 to 74,388,84,19,65,111,59,37,27,24,17,6,1,5,23
S01013263,Very good health,237,59,10,49,68,37,15,14,12,8,4,0,4,20
S01013263,Good health,113,19,8,11,36,16,15,7,9,7,1,1,0,3
S01013263,Fair health,30,6,1,5,4,4,6,5,2,2,1,0,1,0
S01013263,Bad health,8,0,0,0,3,2,1,1,1,0,0,0,0,0
S01013263,Very bad health,0,0,0,0,0,0,0,0,0,0,0,0,0,0
S01013264,All people aged 16 to 74,372,59,12,47,114,64,23,17,27,14,10,6,4,44
S01013264,Very good health,227,34,5,29,69,39,8,9,17,8,2,1,1,41
S01013264,Good health,119,19,5,14,39,22,12,8,8,3,5,2,3,3
S01013264,Fair health,16,4,2,2,4,0,2,0,2,3,1,1,0,0
S01013264,Bad health,9,1,0,1,2,3,1,0,0,0,2,2,0,0
S01013264,Very bad health,1,1,0,1,0,0,0,0,0,0,0,0,0,0
S01013265,All people aged 16 to 74,478,99,21,78,141,70,41,15,31,14,12,7,5,55
S01013265,Very good health,311,65,13,52,96,46,25,9,15,8,3,2,1,44
S01013265,Good health,143,31,7,24,42,18,13,6,13,4,6,3,3,10
S01013265,Fair health,17,3,1,2,2,3,2,0,1,2,3,2,1,1
S01013265,Bad health,5,0,0,0,1,2,1,0,1,0,0,0,0,0
S01013265,Very bad health,2,0,0,0,0,1,0,0,1,0,0,0,0,0
S01013266,All people aged 16 to 74,415,78,12,66,106,77,26,26,37,22,8,4,4,35
S01013266,Very good health,276,53,7,46,69,56,15,12,26,9,7,3,4,29
S01013266,Good health,110,21,4,17,32,18,9,10,8,7,0,0,0,5
S01013266,Fair health,21,4,1,3,2,3,1,4,1,6,0,0,0,0
S01013266,Bad health,7,0,0,0,3,0,1,0,2,0,0,0,0,1
S01013266,Very bad health,1,0,0,0,0,0,0,0,0,0,1,1,0,0
S01013267,All people aged 16 to 74,408,28,8,20,78,62,27,27,75,53,28,21,7,30
S01013267,Very good health,203,19,5,14,44,24,15,14,37,18,7,3,4,25
S01013267,Good health,115,8,3,5,22,26,6,7,21,17,4,3,1,4
S01013267,Fair health,63,1,0,1,12,9,6,2,9,11,13,11,2,0
S01013267,Bad health,17,0,0,0,0,2,0,2,4,6,3,3,0,0
S01013267,Very bad health,10,0,0,0,0,1,0,2,4,1,1,1,0,1
S01013268,All people aged 16 to 74,613,29,5,24,126,102,34,68,112,83,21,12,9,38
S01013268,Very good health,283,13,1,12,62,54,18,29,38,31,8,4,4,30
S01013268,Good health,212,12,3,9,44,33,15,24,45,27,6,3,3,6
S01013268,Fair health,90,4,1,3,18,9,1,12,24,15,6,5,1,1
S01013268,Bad health,21,0,0,0,2,6,0,2,2,7,1,0,1,1
S01013268,Very bad health,7,0,0,0,0,0,0,1,3,3,0,0,0,0
S01013269,All people aged 16 to 74,730,103,19,84,215,119,48,42,72,59,16,8,8,56
S01013269,Very good health,434,67,9,58,119,73,28,21,38,36,9,4,5,43
S01013269,Good health,229,33,9,24,78,31,15,18,21,18,5,2,3,10
S01013269,Fair health,52,2,1,1,15,11,3,2,10,5,2,2,0,2
S01013269,Bad health,14,1,0,1,3,4,2,1,3,0,0,0,0,0
S01013269,Very bad health,1,0,0,0,0,0,0,0,0,0,0,0,0,1
S01013270,All people aged 16 to 74,593,133,31,102,174,106,38,25,44,20,7,4,3,46
S01013270,Very good health,373,83,19,64,105,72,20,13,26,9,6,4,2,39
S01013270,Good health,166,39,10,29,52,29,12,11,10,6,1,0,1,6
S01013270,Fair health,44,10,2,8,15,4,6,1,5,2,0,0,0,1
S01013270,Bad health,8,0,0,0,2,1,0,0,2,3,0,0,0,0
S01013270,Very bad health,2,1,0,1,0,0,0,0,1,0,0,0,0,0
S01013271,All people aged 16 to 74,469,112,24,88,153,87,24,22,27,16,7,5,2,21
S01013271,Very good health,249,62,16,46,83,39,8,12,13,11,3,2,1,18
S01013271,Good health,162,39,3,36,52,34,14,4,11,4,1,1,0,3
S01013271,Fair health,43,7,4,3,14,10,2,4,2,1,3,2,1,0
S01013271,Bad health,11,4,1,3,3,2,0,1,1,0,0,0,0,0
S01013271,Very bad health,4,0,0,0,1,2,0,1,0,0,0,0,0,0
S01013272,All people aged 16 to 74,553,109,22,87,178,80,38,19,42,26,10,3,7,51
S01013272,Very good health,346,63,13,50,110,48,19,13,27,17,6,1,5,43
S01013272,Good health,173,39,8,31,58,29,18,3,12,6,1,1,0,7
S01013272,Fair health,24,5,1,4,7,3,0,2,2,1,3,1,2,1
S01013272,Bad health,7,2,0,2,2,0,1,1,0,1,0,0,0,0
S01013272,Very bad health,3,0,0,0,1,0,0,0,1,1,0,0,0,0
S01013273,All people aged 16 to 74,635,127,22,105,177,112,51,41,50,27,5,2,3,45
S01013273,Very good health,422,88,19,69,119,65,35,29,33,10,4,2,2,39
S01013273,Good health,165,31,3,28,53,34,11,7,11,13,0,0,0,5
S01013273,Fair health,35,6,0,6,4,10,4,4,2,3,1,0,1,1
S01013273,Bad health,10,1,0,1,1,2,1,1,3,1,0,0,0,0
S01013273,Very bad health,3,1,0,1,0,1,0,0,1,0,0,0,0,0
S01013274,All people aged 16 to 74,651,78,22,56,161,133,35,55,77,46,17,10,7,49
S01013274,Very good health,362,46,12,34,82,79,22,28,33,22,9,4,5,41
S01013274,Good health,202,27,9,18,57,41,8,18,25,17,2,2,0,7
S01013274,Fair health,59,3,1,2,13,10,3,7,12,6,4,2,2,1
S01013274,Bad health,20,2,0,2,7,2,1,2,4,1,1,1,0,0
S01013274,Very bad health,8,0,0,0,2,1,1,0,3,0,1,1,0,0
S01013275,All people aged 16 to 74,508,62,11,51,122,100,61,29,53,40,5,5,0,36
S01013275,Very good health,276,27,6,21,71,63,34,14,26,11,2,2,0,28
S01013275,Good health,173,25,5,20,40,25,22,11,21,20,3,3,0,6
S01013275,Fair health,50,8,0,8,8,11,4,4,5,8,0,0,0,2
S01013275,Bad health,8,1,0,1,3,1,1,0,1,1,0,0,0,0
S01013275,Very bad health,1,1,0,1,0,0,0,0,0,0,0,0,0,0
S01013276,All people aged 16 to 74,488,45,10,35,111,109,32,39,63,41,11,4,7,37
S01013276,Very good health,259,25,6,19,59,55,13,20,33,18,6,0,6,30
S01013276,Good health,166,17,4,13,37,34,16,15,21,16,3,2,1,7
S01013276,Fair health,49,3,0,3,10,17,3,4,5,6,1,1,0,0
S01013276,Bad health,12,0,0,0,4,2,0,0,4,1,1,1,0,0
S01013276,Very bad health,2,0,0,0,1,1,0,0,0,0,0,0,0,0
S01013277,All people aged 16 to 74,681,26,9,17,111,87,31,79,152,114,28,16,12,53
S01013277,Very good health,302,13,2,11,51,36,12,36,60,47,8,6,2,39
S01013277,Good health,224,10,5,5,41,36,13,25,48,32,9,3,6,10
S01013277,Fair health,95,2,2,0,10,9,3,10,29,20,9,6,3,3
S01013277,Bad health,46,1,0,1,5,6,2,7,13,9,2,1,1,1
S01013277,Very bad health,14,0,0,0,4,0,1,1,2,6,0,0,0,0
S01013278,All people aged 16 to 74,607,17,9,8,73,94,33,58,128,113,45,21,24,46
S01013278,Very good health,252,6,3,3,32,38,15,27,48,42,10,3,7,34
S01013278,Good health,191,5,1,4,23,39,8,16,41,33,19,7,12,7
S01013278,Fair health,102,5,4,1,12,10,8,8,23,22,12,8,4,2
S01013278,Bad health,49,1,1,0,4,6,2,5,13,11,4,3,1,3
S01013278,Very bad health,13,0,0,0,2,1,0,2,3,5,0,0,0,0
S01013279,All people aged 16 to 74,527,19,7,12,65,72,21,47,119,95,40,27,13,49
S01013279,Very good health,237,10,4,6,34,34,7,19,36,32,22,12,10,43
S01013279,Good health,176,5,2,3,21,27,6,12,48,41,11,8,3,5
S01013279,Fair health,69,3,0,3,4,9,6,11,23,10,2,2,0,1
S01013279,Bad health,37,1,1,0,4,2,2,4,10,9,5,5,0,0
S01013279,Very bad health,8,0,0,0,2,0,0,1,2,3,0,0,0,0
S01013280,All people aged 16 to 74,412,21,4,17,81,88,22,27,78,58,6,3,3,31
S01013280,Very good health,198,15,3,12,37,42,16,11,31,27,1,1,0,18
S01013280,Good health,143,6,1,5,29,32,5,8,26,23,3,0,3,11
S01013280,Fair health,48,0,0,0,9,7,1,5,17,6,1,1,0,2
S01013280,Bad health,21,0,0,0,6,7,0,2,4,2,0,0,0,0
S01013280,Very bad health,2,0,0,0,0,0,0,1,0,0,1,1,0,0
S01013281,All people aged 16 to 74,677,27,4,23,83,93,42,61,152,142,30,22,8,47
S01013281,Very good health,301,16,2,14,41,41,15,15,66,60,14,12,2,33
S01013281,Good health,234,10,1,9,27,40,18,28,46,45,8,4,4,12
S01013281,Fair health,95,0,0,0,10,9,8,11,29,20,6,4,2,2
S01013281,Bad health,33,1,1,0,3,2,1,6,10,9,1,1,0,0
S01013281,Very bad health,14,0,0,0,2,1,0,1,1,8,1,1,0,0
S01013282,All people aged 16 to 74,611,13,3,10,69,93,20,67,139,116,57,29,28,37
S01013282,Very good health,274,6,1,5,43,43,13,22,53,44,27,14,13,23
S01013282,Good health,213,4,1,3,19,42,5,23,53,41,15,4,11,11
S01013282,Fair health,84,2,1,1,4,2,2,13,26,24,10,6,4,1
S01013282,Bad health,29,1,0,1,1,5,0,7,5,6,3,3,0,1
S01013282,Very bad health,11,0,0,0,2,1,0,2,2,1,2,2,0,1
S01013283,All people aged 16 to 74,524,56,3,53,83,71,29,47,99,77,27,21,6,35
S01013283,Very good health,247,40,2,38,46,36,9,22,31,29,12,7,5,22
S01013283,Good health,193,12,1,11,34,29,10,17,43,32,7,6,1,9
S01013283,Fair health,62,4,0,4,3,4,7,6,20,8,6,6,0,4
S01013283,Bad health,19,0,0,0,0,2,3,2,3,7,2,2,0,0
S01013283,Very bad health,3,0,0,0,0,0,0,0,2,1,0,0,0,0
S01013284,All people aged 16 to 74,516,45,7,38,137,116,28,35,74,45,5,2,3,31
S01013284,Very good health,290,22,2,20,82,71,11,8,46,26,2,1,1,22
S01013284,Good health,178,18,2,16,46,34,13,20,21,18,2,1,1,6
S01013284,Fair health,40,5,3,2,7,8,3,6,6,1,1,0,1,3
S01013284,Bad health,8,0,0,0,2,3,1,1,1,0,0,0,0,0
S01013284,Very bad health,0,0,0,0,0,0,0,0,0,0,0,0,0,0
S01013285,All people aged 16 to 74,522,48,5,43,121,110,18,50,76,53,5,2,3,41
S01013285,Very good health,278,23,3,20,68,59,9,28,36,14,3,1,2,38
S01013285,Good health,174,19,0,19,39,36,6,17,26,27,1,1,0,3
S01013285,Fair health,50,4,1,3,10,10,2,2,10,11,1,0,1,0
S01013285,Bad health,16,2,1,1,3,5,1,2,2,1,0,0,0,0
S01013285,Very bad health,4,0,0,0,1,0,0,1,2,0,0,0,0,0
S01013286,All people aged 16 to 74,534,48,5,43,136,101,32,50,74,45,5,3,2,43
S01013286,Very good health,275,28,1,27,64,53,20,24,29,17,1,0,1,39
S01013286,Good health,188,14,3,11,59,36,7,16,34,18,1,1,0,3
S01013286,Fair health,54,6,1,5,8,10,3,8,9,7,2,2,0,1
S01013286,Bad health,14,0,0,0,5,1,2,2,2,1,1,0,1,0
S01013286,Very bad health,3,0,0,0,0,1,0,0,0,2,0,0,0,0
S01013287,All people aged 16 to 74,618,102,16,86,184,110,37,37,50,30,2,1,1,66
S01013287,Very good health,370,64,9,55,111,64,13,20,26,17,1,1,0,54
S01013287,Good health,201,35,7,28,58,33,19,15,18,11,1,0,1,11
S01013287,Fair health,39,2,0,2,11,12,5,2,4,2,0,0,0,1
S01013287,Bad health,7,1,0,1,3,1,0,0,2,0,0,0,0,0
S01013287,Very bad health,1,0,0,0,1,0,0,0,0,0,0,0,0,0
S01013288,All people aged 16 to 74,482,59,13,46,103,94,33,36,57,47,19,14,5,34
S01013288,Very good health,246,41,9,32,63,39,17,17,20,14,7,4,3,28
S01013288,Good health,156,15,4,11,22,38,12,12,24,22,5,4,1,6
S01013288,Fair health,61,3,0,3,15,13,3,4,9,9,5,4,1,0
S01013288,Bad health,19,0,0,0,3,4,1,3,4,2,2,2,0,0
S01013288,Very bad health,0,0,0,0,0,0,0,0,0,0,0,0,0,0
S01013289,All people aged 16 to 74,562,93,16,77,141,83,71,28,61,41,13,8,5,31
S01013289,Very good health,323,60,10,50,82,42,41,10,34,19,7,4,3,28
S01013289,Good health,185,28,5,23,49,29,24,10,20,17,5,3,2,3
S01013289,Fair health,44,4,1,3,8,10,6,5,6,4,1,1,0,0
S01013289,Bad health,8,1,0,1,1,2,0,2,1,1,0,0,0,0
S01013289,Very bad health,2,0,0,0,1,0,0,1,0,0,0,0,0,0
S01013290,All people aged 16 to 74,655,69,13,56,142,102,40,48,107,82,27,12,15,38
S01013290,Very good health,377,50,9,41,86,61,21,28,57,28,12,5,7,34
S01013290,Good health,188,17,3,14,46,22,16,12,32,30,9,4,5,4
S01013290,Fair health,66,2,1,1,7,16,3,4,10,21,3,0,3,0
S01013290,Bad health,20,0,0,0,2,2,0,3,8,3,2,2,0,0
S01013290,Very bad health,4,0,0,0,1,1,0,1,0,0,1,1,0,0
S01013291,All people aged 16 to 74,522,41,8,33,107,88,43,52,80,65,11,3,8,35
S01013291,Very good health,281,26,6,20,64,40,17,23,41,32,6,3,3,32
S01013291,Good health,169,9,0,9,35,27,22,21,28,21,4,0,4,2
S01013291,Fair health,53,6,2,4,7,17,1,7,6,7,1,0,1,1
S01013291,Bad health,15,0,0,0,1,3,3,1,4,3,0,0,0,0
S01013291,Very bad health,4,0,0,0,0,1,0,0,1,2,0,0,0,0
S01013292,All people aged 16 to 74,602,38,10,28,118,120,44,61,85,69,17,5,12,50
S01013292,Very good health,353,25,6,19,80,67,19,29,48,34,12,3,9,39
S01013292,Good health,190,11,4,7,31,42,16,26,28,22,3,1,2,11
S01013292,Fair health,43,1,0,1,5,8,7,4,7,10,1,0,1,0
S01013292,Bad health,11,0,0,0,2,3,1,1,1,2,1,1,0,0
S01013292,Very bad health,5,1,0,1,0,0,1,1,1,1,0,0,0,0
S01013293,All people aged 16 to 74,559,62,10,52,136,110,56,35,69,35,3,1,2,53
S01013293,Very good health,316,39,7,32,78,58,24,19,35,15,1,1,0,47
S01013293,Good health,182,18,2,16,42,45,21,10,23,16,2,0,2,5
S01013293,Fair health,45,3,1,2,10,6,9,4,9,3,0,0,0,1
S01013293,Bad health,14,2,0,2,5,1,2,2,1,1,0,0,0,0
S01013293,Very bad health,2,0,0,0,1,0,0,0,1,0,0,0,0,0
S01013294,All people aged 16 to 74,573,50,7,43,111,117,33,57,76,67,13,10,3,49
S01013294,Very good health,288,30,4,26,63,55,18,31,29,25,4,3,1,33
S01013294,Good health,207,16,3,13,35,52,10,14,34,24,6,4,2,16
S01013294,Fair health,61,4,0,4,9,10,4,8,10,14,2,2,0,0
S01013294,Bad health,14,0,0,0,3,0,0,3,3,4,1,1,0,0
S01013294,Very bad health,3,0,0,0,1,0,1,1,0,0,0,0,0,0
S01013295,All people aged 16 to 74,609,44,7,37,123,140,45,62,85,54,13,11,2,43
S01013295,Very good health,343,30,4,26,76,72,23,33,37,32,3,2,1,37
S01013295,Good health,188,11,2,9,36,38,19,21,33,18,6,5,1,6
S01013295,Fair health,68,3,1,2,8,25,3,7,15,3,4,4,0,0
S01013295,Bad health,9,0,0,0,3,4,0,1,0,1,0,0,0,0
S01013295,Very bad health,1,0,0,0,0,1,0,0,0,0,0,0,0,0
S01013296,All people aged 16 to 74,534,19,4,15,60,70,34,57,107,128,27,14,13,32
S01013296,Very good health,224,9,1,8,27,37,15,28,40,39,12,7,5,17
S01013296,Good health,194,7,2,5,26,24,11,11,46,48,9,5,4,12
S01013296,Fair health,77,3,1,2,4,7,7,7,11,30,5,1,4,3
S01013296,Bad health,26,0,0,0,3,2,0,8,6,6,1,1,0,0
S01013296,Very bad health,13,0,0,0,0,0,1,3,4,5,0,0,0,0
S01013297,All people aged 16 to 74,524,37,10,27,82,96,35,57,91,64,21,13,8,41
S01013297,Very good health,253,19,8,11,38,46,16,29,31,37,6,3,3,31
S01013297,Good health,187,12,1,11,28,36,16,23,40,16,7,4,3,9
S01013297,Fair health,58,3,1,2,14,10,3,3,14,9,2,1,1,0
S01013297,Bad health,24,3,0,3,2,4,0,2,6,2,5,4,1,0
S01013297,Very bad health,2,0,0,0,0,0,0,0,0,0,1,1,0,1
S01013298,All people aged 16 to 74,505,34,6,28,99,86,43,51,67,74,25,20,5,26
S01013298,Very good health,230,17,3,14,58,31,18,24,29,27,11,10,1,15
S01013298,Good health,178,11,1,10,23,41,19,18,24,24,7,5,2,11
S01013298,Fair health,69,4,1,3,16,8,6,5,13,11,6,4,2,0
S01013298,Bad health,24,2,1,1,2,5,0,4,1,9,1,1,0,0
S01013298,Very bad health,4,0,0,0,0,1,0,0,0,3,0,0,0,0
S01013299,All people aged 16 to 74,763,41,9,32,153,122,38,76,134,113,29,15,14,57
S01013299,Very good health,394,28,8,20,88,63,19,31,62,45,9,7,2,49
S01013299,Good health,236,11,1,10,43,45,13,23,44,42,8,1,7,7
S01013299,Fair health,88,1,0,1,17,9,4,7,19,20,10,5,5,1
S01013299,Bad health,33,1,0,1,3,2,2,11,9,3,2,2,0,0
S01013299,Very bad health,12,0,0,0,2,3,0,4,0,3,0,0,0,0
S01013300,All people aged 16 to 74,445,25,5,20,81,52,26,44,96,84,17,10,7,20
S01013300,Very good health,199,18,5,13,43,20,14,15,33,34,5,2,3,17
S01013300,Good health,140,6,0,6,27,20,7,18,31,22,8,6,2,1
S01013300,Fair health,73,1,0,1,10,9,3,9,22,15,4,2,2,0
S01013300,Bad health,29,0,0,0,1,3,2,1,9,11,0,0,0,2
S01013300,Very bad health,4,0,0,0,0,0,0,1,1,2,0,0,0,0
S01013301,All people aged 16 to 74,373,15,5,10,50,50,25,46,79,73,23,16,7,12
S01013301,Very good health,147,10,2,8,29,16,12,15,24,27,5,2,3,9
S01013301,Good health,140,3,2,1,18,27,8,18,28,31,5,4,1,2
S01013301,Fair health,61,1,1,0,3,4,5,11,16,10,10,7,3,1
S01013301,Bad health,19,1,0,1,0,3,0,2,8,3,2,2,0,0
S01013301,Very bad health,6,0,0,0,0,0,0,0,3,2,1,1,0,0
S01013302,All people aged 16 to 74,481,44,7,37,90,82,54,47,64,60,13,6,7,27
S01013302,Very good health,259,33,4,29,45,45,27,20,26,33,6,2,4,24
S01013302,Good health,159,10,3,7,39,28,17,24,22,13,3,0,3,3
S01013302,Fair health,45,0,0,0,5,7,8,2,11,8,4,4,0,0
S01013302,Bad health,10,0,0,0,1,1,1,1,2,4,0,0,0,0
S01013302,Very bad health,8,1,0,1,0,1,1,0,3,2,0,0,0,0
S01013303,All people aged 16 to 74,679,56,13,43,141,116,34,51,103,129,14,10,4,35
S01013303,Very good health,307,25,5,20,70,41,16,20,42,55,7,6,1,31
S01013303,Good health,239,19,7,12,44,53,12,18,40,46,4,2,2,3
S01013303,Fair health,88,8,0,8,18,15,0,7,17,19,3,2,1,1
S01013303,Bad health,33,3,1,2,5,6,6,4,2,7,0,0,0,0
S01013303,Very bad health,12,1,0,1,4,1,0,2,2,2,0,0,0,0
S01013304,All people aged 16 to 74,710,21,1,20,80,78,22,77,157,169,51,27,24,55
S01013304,Very good health,273,10,0,10,32,39,5,32,42,54,22,13,9,37
S01013304,Good health,290,7,1,6,35,23,11,29,78,75,16,5,11,16
S01013304,Fair health,87,4,0,4,6,9,5,10,20,24,7,5,2,2
S01013304,Bad health,44,0,0,0,6,5,1,4,15,7,6,4,2,0
S01013304,Very bad health,16,0,0,0,1,2,0,2,2,9,0,0,0,0
S01013305,All people aged 16 to 74,740,24,9,15,98,115,29,61,147,185,41,27,14,40
S01013305,Very good health,313,11,3,8,48,48,15,29,55,63,13,9,4,31
S01013305,Good health,254,7,3,4,28,49,8,24,54,65,12,7,5,7
S01013305,Fair health,117,2,1,1,18,13,4,3,29,35,11,7,4,2
S01013305,Bad health,44,2,1,1,3,4,2,5,6,17,5,4,1,0
S01013305,Very bad health,12,2,1,1,1,1,0,0,3,5,0,0,0,0
S01013306,All people aged 16 to 74,742,13,6,7,60,82,34,59,179,178,97,55,42,40
S01013306,Very good health,269,5,3,2,22,33,12,23,59,63,27,14,13,25
S01013306,Good health,269,5,2,3,24,36,11,20,60,62,42,25,17,9
S01013306,Fair health,121,3,1,2,8,9,10,8,29,31,17,7,10,6
S01013306,Bad health,67,0,0,0,5,2,1,7,24,18,10,8,2,0
S01013306,Very bad health,16,0,0,0,1,2,0,1,7,4,1,1,0,0
S01013307,All people aged 16 to 74,792,23,7,16,77,85,26,81,169,204,81,48,33,46
S01013307,Very good health,310,12,3,9,34,29,12,36,59,68,29,17,12,31
S01013307,Good health,320,8,3,5,36,34,9,32,78,81,30,16,14,12
S01013307,Fair health,108,3,1,2,6,16,3,8,20,32,17,11,6,3
S01013307,Bad health,41,0,0,0,0,3,2,4,11,16,5,4,1,0
S01013307,Very bad health,13,0,0,0,1,3,0,1,1,7,0,0,0,0
S01013308,All people aged 16 to 74,653,19,2,17,47,85,28,61,161,141,57,39,18,54
S01013308,Very good health,252,8,1,7,28,38,11,25,49,44,17,13,4,32
S01013308,Good health,248,7,1,6,16,28,11,23,66,64,17,9,8,16
S01013308,Fair health,104,2,0,2,1,13,4,10,36,18,14,11,3,6
S01013308,Bad health,41,1,0,1,2,5,2,1,10,12,8,5,3,0
S01013308,Very bad health,8,1,0,1,0,1,0,2,0,3,1,1,0,0
S01013309,All people aged 16 to 74,476,68,15,53,112,79,27,28,56,50,23,19,4,33
S01013309,Very good health,244,33,7,26,67,38,11,13,22,22,11,9,2,27
S01013309,Good health,164,27,5,22,31,28,13,12,20,21,6,5,1,6
S01013309,Fair health,51,6,2,4,13,10,2,3,8,6,3,2,1,0
S01013309,Bad health,11,2,1,1,1,2,1,0,3,0,2,2,0,0
S01013309,Very bad health,6,0,0,0,0,1,0,0,3,1,1,1,0,0
S01013310,All people aged 16 to 74,483,23,3,20,82,76,15,55,102,82,21,11,10,27
S01013310,Very good health,232,14,2,12,38,36,5,30,46,36,10,3,7,17
S01013310,Good health,163,4,1,3,29,32,5,17,36,27,5,3,2,8
S01013310,Fair health,64,5,0,5,13,6,2,5,16,11,4,3,1,2
S01013310,Bad health,22,0,0,0,2,2,3,2,4,7,2,2,0,0
S01013310,Very bad health,2,0,0,0,0,0,0,1,0,1,0,0,0,0
S01013311,All people aged 16 to 74,605,18,3,15,75,89,36,63,134,115,31,20,11,44
S01013311,Very good health,250,9,1,8,32,44,11,25,48,42,12,7,5,27
S01013311,Good health,218,7,2,5,33,29,15,25,47,36,12,7,5,14
S01013311,Fair health,85,2,0,2,7,11,6,4,24,23,7,6,1,1
S01013311,Bad health,42,0,0,0,3,5,1,7,13,11,0,0,0,2
S01013311,Very bad health,10,0,0,0,0,0,3,2,2,3,0,0,0,0
S01013312,All people aged 16 to 74,788,22,4,18,112,110,47,70,152,177,52,31,21,46
S01013312,Very good health,322,10,2,8,49,60,22,32,50,49,17,10,7,33
S01013312,Good health,282,8,1,7,36,36,15,25,63,72,18,8,10,9
S01013312,Fair health,126,2,0,2,19,9,6,8,27,41,10,6,4,4
S01013312,Bad health,48,2,1,1,6,4,3,4,10,13,6,6,0,0
S01013312,Very bad health,10,0,0,0,2,1,1,1,2,2,1,1,0,0
S01013313,All people aged 16 to 74,509,17,5,12,70,76,19,40,106,105,41,33,8,35
S01013313,Very good health,234,9,3,6,32,34,10,14,50,41,19,15,4,25
S01013313,Good health,179,5,1,4,26,27,5,17,36,45,10,9,1,8
S01013313,Fair health,66,2,1,1,8,8,3,5,16,18,4,2,2,2
S01013313,Bad health,28,0,0,0,4,6,1,4,4,1,8,7,1,0
S01013313,Very bad health,2,1,0,1,0,1,0,0,0,0,0,0,0,0
S01013314,All people aged 16 to 74,495,21,7,14,63,86,23,55,104,94,14,7,7,35
S01013314,Very good health,202,10,2,8,30,27,11,25,36,35,5,4,1,23
S01013314,Good health,167,9,4,5,23,35,5,15,37,29,6,3,3,8
S01013314,Fair health,86,2,1,1,7,19,6,9,21,18,3,0,3,1
S01013314,Bad health,28,0,0,0,3,3,0,6,7,8,0,0,0,1
S01013314,Very bad health,12,0,0,0,0,2,1,0,3,4,0,0,0,2
S01013315,All people aged 16 to 74,379,84,21,63,117,50,26,16,35,20,5,5,0,26
S01013315,Very good health,254,58,16,42,78,30,21,6,27,9,1,1,0,24
S01013315,Good health,106,22,4,18,30,20,5,9,7,8,3,3,0,2
S01013315,Fair health,16,4,1,3,9,0,0,1,0,2,0,0,0,0
S01013315,Bad health,3,0,0,0,0,0,0,0,1,1,1,1,0,0
S01013315,Very bad health,0,0,0,0,0,0,0,0,0,0,0,0,0,0
S01013316,All people aged 16 to 74,498,71,19,52,127,94,30,36,65,31,14,12,2,30
S01013316,Very good health,218,28,8,20,55,44,9,11,26,16,6,4,2,23
S01013316,Good health,192,34,8,26,53,30,16,12,25,13,5,5,0,4
S01013316,Fair health,66,9,3,6,14,14,4,11,10,0,1,1,0,3
S01013316,Bad health,15,0,0,0,3,4,1,1,3,1,2,2,0,0
S01013316,Very bad health,7,0,0,0,2,2,0,1,1,1,0,0,0,0
S01013317,All people aged 16 to 74,430,28,6,22,101,91,23,35,68,50,6,2,4,28
S01013317,Very good health,206,15,3,12,45,41,9,16,31,21,4,2,2,24
S01013317,Good health,155,11,3,8,43,38,10,13,15,19,2,0,2,4
S01013317,Fair health,48,2,0,2,9,9,2,1,17,8,0,0,0,0
S01013317,Bad health,18,0,0,0,2,3,2,5,4,2,0,0,0,0
S01013317,Very bad health,3,0,0,0,2,0,0,0,1,0,0,0,0,0
S01013318,All people aged 16 to 74,466,64,13,51,126,78,20,36,61,50,8,6,2,23
S01013318,Very good health,273,40,6,34,85,38,12,21,34,19,2,1,1,22
S01013318,Good health,146,21,6,15,32,28,4,11,21,25,3,3,0,1
S01013318,Fair health,35,1,0,1,6,10,3,2,4,6,3,2,1,0
S01013318,Bad health,11,2,1,1,3,2,0,2,2,0,0,0,0,0
S01013318,Very bad health,1,0,0,0,0,0,1,0,0,0,0,0,0,0
S01013319,All people aged 16 to 74,422,55,13,42,102,72,27,35,54,29,20,16,4,28
S01013319,Very good health,216,34,8,26,53,42,10,14,24,10,6,4,2,23
S01013319,Good health,145,15,4,11,42,25,13,16,14,9,7,6,1,4
S01013319,Fair health,34,4,1,3,5,4,0,2,7,5,6,5,1,1
S01013319,Bad health,23,2,0,2,1,1,3,3,8,4,1,1,0,0
S01013319,Very bad health,4,0,0,0,1,0,1,0,1,1,0,0,0,0
S01013320,All people aged 16 to 74,726,101,16,85,203,115,42,58,82,59,16,12,4,50
S01013320,Very good health,425,65,11,54,120,70,26,22,44,30,8,6,2,40
S01013320,Good health,239,31,5,26,71,33,16,29,23,22,5,5,0,9
S01013320,Fair health,50,5,0,5,11,8,0,6,12,5,2,1,1,1
S01013320,Bad health,8,0,0,0,1,3,0,1,1,1,1,0,1,0
S01013320,Very bad health,4,0,0,0,0,1,0,0,2,1,0,0,0,0
S01013321,All people aged 16 to 74,331,10,2,8,67,59,16,41,39,63,23,12,11,13
S01013321,Very good health,130,6,1,5,24,31,3,16,14,21,7,1,6,8
S01013321,Good health,125,4,1,3,34,20,8,15,9,20,10,8,2,5
S01013321,Fair health,43,0,0,0,4,4,5,5,10,11,4,1,3,0
S01013321,Bad health,21,0,0,0,4,3,0,3,6,4,1,1,0,0
S01013321,Very bad health,12,0,0,0,1,1,0,2,0,7,1,1,0,0
S01013322,All people aged 16 to 74,556,27,5,22,100,111,24,48,103,70,16,12,4,57
S01013322,Very good health,267,14,4,10,50,45,10,29,42,23,7,5,2,47
S01013322,Good health,194,11,1,10,34,48,7,12,38,32,4,2,2,8
S01013322,Fair health,61,2,0,2,6,12,5,5,16,11,2,2,0,2
S01013322,Bad health,29,0,0,0,10,6,1,1,4,4,3,3,0,0
S01013322,Very bad health,5,0,0,0,0,0,1,1,3,0,0,0,0,0
S01013323,All people aged 16 to 74,738,38,7,31,111,107,34,70,141,143,40,21,19,54
S01013323,Very good health,306,23,5,18,58,43,10,30,52,46,9,3,6,35
S01013323,Good health,253,11,0,11,33,35,18,22,52,48,17,9,8,17
S01013323,Fair health,115,3,2,1,13,19,5,10,25,26,12,7,5,2
S01013323,Bad health,52,1,0,1,6,8,0,7,8,20,2,2,0,0
S01013323,Very bad health,12,0,0,0,1,2,1,1,4,3,0,0,0,0
S01013324,All people aged 16 to 74,481,18,7,11,63,61,19,40,113,93,43,21,22,31
S01013324,Very good health,194,5,1,4,29,28,5,12,46,35,9,3,6,25
S01013324,Good health,176,6,3,3,21,24,4,18,37,38,22,8,14,6
S01013324,Fair health,70,4,1,3,10,7,8,8,14,13,6,4,2,0
S01013324,Bad health,31,3,2,1,2,2,2,2,12,4,4,4,0,0
S01013324,Very bad health,10,0,0,0,1,0,0,0,4,3,2,2,0,0
S01013325,All people aged 16 to 74,641,32,8,24,88,73,24,56,124,122,68,51,17,54
S01013325,Very good health,243,19,4,15,49,28,7,12,41,37,14,8,6,36
S01013325,Good health,212,10,2,8,24,23,14,19,42,38,30,23,7,12
S01013325,Fair health,102,2,1,1,10,14,1,11,22,21,17,13,4,4
S01013325,Bad health,61,0,0,0,2,8,2,8,15,20,4,4,0,2
S01013325,Very bad health,23,1,1,0,3,0,0,6,4,6,3,3,0,0
S01013326,All people aged 16 to 74,409,12,1,11,38,49,21,33,104,99,24,17,7,29
S01013326,Very good health,186,9,1,8,19,18,6,14,45,44,9,6,3,22
S01013326,Good health,139,2,0,2,12,23,11,14,35,27,8,5,3,7
S01013326,Fair health,55,0,0,0,4,6,2,4,17,18,4,3,1,0
S01013326,Bad health,21,0,0,0,3,2,2,0,6,6,2,2,0,0
S01013326,Very bad health,8,1,0,1,0,0,0,1,1,4,1,1,0,0
S01013327,All people aged 16 to 74,529,13,3,10,48,67,27,58,121,119,35,25,10,41
S01013327,Very good health,234,5,2,3,24,35,13,29,46,40,13,10,3,29
S01013327,Good health,189,6,1,5,16,23,11,19,51,42,11,6,5,10
S01013327,Fair health,72,1,0,1,5,9,3,5,15,27,5,4,1,2
S01013327,Bad health,28,1,0,1,1,0,0,4,8,9,5,4,1,0
S01013327,Very bad health,6,0,0,0,2,0,0,1,1,1,1,1,0,0
S01013328,All people aged 16 to 74,465,11,2,9,45,56,19,58,112,111,28,19,9,25
S01013328,Very good health,198,6,0,6,25,22,6,26,46,34,13,10,3,20
S01013328,Good health,168,3,1,2,15,22,7,17,43,50,8,4,4,3
S01013328,Fair health,64,1,1,0,5,6,6,8,13,18,5,5,0,2
S01013328,Bad health,32,1,0,1,0,6,0,4,10,9,2,0,2,0
S01013328,Very bad health,3,0,0,0,0,0,0,3,0,0,0,0,0,0
S01013329,All people aged 16 to 74,402,10,3,7,72,47,16,34,100,72,17,12,5,34
S01013329,Very good health,149,5,0,5,34,14,3,10,37,23,5,4,1,18
S01013329,Good health,159,3,2,1,29,25,9,15,40,22,5,2,3,11
S01013329,Fair health,53,1,0,1,5,6,3,3,11,15,4,3,1,5
S01013329,Bad health,31,1,1,0,4,2,1,4,10,8,1,1,0,0
S01013329,Very bad health,10,0,0,0,0,0,0,2,2,4,2,2,0,0
S01013330,All people aged 16 to 74,807,94,17,77,201,147,38,64,106,88,17,8,9,52
S01013330,Very good health,466,60,10,50,122,85,23,36,56,44,6,3,3,34
S01013330,Good health,267,32,7,25,67,48,11,20,36,33,6,1,5,14
S01013330,Fair health,56,2,0,2,8,12,4,7,12,4,3,2,1,4
S01013330,Bad health,14,0,0,0,4,2,0,1,2,4,1,1,0,0
S01013330,Very bad health,4,0,0,0,0,0,0,0,0,3,1,1,0,0
S01013331,All people aged 16 to 74,475,52,9,43,98,95,30,37,62,56,18,12,6,27
S01013331,Very good health,286,29,4,25,65,58,19,18,31,34,8,5,3,24
S01013331,Good health,154,22,5,17,24,28,9,18,27,17,6,5,1,3
S01013331,Fair health,26,1,0,1,9,5,2,1,2,3,3,1,2,0
S01013331,Bad health,9,0,0,0,0,4,0,0,2,2,1,1,0,0
S01013331,Very bad health,0,0,0,0,0,0,0,0,0,0,0,0,0,0
S01013332,All people aged 16 to 74,499,18,2,16,80,79,31,42,101,97,17,8,9,34
S01013332,Very good health,199,10,1,9,34,27,11,15,33,35,7,3,4,27
S01013332,Good health,197,6,1,5,35,34,15,20,42,32,7,2,5,6
S01013332,Fair health,67,0,0,0,9,9,4,6,16,20,2,2,0,1
S01013332,Bad health,26,2,0,2,1,6,1,1,7,7,1,1,0,0
S01013332,Very bad health,10,0,0,0,1,3,0,0,3,3,0,0,0,0
S01013333,All people aged 16 to 74,622,49,7,42,141,112,35,60,92,82,14,7,7,37
S01013333,Very good health,302,30,5,25,72,56,15,32,41,25,7,2,5,24
S01013333,Good health,230,16,2,14,55,38,16,23,30,38,4,2,2,10
S01013333,Fair health,61,3,0,3,9,12,3,5,14,11,1,1,0,3
S01013333,Bad health,17,0,0,0,4,3,1,0,5,4,0,0,0,0
S01013333,Very bad health,12,0,0,0,1,3,0,0,2,4,2,2,0,0
S01013334,All people aged 16 to 74,555,21,3,18,75,75,26,55,116,118,36,23,13,33
S01013334,Very good health,234,7,0,7,35,28,8,18,51,40,22,14,8,25
S01013334,Good health,204,9,3,6,32,30,13,23,40,45,7,3,4,5
S01013334,Fair health,78,4,0,4,7,12,5,9,14,21,3,2,1,3
S01013334,Bad health,28,0,0,0,0,3,0,4,8,9,4,4,0,0
S01013334,Very bad health,11,1,0,1,1,2,0,1,3,3,0,0,0,0
S01013335,All people aged 16 to 74,560,10,2,8,50,76,31,44,133,127,47,24,23,42
S01013335,Very good health,239,7,1,6,17,30,17,18,54,51,21,13,8,24
S01013335,Good health,193,3,1,2,21,29,4,16,47,42,17,8,9,14
S01013335,Fair health,92,0,0,0,7,15,6,5,21,28,6,1,5,4
S01013335,Bad health,27,0,0,0,2,2,3,5,9,4,2,1,1,0
S01013335,Very bad health,9,0,0,0,3,0,1,0,2,2,1,1,0,0
S01013336,All people aged 16 to 74,648,14,4,10,79,67,35,48,136,155,69,42,27,45
S01013336,Very good health,274,7,2,5,42,26,9,29,45,59,26,15,11,31
S01013336,Good health,215,6,1,5,21,25,22,11,51,48,19,7,12,12
S01013336,Fair health,97,1,1,0,7,11,4,6,27,26,14,11,3,1
S01013336,Bad health,43,0,0,0,4,3,0,2,8,17,8,7,1,1
S01013336,Very bad health,19,0,0,0,5,2,0,0,5,5,2,2,0,0
S01013337,All people aged 16 to 74,732,59,17,42,160,125,50,61,94,115,27,14,13,41
S01013337,Very good health,342,29,7,22,83,49,28,28,43,45,6,4,2,31
S01013337,Good health,280,24,8,16,55,57,18,21,32,52,11,4,7,10
S01013337,Fair health,72,4,2,2,18,10,1,9,15,8,7,4,3,0
S01013337,Bad health,33,1,0,1,4,9,2,3,4,7,3,2,1,0
S01013337,Very bad health,5,1,0,1,0,0,1,0,0,3,0,0,0,0
S01013338,All people aged 16 to 74,381,59,12,47,119,60,26,19,28,20,12,10,2,38
S01013338,Very good health,263,40,7,33,79,42,20,12,20,14,9,9,0,27
S01013338,Good health,98,18,5,13,33,14,6,7,6,5,2,0,2,7
S01013338,Fair health,18,1,0,1,6,4,0,0,2,0,1,1,0,4
S01013338,Bad health,1,0,0,0,1,0,0,0,0,0,0,0,0,0
S01013338,Very bad health,1,0,0,0,0,0,0,0,0,1,0,0,0,0
S01013339,All people aged 16 to 74,456,64,13,51,116,91,25,38,52,27,11,4,7,32
S01013339,Very good health,245,36,5,31,59,46,14,20,30,13,3,2,1,24
S01013339,Good health,140,19,5,14,40,30,5,14,13,9,4,1,3,6
S01013339,Fair health,52,7,2,5,12,12,4,4,5,4,2,0,2,2
S01013339,Bad health,18,2,1,1,4,3,2,0,4,1,2,1,1,0
S01013339,Very bad health,1,0,0,0,1,0,0,0,0,0,0,0,0,0
S01013340,All people aged 16 to 74,656,87,22,65,155,133,48,57,70,45,12,10,2,49
S01013340,Very good health,343,46,12,34,74,64,28,30,31,23,6,5,1,41
S01013340,Good health,225,32,7,25,56,51,9,18,29,16,6,5,1,8
S01013340,Fair health,69,8,3,5,21,14,9,5,8,4,0,0,0,0
S01013340,Bad health,13,1,0,1,4,3,1,2,0,2,0,0,0,0
S01013340,Very bad health,6,0,0,0,0,1,1,2,2,0,0,0,0,0
S01013341,All people aged 16 to 74,701,134,34,100,217,103,60,33,65,40,18,8,10,31
S01013341,Very good health,398,91,19,72,129,53,33,12,33,17,3,1,2,27
S01013341,Good health,226,34,12,22,70,33,18,17,24,19,9,3,6,2
S01013341,Fair health,53,6,3,3,15,9,9,1,3,4,4,2,2,2
S01013341,Bad health,18,2,0,2,2,8,0,1,5,0,0,0,0,0
S01013341,Very bad health,6,1,0,1,1,0,0,2,0,0,2,2,0,0
S01013342,All people aged 16 to 74,475,11,3,8,57,65,14,49,111,109,37,28,9,22
S01013342,Very good health,189,7,2,5,21,23,4,17,50,40,13,9,4,14
S01013342,Good health,173,2,1,1,25,28,8,15,40,34,13,8,5,8
S01013342,Fair health,65,1,0,1,7,9,2,9,11,22,4,4,0,0
S01013342,Bad health,37,0,0,0,1,5,0,7,8,10,6,6,0,0
S01013342,Very bad health,11,1,0,1,3,0,0,1,2,3,1,1,0,0
S01013343,All people aged 16 to 74,504,21,4,17,94,90,25,37,88,103,16,11,5,30
S01013343,Very good health,220,11,2,9,35,40,10,14,44,39,5,3,2,22
S01013343,Good health,197,8,1,7,44,30,10,17,31,43,7,4,3,7
S01013343,Fair health,61,2,1,1,12,14,3,2,8,18,2,2,0,0
S01013343,Bad health,16,0,0,0,0,3,1,3,4,3,1,1,0,1
S01013343,Very bad health,10,0,0,0,3,3,1,1,1,0,1,1,0,0
S01013344,All people aged 16 to 74,593,13,3,10,79,80,30,69,108,134,39,30,9,41
S01013344,Very good health,229,8,1,7,27,38,11,26,34,51,9,5,4,25
S01013344,Good health,205,4,1,3,33,29,13,15,35,38,22,18,4,16
S01013344,Fair health,97,1,1,0,13,5,2,11,26,33,6,5,1,0
S01013344,Bad health,51,0,0,0,6,7,4,11,11,10,2,2,0,0
S01013344,Very bad health,11,0,0,0,0,1,0,6,2,2,0,0,0,0
S01013345,All people aged 16 to 74,548,13,3,10,73,74,17,57,107,138,31,15,16,38
S01013345,Very good health,254,8,2,6,36,40,7,29,42,48,13,5,8,31
S01013345,Good health,199,5,1,4,27,26,5,16,41,62,12,5,7,5
S01013345,Fair health,64,0,0,0,7,5,3,9,17,16,5,4,1,2
S01013345,Bad health,26,0,0,0,3,3,2,2,5,10,1,1,0,0
S01013345,Very bad health,5,0,0,0,0,0,0,1,2,2,0,0,0,0
S01013346,All people aged 16 to 74,616,85,22,63,147,104,30,43,86,41,17,10,7,63
S01013346,Very good health,366,44,14,30,97,59,14,21,47,25,9,5,4,50
S01013346,Good health,187,37,7,30,36,36,11,12,26,14,4,2,2,11
S01013346,Fair health,45,4,1,3,10,7,3,7,11,1,1,1,0,1
S01013346,Bad health,15,0,0,0,3,2,2,3,2,1,2,1,1,0
S01013346,Very bad health,3,0,0,0,1,0,0,0,0,0,1,1,0,1
S01013347,All people aged 16 to 74,560,42,7,35,140,117,37,46,71,69,15,5,10,23
S01013347,Very good health,271,19,1,18,74,61,17,21,31,25,7,1,6,16
S01013347,Good health,210,18,6,12,53,41,17,18,24,30,5,3,2,4
S01013347,Fair health,67,3,0,3,13,13,1,5,13,13,3,1,2,3
S01013347,Bad health,6,1,0,1,0,1,0,2,2,0,0,0,0,0
S01013347,Very bad health,6,1,0,1,0,1,2,0,1,1,0,0,0,0
S01013348,All people aged 16 to 74,338,45,10,35,97,68,29,21,29,19,2,2,0,28
S01013348,Very good health,193,27,4,23,59,40,17,10,15,5,0,0,0,20
S01013348,Good health,115,16,6,10,30,24,10,8,8,12,0,0,0,7
S01013348,Fair health,24,2,0,2,5,3,1,2,6,2,2,2,0,1
S01013348,Bad health,5,0,0,0,2,1,1,1,0,0,0,0,0,0
S01013348,Very bad health,1,0,0,0,1,0,0,0,0,0,0,0,0,0
S01013349,All people aged 16 to 74,611,75,12,63,133,88,26,48,80,97,28,22,6,36
S01013349,Very good health,348,40,6,34,82,55,14,23,44,51,14,11,3,25
S01013349,Good health,211,33,6,27,44,27,8,16,24,37,14,11,3,8
S01013349,Fair health,35,2,0,2,5,5,4,7,6,3,0,0,0,3
S01013349,Bad health,11,0,0,0,1,1,0,1,4,4,0,0,0,0
S01013349,Very bad health,6,0,0,0,1,0,0,1,2,2,0,0,0,0
S01013350,All people aged 16 to 74,506,19,3,16,84,77,27,53,104,92,23,12,11,27
S01013350,Very good health,235,10,2,8,38,33,15,26,50,36,6,4,2,21
S01013350,Good health,182,7,1,6,34,28,10,22,35,30,10,5,5,6
S01013350,Fair health,61,2,0,2,8,13,2,5,8,18,5,1,4,0
S01013350,Bad health,23,0,0,0,4,3,0,0,8,7,1,1,0,0
S01013350,Very bad health,5,0,0,0,0,0,0,0,3,1,1,1,0,0
S01013351,All people aged 16 to 74,596,40,15,25,103,117,22,66,106,87,20,11,9,35
S01013351,Very good health,257,21,9,12,51,48,7,27,41,31,6,5,1,25
S01013351,Good health,233,14,3,11,37,47,11,27,43,38,7,4,3,9
S01013351,Fair health,77,3,1,2,10,18,4,11,14,10,6,2,4,1
S01013351,Bad health,25,2,2,0,4,4,0,0,8,6,1,0,1,0
S01013351,Very bad health,4,0,0,0,1,0,0,1,0,2,0,0,0,0
S01013352,All people aged 16 to 74,674,25,5,20,113,130,34,55,131,111,26,14,12,49
S01013352,Very good health,287,12,3,9,53,54,17,24,45,39,7,3,4,36
S01013352,Good health,276,11,1,10,37,61,15,23,54,50,13,7,6,12
S01013352,Fair health,76,2,1,1,15,11,2,3,21,16,5,3,2,1
S01013352,Bad health,28,0,0,0,6,3,0,3,9,6,1,1,0,0
S01013352,Very bad health,7,0,0,0,2,1,0,2,2,0,0,0,0,0
S01013353,All people aged 16 to 74,488,14,2,12,72,73,30,47,92,96,36,25,11,28
S01013353,Very good health,214,8,2,6,35,31,19,22,31,38,11,9,2,19
S01013353,Good health,146,5,0,5,21,23,3,11,39,29,7,2,5,8
S01013353,Fair health,85,1,0,1,12,13,5,9,13,18,13,10,3,1
S01013353,Bad health,31,0,0,0,4,5,2,4,5,10,1,1,0,0
S01013353,Very bad health,12,0,0,0,0,1,1,1,4,1,4,3,1,0
S01013354,All people aged 16 to 74,555,43,18,25,123,90,40,60,89,77,12,8,4,21
S01013354,Very good health,253,27,11,16,64,41,22,23,39,20,4,2,2,13
S01013354,Good health,202,12,6,6,47,34,12,22,28,35,6,4,2,6
S01013354,Fair health,71,3,1,2,11,9,5,10,17,12,2,2,0,2
S01013354,Bad health,21,1,0,1,0,5,1,4,3,7,0,0,0,0
S01013354,Very bad health,8,0,0,0,1,1,0,1,2,3,0,0,0,0
S01013355,All people aged 16 to 74,482,34,4,30,83,64,35,48,80,91,17,9,8,30
S01013355,Very good health,232,21,1,20,45,34,14,23,36,33,5,1,4,21
S01013355,Good health,168,11,3,8,28,22,15,13,31,35,4,2,2,9
S01013355,Fair health,52,1,0,1,8,6,4,8,8,14,3,1,2,0
S01013355,Bad health,25,1,0,1,2,2,2,4,4,5,5,5,0,0
S01013355,Very bad health,5,0,0,0,0,0,0,0,1,4,0,0,0,0
S01013356,All people aged 16 to 74,563,17,5,12,78,55,41,48,113,138,48,24,24,25
S01013356,Very good health,238,8,3,5,40,37,10,19,36,48,22,14,8,18
S01013356,Good health,208,8,2,6,26,11,17,21,40,59,21,6,15,5
S01013356,Fair health,72,1,0,1,7,5,7,5,20,23,3,2,1,1
S01013356,Bad health,26,0,0,0,2,2,5,1,11,3,1,1,0,1
S01013356,Very bad health,19,0,0,0,3,0,2,2,6,5,1,1,0,0
S01013357,All people aged 16 to 74,613,41,12,29,137,110,40,63,95,81,17,9,8,29
S01013357,Very good health,291,28,9,19,64,57,24,30,30,31,5,0,5,22
S01013357,Good health,224,10,2,8,58,34,10,24,34,41,7,6,1,6
S01013357,Fair health,60,2,1,1,12,13,3,6,16,5,2,0,2,1
S01013357,Bad health,32,0,0,0,2,6,3,2,13,4,2,2,0,0
S01013357,Very bad health,6,1,0,1,1,0,0,1,2,0,1,1,0,0
S01013358,All people aged 16 to 74,607,37,10,27,92,78,48,68,128,97,28,19,9,31
S01013358,Very good health,241,18,2,16,52,30,12,35,38,26,8,4,4,22
S01013358,Good health,226,14,5,9,28,37,25,16,54,35,10,6,4,7
S01013358,Fair health,92,4,3,1,8,9,8,9,21,24,7,6,1,2
S01013358,Bad health,35,1,0,1,3,1,1,7,12,7,3,3,0,0
S01013358,Very bad health,13,0,0,0,1,1,2,1,3,5,0,0,0,0
S01013359,All people aged 16 to 74,453,14,6,8,60,43,26,38,90,118,34,26,8,30
S01013359,Very good health,181,5,3,2,25,20,12,17,32,36,12,9,3,22
S01013359,Good health,148,7,1,6,21,12,11,10,30,42,8,6,2,7
S01013359,Fair health,78,2,2,0,10,6,3,5,20,26,6,4,2,0
S01013359,Bad health,34,0,0,0,1,4,0,4,3,13,8,7,1,1
S01013359,Very bad health,12,0,0,0,3,1,0,2,5,1,0,0,0,0
S01013360,All people aged 16 to 74,521,14,5,9,65,59,23,54,129,122,29,18,11,26
S01013360,Very good health,197,6,2,4,34,18,9,22,37,42,9,5,4,20
S01013360,Good health,187,3,1,2,18,24,11,18,59,42,6,3,3,6
S01013360,Fair health,82,4,2,2,6,10,3,12,19,18,10,6,4,0
S01013360,Bad health,37,1,0,1,6,3,0,2,11,14,0,0,0,0
S01013360,Very bad health,18,0,0,0,1,4,0,0,3,6,4,4,0,0
S01013361,All people aged 16 to 74,448,13,6,7,44,69,12,46,109,103,27,19,8,25
S01013361,Very good health,162,8,5,3,18,21,5,13,34,34,9,4,5,20
S01013361,Good health,150,4,0,4,19,26,4,21,33,33,8,5,3,2
S01013361,Fair health,87,1,1,0,4,17,2,9,24,20,7,7,0,3
S01013361,Bad health,38,0,0,0,3,4,1,3,13,11,3,3,0,0
S01013361,Very bad health,11,0,0,0,0,1,0,0,5,5,0,0,0,0
S01013362,All people aged 16 to 74,341,10,3,7,41,35,15,37,81,77,19,11,8,26
S01013362,Very good health,136,4,0,4,23,10,8,14,26,25,11,6,5,15
S01013362,Good health,118,5,3,2,11,17,4,16,24,31,2,1,1,8
S01013362,Fair health,54,0,0,0,0,7,2,3,20,16,4,4,0,2
S01013362,Bad health,20,1,0,1,6,0,1,2,6,2,1,0,1,1
S01013362,Very bad health,13,0,0,0,1,1,0,2,5,3,1,0,1,0
S01013363,All people aged 16 to 74,568,11,5,6,50,77,23,45,129,146,54,29,25,33
S01013363,Very good health,219,7,3,4,24,32,9,16,48,50,22,12,10,11
S01013363,Good health,197,4,2,2,16,26,9,20,45,46,18,8,10,13
S01013363,Fair health,97,0,0,0,7,13,3,5,19,30,11,7,4,9
S01013363,Bad health,40,0,0,0,2,4,2,2,11,16,3,2,1,0
S01013363,Very bad health,15,0,0,0,1,2,0,2,6,4,0,0,0,0
S01013364,All people aged 16 to 74,690,63,16,47,128,87,40,76,111,128,23,17,6,34
S01013364,Very good health,316,30,6,24,66,53,19,30,45,48,3,1,2,22
S01013364,Good health,242,27,6,21,43,25,16,29,41,44,6,3,3,11
S01013364,Fair health,86,6,4,2,12,7,0,14,16,21,9,8,1,1
S01013364,Bad health,36,0,0,0,6,1,2,3,9,12,3,3,0,0
S01013364,Very bad health,10,0,0,0,1,1,3,0,0,3,2,2,0,0
S01013365,All people aged 16 to 74,641,41,10,31,140,122,58,66,89,89,10,4,6,26
S01013365,Very good health,321,26,8,18,76,56,30,37,39,32,6,3,3,19
S01013365,Good health,210,11,1,10,41,46,16,20,28,41,1,0,1,6
S01013365,Fair health,80,4,1,3,19,11,10,9,16,10,1,0,1,0
S01013365,Bad health,23,0,0,0,2,6,2,0,5,6,1,1,0,1
S01013365,Very bad health,7,0,0,0,2,3,0,0,1,0,1,0,1,0
S01013366,All people aged 16 to 74,687,46,13,33,154,125,38,77,83,82,21,12,9,61
S01013366,Very good health,374,27,6,21,77,69,20,50,41,35,8,3,5,47
S01013366,Good health,215,14,5,9,57,39,16,23,31,20,3,0,3,12
S01013366,Fair health,67,3,1,2,11,16,1,4,6,18,6,5,1,2
S01013366,Bad health,25,2,1,1,6,1,1,0,5,7,3,3,0,0
S01013366,Very bad health,6,0,0,0,3,0,0,0,0,2,1,1,0,0
S01013367,All people aged 16 to 74,452,47,12,35,100,69,45,33,53,61,10,10,0,34
S01013367,Very good health,261,32,6,26,60,45,23,15,25,29,5,5,0,27
S01013367,Good health,141,15,6,9,35,19,16,14,15,18,2,2,0,7
S01013367,Fair health,37,0,0,0,5,5,6,3,6,10,2,2,0,0
S01013367,Bad health,10,0,0,0,0,0,0,1,5,3,1,1,0,0
S01013367,Very bad health,3,0,0,0,0,0,0,0,2,1,0,0,0,0
S01013368,All people aged 16 to 74,554,37,12,25,79,68,57,45,95,106,29,20,9,38
S01013368,Very good health,253,24,8,16,37,38,29,16,36,32,9,4,5,32
S01013368,Good health,186,11,3,8,33,23,16,16,34,37,10,7,3,6
S01013368,Fair health,83,2,1,1,6,7,10,10,16,23,9,8,1,0
S01013368,Bad health,23,0,0,0,0,0,2,1,7,12,1,1,0,0
S01013368,Very bad health,9,0,0,0,3,0,0,2,2,2,0,0,0,0
S01013369,All people aged 16 to 74,636,27,6,21,73,90,24,53,159,142,39,28,11,29
S01013369,Very good health,257,16,4,12,39,40,8,29,50,46,9,5,4,20
S01013369,Good health,220,8,2,6,19,29,10,12,58,60,15,11,4,9
S01013369,Fair health,112,2,0,2,11,14,4,7,41,23,10,9,1,0
S01013369,Bad health,34,1,0,1,4,6,1,5,5,9,3,1,2,0
S01013369,Very bad health,13,0,0,0,0,1,1,0,5,4,2,2,0,0
S01013370,All people aged 16 to 74,435,15,3,12,67,51,19,35,83,113,30,16,14,22
S01013370,Very good health,172,7,1,6,32,14,9,15,20,49,9,4,5,17
S01013370,Good health,146,6,1,5,22,20,6,12,32,35,9,4,5,4
S01013370,Fair health,72,1,0,1,6,12,3,3,18,20,8,4,4,1
S01013370,Bad health,34,0,0,0,6,3,1,4,10,8,2,2,0,0
S01013370,Very bad health,11,1,1,0,1,2,0,1,3,1,2,2,0,0
S01013371,All people aged 16 to 74,467,23,8,15,68,68,21,53,94,101,18,11,7,21
S01013371,Very good health,157,10,4,6,24,31,8,15,20,30,3,1,2,16
S01013371,Good health,180,9,3,6,30,28,5,22,39,38,6,4,2,3
S01013371,Fair health,85,2,1,1,10,6,3,10,26,20,7,4,3,1
S01013371,Bad health,37,2,0,2,2,2,3,4,9,12,2,2,0,1
S01013371,Very bad health,8,0,0,0,2,1,2,2,0,1,0,0,0,0
S01013372,All people aged 16 to 74,791,14,7,7,69,87,32,58,205,195,72,36,36,59
S01013372,Very good health,293,7,3,4,25,30,10,25,76,60,24,14,10,36
S01013372,Good health,285,5,2,3,25,36,9,19,73,79,27,12,15,12
S01013372,Fair health,135,1,1,0,10,13,8,8,37,35,12,6,6,11
S01013372,Bad health,63,1,1,0,6,7,5,5,16,16,7,2,5,0
S01013372,Very bad health,15,0,0,0,3,1,0,1,3,5,2,2,0,0
S01013373,All people aged 16 to 74,667,25,8,17,91,88,30,68,145,139,47,24,23,34
S01013373,Very good health,258,19,5,14,43,38,16,27,38,42,13,8,5,22
S01013373,Good health,220,1,0,1,29,27,9,24,61,49,11,2,9,9
S01013373,Fair health,130,3,2,1,11,18,5,9,32,37,15,8,7,0
S01013373,Bad health,44,1,1,0,4,5,0,7,11,8,5,3,2,3
S01013373,Very bad health,15,1,0,1,4,0,0,1,3,3,3,3,0,0
S01013374,All people aged 16 to 74,667,14,2,12,59,75,34,50,129,198,80,44,36,28
S01013374,Very good health,210,4,1,3,18,29,7,17,31,56,30,20,10,18
S01013374,Good health,251,7,0,7,28,27,18,22,50,64,29,10,19,6
S01013374,Fair health,129,3,1,2,9,13,6,7,27,49,12,5,7,3
S01013374,Bad health,61,0,0,0,2,4,3,3,18,25,6,6,0,0
S01013374,Very bad health,16,0,0,0,2,2,0,1,3,4,3,3,0,1
S01013375,All people aged 16 to 74,429,12,2,10,41,69,20,46,101,99,20,12,8,21
S01013375,Very good health,177,4,1,3,21,28,5,13,48,37,8,4,4,13
S01013375,Good health,153,6,1,5,11,29,9,17,30,34,9,6,3,8
S01013375,Fair health,68,2,0,2,6,7,5,10,17,19,2,1,1,0
S01013375,Bad health,30,0,0,0,3,5,1,6,5,9,1,1,0,0
S01013375,Very bad health,1,0,0,0,0,0,0,0,1,0,0,0,0,0
S01013376,All people aged 16 to 74,435,15,3,12,49,63,26,49,83,111,30,18,12,9
S01013376,Very good health,160,10,1,9,18,28,10,16,24,36,11,8,3,7
S01013376,Good health,140,3,2,1,20,23,9,15,32,28,10,3,7,0
S01013376,Fair health,96,2,0,2,9,9,6,12,20,30,7,5,2,1
S01013376,Bad health,35,0,0,0,2,3,1,6,5,15,2,2,0,1
S01013376,Very bad health,4,0,0,0,0,0,0,0,2,2,0,0,0,0
S01013377,All people aged 16 to 74,558,16,2,14,74,75,21,54,120,146,31,16,15,21
S01013377,Very good health,231,11,1,10,36,33,9,27,50,43,9,5,4,13
S01013377,Good health,184,3,1,2,23,25,9,18,36,54,12,5,7,4
S01013377,Fair health,102,2,0,2,10,12,2,6,27,32,7,3,4,4
S01013377,Bad health,36,0,0,0,3,5,1,3,6,15,3,3,0,0
S01013377,Very bad health,5,0,0,0,2,0,0,0,1,2,0,0,0,0
S01013378,All people aged 16 to 74,750,42,14,28,139,111,38,63,112,133,52,24,28,60
S01013378,Very good health,349,19,6,13,67,58,13,31,40,57,22,13,9,42
S01013378,Good health,258,18,5,13,45,40,16,23,41,43,17,5,12,15
S01013378,Fair health,103,4,3,1,18,9,9,5,25,22,8,4,4,3
S01013378,Bad health,35,1,0,1,8,2,0,4,6,9,5,2,3,0
S01013378,Very bad health,5,0,0,0,1,2,0,0,0,2,0,0,0,0
S01013379,All people aged 16 to 74,664,23,3,20,127,101,44,68,130,109,28,20,8,34
S01013379,Very good health,305,12,2,10,67,53,15,32,50,41,8,8,0,27
S01013379,Good health,235,9,1,8,34,36,21,24,56,42,10,5,5,3
S01013379,Fair health,91,1,0,1,16,9,7,11,17,18,8,5,3,4
S01013379,Bad health,27,1,0,1,9,1,1,1,6,7,1,1,0,0
S01013379,Very bad health,6,0,0,0,1,2,0,0,1,1,1,1,0,0
S01013380,All people aged 16 to 74,90,6,2,4,21,13,14,9,8,4,9,9,0,6
S01013380,Very good health,46,6,2,4,8,7,9,4,4,2,1,1,0,5
S01013380,Good health,21,0,0,0,9,2,2,1,3,2,2,2,0,0
S01013380,Fair health,21,0,0,0,4,3,2,4,1,0,6,6,0,1
S01013380,Bad health,2,0,0,0,0,1,1,0,0,0,0,0,0,0
S01013380,Very bad health,0,0,0,0,0,0,0,0,0,0,0,0,0,0
S01013381,All people aged 16 to 74,380,16,5,11,53,39,29,41,75,93,15,8,7,19
S01013381,Very good health,137,3,0,3,25,14,11,17,19,30,5,4,1,13
S01013381,Good health,156,8,3,5,19,16,10,18,35,37,8,2,6,5
S01013381,Fair health,62,4,2,2,7,5,6,4,12,21,2,2,0,1
S01013381,Bad health,22,1,0,1,1,4,2,2,7,5,0,0,0,0
S01013381,Very bad health,3,0,0,0,1,0,0,0,2,0,0,0,0,0
S01013382,All people aged 16 to 74,421,22,11,11,59,55,29,50,82,87,10,4,6,27
S01013382,Very good health,198,13,7,6,27,30,11,25,31,35,2,1,1,24
S01013382,Good health,152,8,4,4,23,20,15,19,33,27,5,2,3,2
S01013382,Fair health,48,1,0,1,6,5,3,5,10,15,2,0,2,1
S01013382,Bad health,17,0,0,0,1,0,0,1,8,6,1,1,0,0
S01013382,Very bad health,6,0,0,0,2,0,0,0,0,4,0,0,0,0
S01013383,All people aged 16 to 74,505,15,2,13,77,65,19,56,108,104,31,19,12,30
S01013383,Very good health,181,6,1,5,31,26,6,20,27,32,10,5,5,23
S01013383,Good health,176,6,0,6,29,20,9,19,41,38,7,5,2,7
S01013383,Fair health,88,1,1,0,10,12,4,9,27,17,8,4,4,0
S01013383,Bad health,45,1,0,1,6,7,0,5,11,12,3,2,1,0
S01013383,Very bad health,15,1,0,1,1,0,0,3,2,5,3,3,0,0
S01013384,All people aged 16 to 74,547,31,6,25,80,77,39,55,97,124,26,19,7,18
S01013384,Very good health,228,13,3,10,36,39,16,17,33,49,9,6,3,16
S01013384,Good health,178,12,3,9,26,27,9,18,39,37,8,6,2,2
S01013384,Fair health,93,4,0,4,10,8,10,11,18,26,6,5,1,0
S01013384,Bad health,33,0,0,0,5,2,2,8,4,9,3,2,1,0
S01013384,Very bad health,15,2,0,2,3,1,2,1,3,3,0,0,0,0
S01013385,All people aged 16 to 74,372,17,5,12,95,66,23,32,48,64,13,9,4,14
S01013385,Very good health,183,11,3,8,47,29,10,20,27,26,3,1,2,10
S01013385,Good health,126,6,2,4,33,25,7,9,11,26,6,4,2,3
S01013385,Fair health,43,0,0,0,9,10,6,2,6,6,3,3,0,1
S01013385,Bad health,15,0,0,0,4,1,0,1,3,5,1,1,0,0
S01013385,Very bad health,5,0,0,0,2,1,0,0,1,1,0,0,0,0
S01013386,All people aged 16 to 74,659,56,9,47,183,108,41,45,88,80,13,5,8,45
S01013386,Very good health,342,30,6,24,105,59,19,16,42,31,6,2,4,34
S01013386,Good health,221,20,3,17,52,36,16,19,36,30,2,0,2,10
S01013386,Fair health,71,4,0,4,19,10,5,8,7,13,4,2,2,1
S01013386,Bad health,21,0,0,0,6,3,1,2,3,5,1,1,0,0
S01013386,Very bad health,4,2,0,2,1,0,0,0,0,1,0,0,0,0
S01013387,All people aged 16 to 74,407,23,8,15,51,56,20,34,82,88,32,14,18,21
S01013387,Very good health,181,7,2,5,29,26,8,15,30,34,15,7,8,17
S01013387,Good health,133,12,6,6,13,18,6,12,34,28,7,1,6,3
S01013387,Fair health,64,4,0,4,4,8,6,5,10,18,8,4,4,1
S01013387,Bad health,23,0,0,0,5,3,0,1,6,7,1,1,0,0
S01013387,Very bad health,6,0,0,0,0,1,0,1,2,1,1,1,0,0
S01013388,All people aged 16 to 74,534,29,7,22,85,78,38,41,88,130,28,18,10,17
S01013388,Very good health,234,17,3,14,51,32,16,20,34,43,10,5,5,11
S01013388,Good health,173,8,2,6,19,30,17,5,34,48,6,1,5,6
S01013388,Fair health,84,4,2,2,11,8,4,8,15,27,7,7,0,0
S01013388,Bad health,33,0,0,0,2,5,1,6,5,9,5,5,0,0
S01013388,Very bad health,10,0,0,0,2,3,0,2,0,3,0,0,0,0
S01013389,All people aged 16 to 74,588,25,3,22,103,93,24,74,98,110,18,10,8,43
S01013389,Very good health,259,16,2,14,47,47,9,27,37,41,7,2,5,28
S01013389,Good health,212,6,1,5,34,28,10,33,38,42,8,5,3,13
S01013389,Fair health,85,3,0,3,17,11,4,11,15,20,3,3,0,1
S01013389,Bad health,27,0,0,0,4,6,1,3,6,6,0,0,0,1
S01013389,Very bad health,5,0,0,0,1,1,0,0,2,1,0,0,0,0
S01013390,All people aged 16 to 74,353,9,0,9,49,52,21,33,76,89,16,8,8,8
S01013390,Very good health,142,4,0,4,21,21,9,18,24,31,8,4,4,6
S01013390,Good health,121,3,0,3,22,19,8,10,29,25,5,2,3,0
S01013390,Fair health,55,1,0,1,3,5,2,3,16,20,3,2,1,2
S01013390,Bad health,27,1,0,1,1,6,1,2,6,10,0,0,0,0
S01013390,Very bad health,8,0,0,0,2,1,1,0,1,3,0,0,0,0
S01013391,All people aged 16 to 74,318,26,8,18,66,47,27,19,56,44,17,11,6,16
S01013391,Very good health,153,19,7,12,33,24,16,5,23,19,3,1,2,11
S01013391,Good health,117,6,1,5,26,17,9,10,23,13,8,5,3,5
S01013391,Fair health,37,1,0,1,7,5,2,1,8,9,4,3,1,0
S01013391,Bad health,9,0,0,0,0,1,0,3,1,3,1,1,0,0
S01013391,Very bad health,2,0,0,0,0,0,0,0,1,0,1,1,0,0
S01013392,All people aged 16 to 74,549,59,16,43,135,116,45,55,56,48,6,4,2,29
S01013392,Very good health,323,39,9,30,91,68,22,26,31,25,2,2,0,19
S01013392,Good health,185,16,6,10,42,34,20,24,22,15,2,1,1,10
S01013392,Fair health,32,4,1,3,2,11,3,3,3,6,0,0,0,0
S01013392,Bad health,7,0,0,0,0,3,0,1,0,2,1,0,1,0
S01013392,Very bad health,2,0,0,0,0,0,0,1,0,0,1,1,0,0
S01013393,All people aged 16 to 74,521,34,10,24,73,57,29,61,102,110,34,12,22,21
S01013393,Very good health,238,19,4,15,42,28,16,27,36,39,15,5,10,16
S01013393,Good health,151,9,4,5,22,17,9,14,37,29,9,1,8,5
S01013393,Fair health,80,3,1,2,7,8,3,16,20,19,4,2,2,0
S01013393,Bad health,39,3,1,2,1,4,0,3,8,16,4,2,2,0
S01013393,Very bad health,13,0,0,0,1,0,1,1,1,7,2,2,0,0
S01013394,All people aged 16 to 74,500,18,5,13,64,66,26,54,89,113,45,32,13,25
S01013394,Very good health,193,8,2,6,27,30,9,17,34,37,13,9,4,18
S01013394,Good health,191,8,3,5,26,27,13,22,33,45,10,5,5,7
S01013394,Fair health,80,2,0,2,5,5,4,12,17,17,18,15,3,0
S01013394,Bad health,31,0,0,0,6,4,0,1,3,14,3,2,1,0
S01013394,Very bad health,5,0,0,0,0,0,0,2,2,0,1,1,0,0
S01013395,All people aged 16 to 74,493,11,2,9,46,45,16,39,105,133,74,43,31,24
S01013395,Very good health,162,3,1,2,20,16,7,11,33,32,20,12,8,20
S01013395,Good health,174,3,0,3,16,15,2,16,38,52,28,12,16,4
S01013395,Fair health,97,3,1,2,5,6,5,9,22,30,17,13,4,0
S01013395,Bad health,42,0,0,0,3,6,2,1,9,16,5,2,3,0
S01013395,Very bad health,18,2,0,2,2,2,0,2,3,3,4,4,0,0
S01013396,All people aged 16 to 74,496,56,10,46,132,99,47,35,56,43,9,5,4,19
S01013396,Very good health,295,27,4,23,88,54,29,24,31,20,7,4,3,15
S01013396,Good health,164,25,6,19,39,34,16,7,22,17,1,1,0,3
S01013396,Fair health,27,4,0,4,2,8,2,3,3,4,0,0,0,1
S01013396,Bad health,5,0,0,0,2,0,0,0,0,2,1,0,1,0
S01013396,Very bad health,5,0,0,0,1,3,0,1,0,0,0,0,0,0
S01013397,All people aged 16 to 74,649,33,6,27,108,99,48,61,111,124,36,26,10,29
S01013397,Very good health,296,22,3,19,58,52,28,27,41,36,14,12,2,18
S01013397,Good health,218,10,3,7,33,37,18,17,39,48,9,3,6,7
S01013397,Fair health,89,1,0,1,12,4,0,8,27,24,9,8,1,4
S01013397,Bad health,35,0,0,0,4,6,1,6,3,11,4,3,1,0
S01013397,Very bad health,11,0,0,0,1,0,1,3,1,5,0,0,0,0
S01013398,All people aged 16 to 74,438,64,10,54,89,88,22,41,49,40,12,9,3,33
S01013398,Very good health,299,46,7,39,64,62,15,22,25,27,8,7,1,30
S01013398,Good health,107,14,3,11,21,22,6,12,17,9,4,2,2,2
S01013398,Fair health,25,4,0,4,1,3,1,6,6,3,0,0,0,1
S01013398,Bad health,6,0,0,0,2,1,0,1,1,1,0,0,0,0
S01013398,Very bad health,1,0,0,0,1,0,0,0,0,0,0,0,0,0
S01013399,All people aged 16 to 74,766,69,18,51,199,125,43,73,116,90,19,12,7,32
S01013399,Very good health,427,43,9,34,124,71,30,35,54,35,8,5,3,27
S01013399,Good health,231,18,5,13,61,42,12,27,35,27,4,1,3,5
S01013399,Fair health,74,7,4,3,8,8,1,5,21,18,6,5,1,0
S01013399,Bad health,25,1,0,1,5,3,0,4,3,8,1,1,0,0
S01013399,Very bad health,9,0,0,0,1,1,0,2,3,2,0,0,0,0
S01013400,All people aged 16 to 74,504,24,5,19,88,75,29,50,109,82,27,16,11,20
S01013400,Very good health,221,10,2,8,46,39,10,22,35,34,9,5,4,16
S01013400,Good health,180,12,3,9,25,23,15,19,45,25,12,6,6,4
S01013400,Fair health,78,1,0,1,14,9,3,7,24,16,4,3,1,0
S01013400,Bad health,19,1,0,1,3,3,0,1,5,4,2,2,0,0
S01013400,Very bad health,6,0,0,0,0,1,1,1,0,3,0,0,0,0
S01013401,All people aged 16 to 74,611,80,17,63,197,104,36,37,57,54,23,15,8,23
S01013401,Very good health,367,63,13,50,124,62,15,25,29,25,9,7,2,15
S01013401,Good health,195,16,3,13,59,38,18,11,16,22,8,5,3,7
S01013401,Fair health,35,1,1,0,9,3,3,1,9,3,5,2,3,1
S01013401,Bad health,11,0,0,0,3,1,0,0,3,3,1,1,0,0
S01013401,Very bad health,3,0,0,0,2,0,0,0,0,1,0,0,0,0
S01013402,All people aged 16 to 74,763,139,20,119,236,136,29,52,65,58,11,7,4,37
S01013402,Very good health,517,101,13,88,172,90,16,30,35,37,5,4,1,31
S01013402,Good health,201,34,7,27,56,35,11,19,22,18,2,1,1,4
S01013402,Fair health,40,4,0,4,8,10,1,2,7,3,4,2,2,1
S01013402,Bad health,5,0,0,0,0,1,1,1,1,0,0,0,0,1
S01013402,Very bad health,0,0,0,0,0,0,0,0,0,0,0,0,0,0
S01013403,All people aged 16 to 74,622,89,18,71,196,114,36,36,67,49,6,4,2,29
S01013403,Very good health,388,61,12,49,127,75,25,18,39,19,2,2,0,22
S01013403,Good health,189,25,4,21,57,33,7,13,22,22,3,1,2,7
S01013403,Fair health,34,3,2,1,9,5,4,3,5,5,0,0,0,0
S01013403,Bad health,8,0,0,0,3,1,0,1,1,1,1,1,0,0
S01013403,Very bad health,3,0,0,0,0,0,0,1,0,2,0,0,0,0
S01013404,All people aged 16 to 74,416,58,13,45,108,56,18,22,60,46,14,10,4,34
S01013404,Very good health,250,41,11,30,68,33,13,7,43,14,5,3,2,26
S01013404,Good health,122,15,2,13,35,18,4,10,13,17,4,3,1,6
S01013404,Fair health,33,2,0,2,3,4,1,3,3,12,3,2,1,2
S01013404,Bad health,8,0,0,0,1,1,0,1,1,3,1,1,0,0
S01013404,Very bad health,3,0,0,0,1,0,0,1,0,0,1,1,0,0
S01013405,All people aged 16 to 74,498,36,9,27,85,87,27,52,85,82,24,6,18,20
S01013405,Very good health,228,21,4,17,40,43,11,18,41,28,11,3,8,15
S01013405,Good health,176,11,2,9,31,30,11,19,27,33,10,3,7,4
S01013405,Fair health,73,4,3,1,11,11,3,14,11,16,2,0,2,1
S01013405,Bad health,16,0,0,0,2,2,2,1,4,4,1,0,1,0
S01013405,Very bad health,5,0,0,0,1,1,0,0,2,1,0,0,0,0
S01013406,All people aged 16 to 74,456,8,2,6,56,60,16,47,107,105,41,21,20,16
S01013406,Very good health,190,5,1,4,28,24,6,12,43,40,20,11,9,12
S01013406,Good health,163,3,1,2,20,23,8,26,33,34,12,6,6,4
S01013406,Fair health,71,0,0,0,6,11,2,8,17,19,8,3,5,0
S01013406,Bad health,25,0,0,0,2,2,0,1,9,11,0,0,0,0
S01013406,Very bad health,7,0,0,0,0,0,0,0,5,1,1,1,0,0
S01013407,All people aged 16 to 74,386,11,6,5,50,50,15,36,90,94,19,10,9,21
S01013407,Very good health,148,6,3,3,27,16,9,13,24,35,3,1,2,15
S01013407,Good health,153,3,1,2,16,22,5,16,43,34,8,4,4,6
S01013407,Fair health,53,1,1,0,4,11,1,4,13,15,4,2,2,0
S01013407,Bad health,25,1,1,0,2,0,0,3,6,9,4,3,1,0
S01013407,Very bad health,7,0,0,0,1,1,0,0,4,1,0,0,0,0
S01013408,All people aged 16 to 74,454,13,2,11,52,73,23,40,89,101,40,21,19,23
S01013408,Very good health,194,7,1,6,21,31,9,12,37,39,19,8,11,19
S01013408,Good health,165,5,0,5,22,29,10,17,35,29,15,7,8,3
S01013408,Fair health,57,1,1,0,4,8,4,8,13,14,5,5,0,0
S01013408,Bad health,29,0,0,0,4,2,0,3,4,15,0,0,0,1
S01013408,Very bad health,9,0,0,0,1,3,0,0,0,4,1,1,0,0
S01013409,All people aged 16 to 74,805,58,22,36,163,126,62,54,126,133,28,14,14,55
S01013409,Very good health,434,35,12,23,100,62,29,23,65,71,8,4,4,41
S01013409,Good health,258,21,10,11,39,51,27,20,38,39,12,4,8,11
S01013409,Fair health,84,1,0,1,22,7,4,7,17,19,5,4,1,2
S01013409,Bad health,21,1,0,1,1,4,2,3,4,3,2,1,1,1
S01013409,Very bad health,8,0,0,0,1,2,0,1,2,1,1,1,0,0
S01013410,All people aged 16 to 74,471,9,5,4,34,70,21,40,109,104,47,18,29,37
S01013410,Very good health,189,4,1,3,20,29,7,13,47,29,17,4,13,23
S01013410,Good health,168,2,1,1,11,22,7,16,41,41,17,6,11,11
S01013410,Fair health,72,3,3,0,2,11,5,9,12,21,6,1,5,3
S01013410,Bad health,34,0,0,0,1,5,2,1,8,13,4,4,0,0
S01013410,Very bad health,8,0,0,0,0,3,0,1,1,0,3,3,0,0
S01013411,All people aged 16 to 74,550,51,5,46,122,87,32,30,84,93,27,15,12,24
S01013411,Very good health,290,35,2,33,61,51,20,9,38,47,10,2,8,19
S01013411,Good health,179,16,3,13,50,29,7,13,29,24,6,5,1,5
S01013411,Fair health,57,0,0,0,10,3,4,6,12,15,7,4,3,0
S01013411,Bad health,17,0,0,0,1,3,1,1,3,4,4,4,0,0
S01013411,Very bad health,7,0,0,0,0,1,0,1,2,3,0,0,0,0
S01013412,All people aged 16 to 74,623,44,14,30,125,106,26,57,85,101,31,16,15,48
S01013412,Very good health,304,28,7,21,71,58,11,20,35,29,12,4,8,40
S01013412,Good health,215,16,7,9,44,38,10,29,25,38,8,6,2,7
S01013412,Fair health,69,0,0,0,7,8,5,7,13,18,10,6,4,1
S01013412,Bad health,29,0,0,0,3,2,0,1,8,14,1,0,1,0
S01013412,Very bad health,6,0,0,0,0,0,0,0,4,2,0,0,0,0
S01013413,All people aged 16 to 74,552,92,29,63,172,72,34,38,56,49,11,8,3,28
S01013413,Very good health,304,60,17,43,100,41,13,28,17,20,5,3,2,20
S01013413,Good health,159,26,11,15,52,23,11,6,18,14,3,2,1,6
S01013413,Fair health,66,6,1,5,14,6,8,2,16,10,2,2,0,2
S01013413,Bad health,22,0,0,0,6,1,2,2,5,5,1,1,0,0
S01013413,Very bad health,1,0,0,0,0,1,0,0,0,0,0,0,0,0
S01013414,All people aged 16 to 74,605,38,6,32,134,74,29,53,104,112,42,25,17,19
S01013414,Very good health,245,21,4,17,75,30,15,19,36,31,4,0,4,14
S01013414,Good health,214,13,1,12,41,23,11,16,45,44,16,8,8,5
S01013414,Fair health,100,2,0,2,15,16,2,10,17,26,12,8,4,0
S01013414,Bad health,32,0,0,0,2,3,1,4,5,8,9,8,1,0
S01013414,Very bad health,14,2,1,1,1,2,0,4,1,3,1,1,0,0
S01013415,All people aged 16 to 74,489,11,4,7,70,85,35,44,95,102,35,18,17,12
S01013415,Very good health,173,5,1,4,32,34,14,9,32,29,7,3,4,11
S01013415,Good health,180,6,3,3,29,33,11,15,32,38,15,5,10,1
S01013415,Fair health,90,0,0,0,7,11,6,17,21,17,11,8,3,0
S01013415,Bad health,38,0,0,0,1,7,3,3,10,12,2,2,0,0
S01013415,Very bad health,8,0,0,0,1,0,1,0,0,6,0,0,0,0
S01013416,All people aged 16 to 74,452,17,4,13,60,52,24,30,100,98,42,30,12,29
S01013416,Very good health,183,9,4,5,33,22,7,12,40,32,7,6,1,21
S01013416,Good health,157,6,0,6,20,19,12,11,35,33,14,9,5,7
S01013416,Fair health,65,1,0,1,4,7,5,4,9,23,11,5,6,1
S01013416,Bad health,35,0,0,0,2,3,0,3,14,7,6,6,0,0
S01013416,Very bad health,12,1,0,1,1,1,0,0,2,3,4,4,0,0
S01013417,All people aged 16 to 74,673,39,9,30,136,98,33,69,126,114,25,12,13,33
S01013417,Very good health,296,21,3,18,68,49,6,34,45,42,9,3,6,22
S01013417,Good health,239,16,6,10,47,33,16,18,48,40,11,7,4,10
S01013417,Fair health,85,1,0,1,14,11,8,8,20,19,3,0,3,1
S01013417,Bad health,43,1,0,1,7,5,3,8,8,11,0,0,0,0
S01013417,Very bad health,10,0,0,0,0,0,0,1,5,2,2,2,0,0
S01013418,All people aged 16 to 74,476,42,8,34,84,65,35,42,77,75,21,13,8,35
S01013418,Very good health,225,30,6,24,46,27,17,19,36,19,6,2,4,25
S01013418,Good health,167,9,2,7,27,25,11,14,28,33,11,8,3,9
S01013418,Fair health,58,3,0,3,6,11,4,8,7,15,4,3,1,0
S01013418,Bad health,21,0,0,0,3,2,3,0,5,7,0,0,0,1
S01013418,Very bad health,5,0,0,0,2,0,0,1,1,1,0,0,0,0
S01013419,All people aged 16 to 74,363,40,4,36,106,73,25,20,37,24,11,6,5,27
S01013419,Very good health,193,22,2,20,61,39,11,7,16,12,4,0,4,21
S01013419,Good health,129,14,2,12,34,26,11,9,16,9,5,4,1,5
S01013419,Fair health,33,4,0,4,9,7,2,4,2,3,1,1,0,1
S01013419,Bad health,3,0,0,0,0,1,1,0,1,0,0,0,0,0
S01013419,Very bad health,5,0,0,0,2,0,0,0,2,0,1,1,0,0
S01013420,All people aged 16 to 74,425,26,5,21,93,90,16,35,68,60,16,10,6,21
S01013420,Very good health,218,17,3,14,52,47,11,17,26,23,5,3,2,20
S01013420,Good health,141,8,2,6,26,31,4,13,31,23,5,3,2,0
S01013420,Fair health,42,1,0,1,9,8,1,3,6,8,5,3,2,1
S01013420,Bad health,17,0,0,0,5,4,0,1,2,4,1,1,0,0
S01013420,Very bad health,7,0,0,0,1,0,0,1,3,2,0,0,0,0
S01013421,All people aged 16 to 74,556,66,12,54,152,103,32,47,64,48,9,7,2,35
S01013421,Very good health,360,48,7,41,116,64,18,30,31,19,3,1,2,31
S01013421,Good health,159,15,5,10,35,36,13,16,19,19,3,3,0,3
S01013421,Fair health,27,3,0,3,1,2,1,0,11,7,1,1,0,1
S01013421,Bad health,8,0,0,0,0,1,0,1,3,3,0,0,0,0
S01013421,Very bad health,2,0,0,0,0,0,0,0,0,0,2,2,0,0
S01013422,All people aged 16 to 74,540,15,1,14,88,101,28,51,109,80,18,10,8,50
S01013422,Very good health,258,8,0,8,53,49,10,25,33,34,5,3,2,41
S01013422,Good health,181,5,1,4,24,37,14,16,43,27,6,2,4,9
S01013422,Fair health,73,2,0,2,7,11,4,6,26,12,5,3,2,0
S01013422,Bad health,19,0,0,0,4,2,0,2,7,3,1,1,0,0
S01013422,Very bad health,9,0,0,0,0,2,0,2,0,4,1,1,0,0
S01013423,All people aged 16 to 74,628,46,9,37,134,107,35,46,86,97,28,18,10,49
S01013423,Very good health,325,29,3,26,81,52,16,24,34,41,12,10,2,36
S01013423,Good health,206,12,5,7,42,38,15,14,31,36,7,2,5,11
S01013423,Fair health,66,4,1,3,7,13,2,7,14,13,4,2,2,2
S01013423,Bad health,23,0,0,0,3,2,2,0,5,7,4,3,1,0
S01013423,Very bad health,8,1,0,1,1,2,0,1,2,0,1,1,0,0
S01013424,All people aged 16 to 74,370,37,12,25,100,65,26,31,47,28,4,3,1,32
S01013424,Very good health,219,22,6,16,62,37,14,19,21,15,1,1,0,28
S01013424,Good health,113,11,5,6,31,23,8,10,17,9,0,0,0,4
S01013424,Fair health,32,4,1,3,6,5,4,1,7,3,2,1,1,0
S01013424,Bad health,5,0,0,0,1,0,0,1,2,0,1,1,0,0
S01013424,Very bad health,1,0,0,0,0,0,0,0,0,1,0,0,0,0
S01013425,All people aged 16 to 74,332,32,5,27,80,52,26,24,49,46,9,3,6,14
S01013425,Very good health,186,23,5,18,45,38,12,17,23,15,1,1,0,12
S01013425,Good health,102,9,0,9,30,11,10,5,14,18,5,1,4,0
S01013425,Fair health,30,0,0,0,4,2,3,1,6,11,2,1,1,1
S01013425,Bad health,12,0,0,0,1,1,0,1,6,2,0,0,0,1
S01013425,Very bad health,2,0,0,0,0,0,1,0,0,0,1,0,1,0
S01013426,All people aged 16 to 74,615,22,8,14,72,100,30,50,120,153,39,24,15,29
S01013426,Very good health,269,14,6,8,37,37,15,20,51,51,19,12,7,25
S01013426,Good health,198,4,1,3,20,37,13,17,41,52,10,4,6,4
S01013426,Fair health,103,3,1,2,11,18,1,10,22,29,9,7,2,0
S01013426,Bad health,30,0,0,0,4,5,1,3,3,14,0,0,0,0
S01013426,Very bad health,15,1,0,1,0,3,0,0,3,7,1,1,0,0
S01013427,All people aged 16 to 74,332,50,11,39,120,38,36,14,26,21,6,3,3,21
S01013427,Very good health,210,33,8,25,79,25,19,12,11,9,3,2,1,19
S01013427,Good health,97,17,3,14,36,8,12,2,10,10,1,0,1,1
S01013427,Fair health,18,0,0,0,5,5,3,0,2,0,2,1,1,1
S01013427,Bad health,3,0,0,0,0,0,1,0,1,1,0,0,0,0
S01013427,Very bad health,4,0,0,0,0,0,1,0,2,1,0,0,0,0
S01013428,All people aged 16 to 74,719,28,6,22,114,89,42,64,127,171,43,26,17,41
S01013428,Very good health,312,13,3,10,55,44,18,27,59,45,22,12,10,29
S01013428,Good health,238,13,2,11,34,30,15,22,38,64,12,9,3,10
S01013428,Fair health,114,0,0,0,20,12,4,12,16,41,7,3,4,2
S01013428,Bad health,42,2,1,1,4,2,3,2,12,15,2,2,0,0
S01013428,Very bad health,13,0,0,0,1,1,2,1,2,6,0,0,0,0
S01013429,All people aged 16 to 74,525,30,4,26,93,81,38,63,102,78,19,14,5,21
S01013429,Very good health,233,18,1,17,42,37,16,25,43,34,3,3,0,15
S01013429,Good health,198,11,2,9,40,23,20,26,38,27,8,5,3,5
S01013429,Fair health,59,1,1,0,8,12,1,4,16,11,6,4,2,0
S01013429,Bad health,22,0,0,0,2,6,1,7,3,2,0,0,0,1
S01013429,Very bad health,13,0,0,0,1,3,0,1,2,4,2,2,0,0
S01013430,All people aged 16 to 74,521,36,7,29,98,78,45,55,84,81,29,22,7,15
S01013430,Very good health,234,17,2,15,45,37,21,26,38,31,9,5,4,10
S01013430,Good health,179,15,4,11,36,29,15,17,28,27,8,6,2,4
S01013430,Fair health,70,3,0,3,12,8,8,9,9,12,9,8,1,0
S01013430,Bad health,31,1,1,0,5,3,1,3,5,9,3,3,0,1
S01013430,Very bad health,7,0,0,0,0,1,0,0,4,2,0,0,0,0
S01013431,All people aged 16 to 74,510,27,9,18,85,62,43,40,98,101,31,19,12,23
S01013431,Very good health,218,17,5,12,35,25,18,16,37,44,10,7,3,16
S01013431,Good health,170,8,2,6,32,25,20,15,26,29,9,5,4,6
S01013431,Fair health,87,2,2,0,14,8,5,6,22,19,10,6,4,1
S01013431,Bad health,22,0,0,0,3,2,0,2,7,6,2,1,1,0
S01013431,Very bad health,13,0,0,0,1,2,0,1,6,3,0,0,0,0
S01013432,All people aged 16 to 74,545,45,10,35,119,69,65,42,78,85,19,6,13,23
S01013432,Very good health,273,32,9,23,63,34,32,17,29,32,13,3,10,21
S01013432,Good health,165,10,1,9,44,20,17,14,28,26,4,1,3,2
S01013432,Fair health,66,2,0,2,9,7,13,6,12,16,1,1,0,0
S01013432,Bad health,33,1,0,1,2,6,2,5,6,11,0,0,0,0
S01013432,Very bad health,8,0,0,0,1,2,1,0,3,0,1,1,0,0
S01013433,All people aged 16 to 74,549,90,25,65,139,71,48,40,71,57,7,4,3,26
S01013433,Very good health,259,57,19,38,71,29,21,15,29,16,3,2,1,18
S01013433,Good health,215,30,5,25,57,29,22,20,23,24,4,2,2,6
S01013433,Fair health,53,2,1,1,10,9,4,4,10,12,0,0,0,2
S01013433,Bad health,15,1,0,1,1,4,0,0,7,2,0,0,0,0
S01013433,Very bad health,7,0,0,0,0,0,1,1,2,3,0,0,0,0
S01013434,All people aged 16 to 74,398,68,9,59,123,40,68,20,30,12,7,5,2,30
S01013434,Very good health,242,50,6,44,69,25,38,11,13,7,3,2,1,26
S01013434,Good health,128,16,3,13,44,13,24,6,13,4,4,3,1,4
S01013434,Fair health,22,2,0,2,7,1,6,2,3,1,0,0,0,0
S01013434,Bad health,5,0,0,0,3,0,0,1,1,0,0,0,0,0
S01013434,Very bad health,1,0,0,0,0,1,0,0,0,0,0,0,0,0
S01013435,All people aged 16 to 74,480,118,32,86,161,65,26,14,29,16,6,4,2,45
S01013435,Very good health,336,86,21,65,117,42,16,5,17,9,2,1,1,42
S01013435,Good health,111,28,10,18,39,16,5,7,8,4,2,2,0,2
S01013435,Fair health,29,4,1,3,5,6,5,1,3,3,1,0,1,1
S01013435,Bad health,3,0,0,0,0,1,0,0,1,0,1,1,0,0
S01013435,Very bad health,1,0,0,0,0,0,0,1,0,0,0,0,0,0
S01013436,All people aged 16 to 74,615,70,14,56,109,83,34,51,103,97,21,14,7,47
S01013436,Very good health,307,49,11,38,56,49,19,18,40,29,8,4,4,39
S01013436,Good health,200,17,3,14,35,22,10,19,38,43,8,6,2,8
S01013436,Fair health,82,4,0,4,13,9,4,11,16,20,5,4,1,0
S01013436,Bad health,23,0,0,0,5,3,1,2,8,4,0,0,0,0
S01013436,Very bad health,3,0,0,0,0,0,0,1,1,1,0,0,0,0
S01013437,All people aged 16 to 74,523,48,6,42,117,76,29,44,79,71,12,6,6,47
S01013437,Very good health,247,24,3,21,70,39,14,12,30,25,2,0,2,31
S01013437,Good health,184,22,3,19,38,25,11,21,29,20,3,2,1,15
S01013437,Fair health,64,2,0,2,5,9,4,9,12,19,3,1,2,1
S01013437,Bad health,17,0,0,0,2,1,0,2,7,3,2,1,1,0
S01013437,Very bad health,11,0,0,0,2,2,0,0,1,4,2,2,0,0
S01013438,All people aged 16 to 74,430,38,10,28,89,64,31,38,72,55,17,8,9,26
S01013438,Very good health,205,31,8,23,41,33,16,15,29,18,3,1,2,19
S01013438,Good health,135,3,0,3,30,16,11,12,32,23,3,1,2,5
S01013438,Fair health,72,4,2,2,15,12,4,9,8,8,10,5,5,2
S01013438,Bad health,14,0,0,0,3,3,0,0,3,5,0,0,0,0
S01013438,Very bad health,4,0,0,0,0,0,0,2,0,1,1,1,0,0
S01013439,All people aged 16 to 74,694,146,22,124,248,101,43,34,46,22,10,3,7,44
S01013439,Very good health,403,84,11,73,148,53,24,17,24,11,6,2,4,36
S01013439,Good health,220,55,10,45,74,37,15,11,14,5,2,0,2,7
S01013439,Fair health,57,6,1,5,23,9,3,5,3,5,2,1,1,1
S01013439,Bad health,11,1,0,1,2,1,1,1,4,1,0,0,0,0
S01013439,Very bad health,3,0,0,0,1,1,0,0,1,0,0,0,0,0
S01013440,All people aged 16 to 74,773,196,31,165,262,111,38,31,44,24,4,0,4,63
S01013440,Very good health,472,128,16,112,157,69,17,16,26,9,4,0,4,46
S01013440,Good health,233,56,11,45,80,32,16,12,12,8,0,0,0,17
S01013440,Fair health,49,8,3,5,19,7,4,2,5,4,0,0,0,0
S01013440,Bad health,15,3,0,3,4,3,1,1,0,3,0,0,0,0
S01013440,Very bad health,4,1,1,0,2,0,0,0,1,0,0,0,0,0
S01013441,All people aged 16 to 74,558,131,26,105,194,68,38,30,32,19,13,10,3,33
S01013441,Very good health,346,86,16,70,116,45,17,18,20,7,9,7,2,28
S01013441,Good health,155,30,9,21,60,17,16,10,8,8,1,0,1,5
S01013441,Fair health,43,12,1,11,16,4,3,1,3,3,1,1,0,0
S01013441,Bad health,9,1,0,1,2,2,2,0,1,0,1,1,0,0
S01013441,Very bad health,5,2,0,2,0,0,0,1,0,1,1,1,0,0
S01013442,All people aged 16 to 74,607,91,10,81,161,94,38,42,81,56,14,10,4,30
S01013442,Very good health,333,62,8,54,92,49,21,19,39,23,2,1,1,26
S01013442,Good health,197,22,2,20,54,36,12,16,27,18,8,6,2,4
S01013442,Fair health,54,7,0,7,12,7,3,5,8,9,3,2,1,0
S01013442,Bad health,17,0,0,0,3,2,1,2,3,5,1,1,0,0
S01013442,Very bad health,6,0,0,0,0,0,1,0,4,1,0,0,0,0
S01013443,All people aged 16 to 74,457,80,14,66,146,43,30,31,61,31,13,6,7,22
S01013443,Very good health,261,55,9,46,90,21,14,13,31,14,6,2,4,17
S01013443,Good health,155,21,5,16,49,17,15,9,25,10,4,2,2,5
S01013443,Fair health,28,2,0,2,6,4,1,6,2,5,2,1,1,0
S01013443,Bad health,10,2,0,2,1,1,0,3,1,1,1,1,0,0
S01013443,Very bad health,3,0,0,0,0,0,0,0,2,1,0,0,0,0
S01013444,All people aged 16 to 74,703,106,15,91,166,74,58,55,108,69,38,22,16,29
S01013444,Very good health,349,71,10,61,94,35,29,23,44,22,13,7,6,18
S01013444,Good health,245,28,2,26,52,28,18,26,48,23,11,8,3,11
S01013444,Fair health,76,6,3,3,10,9,5,4,12,18,12,5,7,0
S01013444,Bad health,26,1,0,1,6,2,6,2,2,5,2,2,0,0
S01013444,Very bad health,7,0,0,0,4,0,0,0,2,1,0,0,0,0
S01013445,All people aged 16 to 74,410,116,20,96,117,57,27,24,30,9,10,8,2,20
S01013445,Very good health,258,84,16,68,75,31,15,12,15,4,4,2,2,18
S01013445,Good health,122,28,4,24,36,18,10,11,10,5,2,2,0,2
S01013445,Fair health,18,3,0,3,5,5,1,0,4,0,0,0,0,0
S01013445,Bad health,8,1,0,1,0,3,1,0,1,0,2,2,0,0
S01013445,Very bad health,4,0,0,0,1,0,0,1,0,0,2,2,0,0
S01013446,All people aged 16 to 74,508,41,7,34,82,94,33,44,90,81,16,9,7,27
S01013446,Very good health,244,27,6,21,47,46,13,18,39,25,8,6,2,21
S01013446,Good health,174,9,1,8,29,32,10,19,34,31,5,1,4,5
S01013446,Fair health,65,3,0,3,5,14,8,6,11,14,3,2,1,1
S01013446,Bad health,19,1,0,1,1,2,2,1,5,7,0,0,0,0
S01013446,Very bad health,6,1,0,1,0,0,0,0,1,4,0,0,0,0
S01013447,All people aged 16 to 74,419,110,19,91,134,61,22,15,25,6,5,2,3,41
S01013447,Very good health,291,82,13,69,96,29,15,10,14,4,2,2,0,39
S01013447,Good health,109,26,6,20,34,24,5,4,11,2,2,0,2,1
S01013447,Fair health,15,2,0,2,4,5,2,1,0,0,0,0,0,1
S01013447,Bad health,4,0,0,0,0,3,0,0,0,0,1,0,1,0
S01013447,Very bad health,0,0,0,0,0,0,0,0,0,0,0,0,0,0
S01013448,All people aged 16 to 74,577,132,28,104,186,90,35,29,46,21,11,9,2,27
S01013448,Very good health,333,84,16,68,114,41,19,12,23,15,3,1,2,22
S01013448,Good health,177,42,10,32,53,37,13,10,13,4,2,2,0,3
S01013448,Fair health,48,4,2,2,14,8,1,6,6,1,6,6,0,2
S01013448,Bad health,14,1,0,1,3,4,1,1,3,1,0,0,0,0
S01013448,Very bad health,5,1,0,1,2,0,1,0,1,0,0,0,0,0
S01013449,All people aged 16 to 74,499,86,16,70,147,101,32,22,55,22,2,1,1,32
S01013449,Very good health,278,51,7,44,83,52,16,8,33,5,0,0,0,30
S01013449,Good health,171,31,7,24,49,41,12,8,14,12,2,1,1,2
S01013449,Fair health,41,2,1,1,13,7,3,6,6,4,0,0,0,0
S01013449,Bad health,7,2,1,1,2,0,1,0,2,0,0,0,0,0
S01013449,Very bad health,2,0,0,0,0,1,0,0,0,1,0,0,0,0
S01013450,All people aged 16 to 74,451,77,11,66,138,84,20,27,41,28,6,3,3,30
S01013450,Very good health,271,54,8,46,80,49,10,14,25,10,2,0,2,27
S01013450,Good health,142,18,1,17,47,32,2,11,13,14,2,1,1,3
S01013450,Fair health,36,5,2,3,10,3,8,2,3,3,2,2,0,0
S01013450,Bad health,2,0,0,0,1,0,0,0,0,1,0,0,0,0
S01013450,Very bad health,0,0,0,0,0,0,0,0,0,0,0,0,0,0
S01013451,All people aged 16 to 74,656,136,25,111,208,89,37,24,53,18,15,10,5,76
S01013451,Very good health,419,90,17,73,128,51,25,14,28,10,8,6,2,65
S01013451,Good health,175,38,8,30,61,25,10,9,17,6,0,0,0,9
S01013451,Fair health,47,7,0,7,16,9,0,1,6,2,4,2,2,2
S01013451,Bad health,13,1,0,1,3,4,0,0,2,0,3,2,1,0
S01013451,Very bad health,2,0,0,0,0,0,2,0,0,0,0,0,0,0
S01013452,All people aged 16 to 74,576,117,21,96,183,80,37,26,48,23,8,6,2,54
S01013452,Very good health,372,85,16,69,116,47,20,17,28,14,4,2,2,41
S01013452,Good health,161,29,5,24,55,27,14,8,11,5,1,1,0,11
S01013452,Fair health,30,2,0,2,10,3,3,1,3,4,2,2,0,2
S01013452,Bad health,9,0,0,0,1,3,0,0,5,0,0,0,0,0
S01013452,Very bad health,4,1,0,1,1,0,0,0,1,0,1,1,0,0
S01013453,All people aged 16 to 74,547,29,8,21,73,60,22,57,111,133,36,16,20,26
S01013453,Very good health,222,21,4,17,38,28,5,18,30,44,15,9,6,23
S01013453,Good health,218,6,2,4,28,20,8,24,57,58,14,6,8,3
S01013453,Fair health,72,0,0,0,7,8,8,6,16,21,6,1,5,0
S01013453,Bad health,28,2,2,0,0,2,0,9,6,9,0,0,0,0
S01013453,Very bad health,7,0,0,0,0,2,1,0,2,1,1,0,1,0
S01013454,All people aged 16 to 74,572,84,15,69,151,78,53,52,66,59,11,7,4,18
S01013454,Very good health,298,50,7,43,89,32,27,30,23,24,5,2,3,18
S01013454,Good health,218,30,6,24,51,36,23,17,33,24,4,3,1,0
S01013454,Fair health,47,4,2,2,8,10,3,5,7,8,2,2,0,0
S01013454,Bad health,9,0,0,0,3,0,0,0,3,3,0,0,0,0
S01013454,Very bad health,0,0,0,0,0,0,0,0,0,0,0,0,0,0
S01013455,All people aged 16 to 74,427,49,10,39,105,56,50,31,54,53,17,9,8,12
S01013455,Very good health,214,35,6,29,59,26,24,18,18,19,5,2,3,10
S01013455,Good health,146,7,2,5,33,21,19,5,29,20,10,6,4,2
S01013455,Fair health,48,6,2,4,11,6,2,6,7,8,2,1,1,0
S01013455,Bad health,16,1,0,1,2,2,4,2,0,5,0,0,0,0
S01013455,Very bad health,3,0,0,0,0,1,1,0,0,1,0,0,0,0
S01013456,All people aged 16 to 74,591,45,9,36,105,73,37,62,102,106,24,13,11,37
S01013456,Very good health,282,31,5,26,59,38,11,28,36,42,8,3,5,29
S01013456,Good health,188,9,3,6,36,26,16,17,35,36,9,6,3,4
S01013456,Fair health,80,4,1,3,8,7,4,7,27,14,6,3,3,3
S01013456,Bad health,32,1,0,1,1,1,6,8,4,10,0,0,0,1
S01013456,Very bad health,9,0,0,0,1,1,0,2,0,4,1,1,0,0
S01013457,All people aged 16 to 74,655,11,0,11,74,89,33,67,142,157,38,17,21,44
S01013457,Very good health,264,6,0,6,34,41,11,19,52,57,16,5,11,28
S01013457,Good health,247,3,0,3,28,27,13,28,54,68,13,7,6,13
S01013457,Fair health,97,2,0,2,8,12,6,16,24,19,7,3,4,3
S01013457,Bad health,42,0,0,0,4,8,3,4,11,11,1,1,0,0
S01013457,Very bad health,5,0,0,0,0,1,0,0,1,2,1,1,0,0
S01013458,All people aged 16 to 74,564,43,13,30,109,87,37,51,96,96,16,3,13,29
S01013458,Very good health,258,23,4,19,65,35,19,27,36,30,6,2,4,17
S01013458,Good health,217,16,7,9,34,35,12,12,40,49,7,1,6,12
S01013458,Fair health,69,3,1,2,7,15,5,10,16,11,2,0,2,0
S01013458,Bad health,9,0,0,0,3,1,1,0,1,2,1,0,1,0
S01013458,Very bad health,11,1,1,0,0,1,0,2,3,4,0,0,0,0
S01013459,All people aged 16 to 74,610,37,6,31,101,88,39,54,111,128,22,12,10,30
S01013459,Very good health,255,22,3,19,48,44,20,17,39,39,4,2,2,22
S01013459,Good health,206,13,3,10,37,22,11,22,41,48,7,5,2,5
S01013459,Fair health,100,2,0,2,11,17,7,10,20,20,11,5,6,2
S01013459,Bad health,42,0,0,0,3,4,0,5,10,19,0,0,0,1
S01013459,Very bad health,7,0,0,0,2,1,1,0,1,2,0,0,0,0
S01013460,All people aged 16 to 74,597,25,5,20,94,96,33,49,112,138,28,18,10,22
S01013460,Very good health,284,12,3,9,51,51,20,20,45,58,10,7,3,17
S01013460,Good health,200,11,2,9,27,29,12,15,46,42,14,9,5,4
S01013460,Fair health,80,2,0,2,12,14,1,5,15,27,3,2,1,1
S01013460,Bad health,26,0,0,0,3,2,0,5,5,10,1,0,1,0
S01013460,Very bad health,7,0,0,0,1,0,0,4,1,1,0,0,0,0
S01013461,All people aged 16 to 74,781,64,10,54,156,120,38,69,121,126,39,17,22,48
S01013461,Very good health,403,47,7,40,77,73,17,32,56,48,14,5,9,39
S01013461,Good health,254,14,2,12,58,34,12,26,46,46,10,4,6,8
S01013461,Fair health,98,3,1,2,20,10,5,5,17,27,10,3,7,1
S01013461,Bad health,23,0,0,0,1,2,4,5,2,4,5,5,0,0
S01013461,Very bad health,3,0,0,0,0,1,0,1,0,1,0,0,0,0
S01013462,All people aged 16 to 74,657,63,14,49,159,103,38,61,92,95,11,5,6,35
S01013462,Very good health,355,43,10,33,90,53,16,32,46,40,8,4,4,27
S01013462,Good health,215,13,3,10,51,41,14,19,33,37,1,0,1,6
S01013462,Fair health,62,5,1,4,13,8,5,8,8,12,1,0,1,2
S01013462,Bad health,21,2,0,2,5,1,3,2,3,4,1,1,0,0
S01013462,Very bad health,4,0,0,0,0,0,0,0,2,2,0,0,0,0
S01013463,All people aged 16 to 74,397,30,5,25,63,69,19,28,88,54,22,10,12,24
S01013463,Very good health,208,18,2,16,38,33,9,13,47,21,12,7,5,17
S01013463,Good health,128,10,3,7,17,23,8,13,22,25,5,2,3,5
S01013463,Fair health,43,1,0,1,6,10,0,1,12,7,4,1,3,2
S01013463,Bad health,15,1,0,1,1,3,1,1,7,0,1,0,1,0
S01013463,Very bad health,3,0,0,0,1,0,1,0,0,1,0,0,0,0
S01013464,All people aged 16 to 74,536,39,13,26,131,85,34,51,80,67,13,9,4,36
S01013464,Very good health,258,16,7,9,69,36,18,26,34,27,7,5,2,25
S01013464,Good health,191,17,4,13,45,34,13,18,27,25,2,1,1,10
S01013464,Fair health,55,1,1,0,9,12,3,5,14,8,3,2,1,0
S01013464,Bad health,23,4,0,4,7,1,0,2,4,4,0,0,0,1
S01013464,Very bad health,9,1,1,0,1,2,0,0,1,3,1,1,0,0
S01013465,All people aged 16 to 74,514,34,5,29,88,124,34,47,85,68,12,8,4,22
S01013465,Very good health,241,16,3,13,46,56,13,19,44,26,2,0,2,19
S01013465,Good health,182,13,1,12,34,44,16,19,22,26,5,4,1,3
S01013465,Fair health,74,5,1,4,8,17,4,8,16,11,5,4,1,0
S01013465,Bad health,12,0,0,0,0,4,1,1,2,4,0,0,0,0
S01013465,Very bad health,5,0,0,0,0,3,0,0,1,1,0,0,0,0
S01013466,All people aged 16 to 74,376,31,4,27,58,18,32,13,31,21,11,5,6,161
S01013466,Very good health,239,21,4,17,33,12,15,7,13,8,6,4,2,124
S01013466,Good health,108,8,0,8,20,5,13,6,13,8,3,1,2,32
S01013466,Fair health,17,1,0,1,4,1,4,0,2,1,2,0,2,2
S01013466,Bad health,10,1,0,1,1,0,0,0,3,3,0,0,0,2
S01013466,Very bad health,2,0,0,0,0,0,0,0,0,1,0,0,0,1
S01013467,All people aged 16 to 74,671,103,16,87,170,105,44,48,81,67,13,9,4,40
S01013467,Very good health,380,64,10,54,110,56,21,28,36,28,5,3,2,32
S01013467,Good health,206,33,5,28,53,36,16,11,25,19,5,3,2,8
S01013467,Fair health,56,5,1,4,4,7,6,5,15,13,1,1,0,0
S01013467,Bad health,24,1,0,1,3,5,1,2,4,6,2,2,0,0
S01013467,Very bad health,5,0,0,0,0,1,0,2,1,1,0,0,0,0
S01013468,All people aged 16 to 74,481,41,14,27,101,79,42,29,82,56,25,16,9,26
S01013468,Very good health,237,25,9,16,57,43,15,12,35,20,7,5,2,23
S01013468,Good health,147,12,3,9,29,21,18,9,30,20,5,4,1,3
S01013468,Fair health,67,2,0,2,11,9,3,8,11,12,11,5,6,0
S01013468,Bad health,21,1,1,0,3,5,4,0,3,3,2,2,0,0
S01013468,Very bad health,9,1,1,0,1,1,2,0,3,1,0,0,0,0
S01013469,All people aged 16 to 74,585,58,12,46,122,102,46,53,92,72,15,12,3,25
S01013469,Very good health,282,36,8,28,66,48,17,20,41,31,3,2,1,20
S01013469,Good health,214,18,4,14,43,42,21,24,34,23,4,3,1,5
S01013469,Fair health,69,4,0,4,8,10,8,7,11,15,6,5,1,0
S01013469,Bad health,16,0,0,0,4,1,0,2,5,3,1,1,0,0
S01013469,Very bad health,4,0,0,0,1,1,0,0,1,0,1,1,0,0
S01013470,All people aged 16 to 74,550,16,4,12,69,60,31,58,134,124,29,18,11,29
S01013470,Very good health,224,7,1,6,37,26,11,22,41,50,7,2,5,23
S01013470,Good health,199,4,1,3,19,24,11,21,60,46,10,8,2,4
S01013470,Fair health,86,5,2,3,9,9,5,7,23,18,8,4,4,2
S01013470,Bad health,30,0,0,0,3,0,3,5,9,7,3,3,0,0
S01013470,Very bad health,11,0,0,0,1,1,1,3,1,3,1,1,0,0
S01013471,All people aged 16 to 74,702,31,10,21,87,103,37,79,155,130,35,22,13,45
S01013471,Very good health,281,11,3,8,31,37,10,39,61,51,11,7,4,30
S01013471,Good health,272,15,6,9,38,48,16,28,62,40,13,8,5,12
S01013471,Fair health,100,4,0,4,12,16,6,6,16,27,10,6,4,3
S01013471,Bad health,41,1,1,0,6,2,2,6,13,10,1,1,0,0
S01013471,Very bad health,8,0,0,0,0,0,3,0,3,2,0,0,0,0
S01013472,All people aged 16 to 74,445,68,16,52,110,78,40,33,42,31,13,6,7,30
S01013472,Very good health,264,44,9,35,75,44,19,17,22,10,6,2,4,27
S01013472,Good health,135,20,4,16,27,26,16,13,11,15,4,1,3,3
S01013472,Fair health,33,4,3,1,7,7,3,1,7,2,2,2,0,0
S01013472,Bad health,11,0,0,0,1,0,1,2,2,4,1,1,0,0
S01013472,Very bad health,2,0,0,0,0,1,1,0,0,0,0,0,0,0
S01013473,All people aged 16 to 74,466,81,20,61,130,82,36,28,35,30,6,4,2,38
S01013473,Very good health,301,59,14,45,91,54,21,15,20,12,1,0,1,28
S01013473,Good health,138,21,6,15,35,25,13,11,10,14,2,1,1,7
S01013473,Fair health,21,1,0,1,4,3,1,1,5,4,1,1,0,1
S01013473,Bad health,6,0,0,0,0,0,1,1,0,0,2,2,0,2
S01013473,Very bad health,0,0,0,0,0,0,0,0,0,0,0,0,0,0
S01013474,All people aged 16 to 74,443,50,8,42,120,86,32,21,52,45,12,7,5,25
S01013474,Very good health,264,31,2,29,76,45,20,13,33,19,5,3,2,22
S01013474,Good health,139,16,5,11,36,30,8,6,15,20,5,2,3,3
S01013474,Fair health,32,3,1,2,7,10,4,1,4,3,0,0,0,0
S01013474,Bad health,4,0,0,0,0,1,0,0,0,3,0,0,0,0
S01013474,Very bad health,4,0,0,0,1,0,0,1,0,0,2,2,0,0
S01013475,All people aged 16 to 74,492,29,6,23,109,78,34,40,97,53,13,7,6,39
S01013475,Very good health,262,16,2,14,55,37,19,22,50,22,6,4,2,35
S01013475,Good health,158,9,3,6,40,31,11,10,30,18,6,3,3,3
S01013475,Fair health,50,3,1,2,10,10,2,4,11,8,1,0,1,1
S01013475,Bad health,19,1,0,1,3,0,2,3,5,5,0,0,0,0
S01013475,Very bad health,3,0,0,0,1,0,0,1,1,0,0,0,0,0
S01013476,All people aged 16 to 74,496,38,13,25,86,100,31,43,90,63,16,10,6,29
S01013476,Very good health,230,24,9,15,38,51,15,18,36,22,4,2,2,22
S01013476,Good health,177,6,4,2,38,40,8,17,34,24,5,4,1,5
S01013476,Fair health,64,6,0,6,10,6,7,5,13,11,4,1,3,2
S01013476,Bad health,20,2,0,2,0,2,0,2,7,6,1,1,0,0
S01013476,Very bad health,5,0,0,0,0,1,1,1,0,0,2,2,0,0
S01013477,All people aged 16 to 74,459,24,7,17,64,56,37,49,76,114,21,10,11,18
S01013477,Very good health,185,13,3,10,33,19,12,18,25,45,9,4,5,11
S01013477,Good health,168,8,3,5,22,28,13,18,31,40,5,1,4,3
S01013477,Fair health,77,3,1,2,4,5,12,10,13,21,5,3,2,4
S01013477,Bad health,24,0,0,0,5,3,0,1,7,6,2,2,0,0
S01013477,Very bad health,5,0,0,0,0,1,0,2,0,2,0,0,0,0
S01013478,All people aged 16 to 74,643,46,5,41,139,97,39,52,100,87,38,24,14,45
S01013478,Very good health,323,18,2,16,87,56,17,26,39,32,12,7,5,36
S01013478,Good health,206,23,2,21,38,28,14,19,42,23,12,6,6,7
S01013478,Fair health,83,3,1,2,9,9,7,6,12,25,11,9,2,1
S01013478,Bad health,23,1,0,1,2,4,0,1,4,7,3,2,1,1
S01013478,Very bad health,8,1,0,1,3,0,1,0,3,0,0,0,0,0
S01013479,All people aged 16 to 74,599,22,2,20,69,92,32,61,126,135,39,19,20,23
S01013479,Very good health,239,8,0,8,37,38,14,25,51,42,11,2,9,13
S01013479,Good health,229,9,1,8,23,42,13,22,48,55,12,6,6,5
S01013479,Fair health,91,3,1,2,6,8,3,11,17,25,13,8,5,5
S01013479,Bad health,33,2,0,2,2,4,2,2,8,12,1,1,0,0
S01013479,Very bad health,7,0,0,0,1,0,0,1,2,1,2,2,0,0
S01013480,All people aged 16 to 74,494,16,4,12,50,66,26,61,120,111,20,8,12,24
S01013480,Very good health,191,7,0,7,25,27,10,21,41,41,6,3,3,13
S01013480,Good health,196,8,3,5,20,27,12,28,46,37,8,2,6,10
S01013480,Fair health,75,0,0,0,3,7,2,8,23,26,5,3,2,1
S01013480,Bad health,24,1,1,0,2,2,1,4,8,5,1,0,1,0
S01013480,Very bad health,8,0,0,0,0,3,1,0,2,2,0,0,0,0
S01013481,All people aged 16 to 74,353,22,6,16,77,53,34,31,51,51,10,6,4,24
S01013481,Very good health,178,15,6,9,41,25,15,14,25,18,3,3,0,22
S01013481,Good health,122,5,0,5,28,19,13,14,13,24,4,1,3,2
S01013481,Fair health,35,1,0,1,7,7,4,1,7,5,3,2,1,0
S01013481,Bad health,13,0,0,0,1,2,2,2,4,2,0,0,0,0
S01013481,Very bad health,5,1,0,1,0,0,0,0,2,2,0,0,0,0
