,,All households,One person household: Total,One person household: Aged 65 and over,One person household: Aged under 65,One family household: Total,One family household: All aged 65 and over,One family household: Couple family: Total,One family household: Couple family: No children,One family household: Couple family: With dependent children,One family household: Couple family: All children non-dependent,One family household: Lone parent: Total,One family household: Lone parent: With dependent children,One family household: Lone parent: All children non-dependent,Other household types: Total,Other household types: With dependent children,Other household types: All full-time students,Other household types: All aged 65 and over,Other household types: Other
S92000003,All households,2372777,823314,311867,511447,1418008,178972,975676,415035,409533,151108,263360,170002,93358,131455,36954,20928,5598,67975
S92000003,Occupancy rating +2 or more,903732,246895,116715,130180,634000,116511,480060,249779,169580,60701,37429,19968,17461,22837,7661,832,1621,12723
S92000003,Occupancy rating +1,663261,283991,100490,183501,356829,44358,251891,114512,93531,43848,60580,33916,26664,22441,4929,2312,1464,13736
S92000003,Occupancy rating 0,591439,222645,74735,147910,320700,14232,184958,40450,108442,36066,121510,84414,37096,48094,9624,9976,1701,26793
S92000003,Occupancy rating -1 or less,214345,69783,19927,49856,106479,3871,58767,10294,37980,10493,43841,31704,12137,38083,14740,7808,812,14723
S01006506,All households,424,165,47,118,248,27,191,102,71,18,30,15,15,11,3,0,1,7
S01006506,Occupancy rating +2 or more,151,24,10,14,125,17,102,55,39,8,6,2,4,2,0,0,1,1
S01006506,Occupancy rating +1,143,83,22,61,55,5,48,31,12,5,2,0,2,5,2,0,0,3
S01006506,Occupancy rating 0,97,49,15,34,46,4,27,12,11,4,15,8,7,2,0,0,0,2
S01006506,Occupancy rating -1 or less,33,9,0,9,22,1,14,4,9,1,7,5,2,2,1,0,0,1
S01006507,All households,364,99,53,46,253,32,179,84,73,22,42,22,20,12,6,0,0,6
S01006507,Occupancy rating +2 or more,148,25,15,10,120,15,93,44,41,8,12,5,7,3,1,0,0,2
S01006507,Occupancy rating +1,114,49,21,28,62,14,43,36,4,3,5,2,3,3,2,0,0,1
S01006507,Occupancy rating 0,77,20,14,6,53,3,31,3,20,8,19,12,7,4,2,0,0,2
S01006507,Occupancy rating -1 or less,25,5,3,2,18,0,12,1,8,3,6,3,3,2,1,0,0,1
S01006508,All households,340,151,27,124,181,8,146,81,53,12,27,14,13,8,3,0,0,5
S01006508,Occupancy rating +2 or more,107,31,6,25,73,3,65,33,24,8,5,2,3,3,1,0,0,2
S01006508,Occupancy rating +1,130,78,14,64,50,4,44,37,5,2,2,2,0,2,0,0,0,2
S01006508,Occupancy rating 0,94,41,6,35,53,0,34,11,22,1,19,10,9,0,0,0,0,0
S01006508,Occupancy rating -1 or less,9,1,1,0,5,1,3,0,2,1,1,0,1,3,2,0,0,1
S01006509,All households,274,87,40,47,182,23,121,57,48,16,38,18,20,5,3,0,0,2
S01006509,Occupancy rating +2 or more,71,13,5,8,57,13,42,21,15,6,2,2,0,1,1,0,0,0
S01006509,Occupancy rating +1,94,37,18,19,57,9,41,29,11,1,7,3,4,0,0,0,0,0
S01006509,Occupancy rating 0,94,34,16,18,58,1,35,6,20,9,22,10,12,2,0,0,0,2
S01006509,Occupancy rating -1 or less,15,3,1,2,10,0,3,1,2,0,7,3,4,2,2,0,0,0
S01006510,All households,256,81,39,42,171,29,115,39,53,23,27,13,14,4,1,0,0,3
S01006510,Occupancy rating +2 or more,100,24,12,12,76,16,55,20,24,11,5,1,4,0,0,0,0,0
S01006510,Occupancy rating +1,80,34,20,14,45,10,29,14,10,5,6,4,2,1,0,0,0,1
S01006510,Occupancy rating 0,58,20,7,13,38,2,25,4,16,5,11,6,5,0,0,0,0,0
S01006510,Occupancy rating -1 or less,18,3,0,3,12,1,6,1,3,2,5,2,3,3,1,0,0,2
S01006511,All households,315,77,43,34,233,56,160,63,72,25,17,10,7,5,3,0,0,2
S01006511,Occupancy rating +2 or more,214,45,31,14,165,44,112,53,41,18,9,7,2,4,2,0,0,2
S01006511,Occupancy rating +1,51,12,7,5,39,8,26,9,15,2,5,2,3,0,0,0,0,0
S01006511,Occupancy rating 0,41,18,5,13,23,3,18,1,14,3,2,1,1,0,0,0,0,0
S01006511,Occupancy rating -1 or less,9,2,0,2,6,1,4,0,2,2,1,0,1,1,1,0,0,0
S01006512,All households,170,22,8,14,142,15,116,36,73,7,11,7,4,6,4,0,0,2
S01006512,Occupancy rating +2 or more,134,12,6,6,116,14,96,35,55,6,6,5,1,6,4,0,0,2
S01006512,Occupancy rating +1,16,7,1,6,9,0,7,0,6,1,2,1,1,0,0,0,0,0
S01006512,Occupancy rating 0,14,3,1,2,11,1,8,1,7,0,2,0,2,0,0,0,0,0
S01006512,Occupancy rating -1 or less,6,0,0,0,6,0,5,0,5,0,1,1,0,0,0,0,0,0
S01006513,All households,230,57,38,19,167,32,119,33,67,19,16,8,8,6,1,0,1,4
S01006513,Occupancy rating +2 or more,149,31,21,10,116,23,86,27,46,13,7,5,2,2,0,0,0,2
S01006513,Occupancy rating +1,62,20,13,7,39,8,25,5,17,3,6,3,3,3,0,0,1,2
S01006513,Occupancy rating 0,14,5,4,1,8,1,5,0,2,3,2,0,2,1,1,0,0,0
S01006513,Occupancy rating -1 or less,5,1,0,1,4,0,3,1,2,0,1,0,1,0,0,0,0,0
S01006514,All households,339,51,29,22,278,42,220,65,128,27,16,6,10,10,5,0,0,5
S01006514,Occupancy rating +2 or more,284,34,21,13,245,36,197,62,111,24,12,5,7,5,3,0,0,2
S01006514,Occupancy rating +1,42,16,8,8,24,6,15,2,12,1,3,0,3,2,0,0,0,2
S01006514,Occupancy rating 0,11,1,0,1,8,0,7,1,4,2,1,1,0,2,1,0,0,1
S01006514,Occupancy rating -1 or less,2,0,0,0,1,0,1,0,1,0,0,0,0,1,1,0,0,0
S01006515,All households,271,40,22,18,227,29,180,53,99,28,18,12,6,4,1,1,0,2
S01006515,Occupancy rating +2 or more,224,33,18,15,190,28,154,48,82,24,8,4,4,1,0,0,0,1
S01006515,Occupancy rating +1,27,7,4,3,20,0,17,5,9,3,3,2,1,0,0,0,0,0
S01006515,Occupancy rating 0,13,0,0,0,11,1,6,0,5,1,4,3,1,2,1,1,0,0
S01006515,Occupancy rating -1 or less,7,0,0,0,6,0,3,0,3,0,3,3,0,1,0,0,0,1
S01006516,All households,185,40,29,11,135,16,110,49,42,19,9,4,5,10,3,1,0,6
S01006516,Occupancy rating +2 or more,159,35,26,9,117,14,95,42,36,17,8,4,4,7,2,0,0,5
S01006516,Occupancy rating +1,17,3,2,1,12,1,11,6,4,1,0,0,0,2,1,0,0,1
S01006516,Occupancy rating 0,5,1,1,0,4,1,2,1,1,0,1,0,1,0,0,0,0,0
S01006516,Occupancy rating -1 or less,4,1,0,1,2,0,2,0,1,1,0,0,0,1,0,1,0,0
S01006517,All households,403,86,44,42,303,46,223,81,112,30,34,15,19,14,5,0,2,7
S01006517,Occupancy rating +2 or more,290,45,24,21,238,37,186,71,92,23,15,5,10,7,2,0,1,4
S01006517,Occupancy rating +1,63,27,11,16,34,6,23,7,12,4,5,1,4,2,1,0,0,1
S01006517,Occupancy rating 0,33,6,2,4,23,3,8,1,5,2,12,8,4,4,1,0,1,2
S01006517,Occupancy rating -1 or less,17,8,7,1,8,0,6,2,3,1,2,1,1,1,1,0,0,0
S01006518,All households,247,46,28,18,196,43,141,48,69,24,12,7,5,5,3,0,0,2
S01006518,Occupancy rating +2 or more,220,41,27,14,176,42,127,46,61,20,7,4,3,3,2,0,0,1
S01006518,Occupancy rating +1,19,4,1,3,14,1,10,0,7,3,3,2,1,1,1,0,0,0
S01006518,Occupancy rating 0,7,1,0,1,6,0,4,2,1,1,2,1,1,0,0,0,0,0
S01006518,Occupancy rating -1 or less,1,0,0,0,0,0,0,0,0,0,0,0,0,1,0,0,0,1
S01006519,All households,281,30,14,16,242,30,191,66,94,31,21,13,8,9,8,0,0,1
S01006519,Occupancy rating +2 or more,250,29,14,15,219,29,173,64,83,26,17,9,8,2,1,0,0,1
S01006519,Occupancy rating +1,19,1,0,1,15,1,11,1,8,2,3,3,0,3,3,0,0,0
S01006519,Occupancy rating 0,9,0,0,0,7,0,6,0,3,3,1,1,0,2,2,0,0,0
S01006519,Occupancy rating -1 or less,3,0,0,0,1,0,1,1,0,0,0,0,0,2,2,0,0,0
S01006520,All households,222,16,5,11,197,11,176,47,112,17,10,8,2,9,5,0,0,4
S01006520,Occupancy rating +2 or more,213,16,5,11,190,11,170,45,108,17,9,8,1,7,4,0,0,3
S01006520,Occupancy rating +1,6,0,0,0,5,0,4,2,2,0,1,0,1,1,0,0,0,1
S01006520,Occupancy rating 0,1,0,0,0,1,0,1,0,1,0,0,0,0,0,0,0,0,0
S01006520,Occupancy rating -1 or less,2,0,0,0,1,0,1,0,1,0,0,0,0,1,1,0,0,0
S01006521,All households,243,35,8,27,201,18,168,59,93,16,15,7,8,7,3,0,0,4
S01006521,Occupancy rating +2 or more,205,25,7,18,176,17,148,51,84,13,11,5,6,4,1,0,0,3
S01006521,Occupancy rating +1,25,6,1,5,19,1,14,7,5,2,4,2,2,0,0,0,0,0
S01006521,Occupancy rating 0,11,4,0,4,5,0,5,1,3,1,0,0,0,2,2,0,0,0
S01006521,Occupancy rating -1 or less,2,0,0,0,1,0,1,0,1,0,0,0,0,1,0,0,0,1
S01006522,All households,218,40,24,16,173,26,139,45,78,16,8,7,1,5,2,0,0,3
S01006522,Occupancy rating +2 or more,194,34,21,13,157,25,127,43,69,15,5,4,1,3,2,0,0,1
S01006522,Occupancy rating +1,20,5,2,3,15,1,11,2,8,1,3,3,0,0,0,0,0,0
S01006522,Occupancy rating 0,1,0,0,0,0,0,0,0,0,0,0,0,0,1,0,0,0,1
S01006522,Occupancy rating -1 or less,3,1,1,0,1,0,1,0,1,0,0,0,0,1,0,0,0,1
S01006523,All households,427,156,83,73,253,43,185,66,96,23,25,16,9,18,6,0,2,10
S01006523,Occupancy rating +2 or more,236,51,27,24,176,30,141,50,72,19,5,3,2,9,2,0,2,5
S01006523,Occupancy rating +1,130,76,39,37,52,13,27,12,12,3,12,7,5,2,0,0,0,2
S01006523,Occupancy rating 0,55,28,17,11,22,0,16,3,12,1,6,4,2,5,3,0,0,2
S01006523,Occupancy rating -1 or less,6,1,0,1,3,0,1,1,0,0,2,2,0,2,1,0,0,1
S01006524,All households,314,111,67,44,192,38,134,54,64,16,20,10,10,11,4,1,0,6
S01006524,Occupancy rating +2 or more,180,33,23,10,141,27,106,41,53,12,8,2,6,6,3,0,0,3
S01006524,Occupancy rating +1,71,44,24,20,26,4,18,13,3,2,4,3,1,1,0,0,0,1
S01006524,Occupancy rating 0,54,29,17,12,23,7,9,0,7,2,7,4,3,2,0,1,0,1
S01006524,Occupancy rating -1 or less,9,5,3,2,2,0,1,0,1,0,1,1,0,2,1,0,0,1
S01006525,All households,339,93,44,49,235,57,158,54,78,26,20,13,7,11,4,2,0,5
S01006525,Occupancy rating +2 or more,219,45,26,19,169,47,116,44,52,20,6,1,5,5,3,0,0,2
S01006525,Occupancy rating +1,72,34,9,25,34,5,24,7,15,2,5,3,2,4,1,1,0,2
S01006525,Occupancy rating 0,39,14,9,5,23,3,15,2,9,4,5,5,0,2,0,1,0,1
S01006525,Occupancy rating -1 or less,9,0,0,0,9,2,3,1,2,0,4,4,0,0,0,0,0,0
S01006526,All households,439,169,88,81,213,31,129,57,52,20,53,30,23,57,8,28,2,19
S01006526,Occupancy rating +2 or more,86,46,23,23,37,14,22,17,2,3,1,0,1,3,0,0,0,3
S01006526,Occupancy rating +1,137,55,15,40,74,6,60,31,23,6,8,0,8,8,0,6,0,2
S01006526,Occupancy rating 0,163,59,46,13,78,10,36,8,21,7,32,23,9,26,1,13,1,11
S01006526,Occupancy rating -1 or less,53,9,4,5,24,1,11,1,6,4,12,7,5,20,7,9,1,3
S01006527,All households,286,87,46,41,170,14,114,38,49,27,42,27,15,29,6,4,2,17
S01006527,Occupancy rating +2 or more,93,27,14,13,62,9,44,24,10,10,9,2,7,4,1,0,1,2
S01006527,Occupancy rating +1,80,24,15,9,46,3,32,7,15,10,11,8,3,10,1,2,0,7
S01006527,Occupancy rating 0,89,32,14,18,46,1,31,5,20,6,14,12,2,11,2,0,1,8
S01006527,Occupancy rating -1 or less,24,4,3,1,16,1,7,2,4,1,8,5,3,4,2,2,0,0
S01006528,All households,433,139,70,69,236,36,152,61,66,25,48,26,22,58,8,27,1,22
S01006528,Occupancy rating +2 or more,139,54,25,29,81,27,48,33,8,7,6,3,3,4,0,3,0,1
S01006528,Occupancy rating +1,107,36,23,13,61,5,44,18,17,9,12,4,8,10,0,3,1,6
S01006528,Occupancy rating 0,142,43,19,24,68,4,37,9,22,6,27,16,11,31,6,12,0,13
S01006528,Occupancy rating -1 or less,45,6,3,3,26,0,23,1,19,3,3,3,0,13,2,9,0,2
S01006529,All households,496,256,86,170,180,23,126,62,53,11,31,15,16,60,4,27,0,29
S01006529,Occupancy rating +2 or more,95,49,21,28,45,9,32,18,12,2,4,2,2,1,1,0,0,0
S01006529,Occupancy rating +1,115,57,14,43,55,6,40,20,15,5,9,3,6,3,0,1,0,2
S01006529,Occupancy rating 0,190,86,37,49,61,8,38,19,17,2,15,8,7,43,3,21,0,19
S01006529,Occupancy rating -1 or less,96,64,14,50,19,0,16,5,9,2,3,2,1,13,0,5,0,8
S01006530,All households,356,133,44,89,172,18,109,55,34,20,45,18,27,51,8,14,3,26
S01006530,Occupancy rating +2 or more,122,54,20,34,67,14,48,37,4,7,5,1,4,1,0,0,0,1
S01006530,Occupancy rating +1,85,25,4,21,49,3,25,8,11,6,21,7,14,11,1,4,1,5
S01006530,Occupancy rating 0,116,47,18,29,41,1,29,9,14,6,11,7,4,28,3,9,1,15
S01006530,Occupancy rating -1 or less,33,7,2,5,15,0,7,1,5,1,8,3,5,11,4,1,1,5
S01006531,All households,429,174,76,98,206,27,128,43,60,25,51,30,21,49,8,19,0,22
S01006531,Occupancy rating +2 or more,84,44,22,22,38,12,25,17,5,3,1,1,0,2,0,1,0,1
S01006531,Occupancy rating +1,102,30,11,19,62,8,41,10,21,10,13,4,9,10,0,3,0,7
S01006531,Occupancy rating 0,191,92,40,52,74,7,45,16,19,10,22,17,5,25,3,10,0,12
S01006531,Occupancy rating -1 or less,52,8,3,5,32,0,17,0,15,2,15,8,7,12,5,5,0,2
S01006532,All households,337,126,74,52,186,37,131,61,53,17,18,8,10,25,5,11,3,6
S01006532,Occupancy rating +2 or more,171,41,27,14,122,27,91,46,36,9,4,1,3,8,2,3,1,2
S01006532,Occupancy rating +1,88,41,7,34,43,8,25,12,8,5,10,5,5,4,0,1,1,2
S01006532,Occupancy rating 0,70,41,37,4,19,2,13,3,8,2,4,2,2,10,2,6,0,2
S01006532,Occupancy rating -1 or less,8,3,3,0,2,0,2,0,1,1,0,0,0,3,1,1,1,0
S01006533,All households,305,88,37,51,200,31,158,64,73,21,11,4,7,17,3,5,0,9
S01006533,Occupancy rating +2 or more,235,66,32,34,160,29,127,55,56,16,4,3,1,9,3,1,0,5
S01006533,Occupancy rating +1,53,19,4,15,31,2,22,6,12,4,7,1,6,3,0,2,0,1
S01006533,Occupancy rating 0,15,2,1,1,9,0,9,3,5,1,0,0,0,4,0,2,0,2
S01006533,Occupancy rating -1 or less,2,1,0,1,0,0,0,0,0,0,0,0,0,1,0,0,0,1
S01006534,All households,398,117,32,85,264,35,214,90,105,19,15,9,6,17,2,3,2,10
S01006534,Occupancy rating +2 or more,261,62,25,37,196,29,160,63,83,14,7,5,2,3,1,0,2,0
S01006534,Occupancy rating +1,92,35,6,29,53,6,45,23,18,4,2,2,0,4,0,0,0,4
S01006534,Occupancy rating 0,32,13,1,12,13,0,7,3,3,1,6,2,4,6,0,1,0,5
S01006534,Occupancy rating -1 or less,13,7,0,7,2,0,2,1,1,0,0,0,0,4,1,2,0,1
S01006535,All households,564,268,34,234,272,23,220,128,77,15,29,10,19,24,3,8,0,13
S01006535,Occupancy rating +2 or more,170,47,14,33,118,14,93,44,41,8,11,2,9,5,2,0,0,3
S01006535,Occupancy rating +1,98,50,8,42,47,3,38,23,11,4,6,2,4,1,1,0,0,0
S01006535,Occupancy rating 0,238,141,9,132,87,5,74,56,15,3,8,3,5,10,0,5,0,5
S01006535,Occupancy rating -1 or less,58,30,3,27,20,1,15,5,10,0,4,3,1,8,0,3,0,5
S01006536,All households,589,312,46,266,230,11,205,129,66,10,14,6,8,47,5,9,0,33
S01006536,Occupancy rating +2 or more,150,55,12,43,89,6,81,37,37,7,2,0,2,6,2,0,0,4
S01006536,Occupancy rating +1,103,60,14,46,38,3,32,27,3,2,3,1,2,5,0,1,0,4
S01006536,Occupancy rating 0,247,149,14,135,82,1,76,58,17,1,5,4,1,16,0,5,0,11
S01006536,Occupancy rating -1 or less,89,48,6,42,21,1,16,7,9,0,4,1,3,20,3,3,0,14
S01006537,All households,341,100,57,43,234,63,156,61,74,21,15,3,12,7,4,0,2,1
S01006537,Occupancy rating +2 or more,263,75,46,29,183,52,122,53,54,15,9,2,7,5,3,0,1,1
S01006537,Occupancy rating +1,48,18,8,10,30,10,18,6,9,3,2,1,1,0,0,0,0,0
S01006537,Occupancy rating 0,24,7,3,4,16,1,13,2,8,3,2,0,2,1,1,0,0,0
S01006537,Occupancy rating -1 or less,6,0,0,0,5,0,3,0,3,0,2,0,2,1,0,0,1,0
S01006538,All households,240,52,32,20,181,37,130,58,53,19,14,5,9,7,1,0,1,5
S01006538,Occupancy rating +2 or more,184,41,26,15,138,34,97,48,35,14,7,2,5,5,0,0,1,4
S01006538,Occupancy rating +1,36,9,5,4,27,3,19,5,11,3,5,2,3,0,0,0,0,0
S01006538,Occupancy rating 0,15,0,0,0,14,0,12,5,5,2,2,1,1,1,0,0,0,1
S01006538,Occupancy rating -1 or less,5,2,1,1,2,0,2,0,2,0,0,0,0,1,1,0,0,0
S01006539,All households,330,105,54,51,212,36,159,79,70,10,17,9,8,13,4,3,2,4
S01006539,Occupancy rating +2 or more,215,52,32,20,159,30,122,71,44,7,7,3,4,4,2,0,1,1
S01006539,Occupancy rating +1,79,42,17,25,35,5,25,6,16,3,5,3,2,2,1,0,1,0
S01006539,Occupancy rating 0,29,8,3,5,14,1,9,2,7,0,4,2,2,7,1,3,0,3
S01006539,Occupancy rating -1 or less,7,3,2,1,4,0,3,0,3,0,1,1,0,0,0,0,0,0
S01006540,All households,451,149,46,103,281,49,218,101,95,22,14,6,8,21,2,4,0,15
S01006540,Occupancy rating +2 or more,283,78,36,42,199,44,151,73,60,18,4,2,2,6,0,0,0,6
S01006540,Occupancy rating +1,78,34,8,26,43,5,34,16,16,2,4,2,2,1,0,0,0,1
S01006540,Occupancy rating 0,68,30,2,28,32,0,26,11,13,2,6,2,4,6,0,2,0,4
S01006540,Occupancy rating -1 or less,22,7,0,7,7,0,7,1,6,0,0,0,0,8,2,2,0,4
S01006541,All households,392,157,125,32,225,47,168,73,73,22,10,4,6,10,2,0,4,4
S01006541,Occupancy rating +2 or more,254,71,52,19,179,41,134,67,52,15,4,2,2,4,0,0,3,1
S01006541,Occupancy rating +1,56,23,10,13,32,3,26,6,16,4,3,2,1,1,0,0,0,1
S01006541,Occupancy rating 0,75,61,61,0,11,3,6,0,4,2,2,0,2,3,1,0,0,2
S01006541,Occupancy rating -1 or less,7,2,2,0,3,0,2,0,1,1,1,0,1,2,1,0,1,0
S01006542,All households,496,172,81,91,312,82,207,105,82,20,23,10,13,12,2,0,1,9
S01006542,Occupancy rating +2 or more,295,70,40,30,222,54,157,83,60,14,11,5,6,3,0,0,1,2
S01006542,Occupancy rating +1,148,89,35,54,59,23,32,19,10,3,4,2,2,0,0,0,0,0
S01006542,Occupancy rating 0,43,12,5,7,24,5,14,0,11,3,5,1,4,7,1,0,0,6
S01006542,Occupancy rating -1 or less,10,1,1,0,7,0,4,3,1,0,3,2,1,2,1,0,0,1
S01006543,All households,363,106,72,34,249,65,170,68,73,29,14,6,8,8,3,0,0,5
S01006543,Occupancy rating +2 or more,245,55,38,17,187,54,127,56,54,17,6,2,4,3,0,0,0,3
S01006543,Occupancy rating +1,89,43,30,13,43,10,29,10,12,7,4,1,3,3,2,0,0,1
S01006543,Occupancy rating 0,27,7,3,4,19,1,14,2,7,5,4,3,1,1,0,0,0,1
S01006543,Occupancy rating -1 or less,2,1,1,0,0,0,0,0,0,0,0,0,0,1,1,0,0,0
S01006544,All households,507,192,42,150,279,33,221,119,85,17,25,11,14,36,2,4,1,29
S01006544,Occupancy rating +2 or more,257,61,27,34,189,31,145,80,51,14,13,3,10,7,0,0,1,6
S01006544,Occupancy rating +1,89,52,11,41,34,0,30,15,15,0,4,3,1,3,0,1,0,2
S01006544,Occupancy rating 0,119,71,4,67,39,2,33,23,9,1,4,2,2,9,0,0,0,9
S01006544,Occupancy rating -1 or less,42,8,0,8,17,0,13,1,10,2,4,3,1,17,2,3,0,12
S01006545,All households,586,288,132,156,273,57,195,103,73,19,21,12,9,25,5,5,1,14
S01006545,Occupancy rating +2 or more,259,83,36,47,171,38,122,69,42,11,11,5,6,5,1,0,0,4
S01006545,Occupancy rating +1,146,86,33,53,55,10,42,24,14,4,3,2,1,5,2,0,1,2
S01006545,Occupancy rating 0,151,106,59,47,36,8,24,8,12,4,4,3,1,9,0,4,0,5
S01006545,Occupancy rating -1 or less,30,13,4,9,11,1,7,2,5,0,3,2,1,6,2,1,0,3
S01006546,All households,262,70,45,25,181,36,139,51,68,20,6,4,2,11,4,1,2,4
S01006546,Occupancy rating +2 or more,225,63,42,21,154,34,117,44,57,16,3,2,1,8,3,0,2,3
S01006546,Occupancy rating +1,29,7,3,4,20,1,17,6,8,3,2,2,0,2,1,0,0,1
S01006546,Occupancy rating 0,7,0,0,0,6,1,4,1,2,1,1,0,1,1,0,1,0,0
S01006546,Occupancy rating -1 or less,1,0,0,0,1,0,1,0,1,0,0,0,0,0,0,0,0,0
S01006547,All households,442,177,102,75,246,52,162,69,68,25,32,15,17,19,9,0,2,8
S01006547,Occupancy rating +2 or more,172,30,15,15,136,23,104,49,38,17,9,2,7,6,2,0,1,3
S01006547,Occupancy rating +1,135,72,46,26,61,23,34,13,18,3,4,2,2,2,0,0,0,2
S01006547,Occupancy rating 0,106,60,32,28,40,4,22,7,10,5,14,8,6,6,2,0,1,3
S01006547,Occupancy rating -1 or less,29,15,9,6,9,2,2,0,2,0,5,3,2,5,5,0,0,0
S01006548,All households,312,71,50,21,236,71,153,60,70,23,12,2,10,5,1,0,1,3
S01006548,Occupancy rating +2 or more,255,61,46,15,190,67,115,52,47,16,8,1,7,4,1,0,1,2
S01006548,Occupancy rating +1,42,8,3,5,33,4,27,6,15,6,2,1,1,1,0,0,0,1
S01006548,Occupancy rating 0,11,1,1,0,10,0,9,2,6,1,1,0,1,0,0,0,0,0
S01006548,Occupancy rating -1 or less,4,1,0,1,3,0,2,0,2,0,1,0,1,0,0,0,0,0
S01006549,All households,366,108,46,62,245,59,176,84,73,19,10,2,8,13,3,0,1,9
S01006549,Occupancy rating +2 or more,278,66,34,32,209,55,147,72,59,16,7,1,6,3,0,0,1,2
S01006549,Occupancy rating +1,53,30,10,20,21,3,18,9,7,2,0,0,0,2,0,0,0,2
S01006549,Occupancy rating 0,25,10,2,8,11,1,8,2,6,0,2,1,1,4,0,0,0,4
S01006549,Occupancy rating -1 or less,10,2,0,2,4,0,3,1,1,1,1,0,1,4,3,0,0,1
S01006550,All households,389,79,48,31,301,74,211,97,85,29,16,5,11,9,4,1,0,4
S01006550,Occupancy rating +2 or more,338,71,47,24,264,70,183,91,69,23,11,3,8,3,0,0,0,3
S01006550,Occupancy rating +1,42,8,1,7,33,3,26,4,16,6,4,2,2,1,1,0,0,0
S01006550,Occupancy rating 0,5,0,0,0,4,1,2,2,0,0,1,0,1,1,0,1,0,0
S01006550,Occupancy rating -1 or less,4,0,0,0,0,0,0,0,0,0,0,0,0,4,3,0,0,1
S01006551,All households,392,220,99,121,162,36,93,36,45,12,33,24,9,10,4,0,0,6
S01006551,Occupancy rating +2 or more,69,20,8,12,47,5,35,9,19,7,7,6,1,2,2,0,0,0
S01006551,Occupancy rating +1,154,98,59,39,56,29,25,18,5,2,2,2,0,0,0,0,0,0
S01006551,Occupancy rating 0,108,57,15,42,48,2,26,8,16,2,20,14,6,3,1,0,0,2
S01006551,Occupancy rating -1 or less,61,45,17,28,11,0,7,1,5,1,4,2,2,5,1,0,0,4
S01006552,All households,417,136,44,92,265,38,184,97,67,20,43,21,22,16,3,0,0,13
S01006552,Occupancy rating +2 or more,250,83,37,46,166,36,116,65,38,13,14,4,10,1,0,0,0,1
S01006552,Occupancy rating +1,113,42,3,39,67,1,53,31,17,5,13,7,6,4,3,0,0,1
S01006552,Occupancy rating 0,48,10,4,6,28,1,13,1,10,2,14,8,6,10,0,0,0,10
S01006552,Occupancy rating -1 or less,6,1,0,1,4,0,2,0,2,0,2,2,0,1,0,0,0,1
S01006553,All households,407,161,119,42,231,63,147,64,61,22,21,16,5,15,5,0,3,7
S01006553,Occupancy rating +2 or more,208,65,42,23,139,42,90,55,24,11,7,5,2,4,0,0,2,2
S01006553,Occupancy rating +1,81,36,21,15,42,14,26,9,13,4,2,1,1,3,1,0,0,2
S01006553,Occupancy rating 0,100,56,52,4,41,7,25,0,19,6,9,7,2,3,1,0,0,2
S01006553,Occupancy rating -1 or less,18,4,4,0,9,0,6,0,5,1,3,3,0,5,3,0,1,1
S01006554,All households,330,107,45,62,206,39,139,70,46,23,28,19,9,17,2,0,1,14
S01006554,Occupancy rating +2 or more,126,38,24,14,88,29,54,28,18,8,5,2,3,0,0,0,0,0
S01006554,Occupancy rating +1,84,43,15,28,40,7,30,22,6,2,3,1,2,1,0,0,0,1
S01006554,Occupancy rating 0,90,24,6,18,58,3,41,17,13,11,14,12,2,8,0,0,1,7
S01006554,Occupancy rating -1 or less,30,2,0,2,20,0,14,3,9,2,6,4,2,8,2,0,0,6
S01006555,All households,374,152,25,127,196,11,130,57,61,12,55,45,10,26,4,3,1,18
S01006555,Occupancy rating +2 or more,65,33,11,22,30,6,23,21,2,0,1,1,0,2,1,1,0,0
S01006555,Occupancy rating +1,123,63,5,58,57,2,48,30,14,4,7,5,2,3,0,1,0,2
S01006555,Occupancy rating 0,133,42,9,33,78,3,44,3,34,7,31,24,7,13,1,0,0,12
S01006555,Occupancy rating -1 or less,53,14,0,14,31,0,15,3,11,1,16,15,1,8,2,1,1,4
S01006556,All households,399,146,85,61,237,41,145,55,56,34,51,28,23,16,5,1,0,10
S01006556,Occupancy rating +2 or more,48,12,6,6,35,9,25,15,6,4,1,0,1,1,1,0,0,0
S01006556,Occupancy rating +1,134,55,34,21,72,22,44,30,9,5,6,3,3,7,0,1,0,6
S01006556,Occupancy rating 0,174,74,41,33,97,7,58,8,31,19,32,19,13,3,0,0,0,3
S01006556,Occupancy rating -1 or less,43,5,4,1,33,3,18,2,10,6,12,6,6,5,4,0,0,1
S01006557,All households,338,133,54,79,193,18,125,46,51,28,50,31,19,12,2,0,0,10
S01006557,Occupancy rating +2 or more,60,18,9,9,41,5,33,17,7,9,3,1,2,1,0,0,0,1
S01006557,Occupancy rating +1,107,49,17,32,57,3,44,20,11,13,10,4,6,1,0,0,0,1
S01006557,Occupancy rating 0,141,62,25,37,73,10,34,8,23,3,29,20,9,6,0,0,0,6
S01006557,Occupancy rating -1 or less,30,4,3,1,22,0,14,1,10,3,8,6,2,4,2,0,0,2
S01006558,All households,354,180,54,126,150,14,125,70,41,14,11,4,7,24,1,7,0,16
S01006558,Occupancy rating +2 or more,120,40,18,22,73,9,59,26,24,9,5,1,4,7,0,4,0,3
S01006558,Occupancy rating +1,60,23,8,15,35,4,29,18,7,4,2,1,1,2,0,0,0,2
S01006558,Occupancy rating 0,140,98,27,71,35,1,32,24,7,1,2,1,1,7,0,3,0,4
S01006558,Occupancy rating -1 or less,34,19,1,18,7,0,5,2,3,0,2,1,1,8,1,0,0,7
S01006559,All households,272,90,36,54,160,13,133,62,62,9,14,9,5,22,3,12,0,7
S01006559,Occupancy rating +2 or more,156,31,14,17,117,9,100,49,44,7,8,5,3,8,2,3,0,3
S01006559,Occupancy rating +1,50,27,8,19,20,3,15,8,6,1,2,0,2,3,0,1,0,2
S01006559,Occupancy rating 0,49,29,12,17,15,1,12,4,8,0,2,2,0,5,1,3,0,1
S01006559,Occupancy rating -1 or less,17,3,2,1,8,0,6,1,4,1,2,2,0,6,0,5,0,1
S01006560,All households,432,151,80,71,252,35,195,69,109,17,22,12,10,29,5,2,0,22
S01006560,Occupancy rating +2 or more,263,57,27,30,195,23,161,57,91,13,11,5,6,11,2,0,0,9
S01006560,Occupancy rating +1,75,35,13,22,32,5,20,7,12,1,7,4,3,8,1,0,0,7
S01006560,Occupancy rating 0,77,51,36,15,19,6,10,4,4,2,3,3,0,7,1,1,0,5
S01006560,Occupancy rating -1 or less,17,8,4,4,6,1,4,1,2,1,1,0,1,3,1,1,0,1
S01006561,All households,323,94,44,50,218,28,168,65,80,23,22,14,8,11,5,3,0,3
S01006561,Occupancy rating +2 or more,246,72,35,37,171,25,132,55,59,18,14,9,5,3,2,0,0,1
S01006561,Occupancy rating +1,52,14,5,9,32,2,25,9,13,3,5,3,2,6,3,3,0,0
S01006561,Occupancy rating 0,16,4,1,3,11,1,8,1,6,1,2,1,1,1,0,0,0,1
S01006561,Occupancy rating -1 or less,9,4,3,1,4,0,3,0,2,1,1,1,0,1,0,0,0,1
S01006562,All households,334,125,55,70,200,41,135,51,54,30,24,18,6,9,2,1,0,6
S01006562,Occupancy rating +2 or more,183,48,31,17,132,35,87,36,34,17,10,8,2,3,1,0,0,2
S01006562,Occupancy rating +1,51,17,6,11,31,1,27,8,11,8,3,2,1,3,0,1,0,2
S01006562,Occupancy rating 0,62,32,13,19,28,3,20,6,9,5,5,4,1,2,1,0,0,1
S01006562,Occupancy rating -1 or less,38,28,5,23,9,2,1,1,0,0,6,4,2,1,0,0,0,1
S01006563,All households,366,120,48,72,218,39,157,63,79,15,22,10,12,28,9,4,1,14
S01006563,Occupancy rating +2 or more,181,50,24,26,128,27,96,40,46,10,5,4,1,3,1,0,0,2
S01006563,Occupancy rating +1,79,29,12,17,47,6,32,14,16,2,9,4,5,3,0,1,0,2
S01006563,Occupancy rating 0,79,38,12,26,32,6,20,8,10,2,6,1,5,9,3,1,0,5
S01006563,Occupancy rating -1 or less,27,3,0,3,11,0,9,1,7,1,2,1,1,13,5,2,1,5
S01006564,All households,578,307,51,256,196,16,126,79,38,9,54,30,24,75,7,24,2,42
S01006564,Occupancy rating +2 or more,35,15,3,12,18,1,15,11,3,1,2,1,1,2,1,0,0,1
S01006564,Occupancy rating +1,149,93,20,73,54,10,40,32,6,2,4,1,3,2,0,1,0,1
S01006564,Occupancy rating 0,290,147,26,121,98,5,55,29,20,6,38,22,16,45,1,14,1,29
S01006564,Occupancy rating -1 or less,104,52,2,50,26,0,16,7,9,0,10,6,4,26,5,9,1,11
S01006565,All households,565,340,34,306,145,6,124,95,25,4,15,9,6,80,0,26,1,53
S01006565,Occupancy rating +2 or more,26,15,1,14,10,3,7,6,0,1,0,0,0,1,0,0,0,1
S01006565,Occupancy rating +1,77,48,7,41,25,2,21,18,1,2,2,1,1,4,0,2,0,2
S01006565,Occupancy rating 0,301,197,22,175,68,1,57,47,9,1,10,8,2,36,0,13,1,22
S01006565,Occupancy rating -1 or less,161,80,4,76,42,0,39,24,15,0,3,0,3,39,0,11,0,28
S01006566,All households,437,215,20,195,171,11,139,96,37,6,21,9,12,51,1,18,2,30
S01006566,Occupancy rating +2 or more,92,31,10,21,56,6,45,29,14,2,5,1,4,5,0,3,0,2
S01006566,Occupancy rating +1,126,75,4,71,45,3,39,31,5,3,3,2,1,6,0,3,0,3
S01006566,Occupancy rating 0,174,88,4,84,58,2,47,35,11,1,9,6,3,28,0,11,1,16
S01006566,Occupancy rating -1 or less,45,21,2,19,12,0,8,1,7,0,4,0,4,12,1,1,1,9
S01006567,All households,552,337,59,278,146,10,114,91,15,8,22,14,8,69,2,38,0,29
S01006567,Occupancy rating +2 or more,30,9,0,9,18,2,14,9,5,0,2,1,1,3,0,1,0,2
S01006567,Occupancy rating +1,118,69,14,55,45,3,38,33,2,3,4,3,1,4,0,1,0,3
S01006567,Occupancy rating 0,262,164,36,128,59,5,45,38,4,3,9,4,5,39,0,27,0,12
S01006567,Occupancy rating -1 or less,142,95,9,86,24,0,17,11,4,2,7,6,1,23,2,9,0,12
S01006568,All households,575,306,14,292,196,3,185,148,34,3,8,5,3,73,2,31,1,39
S01006568,Occupancy rating +2 or more,63,20,1,19,37,1,35,23,11,1,1,1,0,6,1,1,1,3
S01006568,Occupancy rating +1,99,47,3,44,45,1,42,39,3,0,2,1,1,7,0,3,0,4
S01006568,Occupancy rating 0,300,175,7,168,89,1,85,74,10,1,3,2,1,36,0,15,0,21
S01006568,Occupancy rating -1 or less,113,64,3,61,25,0,23,12,10,1,2,1,1,24,1,12,0,11
S01006569,All households,311,154,27,127,130,11,107,59,44,4,12,6,6,27,2,8,0,17
S01006569,Occupancy rating +2 or more,86,27,8,19,57,10,43,16,24,3,4,2,2,2,1,0,0,1
S01006569,Occupancy rating +1,41,13,1,12,25,0,23,15,7,1,2,2,0,3,0,1,0,2
S01006569,Occupancy rating 0,125,77,1,76,36,1,30,23,7,0,5,1,4,12,0,4,0,8
S01006569,Occupancy rating -1 or less,59,37,17,20,12,0,11,5,6,0,1,1,0,10,1,3,0,6
S01006570,All households,371,139,35,104,199,22,159,72,77,10,18,10,8,33,4,10,0,19
S01006570,Occupancy rating +2 or more,181,58,25,33,118,17,94,40,49,5,7,3,4,5,2,0,0,3
S01006570,Occupancy rating +1,79,39,7,32,35,4,28,18,8,2,3,2,1,5,0,2,0,3
S01006570,Occupancy rating 0,88,34,3,31,36,1,29,12,14,3,6,5,1,18,0,5,0,13
S01006570,Occupancy rating -1 or less,23,8,0,8,10,0,8,2,6,0,2,0,2,5,2,3,0,0
S01006571,All households,427,160,36,124,235,21,196,99,79,18,18,7,11,32,2,13,0,17
S01006571,Occupancy rating +2 or more,241,75,18,57,165,20,136,67,56,13,9,3,6,1,1,0,0,0
S01006571,Occupancy rating +1,75,41,10,31,31,0,29,20,6,3,2,1,1,3,0,1,0,2
S01006571,Occupancy rating 0,89,39,6,33,31,1,26,12,12,2,4,2,2,19,0,9,0,10
S01006571,Occupancy rating -1 or less,22,5,2,3,8,0,5,0,5,0,3,1,2,9,1,3,0,5
S01006572,All households,374,107,39,68,257,42,197,69,110,18,18,10,8,10,5,1,0,4
S01006572,Occupancy rating +2 or more,300,74,35,39,219,38,169,61,93,15,12,6,6,7,5,0,0,2
S01006572,Occupancy rating +1,53,30,4,26,22,1,18,7,10,1,3,2,1,1,0,0,0,1
S01006572,Occupancy rating 0,12,1,0,1,9,2,6,1,5,0,1,0,1,2,0,1,0,1
S01006572,Occupancy rating -1 or less,9,2,0,2,7,1,4,0,2,2,2,2,0,0,0,0,0,0
S01006573,All households,290,79,30,49,197,14,165,61,91,13,18,10,8,14,1,4,0,9
S01006573,Occupancy rating +2 or more,222,51,24,27,162,13,136,45,82,9,13,9,4,9,1,2,0,6
S01006573,Occupancy rating +1,45,18,4,14,25,1,20,12,5,3,4,1,3,2,0,2,0,0
S01006573,Occupancy rating 0,16,7,1,6,8,0,7,3,3,1,1,0,1,1,0,0,0,1
S01006573,Occupancy rating -1 or less,7,3,1,2,2,0,2,1,1,0,0,0,0,2,0,0,0,2
S01006574,All households,427,144,36,108,264,25,214,94,102,18,25,11,14,19,2,3,0,14
S01006574,Occupancy rating +2 or more,285,67,26,41,208,23,171,74,83,14,14,5,9,10,2,2,0,6
S01006574,Occupancy rating +1,82,49,7,42,31,0,28,15,9,4,3,2,1,2,0,0,0,2
S01006574,Occupancy rating 0,48,25,2,23,16,1,11,4,7,0,4,1,3,7,0,1,0,6
S01006574,Occupancy rating -1 or less,12,3,1,2,9,1,4,1,3,0,4,3,1,0,0,0,0,0
S01006575,All households,399,121,29,92,243,26,191,79,97,15,26,17,9,35,5,7,0,23
S01006575,Occupancy rating +2 or more,206,52,21,31,148,20,118,41,67,10,10,4,6,6,3,1,0,2
S01006575,Occupancy rating +1,99,40,6,34,56,4,46,28,15,3,6,6,0,3,0,0,0,3
S01006575,Occupancy rating 0,80,27,2,25,31,0,21,8,11,2,10,7,3,22,1,6,0,15
S01006575,Occupancy rating -1 or less,14,2,0,2,8,2,6,2,4,0,0,0,0,4,1,0,0,3
S01006576,All households,325,117,23,94,184,20,149,58,82,9,15,9,6,24,2,7,0,15
S01006576,Occupancy rating +2 or more,167,42,19,23,123,14,101,37,56,8,8,6,2,2,0,1,0,1
S01006576,Occupancy rating +1,49,18,2,16,25,2,20,9,11,0,3,1,2,6,1,2,0,3
S01006576,Occupancy rating 0,84,43,2,41,33,4,26,11,14,1,3,2,1,8,0,2,0,6
S01006576,Occupancy rating -1 or less,25,14,0,14,3,0,2,1,1,0,1,0,1,8,1,2,0,5
S01006577,All households,430,211,33,178,190,12,167,106,57,4,11,8,3,29,1,9,2,17
S01006577,Occupancy rating +2 or more,150,43,15,28,103,10,88,51,35,2,5,3,2,4,0,0,0,4
S01006577,Occupancy rating +1,61,34,9,25,25,0,22,15,6,1,3,2,1,2,1,0,1,0
S01006577,Occupancy rating 0,162,104,7,97,47,2,45,38,6,1,0,0,0,11,0,5,1,5
S01006577,Occupancy rating -1 or less,57,30,2,28,15,0,12,2,10,0,3,3,0,12,0,4,0,8
S01006578,All households,633,346,28,318,207,7,182,128,45,9,18,10,8,80,1,26,0,53
S01006578,Occupancy rating +2 or more,73,31,4,27,37,4,31,22,6,3,2,0,2,5,0,1,0,4
S01006578,Occupancy rating +1,159,84,11,73,60,2,54,42,11,1,4,1,3,15,0,4,0,11
S01006578,Occupancy rating 0,272,159,8,151,75,1,68,51,13,4,6,5,1,38,0,10,0,28
S01006578,Occupancy rating -1 or less,129,72,5,67,35,0,29,13,15,1,6,4,2,22,1,11,0,10
S01006579,All households,640,394,28,366,173,8,152,118,31,3,13,9,4,73,1,21,0,51
S01006579,Occupancy rating +2 or more,37,23,3,20,13,1,12,7,3,2,0,0,0,1,1,0,0,0
S01006579,Occupancy rating +1,162,108,12,96,49,5,43,38,5,0,1,0,1,5,0,2,0,3
S01006579,Occupancy rating 0,351,221,10,211,81,1,73,64,9,0,7,5,2,49,0,15,0,34
S01006579,Occupancy rating -1 or less,90,42,3,39,30,1,24,9,14,1,5,4,1,18,0,4,0,14
S01006580,All households,422,238,31,207,156,8,134,88,39,7,14,10,4,28,5,6,0,17
S01006580,Occupancy rating +2 or more,116,43,14,29,66,6,55,26,24,5,5,3,2,7,1,0,0,6
S01006580,Occupancy rating +1,72,46,10,36,21,1,18,13,5,0,2,2,0,5,2,2,0,1
S01006580,Occupancy rating 0,170,111,6,105,50,1,45,41,3,1,4,3,1,9,1,3,0,5
S01006580,Occupancy rating -1 or less,64,38,1,37,19,0,16,8,7,1,3,2,1,7,1,1,0,5
S01006581,All households,402,141,56,85,247,32,204,86,90,28,11,7,4,14,1,0,2,11
S01006581,Occupancy rating +2 or more,282,90,40,50,186,26,153,68,64,21,7,4,3,6,1,0,0,5
S01006581,Occupancy rating +1,69,31,8,23,35,4,28,12,14,2,3,2,1,3,0,0,2,1
S01006581,Occupancy rating 0,40,16,6,10,21,2,19,5,9,5,0,0,0,3,0,0,0,3
S01006581,Occupancy rating -1 or less,11,4,2,2,5,0,4,1,3,0,1,1,0,2,0,0,0,2
S01006582,All households,466,228,23,205,133,2,113,81,29,3,18,12,6,105,2,30,0,73
S01006582,Occupancy rating +2 or more,41,15,2,13,19,1,14,8,6,0,4,2,2,7,0,1,0,6
S01006582,Occupancy rating +1,121,76,4,72,40,0,39,38,0,1,1,1,0,5,0,0,0,5
S01006582,Occupancy rating 0,242,123,15,108,57,0,47,30,16,1,10,7,3,62,2,23,0,37
S01006582,Occupancy rating -1 or less,62,14,2,12,17,1,13,5,7,1,3,2,1,31,0,6,0,25
S01006583,All households,404,193,11,182,97,3,82,66,13,3,12,7,5,114,4,43,0,67
S01006583,Occupancy rating +2 or more,35,20,6,14,13,3,8,7,0,1,2,2,0,2,0,1,0,1
S01006583,Occupancy rating +1,138,87,3,84,34,0,32,32,0,0,2,0,2,17,1,10,0,6
S01006583,Occupancy rating 0,187,74,1,73,39,0,34,22,11,1,5,4,1,74,1,28,0,45
S01006583,Occupancy rating -1 or less,44,12,1,11,11,0,8,5,2,1,3,1,2,21,2,4,0,15
S01006584,All households,354,176,15,161,115,3,97,58,33,6,15,10,5,63,1,34,0,28
S01006584,Occupancy rating +2 or more,42,18,4,14,24,2,22,11,9,2,0,0,0,0,0,0,0,0
S01006584,Occupancy rating +1,117,74,9,65,36,1,32,25,6,1,3,2,1,7,0,5,0,2
S01006584,Occupancy rating 0,135,65,2,63,34,0,27,17,9,1,7,3,4,36,0,18,0,18
S01006584,Occupancy rating -1 or less,60,19,0,19,21,0,16,5,9,2,5,5,0,20,1,11,0,8
S01006585,All households,465,228,51,177,149,16,97,69,22,6,36,19,17,88,5,28,1,54
S01006585,Occupancy rating +2 or more,24,13,5,8,10,2,8,6,2,0,0,0,0,1,0,0,0,1
S01006585,Occupancy rating +1,145,84,27,57,57,12,36,31,4,1,9,4,5,4,1,1,0,2
S01006585,Occupancy rating 0,209,94,15,79,59,2,39,28,8,3,18,9,9,56,1,22,1,32
S01006585,Occupancy rating -1 or less,87,37,4,33,23,0,14,4,8,2,9,6,3,27,3,5,0,19
S01006586,All households,650,371,62,309,162,19,122,101,16,5,21,9,12,117,3,51,1,62
S01006586,Occupancy rating +2 or more,55,26,5,21,23,2,18,15,2,1,3,1,2,6,1,3,0,2
S01006586,Occupancy rating +1,155,97,19,78,51,11,37,33,3,1,3,1,2,7,0,3,0,4
S01006586,Occupancy rating 0,305,188,31,157,60,6,46,38,6,2,8,4,4,57,0,20,1,36
S01006586,Occupancy rating -1 or less,135,60,7,53,28,0,21,15,5,1,7,3,4,47,2,25,0,20
S01006587,All households,318,171,9,162,89,1,79,53,21,5,9,5,4,58,4,18,0,36
S01006587,Occupancy rating +2 or more,13,6,0,6,7,1,6,2,3,1,0,0,0,0,0,0,0,0
S01006587,Occupancy rating +1,64,46,3,43,14,0,13,10,2,1,1,1,0,4,0,1,0,3
S01006587,Occupancy rating 0,176,100,5,95,48,0,41,35,5,1,7,3,4,28,2,11,0,15
S01006587,Occupancy rating -1 or less,65,19,1,18,20,0,19,6,11,2,1,1,0,26,2,6,0,18
S01006588,All households,338,167,0,167,84,0,76,55,19,2,8,3,5,87,7,32,0,48
S01006588,Occupancy rating +2 or more,10,7,0,7,2,0,2,2,0,0,0,0,0,1,0,0,0,1
S01006588,Occupancy rating +1,58,37,0,37,18,0,18,14,3,1,0,0,0,3,0,1,0,2
S01006588,Occupancy rating 0,176,91,0,91,49,0,44,33,10,1,5,2,3,36,1,10,0,25
S01006588,Occupancy rating -1 or less,94,32,0,32,15,0,12,6,6,0,3,1,2,47,6,21,0,20
S01006589,All households,367,144,8,136,111,2,87,64,17,6,22,14,8,112,8,49,0,55
S01006589,Occupancy rating +2 or more,15,6,2,4,7,1,6,5,0,1,0,0,0,2,0,1,0,1
S01006589,Occupancy rating +1,103,59,3,56,41,1,40,37,2,1,0,0,0,3,0,2,0,1
S01006589,Occupancy rating 0,169,54,3,51,51,0,34,18,12,4,17,11,6,64,0,27,0,37
S01006589,Occupancy rating -1 or less,80,25,0,25,12,0,7,4,3,0,5,3,2,43,8,19,0,16
S01006590,All households,379,208,9,199,116,3,101,71,24,6,12,5,7,55,2,18,0,35
S01006590,Occupancy rating +2 or more,46,27,1,26,17,2,15,8,5,2,0,0,0,2,1,0,0,1
S01006590,Occupancy rating +1,114,77,5,72,30,0,27,26,1,0,3,0,3,7,1,2,0,4
S01006590,Occupancy rating 0,128,59,1,58,46,1,40,28,9,3,5,3,2,23,0,7,0,16
S01006590,Occupancy rating -1 or less,91,45,2,43,23,0,19,9,9,1,4,2,2,23,0,9,0,14
S01006591,All households,367,152,7,145,147,0,122,75,35,12,25,19,6,68,7,16,0,45
S01006591,Occupancy rating +2 or more,41,13,2,11,25,0,25,10,9,6,0,0,0,3,1,0,0,2
S01006591,Occupancy rating +1,114,68,3,65,41,0,41,36,3,2,0,0,0,5,1,3,0,1
S01006591,Occupancy rating 0,142,54,2,52,47,0,33,21,9,3,14,9,5,41,2,11,0,28
S01006591,Occupancy rating -1 or less,70,17,0,17,34,0,23,8,14,1,11,10,1,19,3,2,0,14
S01006592,All households,374,165,13,152,153,6,138,88,44,6,9,5,4,56,2,13,0,41
S01006592,Occupancy rating +2 or more,67,20,6,14,44,5,37,19,16,2,2,2,0,3,1,0,0,2
S01006592,Occupancy rating +1,166,91,3,88,68,1,64,54,9,1,3,2,1,7,0,2,0,5
S01006592,Occupancy rating 0,110,43,4,39,27,0,24,9,13,2,3,0,3,40,1,8,0,31
S01006592,Occupancy rating -1 or less,31,11,0,11,14,0,13,6,6,1,1,1,0,6,0,3,0,3
S01006593,All households,411,188,19,169,161,4,142,97,38,7,15,5,10,62,1,16,0,45
S01006593,Occupancy rating +2 or more,71,24,5,19,44,3,39,17,18,4,2,1,1,3,0,0,0,3
S01006593,Occupancy rating +1,164,95,8,87,61,0,60,57,3,0,1,1,0,8,0,1,0,7
S01006593,Occupancy rating 0,135,57,3,54,41,0,33,19,14,0,8,3,5,37,0,12,0,25
S01006593,Occupancy rating -1 or less,41,12,3,9,15,1,10,4,3,3,4,0,4,14,1,3,0,10
S01006594,All households,345,199,66,133,111,17,83,58,21,4,11,6,5,35,1,12,2,20
S01006594,Occupancy rating +2 or more,51,22,8,14,28,3,24,14,7,3,1,0,1,1,0,1,0,0
S01006594,Occupancy rating +1,150,105,37,68,43,12,31,28,2,1,0,0,0,2,0,1,0,1
S01006594,Occupancy rating 0,111,54,17,37,33,2,23,14,9,0,8,5,3,24,1,8,2,13
S01006594,Occupancy rating -1 or less,33,18,4,14,7,0,5,2,3,0,2,1,1,8,0,2,0,6
S01006595,All households,555,293,26,267,202,6,167,114,50,3,29,14,15,60,5,13,0,42
S01006595,Occupancy rating +2 or more,71,32,8,24,38,3,35,27,6,2,0,0,0,1,0,0,0,1
S01006595,Occupancy rating +1,212,137,11,126,67,2,63,50,12,1,2,1,1,8,0,1,0,7
S01006595,Occupancy rating 0,218,105,5,100,78,1,53,28,25,0,24,13,11,35,0,10,0,25
S01006595,Occupancy rating -1 or less,54,19,2,17,19,0,16,9,7,0,3,0,3,16,5,2,0,9
S01006596,All households,359,155,24,131,170,7,152,100,48,4,11,5,6,34,3,8,0,23
S01006596,Occupancy rating +2 or more,126,29,13,16,90,6,79,49,27,3,5,2,3,7,2,0,0,5
S01006596,Occupancy rating +1,58,33,5,28,24,0,23,14,9,0,1,1,0,1,0,0,0,1
S01006596,Occupancy rating 0,135,79,6,73,45,1,41,34,6,1,3,1,2,11,0,3,0,8
S01006596,Occupancy rating -1 or less,40,14,0,14,11,0,9,3,6,0,2,1,1,15,1,5,0,9
S01006597,All households,352,218,18,200,95,3,86,76,9,1,6,5,1,39,1,14,1,23
S01006597,Occupancy rating +2 or more,13,8,2,6,4,0,4,4,0,0,0,0,0,1,0,0,0,1
S01006597,Occupancy rating +1,55,29,5,24,22,2,20,18,2,0,0,0,0,4,0,2,1,1
S01006597,Occupancy rating 0,221,147,5,142,51,0,47,43,3,1,4,3,1,23,0,8,0,15
S01006597,Occupancy rating -1 or less,63,34,6,28,18,1,15,11,4,0,2,2,0,11,1,4,0,6
S01006598,All households,435,136,28,108,269,31,228,105,102,21,10,4,6,30,4,6,0,20
S01006598,Occupancy rating +2 or more,257,64,19,45,187,23,160,75,71,14,4,2,2,6,3,0,0,3
S01006598,Occupancy rating +1,116,56,6,50,54,8,42,23,15,4,4,1,3,6,1,0,0,5
S01006598,Occupancy rating 0,48,14,3,11,23,0,22,7,13,2,1,1,0,11,0,3,0,8
S01006598,Occupancy rating -1 or less,14,2,0,2,5,0,4,0,3,1,1,0,1,7,0,3,0,4
S01006599,All households,499,269,89,180,178,22,124,92,25,7,32,17,15,52,3,18,3,28
S01006599,Occupancy rating +2 or more,56,22,10,12,32,2,25,20,5,0,5,2,3,2,0,0,2,0
S01006599,Occupancy rating +1,149,93,23,70,51,8,38,34,4,0,5,2,3,5,0,0,0,5
S01006599,Occupancy rating 0,239,126,42,84,79,10,51,36,10,5,18,10,8,34,1,16,1,16
S01006599,Occupancy rating -1 or less,55,28,14,14,16,2,10,2,6,2,4,3,1,11,2,2,0,7
S01006600,All households,587,296,112,184,246,39,185,104,67,14,22,11,11,45,2,12,3,28
S01006600,Occupancy rating +2 or more,158,53,16,37,100,13,78,47,24,7,9,4,5,5,0,0,1,4
S01006600,Occupancy rating +1,194,117,18,99,74,6,63,38,22,3,5,2,3,3,0,0,0,3
S01006600,Occupancy rating 0,179,103,71,32,50,16,27,12,14,1,7,5,2,26,1,10,0,15
S01006600,Occupancy rating -1 or less,56,23,7,16,22,4,17,7,7,3,1,0,1,11,1,2,2,6
S01006601,All households,572,296,48,248,233,23,183,118,52,13,27,14,13,43,9,11,2,21
S01006601,Occupancy rating +2 or more,137,52,27,25,81,14,60,42,16,2,7,4,3,4,1,0,0,3
S01006601,Occupancy rating +1,176,92,14,78,75,6,63,46,10,7,6,4,2,9,4,3,0,2
S01006601,Occupancy rating 0,178,98,5,93,63,3,52,28,20,4,8,3,5,17,0,4,2,11
S01006601,Occupancy rating -1 or less,81,54,2,52,14,0,8,2,6,0,6,3,3,13,4,4,0,5
S01006602,All households,414,179,91,88,216,32,169,68,88,13,15,10,5,19,3,4,1,11
S01006602,Occupancy rating +2 or more,197,55,15,40,136,19,110,49,55,6,7,5,2,6,2,0,0,4
S01006602,Occupancy rating +1,103,51,13,38,45,7,35,14,15,6,3,2,1,7,1,3,0,3
S01006602,Occupancy rating 0,101,67,58,9,29,3,22,4,17,1,4,2,2,5,0,1,1,3
S01006602,Occupancy rating -1 or less,13,6,5,1,6,3,2,1,1,0,1,1,0,1,0,0,0,1
S01006603,All households,385,154,62,92,214,33,135,59,58,18,46,24,22,17,9,1,0,7
S01006603,Occupancy rating +2 or more,75,37,16,21,37,7,29,24,4,1,1,1,0,1,0,0,0,1
S01006603,Occupancy rating +1,132,58,19,39,72,19,39,19,16,4,14,3,11,2,0,1,0,1
S01006603,Occupancy rating 0,145,51,23,28,85,6,52,14,27,11,27,17,10,9,6,0,0,3
S01006603,Occupancy rating -1 or less,33,8,4,4,20,1,15,2,11,2,4,3,1,5,3,0,0,2
S01006604,All households,291,80,32,48,194,32,136,53,55,28,26,14,12,17,5,0,1,11
S01006604,Occupancy rating +2 or more,83,33,13,20,48,9,37,30,6,1,2,1,1,2,0,0,1,1
S01006604,Occupancy rating +1,117,44,17,27,69,20,42,21,10,11,7,1,6,4,1,0,0,3
S01006604,Occupancy rating 0,73,3,2,1,60,3,44,2,28,14,13,10,3,10,3,0,0,7
S01006604,Occupancy rating -1 or less,18,0,0,0,17,0,13,0,11,2,4,2,2,1,1,0,0,0
S01006605,All households,409,179,89,90,213,31,114,42,50,22,68,39,29,17,5,2,3,7
S01006605,Occupancy rating +2 or more,53,28,7,21,24,4,17,11,5,1,3,2,1,1,0,0,1,0
S01006605,Occupancy rating +1,147,76,27,49,67,15,46,28,7,11,6,4,2,4,1,1,0,2
S01006605,Occupancy rating 0,171,64,50,14,99,10,41,3,31,7,48,25,23,8,1,1,2,4
S01006605,Occupancy rating -1 or less,38,11,5,6,23,2,10,0,7,3,11,8,3,4,3,0,0,1
S01006606,All households,390,135,86,49,232,47,157,73,51,33,28,16,12,23,4,1,3,15
S01006606,Occupancy rating +2 or more,218,76,42,34,136,35,94,58,21,15,7,3,4,6,1,0,1,4
S01006606,Occupancy rating +1,79,18,9,9,51,4,36,12,13,11,11,5,6,10,0,0,1,9
S01006606,Occupancy rating 0,71,37,34,3,31,7,17,2,11,4,7,6,1,3,1,0,1,1
S01006606,Occupancy rating -1 or less,22,4,1,3,14,1,10,1,6,3,3,2,1,4,2,1,0,1
S01006607,All households,385,104,50,54,256,34,173,61,73,39,49,24,25,25,10,0,1,14
S01006607,Occupancy rating +2 or more,141,61,22,39,78,19,58,42,8,8,1,1,0,2,1,0,0,1
S01006607,Occupancy rating +1,117,29,19,10,81,10,61,16,28,17,10,6,4,7,0,0,1,6
S01006607,Occupancy rating 0,86,13,8,5,64,2,36,1,23,12,26,9,17,9,5,0,0,4
S01006607,Occupancy rating -1 or less,41,1,1,0,33,3,18,2,14,2,12,8,4,7,4,0,0,3
S01006608,All households,284,57,31,26,210,33,159,63,72,24,18,7,11,17,7,2,0,8
S01006608,Occupancy rating +2 or more,204,45,24,21,151,26,114,58,39,17,11,2,9,8,3,0,0,5
S01006608,Occupancy rating +1,53,9,6,3,41,7,31,4,21,6,3,1,2,3,0,1,0,2
S01006608,Occupancy rating 0,16,2,0,2,12,0,10,0,9,1,2,2,0,2,1,0,0,1
S01006608,Occupancy rating -1 or less,11,1,1,0,6,0,4,1,3,0,2,2,0,4,3,1,0,0
S01006609,All households,490,159,79,80,312,45,192,83,77,32,75,44,31,19,6,0,1,12
S01006609,Occupancy rating +2 or more,101,40,14,26,61,10,46,33,10,3,5,3,2,0,0,0,0,0
S01006609,Occupancy rating +1,214,96,51,45,114,31,74,47,17,10,9,2,7,4,0,0,0,4
S01006609,Occupancy rating 0,127,15,8,7,101,2,56,3,40,13,43,26,17,11,3,0,1,7
S01006609,Occupancy rating -1 or less,48,8,6,2,36,2,16,0,10,6,18,13,5,4,3,0,0,1
S01006610,All households,212,73,43,30,129,20,73,25,29,19,36,14,22,10,4,0,1,5
S01006610,Occupancy rating +2 or more,33,15,12,3,18,8,10,7,0,3,0,0,0,0,0,0,0,0
S01006610,Occupancy rating +1,91,42,23,19,48,11,28,14,6,8,9,2,7,1,0,0,1,0
S01006610,Occupancy rating 0,65,12,5,7,49,0,29,3,20,6,20,9,11,4,1,0,0,3
S01006610,Occupancy rating -1 or less,23,4,3,1,14,1,6,1,3,2,7,3,4,5,3,0,0,2
S01006611,All households,425,135,60,75,269,41,161,65,66,30,67,41,26,21,3,1,0,17
S01006611,Occupancy rating +2 or more,83,31,13,18,50,13,36,28,4,4,1,1,0,2,0,0,0,2
S01006611,Occupancy rating +1,168,75,32,43,85,24,50,33,8,9,11,5,6,8,0,1,0,7
S01006611,Occupancy rating 0,134,24,14,10,103,2,54,3,38,13,47,27,20,7,1,0,0,6
S01006611,Occupancy rating -1 or less,40,5,1,4,31,2,21,1,16,4,8,8,0,4,2,0,0,2
S01006612,All households,373,100,44,56,255,32,186,78,71,37,37,15,22,18,7,1,0,10
S01006612,Occupancy rating +2 or more,139,41,19,22,96,12,78,49,20,9,6,1,5,2,1,0,0,1
S01006612,Occupancy rating +1,121,29,13,16,85,19,59,23,23,13,7,2,5,7,4,0,0,3
S01006612,Occupancy rating 0,89,23,10,13,60,1,41,5,24,12,18,10,8,6,0,1,0,5
S01006612,Occupancy rating -1 or less,24,7,2,5,14,0,8,1,4,3,6,2,4,3,2,0,0,1
S01006613,All households,259,68,7,61,185,16,157,74,72,11,12,9,3,6,2,0,0,4
S01006613,Occupancy rating +2 or more,127,22,4,18,102,11,84,45,35,4,7,7,0,3,1,0,0,2
S01006613,Occupancy rating +1,69,18,2,16,51,3,45,19,22,4,3,1,2,0,0,0,0,0
S01006613,Occupancy rating 0,54,27,0,27,25,2,22,7,12,3,1,0,1,2,0,0,0,2
S01006613,Occupancy rating -1 or less,9,1,1,0,7,0,6,3,3,0,1,1,0,1,1,0,0,0
S01006614,All households,265,54,4,50,206,5,179,66,104,9,22,17,5,5,2,0,0,3
S01006614,Occupancy rating +2 or more,135,29,3,26,106,4,96,38,53,5,6,4,2,0,0,0,0,0
S01006614,Occupancy rating +1,92,21,0,21,69,1,58,24,31,3,10,8,2,2,1,0,0,1
S01006614,Occupancy rating 0,34,4,1,3,27,0,21,3,17,1,6,5,1,3,1,0,0,2
S01006614,Occupancy rating -1 or less,4,0,0,0,4,0,4,1,3,0,0,0,0,0,0,0,0,0
S01006615,All households,270,21,3,18,239,11,211,70,129,12,17,14,3,10,2,0,0,8
S01006615,Occupancy rating +2 or more,202,17,2,15,180,7,167,57,101,9,6,6,0,5,1,0,0,4
S01006615,Occupancy rating +1,40,3,1,2,36,4,27,9,15,3,5,4,1,1,0,0,0,1
S01006615,Occupancy rating 0,23,1,0,1,20,0,15,4,11,0,5,3,2,2,0,0,0,2
S01006615,Occupancy rating -1 or less,5,0,0,0,3,0,2,0,2,0,1,1,0,2,1,0,0,1
S01006616,All households,337,86,7,79,242,12,204,87,75,42,26,17,9,9,4,1,0,4
S01006616,Occupancy rating +2 or more,135,18,2,16,113,7,97,44,31,22,9,5,4,4,2,1,0,1
S01006616,Occupancy rating +1,72,16,3,13,56,5,43,10,19,14,8,5,3,0,0,0,0,0
S01006616,Occupancy rating 0,114,50,2,48,61,0,56,31,20,5,5,4,1,3,2,0,0,1
S01006616,Occupancy rating -1 or less,16,2,0,2,12,0,8,2,5,1,4,3,1,2,0,0,0,2
S01006617,All households,297,89,37,52,190,21,146,60,58,28,23,12,11,18,4,0,0,14
S01006617,Occupancy rating +2 or more,137,32,16,16,99,12,83,48,21,14,4,3,1,6,2,0,0,4
S01006617,Occupancy rating +1,80,23,6,17,48,5,37,8,20,9,6,3,3,9,2,0,0,7
S01006617,Occupancy rating 0,67,30,12,18,34,4,22,4,14,4,8,4,4,3,0,0,0,3
S01006617,Occupancy rating -1 or less,13,4,3,1,9,0,4,0,3,1,5,2,3,0,0,0,0,0
S01006618,All households,246,75,31,44,164,18,137,82,30,25,9,3,6,7,3,0,0,4
S01006618,Occupancy rating +2 or more,98,17,8,9,80,9,69,47,13,9,2,0,2,1,1,0,0,0
S01006618,Occupancy rating +1,70,25,12,13,43,7,35,19,7,9,1,0,1,2,0,0,0,2
S01006618,Occupancy rating 0,68,31,11,20,35,2,30,14,9,7,3,1,2,2,1,0,0,1
S01006618,Occupancy rating -1 or less,10,2,0,2,6,0,3,2,1,0,3,2,1,2,1,0,0,1
S01006619,All households,372,85,19,66,272,24,212,100,83,29,36,18,18,15,5,0,0,10
S01006619,Occupancy rating +2 or more,173,33,8,25,133,20,103,62,29,12,10,7,3,7,2,0,0,5
S01006619,Occupancy rating +1,100,21,5,16,78,2,63,21,34,8,13,5,8,1,0,0,0,1
S01006619,Occupancy rating 0,86,30,5,25,52,1,38,16,14,8,13,6,7,4,3,0,0,1
S01006619,Occupancy rating -1 or less,13,1,1,0,9,1,8,1,6,1,0,0,0,3,0,0,0,3
S01006620,All households,390,120,40,80,259,32,202,98,65,39,25,9,16,11,5,0,1,5
S01006620,Occupancy rating +2 or more,124,27,7,20,95,16,75,51,13,11,4,1,3,2,2,0,0,0
S01006620,Occupancy rating +1,141,48,16,32,91,11,73,37,22,14,7,3,4,2,1,0,0,1
S01006620,Occupancy rating 0,105,42,17,25,57,3,43,9,23,11,11,4,7,6,2,0,1,3
S01006620,Occupancy rating -1 or less,20,3,0,3,16,2,11,1,7,3,3,1,2,1,0,0,0,1
S01006621,All households,235,64,14,50,164,15,126,68,49,9,23,9,14,7,3,0,0,4
S01006621,Occupancy rating +2 or more,81,19,8,11,60,12,45,40,4,1,3,2,1,2,0,0,0,2
S01006621,Occupancy rating +1,78,19,3,16,59,3,50,20,25,5,6,1,5,0,0,0,0,0
S01006621,Occupancy rating 0,66,26,3,23,38,0,27,7,17,3,11,5,6,2,1,0,0,1
S01006621,Occupancy rating -1 or less,10,0,0,0,7,0,4,1,3,0,3,1,2,3,2,0,0,1
S01006622,All households,292,91,10,81,194,8,174,80,77,17,12,7,5,7,5,0,0,2
S01006622,Occupancy rating +2 or more,89,18,3,15,68,4,61,30,28,3,3,2,1,3,2,0,0,1
S01006622,Occupancy rating +1,99,30,4,26,68,0,64,34,23,7,4,1,3,1,0,0,0,1
S01006622,Occupancy rating 0,79,31,0,31,48,3,41,14,23,4,4,4,0,0,0,0,0,0
S01006622,Occupancy rating -1 or less,25,12,3,9,10,1,8,2,3,3,1,0,1,3,3,0,0,0
S01006623,All households,359,165,47,118,174,18,124,51,55,18,32,14,18,20,5,2,0,13
S01006623,Occupancy rating +2 or more,123,55,18,37,65,14,48,30,12,6,3,1,2,3,0,1,0,2
S01006623,Occupancy rating +1,98,47,14,33,48,2,31,12,13,6,15,6,9,3,1,0,0,2
S01006623,Occupancy rating 0,109,54,10,44,45,2,31,8,19,4,12,6,6,10,3,1,0,6
S01006623,Occupancy rating -1 or less,29,9,5,4,16,0,14,1,11,2,2,1,1,4,1,0,0,3
S01006624,All households,481,275,29,246,167,24,123,77,36,10,20,10,10,39,7,5,0,27
S01006624,Occupancy rating +2 or more,73,24,7,17,47,20,26,19,3,4,1,1,0,2,0,0,0,2
S01006624,Occupancy rating +1,89,45,10,35,40,3,29,15,13,1,8,3,5,4,1,3,0,0
S01006624,Occupancy rating 0,194,139,8,131,49,1,42,28,10,4,6,3,3,6,1,1,0,4
S01006624,Occupancy rating -1 or less,125,67,4,63,31,0,26,15,10,1,5,3,2,27,5,1,0,21
S01006625,All households,288,92,34,58,167,19,116,55,33,28,32,19,13,29,5,0,2,22
S01006625,Occupancy rating +2 or more,82,22,8,14,58,7,45,34,7,4,6,3,3,2,1,0,0,1
S01006625,Occupancy rating +1,95,40,17,23,48,6,36,16,7,13,6,2,4,7,0,0,1,6
S01006625,Occupancy rating 0,71,16,4,12,46,4,26,3,16,7,16,10,6,9,0,0,1,8
S01006625,Occupancy rating -1 or less,40,14,5,9,15,2,9,2,3,4,4,4,0,11,4,0,0,7
S01006626,All households,377,159,64,95,197,20,119,60,38,21,58,37,21,21,3,0,2,16
S01006626,Occupancy rating +2 or more,26,11,9,2,12,4,8,5,2,1,0,0,0,3,0,0,0,3
S01006626,Occupancy rating +1,111,55,24,31,54,9,38,25,3,10,7,3,4,2,0,0,1,1
S01006626,Occupancy rating 0,161,61,24,37,93,3,50,20,26,4,40,25,15,7,0,0,1,6
S01006626,Occupancy rating -1 or less,79,32,7,25,38,4,23,10,7,6,11,9,2,9,3,0,0,6
S01006627,All households,511,289,37,252,177,2,140,86,40,14,35,24,11,45,9,5,0,31
S01006627,Occupancy rating +2 or more,29,15,2,13,13,1,10,8,2,0,2,1,1,1,0,0,0,1
S01006627,Occupancy rating +1,78,50,6,44,28,1,23,18,2,3,4,1,3,0,0,0,0,0
S01006627,Occupancy rating 0,245,155,13,142,82,0,67,47,14,6,15,11,4,8,0,2,0,6
S01006627,Occupancy rating -1 or less,159,69,16,53,54,0,40,13,22,5,14,11,3,36,9,3,0,24
S01006628,All households,635,340,19,321,217,6,185,117,59,9,26,16,10,78,13,13,0,52
S01006628,Occupancy rating +2 or more,38,17,2,15,17,3,14,13,0,1,0,0,0,4,0,0,0,4
S01006628,Occupancy rating +1,111,58,1,57,47,2,38,28,7,3,7,1,6,6,0,1,0,5
S01006628,Occupancy rating 0,291,183,8,175,84,1,75,55,18,2,8,6,2,24,0,6,0,18
S01006628,Occupancy rating -1 or less,195,82,8,74,69,0,58,21,34,3,11,9,2,44,13,6,0,25
S01006629,All households,315,96,20,76,199,10,121,46,51,24,68,48,20,20,10,0,0,10
S01006629,Occupancy rating +2 or more,60,22,4,18,37,7,28,20,4,4,2,1,1,1,1,0,0,0
S01006629,Occupancy rating +1,96,46,11,35,47,1,36,19,10,7,10,4,6,3,1,0,0,2
S01006629,Occupancy rating 0,117,25,4,21,86,2,34,6,22,6,50,40,10,6,1,0,0,5
S01006629,Occupancy rating -1 or less,42,3,1,2,29,0,23,1,15,7,6,3,3,10,7,0,0,3
S01006630,All households,256,74,23,51,167,16,94,35,41,18,57,33,24,15,7,0,0,8
S01006630,Occupancy rating +2 or more,75,34,13,21,41,12,27,21,5,1,2,1,1,0,0,0,0,0
S01006630,Occupancy rating +1,73,19,5,14,51,4,31,8,14,9,16,5,11,3,0,0,0,3
S01006630,Occupancy rating 0,79,15,2,13,59,0,28,5,15,8,31,20,11,5,1,0,0,4
S01006630,Occupancy rating -1 or less,29,6,3,3,16,0,8,1,7,0,8,7,1,7,6,0,0,1
S01006631,All households,493,246,84,162,229,26,152,83,49,20,51,35,16,18,5,0,1,12
S01006631,Occupancy rating +2 or more,71,28,8,20,43,9,33,25,7,1,1,1,0,0,0,0,0,0
S01006631,Occupancy rating +1,102,47,14,33,54,5,41,28,8,5,8,2,6,1,0,0,0,1
S01006631,Occupancy rating 0,236,129,43,86,101,9,56,26,23,7,36,28,8,6,2,0,0,4
S01006631,Occupancy rating -1 or less,84,42,19,23,31,3,22,4,11,7,6,4,2,11,3,0,1,7
S01006632,All households,423,191,46,145,210,15,135,66,58,11,60,48,12,22,4,3,0,15
S01006632,Occupancy rating +2 or more,31,17,5,12,12,0,9,6,3,0,3,3,0,2,0,0,0,2
S01006632,Occupancy rating +1,145,95,14,81,49,10,37,34,2,1,2,2,0,1,0,0,0,1
S01006632,Occupancy rating 0,188,67,25,42,108,5,63,23,34,6,40,33,7,13,0,3,0,10
S01006632,Occupancy rating -1 or less,59,12,2,10,41,0,26,3,19,4,15,10,5,6,4,0,0,2
S01006633,All households,288,101,29,72,167,6,111,42,48,21,50,31,19,20,12,0,1,7
S01006633,Occupancy rating +2 or more,62,31,13,18,30,4,22,19,1,2,4,1,3,1,0,0,0,1
S01006633,Occupancy rating +1,67,15,2,13,47,0,31,10,13,8,16,7,9,5,4,0,0,1
S01006633,Occupancy rating 0,116,50,14,36,61,2,37,12,18,7,22,17,5,5,2,0,0,3
S01006633,Occupancy rating -1 or less,43,5,0,5,29,0,21,1,16,4,8,6,2,9,6,0,1,2
S01006634,All households,291,121,22,99,154,7,84,28,48,8,63,48,15,16,6,0,0,10
S01006634,Occupancy rating +2 or more,24,8,1,7,15,2,9,7,2,0,4,2,2,1,0,0,0,1
S01006634,Occupancy rating +1,92,45,8,37,43,3,29,14,10,5,11,8,3,4,1,0,0,3
S01006634,Occupancy rating 0,132,58,8,50,71,0,40,7,30,3,31,25,6,3,1,0,0,2
S01006634,Occupancy rating -1 or less,43,10,5,5,25,2,6,0,6,0,17,13,4,8,4,0,0,4
S01006635,All households,289,96,29,67,169,21,111,36,52,23,37,25,12,24,13,1,0,10
S01006635,Occupancy rating +2 or more,75,29,18,11,43,16,23,12,5,6,4,1,3,3,1,0,0,2
S01006635,Occupancy rating +1,92,42,4,38,48,4,40,20,13,7,4,3,1,2,0,0,0,2
S01006635,Occupancy rating 0,80,22,6,16,51,0,30,1,21,8,21,13,8,7,3,1,0,3
S01006635,Occupancy rating -1 or less,42,3,1,2,27,1,18,3,13,2,8,8,0,12,9,0,0,3
S01006636,All households,386,145,38,107,219,20,133,40,81,12,66,54,12,22,14,0,1,7
S01006636,Occupancy rating +2 or more,34,19,1,18,14,4,9,7,2,0,1,1,0,1,1,0,0,0
S01006636,Occupancy rating +1,126,65,26,39,59,12,36,19,14,3,11,8,3,2,0,0,0,2
S01006636,Occupancy rating 0,173,51,8,43,113,3,68,11,48,9,42,36,6,9,4,0,1,4
S01006636,Occupancy rating -1 or less,53,10,3,7,33,1,20,3,17,0,12,9,3,10,9,0,0,1
S01006637,All households,413,223,46,177,133,11,101,65,27,9,21,15,6,57,8,21,0,28
S01006637,Occupancy rating +2 or more,58,26,7,19,29,5,22,15,6,1,2,2,0,3,0,1,0,2
S01006637,Occupancy rating +1,95,57,7,50,30,0,28,22,5,1,2,1,1,8,1,3,0,4
S01006637,Occupancy rating 0,193,114,27,87,54,6,38,22,10,6,10,7,3,25,0,9,0,16
S01006637,Occupancy rating -1 or less,67,26,5,21,20,0,13,6,6,1,7,5,2,21,7,8,0,6
S01006638,All households,504,271,38,233,148,10,122,98,20,4,16,5,11,85,2,37,0,46
S01006638,Occupancy rating +2 or more,34,14,3,11,12,0,10,10,0,0,2,0,2,8,0,3,0,5
S01006638,Occupancy rating +1,85,44,6,38,35,5,27,24,2,1,3,0,3,6,0,2,0,4
S01006638,Occupancy rating 0,263,150,26,124,72,4,61,49,11,1,7,4,3,41,1,20,0,20
S01006638,Occupancy rating -1 or less,122,63,3,60,29,1,24,15,7,2,4,1,3,30,1,12,0,17
S01006639,All households,592,343,99,244,149,21,106,80,23,3,22,10,12,100,4,52,1,43
S01006639,Occupancy rating +2 or more,32,14,7,7,14,1,10,7,3,0,3,2,1,4,0,3,0,1
S01006639,Occupancy rating +1,93,63,15,48,22,4,18,15,1,2,0,0,0,8,1,1,0,6
S01006639,Occupancy rating 0,330,209,65,144,82,12,61,49,11,1,9,5,4,39,0,21,0,18
S01006639,Occupancy rating -1 or less,137,57,12,45,31,4,17,9,8,0,10,3,7,49,3,27,1,18
S01006640,All households,376,145,5,140,114,0,99,70,24,5,15,9,6,117,2,49,0,66
S01006640,Occupancy rating +2 or more,32,18,2,16,7,0,5,2,3,0,2,2,0,7,0,3,0,4
S01006640,Occupancy rating +1,127,69,1,68,43,0,40,32,7,1,3,2,1,15,0,7,0,8
S01006640,Occupancy rating 0,156,42,2,40,49,0,42,31,8,3,7,2,5,65,0,28,0,37
S01006640,Occupancy rating -1 or less,61,16,0,16,15,0,12,5,6,1,3,3,0,30,2,11,0,17
S01006641,All households,602,307,12,295,174,0,156,116,34,6,18,12,6,121,1,65,0,55
S01006641,Occupancy rating +2 or more,31,11,1,10,18,0,17,12,4,1,1,1,0,2,0,0,0,2
S01006641,Occupancy rating +1,144,94,3,91,43,0,39,36,2,1,4,3,1,7,0,4,0,3
S01006641,Occupancy rating 0,256,116,3,113,67,0,59,45,10,4,8,5,3,73,0,40,0,33
S01006641,Occupancy rating -1 or less,171,86,5,81,46,0,41,23,18,0,5,3,2,39,1,21,0,17
S01006642,All households,492,242,18,224,124,8,108,70,32,6,8,4,4,126,3,82,0,41
S01006642,Occupancy rating +2 or more,33,9,1,8,20,3,16,11,3,2,1,0,1,4,0,2,0,2
S01006642,Occupancy rating +1,104,64,3,61,31,2,29,22,6,1,0,0,0,9,2,2,0,5
S01006642,Occupancy rating 0,223,112,12,100,49,2,42,28,13,1,5,3,2,62,0,41,0,21
S01006642,Occupancy rating -1 or less,132,57,2,55,24,1,21,9,10,2,2,1,1,51,1,37,0,13
S01006643,All households,419,172,11,161,104,4,91,75,13,3,9,3,6,143,3,96,0,44
S01006643,Occupancy rating +2 or more,23,8,1,7,11,0,11,8,2,1,0,0,0,4,0,2,0,2
S01006643,Occupancy rating +1,101,56,4,52,38,2,36,33,2,1,0,0,0,7,0,6,0,1
S01006643,Occupancy rating 0,191,73,4,69,39,1,34,29,4,1,4,0,4,79,2,51,0,26
S01006643,Occupancy rating -1 or less,104,35,2,33,16,1,10,5,5,0,5,3,2,53,1,37,0,15
S01006644,All households,553,241,22,219,159,7,131,96,25,10,21,13,8,153,2,99,0,52
S01006644,Occupancy rating +2 or more,28,13,3,10,11,2,8,7,0,1,1,0,1,4,0,1,0,3
S01006644,Occupancy rating +1,118,76,9,67,36,2,34,30,1,3,0,0,0,6,1,3,0,2
S01006644,Occupancy rating 0,273,114,8,106,85,2,68,51,11,6,15,10,5,74,0,47,0,27
S01006644,Occupancy rating -1 or less,134,38,2,36,27,1,21,8,13,0,5,3,2,69,1,48,0,20
S01006645,All households,393,200,32,168,158,11,97,48,45,4,50,33,17,35,3,15,1,16
S01006645,Occupancy rating +2 or more,16,9,1,8,6,0,6,4,2,0,0,0,0,1,1,0,0,0
S01006645,Occupancy rating +1,121,80,17,63,37,6,28,23,5,0,3,2,1,4,0,3,0,1
S01006645,Occupancy rating 0,196,83,14,69,90,4,48,18,27,3,38,26,12,23,0,9,1,13
S01006645,Occupancy rating -1 or less,60,28,0,28,25,1,15,3,11,1,9,5,4,7,2,3,0,2
S01006646,All households,340,185,36,149,70,6,57,45,12,0,7,4,3,85,5,43,1,36
S01006646,Occupancy rating +2 or more,12,10,2,8,2,0,1,0,1,0,1,0,1,0,0,0,0,0
S01006646,Occupancy rating +1,73,52,0,52,19,1,18,17,1,0,0,0,0,2,0,0,0,2
S01006646,Occupancy rating 0,180,91,30,61,40,5,31,23,8,0,4,3,1,49,1,23,0,25
S01006646,Occupancy rating -1 or less,75,32,4,28,9,0,7,5,2,0,2,1,1,34,4,20,1,9
S01006647,All households,341,145,39,106,137,10,79,46,27,6,48,32,16,59,9,21,0,29
S01006647,Occupancy rating +2 or more,25,13,3,10,10,3,6,3,2,1,1,1,0,2,0,0,0,2
S01006647,Occupancy rating +1,132,81,20,61,48,5,33,30,3,0,10,3,7,3,1,0,0,2
S01006647,Occupancy rating 0,137,41,15,26,63,2,33,11,17,5,28,21,7,33,1,13,0,19
S01006647,Occupancy rating -1 or less,47,10,1,9,16,0,7,2,5,0,9,7,2,21,7,8,0,6
S01006648,All households,651,351,15,336,175,3,156,122,33,1,16,11,5,125,10,44,0,71
S01006648,Occupancy rating +2 or more,23,9,1,8,13,0,13,11,1,1,0,0,0,1,0,0,0,1
S01006648,Occupancy rating +1,112,65,3,62,43,1,41,37,4,0,1,1,0,4,0,2,0,2
S01006648,Occupancy rating 0,353,203,7,196,85,1,75,60,15,0,9,6,3,65,2,26,0,37
S01006648,Occupancy rating -1 or less,163,74,4,70,34,1,27,14,13,0,6,4,2,55,8,16,0,31
S01006649,All households,583,300,21,279,174,4,147,108,32,7,23,18,5,109,5,45,0,59
S01006649,Occupancy rating +2 or more,22,8,1,7,10,2,5,4,0,1,3,3,0,4,0,2,0,2
S01006649,Occupancy rating +1,131,83,5,78,47,0,45,41,3,1,2,2,0,1,0,0,0,1
S01006649,Occupancy rating 0,319,165,11,154,87,0,74,50,21,3,13,10,3,67,0,29,0,38
S01006649,Occupancy rating -1 or less,111,44,4,40,30,2,23,13,8,2,5,3,2,37,5,14,0,18
S01006650,All households,481,242,16,226,126,7,110,79,23,8,9,5,4,113,5,50,2,56
S01006650,Occupancy rating +2 or more,58,19,5,14,29,3,25,17,4,4,1,0,1,10,0,2,1,7
S01006650,Occupancy rating +1,80,36,4,32,27,3,24,16,4,4,0,0,0,17,0,7,1,9
S01006650,Occupancy rating 0,208,124,3,121,47,1,42,36,6,0,4,1,3,37,0,18,0,19
S01006650,Occupancy rating -1 or less,135,63,4,59,23,0,19,10,9,0,4,4,0,49,5,23,0,21
S01006651,All households,382,198,43,155,112,14,90,70,16,4,8,3,5,72,0,40,0,32
S01006651,Occupancy rating +2 or more,26,9,3,6,13,1,12,10,1,1,0,0,0,4,0,2,0,2
S01006651,Occupancy rating +1,56,29,3,26,21,1,18,17,1,0,2,0,2,6,0,2,0,4
S01006651,Occupancy rating 0,208,128,34,94,52,11,38,31,6,1,3,2,1,28,0,16,0,12
S01006651,Occupancy rating -1 or less,92,32,3,29,26,1,22,12,8,2,3,1,2,34,0,20,0,14
S01006652,All households,308,128,19,109,95,5,82,67,14,1,8,1,7,85,3,46,0,36
S01006652,Occupancy rating +2 or more,14,6,1,5,6,0,6,4,1,1,0,0,0,2,0,2,0,0
S01006652,Occupancy rating +1,88,45,5,40,37,4,32,30,2,0,1,0,1,6,0,3,0,3
S01006652,Occupancy rating 0,155,63,8,55,41,1,36,30,6,0,4,1,3,51,0,24,0,27
S01006652,Occupancy rating -1 or less,51,14,5,9,11,0,8,3,5,0,3,0,3,26,3,17,0,6
S01006653,All households,296,113,11,102,120,9,104,63,33,8,7,3,4,63,3,29,0,31
S01006653,Occupancy rating +2 or more,80,26,6,20,50,7,42,19,15,8,1,1,0,4,0,3,0,1
S01006653,Occupancy rating +1,94,54,5,49,36,2,33,30,3,0,1,1,0,4,0,1,0,3
S01006653,Occupancy rating 0,93,25,0,25,26,0,21,10,11,0,5,1,4,42,1,19,0,22
S01006653,Occupancy rating -1 or less,29,8,0,8,8,0,8,4,4,0,0,0,0,13,2,6,0,5
S01006654,All households,504,232,70,162,206,16,123,64,44,15,67,38,29,66,6,23,1,36
S01006654,Occupancy rating +2 or more,41,21,6,15,19,3,16,11,3,2,0,0,0,1,0,0,0,1
S01006654,Occupancy rating +1,140,88,34,54,48,6,41,36,5,0,1,0,1,4,1,1,0,2
S01006654,Occupancy rating 0,252,98,27,71,109,6,50,15,26,9,53,29,24,45,0,18,1,26
S01006654,Occupancy rating -1 or less,71,25,3,22,30,1,16,2,10,4,13,9,4,16,5,4,0,7
S01006655,All households,334,151,23,128,148,12,122,75,40,7,14,11,3,35,1,23,0,11
S01006655,Occupancy rating +2 or more,90,34,5,29,54,7,45,22,20,3,2,1,1,2,0,1,0,1
S01006655,Occupancy rating +1,84,36,4,32,42,3,37,30,6,1,2,2,0,6,0,5,0,1
S01006655,Occupancy rating 0,114,61,9,52,39,2,30,20,8,2,7,5,2,14,0,9,0,5
S01006655,Occupancy rating -1 or less,46,20,5,15,13,0,10,3,6,1,3,3,0,13,1,8,0,4
S01006656,All households,524,242,32,210,191,8,147,87,51,9,36,25,11,91,2,46,1,42
S01006656,Occupancy rating +2 or more,61,25,6,19,32,2,30,18,10,2,0,0,0,4,1,1,0,2
S01006656,Occupancy rating +1,115,74,4,70,40,1,36,32,2,2,3,2,1,1,0,0,0,1
S01006656,Occupancy rating 0,280,124,19,105,88,4,61,33,24,4,23,17,6,68,0,36,1,31
S01006656,Occupancy rating -1 or less,68,19,3,16,31,1,20,4,15,1,10,6,4,18,1,9,0,8
S01006657,All households,286,120,10,110,102,1,85,60,24,1,16,11,5,64,8,30,0,26
S01006657,Occupancy rating +2 or more,23,6,2,4,15,1,13,9,4,0,1,1,0,2,1,1,0,0
S01006657,Occupancy rating +1,55,26,2,24,24,0,22,21,0,1,2,1,1,5,1,1,0,3
S01006657,Occupancy rating 0,150,74,5,69,47,0,40,27,13,0,7,5,2,29,1,14,0,14
S01006657,Occupancy rating -1 or less,58,14,1,13,16,0,10,3,7,0,6,4,2,28,5,14,0,9
S01006658,All households,525,236,22,214,188,7,141,74,63,4,40,31,9,101,5,59,0,37
S01006658,Occupancy rating +2 or more,43,24,2,22,17,1,15,12,3,0,1,0,1,2,0,2,0,0
S01006658,Occupancy rating +1,120,64,9,55,42,3,32,23,9,0,7,2,5,14,1,6,0,7
S01006658,Occupancy rating 0,215,93,10,83,80,2,58,28,28,2,20,19,1,42,0,27,0,15
S01006658,Occupancy rating -1 or less,147,55,1,54,49,1,36,11,23,2,12,10,2,43,4,24,0,15
S01006659,All households,287,93,25,68,93,14,73,39,25,9,6,2,4,101,2,62,0,37
S01006659,Occupancy rating +2 or more,70,33,13,20,28,6,22,13,7,2,0,0,0,9,0,1,0,8
S01006659,Occupancy rating +1,81,31,5,26,31,6,24,13,8,3,1,0,1,19,0,14,0,5
S01006659,Occupancy rating 0,86,16,3,13,23,2,19,11,6,2,2,1,1,47,1,31,0,15
S01006659,Occupancy rating -1 or less,50,13,4,9,11,0,8,2,4,2,3,1,2,26,1,16,0,9
S01006660,All households,247,109,4,105,81,1,64,35,28,1,16,13,3,57,10,31,0,16
S01006660,Occupancy rating +2 or more,25,16,0,16,7,0,7,6,1,0,0,0,0,2,0,2,0,0
S01006660,Occupancy rating +1,48,20,1,19,19,0,13,3,9,1,6,5,1,9,2,2,0,5
S01006660,Occupancy rating 0,109,54,3,51,38,1,32,23,9,0,5,4,1,17,1,9,0,7
S01006660,Occupancy rating -1 or less,65,19,0,19,17,0,12,3,9,0,5,4,1,29,7,18,0,4
S01006661,All households,301,107,16,91,113,14,88,59,21,8,11,3,8,81,2,48,1,30
S01006661,Occupancy rating +2 or more,65,17,5,12,44,8,35,24,7,4,1,0,1,4,0,1,0,3
S01006661,Occupancy rating +1,75,33,8,25,27,5,18,13,2,3,4,1,3,15,0,9,1,5
S01006661,Occupancy rating 0,109,43,2,41,29,1,24,17,6,1,4,1,3,37,2,22,0,13
S01006661,Occupancy rating -1 or less,52,14,1,13,13,0,11,5,6,0,2,1,1,25,0,16,0,9
S01006662,All households,285,117,6,111,100,3,75,33,35,7,22,20,2,68,7,35,0,26
S01006662,Occupancy rating +2 or more,56,40,2,38,14,1,12,12,0,0,1,1,0,2,1,1,0,0
S01006662,Occupancy rating +1,92,38,1,37,41,1,28,12,13,3,12,10,2,13,0,7,0,6
S01006662,Occupancy rating 0,90,23,1,22,36,1,28,9,16,3,7,7,0,31,5,13,0,13
S01006662,Occupancy rating -1 or less,47,16,2,14,9,0,7,0,6,1,2,2,0,22,1,14,0,7
S01006663,All households,245,77,12,65,70,4,59,38,17,4,7,6,1,98,5,64,0,29
S01006663,Occupancy rating +2 or more,42,20,5,15,16,1,15,11,3,1,0,0,0,6,0,4,0,2
S01006663,Occupancy rating +1,56,23,2,21,16,1,13,6,6,1,2,2,0,17,1,13,0,3
S01006663,Occupancy rating 0,90,25,4,21,30,1,25,17,6,2,4,3,1,35,0,24,0,11
S01006663,Occupancy rating -1 or less,57,9,1,8,8,1,6,4,2,0,1,1,0,40,4,23,0,13
S01006664,All households,237,76,8,68,79,6,67,45,16,6,6,1,5,82,4,58,0,20
S01006664,Occupancy rating +2 or more,23,7,0,7,12,1,10,4,3,3,1,0,1,4,0,2,0,2
S01006664,Occupancy rating +1,48,19,0,19,23,2,21,19,2,0,0,0,0,6,0,2,0,4
S01006664,Occupancy rating 0,116,37,6,31,34,3,27,17,7,3,4,1,3,45,1,32,0,12
S01006664,Occupancy rating -1 or less,50,13,2,11,10,0,9,5,4,0,1,0,1,27,3,22,0,2
S01006665,All households,316,145,29,116,88,8,75,56,16,3,5,0,5,83,4,57,0,22
S01006665,Occupancy rating +2 or more,37,16,8,8,16,2,13,8,4,1,1,0,1,5,1,2,0,2
S01006665,Occupancy rating +1,39,21,7,14,12,1,11,9,1,1,0,0,0,6,0,6,0,0
S01006665,Occupancy rating 0,151,79,11,68,42,4,35,28,6,1,3,0,3,30,1,21,0,8
S01006665,Occupancy rating -1 or less,89,29,3,26,18,1,16,11,5,0,1,0,1,42,2,28,0,12
S01006666,All households,499,262,113,149,205,24,121,45,64,12,60,39,21,32,6,7,0,19
S01006666,Occupancy rating +2 or more,25,13,3,10,12,2,9,5,3,1,1,1,0,0,0,0,0,0
S01006666,Occupancy rating +1,100,67,14,53,29,4,22,19,3,0,3,2,1,4,0,1,0,3
S01006666,Occupancy rating 0,308,167,92,75,125,15,64,17,38,9,46,29,17,16,0,5,0,11
S01006666,Occupancy rating -1 or less,66,15,4,11,39,3,26,4,20,2,10,7,3,12,6,1,0,5
S01006667,All households,447,250,43,207,158,19,102,56,38,8,37,22,15,39,7,15,1,16
S01006667,Occupancy rating +2 or more,19,12,4,8,7,0,5,2,1,2,2,1,1,0,0,0,0,0
S01006667,Occupancy rating +1,120,81,10,71,36,9,26,23,3,0,1,1,0,3,1,1,1,0
S01006667,Occupancy rating 0,236,135,21,114,82,6,51,23,22,6,25,14,11,19,1,9,0,9
S01006667,Occupancy rating -1 or less,72,22,8,14,33,4,20,8,12,0,9,6,3,17,5,5,0,7
S01006668,All households,413,187,25,162,106,6,81,56,20,5,19,11,8,120,0,76,0,44
S01006668,Occupancy rating +2 or more,9,6,1,5,2,0,1,1,0,0,1,0,1,1,0,1,0,0
S01006668,Occupancy rating +1,97,61,3,58,32,1,30,26,4,0,1,1,0,4,0,3,0,1
S01006668,Occupancy rating 0,211,85,15,70,57,5,39,26,12,1,13,8,5,69,0,42,0,27
S01006668,Occupancy rating -1 or less,96,35,6,29,15,0,11,3,4,4,4,2,2,46,0,30,0,16
S01006669,All households,444,249,71,178,157,26,116,86,27,3,15,7,8,38,4,15,0,19
S01006669,Occupancy rating +2 or more,43,13,2,11,25,4,19,11,6,2,2,0,2,5,0,2,0,3
S01006669,Occupancy rating +1,49,31,11,20,16,1,15,11,4,0,0,0,0,2,0,0,0,2
S01006669,Occupancy rating 0,278,184,54,130,75,12,58,53,5,0,5,3,2,19,2,10,0,7
S01006669,Occupancy rating -1 or less,74,21,4,17,41,9,24,11,12,1,8,4,4,12,2,3,0,7
S01006670,All households,347,185,50,135,129,19,96,82,11,3,14,10,4,33,1,18,1,13
S01006670,Occupancy rating +2 or more,8,6,1,5,1,0,1,1,0,0,0,0,0,1,0,0,1,0
S01006670,Occupancy rating +1,46,27,1,26,19,2,17,17,0,0,0,0,0,0,0,0,0,0
S01006670,Occupancy rating 0,216,122,38,84,81,12,61,59,1,1,8,6,2,13,0,5,0,8
S01006670,Occupancy rating -1 or less,77,30,10,20,28,5,17,5,10,2,6,4,2,19,1,13,0,5
S01006671,All households,233,82,26,56,102,16,67,40,26,1,19,9,10,49,5,31,0,13
S01006671,Occupancy rating +2 or more,34,8,2,6,22,2,20,13,7,0,0,0,0,4,0,2,0,2
S01006671,Occupancy rating +1,90,46,18,28,40,12,25,20,5,0,3,0,3,4,0,2,0,2
S01006671,Occupancy rating 0,78,18,3,15,33,2,17,7,9,1,14,8,6,27,0,20,0,7
S01006671,Occupancy rating -1 or less,31,10,3,7,7,0,5,0,5,0,2,1,1,14,5,7,0,2
S01006672,All households,366,143,49,94,170,13,98,42,45,11,59,40,19,53,5,20,0,28
S01006672,Occupancy rating +2 or more,40,19,7,12,16,5,10,3,6,1,1,0,1,5,0,3,0,2
S01006672,Occupancy rating +1,113,70,17,53,38,3,30,27,3,0,5,3,2,5,0,3,0,2
S01006672,Occupancy rating 0,132,35,22,13,76,2,37,7,22,8,37,25,12,21,1,7,0,13
S01006672,Occupancy rating -1 or less,81,19,3,16,40,3,21,5,14,2,16,12,4,22,4,7,0,11
S01006673,All households,367,155,17,138,154,6,111,48,47,16,37,23,14,58,6,25,1,26
S01006673,Occupancy rating +2 or more,47,20,6,14,26,4,20,12,4,4,2,1,1,1,0,0,0,1
S01006673,Occupancy rating +1,105,67,7,60,33,2,29,22,6,1,2,0,2,5,1,1,0,3
S01006673,Occupancy rating 0,165,53,4,49,76,0,47,11,27,9,29,18,11,36,2,17,1,16
S01006673,Occupancy rating -1 or less,50,15,0,15,19,0,15,3,10,2,4,4,0,16,3,7,0,6
S01006674,All households,544,300,121,179,220,28,126,53,64,9,66,45,21,24,6,7,2,9
S01006674,Occupancy rating +2 or more,17,11,5,6,6,0,6,5,1,0,0,0,0,0,0,0,0,0
S01006674,Occupancy rating +1,145,95,22,73,50,10,37,29,6,2,3,2,1,0,0,0,0,0
S01006674,Occupancy rating 0,313,170,83,87,130,17,59,16,37,6,54,36,18,13,0,6,1,6
S01006674,Occupancy rating -1 or less,69,24,11,13,34,1,24,3,20,1,9,7,2,11,6,1,1,3
S01006675,All households,315,111,6,105,175,0,110,29,74,7,65,51,14,29,8,2,0,19
S01006675,Occupancy rating +2 or more,28,17,2,15,8,0,7,2,5,0,1,1,0,3,0,0,0,3
S01006675,Occupancy rating +1,108,68,1,67,38,0,32,18,12,2,6,5,1,2,0,0,0,2
S01006675,Occupancy rating 0,135,18,3,15,104,0,60,6,49,5,44,35,9,13,3,1,0,9
S01006675,Occupancy rating -1 or less,44,8,0,8,25,0,11,3,8,0,14,10,4,11,5,1,0,5
S01006676,All households,358,151,49,102,175,18,115,40,57,18,42,29,13,32,6,8,0,18
S01006676,Occupancy rating +2 or more,47,18,6,12,28,9,16,6,8,2,3,1,2,1,0,0,0,1
S01006676,Occupancy rating +1,98,56,10,46,37,2,31,20,8,3,4,4,0,5,0,2,0,3
S01006676,Occupancy rating 0,162,71,31,40,79,6,47,12,27,8,26,18,8,12,2,3,0,7
S01006676,Occupancy rating -1 or less,51,6,2,4,31,1,21,2,14,5,9,6,3,14,4,3,0,7
S01006677,All households,398,196,33,163,156,13,107,59,42,6,36,26,10,46,5,21,0,20
S01006677,Occupancy rating +2 or more,60,22,7,15,36,5,25,23,2,0,6,1,5,2,0,0,0,2
S01006677,Occupancy rating +1,94,47,7,40,40,6,28,23,4,1,6,4,2,7,1,3,0,3
S01006677,Occupancy rating 0,193,115,14,101,61,2,37,12,23,2,22,19,3,17,0,10,0,7
S01006677,Occupancy rating -1 or less,51,12,5,7,19,0,17,1,13,3,2,2,0,20,4,8,0,8
S01006678,All households,525,186,32,154,293,25,193,66,93,34,75,53,22,46,13,15,1,17
S01006678,Occupancy rating +2 or more,77,27,8,19,48,18,29,21,6,2,1,1,0,2,1,0,0,1
S01006678,Occupancy rating +1,180,91,11,80,82,4,64,35,8,21,14,4,10,7,1,3,0,3
S01006678,Occupancy rating 0,201,59,12,47,126,3,79,7,63,9,44,37,7,16,3,8,0,5
S01006678,Occupancy rating -1 or less,67,9,1,8,37,0,21,3,16,2,16,11,5,21,8,4,1,8
S01006679,All households,315,102,33,69,198,37,143,71,46,26,18,10,8,15,1,4,0,10
S01006679,Occupancy rating +2 or more,82,24,10,14,56,13,42,29,8,5,1,1,0,2,0,0,0,2
S01006679,Occupancy rating +1,130,47,13,34,80,16,58,34,13,11,6,1,5,3,0,0,0,3
S01006679,Occupancy rating 0,79,24,9,15,45,5,33,6,19,8,7,4,3,10,1,4,0,5
S01006679,Occupancy rating -1 or less,24,7,1,6,17,3,10,2,6,2,4,4,0,0,0,0,0,0
S01006680,All households,416,178,47,131,206,9,130,38,76,16,67,52,15,32,10,0,0,22
S01006680,Occupancy rating +2 or more,42,25,7,18,16,1,12,9,1,2,3,3,0,1,0,0,0,1
S01006680,Occupancy rating +1,144,98,9,89,44,2,31,19,8,4,11,6,5,2,1,0,0,1
S01006680,Occupancy rating 0,175,45,28,17,115,4,69,6,56,7,42,35,7,15,1,0,0,14
S01006680,Occupancy rating -1 or less,55,10,3,7,31,2,18,4,11,3,11,8,3,14,8,0,0,6
S01006681,All households,464,285,102,183,161,20,110,65,33,12,31,23,8,18,5,3,2,8
S01006681,Occupancy rating +2 or more,39,15,3,12,24,2,18,15,2,1,4,1,3,0,0,0,0,0
S01006681,Occupancy rating +1,120,69,8,61,49,4,39,29,8,2,6,5,1,2,0,0,0,2
S01006681,Occupancy rating 0,221,149,81,68,64,12,37,17,14,6,15,11,4,8,0,2,2,4
S01006681,Occupancy rating -1 or less,84,52,10,42,24,2,16,4,9,3,6,6,0,8,5,1,0,2
S01006682,All households,384,154,56,98,175,4,113,36,66,11,58,46,12,55,13,9,0,33
S01006682,Occupancy rating +2 or more,58,27,3,24,27,1,24,18,4,2,2,2,0,4,2,0,0,2
S01006682,Occupancy rating +1,108,51,10,41,45,1,29,9,16,4,15,9,6,12,0,1,0,11
S01006682,Occupancy rating 0,158,63,34,29,73,2,37,6,28,3,34,29,5,22,2,6,0,14
S01006682,Occupancy rating -1 or less,60,13,9,4,30,0,23,3,18,2,7,6,1,17,9,2,0,6
S01006683,All households,370,125,12,113,186,8,133,61,62,10,45,33,12,59,18,19,0,22
S01006683,Occupancy rating +2 or more,90,46,5,41,38,5,31,22,7,2,2,1,1,6,3,1,0,2
S01006683,Occupancy rating +1,109,38,0,38,57,0,42,14,23,5,15,12,3,14,2,4,0,8
S01006683,Occupancy rating 0,107,29,4,25,62,3,41,17,22,2,18,11,7,16,4,7,0,5
S01006683,Occupancy rating -1 or less,64,12,3,9,29,0,19,8,10,1,10,9,1,23,9,7,0,7
S01006684,All households,401,214,26,188,145,4,114,73,35,6,27,23,4,42,7,11,0,24
S01006684,Occupancy rating +2 or more,27,10,2,8,14,2,11,6,3,2,1,0,1,3,1,2,0,0
S01006684,Occupancy rating +1,89,51,6,45,33,1,31,24,6,1,1,1,0,5,1,0,0,4
S01006684,Occupancy rating 0,209,124,12,112,69,1,51,32,16,3,17,14,3,16,1,4,0,11
S01006684,Occupancy rating -1 or less,76,29,6,23,29,0,21,11,10,0,8,8,0,18,4,5,0,9
S01006685,All households,427,233,45,188,167,13,114,60,40,14,40,31,9,27,4,9,1,13
S01006685,Occupancy rating +2 or more,31,14,2,12,12,0,12,11,1,0,0,0,0,5,0,1,1,3
S01006685,Occupancy rating +1,136,96,21,75,40,9,30,22,7,1,1,1,0,0,0,0,0,0
S01006685,Occupancy rating 0,206,104,19,85,90,4,56,22,26,8,30,23,7,12,0,6,0,6
S01006685,Occupancy rating -1 or less,54,19,3,16,25,0,16,5,6,5,9,7,2,10,4,2,0,4
S01006686,All households,305,116,34,82,173,21,111,48,51,12,41,20,21,16,4,2,2,8
S01006686,Occupancy rating +2 or more,30,14,5,9,15,1,13,7,4,2,1,1,0,1,0,0,0,1
S01006686,Occupancy rating +1,137,76,25,51,60,16,43,38,4,1,1,0,1,1,0,0,1,0
S01006686,Occupancy rating 0,108,23,4,19,77,3,42,3,31,8,32,14,18,8,1,2,1,4
S01006686,Occupancy rating -1 or less,30,3,0,3,21,1,13,0,12,1,7,5,2,6,3,0,0,3
S01006687,All households,419,146,53,93,240,25,139,61,50,28,76,43,33,33,1,7,1,24
S01006687,Occupancy rating +2 or more,23,8,2,6,13,2,9,4,2,3,2,1,1,2,0,0,0,2
S01006687,Occupancy rating +1,207,120,45,75,83,23,57,51,5,1,3,3,0,4,0,1,0,3
S01006687,Occupancy rating 0,149,12,4,8,117,0,57,4,36,17,60,32,28,20,0,5,1,14
S01006687,Occupancy rating -1 or less,40,6,2,4,27,0,16,2,7,7,11,7,4,7,1,1,0,5
S01006688,All households,510,225,160,65,259,57,166,89,55,22,36,16,20,26,5,6,2,13
S01006688,Occupancy rating +2 or more,177,48,32,16,122,27,83,53,17,13,12,5,7,7,1,1,1,4
S01006688,Occupancy rating +1,114,59,35,24,52,12,38,26,6,6,2,1,1,3,0,1,0,2
S01006688,Occupancy rating 0,180,100,81,19,66,16,35,8,24,3,15,5,10,14,4,3,0,7
S01006688,Occupancy rating -1 or less,39,18,12,6,19,2,10,2,8,0,7,5,2,2,0,1,1,0
S01006689,All households,288,79,10,69,178,16,153,85,57,11,9,5,4,31,2,21,0,8
S01006689,Occupancy rating +2 or more,141,35,9,26,102,11,85,46,34,5,6,4,2,4,1,1,0,2
S01006689,Occupancy rating +1,70,21,1,20,40,4,34,24,8,2,2,1,1,9,0,8,0,1
S01006689,Occupancy rating 0,53,12,0,12,27,1,25,7,15,3,1,0,1,14,1,9,0,4
S01006689,Occupancy rating -1 or less,24,11,0,11,9,0,9,8,0,1,0,0,0,4,0,3,0,1
S01006690,All households,308,120,41,79,136,21,83,46,30,7,32,15,17,52,5,26,0,21
S01006690,Occupancy rating +2 or more,42,10,4,6,29,3,24,15,8,1,2,2,0,3,1,0,0,2
S01006690,Occupancy rating +1,140,84,27,57,49,14,31,26,5,0,4,2,2,7,1,3,0,3
S01006690,Occupancy rating 0,99,23,10,13,43,4,20,3,12,5,19,7,12,33,2,16,0,15
S01006690,Occupancy rating -1 or less,27,3,0,3,15,0,8,2,5,1,7,4,3,9,1,7,0,1
S01006691,All households,271,98,25,73,132,15,105,59,37,9,12,5,7,41,4,25,0,12
S01006691,Occupancy rating +2 or more,71,29,7,22,42,7,35,24,6,5,0,0,0,0,0,0,0,0
S01006691,Occupancy rating +1,101,47,12,35,48,5,40,23,14,3,3,1,2,6,2,4,0,0
S01006691,Occupancy rating 0,82,17,5,12,33,1,26,11,14,1,6,2,4,32,0,21,0,11
S01006691,Occupancy rating -1 or less,17,5,1,4,9,2,4,1,3,0,3,2,1,3,2,0,0,1
S01006692,All households,361,127,47,80,194,39,133,71,41,21,22,8,14,40,1,23,0,16
S01006692,Occupancy rating +2 or more,153,49,18,31,93,25,62,42,12,8,6,3,3,11,0,6,0,5
S01006692,Occupancy rating +1,97,33,13,20,54,11,36,19,13,4,7,1,6,10,0,6,0,4
S01006692,Occupancy rating 0,93,43,14,29,38,3,32,10,13,9,3,1,2,12,0,7,0,5
S01006692,Occupancy rating -1 or less,18,2,2,0,9,0,3,0,3,0,6,3,3,7,1,4,0,2
S01006693,All households,497,201,49,152,249,19,175,87,81,7,55,38,17,47,8,11,0,28
S01006693,Occupancy rating +2 or more,73,20,2,18,49,5,42,25,14,3,2,1,1,4,2,0,0,2
S01006693,Occupancy rating +1,162,95,24,71,59,7,50,36,12,2,2,2,0,8,0,3,0,5
S01006693,Occupancy rating 0,183,66,14,52,98,5,51,20,30,1,42,29,13,19,0,8,0,11
S01006693,Occupancy rating -1 or less,79,20,9,11,43,2,32,6,25,1,9,6,3,16,6,0,0,10
S01006694,All households,480,223,132,91,242,67,115,51,45,19,60,45,15,15,2,1,1,11
S01006694,Occupancy rating +2 or more,54,22,13,9,32,16,14,13,1,0,2,1,1,0,0,0,0,0
S01006694,Occupancy rating +1,235,148,86,62,86,34,45,31,7,7,7,3,4,1,0,0,1,0
S01006694,Occupancy rating 0,149,41,26,15,100,15,45,5,31,9,40,34,6,8,0,1,0,7
S01006694,Occupancy rating -1 or less,42,12,7,5,24,2,11,2,6,3,11,7,4,6,2,0,0,4
S01006695,All households,346,131,59,72,203,39,132,65,50,17,32,15,17,12,5,1,1,5
S01006695,Occupancy rating +2 or more,143,45,29,16,97,30,64,50,7,7,3,0,3,1,0,0,0,1
S01006695,Occupancy rating +1,74,20,6,14,50,2,34,6,20,8,14,4,10,4,1,0,1,2
S01006695,Occupancy rating 0,112,62,21,41,46,7,28,9,18,1,11,9,2,4,1,1,0,2
S01006695,Occupancy rating -1 or less,17,4,3,1,10,0,6,0,5,1,4,2,2,3,3,0,0,0
S01006696,All households,390,147,68,79,202,31,110,43,49,18,61,37,24,41,15,11,0,15
S01006696,Occupancy rating +2 or more,75,35,21,14,39,12,25,21,1,3,2,0,2,1,0,0,0,1
S01006696,Occupancy rating +1,125,46,15,31,71,9,47,21,17,9,15,10,5,8,1,0,0,7
S01006696,Occupancy rating 0,135,62,31,31,62,5,25,1,18,6,32,19,13,11,4,3,0,4
S01006696,Occupancy rating -1 or less,55,4,1,3,30,5,13,0,13,0,12,8,4,21,10,8,0,3
S01006697,All households,435,148,66,82,257,33,154,58,70,26,70,43,27,30,7,8,1,14
S01006697,Occupancy rating +2 or more,87,23,13,10,61,16,39,23,14,2,6,2,4,3,0,0,1,2
S01006697,Occupancy rating +1,135,71,34,37,62,15,43,24,11,8,4,2,2,2,2,0,0,0
S01006697,Occupancy rating 0,165,47,17,30,104,2,54,6,32,16,48,32,16,14,1,6,0,7
S01006697,Occupancy rating -1 or less,48,7,2,5,30,0,18,5,13,0,12,7,5,11,4,2,0,5
S01006698,All households,409,224,102,122,151,24,94,50,37,7,33,23,10,34,3,9,0,22
S01006698,Occupancy rating +2 or more,25,16,9,7,9,1,7,5,0,2,1,0,1,0,0,0,0,0
S01006698,Occupancy rating +1,92,53,16,37,38,10,26,23,1,2,2,0,2,1,0,1,0,0
S01006698,Occupancy rating 0,243,136,63,73,88,13,49,21,27,1,26,19,7,19,0,8,0,11
S01006698,Occupancy rating -1 or less,49,19,14,5,16,0,12,1,9,2,4,4,0,14,3,0,0,11
S01006699,All households,209,55,24,31,123,19,79,39,27,13,25,13,12,31,7,8,1,15
S01006699,Occupancy rating +2 or more,77,21,16,5,52,14,37,25,8,4,1,0,1,4,1,0,0,3
S01006699,Occupancy rating +1,66,31,7,24,31,4,25,14,6,5,2,1,1,4,0,1,0,3
S01006699,Occupancy rating 0,42,2,1,1,27,1,8,0,6,2,18,9,9,13,2,4,1,6
S01006699,Occupancy rating -1 or less,24,1,0,1,13,0,9,0,7,2,4,3,1,10,4,3,0,3
S01006700,All households,431,176,67,109,208,51,123,63,39,21,34,13,21,47,7,12,3,25
S01006700,Occupancy rating +2 or more,133,39,21,18,88,29,55,36,11,8,4,0,4,6,1,2,1,2
S01006700,Occupancy rating +1,126,68,23,45,54,17,28,18,6,4,9,3,6,4,1,1,0,2
S01006700,Occupancy rating 0,122,48,20,28,49,4,27,8,14,5,18,8,10,25,2,7,1,15
S01006700,Occupancy rating -1 or less,50,21,3,18,17,1,13,1,8,4,3,2,1,12,3,2,1,6
S01006701,All households,321,99,33,66,208,22,116,38,53,25,70,57,13,14,8,0,1,5
S01006701,Occupancy rating +2 or more,37,19,5,14,17,5,12,8,3,1,0,0,0,1,0,0,0,1
S01006701,Occupancy rating +1,122,56,17,39,66,16,46,29,7,10,4,4,0,0,0,0,0,0
S01006701,Occupancy rating 0,110,18,10,8,85,0,40,1,28,11,45,35,10,7,2,0,1,4
S01006701,Occupancy rating -1 or less,52,6,1,5,40,1,18,0,15,3,21,18,3,6,6,0,0,0
S01006702,All households,332,90,47,43,224,35,151,62,58,31,38,16,22,18,9,0,1,8
S01006702,Occupancy rating +2 or more,67,25,15,10,41,9,26,22,2,2,6,3,3,1,0,0,0,1
S01006702,Occupancy rating +1,149,55,26,29,91,20,65,38,16,11,6,4,2,3,1,0,0,2
S01006702,Occupancy rating 0,82,8,4,4,67,6,41,2,24,15,20,6,14,7,3,0,1,3
S01006702,Occupancy rating -1 or less,34,2,2,0,25,0,19,0,16,3,6,3,3,7,5,0,0,2
S01006703,All households,301,107,49,58,184,16,120,38,62,20,48,34,14,10,3,0,1,6
S01006703,Occupancy rating +2 or more,56,27,10,17,29,4,23,13,3,7,2,1,1,0,0,0,0,0
S01006703,Occupancy rating +1,93,52,22,30,40,7,30,20,7,3,3,2,1,1,0,0,0,1
S01006703,Occupancy rating 0,112,24,16,8,84,4,51,4,38,9,29,19,10,4,0,0,1,3
S01006703,Occupancy rating -1 or less,40,4,1,3,31,1,16,1,14,1,14,12,2,5,3,0,0,2
S01006704,All households,301,123,28,95,163,13,96,36,45,15,54,35,19,15,6,1,0,8
S01006704,Occupancy rating +2 or more,18,12,3,9,6,0,3,0,2,1,3,2,1,0,0,0,0,0
S01006704,Occupancy rating +1,110,57,13,44,51,11,36,24,6,6,4,0,4,2,0,0,0,2
S01006704,Occupancy rating 0,133,45,8,37,80,1,44,12,27,5,35,25,10,8,1,1,0,6
S01006704,Occupancy rating -1 or less,40,9,4,5,26,1,13,0,10,3,12,8,4,5,5,0,0,0
S01006705,All households,364,148,80,68,205,30,129,60,42,27,46,29,17,11,4,1,0,6
S01006705,Occupancy rating +2 or more,62,26,14,12,35,6,27,22,4,1,2,2,0,1,0,0,0,1
S01006705,Occupancy rating +1,162,96,52,44,64,17,44,33,5,6,3,2,1,2,0,0,0,2
S01006705,Occupancy rating 0,107,20,12,8,81,4,44,3,24,17,33,19,14,6,3,1,0,2
S01006705,Occupancy rating -1 or less,33,6,2,4,25,3,14,2,9,3,8,6,2,2,1,0,0,1
S01006706,All households,272,81,33,48,180,16,119,40,56,23,45,30,15,11,3,0,0,8
S01006706,Occupancy rating +2 or more,43,13,5,8,30,8,21,15,4,2,1,0,1,0,0,0,0,0
S01006706,Occupancy rating +1,101,54,19,35,47,7,36,22,8,6,4,1,3,0,0,0,0,0
S01006706,Occupancy rating 0,96,10,6,4,79,1,48,3,34,11,30,21,9,7,2,0,0,5
S01006706,Occupancy rating -1 or less,32,4,3,1,24,0,14,0,10,4,10,8,2,4,1,0,0,3
S01006707,All households,311,95,27,68,204,15,123,44,57,22,66,43,23,12,1,2,0,9
S01006707,Occupancy rating +2 or more,37,12,6,6,24,4,18,9,4,5,2,1,1,1,0,0,0,1
S01006707,Occupancy rating +1,111,47,12,35,64,8,47,30,9,8,9,3,6,0,0,0,0,0
S01006707,Occupancy rating 0,128,32,7,25,89,3,42,4,30,8,44,31,13,7,1,0,0,6
S01006707,Occupancy rating -1 or less,35,4,2,2,27,0,16,1,14,1,11,8,3,4,0,2,0,2
S01006708,All households,364,124,76,48,224,46,142,52,60,30,36,17,19,16,5,1,0,10
S01006708,Occupancy rating +2 or more,47,13,4,9,32,11,21,17,3,1,0,0,0,2,0,0,0,2
S01006708,Occupancy rating +1,143,61,28,33,82,28,47,27,11,9,7,2,5,0,0,0,0,0
S01006708,Occupancy rating 0,134,41,37,4,85,3,57,6,33,18,25,12,13,8,1,1,0,6
S01006708,Occupancy rating -1 or less,40,9,7,2,25,4,17,2,13,2,4,3,1,6,4,0,0,2
S01006709,All households,376,106,44,62,260,27,159,53,77,29,74,51,23,10,3,1,0,6
S01006709,Occupancy rating +2 or more,65,22,12,10,43,8,31,17,11,3,4,2,2,0,0,0,0,0
S01006709,Occupancy rating +1,106,46,20,26,60,11,42,24,12,6,7,5,2,0,0,0,0,0
S01006709,Occupancy rating 0,171,33,10,23,131,8,71,10,44,17,52,36,16,7,2,1,0,4
S01006709,Occupancy rating -1 or less,34,5,2,3,26,0,15,2,10,3,11,8,3,3,1,0,0,2
S01006710,All households,415,150,98,52,251,45,173,86,50,37,33,17,16,14,4,0,1,9
S01006710,Occupancy rating +2 or more,119,42,14,28,71,17,52,41,6,5,2,2,0,6,1,0,1,4
S01006710,Occupancy rating +1,142,37,19,18,101,13,76,33,26,17,12,6,6,4,1,0,0,3
S01006710,Occupancy rating 0,133,66,60,6,67,14,38,12,14,12,15,8,7,0,0,0,0,0
S01006710,Occupancy rating -1 or less,21,5,5,0,12,1,7,0,4,3,4,1,3,4,2,0,0,2
S01006711,All households,511,254,117,137,248,23,176,99,53,24,49,24,25,9,3,1,1,4
S01006711,Occupancy rating +2 or more,102,28,8,20,74,6,66,53,6,7,2,0,2,0,0,0,0,0
S01006711,Occupancy rating +1,107,42,14,28,65,3,46,23,18,5,16,7,9,0,0,0,0,0
S01006711,Occupancy rating 0,256,171,88,83,79,12,50,21,20,9,17,10,7,6,1,1,0,4
S01006711,Occupancy rating -1 or less,46,13,7,6,30,2,14,2,9,3,14,7,7,3,2,0,1,0
S01006712,All households,250,82,54,28,161,29,102,41,37,24,30,12,18,7,3,1,1,2
S01006712,Occupancy rating +2 or more,31,6,3,3,25,6,19,16,2,1,0,0,0,0,0,0,0,0
S01006712,Occupancy rating +1,110,48,32,16,61,19,37,24,8,5,5,1,4,1,0,0,0,1
S01006712,Occupancy rating 0,81,15,9,6,64,4,39,1,24,14,21,8,13,2,1,1,0,0
S01006712,Occupancy rating -1 or less,28,13,10,3,11,0,7,0,3,4,4,3,1,4,2,0,1,1
S01006713,All households,420,137,64,73,263,29,182,79,67,36,52,34,18,20,7,1,3,9
S01006713,Occupancy rating +2 or more,50,13,3,10,35,10,25,22,1,2,0,0,0,2,0,0,0,2
S01006713,Occupancy rating +1,165,84,48,36,80,15,60,43,13,4,5,2,3,1,0,0,0,1
S01006713,Occupancy rating 0,136,28,8,20,101,4,66,9,36,21,31,25,6,7,2,1,0,4
S01006713,Occupancy rating -1 or less,69,12,5,7,47,0,31,5,17,9,16,7,9,10,5,0,3,2
S01006714,All households,304,106,64,42,176,28,122,55,48,19,26,9,17,22,8,2,1,11
S01006714,Occupancy rating +2 or more,110,32,14,18,75,13,62,48,9,5,0,0,0,3,0,1,1,1
S01006714,Occupancy rating +1,75,25,10,15,45,6,28,5,16,7,11,3,8,5,0,0,0,5
S01006714,Occupancy rating 0,92,42,34,8,43,8,22,1,18,3,13,5,8,7,4,0,0,3
S01006714,Occupancy rating -1 or less,27,7,6,1,13,1,10,1,5,4,2,1,1,7,4,1,0,2
S01006715,All households,218,44,16,28,154,8,96,34,50,12,50,38,12,20,11,1,0,8
S01006715,Occupancy rating +2 or more,49,19,8,11,28,5,23,21,2,0,0,0,0,2,1,0,0,1
S01006715,Occupancy rating +1,66,23,7,16,42,2,26,12,10,4,14,9,5,1,1,0,0,0
S01006715,Occupancy rating 0,71,1,0,1,61,0,38,0,32,6,23,18,5,9,3,0,0,6
S01006715,Occupancy rating -1 or less,32,1,1,0,23,1,9,1,6,2,13,11,2,8,6,1,0,1
S01006716,All households,242,54,17,37,167,16,109,38,45,26,42,25,17,21,9,1,2,9
S01006716,Occupancy rating +2 or more,73,24,6,18,49,14,34,28,3,3,1,0,1,0,0,0,0,0
S01006716,Occupancy rating +1,82,22,8,14,51,2,35,9,13,13,14,6,8,9,1,0,2,6
S01006716,Occupancy rating 0,65,7,2,5,54,0,34,1,24,9,20,14,6,4,3,1,0,0
S01006716,Occupancy rating -1 or less,22,1,1,0,13,0,6,0,5,1,7,5,2,8,5,0,0,3
S01006717,All households,445,149,98,51,276,37,179,70,68,41,60,31,29,20,7,2,0,11
S01006717,Occupancy rating +2 or more,69,24,12,12,44,11,31,23,4,4,2,2,0,1,0,0,0,1
S01006717,Occupancy rating +1,148,58,32,26,85,11,61,41,7,13,13,3,10,5,2,1,0,2
S01006717,Occupancy rating 0,166,44,35,9,111,8,69,4,46,19,34,18,16,11,2,1,0,8
S01006717,Occupancy rating -1 or less,62,23,19,4,36,7,18,2,11,5,11,8,3,3,3,0,0,0
S01006718,All households,248,58,33,25,175,19,115,41,41,33,41,20,21,15,5,1,1,8
S01006718,Occupancy rating +2 or more,103,46,30,16,57,16,38,33,2,3,3,2,1,0,0,0,0,0
S01006718,Occupancy rating +1,72,10,3,7,55,2,36,4,12,20,17,1,16,7,1,1,1,4
S01006718,Occupancy rating 0,46,2,0,2,42,1,30,3,20,7,11,9,2,2,0,0,0,2
S01006718,Occupancy rating -1 or less,27,0,0,0,21,0,11,1,7,3,10,8,2,6,4,0,0,2
S01006719,All households,350,76,26,50,250,18,180,66,79,35,52,32,20,24,14,0,1,9
S01006719,Occupancy rating +2 or more,95,31,8,23,63,11,48,39,7,2,4,2,2,1,0,0,0,1
S01006719,Occupancy rating +1,128,38,13,25,88,5,65,24,27,14,18,9,9,2,0,0,0,2
S01006719,Occupancy rating 0,89,5,4,1,74,2,54,3,36,15,18,11,7,10,7,0,0,3
S01006719,Occupancy rating -1 or less,38,2,1,1,25,0,13,0,9,4,12,10,2,11,7,0,1,3
S01006720,All households,242,61,22,39,171,13,119,52,45,22,39,18,21,10,5,0,0,5
S01006720,Occupancy rating +2 or more,56,19,4,15,36,7,29,26,3,0,0,0,0,1,1,0,0,0
S01006720,Occupancy rating +1,81,25,8,17,52,4,42,25,7,10,6,1,5,4,1,0,0,3
S01006720,Occupancy rating 0,73,13,7,6,57,1,34,1,23,10,22,9,13,3,1,0,0,2
S01006720,Occupancy rating -1 or less,32,4,3,1,26,1,14,0,12,2,11,8,3,2,2,0,0,0
S01006721,All households,386,117,45,72,249,24,167,64,67,36,58,35,23,20,7,0,2,11
S01006721,Occupancy rating +2 or more,92,37,16,21,55,12,39,30,5,4,4,0,4,0,0,0,0,0
S01006721,Occupancy rating +1,124,40,18,22,77,8,58,29,17,12,11,4,7,7,2,0,0,5
S01006721,Occupancy rating 0,125,32,9,23,83,3,49,3,33,13,31,22,9,10,4,0,2,4
S01006721,Occupancy rating -1 or less,45,8,2,6,34,1,21,2,12,7,12,9,3,3,1,0,0,2
S01006722,All households,312,85,37,48,204,18,128,45,58,25,58,33,25,23,15,1,1,6
S01006722,Occupancy rating +2 or more,76,34,13,21,42,7,31,22,7,2,4,2,2,0,0,0,0,0
S01006722,Occupancy rating +1,96,31,13,18,63,11,42,19,14,9,10,2,8,2,1,0,1,0
S01006722,Occupancy rating 0,105,20,11,9,73,0,43,4,30,9,30,20,10,12,8,0,0,4
S01006722,Occupancy rating -1 or less,35,0,0,0,26,0,12,0,7,5,14,9,5,9,6,1,0,2
S01006723,All households,283,87,42,45,181,19,119,43,47,29,43,26,17,15,7,0,1,7
S01006723,Occupancy rating +2 or more,71,28,13,15,42,9,30,25,3,2,3,2,1,1,0,0,0,1
S01006723,Occupancy rating +1,103,29,15,14,70,9,46,16,15,15,15,9,6,4,0,0,0,4
S01006723,Occupancy rating 0,79,20,10,10,52,0,34,2,23,9,18,12,6,7,4,0,1,2
S01006723,Occupancy rating -1 or less,30,10,4,6,17,1,9,0,6,3,7,3,4,3,3,0,0,0
S01006724,All households,343,66,11,55,250,7,146,21,94,31,97,81,16,27,14,3,0,10
S01006724,Occupancy rating +2 or more,62,32,5,27,28,5,23,17,5,1,0,0,0,2,0,0,0,2
S01006724,Occupancy rating +1,86,20,2,18,64,0,41,4,26,11,23,16,7,2,0,0,0,2
S01006724,Occupancy rating 0,132,12,3,9,108,1,51,0,37,14,56,50,6,12,8,1,0,3
S01006724,Occupancy rating -1 or less,63,2,1,1,50,1,31,0,26,5,18,15,3,11,6,2,0,3
S01006725,All households,265,72,17,55,173,16,131,47,58,26,26,18,8,20,11,2,1,6
S01006725,Occupancy rating +2 or more,74,29,10,19,44,7,36,27,5,4,1,0,1,1,0,0,0,1
S01006725,Occupancy rating +1,80,20,6,14,54,7,37,13,14,10,10,6,4,6,1,2,0,3
S01006725,Occupancy rating 0,83,21,0,21,55,1,40,6,23,11,14,11,3,7,4,0,1,2
S01006725,Occupancy rating -1 or less,28,2,1,1,20,1,18,1,16,1,1,1,0,6,6,0,0,0
S01006726,All households,505,110,18,92,330,7,185,53,114,18,138,107,31,65,28,3,0,34
S01006726,Occupancy rating +2 or more,80,36,9,27,41,5,34,23,11,0,2,0,2,3,1,0,0,2
S01006726,Occupancy rating +1,130,49,7,42,77,0,53,21,26,6,24,12,12,4,1,0,0,3
S01006726,Occupancy rating 0,195,18,1,17,146,2,66,8,47,11,78,69,9,31,11,3,0,17
S01006726,Occupancy rating -1 or less,100,7,1,6,66,0,32,1,30,1,34,26,8,27,15,0,0,12
S01006727,All households,395,137,43,94,225,5,152,44,88,20,68,49,19,33,16,0,1,16
S01006727,Occupancy rating +2 or more,58,31,6,25,26,1,23,16,6,1,2,1,1,1,1,0,0,0
S01006727,Occupancy rating +1,99,28,3,25,64,1,43,13,20,10,20,11,9,7,0,0,0,7
S01006727,Occupancy rating 0,167,60,29,31,98,2,62,13,42,7,34,26,8,9,4,0,0,5
S01006727,Occupancy rating -1 or less,71,18,5,13,37,1,24,2,20,2,12,11,1,16,11,0,1,4
S01006728,All households,334,103,42,61,213,22,131,46,69,16,60,40,20,18,8,1,1,8
S01006728,Occupancy rating +2 or more,67,28,9,19,39,8,28,18,8,2,3,1,2,0,0,0,0,0
S01006728,Occupancy rating +1,125,61,26,35,61,13,40,27,7,6,8,4,4,3,0,0,1,2
S01006728,Occupancy rating 0,113,11,6,5,93,1,51,0,43,8,41,31,10,9,3,1,0,5
S01006728,Occupancy rating -1 or less,29,3,1,2,20,0,12,1,11,0,8,4,4,6,5,0,0,1
S01006729,All households,349,112,48,64,205,12,120,41,58,21,73,53,20,32,14,0,1,17
S01006729,Occupancy rating +2 or more,64,35,13,22,28,4,24,22,1,1,0,0,0,1,1,0,0,0
S01006729,Occupancy rating +1,118,46,10,36,66,6,45,18,15,12,15,10,5,6,3,0,1,2
S01006729,Occupancy rating 0,112,25,20,5,72,1,36,1,30,5,35,26,9,15,4,0,0,11
S01006729,Occupancy rating -1 or less,55,6,5,1,39,1,15,0,12,3,23,17,6,10,6,0,0,4
S01006730,All households,276,55,20,35,205,20,154,68,60,26,31,20,11,16,7,0,0,9
S01006730,Occupancy rating +2 or more,105,33,7,26,70,12,55,49,3,3,3,2,1,2,0,0,0,2
S01006730,Occupancy rating +1,71,9,4,5,59,1,48,12,26,10,10,4,6,3,0,0,0,3
S01006730,Occupancy rating 0,74,11,7,4,56,5,37,5,20,12,14,10,4,7,4,0,0,3
S01006730,Occupancy rating -1 or less,26,2,2,0,20,2,14,2,11,1,4,4,0,4,3,0,0,1
S01006731,All households,257,87,17,70,156,11,112,54,39,19,33,17,16,14,5,0,1,8
S01006731,Occupancy rating +2 or more,87,36,7,29,50,7,41,37,3,1,2,1,1,1,1,0,0,0
S01006731,Occupancy rating +1,48,15,3,12,31,1,25,6,8,11,5,1,4,2,0,0,0,2
S01006731,Occupancy rating 0,94,32,6,26,57,2,33,9,19,5,22,13,9,5,1,0,1,3
S01006731,Occupancy rating -1 or less,28,4,1,3,18,1,13,2,9,2,4,2,2,6,3,0,0,3
S01006732,All households,353,65,13,52,267,26,214,78,104,32,27,15,12,21,6,1,0,14
S01006732,Occupancy rating +2 or more,254,38,9,29,205,21,171,71,77,23,13,6,7,11,5,0,0,6
S01006732,Occupancy rating +1,50,17,3,14,31,5,22,4,14,4,4,1,3,2,0,0,0,2
S01006732,Occupancy rating 0,30,7,0,7,19,0,13,2,7,4,6,4,2,4,0,0,0,4
S01006732,Occupancy rating -1 or less,19,3,1,2,12,0,8,1,6,1,4,4,0,4,1,1,0,2
S01006733,All households,309,36,10,26,262,17,227,63,146,18,18,12,6,11,6,0,0,5
S01006733,Occupancy rating +2 or more,265,26,5,21,231,13,208,61,130,17,10,6,4,8,3,0,0,5
S01006733,Occupancy rating +1,33,8,3,5,24,4,13,2,10,1,7,5,2,1,1,0,0,0
S01006733,Occupancy rating 0,8,2,2,0,4,0,4,0,4,0,0,0,0,2,2,0,0,0
S01006733,Occupancy rating -1 or less,3,0,0,0,3,0,2,0,2,0,1,1,0,0,0,0,0,0
S01006734,All households,352,75,25,50,271,18,237,73,139,25,16,7,9,6,4,0,0,2
S01006734,Occupancy rating +2 or more,247,42,14,28,202,16,178,59,102,17,8,3,5,3,3,0,0,0
S01006734,Occupancy rating +1,71,25,9,16,46,1,42,14,23,5,3,2,1,0,0,0,0,0
S01006734,Occupancy rating 0,30,7,2,5,21,1,15,0,12,3,5,2,3,2,1,0,0,1
S01006734,Occupancy rating -1 or less,4,1,0,1,2,0,2,0,2,0,0,0,0,1,0,0,0,1
S01006735,All households,245,45,29,16,192,50,135,59,61,15,7,5,2,8,6,0,0,2
S01006735,Occupancy rating +2 or more,195,24,13,11,168,39,122,55,54,13,7,5,2,3,3,0,0,0
S01006735,Occupancy rating +1,35,16,12,4,18,8,10,4,4,2,0,0,0,1,1,0,0,0
S01006735,Occupancy rating 0,11,5,4,1,4,3,1,0,1,0,0,0,0,2,0,0,0,2
S01006735,Occupancy rating -1 or less,4,0,0,0,2,0,2,0,2,0,0,0,0,2,2,0,0,0
S01006736,All households,395,50,2,48,332,9,285,96,176,13,38,25,13,13,5,0,0,8
S01006736,Occupancy rating +2 or more,281,33,1,32,243,9,219,85,124,10,15,9,6,5,2,0,0,3
S01006736,Occupancy rating +1,90,14,0,14,69,0,56,11,42,3,13,9,4,7,3,0,0,4
S01006736,Occupancy rating 0,22,2,1,1,19,0,9,0,9,0,10,7,3,1,0,0,0,1
S01006736,Occupancy rating -1 or less,2,1,0,1,1,0,1,0,1,0,0,0,0,0,0,0,0,0
S01006737,All households,265,51,22,29,199,38,144,61,61,22,17,6,11,15,5,0,2,8
S01006737,Occupancy rating +2 or more,182,28,16,12,150,31,110,48,43,19,9,3,6,4,2,0,0,2
S01006737,Occupancy rating +1,48,14,2,12,29,4,21,12,8,1,4,2,2,5,0,0,1,4
S01006737,Occupancy rating 0,25,8,4,4,15,3,10,0,8,2,2,1,1,2,0,0,1,1
S01006737,Occupancy rating -1 or less,10,1,0,1,5,0,3,1,2,0,2,0,2,4,3,0,0,1
S01006738,All households,453,216,30,186,206,9,156,96,50,10,41,25,16,31,8,0,0,23
S01006738,Occupancy rating +2 or more,102,40,12,28,59,6,50,37,9,4,3,1,2,3,1,0,0,2
S01006738,Occupancy rating +1,154,87,12,75,57,2,48,37,9,2,7,3,4,10,2,0,0,8
S01006738,Occupancy rating 0,164,82,6,76,71,1,45,18,24,3,25,16,9,11,1,0,0,10
S01006738,Occupancy rating -1 or less,33,7,0,7,19,0,13,4,8,1,6,5,1,7,4,0,0,3
S01006739,All households,309,117,26,91,173,17,134,82,41,11,22,13,9,19,5,2,0,12
S01006739,Occupancy rating +2 or more,77,23,16,7,51,12,39,27,8,4,0,0,0,3,2,0,0,1
S01006739,Occupancy rating +1,115,48,4,44,66,4,56,44,7,5,6,3,3,1,0,0,0,1
S01006739,Occupancy rating 0,87,33,3,30,43,1,29,10,17,2,13,7,6,11,0,2,0,9
S01006739,Occupancy rating -1 or less,30,13,3,10,13,0,10,1,9,0,3,3,0,4,3,0,0,1
S01006740,All households,335,103,51,52,213,29,143,74,40,29,41,24,17,19,8,0,3,8
S01006740,Occupancy rating +2 or more,81,30,19,11,47,11,33,26,5,2,3,1,2,4,2,0,0,2
S01006740,Occupancy rating +1,125,41,23,18,80,16,58,40,10,8,6,1,5,4,3,0,0,1
S01006740,Occupancy rating 0,96,25,7,18,64,1,39,8,19,12,24,15,9,7,0,0,2,5
S01006740,Occupancy rating -1 or less,33,7,2,5,22,1,13,0,6,7,8,7,1,4,3,0,1,0
S01006741,All households,342,134,77,57,198,49,127,60,45,22,22,7,15,10,4,0,1,5
S01006741,Occupancy rating +2 or more,96,36,14,22,60,15,44,30,10,4,1,0,1,0,0,0,0,0
S01006741,Occupancy rating +1,87,21,14,7,64,17,35,10,17,8,12,5,7,2,1,0,0,1
S01006741,Occupancy rating 0,134,72,46,26,59,13,39,18,14,7,7,2,5,3,3,0,0,0
S01006741,Occupancy rating -1 or less,25,5,3,2,15,4,9,2,4,3,2,0,2,5,0,0,1,4
S01006742,All households,233,92,58,34,139,25,92,41,40,11,22,11,11,2,1,0,0,1
S01006742,Occupancy rating +2 or more,80,34,14,20,46,10,34,25,7,2,2,0,2,0,0,0,0,0
S01006742,Occupancy rating +1,51,9,8,1,41,2,32,7,20,5,7,3,4,1,0,0,0,1
S01006742,Occupancy rating 0,84,41,29,12,43,12,21,8,9,4,10,6,4,0,0,0,0,0
S01006742,Occupancy rating -1 or less,18,8,7,1,9,1,5,1,4,0,3,2,1,1,1,0,0,0
S01006743,All households,271,106,41,65,155,28,108,63,29,16,19,10,9,10,2,0,0,8
S01006743,Occupancy rating +2 or more,82,26,9,17,54,14,39,26,5,8,1,0,1,2,0,0,0,2
S01006743,Occupancy rating +1,99,44,10,34,53,5,41,27,10,4,7,1,6,2,1,0,0,1
S01006743,Occupancy rating 0,80,33,20,13,42,8,25,10,11,4,9,7,2,5,0,0,0,5
S01006743,Occupancy rating -1 or less,10,3,2,1,6,1,3,0,3,0,2,2,0,1,1,0,0,0
S01006744,All households,302,119,26,93,173,14,133,76,38,19,26,13,13,10,5,0,0,5
S01006744,Occupancy rating +2 or more,75,24,3,21,51,8,41,30,8,3,2,0,2,0,0,0,0,0
S01006744,Occupancy rating +1,89,43,14,29,43,3,37,23,11,3,3,3,0,3,0,0,0,3
S01006744,Occupancy rating 0,110,45,7,38,63,2,43,19,12,12,18,7,11,2,1,0,0,1
S01006744,Occupancy rating -1 or less,28,7,2,5,16,1,12,4,7,1,3,3,0,5,4,0,0,1
S01006745,All households,409,154,92,62,235,31,143,69,46,28,61,29,32,20,3,2,0,15
S01006745,Occupancy rating +2 or more,102,33,20,13,66,12,47,32,12,3,7,2,5,3,0,1,0,2
S01006745,Occupancy rating +1,129,60,29,31,65,15,42,27,8,7,8,3,5,4,0,0,0,4
S01006745,Occupancy rating 0,142,50,34,16,82,4,42,7,20,15,36,17,19,10,1,1,0,8
S01006745,Occupancy rating -1 or less,36,11,9,2,22,0,12,3,6,3,10,7,3,3,2,0,0,1
S01006746,All households,350,97,52,45,243,33,156,56,72,28,54,28,26,10,3,0,1,6
S01006746,Occupancy rating +2 or more,114,39,20,19,73,21,50,35,13,2,2,0,2,2,0,0,0,2
S01006746,Occupancy rating +1,87,25,12,13,60,5,43,16,19,8,12,4,8,2,0,0,0,2
S01006746,Occupancy rating 0,110,31,19,12,75,6,45,5,28,12,24,13,11,4,2,0,0,2
S01006746,Occupancy rating -1 or less,39,2,1,1,35,1,18,0,12,6,16,11,5,2,1,0,1,0
S01006747,All households,368,82,51,31,274,88,168,74,54,40,18,7,11,12,6,1,1,4
S01006747,Occupancy rating +2 or more,270,64,42,22,202,79,114,61,29,24,9,3,6,4,2,0,0,2
S01006747,Occupancy rating +1,65,15,8,7,48,8,36,10,17,9,4,2,2,2,1,0,0,1
S01006747,Occupancy rating 0,26,2,1,1,19,0,16,3,7,6,3,1,2,5,3,0,1,1
S01006747,Occupancy rating -1 or less,7,1,0,1,5,1,2,0,1,1,2,1,1,1,0,1,0,0
S01006748,All households,408,123,55,68,276,56,204,94,77,33,16,8,8,9,3,0,0,6
S01006748,Occupancy rating +2 or more,190,33,18,15,157,37,117,64,35,18,3,1,2,0,0,0,0,0
S01006748,Occupancy rating +1,96,45,17,28,51,8,43,22,12,9,0,0,0,0,0,0,0,0
S01006748,Occupancy rating 0,98,42,18,24,50,7,32,6,20,6,11,5,6,6,1,0,0,5
S01006748,Occupancy rating -1 or less,24,3,2,1,18,4,12,2,10,0,2,2,0,3,2,0,0,1
S01006749,All households,419,141,67,74,260,35,197,87,79,31,28,13,15,18,9,0,1,8
S01006749,Occupancy rating +2 or more,164,61,17,44,101,20,77,56,18,3,4,1,3,2,1,0,0,1
S01006749,Occupancy rating +1,126,26,12,14,94,5,75,24,35,16,14,7,7,6,2,0,0,4
S01006749,Occupancy rating 0,105,41,31,10,56,10,39,6,23,10,7,4,3,8,4,0,1,3
S01006749,Occupancy rating -1 or less,24,13,7,6,9,0,6,1,3,2,3,1,2,2,2,0,0,0
S01006750,All households,292,83,43,40,191,31,134,67,41,26,26,12,14,18,5,1,0,12
S01006750,Occupancy rating +2 or more,114,36,17,19,75,16,57,47,8,2,2,1,1,3,1,0,0,2
S01006750,Occupancy rating +1,97,18,6,12,73,10,52,16,20,16,11,5,6,6,0,1,0,5
S01006750,Occupancy rating 0,66,27,18,9,32,5,19,3,10,6,8,4,4,7,3,0,0,4
S01006750,Occupancy rating -1 or less,15,2,2,0,11,0,6,1,3,2,5,2,3,2,1,0,0,1
S01006751,All households,241,93,60,33,135,26,90,40,35,15,19,8,11,13,7,0,0,6
S01006751,Occupancy rating +2 or more,77,21,9,12,55,11,42,24,15,3,2,0,2,1,1,0,0,0
S01006751,Occupancy rating +1,67,24,9,15,42,10,26,14,9,3,6,2,4,1,0,0,0,1
S01006751,Occupancy rating 0,81,44,40,4,31,5,17,2,9,6,9,5,4,6,2,0,0,4
S01006751,Occupancy rating -1 or less,16,4,2,2,7,0,5,0,2,3,2,1,1,5,4,0,0,1
S01006752,All households,339,119,54,65,208,46,124,53,47,24,38,25,13,12,4,1,0,7
S01006752,Occupancy rating +2 or more,112,44,16,28,66,25,40,29,6,5,1,1,0,2,0,1,0,1
S01006752,Occupancy rating +1,114,36,14,22,75,15,47,18,22,7,13,8,5,3,0,0,0,3
S01006752,Occupancy rating 0,93,32,19,13,58,6,33,6,17,10,19,13,6,3,0,0,0,3
S01006752,Occupancy rating -1 or less,20,7,5,2,9,0,4,0,2,2,5,3,2,4,4,0,0,0
S01006753,All households,410,115,49,66,279,70,181,75,73,33,28,11,17,16,6,1,1,8
S01006753,Occupancy rating +2 or more,243,58,26,32,179,59,116,55,41,20,4,2,2,6,2,0,0,4
S01006753,Occupancy rating +1,94,34,14,20,57,9,37,14,14,9,11,3,8,3,1,0,0,2
S01006753,Occupancy rating 0,60,19,7,12,35,2,22,5,14,3,11,5,6,6,2,1,1,2
S01006753,Occupancy rating -1 or less,13,4,2,2,8,0,6,1,4,1,2,1,1,1,1,0,0,0
S01006754,All households,400,88,28,60,300,74,203,105,62,36,23,11,12,12,1,0,1,10
S01006754,Occupancy rating +2 or more,250,52,21,31,197,62,126,76,29,21,9,4,5,1,0,0,0,1
S01006754,Occupancy rating +1,93,24,5,19,66,11,47,19,21,7,8,4,4,3,1,0,0,2
S01006754,Occupancy rating 0,49,12,2,10,31,1,24,8,9,7,6,3,3,6,0,0,1,5
S01006754,Occupancy rating -1 or less,8,0,0,0,6,0,6,2,3,1,0,0,0,2,0,0,0,2
S01006755,All households,289,70,21,49,204,16,171,61,97,13,17,9,8,15,5,1,0,9
S01006755,Occupancy rating +2 or more,184,37,11,26,144,11,128,48,72,8,5,3,2,3,3,0,0,0
S01006755,Occupancy rating +1,59,29,8,21,28,4,22,9,13,0,2,1,1,2,0,0,0,2
S01006755,Occupancy rating 0,29,1,1,0,22,1,14,3,8,3,7,3,4,6,0,1,0,5
S01006755,Occupancy rating -1 or less,17,3,1,2,10,0,7,1,4,2,3,2,1,4,2,0,0,2
S01006756,All households,286,82,1,81,177,3,162,75,75,12,12,12,0,27,3,2,0,22
S01006756,Occupancy rating +2 or more,139,20,0,20,109,3,103,37,57,9,3,3,0,10,3,1,0,6
S01006756,Occupancy rating +1,49,28,0,28,19,0,19,16,3,0,0,0,0,2,0,0,0,2
S01006756,Occupancy rating 0,70,29,1,28,31,0,26,14,11,1,5,5,0,10,0,1,0,9
S01006756,Occupancy rating -1 or less,28,5,0,5,18,0,14,8,4,2,4,4,0,5,0,0,0,5
S01006757,All households,343,112,21,91,224,27,178,83,64,31,19,11,8,7,4,0,0,3
S01006757,Occupancy rating +2 or more,131,19,6,13,110,21,87,41,28,18,2,1,1,2,1,0,0,1
S01006757,Occupancy rating +1,103,42,9,33,59,4,47,21,16,10,8,5,3,2,0,0,0,2
S01006757,Occupancy rating 0,95,45,4,41,48,1,40,19,18,3,7,4,3,2,2,0,0,0
S01006757,Occupancy rating -1 or less,14,6,2,4,7,1,4,2,2,0,2,1,1,1,1,0,0,0
S01006758,All households,318,101,10,91,211,26,170,85,57,28,15,8,7,6,3,0,0,3
S01006758,Occupancy rating +2 or more,145,17,3,14,126,17,104,53,36,15,5,3,2,2,1,0,0,1
S01006758,Occupancy rating +1,86,23,5,18,61,8,49,21,17,11,4,2,2,2,2,0,0,0
S01006758,Occupancy rating 0,68,48,1,47,18,1,12,7,3,2,5,3,2,2,0,0,0,2
S01006758,Occupancy rating -1 or less,19,13,1,12,6,0,5,4,1,0,1,0,1,0,0,0,0,0
S01006759,All households,251,58,19,39,189,21,148,65,58,25,20,12,8,4,1,0,0,3
S01006759,Occupancy rating +2 or more,137,19,9,10,117,11,95,41,39,15,11,7,4,1,0,0,0,1
S01006759,Occupancy rating +1,74,25,8,17,48,9,38,20,12,6,1,1,0,1,1,0,0,0
S01006759,Occupancy rating 0,33,13,1,12,18,1,10,4,3,3,7,4,3,2,0,0,0,2
S01006759,Occupancy rating -1 or less,7,1,1,0,6,0,5,0,4,1,1,0,1,0,0,0,0,0
S01006760,All households,235,77,11,66,154,16,124,66,45,13,14,13,1,4,1,1,0,2
S01006760,Occupancy rating +2 or more,56,8,2,6,48,7,39,27,8,4,2,2,0,0,0,0,0,0
S01006760,Occupancy rating +1,66,23,6,17,43,6,36,23,11,2,1,1,0,0,0,0,0,0
S01006760,Occupancy rating 0,91,38,2,36,50,3,39,13,20,6,8,7,1,3,0,1,0,2
S01006760,Occupancy rating -1 or less,22,8,1,7,13,0,10,3,6,1,3,3,0,1,1,0,0,0
S01006761,All households,334,98,36,62,230,41,176,99,50,27,13,8,5,6,2,0,0,4
S01006761,Occupancy rating +2 or more,135,25,11,14,110,21,84,50,23,11,5,4,1,0,0,0,0,0
S01006761,Occupancy rating +1,105,38,17,21,65,16,49,29,13,7,0,0,0,2,0,0,0,2
S01006761,Occupancy rating 0,75,25,7,18,48,2,40,19,13,8,6,2,4,2,0,0,0,2
S01006761,Occupancy rating -1 or less,19,10,1,9,7,2,3,1,1,1,2,2,0,2,2,0,0,0
S01006762,All households,416,168,110,58,243,51,181,98,55,28,11,7,4,5,1,0,2,2
S01006762,Occupancy rating +2 or more,171,45,21,24,123,23,99,62,29,8,1,1,0,3,0,0,1,2
S01006762,Occupancy rating +1,101,43,26,17,57,11,44,22,11,11,2,2,0,1,1,0,0,0
S01006762,Occupancy rating 0,124,73,57,16,51,13,32,11,13,8,6,3,3,0,0,0,0,0
S01006762,Occupancy rating -1 or less,20,7,6,1,12,4,6,3,2,1,2,1,1,1,0,0,1,0
S01006763,All households,334,69,7,62,253,5,222,75,122,25,26,18,8,12,6,1,0,5
S01006763,Occupancy rating +2 or more,128,25,3,22,102,2,94,46,39,9,6,5,1,1,0,0,0,1
S01006763,Occupancy rating +1,139,40,4,36,96,3,90,28,49,13,3,3,0,3,2,0,0,1
S01006763,Occupancy rating 0,56,4,0,4,46,0,33,1,30,2,13,8,5,6,3,0,0,3
S01006763,Occupancy rating -1 or less,11,0,0,0,9,0,5,0,4,1,4,2,2,2,1,1,0,0
S01006764,All households,345,101,7,94,236,10,203,85,83,35,23,13,10,8,3,0,1,4
S01006764,Occupancy rating +2 or more,80,19,2,17,61,1,59,32,17,10,1,1,0,0,0,0,0,0
S01006764,Occupancy rating +1,126,36,4,32,89,6,77,42,20,15,6,3,3,1,1,0,0,0
S01006764,Occupancy rating 0,115,40,1,39,70,2,57,10,39,8,11,8,3,5,2,0,1,2
S01006764,Occupancy rating -1 or less,24,6,0,6,16,1,10,1,7,2,5,1,4,2,0,0,0,2
S01006765,All households,273,94,9,85,173,9,147,75,49,23,17,11,6,6,0,0,0,6
S01006765,Occupancy rating +2 or more,73,8,1,7,64,7,54,32,14,8,3,2,1,1,0,0,0,1
S01006765,Occupancy rating +1,69,18,2,16,49,2,42,18,15,9,5,3,2,2,0,0,0,2
S01006765,Occupancy rating 0,95,43,3,40,50,0,43,23,14,6,7,5,2,2,0,0,0,2
S01006765,Occupancy rating -1 or less,36,25,3,22,10,0,8,2,6,0,2,1,1,1,0,0,0,1
S01006766,All households,240,54,10,44,176,12,154,71,56,27,10,5,5,10,6,1,0,3
S01006766,Occupancy rating +2 or more,148,23,6,17,122,11,107,53,33,21,4,2,2,3,2,1,0,0
S01006766,Occupancy rating +1,56,18,3,15,33,0,31,12,15,4,2,0,2,5,4,0,0,1
S01006766,Occupancy rating 0,29,13,1,12,15,1,13,6,5,2,1,1,0,1,0,0,0,1
S01006766,Occupancy rating -1 or less,7,0,0,0,6,0,3,0,3,0,3,2,1,1,0,0,0,1
S01006767,All households,283,69,37,32,207,25,157,63,64,30,25,13,12,7,4,0,0,3
S01006767,Occupancy rating +2 or more,106,19,7,12,86,6,73,36,26,11,7,5,2,1,1,0,0,0
S01006767,Occupancy rating +1,88,21,11,10,65,7,50,24,19,7,8,4,4,2,1,0,0,1
S01006767,Occupancy rating 0,73,28,18,10,45,11,25,2,14,9,9,4,5,0,0,0,0,0
S01006767,Occupancy rating -1 or less,16,1,1,0,11,1,9,1,5,3,1,0,1,4,2,0,0,2
S01006768,All households,212,16,6,10,192,14,169,61,79,29,9,3,6,4,1,0,0,3
S01006768,Occupancy rating +2 or more,181,15,5,10,162,14,144,59,62,23,4,0,4,4,1,0,0,3
S01006768,Occupancy rating +1,20,1,1,0,19,0,16,2,10,4,3,2,1,0,0,0,0,0
S01006768,Occupancy rating 0,8,0,0,0,8,0,7,0,5,2,1,1,0,0,0,0,0,0
S01006768,Occupancy rating -1 or less,3,0,0,0,3,0,2,0,2,0,1,0,1,0,0,0,0,0
S01006769,All households,392,93,40,53,289,31,222,86,95,41,36,19,17,10,8,0,0,2
S01006769,Occupancy rating +2 or more,174,29,11,18,142,12,119,56,43,20,11,6,5,3,2,0,0,1
S01006769,Occupancy rating +1,119,29,13,16,86,13,63,21,31,11,10,6,4,4,3,0,0,1
S01006769,Occupancy rating 0,82,34,15,19,46,6,28,7,14,7,12,7,5,2,2,0,0,0
S01006769,Occupancy rating -1 or less,17,1,1,0,15,0,12,2,7,3,3,0,3,1,1,0,0,0
S01006770,All households,273,39,18,21,230,25,188,105,54,29,17,7,10,4,1,0,0,3
S01006770,Occupancy rating +2 or more,166,24,9,15,142,16,122,87,19,16,4,1,3,0,0,0,0,0
S01006770,Occupancy rating +1,76,12,6,6,63,9,47,16,20,11,7,3,4,1,0,0,0,1
S01006770,Occupancy rating 0,21,2,2,0,17,0,13,1,10,2,4,2,2,2,1,0,0,1
S01006770,Occupancy rating -1 or less,10,1,1,0,8,0,6,1,5,0,2,1,1,1,0,0,0,1
S01006771,All households,150,11,4,7,130,8,112,32,59,21,10,4,6,9,3,2,0,4
S01006771,Occupancy rating +2 or more,98,11,4,7,84,5,72,30,32,10,7,3,4,3,2,0,0,1
S01006771,Occupancy rating +1,35,0,0,0,34,3,29,2,17,10,2,1,1,1,0,1,0,0
S01006771,Occupancy rating 0,10,0,0,0,7,0,6,0,6,0,1,0,1,3,0,1,0,2
S01006771,Occupancy rating -1 or less,7,0,0,0,5,0,5,0,4,1,0,0,0,2,1,0,0,1
S01006772,All households,375,107,28,79,257,26,214,111,64,39,17,10,7,11,4,0,0,7
S01006772,Occupancy rating +2 or more,180,43,12,31,135,16,112,66,29,17,7,3,4,2,1,0,0,1
S01006772,Occupancy rating +1,104,33,13,20,70,8,60,30,14,16,2,0,2,1,0,0,0,1
S01006772,Occupancy rating 0,76,30,3,27,40,2,33,13,16,4,5,4,1,6,2,0,0,4
S01006772,Occupancy rating -1 or less,15,1,0,1,12,0,9,2,5,2,3,3,0,2,1,0,0,1
S01006773,All households,255,42,14,28,208,19,168,67,77,24,21,11,10,5,2,0,0,3
S01006773,Occupancy rating +2 or more,139,24,6,18,114,8,100,59,32,9,6,4,2,1,1,0,0,0
S01006773,Occupancy rating +1,79,13,6,7,64,8,47,8,26,13,9,4,5,2,0,0,0,2
S01006773,Occupancy rating 0,30,4,2,2,24,2,18,0,17,1,4,1,3,2,1,0,0,1
S01006773,Occupancy rating -1 or less,7,1,0,1,6,1,3,0,2,1,2,2,0,0,0,0,0,0
S01006774,All households,221,14,2,12,193,12,168,59,64,45,13,6,7,14,8,0,1,5
S01006774,Occupancy rating +2 or more,133,11,1,10,118,11,104,54,30,20,3,1,2,4,4,0,0,0
S01006774,Occupancy rating +1,60,3,1,2,54,1,47,5,24,18,6,2,4,3,0,0,0,3
S01006774,Occupancy rating 0,23,0,0,0,18,0,15,0,8,7,3,2,1,5,3,0,1,1
S01006774,Occupancy rating -1 or less,5,0,0,0,3,0,2,0,2,0,1,1,0,2,1,0,0,1
S01006775,All households,319,141,47,94,168,19,119,67,34,18,30,21,9,10,4,0,0,6
S01006775,Occupancy rating +2 or more,88,37,12,25,51,5,44,29,11,4,2,1,1,0,0,0,0,0
S01006775,Occupancy rating +1,95,46,13,33,48,5,39,24,8,7,4,3,1,1,0,0,0,1
S01006775,Occupancy rating 0,111,54,19,35,54,8,27,12,10,5,19,12,7,3,1,0,0,2
S01006775,Occupancy rating -1 or less,25,4,3,1,15,1,9,2,5,2,5,5,0,6,3,0,0,3
S01006776,All households,271,121,76,45,134,28,84,48,23,13,22,10,12,16,5,1,2,8
S01006776,Occupancy rating +2 or more,47,15,9,6,30,7,21,18,1,2,2,2,0,2,0,0,0,2
S01006776,Occupancy rating +1,80,37,13,24,42,6,31,24,5,2,5,2,3,1,0,0,0,1
S01006776,Occupancy rating 0,116,59,45,14,51,13,26,6,13,7,12,5,7,6,1,1,1,3
S01006776,Occupancy rating -1 or less,28,10,9,1,11,2,6,0,4,2,3,1,2,7,4,0,1,2
S01006777,All households,262,39,18,21,216,27,176,85,59,32,13,6,7,7,5,0,0,2
S01006777,Occupancy rating +2 or more,180,31,15,16,146,24,113,78,20,15,9,4,5,3,2,0,0,1
S01006777,Occupancy rating +1,54,5,1,4,46,3,40,6,22,12,3,2,1,3,2,0,0,1
S01006777,Occupancy rating 0,22,1,0,1,20,0,19,1,14,4,1,0,1,1,1,0,0,0
S01006777,Occupancy rating -1 or less,6,2,2,0,4,0,4,0,3,1,0,0,0,0,0,0,0,0
S01006778,All households,287,71,26,45,206,32,152,78,47,27,22,8,14,10,3,0,1,6
S01006778,Occupancy rating +2 or more,128,22,8,14,105,18,82,54,21,7,5,2,3,1,0,0,0,1
S01006778,Occupancy rating +1,87,30,6,24,56,5,43,21,12,10,8,1,7,1,0,0,1,0
S01006778,Occupancy rating 0,56,18,11,7,35,9,19,2,12,5,7,4,3,3,1,0,0,2
S01006778,Occupancy rating -1 or less,16,1,1,0,10,0,8,1,2,5,2,1,1,5,2,0,0,3
S01006779,All households,293,115,65,50,165,24,94,31,39,24,47,24,23,13,5,0,1,7
S01006779,Occupancy rating +2 or more,54,20,9,11,33,9,21,12,6,3,3,2,1,1,0,0,0,1
S01006779,Occupancy rating +1,92,30,13,17,60,7,38,17,12,9,15,5,10,2,1,0,0,1
S01006779,Occupancy rating 0,108,49,28,21,54,8,23,2,12,9,23,14,9,5,2,0,0,3
S01006779,Occupancy rating -1 or less,39,16,15,1,18,0,12,0,9,3,6,3,3,5,2,0,1,2
S01006780,All households,254,71,34,37,175,26,119,56,43,20,30,10,20,8,5,0,0,3
S01006780,Occupancy rating +2 or more,105,27,9,18,78,15,61,38,15,8,2,1,1,0,0,0,0,0
S01006780,Occupancy rating +1,84,31,16,15,51,8,30,16,9,5,13,3,10,2,1,0,0,1
S01006780,Occupancy rating 0,50,11,8,3,37,2,23,2,15,6,12,3,9,2,1,0,0,1
S01006780,Occupancy rating -1 or less,15,2,1,1,9,1,5,0,4,1,3,3,0,4,3,0,0,1
S01006781,All households,295,68,50,18,218,47,146,64,51,31,25,14,11,9,5,0,0,4
S01006781,Occupancy rating +2 or more,162,42,30,12,119,34,76,49,18,9,9,3,6,1,1,0,0,0
S01006781,Occupancy rating +1,79,22,16,6,55,10,40,14,17,9,5,3,2,2,0,0,0,2
S01006781,Occupancy rating 0,43,4,4,0,36,3,24,1,12,11,9,6,3,3,2,0,0,1
S01006781,Occupancy rating -1 or less,11,0,0,0,8,0,6,0,4,2,2,2,0,3,2,0,0,1
S01006782,All households,341,128,30,98,204,20,169,74,71,24,15,10,5,9,4,1,0,4
S01006782,Occupancy rating +2 or more,154,31,7,24,121,14,105,45,48,12,2,2,0,2,0,0,0,2
S01006782,Occupancy rating +1,66,24,12,12,39,3,33,20,7,6,3,2,1,3,2,0,0,1
S01006782,Occupancy rating 0,75,47,10,37,27,2,21,6,9,6,4,1,3,1,1,0,0,0
S01006782,Occupancy rating -1 or less,46,26,1,25,17,1,10,3,7,0,6,5,1,3,1,1,0,1
S01006783,All households,299,68,45,23,220,61,127,59,44,24,32,13,19,11,6,0,1,4
S01006783,Occupancy rating +2 or more,142,25,21,4,116,41,70,40,20,10,5,0,5,1,0,0,0,1
S01006783,Occupancy rating +1,92,36,20,16,54,17,30,17,6,7,7,2,5,2,1,0,0,1
S01006783,Occupancy rating 0,45,5,4,1,36,1,19,1,12,6,16,9,7,4,2,0,1,1
S01006783,Occupancy rating -1 or less,20,2,0,2,14,2,8,1,6,1,4,2,2,4,3,0,0,1
S01006784,All households,302,110,37,73,173,24,141,76,46,19,8,1,7,19,1,4,1,13
S01006784,Occupancy rating +2 or more,126,34,17,17,90,14,72,44,19,9,4,1,3,2,0,0,0,2
S01006784,Occupancy rating +1,92,36,11,25,54,10,42,23,11,8,2,0,2,2,1,0,0,1
S01006784,Occupancy rating 0,77,37,6,31,27,0,27,9,16,2,0,0,0,13,0,4,1,8
S01006784,Occupancy rating -1 or less,7,3,3,0,2,0,0,0,0,0,2,0,2,2,0,0,0,2
S01006785,All households,223,30,10,20,186,16,161,59,72,30,9,9,0,7,4,0,0,3
S01006785,Occupancy rating +2 or more,125,10,4,6,113,11,101,46,36,19,1,1,0,2,1,0,0,1
S01006785,Occupancy rating +1,67,17,4,13,50,5,40,11,21,8,5,5,0,0,0,0,0,0
S01006785,Occupancy rating 0,22,1,0,1,17,0,14,1,11,2,3,3,0,4,2,0,0,2
S01006785,Occupancy rating -1 or less,9,2,2,0,6,0,6,1,4,1,0,0,0,1,1,0,0,0
S01006786,All households,339,84,22,62,243,18,213,85,99,29,12,7,5,12,4,1,0,7
S01006786,Occupancy rating +2 or more,188,29,7,22,155,12,138,66,54,18,5,3,2,4,1,0,0,3
S01006786,Occupancy rating +1,68,17,9,8,50,4,44,10,25,9,2,1,1,1,1,0,0,0
S01006786,Occupancy rating 0,52,24,5,19,24,2,19,3,15,1,3,1,2,4,1,0,0,3
S01006786,Occupancy rating -1 or less,31,14,1,13,14,0,12,6,5,1,2,2,0,3,1,1,0,1
S01006787,All households,281,65,28,37,209,41,149,65,48,36,19,11,8,7,3,0,1,3
S01006787,Occupancy rating +2 or more,137,31,16,15,103,25,72,40,18,14,6,4,2,3,1,0,1,1
S01006787,Occupancy rating +1,83,16,1,15,65,7,52,25,16,11,6,3,3,2,1,0,0,1
S01006787,Occupancy rating 0,50,14,8,6,35,7,22,0,11,11,6,3,3,1,0,0,0,1
S01006787,Occupancy rating -1 or less,11,4,3,1,6,2,3,0,3,0,1,1,0,1,1,0,0,0
S01006788,All households,302,79,9,70,208,11,182,77,90,15,15,11,4,15,6,0,0,9
S01006788,Occupancy rating +2 or more,166,30,4,26,131,8,116,50,55,11,7,6,1,5,2,0,0,3
S01006788,Occupancy rating +1,103,42,5,37,56,3,49,24,21,4,4,2,2,5,1,0,0,4
S01006788,Occupancy rating 0,22,5,0,5,14,0,11,2,9,0,3,2,1,3,1,0,0,2
S01006788,Occupancy rating -1 or less,11,2,0,2,7,0,6,1,5,0,1,1,0,2,2,0,0,0
S01006789,All households,290,102,54,48,181,44,114,57,36,21,23,14,9,7,2,0,0,5
S01006789,Occupancy rating +2 or more,174,44,31,13,126,39,78,43,18,17,9,4,5,4,1,0,0,3
S01006789,Occupancy rating +1,57,27,12,15,30,3,22,11,9,2,5,2,3,0,0,0,0,0
S01006789,Occupancy rating 0,42,23,11,12,17,1,7,2,4,1,9,8,1,2,0,0,0,2
S01006789,Occupancy rating -1 or less,17,8,0,8,8,1,7,1,5,1,0,0,0,1,1,0,0,0
S01006790,All households,444,177,109,68,253,70,151,72,56,23,32,25,7,14,6,0,1,7
S01006790,Occupancy rating +2 or more,220,66,40,26,149,55,91,57,22,12,3,1,2,5,1,0,1,3
S01006790,Occupancy rating +1,81,37,19,18,40,8,25,11,6,8,7,4,3,4,1,0,0,3
S01006790,Occupancy rating 0,110,66,46,20,43,5,24,2,20,2,14,13,1,1,1,0,0,0
S01006790,Occupancy rating -1 or less,33,8,4,4,21,2,11,2,8,1,8,7,1,4,3,0,0,1
S01006791,All households,253,90,38,52,154,24,114,64,39,11,16,9,7,9,2,0,1,6
S01006791,Occupancy rating +2 or more,169,58,21,37,105,20,74,53,15,6,11,5,6,6,2,0,0,4
S01006791,Occupancy rating +1,43,15,6,9,27,3,21,5,12,4,3,2,1,1,0,0,0,1
S01006791,Occupancy rating 0,35,16,11,5,17,1,14,5,8,1,2,2,0,2,0,0,1,1
S01006791,Occupancy rating -1 or less,6,1,0,1,5,0,5,1,4,0,0,0,0,0,0,0,0,0
S01006792,All households,214,57,30,27,148,30,112,64,37,11,6,3,3,9,4,0,0,5
S01006792,Occupancy rating +2 or more,151,38,19,19,110,27,80,51,22,7,3,1,2,3,1,0,0,2
S01006792,Occupancy rating +1,42,15,9,6,25,3,21,9,10,2,1,1,0,2,0,0,0,2
S01006792,Occupancy rating 0,13,3,1,2,10,0,10,4,4,2,0,0,0,0,0,0,0,0
S01006792,Occupancy rating -1 or less,8,1,1,0,3,0,1,0,1,0,2,1,1,4,3,0,0,1
S01006793,All households,245,83,44,39,152,34,106,58,35,13,12,7,5,10,1,0,1,8
S01006793,Occupancy rating +2 or more,146,39,21,18,100,28,68,44,15,9,4,3,1,7,1,0,0,6
S01006793,Occupancy rating +1,48,20,10,10,27,1,22,10,9,3,4,2,2,1,0,0,0,1
S01006793,Occupancy rating 0,45,22,13,9,21,5,12,3,8,1,4,2,2,2,0,0,1,1
S01006793,Occupancy rating -1 or less,6,2,0,2,4,0,4,1,3,0,0,0,0,0,0,0,0,0
S01006794,All households,280,101,51,50,170,32,110,65,29,16,28,14,14,9,2,0,0,7
S01006794,Occupancy rating +2 or more,153,43,27,16,107,21,78,51,21,6,8,4,4,3,0,0,0,3
S01006794,Occupancy rating +1,60,26,12,14,32,7,18,12,1,5,7,4,3,2,0,0,0,2
S01006794,Occupancy rating 0,56,28,11,17,26,4,10,2,4,4,12,6,6,2,1,0,0,1
S01006794,Occupancy rating -1 or less,11,4,1,3,5,0,4,0,3,1,1,0,1,2,1,0,0,1
S01006795,All households,319,93,52,41,223,40,164,70,78,16,19,14,5,3,2,0,0,1
S01006795,Occupancy rating +2 or more,219,48,31,17,169,34,126,59,55,12,9,6,3,2,1,0,0,1
S01006795,Occupancy rating +1,51,26,14,12,24,4,16,5,10,1,4,4,0,1,1,0,0,0
S01006795,Occupancy rating 0,41,17,5,12,24,2,19,6,10,3,3,2,1,0,0,0,0,0
S01006795,Occupancy rating -1 or less,8,2,2,0,6,0,3,0,3,0,3,2,1,0,0,0,0,0
S01006796,All households,222,37,19,18,179,26,135,60,71,4,18,17,1,6,0,0,0,6
S01006796,Occupancy rating +2 or more,155,28,16,12,124,24,93,46,43,4,7,7,0,3,0,0,0,3
S01006796,Occupancy rating +1,37,5,1,4,30,1,25,12,13,0,4,4,0,2,0,0,0,2
S01006796,Occupancy rating 0,29,4,2,2,24,1,16,2,14,0,7,6,1,1,0,0,0,1
S01006796,Occupancy rating -1 or less,1,0,0,0,1,0,1,0,1,0,0,0,0,0,0,0,0,0
S01006797,All households,243,49,18,31,185,18,157,80,63,14,10,7,3,9,3,0,0,6
S01006797,Occupancy rating +2 or more,165,33,15,18,126,13,109,67,34,8,4,2,2,6,1,0,0,5
S01006797,Occupancy rating +1,46,11,2,9,34,4,27,10,15,2,3,2,1,1,1,0,0,0
S01006797,Occupancy rating 0,22,5,1,4,16,1,12,3,7,2,3,3,0,1,1,0,0,0
S01006797,Occupancy rating -1 or less,10,0,0,0,9,0,9,0,7,2,0,0,0,1,0,0,0,1
S01006798,All households,225,34,20,14,185,25,154,65,69,20,6,3,3,6,2,0,0,4
S01006798,Occupancy rating +2 or more,153,19,13,6,132,21,109,55,43,11,2,1,1,2,0,0,0,2
S01006798,Occupancy rating +1,44,7,3,4,36,4,28,10,12,6,4,2,2,1,0,0,0,1
S01006798,Occupancy rating 0,21,7,4,3,13,0,13,0,10,3,0,0,0,1,1,0,0,0
S01006798,Occupancy rating -1 or less,7,1,0,1,4,0,4,0,4,0,0,0,0,2,1,0,0,1
S01006799,All households,403,147,80,67,245,40,177,66,85,26,28,17,11,11,3,0,2,6
S01006799,Occupancy rating +2 or more,186,45,23,22,135,26,101,45,44,12,8,4,4,6,1,0,0,5
S01006799,Occupancy rating +1,83,30,19,11,51,8,37,15,17,5,6,2,4,2,0,0,1,1
S01006799,Occupancy rating 0,112,61,33,28,50,4,34,5,21,8,12,9,3,1,1,0,0,0
S01006799,Occupancy rating -1 or less,22,11,5,6,9,2,5,1,3,1,2,2,0,2,1,0,1,0
S01006800,All households,320,56,21,35,255,44,196,75,95,26,15,8,7,9,3,0,0,6
S01006800,Occupancy rating +2 or more,263,42,15,27,214,39,166,68,80,18,9,4,5,7,2,0,0,5
S01006800,Occupancy rating +1,32,10,5,5,21,2,16,4,8,4,3,3,0,1,0,0,0,1
S01006800,Occupancy rating 0,19,4,1,3,15,2,11,3,4,4,2,1,1,0,0,0,0,0
S01006800,Occupancy rating -1 or less,6,0,0,0,5,1,3,0,3,0,1,0,1,1,1,0,0,0
S01006801,All households,353,55,22,33,291,52,221,105,86,30,18,12,6,7,1,0,0,6
S01006801,Occupancy rating +2 or more,270,47,21,26,218,44,165,92,53,20,9,5,4,5,1,0,0,4
S01006801,Occupancy rating +1,58,8,1,7,50,5,40,11,23,6,5,3,2,0,0,0,0,0
S01006801,Occupancy rating 0,20,0,0,0,18,2,13,2,8,3,3,3,0,2,0,0,0,2
S01006801,Occupancy rating -1 or less,5,0,0,0,5,1,3,0,2,1,1,1,0,0,0,0,0,0
S01006802,All households,298,93,57,36,196,23,149,69,64,16,24,11,13,9,4,0,0,5
S01006802,Occupancy rating +2 or more,165,34,16,18,127,16,102,60,34,8,9,2,7,4,2,0,0,2
S01006802,Occupancy rating +1,58,24,12,12,33,3,23,5,14,4,7,3,4,1,1,0,0,0
S01006802,Occupancy rating 0,65,33,27,6,28,4,18,4,11,3,6,4,2,4,1,0,0,3
S01006802,Occupancy rating -1 or less,10,2,2,0,8,0,6,0,5,1,2,2,0,0,0,0,0,0
S01006803,All households,313,105,78,27,201,34,139,63,53,23,28,16,12,7,3,0,0,4
S01006803,Occupancy rating +2 or more,125,26,15,11,98,14,74,40,24,10,10,5,5,1,0,0,0,1
S01006803,Occupancy rating +1,73,23,17,6,49,10,37,16,14,7,2,1,1,1,0,0,0,1
S01006803,Occupancy rating 0,99,51,42,9,46,9,22,7,10,5,15,9,6,2,0,0,0,2
S01006803,Occupancy rating -1 or less,16,5,4,1,8,1,6,0,5,1,1,1,0,3,3,0,0,0
S01006804,All households,295,53,28,25,235,23,192,74,93,25,20,11,9,7,2,0,0,5
S01006804,Occupancy rating +2 or more,176,27,11,16,149,17,129,64,52,13,3,1,2,0,0,0,0,0
S01006804,Occupancy rating +1,72,16,10,6,52,5,41,7,26,8,6,3,3,4,1,0,0,3
S01006804,Occupancy rating 0,32,7,5,2,23,0,16,3,10,3,7,5,2,2,0,0,0,2
S01006804,Occupancy rating -1 or less,15,3,2,1,11,1,6,0,5,1,4,2,2,1,1,0,0,0
S01006805,All households,442,116,56,60,303,30,235,95,111,29,38,30,8,23,8,0,2,13
S01006805,Occupancy rating +2 or more,260,55,33,22,199,25,166,74,69,23,8,4,4,6,4,0,0,2
S01006805,Occupancy rating +1,75,22,9,13,52,2,39,15,21,3,11,9,2,1,1,0,0,0
S01006805,Occupancy rating 0,66,25,13,12,36,2,21,6,12,3,13,11,2,5,1,0,2,2
S01006805,Occupancy rating -1 or less,41,14,1,13,16,1,9,0,9,0,6,6,0,11,2,0,0,9
S01006806,All households,429,104,47,57,311,38,249,113,96,40,24,16,8,14,4,0,1,9
S01006806,Occupancy rating +2 or more,273,56,23,33,206,34,168,91,52,25,4,2,2,11,3,0,1,7
S01006806,Occupancy rating +1,83,26,13,13,56,1,49,17,23,9,6,3,3,1,1,0,0,0
S01006806,Occupancy rating 0,64,19,11,8,43,3,28,5,18,5,12,10,2,2,0,0,0,2
S01006806,Occupancy rating -1 or less,9,3,0,3,6,0,4,0,3,1,2,1,1,0,0,0,0,0
S01006807,All households,243,40,8,32,196,20,158,78,62,18,18,15,3,7,2,0,0,5
S01006807,Occupancy rating +2 or more,171,33,7,26,135,18,112,68,32,12,5,4,1,3,1,0,0,2
S01006807,Occupancy rating +1,49,7,1,6,39,2,32,8,18,6,5,4,1,3,0,0,0,3
S01006807,Occupancy rating 0,17,0,0,0,16,0,11,1,10,0,5,4,1,1,1,0,0,0
S01006807,Occupancy rating -1 or less,6,0,0,0,6,0,3,1,2,0,3,3,0,0,0,0,0,0
S01006808,All households,248,44,23,21,192,21,158,75,63,20,13,9,4,12,4,0,2,6
S01006808,Occupancy rating +2 or more,195,28,14,14,161,20,131,65,49,17,10,6,4,6,2,0,2,2
S01006808,Occupancy rating +1,36,12,6,6,21,1,20,9,10,1,0,0,0,3,1,0,0,2
S01006808,Occupancy rating 0,9,0,0,0,8,0,6,1,3,2,2,2,0,1,0,0,0,1
S01006808,Occupancy rating -1 or less,8,4,3,1,2,0,1,0,1,0,1,1,0,2,1,0,0,1
S01006809,All households,354,108,55,53,235,31,171,76,69,26,33,20,13,11,5,0,1,5
S01006809,Occupancy rating +2 or more,166,46,28,18,114,14,90,53,25,12,10,6,4,6,3,0,0,3
S01006809,Occupancy rating +1,84,26,9,17,56,11,41,17,16,8,4,3,1,2,1,0,1,0
S01006809,Occupancy rating 0,89,32,17,15,55,4,32,6,21,5,19,11,8,2,0,0,0,2
S01006809,Occupancy rating -1 or less,15,4,1,3,10,2,8,0,7,1,0,0,0,1,1,0,0,0
S01006810,All households,370,109,39,70,249,33,192,84,83,25,24,15,9,12,4,0,1,7
S01006810,Occupancy rating +2 or more,198,42,14,28,148,20,120,62,46,12,8,5,3,8,3,0,0,5
S01006810,Occupancy rating +1,84,31,14,17,52,8,39,14,17,8,5,2,3,1,0,0,1,0
S01006810,Occupancy rating 0,70,30,8,22,39,5,27,7,16,4,7,5,2,1,0,0,0,1
S01006810,Occupancy rating -1 or less,18,6,3,3,10,0,6,1,4,1,4,3,1,2,1,0,0,1
S01006811,All households,430,87,33,54,331,34,274,107,134,33,23,18,5,12,4,0,2,6
S01006811,Occupancy rating +2 or more,285,53,18,35,226,26,194,87,83,24,6,5,1,6,2,0,2,2
S01006811,Occupancy rating +1,74,18,9,9,56,8,43,12,26,5,5,2,3,0,0,0,0,0
S01006811,Occupancy rating 0,59,13,5,8,40,0,32,6,23,3,8,8,0,6,2,0,0,4
S01006811,Occupancy rating -1 or less,12,3,1,2,9,0,5,2,2,1,4,3,1,0,0,0,0,0
S01006812,All households,304,61,19,42,232,19,189,91,82,16,24,16,8,11,4,0,0,7
S01006812,Occupancy rating +2 or more,189,28,7,21,157,16,135,69,55,11,6,4,2,4,1,0,0,3
S01006812,Occupancy rating +1,69,22,6,16,44,1,38,21,15,2,5,3,2,3,2,0,0,1
S01006812,Occupancy rating 0,37,10,6,4,24,2,13,1,9,3,9,5,4,3,0,0,0,3
S01006812,Occupancy rating -1 or less,9,1,0,1,7,0,3,0,3,0,4,4,0,1,1,0,0,0
S01006813,All households,322,87,42,45,222,19,178,69,84,25,25,14,11,13,7,0,2,4
S01006813,Occupancy rating +2 or more,155,35,14,21,118,13,100,48,39,13,5,3,2,2,1,0,1,0
S01006813,Occupancy rating +1,85,28,17,11,52,4,42,17,21,4,6,3,3,5,3,0,1,1
S01006813,Occupancy rating 0,68,23,10,13,41,2,29,4,19,6,10,5,5,4,3,0,0,1
S01006813,Occupancy rating -1 or less,14,1,1,0,11,0,7,0,5,2,4,3,1,2,0,0,0,2
S01006814,All households,282,39,19,20,229,27,186,82,87,17,16,11,5,14,8,0,1,5
S01006814,Occupancy rating +2 or more,235,27,12,15,199,25,162,77,70,15,12,7,5,9,5,0,1,3
S01006814,Occupancy rating +1,32,8,4,4,21,2,16,5,10,1,3,3,0,3,2,0,0,1
S01006814,Occupancy rating 0,11,2,2,0,7,0,6,0,5,1,1,1,0,2,1,0,0,1
S01006814,Occupancy rating -1 or less,4,2,1,1,2,0,2,0,2,0,0,0,0,0,0,0,0,0
S01006815,All households,285,111,62,49,165,17,112,58,36,18,36,21,15,9,3,0,3,3
S01006815,Occupancy rating +2 or more,85,16,10,6,68,6,61,40,13,8,1,0,1,1,0,0,1,0
S01006815,Occupancy rating +1,81,38,20,18,41,6,27,13,9,5,8,2,6,2,0,0,2,0
S01006815,Occupancy rating 0,100,54,29,25,44,5,21,5,12,4,18,14,4,2,0,0,0,2
S01006815,Occupancy rating -1 or less,19,3,3,0,12,0,3,0,2,1,9,5,4,4,3,0,0,1
S01006816,All households,298,87,36,51,204,22,167,67,80,20,15,9,6,7,4,0,1,2
S01006816,Occupancy rating +2 or more,170,26,12,14,141,19,116,51,52,13,6,2,4,3,3,0,0,0
S01006816,Occupancy rating +1,55,25,5,20,28,0,24,10,10,4,4,3,1,2,0,0,1,1
S01006816,Occupancy rating 0,67,35,19,16,31,3,23,5,15,3,5,4,1,1,1,0,0,0
S01006816,Occupancy rating -1 or less,6,1,0,1,4,0,4,1,3,0,0,0,0,1,0,0,0,1
S01006817,All households,261,62,21,41,181,12,147,60,61,26,22,14,8,18,9,0,3,6
S01006817,Occupancy rating +2 or more,139,32,11,21,100,6,87,46,30,11,7,3,4,7,5,0,2,0
S01006817,Occupancy rating +1,63,21,6,15,37,3,33,12,15,6,1,0,1,5,0,0,1,4
S01006817,Occupancy rating 0,49,8,4,4,37,3,22,1,12,9,12,10,2,4,3,0,0,1
S01006817,Occupancy rating -1 or less,10,1,0,1,7,0,5,1,4,0,2,1,1,2,1,0,0,1
S01006818,All households,278,51,19,32,213,26,172,73,74,25,15,3,12,14,6,0,1,7
S01006818,Occupancy rating +2 or more,203,31,11,20,163,21,134,66,54,14,8,0,8,9,3,0,1,5
S01006818,Occupancy rating +1,44,9,4,5,33,3,27,7,14,6,3,1,2,2,0,0,0,2
S01006818,Occupancy rating 0,19,8,4,4,11,1,7,0,4,3,3,1,2,0,0,0,0,0
S01006818,Occupancy rating -1 or less,12,3,0,3,6,1,4,0,2,2,1,1,0,3,3,0,0,0
S01006819,All households,313,58,15,43,243,16,207,78,103,26,20,10,10,12,6,0,1,5
S01006819,Occupancy rating +2 or more,224,39,12,27,183,14,157,61,78,18,12,7,5,2,1,0,0,1
S01006819,Occupancy rating +1,51,11,0,11,38,2,33,12,15,6,3,1,2,2,2,0,0,0
S01006819,Occupancy rating 0,26,3,1,2,17,0,14,4,9,1,3,1,2,6,2,0,1,3
S01006819,Occupancy rating -1 or less,12,5,2,3,5,0,3,1,1,1,2,1,1,2,1,0,0,1
S01006820,All households,180,35,11,24,139,25,112,51,43,18,2,1,1,6,3,0,0,3
S01006820,Occupancy rating +2 or more,129,22,6,16,105,22,82,45,28,9,1,0,1,2,0,0,0,2
S01006820,Occupancy rating +1,38,12,5,7,25,2,23,5,11,7,0,0,0,1,0,0,0,1
S01006820,Occupancy rating 0,10,1,0,1,7,1,5,1,3,1,1,1,0,2,2,0,0,0
S01006820,Occupancy rating -1 or less,3,0,0,0,2,0,2,0,1,1,0,0,0,1,1,0,0,0
S01006821,All households,229,46,16,30,172,26,132,55,59,18,14,8,6,11,3,0,1,7
S01006821,Occupancy rating +2 or more,186,36,11,25,142,24,110,49,48,13,8,4,4,8,2,0,1,5
S01006821,Occupancy rating +1,30,9,4,5,18,1,15,5,6,4,2,1,1,3,1,0,0,2
S01006821,Occupancy rating 0,7,1,1,0,6,1,5,1,3,1,0,0,0,0,0,0,0,0
S01006821,Occupancy rating -1 or less,6,0,0,0,6,0,2,0,2,0,4,3,1,0,0,0,0,0
S01006822,All households,279,46,15,31,225,20,186,80,82,24,19,8,11,8,4,0,0,4
S01006822,Occupancy rating +2 or more,225,32,12,20,187,19,154,73,66,15,14,7,7,6,3,0,0,3
S01006822,Occupancy rating +1,35,12,3,9,22,0,20,5,9,6,2,0,2,1,1,0,0,0
S01006822,Occupancy rating 0,13,1,0,1,12,1,9,2,4,3,2,0,2,0,0,0,0,0
S01006822,Occupancy rating -1 or less,6,1,0,1,4,0,3,0,3,0,1,1,0,1,0,0,0,1
S01006823,All households,302,101,37,64,196,24,157,72,64,21,15,10,5,5,0,0,0,5
S01006823,Occupancy rating +2 or more,178,42,23,19,135,18,111,54,43,14,6,4,2,1,0,0,0,1
S01006823,Occupancy rating +1,83,51,13,38,31,4,25,12,8,5,2,1,1,1,0,0,0,1
S01006823,Occupancy rating 0,22,4,0,4,16,2,11,2,8,1,3,2,1,2,0,0,0,2
S01006823,Occupancy rating -1 or less,19,4,1,3,14,0,10,4,5,1,4,3,1,1,0,0,0,1
S01006824,All households,367,130,41,89,228,19,141,45,67,29,68,44,24,9,3,0,0,6
S01006824,Occupancy rating +2 or more,110,42,17,25,67,11,49,26,19,4,7,5,2,1,0,0,0,1
S01006824,Occupancy rating +1,115,44,13,31,68,8,42,11,15,16,18,9,9,3,2,0,0,1
S01006824,Occupancy rating 0,129,39,9,30,85,0,44,8,28,8,41,28,13,5,1,0,0,4
S01006824,Occupancy rating -1 or less,13,5,2,3,8,0,6,0,5,1,2,2,0,0,0,0,0,0
S01006825,All households,333,74,34,40,247,37,176,70,74,32,34,17,17,12,5,0,0,7
S01006825,Occupancy rating +2 or more,174,43,20,23,129,24,99,53,32,14,6,3,3,2,1,0,0,1
S01006825,Occupancy rating +1,93,23,8,15,66,10,43,16,20,7,13,4,9,4,1,0,0,3
S01006825,Occupancy rating 0,53,7,5,2,43,3,28,1,16,11,12,9,3,3,2,0,0,1
S01006825,Occupancy rating -1 or less,13,1,1,0,9,0,6,0,6,0,3,1,2,3,1,0,0,2
S01006826,All households,344,74,35,39,262,33,214,71,102,41,15,8,7,8,2,1,1,4
S01006826,Occupancy rating +2 or more,237,34,12,22,197,21,167,63,78,26,9,4,5,6,1,1,1,3
S01006826,Occupancy rating +1,49,18,9,9,29,3,24,7,9,8,2,1,1,2,1,0,0,1
S01006826,Occupancy rating 0,50,19,12,7,31,9,19,1,12,6,3,3,0,0,0,0,0,0
S01006826,Occupancy rating -1 or less,8,3,2,1,5,0,4,0,3,1,1,0,1,0,0,0,0,0
S01006827,All households,419,141,75,66,268,34,179,81,70,28,55,34,21,10,5,0,0,5
S01006827,Occupancy rating +2 or more,143,41,22,19,100,13,77,36,32,9,10,6,4,2,0,0,0,2
S01006827,Occupancy rating +1,115,52,27,25,61,8,46,26,11,9,7,2,5,2,1,0,0,1
S01006827,Occupancy rating 0,119,32,19,13,85,11,44,12,23,9,30,21,9,2,0,0,0,2
S01006827,Occupancy rating -1 or less,42,16,7,9,22,2,12,7,4,1,8,5,3,4,4,0,0,0
S01006828,All households,485,214,81,133,245,42,176,93,70,13,27,17,10,26,2,0,2,22
S01006828,Occupancy rating +2 or more,164,50,23,27,110,26,79,45,29,5,5,3,2,4,1,0,1,2
S01006828,Occupancy rating +1,122,62,23,39,56,11,41,30,11,0,4,4,0,4,1,0,0,3
S01006828,Occupancy rating 0,160,88,30,58,58,5,41,15,19,7,12,6,6,14,0,0,1,13
S01006828,Occupancy rating -1 or less,39,14,5,9,21,0,15,3,11,1,6,4,2,4,0,0,0,4
S01006829,All households,139,15,4,11,118,4,109,29,74,6,5,4,1,6,3,0,0,3
S01006829,Occupancy rating +2 or more,113,11,2,9,99,3,93,27,61,5,3,3,0,3,2,0,0,1
S01006829,Occupancy rating +1,18,3,1,2,14,0,12,2,9,1,2,1,1,1,1,0,0,0
S01006829,Occupancy rating 0,8,1,1,0,5,1,4,0,4,0,0,0,0,2,0,0,0,2
S01006829,Occupancy rating -1 or less,0,0,0,0,0,0,0,0,0,0,0,0,0,0,0,0,0,0
S01006830,All households,301,72,30,42,217,38,151,59,65,27,28,15,13,12,1,0,0,11
S01006830,Occupancy rating +2 or more,167,42,21,21,122,29,86,44,29,13,7,4,3,3,0,0,0,3
S01006830,Occupancy rating +1,63,9,5,4,49,8,32,9,15,8,9,6,3,5,1,0,0,4
S01006830,Occupancy rating 0,57,17,3,14,37,0,27,5,18,4,10,5,5,3,0,0,0,3
S01006830,Occupancy rating -1 or less,14,4,1,3,9,1,6,1,3,2,2,0,2,1,0,0,0,1
S01006831,All households,221,49,33,16,165,27,129,59,50,20,9,6,3,7,0,0,0,7
S01006831,Occupancy rating +2 or more,171,42,28,14,123,26,97,54,28,15,0,0,0,6,0,0,0,6
S01006831,Occupancy rating +1,32,7,5,2,24,1,20,4,14,2,3,3,0,1,0,0,0,1
S01006831,Occupancy rating 0,17,0,0,0,17,0,11,1,7,3,6,3,3,0,0,0,0,0
S01006831,Occupancy rating -1 or less,1,0,0,0,1,0,1,0,1,0,0,0,0,0,0,0,0,0
S01006832,All households,424,109,53,56,300,46,222,96,102,24,32,13,19,15,7,0,2,6
S01006832,Occupancy rating +2 or more,261,46,25,21,210,36,163,75,69,19,11,5,6,5,3,0,1,1
S01006832,Occupancy rating +1,83,39,12,27,41,5,32,16,14,2,4,0,4,3,1,0,1,1
S01006832,Occupancy rating 0,56,18,14,4,35,4,18,3,13,2,13,7,6,3,0,0,0,3
S01006832,Occupancy rating -1 or less,24,6,2,4,14,1,9,2,6,1,4,1,3,4,3,0,0,1
S01006833,All households,175,35,26,9,134,26,97,37,48,12,11,7,4,6,1,0,0,5
S01006833,Occupancy rating +2 or more,153,27,19,8,123,26,88,35,42,11,9,6,3,3,0,0,0,3
S01006833,Occupancy rating +1,11,4,4,0,7,0,6,1,4,1,1,0,1,0,0,0,0,0
S01006833,Occupancy rating 0,5,0,0,0,3,0,2,0,2,0,1,1,0,2,0,0,0,2
S01006833,Occupancy rating -1 or less,6,4,3,1,1,0,1,1,0,0,0,0,0,1,1,0,0,0
S01006834,All households,163,12,0,12,145,3,127,19,96,12,15,9,6,6,1,0,0,5
S01006834,Occupancy rating +2 or more,130,11,0,11,118,3,107,19,78,10,8,5,3,1,0,0,0,1
S01006834,Occupancy rating +1,17,1,0,1,13,0,10,0,8,2,3,1,2,3,0,0,0,3
S01006834,Occupancy rating 0,13,0,0,0,13,0,9,0,9,0,4,3,1,0,0,0,0,0
S01006834,Occupancy rating -1 or less,3,0,0,0,1,0,1,0,1,0,0,0,0,2,1,0,0,1
S01006835,All households,478,254,141,113,204,42,135,67,56,12,27,17,10,20,5,0,3,12
S01006835,Occupancy rating +2 or more,135,45,19,26,87,13,65,32,27,6,9,4,5,3,2,0,0,1
S01006835,Occupancy rating +1,100,48,19,29,47,14,28,18,8,2,5,1,4,5,1,0,1,3
S01006835,Occupancy rating 0,193,139,94,45,48,10,29,13,13,3,9,8,1,6,1,0,1,4
S01006835,Occupancy rating -1 or less,50,22,9,13,22,5,13,4,8,1,4,4,0,6,1,0,1,4
S01006836,All households,210,68,11,57,142,3,125,38,81,6,14,13,1,0,0,0,0,0
S01006836,Occupancy rating +2 or more,112,12,1,11,100,1,95,26,65,4,4,3,1,0,0,0,0,0
S01006836,Occupancy rating +1,48,30,4,26,18,0,16,9,6,1,2,2,0,0,0,0,0,0
S01006836,Occupancy rating 0,42,24,5,19,18,2,10,3,6,1,6,6,0,0,0,0,0,0
S01006836,Occupancy rating -1 or less,8,2,1,1,6,0,4,0,4,0,2,2,0,0,0,0,0,0
S01006837,All households,230,49,20,29,175,24,130,35,72,23,21,15,6,6,3,0,0,3
S01006837,Occupancy rating +2 or more,132,27,11,16,103,17,79,28,41,10,7,7,0,2,0,0,0,2
S01006837,Occupancy rating +1,59,10,8,2,46,7,30,3,20,7,9,5,4,3,2,0,0,1
S01006837,Occupancy rating 0,31,11,1,10,19,0,16,3,8,5,3,1,2,1,1,0,0,0
S01006837,Occupancy rating -1 or less,8,1,0,1,7,0,5,1,3,1,2,2,0,0,0,0,0,0
S01006838,All households,249,56,25,31,188,12,162,55,88,19,14,9,5,5,1,0,0,4
S01006838,Occupancy rating +2 or more,163,27,5,22,133,8,120,47,63,10,5,2,3,3,0,0,0,3
S01006838,Occupancy rating +1,46,7,4,3,38,2,30,4,20,6,6,5,1,1,0,0,0,1
S01006838,Occupancy rating 0,36,21,15,6,15,2,11,3,5,3,2,1,1,0,0,0,0,0
S01006838,Occupancy rating -1 or less,4,1,1,0,2,0,1,1,0,0,1,1,0,1,1,0,0,0
S01006839,All households,450,111,51,60,323,49,229,102,87,40,45,26,19,16,7,0,0,9
S01006839,Occupancy rating +2 or more,215,48,19,29,164,32,120,68,32,20,12,7,5,3,1,0,0,2
S01006839,Occupancy rating +1,122,28,12,16,90,14,61,25,26,10,15,8,7,4,1,0,0,3
S01006839,Occupancy rating 0,97,34,19,15,59,3,41,9,25,7,15,8,7,4,2,0,0,2
S01006839,Occupancy rating -1 or less,16,1,1,0,10,0,7,0,4,3,3,3,0,5,3,0,0,2
S01006840,All households,366,46,21,25,309,43,248,82,128,38,18,12,6,11,5,0,1,5
S01006840,Occupancy rating +2 or more,308,37,16,21,264,41,212,79,105,28,11,8,3,7,3,0,0,4
S01006840,Occupancy rating +1,43,9,5,4,32,2,25,3,16,6,5,2,3,2,2,0,0,0
S01006840,Occupancy rating 0,11,0,0,0,11,0,10,0,6,4,1,1,0,0,0,0,0,0
S01006840,Occupancy rating -1 or less,4,0,0,0,2,0,1,0,1,0,1,1,0,2,0,0,1,1
S01006841,All households,344,53,19,34,281,17,232,90,105,37,32,24,8,10,2,0,0,8
S01006841,Occupancy rating +2 or more,231,35,14,21,189,11,166,76,70,20,12,10,2,7,1,0,0,6
S01006841,Occupancy rating +1,73,17,4,13,56,4,44,13,21,10,8,5,3,0,0,0,0,0
S01006841,Occupancy rating 0,34,1,1,0,31,2,19,1,14,4,10,8,2,2,0,0,0,2
S01006841,Occupancy rating -1 or less,6,0,0,0,5,0,3,0,0,3,2,1,1,1,1,0,0,0
S01006842,All households,308,47,29,18,252,33,199,66,84,49,20,8,12,9,6,0,0,3
S01006842,Occupancy rating +2 or more,198,31,18,13,162,27,132,51,55,26,3,2,1,5,2,0,0,3
S01006842,Occupancy rating +1,75,13,9,4,61,6,46,15,14,17,9,1,8,1,1,0,0,0
S01006842,Occupancy rating 0,32,3,2,1,28,0,20,0,14,6,8,5,3,1,1,0,0,0
S01006842,Occupancy rating -1 or less,3,0,0,0,1,0,1,0,1,0,0,0,0,2,2,0,0,0
S01006843,All households,312,51,17,34,255,21,214,83,100,31,20,14,6,6,3,0,0,3
S01006843,Occupancy rating +2 or more,164,31,11,20,133,12,113,61,38,14,8,5,3,0,0,0,0,0
S01006843,Occupancy rating +1,98,16,5,11,80,7,65,20,35,10,8,5,3,2,1,0,0,1
S01006843,Occupancy rating 0,43,3,1,2,38,2,32,2,24,6,4,4,0,2,0,0,0,2
S01006843,Occupancy rating -1 or less,7,1,0,1,4,0,4,0,3,1,0,0,0,2,2,0,0,0
S01006844,All households,332,139,33,106,186,20,150,62,64,24,16,7,9,7,1,0,0,6
S01006844,Occupancy rating +2 or more,98,16,5,11,80,10,66,24,30,12,4,2,2,2,0,0,0,2
S01006844,Occupancy rating +1,111,54,18,36,56,8,44,23,12,9,4,1,3,1,0,0,0,1
S01006844,Occupancy rating 0,89,45,7,38,41,1,32,12,17,3,8,4,4,3,0,0,0,3
S01006844,Occupancy rating -1 or less,34,24,3,21,9,1,8,3,5,0,0,0,0,1,1,0,0,0
S01006845,All households,366,77,18,59,281,16,234,86,106,42,31,18,13,8,4,0,0,4
S01006845,Occupancy rating +2 or more,191,27,7,20,162,11,136,57,57,22,15,7,8,2,0,0,0,2
S01006845,Occupancy rating +1,103,30,7,23,70,3,65,19,30,16,2,2,0,3,2,0,0,1
S01006845,Occupancy rating 0,62,19,4,15,41,2,29,8,18,3,10,7,3,2,1,0,0,1
S01006845,Occupancy rating -1 or less,10,1,0,1,8,0,4,2,1,1,4,2,2,1,1,0,0,0
S01006846,All households,240,63,16,47,169,25,130,61,51,18,14,6,8,8,2,0,1,5
S01006846,Occupancy rating +2 or more,97,26,9,17,69,11,54,35,15,4,4,2,2,2,1,0,0,1
S01006846,Occupancy rating +1,72,25,4,21,46,6,34,18,13,3,6,2,4,1,0,0,1,0
S01006846,Occupancy rating 0,56,9,3,6,45,8,35,7,19,9,2,2,0,2,1,0,0,1
S01006846,Occupancy rating -1 or less,15,3,0,3,9,0,7,1,4,2,2,0,2,3,0,0,0,3
S01006847,All households,238,31,11,20,203,18,167,56,85,26,18,13,5,4,2,0,0,2
S01006847,Occupancy rating +2 or more,130,14,3,11,114,13,96,43,40,13,5,3,2,2,1,0,0,1
S01006847,Occupancy rating +1,71,15,7,8,55,5,43,10,27,6,7,6,1,1,1,0,0,0
S01006847,Occupancy rating 0,28,2,1,1,26,0,22,2,16,4,4,3,1,0,0,0,0,0
S01006847,Occupancy rating -1 or less,9,0,0,0,8,0,6,1,2,3,2,1,1,1,0,0,0,1
S01006848,All households,364,81,36,45,271,31,225,91,107,27,15,8,7,12,2,0,0,10
S01006848,Occupancy rating +2 or more,245,31,17,14,208,20,179,73,89,17,9,4,5,6,2,0,0,4
S01006848,Occupancy rating +1,75,26,11,15,47,10,34,17,11,6,3,2,1,2,0,0,0,2
S01006848,Occupancy rating 0,28,14,6,8,11,1,8,1,5,2,2,2,0,3,0,0,0,3
S01006848,Occupancy rating -1 or less,16,10,2,8,5,0,4,0,2,2,1,0,1,1,0,0,0,1
S01006849,All households,355,40,4,36,300,4,255,98,141,16,41,37,4,15,10,0,0,5
S01006849,Occupancy rating +2 or more,205,21,3,18,176,2,166,86,71,9,8,7,1,8,6,0,0,2
S01006849,Occupancy rating +1,67,3,1,2,62,0,51,6,43,2,11,9,2,2,1,0,0,1
S01006849,Occupancy rating 0,65,12,0,12,49,2,30,6,19,5,17,16,1,4,3,0,0,1
S01006849,Occupancy rating -1 or less,18,4,0,4,13,0,8,0,8,0,5,5,0,1,0,0,0,1
S01006850,All households,365,64,19,45,284,17,213,77,89,47,54,37,17,17,7,0,0,10
S01006850,Occupancy rating +2 or more,118,24,5,19,90,6,74,44,20,10,10,6,4,4,1,0,0,3
S01006850,Occupancy rating +1,136,22,7,15,107,9,80,28,32,20,18,13,5,7,3,0,0,4
S01006850,Occupancy rating 0,96,18,7,11,72,2,51,4,31,16,19,14,5,6,3,0,0,3
S01006850,Occupancy rating -1 or less,15,0,0,0,15,0,8,1,6,1,7,4,3,0,0,0,0,0
S01006851,All households,337,99,56,43,222,23,163,49,78,36,36,24,12,16,7,0,1,8
S01006851,Occupancy rating +2 or more,129,30,14,16,95,7,79,30,28,21,9,3,6,4,1,0,1,2
S01006851,Occupancy rating +1,77,17,5,12,58,5,44,16,21,7,9,6,3,2,0,0,0,2
S01006851,Occupancy rating 0,110,47,32,15,55,9,31,2,22,7,15,13,2,8,4,0,0,4
S01006851,Occupancy rating -1 or less,21,5,5,0,14,2,9,1,7,1,3,2,1,2,2,0,0,0
S01006852,All households,229,41,19,22,177,22,143,55,61,27,12,3,9,11,5,0,0,6
S01006852,Occupancy rating +2 or more,175,28,12,16,141,19,114,50,45,19,8,2,6,6,2,0,0,4
S01006852,Occupancy rating +1,33,9,7,2,21,3,16,4,8,4,2,0,2,3,2,0,0,1
S01006852,Occupancy rating 0,18,3,0,3,14,0,12,1,7,4,2,1,1,1,0,0,0,1
S01006852,Occupancy rating -1 or less,3,1,0,1,1,0,1,0,1,0,0,0,0,1,1,0,0,0
S01006853,All households,318,68,28,40,239,18,205,77,106,22,16,5,11,11,4,0,0,7
S01006853,Occupancy rating +2 or more,254,48,18,30,198,18,171,70,84,17,9,2,7,8,4,0,0,4
S01006853,Occupancy rating +1,44,17,9,8,25,0,22,7,12,3,3,2,1,2,0,0,0,2
S01006853,Occupancy rating 0,13,1,1,0,12,0,9,0,7,2,3,1,2,0,0,0,0,0
S01006853,Occupancy rating -1 or less,7,2,0,2,4,0,3,0,3,0,1,0,1,1,0,0,0,1
S01006854,All households,364,81,38,43,277,50,197,84,82,31,30,19,11,6,2,0,0,4
S01006854,Occupancy rating +2 or more,226,36,19,17,188,35,144,77,47,20,9,5,4,2,1,0,0,1
S01006854,Occupancy rating +1,53,11,2,9,41,9,25,7,15,3,7,5,2,1,0,0,0,1
S01006854,Occupancy rating 0,72,34,17,17,38,6,22,0,15,7,10,5,5,0,0,0,0,0
S01006854,Occupancy rating -1 or less,13,0,0,0,10,0,6,0,5,1,4,4,0,3,1,0,0,2
S01006855,All households,294,43,24,19,234,29,191,82,84,25,14,7,7,17,4,0,3,10
S01006855,Occupancy rating +2 or more,239,34,19,15,192,27,156,73,64,19,9,4,5,13,4,0,2,7
S01006855,Occupancy rating +1,28,3,2,1,22,0,20,6,11,3,2,1,1,3,0,0,1,2
S01006855,Occupancy rating 0,21,6,3,3,14,2,9,1,5,3,3,2,1,1,0,0,0,1
S01006855,Occupancy rating -1 or less,6,0,0,0,6,0,6,2,4,0,0,0,0,0,0,0,0,0
S01006856,All households,254,42,26,16,202,20,161,68,76,17,21,11,10,10,5,0,1,4
S01006856,Occupancy rating +2 or more,176,24,13,11,146,17,120,54,55,11,9,3,6,6,4,0,0,2
S01006856,Occupancy rating +1,57,16,11,5,38,3,29,12,14,3,6,3,3,3,1,0,1,1
S01006856,Occupancy rating 0,17,2,2,0,14,0,10,2,5,3,4,3,1,1,0,0,0,1
S01006856,Occupancy rating -1 or less,4,0,0,0,4,0,2,0,2,0,2,2,0,0,0,0,0,0
S01006857,All households,398,92,38,54,289,33,242,106,101,35,14,4,10,17,4,0,1,12
S01006857,Occupancy rating +2 or more,278,52,18,34,215,28,180,86,73,21,7,2,5,11,3,0,1,7
S01006857,Occupancy rating +1,59,14,5,9,45,3,38,16,16,6,4,1,3,0,0,0,0,0
S01006857,Occupancy rating 0,51,22,13,9,23,2,18,3,9,6,3,1,2,6,1,0,0,5
S01006857,Occupancy rating -1 or less,10,4,2,2,6,0,6,1,3,2,0,0,0,0,0,0,0,0
S01006858,All households,240,37,17,20,193,25,159,66,63,30,9,5,4,10,3,0,0,7
S01006858,Occupancy rating +2 or more,185,26,11,15,151,23,125,55,50,20,3,2,1,8,2,0,0,6
S01006858,Occupancy rating +1,38,9,5,4,28,2,24,8,9,7,2,1,1,1,0,0,0,1
S01006858,Occupancy rating 0,13,2,1,1,11,0,8,3,4,1,3,2,1,0,0,0,0,0
S01006858,Occupancy rating -1 or less,4,0,0,0,3,0,2,0,0,2,1,0,1,1,1,0,0,0
S01006859,All households,421,96,50,46,308,38,250,92,123,35,20,11,9,17,4,0,1,12
S01006859,Occupancy rating +2 or more,314,54,27,27,250,32,206,78,102,26,12,7,5,10,3,0,1,6
S01006859,Occupancy rating +1,67,23,14,9,42,5,32,9,17,6,5,3,2,2,1,0,0,1
S01006859,Occupancy rating 0,35,17,8,9,14,1,10,5,3,2,3,1,2,4,0,0,0,4
S01006859,Occupancy rating -1 or less,5,2,1,1,2,0,2,0,1,1,0,0,0,1,0,0,0,1
S01006860,All households,264,104,57,47,153,27,98,45,36,17,28,15,13,7,5,0,0,2
S01006860,Occupancy rating +2 or more,73,18,12,6,54,15,36,19,14,3,3,2,1,1,1,0,0,0
S01006860,Occupancy rating +1,86,33,15,18,51,9,33,18,7,8,9,3,6,2,0,0,0,2
S01006860,Occupancy rating 0,93,51,29,22,41,2,24,8,13,3,15,10,5,1,1,0,0,0
S01006860,Occupancy rating -1 or less,12,2,1,1,7,1,5,0,2,3,1,0,1,3,3,0,0,0
S01006861,All households,195,23,1,22,167,4,157,34,114,9,6,4,2,5,3,0,0,2
S01006861,Occupancy rating +2 or more,135,14,1,13,120,3,113,26,79,8,4,2,2,1,1,0,0,0
S01006861,Occupancy rating +1,37,7,0,7,29,1,28,8,20,0,0,0,0,1,1,0,0,0
S01006861,Occupancy rating 0,16,2,0,2,12,0,11,0,11,0,1,1,0,2,0,0,0,2
S01006861,Occupancy rating -1 or less,7,0,0,0,6,0,5,0,4,1,1,1,0,1,1,0,0,0
S01006862,All households,312,98,60,38,209,38,150,64,61,25,21,11,10,5,2,0,0,3
S01006862,Occupancy rating +2 or more,167,37,23,14,129,29,95,53,30,12,5,2,3,1,1,0,0,0
S01006862,Occupancy rating +1,70,25,13,12,44,4,34,5,17,12,6,3,3,1,0,0,0,1
S01006862,Occupancy rating 0,58,29,20,9,28,4,17,4,13,0,7,5,2,1,1,0,0,0
S01006862,Occupancy rating -1 or less,17,7,4,3,8,1,4,2,1,1,3,1,2,2,0,0,0,2
S01006863,All households,295,90,42,48,193,33,128,39,68,21,32,14,18,12,5,0,0,7
S01006863,Occupancy rating +2 or more,147,35,16,19,109,26,70,30,27,13,13,8,5,3,2,0,0,1
S01006863,Occupancy rating +1,81,33,16,17,43,5,29,5,20,4,9,2,7,5,1,0,0,4
S01006863,Occupancy rating 0,53,20,10,10,31,2,21,4,13,4,8,4,4,2,0,0,0,2
S01006863,Occupancy rating -1 or less,14,2,0,2,10,0,8,0,8,0,2,0,2,2,2,0,0,0
S01006864,All households,165,35,5,30,124,3,94,36,52,6,27,20,7,6,2,0,0,4
S01006864,Occupancy rating +2 or more,63,9,1,8,54,2,49,27,19,3,3,1,2,0,0,0,0,0
S01006864,Occupancy rating +1,48,14,3,11,32,1,22,5,16,1,9,7,2,2,1,0,0,1
S01006864,Occupancy rating 0,43,11,1,10,30,0,18,4,12,2,12,11,1,2,1,0,0,1
S01006864,Occupancy rating -1 or less,11,1,0,1,8,0,5,0,5,0,3,1,2,2,0,0,0,2
S01006865,All households,424,144,58,86,269,35,216,116,80,20,18,11,7,11,2,1,0,8
S01006865,Occupancy rating +2 or more,227,60,32,28,165,25,133,73,46,14,7,2,5,2,0,0,0,2
S01006865,Occupancy rating +1,89,40,14,26,47,6,38,24,9,5,3,3,0,2,0,0,0,2
S01006865,Occupancy rating 0,92,43,12,31,45,3,37,18,18,1,5,3,2,4,0,1,0,3
S01006865,Occupancy rating -1 or less,16,1,0,1,12,1,8,1,7,0,3,3,0,3,2,0,0,1
S01006866,All households,220,48,31,17,159,36,118,56,48,14,5,4,1,13,7,0,2,4
S01006866,Occupancy rating +2 or more,168,32,21,11,131,35,94,49,36,9,2,2,0,5,2,0,1,2
S01006866,Occupancy rating +1,33,13,8,5,18,1,16,6,6,4,1,0,1,2,0,0,1,1
S01006866,Occupancy rating 0,18,3,2,1,10,0,8,1,6,1,2,2,0,5,4,0,0,1
S01006866,Occupancy rating -1 or less,1,0,0,0,0,0,0,0,0,0,0,0,0,1,1,0,0,0
S01006867,All households,293,64,42,22,222,50,153,58,62,33,19,13,6,7,3,0,0,4
S01006867,Occupancy rating +2 or more,208,30,21,9,172,38,125,50,49,26,9,6,3,6,3,0,0,3
S01006867,Occupancy rating +1,41,21,12,9,20,5,13,6,6,1,2,1,1,0,0,0,0,0
S01006867,Occupancy rating 0,39,11,7,4,27,6,15,2,7,6,6,4,2,1,0,0,0,1
S01006867,Occupancy rating -1 or less,5,2,2,0,3,1,0,0,0,0,2,2,0,0,0,0,0,0
S01006868,All households,364,97,64,33,256,39,183,62,85,36,34,22,12,11,4,0,1,6
S01006868,Occupancy rating +2 or more,202,37,24,13,160,21,127,45,60,22,12,8,4,5,1,0,0,4
S01006868,Occupancy rating +1,62,20,11,9,41,8,27,6,14,7,6,3,3,1,0,0,0,1
S01006868,Occupancy rating 0,85,38,27,11,46,9,24,10,8,6,13,10,3,1,0,0,0,1
S01006868,Occupancy rating -1 or less,15,2,2,0,9,1,5,1,3,1,3,1,2,4,3,0,1,0
S01006869,All households,197,45,14,31,142,20,107,44,45,18,15,7,8,10,3,0,1,6
S01006869,Occupancy rating +2 or more,118,28,12,16,88,16,70,31,27,12,2,1,1,2,0,0,0,2
S01006869,Occupancy rating +1,34,9,2,7,22,1,18,7,7,4,3,2,1,3,0,0,0,3
S01006869,Occupancy rating 0,34,7,0,7,24,3,14,4,8,2,7,3,4,3,1,0,1,1
S01006869,Occupancy rating -1 or less,11,1,0,1,8,0,5,2,3,0,3,1,2,2,2,0,0,0
S01006870,All households,196,48,27,21,141,29,101,35,51,15,11,9,2,7,1,0,0,6
S01006870,Occupancy rating +2 or more,134,24,15,9,108,25,78,28,38,12,5,5,0,2,1,0,0,1
S01006870,Occupancy rating +1,32,9,6,3,22,2,19,6,11,2,1,1,0,1,0,0,0,1
S01006870,Occupancy rating 0,24,13,4,9,9,2,2,1,0,1,5,3,2,2,0,0,0,2
S01006870,Occupancy rating -1 or less,6,2,2,0,2,0,2,0,2,0,0,0,0,2,0,0,0,2
S01006871,All households,265,54,32,22,204,33,155,52,84,19,16,13,3,7,2,0,0,5
S01006871,Occupancy rating +2 or more,171,21,14,7,149,23,120,47,59,14,6,4,2,1,0,0,0,1
S01006871,Occupancy rating +1,38,13,6,7,25,8,15,4,9,2,2,2,0,0,0,0,0,0
S01006871,Occupancy rating 0,43,18,10,8,20,2,14,1,10,3,4,3,1,5,1,0,0,4
S01006871,Occupancy rating -1 or less,13,2,2,0,10,0,6,0,6,0,4,4,0,1,1,0,0,0
S01006872,All households,252,36,17,19,205,26,173,62,90,21,6,2,4,11,6,0,1,4
S01006872,Occupancy rating +2 or more,206,28,13,15,171,22,146,53,74,19,3,1,2,7,5,0,1,1
S01006872,Occupancy rating +1,28,6,3,3,21,3,16,6,10,0,2,1,1,1,0,0,0,1
S01006872,Occupancy rating 0,12,2,1,1,9,1,7,2,3,2,1,0,1,1,0,0,0,1
S01006872,Occupancy rating -1 or less,6,0,0,0,4,0,4,1,3,0,0,0,0,2,1,0,0,1
S01006873,All households,426,135,98,37,273,71,181,72,87,22,21,16,5,18,8,0,0,10
S01006873,Occupancy rating +2 or more,273,66,44,22,194,50,136,60,63,13,8,7,1,13,6,0,0,7
S01006873,Occupancy rating +1,106,48,42,6,55,19,30,12,12,6,6,3,3,3,2,0,0,1
S01006873,Occupancy rating 0,41,18,10,8,23,2,14,0,11,3,7,6,1,0,0,0,0,0
S01006873,Occupancy rating -1 or less,6,3,2,1,1,0,1,0,1,0,0,0,0,2,0,0,0,2
S01006874,All households,216,39,9,30,172,18,139,53,64,22,15,7,8,5,2,0,0,3
S01006874,Occupancy rating +2 or more,162,27,7,20,134,16,111,44,49,18,7,3,4,1,0,0,0,1
S01006874,Occupancy rating +1,30,11,2,9,19,2,14,8,5,1,3,1,2,0,0,0,0,0
S01006874,Occupancy rating 0,15,1,0,1,12,0,8,0,5,3,4,3,1,2,2,0,0,0
S01006874,Occupancy rating -1 or less,9,0,0,0,7,0,6,1,5,0,1,0,1,2,0,0,0,2
S01006875,All households,321,115,65,50,200,42,128,55,56,17,30,23,7,6,1,0,1,4
S01006875,Occupancy rating +2 or more,150,42,21,21,104,30,68,34,25,9,6,5,1,4,1,0,1,2
S01006875,Occupancy rating +1,74,26,16,10,47,8,28,10,13,5,11,8,3,1,0,0,0,1
S01006875,Occupancy rating 0,84,43,27,16,41,3,28,9,16,3,10,9,1,0,0,0,0,0
S01006875,Occupancy rating -1 or less,13,4,1,3,8,1,4,2,2,0,3,1,2,1,0,0,0,1
S01006876,All households,396,87,36,51,299,40,223,96,97,30,36,17,19,10,4,0,1,5
S01006876,Occupancy rating +2 or more,256,45,21,24,209,31,164,86,58,20,14,6,8,2,2,0,0,0
S01006876,Occupancy rating +1,70,17,8,9,51,7,34,9,19,6,10,4,6,2,0,0,1,1
S01006876,Occupancy rating 0,50,22,6,16,26,2,17,1,13,3,7,3,4,2,1,0,0,1
S01006876,Occupancy rating -1 or less,20,3,1,2,13,0,8,0,7,1,5,4,1,4,1,0,0,3
S01006877,All households,372,76,27,49,279,28,232,113,94,25,19,10,9,17,6,0,1,10
S01006877,Occupancy rating +2 or more,285,54,20,34,220,28,183,102,61,20,9,5,4,11,3,0,1,7
S01006877,Occupancy rating +1,45,12,5,7,33,0,29,7,21,1,4,4,0,0,0,0,0,0
S01006877,Occupancy rating 0,33,7,0,7,21,0,16,4,9,3,5,0,5,5,3,0,0,2
S01006877,Occupancy rating -1 or less,9,3,2,1,5,0,4,0,3,1,1,1,0,1,0,0,0,1
S01006878,All households,322,107,50,57,204,34,153,81,58,14,17,8,9,11,2,0,1,8
S01006878,Occupancy rating +2 or more,208,57,32,25,143,31,108,63,33,12,4,1,3,8,1,0,1,6
S01006878,Occupancy rating +1,54,20,6,14,33,1,26,10,14,2,6,3,3,1,0,0,0,1
S01006878,Occupancy rating 0,54,25,10,15,27,2,18,8,10,0,7,4,3,2,1,0,0,1
S01006878,Occupancy rating -1 or less,6,5,2,3,1,0,1,0,1,0,0,0,0,0,0,0,0,0
S01006879,All households,322,91,33,58,218,38,165,77,70,18,15,10,5,13,3,0,2,8
S01006879,Occupancy rating +2 or more,233,64,26,38,164,33,120,64,43,13,11,8,3,5,2,0,0,3
S01006879,Occupancy rating +1,61,22,7,15,35,3,31,11,16,4,1,1,0,4,0,0,1,3
S01006879,Occupancy rating 0,24,3,0,3,17,1,13,2,11,0,3,1,2,4,1,0,1,2
S01006879,Occupancy rating -1 or less,4,2,0,2,2,1,1,0,0,1,0,0,0,0,0,0,0,0
S01006880,All households,227,32,15,17,189,18,158,62,78,18,13,8,5,6,2,0,1,3
S01006880,Occupancy rating +2 or more,177,23,9,14,150,17,128,53,59,16,5,1,4,4,1,0,1,2
S01006880,Occupancy rating +1,35,9,6,3,26,1,24,9,15,0,1,1,0,0,0,0,0,0
S01006880,Occupancy rating 0,8,0,0,0,8,0,3,0,2,1,5,4,1,0,0,0,0,0
S01006880,Occupancy rating -1 or less,7,0,0,0,5,0,3,0,2,1,2,2,0,2,1,0,0,1
S01006881,All households,227,34,10,24,189,26,148,71,63,14,15,6,9,4,1,0,0,3
S01006881,Occupancy rating +2 or more,179,25,7,18,151,22,122,62,48,12,7,2,5,3,1,0,0,2
S01006881,Occupancy rating +1,26,7,2,5,18,2,14,5,8,1,2,1,1,1,0,0,0,1
S01006881,Occupancy rating 0,20,2,1,1,18,2,10,4,6,0,6,3,3,0,0,0,0,0
S01006881,Occupancy rating -1 or less,2,0,0,0,2,0,2,0,1,1,0,0,0,0,0,0,0,0
S01006882,All households,207,99,72,27,104,17,69,29,27,13,18,11,7,4,0,0,0,4
S01006882,Occupancy rating +2 or more,62,19,10,9,40,8,31,18,9,4,1,0,1,3,0,0,0,3
S01006882,Occupancy rating +1,58,29,14,15,29,5,19,9,4,6,5,2,3,0,0,0,0,0
S01006882,Occupancy rating 0,69,38,36,2,30,4,16,2,11,3,10,8,2,1,0,0,0,1
S01006882,Occupancy rating -1 or less,18,13,12,1,5,0,3,0,3,0,2,1,1,0,0,0,0,0
S01006883,All households,217,86,34,52,126,23,88,39,35,14,15,9,6,5,4,0,0,1
S01006883,Occupancy rating +2 or more,117,29,16,13,85,17,60,25,25,10,8,4,4,3,3,0,0,0
S01006883,Occupancy rating +1,39,20,7,13,19,5,11,4,6,1,3,3,0,0,0,0,0,0
S01006883,Occupancy rating 0,52,34,11,23,17,1,14,9,4,1,2,0,2,1,0,0,0,1
S01006883,Occupancy rating -1 or less,9,3,0,3,5,0,3,1,0,2,2,2,0,1,1,0,0,0
S01006884,All households,390,123,75,48,258,48,174,59,87,28,36,20,16,9,5,0,2,2
S01006884,Occupancy rating +2 or more,229,56,36,20,171,38,115,51,50,14,18,8,10,2,1,0,1,0
S01006884,Occupancy rating +1,82,31,17,14,48,8,31,6,18,7,9,6,3,3,1,0,0,2
S01006884,Occupancy rating 0,67,33,21,12,33,2,22,2,15,5,9,6,3,1,0,0,1,0
S01006884,Occupancy rating -1 or less,12,3,1,2,6,0,6,0,4,2,0,0,0,3,3,0,0,0
S01006885,All households,220,50,30,20,163,34,117,60,41,16,12,9,3,7,5,0,1,1
S01006885,Occupancy rating +2 or more,163,31,18,13,127,23,98,50,33,15,6,4,2,5,3,0,1,1
S01006885,Occupancy rating +1,42,17,11,6,23,8,12,7,4,1,3,2,1,2,2,0,0,0
S01006885,Occupancy rating 0,12,1,0,1,11,2,6,2,4,0,3,3,0,0,0,0,0,0
S01006885,Occupancy rating -1 or less,3,1,1,0,2,1,1,1,0,0,0,0,0,0,0,0,0,0
S01006886,All households,321,84,28,56,227,32,183,99,61,23,12,9,3,10,9,0,0,1
S01006886,Occupancy rating +2 or more,214,41,13,28,171,27,139,88,37,14,5,3,2,2,2,0,0,0
S01006886,Occupancy rating +1,49,18,8,10,29,5,23,8,13,2,1,0,1,2,2,0,0,0
S01006886,Occupancy rating 0,47,22,6,16,23,0,18,3,10,5,5,5,0,2,1,0,0,1
S01006886,Occupancy rating -1 or less,11,3,1,2,4,0,3,0,1,2,1,1,0,4,4,0,0,0
S01006887,All households,213,29,9,20,178,14,149,62,71,16,15,12,3,6,3,0,0,3
S01006887,Occupancy rating +2 or more,169,18,4,14,150,13,131,53,62,16,6,6,0,1,1,0,0,0
S01006887,Occupancy rating +1,24,8,2,6,15,1,13,8,5,0,1,1,0,1,1,0,0,0
S01006887,Occupancy rating 0,17,3,3,0,12,0,5,1,4,0,7,4,3,2,0,0,0,2
S01006887,Occupancy rating -1 or less,3,0,0,0,1,0,0,0,0,0,1,1,0,2,1,0,0,1
S01006888,All households,309,58,18,40,239,27,194,79,90,25,18,13,5,12,4,0,1,7
S01006888,Occupancy rating +2 or more,218,38,11,27,174,25,147,69,64,14,2,2,0,6,2,0,0,4
S01006888,Occupancy rating +1,47,9,4,5,35,2,22,5,12,5,11,7,4,3,0,0,0,3
S01006888,Occupancy rating 0,37,9,3,6,26,0,22,5,11,6,4,3,1,2,1,0,1,0
S01006888,Occupancy rating -1 or less,7,2,0,2,4,0,3,0,3,0,1,1,0,1,1,0,0,0
S01006889,All households,350,101,40,61,240,28,176,72,72,32,36,21,15,9,3,0,0,6
S01006889,Occupancy rating +2 or more,124,39,13,26,85,12,68,52,12,4,5,3,2,0,0,0,0,0
S01006889,Occupancy rating +1,95,29,10,19,65,13,44,13,14,17,8,3,5,1,0,0,0,1
S01006889,Occupancy rating 0,93,24,15,9,63,3,42,5,27,10,18,14,4,6,2,0,0,4
S01006889,Occupancy rating -1 or less,38,9,2,7,27,0,22,2,19,1,5,1,4,2,1,0,0,1
S01006890,All households,264,57,19,38,201,23,164,64,79,21,14,8,6,6,2,0,0,4
S01006890,Occupancy rating +2 or more,172,21,13,8,148,19,122,47,57,18,7,3,4,3,1,0,0,2
S01006890,Occupancy rating +1,52,21,5,16,31,4,24,15,9,0,3,2,1,0,0,0,0,0
S01006890,Occupancy rating 0,31,11,0,11,18,0,15,2,10,3,3,2,1,2,0,0,0,2
S01006890,Occupancy rating -1 or less,9,4,1,3,4,0,3,0,3,0,1,1,0,1,1,0,0,0
S01006891,All households,400,125,59,66,265,25,211,91,88,32,29,16,13,10,6,0,2,2
S01006891,Occupancy rating +2 or more,201,46,19,27,152,18,132,64,54,14,2,2,0,3,1,0,1,1
S01006891,Occupancy rating +1,92,31,11,20,57,5,42,22,12,8,10,3,7,4,3,0,0,1
S01006891,Occupancy rating 0,83,38,25,13,43,2,29,5,16,8,12,7,5,2,1,0,1,0
S01006891,Occupancy rating -1 or less,24,10,4,6,13,0,8,0,6,2,5,4,1,1,1,0,0,0
S01006892,All households,275,93,37,56,176,18,128,51,54,23,30,20,10,6,1,0,0,5
S01006892,Occupancy rating +2 or more,59,12,3,9,47,6,40,24,12,4,1,1,0,0,0,0,0,0
S01006892,Occupancy rating +1,80,28,9,19,51,5,41,19,12,10,5,0,5,1,0,0,0,1
S01006892,Occupancy rating 0,114,48,21,27,64,7,39,8,25,6,18,14,4,2,0,0,0,2
S01006892,Occupancy rating -1 or less,22,5,4,1,14,0,8,0,5,3,6,5,1,3,1,0,0,2
S01006893,All households,196,28,15,13,162,21,116,37,53,26,25,19,6,6,4,0,0,2
S01006893,Occupancy rating +2 or more,97,14,5,9,80,16,62,28,20,14,2,2,0,3,1,0,0,2
S01006893,Occupancy rating +1,45,4,2,2,41,4,24,5,10,9,13,7,6,0,0,0,0,0
S01006893,Occupancy rating 0,40,6,4,2,32,0,23,3,17,3,9,9,0,2,2,0,0,0
S01006893,Occupancy rating -1 or less,14,4,4,0,9,1,7,1,6,0,1,1,0,1,1,0,0,0
S01006894,All households,448,160,88,72,281,59,195,87,73,35,27,12,15,7,0,0,2,5
S01006894,Occupancy rating +2 or more,198,50,21,29,146,27,114,55,38,21,5,3,2,2,0,0,0,2
S01006894,Occupancy rating +1,118,41,15,26,77,16,50,26,15,9,11,5,6,0,0,0,0,0
S01006894,Occupancy rating 0,112,57,43,14,51,14,28,6,19,3,9,3,6,4,0,0,2,2
S01006894,Occupancy rating -1 or less,20,12,9,3,7,2,3,0,1,2,2,1,1,1,0,0,0,1
S01006895,All households,266,107,30,77,147,19,99,57,34,8,29,12,17,12,2,0,0,10
S01006895,Occupancy rating +2 or more,66,27,10,17,39,9,26,17,8,1,4,2,2,0,0,0,0,0
S01006895,Occupancy rating +1,118,55,13,42,60,5,50,37,11,2,5,2,3,3,0,0,0,3
S01006895,Occupancy rating 0,60,21,6,15,34,4,14,1,10,3,16,5,11,5,0,0,0,5
S01006895,Occupancy rating -1 or less,22,4,1,3,14,1,9,2,5,2,4,3,1,4,2,0,0,2
S01006896,All households,361,105,43,62,241,42,168,93,51,24,31,16,15,15,5,1,2,7
S01006896,Occupancy rating +2 or more,163,30,16,14,128,30,92,55,23,14,6,2,4,5,2,0,1,2
S01006896,Occupancy rating +1,96,38,14,24,57,7,45,26,13,6,5,2,3,1,0,0,1,0
S01006896,Occupancy rating 0,72,26,7,19,44,5,24,8,13,3,15,9,6,2,0,0,0,2
S01006896,Occupancy rating -1 or less,30,11,6,5,12,0,7,4,2,1,5,3,2,7,3,1,0,3
S01006897,All households,290,66,22,44,214,28,170,70,65,35,16,11,5,10,2,0,1,7
S01006897,Occupancy rating +2 or more,157,29,11,18,124,25,94,50,27,17,5,3,2,4,0,0,0,4
S01006897,Occupancy rating +1,83,25,11,14,56,3,49,14,23,12,4,4,0,2,1,0,0,1
S01006897,Occupancy rating 0,40,11,0,11,28,0,22,4,13,5,6,3,3,1,0,0,0,1
S01006897,Occupancy rating -1 or less,10,1,0,1,6,0,5,2,2,1,1,1,0,3,1,0,1,1
S01006898,All households,340,112,39,73,222,30,164,66,67,31,28,21,7,6,2,0,2,2
S01006898,Occupancy rating +2 or more,143,29,15,14,113,20,89,40,38,11,4,3,1,1,1,0,0,0
S01006898,Occupancy rating +1,82,29,14,15,50,6,38,16,11,11,6,5,1,3,1,0,2,0
S01006898,Occupancy rating 0,79,34,6,28,45,3,27,6,12,9,15,11,4,0,0,0,0,0
S01006898,Occupancy rating -1 or less,36,20,4,16,14,1,10,4,6,0,3,2,1,2,0,0,0,2
S01006899,All households,242,50,20,30,186,13,159,58,76,25,14,9,5,6,2,0,0,4
S01006899,Occupancy rating +2 or more,140,17,9,8,121,6,108,46,50,12,7,4,3,2,0,0,0,2
S01006899,Occupancy rating +1,68,23,5,18,41,7,30,11,13,6,4,3,1,4,2,0,0,2
S01006899,Occupancy rating 0,29,7,5,2,22,0,20,0,13,7,2,1,1,0,0,0,0,0
S01006899,Occupancy rating -1 or less,5,3,1,2,2,0,1,1,0,0,1,1,0,0,0,0,0,0
S01006900,All households,234,46,23,23,173,16,144,63,55,26,13,6,7,15,3,0,0,12
S01006900,Occupancy rating +2 or more,113,24,14,10,87,8,76,43,20,13,3,0,3,2,0,0,0,2
S01006900,Occupancy rating +1,83,21,9,12,57,5,49,20,24,5,3,2,1,5,0,0,0,5
S01006900,Occupancy rating 0,28,0,0,0,23,2,18,0,10,8,3,2,1,5,2,0,0,3
S01006900,Occupancy rating -1 or less,10,1,0,1,6,1,1,0,1,0,4,2,2,3,1,0,0,2
S01006901,All households,270,89,50,39,168,22,119,53,39,27,27,17,10,13,7,1,0,5
S01006901,Occupancy rating +2 or more,75,18,10,8,56,9,43,30,9,4,4,3,1,1,1,0,0,0
S01006901,Occupancy rating +1,57,14,7,7,43,4,33,15,10,8,6,1,5,0,0,0,0,0
S01006901,Occupancy rating 0,110,48,33,15,53,8,32,8,14,10,13,11,2,9,4,1,0,4
S01006901,Occupancy rating -1 or less,28,9,0,9,16,1,11,0,6,5,4,2,2,3,2,0,0,1
S01006902,All households,296,95,33,62,190,18,143,48,74,21,29,21,8,11,1,0,0,10
S01006902,Occupancy rating +2 or more,101,18,7,11,82,7,71,30,34,7,4,3,1,1,0,0,0,1
S01006902,Occupancy rating +1,67,28,6,22,39,4,29,10,11,8,6,4,2,0,0,0,0,0
S01006902,Occupancy rating 0,102,45,19,26,51,7,32,8,19,5,12,9,3,6,1,0,0,5
S01006902,Occupancy rating -1 or less,26,4,1,3,18,0,11,0,10,1,7,5,2,4,0,0,0,4
S01006903,All households,349,110,38,72,228,31,160,68,71,21,37,24,13,11,4,0,0,7
S01006903,Occupancy rating +2 or more,108,29,10,19,78,16,60,35,18,7,2,1,1,1,0,0,0,1
S01006903,Occupancy rating +1,107,52,14,38,55,10,42,27,12,3,3,1,2,0,0,0,0,0
S01006903,Occupancy rating 0,104,25,11,14,73,4,43,5,30,8,26,17,9,6,2,0,0,4
S01006903,Occupancy rating -1 or less,30,4,3,1,22,1,15,1,11,3,6,5,1,4,2,0,0,2
S01006904,All households,330,125,68,57,194,29,128,52,64,12,37,24,13,11,4,0,0,7
S01006904,Occupancy rating +2 or more,107,30,13,17,75,10,58,29,18,11,7,3,4,2,0,0,0,2
S01006904,Occupancy rating +1,98,46,22,24,51,15,31,16,15,0,5,3,2,1,0,0,0,1
S01006904,Occupancy rating 0,103,40,30,10,60,4,33,5,27,1,23,17,6,3,0,0,0,3
S01006904,Occupancy rating -1 or less,22,9,3,6,8,0,6,2,4,0,2,1,1,5,4,0,0,1
S01006905,All households,395,119,78,41,268,64,176,72,67,37,28,12,16,8,1,0,3,4
S01006905,Occupancy rating +2 or more,233,52,33,19,176,48,121,57,41,23,7,3,4,5,1,0,2,2
S01006905,Occupancy rating +1,67,17,9,8,50,10,32,14,10,8,8,3,5,0,0,0,0,0
S01006905,Occupancy rating 0,82,48,35,13,34,6,18,1,12,5,10,5,5,0,0,0,0,0
S01006905,Occupancy rating -1 or less,13,2,1,1,8,0,5,0,4,1,3,1,2,3,0,0,1,2
S01006906,All households,441,193,108,85,237,52,141,67,47,27,44,24,20,11,1,0,2,8
S01006906,Occupancy rating +2 or more,89,28,15,13,59,17,40,28,8,4,2,0,2,2,0,0,0,2
S01006906,Occupancy rating +1,125,45,26,19,78,21,46,29,10,7,11,7,4,2,0,0,1,1
S01006906,Occupancy rating 0,190,109,61,48,78,13,42,9,20,13,23,15,8,3,1,0,1,1
S01006906,Occupancy rating -1 or less,37,11,6,5,22,1,13,1,9,3,8,2,6,4,0,0,0,4
S01006907,All households,305,121,38,83,165,17,127,82,31,14,21,12,9,19,6,0,1,12
S01006907,Occupancy rating +2 or more,106,20,10,10,78,14,63,39,14,10,1,1,0,8,4,0,0,4
S01006907,Occupancy rating +1,66,32,10,22,30,1,26,21,4,1,3,1,2,4,0,0,1,3
S01006907,Occupancy rating 0,102,59,16,43,38,2,22,15,4,3,14,7,7,5,2,0,0,3
S01006907,Occupancy rating -1 or less,31,10,2,8,19,0,16,7,9,0,3,3,0,2,0,0,0,2
S01006908,All households,426,190,76,114,210,35,135,72,38,25,40,25,15,26,2,0,1,23
S01006908,Occupancy rating +2 or more,120,46,24,22,70,12,52,32,9,11,6,2,4,4,1,0,0,3
S01006908,Occupancy rating +1,124,68,25,43,55,13,39,23,9,7,3,2,1,1,0,0,0,1
S01006908,Occupancy rating 0,155,69,26,43,74,9,39,17,19,3,26,18,8,12,1,0,0,11
S01006908,Occupancy rating -1 or less,27,7,1,6,11,1,5,0,1,4,5,3,2,9,0,0,1,8
S01006909,All households,275,24,6,18,244,20,211,77,107,27,13,8,5,7,4,0,1,2
S01006909,Occupancy rating +2 or more,248,21,6,15,223,18,193,71,98,24,12,8,4,4,2,0,1,1
S01006909,Occupancy rating +1,21,3,0,3,16,2,14,5,7,2,0,0,0,2,2,0,0,0
S01006909,Occupancy rating 0,5,0,0,0,4,0,3,1,2,0,1,0,1,1,0,0,0,1
S01006909,Occupancy rating -1 or less,1,0,0,0,1,0,1,0,0,1,0,0,0,0,0,0,0,0
S01006910,All households,353,75,30,45,265,18,229,109,93,27,18,9,9,13,3,0,1,9
S01006910,Occupancy rating +2 or more,259,42,21,21,213,18,184,94,69,21,11,4,7,4,1,0,1,2
S01006910,Occupancy rating +1,51,17,5,12,31,0,28,12,13,3,3,2,1,3,0,0,0,3
S01006910,Occupancy rating 0,32,13,4,9,16,0,12,2,7,3,4,3,1,3,2,0,0,1
S01006910,Occupancy rating -1 or less,11,3,0,3,5,0,5,1,4,0,0,0,0,3,0,0,0,3
S01006911,All households,224,19,1,18,197,2,170,55,106,9,25,23,2,8,4,0,0,4
S01006911,Occupancy rating +2 or more,175,16,0,16,155,2,146,53,87,6,7,6,1,4,1,0,0,3
S01006911,Occupancy rating +1,12,1,0,1,10,0,9,1,7,1,1,1,0,1,0,0,0,1
S01006911,Occupancy rating 0,28,1,0,1,26,0,12,0,10,2,14,13,1,1,1,0,0,0
S01006911,Occupancy rating -1 or less,9,1,1,0,6,0,3,1,2,0,3,3,0,2,2,0,0,0
S01006912,All households,170,33,13,20,130,18,106,47,37,22,6,4,2,7,3,0,0,4
S01006912,Occupancy rating +2 or more,128,24,10,14,101,17,83,41,28,14,1,1,0,3,1,0,0,2
S01006912,Occupancy rating +1,21,8,2,6,11,0,11,5,3,3,0,0,0,2,1,0,0,1
S01006912,Occupancy rating 0,14,0,0,0,13,1,8,0,5,3,4,3,1,1,1,0,0,0
S01006912,Occupancy rating -1 or less,7,1,1,0,5,0,4,1,1,2,1,0,1,1,0,0,0,1
S01006913,All households,182,27,5,22,147,1,139,37,81,21,7,7,0,8,3,0,0,5
S01006913,Occupancy rating +2 or more,154,20,4,16,128,0,123,37,72,14,5,5,0,6,2,0,0,4
S01006913,Occupancy rating +1,18,5,1,4,13,1,10,0,7,3,2,2,0,0,0,0,0,0
S01006913,Occupancy rating 0,8,2,0,2,5,0,5,0,2,3,0,0,0,1,0,0,0,1
S01006913,Occupancy rating -1 or less,2,0,0,0,1,0,1,0,0,1,0,0,0,1,1,0,0,0
S01006914,All households,273,43,10,33,218,21,186,71,94,21,11,5,6,12,1,1,2,8
S01006914,Occupancy rating +2 or more,198,26,6,20,164,19,140,60,65,15,5,2,3,8,1,1,2,4
S01006914,Occupancy rating +1,46,11,3,8,35,2,32,8,20,4,1,1,0,0,0,0,0,0
S01006914,Occupancy rating 0,18,6,1,5,10,0,6,1,5,0,4,2,2,2,0,0,0,2
S01006914,Occupancy rating -1 or less,11,0,0,0,9,0,8,2,4,2,1,0,1,2,0,0,0,2
S01006915,All households,301,39,15,24,247,24,206,89,94,23,17,8,9,15,5,0,1,9
S01006915,Occupancy rating +2 or more,222,20,6,14,193,22,166,81,66,19,5,2,3,9,3,0,1,5
S01006915,Occupancy rating +1,50,16,6,10,31,2,24,5,15,4,5,3,2,3,1,0,0,2
S01006915,Occupancy rating 0,21,2,2,0,17,0,12,3,9,0,5,1,4,2,0,0,0,2
S01006915,Occupancy rating -1 or less,8,1,1,0,6,0,4,0,4,0,2,2,0,1,1,0,0,0
S01006916,All households,207,36,3,33,167,8,125,34,76,15,34,30,4,4,0,1,1,2
S01006916,Occupancy rating +2 or more,105,11,0,11,93,8,81,29,42,10,4,3,1,1,0,0,1,0
S01006916,Occupancy rating +1,41,14,3,11,26,0,23,2,16,5,3,3,0,1,0,1,0,0
S01006916,Occupancy rating 0,48,3,0,3,44,0,18,0,18,0,26,23,3,1,0,0,0,1
S01006916,Occupancy rating -1 or less,13,8,0,8,4,0,3,3,0,0,1,1,0,1,0,0,0,1
S01006917,All households,320,27,3,24,283,4,256,62,184,10,23,21,2,10,8,0,0,2
S01006917,Occupancy rating +2 or more,281,26,3,23,249,4,234,62,167,5,11,9,2,6,4,0,0,2
S01006917,Occupancy rating +1,16,1,0,1,14,0,12,0,11,1,2,2,0,1,1,0,0,0
S01006917,Occupancy rating 0,16,0,0,0,15,0,7,0,3,4,8,8,0,1,1,0,0,0
S01006917,Occupancy rating -1 or less,7,0,0,0,5,0,3,0,3,0,2,2,0,2,2,0,0,0
S01006918,All households,195,42,22,20,149,19,121,49,64,8,9,7,2,4,3,0,0,1
S01006918,Occupancy rating +2 or more,130,20,11,9,109,13,94,41,46,7,2,2,0,1,0,0,0,1
S01006918,Occupancy rating +1,39,13,7,6,23,2,17,5,11,1,4,2,2,3,3,0,0,0
S01006918,Occupancy rating 0,22,8,4,4,14,4,8,3,5,0,2,2,0,0,0,0,0,0
S01006918,Occupancy rating -1 or less,4,1,0,1,3,0,2,0,2,0,1,1,0,0,0,0,0,0
S01006919,All households,205,42,17,25,159,32,115,58,37,20,12,6,6,4,2,0,0,2
S01006919,Occupancy rating +2 or more,124,21,10,11,102,22,77,44,22,11,3,1,2,1,0,0,0,1
S01006919,Occupancy rating +1,43,10,4,6,33,8,21,9,7,5,4,1,3,0,0,0,0,0
S01006919,Occupancy rating 0,27,10,3,7,16,1,11,4,4,3,4,4,0,1,1,0,0,0
S01006919,Occupancy rating -1 or less,11,1,0,1,8,1,6,1,4,1,1,0,1,2,1,0,0,1
S01006920,All households,243,88,47,41,149,21,105,50,45,10,23,15,8,6,0,0,0,6
S01006920,Occupancy rating +2 or more,103,28,16,12,73,13,56,28,23,5,4,2,2,2,0,0,0,2
S01006920,Occupancy rating +1,48,15,6,9,32,6,21,12,9,0,5,2,3,1,0,0,0,1
S01006920,Occupancy rating 0,82,43,24,19,38,2,23,9,9,5,13,10,3,1,0,0,0,1
S01006920,Occupancy rating -1 or less,10,2,1,1,6,0,5,1,4,0,1,1,0,2,0,0,0,2
S01006921,All households,270,21,3,18,245,10,218,60,146,12,17,15,2,4,2,0,0,2
S01006921,Occupancy rating +2 or more,219,13,1,12,203,9,185,58,119,8,9,8,1,3,1,0,0,2
S01006921,Occupancy rating +1,35,7,2,5,28,1,25,1,22,2,2,2,0,0,0,0,0,0
S01006921,Occupancy rating 0,15,1,0,1,13,0,7,1,4,2,6,5,1,1,1,0,0,0
S01006921,Occupancy rating -1 or less,1,0,0,0,1,0,1,0,1,0,0,0,0,0,0,0,0,0
S01006922,All households,201,41,19,22,151,21,121,57,48,16,9,5,4,9,2,0,1,6
S01006922,Occupancy rating +2 or more,136,22,10,12,108,17,86,51,25,10,5,2,3,6,2,0,0,4
S01006922,Occupancy rating +1,44,13,7,6,29,3,24,4,15,5,2,1,1,2,0,0,1,1
S01006922,Occupancy rating 0,17,6,2,4,10,0,9,2,6,1,1,1,0,1,0,0,0,1
S01006922,Occupancy rating -1 or less,4,0,0,0,4,1,2,0,2,0,1,1,0,0,0,0,0,0
S01006923,All households,331,83,60,23,236,47,177,79,71,27,12,7,5,12,2,0,2,8
S01006923,Occupancy rating +2 or more,216,35,17,18,175,27,145,69,55,21,3,2,1,6,2,0,2,2
S01006923,Occupancy rating +1,48,14,9,5,32,11,18,5,8,5,3,1,2,2,0,0,0,2
S01006923,Occupancy rating 0,64,33,33,0,27,9,12,5,7,0,6,4,2,4,0,0,0,4
S01006923,Occupancy rating -1 or less,3,1,1,0,2,0,2,0,1,1,0,0,0,0,0,0,0,0
S01006924,All households,208,39,12,27,161,6,146,59,64,23,9,6,3,8,4,0,0,4
S01006924,Occupancy rating +2 or more,171,33,12,21,131,4,121,56,49,16,6,3,3,7,3,0,0,4
S01006924,Occupancy rating +1,24,3,0,3,21,1,17,3,9,5,3,3,0,0,0,0,0,0
S01006924,Occupancy rating 0,9,3,0,3,5,0,5,0,3,2,0,0,0,1,1,0,0,0
S01006924,Occupancy rating -1 or less,4,0,0,0,4,1,3,0,3,0,0,0,0,0,0,0,0,0
S01006925,All households,215,56,26,30,156,21,125,63,45,17,10,6,4,3,2,0,0,1
S01006925,Occupancy rating +2 or more,126,20,8,12,106,15,88,53,25,10,3,1,2,0,0,0,0,0
S01006925,Occupancy rating +1,41,15,3,12,26,1,22,5,11,6,3,2,1,0,0,0,0,0
S01006925,Occupancy rating 0,39,16,12,4,20,5,11,5,5,1,4,3,1,3,2,0,0,1
S01006925,Occupancy rating -1 or less,9,5,3,2,4,0,4,0,4,0,0,0,0,0,0,0,0,0
S01006926,All households,263,27,7,20,228,14,197,77,98,22,17,11,6,8,2,0,1,5
S01006926,Occupancy rating +2 or more,205,20,5,15,181,12,163,70,76,17,6,2,4,4,1,0,0,3
S01006926,Occupancy rating +1,43,6,1,5,35,1,26,7,15,4,8,6,2,2,0,0,1,1
S01006926,Occupancy rating 0,13,0,0,0,12,1,8,0,7,1,3,3,0,1,1,0,0,0
S01006926,Occupancy rating -1 or less,2,1,1,0,0,0,0,0,0,0,0,0,0,1,0,0,0,1
S01006927,All households,358,27,1,26,325,3,298,114,171,13,24,17,7,6,3,0,0,3
S01006927,Occupancy rating +2 or more,283,19,1,18,259,1,248,98,141,9,10,4,6,5,3,0,0,2
S01006927,Occupancy rating +1,41,3,0,3,38,0,36,12,21,3,2,2,0,0,0,0,0,0
S01006927,Occupancy rating 0,31,5,0,5,25,2,12,4,7,1,11,11,0,1,0,0,0,1
S01006927,Occupancy rating -1 or less,3,0,0,0,3,0,2,0,2,0,1,0,1,0,0,0,0,0
S01006928,All households,416,95,29,66,298,32,226,87,106,33,40,30,10,23,6,0,0,17
S01006928,Occupancy rating +2 or more,250,41,16,25,202,26,161,68,74,19,15,12,3,7,2,0,0,5
S01006928,Occupancy rating +1,84,32,7,25,47,5,35,14,17,4,7,5,2,5,1,0,0,4
S01006928,Occupancy rating 0,56,16,4,12,36,1,22,4,11,7,13,9,4,4,0,0,0,4
S01006928,Occupancy rating -1 or less,26,6,2,4,13,0,8,1,4,3,5,4,1,7,3,0,0,4
S01006929,All households,280,28,12,16,239,14,207,80,96,31,18,10,8,13,6,0,0,7
S01006929,Occupancy rating +2 or more,260,26,12,14,223,14,193,79,84,30,16,8,8,11,5,0,0,6
S01006929,Occupancy rating +1,15,2,0,2,12,0,11,1,9,1,1,1,0,1,1,0,0,0
S01006929,Occupancy rating 0,2,0,0,0,2,0,1,0,1,0,1,1,0,0,0,0,0,0
S01006929,Occupancy rating -1 or less,3,0,0,0,2,0,2,0,2,0,0,0,0,1,0,0,0,1
S01006930,All households,358,68,30,38,284,34,236,101,93,42,14,9,5,6,3,0,0,3
S01006930,Occupancy rating +2 or more,272,36,15,21,231,25,198,90,79,29,8,5,3,5,2,0,0,3
S01006930,Occupancy rating +1,72,29,13,16,43,8,32,11,12,9,3,3,0,0,0,0,0,0
S01006930,Occupancy rating 0,12,3,2,1,8,1,5,0,2,3,2,1,1,1,1,0,0,0
S01006930,Occupancy rating -1 or less,2,0,0,0,2,0,1,0,0,1,1,0,1,0,0,0,0,0
S01006931,All households,159,39,17,22,115,12,92,40,41,11,11,6,5,5,2,0,0,3
S01006931,Occupancy rating +2 or more,105,18,8,10,83,7,72,33,29,10,4,3,1,4,2,0,0,2
S01006931,Occupancy rating +1,39,17,6,11,21,5,13,7,5,1,3,2,1,1,0,0,0,1
S01006931,Occupancy rating 0,12,4,3,1,8,0,5,0,5,0,3,1,2,0,0,0,0,0
S01006931,Occupancy rating -1 or less,3,0,0,0,3,0,2,0,2,0,1,0,1,0,0,0,0,0
S01006932,All households,195,13,2,11,179,3,150,32,100,18,26,22,4,3,2,0,0,1
S01006932,Occupancy rating +2 or more,139,6,0,6,132,3,120,27,75,18,9,6,3,1,0,0,0,1
S01006932,Occupancy rating +1,26,6,1,5,20,0,16,5,11,0,4,4,0,0,0,0,0,0
S01006932,Occupancy rating 0,25,1,1,0,24,0,12,0,12,0,12,11,1,0,0,0,0,0
S01006932,Occupancy rating -1 or less,5,0,0,0,3,0,2,0,2,0,1,1,0,2,2,0,0,0
S01006933,All households,220,33,7,26,182,8,161,60,73,28,13,10,3,5,0,0,0,5
S01006933,Occupancy rating +2 or more,130,21,7,14,108,8,96,52,32,12,4,4,0,1,0,0,0,1
S01006933,Occupancy rating +1,61,11,0,11,48,0,42,8,24,10,6,4,2,2,0,0,0,2
S01006933,Occupancy rating 0,23,1,0,1,21,0,19,0,14,5,2,1,1,1,0,0,0,1
S01006933,Occupancy rating -1 or less,6,0,0,0,5,0,4,0,3,1,1,1,0,1,0,0,0,1
S01006934,All households,234,59,28,31,168,19,135,62,58,15,14,6,8,7,4,0,0,3
S01006934,Occupancy rating +2 or more,145,26,10,16,116,11,102,51,43,8,3,2,1,3,1,0,0,2
S01006934,Occupancy rating +1,52,23,10,13,28,6,17,9,6,2,5,0,5,1,1,0,0,0
S01006934,Occupancy rating 0,30,9,8,1,20,2,14,1,8,5,4,3,1,1,0,0,0,1
S01006934,Occupancy rating -1 or less,7,1,0,1,4,0,2,1,1,0,2,1,1,2,2,0,0,0
S01006935,All households,301,81,48,33,212,32,166,75,57,34,14,3,11,8,4,0,0,4
S01006935,Occupancy rating +2 or more,182,25,16,9,155,27,123,63,36,24,5,1,4,2,0,0,0,2
S01006935,Occupancy rating +1,93,50,27,23,42,5,32,10,13,9,5,1,4,1,0,0,0,1
S01006935,Occupancy rating 0,22,5,4,1,14,0,11,2,8,1,3,1,2,3,2,0,0,1
S01006935,Occupancy rating -1 or less,4,1,1,0,1,0,0,0,0,0,1,0,1,2,2,0,0,0
S01006936,All households,274,79,37,42,192,29,137,57,57,23,26,16,10,3,3,0,0,0
S01006936,Occupancy rating +2 or more,163,42,21,21,120,23,88,37,38,13,9,6,3,1,1,0,0,0
S01006936,Occupancy rating +1,57,21,11,10,35,4,26,10,10,6,5,1,4,1,1,0,0,0
S01006936,Occupancy rating 0,49,16,5,11,32,1,21,10,7,4,10,7,3,1,1,0,0,0
S01006936,Occupancy rating -1 or less,5,0,0,0,5,1,2,0,2,0,2,2,0,0,0,0,0,0
S01006937,All households,316,86,35,51,215,25,163,73,64,26,27,17,10,15,3,2,0,10
S01006937,Occupancy rating +2 or more,154,39,21,18,110,21,83,42,28,13,6,4,2,5,1,0,0,4
S01006937,Occupancy rating +1,92,26,10,16,62,4,50,19,23,8,8,5,3,4,0,1,0,3
S01006937,Occupancy rating 0,62,21,4,17,38,0,25,10,10,5,13,8,5,3,1,1,0,1
S01006937,Occupancy rating -1 or less,8,0,0,0,5,0,5,2,3,0,0,0,0,3,1,0,0,2
S01006938,All households,254,91,53,38,158,26,119,53,45,21,13,9,4,5,3,0,0,2
S01006938,Occupancy rating +2 or more,88,23,8,15,64,11,52,26,18,8,1,0,1,1,1,0,0,0
S01006938,Occupancy rating +1,78,25,9,16,52,11,38,17,12,9,3,3,0,1,0,0,0,1
S01006938,Occupancy rating 0,70,33,26,7,35,4,25,10,12,3,6,5,1,2,1,0,0,1
S01006938,Occupancy rating -1 or less,18,10,10,0,7,0,4,0,3,1,3,1,2,1,1,0,0,0
S01006939,All households,234,36,19,17,194,25,157,58,68,31,12,5,7,4,1,0,0,3
S01006939,Occupancy rating +2 or more,177,31,18,13,144,23,115,52,45,18,6,2,4,2,1,0,0,1
S01006939,Occupancy rating +1,37,4,1,3,32,2,27,6,12,9,3,1,2,1,0,0,0,1
S01006939,Occupancy rating 0,15,1,0,1,13,0,11,0,7,4,2,1,1,1,0,0,0,1
S01006939,Occupancy rating -1 or less,5,0,0,0,5,0,4,0,4,0,1,1,0,0,0,0,0,0
S01006940,All households,378,81,23,58,284,30,221,98,85,38,33,19,14,13,4,3,0,6
S01006940,Occupancy rating +2 or more,236,34,14,20,197,25,161,76,63,22,11,6,5,5,2,0,0,3
S01006940,Occupancy rating +1,80,25,6,19,55,5,44,19,15,10,6,2,4,0,0,0,0,0
S01006940,Occupancy rating 0,50,22,3,19,24,0,12,3,4,5,12,8,4,4,1,2,0,1
S01006940,Occupancy rating -1 or less,12,0,0,0,8,0,4,0,3,1,4,3,1,4,1,1,0,2
S01006941,All households,255,68,28,40,181,20,142,55,79,8,19,14,5,6,3,0,1,2
S01006941,Occupancy rating +2 or more,136,28,12,16,106,16,84,42,38,4,6,3,3,2,1,0,0,1
S01006941,Occupancy rating +1,72,22,12,10,48,4,40,10,28,2,4,3,1,2,0,0,1,1
S01006941,Occupancy rating 0,39,15,4,11,22,0,17,3,12,2,5,4,1,2,2,0,0,0
S01006941,Occupancy rating -1 or less,8,3,0,3,5,0,1,0,1,0,4,4,0,0,0,0,0,0
S01006942,All households,390,67,35,32,315,30,265,70,150,45,20,11,9,8,4,1,0,3
S01006942,Occupancy rating +2 or more,247,29,18,11,215,22,183,64,88,31,10,6,4,3,1,0,0,2
S01006942,Occupancy rating +1,85,22,12,10,61,5,50,5,37,8,6,2,4,2,2,0,0,0
S01006942,Occupancy rating 0,52,14,4,10,35,3,28,0,22,6,4,3,1,3,1,1,0,1
S01006942,Occupancy rating -1 or less,6,2,1,1,4,0,4,1,3,0,0,0,0,0,0,0,0,0
S01006943,All households,208,17,4,13,187,2,178,32,134,12,7,6,1,4,3,0,0,1
S01006943,Occupancy rating +2 or more,191,17,4,13,172,1,165,29,124,12,6,5,1,2,1,0,0,1
S01006943,Occupancy rating +1,10,0,0,0,9,1,7,2,5,0,1,1,0,1,1,0,0,0
S01006943,Occupancy rating 0,5,0,0,0,5,0,5,1,4,0,0,0,0,0,0,0,0,0
S01006943,Occupancy rating -1 or less,2,0,0,0,1,0,1,0,1,0,0,0,0,1,1,0,0,0
S01006944,All households,327,54,4,50,266,4,226,79,137,10,36,28,8,7,2,2,0,3
S01006944,Occupancy rating +2 or more,184,22,2,20,162,2,151,47,96,8,9,8,1,0,0,0,0,0
S01006944,Occupancy rating +1,73,27,1,26,46,1,42,31,11,0,3,2,1,0,0,0,0,0
S01006944,Occupancy rating 0,58,3,0,3,51,0,30,1,27,2,21,16,5,4,0,2,0,2
S01006944,Occupancy rating -1 or less,12,2,1,1,7,1,3,0,3,0,3,2,1,3,2,0,0,1
S01006945,All households,215,49,16,33,164,16,138,70,49,19,10,6,4,2,0,0,0,2
S01006945,Occupancy rating +2 or more,133,11,7,4,120,12,104,59,36,9,4,2,2,2,0,0,0,2
S01006945,Occupancy rating +1,39,17,8,9,22,1,19,8,6,5,2,2,0,0,0,0,0,0
S01006945,Occupancy rating 0,39,21,1,20,18,2,14,3,6,5,2,1,1,0,0,0,0,0
S01006945,Occupancy rating -1 or less,4,0,0,0,4,1,1,0,1,0,2,1,1,0,0,0,0,0
S01006946,All households,314,61,15,46,234,23,195,92,84,19,16,4,12,19,13,0,1,5
S01006946,Occupancy rating +2 or more,192,36,9,27,149,20,125,66,47,12,4,2,2,7,5,0,0,2
S01006946,Occupancy rating +1,73,14,4,10,55,3,47,20,22,5,5,1,4,4,3,0,0,1
S01006946,Occupancy rating 0,35,9,0,9,22,0,17,5,11,1,5,1,4,4,3,0,1,0
S01006946,Occupancy rating -1 or less,14,2,2,0,8,0,6,1,4,1,2,0,2,4,2,0,0,2
S01006947,All households,306,49,12,37,245,4,215,70,127,18,26,20,6,12,6,0,0,6
S01006947,Occupancy rating +2 or more,201,27,6,21,167,4,156,52,95,9,7,6,1,7,3,0,0,4
S01006947,Occupancy rating +1,52,14,1,13,35,0,31,13,14,4,4,3,1,3,2,0,0,1
S01006947,Occupancy rating 0,38,6,5,1,30,0,19,5,11,3,11,9,2,2,1,0,0,1
S01006947,Occupancy rating -1 or less,15,2,0,2,13,0,9,0,7,2,4,2,2,0,0,0,0,0
S01006948,All households,372,94,61,33,268,38,209,96,78,35,21,11,10,10,3,0,1,6
S01006948,Occupancy rating +2 or more,245,42,20,22,197,32,154,76,50,28,11,6,5,6,3,0,1,2
S01006948,Occupancy rating +1,57,15,9,6,40,3,35,15,15,5,2,1,1,2,0,0,0,2
S01006948,Occupancy rating 0,58,33,29,4,23,3,13,3,9,1,7,3,4,2,0,0,0,2
S01006948,Occupancy rating -1 or less,12,4,3,1,8,0,7,2,4,1,1,1,0,0,0,0,0,0
S01006949,All households,248,40,10,30,198,19,170,67,86,17,9,8,1,10,3,0,0,7
S01006949,Occupancy rating +2 or more,209,33,10,23,170,18,147,61,71,15,5,4,1,6,3,0,0,3
S01006949,Occupancy rating +1,26,6,0,6,18,1,16,4,12,0,1,1,0,2,0,0,0,2
S01006949,Occupancy rating 0,10,1,0,1,7,0,4,2,0,2,3,3,0,2,0,0,0,2
S01006949,Occupancy rating -1 or less,3,0,0,0,3,0,3,0,3,0,0,0,0,0,0,0,0,0
S01006950,All households,199,23,2,21,169,2,154,58,95,1,13,10,3,7,4,0,0,3
S01006950,Occupancy rating +2 or more,103,6,1,5,94,0,93,38,54,1,1,1,0,3,2,0,0,1
S01006950,Occupancy rating +1,34,7,0,7,26,1,23,10,13,0,2,2,0,1,1,0,0,0
S01006950,Occupancy rating 0,56,8,1,7,45,1,35,10,25,0,9,6,3,3,1,0,0,2
S01006950,Occupancy rating -1 or less,6,2,0,2,4,0,3,0,3,0,1,1,0,0,0,0,0,0
S01006951,All households,204,60,27,33,142,11,116,56,44,16,15,6,9,2,2,0,0,0
S01006951,Occupancy rating +2 or more,117,26,10,16,91,4,79,45,26,8,8,4,4,0,0,0,0,0
S01006951,Occupancy rating +1,47,16,8,8,29,6,19,6,8,5,4,2,2,2,2,0,0,0
S01006951,Occupancy rating 0,34,15,8,7,19,1,16,5,8,3,2,0,2,0,0,0,0,0
S01006951,Occupancy rating -1 or less,6,3,1,2,3,0,2,0,2,0,1,0,1,0,0,0,0,0
S01006952,All households,364,106,45,61,246,34,195,90,66,39,17,7,10,12,5,0,1,6
S01006952,Occupancy rating +2 or more,256,69,33,36,184,30,146,81,43,22,8,2,6,3,2,0,0,1
S01006952,Occupancy rating +1,66,26,12,14,34,3,30,7,12,11,1,1,0,6,2,0,1,3
S01006952,Occupancy rating 0,25,5,0,5,18,1,10,1,6,3,7,3,4,2,0,0,0,2
S01006952,Occupancy rating -1 or less,17,6,0,6,10,0,9,1,5,3,1,1,0,1,1,0,0,0
S01006953,All households,301,51,18,33,245,18,214,87,95,32,13,9,4,5,3,0,0,2
S01006953,Occupancy rating +2 or more,236,34,14,20,200,16,174,79,74,21,10,7,3,2,1,0,0,1
S01006953,Occupancy rating +1,37,10,3,7,26,1,24,6,13,5,1,0,1,1,0,0,0,1
S01006953,Occupancy rating 0,23,7,1,6,15,0,14,2,6,6,1,1,0,1,1,0,0,0
S01006953,Occupancy rating -1 or less,5,0,0,0,4,1,2,0,2,0,1,1,0,1,1,0,0,0
S01006954,All households,317,45,18,27,263,28,221,92,97,32,14,6,8,9,6,0,1,2
S01006954,Occupancy rating +2 or more,208,27,12,15,177,24,146,81,48,17,7,3,4,4,2,0,0,2
S01006954,Occupancy rating +1,71,16,6,10,54,3,47,11,27,9,4,2,2,1,1,0,0,0
S01006954,Occupancy rating 0,30,1,0,1,29,1,25,0,21,4,3,1,2,0,0,0,0,0
S01006954,Occupancy rating -1 or less,8,1,0,1,3,0,3,0,1,2,0,0,0,4,3,0,1,0
S01006955,All households,267,85,41,44,177,9,141,61,62,18,27,19,8,5,3,0,0,2
S01006955,Occupancy rating +2 or more,70,10,4,6,60,4,54,27,19,8,2,0,2,0,0,0,0,0
S01006955,Occupancy rating +1,75,23,7,16,50,3,44,22,18,4,3,2,1,2,2,0,0,0
S01006955,Occupancy rating 0,96,46,24,22,48,2,31,10,17,4,15,12,3,2,0,0,0,2
S01006955,Occupancy rating -1 or less,26,6,6,0,19,0,12,2,8,2,7,5,2,1,1,0,0,0
S01006956,All households,394,47,10,37,336,13,286,102,160,24,37,20,17,11,5,0,0,6
S01006956,Occupancy rating +2 or more,244,24,2,22,216,11,194,76,99,19,11,4,7,4,2,0,0,2
S01006956,Occupancy rating +1,85,16,6,10,68,2,51,23,24,4,15,9,6,1,0,0,0,1
S01006956,Occupancy rating 0,53,7,2,5,42,0,31,2,28,1,11,7,4,4,1,0,0,3
S01006956,Occupancy rating -1 or less,12,0,0,0,10,0,10,1,9,0,0,0,0,2,2,0,0,0
S01006957,All households,387,66,25,41,307,17,273,111,135,27,17,11,6,14,8,0,0,6
S01006957,Occupancy rating +2 or more,298,48,17,31,236,14,214,88,102,24,8,6,2,14,8,0,0,6
S01006957,Occupancy rating +1,61,15,7,8,46,2,40,19,18,3,4,2,2,0,0,0,0,0
S01006957,Occupancy rating 0,22,3,1,2,19,1,14,2,12,0,4,2,2,0,0,0,0,0
S01006957,Occupancy rating -1 or less,6,0,0,0,6,0,5,2,3,0,1,1,0,0,0,0,0,0
S01006958,All households,435,147,83,64,281,72,196,109,61,26,13,5,8,7,3,0,0,4
S01006958,Occupancy rating +2 or more,262,66,39,27,194,49,140,88,34,18,5,3,2,2,1,0,0,1
S01006958,Occupancy rating +1,115,53,31,22,59,18,36,19,12,5,5,0,5,3,1,0,0,2
S01006958,Occupancy rating 0,51,25,11,14,24,5,16,2,13,1,3,2,1,2,1,0,0,1
S01006958,Occupancy rating -1 or less,7,3,2,1,4,0,4,0,2,2,0,0,0,0,0,0,0,0
S01006959,All households,347,150,80,70,187,36,115,45,51,19,36,17,19,10,4,0,1,5
S01006959,Occupancy rating +2 or more,101,27,10,17,72,16,51,16,23,12,5,1,4,2,2,0,0,0
S01006959,Occupancy rating +1,91,45,20,25,44,9,32,21,10,1,3,0,3,2,0,0,0,2
S01006959,Occupancy rating 0,111,49,29,20,58,8,29,6,17,6,21,11,10,4,1,0,1,2
S01006959,Occupancy rating -1 or less,44,29,21,8,13,3,3,2,1,0,7,5,2,2,1,0,0,1
S01006960,All households,318,33,6,27,279,7,242,54,170,18,30,20,10,6,3,0,0,3
S01006960,Occupancy rating +2 or more,260,18,3,15,237,7,221,51,156,14,9,8,1,5,2,0,0,3
S01006960,Occupancy rating +1,24,4,1,3,19,0,13,2,8,3,6,3,3,1,1,0,0,0
S01006960,Occupancy rating 0,27,10,2,8,17,0,6,1,4,1,11,7,4,0,0,0,0,0
S01006960,Occupancy rating -1 or less,7,1,0,1,6,0,2,0,2,0,4,2,2,0,0,0,0,0
S01006961,All households,321,29,2,27,283,7,261,68,178,15,15,12,3,9,5,0,0,4
S01006961,Occupancy rating +2 or more,259,25,1,24,227,7,213,65,134,14,7,6,1,7,4,0,0,3
S01006961,Occupancy rating +1,50,4,1,3,45,0,38,3,34,1,7,5,2,1,1,0,0,0
S01006961,Occupancy rating 0,8,0,0,0,7,0,7,0,7,0,0,0,0,1,0,0,0,1
S01006961,Occupancy rating -1 or less,4,0,0,0,4,0,3,0,3,0,1,1,0,0,0,0,0,0
S01006962,All households,409,121,68,53,277,64,203,115,59,29,10,6,4,11,4,0,0,7
S01006962,Occupancy rating +2 or more,179,38,24,14,136,42,94,60,23,11,0,0,0,5,2,0,0,3
S01006962,Occupancy rating +1,140,49,34,15,88,21,63,34,21,8,4,1,3,3,1,0,0,2
S01006962,Occupancy rating 0,78,33,9,24,43,1,37,21,8,8,5,4,1,2,0,0,0,2
S01006962,Occupancy rating -1 or less,12,1,1,0,10,0,9,0,7,2,1,1,0,1,1,0,0,0
S01006963,All households,275,63,25,38,209,22,163,74,56,33,24,14,10,3,2,0,0,1
S01006963,Occupancy rating +2 or more,174,35,18,17,137,19,106,61,25,20,12,6,6,2,2,0,0,0
S01006963,Occupancy rating +1,71,24,6,18,46,3,40,11,19,10,3,1,2,1,0,0,0,1
S01006963,Occupancy rating 0,27,4,1,3,23,0,15,2,11,2,8,6,2,0,0,0,0,0
S01006963,Occupancy rating -1 or less,3,0,0,0,3,0,2,0,1,1,1,1,0,0,0,0,0,0
S01006964,All households,348,119,27,92,217,14,177,83,66,28,26,16,10,12,3,0,0,9
S01006964,Occupancy rating +2 or more,110,25,10,15,84,9,72,33,26,13,3,1,2,1,1,0,0,0
S01006964,Occupancy rating +1,142,72,10,62,70,3,65,44,14,7,2,2,0,0,0,0,0,0
S01006964,Occupancy rating 0,76,18,6,12,49,2,33,5,21,7,14,10,4,9,1,0,0,8
S01006964,Occupancy rating -1 or less,20,4,1,3,14,0,7,1,5,1,7,3,4,2,1,0,0,1
S01006965,All households,216,61,23,38,149,23,111,47,40,24,15,8,7,6,2,0,0,4
S01006965,Occupancy rating +2 or more,115,25,12,13,88,18,67,35,18,14,3,2,1,2,1,0,0,1
S01006965,Occupancy rating +1,38,12,5,7,25,3,18,6,8,4,4,3,1,1,1,0,0,0
S01006965,Occupancy rating 0,51,21,5,16,28,1,22,6,11,5,5,2,3,2,0,0,0,2
S01006965,Occupancy rating -1 or less,12,3,1,2,8,1,4,0,3,1,3,1,2,1,0,0,0,1
S01006966,All households,253,70,42,28,171,21,106,47,43,16,44,29,15,12,5,0,0,7
S01006966,Occupancy rating +2 or more,99,24,11,13,72,15,51,34,11,6,6,2,4,3,1,0,0,2
S01006966,Occupancy rating +1,58,7,4,3,45,1,35,10,20,5,9,5,4,6,2,0,0,4
S01006966,Occupancy rating 0,84,37,26,11,44,5,18,3,10,5,21,15,6,3,2,0,0,1
S01006966,Occupancy rating -1 or less,12,2,1,1,10,0,2,0,2,0,8,7,1,0,0,0,0,0
S01006967,All households,237,35,14,21,193,18,161,66,71,24,14,8,6,9,5,0,1,3
S01006967,Occupancy rating +2 or more,154,22,11,11,129,14,107,54,36,17,8,4,4,3,2,0,1,0
S01006967,Occupancy rating +1,47,10,1,9,34,2,28,11,14,3,4,2,2,3,1,0,0,2
S01006967,Occupancy rating 0,27,3,2,1,23,2,19,1,14,4,2,2,0,1,1,0,0,0
S01006967,Occupancy rating -1 or less,9,0,0,0,7,0,7,0,7,0,0,0,0,2,1,0,0,1
S01006968,All households,224,59,30,29,158,16,129,62,44,23,13,11,2,7,2,0,2,3
S01006968,Occupancy rating +2 or more,80,21,11,10,58,8,49,33,11,5,1,1,0,1,0,0,0,1
S01006968,Occupancy rating +1,80,21,9,12,57,5,44,22,13,9,8,7,1,2,1,0,1,0
S01006968,Occupancy rating 0,53,15,8,7,36,3,30,7,17,6,3,3,0,2,0,0,0,2
S01006968,Occupancy rating -1 or less,11,2,2,0,7,0,6,0,3,3,1,0,1,2,1,0,1,0
S01006969,All households,412,140,60,80,259,52,191,86,68,37,16,8,8,13,6,0,0,7
S01006969,Occupancy rating +2 or more,154,31,14,17,121,25,93,52,30,11,3,1,2,2,2,0,0,0
S01006969,Occupancy rating +1,108,42,18,24,64,15,46,20,10,16,3,1,2,2,1,0,0,1
S01006969,Occupancy rating 0,131,60,25,35,66,11,46,13,23,10,9,5,4,5,2,0,0,3
S01006969,Occupancy rating -1 or less,19,7,3,4,8,1,6,1,5,0,1,1,0,4,1,0,0,3
S01006970,All households,258,32,16,16,220,24,184,69,83,32,12,10,2,6,2,0,0,4
S01006970,Occupancy rating +2 or more,203,28,15,13,170,23,144,60,57,27,3,2,1,5,2,0,0,3
S01006970,Occupancy rating +1,29,3,1,2,26,1,24,7,14,3,1,1,0,0,0,0,0,0
S01006970,Occupancy rating 0,22,1,0,1,20,0,14,1,12,1,6,6,0,1,0,0,0,1
S01006970,Occupancy rating -1 or less,4,0,0,0,4,0,2,1,0,1,2,1,1,0,0,0,0,0
S01006971,All households,248,95,56,39,147,27,91,36,35,20,29,12,17,6,2,0,0,4
S01006971,Occupancy rating +2 or more,84,25,12,13,59,16,40,24,9,7,3,0,3,0,0,0,0,0
S01006971,Occupancy rating +1,71,31,14,17,40,8,24,9,8,7,8,0,8,0,0,0,0,0
S01006971,Occupancy rating 0,80,38,29,9,39,1,21,2,13,6,17,11,6,3,0,0,0,3
S01006971,Occupancy rating -1 or less,13,1,1,0,9,2,6,1,5,0,1,1,0,3,2,0,0,1
S01006972,All households,192,34,14,20,150,8,132,55,57,20,10,5,5,8,2,0,0,6
S01006972,Occupancy rating +2 or more,143,26,11,15,114,7,101,49,40,12,6,3,3,3,2,0,0,1
S01006972,Occupancy rating +1,35,6,2,4,24,1,21,5,9,7,2,0,2,5,0,0,0,5
S01006972,Occupancy rating 0,8,2,1,1,6,0,6,0,6,0,0,0,0,0,0,0,0,0
S01006972,Occupancy rating -1 or less,6,0,0,0,6,0,4,1,2,1,2,2,0,0,0,0,0,0
S01006973,All households,234,58,29,29,171,21,135,65,42,28,15,10,5,5,0,0,0,5
S01006973,Occupancy rating +2 or more,152,32,18,14,119,16,97,47,30,20,6,5,1,1,0,0,0,1
S01006973,Occupancy rating +1,48,10,5,5,36,5,25,14,5,6,6,2,4,2,0,0,0,2
S01006973,Occupancy rating 0,29,13,6,7,14,0,11,4,5,2,3,3,0,2,0,0,0,2
S01006973,Occupancy rating -1 or less,5,3,0,3,2,0,2,0,2,0,0,0,0,0,0,0,0,0
S01006974,All households,393,68,30,38,314,28,257,101,124,32,29,20,9,11,1,0,0,10
S01006974,Occupancy rating +2 or more,271,43,17,26,223,22,189,85,82,22,12,9,3,5,1,0,0,4
S01006974,Occupancy rating +1,80,18,11,7,59,4,48,15,27,6,7,3,4,3,0,0,0,3
S01006974,Occupancy rating 0,34,7,2,5,25,2,14,1,13,0,9,7,2,2,0,0,0,2
S01006974,Occupancy rating -1 or less,8,0,0,0,7,0,6,0,2,4,1,1,0,1,0,0,0,1
S01006975,All households,386,81,25,56,285,16,256,135,95,26,13,6,7,20,5,0,3,12
S01006975,Occupancy rating +2 or more,268,46,15,31,212,13,195,110,67,18,4,1,3,10,2,0,2,6
S01006975,Occupancy rating +1,68,23,6,17,41,3,34,15,17,2,4,1,3,4,1,0,1,2
S01006975,Occupancy rating 0,42,11,4,7,27,0,23,10,8,5,4,4,0,4,1,0,0,3
S01006975,Occupancy rating -1 or less,8,1,0,1,5,0,4,0,3,1,1,0,1,2,1,0,0,1
S01006976,All households,172,21,5,16,139,14,116,56,35,25,9,6,3,12,6,0,0,6
S01006976,Occupancy rating +2 or more,132,16,4,12,108,12,91,50,28,13,5,3,2,8,3,0,0,5
S01006976,Occupancy rating +1,21,4,1,3,16,2,13,6,4,3,1,1,0,1,1,0,0,0
S01006976,Occupancy rating 0,11,0,0,0,9,0,6,0,1,5,3,2,1,2,1,0,0,1
S01006976,Occupancy rating -1 or less,8,1,0,1,6,0,6,0,2,4,0,0,0,1,1,0,0,0
S01006977,All households,316,54,13,41,245,23,201,87,82,32,21,15,6,17,4,0,2,11
S01006977,Occupancy rating +2 or more,218,32,7,25,180,21,148,69,60,19,11,7,4,6,1,0,0,5
S01006977,Occupancy rating +1,65,16,4,12,44,1,39,16,14,9,4,2,2,5,2,0,0,3
S01006977,Occupancy rating 0,23,4,1,3,14,1,7,1,3,3,6,6,0,5,0,0,2,3
S01006977,Occupancy rating -1 or less,10,2,1,1,7,0,7,1,5,1,0,0,0,1,1,0,0,0
S01006978,All households,371,101,44,57,261,30,213,101,79,33,18,10,8,9,5,0,0,4
S01006978,Occupancy rating +2 or more,248,64,32,32,183,17,161,84,51,26,5,2,3,1,0,0,0,1
S01006978,Occupancy rating +1,63,19,8,11,42,12,27,15,8,4,3,1,2,2,0,0,0,2
S01006978,Occupancy rating 0,46,16,4,12,27,1,17,2,12,3,9,6,3,3,2,0,0,1
S01006978,Occupancy rating -1 or less,14,2,0,2,9,0,8,0,8,0,1,1,0,3,3,0,0,0
S01006979,All households,369,105,61,44,252,37,195,92,75,28,20,17,3,12,5,0,0,7
S01006979,Occupancy rating +2 or more,205,37,14,23,163,23,136,73,47,16,4,3,1,5,3,0,0,2
S01006979,Occupancy rating +1,75,28,17,11,45,8,34,14,14,6,3,3,0,2,0,0,0,2
S01006979,Occupancy rating 0,75,35,27,8,38,5,20,5,11,4,13,11,2,2,1,0,0,1
S01006979,Occupancy rating -1 or less,14,5,3,2,6,1,5,0,3,2,0,0,0,3,1,0,0,2
S01006980,All households,326,53,20,33,264,31,212,92,87,33,21,9,12,9,5,0,0,4
S01006980,Occupancy rating +2 or more,230,33,12,21,192,27,159,84,51,24,6,3,3,5,3,0,0,2
S01006980,Occupancy rating +1,58,14,7,7,42,4,28,5,18,5,10,5,5,2,1,0,0,1
S01006980,Occupancy rating 0,28,5,1,4,21,0,18,2,14,2,3,1,2,2,1,0,0,1
S01006980,Occupancy rating -1 or less,10,1,0,1,9,0,7,1,4,2,2,0,2,0,0,0,0,0
S01006981,All households,321,69,22,47,239,17,205,93,86,26,17,10,7,13,6,0,1,6
S01006981,Occupancy rating +2 or more,207,39,17,22,165,13,148,78,56,14,4,0,4,3,2,0,0,1
S01006981,Occupancy rating +1,59,10,0,10,42,1,35,8,19,8,6,4,2,7,3,0,1,3
S01006981,Occupancy rating 0,43,13,4,9,27,3,18,6,9,3,6,5,1,3,1,0,0,2
S01006981,Occupancy rating -1 or less,12,7,1,6,5,0,4,1,2,1,1,1,0,0,0,0,0,0
S01006982,All households,359,84,30,54,267,23,207,80,111,16,37,25,12,8,4,0,0,4
S01006982,Occupancy rating +2 or more,193,33,9,24,156,18,131,58,65,8,7,4,3,4,2,0,0,2
S01006982,Occupancy rating +1,89,23,6,17,65,3,50,20,25,5,12,7,5,1,1,0,0,0
S01006982,Occupancy rating 0,60,25,14,11,34,1,19,2,15,2,14,11,3,1,1,0,0,0
S01006982,Occupancy rating -1 or less,17,3,1,2,12,1,7,0,6,1,4,3,1,2,0,0,0,2
S01006983,All households,289,58,20,38,220,18,179,78,80,21,23,16,7,11,4,0,0,7
S01006983,Occupancy rating +2 or more,186,47,15,32,137,12,113,65,40,8,12,9,3,2,1,0,0,1
S01006983,Occupancy rating +1,65,10,4,6,50,5,41,11,22,8,4,2,2,5,2,0,0,3
S01006983,Occupancy rating 0,34,0,0,0,30,0,23,2,16,5,7,5,2,4,1,0,0,3
S01006983,Occupancy rating -1 or less,4,1,1,0,3,1,2,0,2,0,0,0,0,0,0,0,0,0
S01006984,All households,275,54,18,36,206,18,170,80,74,16,18,12,6,15,6,0,1,8
S01006984,Occupancy rating +2 or more,200,30,11,19,163,15,139,71,58,10,9,6,3,7,2,0,1,4
S01006984,Occupancy rating +1,41,17,1,16,22,1,19,6,8,5,2,1,1,2,2,0,0,0
S01006984,Occupancy rating 0,25,6,6,0,16,2,10,3,6,1,4,2,2,3,1,0,0,2
S01006984,Occupancy rating -1 or less,9,1,0,1,5,0,2,0,2,0,3,3,0,3,1,0,0,2
S01006985,All households,432,127,67,60,297,45,229,95,96,38,23,15,8,8,4,0,0,4
S01006985,Occupancy rating +2 or more,229,59,28,31,166,28,130,61,51,18,8,4,4,4,2,0,0,2
S01006985,Occupancy rating +1,96,24,11,13,71,7,59,26,24,9,5,5,0,1,0,0,0,1
S01006985,Occupancy rating 0,89,40,25,15,46,9,28,5,15,8,9,6,3,3,2,0,0,1
S01006985,Occupancy rating -1 or less,18,4,3,1,14,1,12,3,6,3,1,0,1,0,0,0,0,0
S01006986,All households,243,47,18,29,186,6,159,58,87,14,21,16,5,10,3,0,1,6
S01006986,Occupancy rating +2 or more,157,26,8,18,128,3,116,48,58,10,9,6,3,3,2,0,0,1
S01006986,Occupancy rating +1,30,9,4,5,20,3,15,5,9,1,2,2,0,1,0,0,0,1
S01006986,Occupancy rating 0,44,4,2,2,36,0,26,5,19,2,10,8,2,4,1,0,1,2
S01006986,Occupancy rating -1 or less,12,8,4,4,2,0,2,0,1,1,0,0,0,2,0,0,0,2
S01006987,All households,294,92,49,43,195,30,146,58,56,32,19,12,7,7,3,0,0,4
S01006987,Occupancy rating +2 or more,150,28,12,16,119,21,93,44,30,19,5,3,2,3,0,0,0,3
S01006987,Occupancy rating +1,70,34,17,17,35,6,27,9,10,8,2,1,1,1,0,0,0,1
S01006987,Occupancy rating 0,58,23,14,9,34,1,24,5,14,5,9,7,2,1,1,0,0,0
S01006987,Occupancy rating -1 or less,16,7,6,1,7,2,2,0,2,0,3,1,2,2,2,0,0,0
S01006988,All households,218,32,9,23,175,10,147,53,80,14,18,15,3,11,7,0,0,4
S01006988,Occupancy rating +2 or more,149,22,7,15,123,7,110,47,53,10,6,4,2,4,2,0,0,2
S01006988,Occupancy rating +1,31,4,0,4,26,2,19,4,14,1,5,4,1,1,1,0,0,0
S01006988,Occupancy rating 0,29,5,2,3,21,1,14,2,10,2,6,6,0,3,2,0,0,1
S01006988,Occupancy rating -1 or less,9,1,0,1,5,0,4,0,3,1,1,1,0,3,2,0,0,1
S01006989,All households,375,60,12,48,308,28,257,91,123,43,23,9,14,7,5,1,0,1
S01006989,Occupancy rating +2 or more,307,43,8,35,260,26,219,87,101,31,15,6,9,4,2,1,0,1
S01006989,Occupancy rating +1,42,11,3,8,29,2,23,3,12,8,4,1,3,2,2,0,0,0
S01006989,Occupancy rating 0,20,6,1,5,13,0,11,1,6,4,2,1,1,1,1,0,0,0
S01006989,Occupancy rating -1 or less,6,0,0,0,6,0,4,0,4,0,2,1,1,0,0,0,0,0
S01006990,All households,313,36,8,28,268,9,241,90,132,19,18,15,3,9,4,0,0,5
S01006990,Occupancy rating +2 or more,254,26,5,21,223,8,205,79,110,16,10,7,3,5,1,0,0,4
S01006990,Occupancy rating +1,33,9,3,6,24,0,18,6,11,1,6,6,0,0,0,0,0,0
S01006990,Occupancy rating 0,20,0,0,0,17,1,14,5,9,0,2,2,0,3,2,0,0,1
S01006990,Occupancy rating -1 or less,6,1,0,1,4,0,4,0,2,2,0,0,0,1,1,0,0,0
S01006991,All households,216,88,50,38,119,18,84,40,30,14,17,10,7,9,5,0,0,4
S01006991,Occupancy rating +2 or more,87,25,14,11,60,9,46,28,13,5,5,4,1,2,2,0,0,0
S01006991,Occupancy rating +1,53,25,11,14,27,5,18,10,3,5,4,1,3,1,0,0,0,1
S01006991,Occupancy rating 0,66,36,24,12,26,4,14,2,9,3,8,5,3,4,2,0,0,2
S01006991,Occupancy rating -1 or less,10,2,1,1,6,0,6,0,5,1,0,0,0,2,1,0,0,1
S01006992,All households,241,45,14,31,187,20,160,75,66,19,7,2,5,9,6,0,0,3
S01006992,Occupancy rating +2 or more,190,32,12,20,155,16,136,67,57,12,3,1,2,3,2,0,0,1
S01006992,Occupancy rating +1,36,10,2,8,23,4,17,7,6,4,2,1,1,3,2,0,0,1
S01006992,Occupancy rating 0,9,1,0,1,7,0,5,1,3,1,2,0,2,1,1,0,0,0
S01006992,Occupancy rating -1 or less,6,2,0,2,2,0,2,0,0,2,0,0,0,2,1,0,0,1
S01006993,All households,202,33,8,25,157,15,130,62,49,19,12,7,5,12,8,0,0,4
S01006993,Occupancy rating +2 or more,147,27,8,19,113,14,97,55,30,12,2,2,0,7,4,0,0,3
S01006993,Occupancy rating +1,25,3,0,3,22,1,18,4,9,5,3,1,2,0,0,0,0,0
S01006993,Occupancy rating 0,22,1,0,1,18,0,12,3,7,2,6,4,2,3,2,0,0,1
S01006993,Occupancy rating -1 or less,8,2,0,2,4,0,3,0,3,0,1,0,1,2,2,0,0,0
S01006994,All households,226,40,12,28,176,15,146,65,49,32,15,9,6,10,1,0,3,6
S01006994,Occupancy rating +2 or more,183,33,10,23,144,13,125,60,42,23,6,3,3,6,1,0,1,4
S01006994,Occupancy rating +1,28,7,2,5,19,2,13,2,4,7,4,3,1,2,0,0,0,2
S01006994,Occupancy rating 0,11,0,0,0,9,0,5,3,1,1,4,3,1,2,0,0,2,0
S01006994,Occupancy rating -1 or less,4,0,0,0,4,0,3,0,2,1,1,0,1,0,0,0,0,0
S01006995,All households,331,53,10,43,266,38,205,87,94,24,23,17,6,12,6,0,0,6
S01006995,Occupancy rating +2 or more,249,43,10,33,199,35,152,69,68,15,12,8,4,7,1,0,0,6
S01006995,Occupancy rating +1,48,8,0,8,38,3,29,14,10,5,6,5,1,2,2,0,0,0
S01006995,Occupancy rating 0,27,2,0,2,24,0,21,4,14,3,3,2,1,1,1,0,0,0
S01006995,Occupancy rating -1 or less,7,0,0,0,5,0,3,0,2,1,2,2,0,2,2,0,0,0
S01006996,All households,306,73,36,37,226,25,179,59,99,21,22,16,6,7,3,0,0,4
S01006996,Occupancy rating +2 or more,168,28,12,16,137,20,113,37,69,7,4,2,2,3,2,0,0,1
S01006996,Occupancy rating +1,63,15,9,6,47,4,40,19,14,7,3,2,1,1,0,0,0,1
S01006996,Occupancy rating 0,61,30,15,15,28,1,17,3,10,4,10,7,3,3,1,0,0,2
S01006996,Occupancy rating -1 or less,14,0,0,0,14,0,9,0,6,3,5,5,0,0,0,0,0,0
S01006997,All households,292,54,17,37,232,16,200,80,104,16,16,7,9,6,4,0,0,2
S01006997,Occupancy rating +2 or more,222,33,9,24,187,10,169,70,86,13,8,3,5,2,2,0,0,0
S01006997,Occupancy rating +1,44,9,2,7,32,5,22,7,13,2,5,2,3,3,2,0,0,1
S01006997,Occupancy rating 0,22,12,6,6,9,1,6,3,2,1,2,1,1,1,0,0,0,1
S01006997,Occupancy rating -1 or less,4,0,0,0,4,0,3,0,3,0,1,1,0,0,0,0,0,0
S01006998,All households,450,95,40,55,341,34,283,134,115,34,24,18,6,14,4,0,2,8
S01006998,Occupancy rating +2 or more,307,57,23,34,238,27,200,110,68,22,11,7,4,12,3,0,2,7
S01006998,Occupancy rating +1,83,21,9,12,60,7,50,19,24,7,3,2,1,2,1,0,0,1
S01006998,Occupancy rating 0,54,15,7,8,39,0,30,5,20,5,9,9,0,0,0,0,0,0
S01006998,Occupancy rating -1 or less,6,2,1,1,4,0,3,0,3,0,1,0,1,0,0,0,0,0
S01006999,All households,334,63,18,45,258,29,215,101,77,37,14,8,6,13,6,0,2,5
S01006999,Occupancy rating +2 or more,241,45,13,32,187,24,157,84,52,21,6,2,4,9,4,0,1,4
S01006999,Occupancy rating +1,60,16,5,11,43,5,34,16,11,7,4,3,1,1,1,0,0,0
S01006999,Occupancy rating 0,26,1,0,1,22,0,19,0,11,8,3,2,1,3,1,0,1,1
S01006999,Occupancy rating -1 or less,7,1,0,1,6,0,5,1,3,1,1,1,0,0,0,0,0,0
S01007000,All households,414,127,73,54,275,39,211,98,88,25,25,15,10,12,4,0,1,7
S01007000,Occupancy rating +2 or more,232,43,24,19,185,31,144,74,58,12,10,5,5,4,1,0,1,2
S01007000,Occupancy rating +1,80,26,12,14,51,5,40,17,16,7,6,1,5,3,0,0,0,3
S01007000,Occupancy rating 0,88,52,31,21,33,3,22,6,11,5,8,8,0,3,1,0,0,2
S01007000,Occupancy rating -1 or less,14,6,6,0,6,0,5,1,3,1,1,1,0,2,2,0,0,0
S01007001,All households,388,100,47,53,279,49,192,82,89,21,38,23,15,9,2,0,0,7
S01007001,Occupancy rating +2 or more,245,54,29,25,186,39,134,58,63,13,13,5,8,5,1,0,0,4
S01007001,Occupancy rating +1,70,23,10,13,46,9,29,17,9,3,8,6,2,1,0,0,0,1
S01007001,Occupancy rating 0,63,22,8,14,40,1,25,6,14,5,14,9,5,1,0,0,0,1
S01007001,Occupancy rating -1 or less,10,1,0,1,7,0,4,1,3,0,3,3,0,2,1,0,0,1
S01007002,All households,230,46,19,27,176,16,142,52,72,18,18,12,6,8,3,0,0,5
S01007002,Occupancy rating +2 or more,130,31,18,13,98,12,85,43,30,12,1,1,0,1,0,0,0,1
S01007002,Occupancy rating +1,56,7,0,7,47,3,38,7,27,4,6,4,2,2,0,0,0,2
S01007002,Occupancy rating 0,36,8,1,7,26,1,15,2,11,2,10,6,4,2,0,0,0,2
S01007002,Occupancy rating -1 or less,8,0,0,0,5,0,4,0,4,0,1,1,0,3,3,0,0,0
S01007003,All households,205,35,15,20,160,22,125,55,53,17,13,6,7,10,4,0,1,5
S01007003,Occupancy rating +2 or more,145,25,10,15,114,18,90,45,35,10,6,3,3,6,3,0,0,3
S01007003,Occupancy rating +1,35,8,4,4,25,2,19,5,11,3,4,1,3,2,1,0,0,1
S01007003,Occupancy rating 0,17,2,1,1,13,2,9,2,4,3,2,2,0,2,0,0,1,1
S01007003,Occupancy rating -1 or less,8,0,0,0,8,0,7,3,3,1,1,0,1,0,0,0,0,0
S01007004,All households,304,84,27,57,211,24,176,89,66,21,11,9,2,9,6,0,0,3
S01007004,Occupancy rating +2 or more,222,59,19,40,160,22,133,78,40,15,5,4,1,3,2,0,0,1
S01007004,Occupancy rating +1,51,19,5,14,29,1,25,8,15,2,3,3,0,3,3,0,0,0
S01007004,Occupancy rating 0,25,6,3,3,18,1,15,2,10,3,2,1,1,1,0,0,0,1
S01007004,Occupancy rating -1 or less,6,0,0,0,4,0,3,1,1,1,1,1,0,2,1,0,0,1
S01007005,All households,348,52,23,29,285,33,237,111,87,39,15,12,3,11,5,0,0,6
S01007005,Occupancy rating +2 or more,278,41,17,24,231,29,197,103,64,30,5,5,0,6,2,0,0,4
S01007005,Occupancy rating +1,44,8,4,4,31,4,24,7,11,6,3,2,1,5,3,0,0,2
S01007005,Occupancy rating 0,23,3,2,1,20,0,14,1,12,1,6,4,2,0,0,0,0,0
S01007005,Occupancy rating -1 or less,3,0,0,0,3,0,2,0,0,2,1,1,0,0,0,0,0,0
S01007006,All households,394,114,51,63,267,35,210,102,83,25,22,14,8,13,5,0,0,8
S01007006,Occupancy rating +2 or more,229,58,24,34,164,26,129,82,35,12,9,5,4,7,3,0,0,4
S01007006,Occupancy rating +1,89,29,16,13,58,8,42,15,22,5,8,5,3,2,2,0,0,0
S01007006,Occupancy rating 0,57,23,10,13,34,1,28,4,19,5,5,4,1,0,0,0,0,0
S01007006,Occupancy rating -1 or less,19,4,1,3,11,0,11,1,7,3,0,0,0,4,0,0,0,4
S01007007,All households,338,86,37,49,238,28,198,85,84,29,12,4,8,14,9,0,0,5
S01007007,Occupancy rating +2 or more,218,58,24,34,157,25,129,69,45,15,3,2,1,3,2,0,0,1
S01007007,Occupancy rating +1,65,16,8,8,45,2,36,12,16,8,7,2,5,4,2,0,0,2
S01007007,Occupancy rating 0,46,10,5,5,32,1,29,3,22,4,2,0,2,4,3,0,0,1
S01007007,Occupancy rating -1 or less,9,2,0,2,4,0,4,1,1,2,0,0,0,3,2,0,0,1
S01007008,All households,450,167,91,76,272,37,194,66,95,33,41,24,17,11,5,0,1,5
S01007008,Occupancy rating +2 or more,179,69,36,33,106,22,78,36,30,12,6,2,4,4,1,0,1,2
S01007008,Occupancy rating +1,129,44,23,21,84,8,68,27,30,11,8,3,5,1,0,0,0,1
S01007008,Occupancy rating 0,110,44,25,19,66,6,37,3,24,10,23,16,7,0,0,0,0,0
S01007008,Occupancy rating -1 or less,32,10,7,3,16,1,11,0,11,0,4,3,1,6,4,0,0,2
S01007009,All households,496,209,96,113,276,50,194,85,71,38,32,13,19,11,4,0,0,7
S01007009,Occupancy rating +2 or more,229,69,42,27,155,37,106,60,25,21,12,2,10,5,2,0,0,3
S01007009,Occupancy rating +1,111,46,20,26,63,10,46,15,20,11,7,2,5,2,1,0,0,1
S01007009,Occupancy rating 0,120,80,29,51,39,2,30,8,17,5,7,4,3,1,0,0,0,1
S01007009,Occupancy rating -1 or less,36,14,5,9,19,1,12,2,9,1,6,5,1,3,1,0,0,2
S01007010,All households,392,153,101,52,226,58,154,74,57,23,14,9,5,13,3,0,2,8
S01007010,Occupancy rating +2 or more,208,58,43,15,146,36,107,59,32,16,3,1,2,4,2,0,1,1
S01007010,Occupancy rating +1,65,21,13,8,42,15,23,10,10,3,4,3,1,2,0,0,0,2
S01007010,Occupancy rating 0,105,68,42,26,32,5,22,4,14,4,5,3,2,5,0,0,1,4
S01007010,Occupancy rating -1 or less,14,6,3,3,6,2,2,1,1,0,2,2,0,2,1,0,0,1
S01007011,All households,463,237,113,124,210,37,138,71,51,16,35,25,10,16,7,0,2,7
S01007011,Occupancy rating +2 or more,121,51,23,28,67,12,54,33,13,8,1,0,1,3,2,0,0,1
S01007011,Occupancy rating +1,125,57,17,40,66,13,46,23,17,6,7,4,3,2,0,0,0,2
S01007011,Occupancy rating 0,186,115,66,49,62,11,31,14,15,2,20,15,5,9,4,0,2,3
S01007011,Occupancy rating -1 or less,31,14,7,7,15,1,7,1,6,0,7,6,1,2,1,0,0,1
S01007012,All households,322,99,48,51,214,36,121,55,49,17,57,42,15,9,3,0,1,5
S01007012,Occupancy rating +2 or more,62,21,13,8,40,13,24,21,3,0,3,1,2,1,0,0,1,0
S01007012,Occupancy rating +1,115,44,19,25,70,16,46,30,9,7,8,4,4,1,0,0,0,1
S01007012,Occupancy rating 0,121,33,15,18,83,3,42,4,29,9,38,31,7,5,2,0,0,3
S01007012,Occupancy rating -1 or less,24,1,1,0,21,4,9,0,8,1,8,6,2,2,1,0,0,1
S01007013,All households,222,40,12,28,172,24,139,63,58,18,9,5,4,10,3,0,1,6
S01007013,Occupancy rating +2 or more,178,32,12,20,140,20,113,56,45,12,7,3,4,6,3,0,1,2
S01007013,Occupancy rating +1,30,7,0,7,22,4,17,7,6,4,1,1,0,1,0,0,0,1
S01007013,Occupancy rating 0,12,1,0,1,9,0,8,0,6,2,1,1,0,2,0,0,0,2
S01007013,Occupancy rating -1 or less,2,0,0,0,1,0,1,0,1,0,0,0,0,1,0,0,0,1
S01007014,All households,381,70,19,51,302,28,258,102,125,31,16,10,6,9,1,0,2,6
S01007014,Occupancy rating +2 or more,282,43,11,32,234,25,201,85,91,25,8,4,4,5,1,0,2,2
S01007014,Occupancy rating +1,77,23,6,17,50,3,42,16,22,4,5,3,2,4,0,0,0,4
S01007014,Occupancy rating 0,16,3,2,1,13,0,11,0,10,1,2,2,0,0,0,0,0,0
S01007014,Occupancy rating -1 or less,6,1,0,1,5,0,4,1,2,1,1,1,0,0,0,0,0,0
S01007015,All households,247,55,16,39,182,23,146,62,63,21,13,5,8,10,4,0,0,6
S01007015,Occupancy rating +2 or more,171,37,9,28,127,19,104,52,39,13,4,1,3,7,2,0,0,5
S01007015,Occupancy rating +1,47,18,7,11,27,4,20,9,6,5,3,1,2,2,2,0,0,0
S01007015,Occupancy rating 0,29,0,0,0,28,0,22,1,18,3,6,3,3,1,0,0,0,1
S01007015,Occupancy rating -1 or less,0,0,0,0,0,0,0,0,0,0,0,0,0,0,0,0,0,0
S01007016,All households,213,29,6,23,173,13,154,70,66,18,6,4,2,11,7,0,0,4
S01007016,Occupancy rating +2 or more,157,21,5,16,130,11,118,62,44,12,1,0,1,6,4,0,0,2
S01007016,Occupancy rating +1,37,6,1,5,29,2,25,8,13,4,2,2,0,2,1,0,0,1
S01007016,Occupancy rating 0,12,2,0,2,8,0,7,0,6,1,1,1,0,2,2,0,0,0
S01007016,Occupancy rating -1 or less,7,0,0,0,6,0,4,0,3,1,2,1,1,1,0,0,0,1
S01007017,All households,476,186,98,88,274,39,192,92,74,26,43,23,20,16,4,0,1,11
S01007017,Occupancy rating +2 or more,155,53,20,33,97,14,78,47,26,5,5,3,2,5,1,0,0,4
S01007017,Occupancy rating +1,130,42,17,25,83,12,62,32,21,9,9,5,4,5,1,0,1,3
S01007017,Occupancy rating 0,162,80,55,25,79,12,42,10,21,11,25,13,12,3,1,0,0,2
S01007017,Occupancy rating -1 or less,29,11,6,5,15,1,10,3,6,1,4,2,2,3,1,0,0,2
S01007018,All households,421,101,68,33,309,61,219,97,98,24,29,19,10,11,5,0,2,4
S01007018,Occupancy rating +2 or more,235,49,35,14,184,46,132,73,47,12,6,4,2,2,0,0,1,1
S01007018,Occupancy rating +1,100,38,29,9,61,14,44,19,21,4,3,1,2,1,1,0,0,0
S01007018,Occupancy rating 0,61,12,2,10,46,1,29,3,23,3,16,12,4,3,2,0,1,0
S01007018,Occupancy rating -1 or less,25,2,2,0,18,0,14,2,7,5,4,2,2,5,2,0,0,3
S01007019,All households,309,106,61,45,187,38,126,54,48,24,23,10,13,16,1,0,0,15
S01007019,Occupancy rating +2 or more,127,41,23,18,86,29,56,34,12,10,1,0,1,0,0,0,0,0
S01007019,Occupancy rating +1,77,35,19,16,40,6,31,12,12,7,3,1,2,2,0,0,0,2
S01007019,Occupancy rating 0,80,28,17,11,46,1,31,7,19,5,14,8,6,6,0,0,0,6
S01007019,Occupancy rating -1 or less,25,2,2,0,15,2,8,1,5,2,5,1,4,8,1,0,0,7
S01007020,All households,411,194,96,98,196,38,135,68,55,12,23,10,13,21,6,0,4,11
S01007020,Occupancy rating +2 or more,148,41,21,20,103,27,71,44,22,5,5,2,3,4,0,0,0,4
S01007020,Occupancy rating +1,112,60,22,38,46,7,35,16,13,6,4,2,2,6,0,0,3,3
S01007020,Occupancy rating 0,121,81,49,32,34,4,19,5,13,1,11,4,7,6,2,0,1,3
S01007020,Occupancy rating -1 or less,30,12,4,8,13,0,10,3,7,0,3,2,1,5,4,0,0,1
S01007021,All households,403,137,86,51,255,48,164,69,67,28,43,17,26,11,5,0,0,6
S01007021,Occupancy rating +2 or more,199,76,47,29,120,34,76,47,21,8,10,2,8,3,0,0,0,3
S01007021,Occupancy rating +1,121,37,17,20,83,14,53,15,24,14,16,7,9,1,0,0,0,1
S01007021,Occupancy rating 0,63,14,12,2,44,0,30,6,20,4,14,7,7,5,3,0,0,2
S01007021,Occupancy rating -1 or less,20,10,10,0,8,0,5,1,2,2,3,1,2,2,2,0,0,0
S01007022,All households,209,54,37,17,146,23,105,40,53,12,18,13,5,9,2,0,0,7
S01007022,Occupancy rating +2 or more,106,21,17,4,83,14,66,28,30,8,3,3,0,2,0,0,0,2
S01007022,Occupancy rating +1,35,11,5,6,22,6,13,6,7,0,3,1,2,2,0,0,0,2
S01007022,Occupancy rating 0,60,22,15,7,34,3,20,6,11,3,11,8,3,4,1,0,0,3
S01007022,Occupancy rating -1 or less,8,0,0,0,7,0,6,0,5,1,1,1,0,1,1,0,0,0
S01007023,All households,203,51,25,26,142,19,108,52,43,13,15,6,9,10,5,0,2,3
S01007023,Occupancy rating +2 or more,131,29,13,16,96,13,80,45,28,7,3,0,3,6,3,0,1,2
S01007023,Occupancy rating +1,42,11,8,3,30,4,19,6,10,3,7,4,3,1,0,0,0,1
S01007023,Occupancy rating 0,22,8,3,5,11,0,6,0,4,2,5,2,3,3,2,0,1,0
S01007023,Occupancy rating -1 or less,8,3,1,2,5,2,3,1,1,1,0,0,0,0,0,0,0,0
S01007024,All households,416,89,43,46,298,48,221,122,80,19,29,11,18,29,14,0,2,13
S01007024,Occupancy rating +2 or more,282,58,27,31,205,37,160,98,52,10,8,3,5,19,10,0,0,9
S01007024,Occupancy rating +1,84,17,9,8,62,10,38,19,13,6,14,3,11,5,2,0,1,2
S01007024,Occupancy rating 0,38,13,6,7,23,1,18,4,11,3,4,2,2,2,0,0,1,1
S01007024,Occupancy rating -1 or less,12,1,1,0,8,0,5,1,4,0,3,3,0,3,2,0,0,1
S01007025,All households,389,140,81,59,236,36,165,71,71,23,35,15,20,13,7,0,1,5
S01007025,Occupancy rating +2 or more,151,53,31,22,96,13,75,50,18,7,8,2,6,2,1,0,0,1
S01007025,Occupancy rating +1,138,64,39,25,70,19,42,18,18,6,9,4,5,4,0,0,0,4
S01007025,Occupancy rating 0,84,23,11,12,58,4,39,3,28,8,15,8,7,3,2,0,1,0
S01007025,Occupancy rating -1 or less,16,0,0,0,12,0,9,0,7,2,3,1,2,4,4,0,0,0
S01007026,All households,412,157,96,61,242,52,163,73,65,25,27,14,13,13,4,0,1,8
S01007026,Occupancy rating +2 or more,240,72,41,31,163,40,112,59,37,16,11,3,8,5,1,0,0,4
S01007026,Occupancy rating +1,76,29,19,10,43,8,30,12,14,4,5,5,0,4,1,0,0,3
S01007026,Occupancy rating 0,82,48,30,18,32,4,17,2,11,4,11,6,5,2,1,0,1,0
S01007026,Occupancy rating -1 or less,14,8,6,2,4,0,4,0,3,1,0,0,0,2,1,0,0,1
S01007027,All households,481,157,88,69,312,52,224,97,91,36,36,23,13,12,7,0,1,4
S01007027,Occupancy rating +2 or more,256,64,36,28,190,38,146,78,50,18,6,3,3,2,1,0,0,1
S01007027,Occupancy rating +1,104,38,19,19,63,8,40,11,19,10,15,9,6,3,2,0,0,1
S01007027,Occupancy rating 0,94,46,27,19,45,5,28,6,16,6,12,9,3,3,2,0,1,0
S01007027,Occupancy rating -1 or less,27,9,6,3,14,1,10,2,6,2,3,2,1,4,2,0,0,2
S01007028,All households,315,86,30,56,206,37,152,76,56,20,17,12,5,23,6,0,2,15
S01007028,Occupancy rating +2 or more,221,56,22,34,152,31,115,64,37,14,6,4,2,13,2,0,0,11
S01007028,Occupancy rating +1,63,24,7,17,36,6,25,9,10,6,5,4,1,3,0,0,0,3
S01007028,Occupancy rating 0,21,5,1,4,12,0,8,2,6,0,4,3,1,4,2,0,2,0
S01007028,Occupancy rating -1 or less,10,1,0,1,6,0,4,1,3,0,2,1,1,3,2,0,0,1
S01007029,All households,221,48,33,15,157,28,119,60,44,15,10,4,6,16,11,0,0,5
S01007029,Occupancy rating +2 or more,164,37,27,10,119,23,91,53,30,8,5,1,4,8,4,0,0,4
S01007029,Occupancy rating +1,36,7,4,3,25,3,21,6,10,5,1,1,0,4,3,0,0,1
S01007029,Occupancy rating 0,14,2,1,1,11,2,6,1,3,2,3,1,2,1,1,0,0,0
S01007029,Occupancy rating -1 or less,7,2,1,1,2,0,1,0,1,0,1,1,0,3,3,0,0,0
S01007030,All households,338,84,47,37,244,36,184,74,83,27,24,13,11,10,3,0,2,5
S01007030,Occupancy rating +2 or more,162,38,22,16,121,28,88,53,27,8,5,2,3,3,0,0,1,2
S01007030,Occupancy rating +1,87,30,15,15,56,7,43,17,16,10,6,2,4,1,1,0,0,0
S01007030,Occupancy rating 0,77,16,10,6,55,1,42,2,31,9,12,8,4,6,2,0,1,3
S01007030,Occupancy rating -1 or less,12,0,0,0,12,0,11,2,9,0,1,1,0,0,0,0,0,0
S01007031,All households,285,105,49,56,167,21,128,57,58,13,18,9,9,13,7,0,0,6
S01007031,Occupancy rating +2 or more,136,28,18,10,103,17,81,43,28,10,5,2,3,5,4,0,0,1
S01007031,Occupancy rating +1,48,19,3,16,24,2,19,10,6,3,3,1,2,5,1,0,0,4
S01007031,Occupancy rating 0,88,52,26,26,35,2,24,4,20,0,9,5,4,1,0,0,0,1
S01007031,Occupancy rating -1 or less,13,6,2,4,5,0,4,0,4,0,1,1,0,2,2,0,0,0
S01007032,All households,507,256,109,147,236,38,174,76,81,17,24,18,6,15,5,0,1,9
S01007032,Occupancy rating +2 or more,197,81,35,46,113,23,88,49,28,11,2,0,2,3,1,0,0,2
S01007032,Occupancy rating +1,116,61,24,37,52,8,38,15,19,4,6,4,2,3,0,0,1,2
S01007032,Occupancy rating 0,165,103,44,59,57,7,38,12,24,2,12,11,1,5,2,0,0,3
S01007032,Occupancy rating -1 or less,29,11,6,5,14,0,10,0,10,0,4,3,1,4,2,0,0,2
S01007033,All households,338,111,52,59,220,31,147,65,64,18,42,22,20,7,4,0,0,3
S01007033,Occupancy rating +2 or more,140,49,20,29,88,22,60,40,13,7,6,3,3,3,2,0,0,1
S01007033,Occupancy rating +1,95,40,22,18,54,6,43,22,19,2,5,2,3,1,1,0,0,0
S01007033,Occupancy rating 0,90,22,10,12,66,3,35,2,26,7,28,14,14,2,1,0,0,1
S01007033,Occupancy rating -1 or less,13,0,0,0,12,0,9,1,6,2,3,3,0,1,0,0,0,1
S01007034,All households,266,89,37,52,168,18,123,50,54,19,27,21,6,9,1,0,1,7
S01007034,Occupancy rating +2 or more,135,51,22,29,80,9,68,31,24,13,3,2,1,4,0,0,0,4
S01007034,Occupancy rating +1,56,27,8,19,29,5,21,12,8,1,3,1,2,0,0,0,0,0
S01007034,Occupancy rating 0,58,9,6,3,47,2,28,6,18,4,17,15,2,2,1,0,1,0
S01007034,Occupancy rating -1 or less,17,2,1,1,12,2,6,1,4,1,4,3,1,3,0,0,0,3
S01007035,All households,375,143,77,66,218,28,146,57,66,23,44,34,10,14,4,0,1,9
S01007035,Occupancy rating +2 or more,103,41,23,18,60,14,44,30,10,4,2,2,0,2,0,0,1,1
S01007035,Occupancy rating +1,142,76,39,37,61,9,46,24,11,11,6,3,3,5,1,0,0,4
S01007035,Occupancy rating 0,103,23,12,11,75,5,41,3,31,7,29,24,5,5,2,0,0,3
S01007035,Occupancy rating -1 or less,27,3,3,0,22,0,15,0,14,1,7,5,2,2,1,0,0,1
S01007036,All households,401,125,66,59,264,51,187,77,86,24,26,16,10,12,5,0,2,5
S01007036,Occupancy rating +2 or more,235,55,31,24,174,43,128,61,53,14,3,1,2,6,3,0,1,2
S01007036,Occupancy rating +1,72,29,11,18,39,3,29,10,14,5,7,1,6,4,2,0,1,1
S01007036,Occupancy rating 0,83,41,24,17,42,5,25,5,15,5,12,10,2,0,0,0,0,0
S01007036,Occupancy rating -1 or less,11,0,0,0,9,0,5,1,4,0,4,4,0,2,0,0,0,2
S01007037,All households,453,148,86,62,298,51,193,65,94,34,54,28,26,7,2,0,0,5
S01007037,Occupancy rating +2 or more,161,39,24,15,119,30,78,35,34,9,11,6,5,3,1,0,0,2
S01007037,Occupancy rating +1,140,57,22,35,82,17,59,25,20,14,6,0,6,1,0,0,0,1
S01007037,Occupancy rating 0,123,50,39,11,71,3,39,4,27,8,29,18,11,2,1,0,0,1
S01007037,Occupancy rating -1 or less,29,2,1,1,26,1,17,1,13,3,8,4,4,1,0,0,0,1
S01007038,All households,328,114,47,67,193,15,156,66,69,21,22,10,12,21,7,0,1,13
S01007038,Occupancy rating +2 or more,142,49,24,25,89,12,72,35,27,10,5,1,4,4,1,0,1,2
S01007038,Occupancy rating +1,88,32,11,21,51,3,43,21,14,8,5,3,2,5,1,0,0,4
S01007038,Occupancy rating 0,72,25,10,15,43,0,34,8,23,3,9,4,5,4,1,0,0,3
S01007038,Occupancy rating -1 or less,26,8,2,6,10,0,7,2,5,0,3,2,1,8,4,0,0,4
S01007039,All households,368,106,41,65,253,35,184,71,87,26,34,21,13,9,2,2,1,4
S01007039,Occupancy rating +2 or more,178,41,21,20,135,25,103,51,42,10,7,4,3,2,0,0,0,2
S01007039,Occupancy rating +1,85,36,8,28,48,7,36,13,15,8,5,2,3,1,0,0,1,0
S01007039,Occupancy rating 0,87,28,12,16,56,2,37,4,27,6,17,11,6,3,1,1,0,1
S01007039,Occupancy rating -1 or less,18,1,0,1,14,1,8,3,3,2,5,4,1,3,1,1,0,1
S01007040,All households,301,109,56,53,183,31,116,53,45,18,36,24,12,9,5,0,0,4
S01007040,Occupancy rating +2 or more,118,41,20,21,74,15,55,31,16,8,4,1,3,3,1,0,0,2
S01007040,Occupancy rating +1,83,38,17,21,45,15,24,15,8,1,6,3,3,0,0,0,0,0
S01007040,Occupancy rating 0,71,23,14,9,45,1,25,4,14,7,19,13,6,3,1,0,0,2
S01007040,Occupancy rating -1 or less,29,7,5,2,19,0,12,3,7,2,7,7,0,3,3,0,0,0
S01007041,All households,344,135,73,62,200,28,144,66,56,22,28,14,14,9,1,0,0,8
S01007041,Occupancy rating +2 or more,176,60,33,27,114,19,87,49,29,9,8,3,5,2,0,0,0,2
S01007041,Occupancy rating +1,76,27,13,14,45,6,33,15,10,8,6,2,4,4,1,0,0,3
S01007041,Occupancy rating 0,77,44,26,18,31,3,17,2,11,4,11,7,4,2,0,0,0,2
S01007041,Occupancy rating -1 or less,15,4,1,3,10,0,7,0,6,1,3,2,1,1,0,0,0,1
S01007042,All households,318,98,64,34,199,29,153,70,69,14,17,9,8,21,10,0,1,10
S01007042,Occupancy rating +2 or more,169,35,20,15,124,20,97,54,37,6,7,3,4,10,6,0,0,4
S01007042,Occupancy rating +1,77,28,19,9,46,6,34,14,17,3,6,3,3,3,2,0,0,1
S01007042,Occupancy rating 0,51,25,18,7,22,3,15,1,10,4,4,3,1,4,0,0,1,3
S01007042,Occupancy rating -1 or less,21,10,7,3,7,0,7,1,5,1,0,0,0,4,2,0,0,2
S01007043,All households,382,75,30,45,290,25,243,110,91,42,22,7,15,17,6,0,1,10
S01007043,Occupancy rating +2 or more,291,55,24,31,223,21,190,97,62,31,12,5,7,13,5,0,1,7
S01007043,Occupancy rating +1,58,15,5,10,42,3,32,10,17,5,7,2,5,1,0,0,0,1
S01007043,Occupancy rating 0,27,3,1,2,21,1,17,3,9,5,3,0,3,3,1,0,0,2
S01007043,Occupancy rating -1 or less,6,2,0,2,4,0,4,0,3,1,0,0,0,0,0,0,0,0
S01007044,All households,306,97,55,42,203,41,142,74,45,23,20,8,12,6,3,0,1,2
S01007044,Occupancy rating +2 or more,183,41,23,18,138,34,96,59,24,13,8,3,5,4,1,0,1,2
S01007044,Occupancy rating +1,70,31,18,13,39,5,26,11,12,3,8,3,5,0,0,0,0,0
S01007044,Occupancy rating 0,46,23,12,11,21,1,16,3,7,6,4,2,2,2,2,0,0,0
S01007044,Occupancy rating -1 or less,7,2,2,0,5,1,4,1,2,1,0,0,0,0,0,0,0,0
S01007045,All households,325,63,29,34,242,28,195,108,57,30,19,8,11,20,8,0,2,10
S01007045,Occupancy rating +2 or more,246,51,23,28,186,26,148,93,37,18,12,4,8,9,3,0,0,6
S01007045,Occupancy rating +1,55,10,5,5,41,1,35,12,14,9,5,3,2,4,2,0,1,1
S01007045,Occupancy rating 0,15,1,1,0,9,0,8,3,2,3,1,1,0,5,1,0,1,3
S01007045,Occupancy rating -1 or less,9,1,0,1,6,1,4,0,4,0,1,0,1,2,2,0,0,0
S01007046,All households,259,80,30,50,165,23,127,63,43,21,15,4,11,14,7,0,0,7
S01007046,Occupancy rating +2 or more,161,48,18,30,106,14,87,51,22,14,5,2,3,7,2,0,0,5
S01007046,Occupancy rating +1,59,20,9,11,38,7,27,7,13,7,4,0,4,1,1,0,0,0
S01007046,Occupancy rating 0,31,11,3,8,18,2,10,4,6,0,6,2,4,2,1,0,0,1
S01007046,Occupancy rating -1 or less,8,1,0,1,3,0,3,1,2,0,0,0,0,4,3,0,0,1
S01007047,All households,261,47,21,26,201,30,162,82,56,24,9,5,4,13,5,0,3,5
S01007047,Occupancy rating +2 or more,190,32,14,18,151,24,125,74,35,16,2,1,1,7,2,0,2,3
S01007047,Occupancy rating +1,48,13,6,7,33,5,24,6,15,3,4,2,2,2,1,0,1,0
S01007047,Occupancy rating 0,14,2,1,1,9,0,8,2,3,3,1,0,1,3,2,0,0,1
S01007047,Occupancy rating -1 or less,9,0,0,0,8,1,5,0,3,2,2,2,0,1,0,0,0,1
S01007048,All households,359,80,33,47,260,38,205,86,75,44,17,5,12,19,7,0,1,11
S01007048,Occupancy rating +2 or more,248,54,27,27,181,28,147,73,49,25,6,2,4,13,3,0,1,9
S01007048,Occupancy rating +1,62,10,1,9,51,10,36,10,14,12,5,3,2,1,0,0,0,1
S01007048,Occupancy rating 0,38,15,5,10,22,0,16,2,8,6,6,0,6,1,1,0,0,0
S01007048,Occupancy rating -1 or less,11,1,0,1,6,0,6,1,4,1,0,0,0,4,3,0,0,1
S01007049,All households,415,131,57,74,264,36,194,83,82,29,34,22,12,20,8,0,2,10
S01007049,Occupancy rating +2 or more,170,47,20,27,116,22,88,53,24,11,6,3,3,7,3,0,1,3
S01007049,Occupancy rating +1,127,45,15,30,81,9,62,28,23,11,10,4,6,1,0,0,0,1
S01007049,Occupancy rating 0,91,28,16,12,56,5,38,1,31,6,13,11,2,7,1,0,1,5
S01007049,Occupancy rating -1 or less,27,11,6,5,11,0,6,1,4,1,5,4,1,5,4,0,0,1
S01007050,All households,295,102,52,50,181,29,132,55,57,20,20,11,9,12,5,0,1,6
S01007050,Occupancy rating +2 or more,154,39,19,20,112,19,85,43,31,11,8,4,4,3,2,0,1,0
S01007050,Occupancy rating +1,70,30,11,19,37,7,24,7,13,4,6,4,2,3,0,0,0,3
S01007050,Occupancy rating 0,59,29,18,11,25,2,18,5,9,4,5,2,3,5,3,0,0,2
S01007050,Occupancy rating -1 or less,12,4,4,0,7,1,5,0,4,1,1,1,0,1,0,0,0,1
S01007051,All households,332,97,43,54,222,27,173,75,80,18,22,12,10,13,5,0,2,6
S01007051,Occupancy rating +2 or more,173,33,11,22,135,24,108,60,39,9,3,2,1,5,2,0,0,3
S01007051,Occupancy rating +1,70,22,6,16,45,2,39,13,21,5,4,1,3,3,1,0,1,1
S01007051,Occupancy rating 0,72,36,23,13,34,1,20,2,14,4,13,7,6,2,0,0,1,1
S01007051,Occupancy rating -1 or less,17,6,3,3,8,0,6,0,6,0,2,2,0,3,2,0,0,1
S01007052,All households,233,51,29,22,173,17,140,59,54,27,16,8,8,9,4,0,0,5
S01007052,Occupancy rating +2 or more,135,25,16,9,107,10,88,36,34,18,9,4,5,3,1,0,0,2
S01007052,Occupancy rating +1,64,16,7,9,45,7,35,19,10,6,3,1,2,3,2,0,0,1
S01007052,Occupancy rating 0,26,8,4,4,16,0,12,3,6,3,4,3,1,2,0,0,0,2
S01007052,Occupancy rating -1 or less,8,2,2,0,5,0,5,1,4,0,0,0,0,1,1,0,0,0
S01007053,All households,191,35,14,21,152,21,118,49,50,19,13,5,8,4,1,0,0,3
S01007053,Occupancy rating +2 or more,154,23,7,16,127,15,104,47,42,15,8,3,5,4,1,0,0,3
S01007053,Occupancy rating +1,20,5,3,2,15,6,6,1,2,3,3,0,3,0,0,0,0,0
S01007053,Occupancy rating 0,12,7,4,3,5,0,5,1,3,1,0,0,0,0,0,0,0,0
S01007053,Occupancy rating -1 or less,5,0,0,0,5,0,3,0,3,0,2,2,0,0,0,0,0,0
S01007054,All households,434,148,91,57,277,43,203,81,88,34,31,21,10,9,3,0,0,6
S01007054,Occupancy rating +2 or more,189,50,30,20,136,20,111,55,43,13,5,2,3,3,1,0,0,2
S01007054,Occupancy rating +1,113,43,22,21,67,14,43,21,10,12,10,7,3,3,1,0,0,2
S01007054,Occupancy rating 0,117,54,39,15,61,7,42,5,31,6,12,9,3,2,0,0,0,2
S01007054,Occupancy rating -1 or less,15,1,0,1,13,2,7,0,4,3,4,3,1,1,1,0,0,0
S01007055,All households,196,42,10,32,143,16,119,49,57,13,8,3,5,11,2,0,1,8
S01007055,Occupancy rating +2 or more,143,29,9,20,106,15,88,44,34,10,3,2,1,8,2,0,1,5
S01007055,Occupancy rating +1,34,7,1,6,25,1,22,3,17,2,2,0,2,2,0,0,0,2
S01007055,Occupancy rating 0,16,5,0,5,10,0,7,2,4,1,3,1,2,1,0,0,0,1
S01007055,Occupancy rating -1 or less,3,1,0,1,2,0,2,0,2,0,0,0,0,0,0,0,0,0
S01007056,All households,221,27,11,16,179,17,148,58,60,30,14,3,11,15,6,0,0,9
S01007056,Occupancy rating +2 or more,164,19,8,11,137,16,114,51,46,17,7,1,6,8,2,0,0,6
S01007056,Occupancy rating +1,30,7,3,4,21,0,20,7,7,6,1,0,1,2,1,0,0,1
S01007056,Occupancy rating 0,16,1,0,1,13,1,7,0,3,4,5,1,4,2,1,0,0,1
S01007056,Occupancy rating -1 or less,11,0,0,0,8,0,7,0,4,3,1,1,0,3,2,0,0,1
S01007057,All households,247,75,52,23,168,40,112,53,38,21,16,3,13,4,3,0,0,1
S01007057,Occupancy rating +2 or more,131,36,28,8,94,23,70,43,18,9,1,1,0,1,1,0,0,0
S01007057,Occupancy rating +1,69,25,19,6,43,12,27,9,11,7,4,0,4,1,1,0,0,0
S01007057,Occupancy rating 0,40,13,4,9,26,5,14,1,8,5,7,2,5,1,1,0,0,0
S01007057,Occupancy rating -1 or less,7,1,1,0,5,0,1,0,1,0,4,0,4,1,0,0,0,1
S01007058,All households,288,113,75,38,169,45,107,48,42,17,17,11,6,6,0,0,2,4
S01007058,Occupancy rating +2 or more,124,41,17,24,81,25,53,30,17,6,3,1,2,2,0,0,1,1
S01007058,Occupancy rating +1,74,20,13,7,50,13,36,13,14,9,1,1,0,4,0,0,1,3
S01007058,Occupancy rating 0,80,51,44,7,29,5,14,5,7,2,10,6,4,0,0,0,0,0
S01007058,Occupancy rating -1 or less,10,1,1,0,9,2,4,0,4,0,3,3,0,0,0,0,0,0
S01007059,All households,433,117,55,62,303,48,212,91,95,26,43,32,11,13,5,0,0,8
S01007059,Occupancy rating +2 or more,224,48,19,29,173,34,133,74,49,10,6,3,3,3,1,0,0,2
S01007059,Occupancy rating +1,105,34,12,22,66,8,43,14,22,7,15,11,4,5,1,0,0,4
S01007059,Occupancy rating 0,81,25,16,9,53,4,32,3,20,9,17,14,3,3,1,0,0,2
S01007059,Occupancy rating -1 or less,23,10,8,2,11,2,4,0,4,0,5,4,1,2,2,0,0,0
S01007060,All households,231,44,21,23,178,22,111,38,41,32,45,34,11,9,5,0,0,4
S01007060,Occupancy rating +2 or more,90,25,9,16,64,18,42,29,7,6,4,2,2,1,1,0,0,0
S01007060,Occupancy rating +1,68,11,6,5,55,2,42,7,15,20,11,9,2,2,1,0,0,1
S01007060,Occupancy rating 0,54,8,6,2,41,0,19,2,12,5,22,16,6,5,2,0,0,3
S01007060,Occupancy rating -1 or less,19,0,0,0,18,2,8,0,7,1,8,7,1,1,1,0,0,0
S01007061,All households,346,50,16,34,276,20,240,110,95,35,16,12,4,20,5,0,0,15
S01007061,Occupancy rating +2 or more,258,34,8,26,211,13,189,95,69,25,9,5,4,13,3,0,0,10
S01007061,Occupancy rating +1,59,11,5,6,45,5,35,14,14,7,5,5,0,3,1,0,0,2
S01007061,Occupancy rating 0,22,3,2,1,15,2,11,0,8,3,2,2,0,4,1,0,0,3
S01007061,Occupancy rating -1 or less,7,2,1,1,5,0,5,1,4,0,0,0,0,0,0,0,0,0
S01007062,All households,272,48,17,31,215,25,177,89,61,27,13,8,5,9,5,0,2,2
S01007062,Occupancy rating +2 or more,209,34,12,22,168,23,140,79,42,19,5,3,2,7,4,0,1,2
S01007062,Occupancy rating +1,44,12,4,8,30,2,24,7,12,5,4,3,1,2,1,0,1,0
S01007062,Occupancy rating 0,19,2,1,1,17,0,13,3,7,3,4,2,2,0,0,0,0,0
S01007062,Occupancy rating -1 or less,0,0,0,0,0,0,0,0,0,0,0,0,0,0,0,0,0,0
S01007063,All households,282,78,46,32,201,22,162,73,60,29,17,9,8,3,2,0,0,1
S01007063,Occupancy rating +2 or more,177,36,17,19,138,19,113,58,38,17,6,4,2,3,2,0,0,1
S01007063,Occupancy rating +1,59,17,11,6,42,2,32,14,11,7,8,3,5,0,0,0,0,0
S01007063,Occupancy rating 0,42,24,18,6,18,1,14,1,8,5,3,2,1,0,0,0,0,0
S01007063,Occupancy rating -1 or less,4,1,0,1,3,0,3,0,3,0,0,0,0,0,0,0,0,0
S01007064,All households,253,45,15,30,196,16,162,81,55,26,18,10,8,12,5,0,0,7
S01007064,Occupancy rating +2 or more,175,29,9,20,140,13,120,65,32,23,7,6,1,6,4,0,0,2
S01007064,Occupancy rating +1,38,11,5,6,25,3,19,8,11,0,3,1,2,2,0,0,0,2
S01007064,Occupancy rating 0,35,5,1,4,27,0,20,7,11,2,7,2,5,3,1,0,0,2
S01007064,Occupancy rating -1 or less,5,0,0,0,4,0,3,1,1,1,1,1,0,1,0,0,0,1
S01007065,All households,249,63,19,44,176,18,138,70,52,16,20,16,4,10,4,0,1,5
S01007065,Occupancy rating +2 or more,162,39,10,29,116,14,97,57,30,10,5,3,2,7,2,0,1,4
S01007065,Occupancy rating +1,49,14,3,11,35,3,27,11,12,4,5,4,1,0,0,0,0,0
S01007065,Occupancy rating 0,31,10,6,4,18,1,11,2,7,2,6,5,1,3,2,0,0,1
S01007065,Occupancy rating -1 or less,7,0,0,0,7,0,3,0,3,0,4,4,0,0,0,0,0,0
S01007066,All households,252,44,13,31,189,17,160,66,59,35,12,8,4,19,7,0,1,11
S01007066,Occupancy rating +2 or more,186,33,9,24,141,12,124,58,42,24,5,3,2,12,4,0,1,7
S01007066,Occupancy rating +1,38,6,2,4,28,3,22,6,10,6,3,2,1,4,2,0,0,2
S01007066,Occupancy rating 0,22,4,2,2,15,1,11,2,5,4,3,2,1,3,1,0,0,2
S01007066,Occupancy rating -1 or less,6,1,0,1,5,1,3,0,2,1,1,1,0,0,0,0,0,0
S01007067,All households,254,74,31,43,169,27,127,71,39,17,15,4,11,11,6,0,0,5
S01007067,Occupancy rating +2 or more,123,31,19,12,88,18,67,46,13,8,3,1,2,4,3,0,0,1
S01007067,Occupancy rating +1,84,34,11,23,49,5,44,24,12,8,0,0,0,1,1,0,0,0
S01007067,Occupancy rating 0,34,6,1,5,23,1,12,1,11,0,10,3,7,5,1,0,0,4
S01007067,Occupancy rating -1 or less,13,3,0,3,9,3,4,0,3,1,2,0,2,1,1,0,0,0
S01007068,All households,329,97,46,51,221,37,145,74,50,21,39,24,15,11,3,0,1,7
S01007068,Occupancy rating +2 or more,168,31,11,20,134,26,104,65,28,11,4,3,1,3,0,0,0,3
S01007068,Occupancy rating +1,59,25,10,15,32,7,18,5,7,6,7,3,4,2,0,0,0,2
S01007068,Occupancy rating 0,85,37,23,14,45,4,18,4,10,4,23,15,8,3,1,0,0,2
S01007068,Occupancy rating -1 or less,17,4,2,2,10,0,5,0,5,0,5,3,2,3,2,0,1,0
S01007069,All households,338,83,27,56,244,27,180,72,86,22,37,29,8,11,3,0,0,8
S01007069,Occupancy rating +2 or more,166,37,15,22,126,17,101,49,41,11,8,6,2,3,0,0,0,3
S01007069,Occupancy rating +1,81,22,3,19,57,8,41,19,15,7,8,4,4,2,0,0,0,2
S01007069,Occupancy rating 0,74,20,8,12,52,2,31,4,25,2,19,17,2,2,1,0,0,1
S01007069,Occupancy rating -1 or less,17,4,1,3,9,0,7,0,5,2,2,2,0,4,2,0,0,2
S01007070,All households,247,100,38,62,136,15,106,51,38,17,15,7,8,11,3,0,1,7
S01007070,Occupancy rating +2 or more,98,30,8,22,64,11,50,35,12,3,3,1,2,4,1,0,1,2
S01007070,Occupancy rating +1,54,28,10,18,24,3,18,12,3,3,3,2,1,2,0,0,0,2
S01007070,Occupancy rating 0,77,39,19,20,34,1,25,3,14,8,8,4,4,4,1,0,0,3
S01007070,Occupancy rating -1 or less,18,3,1,2,14,0,13,1,9,3,1,0,1,1,1,0,0,0
S01007071,All households,356,109,37,72,238,22,193,78,82,33,23,12,11,9,3,0,1,5
S01007071,Occupancy rating +2 or more,167,36,12,24,128,13,110,54,43,13,5,2,3,3,1,0,1,1
S01007071,Occupancy rating +1,88,31,7,24,55,8,45,19,18,8,2,1,1,2,0,0,0,2
S01007071,Occupancy rating 0,80,29,15,14,49,1,36,5,20,11,12,6,6,2,1,0,0,1
S01007071,Occupancy rating -1 or less,21,13,3,10,6,0,2,0,1,1,4,3,1,2,1,0,0,1
S01007072,All households,246,44,9,35,196,17,161,66,71,24,18,10,8,6,4,0,0,2
S01007072,Occupancy rating +2 or more,153,27,6,21,123,13,108,56,39,13,2,0,2,3,3,0,0,0
S01007072,Occupancy rating +1,60,17,3,14,43,3,34,10,17,7,6,5,1,0,0,0,0,0
S01007072,Occupancy rating 0,26,0,0,0,25,1,15,0,11,4,9,4,5,1,0,0,0,1
S01007072,Occupancy rating -1 or less,7,0,0,0,5,0,4,0,4,0,1,1,0,2,1,0,0,1
S01007073,All households,358,80,43,37,267,35,206,87,85,34,26,16,10,11,5,0,1,5
S01007073,Occupancy rating +2 or more,254,66,36,30,186,34,142,74,49,19,10,5,5,2,0,0,1,1
S01007073,Occupancy rating +1,71,12,6,6,55,1,45,13,26,6,9,5,4,4,1,0,0,3
S01007073,Occupancy rating 0,28,1,0,1,22,0,16,0,8,8,6,5,1,5,4,0,0,1
S01007073,Occupancy rating -1 or less,5,1,1,0,4,0,3,0,2,1,1,1,0,0,0,0,0,0
S01007074,All households,292,74,23,51,207,22,141,69,44,28,44,27,17,11,6,0,0,5
S01007074,Occupancy rating +2 or more,149,45,17,28,101,15,83,58,17,8,3,0,3,3,0,0,0,3
S01007074,Occupancy rating +1,81,24,3,21,56,5,41,11,14,16,10,4,6,1,0,0,0,1
S01007074,Occupancy rating 0,54,4,3,1,45,2,14,0,10,4,29,23,6,5,4,0,0,1
S01007074,Occupancy rating -1 or less,8,1,0,1,5,0,3,0,3,0,2,0,2,2,2,0,0,0
S01007075,All households,305,95,45,50,191,25,126,41,61,24,40,27,13,19,11,1,1,6
S01007075,Occupancy rating +2 or more,80,24,6,18,54,16,35,28,5,2,3,2,1,2,1,0,0,1
S01007075,Occupancy rating +1,97,46,18,28,49,3,38,12,14,12,8,1,7,2,2,0,0,0
S01007075,Occupancy rating 0,102,24,20,4,71,6,44,1,35,8,21,19,2,7,4,1,0,2
S01007075,Occupancy rating -1 or less,26,1,1,0,17,0,9,0,7,2,8,5,3,8,4,0,1,3
S01007076,All households,289,56,18,38,224,13,179,65,75,39,32,14,18,9,5,0,0,4
S01007076,Occupancy rating +2 or more,146,35,12,23,109,11,91,54,22,15,7,1,6,2,0,0,0,2
S01007076,Occupancy rating +1,85,15,3,12,68,2,53,10,26,17,13,5,8,2,1,0,0,1
S01007076,Occupancy rating 0,39,3,0,3,35,0,27,0,21,6,8,6,2,1,1,0,0,0
S01007076,Occupancy rating -1 or less,19,3,3,0,12,0,8,1,6,1,4,2,2,4,3,0,0,1
S01007077,All households,311,81,37,44,220,48,144,74,39,31,28,13,15,10,4,0,0,6
S01007077,Occupancy rating +2 or more,135,35,10,25,99,27,65,50,8,7,7,3,4,1,0,0,0,1
S01007077,Occupancy rating +1,86,21,14,7,61,15,40,17,10,13,6,3,3,4,1,0,0,3
S01007077,Occupancy rating 0,79,21,10,11,54,6,35,6,18,11,13,6,7,4,2,0,0,2
S01007077,Occupancy rating -1 or less,11,4,3,1,6,0,4,1,3,0,2,1,1,1,1,0,0,0
S01007078,All households,398,144,63,81,244,48,154,68,61,25,42,25,17,10,5,0,2,3
S01007078,Occupancy rating +2 or more,149,52,34,18,97,30,64,32,22,10,3,1,2,0,0,0,0,0
S01007078,Occupancy rating +1,135,50,18,32,80,17,57,32,15,10,6,2,4,5,2,0,2,1
S01007078,Occupancy rating 0,89,37,10,27,52,1,27,4,18,5,24,16,8,0,0,0,0,0
S01007078,Occupancy rating -1 or less,25,5,1,4,15,0,6,0,6,0,9,6,3,5,3,0,0,2
S01007079,All households,522,259,130,129,246,49,165,75,69,21,32,19,13,17,2,0,0,15
S01007079,Occupancy rating +2 or more,161,44,22,22,115,29,82,45,30,7,4,3,1,2,0,0,0,2
S01007079,Occupancy rating +1,150,79,33,46,68,14,44,20,19,5,10,4,6,3,1,0,0,2
S01007079,Occupancy rating 0,168,112,60,52,50,4,30,9,14,7,16,11,5,6,0,0,0,6
S01007079,Occupancy rating -1 or less,43,24,15,9,13,2,9,1,6,2,2,1,1,6,1,0,0,5
S01007080,All households,386,145,78,67,231,45,136,55,57,24,50,32,18,10,3,0,0,7
S01007080,Occupancy rating +2 or more,149,60,38,22,88,28,57,35,15,7,3,2,1,1,0,0,0,1
S01007080,Occupancy rating +1,120,53,27,26,66,13,42,16,17,9,11,6,5,1,0,0,0,1
S01007080,Occupancy rating 0,101,29,12,17,68,3,32,4,20,8,33,21,12,4,2,0,0,2
S01007080,Occupancy rating -1 or less,16,3,1,2,9,1,5,0,5,0,3,3,0,4,1,0,0,3
S01007081,All households,370,94,35,59,248,18,167,49,87,31,63,33,30,28,17,0,0,11
S01007081,Occupancy rating +2 or more,121,55,22,33,65,9,51,30,13,8,5,2,3,1,0,0,0,1
S01007081,Occupancy rating +1,117,33,10,23,79,7,49,17,22,10,23,9,14,5,2,0,0,3
S01007081,Occupancy rating 0,94,4,2,2,77,1,49,2,38,9,27,17,10,13,6,0,0,7
S01007081,Occupancy rating -1 or less,38,2,1,1,27,1,18,0,14,4,8,5,3,9,9,0,0,0
S01007082,All households,233,83,29,54,130,12,85,28,39,18,33,20,13,20,13,0,0,7
S01007082,Occupancy rating +2 or more,71,26,11,15,41,9,30,14,11,5,2,1,1,4,3,0,0,1
S01007082,Occupancy rating +1,77,42,12,30,33,1,24,10,6,8,8,3,5,2,0,0,0,2
S01007082,Occupancy rating 0,57,12,5,7,41,2,21,2,14,5,18,13,5,4,3,0,0,1
S01007082,Occupancy rating -1 or less,28,3,1,2,15,0,10,2,8,0,5,3,2,10,7,0,0,3
S01007083,All households,451,188,70,118,236,39,146,52,73,21,51,37,14,27,5,1,2,19
S01007083,Occupancy rating +2 or more,69,27,13,14,37,7,27,16,9,2,3,2,1,5,0,0,0,5
S01007083,Occupancy rating +1,166,89,30,59,75,24,41,28,7,6,10,8,2,2,0,0,1,1
S01007083,Occupancy rating 0,173,56,18,38,106,7,64,6,46,12,35,25,10,11,1,1,1,8
S01007083,Occupancy rating -1 or less,43,16,9,7,18,1,14,2,11,1,3,2,1,9,4,0,0,5
S01007084,All households,273,106,53,53,152,31,108,50,33,25,13,10,3,15,6,0,3,6
S01007084,Occupancy rating +2 or more,118,33,16,17,82,12,65,35,17,13,5,4,1,3,2,0,1,0
S01007084,Occupancy rating +1,90,40,19,21,50,19,26,12,8,6,5,4,1,0,0,0,0,0
S01007084,Occupancy rating 0,51,29,16,13,16,0,13,2,7,4,3,2,1,6,3,0,2,1
S01007084,Occupancy rating -1 or less,14,4,2,2,4,0,4,1,1,2,0,0,0,6,1,0,0,5
S01007085,All households,366,148,29,119,193,24,145,58,68,19,24,12,12,25,9,1,0,15
S01007085,Occupancy rating +2 or more,142,46,11,35,93,18,68,34,23,11,7,4,3,3,3,0,0,0
S01007085,Occupancy rating +1,111,65,16,49,44,5,35,18,14,3,4,2,2,2,1,0,0,1
S01007085,Occupancy rating 0,72,31,2,29,35,1,28,5,19,4,6,3,3,6,0,1,0,5
S01007085,Occupancy rating -1 or less,41,6,0,6,21,0,14,1,12,1,7,3,4,14,5,0,0,9
S01007086,All households,573,278,55,223,249,10,181,81,83,17,58,50,8,46,16,1,1,28
S01007086,Occupancy rating +2 or more,87,32,7,25,53,5,44,19,14,11,4,4,0,2,0,0,1,1
S01007086,Occupancy rating +1,156,84,14,70,67,3,54,36,16,2,10,10,0,5,1,0,0,4
S01007086,Occupancy rating 0,244,150,30,120,81,1,50,17,32,1,30,26,4,13,0,1,0,12
S01007086,Occupancy rating -1 or less,86,12,4,8,48,1,33,9,21,3,14,10,4,26,15,0,0,11
S01007087,All households,439,208,61,147,199,15,139,60,60,19,45,32,13,32,11,1,4,16
S01007087,Occupancy rating +2 or more,97,41,16,25,55,9,43,23,15,5,3,2,1,1,0,0,0,1
S01007087,Occupancy rating +1,117,59,23,36,52,6,34,23,8,3,12,5,7,6,0,1,2,3
S01007087,Occupancy rating 0,152,91,20,71,55,0,33,9,20,4,22,18,4,6,1,0,1,4
S01007087,Occupancy rating -1 or less,73,17,2,15,37,0,29,5,17,7,8,7,1,19,10,0,1,8
S01007088,All households,247,83,21,62,147,10,94,48,39,7,43,30,13,17,4,1,0,12
S01007088,Occupancy rating +2 or more,48,21,8,13,26,2,22,14,7,1,2,1,1,1,0,0,0,1
S01007088,Occupancy rating +1,104,52,11,41,51,7,37,29,6,2,7,4,3,1,0,0,0,1
S01007088,Occupancy rating 0,61,8,2,6,47,0,23,3,17,3,24,19,5,6,1,1,0,4
S01007088,Occupancy rating -1 or less,34,2,0,2,23,1,12,2,9,1,10,6,4,9,3,0,0,6
S01007089,All households,217,52,23,29,158,23,130,59,57,14,5,1,4,7,1,0,1,5
S01007089,Occupancy rating +2 or more,145,32,16,16,111,18,92,44,38,10,1,0,1,2,0,0,1,1
S01007089,Occupancy rating +1,53,17,7,10,35,5,28,11,13,4,2,0,2,1,0,0,0,1
S01007089,Occupancy rating 0,12,1,0,1,8,0,8,2,6,0,0,0,0,3,1,0,0,2
S01007089,Occupancy rating -1 or less,7,2,0,2,4,0,2,2,0,0,2,1,1,1,0,0,0,1
S01007090,All households,243,79,12,67,158,24,120,54,45,21,14,11,3,6,2,0,0,4
S01007090,Occupancy rating +2 or more,86,19,2,17,66,10,55,30,18,7,1,1,0,1,0,0,0,1
S01007090,Occupancy rating +1,95,37,6,31,56,14,35,19,10,6,7,6,1,2,1,0,0,1
S01007090,Occupancy rating 0,53,21,3,18,30,0,26,4,14,8,4,3,1,2,1,0,0,1
S01007090,Occupancy rating -1 or less,9,2,1,1,6,0,4,1,3,0,2,1,1,1,0,0,0,1
S01007091,All households,280,40,6,34,232,6,175,39,114,22,51,42,9,8,6,1,0,1
S01007091,Occupancy rating +2 or more,90,15,2,13,74,3,68,23,38,7,3,3,0,1,1,0,0,0
S01007091,Occupancy rating +1,87,13,4,9,71,3,55,15,34,6,13,8,5,3,2,1,0,0
S01007091,Occupancy rating 0,86,10,0,10,75,0,45,1,36,8,30,26,4,1,0,0,0,1
S01007091,Occupancy rating -1 or less,17,2,0,2,12,0,7,0,6,1,5,5,0,3,3,0,0,0
S01007092,All households,307,120,72,48,177,32,116,54,39,23,29,14,15,10,4,1,0,5
S01007092,Occupancy rating +2 or more,75,18,5,13,56,12,40,29,4,7,4,0,4,1,0,1,0,0
S01007092,Occupancy rating +1,96,34,17,17,58,14,39,21,10,8,5,2,3,4,0,0,0,4
S01007092,Occupancy rating 0,115,59,45,14,52,6,30,3,20,7,16,8,8,4,4,0,0,0
S01007092,Occupancy rating -1 or less,21,9,5,4,11,0,7,1,5,1,4,4,0,1,0,0,0,1
S01007093,All households,417,114,55,59,296,62,214,93,80,41,20,12,8,7,3,0,0,4
S01007093,Occupancy rating +2 or more,206,33,14,19,172,33,132,69,44,19,7,3,4,1,0,0,0,1
S01007093,Occupancy rating +1,125,41,24,17,80,21,56,17,24,15,3,1,2,4,2,0,0,2
S01007093,Occupancy rating 0,63,29,13,16,32,7,20,5,9,6,5,4,1,2,1,0,0,1
S01007093,Occupancy rating -1 or less,23,11,4,7,12,1,6,2,3,1,5,4,1,0,0,0,0,0
S01007094,All households,354,64,35,29,270,53,197,90,70,37,20,10,10,20,9,0,3,8
S01007094,Occupancy rating +2 or more,259,49,26,23,201,43,151,86,43,22,7,4,3,9,4,0,1,4
S01007094,Occupancy rating +1,53,12,6,6,39,9,24,2,12,10,6,2,4,2,1,0,1,0
S01007094,Occupancy rating 0,32,3,3,0,25,1,17,2,11,4,7,4,3,4,2,0,1,1
S01007094,Occupancy rating -1 or less,10,0,0,0,5,0,5,0,4,1,0,0,0,5,2,0,0,3
S01007095,All households,209,39,12,27,155,23,121,48,50,23,11,6,5,15,7,0,0,8
S01007095,Occupancy rating +2 or more,159,25,9,16,121,20,95,41,33,21,6,4,2,13,7,0,0,6
S01007095,Occupancy rating +1,30,11,3,8,18,3,12,3,9,0,3,2,1,1,0,0,0,1
S01007095,Occupancy rating 0,15,2,0,2,12,0,10,4,4,2,2,0,2,1,0,0,0,1
S01007095,Occupancy rating -1 or less,5,1,0,1,4,0,4,0,4,0,0,0,0,0,0,0,0,0
S01007096,All households,316,59,22,37,248,28,207,79,104,24,13,11,2,9,2,0,0,7
S01007096,Occupancy rating +2 or more,208,27,6,21,178,20,153,71,65,17,5,4,1,3,1,0,0,2
S01007096,Occupancy rating +1,47,6,0,6,39,3,34,8,23,3,2,1,1,2,1,0,0,1
S01007096,Occupancy rating 0,48,23,15,8,21,4,14,0,11,3,3,3,0,4,0,0,0,4
S01007096,Occupancy rating -1 or less,13,3,1,2,10,1,6,0,5,1,3,3,0,0,0,0,0,0
S01007097,All households,188,31,9,22,149,15,125,59,50,16,9,5,4,8,2,0,0,6
S01007097,Occupancy rating +2 or more,148,26,8,18,118,12,100,53,35,12,6,4,2,4,1,0,0,3
S01007097,Occupancy rating +1,22,3,0,3,18,3,13,5,4,4,2,0,2,1,0,0,0,1
S01007097,Occupancy rating 0,16,2,1,1,12,0,11,1,10,0,1,1,0,2,1,0,0,1
S01007097,Occupancy rating -1 or less,2,0,0,0,1,0,1,0,1,0,0,0,0,1,0,0,0,1
S01007098,All households,288,40,17,23,238,20,205,70,101,34,13,8,5,10,5,0,1,4
S01007098,Occupancy rating +2 or more,243,35,16,19,202,19,175,65,83,27,8,6,2,6,2,0,1,3
S01007098,Occupancy rating +1,30,5,1,4,24,1,22,5,12,5,1,0,1,1,1,0,0,0
S01007098,Occupancy rating 0,9,0,0,0,9,0,7,0,5,2,2,2,0,0,0,0,0,0
S01007098,Occupancy rating -1 or less,6,0,0,0,3,0,1,0,1,0,2,0,2,3,2,0,0,1
S01007099,All households,338,79,42,37,252,26,208,66,105,37,18,12,6,7,4,0,0,3
S01007099,Occupancy rating +2 or more,223,39,16,23,181,18,157,53,79,25,6,5,1,3,1,0,0,2
S01007099,Occupancy rating +1,62,17,9,8,44,7,33,12,14,7,4,3,1,1,1,0,0,0
S01007099,Occupancy rating 0,42,23,17,6,17,1,11,1,7,3,5,3,2,2,1,0,0,1
S01007099,Occupancy rating -1 or less,11,0,0,0,10,0,7,0,5,2,3,1,2,1,1,0,0,0
S01007100,All households,298,71,29,42,214,27,160,68,66,26,27,14,13,13,6,0,0,7
S01007100,Occupancy rating +2 or more,189,45,16,29,137,18,109,50,41,18,10,5,5,7,2,0,0,5
S01007100,Occupancy rating +1,64,14,8,6,47,8,36,14,16,6,3,1,2,3,1,0,0,2
S01007100,Occupancy rating 0,36,11,5,6,22,1,11,3,7,1,10,5,5,3,3,0,0,0
S01007100,Occupancy rating -1 or less,9,1,0,1,8,0,4,1,2,1,4,3,1,0,0,0,0,0
S01007101,All households,342,90,42,48,238,25,173,71,72,30,40,28,12,14,3,0,1,10
S01007101,Occupancy rating +2 or more,104,18,8,10,83,10,70,37,25,8,3,2,1,3,0,0,0,3
S01007101,Occupancy rating +1,91,22,5,17,67,8,48,27,8,13,11,6,5,2,1,0,0,1
S01007101,Occupancy rating 0,125,47,26,21,70,6,43,7,29,7,21,15,6,8,1,0,1,6
S01007101,Occupancy rating -1 or less,22,3,3,0,18,1,12,0,10,2,5,5,0,1,1,0,0,0
S01007102,All households,260,46,15,31,199,29,157,64,57,36,13,6,7,15,7,0,2,6
S01007102,Occupancy rating +2 or more,188,33,10,23,150,26,120,59,38,23,4,2,2,5,2,0,1,2
S01007102,Occupancy rating +1,44,11,4,7,29,3,20,4,8,8,6,3,3,4,1,0,1,2
S01007102,Occupancy rating 0,23,2,1,1,16,0,14,0,11,3,2,1,1,5,3,0,0,2
S01007102,Occupancy rating -1 or less,5,0,0,0,4,0,3,1,0,2,1,0,1,1,1,0,0,0
S01007103,All households,330,85,45,40,231,27,172,53,84,35,32,19,13,14,5,0,2,7
S01007103,Occupancy rating +2 or more,190,43,24,19,143,22,112,43,48,21,9,3,6,4,1,0,0,3
S01007103,Occupancy rating +1,72,27,12,15,39,3,31,7,14,10,5,3,2,6,1,0,1,4
S01007103,Occupancy rating 0,53,14,8,6,38,2,22,3,16,3,14,12,2,1,0,0,1,0
S01007103,Occupancy rating -1 or less,15,1,1,0,11,0,7,0,6,1,4,1,3,3,3,0,0,0
S01007104,All households,197,41,22,19,148,18,120,56,50,14,10,6,4,8,4,0,0,4
S01007104,Occupancy rating +2 or more,143,32,17,15,106,18,83,44,29,10,5,3,2,5,3,0,0,2
S01007104,Occupancy rating +1,33,6,3,3,27,0,25,11,12,2,2,1,1,0,0,0,0,0
S01007104,Occupancy rating 0,14,2,1,1,10,0,8,0,6,2,2,1,1,2,1,0,0,1
S01007104,Occupancy rating -1 or less,7,1,1,0,5,0,4,1,3,0,1,1,0,1,0,0,0,1
S01007105,All households,238,76,41,35,156,25,107,29,54,24,24,11,13,6,1,0,2,3
S01007105,Occupancy rating +2 or more,133,40,22,18,92,21,66,26,26,14,5,2,3,1,0,0,1,0
S01007105,Occupancy rating +1,50,16,8,8,32,2,24,1,16,7,6,2,4,2,0,0,1,1
S01007105,Occupancy rating 0,46,18,9,9,25,2,15,2,11,2,8,4,4,3,1,0,0,2
S01007105,Occupancy rating -1 or less,9,2,2,0,7,0,2,0,1,1,5,3,2,0,0,0,0,0
S01007106,All households,319,102,52,50,205,34,140,58,51,31,31,19,12,12,7,0,0,5
S01007106,Occupancy rating +2 or more,157,50,24,26,104,23,77,43,23,11,4,1,3,3,2,0,0,1
S01007106,Occupancy rating +1,76,26,13,13,46,9,30,11,7,12,7,4,3,4,2,0,0,2
S01007106,Occupancy rating 0,71,25,14,11,45,2,26,2,16,8,17,11,6,1,1,0,0,0
S01007106,Occupancy rating -1 or less,15,1,1,0,10,0,7,2,5,0,3,3,0,4,2,0,0,2
S01007107,All households,256,36,18,18,204,24,167,78,67,22,13,7,6,16,8,0,2,6
S01007107,Occupancy rating +2 or more,198,27,13,14,160,23,130,69,47,14,7,4,3,11,5,0,1,5
S01007107,Occupancy rating +1,33,8,4,4,22,1,19,6,11,2,2,0,2,3,1,0,1,1
S01007107,Occupancy rating 0,18,1,1,0,17,0,15,3,7,5,2,1,1,0,0,0,0,0
S01007107,Occupancy rating -1 or less,7,0,0,0,5,0,3,0,2,1,2,2,0,2,2,0,0,0
S01007108,All households,226,42,14,28,169,21,137,64,52,21,11,5,6,15,3,0,3,9
S01007108,Occupancy rating +2 or more,174,32,10,22,133,17,109,55,39,15,7,3,4,9,2,0,2,5
S01007108,Occupancy rating +1,29,8,3,5,19,4,13,6,4,3,2,1,1,2,0,0,0,2
S01007108,Occupancy rating 0,19,2,1,1,14,0,12,2,8,2,2,1,1,3,0,0,1,2
S01007108,Occupancy rating -1 or less,4,0,0,0,3,0,3,1,1,1,0,0,0,1,1,0,0,0
S01007109,All households,371,120,54,66,236,26,169,80,67,22,41,24,17,15,8,0,0,7
S01007109,Occupancy rating +2 or more,114,35,16,19,77,13,59,38,13,8,5,2,3,2,2,0,0,0
S01007109,Occupancy rating +1,130,46,27,19,82,6,61,36,17,8,15,6,9,2,1,0,0,1
S01007109,Occupancy rating 0,98,36,11,25,56,4,37,3,29,5,15,12,3,6,2,0,0,4
S01007109,Occupancy rating -1 or less,29,3,0,3,21,3,12,3,8,1,6,4,2,5,3,0,0,2
S01007110,All households,324,94,49,45,221,23,163,48,89,26,35,24,11,9,5,0,0,4
S01007110,Occupancy rating +2 or more,130,36,18,18,92,16,74,31,35,8,2,1,1,2,2,0,0,0
S01007110,Occupancy rating +1,91,31,17,14,57,7,42,13,19,10,8,4,4,3,1,0,0,2
S01007110,Occupancy rating 0,84,24,12,12,57,0,38,3,27,8,19,15,4,3,1,0,0,2
S01007110,Occupancy rating -1 or less,19,3,2,1,15,0,9,1,8,0,6,4,2,1,1,0,0,0
S01007111,All households,225,59,28,31,160,28,118,51,52,15,14,11,3,6,2,0,1,3
S01007111,Occupancy rating +2 or more,108,21,10,11,86,20,63,40,15,8,3,2,1,1,0,0,1,0
S01007111,Occupancy rating +1,71,26,15,11,45,7,32,9,19,4,6,5,1,0,0,0,0,0
S01007111,Occupancy rating 0,33,9,3,6,21,1,16,2,11,3,4,3,1,3,2,0,0,1
S01007111,Occupancy rating -1 or less,13,3,0,3,8,0,7,0,7,0,1,1,0,2,0,0,0,2
S01007112,All households,214,40,21,19,166,43,117,43,41,33,6,2,4,8,2,0,0,6
S01007112,Occupancy rating +2 or more,165,32,17,15,130,35,91,37,26,28,4,2,2,3,1,0,0,2
S01007112,Occupancy rating +1,29,7,3,4,20,6,14,5,7,2,0,0,0,2,0,0,0,2
S01007112,Occupancy rating 0,15,1,1,0,12,2,8,1,4,3,2,0,2,2,0,0,0,2
S01007112,Occupancy rating -1 or less,5,0,0,0,4,0,4,0,4,0,0,0,0,1,1,0,0,0
S01007113,All households,231,79,31,48,140,35,96,41,37,18,9,3,6,12,5,0,1,6
S01007113,Occupancy rating +2 or more,165,56,27,29,104,29,68,30,27,11,7,2,5,5,3,0,1,1
S01007113,Occupancy rating +1,43,17,1,16,24,5,19,9,6,4,0,0,0,2,0,0,0,2
S01007113,Occupancy rating 0,19,5,3,2,11,1,9,2,4,3,1,0,1,3,2,0,0,1
S01007113,Occupancy rating -1 or less,4,1,0,1,1,0,0,0,0,0,1,1,0,2,0,0,0,2
S01007114,All households,378,103,55,48,271,52,188,62,86,40,31,20,11,4,2,0,0,2
S01007114,Occupancy rating +2 or more,183,49,23,26,133,35,95,42,33,20,3,1,2,1,1,0,0,0
S01007114,Occupancy rating +1,117,48,29,19,68,15,50,18,22,10,3,2,1,1,0,0,0,1
S01007114,Occupancy rating 0,60,5,3,2,54,2,31,2,21,8,21,13,8,1,1,0,0,0
S01007114,Occupancy rating -1 or less,18,1,0,1,16,0,12,0,10,2,4,4,0,1,0,0,0,1
S01007115,All households,257,66,44,22,186,25,148,50,71,27,13,6,7,5,3,0,1,1
S01007115,Occupancy rating +2 or more,172,37,19,18,132,21,106,44,41,21,5,2,3,3,2,0,0,1
S01007115,Occupancy rating +1,41,9,7,2,32,3,25,5,16,4,4,2,2,0,0,0,0,0
S01007115,Occupancy rating 0,37,20,18,2,16,1,13,1,10,2,2,2,0,1,0,0,1,0
S01007115,Occupancy rating -1 or less,7,0,0,0,6,0,4,0,4,0,2,0,2,1,1,0,0,0
S01007116,All households,315,26,9,17,281,17,256,53,168,35,8,5,3,8,3,0,0,5
S01007116,Occupancy rating +2 or more,243,20,6,14,220,13,201,48,124,29,6,5,1,3,2,0,0,1
S01007116,Occupancy rating +1,54,4,2,2,48,4,42,4,33,5,2,0,2,2,0,0,0,2
S01007116,Occupancy rating 0,14,2,1,1,10,0,10,0,9,1,0,0,0,2,1,0,0,1
S01007116,Occupancy rating -1 or less,4,0,0,0,3,0,3,1,2,0,0,0,0,1,0,0,0,1
S01007117,All households,177,23,14,9,147,31,110,47,36,27,6,6,0,7,5,0,0,2
S01007117,Occupancy rating +2 or more,140,20,13,7,115,26,85,46,22,17,4,4,0,5,4,0,0,1
S01007117,Occupancy rating +1,25,3,1,2,22,4,18,0,10,8,0,0,0,0,0,0,0,0
S01007117,Occupancy rating 0,5,0,0,0,5,0,4,0,3,1,1,1,0,0,0,0,0,0
S01007117,Occupancy rating -1 or less,7,0,0,0,5,1,3,1,1,1,1,1,0,2,1,0,0,1
S01007118,All households,282,68,19,49,192,9,124,43,63,18,59,40,19,22,9,0,1,12
S01007118,Occupancy rating +2 or more,42,16,7,9,24,2,20,16,4,0,2,0,2,2,1,0,0,1
S01007118,Occupancy rating +1,101,48,9,39,48,6,37,26,8,3,5,4,1,5,2,0,1,2
S01007118,Occupancy rating 0,106,3,3,0,94,1,53,1,39,13,40,28,12,9,1,0,0,8
S01007118,Occupancy rating -1 or less,33,1,0,1,26,0,14,0,12,2,12,8,4,6,5,0,0,1
S01007119,All households,330,85,32,53,228,17,163,64,67,32,48,25,23,17,10,0,0,7
S01007119,Occupancy rating +2 or more,100,31,7,24,65,8,57,40,9,8,0,0,0,4,3,0,0,1
S01007119,Occupancy rating +1,93,27,8,19,65,4,45,20,15,10,16,10,6,1,0,0,0,1
S01007119,Occupancy rating 0,106,26,16,10,73,4,46,3,32,11,23,10,13,7,3,0,0,4
S01007119,Occupancy rating -1 or less,31,1,1,0,25,1,15,1,11,3,9,5,4,5,4,0,0,1
S01007120,All households,483,153,49,104,306,29,214,84,87,43,63,38,25,24,7,0,0,17
S01007120,Occupancy rating +2 or more,120,35,14,21,82,14,65,40,16,9,3,1,2,3,1,0,0,2
S01007120,Occupancy rating +1,157,58,12,46,97,13,77,39,25,13,7,2,5,2,0,0,0,2
S01007120,Occupancy rating 0,170,57,21,36,102,2,56,4,36,16,44,26,18,11,1,0,0,10
S01007120,Occupancy rating -1 or less,36,3,2,1,25,0,16,1,10,5,9,9,0,8,5,0,0,3
S01007121,All households,294,169,106,63,97,24,62,24,32,6,11,3,8,28,6,1,3,18
S01007121,Occupancy rating +2 or more,54,16,8,8,36,8,27,15,8,4,1,1,0,2,1,0,0,1
S01007121,Occupancy rating +1,48,22,9,13,23,3,16,5,10,1,4,2,2,3,1,0,1,1
S01007121,Occupancy rating 0,152,112,78,34,29,10,15,4,10,1,4,0,4,11,1,1,1,8
S01007121,Occupancy rating -1 or less,40,19,11,8,9,3,4,0,4,0,2,0,2,12,3,0,1,8
S01007122,All households,287,124,47,77,156,23,110,38,47,25,23,15,8,7,2,0,1,4
S01007122,Occupancy rating +2 or more,125,35,18,17,87,18,63,26,20,17,6,3,3,3,0,0,1,2
S01007122,Occupancy rating +1,57,31,9,22,26,3,22,6,11,5,1,0,1,0,0,0,0,0
S01007122,Occupancy rating 0,82,50,19,31,29,2,18,5,11,2,9,7,2,3,1,0,0,2
S01007122,Occupancy rating -1 or less,23,8,1,7,14,0,7,1,5,1,7,5,2,1,1,0,0,0
S01007123,All households,313,125,54,71,180,33,124,45,61,18,23,10,13,8,2,0,2,4
S01007123,Occupancy rating +2 or more,89,38,17,21,51,11,35,20,12,3,5,1,4,0,0,0,0,0
S01007123,Occupancy rating +1,138,61,31,30,73,19,50,24,16,10,4,1,3,4,1,0,2,1
S01007123,Occupancy rating 0,73,22,5,17,48,2,33,1,28,4,13,7,6,3,0,0,0,3
S01007123,Occupancy rating -1 or less,13,4,1,3,8,1,6,0,5,1,1,1,0,1,1,0,0,0
S01007124,All households,380,94,40,54,270,37,194,70,90,34,39,22,17,16,4,0,1,11
S01007124,Occupancy rating +2 or more,140,46,21,25,90,15,71,49,19,3,4,3,1,4,1,0,1,2
S01007124,Occupancy rating +1,126,44,17,27,79,22,52,20,17,15,5,3,2,3,0,0,0,3
S01007124,Occupancy rating 0,88,2,0,2,83,0,57,0,43,14,26,13,13,3,1,0,0,2
S01007124,Occupancy rating -1 or less,26,2,2,0,18,0,14,1,11,2,4,3,1,6,2,0,0,4
S01007125,All households,351,106,45,61,221,35,144,46,77,21,42,30,12,24,13,0,0,11
S01007125,Occupancy rating +2 or more,122,46,21,25,71,20,47,28,16,3,4,3,1,5,2,0,0,3
S01007125,Occupancy rating +1,114,43,17,26,71,10,47,13,22,12,14,10,4,0,0,0,0,0
S01007125,Occupancy rating 0,90,16,6,10,63,5,39,4,30,5,19,14,5,11,5,0,0,6
S01007125,Occupancy rating -1 or less,25,1,1,0,16,0,11,1,9,1,5,3,2,8,6,0,0,2
S01007126,All households,399,145,43,102,218,10,145,40,89,16,63,35,28,36,14,0,2,20
S01007126,Occupancy rating +2 or more,77,27,8,19,48,6,34,21,9,4,8,4,4,2,1,0,1,0
S01007126,Occupancy rating +1,116,69,21,48,46,3,34,15,14,5,9,3,6,1,1,0,0,0
S01007126,Occupancy rating 0,145,38,12,26,93,1,56,2,48,6,36,25,11,14,1,0,1,12
S01007126,Occupancy rating -1 or less,61,11,2,9,31,0,21,2,18,1,10,3,7,19,11,0,0,8
S01007127,All households,446,164,43,121,215,16,159,71,74,14,40,27,13,67,21,0,2,44
S01007127,Occupancy rating +2 or more,103,37,10,27,62,6,51,33,14,4,5,4,1,4,3,0,0,1
S01007127,Occupancy rating +1,93,39,7,32,40,5,28,14,10,4,7,4,3,14,1,0,2,11
S01007127,Occupancy rating 0,155,65,23,42,71,5,49,12,34,3,17,12,5,19,2,0,0,17
S01007127,Occupancy rating -1 or less,95,23,3,20,42,0,31,12,16,3,11,7,4,30,15,0,0,15
S01007128,All households,411,173,89,84,222,38,147,51,65,31,37,26,11,16,7,0,1,8
S01007128,Occupancy rating +2 or more,75,26,13,13,47,16,29,22,5,2,2,1,1,2,2,0,0,0
S01007128,Occupancy rating +1,145,71,26,45,73,15,55,24,20,11,3,1,2,1,0,0,0,1
S01007128,Occupancy rating 0,148,54,30,24,85,5,53,3,32,18,27,20,7,9,2,0,1,6
S01007128,Occupancy rating -1 or less,43,22,20,2,17,2,10,2,8,0,5,4,1,4,3,0,0,1
S01007129,All households,374,68,27,41,294,36,236,98,113,25,22,18,4,12,3,0,1,8
S01007129,Occupancy rating +2 or more,292,45,20,25,238,31,197,93,88,16,10,7,3,9,2,0,1,6
S01007129,Occupancy rating +1,53,19,7,12,33,5,23,5,13,5,5,4,1,1,1,0,0,0
S01007129,Occupancy rating 0,25,3,0,3,21,0,15,0,11,4,6,6,0,1,0,0,0,1
S01007129,Occupancy rating -1 or less,4,1,0,1,2,0,1,0,1,0,1,1,0,1,0,0,0,1
S01007130,All households,280,91,51,40,178,42,120,44,50,26,16,6,10,11,6,0,1,4
S01007130,Occupancy rating +2 or more,124,30,17,13,90,20,64,25,28,11,6,2,4,4,2,0,1,1
S01007130,Occupancy rating +1,85,37,21,16,48,13,32,16,10,6,3,1,2,0,0,0,0,0
S01007130,Occupancy rating 0,51,20,12,8,29,6,19,2,9,8,4,1,3,2,0,0,0,2
S01007130,Occupancy rating -1 or less,20,4,1,3,11,3,5,1,3,1,3,2,1,5,4,0,0,1
S01007131,All households,341,98,63,35,232,39,176,81,66,29,17,13,4,11,7,0,0,4
S01007131,Occupancy rating +2 or more,199,47,23,24,149,22,121,70,36,15,6,4,2,3,2,0,0,1
S01007131,Occupancy rating +1,67,13,5,8,51,7,39,9,21,9,5,3,2,3,1,0,0,2
S01007131,Occupancy rating 0,64,33,31,2,27,10,13,1,8,4,4,4,0,4,3,0,0,1
S01007131,Occupancy rating -1 or less,11,5,4,1,5,0,3,1,1,1,2,2,0,1,1,0,0,0
S01007132,All households,297,73,34,39,218,44,157,71,65,21,17,12,5,6,3,0,0,3
S01007132,Occupancy rating +2 or more,185,38,20,18,144,34,105,55,37,13,5,5,0,3,1,0,0,2
S01007132,Occupancy rating +1,70,25,12,13,45,9,32,11,16,5,4,1,3,0,0,0,0,0
S01007132,Occupancy rating 0,30,5,1,4,22,1,15,4,9,2,6,4,2,3,2,0,0,1
S01007132,Occupancy rating -1 or less,12,5,1,4,7,0,5,1,3,1,2,2,0,0,0,0,0,0
S01007133,All households,262,55,21,34,195,29,153,58,72,23,13,9,4,12,3,0,0,9
S01007133,Occupancy rating +2 or more,188,34,13,21,148,23,120,47,56,17,5,2,3,6,2,0,0,4
S01007133,Occupancy rating +1,44,14,4,10,27,4,22,11,7,4,1,1,0,3,1,0,0,2
S01007133,Occupancy rating 0,21,7,4,3,11,1,9,0,7,2,1,1,0,3,0,0,0,3
S01007133,Occupancy rating -1 or less,9,0,0,0,9,1,2,0,2,0,6,5,1,0,0,0,0,0
S01007134,All households,317,85,41,44,217,20,175,80,67,28,22,11,11,15,10,0,1,4
S01007134,Occupancy rating +2 or more,188,37,15,22,143,16,117,60,38,19,10,5,5,8,5,0,1,2
S01007134,Occupancy rating +1,68,22,12,10,44,4,36,16,15,5,4,1,3,2,2,0,0,0
S01007134,Occupancy rating 0,48,21,12,9,23,0,18,3,11,4,5,3,2,4,2,0,0,2
S01007134,Occupancy rating -1 or less,13,5,2,3,7,0,4,1,3,0,3,2,1,1,1,0,0,0
S01007135,All households,221,51,24,27,154,19,126,53,58,15,9,6,3,16,8,0,0,8
S01007135,Occupancy rating +2 or more,166,34,20,14,123,17,102,47,42,13,4,3,1,9,5,0,0,4
S01007135,Occupancy rating +1,30,11,3,8,18,1,13,2,9,2,4,2,2,1,1,0,0,0
S01007135,Occupancy rating 0,20,5,1,4,12,1,10,3,7,0,1,1,0,3,0,0,0,3
S01007135,Occupancy rating -1 or less,5,1,0,1,1,0,1,1,0,0,0,0,0,3,2,0,0,1
S01007136,All households,185,16,8,8,162,18,131,53,63,15,13,10,3,7,4,0,0,3
S01007136,Occupancy rating +2 or more,166,12,7,5,149,18,123,51,57,15,8,8,0,5,2,0,0,3
S01007136,Occupancy rating +1,15,3,1,2,10,0,6,2,4,0,4,1,3,2,2,0,0,0
S01007136,Occupancy rating 0,3,1,0,1,2,0,1,0,1,0,1,1,0,0,0,0,0,0
S01007136,Occupancy rating -1 or less,1,0,0,0,1,0,1,0,1,0,0,0,0,0,0,0,0,0
S01007137,All households,248,24,3,21,217,7,198,54,126,18,12,10,2,7,4,0,0,3
S01007137,Occupancy rating +2 or more,213,17,3,14,192,7,176,47,113,16,9,7,2,4,3,0,0,1
S01007137,Occupancy rating +1,12,1,0,1,9,0,8,2,4,2,1,1,0,2,1,0,0,1
S01007137,Occupancy rating 0,18,4,0,4,13,0,11,5,6,0,2,2,0,1,0,0,0,1
S01007137,Occupancy rating -1 or less,5,2,0,2,3,0,3,0,3,0,0,0,0,0,0,0,0,0
S01007138,All households,243,55,25,30,180,28,140,56,64,20,12,9,3,8,5,0,0,3
S01007138,Occupancy rating +2 or more,156,24,11,13,125,22,96,44,40,12,7,4,3,7,5,0,0,2
S01007138,Occupancy rating +1,48,20,14,6,28,4,23,7,10,6,1,1,0,0,0,0,0,0
S01007138,Occupancy rating 0,34,10,0,10,23,2,18,5,11,2,3,3,0,1,0,0,0,1
S01007138,Occupancy rating -1 or less,5,1,0,1,4,0,3,0,3,0,1,1,0,0,0,0,0,0
S01007139,All households,324,66,32,34,253,42,187,84,83,20,24,18,6,5,1,0,1,3
S01007139,Occupancy rating +2 or more,183,29,15,14,152,31,109,65,39,5,12,9,3,2,0,0,0,2
S01007139,Occupancy rating +1,85,22,12,10,63,8,48,17,24,7,7,4,3,0,0,0,0,0
S01007139,Occupancy rating 0,47,11,5,6,33,2,27,2,17,8,4,4,0,3,1,0,1,1
S01007139,Occupancy rating -1 or less,9,4,0,4,5,1,3,0,3,0,1,1,0,0,0,0,0,0
S01007140,All households,405,84,42,42,308,44,234,100,97,37,30,21,9,13,4,0,0,9
S01007140,Occupancy rating +2 or more,260,49,28,21,207,35,161,79,61,21,11,9,2,4,2,0,0,2
S01007140,Occupancy rating +1,106,32,12,20,68,8,53,18,25,10,7,5,2,6,2,0,0,4
S01007140,Occupancy rating 0,33,3,2,1,29,1,17,2,10,5,11,7,4,1,0,0,0,1
S01007140,Occupancy rating -1 or less,6,0,0,0,4,0,3,1,1,1,1,0,1,2,0,0,0,2
S01007141,All households,249,37,21,16,202,24,161,56,77,28,17,7,10,10,5,0,1,4
S01007141,Occupancy rating +2 or more,174,26,19,7,144,17,119,47,55,17,8,4,4,4,3,0,1,0
S01007141,Occupancy rating +1,45,8,1,7,35,6,24,6,12,6,5,2,3,2,0,0,0,2
S01007141,Occupancy rating 0,25,2,0,2,20,1,15,3,7,5,4,1,3,3,1,0,0,2
S01007141,Occupancy rating -1 or less,5,1,1,0,3,0,3,0,3,0,0,0,0,1,1,0,0,0
S01007142,All households,153,7,2,5,140,0,135,13,110,12,5,5,0,6,6,0,0,0
S01007142,Occupancy rating +2 or more,133,6,2,4,124,0,121,13,97,11,3,3,0,3,3,0,0,0
S01007142,Occupancy rating +1,13,0,0,0,12,0,12,0,11,1,0,0,0,1,1,0,0,0
S01007142,Occupancy rating 0,6,1,0,1,4,0,2,0,2,0,2,2,0,1,1,0,0,0
S01007142,Occupancy rating -1 or less,1,0,0,0,0,0,0,0,0,0,0,0,0,1,1,0,0,0
S01007143,All households,203,7,2,5,191,7,170,28,132,10,14,9,5,5,2,0,0,3
S01007143,Occupancy rating +2 or more,152,7,2,5,142,6,130,26,97,7,6,5,1,3,1,0,0,2
S01007143,Occupancy rating +1,38,0,0,0,36,1,30,2,27,1,5,2,3,2,1,0,0,1
S01007143,Occupancy rating 0,11,0,0,0,11,0,8,0,6,2,3,2,1,0,0,0,0,0
S01007143,Occupancy rating -1 or less,2,0,0,0,2,0,2,0,2,0,0,0,0,0,0,0,0,0
S01007144,All households,240,53,20,33,166,27,126,62,43,21,13,8,5,21,7,0,1,13
S01007144,Occupancy rating +2 or more,141,31,15,16,102,22,78,43,25,10,2,2,0,8,5,0,0,3
S01007144,Occupancy rating +1,57,17,3,14,39,4,32,16,9,7,3,1,2,1,0,0,0,1
S01007144,Occupancy rating 0,31,3,0,3,20,1,14,3,8,3,5,2,3,8,2,0,1,5
S01007144,Occupancy rating -1 or less,11,2,2,0,5,0,2,0,1,1,3,3,0,4,0,0,0,4
S01007145,All households,408,123,84,39,272,70,176,77,58,41,26,15,11,13,6,0,2,5
S01007145,Occupancy rating +2 or more,225,54,41,13,163,50,108,60,28,20,5,3,2,8,3,0,1,4
S01007145,Occupancy rating +1,107,30,21,9,75,16,46,14,15,17,13,6,7,2,0,0,1,1
S01007145,Occupancy rating 0,65,36,21,15,28,4,17,3,10,4,7,6,1,1,1,0,0,0
S01007145,Occupancy rating -1 or less,11,3,1,2,6,0,5,0,5,0,1,0,1,2,2,0,0,0
S01007146,All households,334,102,61,41,222,42,146,52,68,26,34,21,13,10,5,0,1,4
S01007146,Occupancy rating +2 or more,169,44,24,20,121,29,86,32,43,11,6,4,2,4,1,0,1,2
S01007146,Occupancy rating +1,111,47,29,18,62,10,41,19,11,11,11,3,8,2,2,0,0,0
S01007146,Occupancy rating 0,43,11,8,3,30,2,17,1,13,3,11,10,1,2,1,0,0,1
S01007146,Occupancy rating -1 or less,11,0,0,0,9,1,2,0,1,1,6,4,2,2,1,0,0,1
S01007147,All households,305,68,40,28,228,51,152,68,54,30,25,12,13,9,5,1,0,3
S01007147,Occupancy rating +2 or more,164,38,21,17,122,32,88,51,25,12,2,1,1,4,2,0,0,2
S01007147,Occupancy rating +1,92,27,16,11,63,16,42,15,15,12,5,2,3,2,1,0,0,1
S01007147,Occupancy rating 0,42,3,3,0,37,3,17,1,13,3,17,9,8,2,2,0,0,0
S01007147,Occupancy rating -1 or less,7,0,0,0,6,0,5,1,1,3,1,0,1,1,0,1,0,0
S01007148,All households,204,24,14,10,173,19,138,59,55,24,16,10,6,7,2,0,0,5
S01007148,Occupancy rating +2 or more,131,16,9,7,113,16,92,48,27,17,5,3,2,2,0,0,0,2
S01007148,Occupancy rating +1,52,7,5,2,44,2,35,11,18,6,7,4,3,1,0,0,0,1
S01007148,Occupancy rating 0,16,1,0,1,13,1,9,0,8,1,3,2,1,2,1,0,0,1
S01007148,Occupancy rating -1 or less,5,0,0,0,3,0,2,0,2,0,1,1,0,2,1,0,0,1
S01007149,All households,237,55,28,27,178,45,123,61,37,25,10,6,4,4,2,0,0,2
S01007149,Occupancy rating +2 or more,142,23,14,9,118,37,78,47,19,12,3,1,2,1,1,0,0,0
S01007149,Occupancy rating +1,73,30,12,18,42,8,33,12,10,11,1,1,0,1,0,0,0,1
S01007149,Occupancy rating 0,14,2,2,0,12,0,9,2,5,2,3,2,1,0,0,0,0,0
S01007149,Occupancy rating -1 or less,8,0,0,0,6,0,3,0,3,0,3,2,1,2,1,0,0,1
S01007150,All households,350,120,90,30,225,80,131,59,36,36,14,6,8,5,1,0,0,4
S01007150,Occupancy rating +2 or more,212,55,47,8,152,58,88,43,22,23,6,2,4,5,1,0,0,4
S01007150,Occupancy rating +1,96,46,30,16,50,17,28,11,7,10,5,2,3,0,0,0,0,0
S01007150,Occupancy rating 0,37,16,12,4,21,5,14,5,6,3,2,1,1,0,0,0,0,0
S01007150,Occupancy rating -1 or less,5,3,1,2,2,0,1,0,1,0,1,1,0,0,0,0,0,0
S01007151,All households,331,71,33,38,249,30,199,78,92,29,20,17,3,11,7,0,2,2
S01007151,Occupancy rating +2 or more,207,40,19,21,158,21,133,56,61,16,4,4,0,9,6,0,1,2
S01007151,Occupancy rating +1,83,29,12,17,54,8,41,19,17,5,5,4,1,0,0,0,0,0
S01007151,Occupancy rating 0,32,2,2,0,29,0,21,3,12,6,8,7,1,1,0,0,1,0
S01007151,Occupancy rating -1 or less,9,0,0,0,8,1,4,0,2,2,3,2,1,1,1,0,0,0
S01007152,All households,237,68,42,26,163,30,118,48,55,15,15,7,8,6,2,0,0,4
S01007152,Occupancy rating +2 or more,148,36,24,12,109,22,84,40,35,9,3,1,2,3,1,0,0,2
S01007152,Occupancy rating +1,47,15,10,5,31,5,23,6,14,3,3,2,1,1,1,0,0,0
S01007152,Occupancy rating 0,38,16,7,9,20,3,9,2,4,3,8,3,5,2,0,0,0,2
S01007152,Occupancy rating -1 or less,4,1,1,0,3,0,2,0,2,0,1,1,0,0,0,0,0,0
S01007153,All households,286,83,52,31,199,43,136,60,61,15,20,12,8,4,1,0,0,3
S01007153,Occupancy rating +2 or more,161,38,24,14,121,29,87,45,33,9,5,3,2,2,0,0,0,2
S01007153,Occupancy rating +1,71,26,13,13,44,7,30,11,15,4,7,5,2,1,0,0,0,1
S01007153,Occupancy rating 0,41,16,13,3,24,5,13,1,10,2,6,4,2,1,1,0,0,0
S01007153,Occupancy rating -1 or less,13,3,2,1,10,2,6,3,3,0,2,0,2,0,0,0,0,0
S01007154,All households,453,250,142,108,197,50,119,65,36,18,28,16,12,6,4,0,0,2
S01007154,Occupancy rating +2 or more,104,28,7,21,73,19,51,33,12,6,3,0,3,3,2,0,0,1
S01007154,Occupancy rating +1,148,86,45,41,61,15,40,23,11,6,6,4,2,1,1,0,0,0
S01007154,Occupancy rating 0,160,108,65,43,51,12,22,9,8,5,17,11,6,1,0,0,0,1
S01007154,Occupancy rating -1 or less,41,28,25,3,12,4,6,0,5,1,2,1,1,1,1,0,0,0
S01007155,All households,305,107,62,45,191,45,127,54,54,19,19,12,7,7,1,0,1,5
S01007155,Occupancy rating +2 or more,142,31,17,14,108,26,76,34,29,13,6,4,2,3,1,0,1,1
S01007155,Occupancy rating +1,79,32,18,14,46,8,33,15,12,6,5,5,0,1,0,0,0,1
S01007155,Occupancy rating 0,73,41,25,16,30,10,14,5,9,0,6,2,4,2,0,0,0,2
S01007155,Occupancy rating -1 or less,11,3,2,1,7,1,4,0,4,0,2,1,1,1,0,0,0,1
S01007156,All households,308,71,30,41,225,28,167,78,48,41,30,22,8,12,6,0,0,6
S01007156,Occupancy rating +2 or more,132,25,14,11,105,19,83,49,16,18,3,2,1,2,1,0,0,1
S01007156,Occupancy rating +1,93,37,12,25,55,9,41,23,10,8,5,4,1,1,0,0,0,1
S01007156,Occupancy rating 0,69,7,4,3,56,0,38,6,18,14,18,14,4,6,2,0,0,4
S01007156,Occupancy rating -1 or less,14,2,0,2,9,0,5,0,4,1,4,2,2,3,3,0,0,0
S01007157,All households,279,80,28,52,187,14,127,50,56,21,46,33,13,12,8,0,0,4
S01007157,Occupancy rating +2 or more,85,20,5,15,65,4,53,30,15,8,8,5,3,0,0,0,0,0
S01007157,Occupancy rating +1,97,37,14,23,58,4,42,16,19,7,12,7,5,2,0,0,0,2
S01007157,Occupancy rating 0,72,17,6,11,51,5,24,4,16,4,22,17,5,4,2,0,0,2
S01007157,Occupancy rating -1 or less,25,6,3,3,13,1,8,0,6,2,4,4,0,6,6,0,0,0
S01007158,All households,386,95,34,61,279,24,225,91,104,30,30,20,10,12,3,1,0,8
S01007158,Occupancy rating +2 or more,180,28,8,20,150,16,129,61,52,16,5,4,1,2,1,0,0,1
S01007158,Occupancy rating +1,119,45,17,28,73,8,58,26,26,6,7,4,3,1,0,0,0,1
S01007158,Occupancy rating 0,69,18,6,12,44,0,31,3,22,6,13,8,5,7,2,1,0,4
S01007158,Occupancy rating -1 or less,18,4,3,1,12,0,7,1,4,2,5,4,1,2,0,0,0,2
S01007159,All households,407,142,57,85,251,34,149,74,58,17,68,49,19,14,9,0,0,5
S01007159,Occupancy rating +2 or more,79,31,15,16,48,13,33,22,7,4,2,2,0,0,0,0,0,0
S01007159,Occupancy rating +1,143,62,23,39,81,18,53,30,19,4,10,2,8,0,0,0,0,0
S01007159,Occupancy rating 0,133,40,13,27,88,3,49,20,24,5,36,30,6,5,2,0,0,3
S01007159,Occupancy rating -1 or less,52,9,6,3,34,0,14,2,8,4,20,15,5,9,7,0,0,2
S01007160,All households,377,116,61,55,252,33,154,73,55,26,65,48,17,9,6,0,0,3
S01007160,Occupancy rating +2 or more,123,32,16,16,89,19,60,36,17,7,10,5,5,2,1,0,0,1
S01007160,Occupancy rating +1,96,35,21,14,60,11,37,24,5,8,12,8,4,1,1,0,0,0
S01007160,Occupancy rating 0,116,38,18,20,76,3,45,12,24,9,28,23,5,2,2,0,0,0
S01007160,Occupancy rating -1 or less,42,11,6,5,27,0,12,1,9,2,15,12,3,4,2,0,0,2
S01007161,All households,317,96,45,51,209,34,134,61,48,25,41,31,10,12,7,0,0,5
S01007161,Occupancy rating +2 or more,143,42,19,23,100,23,73,36,24,13,4,3,1,1,0,0,0,1
S01007161,Occupancy rating +1,89,30,16,14,55,8,35,19,7,9,12,8,4,4,3,0,0,1
S01007161,Occupancy rating 0,70,21,9,12,44,3,23,6,14,3,18,15,3,5,2,0,0,3
S01007161,Occupancy rating -1 or less,15,3,1,2,10,0,3,0,3,0,7,5,2,2,2,0,0,0
S01007162,All households,271,114,53,61,145,21,87,40,36,11,37,32,5,12,4,1,1,6
S01007162,Occupancy rating +2 or more,60,18,7,11,41,7,33,14,11,8,1,1,0,1,0,0,0,1
S01007162,Occupancy rating +1,88,46,17,29,40,9,27,18,8,1,4,4,0,2,0,0,0,2
S01007162,Occupancy rating 0,92,42,22,20,45,4,20,6,12,2,21,19,2,5,2,1,1,1
S01007162,Occupancy rating -1 or less,31,8,7,1,19,1,7,2,5,0,11,8,3,4,2,0,0,2
S01007163,All households,392,101,47,54,276,70,164,73,57,34,42,25,17,15,6,0,1,8
S01007163,Occupancy rating +2 or more,211,55,21,34,152,47,94,56,27,11,11,5,6,4,2,0,0,2
S01007163,Occupancy rating +1,109,32,18,14,72,19,42,13,13,16,11,4,7,5,3,0,0,2
S01007163,Occupancy rating 0,51,13,7,6,33,3,20,4,12,4,10,8,2,5,0,0,1,4
S01007163,Occupancy rating -1 or less,21,1,1,0,19,1,8,0,5,3,10,8,2,1,1,0,0,0
S01007164,All households,257,74,36,38,174,37,113,54,42,17,24,11,13,9,3,0,2,4
S01007164,Occupancy rating +2 or more,141,29,13,16,107,25,72,40,20,12,10,2,8,5,1,0,1,3
S01007164,Occupancy rating +1,54,17,8,9,36,8,25,11,13,1,3,1,2,1,0,0,0,1
S01007164,Occupancy rating 0,53,24,12,12,27,4,15,3,8,4,8,7,1,2,1,0,1,0
S01007164,Occupancy rating -1 or less,9,4,3,1,4,0,1,0,1,0,3,1,2,1,1,0,0,0
S01007165,All households,330,80,36,44,229,44,171,68,73,30,14,10,4,21,11,0,1,9
S01007165,Occupancy rating +2 or more,228,43,21,22,176,33,136,56,56,24,7,5,2,9,4,0,1,4
S01007165,Occupancy rating +1,53,19,6,13,31,8,20,8,9,3,3,2,1,3,1,0,0,2
S01007165,Occupancy rating 0,34,13,5,8,17,3,11,3,7,1,3,2,1,4,3,0,0,1
S01007165,Occupancy rating -1 or less,15,5,4,1,5,0,4,1,1,2,1,1,0,5,3,0,0,2
S01007166,All households,328,126,67,59,191,40,129,55,62,12,22,16,6,11,6,0,0,5
S01007166,Occupancy rating +2 or more,162,44,23,21,113,32,73,35,26,12,8,6,2,5,2,0,0,3
S01007166,Occupancy rating +1,90,42,22,20,46,4,36,14,22,0,6,4,2,2,2,0,0,0
S01007166,Occupancy rating 0,60,33,20,13,26,4,18,5,13,0,4,3,1,1,1,0,0,0
S01007166,Occupancy rating -1 or less,16,7,2,5,6,0,2,1,1,0,4,3,1,3,1,0,0,2
S01007167,All households,331,67,33,34,258,55,178,80,61,37,25,16,9,6,1,1,0,4
S01007167,Occupancy rating +2 or more,254,52,25,27,199,54,136,73,40,23,9,3,6,3,0,0,0,3
S01007167,Occupancy rating +1,53,11,6,5,41,1,28,4,13,11,12,10,2,1,0,0,0,1
S01007167,Occupancy rating 0,22,4,2,2,17,0,13,3,7,3,4,3,1,1,1,0,0,0
S01007167,Occupancy rating -1 or less,2,0,0,0,1,0,1,0,1,0,0,0,0,1,0,1,0,0
S01007168,All households,415,101,63,38,308,54,227,102,76,49,27,15,12,6,2,0,1,3
S01007168,Occupancy rating +2 or more,296,67,40,27,226,43,170,88,49,33,13,6,7,3,0,0,1,2
S01007168,Occupancy rating +1,95,34,23,11,59,10,40,11,16,13,9,6,3,2,1,0,0,1
S01007168,Occupancy rating 0,22,0,0,0,21,1,16,3,10,3,4,3,1,1,1,0,0,0
S01007168,Occupancy rating -1 or less,2,0,0,0,2,0,1,0,1,0,1,0,1,0,0,0,0,0
S01007169,All households,326,102,68,34,216,33,158,55,68,35,25,15,10,8,3,0,0,5
S01007169,Occupancy rating +2 or more,186,48,25,23,134,17,108,54,36,18,9,5,4,4,2,0,0,2
S01007169,Occupancy rating +1,72,23,15,8,47,9,28,1,15,12,10,6,4,2,0,0,0,2
S01007169,Occupancy rating 0,61,28,26,2,32,7,20,0,15,5,5,4,1,1,0,0,0,1
S01007169,Occupancy rating -1 or less,7,3,2,1,3,0,2,0,2,0,1,0,1,1,1,0,0,0
S01007170,All households,268,65,29,36,192,17,162,81,52,29,13,10,3,11,4,0,0,7
S01007170,Occupancy rating +2 or more,188,42,18,24,140,16,119,69,26,24,5,4,1,6,2,0,0,4
S01007170,Occupancy rating +1,50,16,8,8,33,1,28,11,15,2,4,3,1,1,0,0,0,1
S01007170,Occupancy rating 0,22,6,3,3,15,0,13,1,9,3,2,1,1,1,1,0,0,0
S01007170,Occupancy rating -1 or less,8,1,0,1,4,0,2,0,2,0,2,2,0,3,1,0,0,2
S01007171,All households,364,105,38,67,236,31,184,104,55,25,21,10,11,23,7,1,0,15
S01007171,Occupancy rating +2 or more,203,51,27,24,144,27,106,64,25,17,11,4,7,8,4,0,0,4
S01007171,Occupancy rating +1,82,28,7,21,53,3,44,24,15,5,6,5,1,1,0,0,0,1
S01007171,Occupancy rating 0,52,16,2,14,31,1,27,13,11,3,3,1,2,5,1,1,0,3
S01007171,Occupancy rating -1 or less,27,10,2,8,8,0,7,3,4,0,1,0,1,9,2,0,0,7
S01007172,All households,333,61,28,33,261,48,198,111,60,27,15,11,4,11,5,0,1,5
S01007172,Occupancy rating +2 or more,247,44,23,21,196,40,149,90,39,20,7,6,1,7,3,0,1,3
S01007172,Occupancy rating +1,52,9,4,5,41,8,29,15,12,2,4,3,1,2,0,0,0,2
S01007172,Occupancy rating 0,28,7,1,6,20,0,16,6,6,4,4,2,2,1,1,0,0,0
S01007172,Occupancy rating -1 or less,6,1,0,1,4,0,4,0,3,1,0,0,0,1,1,0,0,0
S01007173,All households,327,47,18,29,271,14,224,87,111,26,33,24,9,9,2,0,0,7
S01007173,Occupancy rating +2 or more,182,21,9,12,157,8,140,71,58,11,9,9,0,4,2,0,0,2
S01007173,Occupancy rating +1,93,20,6,14,70,4,57,15,32,10,9,7,2,3,0,0,0,3
S01007173,Occupancy rating 0,44,5,3,2,39,2,25,1,19,5,12,5,7,0,0,0,0,0
S01007173,Occupancy rating -1 or less,8,1,0,1,5,0,2,0,2,0,3,3,0,2,0,0,0,2
S01007174,All households,286,43,18,25,229,13,182,61,103,18,34,30,4,14,11,0,0,3
S01007174,Occupancy rating +2 or more,148,15,5,10,128,8,114,39,63,12,6,4,2,5,3,0,0,2
S01007174,Occupancy rating +1,79,19,7,12,59,5,50,22,24,4,4,4,0,1,0,0,0,1
S01007174,Occupancy rating 0,45,9,6,3,33,0,12,0,12,0,21,19,2,3,3,0,0,0
S01007174,Occupancy rating -1 or less,14,0,0,0,9,0,6,0,4,2,3,3,0,5,5,0,0,0
S01007175,All households,294,77,57,20,214,55,138,63,58,17,21,14,7,3,2,0,0,1
S01007175,Occupancy rating +2 or more,140,33,24,9,107,35,68,42,19,7,4,3,1,0,0,0,0,0
S01007175,Occupancy rating +1,91,30,20,10,61,14,44,19,21,4,3,2,1,0,0,0,0,0
S01007175,Occupancy rating 0,53,12,12,0,40,6,22,1,15,6,12,9,3,1,1,0,0,0
S01007175,Occupancy rating -1 or less,10,2,1,1,6,0,4,1,3,0,2,0,2,2,1,0,0,1
S01007176,All households,290,65,43,22,216,33,156,59,78,19,27,18,9,9,5,0,2,2
S01007176,Occupancy rating +2 or more,133,30,22,8,102,21,78,45,29,4,3,2,1,1,0,0,1,0
S01007176,Occupancy rating +1,78,27,17,10,49,10,35,10,20,5,4,2,2,2,1,0,1,0
S01007176,Occupancy rating 0,71,7,3,4,58,2,39,4,26,9,17,12,5,6,4,0,0,2
S01007176,Occupancy rating -1 or less,8,1,1,0,7,0,4,0,3,1,3,2,1,0,0,0,0,0
S01007177,All households,303,110,37,73,187,32,107,41,51,15,48,35,13,6,4,0,0,2
S01007177,Occupancy rating +2 or more,54,16,8,8,38,11,25,13,8,4,2,1,1,0,0,0,0,0
S01007177,Occupancy rating +1,106,40,10,30,66,10,41,20,16,5,15,10,5,0,0,0,0,0
S01007177,Occupancy rating 0,121,52,19,33,66,10,34,6,23,5,22,16,6,3,1,0,0,2
S01007177,Occupancy rating -1 or less,22,2,0,2,17,1,7,2,4,1,9,8,1,3,3,0,0,0
S01007178,All households,505,198,57,141,288,36,165,70,66,29,87,64,23,19,12,0,0,7
S01007178,Occupancy rating +2 or more,97,35,13,22,61,17,39,18,14,7,5,1,4,1,1,0,0,0
S01007178,Occupancy rating +1,124,43,13,30,75,7,56,31,16,9,12,8,4,6,3,0,0,3
S01007178,Occupancy rating 0,235,110,29,81,121,11,52,18,23,11,58,46,12,4,1,0,0,3
S01007178,Occupancy rating -1 or less,49,10,2,8,31,1,18,3,13,2,12,9,3,8,7,0,0,1
S01007179,All households,384,79,38,41,292,64,212,91,70,51,16,9,7,13,7,0,1,5
S01007179,Occupancy rating +2 or more,278,55,26,29,215,49,154,78,46,30,12,6,6,8,4,0,1,3
S01007179,Occupancy rating +1,75,20,12,8,53,12,38,11,13,14,3,3,0,2,2,0,0,0
S01007179,Occupancy rating 0,25,4,0,4,19,3,16,2,8,6,0,0,0,2,0,0,0,2
S01007179,Occupancy rating -1 or less,6,0,0,0,5,0,4,0,3,1,1,0,1,1,1,0,0,0
S01007180,All households,347,105,70,35,236,73,145,63,62,20,18,10,8,6,2,0,0,4
S01007180,Occupancy rating +2 or more,238,68,52,16,168,62,103,56,34,13,3,2,1,2,1,0,0,1
S01007180,Occupancy rating +1,58,18,13,5,39,9,25,5,15,5,5,3,2,1,0,0,0,1
S01007180,Occupancy rating 0,44,16,4,12,25,1,14,2,11,1,10,5,5,3,1,0,0,2
S01007180,Occupancy rating -1 or less,7,3,1,2,4,1,3,0,2,1,0,0,0,0,0,0,0,0
S01007181,All households,317,83,43,40,220,44,158,73,59,26,18,14,4,14,9,0,0,5
S01007181,Occupancy rating +2 or more,215,37,19,18,171,35,126,65,39,22,10,7,3,7,4,0,0,3
S01007181,Occupancy rating +1,48,18,9,9,26,5,20,7,11,2,1,1,0,4,3,0,0,1
S01007181,Occupancy rating 0,45,26,14,12,17,4,9,1,6,2,4,3,1,2,1,0,0,1
S01007181,Occupancy rating -1 or less,9,2,1,1,6,0,3,0,3,0,3,3,0,1,1,0,0,0
S01007182,All households,526,229,104,125,280,47,186,85,69,32,47,30,17,17,7,0,2,8
S01007182,Occupancy rating +2 or more,223,63,30,33,155,32,118,53,46,19,5,2,3,5,3,0,1,1
S01007182,Occupancy rating +1,150,89,36,53,60,11,40,22,10,8,9,5,4,1,0,0,0,1
S01007182,Occupancy rating 0,128,69,36,33,56,3,27,10,12,5,26,18,8,3,0,0,1,2
S01007182,Occupancy rating -1 or less,25,8,2,6,9,1,1,0,1,0,7,5,2,8,4,0,0,4
S01007183,All households,560,240,122,118,312,64,206,106,78,22,42,25,17,8,2,0,1,5
S01007183,Occupancy rating +2 or more,162,42,20,22,120,32,80,49,24,7,8,3,5,0,0,0,0,0
S01007183,Occupancy rating +1,188,95,45,50,91,19,69,43,20,6,3,2,1,2,1,0,0,1
S01007183,Occupancy rating 0,165,86,49,37,76,13,42,11,25,6,21,15,6,3,0,0,1,2
S01007183,Occupancy rating -1 or less,45,17,8,9,25,0,15,3,9,3,10,5,5,3,1,0,0,2
S01007184,All households,594,321,118,203,261,34,175,92,60,23,52,31,21,12,3,0,1,8
S01007184,Occupancy rating +2 or more,134,54,20,34,80,17,53,33,16,4,10,7,3,0,0,0,0,0
S01007184,Occupancy rating +1,160,76,28,48,82,8,59,29,19,11,15,7,8,2,1,0,1,0
S01007184,Occupancy rating 0,248,165,63,102,78,7,54,27,19,8,17,10,7,5,0,0,0,5
S01007184,Occupancy rating -1 or less,52,26,7,19,21,2,9,3,6,0,10,7,3,5,2,0,0,3
S01007185,All households,422,194,75,119,214,16,128,56,56,16,70,52,18,14,8,0,0,6
S01007185,Occupancy rating +2 or more,89,35,15,20,52,9,39,23,11,5,4,1,3,2,2,0,0,0
S01007185,Occupancy rating +1,102,45,13,32,53,6,34,20,10,4,13,7,6,4,0,0,0,4
S01007185,Occupancy rating 0,196,103,42,61,89,1,49,13,29,7,39,32,7,4,3,0,0,1
S01007185,Occupancy rating -1 or less,35,11,5,6,20,0,6,0,6,0,14,12,2,4,3,0,0,1
S01007186,All households,327,174,44,130,144,7,97,46,44,7,40,26,14,9,3,0,0,6
S01007186,Occupancy rating +2 or more,49,18,4,14,29,3,25,15,7,3,1,1,0,2,0,0,0,2
S01007186,Occupancy rating +1,67,37,12,25,30,1,21,8,12,1,8,7,1,0,0,0,0,0
S01007186,Occupancy rating 0,170,101,25,76,65,2,39,18,21,0,24,17,7,4,1,0,0,3
S01007186,Occupancy rating -1 or less,41,18,3,15,20,1,12,5,4,3,7,1,6,3,2,0,0,1
S01007187,All households,498,302,112,190,181,24,116,61,40,15,41,29,12,15,2,1,1,11
S01007187,Occupancy rating +2 or more,96,44,20,24,50,11,37,23,11,3,2,1,1,2,0,0,1,1
S01007187,Occupancy rating +1,115,80,23,57,33,5,24,14,6,4,4,3,1,2,0,0,0,2
S01007187,Occupancy rating 0,208,130,59,71,72,6,40,21,12,7,26,19,7,6,0,1,0,5
S01007187,Occupancy rating -1 or less,79,48,10,38,26,2,15,3,11,1,9,6,3,5,2,0,0,3
S01007188,All households,328,162,37,125,152,14,110,62,34,14,28,21,7,14,5,0,1,8
S01007188,Occupancy rating +2 or more,87,34,12,22,50,5,41,23,12,6,4,1,3,3,1,0,0,2
S01007188,Occupancy rating +1,97,56,15,41,38,5,30,22,5,3,3,3,0,3,2,0,0,1
S01007188,Occupancy rating 0,107,54,10,44,49,4,29,11,14,4,16,12,4,4,1,0,1,2
S01007188,Occupancy rating -1 or less,37,18,0,18,15,0,10,6,3,1,5,5,0,4,1,0,0,3
S01007189,All households,461,273,138,135,175,26,131,70,45,16,18,17,1,13,5,0,2,6
S01007189,Occupancy rating +2 or more,131,39,22,17,86,14,71,45,18,8,1,1,0,6,3,0,1,2
S01007189,Occupancy rating +1,73,31,10,21,40,6,30,12,13,5,4,3,1,2,0,0,0,2
S01007189,Occupancy rating 0,197,158,96,62,38,5,24,13,9,2,9,9,0,1,0,0,0,1
S01007189,Occupancy rating -1 or less,60,45,10,35,11,1,6,0,5,1,4,4,0,4,2,0,1,1
S01007190,All households,378,113,84,29,260,67,165,80,57,28,28,15,13,5,2,0,0,3
S01007190,Occupancy rating +2 or more,193,54,40,14,139,45,89,65,19,5,5,2,3,0,0,0,0,0
S01007190,Occupancy rating +1,92,17,12,5,73,8,50,13,24,13,15,8,7,2,1,0,0,1
S01007190,Occupancy rating 0,79,38,28,10,38,13,20,2,11,7,5,2,3,3,1,0,0,2
S01007190,Occupancy rating -1 or less,14,4,4,0,10,1,6,0,3,3,3,3,0,0,0,0,0,0
S01007191,All households,274,81,37,44,176,24,122,56,43,23,30,22,8,17,4,0,0,13
S01007191,Occupancy rating +2 or more,83,22,11,11,60,14,43,29,7,7,3,2,1,1,0,0,0,1
S01007191,Occupancy rating +1,73,28,20,8,43,6,29,17,9,3,8,6,2,2,0,0,0,2
S01007191,Occupancy rating 0,83,25,4,21,50,3,36,8,18,10,11,8,3,8,2,0,0,6
S01007191,Occupancy rating -1 or less,35,6,2,4,23,1,14,2,9,3,8,6,2,6,2,0,0,4
S01007192,All households,286,101,37,64,173,16,107,49,40,18,50,31,19,12,6,0,1,5
S01007192,Occupancy rating +2 or more,71,25,11,14,43,10,29,22,4,3,4,0,4,3,2,0,0,1
S01007192,Occupancy rating +1,90,38,14,24,49,5,35,18,10,7,9,4,5,3,1,0,1,1
S01007192,Occupancy rating 0,85,32,10,22,52,0,30,7,16,7,22,16,6,1,0,0,0,1
S01007192,Occupancy rating -1 or less,40,6,2,4,29,1,13,2,10,1,15,11,4,5,3,0,0,2
S01007193,All households,289,59,32,27,209,22,141,39,68,34,46,25,21,21,10,0,1,10
S01007193,Occupancy rating +2 or more,94,34,20,14,57,13,42,32,4,6,2,2,0,3,0,0,1,2
S01007193,Occupancy rating +1,114,22,10,12,84,8,55,5,30,20,21,7,14,8,3,0,0,5
S01007193,Occupancy rating 0,61,3,2,1,53,1,37,2,28,7,15,11,4,5,3,0,0,2
S01007193,Occupancy rating -1 or less,20,0,0,0,15,0,7,0,6,1,8,5,3,5,4,0,0,1
S01007194,All households,276,87,34,53,178,17,92,40,45,7,69,54,15,11,2,0,0,9
S01007194,Occupancy rating +2 or more,55,17,9,8,38,10,24,20,4,0,4,2,2,0,0,0,0,0
S01007194,Occupancy rating +1,79,28,9,19,51,5,27,15,8,4,19,14,5,0,0,0,0,0
S01007194,Occupancy rating 0,105,38,15,23,61,1,32,5,25,2,28,21,7,6,1,0,0,5
S01007194,Occupancy rating -1 or less,37,4,1,3,28,1,9,0,8,1,18,17,1,5,1,0,0,4
S01007195,All households,237,59,24,35,170,30,97,31,51,15,43,37,6,8,3,0,0,5
S01007195,Occupancy rating +2 or more,68,18,10,8,49,16,30,19,9,2,3,3,0,1,1,0,0,0
S01007195,Occupancy rating +1,85,24,10,14,57,10,30,10,13,7,17,13,4,4,1,0,0,3
S01007195,Occupancy rating 0,66,15,3,12,49,4,33,2,26,5,12,11,1,2,0,0,0,2
S01007195,Occupancy rating -1 or less,18,2,1,1,15,0,4,0,3,1,11,10,1,1,1,0,0,0
S01007196,All households,278,43,8,35,214,11,138,46,81,11,65,43,22,21,9,1,0,11
S01007196,Occupancy rating +2 or more,73,9,1,8,59,6,44,31,10,3,9,6,3,5,1,1,0,3
S01007196,Occupancy rating +1,93,24,7,17,64,4,47,15,29,3,13,9,4,5,2,0,0,3
S01007196,Occupancy rating 0,88,8,0,8,74,1,37,0,33,4,36,23,13,6,2,0,0,4
S01007196,Occupancy rating -1 or less,24,2,0,2,17,0,10,0,9,1,7,5,2,5,4,0,0,1
S01007197,All households,286,100,21,79,176,7,92,27,54,11,77,59,18,10,0,2,0,8
S01007197,Occupancy rating +2 or more,32,9,0,9,20,1,14,7,3,4,5,2,3,3,0,2,0,1
S01007197,Occupancy rating +1,76,35,8,27,40,2,23,11,11,1,15,11,4,1,0,0,0,1
S01007197,Occupancy rating 0,145,52,13,39,90,2,41,7,29,5,47,39,8,3,0,0,0,3
S01007197,Occupancy rating -1 or less,33,4,0,4,26,2,14,2,11,1,10,7,3,3,0,0,0,3
S01007198,All households,229,69,20,49,148,14,87,36,39,12,47,35,12,12,7,0,0,5
S01007198,Occupancy rating +2 or more,57,15,6,9,40,4,35,19,14,2,1,1,0,2,1,0,0,1
S01007198,Occupancy rating +1,74,33,8,25,39,10,22,11,5,6,7,3,4,2,0,0,0,2
S01007198,Occupancy rating 0,70,18,5,13,50,0,25,6,15,4,25,19,6,2,1,0,0,1
S01007198,Occupancy rating -1 or less,28,3,1,2,19,0,5,0,5,0,14,12,2,6,5,0,0,1
S01007199,All households,306,81,22,59,208,21,118,37,59,22,69,40,29,17,12,1,0,4
S01007199,Occupancy rating +2 or more,77,26,8,18,51,13,33,22,9,2,5,1,4,0,0,0,0,0
S01007199,Occupancy rating +1,89,30,6,24,56,6,36,11,15,10,14,7,7,3,0,1,0,2
S01007199,Occupancy rating 0,105,22,7,15,80,2,38,3,27,8,40,28,12,3,2,0,0,1
S01007199,Occupancy rating -1 or less,35,3,1,2,21,0,11,1,8,2,10,4,6,11,10,0,0,1
S01007200,All households,405,145,48,97,253,26,175,81,67,27,52,31,21,7,3,0,0,4
S01007200,Occupancy rating +2 or more,119,35,14,21,83,17,62,48,10,4,4,3,1,1,0,0,0,1
S01007200,Occupancy rating +1,132,37,15,22,95,5,71,24,35,12,19,10,9,0,0,0,0,0
S01007200,Occupancy rating 0,133,70,19,51,59,4,32,8,14,10,23,16,7,4,2,0,0,2
S01007200,Occupancy rating -1 or less,21,3,0,3,16,0,10,1,8,1,6,2,4,2,1,0,0,1
S01007201,All households,350,105,46,59,235,49,150,74,59,17,36,22,14,10,5,0,0,5
S01007201,Occupancy rating +2 or more,141,29,16,13,110,31,73,47,18,8,6,3,3,2,2,0,0,0
S01007201,Occupancy rating +1,98,36,15,21,60,12,41,22,15,4,7,4,3,2,0,0,0,2
S01007201,Occupancy rating 0,98,36,13,23,57,6,32,4,24,4,19,12,7,5,3,0,0,2
S01007201,Occupancy rating -1 or less,13,4,2,2,8,0,4,1,2,1,4,3,1,1,0,0,0,1
S01007202,All households,350,118,31,87,228,31,153,76,52,25,44,30,14,4,2,0,0,2
S01007202,Occupancy rating +2 or more,114,30,10,20,83,17,62,46,11,5,4,2,2,1,0,0,0,1
S01007202,Occupancy rating +1,120,46,11,35,73,9,53,23,16,14,11,4,7,1,0,0,0,1
S01007202,Occupancy rating 0,89,32,7,25,56,3,32,7,21,4,21,16,5,1,1,0,0,0
S01007202,Occupancy rating -1 or less,27,10,3,7,16,2,6,0,4,2,8,8,0,1,1,0,0,0
S01007203,All households,250,47,18,29,196,27,146,49,61,36,23,13,10,7,6,0,1,0
S01007203,Occupancy rating +2 or more,108,18,5,13,88,16,69,36,18,15,3,2,1,2,2,0,0,0
S01007203,Occupancy rating +1,73,10,3,7,63,9,46,10,25,11,8,3,5,0,0,0,0,0
S01007203,Occupancy rating 0,54,19,10,9,34,1,23,3,14,6,10,7,3,1,1,0,0,0
S01007203,Occupancy rating -1 or less,15,0,0,0,11,1,8,0,4,4,2,1,1,4,3,0,1,0
S01007204,All households,426,112,34,78,299,34,231,129,73,29,34,23,11,15,6,1,1,7
S01007204,Occupancy rating +2 or more,226,51,15,36,169,26,138,95,31,12,5,2,3,6,1,1,1,3
S01007204,Occupancy rating +1,110,35,11,24,75,7,62,26,23,13,6,3,3,0,0,0,0,0
S01007204,Occupancy rating 0,73,20,5,15,48,1,27,7,17,3,20,16,4,5,2,0,0,3
S01007204,Occupancy rating -1 or less,17,6,3,3,7,0,4,1,2,1,3,2,1,4,3,0,0,1
S01007205,All households,263,37,15,22,207,33,153,81,52,20,21,11,10,19,4,0,2,13
S01007205,Occupancy rating +2 or more,179,28,11,17,142,30,105,64,29,12,7,4,3,9,0,0,1,8
S01007205,Occupancy rating +1,49,8,4,4,36,3,25,15,6,4,8,5,3,5,1,0,1,3
S01007205,Occupancy rating 0,26,1,0,1,22,0,16,1,12,3,6,2,4,3,2,0,0,1
S01007205,Occupancy rating -1 or less,9,0,0,0,7,0,7,1,5,1,0,0,0,2,1,0,0,1
S01007206,All households,212,106,53,53,102,12,74,32,34,8,16,7,9,4,1,0,1,2
S01007206,Occupancy rating +2 or more,51,21,9,12,29,3,25,12,12,1,1,0,1,1,1,0,0,0
S01007206,Occupancy rating +1,88,45,19,26,42,5,34,17,14,3,3,0,3,1,0,0,0,1
S01007206,Occupancy rating 0,56,32,21,11,23,3,13,2,7,4,7,4,3,1,0,0,0,1
S01007206,Occupancy rating -1 or less,17,8,4,4,8,1,2,1,1,0,5,3,2,1,0,0,1,0
S01007207,All households,420,133,54,79,277,33,203,106,66,31,41,30,11,10,1,0,2,7
S01007207,Occupancy rating +2 or more,201,54,28,26,145,24,112,79,23,10,9,7,2,2,1,0,0,1
S01007207,Occupancy rating +1,119,48,14,34,66,7,51,20,20,11,8,5,3,5,0,0,1,4
S01007207,Occupancy rating 0,75,26,11,15,46,2,26,6,15,5,18,13,5,3,0,0,1,2
S01007207,Occupancy rating -1 or less,25,5,1,4,20,0,14,1,8,5,6,5,1,0,0,0,0,0
S01007208,All households,550,287,76,211,244,19,146,74,59,13,79,57,22,19,4,0,5,10
S01007208,Occupancy rating +2 or more,104,39,6,33,62,9,46,24,20,2,7,4,3,3,1,0,1,1
S01007208,Occupancy rating +1,166,95,21,74,67,7,48,34,10,4,12,7,5,4,0,0,2,2
S01007208,Occupancy rating 0,230,135,46,89,89,3,41,15,21,5,45,32,13,6,1,0,2,3
S01007208,Occupancy rating -1 or less,50,18,3,15,26,0,11,1,8,2,15,14,1,6,2,0,0,4
S01007209,All households,389,194,65,129,178,17,121,69,37,15,40,30,10,17,4,0,2,11
S01007209,Occupancy rating +2 or more,123,44,15,29,73,7,58,35,14,9,8,5,3,6,1,0,2,3
S01007209,Occupancy rating +1,114,57,23,34,54,7,38,24,11,3,9,7,2,3,0,0,0,3
S01007209,Occupancy rating 0,110,68,18,50,37,3,17,8,6,3,17,15,2,5,2,0,0,3
S01007209,Occupancy rating -1 or less,42,25,9,16,14,0,8,2,6,0,6,3,3,3,1,0,0,2
S01007210,All households,387,183,72,111,188,13,137,57,59,21,38,26,12,16,6,0,1,9
S01007210,Occupancy rating +2 or more,100,31,13,18,68,7,58,31,15,12,3,2,1,1,0,0,1,0
S01007210,Occupancy rating +1,78,39,11,28,36,2,27,14,11,2,7,4,3,3,0,0,0,3
S01007210,Occupancy rating 0,154,90,38,52,58,4,38,10,23,5,16,12,4,6,1,0,0,5
S01007210,Occupancy rating -1 or less,55,23,10,13,26,0,14,2,10,2,12,8,4,6,5,0,0,1
S01007211,All households,498,237,90,147,245,20,163,79,60,24,62,42,20,16,5,0,1,10
S01007211,Occupancy rating +2 or more,126,48,20,28,76,9,65,44,14,7,2,1,1,2,0,0,0,2
S01007211,Occupancy rating +1,142,65,26,39,72,8,47,20,19,8,17,11,6,5,0,0,1,4
S01007211,Occupancy rating 0,183,111,40,71,68,3,41,15,19,7,24,17,7,4,1,0,0,3
S01007211,Occupancy rating -1 or less,47,13,4,9,29,0,10,0,8,2,19,13,6,5,4,0,0,1
S01007212,All households,259,92,28,64,155,19,118,65,41,12,18,11,7,12,4,0,1,7
S01007212,Occupancy rating +2 or more,111,26,10,16,81,15,63,39,18,6,3,3,0,4,0,0,0,4
S01007212,Occupancy rating +1,76,42,16,26,32,2,27,17,8,2,3,2,1,2,1,0,1,0
S01007212,Occupancy rating 0,60,17,2,15,38,2,24,8,12,4,12,6,6,5,2,0,0,3
S01007212,Occupancy rating -1 or less,12,7,0,7,4,0,4,1,3,0,0,0,0,1,1,0,0,0
S01007213,All households,423,159,83,76,249,50,168,78,63,27,31,17,14,15,4,0,1,10
S01007213,Occupancy rating +2 or more,207,61,42,19,140,33,98,51,32,15,9,3,6,6,2,0,1,3
S01007213,Occupancy rating +1,107,50,19,31,52,14,32,15,12,5,6,3,3,5,1,0,0,4
S01007213,Occupancy rating 0,78,38,19,19,38,1,28,9,14,5,9,7,2,2,0,0,0,2
S01007213,Occupancy rating -1 or less,31,10,3,7,19,2,10,3,5,2,7,4,3,2,1,0,0,1
S01007214,All households,424,230,88,142,175,26,103,55,36,12,46,19,27,19,6,0,3,10
S01007214,Occupancy rating +2 or more,74,32,8,24,39,7,28,16,9,3,4,2,2,3,2,0,1,0
S01007214,Occupancy rating +1,113,56,20,36,55,11,32,19,11,2,12,5,7,2,0,0,0,2
S01007214,Occupancy rating 0,188,113,42,71,65,8,38,18,14,6,19,5,14,10,1,0,2,7
S01007214,Occupancy rating -1 or less,49,29,18,11,16,0,5,2,2,1,11,7,4,4,3,0,0,1
S01007215,All households,397,182,72,110,204,29,138,61,58,19,37,24,13,11,3,0,0,8
S01007215,Occupancy rating +2 or more,126,43,19,24,82,15,59,35,17,7,8,5,3,1,1,0,0,0
S01007215,Occupancy rating +1,81,33,11,22,45,4,32,13,13,6,9,4,5,3,0,0,0,3
S01007215,Occupancy rating 0,133,72,33,39,57,9,36,10,21,5,12,9,3,4,0,0,0,4
S01007215,Occupancy rating -1 or less,57,34,9,25,20,1,11,3,7,1,8,6,2,3,2,0,0,1
S01007216,All households,315,99,56,43,208,32,152,75,55,22,24,15,9,8,3,0,1,4
S01007216,Occupancy rating +2 or more,179,49,33,16,127,26,95,55,28,12,6,5,1,3,2,0,0,1
S01007216,Occupancy rating +1,68,28,15,13,39,3,29,11,14,4,7,3,4,1,0,0,0,1
S01007216,Occupancy rating 0,51,18,5,13,31,1,22,5,11,6,8,6,2,2,1,0,0,1
S01007216,Occupancy rating -1 or less,17,4,3,1,11,2,6,4,2,0,3,1,2,2,0,0,1,1
S01007217,All households,460,180,67,113,264,33,169,73,70,26,62,41,21,16,6,0,2,8
S01007217,Occupancy rating +2 or more,113,44,18,26,67,12,50,33,13,4,5,3,2,2,1,0,0,1
S01007217,Occupancy rating +1,159,71,34,37,84,16,56,31,18,7,12,7,5,4,1,0,1,2
S01007217,Occupancy rating 0,164,63,14,49,95,5,50,9,27,14,40,27,13,6,2,0,1,3
S01007217,Occupancy rating -1 or less,24,2,1,1,18,0,13,0,12,1,5,4,1,4,2,0,0,2
S01007218,All households,353,58,42,16,288,51,215,101,85,29,22,11,11,7,5,1,1,0
S01007218,Occupancy rating +2 or more,238,43,31,12,190,38,147,78,47,22,5,2,3,5,4,0,1,0
S01007218,Occupancy rating +1,71,13,9,4,57,12,44,19,19,6,1,0,1,1,1,0,0,0
S01007218,Occupancy rating 0,39,2,2,0,36,1,20,3,16,1,15,9,6,1,0,1,0,0
S01007218,Occupancy rating -1 or less,5,0,0,0,5,0,4,1,3,0,1,0,1,0,0,0,0,0
S01007219,All households,386,143,59,84,235,33,159,74,64,21,43,29,14,8,4,0,2,2
S01007219,Occupancy rating +2 or more,114,29,10,19,84,14,61,33,20,8,9,3,6,1,0,0,1,0
S01007219,Occupancy rating +1,112,38,16,22,71,6,55,29,19,7,10,7,3,3,3,0,0,0
S01007219,Occupancy rating 0,128,62,23,39,63,12,35,11,18,6,16,13,3,3,1,0,1,1
S01007219,Occupancy rating -1 or less,32,14,10,4,17,1,8,1,7,0,8,6,2,1,0,0,0,1
S01007220,All households,330,143,53,90,180,18,134,51,66,17,28,17,11,7,4,0,0,3
S01007220,Occupancy rating +2 or more,102,29,12,17,73,8,58,32,23,3,7,4,3,0,0,0,0,0
S01007220,Occupancy rating +1,75,25,10,15,47,5,38,13,19,6,4,2,2,3,2,0,0,1
S01007220,Occupancy rating 0,111,66,26,40,45,5,28,4,17,7,12,8,4,0,0,0,0,0
S01007220,Occupancy rating -1 or less,42,23,5,18,15,0,10,2,7,1,5,3,2,4,2,0,0,2
S01007221,All households,273,51,33,18,213,37,160,67,84,9,16,11,5,9,5,1,0,3
S01007221,Occupancy rating +2 or more,166,17,11,6,147,26,114,52,58,4,7,3,4,2,1,0,0,1
S01007221,Occupancy rating +1,66,28,16,12,35,9,24,7,14,3,2,2,0,3,2,0,0,1
S01007221,Occupancy rating 0,29,6,6,0,21,1,15,5,8,2,5,5,0,2,1,0,0,1
S01007221,Occupancy rating -1 or less,12,0,0,0,10,1,7,3,4,0,2,1,1,2,1,1,0,0
S01007222,All households,320,53,29,24,261,30,190,83,79,28,41,32,9,6,3,0,0,3
S01007222,Occupancy rating +2 or more,136,25,15,10,110,17,86,54,26,6,7,5,2,1,0,0,0,1
S01007222,Occupancy rating +1,95,22,10,12,72,9,54,23,18,13,9,8,1,1,0,0,0,1
S01007222,Occupancy rating 0,70,6,4,2,61,4,36,4,26,6,21,16,5,3,2,0,0,1
S01007222,Occupancy rating -1 or less,19,0,0,0,18,0,14,2,9,3,4,3,1,1,1,0,0,0
S01007223,All households,200,42,22,20,153,22,123,43,67,13,8,5,3,5,3,0,1,1
S01007223,Occupancy rating +2 or more,147,29,16,13,116,16,94,36,47,11,6,3,3,2,1,0,1,0
S01007223,Occupancy rating +1,36,9,4,5,27,6,19,7,11,1,2,2,0,0,0,0,0,0
S01007223,Occupancy rating 0,13,3,1,2,8,0,8,0,8,0,0,0,0,2,1,0,0,1
S01007223,Occupancy rating -1 or less,4,1,1,0,2,0,2,0,1,1,0,0,0,1,1,0,0,0
S01007224,All households,279,85,48,37,190,40,124,46,62,16,26,17,9,4,2,0,1,1
S01007224,Occupancy rating +2 or more,132,27,13,14,103,29,70,31,30,9,4,3,1,2,1,0,0,1
S01007224,Occupancy rating +1,65,22,11,11,43,7,31,14,15,2,5,1,4,0,0,0,0,0
S01007224,Occupancy rating 0,74,31,20,11,41,4,20,0,16,4,17,13,4,2,1,0,1,0
S01007224,Occupancy rating -1 or less,8,5,4,1,3,0,3,1,1,1,0,0,0,0,0,0,0,0
S01007225,All households,369,93,35,58,265,30,209,98,82,29,26,13,13,11,6,0,1,4
S01007225,Occupancy rating +2 or more,234,54,27,27,173,22,145,73,50,22,6,2,4,7,3,0,0,4
S01007225,Occupancy rating +1,81,32,6,26,48,7,35,19,12,4,6,1,5,1,0,0,1,0
S01007225,Occupancy rating 0,45,6,2,4,38,1,26,6,17,3,11,7,4,1,1,0,0,0
S01007225,Occupancy rating -1 or less,9,1,0,1,6,0,3,0,3,0,3,3,0,2,2,0,0,0
S01007226,All households,322,71,24,47,231,32,181,81,70,30,18,5,13,20,13,0,4,3
S01007226,Occupancy rating +2 or more,211,42,15,27,161,27,128,63,44,21,6,2,4,8,7,0,0,1
S01007226,Occupancy rating +1,62,20,6,14,38,2,30,15,8,7,6,2,4,4,1,0,2,1
S01007226,Occupancy rating 0,39,9,3,6,26,3,18,3,13,2,5,1,4,4,2,0,2,0
S01007226,Occupancy rating -1 or less,10,0,0,0,6,0,5,0,5,0,1,0,1,4,3,0,0,1
S01007227,All households,425,137,70,67,274,51,192,84,87,21,31,19,12,14,6,0,1,7
S01007227,Occupancy rating +2 or more,223,58,33,25,161,32,124,62,47,15,5,2,3,4,1,0,0,3
S01007227,Occupancy rating +1,105,40,25,15,62,13,40,15,22,3,9,5,4,3,2,0,0,1
S01007227,Occupancy rating 0,73,36,11,25,34,4,17,6,9,2,13,9,4,3,2,0,0,1
S01007227,Occupancy rating -1 or less,24,3,1,2,17,2,11,1,9,1,4,3,1,4,1,0,1,2
S01007228,All households,260,60,16,44,188,26,149,63,72,14,13,8,5,12,6,0,1,5
S01007228,Occupancy rating +2 or more,168,34,10,24,129,22,105,50,46,9,2,2,0,5,2,0,1,2
S01007228,Occupancy rating +1,64,20,2,18,40,4,28,10,13,5,8,5,3,4,2,0,0,2
S01007228,Occupancy rating 0,23,5,4,1,16,0,15,2,13,0,1,0,1,2,1,0,0,1
S01007228,Occupancy rating -1 or less,5,1,0,1,3,0,1,1,0,0,2,1,1,1,1,0,0,0
S01007229,All households,455,96,39,57,346,43,278,134,103,41,25,12,13,13,5,0,2,6
S01007229,Occupancy rating +2 or more,301,57,25,32,237,34,193,117,55,21,10,1,9,7,2,0,1,4
S01007229,Occupancy rating +1,86,24,9,15,60,8,46,13,20,13,6,3,3,2,1,0,0,1
S01007229,Occupancy rating 0,59,14,5,9,43,1,34,4,23,7,8,8,0,2,1,0,0,1
S01007229,Occupancy rating -1 or less,9,1,0,1,6,0,5,0,5,0,1,0,1,2,1,0,1,0
S01007230,All households,358,158,49,109,187,21,120,37,73,10,46,30,16,13,8,0,0,5
S01007230,Occupancy rating +2 or more,69,21,8,13,47,10,30,21,9,0,7,5,2,1,1,0,0,0
S01007230,Occupancy rating +1,101,44,18,26,54,8,34,13,19,2,12,3,9,3,1,0,0,2
S01007230,Occupancy rating 0,159,81,18,63,73,3,47,2,38,7,23,18,5,5,2,0,0,3
S01007230,Occupancy rating -1 or less,29,12,5,7,13,0,9,1,7,1,4,4,0,4,4,0,0,0
S01007231,All households,372,179,80,99,174,24,104,46,48,10,46,33,13,19,6,0,0,13
S01007231,Occupancy rating +2 or more,71,27,15,12,42,9,30,18,9,3,3,3,0,2,1,0,0,1
S01007231,Occupancy rating +1,93,47,15,32,42,8,27,15,10,2,7,4,3,4,2,0,0,2
S01007231,Occupancy rating 0,155,84,44,40,65,6,34,8,22,4,25,19,6,6,2,0,0,4
S01007231,Occupancy rating -1 or less,53,21,6,15,25,1,13,5,7,1,11,7,4,7,1,0,0,6
S01007232,All households,381,178,56,122,188,34,105,55,45,5,49,36,13,15,5,0,0,10
S01007232,Occupancy rating +2 or more,53,15,4,11,36,8,26,12,14,0,2,2,0,2,0,0,0,2
S01007232,Occupancy rating +1,121,64,22,42,54,12,36,29,4,3,6,3,3,3,1,0,0,2
S01007232,Occupancy rating 0,168,88,27,61,75,12,34,11,21,2,29,21,8,5,1,0,0,4
S01007232,Occupancy rating -1 or less,39,11,3,8,23,2,9,3,6,0,12,10,2,5,3,0,0,2
S01007233,All households,347,101,33,68,229,31,161,74,60,27,37,22,15,17,5,0,4,8
S01007233,Occupancy rating +2 or more,151,32,16,16,117,17,96,57,27,12,4,1,3,2,0,0,2,0
S01007233,Occupancy rating +1,77,20,6,14,52,11,31,12,13,6,10,6,4,5,2,0,1,2
S01007233,Occupancy rating 0,96,38,11,27,52,3,28,4,16,8,21,14,7,6,2,0,0,4
S01007233,Occupancy rating -1 or less,23,11,0,11,8,0,6,1,4,1,2,1,1,4,1,0,1,2
S01007234,All households,263,93,53,40,162,26,109,45,54,10,27,15,12,8,4,0,0,4
S01007234,Occupancy rating +2 or more,133,46,25,21,86,20,61,37,19,5,5,2,3,1,0,0,0,1
S01007234,Occupancy rating +1,57,20,12,8,34,4,22,4,14,4,8,3,5,3,1,0,0,2
S01007234,Occupancy rating 0,52,22,13,9,28,1,18,3,15,0,9,6,3,2,1,0,0,1
S01007234,Occupancy rating -1 or less,21,5,3,2,14,1,8,1,6,1,5,4,1,2,2,0,0,0
S01007235,All households,407,181,85,96,215,39,135,71,48,16,41,27,14,11,4,0,0,7
S01007235,Occupancy rating +2 or more,130,37,12,25,90,19,63,37,21,5,8,3,5,3,2,0,0,1
S01007235,Occupancy rating +1,104,54,21,33,50,12,31,21,4,6,7,4,3,0,0,0,0,0
S01007235,Occupancy rating 0,131,75,44,31,52,7,27,8,16,3,18,13,5,4,0,0,0,4
S01007235,Occupancy rating -1 or less,42,15,8,7,23,1,14,5,7,2,8,7,1,4,2,0,0,2
S01007236,All households,305,113,51,62,188,21,128,64,50,14,39,18,21,4,1,0,0,3
S01007236,Occupancy rating +2 or more,114,43,23,20,68,8,55,33,13,9,5,2,3,3,1,0,0,2
S01007236,Occupancy rating +1,114,44,20,24,70,12,37,23,10,4,21,8,13,0,0,0,0,0
S01007236,Occupancy rating 0,56,14,7,7,41,1,29,7,21,1,11,8,3,1,0,0,0,1
S01007236,Occupancy rating -1 or less,21,12,1,11,9,0,7,1,6,0,2,0,2,0,0,0,0,0
S01007237,All households,325,105,52,53,218,41,152,59,62,31,25,16,9,2,0,0,1,1
S01007237,Occupancy rating +2 or more,172,52,26,26,120,28,85,48,24,13,7,5,2,0,0,0,0,0
S01007237,Occupancy rating +1,81,32,19,13,49,10,35,8,16,11,4,1,3,0,0,0,0,0
S01007237,Occupancy rating 0,59,17,5,12,40,1,27,3,18,6,12,8,4,2,0,0,1,1
S01007237,Occupancy rating -1 or less,13,4,2,2,9,2,5,0,4,1,2,2,0,0,0,0,0,0
S01007238,All households,417,124,70,54,290,51,201,92,79,30,38,17,21,3,2,0,0,1
S01007238,Occupancy rating +2 or more,168,38,19,19,129,28,93,57,23,13,8,3,5,1,1,0,0,0
S01007238,Occupancy rating +1,107,32,20,12,75,14,54,25,23,6,7,3,4,0,0,0,0,0
S01007238,Occupancy rating 0,127,51,28,23,76,9,48,9,30,9,19,10,9,0,0,0,0,0
S01007238,Occupancy rating -1 or less,15,3,3,0,10,0,6,1,3,2,4,1,3,2,1,0,0,1
S01007239,All households,367,105,67,38,250,54,171,91,53,27,25,10,15,12,7,0,1,4
S01007239,Occupancy rating +2 or more,277,71,43,28,198,48,133,80,35,18,17,5,12,8,5,0,1,2
S01007239,Occupancy rating +1,56,21,16,5,33,5,23,7,11,5,5,3,2,2,0,0,0,2
S01007239,Occupancy rating 0,27,12,7,5,14,1,11,3,5,3,2,1,1,1,1,0,0,0
S01007239,Occupancy rating -1 or less,7,1,1,0,5,0,4,1,2,1,1,1,0,1,1,0,0,0
S01007240,All households,233,49,19,30,178,26,139,79,41,19,13,5,8,6,2,0,1,3
S01007240,Occupancy rating +2 or more,149,29,13,16,117,21,91,59,22,10,5,0,5,3,1,0,1,1
S01007240,Occupancy rating +1,49,12,5,7,37,5,30,14,11,5,2,0,2,0,0,0,0,0
S01007240,Occupancy rating 0,25,5,1,4,18,0,15,5,6,4,3,2,1,2,0,0,0,2
S01007240,Occupancy rating -1 or less,10,3,0,3,6,0,3,1,2,0,3,3,0,1,1,0,0,0
S01007241,All households,242,45,18,27,185,27,148,62,63,23,10,3,7,12,5,0,1,6
S01007241,Occupancy rating +2 or more,170,27,13,14,135,21,111,52,44,15,3,1,2,8,2,0,1,5
S01007241,Occupancy rating +1,49,15,5,10,32,5,25,10,12,3,2,0,2,2,1,0,0,1
S01007241,Occupancy rating 0,20,3,0,3,16,1,11,0,6,5,4,2,2,1,1,0,0,0
S01007241,Occupancy rating -1 or less,3,0,0,0,2,0,1,0,1,0,1,0,1,1,1,0,0,0
S01007242,All households,447,124,73,51,311,63,207,99,78,30,41,23,18,12,6,0,0,6
S01007242,Occupancy rating +2 or more,257,52,30,22,200,45,141,75,48,18,14,7,7,5,3,0,0,2
S01007242,Occupancy rating +1,102,36,21,15,64,16,40,20,12,8,8,4,4,2,1,0,0,1
S01007242,Occupancy rating 0,79,34,22,12,41,2,25,4,17,4,14,8,6,4,1,0,0,3
S01007242,Occupancy rating -1 or less,9,2,0,2,6,0,1,0,1,0,5,4,1,1,1,0,0,0
S01007243,All households,255,66,34,32,183,32,134,57,58,19,17,5,12,6,2,0,2,2
S01007243,Occupancy rating +2 or more,166,36,20,16,127,24,96,49,36,11,7,3,4,3,1,0,1,1
S01007243,Occupancy rating +1,55,20,9,11,33,6,23,7,10,6,4,1,3,2,0,0,1,1
S01007243,Occupancy rating 0,26,9,5,4,17,2,10,0,10,0,5,1,4,0,0,0,0,0
S01007243,Occupancy rating -1 or less,8,1,0,1,6,0,5,1,2,2,1,0,1,1,1,0,0,0
S01007244,All households,303,62,30,32,227,34,179,94,57,28,14,6,8,14,2,0,0,12
S01007244,Occupancy rating +2 or more,206,37,19,18,165,28,130,74,38,18,7,2,5,4,0,0,0,4
S01007244,Occupancy rating +1,57,16,8,8,38,4,34,19,9,6,0,0,0,3,1,0,0,2
S01007244,Occupancy rating 0,28,6,2,4,18,0,12,1,7,4,6,4,2,4,0,0,0,4
S01007244,Occupancy rating -1 or less,12,3,1,2,6,2,3,0,3,0,1,0,1,3,1,0,0,2
S01007245,All households,310,95,54,41,204,33,149,76,45,28,22,11,11,11,6,0,0,5
S01007245,Occupancy rating +2 or more,164,39,21,18,118,17,96,56,27,13,5,3,2,7,4,0,0,3
S01007245,Occupancy rating +1,59,18,6,12,40,10,24,14,5,5,6,2,4,1,1,0,0,0
S01007245,Occupancy rating 0,69,30,21,9,37,5,24,4,11,9,8,5,3,2,1,0,0,1
S01007245,Occupancy rating -1 or less,18,8,6,2,9,1,5,2,2,1,3,1,2,1,0,0,0,1
S01007246,All households,237,43,14,29,188,24,153,80,51,22,11,6,5,6,1,0,0,5
S01007246,Occupancy rating +2 or more,133,23,5,18,107,16,89,54,23,12,2,1,1,3,1,0,0,2
S01007246,Occupancy rating +1,58,9,5,4,47,7,39,20,15,4,1,1,0,2,0,0,0,2
S01007246,Occupancy rating 0,39,10,4,6,28,1,21,4,11,6,6,3,3,1,0,0,0,1
S01007246,Occupancy rating -1 or less,7,1,0,1,6,0,4,2,2,0,2,1,1,0,0,0,0,0
S01007247,All households,279,71,30,41,200,25,159,85,55,19,16,9,7,8,6,0,0,2
S01007247,Occupancy rating +2 or more,137,21,9,12,113,16,93,60,23,10,4,3,1,3,2,0,0,1
S01007247,Occupancy rating +1,90,38,16,22,51,7,39,18,17,4,5,3,2,1,1,0,0,0
S01007247,Occupancy rating 0,40,10,5,5,28,2,20,6,11,3,6,3,3,2,1,0,0,1
S01007247,Occupancy rating -1 or less,12,2,0,2,8,0,7,1,4,2,1,0,1,2,2,0,0,0
S01007248,All households,310,61,44,17,242,51,176,77,74,25,15,5,10,7,3,0,0,4
S01007248,Occupancy rating +2 or more,256,48,32,16,201,48,144,75,52,17,9,5,4,7,3,0,0,4
S01007248,Occupancy rating +1,32,8,7,1,24,1,19,2,12,5,4,0,4,0,0,0,0,0
S01007248,Occupancy rating 0,11,3,3,0,8,1,7,0,5,2,0,0,0,0,0,0,0,0
S01007248,Occupancy rating -1 or less,11,2,2,0,9,1,6,0,5,1,2,0,2,0,0,0,0,0
S01007249,All households,174,48,26,22,122,23,83,43,30,10,16,11,5,4,0,0,0,4
S01007249,Occupancy rating +2 or more,104,26,19,7,77,21,53,36,13,4,3,2,1,1,0,0,0,1
S01007249,Occupancy rating +1,34,12,4,8,22,2,15,3,8,4,5,2,3,0,0,0,0,0
S01007249,Occupancy rating 0,30,9,3,6,20,0,14,4,8,2,6,5,1,1,0,0,0,1
S01007249,Occupancy rating -1 or less,6,1,0,1,3,0,1,0,1,0,2,2,0,2,0,0,0,2
S01007250,All households,432,197,67,130,220,36,151,74,55,22,33,17,16,15,5,0,0,10
S01007250,Occupancy rating +2 or more,120,37,20,17,83,24,54,30,16,8,5,2,3,0,0,0,0,0
S01007250,Occupancy rating +1,126,64,20,44,61,10,47,30,15,2,4,1,3,1,1,0,0,0
S01007250,Occupancy rating 0,154,90,25,65,57,2,39,13,16,10,16,9,7,7,0,0,0,7
S01007250,Occupancy rating -1 or less,32,6,2,4,19,0,11,1,8,2,8,5,3,7,4,0,0,3
S01007251,All households,250,102,56,46,145,28,98,45,43,10,19,14,5,3,2,0,0,1
S01007251,Occupancy rating +2 or more,74,19,8,11,55,9,42,21,19,2,4,4,0,0,0,0,0,0
S01007251,Occupancy rating +1,68,26,10,16,42,9,27,13,8,6,6,4,2,0,0,0,0,0
S01007251,Occupancy rating 0,86,49,34,15,36,8,22,10,11,1,6,5,1,1,1,0,0,0
S01007251,Occupancy rating -1 or less,22,8,4,4,12,2,7,1,5,1,3,1,2,2,1,0,0,1
S01007252,All households,315,61,24,37,240,34,160,62,72,26,46,34,12,14,4,0,1,9
S01007252,Occupancy rating +2 or more,111,18,9,9,90,21,65,37,19,9,4,4,0,3,0,0,1,2
S01007252,Occupancy rating +1,92,27,11,16,64,13,41,17,17,7,10,7,3,1,1,0,0,0
S01007252,Occupancy rating 0,83,13,3,10,64,0,35,7,23,5,29,20,9,6,2,0,0,4
S01007252,Occupancy rating -1 or less,29,3,1,2,22,0,19,1,13,5,3,3,0,4,1,0,0,3
S01007253,All households,358,86,53,33,260,57,183,93,68,22,20,10,10,12,3,0,3,6
S01007253,Occupancy rating +2 or more,201,41,28,13,156,37,115,69,35,11,4,2,2,4,2,0,2,0
S01007253,Occupancy rating +1,89,23,18,5,62,16,41,19,13,9,5,1,4,4,1,0,0,3
S01007253,Occupancy rating 0,51,12,4,8,36,2,24,4,18,2,10,6,4,3,0,0,1,2
S01007253,Occupancy rating -1 or less,17,10,3,7,6,2,3,1,2,0,1,1,0,1,0,0,0,1
S01007254,All households,401,179,90,89,213,34,134,45,63,26,45,28,17,9,3,0,0,6
S01007254,Occupancy rating +2 or more,74,22,11,11,51,9,41,17,18,6,1,0,1,1,0,0,0,1
S01007254,Occupancy rating +1,140,78,36,42,61,13,40,21,10,9,8,3,5,1,0,0,0,1
S01007254,Occupancy rating 0,157,70,42,28,84,12,43,6,29,8,29,21,8,3,2,0,0,1
S01007254,Occupancy rating -1 or less,30,9,1,8,17,0,10,1,6,3,7,4,3,4,1,0,0,3
S01007255,All households,374,133,48,85,227,21,140,63,57,20,66,52,14,14,8,0,1,5
S01007255,Occupancy rating +2 or more,57,19,7,12,37,2,32,26,4,2,3,2,1,1,0,0,0,1
S01007255,Occupancy rating +1,144,72,26,46,71,14,50,28,17,5,7,6,1,1,0,0,0,1
S01007255,Occupancy rating 0,143,40,15,25,97,4,50,8,31,11,43,35,8,6,2,0,1,3
S01007255,Occupancy rating -1 or less,30,2,0,2,22,1,8,1,5,2,13,9,4,6,6,0,0,0
S01007256,All households,407,184,70,114,204,24,137,67,58,12,43,33,10,19,5,0,2,12
S01007256,Occupancy rating +2 or more,83,27,10,17,50,3,45,28,12,5,2,2,0,6,2,0,2,2
S01007256,Occupancy rating +1,139,70,25,45,65,14,43,27,12,4,8,6,2,4,2,0,0,2
S01007256,Occupancy rating 0,152,75,32,43,71,6,40,11,27,2,25,18,7,6,0,0,0,6
S01007256,Occupancy rating -1 or less,33,12,3,9,18,1,9,1,7,1,8,7,1,3,1,0,0,2
S01007257,All households,296,124,31,93,157,26,86,35,40,11,45,40,5,15,3,0,2,10
S01007257,Occupancy rating +2 or more,71,18,7,11,51,19,30,17,11,2,2,2,0,2,0,0,1,1
S01007257,Occupancy rating +1,80,39,9,30,38,4,28,12,10,6,6,5,1,3,1,0,0,2
S01007257,Occupancy rating 0,101,50,12,38,48,2,17,2,13,2,29,26,3,3,0,0,0,3
S01007257,Occupancy rating -1 or less,44,17,3,14,20,1,11,4,6,1,8,7,1,7,2,0,1,4
S01007258,All households,410,168,81,87,223,42,148,65,68,15,33,24,9,19,6,1,1,11
S01007258,Occupancy rating +2 or more,147,31,13,18,112,23,87,49,28,10,2,1,1,4,0,0,1,3
S01007258,Occupancy rating +1,99,45,18,27,50,11,29,12,16,1,10,6,4,4,2,0,0,2
S01007258,Occupancy rating 0,124,78,43,35,43,7,22,2,16,4,14,11,3,3,0,0,0,3
S01007258,Occupancy rating -1 or less,40,14,7,7,18,1,10,2,8,0,7,6,1,8,4,1,0,3
S01007259,All households,414,175,82,93,224,34,141,52,70,19,49,28,21,15,3,0,5,7
S01007259,Occupancy rating +2 or more,82,23,11,12,56,11,40,25,13,2,5,1,4,3,1,0,1,1
S01007259,Occupancy rating +1,121,58,31,27,60,15,39,15,20,4,6,4,2,3,0,0,2,1
S01007259,Occupancy rating 0,175,85,38,47,87,7,55,12,31,12,25,16,9,3,0,0,2,1
S01007259,Occupancy rating -1 or less,36,9,2,7,21,1,7,0,6,1,13,7,6,6,2,0,0,4
S01007260,All households,418,150,42,108,258,26,156,74,64,18,76,61,15,10,4,0,1,5
S01007260,Occupancy rating +2 or more,74,22,11,11,52,12,36,25,9,2,4,4,0,0,0,0,0,0
S01007260,Occupancy rating +1,150,69,20,49,80,12,59,42,14,3,9,7,2,1,0,0,0,1
S01007260,Occupancy rating 0,153,54,11,43,95,2,48,7,31,10,45,37,8,4,1,0,0,3
S01007260,Occupancy rating -1 or less,41,5,0,5,31,0,13,0,10,3,18,13,5,5,3,0,1,1
S01007261,All households,356,109,56,53,237,55,167,73,62,32,15,9,6,10,5,0,1,4
S01007261,Occupancy rating +2 or more,205,49,26,23,153,38,110,62,33,15,5,0,5,3,2,0,0,1
S01007261,Occupancy rating +1,90,37,20,17,50,14,33,9,13,11,3,3,0,3,1,0,1,1
S01007261,Occupancy rating 0,46,18,7,11,25,2,19,2,13,4,4,3,1,3,1,0,0,2
S01007261,Occupancy rating -1 or less,15,5,3,2,9,1,5,0,3,2,3,3,0,1,1,0,0,0
S01007262,All households,301,81,37,44,207,32,140,52,59,29,35,21,14,13,4,0,3,6
S01007262,Occupancy rating +2 or more,72,20,11,9,52,12,35,22,11,2,5,2,3,0,0,0,0,0
S01007262,Occupancy rating +1,112,32,16,16,78,17,53,27,15,11,8,3,5,2,0,0,0,2
S01007262,Occupancy rating 0,96,27,9,18,63,2,43,3,26,14,18,12,6,6,2,0,1,3
S01007262,Occupancy rating -1 or less,21,2,1,1,14,1,9,0,7,2,4,4,0,5,2,0,2,1
S01007263,All households,366,114,56,58,243,47,156,80,54,22,40,26,14,9,2,0,0,7
S01007263,Occupancy rating +2 or more,112,27,15,12,84,25,55,39,12,4,4,2,2,1,0,0,0,1
S01007263,Occupancy rating +1,145,62,24,38,80,19,56,37,11,8,5,4,1,3,1,0,0,2
S01007263,Occupancy rating 0,85,21,15,6,62,1,35,4,24,7,26,17,9,2,0,0,0,2
S01007263,Occupancy rating -1 or less,24,4,2,2,17,2,10,0,7,3,5,3,2,3,1,0,0,2
S01007264,All households,339,111,71,40,219,48,152,67,58,27,19,11,8,9,3,0,1,5
S01007264,Occupancy rating +2 or more,142,31,15,16,110,28,80,39,28,13,2,1,1,1,1,0,0,0
S01007264,Occupancy rating +1,95,34,21,13,58,11,43,26,11,6,4,3,1,3,1,0,0,2
S01007264,Occupancy rating 0,88,42,31,11,43,9,22,2,13,7,12,7,5,3,0,0,1,2
S01007264,Occupancy rating -1 or less,14,4,4,0,8,0,7,0,6,1,1,0,1,2,1,0,0,1
S01007265,All households,472,171,78,93,284,27,205,81,89,35,52,34,18,17,7,0,1,9
S01007265,Occupancy rating +2 or more,144,50,24,26,90,9,77,43,25,9,4,2,2,4,3,0,0,1
S01007265,Occupancy rating +1,139,47,20,27,88,14,61,25,26,10,13,7,6,4,2,0,0,2
S01007265,Occupancy rating 0,142,53,26,27,82,4,49,7,28,14,29,21,8,7,1,0,1,5
S01007265,Occupancy rating -1 or less,47,21,8,13,24,0,18,6,10,2,6,4,2,2,1,0,0,1
S01007266,All households,305,98,44,54,192,38,126,46,43,37,28,19,9,15,5,0,1,9
S01007266,Occupancy rating +2 or more,105,27,18,9,74,20,49,28,12,9,5,3,2,4,2,0,0,2
S01007266,Occupancy rating +1,84,34,14,20,47,10,36,12,12,12,1,0,1,3,0,0,0,3
S01007266,Occupancy rating 0,85,33,12,21,50,7,29,3,13,13,14,12,2,2,0,0,1,1
S01007266,Occupancy rating -1 or less,31,4,0,4,21,1,12,3,6,3,8,4,4,6,3,0,0,3
S01007267,All households,222,47,19,28,173,26,133,65,46,22,14,7,7,2,1,0,0,1
S01007267,Occupancy rating +2 or more,140,29,13,16,110,19,88,55,21,12,3,0,3,1,1,0,0,0
S01007267,Occupancy rating +1,48,11,4,7,36,6,26,6,15,5,4,2,2,1,0,0,0,1
S01007267,Occupancy rating 0,29,7,2,5,22,1,14,3,6,5,7,5,2,0,0,0,0,0
S01007267,Occupancy rating -1 or less,5,0,0,0,5,0,5,1,4,0,0,0,0,0,0,0,0,0
S01007268,All households,249,57,24,33,184,27,133,65,47,21,24,17,7,8,5,0,1,2
S01007268,Occupancy rating +2 or more,157,31,15,16,121,23,89,47,31,11,9,4,5,5,2,0,1,2
S01007268,Occupancy rating +1,50,14,4,10,35,2,29,14,6,9,4,3,1,1,1,0,0,0
S01007268,Occupancy rating 0,35,10,4,6,23,1,13,4,8,1,9,8,1,2,2,0,0,0
S01007268,Occupancy rating -1 or less,7,2,1,1,5,1,2,0,2,0,2,2,0,0,0,0,0,0
S01007269,All households,224,60,31,29,159,32,115,40,55,20,12,7,5,5,3,0,1,1
S01007269,Occupancy rating +2 or more,137,37,18,19,98,25,69,30,26,13,4,3,1,2,1,0,1,0
S01007269,Occupancy rating +1,47,13,6,7,33,3,27,9,14,4,3,1,2,1,0,0,0,1
S01007269,Occupancy rating 0,29,10,7,3,18,3,11,0,9,2,4,2,2,1,1,0,0,0
S01007269,Occupancy rating -1 or less,11,0,0,0,10,1,8,1,6,1,1,1,0,1,1,0,0,0
S01007270,All households,205,66,25,41,131,25,95,37,33,25,11,6,5,8,6,0,0,2
S01007270,Occupancy rating +2 or more,116,36,12,24,78,20,54,20,19,15,4,4,0,2,2,0,0,0
S01007270,Occupancy rating +1,59,22,11,11,36,5,28,15,7,6,3,0,3,1,1,0,0,0
S01007270,Occupancy rating 0,24,6,1,5,15,0,11,2,6,3,4,2,2,3,1,0,0,2
S01007270,Occupancy rating -1 or less,6,2,1,1,2,0,2,0,1,1,0,0,0,2,2,0,0,0
S01007271,All households,448,150,67,83,287,46,204,99,75,30,37,23,14,11,5,0,0,6
S01007271,Occupancy rating +2 or more,206,57,30,27,146,28,110,71,23,16,8,5,3,3,1,0,0,2
S01007271,Occupancy rating +1,120,46,17,29,73,15,51,20,23,8,7,3,4,1,0,0,0,1
S01007271,Occupancy rating 0,93,34,15,19,55,2,34,6,24,4,19,12,7,4,2,0,0,2
S01007271,Occupancy rating -1 or less,29,13,5,8,13,1,9,2,5,2,3,3,0,3,2,0,0,1
S01007272,All households,417,175,73,102,233,22,145,50,79,16,66,49,17,9,4,0,2,3
S01007272,Occupancy rating +2 or more,73,25,10,15,48,7,37,20,15,2,4,3,1,0,0,0,0,0
S01007272,Occupancy rating +1,158,89,36,53,68,12,47,26,18,3,9,6,3,1,1,0,0,0
S01007272,Occupancy rating 0,152,51,22,29,96,2,51,4,38,9,43,32,11,5,1,0,2,2
S01007272,Occupancy rating -1 or less,34,10,5,5,21,1,10,0,8,2,10,8,2,3,2,0,0,1
S01007273,All households,296,75,31,44,210,41,132,48,64,20,37,22,15,11,5,0,0,6
S01007273,Occupancy rating +2 or more,148,39,21,18,108,34,67,36,26,5,7,5,2,1,1,0,0,0
S01007273,Occupancy rating +1,76,26,8,18,49,5,36,11,18,7,8,3,5,1,0,0,0,1
S01007273,Occupancy rating 0,52,7,2,5,41,2,22,1,14,7,17,13,4,4,0,0,0,4
S01007273,Occupancy rating -1 or less,20,3,0,3,12,0,7,0,6,1,5,1,4,5,4,0,0,1
S01007274,All households,456,247,120,127,193,29,129,55,54,20,35,22,13,16,5,0,2,9
S01007274,Occupancy rating +2 or more,128,48,19,29,75,13,55,27,17,11,7,4,3,5,2,0,1,2
S01007274,Occupancy rating +1,109,54,17,37,50,3,38,18,14,6,9,8,1,5,2,0,1,2
S01007274,Occupancy rating 0,172,112,62,50,58,13,30,9,18,3,15,7,8,2,1,0,0,1
S01007274,Occupancy rating -1 or less,47,33,22,11,10,0,6,1,5,0,4,3,1,4,0,0,0,4
S01007275,All households,243,71,36,35,167,43,112,50,44,18,12,8,4,5,2,0,1,2
S01007275,Occupancy rating +2 or more,140,32,17,15,107,32,73,39,24,10,2,1,1,1,0,0,1,0
S01007275,Occupancy rating +1,43,12,6,6,30,7,18,7,9,2,5,3,2,1,0,0,0,1
S01007275,Occupancy rating 0,33,15,7,8,16,1,13,3,5,5,2,2,0,2,2,0,0,0
S01007275,Occupancy rating -1 or less,27,12,6,6,14,3,8,1,6,1,3,2,1,1,0,0,0,1
S01007276,All households,369,100,45,55,256,43,167,69,69,29,46,34,12,13,6,1,1,5
S01007276,Occupancy rating +2 or more,177,48,22,26,128,35,85,50,23,12,8,4,4,1,0,0,0,1
S01007276,Occupancy rating +1,96,31,14,17,62,7,44,16,17,11,11,8,3,3,0,0,1,2
S01007276,Occupancy rating 0,69,20,9,11,46,0,32,2,24,6,14,10,4,3,2,0,0,1
S01007276,Occupancy rating -1 or less,27,1,0,1,20,1,6,1,5,0,13,12,1,6,4,1,0,1
S01007277,All households,327,80,61,19,240,46,169,85,61,23,25,16,9,7,1,0,2,4
S01007277,Occupancy rating +2 or more,231,57,41,16,170,41,118,68,35,15,11,5,6,4,0,0,2,2
S01007277,Occupancy rating +1,64,17,14,3,45,4,37,16,15,6,4,4,0,2,0,0,0,2
S01007277,Occupancy rating 0,29,5,5,0,24,1,13,1,10,2,10,7,3,0,0,0,0,0
S01007277,Occupancy rating -1 or less,3,1,1,0,1,0,1,0,1,0,0,0,0,1,1,0,0,0
S01007278,All households,227,50,31,19,172,35,125,46,58,21,12,11,1,5,0,0,2,3
S01007278,Occupancy rating +2 or more,169,37,23,14,129,30,92,41,36,15,7,6,1,3,0,0,2,1
S01007278,Occupancy rating +1,45,10,6,4,33,5,25,5,16,4,3,3,0,2,0,0,0,2
S01007278,Occupancy rating 0,13,3,2,1,10,0,8,0,6,2,2,2,0,0,0,0,0,0
S01007278,Occupancy rating -1 or less,0,0,0,0,0,0,0,0,0,0,0,0,0,0,0,0,0,0
S01007279,All households,240,67,28,39,162,24,118,55,40,23,20,14,6,11,3,0,2,6
S01007279,Occupancy rating +2 or more,179,48,20,28,121,22,91,47,27,17,8,5,3,10,3,0,1,6
S01007279,Occupancy rating +1,31,14,7,7,17,2,13,7,4,2,2,1,1,0,0,0,0,0
S01007279,Occupancy rating 0,21,4,1,3,16,0,10,1,6,3,6,4,2,1,0,0,1,0
S01007279,Occupancy rating -1 or less,9,1,0,1,8,0,4,0,3,1,4,4,0,0,0,0,0,0
S01007280,All households,237,65,19,46,167,18,129,60,47,22,20,13,7,5,4,0,0,1
S01007280,Occupancy rating +2 or more,153,37,13,24,114,15,93,50,27,16,6,3,3,2,1,0,0,1
S01007280,Occupancy rating +1,39,21,5,16,17,2,13,5,6,2,2,1,1,1,1,0,0,0
S01007280,Occupancy rating 0,34,5,1,4,27,1,17,4,9,4,9,7,2,2,2,0,0,0
S01007280,Occupancy rating -1 or less,11,2,0,2,9,0,6,1,5,0,3,2,1,0,0,0,0,0
S01007281,All households,361,92,24,68,249,30,200,84,86,30,19,11,8,20,8,0,0,12
S01007281,Occupancy rating +2 or more,236,54,17,37,176,26,146,71,53,22,4,2,2,6,2,0,0,4
S01007281,Occupancy rating +1,57,16,3,13,37,4,28,11,13,4,5,1,4,4,3,0,0,1
S01007281,Occupancy rating 0,50,13,4,9,31,0,22,2,16,4,9,7,2,6,2,0,0,4
S01007281,Occupancy rating -1 or less,18,9,0,9,5,0,4,0,4,0,1,1,0,4,1,0,0,3
S01007282,All households,228,65,20,45,157,18,121,54,52,15,18,10,8,6,2,0,0,4
S01007282,Occupancy rating +2 or more,132,34,11,23,95,14,78,44,25,9,3,1,2,3,2,0,0,1
S01007282,Occupancy rating +1,52,20,7,13,31,4,20,7,11,2,7,3,4,1,0,0,0,1
S01007282,Occupancy rating 0,32,8,1,7,22,0,17,3,11,3,5,4,1,2,0,0,0,2
S01007282,Occupancy rating -1 or less,12,3,1,2,9,0,6,0,5,1,3,2,1,0,0,0,0,0
S01007283,All households,482,166,116,50,309,78,209,112,82,15,22,15,7,7,0,0,1,6
S01007283,Occupancy rating +2 or more,299,90,59,31,204,57,138,82,46,10,9,6,3,5,0,0,1,4
S01007283,Occupancy rating +1,95,41,30,11,53,13,39,23,14,2,1,0,1,1,0,0,0,1
S01007283,Occupancy rating 0,65,28,21,7,36,8,22,6,13,3,6,4,2,1,0,0,0,1
S01007283,Occupancy rating -1 or less,23,7,6,1,16,0,10,1,9,0,6,5,1,0,0,0,0,0
S01007284,All households,403,153,72,81,235,33,165,87,59,19,37,23,14,15,6,0,2,7
S01007284,Occupancy rating +2 or more,247,93,54,39,147,27,110,61,38,11,10,6,4,7,2,0,2,3
S01007284,Occupancy rating +1,83,36,12,24,43,4,32,19,9,4,7,4,3,4,1,0,0,3
S01007284,Occupancy rating 0,58,17,4,13,38,2,19,6,10,3,17,11,6,3,2,0,0,1
S01007284,Occupancy rating -1 or less,15,7,2,5,7,0,4,1,2,1,3,2,1,1,1,0,0,0
S01007285,All households,358,96,52,44,241,43,174,81,72,21,24,9,15,21,10,0,0,11
S01007285,Occupancy rating +2 or more,232,60,32,28,166,35,116,61,42,13,15,4,11,6,2,0,0,4
S01007285,Occupancy rating +1,77,23,15,8,45,6,35,14,16,5,4,1,3,9,5,0,0,4
S01007285,Occupancy rating 0,36,7,4,3,23,1,18,5,10,3,4,3,1,6,3,0,0,3
S01007285,Occupancy rating -1 or less,13,6,1,5,7,1,5,1,4,0,1,1,0,0,0,0,0,0
S01007286,All households,460,174,73,101,262,30,181,96,71,14,51,34,17,24,9,0,4,11
S01007286,Occupancy rating +2 or more,219,67,39,28,140,25,106,67,32,7,9,6,3,12,4,0,4,4
S01007286,Occupancy rating +1,99,44,14,30,52,4,37,16,15,6,11,8,3,3,2,0,0,1
S01007286,Occupancy rating 0,107,40,13,27,60,1,33,11,21,1,26,17,9,7,1,0,0,6
S01007286,Occupancy rating -1 or less,35,23,7,16,10,0,5,2,3,0,5,3,2,2,2,0,0,0
S01007287,All households,281,117,46,71,156,28,117,63,43,11,11,8,3,8,1,0,0,7
S01007287,Occupancy rating +2 or more,156,53,26,27,100,24,75,49,23,3,1,0,1,3,0,0,0,3
S01007287,Occupancy rating +1,75,40,13,27,33,4,25,10,9,6,4,3,1,2,0,0,0,2
S01007287,Occupancy rating 0,38,20,6,14,18,0,14,3,10,1,4,3,1,0,0,0,0,0
S01007287,Occupancy rating -1 or less,12,4,1,3,5,0,3,1,1,1,2,2,0,3,1,0,0,2
S01007288,All households,252,76,43,33,170,29,132,77,35,20,9,3,6,6,4,0,0,2
S01007288,Occupancy rating +2 or more,173,47,33,14,124,22,99,64,19,16,3,2,1,2,2,0,0,0
S01007288,Occupancy rating +1,44,16,7,9,26,5,19,10,8,1,2,0,2,2,1,0,0,1
S01007288,Occupancy rating 0,25,9,3,6,16,1,11,2,7,2,4,1,3,0,0,0,0,0
S01007288,Occupancy rating -1 or less,10,4,0,4,4,1,3,1,1,1,0,0,0,2,1,0,0,1
S01007289,All households,323,72,27,45,230,36,176,76,71,29,18,8,10,21,8,0,1,12
S01007289,Occupancy rating +2 or more,216,47,21,26,154,32,111,63,35,13,11,4,7,15,6,0,1,8
S01007289,Occupancy rating +1,60,16,4,12,41,3,35,9,18,8,3,1,2,3,0,0,0,3
S01007289,Occupancy rating 0,35,7,2,5,27,1,23,2,15,6,3,2,1,1,1,0,0,0
S01007289,Occupancy rating -1 or less,12,2,0,2,8,0,7,2,3,2,1,1,0,2,1,0,0,1
S01007290,All households,276,53,10,43,208,1,149,35,109,5,58,51,7,15,9,0,0,6
S01007290,Occupancy rating +2 or more,77,16,6,10,58,0,50,23,25,2,8,4,4,3,1,0,0,2
S01007290,Occupancy rating +1,70,21,0,21,48,1,35,11,22,2,12,10,2,1,0,0,0,1
S01007290,Occupancy rating 0,100,11,2,9,84,0,53,1,51,1,31,30,1,5,2,0,0,3
S01007290,Occupancy rating -1 or less,29,5,2,3,18,0,11,0,11,0,7,7,0,6,6,0,0,0
S01007291,All households,329,143,69,74,174,27,109,53,38,18,38,26,12,12,3,2,1,6
S01007291,Occupancy rating +2 or more,87,25,13,12,60,15,41,25,10,6,4,1,3,2,0,0,0,2
S01007291,Occupancy rating +1,86,33,14,19,51,7,42,21,13,8,2,0,2,2,0,0,0,2
S01007291,Occupancy rating 0,116,68,33,35,43,5,18,4,10,4,20,14,6,5,2,1,0,2
S01007291,Occupancy rating -1 or less,40,17,9,8,20,0,8,3,5,0,12,11,1,3,1,1,1,0
S01007292,All households,320,81,36,45,230,26,182,72,83,27,22,12,10,9,0,0,1,8
S01007292,Occupancy rating +2 or more,157,51,21,30,104,17,83,49,25,9,4,1,3,2,0,0,0,2
S01007292,Occupancy rating +1,109,29,15,14,77,7,62,18,36,8,8,5,3,3,0,0,1,2
S01007292,Occupancy rating 0,44,0,0,0,40,2,29,4,19,6,9,5,4,4,0,0,0,4
S01007292,Occupancy rating -1 or less,10,1,0,1,9,0,8,1,3,4,1,1,0,0,0,0,0,0
S01007293,All households,310,67,20,47,215,15,114,35,60,19,86,62,24,28,8,0,0,20
S01007293,Occupancy rating +2 or more,89,38,11,27,47,10,34,25,7,2,3,2,1,4,3,0,0,1
S01007293,Occupancy rating +1,112,24,9,15,80,3,42,7,24,11,35,23,12,8,0,0,0,8
S01007293,Occupancy rating 0,85,3,0,3,72,2,30,3,23,4,40,32,8,10,1,0,0,9
S01007293,Occupancy rating -1 or less,24,2,0,2,16,0,8,0,6,2,8,5,3,6,4,0,0,2
S01007294,All households,378,125,58,67,228,21,167,68,57,42,40,26,14,25,11,0,1,13
S01007294,Occupancy rating +2 or more,171,61,32,29,102,12,85,49,18,18,5,3,2,8,5,0,0,3
S01007294,Occupancy rating +1,117,48,19,29,64,9,43,16,16,11,12,6,6,5,1,0,0,4
S01007294,Occupancy rating 0,63,13,5,8,44,0,29,3,17,9,15,11,4,6,1,0,0,5
S01007294,Occupancy rating -1 or less,27,3,2,1,18,0,10,0,6,4,8,6,2,6,4,0,1,1
S01007295,All households,307,180,78,102,112,7,57,26,24,7,48,33,15,15,3,0,1,11
S01007295,Occupancy rating +2 or more,25,10,6,4,13,2,9,8,1,0,2,1,1,2,0,0,1,1
S01007295,Occupancy rating +1,79,48,16,32,29,2,21,14,4,3,6,4,2,2,1,0,0,1
S01007295,Occupancy rating 0,165,105,47,58,52,2,20,3,15,2,30,19,11,8,1,0,0,7
S01007295,Occupancy rating -1 or less,38,17,9,8,18,1,7,1,4,2,10,9,1,3,1,0,0,2
S01007296,All households,354,222,74,148,111,15,70,47,17,6,26,16,10,21,1,2,3,15
S01007296,Occupancy rating +2 or more,54,33,12,21,21,3,15,11,3,1,3,1,2,0,0,0,0,0
S01007296,Occupancy rating +1,96,65,28,37,31,9,16,14,1,1,6,3,3,0,0,0,0,0
S01007296,Occupancy rating 0,156,98,29,69,40,2,27,17,7,3,11,9,2,18,0,1,3,14
S01007296,Occupancy rating -1 or less,48,26,5,21,19,1,12,5,6,1,6,3,3,3,1,1,0,1
S01007297,All households,444,194,59,135,212,32,152,77,58,17,28,19,9,38,10,0,0,28
S01007297,Occupancy rating +2 or more,209,70,32,38,126,29,92,48,34,10,5,3,2,13,7,0,0,6
S01007297,Occupancy rating +1,93,50,20,30,37,2,29,13,10,6,6,4,2,6,2,0,0,4
S01007297,Occupancy rating 0,92,45,6,39,36,1,22,14,8,0,13,8,5,11,1,0,0,10
S01007297,Occupancy rating -1 or less,50,29,1,28,13,0,9,2,6,1,4,4,0,8,0,0,0,8
S01007298,All households,244,85,57,28,147,14,100,40,46,14,33,15,18,12,4,3,0,5
S01007298,Occupancy rating +2 or more,89,32,24,8,55,7,46,25,14,7,2,1,1,2,1,0,0,1
S01007298,Occupancy rating +1,76,42,23,19,33,4,21,13,5,3,8,2,6,1,0,0,0,1
S01007298,Occupancy rating 0,49,7,7,0,38,2,20,0,18,2,16,7,9,4,0,3,0,1
S01007298,Occupancy rating -1 or less,30,4,3,1,21,1,13,2,9,2,7,5,2,5,3,0,0,2
S01007299,All households,387,154,58,96,212,20,148,67,59,22,44,30,14,21,5,0,0,16
S01007299,Occupancy rating +2 or more,114,47,28,19,66,14,46,26,11,9,6,3,3,1,1,0,0,0
S01007299,Occupancy rating +1,128,66,18,48,59,4,49,34,11,4,6,2,4,3,1,0,0,2
S01007299,Occupancy rating 0,101,28,5,23,62,2,38,6,26,6,22,16,6,11,1,0,0,10
S01007299,Occupancy rating -1 or less,44,13,7,6,25,0,15,1,11,3,10,9,1,6,2,0,0,4
S01007300,All households,241,109,36,73,125,18,74,30,32,12,33,22,11,7,1,0,0,6
S01007300,Occupancy rating +2 or more,40,18,12,6,21,6,15,9,5,1,0,0,0,1,0,0,0,1
S01007300,Occupancy rating +1,78,37,12,25,40,10,25,18,6,1,5,0,5,1,0,0,0,1
S01007300,Occupancy rating 0,96,47,9,38,47,1,23,3,13,7,23,18,5,2,0,0,0,2
S01007300,Occupancy rating -1 or less,27,7,3,4,17,1,11,0,8,3,5,4,1,3,1,0,0,2
S01007301,All households,311,82,45,37,217,48,155,71,67,17,14,4,10,12,5,0,0,7
S01007301,Occupancy rating +2 or more,223,53,36,17,163,44,114,62,43,9,5,0,5,7,3,0,0,4
S01007301,Occupancy rating +1,59,22,8,14,33,4,26,7,13,6,3,2,1,4,1,0,0,3
S01007301,Occupancy rating 0,24,6,1,5,17,0,13,2,9,2,4,1,3,1,1,0,0,0
S01007301,Occupancy rating -1 or less,5,1,0,1,4,0,2,0,2,0,2,1,1,0,0,0,0,0
S01007302,All households,280,92,53,39,173,14,133,62,50,21,26,13,13,15,1,5,0,9
S01007302,Occupancy rating +2 or more,92,35,18,17,56,6,46,32,11,3,4,1,3,1,0,0,0,1
S01007302,Occupancy rating +1,98,30,19,11,64,7,45,22,17,6,12,4,8,4,0,0,0,4
S01007302,Occupancy rating 0,71,23,15,8,39,0,29,5,14,10,10,8,2,9,1,4,0,4
S01007302,Occupancy rating -1 or less,19,4,1,3,14,1,13,3,8,2,0,0,0,1,0,1,0,0
S01007303,All households,366,90,47,43,245,40,187,80,78,29,18,10,8,31,5,0,3,23
S01007303,Occupancy rating +2 or more,236,57,25,32,169,33,126,62,47,17,10,3,7,10,1,0,3,6
S01007303,Occupancy rating +1,68,19,12,7,44,4,36,9,20,7,4,3,1,5,1,0,0,4
S01007303,Occupancy rating 0,36,11,9,2,22,3,17,7,5,5,2,2,0,3,2,0,0,1
S01007303,Occupancy rating -1 or less,26,3,1,2,10,0,8,2,6,0,2,2,0,13,1,0,0,12
S01007304,All households,310,88,71,17,209,47,140,73,46,21,22,13,9,13,6,0,1,6
S01007304,Occupancy rating +2 or more,191,47,38,9,138,42,93,58,25,10,3,1,2,6,2,0,0,4
S01007304,Occupancy rating +1,73,36,30,6,35,3,26,11,9,6,6,3,3,2,0,0,1,1
S01007304,Occupancy rating 0,30,3,2,1,26,0,17,2,11,4,9,6,3,1,1,0,0,0
S01007304,Occupancy rating -1 or less,16,2,1,1,10,2,4,2,1,1,4,3,1,4,3,0,0,1
S01007305,All households,305,69,37,32,223,28,179,81,72,26,16,8,8,13,4,0,1,8
S01007305,Occupancy rating +2 or more,201,41,24,17,151,24,122,67,37,18,5,4,1,9,1,0,1,7
S01007305,Occupancy rating +1,62,22,9,13,39,3,30,10,15,5,6,2,4,1,0,0,0,1
S01007305,Occupancy rating 0,30,5,3,2,22,1,19,3,14,2,2,0,2,3,3,0,0,0
S01007305,Occupancy rating -1 or less,12,1,1,0,11,0,8,1,6,1,3,2,1,0,0,0,0,0
S01007306,All households,342,109,50,59,225,36,159,62,71,26,30,23,7,8,1,0,4,3
S01007306,Occupancy rating +2 or more,175,52,31,21,121,29,87,41,35,11,5,4,1,2,1,0,1,0
S01007306,Occupancy rating +1,85,32,10,22,49,5,40,15,17,8,4,2,2,4,0,0,2,2
S01007306,Occupancy rating 0,71,23,8,15,46,2,26,5,16,5,18,14,4,2,0,0,1,1
S01007306,Occupancy rating -1 or less,11,2,1,1,9,0,6,1,3,2,3,3,0,0,0,0,0,0
S01007307,All households,337,93,35,58,223,37,168,78,62,28,18,9,9,21,4,0,0,17
S01007307,Occupancy rating +2 or more,232,61,29,32,160,32,118,64,38,16,10,5,5,11,2,0,0,9
S01007307,Occupancy rating +1,68,19,4,15,44,3,38,12,16,10,3,2,1,5,1,0,0,4
S01007307,Occupancy rating 0,29,10,1,9,15,1,10,2,6,2,4,1,3,4,0,0,0,4
S01007307,Occupancy rating -1 or less,8,3,1,2,4,1,2,0,2,0,1,1,0,1,1,0,0,0
S01007308,All households,339,104,56,48,220,37,154,82,54,18,29,15,14,15,4,0,2,9
S01007308,Occupancy rating +2 or more,201,54,28,26,142,33,99,64,24,11,10,6,4,5,2,0,0,3
S01007308,Occupancy rating +1,81,34,19,15,43,4,28,12,11,5,11,4,7,4,0,0,1,3
S01007308,Occupancy rating 0,43,12,6,6,28,0,21,5,14,2,7,4,3,3,1,0,1,1
S01007308,Occupancy rating -1 or less,14,4,3,1,7,0,6,1,5,0,1,1,0,3,1,0,0,2
S01007309,All households,277,83,26,57,175,27,130,77,39,14,18,15,3,19,5,0,0,14
S01007309,Occupancy rating +2 or more,193,59,20,39,123,27,91,64,19,8,5,4,1,11,1,0,0,10
S01007309,Occupancy rating +1,38,12,3,9,23,0,20,7,10,3,3,2,1,3,1,0,0,2
S01007309,Occupancy rating 0,33,9,2,7,20,0,12,4,7,1,8,7,1,4,2,0,0,2
S01007309,Occupancy rating -1 or less,13,3,1,2,9,0,7,2,3,2,2,2,0,1,1,0,0,0
S01007310,All households,380,128,64,64,237,49,176,99,61,16,12,9,3,15,6,0,4,5
S01007310,Occupancy rating +2 or more,209,60,34,26,142,40,101,67,24,10,1,1,0,7,2,0,1,4
S01007310,Occupancy rating +1,87,36,15,21,47,8,35,16,15,4,4,3,1,4,2,0,1,1
S01007310,Occupancy rating 0,50,21,12,9,29,1,23,11,11,1,5,4,1,0,0,0,0,0
S01007310,Occupancy rating -1 or less,34,11,3,8,19,0,17,5,11,1,2,1,1,4,2,0,2,0
S01007311,All households,343,125,54,71,195,30,143,72,56,15,22,12,10,23,7,0,0,16
S01007311,Occupancy rating +2 or more,143,57,23,34,81,20,58,39,14,5,3,1,2,5,2,0,0,3
S01007311,Occupancy rating +1,96,32,12,20,58,9,42,22,13,7,7,2,5,6,1,0,0,5
S01007311,Occupancy rating 0,82,27,18,9,48,0,36,10,23,3,12,9,3,7,3,0,0,4
S01007311,Occupancy rating -1 or less,22,9,1,8,8,1,7,1,6,0,0,0,0,5,1,0,0,4
S01007312,All households,355,103,52,51,238,55,155,93,54,8,28,17,11,14,4,0,1,9
S01007312,Occupancy rating +2 or more,221,61,36,25,155,48,102,77,19,6,5,3,2,5,1,0,1,3
S01007312,Occupancy rating +1,75,30,11,19,41,5,30,13,15,2,6,1,5,4,1,0,0,3
S01007312,Occupancy rating 0,47,8,3,5,37,1,22,3,19,0,14,11,3,2,0,0,0,2
S01007312,Occupancy rating -1 or less,12,4,2,2,5,1,1,0,1,0,3,2,1,3,2,0,0,1
S01007313,All households,436,122,73,49,293,56,215,118,74,23,22,13,9,21,2,0,2,17
S01007313,Occupancy rating +2 or more,282,75,52,23,196,48,143,90,39,14,5,3,2,11,1,0,2,8
S01007313,Occupancy rating +1,79,22,12,10,55,6,41,20,15,6,8,5,3,2,1,0,0,1
S01007313,Occupancy rating 0,52,16,8,8,30,1,22,2,17,3,7,4,3,6,0,0,0,6
S01007313,Occupancy rating -1 or less,23,9,1,8,12,1,9,6,3,0,2,1,1,2,0,0,0,2
S01007314,All households,292,86,30,56,192,25,147,81,58,8,20,12,8,14,2,0,0,12
S01007314,Occupancy rating +2 or more,167,47,19,28,116,21,93,66,24,3,2,1,1,4,1,0,0,3
S01007314,Occupancy rating +1,80,32,7,25,43,4,32,10,19,3,7,4,3,5,0,0,0,5
S01007314,Occupancy rating 0,31,6,3,3,22,0,14,2,10,2,8,5,3,3,1,0,0,2
S01007314,Occupancy rating -1 or less,14,1,1,0,11,0,8,3,5,0,3,2,1,2,0,0,0,2
S01007315,All households,434,144,66,78,282,45,198,87,87,24,39,21,18,8,2,0,1,5
S01007315,Occupancy rating +2 or more,210,70,39,31,139,34,99,53,33,13,6,2,4,1,0,0,0,1
S01007315,Occupancy rating +1,142,62,20,42,78,8,63,29,26,8,7,4,3,2,0,0,0,2
S01007315,Occupancy rating 0,66,9,5,4,53,1,34,5,26,3,18,10,8,4,1,0,1,2
S01007315,Occupancy rating -1 or less,16,3,2,1,12,2,2,0,2,0,8,5,3,1,1,0,0,0
S01007316,All households,449,200,85,115,232,32,148,80,54,14,52,32,20,17,2,0,2,13
S01007316,Occupancy rating +2 or more,169,60,27,33,104,23,76,46,25,5,5,3,2,5,0,0,0,5
S01007316,Occupancy rating +1,139,78,36,42,54,7,34,24,6,4,13,7,6,7,0,0,1,6
S01007316,Occupancy rating 0,110,47,16,31,60,2,32,6,21,5,26,16,10,3,1,0,1,1
S01007316,Occupancy rating -1 or less,31,15,6,9,14,0,6,4,2,0,8,6,2,2,1,0,0,1
S01007317,All households,266,80,21,59,174,13,135,47,72,16,26,19,7,12,3,0,0,9
S01007317,Occupancy rating +2 or more,104,32,11,21,70,10,54,27,23,4,6,3,3,2,0,0,0,2
S01007317,Occupancy rating +1,85,34,8,26,48,2,44,18,19,7,2,2,0,3,1,0,0,2
S01007317,Occupancy rating 0,53,11,2,9,37,0,25,2,19,4,12,8,4,5,0,0,0,5
S01007317,Occupancy rating -1 or less,24,3,0,3,19,1,12,0,11,1,6,6,0,2,2,0,0,0
S01007318,All households,274,89,45,44,183,21,129,54,60,15,33,21,12,2,0,0,0,2
S01007318,Occupancy rating +2 or more,111,37,19,18,73,14,58,30,19,9,1,0,1,1,0,0,0,1
S01007318,Occupancy rating +1,95,43,21,22,52,6,38,18,17,3,8,2,6,0,0,0,0,0
S01007318,Occupancy rating 0,60,6,2,4,53,1,29,6,20,3,23,19,4,1,0,0,0,1
S01007318,Occupancy rating -1 or less,8,3,3,0,5,0,4,0,4,0,1,0,1,0,0,0,0,0
S01007319,All households,369,159,71,88,197,30,144,62,61,21,23,15,8,13,2,0,3,8
S01007319,Occupancy rating +2 or more,150,55,24,31,94,22,66,37,22,7,6,3,3,1,0,0,0,1
S01007319,Occupancy rating +1,137,74,33,41,59,6,45,21,16,8,8,5,3,4,0,0,1,3
S01007319,Occupancy rating 0,68,23,11,12,38,2,29,3,21,5,7,5,2,7,2,0,1,4
S01007319,Occupancy rating -1 or less,14,7,3,4,6,0,4,1,2,1,2,2,0,1,0,0,1,0
S01007320,All households,353,123,59,64,219,46,148,70,61,17,25,13,12,11,5,0,0,6
S01007320,Occupancy rating +2 or more,251,89,37,52,155,42,102,62,30,10,11,7,4,7,3,0,0,4
S01007320,Occupancy rating +1,63,19,13,6,41,4,29,4,20,5,8,2,6,3,1,0,0,2
S01007320,Occupancy rating 0,29,10,7,3,18,0,15,4,9,2,3,2,1,1,1,0,0,0
S01007320,Occupancy rating -1 or less,10,5,2,3,5,0,2,0,2,0,3,2,1,0,0,0,0,0
S01007321,All households,271,74,28,46,185,38,134,79,34,21,13,6,7,12,5,0,2,5
S01007321,Occupancy rating +2 or more,189,48,19,29,135,30,102,71,17,14,3,0,3,6,3,0,1,2
S01007321,Occupancy rating +1,53,15,6,9,34,8,21,6,13,2,5,3,2,4,2,0,1,1
S01007321,Occupancy rating 0,27,10,2,8,15,0,10,2,3,5,5,3,2,2,0,0,0,2
S01007321,Occupancy rating -1 or less,2,1,1,0,1,0,1,0,1,0,0,0,0,0,0,0,0,0
S01007322,All households,376,165,64,101,197,29,136,63,56,17,32,15,17,14,2,0,2,10
S01007322,Occupancy rating +2 or more,145,56,29,27,85,19,58,36,13,9,8,3,5,4,1,0,1,2
S01007322,Occupancy rating +1,116,62,22,40,53,7,40,22,14,4,6,1,5,1,0,0,0,1
S01007322,Occupancy rating 0,83,37,9,28,40,1,24,3,19,2,15,8,7,6,1,0,1,4
S01007322,Occupancy rating -1 or less,32,10,4,6,19,2,14,2,10,2,3,3,0,3,0,0,0,3
S01007323,All households,227,87,39,48,130,24,84,45,27,12,22,12,10,10,4,0,0,6
S01007323,Occupancy rating +2 or more,98,37,20,17,56,13,36,29,7,0,7,2,5,5,3,0,0,2
S01007323,Occupancy rating +1,81,39,12,27,40,9,26,14,7,5,5,3,2,2,1,0,0,1
S01007323,Occupancy rating 0,35,5,5,0,28,1,18,1,13,4,9,7,2,2,0,0,0,2
S01007323,Occupancy rating -1 or less,13,6,2,4,6,1,4,1,0,3,1,0,1,1,0,0,0,1
S01007324,All households,167,73,38,35,89,8,77,50,19,8,4,3,1,5,2,0,0,3
S01007324,Occupancy rating +2 or more,111,42,20,22,67,7,59,41,12,6,1,1,0,2,1,0,0,1
S01007324,Occupancy rating +1,40,23,12,11,15,1,11,7,4,0,3,2,1,2,1,0,0,1
S01007324,Occupancy rating 0,12,5,3,2,7,0,7,2,3,2,0,0,0,0,0,0,0,0
S01007324,Occupancy rating -1 or less,4,3,3,0,0,0,0,0,0,0,0,0,0,1,0,0,0,1
S01007325,All households,393,147,78,69,232,40,157,73,63,21,35,22,13,14,4,0,3,7
S01007325,Occupancy rating +2 or more,241,88,51,37,146,33,101,62,26,13,12,5,7,7,2,0,0,5
S01007325,Occupancy rating +1,71,33,17,16,37,4,26,7,13,6,7,4,3,1,0,0,1,0
S01007325,Occupancy rating 0,65,23,9,14,39,3,22,3,18,1,14,11,3,3,0,0,2,1
S01007325,Occupancy rating -1 or less,16,3,1,2,10,0,8,1,6,1,2,2,0,3,2,0,0,1
S01007326,All households,346,100,58,42,240,45,177,94,57,26,18,11,7,6,3,0,0,3
S01007326,Occupancy rating +2 or more,211,63,36,27,144,31,110,75,26,9,3,2,1,4,3,0,0,1
S01007326,Occupancy rating +1,74,23,14,9,50,9,37,16,11,10,4,1,3,1,0,0,0,1
S01007326,Occupancy rating 0,45,12,7,5,32,3,23,3,15,5,6,5,1,1,0,0,0,1
S01007326,Occupancy rating -1 or less,16,2,1,1,14,2,7,0,5,2,5,3,2,0,0,0,0,0
S01007327,All households,350,109,50,59,224,35,137,64,50,23,52,31,21,17,3,0,2,12
S01007327,Occupancy rating +2 or more,117,39,14,25,74,22,47,35,7,5,5,3,2,4,1,0,1,2
S01007327,Occupancy rating +1,116,41,22,19,67,8,46,23,17,6,13,5,8,8,1,0,1,6
S01007327,Occupancy rating 0,92,26,13,13,64,4,38,6,21,11,22,14,8,2,0,0,0,2
S01007327,Occupancy rating -1 or less,25,3,1,2,19,1,6,0,5,1,12,9,3,3,1,0,0,2
S01007328,All households,390,134,67,67,233,32,154,71,58,25,47,26,21,23,4,0,5,14
S01007328,Occupancy rating +2 or more,141,44,25,19,91,25,59,40,14,5,7,3,4,6,1,0,2,3
S01007328,Occupancy rating +1,112,43,19,24,62,5,47,28,9,10,10,4,6,7,1,0,2,4
S01007328,Occupancy rating 0,95,37,21,16,53,2,30,3,21,6,21,13,8,5,0,0,1,4
S01007328,Occupancy rating -1 or less,42,10,2,8,27,0,18,0,14,4,9,6,3,5,2,0,0,3
S01007329,All households,314,104,54,50,202,28,143,66,63,14,31,17,14,8,1,0,0,7
S01007329,Occupancy rating +2 or more,194,57,33,24,134,23,101,58,35,8,10,3,7,3,0,0,0,3
S01007329,Occupancy rating +1,72,29,15,14,41,5,25,5,15,5,11,8,3,2,0,0,0,2
S01007329,Occupancy rating 0,32,10,3,7,20,0,14,3,10,1,6,3,3,2,0,0,0,2
S01007329,Occupancy rating -1 or less,16,8,3,5,7,0,3,0,3,0,4,3,1,1,1,0,0,0
S01007330,All households,375,115,72,43,244,65,157,99,40,18,22,13,9,16,2,0,3,11
S01007330,Occupancy rating +2 or more,264,80,53,27,174,59,110,80,20,10,5,0,5,10,1,0,2,7
S01007330,Occupancy rating +1,63,18,10,8,43,5,30,15,8,7,8,5,3,2,0,0,0,2
S01007330,Occupancy rating 0,41,15,8,7,23,0,17,4,12,1,6,5,1,3,1,0,0,2
S01007330,Occupancy rating -1 or less,7,2,1,1,4,1,0,0,0,0,3,3,0,1,0,0,1,0
S01007331,All households,419,106,43,63,296,39,222,101,88,33,35,15,20,17,4,0,3,10
S01007331,Occupancy rating +2 or more,206,50,23,27,151,24,119,69,36,14,8,2,6,5,1,0,0,4
S01007331,Occupancy rating +1,113,34,12,22,75,12,56,25,23,8,7,4,3,4,2,0,0,2
S01007331,Occupancy rating 0,78,18,7,11,54,2,39,6,22,11,13,6,7,6,0,0,3,3
S01007331,Occupancy rating -1 or less,22,4,1,3,16,1,8,1,7,0,7,3,4,2,1,0,0,1
S01007332,All households,219,63,36,27,149,26,105,47,46,12,18,7,11,7,3,0,3,1
S01007332,Occupancy rating +2 or more,142,40,27,13,99,20,73,36,29,8,6,2,4,3,2,0,0,1
S01007332,Occupancy rating +1,54,21,8,13,31,6,20,9,8,3,5,1,4,2,0,0,2,0
S01007332,Occupancy rating 0,16,2,1,1,12,0,8,1,6,1,4,1,3,2,1,0,1,0
S01007332,Occupancy rating -1 or less,7,0,0,0,7,0,4,1,3,0,3,3,0,0,0,0,0,0
S01007333,All households,367,122,56,66,234,47,153,72,60,21,34,24,10,11,3,0,2,6
S01007333,Occupancy rating +2 or more,200,56,34,22,141,38,95,62,21,12,8,6,2,3,0,0,0,3
S01007333,Occupancy rating +1,108,52,16,36,52,9,34,10,19,5,9,5,4,4,0,0,2,2
S01007333,Occupancy rating 0,50,9,3,6,37,0,23,0,20,3,14,11,3,4,3,0,0,1
S01007333,Occupancy rating -1 or less,9,5,3,2,4,0,1,0,0,1,3,2,1,0,0,0,0,0
S01007334,All households,391,199,100,99,183,23,103,45,44,14,57,44,13,9,3,0,1,5
S01007334,Occupancy rating +2 or more,63,25,13,12,38,5,30,13,15,2,3,2,1,0,0,0,0,0
S01007334,Occupancy rating +1,149,78,37,41,69,13,40,21,11,8,16,12,4,2,1,0,1,0
S01007334,Occupancy rating 0,130,65,31,34,61,4,27,10,14,3,30,23,7,4,1,0,0,3
S01007334,Occupancy rating -1 or less,49,31,19,12,15,1,6,1,4,1,8,7,1,3,1,0,0,2
S01007335,All households,412,180,70,110,222,38,133,47,58,28,51,34,17,10,5,0,1,4
S01007335,Occupancy rating +2 or more,85,38,24,14,47,14,31,22,5,4,2,2,0,0,0,0,0,0
S01007335,Occupancy rating +1,165,86,33,53,78,18,45,24,12,9,15,7,8,1,0,0,1,0
S01007335,Occupancy rating 0,132,50,13,37,76,5,45,0,31,14,26,19,7,6,3,0,0,3
S01007335,Occupancy rating -1 or less,30,6,0,6,21,1,12,1,10,1,8,6,2,3,2,0,0,1
S01007336,All households,302,182,37,145,106,15,63,32,27,4,28,21,7,14,3,0,1,10
S01007336,Occupancy rating +2 or more,54,23,4,19,27,4,20,11,8,1,3,3,0,4,2,0,0,2
S01007336,Occupancy rating +1,83,51,11,40,28,7,16,11,4,1,5,3,2,4,1,0,0,3
S01007336,Occupancy rating 0,126,80,15,65,42,3,23,8,13,2,16,11,5,4,0,0,1,3
S01007336,Occupancy rating -1 or less,39,28,7,21,9,1,4,2,2,0,4,4,0,2,0,0,0,2
S01007337,All households,380,215,116,99,155,30,97,53,34,10,28,22,6,10,0,0,3,7
S01007337,Occupancy rating +2 or more,83,35,19,16,46,9,35,22,9,4,2,2,0,2,0,0,0,2
S01007337,Occupancy rating +1,146,92,48,44,51,9,38,22,12,4,4,3,1,3,0,0,1,2
S01007337,Occupancy rating 0,133,81,46,35,49,11,20,8,11,1,18,15,3,3,0,0,2,1
S01007337,Occupancy rating -1 or less,18,7,3,4,9,1,4,1,2,1,4,2,2,2,0,0,0,2
S01007338,All households,302,69,40,29,224,31,153,54,74,25,40,21,19,9,2,0,3,4
S01007338,Occupancy rating +2 or more,147,51,31,20,92,27,64,47,12,5,1,1,0,4,0,0,3,1
S01007338,Occupancy rating +1,96,16,8,8,78,3,57,7,38,12,18,4,14,2,0,0,0,2
S01007338,Occupancy rating 0,46,2,1,1,42,0,27,0,19,8,15,11,4,2,1,0,0,1
S01007338,Occupancy rating -1 or less,13,0,0,0,12,1,5,0,5,0,6,5,1,1,1,0,0,0
S01007339,All households,302,123,70,53,171,45,113,49,52,12,13,7,6,8,2,0,4,2
S01007339,Occupancy rating +2 or more,173,58,36,22,111,32,72,36,28,8,7,2,5,4,0,0,3,1
S01007339,Occupancy rating +1,74,37,24,13,35,7,26,10,12,4,2,1,1,2,1,0,1,0
S01007339,Occupancy rating 0,38,14,5,9,22,6,12,1,11,0,4,4,0,2,1,0,0,1
S01007339,Occupancy rating -1 or less,17,14,5,9,3,0,3,2,1,0,0,0,0,0,0,0,0,0
S01007340,All households,273,154,77,77,113,22,77,42,30,5,14,8,6,6,3,0,0,3
S01007340,Occupancy rating +2 or more,69,27,14,13,41,11,30,22,6,2,0,0,0,1,0,0,0,1
S01007340,Occupancy rating +1,72,35,19,16,37,8,24,13,9,2,5,3,2,0,0,0,0,0
S01007340,Occupancy rating 0,109,76,37,39,30,1,21,6,14,1,8,4,4,3,2,0,0,1
S01007340,Occupancy rating -1 or less,23,16,7,9,5,2,2,1,1,0,1,1,0,2,1,0,0,1
S01007341,All households,394,177,88,89,209,57,129,67,47,15,23,18,5,8,3,0,2,3
S01007341,Occupancy rating +2 or more,185,70,49,21,111,37,70,47,16,7,4,3,1,4,1,0,1,2
S01007341,Occupancy rating +1,96,40,21,19,52,13,35,13,17,5,4,3,1,4,2,0,1,1
S01007341,Occupancy rating 0,85,46,12,34,39,7,20,5,12,3,12,9,3,0,0,0,0,0
S01007341,Occupancy rating -1 or less,28,21,6,15,7,0,4,2,2,0,3,3,0,0,0,0,0,0
S01007342,All households,359,106,59,47,235,54,170,85,63,22,11,6,5,18,6,0,2,10
S01007342,Occupancy rating +2 or more,267,66,40,26,190,48,135,74,46,15,7,4,3,11,3,0,1,7
S01007342,Occupancy rating +1,65,31,15,16,29,5,22,9,8,5,2,1,1,5,2,0,1,2
S01007342,Occupancy rating 0,21,8,4,4,13,1,10,1,8,1,2,1,1,0,0,0,0,0
S01007342,Occupancy rating -1 or less,6,1,0,1,3,0,3,1,1,1,0,0,0,2,1,0,0,1
S01007343,All households,302,95,53,42,195,42,140,77,44,19,13,3,10,12,6,0,1,5
S01007343,Occupancy rating +2 or more,187,42,26,16,134,30,99,57,26,16,5,0,5,11,6,0,1,4
S01007343,Occupancy rating +1,65,33,20,13,32,6,24,18,6,0,2,1,1,0,0,0,0,0
S01007343,Occupancy rating 0,33,9,2,7,23,4,14,1,11,2,5,1,4,1,0,0,0,1
S01007343,Occupancy rating -1 or less,17,11,5,6,6,2,3,1,1,1,1,1,0,0,0,0,0,0
S01007344,All households,242,118,57,61,113,32,63,35,23,5,18,10,8,11,4,0,1,6
S01007344,Occupancy rating +2 or more,84,31,14,17,48,17,28,17,9,2,3,1,2,5,4,0,0,1
S01007344,Occupancy rating +1,88,54,27,27,32,11,18,14,4,0,3,2,1,2,0,0,0,2
S01007344,Occupancy rating 0,55,26,14,12,25,3,15,4,9,2,7,4,3,4,0,0,1,3
S01007344,Occupancy rating -1 or less,15,7,2,5,8,1,2,0,1,1,5,3,2,0,0,0,0,0
S01007345,All households,315,165,74,91,142,11,83,27,47,9,48,40,8,8,1,0,1,6
S01007345,Occupancy rating +2 or more,48,21,5,16,27,5,21,10,8,3,1,1,0,0,0,0,0,0
S01007345,Occupancy rating +1,87,39,12,27,45,5,31,14,15,2,9,9,0,3,0,0,1,2
S01007345,Occupancy rating 0,130,71,40,31,55,0,24,2,18,4,31,24,7,4,1,0,0,3
S01007345,Occupancy rating -1 or less,50,34,17,17,15,1,7,1,6,0,7,6,1,1,0,0,0,1
S01007346,All households,351,227,76,151,117,25,55,32,18,5,37,22,15,7,1,0,0,6
S01007346,Occupancy rating +2 or more,38,23,9,14,15,2,9,6,2,1,4,3,1,0,0,0,0,0
S01007346,Occupancy rating +1,105,60,31,29,43,19,20,13,5,2,4,1,3,2,0,0,0,2
S01007346,Occupancy rating 0,149,102,27,75,42,3,20,10,8,2,19,13,6,5,1,0,0,4
S01007346,Occupancy rating -1 or less,59,42,9,33,17,1,6,3,3,0,10,5,5,0,0,0,0,0
S01007347,All households,351,190,78,112,154,28,89,38,30,21,37,22,15,7,0,0,0,7
S01007347,Occupancy rating +2 or more,81,39,20,19,41,13,26,15,8,3,2,2,0,1,0,0,0,1
S01007347,Occupancy rating +1,98,47,17,30,48,10,29,15,8,6,9,5,4,3,0,0,0,3
S01007347,Occupancy rating 0,124,68,29,39,53,4,29,8,11,10,20,15,5,3,0,0,0,3
S01007347,Occupancy rating -1 or less,48,36,12,24,12,1,5,0,3,2,6,0,6,0,0,0,0,0
S01007348,All households,280,116,65,51,155,16,95,34,44,17,44,32,12,9,5,0,0,4
S01007348,Occupancy rating +2 or more,62,23,10,13,38,5,29,18,8,3,4,2,2,1,0,0,0,1
S01007348,Occupancy rating +1,95,38,19,19,54,8,32,12,12,8,14,9,5,3,2,0,0,1
S01007348,Occupancy rating 0,90,39,26,13,49,1,28,4,21,3,20,16,4,2,1,0,0,1
S01007348,Occupancy rating -1 or less,33,16,10,6,14,2,6,0,3,3,6,5,1,3,2,0,0,1
S01007349,All households,189,42,19,23,138,16,80,35,29,16,42,30,12,9,6,0,0,3
S01007349,Occupancy rating +2 or more,61,9,4,5,51,8,38,17,15,6,5,2,3,1,0,0,0,1
S01007349,Occupancy rating +1,81,27,14,13,51,7,29,17,6,6,15,11,4,3,3,0,0,0
S01007349,Occupancy rating 0,37,3,0,3,30,1,10,1,7,2,19,15,4,4,2,0,0,2
S01007349,Occupancy rating -1 or less,10,3,1,2,6,0,3,0,1,2,3,2,1,1,1,0,0,0
S01007350,All households,331,204,102,102,118,21,77,44,21,12,20,17,3,9,1,0,1,7
S01007350,Occupancy rating +2 or more,93,47,24,23,45,8,34,25,5,4,3,2,1,1,0,0,0,1
S01007350,Occupancy rating +1,98,59,26,33,36,6,23,16,4,3,7,5,2,3,0,0,0,3
S01007350,Occupancy rating 0,102,69,40,29,30,7,15,3,10,2,8,8,0,3,0,0,1,2
S01007350,Occupancy rating -1 or less,38,29,12,17,7,0,5,0,2,3,2,2,0,2,1,0,0,1
S01007351,All households,355,152,76,76,192,65,114,69,31,14,13,8,5,11,2,0,2,7
S01007351,Occupancy rating +2 or more,204,81,50,31,122,46,73,48,16,9,3,1,2,1,0,0,0,1
S01007351,Occupancy rating +1,90,49,21,28,36,15,19,11,4,4,2,1,1,5,0,0,2,3
S01007351,Occupancy rating 0,41,11,4,7,28,3,18,9,8,1,7,5,2,2,1,0,0,1
S01007351,Occupancy rating -1 or less,20,11,1,10,6,1,4,1,3,0,1,1,0,3,1,0,0,2
S01007352,All households,230,58,28,30,165,25,134,84,33,17,6,2,4,7,1,0,0,6
S01007352,Occupancy rating +2 or more,146,38,20,18,106,22,83,61,14,8,1,0,1,2,0,0,0,2
S01007352,Occupancy rating +1,42,9,3,6,32,2,27,15,7,5,3,1,2,1,0,0,0,1
S01007352,Occupancy rating 0,25,5,5,0,19,1,16,7,7,2,2,1,1,1,0,0,0,1
S01007352,Occupancy rating -1 or less,17,6,0,6,8,0,8,1,5,2,0,0,0,3,1,0,0,2
S01007353,All households,282,68,40,28,203,50,127,69,36,22,26,17,9,11,4,0,1,6
S01007353,Occupancy rating +2 or more,197,44,29,15,144,48,90,59,19,12,6,2,4,9,3,0,1,5
S01007353,Occupancy rating +1,42,14,9,5,27,2,17,6,6,5,8,4,4,1,1,0,0,0
S01007353,Occupancy rating 0,33,9,2,7,23,0,15,3,8,4,8,7,1,1,0,0,0,1
S01007353,Occupancy rating -1 or less,10,1,0,1,9,0,5,1,3,1,4,4,0,0,0,0,0,0
S01007354,All households,403,139,88,51,254,74,162,99,48,15,18,10,8,10,1,0,3,6
S01007354,Occupancy rating +2 or more,205,56,35,21,147,44,97,65,24,8,6,2,4,2,1,0,0,1
S01007354,Occupancy rating +1,94,29,19,10,63,19,38,26,9,3,6,3,3,2,0,0,1,1
S01007354,Occupancy rating 0,74,38,25,13,32,10,17,6,8,3,5,4,1,4,0,0,1,3
S01007354,Occupancy rating -1 or less,30,16,9,7,12,1,10,2,7,1,1,1,0,2,0,0,1,1
S01007355,All households,464,173,85,88,271,61,196,124,47,25,14,9,5,20,3,0,0,17
S01007355,Occupancy rating +2 or more,318,105,52,53,202,51,146,109,25,12,5,2,3,11,1,0,0,10
S01007355,Occupancy rating +1,79,33,14,19,43,7,32,10,11,11,4,3,1,3,0,0,0,3
S01007355,Occupancy rating 0,53,29,17,12,20,3,14,5,8,1,3,3,0,4,2,0,0,2
S01007355,Occupancy rating -1 or less,14,6,2,4,6,0,4,0,3,1,2,1,1,2,0,0,0,2
S01007356,All households,350,110,62,48,226,53,145,88,41,16,28,18,10,14,4,0,1,9
S01007356,Occupancy rating +2 or more,212,59,37,22,144,41,96,66,20,10,7,2,5,9,2,0,1,6
S01007356,Occupancy rating +1,70,29,17,12,40,6,26,18,5,3,8,5,3,1,0,0,0,1
S01007356,Occupancy rating 0,44,19,8,11,24,4,13,2,9,2,7,7,0,1,0,0,0,1
S01007356,Occupancy rating -1 or less,24,3,0,3,18,2,10,2,7,1,6,4,2,3,2,0,0,1
S01007357,All households,388,149,85,64,219,51,150,75,58,17,18,11,7,20,8,0,3,9
S01007357,Occupancy rating +2 or more,234,95,53,42,131,40,89,59,25,5,2,0,2,8,4,0,1,3
S01007357,Occupancy rating +1,88,31,15,16,52,8,34,9,16,9,10,6,4,5,0,0,2,3
S01007357,Occupancy rating 0,43,14,9,5,26,1,20,6,11,3,5,4,1,3,1,0,0,2
S01007357,Occupancy rating -1 or less,23,9,8,1,10,2,7,1,6,0,1,1,0,4,3,0,0,1
S01007358,All households,368,103,40,63,239,26,189,100,66,23,24,14,10,26,10,0,2,14
S01007358,Occupancy rating +2 or more,194,53,22,31,132,21,107,66,31,10,4,0,4,9,5,0,0,4
S01007358,Occupancy rating +1,91,30,9,21,55,5,44,22,16,6,6,2,4,6,0,0,0,6
S01007358,Occupancy rating 0,57,15,8,7,36,0,27,11,10,6,9,8,1,6,4,0,1,1
S01007358,Occupancy rating -1 or less,26,5,1,4,16,0,11,1,9,1,5,4,1,5,1,0,1,3
S01007359,All households,371,117,65,52,241,50,138,57,56,25,53,36,17,13,8,0,0,5
S01007359,Occupancy rating +2 or more,185,65,43,22,119,38,66,39,18,9,15,10,5,1,1,0,0,0
S01007359,Occupancy rating +1,90,28,8,20,58,8,37,15,16,6,13,6,7,4,3,0,0,1
S01007359,Occupancy rating 0,74,20,12,8,51,4,28,3,17,8,19,14,5,3,1,0,0,2
S01007359,Occupancy rating -1 or less,22,4,2,2,13,0,7,0,5,2,6,6,0,5,3,0,0,2
S01007360,All households,236,63,37,26,167,42,108,65,26,17,17,9,8,6,1,1,0,4
S01007360,Occupancy rating +2 or more,146,37,22,15,105,32,66,43,13,10,7,2,5,4,1,0,0,3
S01007360,Occupancy rating +1,57,15,9,6,41,8,28,17,6,5,5,3,2,1,0,0,0,1
S01007360,Occupancy rating 0,23,8,6,2,14,1,9,5,3,1,4,4,0,1,0,1,0,0
S01007360,Occupancy rating -1 or less,10,3,0,3,7,1,5,0,4,1,1,0,1,0,0,0,0,0
S01007361,All households,507,215,119,96,273,66,176,96,59,21,31,11,20,19,8,0,2,9
S01007361,Occupancy rating +2 or more,243,77,51,26,159,47,97,65,19,13,15,5,10,7,2,0,2,3
S01007361,Occupancy rating +1,119,54,25,29,59,13,40,20,17,3,6,0,6,6,2,0,0,4
S01007361,Occupancy rating 0,116,74,40,34,39,5,28,9,15,4,6,3,3,3,1,0,0,2
S01007361,Occupancy rating -1 or less,29,10,3,7,16,1,11,2,8,1,4,3,1,3,3,0,0,0
S01007362,All households,316,94,51,43,203,52,124,48,56,20,27,15,12,19,6,2,4,7
S01007362,Occupancy rating +2 or more,148,38,22,16,105,37,60,32,19,9,8,3,5,5,2,1,0,2
S01007362,Occupancy rating +1,101,45,24,21,52,13,33,11,17,5,6,5,1,4,1,1,0,2
S01007362,Occupancy rating 0,50,8,4,4,36,1,24,5,14,5,11,6,5,6,2,0,3,1
S01007362,Occupancy rating -1 or less,17,3,1,2,10,1,7,0,6,1,2,1,1,4,1,0,1,2
S01007363,All households,348,142,94,48,189,53,118,57,36,25,18,11,7,17,6,0,0,11
S01007363,Occupancy rating +2 or more,173,47,31,16,118,40,74,39,19,16,4,2,2,8,2,0,0,6
S01007363,Occupancy rating +1,71,29,21,8,38,7,25,10,8,7,6,3,3,4,1,0,0,3
S01007363,Occupancy rating 0,79,50,36,14,25,5,15,8,6,1,5,3,2,4,2,0,0,2
S01007363,Occupancy rating -1 or less,25,16,6,10,8,1,4,0,3,1,3,3,0,1,1,0,0,0
S01007364,All households,409,154,54,100,242,17,126,47,62,17,99,72,27,13,6,0,1,6
S01007364,Occupancy rating +2 or more,76,31,13,18,45,4,31,18,11,2,10,7,3,0,0,0,0,0
S01007364,Occupancy rating +1,126,57,19,38,64,9,33,18,10,5,22,14,8,5,1,0,0,4
S01007364,Occupancy rating 0,157,52,20,32,101,2,48,9,29,10,51,39,12,4,2,0,1,1
S01007364,Occupancy rating -1 or less,50,14,2,12,32,2,14,2,12,0,16,12,4,4,3,0,0,1
S01007365,All households,215,75,35,40,132,23,82,37,31,14,27,22,5,8,4,0,2,2
S01007365,Occupancy rating +2 or more,98,28,15,13,69,21,43,23,14,6,5,3,2,1,0,0,1,0
S01007365,Occupancy rating +1,54,33,18,15,20,2,16,10,5,1,2,2,0,1,1,0,0,0
S01007365,Occupancy rating 0,45,13,2,11,30,0,16,4,9,3,14,12,2,2,0,0,1,1
S01007365,Occupancy rating -1 or less,18,1,0,1,13,0,7,0,3,4,6,5,1,4,3,0,0,1
S01007366,All households,276,166,89,77,101,14,58,25,26,7,29,24,5,9,2,0,3,4
S01007366,Occupancy rating +2 or more,66,30,19,11,35,6,24,15,6,3,5,4,1,1,0,0,0,1
S01007366,Occupancy rating +1,49,25,13,12,23,3,14,6,6,2,6,6,0,1,1,0,0,0
S01007366,Occupancy rating 0,109,81,48,33,26,4,11,3,7,1,11,9,2,2,0,0,0,2
S01007366,Occupancy rating -1 or less,52,30,9,21,17,1,9,1,7,1,7,5,2,5,1,0,3,1
S01007367,All households,295,135,67,68,144,20,93,52,33,8,31,18,13,16,3,0,3,10
S01007367,Occupancy rating +2 or more,83,23,18,5,56,12,42,30,10,2,2,1,1,4,1,0,2,1
S01007367,Occupancy rating +1,84,44,23,21,39,5,26,14,10,2,8,5,3,1,0,0,0,1
S01007367,Occupancy rating 0,94,46,17,29,41,3,23,8,13,2,15,8,7,7,1,0,0,6
S01007367,Occupancy rating -1 or less,34,22,9,13,8,0,2,0,0,2,6,4,2,4,1,0,1,2
S01007368,All households,233,91,29,62,129,11,71,20,38,13,47,34,13,13,7,0,0,6
S01007368,Occupancy rating +2 or more,67,30,12,18,32,3,27,13,9,5,2,1,1,5,2,0,0,3
S01007368,Occupancy rating +1,63,24,11,13,38,6,24,7,13,4,8,5,3,1,0,0,0,1
S01007368,Occupancy rating 0,77,33,5,28,40,1,13,0,10,3,26,21,5,4,4,0,0,0
S01007368,Occupancy rating -1 or less,26,4,1,3,19,1,7,0,6,1,11,7,4,3,1,0,0,2
S01007369,All households,378,158,46,112,208,28,137,52,61,24,43,30,13,12,6,0,0,6
S01007369,Occupancy rating +2 or more,135,52,18,34,79,16,57,28,18,11,6,2,4,4,3,0,0,1
S01007369,Occupancy rating +1,106,37,13,24,64,7,47,14,26,7,10,8,2,5,2,0,0,3
S01007369,Occupancy rating 0,101,50,13,37,49,2,25,6,15,4,22,17,5,2,0,0,0,2
S01007369,Occupancy rating -1 or less,36,19,2,17,16,3,8,4,2,2,5,3,2,1,1,0,0,0
S01007370,All households,389,185,55,130,181,16,118,58,44,16,47,30,17,23,4,0,0,19
S01007370,Occupancy rating +2 or more,140,59,26,33,78,14,54,34,15,5,10,7,3,3,1,0,0,2
S01007370,Occupancy rating +1,93,48,14,34,41,2,29,16,8,5,10,7,3,4,0,0,0,4
S01007370,Occupancy rating 0,99,42,8,34,47,0,24,5,16,3,23,13,10,10,0,0,0,10
S01007370,Occupancy rating -1 or less,57,36,7,29,15,0,11,3,5,3,4,3,1,6,3,0,0,3
S01007371,All households,320,116,35,81,186,28,120,45,60,15,38,31,7,18,7,0,2,9
S01007371,Occupancy rating +2 or more,152,46,19,27,98,21,69,32,27,10,8,7,1,8,4,0,1,3
S01007371,Occupancy rating +1,72,31,9,22,39,5,25,9,12,4,9,7,2,2,0,0,1,1
S01007371,Occupancy rating 0,68,32,5,27,32,1,19,4,14,1,12,10,2,4,2,0,0,2
S01007371,Occupancy rating -1 or less,28,7,2,5,17,1,7,0,7,0,9,7,2,4,1,0,0,3
S01007372,All households,374,121,61,60,242,59,151,65,65,21,32,22,10,11,3,0,1,7
S01007372,Occupancy rating +2 or more,221,64,38,26,153,43,98,47,37,14,12,8,4,4,1,0,0,3
S01007372,Occupancy rating +1,89,35,14,21,52,15,31,13,15,3,6,4,2,2,1,0,1,0
S01007372,Occupancy rating 0,35,11,5,6,21,1,11,1,7,3,9,6,3,3,0,0,0,3
S01007372,Occupancy rating -1 or less,29,11,4,7,16,0,11,4,6,1,5,4,1,2,1,0,0,1
S01007373,All households,283,94,47,47,175,43,121,69,39,13,11,5,6,14,4,0,0,10
S01007373,Occupancy rating +2 or more,178,44,16,28,125,30,89,55,28,6,6,4,2,9,3,0,0,6
S01007373,Occupancy rating +1,69,35,21,14,31,11,18,12,3,3,2,0,2,3,1,0,0,2
S01007373,Occupancy rating 0,26,10,6,4,16,2,13,2,7,4,1,0,1,0,0,0,0,0
S01007373,Occupancy rating -1 or less,10,5,4,1,3,0,1,0,1,0,2,1,1,2,0,0,0,2
S01007374,All households,217,54,23,31,155,18,122,55,46,21,15,8,7,8,5,0,0,3
S01007374,Occupancy rating +2 or more,122,30,14,16,91,17,70,44,20,6,4,3,1,1,0,0,0,1
S01007374,Occupancy rating +1,56,12,5,7,40,1,32,8,14,10,7,2,5,4,3,0,0,1
S01007374,Occupancy rating 0,30,10,3,7,18,0,14,3,6,5,4,3,1,2,1,0,0,1
S01007374,Occupancy rating -1 or less,9,2,1,1,6,0,6,0,6,0,0,0,0,1,1,0,0,0
S01007375,All households,216,60,31,29,143,26,98,59,25,14,19,10,9,13,3,0,2,8
S01007375,Occupancy rating +2 or more,138,34,16,18,96,19,66,45,14,7,11,5,6,8,2,0,0,6
S01007375,Occupancy rating +1,40,14,8,6,25,5,15,7,5,3,5,2,3,1,0,0,1,0
S01007375,Occupancy rating 0,30,11,6,5,17,2,12,5,3,4,3,3,0,2,0,0,0,2
S01007375,Occupancy rating -1 or less,8,1,1,0,5,0,5,2,3,0,0,0,0,2,1,0,1,0
S01007376,All households,371,115,48,67,244,23,159,70,67,22,62,45,17,12,7,0,0,5
S01007376,Occupancy rating +2 or more,139,50,21,29,86,14,63,47,11,5,9,7,2,3,2,0,0,1
S01007376,Occupancy rating +1,121,38,15,23,81,6,53,20,23,10,22,12,10,2,1,0,0,1
S01007376,Occupancy rating 0,93,27,12,15,62,2,35,2,27,6,25,21,4,4,1,0,0,3
S01007376,Occupancy rating -1 or less,18,0,0,0,15,1,8,1,6,1,6,5,1,3,3,0,0,0
S01007377,All households,279,54,22,32,211,33,155,88,53,14,23,20,3,14,5,0,1,8
S01007377,Occupancy rating +2 or more,218,42,19,23,166,31,119,77,32,10,16,14,2,10,5,0,0,5
S01007377,Occupancy rating +1,28,7,2,5,21,2,17,8,8,1,2,1,1,0,0,0,0,0
S01007377,Occupancy rating 0,28,3,0,3,21,0,17,3,11,3,4,4,0,4,0,0,1,3
S01007377,Occupancy rating -1 or less,5,2,1,1,3,0,2,0,2,0,1,1,0,0,0,0,0,0
S01007378,All households,231,55,22,33,167,23,130,61,51,18,14,7,7,9,1,0,3,5
S01007378,Occupancy rating +2 or more,149,27,13,14,117,21,95,48,31,16,1,0,1,5,1,0,2,2
S01007378,Occupancy rating +1,42,13,4,9,29,2,19,11,7,1,8,3,5,0,0,0,0,0
S01007378,Occupancy rating 0,30,12,2,10,16,0,12,2,9,1,4,3,1,2,0,0,1,1
S01007378,Occupancy rating -1 or less,10,3,3,0,5,0,4,0,4,0,1,1,0,2,0,0,0,2
S01007379,All households,234,92,49,43,134,21,87,35,38,14,26,15,11,8,5,0,1,2
S01007379,Occupancy rating +2 or more,79,32,21,11,46,11,33,25,5,3,2,1,1,1,1,0,0,0
S01007379,Occupancy rating +1,90,42,19,23,45,9,28,10,13,5,8,2,6,3,0,0,1,2
S01007379,Occupancy rating 0,51,15,6,9,33,1,21,0,16,5,11,8,3,3,3,0,0,0
S01007379,Occupancy rating -1 or less,14,3,3,0,10,0,5,0,4,1,5,4,1,1,1,0,0,0
S01007380,All households,229,59,24,35,161,8,125,45,62,18,28,16,12,9,5,0,0,4
S01007380,Occupancy rating +2 or more,91,28,11,17,61,6,53,36,14,3,2,1,1,2,1,0,0,1
S01007380,Occupancy rating +1,81,20,5,15,60,2,46,8,26,12,12,6,6,1,0,0,0,1
S01007380,Occupancy rating 0,45,7,5,2,33,0,23,1,20,2,10,7,3,5,3,0,0,2
S01007380,Occupancy rating -1 or less,12,4,3,1,7,0,3,0,2,1,4,2,2,1,1,0,0,0
S01007381,All households,191,39,21,18,144,30,104,50,40,14,10,8,2,8,1,0,2,5
S01007381,Occupancy rating +2 or more,164,30,19,11,127,28,92,46,34,12,7,5,2,7,0,0,2,5
S01007381,Occupancy rating +1,15,7,1,6,8,1,6,3,2,1,1,1,0,0,0,0,0,0
S01007381,Occupancy rating 0,8,1,0,1,6,1,4,1,2,1,1,1,0,1,1,0,0,0
S01007381,Occupancy rating -1 or less,4,1,1,0,3,0,2,0,2,0,1,1,0,0,0,0,0,0
S01007382,All households,281,87,36,51,186,29,135,54,64,17,22,17,5,8,1,0,1,6
S01007382,Occupancy rating +2 or more,169,43,25,18,120,25,85,42,34,9,10,9,1,6,1,0,1,4
S01007382,Occupancy rating +1,65,31,9,22,33,4,25,7,13,5,4,3,1,1,0,0,0,1
S01007382,Occupancy rating 0,43,13,2,11,29,0,23,4,16,3,6,3,3,1,0,0,0,1
S01007382,Occupancy rating -1 or less,4,0,0,0,4,0,2,1,1,0,2,2,0,0,0,0,0,0
S01007383,All households,349,107,49,58,234,52,160,82,53,25,22,14,8,8,4,0,0,4
S01007383,Occupancy rating +2 or more,181,35,21,14,142,37,101,49,35,17,4,3,1,4,3,0,0,1
S01007383,Occupancy rating +1,108,50,18,32,56,13,36,26,5,5,7,4,3,2,1,0,0,1
S01007383,Occupancy rating 0,45,18,8,10,26,2,17,7,7,3,7,3,4,1,0,0,0,1
S01007383,Occupancy rating -1 or less,15,4,2,2,10,0,6,0,6,0,4,4,0,1,0,0,0,1
S01007384,All households,332,86,37,49,237,33,164,65,84,15,40,34,6,9,1,0,1,7
S01007384,Occupancy rating +2 or more,199,42,23,19,152,29,110,54,50,6,13,8,5,5,1,0,1,3
S01007384,Occupancy rating +1,82,37,12,25,44,4,34,9,19,6,6,6,0,1,0,0,0,1
S01007384,Occupancy rating 0,42,6,2,4,33,0,15,2,11,2,18,17,1,3,0,0,0,3
S01007384,Occupancy rating -1 or less,9,1,0,1,8,0,5,0,4,1,3,3,0,0,0,0,0,0
S01007385,All households,404,138,82,56,263,60,167,76,61,30,36,17,19,3,1,0,0,2
S01007385,Occupancy rating +2 or more,220,68,47,21,152,44,101,52,33,16,7,2,5,0,0,0,0,0
S01007385,Occupancy rating +1,132,62,31,31,69,13,47,20,18,9,9,2,7,1,0,0,0,1
S01007385,Occupancy rating 0,41,6,3,3,33,3,16,2,10,4,14,9,5,2,1,0,0,1
S01007385,Occupancy rating -1 or less,11,2,1,1,9,0,3,2,0,1,6,4,2,0,0,0,0,0
S01007386,All households,337,69,44,25,256,61,177,74,75,28,18,10,8,12,3,0,2,7
S01007386,Occupancy rating +2 or more,270,46,34,12,218,56,149,66,58,25,13,7,6,6,2,0,0,4
S01007386,Occupancy rating +1,42,15,6,9,26,5,19,7,11,1,2,1,1,1,1,0,0,0
S01007386,Occupancy rating 0,23,8,4,4,10,0,8,1,5,2,2,1,1,5,0,0,2,3
S01007386,Occupancy rating -1 or less,2,0,0,0,2,0,1,0,1,0,1,1,0,0,0,0,0,0
S01007387,All households,289,33,21,12,246,40,193,86,76,31,13,7,6,10,3,0,0,7
S01007387,Occupancy rating +2 or more,257,29,18,11,222,40,172,82,63,27,10,6,4,6,1,0,0,5
S01007387,Occupancy rating +1,20,3,2,1,15,0,13,4,7,2,2,1,1,2,2,0,0,0
S01007387,Occupancy rating 0,9,0,0,0,7,0,6,0,4,2,1,0,1,2,0,0,0,2
S01007387,Occupancy rating -1 or less,3,1,1,0,2,0,2,0,2,0,0,0,0,0,0,0,0,0
S01007388,All households,256,37,20,17,211,46,149,55,59,35,16,13,3,8,3,0,0,5
S01007388,Occupancy rating +2 or more,210,36,19,17,170,43,117,54,36,27,10,8,2,4,2,0,0,2
S01007388,Occupancy rating +1,26,0,0,0,25,2,22,1,17,4,1,1,0,1,0,0,0,1
S01007388,Occupancy rating 0,15,1,1,0,12,1,7,0,5,2,4,3,1,2,1,0,0,1
S01007388,Occupancy rating -1 or less,5,0,0,0,4,0,3,0,1,2,1,1,0,1,0,0,0,1
S01007389,All households,198,27,0,27,165,2,125,36,80,9,38,32,6,6,3,0,0,3
S01007389,Occupancy rating +2 or more,44,9,0,9,35,2,31,13,17,1,2,2,0,0,0,0,0,0
S01007389,Occupancy rating +1,72,17,0,17,54,0,48,22,25,1,6,5,1,1,0,0,0,1
S01007389,Occupancy rating 0,71,1,0,1,68,0,41,1,35,5,27,22,5,2,1,0,0,1
S01007389,Occupancy rating -1 or less,11,0,0,0,8,0,5,0,3,2,3,3,0,3,2,0,0,1
S01007390,All households,193,28,1,27,158,2,110,24,80,6,46,42,4,7,6,0,0,1
S01007390,Occupancy rating +2 or more,43,8,1,7,33,2,28,10,17,1,3,2,1,2,2,0,0,0
S01007390,Occupancy rating +1,69,17,0,17,52,0,42,14,25,3,10,7,3,0,0,0,0,0
S01007390,Occupancy rating 0,69,2,0,2,63,0,34,0,33,1,29,29,0,4,3,0,0,1
S01007390,Occupancy rating -1 or less,12,1,0,1,10,0,6,0,5,1,4,4,0,1,1,0,0,0
S01007391,All households,223,39,24,15,176,35,134,49,49,36,7,5,2,8,4,0,0,4
S01007391,Occupancy rating +2 or more,175,35,22,13,137,35,99,47,29,23,3,1,2,3,2,0,0,1
S01007391,Occupancy rating +1,32,3,2,1,25,0,22,2,12,8,3,3,0,4,2,0,0,2
S01007391,Occupancy rating 0,13,1,0,1,11,0,11,0,8,3,0,0,0,1,0,0,0,1
S01007391,Occupancy rating -1 or less,3,0,0,0,3,0,2,0,0,2,1,1,0,0,0,0,0,0
S01007392,All households,200,55,28,27,140,32,102,46,33,23,6,2,4,5,2,0,0,3
S01007392,Occupancy rating +2 or more,144,34,19,15,105,26,75,37,21,17,4,1,3,5,2,0,0,3
S01007392,Occupancy rating +1,39,17,7,10,22,4,17,8,4,5,1,0,1,0,0,0,0,0
S01007392,Occupancy rating 0,15,3,1,2,12,1,10,1,8,1,1,1,0,0,0,0,0,0
S01007392,Occupancy rating -1 or less,2,1,1,0,1,1,0,0,0,0,0,0,0,0,0,0,0,0
S01007393,All households,308,117,84,33,182,37,131,61,55,15,14,10,4,9,4,0,4,1
S01007393,Occupancy rating +2 or more,178,32,22,10,142,27,107,52,43,12,8,6,2,4,2,0,2,0
S01007393,Occupancy rating +1,43,25,16,9,17,4,11,5,5,1,2,2,0,1,1,0,0,0
S01007393,Occupancy rating 0,66,49,39,10,14,4,8,3,4,1,2,1,1,3,0,0,2,1
S01007393,Occupancy rating -1 or less,21,11,7,4,9,2,5,1,3,1,2,1,1,1,1,0,0,0
S01007394,All households,335,165,115,50,160,40,96,39,44,13,24,9,15,10,4,0,1,5
S01007394,Occupancy rating +2 or more,168,48,29,19,114,32,74,28,34,12,8,0,8,6,2,0,1,3
S01007394,Occupancy rating +1,79,59,37,22,20,2,12,8,3,1,6,4,2,0,0,0,0,0
S01007394,Occupancy rating 0,80,52,43,9,24,5,10,3,7,0,9,4,5,4,2,0,0,2
S01007394,Occupancy rating -1 or less,8,6,6,0,2,1,0,0,0,0,1,1,0,0,0,0,0,0
S01007395,All households,516,324,112,212,174,26,110,74,33,3,38,23,15,18,1,0,0,17
S01007395,Occupancy rating +2 or more,68,31,14,17,34,7,22,17,4,1,5,3,2,3,1,0,0,2
S01007395,Occupancy rating +1,154,105,31,74,44,8,32,29,3,0,4,2,2,5,0,0,0,5
S01007395,Occupancy rating 0,210,127,51,76,75,8,45,21,22,2,22,13,9,8,0,0,0,8
S01007395,Occupancy rating -1 or less,84,61,16,45,21,3,11,7,4,0,7,5,2,2,0,0,0,2
S01007396,All households,477,268,95,173,197,28,117,66,38,13,52,37,15,12,2,0,1,9
S01007396,Occupancy rating +2 or more,92,44,17,27,47,9,34,19,8,7,4,3,1,1,0,0,0,1
S01007396,Occupancy rating +1,161,106,37,69,50,13,32,22,8,2,5,4,1,5,2,0,1,2
S01007396,Occupancy rating 0,181,98,34,64,78,3,43,23,19,1,32,21,11,5,0,0,0,5
S01007396,Occupancy rating -1 or less,43,20,7,13,22,3,8,2,3,3,11,9,2,1,0,0,0,1
S01007397,All households,443,164,73,91,264,60,179,85,76,18,25,18,7,15,6,1,2,6
S01007397,Occupancy rating +2 or more,222,46,31,15,171,49,116,61,45,10,6,4,2,5,3,0,0,2
S01007397,Occupancy rating +1,98,54,22,32,43,10,27,12,12,3,6,4,2,1,1,0,0,0
S01007397,Occupancy rating 0,98,54,20,34,41,1,31,11,17,3,9,8,1,3,1,0,1,1
S01007397,Occupancy rating -1 or less,25,10,0,10,9,0,5,1,2,2,4,2,2,6,1,1,1,3
S01007398,All households,279,73,19,54,194,8,107,40,48,19,79,48,31,12,5,0,1,6
S01007398,Occupancy rating +2 or more,67,25,12,13,40,4,29,22,5,2,7,2,5,2,0,0,0,2
S01007398,Occupancy rating +1,102,31,7,24,68,3,41,17,17,7,24,10,14,3,0,0,1,2
S01007398,Occupancy rating 0,88,12,0,12,71,1,30,1,21,8,40,28,12,5,3,0,0,2
S01007398,Occupancy rating -1 or less,22,5,0,5,15,0,7,0,5,2,8,8,0,2,2,0,0,0
S01007399,All households,324,146,23,123,170,13,92,38,42,12,65,44,21,8,3,0,0,5
S01007399,Occupancy rating +2 or more,54,19,5,14,33,5,26,18,5,3,2,1,1,2,0,0,0,2
S01007399,Occupancy rating +1,108,52,5,47,56,7,28,15,10,3,21,12,9,0,0,0,0,0
S01007399,Occupancy rating 0,128,63,10,53,62,1,32,4,23,5,29,20,9,3,1,0,0,2
S01007399,Occupancy rating -1 or less,34,12,3,9,19,0,6,1,4,1,13,11,2,3,2,0,0,1
S01007400,All households,344,152,86,66,184,29,132,59,49,24,23,11,12,8,3,0,1,4
S01007400,Occupancy rating +2 or more,165,59,34,25,102,15,82,40,30,12,5,1,4,4,1,0,1,2
S01007400,Occupancy rating +1,78,31,16,15,46,7,29,12,9,8,10,6,4,1,1,0,0,0
S01007400,Occupancy rating 0,76,47,30,17,27,7,16,5,7,4,4,3,1,2,0,0,0,2
S01007400,Occupancy rating -1 or less,25,15,6,9,9,0,5,2,3,0,4,1,3,1,1,0,0,0
S01007401,All households,290,82,39,43,195,27,141,57,52,32,27,19,8,13,6,0,4,3
S01007401,Occupancy rating +2 or more,151,39,23,16,105,18,77,44,18,15,10,5,5,7,3,0,1,3
S01007401,Occupancy rating +1,80,32,14,18,47,8,36,10,22,4,3,2,1,1,0,0,1,0
S01007401,Occupancy rating 0,48,11,2,9,34,1,25,2,12,11,8,6,2,3,1,0,2,0
S01007401,Occupancy rating -1 or less,11,0,0,0,9,0,3,1,0,2,6,6,0,2,2,0,0,0
S01007402,All households,260,70,48,22,180,30,132,45,56,31,18,10,8,10,6,1,0,3
S01007402,Occupancy rating +2 or more,143,46,32,14,91,21,63,35,12,16,7,3,4,6,4,0,0,2
S01007402,Occupancy rating +1,77,22,16,6,54,9,42,10,23,9,3,2,1,1,0,0,0,1
S01007402,Occupancy rating 0,29,2,0,2,25,0,20,0,14,6,5,2,3,2,1,1,0,0
S01007402,Occupancy rating -1 or less,11,0,0,0,10,0,7,0,7,0,3,3,0,1,1,0,0,0
S01007403,All households,261,25,15,10,229,5,208,46,144,18,16,13,3,7,7,0,0,0
S01007403,Occupancy rating +2 or more,111,20,12,8,89,4,81,24,49,8,4,3,1,2,2,0,0,0
S01007403,Occupancy rating +1,97,5,3,2,90,1,85,22,55,8,4,2,2,2,2,0,0,0
S01007403,Occupancy rating 0,48,0,0,0,45,0,37,0,36,1,8,8,0,3,3,0,0,0
S01007403,Occupancy rating -1 or less,5,0,0,0,5,0,5,0,4,1,0,0,0,0,0,0,0,0
S01007404,All households,193,57,25,32,130,21,96,47,31,18,13,4,9,6,2,0,1,3
S01007404,Occupancy rating +2 or more,114,27,8,19,83,15,62,33,19,10,6,4,2,4,1,0,1,2
S01007404,Occupancy rating +1,42,11,8,3,30,4,22,11,7,4,4,0,4,1,0,0,0,1
S01007404,Occupancy rating 0,32,16,7,9,16,2,11,3,4,4,3,0,3,0,0,0,0,0
S01007404,Occupancy rating -1 or less,5,3,2,1,1,0,1,0,1,0,0,0,0,1,1,0,0,0
S01007405,All households,277,71,27,44,198,22,162,70,65,27,14,4,10,8,3,0,0,5
S01007405,Occupancy rating +2 or more,194,37,15,22,149,18,127,54,54,19,4,0,4,8,3,0,0,5
S01007405,Occupancy rating +1,54,24,7,17,30,4,23,12,4,7,3,0,3,0,0,0,0,0
S01007405,Occupancy rating 0,24,8,4,4,16,0,10,4,6,0,6,3,3,0,0,0,0,0
S01007405,Occupancy rating -1 or less,5,2,1,1,3,0,2,0,1,1,1,1,0,0,0,0,0,0
S01007406,All households,252,58,31,27,190,37,142,58,56,28,11,6,5,4,2,0,1,1
S01007406,Occupancy rating +2 or more,206,48,29,19,156,34,117,54,43,20,5,3,2,2,0,0,1,1
S01007406,Occupancy rating +1,29,7,2,5,20,2,17,3,8,6,1,0,1,2,2,0,0,0
S01007406,Occupancy rating 0,13,3,0,3,10,0,5,0,4,1,5,3,2,0,0,0,0,0
S01007406,Occupancy rating -1 or less,4,0,0,0,4,1,3,1,1,1,0,0,0,0,0,0,0,0
S01007407,All households,315,86,46,40,223,50,150,62,69,19,23,13,10,6,3,0,2,1
S01007407,Occupancy rating +2 or more,199,36,22,14,160,37,111,53,44,14,12,4,8,3,0,0,2,1
S01007407,Occupancy rating +1,61,23,14,9,37,12,21,7,11,3,4,3,1,1,1,0,0,0
S01007407,Occupancy rating 0,47,26,10,16,20,1,15,2,11,2,4,4,0,1,1,0,0,0
S01007407,Occupancy rating -1 or less,8,1,0,1,6,0,3,0,3,0,3,2,1,1,1,0,0,0
S01007408,All households,256,72,35,37,174,16,119,42,54,23,39,23,16,10,4,0,0,6
S01007408,Occupancy rating +2 or more,92,28,13,15,61,9,49,26,17,6,3,2,1,3,0,0,0,3
S01007408,Occupancy rating +1,86,34,17,17,50,4,36,12,15,9,10,6,4,2,1,0,0,1
S01007408,Occupancy rating 0,56,5,2,3,49,3,30,4,18,8,16,9,7,2,0,0,0,2
S01007408,Occupancy rating -1 or less,22,5,3,2,14,0,4,0,4,0,10,6,4,3,3,0,0,0
S01007409,All households,308,110,34,76,190,32,131,50,48,33,27,20,7,8,3,0,1,4
S01007409,Occupancy rating +2 or more,153,35,15,20,116,24,83,39,26,18,9,5,4,2,1,0,0,1
S01007409,Occupancy rating +1,86,44,4,40,39,6,31,9,12,10,2,1,1,3,1,0,1,1
S01007409,Occupancy rating 0,58,26,14,12,29,2,13,1,8,4,14,13,1,3,1,0,0,2
S01007409,Occupancy rating -1 or less,11,5,1,4,6,0,4,1,2,1,2,1,1,0,0,0,0,0
S01007410,All households,291,83,32,51,198,22,112,36,49,27,64,45,19,10,5,0,0,5
S01007410,Occupancy rating +2 or more,70,22,11,11,46,13,26,16,7,3,7,5,2,2,0,0,0,2
S01007410,Occupancy rating +1,88,30,11,19,56,7,36,16,11,9,13,4,9,2,1,0,0,1
S01007410,Occupancy rating 0,100,25,9,16,74,2,37,4,23,10,35,28,7,1,1,0,0,0
S01007410,Occupancy rating -1 or less,33,6,1,5,22,0,13,0,8,5,9,8,1,5,3,0,0,2
S01007411,All households,437,180,82,98,242,20,149,66,68,15,73,59,14,15,5,0,1,9
S01007411,Occupancy rating +2 or more,82,32,10,22,49,5,42,23,14,5,2,1,1,1,1,0,0,0
S01007411,Occupancy rating +1,150,71,27,44,75,9,50,33,12,5,16,14,2,4,1,0,1,2
S01007411,Occupancy rating 0,158,62,38,24,88,5,41,7,30,4,42,34,8,8,1,0,0,7
S01007411,Occupancy rating -1 or less,47,15,7,8,30,1,16,3,12,1,13,10,3,2,2,0,0,0
S01007412,All households,212,69,38,31,134,20,88,35,35,18,26,14,12,9,1,0,3,5
S01007412,Occupancy rating +2 or more,92,36,24,12,55,16,36,26,5,5,3,1,2,1,0,0,0,1
S01007412,Occupancy rating +1,67,22,8,14,40,4,26,6,12,8,10,5,5,5,1,0,1,3
S01007412,Occupancy rating 0,39,10,5,5,29,0,20,3,12,5,9,6,3,0,0,0,0,0
S01007412,Occupancy rating -1 or less,14,1,1,0,10,0,6,0,6,0,4,2,2,3,0,0,2,1
S01007413,All households,360,70,20,50,276,13,223,91,98,34,40,24,16,14,7,0,0,7
S01007413,Occupancy rating +2 or more,215,27,10,17,180,11,157,68,63,26,12,8,4,8,3,0,0,5
S01007413,Occupancy rating +1,81,34,7,27,46,2,35,18,12,5,9,5,4,1,1,0,0,0
S01007413,Occupancy rating 0,49,5,2,3,42,0,27,4,20,3,15,9,6,2,0,0,0,2
S01007413,Occupancy rating -1 or less,15,4,1,3,8,0,4,1,3,0,4,2,2,3,3,0,0,0
S01007414,All households,244,34,8,26,203,12,176,51,102,23,15,7,8,7,3,0,0,4
S01007414,Occupancy rating +2 or more,201,31,6,25,165,12,146,50,79,17,7,3,4,5,1,0,0,4
S01007414,Occupancy rating +1,34,3,2,1,29,0,24,1,19,4,5,3,2,2,2,0,0,0
S01007414,Occupancy rating 0,7,0,0,0,7,0,5,0,4,1,2,0,2,0,0,0,0,0
S01007414,Occupancy rating -1 or less,2,0,0,0,2,0,1,0,0,1,1,1,0,0,0,0,0,0
S01007415,All households,374,110,53,57,250,24,163,70,64,29,63,45,18,14,10,0,0,4
S01007415,Occupancy rating +2 or more,103,34,13,21,66,11,52,40,5,7,3,3,0,3,2,0,0,1
S01007415,Occupancy rating +1,140,48,22,26,90,9,64,29,22,13,17,12,5,2,2,0,0,0
S01007415,Occupancy rating 0,98,23,15,8,70,2,36,0,28,8,32,23,9,5,3,0,0,2
S01007415,Occupancy rating -1 or less,33,5,3,2,24,2,11,1,9,1,11,7,4,4,3,0,0,1
S01007416,All households,223,37,6,31,174,5,104,36,51,17,65,52,13,12,8,0,1,3
S01007416,Occupancy rating +2 or more,49,15,2,13,32,5,24,16,6,2,3,1,2,2,1,0,1,0
S01007416,Occupancy rating +1,73,20,4,16,50,0,39,19,10,10,11,7,4,3,1,0,0,2
S01007416,Occupancy rating 0,79,2,0,2,74,0,30,1,25,4,44,40,4,3,2,0,0,1
S01007416,Occupancy rating -1 or less,22,0,0,0,18,0,11,0,10,1,7,4,3,4,4,0,0,0
S01007417,All households,406,81,22,59,319,33,256,124,101,31,30,25,5,6,3,0,0,3
S01007417,Occupancy rating +2 or more,309,57,19,38,250,30,208,113,73,22,12,9,3,2,2,0,0,0
S01007417,Occupancy rating +1,73,22,2,20,49,3,34,9,18,7,12,10,2,2,0,0,0,2
S01007417,Occupancy rating 0,18,2,1,1,15,0,10,2,7,1,5,5,0,1,0,0,0,1
S01007417,Occupancy rating -1 or less,6,0,0,0,5,0,4,0,3,1,1,1,0,1,1,0,0,0
S01007418,All households,292,81,28,53,200,16,118,57,38,23,66,41,25,11,6,0,1,4
S01007418,Occupancy rating +2 or more,101,37,9,28,64,10,49,40,6,3,5,2,3,0,0,0,0,0
S01007418,Occupancy rating +1,103,32,16,16,67,5,36,16,9,11,26,14,12,4,1,0,0,3
S01007418,Occupancy rating 0,65,11,2,9,54,1,23,1,15,7,30,21,9,0,0,0,0,0
S01007418,Occupancy rating -1 or less,23,1,1,0,15,0,10,0,8,2,5,4,1,7,5,0,1,1
S01007419,All households,332,77,18,59,233,4,156,59,68,29,73,51,22,22,11,0,0,11
S01007419,Occupancy rating +2 or more,109,48,10,38,59,2,54,40,7,7,3,0,3,2,1,0,0,1
S01007419,Occupancy rating +1,100,16,4,12,78,2,44,15,21,8,32,22,10,6,2,0,0,4
S01007419,Occupancy rating 0,95,6,1,5,80,0,47,4,32,11,33,25,8,9,6,0,0,3
S01007419,Occupancy rating -1 or less,28,7,3,4,16,0,11,0,8,3,5,4,1,5,2,0,0,3
S01007420,All households,296,42,11,31,249,19,213,80,102,31,17,9,8,5,3,0,0,2
S01007420,Occupancy rating +2 or more,216,31,7,24,183,17,160,76,66,18,6,4,2,2,1,0,0,1
S01007420,Occupancy rating +1,51,7,3,4,43,0,34,4,22,8,9,4,5,1,1,0,0,0
S01007420,Occupancy rating 0,20,2,0,2,18,2,14,0,9,5,2,1,1,0,0,0,0,0
S01007420,Occupancy rating -1 or less,9,2,1,1,5,0,5,0,5,0,0,0,0,2,1,0,0,1
S01007421,All households,282,72,26,46,203,23,151,56,80,15,29,18,11,7,2,1,0,4
S01007421,Occupancy rating +2 or more,165,32,12,20,130,14,108,44,58,6,8,6,2,3,2,0,0,1
S01007421,Occupancy rating +1,59,23,5,18,35,4,26,11,10,5,5,2,3,1,0,1,0,0
S01007421,Occupancy rating 0,45,16,9,7,26,4,13,0,9,4,9,6,3,3,0,0,0,3
S01007421,Occupancy rating -1 or less,13,1,0,1,12,1,4,1,3,0,7,4,3,0,0,0,0,0
S01007422,All households,261,86,30,56,170,18,121,59,49,13,31,18,13,5,2,0,1,2
S01007422,Occupancy rating +2 or more,126,33,13,20,91,14,69,35,30,4,8,3,5,2,0,0,0,2
S01007422,Occupancy rating +1,64,22,7,15,42,3,30,18,6,6,9,5,4,0,0,0,0,0
S01007422,Occupancy rating 0,59,26,9,17,31,0,19,5,12,2,12,9,3,2,1,0,1,0
S01007422,Occupancy rating -1 or less,12,5,1,4,6,1,3,1,1,1,2,1,1,1,1,0,0,0
S01007423,All households,325,84,34,50,233,24,179,65,87,27,30,17,13,8,1,0,0,7
S01007423,Occupancy rating +2 or more,176,42,15,27,131,12,114,51,52,11,5,3,2,3,0,0,0,3
S01007423,Occupancy rating +1,80,16,7,9,62,9,42,11,23,8,11,5,6,2,0,0,0,2
S01007423,Occupancy rating 0,51,19,9,10,31,2,18,2,8,8,11,6,5,1,0,0,0,1
S01007423,Occupancy rating -1 or less,18,7,3,4,9,1,5,1,4,0,3,3,0,2,1,0,0,1
S01007424,All households,340,74,42,32,256,58,179,85,65,29,19,9,10,10,3,0,1,6
S01007424,Occupancy rating +2 or more,245,58,31,27,184,50,130,74,35,21,4,2,2,3,2,0,1,0
S01007424,Occupancy rating +1,62,11,9,2,49,6,36,11,21,4,7,3,4,2,0,0,0,2
S01007424,Occupancy rating 0,28,5,2,3,19,1,11,0,7,4,7,4,3,4,0,0,0,4
S01007424,Occupancy rating -1 or less,5,0,0,0,4,1,2,0,2,0,1,0,1,1,1,0,0,0
S01007425,All households,373,88,35,53,276,44,193,82,75,36,39,27,12,9,4,0,0,5
S01007425,Occupancy rating +2 or more,213,44,23,21,167,38,122,71,33,18,7,4,3,2,1,0,0,1
S01007425,Occupancy rating +1,91,29,11,18,59,5,39,10,15,14,15,10,5,3,1,0,0,2
S01007425,Occupancy rating 0,50,11,0,11,37,0,23,0,21,2,14,10,4,2,1,0,0,1
S01007425,Occupancy rating -1 or less,19,4,1,3,13,1,9,1,6,2,3,3,0,2,1,0,0,1
S01007426,All households,344,165,70,95,173,19,113,51,46,16,41,31,10,6,1,2,1,2
S01007426,Occupancy rating +2 or more,97,34,21,13,63,14,45,25,16,4,4,2,2,0,0,0,0,0
S01007426,Occupancy rating +1,106,69,28,41,36,5,25,16,9,0,6,4,2,1,0,1,0,0
S01007426,Occupancy rating 0,113,51,18,33,59,0,36,10,15,11,23,18,5,3,0,0,1,2
S01007426,Occupancy rating -1 or less,28,11,3,8,15,0,7,0,6,1,8,7,1,2,1,1,0,0
S01007427,All households,309,100,40,60,199,38,121,58,39,24,40,24,16,10,6,0,0,4
S01007427,Occupancy rating +2 or more,82,24,12,12,57,16,38,30,6,2,3,3,0,1,0,0,0,1
S01007427,Occupancy rating +1,123,53,23,30,69,17,46,22,10,14,6,4,2,1,0,0,0,1
S01007427,Occupancy rating 0,77,18,5,13,57,4,29,4,17,8,24,12,12,2,0,0,0,2
S01007427,Occupancy rating -1 or less,27,5,0,5,16,1,8,2,6,0,7,5,2,6,6,0,0,0
S01007428,All households,465,216,92,124,234,33,154,80,57,17,47,33,14,15,6,0,1,8
S01007428,Occupancy rating +2 or more,138,48,19,29,87,18,65,40,19,6,4,2,2,3,2,0,0,1
S01007428,Occupancy rating +1,137,71,22,49,62,7,43,29,10,4,12,6,6,4,0,0,0,4
S01007428,Occupancy rating 0,150,83,46,37,63,8,30,9,15,6,25,21,4,4,2,0,0,2
S01007428,Occupancy rating -1 or less,40,14,5,9,22,0,16,2,13,1,6,4,2,4,2,0,1,1
S01007429,All households,324,115,42,73,197,19,139,63,52,24,39,22,17,12,5,0,1,6
S01007429,Occupancy rating +2 or more,108,32,16,16,72,11,55,28,15,12,6,4,2,4,1,0,1,2
S01007429,Occupancy rating +1,95,29,8,21,63,8,48,28,16,4,7,4,3,3,1,0,0,2
S01007429,Occupancy rating 0,98,46,16,30,50,0,28,7,16,5,22,12,10,2,1,0,0,1
S01007429,Occupancy rating -1 or less,23,8,2,6,12,0,8,0,5,3,4,2,2,3,2,0,0,1
S01007430,All households,211,78,37,41,125,23,90,50,24,16,12,8,4,8,5,0,0,3
S01007430,Occupancy rating +2 or more,88,19,12,7,66,16,49,34,8,7,1,1,0,3,2,0,0,1
S01007430,Occupancy rating +1,38,12,5,7,26,4,20,10,4,6,2,0,2,0,0,0,0,0
S01007430,Occupancy rating 0,53,29,17,12,21,3,9,4,4,1,9,7,2,3,2,0,0,1
S01007430,Occupancy rating -1 or less,32,18,3,15,12,0,12,2,8,2,0,0,0,2,1,0,0,1
S01007431,All households,218,45,25,20,165,18,132,50,54,28,15,6,9,8,2,0,1,5
S01007431,Occupancy rating +2 or more,147,31,19,12,113,16,90,46,27,17,7,3,4,3,0,0,0,3
S01007431,Occupancy rating +1,41,10,3,7,30,2,25,2,15,8,3,1,2,1,1,0,0,0
S01007431,Occupancy rating 0,21,4,3,1,14,0,11,2,7,2,3,2,1,3,1,0,1,1
S01007431,Occupancy rating -1 or less,9,0,0,0,8,0,6,0,5,1,2,0,2,1,0,0,0,1
S01007432,All households,354,101,44,57,240,40,168,76,60,32,32,18,14,13,3,0,1,9
S01007432,Occupancy rating +2 or more,154,35,14,21,116,23,87,50,28,9,6,2,4,3,1,0,0,2
S01007432,Occupancy rating +1,124,55,25,30,64,13,44,25,13,6,7,5,2,5,1,0,1,3
S01007432,Occupancy rating 0,63,10,5,5,49,2,30,1,13,16,17,10,7,4,1,0,0,3
S01007432,Occupancy rating -1 or less,13,1,0,1,11,2,7,0,6,1,2,1,1,1,0,0,0,1
S01007433,All households,350,103,46,57,235,33,174,80,64,30,28,18,10,12,6,0,1,5
S01007433,Occupancy rating +2 or more,178,48,21,27,129,18,103,54,34,15,8,5,3,1,0,0,0,1
S01007433,Occupancy rating +1,94,33,15,18,56,8,43,20,11,12,5,3,2,5,2,0,1,2
S01007433,Occupancy rating 0,60,18,9,9,37,6,19,5,11,3,12,7,5,5,3,0,0,2
S01007433,Occupancy rating -1 or less,18,4,1,3,13,1,9,1,8,0,3,3,0,1,1,0,0,0
S01007434,All households,242,91,21,70,146,13,82,37,31,14,51,33,18,5,3,0,0,2
S01007434,Occupancy rating +2 or more,42,16,8,8,25,6,15,11,1,3,4,2,2,1,1,0,0,0
S01007434,Occupancy rating +1,91,42,6,36,48,5,35,22,10,3,8,5,3,1,0,0,0,1
S01007434,Occupancy rating 0,81,26,5,21,54,1,26,4,18,4,27,18,9,1,0,0,0,1
S01007434,Occupancy rating -1 or less,28,7,2,5,19,1,6,0,2,4,12,8,4,2,2,0,0,0
S01007435,All households,327,134,38,96,182,25,125,46,54,25,32,18,14,11,3,0,0,8
S01007435,Occupancy rating +2 or more,137,54,16,38,80,18,56,27,18,11,6,3,3,3,1,0,0,2
S01007435,Occupancy rating +1,102,41,7,34,59,3,42,13,22,7,14,6,8,2,1,0,0,1
S01007435,Occupancy rating 0,78,35,15,20,40,4,25,6,13,6,11,8,3,3,1,0,0,2
S01007435,Occupancy rating -1 or less,10,4,0,4,3,0,2,0,1,1,1,1,0,3,0,0,0,3
S01007436,All households,356,168,56,112,172,12,101,52,35,14,59,45,14,16,4,0,2,10
S01007436,Occupancy rating +2 or more,77,27,11,16,44,4,29,21,6,2,11,6,5,6,2,0,0,4
S01007436,Occupancy rating +1,116,66,16,50,47,3,36,24,8,4,8,5,3,3,0,0,1,2
S01007436,Occupancy rating 0,108,52,17,35,52,4,26,6,13,7,22,18,4,4,0,0,0,4
S01007436,Occupancy rating -1 or less,55,23,12,11,29,1,10,1,8,1,18,16,2,3,2,0,1,0
S01007437,All households,230,98,33,65,123,9,76,42,23,11,38,27,11,9,2,0,1,6
S01007437,Occupancy rating +2 or more,74,24,12,12,48,8,39,26,9,4,1,1,0,2,1,0,0,1
S01007437,Occupancy rating +1,57,28,9,19,27,1,17,9,4,4,9,6,3,2,0,0,0,2
S01007437,Occupancy rating 0,72,35,10,25,34,0,10,4,4,2,24,18,6,3,1,0,1,1
S01007437,Occupancy rating -1 or less,27,11,2,9,14,0,10,3,6,1,4,2,2,2,0,0,0,2
S01007438,All households,338,136,45,91,190,34,126,62,43,21,30,22,8,12,5,0,2,5
S01007438,Occupancy rating +2 or more,91,28,10,18,63,17,45,32,6,7,1,0,1,0,0,0,0,0
S01007438,Occupancy rating +1,112,50,20,30,60,11,41,24,10,7,8,3,5,2,0,0,0,2
S01007438,Occupancy rating 0,112,51,12,39,57,4,34,5,22,7,19,17,2,4,1,0,2,1
S01007438,Occupancy rating -1 or less,23,7,3,4,10,2,6,1,5,0,2,2,0,6,4,0,0,2
S01007439,All households,337,124,47,77,204,31,147,70,55,22,26,16,10,9,3,0,0,6
S01007439,Occupancy rating +2 or more,147,50,22,28,96,22,71,50,15,6,3,1,2,1,0,0,0,1
S01007439,Occupancy rating +1,106,52,17,35,51,5,35,16,15,4,11,7,4,3,0,0,0,3
S01007439,Occupancy rating 0,71,20,7,13,47,2,35,2,22,11,10,7,3,4,3,0,0,1
S01007439,Occupancy rating -1 or less,13,2,1,1,10,2,6,2,3,1,2,1,1,1,0,0,0,1
S01007440,All households,295,102,53,49,187,20,134,54,59,21,33,19,14,6,3,0,0,3
S01007440,Occupancy rating +2 or more,109,39,15,24,68,12,48,36,8,4,8,4,4,2,1,0,0,1
S01007440,Occupancy rating +1,81,23,12,11,57,8,41,15,16,10,8,4,4,1,1,0,0,0
S01007440,Occupancy rating 0,88,37,25,12,48,0,34,3,27,4,14,9,5,3,1,0,0,2
S01007440,Occupancy rating -1 or less,17,3,1,2,14,0,11,0,8,3,3,2,1,0,0,0,0,0
S01007441,All households,226,35,11,24,190,29,147,65,60,22,14,9,5,1,0,0,0,1
S01007441,Occupancy rating +2 or more,150,21,7,14,128,24,98,54,34,10,6,3,3,1,0,0,0,1
S01007441,Occupancy rating +1,55,11,3,8,44,5,33,9,15,9,6,5,1,0,0,0,0,0
S01007441,Occupancy rating 0,18,3,1,2,15,0,14,2,9,3,1,0,1,0,0,0,0,0
S01007441,Occupancy rating -1 or less,3,0,0,0,3,0,2,0,2,0,1,1,0,0,0,0,0,0
S01007442,All households,198,34,17,17,156,26,122,64,34,24,8,7,1,8,0,0,1,7
S01007442,Occupancy rating +2 or more,153,27,13,14,121,24,92,57,23,12,5,4,1,5,0,0,1,4
S01007442,Occupancy rating +1,28,5,3,2,21,2,18,6,6,6,1,1,0,2,0,0,0,2
S01007442,Occupancy rating 0,16,2,1,1,13,0,11,1,5,5,2,2,0,1,0,0,0,1
S01007442,Occupancy rating -1 or less,1,0,0,0,1,0,1,0,0,1,0,0,0,0,0,0,0,0
S01007443,All households,387,122,75,47,261,64,171,69,86,16,26,11,15,4,1,0,0,3
S01007443,Occupancy rating +2 or more,250,63,41,22,185,55,121,57,55,9,9,2,7,2,0,0,0,2
S01007443,Occupancy rating +1,59,25,10,15,33,5,25,9,13,3,3,3,0,1,0,0,0,1
S01007443,Occupancy rating 0,69,33,24,9,36,4,22,2,16,4,10,6,4,0,0,0,0,0
S01007443,Occupancy rating -1 or less,9,1,0,1,7,0,3,1,2,0,4,0,4,1,1,0,0,0
S01007444,All households,427,147,88,59,272,43,201,91,91,19,28,19,9,8,5,0,0,3
S01007444,Occupancy rating +2 or more,274,75,53,22,195,34,151,67,75,9,10,6,4,4,2,0,0,2
S01007444,Occupancy rating +1,102,50,22,28,50,9,33,17,9,7,8,6,2,2,1,0,0,1
S01007444,Occupancy rating 0,37,19,10,9,17,0,10,4,5,1,7,5,2,1,1,0,0,0
S01007444,Occupancy rating -1 or less,14,3,3,0,10,0,7,3,2,2,3,2,1,1,1,0,0,0
S01007445,All households,265,65,32,33,195,32,146,65,61,20,17,13,4,5,2,0,0,3
S01007445,Occupancy rating +2 or more,216,50,27,23,162,31,120,56,48,16,11,8,3,4,2,0,0,2
S01007445,Occupancy rating +1,31,9,1,8,21,1,18,5,12,1,2,2,0,1,0,0,0,1
S01007445,Occupancy rating 0,13,5,3,2,8,0,6,3,0,3,2,2,0,0,0,0,0,0
S01007445,Occupancy rating -1 or less,5,1,1,0,4,0,2,1,1,0,2,1,1,0,0,0,0,0
S01007446,All households,201,28,20,8,166,29,117,46,59,12,20,10,10,7,4,0,0,3
S01007446,Occupancy rating +2 or more,174,21,15,6,148,28,108,43,55,10,12,6,6,5,2,0,0,3
S01007446,Occupancy rating +1,20,5,4,1,15,1,7,3,3,1,7,3,4,0,0,0,0,0
S01007446,Occupancy rating 0,6,1,1,0,3,0,2,0,1,1,1,1,0,2,2,0,0,0
S01007446,Occupancy rating -1 or less,1,1,0,1,0,0,0,0,0,0,0,0,0,0,0,0,0,0
S01007447,All households,209,47,28,19,156,23,124,60,45,19,9,6,3,6,2,0,1,3
S01007447,Occupancy rating +2 or more,169,33,21,12,133,22,105,57,35,13,6,3,3,3,0,0,1,2
S01007447,Occupancy rating +1,20,7,3,4,13,1,11,1,6,4,1,1,0,0,0,0,0,0
S01007447,Occupancy rating 0,14,6,4,2,6,0,6,2,4,0,0,0,0,2,1,0,0,1
S01007447,Occupancy rating -1 or less,6,1,0,1,4,0,2,0,0,2,2,2,0,1,1,0,0,0
S01007448,All households,367,86,40,46,274,53,201,86,70,45,20,10,10,7,4,0,0,3
S01007448,Occupancy rating +2 or more,235,51,25,26,181,42,130,73,36,21,9,4,5,3,2,0,0,1
S01007448,Occupancy rating +1,80,22,7,15,54,8,42,12,15,15,4,2,2,4,2,0,0,2
S01007448,Occupancy rating 0,43,9,5,4,34,2,25,1,15,9,7,4,3,0,0,0,0,0
S01007448,Occupancy rating -1 or less,9,4,3,1,5,1,4,0,4,0,0,0,0,0,0,0,0,0
S01007449,All households,458,142,51,91,302,35,206,101,73,32,61,38,23,14,4,1,1,8
S01007449,Occupancy rating +2 or more,160,45,21,24,114,24,89,60,22,7,1,1,0,1,0,0,0,1
S01007449,Occupancy rating +1,126,49,19,30,73,7,51,27,15,9,15,4,11,4,1,1,1,1
S01007449,Occupancy rating 0,119,33,8,25,83,2,51,12,26,13,30,20,10,3,0,0,0,3
S01007449,Occupancy rating -1 or less,53,15,3,12,32,2,15,2,10,3,15,13,2,6,3,0,0,3
S01007450,All households,332,114,46,68,205,18,129,49,55,25,58,35,23,13,9,0,0,4
S01007450,Occupancy rating +2 or more,84,32,14,18,51,7,39,23,10,6,5,1,4,1,0,0,0,1
S01007450,Occupancy rating +1,93,32,13,19,59,5,44,18,13,13,10,3,7,2,0,0,0,2
S01007450,Occupancy rating 0,117,45,18,27,68,5,29,5,21,3,34,26,8,4,3,0,0,1
S01007450,Occupancy rating -1 or less,38,5,1,4,27,1,17,3,11,3,9,5,4,6,6,0,0,0
S01007451,All households,283,86,37,49,189,28,135,70,49,16,26,14,12,8,4,0,0,4
S01007451,Occupancy rating +2 or more,120,33,13,20,85,14,64,47,15,2,7,2,5,2,1,0,0,1
S01007451,Occupancy rating +1,89,29,9,20,58,7,44,16,20,8,7,4,3,2,0,0,0,2
S01007451,Occupancy rating 0,60,21,13,8,36,7,22,5,11,6,7,4,3,3,2,0,0,1
S01007451,Occupancy rating -1 or less,14,3,2,1,10,0,5,2,3,0,5,4,1,1,1,0,0,0
S01007452,All households,209,59,29,30,135,18,93,35,42,16,24,17,7,15,10,0,0,5
S01007452,Occupancy rating +2 or more,82,19,11,8,60,13,44,29,12,3,3,3,0,3,2,0,0,1
S01007452,Occupancy rating +1,56,13,5,8,41,4,27,5,13,9,10,5,5,2,1,0,0,1
S01007452,Occupancy rating 0,51,24,11,13,21,1,12,1,10,1,8,6,2,6,3,0,0,3
S01007452,Occupancy rating -1 or less,20,3,2,1,13,0,10,0,7,3,3,3,0,4,4,0,0,0
S01007453,All households,212,20,2,18,180,8,161,56,90,15,11,9,2,12,6,0,0,6
S01007453,Occupancy rating +2 or more,164,18,1,17,136,6,123,49,63,11,7,7,0,10,5,0,0,5
S01007453,Occupancy rating +1,31,0,0,0,30,2,26,6,19,1,2,1,1,1,0,0,0,1
S01007453,Occupancy rating 0,9,0,0,0,8,0,8,1,5,2,0,0,0,1,1,0,0,0
S01007453,Occupancy rating -1 or less,8,2,1,1,6,0,4,0,3,1,2,1,1,0,0,0,0,0
S01007454,All households,190,29,17,12,151,13,110,41,43,26,28,13,15,10,5,0,0,5
S01007454,Occupancy rating +2 or more,86,18,9,9,67,10,50,36,8,6,7,2,5,1,0,0,0,1
S01007454,Occupancy rating +1,49,7,4,3,40,1,28,3,13,12,11,7,4,2,1,0,0,1
S01007454,Occupancy rating 0,46,4,4,0,38,1,28,2,18,8,9,4,5,4,1,0,0,3
S01007454,Occupancy rating -1 or less,9,0,0,0,6,1,4,0,4,0,1,0,1,3,3,0,0,0
S01007455,All households,388,123,44,79,256,17,169,76,70,23,70,48,22,9,3,0,1,5
S01007455,Occupancy rating +2 or more,80,24,10,14,56,9,41,29,9,3,6,5,1,0,0,0,0,0
S01007455,Occupancy rating +1,133,50,18,32,81,3,65,42,10,13,13,9,4,2,1,0,0,1
S01007455,Occupancy rating 0,134,37,13,24,94,3,51,4,40,7,40,27,13,3,0,0,1,2
S01007455,Occupancy rating -1 or less,41,12,3,9,25,2,12,1,11,0,11,7,4,4,2,0,0,2
S01007456,All households,394,135,42,93,237,14,139,55,71,13,84,61,23,22,14,0,0,8
S01007456,Occupancy rating +2 or more,72,36,13,23,34,8,22,15,6,1,4,0,4,2,1,0,0,1
S01007456,Occupancy rating +1,158,76,23,53,78,5,54,35,14,5,19,12,7,4,1,0,0,3
S01007456,Occupancy rating 0,129,20,5,15,102,0,52,4,42,6,50,39,11,7,6,0,0,1
S01007456,Occupancy rating -1 or less,35,3,1,2,23,1,11,1,9,1,11,10,1,9,6,0,0,3
S01007457,All households,465,156,41,115,294,32,213,88,100,25,49,37,12,15,4,0,0,11
S01007457,Occupancy rating +2 or more,147,30,8,22,114,11,98,39,49,10,5,4,1,3,3,0,0,0
S01007457,Occupancy rating +1,157,68,18,50,89,20,59,39,15,5,10,5,5,0,0,0,0,0
S01007457,Occupancy rating 0,124,43,10,33,74,1,43,6,31,6,30,25,5,7,0,0,0,7
S01007457,Occupancy rating -1 or less,37,15,5,10,17,0,13,4,5,4,4,3,1,5,1,0,0,4
S01007458,All households,224,53,30,23,168,30,121,52,51,18,17,10,7,3,1,0,0,2
S01007458,Occupancy rating +2 or more,138,29,20,9,106,24,77,44,23,10,5,3,2,3,1,0,0,2
S01007458,Occupancy rating +1,55,21,10,11,34,5,24,7,12,5,5,2,3,0,0,0,0,0
S01007458,Occupancy rating 0,22,3,0,3,19,1,14,1,11,2,4,2,2,0,0,0,0,0
S01007458,Occupancy rating -1 or less,9,0,0,0,9,0,6,0,5,1,3,3,0,0,0,0,0,0
S01007459,All households,291,90,61,29,195,38,135,55,49,31,22,10,12,6,2,0,1,3
S01007459,Occupancy rating +2 or more,125,28,14,14,94,22,69,30,24,15,3,0,3,3,1,0,0,2
S01007459,Occupancy rating +1,71,17,10,7,52,7,38,20,9,9,7,3,4,2,0,0,1,1
S01007459,Occupancy rating 0,80,40,34,6,39,8,26,5,15,6,5,2,3,1,1,0,0,0
S01007459,Occupancy rating -1 or less,15,5,3,2,10,1,2,0,1,1,7,5,2,0,0,0,0,0
S01007460,All households,345,117,46,71,218,24,153,84,43,26,41,22,19,10,3,0,1,6
S01007460,Occupancy rating +2 or more,115,20,9,11,95,15,74,60,10,4,6,3,3,0,0,0,0,0
S01007460,Occupancy rating +1,101,44,17,27,53,3,43,18,12,13,7,1,6,4,2,0,0,2
S01007460,Occupancy rating 0,91,42,15,27,46,5,23,4,13,6,18,11,7,3,0,0,0,3
S01007460,Occupancy rating -1 or less,38,11,5,6,24,1,13,2,8,3,10,7,3,3,1,0,1,1
S01007461,All households,372,174,44,130,189,14,106,59,36,11,69,51,18,9,4,0,1,4
S01007461,Occupancy rating +2 or more,63,25,12,13,37,7,27,25,1,1,3,1,2,1,0,0,1,0
S01007461,Occupancy rating +1,95,44,8,36,48,1,40,22,11,7,7,4,3,3,2,0,0,1
S01007461,Occupancy rating 0,167,92,21,71,74,5,31,8,20,3,38,29,9,1,0,0,0,1
S01007461,Occupancy rating -1 or less,47,13,3,10,30,1,8,4,4,0,21,17,4,4,2,0,0,2
S01007462,All households,371,140,31,109,215,17,153,82,49,22,45,30,15,16,5,0,1,10
S01007462,Occupancy rating +2 or more,117,34,10,24,79,14,60,38,15,7,5,2,3,4,1,0,0,3
S01007462,Occupancy rating +1,144,67,16,51,74,3,62,41,13,8,9,6,3,3,1,0,0,2
S01007462,Occupancy rating 0,80,31,4,27,43,0,22,3,15,4,21,16,5,6,0,0,1,5
S01007462,Occupancy rating -1 or less,30,8,1,7,19,0,9,0,6,3,10,6,4,3,3,0,0,0
S01007463,All households,377,93,23,70,263,16,132,38,64,30,115,75,40,21,10,0,0,11
S01007463,Occupancy rating +2 or more,93,44,11,33,46,8,32,23,6,3,6,4,2,3,1,0,0,2
S01007463,Occupancy rating +1,116,22,8,14,89,6,39,11,11,17,44,21,23,5,1,0,0,4
S01007463,Occupancy rating 0,116,21,3,18,88,1,39,3,27,9,48,37,11,7,3,0,0,4
S01007463,Occupancy rating -1 or less,52,6,1,5,40,1,22,1,20,1,17,13,4,6,5,0,0,1
S01007464,All households,313,111,35,76,187,23,113,47,47,19,51,27,24,15,6,0,0,9
S01007464,Occupancy rating +2 or more,83,31,12,19,52,15,33,25,4,4,4,2,2,0,0,0,0,0
S01007464,Occupancy rating +1,82,27,9,18,51,5,30,12,9,9,16,6,10,4,0,0,0,4
S01007464,Occupancy rating 0,118,48,11,37,63,2,36,7,25,4,25,17,8,7,3,0,0,4
S01007464,Occupancy rating -1 or less,30,5,3,2,21,1,14,3,9,2,6,2,4,4,3,0,0,1
S01007465,All households,380,153,30,123,213,15,113,53,48,12,85,71,14,14,7,0,0,7
S01007465,Occupancy rating +2 or more,67,29,5,24,38,7,26,20,3,3,5,2,3,0,0,0,0,0
S01007465,Occupancy rating +1,96,44,9,35,48,6,30,21,6,3,12,10,2,4,0,0,0,4
S01007465,Occupancy rating 0,159,61,14,47,94,0,46,12,30,4,48,41,7,4,2,0,0,2
S01007465,Occupancy rating -1 or less,58,19,2,17,33,2,11,0,9,2,20,18,2,6,5,0,0,1
S01007466,All households,581,332,61,271,218,27,129,61,48,20,62,41,21,31,10,4,1,16
S01007466,Occupancy rating +2 or more,79,33,12,21,42,15,24,15,7,2,3,1,2,4,1,0,0,3
S01007466,Occupancy rating +1,158,94,12,82,57,4,45,26,8,11,8,3,5,7,2,1,0,4
S01007466,Occupancy rating 0,243,142,29,113,89,5,45,17,23,5,39,30,9,12,4,2,1,5
S01007466,Occupancy rating -1 or less,101,63,8,55,30,3,15,3,10,2,12,7,5,8,3,1,0,4
S01007467,All households,523,244,105,139,268,32,171,82,69,20,65,45,20,11,1,0,1,9
S01007467,Occupancy rating +2 or more,134,41,16,25,89,14,67,33,25,9,8,7,1,4,1,0,0,3
S01007467,Occupancy rating +1,169,91,30,61,76,10,56,36,14,6,10,8,2,2,0,0,1,1
S01007467,Occupancy rating 0,192,104,55,49,87,6,43,13,26,4,38,28,10,1,0,0,0,1
S01007467,Occupancy rating -1 or less,28,8,4,4,16,2,5,0,4,1,9,2,7,4,0,0,0,4
S01007468,All households,333,100,24,76,225,29,173,88,67,18,23,16,7,8,2,0,1,5
S01007468,Occupancy rating +2 or more,128,20,5,15,106,15,87,59,21,7,4,2,2,2,0,0,1,1
S01007468,Occupancy rating +1,116,41,14,27,72,11,56,26,23,7,5,3,2,3,1,0,0,2
S01007468,Occupancy rating 0,72,32,5,27,39,2,25,2,19,4,12,9,3,1,0,0,0,1
S01007468,Occupancy rating -1 or less,17,7,0,7,8,1,5,1,4,0,2,2,0,2,1,0,0,1
S01007469,All households,250,59,24,35,180,17,119,52,48,19,44,35,9,11,8,0,0,3
S01007469,Occupancy rating +2 or more,97,28,13,15,69,14,47,35,10,2,8,6,2,0,0,0,0,0
S01007469,Occupancy rating +1,79,20,4,16,56,3,41,16,15,10,12,10,2,3,1,0,0,2
S01007469,Occupancy rating 0,61,10,7,3,48,0,27,1,20,6,21,16,5,3,2,0,0,1
S01007469,Occupancy rating -1 or less,13,1,0,1,7,0,4,0,3,1,3,3,0,5,5,0,0,0
S01007470,All households,335,142,69,73,177,21,109,47,45,17,47,27,20,16,5,0,0,11
S01007470,Occupancy rating +2 or more,80,24,9,15,54,10,41,24,12,5,3,1,2,2,0,0,0,2
S01007470,Occupancy rating +1,95,42,13,29,48,8,30,15,10,5,10,3,7,5,0,0,0,5
S01007470,Occupancy rating 0,114,46,23,23,65,3,32,8,18,6,30,20,10,3,1,0,0,2
S01007470,Occupancy rating -1 or less,46,30,24,6,10,0,6,0,5,1,4,3,1,6,4,0,0,2
S01007471,All households,203,56,29,27,144,10,108,40,54,14,26,17,9,3,0,0,0,3
S01007471,Occupancy rating +2 or more,74,13,6,7,58,3,50,19,25,6,5,2,3,3,0,0,0,3
S01007471,Occupancy rating +1,68,25,14,11,43,5,35,20,10,5,3,2,1,0,0,0,0,0
S01007471,Occupancy rating 0,45,15,7,8,30,1,16,1,13,2,13,10,3,0,0,0,0,0
S01007471,Occupancy rating -1 or less,16,3,2,1,13,1,7,0,6,1,5,3,2,0,0,0,0,0
S01007472,All households,273,105,51,54,162,16,104,42,48,14,42,25,17,6,3,0,1,2
S01007472,Occupancy rating +2 or more,70,37,22,15,32,7,24,20,3,1,1,0,1,1,1,0,0,0
S01007472,Occupancy rating +1,102,41,17,24,60,7,43,20,13,10,10,6,4,1,0,0,0,1
S01007472,Occupancy rating 0,85,25,11,14,58,1,29,2,25,2,28,18,10,2,0,0,1,1
S01007472,Occupancy rating -1 or less,16,2,1,1,12,1,8,0,7,1,3,1,2,2,2,0,0,0
S01007473,All households,227,99,33,66,124,14,78,33,31,14,32,22,10,4,1,0,0,3
S01007473,Occupancy rating +2 or more,43,19,8,11,23,5,17,12,3,2,1,0,1,1,0,0,0,1
S01007473,Occupancy rating +1,74,32,9,23,42,8,30,13,9,8,4,2,2,0,0,0,0,0
S01007473,Occupancy rating 0,89,41,11,30,48,1,25,8,13,4,22,15,7,0,0,0,0,0
S01007473,Occupancy rating -1 or less,21,7,5,2,11,0,6,0,6,0,5,5,0,3,1,0,0,2
S01007474,All households,213,43,22,21,160,19,131,53,54,24,10,6,4,10,7,0,0,3
S01007474,Occupancy rating +2 or more,138,25,14,11,108,15,90,47,33,10,3,2,1,5,3,0,0,2
S01007474,Occupancy rating +1,49,10,6,4,37,2,32,5,15,12,3,2,1,2,2,0,0,0
S01007474,Occupancy rating 0,21,8,2,6,11,1,6,0,4,2,4,2,2,2,1,0,0,1
S01007474,Occupancy rating -1 or less,5,0,0,0,4,1,3,1,2,0,0,0,0,1,1,0,0,0
S01007475,All households,257,65,19,46,184,21,137,67,47,23,26,18,8,8,4,0,1,3
S01007475,Occupancy rating +2 or more,140,25,13,12,111,18,86,45,26,15,7,5,2,4,2,0,0,2
S01007475,Occupancy rating +1,53,11,3,8,40,1,33,15,14,4,6,3,3,2,0,0,1,1
S01007475,Occupancy rating 0,48,21,3,18,27,2,15,7,4,4,10,7,3,0,0,0,0,0
S01007475,Occupancy rating -1 or less,16,8,0,8,6,0,3,0,3,0,3,3,0,2,2,0,0,0
S01007476,All households,317,107,62,45,206,54,135,71,44,20,17,12,5,4,3,0,0,1
S01007476,Occupancy rating +2 or more,159,41,23,18,118,41,73,44,21,8,4,2,2,0,0,0,0,0
S01007476,Occupancy rating +1,101,49,28,21,50,12,37,23,9,5,1,0,1,2,2,0,0,0
S01007476,Occupancy rating 0,38,14,9,5,23,1,16,2,9,5,6,4,2,1,0,0,0,1
S01007476,Occupancy rating -1 or less,19,3,2,1,15,0,9,2,5,2,6,6,0,1,1,0,0,0
S01007477,All households,247,84,33,51,158,21,117,54,48,15,20,12,8,5,4,0,1,0
S01007477,Occupancy rating +2 or more,144,39,20,19,102,15,79,36,31,12,8,6,2,3,3,0,0,0
S01007477,Occupancy rating +1,51,17,3,14,33,3,23,10,11,2,7,4,3,1,1,0,0,0
S01007477,Occupancy rating 0,43,26,8,18,17,2,13,8,4,1,2,1,1,0,0,0,0,0
S01007477,Occupancy rating -1 or less,9,2,2,0,6,1,2,0,2,0,3,1,2,1,0,0,1,0
S01007478,All households,433,168,82,86,246,40,176,89,74,13,30,21,9,19,9,0,0,10
S01007478,Occupancy rating +2 or more,187,38,14,24,141,16,108,48,51,9,17,11,6,8,4,0,0,4
S01007478,Occupancy rating +1,137,74,38,36,59,15,40,32,6,2,4,1,3,4,3,0,0,1
S01007478,Occupancy rating 0,84,47,26,21,33,6,23,7,14,2,4,4,0,4,0,0,0,4
S01007478,Occupancy rating -1 or less,25,9,4,5,13,3,5,2,3,0,5,5,0,3,2,0,0,1
S01007479,All households,275,101,32,69,172,11,129,55,62,12,32,25,7,2,1,0,0,1
S01007479,Occupancy rating +2 or more,60,20,7,13,40,5,33,20,10,3,2,2,0,0,0,0,0,0
S01007479,Occupancy rating +1,112,44,18,26,68,6,57,24,26,7,5,3,2,0,0,0,0,0
S01007479,Occupancy rating 0,76,23,4,19,51,0,31,7,23,1,20,16,4,2,1,0,0,1
S01007479,Occupancy rating -1 or less,27,14,3,11,13,0,8,4,3,1,5,4,1,0,0,0,0,0
S01007480,All households,327,95,18,77,228,17,186,72,90,24,25,17,8,4,2,0,0,2
S01007480,Occupancy rating +2 or more,121,27,7,20,92,10,77,45,28,4,5,3,2,2,1,0,0,1
S01007480,Occupancy rating +1,128,53,11,42,74,7,61,25,27,9,6,4,2,1,1,0,0,0
S01007480,Occupancy rating 0,66,11,0,11,54,0,42,1,32,9,12,8,4,1,0,0,0,1
S01007480,Occupancy rating -1 or less,12,4,0,4,8,0,6,1,3,2,2,2,0,0,0,0,0,0
S01007481,All households,394,116,87,29,267,81,167,83,57,27,19,8,11,11,1,0,3,7
S01007481,Occupancy rating +2 or more,311,90,73,17,214,77,124,70,37,17,13,5,8,7,0,0,0,7
S01007481,Occupancy rating +1,59,20,13,7,36,4,29,11,11,7,3,0,3,3,1,0,2,0
S01007481,Occupancy rating 0,23,5,0,5,17,0,14,2,9,3,3,3,0,1,0,0,1,0
S01007481,Occupancy rating -1 or less,1,1,1,0,0,0,0,0,0,0,0,0,0,0,0,0,0,0
S01007482,All households,253,117,75,42,125,29,75,38,25,12,21,11,10,11,6,0,2,3
S01007482,Occupancy rating +2 or more,98,38,20,18,58,17,36,21,9,6,5,1,4,2,1,0,0,1
S01007482,Occupancy rating +1,81,40,23,17,37,9,24,14,7,3,4,3,1,4,1,0,2,1
S01007482,Occupancy rating 0,51,30,27,3,20,3,9,2,5,2,8,4,4,1,0,0,0,1
S01007482,Occupancy rating -1 or less,23,9,5,4,10,0,6,1,4,1,4,3,1,4,4,0,0,0
S01007483,All households,340,109,54,55,212,20,150,62,72,16,42,25,17,19,11,0,2,6
S01007483,Occupancy rating +2 or more,164,65,34,31,93,17,71,46,20,5,5,3,2,6,5,0,0,1
S01007483,Occupancy rating +1,101,29,14,15,67,3,48,14,28,6,16,11,5,5,1,0,1,3
S01007483,Occupancy rating 0,64,14,5,9,44,0,25,2,19,4,19,11,8,6,3,0,1,2
S01007483,Occupancy rating -1 or less,11,1,1,0,8,0,6,0,5,1,2,0,2,2,2,0,0,0
S01007484,All households,285,135,60,75,132,21,81,30,39,12,30,23,7,18,8,1,0,9
S01007484,Occupancy rating +2 or more,108,43,25,18,62,14,43,18,15,10,5,4,1,3,1,0,0,2
S01007484,Occupancy rating +1,68,37,11,26,23,3,14,4,8,2,6,3,3,8,3,1,0,4
S01007484,Occupancy rating 0,81,45,18,27,34,2,17,7,10,0,15,12,3,2,1,0,0,1
S01007484,Occupancy rating -1 or less,28,10,6,4,13,2,7,1,6,0,4,4,0,5,3,0,0,2
S01007485,All households,219,74,19,55,135,14,78,23,43,12,43,33,10,10,4,0,1,5
S01007485,Occupancy rating +2 or more,40,13,6,7,25,7,12,8,3,1,6,2,4,2,1,0,0,1
S01007485,Occupancy rating +1,68,42,9,33,23,4,17,11,2,4,2,2,0,3,1,0,0,2
S01007485,Occupancy rating 0,80,11,2,9,67,2,41,3,32,6,24,18,6,2,0,0,0,2
S01007485,Occupancy rating -1 or less,31,8,2,6,20,1,8,1,6,1,11,11,0,3,2,0,1,0
S01007486,All households,255,104,37,67,145,8,67,16,44,7,70,59,11,6,4,0,1,1
S01007486,Occupancy rating +2 or more,33,15,7,8,16,3,8,6,2,0,5,5,0,2,1,0,0,1
S01007486,Occupancy rating +1,114,79,27,52,35,5,17,10,5,2,13,6,7,0,0,0,0,0
S01007486,Occupancy rating 0,86,7,2,5,78,0,34,0,30,4,44,40,4,1,0,0,1,0
S01007486,Occupancy rating -1 or less,22,3,1,2,16,0,8,0,7,1,8,8,0,3,3,0,0,0
S01007487,All households,498,270,103,167,206,19,139,71,51,17,48,37,11,22,3,1,2,16
S01007487,Occupancy rating +2 or more,148,46,17,29,94,15,71,46,17,8,8,4,4,8,0,1,0,7
S01007487,Occupancy rating +1,108,54,12,42,48,2,34,15,14,5,12,10,2,6,1,0,0,5
S01007487,Occupancy rating 0,165,113,48,65,47,2,26,9,15,2,19,16,3,5,2,0,1,2
S01007487,Occupancy rating -1 or less,77,57,26,31,17,0,8,1,5,2,9,7,2,3,0,0,1,2
S01007488,All households,483,179,75,104,284,42,177,73,86,18,65,42,23,20,9,0,1,10
S01007488,Occupancy rating +2 or more,225,74,33,41,145,32,94,51,32,11,19,14,5,6,3,0,1,2
S01007488,Occupancy rating +1,118,48,23,25,65,6,46,17,26,3,13,3,10,5,1,0,0,4
S01007488,Occupancy rating 0,111,43,16,27,61,3,29,5,20,4,29,21,8,7,5,0,0,2
S01007488,Occupancy rating -1 or less,29,14,3,11,13,1,8,0,8,0,4,4,0,2,0,0,0,2
S01007489,All households,406,139,78,61,254,41,165,75,71,19,48,31,17,13,4,0,3,6
S01007489,Occupancy rating +2 or more,216,77,48,29,134,30,93,50,33,10,11,5,6,5,1,0,2,2
S01007489,Occupancy rating +1,114,46,21,25,65,10,42,21,16,5,13,7,6,3,0,0,1,2
S01007489,Occupancy rating 0,64,15,8,7,45,1,23,4,15,4,21,16,5,4,2,0,0,2
S01007489,Occupancy rating -1 or less,12,1,1,0,10,0,7,0,7,0,3,3,0,1,1,0,0,0
S01007490,All households,378,113,62,51,253,43,169,61,76,32,41,21,20,12,7,0,0,5
S01007490,Occupancy rating +2 or more,174,68,37,31,103,25,71,42,16,13,7,2,5,3,1,0,0,2
S01007490,Occupancy rating +1,115,34,18,16,77,14,51,16,26,9,12,6,6,4,1,0,0,3
S01007490,Occupancy rating 0,66,9,6,3,53,1,36,2,26,8,16,10,6,4,4,0,0,0
S01007490,Occupancy rating -1 or less,23,2,1,1,20,3,11,1,8,2,6,3,3,1,1,0,0,0
S01007491,All households,460,112,36,76,325,27,220,89,108,23,78,67,11,23,10,0,0,13
S01007491,Occupancy rating +2 or more,154,41,19,22,109,18,86,58,25,3,5,5,0,4,1,0,0,3
S01007491,Occupancy rating +1,171,58,16,42,111,9,80,29,42,9,22,18,4,2,0,0,0,2
S01007491,Occupancy rating 0,101,9,1,8,80,0,38,2,28,8,42,35,7,12,6,0,0,6
S01007491,Occupancy rating -1 or less,34,4,0,4,25,0,16,0,13,3,9,9,0,5,3,0,0,2
S01007492,All households,332,125,63,62,198,29,141,72,47,22,28,15,13,9,2,0,1,6
S01007492,Occupancy rating +2 or more,145,40,24,16,102,24,71,51,13,7,7,3,4,3,1,0,0,2
S01007492,Occupancy rating +1,80,33,17,16,45,5,35,14,14,7,5,2,3,2,0,0,1,1
S01007492,Occupancy rating 0,85,42,18,24,39,0,28,7,14,7,11,6,5,4,1,0,0,3
S01007492,Occupancy rating -1 or less,22,10,4,6,12,0,7,0,6,1,5,4,1,0,0,0,0,0
S01007493,All households,368,105,43,62,255,38,172,67,75,30,45,30,15,8,2,0,2,4
S01007493,Occupancy rating +2 or more,122,38,15,23,84,25,55,40,12,3,4,2,2,0,0,0,0,0
S01007493,Occupancy rating +1,132,52,20,32,78,11,54,24,19,11,13,8,5,2,1,0,0,1
S01007493,Occupancy rating 0,88,14,7,7,69,0,48,3,33,12,21,14,7,5,0,0,2,3
S01007493,Occupancy rating -1 or less,26,1,1,0,24,2,15,0,11,4,7,6,1,1,1,0,0,0
S01007494,All households,239,69,34,35,161,29,117,63,40,14,15,10,5,9,5,0,1,3
S01007494,Occupancy rating +2 or more,158,45,23,22,107,25,76,47,18,11,6,2,4,6,3,0,0,3
S01007494,Occupancy rating +1,45,18,9,9,26,4,21,13,6,2,1,1,0,1,1,0,0,0
S01007494,Occupancy rating 0,32,6,2,4,24,0,18,2,15,1,6,5,1,2,1,0,1,0
S01007494,Occupancy rating -1 or less,4,0,0,0,4,0,2,1,1,0,2,2,0,0,0,0,0,0
S01007495,All households,345,72,33,39,255,37,192,86,82,24,26,15,11,18,8,0,1,9
S01007495,Occupancy rating +2 or more,240,45,22,23,186,29,146,73,59,14,11,5,6,9,3,0,1,5
S01007495,Occupancy rating +1,57,16,4,12,39,6,29,10,14,5,4,3,1,2,1,0,0,1
S01007495,Occupancy rating 0,40,8,5,3,27,2,14,3,6,5,11,7,4,5,2,0,0,3
S01007495,Occupancy rating -1 or less,8,3,2,1,3,0,3,0,3,0,0,0,0,2,2,0,0,0
S01007496,All households,470,142,73,69,309,70,209,110,65,34,30,18,12,19,6,0,3,10
S01007496,Occupancy rating +2 or more,283,69,42,27,202,57,136,75,39,22,9,5,4,12,4,0,1,7
S01007496,Occupancy rating +1,97,28,9,19,67,10,52,25,18,9,5,3,2,2,0,0,1,1
S01007496,Occupancy rating 0,76,40,19,21,33,2,17,8,6,3,14,8,6,3,1,0,1,1
S01007496,Occupancy rating -1 or less,14,5,3,2,7,1,4,2,2,0,2,2,0,2,1,0,0,1
S01007497,All households,264,81,42,39,175,28,123,55,49,19,24,21,3,8,1,0,1,6
S01007497,Occupancy rating +2 or more,144,40,22,18,100,23,68,44,18,6,9,8,1,4,0,0,1,3
S01007497,Occupancy rating +1,53,20,8,12,31,3,26,8,11,7,2,1,1,2,0,0,0,2
S01007497,Occupancy rating 0,57,19,12,7,37,2,25,3,17,5,10,9,1,1,1,0,0,0
S01007497,Occupancy rating -1 or less,10,2,0,2,7,0,4,0,3,1,3,3,0,1,0,0,0,1
S01007498,All households,416,159,93,66,244,42,179,102,56,21,23,15,8,13,6,0,2,5
S01007498,Occupancy rating +2 or more,194,67,40,27,126,29,91,67,18,6,6,5,1,1,1,0,0,0
S01007498,Occupancy rating +1,109,40,24,16,64,9,47,24,14,9,8,4,4,5,2,0,1,2
S01007498,Occupancy rating 0,92,47,27,20,40,4,29,8,17,4,7,5,2,5,2,0,1,2
S01007498,Occupancy rating -1 or less,21,5,2,3,14,0,12,3,7,2,2,1,1,2,1,0,0,1
S01007499,All households,358,92,38,54,253,27,196,80,79,37,30,19,11,13,2,0,0,11
S01007499,Occupancy rating +2 or more,188,61,25,36,124,16,101,57,28,16,7,4,3,3,1,0,0,2
S01007499,Occupancy rating +1,93,21,11,10,68,9,49,16,17,16,10,6,4,4,0,0,0,4
S01007499,Occupancy rating 0,66,10,2,8,52,1,40,7,28,5,11,7,4,4,0,0,0,4
S01007499,Occupancy rating -1 or less,11,0,0,0,9,1,6,0,6,0,2,2,0,2,1,0,0,1
S01007500,All households,288,100,45,55,179,37,126,65,39,22,16,9,7,9,5,0,0,4
S01007500,Occupancy rating +2 or more,141,39,21,18,99,22,72,48,13,11,5,4,1,3,0,0,0,3
S01007500,Occupancy rating +1,77,25,8,17,50,12,34,15,13,6,4,0,4,2,1,0,0,1
S01007500,Occupancy rating 0,55,32,14,18,21,2,16,2,9,5,3,2,1,2,2,0,0,0
S01007500,Occupancy rating -1 or less,15,4,2,2,9,1,4,0,4,0,4,3,1,2,2,0,0,0
S01007501,All households,325,100,52,48,210,48,146,89,39,18,16,11,5,15,3,0,0,12
S01007501,Occupancy rating +2 or more,234,68,36,32,157,40,114,70,31,13,3,2,1,9,3,0,0,6
S01007501,Occupancy rating +1,57,23,10,13,31,2,25,16,5,4,4,3,1,3,0,0,0,3
S01007501,Occupancy rating 0,26,9,6,3,14,4,5,3,1,1,5,3,2,3,0,0,0,3
S01007501,Occupancy rating -1 or less,8,0,0,0,8,2,2,0,2,0,4,3,1,0,0,0,0,0
S01007502,All households,248,88,34,54,155,24,120,66,41,13,11,6,5,5,1,0,0,4
S01007502,Occupancy rating +2 or more,140,42,16,26,96,16,78,50,19,9,2,1,1,2,1,0,0,1
S01007502,Occupancy rating +1,58,30,13,17,26,5,17,10,5,2,4,0,4,2,0,0,0,2
S01007502,Occupancy rating 0,39,14,5,9,25,3,18,5,12,1,4,4,0,0,0,0,0,0
S01007502,Occupancy rating -1 or less,11,2,0,2,8,0,7,1,5,1,1,1,0,1,0,0,0,1
S01007503,All households,482,154,82,72,309,63,208,107,77,24,38,26,12,19,6,0,2,11
S01007503,Occupancy rating +2 or more,276,74,39,35,196,49,140,88,40,12,7,4,3,6,2,0,1,3
S01007503,Occupancy rating +1,99,41,19,22,54,10,38,13,20,5,6,3,3,4,0,0,0,4
S01007503,Occupancy rating 0,85,35,21,14,43,3,22,5,14,3,18,14,4,7,2,0,1,4
S01007503,Occupancy rating -1 or less,22,4,3,1,16,1,8,1,3,4,7,5,2,2,2,0,0,0
S01007504,All households,321,109,45,64,202,47,135,68,43,24,20,10,10,10,2,0,1,7
S01007504,Occupancy rating +2 or more,192,58,24,34,130,33,85,49,24,12,12,6,6,4,0,0,1,3
S01007504,Occupancy rating +1,74,32,15,17,40,10,25,13,7,5,5,3,2,2,1,0,0,1
S01007504,Occupancy rating 0,44,17,5,12,25,4,19,5,9,5,2,0,2,2,0,0,0,2
S01007504,Occupancy rating -1 or less,11,2,1,1,7,0,6,1,3,2,1,1,0,2,1,0,0,1
S01007505,All households,179,41,14,27,126,15,95,45,39,11,16,12,4,12,2,0,1,9
S01007505,Occupancy rating +2 or more,104,23,10,13,76,14,59,39,14,6,3,2,1,5,1,0,1,3
S01007505,Occupancy rating +1,41,13,2,11,24,1,20,4,12,4,3,3,0,4,0,0,0,4
S01007505,Occupancy rating 0,27,4,2,2,22,0,13,2,10,1,9,6,3,1,0,0,0,1
S01007505,Occupancy rating -1 or less,7,1,0,1,4,0,3,0,3,0,1,1,0,2,1,0,0,1
S01007506,All households,237,69,37,32,164,47,104,52,41,11,13,7,6,4,1,0,2,1
S01007506,Occupancy rating +2 or more,173,41,22,19,129,42,78,42,29,7,9,4,5,3,1,0,1,1
S01007506,Occupancy rating +1,37,17,11,6,19,4,13,7,4,2,2,1,1,1,0,0,1,0
S01007506,Occupancy rating 0,21,8,3,5,13,0,11,3,7,1,2,2,0,0,0,0,0,0
S01007506,Occupancy rating -1 or less,6,3,1,2,3,1,2,0,1,1,0,0,0,0,0,0,0,0
S01007507,All households,455,170,90,80,263,51,181,93,68,20,31,22,9,22,6,0,6,10
S01007507,Occupancy rating +2 or more,227,72,43,29,146,40,101,73,22,6,5,2,3,9,3,0,2,4
S01007507,Occupancy rating +1,119,54,31,23,59,10,39,12,20,7,10,7,3,6,0,0,2,4
S01007507,Occupancy rating 0,91,41,16,25,47,1,32,7,20,5,14,11,3,3,1,0,1,1
S01007507,Occupancy rating -1 or less,18,3,0,3,11,0,9,1,6,2,2,2,0,4,2,0,1,1
S01007508,All households,329,109,56,53,210,37,158,88,43,27,15,7,8,10,4,0,2,4
S01007508,Occupancy rating +2 or more,204,64,36,28,139,34,102,73,16,13,3,2,1,1,1,0,0,0
S01007508,Occupancy rating +1,65,25,11,14,36,2,30,12,12,6,4,1,3,4,1,0,1,2
S01007508,Occupancy rating 0,53,18,9,9,30,1,24,3,13,8,5,2,3,5,2,0,1,2
S01007508,Occupancy rating -1 or less,7,2,0,2,5,0,2,0,2,0,3,2,1,0,0,0,0,0
S01007509,All households,274,76,39,37,185,31,139,67,48,24,15,8,7,13,2,0,4,7
S01007509,Occupancy rating +2 or more,178,48,25,23,124,27,93,55,29,9,4,2,2,6,0,0,2,4
S01007509,Occupancy rating +1,49,14,7,7,31,3,25,10,9,6,3,3,0,4,0,0,2,2
S01007509,Occupancy rating 0,39,13,7,6,25,1,17,2,9,6,7,3,4,1,1,0,0,0
S01007509,Occupancy rating -1 or less,8,1,0,1,5,0,4,0,1,3,1,0,1,2,1,0,0,1
S01007510,All households,459,152,109,43,294,57,205,104,70,31,32,15,17,13,4,0,2,7
S01007510,Occupancy rating +2 or more,288,90,69,21,192,48,133,86,30,17,11,3,8,6,2,0,1,3
S01007510,Occupancy rating +1,88,36,25,11,50,8,34,13,13,8,8,4,4,2,0,0,0,2
S01007510,Occupancy rating 0,60,21,14,7,36,1,27,4,18,5,8,4,4,3,0,0,1,2
S01007510,Occupancy rating -1 or less,23,5,1,4,16,0,11,1,9,1,5,4,1,2,2,0,0,0
S01007511,All households,370,122,63,59,234,35,146,58,56,32,53,25,28,14,3,0,3,8
S01007511,Occupancy rating +2 or more,167,59,31,28,103,26,66,36,15,15,11,5,6,5,1,0,1,3
S01007511,Occupancy rating +1,94,30,15,15,61,5,40,18,12,10,16,3,13,3,0,0,2,1
S01007511,Occupancy rating 0,79,31,17,14,45,2,27,4,17,6,16,9,7,3,0,0,0,3
S01007511,Occupancy rating -1 or less,30,2,0,2,25,2,13,0,12,1,10,8,2,3,2,0,0,1
S01007512,All households,247,85,48,37,157,27,110,55,32,23,20,13,7,5,2,0,1,2
S01007512,Occupancy rating +2 or more,152,39,24,15,110,25,78,43,24,11,7,3,4,3,1,0,1,1
S01007512,Occupancy rating +1,57,31,17,14,24,2,18,8,3,7,4,2,2,2,1,0,0,1
S01007512,Occupancy rating 0,31,14,6,8,17,0,10,3,3,4,7,6,1,0,0,0,0,0
S01007512,Occupancy rating -1 or less,7,1,1,0,6,0,4,1,2,1,2,2,0,0,0,0,0,0
S01007513,All households,468,170,69,101,282,37,196,71,102,23,49,38,11,16,12,0,1,3
S01007513,Occupancy rating +2 or more,163,57,28,29,104,23,73,42,22,9,8,4,4,2,1,0,1,0
S01007513,Occupancy rating +1,148,67,26,41,78,13,58,24,26,8,7,7,0,3,2,0,0,1
S01007513,Occupancy rating 0,115,40,15,25,70,1,48,5,39,4,21,16,5,5,4,0,0,1
S01007513,Occupancy rating -1 or less,42,6,0,6,30,0,17,0,15,2,13,11,2,6,5,0,0,1
S01007514,All households,247,89,31,58,135,21,83,40,32,11,31,18,13,23,3,1,3,16
S01007514,Occupancy rating +2 or more,93,25,10,15,59,10,42,23,12,7,7,3,4,9,0,0,2,7
S01007514,Occupancy rating +1,59,25,10,15,32,8,20,12,5,3,4,4,0,2,0,0,0,2
S01007514,Occupancy rating 0,76,36,10,26,32,2,16,4,11,1,14,7,7,8,2,1,1,4
S01007514,Occupancy rating -1 or less,19,3,1,2,12,1,5,1,4,0,6,4,2,4,1,0,0,3
S01007515,All households,254,72,39,33,178,43,125,56,50,19,10,7,3,4,1,0,1,2
S01007515,Occupancy rating +2 or more,185,47,29,18,135,41,92,46,32,14,2,0,2,3,1,0,1,1
S01007515,Occupancy rating +1,42,15,7,8,26,1,22,9,9,4,3,3,0,1,0,0,0,1
S01007515,Occupancy rating 0,21,7,2,5,14,0,9,0,8,1,5,4,1,0,0,0,0,0
S01007515,Occupancy rating -1 or less,6,3,1,2,3,1,2,1,1,0,0,0,0,0,0,0,0,0
S01007516,All households,257,75,52,23,166,18,117,50,57,10,31,23,8,16,7,0,2,7
S01007516,Occupancy rating +2 or more,86,24,13,11,61,13,45,31,12,2,3,3,0,1,0,0,0,1
S01007516,Occupancy rating +1,76,26,17,9,47,2,36,13,20,3,9,5,4,3,0,0,0,3
S01007516,Occupancy rating 0,74,23,22,1,44,1,29,5,19,5,14,11,3,7,3,0,2,2
S01007516,Occupancy rating -1 or less,21,2,0,2,14,2,7,1,6,0,5,4,1,5,4,0,0,1
S01007517,All households,224,91,54,37,129,31,88,48,21,19,10,5,5,4,0,0,0,4
S01007517,Occupancy rating +2 or more,114,31,21,10,81,26,51,36,8,7,4,1,3,2,0,0,0,2
S01007517,Occupancy rating +1,50,24,16,8,25,3,22,9,6,7,0,0,0,1,0,0,0,1
S01007517,Occupancy rating 0,51,31,15,16,19,2,12,2,6,4,5,3,2,1,0,0,0,1
S01007517,Occupancy rating -1 or less,9,5,2,3,4,0,3,1,1,1,1,1,0,0,0,0,0,0
S01007518,All households,381,139,69,70,226,38,150,61,64,25,38,19,19,16,5,0,2,9
S01007518,Occupancy rating +2 or more,132,49,28,21,80,19,58,40,11,7,3,1,2,3,0,0,0,3
S01007518,Occupancy rating +1,129,52,23,29,74,16,46,16,17,13,12,6,6,3,0,0,1,2
S01007518,Occupancy rating 0,94,31,13,18,59,2,37,4,28,5,20,10,10,4,3,0,1,0
S01007518,Occupancy rating -1 or less,26,7,5,2,13,1,9,1,8,0,3,2,1,6,2,0,0,4
S01007519,All households,215,62,32,30,145,35,100,61,22,17,10,4,6,8,1,0,1,6
S01007519,Occupancy rating +2 or more,157,45,24,21,109,34,69,47,11,11,6,2,4,3,0,0,0,3
S01007519,Occupancy rating +1,47,14,8,6,29,0,26,13,8,5,3,1,2,4,1,0,1,2
S01007519,Occupancy rating 0,11,3,0,3,7,1,5,1,3,1,1,1,0,1,0,0,0,1
S01007519,Occupancy rating -1 or less,0,0,0,0,0,0,0,0,0,0,0,0,0,0,0,0,0,0
S01007520,All households,446,156,87,69,276,59,191,83,81,27,26,18,8,14,1,1,1,11
S01007520,Occupancy rating +2 or more,237,84,43,41,146,42,97,59,28,10,7,5,2,7,0,0,1,6
S01007520,Occupancy rating +1,118,49,28,21,66,14,48,19,18,11,4,1,3,3,0,0,0,3
S01007520,Occupancy rating 0,79,20,14,6,56,3,40,4,31,5,13,10,3,3,1,0,0,2
S01007520,Occupancy rating -1 or less,12,3,2,1,8,0,6,1,4,1,2,2,0,1,0,1,0,0
S01007521,All households,202,68,26,42,126,26,91,49,33,9,9,7,2,8,2,0,1,5
S01007521,Occupancy rating +2 or more,149,45,16,29,100,25,71,43,20,8,4,2,2,4,2,0,0,2
S01007521,Occupancy rating +1,35,15,8,7,17,1,14,5,8,1,2,2,0,3,0,0,1,2
S01007521,Occupancy rating 0,15,7,1,6,8,0,6,1,5,0,2,2,0,0,0,0,0,0
S01007521,Occupancy rating -1 or less,3,1,1,0,1,0,0,0,0,0,1,1,0,1,0,0,0,1
S01007522,All households,476,198,127,71,263,62,165,83,57,25,36,19,17,15,2,0,0,13
S01007522,Occupancy rating +2 or more,291,112,75,37,174,56,110,72,26,12,8,2,6,5,0,0,0,5
S01007522,Occupancy rating +1,88,47,26,21,38,3,26,8,12,6,9,5,4,3,0,0,0,3
S01007522,Occupancy rating 0,74,32,24,8,39,2,19,1,15,3,18,12,6,3,0,0,0,3
S01007522,Occupancy rating -1 or less,23,7,2,5,12,1,10,2,4,4,1,0,1,4,2,0,0,2
S01007523,All households,229,58,34,24,153,29,106,53,39,14,18,4,14,18,7,0,1,10
S01007523,Occupancy rating +2 or more,148,44,28,16,96,26,62,37,15,10,8,2,6,8,4,0,1,3
S01007523,Occupancy rating +1,45,11,6,5,33,2,27,14,13,0,4,0,4,1,1,0,0,0
S01007523,Occupancy rating 0,31,3,0,3,19,1,14,2,9,3,4,2,2,9,2,0,0,7
S01007523,Occupancy rating -1 or less,5,0,0,0,5,0,3,0,2,1,2,0,2,0,0,0,0,0
S01007524,All households,385,87,49,38,280,46,210,109,67,34,24,12,12,18,9,0,1,8
S01007524,Occupancy rating +2 or more,263,68,41,27,189,37,146,96,29,21,6,2,4,6,4,0,0,2
S01007524,Occupancy rating +1,74,12,6,6,57,7,38,11,19,8,12,7,5,5,1,0,0,4
S01007524,Occupancy rating 0,38,5,0,5,27,1,20,2,14,4,6,3,3,6,3,0,1,2
S01007524,Occupancy rating -1 or less,10,2,2,0,7,1,6,0,5,1,0,0,0,1,1,0,0,0
S01007525,All households,237,73,34,39,159,32,109,55,37,17,18,7,11,5,0,0,1,4
S01007525,Occupancy rating +2 or more,115,32,15,17,80,21,51,34,12,5,8,3,5,3,0,0,1,2
S01007525,Occupancy rating +1,60,19,8,11,40,10,26,15,6,5,4,1,3,1,0,0,0,1
S01007525,Occupancy rating 0,50,20,10,10,30,0,25,4,15,6,5,2,3,0,0,0,0,0
S01007525,Occupancy rating -1 or less,12,2,1,1,9,1,7,2,4,1,1,1,0,1,0,0,0,1
S01007526,All households,385,181,88,93,194,38,116,52,43,21,40,23,17,10,3,0,3,4
S01007526,Occupancy rating +2 or more,161,57,33,24,100,27,64,39,14,11,9,3,6,4,2,0,2,0
S01007526,Occupancy rating +1,80,37,18,19,42,7,25,6,13,6,10,6,4,1,0,0,0,1
S01007526,Occupancy rating 0,119,76,30,46,40,3,22,7,11,4,15,9,6,3,0,0,1,2
S01007526,Occupancy rating -1 or less,25,11,7,4,12,1,5,0,5,0,6,5,1,2,1,0,0,1
S01007527,All households,374,118,72,46,246,53,166,93,56,17,27,11,16,10,6,0,0,4
S01007527,Occupancy rating +2 or more,193,51,38,13,139,43,91,68,15,8,5,1,4,3,3,0,0,0
S01007527,Occupancy rating +1,94,35,21,14,56,9,39,18,17,4,8,1,7,3,0,0,0,3
S01007527,Occupancy rating 0,77,31,12,19,43,1,29,7,18,4,13,9,4,3,2,0,0,1
S01007527,Occupancy rating -1 or less,10,1,1,0,8,0,7,0,6,1,1,0,1,1,1,0,0,0
S01007528,All households,363,153,76,77,198,31,122,56,46,20,45,32,13,12,3,0,0,9
S01007528,Occupancy rating +2 or more,138,48,24,24,86,17,64,38,21,5,5,2,3,4,1,0,0,3
S01007528,Occupancy rating +1,85,39,25,14,45,11,21,11,5,5,13,9,4,1,0,0,0,1
S01007528,Occupancy rating 0,108,61,25,36,45,3,26,5,13,8,16,13,3,2,1,0,0,1
S01007528,Occupancy rating -1 or less,32,5,2,3,22,0,11,2,7,2,11,8,3,5,1,0,0,4
S01007529,All households,308,83,44,39,214,63,138,74,54,10,13,7,6,11,3,0,3,5
S01007529,Occupancy rating +2 or more,203,42,26,16,156,55,97,62,30,5,4,2,2,5,1,0,3,1
S01007529,Occupancy rating +1,50,16,7,9,32,7,20,8,10,2,5,2,3,2,0,0,0,2
S01007529,Occupancy rating 0,43,22,9,13,20,1,16,4,10,2,3,2,1,1,1,0,0,0
S01007529,Occupancy rating -1 or less,12,3,2,1,6,0,5,0,4,1,1,1,0,3,1,0,0,2
S01007530,All households,223,59,32,27,155,30,114,47,45,22,11,6,5,9,5,0,0,4
S01007530,Occupancy rating +2 or more,160,44,27,17,113,27,81,38,27,16,5,2,3,3,2,0,0,1
S01007530,Occupancy rating +1,36,11,4,7,24,3,19,9,6,4,2,2,0,1,1,0,0,0
S01007530,Occupancy rating 0,20,3,1,2,15,0,12,0,10,2,3,1,2,2,2,0,0,0
S01007530,Occupancy rating -1 or less,7,1,0,1,3,0,2,0,2,0,1,1,0,3,0,0,0,3
S01007531,All households,313,92,49,43,210,37,150,78,57,15,23,14,9,11,4,0,0,7
S01007531,Occupancy rating +2 or more,197,56,40,16,135,30,99,60,29,10,6,3,3,6,1,0,0,5
S01007531,Occupancy rating +1,66,18,5,13,47,7,34,17,15,2,6,2,4,1,1,0,0,0
S01007531,Occupancy rating 0,39,14,3,11,23,0,14,1,10,3,9,8,1,2,0,0,0,2
S01007531,Occupancy rating -1 or less,11,4,1,3,5,0,3,0,3,0,2,1,1,2,2,0,0,0
S01007532,All households,248,65,26,39,171,29,123,59,52,12,19,12,7,12,4,0,0,8
S01007532,Occupancy rating +2 or more,154,39,19,20,111,26,82,52,23,7,3,2,1,4,0,0,0,4
S01007532,Occupancy rating +1,54,20,6,14,33,3,24,7,14,3,6,3,3,1,1,0,0,0
S01007532,Occupancy rating 0,28,5,1,4,20,0,13,0,11,2,7,5,2,3,2,0,0,1
S01007532,Occupancy rating -1 or less,12,1,0,1,7,0,4,0,4,0,3,2,1,4,1,0,0,3
S01007533,All households,222,58,33,25,151,23,119,54,42,23,9,1,8,13,7,0,1,5
S01007533,Occupancy rating +2 or more,156,38,21,17,109,21,85,43,25,17,3,1,2,9,4,0,1,4
S01007533,Occupancy rating +1,29,7,6,1,20,2,15,4,7,4,3,0,3,2,2,0,0,0
S01007533,Occupancy rating 0,33,12,5,7,19,0,17,7,8,2,2,0,2,2,1,0,0,1
S01007533,Occupancy rating -1 or less,4,1,1,0,3,0,2,0,2,0,1,0,1,0,0,0,0,0
S01007534,All households,428,130,82,48,286,50,176,74,74,28,60,31,29,12,5,0,1,6
S01007534,Occupancy rating +2 or more,199,56,35,21,138,37,92,57,24,11,9,0,9,5,2,0,1,2
S01007534,Occupancy rating +1,109,34,17,17,74,6,50,11,28,11,18,9,9,1,0,0,0,1
S01007534,Occupancy rating 0,97,34,26,8,59,6,29,6,18,5,24,16,8,4,1,0,0,3
S01007534,Occupancy rating -1 or less,23,6,4,2,15,1,5,0,4,1,9,6,3,2,2,0,0,0
S01007535,All households,492,178,92,86,295,61,171,60,75,36,63,48,15,19,8,0,1,10
S01007535,Occupancy rating +2 or more,227,62,39,23,160,52,99,47,34,18,9,7,2,5,4,0,0,1
S01007535,Occupancy rating +1,106,49,20,29,52,7,32,9,10,13,13,7,6,5,2,0,1,2
S01007535,Occupancy rating 0,143,64,32,32,74,2,38,4,29,5,34,28,6,5,0,0,0,5
S01007535,Occupancy rating -1 or less,16,3,1,2,9,0,2,0,2,0,7,6,1,4,2,0,0,2
S01007536,All households,443,168,84,84,249,42,175,87,68,20,32,18,14,26,8,0,2,16
S01007536,Occupancy rating +2 or more,203,64,38,26,130,26,97,64,24,9,7,2,5,9,2,0,1,6
S01007536,Occupancy rating +1,135,66,29,37,66,10,44,18,20,6,12,8,4,3,1,0,0,2
S01007536,Occupancy rating 0,90,35,16,19,45,4,32,5,22,5,9,7,2,10,2,0,1,7
S01007536,Occupancy rating -1 or less,15,3,1,2,8,2,2,0,2,0,4,1,3,4,3,0,0,1
S01007537,All households,518,200,100,100,290,68,176,96,62,18,46,32,14,28,4,2,8,14
S01007537,Occupancy rating +2 or more,217,63,42,21,147,49,90,58,23,9,8,2,6,7,2,0,2,3
S01007537,Occupancy rating +1,156,79,37,42,72,14,52,34,11,7,6,5,1,5,1,0,1,3
S01007537,Occupancy rating 0,119,52,20,32,55,3,26,4,21,1,26,20,6,12,1,1,3,7
S01007537,Occupancy rating -1 or less,26,6,1,5,16,2,8,0,7,1,6,5,1,4,0,1,2,1
S01007538,All households,366,85,39,46,265,40,205,90,88,27,20,14,6,16,9,0,1,6
S01007538,Occupancy rating +2 or more,284,68,33,35,206,34,165,80,62,23,7,5,2,10,4,0,1,5
S01007538,Occupancy rating +1,53,10,4,6,41,5,27,8,17,2,9,6,3,2,1,0,0,1
S01007538,Occupancy rating 0,23,6,1,5,13,1,8,1,5,2,4,3,1,4,4,0,0,0
S01007538,Occupancy rating -1 or less,6,1,1,0,5,0,5,1,4,0,0,0,0,0,0,0,0,0
S01007539,All households,331,113,80,33,207,57,137,76,44,17,13,8,5,11,4,0,4,3
S01007539,Occupancy rating +2 or more,235,80,63,17,147,47,94,59,23,12,6,4,2,8,3,0,4,1
S01007539,Occupancy rating +1,62,22,15,7,37,7,27,14,9,4,3,2,1,3,1,0,0,2
S01007539,Occupancy rating 0,31,11,2,9,20,2,14,3,11,0,4,2,2,0,0,0,0,0
S01007539,Occupancy rating -1 or less,3,0,0,0,3,1,2,0,1,1,0,0,0,0,0,0,0,0
S01007540,All households,450,211,111,100,226,40,156,90,51,15,30,21,9,13,4,0,1,8
S01007540,Occupancy rating +2 or more,179,55,34,21,117,22,89,60,21,8,6,3,3,7,3,0,0,4
S01007540,Occupancy rating +1,112,57,33,24,52,13,31,22,7,2,8,4,4,3,0,0,0,3
S01007540,Occupancy rating 0,140,92,41,51,47,5,31,8,18,5,11,10,1,1,0,0,0,1
S01007540,Occupancy rating -1 or less,19,7,3,4,10,0,5,0,5,0,5,4,1,2,1,0,1,0
S01007541,All households,337,103,56,47,221,49,150,70,59,21,22,13,9,13,3,0,0,10
S01007541,Occupancy rating +2 or more,206,65,41,24,136,37,93,51,30,12,6,2,4,5,1,0,0,4
S01007541,Occupancy rating +1,86,28,11,17,56,9,42,18,18,6,5,3,2,2,1,0,0,1
S01007541,Occupancy rating 0,38,8,3,5,25,2,13,1,9,3,10,7,3,5,0,0,0,5
S01007541,Occupancy rating -1 or less,7,2,1,1,4,1,2,0,2,0,1,1,0,1,1,0,0,0
S01007542,All households,416,163,68,95,236,22,148,62,63,23,66,49,17,17,5,0,4,8
S01007542,Occupancy rating +2 or more,163,66,36,30,90,15,65,34,20,11,10,5,5,7,4,0,1,2
S01007542,Occupancy rating +1,122,53,17,36,66,6,42,19,19,4,18,15,3,3,0,0,2,1
S01007542,Occupancy rating 0,94,34,14,20,55,1,27,7,15,5,27,22,5,5,0,0,0,5
S01007542,Occupancy rating -1 or less,37,10,1,9,25,0,14,2,9,3,11,7,4,2,1,0,1,0
S01007543,All households,481,143,64,79,317,30,228,108,86,34,59,41,18,21,8,0,2,11
S01007543,Occupancy rating +2 or more,160,56,23,33,100,18,77,55,15,7,5,2,3,4,0,0,0,4
S01007543,Occupancy rating +1,157,44,17,27,109,8,90,46,28,16,11,7,4,4,1,0,2,1
S01007543,Occupancy rating 0,128,39,22,17,82,2,50,7,35,8,30,21,9,7,3,0,0,4
S01007543,Occupancy rating -1 or less,36,4,2,2,26,2,11,0,8,3,13,11,2,6,4,0,0,2
S01007544,All households,496,145,93,52,324,112,190,98,65,27,22,12,10,27,3,0,8,16
S01007544,Occupancy rating +2 or more,389,105,71,34,263,99,154,89,43,22,10,6,4,21,1,0,7,13
S01007544,Occupancy rating +1,57,24,15,9,30,7,20,7,10,3,3,2,1,3,1,0,1,1
S01007544,Occupancy rating 0,37,11,7,4,26,5,13,2,9,2,8,4,4,0,0,0,0,0
S01007544,Occupancy rating -1 or less,13,5,0,5,5,1,3,0,3,0,1,0,1,3,1,0,0,2
S01007545,All households,359,101,59,42,248,36,192,90,79,23,20,9,11,10,2,0,1,7
S01007545,Occupancy rating +2 or more,257,76,49,27,175,32,132,82,39,11,11,1,10,6,1,0,1,4
S01007545,Occupancy rating +1,70,14,4,10,53,4,42,5,27,10,7,7,0,3,1,0,0,2
S01007545,Occupancy rating 0,27,10,6,4,17,0,15,2,11,2,2,1,1,0,0,0,0,0
S01007545,Occupancy rating -1 or less,5,1,0,1,3,0,3,1,2,0,0,0,0,1,0,0,0,1
S01007546,All households,223,42,22,20,175,31,135,53,60,22,9,5,4,6,0,0,1,5
S01007546,Occupancy rating +2 or more,172,26,17,9,141,28,109,49,44,16,4,1,3,5,0,0,1,4
S01007546,Occupancy rating +1,25,5,0,5,20,2,16,3,9,4,2,1,1,0,0,0,0,0
S01007546,Occupancy rating 0,23,10,5,5,12,1,8,1,5,2,3,3,0,1,0,0,0,1
S01007546,Occupancy rating -1 or less,3,1,0,1,2,0,2,0,2,0,0,0,0,0,0,0,0,0
S01007547,All households,239,70,20,50,162,29,123,51,49,23,10,7,3,7,2,0,2,3
S01007547,Occupancy rating +2 or more,155,34,13,21,117,25,89,43,31,15,3,2,1,4,1,0,1,2
S01007547,Occupancy rating +1,48,22,4,18,24,2,21,6,10,5,1,0,1,2,0,0,1,1
S01007547,Occupancy rating 0,30,13,2,11,16,2,9,1,6,2,5,4,1,1,1,0,0,0
S01007547,Occupancy rating -1 or less,6,1,1,0,5,0,4,1,2,1,1,1,0,0,0,0,0,0
S01007548,All households,304,86,40,46,212,32,151,65,58,28,29,17,12,6,2,0,0,4
S01007548,Occupancy rating +2 or more,172,44,23,21,125,27,90,49,27,14,8,3,5,3,1,0,0,2
S01007548,Occupancy rating +1,72,29,12,17,42,4,33,12,12,9,5,2,3,1,0,0,0,1
S01007548,Occupancy rating 0,48,12,5,7,35,1,21,2,16,3,13,10,3,1,0,0,0,1
S01007548,Occupancy rating -1 or less,12,1,0,1,10,0,7,2,3,2,3,2,1,1,1,0,0,0
S01007549,All households,298,100,56,44,187,39,119,72,36,11,29,18,11,11,4,0,0,7
S01007549,Occupancy rating +2 or more,182,60,34,26,117,27,80,58,16,6,10,4,6,5,2,0,0,3
S01007549,Occupancy rating +1,62,25,15,10,34,10,15,8,6,1,9,6,3,3,1,0,0,2
S01007549,Occupancy rating 0,48,14,6,8,31,2,22,6,12,4,7,5,2,3,1,0,0,2
S01007549,Occupancy rating -1 or less,6,1,1,0,5,0,2,0,2,0,3,3,0,0,0,0,0,0
S01007550,All households,449,160,90,70,278,72,171,94,53,24,35,24,11,11,5,0,1,5
S01007550,Occupancy rating +2 or more,271,87,52,35,178,53,116,73,28,15,9,3,6,6,2,0,1,3
S01007550,Occupancy rating +1,97,37,22,15,59,14,38,17,14,7,7,5,2,1,1,0,0,0
S01007550,Occupancy rating 0,66,33,15,18,31,4,11,4,6,1,16,14,2,2,1,0,0,1
S01007550,Occupancy rating -1 or less,15,3,1,2,10,1,6,0,5,1,3,2,1,2,1,0,0,1
S01007551,All households,395,119,52,67,259,44,200,108,56,36,15,6,9,17,2,0,2,13
S01007551,Occupancy rating +2 or more,299,81,35,46,208,41,158,97,36,25,9,3,6,10,1,0,0,9
S01007551,Occupancy rating +1,64,23,11,12,35,2,29,11,12,6,4,3,1,6,1,0,2,3
S01007551,Occupancy rating 0,25,13,6,7,11,0,10,0,5,5,1,0,1,1,0,0,0,1
S01007551,Occupancy rating -1 or less,7,2,0,2,5,1,3,0,3,0,1,0,1,0,0,0,0,0
S01007552,All households,401,134,49,85,256,29,186,76,84,26,41,25,16,11,6,0,0,5
S01007552,Occupancy rating +2 or more,125,43,17,26,81,18,60,43,12,5,3,1,2,1,1,0,0,0
S01007552,Occupancy rating +1,128,44,12,32,80,7,61,25,24,12,12,7,5,4,0,0,0,4
S01007552,Occupancy rating 0,120,40,17,23,75,3,49,6,36,7,23,16,7,5,4,0,0,1
S01007552,Occupancy rating -1 or less,28,7,3,4,20,1,16,2,12,2,3,1,2,1,1,0,0,0
S01007553,All households,376,113,60,53,252,37,171,63,74,34,44,28,16,11,2,0,0,9
S01007553,Occupancy rating +2 or more,116,39,24,15,76,20,52,35,11,6,4,0,4,1,0,0,0,1
S01007553,Occupancy rating +1,137,45,19,26,88,14,59,23,18,18,15,10,5,4,0,0,0,4
S01007553,Occupancy rating 0,91,22,12,10,64,1,41,2,31,8,22,15,7,5,1,0,0,4
S01007553,Occupancy rating -1 or less,32,7,5,2,24,2,19,3,14,2,3,3,0,1,1,0,0,0
S01007554,All households,221,85,38,47,129,24,67,31,24,12,38,26,12,7,1,0,1,5
S01007554,Occupancy rating +2 or more,40,13,8,5,27,11,14,9,2,3,2,2,0,0,0,0,0,0
S01007554,Occupancy rating +1,106,61,23,38,43,10,26,19,4,3,7,5,2,2,0,0,0,2
S01007554,Occupancy rating 0,50,7,5,2,40,0,14,1,11,2,26,17,9,3,1,0,1,1
S01007554,Occupancy rating -1 or less,25,4,2,2,19,3,13,2,7,4,3,2,1,2,0,0,0,2
S01007555,All households,238,77,44,33,158,30,112,47,40,25,16,8,8,3,0,0,1,2
S01007555,Occupancy rating +2 or more,137,44,25,19,91,19,70,38,24,8,2,2,0,2,0,0,1,1
S01007555,Occupancy rating +1,61,22,11,11,39,8,24,5,7,12,7,5,2,0,0,0,0,0
S01007555,Occupancy rating 0,30,9,7,2,20,0,15,3,8,4,5,1,4,1,0,0,0,1
S01007555,Occupancy rating -1 or less,10,2,1,1,8,3,3,1,1,1,2,0,2,0,0,0,0,0
S01007556,All households,227,109,55,54,109,20,75,32,28,15,14,11,3,9,4,0,0,5
S01007556,Occupancy rating +2 or more,73,19,11,8,48,10,37,23,11,3,1,1,0,6,3,0,0,3
S01007556,Occupancy rating +1,52,24,7,17,27,4,18,6,6,6,5,3,2,1,0,0,0,1
S01007556,Occupancy rating 0,77,48,25,23,29,6,17,3,9,5,6,5,1,0,0,0,0,0
S01007556,Occupancy rating -1 or less,25,18,12,6,5,0,3,0,2,1,2,2,0,2,1,0,0,1
S01007557,All households,478,139,85,54,317,47,206,66,98,42,64,46,18,22,10,0,1,11
S01007557,Occupancy rating +2 or more,196,82,52,30,108,29,72,50,11,11,7,4,3,6,0,0,0,6
S01007557,Occupancy rating +1,153,41,25,16,105,15,67,14,34,19,23,17,6,7,4,0,0,3
S01007557,Occupancy rating 0,99,15,8,7,82,3,51,2,39,10,28,21,7,2,1,0,1,0
S01007557,Occupancy rating -1 or less,30,1,0,1,22,0,16,0,14,2,6,4,2,7,5,0,0,2
S01007558,All households,189,52,20,32,132,27,101,54,33,14,4,3,1,5,3,0,0,2
S01007558,Occupancy rating +2 or more,122,33,15,18,86,20,65,39,15,11,1,0,1,3,2,0,0,1
S01007558,Occupancy rating +1,33,11,2,9,22,4,18,9,8,1,0,0,0,0,0,0,0,0
S01007558,Occupancy rating 0,29,8,3,5,21,3,15,6,7,2,3,3,0,0,0,0,0,0
S01007558,Occupancy rating -1 or less,5,0,0,0,3,0,3,0,3,0,0,0,0,2,1,0,0,1
S01007559,All households,308,79,34,45,219,24,172,82,70,20,23,14,9,10,4,0,2,4
S01007559,Occupancy rating +2 or more,191,48,25,23,139,18,114,63,42,9,7,4,3,4,2,0,0,2
S01007559,Occupancy rating +1,55,22,8,14,32,4,26,15,5,6,2,1,1,1,1,0,0,0
S01007559,Occupancy rating 0,45,8,1,7,33,2,20,2,14,4,11,8,3,4,0,0,2,2
S01007559,Occupancy rating -1 or less,17,1,0,1,15,0,12,2,9,1,3,1,2,1,1,0,0,0
S01007560,All households,440,151,93,58,272,59,171,77,66,28,42,23,19,17,7,0,3,7
S01007560,Occupancy rating +2 or more,200,48,35,13,147,38,91,48,29,14,18,8,10,5,3,0,0,2
S01007560,Occupancy rating +1,134,60,29,31,69,16,44,23,13,8,9,7,2,5,3,0,1,1
S01007560,Occupancy rating 0,91,38,26,12,47,5,28,6,17,5,14,7,7,6,0,0,2,4
S01007560,Occupancy rating -1 or less,15,5,3,2,9,0,8,0,7,1,1,1,0,1,1,0,0,0
S01007561,All households,357,143,89,54,203,54,118,59,41,18,31,13,18,11,4,0,1,6
S01007561,Occupancy rating +2 or more,184,75,45,30,105,36,63,43,15,5,6,2,4,4,2,0,0,2
S01007561,Occupancy rating +1,115,46,33,13,66,17,35,15,11,9,14,6,8,3,1,0,0,2
S01007561,Occupancy rating 0,47,16,7,9,29,1,19,1,14,4,9,3,6,2,0,0,1,1
S01007561,Occupancy rating -1 or less,11,6,4,2,3,0,1,0,1,0,2,2,0,2,1,0,0,1
S01007562,All households,365,97,48,49,256,39,182,71,82,29,35,27,8,12,2,0,0,10
S01007562,Occupancy rating +2 or more,193,49,28,21,136,33,99,50,37,12,4,4,0,8,1,0,0,7
S01007562,Occupancy rating +1,84,24,9,15,58,5,43,15,18,10,10,5,5,2,0,0,0,2
S01007562,Occupancy rating 0,79,23,11,12,56,1,36,5,24,7,19,16,3,0,0,0,0,0
S01007562,Occupancy rating -1 or less,9,1,0,1,6,0,4,1,3,0,2,2,0,2,1,0,0,1
S01007563,All households,396,117,61,56,268,49,179,88,69,22,40,29,11,11,4,0,1,6
S01007563,Occupancy rating +2 or more,228,55,31,24,166,39,119,70,31,18,8,8,0,7,2,0,0,5
S01007563,Occupancy rating +1,115,49,26,23,63,9,39,15,21,3,15,11,4,3,1,0,1,1
S01007563,Occupancy rating 0,40,12,4,8,28,1,13,2,11,0,14,9,5,0,0,0,0,0
S01007563,Occupancy rating -1 or less,13,1,0,1,11,0,8,1,6,1,3,1,2,1,1,0,0,0
S01007564,All households,323,82,44,38,225,38,165,71,66,28,22,8,14,16,5,0,2,9
S01007564,Occupancy rating +2 or more,207,43,22,21,154,34,111,59,36,16,9,1,8,10,5,0,0,5
S01007564,Occupancy rating +1,64,22,13,9,41,3,32,11,13,8,6,3,3,1,0,0,1,0
S01007564,Occupancy rating 0,38,14,7,7,21,0,15,1,12,2,6,4,2,3,0,0,1,2
S01007564,Occupancy rating -1 or less,14,3,2,1,9,1,7,0,5,2,1,0,1,2,0,0,0,2
S01007565,All households,396,98,51,47,277,39,213,105,78,30,25,10,15,21,9,0,2,10
S01007565,Occupancy rating +2 or more,242,52,26,26,184,33,140,90,38,12,11,2,9,6,5,0,0,1
S01007565,Occupancy rating +1,92,30,15,15,55,4,43,12,17,14,8,4,4,7,1,0,1,5
S01007565,Occupancy rating 0,44,13,8,5,29,2,22,2,17,3,5,3,2,2,0,0,0,2
S01007565,Occupancy rating -1 or less,18,3,2,1,9,0,8,1,6,1,1,1,0,6,3,0,1,2
S01007566,All households,275,43,26,17,222,31,174,78,71,25,17,11,6,10,5,0,0,5
S01007566,Occupancy rating +2 or more,167,32,22,10,132,25,105,62,36,7,2,1,1,3,1,0,0,2
S01007566,Occupancy rating +1,58,7,2,5,50,5,40,10,18,12,5,4,1,1,0,0,0,1
S01007566,Occupancy rating 0,36,3,1,2,31,1,22,6,12,4,8,5,3,2,1,0,0,1
S01007566,Occupancy rating -1 or less,14,1,1,0,9,0,7,0,5,2,2,1,1,4,3,0,0,1
S01007567,All households,233,43,15,28,182,23,151,61,67,23,8,6,2,8,1,0,1,6
S01007567,Occupancy rating +2 or more,177,36,14,22,136,21,111,52,43,16,4,3,1,5,0,0,1,4
S01007567,Occupancy rating +1,40,7,1,6,32,1,27,9,14,4,4,3,1,1,0,0,0,1
S01007567,Occupancy rating 0,15,0,0,0,13,1,12,0,9,3,0,0,0,2,1,0,0,1
S01007567,Occupancy rating -1 or less,1,0,0,0,1,0,1,0,1,0,0,0,0,0,0,0,0,0
S01007568,All households,295,83,35,48,203,27,150,75,54,21,26,14,12,9,6,0,2,1
S01007568,Occupancy rating +2 or more,191,53,24,29,136,22,106,63,31,12,8,4,4,2,1,0,0,1
S01007568,Occupancy rating +1,63,15,8,7,44,5,31,8,14,9,8,5,3,4,2,0,2,0
S01007568,Occupancy rating 0,34,13,2,11,19,0,11,4,7,0,8,5,3,2,2,0,0,0
S01007568,Occupancy rating -1 or less,7,2,1,1,4,0,2,0,2,0,2,0,2,1,1,0,0,0
S01007569,All households,342,95,54,41,231,39,180,97,68,15,12,8,4,16,4,0,2,10
S01007569,Occupancy rating +2 or more,198,54,33,21,139,28,110,75,27,8,1,1,0,5,2,0,2,1
S01007569,Occupancy rating +1,78,25,14,11,48,7,40,15,20,5,1,0,1,5,1,0,0,4
S01007569,Occupancy rating 0,47,14,7,7,31,4,20,6,13,1,7,5,2,2,0,0,0,2
S01007569,Occupancy rating -1 or less,19,2,0,2,13,0,10,1,8,1,3,2,1,4,1,0,0,3
S01007570,All households,295,72,31,41,212,31,152,75,49,28,29,18,11,11,3,0,0,8
S01007570,Occupancy rating +2 or more,181,36,18,18,139,28,102,60,24,18,9,2,7,6,1,0,0,5
S01007570,Occupancy rating +1,67,34,12,22,31,2,23,11,8,4,6,4,2,2,1,0,0,1
S01007570,Occupancy rating 0,35,1,1,0,33,1,20,3,12,5,12,10,2,1,0,0,0,1
S01007570,Occupancy rating -1 or less,12,1,0,1,9,0,7,1,5,1,2,2,0,2,1,0,0,1
S01007571,All households,240,63,34,29,174,26,139,75,49,15,9,3,6,3,1,0,1,1
S01007571,Occupancy rating +2 or more,169,39,24,15,128,23,102,60,30,12,3,0,3,2,0,0,1,1
S01007571,Occupancy rating +1,50,16,8,8,34,2,28,15,11,2,4,3,1,0,0,0,0,0
S01007571,Occupancy rating 0,16,7,1,6,9,0,7,0,6,1,2,0,2,0,0,0,0,0
S01007571,Occupancy rating -1 or less,5,1,1,0,3,1,2,0,2,0,0,0,0,1,1,0,0,0
S01007572,All households,370,102,46,56,256,37,178,73,78,27,41,32,9,12,6,0,2,4
S01007572,Occupancy rating +2 or more,164,35,16,19,122,21,98,54,33,11,3,2,1,7,3,0,1,3
S01007572,Occupancy rating +1,112,46,22,24,62,11,39,17,15,7,12,8,4,4,2,0,1,1
S01007572,Occupancy rating 0,80,19,7,12,61,5,35,2,26,7,21,19,2,0,0,0,0,0
S01007572,Occupancy rating -1 or less,14,2,1,1,11,0,6,0,4,2,5,3,2,1,1,0,0,0
S01007573,All households,329,55,10,45,267,12,230,75,139,16,25,20,5,7,2,0,0,5
S01007573,Occupancy rating +2 or more,191,39,6,33,150,10,137,60,68,9,3,3,0,2,1,0,0,1
S01007573,Occupancy rating +1,100,16,4,12,83,2,67,15,49,3,14,10,4,1,1,0,0,0
S01007573,Occupancy rating 0,29,0,0,0,26,0,19,0,15,4,7,6,1,3,0,0,0,3
S01007573,Occupancy rating -1 or less,9,0,0,0,8,0,7,0,7,0,1,1,0,1,0,0,0,1
S01007574,All households,438,127,65,62,292,41,189,74,85,30,62,41,21,19,10,0,0,9
S01007574,Occupancy rating +2 or more,133,56,27,29,76,21,51,39,8,4,4,1,3,1,1,0,0,0
S01007574,Occupancy rating +1,182,59,31,28,117,14,83,33,36,14,20,14,6,6,1,0,0,5
S01007574,Occupancy rating 0,81,8,4,4,70,3,41,2,31,8,26,18,8,3,3,0,0,0
S01007574,Occupancy rating -1 or less,42,4,3,1,29,3,14,0,10,4,12,8,4,9,5,0,0,4
S01007575,All households,452,210,88,122,225,32,126,61,48,17,67,50,17,17,7,0,4,6
S01007575,Occupancy rating +2 or more,94,49,21,28,43,11,29,24,4,1,3,2,1,2,1,0,1,0
S01007575,Occupancy rating +1,148,64,31,33,82,17,49,29,14,6,16,11,5,2,1,0,0,1
S01007575,Occupancy rating 0,164,84,30,54,73,1,38,6,24,8,34,26,8,7,2,0,3,2
S01007575,Occupancy rating -1 or less,46,13,6,7,27,3,10,2,6,2,14,11,3,6,3,0,0,3
S01007576,All households,344,144,43,101,185,13,91,37,43,11,81,55,26,15,9,0,1,5
S01007576,Occupancy rating +2 or more,45,23,8,15,21,5,13,10,2,1,3,1,2,1,0,0,0,1
S01007576,Occupancy rating +1,110,51,19,32,55,4,31,18,10,3,20,12,8,4,0,0,1,3
S01007576,Occupancy rating 0,145,56,15,41,85,3,36,9,21,6,46,32,14,4,4,0,0,0
S01007576,Occupancy rating -1 or less,44,14,1,13,24,1,11,0,10,1,12,10,2,6,5,0,0,1
S01007577,All households,296,91,34,57,194,13,105,37,48,20,76,51,25,11,5,0,1,5
S01007577,Occupancy rating +2 or more,56,19,7,12,35,6,23,17,3,3,6,2,4,2,0,0,1,1
S01007577,Occupancy rating +1,94,41,20,21,51,6,28,16,6,6,17,8,9,2,1,0,0,1
S01007577,Occupancy rating 0,115,29,7,22,82,0,38,3,26,9,44,33,11,4,2,0,0,2
S01007577,Occupancy rating -1 or less,31,2,0,2,26,1,16,1,13,2,9,8,1,3,2,0,0,1
S01007578,All households,332,141,59,82,180,10,118,46,56,16,52,41,11,11,4,0,0,7
S01007578,Occupancy rating +2 or more,69,32,17,15,34,0,32,26,4,2,2,1,1,3,2,0,0,1
S01007578,Occupancy rating +1,110,52,28,24,56,9,35,17,9,9,12,10,2,2,0,0,0,2
S01007578,Occupancy rating 0,118,43,11,32,73,1,41,3,34,4,31,23,8,2,0,0,0,2
S01007578,Occupancy rating -1 or less,35,14,3,11,17,0,10,0,9,1,7,7,0,4,2,0,0,2
S01007579,All households,298,115,33,82,172,16,88,27,55,6,68,51,17,11,7,0,0,4
S01007579,Occupancy rating +2 or more,37,14,5,9,23,5,14,9,4,1,4,0,4,0,0,0,0,0
S01007579,Occupancy rating +1,102,48,16,32,49,8,29,14,13,2,12,8,4,5,2,0,0,3
S01007579,Occupancy rating 0,120,41,8,33,77,2,33,2,28,3,42,35,7,2,1,0,0,1
S01007579,Occupancy rating -1 or less,39,12,4,8,23,1,12,2,10,0,10,8,2,4,4,0,0,0
S01007580,All households,293,66,23,43,197,19,120,29,67,24,58,40,18,30,16,0,1,13
S01007580,Occupancy rating +2 or more,99,39,16,23,55,11,39,22,10,7,5,1,4,5,2,0,0,3
S01007580,Occupancy rating +1,69,11,5,6,52,8,27,4,17,6,17,10,7,6,0,0,0,6
S01007580,Occupancy rating 0,82,10,1,9,63,0,41,3,30,8,22,16,6,9,5,0,1,3
S01007580,Occupancy rating -1 or less,43,6,1,5,27,0,13,0,10,3,14,13,1,10,9,0,0,1
S01007581,All households,198,44,24,20,143,12,91,30,40,21,40,25,15,11,4,0,0,7
S01007581,Occupancy rating +2 or more,58,16,10,6,41,7,31,20,9,2,3,1,2,1,0,0,0,1
S01007581,Occupancy rating +1,71,24,14,10,44,4,26,9,8,9,14,10,4,3,0,0,0,3
S01007581,Occupancy rating 0,52,3,0,3,45,1,26,1,15,10,18,10,8,4,1,0,0,3
S01007581,Occupancy rating -1 or less,17,1,0,1,13,0,8,0,8,0,5,4,1,3,3,0,0,0
S01007582,All households,285,80,39,41,196,16,126,47,53,26,54,33,21,9,4,0,0,5
S01007582,Occupancy rating +2 or more,55,22,13,9,31,3,26,18,5,3,2,1,1,2,1,0,0,1
S01007582,Occupancy rating +1,106,45,21,24,61,10,41,26,11,4,10,3,7,0,0,0,0,0
S01007582,Occupancy rating 0,81,2,1,1,75,0,46,2,28,16,29,20,9,4,2,0,0,2
S01007582,Occupancy rating -1 or less,43,11,4,7,29,3,13,1,9,3,13,9,4,3,1,0,0,2
S01007583,All households,519,214,60,154,280,23,147,59,68,20,110,77,33,25,9,0,0,16
S01007583,Occupancy rating +2 or more,84,45,18,27,37,4,29,17,6,6,4,4,0,2,0,0,0,2
S01007583,Occupancy rating +1,191,108,27,81,78,15,49,32,10,7,14,6,8,5,0,0,0,5
S01007583,Occupancy rating 0,199,56,14,42,133,3,53,7,39,7,77,57,20,10,4,0,0,6
S01007583,Occupancy rating -1 or less,45,5,1,4,32,1,16,3,13,0,15,10,5,8,5,0,0,3
S01007584,All households,279,104,31,73,153,17,104,39,55,10,32,17,15,22,10,0,0,12
S01007584,Occupancy rating +2 or more,70,22,12,10,46,11,29,21,6,2,6,1,5,2,1,0,0,1
S01007584,Occupancy rating +1,99,49,13,36,46,5,40,16,20,4,1,0,1,4,2,0,0,2
S01007584,Occupancy rating 0,80,22,3,19,49,1,26,1,21,4,22,15,7,9,3,0,0,6
S01007584,Occupancy rating -1 or less,30,11,3,8,12,0,9,1,8,0,3,1,2,7,4,0,0,3
S01007585,All households,438,149,109,40,275,67,177,84,51,42,31,10,21,14,5,0,0,9
S01007585,Occupancy rating +2 or more,264,96,70,26,163,52,99,59,23,17,12,5,7,5,1,0,0,4
S01007585,Occupancy rating +1,122,43,33,10,77,14,52,23,14,15,11,3,8,2,1,0,0,1
S01007585,Occupancy rating 0,33,6,2,4,24,1,16,1,9,6,7,2,5,3,2,0,0,1
S01007585,Occupancy rating -1 or less,19,4,4,0,11,0,10,1,5,4,1,0,1,4,1,0,0,3
S01007586,All households,377,121,54,67,246,22,159,60,76,23,65,44,21,10,6,0,0,4
S01007586,Occupancy rating +2 or more,139,44,25,19,94,14,70,44,19,7,10,4,6,1,0,0,0,1
S01007586,Occupancy rating +1,126,62,23,39,63,7,44,15,19,10,12,8,4,1,1,0,0,0
S01007586,Occupancy rating 0,96,14,5,9,77,1,38,1,33,4,38,28,10,5,2,0,0,3
S01007586,Occupancy rating -1 or less,16,1,1,0,12,0,7,0,5,2,5,4,1,3,3,0,0,0
S01007587,All households,306,119,53,66,175,39,121,57,45,19,15,10,5,12,3,0,1,8
S01007587,Occupancy rating +2 or more,175,49,31,18,120,30,82,40,28,14,8,5,3,6,1,0,1,4
S01007587,Occupancy rating +1,68,32,12,20,34,5,27,11,12,4,2,1,1,2,1,0,0,1
S01007587,Occupancy rating 0,53,31,10,21,18,2,11,5,5,1,5,4,1,4,1,0,0,3
S01007587,Occupancy rating -1 or less,10,7,0,7,3,2,1,1,0,0,0,0,0,0,0,0,0,0
S01007588,All households,360,103,64,39,238,50,167,63,83,21,21,11,10,19,6,0,1,12
S01007588,Occupancy rating +2 or more,255,77,52,25,169,43,119,56,50,13,7,4,3,9,3,0,0,6
S01007588,Occupancy rating +1,65,22,9,13,39,6,27,7,18,2,6,2,4,4,0,0,0,4
S01007588,Occupancy rating 0,28,3,3,0,23,1,16,0,12,4,6,4,2,2,0,0,1,1
S01007588,Occupancy rating -1 or less,12,1,0,1,7,0,5,0,3,2,2,1,1,4,3,0,0,1
S01007589,All households,408,199,59,140,192,27,134,73,43,18,31,19,12,17,5,0,0,12
S01007589,Occupancy rating +2 or more,176,77,30,47,98,23,67,35,22,10,8,4,4,1,1,0,0,0
S01007589,Occupancy rating +1,112,62,20,42,46,0,39,22,12,5,7,5,2,4,0,0,0,4
S01007589,Occupancy rating 0,96,56,9,47,36,3,20,15,3,2,13,8,5,4,0,0,0,4
S01007589,Occupancy rating -1 or less,24,4,0,4,12,1,8,1,6,1,3,2,1,8,4,0,0,4
S01007590,All households,289,87,61,26,193,43,131,52,60,19,19,13,6,9,2,0,2,5
S01007590,Occupancy rating +2 or more,223,62,46,16,155,39,106,46,45,15,10,7,3,6,0,0,1,5
S01007590,Occupancy rating +1,48,21,12,9,26,4,15,6,6,3,7,5,2,1,1,0,0,0
S01007590,Occupancy rating 0,13,2,1,1,9,0,8,0,7,1,1,1,0,2,1,0,1,0
S01007590,Occupancy rating -1 or less,5,2,2,0,3,0,2,0,2,0,1,0,1,0,0,0,0,0
S01007591,All households,272,100,40,60,159,17,116,53,47,16,26,13,13,13,3,0,0,10
S01007591,Occupancy rating +2 or more,105,37,20,17,66,14,49,26,16,7,3,1,2,2,0,0,0,2
S01007591,Occupancy rating +1,79,34,8,26,45,2,35,20,12,3,8,3,5,0,0,0,0,0
S01007591,Occupancy rating 0,67,22,9,13,37,0,29,6,17,6,8,3,5,8,1,0,0,7
S01007591,Occupancy rating -1 or less,21,7,3,4,11,1,3,1,2,0,7,6,1,3,2,0,0,1
S01007592,All households,353,162,45,117,161,16,88,42,30,16,57,41,16,30,9,1,2,18
S01007592,Occupancy rating +2 or more,62,30,15,15,31,2,25,18,4,3,4,3,1,1,0,0,1,0
S01007592,Occupancy rating +1,142,85,22,63,52,8,33,17,10,6,11,4,7,5,1,0,1,3
S01007592,Occupancy rating 0,112,40,8,32,59,5,22,6,12,4,32,25,7,13,3,1,0,9
S01007592,Occupancy rating -1 or less,37,7,0,7,19,1,8,1,4,3,10,9,1,11,5,0,0,6
S01007593,All households,453,122,67,55,307,64,215,94,93,28,28,15,13,24,10,0,0,14
S01007593,Occupancy rating +2 or more,231,54,31,23,170,44,117,67,39,11,9,3,6,7,5,0,0,2
S01007593,Occupancy rating +1,145,56,30,26,85,19,57,25,20,12,9,6,3,4,0,0,0,4
S01007593,Occupancy rating 0,58,11,6,5,39,1,30,2,24,4,8,5,3,8,2,0,0,6
S01007593,Occupancy rating -1 or less,19,1,0,1,13,0,11,0,10,1,2,1,1,5,3,0,0,2
S01007594,All households,334,76,41,35,251,34,193,84,78,31,24,12,12,7,0,0,2,5
S01007594,Occupancy rating +2 or more,200,41,24,17,156,23,128,66,46,16,5,1,4,3,0,0,1,2
S01007594,Occupancy rating +1,84,22,11,11,59,9,41,16,18,7,9,6,3,3,0,0,1,2
S01007594,Occupancy rating 0,43,12,5,7,31,1,21,2,11,8,9,4,5,0,0,0,0,0
S01007594,Occupancy rating -1 or less,7,1,1,0,5,1,3,0,3,0,1,1,0,1,0,0,0,1
S01007595,All households,443,134,63,71,299,63,215,107,81,27,21,11,10,10,4,0,0,6
S01007595,Occupancy rating +2 or more,279,70,32,38,204,46,145,89,44,12,13,8,5,5,3,0,0,2
S01007595,Occupancy rating +1,98,38,18,20,57,14,42,14,19,9,1,1,0,3,1,0,0,2
S01007595,Occupancy rating 0,49,22,11,11,26,3,18,2,12,4,5,2,3,1,0,0,0,1
S01007595,Occupancy rating -1 or less,17,4,2,2,12,0,10,2,6,2,2,0,2,1,0,0,0,1
S01007596,All households,275,98,55,43,164,34,108,61,30,17,22,9,13,13,4,0,1,8
S01007596,Occupancy rating +2 or more,157,53,34,19,98,25,65,39,19,7,8,3,5,6,3,0,0,3
S01007596,Occupancy rating +1,84,34,16,18,45,6,32,17,6,9,7,2,5,5,0,0,1,4
S01007596,Occupancy rating 0,24,10,4,6,13,2,6,3,2,1,5,2,3,1,1,0,0,0
S01007596,Occupancy rating -1 or less,10,1,1,0,8,1,5,2,3,0,2,2,0,1,0,0,0,1
S01007597,All households,254,55,26,29,188,32,145,55,66,24,11,6,5,11,6,0,0,5
S01007597,Occupancy rating +2 or more,185,35,15,20,142,31,107,48,42,17,4,1,3,8,6,0,0,2
S01007597,Occupancy rating +1,49,15,10,5,32,1,28,7,15,6,3,3,0,2,0,0,0,2
S01007597,Occupancy rating 0,15,5,1,4,9,0,7,0,6,1,2,1,1,1,0,0,0,1
S01007597,Occupancy rating -1 or less,5,0,0,0,5,0,3,0,3,0,2,1,1,0,0,0,0,0
S01007598,All households,266,58,27,31,195,36,139,76,43,20,20,15,5,13,5,1,1,6
S01007598,Occupancy rating +2 or more,183,39,17,22,138,34,100,61,26,13,4,3,1,6,4,1,1,0
S01007598,Occupancy rating +1,49,14,6,8,33,1,22,11,6,5,10,7,3,2,0,0,0,2
S01007598,Occupancy rating 0,27,5,4,1,17,0,14,4,9,1,3,2,1,5,1,0,0,4
S01007598,Occupancy rating -1 or less,7,0,0,0,7,1,3,0,2,1,3,3,0,0,0,0,0,0
S01007599,All households,361,112,34,78,233,29,174,70,77,27,30,22,8,16,6,2,2,6
S01007599,Occupancy rating +2 or more,156,41,21,20,113,18,92,55,28,9,3,3,0,2,0,0,0,2
S01007599,Occupancy rating +1,109,42,6,36,61,8,46,14,23,9,7,2,5,6,0,2,2,2
S01007599,Occupancy rating 0,77,27,6,21,46,2,28,1,20,7,16,14,2,4,3,0,0,1
S01007599,Occupancy rating -1 or less,19,2,1,1,13,1,8,0,6,2,4,3,1,4,3,0,0,1
S01007600,All households,510,221,116,105,274,44,203,91,89,23,27,15,12,15,4,1,0,10
S01007600,Occupancy rating +2 or more,248,68,40,28,174,33,133,72,47,14,8,4,4,6,1,0,0,5
S01007600,Occupancy rating +1,93,41,11,30,47,6,33,8,18,7,8,4,4,5,1,0,0,4
S01007600,Occupancy rating 0,141,96,57,39,42,4,30,11,19,0,8,5,3,3,1,1,0,1
S01007600,Occupancy rating -1 or less,28,16,8,8,11,1,7,0,5,2,3,2,1,1,1,0,0,0
S01007601,All households,300,106,18,88,180,12,134,55,54,25,34,24,10,14,5,1,0,8
S01007601,Occupancy rating +2 or more,87,14,6,8,71,9,55,22,21,12,7,2,5,2,2,0,0,0
S01007601,Occupancy rating +1,113,55,7,48,53,3,44,26,11,7,6,4,2,5,3,0,0,2
S01007601,Occupancy rating 0,84,32,4,28,46,0,27,6,15,6,19,16,3,6,0,0,0,6
S01007601,Occupancy rating -1 or less,16,5,1,4,10,0,8,1,7,0,2,2,0,1,0,1,0,0
S01007602,All households,269,68,26,42,194,12,164,74,61,29,18,11,7,7,3,0,0,4
S01007602,Occupancy rating +2 or more,150,29,15,14,118,8,103,62,26,15,7,5,2,3,1,0,0,2
S01007602,Occupancy rating +1,71,24,7,17,46,4,39,11,20,8,3,0,3,1,0,0,0,1
S01007602,Occupancy rating 0,41,14,4,10,25,0,18,1,13,4,7,5,2,2,1,0,0,1
S01007602,Occupancy rating -1 or less,7,1,0,1,5,0,4,0,2,2,1,1,0,1,1,0,0,0
S01007603,All households,309,53,21,32,252,22,209,93,77,39,21,14,7,4,2,0,0,2
S01007603,Occupancy rating +2 or more,223,25,14,11,195,19,165,82,54,29,11,5,6,3,2,0,0,1
S01007603,Occupancy rating +1,60,22,5,17,38,2,32,9,13,10,4,3,1,0,0,0,0,0
S01007603,Occupancy rating 0,22,6,2,4,15,1,9,2,7,0,5,5,0,1,0,0,0,1
S01007603,Occupancy rating -1 or less,4,0,0,0,4,0,3,0,3,0,1,1,0,0,0,0,0,0
S01007604,All households,389,107,58,49,269,54,205,95,77,33,10,6,4,13,6,1,1,5
S01007604,Occupancy rating +2 or more,239,63,33,30,169,36,130,71,40,19,3,2,1,7,3,0,0,4
S01007604,Occupancy rating +1,99,26,15,11,69,14,53,16,27,10,2,0,2,4,2,0,1,1
S01007604,Occupancy rating 0,35,15,8,7,20,3,14,7,4,3,3,2,1,0,0,0,0,0
S01007604,Occupancy rating -1 or less,16,3,2,1,11,1,8,1,6,1,2,2,0,2,1,1,0,0
S01007605,All households,364,88,52,36,267,52,193,88,69,36,22,10,12,9,3,0,1,5
S01007605,Occupancy rating +2 or more,213,50,33,17,162,40,116,69,29,18,6,2,4,1,0,0,0,1
S01007605,Occupancy rating +1,107,37,19,18,68,8,52,17,23,12,8,5,3,2,0,0,1,1
S01007605,Occupancy rating 0,37,1,0,1,30,2,21,2,13,6,7,3,4,6,3,0,0,3
S01007605,Occupancy rating -1 or less,7,0,0,0,7,2,4,0,4,0,1,0,1,0,0,0,0,0
S01007606,All households,314,143,51,92,165,26,118,48,49,21,21,15,6,6,3,0,0,3
S01007606,Occupancy rating +2 or more,131,45,23,22,85,17,61,34,15,12,7,3,4,1,1,0,0,0
S01007606,Occupancy rating +1,60,27,10,17,32,6,23,5,14,4,3,2,1,1,0,0,0,1
S01007606,Occupancy rating 0,99,54,15,39,42,2,32,9,19,4,8,7,1,3,1,0,0,2
S01007606,Occupancy rating -1 or less,24,17,3,14,6,1,2,0,1,1,3,3,0,1,1,0,0,0
S01007607,All households,294,61,33,28,224,40,165,68,70,27,19,6,13,9,3,0,2,4
S01007607,Occupancy rating +2 or more,201,39,21,18,159,36,111,58,32,21,12,3,9,3,1,0,1,1
S01007607,Occupancy rating +1,66,19,11,8,43,4,35,7,24,4,4,1,3,4,1,0,1,2
S01007607,Occupancy rating 0,18,2,1,1,16,0,13,2,9,2,3,2,1,0,0,0,0,0
S01007607,Occupancy rating -1 or less,9,1,0,1,6,0,6,1,5,0,0,0,0,2,1,0,0,1
S01007608,All households,308,77,45,32,223,33,163,64,64,35,27,14,13,8,4,0,1,3
S01007608,Occupancy rating +2 or more,204,59,36,23,143,31,98,55,27,16,14,6,8,2,0,0,0,2
S01007608,Occupancy rating +1,66,11,8,3,54,2,46,7,24,15,6,3,3,1,1,0,0,0
S01007608,Occupancy rating 0,30,7,1,6,20,0,15,2,11,2,5,4,1,3,1,0,1,1
S01007608,Occupancy rating -1 or less,8,0,0,0,6,0,4,0,2,2,2,1,1,2,2,0,0,0
S01007609,All households,447,169,53,116,254,29,157,65,71,21,68,51,17,24,7,1,4,12
S01007609,Occupancy rating +2 or more,122,48,14,34,71,16,48,26,15,7,7,3,4,3,1,0,0,2
S01007609,Occupancy rating +1,153,75,26,49,73,13,51,36,10,5,9,4,5,5,1,1,1,2
S01007609,Occupancy rating 0,143,37,10,27,94,0,49,2,40,7,45,38,7,12,3,0,3,6
S01007609,Occupancy rating -1 or less,29,9,3,6,16,0,9,1,6,2,7,6,1,4,2,0,0,2
S01007610,All households,255,131,39,92,115,18,71,39,25,7,26,19,7,9,3,1,1,4
S01007610,Occupancy rating +2 or more,69,21,6,15,46,12,31,21,8,2,3,1,2,2,1,0,0,1
S01007610,Occupancy rating +1,81,53,16,37,28,4,21,14,6,1,3,2,1,0,0,0,0,0
S01007610,Occupancy rating 0,90,57,17,40,29,2,14,3,9,2,13,11,2,4,0,1,1,2
S01007610,Occupancy rating -1 or less,15,0,0,0,12,0,5,1,2,2,7,5,2,3,2,0,0,1
S01007611,All households,538,307,132,175,207,28,133,68,47,18,46,32,14,24,7,0,0,17
S01007611,Occupancy rating +2 or more,99,53,24,29,41,7,31,16,8,7,3,3,0,5,1,0,0,4
S01007611,Occupancy rating +1,143,86,37,49,52,14,33,25,8,0,5,3,2,5,0,0,0,5
S01007611,Occupancy rating 0,250,150,64,86,93,6,56,24,21,11,31,22,9,7,3,0,0,4
S01007611,Occupancy rating -1 or less,46,18,7,11,21,1,13,3,10,0,7,4,3,7,3,0,0,4
S01007612,All households,609,357,88,269,201,17,143,80,49,14,41,24,17,51,7,10,2,32
S01007612,Occupancy rating +2 or more,110,40,12,28,60,8,41,25,11,5,11,5,6,10,2,1,1,6
S01007612,Occupancy rating +1,178,111,30,81,58,7,44,28,12,4,7,4,3,9,0,1,0,8
S01007612,Occupancy rating 0,230,149,40,109,63,2,47,24,20,3,14,10,4,18,0,6,1,11
S01007612,Occupancy rating -1 or less,91,57,6,51,20,0,11,3,6,2,9,5,4,14,5,2,0,7
S01007613,All households,324,103,45,58,201,32,153,70,67,16,16,5,11,20,3,1,0,16
S01007613,Occupancy rating +2 or more,217,59,33,26,146,28,109,52,46,11,9,3,6,12,1,1,0,10
S01007613,Occupancy rating +1,52,22,9,13,28,3,21,7,10,4,4,1,3,2,0,0,0,2
S01007613,Occupancy rating 0,46,21,3,18,21,0,19,8,10,1,2,1,1,4,0,0,0,4
S01007613,Occupancy rating -1 or less,9,1,0,1,6,1,4,3,1,0,1,0,1,2,2,0,0,0
S01007614,All households,358,87,48,39,260,53,188,75,93,20,19,12,7,11,4,0,1,6
S01007614,Occupancy rating +2 or more,291,65,38,27,218,50,158,68,74,16,10,6,4,8,2,0,1,5
S01007614,Occupancy rating +1,47,19,9,10,26,3,18,6,11,1,5,4,1,2,1,0,0,1
S01007614,Occupancy rating 0,14,3,1,2,11,0,8,1,5,2,3,2,1,0,0,0,0,0
S01007614,Occupancy rating -1 or less,6,0,0,0,5,0,4,0,3,1,1,0,1,1,1,0,0,0
S01007615,All households,515,201,85,116,293,44,204,87,93,24,45,30,15,21,4,0,2,15
S01007615,Occupancy rating +2 or more,239,67,34,33,163,30,119,53,51,15,14,10,4,9,2,0,1,6
S01007615,Occupancy rating +1,133,59,25,34,68,12,48,20,22,6,8,5,3,6,0,0,1,5
S01007615,Occupancy rating 0,111,60,19,41,47,2,30,12,15,3,15,9,6,4,1,0,0,3
S01007615,Occupancy rating -1 or less,32,15,7,8,15,0,7,2,5,0,8,6,2,2,1,0,0,1
S01007616,All households,387,181,70,111,192,21,128,65,50,13,43,31,12,14,4,2,0,8
S01007616,Occupancy rating +2 or more,81,35,12,23,45,9,31,18,11,2,5,3,2,1,0,0,0,1
S01007616,Occupancy rating +1,143,78,36,42,61,7,49,33,10,6,5,3,2,4,3,0,0,1
S01007616,Occupancy rating 0,137,63,21,42,69,4,41,12,24,5,24,19,5,5,0,1,0,4
S01007616,Occupancy rating -1 or less,26,5,1,4,17,1,7,2,5,0,9,6,3,4,1,1,0,2
S01007617,All households,234,69,35,34,156,28,105,43,44,18,23,15,8,9,3,0,1,5
S01007617,Occupancy rating +2 or more,70,17,12,5,51,14,36,18,11,7,1,0,1,2,1,0,0,1
S01007617,Occupancy rating +1,99,36,17,19,60,12,42,22,14,6,6,4,2,3,2,0,0,1
S01007617,Occupancy rating 0,52,16,6,10,34,2,20,2,14,4,12,7,5,2,0,0,1,1
S01007617,Occupancy rating -1 or less,13,0,0,0,11,0,7,1,5,1,4,4,0,2,0,0,0,2
S01007618,All households,294,108,86,22,180,28,112,45,54,13,40,25,15,6,4,0,0,2
S01007618,Occupancy rating +2 or more,91,35,22,13,56,20,29,22,7,0,7,4,3,0,0,0,0,0
S01007618,Occupancy rating +1,92,32,25,7,57,6,37,20,14,3,14,8,6,3,1,0,0,2
S01007618,Occupancy rating 0,81,30,29,1,50,2,34,2,23,9,14,10,4,1,1,0,0,0
S01007618,Occupancy rating -1 or less,30,11,10,1,17,0,12,1,10,1,5,3,2,2,2,0,0,0
S01007619,All households,280,92,45,47,177,26,121,47,50,24,30,17,13,11,6,0,1,4
S01007619,Occupancy rating +2 or more,95,33,19,14,61,18,38,27,9,2,5,2,3,1,1,0,0,0
S01007619,Occupancy rating +1,106,33,15,18,70,6,51,18,19,14,13,6,7,3,1,0,0,2
S01007619,Occupancy rating 0,63,22,8,14,37,1,25,1,19,5,11,8,3,4,3,0,0,1
S01007619,Occupancy rating -1 or less,16,4,3,1,9,1,7,1,3,3,1,1,0,3,1,0,1,1
S01007620,All households,271,80,39,41,185,41,133,68,40,25,11,6,5,6,2,0,1,3
S01007620,Occupancy rating +2 or more,157,49,30,19,107,31,75,44,19,12,1,1,0,1,0,0,0,1
S01007620,Occupancy rating +1,86,27,9,18,57,9,41,23,11,7,7,4,3,2,0,0,1,1
S01007620,Occupancy rating 0,24,4,0,4,19,1,15,1,9,5,3,1,2,1,0,0,0,1
S01007620,Occupancy rating -1 or less,4,0,0,0,2,0,2,0,1,1,0,0,0,2,2,0,0,0
S01007621,All households,291,77,51,26,206,41,141,60,53,28,24,12,12,8,4,0,1,3
S01007621,Occupancy rating +2 or more,152,42,28,14,107,29,70,50,12,8,8,2,6,3,2,0,1,0
S01007621,Occupancy rating +1,101,31,21,10,68,11,49,9,24,16,8,4,4,2,0,0,0,2
S01007621,Occupancy rating 0,27,2,2,0,24,1,16,0,13,3,7,6,1,1,0,0,0,1
S01007621,Occupancy rating -1 or less,11,2,0,2,7,0,6,1,4,1,1,0,1,2,2,0,0,0
S01007622,All households,256,80,50,30,170,25,114,43,50,21,31,15,16,6,2,0,1,3
S01007622,Occupancy rating +2 or more,128,39,22,17,89,20,66,31,23,12,3,2,1,0,0,0,0,0
S01007622,Occupancy rating +1,63,20,13,7,40,4,24,10,9,5,12,6,6,3,0,0,0,3
S01007622,Occupancy rating 0,53,18,12,6,33,1,18,2,12,4,14,6,8,2,1,0,1,0
S01007622,Occupancy rating -1 or less,12,3,3,0,8,0,6,0,6,0,2,1,1,1,1,0,0,0
S01007623,All households,250,52,31,21,192,37,140,57,62,21,15,9,6,6,3,0,1,2
S01007623,Occupancy rating +2 or more,166,34,22,12,129,33,92,46,37,9,4,3,1,3,0,0,1,2
S01007623,Occupancy rating +1,55,16,8,8,39,3,32,11,11,10,4,2,2,0,0,0,0,0
S01007623,Occupancy rating 0,18,0,0,0,17,0,12,0,11,1,5,2,3,1,1,0,0,0
S01007623,Occupancy rating -1 or less,11,2,1,1,7,1,4,0,3,1,2,2,0,2,2,0,0,0
S01007624,All households,268,61,23,38,201,22,160,58,75,27,19,8,11,6,2,0,0,4
S01007624,Occupancy rating +2 or more,140,39,18,21,98,17,76,44,18,14,5,2,3,3,2,0,0,1
S01007624,Occupancy rating +1,93,18,4,14,73,5,60,14,36,10,8,3,5,2,0,0,0,2
S01007624,Occupancy rating 0,30,4,1,3,25,0,22,0,19,3,3,2,1,1,0,0,0,1
S01007624,Occupancy rating -1 or less,5,0,0,0,5,0,2,0,2,0,3,1,2,0,0,0,0,0
S01007625,All households,224,63,34,29,156,22,118,56,46,16,16,9,7,5,1,0,0,4
S01007625,Occupancy rating +2 or more,100,21,10,11,78,11,62,30,25,7,5,3,2,1,0,0,0,1
S01007625,Occupancy rating +1,96,40,22,18,54,10,42,24,14,4,2,1,1,2,0,0,0,2
S01007625,Occupancy rating 0,21,1,1,0,19,0,10,2,5,3,9,5,4,1,0,0,0,1
S01007625,Occupancy rating -1 or less,7,1,1,0,5,1,4,0,2,2,0,0,0,1,1,0,0,0
S01007626,All households,269,75,19,56,185,16,157,52,88,17,12,9,3,9,2,0,0,7
S01007626,Occupancy rating +2 or more,120,34,10,24,84,8,75,32,35,8,1,0,1,2,1,0,0,1
S01007626,Occupancy rating +1,107,38,8,30,67,8,55,20,27,8,4,3,1,2,0,0,0,2
S01007626,Occupancy rating 0,36,3,1,2,29,0,23,0,22,1,6,5,1,4,1,0,0,3
S01007626,Occupancy rating -1 or less,6,0,0,0,5,0,4,0,4,0,1,1,0,1,0,0,0,1
S01007627,All households,251,83,50,33,163,19,127,63,57,7,17,10,7,5,2,0,0,3
S01007627,Occupancy rating +2 or more,142,31,10,21,109,15,85,44,35,6,9,7,2,2,1,0,0,1
S01007627,Occupancy rating +1,54,20,11,9,34,3,27,12,15,0,4,3,1,0,0,0,0,0
S01007627,Occupancy rating 0,47,30,27,3,15,1,11,5,6,0,3,0,3,2,0,0,0,2
S01007627,Occupancy rating -1 or less,8,2,2,0,5,0,4,2,1,1,1,0,1,1,1,0,0,0
S01007628,All households,314,78,49,29,225,60,149,68,59,22,16,7,9,11,4,0,0,7
S01007628,Occupancy rating +2 or more,213,45,32,13,161,56,96,51,32,13,9,4,5,7,2,0,0,5
S01007628,Occupancy rating +1,68,22,13,9,42,4,35,14,17,4,3,1,2,4,2,0,0,2
S01007628,Occupancy rating 0,24,9,3,6,15,0,11,2,5,4,4,2,2,0,0,0,0,0
S01007628,Occupancy rating -1 or less,9,2,1,1,7,0,7,1,5,1,0,0,0,0,0,0,0,0
S01007629,All households,286,63,34,29,214,43,151,74,57,20,20,10,10,9,5,0,1,3
S01007629,Occupancy rating +2 or more,190,47,28,19,139,40,93,59,26,8,6,2,4,4,2,0,0,2
S01007629,Occupancy rating +1,50,8,2,6,38,3,34,14,15,5,1,1,0,4,2,0,1,1
S01007629,Occupancy rating 0,34,4,2,2,29,0,20,1,13,6,9,5,4,1,1,0,0,0
S01007629,Occupancy rating -1 or less,12,4,2,2,8,0,4,0,3,1,4,2,2,0,0,0,0,0
S01007630,All households,338,83,40,43,247,29,203,86,76,41,15,7,8,8,2,0,1,5
S01007630,Occupancy rating +2 or more,232,58,33,25,170,24,139,69,46,24,7,3,4,4,1,0,1,2
S01007630,Occupancy rating +1,75,22,7,15,52,4,43,16,16,11,5,2,3,1,0,0,0,1
S01007630,Occupancy rating 0,28,3,0,3,23,1,19,1,12,6,3,2,1,2,0,0,0,2
S01007630,Occupancy rating -1 or less,3,0,0,0,2,0,2,0,2,0,0,0,0,1,1,0,0,0
S01007631,All households,269,57,30,27,199,31,152,77,55,20,16,7,9,13,2,0,1,10
S01007631,Occupancy rating +2 or more,188,37,22,15,143,26,109,61,36,12,8,3,5,8,1,0,1,6
S01007631,Occupancy rating +1,47,15,7,8,30,3,22,12,6,4,5,2,3,2,0,0,0,2
S01007631,Occupancy rating 0,30,5,1,4,24,2,19,4,11,4,3,2,1,1,0,0,0,1
S01007631,Occupancy rating -1 or less,4,0,0,0,2,0,2,0,2,0,0,0,0,2,1,0,0,1
S01007632,All households,437,132,69,63,290,42,200,95,76,29,48,30,18,15,7,0,1,7
S01007632,Occupancy rating +2 or more,207,55,27,28,149,34,104,63,27,14,11,7,4,3,2,0,1,0
S01007632,Occupancy rating +1,113,39,21,18,69,5,53,30,17,6,11,5,6,5,2,0,0,3
S01007632,Occupancy rating 0,98,35,18,17,58,3,35,2,26,7,20,16,4,5,1,0,0,4
S01007632,Occupancy rating -1 or less,19,3,3,0,14,0,8,0,6,2,6,2,4,2,2,0,0,0
S01007633,All households,441,129,75,54,296,48,214,102,78,34,34,25,9,16,8,0,1,7
S01007633,Occupancy rating +2 or more,210,58,41,17,146,35,107,70,24,13,4,3,1,6,1,0,0,5
S01007633,Occupancy rating +1,118,32,18,14,83,11,60,25,25,10,12,6,6,3,1,0,0,2
S01007633,Occupancy rating 0,92,36,14,22,52,2,36,7,20,9,14,13,1,4,4,0,0,0
S01007633,Occupancy rating -1 or less,21,3,2,1,15,0,11,0,9,2,4,3,1,3,2,0,1,0
S01007634,All households,241,62,32,30,169,26,130,64,45,21,13,9,4,10,2,0,1,7
S01007634,Occupancy rating +2 or more,159,38,20,18,116,21,91,52,25,14,4,3,1,5,0,0,1,4
S01007634,Occupancy rating +1,46,16,8,8,29,4,22,8,10,4,3,1,2,1,1,0,0,0
S01007634,Occupancy rating 0,25,7,3,4,15,1,12,3,6,3,2,2,0,3,0,0,0,3
S01007634,Occupancy rating -1 or less,11,1,1,0,9,0,5,1,4,0,4,3,1,1,1,0,0,0
S01007635,All households,321,105,78,27,205,65,126,54,42,30,14,8,6,11,3,0,2,6
S01007635,Occupancy rating +2 or more,241,72,53,19,163,60,98,50,27,21,5,2,3,6,0,0,2,4
S01007635,Occupancy rating +1,52,24,18,6,27,5,17,3,8,6,5,2,3,1,0,0,0,1
S01007635,Occupancy rating 0,21,5,4,1,13,0,10,1,7,2,3,3,0,3,3,0,0,0
S01007635,Occupancy rating -1 or less,7,4,3,1,2,0,1,0,0,1,1,1,0,1,0,0,0,1
S01007636,All households,416,173,95,78,226,45,139,69,52,18,42,22,20,17,3,0,4,10
S01007636,Occupancy rating +2 or more,183,65,40,25,110,30,76,49,18,9,4,2,2,8,1,0,2,5
S01007636,Occupancy rating +1,113,52,26,26,57,11,34,14,15,5,12,3,9,4,0,0,2,2
S01007636,Occupancy rating 0,102,51,27,24,48,4,23,4,16,3,21,14,7,3,1,0,0,2
S01007636,Occupancy rating -1 or less,18,5,2,3,11,0,6,2,3,1,5,3,2,2,1,0,0,1
S01007637,All households,403,151,73,78,237,33,164,68,72,24,40,23,17,15,9,0,3,3
S01007637,Occupancy rating +2 or more,127,38,22,16,86,16,65,43,18,4,5,4,1,3,2,0,0,1
S01007637,Occupancy rating +1,128,51,20,31,72,11,47,17,22,8,14,5,9,5,2,0,2,1
S01007637,Occupancy rating 0,121,56,28,28,62,4,42,8,24,10,16,10,6,3,2,0,0,1
S01007637,Occupancy rating -1 or less,27,6,3,3,17,2,10,0,8,2,5,4,1,4,3,0,1,0
S01007638,All households,373,150,66,84,212,40,142,57,59,26,30,15,15,11,5,0,0,6
S01007638,Occupancy rating +2 or more,123,34,20,14,87,19,63,31,19,13,5,2,3,2,1,0,0,1
S01007638,Occupancy rating +1,131,67,32,35,63,16,41,18,16,7,6,1,5,1,1,0,0,0
S01007638,Occupancy rating 0,102,46,14,32,53,4,33,7,21,5,16,11,5,3,1,0,0,2
S01007638,Occupancy rating -1 or less,17,3,0,3,9,1,5,1,3,1,3,1,2,5,2,0,0,3
S01007639,All households,451,101,38,63,343,41,214,78,98,38,88,56,32,7,3,0,1,3
S01007639,Occupancy rating +2 or more,187,50,20,30,137,26,100,57,29,14,11,7,4,0,0,0,0,0
S01007639,Occupancy rating +1,141,36,14,22,102,14,56,17,29,10,32,17,15,3,1,0,1,1
S01007639,Occupancy rating 0,104,11,3,8,89,0,49,3,34,12,40,27,13,4,2,0,0,2
S01007639,Occupancy rating -1 or less,19,4,1,3,15,1,9,1,6,2,5,5,0,0,0,0,0,0
S01007640,All households,303,69,22,47,222,34,169,81,60,28,19,13,6,12,5,0,1,6
S01007640,Occupancy rating +2 or more,178,42,12,30,127,27,92,53,26,13,8,4,4,9,4,0,1,4
S01007640,Occupancy rating +1,77,19,8,11,58,7,47,27,12,8,4,4,0,0,0,0,0,0
S01007640,Occupancy rating 0,31,6,2,4,23,0,20,1,13,6,3,2,1,2,0,0,0,2
S01007640,Occupancy rating -1 or less,17,2,0,2,14,0,10,0,9,1,4,3,1,1,1,0,0,0
S01007641,All households,369,100,47,53,259,44,177,66,83,28,38,25,13,10,3,0,2,5
S01007641,Occupancy rating +2 or more,208,59,33,26,143,34,102,50,38,14,7,4,3,6,0,0,2,4
S01007641,Occupancy rating +1,74,20,9,11,52,8,32,11,13,8,12,7,5,2,2,0,0,0
S01007641,Occupancy rating 0,75,19,5,14,55,1,37,5,26,6,17,12,5,1,0,0,0,1
S01007641,Occupancy rating -1 or less,12,2,0,2,9,1,6,0,6,0,2,2,0,1,1,0,0,0
S01007642,All households,415,191,110,81,212,44,148,72,65,11,20,11,9,12,3,0,1,8
S01007642,Occupancy rating +2 or more,210,74,52,22,131,33,93,49,39,5,5,3,2,5,1,0,0,4
S01007642,Occupancy rating +1,89,41,15,26,46,10,29,12,12,5,7,5,2,2,0,0,1,1
S01007642,Occupancy rating 0,87,61,40,21,24,1,16,8,8,0,7,2,5,2,0,0,0,2
S01007642,Occupancy rating -1 or less,29,15,3,12,11,0,10,3,6,1,1,1,0,3,2,0,0,1
S01007643,All households,424,153,83,70,262,46,167,75,62,30,49,27,22,9,1,0,2,6
S01007643,Occupancy rating +2 or more,210,69,43,26,138,38,84,48,24,12,16,8,8,3,1,0,1,1
S01007643,Occupancy rating +1,108,42,26,16,62,7,40,11,19,10,15,6,9,4,0,0,1,3
S01007643,Occupancy rating 0,90,38,12,26,50,1,33,12,14,7,16,11,5,2,0,0,0,2
S01007643,Occupancy rating -1 or less,16,4,2,2,12,0,10,4,5,1,2,2,0,0,0,0,0,0
S01007644,All households,384,108,65,43,270,59,156,77,62,17,55,35,20,6,1,0,1,4
S01007644,Occupancy rating +2 or more,203,52,32,20,149,49,96,64,25,7,4,3,1,2,1,0,0,1
S01007644,Occupancy rating +1,90,28,19,9,60,9,32,12,15,5,19,10,9,2,0,0,0,2
S01007644,Occupancy rating 0,82,28,14,14,52,1,22,1,18,3,29,20,9,2,0,0,1,1
S01007644,Occupancy rating -1 or less,9,0,0,0,9,0,6,0,4,2,3,2,1,0,0,0,0,0
S01007645,All households,219,40,12,28,165,30,117,63,37,17,18,7,11,14,7,0,0,7
S01007645,Occupancy rating +2 or more,150,26,10,16,115,24,84,52,20,12,7,1,6,9,5,0,0,4
S01007645,Occupancy rating +1,45,11,2,9,32,6,22,7,10,5,4,4,0,2,1,0,0,1
S01007645,Occupancy rating 0,18,1,0,1,14,0,8,3,5,0,6,2,4,3,1,0,0,2
S01007645,Occupancy rating -1 or less,6,2,0,2,4,0,3,1,2,0,1,0,1,0,0,0,0,0
S01007646,All households,260,80,25,55,175,28,126,66,48,12,21,9,12,5,3,0,0,2
S01007646,Occupancy rating +2 or more,161,50,15,35,110,25,80,52,22,6,5,0,5,1,1,0,0,0
S01007646,Occupancy rating +1,63,17,7,10,44,3,34,10,20,4,7,3,4,2,1,0,0,1
S01007646,Occupancy rating 0,25,9,2,7,15,0,8,2,6,0,7,6,1,1,1,0,0,0
S01007646,Occupancy rating -1 or less,11,4,1,3,6,0,4,2,0,2,2,0,2,1,0,0,0,1
S01007647,All households,361,142,64,78,211,44,136,60,53,23,31,21,10,8,1,0,1,6
S01007647,Occupancy rating +2 or more,177,53,28,25,120,32,78,40,22,16,10,5,5,4,0,0,0,4
S01007647,Occupancy rating +1,89,39,21,18,49,8,31,9,19,3,10,6,4,1,0,0,0,1
S01007647,Occupancy rating 0,74,34,10,24,37,4,24,10,10,4,9,8,1,3,1,0,1,1
S01007647,Occupancy rating -1 or less,21,16,5,11,5,0,3,1,2,0,2,2,0,0,0,0,0,0
S01007648,All households,446,188,79,109,251,53,169,87,58,24,29,24,5,7,3,0,0,4
S01007648,Occupancy rating +2 or more,194,63,32,31,129,35,86,61,18,7,8,6,2,2,1,0,0,1
S01007648,Occupancy rating +1,146,71,25,46,72,16,45,19,15,11,11,10,1,3,1,0,0,2
S01007648,Occupancy rating 0,85,45,18,27,39,1,31,6,22,3,7,5,2,1,0,0,0,1
S01007648,Occupancy rating -1 or less,21,9,4,5,11,1,7,1,3,3,3,3,0,1,1,0,0,0
S01007649,All households,339,114,58,56,217,29,160,75,62,23,28,17,11,8,1,1,1,5
S01007649,Occupancy rating +2 or more,144,46,24,22,94,19,73,48,16,9,2,1,1,4,1,1,1,1
S01007649,Occupancy rating +1,100,42,23,19,56,9,39,22,10,7,8,4,4,2,0,0,0,2
S01007649,Occupancy rating 0,84,26,11,15,56,1,41,5,29,7,14,8,6,2,0,0,0,2
S01007649,Occupancy rating -1 or less,11,0,0,0,11,0,7,0,7,0,4,4,0,0,0,0,0,0
S01007650,All households,420,118,64,54,281,56,196,86,79,31,29,16,13,21,3,0,3,15
S01007650,Occupancy rating +2 or more,266,72,45,27,183,44,132,71,45,16,7,3,4,11,1,0,2,8
S01007650,Occupancy rating +1,83,25,13,12,54,7,38,14,15,9,9,5,4,4,0,0,0,4
S01007650,Occupancy rating 0,58,17,5,12,35,4,21,1,15,5,10,6,4,6,2,0,1,3
S01007650,Occupancy rating -1 or less,13,4,1,3,9,1,5,0,4,1,3,2,1,0,0,0,0,0
S01007651,All households,227,49,24,25,169,24,134,50,56,28,11,6,5,9,4,0,1,4
S01007651,Occupancy rating +2 or more,167,36,17,19,124,20,97,44,35,18,7,3,4,7,2,0,1,4
S01007651,Occupancy rating +1,34,9,6,3,24,3,19,5,10,4,2,2,0,1,1,0,0,0
S01007651,Occupancy rating 0,18,3,1,2,15,1,13,0,7,6,1,1,0,0,0,0,0,0
S01007651,Occupancy rating -1 or less,8,1,0,1,6,0,5,1,4,0,1,0,1,1,1,0,0,0
S01007652,All households,257,80,40,40,167,35,116,51,55,10,16,10,6,10,6,0,1,3
S01007652,Occupancy rating +2 or more,145,45,26,19,96,25,67,36,29,2,4,0,4,4,3,0,0,1
S01007652,Occupancy rating +1,59,16,6,10,42,9,27,11,13,3,6,4,2,1,0,0,1,0
S01007652,Occupancy rating 0,44,16,8,8,24,1,19,4,10,5,4,4,0,4,2,0,0,2
S01007652,Occupancy rating -1 or less,9,3,0,3,5,0,3,0,3,0,2,2,0,1,1,0,0,0
S01007653,All households,378,100,49,51,259,38,193,83,72,38,28,18,10,19,3,0,2,14
S01007653,Occupancy rating +2 or more,239,50,24,26,175,32,136,71,40,25,7,6,1,14,2,0,1,11
S01007653,Occupancy rating +1,75,31,16,15,43,5,33,10,16,7,5,3,2,1,0,0,0,1
S01007653,Occupancy rating 0,50,15,6,9,32,1,20,2,13,5,11,6,5,3,0,0,1,2
S01007653,Occupancy rating -1 or less,14,4,3,1,9,0,4,0,3,1,5,3,2,1,1,0,0,0
S01007654,All households,465,155,66,89,295,46,206,82,86,38,43,32,11,15,7,0,0,8
S01007654,Occupancy rating +2 or more,199,60,27,33,135,29,102,52,34,16,4,3,1,4,3,0,0,1
S01007654,Occupancy rating +1,103,31,14,17,71,9,52,16,21,15,10,4,6,1,1,0,0,0
S01007654,Occupancy rating 0,133,52,21,31,73,7,40,13,23,4,26,22,4,8,3,0,0,5
S01007654,Occupancy rating -1 or less,30,12,4,8,16,1,12,1,8,3,3,3,0,2,0,0,0,2
S01007655,All households,341,84,33,51,234,43,172,92,64,16,19,10,9,23,5,0,0,18
S01007655,Occupancy rating +2 or more,255,59,26,33,185,36,137,79,45,13,12,6,6,11,2,0,0,9
S01007655,Occupancy rating +1,65,20,6,14,37,7,28,12,15,1,2,0,2,8,0,0,0,8
S01007655,Occupancy rating 0,12,5,1,4,7,0,5,1,4,0,2,1,1,0,0,0,0,0
S01007655,Occupancy rating -1 or less,9,0,0,0,5,0,2,0,0,2,3,3,0,4,3,0,0,1
S01007656,All households,358,85,44,41,258,40,198,97,72,29,20,14,6,15,7,0,1,7
S01007656,Occupancy rating +2 or more,222,51,26,25,163,28,125,74,34,17,10,7,3,8,4,0,0,4
S01007656,Occupancy rating +1,93,22,10,12,67,12,50,18,26,6,5,3,2,4,2,0,1,1
S01007656,Occupancy rating 0,36,9,6,3,26,0,22,5,11,6,4,3,1,1,0,0,0,1
S01007656,Occupancy rating -1 or less,7,3,2,1,2,0,1,0,1,0,1,1,0,2,1,0,0,1
S01007657,All households,176,39,14,25,128,13,98,55,34,9,17,9,8,9,4,0,1,4
S01007657,Occupancy rating +2 or more,113,22,7,15,85,9,70,46,17,7,6,2,4,6,3,0,0,3
S01007657,Occupancy rating +1,40,14,6,8,25,3,17,5,11,1,5,2,3,1,1,0,0,0
S01007657,Occupancy rating 0,19,3,1,2,16,1,9,2,6,1,6,5,1,0,0,0,0,0
S01007657,Occupancy rating -1 or less,4,0,0,0,2,0,2,2,0,0,0,0,0,2,0,0,1,1
S01007658,All households,231,75,42,33,147,23,105,49,36,20,19,14,5,9,6,0,0,3
S01007658,Occupancy rating +2 or more,153,49,30,19,101,17,70,39,18,13,14,11,3,3,2,0,0,1
S01007658,Occupancy rating +1,49,21,10,11,26,5,20,10,6,4,1,0,1,2,2,0,0,0
S01007658,Occupancy rating 0,23,4,2,2,16,1,13,0,11,2,2,1,1,3,1,0,0,2
S01007658,Occupancy rating -1 or less,6,1,0,1,4,0,2,0,1,1,2,2,0,1,1,0,0,0
S01007659,All households,366,107,56,51,251,51,160,73,69,18,40,21,19,8,4,0,0,4
S01007659,Occupancy rating +2 or more,201,60,30,30,139,41,91,53,32,6,7,1,6,2,1,0,0,1
S01007659,Occupancy rating +1,98,36,19,17,61,7,41,19,17,5,13,8,5,1,0,0,0,1
S01007659,Occupancy rating 0,48,9,5,4,37,2,20,1,13,6,15,9,6,2,0,0,0,2
S01007659,Occupancy rating -1 or less,19,2,2,0,14,1,8,0,7,1,5,3,2,3,3,0,0,0
S01007660,All households,400,145,45,100,246,20,167,66,75,26,59,42,17,9,3,0,0,6
S01007660,Occupancy rating +2 or more,68,20,4,16,48,6,37,28,5,4,5,3,2,0,0,0,0,0
S01007660,Occupancy rating +1,124,49,11,38,74,10,54,23,21,10,10,8,2,1,0,0,0,1
S01007660,Occupancy rating 0,172,69,27,42,97,3,61,11,41,9,33,21,12,6,3,0,0,3
S01007660,Occupancy rating -1 or less,36,7,3,4,27,1,15,4,8,3,11,10,1,2,0,0,0,2
S01007661,All households,327,143,72,71,175,27,124,52,48,24,24,17,7,9,3,0,1,5
S01007661,Occupancy rating +2 or more,131,43,25,18,84,18,61,29,18,14,5,1,4,4,2,0,0,2
S01007661,Occupancy rating +1,79,35,11,24,44,3,37,17,13,7,4,3,1,0,0,0,0,0
S01007661,Occupancy rating 0,95,57,31,26,37,5,21,6,12,3,11,9,2,1,0,0,0,1
S01007661,Occupancy rating -1 or less,22,8,5,3,10,1,5,0,5,0,4,4,0,4,1,0,1,2
S01007662,All households,493,247,126,121,236,50,151,71,60,20,35,23,12,10,4,0,1,5
S01007662,Occupancy rating +2 or more,165,70,40,30,94,26,60,41,14,5,8,5,3,1,1,0,0,0
S01007662,Occupancy rating +1,142,70,36,34,70,14,51,27,19,5,5,2,3,2,0,0,1,1
S01007662,Occupancy rating 0,157,99,47,52,54,9,28,3,17,8,17,13,4,4,2,0,0,2
S01007662,Occupancy rating -1 or less,29,8,3,5,18,1,12,0,10,2,5,3,2,3,1,0,0,2
S01007663,All households,387,137,75,62,235,49,164,76,58,30,22,10,12,15,9,0,2,4
S01007663,Occupancy rating +2 or more,213,57,34,23,146,38,102,57,30,15,6,2,4,10,5,0,2,3
S01007663,Occupancy rating +1,83,35,16,19,47,7,36,14,13,9,4,3,1,1,1,0,0,0
S01007663,Occupancy rating 0,74,36,22,14,34,3,21,4,11,6,10,3,7,4,3,0,0,1
S01007663,Occupancy rating -1 or less,17,9,3,6,8,1,5,1,4,0,2,2,0,0,0,0,0,0
S01007664,All households,283,124,61,63,143,20,95,38,41,16,28,21,7,16,7,0,1,8
S01007664,Occupancy rating +2 or more,99,40,19,21,57,17,37,27,8,2,3,2,1,2,0,0,0,2
S01007664,Occupancy rating +1,71,23,9,14,42,3,31,9,16,6,8,6,2,6,2,0,1,3
S01007664,Occupancy rating 0,86,55,30,25,27,0,18,1,11,6,9,8,1,4,2,0,0,2
S01007664,Occupancy rating -1 or less,27,6,3,3,17,0,9,1,6,2,8,5,3,4,3,0,0,1
S01007665,All households,275,82,35,47,188,27,129,39,66,24,32,25,7,5,3,0,1,1
S01007665,Occupancy rating +2 or more,98,35,17,18,62,21,38,21,15,2,3,1,2,1,1,0,0,0
S01007665,Occupancy rating +1,109,41,17,24,68,6,53,18,26,9,9,8,1,0,0,0,0,0
S01007665,Occupancy rating 0,53,4,0,4,47,0,32,0,21,11,15,12,3,2,1,0,1,0
S01007665,Occupancy rating -1 or less,15,2,1,1,11,0,6,0,4,2,5,4,1,2,1,0,0,1
S01007666,All households,198,38,29,9,150,27,106,45,41,20,17,8,9,10,6,0,1,3
S01007666,Occupancy rating +2 or more,129,24,18,6,100,21,75,39,25,11,4,2,2,5,2,0,0,3
S01007666,Occupancy rating +1,49,13,11,2,32,6,19,6,8,5,7,2,5,4,3,0,1,0
S01007666,Occupancy rating 0,18,1,0,1,16,0,10,0,7,3,6,4,2,1,1,0,0,0
S01007666,Occupancy rating -1 or less,2,0,0,0,2,0,2,0,1,1,0,0,0,0,0,0,0,0
S01007667,All households,283,56,29,27,218,45,165,63,66,36,8,4,4,9,7,0,0,2
S01007667,Occupancy rating +2 or more,201,38,23,15,159,42,115,50,46,19,2,0,2,4,3,0,0,1
S01007667,Occupancy rating +1,60,10,2,8,45,3,41,13,15,13,1,0,1,5,4,0,0,1
S01007667,Occupancy rating 0,18,5,3,2,13,0,9,0,5,4,4,4,0,0,0,0,0,0
S01007667,Occupancy rating -1 or less,4,3,1,2,1,0,0,0,0,0,1,0,1,0,0,0,0,0
S01007668,All households,468,167,68,99,289,37,204,74,94,36,48,33,15,12,6,0,1,5
S01007668,Occupancy rating +2 or more,118,42,19,23,76,18,55,30,19,6,3,1,2,0,0,0,0,0
S01007668,Occupancy rating +1,181,74,31,43,106,18,74,38,21,15,14,9,5,1,0,0,0,1
S01007668,Occupancy rating 0,127,44,15,29,78,0,57,4,43,10,21,16,5,5,2,0,0,3
S01007668,Occupancy rating -1 or less,42,7,3,4,29,1,18,2,11,5,10,7,3,6,4,0,1,1
S01007669,All households,268,84,26,58,171,13,98,25,52,21,60,49,11,13,7,0,2,4
S01007669,Occupancy rating +2 or more,91,37,11,26,50,10,35,20,7,8,5,4,1,4,2,0,1,1
S01007669,Occupancy rating +1,75,33,9,24,42,2,27,5,15,7,13,6,7,0,0,0,0,0
S01007669,Occupancy rating 0,74,10,5,5,62,0,25,0,20,5,37,34,3,2,1,0,0,1
S01007669,Occupancy rating -1 or less,28,4,1,3,17,1,11,0,10,1,5,5,0,7,4,0,1,2
S01007670,All households,299,96,38,58,185,12,123,32,74,17,50,34,16,18,11,0,0,7
S01007670,Occupancy rating +2 or more,91,31,13,18,57,11,37,26,10,1,9,3,6,3,0,0,0,3
S01007670,Occupancy rating +1,68,16,4,12,50,0,32,2,21,9,18,12,6,2,0,0,0,2
S01007670,Occupancy rating 0,111,44,18,26,63,1,45,4,35,6,17,15,2,4,3,0,0,1
S01007670,Occupancy rating -1 or less,29,5,3,2,15,0,9,0,8,1,6,4,2,9,8,0,0,1
S01007671,All households,289,60,34,26,222,30,181,88,65,28,11,3,8,7,4,0,1,2
S01007671,Occupancy rating +2 or more,200,36,23,13,159,26,128,74,38,16,5,2,3,5,3,0,1,1
S01007671,Occupancy rating +1,66,20,9,11,45,4,37,14,17,6,4,1,3,1,0,0,0,1
S01007671,Occupancy rating 0,18,4,2,2,14,0,13,0,7,6,1,0,1,0,0,0,0,0
S01007671,Occupancy rating -1 or less,5,0,0,0,4,0,3,0,3,0,1,0,1,1,1,0,0,0
S01007672,All households,389,87,66,21,290,85,191,96,60,35,14,4,10,12,4,0,0,8
S01007672,Occupancy rating +2 or more,317,72,58,14,239,80,151,85,39,27,8,3,5,6,2,0,0,4
S01007672,Occupancy rating +1,42,9,6,3,30,5,21,9,7,5,4,0,4,3,1,0,0,2
S01007672,Occupancy rating 0,27,5,2,3,19,0,17,2,12,3,2,1,1,3,1,0,0,2
S01007672,Occupancy rating -1 or less,3,1,0,1,2,0,2,0,2,0,0,0,0,0,0,0,0,0
S01007673,All households,304,81,41,40,215,23,178,86,72,20,14,7,7,8,2,0,0,6
S01007673,Occupancy rating +2 or more,174,42,24,18,127,13,109,62,37,10,5,2,3,5,1,0,0,4
S01007673,Occupancy rating +1,91,33,16,17,56,7,45,20,18,7,4,1,3,2,1,0,0,1
S01007673,Occupancy rating 0,32,5,1,4,26,2,21,4,15,2,3,3,0,1,0,0,0,1
S01007673,Occupancy rating -1 or less,7,1,0,1,6,1,3,0,2,1,2,1,1,0,0,0,0,0
S01007674,All households,376,131,53,78,234,34,153,70,51,32,47,33,14,11,3,0,0,8
S01007674,Occupancy rating +2 or more,149,45,20,25,100,22,69,46,15,8,9,6,3,4,0,0,0,4
S01007674,Occupancy rating +1,122,49,23,26,70,9,46,20,10,16,15,12,3,3,2,0,0,1
S01007674,Occupancy rating 0,84,30,7,23,51,3,31,4,20,7,17,11,6,3,0,0,0,3
S01007674,Occupancy rating -1 or less,21,7,3,4,13,0,7,0,6,1,6,4,2,1,1,0,0,0
S01007675,All households,251,38,20,18,204,35,153,77,45,31,16,12,4,9,3,0,1,5
S01007675,Occupancy rating +2 or more,166,27,14,13,135,30,101,67,17,17,4,1,3,4,1,0,0,3
S01007675,Occupancy rating +1,46,9,5,4,35,4,29,8,17,4,2,2,0,2,2,0,0,0
S01007675,Occupancy rating 0,34,2,1,1,30,1,21,2,9,10,8,7,1,2,0,0,0,2
S01007675,Occupancy rating -1 or less,5,0,0,0,4,0,2,0,2,0,2,2,0,1,0,0,1,0
S01007676,All households,279,70,35,35,202,30,158,65,58,35,14,3,11,7,5,0,0,2
S01007676,Occupancy rating +2 or more,211,54,27,27,155,26,121,59,37,25,8,1,7,2,2,0,0,0
S01007676,Occupancy rating +1,43,14,6,8,27,4,19,4,11,4,4,1,3,2,1,0,0,1
S01007676,Occupancy rating 0,17,1,1,0,14,0,12,1,5,6,2,1,1,2,1,0,0,1
S01007676,Occupancy rating -1 or less,8,1,1,0,6,0,6,1,5,0,0,0,0,1,1,0,0,0
S01007677,All households,201,40,21,19,152,32,102,38,51,13,18,12,6,9,5,0,1,3
S01007677,Occupancy rating +2 or more,136,32,19,13,98,27,67,30,31,6,4,2,2,6,3,0,1,2
S01007677,Occupancy rating +1,39,4,2,2,33,5,20,6,12,2,8,5,3,2,1,0,0,1
S01007677,Occupancy rating 0,21,2,0,2,18,0,14,2,8,4,4,4,0,1,1,0,0,0
S01007677,Occupancy rating -1 or less,5,2,0,2,3,0,1,0,0,1,2,1,1,0,0,0,0,0
S01007678,All households,368,134,82,52,211,39,137,57,58,22,35,20,15,23,4,0,5,14
S01007678,Occupancy rating +2 or more,121,35,26,9,80,19,56,31,19,6,5,1,4,6,0,0,0,6
S01007678,Occupancy rating +1,128,51,28,23,68,12,41,21,13,7,15,11,4,9,1,0,2,6
S01007678,Occupancy rating 0,99,45,26,19,50,8,29,5,16,8,13,8,5,4,1,0,2,1
S01007678,Occupancy rating -1 or less,20,3,2,1,13,0,11,0,10,1,2,0,2,4,2,0,1,1
S01007679,All households,381,123,58,65,240,52,142,67,47,28,46,31,15,18,12,0,2,4
S01007679,Occupancy rating +2 or more,115,34,17,17,81,34,45,29,9,7,2,1,1,0,0,0,0,0
S01007679,Occupancy rating +1,135,50,26,24,83,17,54,35,8,11,12,9,3,2,1,0,0,1
S01007679,Occupancy rating 0,103,36,12,24,59,1,34,3,23,8,24,15,9,8,4,0,2,2
S01007679,Occupancy rating -1 or less,28,3,3,0,17,0,9,0,7,2,8,6,2,8,7,0,0,1
S01007680,All households,386,93,61,32,277,44,212,98,75,39,21,12,9,16,5,0,2,9
S01007680,Occupancy rating +2 or more,271,76,50,26,188,41,141,91,31,19,6,3,3,7,1,0,0,6
S01007680,Occupancy rating +1,78,15,11,4,61,3,49,5,29,15,9,7,2,2,0,0,2,0
S01007680,Occupancy rating 0,27,1,0,1,24,0,20,2,14,4,4,2,2,2,1,0,0,1
S01007680,Occupancy rating -1 or less,10,1,0,1,4,0,2,0,1,1,2,0,2,5,3,0,0,2
S01007681,All households,192,72,36,36,114,22,80,41,19,20,12,3,9,6,1,0,1,4
S01007681,Occupancy rating +2 or more,80,30,14,16,48,9,38,25,8,5,1,0,1,2,1,0,0,1
S01007681,Occupancy rating +1,54,18,11,7,34,5,24,14,4,6,5,1,4,2,0,0,1,1
S01007681,Occupancy rating 0,45,20,10,10,24,6,14,2,5,7,4,1,3,1,0,0,0,1
S01007681,Occupancy rating -1 or less,13,4,1,3,8,2,4,0,2,2,2,1,1,1,0,0,0,1
S01007682,All households,403,122,46,76,257,45,189,94,68,27,23,14,9,24,4,5,3,12
S01007682,Occupancy rating +2 or more,250,70,36,34,175,36,126,67,39,20,13,8,5,5,0,0,2,3
S01007682,Occupancy rating +1,90,28,7,21,55,7,42,23,15,4,6,4,2,7,4,0,1,2
S01007682,Occupancy rating 0,33,7,1,6,18,2,13,2,8,3,3,2,1,8,0,3,0,5
S01007682,Occupancy rating -1 or less,30,17,2,15,9,0,8,2,6,0,1,0,1,4,0,2,0,2
S01007683,All households,301,93,34,59,177,35,126,39,69,18,16,8,8,31,3,13,2,13
S01007683,Occupancy rating +2 or more,149,38,22,16,105,30,70,27,34,9,5,3,2,6,0,2,1,3
S01007683,Occupancy rating +1,76,27,8,19,39,5,30,12,11,7,4,1,3,10,1,6,1,2
S01007683,Occupancy rating 0,54,22,4,18,20,0,16,0,14,2,4,2,2,12,1,4,0,7
S01007683,Occupancy rating -1 or less,22,6,0,6,13,0,10,0,10,0,3,2,1,3,1,1,0,1
S01007684,All households,332,77,49,28,234,60,151,62,66,23,23,10,13,21,7,6,3,5
S01007684,Occupancy rating +2 or more,270,71,48,23,188,56,120,58,42,20,12,3,9,11,2,3,2,4
S01007684,Occupancy rating +1,41,5,0,5,31,4,21,4,15,2,6,4,2,5,2,1,1,1
S01007684,Occupancy rating 0,14,1,1,0,10,0,7,0,7,0,3,2,1,3,1,2,0,0
S01007684,Occupancy rating -1 or less,7,0,0,0,5,0,3,0,2,1,2,1,1,2,2,0,0,0
S01007685,All households,273,68,40,28,193,22,150,73,59,18,21,9,12,12,1,3,0,8
S01007685,Occupancy rating +2 or more,220,55,33,22,161,21,126,64,48,14,14,6,8,4,1,0,0,3
S01007685,Occupancy rating +1,36,10,5,5,22,1,18,7,8,3,3,1,2,4,0,1,0,3
S01007685,Occupancy rating 0,10,3,2,1,5,0,4,2,2,0,1,0,1,2,0,1,0,1
S01007685,Occupancy rating -1 or less,7,0,0,0,5,0,2,0,1,1,3,2,1,2,0,1,0,1
S01007686,All households,320,123,46,77,169,34,120,56,46,18,15,8,7,28,1,12,1,14
S01007686,Occupancy rating +2 or more,180,61,33,28,113,28,79,42,26,11,6,3,3,6,0,1,1,4
S01007686,Occupancy rating +1,76,39,10,29,34,5,23,9,8,6,6,4,2,3,1,0,0,2
S01007686,Occupancy rating 0,49,12,3,9,21,1,17,5,11,1,3,1,2,16,0,10,0,6
S01007686,Occupancy rating -1 or less,15,11,0,11,1,0,1,0,1,0,0,0,0,3,0,1,0,2
S01007687,All households,399,144,52,92,170,22,122,61,49,12,26,17,9,85,5,49,0,31
S01007687,Occupancy rating +2 or more,174,54,30,24,105,17,80,36,35,9,8,5,3,15,3,8,0,4
S01007687,Occupancy rating +1,85,46,16,30,29,5,22,15,5,2,2,0,2,10,1,4,0,5
S01007687,Occupancy rating 0,104,31,3,28,30,0,15,8,7,0,15,11,4,43,0,25,0,18
S01007687,Occupancy rating -1 or less,36,13,3,10,6,0,5,2,2,1,1,1,0,17,1,12,0,4
S01007688,All households,545,252,27,225,175,5,142,103,30,9,28,22,6,118,8,77,0,33
S01007688,Occupancy rating +2 or more,71,16,5,11,39,2,34,20,8,6,3,2,1,16,3,7,0,6
S01007688,Occupancy rating +1,156,86,7,79,54,1,48,42,5,1,5,3,2,16,3,10,0,3
S01007688,Occupancy rating 0,216,100,10,90,60,2,42,29,11,2,16,13,3,56,1,40,0,15
S01007688,Occupancy rating -1 or less,102,50,5,45,22,0,18,12,6,0,4,4,0,30,1,20,0,9
S01007689,All households,288,121,32,89,92,11,69,48,17,4,12,10,2,75,5,51,0,19
S01007689,Occupancy rating +2 or more,45,13,3,10,22,3,16,6,8,2,3,2,1,10,2,6,0,2
S01007689,Occupancy rating +1,76,38,9,29,30,2,28,25,3,0,0,0,0,8,2,4,0,2
S01007689,Occupancy rating 0,127,60,16,44,30,5,19,17,2,0,6,5,1,37,0,25,0,12
S01007689,Occupancy rating -1 or less,40,10,4,6,10,1,6,0,4,2,3,3,0,20,1,16,0,3
S01007690,All households,393,143,30,113,103,8,78,54,16,8,17,14,3,147,9,102,2,34
S01007690,Occupancy rating +2 or more,70,23,6,17,27,3,22,15,5,2,2,2,0,20,4,9,2,5
S01007690,Occupancy rating +1,106,37,8,29,39,4,31,21,6,4,4,3,1,30,2,21,0,7
S01007690,Occupancy rating 0,143,64,13,51,24,0,18,12,5,1,6,5,1,55,1,43,0,11
S01007690,Occupancy rating -1 or less,74,19,3,16,13,1,7,6,0,1,5,4,1,42,2,29,0,11
S01007691,All households,515,227,19,208,122,8,76,56,19,1,38,24,14,166,1,112,0,53
S01007691,Occupancy rating +2 or more,40,16,1,15,18,3,11,7,4,0,4,2,2,6,0,4,0,2
S01007691,Occupancy rating +1,98,53,8,45,27,2,23,23,0,0,2,1,1,18,0,13,0,5
S01007691,Occupancy rating 0,255,125,9,116,57,3,33,24,8,1,21,13,8,73,0,46,0,27
S01007691,Occupancy rating -1 or less,122,33,1,32,20,0,9,2,7,0,11,8,3,69,1,49,0,19
S01007692,All households,434,150,38,112,111,5,83,52,26,5,23,15,8,173,2,123,0,48
S01007692,Occupancy rating +2 or more,40,10,0,10,24,2,19,11,7,1,3,0,3,6,0,4,0,2
S01007692,Occupancy rating +1,102,38,4,34,43,3,37,27,8,2,3,2,1,21,0,11,0,10
S01007692,Occupancy rating 0,218,90,30,60,33,0,20,14,4,2,13,10,3,95,0,73,0,22
S01007692,Occupancy rating -1 or less,74,12,4,8,11,0,7,0,7,0,4,3,1,51,2,35,0,14
S01007693,All households,347,207,11,196,66,1,48,31,15,2,17,10,7,74,2,56,0,16
S01007693,Occupancy rating +2 or more,15,8,0,8,5,0,5,2,1,2,0,0,0,2,0,1,0,1
S01007693,Occupancy rating +1,45,31,3,28,10,1,9,7,2,0,0,0,0,4,0,4,0,0
S01007693,Occupancy rating 0,156,88,4,84,32,0,20,17,3,0,12,8,4,36,0,32,0,4
S01007693,Occupancy rating -1 or less,131,80,4,76,19,0,14,5,9,0,5,2,3,32,2,19,0,11
S01007694,All households,523,238,57,181,156,8,96,60,33,3,52,36,16,129,6,101,2,20
S01007694,Occupancy rating +2 or more,48,15,3,12,20,1,15,6,7,2,4,3,1,13,0,13,0,0
S01007694,Occupancy rating +1,125,45,5,40,41,2,31,25,5,1,8,6,2,39,1,33,0,5
S01007694,Occupancy rating 0,234,120,42,78,64,5,30,21,9,0,29,19,10,50,1,37,1,11
S01007694,Occupancy rating -1 or less,116,58,7,51,31,0,20,8,12,0,11,8,3,27,4,18,1,4
S01007695,All households,614,363,136,227,173,31,110,72,31,7,32,17,15,78,3,45,1,29
S01007695,Occupancy rating +2 or more,58,22,12,10,32,3,26,12,13,1,3,1,2,4,0,2,0,2
S01007695,Occupancy rating +1,190,123,68,55,61,19,37,33,4,0,5,3,2,6,0,4,0,2
S01007695,Occupancy rating 0,284,181,49,132,58,7,36,24,6,6,15,6,9,45,1,26,1,17
S01007695,Occupancy rating -1 or less,82,37,7,30,22,2,11,3,8,0,9,7,2,23,2,13,0,8
S01007696,All households,437,234,33,201,99,6,57,35,19,3,36,31,5,104,6,85,0,13
S01007696,Occupancy rating +2 or more,42,21,6,15,17,2,9,5,4,0,6,5,1,4,1,3,0,0
S01007696,Occupancy rating +1,69,30,4,26,26,0,17,13,3,1,9,7,2,13,0,13,0,0
S01007696,Occupancy rating 0,221,131,18,113,44,4,22,16,5,1,18,17,1,46,0,37,0,9
S01007696,Occupancy rating -1 or less,105,52,5,47,12,0,9,1,7,1,3,2,1,41,5,32,0,4
S01007697,All households,608,351,130,221,192,35,120,80,31,9,37,20,17,65,2,36,0,27
S01007697,Occupancy rating +2 or more,57,26,10,16,28,3,24,14,8,2,1,0,1,3,0,2,0,1
S01007697,Occupancy rating +1,239,160,59,101,74,18,51,47,3,1,5,2,3,5,0,3,0,2
S01007697,Occupancy rating 0,241,123,49,74,72,13,38,17,16,5,21,11,10,46,0,26,0,20
S01007697,Occupancy rating -1 or less,71,42,12,30,18,1,7,2,4,1,10,7,3,11,2,5,0,4
S01007698,All households,589,321,13,308,181,4,118,72,37,9,59,40,19,87,5,50,0,32
S01007698,Occupancy rating +2 or more,45,15,4,11,24,1,15,8,5,2,8,4,4,6,1,3,0,2
S01007698,Occupancy rating +1,114,62,3,59,37,0,32,22,7,3,5,2,3,15,0,11,0,4
S01007698,Occupancy rating 0,256,155,4,151,74,3,51,33,14,4,20,12,8,27,0,13,0,14
S01007698,Occupancy rating -1 or less,174,89,2,87,46,0,20,9,11,0,26,22,4,39,4,23,0,12
S01007699,All households,454,239,20,219,150,5,99,62,29,8,46,34,12,65,2,44,0,19
S01007699,Occupancy rating +2 or more,29,12,4,8,13,2,6,4,1,1,5,3,2,4,1,2,0,1
S01007699,Occupancy rating +1,136,85,11,74,44,3,32,27,3,2,9,6,3,7,1,4,0,2
S01007699,Occupancy rating 0,207,107,5,102,71,0,45,28,13,4,26,20,6,29,0,21,0,8
S01007699,Occupancy rating -1 or less,82,35,0,35,22,0,16,3,12,1,6,5,1,25,0,17,0,8
S01007700,All households,450,172,48,124,248,29,200,104,65,31,19,10,9,30,7,8,1,14
S01007700,Occupancy rating +2 or more,259,75,26,49,174,22,140,79,41,20,12,6,6,10,1,1,0,8
S01007700,Occupancy rating +1,91,44,12,32,43,7,35,21,8,6,1,0,1,4,2,1,0,1
S01007700,Occupancy rating 0,63,35,7,28,20,0,16,3,10,3,4,3,1,8,1,5,0,2
S01007700,Occupancy rating -1 or less,37,18,3,15,11,0,9,1,6,2,2,1,1,8,3,1,1,3
S01007701,All households,318,178,29,149,87,9,43,26,13,4,35,18,17,53,2,36,2,13
S01007701,Occupancy rating +2 or more,26,14,3,11,8,2,5,4,0,1,1,0,1,4,0,3,0,1
S01007701,Occupancy rating +1,93,62,13,49,26,5,19,16,3,0,2,2,0,5,0,4,0,1
S01007701,Occupancy rating 0,147,83,10,73,37,1,14,6,6,2,22,12,10,27,0,21,2,4
S01007701,Occupancy rating -1 or less,52,19,3,16,16,1,5,0,4,1,10,4,6,17,2,8,0,7
S01007702,All households,266,99,1,98,94,6,71,47,20,4,17,14,3,73,7,46,0,20
S01007702,Occupancy rating +2 or more,72,27,1,26,34,5,26,16,8,2,3,3,0,11,1,6,0,4
S01007702,Occupancy rating +1,61,18,0,18,29,1,25,18,7,0,3,1,2,14,1,9,0,4
S01007702,Occupancy rating 0,92,39,0,39,21,0,15,10,3,2,6,5,1,32,2,21,0,9
S01007702,Occupancy rating -1 or less,41,15,0,15,10,0,5,3,2,0,5,5,0,16,3,10,0,3
S01007703,All households,398,170,51,119,182,19,125,70,34,21,38,22,16,46,10,22,0,14
S01007703,Occupancy rating +2 or more,97,26,5,21,63,6,53,36,10,7,4,2,2,8,2,2,0,4
S01007703,Occupancy rating +1,161,96,37,59,54,12,35,24,8,3,7,4,3,11,2,4,0,5
S01007703,Occupancy rating 0,103,37,8,29,50,1,26,8,10,8,23,14,9,16,2,11,0,3
S01007703,Occupancy rating -1 or less,37,11,1,10,15,0,11,2,6,3,4,2,2,11,4,5,0,2
S01007704,All households,517,286,62,224,160,13,70,28,32,10,77,53,24,71,7,31,0,33
S01007704,Occupancy rating +2 or more,35,19,3,16,10,1,9,5,3,1,0,0,0,6,0,2,0,4
S01007704,Occupancy rating +1,166,116,39,77,43,10,24,16,6,2,9,4,5,7,0,3,0,4
S01007704,Occupancy rating 0,219,112,14,98,75,2,28,7,17,4,45,34,11,32,1,14,0,17
S01007704,Occupancy rating -1 or less,97,39,6,33,32,0,9,0,6,3,23,15,8,26,6,12,0,8
S01007705,All households,262,91,1,90,40,0,33,27,4,2,7,5,2,131,3,87,0,41
S01007705,Occupancy rating +2 or more,19,9,0,9,4,0,3,2,0,1,1,0,1,6,0,3,0,3
S01007705,Occupancy rating +1,46,17,1,16,16,0,16,16,0,0,0,0,0,13,0,12,0,1
S01007705,Occupancy rating 0,127,44,0,44,14,0,11,7,3,1,3,2,1,69,2,44,0,23
S01007705,Occupancy rating -1 or less,70,21,0,21,6,0,3,2,1,0,3,3,0,43,1,28,0,14
S01007706,All households,370,126,3,123,63,1,50,43,7,0,12,10,2,181,0,143,0,38
S01007706,Occupancy rating +2 or more,18,6,0,6,6,0,6,4,2,0,0,0,0,6,0,5,0,1
S01007706,Occupancy rating +1,97,52,2,50,20,0,19,18,1,0,1,1,0,25,0,18,0,7
S01007706,Occupancy rating 0,157,33,1,32,29,1,20,18,2,0,8,6,2,95,0,78,0,17
S01007706,Occupancy rating -1 or less,98,35,0,35,8,0,5,3,2,0,3,3,0,55,0,42,0,13
S01007707,All households,465,203,6,197,159,6,133,85,42,6,20,16,4,103,4,49,0,50
S01007707,Occupancy rating +2 or more,78,28,3,25,38,3,29,17,10,2,6,5,1,12,0,7,0,5
S01007707,Occupancy rating +1,108,65,1,64,33,2,30,24,4,2,1,1,0,10,0,6,0,4
S01007707,Occupancy rating 0,192,103,2,101,63,1,57,42,14,1,5,2,3,26,1,11,0,14
S01007707,Occupancy rating -1 or less,87,7,0,7,25,0,17,2,14,1,8,8,0,55,3,25,0,27
S01007708,All households,357,202,42,160,120,12,74,42,22,10,34,25,9,35,8,9,2,16
S01007708,Occupancy rating +2 or more,43,11,4,7,28,8,14,6,7,1,6,4,2,4,1,0,1,2
S01007708,Occupancy rating +1,80,45,6,39,27,3,23,16,3,4,1,1,0,8,1,1,0,6
S01007708,Occupancy rating 0,158,108,25,83,38,1,26,18,4,4,11,10,1,12,2,5,0,5
S01007708,Occupancy rating -1 or less,76,38,7,31,27,0,11,2,8,1,16,10,6,11,4,3,1,3
S01007709,All households,309,179,61,118,92,9,65,40,21,4,18,8,10,38,5,9,0,24
S01007709,Occupancy rating +2 or more,34,17,5,12,14,3,9,8,0,1,2,1,1,3,0,2,0,1
S01007709,Occupancy rating +1,76,50,14,36,20,3,13,13,0,0,4,0,4,6,0,0,0,6
S01007709,Occupancy rating 0,127,71,30,41,42,2,34,19,12,3,6,4,2,14,1,3,0,10
S01007709,Occupancy rating -1 or less,72,41,12,29,16,1,9,0,9,0,6,3,3,15,4,4,0,7
S01007710,All households,450,215,15,200,143,4,94,65,25,4,45,31,14,92,1,57,0,34
S01007710,Occupancy rating +2 or more,20,10,2,8,8,1,6,6,0,0,1,1,0,2,0,1,0,1
S01007710,Occupancy rating +1,127,76,4,72,42,2,36,34,1,1,4,2,2,9,0,5,0,4
S01007710,Occupancy rating 0,219,100,6,94,69,1,39,22,14,3,29,20,9,50,0,31,0,19
S01007710,Occupancy rating -1 or less,84,29,3,26,24,0,13,3,10,0,11,8,3,31,1,20,0,10
S01007711,All households,493,233,59,174,155,14,106,60,27,19,35,22,13,105,4,65,0,36
S01007711,Occupancy rating +2 or more,43,10,1,9,31,4,26,13,7,6,1,0,1,2,0,2,0,0
S01007711,Occupancy rating +1,111,63,12,51,37,4,27,18,2,7,6,2,4,11,0,7,0,4
S01007711,Occupancy rating 0,217,117,41,76,54,4,32,18,12,2,18,12,6,46,2,28,0,16
S01007711,Occupancy rating -1 or less,122,43,5,38,33,2,21,11,6,4,10,8,2,46,2,28,0,16
S01007712,All households,360,187,19,168,103,5,76,50,19,7,22,15,7,70,3,35,0,32
S01007712,Occupancy rating +2 or more,44,21,2,19,20,1,17,12,2,3,2,1,1,3,0,0,0,3
S01007712,Occupancy rating +1,95,49,7,42,33,4,27,20,5,2,2,1,1,13,0,10,0,3
S01007712,Occupancy rating 0,153,77,6,71,39,0,24,14,9,1,15,11,4,37,1,19,0,17
S01007712,Occupancy rating -1 or less,68,40,4,36,11,0,8,4,3,1,3,2,1,17,2,6,0,9
S01007713,All households,229,101,29,72,91,6,63,35,21,7,22,15,7,37,9,11,0,17
S01007713,Occupancy rating +2 or more,44,11,1,10,28,5,21,15,4,2,2,0,2,5,2,0,0,3
S01007713,Occupancy rating +1,67,33,13,20,25,1,19,12,6,1,5,4,1,9,3,1,0,5
S01007713,Occupancy rating 0,97,55,15,40,29,0,18,7,8,3,11,9,2,13,1,7,0,5
S01007713,Occupancy rating -1 or less,21,2,0,2,9,0,5,1,3,1,4,2,2,10,3,3,0,4
S01007714,All households,321,145,42,103,163,7,122,53,48,21,34,21,13,13,4,3,0,6
S01007714,Occupancy rating +2 or more,29,13,0,13,16,0,14,7,4,3,2,2,0,0,0,0,0,0
S01007714,Occupancy rating +1,106,50,8,42,56,4,46,31,8,7,6,2,4,0,0,0,0,0
S01007714,Occupancy rating 0,125,50,14,36,68,0,50,14,27,9,18,11,7,7,1,2,0,4
S01007714,Occupancy rating -1 or less,61,32,20,12,23,3,12,1,9,2,8,6,2,6,3,1,0,2
S01007715,All households,267,124,37,87,115,5,60,27,23,10,50,34,16,28,8,11,1,8
S01007715,Occupancy rating +2 or more,30,11,6,5,16,2,11,6,3,2,3,3,0,3,2,0,0,1
S01007715,Occupancy rating +1,72,38,7,31,32,2,18,13,2,3,12,9,3,2,1,1,0,0
S01007715,Occupancy rating 0,119,59,18,41,49,1,24,8,11,5,24,17,7,11,0,6,1,4
S01007715,Occupancy rating -1 or less,46,16,6,10,18,0,7,0,7,0,11,5,6,12,5,4,0,3
S01007716,All households,598,381,112,269,163,26,96,51,38,7,41,27,14,54,10,24,0,20
S01007716,Occupancy rating +2 or more,39,22,6,16,17,7,9,5,2,2,1,0,1,0,0,0,0,0
S01007716,Occupancy rating +1,113,67,18,49,39,6,27,13,13,1,6,4,2,7,0,2,0,5
S01007716,Occupancy rating 0,325,224,72,152,78,10,46,27,15,4,22,14,8,23,1,14,0,8
S01007716,Occupancy rating -1 or less,121,68,16,52,29,3,14,6,8,0,12,9,3,24,9,8,0,7
S01007717,All households,567,317,81,236,223,15,132,67,50,15,76,62,14,27,4,8,1,14
S01007717,Occupancy rating +2 or more,41,16,5,11,22,2,15,10,3,2,5,3,2,3,0,0,0,3
S01007717,Occupancy rating +1,142,82,13,69,60,7,41,26,8,7,12,8,4,0,0,0,0,0
S01007717,Occupancy rating 0,257,143,47,96,103,5,51,24,23,4,47,39,8,11,1,2,1,7
S01007717,Occupancy rating -1 or less,127,76,16,60,38,1,25,7,16,2,12,12,0,13,3,6,0,4
S01007718,All households,467,300,91,209,138,23,81,59,19,3,34,17,17,29,5,7,0,17
S01007718,Occupancy rating +2 or more,15,7,3,4,6,1,3,3,0,0,2,2,0,2,1,0,0,1
S01007718,Occupancy rating +1,161,113,42,71,46,16,26,23,3,0,4,2,2,2,0,0,0,2
S01007718,Occupancy rating 0,235,154,35,119,68,4,42,30,11,1,22,10,12,13,2,4,0,7
S01007718,Occupancy rating -1 or less,56,26,11,15,18,2,10,3,5,2,6,3,3,12,2,3,0,7
S01007719,All households,651,419,122,297,206,32,122,76,40,6,52,28,24,26,6,3,1,16
S01007719,Occupancy rating +2 or more,35,22,5,17,13,2,11,5,4,2,0,0,0,0,0,0,0,0
S01007719,Occupancy rating +1,211,151,49,102,57,16,38,36,2,0,3,2,1,3,0,1,0,2
S01007719,Occupancy rating 0,338,219,60,159,111,11,62,33,27,2,38,18,20,8,0,1,0,7
S01007719,Occupancy rating -1 or less,67,27,8,19,25,3,11,2,7,2,11,8,3,15,6,1,1,7
S01007720,All households,404,184,87,97,208,57,96,52,26,18,55,26,29,12,1,1,3,7
S01007720,Occupancy rating +2 or more,66,30,13,17,35,12,20,16,3,1,3,2,1,1,0,0,0,1
S01007720,Occupancy rating +1,198,106,51,55,88,38,42,33,6,3,8,2,6,4,0,0,1,3
S01007720,Occupancy rating 0,111,44,20,24,62,5,22,2,11,9,35,18,17,5,0,0,2,3
S01007720,Occupancy rating -1 or less,29,4,3,1,23,2,12,1,6,5,9,4,5,2,1,1,0,0
S01007721,All households,435,237,73,164,182,23,100,52,34,14,59,33,26,16,3,1,1,11
S01007721,Occupancy rating +2 or more,36,15,3,12,21,3,15,12,2,1,3,2,1,0,0,0,0,0
S01007721,Occupancy rating +1,136,77,28,49,59,14,36,26,6,4,9,6,3,0,0,0,0,0
S01007721,Occupancy rating 0,217,131,38,93,77,5,37,14,15,8,35,20,15,9,0,1,1,7
S01007721,Occupancy rating -1 or less,46,14,4,10,25,1,12,0,11,1,12,5,7,7,3,0,0,4
S01007722,All households,548,335,108,227,195,15,102,58,32,12,78,58,20,18,4,5,0,9
S01007722,Occupancy rating +2 or more,28,9,1,8,18,0,12,6,5,1,6,4,2,1,0,1,0,0
S01007722,Occupancy rating +1,155,104,33,71,48,9,33,30,1,2,6,4,2,3,2,1,0,0
S01007722,Occupancy rating 0,287,184,57,127,96,4,43,18,17,8,49,35,14,7,0,2,0,5
S01007722,Occupancy rating -1 or less,78,38,17,21,33,2,14,4,9,1,17,15,2,7,2,1,0,4
S01007723,All households,604,375,169,206,207,28,121,65,46,10,58,33,25,22,7,2,1,12
S01007723,Occupancy rating +2 or more,46,26,13,13,20,1,18,16,2,0,1,0,1,0,0,0,0,0
S01007723,Occupancy rating +1,141,93,42,51,45,7,27,18,7,2,11,7,4,3,0,0,0,3
S01007723,Occupancy rating 0,330,218,93,125,102,17,51,26,20,5,34,23,11,10,4,1,0,5
S01007723,Occupancy rating -1 or less,87,38,21,17,40,3,25,5,17,3,12,3,9,9,3,1,1,4
S01007724,All households,358,175,8,167,148,4,72,43,26,3,72,56,16,35,6,12,0,17
S01007724,Occupancy rating +2 or more,19,13,0,13,6,2,2,2,0,0,2,1,1,0,0,0,0,0
S01007724,Occupancy rating +1,87,42,4,38,41,2,29,25,4,0,10,9,1,4,0,0,0,4
S01007724,Occupancy rating 0,178,93,0,93,69,0,34,14,17,3,35,26,9,16,1,7,0,8
S01007724,Occupancy rating -1 or less,74,27,4,23,32,0,7,2,5,0,25,20,5,15,5,5,0,5
S01007725,All households,498,318,57,261,150,17,90,57,23,10,43,27,16,30,9,5,3,13
S01007725,Occupancy rating +2 or more,20,8,1,7,12,2,9,8,1,0,1,0,1,0,0,0,0,0
S01007725,Occupancy rating +1,164,117,31,86,44,9,31,23,5,3,4,2,2,3,0,1,0,2
S01007725,Occupancy rating 0,239,163,19,144,66,4,33,16,10,7,29,20,9,10,1,2,2,5
S01007725,Occupancy rating -1 or less,75,30,6,24,28,2,17,10,7,0,9,5,4,17,8,2,1,6
S01007726,All households,453,262,36,226,157,14,101,66,30,5,42,31,11,34,6,3,0,25
S01007726,Occupancy rating +2 or more,47,21,6,15,23,7,15,12,2,1,1,1,0,3,0,0,0,3
S01007726,Occupancy rating +1,95,46,4,42,45,3,35,23,10,2,7,5,2,4,0,1,0,3
S01007726,Occupancy rating 0,236,152,21,131,68,4,42,30,11,1,22,19,3,16,2,2,0,12
S01007726,Occupancy rating -1 or less,75,43,5,38,21,0,9,1,7,1,12,6,6,11,4,0,0,7
S01007727,All households,591,340,56,284,189,13,107,69,31,7,69,57,12,62,10,29,0,23
S01007727,Occupancy rating +2 or more,44,21,7,14,21,3,13,7,6,0,5,4,1,2,1,0,0,1
S01007727,Occupancy rating +1,116,74,11,63,38,7,28,27,1,0,3,3,0,4,2,1,0,1
S01007727,Occupancy rating 0,316,195,31,164,93,2,48,30,15,3,43,37,6,28,3,16,0,9
S01007727,Occupancy rating -1 or less,115,50,7,43,37,1,18,5,9,4,18,13,5,28,4,12,0,12
S01007728,All households,414,232,17,215,150,5,104,68,31,5,41,30,11,32,1,14,0,17
S01007728,Occupancy rating +2 or more,20,6,1,5,13,0,11,7,4,0,2,1,1,1,0,0,0,1
S01007728,Occupancy rating +1,97,59,8,51,37,2,29,23,4,2,6,2,4,1,0,0,0,1
S01007728,Occupancy rating 0,208,126,8,118,69,2,45,32,11,2,22,18,4,13,0,8,0,5
S01007728,Occupancy rating -1 or less,89,41,0,41,31,1,19,6,12,1,11,9,2,17,1,6,0,10
S01007729,All households,439,226,21,205,170,3,119,82,28,9,48,41,7,43,8,19,0,16
S01007729,Occupancy rating +2 or more,40,18,2,16,21,0,20,17,1,2,1,1,0,1,0,0,0,1
S01007729,Occupancy rating +1,100,57,7,50,36,2,29,23,4,2,5,4,1,7,1,2,0,4
S01007729,Occupancy rating 0,201,112,9,103,72,1,48,33,12,3,23,22,1,17,1,8,0,8
S01007729,Occupancy rating -1 or less,98,39,3,36,41,0,22,9,11,2,19,14,5,18,6,9,0,3
S01007730,All households,464,243,22,221,181,5,129,94,30,5,47,36,11,40,4,10,0,26
S01007730,Occupancy rating +2 or more,23,12,4,8,10,1,8,5,2,1,1,0,1,1,0,0,0,1
S01007730,Occupancy rating +1,126,71,9,62,49,2,45,44,1,0,2,2,0,6,0,2,0,4
S01007730,Occupancy rating 0,252,134,9,125,94,2,63,41,18,4,29,24,5,24,0,7,0,17
S01007730,Occupancy rating -1 or less,63,26,0,26,28,0,13,4,9,0,15,10,5,9,4,1,0,4
S01007731,All households,396,199,29,170,167,4,116,67,37,12,47,36,11,30,5,6,0,19
S01007731,Occupancy rating +2 or more,47,22,6,16,24,2,21,18,3,0,1,0,1,1,1,0,0,0
S01007731,Occupancy rating +1,109,52,7,45,51,2,38,27,7,4,11,8,3,6,0,1,0,5
S01007731,Occupancy rating 0,183,103,14,89,68,0,44,19,18,7,24,19,5,12,0,2,0,10
S01007731,Occupancy rating -1 or less,57,22,2,20,24,0,13,3,9,1,11,9,2,11,4,3,0,4
S01007732,All households,374,177,44,133,140,7,96,63,26,7,37,26,11,57,5,20,1,31
S01007732,Occupancy rating +2 or more,38,10,3,7,22,1,19,15,3,1,2,2,0,6,1,1,0,4
S01007732,Occupancy rating +1,110,55,13,42,45,6,36,29,5,2,3,1,2,10,0,4,0,6
S01007732,Occupancy rating 0,181,97,27,70,56,0,38,19,15,4,18,14,4,28,1,11,1,15
S01007732,Occupancy rating -1 or less,45,15,1,14,17,0,3,0,3,0,14,9,5,13,3,4,0,6
S01007733,All households,338,92,23,69,220,26,173,75,76,22,21,12,9,26,16,1,0,9
S01007733,Occupancy rating +2 or more,202,45,16,29,147,18,123,55,50,18,6,1,5,10,6,0,0,4
S01007733,Occupancy rating +1,73,28,4,24,38,5,31,16,12,3,2,0,2,7,6,0,0,1
S01007733,Occupancy rating 0,46,13,1,12,26,3,11,2,8,1,12,10,2,7,2,1,0,4
S01007733,Occupancy rating -1 or less,17,6,2,4,9,0,8,2,6,0,1,1,0,2,2,0,0,0
S01007734,All households,384,122,72,50,251,48,177,86,54,37,26,14,12,11,3,0,0,8
S01007734,Occupancy rating +2 or more,233,72,48,24,157,35,115,62,26,27,7,2,5,4,2,0,0,2
S01007734,Occupancy rating +1,89,40,18,22,48,11,31,18,8,5,6,2,4,1,1,0,0,0
S01007734,Occupancy rating 0,51,9,5,4,39,2,27,5,17,5,10,7,3,3,0,0,0,3
S01007734,Occupancy rating -1 or less,11,1,1,0,7,0,4,1,3,0,3,3,0,3,0,0,0,3
S01007735,All households,359,105,48,57,237,41,170,90,56,24,26,17,9,17,10,0,0,7
S01007735,Occupancy rating +2 or more,205,50,32,18,149,28,111,70,26,15,10,5,5,6,3,0,0,3
S01007735,Occupancy rating +1,68,18,11,7,45,12,30,9,17,4,3,3,0,5,3,0,0,2
S01007735,Occupancy rating 0,66,27,4,23,37,1,24,11,8,5,12,8,4,2,1,0,0,1
S01007735,Occupancy rating -1 or less,20,10,1,9,6,0,5,0,5,0,1,1,0,4,3,0,0,1
S01007736,All households,309,92,39,53,200,40,136,57,54,25,24,17,7,17,7,1,1,8
S01007736,Occupancy rating +2 or more,145,38,25,13,102,26,72,33,24,15,4,3,1,5,2,0,0,3
S01007736,Occupancy rating +1,69,25,10,15,42,11,25,10,12,3,6,3,3,2,0,0,0,2
S01007736,Occupancy rating 0,75,23,3,20,44,3,31,13,12,6,10,7,3,8,3,1,1,3
S01007736,Occupancy rating -1 or less,20,6,1,5,12,0,8,1,6,1,4,4,0,2,2,0,0,0
S01007737,All households,554,252,117,135,279,40,168,84,54,30,71,52,19,23,11,1,1,10
S01007737,Occupancy rating +2 or more,87,19,4,15,66,4,60,27,25,8,2,2,0,2,2,0,0,0
S01007737,Occupancy rating +1,276,186,93,93,85,28,56,43,7,6,1,1,0,5,1,0,0,4
S01007737,Occupancy rating 0,149,40,19,21,104,6,40,12,13,15,58,42,16,5,1,1,0,3
S01007737,Occupancy rating -1 or less,42,7,1,6,24,2,12,2,9,1,10,7,3,11,7,0,1,3
S01007738,All households,358,127,74,53,224,58,130,57,50,23,36,23,13,7,2,0,1,4
S01007738,Occupancy rating +2 or more,138,51,32,19,84,30,50,31,13,6,4,2,2,3,1,0,0,2
S01007738,Occupancy rating +1,142,65,36,29,76,25,39,22,6,11,12,6,6,1,0,0,1,0
S01007738,Occupancy rating 0,68,9,5,4,56,1,38,4,29,5,17,13,4,3,1,0,0,2
S01007738,Occupancy rating -1 or less,10,2,1,1,8,2,3,0,2,1,3,2,1,0,0,0,0,0
S01007739,All households,347,180,118,62,161,53,82,42,26,14,26,16,10,6,1,0,2,3
S01007739,Occupancy rating +2 or more,47,13,8,5,33,8,24,11,8,5,1,1,0,1,0,0,0,1
S01007739,Occupancy rating +1,176,100,73,27,75,34,40,30,5,5,1,1,0,1,1,0,0,0
S01007739,Occupancy rating 0,95,56,30,26,38,8,14,1,9,4,16,7,9,1,0,0,1,0
S01007739,Occupancy rating -1 or less,29,11,7,4,15,3,4,0,4,0,8,7,1,3,0,0,1,2
S01007740,All households,265,105,36,69,155,26,99,44,37,18,30,16,14,5,2,0,0,3
S01007740,Occupancy rating +2 or more,107,33,13,20,71,16,48,28,11,9,7,3,4,3,0,0,0,3
S01007740,Occupancy rating +1,86,39,13,26,47,7,31,12,13,6,9,5,4,0,0,0,0,0
S01007740,Occupancy rating 0,56,24,8,16,32,3,18,4,12,2,11,6,5,0,0,0,0,0
S01007740,Occupancy rating -1 or less,16,9,2,7,5,0,2,0,1,1,3,2,1,2,2,0,0,0
S01007741,All households,435,240,140,100,179,47,96,35,43,18,36,22,14,16,2,2,3,9
S01007741,Occupancy rating +2 or more,78,34,18,16,41,14,25,11,11,3,2,1,1,3,0,1,1,1
S01007741,Occupancy rating +1,147,73,45,28,69,24,37,21,9,7,8,6,2,5,0,0,0,5
S01007741,Occupancy rating 0,154,99,53,46,53,8,26,3,16,7,19,9,10,2,0,0,0,2
S01007741,Occupancy rating -1 or less,56,34,24,10,16,1,8,0,7,1,7,6,1,6,2,1,2,1
S01007742,All households,328,140,78,62,168,27,95,51,31,13,46,25,21,20,7,0,4,9
S01007742,Occupancy rating +2 or more,104,32,23,9,68,12,50,33,12,5,6,3,3,4,0,0,2,2
S01007742,Occupancy rating +1,122,65,35,30,53,14,28,15,7,6,11,4,7,4,1,0,0,3
S01007742,Occupancy rating 0,82,38,18,20,38,1,14,3,9,2,23,15,8,6,1,0,1,4
S01007742,Occupancy rating -1 or less,20,5,2,3,9,0,3,0,3,0,6,3,3,6,5,0,1,0
S01007743,All households,457,201,58,143,241,20,134,51,60,23,87,60,27,15,3,0,0,12
S01007743,Occupancy rating +2 or more,42,15,7,8,23,6,16,11,3,2,1,1,0,4,1,0,0,3
S01007743,Occupancy rating +1,169,94,31,63,73,10,54,36,10,8,9,5,4,2,0,0,0,2
S01007743,Occupancy rating 0,196,75,18,57,116,2,53,3,39,11,61,45,16,5,1,0,0,4
S01007743,Occupancy rating -1 or less,50,17,2,15,29,2,11,1,8,2,16,9,7,4,1,0,0,3
S01007744,All households,403,190,90,100,191,22,86,40,32,14,83,62,21,22,12,0,1,9
S01007744,Occupancy rating +2 or more,79,31,21,10,45,13,26,19,4,3,6,1,5,3,2,0,0,1
S01007744,Occupancy rating +1,107,68,14,54,35,3,22,12,7,3,10,5,5,4,1,0,0,3
S01007744,Occupancy rating 0,156,75,45,30,76,5,26,8,12,6,45,39,6,5,2,0,0,3
S01007744,Occupancy rating -1 or less,61,16,10,6,35,1,12,1,9,2,22,17,5,10,7,0,1,2
S01007745,All households,378,202,78,124,165,13,90,40,39,11,62,36,26,11,2,1,1,7
S01007745,Occupancy rating +2 or more,45,15,8,7,30,3,20,14,4,2,7,4,3,0,0,0,0,0
S01007745,Occupancy rating +1,126,86,29,57,40,7,26,17,7,2,7,4,3,0,0,0,0,0
S01007745,Occupancy rating 0,170,84,32,52,79,3,41,8,26,7,35,26,9,7,1,1,1,4
S01007745,Occupancy rating -1 or less,37,17,9,8,16,0,3,1,2,0,13,2,11,4,1,0,0,3
S01007746,All households,409,131,39,92,253,24,153,71,59,23,76,55,21,25,13,0,0,12
S01007746,Occupancy rating +2 or more,94,28,9,19,63,16,43,37,4,2,4,3,1,3,1,0,0,2
S01007746,Occupancy rating +1,150,72,20,52,71,7,52,31,13,8,12,8,4,7,2,0,0,5
S01007746,Occupancy rating 0,116,21,8,13,85,0,40,3,25,12,45,33,12,10,6,0,0,4
S01007746,Occupancy rating -1 or less,49,10,2,8,34,1,18,0,17,1,15,11,4,5,4,0,0,1
S01007747,All households,242,79,27,52,155,14,83,31,37,15,58,38,20,8,1,0,0,7
S01007747,Occupancy rating +2 or more,40,22,9,13,18,4,13,9,4,0,1,0,1,0,0,0,0,0
S01007747,Occupancy rating +1,92,43,16,27,48,8,33,22,5,6,7,4,3,1,0,0,0,1
S01007747,Occupancy rating 0,81,12,2,10,63,2,26,0,19,7,35,26,9,6,0,0,0,6
S01007747,Occupancy rating -1 or less,29,2,0,2,26,0,11,0,9,2,15,8,7,1,1,0,0,0
S01007748,All households,369,167,44,123,192,14,85,30,39,16,93,69,24,10,6,1,0,3
S01007748,Occupancy rating +2 or more,39,19,9,10,20,3,13,11,2,0,4,3,1,0,0,0,0,0
S01007748,Occupancy rating +1,142,93,10,83,49,4,26,16,4,6,19,12,7,0,0,0,0,0
S01007748,Occupancy rating 0,149,41,20,21,104,5,44,3,32,9,55,40,15,4,1,0,0,3
S01007748,Occupancy rating -1 or less,39,14,5,9,19,2,2,0,1,1,15,14,1,6,5,1,0,0
S01007749,All households,281,52,32,20,220,32,165,78,57,30,23,18,5,9,3,1,0,5
S01007749,Occupancy rating +2 or more,195,45,27,18,148,29,112,66,31,15,7,4,3,2,1,0,0,1
S01007749,Occupancy rating +1,56,5,4,1,47,3,34,9,15,10,10,9,1,4,2,0,0,2
S01007749,Occupancy rating 0,23,2,1,1,20,0,14,3,9,2,6,5,1,1,0,1,0,0
S01007749,Occupancy rating -1 or less,7,0,0,0,5,0,5,0,2,3,0,0,0,2,0,0,0,2
S01007750,All households,358,103,72,31,245,71,150,68,44,38,24,16,8,10,4,0,0,6
S01007750,Occupancy rating +2 or more,275,75,50,25,194,62,121,61,29,31,11,6,5,6,3,0,0,3
S01007750,Occupancy rating +1,62,24,18,6,36,8,18,7,7,4,10,7,3,2,1,0,0,1
S01007750,Occupancy rating 0,16,4,4,0,11,1,8,0,6,2,2,2,0,1,0,0,0,1
S01007750,Occupancy rating -1 or less,5,0,0,0,4,0,3,0,2,1,1,1,0,1,0,0,0,1
S01007751,All households,337,111,77,34,212,59,137,66,49,22,16,6,10,14,6,1,1,6
S01007751,Occupancy rating +2 or more,243,75,55,20,162,47,106,54,35,17,9,1,8,6,2,1,0,3
S01007751,Occupancy rating +1,62,31,19,12,29,9,17,9,6,2,3,3,0,2,2,0,0,0
S01007751,Occupancy rating 0,23,4,3,1,15,1,10,3,6,1,4,2,2,4,2,0,1,1
S01007751,Occupancy rating -1 or less,9,1,0,1,6,2,4,0,2,2,0,0,0,2,0,0,0,2
S01007752,All households,356,155,126,29,191,62,111,47,45,19,18,6,12,10,7,0,2,1
S01007752,Occupancy rating +2 or more,162,42,25,17,116,35,76,34,28,14,5,3,2,4,3,0,0,1
S01007752,Occupancy rating +1,76,38,29,9,37,6,24,10,11,3,7,1,6,1,1,0,0,0
S01007752,Occupancy rating 0,103,69,66,3,30,16,10,3,5,2,4,2,2,4,2,0,2,0
S01007752,Occupancy rating -1 or less,15,6,6,0,8,5,1,0,1,0,2,0,2,1,1,0,0,0
S01007753,All households,241,72,30,42,158,11,93,37,41,15,54,40,14,11,3,0,2,6
S01007753,Occupancy rating +2 or more,46,20,8,12,22,2,16,10,5,1,4,1,3,4,0,0,1,3
S01007753,Occupancy rating +1,94,42,19,23,50,7,33,19,9,5,10,6,4,2,0,0,0,2
S01007753,Occupancy rating 0,71,8,3,5,61,2,28,6,19,3,31,26,5,2,1,0,1,0
S01007753,Occupancy rating -1 or less,30,2,0,2,25,0,16,2,8,6,9,7,2,3,2,0,0,1
S01007754,All households,414,154,73,81,239,22,128,51,56,21,89,56,33,21,14,0,1,6
S01007754,Occupancy rating +2 or more,76,30,20,10,44,11,27,26,1,0,6,3,3,2,1,0,1,0
S01007754,Occupancy rating +1,137,58,21,37,74,6,39,17,13,9,29,14,15,5,4,0,0,1
S01007754,Occupancy rating 0,167,58,29,29,101,5,51,7,35,9,45,32,13,8,4,0,0,4
S01007754,Occupancy rating -1 or less,34,8,3,5,20,0,11,1,7,3,9,7,2,6,5,0,0,1
S01007755,All households,417,153,94,59,248,26,126,51,48,27,96,77,19,16,9,0,0,7
S01007755,Occupancy rating +2 or more,59,23,13,10,36,11,19,12,6,1,6,4,2,0,0,0,0,0
S01007755,Occupancy rating +1,117,49,17,32,66,6,43,28,5,10,17,11,6,2,0,0,0,2
S01007755,Occupancy rating 0,186,62,47,15,115,8,46,10,25,11,61,53,8,9,5,0,0,4
S01007755,Occupancy rating -1 or less,55,19,17,2,31,1,18,1,12,5,12,9,3,5,4,0,0,1
S01007756,All households,298,111,51,60,175,22,82,33,33,16,71,53,18,12,6,0,1,5
S01007756,Occupancy rating +2 or more,44,18,8,10,26,6,17,13,2,2,3,2,1,0,0,0,0,0
S01007756,Occupancy rating +1,93,40,13,27,52,10,25,12,8,5,17,13,4,1,0,0,0,1
S01007756,Occupancy rating 0,125,45,27,18,75,6,31,8,16,7,38,26,12,5,3,0,1,1
S01007756,Occupancy rating -1 or less,36,8,3,5,22,0,9,0,7,2,13,12,1,6,3,0,0,3
S01007757,All households,371,97,69,28,267,75,174,72,79,23,18,7,11,7,1,0,2,4
S01007757,Occupancy rating +2 or more,268,71,54,17,193,64,118,57,46,15,11,5,6,4,0,0,2,2
S01007757,Occupancy rating +1,82,24,13,11,58,11,44,14,23,7,3,0,3,0,0,0,0,0
S01007757,Occupancy rating 0,13,2,2,0,11,0,8,1,7,0,3,1,2,0,0,0,0,0
S01007757,Occupancy rating -1 or less,8,0,0,0,5,0,4,0,3,1,1,1,0,3,1,0,0,2
S01007758,All households,468,199,106,93,259,84,157,84,59,14,18,8,10,10,5,0,3,2
S01007758,Occupancy rating +2 or more,280,97,56,41,179,65,109,56,45,8,5,3,2,4,1,0,1,2
S01007758,Occupancy rating +1,110,62,39,23,47,15,28,16,8,4,4,3,1,1,1,0,0,0
S01007758,Occupancy rating 0,67,36,10,26,28,4,17,12,4,1,7,1,6,3,1,0,2,0
S01007758,Occupancy rating -1 or less,11,4,1,3,5,0,3,0,2,1,2,1,1,2,2,0,0,0
S01007759,All households,618,372,144,228,230,36,139,105,28,6,55,40,15,16,4,1,1,10
S01007759,Occupancy rating +2 or more,101,43,19,24,55,11,39,31,6,2,5,2,3,3,0,0,0,3
S01007759,Occupancy rating +1,199,127,50,77,71,13,51,39,11,1,7,4,3,1,0,0,0,1
S01007759,Occupancy rating 0,232,150,59,91,74,9,39,28,9,2,26,22,4,8,2,0,1,5
S01007759,Occupancy rating -1 or less,86,52,16,36,30,3,10,7,2,1,17,12,5,4,2,1,0,1
S01007760,All households,262,73,43,30,184,45,119,58,44,17,20,12,8,5,3,0,0,2
S01007760,Occupancy rating +2 or more,190,41,27,14,147,37,101,50,38,13,9,5,4,2,2,0,0,0
S01007760,Occupancy rating +1,51,24,12,12,27,7,15,8,4,3,5,3,2,0,0,0,0,0
S01007760,Occupancy rating 0,17,7,4,3,7,1,2,0,1,1,4,2,2,3,1,0,0,2
S01007760,Occupancy rating -1 or less,4,1,0,1,3,0,1,0,1,0,2,2,0,0,0,0,0,0
S01007761,All households,383,112,54,58,255,53,170,88,59,23,32,21,11,16,7,0,1,8
S01007761,Occupancy rating +2 or more,255,68,40,28,183,44,127,68,40,19,12,8,4,4,0,0,0,4
S01007761,Occupancy rating +1,71,27,10,17,39,3,31,16,11,4,5,3,2,5,4,0,0,1
S01007761,Occupancy rating 0,42,13,3,10,24,5,8,4,4,0,11,7,4,5,2,0,1,2
S01007761,Occupancy rating -1 or less,15,4,1,3,9,1,4,0,4,0,4,3,1,2,1,0,0,1
S01007762,All households,474,282,133,149,182,19,128,85,34,9,35,26,9,10,2,0,3,5
S01007762,Occupancy rating +2 or more,108,41,17,24,66,10,52,39,10,3,4,1,3,1,1,0,0,0
S01007762,Occupancy rating +1,136,86,49,37,50,6,36,26,8,2,8,6,2,0,0,0,0,0
S01007762,Occupancy rating 0,177,116,51,65,54,3,36,19,14,3,15,11,4,7,1,0,2,4
S01007762,Occupancy rating -1 or less,53,39,16,23,12,0,4,1,2,1,8,8,0,2,0,0,1,1
S01007763,All households,329,191,130,61,131,44,64,28,27,9,23,14,9,7,2,0,2,3
S01007763,Occupancy rating +2 or more,56,21,11,10,34,8,22,15,6,1,4,2,2,1,0,0,0,1
S01007763,Occupancy rating +1,132,80,54,26,51,24,22,10,8,4,5,2,3,1,0,0,0,1
S01007763,Occupancy rating 0,97,60,49,11,35,8,15,2,9,4,12,8,4,2,0,0,1,1
S01007763,Occupancy rating -1 or less,44,30,16,14,11,4,5,1,4,0,2,2,0,3,2,0,1,0
S01007764,All households,310,69,31,38,229,34,159,58,69,32,36,23,13,12,4,1,0,7
S01007764,Occupancy rating +2 or more,198,43,22,21,148,33,101,51,35,15,14,9,5,7,1,0,0,6
S01007764,Occupancy rating +1,74,12,5,7,59,1,42,4,25,13,16,9,7,3,2,0,0,1
S01007764,Occupancy rating 0,31,10,4,6,19,0,14,2,8,4,5,4,1,2,1,1,0,0
S01007764,Occupancy rating -1 or less,7,4,0,4,3,0,2,1,1,0,1,1,0,0,0,0,0,0
S01007765,All households,308,86,58,28,219,54,139,55,62,22,26,14,12,3,0,0,0,3
S01007765,Occupancy rating +2 or more,232,63,45,18,168,50,107,52,38,17,11,5,6,1,0,0,0,1
S01007765,Occupancy rating +1,55,19,11,8,34,3,24,2,18,4,7,6,1,2,0,0,0,2
S01007765,Occupancy rating 0,17,3,1,2,14,1,8,1,6,1,5,2,3,0,0,0,0,0
S01007765,Occupancy rating -1 or less,4,1,1,0,3,0,0,0,0,0,3,1,2,0,0,0,0,0
S01007766,All households,382,95,67,28,273,66,185,65,79,41,22,14,8,14,6,1,1,6
S01007766,Occupancy rating +2 or more,288,78,56,22,205,56,133,60,45,28,16,8,8,5,1,0,0,4
S01007766,Occupancy rating +1,62,14,8,6,45,10,33,4,22,7,2,2,0,3,3,0,0,0
S01007766,Occupancy rating 0,28,3,3,0,21,0,17,1,10,6,4,4,0,4,1,0,1,2
S01007766,Occupancy rating -1 or less,4,0,0,0,2,0,2,0,2,0,0,0,0,2,1,1,0,0
S01007767,All households,398,116,61,55,274,62,182,84,68,30,30,11,19,8,5,0,0,3
S01007767,Occupancy rating +2 or more,243,60,36,24,180,52,118,63,37,18,10,3,7,3,2,0,0,1
S01007767,Occupancy rating +1,103,37,21,16,64,9,43,15,18,10,12,6,6,2,0,0,0,2
S01007767,Occupancy rating 0,43,16,3,13,27,1,20,6,12,2,6,1,5,0,0,0,0,0
S01007767,Occupancy rating -1 or less,9,3,1,2,3,0,1,0,1,0,2,1,1,3,3,0,0,0
S01007768,All households,356,172,80,92,167,34,108,57,40,11,25,14,11,17,3,1,1,12
S01007768,Occupancy rating +2 or more,132,43,15,28,84,22,57,31,20,6,5,1,4,5,0,0,1,4
S01007768,Occupancy rating +1,114,67,27,40,42,10,30,19,8,3,2,2,0,5,1,1,0,3
S01007768,Occupancy rating 0,87,50,32,18,33,1,17,5,10,2,15,9,6,4,0,0,0,4
S01007768,Occupancy rating -1 or less,23,12,6,6,8,1,4,2,2,0,3,2,1,3,2,0,0,1
S01007769,All households,325,93,51,42,223,60,142,72,50,20,21,12,9,9,2,0,1,6
S01007769,Occupancy rating +2 or more,233,55,33,22,174,50,115,67,37,11,9,5,4,4,1,0,0,3
S01007769,Occupancy rating +1,52,25,13,12,26,8,14,5,6,3,4,2,2,1,0,0,0,1
S01007769,Occupancy rating 0,30,9,3,6,18,1,12,0,7,5,5,2,3,3,0,0,1,2
S01007769,Occupancy rating -1 or less,10,4,2,2,5,1,1,0,0,1,3,3,0,1,1,0,0,0
S01007770,All households,318,69,46,23,237,61,137,61,55,21,39,23,16,12,7,0,0,5
S01007770,Occupancy rating +2 or more,223,43,33,10,171,52,104,50,34,20,15,6,9,9,4,0,0,5
S01007770,Occupancy rating +1,61,23,11,12,36,6,22,8,14,0,8,4,4,2,2,0,0,0
S01007770,Occupancy rating 0,30,3,2,1,27,3,9,3,6,0,15,12,3,0,0,0,0,0
S01007770,Occupancy rating -1 or less,4,0,0,0,3,0,2,0,1,1,1,1,0,1,1,0,0,0
S01007771,All households,235,54,42,12,173,46,108,49,43,16,19,9,10,8,2,1,0,5
S01007771,Occupancy rating +2 or more,197,47,39,8,145,43,90,43,34,13,12,4,8,5,1,0,0,4
S01007771,Occupancy rating +1,25,5,2,3,20,3,13,5,7,1,4,3,1,0,0,0,0,0
S01007771,Occupancy rating 0,10,2,1,1,7,0,4,1,2,1,3,2,1,1,0,1,0,0
S01007771,Occupancy rating -1 or less,3,0,0,0,1,0,1,0,0,1,0,0,0,2,1,0,0,1
S01007772,All households,546,274,120,154,253,54,138,62,54,22,61,34,27,19,5,0,3,11
S01007772,Occupancy rating +2 or more,109,43,26,17,65,17,38,21,11,6,10,5,5,1,0,0,0,1
S01007772,Occupancy rating +1,186,97,56,41,85,29,40,23,12,5,16,7,9,4,3,0,0,1
S01007772,Occupancy rating 0,205,117,32,85,80,8,51,16,26,9,21,14,7,8,0,0,2,6
S01007772,Occupancy rating -1 or less,46,17,6,11,23,0,9,2,5,2,14,8,6,6,2,0,1,3
S01007773,All households,314,61,38,23,248,46,182,88,61,33,20,10,10,5,3,0,0,2
S01007773,Occupancy rating +2 or more,224,48,29,19,173,40,125,80,26,19,8,3,5,3,2,0,0,1
S01007773,Occupancy rating +1,57,11,7,4,46,5,36,7,22,7,5,2,3,0,0,0,0,0
S01007773,Occupancy rating 0,29,2,2,0,26,1,19,1,13,5,6,4,2,1,1,0,0,0
S01007773,Occupancy rating -1 or less,4,0,0,0,3,0,2,0,0,2,1,1,0,1,0,0,0,1
S01007774,All households,323,24,3,21,290,6,247,76,150,21,37,33,4,9,4,0,0,5
S01007774,Occupancy rating +2 or more,265,18,2,16,241,5,218,72,127,19,18,15,3,6,3,0,0,3
S01007774,Occupancy rating +1,36,5,0,5,30,1,20,4,15,1,9,9,0,1,1,0,0,0
S01007774,Occupancy rating 0,20,1,1,0,17,0,8,0,7,1,9,8,1,2,0,0,0,2
S01007774,Occupancy rating -1 or less,2,0,0,0,2,0,1,0,1,0,1,1,0,0,0,0,0,0
S01007775,All households,346,95,36,59,245,14,206,81,100,25,25,19,6,6,3,0,0,3
S01007775,Occupancy rating +2 or more,195,49,22,27,144,9,125,55,52,18,10,8,2,2,1,0,0,1
S01007775,Occupancy rating +1,107,41,13,28,66,5,55,26,24,5,6,4,2,0,0,0,0,0
S01007775,Occupancy rating 0,36,4,1,3,30,0,21,0,19,2,9,7,2,2,1,0,0,1
S01007775,Occupancy rating -1 or less,8,1,0,1,5,0,5,0,5,0,0,0,0,2,1,0,0,1
S01007776,All households,282,73,29,44,204,13,169,52,92,25,22,16,6,5,4,0,0,1
S01007776,Occupancy rating +2 or more,188,37,18,19,148,11,132,45,69,18,5,4,1,3,2,0,0,1
S01007776,Occupancy rating +1,66,36,11,25,29,2,23,7,11,5,4,1,3,1,1,0,0,0
S01007776,Occupancy rating 0,21,0,0,0,20,0,11,0,9,2,9,7,2,1,1,0,0,0
S01007776,Occupancy rating -1 or less,7,0,0,0,7,0,3,0,3,0,4,4,0,0,0,0,0,0
S01007777,All households,314,34,7,27,274,6,244,50,167,27,24,22,2,6,6,0,0,0
S01007777,Occupancy rating +2 or more,238,29,6,23,205,5,189,43,125,21,11,10,1,4,4,0,0,0
S01007777,Occupancy rating +1,52,5,1,4,46,0,39,7,29,3,7,7,0,1,1,0,0,0
S01007777,Occupancy rating 0,22,0,0,0,22,1,15,0,12,3,6,5,1,0,0,0,0,0
S01007777,Occupancy rating -1 or less,2,0,0,0,1,0,1,0,1,0,0,0,0,1,1,0,0,0
S01007778,All households,155,17,8,9,135,4,126,42,73,11,5,2,3,3,2,0,0,1
S01007778,Occupancy rating +2 or more,140,12,6,6,125,4,116,40,66,10,5,2,3,3,2,0,0,1
S01007778,Occupancy rating +1,10,2,2,0,8,0,8,2,5,1,0,0,0,0,0,0,0,0
S01007778,Occupancy rating 0,3,1,0,1,2,0,2,0,2,0,0,0,0,0,0,0,0,0
S01007778,Occupancy rating -1 or less,2,2,0,2,0,0,0,0,0,0,0,0,0,0,0,0,0,0
S01007779,All households,311,78,28,50,224,23,170,82,51,37,31,17,14,9,5,0,0,4
S01007779,Occupancy rating +2 or more,122,19,4,15,98,15,76,54,13,9,7,5,2,5,2,0,0,3
S01007779,Occupancy rating +1,105,26,14,12,77,7,61,25,21,15,9,4,5,2,1,0,0,1
S01007779,Occupancy rating 0,69,28,8,20,41,1,28,2,15,11,12,6,6,0,0,0,0,0
S01007779,Occupancy rating -1 or less,15,5,2,3,8,0,5,1,2,2,3,2,1,2,2,0,0,0
S01007780,All households,331,88,17,71,228,15,194,86,85,23,19,15,4,15,10,0,0,5
S01007780,Occupancy rating +2 or more,132,28,4,24,100,7,86,47,33,6,7,5,2,4,4,0,0,0
S01007780,Occupancy rating +1,93,24,8,16,67,4,60,29,24,7,3,3,0,2,0,0,0,2
S01007780,Occupancy rating 0,90,31,3,28,54,3,42,9,26,7,9,7,2,5,3,0,0,2
S01007780,Occupancy rating -1 or less,16,5,2,3,7,1,6,1,2,3,0,0,0,4,3,0,0,1
S01007781,All households,381,96,23,73,270,13,215,94,88,33,42,28,14,15,9,0,0,6
S01007781,Occupancy rating +2 or more,149,35,10,25,111,7,92,46,36,10,12,9,3,3,0,0,0,3
S01007781,Occupancy rating +1,118,28,4,24,85,5,69,34,22,13,11,5,6,5,2,0,0,3
S01007781,Occupancy rating 0,95,22,7,15,68,1,51,13,28,10,16,12,4,5,5,0,0,0
S01007781,Occupancy rating -1 or less,19,11,2,9,6,0,3,1,2,0,3,2,1,2,2,0,0,0
S01007782,All households,239,109,20,89,121,4,80,33,37,10,37,31,6,9,3,2,0,4
S01007782,Occupancy rating +2 or more,40,23,8,15,16,0,16,11,4,1,0,0,0,1,0,1,0,0
S01007782,Occupancy rating +1,70,26,7,19,43,3,26,16,6,4,14,13,1,1,0,0,0,1
S01007782,Occupancy rating 0,105,51,4,47,50,1,31,5,21,5,18,14,4,4,2,1,0,1
S01007782,Occupancy rating -1 or less,24,9,1,8,12,0,7,1,6,0,5,4,1,3,1,0,0,2
S01007783,All households,405,157,59,98,234,39,100,55,29,16,95,63,32,14,10,0,1,3
S01007783,Occupancy rating +2 or more,28,9,4,5,19,4,10,8,1,1,5,0,5,0,0,0,0,0
S01007783,Occupancy rating +1,192,101,38,63,90,31,46,44,2,0,13,11,2,1,1,0,0,0
S01007783,Occupancy rating 0,130,35,14,21,91,2,33,2,18,13,56,36,20,4,1,0,1,2
S01007783,Occupancy rating -1 or less,55,12,3,9,34,2,11,1,8,2,21,16,5,9,8,0,0,1
S01007784,All households,276,65,9,56,199,4,148,48,78,22,47,36,11,12,7,0,0,5
S01007784,Occupancy rating +2 or more,76,19,4,15,55,1,48,31,12,5,6,4,2,2,1,0,0,1
S01007784,Occupancy rating +1,90,29,4,25,60,3,41,11,21,9,16,13,3,1,0,0,0,1
S01007784,Occupancy rating 0,88,14,1,13,68,0,49,4,39,6,19,14,5,6,4,0,0,2
S01007784,Occupancy rating -1 or less,22,3,0,3,16,0,10,2,6,2,6,5,1,3,2,0,0,1
S01007785,All households,276,100,48,52,169,4,66,28,26,12,99,81,18,7,6,0,0,1
S01007785,Occupancy rating +2 or more,44,18,5,13,26,4,13,10,1,2,9,6,3,0,0,0,0,0
S01007785,Occupancy rating +1,93,46,22,24,45,0,27,16,9,2,18,15,3,2,1,0,0,1
S01007785,Occupancy rating 0,107,30,18,12,77,0,21,2,13,6,56,47,9,0,0,0,0,0
S01007785,Occupancy rating -1 or less,32,6,3,3,21,0,5,0,3,2,16,13,3,5,5,0,0,0
S01007786,All households,333,94,45,49,221,25,130,57,44,29,66,37,29,18,13,0,0,5
S01007786,Occupancy rating +2 or more,93,37,15,22,54,10,38,31,7,0,6,4,2,2,1,0,0,1
S01007786,Occupancy rating +1,130,44,24,20,85,14,51,24,12,15,20,7,13,1,0,0,0,1
S01007786,Occupancy rating 0,79,10,3,7,61,1,29,2,14,13,31,21,10,8,6,0,0,2
S01007786,Occupancy rating -1 or less,31,3,3,0,21,0,12,0,11,1,9,5,4,7,6,0,0,1
S01007787,All households,277,64,36,28,196,15,120,53,41,26,61,45,16,17,7,0,0,10
S01007787,Occupancy rating +2 or more,73,33,22,11,38,5,33,27,4,2,0,0,0,2,0,0,0,2
S01007787,Occupancy rating +1,105,28,12,16,74,8,45,24,14,7,21,13,8,3,1,0,0,2
S01007787,Occupancy rating 0,67,1,1,0,58,2,29,2,16,11,27,23,4,8,4,0,0,4
S01007787,Occupancy rating -1 or less,32,2,1,1,26,0,13,0,7,6,13,9,4,4,2,0,0,2
S01007788,All households,268,68,14,54,181,5,77,15,48,14,99,79,20,19,7,0,0,12
S01007788,Occupancy rating +2 or more,32,10,1,9,21,0,12,4,7,1,9,3,6,1,0,0,0,1
S01007788,Occupancy rating +1,66,17,5,12,40,1,21,5,12,4,18,15,3,9,4,0,0,5
S01007788,Occupancy rating 0,129,34,8,26,91,2,34,6,21,7,55,46,9,4,0,0,0,4
S01007788,Occupancy rating -1 or less,41,7,0,7,29,2,10,0,8,2,17,15,2,5,3,0,0,2
S01007789,All households,231,55,3,52,158,7,77,20,39,18,74,56,18,18,14,0,0,4
S01007789,Occupancy rating +2 or more,29,8,1,7,20,0,13,8,2,3,7,4,3,1,1,0,0,0
S01007789,Occupancy rating +1,74,21,1,20,50,3,27,9,13,5,20,17,3,3,2,0,0,1
S01007789,Occupancy rating 0,87,21,0,21,61,4,25,3,16,6,32,27,5,5,4,0,0,1
S01007789,Occupancy rating -1 or less,41,5,1,4,27,0,12,0,8,4,15,8,7,9,7,0,0,2
S01007790,All households,330,85,12,73,221,4,90,15,58,17,127,110,17,24,16,0,0,8
S01007790,Occupancy rating +2 or more,28,17,1,16,11,0,10,5,4,1,1,1,0,0,0,0,0,0
S01007790,Occupancy rating +1,103,52,10,42,48,3,26,9,14,3,19,16,3,3,0,0,0,3
S01007790,Occupancy rating 0,150,11,1,10,128,1,43,1,31,11,84,75,9,11,7,0,0,4
S01007790,Occupancy rating -1 or less,49,5,0,5,34,0,11,0,9,2,23,18,5,10,9,0,0,1
S01007791,All households,174,27,8,19,138,10,116,43,57,16,12,9,3,9,3,0,0,6
S01007791,Occupancy rating +2 or more,106,18,5,13,85,8,70,32,30,8,7,5,2,3,1,0,0,2
S01007791,Occupancy rating +1,45,5,3,2,37,1,35,11,17,7,1,0,1,3,1,0,0,2
S01007791,Occupancy rating 0,17,2,0,2,13,1,9,0,8,1,3,3,0,2,0,0,0,2
S01007791,Occupancy rating -1 or less,6,2,0,2,3,0,2,0,2,0,1,1,0,1,1,0,0,0
S01007792,All households,384,107,36,71,261,38,150,65,50,35,73,52,21,16,8,0,0,8
S01007792,Occupancy rating +2 or more,95,38,13,25,56,18,36,31,3,2,2,2,0,1,1,0,0,0
S01007792,Occupancy rating +1,154,54,19,35,96,17,59,30,17,12,20,13,7,4,0,0,0,4
S01007792,Occupancy rating 0,106,11,3,8,90,3,45,3,26,16,42,28,14,5,2,0,0,3
S01007792,Occupancy rating -1 or less,29,4,1,3,19,0,10,1,4,5,9,9,0,6,5,0,0,1
S01007793,All households,457,186,95,91,249,28,119,38,64,17,102,84,18,22,6,0,0,16
S01007793,Occupancy rating +2 or more,64,38,10,28,26,8,14,11,2,1,4,4,0,0,0,0,0,0
S01007793,Occupancy rating +1,142,77,37,40,64,15,39,20,11,8,10,8,2,1,0,0,0,1
S01007793,Occupancy rating 0,181,47,31,16,119,4,52,6,40,6,63,51,12,15,3,0,0,12
S01007793,Occupancy rating -1 or less,70,24,17,7,40,1,14,1,11,2,25,21,4,6,3,0,0,3
S01007794,All households,234,63,25,38,160,17,99,30,45,24,44,30,14,11,7,0,0,4
S01007794,Occupancy rating +2 or more,95,47,17,30,48,15,31,25,4,2,2,2,0,0,0,0,0,0
S01007794,Occupancy rating +1,78,12,6,6,65,2,43,4,22,17,20,9,11,1,0,0,0,1
S01007794,Occupancy rating 0,47,4,2,2,36,0,19,1,14,4,17,14,3,7,4,0,0,3
S01007794,Occupancy rating -1 or less,14,0,0,0,11,0,6,0,5,1,5,5,0,3,3,0,0,0
S01007795,All households,243,49,19,30,173,16,101,41,36,24,56,42,14,21,10,0,1,10
S01007795,Occupancy rating +2 or more,69,30,14,16,38,11,27,20,5,2,0,0,0,1,0,0,0,1
S01007795,Occupancy rating +1,88,15,3,12,68,5,44,18,12,14,19,13,6,5,0,0,1,4
S01007795,Occupancy rating 0,64,2,2,0,52,0,23,3,14,6,29,21,8,10,6,0,0,4
S01007795,Occupancy rating -1 or less,22,2,0,2,15,0,7,0,5,2,8,8,0,5,4,0,0,1
S01007796,All households,311,107,39,68,192,12,116,38,57,21,64,55,9,12,7,0,1,4
S01007796,Occupancy rating +2 or more,105,34,15,19,69,8,53,30,21,2,8,6,2,2,1,0,0,1
S01007796,Occupancy rating +1,83,28,11,17,53,2,32,4,14,14,19,16,3,2,1,0,1,0
S01007796,Occupancy rating 0,92,38,11,27,49,2,22,4,13,5,25,21,4,5,4,0,0,1
S01007796,Occupancy rating -1 or less,31,7,2,5,21,0,9,0,9,0,12,12,0,3,1,0,0,2
S01007797,All households,258,103,35,68,148,13,69,27,31,11,66,48,18,7,1,0,0,6
S01007797,Occupancy rating +2 or more,52,21,9,12,31,8,20,15,5,0,3,2,1,0,0,0,0,0
S01007797,Occupancy rating +1,84,37,8,29,46,2,22,8,8,6,22,13,9,1,0,0,0,1
S01007797,Occupancy rating 0,97,42,17,25,50,3,18,2,12,4,29,24,5,5,1,0,0,4
S01007797,Occupancy rating -1 or less,25,3,1,2,21,0,9,2,6,1,12,9,3,1,0,0,0,1
S01007798,All households,226,32,7,25,181,6,147,38,84,25,28,20,8,13,9,0,0,4
S01007798,Occupancy rating +2 or more,115,19,2,17,89,3,80,37,35,8,6,4,2,7,4,0,0,3
S01007798,Occupancy rating +1,59,9,4,5,48,1,38,1,31,6,9,6,3,2,1,0,0,1
S01007798,Occupancy rating 0,38,4,1,3,32,1,22,0,15,7,9,8,1,2,2,0,0,0
S01007798,Occupancy rating -1 or less,14,0,0,0,12,1,7,0,3,4,4,2,2,2,2,0,0,0
S01007799,All households,193,16,0,16,165,2,146,36,97,13,17,17,0,12,7,0,0,5
S01007799,Occupancy rating +2 or more,124,7,0,7,112,2,108,31,69,8,2,2,0,5,4,0,0,1
S01007799,Occupancy rating +1,42,8,0,8,30,0,24,4,17,3,6,6,0,4,1,0,0,3
S01007799,Occupancy rating 0,20,1,0,1,17,0,10,1,8,1,7,7,0,2,1,0,0,1
S01007799,Occupancy rating -1 or less,7,0,0,0,6,0,4,0,3,1,2,2,0,1,1,0,0,0
S01007800,All households,365,85,32,53,251,13,125,53,42,30,113,88,25,29,14,0,1,14
S01007800,Occupancy rating +2 or more,86,36,18,18,49,5,36,26,6,4,8,8,0,1,0,0,0,1
S01007800,Occupancy rating +1,120,35,9,26,80,6,38,19,7,12,36,30,6,5,1,0,0,4
S01007800,Occupancy rating 0,109,12,4,8,86,2,35,7,21,7,49,34,15,11,4,0,1,6
S01007800,Occupancy rating -1 or less,50,2,1,1,36,0,16,1,8,7,20,16,4,12,9,0,0,3
S01007801,All households,388,165,56,109,205,11,111,45,41,25,83,52,31,18,10,0,2,6
S01007801,Occupancy rating +2 or more,74,32,10,22,40,5,31,25,1,5,4,1,3,2,0,0,1,1
S01007801,Occupancy rating +1,116,42,14,28,70,3,40,13,17,10,27,16,11,4,1,0,0,3
S01007801,Occupancy rating 0,128,57,21,36,66,2,31,7,15,9,33,23,10,5,3,0,1,1
S01007801,Occupancy rating -1 or less,70,34,11,23,29,1,9,0,8,1,19,12,7,7,6,0,0,1
S01007802,All households,199,35,4,31,156,3,128,38,72,18,25,18,7,8,8,0,0,0
S01007802,Occupancy rating +2 or more,55,11,2,9,44,0,42,23,15,4,2,2,0,0,0,0,0,0
S01007802,Occupancy rating +1,73,19,1,18,51,3,39,13,22,4,9,5,4,3,3,0,0,0
S01007802,Occupancy rating 0,59,4,1,3,55,0,44,2,33,9,11,8,3,0,0,0,0,0
S01007802,Occupancy rating -1 or less,12,1,0,1,6,0,3,0,2,1,3,3,0,5,5,0,0,0
S01007803,All households,524,243,85,158,256,24,112,40,56,16,120,93,27,25,8,0,1,16
S01007803,Occupancy rating +2 or more,65,26,7,19,37,10,21,12,5,4,6,5,1,2,0,0,0,2
S01007803,Occupancy rating +1,164,77,30,47,81,10,47,22,20,5,24,19,5,6,2,0,0,4
S01007803,Occupancy rating 0,208,101,32,69,96,4,33,4,23,6,59,42,17,11,3,0,1,7
S01007803,Occupancy rating -1 or less,87,39,16,23,42,0,11,2,8,1,31,27,4,6,3,0,0,3
S01007804,All households,259,67,16,51,172,11,67,24,32,11,94,74,20,20,7,0,2,11
S01007804,Occupancy rating +2 or more,45,10,1,9,30,5,14,6,3,5,11,9,2,5,2,0,0,3
S01007804,Occupancy rating +1,98,29,5,24,63,3,26,15,10,1,34,28,6,6,2,0,0,4
S01007804,Occupancy rating 0,81,18,9,9,59,3,20,2,15,3,36,28,8,4,1,0,1,2
S01007804,Occupancy rating -1 or less,35,10,1,9,20,0,7,1,4,2,13,9,4,5,2,0,1,2
S01007805,All households,207,49,12,37,150,2,71,26,32,13,77,56,21,8,4,0,1,3
S01007805,Occupancy rating +2 or more,38,17,3,14,21,0,16,15,0,1,5,4,1,0,0,0,0,0
S01007805,Occupancy rating +1,77,23,6,17,53,2,30,9,16,5,21,12,9,1,0,0,0,1
S01007805,Occupancy rating 0,61,5,1,4,56,0,21,2,13,6,35,27,8,0,0,0,0,0
S01007805,Occupancy rating -1 or less,31,4,2,2,20,0,4,0,3,1,16,13,3,7,4,0,1,2
S01007806,All households,296,91,38,53,193,23,117,46,43,28,53,31,22,12,3,0,2,7
S01007806,Occupancy rating +2 or more,59,24,11,13,35,10,22,17,3,2,3,2,1,0,0,0,0,0
S01007806,Occupancy rating +1,128,54,23,31,73,12,46,26,9,11,15,6,9,1,0,0,0,1
S01007806,Occupancy rating 0,89,10,4,6,71,1,42,3,24,15,28,19,9,8,2,0,2,4
S01007806,Occupancy rating -1 or less,20,3,0,3,14,0,7,0,7,0,7,4,3,3,1,0,0,2
S01007807,All households,258,43,15,28,190,18,148,44,76,28,24,16,8,25,13,0,1,11
S01007807,Occupancy rating +2 or more,146,29,10,19,109,14,87,36,39,12,8,7,1,8,3,0,0,5
S01007807,Occupancy rating +1,61,11,5,6,46,0,38,6,21,11,8,4,4,4,0,0,1,3
S01007807,Occupancy rating 0,42,3,0,3,31,4,20,1,14,5,7,5,2,8,6,0,0,2
S01007807,Occupancy rating -1 or less,9,0,0,0,4,0,3,1,2,0,1,0,1,5,4,0,0,1
S01007808,All households,304,56,13,43,225,11,154,51,70,33,60,45,15,23,11,0,0,12
S01007808,Occupancy rating +2 or more,127,47,11,36,77,9,62,39,11,12,6,3,3,3,1,0,0,2
S01007808,Occupancy rating +1,88,5,1,4,75,2,55,11,30,14,18,14,4,8,1,0,0,7
S01007808,Occupancy rating 0,56,2,1,1,46,0,24,0,19,5,22,15,7,8,5,0,0,3
S01007808,Occupancy rating -1 or less,33,2,0,2,27,0,13,1,10,2,14,13,1,4,4,0,0,0
S01007809,All households,398,94,67,27,289,57,198,83,73,42,34,20,14,15,7,1,1,6
S01007809,Occupancy rating +2 or more,222,58,41,17,160,40,110,66,25,19,10,4,6,4,1,0,1,2
S01007809,Occupancy rating +1,122,29,22,7,88,14,62,14,32,16,12,8,4,5,2,0,0,3
S01007809,Occupancy rating 0,42,6,3,3,33,2,21,2,13,6,10,6,4,3,1,1,0,1
S01007809,Occupancy rating -1 or less,12,1,1,0,8,1,5,1,3,1,2,2,0,3,3,0,0,0
S01007810,All households,369,129,65,64,209,20,135,52,55,28,54,35,19,31,21,1,1,8
S01007810,Occupancy rating +2 or more,93,36,17,19,55,9,41,30,8,3,5,3,2,2,1,0,1,0
S01007810,Occupancy rating +1,120,36,16,20,76,9,56,19,23,14,11,5,6,8,5,1,0,2
S01007810,Occupancy rating 0,127,54,30,24,63,2,32,3,19,10,29,20,9,10,7,0,0,3
S01007810,Occupancy rating -1 or less,29,3,2,1,15,0,6,0,5,1,9,7,2,11,8,0,0,3
S01007811,All households,325,69,28,41,237,14,140,51,64,25,83,55,28,19,11,0,1,7
S01007811,Occupancy rating +2 or more,71,28,9,19,41,7,29,24,4,1,5,1,4,2,0,0,0,2
S01007811,Occupancy rating +1,117,35,17,18,77,5,54,22,22,10,18,8,10,5,3,0,1,1
S01007811,Occupancy rating 0,101,5,2,3,90,2,47,5,30,12,41,34,7,6,4,0,0,2
S01007811,Occupancy rating -1 or less,36,1,0,1,29,0,10,0,8,2,19,12,7,6,4,0,0,2
S01007812,All households,328,99,18,81,203,4,115,27,66,22,84,65,19,26,22,0,0,4
S01007812,Occupancy rating +2 or more,35,17,4,13,18,1,13,7,3,3,4,3,1,0,0,0,0,0
S01007812,Occupancy rating +1,130,65,10,55,60,3,36,17,13,6,21,17,4,5,3,0,0,2
S01007812,Occupancy rating 0,121,13,3,10,100,0,53,2,41,10,47,36,11,8,6,0,0,2
S01007812,Occupancy rating -1 or less,42,4,1,3,25,0,13,1,9,3,12,9,3,13,13,0,0,0
S01007813,All households,306,77,38,39,204,16,110,47,45,18,78,55,23,25,15,0,0,10
S01007813,Occupancy rating +2 or more,92,31,10,21,60,6,44,38,5,1,10,9,1,1,1,0,0,0
S01007813,Occupancy rating +1,83,17,5,12,63,4,35,8,16,11,24,13,11,3,0,0,0,3
S01007813,Occupancy rating 0,94,26,20,6,56,3,23,1,17,5,30,22,8,12,6,0,0,6
S01007813,Occupancy rating -1 or less,37,3,3,0,25,3,8,0,7,1,14,11,3,9,8,0,0,1
S01007814,All households,229,65,32,33,150,14,115,44,43,28,21,12,9,14,8,1,0,5
S01007814,Occupancy rating +2 or more,103,40,22,18,59,9,49,32,10,7,1,0,1,4,1,0,0,3
S01007814,Occupancy rating +1,76,15,9,6,58,5,44,9,20,15,9,5,4,3,3,0,0,0
S01007814,Occupancy rating 0,40,10,1,9,27,0,20,3,11,6,7,3,4,3,1,1,0,1
S01007814,Occupancy rating -1 or less,10,0,0,0,6,0,2,0,2,0,4,4,0,4,3,0,0,1
S01007815,All households,343,70,44,26,258,40,194,77,69,48,24,14,10,15,5,0,2,8
S01007815,Occupancy rating +2 or more,205,51,31,20,148,32,110,60,32,18,6,4,2,6,1,0,1,4
S01007815,Occupancy rating +1,82,16,10,6,64,6,52,15,19,18,6,5,1,2,1,0,0,1
S01007815,Occupancy rating 0,45,3,3,0,36,2,24,2,11,11,10,4,6,6,2,0,1,3
S01007815,Occupancy rating -1 or less,11,0,0,0,10,0,8,0,7,1,2,1,1,1,1,0,0,0
S01007816,All households,273,53,27,26,206,27,150,66,48,36,29,20,9,14,8,0,0,6
S01007816,Occupancy rating +2 or more,141,36,15,21,102,20,72,53,10,9,10,3,7,3,2,0,0,1
S01007816,Occupancy rating +1,80,16,11,5,59,5,46,11,17,18,8,7,1,5,1,0,0,4
S01007816,Occupancy rating 0,39,1,1,0,33,2,22,2,15,5,9,8,1,5,4,0,0,1
S01007816,Occupancy rating -1 or less,13,0,0,0,12,0,10,0,6,4,2,2,0,1,1,0,0,0
S01007817,All households,207,59,36,23,137,26,82,36,24,22,29,15,14,11,6,0,0,5
S01007817,Occupancy rating +2 or more,75,31,17,14,43,12,31,24,4,3,0,0,0,1,0,0,0,1
S01007817,Occupancy rating +1,83,23,15,8,57,14,27,10,8,9,16,7,9,3,1,0,0,2
S01007817,Occupancy rating 0,41,2,2,0,34,0,22,2,10,10,12,8,4,5,4,0,0,1
S01007817,Occupancy rating -1 or less,8,3,2,1,3,0,2,0,2,0,1,0,1,2,1,0,0,1
S01007818,All households,314,71,30,41,232,27,171,74,68,29,34,29,5,11,6,0,0,5
S01007818,Occupancy rating +2 or more,105,22,10,12,80,16,64,40,11,13,0,0,0,3,0,0,0,3
S01007818,Occupancy rating +1,134,42,18,24,89,10,66,31,23,12,13,12,1,3,1,0,0,2
S01007818,Occupancy rating 0,58,6,2,4,51,1,33,3,27,3,17,13,4,1,1,0,0,0
S01007818,Occupancy rating -1 or less,17,1,0,1,12,0,8,0,7,1,4,4,0,4,4,0,0,0
S01007819,All households,353,100,56,44,238,51,146,58,59,29,41,17,24,15,5,1,1,8
S01007819,Occupancy rating +2 or more,170,48,29,19,118,38,71,37,25,9,9,3,6,4,0,0,0,4
S01007819,Occupancy rating +1,107,38,22,16,66,10,41,18,14,9,15,6,9,3,1,0,0,2
S01007819,Occupancy rating 0,54,12,4,8,37,1,25,0,15,10,11,5,6,5,2,0,1,2
S01007819,Occupancy rating -1 or less,22,2,1,1,17,2,9,3,5,1,6,3,3,3,2,1,0,0
S01007820,All households,408,131,74,57,261,46,163,58,68,37,52,32,20,16,6,0,2,8
S01007820,Occupancy rating +2 or more,150,61,36,25,85,30,53,37,12,4,2,1,1,4,1,0,0,3
S01007820,Occupancy rating +1,134,32,12,20,98,11,66,18,26,22,21,7,14,4,0,0,1,3
S01007820,Occupancy rating 0,95,28,19,9,61,4,35,2,22,11,22,21,1,6,3,0,1,2
S01007820,Occupancy rating -1 or less,29,10,7,3,17,1,9,1,8,0,7,3,4,2,2,0,0,0
S01007821,All households,244,64,26,38,171,28,107,37,41,29,36,19,17,9,3,0,1,5
S01007821,Occupancy rating +2 or more,103,35,17,18,68,21,42,24,7,11,5,1,4,0,0,0,0,0
S01007821,Occupancy rating +1,74,15,5,10,58,4,43,12,19,12,11,4,7,1,1,0,0,0
S01007821,Occupancy rating 0,44,7,4,3,31,3,14,1,10,3,14,10,4,6,1,0,1,4
S01007821,Occupancy rating -1 or less,23,7,0,7,14,0,8,0,5,3,6,4,2,2,1,0,0,1
S01007822,All households,349,118,73,45,222,52,144,67,52,25,26,18,8,9,4,0,0,5
S01007822,Occupancy rating +2 or more,147,42,22,20,104,26,77,47,22,8,1,0,1,1,0,0,0,1
S01007822,Occupancy rating +1,99,18,4,14,76,16,46,19,17,10,14,9,5,5,1,0,0,4
S01007822,Occupancy rating 0,94,55,44,11,37,10,18,1,11,6,9,7,2,2,2,0,0,0
S01007822,Occupancy rating -1 or less,9,3,3,0,5,0,3,0,2,1,2,2,0,1,1,0,0,0
S01007823,All households,306,87,43,44,201,39,134,49,51,34,28,14,14,18,2,1,1,14
S01007823,Occupancy rating +2 or more,153,34,20,14,116,31,78,34,26,18,7,1,6,3,0,0,0,3
S01007823,Occupancy rating +1,84,34,18,16,48,8,31,9,12,10,9,4,5,2,0,0,1,1
S01007823,Occupancy rating 0,50,8,4,4,34,0,24,6,13,5,10,7,3,8,1,0,0,7
S01007823,Occupancy rating -1 or less,19,11,1,10,3,0,1,0,0,1,2,2,0,5,1,1,0,3
S01007824,All households,342,131,78,53,185,37,120,52,48,20,28,18,10,26,14,1,1,10
S01007824,Occupancy rating +2 or more,173,64,45,19,98,24,65,36,19,10,9,5,4,11,4,0,1,6
S01007824,Occupancy rating +1,90,35,26,9,51,11,32,11,16,5,8,4,4,4,4,0,0,0
S01007824,Occupancy rating 0,62,22,4,18,33,2,21,5,11,5,10,8,2,7,3,1,0,3
S01007824,Occupancy rating -1 or less,17,10,3,7,3,0,2,0,2,0,1,1,0,4,3,0,0,1
S01007825,All households,482,176,97,79,289,59,199,85,77,37,31,18,13,17,6,0,2,9
S01007825,Occupancy rating +2 or more,203,60,36,24,137,31,100,42,43,15,6,3,3,6,3,0,0,3
S01007825,Occupancy rating +1,164,75,45,30,86,18,66,35,18,13,2,0,2,3,1,0,1,1
S01007825,Occupancy rating 0,96,37,14,23,53,10,24,8,10,6,19,12,7,6,2,0,1,3
S01007825,Occupancy rating -1 or less,19,4,2,2,13,0,9,0,6,3,4,3,1,2,0,0,0,2
S01007826,All households,260,105,50,55,138,17,70,21,34,15,51,34,17,17,13,0,1,3
S01007826,Occupancy rating +2 or more,53,21,6,15,32,3,18,13,1,4,11,7,4,0,0,0,0,0
S01007826,Occupancy rating +1,84,38,14,24,43,10,23,6,12,5,10,6,4,3,2,0,0,1
S01007826,Occupancy rating 0,86,35,24,11,43,3,19,2,16,1,21,15,6,8,5,0,1,2
S01007826,Occupancy rating -1 or less,37,11,6,5,20,1,10,0,5,5,9,6,3,6,6,0,0,0
S01007827,All households,291,119,16,103,152,4,110,62,29,19,38,32,6,20,7,2,0,11
S01007827,Occupancy rating +2 or more,55,17,2,15,34,1,29,23,3,3,4,4,0,4,1,0,0,3
S01007827,Occupancy rating +1,111,57,9,48,51,2,45,29,10,6,4,2,2,3,1,0,0,2
S01007827,Occupancy rating 0,87,31,3,28,48,1,26,5,12,9,21,19,2,8,3,1,0,4
S01007827,Occupancy rating -1 or less,38,14,2,12,19,0,10,5,4,1,9,7,2,5,2,1,0,2
S01007828,All households,592,358,128,230,215,33,128,78,35,15,54,37,17,19,1,3,1,14
S01007828,Occupancy rating +2 or more,32,13,3,10,17,0,15,8,5,2,2,2,0,2,0,0,1,1
S01007828,Occupancy rating +1,220,140,63,77,80,21,53,47,3,3,6,4,2,0,0,0,0,0
S01007828,Occupancy rating 0,286,178,52,126,97,9,53,21,22,10,35,23,12,11,1,1,0,9
S01007828,Occupancy rating -1 or less,54,27,10,17,21,3,7,2,5,0,11,8,3,6,0,2,0,4
S01007829,All households,348,189,115,74,145,42,73,41,17,15,30,14,16,14,2,3,1,8
S01007829,Occupancy rating +2 or more,39,11,6,5,26,5,19,8,8,3,2,0,2,2,0,1,0,1
S01007829,Occupancy rating +1,160,94,61,33,64,31,30,26,2,2,3,0,3,2,0,0,0,2
S01007829,Occupancy rating 0,121,72,39,33,44,5,23,7,7,9,16,9,7,5,0,2,0,3
S01007829,Occupancy rating -1 or less,28,12,9,3,11,1,1,0,0,1,9,5,4,5,2,0,1,2
S01007830,All households,545,302,141,161,208,38,109,65,33,11,61,38,23,35,8,10,2,15
S01007830,Occupancy rating +2 or more,53,23,8,15,28,6,20,14,4,2,2,1,1,2,2,0,0,0
S01007830,Occupancy rating +1,215,141,68,73,67,16,39,30,8,1,12,5,7,7,0,5,0,2
S01007830,Occupancy rating 0,217,114,54,60,87,10,44,20,18,6,33,23,10,16,0,4,2,10
S01007830,Occupancy rating -1 or less,60,24,11,13,26,6,6,1,3,2,14,9,5,10,6,1,0,3
S01007831,All households,501,284,102,182,195,35,97,46,35,16,63,50,13,22,11,6,0,5
S01007831,Occupancy rating +2 or more,51,21,5,16,27,8,15,9,2,4,4,3,1,3,2,0,0,1
S01007831,Occupancy rating +1,193,132,55,77,59,20,29,21,4,4,10,8,2,2,1,1,0,0
S01007831,Occupancy rating 0,193,109,36,73,77,4,38,14,19,5,35,27,8,7,1,3,0,3
S01007831,Occupancy rating -1 or less,64,22,6,16,32,3,15,2,10,3,14,12,2,10,7,2,0,1
S01007832,All households,362,183,61,122,163,23,93,52,27,14,47,33,14,16,3,3,2,8
S01007832,Occupancy rating +2 or more,28,2,1,1,24,0,20,11,5,4,4,4,0,2,1,0,1,0
S01007832,Occupancy rating +1,169,113,43,70,54,21,32,29,1,2,1,1,0,2,0,0,0,2
S01007832,Occupancy rating 0,132,54,11,43,71,2,35,10,19,6,34,22,12,7,1,0,1,5
S01007832,Occupancy rating -1 or less,33,14,6,8,14,0,6,2,2,2,8,6,2,5,1,3,0,1
S01007833,All households,479,264,176,88,206,82,98,46,32,20,26,9,17,9,3,2,0,4
S01007833,Occupancy rating +2 or more,88,37,18,19,50,17,29,16,9,4,4,1,3,1,0,0,0,1
S01007833,Occupancy rating +1,250,159,107,52,91,52,35,24,6,5,4,2,2,0,0,0,0,0
S01007833,Occupancy rating 0,105,48,37,11,52,10,28,6,14,8,14,5,9,5,1,2,0,2
S01007833,Occupancy rating -1 or less,36,20,14,6,13,3,6,0,3,3,4,1,3,3,2,0,0,1
S01007834,All households,416,201,54,147,186,19,87,41,30,16,80,54,26,29,1,9,0,19
S01007834,Occupancy rating +2 or more,45,26,7,19,18,3,11,10,1,0,4,3,1,1,0,0,0,1
S01007834,Occupancy rating +1,172,115,25,90,55,11,33,25,4,4,11,6,5,2,0,0,0,2
S01007834,Occupancy rating 0,152,55,20,35,80,3,32,6,16,10,45,32,13,17,0,6,0,11
S01007834,Occupancy rating -1 or less,47,5,2,3,33,2,11,0,9,2,20,13,7,9,1,3,0,5
S01007835,All households,325,121,81,40,193,22,125,52,53,20,46,25,21,11,3,0,0,8
S01007835,Occupancy rating +2 or more,85,17,10,7,65,6,54,22,18,14,5,0,5,3,0,0,0,3
S01007835,Occupancy rating +1,84,38,18,20,43,7,30,23,7,0,6,2,4,3,2,0,0,1
S01007835,Occupancy rating 0,116,46,35,11,67,8,29,7,20,2,30,19,11,3,0,0,0,3
S01007835,Occupancy rating -1 or less,40,20,18,2,18,1,12,0,8,4,5,4,1,2,1,0,0,1
S01007836,All households,285,141,67,74,132,28,88,44,29,15,16,7,9,12,2,0,0,10
S01007836,Occupancy rating +2 or more,92,25,13,12,61,14,43,24,11,8,4,3,1,6,0,0,0,6
S01007836,Occupancy rating +1,103,58,34,24,43,11,27,16,9,2,5,2,3,2,0,0,0,2
S01007836,Occupancy rating 0,75,48,17,31,23,3,16,4,8,4,4,1,3,4,2,0,0,2
S01007836,Occupancy rating -1 or less,15,10,3,7,5,0,2,0,1,1,3,1,2,0,0,0,0,0
S01007837,All households,357,101,62,39,245,57,162,81,43,38,26,12,14,11,7,0,1,3
S01007837,Occupancy rating +2 or more,220,65,40,25,151,51,96,58,15,23,4,1,3,4,3,0,1,0
S01007837,Occupancy rating +1,94,32,20,12,60,4,45,18,16,11,11,4,7,2,1,0,0,1
S01007837,Occupancy rating 0,34,4,2,2,25,2,13,3,7,3,10,6,4,5,3,0,0,2
S01007837,Occupancy rating -1 or less,9,0,0,0,9,0,8,2,5,1,1,1,0,0,0,0,0,0
S01007838,All households,392,114,65,49,269,79,154,66,54,34,36,20,16,9,5,1,0,3
S01007838,Occupancy rating +2 or more,219,68,40,28,149,59,77,40,26,11,13,5,8,2,1,0,0,1
S01007838,Occupancy rating +1,96,23,14,9,71,16,48,23,11,14,7,3,4,2,1,0,0,1
S01007838,Occupancy rating 0,61,21,9,12,37,4,21,2,12,7,12,10,2,3,1,1,0,1
S01007838,Occupancy rating -1 or less,16,2,2,0,12,0,8,1,5,2,4,2,2,2,2,0,0,0
S01007839,All households,281,129,98,31,141,47,69,24,25,20,25,14,11,11,2,2,0,7
S01007839,Occupancy rating +2 or more,67,17,11,6,48,21,24,12,7,5,3,1,2,2,0,0,0,2
S01007839,Occupancy rating +1,81,38,22,16,40,17,19,7,7,5,4,2,2,3,1,0,0,2
S01007839,Occupancy rating 0,107,63,54,9,42,5,22,5,8,9,15,10,5,2,0,1,0,1
S01007839,Occupancy rating -1 or less,26,11,11,0,11,4,4,0,3,1,3,1,2,4,1,1,0,2
S01007840,All households,425,210,72,138,192,33,99,49,40,10,60,39,21,23,6,4,3,10
S01007840,Occupancy rating +2 or more,40,22,15,7,16,4,10,8,1,1,2,2,0,2,1,0,1,0
S01007840,Occupancy rating +1,162,100,33,67,60,22,32,29,1,2,6,1,5,2,0,0,2,0
S01007840,Occupancy rating 0,176,73,16,57,92,5,50,10,34,6,37,25,12,11,2,4,0,5
S01007840,Occupancy rating -1 or less,47,15,8,7,24,2,7,2,4,1,15,11,4,8,3,0,0,5
S01007841,All households,341,125,41,84,206,25,104,42,43,19,77,55,22,10,4,0,2,4
S01007841,Occupancy rating +2 or more,36,22,9,13,14,5,9,7,1,1,0,0,0,0,0,0,0,0
S01007841,Occupancy rating +1,150,74,24,50,75,18,43,32,6,5,14,6,8,1,0,0,0,1
S01007841,Occupancy rating 0,111,19,8,11,90,1,40,2,27,11,49,36,13,2,0,0,0,2
S01007841,Occupancy rating -1 or less,44,10,0,10,27,1,12,1,9,2,14,13,1,7,4,0,2,1
S01007842,All households,391,185,22,163,183,13,77,35,32,10,93,79,14,23,9,3,0,11
S01007842,Occupancy rating +2 or more,46,23,9,14,23,7,11,8,2,1,5,4,1,0,0,0,0,0
S01007842,Occupancy rating +1,90,50,7,43,39,5,23,17,3,3,11,8,3,1,1,0,0,0
S01007842,Occupancy rating 0,190,92,5,87,88,1,36,10,23,3,51,48,3,10,2,2,0,6
S01007842,Occupancy rating -1 or less,65,20,1,19,33,0,7,0,4,3,26,19,7,12,6,1,0,5
S01007843,All households,354,151,53,98,185,17,104,36,46,22,64,46,18,18,5,6,0,7
S01007843,Occupancy rating +2 or more,36,21,14,7,15,4,11,9,1,1,0,0,0,0,0,0,0,0
S01007843,Occupancy rating +1,162,101,31,70,60,13,37,22,8,7,10,6,4,1,1,0,0,0
S01007843,Occupancy rating 0,114,17,7,10,88,0,47,5,32,10,41,30,11,9,0,3,0,6
S01007843,Occupancy rating -1 or less,42,12,1,11,22,0,9,0,5,4,13,10,3,8,4,3,0,1
S01007844,All households,520,275,51,224,219,22,114,50,52,12,83,60,23,26,7,6,1,12
S01007844,Occupancy rating +2 or more,43,17,11,6,26,7,17,9,6,2,2,1,1,0,0,0,0,0
S01007844,Occupancy rating +1,169,103,25,78,63,10,40,27,9,4,13,6,7,3,1,0,0,2
S01007844,Occupancy rating 0,230,135,12,123,82,5,36,11,22,3,41,30,11,13,3,1,1,8
S01007844,Occupancy rating -1 or less,78,20,3,17,48,0,21,3,15,3,27,23,4,10,3,5,0,2
S01007845,All households,427,179,64,115,231,16,116,43,55,18,99,77,22,17,8,0,1,8
S01007845,Occupancy rating +2 or more,41,19,5,14,22,3,15,11,4,0,4,4,0,0,0,0,0,0
S01007845,Occupancy rating +1,170,106,31,75,60,9,38,28,8,2,13,9,4,4,1,0,0,3
S01007845,Occupancy rating 0,147,39,19,20,106,2,46,3,31,12,58,44,14,2,1,0,0,1
S01007845,Occupancy rating -1 or less,69,15,9,6,43,2,17,1,12,4,24,20,4,11,6,0,1,4
S01007846,All households,337,110,51,59,210,17,125,51,57,17,68,49,19,17,8,0,2,7
S01007846,Occupancy rating +2 or more,42,14,4,10,25,2,17,10,5,2,6,3,3,3,2,0,0,1
S01007846,Occupancy rating +1,155,80,36,44,70,11,52,37,14,1,7,5,2,5,0,0,1,4
S01007846,Occupancy rating 0,103,12,9,3,88,3,42,2,30,10,43,35,8,3,1,0,0,2
S01007846,Occupancy rating -1 or less,37,4,2,2,27,1,14,2,8,4,12,6,6,6,5,0,1,0
S01007847,All households,437,168,74,94,245,22,135,51,53,31,88,60,28,24,13,0,0,11
S01007847,Occupancy rating +2 or more,35,16,8,8,19,5,14,10,3,1,0,0,0,0,0,0,0,0
S01007847,Occupancy rating +1,174,95,32,63,77,13,46,34,7,5,18,9,9,2,0,0,0,2
S01007847,Occupancy rating 0,172,50,30,20,112,4,59,4,35,20,49,36,13,10,3,0,0,7
S01007847,Occupancy rating -1 or less,56,7,4,3,37,0,16,3,8,5,21,15,6,12,10,0,0,2
S01007848,All households,447,237,65,172,192,17,93,40,45,8,82,64,18,18,8,2,0,8
S01007848,Occupancy rating +2 or more,27,16,2,14,10,0,9,5,2,2,1,0,1,1,0,0,0,1
S01007848,Occupancy rating +1,130,66,17,49,60,12,40,26,12,2,8,7,1,4,0,0,0,4
S01007848,Occupancy rating 0,224,123,35,88,94,3,31,8,21,2,60,46,14,7,2,2,0,3
S01007848,Occupancy rating -1 or less,66,32,11,21,28,2,13,1,10,2,13,11,2,6,6,0,0,0
S01007849,All households,413,128,41,87,273,23,143,54,75,14,107,76,31,12,8,0,0,4
S01007849,Occupancy rating +2 or more,46,24,5,19,22,1,17,12,2,3,4,0,4,0,0,0,0,0
S01007849,Occupancy rating +1,184,87,29,58,96,19,52,32,17,3,25,19,6,1,0,0,0,1
S01007849,Occupancy rating 0,133,15,6,9,116,2,56,9,40,7,58,42,16,2,1,0,0,1
S01007849,Occupancy rating -1 or less,50,2,1,1,39,1,18,1,16,1,20,15,5,9,7,0,0,2
S01007850,All households,293,61,39,22,206,22,109,40,37,32,75,38,37,26,8,0,4,14
S01007850,Occupancy rating +2 or more,113,49,30,19,59,16,40,31,6,3,3,1,2,5,2,0,0,3
S01007850,Occupancy rating +1,95,10,7,3,77,6,38,6,11,21,33,13,20,8,0,0,3,5
S01007850,Occupancy rating 0,68,2,2,0,58,0,24,3,13,8,34,21,13,8,3,0,1,4
S01007850,Occupancy rating -1 or less,17,0,0,0,12,0,7,0,7,0,5,3,2,5,3,0,0,2
S01007851,All households,479,207,152,55,257,62,145,62,54,29,50,26,24,15,7,0,0,8
S01007851,Occupancy rating +2 or more,119,39,26,13,75,20,50,33,11,6,5,2,3,5,3,0,0,2
S01007851,Occupancy rating +1,231,115,82,33,111,39,56,25,22,9,16,7,9,5,3,0,0,2
S01007851,Occupancy rating 0,94,34,28,6,57,0,35,4,19,12,22,14,8,3,1,0,0,2
S01007851,Occupancy rating -1 or less,35,19,16,3,14,3,4,0,2,2,7,3,4,2,0,0,0,2
S01007852,All households,356,170,32,138,170,16,83,33,38,12,71,50,21,16,8,0,2,6
S01007852,Occupancy rating +2 or more,58,27,11,16,31,9,21,14,4,3,1,1,0,0,0,0,0,0
S01007852,Occupancy rating +1,132,86,17,69,42,6,25,14,7,4,11,7,4,4,0,0,1,3
S01007852,Occupancy rating 0,134,50,4,46,81,1,33,4,24,5,47,36,11,3,1,0,1,1
S01007852,Occupancy rating -1 or less,32,7,0,7,16,0,4,1,3,0,12,6,6,9,7,0,0,2
S01007853,All households,413,252,104,148,148,29,67,33,21,13,52,41,11,13,4,3,1,5
S01007853,Occupancy rating +2 or more,33,17,6,11,16,5,11,8,0,3,0,0,0,0,0,0,0,0
S01007853,Occupancy rating +1,127,85,33,52,42,14,26,12,10,4,2,1,1,0,0,0,0,0
S01007853,Occupancy rating 0,199,121,55,66,70,9,24,12,6,6,37,28,9,8,4,2,0,2
S01007853,Occupancy rating -1 or less,54,29,10,19,20,1,6,1,5,0,13,12,1,5,0,1,1,3
S01007854,All households,548,269,90,179,256,13,135,50,58,27,108,88,20,23,7,0,2,14
S01007854,Occupancy rating +2 or more,105,50,11,39,51,4,40,18,15,7,7,5,2,4,2,0,0,2
S01007854,Occupancy rating +1,157,88,23,65,66,6,41,18,14,9,19,16,3,3,0,0,0,3
S01007854,Occupancy rating 0,220,105,41,64,106,3,40,13,18,9,63,50,13,9,1,0,0,8
S01007854,Occupancy rating -1 or less,66,26,15,11,33,0,14,1,11,2,19,17,2,7,4,0,2,1
S01007855,All households,310,197,45,152,101,7,54,26,17,11,40,29,11,12,6,1,3,2
S01007855,Occupancy rating +2 or more,38,20,5,15,18,3,12,6,3,3,3,3,0,0,0,0,0,0
S01007855,Occupancy rating +1,109,82,22,60,27,4,19,14,4,1,4,2,2,0,0,0,0,0
S01007855,Occupancy rating 0,118,74,16,58,40,0,16,4,7,5,24,17,7,4,0,1,3,0
S01007855,Occupancy rating -1 or less,45,21,2,19,16,0,7,2,3,2,9,7,2,8,6,0,0,2
S01007856,All households,348,83,35,48,240,26,149,62,61,26,65,47,18,25,10,0,3,12
S01007856,Occupancy rating +2 or more,137,36,19,17,99,20,69,44,17,8,10,9,1,2,0,0,1,1
S01007856,Occupancy rating +1,114,34,10,24,73,6,46,13,19,14,21,12,9,7,3,0,1,3
S01007856,Occupancy rating 0,71,13,6,7,49,0,27,3,21,3,22,17,5,9,3,0,1,5
S01007856,Occupancy rating -1 or less,26,0,0,0,19,0,7,2,4,1,12,9,3,7,4,0,0,3
S01007857,All households,233,91,36,55,132,12,60,19,30,11,60,44,16,10,5,0,0,5
S01007857,Occupancy rating +2 or more,46,19,10,9,27,8,12,9,1,2,7,4,3,0,0,0,0,0
S01007857,Occupancy rating +1,78,35,9,26,41,3,24,8,12,4,14,11,3,2,1,0,0,1
S01007857,Occupancy rating 0,89,31,15,16,53,1,20,1,14,5,32,24,8,5,2,0,0,3
S01007857,Occupancy rating -1 or less,20,6,2,4,11,0,4,1,3,0,7,5,2,3,2,0,0,1
S01007858,All households,533,244,124,120,277,32,161,75,64,22,84,58,26,12,7,1,0,4
S01007858,Occupancy rating +2 or more,96,43,14,29,51,10,30,26,3,1,11,4,7,2,1,1,0,0
S01007858,Occupancy rating +1,218,102,51,51,114,12,73,38,25,10,29,24,5,2,1,0,0,1
S01007858,Occupancy rating 0,181,82,48,34,96,10,50,7,32,11,36,22,14,3,1,0,0,2
S01007858,Occupancy rating -1 or less,38,17,11,6,16,0,8,4,4,0,8,8,0,5,4,0,0,1
S01007859,All households,246,109,50,59,121,7,59,17,26,16,55,43,12,16,9,0,2,5
S01007859,Occupancy rating +2 or more,40,19,3,16,19,2,14,5,6,3,3,3,0,2,1,0,0,1
S01007859,Occupancy rating +1,82,41,15,26,38,3,23,7,7,9,12,8,4,3,0,0,0,3
S01007859,Occupancy rating 0,81,29,19,10,46,1,16,5,8,3,29,23,6,6,4,0,1,1
S01007859,Occupancy rating -1 or less,43,20,13,7,18,1,6,0,5,1,11,9,2,5,4,0,1,0
S01007860,All households,237,61,7,54,167,6,117,29,75,13,44,33,11,9,7,1,0,1
S01007860,Occupancy rating +2 or more,101,14,0,14,82,3,68,20,47,1,11,10,1,5,4,1,0,0
S01007860,Occupancy rating +1,75,23,2,21,52,3,30,8,15,7,19,11,8,0,0,0,0,0
S01007860,Occupancy rating 0,36,12,1,11,22,0,16,1,11,4,6,5,1,2,1,0,0,1
S01007860,Occupancy rating -1 or less,25,12,4,8,11,0,3,0,2,1,8,7,1,2,2,0,0,0
S01007861,All households,254,48,34,14,190,19,120,43,43,34,51,29,22,16,9,0,3,4
S01007861,Occupancy rating +2 or more,78,21,13,8,57,16,37,36,1,0,4,3,1,0,0,0,0,0
S01007861,Occupancy rating +1,83,13,10,3,67,1,43,5,17,21,23,10,13,3,0,0,2,1
S01007861,Occupancy rating 0,63,8,7,1,50,2,31,0,18,13,17,12,5,5,2,0,1,2
S01007861,Occupancy rating -1 or less,30,6,4,2,16,0,9,2,7,0,7,4,3,8,7,0,0,1
S01007862,All households,308,88,36,52,208,18,125,62,37,26,65,46,19,12,7,0,0,5
S01007862,Occupancy rating +2 or more,113,52,20,32,61,11,48,41,4,3,2,2,0,0,0,0,0,0
S01007862,Occupancy rating +1,90,25,11,14,65,5,41,17,12,12,19,13,6,0,0,0,0,0
S01007862,Occupancy rating 0,83,8,3,5,72,2,31,4,19,8,39,26,13,3,1,0,0,2
S01007862,Occupancy rating -1 or less,22,3,2,1,10,0,5,0,2,3,5,5,0,9,6,0,0,3
S01007863,All households,441,176,46,130,256,16,123,42,61,20,117,91,26,9,6,0,0,3
S01007863,Occupancy rating +2 or more,40,14,6,8,26,2,18,16,1,1,6,4,2,0,0,0,0,0
S01007863,Occupancy rating +1,160,100,22,78,60,11,35,23,8,4,14,7,7,0,0,0,0,0
S01007863,Occupancy rating 0,176,46,14,32,128,3,57,2,42,13,68,58,10,2,1,0,0,1
S01007863,Occupancy rating -1 or less,65,16,4,12,42,0,13,1,10,2,29,22,7,7,5,0,0,2
S01007864,All households,486,210,80,130,263,44,153,70,61,22,66,53,13,13,3,3,3,4
S01007864,Occupancy rating +2 or more,83,37,19,18,45,16,27,20,6,1,2,2,0,1,0,0,0,1
S01007864,Occupancy rating +1,182,83,36,47,97,19,70,41,20,9,8,6,2,2,0,1,0,1
S01007864,Occupancy rating 0,168,78,21,57,85,8,42,9,23,10,35,26,9,5,0,2,2,1
S01007864,Occupancy rating -1 or less,53,12,4,8,36,1,14,0,12,2,21,19,2,5,3,0,1,1
S01007865,All households,229,17,1,16,202,3,181,50,117,14,18,16,2,10,6,1,0,3
S01007865,Occupancy rating +2 or more,187,14,1,13,168,2,153,50,89,14,13,12,1,5,3,0,0,2
S01007865,Occupancy rating +1,28,2,0,2,23,1,18,0,18,0,4,3,1,3,3,0,0,0
S01007865,Occupancy rating 0,12,1,0,1,10,0,9,0,9,0,1,1,0,1,0,1,0,0
S01007865,Occupancy rating -1 or less,2,0,0,0,1,0,1,0,1,0,0,0,0,1,0,0,0,1
S01007866,All households,209,29,4,25,170,3,156,53,83,20,11,10,1,10,4,0,1,5
S01007866,Occupancy rating +2 or more,112,18,1,17,89,1,84,41,33,10,4,3,1,5,1,0,0,4
S01007866,Occupancy rating +1,55,8,2,6,46,2,44,9,28,7,0,0,0,1,1,0,0,0
S01007866,Occupancy rating 0,31,3,1,2,27,0,21,1,18,2,6,6,0,1,1,0,0,0
S01007866,Occupancy rating -1 or less,11,0,0,0,8,0,7,2,4,1,1,1,0,3,1,0,1,1
S01007867,All households,195,47,11,36,144,12,107,51,48,8,25,21,4,4,1,0,0,3
S01007867,Occupancy rating +2 or more,88,22,6,16,65,7,51,28,20,3,7,5,2,1,0,0,0,1
S01007867,Occupancy rating +1,68,20,5,15,46,4,34,19,14,1,8,6,2,2,0,0,0,2
S01007867,Occupancy rating 0,30,5,0,5,24,1,16,4,9,3,7,7,0,1,1,0,0,0
S01007867,Occupancy rating -1 or less,9,0,0,0,9,0,6,0,5,1,3,3,0,0,0,0,0,0
S01007868,All households,351,62,30,32,278,37,216,101,68,47,25,16,9,11,2,0,1,8
S01007868,Occupancy rating +2 or more,218,48,22,26,168,31,132,84,29,19,5,2,3,2,0,0,0,2
S01007868,Occupancy rating +1,88,11,6,5,74,6,59,13,26,20,9,7,2,3,1,0,0,2
S01007868,Occupancy rating 0,38,3,2,1,29,0,19,4,10,5,10,6,4,6,1,0,1,4
S01007868,Occupancy rating -1 or less,7,0,0,0,7,0,6,0,3,3,1,1,0,0,0,0,0,0
S01007869,All households,362,81,28,53,261,28,202,73,94,35,31,24,7,20,5,3,0,12
S01007869,Occupancy rating +2 or more,249,58,24,34,180,21,146,58,64,24,13,7,6,11,3,2,0,6
S01007869,Occupancy rating +1,66,19,4,15,45,6,34,14,12,8,5,5,0,2,1,0,0,1
S01007869,Occupancy rating 0,38,2,0,2,29,1,17,1,14,2,11,10,1,7,1,1,0,5
S01007869,Occupancy rating -1 or less,9,2,0,2,7,0,5,0,4,1,2,2,0,0,0,0,0,0
S01007870,All households,199,37,13,24,150,14,124,54,50,20,12,4,8,12,5,0,0,7
S01007870,Occupancy rating +2 or more,109,21,7,14,84,6,72,47,17,8,6,1,5,4,2,0,0,2
S01007870,Occupancy rating +1,55,13,5,8,39,8,30,7,18,5,1,1,0,3,0,0,0,3
S01007870,Occupancy rating 0,23,2,1,1,18,0,14,0,8,6,4,2,2,3,1,0,0,2
S01007870,Occupancy rating -1 or less,12,1,0,1,9,0,8,0,7,1,1,0,1,2,2,0,0,0
S01007871,All households,285,86,36,50,183,25,109,32,46,31,49,38,11,16,1,0,1,14
S01007871,Occupancy rating +2 or more,81,33,18,15,47,14,29,18,7,4,4,2,2,1,0,0,0,1
S01007871,Occupancy rating +1,111,38,12,26,67,10,38,12,10,16,19,15,4,6,0,0,0,6
S01007871,Occupancy rating 0,68,11,4,7,51,1,31,1,20,10,19,14,5,6,0,0,1,5
S01007871,Occupancy rating -1 or less,25,4,2,2,18,0,11,1,9,1,7,7,0,3,1,0,0,2
S01007872,All households,322,115,31,84,197,14,111,44,43,24,72,51,21,10,5,0,0,5
S01007872,Occupancy rating +2 or more,104,53,19,34,51,9,40,31,5,4,2,2,0,0,0,0,0,0
S01007872,Occupancy rating +1,124,51,9,42,70,2,37,12,10,15,31,20,11,3,1,0,0,2
S01007872,Occupancy rating 0,66,6,2,4,56,2,25,0,22,3,29,23,6,4,2,0,0,2
S01007872,Occupancy rating -1 or less,28,5,1,4,20,1,9,1,6,2,10,6,4,3,2,0,0,1
S01007873,All households,295,102,62,40,182,18,133,60,46,27,31,20,11,11,4,0,1,6
S01007873,Occupancy rating +2 or more,95,28,17,11,64,12,49,33,12,4,3,2,1,3,0,0,0,3
S01007873,Occupancy rating +1,91,37,18,19,53,6,41,19,10,12,6,3,3,1,0,0,1,0
S01007873,Occupancy rating 0,90,37,27,10,49,0,36,8,19,9,13,6,7,4,1,0,0,3
S01007873,Occupancy rating -1 or less,19,0,0,0,16,0,7,0,5,2,9,9,0,3,3,0,0,0
S01007874,All households,367,148,87,61,208,29,137,61,47,29,42,24,18,11,4,0,0,7
S01007874,Occupancy rating +2 or more,101,38,22,16,62,15,43,27,6,10,4,2,2,1,0,0,0,1
S01007874,Occupancy rating +1,137,72,44,28,64,11,46,27,15,4,7,3,4,1,0,0,0,1
S01007874,Occupancy rating 0,104,27,13,14,71,2,41,6,22,13,28,18,10,6,3,0,0,3
S01007874,Occupancy rating -1 or less,25,11,8,3,11,1,7,1,4,2,3,1,2,3,1,0,0,2
S01007875,All households,242,78,30,48,152,16,99,44,35,20,37,21,16,12,7,0,0,5
S01007875,Occupancy rating +2 or more,90,37,14,23,50,8,38,27,7,4,4,0,4,3,1,0,0,2
S01007875,Occupancy rating +1,73,25,12,13,46,6,31,15,9,7,9,5,4,2,1,0,0,1
S01007875,Occupancy rating 0,59,10,2,8,43,2,22,2,13,7,19,12,7,6,5,0,0,1
S01007875,Occupancy rating -1 or less,20,6,2,4,13,0,8,0,6,2,5,4,1,1,0,0,0,1
S01007876,All households,420,111,42,69,291,34,206,87,97,22,51,37,14,18,7,0,0,11
S01007876,Occupancy rating +2 or more,184,52,21,31,128,22,99,64,26,9,7,6,1,4,0,0,0,4
S01007876,Occupancy rating +1,131,45,17,28,83,11,53,19,27,7,19,10,9,3,0,0,0,3
S01007876,Occupancy rating 0,84,12,4,8,64,1,44,3,37,4,19,16,3,8,4,0,0,4
S01007876,Occupancy rating -1 or less,21,2,0,2,16,0,10,1,7,2,6,5,1,3,3,0,0,0
S01007877,All households,336,104,55,49,216,31,149,64,62,23,36,19,17,16,5,0,3,8
S01007877,Occupancy rating +2 or more,124,38,21,17,83,21,58,47,8,3,4,2,2,3,2,0,0,1
S01007877,Occupancy rating +1,100,39,18,21,58,3,44,13,17,14,11,3,8,3,0,0,2,1
S01007877,Occupancy rating 0,90,24,15,9,61,7,34,3,25,6,20,14,6,5,3,0,1,1
S01007877,Occupancy rating -1 or less,22,3,1,2,14,0,13,1,12,0,1,0,1,5,0,0,0,5
S01007878,All households,281,104,38,66,161,16,98,45,32,21,47,34,13,16,9,0,1,6
S01007878,Occupancy rating +2 or more,71,30,13,17,39,8,26,17,4,5,5,3,2,2,2,0,0,0
S01007878,Occupancy rating +1,123,55,16,39,64,7,41,23,9,9,16,11,5,4,2,0,1,1
S01007878,Occupancy rating 0,66,13,6,7,46,1,25,4,14,7,20,16,4,7,5,0,0,2
S01007878,Occupancy rating -1 or less,21,6,3,3,12,0,6,1,5,0,6,4,2,3,0,0,0,3
S01007879,All households,320,82,30,52,225,23,140,58,62,20,62,49,13,13,4,0,2,7
S01007879,Occupancy rating +2 or more,126,48,18,30,76,16,52,38,9,5,8,5,3,2,0,0,0,2
S01007879,Occupancy rating +1,104,29,9,20,72,6,46,17,19,10,20,17,3,3,0,0,2,1
S01007879,Occupancy rating 0,75,4,3,1,63,0,37,3,30,4,26,21,5,8,4,0,0,4
S01007879,Occupancy rating -1 or less,15,1,0,1,14,1,5,0,4,1,8,6,2,0,0,0,0,0
S01007880,All households,178,59,25,34,109,8,91,54,23,14,10,5,5,10,4,0,1,5
S01007880,Occupancy rating +2 or more,112,33,18,15,71,6,62,37,17,8,3,1,2,8,3,0,0,5
S01007880,Occupancy rating +1,37,17,6,11,19,2,15,11,1,3,2,1,1,1,0,0,1,0
S01007880,Occupancy rating 0,20,6,0,6,13,0,9,5,3,1,4,3,1,1,1,0,0,0
S01007880,Occupancy rating -1 or less,9,3,1,2,6,0,5,1,2,2,1,0,1,0,0,0,0,0
S01007881,All households,244,83,31,52,150,21,108,35,50,23,21,11,10,11,7,0,0,4
S01007881,Occupancy rating +2 or more,90,28,10,18,60,10,47,24,17,6,3,1,2,2,1,0,0,1
S01007881,Occupancy rating +1,88,44,16,28,43,9,28,7,13,8,6,2,4,1,1,0,0,0
S01007881,Occupancy rating 0,49,6,4,2,40,2,28,4,17,7,10,6,4,3,2,0,0,1
S01007881,Occupancy rating -1 or less,17,5,1,4,7,0,5,0,3,2,2,2,0,5,3,0,0,2
S01007882,All households,268,29,10,19,222,17,192,89,76,27,13,6,7,17,8,0,1,8
S01007882,Occupancy rating +2 or more,192,19,7,12,162,14,143,78,49,16,5,2,3,11,4,0,1,6
S01007882,Occupancy rating +1,42,7,3,4,32,2,25,7,11,7,5,2,3,3,1,0,0,2
S01007882,Occupancy rating 0,27,3,0,3,22,1,18,3,12,3,3,2,1,2,2,0,0,0
S01007882,Occupancy rating -1 or less,7,0,0,0,6,0,6,1,4,1,0,0,0,1,1,0,0,0
S01007883,All households,468,134,61,73,319,35,236,114,90,32,48,30,18,15,5,0,0,10
S01007883,Occupancy rating +2 or more,218,51,25,26,164,23,136,91,32,13,5,3,2,3,2,0,0,1
S01007883,Occupancy rating +1,121,46,22,24,71,10,48,19,20,9,13,8,5,4,1,0,0,3
S01007883,Occupancy rating 0,105,31,13,18,68,2,44,3,31,10,22,15,7,6,1,0,0,5
S01007883,Occupancy rating -1 or less,24,6,1,5,16,0,8,1,7,0,8,4,4,2,1,0,0,1
S01007884,All households,269,68,32,36,190,25,132,47,61,24,33,25,8,11,7,0,1,3
S01007884,Occupancy rating +2 or more,75,24,12,12,50,9,40,20,9,11,1,0,1,1,0,0,1,0
S01007884,Occupancy rating +1,94,31,15,16,63,12,43,26,11,6,8,7,1,0,0,0,0,0
S01007884,Occupancy rating 0,74,11,5,6,57,3,40,0,34,6,14,10,4,6,3,0,0,3
S01007884,Occupancy rating -1 or less,26,2,0,2,20,1,9,1,7,1,10,8,2,4,4,0,0,0
S01007885,All households,345,126,49,77,204,26,121,53,48,20,57,37,20,15,3,0,2,10
S01007885,Occupancy rating +2 or more,73,27,10,17,40,12,27,17,5,5,1,0,1,6,0,0,1,5
S01007885,Occupancy rating +1,131,58,20,38,70,12,49,32,10,7,9,5,4,3,1,0,1,1
S01007885,Occupancy rating 0,103,36,16,20,64,2,30,4,19,7,32,20,12,3,1,0,0,2
S01007885,Occupancy rating -1 or less,38,5,3,2,30,0,15,0,14,1,15,12,3,3,1,0,0,2
S01007886,All households,433,186,65,121,230,34,167,77,67,23,29,19,10,17,4,0,3,10
S01007886,Occupancy rating +2 or more,157,44,16,28,108,24,78,37,31,10,6,2,4,5,0,0,1,4
S01007886,Occupancy rating +1,123,56,26,30,62,4,48,29,14,5,10,7,3,5,1,0,2,2
S01007886,Occupancy rating 0,111,69,18,51,41,3,29,7,16,6,9,7,2,1,0,0,0,1
S01007886,Occupancy rating -1 or less,42,17,5,12,19,3,12,4,6,2,4,3,1,6,3,0,0,3
S01007887,All households,230,65,30,35,153,21,125,48,49,28,7,3,4,12,7,0,1,4
S01007887,Occupancy rating +2 or more,152,40,18,22,106,15,89,34,37,18,2,1,1,6,3,0,1,2
S01007887,Occupancy rating +1,47,12,5,7,34,5,26,13,6,7,3,2,1,1,1,0,0,0
S01007887,Occupancy rating 0,21,9,4,5,8,0,7,1,3,3,1,0,1,4,3,0,0,1
S01007887,Occupancy rating -1 or less,10,4,3,1,5,1,3,0,3,0,1,0,1,1,0,0,0,1
S01007888,All households,451,116,45,71,322,23,208,75,92,41,91,65,26,13,5,0,0,8
S01007888,Occupancy rating +2 or more,123,37,14,23,83,13,59,44,8,7,11,8,3,3,1,0,0,2
S01007888,Occupancy rating +1,164,62,18,44,100,8,65,24,23,18,27,16,11,2,1,0,0,1
S01007888,Occupancy rating 0,125,9,8,1,112,2,66,1,55,10,44,32,12,4,1,0,0,3
S01007888,Occupancy rating -1 or less,39,8,5,3,27,0,18,6,6,6,9,9,0,4,2,0,0,2
S01007889,All households,242,76,36,40,154,28,90,36,35,19,36,21,15,12,5,0,0,7
S01007889,Occupancy rating +2 or more,70,29,12,17,39,9,27,19,6,2,3,1,2,2,0,0,0,2
S01007889,Occupancy rating +1,88,33,19,14,50,12,29,14,8,7,9,5,4,5,3,0,0,2
S01007889,Occupancy rating 0,58,9,5,4,47,3,26,2,15,9,18,12,6,2,0,0,0,2
S01007889,Occupancy rating -1 or less,26,5,0,5,18,4,8,1,6,1,6,3,3,3,2,0,0,1
S01007890,All households,300,60,22,38,222,36,156,66,64,26,30,19,11,18,11,0,1,6
S01007890,Occupancy rating +2 or more,131,38,15,23,88,24,62,47,13,2,2,1,1,5,3,0,0,2
S01007890,Occupancy rating +1,94,18,6,12,75,10,56,17,19,20,9,5,4,1,0,0,1,0
S01007890,Occupancy rating 0,60,4,1,3,49,1,32,2,27,3,16,10,6,7,4,0,0,3
S01007890,Occupancy rating -1 or less,15,0,0,0,10,1,6,0,5,1,3,3,0,5,4,0,0,1
S01007891,All households,370,106,55,51,251,35,184,74,79,31,32,20,12,13,7,0,2,4
S01007891,Occupancy rating +2 or more,137,25,12,13,106,23,80,44,29,7,3,3,0,6,2,0,1,3
S01007891,Occupancy rating +1,124,42,19,23,79,10,62,28,20,14,7,3,4,3,2,0,0,1
S01007891,Occupancy rating 0,83,32,21,11,48,1,29,1,20,8,18,13,5,3,2,0,1,0
S01007891,Occupancy rating -1 or less,26,7,3,4,18,1,13,1,10,2,4,1,3,1,1,0,0,0
S01007892,All households,341,108,42,66,226,47,158,73,55,30,21,16,5,7,1,0,1,5
S01007892,Occupancy rating +2 or more,174,43,26,17,127,29,95,56,27,12,3,0,3,4,0,0,1,3
S01007892,Occupancy rating +1,101,43,13,30,56,15,37,16,9,12,4,3,1,2,1,0,0,1
S01007892,Occupancy rating 0,52,21,3,18,31,2,19,1,14,4,10,9,1,0,0,0,0,0
S01007892,Occupancy rating -1 or less,14,1,0,1,12,1,7,0,5,2,4,4,0,1,0,0,0,1
S01007893,All households,423,95,48,47,315,54,219,82,95,42,42,23,19,13,3,0,0,10
S01007893,Occupancy rating +2 or more,258,57,32,25,197,45,140,64,53,23,12,7,5,4,0,0,0,4
S01007893,Occupancy rating +1,96,23,8,15,69,7,48,17,18,13,14,9,5,4,0,0,0,4
S01007893,Occupancy rating 0,55,11,6,5,41,2,27,1,20,6,12,3,9,3,1,0,0,2
S01007893,Occupancy rating -1 or less,14,4,2,2,8,0,4,0,4,0,4,4,0,2,2,0,0,0
S01007894,All households,386,101,57,44,268,34,184,66,81,37,50,31,19,17,11,0,1,5
S01007894,Occupancy rating +2 or more,133,46,27,19,87,19,63,43,16,4,5,3,2,0,0,0,0,0
S01007894,Occupancy rating +1,124,40,23,17,78,13,51,21,20,10,14,9,5,6,1,0,1,4
S01007894,Occupancy rating 0,101,12,6,6,85,1,55,2,32,21,29,17,12,4,3,0,0,1
S01007894,Occupancy rating -1 or less,28,3,1,2,18,1,15,0,13,2,2,2,0,7,7,0,0,0
S01007895,All households,249,82,51,31,160,29,110,44,40,26,21,13,8,7,4,0,1,2
S01007895,Occupancy rating +2 or more,127,30,21,9,93,23,67,30,20,17,3,2,1,4,1,0,1,2
S01007895,Occupancy rating +1,55,24,12,12,30,5,19,9,4,6,6,3,3,1,1,0,0,0
S01007895,Occupancy rating 0,54,26,17,9,28,1,19,5,12,2,8,6,2,0,0,0,0,0
S01007895,Occupancy rating -1 or less,13,2,1,1,9,0,5,0,4,1,4,2,2,2,2,0,0,0
S01007896,All households,387,130,58,72,241,26,143,53,63,27,72,47,25,16,6,0,5,5
S01007896,Occupancy rating +2 or more,68,25,16,9,43,9,29,23,5,1,5,4,1,0,0,0,0,0
S01007896,Occupancy rating +1,150,71,21,50,76,9,47,27,10,10,20,9,11,3,1,0,1,1
S01007896,Occupancy rating 0,124,21,12,9,93,7,49,3,35,11,37,27,10,10,4,0,3,3
S01007896,Occupancy rating -1 or less,45,13,9,4,29,1,18,0,13,5,10,7,3,3,1,0,1,1
S01007897,All households,165,31,11,20,121,16,95,33,44,18,10,3,7,13,5,0,1,7
S01007897,Occupancy rating +2 or more,115,18,8,10,87,11,71,30,30,11,5,1,4,10,3,0,1,6
S01007897,Occupancy rating +1,31,10,3,7,21,4,15,2,9,4,2,0,2,0,0,0,0,0
S01007897,Occupancy rating 0,14,3,0,3,9,1,6,0,3,3,2,1,1,2,1,0,0,1
S01007897,Occupancy rating -1 or less,5,0,0,0,4,0,3,1,2,0,1,1,0,1,1,0,0,0
S01007898,All households,166,25,9,16,136,16,110,43,44,23,10,4,6,5,3,0,0,2
S01007898,Occupancy rating +2 or more,115,16,4,12,97,12,78,37,26,15,7,2,5,2,1,0,0,1
S01007898,Occupancy rating +1,23,9,5,4,13,1,12,4,4,4,0,0,0,1,1,0,0,0
S01007898,Occupancy rating 0,22,0,0,0,20,1,16,1,11,4,3,2,1,2,1,0,0,1
S01007898,Occupancy rating -1 or less,6,0,0,0,6,2,4,1,3,0,0,0,0,0,0,0,0,0
S01007899,All households,145,39,9,30,100,16,76,28,29,19,8,2,6,6,1,0,0,5
S01007899,Occupancy rating +2 or more,91,15,3,12,72,13,54,23,18,13,5,1,4,4,1,0,0,3
S01007899,Occupancy rating +1,32,18,5,13,13,2,10,5,2,3,1,0,1,1,0,0,0,1
S01007899,Occupancy rating 0,14,3,1,2,11,1,8,0,5,3,2,1,1,0,0,0,0,0
S01007899,Occupancy rating -1 or less,8,3,0,3,4,0,4,0,4,0,0,0,0,1,0,0,0,1
S01007900,All households,232,74,35,39,149,28,88,27,34,27,33,22,11,9,4,0,0,5
S01007900,Occupancy rating +2 or more,104,38,20,18,63,23,31,20,4,7,9,6,3,3,0,0,0,3
S01007900,Occupancy rating +1,70,26,9,17,41,4,28,5,11,12,9,4,5,3,1,0,0,2
S01007900,Occupancy rating 0,39,10,6,4,29,1,20,2,15,3,8,7,1,0,0,0,0,0
S01007900,Occupancy rating -1 or less,19,0,0,0,16,0,9,0,4,5,7,5,2,3,3,0,0,0
S01007901,All households,317,106,60,46,202,24,138,50,64,24,40,24,16,9,2,0,0,7
S01007901,Occupancy rating +2 or more,93,31,16,15,58,13,38,26,9,3,7,3,4,4,1,0,0,3
S01007901,Occupancy rating +1,105,38,17,21,65,6,49,23,15,11,10,4,6,2,0,0,0,2
S01007901,Occupancy rating 0,97,29,25,4,66,4,41,1,31,9,21,15,6,2,1,0,0,1
S01007901,Occupancy rating -1 or less,22,8,2,6,13,1,10,0,9,1,2,2,0,1,0,0,0,1
S01007902,All households,394,124,52,72,252,29,168,69,62,37,55,34,21,18,9,0,1,8
S01007902,Occupancy rating +2 or more,153,70,31,39,81,23,52,47,4,1,6,3,3,2,1,0,0,1
S01007902,Occupancy rating +1,136,41,16,25,89,4,63,15,25,23,22,12,10,6,2,0,0,4
S01007902,Occupancy rating 0,79,10,4,6,62,2,37,5,23,9,23,16,7,7,5,0,1,1
S01007902,Occupancy rating -1 or less,26,3,1,2,20,0,16,2,10,4,4,3,1,3,1,0,0,2
S01007903,All households,322,129,67,62,180,32,128,63,41,24,20,14,6,13,6,0,1,6
S01007903,Occupancy rating +2 or more,100,28,13,15,69,17,51,38,8,5,1,0,1,3,1,0,1,1
S01007903,Occupancy rating +1,124,64,34,30,57,9,41,20,15,6,7,6,1,3,1,0,0,2
S01007903,Occupancy rating 0,69,23,16,7,42,4,28,4,13,11,10,6,4,4,1,0,0,3
S01007903,Occupancy rating -1 or less,29,14,4,10,12,2,8,1,5,2,2,2,0,3,3,0,0,0
S01007904,All households,312,61,25,36,228,36,175,77,66,32,17,10,7,23,12,0,2,9
S01007904,Occupancy rating +2 or more,204,37,17,20,155,25,126,61,44,21,4,2,2,12,4,0,0,8
S01007904,Occupancy rating +1,57,13,4,9,41,8,28,13,8,7,5,3,2,3,2,0,1,0
S01007904,Occupancy rating 0,35,10,4,6,20,2,13,3,9,1,5,3,2,5,3,0,1,1
S01007904,Occupancy rating -1 or less,16,1,0,1,12,1,8,0,5,3,3,2,1,3,3,0,0,0
S01007905,All households,292,77,21,56,202,22,124,39,56,29,56,45,11,13,6,0,2,5
S01007905,Occupancy rating +2 or more,59,22,9,13,36,10,23,12,6,5,3,3,0,1,0,0,1,0
S01007905,Occupancy rating +1,136,51,10,41,83,10,56,22,19,15,17,15,2,2,0,0,1,1
S01007905,Occupancy rating 0,69,3,2,1,63,2,33,3,25,5,28,21,7,3,1,0,0,2
S01007905,Occupancy rating -1 or less,28,1,0,1,20,0,12,2,6,4,8,6,2,7,5,0,0,2
S01007906,All households,382,161,92,69,204,40,109,53,33,23,55,32,23,17,3,0,1,13
S01007906,Occupancy rating +2 or more,57,21,11,10,35,11,23,18,4,1,1,1,0,1,0,0,0,1
S01007906,Occupancy rating +1,178,95,44,51,78,21,44,31,4,9,13,7,6,5,0,0,1,4
S01007906,Occupancy rating 0,121,36,30,6,77,5,38,3,22,13,34,19,15,8,2,0,0,6
S01007906,Occupancy rating -1 or less,26,9,7,2,14,3,4,1,3,0,7,5,2,3,1,0,0,2
S01007907,All households,254,85,49,36,162,30,100,39,31,30,32,14,18,7,1,0,1,5
S01007907,Occupancy rating +2 or more,80,32,21,11,47,12,29,17,5,7,6,2,4,1,0,0,1,0
S01007907,Occupancy rating +1,86,27,16,11,57,10,41,17,9,15,6,3,3,2,0,0,0,2
S01007907,Occupancy rating 0,68,21,10,11,45,5,26,3,17,6,14,7,7,2,0,0,0,2
S01007907,Occupancy rating -1 or less,20,5,2,3,13,3,4,2,0,2,6,2,4,2,1,0,0,1
S01007908,All households,419,126,85,41,272,44,187,84,68,35,41,19,22,21,4,0,2,15
S01007908,Occupancy rating +2 or more,162,35,23,12,124,21,94,51,29,14,9,5,4,3,0,0,0,3
S01007908,Occupancy rating +1,152,65,42,23,82,14,54,26,19,9,14,7,7,5,2,0,0,3
S01007908,Occupancy rating 0,72,14,13,1,50,9,29,5,15,9,12,5,7,8,1,0,1,6
S01007908,Occupancy rating -1 or less,33,12,7,5,16,0,10,2,5,3,6,2,4,5,1,0,1,3
S01007909,All households,226,64,23,41,153,12,109,34,59,16,32,24,8,9,5,0,0,4
S01007909,Occupancy rating +2 or more,63,27,10,17,36,9,24,17,7,0,3,2,1,0,0,0,0,0
S01007909,Occupancy rating +1,91,36,12,24,53,1,43,16,19,8,9,6,3,2,0,0,0,2
S01007909,Occupancy rating 0,52,1,1,0,49,1,32,1,25,6,16,12,4,2,1,0,0,1
S01007909,Occupancy rating -1 or less,20,0,0,0,15,1,10,0,8,2,4,4,0,5,4,0,0,1
S01007910,All households,369,88,37,51,263,17,146,43,80,23,100,71,29,18,6,1,0,11
S01007910,Occupancy rating +2 or more,140,67,29,38,71,15,48,34,10,4,8,5,3,2,1,0,0,1
S01007910,Occupancy rating +1,137,14,6,8,113,2,53,9,31,13,58,42,16,10,4,0,0,6
S01007910,Occupancy rating 0,68,7,2,5,58,0,33,0,28,5,25,18,7,3,0,0,0,3
S01007910,Occupancy rating -1 or less,24,0,0,0,21,0,12,0,11,1,9,6,3,3,1,1,0,1
S01007911,All households,348,115,58,57,218,25,149,56,67,26,44,30,14,15,7,0,1,7
S01007911,Occupancy rating +2 or more,119,36,19,17,81,14,59,34,21,4,8,6,2,2,1,0,0,1
S01007911,Occupancy rating +1,123,47,17,30,74,5,53,16,26,11,16,10,6,2,1,0,0,1
S01007911,Occupancy rating 0,87,27,19,8,50,5,28,4,14,10,17,13,4,10,5,0,1,4
S01007911,Occupancy rating -1 or less,19,5,3,2,13,1,9,2,6,1,3,1,2,1,0,0,0,1
S01007912,All households,346,104,39,65,227,43,151,61,61,29,33,14,19,15,3,0,1,11
S01007912,Occupancy rating +2 or more,121,35,17,18,84,25,57,36,16,5,2,0,2,2,0,0,0,2
S01007912,Occupancy rating +1,115,54,15,39,58,12,41,21,10,10,5,1,4,3,0,0,0,3
S01007912,Occupancy rating 0,88,8,4,4,71,4,45,4,29,12,22,11,11,9,3,0,1,5
S01007912,Occupancy rating -1 or less,22,7,3,4,14,2,8,0,6,2,4,2,2,1,0,0,0,1
S01007913,All households,304,119,53,66,177,20,110,48,44,18,47,29,18,8,2,0,0,6
S01007913,Occupancy rating +2 or more,58,16,8,8,41,4,30,18,4,8,7,7,0,1,0,0,0,1
S01007913,Occupancy rating +1,116,61,21,40,54,8,38,21,12,5,8,5,3,1,1,0,0,0
S01007913,Occupancy rating 0,99,31,14,17,65,8,30,7,20,3,27,14,13,3,0,0,0,3
S01007913,Occupancy rating -1 or less,31,11,10,1,17,0,12,2,8,2,5,3,2,3,1,0,0,2
S01007914,All households,279,92,34,58,180,22,105,33,49,23,53,28,25,7,5,0,0,2
S01007914,Occupancy rating +2 or more,71,32,11,21,39,5,25,17,5,3,9,5,4,0,0,0,0,0
S01007914,Occupancy rating +1,103,42,13,29,59,14,31,16,10,5,14,8,6,2,2,0,0,0
S01007914,Occupancy rating 0,75,15,9,6,57,3,32,0,23,9,22,10,12,3,1,0,0,2
S01007914,Occupancy rating -1 or less,30,3,1,2,25,0,17,0,11,6,8,5,3,2,2,0,0,0
S01007915,All households,361,101,41,60,245,29,170,62,76,32,46,33,13,15,6,0,0,9
S01007915,Occupancy rating +2 or more,104,27,11,16,75,10,62,36,13,13,3,3,0,2,0,0,0,2
S01007915,Occupancy rating +1,136,51,14,37,82,17,55,23,25,7,10,7,3,3,1,0,0,2
S01007915,Occupancy rating 0,91,15,12,3,72,1,44,1,32,11,27,20,7,4,0,0,0,4
S01007915,Occupancy rating -1 or less,30,8,4,4,16,1,9,2,6,1,6,3,3,6,5,0,0,1
S01007916,All households,399,163,96,67,220,45,143,63,52,28,32,22,10,16,5,0,4,7
S01007916,Occupancy rating +2 or more,130,52,29,23,76,19,55,38,14,3,2,1,1,2,0,0,1,1
S01007916,Occupancy rating +1,148,59,32,27,83,23,47,20,14,13,13,6,7,6,0,0,3,3
S01007916,Occupancy rating 0,92,41,26,15,45,1,31,5,16,10,13,11,2,6,3,0,0,3
S01007916,Occupancy rating -1 or less,29,11,9,2,16,2,10,0,8,2,4,4,0,2,2,0,0,0
S01007917,All households,369,107,34,73,246,36,168,82,55,31,42,21,21,16,8,0,0,8
S01007917,Occupancy rating +2 or more,149,40,16,24,108,25,79,61,8,10,4,2,2,1,1,0,0,0
S01007917,Occupancy rating +1,116,36,15,21,76,10,49,17,20,12,17,6,11,4,1,0,0,3
S01007917,Occupancy rating 0,77,24,2,22,47,1,31,3,20,8,15,9,6,6,3,0,0,3
S01007917,Occupancy rating -1 or less,27,7,1,6,15,0,9,1,7,1,6,4,2,5,3,0,0,2
S01007918,All households,446,198,84,114,226,26,165,67,69,29,35,21,14,22,10,0,2,10
S01007918,Occupancy rating +2 or more,155,49,21,28,104,14,85,43,29,13,5,3,2,2,1,0,0,1
S01007918,Occupancy rating +1,138,65,19,46,65,9,46,17,20,9,10,5,5,8,5,0,0,3
S01007918,Occupancy rating 0,110,56,24,32,46,3,27,6,15,6,16,11,5,8,2,0,1,5
S01007918,Occupancy rating -1 or less,43,28,20,8,11,0,7,1,5,1,4,2,2,4,2,0,1,1
S01007919,All households,303,60,39,21,230,24,192,77,80,35,14,6,8,13,6,0,2,5
S01007919,Occupancy rating +2 or more,193,33,20,13,155,18,131,57,55,19,6,1,5,5,2,0,0,3
S01007919,Occupancy rating +1,85,24,17,7,58,6,48,20,14,14,4,2,2,3,1,0,1,1
S01007919,Occupancy rating 0,14,1,1,0,10,0,8,0,7,1,2,2,0,3,2,0,0,1
S01007919,Occupancy rating -1 or less,11,2,1,1,7,0,5,0,4,1,2,1,1,2,1,0,1,0
S01007920,All households,245,46,19,27,190,30,138,57,63,18,22,13,9,9,3,0,0,6
S01007920,Occupancy rating +2 or more,136,32,12,20,102,20,75,41,27,7,7,5,2,2,1,0,0,1
S01007920,Occupancy rating +1,62,12,7,5,46,8,32,13,16,3,6,4,2,4,1,0,0,3
S01007920,Occupancy rating 0,40,2,0,2,37,2,27,3,16,8,8,4,4,1,0,0,0,1
S01007920,Occupancy rating -1 or less,7,0,0,0,5,0,4,0,4,0,1,0,1,2,1,0,0,1
S01007921,All households,422,150,79,71,252,24,163,62,71,30,65,40,25,20,7,0,2,11
S01007921,Occupancy rating +2 or more,61,33,18,15,28,2,25,15,7,3,1,0,1,0,0,0,0,0
S01007921,Occupancy rating +1,170,69,23,46,95,15,62,42,10,10,18,10,8,6,1,0,1,4
S01007921,Occupancy rating 0,140,37,32,5,95,5,59,2,41,16,31,17,14,8,1,0,1,6
S01007921,Occupancy rating -1 or less,51,11,6,5,34,2,17,3,13,1,15,13,2,6,5,0,0,1
S01007922,All households,386,134,54,80,230,22,136,47,57,32,72,46,26,22,11,0,0,11
S01007922,Occupancy rating +2 or more,85,22,13,9,57,14,36,25,4,7,7,3,4,6,2,0,0,4
S01007922,Occupancy rating +1,155,87,33,54,65,6,44,18,15,11,15,7,8,3,2,0,0,1
S01007922,Occupancy rating 0,100,16,4,12,78,0,37,3,21,13,41,28,13,6,3,0,0,3
S01007922,Occupancy rating -1 or less,46,9,4,5,30,2,19,1,17,1,9,8,1,7,4,0,0,3
S01007923,All households,412,113,46,67,283,30,220,101,81,38,33,18,15,16,9,0,1,6
S01007923,Occupancy rating +2 or more,160,44,17,27,108,11,93,58,26,9,4,3,1,8,3,0,1,4
S01007923,Occupancy rating +1,146,45,18,27,98,15,72,27,30,15,11,5,6,3,3,0,0,0
S01007923,Occupancy rating 0,80,22,10,12,56,4,40,14,17,9,12,7,5,2,1,0,0,1
S01007923,Occupancy rating -1 or less,26,2,1,1,21,0,15,2,8,5,6,3,3,3,2,0,0,1
S01007924,All households,430,146,48,98,258,28,164,66,69,29,66,46,20,26,17,0,2,7
S01007924,Occupancy rating +2 or more,142,38,13,25,99,16,72,44,23,5,11,6,5,5,4,0,1,0
S01007924,Occupancy rating +1,146,72,21,51,71,11,46,15,16,15,14,8,6,3,1,0,0,2
S01007924,Occupancy rating 0,102,27,9,18,65,1,37,7,23,7,27,20,7,10,6,0,0,4
S01007924,Occupancy rating -1 or less,40,9,5,4,23,0,9,0,7,2,14,12,2,8,6,0,1,1
S01007925,All households,176,25,10,15,139,15,115,53,38,24,9,6,3,12,5,0,1,6
S01007925,Occupancy rating +2 or more,140,17,8,9,113,12,95,47,29,19,6,5,1,10,4,0,1,5
S01007925,Occupancy rating +1,23,6,2,4,15,3,11,3,5,3,1,1,0,2,1,0,0,1
S01007925,Occupancy rating 0,11,1,0,1,10,0,8,3,3,2,2,0,2,0,0,0,0,0
S01007925,Occupancy rating -1 or less,2,1,0,1,1,0,1,0,1,0,0,0,0,0,0,0,0,0
S01007926,All households,175,20,7,13,146,17,122,56,47,19,7,5,2,9,6,0,0,3
S01007926,Occupancy rating +2 or more,132,18,7,11,109,16,90,50,30,10,3,2,1,5,2,0,0,3
S01007926,Occupancy rating +1,28,1,0,1,25,1,21,4,9,8,3,2,1,2,2,0,0,0
S01007926,Occupancy rating 0,11,1,0,1,9,0,9,2,6,1,0,0,0,1,1,0,0,0
S01007926,Occupancy rating -1 or less,4,0,0,0,3,0,2,0,2,0,1,1,0,1,1,0,0,0
S01007927,All households,237,49,18,31,176,19,145,52,59,34,12,3,9,12,5,0,1,6
S01007927,Occupancy rating +2 or more,187,40,15,25,139,16,120,47,45,28,3,0,3,8,3,0,1,4
S01007927,Occupancy rating +1,32,5,3,2,25,3,18,3,10,5,4,1,3,2,1,0,0,1
S01007927,Occupancy rating 0,12,1,0,1,9,0,6,2,3,1,3,1,2,2,1,0,0,1
S01007927,Occupancy rating -1 or less,6,3,0,3,3,0,1,0,1,0,2,1,1,0,0,0,0,0
S01007928,All households,418,107,49,58,295,40,218,93,93,32,37,24,13,16,4,0,3,9
S01007928,Occupancy rating +2 or more,242,56,32,24,183,31,144,76,57,11,8,6,2,3,1,0,1,1
S01007928,Occupancy rating +1,91,28,11,17,59,7,39,13,14,12,13,6,7,4,0,0,1,3
S01007928,Occupancy rating 0,62,19,4,15,40,2,24,4,13,7,14,11,3,3,1,0,0,2
S01007928,Occupancy rating -1 or less,23,4,2,2,13,0,11,0,9,2,2,1,1,6,2,0,1,3
S01007929,All households,268,47,18,29,204,11,182,70,77,35,11,6,5,17,9,0,0,8
S01007929,Occupancy rating +2 or more,198,36,14,22,152,8,141,63,54,24,3,0,3,10,4,0,0,6
S01007929,Occupancy rating +1,38,7,4,3,28,3,23,3,14,6,2,1,1,3,2,0,0,1
S01007929,Occupancy rating 0,20,4,0,4,14,0,11,4,3,4,3,3,0,2,1,0,0,1
S01007929,Occupancy rating -1 or less,12,0,0,0,10,0,7,0,6,1,3,2,1,2,2,0,0,0
S01007930,All households,216,24,10,14,181,18,152,70,63,19,11,5,6,11,6,0,0,5
S01007930,Occupancy rating +2 or more,161,16,9,7,136,13,118,62,45,11,5,2,3,9,6,0,0,3
S01007930,Occupancy rating +1,36,6,1,5,28,5,20,6,11,3,3,1,2,2,0,0,0,2
S01007930,Occupancy rating 0,12,0,0,0,12,0,10,1,5,4,2,1,1,0,0,0,0,0
S01007930,Occupancy rating -1 or less,7,2,0,2,5,0,4,1,2,1,1,1,0,0,0,0,0,0
S01007931,All households,481,125,62,63,340,67,240,93,120,27,33,18,15,16,4,0,0,12
S01007931,Occupancy rating +2 or more,275,60,28,32,208,53,150,68,70,12,5,2,3,7,2,0,0,5
S01007931,Occupancy rating +1,111,37,20,17,69,8,46,17,23,6,15,6,9,5,2,0,0,3
S01007931,Occupancy rating 0,73,22,11,11,48,4,34,6,20,8,10,9,1,3,0,0,0,3
S01007931,Occupancy rating -1 or less,22,6,3,3,15,2,10,2,7,1,3,1,2,1,0,0,0,1
S01007932,All households,364,87,50,37,265,62,185,88,62,35,18,8,10,12,8,0,0,4
S01007932,Occupancy rating +2 or more,247,52,34,18,189,53,131,71,38,22,5,1,4,6,5,0,0,1
S01007932,Occupancy rating +1,75,19,11,8,52,8,37,15,13,9,7,3,4,4,1,0,0,3
S01007932,Occupancy rating 0,38,14,4,10,22,1,15,1,10,4,6,4,2,2,2,0,0,0
S01007932,Occupancy rating -1 or less,4,2,1,1,2,0,2,1,1,0,0,0,0,0,0,0,0,0
S01007933,All households,316,62,24,38,240,25,179,53,104,22,36,26,10,14,8,0,0,6
S01007933,Occupancy rating +2 or more,178,44,21,23,126,21,99,46,45,8,6,3,3,8,4,0,0,4
S01007933,Occupancy rating +1,71,15,3,12,55,3,38,4,26,8,14,9,5,1,1,0,0,0
S01007933,Occupancy rating 0,49,3,0,3,46,0,33,2,27,4,13,11,2,0,0,0,0,0
S01007933,Occupancy rating -1 or less,18,0,0,0,13,1,9,1,6,2,3,3,0,5,3,0,0,2
S01007934,All households,300,87,44,43,205,22,144,50,79,15,39,26,13,8,3,0,1,4
S01007934,Occupancy rating +2 or more,144,38,16,22,103,12,85,39,38,8,6,5,1,3,1,0,1,1
S01007934,Occupancy rating +1,83,38,22,16,44,9,31,9,20,2,4,4,0,1,0,0,0,1
S01007934,Occupancy rating 0,48,3,1,2,43,1,19,1,15,3,23,14,9,2,1,0,0,1
S01007934,Occupancy rating -1 or less,25,8,5,3,15,0,9,1,6,2,6,3,3,2,1,0,0,1
S01007935,All households,444,226,94,132,208,20,128,68,44,16,60,46,14,10,2,0,2,6
S01007935,Occupancy rating +2 or more,118,35,13,22,82,6,65,32,25,8,11,7,4,1,0,0,0,1
S01007935,Occupancy rating +1,122,69,25,44,53,6,37,27,7,3,10,6,4,0,0,0,0,0
S01007935,Occupancy rating 0,140,84,38,46,53,6,19,8,7,4,28,22,6,3,1,0,1,1
S01007935,Occupancy rating -1 or less,64,38,18,20,20,2,7,1,5,1,11,11,0,6,1,0,1,4
S01007936,All households,389,74,25,49,311,37,253,82,131,40,21,13,8,4,2,0,0,2
S01007936,Occupancy rating +2 or more,277,45,19,26,232,29,196,62,103,31,7,5,2,0,0,0,0,0
S01007936,Occupancy rating +1,61,17,2,15,42,6,32,11,16,5,4,1,3,2,1,0,0,1
S01007936,Occupancy rating 0,44,11,3,8,32,2,24,9,11,4,6,5,1,1,1,0,0,0
S01007936,Occupancy rating -1 or less,7,1,1,0,5,0,1,0,1,0,4,2,2,1,0,0,0,1
S01007937,All households,435,95,41,54,322,36,248,108,103,37,38,28,10,18,3,0,1,14
S01007937,Occupancy rating +2 or more,257,48,24,24,204,29,161,89,57,15,14,9,5,5,1,0,1,3
S01007937,Occupancy rating +1,104,37,14,23,62,7,49,11,24,14,6,3,3,5,1,0,0,4
S01007937,Occupancy rating 0,61,9,2,7,46,0,32,7,18,7,14,12,2,6,1,0,0,5
S01007937,Occupancy rating -1 or less,13,1,1,0,10,0,6,1,4,1,4,4,0,2,0,0,0,2
S01007938,All households,372,141,63,78,219,32,132,63,52,17,55,34,21,12,3,0,0,9
S01007938,Occupancy rating +2 or more,126,57,39,18,69,22,44,33,9,2,3,1,2,0,0,0,0,0
S01007938,Occupancy rating +1,136,75,20,55,60,8,45,25,16,4,7,2,5,1,0,0,0,1
S01007938,Occupancy rating 0,88,7,3,4,73,1,34,3,21,10,38,25,13,8,1,0,0,7
S01007938,Occupancy rating -1 or less,22,2,1,1,17,1,9,2,6,1,7,6,1,3,2,0,0,1
S01007939,All households,412,137,53,84,265,44,146,62,56,28,75,58,17,10,3,0,0,7
S01007939,Occupancy rating +2 or more,121,48,25,23,70,24,42,35,4,3,4,3,1,3,1,0,0,2
S01007939,Occupancy rating +1,167,72,23,49,94,18,51,24,16,11,25,13,12,1,0,0,0,1
S01007939,Occupancy rating 0,92,11,2,9,78,0,43,2,30,11,35,31,4,3,0,0,0,3
S01007939,Occupancy rating -1 or less,32,6,3,3,23,2,10,1,6,3,11,11,0,3,2,0,0,1
S01007940,All households,497,181,75,106,303,50,210,91,87,32,43,31,12,13,4,1,1,7
S01007940,Occupancy rating +2 or more,191,52,26,26,137,27,102,55,36,11,8,6,2,2,1,0,0,1
S01007940,Occupancy rating +1,138,56,21,35,79,13,55,21,21,13,11,5,6,3,0,0,1,2
S01007940,Occupancy rating 0,152,69,28,41,77,9,46,10,28,8,22,18,4,6,2,1,0,3
S01007940,Occupancy rating -1 or less,16,4,0,4,10,1,7,5,2,0,2,2,0,2,1,0,0,1
S01007941,All households,257,43,25,18,205,21,166,87,52,27,18,13,5,9,4,0,0,5
S01007941,Occupancy rating +2 or more,157,27,19,8,128,17,107,76,21,10,4,3,1,2,0,0,0,2
S01007941,Occupancy rating +1,67,13,5,8,51,4,37,11,16,10,10,8,2,3,1,0,0,2
S01007941,Occupancy rating 0,24,3,1,2,20,0,17,0,12,5,3,2,1,1,1,0,0,0
S01007941,Occupancy rating -1 or less,9,0,0,0,6,0,5,0,3,2,1,0,1,3,2,0,0,1
S01007942,All households,207,63,15,48,138,9,104,39,59,6,25,23,2,6,5,0,0,1
S01007942,Occupancy rating +2 or more,87,7,2,5,78,3,69,30,36,3,6,6,0,2,1,0,0,1
S01007942,Occupancy rating +1,46,18,3,15,28,2,21,6,12,3,5,5,0,0,0,0,0,0
S01007942,Occupancy rating 0,61,33,8,25,24,3,11,3,8,0,10,8,2,4,4,0,0,0
S01007942,Occupancy rating -1 or less,13,5,2,3,8,1,3,0,3,0,4,4,0,0,0,0,0,0
S01007943,All households,319,106,54,52,204,41,136,72,42,22,27,18,9,9,3,0,0,6
S01007943,Occupancy rating +2 or more,146,39,18,21,102,23,75,49,15,11,4,3,1,5,1,0,0,4
S01007943,Occupancy rating +1,83,25,17,8,57,14,37,15,13,9,6,3,3,1,0,0,0,1
S01007943,Occupancy rating 0,63,32,14,18,30,4,18,7,10,1,8,5,3,1,1,0,0,0
S01007943,Occupancy rating -1 or less,27,10,5,5,15,0,6,1,4,1,9,7,2,2,1,0,0,1
S01007944,All households,442,160,62,98,272,42,181,83,71,27,49,34,15,10,3,0,1,6
S01007944,Occupancy rating +2 or more,142,38,18,20,102,21,79,49,21,9,2,0,2,2,1,0,0,1
S01007944,Occupancy rating +1,164,80,31,49,82,18,52,28,13,11,12,6,6,2,0,0,1,1
S01007944,Occupancy rating 0,111,35,10,25,72,1,42,4,31,7,29,23,6,4,1,0,0,3
S01007944,Occupancy rating -1 or less,25,7,3,4,16,2,8,2,6,0,6,5,1,2,1,0,0,1
S01007945,All households,443,202,77,125,230,34,160,79,57,24,36,28,8,11,4,0,0,7
S01007945,Occupancy rating +2 or more,140,35,13,22,101,17,80,46,20,14,4,3,1,4,2,0,0,2
S01007945,Occupancy rating +1,135,64,19,45,69,10,49,25,15,9,10,8,2,2,1,0,0,1
S01007945,Occupancy rating 0,125,82,41,41,40,5,24,6,17,1,11,9,2,3,0,0,0,3
S01007945,Occupancy rating -1 or less,43,21,4,17,20,2,7,2,5,0,11,8,3,2,1,0,0,1
S01007946,All households,396,170,45,125,207,25,132,60,50,22,50,37,13,19,5,0,4,10
S01007946,Occupancy rating +2 or more,118,37,15,22,75,11,59,35,14,10,5,2,3,6,1,0,2,3
S01007946,Occupancy rating +1,115,53,13,40,62,10,42,14,21,7,10,8,2,0,0,0,0,0
S01007946,Occupancy rating 0,120,63,11,52,50,4,24,9,11,4,22,19,3,7,1,0,1,5
S01007946,Occupancy rating -1 or less,43,17,6,11,20,0,7,2,4,1,13,8,5,6,3,0,1,2
S01007947,All households,327,107,42,65,210,38,147,56,66,25,25,19,6,10,6,0,1,3
S01007947,Occupancy rating +2 or more,178,49,20,29,125,33,90,48,29,13,2,2,0,4,2,0,1,1
S01007947,Occupancy rating +1,67,25,14,11,41,4,31,8,16,7,6,4,2,1,0,0,0,1
S01007947,Occupancy rating 0,59,27,6,21,29,1,19,0,15,4,9,6,3,3,2,0,0,1
S01007947,Occupancy rating -1 or less,23,6,2,4,15,0,7,0,6,1,8,7,1,2,2,0,0,0
S01007948,All households,304,113,43,70,177,17,114,54,42,18,46,31,15,14,5,0,1,8
S01007948,Occupancy rating +2 or more,101,34,17,17,65,11,49,34,12,3,5,2,3,2,1,0,0,1
S01007948,Occupancy rating +1,93,45,17,28,43,2,28,14,7,7,13,8,5,5,1,0,1,3
S01007948,Occupancy rating 0,90,27,5,22,59,4,33,5,20,8,22,18,4,4,1,0,0,3
S01007948,Occupancy rating -1 or less,20,7,4,3,10,0,4,1,3,0,6,3,3,3,2,0,0,1
S01007949,All households,347,99,46,53,239,42,172,88,56,28,25,18,7,9,2,0,3,4
S01007949,Occupancy rating +2 or more,162,24,11,13,135,26,102,64,25,13,7,5,2,3,1,0,0,2
S01007949,Occupancy rating +1,111,43,19,24,66,12,43,18,16,9,11,9,2,2,0,0,0,2
S01007949,Occupancy rating 0,62,27,13,14,31,4,22,6,10,6,5,3,2,4,1,0,3,0
S01007949,Occupancy rating -1 or less,12,5,3,2,7,0,5,0,5,0,2,1,1,0,0,0,0,0
S01007950,All households,376,95,39,56,266,39,198,90,76,32,29,21,8,15,10,0,1,4
S01007950,Occupancy rating +2 or more,235,44,22,22,183,34,142,70,51,21,7,5,2,8,5,0,0,3
S01007950,Occupancy rating +1,72,26,10,16,42,4,32,10,13,9,6,3,3,4,3,0,1,0
S01007950,Occupancy rating 0,53,20,5,15,31,0,20,9,9,2,11,9,2,2,2,0,0,0
S01007950,Occupancy rating -1 or less,16,5,2,3,10,1,4,1,3,0,5,4,1,1,0,0,0,1
S01007951,All households,321,94,43,51,221,26,161,62,74,25,34,18,16,6,2,0,1,3
S01007951,Occupancy rating +2 or more,156,39,21,18,115,19,88,44,36,8,8,5,3,2,1,0,0,1
S01007951,Occupancy rating +1,103,42,20,22,59,6,45,16,20,9,8,2,6,2,0,0,1,1
S01007951,Occupancy rating 0,47,10,1,9,35,1,21,2,11,8,13,7,6,2,1,0,0,1
S01007951,Occupancy rating -1 or less,15,3,1,2,12,0,7,0,7,0,5,4,1,0,0,0,0,0
S01007952,All households,357,196,91,105,148,31,84,48,27,9,33,18,15,13,5,0,0,8
S01007952,Occupancy rating +2 or more,64,27,8,19,35,8,24,17,4,3,3,0,3,2,0,0,0,2
S01007952,Occupancy rating +1,138,85,36,49,50,16,30,24,5,1,4,2,2,3,1,0,0,2
S01007952,Occupancy rating 0,107,53,28,25,49,4,23,7,13,3,22,14,8,5,2,0,0,3
S01007952,Occupancy rating -1 or less,48,31,19,12,14,3,7,0,5,2,4,2,2,3,2,0,0,1
S01007953,All households,414,131,67,64,276,26,190,77,85,28,60,44,16,7,3,0,0,4
S01007953,Occupancy rating +2 or more,102,29,15,14,71,13,52,29,16,7,6,3,3,2,1,0,0,1
S01007953,Occupancy rating +1,160,57,29,28,102,10,74,41,23,10,18,10,8,1,0,0,0,1
S01007953,Occupancy rating 0,123,41,20,21,80,2,49,6,35,8,29,25,4,2,1,0,0,1
S01007953,Occupancy rating -1 or less,29,4,3,1,23,1,15,1,11,3,7,6,1,2,1,0,0,1
S01007954,All households,324,117,34,83,196,14,122,39,47,36,60,43,17,11,7,0,0,4
S01007954,Occupancy rating +2 or more,90,43,14,29,47,8,38,24,7,7,1,1,0,0,0,0,0,0
S01007954,Occupancy rating +1,119,55,14,41,63,4,44,14,12,18,15,8,7,1,0,0,0,1
S01007954,Occupancy rating 0,86,16,6,10,63,2,30,1,21,8,31,24,7,7,4,0,0,3
S01007954,Occupancy rating -1 or less,29,3,0,3,23,0,10,0,7,3,13,10,3,3,3,0,0,0
S01007955,All households,322,71,21,50,230,20,142,37,72,33,68,49,19,21,12,1,0,8
S01007955,Occupancy rating +2 or more,73,28,11,17,43,11,29,19,5,5,3,2,1,2,1,0,0,1
S01007955,Occupancy rating +1,103,30,3,27,68,8,40,16,12,12,20,9,11,5,0,1,0,4
S01007955,Occupancy rating 0,110,12,6,6,89,0,54,1,41,12,35,29,6,9,6,0,0,3
S01007955,Occupancy rating -1 or less,36,1,1,0,30,1,19,1,14,4,10,9,1,5,5,0,0,0
S01007956,All households,297,74,38,36,197,23,120,35,66,19,54,39,15,26,12,0,0,14
S01007956,Occupancy rating +2 or more,75,38,18,20,36,10,25,15,6,4,1,1,0,1,0,0,0,1
S01007956,Occupancy rating +1,112,30,17,13,75,11,46,19,20,7,18,8,10,7,2,0,0,5
S01007956,Occupancy rating 0,84,6,3,3,68,1,39,1,32,6,28,26,2,10,5,0,0,5
S01007956,Occupancy rating -1 or less,26,0,0,0,18,1,10,0,8,2,7,4,3,8,5,0,0,3
S01007957,All households,455,179,90,89,262,47,169,76,68,25,46,25,21,14,4,0,2,8
S01007957,Occupancy rating +2 or more,95,25,14,11,68,21,41,31,7,3,6,3,3,2,1,0,0,1
S01007957,Occupancy rating +1,185,82,45,37,100,22,67,33,24,10,11,4,7,3,0,0,1,2
S01007957,Occupancy rating 0,137,58,28,30,76,4,49,11,30,8,23,15,8,3,0,0,0,3
S01007957,Occupancy rating -1 or less,38,14,3,11,18,0,12,1,7,4,6,3,3,6,3,0,1,2
S01007958,All households,388,136,46,90,239,17,149,71,54,24,73,48,25,13,5,0,0,8
S01007958,Occupancy rating +2 or more,68,6,2,4,61,6,50,34,10,6,5,2,3,1,1,0,0,0
S01007958,Occupancy rating +1,147,78,30,48,66,9,50,30,11,9,7,4,3,3,1,0,0,2
S01007958,Occupancy rating 0,134,43,9,34,85,2,36,7,24,5,47,31,16,6,1,0,0,5
S01007958,Occupancy rating -1 or less,39,9,5,4,27,0,13,0,9,4,14,11,3,3,2,0,0,1
S01007959,All households,380,134,75,59,236,52,165,84,49,32,19,7,12,10,2,0,2,6
S01007959,Occupancy rating +2 or more,139,41,25,16,95,27,64,45,8,11,4,0,4,3,0,0,1,2
S01007959,Occupancy rating +1,138,55,29,26,81,19,54,29,14,11,8,5,3,2,1,0,0,1
S01007959,Occupancy rating 0,83,29,16,13,49,5,38,8,22,8,6,2,4,5,1,0,1,3
S01007959,Occupancy rating -1 or less,20,9,5,4,11,1,9,2,5,2,1,0,1,0,0,0,0,0
S01007960,All households,291,84,29,55,190,14,127,39,58,30,49,30,19,17,8,0,0,9
S01007960,Occupancy rating +2 or more,82,25,10,15,52,7,42,22,17,3,3,2,1,5,2,0,0,3
S01007960,Occupancy rating +1,113,47,16,31,62,4,41,12,15,14,17,7,10,4,2,0,0,2
S01007960,Occupancy rating 0,80,10,3,7,65,2,41,4,25,12,22,14,8,5,1,0,0,4
S01007960,Occupancy rating -1 or less,16,2,0,2,11,1,3,1,1,1,7,7,0,3,3,0,0,0
S01007961,All households,278,47,16,31,220,34,169,85,52,32,17,6,11,11,7,0,0,4
S01007961,Occupancy rating +2 or more,197,29,9,20,162,28,124,71,31,22,10,2,8,6,3,0,0,3
S01007961,Occupancy rating +1,50,11,5,6,37,6,26,14,5,7,5,4,1,2,2,0,0,0
S01007961,Occupancy rating 0,27,5,1,4,19,0,17,0,14,3,2,0,2,3,2,0,0,1
S01007961,Occupancy rating -1 or less,4,2,1,1,2,0,2,0,2,0,0,0,0,0,0,0,0,0
S01007962,All households,246,74,14,60,160,18,101,32,54,15,41,32,9,12,9,0,0,3
S01007962,Occupancy rating +2 or more,67,27,7,20,38,10,23,10,10,3,5,3,2,2,1,0,0,1
S01007962,Occupancy rating +1,86,31,4,27,52,8,38,16,16,6,6,6,0,3,1,0,0,2
S01007962,Occupancy rating 0,67,13,2,11,51,0,32,5,23,4,19,15,4,3,3,0,0,0
S01007962,Occupancy rating -1 or less,26,3,1,2,19,0,8,1,5,2,11,8,3,4,4,0,0,0
S01007963,All households,408,133,31,102,250,16,124,28,66,30,110,84,26,25,15,0,3,7
S01007963,Occupancy rating +2 or more,78,43,10,33,34,8,19,14,2,3,7,5,2,1,0,0,1,0
S01007963,Occupancy rating +1,149,57,15,42,83,5,40,10,22,8,38,24,14,9,4,0,1,4
S01007963,Occupancy rating 0,141,27,4,23,107,3,53,4,37,12,51,45,6,7,3,0,1,3
S01007963,Occupancy rating -1 or less,40,6,2,4,26,0,12,0,5,7,14,10,4,8,8,0,0,0
S01007964,All households,353,118,54,64,212,33,124,52,47,25,55,33,22,23,12,0,2,9
S01007964,Occupancy rating +2 or more,110,51,24,27,58,21,32,23,6,3,5,3,2,1,0,0,0,1
S01007964,Occupancy rating +1,109,36,17,19,66,8,41,22,9,10,17,8,9,7,2,0,2,3
S01007964,Occupancy rating 0,105,27,10,17,66,3,41,7,23,11,22,15,7,12,9,0,0,3
S01007964,Occupancy rating -1 or less,29,4,3,1,22,1,10,0,9,1,11,7,4,3,1,0,0,2
S01007965,All households,256,87,44,43,160,14,97,39,37,21,49,30,19,9,2,0,0,7
S01007965,Occupancy rating +2 or more,64,27,13,14,36,6,26,22,1,3,4,2,2,1,1,0,0,0
S01007965,Occupancy rating +1,101,38,20,18,60,6,39,16,14,9,15,7,8,3,0,0,0,3
S01007965,Occupancy rating 0,59,11,5,6,44,1,22,0,16,6,21,14,7,4,0,0,0,4
S01007965,Occupancy rating -1 or less,32,11,6,5,20,1,10,1,6,3,9,7,2,1,1,0,0,0
S01007966,All households,418,123,58,65,278,22,138,52,59,27,118,91,27,17,7,0,1,9
S01007966,Occupancy rating +2 or more,90,39,22,17,50,10,37,30,5,2,3,2,1,1,1,0,0,0
S01007966,Occupancy rating +1,170,65,29,36,98,8,55,22,19,14,35,25,10,7,2,0,1,4
S01007966,Occupancy rating 0,116,16,6,10,97,3,34,0,28,6,60,45,15,3,1,0,0,2
S01007966,Occupancy rating -1 or less,42,3,1,2,33,1,12,0,7,5,20,19,1,6,3,0,0,3
S01007967,All households,245,51,18,33,175,10,92,32,42,18,73,54,19,19,13,0,0,6
S01007967,Occupancy rating +2 or more,52,24,13,11,26,4,20,16,3,1,2,2,0,2,1,0,0,1
S01007967,Occupancy rating +1,80,21,4,17,57,6,29,15,7,7,22,14,8,2,0,0,0,2
S01007967,Occupancy rating 0,88,4,0,4,73,0,32,1,24,7,41,32,9,11,8,0,0,3
S01007967,Occupancy rating -1 or less,25,2,1,1,19,0,11,0,8,3,8,6,2,4,4,0,0,0
S01007968,All households,397,122,70,52,262,47,162,67,58,37,53,32,21,13,5,0,0,8
S01007968,Occupancy rating +2 or more,115,49,25,24,64,22,40,37,0,3,2,1,1,2,0,0,0,2
S01007968,Occupancy rating +1,163,63,37,26,98,20,63,26,20,17,15,7,8,2,0,0,0,2
S01007968,Occupancy rating 0,79,6,4,2,68,3,41,3,27,11,24,14,10,5,2,0,0,3
S01007968,Occupancy rating -1 or less,40,4,4,0,32,2,18,1,11,6,12,10,2,4,3,0,0,1
S01007969,All households,390,148,82,66,230,31,155,52,61,42,44,29,15,12,5,0,3,4
S01007969,Occupancy rating +2 or more,112,56,32,24,55,16,39,26,7,6,0,0,0,1,1,0,0,0
S01007969,Occupancy rating +1,131,47,24,23,81,11,58,23,21,14,12,3,9,3,1,0,0,2
S01007969,Occupancy rating 0,118,38,22,16,75,2,49,3,28,18,24,19,5,5,1,0,2,2
S01007969,Occupancy rating -1 or less,29,7,4,3,19,2,9,0,5,4,8,7,1,3,2,0,1,0
S01007970,All households,408,146,60,86,252,32,160,68,64,28,60,38,22,10,6,0,0,4
S01007970,Occupancy rating +2 or more,91,41,17,24,50,13,35,25,7,3,2,0,2,0,0,0,0,0
S01007970,Occupancy rating +1,175,76,31,45,94,16,60,32,18,10,18,9,9,5,3,0,0,2
S01007970,Occupancy rating 0,107,26,11,15,79,2,51,8,28,15,26,18,8,2,1,0,0,1
S01007970,Occupancy rating -1 or less,35,3,1,2,29,1,14,3,11,0,14,11,3,3,2,0,0,1
S01007971,All households,469,195,91,104,264,38,159,68,58,33,67,38,29,10,1,0,4,5
S01007971,Occupancy rating +2 or more,95,33,17,16,61,22,37,29,6,2,2,1,1,1,0,0,0,1
S01007971,Occupancy rating +1,187,96,41,55,89,12,62,32,18,12,15,5,10,2,0,0,2,0
S01007971,Occupancy rating 0,147,53,25,28,89,2,47,6,24,17,40,26,14,5,0,0,2,3
S01007971,Occupancy rating -1 or less,40,13,8,5,25,2,13,1,10,2,10,6,4,2,1,0,0,1
S01007972,All households,377,115,55,60,249,43,153,57,64,32,53,30,23,13,4,0,0,9
S01007972,Occupancy rating +2 or more,100,38,25,13,62,18,40,32,7,1,4,2,2,0,0,0,0,0
S01007972,Occupancy rating +1,160,68,28,40,90,19,59,23,18,18,12,6,6,2,1,0,0,1
S01007972,Occupancy rating 0,80,3,1,2,69,5,35,0,26,9,29,18,11,8,1,0,0,7
S01007972,Occupancy rating -1 or less,37,6,1,5,28,1,19,2,13,4,8,4,4,3,2,0,0,1
S01007973,All households,355,81,37,44,271,44,205,93,68,44,22,4,18,3,1,0,0,2
S01007973,Occupancy rating +2 or more,203,50,28,22,152,40,110,77,20,13,2,0,2,1,1,0,0,0
S01007973,Occupancy rating +1,102,21,5,16,79,4,60,12,28,20,15,3,12,2,0,0,0,2
S01007973,Occupancy rating 0,45,9,3,6,36,0,31,4,18,9,5,1,4,0,0,0,0,0
S01007973,Occupancy rating -1 or less,5,1,1,0,4,0,4,0,2,2,0,0,0,0,0,0,0,0
S01007974,All households,426,196,75,121,207,23,122,58,46,18,62,33,29,23,8,0,3,12
S01007974,Occupancy rating +2 or more,40,15,5,10,25,5,19,8,6,5,1,1,0,0,0,0,0,0
S01007974,Occupancy rating +1,210,128,54,74,81,13,58,43,8,7,10,5,5,1,1,0,0,0
S01007974,Occupancy rating 0,133,41,12,29,76,3,35,6,25,4,38,18,20,16,4,0,3,9
S01007974,Occupancy rating -1 or less,43,12,4,8,25,2,10,1,7,2,13,9,4,6,3,0,0,3
S01007975,All households,324,131,63,68,181,26,119,47,48,24,36,20,16,12,3,0,4,5
S01007975,Occupancy rating +2 or more,65,27,10,17,37,12,25,21,2,2,0,0,0,1,0,0,1,0
S01007975,Occupancy rating +1,106,41,18,23,63,10,42,15,13,14,11,3,8,2,0,0,1,1
S01007975,Occupancy rating 0,117,52,31,21,60,4,40,10,24,6,16,11,5,5,3,0,0,2
S01007975,Occupancy rating -1 or less,36,11,4,7,21,0,12,1,9,2,9,6,3,4,0,0,2,2
S01007976,All households,456,276,110,166,164,35,93,55,23,15,36,23,13,16,3,1,1,11
S01007976,Occupancy rating +2 or more,83,36,13,23,46,12,29,20,3,6,5,2,3,1,0,0,0,1
S01007976,Occupancy rating +1,187,128,51,77,57,14,39,25,12,2,4,2,2,2,0,0,0,2
S01007976,Occupancy rating 0,161,100,39,61,53,8,24,9,8,7,21,15,6,8,2,1,1,4
S01007976,Occupancy rating -1 or less,25,12,7,5,8,1,1,1,0,0,6,4,2,5,1,0,0,4
S01007977,All households,304,100,35,65,195,20,140,62,56,22,35,18,17,9,2,0,0,7
S01007977,Occupancy rating +2 or more,108,37,19,18,69,12,51,32,15,4,6,3,3,2,0,0,0,2
S01007977,Occupancy rating +1,106,37,11,26,67,8,44,21,18,5,15,8,7,2,0,0,0,2
S01007977,Occupancy rating 0,74,22,3,19,50,0,39,9,19,11,11,5,6,2,1,0,0,1
S01007977,Occupancy rating -1 or less,16,4,2,2,9,0,6,0,4,2,3,2,1,3,1,0,0,2
S01007978,All households,353,215,61,154,128,8,90,54,27,9,30,15,15,10,1,1,1,7
S01007978,Occupancy rating +2 or more,29,8,2,6,20,1,16,9,4,3,3,2,1,1,0,0,0,1
S01007978,Occupancy rating +1,107,70,17,53,37,2,31,25,3,3,4,1,3,0,0,0,0,0
S01007978,Occupancy rating 0,176,117,40,77,55,4,34,18,14,2,17,10,7,4,0,0,0,4
S01007978,Occupancy rating -1 or less,41,20,2,18,16,1,9,2,6,1,6,2,4,5,1,1,1,2
S01007979,All households,363,109,47,62,241,25,190,89,72,29,26,9,17,13,6,0,0,7
S01007979,Occupancy rating +2 or more,199,52,24,28,142,17,119,59,41,19,6,3,3,5,4,0,0,1
S01007979,Occupancy rating +1,87,33,17,16,51,8,36,15,15,6,7,2,5,3,0,0,0,3
S01007979,Occupancy rating 0,61,19,5,14,40,0,29,12,13,4,11,4,7,2,1,0,0,1
S01007979,Occupancy rating -1 or less,16,5,1,4,8,0,6,3,3,0,2,0,2,3,1,0,0,2
S01007980,All households,340,141,80,61,187,29,129,54,49,26,29,15,14,12,4,0,1,7
S01007980,Occupancy rating +2 or more,122,39,22,17,82,15,63,36,19,8,4,2,2,1,1,0,0,0
S01007980,Occupancy rating +1,124,67,36,31,55,8,39,13,16,10,8,2,6,2,0,0,0,2
S01007980,Occupancy rating 0,79,30,18,12,43,4,25,5,12,8,14,9,5,6,1,0,1,4
S01007980,Occupancy rating -1 or less,15,5,4,1,7,2,2,0,2,0,3,2,1,3,2,0,0,1
S01007981,All households,252,72,48,24,171,39,123,67,29,27,9,6,3,9,4,0,0,5
S01007981,Occupancy rating +2 or more,172,54,34,20,115,31,81,51,18,12,3,1,2,3,0,0,0,3
S01007981,Occupancy rating +1,61,17,14,3,42,6,34,16,9,9,2,1,1,2,1,0,0,1
S01007981,Occupancy rating 0,13,0,0,0,11,1,6,0,2,4,4,4,0,2,1,0,0,1
S01007981,Occupancy rating -1 or less,6,1,0,1,3,1,2,0,0,2,0,0,0,2,2,0,0,0
S01007982,All households,210,32,19,13,167,39,109,45,42,22,19,10,9,11,6,0,1,4
S01007982,Occupancy rating +2 or more,144,30,18,12,110,36,66,37,17,12,8,4,4,4,1,0,0,3
S01007982,Occupancy rating +1,42,0,0,0,39,2,30,6,17,7,7,3,4,3,2,0,1,0
S01007982,Occupancy rating 0,18,1,0,1,15,1,12,2,7,3,2,2,0,2,1,0,0,1
S01007982,Occupancy rating -1 or less,6,1,1,0,3,0,1,0,1,0,2,1,1,2,2,0,0,0
S01007983,All households,387,158,89,69,219,47,109,37,47,25,63,46,17,10,4,0,2,4
S01007983,Occupancy rating +2 or more,124,52,32,20,71,32,33,23,6,4,6,4,2,1,0,0,1,0
S01007983,Occupancy rating +1,105,29,10,19,74,8,41,11,18,12,25,16,9,2,0,0,1,1
S01007983,Occupancy rating 0,122,70,41,29,47,7,25,3,18,4,15,12,3,5,3,0,0,2
S01007983,Occupancy rating -1 or less,36,7,6,1,27,0,10,0,5,5,17,14,3,2,1,0,0,1
S01007984,All households,374,123,65,58,237,51,148,58,68,22,38,23,15,14,6,0,1,7
S01007984,Occupancy rating +2 or more,199,63,41,22,132,47,81,46,27,8,4,3,1,4,2,0,1,1
S01007984,Occupancy rating +1,102,36,15,21,63,1,46,10,27,9,16,7,9,3,2,0,0,1
S01007984,Occupancy rating 0,56,23,9,14,30,2,17,2,13,2,11,8,3,3,0,0,0,3
S01007984,Occupancy rating -1 or less,17,1,0,1,12,1,4,0,1,3,7,5,2,4,2,0,0,2
S01007985,All households,412,143,49,94,255,41,150,48,68,34,64,44,20,14,8,0,2,4
S01007985,Occupancy rating +2 or more,156,73,37,36,83,35,45,37,6,2,3,1,2,0,0,0,0,0
S01007985,Occupancy rating +1,131,45,9,36,82,5,54,5,30,19,23,14,9,4,0,0,2,2
S01007985,Occupancy rating 0,102,19,3,16,73,1,42,5,25,12,30,24,6,10,8,0,0,2
S01007985,Occupancy rating -1 or less,23,6,0,6,17,0,9,1,7,1,8,5,3,0,0,0,0,0
S01007986,All households,238,55,33,22,174,30,115,37,56,22,29,13,16,9,6,0,0,3
S01007986,Occupancy rating +2 or more,115,34,21,13,80,21,56,30,24,2,3,2,1,1,1,0,0,0
S01007986,Occupancy rating +1,77,18,10,8,57,5,42,6,20,16,10,2,8,2,0,0,0,2
S01007986,Occupancy rating 0,35,2,1,1,28,3,12,1,9,2,13,7,6,5,4,0,0,1
S01007986,Occupancy rating -1 or less,11,1,1,0,9,1,5,0,3,2,3,2,1,1,1,0,0,0
S01007987,All households,313,73,30,43,231,25,166,66,62,38,40,28,12,9,4,0,0,5
S01007987,Occupancy rating +2 or more,147,36,9,27,109,19,86,56,20,10,4,2,2,2,0,0,0,2
S01007987,Occupancy rating +1,101,29,14,15,69,5,49,7,21,21,15,9,6,3,2,0,0,1
S01007987,Occupancy rating 0,50,7,6,1,42,1,25,3,16,6,16,13,3,1,1,0,0,0
S01007987,Occupancy rating -1 or less,15,1,1,0,11,0,6,0,5,1,5,4,1,3,1,0,0,2
S01007988,All households,336,70,36,34,248,28,155,65,53,37,65,41,24,18,9,0,1,8
S01007988,Occupancy rating +2 or more,144,50,29,21,93,25,64,56,5,3,4,2,2,1,1,0,0,0
S01007988,Occupancy rating +1,115,13,3,10,94,1,63,9,30,24,30,14,16,8,1,0,1,6
S01007988,Occupancy rating 0,60,6,3,3,48,2,20,0,15,5,26,21,5,6,5,0,0,1
S01007988,Occupancy rating -1 or less,17,1,1,0,13,0,8,0,3,5,5,4,1,3,2,0,0,1
S01007989,All households,290,59,15,44,211,11,124,50,55,19,76,57,19,20,10,0,0,10
S01007989,Occupancy rating +2 or more,71,21,4,17,49,7,38,30,7,1,4,2,2,1,0,0,0,1
S01007989,Occupancy rating +1,102,34,9,25,63,4,41,18,14,9,18,11,7,5,1,0,0,4
S01007989,Occupancy rating 0,93,4,2,2,79,0,38,2,29,7,41,32,9,10,5,0,0,5
S01007989,Occupancy rating -1 or less,24,0,0,0,20,0,7,0,5,2,13,12,1,4,4,0,0,0
S01007990,All households,339,61,15,46,259,15,180,55,96,29,64,48,16,19,12,0,1,6
S01007990,Occupancy rating +2 or more,117,29,6,23,83,9,68,34,28,6,6,2,4,5,2,0,1,2
S01007990,Occupancy rating +1,120,29,8,21,87,5,62,21,29,12,20,16,4,4,0,0,0,4
S01007990,Occupancy rating 0,75,2,0,2,68,1,33,0,24,9,34,28,6,5,5,0,0,0
S01007990,Occupancy rating -1 or less,27,1,1,0,21,0,17,0,15,2,4,2,2,5,5,0,0,0
S01007991,All households,334,39,7,32,283,17,243,74,130,39,23,17,6,12,11,0,0,1
S01007991,Occupancy rating +2 or more,273,33,6,27,231,15,200,70,105,25,16,13,3,9,9,0,0,0
S01007991,Occupancy rating +1,40,4,1,3,34,0,31,4,15,12,3,1,2,2,1,0,0,1
S01007991,Occupancy rating 0,15,1,0,1,14,2,10,0,8,2,2,2,0,0,0,0,0,0
S01007991,Occupancy rating -1 or less,6,1,0,1,4,0,2,0,2,0,2,1,1,1,1,0,0,0
S01007992,All households,224,29,4,25,182,7,163,54,99,10,12,12,0,13,6,0,1,6
S01007992,Occupancy rating +2 or more,162,24,3,21,133,5,120,45,68,7,8,8,0,5,3,0,0,2
S01007992,Occupancy rating +1,36,4,1,3,29,2,26,6,17,3,1,1,0,3,2,0,0,1
S01007992,Occupancy rating 0,18,1,0,1,14,0,12,2,10,0,2,2,0,3,0,0,1,2
S01007992,Occupancy rating -1 or less,8,0,0,0,6,0,5,1,4,0,1,1,0,2,1,0,0,1
S01007993,All households,329,48,21,27,277,35,219,101,70,48,23,12,11,4,3,0,0,1
S01007993,Occupancy rating +2 or more,231,41,18,23,190,33,151,91,35,25,6,2,4,0,0,0,0,0
S01007993,Occupancy rating +1,65,4,3,1,58,2,48,10,26,12,8,6,2,3,2,0,0,1
S01007993,Occupancy rating 0,28,3,0,3,24,0,16,0,6,10,8,3,5,1,1,0,0,0
S01007993,Occupancy rating -1 or less,5,0,0,0,5,0,4,0,3,1,1,1,0,0,0,0,0,0
S01007994,All households,293,39,3,36,242,10,222,68,143,11,10,6,4,12,5,0,0,7
S01007994,Occupancy rating +2 or more,241,35,3,32,198,9,184,64,114,6,5,2,3,8,4,0,0,4
S01007994,Occupancy rating +1,34,3,0,3,30,1,26,3,19,4,3,2,1,1,1,0,0,0
S01007994,Occupancy rating 0,17,1,0,1,13,0,11,1,9,1,2,2,0,3,0,0,0,3
S01007994,Occupancy rating -1 or less,1,0,0,0,1,0,1,0,1,0,0,0,0,0,0,0,0,0
S01007995,All households,309,32,6,26,269,17,233,78,121,34,19,11,8,8,5,0,0,3
S01007995,Occupancy rating +2 or more,211,26,4,22,180,16,159,75,71,13,5,2,3,5,3,0,0,2
S01007995,Occupancy rating +1,63,5,1,4,55,0,49,3,32,14,6,4,2,3,2,0,0,1
S01007995,Occupancy rating 0,31,1,1,0,30,1,23,0,17,6,6,4,2,0,0,0,0,0
S01007995,Occupancy rating -1 or less,4,0,0,0,4,0,2,0,1,1,2,1,1,0,0,0,0,0
S01007996,All households,187,31,15,16,150,22,113,54,37,22,15,11,4,6,2,0,1,3
S01007996,Occupancy rating +2 or more,139,23,12,11,113,20,87,48,21,18,6,5,1,3,1,0,0,2
S01007996,Occupancy rating +1,37,6,2,4,29,2,19,6,9,4,8,5,3,2,1,0,0,1
S01007996,Occupancy rating 0,9,2,1,1,6,0,6,0,6,0,0,0,0,1,0,0,1,0
S01007996,Occupancy rating -1 or less,2,0,0,0,2,0,1,0,1,0,1,1,0,0,0,0,0,0
S01007997,All households,296,84,48,36,202,29,160,67,48,45,13,7,6,10,3,1,0,6
S01007997,Occupancy rating +2 or more,220,61,39,22,155,28,119,60,28,31,8,3,5,4,0,0,0,4
S01007997,Occupancy rating +1,45,19,7,12,25,1,22,5,9,8,2,2,0,1,0,0,0,1
S01007997,Occupancy rating 0,25,3,2,1,19,0,16,2,8,6,3,2,1,3,1,1,0,1
S01007997,Occupancy rating -1 or less,6,1,0,1,3,0,3,0,3,0,0,0,0,2,2,0,0,0
S01007998,All households,225,76,26,50,138,26,106,47,41,18,6,4,2,11,7,0,0,4
S01007998,Occupancy rating +2 or more,131,27,14,13,99,19,79,39,27,13,1,1,0,5,4,0,0,1
S01007998,Occupancy rating +1,49,19,2,17,26,6,17,7,8,2,3,2,1,4,1,0,0,3
S01007998,Occupancy rating 0,35,26,9,17,8,1,6,1,3,2,1,1,0,1,1,0,0,0
S01007998,Occupancy rating -1 or less,10,4,1,3,5,0,4,0,3,1,1,0,1,1,1,0,0,0
S01007999,All households,301,106,37,69,181,15,110,36,47,27,56,34,22,14,7,0,2,5
S01007999,Occupancy rating +2 or more,65,30,14,16,35,6,27,17,5,5,2,1,1,0,0,0,0,0
S01007999,Occupancy rating +1,122,68,20,48,52,9,33,19,6,8,10,3,7,2,0,0,1,1
S01007999,Occupancy rating 0,87,4,1,3,72,0,40,0,31,9,32,21,11,11,6,0,1,4
S01007999,Occupancy rating -1 or less,27,4,2,2,22,0,10,0,5,5,12,9,3,1,1,0,0,0
S01008000,All households,390,131,59,72,244,21,142,47,73,22,81,55,26,15,9,0,0,6
S01008000,Occupancy rating +2 or more,75,35,12,23,40,9,28,21,5,2,3,2,1,0,0,0,0,0
S01008000,Occupancy rating +1,126,52,23,29,73,9,49,22,22,5,15,8,7,1,1,0,0,0
S01008000,Occupancy rating 0,146,38,23,15,104,3,52,3,36,13,49,34,15,4,2,0,0,2
S01008000,Occupancy rating -1 or less,43,6,1,5,27,0,13,1,10,2,14,11,3,10,6,0,0,4
S01008001,All households,372,116,35,81,241,20,118,34,59,25,103,72,31,15,6,0,1,8
S01008001,Occupancy rating +2 or more,71,40,15,25,30,6,22,19,2,1,2,1,1,1,1,0,0,0
S01008001,Occupancy rating +1,132,54,14,40,75,10,37,10,16,11,28,16,12,3,0,0,1,2
S01008001,Occupancy rating 0,128,14,4,10,109,1,51,5,36,10,57,44,13,5,2,0,0,3
S01008001,Occupancy rating -1 or less,41,8,2,6,27,3,8,0,5,3,16,11,5,6,3,0,0,3
S01008002,All households,330,117,20,97,199,7,116,38,54,24,76,51,25,14,8,0,1,5
S01008002,Occupancy rating +2 or more,57,32,7,25,25,2,21,10,6,5,2,1,1,0,0,0,0,0
S01008002,Occupancy rating +1,131,67,10,57,63,3,46,24,13,9,14,9,5,1,0,0,0,1
S01008002,Occupancy rating 0,97,9,3,6,81,0,38,2,29,7,43,26,17,7,3,0,1,3
S01008002,Occupancy rating -1 or less,45,9,0,9,30,2,11,2,6,3,17,15,2,6,5,0,0,1
S01008003,All households,241,68,16,52,160,8,115,40,56,19,37,23,14,13,9,0,0,4
S01008003,Occupancy rating +2 or more,80,21,5,16,55,4,48,24,16,8,3,2,1,4,4,0,0,0
S01008003,Occupancy rating +1,100,37,10,27,61,3,42,12,22,8,16,7,9,2,0,0,0,2
S01008003,Occupancy rating 0,47,7,1,6,36,1,21,4,14,3,14,10,4,4,3,0,0,1
S01008003,Occupancy rating -1 or less,14,3,0,3,8,0,4,0,4,0,4,4,0,3,2,0,0,1
S01008004,All households,230,39,7,32,181,5,138,35,89,14,38,29,9,10,5,0,1,4
S01008004,Occupancy rating +2 or more,107,27,3,24,77,4,69,31,32,6,4,3,1,3,1,0,0,2
S01008004,Occupancy rating +1,65,7,1,6,55,1,41,3,35,3,13,7,6,3,2,0,1,0
S01008004,Occupancy rating 0,44,5,3,2,37,0,23,1,19,3,14,12,2,2,1,0,0,1
S01008004,Occupancy rating -1 or less,14,0,0,0,12,0,5,0,3,2,7,7,0,2,1,0,0,1
S01008005,All households,220,28,1,27,185,5,125,56,65,4,55,50,5,7,4,0,0,3
S01008005,Occupancy rating +2 or more,94,18,1,17,75,5,66,48,16,2,4,3,1,1,1,0,0,0
S01008005,Occupancy rating +1,60,7,0,7,51,0,37,8,27,2,14,12,2,2,0,0,0,2
S01008005,Occupancy rating 0,53,1,0,1,51,0,17,0,17,0,34,32,2,1,0,0,0,1
S01008005,Occupancy rating -1 or less,13,2,0,2,8,0,5,0,5,0,3,3,0,3,3,0,0,0
S01008006,All households,248,75,20,55,155,16,75,26,37,12,64,45,19,18,7,0,1,10
S01008006,Occupancy rating +2 or more,56,28,13,15,27,8,18,13,3,2,1,0,1,1,1,0,0,0
S01008006,Occupancy rating +1,87,36,6,30,47,6,29,12,10,7,12,5,7,4,2,0,1,1
S01008006,Occupancy rating 0,72,6,0,6,59,2,21,1,17,3,36,28,8,7,1,0,0,6
S01008006,Occupancy rating -1 or less,33,5,1,4,22,0,7,0,7,0,15,12,3,6,3,0,0,3
S01008007,All households,208,88,11,77,117,4,70,27,30,13,43,37,6,3,0,0,0,3
S01008007,Occupancy rating +2 or more,21,5,2,3,15,3,11,8,2,1,1,1,0,1,0,0,0,1
S01008007,Occupancy rating +1,103,58,7,51,45,1,32,16,9,7,12,10,2,0,0,0,0,0
S01008007,Occupancy rating 0,64,20,2,18,43,0,19,2,15,2,24,21,3,1,0,0,0,1
S01008007,Occupancy rating -1 or less,20,5,0,5,14,0,8,1,4,3,6,5,1,1,0,0,0,1
S01008008,All households,267,79,19,60,177,5,107,35,63,9,65,46,19,11,4,0,0,7
S01008008,Occupancy rating +2 or more,50,13,2,11,36,1,26,11,12,3,9,7,2,1,0,0,0,1
S01008008,Occupancy rating +1,107,32,8,24,73,3,52,21,28,3,18,11,7,2,0,0,0,2
S01008008,Occupancy rating 0,77,22,2,20,50,0,22,2,17,3,28,21,7,5,1,0,0,4
S01008008,Occupancy rating -1 or less,33,12,7,5,18,1,7,1,6,0,10,7,3,3,3,0,0,0
S01008009,All households,373,156,30,126,196,10,118,46,59,13,68,52,16,21,12,0,1,8
S01008009,Occupancy rating +2 or more,56,16,2,14,36,5,26,14,12,0,5,3,2,4,2,0,1,1
S01008009,Occupancy rating +1,133,69,14,55,58,4,41,17,20,4,13,10,3,6,2,0,0,4
S01008009,Occupancy rating 0,138,50,8,42,82,1,38,11,19,8,43,34,9,6,5,0,0,1
S01008009,Occupancy rating -1 or less,46,21,6,15,20,0,13,4,8,1,7,5,2,5,3,0,0,2
S01008010,All households,476,243,39,204,216,20,158,80,58,20,38,23,15,17,6,1,0,10
S01008010,Occupancy rating +2 or more,92,28,7,21,60,10,48,27,13,8,2,1,1,4,3,0,0,1
S01008010,Occupancy rating +1,204,121,21,100,81,9,65,40,19,6,7,4,3,2,0,0,0,2
S01008010,Occupancy rating 0,154,81,10,71,65,0,39,11,22,6,26,15,11,8,2,1,0,5
S01008010,Occupancy rating -1 or less,26,13,1,12,10,1,6,2,4,0,3,3,0,3,1,0,0,2
S01008011,All households,455,301,134,167,131,25,77,54,18,5,29,15,14,23,1,1,1,20
S01008011,Occupancy rating +2 or more,31,20,6,14,11,2,6,5,1,0,3,1,2,0,0,0,0,0
S01008011,Occupancy rating +1,149,89,26,63,52,10,40,35,4,1,2,1,1,8,0,0,0,8
S01008011,Occupancy rating 0,222,164,89,75,53,12,23,13,7,3,18,8,10,5,0,1,0,4
S01008011,Occupancy rating -1 or less,53,28,13,15,15,1,8,1,6,1,6,5,1,10,1,0,1,8
S01008012,All households,471,278,62,216,176,20,121,70,38,13,35,22,13,17,4,0,1,12
S01008012,Occupancy rating +2 or more,70,28,10,18,40,7,28,16,8,4,5,4,1,2,1,0,0,1
S01008012,Occupancy rating +1,133,77,20,57,52,9,38,26,10,2,5,4,1,4,2,0,0,2
S01008012,Occupancy rating 0,207,136,24,112,66,4,44,25,13,6,18,8,10,5,1,0,0,4
S01008012,Occupancy rating -1 or less,61,37,8,29,18,0,11,3,7,1,7,6,1,6,0,0,1,5
S01008013,All households,363,216,88,128,135,17,97,53,35,9,21,15,6,12,6,0,0,6
S01008013,Occupancy rating +2 or more,67,19,8,11,44,3,40,16,18,6,1,0,1,4,1,0,0,3
S01008013,Occupancy rating +1,92,56,12,44,34,8,23,19,3,1,3,2,1,2,1,0,0,1
S01008013,Occupancy rating 0,154,106,56,50,47,6,30,18,10,2,11,9,2,1,0,0,0,1
S01008013,Occupancy rating -1 or less,50,35,12,23,10,0,4,0,4,0,6,4,2,5,4,0,0,1
S01008014,All households,312,139,43,96,169,29,126,55,50,21,14,8,6,4,2,0,0,2
S01008014,Occupancy rating +2 or more,116,28,10,18,88,14,71,33,25,13,3,2,1,0,0,0,0,0
S01008014,Occupancy rating +1,86,47,14,33,39,12,25,14,8,3,2,0,2,0,0,0,0,0
S01008014,Occupancy rating 0,91,56,16,40,33,2,24,7,12,5,7,4,3,2,1,0,0,1
S01008014,Occupancy rating -1 or less,19,8,3,5,9,1,6,1,5,0,2,2,0,2,1,0,0,1
S01008015,All households,437,227,75,152,202,29,116,58,45,13,57,38,19,8,2,0,1,5
S01008015,Occupancy rating +2 or more,40,15,5,10,25,7,16,8,5,3,2,1,1,0,0,0,0,0
S01008015,Occupancy rating +1,144,78,26,52,63,17,41,30,8,3,5,4,1,3,2,0,0,1
S01008015,Occupancy rating 0,181,99,29,70,79,4,43,16,23,4,32,21,11,3,0,0,0,3
S01008015,Occupancy rating -1 or less,72,35,15,20,35,1,16,4,9,3,18,12,6,2,0,0,1,1
S01008016,All households,433,208,96,112,206,41,125,63,40,22,40,27,13,19,5,0,6,8
S01008016,Occupancy rating +2 or more,82,31,18,13,47,15,31,19,9,3,1,1,0,4,2,0,1,1
S01008016,Occupancy rating +1,164,95,45,50,68,21,43,32,7,4,4,2,2,1,1,0,0,0
S01008016,Occupancy rating 0,147,70,30,40,66,3,38,9,16,13,25,16,9,11,0,0,4,7
S01008016,Occupancy rating -1 or less,40,12,3,9,25,2,13,3,8,2,10,8,2,3,2,0,1,0
S01008017,All households,375,93,71,22,276,60,195,68,76,51,21,12,9,6,1,0,0,5
S01008017,Occupancy rating +2 or more,266,68,52,16,195,47,138,54,51,33,10,5,5,3,0,0,0,3
S01008017,Occupancy rating +1,85,23,18,5,60,13,41,14,17,10,6,4,2,2,0,0,0,2
S01008017,Occupancy rating 0,16,1,0,1,14,0,9,0,4,5,5,3,2,1,1,0,0,0
S01008017,Occupancy rating -1 or less,8,1,1,0,7,0,7,0,4,3,0,0,0,0,0,0,0,0
S01008018,All households,308,96,45,51,209,48,139,74,41,24,22,10,12,3,2,0,0,1
S01008018,Occupancy rating +2 or more,159,37,19,18,120,38,76,50,18,8,6,1,5,2,1,0,0,1
S01008018,Occupancy rating +1,99,46,21,25,52,9,40,18,12,10,3,1,2,1,1,0,0,0
S01008018,Occupancy rating 0,39,11,4,7,28,1,18,5,11,2,9,4,5,0,0,0,0,0
S01008018,Occupancy rating -1 or less,11,2,1,1,9,0,5,1,0,4,4,4,0,0,0,0,0,0
S01008019,All households,271,68,31,37,194,21,161,47,79,35,12,5,7,9,3,0,1,5
S01008019,Occupancy rating +2 or more,181,29,17,12,144,16,126,36,59,31,2,0,2,8,3,0,1,4
S01008019,Occupancy rating +1,39,10,4,6,28,2,24,8,15,1,2,1,1,1,0,0,0,1
S01008019,Occupancy rating 0,39,25,9,16,14,2,6,0,3,3,6,4,2,0,0,0,0,0
S01008019,Occupancy rating -1 or less,12,4,1,3,8,1,5,3,2,0,2,0,2,0,0,0,0,0
S01008020,All households,313,144,34,110,157,16,120,64,42,14,21,13,8,12,3,1,0,8
S01008020,Occupancy rating +2 or more,104,32,12,20,70,10,58,31,23,4,2,1,1,2,1,0,0,1
S01008020,Occupancy rating +1,89,48,14,34,39,5,32,22,6,4,2,1,1,2,2,0,0,0
S01008020,Occupancy rating 0,89,50,5,45,32,0,21,9,7,5,11,5,6,7,0,1,0,6
S01008020,Occupancy rating -1 or less,31,14,3,11,16,1,9,2,6,1,6,6,0,1,0,0,0,1
S01008021,All households,244,58,28,30,178,44,121,51,51,19,13,5,8,8,2,0,1,5
S01008021,Occupancy rating +2 or more,173,40,23,17,129,39,87,46,32,9,3,1,2,4,1,0,0,3
S01008021,Occupancy rating +1,39,11,4,7,26,4,16,2,6,8,6,3,3,2,1,0,1,0
S01008021,Occupancy rating 0,29,5,0,5,22,1,17,3,12,2,4,1,3,2,0,0,0,2
S01008021,Occupancy rating -1 or less,3,2,1,1,1,0,1,0,1,0,0,0,0,0,0,0,0,0
S01008022,All households,286,60,32,28,218,31,172,63,76,33,15,8,7,8,1,1,1,5
S01008022,Occupancy rating +2 or more,204,43,24,19,158,29,120,46,50,24,9,6,3,3,0,0,0,3
S01008022,Occupancy rating +1,53,12,6,6,40,2,35,14,16,5,3,0,3,1,0,0,1,0
S01008022,Occupancy rating 0,27,5,2,3,18,0,15,2,9,4,3,2,1,4,1,1,0,2
S01008022,Occupancy rating -1 or less,2,0,0,0,2,0,2,1,1,0,0,0,0,0,0,0,0,0
S01008023,All households,246,28,12,16,208,12,180,47,107,26,16,12,4,10,6,0,1,3
S01008023,Occupancy rating +2 or more,192,24,10,14,164,12,143,45,77,21,9,6,3,4,2,0,0,2
S01008023,Occupancy rating +1,39,4,2,2,31,0,25,1,19,5,6,5,1,4,2,0,1,1
S01008023,Occupancy rating 0,14,0,0,0,12,0,11,0,11,0,1,1,0,2,2,0,0,0
S01008023,Occupancy rating -1 or less,1,0,0,0,1,0,1,1,0,0,0,0,0,0,0,0,0,0
S01008024,All households,224,13,1,12,202,4,184,52,118,14,14,11,3,9,5,0,0,4
S01008024,Occupancy rating +2 or more,183,12,1,11,163,3,152,44,96,12,8,5,3,8,5,0,0,3
S01008024,Occupancy rating +1,25,0,0,0,24,1,18,5,11,2,5,5,0,1,0,0,0,1
S01008024,Occupancy rating 0,12,1,0,1,11,0,10,3,7,0,1,1,0,0,0,0,0,0
S01008024,Occupancy rating -1 or less,4,0,0,0,4,0,4,0,4,0,0,0,0,0,0,0,0,0
S01008025,All households,283,55,20,35,221,35,170,75,62,33,16,9,7,7,2,1,0,4
S01008025,Occupancy rating +2 or more,130,30,9,21,99,19,76,48,17,11,4,2,2,1,1,0,0,0
S01008025,Occupancy rating +1,92,16,7,9,73,13,53,22,22,9,7,3,4,3,1,1,0,1
S01008025,Occupancy rating 0,49,6,2,4,40,1,36,4,21,11,3,3,0,3,0,0,0,3
S01008025,Occupancy rating -1 or less,12,3,2,1,9,2,5,1,2,2,2,1,1,0,0,0,0,0
S01008026,All households,466,159,87,72,294,29,208,76,79,53,57,33,24,13,5,0,1,7
S01008026,Occupancy rating +2 or more,145,43,26,17,101,10,86,42,25,19,5,2,3,1,0,0,0,1
S01008026,Occupancy rating +1,140,61,32,29,76,8,52,25,12,15,16,8,8,3,1,0,0,2
S01008026,Occupancy rating 0,140,44,24,20,90,9,55,9,33,13,26,14,12,6,1,0,1,4
S01008026,Occupancy rating -1 or less,41,11,5,6,27,2,15,0,9,6,10,9,1,3,3,0,0,0
S01008027,All households,259,94,45,49,155,26,93,38,38,17,36,18,18,10,7,0,1,2
S01008027,Occupancy rating +2 or more,68,30,19,11,38,15,22,14,7,1,1,0,1,0,0,0,0,0
S01008027,Occupancy rating +1,104,45,19,26,57,8,36,21,6,9,13,7,6,2,0,0,0,2
S01008027,Occupancy rating 0,65,9,3,6,52,1,31,2,22,7,20,10,10,4,3,0,1,0
S01008027,Occupancy rating -1 or less,22,10,4,6,8,2,4,1,3,0,2,1,1,4,4,0,0,0
S01008028,All households,239,60,28,32,172,13,143,50,71,22,16,9,7,7,5,0,0,2
S01008028,Occupancy rating +2 or more,103,21,10,11,80,5,70,44,16,10,5,3,2,2,2,0,0,0
S01008028,Occupancy rating +1,70,22,10,12,46,5,37,6,28,3,4,1,3,2,1,0,0,1
S01008028,Occupancy rating 0,50,15,8,7,34,1,27,0,20,7,6,4,2,1,1,0,0,0
S01008028,Occupancy rating -1 or less,16,2,0,2,12,2,9,0,7,2,1,1,0,2,1,0,0,1
S01008029,All households,345,92,37,55,250,27,193,95,59,39,30,13,17,3,1,0,0,2
S01008029,Occupancy rating +2 or more,188,36,20,16,152,18,126,70,34,22,8,2,6,0,0,0,0,0
S01008029,Occupancy rating +1,85,29,7,22,54,9,38,17,13,8,7,0,7,2,1,0,0,1
S01008029,Occupancy rating 0,51,18,7,11,32,0,22,7,8,7,10,7,3,1,0,0,0,1
S01008029,Occupancy rating -1 or less,21,9,3,6,12,0,7,1,4,2,5,4,1,0,0,0,0,0
S01008030,All households,476,131,76,55,339,54,245,105,94,46,40,21,19,6,0,0,0,6
S01008030,Occupancy rating +2 or more,260,50,29,21,208,32,165,79,59,27,11,5,6,2,0,0,0,2
S01008030,Occupancy rating +1,125,50,32,18,74,19,46,17,16,13,9,5,4,1,0,0,0,1
S01008030,Occupancy rating 0,72,25,12,13,45,3,26,9,13,4,16,9,7,2,0,0,0,2
S01008030,Occupancy rating -1 or less,19,6,3,3,12,0,8,0,6,2,4,2,2,1,0,0,0,1
S01008031,All households,403,146,68,78,238,26,161,61,69,31,51,32,19,19,7,0,2,10
S01008031,Occupancy rating +2 or more,123,36,13,23,83,13,63,34,19,10,7,2,5,4,0,0,0,4
S01008031,Occupancy rating +1,134,57,26,31,72,12,49,20,19,10,11,9,2,5,3,0,0,2
S01008031,Occupancy rating 0,108,35,17,18,67,1,38,7,24,7,28,16,12,6,3,0,1,2
S01008031,Occupancy rating -1 or less,38,18,12,6,16,0,11,0,7,4,5,5,0,4,1,0,1,2
S01008032,All households,377,91,34,57,275,39,186,73,74,39,50,35,15,11,8,0,0,3
S01008032,Occupancy rating +2 or more,159,43,17,26,115,22,88,51,31,6,5,2,3,1,1,0,0,0
S01008032,Occupancy rating +1,111,31,11,20,79,16,48,18,16,14,15,11,4,1,1,0,0,0
S01008032,Occupancy rating 0,90,15,5,10,70,1,43,3,24,16,26,19,7,5,2,0,0,3
S01008032,Occupancy rating -1 or less,17,2,1,1,11,0,7,1,3,3,4,3,1,4,4,0,0,0
S01008033,All households,269,39,17,22,225,15,191,49,107,35,19,15,4,5,3,0,0,2
S01008033,Occupancy rating +2 or more,228,36,17,19,189,13,165,49,86,30,11,9,2,3,2,0,0,1
S01008033,Occupancy rating +1,23,1,0,1,20,2,11,0,11,0,7,5,2,2,1,0,0,1
S01008033,Occupancy rating 0,12,0,0,0,12,0,11,0,7,4,1,1,0,0,0,0,0,0
S01008033,Occupancy rating -1 or less,6,2,0,2,4,0,4,0,3,1,0,0,0,0,0,0,0,0
S01008034,All households,271,46,14,32,219,16,182,35,113,34,21,13,8,6,3,0,1,2
S01008034,Occupancy rating +2 or more,170,22,5,17,145,13,124,30,70,24,8,7,1,3,2,0,0,1
S01008034,Occupancy rating +1,75,21,8,13,53,3,43,5,31,7,7,2,5,1,0,0,1,0
S01008034,Occupancy rating 0,21,1,0,1,19,0,15,0,12,3,4,4,0,1,0,0,0,1
S01008034,Occupancy rating -1 or less,5,2,1,1,2,0,0,0,0,0,2,0,2,1,1,0,0,0
S01008035,All households,281,85,33,52,190,24,136,52,49,35,30,24,6,6,0,0,2,4
S01008035,Occupancy rating +2 or more,121,26,10,16,92,16,66,32,17,17,10,6,4,3,0,0,2,1
S01008035,Occupancy rating +1,98,41,17,24,56,8,48,17,16,15,0,0,0,1,0,0,0,1
S01008035,Occupancy rating 0,45,15,6,9,30,0,18,3,14,1,12,10,2,0,0,0,0,0
S01008035,Occupancy rating -1 or less,17,3,0,3,12,0,4,0,2,2,8,8,0,2,0,0,0,2
S01008036,All households,246,25,18,7,216,37,159,58,61,40,20,12,8,5,2,0,1,2
S01008036,Occupancy rating +2 or more,161,21,15,6,139,31,101,51,26,24,7,4,3,1,1,0,0,0
S01008036,Occupancy rating +1,50,4,3,1,44,4,33,6,17,10,7,2,5,2,0,0,0,2
S01008036,Occupancy rating 0,25,0,0,0,24,1,20,1,14,5,3,3,0,1,0,0,1,0
S01008036,Occupancy rating -1 or less,10,0,0,0,9,1,5,0,4,1,3,3,0,1,1,0,0,0
S01008037,All households,421,117,64,53,286,23,177,60,70,47,86,46,40,18,8,0,1,9
S01008037,Occupancy rating +2 or more,118,45,20,25,73,17,50,37,9,4,6,4,2,0,0,0,0,0
S01008037,Occupancy rating +1,138,33,21,12,99,4,64,15,27,22,31,8,23,6,1,0,1,4
S01008037,Occupancy rating 0,127,33,21,12,87,1,51,7,26,18,35,23,12,7,5,0,0,2
S01008037,Occupancy rating -1 or less,38,6,2,4,27,1,12,1,8,3,14,11,3,5,2,0,0,3
S01008038,All households,303,71,42,29,216,21,131,36,66,29,64,40,24,16,9,1,1,5
S01008038,Occupancy rating +2 or more,94,37,24,13,55,17,35,17,13,5,3,1,2,2,0,0,0,2
S01008038,Occupancy rating +1,101,26,15,11,73,4,54,17,24,13,15,9,6,2,0,0,1,1
S01008038,Occupancy rating 0,78,7,2,5,66,0,34,2,24,8,32,19,13,5,3,0,0,2
S01008038,Occupancy rating -1 or less,30,1,1,0,22,0,8,0,5,3,14,11,3,7,6,1,0,0
S01008039,All households,363,101,39,62,250,25,172,49,92,31,53,32,21,12,7,0,1,4
S01008039,Occupancy rating +2 or more,127,38,20,18,87,15,65,30,27,8,7,2,5,2,0,0,0,2
S01008039,Occupancy rating +1,109,36,14,22,72,8,45,14,21,10,19,15,4,1,0,0,1,0
S01008039,Occupancy rating 0,97,24,5,19,68,1,46,3,31,12,21,12,9,5,3,0,0,2
S01008039,Occupancy rating -1 or less,30,3,0,3,23,1,16,2,13,1,6,3,3,4,4,0,0,0
S01008040,All households,332,72,40,32,255,53,159,55,76,28,43,22,21,5,0,0,1,4
S01008040,Occupancy rating +2 or more,217,45,30,15,169,47,106,44,47,15,16,7,9,3,0,0,1,2
S01008040,Occupancy rating +1,54,10,8,2,42,5,31,9,18,4,6,6,0,2,0,0,0,2
S01008040,Occupancy rating 0,47,15,2,13,32,1,17,2,8,7,14,5,9,0,0,0,0,0
S01008040,Occupancy rating -1 or less,14,2,0,2,12,0,5,0,3,2,7,4,3,0,0,0,0,0
S01008041,All households,354,155,88,67,184,41,114,41,48,25,29,20,9,15,4,0,3,8
S01008041,Occupancy rating +2 or more,153,63,40,23,86,25,56,21,24,11,5,3,2,4,1,0,1,2
S01008041,Occupancy rating +1,94,39,21,18,53,11,35,13,15,7,7,4,3,2,1,0,0,1
S01008041,Occupancy rating 0,86,42,17,25,36,4,19,7,8,4,13,9,4,8,2,0,2,4
S01008041,Occupancy rating -1 or less,21,11,10,1,9,1,4,0,1,3,4,4,0,1,0,0,0,1
S01008042,All households,280,109,61,48,164,29,117,53,55,9,18,11,7,7,2,0,1,4
S01008042,Occupancy rating +2 or more,166,36,26,10,128,22,95,42,47,6,11,5,6,2,1,0,0,1
S01008042,Occupancy rating +1,57,34,16,18,22,6,13,5,6,2,3,3,0,1,0,0,0,1
S01008042,Occupancy rating 0,50,36,18,18,11,1,6,4,1,1,4,3,1,3,1,0,1,1
S01008042,Occupancy rating -1 or less,7,3,1,2,3,0,3,2,1,0,0,0,0,1,0,0,0,1
S01008043,All households,398,89,63,26,306,69,201,65,103,33,36,22,14,3,1,0,0,2
S01008043,Occupancy rating +2 or more,306,67,48,19,237,58,163,60,76,27,16,7,9,2,1,0,0,1
S01008043,Occupancy rating +1,59,22,15,7,37,9,25,4,18,3,3,1,2,0,0,0,0,0
S01008043,Occupancy rating 0,28,0,0,0,27,1,11,1,8,2,15,12,3,1,0,0,0,1
S01008043,Occupancy rating -1 or less,5,0,0,0,5,1,2,0,1,1,2,2,0,0,0,0,0,0
S01008044,All households,431,137,79,58,287,63,196,70,86,40,28,18,10,7,1,0,1,5
S01008044,Occupancy rating +2 or more,245,54,39,15,188,46,132,53,52,27,10,6,4,3,0,0,0,3
S01008044,Occupancy rating +1,123,57,29,28,65,13,47,17,21,9,5,4,1,1,0,0,1,0
S01008044,Occupancy rating 0,49,22,9,13,25,3,14,0,11,3,8,4,4,2,0,0,0,2
S01008044,Occupancy rating -1 or less,14,4,2,2,9,1,3,0,2,1,5,4,1,1,1,0,0,0
S01008045,All households,449,169,104,65,260,53,177,67,77,33,30,14,16,20,8,0,2,10
S01008045,Occupancy rating +2 or more,252,62,39,23,181,36,135,53,57,25,10,1,9,9,2,0,2,5
S01008045,Occupancy rating +1,96,55,29,26,38,11,22,8,9,5,5,3,2,3,0,0,0,3
S01008045,Occupancy rating 0,77,45,32,13,26,6,12,5,5,2,8,5,3,6,5,0,0,1
S01008045,Occupancy rating -1 or less,24,7,4,3,15,0,8,1,6,1,7,5,2,2,1,0,0,1
S01008046,All households,527,327,186,141,190,44,95,48,31,16,51,25,26,10,3,0,0,7
S01008046,Occupancy rating +2 or more,107,35,15,20,70,18,43,24,13,6,9,3,6,2,1,0,0,1
S01008046,Occupancy rating +1,99,62,33,29,35,2,23,13,6,4,10,3,7,2,1,0,0,1
S01008046,Occupancy rating 0,271,202,114,88,65,23,25,10,10,5,17,10,7,4,1,0,0,3
S01008046,Occupancy rating -1 or less,50,28,24,4,20,1,4,1,2,1,15,9,6,2,0,0,0,2
S01008047,All households,292,87,64,23,193,41,145,45,68,32,7,5,2,12,2,2,4,4
S01008047,Occupancy rating +2 or more,211,58,46,12,147,36,107,38,46,23,4,2,2,6,1,2,1,2
S01008047,Occupancy rating +1,49,17,11,6,28,3,24,4,13,7,1,1,0,4,1,0,3,0
S01008047,Occupancy rating 0,22,8,3,5,13,2,10,3,5,2,1,1,0,1,0,0,0,1
S01008047,Occupancy rating -1 or less,10,4,4,0,5,0,4,0,4,0,1,1,0,1,0,0,0,1
S01008048,All households,238,60,41,19,173,41,120,45,52,23,12,4,8,5,2,0,0,3
S01008048,Occupancy rating +2 or more,181,41,26,15,136,37,94,39,35,20,5,3,2,4,2,0,0,2
S01008048,Occupancy rating +1,36,10,8,2,26,4,18,4,12,2,4,1,3,0,0,0,0,0
S01008048,Occupancy rating 0,18,7,5,2,11,0,8,2,5,1,3,0,3,0,0,0,0,0
S01008048,Occupancy rating -1 or less,3,2,2,0,0,0,0,0,0,0,0,0,0,1,0,0,0,1
S01008049,All households,357,91,67,24,258,61,182,59,93,30,15,5,10,8,1,0,1,6
S01008049,Occupancy rating +2 or more,263,67,48,19,192,54,135,50,62,23,3,0,3,4,0,0,1,3
S01008049,Occupancy rating +1,68,22,17,5,44,6,28,5,16,7,10,4,6,2,1,0,0,1
S01008049,Occupancy rating 0,20,1,1,0,18,0,16,4,12,0,2,1,1,1,0,0,0,1
S01008049,Occupancy rating -1 or less,6,1,1,0,4,1,3,0,3,0,0,0,0,1,0,0,0,1
S01008050,All households,245,46,27,19,190,59,116,33,59,24,15,8,7,9,1,0,3,5
S01008050,Occupancy rating +2 or more,179,25,19,6,148,52,86,27,40,19,10,5,5,6,1,0,1,4
S01008050,Occupancy rating +1,33,9,4,5,24,5,19,2,13,4,0,0,0,0,0,0,0,0
S01008050,Occupancy rating 0,25,11,3,8,13,1,11,4,6,1,1,1,0,1,0,0,1,0
S01008050,Occupancy rating -1 or less,8,1,1,0,5,1,0,0,0,0,4,2,2,2,0,0,1,1
S01008051,All households,328,62,29,33,257,50,188,37,113,38,19,11,8,9,4,0,2,3
S01008051,Occupancy rating +2 or more,241,44,22,22,192,48,132,31,78,23,12,6,6,5,1,0,2,2
S01008051,Occupancy rating +1,62,15,6,9,46,2,39,5,24,10,5,3,2,1,1,0,0,0
S01008051,Occupancy rating 0,20,3,1,2,16,0,14,1,9,4,2,2,0,1,0,0,0,1
S01008051,Occupancy rating -1 or less,5,0,0,0,3,0,3,0,2,1,0,0,0,2,2,0,0,0
S01008052,All households,337,73,50,23,258,34,213,85,95,33,11,7,4,6,4,0,0,2
S01008052,Occupancy rating +2 or more,244,48,35,13,194,28,161,75,63,23,5,2,3,2,1,0,0,1
S01008052,Occupancy rating +1,65,21,12,9,42,5,33,9,20,4,4,3,1,2,1,0,0,1
S01008052,Occupancy rating 0,23,3,2,1,18,1,15,1,10,4,2,2,0,2,2,0,0,0
S01008052,Occupancy rating -1 or less,5,1,1,0,4,0,4,0,2,2,0,0,0,0,0,0,0,0
S01008053,All households,263,65,41,24,191,45,117,44,58,15,29,11,18,7,3,0,1,3
S01008053,Occupancy rating +2 or more,189,48,32,16,140,36,91,38,42,11,13,4,9,1,0,0,0,1
S01008053,Occupancy rating +1,57,17,9,8,37,8,19,6,11,2,10,3,7,3,0,0,1,2
S01008053,Occupancy rating 0,11,0,0,0,9,1,4,0,3,1,4,2,2,2,2,0,0,0
S01008053,Occupancy rating -1 or less,6,0,0,0,5,0,3,0,2,1,2,2,0,1,1,0,0,0
S01008054,All households,361,143,86,57,207,51,142,58,69,15,14,7,7,11,2,0,1,8
S01008054,Occupancy rating +2 or more,204,47,30,17,149,33,109,43,58,8,7,5,2,8,2,0,1,5
S01008054,Occupancy rating +1,71,29,20,9,42,15,22,10,6,6,5,2,3,0,0,0,0,0
S01008054,Occupancy rating 0,73,59,31,28,12,3,8,4,4,0,1,0,1,2,0,0,0,2
S01008054,Occupancy rating -1 or less,13,8,5,3,4,0,3,1,1,1,1,0,1,1,0,0,0,1
S01008055,All households,384,60,46,14,318,58,242,68,128,46,18,9,9,6,2,0,0,4
S01008055,Occupancy rating +2 or more,330,58,45,13,266,54,201,68,99,34,11,6,5,6,2,0,0,4
S01008055,Occupancy rating +1,33,1,0,1,32,3,26,0,16,10,3,2,1,0,0,0,0,0
S01008055,Occupancy rating 0,16,1,1,0,15,0,12,0,10,2,3,1,2,0,0,0,0,0
S01008055,Occupancy rating -1 or less,5,0,0,0,5,1,3,0,3,0,1,0,1,0,0,0,0,0
S01008056,All households,332,122,98,24,203,52,137,33,78,26,14,8,6,7,4,0,0,3
S01008056,Occupancy rating +2 or more,213,48,34,14,159,41,113,33,60,20,5,2,3,6,4,0,0,2
S01008056,Occupancy rating +1,58,32,28,4,26,6,17,0,12,5,3,2,1,0,0,0,0,0
S01008056,Occupancy rating 0,33,22,17,5,10,3,4,0,3,1,3,1,2,1,0,0,0,1
S01008056,Occupancy rating -1 or less,28,20,19,1,8,2,3,0,3,0,3,3,0,0,0,0,0,0
S01008057,All households,400,136,79,57,253,54,187,47,98,42,12,7,5,11,5,0,1,5
S01008057,Occupancy rating +2 or more,249,50,33,17,196,46,145,40,69,36,5,2,3,3,1,0,1,1
S01008057,Occupancy rating +1,60,27,15,12,29,5,21,3,14,4,3,1,2,4,4,0,0,0
S01008057,Occupancy rating 0,70,46,22,24,21,2,16,4,10,2,3,3,0,3,0,0,0,3
S01008057,Occupancy rating -1 or less,21,13,9,4,7,1,5,0,5,0,1,1,0,1,0,0,0,1
S01008058,All households,304,41,20,21,248,16,215,80,93,42,17,10,7,15,10,0,0,5
S01008058,Occupancy rating +2 or more,271,39,20,19,223,15,197,77,83,37,11,8,3,9,7,0,0,2
S01008058,Occupancy rating +1,18,0,0,0,16,1,13,2,6,5,2,1,1,2,1,0,0,1
S01008058,Occupancy rating 0,11,2,0,2,7,0,3,1,2,0,4,1,3,2,1,0,0,1
S01008058,Occupancy rating -1 or less,4,0,0,0,2,0,2,0,2,0,0,0,0,2,1,0,0,1
S01008059,All households,260,49,27,22,207,35,152,52,60,40,20,14,6,4,1,0,0,3
S01008059,Occupancy rating +2 or more,173,36,21,15,134,29,96,42,31,23,9,6,3,3,0,0,0,3
S01008059,Occupancy rating +1,53,11,5,6,42,2,36,10,16,10,4,2,2,0,0,0,0,0
S01008059,Occupancy rating 0,27,1,0,1,25,3,16,0,10,6,6,6,0,1,1,0,0,0
S01008059,Occupancy rating -1 or less,7,1,1,0,6,1,4,0,3,1,1,0,1,0,0,0,0,0
S01008060,All households,326,51,27,24,263,34,208,69,99,40,21,14,7,12,6,0,0,6
S01008060,Occupancy rating +2 or more,222,41,22,19,176,31,134,59,55,20,11,7,4,5,2,0,0,3
S01008060,Occupancy rating +1,70,9,5,4,60,3,52,9,30,13,5,3,2,1,1,0,0,0
S01008060,Occupancy rating 0,25,0,0,0,21,0,18,1,12,5,3,3,0,4,3,0,0,1
S01008060,Occupancy rating -1 or less,9,1,0,1,6,0,4,0,2,2,2,1,1,2,0,0,0,2
S01008061,All households,283,89,43,46,188,12,154,38,98,18,22,16,6,6,2,0,0,4
S01008061,Occupancy rating +2 or more,145,31,16,15,113,7,99,28,60,11,7,5,2,1,0,0,0,1
S01008061,Occupancy rating +1,88,43,24,19,43,5,34,8,23,3,4,3,1,2,1,0,0,1
S01008061,Occupancy rating 0,36,13,2,11,23,0,15,2,10,3,8,5,3,0,0,0,0,0
S01008061,Occupancy rating -1 or less,14,2,1,1,9,0,6,0,5,1,3,3,0,3,1,0,0,2
S01008062,All households,371,103,43,60,260,52,177,55,78,44,31,23,8,8,4,0,0,4
S01008062,Occupancy rating +2 or more,143,31,16,15,110,33,76,33,30,13,1,1,0,2,1,0,0,1
S01008062,Occupancy rating +1,158,61,22,39,93,19,64,20,27,17,10,8,2,4,2,0,0,2
S01008062,Occupancy rating 0,51,8,5,3,42,0,28,0,18,10,14,9,5,1,0,0,0,1
S01008062,Occupancy rating -1 or less,19,3,0,3,15,0,9,2,3,4,6,5,1,1,1,0,0,0
S01008063,All households,381,97,58,39,274,53,185,58,94,33,36,20,16,10,8,0,0,2
S01008063,Occupancy rating +2 or more,263,67,46,21,192,49,130,52,62,16,13,5,8,4,3,0,0,1
S01008063,Occupancy rating +1,77,27,11,16,49,4,32,4,18,10,13,7,6,1,1,0,0,0
S01008063,Occupancy rating 0,31,3,1,2,25,0,18,2,10,6,7,5,2,3,3,0,0,0
S01008063,Occupancy rating -1 or less,10,0,0,0,8,0,5,0,4,1,3,3,0,2,1,0,0,1
S01008064,All households,296,99,43,56,184,18,103,26,50,27,63,35,28,13,6,0,0,7
S01008064,Occupancy rating +2 or more,91,35,19,16,52,16,31,18,11,2,5,1,4,4,2,0,0,2
S01008064,Occupancy rating +1,72,28,14,14,41,2,27,4,13,10,12,7,5,3,1,0,0,2
S01008064,Occupancy rating 0,107,32,9,23,70,0,35,4,18,13,35,18,17,5,2,0,0,3
S01008064,Occupancy rating -1 or less,26,4,1,3,21,0,10,0,8,2,11,9,2,1,1,0,0,0
S01008065,All households,348,52,35,17,286,32,233,66,124,43,21,9,12,10,5,0,0,5
S01008065,Occupancy rating +2 or more,283,45,33,12,232,30,188,63,96,29,14,4,10,6,3,0,0,3
S01008065,Occupancy rating +1,49,7,2,5,38,2,33,3,18,12,3,2,1,4,2,0,0,2
S01008065,Occupancy rating 0,12,0,0,0,12,0,10,0,8,2,2,1,1,0,0,0,0,0
S01008065,Occupancy rating -1 or less,4,0,0,0,4,0,2,0,2,0,2,2,0,0,0,0,0,0
S01008066,All households,326,45,32,13,269,46,201,60,110,31,22,10,12,12,7,0,0,5
S01008066,Occupancy rating +2 or more,294,44,32,12,242,45,180,58,94,28,17,9,8,8,3,0,0,5
S01008066,Occupancy rating +1,19,0,0,0,17,0,14,2,10,2,3,1,2,2,2,0,0,0
S01008066,Occupancy rating 0,10,0,0,0,9,1,6,0,5,1,2,0,2,1,1,0,0,0
S01008066,Occupancy rating -1 or less,3,1,0,1,1,0,1,0,1,0,0,0,0,1,1,0,0,0
S01008067,All households,257,62,37,25,186,43,129,45,62,22,14,11,3,9,3,0,0,6
S01008067,Occupancy rating +2 or more,181,37,23,14,137,37,94,37,42,15,6,5,1,7,3,0,0,4
S01008067,Occupancy rating +1,52,21,13,8,31,6,23,7,11,5,2,2,0,0,0,0,0,0
S01008067,Occupancy rating 0,20,3,1,2,15,0,11,1,8,2,4,2,2,2,0,0,0,2
S01008067,Occupancy rating -1 or less,4,1,0,1,3,0,1,0,1,0,2,2,0,0,0,0,0,0
S01008068,All households,384,100,60,40,273,54,199,69,85,45,20,8,12,11,2,0,2,7
S01008068,Occupancy rating +2 or more,245,62,45,17,176,44,129,56,48,25,3,1,2,7,0,0,0,7
S01008068,Occupancy rating +1,82,29,7,22,52,9,37,12,15,10,6,1,5,1,1,0,0,0
S01008068,Occupancy rating 0,45,8,7,1,35,0,28,1,19,8,7,3,4,2,1,0,1,0
S01008068,Occupancy rating -1 or less,12,1,1,0,10,1,5,0,3,2,4,3,1,1,0,0,1,0
S01008069,All households,385,94,49,45,278,53,197,65,96,36,28,18,10,13,8,0,0,5
S01008069,Occupancy rating +2 or more,119,24,11,13,94,25,66,35,22,9,3,1,2,1,0,0,0,1
S01008069,Occupancy rating +1,158,60,31,29,95,26,64,26,28,10,5,4,1,3,2,0,0,1
S01008069,Occupancy rating 0,85,5,3,2,75,2,57,4,39,14,16,10,6,5,3,0,0,2
S01008069,Occupancy rating -1 or less,23,5,4,1,14,0,10,0,7,3,4,3,1,4,3,0,0,1
S01008070,All households,356,76,38,38,267,26,196,68,74,54,45,24,21,13,5,0,4,4
S01008070,Occupancy rating +2 or more,106,24,11,13,82,17,61,37,17,7,4,2,2,0,0,0,0,0
S01008070,Occupancy rating +1,152,46,25,21,104,8,79,30,25,24,17,7,10,2,1,0,0,1
S01008070,Occupancy rating 0,75,5,1,4,65,1,47,1,27,19,17,9,8,5,1,0,3,1
S01008070,Occupancy rating -1 or less,23,1,1,0,16,0,9,0,5,4,7,6,1,6,3,0,1,2
S01008071,All households,287,64,35,29,216,30,158,56,74,28,28,22,6,7,3,0,2,2
S01008071,Occupancy rating +2 or more,184,39,22,17,141,26,105,46,42,17,10,7,3,4,1,0,1,2
S01008071,Occupancy rating +1,59,11,6,5,46,4,32,7,19,6,10,7,3,2,1,0,1,0
S01008071,Occupancy rating 0,39,14,7,7,24,0,18,3,12,3,6,6,0,1,1,0,0,0
S01008071,Occupancy rating -1 or less,5,0,0,0,5,0,3,0,1,2,2,2,0,0,0,0,0,0
S01008072,All households,350,131,30,101,207,17,156,67,69,20,34,22,12,12,2,0,1,9
S01008072,Occupancy rating +2 or more,158,38,9,29,114,11,98,37,53,8,5,4,1,6,2,0,1,3
S01008072,Occupancy rating +1,118,65,16,49,53,6,41,24,9,8,6,5,1,0,0,0,0,0
S01008072,Occupancy rating 0,61,27,4,23,30,0,16,6,6,4,14,6,8,4,0,0,0,4
S01008072,Occupancy rating -1 or less,13,1,1,0,10,0,1,0,1,0,9,7,2,2,0,0,0,2
S01008073,All households,178,25,11,14,149,39,105,38,44,23,5,1,4,4,2,0,0,2
S01008073,Occupancy rating +2 or more,152,20,9,11,130,36,91,38,37,16,3,0,3,2,1,0,0,1
S01008073,Occupancy rating +1,19,5,2,3,13,3,9,0,3,6,1,0,1,1,0,0,0,1
S01008073,Occupancy rating 0,4,0,0,0,4,0,3,0,3,0,1,1,0,0,0,0,0,0
S01008073,Occupancy rating -1 or less,3,0,0,0,2,0,2,0,1,1,0,0,0,1,1,0,0,0
S01008074,All households,378,75,52,23,281,41,212,70,95,47,28,11,17,22,5,0,1,16
S01008074,Occupancy rating +2 or more,306,67,47,20,227,39,172,66,71,35,16,6,10,12,2,0,1,9
S01008074,Occupancy rating +1,40,5,3,2,30,1,22,3,14,5,7,2,5,5,0,0,0,5
S01008074,Occupancy rating 0,22,2,1,1,15,1,11,0,7,4,3,1,2,5,3,0,0,2
S01008074,Occupancy rating -1 or less,10,1,1,0,9,0,7,1,3,3,2,2,0,0,0,0,0,0
S01008075,All households,246,60,48,12,177,52,111,28,65,18,14,7,7,9,3,0,3,3
S01008075,Occupancy rating +2 or more,213,57,45,12,148,50,94,26,54,14,4,2,2,8,3,0,3,2
S01008075,Occupancy rating +1,24,3,3,0,20,2,13,2,8,3,5,2,3,1,0,0,0,1
S01008075,Occupancy rating 0,3,0,0,0,3,0,1,0,0,1,2,2,0,0,0,0,0,0
S01008075,Occupancy rating -1 or less,6,0,0,0,6,0,3,0,3,0,3,1,2,0,0,0,0,0
S01008076,All households,301,104,66,38,186,73,100,41,39,20,13,3,10,11,4,0,4,3
S01008076,Occupancy rating +2 or more,226,80,55,25,143,59,79,37,27,15,5,0,5,3,1,0,0,2
S01008076,Occupancy rating +1,53,17,8,9,30,9,16,4,8,4,5,2,3,6,2,0,3,1
S01008076,Occupancy rating 0,18,7,3,4,10,4,3,0,2,1,3,1,2,1,0,0,1,0
S01008076,Occupancy rating -1 or less,4,0,0,0,3,1,2,0,2,0,0,0,0,1,1,0,0,0
S01008077,All households,349,106,70,36,236,44,176,60,83,33,16,9,7,7,3,0,2,2
S01008077,Occupancy rating +2 or more,264,67,40,27,191,34,148,57,65,26,9,5,4,6,3,0,1,2
S01008077,Occupancy rating +1,57,30,24,6,27,10,16,3,9,4,1,0,1,0,0,0,0,0
S01008077,Occupancy rating 0,25,8,5,3,17,0,11,0,8,3,6,4,2,0,0,0,0,0
S01008077,Occupancy rating -1 or less,3,1,1,0,1,0,1,0,1,0,0,0,0,1,0,0,1,0
S01008078,All households,350,98,64,34,237,50,164,53,80,31,23,11,12,15,5,0,1,9
S01008078,Occupancy rating +2 or more,221,46,32,14,173,42,120,41,55,24,11,4,7,2,0,0,0,2
S01008078,Occupancy rating +1,67,26,21,5,39,6,29,6,17,6,4,3,1,2,1,0,0,1
S01008078,Occupancy rating 0,54,25,11,14,20,2,12,4,7,1,6,3,3,9,3,0,1,5
S01008078,Occupancy rating -1 or less,8,1,0,1,5,0,3,2,1,0,2,1,1,2,1,0,0,1
S01008079,All households,341,48,40,8,280,64,195,65,81,49,21,10,11,13,6,0,3,4
S01008079,Occupancy rating +2 or more,282,41,35,6,238,63,163,63,59,41,12,5,7,3,1,0,0,2
S01008079,Occupancy rating +1,44,6,4,2,32,1,24,2,14,8,7,3,4,6,3,0,2,1
S01008079,Occupancy rating 0,9,0,0,0,7,0,5,0,5,0,2,2,0,2,1,0,0,1
S01008079,Occupancy rating -1 or less,6,1,1,0,3,0,3,0,3,0,0,0,0,2,1,0,1,0
S01008080,All households,279,60,34,26,204,38,149,59,65,25,17,13,4,15,6,0,1,8
S01008080,Occupancy rating +2 or more,207,40,25,15,159,33,119,54,46,19,7,5,2,8,2,0,0,6
S01008080,Occupancy rating +1,48,15,6,9,29,3,22,4,14,4,4,3,1,4,1,0,1,2
S01008080,Occupancy rating 0,17,4,3,1,13,2,6,1,4,1,5,5,0,0,0,0,0,0
S01008080,Occupancy rating -1 or less,7,1,0,1,3,0,2,0,1,1,1,0,1,3,3,0,0,0
S01008081,All households,235,61,38,23,164,29,118,35,53,30,17,8,9,10,8,0,0,2
S01008081,Occupancy rating +2 or more,187,48,30,18,135,25,100,31,45,24,10,6,4,4,3,0,0,1
S01008081,Occupancy rating +1,36,9,6,3,22,4,14,3,6,5,4,0,4,5,4,0,0,1
S01008081,Occupancy rating 0,7,2,1,1,5,0,3,1,1,1,2,1,1,0,0,0,0,0
S01008081,Occupancy rating -1 or less,5,2,1,1,2,0,1,0,1,0,1,1,0,1,1,0,0,0
S01008082,All households,328,73,50,23,235,35,173,62,71,40,27,16,11,20,8,0,1,11
S01008082,Occupancy rating +2 or more,240,53,41,12,174,30,130,56,47,27,14,9,5,13,3,0,1,9
S01008082,Occupancy rating +1,58,10,6,4,45,5,32,4,18,10,8,4,4,3,3,0,0,0
S01008082,Occupancy rating 0,22,8,2,6,12,0,8,1,5,2,4,2,2,2,1,0,0,1
S01008082,Occupancy rating -1 or less,8,2,1,1,4,0,3,1,1,1,1,1,0,2,1,0,0,1
S01008083,All households,270,49,33,16,215,43,144,42,70,32,28,15,13,6,5,0,0,1
S01008083,Occupancy rating +2 or more,206,44,28,16,159,40,108,41,46,21,11,2,9,3,2,0,0,1
S01008083,Occupancy rating +1,45,3,3,0,40,3,25,1,17,7,12,10,2,2,2,0,0,0
S01008083,Occupancy rating 0,16,2,2,0,14,0,10,0,6,4,4,2,2,0,0,0,0,0
S01008083,Occupancy rating -1 or less,3,0,0,0,2,0,1,0,1,0,1,1,0,1,1,0,0,0
S01008084,All households,353,92,47,45,252,38,173,63,80,30,41,28,13,9,4,0,0,5
S01008084,Occupancy rating +2 or more,217,51,31,20,160,35,118,51,46,21,7,2,5,6,1,0,0,5
S01008084,Occupancy rating +1,70,25,8,17,43,2,32,12,15,5,9,3,6,2,2,0,0,0
S01008084,Occupancy rating 0,44,13,6,7,31,0,13,0,11,2,18,16,2,0,0,0,0,0
S01008084,Occupancy rating -1 or less,22,3,2,1,18,1,10,0,8,2,7,7,0,1,1,0,0,0
S01008085,All households,339,48,26,22,271,25,229,73,107,49,17,9,8,20,9,0,3,8
S01008085,Occupancy rating +2 or more,260,40,20,20,210,25,176,70,70,36,9,6,3,10,2,0,2,6
S01008085,Occupancy rating +1,49,5,4,1,39,0,34,2,22,10,5,1,4,5,4,0,1,0
S01008085,Occupancy rating 0,21,2,2,0,16,0,16,1,13,2,0,0,0,3,1,0,0,2
S01008085,Occupancy rating -1 or less,9,1,0,1,6,0,3,0,2,1,3,2,1,2,2,0,0,0
S01008086,All households,418,94,42,52,311,26,241,72,118,51,44,29,15,13,7,0,0,6
S01008086,Occupancy rating +2 or more,230,41,20,21,185,20,152,61,71,20,13,8,5,4,1,0,0,3
S01008086,Occupancy rating +1,106,40,16,24,62,4,46,9,24,13,12,6,6,4,3,0,0,1
S01008086,Occupancy rating 0,66,12,5,7,51,1,35,2,20,13,15,11,4,3,1,0,0,2
S01008086,Occupancy rating -1 or less,16,1,1,0,13,1,8,0,3,5,4,4,0,2,2,0,0,0
S01008087,All households,330,69,55,14,253,62,162,42,82,38,29,14,15,8,5,1,1,1
S01008087,Occupancy rating +2 or more,259,65,53,12,190,56,117,41,48,28,17,9,8,4,2,1,1,0
S01008087,Occupancy rating +1,50,3,2,1,46,5,31,1,25,5,10,4,6,1,1,0,0,0
S01008087,Occupancy rating 0,14,1,0,1,11,1,9,0,6,3,1,0,1,2,2,0,0,0
S01008087,Occupancy rating -1 or less,7,0,0,0,6,0,5,0,3,2,1,1,0,1,0,0,0,1
S01008088,All households,398,122,76,46,265,59,173,54,73,46,33,22,11,11,5,0,0,6
S01008088,Occupancy rating +2 or more,225,48,35,13,171,48,113,42,42,29,10,5,5,6,2,0,0,4
S01008088,Occupancy rating +1,104,52,32,20,50,6,41,8,21,12,3,3,0,2,2,0,0,0
S01008088,Occupancy rating 0,51,15,8,7,34,5,15,3,7,5,14,9,5,2,1,0,0,1
S01008088,Occupancy rating -1 or less,18,7,1,6,10,0,4,1,3,0,6,5,1,1,0,0,0,1
S01008089,All households,243,42,30,12,197,37,141,34,69,38,19,4,15,4,1,0,1,2
S01008089,Occupancy rating +2 or more,154,36,26,10,117,30,81,31,31,19,6,1,5,1,0,0,1,0
S01008089,Occupancy rating +1,51,5,3,2,46,5,35,3,20,12,6,1,5,0,0,0,0,0
S01008089,Occupancy rating 0,28,1,1,0,25,2,18,0,12,6,5,1,4,2,1,0,0,1
S01008089,Occupancy rating -1 or less,10,0,0,0,9,0,7,0,6,1,2,1,1,1,0,0,0,1
S01008090,All households,305,73,54,19,227,28,164,41,79,44,35,23,12,5,2,0,0,3
S01008090,Occupancy rating +2 or more,173,47,40,7,123,19,93,30,36,27,11,4,7,3,1,0,0,2
S01008090,Occupancy rating +1,82,21,10,11,60,8,44,11,24,9,8,6,2,1,0,0,0,1
S01008090,Occupancy rating 0,38,3,2,1,34,0,21,0,15,6,13,10,3,1,1,0,0,0
S01008090,Occupancy rating -1 or less,12,2,2,0,10,1,6,0,4,2,3,3,0,0,0,0,0,0
S01008091,All households,146,16,11,5,121,30,82,31,30,21,9,5,4,9,6,0,0,3
S01008091,Occupancy rating +2 or more,104,14,9,5,86,24,57,29,16,12,5,2,3,4,1,0,0,3
S01008091,Occupancy rating +1,27,1,1,0,22,4,17,1,9,7,1,0,1,4,4,0,0,0
S01008091,Occupancy rating 0,14,1,1,0,12,2,8,1,5,2,2,2,0,1,1,0,0,0
S01008091,Occupancy rating -1 or less,1,0,0,0,1,0,0,0,0,0,1,1,0,0,0,0,0,0
S01008092,All households,368,94,73,21,267,87,170,36,91,43,10,5,5,7,3,0,1,3
S01008092,Occupancy rating +2 or more,271,65,47,18,203,77,121,34,61,26,5,3,2,3,1,0,1,1
S01008092,Occupancy rating +1,53,11,10,1,41,6,31,1,21,9,4,2,2,1,1,0,0,0
S01008092,Occupancy rating 0,36,16,14,2,18,3,14,0,6,8,1,0,1,2,0,0,0,2
S01008092,Occupancy rating -1 or less,8,2,2,0,5,1,4,1,3,0,0,0,0,1,1,0,0,0
S01008093,All households,331,95,71,24,219,43,146,36,73,37,30,16,14,17,7,0,4,6
S01008093,Occupancy rating +2 or more,204,66,52,14,130,38,80,32,32,16,12,6,6,8,3,0,2,3
S01008093,Occupancy rating +1,86,24,16,8,58,3,46,4,27,15,9,6,3,4,1,0,0,3
S01008093,Occupancy rating 0,33,4,2,2,27,1,17,0,11,6,9,4,5,2,0,0,2,0
S01008093,Occupancy rating -1 or less,8,1,1,0,4,1,3,0,3,0,0,0,0,3,3,0,0,0
S01008094,All households,257,50,35,15,199,43,140,41,62,37,16,6,10,8,6,0,1,1
S01008094,Occupancy rating +2 or more,205,41,28,13,157,41,106,38,39,29,10,3,7,7,6,0,0,1
S01008094,Occupancy rating +1,34,8,6,2,25,1,22,2,14,6,2,0,2,1,0,0,1,0
S01008094,Occupancy rating 0,13,0,0,0,13,1,9,1,6,2,3,2,1,0,0,0,0,0
S01008094,Occupancy rating -1 or less,5,1,1,0,4,0,3,0,3,0,1,1,0,0,0,0,0,0
S01008095,All households,345,126,64,62,212,50,128,34,53,41,34,17,17,7,4,0,0,3
S01008095,Occupancy rating +2 or more,124,39,21,18,85,21,59,24,20,15,5,3,2,0,0,0,0,0
S01008095,Occupancy rating +1,126,56,26,30,68,26,31,10,12,9,11,3,8,2,1,0,0,1
S01008095,Occupancy rating 0,78,27,16,11,48,3,31,0,17,14,14,9,5,3,2,0,0,1
S01008095,Occupancy rating -1 or less,17,4,1,3,11,0,7,0,4,3,4,2,2,2,1,0,0,1
S01008096,All households,334,93,71,22,224,62,142,42,64,36,20,7,13,17,8,0,2,7
S01008096,Occupancy rating +2 or more,197,48,32,16,142,44,95,32,37,26,3,1,2,7,1,0,1,5
S01008096,Occupancy rating +1,72,23,17,6,44,12,22,8,8,6,10,3,7,5,2,0,1,2
S01008096,Occupancy rating 0,47,15,15,0,29,5,19,1,15,3,5,2,3,3,3,0,0,0
S01008096,Occupancy rating -1 or less,18,7,7,0,9,1,6,1,4,1,2,1,1,2,2,0,0,0
S01008097,All households,281,101,78,23,172,42,106,31,50,25,24,11,13,8,4,0,2,2
S01008097,Occupancy rating +2 or more,142,35,20,15,105,32,65,25,29,11,8,3,5,2,2,0,0,0
S01008097,Occupancy rating +1,68,32,25,7,33,8,20,3,10,7,5,2,3,3,1,0,1,1
S01008097,Occupancy rating 0,59,30,29,1,26,2,19,3,9,7,5,3,2,3,1,0,1,1
S01008097,Occupancy rating -1 or less,12,4,4,0,8,0,2,0,2,0,6,3,3,0,0,0,0,0
S01008098,All households,293,71,43,28,206,40,144,45,64,35,22,15,7,16,8,0,1,7
S01008098,Occupancy rating +2 or more,157,47,30,17,104,25,73,34,22,17,6,3,3,6,3,0,0,3
S01008098,Occupancy rating +1,81,21,10,11,60,14,40,11,18,11,6,5,1,0,0,0,0,0
S01008098,Occupancy rating 0,35,1,1,0,29,0,24,0,18,6,5,3,2,5,1,0,1,3
S01008098,Occupancy rating -1 or less,20,2,2,0,13,1,7,0,6,1,5,4,1,5,4,0,0,1
S01008099,All households,209,47,25,22,154,17,116,45,52,19,21,11,10,8,4,0,0,4
S01008099,Occupancy rating +2 or more,105,25,16,9,76,11,57,30,21,6,8,4,4,4,2,0,0,2
S01008099,Occupancy rating +1,68,18,8,10,49,6,39,15,16,8,4,1,3,1,1,0,0,0
S01008099,Occupancy rating 0,27,3,1,2,23,0,16,0,12,4,7,4,3,1,0,0,0,1
S01008099,Occupancy rating -1 or less,9,1,0,1,6,0,4,0,3,1,2,2,0,2,1,0,0,1
S01008100,All households,401,138,104,34,246,54,171,55,74,42,21,12,9,17,6,0,0,11
S01008100,Occupancy rating +2 or more,230,38,21,17,179,36,134,49,54,31,9,6,3,13,4,0,0,9
S01008100,Occupancy rating +1,71,32,22,10,37,8,23,5,12,6,6,3,3,2,1,0,0,1
S01008100,Occupancy rating 0,87,61,54,7,24,9,12,1,7,4,3,2,1,2,1,0,0,1
S01008100,Occupancy rating -1 or less,13,7,7,0,6,1,2,0,1,1,3,1,2,0,0,0,0,0
S01008101,All households,351,132,25,107,209,16,148,48,77,23,45,30,15,10,7,0,0,3
S01008101,Occupancy rating +2 or more,133,33,11,22,99,8,86,26,44,16,5,3,2,1,0,0,0,1
S01008101,Occupancy rating +1,111,55,10,45,51,6,35,16,18,1,10,6,4,5,4,0,0,1
S01008101,Occupancy rating 0,88,40,4,36,46,2,18,6,10,2,26,19,7,2,1,0,0,1
S01008101,Occupancy rating -1 or less,19,4,0,4,13,0,9,0,5,4,4,2,2,2,2,0,0,0
S01008102,All households,310,91,32,59,198,26,125,42,50,33,47,25,22,21,8,0,1,12
S01008102,Occupancy rating +2 or more,111,34,14,20,73,15,48,24,16,8,10,4,6,4,2,0,0,2
S01008102,Occupancy rating +1,109,39,13,26,63,9,41,15,16,10,13,6,7,7,2,0,1,4
S01008102,Occupancy rating 0,61,12,4,8,41,1,24,2,13,9,16,10,6,8,2,0,0,6
S01008102,Occupancy rating -1 or less,29,6,1,5,21,1,12,1,5,6,8,5,3,2,2,0,0,0
S01008103,All households,338,176,72,104,153,22,84,32,36,16,47,28,19,9,2,0,0,7
S01008103,Occupancy rating +2 or more,65,23,12,11,42,8,29,14,12,3,5,2,3,0,0,0,0,0
S01008103,Occupancy rating +1,93,58,23,35,35,10,20,12,6,2,5,1,4,0,0,0,0,0
S01008103,Occupancy rating 0,151,85,34,51,60,4,29,6,14,9,27,19,8,6,0,0,0,6
S01008103,Occupancy rating -1 or less,29,10,3,7,16,0,6,0,4,2,10,6,4,3,2,0,0,1
S01008104,All households,390,134,50,84,242,28,137,43,57,37,77,47,30,14,3,0,0,11
S01008104,Occupancy rating +2 or more,98,31,12,19,63,17,42,21,12,9,4,2,2,4,0,0,0,4
S01008104,Occupancy rating +1,112,49,17,32,61,9,45,19,14,12,7,2,5,2,0,0,0,2
S01008104,Occupancy rating 0,134,44,19,25,86,1,36,3,22,11,49,33,16,4,1,0,0,3
S01008104,Occupancy rating -1 or less,46,10,2,8,32,1,14,0,9,5,17,10,7,4,2,0,0,2
S01008105,All households,518,219,89,130,287,16,159,57,73,29,112,76,36,12,3,0,1,8
S01008105,Occupancy rating +2 or more,74,27,11,16,45,7,30,16,13,1,8,5,3,2,0,0,0,2
S01008105,Occupancy rating +1,143,71,16,55,69,5,48,23,17,8,16,7,9,3,0,0,1,2
S01008105,Occupancy rating 0,233,106,58,48,125,3,63,11,34,18,59,41,18,2,0,0,0,2
S01008105,Occupancy rating -1 or less,68,15,4,11,48,1,18,7,9,2,29,23,6,5,3,0,0,2
S01008106,All households,371,150,57,93,201,20,110,42,44,24,71,45,26,20,12,0,1,7
S01008106,Occupancy rating +2 or more,87,46,24,22,38,13,19,14,3,2,6,4,2,3,2,0,0,1
S01008106,Occupancy rating +1,103,39,8,31,57,3,35,12,16,7,19,11,8,7,3,0,0,4
S01008106,Occupancy rating 0,140,54,20,34,81,3,47,14,22,11,31,21,10,5,3,0,1,1
S01008106,Occupancy rating -1 or less,41,11,5,6,25,1,9,2,3,4,15,9,6,5,4,0,0,1
S01008107,All households,281,40,6,34,220,9,193,37,142,14,18,12,6,21,10,0,0,11
S01008107,Occupancy rating +2 or more,189,14,1,13,164,6,153,29,113,11,5,4,1,11,7,0,0,4
S01008107,Occupancy rating +1,42,10,2,8,25,2,19,4,13,2,4,2,2,7,2,0,0,5
S01008107,Occupancy rating 0,41,15,3,12,24,1,17,3,14,0,6,3,3,2,1,0,0,1
S01008107,Occupancy rating -1 or less,9,1,0,1,7,0,4,1,2,1,3,3,0,1,0,0,0,1
S01008108,All households,244,49,9,40,189,14,153,43,62,48,22,11,11,6,5,0,0,1
S01008108,Occupancy rating +2 or more,108,18,4,14,88,10,74,31,19,24,4,1,3,2,1,0,0,1
S01008108,Occupancy rating +1,75,17,3,14,56,4,45,10,27,8,7,3,4,2,2,0,0,0
S01008108,Occupancy rating 0,49,13,2,11,34,0,24,2,12,10,10,6,4,2,2,0,0,0
S01008108,Occupancy rating -1 or less,12,1,0,1,11,0,10,0,4,6,1,1,0,0,0,0,0,0
S01008109,All households,332,44,24,20,262,31,193,55,87,51,38,25,13,26,13,0,1,12
S01008109,Occupancy rating +2 or more,171,27,19,8,137,26,101,47,38,16,10,8,2,7,3,0,0,4
S01008109,Occupancy rating +1,89,15,5,10,71,3,58,7,28,23,10,4,6,3,1,0,1,1
S01008109,Occupancy rating 0,53,2,0,2,43,2,27,1,16,10,14,11,3,8,3,0,0,5
S01008109,Occupancy rating -1 or less,19,0,0,0,11,0,7,0,5,2,4,2,2,8,6,0,0,2
S01008110,All households,316,54,29,25,247,31,193,39,109,45,23,15,8,15,9,0,2,4
S01008110,Occupancy rating +2 or more,144,33,19,14,108,27,77,24,40,13,4,1,3,3,1,0,1,1
S01008110,Occupancy rating +1,111,16,6,10,87,2,74,14,43,17,11,7,4,8,4,0,1,3
S01008110,Occupancy rating 0,48,3,2,1,42,1,33,0,20,13,8,7,1,3,3,0,0,0
S01008110,Occupancy rating -1 or less,13,2,2,0,10,1,9,1,6,2,0,0,0,1,1,0,0,0
S01008111,All households,349,96,78,18,240,46,173,45,75,53,21,10,11,13,8,0,0,5
S01008111,Occupancy rating +2 or more,208,50,36,14,153,38,109,39,41,29,6,1,5,5,2,0,0,3
S01008111,Occupancy rating +1,73,13,11,2,58,5,46,4,24,18,7,2,5,2,1,0,0,1
S01008111,Occupancy rating 0,49,26,25,1,20,3,14,1,8,5,3,3,0,3,2,0,0,1
S01008111,Occupancy rating -1 or less,19,7,6,1,9,0,4,1,2,1,5,4,1,3,3,0,0,0
S01008112,All households,322,64,46,18,247,66,159,40,62,57,22,10,12,11,6,0,1,4
S01008112,Occupancy rating +2 or more,215,54,36,18,157,63,89,38,25,26,5,1,4,4,2,0,1,1
S01008112,Occupancy rating +1,70,9,9,0,56,2,47,1,26,20,7,4,3,5,2,0,0,3
S01008112,Occupancy rating 0,28,0,0,0,27,1,19,1,10,8,7,4,3,1,1,0,0,0
S01008112,Occupancy rating -1 or less,9,1,1,0,7,0,4,0,1,3,3,1,2,1,1,0,0,0
S01008113,All households,359,78,52,26,269,61,182,59,66,57,26,12,14,12,5,0,0,7
S01008113,Occupancy rating +2 or more,218,46,35,11,168,44,114,50,33,31,10,4,6,4,2,0,0,2
S01008113,Occupancy rating +1,90,21,11,10,67,15,46,7,20,19,6,3,3,2,0,0,0,2
S01008113,Occupancy rating 0,40,10,6,4,27,1,16,2,10,4,10,5,5,3,1,0,0,2
S01008113,Occupancy rating -1 or less,11,1,0,1,7,1,6,0,3,3,0,0,0,3,2,0,0,1
S01008114,All households,262,46,29,17,200,47,132,41,53,38,21,9,12,16,8,0,0,8
S01008114,Occupancy rating +2 or more,174,39,25,14,130,44,79,39,25,15,7,2,5,5,0,0,0,5
S01008114,Occupancy rating +1,44,3,2,1,37,3,29,2,16,11,5,2,3,4,4,0,0,0
S01008114,Occupancy rating 0,33,4,2,2,25,0,19,0,9,10,6,3,3,4,2,0,0,2
S01008114,Occupancy rating -1 or less,11,0,0,0,8,0,5,0,3,2,3,2,1,3,2,0,0,1
S01008115,All households,368,104,30,74,253,16,194,64,84,46,43,29,14,11,4,0,1,6
S01008115,Occupancy rating +2 or more,153,40,14,26,107,13,83,38,29,16,11,8,3,6,2,0,1,3
S01008115,Occupancy rating +1,102,26,7,19,75,3,61,20,20,21,11,7,4,1,0,0,0,1
S01008115,Occupancy rating 0,81,25,6,19,54,0,35,6,24,5,19,12,7,2,1,0,0,1
S01008115,Occupancy rating -1 or less,32,13,3,10,17,0,15,0,11,4,2,2,0,2,1,0,0,1
S01008116,All households,350,71,36,35,268,33,208,63,99,46,27,18,9,11,5,0,0,6
S01008116,Occupancy rating +2 or more,204,51,31,20,147,29,115,53,41,21,3,1,2,6,2,0,0,4
S01008116,Occupancy rating +1,91,17,4,13,73,3,60,9,33,18,10,6,4,1,0,0,0,1
S01008116,Occupancy rating 0,41,3,1,2,35,1,24,1,18,5,10,8,2,3,3,0,0,0
S01008116,Occupancy rating -1 or less,14,0,0,0,13,0,9,0,7,2,4,3,1,1,0,0,0,1
S01008117,All households,329,77,48,29,241,56,160,55,64,41,25,18,7,11,2,0,2,7
S01008117,Occupancy rating +2 or more,225,44,31,13,176,53,116,50,42,24,7,4,3,5,0,0,1,4
S01008117,Occupancy rating +1,53,10,6,4,42,3,29,3,15,11,10,6,4,1,0,0,0,1
S01008117,Occupancy rating 0,38,18,8,10,18,0,11,1,5,5,7,7,0,2,1,0,0,1
S01008117,Occupancy rating -1 or less,13,5,3,2,5,0,4,1,2,1,1,1,0,3,1,0,1,1
S01008118,All households,361,96,61,35,253,46,159,51,82,26,48,27,21,12,8,0,0,4
S01008118,Occupancy rating +2 or more,183,56,37,19,126,36,81,46,26,9,9,3,6,1,1,0,0,0
S01008118,Occupancy rating +1,85,26,15,11,56,4,43,4,29,10,9,3,6,3,0,0,0,3
S01008118,Occupancy rating 0,67,10,7,3,55,3,26,1,21,4,26,19,7,2,1,0,0,1
S01008118,Occupancy rating -1 or less,26,4,2,2,16,3,9,0,6,3,4,2,2,6,6,0,0,0
S01008119,All households,260,70,37,33,175,18,116,37,43,36,41,24,17,15,7,0,0,8
S01008119,Occupancy rating +2 or more,68,23,15,8,43,9,29,15,6,8,5,1,4,2,0,0,0,2
S01008119,Occupancy rating +1,87,29,11,18,57,7,36,19,6,11,14,9,5,1,0,0,0,1
S01008119,Occupancy rating 0,62,13,8,5,48,2,30,0,22,8,16,11,5,1,0,0,0,1
S01008119,Occupancy rating -1 or less,43,5,3,2,27,0,21,3,9,9,6,3,3,11,7,0,0,4
S01008120,All households,288,99,53,46,179,42,109,35,57,17,28,13,15,10,5,0,1,4
S01008120,Occupancy rating +2 or more,137,30,23,7,105,34,63,28,25,10,8,3,5,2,1,0,0,1
S01008120,Occupancy rating +1,75,39,17,22,33,5,21,5,13,3,7,2,5,3,2,0,0,1
S01008120,Occupancy rating 0,59,27,11,16,31,2,20,2,14,4,9,5,4,1,0,0,1,0
S01008120,Occupancy rating -1 or less,17,3,2,1,10,1,5,0,5,0,4,3,1,4,2,0,0,2
S01008121,All households,269,61,46,15,200,49,140,51,66,23,11,4,7,8,3,0,1,4
S01008121,Occupancy rating +2 or more,223,50,37,13,167,46,114,49,49,16,7,2,5,6,2,0,1,3
S01008121,Occupancy rating +1,30,10,8,2,19,3,15,2,10,3,1,0,1,1,0,0,0,1
S01008121,Occupancy rating 0,12,1,1,0,11,0,9,0,6,3,2,2,0,0,0,0,0,0
S01008121,Occupancy rating -1 or less,4,0,0,0,3,0,2,0,1,1,1,0,1,1,1,0,0,0
S01008122,All households,266,40,23,17,216,33,160,46,90,24,23,7,16,10,5,0,0,5
S01008122,Occupancy rating +2 or more,227,32,21,11,187,31,137,43,76,18,19,7,12,8,5,0,0,3
S01008122,Occupancy rating +1,22,8,2,6,14,1,12,2,6,4,1,0,1,0,0,0,0,0
S01008122,Occupancy rating 0,11,0,0,0,9,0,8,1,5,2,1,0,1,2,0,0,0,2
S01008122,Occupancy rating -1 or less,6,0,0,0,6,1,3,0,3,0,2,0,2,0,0,0,0,0
S01008123,All households,366,87,56,31,267,60,182,65,77,40,25,17,8,12,6,0,2,4
S01008123,Occupancy rating +2 or more,283,57,42,15,220,57,150,56,60,34,13,7,6,6,3,0,2,1
S01008123,Occupancy rating +1,45,16,9,7,28,3,21,5,11,5,4,2,2,1,1,0,0,0
S01008123,Occupancy rating 0,25,12,5,7,13,0,9,4,4,1,4,4,0,0,0,0,0,0
S01008123,Occupancy rating -1 or less,13,2,0,2,6,0,2,0,2,0,4,4,0,5,2,0,0,3
S01008124,All households,306,51,31,20,249,31,192,56,100,36,26,13,13,6,5,0,0,1
S01008124,Occupancy rating +2 or more,194,40,23,17,152,28,120,53,48,19,4,1,3,2,1,0,0,1
S01008124,Occupancy rating +1,80,7,4,3,72,2,56,3,40,13,14,7,7,1,1,0,0,0
S01008124,Occupancy rating 0,25,3,3,0,20,1,14,0,10,4,5,4,1,2,2,0,0,0
S01008124,Occupancy rating -1 or less,7,1,1,0,5,0,2,0,2,0,3,1,2,1,1,0,0,0
S01008125,All households,378,107,48,59,265,42,194,75,85,34,29,15,14,6,1,0,1,4
S01008125,Occupancy rating +2 or more,243,55,28,27,185,37,133,66,43,24,15,6,9,3,1,0,0,2
S01008125,Occupancy rating +1,77,26,13,13,49,3,40,5,28,7,6,3,3,2,0,0,1,1
S01008125,Occupancy rating 0,43,19,5,14,23,2,16,3,12,1,5,3,2,1,0,0,0,1
S01008125,Occupancy rating -1 or less,15,7,2,5,8,0,5,1,2,2,3,3,0,0,0,0,0,0
S01008126,All households,308,52,12,40,251,22,206,72,94,40,23,12,11,5,2,0,1,2
S01008126,Occupancy rating +2 or more,180,25,10,15,153,18,129,62,47,20,6,1,5,2,1,0,0,1
S01008126,Occupancy rating +1,85,27,2,25,56,4,46,10,22,14,6,3,3,2,1,0,0,1
S01008126,Occupancy rating 0,32,0,0,0,31,0,23,0,19,4,8,5,3,1,0,0,1,0
S01008126,Occupancy rating -1 or less,11,0,0,0,11,0,8,0,6,2,3,3,0,0,0,0,0,0
S01008127,All households,194,36,18,18,154,24,114,47,40,27,16,6,10,4,2,0,0,2
S01008127,Occupancy rating +2 or more,144,36,18,18,106,22,80,42,22,16,4,0,4,2,0,0,0,2
S01008127,Occupancy rating +1,38,0,0,0,37,2,27,4,16,7,8,3,5,1,1,0,0,0
S01008127,Occupancy rating 0,10,0,0,0,10,0,6,1,2,3,4,3,1,0,0,0,0,0
S01008127,Occupancy rating -1 or less,2,0,0,0,1,0,1,0,0,1,0,0,0,1,1,0,0,0
S01008128,All households,350,74,36,38,265,49,190,67,80,43,26,17,9,11,4,0,0,7
S01008128,Occupancy rating +2 or more,211,47,25,22,164,42,116,60,36,20,6,2,4,0,0,0,0,0
S01008128,Occupancy rating +1,87,20,8,12,61,6,47,6,26,15,8,5,3,6,2,0,0,4
S01008128,Occupancy rating 0,42,7,3,4,32,1,21,1,12,8,10,9,1,3,1,0,0,2
S01008128,Occupancy rating -1 or less,10,0,0,0,8,0,6,0,6,0,2,1,1,2,1,0,0,1
S01008129,All households,426,173,50,123,239,23,156,64,60,32,60,31,29,14,7,0,0,7
S01008129,Occupancy rating +2 or more,87,37,20,17,47,10,36,25,8,3,1,0,1,3,2,0,0,1
S01008129,Occupancy rating +1,146,51,20,31,93,13,57,23,20,14,23,7,16,2,0,0,0,2
S01008129,Occupancy rating 0,143,61,10,51,76,0,46,13,19,14,30,18,12,6,2,0,0,4
S01008129,Occupancy rating -1 or less,50,24,0,24,23,0,17,3,13,1,6,6,0,3,3,0,0,0
S01008130,All households,462,193,47,146,244,28,156,59,61,36,60,37,23,25,10,0,0,15
S01008130,Occupancy rating +2 or more,89,22,13,9,65,14,48,25,16,7,3,1,2,2,0,0,0,2
S01008130,Occupancy rating +1,154,85,23,62,66,9,42,20,9,13,15,8,7,3,0,0,0,3
S01008130,Occupancy rating 0,161,62,8,54,85,3,53,10,30,13,29,21,8,14,6,0,0,8
S01008130,Occupancy rating -1 or less,58,24,3,21,28,2,13,4,6,3,13,7,6,6,4,0,0,2
S01008131,All households,398,194,55,139,199,16,116,51,43,22,67,36,31,5,3,0,0,2
S01008131,Occupancy rating +2 or more,66,21,8,13,45,4,37,21,8,8,4,0,4,0,0,0,0,0
S01008131,Occupancy rating +1,124,71,26,45,53,8,34,20,9,5,11,4,7,0,0,0,0,0
S01008131,Occupancy rating 0,161,86,19,67,75,3,32,6,19,7,40,25,15,0,0,0,0,0
S01008131,Occupancy rating -1 or less,47,16,2,14,26,1,13,4,7,2,12,7,5,5,3,0,0,2
S01008132,All households,423,104,72,32,308,80,215,71,102,42,13,5,8,11,5,0,3,3
S01008132,Occupancy rating +2 or more,313,87,58,29,221,74,141,62,58,21,6,4,2,5,3,0,1,1
S01008132,Occupancy rating +1,73,14,11,3,55,3,46,7,25,14,6,0,6,4,1,0,1,2
S01008132,Occupancy rating 0,26,3,3,0,22,1,21,1,13,7,0,0,0,1,1,0,0,0
S01008132,Occupancy rating -1 or less,11,0,0,0,10,2,7,1,6,0,1,1,0,1,0,0,1,0
S01008133,All households,338,173,79,94,158,36,95,34,38,23,27,20,7,7,2,0,0,5
S01008133,Occupancy rating +2 or more,98,18,15,3,77,20,54,19,19,16,3,2,1,3,2,0,0,1
S01008133,Occupancy rating +1,82,53,15,38,29,10,16,9,5,2,3,2,1,0,0,0,0,0
S01008133,Occupancy rating 0,130,86,43,43,41,5,20,4,12,4,16,11,5,3,0,0,0,3
S01008133,Occupancy rating -1 or less,28,16,6,10,11,1,5,2,2,1,5,5,0,1,0,0,0,1
S01008134,All households,325,167,44,123,148,19,101,42,43,16,28,11,17,10,3,0,0,7
S01008134,Occupancy rating +2 or more,85,27,16,11,55,12,42,13,19,10,1,0,1,3,1,0,0,2
S01008134,Occupancy rating +1,102,63,17,46,37,6,27,18,6,3,4,0,4,2,1,0,0,1
S01008134,Occupancy rating 0,89,44,7,37,42,1,23,6,14,3,18,10,8,3,0,0,0,3
S01008134,Occupancy rating -1 or less,49,33,4,29,14,0,9,5,4,0,5,1,4,2,1,0,0,1
S01008135,All households,478,167,26,141,289,18,218,67,131,20,53,40,13,22,13,0,0,9
S01008135,Occupancy rating +2 or more,147,21,4,17,122,7,107,35,62,10,8,7,1,4,3,0,0,1
S01008135,Occupancy rating +1,133,63,16,47,67,8,52,20,27,5,7,6,1,3,1,0,0,2
S01008135,Occupancy rating 0,149,69,5,64,74,3,41,10,27,4,30,23,7,6,1,0,0,5
S01008135,Occupancy rating -1 or less,49,14,1,13,26,0,18,2,15,1,8,4,4,9,8,0,0,1
S01008136,All households,448,203,72,131,229,32,154,66,64,24,43,18,25,16,3,0,2,11
S01008136,Occupancy rating +2 or more,109,43,19,24,65,10,52,36,12,4,3,2,1,1,0,0,0,1
S01008136,Occupancy rating +1,180,90,34,56,87,19,53,22,20,11,15,4,11,3,0,0,0,3
S01008136,Occupancy rating 0,132,60,15,45,64,3,40,7,25,8,21,10,11,8,1,0,1,6
S01008136,Occupancy rating -1 or less,27,10,4,6,13,0,9,1,7,1,4,2,2,4,2,0,1,1
S01008137,All households,414,168,37,131,231,9,98,27,45,26,124,97,27,15,9,0,0,6
S01008137,Occupancy rating +2 or more,56,31,3,28,25,1,18,10,3,5,6,2,4,0,0,0,0,0
S01008137,Occupancy rating +1,113,69,13,56,42,6,22,9,7,6,14,12,2,2,1,0,0,1
S01008137,Occupancy rating 0,180,56,17,39,116,2,42,8,23,11,72,56,16,8,3,0,0,5
S01008137,Occupancy rating -1 or less,65,12,4,8,48,0,16,0,12,4,32,27,5,5,5,0,0,0
S01008138,All households,374,146,37,109,206,4,123,40,63,20,79,50,29,22,8,0,1,13
S01008138,Occupancy rating +2 or more,63,24,10,14,37,0,30,22,5,3,7,3,4,2,1,0,0,1
S01008138,Occupancy rating +1,121,58,13,45,57,1,38,15,15,8,18,12,6,6,2,0,0,4
S01008138,Occupancy rating 0,139,49,13,36,84,2,36,3,26,7,46,29,17,6,1,0,1,4
S01008138,Occupancy rating -1 or less,51,15,1,14,28,1,19,0,17,2,8,6,2,8,4,0,0,4
S01008139,All households,393,138,51,87,240,24,147,46,65,36,69,46,23,15,3,0,3,9
S01008139,Occupancy rating +2 or more,111,50,23,27,60,12,44,24,10,10,4,3,1,1,1,0,0,0
S01008139,Occupancy rating +1,137,53,15,38,79,10,53,18,23,12,16,10,6,5,0,0,2,3
S01008139,Occupancy rating 0,108,21,7,14,83,1,39,3,25,11,43,27,16,4,1,0,0,3
S01008139,Occupancy rating -1 or less,37,14,6,8,18,1,11,1,7,3,6,6,0,5,1,0,1,3
S01008140,All households,239,90,55,35,141,18,74,25,34,15,49,37,12,8,1,0,0,7
S01008140,Occupancy rating +2 or more,56,17,10,7,37,8,24,9,10,5,5,1,4,2,0,0,0,2
S01008140,Occupancy rating +1,67,33,11,22,34,5,22,13,4,5,7,5,2,0,0,0,0,0
S01008140,Occupancy rating 0,94,37,32,5,54,5,21,2,16,3,28,24,4,3,0,0,0,3
S01008140,Occupancy rating -1 or less,22,3,2,1,16,0,7,1,4,2,9,7,2,3,1,0,0,2
S01008141,All households,318,64,37,27,238,44,169,40,79,50,25,11,14,16,5,0,0,11
S01008141,Occupancy rating +2 or more,189,55,32,23,129,38,83,39,26,18,8,2,6,5,1,0,0,4
S01008141,Occupancy rating +1,73,5,4,1,65,6,53,1,33,19,6,1,5,3,2,0,0,1
S01008141,Occupancy rating 0,46,2,1,1,40,0,29,0,19,10,11,8,3,4,0,0,0,4
S01008141,Occupancy rating -1 or less,10,2,0,2,4,0,4,0,1,3,0,0,0,4,2,0,0,2
S01008142,All households,293,55,20,35,229,19,185,57,78,50,25,15,10,9,6,0,0,3
S01008142,Occupancy rating +2 or more,177,45,16,29,130,18,103,54,27,22,9,7,2,2,1,0,0,1
S01008142,Occupancy rating +1,66,7,3,4,57,1,51,3,31,17,5,3,2,2,0,0,0,2
S01008142,Occupancy rating 0,40,2,0,2,35,0,27,0,16,11,8,4,4,3,3,0,0,0
S01008142,Occupancy rating -1 or less,10,1,1,0,7,0,4,0,4,0,3,1,2,2,2,0,0,0
S01008143,All households,428,175,82,93,238,23,144,61,54,29,71,44,27,15,10,0,0,5
S01008143,Occupancy rating +2 or more,120,46,24,22,72,15,51,32,13,6,6,4,2,2,1,0,0,1
S01008143,Occupancy rating +1,151,78,41,37,69,5,48,25,15,8,16,10,6,4,1,0,0,3
S01008143,Occupancy rating 0,119,45,12,33,69,3,30,3,16,11,36,22,14,5,4,0,0,1
S01008143,Occupancy rating -1 or less,38,6,5,1,28,0,15,1,10,4,13,8,5,4,4,0,0,0
S01008144,All households,229,43,17,26,179,30,131,42,65,24,18,11,7,7,5,0,0,2
S01008144,Occupancy rating +2 or more,143,29,13,16,111,29,79,30,31,18,3,1,2,3,1,0,0,2
S01008144,Occupancy rating +1,48,13,4,9,34,1,28,9,16,3,5,2,3,1,1,0,0,0
S01008144,Occupancy rating 0,21,1,0,1,19,0,15,2,13,0,4,3,1,1,1,0,0,0
S01008144,Occupancy rating -1 or less,17,0,0,0,15,0,9,1,5,3,6,5,1,2,2,0,0,0
S01008145,All households,328,100,40,60,215,22,152,44,70,38,41,28,13,13,7,0,0,6
S01008145,Occupancy rating +2 or more,97,26,13,13,66,8,48,25,15,8,10,8,2,5,2,0,0,3
S01008145,Occupancy rating +1,97,35,17,18,61,11,44,14,20,10,6,4,2,1,1,0,0,0
S01008145,Occupancy rating 0,94,31,7,24,60,2,36,4,21,11,22,14,8,3,0,0,0,3
S01008145,Occupancy rating -1 or less,40,8,3,5,28,1,24,1,14,9,3,2,1,4,4,0,0,0
S01008146,All households,218,73,39,34,134,20,73,22,24,27,41,28,13,11,6,0,1,4
S01008146,Occupancy rating +2 or more,73,29,16,13,41,10,25,12,4,9,6,4,2,3,2,0,0,1
S01008146,Occupancy rating +1,67,23,14,9,44,8,22,7,7,8,14,7,7,0,0,0,0,0
S01008146,Occupancy rating 0,56,17,6,11,33,2,18,2,7,9,13,10,3,6,3,0,1,2
S01008146,Occupancy rating -1 or less,22,4,3,1,16,0,8,1,6,1,8,7,1,2,1,0,0,1
S01008147,All households,339,86,35,51,243,25,162,71,54,37,56,32,24,10,5,0,0,5
S01008147,Occupancy rating +2 or more,98,24,12,12,74,15,55,33,11,11,4,2,2,0,0,0,0,0
S01008147,Occupancy rating +1,110,36,12,24,74,7,57,32,13,12,10,3,7,0,0,0,0,0
S01008147,Occupancy rating 0,96,22,9,13,70,3,35,4,22,9,32,18,14,4,2,0,0,2
S01008147,Occupancy rating -1 or less,35,4,2,2,25,0,15,2,8,5,10,9,1,6,3,0,0,3
S01008148,All households,328,106,32,74,217,21,165,57,63,45,31,15,16,5,3,0,0,2
S01008148,Occupancy rating +2 or more,136,25,11,14,110,18,88,43,27,18,4,2,2,1,0,0,0,1
S01008148,Occupancy rating +1,80,23,6,17,56,2,44,8,16,20,10,3,7,1,0,0,0,1
S01008148,Occupancy rating 0,85,47,13,34,37,1,27,5,17,5,9,6,3,1,1,0,0,0
S01008148,Occupancy rating -1 or less,27,11,2,9,14,0,6,1,3,2,8,4,4,2,2,0,0,0
S01008149,All households,313,98,40,58,209,21,133,50,55,28,55,42,13,6,3,0,0,3
S01008149,Occupancy rating +2 or more,80,31,19,12,47,11,29,25,2,2,7,4,3,2,0,0,0,2
S01008149,Occupancy rating +1,119,46,17,29,72,7,58,23,21,14,7,4,3,1,0,0,0,1
S01008149,Occupancy rating 0,85,14,2,12,70,3,32,1,24,7,35,29,6,1,1,0,0,0
S01008149,Occupancy rating -1 or less,29,7,2,5,20,0,14,1,8,5,6,5,1,2,2,0,0,0
S01008150,All households,428,150,58,92,265,40,148,46,73,29,77,43,34,13,6,0,2,5
S01008150,Occupancy rating +2 or more,84,42,21,21,41,14,23,14,9,0,4,1,3,1,0,0,1,0
S01008150,Occupancy rating +1,156,63,23,40,91,19,58,20,25,13,14,6,8,2,1,0,0,1
S01008150,Occupancy rating 0,137,32,10,22,102,5,55,10,32,13,42,22,20,3,1,0,0,2
S01008150,Occupancy rating -1 or less,51,13,4,9,31,2,12,2,7,3,17,14,3,7,4,0,1,2
S01008151,All households,321,123,56,67,187,28,119,34,60,25,40,26,14,11,3,0,2,6
S01008151,Occupancy rating +2 or more,89,35,22,13,53,16,33,15,13,5,4,2,2,1,0,0,1,0
S01008151,Occupancy rating +1,99,34,16,18,61,7,39,14,17,8,15,8,7,4,0,0,0,4
S01008151,Occupancy rating 0,101,48,15,33,50,5,32,4,23,5,13,9,4,3,0,0,1,2
S01008151,Occupancy rating -1 or less,32,6,3,3,23,0,15,1,7,7,8,7,1,3,3,0,0,0
S01008152,All households,511,193,100,93,294,50,150,61,51,38,94,59,35,24,8,0,4,12
S01008152,Occupancy rating +2 or more,130,46,23,23,82,32,46,29,9,8,4,2,2,2,0,0,0,2
S01008152,Occupancy rating +1,163,62,23,39,94,14,56,22,20,14,24,14,10,7,0,0,2,5
S01008152,Occupancy rating 0,151,54,29,25,89,4,35,7,17,11,50,32,18,8,4,0,0,4
S01008152,Occupancy rating -1 or less,67,31,25,6,29,0,13,3,5,5,16,11,5,7,4,0,2,1
S01008153,All households,295,55,15,40,234,22,193,62,81,50,19,14,5,6,5,0,0,1
S01008153,Occupancy rating +2 or more,179,27,10,17,149,15,128,54,43,31,6,4,2,3,3,0,0,0
S01008153,Occupancy rating +1,79,23,4,19,55,6,45,7,21,17,4,3,1,1,0,0,0,1
S01008153,Occupancy rating 0,26,3,0,3,23,0,15,1,12,2,8,6,2,0,0,0,0,0
S01008153,Occupancy rating -1 or less,11,2,1,1,7,1,5,0,5,0,1,1,0,2,2,0,0,0
S01008154,All households,355,96,60,36,253,53,173,65,64,44,27,14,13,6,1,0,1,4
S01008154,Occupancy rating +2 or more,183,34,16,18,146,31,109,49,31,29,6,4,2,3,0,0,0,3
S01008154,Occupancy rating +1,114,44,30,14,69,15,45,16,21,8,9,0,9,1,1,0,0,0
S01008154,Occupancy rating 0,46,16,13,3,29,6,17,0,10,7,6,4,2,1,0,0,0,1
S01008154,Occupancy rating -1 or less,12,2,1,1,9,1,2,0,2,0,6,6,0,1,0,0,1,0
S01008155,All households,275,69,31,38,196,32,140,57,53,30,24,10,14,10,5,0,0,5
S01008155,Occupancy rating +2 or more,166,41,17,24,120,26,88,45,32,11,6,2,4,5,1,0,0,4
S01008155,Occupancy rating +1,64,25,11,14,39,6,23,8,4,11,10,3,7,0,0,0,0,0
S01008155,Occupancy rating 0,36,1,1,0,32,0,24,3,13,8,8,5,3,3,2,0,0,1
S01008155,Occupancy rating -1 or less,9,2,2,0,5,0,5,1,4,0,0,0,0,2,2,0,0,0
S01008156,All households,391,113,45,68,263,31,180,57,71,52,52,31,21,15,7,0,1,7
S01008156,Occupancy rating +2 or more,182,59,25,34,120,23,88,39,26,23,9,3,6,3,1,0,0,2
S01008156,Occupancy rating +1,112,39,17,22,71,8,51,13,20,18,12,5,7,2,1,0,0,1
S01008156,Occupancy rating 0,77,13,2,11,59,0,35,5,20,10,24,18,6,5,2,0,1,2
S01008156,Occupancy rating -1 or less,20,2,1,1,13,0,6,0,5,1,7,5,2,5,3,0,0,2
S01008157,All households,293,65,26,39,220,18,158,58,68,32,44,31,13,8,2,0,1,5
S01008157,Occupancy rating +2 or more,151,35,14,21,112,12,91,41,33,17,9,6,3,4,1,0,0,3
S01008157,Occupancy rating +1,71,19,7,12,50,3,37,14,14,9,10,6,4,2,0,0,1,1
S01008157,Occupancy rating 0,55,9,3,6,45,2,24,2,17,5,19,13,6,1,0,0,0,1
S01008157,Occupancy rating -1 or less,16,2,2,0,13,1,6,1,4,1,6,6,0,1,1,0,0,0
S01008158,All households,287,63,15,48,214,13,176,75,59,42,25,14,11,10,3,0,0,7
S01008158,Occupancy rating +2 or more,153,29,10,19,121,11,102,55,25,22,8,3,5,3,1,0,0,2
S01008158,Occupancy rating +1,74,17,4,13,54,2,43,10,22,11,9,4,5,3,1,0,0,2
S01008158,Occupancy rating 0,49,15,1,14,31,0,26,10,9,7,5,4,1,3,1,0,0,2
S01008158,Occupancy rating -1 or less,11,2,0,2,8,0,5,0,3,2,3,3,0,1,0,0,0,1
S01008159,All households,461,180,66,114,253,24,143,56,65,22,86,63,23,28,11,0,3,14
S01008159,Occupancy rating +2 or more,118,47,21,26,65,7,53,34,11,8,5,4,1,6,1,0,1,4
S01008159,Occupancy rating +1,148,68,15,53,76,9,40,13,20,7,27,17,10,4,2,0,0,2
S01008159,Occupancy rating 0,151,50,25,25,91,7,40,7,27,6,44,37,7,10,2,0,1,7
S01008159,Occupancy rating -1 or less,44,15,5,10,21,1,10,2,7,1,10,5,5,8,6,0,1,1
S01008160,All households,397,123,49,74,260,22,147,44,73,30,91,62,29,14,10,0,1,3
S01008160,Occupancy rating +2 or more,112,50,18,32,60,8,44,22,16,6,8,2,6,2,0,0,0,2
S01008160,Occupancy rating +1,124,33,14,19,88,9,51,18,25,8,28,20,8,3,2,0,1,0
S01008160,Occupancy rating 0,129,34,14,20,92,4,43,3,28,12,45,32,13,3,3,0,0,0
S01008160,Occupancy rating -1 or less,32,6,3,3,20,1,9,1,4,4,10,8,2,6,5,0,0,1
S01008161,All households,399,89,19,70,293,26,247,87,125,35,20,11,9,17,8,0,1,8
S01008161,Occupancy rating +2 or more,222,33,8,25,181,19,159,60,75,24,3,2,1,8,4,0,1,3
S01008161,Occupancy rating +1,94,35,6,29,57,6,43,16,21,6,8,6,2,2,0,0,0,2
S01008161,Occupancy rating 0,66,19,5,14,42,0,34,9,23,2,8,3,5,5,3,0,0,2
S01008161,Occupancy rating -1 or less,17,2,0,2,13,1,11,2,6,3,1,0,1,2,1,0,0,1
S01008162,All households,430,130,62,68,285,37,216,81,92,43,32,13,19,15,5,0,2,8
S01008162,Occupancy rating +2 or more,188,53,27,26,132,20,107,60,31,16,5,4,1,3,1,0,0,2
S01008162,Occupancy rating +1,128,47,21,26,75,10,56,14,32,10,9,2,7,6,1,0,1,4
S01008162,Occupancy rating 0,88,24,12,12,61,6,40,6,22,12,15,5,10,3,0,0,1,2
S01008162,Occupancy rating -1 or less,26,6,2,4,17,1,13,1,7,5,3,2,1,3,3,0,0,0
S01008163,All households,327,80,35,45,229,31,129,54,55,20,69,51,18,18,6,0,0,12
S01008163,Occupancy rating +2 or more,89,24,13,11,62,18,40,30,8,2,4,2,2,3,0,0,0,3
S01008163,Occupancy rating +1,114,40,12,28,68,11,44,19,17,8,13,5,8,6,0,0,0,6
S01008163,Occupancy rating 0,97,15,9,6,81,1,35,4,23,8,45,38,7,1,1,0,0,0
S01008163,Occupancy rating -1 or less,27,1,1,0,18,1,10,1,7,2,7,6,1,8,5,0,0,3
S01008164,All households,289,104,38,66,175,9,123,41,57,25,43,29,14,10,4,0,2,4
S01008164,Occupancy rating +2 or more,68,26,16,10,42,4,35,13,18,4,3,0,3,0,0,0,0,0
S01008164,Occupancy rating +1,92,38,12,26,53,4,41,21,11,9,8,8,0,1,0,0,0,1
S01008164,Occupancy rating 0,101,33,9,24,64,0,37,6,22,9,27,17,10,4,1,0,2,1
S01008164,Occupancy rating -1 or less,28,7,1,6,16,1,10,1,6,3,5,4,1,5,3,0,0,2
S01008165,All households,266,36,5,31,214,8,192,60,118,14,14,11,3,16,9,0,0,7
S01008165,Occupancy rating +2 or more,173,22,4,18,144,8,130,51,69,10,6,4,2,7,4,0,0,3
S01008165,Occupancy rating +1,52,9,0,9,39,0,36,7,27,2,3,3,0,4,3,0,0,1
S01008165,Occupancy rating 0,31,2,1,1,25,0,22,1,19,2,3,2,1,4,1,0,0,3
S01008165,Occupancy rating -1 or less,10,3,0,3,6,0,4,1,3,0,2,2,0,1,1,0,0,0
S01008166,All households,226,54,20,34,161,19,100,35,43,22,42,25,17,11,3,1,0,7
S01008166,Occupancy rating +2 or more,62,25,8,17,36,10,25,16,4,5,1,0,1,1,0,0,0,1
S01008166,Occupancy rating +1,77,17,7,10,56,6,37,17,13,7,13,6,7,4,0,0,0,4
S01008166,Occupancy rating 0,65,10,5,5,51,2,31,2,22,7,18,11,7,4,1,1,0,2
S01008166,Occupancy rating -1 or less,22,2,0,2,18,1,7,0,4,3,10,8,2,2,2,0,0,0
S01008167,All households,294,68,25,43,215,22,123,34,61,28,70,41,29,11,6,0,1,4
S01008167,Occupancy rating +2 or more,75,29,8,21,46,11,32,18,10,4,3,1,2,0,0,0,0,0
S01008167,Occupancy rating +1,102,30,13,17,68,10,37,14,16,7,21,10,11,4,1,0,1,2
S01008167,Occupancy rating 0,81,4,1,3,74,1,40,2,29,9,33,23,10,3,3,0,0,0
S01008167,Occupancy rating -1 or less,36,5,3,2,27,0,14,0,6,8,13,7,6,4,2,0,0,2
S01008168,All households,349,100,36,64,231,16,157,59,73,25,58,44,14,18,9,0,0,9
S01008168,Occupancy rating +2 or more,93,25,11,14,64,4,57,27,21,9,3,1,2,4,2,0,0,2
S01008168,Occupancy rating +1,106,34,13,21,69,7,52,27,16,9,10,7,3,3,1,0,0,2
S01008168,Occupancy rating 0,101,28,8,20,67,3,33,4,23,6,31,25,6,6,1,0,0,5
S01008168,Occupancy rating -1 or less,49,13,4,9,31,2,15,1,13,1,14,11,3,5,5,0,0,0
S01008169,All households,320,95,43,52,210,23,133,53,55,25,54,39,15,15,7,1,0,7
S01008169,Occupancy rating +2 or more,75,24,6,18,49,9,34,24,7,3,6,5,1,2,1,0,0,1
S01008169,Occupancy rating +1,108,41,16,25,65,8,48,23,21,4,9,7,2,2,1,0,0,1
S01008169,Occupancy rating 0,105,22,14,8,76,6,42,6,22,14,28,20,8,7,2,1,0,4
S01008169,Occupancy rating -1 or less,32,8,7,1,20,0,9,0,5,4,11,7,4,4,3,0,0,1
S01008170,All households,231,55,26,29,167,18,135,49,65,21,14,10,4,9,5,0,1,3
S01008170,Occupancy rating +2 or more,116,17,8,9,96,9,84,34,38,12,3,2,1,3,1,0,0,2
S01008170,Occupancy rating +1,75,29,14,15,45,8,33,12,15,6,4,3,1,1,0,0,0,1
S01008170,Occupancy rating 0,34,7,4,3,23,1,16,3,10,3,6,4,2,4,3,0,1,0
S01008170,Occupancy rating -1 or less,6,2,0,2,3,0,2,0,2,0,1,1,0,1,1,0,0,0
S01008171,All households,373,154,73,81,207,22,135,54,57,24,50,30,20,12,3,2,1,6
S01008171,Occupancy rating +2 or more,63,28,20,8,35,10,23,14,8,1,2,0,2,0,0,0,0,0
S01008171,Occupancy rating +1,139,73,37,36,64,10,46,29,12,5,8,5,3,2,1,0,0,1
S01008171,Occupancy rating 0,137,46,11,35,83,2,50,10,25,15,31,18,13,8,1,2,1,4
S01008171,Occupancy rating -1 or less,34,7,5,2,25,0,16,1,12,3,9,7,2,2,1,0,0,1
S01008172,All households,250,82,35,47,165,29,108,43,48,17,28,21,7,3,1,0,0,2
S01008172,Occupancy rating +2 or more,77,26,13,13,51,11,40,24,13,3,0,0,0,0,0,0,0,0
S01008172,Occupancy rating +1,98,37,17,20,60,16,36,13,14,9,8,7,1,1,0,0,0,1
S01008172,Occupancy rating 0,57,17,4,13,40,1,24,5,14,5,15,10,5,0,0,0,0,0
S01008172,Occupancy rating -1 or less,18,2,1,1,14,1,8,1,7,0,5,4,1,2,1,0,0,1
S01008173,All households,260,60,38,22,192,12,151,49,80,22,29,21,8,8,4,0,0,4
S01008173,Occupancy rating +2 or more,104,20,12,8,83,9,67,32,32,3,7,5,2,1,0,0,0,1
S01008173,Occupancy rating +1,84,22,12,10,59,3,50,15,24,11,6,3,3,3,1,0,0,2
S01008173,Occupancy rating 0,61,16,13,3,41,0,31,2,21,8,10,9,1,4,3,0,0,1
S01008173,Occupancy rating -1 or less,11,2,1,1,9,0,3,0,3,0,6,4,2,0,0,0,0,0
S01008174,All households,226,67,38,29,149,11,120,42,55,23,18,8,10,10,2,2,0,6
S01008174,Occupancy rating +2 or more,65,13,9,4,49,3,44,15,17,12,2,2,0,3,0,1,0,2
S01008174,Occupancy rating +1,74,20,12,8,53,7,42,23,13,6,4,0,4,1,0,0,0,1
S01008174,Occupancy rating 0,69,30,15,15,35,1,27,3,21,3,7,3,4,4,1,1,0,2
S01008174,Occupancy rating -1 or less,18,4,2,2,12,0,7,1,4,2,5,3,2,2,1,0,0,1
S01008175,All households,378,160,39,121,203,13,143,62,61,20,47,27,20,15,5,1,2,7
S01008175,Occupancy rating +2 or more,72,17,7,10,50,3,45,18,18,9,2,0,2,5,3,0,0,2
S01008175,Occupancy rating +1,103,55,13,42,48,5,39,26,12,1,4,4,0,0,0,0,0,0
S01008175,Occupancy rating 0,157,67,14,53,83,5,47,18,22,7,31,14,17,7,1,1,2,3
S01008175,Occupancy rating -1 or less,46,21,5,16,22,0,12,0,9,3,10,9,1,3,1,0,0,2
S01008176,All households,327,100,30,70,213,32,167,76,70,21,14,9,5,14,1,4,0,9
S01008176,Occupancy rating +2 or more,161,29,11,18,128,26,99,57,32,10,3,3,0,4,0,0,0,4
S01008176,Occupancy rating +1,74,41,14,27,32,3,25,12,10,3,4,2,2,1,0,0,0,1
S01008176,Occupancy rating 0,74,28,5,23,39,3,30,6,18,6,6,3,3,7,1,3,0,3
S01008176,Occupancy rating -1 or less,18,2,0,2,14,0,13,1,10,2,1,1,0,2,0,1,0,1
S01008177,All households,371,134,62,72,221,42,132,54,66,12,47,21,26,16,6,0,0,10
S01008177,Occupancy rating +2 or more,53,9,3,6,42,8,30,12,14,4,4,1,3,2,2,0,0,0
S01008177,Occupancy rating +1,168,82,36,46,83,28,46,36,8,2,9,3,6,3,0,0,0,3
S01008177,Occupancy rating 0,108,32,16,16,70,4,41,5,31,5,25,12,13,6,1,0,0,5
S01008177,Occupancy rating -1 or less,42,11,7,4,26,2,15,1,13,1,9,5,4,5,3,0,0,2
S01008178,All households,278,68,30,38,197,42,131,50,45,36,24,9,15,13,6,0,0,7
S01008178,Occupancy rating +2 or more,127,19,14,5,105,36,65,34,18,13,4,1,3,3,3,0,0,0
S01008178,Occupancy rating +1,78,20,8,12,56,3,41,10,14,17,12,4,8,2,0,0,0,2
S01008178,Occupancy rating 0,50,19,6,13,28,3,20,6,10,4,5,3,2,3,1,0,0,2
S01008178,Occupancy rating -1 or less,23,10,2,8,8,0,5,0,3,2,3,1,2,5,2,0,0,3
S01008179,All households,170,14,5,9,152,5,134,38,76,20,13,11,2,4,2,0,0,2
S01008179,Occupancy rating +2 or more,95,8,3,5,86,3,78,20,48,10,5,4,1,1,1,0,0,0
S01008179,Occupancy rating +1,50,5,2,3,44,2,37,17,14,6,5,4,1,1,0,0,0,1
S01008179,Occupancy rating 0,18,0,0,0,17,0,15,0,11,4,2,2,0,1,0,0,0,1
S01008179,Occupancy rating -1 or less,7,1,0,1,5,0,4,1,3,0,1,1,0,1,1,0,0,0
S01008180,All households,167,24,8,16,138,5,122,38,55,29,11,8,3,5,4,1,0,0
S01008180,Occupancy rating +2 or more,110,15,4,11,93,4,85,34,30,21,4,3,1,2,2,0,0,0
S01008180,Occupancy rating +1,41,6,2,4,34,1,29,2,19,8,4,3,1,1,1,0,0,0
S01008180,Occupancy rating 0,13,2,1,1,9,0,7,2,5,0,2,1,1,2,1,1,0,0
S01008180,Occupancy rating -1 or less,3,1,1,0,2,0,1,0,1,0,1,1,0,0,0,0,0,0
S01008181,All households,284,70,46,24,203,40,145,51,60,34,18,7,11,11,1,1,1,8
S01008181,Occupancy rating +2 or more,170,48,34,14,117,32,80,41,26,13,5,1,4,5,1,0,0,4
S01008181,Occupancy rating +1,72,16,8,8,54,6,43,7,23,13,5,1,4,2,0,0,1,1
S01008181,Occupancy rating 0,35,6,4,2,26,2,18,3,8,7,6,4,2,3,0,1,0,2
S01008181,Occupancy rating -1 or less,7,0,0,0,6,0,4,0,3,1,2,1,1,1,0,0,0,1
S01008182,All households,563,315,78,237,225,21,166,109,44,13,38,21,17,23,2,3,0,18
S01008182,Occupancy rating +2 or more,73,30,12,18,41,10,29,22,6,1,2,0,2,2,0,0,0,2
S01008182,Occupancy rating +1,153,79,17,62,68,6,56,37,14,5,6,2,4,6,0,1,0,5
S01008182,Occupancy rating 0,207,127,43,84,77,4,51,29,16,6,22,11,11,3,0,0,0,3
S01008182,Occupancy rating -1 or less,130,79,6,73,39,1,30,21,8,1,8,8,0,12,2,2,0,8
S01008183,All households,282,88,35,53,173,16,124,41,66,17,33,21,12,21,3,7,2,9
S01008183,Occupancy rating +2 or more,104,38,20,18,66,12,50,21,23,6,4,3,1,0,0,0,0,0
S01008183,Occupancy rating +1,89,30,13,17,50,4,34,15,16,3,12,7,5,9,2,0,2,5
S01008183,Occupancy rating 0,73,17,2,15,46,0,34,5,21,8,12,7,5,10,1,7,0,2
S01008183,Occupancy rating -1 or less,16,3,0,3,11,0,6,0,6,0,5,4,1,2,0,0,0,2
S01008184,All households,481,271,121,150,181,36,128,73,36,19,17,11,6,29,1,3,3,22
S01008184,Occupancy rating +2 or more,73,24,8,16,43,10,31,15,10,6,2,2,0,6,1,0,0,5
S01008184,Occupancy rating +1,149,72,27,45,71,12,55,39,11,5,4,2,2,6,0,1,0,5
S01008184,Occupancy rating 0,180,129,74,55,41,6,30,13,11,6,5,4,1,10,0,1,2,7
S01008184,Occupancy rating -1 or less,79,46,12,34,26,8,12,6,4,2,6,3,3,7,0,1,1,5
S01008185,All households,573,289,95,194,254,40,160,83,61,16,54,35,19,30,2,2,4,22
S01008185,Occupancy rating +2 or more,89,33,17,16,52,12,35,22,11,2,5,3,2,4,0,0,0,4
S01008185,Occupancy rating +1,153,92,34,58,59,14,40,27,10,3,5,2,3,2,0,0,1,1
S01008185,Occupancy rating 0,260,128,39,89,115,13,66,28,32,6,36,23,13,17,0,2,2,13
S01008185,Occupancy rating -1 or less,71,36,5,31,28,1,19,6,8,5,8,7,1,7,2,0,1,4
S01008186,All households,366,197,70,127,150,20,108,55,40,13,22,13,9,19,2,4,0,13
S01008186,Occupancy rating +2 or more,62,21,12,9,39,8,28,16,8,4,3,2,1,2,1,0,0,1
S01008186,Occupancy rating +1,115,67,27,40,47,7,35,23,8,4,5,2,3,1,0,0,0,1
S01008186,Occupancy rating 0,144,85,29,56,50,4,35,14,16,5,11,7,4,9,0,0,0,9
S01008186,Occupancy rating -1 or less,45,24,2,22,14,1,10,2,8,0,3,2,1,7,1,4,0,2
S01008187,All households,284,97,40,57,170,15,107,45,47,15,48,34,14,17,5,0,1,11
S01008187,Occupancy rating +2 or more,81,25,14,11,55,9,42,24,15,3,4,3,1,1,1,0,0,0
S01008187,Occupancy rating +1,93,49,18,31,41,3,32,18,8,6,6,4,2,3,0,0,0,3
S01008187,Occupancy rating 0,80,17,5,12,52,1,25,2,19,4,26,16,10,11,4,0,1,6
S01008187,Occupancy rating -1 or less,30,6,3,3,22,2,8,1,5,2,12,11,1,2,0,0,0,2
S01008188,All households,485,228,109,119,230,32,131,61,58,12,67,46,21,27,7,6,0,14
S01008188,Occupancy rating +2 or more,71,25,12,13,44,6,36,20,14,2,2,0,2,2,0,0,0,2
S01008188,Occupancy rating +1,154,84,35,49,66,13,41,27,10,4,12,8,4,4,2,1,0,1
S01008188,Occupancy rating 0,197,93,52,41,90,11,39,9,24,6,40,30,10,14,3,4,0,7
S01008188,Occupancy rating -1 or less,63,26,10,16,30,2,15,5,10,0,13,8,5,7,2,1,0,4
S01008189,All households,271,97,40,57,160,33,100,36,44,20,27,15,12,14,1,0,0,13
S01008189,Occupancy rating +2 or more,94,24,13,11,69,19,43,23,16,4,7,3,4,1,0,0,0,1
S01008189,Occupancy rating +1,87,45,20,25,41,12,27,10,9,8,2,0,2,1,0,0,0,1
S01008189,Occupancy rating 0,72,17,7,10,44,2,27,3,16,8,15,10,5,11,1,0,0,10
S01008189,Occupancy rating -1 or less,18,11,0,11,6,0,3,0,3,0,3,2,1,1,0,0,0,1
S01008190,All households,365,109,58,51,240,26,149,48,64,37,65,43,22,16,10,0,0,6
S01008190,Occupancy rating +2 or more,114,51,24,27,62,11,48,35,7,6,3,1,2,1,0,0,0,1
S01008190,Occupancy rating +1,117,46,28,18,67,10,43,9,19,15,14,9,5,4,1,0,0,3
S01008190,Occupancy rating 0,100,9,5,4,84,5,46,3,30,13,33,23,10,7,6,0,0,1
S01008190,Occupancy rating -1 or less,34,3,1,2,27,0,12,1,8,3,15,10,5,4,3,0,0,1
S01008191,All households,187,48,31,17,134,23,82,24,37,21,29,19,10,5,3,1,0,1
S01008191,Occupancy rating +2 or more,81,27,15,12,54,18,34,17,11,6,2,1,1,0,0,0,0,0
S01008191,Occupancy rating +1,46,13,9,4,32,3,21,3,11,7,8,4,4,1,0,0,0,1
S01008191,Occupancy rating 0,45,6,5,1,38,2,20,4,8,8,16,11,5,1,0,1,0,0
S01008191,Occupancy rating -1 or less,15,2,2,0,10,0,7,0,7,0,3,3,0,3,3,0,0,0
S01008192,All households,360,131,38,93,209,20,154,70,56,28,35,19,16,20,4,0,0,16
S01008192,Occupancy rating +2 or more,106,33,18,15,72,15,53,39,7,7,4,1,3,1,0,0,0,1
S01008192,Occupancy rating +1,110,46,13,33,55,4,43,16,21,6,8,2,6,9,1,0,0,8
S01008192,Occupancy rating 0,91,24,3,21,59,1,43,7,24,12,15,10,5,8,2,0,0,6
S01008192,Occupancy rating -1 or less,53,28,4,24,23,0,15,8,4,3,8,6,2,2,1,0,0,1
S01008193,All households,327,86,51,35,230,28,163,65,77,21,39,19,20,11,5,0,1,5
S01008193,Occupancy rating +2 or more,156,42,27,15,112,22,85,46,31,8,5,2,3,2,0,0,1,1
S01008193,Occupancy rating +1,84,18,12,6,61,3,46,14,25,7,12,4,8,5,3,0,0,2
S01008193,Occupancy rating 0,74,26,12,14,46,3,27,5,16,6,16,11,5,2,1,0,0,1
S01008193,Occupancy rating -1 or less,13,0,0,0,11,0,5,0,5,0,6,2,4,2,1,0,0,1
S01008194,All households,244,58,27,31,170,18,119,43,55,21,33,22,11,16,7,0,0,9
S01008194,Occupancy rating +2 or more,81,7,3,4,68,16,50,23,19,8,2,1,1,6,2,0,0,4
S01008194,Occupancy rating +1,87,46,22,24,40,2,36,16,16,4,2,2,0,1,1,0,0,0
S01008194,Occupancy rating 0,62,3,1,2,53,0,28,4,16,8,25,16,9,6,1,0,0,5
S01008194,Occupancy rating -1 or less,14,2,1,1,9,0,5,0,4,1,4,3,1,3,3,0,0,0
S01008195,All households,331,89,20,69,214,14,143,55,72,16,57,41,16,28,12,1,0,15
S01008195,Occupancy rating +2 or more,65,11,5,6,53,10,43,26,14,3,0,0,0,1,1,0,0,0
S01008195,Occupancy rating +1,125,62,9,53,57,3,46,23,15,8,8,2,6,6,1,1,0,4
S01008195,Occupancy rating 0,95,10,4,6,74,0,33,4,25,4,41,32,9,11,4,0,0,7
S01008195,Occupancy rating -1 or less,46,6,2,4,30,1,21,2,18,1,8,7,1,10,6,0,0,4
S01008196,All households,333,100,22,78,216,22,124,32,74,18,70,55,15,17,8,1,0,8
S01008196,Occupancy rating +2 or more,53,23,6,17,27,7,18,12,5,1,2,2,0,3,3,0,0,0
S01008196,Occupancy rating +1,114,42,12,30,70,13,45,16,21,8,12,7,5,2,0,1,0,1
S01008196,Occupancy rating 0,122,30,3,27,83,0,43,3,35,5,40,32,8,9,4,0,0,5
S01008196,Occupancy rating -1 or less,44,5,1,4,36,2,18,1,13,4,16,14,2,3,1,0,0,2
S01008197,All households,390,72,3,69,292,3,253,125,113,15,36,30,6,26,6,0,0,20
S01008197,Occupancy rating +2 or more,179,28,1,27,143,2,135,87,42,6,6,4,2,8,2,0,0,6
S01008197,Occupancy rating +1,97,23,1,22,71,1,67,29,33,5,3,2,1,3,1,0,0,2
S01008197,Occupancy rating 0,80,15,1,14,58,0,36,5,29,2,22,19,3,7,2,0,0,5
S01008197,Occupancy rating -1 or less,34,6,0,6,20,0,15,4,9,2,5,5,0,8,1,0,0,7
S01008198,All households,300,81,48,33,207,34,122,50,39,33,51,33,18,12,5,0,1,6
S01008198,Occupancy rating +2 or more,132,52,32,20,80,27,47,33,7,7,6,3,3,0,0,0,0,0
S01008198,Occupancy rating +1,90,23,11,12,62,4,45,16,14,15,13,7,6,5,2,0,1,2
S01008198,Occupancy rating 0,61,5,4,1,52,2,21,0,14,7,29,20,9,4,2,0,0,2
S01008198,Occupancy rating -1 or less,17,1,1,0,13,1,9,1,4,4,3,3,0,3,1,0,0,2
S01008199,All households,298,51,18,33,230,15,160,54,68,38,55,39,16,17,6,0,2,9
S01008199,Occupancy rating +2 or more,56,13,5,8,42,7,34,27,4,3,1,0,1,1,0,0,1,0
S01008199,Occupancy rating +1,92,22,8,14,68,7,50,20,17,13,11,4,7,2,0,0,1,1
S01008199,Occupancy rating 0,97,10,4,6,81,1,49,5,29,15,31,25,6,6,2,0,0,4
S01008199,Occupancy rating -1 or less,53,6,1,5,39,0,27,2,18,7,12,10,2,8,4,0,0,4
S01008200,All households,300,116,61,55,177,39,91,30,40,21,47,32,15,7,2,0,1,4
S01008200,Occupancy rating +2 or more,46,16,9,7,29,13,13,7,3,3,3,2,1,1,1,0,0,0
S01008200,Occupancy rating +1,98,39,21,18,58,19,30,20,5,5,9,6,3,1,0,0,0,1
S01008200,Occupancy rating 0,122,50,25,25,68,6,36,2,22,12,26,18,8,4,0,0,1,3
S01008200,Occupancy rating -1 or less,34,11,6,5,22,1,12,1,10,1,9,6,3,1,1,0,0,0
S01008201,All households,354,121,48,73,219,20,136,62,49,25,63,40,23,14,8,0,0,6
S01008201,Occupancy rating +2 or more,79,25,9,16,52,11,38,27,7,4,3,2,1,2,1,0,0,1
S01008201,Occupancy rating +1,108,48,16,32,59,5,43,29,6,8,11,5,6,1,0,0,0,1
S01008201,Occupancy rating 0,122,38,20,18,76,3,37,2,28,7,36,23,13,8,5,0,0,3
S01008201,Occupancy rating -1 or less,45,10,3,7,32,1,18,4,8,6,13,10,3,3,2,0,0,1
S01008202,All households,261,83,52,31,172,28,117,47,44,26,27,17,10,6,2,0,1,3
S01008202,Occupancy rating +2 or more,102,25,10,15,74,13,57,26,18,13,4,3,1,3,2,0,0,1
S01008202,Occupancy rating +1,66,17,8,9,48,10,33,20,7,6,5,3,2,1,0,0,1,0
S01008202,Occupancy rating 0,83,36,30,6,45,4,25,1,17,7,16,9,7,2,0,0,0,2
S01008202,Occupancy rating -1 or less,10,5,4,1,5,1,2,0,2,0,2,2,0,0,0,0,0,0
S01008203,All households,283,121,39,82,145,14,85,45,30,10,46,35,11,17,5,0,0,12
S01008203,Occupancy rating +2 or more,45,17,10,7,26,6,15,12,2,1,5,2,3,2,0,0,0,2
S01008203,Occupancy rating +1,91,47,7,40,40,7,27,19,4,4,6,3,3,4,0,0,0,4
S01008203,Occupancy rating 0,100,33,19,14,59,1,31,11,16,4,27,22,5,8,3,0,0,5
S01008203,Occupancy rating -1 or less,47,24,3,21,20,0,12,3,8,1,8,8,0,3,2,0,0,1
S01008204,All households,480,231,128,103,235,64,139,59,50,30,32,19,13,14,3,0,3,8
S01008204,Occupancy rating +2 or more,128,47,26,21,79,25,51,26,17,8,3,0,3,2,0,0,0,2
S01008204,Occupancy rating +1,181,100,51,49,80,28,51,27,16,8,1,1,0,1,0,0,0,1
S01008204,Occupancy rating 0,139,71,46,25,61,9,32,5,16,11,20,13,7,7,1,0,2,4
S01008204,Occupancy rating -1 or less,32,13,5,8,15,2,5,1,1,3,8,5,3,4,2,0,1,1
S01008205,All households,276,61,33,28,196,21,139,52,56,31,36,22,14,19,8,0,2,9
S01008205,Occupancy rating +2 or more,99,29,15,14,65,13,47,26,15,6,5,3,2,5,1,0,0,4
S01008205,Occupancy rating +1,89,21,10,11,63,7,49,24,14,11,7,5,2,5,1,0,2,2
S01008205,Occupancy rating 0,58,6,5,1,49,1,32,1,19,12,16,8,8,3,2,0,0,1
S01008205,Occupancy rating -1 or less,30,5,3,2,19,0,11,1,8,2,8,6,2,6,4,0,0,2
S01008206,All households,295,102,53,49,175,27,113,47,42,24,35,22,13,18,9,0,1,8
S01008206,Occupancy rating +2 or more,77,31,22,9,45,7,35,25,7,3,3,0,3,1,1,0,0,0
S01008206,Occupancy rating +1,127,50,21,29,68,15,44,21,15,8,9,7,2,9,4,0,1,4
S01008206,Occupancy rating 0,68,18,8,10,45,4,24,1,13,10,17,10,7,5,2,0,0,3
S01008206,Occupancy rating -1 or less,23,3,2,1,17,1,10,0,7,3,6,5,1,3,2,0,0,1
S01008207,All households,246,64,21,43,171,18,101,31,57,13,52,38,14,11,6,0,0,5
S01008207,Occupancy rating +2 or more,48,16,5,11,32,10,22,15,5,2,0,0,0,0,0,0,0,0
S01008207,Occupancy rating +1,74,22,5,17,48,6,28,14,9,5,14,7,7,4,2,0,0,2
S01008207,Occupancy rating 0,95,21,9,12,68,2,34,2,26,6,32,28,4,6,3,0,0,3
S01008207,Occupancy rating -1 or less,29,5,2,3,23,0,17,0,17,0,6,3,3,1,1,0,0,0
S01008208,All households,344,87,9,78,240,10,190,87,85,18,40,32,8,17,5,0,2,10
S01008208,Occupancy rating +2 or more,143,20,3,17,117,8,101,52,41,8,8,7,1,6,2,0,2,2
S01008208,Occupancy rating +1,106,50,5,45,54,2,44,27,14,3,8,7,1,2,1,0,0,1
S01008208,Occupancy rating 0,75,14,1,13,55,0,40,7,26,7,15,11,4,6,0,0,0,6
S01008208,Occupancy rating -1 or less,20,3,0,3,14,0,5,1,4,0,9,7,2,3,2,0,0,1
S01008209,All households,200,26,1,25,163,6,134,46,76,12,23,19,4,11,9,0,0,2
S01008209,Occupancy rating +2 or more,101,9,0,9,88,4,76,32,36,8,8,5,3,4,3,0,0,1
S01008209,Occupancy rating +1,61,13,1,12,47,2,41,11,27,3,4,4,0,1,0,0,0,1
S01008209,Occupancy rating 0,29,1,0,1,24,0,15,3,11,1,9,8,1,4,4,0,0,0
S01008209,Occupancy rating -1 or less,9,3,0,3,4,0,2,0,2,0,2,2,0,2,2,0,0,0
S01008210,All households,417,129,50,79,273,33,188,87,73,28,52,39,13,15,8,0,1,6
S01008210,Occupancy rating +2 or more,139,34,16,18,103,18,79,45,26,8,6,2,4,2,1,0,0,1
S01008210,Occupancy rating +1,137,56,22,34,80,11,56,30,17,9,13,9,4,1,1,0,0,0
S01008210,Occupancy rating 0,115,36,11,25,73,4,43,12,23,8,26,22,4,6,4,0,1,1
S01008210,Occupancy rating -1 or less,26,3,1,2,17,0,10,0,7,3,7,6,1,6,2,0,0,4
S01008211,All households,420,158,68,90,244,29,174,74,66,34,41,31,10,18,6,0,1,11
S01008211,Occupancy rating +2 or more,140,45,26,19,89,18,69,40,17,12,2,2,0,6,2,0,0,4
S01008211,Occupancy rating +1,119,45,19,26,69,6,54,24,20,10,9,6,3,5,1,0,1,3
S01008211,Occupancy rating 0,115,50,19,31,61,4,35,8,18,9,22,18,4,4,1,0,0,3
S01008211,Occupancy rating -1 or less,46,18,4,14,25,1,16,2,11,3,8,5,3,3,2,0,0,1
S01008212,All households,212,33,8,25,170,9,139,48,68,23,22,14,8,9,4,0,1,4
S01008212,Occupancy rating +2 or more,138,22,6,16,112,7,96,43,40,13,9,5,4,4,2,0,1,1
S01008212,Occupancy rating +1,41,9,2,7,30,2,21,3,13,5,7,5,2,2,2,0,0,0
S01008212,Occupancy rating 0,28,2,0,2,25,0,20,2,14,4,5,3,2,1,0,0,0,1
S01008212,Occupancy rating -1 or less,5,0,0,0,3,0,2,0,1,1,1,1,0,2,0,0,0,2
S01008213,All households,370,64,25,39,295,31,231,70,132,29,33,24,9,11,7,0,1,3
S01008213,Occupancy rating +2 or more,246,45,16,29,197,26,159,62,79,18,12,12,0,4,2,0,0,2
S01008213,Occupancy rating +1,75,17,8,9,55,2,45,7,31,7,8,2,6,3,1,0,1,1
S01008213,Occupancy rating 0,39,2,1,1,34,3,22,1,17,4,9,7,2,3,3,0,0,0
S01008213,Occupancy rating -1 or less,10,0,0,0,9,0,5,0,5,0,4,3,1,1,1,0,0,0
S01008214,All households,354,128,64,64,217,47,132,66,51,15,38,21,17,9,2,0,0,7
S01008214,Occupancy rating +2 or more,101,30,17,13,69,19,44,30,11,3,6,2,4,2,0,0,0,2
S01008214,Occupancy rating +1,145,61,33,28,81,25,52,26,21,5,4,0,4,3,1,0,0,2
S01008214,Occupancy rating 0,76,24,9,15,50,1,27,7,14,6,22,16,6,2,0,0,0,2
S01008214,Occupancy rating -1 or less,32,13,5,8,17,2,9,3,5,1,6,3,3,2,1,0,0,1
S01008215,All households,324,96,34,62,218,34,159,71,70,18,25,11,14,10,3,0,0,7
S01008215,Occupancy rating +2 or more,104,27,12,15,75,19,55,28,21,6,1,1,0,2,0,0,0,2
S01008215,Occupancy rating +1,107,31,12,19,74,14,53,31,18,4,7,3,4,2,0,0,0,2
S01008215,Occupancy rating 0,86,30,10,20,54,1,41,12,22,7,12,3,9,2,1,0,0,1
S01008215,Occupancy rating -1 or less,27,8,0,8,15,0,10,0,9,1,5,4,1,4,2,0,0,2
S01008216,All households,205,46,20,26,154,11,124,52,53,19,19,11,8,5,5,0,0,0
S01008216,Occupancy rating +2 or more,114,27,12,15,86,8,73,36,24,13,5,3,2,1,1,0,0,0
S01008216,Occupancy rating +1,59,15,7,8,43,3,34,13,16,5,6,3,3,1,1,0,0,0
S01008216,Occupancy rating 0,24,3,0,3,19,0,12,2,9,1,7,4,3,2,2,0,0,0
S01008216,Occupancy rating -1 or less,8,1,1,0,6,0,5,1,4,0,1,1,0,1,1,0,0,0
S01008217,All households,226,42,20,22,179,32,138,56,61,21,9,3,6,5,3,0,0,2
S01008217,Occupancy rating +2 or more,180,35,17,18,143,30,110,51,47,12,3,1,2,2,1,0,0,1
S01008217,Occupancy rating +1,31,5,1,4,24,2,18,5,10,3,4,2,2,2,2,0,0,0
S01008217,Occupancy rating 0,10,2,2,0,7,0,5,0,1,4,2,0,2,1,0,0,0,1
S01008217,Occupancy rating -1 or less,5,0,0,0,5,0,5,0,3,2,0,0,0,0,0,0,0,0
S01008218,All households,376,40,8,32,323,26,271,79,152,40,26,15,11,13,8,0,0,5
S01008218,Occupancy rating +2 or more,274,30,6,24,238,24,203,73,104,26,11,7,4,6,2,0,0,4
S01008218,Occupancy rating +1,65,9,2,7,54,2,44,6,31,7,8,4,4,2,2,0,0,0
S01008218,Occupancy rating 0,27,0,0,0,23,0,19,0,13,6,4,1,3,4,4,0,0,0
S01008218,Occupancy rating -1 or less,10,1,0,1,8,0,5,0,4,1,3,3,0,1,0,0,0,1
S01008219,All households,424,135,36,99,276,28,198,87,84,27,50,30,20,13,5,0,1,7
S01008219,Occupancy rating +2 or more,147,29,13,16,112,16,88,39,34,15,8,3,5,6,3,0,0,3
S01008219,Occupancy rating +1,122,52,15,37,70,12,47,30,12,5,11,7,4,0,0,0,0,0
S01008219,Occupancy rating 0,120,42,4,38,74,0,50,16,30,4,24,16,8,4,0,0,1,3
S01008219,Occupancy rating -1 or less,35,12,4,8,20,0,13,2,8,3,7,4,3,3,2,0,0,1
S01008220,All households,223,43,17,26,166,3,102,24,49,29,61,40,21,14,9,0,0,5
S01008220,Occupancy rating +2 or more,79,30,13,17,44,3,35,20,10,5,6,2,4,5,3,0,0,2
S01008220,Occupancy rating +1,58,7,4,3,47,0,32,2,18,12,15,4,11,4,2,0,0,2
S01008220,Occupancy rating 0,61,6,0,6,52,0,23,2,13,8,29,25,4,3,2,0,0,1
S01008220,Occupancy rating -1 or less,25,0,0,0,23,0,12,0,8,4,11,9,2,2,2,0,0,0
S01008221,All households,309,107,31,76,191,14,112,36,59,17,65,45,20,11,7,0,0,4
S01008221,Occupancy rating +2 or more,60,26,10,16,33,11,20,12,4,4,2,0,2,1,1,0,0,0
S01008221,Occupancy rating +1,87,48,13,35,38,2,29,14,11,4,7,3,4,1,1,0,0,0
S01008221,Occupancy rating 0,112,28,6,22,82,0,45,5,31,9,37,25,12,2,0,0,0,2
S01008221,Occupancy rating -1 or less,50,5,2,3,38,1,18,5,13,0,19,17,2,7,5,0,0,2
S01008222,All households,287,99,63,36,171,32,96,27,53,16,43,25,18,17,4,0,2,11
S01008222,Occupancy rating +2 or more,68,20,12,8,43,15,24,13,9,2,4,3,1,5,2,0,0,3
S01008222,Occupancy rating +1,96,43,23,20,49,13,29,13,10,6,7,3,4,4,1,0,0,3
S01008222,Occupancy rating 0,90,32,26,6,52,3,28,0,22,6,21,13,8,6,0,0,2,4
S01008222,Occupancy rating -1 or less,33,4,2,2,27,1,15,1,12,2,11,6,5,2,1,0,0,1
S01008223,All households,280,101,59,42,161,32,107,41,44,22,22,13,9,18,6,0,3,9
S01008223,Occupancy rating +2 or more,69,17,11,6,48,12,35,21,8,6,1,1,0,4,1,0,0,3
S01008223,Occupancy rating +1,85,23,10,13,59,15,40,14,14,12,4,1,3,3,1,0,2,0
S01008223,Occupancy rating 0,106,59,36,23,39,4,24,5,16,3,11,8,3,8,3,0,0,5
S01008223,Occupancy rating -1 or less,20,2,2,0,15,1,8,1,6,1,6,3,3,3,1,0,1,1
S01008224,All households,406,113,46,67,286,24,242,119,79,44,20,12,8,7,2,0,1,4
S01008224,Occupancy rating +2 or more,146,38,23,15,108,7,97,55,24,18,4,1,3,0,0,0,0,0
S01008224,Occupancy rating +1,136,38,17,21,96,12,77,46,16,15,7,5,2,2,0,0,0,2
S01008224,Occupancy rating 0,103,33,3,30,68,4,58,16,34,8,6,4,2,2,0,0,0,2
S01008224,Occupancy rating -1 or less,21,4,3,1,14,1,10,2,5,3,3,2,1,3,2,0,1,0
S01008225,All households,290,76,34,42,208,18,165,59,67,39,25,16,9,6,4,0,0,2
S01008225,Occupancy rating +2 or more,119,28,14,14,90,11,74,41,23,10,5,2,3,1,1,0,0,0
S01008225,Occupancy rating +1,84,23,11,12,60,4,48,15,20,13,8,5,3,1,0,0,0,1
S01008225,Occupancy rating 0,69,21,9,12,46,3,35,2,19,14,8,6,2,2,1,0,0,1
S01008225,Occupancy rating -1 or less,18,4,0,4,12,0,8,1,5,2,4,3,1,2,2,0,0,0
S01008226,All households,379,165,89,76,199,25,124,50,48,26,50,26,24,15,4,1,2,8
S01008226,Occupancy rating +2 or more,77,29,11,18,48,9,36,24,7,5,3,0,3,0,0,0,0,0
S01008226,Occupancy rating +1,126,56,30,26,63,11,39,18,8,13,13,7,6,7,1,0,1,5
S01008226,Occupancy rating 0,146,71,44,27,72,4,38,6,25,7,30,15,15,3,1,1,0,1
S01008226,Occupancy rating -1 or less,30,9,4,5,16,1,11,2,8,1,4,4,0,5,2,0,1,2
S01008227,All households,389,139,51,88,236,48,143,60,57,26,45,33,12,14,2,0,0,12
S01008227,Occupancy rating +2 or more,64,21,10,11,39,13,25,21,2,2,1,1,0,4,1,0,0,3
S01008227,Occupancy rating +1,130,46,22,24,82,29,48,31,12,5,5,2,3,2,0,0,0,2
S01008227,Occupancy rating 0,133,55,16,39,72,2,51,7,30,14,19,12,7,6,1,0,0,5
S01008227,Occupancy rating -1 or less,62,17,3,14,43,4,19,1,13,5,20,18,2,2,0,0,0,2
S01008228,All households,279,74,37,37,192,32,139,60,59,20,21,11,10,13,2,0,2,9
S01008228,Occupancy rating +2 or more,153,30,22,8,118,27,84,44,33,7,7,4,3,5,0,0,0,5
S01008228,Occupancy rating +1,63,22,7,15,36,4,29,12,8,9,3,1,2,5,1,0,1,3
S01008228,Occupancy rating 0,50,17,7,10,30,1,18,3,12,3,11,6,5,3,1,0,1,1
S01008228,Occupancy rating -1 or less,13,5,1,4,8,0,8,1,6,1,0,0,0,0,0,0,0,0
S01008229,All households,300,78,34,44,214,28,129,52,56,21,57,34,23,8,6,0,1,1
S01008229,Occupancy rating +2 or more,51,13,6,7,38,11,24,14,8,2,3,2,1,0,0,0,0,0
S01008229,Occupancy rating +1,107,43,16,27,63,9,43,31,8,4,11,3,8,1,1,0,0,0
S01008229,Occupancy rating 0,109,18,9,9,88,7,47,6,34,7,34,23,11,3,2,0,1,0
S01008229,Occupancy rating -1 or less,33,4,3,1,25,1,15,1,6,8,9,6,3,4,3,0,0,1
S01008230,All households,305,57,6,51,231,6,200,66,114,20,25,15,10,17,4,0,1,12
S01008230,Occupancy rating +2 or more,161,27,2,25,128,3,114,43,62,9,11,6,5,6,3,0,1,2
S01008230,Occupancy rating +1,85,24,1,23,55,2,49,22,23,4,4,3,1,6,1,0,0,5
S01008230,Occupancy rating 0,49,6,3,3,39,1,31,1,24,6,7,5,2,4,0,0,0,4
S01008230,Occupancy rating -1 or less,10,0,0,0,9,0,6,0,5,1,3,1,2,1,0,0,0,1
S01008231,All households,243,24,1,23,208,4,194,38,144,12,10,8,2,11,8,0,0,3
S01008231,Occupancy rating +2 or more,196,16,1,15,173,3,165,33,122,10,5,5,0,7,4,0,0,3
S01008231,Occupancy rating +1,31,6,0,6,23,1,21,5,15,1,1,0,1,2,2,0,0,0
S01008231,Occupancy rating 0,14,2,0,2,10,0,6,0,5,1,4,3,1,2,2,0,0,0
S01008231,Occupancy rating -1 or less,2,0,0,0,2,0,2,0,2,0,0,0,0,0,0,0,0,0
S01008232,All households,259,42,2,40,204,3,161,56,96,9,40,34,6,13,3,0,0,10
S01008232,Occupancy rating +2 or more,124,7,1,6,108,2,100,35,59,6,6,5,1,9,2,0,0,7
S01008232,Occupancy rating +1,63,18,0,18,44,1,38,16,20,2,5,3,2,1,0,0,0,1
S01008232,Occupancy rating 0,59,16,1,15,41,0,18,5,12,1,23,20,3,2,1,0,0,1
S01008232,Occupancy rating -1 or less,13,1,0,1,11,0,5,0,5,0,6,6,0,1,0,0,0,1
S01008233,All households,178,27,5,22,144,8,121,52,64,5,15,12,3,7,3,0,0,4
S01008233,Occupancy rating +2 or more,98,10,2,8,85,7,77,36,39,2,1,1,0,3,2,0,0,1
S01008233,Occupancy rating +1,32,7,2,5,25,1,22,12,9,1,2,0,2,0,0,0,0,0
S01008233,Occupancy rating 0,36,10,1,9,23,0,15,4,10,1,8,7,1,3,0,0,0,3
S01008233,Occupancy rating -1 or less,12,0,0,0,11,0,7,0,6,1,4,4,0,1,1,0,0,0
S01008234,All households,187,59,27,32,120,28,68,33,19,16,24,12,12,8,2,0,2,4
S01008234,Occupancy rating +2 or more,65,20,7,13,42,14,25,15,6,4,3,1,2,3,1,0,0,2
S01008234,Occupancy rating +1,62,23,12,11,36,8,22,16,2,4,6,5,1,3,0,0,2,1
S01008234,Occupancy rating 0,50,14,7,7,34,6,14,2,6,6,14,6,8,2,1,0,0,1
S01008234,Occupancy rating -1 or less,10,2,1,1,8,0,7,0,5,2,1,0,1,0,0,0,0,0
S01008235,All households,368,107,56,51,246,43,168,74,65,29,35,23,12,15,8,0,2,5
S01008235,Occupancy rating +2 or more,125,39,18,21,84,17,63,46,14,3,4,2,2,2,0,0,0,2
S01008235,Occupancy rating +1,120,44,23,21,72,21,44,23,16,5,7,3,4,4,2,0,0,2
S01008235,Occupancy rating 0,87,21,14,7,63,1,46,4,25,17,16,12,4,3,1,0,1,1
S01008235,Occupancy rating -1 or less,36,3,1,2,27,4,15,1,10,4,8,6,2,6,5,0,1,0
S01008236,All households,386,123,55,68,255,32,179,73,72,34,44,30,14,8,2,0,2,4
S01008236,Occupancy rating +2 or more,158,42,26,16,114,17,89,46,29,14,8,3,5,2,0,0,1,1
S01008236,Occupancy rating +1,113,52,21,31,61,11,43,20,14,9,7,4,3,0,0,0,0,0
S01008236,Occupancy rating 0,86,18,7,11,64,2,38,5,22,11,24,19,5,4,1,0,1,2
S01008236,Occupancy rating -1 or less,29,11,1,10,16,2,9,2,7,0,5,4,1,2,1,0,0,1
S01008237,All households,376,112,43,69,253,30,170,62,79,29,53,34,19,11,3,0,0,8
S01008237,Occupancy rating +2 or more,125,40,16,24,82,18,57,34,18,5,7,4,3,3,0,0,0,3
S01008237,Occupancy rating +1,110,41,15,26,65,9,49,26,15,8,7,4,3,4,0,0,0,4
S01008237,Occupancy rating 0,102,23,8,15,77,2,44,2,29,13,31,21,10,2,1,0,0,1
S01008237,Occupancy rating -1 or less,39,8,4,4,29,1,20,0,17,3,8,5,3,2,2,0,0,0
S01008238,All households,341,102,54,48,230,34,152,66,60,26,44,19,25,9,5,0,1,3
S01008238,Occupancy rating +2 or more,89,28,13,15,61,14,45,31,12,2,2,0,2,0,0,0,0,0
S01008238,Occupancy rating +1,122,45,27,18,74,12,54,26,17,11,8,4,4,3,0,0,1,2
S01008238,Occupancy rating 0,106,26,13,13,76,6,44,7,26,11,26,12,14,4,3,0,0,1
S01008238,Occupancy rating -1 or less,24,3,1,2,19,2,9,2,5,2,8,3,5,2,2,0,0,0
S01008239,All households,331,91,49,42,232,26,174,77,64,33,32,21,11,8,4,0,0,4
S01008239,Occupancy rating +2 or more,141,35,16,19,103,13,86,43,32,11,4,3,1,3,1,0,0,2
S01008239,Occupancy rating +1,104,31,15,16,72,10,55,28,16,11,7,4,3,1,1,0,0,0
S01008239,Occupancy rating 0,74,24,17,7,46,1,28,4,14,10,17,11,6,4,2,0,0,2
S01008239,Occupancy rating -1 or less,12,1,1,0,11,2,5,2,2,1,4,3,1,0,0,0,0,0
S01008240,All households,358,68,42,26,282,52,216,94,89,33,14,3,11,8,3,0,1,4
S01008240,Occupancy rating +2 or more,273,54,36,18,215,46,162,85,49,28,7,1,6,4,2,0,0,2
S01008240,Occupancy rating +1,59,10,4,6,48,3,42,8,29,5,3,0,3,1,0,0,1,0
S01008240,Occupancy rating 0,20,4,2,2,16,3,11,1,10,0,2,1,1,0,0,0,0,0
S01008240,Occupancy rating -1 or less,6,0,0,0,3,0,1,0,1,0,2,1,1,3,1,0,0,2
S01008241,All households,271,51,30,21,207,48,150,76,52,22,9,4,5,13,5,0,2,6
S01008241,Occupancy rating +2 or more,231,48,30,18,178,46,127,73,38,16,5,2,3,5,2,0,1,2
S01008241,Occupancy rating +1,30,2,0,2,22,2,16,1,9,6,4,2,2,6,2,0,0,4
S01008241,Occupancy rating 0,6,1,0,1,5,0,5,1,4,0,0,0,0,0,0,0,0,0
S01008241,Occupancy rating -1 or less,4,0,0,0,2,0,2,1,1,0,0,0,0,2,1,0,1,0
S01008242,All households,430,141,81,60,279,66,187,84,67,36,26,10,16,10,2,0,1,7
S01008242,Occupancy rating +2 or more,202,50,30,20,148,38,105,62,30,13,5,1,4,4,1,0,1,2
S01008242,Occupancy rating +1,114,35,17,18,76,20,43,18,15,10,13,5,8,3,1,0,0,2
S01008242,Occupancy rating 0,100,51,32,19,46,7,32,4,17,11,7,4,3,3,0,0,0,3
S01008242,Occupancy rating -1 or less,14,5,2,3,9,1,7,0,5,2,1,0,1,0,0,0,0,0
S01008243,All households,361,83,44,39,265,32,211,70,123,18,22,16,6,13,5,0,1,7
S01008243,Occupancy rating +2 or more,222,42,20,22,176,19,153,55,86,12,4,4,0,4,1,0,0,3
S01008243,Occupancy rating +1,79,21,12,9,55,10,38,13,22,3,7,5,2,3,1,0,0,2
S01008243,Occupancy rating 0,39,15,9,6,22,2,11,2,7,2,9,5,4,2,1,0,1,0
S01008243,Occupancy rating -1 or less,21,5,3,2,12,1,9,0,8,1,2,2,0,4,2,0,0,2
S01008244,All households,255,78,42,36,171,38,114,44,52,18,19,10,9,6,1,0,1,4
S01008244,Occupancy rating +2 or more,148,35,21,14,109,28,77,36,32,9,4,3,1,4,0,0,0,4
S01008244,Occupancy rating +1,62,31,14,17,29,7,16,4,11,1,6,2,4,2,1,0,1,0
S01008244,Occupancy rating 0,36,9,7,2,27,2,16,1,9,6,9,5,4,0,0,0,0,0
S01008244,Occupancy rating -1 or less,9,3,0,3,6,1,5,3,0,2,0,0,0,0,0,0,0,0
S01008245,All households,410,102,62,40,297,43,233,94,108,31,21,15,6,11,5,0,2,4
S01008245,Occupancy rating +2 or more,239,38,22,16,197,29,163,73,70,20,5,2,3,4,0,0,1,3
S01008245,Occupancy rating +1,99,42,21,21,56,10,43,16,20,7,3,3,0,1,1,0,0,0
S01008245,Occupancy rating 0,56,19,17,2,34,4,21,4,14,3,9,7,2,3,2,0,1,0
S01008245,Occupancy rating -1 or less,16,3,2,1,10,0,6,1,4,1,4,3,1,3,2,0,0,1
S01008246,All households,353,58,21,37,284,22,238,98,102,38,24,14,10,11,5,1,1,4
S01008246,Occupancy rating +2 or more,254,32,13,19,217,17,192,83,82,27,8,4,4,5,2,1,0,2
S01008246,Occupancy rating +1,50,19,5,14,30,3,19,10,5,4,8,4,4,1,0,0,0,1
S01008246,Occupancy rating 0,39,6,3,3,31,1,23,4,13,6,7,5,2,2,2,0,0,0
S01008246,Occupancy rating -1 or less,10,1,0,1,6,1,4,1,2,1,1,1,0,3,1,0,1,1
S01008247,All households,319,56,25,31,250,22,208,103,81,24,20,12,8,13,4,0,1,8
S01008247,Occupancy rating +2 or more,204,31,18,13,170,18,147,83,55,9,5,1,4,3,0,0,1,2
S01008247,Occupancy rating +1,64,16,4,12,47,3,40,17,12,11,4,3,1,1,1,0,0,0
S01008247,Occupancy rating 0,33,8,3,5,20,1,13,2,9,2,6,4,2,5,0,0,0,5
S01008247,Occupancy rating -1 or less,18,1,0,1,13,0,8,1,5,2,5,4,1,4,3,0,0,1
S01008248,All households,397,106,52,54,277,51,191,83,85,23,35,24,11,14,8,0,1,5
S01008248,Occupancy rating +2 or more,219,44,23,21,170,37,125,67,47,11,8,7,1,5,2,0,1,2
S01008248,Occupancy rating +1,88,33,17,16,53,13,30,11,13,6,10,4,6,2,1,0,0,1
S01008248,Occupancy rating 0,61,23,9,14,35,1,22,5,13,4,12,8,4,3,2,0,0,1
S01008248,Occupancy rating -1 or less,29,6,3,3,19,0,14,0,12,2,5,5,0,4,3,0,0,1
S01008249,All households,401,119,50,69,268,44,204,102,82,20,20,13,7,14,1,0,2,11
S01008249,Occupancy rating +2 or more,260,67,31,36,188,39,143,87,47,9,6,3,3,5,0,0,0,5
S01008249,Occupancy rating +1,76,28,11,17,43,5,33,12,14,7,5,3,2,5,1,0,2,2
S01008249,Occupancy rating 0,49,20,7,13,27,0,21,2,15,4,6,4,2,2,0,0,0,2
S01008249,Occupancy rating -1 or less,16,4,1,3,10,0,7,1,6,0,3,3,0,2,0,0,0,2
S01008250,All households,447,122,43,79,307,51,229,111,93,25,27,20,7,18,4,0,1,13
S01008250,Occupancy rating +2 or more,269,51,28,23,213,37,169,84,71,14,7,6,1,5,2,0,0,3
S01008250,Occupancy rating +1,118,52,12,40,62,13,44,22,13,9,5,2,3,4,0,0,1,3
S01008250,Occupancy rating 0,41,11,1,10,26,1,14,4,9,1,11,9,2,4,1,0,0,3
S01008250,Occupancy rating -1 or less,19,8,2,6,6,0,2,1,0,1,4,3,1,5,1,0,0,4
S01008251,All households,255,28,13,15,221,28,177,37,125,15,16,9,7,6,2,0,0,4
S01008251,Occupancy rating +2 or more,198,23,11,12,171,25,135,34,90,11,11,6,5,4,2,0,0,2
S01008251,Occupancy rating +1,40,4,1,3,34,3,29,3,23,3,2,1,1,2,0,0,0,2
S01008251,Occupancy rating 0,11,1,1,0,10,0,7,0,6,1,3,2,1,0,0,0,0,0
S01008251,Occupancy rating -1 or less,6,0,0,0,6,0,6,0,6,0,0,0,0,0,0,0,0,0
S01008252,All households,338,81,48,33,246,49,175,67,81,27,22,11,11,11,7,0,0,4
S01008252,Occupancy rating +2 or more,246,51,32,19,187,45,132,63,52,17,10,4,6,8,5,0,0,3
S01008252,Occupancy rating +1,63,27,15,12,35,4,27,4,16,7,4,2,2,1,1,0,0,0
S01008252,Occupancy rating 0,23,2,0,2,20,0,14,0,12,2,6,4,2,1,0,0,0,1
S01008252,Occupancy rating -1 or less,6,1,1,0,4,0,2,0,1,1,2,1,1,1,1,0,0,0
S01008253,All households,370,151,89,62,211,24,150,61,63,26,37,10,27,8,1,0,1,6
S01008253,Occupancy rating +2 or more,113,37,25,12,75,10,62,39,14,9,3,1,2,1,0,0,0,1
S01008253,Occupancy rating +1,122,63,41,22,54,8,38,16,16,6,8,1,7,5,0,0,1,4
S01008253,Occupancy rating 0,103,38,16,22,63,5,34,5,21,8,24,7,17,2,1,0,0,1
S01008253,Occupancy rating -1 or less,32,13,7,6,19,1,16,1,12,3,2,1,1,0,0,0,0,0
S01008254,All households,428,135,65,70,282,41,185,63,86,36,56,32,24,11,4,0,2,5
S01008254,Occupancy rating +2 or more,157,53,28,25,102,26,67,36,23,8,9,3,6,2,2,0,0,0
S01008254,Occupancy rating +1,109,27,12,15,80,13,52,20,16,16,15,10,5,2,1,0,0,1
S01008254,Occupancy rating 0,127,41,20,21,83,1,55,7,37,11,27,17,10,3,0,0,2,1
S01008254,Occupancy rating -1 or less,35,14,5,9,17,1,11,0,10,1,5,2,3,4,1,0,0,3
S01008255,All households,292,79,41,38,202,23,142,48,71,23,37,25,12,11,5,0,0,6
S01008255,Occupancy rating +2 or more,142,49,25,24,93,21,70,40,24,6,2,0,2,0,0,0,0,0
S01008255,Occupancy rating +1,90,24,12,12,61,2,39,7,22,10,20,13,7,5,1,0,0,4
S01008255,Occupancy rating 0,43,4,2,2,34,0,26,1,18,7,8,8,0,5,3,0,0,2
S01008255,Occupancy rating -1 or less,17,2,2,0,14,0,7,0,7,0,7,4,3,1,1,0,0,0
S01008256,All households,361,118,41,77,222,20,136,43,70,23,66,41,25,21,7,0,0,14
S01008256,Occupancy rating +2 or more,114,44,22,22,69,15,50,29,14,7,4,1,3,1,0,0,0,1
S01008256,Occupancy rating +1,87,31,7,24,48,4,27,6,15,6,17,7,10,8,2,0,0,6
S01008256,Occupancy rating 0,118,34,12,22,78,1,42,7,28,7,35,23,12,6,2,0,0,4
S01008256,Occupancy rating -1 or less,42,9,0,9,27,0,17,1,13,3,10,10,0,6,3,0,0,3
S01008257,All households,357,185,116,69,165,48,91,35,43,13,26,16,10,7,0,0,1,6
S01008257,Occupancy rating +2 or more,102,29,16,13,70,27,40,19,19,2,3,2,1,3,0,0,0,3
S01008257,Occupancy rating +1,105,61,39,22,44,12,24,9,11,4,8,3,5,0,0,0,0,0
S01008257,Occupancy rating 0,123,78,50,28,41,9,20,6,9,5,12,8,4,4,0,0,1,3
S01008257,Occupancy rating -1 or less,27,17,11,6,10,0,7,1,4,2,3,3,0,0,0,0,0,0
S01008258,All households,401,150,50,100,242,38,178,96,56,26,26,12,14,9,2,0,0,7
S01008258,Occupancy rating +2 or more,172,37,17,20,132,24,100,61,28,11,8,3,5,3,2,0,0,1
S01008258,Occupancy rating +1,126,59,28,31,67,12,49,23,18,8,6,4,2,0,0,0,0,0
S01008258,Occupancy rating 0,86,47,5,42,36,2,24,12,8,4,10,4,6,3,0,0,0,3
S01008258,Occupancy rating -1 or less,17,7,0,7,7,0,5,0,2,3,2,1,1,3,0,0,0,3
S01008259,All households,376,153,75,78,212,32,155,64,72,19,25,14,11,11,4,0,0,7
S01008259,Occupancy rating +2 or more,158,52,31,21,104,21,76,35,30,11,7,2,5,2,0,0,0,2
S01008259,Occupancy rating +1,86,33,14,19,51,7,42,17,22,3,2,2,0,2,2,0,0,0
S01008259,Occupancy rating 0,98,42,20,22,51,4,33,11,18,4,14,8,6,5,0,0,0,5
S01008259,Occupancy rating -1 or less,34,26,10,16,6,0,4,1,2,1,2,2,0,2,2,0,0,0
S01008260,All households,355,112,38,74,226,22,148,67,62,19,56,37,19,17,5,0,0,12
S01008260,Occupancy rating +2 or more,109,33,13,20,75,20,51,38,9,4,4,1,3,1,0,0,0,1
S01008260,Occupancy rating +1,102,31,12,19,67,2,45,20,18,7,20,14,6,4,0,0,0,4
S01008260,Occupancy rating 0,106,45,11,34,55,0,37,6,26,5,18,12,6,6,3,0,0,3
S01008260,Occupancy rating -1 or less,38,3,2,1,29,0,15,3,9,3,14,10,4,6,2,0,0,4
S01008261,All households,368,99,38,61,250,28,173,64,78,31,49,36,13,19,8,0,2,9
S01008261,Occupancy rating +2 or more,107,31,14,17,74,16,52,32,13,7,6,1,5,2,1,0,0,1
S01008261,Occupancy rating +1,125,42,14,28,81,9,57,27,19,11,15,13,2,2,0,0,1,1
S01008261,Occupancy rating 0,108,24,9,15,75,3,49,5,34,10,23,17,6,9,4,0,1,4
S01008261,Occupancy rating -1 or less,28,2,1,1,20,0,15,0,12,3,5,5,0,6,3,0,0,3
S01008262,All households,252,66,27,39,180,17,149,63,63,23,14,7,7,6,3,0,0,3
S01008262,Occupancy rating +2 or more,138,25,11,14,110,12,89,49,31,9,9,6,3,3,1,0,0,2
S01008262,Occupancy rating +1,58,25,9,16,32,4,28,10,12,6,0,0,0,1,0,0,0,1
S01008262,Occupancy rating 0,46,15,6,9,30,0,25,4,14,7,5,1,4,1,1,0,0,0
S01008262,Occupancy rating -1 or less,10,1,1,0,8,1,7,0,6,1,0,0,0,1,1,0,0,0
S01008263,All households,284,108,40,68,171,38,110,57,40,13,23,11,12,5,1,0,0,4
S01008263,Occupancy rating +2 or more,125,34,14,20,88,26,61,33,19,9,1,0,1,3,1,0,0,2
S01008263,Occupancy rating +1,95,52,21,31,43,9,26,20,5,1,8,4,4,0,0,0,0,0
S01008263,Occupancy rating 0,58,21,5,16,35,3,22,3,16,3,10,5,5,2,0,0,0,2
S01008263,Occupancy rating -1 or less,6,1,0,1,5,0,1,1,0,0,4,2,2,0,0,0,0,0
S01008264,All households,330,113,52,61,207,32,149,42,90,17,26,19,7,10,1,0,0,9
S01008264,Occupancy rating +2 or more,119,32,17,15,86,17,66,21,38,7,3,2,1,1,0,0,0,1
S01008264,Occupancy rating +1,80,36,14,22,43,12,27,17,7,3,4,3,1,1,1,0,0,0
S01008264,Occupancy rating 0,111,41,18,23,64,3,46,4,36,6,15,11,4,6,0,0,0,6
S01008264,Occupancy rating -1 or less,20,4,3,1,14,0,10,0,9,1,4,3,1,2,0,0,0,2
S01008265,All households,332,123,84,39,206,54,135,54,71,10,17,9,8,3,0,0,0,3
S01008265,Occupancy rating +2 or more,211,58,47,11,152,39,101,40,55,6,12,5,7,1,0,0,0,1
S01008265,Occupancy rating +1,86,50,29,21,36,13,22,10,11,1,1,0,1,0,0,0,0,0
S01008265,Occupancy rating 0,27,12,7,5,15,2,10,3,4,3,3,3,0,0,0,0,0,0
S01008265,Occupancy rating -1 or less,8,3,1,2,3,0,2,1,1,0,1,1,0,2,0,0,0,2
S01008266,All households,319,104,81,23,208,67,131,61,56,14,10,4,6,7,5,0,0,2
S01008266,Occupancy rating +2 or more,250,72,57,15,173,63,106,53,44,9,4,0,4,5,3,0,0,2
S01008266,Occupancy rating +1,49,26,20,6,22,3,18,6,9,3,1,0,1,1,1,0,0,0
S01008266,Occupancy rating 0,15,6,4,2,9,1,5,2,1,2,3,2,1,0,0,0,0,0
S01008266,Occupancy rating -1 or less,5,0,0,0,4,0,2,0,2,0,2,2,0,1,1,0,0,0
S01008267,All households,350,89,39,50,251,42,180,85,78,17,29,15,14,10,3,0,1,6
S01008267,Occupancy rating +2 or more,202,41,20,21,159,30,125,62,56,7,4,1,3,2,1,0,1,0
S01008267,Occupancy rating +1,87,30,12,18,54,11,36,23,7,6,7,4,3,3,0,0,0,3
S01008267,Occupancy rating 0,49,16,7,9,29,1,14,0,12,2,14,7,7,4,1,0,0,3
S01008267,Occupancy rating -1 or less,12,2,0,2,9,0,5,0,3,2,4,3,1,1,1,0,0,0
S01008268,All households,355,99,57,42,249,69,170,76,78,16,10,7,3,7,5,0,1,1
S01008268,Occupancy rating +2 or more,255,55,38,17,197,58,132,63,58,11,7,4,3,3,3,0,0,0
S01008268,Occupancy rating +1,59,27,12,15,31,6,24,8,14,2,1,1,0,1,0,0,1,0
S01008268,Occupancy rating 0,26,11,5,6,13,4,9,4,3,2,0,0,0,2,1,0,0,1
S01008268,Occupancy rating -1 or less,15,6,2,4,8,1,5,1,3,1,2,2,0,1,1,0,0,0
S01008269,All households,400,167,139,28,227,74,138,49,64,25,15,7,8,6,1,0,2,3
S01008269,Occupancy rating +2 or more,250,72,56,16,175,52,116,44,54,18,7,3,4,3,0,0,1,2
S01008269,Occupancy rating +1,78,47,40,7,29,18,7,3,2,2,4,2,2,2,0,0,1,1
S01008269,Occupancy rating 0,62,45,40,5,16,3,10,2,6,2,3,1,2,1,1,0,0,0
S01008269,Occupancy rating -1 or less,10,3,3,0,7,1,5,0,2,3,1,1,0,0,0,0,0,0
S01008270,All households,394,160,111,49,221,65,132,53,64,15,24,10,14,13,3,0,3,7
S01008270,Occupancy rating +2 or more,228,74,49,25,147,39,101,41,50,10,7,2,5,7,2,0,1,4
S01008270,Occupancy rating +1,102,48,32,16,53,19,26,12,11,3,8,2,6,1,1,0,0,0
S01008270,Occupancy rating 0,52,33,26,7,17,5,4,0,2,2,8,5,3,2,0,0,0,2
S01008270,Occupancy rating -1 or less,12,5,4,1,4,2,1,0,1,0,1,1,0,3,0,0,2,1
S01008271,All households,386,211,67,144,161,23,103,57,37,9,35,26,9,14,3,0,1,10
S01008271,Occupancy rating +2 or more,102,45,15,30,56,10,40,19,15,6,6,1,5,1,0,0,0,1
S01008271,Occupancy rating +1,94,50,18,32,42,8,28,20,7,1,6,6,0,2,1,0,0,1
S01008271,Occupancy rating 0,124,70,21,49,45,4,29,15,12,2,12,10,2,9,1,0,1,7
S01008271,Occupancy rating -1 or less,66,46,13,33,18,1,6,3,3,0,11,9,2,2,1,0,0,1
S01008272,All households,414,105,51,54,299,40,222,90,101,31,37,28,9,10,4,0,3,3
S01008272,Occupancy rating +2 or more,241,50,32,18,187,31,143,61,66,16,13,9,4,4,0,0,2,2
S01008272,Occupancy rating +1,100,33,9,24,64,5,56,27,19,10,3,3,0,3,1,0,1,1
S01008272,Occupancy rating 0,58,19,10,9,37,1,18,2,12,4,18,13,5,2,2,0,0,0
S01008272,Occupancy rating -1 or less,15,3,0,3,11,3,5,0,4,1,3,3,0,1,1,0,0,0
S01008273,All households,346,88,57,31,250,48,177,64,87,26,25,17,8,8,2,0,0,6
S01008273,Occupancy rating +2 or more,229,38,28,10,187,40,136,55,65,16,11,7,4,4,2,0,0,2
S01008273,Occupancy rating +1,63,28,20,8,34,8,22,8,11,3,4,3,1,1,0,0,0,1
S01008273,Occupancy rating 0,40,18,8,10,20,0,11,1,5,5,9,6,3,2,0,0,0,2
S01008273,Occupancy rating -1 or less,14,4,1,3,9,0,8,0,6,2,1,1,0,1,0,0,0,1
S01008274,All households,322,94,44,50,214,41,129,42,59,28,44,27,17,14,3,0,2,9
S01008274,Occupancy rating +2 or more,123,37,22,15,83,32,44,26,11,7,7,4,3,3,0,0,1,2
S01008274,Occupancy rating +1,111,41,19,22,67,7,46,12,22,12,14,9,5,3,1,0,1,1
S01008274,Occupancy rating 0,69,12,3,9,53,2,31,2,22,7,20,11,9,4,0,0,0,4
S01008274,Occupancy rating -1 or less,19,4,0,4,11,0,8,2,4,2,3,3,0,4,2,0,0,2
S01008275,All households,258,88,45,43,160,30,110,50,47,13,20,13,7,10,3,0,0,7
S01008275,Occupancy rating +2 or more,140,34,20,14,102,21,74,39,29,6,7,3,4,4,0,0,0,4
S01008275,Occupancy rating +1,65,32,13,19,30,6,20,9,9,2,4,3,1,3,2,0,0,1
S01008275,Occupancy rating 0,44,21,11,10,20,2,12,2,5,5,6,5,1,3,1,0,0,2
S01008275,Occupancy rating -1 or less,9,1,1,0,8,1,4,0,4,0,3,2,1,0,0,0,0,0
S01008276,All households,199,26,8,18,166,24,126,39,68,19,16,10,6,7,3,0,1,3
S01008276,Occupancy rating +2 or more,139,9,1,8,126,20,99,29,58,12,7,5,2,4,2,0,1,1
S01008276,Occupancy rating +1,34,13,7,6,20,3,17,9,3,5,0,0,0,1,0,0,0,1
S01008276,Occupancy rating 0,18,4,0,4,12,1,6,1,3,2,5,3,2,2,1,0,0,1
S01008276,Occupancy rating -1 or less,8,0,0,0,8,0,4,0,4,0,4,2,2,0,0,0,0,0
S01008277,All households,213,55,25,30,147,20,116,53,53,10,11,9,2,11,2,0,2,7
S01008277,Occupancy rating +2 or more,141,37,19,18,100,18,81,42,32,7,1,1,0,4,1,0,1,2
S01008277,Occupancy rating +1,42,15,5,10,27,1,20,9,9,2,6,5,1,0,0,0,0,0
S01008277,Occupancy rating 0,21,2,1,1,12,0,10,1,8,1,2,1,1,7,1,0,1,5
S01008277,Occupancy rating -1 or less,9,1,0,1,8,1,5,1,4,0,2,2,0,0,0,0,0,0
S01008278,All households,334,81,43,38,243,49,181,89,80,12,13,8,5,10,5,0,0,5
S01008278,Occupancy rating +2 or more,247,61,35,26,182,45,134,71,54,9,3,1,2,4,3,0,0,1
S01008278,Occupancy rating +1,62,17,8,9,41,2,34,14,17,3,5,5,0,4,2,0,0,2
S01008278,Occupancy rating 0,18,2,0,2,15,2,9,3,6,0,4,1,3,1,0,0,0,1
S01008278,Occupancy rating -1 or less,7,1,0,1,5,0,4,1,3,0,1,1,0,1,0,0,0,1
S01008279,All households,331,97,54,43,227,39,160,73,65,22,28,15,13,7,2,0,1,4
S01008279,Occupancy rating +2 or more,163,39,27,12,122,30,85,52,26,7,7,3,4,2,1,0,1,0
S01008279,Occupancy rating +1,97,37,22,15,60,7,45,17,19,9,8,4,4,0,0,0,0,0
S01008279,Occupancy rating 0,52,16,5,11,31,2,19,3,12,4,10,5,5,5,1,0,0,4
S01008279,Occupancy rating -1 or less,19,5,0,5,14,0,11,1,8,2,3,3,0,0,0,0,0,0
S01008280,All households,425,148,65,83,261,39,198,91,86,21,24,12,12,16,4,0,1,11
S01008280,Occupancy rating +2 or more,206,58,24,34,142,24,114,63,43,8,4,1,3,6,2,0,0,4
S01008280,Occupancy rating +1,92,36,16,20,53,6,41,18,19,4,6,3,3,3,1,0,1,1
S01008280,Occupancy rating 0,83,34,20,14,47,8,33,8,19,6,6,3,3,2,0,0,0,2
S01008280,Occupancy rating -1 or less,44,20,5,15,19,1,10,2,5,3,8,5,3,5,1,0,0,4
S01008281,All households,316,81,24,57,228,27,171,88,60,23,30,20,10,7,1,0,0,6
S01008281,Occupancy rating +2 or more,184,38,17,21,144,23,111,65,30,16,10,4,6,2,1,0,0,1
S01008281,Occupancy rating +1,70,25,4,21,45,3,36,19,14,3,6,4,2,0,0,0,0,0
S01008281,Occupancy rating 0,53,17,3,14,32,1,22,4,14,4,9,8,1,4,0,0,0,4
S01008281,Occupancy rating -1 or less,9,1,0,1,7,0,2,0,2,0,5,4,1,1,0,0,0,1
S01008282,All households,299,78,35,43,214,32,166,89,60,17,16,10,6,7,5,0,0,2
S01008282,Occupancy rating +2 or more,165,44,23,21,119,21,94,57,31,6,4,1,3,2,1,0,0,1
S01008282,Occupancy rating +1,77,23,7,16,53,9,41,23,14,4,3,2,1,1,1,0,0,0
S01008282,Occupancy rating 0,44,10,4,6,33,2,25,9,11,5,6,5,1,1,1,0,0,0
S01008282,Occupancy rating -1 or less,13,1,1,0,9,0,6,0,4,2,3,2,1,3,2,0,0,1
S01008283,All households,184,34,7,27,139,12,120,47,59,14,7,5,2,11,5,0,0,6
S01008283,Occupancy rating +2 or more,137,26,6,20,101,9,89,36,45,8,3,2,1,10,5,0,0,5
S01008283,Occupancy rating +1,30,7,1,6,22,1,21,11,7,3,0,0,0,1,0,0,0,1
S01008283,Occupancy rating 0,10,1,0,1,9,2,5,0,3,2,2,1,1,0,0,0,0,0
S01008283,Occupancy rating -1 or less,7,0,0,0,7,0,5,0,4,1,2,2,0,0,0,0,0,0
S01008284,All households,348,73,40,33,266,24,211,73,112,26,31,19,12,9,4,0,1,4
S01008284,Occupancy rating +2 or more,183,29,16,13,149,15,127,42,70,15,7,3,4,5,2,0,1,2
S01008284,Occupancy rating +1,102,31,18,13,70,4,52,27,18,7,14,10,4,1,1,0,0,0
S01008284,Occupancy rating 0,53,10,4,6,41,3,29,4,21,4,9,6,3,2,1,0,0,1
S01008284,Occupancy rating -1 or less,10,3,2,1,6,2,3,0,3,0,1,0,1,1,0,0,0,1
S01008285,All households,355,119,55,64,224,42,137,55,59,23,45,24,21,12,4,0,0,8
S01008285,Occupancy rating +2 or more,84,27,16,11,57,17,39,25,11,3,1,1,0,0,0,0,0,0
S01008285,Occupancy rating +1,159,87,36,51,71,22,43,25,11,7,6,3,3,1,0,0,0,1
S01008285,Occupancy rating 0,90,3,2,1,80,2,44,3,30,11,34,18,16,7,2,0,0,5
S01008285,Occupancy rating -1 or less,22,2,1,1,16,1,11,2,7,2,4,2,2,4,2,0,0,2
S01008286,All households,303,80,45,35,212,31,151,55,69,27,30,16,14,11,5,0,0,6
S01008286,Occupancy rating +2 or more,124,30,16,14,91,16,72,43,22,7,3,2,1,3,0,0,0,3
S01008286,Occupancy rating +1,83,24,13,11,58,8,43,9,19,15,7,1,6,1,1,0,0,0
S01008286,Occupancy rating 0,67,16,12,4,45,6,25,2,19,4,14,8,6,6,3,0,0,3
S01008286,Occupancy rating -1 or less,29,10,4,6,18,1,11,1,9,1,6,5,1,1,1,0,0,0
S01008287,All households,311,100,43,57,199,24,146,54,61,31,29,16,13,12,7,1,0,4
S01008287,Occupancy rating +2 or more,149,46,23,23,98,18,78,38,24,16,2,1,1,5,0,1,0,4
S01008287,Occupancy rating +1,69,28,5,23,41,1,29,12,14,3,11,2,9,0,0,0,0,0
S01008287,Occupancy rating 0,69,20,11,9,45,4,28,4,15,9,13,12,1,4,4,0,0,0
S01008287,Occupancy rating -1 or less,24,6,4,2,15,1,11,0,8,3,3,1,2,3,3,0,0,0
S01008288,All households,413,151,93,58,243,44,172,78,71,23,27,21,6,19,8,0,0,11
S01008288,Occupancy rating +2 or more,209,59,40,19,144,28,113,56,44,13,3,2,1,6,1,0,0,5
S01008288,Occupancy rating +1,103,49,23,26,48,11,29,14,9,6,8,5,3,6,3,0,0,3
S01008288,Occupancy rating 0,74,33,26,7,38,4,25,7,16,2,9,8,1,3,1,0,0,2
S01008288,Occupancy rating -1 or less,27,10,4,6,13,1,5,1,2,2,7,6,1,4,3,0,0,1
S01008289,All households,319,138,39,99,161,21,104,54,35,15,36,22,14,20,4,0,0,16
S01008289,Occupancy rating +2 or more,82,28,13,15,51,13,34,22,11,1,4,2,2,3,2,0,0,1
S01008289,Occupancy rating +1,90,41,15,26,43,5,29,20,4,5,9,4,5,6,0,0,0,6
S01008289,Occupancy rating 0,112,49,10,39,55,3,31,9,15,7,21,14,7,8,1,0,0,7
S01008289,Occupancy rating -1 or less,35,20,1,19,12,0,10,3,5,2,2,2,0,3,1,0,0,2
S01008290,All households,397,152,50,102,226,19,175,67,90,18,32,24,8,19,4,0,0,15
S01008290,Occupancy rating +2 or more,151,41,18,23,103,9,90,39,45,6,4,2,2,7,2,0,0,5
S01008290,Occupancy rating +1,102,49,14,35,51,10,37,21,12,4,4,3,1,2,0,0,0,2
S01008290,Occupancy rating 0,107,40,17,23,59,0,37,4,27,6,22,19,3,8,1,0,0,7
S01008290,Occupancy rating -1 or less,37,22,1,21,13,0,11,3,6,2,2,0,2,2,1,0,0,1
S01008291,All households,369,145,89,56,221,69,137,70,41,26,15,9,6,3,1,0,0,2
S01008291,Occupancy rating +2 or more,152,43,31,12,108,38,68,47,10,11,2,2,0,1,1,0,0,0
S01008291,Occupancy rating +1,139,72,33,39,66,24,42,22,11,9,0,0,0,1,0,0,0,1
S01008291,Occupancy rating 0,68,25,22,3,42,5,26,1,20,5,11,7,4,1,0,0,0,1
S01008291,Occupancy rating -1 or less,10,5,3,2,5,2,1,0,0,1,2,0,2,0,0,0,0,0
S01008292,All households,310,59,17,42,243,17,168,50,99,19,58,48,10,8,5,0,0,3
S01008292,Occupancy rating +2 or more,103,14,5,9,87,7,74,32,38,4,6,5,1,2,1,0,0,1
S01008292,Occupancy rating +1,87,22,8,14,64,9,43,14,22,7,12,9,3,1,1,0,0,0
S01008292,Occupancy rating 0,92,17,4,13,73,1,43,4,32,7,29,24,5,2,0,0,0,2
S01008292,Occupancy rating -1 or less,28,6,0,6,19,0,8,0,7,1,11,10,1,3,3,0,0,0
S01008293,All households,199,20,8,12,175,20,150,35,102,13,5,4,1,4,3,0,0,1
S01008293,Occupancy rating +2 or more,176,20,8,12,152,19,130,33,86,11,3,2,1,4,3,0,0,1
S01008293,Occupancy rating +1,17,0,0,0,17,1,16,2,13,1,0,0,0,0,0,0,0,0
S01008293,Occupancy rating 0,4,0,0,0,4,0,3,0,2,1,1,1,0,0,0,0,0,0
S01008293,Occupancy rating -1 or less,2,0,0,0,2,0,1,0,1,0,1,1,0,0,0,0,0,0
S01008294,All households,326,58,25,33,253,16,219,69,119,31,18,14,4,15,9,0,0,6
S01008294,Occupancy rating +2 or more,225,34,14,20,182,11,163,56,89,18,8,8,0,9,5,0,0,4
S01008294,Occupancy rating +1,44,7,3,4,36,5,28,8,16,4,3,1,2,1,0,0,0,1
S01008294,Occupancy rating 0,43,14,6,8,29,0,22,4,11,7,7,5,2,0,0,0,0,0
S01008294,Occupancy rating -1 or less,14,3,2,1,6,0,6,1,3,2,0,0,0,5,4,0,0,1
S01008295,All households,380,88,29,59,280,28,220,80,87,53,32,24,8,12,8,0,0,4
S01008295,Occupancy rating +2 or more,183,48,15,33,132,21,107,61,28,18,4,4,0,3,2,0,0,1
S01008295,Occupancy rating +1,116,27,9,18,85,5,67,19,31,17,13,10,3,4,1,0,0,3
S01008295,Occupancy rating 0,59,7,5,2,51,1,37,0,23,14,13,9,4,1,1,0,0,0
S01008295,Occupancy rating -1 or less,22,6,0,6,12,1,9,0,5,4,2,1,1,4,4,0,0,0
S01008296,All households,320,132,77,55,169,21,106,32,50,24,42,27,15,19,5,0,2,12
S01008296,Occupancy rating +2 or more,98,32,15,17,65,10,53,23,19,11,2,1,1,1,0,0,0,1
S01008296,Occupancy rating +1,72,31,14,17,37,4,25,8,12,5,8,4,4,4,1,0,1,2
S01008296,Occupancy rating 0,109,43,31,12,56,6,21,1,14,6,29,19,10,10,2,0,0,8
S01008296,Occupancy rating -1 or less,41,26,17,9,11,1,7,0,5,2,3,3,0,4,2,0,1,1
S01008297,All households,295,66,25,41,219,25,159,41,95,23,35,25,10,10,3,0,1,6
S01008297,Occupancy rating +2 or more,161,30,14,16,127,19,99,33,53,13,9,6,3,4,2,0,0,2
S01008297,Occupancy rating +1,74,28,7,21,44,6,31,7,16,8,7,4,3,2,0,0,0,2
S01008297,Occupancy rating 0,47,6,3,3,39,0,24,1,21,2,15,12,3,2,0,0,1,1
S01008297,Occupancy rating -1 or less,13,2,1,1,9,0,5,0,5,0,4,3,1,2,1,0,0,1
S01008298,All households,303,80,23,57,213,23,170,61,80,29,20,12,8,10,6,0,1,3
S01008298,Occupancy rating +2 or more,141,29,7,22,109,14,91,42,37,12,4,1,3,3,2,0,0,1
S01008298,Occupancy rating +1,89,33,11,22,53,3,43,14,21,8,7,6,1,3,1,0,1,1
S01008298,Occupancy rating 0,52,13,4,9,37,6,26,4,15,7,5,2,3,2,1,0,0,1
S01008298,Occupancy rating -1 or less,21,5,1,4,14,0,10,1,7,2,4,3,1,2,2,0,0,0
S01008299,All households,370,156,58,98,196,24,117,47,47,23,55,46,9,18,5,0,0,13
S01008299,Occupancy rating +2 or more,88,22,10,12,63,10,45,22,11,12,8,8,0,3,0,0,0,3
S01008299,Occupancy rating +1,106,49,18,31,53,7,33,16,12,5,13,10,3,4,0,0,0,4
S01008299,Occupancy rating 0,121,64,24,40,49,5,21,5,12,4,23,21,2,8,2,0,0,6
S01008299,Occupancy rating -1 or less,55,21,6,15,31,2,18,4,12,2,11,7,4,3,3,0,0,0
S01008300,All households,377,128,50,78,241,26,158,55,68,35,57,35,22,8,2,0,2,4
S01008300,Occupancy rating +2 or more,135,43,23,20,88,15,68,32,20,16,5,1,4,4,1,0,0,3
S01008300,Occupancy rating +1,107,48,15,33,57,7,40,15,14,11,10,7,3,2,1,0,0,1
S01008300,Occupancy rating 0,102,33,12,21,68,4,39,8,26,5,25,16,9,1,0,0,1,0
S01008300,Occupancy rating -1 or less,33,4,0,4,28,0,11,0,8,3,17,11,6,1,0,0,1,0
S01008301,All households,316,59,18,41,248,16,204,77,88,39,28,15,13,9,5,0,1,3
S01008301,Occupancy rating +2 or more,180,43,14,29,135,15,111,64,33,14,9,3,6,2,1,0,0,1
S01008301,Occupancy rating +1,68,13,3,10,53,1,43,6,22,15,9,5,4,2,1,0,0,1
S01008301,Occupancy rating 0,56,1,0,1,52,0,43,6,28,9,9,7,2,3,2,0,0,1
S01008301,Occupancy rating -1 or less,12,2,1,1,8,0,7,1,5,1,1,0,1,2,1,0,1,0
S01008302,All households,300,69,36,33,223,44,162,67,72,23,17,9,8,8,4,0,1,3
S01008302,Occupancy rating +2 or more,242,50,26,24,184,38,135,62,52,21,11,5,6,8,4,0,1,3
S01008302,Occupancy rating +1,37,12,6,6,25,4,16,4,11,1,5,3,2,0,0,0,0,0
S01008302,Occupancy rating 0,18,6,3,3,12,2,10,1,8,1,0,0,0,0,0,0,0,0
S01008302,Occupancy rating -1 or less,3,1,1,0,2,0,1,0,1,0,1,1,0,0,0,0,0,0
S01008303,All households,272,123,50,73,145,17,93,30,45,18,35,20,15,4,3,0,1,0
S01008303,Occupancy rating +2 or more,93,35,16,19,56,6,46,14,24,8,4,0,4,2,2,0,0,0
S01008303,Occupancy rating +1,69,36,13,23,32,3,24,9,11,4,5,3,2,1,0,0,1,0
S01008303,Occupancy rating 0,88,44,16,28,43,6,20,6,10,4,17,9,8,1,1,0,0,0
S01008303,Occupancy rating -1 or less,22,8,5,3,14,2,3,1,0,2,9,8,1,0,0,0,0,0
S01008304,All households,212,82,37,45,120,14,94,37,30,27,12,8,4,10,4,0,0,6
S01008304,Occupancy rating +2 or more,105,20,11,9,83,9,68,30,21,17,6,4,2,2,2,0,0,0
S01008304,Occupancy rating +1,52,32,12,20,15,1,13,4,4,5,1,0,1,5,1,0,0,4
S01008304,Occupancy rating 0,45,27,14,13,18,2,12,2,5,5,4,4,0,0,0,0,0,0
S01008304,Occupancy rating -1 or less,10,3,0,3,4,2,1,1,0,0,1,0,1,3,1,0,0,2
S01008305,All households,315,60,33,27,243,38,184,67,69,48,21,11,10,12,3,0,1,8
S01008305,Occupancy rating +2 or more,164,36,18,18,124,23,96,52,23,21,5,1,4,4,0,0,1,3
S01008305,Occupancy rating +1,85,17,11,6,62,9,52,13,24,15,1,1,0,6,1,0,0,5
S01008305,Occupancy rating 0,62,6,3,3,55,5,35,2,22,11,15,9,6,1,1,0,0,0
S01008305,Occupancy rating -1 or less,4,1,1,0,2,1,1,0,0,1,0,0,0,1,1,0,0,0
S01008306,All households,239,48,25,23,186,21,151,47,56,48,14,8,6,5,3,0,0,2
S01008306,Occupancy rating +2 or more,128,38,20,18,88,20,65,38,16,11,3,3,0,2,2,0,0,0
S01008306,Occupancy rating +1,73,8,4,4,63,1,57,8,20,29,5,2,3,2,0,0,0,2
S01008306,Occupancy rating 0,33,2,1,1,31,0,25,1,18,6,6,3,3,0,0,0,0,0
S01008306,Occupancy rating -1 or less,5,0,0,0,4,0,4,0,2,2,0,0,0,1,1,0,0,0
S01008307,All households,216,35,15,20,175,16,135,40,77,18,24,18,6,6,2,0,1,3
S01008307,Occupancy rating +2 or more,121,21,8,13,97,15,72,31,32,9,10,9,1,3,2,0,1,0
S01008307,Occupancy rating +1,56,12,5,7,43,1,37,8,25,4,5,3,2,1,0,0,0,1
S01008307,Occupancy rating 0,30,1,1,0,28,0,23,0,18,5,5,3,2,1,0,0,0,1
S01008307,Occupancy rating -1 or less,9,1,1,0,7,0,3,1,2,0,4,3,1,1,0,0,0,1
S01008308,All households,238,45,27,18,188,50,126,54,44,28,12,6,6,5,4,0,0,1
S01008308,Occupancy rating +2 or more,164,35,21,14,127,39,83,35,28,20,5,1,4,2,2,0,0,0
S01008308,Occupancy rating +1,53,10,6,4,42,8,32,16,8,8,2,1,1,1,1,0,0,0
S01008308,Occupancy rating 0,15,0,0,0,14,2,8,2,6,0,4,3,1,1,0,0,0,1
S01008308,Occupancy rating -1 or less,6,0,0,0,5,1,3,1,2,0,1,1,0,1,1,0,0,0
S01008309,All households,372,181,53,128,176,25,85,33,38,14,66,55,11,15,5,0,3,7
S01008309,Occupancy rating +2 or more,77,30,12,18,46,12,30,14,8,8,4,3,1,1,0,0,0,1
S01008309,Occupancy rating +1,108,63,8,55,44,9,20,11,8,1,15,13,2,1,0,0,1,0
S01008309,Occupancy rating 0,129,58,24,34,63,3,26,5,18,3,34,28,6,8,1,0,1,6
S01008309,Occupancy rating -1 or less,58,30,9,21,23,1,9,3,4,2,13,11,2,5,4,0,1,0
S01008310,All households,467,200,109,91,253,31,173,70,74,29,49,27,22,14,4,0,2,8
S01008310,Occupancy rating +2 or more,128,36,17,19,86,16,66,37,19,10,4,4,0,6,1,0,0,5
S01008310,Occupancy rating +1,159,79,42,37,76,8,60,29,23,8,8,4,4,4,2,0,1,1
S01008310,Occupancy rating 0,136,60,41,19,73,6,39,3,28,8,28,12,16,3,1,0,1,1
S01008310,Occupancy rating -1 or less,44,25,9,16,18,1,8,1,4,3,9,7,2,1,0,0,0,1
S01008311,All households,172,61,18,43,106,9,71,19,41,11,26,15,11,5,3,0,0,2
S01008311,Occupancy rating +2 or more,43,12,5,7,31,5,25,15,7,3,1,1,0,0,0,0,0,0
S01008311,Occupancy rating +1,66,27,10,17,37,3,27,4,17,6,7,5,2,2,1,0,0,1
S01008311,Occupancy rating 0,53,19,3,16,31,1,15,0,13,2,15,7,8,3,2,0,0,1
S01008311,Occupancy rating -1 or less,10,3,0,3,7,0,4,0,4,0,3,2,1,0,0,0,0,0
S01008312,All households,171,42,17,25,118,16,78,29,42,7,24,19,5,11,0,0,0,11
S01008312,Occupancy rating +2 or more,65,8,3,5,51,5,42,16,21,5,4,3,1,6,0,0,0,6
S01008312,Occupancy rating +1,63,25,10,15,34,9,21,10,10,1,4,3,1,4,0,0,0,4
S01008312,Occupancy rating 0,34,8,4,4,25,2,13,3,9,1,10,8,2,1,0,0,0,1
S01008312,Occupancy rating -1 or less,9,1,0,1,8,0,2,0,2,0,6,5,1,0,0,0,0,0
S01008313,All households,403,153,55,98,220,23,118,45,37,36,79,49,30,30,7,0,1,22
S01008313,Occupancy rating +2 or more,88,33,13,20,51,11,37,20,8,9,3,1,2,4,1,0,0,3
S01008313,Occupancy rating +1,132,74,26,48,55,9,34,21,7,6,12,7,5,3,0,0,0,3
S01008313,Occupancy rating 0,127,33,10,23,82,2,38,3,18,17,42,28,14,12,3,0,0,9
S01008313,Occupancy rating -1 or less,56,13,6,7,32,1,9,1,4,4,22,13,9,11,3,0,1,7
S01008314,All households,311,164,21,143,132,3,73,38,28,7,56,40,16,15,7,0,0,8
S01008314,Occupancy rating +2 or more,34,13,2,11,21,1,16,10,4,2,4,2,2,0,0,0,0,0
S01008314,Occupancy rating +1,78,43,7,36,33,1,22,14,6,2,10,7,3,2,0,0,0,2
S01008314,Occupancy rating 0,140,71,9,62,63,1,30,13,14,3,32,22,10,6,2,0,0,4
S01008314,Occupancy rating -1 or less,59,37,3,34,15,0,5,1,4,0,10,9,1,7,5,0,0,2
S01008315,All households,450,265,58,207,176,11,92,45,34,13,73,58,15,9,1,0,0,8
S01008315,Occupancy rating +2 or more,51,24,9,15,27,5,13,12,1,0,9,6,3,0,0,0,0,0
S01008315,Occupancy rating +1,110,60,14,46,47,2,38,23,10,5,7,5,2,3,0,0,0,3
S01008315,Occupancy rating 0,229,147,28,119,79,4,34,9,17,8,41,36,5,3,0,0,0,3
S01008315,Occupancy rating -1 or less,60,34,7,27,23,0,7,1,6,0,16,11,5,3,1,0,0,2
S01008316,All households,265,103,11,92,147,1,79,23,49,7,67,51,16,15,7,0,1,7
S01008316,Occupancy rating +2 or more,45,19,1,18,24,1,17,5,10,2,6,3,3,2,0,0,0,2
S01008316,Occupancy rating +1,83,38,4,34,43,0,20,11,7,2,23,17,6,2,1,0,1,0
S01008316,Occupancy rating 0,114,39,5,34,68,0,37,7,27,3,31,27,4,7,2,0,0,5
S01008316,Occupancy rating -1 or less,23,7,1,6,12,0,5,0,5,0,7,4,3,4,4,0,0,0
S01008317,All households,316,110,16,94,191,7,137,42,77,18,47,36,11,15,7,0,0,8
S01008317,Occupancy rating +2 or more,86,36,4,32,47,3,41,21,16,4,3,2,1,3,0,0,0,3
S01008317,Occupancy rating +1,104,35,4,31,67,4,51,18,27,6,12,9,3,2,1,0,0,1
S01008317,Occupancy rating 0,98,25,2,23,67,0,38,3,27,8,29,22,7,6,2,0,0,4
S01008317,Occupancy rating -1 or less,28,14,6,8,10,0,7,0,7,0,3,3,0,4,4,0,0,0
S01008318,All households,368,77,39,38,274,32,205,80,87,38,37,23,14,17,5,0,2,10
S01008318,Occupancy rating +2 or more,230,51,32,19,170,28,132,58,48,26,10,4,6,9,3,0,1,5
S01008318,Occupancy rating +1,85,22,7,15,59,4,43,20,15,8,12,8,4,4,0,0,0,4
S01008318,Occupancy rating 0,40,4,0,4,35,0,25,2,20,3,10,7,3,1,0,0,1,0
S01008318,Occupancy rating -1 or less,13,0,0,0,10,0,5,0,4,1,5,4,1,3,2,0,0,1
S01008319,All households,373,161,83,78,207,42,115,38,52,25,50,29,21,5,3,0,0,2
S01008319,Occupancy rating +2 or more,88,34,21,13,54,18,35,20,11,4,1,0,1,0,0,0,0,0
S01008319,Occupancy rating +1,130,63,32,31,67,20,37,14,15,8,10,5,5,0,0,0,0,0
S01008319,Occupancy rating 0,119,51,21,30,66,4,30,3,19,8,32,18,14,2,1,0,0,1
S01008319,Occupancy rating -1 or less,36,13,9,4,20,0,13,1,7,5,7,6,1,3,2,0,0,1
S01008320,All households,308,96,48,48,207,54,119,61,31,27,34,13,21,5,2,0,0,3
S01008320,Occupancy rating +2 or more,153,47,31,16,105,38,63,43,9,11,4,1,3,1,0,0,0,1
S01008320,Occupancy rating +1,84,29,11,18,54,12,34,15,10,9,8,2,6,1,1,0,0,0
S01008320,Occupancy rating 0,65,20,6,14,44,4,19,3,9,7,21,10,11,1,0,0,0,1
S01008320,Occupancy rating -1 or less,6,0,0,0,4,0,3,0,3,0,1,0,1,2,1,0,0,1
S01008321,All households,195,30,8,22,161,13,135,45,64,26,13,10,3,4,3,0,1,0
S01008321,Occupancy rating +2 or more,130,21,4,17,108,9,97,38,43,16,2,2,0,1,0,0,1,0
S01008321,Occupancy rating +1,42,8,3,5,34,4,23,6,10,7,7,5,2,0,0,0,0,0
S01008321,Occupancy rating 0,18,1,1,0,15,0,12,1,9,2,3,2,1,2,2,0,0,0
S01008321,Occupancy rating -1 or less,5,0,0,0,4,0,3,0,2,1,1,1,0,1,1,0,0,0
S01008322,All households,501,206,65,141,278,37,179,68,81,30,62,49,13,17,6,0,0,11
S01008322,Occupancy rating +2 or more,141,46,22,24,93,16,73,42,21,10,4,4,0,2,1,0,0,1
S01008322,Occupancy rating +1,161,82,23,59,76,14,49,20,19,10,13,10,3,3,0,0,0,3
S01008322,Occupancy rating 0,148,60,14,46,80,4,40,4,27,9,36,27,9,8,3,0,0,5
S01008322,Occupancy rating -1 or less,51,18,6,12,29,3,17,2,14,1,9,8,1,4,2,0,0,2
S01008323,All households,324,98,28,70,203,14,115,43,46,26,74,47,27,23,15,0,0,8
S01008323,Occupancy rating +2 or more,90,32,14,18,57,10,39,22,10,7,8,4,4,1,1,0,0,0
S01008323,Occupancy rating +1,102,34,8,26,65,3,44,20,12,12,18,9,9,3,2,0,0,1
S01008323,Occupancy rating 0,89,24,5,19,55,1,24,1,17,6,30,22,8,10,4,0,0,6
S01008323,Occupancy rating -1 or less,43,8,1,7,26,0,8,0,7,1,18,12,6,9,8,0,0,1
S01008324,All households,254,67,26,41,172,10,109,31,48,30,53,32,21,15,11,0,1,3
S01008324,Occupancy rating +2 or more,91,37,15,22,51,7,38,25,6,7,6,3,3,3,1,0,1,1
S01008324,Occupancy rating +1,70,18,6,12,49,2,28,4,13,11,19,9,10,3,2,0,0,1
S01008324,Occupancy rating 0,69,9,3,6,55,0,34,2,22,10,21,15,6,5,5,0,0,0
S01008324,Occupancy rating -1 or less,24,3,2,1,17,1,9,0,7,2,7,5,2,4,3,0,0,1
S01008325,All households,291,73,19,54,207,11,127,34,72,21,69,48,21,11,8,0,1,2
S01008325,Occupancy rating +2 or more,90,36,12,24,54,9,36,26,7,3,9,3,6,0,0,0,0,0
S01008325,Occupancy rating +1,82,22,4,18,57,2,37,4,26,7,18,8,10,3,1,0,1,1
S01008325,Occupancy rating 0,85,13,3,10,69,0,44,4,31,9,25,22,3,3,3,0,0,0
S01008325,Occupancy rating -1 or less,34,2,0,2,27,0,10,0,8,2,17,15,2,5,4,0,0,1
S01008326,All households,455,169,49,120,267,19,137,41,68,28,111,82,29,19,5,0,1,13
S01008326,Occupancy rating +2 or more,102,51,25,26,49,14,29,19,6,4,6,4,2,2,0,0,0,2
S01008326,Occupancy rating +1,156,85,18,67,69,3,46,20,17,9,20,13,7,2,0,0,0,2
S01008326,Occupancy rating 0,143,22,4,18,109,2,43,1,34,8,64,52,12,12,2,0,1,9
S01008326,Occupancy rating -1 or less,54,11,2,9,40,0,19,1,11,7,21,13,8,3,3,0,0,0
S01008327,All households,386,141,76,65,227,29,145,51,54,40,53,39,14,18,6,0,0,12
S01008327,Occupancy rating +2 or more,106,48,29,19,56,14,34,19,9,6,8,7,1,2,0,0,0,2
S01008327,Occupancy rating +1,133,50,27,23,79,14,55,28,15,12,10,7,3,4,0,0,0,4
S01008327,Occupancy rating 0,86,17,8,9,67,1,45,2,26,17,21,14,7,2,1,0,0,1
S01008327,Occupancy rating -1 or less,61,26,12,14,25,0,11,2,4,5,14,11,3,10,5,0,0,5
S01008328,All households,242,39,11,28,201,16,159,40,104,15,26,20,6,2,1,0,0,1
S01008328,Occupancy rating +2 or more,162,28,7,21,132,13,111,35,66,10,8,6,2,2,1,0,0,1
S01008328,Occupancy rating +1,46,6,1,5,40,3,31,2,25,4,6,6,0,0,0,0,0,0
S01008328,Occupancy rating 0,26,5,3,2,21,0,12,2,9,1,9,6,3,0,0,0,0,0
S01008328,Occupancy rating -1 or less,8,0,0,0,8,0,5,1,4,0,3,2,1,0,0,0,0,0
S01008329,All households,291,33,9,24,252,23,212,58,110,44,17,12,5,6,4,0,0,2
S01008329,Occupancy rating +2 or more,191,26,7,19,162,21,138,58,57,23,3,1,2,3,2,0,0,1
S01008329,Occupancy rating +1,65,5,0,5,58,2,50,0,33,17,6,4,2,2,1,0,0,1
S01008329,Occupancy rating 0,27,2,2,0,25,0,20,0,16,4,5,4,1,0,0,0,0,0
S01008329,Occupancy rating -1 or less,8,0,0,0,7,0,4,0,4,0,3,3,0,1,1,0,0,0
S01008330,All households,290,42,19,23,237,19,189,38,101,50,29,15,14,11,6,0,0,5
S01008330,Occupancy rating +2 or more,168,39,18,21,123,18,96,38,35,23,9,2,7,6,3,0,0,3
S01008330,Occupancy rating +1,68,2,1,1,63,1,55,0,39,16,7,4,3,3,1,0,0,2
S01008330,Occupancy rating 0,46,1,0,1,43,0,33,0,24,9,10,8,2,2,2,0,0,0
S01008330,Occupancy rating -1 or less,8,0,0,0,8,0,5,0,3,2,3,1,2,0,0,0,0,0
S01008331,All households,246,82,20,62,155,12,120,32,65,23,23,21,2,9,3,0,0,6
S01008331,Occupancy rating +2 or more,92,15,2,13,74,4,65,17,35,13,5,5,0,3,1,0,0,2
S01008331,Occupancy rating +1,79,40,14,26,36,5,24,10,11,3,7,7,0,3,1,0,0,2
S01008331,Occupancy rating 0,54,17,3,14,34,3,26,4,17,5,5,4,1,3,1,0,0,2
S01008331,Occupancy rating -1 or less,21,10,1,9,11,0,5,1,2,2,6,5,1,0,0,0,0,0
S01008332,All households,378,140,81,59,222,46,153,55,67,31,23,11,12,16,10,0,0,6
S01008332,Occupancy rating +2 or more,215,56,32,24,154,34,112,41,47,24,8,2,6,5,4,0,0,1
S01008332,Occupancy rating +1,74,37,28,9,33,7,20,5,11,4,6,2,4,4,1,0,0,3
S01008332,Occupancy rating 0,73,44,18,26,24,3,15,7,5,3,6,5,1,5,3,0,0,2
S01008332,Occupancy rating -1 or less,16,3,3,0,11,2,6,2,4,0,3,2,1,2,2,0,0,0
S01008333,All households,454,189,138,51,250,62,170,74,66,30,18,9,9,15,9,1,1,4
S01008333,Occupancy rating +2 or more,283,81,51,30,195,47,137,69,46,22,11,6,5,7,4,1,1,1
S01008333,Occupancy rating +1,70,33,18,15,33,6,24,5,14,5,3,1,2,4,2,0,0,2
S01008333,Occupancy rating 0,91,69,64,5,20,8,9,0,6,3,3,1,2,2,1,0,0,1
S01008333,Occupancy rating -1 or less,10,6,5,1,2,1,0,0,0,0,1,1,0,2,2,0,0,0
S01008334,All households,321,111,56,55,200,46,133,48,68,17,21,16,5,10,4,0,2,4
S01008334,Occupancy rating +2 or more,183,48,30,18,130,33,90,32,48,10,7,6,1,5,2,0,1,2
S01008334,Occupancy rating +1,101,55,22,33,44,10,29,13,11,5,5,3,2,2,1,0,0,1
S01008334,Occupancy rating 0,30,8,4,4,21,2,13,3,8,2,6,5,1,1,1,0,0,0
S01008334,Occupancy rating -1 or less,7,0,0,0,5,1,1,0,1,0,3,2,1,2,0,0,1,1
S01008335,All households,330,113,55,58,208,36,120,29,74,17,52,35,17,9,4,0,2,3
S01008335,Occupancy rating +2 or more,142,39,22,17,101,27,62,13,40,9,12,8,4,2,1,0,0,1
S01008335,Occupancy rating +1,73,32,12,20,39,6,25,13,11,1,8,6,2,2,0,0,0,2
S01008335,Occupancy rating 0,90,37,20,17,52,2,24,3,14,7,26,17,9,1,0,0,1,0
S01008335,Occupancy rating -1 or less,25,5,1,4,16,1,9,0,9,0,6,4,2,4,3,0,1,0
S01008336,All households,268,84,50,34,174,11,129,36,74,19,34,18,16,10,5,0,1,4
S01008336,Occupancy rating +2 or more,110,17,9,8,90,6,78,27,42,9,6,1,5,3,3,0,0,0
S01008336,Occupancy rating +1,66,29,9,20,35,4,20,7,9,4,11,6,5,2,1,0,1,0
S01008336,Occupancy rating 0,50,14,10,4,32,0,24,2,17,5,8,5,3,4,1,0,0,3
S01008336,Occupancy rating -1 or less,42,24,22,2,17,1,7,0,6,1,9,6,3,1,0,0,0,1
S01008337,All households,365,115,52,63,240,11,199,61,120,18,30,22,8,10,5,0,0,5
S01008337,Occupancy rating +2 or more,168,24,5,19,138,2,129,42,75,12,7,7,0,6,3,0,0,3
S01008337,Occupancy rating +1,82,33,13,20,49,1,41,16,24,1,7,6,1,0,0,0,0,0
S01008337,Occupancy rating 0,97,50,26,24,44,8,24,3,16,5,12,8,4,3,1,0,0,2
S01008337,Occupancy rating -1 or less,18,8,8,0,9,0,5,0,5,0,4,1,3,1,1,0,0,0
S01008338,All households,262,34,12,22,217,5,186,26,145,15,26,20,6,11,9,0,0,2
S01008338,Occupancy rating +2 or more,198,23,9,14,169,3,151,24,116,11,15,13,2,6,4,0,0,2
S01008338,Occupancy rating +1,39,10,2,8,28,0,20,1,16,3,8,4,4,1,1,0,0,0
S01008338,Occupancy rating 0,14,1,1,0,11,2,6,1,5,0,3,3,0,2,2,0,0,0
S01008338,Occupancy rating -1 or less,11,0,0,0,9,0,9,0,8,1,0,0,0,2,2,0,0,0
S01008339,All households,227,42,13,29,181,9,155,51,78,26,17,12,5,4,2,0,0,2
S01008339,Occupancy rating +2 or more,135,26,9,17,107,9,92,33,40,19,6,3,3,2,2,0,0,0
S01008339,Occupancy rating +1,57,13,3,10,43,0,42,17,22,3,1,1,0,1,0,0,0,1
S01008339,Occupancy rating 0,28,2,1,1,25,0,18,1,13,4,7,5,2,1,0,0,0,1
S01008339,Occupancy rating -1 or less,7,1,0,1,6,0,3,0,3,0,3,3,0,0,0,0,0,0
S01008340,All households,313,93,22,71,206,11,168,47,95,26,27,19,8,14,11,0,0,3
S01008340,Occupancy rating +2 or more,156,29,9,20,119,9,101,30,53,18,9,7,2,8,8,0,0,0
S01008340,Occupancy rating +1,77,37,6,31,40,1,33,12,19,2,6,4,2,0,0,0,0,0
S01008340,Occupancy rating 0,64,25,7,18,38,1,29,5,20,4,8,5,3,1,0,0,0,1
S01008340,Occupancy rating -1 or less,16,2,0,2,9,0,5,0,3,2,4,3,1,5,3,0,0,2
S01008341,All households,204,16,4,12,181,6,161,21,111,29,14,8,6,7,7,0,0,0
S01008341,Occupancy rating +2 or more,169,14,3,11,153,5,136,20,95,21,12,7,5,2,2,0,0,0
S01008341,Occupancy rating +1,28,1,0,1,25,1,23,1,15,7,1,0,1,2,2,0,0,0
S01008341,Occupancy rating 0,5,1,1,0,2,0,1,0,1,0,1,1,0,2,2,0,0,0
S01008341,Occupancy rating -1 or less,2,0,0,0,1,0,1,0,0,1,0,0,0,1,1,0,0,0
S01008342,All households,327,79,29,50,233,27,173,62,79,32,33,20,13,15,10,0,0,5
S01008342,Occupancy rating +2 or more,171,25,15,10,139,22,109,45,49,15,8,6,2,7,6,0,0,1
S01008342,Occupancy rating +1,63,16,5,11,45,3,35,11,16,8,7,5,2,2,2,0,0,0
S01008342,Occupancy rating 0,57,27,7,20,28,2,19,4,8,7,7,3,4,2,0,0,0,2
S01008342,Occupancy rating -1 or less,36,11,2,9,21,0,10,2,6,2,11,6,5,4,2,0,0,2
S01008343,All households,328,70,49,21,252,58,181,60,88,33,13,9,4,6,2,0,0,4
S01008343,Occupancy rating +2 or more,298,67,47,20,226,57,161,58,74,29,8,7,1,5,1,0,0,4
S01008343,Occupancy rating +1,25,3,2,1,21,1,15,2,10,3,5,2,3,1,1,0,0,0
S01008343,Occupancy rating 0,3,0,0,0,3,0,3,0,2,1,0,0,0,0,0,0,0,0
S01008343,Occupancy rating -1 or less,2,0,0,0,2,0,2,0,2,0,0,0,0,0,0,0,0,0
S01008344,All households,355,98,46,52,246,51,174,64,76,34,21,15,6,11,6,0,0,5
S01008344,Occupancy rating +2 or more,257,43,24,19,205,40,153,55,69,29,12,9,3,9,5,0,0,4
S01008344,Occupancy rating +1,74,47,19,28,27,11,11,9,1,1,5,4,1,0,0,0,0,0
S01008344,Occupancy rating 0,21,7,3,4,13,0,9,0,5,4,4,2,2,1,0,0,0,1
S01008344,Occupancy rating -1 or less,3,1,0,1,1,0,1,0,1,0,0,0,0,1,1,0,0,0
S01008345,All households,350,79,55,24,261,56,182,57,80,45,23,13,10,10,7,0,0,3
S01008345,Occupancy rating +2 or more,315,68,51,17,242,56,169,56,75,38,17,9,8,5,3,0,0,2
S01008345,Occupancy rating +1,18,6,2,4,10,0,6,0,2,4,4,3,1,2,1,0,0,1
S01008345,Occupancy rating 0,10,4,2,2,4,0,3,1,1,1,1,1,0,2,2,0,0,0
S01008345,Occupancy rating -1 or less,7,1,0,1,5,0,4,0,2,2,1,0,1,1,1,0,0,0
S01008346,All households,359,77,50,27,272,54,210,55,124,31,8,5,3,10,7,0,0,3
S01008346,Occupancy rating +2 or more,321,69,48,21,247,53,189,54,106,29,5,3,2,5,4,0,0,1
S01008346,Occupancy rating +1,25,8,2,6,16,1,13,1,12,0,2,1,1,1,1,0,0,0
S01008346,Occupancy rating 0,7,0,0,0,5,0,4,0,3,1,1,1,0,2,0,0,0,2
S01008346,Occupancy rating -1 or less,6,0,0,0,4,0,4,0,3,1,0,0,0,2,2,0,0,0
S01008347,All households,489,221,151,70,259,64,150,55,70,25,45,23,22,9,3,0,0,6
S01008347,Occupancy rating +2 or more,256,75,50,25,177,44,123,49,53,21,10,7,3,4,3,0,0,1
S01008347,Occupancy rating +1,106,52,33,19,53,15,21,6,12,3,17,5,12,1,0,0,0,1
S01008347,Occupancy rating 0,104,78,61,17,23,4,3,0,2,1,16,9,7,3,0,0,0,3
S01008347,Occupancy rating -1 or less,23,16,7,9,6,1,3,0,3,0,2,2,0,1,0,0,0,1
S01008348,All households,326,95,50,45,221,61,126,42,62,22,34,20,14,10,2,0,1,7
S01008348,Occupancy rating +2 or more,207,49,30,19,152,45,94,35,44,15,13,7,6,6,2,0,0,4
S01008348,Occupancy rating +1,75,32,16,16,41,15,17,5,8,4,9,7,2,2,0,0,0,2
S01008348,Occupancy rating 0,36,10,3,7,24,1,13,2,8,3,10,4,6,2,0,0,1,1
S01008348,Occupancy rating -1 or less,8,4,1,3,4,0,2,0,2,0,2,2,0,0,0,0,0,0
S01008349,All households,313,68,37,31,235,39,175,37,121,17,21,18,3,10,5,0,0,5
S01008349,Occupancy rating +2 or more,260,46,25,21,205,32,162,33,114,15,11,8,3,9,4,0,0,5
S01008349,Occupancy rating +1,39,22,12,10,17,6,8,4,2,2,3,3,0,0,0,0,0,0
S01008349,Occupancy rating 0,7,0,0,0,7,1,2,0,2,0,4,4,0,0,0,0,0,0
S01008349,Occupancy rating -1 or less,7,0,0,0,6,0,3,0,3,0,3,3,0,1,1,0,0,0
S01008350,All households,257,74,44,30,175,58,110,41,52,17,7,1,6,8,1,0,1,6
S01008350,Occupancy rating +2 or more,203,50,30,20,148,50,96,38,45,13,2,0,2,5,1,0,0,4
S01008350,Occupancy rating +1,36,15,13,2,19,8,9,2,5,2,2,0,2,2,0,0,1,1
S01008350,Occupancy rating 0,11,4,0,4,6,0,4,1,1,2,2,1,1,1,0,0,0,1
S01008350,Occupancy rating -1 or less,7,5,1,4,2,0,1,0,1,0,1,0,1,0,0,0,0,0
S01008351,All households,347,78,52,26,260,53,182,56,95,31,25,10,15,9,5,0,0,4
S01008351,Occupancy rating +2 or more,269,59,41,18,203,44,147,53,69,25,12,5,7,7,4,0,0,3
S01008351,Occupancy rating +1,53,10,7,3,43,7,29,3,20,6,7,2,5,0,0,0,0,0
S01008351,Occupancy rating 0,20,7,3,4,11,2,5,0,5,0,4,1,3,2,1,0,0,1
S01008351,Occupancy rating -1 or less,5,2,1,1,3,0,1,0,1,0,2,2,0,0,0,0,0,0
S01008352,All households,248,47,33,14,195,38,144,41,77,26,13,8,5,6,4,0,0,2
S01008352,Occupancy rating +2 or more,212,44,31,13,166,35,122,38,65,19,9,5,4,2,1,0,0,1
S01008352,Occupancy rating +1,22,2,1,1,19,3,13,3,5,5,3,2,1,1,1,0,0,0
S01008352,Occupancy rating 0,12,1,1,0,8,0,7,0,5,2,1,1,0,3,2,0,0,1
S01008352,Occupancy rating -1 or less,2,0,0,0,2,0,2,0,2,0,0,0,0,0,0,0,0,0
S01008353,All households,198,47,28,19,143,30,105,23,67,15,8,7,1,8,2,1,1,4
S01008353,Occupancy rating +2 or more,154,33,22,11,117,24,90,20,58,12,3,2,1,4,2,0,0,2
S01008353,Occupancy rating +1,25,11,5,6,14,4,9,3,4,2,1,1,0,0,0,0,0,0
S01008353,Occupancy rating 0,12,2,1,1,7,2,2,0,1,1,3,3,0,3,0,0,1,2
S01008353,Occupancy rating -1 or less,7,1,0,1,5,0,4,0,4,0,1,1,0,1,0,1,0,0
S01008354,All households,286,88,47,41,189,29,140,46,76,18,20,12,8,9,4,0,0,5
S01008354,Occupancy rating +2 or more,186,37,17,20,141,22,109,39,57,13,10,5,5,8,3,0,0,5
S01008354,Occupancy rating +1,44,20,8,12,24,6,14,5,6,3,4,3,1,0,0,0,0,0
S01008354,Occupancy rating 0,39,19,12,7,19,1,13,2,9,2,5,3,2,1,1,0,0,0
S01008354,Occupancy rating -1 or less,17,12,10,2,5,0,4,0,4,0,1,1,0,0,0,0,0,0
S01008355,All households,299,108,61,47,182,27,108,41,48,19,47,25,22,9,4,0,1,4
S01008355,Occupancy rating +2 or more,113,30,17,13,80,21,49,23,18,8,10,4,6,3,1,0,1,1
S01008355,Occupancy rating +1,76,26,8,18,50,3,36,14,17,5,11,6,5,0,0,0,0,0
S01008355,Occupancy rating 0,82,38,27,11,40,3,16,3,9,4,21,14,7,4,2,0,0,2
S01008355,Occupancy rating -1 or less,28,14,9,5,12,0,7,1,4,2,5,1,4,2,1,0,0,1
S01008356,All households,259,85,28,57,170,12,127,56,60,11,31,24,7,4,1,0,0,3
S01008356,Occupancy rating +2 or more,106,29,13,16,75,10,59,35,20,4,6,5,1,2,1,0,0,1
S01008356,Occupancy rating +1,78,36,9,27,40,2,32,18,13,1,6,4,2,2,0,0,0,2
S01008356,Occupancy rating 0,58,14,4,10,44,0,30,2,24,4,14,12,2,0,0,0,0,0
S01008356,Occupancy rating -1 or less,17,6,2,4,11,0,6,1,3,2,5,3,2,0,0,0,0,0
S01008357,All households,296,83,41,42,204,41,137,42,76,19,26,15,11,9,3,0,0,6
S01008357,Occupancy rating +2 or more,166,35,25,10,125,34,86,30,45,11,5,3,2,6,1,0,0,5
S01008357,Occupancy rating +1,65,27,10,17,37,3,31,9,18,4,3,1,2,1,1,0,0,0
S01008357,Occupancy rating 0,55,20,5,15,33,3,16,2,11,3,14,8,6,2,1,0,0,1
S01008357,Occupancy rating -1 or less,10,1,1,0,9,1,4,1,2,1,4,3,1,0,0,0,0,0
S01008358,All households,346,144,79,65,195,43,109,44,39,26,43,29,14,7,5,0,0,2
S01008358,Occupancy rating +2 or more,115,33,18,15,79,17,61,29,20,12,1,1,0,3,2,0,0,1
S01008358,Occupancy rating +1,110,52,28,24,57,20,26,14,6,6,11,4,7,1,0,0,0,1
S01008358,Occupancy rating 0,88,36,20,16,49,5,16,1,9,6,28,21,7,3,3,0,0,0
S01008358,Occupancy rating -1 or less,33,23,13,10,10,1,6,0,4,2,3,3,0,0,0,0,0,0
S01008359,All households,250,63,31,32,180,31,129,39,71,19,20,11,9,7,5,0,0,2
S01008359,Occupancy rating +2 or more,141,28,20,8,109,25,80,30,34,16,4,1,3,4,4,0,0,0
S01008359,Occupancy rating +1,73,29,8,21,43,6,31,8,21,2,6,3,3,1,0,0,0,1
S01008359,Occupancy rating 0,28,2,1,1,25,0,17,1,15,1,8,5,3,1,0,0,0,1
S01008359,Occupancy rating -1 or less,8,4,2,2,3,0,1,0,1,0,2,2,0,1,1,0,0,0
S01008360,All households,319,48,26,22,262,49,176,54,83,39,37,20,17,9,4,1,1,3
S01008360,Occupancy rating +2 or more,222,28,18,10,191,43,130,46,59,25,18,8,10,3,2,0,0,1
S01008360,Occupancy rating +1,71,20,8,12,48,4,33,8,17,8,11,8,3,3,0,0,1,2
S01008360,Occupancy rating 0,21,0,0,0,19,2,10,0,4,6,7,4,3,2,1,1,0,0
S01008360,Occupancy rating -1 or less,5,0,0,0,4,0,3,0,3,0,1,0,1,1,1,0,0,0
S01008361,All households,201,35,20,15,163,18,123,44,53,26,22,17,5,3,1,0,0,2
S01008361,Occupancy rating +2 or more,119,24,15,9,93,15,75,33,26,16,3,2,1,2,0,0,0,2
S01008361,Occupancy rating +1,50,9,4,5,41,2,30,11,15,4,9,6,3,0,0,0,0,0
S01008361,Occupancy rating 0,26,2,1,1,23,1,12,0,9,3,10,9,1,1,1,0,0,0
S01008361,Occupancy rating -1 or less,6,0,0,0,6,0,6,0,3,3,0,0,0,0,0,0,0,0
S01008362,All households,409,151,49,102,253,19,180,49,111,20,54,37,17,5,3,0,0,2
S01008362,Occupancy rating +2 or more,153,37,11,26,115,6,100,26,62,12,9,9,0,1,1,0,0,0
S01008362,Occupancy rating +1,110,54,15,39,56,7,40,14,21,5,9,5,4,0,0,0,0,0
S01008362,Occupancy rating 0,107,46,15,31,58,3,33,7,23,3,22,14,8,3,1,0,0,2
S01008362,Occupancy rating -1 or less,39,14,8,6,24,3,7,2,5,0,14,9,5,1,1,0,0,0
S01008363,All households,320,104,31,73,211,36,143,47,66,30,32,24,8,5,2,0,0,3
S01008363,Occupancy rating +2 or more,177,32,15,17,142,34,99,35,43,21,9,5,4,3,2,0,0,1
S01008363,Occupancy rating +1,50,22,6,16,28,1,21,8,6,7,6,4,2,0,0,0,0,0
S01008363,Occupancy rating 0,49,15,7,8,32,1,18,3,13,2,13,13,0,2,0,0,0,2
S01008363,Occupancy rating -1 or less,44,35,3,32,9,0,5,1,4,0,4,2,2,0,0,0,0,0
S01008364,All households,322,97,41,56,218,43,136,46,65,25,39,27,12,7,4,0,0,3
S01008364,Occupancy rating +2 or more,196,41,24,17,149,36,101,39,44,18,12,7,5,6,3,0,0,3
S01008364,Occupancy rating +1,75,36,14,22,38,7,23,5,12,6,8,4,4,1,1,0,0,0
S01008364,Occupancy rating 0,39,19,2,17,20,0,9,2,6,1,11,9,2,0,0,0,0,0
S01008364,Occupancy rating -1 or less,12,1,1,0,11,0,3,0,3,0,8,7,1,0,0,0,0,0
S01008365,All households,288,81,47,34,201,39,149,67,64,18,13,8,5,6,3,0,0,3
S01008365,Occupancy rating +2 or more,224,55,35,20,167,34,128,60,55,13,5,3,2,2,1,0,0,1
S01008365,Occupancy rating +1,42,23,10,13,16,5,9,4,1,4,2,0,2,3,2,0,0,1
S01008365,Occupancy rating 0,21,3,2,1,17,0,11,2,8,1,6,5,1,1,0,0,0,1
S01008365,Occupancy rating -1 or less,1,0,0,0,1,0,1,1,0,0,0,0,0,0,0,0,0,0
S01008366,All households,424,180,109,71,241,37,144,42,79,23,60,35,25,3,2,0,0,1
S01008366,Occupancy rating +2 or more,132,50,19,31,82,18,56,19,27,10,8,4,4,0,0,0,0,0
S01008366,Occupancy rating +1,152,70,42,28,80,12,49,19,24,6,19,10,9,2,1,0,0,1
S01008366,Occupancy rating 0,107,48,40,8,58,7,27,4,18,5,24,16,8,1,1,0,0,0
S01008366,Occupancy rating -1 or less,33,12,8,4,21,0,12,0,10,2,9,5,4,0,0,0,0,0
S01008367,All households,368,172,65,107,183,18,113,39,51,23,52,23,29,13,4,0,1,8
S01008367,Occupancy rating +2 or more,87,33,11,22,51,8,39,17,17,5,4,2,2,3,1,0,0,2
S01008367,Occupancy rating +1,105,51,11,40,53,7,38,16,15,7,8,4,4,1,0,0,0,1
S01008367,Occupancy rating 0,136,68,36,32,64,3,30,5,14,11,31,10,21,4,0,0,0,4
S01008367,Occupancy rating -1 or less,40,20,7,13,15,0,6,1,5,0,9,7,2,5,3,0,1,1
S01008368,All households,311,126,48,78,178,25,126,48,62,16,27,21,6,7,3,0,0,4
S01008368,Occupancy rating +2 or more,111,44,16,28,66,16,49,23,20,6,1,1,0,1,1,0,0,0
S01008368,Occupancy rating +1,132,74,25,49,57,7,41,24,12,5,9,7,2,1,0,0,0,1
S01008368,Occupancy rating 0,53,8,7,1,43,1,29,1,23,5,13,12,1,2,0,0,0,2
S01008368,Occupancy rating -1 or less,15,0,0,0,12,1,7,0,7,0,4,1,3,3,2,0,0,1
S01008369,All households,235,74,37,37,156,16,99,35,53,11,41,19,22,5,1,0,1,3
S01008369,Occupancy rating +2 or more,101,28,13,15,70,12,52,24,23,5,6,3,3,3,1,0,0,2
S01008369,Occupancy rating +1,68,32,16,16,35,4,23,10,11,2,8,1,7,1,0,0,1,0
S01008369,Occupancy rating 0,55,12,7,5,42,0,21,1,17,3,21,12,9,1,0,0,0,1
S01008369,Occupancy rating -1 or less,11,2,1,1,9,0,3,0,2,1,6,3,3,0,0,0,0,0
S01008370,All households,300,107,46,61,189,27,132,46,70,16,30,16,14,4,2,0,0,2
S01008370,Occupancy rating +2 or more,123,25,12,13,97,22,74,22,42,10,1,0,1,1,1,0,0,0
S01008370,Occupancy rating +1,104,58,24,34,46,4,37,16,18,3,5,2,3,0,0,0,0,0
S01008370,Occupancy rating 0,52,16,5,11,33,0,14,6,7,1,19,10,9,3,1,0,0,2
S01008370,Occupancy rating -1 or less,21,8,5,3,13,1,7,2,3,2,5,4,1,0,0,0,0,0
S01008371,All households,302,65,32,33,235,34,173,48,95,30,28,23,5,2,1,0,0,1
S01008371,Occupancy rating +2 or more,189,33,21,12,156,28,121,41,57,23,7,5,2,0,0,0,0,0
S01008371,Occupancy rating +1,74,29,9,20,43,6,28,6,18,4,9,8,1,2,1,0,0,1
S01008371,Occupancy rating 0,32,2,1,1,30,0,20,0,17,3,10,8,2,0,0,0,0,0
S01008371,Occupancy rating -1 or less,7,1,1,0,6,0,4,1,3,0,2,2,0,0,0,0,0,0
S01008372,All households,288,57,21,36,226,31,162,34,93,35,33,14,19,5,3,0,0,2
S01008372,Occupancy rating +2 or more,153,34,13,21,118,25,81,25,41,15,12,3,9,1,0,0,0,1
S01008372,Occupancy rating +1,85,21,7,14,63,5,46,9,24,13,12,6,6,1,1,0,0,0
S01008372,Occupancy rating 0,40,2,1,1,37,0,28,0,22,6,9,5,4,1,0,0,0,1
S01008372,Occupancy rating -1 or less,10,0,0,0,8,1,7,0,6,1,0,0,0,2,2,0,0,0
S01008373,All households,269,36,23,13,228,25,183,42,109,32,20,9,11,5,2,0,0,3
S01008373,Occupancy rating +2 or more,181,26,17,9,154,24,123,34,71,18,7,2,5,1,0,0,0,1
S01008373,Occupancy rating +1,58,9,6,3,46,1,38,8,22,8,7,2,5,3,1,0,0,2
S01008373,Occupancy rating 0,22,0,0,0,21,0,16,0,13,3,5,4,1,1,1,0,0,0
S01008373,Occupancy rating -1 or less,8,1,0,1,7,0,6,0,3,3,1,1,0,0,0,0,0,0
S01008374,All households,264,46,31,15,212,31,157,45,73,39,24,14,10,6,4,0,2,0
S01008374,Occupancy rating +2 or more,166,25,21,4,141,26,107,42,41,24,8,4,4,0,0,0,0,0
S01008374,Occupancy rating +1,64,16,9,7,47,4,36,2,23,11,7,3,4,1,1,0,0,0
S01008374,Occupancy rating 0,30,4,1,3,22,1,14,1,9,4,7,5,2,4,2,0,2,0
S01008374,Occupancy rating -1 or less,4,1,0,1,2,0,0,0,0,0,2,2,0,1,1,0,0,0
S01008375,All households,285,46,31,15,236,42,171,45,90,36,23,13,10,3,2,0,0,1
S01008375,Occupancy rating +2 or more,218,38,28,10,178,38,127,38,66,23,13,7,6,2,2,0,0,0
S01008375,Occupancy rating +1,54,7,2,5,47,2,37,7,20,10,8,5,3,0,0,0,0,0
S01008375,Occupancy rating 0,10,0,0,0,9,2,5,0,3,2,2,1,1,1,0,0,0,1
S01008375,Occupancy rating -1 or less,3,1,1,0,2,0,2,0,1,1,0,0,0,0,0,0,0,0
S01008376,All households,212,57,21,36,152,22,108,28,60,20,22,12,10,3,3,0,0,0
S01008376,Occupancy rating +2 or more,113,22,11,11,89,15,70,21,36,13,4,1,3,2,2,0,0,0
S01008376,Occupancy rating +1,49,15,6,9,34,5,24,5,15,4,5,3,2,0,0,0,0,0
S01008376,Occupancy rating 0,35,17,4,13,17,0,8,1,5,2,9,6,3,1,1,0,0,0
S01008376,Occupancy rating -1 or less,15,3,0,3,12,2,6,1,4,1,4,2,2,0,0,0,0,0
S01008377,All households,291,81,33,48,198,22,151,37,84,30,25,13,12,12,4,0,1,7
S01008377,Occupancy rating +2 or more,172,35,16,19,131,17,104,29,53,22,10,4,6,6,2,0,1,3
S01008377,Occupancy rating +1,66,25,13,12,37,4,28,3,19,6,5,3,2,4,1,0,0,3
S01008377,Occupancy rating 0,44,15,4,11,28,1,17,5,10,2,10,6,4,1,0,0,0,1
S01008377,Occupancy rating -1 or less,9,6,0,6,2,0,2,0,2,0,0,0,0,1,1,0,0,0
S01008378,All households,421,133,101,32,280,44,199,48,115,36,37,20,17,8,2,0,4,2
S01008378,Occupancy rating +2 or more,235,46,36,10,184,31,139,41,78,20,14,9,5,5,2,0,2,1
S01008378,Occupancy rating +1,89,31,20,11,57,5,39,5,21,13,13,5,8,1,0,0,0,1
S01008378,Occupancy rating 0,80,48,38,10,30,7,14,2,10,2,9,5,4,2,0,0,2,0
S01008378,Occupancy rating -1 or less,17,8,7,1,9,1,7,0,6,1,1,1,0,0,0,0,0,0
S01008379,All households,206,45,33,12,154,35,107,35,45,27,12,10,2,7,0,0,2,5
S01008379,Occupancy rating +2 or more,158,35,25,10,119,34,82,35,28,19,3,2,1,4,0,0,0,4
S01008379,Occupancy rating +1,30,8,6,2,20,1,13,0,7,6,6,5,1,2,0,0,2,0
S01008379,Occupancy rating 0,13,2,2,0,11,0,8,0,7,1,3,3,0,0,0,0,0,0
S01008379,Occupancy rating -1 or less,5,0,0,0,4,0,4,0,3,1,0,0,0,1,0,0,0,1
S01008380,All households,238,44,25,19,190,18,153,42,82,29,19,8,11,4,2,0,0,2
S01008380,Occupancy rating +2 or more,196,37,23,14,158,18,127,40,65,22,13,5,8,1,0,0,0,1
S01008380,Occupancy rating +1,32,5,0,5,26,0,21,2,14,5,5,2,3,1,1,0,0,0
S01008380,Occupancy rating 0,8,2,2,0,4,0,4,0,3,1,0,0,0,2,1,0,0,1
S01008380,Occupancy rating -1 or less,2,0,0,0,2,0,1,0,0,1,1,1,0,0,0,0,0,0
S01008381,All households,229,37,17,20,185,13,158,38,91,29,14,8,6,7,4,0,0,3
S01008381,Occupancy rating +2 or more,181,33,16,17,145,12,125,38,65,22,8,4,4,3,1,0,0,2
S01008381,Occupancy rating +1,41,4,1,3,34,1,27,0,22,5,6,4,2,3,2,0,0,1
S01008381,Occupancy rating 0,7,0,0,0,6,0,6,0,4,2,0,0,0,1,1,0,0,0
S01008381,Occupancy rating -1 or less,0,0,0,0,0,0,0,0,0,0,0,0,0,0,0,0,0,0
S01008382,All households,248,55,37,18,187,31,146,42,83,21,10,7,3,6,2,0,0,4
S01008382,Occupancy rating +2 or more,189,43,33,10,144,27,111,40,59,12,6,4,2,2,1,0,0,1
S01008382,Occupancy rating +1,47,12,4,8,31,4,24,2,16,6,3,2,1,4,1,0,0,3
S01008382,Occupancy rating 0,7,0,0,0,7,0,6,0,5,1,1,1,0,0,0,0,0,0
S01008382,Occupancy rating -1 or less,5,0,0,0,5,0,5,0,3,2,0,0,0,0,0,0,0,0
S01008383,All households,181,43,25,18,134,18,109,27,63,19,7,4,3,4,2,0,0,2
S01008383,Occupancy rating +2 or more,135,27,19,8,106,18,86,25,46,15,2,0,2,2,2,0,0,0
S01008383,Occupancy rating +1,29,11,2,9,18,0,17,1,12,4,1,1,0,0,0,0,0,0
S01008383,Occupancy rating 0,15,5,4,1,8,0,5,1,4,0,3,3,0,2,0,0,0,2
S01008383,Occupancy rating -1 or less,2,0,0,0,2,0,1,0,1,0,1,0,1,0,0,0,0,0
S01008384,All households,387,87,42,45,288,40,193,64,101,28,55,34,21,12,5,0,1,6
S01008384,Occupancy rating +2 or more,185,46,24,22,137,26,100,41,48,11,11,6,5,2,1,0,0,1
S01008384,Occupancy rating +1,118,38,16,22,76,12,51,21,24,6,13,8,5,4,1,0,0,3
S01008384,Occupancy rating 0,61,3,2,1,53,1,32,1,24,7,20,12,8,5,2,0,1,2
S01008384,Occupancy rating -1 or less,23,0,0,0,22,1,10,1,5,4,11,8,3,1,1,0,0,0
S01008385,All households,252,47,31,16,195,37,145,48,70,27,13,5,8,10,6,0,0,4
S01008385,Occupancy rating +2 or more,203,34,24,10,161,36,119,44,55,20,6,3,3,8,5,0,0,3
S01008385,Occupancy rating +1,40,11,7,4,28,1,21,3,12,6,6,2,4,1,1,0,0,0
S01008385,Occupancy rating 0,5,2,0,2,3,0,2,0,2,0,1,0,1,0,0,0,0,0
S01008385,Occupancy rating -1 or less,4,0,0,0,3,0,3,1,1,1,0,0,0,1,0,0,0,1
S01008386,All households,337,87,36,51,244,28,174,62,75,37,42,29,13,6,2,0,0,4
S01008386,Occupancy rating +2 or more,106,29,12,17,76,12,59,28,23,8,5,3,2,1,1,0,0,0
S01008386,Occupancy rating +1,143,51,21,30,89,15,62,31,19,12,12,8,4,3,1,0,0,2
S01008386,Occupancy rating 0,69,3,2,1,64,1,42,2,25,15,21,16,5,2,0,0,0,2
S01008386,Occupancy rating -1 or less,19,4,1,3,15,0,11,1,8,2,4,2,2,0,0,0,0,0
S01008387,All households,241,50,20,30,189,24,144,46,83,15,21,11,10,2,2,0,0,0
S01008387,Occupancy rating +2 or more,76,17,9,8,58,11,45,15,24,6,2,1,1,1,1,0,0,0
S01008387,Occupancy rating +1,103,30,10,20,73,10,57,30,21,6,6,1,5,0,0,0,0,0
S01008387,Occupancy rating 0,45,1,1,0,44,2,31,1,27,3,11,8,3,0,0,0,0,0
S01008387,Occupancy rating -1 or less,17,2,0,2,14,1,11,0,11,0,2,1,1,1,1,0,0,0
S01008388,All households,243,49,10,39,191,10,153,46,84,23,28,25,3,3,2,0,0,1
S01008388,Occupancy rating +2 or more,74,19,2,17,54,5,47,17,22,8,2,2,0,1,1,0,0,0
S01008388,Occupancy rating +1,87,26,7,19,60,5,54,28,18,8,1,1,0,1,1,0,0,0
S01008388,Occupancy rating 0,68,1,0,1,66,0,43,1,35,7,23,20,3,1,0,0,0,1
S01008388,Occupancy rating -1 or less,14,3,1,2,11,0,9,0,9,0,2,2,0,0,0,0,0,0
S01008389,All households,312,134,104,30,171,65,89,35,35,19,17,8,9,7,1,0,3,3
S01008389,Occupancy rating +2 or more,164,50,41,9,112,38,68,29,24,15,6,1,5,2,0,0,0,2
S01008389,Occupancy rating +1,101,58,38,20,42,22,16,5,9,2,4,3,1,1,0,0,0,1
S01008389,Occupancy rating 0,35,19,19,0,12,3,4,0,2,2,5,2,3,4,1,0,3,0
S01008389,Occupancy rating -1 or less,12,7,6,1,5,2,1,1,0,0,2,2,0,0,0,0,0,0
S01008390,All households,255,66,40,26,186,37,140,45,66,29,9,4,5,3,2,0,0,1
S01008390,Occupancy rating +2 or more,214,56,34,22,156,35,116,43,52,21,5,1,4,2,1,0,0,1
S01008390,Occupancy rating +1,27,8,5,3,18,1,15,2,8,5,2,1,1,1,1,0,0,0
S01008390,Occupancy rating 0,13,2,1,1,11,1,8,0,5,3,2,2,0,0,0,0,0,0
S01008390,Occupancy rating -1 or less,1,0,0,0,1,0,1,0,1,0,0,0,0,0,0,0,0,0
S01008391,All households,349,139,103,36,206,48,139,36,78,25,19,14,5,4,1,0,1,2
S01008391,Occupancy rating +2 or more,186,46,26,20,139,29,103,28,60,15,7,6,1,1,0,0,0,1
S01008391,Occupancy rating +1,84,39,28,11,44,15,26,7,12,7,3,2,1,1,1,0,0,0
S01008391,Occupancy rating 0,56,39,34,5,15,4,7,1,5,1,4,3,1,2,0,0,1,1
S01008391,Occupancy rating -1 or less,23,15,15,0,8,0,3,0,1,2,5,3,2,0,0,0,0,0
S01008392,All households,330,73,29,44,252,24,207,49,125,33,21,11,10,5,4,0,0,1
S01008392,Occupancy rating +2 or more,227,31,13,18,195,19,163,45,99,19,13,7,6,1,0,0,0,1
S01008392,Occupancy rating +1,60,21,10,11,36,5,28,3,16,9,3,1,2,3,3,0,0,0
S01008392,Occupancy rating 0,38,21,6,15,16,0,12,0,8,4,4,2,2,1,1,0,0,0
S01008392,Occupancy rating -1 or less,5,0,0,0,5,0,4,1,2,1,1,1,0,0,0,0,0,0
S01008393,All households,369,145,96,49,215,45,153,38,94,21,17,10,7,9,4,0,2,3
S01008393,Occupancy rating +2 or more,227,55,38,17,168,33,129,33,79,17,6,4,2,4,2,0,1,1
S01008393,Occupancy rating +1,92,61,36,25,30,7,17,4,10,3,6,2,4,1,0,0,0,1
S01008393,Occupancy rating 0,43,28,22,6,12,4,6,1,4,1,2,1,1,3,2,0,1,0
S01008393,Occupancy rating -1 or less,7,1,0,1,5,1,1,0,1,0,3,3,0,1,0,0,0,1
S01008394,All households,276,38,17,21,231,27,186,35,125,26,18,13,5,7,3,0,1,3
S01008394,Occupancy rating +2 or more,223,30,14,16,190,27,155,35,98,22,8,6,2,3,0,0,1,2
S01008394,Occupancy rating +1,39,7,2,5,30,0,26,0,23,3,4,2,2,2,1,0,0,1
S01008394,Occupancy rating 0,11,1,1,0,10,0,5,0,4,1,5,4,1,0,0,0,0,0
S01008394,Occupancy rating -1 or less,3,0,0,0,1,0,0,0,0,0,1,1,0,2,2,0,0,0
S01008395,All households,189,34,17,17,149,8,122,37,62,23,19,12,7,6,2,0,1,3
S01008395,Occupancy rating +2 or more,98,12,8,4,84,7,72,23,36,13,5,3,2,2,1,0,0,1
S01008395,Occupancy rating +1,58,19,8,11,38,1,31,13,11,7,6,3,3,1,0,0,0,1
S01008395,Occupancy rating 0,28,3,1,2,23,0,16,1,12,3,7,5,2,2,0,0,1,1
S01008395,Occupancy rating -1 or less,5,0,0,0,4,0,3,0,3,0,1,1,0,1,1,0,0,0
S01008396,All households,303,122,79,43,177,53,108,36,45,27,16,2,14,4,2,0,1,1
S01008396,Occupancy rating +2 or more,138,48,26,22,90,28,56,26,17,13,6,2,4,0,0,0,0,0
S01008396,Occupancy rating +1,122,58,44,14,63,22,34,8,17,9,7,0,7,1,0,0,0,1
S01008396,Occupancy rating 0,31,15,9,6,13,2,11,1,5,5,0,0,0,3,2,0,1,0
S01008396,Occupancy rating -1 or less,12,1,0,1,11,1,7,1,6,0,3,0,3,0,0,0,0,0
S01008397,All households,346,64,40,24,266,36,207,70,96,41,23,12,11,16,11,0,0,5
S01008397,Occupancy rating +2 or more,266,46,30,16,213,33,169,66,74,29,11,3,8,7,4,0,0,3
S01008397,Occupancy rating +1,55,14,7,7,36,3,27,4,13,10,6,6,0,5,4,0,0,1
S01008397,Occupancy rating 0,18,3,2,1,11,0,6,0,5,1,5,2,3,4,3,0,0,1
S01008397,Occupancy rating -1 or less,7,1,1,0,6,0,5,0,4,1,1,1,0,0,0,0,0,0
S01008398,All households,238,59,45,14,171,30,123,44,60,19,18,10,8,8,4,0,2,2
S01008398,Occupancy rating +2 or more,154,31,21,10,118,22,87,37,40,10,9,3,6,5,3,0,0,2
S01008398,Occupancy rating +1,37,6,3,3,29,5,20,7,11,2,4,2,2,2,0,0,2,0
S01008398,Occupancy rating 0,37,19,18,1,17,2,11,0,6,5,4,4,0,1,1,0,0,0
S01008398,Occupancy rating -1 or less,10,3,3,0,7,1,5,0,3,2,1,1,0,0,0,0,0,0
S01008399,All households,257,104,69,35,147,36,101,42,42,17,10,1,9,6,0,0,1,5
S01008399,Occupancy rating +2 or more,184,80,56,24,100,30,69,36,22,11,1,0,1,4,0,0,0,4
S01008399,Occupancy rating +1,57,18,11,7,38,6,23,5,15,3,9,1,8,1,0,0,0,1
S01008399,Occupancy rating 0,12,5,1,4,7,0,7,0,4,3,0,0,0,0,0,0,0,0
S01008399,Occupancy rating -1 or less,4,1,1,0,2,0,2,1,1,0,0,0,0,1,0,0,1,0
S01008400,All households,261,65,41,24,187,33,134,39,71,24,20,15,5,9,5,0,1,3
S01008400,Occupancy rating +2 or more,194,58,36,22,131,26,97,33,47,17,8,6,2,5,2,0,0,3
S01008400,Occupancy rating +1,44,7,5,2,37,6,24,3,17,4,7,5,2,0,0,0,0,0
S01008400,Occupancy rating 0,18,0,0,0,16,1,11,3,5,3,4,3,1,2,1,0,1,0
S01008400,Occupancy rating -1 or less,5,0,0,0,3,0,2,0,2,0,1,1,0,2,2,0,0,0
S01008401,All households,404,132,85,47,254,55,175,59,83,33,24,13,11,18,10,0,0,8
S01008401,Occupancy rating +2 or more,239,64,36,28,167,42,117,47,50,20,8,4,4,8,2,0,0,6
S01008401,Occupancy rating +1,96,35,23,12,58,10,39,9,21,9,9,4,5,3,2,0,0,1
S01008401,Occupancy rating 0,52,29,22,7,18,2,13,2,8,3,3,2,1,5,4,0,0,1
S01008401,Occupancy rating -1 or less,17,4,4,0,11,1,6,1,4,1,4,3,1,2,2,0,0,0
S01008402,All households,415,83,55,28,317,76,227,75,104,48,14,4,10,15,8,0,3,4
S01008402,Occupancy rating +2 or more,357,68,49,19,281,70,201,70,91,40,10,4,6,8,5,0,1,2
S01008402,Occupancy rating +1,40,9,4,5,26,6,18,3,10,5,2,0,2,5,3,0,1,1
S01008402,Occupancy rating 0,11,5,1,4,6,0,4,1,1,2,2,0,2,0,0,0,0,0
S01008402,Occupancy rating -1 or less,7,1,1,0,4,0,4,1,2,1,0,0,0,2,0,0,1,1
S01008403,All households,218,41,26,15,174,33,130,30,76,24,11,5,6,3,2,0,0,1
S01008403,Occupancy rating +2 or more,171,32,23,9,137,30,104,30,57,17,3,1,2,2,1,0,0,1
S01008403,Occupancy rating +1,34,6,2,4,28,3,19,0,15,4,6,3,3,0,0,0,0,0
S01008403,Occupancy rating 0,9,3,1,2,6,0,5,0,2,3,1,0,1,0,0,0,0,0
S01008403,Occupancy rating -1 or less,4,0,0,0,3,0,2,0,2,0,1,1,0,1,1,0,0,0
S01008404,All households,349,89,70,19,255,44,196,56,104,36,15,10,5,5,1,0,0,4
S01008404,Occupancy rating +2 or more,240,41,33,8,195,34,154,52,75,27,7,5,2,4,1,0,0,3
S01008404,Occupancy rating +1,82,40,31,9,41,9,30,3,21,6,2,1,1,1,0,0,0,1
S01008404,Occupancy rating 0,18,6,4,2,12,1,7,0,6,1,4,2,2,0,0,0,0,0
S01008404,Occupancy rating -1 or less,9,2,2,0,7,0,5,1,2,2,2,2,0,0,0,0,0,0
S01008405,All households,266,41,27,14,217,26,171,54,86,31,20,9,11,8,6,0,1,1
S01008405,Occupancy rating +2 or more,225,30,22,8,189,23,152,51,74,27,14,6,8,6,4,0,1,1
S01008405,Occupancy rating +1,31,10,5,5,20,3,13,3,7,3,4,2,2,1,1,0,0,0
S01008405,Occupancy rating 0,8,1,0,1,6,0,5,0,4,1,1,1,0,1,1,0,0,0
S01008405,Occupancy rating -1 or less,2,0,0,0,2,0,1,0,1,0,1,0,1,0,0,0,0,0
S01008406,All households,451,216,158,58,219,39,159,46,81,32,21,11,10,16,8,0,2,6
S01008406,Occupancy rating +2 or more,203,37,21,16,160,24,126,41,58,27,10,4,6,6,2,0,0,4
S01008406,Occupancy rating +1,65,34,16,18,25,6,17,1,15,1,2,1,1,6,4,0,1,1
S01008406,Occupancy rating 0,139,112,96,16,24,8,12,4,6,2,4,2,2,3,2,0,0,1
S01008406,Occupancy rating -1 or less,44,33,25,8,10,1,4,0,2,2,5,4,1,1,0,0,1,0
S01008407,All households,284,157,93,64,113,20,74,32,31,11,19,10,9,14,6,0,1,7
S01008407,Occupancy rating +2 or more,97,42,29,13,53,14,36,17,15,4,3,1,2,2,2,0,0,0
S01008407,Occupancy rating +1,75,36,13,23,34,3,23,11,8,4,8,4,4,5,1,0,1,3
S01008407,Occupancy rating 0,81,53,30,23,21,1,13,4,7,2,7,4,3,7,3,0,0,4
S01008407,Occupancy rating -1 or less,31,26,21,5,5,2,2,0,1,1,1,1,0,0,0,0,0,0
S01008408,All households,265,77,37,40,185,12,143,40,79,24,30,22,8,3,2,0,0,1
S01008408,Occupancy rating +2 or more,104,25,16,9,78,8,61,20,33,8,9,5,4,1,1,0,0,0
S01008408,Occupancy rating +1,83,19,11,8,64,3,53,16,31,6,8,5,3,0,0,0,0,0
S01008408,Occupancy rating 0,50,20,8,12,29,0,23,4,11,8,6,6,0,1,1,0,0,0
S01008408,Occupancy rating -1 or less,28,13,2,11,14,1,6,0,4,2,7,6,1,1,0,0,0,1
S01008409,All households,390,164,71,93,212,25,141,50,57,34,46,35,11,14,7,0,3,4
S01008409,Occupancy rating +2 or more,124,41,17,24,80,16,59,26,20,13,5,1,4,3,0,0,1,2
S01008409,Occupancy rating +1,122,54,19,35,66,6,45,22,15,8,15,13,2,2,2,0,0,0
S01008409,Occupancy rating 0,90,38,11,27,49,3,29,2,15,12,17,14,3,3,1,0,2,0
S01008409,Occupancy rating -1 or less,54,31,24,7,17,0,8,0,7,1,9,7,2,6,4,0,0,2
S01008410,All households,269,113,74,39,146,26,98,36,39,23,22,12,10,10,4,1,2,3
S01008410,Occupancy rating +2 or more,116,32,17,15,79,17,58,24,23,11,4,2,2,5,3,1,0,1
S01008410,Occupancy rating +1,81,45,24,21,32,1,26,11,8,7,5,3,2,4,1,0,2,1
S01008410,Occupancy rating 0,57,30,27,3,26,3,12,1,7,4,11,6,5,1,0,0,0,1
S01008410,Occupancy rating -1 or less,15,6,6,0,9,5,2,0,1,1,2,1,1,0,0,0,0,0
S01008411,All households,247,70,28,42,163,25,115,43,51,21,23,12,11,14,7,1,1,5
S01008411,Occupancy rating +2 or more,104,17,10,7,83,15,64,29,28,7,4,2,2,4,2,1,0,1
S01008411,Occupancy rating +1,85,40,14,26,42,10,26,11,8,7,6,3,3,3,1,0,1,1
S01008411,Occupancy rating 0,38,10,3,7,26,0,17,2,11,4,9,7,2,2,1,0,0,1
S01008411,Occupancy rating -1 or less,20,3,1,2,12,0,8,1,4,3,4,0,4,5,3,0,0,2
S01008412,All households,274,85,34,51,176,29,118,26,72,20,29,21,8,13,5,0,0,8
S01008412,Occupancy rating +2 or more,135,32,17,15,98,24,71,18,42,11,3,2,1,5,2,0,0,3
S01008412,Occupancy rating +1,79,37,13,24,38,5,26,7,14,5,7,4,3,4,1,0,0,3
S01008412,Occupancy rating 0,40,9,1,8,28,0,15,1,11,3,13,11,2,3,2,0,0,1
S01008412,Occupancy rating -1 or less,20,7,3,4,12,0,6,0,5,1,6,4,2,1,0,0,0,1
S01008413,All households,222,66,30,36,142,14,99,36,44,19,29,12,17,14,6,0,0,8
S01008413,Occupancy rating +2 or more,84,12,7,5,67,8,53,20,27,6,6,1,5,5,2,0,0,3
S01008413,Occupancy rating +1,61,27,14,13,32,5,23,14,4,5,4,0,4,2,1,0,0,1
S01008413,Occupancy rating 0,57,21,5,16,32,1,17,2,10,5,14,9,5,4,2,0,0,2
S01008413,Occupancy rating -1 or less,20,6,4,2,11,0,6,0,3,3,5,2,3,3,1,0,0,2
S01008414,All households,152,22,9,13,124,17,96,22,50,24,11,7,4,6,2,0,0,4
S01008414,Occupancy rating +2 or more,114,19,8,11,90,17,67,20,31,16,6,3,3,5,2,0,0,3
S01008414,Occupancy rating +1,24,3,1,2,20,0,18,1,13,4,2,1,1,1,0,0,0,1
S01008414,Occupancy rating 0,10,0,0,0,10,0,8,1,4,3,2,2,0,0,0,0,0,0
S01008414,Occupancy rating -1 or less,4,0,0,0,4,0,3,0,2,1,1,1,0,0,0,0,0,0
S01008415,All households,347,114,49,65,220,27,149,43,75,31,44,26,18,13,8,0,0,5
S01008415,Occupancy rating +2 or more,115,28,15,13,85,20,59,24,26,9,6,1,5,2,1,0,0,1
S01008415,Occupancy rating +1,132,66,27,39,65,6,52,18,22,12,7,2,5,1,0,0,0,1
S01008415,Occupancy rating 0,71,16,6,10,52,1,27,1,20,6,24,17,7,3,1,0,0,2
S01008415,Occupancy rating -1 or less,29,4,1,3,18,0,11,0,7,4,7,6,1,7,6,0,0,1
S01008416,All households,437,181,54,127,237,15,164,60,72,32,58,39,19,19,12,0,0,7
S01008416,Occupancy rating +2 or more,102,41,11,30,57,6,47,28,13,6,4,1,3,4,2,0,0,2
S01008416,Occupancy rating +1,142,66,24,42,75,8,58,23,25,10,9,6,3,1,1,0,0,0
S01008416,Occupancy rating 0,148,63,18,45,76,1,48,8,26,14,27,20,7,9,5,0,0,4
S01008416,Occupancy rating -1 or less,45,11,1,10,29,0,11,1,8,2,18,12,6,5,4,0,0,1
S01008417,All households,299,70,32,38,215,45,156,65,73,18,14,11,3,14,7,0,0,7
S01008417,Occupancy rating +2 or more,189,25,14,11,155,40,112,56,48,8,3,1,2,9,5,0,0,4
S01008417,Occupancy rating +1,77,40,16,24,35,4,28,9,13,6,3,3,0,2,0,0,0,2
S01008417,Occupancy rating 0,26,2,1,1,21,1,12,0,9,3,8,7,1,3,2,0,0,1
S01008417,Occupancy rating -1 or less,7,3,1,2,4,0,4,0,3,1,0,0,0,0,0,0,0,0
S01008418,All households,312,95,52,43,207,35,156,65,65,26,16,4,12,10,2,0,0,8
S01008418,Occupancy rating +2 or more,144,31,20,11,110,24,84,42,29,13,2,1,1,3,1,0,0,2
S01008418,Occupancy rating +1,126,62,32,30,62,11,46,23,16,7,5,1,4,2,1,0,0,1
S01008418,Occupancy rating 0,40,2,0,2,34,0,26,0,20,6,8,1,7,4,0,0,0,4
S01008418,Occupancy rating -1 or less,2,0,0,0,1,0,0,0,0,0,1,1,0,1,0,0,0,1
S01008419,All households,193,58,29,29,131,9,112,35,66,11,10,5,5,4,3,0,0,1
S01008419,Occupancy rating +2 or more,113,16,5,11,94,7,83,25,50,8,4,2,2,3,2,0,0,1
S01008419,Occupancy rating +1,34,16,6,10,18,0,17,6,9,2,1,1,0,0,0,0,0,0
S01008419,Occupancy rating 0,33,20,13,7,12,2,7,3,4,0,3,1,2,1,1,0,0,0
S01008419,Occupancy rating -1 or less,13,6,5,1,7,0,5,1,3,1,2,1,1,0,0,0,0,0
S01008420,All households,190,36,23,13,150,26,109,43,46,20,15,7,8,4,2,1,0,1
S01008420,Occupancy rating +2 or more,109,16,11,5,91,17,70,36,22,12,4,2,2,2,1,0,0,1
S01008420,Occupancy rating +1,47,14,7,7,33,8,21,7,11,3,4,1,3,0,0,0,0,0
S01008420,Occupancy rating 0,32,4,3,1,26,1,18,0,13,5,7,4,3,2,1,1,0,0
S01008420,Occupancy rating -1 or less,2,2,2,0,0,0,0,0,0,0,0,0,0,0,0,0,0,0
S01008421,All households,394,146,67,79,235,17,167,55,85,27,51,33,18,13,5,2,1,5
S01008421,Occupancy rating +2 or more,104,38,16,22,62,5,53,26,17,10,4,1,3,4,1,0,0,3
S01008421,Occupancy rating +1,166,68,39,29,96,11,72,27,34,11,13,8,5,2,2,0,0,0
S01008421,Occupancy rating 0,100,31,10,21,63,0,36,2,29,5,27,18,9,6,1,2,1,2
S01008421,Occupancy rating -1 or less,24,9,2,7,14,1,6,0,5,1,7,6,1,1,1,0,0,0
S01008422,All households,241,49,41,8,186,29,151,64,65,22,6,5,1,6,3,0,0,3
S01008422,Occupancy rating +2 or more,187,20,14,6,163,21,138,63,58,17,4,3,1,4,2,0,0,2
S01008422,Occupancy rating +1,18,6,5,1,11,3,7,0,4,3,1,1,0,1,1,0,0,0
S01008422,Occupancy rating 0,29,19,19,0,10,5,5,1,2,2,0,0,0,0,0,0,0,0
S01008422,Occupancy rating -1 or less,7,4,3,1,2,0,1,0,1,0,1,1,0,1,0,0,0,1
S01008423,All households,398,74,34,40,315,49,250,86,140,24,16,7,9,9,3,0,1,5
S01008423,Occupancy rating +2 or more,311,49,28,21,255,45,203,76,110,17,7,2,5,7,2,0,0,5
S01008423,Occupancy rating +1,50,19,5,14,30,3,25,9,14,2,2,0,2,1,1,0,0,0
S01008423,Occupancy rating 0,29,4,1,3,24,1,18,1,12,5,5,5,0,1,0,0,1,0
S01008423,Occupancy rating -1 or less,8,2,0,2,6,0,4,0,4,0,2,0,2,0,0,0,0,0
S01008424,All households,338,63,45,18,266,86,170,66,79,25,10,7,3,9,5,0,0,4
S01008424,Occupancy rating +2 or more,309,57,41,16,245,85,153,61,68,24,7,4,3,7,3,0,0,4
S01008424,Occupancy rating +1,13,4,3,1,8,0,7,3,3,1,1,1,0,1,1,0,0,0
S01008424,Occupancy rating 0,13,2,1,1,10,0,8,1,7,0,2,2,0,1,1,0,0,0
S01008424,Occupancy rating -1 or less,3,0,0,0,3,1,2,1,1,0,0,0,0,0,0,0,0,0
S01008425,All households,409,111,63,48,285,59,201,85,83,33,25,9,16,13,5,1,1,6
S01008425,Occupancy rating +2 or more,261,72,47,25,184,51,123,62,48,13,10,3,7,5,2,0,1,2
S01008425,Occupancy rating +1,97,30,15,15,65,7,52,17,22,13,6,2,4,2,1,0,0,1
S01008425,Occupancy rating 0,41,6,1,5,31,1,21,5,11,5,9,4,5,4,1,1,0,2
S01008425,Occupancy rating -1 or less,10,3,0,3,5,0,5,1,2,2,0,0,0,2,1,0,0,1
S01008426,All households,264,89,65,24,163,28,92,31,43,18,43,20,23,12,5,1,0,6
S01008426,Occupancy rating +2 or more,86,39,31,8,45,10,28,13,13,2,7,3,4,2,1,0,0,1
S01008426,Occupancy rating +1,96,39,27,12,53,16,28,16,8,4,9,6,3,4,2,1,0,1
S01008426,Occupancy rating 0,66,7,5,2,55,2,29,2,19,8,24,10,14,4,1,0,0,3
S01008426,Occupancy rating -1 or less,16,4,2,2,10,0,7,0,3,4,3,1,2,2,1,0,0,1
S01008427,All households,397,54,13,41,327,28,273,97,128,48,26,14,12,16,8,1,0,7
S01008427,Occupancy rating +2 or more,201,25,5,20,172,22,143,66,57,20,7,3,4,4,2,0,0,2
S01008427,Occupancy rating +1,131,27,7,20,98,4,85,29,37,19,9,4,5,6,3,1,0,2
S01008427,Occupancy rating 0,51,1,0,1,45,0,36,2,28,6,9,6,3,5,3,0,0,2
S01008427,Occupancy rating -1 or less,14,1,1,0,12,2,9,0,6,3,1,1,0,1,0,0,0,1
S01008428,All households,316,120,83,37,185,29,119,47,50,22,37,22,15,11,5,0,0,6
S01008428,Occupancy rating +2 or more,103,34,23,11,69,21,45,28,15,2,3,3,0,0,0,0,0,0
S01008428,Occupancy rating +1,120,54,36,18,63,8,40,18,12,10,15,7,8,3,2,0,0,1
S01008428,Occupancy rating 0,72,26,19,7,40,0,25,1,18,6,15,9,6,6,3,0,0,3
S01008428,Occupancy rating -1 or less,21,6,5,1,13,0,9,0,5,4,4,3,1,2,0,0,0,2
S01008429,All households,352,89,61,28,258,50,188,70,80,38,20,9,11,5,4,0,0,1
S01008429,Occupancy rating +2 or more,243,68,51,17,175,44,122,61,39,22,9,2,7,0,0,0,0,0
S01008429,Occupancy rating +1,79,16,8,8,60,5,50,6,33,11,5,3,2,3,2,0,0,1
S01008429,Occupancy rating 0,22,3,1,2,19,1,14,2,8,4,4,3,1,0,0,0,0,0
S01008429,Occupancy rating -1 or less,8,2,1,1,4,0,2,1,0,1,2,1,1,2,2,0,0,0
S01008430,All households,276,70,48,22,192,44,130,49,61,20,18,10,8,14,6,1,1,6
S01008430,Occupancy rating +2 or more,175,45,33,12,123,35,84,39,33,12,4,2,2,7,1,0,1,5
S01008430,Occupancy rating +1,54,18,12,6,34,9,20,7,11,2,5,2,3,2,0,1,0,1
S01008430,Occupancy rating 0,32,6,2,4,24,0,17,2,12,3,7,5,2,2,2,0,0,0
S01008430,Occupancy rating -1 or less,15,1,1,0,11,0,9,1,5,3,2,1,1,3,3,0,0,0
S01008431,All households,352,94,58,36,248,52,175,54,84,37,21,11,10,10,6,0,0,4
S01008431,Occupancy rating +2 or more,232,61,49,12,166,49,107,45,39,23,10,6,4,5,3,0,0,2
S01008431,Occupancy rating +1,66,11,6,5,53,2,45,7,30,8,6,3,3,2,2,0,0,0
S01008431,Occupancy rating 0,35,11,2,9,21,1,17,1,11,5,3,2,1,3,1,0,0,2
S01008431,Occupancy rating -1 or less,19,11,1,10,8,0,6,1,4,1,2,0,2,0,0,0,0,0
S01008432,All households,293,66,41,25,218,63,138,49,62,27,17,13,4,9,3,0,0,6
S01008432,Occupancy rating +2 or more,224,52,38,14,167,58,102,47,35,20,7,5,2,5,2,0,0,3
S01008432,Occupancy rating +1,37,3,2,1,34,5,25,2,18,5,4,4,0,0,0,0,0,0
S01008432,Occupancy rating 0,24,9,1,8,13,0,8,0,6,2,5,3,2,2,0,0,0,2
S01008432,Occupancy rating -1 or less,8,2,0,2,4,0,3,0,3,0,1,1,0,2,1,0,0,1
S01008433,All households,348,79,31,48,268,46,202,90,74,38,20,8,12,1,1,0,0,0
S01008433,Occupancy rating +2 or more,177,33,21,12,144,32,108,61,29,18,4,1,3,0,0,0,0,0
S01008433,Occupancy rating +1,113,32,9,23,81,12,66,25,25,16,3,1,2,0,0,0,0,0
S01008433,Occupancy rating 0,51,13,1,12,37,2,25,4,17,4,10,5,5,1,1,0,0,0
S01008433,Occupancy rating -1 or less,7,1,0,1,6,0,3,0,3,0,3,1,2,0,0,0,0,0
S01008434,All households,322,61,24,37,248,35,189,82,74,33,24,15,9,13,6,0,0,7
S01008434,Occupancy rating +2 or more,209,46,17,29,160,32,120,69,37,14,8,5,3,3,1,0,0,2
S01008434,Occupancy rating +1,71,10,4,6,59,2,49,11,24,14,8,3,5,2,1,0,0,1
S01008434,Occupancy rating 0,33,4,2,2,24,1,18,0,13,5,5,4,1,5,1,0,0,4
S01008434,Occupancy rating -1 or less,9,1,1,0,5,0,2,2,0,0,3,3,0,3,3,0,0,0
S01008435,All households,301,51,29,22,238,48,171,66,68,37,19,6,13,12,5,0,0,7
S01008435,Occupancy rating +2 or more,216,40,22,18,172,44,118,60,38,20,10,3,7,4,2,0,0,2
S01008435,Occupancy rating +1,52,10,6,4,39,4,29,6,12,11,6,2,4,3,1,0,0,2
S01008435,Occupancy rating 0,27,1,1,0,21,0,20,0,15,5,1,0,1,5,2,0,0,3
S01008435,Occupancy rating -1 or less,6,0,0,0,6,0,4,0,3,1,2,1,1,0,0,0,0,0
S01008436,All households,356,95,49,46,244,36,182,78,85,19,26,13,13,17,9,2,0,6
S01008436,Occupancy rating +2 or more,215,45,30,15,165,25,134,64,58,12,6,4,2,5,3,0,0,2
S01008436,Occupancy rating +1,85,40,17,23,44,9,27,9,14,4,8,4,4,1,1,0,0,0
S01008436,Occupancy rating 0,46,8,2,6,28,2,17,2,12,3,9,5,4,10,4,2,0,4
S01008436,Occupancy rating -1 or less,10,2,0,2,7,0,4,3,1,0,3,0,3,1,1,0,0,0
S01008437,All households,367,165,85,80,193,33,135,60,53,22,25,17,8,9,1,0,0,8
S01008437,Occupancy rating +2 or more,137,31,15,16,102,17,78,29,35,14,7,4,3,4,1,0,0,3
S01008437,Occupancy rating +1,87,48,25,23,39,8,25,12,8,5,6,4,2,0,0,0,0,0
S01008437,Occupancy rating 0,114,73,41,32,38,8,22,14,5,3,8,6,2,3,0,0,0,3
S01008437,Occupancy rating -1 or less,29,13,4,9,14,0,10,5,5,0,4,3,1,2,0,0,0,2
S01008438,All households,189,61,15,46,122,12,103,41,50,12,7,4,3,6,3,1,0,2
S01008438,Occupancy rating +2 or more,104,16,6,10,83,10,70,24,36,10,3,2,1,5,3,0,0,2
S01008438,Occupancy rating +1,36,14,4,10,22,1,20,10,9,1,1,0,1,0,0,0,0,0
S01008438,Occupancy rating 0,23,11,3,8,11,1,8,3,4,1,2,2,0,1,0,1,0,0
S01008438,Occupancy rating -1 or less,26,20,2,18,6,0,5,4,1,0,1,0,1,0,0,0,0,0
S01008439,All households,434,94,50,44,329,47,254,84,145,25,28,19,9,11,6,0,0,5
S01008439,Occupancy rating +2 or more,342,58,39,19,277,44,215,74,118,23,18,12,6,7,4,0,0,3
S01008439,Occupancy rating +1,42,13,3,10,28,3,19,4,14,1,6,4,2,1,0,0,0,1
S01008439,Occupancy rating 0,34,13,5,8,20,0,19,6,12,1,1,1,0,1,0,0,0,1
S01008439,Occupancy rating -1 or less,16,10,3,7,4,0,1,0,1,0,3,2,1,2,2,0,0,0
S01008440,All households,403,82,54,28,309,77,211,78,108,25,21,11,10,12,4,0,2,6
S01008440,Occupancy rating +2 or more,323,53,37,16,262,75,173,69,83,21,14,5,9,8,4,0,1,3
S01008440,Occupancy rating +1,53,14,8,6,38,2,33,7,23,3,3,2,1,1,0,0,0,1
S01008440,Occupancy rating 0,20,12,8,4,7,0,4,2,2,0,3,3,0,1,0,0,0,1
S01008440,Occupancy rating -1 or less,7,3,1,2,2,0,1,0,0,1,1,1,0,2,0,0,1,1
S01008441,All households,186,37,21,16,144,28,103,38,52,13,13,7,6,5,0,0,1,4
S01008441,Occupancy rating +2 or more,152,30,18,12,119,26,84,37,38,9,9,5,4,3,0,0,0,3
S01008441,Occupancy rating +1,28,7,3,4,19,1,16,1,12,3,2,1,1,2,0,0,1,1
S01008441,Occupancy rating 0,3,0,0,0,3,1,1,0,1,0,1,1,0,0,0,0,0,0
S01008441,Occupancy rating -1 or less,3,0,0,0,3,0,2,0,1,1,1,0,1,0,0,0,0,0
S01008442,All households,303,89,30,59,210,17,175,84,75,16,18,14,4,4,0,0,1,3
S01008442,Occupancy rating +2 or more,179,43,21,22,135,15,113,58,45,10,7,4,3,1,0,0,0,1
S01008442,Occupancy rating +1,72,29,5,24,43,1,38,19,16,3,4,3,1,0,0,0,0,0
S01008442,Occupancy rating 0,42,11,1,10,29,1,22,6,13,3,6,6,0,2,0,0,0,2
S01008442,Occupancy rating -1 or less,10,6,3,3,3,0,2,1,1,0,1,1,0,1,0,0,1,0
S01008443,All households,252,68,34,34,175,37,129,59,58,12,9,6,3,9,3,0,0,6
S01008443,Occupancy rating +2 or more,196,43,29,14,147,31,111,53,48,10,5,4,1,6,2,0,0,4
S01008443,Occupancy rating +1,33,10,3,7,21,6,13,5,7,1,2,0,2,2,1,0,0,1
S01008443,Occupancy rating 0,19,14,2,12,5,0,3,0,3,0,2,2,0,0,0,0,0,0
S01008443,Occupancy rating -1 or less,4,1,0,1,2,0,2,1,0,1,0,0,0,1,0,0,0,1
S01008444,All households,260,74,19,55,181,17,149,57,75,17,15,11,4,5,1,0,3,1
S01008444,Occupancy rating +2 or more,137,30,12,18,107,9,96,44,45,7,2,1,1,0,0,0,0,0
S01008444,Occupancy rating +1,71,32,6,26,37,6,23,10,11,2,8,6,2,2,1,0,1,0
S01008444,Occupancy rating 0,37,12,1,11,23,1,18,3,12,3,4,3,1,2,0,0,2,0
S01008444,Occupancy rating -1 or less,15,0,0,0,14,1,12,0,7,5,1,1,0,1,0,0,0,1
S01008445,All households,403,168,146,22,225,43,170,45,111,14,12,6,6,10,8,0,0,2
S01008445,Occupancy rating +2 or more,117,19,14,5,94,16,75,34,34,7,3,1,2,4,3,0,0,1
S01008445,Occupancy rating +1,89,22,14,8,66,11,51,8,41,2,4,3,1,1,0,0,0,1
S01008445,Occupancy rating 0,139,82,79,3,54,14,36,1,32,3,4,1,3,3,3,0,0,0
S01008445,Occupancy rating -1 or less,58,45,39,6,11,2,8,2,4,2,1,1,0,2,2,0,0,0
S01008446,All households,323,76,54,22,238,49,173,65,93,15,16,10,6,9,2,0,2,5
S01008446,Occupancy rating +2 or more,264,66,46,20,193,45,138,61,68,9,10,5,5,5,0,0,1,4
S01008446,Occupancy rating +1,42,7,6,1,33,4,27,3,19,5,2,1,1,2,0,0,1,1
S01008446,Occupancy rating 0,12,1,1,0,9,0,6,0,5,1,3,3,0,2,2,0,0,0
S01008446,Occupancy rating -1 or less,5,2,1,1,3,0,2,1,1,0,1,1,0,0,0,0,0,0
S01008447,All households,286,61,32,29,220,41,166,78,70,18,13,8,5,5,1,0,1,3
S01008447,Occupancy rating +2 or more,210,41,25,16,167,36,122,65,45,12,9,4,5,2,1,0,1,0
S01008447,Occupancy rating +1,45,9,5,4,34,4,29,10,14,5,1,1,0,2,0,0,0,2
S01008447,Occupancy rating 0,24,7,0,7,16,1,13,3,9,1,2,2,0,1,0,0,0,1
S01008447,Occupancy rating -1 or less,7,4,2,2,3,0,2,0,2,0,1,1,0,0,0,0,0,0
S01008448,All households,315,67,37,30,235,45,175,75,79,21,15,7,8,13,1,5,2,5
S01008448,Occupancy rating +2 or more,199,34,23,11,162,40,117,62,39,16,5,3,2,3,0,1,2,0
S01008448,Occupancy rating +1,73,30,12,18,41,5,30,12,14,4,6,1,5,2,0,0,0,2
S01008448,Occupancy rating 0,32,3,2,1,25,0,23,1,22,0,2,2,0,4,1,1,0,2
S01008448,Occupancy rating -1 or less,11,0,0,0,7,0,5,0,4,1,2,1,1,4,0,3,0,1
S01008449,All households,351,146,22,124,175,8,103,30,59,14,64,52,12,30,11,0,1,18
S01008449,Occupancy rating +2 or more,73,34,10,24,36,4,25,16,9,0,7,5,2,3,0,0,0,3
S01008449,Occupancy rating +1,93,29,6,23,54,3,26,5,16,5,25,19,6,10,3,0,1,6
S01008449,Occupancy rating 0,144,72,5,67,65,1,41,8,27,6,23,21,2,7,3,0,0,4
S01008449,Occupancy rating -1 or less,41,11,1,10,20,0,11,1,7,3,9,7,2,10,5,0,0,5
S01008450,All households,256,97,14,83,141,2,62,18,35,9,77,63,14,18,7,0,0,11
S01008450,Occupancy rating +2 or more,34,20,1,19,13,1,9,6,3,0,3,3,0,1,1,0,0,0
S01008450,Occupancy rating +1,102,65,11,54,34,1,21,10,6,5,12,8,4,3,0,0,0,3
S01008450,Occupancy rating 0,84,12,2,10,66,0,24,2,18,4,42,35,7,6,1,0,0,5
S01008450,Occupancy rating -1 or less,36,0,0,0,28,0,8,0,8,0,20,17,3,8,5,0,0,3
S01008451,All households,325,154,15,139,151,0,76,26,42,8,75,62,13,20,11,1,1,7
S01008451,Occupancy rating +2 or more,56,29,3,26,22,0,14,8,5,1,8,5,3,5,1,0,1,3
S01008451,Occupancy rating +1,77,36,4,32,38,0,19,3,13,3,19,15,4,3,2,0,0,1
S01008451,Occupancy rating 0,137,75,7,68,59,0,31,13,14,4,28,25,3,3,2,1,0,0
S01008451,Occupancy rating -1 or less,55,14,1,13,32,0,12,2,10,0,20,17,3,9,6,0,0,3
S01008452,All households,271,126,11,115,131,1,70,25,36,9,60,49,11,14,9,1,0,4
S01008452,Occupancy rating +2 or more,51,27,4,23,23,1,17,11,3,3,5,1,4,1,0,0,0,1
S01008452,Occupancy rating +1,50,10,2,8,39,0,19,6,9,4,20,18,2,1,0,0,0,1
S01008452,Occupancy rating 0,120,73,4,69,41,0,22,6,16,0,19,15,4,6,5,0,0,1
S01008452,Occupancy rating -1 or less,50,16,1,15,28,0,12,2,8,2,16,15,1,6,4,1,0,1
S01008453,All households,215,68,4,64,123,2,88,40,44,4,33,26,7,24,7,4,0,13
S01008453,Occupancy rating +2 or more,28,7,1,6,18,1,16,7,9,0,1,1,0,3,0,1,0,2
S01008453,Occupancy rating +1,35,12,2,10,22,1,18,11,4,3,3,2,1,1,0,0,0,1
S01008453,Occupancy rating 0,76,28,0,28,39,0,27,12,14,1,12,9,3,9,3,3,0,3
S01008453,Occupancy rating -1 or less,76,21,1,20,44,0,27,10,17,0,17,14,3,11,4,0,0,7
S01008454,All households,393,146,22,124,221,6,110,32,63,15,105,81,24,26,10,0,0,16
S01008454,Occupancy rating +2 or more,59,25,5,20,33,3,22,11,7,4,8,6,2,1,0,0,0,1
S01008454,Occupancy rating +1,98,30,5,25,63,1,28,9,15,4,34,25,9,5,1,0,0,4
S01008454,Occupancy rating 0,184,79,9,70,96,2,43,9,29,5,51,43,8,9,2,0,0,7
S01008454,Occupancy rating -1 or less,52,12,3,9,29,0,17,3,12,2,12,7,5,11,7,0,0,4
S01008455,All households,501,221,50,171,234,17,127,56,58,13,90,72,18,46,7,13,0,26
S01008455,Occupancy rating +2 or more,66,41,11,30,25,6,17,12,3,2,2,0,2,0,0,0,0,0
S01008455,Occupancy rating +1,162,87,17,70,67,7,46,26,13,7,14,10,4,8,1,1,0,6
S01008455,Occupancy rating 0,206,82,17,65,105,4,43,12,27,4,58,47,11,19,0,5,0,14
S01008455,Occupancy rating -1 or less,67,11,5,6,37,0,21,6,15,0,16,15,1,19,6,7,0,6
S01008456,All households,528,262,36,226,233,15,127,46,70,11,91,68,23,33,6,2,1,24
S01008456,Occupancy rating +2 or more,43,27,6,21,15,3,9,6,2,1,3,1,2,1,0,0,0,1
S01008456,Occupancy rating +1,219,149,15,134,68,8,44,28,13,3,16,9,7,2,0,0,0,2
S01008456,Occupancy rating 0,179,52,8,44,108,2,54,8,41,5,52,39,13,19,1,2,1,15
S01008456,Occupancy rating -1 or less,87,34,7,27,42,2,20,4,14,2,20,19,1,11,5,0,0,6
S01008457,All households,353,189,74,115,142,18,78,41,25,12,46,27,19,22,6,4,0,12
S01008457,Occupancy rating +2 or more,39,20,7,13,19,4,11,11,0,0,4,3,1,0,0,0,0,0
S01008457,Occupancy rating +1,117,62,18,44,50,6,34,21,6,7,10,5,5,5,0,3,0,2
S01008457,Occupancy rating 0,151,89,38,51,52,6,25,8,12,5,21,14,7,10,1,1,0,8
S01008457,Occupancy rating -1 or less,46,18,11,7,21,2,8,1,7,0,11,5,6,7,5,0,0,2
S01008458,All households,428,145,37,108,258,21,167,59,68,40,70,52,18,25,10,5,0,10
S01008458,Occupancy rating +2 or more,102,40,14,26,60,13,40,28,11,1,7,5,2,2,0,1,0,1
S01008458,Occupancy rating +1,146,43,12,31,98,8,67,26,19,22,23,14,9,5,0,0,0,5
S01008458,Occupancy rating 0,141,53,7,46,75,0,47,5,32,10,28,25,3,13,5,4,0,4
S01008458,Occupancy rating -1 or less,39,9,4,5,25,0,13,0,6,7,12,8,4,5,5,0,0,0
S01008459,All households,393,205,25,180,167,8,98,43,42,13,61,42,19,21,5,1,1,14
S01008459,Occupancy rating +2 or more,76,39,5,34,36,5,27,22,2,3,4,2,2,1,0,0,0,1
S01008459,Occupancy rating +1,84,32,5,27,46,1,28,7,15,6,17,13,4,6,0,1,1,4
S01008459,Occupancy rating 0,188,119,12,107,63,1,35,14,18,3,27,16,11,6,2,0,0,4
S01008459,Occupancy rating -1 or less,45,15,3,12,22,1,8,0,7,1,13,11,2,8,3,0,0,5
S01008460,All households,368,161,20,141,179,3,79,29,41,9,97,80,17,28,15,1,0,12
S01008460,Occupancy rating +2 or more,53,33,4,29,18,1,13,7,4,2,4,2,2,2,1,0,0,1
S01008460,Occupancy rating +1,101,45,6,39,52,1,25,10,12,3,26,20,6,4,0,1,0,3
S01008460,Occupancy rating 0,169,79,10,69,82,1,32,11,18,3,49,42,7,8,4,0,0,4
S01008460,Occupancy rating -1 or less,45,4,0,4,27,0,9,1,7,1,18,16,2,14,10,0,0,4
S01008461,All households,450,193,15,178,225,9,112,45,52,15,104,86,18,32,9,0,0,23
S01008461,Occupancy rating +2 or more,49,22,2,20,25,3,17,13,2,2,5,5,0,2,0,0,0,2
S01008461,Occupancy rating +1,148,89,4,85,53,5,34,25,7,2,14,12,2,6,1,0,0,5
S01008461,Occupancy rating 0,193,70,7,63,111,1,50,6,36,8,60,49,11,12,1,0,0,11
S01008461,Occupancy rating -1 or less,60,12,2,10,36,0,11,1,7,3,25,20,5,12,7,0,0,5
S01008462,All households,349,228,52,176,105,9,63,39,18,6,33,21,12,16,4,2,0,10
S01008462,Occupancy rating +2 or more,30,17,3,14,11,1,10,6,2,2,0,0,0,2,1,0,0,1
S01008462,Occupancy rating +1,163,123,30,93,40,6,25,22,2,1,9,6,3,0,0,0,0,0
S01008462,Occupancy rating 0,123,66,13,53,46,2,24,9,12,3,20,12,8,11,2,2,0,7
S01008462,Occupancy rating -1 or less,33,22,6,16,8,0,4,2,2,0,4,3,1,3,1,0,0,2
S01008463,All households,355,175,33,142,143,8,85,36,39,10,50,31,19,37,14,4,0,19
S01008463,Occupancy rating +2 or more,42,23,7,16,19,3,15,11,3,1,1,0,1,0,0,0,0,0
S01008463,Occupancy rating +1,97,67,17,50,26,3,20,13,4,3,3,1,2,4,1,0,0,3
S01008463,Occupancy rating 0,168,78,7,71,75,2,40,10,27,3,33,22,11,15,5,2,0,8
S01008463,Occupancy rating -1 or less,48,7,2,5,23,0,10,2,5,3,13,8,5,18,8,2,0,8
S01008464,All households,413,141,54,87,247,30,146,71,48,27,71,54,17,25,6,3,1,15
S01008464,Occupancy rating +2 or more,88,29,9,20,57,12,38,31,6,1,7,3,4,2,0,0,1,1
S01008464,Occupancy rating +1,168,96,35,61,71,17,46,33,5,8,8,5,3,1,0,0,0,1
S01008464,Occupancy rating 0,117,12,7,5,91,0,50,6,29,15,41,33,8,14,1,3,0,10
S01008464,Occupancy rating -1 or less,40,4,3,1,28,1,12,1,8,3,15,13,2,8,5,0,0,3
S01008465,All households,346,108,40,68,216,27,132,75,44,13,57,38,19,22,3,5,1,13
S01008465,Occupancy rating +2 or more,60,21,9,12,36,5,30,26,0,4,1,1,0,3,1,0,1,1
S01008465,Occupancy rating +1,167,72,26,46,94,21,63,48,13,2,10,8,2,1,0,0,0,1
S01008465,Occupancy rating 0,91,10,4,6,72,1,32,1,26,5,39,23,16,9,0,1,0,8
S01008465,Occupancy rating -1 or less,28,5,1,4,14,0,7,0,5,2,7,6,1,9,2,4,0,3
S01008466,All households,318,86,26,60,202,23,121,50,49,22,58,46,12,30,7,7,0,16
S01008466,Occupancy rating +2 or more,47,11,4,7,34,6,25,17,5,3,3,2,1,2,1,0,0,1
S01008466,Occupancy rating +1,141,61,19,42,75,15,47,32,8,7,13,10,3,5,1,1,0,3
S01008466,Occupancy rating 0,99,11,2,9,74,1,39,1,29,9,34,27,7,14,2,1,0,11
S01008466,Occupancy rating -1 or less,31,3,1,2,19,1,10,0,7,3,8,7,1,9,3,5,0,1
S01008467,All households,330,77,39,38,239,27,171,73,65,33,41,31,10,14,4,2,0,8
S01008467,Occupancy rating +2 or more,104,38,26,12,66,17,48,36,8,4,1,1,0,0,0,0,0,0
S01008467,Occupancy rating +1,126,37,11,26,85,9,69,33,23,13,7,2,5,4,0,1,0,3
S01008467,Occupancy rating 0,83,1,1,0,76,1,43,2,26,15,32,27,5,6,1,1,0,4
S01008467,Occupancy rating -1 or less,17,1,1,0,12,0,11,2,8,1,1,1,0,4,3,0,0,1
S01008468,All households,232,54,23,31,157,13,98,30,45,23,46,33,13,21,11,4,1,5
S01008468,Occupancy rating +2 or more,77,34,17,17,40,10,24,21,1,2,6,3,3,3,1,0,1,1
S01008468,Occupancy rating +1,76,11,2,9,60,3,37,9,14,14,20,13,7,5,2,0,0,3
S01008468,Occupancy rating 0,56,8,3,5,40,0,29,0,23,6,11,8,3,8,4,3,0,1
S01008468,Occupancy rating -1 or less,23,1,1,0,17,0,8,0,7,1,9,9,0,5,4,1,0,0
S01008469,All households,229,54,28,26,144,12,112,46,46,20,20,14,6,31,5,11,2,13
S01008469,Occupancy rating +2 or more,95,37,20,17,54,9,43,32,5,6,2,2,0,4,1,0,0,3
S01008469,Occupancy rating +1,62,10,4,6,46,2,37,9,18,10,7,3,4,6,1,1,1,3
S01008469,Occupancy rating 0,48,4,2,2,32,1,23,5,15,3,8,7,1,12,2,7,1,2
S01008469,Occupancy rating -1 or less,24,3,2,1,12,0,9,0,8,1,3,2,1,9,1,3,0,5
S01008470,All households,298,87,38,49,168,7,111,40,47,24,50,29,21,43,14,3,2,24
S01008470,Occupancy rating +2 or more,73,24,7,17,42,3,35,28,5,2,4,1,3,7,1,1,1,4
S01008470,Occupancy rating +1,95,29,12,17,58,2,32,5,17,10,24,14,10,8,1,0,0,7
S01008470,Occupancy rating 0,87,32,17,15,41,2,31,5,16,10,8,7,1,14,5,1,1,7
S01008470,Occupancy rating -1 or less,43,2,2,0,27,0,13,2,9,2,14,7,7,14,7,1,0,6
S01008471,All households,347,106,20,86,206,7,101,26,50,25,98,75,23,35,8,2,2,23
S01008471,Occupancy rating +2 or more,68,38,4,34,26,2,18,16,1,1,6,3,3,4,0,2,0,2
S01008471,Occupancy rating +1,101,30,6,24,63,4,28,4,15,9,31,20,11,8,0,0,1,7
S01008471,Occupancy rating 0,125,30,7,23,85,0,41,6,24,11,44,37,7,10,0,0,1,9
S01008471,Occupancy rating -1 or less,53,8,3,5,32,1,14,0,10,4,17,15,2,13,8,0,0,5
S01008472,All households,277,81,28,53,165,9,118,44,51,23,38,30,8,31,12,4,1,14
S01008472,Occupancy rating +2 or more,69,21,4,17,46,6,37,23,7,7,3,2,1,2,0,2,0,0
S01008472,Occupancy rating +1,92,38,17,21,46,3,37,17,14,6,6,4,2,8,2,0,0,6
S01008472,Occupancy rating 0,79,21,7,14,49,0,28,3,19,6,21,19,2,9,3,0,1,5
S01008472,Occupancy rating -1 or less,37,1,0,1,24,0,16,1,11,4,8,5,3,12,7,2,0,3
S01008473,All households,307,110,36,74,168,9,101,40,48,13,58,35,23,29,14,3,0,12
S01008473,Occupancy rating +2 or more,74,38,14,24,36,6,25,16,6,3,5,1,4,0,0,0,0,0
S01008473,Occupancy rating +1,95,33,11,22,61,3,43,17,19,7,15,9,6,1,0,0,0,1
S01008473,Occupancy rating 0,102,37,10,27,47,0,26,6,17,3,21,14,7,18,9,3,0,6
S01008473,Occupancy rating -1 or less,36,2,1,1,24,0,7,1,6,0,17,11,6,10,5,0,0,5
S01008474,All households,440,230,81,149,178,26,94,40,40,14,58,38,20,32,5,8,0,19
S01008474,Occupancy rating +2 or more,45,25,8,17,18,5,8,6,2,0,5,3,2,2,0,1,0,1
S01008474,Occupancy rating +1,157,84,28,56,70,13,36,24,8,4,21,15,6,3,0,0,0,3
S01008474,Occupancy rating 0,189,107,37,70,68,4,41,9,24,8,23,15,8,14,3,3,0,8
S01008474,Occupancy rating -1 or less,49,14,8,6,22,4,9,1,6,2,9,5,4,13,2,4,0,7
S01008475,All households,327,154,73,81,148,17,77,41,27,9,54,41,13,25,5,6,3,11
S01008475,Occupancy rating +2 or more,12,8,3,5,4,1,3,3,0,0,0,0,0,0,0,0,0,0
S01008475,Occupancy rating +1,158,101,54,47,55,13,37,32,2,3,5,4,1,2,1,1,0,0
S01008475,Occupancy rating 0,119,36,15,21,68,2,29,6,18,5,37,28,9,15,1,5,2,7
S01008475,Occupancy rating -1 or less,38,9,1,8,21,1,8,0,7,1,12,9,3,8,3,0,1,4
S01008476,All households,406,216,82,134,166,26,101,54,38,9,39,25,14,24,4,0,1,19
S01008476,Occupancy rating +2 or more,15,10,6,4,5,3,2,2,0,0,0,0,0,0,0,0,0,0
S01008476,Occupancy rating +1,195,134,50,84,60,16,41,38,2,1,3,2,1,1,1,0,0,0
S01008476,Occupancy rating 0,157,68,25,43,74,5,47,11,28,8,22,15,7,15,0,0,0,15
S01008476,Occupancy rating -1 or less,39,4,1,3,27,2,11,3,8,0,14,8,6,8,3,0,1,4
S01008477,All households,465,251,97,154,183,23,108,68,32,8,52,32,20,31,5,2,2,22
S01008477,Occupancy rating +2 or more,16,11,4,7,4,0,4,4,0,0,0,0,0,1,0,0,1,0
S01008477,Occupancy rating +1,198,128,59,69,69,17,49,46,1,2,3,1,2,1,0,0,0,1
S01008477,Occupancy rating 0,203,95,29,66,89,3,44,17,22,5,42,26,16,19,0,2,0,17
S01008477,Occupancy rating -1 or less,48,17,5,12,21,3,11,1,9,1,7,5,2,10,5,0,1,4
S01008478,All households,439,229,108,121,177,18,114,52,46,16,45,30,15,33,5,9,0,19
S01008478,Occupancy rating +2 or more,53,19,7,12,32,5,25,14,7,4,2,1,1,2,0,0,0,2
S01008478,Occupancy rating +1,134,88,38,50,46,10,31,23,8,0,5,2,3,0,0,0,0,0
S01008478,Occupancy rating 0,194,108,53,55,66,3,39,10,19,10,24,15,9,20,1,7,0,12
S01008478,Occupancy rating -1 or less,58,14,10,4,33,0,19,5,12,2,14,12,2,11,4,2,0,5
S01008479,All households,407,166,82,84,205,26,120,69,39,12,59,38,21,36,7,5,1,23
S01008479,Occupancy rating +2 or more,22,6,5,1,15,5,8,6,2,0,2,2,0,1,0,1,0,0
S01008479,Occupancy rating +1,224,136,62,74,84,20,60,58,1,1,4,4,0,4,1,1,0,2
S01008479,Occupancy rating 0,123,18,11,7,85,1,43,5,28,10,41,23,18,20,0,2,1,17
S01008479,Occupancy rating -1 or less,38,6,4,2,21,0,9,0,8,1,12,9,3,11,6,1,0,4
S01008480,All households,279,73,10,63,161,8,97,60,30,7,56,40,16,45,4,9,0,32
S01008480,Occupancy rating +2 or more,25,7,3,4,18,4,11,11,0,0,3,2,1,0,0,0,0,0
S01008480,Occupancy rating +1,113,53,5,48,57,2,47,38,5,4,8,1,7,3,1,0,0,2
S01008480,Occupancy rating 0,95,9,1,8,61,2,27,7,17,3,32,25,7,25,0,6,0,19
S01008480,Occupancy rating -1 or less,46,4,1,3,25,0,12,4,8,0,13,12,1,17,3,3,0,11
S01008481,All households,373,74,35,39,267,38,156,54,71,31,73,43,30,32,14,1,0,17
S01008481,Occupancy rating +2 or more,142,43,23,20,94,35,52,37,8,7,7,1,6,5,1,0,0,4
S01008481,Occupancy rating +1,108,21,7,14,82,3,53,14,24,15,26,11,15,5,1,0,0,4
S01008481,Occupancy rating 0,96,10,5,5,75,0,41,3,31,7,34,26,8,11,4,1,0,6
S01008481,Occupancy rating -1 or less,27,0,0,0,16,0,10,0,8,2,6,5,1,11,8,0,0,3
S01008482,All households,316,128,60,68,171,29,99,53,37,9,43,30,13,17,1,2,1,13
S01008482,Occupancy rating +2 or more,47,18,6,12,25,6,18,15,2,1,1,0,1,4,1,0,0,3
S01008482,Occupancy rating +1,119,51,19,32,66,18,38,29,7,2,10,9,1,2,0,0,1,1
S01008482,Occupancy rating 0,122,54,33,21,59,4,31,6,20,5,24,16,8,9,0,1,0,8
S01008482,Occupancy rating -1 or less,28,5,2,3,21,1,12,3,8,1,8,5,3,2,0,1,0,1
S01008483,All households,327,156,74,82,156,19,114,64,31,19,23,18,5,15,2,2,1,10
S01008483,Occupancy rating +2 or more,51,21,10,11,28,7,21,19,1,1,0,0,0,2,1,1,0,0
S01008483,Occupancy rating +1,124,67,29,38,57,5,50,32,12,6,2,0,2,0,0,0,0,0
S01008483,Occupancy rating 0,126,60,29,31,57,6,35,12,15,8,16,13,3,9,0,1,0,8
S01008483,Occupancy rating -1 or less,26,8,6,2,14,1,8,1,3,4,5,5,0,4,1,0,1,2
S01008484,All households,342,113,50,63,214,28,153,62,59,32,33,16,17,15,6,3,0,6
S01008484,Occupancy rating +2 or more,128,44,26,18,80,16,60,40,13,7,4,2,2,4,2,0,0,2
S01008484,Occupancy rating +1,123,57,20,37,62,11,42,18,16,8,9,4,5,4,1,0,0,3
S01008484,Occupancy rating 0,68,6,2,4,59,1,39,4,25,10,19,10,9,3,1,1,0,1
S01008484,Occupancy rating -1 or less,23,6,2,4,13,0,12,0,5,7,1,0,1,4,2,2,0,0
S01008485,All households,408,103,30,73,274,45,200,66,106,28,29,23,6,31,5,9,0,17
S01008485,Occupancy rating +2 or more,147,30,11,19,116,34,77,35,41,1,5,4,1,1,1,0,0,0
S01008485,Occupancy rating +1,139,55,14,41,76,10,60,25,23,12,6,4,2,8,1,2,0,5
S01008485,Occupancy rating 0,93,17,5,12,63,1,49,6,31,12,13,11,2,13,1,3,0,9
S01008485,Occupancy rating -1 or less,29,1,0,1,19,0,14,0,11,3,5,4,1,9,2,4,0,3
S01008486,All households,459,206,120,86,223,45,139,66,40,33,39,24,15,30,5,6,0,19
S01008486,Occupancy rating +2 or more,108,29,11,18,76,22,49,29,10,10,5,2,3,3,1,1,0,1
S01008486,Occupancy rating +1,151,69,36,33,74,11,56,30,13,13,7,3,4,8,1,1,0,6
S01008486,Occupancy rating 0,144,75,49,26,55,6,27,5,14,8,22,14,8,14,1,4,0,9
S01008486,Occupancy rating -1 or less,56,33,24,9,18,6,7,2,3,2,5,5,0,5,2,0,0,3
S01008487,All households,417,182,34,148,177,11,146,97,41,8,20,15,5,58,10,14,0,34
S01008487,Occupancy rating +2 or more,57,13,7,6,43,7,31,18,12,1,5,3,2,1,0,1,0,0
S01008487,Occupancy rating +1,87,40,8,32,44,2,39,27,8,4,3,1,2,3,0,1,0,2
S01008487,Occupancy rating 0,171,94,15,79,66,2,55,39,14,2,9,8,1,11,0,3,0,8
S01008487,Occupancy rating -1 or less,102,35,4,31,24,0,21,13,7,1,3,3,0,43,10,9,0,24
S01008488,All households,416,188,77,111,182,13,131,77,41,13,38,21,17,46,2,16,3,25
S01008488,Occupancy rating +2 or more,53,22,2,20,30,5,25,18,4,3,0,0,0,1,0,0,0,1
S01008488,Occupancy rating +1,176,101,57,44,64,5,56,46,9,1,3,2,1,11,0,5,0,6
S01008488,Occupancy rating 0,141,50,13,37,69,2,38,11,20,7,29,15,14,22,1,6,2,13
S01008488,Occupancy rating -1 or less,46,15,5,10,19,1,12,2,8,2,6,4,2,12,1,5,1,5
S01008489,All households,305,114,39,75,162,21,107,49,39,19,34,19,15,29,6,9,2,12
S01008489,Occupancy rating +2 or more,68,25,13,12,39,8,30,23,4,3,1,1,0,4,1,1,0,2
S01008489,Occupancy rating +1,121,56,17,39,59,11,41,20,13,8,7,1,6,6,1,0,2,3
S01008489,Occupancy rating 0,96,31,8,23,53,1,34,6,20,8,18,9,9,12,2,6,0,4
S01008489,Occupancy rating -1 or less,20,2,1,1,11,1,2,0,2,0,8,8,0,7,2,2,0,3
S01008490,All households,528,283,65,218,201,17,149,87,45,17,35,20,15,44,5,13,2,24
S01008490,Occupancy rating +2 or more,53,21,7,14,27,3,21,11,7,3,3,1,2,5,2,0,0,3
S01008490,Occupancy rating +1,173,107,34,73,61,10,47,31,13,3,4,2,2,5,1,2,0,2
S01008490,Occupancy rating 0,193,96,17,79,75,2,53,27,17,9,20,11,9,22,0,8,2,12
S01008490,Occupancy rating -1 or less,109,59,7,52,38,2,28,18,8,2,8,6,2,12,2,3,0,7
S01008491,All households,487,209,44,165,191,13,142,80,52,10,36,16,20,87,2,36,2,47
S01008491,Occupancy rating +2 or more,54,23,7,16,28,4,23,14,6,3,1,0,1,3,0,0,0,3
S01008491,Occupancy rating +1,214,128,27,101,71,8,61,52,6,3,2,2,0,15,0,4,1,10
S01008491,Occupancy rating 0,154,46,7,39,65,1,41,9,30,2,23,8,15,43,0,16,1,26
S01008491,Occupancy rating -1 or less,65,12,3,9,27,0,17,5,10,2,10,6,4,26,2,16,0,8
S01008492,All households,515,230,19,211,226,3,167,119,40,8,56,43,13,59,4,15,0,40
S01008492,Occupancy rating +2 or more,49,12,1,11,32,0,32,26,5,1,0,0,0,5,1,0,0,4
S01008492,Occupancy rating +1,167,86,6,80,73,2,64,55,7,2,7,6,1,8,1,1,0,6
S01008492,Occupancy rating 0,219,97,9,88,88,1,54,29,22,3,33,25,8,34,1,9,0,24
S01008492,Occupancy rating -1 or less,80,35,3,32,33,0,17,9,6,2,16,12,4,12,1,5,0,6
S01008493,All households,420,197,66,131,173,29,104,52,40,12,40,29,11,50,3,17,1,29
S01008493,Occupancy rating +2 or more,83,52,24,28,31,9,19,13,4,2,3,0,3,0,0,0,0,0
S01008493,Occupancy rating +1,101,38,20,18,55,14,35,19,10,6,6,4,2,8,0,0,0,8
S01008493,Occupancy rating 0,147,59,11,48,62,5,37,16,18,3,20,14,6,26,1,10,0,15
S01008493,Occupancy rating -1 or less,89,48,11,37,25,1,13,4,8,1,11,11,0,16,2,7,1,6
S01008494,All households,409,222,30,192,157,12,107,84,22,1,38,27,11,30,5,5,0,20
S01008494,Occupancy rating +2 or more,29,17,7,10,12,3,7,6,1,0,2,2,0,0,0,0,0,0
S01008494,Occupancy rating +1,77,45,14,31,29,4,20,16,4,0,5,1,4,3,0,2,0,1
S01008494,Occupancy rating 0,205,115,3,112,81,4,55,45,9,1,22,15,7,9,2,1,0,6
S01008494,Occupancy rating -1 or less,98,45,6,39,35,1,25,17,8,0,9,9,0,18,3,2,0,13
S01008495,All households,589,344,22,322,180,6,161,132,28,1,13,8,5,65,2,38,0,25
S01008495,Occupancy rating +2 or more,12,3,0,3,8,0,8,7,1,0,0,0,0,1,0,1,0,0
S01008495,Occupancy rating +1,94,53,3,50,34,2,32,30,2,0,0,0,0,7,0,3,0,4
S01008495,Occupancy rating 0,256,168,11,157,73,1,64,56,8,0,8,6,2,15,0,12,0,3
S01008495,Occupancy rating -1 or less,227,120,8,112,65,3,57,39,17,1,5,2,3,42,2,22,0,18
S01008496,All households,676,437,29,408,169,2,156,136,17,3,11,9,2,70,2,28,0,40
S01008496,Occupancy rating +2 or more,20,13,0,13,7,0,6,5,0,1,1,1,0,0,0,0,0,0
S01008496,Occupancy rating +1,123,68,1,67,49,0,46,42,3,1,3,3,0,6,1,2,0,3
S01008496,Occupancy rating 0,272,174,15,159,67,1,64,57,6,1,2,2,0,31,0,12,0,19
S01008496,Occupancy rating -1 or less,261,182,13,169,46,1,40,32,8,0,5,3,2,33,1,14,0,18
S01008497,All households,572,397,19,378,146,6,133,110,20,3,7,4,3,29,3,10,0,16
S01008497,Occupancy rating +2 or more,31,14,2,12,16,3,13,9,3,1,0,0,0,1,1,0,0,0
S01008497,Occupancy rating +1,53,40,2,38,13,0,11,11,0,0,2,2,0,0,0,0,0,0
S01008497,Occupancy rating 0,289,210,11,199,69,3,63,59,4,0,3,2,1,10,0,3,0,7
S01008497,Occupancy rating -1 or less,199,133,4,129,48,0,46,31,13,2,2,0,2,18,2,7,0,9
S01008498,All households,525,344,29,315,125,2,112,85,23,4,11,9,2,56,1,18,1,36
S01008498,Occupancy rating +2 or more,20,5,1,4,14,0,13,10,3,0,1,1,0,1,0,1,0,0
S01008498,Occupancy rating +1,92,56,7,49,31,2,27,24,3,0,2,1,1,5,0,1,0,4
S01008498,Occupancy rating 0,208,121,8,113,52,0,48,36,10,2,4,4,0,35,0,12,1,22
S01008498,Occupancy rating -1 or less,205,162,13,149,28,0,24,15,7,2,4,3,1,15,1,4,0,10
S01008499,All households,591,291,26,265,187,3,165,128,32,5,19,17,2,113,2,53,0,58
S01008499,Occupancy rating +2 or more,34,8,0,8,22,1,20,16,3,1,1,1,0,4,0,2,0,2
S01008499,Occupancy rating +1,112,58,5,53,46,1,43,40,3,0,2,2,0,8,0,5,0,3
S01008499,Occupancy rating 0,229,118,13,105,57,0,53,43,8,2,4,4,0,54,0,25,0,29
S01008499,Occupancy rating -1 or less,216,107,8,99,62,1,49,29,18,2,12,10,2,47,2,21,0,24
S01008500,All households,209,107,3,104,61,0,40,23,12,5,21,14,7,41,4,15,0,22
S01008500,Occupancy rating +2 or more,13,6,0,6,4,0,4,3,0,1,0,0,0,3,0,3,0,0
S01008500,Occupancy rating +1,46,18,0,18,20,0,16,13,1,2,4,3,1,8,0,3,0,5
S01008500,Occupancy rating 0,98,65,3,62,21,0,13,3,9,1,8,5,3,12,0,2,0,10
S01008500,Occupancy rating -1 or less,52,18,0,18,16,0,7,4,2,1,9,6,3,18,4,7,0,7
S01008501,All households,316,127,4,123,99,1,93,66,27,0,5,3,2,90,3,29,0,58
S01008501,Occupancy rating +2 or more,22,11,0,11,10,0,10,7,3,0,0,0,0,1,0,0,0,1
S01008501,Occupancy rating +1,117,64,2,62,46,1,45,39,6,0,0,0,0,7,0,3,0,4
S01008501,Occupancy rating 0,135,41,2,39,30,0,26,10,16,0,4,2,2,64,1,21,0,42
S01008501,Occupancy rating -1 or less,42,11,0,11,13,0,12,10,2,0,1,1,0,18,2,5,0,11
S01008502,All households,373,179,8,171,116,1,101,82,15,4,14,10,4,78,2,32,0,44
S01008502,Occupancy rating +2 or more,35,26,0,26,7,0,7,7,0,0,0,0,0,2,0,1,0,1
S01008502,Occupancy rating +1,111,62,2,60,37,1,35,30,5,0,1,1,0,12,0,4,0,8
S01008502,Occupancy rating 0,154,73,3,70,45,0,38,30,6,2,7,5,2,36,0,15,0,21
S01008502,Occupancy rating -1 or less,73,18,3,15,27,0,21,15,4,2,6,4,2,28,2,12,0,14
S01008503,All households,443,163,20,143,217,4,193,139,50,4,20,11,9,63,1,21,1,40
S01008503,Occupancy rating +2 or more,86,28,7,21,53,2,48,33,14,1,3,1,2,5,0,0,1,4
S01008503,Occupancy rating +1,172,68,6,62,94,1,88,76,11,1,5,3,2,10,1,2,0,7
S01008503,Occupancy rating 0,126,51,4,47,48,1,42,23,17,2,5,3,2,27,0,12,0,15
S01008503,Occupancy rating -1 or less,59,16,3,13,22,0,15,7,8,0,7,4,3,21,0,7,0,14
S01008504,All households,543,202,28,174,276,19,238,128,96,14,19,14,5,65,6,20,1,38
S01008504,Occupancy rating +2 or more,181,46,15,31,126,12,106,52,48,6,8,6,2,9,2,0,0,7
S01008504,Occupancy rating +1,154,70,8,62,73,5,66,40,21,5,2,2,0,11,0,6,1,4
S01008504,Occupancy rating 0,159,73,5,68,62,2,57,32,23,2,3,2,1,24,1,8,0,15
S01008504,Occupancy rating -1 or less,49,13,0,13,15,0,9,4,4,1,6,4,2,21,3,6,0,12
S01008505,All households,330,112,28,84,197,12,163,87,63,13,22,13,9,21,3,6,0,12
S01008505,Occupancy rating +2 or more,134,33,5,28,98,7,83,36,38,9,8,4,4,3,3,0,0,0
S01008505,Occupancy rating +1,111,51,18,33,56,3,51,33,16,2,2,1,1,4,0,1,0,3
S01008505,Occupancy rating 0,69,25,5,20,35,2,25,14,9,2,8,4,4,9,0,3,0,6
S01008505,Occupancy rating -1 or less,16,3,0,3,8,0,4,4,0,0,4,4,0,5,0,2,0,3
S01008506,All households,442,212,91,121,198,40,137,83,51,3,21,14,7,32,1,9,1,21
S01008506,Occupancy rating +2 or more,160,54,23,31,101,21,76,50,23,3,4,2,2,5,0,1,0,4
S01008506,Occupancy rating +1,116,69,22,47,42,5,34,20,14,0,3,2,1,5,0,0,0,5
S01008506,Occupancy rating 0,127,73,37,36,40,10,21,10,11,0,9,5,4,14,0,5,0,9
S01008506,Occupancy rating -1 or less,39,16,9,7,15,4,6,3,3,0,5,5,0,8,1,3,1,3
S01008507,All households,386,151,26,125,194,4,169,110,50,9,21,14,7,41,3,14,0,24
S01008507,Occupancy rating +2 or more,92,25,5,20,65,1,58,33,22,3,6,2,4,2,1,0,0,1
S01008507,Occupancy rating +1,144,71,12,59,65,2,57,46,8,3,6,4,2,8,0,3,0,5
S01008507,Occupancy rating 0,121,46,7,39,56,1,49,29,18,2,6,5,1,19,0,5,0,14
S01008507,Occupancy rating -1 or less,29,9,2,7,8,0,5,2,2,1,3,3,0,12,2,6,0,4
S01008508,All households,358,102,53,49,236,32,181,71,90,20,23,9,14,20,3,2,0,15
S01008508,Occupancy rating +2 or more,231,65,37,28,159,28,122,53,58,11,9,4,5,7,3,0,0,4
S01008508,Occupancy rating +1,83,30,15,15,48,2,38,15,18,5,8,2,6,5,0,0,0,5
S01008508,Occupancy rating 0,38,6,1,5,25,2,17,3,12,2,6,3,3,7,0,1,0,6
S01008508,Occupancy rating -1 or less,6,1,0,1,4,0,4,0,2,2,0,0,0,1,0,1,0,0
S01008509,All households,509,201,84,117,281,50,206,111,77,18,25,18,7,27,2,3,2,20
S01008509,Occupancy rating +2 or more,255,77,37,40,172,35,135,76,47,12,2,2,0,6,1,0,1,4
S01008509,Occupancy rating +1,152,90,39,51,58,12,39,24,12,3,7,6,1,4,0,1,0,3
S01008509,Occupancy rating 0,77,28,6,22,38,1,23,9,13,1,14,9,5,11,0,0,1,10
S01008509,Occupancy rating -1 or less,25,6,2,4,13,2,9,2,5,2,2,1,1,6,1,2,0,3
S01008510,All households,390,97,46,51,269,53,187,80,86,21,29,17,12,24,0,10,2,12
S01008510,Occupancy rating +2 or more,234,53,27,26,177,43,125,59,50,16,9,3,6,4,0,0,2,2
S01008510,Occupancy rating +1,103,41,17,24,57,10,40,20,16,4,7,4,3,5,0,1,0,4
S01008510,Occupancy rating 0,36,2,1,1,30,0,19,0,18,1,11,8,3,4,0,1,0,3
S01008510,Occupancy rating -1 or less,17,1,1,0,5,0,3,1,2,0,2,2,0,11,0,8,0,3
S01008511,All households,358,82,52,30,266,45,197,78,99,20,24,14,10,10,4,0,0,6
S01008511,Occupancy rating +2 or more,285,62,37,25,219,43,161,75,69,17,15,8,7,4,1,0,0,3
S01008511,Occupancy rating +1,51,17,13,4,31,2,24,2,21,1,5,2,3,3,2,0,0,1
S01008511,Occupancy rating 0,18,3,2,1,13,0,9,0,8,1,4,4,0,2,0,0,0,2
S01008511,Occupancy rating -1 or less,4,0,0,0,3,0,3,1,1,1,0,0,0,1,1,0,0,0
S01008512,All households,201,43,27,16,151,32,110,36,58,16,9,4,5,7,5,0,0,2
S01008512,Occupancy rating +2 or more,162,34,24,10,126,30,89,29,48,12,7,3,4,2,1,0,0,1
S01008512,Occupancy rating +1,30,8,3,5,19,2,16,5,7,4,1,1,0,3,3,0,0,0
S01008512,Occupancy rating 0,7,1,0,1,4,0,4,2,2,0,0,0,0,2,1,0,0,1
S01008512,Occupancy rating -1 or less,2,0,0,0,2,0,1,0,1,0,1,0,1,0,0,0,0,0
S01008513,All households,258,48,35,13,199,34,151,59,79,13,14,4,10,11,5,0,3,3
S01008513,Occupancy rating +2 or more,215,42,31,11,167,33,127,53,62,12,7,0,7,6,2,0,2,2
S01008513,Occupancy rating +1,26,5,3,2,19,1,15,2,12,1,3,2,1,2,2,0,0,0
S01008513,Occupancy rating 0,10,1,1,0,7,0,6,3,3,0,1,1,0,2,0,0,1,1
S01008513,Occupancy rating -1 or less,7,0,0,0,6,0,3,1,2,0,3,1,2,1,1,0,0,0
S01008514,All households,397,140,101,39,240,31,189,74,100,15,20,15,5,17,3,3,3,8
S01008514,Occupancy rating +2 or more,236,54,37,17,179,22,147,63,72,12,10,6,4,3,1,0,1,1
S01008514,Occupancy rating +1,91,45,33,12,41,8,30,9,18,3,3,2,1,5,1,1,0,3
S01008514,Occupancy rating 0,59,35,27,8,16,0,10,2,8,0,6,6,0,8,1,2,2,3
S01008514,Occupancy rating -1 or less,11,6,4,2,4,1,2,0,2,0,1,1,0,1,0,0,0,1
S01008515,All households,297,82,27,55,202,17,170,51,99,20,15,10,5,13,4,2,2,5
S01008515,Occupancy rating +2 or more,172,34,17,17,133,16,114,37,64,13,3,1,2,5,2,0,1,2
S01008515,Occupancy rating +1,66,25,6,19,40,1,35,11,19,5,4,2,2,1,0,0,0,1
S01008515,Occupancy rating 0,42,15,3,12,23,0,18,3,13,2,5,4,1,4,2,0,1,1
S01008515,Occupancy rating -1 or less,17,8,1,7,6,0,3,0,3,0,3,3,0,3,0,2,0,1
S01008516,All households,592,371,60,311,169,13,133,92,37,4,23,15,8,52,2,30,1,19
S01008516,Occupancy rating +2 or more,50,23,6,17,22,4,16,10,5,1,2,1,1,5,0,0,1,4
S01008516,Occupancy rating +1,167,107,26,81,52,4,45,35,9,1,3,2,1,8,0,6,0,2
S01008516,Occupancy rating 0,246,162,18,144,61,3,45,29,15,1,13,9,4,23,0,14,0,9
S01008516,Occupancy rating -1 or less,129,79,10,69,34,2,27,18,8,1,5,3,2,16,2,10,0,4
S01008517,All households,463,216,93,123,173,20,139,88,39,12,14,12,2,74,2,35,3,34
S01008517,Occupancy rating +2 or more,75,29,16,13,42,3,37,22,11,4,2,1,1,4,1,1,0,2
S01008517,Occupancy rating +1,189,100,39,61,77,13,62,45,11,6,2,2,0,12,0,7,1,4
S01008517,Occupancy rating 0,156,75,33,42,50,4,36,21,13,2,10,9,1,31,1,13,1,16
S01008517,Occupancy rating -1 or less,43,12,5,7,4,0,4,0,4,0,0,0,0,27,0,14,1,12
S01008518,All households,378,96,41,55,235,18,191,80,91,20,26,14,12,47,8,14,2,23
S01008518,Occupancy rating +2 or more,221,52,30,22,162,14,141,50,75,16,7,4,3,7,3,1,2,1
S01008518,Occupancy rating +1,79,32,8,24,39,2,31,22,7,2,6,2,4,8,1,1,0,6
S01008518,Occupancy rating 0,58,11,3,8,29,1,17,7,9,1,11,8,3,18,1,4,0,13
S01008518,Occupancy rating -1 or less,20,1,0,1,5,1,2,1,0,1,2,0,2,14,3,8,0,3
S01008519,All households,324,86,46,40,226,28,177,59,102,16,21,14,7,12,2,1,3,6
S01008519,Occupancy rating +2 or more,234,48,25,23,181,26,144,47,84,13,11,6,5,5,0,0,2,3
S01008519,Occupancy rating +1,42,18,13,5,22,1,16,4,10,2,5,4,1,2,1,0,1,0
S01008519,Occupancy rating 0,31,14,7,7,14,1,12,5,6,1,1,1,0,3,1,1,0,1
S01008519,Occupancy rating -1 or less,17,6,1,5,9,0,5,3,2,0,4,3,1,2,0,0,0,2
S01008520,All households,433,93,66,27,321,64,241,94,111,36,16,10,6,19,7,0,3,9
S01008520,Occupancy rating +2 or more,377,80,56,24,285,63,212,89,92,31,10,5,5,12,3,0,3,6
S01008520,Occupancy rating +1,39,8,7,1,27,1,22,4,14,4,4,3,1,4,1,0,0,3
S01008520,Occupancy rating 0,9,2,1,1,6,0,4,0,3,1,2,2,0,1,1,0,0,0
S01008520,Occupancy rating -1 or less,8,3,2,1,3,0,3,1,2,0,0,0,0,2,2,0,0,0
S01008521,All households,338,54,35,19,275,44,220,84,110,26,11,6,5,9,4,0,2,3
S01008521,Occupancy rating +2 or more,299,48,31,17,244,44,192,82,86,24,8,4,4,7,2,0,2,3
S01008521,Occupancy rating +1,29,5,3,2,23,0,22,2,19,1,1,0,1,1,1,0,0,0
S01008521,Occupancy rating 0,7,1,1,0,6,0,5,0,4,1,1,1,0,0,0,0,0,0
S01008521,Occupancy rating -1 or less,3,0,0,0,2,0,1,0,1,0,1,1,0,1,1,0,0,0
S01008522,All households,228,57,18,39,165,30,121,49,58,14,14,8,6,6,2,3,0,1
S01008522,Occupancy rating +2 or more,154,36,12,24,116,24,85,36,39,10,7,4,3,2,0,2,0,0
S01008522,Occupancy rating +1,51,19,6,13,30,5,23,10,10,3,2,1,1,2,2,0,0,0
S01008522,Occupancy rating 0,20,1,0,1,18,1,12,2,9,1,5,3,2,1,0,0,0,1
S01008522,Occupancy rating -1 or less,3,1,0,1,1,0,1,1,0,0,0,0,0,1,0,1,0,0
S01008523,All households,434,142,44,98,279,36,215,95,111,9,28,22,6,13,2,3,1,7
S01008523,Occupancy rating +2 or more,256,67,21,46,184,28,147,66,77,4,9,9,0,5,2,1,0,2
S01008523,Occupancy rating +1,126,61,21,40,62,7,47,27,19,1,8,3,5,3,0,0,0,3
S01008523,Occupancy rating 0,42,10,2,8,27,1,19,2,13,4,7,6,1,5,0,2,1,2
S01008523,Occupancy rating -1 or less,10,4,0,4,6,0,2,0,2,0,4,4,0,0,0,0,0,0
S01008524,All households,442,186,51,135,224,15,123,60,48,15,86,54,32,32,7,7,1,17
S01008524,Occupancy rating +2 or more,56,23,9,14,31,1,25,16,7,2,5,4,1,2,0,0,0,2
S01008524,Occupancy rating +1,167,98,22,76,67,9,44,37,4,3,14,8,6,2,1,0,0,1
S01008524,Occupancy rating 0,155,53,16,37,88,3,38,5,27,6,47,28,19,14,0,3,0,11
S01008524,Occupancy rating -1 or less,64,12,4,8,38,2,16,2,10,4,20,14,6,14,6,4,1,3
S01008525,All households,380,186,103,83,170,23,93,33,48,12,54,37,17,24,5,1,1,17
S01008525,Occupancy rating +2 or more,72,26,12,14,45,6,24,11,10,3,15,13,2,1,0,0,0,1
S01008525,Occupancy rating +1,141,67,28,39,68,8,45,19,21,5,15,13,2,6,0,0,1,5
S01008525,Occupancy rating 0,137,84,57,27,43,8,17,3,10,4,18,8,10,10,1,1,0,8
S01008525,Occupancy rating -1 or less,30,9,6,3,14,1,7,0,7,0,6,3,3,7,4,0,0,3
S01008526,All households,448,208,108,100,224,29,150,68,60,22,45,28,17,16,1,3,0,12
S01008526,Occupancy rating +2 or more,76,27,14,13,48,2,41,28,7,6,5,1,4,1,0,0,0,1
S01008526,Occupancy rating +1,223,137,64,73,83,22,56,35,15,6,5,4,1,3,0,1,0,2
S01008526,Occupancy rating 0,117,37,26,11,72,5,40,4,31,5,27,16,11,8,0,2,0,6
S01008526,Occupancy rating -1 or less,32,7,4,3,21,0,13,1,7,5,8,7,1,4,1,0,0,3
S01008527,All households,333,108,32,76,207,18,124,51,50,23,65,47,18,18,2,0,0,16
S01008527,Occupancy rating +2 or more,85,36,6,30,49,5,38,23,8,7,6,4,2,0,0,0,0,0
S01008527,Occupancy rating +1,150,61,23,38,82,13,52,26,13,13,17,12,5,7,0,0,0,7
S01008527,Occupancy rating 0,70,9,2,7,52,0,25,1,22,2,27,19,8,9,0,0,0,9
S01008527,Occupancy rating -1 or less,28,2,1,1,24,0,9,1,7,1,15,12,3,2,2,0,0,0
S01008528,All households,304,90,29,61,200,21,122,36,60,26,57,46,11,14,6,0,1,7
S01008528,Occupancy rating +2 or more,93,43,16,27,49,10,31,23,5,3,8,7,1,1,0,0,0,1
S01008528,Occupancy rating +1,119,40,10,30,74,11,47,12,26,9,16,13,3,5,1,0,1,3
S01008528,Occupancy rating 0,69,5,2,3,60,0,35,1,24,10,25,19,6,4,3,0,0,1
S01008528,Occupancy rating -1 or less,23,2,1,1,17,0,9,0,5,4,8,7,1,4,2,0,0,2
S01008529,All households,349,132,77,55,203,17,140,59,41,40,46,30,16,14,3,2,3,6
S01008529,Occupancy rating +2 or more,119,52,31,21,63,13,48,26,8,14,2,0,2,4,1,0,3,0
S01008529,Occupancy rating +1,124,60,38,22,60,3,50,27,14,9,7,2,5,4,1,0,0,3
S01008529,Occupancy rating 0,79,15,7,8,60,1,30,4,12,14,29,23,6,4,0,2,0,2
S01008529,Occupancy rating -1 or less,27,5,1,4,20,0,12,2,7,3,8,5,3,2,1,0,0,1
S01008530,All households,369,161,57,104,196,13,102,46,43,13,81,53,28,12,5,0,0,7
S01008530,Occupancy rating +2 or more,40,15,6,9,24,3,17,13,2,2,4,1,3,1,1,0,0,0
S01008530,Occupancy rating +1,168,107,41,66,59,10,36,26,8,2,13,10,3,2,1,0,0,1
S01008530,Occupancy rating 0,105,18,5,13,81,0,30,5,17,8,51,31,20,6,1,0,0,5
S01008530,Occupancy rating -1 or less,56,21,5,16,32,0,19,2,16,1,13,11,2,3,2,0,0,1
S01008531,All households,394,182,61,121,198,28,102,49,38,15,68,47,21,14,4,1,0,9
S01008531,Occupancy rating +2 or more,80,36,14,22,43,12,27,15,9,3,4,1,3,1,0,0,0,1
S01008531,Occupancy rating +1,134,74,30,44,58,12,36,21,10,5,10,6,4,2,0,0,0,2
S01008531,Occupancy rating 0,142,61,14,47,74,3,31,12,13,6,40,28,12,7,2,0,0,5
S01008531,Occupancy rating -1 or less,38,11,3,8,23,1,8,1,6,1,14,12,2,4,2,1,0,1
S01008532,All households,213,86,45,41,112,16,62,21,29,12,34,18,16,15,5,0,1,9
S01008532,Occupancy rating +2 or more,60,23,15,8,35,6,25,12,10,3,4,2,2,2,0,0,0,2
S01008532,Occupancy rating +1,54,23,12,11,29,4,16,3,7,6,9,5,4,2,0,0,0,2
S01008532,Occupancy rating 0,84,36,15,21,40,5,18,5,10,3,17,9,8,8,3,0,0,5
S01008532,Occupancy rating -1 or less,15,4,3,1,8,1,3,1,2,0,4,2,2,3,2,0,1,0
S01008533,All households,179,20,9,11,154,5,142,46,89,7,7,5,2,5,3,0,0,2
S01008533,Occupancy rating +2 or more,76,10,4,6,65,3,58,24,30,4,4,3,1,1,0,0,0,1
S01008533,Occupancy rating +1,56,2,0,2,53,1,50,19,29,2,2,1,1,1,1,0,0,0
S01008533,Occupancy rating 0,38,8,5,3,28,0,27,2,24,1,1,1,0,2,1,0,0,1
S01008533,Occupancy rating -1 or less,9,0,0,0,8,1,7,1,6,0,0,0,0,1,1,0,0,0
S01008534,All households,274,46,16,30,220,18,183,77,84,22,19,9,10,8,4,1,0,3
S01008534,Occupancy rating +2 or more,156,23,9,14,132,14,109,51,40,18,9,4,5,1,1,0,0,0
S01008534,Occupancy rating +1,69,18,5,13,49,2,41,21,17,3,6,2,4,2,1,0,0,1
S01008534,Occupancy rating 0,40,3,1,2,35,2,29,3,25,1,4,3,1,2,0,1,0,1
S01008534,Occupancy rating -1 or less,9,2,1,1,4,0,4,2,2,0,0,0,0,3,2,0,0,1
S01008535,All households,284,68,31,37,208,36,160,54,78,28,12,6,6,8,2,1,1,4
S01008535,Occupancy rating +2 or more,193,51,19,32,138,27,105,44,43,18,6,2,4,4,1,0,0,3
S01008535,Occupancy rating +1,68,16,11,5,51,9,39,8,25,6,3,2,1,1,0,0,1,0
S01008535,Occupancy rating 0,20,1,1,0,18,0,15,2,9,4,3,2,1,1,1,0,0,0
S01008535,Occupancy rating -1 or less,3,0,0,0,1,0,1,0,1,0,0,0,0,2,0,1,0,1
S01008536,All households,263,79,49,30,175,45,112,46,51,15,18,7,11,9,3,0,2,4
S01008536,Occupancy rating +2 or more,178,46,36,10,128,43,78,33,35,10,7,1,6,4,1,0,1,2
S01008536,Occupancy rating +1,61,27,9,18,32,2,26,12,11,3,4,0,4,2,1,0,0,1
S01008536,Occupancy rating 0,21,5,4,1,14,0,8,1,5,2,6,5,1,2,0,0,1,1
S01008536,Occupancy rating -1 or less,3,1,0,1,1,0,0,0,0,0,1,1,0,1,1,0,0,0
S01008537,All households,280,56,29,27,217,46,158,66,65,27,13,5,8,7,4,0,2,1
S01008537,Occupancy rating +2 or more,244,54,27,27,186,45,135,63,50,22,6,3,3,4,1,0,2,1
S01008537,Occupancy rating +1,23,1,1,0,20,1,13,2,9,2,6,2,4,2,2,0,0,0
S01008537,Occupancy rating 0,10,1,1,0,8,0,8,1,4,3,0,0,0,1,1,0,0,0
S01008537,Occupancy rating -1 or less,3,0,0,0,3,0,2,0,2,0,1,0,1,0,0,0,0,0
S01008538,All households,242,70,56,14,164,40,119,53,49,17,5,3,2,8,3,0,2,3
S01008538,Occupancy rating +2 or more,216,67,54,13,145,39,104,51,39,14,2,1,1,4,0,0,1,3
S01008538,Occupancy rating +1,18,3,2,1,13,1,9,2,5,2,3,2,1,2,1,0,1,0
S01008538,Occupancy rating 0,7,0,0,0,6,0,6,0,5,1,0,0,0,1,1,0,0,0
S01008538,Occupancy rating -1 or less,1,0,0,0,0,0,0,0,0,0,0,0,0,1,1,0,0,0
S01008539,All households,346,98,59,39,234,36,189,63,96,30,9,4,5,14,7,1,2,4
S01008539,Occupancy rating +2 or more,277,71,47,24,199,31,161,58,79,24,7,3,4,7,3,0,2,2
S01008539,Occupancy rating +1,58,25,12,13,31,5,25,5,15,5,1,0,1,2,2,0,0,0
S01008539,Occupancy rating 0,9,2,0,2,4,0,3,0,2,1,1,1,0,3,1,1,0,1
S01008539,Occupancy rating -1 or less,2,0,0,0,0,0,0,0,0,0,0,0,0,2,1,0,0,1
S01008540,All households,373,88,59,29,276,65,193,78,80,35,18,8,10,9,1,1,2,5
S01008540,Occupancy rating +2 or more,287,68,46,22,215,60,150,68,57,25,5,3,2,4,0,0,2,2
S01008540,Occupancy rating +1,61,17,11,6,42,5,29,10,13,6,8,2,6,2,0,0,0,2
S01008540,Occupancy rating 0,22,3,2,1,18,0,13,0,9,4,5,3,2,1,0,1,0,0
S01008540,Occupancy rating -1 or less,3,0,0,0,1,0,1,0,1,0,0,0,0,2,1,0,0,1
S01008541,All households,323,52,37,15,261,35,196,51,113,32,30,18,12,10,4,1,1,4
S01008541,Occupancy rating +2 or more,190,41,32,9,145,32,104,45,46,13,9,4,5,4,1,0,1,2
S01008541,Occupancy rating +1,92,10,5,5,79,3,65,6,44,15,11,8,3,3,1,0,0,2
S01008541,Occupancy rating 0,35,1,0,1,32,0,24,0,20,4,8,4,4,2,1,1,0,0
S01008541,Occupancy rating -1 or less,6,0,0,0,5,0,3,0,3,0,2,2,0,1,1,0,0,0
S01008542,All households,337,52,28,24,273,32,213,68,114,31,28,13,15,12,8,1,0,3
S01008542,Occupancy rating +2 or more,248,43,24,19,201,30,155,66,69,20,16,8,8,4,2,0,0,2
S01008542,Occupancy rating +1,53,5,3,2,45,2,37,2,28,7,6,3,3,3,3,0,0,0
S01008542,Occupancy rating 0,25,2,1,1,20,0,17,0,13,4,3,1,2,3,1,1,0,1
S01008542,Occupancy rating -1 or less,11,2,0,2,7,0,4,0,4,0,3,1,2,2,2,0,0,0
S01008543,All households,259,37,17,20,217,13,189,46,103,40,15,9,6,5,1,1,1,2
S01008543,Occupancy rating +2 or more,146,27,11,16,117,12,101,39,47,15,4,3,1,2,0,0,0,2
S01008543,Occupancy rating +1,75,9,6,3,65,1,59,7,34,18,5,4,1,1,0,0,1,0
S01008543,Occupancy rating 0,34,1,0,1,32,0,27,0,21,6,5,2,3,1,0,1,0,0
S01008543,Occupancy rating -1 or less,4,0,0,0,3,0,2,0,1,1,1,0,1,1,1,0,0,0
S01008544,All households,216,31,4,27,183,8,154,29,101,24,21,15,6,2,2,0,0,0
S01008544,Occupancy rating +2 or more,166,15,3,12,150,5,132,25,86,21,13,9,4,1,1,0,0,0
S01008544,Occupancy rating +1,22,6,1,5,15,2,11,2,9,0,2,1,1,1,1,0,0,0
S01008544,Occupancy rating 0,15,1,0,1,14,1,7,0,4,3,6,5,1,0,0,0,0,0
S01008544,Occupancy rating -1 or less,13,9,0,9,4,0,4,2,2,0,0,0,0,0,0,0,0,0
S01008545,All households,334,68,36,32,256,45,201,66,116,19,10,9,1,10,4,0,1,5
S01008545,Occupancy rating +2 or more,277,44,26,18,228,43,180,58,105,17,5,5,0,5,2,0,0,3
S01008545,Occupancy rating +1,39,19,8,11,18,2,15,8,5,2,1,1,0,2,0,0,0,2
S01008545,Occupancy rating 0,11,4,1,3,7,0,3,0,3,0,4,3,1,0,0,0,0,0
S01008545,Occupancy rating -1 or less,7,1,1,0,3,0,3,0,3,0,0,0,0,3,2,0,1,0
S01008546,All households,337,55,45,10,277,52,210,103,72,35,15,6,9,5,1,0,0,4
S01008546,Occupancy rating +2 or more,300,52,43,9,246,48,187,101,59,27,11,5,6,2,1,0,0,1
S01008546,Occupancy rating +1,28,1,1,0,26,4,18,1,9,8,4,1,3,1,0,0,0,1
S01008546,Occupancy rating 0,5,1,1,0,2,0,2,0,2,0,0,0,0,2,0,0,0,2
S01008546,Occupancy rating -1 or less,4,1,0,1,3,0,3,1,2,0,0,0,0,0,0,0,0,0
S01008547,All households,424,108,20,88,303,20,246,111,96,39,37,26,11,13,6,0,0,7
S01008547,Occupancy rating +2 or more,208,54,11,43,151,10,133,72,39,22,8,8,0,3,1,0,0,2
S01008547,Occupancy rating +1,141,47,6,41,92,8,71,36,24,11,13,9,4,2,1,0,0,1
S01008547,Occupancy rating 0,60,7,3,4,48,2,32,2,25,5,14,8,6,5,1,0,0,4
S01008547,Occupancy rating -1 or less,15,0,0,0,12,0,10,1,8,1,2,1,1,3,3,0,0,0
S01008548,All households,347,84,14,70,245,11,192,85,87,20,42,31,11,18,7,1,0,10
S01008548,Occupancy rating +2 or more,130,24,3,21,101,5,88,48,30,10,8,6,2,5,3,0,0,2
S01008548,Occupancy rating +1,120,47,10,37,71,3,58,29,22,7,10,6,4,2,1,0,0,1
S01008548,Occupancy rating 0,75,10,1,9,58,2,37,6,30,1,19,15,4,7,2,0,0,5
S01008548,Occupancy rating -1 or less,22,3,0,3,15,1,9,2,5,2,5,4,1,4,1,1,0,2
S01008549,All households,439,144,57,87,278,39,200,94,74,32,39,27,12,17,6,0,1,10
S01008549,Occupancy rating +2 or more,180,50,17,33,125,22,94,64,16,14,9,5,4,5,3,0,0,2
S01008549,Occupancy rating +1,119,38,16,22,78,10,54,18,27,9,14,8,6,3,0,0,1,2
S01008549,Occupancy rating 0,91,33,16,17,55,7,36,9,20,7,12,10,2,3,0,0,0,3
S01008549,Occupancy rating -1 or less,49,23,8,15,20,0,16,3,11,2,4,4,0,6,3,0,0,3
S01008550,All households,346,102,23,79,231,23,180,85,76,19,28,17,11,13,9,0,0,4
S01008550,Occupancy rating +2 or more,175,30,12,18,141,19,113,57,46,10,9,6,3,4,3,0,0,1
S01008550,Occupancy rating +1,64,17,4,13,46,4,38,13,17,8,4,1,3,1,1,0,0,0
S01008550,Occupancy rating 0,88,47,5,42,34,0,26,14,11,1,8,6,2,7,4,0,0,3
S01008550,Occupancy rating -1 or less,19,8,2,6,10,0,3,1,2,0,7,4,3,1,1,0,0,0
S01008551,All households,496,201,87,114,278,42,203,118,64,21,33,13,20,17,5,1,2,9
S01008551,Occupancy rating +2 or more,138,43,18,25,92,17,72,49,18,5,3,1,2,3,1,0,0,2
S01008551,Occupancy rating +1,226,115,57,58,110,21,81,58,16,7,8,1,7,1,0,0,1,0
S01008551,Occupancy rating 0,97,36,12,24,53,3,35,8,20,7,15,7,8,8,2,1,1,4
S01008551,Occupancy rating -1 or less,35,7,0,7,23,1,15,3,10,2,7,4,3,5,2,0,0,3
S01008552,All households,383,115,49,66,248,47,179,89,63,27,22,14,8,20,10,0,1,9
S01008552,Occupancy rating +2 or more,223,72,42,30,144,41,97,68,21,8,6,2,4,7,4,0,1,2
S01008552,Occupancy rating +1,96,29,6,23,65,6,52,20,21,11,7,5,2,2,1,0,0,1
S01008552,Occupancy rating 0,50,8,1,7,34,0,27,1,18,8,7,5,2,8,3,0,0,5
S01008552,Occupancy rating -1 or less,14,6,0,6,5,0,3,0,3,0,2,2,0,3,2,0,0,1
S01008553,All households,244,77,34,43,142,28,94,54,29,11,20,9,11,25,9,1,2,13
S01008553,Occupancy rating +2 or more,141,54,23,31,79,18,57,45,8,4,4,3,1,8,0,1,0,7
S01008553,Occupancy rating +1,62,18,7,11,37,7,22,8,11,3,8,1,7,7,2,0,2,3
S01008553,Occupancy rating 0,23,3,2,1,17,2,11,1,7,3,4,3,1,3,2,0,0,1
S01008553,Occupancy rating -1 or less,18,2,2,0,9,1,4,0,3,1,4,2,2,7,5,0,0,2
S01008554,All households,368,78,31,47,259,14,146,35,73,38,99,78,21,31,17,0,0,14
S01008554,Occupancy rating +2 or more,103,44,19,25,59,11,42,24,11,7,6,4,2,0,0,0,0,0
S01008554,Occupancy rating +1,83,13,3,10,64,1,37,4,15,18,26,19,7,6,1,0,0,5
S01008554,Occupancy rating 0,115,19,9,10,85,2,42,4,28,10,41,34,7,11,6,0,0,5
S01008554,Occupancy rating -1 or less,67,2,0,2,51,0,25,3,19,3,26,21,5,14,10,0,0,4
S01008555,All households,528,250,63,187,256,15,124,49,64,11,117,93,24,22,6,4,0,12
S01008555,Occupancy rating +2 or more,53,26,5,21,26,3,18,11,5,2,5,5,0,1,0,0,0,1
S01008555,Occupancy rating +1,190,116,17,99,71,8,43,30,10,3,20,14,6,3,1,0,0,2
S01008555,Occupancy rating 0,202,89,32,57,104,1,42,6,31,5,61,47,14,9,1,2,0,6
S01008555,Occupancy rating -1 or less,83,19,9,10,55,3,21,2,18,1,31,27,4,9,4,2,0,3
S01008556,All households,346,129,52,77,196,21,103,41,46,16,72,54,18,21,10,1,2,8
S01008556,Occupancy rating +2 or more,96,41,20,21,52,13,35,22,9,4,4,4,0,3,1,0,0,2
S01008556,Occupancy rating +1,110,59,20,39,46,2,29,13,11,5,15,9,6,5,2,1,1,1
S01008556,Occupancy rating 0,94,18,9,9,70,6,32,6,21,5,32,26,6,6,3,0,1,2
S01008556,Occupancy rating -1 or less,46,11,3,8,28,0,7,0,5,2,21,15,6,7,4,0,0,3
S01008557,All households,429,188,76,112,217,32,98,29,52,17,87,64,23,24,7,0,2,15
S01008557,Occupancy rating +2 or more,83,43,18,25,38,7,20,8,9,3,11,9,2,2,1,0,0,1
S01008557,Occupancy rating +1,127,53,20,33,68,16,34,18,14,2,18,9,9,6,1,0,2,3
S01008557,Occupancy rating 0,160,68,32,36,83,5,34,2,23,9,44,37,7,9,1,0,0,8
S01008557,Occupancy rating -1 or less,59,24,6,18,28,4,10,1,6,3,14,9,5,7,4,0,0,3
S01008558,All households,433,179,80,99,228,23,117,53,42,22,88,57,31,26,8,4,2,12
S01008558,Occupancy rating +2 or more,83,36,19,17,46,8,33,18,11,4,5,4,1,1,0,0,1,0
S01008558,Occupancy rating +1,144,74,33,41,65,10,36,25,8,3,19,10,9,5,0,0,1,4
S01008558,Occupancy rating 0,147,51,22,29,85,4,34,7,16,11,47,27,20,11,2,2,0,7
S01008558,Occupancy rating -1 or less,59,18,6,12,32,1,14,3,7,4,17,16,1,9,6,2,0,1
S01008559,All households,295,85,39,46,191,28,115,48,44,23,48,32,16,19,9,1,0,9
S01008559,Occupancy rating +2 or more,81,22,10,12,58,14,40,26,9,5,4,1,3,1,0,0,0,1
S01008559,Occupancy rating +1,111,48,22,26,60,11,34,19,10,5,15,9,6,3,0,0,0,3
S01008559,Occupancy rating 0,72,10,5,5,55,3,30,3,19,8,22,17,5,7,3,1,0,3
S01008559,Occupancy rating -1 or less,31,5,2,3,18,0,11,0,6,5,7,5,2,8,6,0,0,2
S01008560,All households,295,91,53,38,180,18,103,33,47,23,59,33,26,24,10,0,0,14
S01008560,Occupancy rating +2 or more,65,26,12,14,38,10,20,14,2,4,8,0,8,1,0,0,0,1
S01008560,Occupancy rating +1,109,54,36,18,48,6,33,17,9,7,9,4,5,7,3,0,0,4
S01008560,Occupancy rating 0,86,3,2,1,71,2,40,2,28,10,29,18,11,12,5,0,0,7
S01008560,Occupancy rating -1 or less,35,8,3,5,23,0,10,0,8,2,13,11,2,4,2,0,0,2
S01008561,All households,277,79,35,44,183,17,125,47,59,19,41,27,14,15,6,0,1,8
S01008561,Occupancy rating +2 or more,74,24,10,14,50,8,39,26,7,6,3,0,3,0,0,0,0,0
S01008561,Occupancy rating +1,95,36,18,18,54,8,35,14,17,4,11,7,4,5,2,0,0,3
S01008561,Occupancy rating 0,61,5,2,3,50,0,32,3,23,6,18,12,6,6,1,0,0,5
S01008561,Occupancy rating -1 or less,47,14,5,9,29,1,19,4,12,3,9,8,1,4,3,0,1,0
S01008562,All households,344,184,83,101,152,12,76,31,39,6,64,45,19,8,3,0,1,4
S01008562,Occupancy rating +2 or more,41,16,6,10,23,4,10,8,2,0,9,8,1,2,0,0,1,1
S01008562,Occupancy rating +1,97,46,13,33,49,5,29,14,13,2,15,10,5,2,0,0,0,2
S01008562,Occupancy rating 0,157,97,47,50,58,3,29,8,20,1,26,16,10,2,1,0,0,1
S01008562,Occupancy rating -1 or less,49,25,17,8,22,0,8,1,4,3,14,11,3,2,2,0,0,0
S01008563,All households,369,129,39,90,223,25,127,50,56,21,71,52,19,17,8,0,0,9
S01008563,Occupancy rating +2 or more,74,21,8,13,50,9,35,22,8,5,6,3,3,3,0,0,0,3
S01008563,Occupancy rating +1,126,54,21,33,68,12,39,21,13,5,17,10,7,4,1,0,0,3
S01008563,Occupancy rating 0,115,34,7,27,77,4,40,5,25,10,33,29,4,4,1,0,0,3
S01008563,Occupancy rating -1 or less,54,20,3,17,28,0,13,2,10,1,15,10,5,6,6,0,0,0
S01008564,All households,315,143,68,75,157,24,97,48,30,19,36,20,16,15,5,0,0,10
S01008564,Occupancy rating +2 or more,48,26,11,15,22,6,16,12,3,1,0,0,0,0,0,0,0,0
S01008564,Occupancy rating +1,119,59,27,32,59,14,39,28,7,4,6,3,3,1,0,0,0,1
S01008564,Occupancy rating 0,122,50,27,23,64,4,33,6,16,11,27,15,12,8,3,0,0,5
S01008564,Occupancy rating -1 or less,26,8,3,5,12,0,9,2,4,3,3,2,1,6,2,0,0,4
S01008565,All households,414,144,58,86,248,24,131,44,61,26,93,59,34,22,13,1,0,8
S01008565,Occupancy rating +2 or more,91,36,17,19,52,11,34,20,9,5,7,4,3,3,2,0,0,1
S01008565,Occupancy rating +1,132,55,25,30,74,11,43,17,16,10,20,8,12,3,1,0,0,2
S01008565,Occupancy rating 0,145,46,12,34,87,2,34,4,24,6,51,32,19,12,7,1,0,4
S01008565,Occupancy rating -1 or less,46,7,4,3,35,0,20,3,12,5,15,15,0,4,3,0,0,1
S01008566,All households,433,123,50,73,275,25,167,68,70,29,83,52,31,35,18,0,2,15
S01008566,Occupancy rating +2 or more,118,45,21,24,70,15,49,33,9,7,6,2,4,3,2,0,0,1
S01008566,Occupancy rating +1,145,49,19,30,89,7,54,25,17,12,28,14,14,7,0,0,2,5
S01008566,Occupancy rating 0,103,20,7,13,73,3,42,9,25,8,28,21,7,10,5,0,0,5
S01008566,Occupancy rating -1 or less,67,9,3,6,43,0,22,1,19,2,21,15,6,15,11,0,0,4
S01008567,All households,289,74,22,52,186,19,120,40,66,14,47,23,24,29,15,0,2,12
S01008567,Occupancy rating +2 or more,93,39,16,23,52,13,36,28,8,0,3,1,2,2,2,0,0,0
S01008567,Occupancy rating +1,87,16,2,14,69,4,46,10,29,7,19,7,12,2,0,0,0,2
S01008567,Occupancy rating 0,75,18,4,14,45,2,22,2,17,3,21,11,10,12,6,0,0,6
S01008567,Occupancy rating -1 or less,34,1,0,1,20,0,16,0,12,4,4,4,0,13,7,0,2,4
S01008568,All households,350,115,33,82,220,16,165,66,79,20,39,28,11,15,5,0,1,9
S01008568,Occupancy rating +2 or more,108,41,11,30,64,8,53,31,16,6,3,2,1,3,1,0,1,1
S01008568,Occupancy rating +1,115,43,10,33,69,4,57,27,25,5,8,4,4,3,1,0,0,2
S01008568,Occupancy rating 0,99,23,10,13,69,4,43,6,29,8,22,17,5,7,1,0,0,6
S01008568,Occupancy rating -1 or less,28,8,2,6,18,0,12,2,9,1,6,5,1,2,2,0,0,0
S01008569,All households,400,249,27,222,127,6,60,26,27,7,61,52,9,24,4,3,0,17
S01008569,Occupancy rating +2 or more,24,17,3,14,7,0,7,5,1,1,0,0,0,0,0,0,0,0
S01008569,Occupancy rating +1,153,128,19,109,24,4,17,14,2,1,3,3,0,1,0,0,0,1
S01008569,Occupancy rating 0,151,79,5,74,59,2,23,6,15,2,34,31,3,13,0,2,0,11
S01008569,Occupancy rating -1 or less,72,25,0,25,37,0,13,1,9,3,24,18,6,10,4,1,0,5
S01008570,All households,426,156,37,119,245,12,113,36,62,15,120,82,38,25,13,0,0,12
S01008570,Occupancy rating +2 or more,72,28,12,16,43,7,27,18,9,0,9,5,4,1,1,0,0,0
S01008570,Occupancy rating +1,139,69,13,56,68,5,34,14,13,7,29,16,13,2,0,0,0,2
S01008570,Occupancy rating 0,143,52,9,43,83,0,29,2,23,4,54,38,16,8,3,0,0,5
S01008570,Occupancy rating -1 or less,72,7,3,4,51,0,23,2,17,4,28,23,5,14,9,0,0,5
S01008571,All households,323,129,69,60,180,23,115,52,36,27,42,30,12,14,6,1,1,6
S01008571,Occupancy rating +2 or more,113,43,26,17,69,13,53,35,10,8,3,1,2,1,0,0,0,1
S01008571,Occupancy rating +1,112,49,22,27,59,9,34,10,11,13,16,9,7,4,1,0,0,3
S01008571,Occupancy rating 0,83,35,20,15,44,1,23,6,12,5,20,18,2,4,2,1,0,1
S01008571,Occupancy rating -1 or less,15,2,1,1,8,0,5,1,3,1,3,2,1,5,3,0,1,1
S01008572,All households,346,99,37,62,224,39,140,43,65,32,45,23,22,23,6,1,0,16
S01008572,Occupancy rating +2 or more,146,53,22,31,89,31,53,30,18,5,5,3,2,4,0,1,0,3
S01008572,Occupancy rating +1,137,35,11,24,93,7,66,12,31,23,20,6,14,9,2,0,0,7
S01008572,Occupancy rating 0,48,10,3,7,31,1,16,0,12,4,14,10,4,7,1,0,0,6
S01008572,Occupancy rating -1 or less,15,1,1,0,11,0,5,1,4,0,6,4,2,3,3,0,0,0
S01008573,All households,321,73,22,51,236,17,191,78,92,21,28,23,5,12,6,0,0,6
S01008573,Occupancy rating +2 or more,198,34,14,20,162,11,138,66,63,9,13,10,3,2,1,0,0,1
S01008573,Occupancy rating +1,61,17,6,11,42,4,32,7,17,8,6,5,1,2,1,0,0,1
S01008573,Occupancy rating 0,40,12,1,11,21,2,12,2,8,2,7,7,0,7,3,0,0,4
S01008573,Occupancy rating -1 or less,22,10,1,9,11,0,9,3,4,2,2,1,1,1,1,0,0,0
S01008574,All households,293,70,12,58,207,10,175,74,74,27,22,17,5,16,5,3,0,8
S01008574,Occupancy rating +2 or more,185,44,9,35,135,9,113,59,40,14,13,9,4,6,0,1,0,5
S01008574,Occupancy rating +1,56,15,1,14,40,1,35,12,16,7,4,3,1,1,1,0,0,0
S01008574,Occupancy rating 0,43,9,2,7,28,0,23,3,15,5,5,5,0,6,1,2,0,3
S01008574,Occupancy rating -1 or less,9,2,0,2,4,0,4,0,3,1,0,0,0,3,3,0,0,0
S01008575,All households,335,90,40,50,231,27,178,73,83,22,26,19,7,14,5,1,0,8
S01008575,Occupancy rating +2 or more,245,66,29,37,173,22,138,57,65,16,13,9,4,6,2,0,0,4
S01008575,Occupancy rating +1,58,22,10,12,34,5,25,15,7,3,4,2,2,2,1,0,0,1
S01008575,Occupancy rating 0,24,1,0,1,17,0,10,1,8,1,7,6,1,6,2,1,0,3
S01008575,Occupancy rating -1 or less,8,1,1,0,7,0,5,0,3,2,2,2,0,0,0,0,0,0
S01008576,All households,386,118,55,63,249,42,177,94,50,33,30,13,17,19,3,8,0,8
S01008576,Occupancy rating +2 or more,172,53,29,24,118,29,83,54,16,13,6,1,5,1,0,0,0,1
S01008576,Occupancy rating +1,132,46,18,28,82,11,58,29,15,14,13,6,7,4,1,1,0,2
S01008576,Occupancy rating 0,64,16,7,9,38,0,28,9,14,5,10,6,4,10,0,6,0,4
S01008576,Occupancy rating -1 or less,18,3,1,2,11,2,8,2,5,1,1,0,1,4,2,1,0,1
S01008577,All households,363,122,73,49,229,39,172,73,70,29,18,5,13,12,6,0,2,4
S01008577,Occupancy rating +2 or more,226,60,33,27,162,26,125,58,49,18,11,3,8,4,2,0,1,1
S01008577,Occupancy rating +1,90,41,24,17,44,8,33,10,15,8,3,0,3,5,1,0,1,3
S01008577,Occupancy rating 0,36,16,14,2,19,4,11,3,6,2,4,2,2,1,1,0,0,0
S01008577,Occupancy rating -1 or less,11,5,2,3,4,1,3,2,0,1,0,0,0,2,2,0,0,0
S01008578,All households,291,56,41,15,221,43,166,69,83,14,12,5,7,14,3,1,0,10
S01008578,Occupancy rating +2 or more,258,52,37,15,197,43,146,67,67,12,8,3,5,9,0,1,0,8
S01008578,Occupancy rating +1,25,3,3,0,20,0,16,2,13,1,4,2,2,2,2,0,0,0
S01008578,Occupancy rating 0,5,1,1,0,3,0,3,0,2,1,0,0,0,1,0,0,0,1
S01008578,Occupancy rating -1 or less,3,0,0,0,1,0,1,0,1,0,0,0,0,2,1,0,0,1
S01008579,All households,301,85,47,38,206,51,136,73,46,17,19,11,8,10,3,0,0,7
S01008579,Occupancy rating +2 or more,215,53,35,18,156,47,103,58,34,11,6,2,4,6,2,0,0,4
S01008579,Occupancy rating +1,56,20,9,11,35,4,24,13,6,5,7,4,3,1,0,0,0,1
S01008579,Occupancy rating 0,20,10,3,7,9,0,5,2,3,0,4,3,1,1,1,0,0,0
S01008579,Occupancy rating -1 or less,10,2,0,2,6,0,4,0,3,1,2,2,0,2,0,0,0,2
S01008580,All households,261,99,41,58,150,22,113,57,42,14,15,11,4,12,3,4,0,5
S01008580,Occupancy rating +2 or more,93,22,8,14,66,14,50,31,13,6,2,0,2,5,1,1,0,3
S01008580,Occupancy rating +1,89,40,13,27,46,8,35,24,8,3,3,2,1,3,1,0,0,2
S01008580,Occupancy rating 0,64,34,20,14,27,0,21,2,15,4,6,6,0,3,0,3,0,0
S01008580,Occupancy rating -1 or less,15,3,0,3,11,0,7,0,6,1,4,3,1,1,1,0,0,0
S01008581,All households,464,208,94,114,220,28,137,64,47,26,55,37,18,36,5,5,0,26
S01008581,Occupancy rating +2 or more,70,31,13,18,36,12,21,13,7,1,3,1,2,3,1,0,0,2
S01008581,Occupancy rating +1,179,101,54,47,74,8,60,39,10,11,6,2,4,4,1,0,0,3
S01008581,Occupancy rating 0,164,67,20,47,79,7,35,10,17,8,37,27,10,18,0,4,0,14
S01008581,Occupancy rating -1 or less,51,9,7,2,31,1,21,2,13,6,9,7,2,11,3,1,0,7
S01008582,All households,486,185,72,113,265,24,154,66,67,21,87,50,37,36,6,6,1,23
S01008582,Occupancy rating +2 or more,137,50,28,22,79,13,54,33,16,5,12,4,8,8,1,0,0,7
S01008582,Occupancy rating +1,154,71,23,48,74,8,44,25,13,6,22,7,15,9,2,4,0,3
S01008582,Occupancy rating 0,150,50,15,35,89,3,44,8,30,6,42,29,13,11,1,1,1,8
S01008582,Occupancy rating -1 or less,45,14,6,8,23,0,12,0,8,4,11,10,1,8,2,1,0,5
S01008583,All households,352,155,77,78,162,21,104,39,53,12,37,21,16,35,7,6,0,22
S01008583,Occupancy rating +2 or more,71,33,16,17,34,6,25,15,9,1,3,1,2,4,1,2,0,1
S01008583,Occupancy rating +1,134,81,39,42,51,11,33,21,10,2,7,3,4,2,0,0,0,2
S01008583,Occupancy rating 0,104,34,18,16,51,2,32,3,24,5,17,13,4,19,2,2,0,15
S01008583,Occupancy rating -1 or less,43,7,4,3,26,2,14,0,10,4,10,4,6,10,4,2,0,4
S01008584,All households,394,144,56,88,220,27,134,55,60,19,59,37,22,30,9,10,0,11
S01008584,Occupancy rating +2 or more,104,49,20,29,54,13,38,25,10,3,3,1,2,1,0,0,0,1
S01008584,Occupancy rating +1,126,55,21,34,64,13,39,21,10,8,12,4,8,7,1,2,0,4
S01008584,Occupancy rating 0,123,37,14,23,76,0,44,8,31,5,32,22,10,10,2,5,0,3
S01008584,Occupancy rating -1 or less,41,3,1,2,26,1,13,1,9,3,12,10,2,12,6,3,0,3
S01008585,All households,249,77,33,44,133,9,85,35,36,14,39,19,20,39,14,3,3,19
S01008585,Occupancy rating +2 or more,89,44,24,20,40,5,34,25,7,2,1,0,1,5,2,0,1,2
S01008585,Occupancy rating +1,86,20,5,15,55,2,30,8,15,7,23,10,13,11,3,0,2,6
S01008585,Occupancy rating 0,48,13,4,9,24,0,13,2,9,2,11,7,4,11,3,1,0,7
S01008585,Occupancy rating -1 or less,26,0,0,0,14,2,8,0,5,3,4,2,2,12,6,2,0,4
S01008586,All households,360,143,70,73,177,20,118,41,51,26,39,26,13,40,16,4,2,18
S01008586,Occupancy rating +2 or more,84,35,18,17,47,11,35,22,7,6,1,1,0,2,0,0,0,2
S01008586,Occupancy rating +1,138,72,31,41,58,3,43,15,19,9,12,5,7,8,3,0,0,5
S01008586,Occupancy rating 0,85,24,14,10,47,5,27,3,15,9,15,10,5,14,4,4,1,5
S01008586,Occupancy rating -1 or less,53,12,7,5,25,1,13,1,10,2,11,10,1,16,9,0,1,6
S01008587,All households,316,80,37,43,205,42,149,67,62,20,14,7,7,31,9,7,0,15
S01008587,Occupancy rating +2 or more,214,49,24,25,155,41,110,57,39,14,4,0,4,10,6,0,0,4
S01008587,Occupancy rating +1,55,24,9,15,26,1,24,6,14,4,1,1,0,5,1,1,0,3
S01008587,Occupancy rating 0,35,3,2,1,19,0,13,4,7,2,6,6,0,13,0,5,0,8
S01008587,Occupancy rating -1 or less,12,4,2,2,5,0,2,0,2,0,3,0,3,3,2,1,0,0
S01008588,All households,344,128,70,58,190,26,143,51,78,14,21,13,8,26,2,13,0,11
S01008588,Occupancy rating +2 or more,197,73,41,32,123,19,96,45,47,4,8,5,3,1,0,1,0,0
S01008588,Occupancy rating +1,94,44,24,20,46,6,37,6,24,7,3,1,2,4,1,2,0,1
S01008588,Occupancy rating 0,37,10,5,5,17,1,10,0,7,3,6,4,2,10,0,3,0,7
S01008588,Occupancy rating -1 or less,16,1,0,1,4,0,0,0,0,0,4,3,1,11,1,7,0,3
S01008589,All households,172,59,43,16,107,22,76,30,37,9,9,5,4,6,2,2,1,1
S01008589,Occupancy rating +2 or more,90,24,15,9,66,15,48,25,19,4,3,1,2,0,0,0,0,0
S01008589,Occupancy rating +1,35,10,6,4,24,4,17,3,11,3,3,3,0,1,0,0,1,0
S01008589,Occupancy rating 0,43,24,21,3,15,3,10,1,7,2,2,1,1,4,1,2,0,1
S01008589,Occupancy rating -1 or less,4,1,1,0,2,0,1,1,0,0,1,0,1,1,1,0,0,0
S01008590,All households,413,200,119,81,182,36,121,59,56,6,25,18,7,31,0,16,1,14
S01008590,Occupancy rating +2 or more,96,40,20,20,56,8,43,16,24,3,5,3,2,0,0,0,0,0
S01008590,Occupancy rating +1,177,102,52,50,70,21,45,36,7,2,4,3,1,5,0,2,0,3
S01008590,Occupancy rating 0,122,52,42,10,50,7,30,6,23,1,13,9,4,20,0,8,1,11
S01008590,Occupancy rating -1 or less,18,6,5,1,6,0,3,1,2,0,3,3,0,6,0,6,0,0
S01008591,All households,327,84,25,59,192,26,146,56,74,16,20,8,12,51,8,22,3,18
S01008591,Occupancy rating +2 or more,141,37,17,20,96,16,77,29,38,10,3,3,0,8,2,2,2,2
S01008591,Occupancy rating +1,90,32,8,24,53,9,39,22,13,4,5,2,3,5,2,2,0,1
S01008591,Occupancy rating 0,74,10,0,10,38,1,28,5,21,2,9,3,6,26,1,12,1,12
S01008591,Occupancy rating -1 or less,22,5,0,5,5,0,2,0,2,0,3,0,3,12,3,6,0,3
S01008592,All households,356,143,73,70,171,14,113,35,64,14,44,31,13,42,5,22,0,15
S01008592,Occupancy rating +2 or more,80,29,22,7,49,8,39,15,18,6,2,1,1,2,2,0,0,0
S01008592,Occupancy rating +1,152,100,46,54,47,4,34,19,12,3,9,6,3,5,2,1,0,2
S01008592,Occupancy rating 0,91,10,4,6,56,1,30,0,27,3,25,18,7,25,1,14,0,10
S01008592,Occupancy rating -1 or less,33,4,1,3,19,1,10,1,7,2,8,6,2,10,0,7,0,3
S01008593,All households,309,71,41,30,222,44,164,61,81,22,14,7,7,16,4,5,0,7
S01008593,Occupancy rating +2 or more,252,60,37,23,184,39,135,53,66,16,10,4,6,8,3,0,0,5
S01008593,Occupancy rating +1,35,9,2,7,23,5,16,7,7,2,2,1,1,3,1,1,0,1
S01008593,Occupancy rating 0,16,1,1,0,11,0,11,1,6,4,0,0,0,4,0,3,0,1
S01008593,Occupancy rating -1 or less,6,1,1,0,4,0,2,0,2,0,2,2,0,1,0,1,0,0
S01008594,All households,428,134,53,81,256,39,195,94,85,16,22,14,8,38,5,18,1,14
S01008594,Occupancy rating +2 or more,259,78,40,38,172,31,127,60,54,13,14,8,6,9,3,1,1,4
S01008594,Occupancy rating +1,83,38,12,26,42,5,37,24,12,1,0,0,0,3,0,1,0,2
S01008594,Occupancy rating 0,62,14,0,14,34,2,26,9,15,2,6,5,1,14,2,7,0,5
S01008594,Occupancy rating -1 or less,24,4,1,3,8,1,5,1,4,0,2,1,1,12,0,9,0,3
S01008595,All households,508,302,109,193,183,40,111,60,39,12,32,20,12,23,4,6,2,11
S01008595,Occupancy rating +2 or more,88,30,13,17,54,13,37,19,14,4,4,0,4,4,0,0,0,4
S01008595,Occupancy rating +1,99,53,13,40,43,11,31,17,8,6,1,1,0,3,0,0,0,3
S01008595,Occupancy rating 0,231,165,61,104,56,14,28,22,4,2,14,7,7,10,1,3,2,4
S01008595,Occupancy rating -1 or less,90,54,22,32,30,2,15,2,13,0,13,12,1,6,3,3,0,0
S01008596,All households,455,203,78,125,189,18,118,75,33,10,53,31,22,63,5,31,2,25
S01008596,Occupancy rating +2 or more,33,15,6,9,16,0,14,9,4,1,2,1,1,2,0,0,1,1
S01008596,Occupancy rating +1,193,116,45,71,66,9,50,46,4,0,7,3,4,11,1,4,0,6
S01008596,Occupancy rating 0,160,51,19,32,72,6,38,15,18,5,28,16,12,37,1,21,1,14
S01008596,Occupancy rating -1 or less,69,21,8,13,35,3,16,5,7,4,16,11,5,13,3,6,0,4
S01008597,All households,388,114,61,53,252,47,186,75,84,27,19,10,9,22,4,3,2,13
S01008597,Occupancy rating +2 or more,227,67,35,32,152,34,112,57,41,14,6,0,6,8,2,1,1,4
S01008597,Occupancy rating +1,106,40,22,18,64,10,50,15,25,10,4,3,1,2,0,0,0,2
S01008597,Occupancy rating 0,42,4,1,3,30,3,22,3,17,2,5,4,1,8,1,1,1,5
S01008597,Occupancy rating -1 or less,13,3,3,0,6,0,2,0,1,1,4,3,1,4,1,1,0,2
S01008598,All households,329,90,30,60,137,20,96,44,41,11,21,16,5,102,4,63,0,35
S01008598,Occupancy rating +2 or more,87,27,9,18,52,8,43,21,17,5,1,1,0,8,0,2,0,6
S01008598,Occupancy rating +1,90,40,12,28,41,11,26,15,8,3,4,2,2,9,1,3,0,5
S01008598,Occupancy rating 0,100,18,8,10,34,1,23,7,14,2,10,8,2,48,2,27,0,19
S01008598,Occupancy rating -1 or less,52,5,1,4,10,0,4,1,2,1,6,5,1,37,1,31,0,5
S01008599,All households,366,92,35,57,186,21,151,67,69,15,14,6,8,88,4,46,0,38
S01008599,Occupancy rating +2 or more,191,48,26,22,133,20,107,45,49,13,6,3,3,10,2,1,0,7
S01008599,Occupancy rating +1,72,31,7,24,31,0,29,17,10,2,2,0,2,10,0,4,0,6
S01008599,Occupancy rating 0,70,12,2,10,17,1,12,5,7,0,4,1,3,41,0,27,0,14
S01008599,Occupancy rating -1 or less,33,1,0,1,5,0,3,0,3,0,2,2,0,27,2,14,0,11
S01008600,All households,306,68,30,38,195,22,156,62,89,5,17,12,5,43,7,17,2,17
S01008600,Occupancy rating +2 or more,168,30,14,16,123,20,97,45,48,4,6,4,2,15,4,0,2,9
S01008600,Occupancy rating +1,49,20,9,11,27,2,23,13,10,0,2,1,1,2,0,1,0,1
S01008600,Occupancy rating 0,58,12,5,7,27,0,19,2,16,1,8,6,2,19,2,11,0,6
S01008600,Occupancy rating -1 or less,31,6,2,4,18,0,17,2,15,0,1,1,0,7,1,5,0,1
S01008601,All households,314,104,28,76,83,10,68,41,26,1,5,3,2,127,3,89,0,35
S01008601,Occupancy rating +2 or more,78,39,11,28,32,5,27,16,10,1,0,0,0,7,2,3,0,2
S01008601,Occupancy rating +1,64,27,5,22,29,3,24,21,3,0,2,2,0,8,0,5,0,3
S01008601,Occupancy rating 0,94,33,10,23,17,1,15,4,11,0,1,0,1,44,0,28,0,16
S01008601,Occupancy rating -1 or less,78,5,2,3,5,1,2,0,2,0,2,1,1,68,1,53,0,14
S01008602,All households,323,172,26,146,80,6,66,44,19,3,8,8,0,71,2,40,1,28
S01008602,Occupancy rating +2 or more,36,20,6,14,13,0,13,10,3,0,0,0,0,3,0,2,1,0
S01008602,Occupancy rating +1,124,74,12,62,40,4,35,26,9,0,1,1,0,10,1,1,0,8
S01008602,Occupancy rating 0,115,60,5,55,19,2,10,7,2,1,7,7,0,36,0,22,0,14
S01008602,Occupancy rating -1 or less,48,18,3,15,8,0,8,1,5,2,0,0,0,22,1,15,0,6
S01008603,All households,544,204,30,174,152,10,123,83,32,8,19,10,9,188,0,121,1,66
S01008603,Occupancy rating +2 or more,46,21,4,17,17,2,13,8,4,1,2,2,0,8,0,4,0,4
S01008603,Occupancy rating +1,122,59,9,50,52,5,44,36,6,2,3,1,2,11,0,8,0,3
S01008603,Occupancy rating 0,236,85,12,73,59,2,47,29,15,3,10,5,5,92,0,60,1,31
S01008603,Occupancy rating -1 or less,140,39,5,34,24,1,19,10,7,2,4,2,2,77,0,49,0,28
S01008604,All households,418,170,36,134,151,14,128,76,45,7,9,7,2,97,8,52,0,37
S01008604,Occupancy rating +2 or more,126,49,17,32,68,12,55,26,26,3,1,1,0,9,4,2,0,3
S01008604,Occupancy rating +1,117,54,8,46,48,2,42,33,8,1,4,3,1,15,2,5,0,8
S01008604,Occupancy rating 0,124,52,11,41,24,0,21,13,7,1,3,2,1,48,0,32,0,16
S01008604,Occupancy rating -1 or less,51,15,0,15,11,0,10,4,4,2,1,1,0,25,2,13,0,10
S01008605,All households,337,125,25,100,123,3,104,61,35,8,16,12,4,89,2,49,0,38
S01008605,Occupancy rating +2 or more,88,28,11,17,51,1,46,23,19,4,4,3,1,9,2,2,0,5
S01008605,Occupancy rating +1,94,50,10,40,37,1,33,28,5,0,3,2,1,7,0,2,0,5
S01008605,Occupancy rating 0,100,33,3,30,26,0,19,7,9,3,7,6,1,41,0,26,0,15
S01008605,Occupancy rating -1 or less,55,14,1,13,9,1,6,3,2,1,2,1,1,32,0,19,0,13
S01008606,All households,287,65,34,31,188,19,154,54,83,17,15,12,3,34,2,10,0,22
S01008606,Occupancy rating +2 or more,183,33,19,14,139,14,119,47,61,11,6,4,2,11,2,3,0,6
S01008606,Occupancy rating +1,57,21,8,13,30,5,21,7,11,3,4,3,1,6,0,1,0,5
S01008606,Occupancy rating 0,31,8,6,2,13,0,9,0,8,1,4,4,0,10,0,3,0,7
S01008606,Occupancy rating -1 or less,16,3,1,2,6,0,5,0,3,2,1,1,0,7,0,3,0,4
S01008607,All households,283,103,62,41,165,43,110,39,58,13,12,8,4,15,5,2,0,8
S01008607,Occupancy rating +2 or more,206,56,30,26,140,35,97,37,48,12,8,5,3,10,4,1,0,5
S01008607,Occupancy rating +1,24,8,4,4,13,4,8,1,6,1,1,1,0,3,1,0,0,2
S01008607,Occupancy rating 0,40,31,24,7,7,2,4,0,4,0,1,1,0,2,0,1,0,1
S01008607,Occupancy rating -1 or less,13,8,4,4,5,2,1,1,0,0,2,1,1,0,0,0,0,0
S01008608,All households,326,121,74,47,179,34,131,46,68,17,14,7,7,26,2,8,1,15
S01008608,Occupancy rating +2 or more,213,79,57,22,129,31,91,38,42,11,7,2,5,5,0,0,1,4
S01008608,Occupancy rating +1,74,37,14,23,33,2,28,7,17,4,3,2,1,4,0,2,0,2
S01008608,Occupancy rating 0,27,4,3,1,13,1,8,1,5,2,4,3,1,10,0,4,0,6
S01008608,Occupancy rating -1 or less,12,1,0,1,4,0,4,0,4,0,0,0,0,7,2,2,0,3
S01008609,All households,410,148,87,61,243,45,172,76,84,12,26,18,8,19,5,6,0,8
S01008609,Occupancy rating +2 or more,251,71,43,28,171,37,122,60,51,11,12,6,6,9,5,0,0,4
S01008609,Occupancy rating +1,79,39,17,22,39,5,29,14,15,0,5,4,1,1,0,1,0,0
S01008609,Occupancy rating 0,57,22,15,7,28,3,18,1,16,1,7,6,1,7,0,5,0,2
S01008609,Occupancy rating -1 or less,23,16,12,4,5,0,3,1,2,0,2,2,0,2,0,0,0,2
S01008610,All households,416,192,143,49,173,34,124,52,60,12,15,8,7,51,2,28,1,20
S01008610,Occupancy rating +2 or more,159,37,16,21,119,25,87,36,42,9,7,3,4,3,0,1,0,2
S01008610,Occupancy rating +1,74,40,22,18,26,4,18,8,8,2,4,2,2,8,0,7,0,1
S01008610,Occupancy rating 0,148,102,93,9,24,4,17,7,9,1,3,2,1,22,1,8,0,13
S01008610,Occupancy rating -1 or less,35,13,12,1,4,1,2,1,1,0,1,1,0,18,1,12,1,4
S01008611,All households,592,262,48,214,171,13,143,87,49,7,15,11,4,159,5,111,1,42
S01008611,Occupancy rating +2 or more,103,40,23,17,57,8,49,25,21,3,0,0,0,6,3,2,0,1
S01008611,Occupancy rating +1,130,71,13,58,47,5,39,28,11,0,3,3,0,12,1,7,0,4
S01008611,Occupancy rating 0,244,99,8,91,48,0,38,25,10,3,10,7,3,97,0,72,0,25
S01008611,Occupancy rating -1 or less,115,52,4,48,19,0,17,9,7,1,2,1,1,44,1,30,1,12
S01008612,All households,376,144,22,122,100,3,82,54,27,1,15,8,7,132,4,73,0,55
S01008612,Occupancy rating +2 or more,33,12,3,9,12,1,9,6,3,0,2,0,2,9,0,3,0,6
S01008612,Occupancy rating +1,103,56,10,46,36,1,32,28,4,0,3,2,1,11,0,6,0,5
S01008612,Occupancy rating 0,164,58,8,50,40,1,33,17,15,1,6,2,4,66,1,35,0,30
S01008612,Occupancy rating -1 or less,76,18,1,17,12,0,8,3,5,0,4,4,0,46,3,29,0,14
S01008613,All households,371,148,61,87,130,11,110,57,46,7,9,8,1,93,7,48,0,38
S01008613,Occupancy rating +2 or more,111,23,10,13,81,8,71,31,33,7,2,2,0,7,3,1,0,3
S01008613,Occupancy rating +1,78,42,11,31,21,1,19,16,3,0,1,0,1,15,2,4,0,9
S01008613,Occupancy rating 0,132,71,38,33,19,2,12,8,4,0,5,5,0,42,1,26,0,15
S01008613,Occupancy rating -1 or less,50,12,2,10,9,0,8,2,6,0,1,1,0,29,1,17,0,11
S01008614,All households,307,106,30,76,77,7,64,39,21,4,6,1,5,124,0,85,0,39
S01008614,Occupancy rating +2 or more,64,24,8,16,32,4,27,18,6,3,1,0,1,8,0,5,0,3
S01008614,Occupancy rating +1,75,34,6,28,28,2,23,15,7,1,3,0,3,13,0,8,0,5
S01008614,Occupancy rating 0,104,40,13,27,14,1,12,6,6,0,1,0,1,50,0,35,0,15
S01008614,Occupancy rating -1 or less,64,8,3,5,3,0,2,0,2,0,1,1,0,53,0,37,0,16
S01008615,All households,331,76,15,61,114,6,95,44,44,7,13,8,5,141,4,102,1,34
S01008615,Occupancy rating +2 or more,97,27,8,19,58,5,50,22,25,3,3,1,2,12,0,4,1,7
S01008615,Occupancy rating +1,74,27,3,24,29,0,25,13,10,2,4,3,1,18,1,8,0,9
S01008615,Occupancy rating 0,98,18,2,16,25,1,19,9,8,2,5,4,1,55,2,42,0,11
S01008615,Occupancy rating -1 or less,62,4,2,2,2,0,1,0,1,0,1,0,1,56,1,48,0,7
S01008616,All households,259,42,9,33,74,5,62,25,32,5,7,3,4,143,1,104,0,38
S01008616,Occupancy rating +2 or more,58,29,5,24,26,4,22,14,7,1,0,0,0,3,0,2,0,1
S01008616,Occupancy rating +1,59,7,3,4,30,1,25,7,17,1,4,3,1,22,0,11,0,11
S01008616,Occupancy rating 0,64,4,0,4,15,0,13,4,7,2,2,0,2,45,0,35,0,10
S01008616,Occupancy rating -1 or less,78,2,1,1,3,0,2,0,1,1,1,0,1,73,1,56,0,16
S01008617,All households,281,50,18,32,96,7,74,35,36,3,15,14,1,135,1,106,0,28
S01008617,Occupancy rating +2 or more,93,33,13,20,55,5,48,27,19,2,2,2,0,5,0,2,0,3
S01008617,Occupancy rating +1,59,14,3,11,22,1,18,8,10,0,3,3,0,23,0,13,0,10
S01008617,Occupancy rating 0,68,1,1,0,15,0,6,0,5,1,9,8,1,52,0,44,0,8
S01008617,Occupancy rating -1 or less,61,2,1,1,4,1,2,0,2,0,1,1,0,55,1,47,0,7
S01008618,All households,267,64,15,49,60,2,47,18,27,2,11,9,2,143,2,99,1,41
S01008618,Occupancy rating +2 or more,62,34,6,28,24,1,21,12,8,1,2,1,1,4,1,0,1,2
S01008618,Occupancy rating +1,61,18,7,11,20,1,17,6,11,0,2,1,1,23,0,11,0,12
S01008618,Occupancy rating 0,74,2,0,2,14,0,8,0,7,1,6,6,0,58,1,44,0,13
S01008618,Occupancy rating -1 or less,70,10,2,8,2,0,1,0,1,0,1,1,0,58,0,44,0,14
S01008619,All households,203,58,16,42,56,5,44,21,18,5,7,5,2,89,2,52,0,35
S01008619,Occupancy rating +2 or more,78,40,13,27,30,4,24,16,5,3,2,2,0,8,0,5,0,3
S01008619,Occupancy rating +1,42,13,1,12,14,1,10,2,6,2,3,1,2,15,0,6,0,9
S01008619,Occupancy rating 0,45,2,1,1,9,0,7,1,6,0,2,2,0,34,1,25,0,8
S01008619,Occupancy rating -1 or less,38,3,1,2,3,0,3,2,1,0,0,0,0,32,1,16,0,15
S01008620,All households,290,50,10,40,90,7,73,47,21,5,10,5,5,150,4,99,0,47
S01008620,Occupancy rating +2 or more,96,39,7,32,46,5,41,32,6,3,0,0,0,11,0,4,0,7
S01008620,Occupancy rating +1,63,9,3,6,25,1,23,13,8,2,1,1,0,29,1,18,0,10
S01008620,Occupancy rating 0,77,1,0,1,17,1,8,2,6,0,8,3,5,59,2,40,0,17
S01008620,Occupancy rating -1 or less,54,1,0,1,2,0,1,0,1,0,1,1,0,51,1,37,0,13
S01008621,All households,272,49,16,33,78,3,63,31,23,9,12,12,0,145,8,96,0,41
S01008621,Occupancy rating +2 or more,78,32,13,19,33,2,30,21,6,3,1,1,0,13,0,7,0,6
S01008621,Occupancy rating +1,61,15,2,13,26,1,20,9,7,4,5,5,0,20,3,10,0,7
S01008621,Occupancy rating 0,86,2,1,1,17,0,11,1,9,1,6,6,0,67,3,47,0,17
S01008621,Occupancy rating -1 or less,47,0,0,0,2,0,2,0,1,1,0,0,0,45,2,32,0,11
S01008622,All households,200,58,18,40,72,2,65,30,25,10,5,4,1,70,4,38,0,28
S01008622,Occupancy rating +2 or more,84,36,9,27,40,1,39,27,7,5,0,0,0,8,1,2,0,5
S01008622,Occupancy rating +1,48,19,8,11,20,1,18,2,14,2,1,1,0,9,0,3,0,6
S01008622,Occupancy rating 0,46,3,1,2,9,0,7,1,3,3,2,2,0,34,3,19,0,12
S01008622,Occupancy rating -1 or less,22,0,0,0,3,0,1,0,1,0,2,1,1,19,0,14,0,5
S01008623,All households,343,109,45,64,141,24,109,48,51,10,8,4,4,93,2,59,1,31
S01008623,Occupancy rating +2 or more,131,39,21,18,82,20,60,30,24,6,2,0,2,10,2,2,0,6
S01008623,Occupancy rating +1,101,50,21,29,34,4,27,16,9,2,3,2,1,17,0,7,1,9
S01008623,Occupancy rating 0,58,13,2,11,20,0,18,1,16,1,2,2,0,25,0,18,0,7
S01008623,Occupancy rating -1 or less,53,7,1,6,5,0,4,1,2,1,1,0,1,41,0,32,0,9
S01008624,All households,346,153,97,56,181,48,122,57,54,11,11,5,6,12,4,3,0,5
S01008624,Occupancy rating +2 or more,188,49,27,22,134,41,91,41,43,7,2,1,1,5,3,0,0,2
S01008624,Occupancy rating +1,83,49,32,17,32,6,21,13,6,2,5,3,2,2,1,0,0,1
S01008624,Occupancy rating 0,47,32,26,6,12,1,7,3,4,0,4,1,3,3,0,1,0,2
S01008624,Occupancy rating -1 or less,28,23,12,11,3,0,3,0,1,2,0,0,0,2,0,2,0,0
S01008625,All households,239,65,37,28,170,28,127,47,64,16,15,6,9,4,1,2,0,1
S01008625,Occupancy rating +2 or more,187,34,25,9,151,27,113,42,56,15,11,3,8,2,1,0,0,1
S01008625,Occupancy rating +1,27,12,3,9,15,0,12,4,7,1,3,2,1,0,0,0,0,0
S01008625,Occupancy rating 0,17,15,7,8,1,0,1,1,0,0,0,0,0,1,0,1,0,0
S01008625,Occupancy rating -1 or less,8,4,2,2,3,1,1,0,1,0,1,1,0,1,0,1,0,0
S01008626,All households,388,104,43,61,249,30,197,90,93,14,22,13,9,35,3,10,1,21
S01008626,Occupancy rating +2 or more,215,37,21,16,173,29,135,57,67,11,9,3,6,5,1,0,0,4
S01008626,Occupancy rating +1,98,39,13,26,50,1,44,26,16,2,5,5,0,9,2,0,0,7
S01008626,Occupancy rating 0,49,18,7,11,18,0,14,7,6,1,4,1,3,13,0,5,1,7
S01008626,Occupancy rating -1 or less,26,10,2,8,8,0,4,0,4,0,4,4,0,8,0,5,0,3
S01008627,All households,256,57,24,33,189,21,158,46,95,17,10,8,2,10,3,3,0,4
S01008627,Occupancy rating +2 or more,199,34,20,14,162,20,133,38,79,16,9,7,2,3,2,0,0,1
S01008627,Occupancy rating +1,36,18,3,15,15,1,14,5,8,1,0,0,0,3,1,1,0,1
S01008627,Occupancy rating 0,14,2,0,2,10,0,9,3,6,0,1,1,0,2,0,1,0,1
S01008627,Occupancy rating -1 or less,7,3,1,2,2,0,2,0,2,0,0,0,0,2,0,1,0,1
S01008628,All households,262,80,21,59,138,14,108,63,38,7,16,12,4,44,4,16,1,23
S01008628,Occupancy rating +2 or more,116,36,13,23,73,14,57,32,20,5,2,1,1,7,2,0,1,4
S01008628,Occupancy rating +1,59,26,5,21,26,0,18,10,7,1,8,6,2,7,1,1,0,5
S01008628,Occupancy rating 0,61,11,3,8,31,0,26,17,8,1,5,5,0,19,0,8,0,11
S01008628,Occupancy rating -1 or less,26,7,0,7,8,0,7,4,3,0,1,0,1,11,1,7,0,3
S01008629,All households,301,142,52,90,118,11,90,44,42,4,17,11,6,41,3,16,1,21
S01008629,Occupancy rating +2 or more,125,49,18,31,68,7,56,33,19,4,5,3,2,8,0,3,0,5
S01008629,Occupancy rating +1,92,58,24,34,26,3,20,11,9,0,3,2,1,8,0,2,1,5
S01008629,Occupancy rating 0,51,17,3,14,20,1,11,0,11,0,8,5,3,14,1,3,0,10
S01008629,Occupancy rating -1 or less,33,18,7,11,4,0,3,0,3,0,1,1,0,11,2,8,0,1
S01008630,All households,277,114,45,69,108,9,88,55,29,4,11,8,3,55,1,31,0,23
S01008630,Occupancy rating +2 or more,60,30,15,15,27,3,23,16,6,1,1,1,0,3,1,0,0,2
S01008630,Occupancy rating +1,100,55,27,28,41,5,33,26,6,1,3,1,2,4,0,1,0,3
S01008630,Occupancy rating 0,91,25,3,22,36,1,28,12,15,1,7,6,1,30,0,18,0,12
S01008630,Occupancy rating -1 or less,26,4,0,4,4,0,4,1,2,1,0,0,0,18,0,12,0,6
S01008631,All households,453,238,34,204,158,9,119,76,36,7,30,23,7,57,2,14,0,41
S01008631,Occupancy rating +2 or more,91,41,8,33,44,7,34,17,12,5,3,2,1,6,1,0,0,5
S01008631,Occupancy rating +1,146,87,10,77,53,1,46,40,6,0,6,4,2,6,0,0,0,6
S01008631,Occupancy rating 0,134,67,11,56,42,1,25,15,8,2,16,14,2,25,0,5,0,20
S01008631,Occupancy rating -1 or less,82,43,5,38,19,0,14,4,10,0,5,3,2,20,1,9,0,10
S01008632,All households,420,218,42,176,160,15,134,97,27,10,11,7,4,42,4,10,0,28
S01008632,Occupancy rating +2 or more,83,27,14,13,53,13,40,22,13,5,0,0,0,3,1,0,0,2
S01008632,Occupancy rating +1,125,64,13,51,53,2,49,40,6,3,2,2,0,8,0,0,0,8
S01008632,Occupancy rating 0,161,106,12,94,42,0,36,30,5,1,6,4,2,13,1,4,0,8
S01008632,Occupancy rating -1 or less,51,21,3,18,12,0,9,5,3,1,3,1,2,18,2,6,0,10
S01008633,All households,452,196,116,80,228,53,150,63,70,17,25,21,4,28,4,13,1,10
S01008633,Occupancy rating +2 or more,271,97,57,40,165,40,118,51,54,13,7,5,2,9,3,1,0,5
S01008633,Occupancy rating +1,96,58,31,27,33,8,19,8,8,3,6,5,1,5,1,3,0,1
S01008633,Occupancy rating 0,68,36,26,10,24,3,11,3,7,1,10,9,1,8,0,4,0,4
S01008633,Occupancy rating -1 or less,17,5,2,3,6,2,2,1,1,0,2,2,0,6,0,5,1,0
S01008634,All households,276,66,35,31,161,15,130,49,66,15,16,8,8,49,3,21,0,25
S01008634,Occupancy rating +2 or more,162,42,23,19,113,12,94,46,37,11,7,4,3,7,1,2,0,4
S01008634,Occupancy rating +1,53,14,7,7,31,3,26,3,21,2,2,0,2,8,0,1,0,7
S01008634,Occupancy rating 0,41,10,5,5,12,0,7,0,6,1,5,2,3,19,1,7,0,11
S01008634,Occupancy rating -1 or less,20,0,0,0,5,0,3,0,2,1,2,2,0,15,1,11,0,3
S01008635,All households,362,124,42,82,171,10,149,78,54,17,12,9,3,67,6,31,0,30
S01008635,Occupancy rating +2 or more,189,69,25,44,111,9,97,52,33,12,5,3,2,9,2,1,0,6
S01008635,Occupancy rating +1,86,42,15,27,35,1,32,18,14,0,2,2,0,9,1,2,0,6
S01008635,Occupancy rating 0,65,11,2,9,20,0,17,6,6,5,3,2,1,34,1,21,0,12
S01008635,Occupancy rating -1 or less,22,2,0,2,5,0,3,2,1,0,2,2,0,15,2,7,0,6
S01008636,All households,367,114,52,62,178,26,137,66,60,11,15,8,7,75,5,36,1,33
S01008636,Occupancy rating +2 or more,179,52,20,32,117,20,93,48,36,9,4,0,4,10,2,0,1,7
S01008636,Occupancy rating +1,82,35,17,18,35,5,25,12,11,2,5,4,1,12,1,6,0,5
S01008636,Occupancy rating 0,78,27,15,12,21,1,17,6,11,0,3,1,2,30,1,11,0,18
S01008636,Occupancy rating -1 or less,28,0,0,0,5,0,2,0,2,0,3,3,0,23,1,19,0,3
S01008637,All households,309,106,41,65,156,26,116,63,46,7,14,10,4,47,6,19,0,22
S01008637,Occupancy rating +2 or more,145,43,26,17,96,26,65,36,24,5,5,3,2,6,2,1,0,3
S01008637,Occupancy rating +1,83,35,13,22,39,0,33,18,15,0,6,5,1,9,2,2,0,5
S01008637,Occupancy rating 0,46,17,2,15,15,0,14,8,6,0,1,1,0,14,1,6,0,7
S01008637,Occupancy rating -1 or less,35,11,0,11,6,0,4,1,1,2,2,1,1,18,1,10,0,7
S01008638,All households,344,122,84,38,128,21,95,45,41,9,12,7,5,94,1,43,0,50
S01008638,Occupancy rating +2 or more,93,28,8,20,52,7,42,20,17,5,3,2,1,13,1,3,0,9
S01008638,Occupancy rating +1,83,19,17,2,50,8,40,22,16,2,2,1,1,14,0,6,0,8
S01008638,Occupancy rating 0,111,59,47,12,16,5,8,3,4,1,3,2,1,36,0,19,0,17
S01008638,Occupancy rating -1 or less,57,16,12,4,10,1,5,0,4,1,4,2,2,31,0,15,0,16
S01008639,All households,430,182,28,154,165,4,146,93,42,11,15,14,1,83,5,24,0,54
S01008639,Occupancy rating +2 or more,95,28,8,20,61,2,54,28,18,8,5,5,0,6,1,1,0,4
S01008639,Occupancy rating +1,113,61,14,47,39,0,38,29,8,1,1,1,0,13,0,5,0,8
S01008639,Occupancy rating 0,161,73,6,67,47,1,40,26,12,2,6,6,0,41,4,10,0,27
S01008639,Occupancy rating -1 or less,61,20,0,20,18,1,14,10,4,0,3,2,1,23,0,8,0,15
S01008640,All households,351,108,17,91,135,1,115,76,33,6,19,17,2,108,4,49,0,55
S01008640,Occupancy rating +2 or more,68,21,5,16,42,0,37,22,11,4,5,5,0,5,1,1,0,3
S01008640,Occupancy rating +1,130,54,7,47,58,1,51,35,15,1,6,6,0,18,1,5,0,12
S01008640,Occupancy rating 0,109,30,4,26,29,0,23,17,6,0,6,5,1,50,0,23,0,27
S01008640,Occupancy rating -1 or less,44,3,1,2,6,0,4,2,1,1,2,1,1,35,2,20,0,13
S01008641,All households,351,104,14,90,100,4,82,52,26,4,14,10,4,147,1,70,2,74
S01008641,Occupancy rating +2 or more,100,48,6,42,44,2,38,30,6,2,4,3,1,8,0,0,2,6
S01008641,Occupancy rating +1,99,40,7,33,33,1,26,16,9,1,6,5,1,26,1,10,0,15
S01008641,Occupancy rating 0,97,15,1,14,21,1,17,5,11,1,3,1,2,61,0,29,0,32
S01008641,Occupancy rating -1 or less,55,1,0,1,2,0,1,1,0,0,1,1,0,52,0,31,0,21
S01008642,All households,433,154,27,127,161,12,133,75,47,11,16,13,3,118,4,48,0,66
S01008642,Occupancy rating +2 or more,117,50,15,35,61,8,50,28,19,3,3,3,0,6,2,2,0,2
S01008642,Occupancy rating +1,161,79,8,71,64,4,58,40,13,5,2,2,0,18,0,4,0,14
S01008642,Occupancy rating 0,102,19,4,15,32,0,24,7,14,3,8,6,2,51,1,18,0,32
S01008642,Occupancy rating -1 or less,53,6,0,6,4,0,1,0,1,0,3,2,1,43,1,24,0,18
S01008643,All households,323,111,15,96,153,4,136,78,53,5,13,10,3,59,2,22,0,35
S01008643,Occupancy rating +2 or more,105,30,6,24,68,2,64,26,33,5,2,1,1,7,0,0,0,7
S01008643,Occupancy rating +1,108,53,7,46,48,1,43,35,8,0,4,4,0,7,1,1,0,5
S01008643,Occupancy rating 0,77,23,2,21,28,1,21,12,9,0,6,4,2,26,0,13,0,13
S01008643,Occupancy rating -1 or less,33,5,0,5,9,0,8,5,3,0,1,1,0,19,1,8,0,10
S01008644,All households,386,173,51,122,128,12,100,59,36,5,16,7,9,85,1,44,0,40
S01008644,Occupancy rating +2 or more,60,21,5,16,33,1,30,17,11,2,2,0,2,6,0,4,0,2
S01008644,Occupancy rating +1,123,56,7,49,54,5,47,26,19,2,2,1,1,13,0,5,0,8
S01008644,Occupancy rating 0,142,73,32,41,30,5,19,14,4,1,6,4,2,39,1,15,0,23
S01008644,Occupancy rating -1 or less,61,23,7,16,11,1,4,2,2,0,6,2,4,27,0,20,0,7
S01008645,All households,360,110,35,75,151,12,121,65,50,6,18,15,3,99,3,53,0,43
S01008645,Occupancy rating +2 or more,59,27,5,22,29,4,22,12,10,0,3,3,0,3,1,2,0,0
S01008645,Occupancy rating +1,148,55,20,35,73,5,61,41,17,3,7,5,2,20,0,5,0,15
S01008645,Occupancy rating 0,104,25,10,15,41,2,32,11,19,2,7,6,1,38,1,18,0,19
S01008645,Occupancy rating -1 or less,49,3,0,3,8,1,6,1,4,1,1,1,0,38,1,28,0,9
S01008646,All households,453,216,36,180,164,13,132,90,39,3,19,15,4,73,3,28,0,42
S01008646,Occupancy rating +2 or more,70,28,12,16,37,7,27,19,6,2,3,3,0,5,1,1,0,3
S01008646,Occupancy rating +1,133,67,13,54,52,4,45,33,11,1,3,1,2,14,1,2,0,11
S01008646,Occupancy rating 0,158,67,5,62,54,0,46,28,18,0,8,7,1,37,0,14,0,23
S01008646,Occupancy rating -1 or less,92,54,6,48,21,2,14,10,4,0,5,4,1,17,1,11,0,5
S01008647,All households,330,153,12,141,110,5,102,70,26,6,3,2,1,67,2,22,0,43
S01008647,Occupancy rating +2 or more,38,19,2,17,18,0,18,10,3,5,0,0,0,1,0,0,0,1
S01008647,Occupancy rating +1,114,62,4,58,45,1,44,37,7,0,0,0,0,7,0,2,0,5
S01008647,Occupancy rating 0,134,58,2,56,32,3,26,19,7,0,3,2,1,44,1,15,0,28
S01008647,Occupancy rating -1 or less,44,14,4,10,15,1,14,4,9,1,0,0,0,15,1,5,0,9
S01008648,All households,339,149,27,122,113,7,99,74,22,3,7,4,3,77,3,32,0,42
S01008648,Occupancy rating +2 or more,15,4,1,3,8,1,7,6,1,0,0,0,0,3,0,2,0,1
S01008648,Occupancy rating +1,90,49,7,42,36,2,33,33,0,0,1,1,0,5,0,2,0,3
S01008648,Occupancy rating 0,163,66,15,51,48,4,40,24,14,2,4,3,1,49,0,24,0,25
S01008648,Occupancy rating -1 or less,71,30,4,26,21,0,19,11,7,1,2,0,2,20,3,4,0,13
S01008649,All households,560,330,24,306,182,9,164,142,20,2,9,4,5,48,2,19,0,27
S01008649,Occupancy rating +2 or more,6,4,1,3,2,0,2,2,0,0,0,0,0,0,0,0,0,0
S01008649,Occupancy rating +1,82,40,1,39,40,2,38,34,3,1,0,0,0,2,0,2,0,0
S01008649,Occupancy rating 0,286,181,9,172,82,6,72,68,4,0,4,2,2,23,0,7,0,16
S01008649,Occupancy rating -1 or less,186,105,13,92,58,1,52,38,13,1,5,2,3,23,2,10,0,11
S01008650,All households,470,272,17,255,128,6,118,99,17,2,4,3,1,70,0,25,0,45
S01008650,Occupancy rating +2 or more,22,12,2,10,10,0,10,9,1,0,0,0,0,0,0,0,0,0
S01008650,Occupancy rating +1,81,45,5,40,32,3,29,28,1,0,0,0,0,4,0,1,0,3
S01008650,Occupancy rating 0,181,97,5,92,55,3,49,40,7,2,3,2,1,29,0,13,0,16
S01008650,Occupancy rating -1 or less,186,118,5,113,31,0,30,22,8,0,1,1,0,37,0,11,0,26
S01008651,All households,497,332,21,311,123,5,112,101,9,2,6,4,2,42,1,17,0,24
S01008651,Occupancy rating +2 or more,20,5,3,2,12,1,10,9,1,0,1,0,1,3,0,2,0,1
S01008651,Occupancy rating +1,55,36,3,33,17,1,16,15,1,0,0,0,0,2,0,1,0,1
S01008651,Occupancy rating 0,220,162,6,156,49,2,44,40,3,1,3,2,1,9,1,1,0,7
S01008651,Occupancy rating -1 or less,202,129,9,120,45,1,42,37,4,1,2,2,0,28,0,13,0,15
S01008652,All households,387,253,18,235,93,2,81,68,10,3,10,4,6,41,1,16,1,23
S01008652,Occupancy rating +2 or more,27,22,3,19,4,0,4,3,1,0,0,0,0,1,0,1,0,0
S01008652,Occupancy rating +1,53,32,3,29,13,0,13,12,0,1,0,0,0,8,0,4,0,4
S01008652,Occupancy rating 0,126,75,4,71,35,0,31,27,4,0,4,2,2,16,0,6,1,9
S01008652,Occupancy rating -1 or less,181,124,8,116,41,2,33,26,5,2,6,2,4,16,1,5,0,10
S01008653,All households,402,216,26,190,100,6,77,53,20,4,17,7,10,86,1,38,0,47
S01008653,Occupancy rating +2 or more,15,10,1,9,4,0,4,3,1,0,0,0,0,1,0,1,0,0
S01008653,Occupancy rating +1,84,52,3,49,27,3,19,19,0,0,5,2,3,5,1,1,0,3
S01008653,Occupancy rating 0,156,69,11,58,43,3,31,17,10,4,9,4,5,44,0,23,0,21
S01008653,Occupancy rating -1 or less,147,85,11,74,26,0,23,14,9,0,3,1,2,36,0,13,0,23
S01008654,All households,585,315,23,292,167,4,139,113,22,4,24,16,8,103,3,50,0,50
S01008654,Occupancy rating +2 or more,11,6,0,6,5,0,5,5,0,0,0,0,0,0,0,0,0,0
S01008654,Occupancy rating +1,106,60,2,58,39,1,36,35,1,0,2,0,2,7,0,5,0,2
S01008654,Occupancy rating 0,245,120,14,106,69,3,55,41,11,3,11,8,3,56,1,28,0,27
S01008654,Occupancy rating -1 or less,223,129,7,122,54,0,43,32,10,1,11,8,3,40,2,17,0,21
S01008655,All households,442,199,29,170,126,1,113,86,25,2,12,6,6,117,1,40,0,76
S01008655,Occupancy rating +2 or more,37,16,3,13,18,0,17,11,4,2,1,0,1,3,0,0,0,3
S01008655,Occupancy rating +1,122,75,15,60,36,1,33,32,1,0,2,1,1,11,0,4,0,7
S01008655,Occupancy rating 0,171,71,6,65,39,0,34,22,12,0,5,3,2,61,0,20,0,41
S01008655,Occupancy rating -1 or less,112,37,5,32,33,0,29,21,8,0,4,2,2,42,1,16,0,25
S01008656,All households,426,264,24,240,101,4,86,65,19,2,11,9,2,61,4,24,0,33
S01008656,Occupancy rating +2 or more,16,11,2,9,3,0,2,1,1,0,1,1,0,2,0,1,0,1
S01008656,Occupancy rating +1,67,35,2,33,31,3,26,25,1,0,2,2,0,1,0,0,0,1
S01008656,Occupancy rating 0,134,78,6,72,32,1,25,15,9,1,6,5,1,24,0,10,0,14
S01008656,Occupancy rating -1 or less,209,140,14,126,35,0,33,24,8,1,2,1,1,34,4,13,0,17
S01008657,All households,361,159,27,132,135,5,107,70,33,4,23,16,7,67,4,25,1,37
S01008657,Occupancy rating +2 or more,41,20,2,18,21,2,19,16,3,0,0,0,0,0,0,0,0,0
S01008657,Occupancy rating +1,130,64,16,48,55,2,49,37,11,1,4,1,3,11,0,1,1,9
S01008657,Occupancy rating 0,160,69,8,61,50,1,33,16,14,3,16,12,4,41,1,15,0,25
S01008657,Occupancy rating -1 or less,30,6,1,5,9,0,6,1,5,0,3,3,0,15,3,9,0,3
S01008658,All households,555,302,55,247,155,7,126,102,22,2,22,15,7,98,4,32,1,61
S01008658,Occupancy rating +2 or more,35,19,7,12,13,0,12,10,2,0,1,1,0,3,0,0,1,2
S01008658,Occupancy rating +1,138,79,17,62,50,5,43,39,4,0,2,2,0,9,0,4,0,5
S01008658,Occupancy rating 0,259,155,24,131,63,1,53,42,10,1,9,5,4,41,0,16,0,25
S01008658,Occupancy rating -1 or less,123,49,7,42,29,1,18,11,6,1,10,7,3,45,4,12,0,29
S01008659,All households,446,208,29,179,112,4,90,76,11,3,18,15,3,126,1,64,1,60
S01008659,Occupancy rating +2 or more,26,16,7,9,8,1,7,6,0,1,0,0,0,2,0,1,0,1
S01008659,Occupancy rating +1,86,47,6,41,28,0,24,23,1,0,4,3,1,11,0,4,0,7
S01008659,Occupancy rating 0,195,77,8,69,50,3,37,31,4,2,10,8,2,68,0,41,0,27
S01008659,Occupancy rating -1 or less,139,68,8,60,26,0,22,16,6,0,4,4,0,45,1,18,1,25
S01008660,All households,444,177,13,164,124,4,100,75,23,2,20,13,7,143,6,70,1,66
S01008660,Occupancy rating +2 or more,76,36,4,32,32,0,32,22,9,1,0,0,0,8,0,4,0,4
S01008660,Occupancy rating +1,112,55,4,51,35,3,27,20,7,0,5,2,3,22,1,9,0,12
S01008660,Occupancy rating 0,159,67,4,63,36,0,29,24,4,1,7,5,2,56,0,34,0,22
S01008660,Occupancy rating -1 or less,97,19,1,18,21,1,12,9,3,0,8,6,2,57,5,23,1,28
S01008661,All households,437,228,38,190,119,7,85,65,12,8,27,13,14,90,2,47,0,41
S01008661,Occupancy rating +2 or more,50,26,8,18,23,5,13,11,2,0,5,3,2,1,1,0,0,0
S01008661,Occupancy rating +1,93,58,14,44,31,1,27,23,2,2,3,1,2,4,0,1,0,3
S01008661,Occupancy rating 0,161,83,11,72,41,1,27,20,4,3,13,7,6,37,0,18,0,19
S01008661,Occupancy rating -1 or less,133,61,5,56,24,0,18,11,4,3,6,2,4,48,1,28,0,19
S01008662,All households,276,136,9,127,43,0,33,24,7,2,10,9,1,97,1,53,0,43
S01008662,Occupancy rating +2 or more,12,10,1,9,1,0,1,1,0,0,0,0,0,1,0,1,0,0
S01008662,Occupancy rating +1,45,28,2,26,8,0,8,6,0,2,0,0,0,9,0,3,0,6
S01008662,Occupancy rating 0,156,78,6,72,25,0,17,14,3,0,8,7,1,53,0,27,0,26
S01008662,Occupancy rating -1 or less,63,20,0,20,9,0,7,3,4,0,2,2,0,34,1,22,0,11
S01008663,All households,434,198,44,154,99,5,74,62,9,3,20,11,9,137,5,70,1,61
S01008663,Occupancy rating +2 or more,36,16,2,14,15,0,15,12,1,2,0,0,0,5,3,1,0,1
S01008663,Occupancy rating +1,85,37,10,27,32,1,29,26,3,0,2,1,1,16,0,9,0,7
S01008663,Occupancy rating 0,177,85,25,60,34,3,16,14,2,0,15,9,6,58,0,28,1,29
S01008663,Occupancy rating -1 or less,136,60,7,53,18,1,14,10,3,1,3,1,2,58,2,32,0,24
S01008664,All households,396,187,22,165,111,6,97,78,16,3,8,6,2,98,2,47,0,49
S01008664,Occupancy rating +2 or more,40,14,2,12,24,2,20,18,2,0,2,1,1,2,0,0,0,2
S01008664,Occupancy rating +1,105,65,11,54,30,3,25,21,3,1,2,2,0,10,1,4,0,5
S01008664,Occupancy rating 0,179,92,7,85,44,0,41,29,10,2,3,2,1,43,0,19,0,24
S01008664,Occupancy rating -1 or less,72,16,2,14,13,1,11,10,1,0,1,1,0,43,1,24,0,18
S01008665,All households,524,253,24,229,156,3,128,94,29,5,25,21,4,115,8,33,0,74
S01008665,Occupancy rating +2 or more,49,21,3,18,20,0,17,12,5,0,3,3,0,8,1,2,0,5
S01008665,Occupancy rating +1,122,65,4,61,43,2,39,30,8,1,2,2,0,14,2,6,0,6
S01008665,Occupancy rating 0,210,115,12,103,52,1,46,35,10,1,5,4,1,43,1,14,0,28
S01008665,Occupancy rating -1 or less,143,52,5,47,41,0,26,17,6,3,15,12,3,50,4,11,0,35
S01008666,All households,311,85,20,65,84,5,71,40,28,3,8,4,4,142,2,72,1,67
S01008666,Occupancy rating +2 or more,65,26,6,20,28,4,23,13,9,1,1,1,0,11,0,2,1,8
S01008666,Occupancy rating +1,58,19,9,10,24,1,20,13,7,0,3,3,0,15,0,8,0,7
S01008666,Occupancy rating 0,107,26,4,22,24,0,22,13,7,2,2,0,2,57,1,31,0,25
S01008666,Occupancy rating -1 or less,81,14,1,13,8,0,6,1,5,0,2,0,2,59,1,31,0,27
S01008667,All households,308,101,16,85,115,10,75,42,26,7,30,17,13,92,4,44,1,43
S01008667,Occupancy rating +2 or more,83,32,11,21,42,7,31,18,12,1,4,2,2,9,1,0,1,7
S01008667,Occupancy rating +1,86,35,4,31,34,3,25,16,6,3,6,4,2,17,0,6,0,11
S01008667,Occupancy rating 0,86,18,0,18,28,0,11,4,5,2,17,9,8,40,2,21,0,17
S01008667,Occupancy rating -1 or less,53,16,1,15,11,0,8,4,3,1,3,2,1,26,1,17,0,8
S01008668,All households,280,109,18,91,81,4,65,55,8,2,12,9,3,90,1,63,0,26
S01008668,Occupancy rating +2 or more,18,11,1,10,6,0,5,5,0,0,1,0,1,1,0,1,0,0
S01008668,Occupancy rating +1,60,32,5,27,22,3,19,19,0,0,0,0,0,6,0,4,0,2
S01008668,Occupancy rating 0,133,45,8,37,41,0,34,27,6,1,7,6,1,47,0,30,0,17
S01008668,Occupancy rating -1 or less,69,21,4,17,12,1,7,4,2,1,4,3,1,36,1,28,0,7
S01008669,All households,173,25,3,22,28,3,16,6,7,3,9,6,3,120,3,84,1,32
S01008669,Occupancy rating +2 or more,20,7,1,6,9,3,5,3,2,0,1,0,1,4,0,3,0,1
S01008669,Occupancy rating +1,31,9,2,7,9,0,7,3,3,1,2,2,0,13,1,8,1,3
S01008669,Occupancy rating 0,71,8,0,8,5,0,3,0,1,2,2,0,2,58,0,41,0,17
S01008669,Occupancy rating -1 or less,51,1,0,1,5,0,1,0,1,0,4,4,0,45,2,32,0,11
S01008670,All households,260,63,16,47,50,5,39,23,10,6,6,5,1,147,8,104,1,34
S01008670,Occupancy rating +2 or more,41,21,5,16,16,2,14,8,3,3,0,0,0,4,0,2,0,2
S01008670,Occupancy rating +1,42,15,7,8,14,2,11,8,2,1,1,1,0,13,1,7,0,5
S01008670,Occupancy rating 0,106,17,2,15,15,1,10,6,3,1,4,4,0,74,2,56,1,15
S01008670,Occupancy rating -1 or less,71,10,2,8,5,0,4,1,2,1,1,0,1,56,5,39,0,12
S01008671,All households,331,126,24,102,46,4,33,28,4,1,9,5,4,159,2,112,0,45
S01008671,Occupancy rating +2 or more,25,13,4,9,9,2,7,5,1,1,0,0,0,3,1,2,0,0
S01008671,Occupancy rating +1,75,46,12,34,14,1,10,9,1,0,3,2,1,15,0,9,0,6
S01008671,Occupancy rating 0,153,53,7,46,17,1,11,9,2,0,5,3,2,83,0,55,0,28
S01008671,Occupancy rating -1 or less,78,14,1,13,6,0,5,5,0,0,1,0,1,58,1,46,0,11
S01008672,All households,341,141,39,102,81,6,67,46,17,4,8,7,1,119,2,79,1,37
S01008672,Occupancy rating +2 or more,37,21,3,18,11,1,10,5,3,2,0,0,0,5,1,3,0,1
S01008672,Occupancy rating +1,59,23,6,17,21,1,16,11,3,2,4,4,0,15,0,10,0,5
S01008672,Occupancy rating 0,161,73,26,47,40,4,34,28,6,0,2,2,0,48,1,33,0,14
S01008672,Occupancy rating -1 or less,84,24,4,20,9,0,7,2,5,0,2,1,1,51,0,33,1,17
S01008673,All households,649,368,28,340,157,6,128,96,29,3,23,19,4,124,3,84,0,37
S01008673,Occupancy rating +2 or more,49,26,2,24,20,2,14,9,5,0,4,4,0,3,0,2,0,1
S01008673,Occupancy rating +1,123,79,12,67,32,1,30,27,2,1,1,1,0,12,1,8,0,3
S01008673,Occupancy rating 0,241,134,9,125,57,1,44,34,8,2,12,8,4,50,2,33,0,15
S01008673,Occupancy rating -1 or less,236,129,5,124,48,2,40,26,14,0,6,6,0,59,0,41,0,18
S01008674,All households,413,196,21,175,88,5,71,56,12,3,12,9,3,129,1,84,0,44
S01008674,Occupancy rating +2 or more,21,12,2,10,7,0,7,6,1,0,0,0,0,2,0,2,0,0
S01008674,Occupancy rating +1,82,47,6,41,22,4,15,12,1,2,3,2,1,13,0,7,0,6
S01008674,Occupancy rating 0,181,89,11,78,36,0,32,24,7,1,4,3,1,56,0,30,0,26
S01008674,Occupancy rating -1 or less,129,48,2,46,23,1,17,14,3,0,5,4,1,58,1,45,0,12
S01008675,All households,476,302,49,253,111,3,93,77,13,3,15,10,5,63,5,27,0,31
S01008675,Occupancy rating +2 or more,47,30,8,22,17,3,12,11,1,0,2,2,0,0,0,0,0,0
S01008675,Occupancy rating +1,63,37,9,28,22,0,21,17,3,1,1,1,0,4,0,4,0,0
S01008675,Occupancy rating 0,187,120,18,102,35,0,31,27,3,1,4,2,2,32,1,15,0,16
S01008675,Occupancy rating -1 or less,179,115,14,101,37,0,29,22,6,1,8,5,3,27,4,8,0,15
S01008676,All households,338,131,15,116,112,6,89,72,14,3,17,10,7,95,4,36,1,54
S01008676,Occupancy rating +2 or more,71,28,3,25,35,3,29,20,7,2,3,0,3,8,2,2,0,4
S01008676,Occupancy rating +1,84,36,5,31,35,2,29,28,1,0,4,2,2,13,0,2,0,11
S01008676,Occupancy rating 0,131,47,5,42,27,1,22,16,5,1,4,4,0,57,1,24,1,31
S01008676,Occupancy rating -1 or less,52,20,2,18,15,0,9,8,1,0,6,4,2,17,1,8,0,8
S01008677,All households,420,197,20,177,98,5,78,64,13,1,15,8,7,125,2,68,1,54
S01008677,Occupancy rating +2 or more,29,22,2,20,7,1,5,5,0,0,1,0,1,0,0,0,0,0
S01008677,Occupancy rating +1,85,41,8,33,29,3,25,25,0,0,1,0,1,15,0,2,0,13
S01008677,Occupancy rating 0,174,80,6,74,43,1,31,25,5,1,11,8,3,51,0,35,0,16
S01008677,Occupancy rating -1 or less,132,54,4,50,19,0,17,9,8,0,2,0,2,59,2,31,1,25
S01008678,All households,393,164,10,154,82,1,63,50,13,0,18,14,4,147,0,102,0,45
S01008678,Occupancy rating +2 or more,13,6,0,6,6,1,5,4,1,0,0,0,0,1,0,1,0,0
S01008678,Occupancy rating +1,77,44,6,38,20,0,18,18,0,0,2,2,0,13,0,9,0,4
S01008678,Occupancy rating 0,178,70,0,70,39,0,28,19,9,0,11,8,3,69,0,50,0,19
S01008678,Occupancy rating -1 or less,125,44,4,40,17,0,12,9,3,0,5,4,1,64,0,42,0,22
S01008679,All households,546,346,67,279,89,6,59,47,8,4,24,18,6,111,1,71,2,37
S01008679,Occupancy rating +2 or more,27,17,0,17,7,0,6,5,0,1,1,1,0,3,0,1,0,2
S01008679,Occupancy rating +1,78,48,7,41,24,2,20,17,1,2,2,1,1,6,0,4,0,2
S01008679,Occupancy rating 0,251,170,51,119,39,2,19,15,3,1,18,14,4,42,1,22,0,19
S01008679,Occupancy rating -1 or less,190,111,9,102,19,2,14,10,4,0,3,2,1,60,0,44,2,14
S01008680,All households,326,163,14,149,79,2,64,51,10,3,13,9,4,84,1,57,0,26
S01008680,Occupancy rating +2 or more,15,7,0,7,7,1,5,3,1,1,1,0,1,1,0,1,0,0
S01008680,Occupancy rating +1,67,38,5,33,20,0,20,20,0,0,0,0,0,9,0,6,0,3
S01008680,Occupancy rating 0,133,69,5,64,28,1,21,15,4,2,6,3,3,36,0,23,0,13
S01008680,Occupancy rating -1 or less,111,49,4,45,24,0,18,13,5,0,6,6,0,38,1,27,0,10
S01008681,All households,540,281,77,204,99,8,75,65,10,0,16,12,4,160,3,122,0,35
S01008681,Occupancy rating +2 or more,21,14,3,11,2,0,2,2,0,0,0,0,0,5,1,2,0,2
S01008681,Occupancy rating +1,103,73,16,57,26,5,20,19,1,0,1,0,1,4,0,3,0,1
S01008681,Occupancy rating 0,282,162,46,116,58,3,45,41,4,0,10,9,1,62,0,41,0,21
S01008681,Occupancy rating -1 or less,134,32,12,20,13,0,8,3,5,0,5,3,2,89,2,76,0,11
S01008682,All households,431,209,34,175,119,5,88,56,25,7,26,18,8,103,2,57,0,44
S01008682,Occupancy rating +2 or more,23,11,2,9,12,1,9,4,5,0,2,2,0,0,0,0,0,0
S01008682,Occupancy rating +1,88,55,14,41,26,2,21,19,1,1,3,2,1,7,0,2,0,5
S01008682,Occupancy rating 0,193,84,12,72,47,2,36,20,11,5,9,5,4,62,1,35,0,26
S01008682,Occupancy rating -1 or less,127,59,6,53,34,0,22,13,8,1,12,9,3,34,1,20,0,13
S01008683,All households,576,277,60,217,180,4,97,55,30,12,79,58,21,119,9,60,0,50
S01008683,Occupancy rating +2 or more,35,16,6,10,17,1,11,7,4,0,5,3,2,2,1,0,0,1
S01008683,Occupancy rating +1,145,90,25,65,45,3,32,26,3,3,10,7,3,10,0,5,0,5
S01008683,Occupancy rating 0,249,114,20,94,84,0,40,18,16,6,44,31,13,51,3,24,0,24
S01008683,Occupancy rating -1 or less,147,57,9,48,34,0,14,4,7,3,20,17,3,56,5,31,0,20
S01008684,All households,532,285,42,243,179,8,98,56,34,8,73,59,14,68,6,24,3,35
S01008684,Occupancy rating +2 or more,44,18,6,12,23,5,17,11,6,0,1,1,0,3,0,2,0,1
S01008684,Occupancy rating +1,141,98,24,74,35,1,29,23,4,2,5,3,2,8,0,2,1,5
S01008684,Occupancy rating 0,255,140,9,131,85,1,39,18,16,5,45,38,7,30,0,11,2,17
S01008684,Occupancy rating -1 or less,92,29,3,26,36,1,13,4,8,1,22,17,5,27,6,9,0,12
S01008685,All households,489,274,39,235,134,15,95,67,25,3,24,15,9,81,0,39,1,41
S01008685,Occupancy rating +2 or more,46,25,4,21,20,7,12,9,3,0,1,1,0,1,0,1,0,0
S01008685,Occupancy rating +1,139,95,15,80,34,5,29,25,4,0,0,0,0,10,0,6,1,3
S01008685,Occupancy rating 0,216,110,17,93,59,2,43,26,14,3,14,11,3,47,0,22,0,25
S01008685,Occupancy rating -1 or less,88,44,3,41,21,1,11,7,4,0,9,3,6,23,0,10,0,13
S01008686,All households,585,338,118,220,190,22,125,87,29,9,43,32,11,57,2,12,1,42
S01008686,Occupancy rating +2 or more,40,21,4,17,16,6,9,6,2,1,1,1,0,3,0,1,0,2
S01008686,Occupancy rating +1,114,60,22,38,48,7,37,24,11,2,4,2,2,6,1,2,0,3
S01008686,Occupancy rating 0,308,189,80,109,89,8,52,39,9,4,29,22,7,30,0,7,0,23
S01008686,Occupancy rating -1 or less,123,68,12,56,37,1,27,18,7,2,9,7,2,18,1,2,1,14
S01008687,All households,419,225,20,205,141,5,118,107,11,0,18,12,6,53,0,17,0,36
S01008687,Occupancy rating +2 or more,13,3,1,2,7,0,7,6,1,0,0,0,0,3,0,2,0,1
S01008687,Occupancy rating +1,106,56,7,49,42,2,39,38,1,0,1,0,1,8,0,1,0,7
S01008687,Occupancy rating 0,170,100,7,93,45,2,36,32,4,0,7,5,2,25,0,9,0,16
S01008687,Occupancy rating -1 or less,130,66,5,61,47,1,36,31,5,0,10,7,3,17,0,5,0,12
S01008688,All households,457,216,18,198,187,2,162,117,40,5,23,18,5,54,4,14,0,36
S01008688,Occupancy rating +2 or more,71,27,6,21,40,2,37,25,9,3,1,1,0,4,1,0,0,3
S01008688,Occupancy rating +1,117,57,5,52,55,0,54,46,6,2,1,0,1,5,0,2,0,3
S01008688,Occupancy rating 0,169,79,3,76,62,0,51,34,17,0,11,10,1,28,0,9,0,19
S01008688,Occupancy rating -1 or less,100,53,4,49,30,0,20,12,8,0,10,7,3,17,3,3,0,11
S01008689,All households,548,313,65,248,185,14,156,120,31,5,15,9,6,50,2,12,0,36
S01008689,Occupancy rating +2 or more,42,17,1,16,23,2,20,15,5,0,1,0,1,2,0,1,0,1
S01008689,Occupancy rating +1,110,54,7,47,52,4,48,40,5,3,0,0,0,4,1,3,0,0
S01008689,Occupancy rating 0,274,179,50,129,74,6,62,47,13,2,6,4,2,21,0,3,0,18
S01008689,Occupancy rating -1 or less,122,63,7,56,36,2,26,18,8,0,8,5,3,23,1,5,0,17
S01008690,All households,598,309,45,264,216,12,182,139,36,7,22,17,5,73,8,12,2,51
S01008690,Occupancy rating +2 or more,60,22,7,15,36,1,34,27,6,1,1,0,1,2,0,0,0,2
S01008690,Occupancy rating +1,170,87,7,80,74,4,66,54,10,2,4,3,1,9,2,0,2,5
S01008690,Occupancy rating 0,260,148,28,120,77,5,60,45,12,3,12,11,1,35,2,5,0,28
S01008690,Occupancy rating -1 or less,108,52,3,49,29,2,22,13,8,1,5,3,2,27,4,7,0,16
S01008691,All households,678,390,42,348,222,7,196,156,36,4,19,12,7,66,0,15,0,51
S01008691,Occupancy rating +2 or more,38,26,4,22,12,0,12,10,2,0,0,0,0,0,0,0,0,0
S01008691,Occupancy rating +1,180,90,14,76,78,3,73,67,5,1,2,1,1,12,0,2,0,10
S01008691,Occupancy rating 0,290,171,16,155,86,3,71,50,19,2,12,8,4,33,0,11,0,22
S01008691,Occupancy rating -1 or less,170,103,8,95,46,1,40,29,10,1,5,3,2,21,0,2,0,19
S01008692,All households,391,217,20,197,130,12,110,83,17,10,8,6,2,44,1,9,1,33
S01008692,Occupancy rating +2 or more,26,9,2,7,16,2,14,9,1,4,0,0,0,1,0,0,0,1
S01008692,Occupancy rating +1,90,54,4,50,29,8,20,20,0,0,1,1,0,7,0,2,0,5
S01008692,Occupancy rating 0,187,107,11,96,59,2,53,39,12,2,4,4,0,21,0,3,0,18
S01008692,Occupancy rating -1 or less,88,47,3,44,26,0,23,15,4,4,3,1,2,15,1,4,1,9
S01008693,All households,224,70,38,32,138,32,95,36,41,18,11,4,7,16,4,0,1,11
S01008693,Occupancy rating +2 or more,66,19,7,12,45,13,32,20,11,1,0,0,0,2,0,0,0,2
S01008693,Occupancy rating +1,100,43,25,18,55,17,35,16,10,9,3,3,0,2,0,0,0,2
S01008693,Occupancy rating 0,46,6,4,2,31,1,23,0,16,7,7,1,6,9,2,0,1,6
S01008693,Occupancy rating -1 or less,12,2,2,0,7,1,5,0,4,1,1,0,1,3,2,0,0,1
S01008694,All households,537,230,35,195,241,16,198,127,61,10,27,18,9,66,3,12,0,51
S01008694,Occupancy rating +2 or more,72,33,6,27,38,5,33,26,7,0,0,0,0,1,0,0,0,1
S01008694,Occupancy rating +1,194,89,20,69,96,8,82,63,15,4,6,4,2,9,0,0,0,9
S01008694,Occupancy rating 0,177,59,4,55,81,3,61,27,33,1,17,10,7,37,0,7,0,30
S01008694,Occupancy rating -1 or less,94,49,5,44,26,0,22,11,6,5,4,4,0,19,3,5,0,11
S01008695,All households,338,111,32,79,195,9,154,80,65,9,32,23,9,32,4,5,0,23
S01008695,Occupancy rating +2 or more,107,36,9,27,69,6,61,38,20,3,2,1,1,2,0,1,0,1
S01008695,Occupancy rating +1,115,48,19,29,60,2,48,30,17,1,10,8,2,7,0,0,0,7
S01008695,Occupancy rating 0,90,24,4,20,50,1,39,12,23,4,10,6,4,16,2,4,0,10
S01008695,Occupancy rating -1 or less,26,3,0,3,16,0,6,0,5,1,10,8,2,7,2,0,0,5
S01008696,All households,285,75,36,39,199,21,155,63,75,17,23,13,10,11,5,0,0,6
S01008696,Occupancy rating +2 or more,154,39,23,16,110,17,83,44,31,8,10,7,3,5,2,0,0,3
S01008696,Occupancy rating +1,89,30,12,18,57,4,47,19,26,2,6,3,3,2,1,0,0,1
S01008696,Occupancy rating 0,28,2,0,2,23,0,17,0,12,5,6,2,4,3,2,0,0,1
S01008696,Occupancy rating -1 or less,14,4,1,3,9,0,8,0,6,2,1,1,0,1,0,0,0,1
S01008697,All households,453,106,51,55,317,57,230,101,88,41,30,16,14,30,6,2,0,22
S01008697,Occupancy rating +2 or more,255,56,36,20,191,44,138,70,45,23,9,4,5,8,2,0,0,6
S01008697,Occupancy rating +1,114,38,13,25,73,9,58,24,25,9,6,2,4,3,0,0,0,3
S01008697,Occupancy rating 0,66,9,0,9,42,3,26,7,12,7,13,9,4,15,2,1,0,12
S01008697,Occupancy rating -1 or less,18,3,2,1,11,1,8,0,6,2,2,1,1,4,2,1,0,1
S01008698,All households,209,61,42,19,140,23,104,36,42,26,13,6,7,8,3,0,0,5
S01008698,Occupancy rating +2 or more,134,40,33,7,92,22,63,29,21,13,7,3,4,2,1,0,0,1
S01008698,Occupancy rating +1,43,13,6,7,30,1,26,6,12,8,3,1,2,0,0,0,0,0
S01008698,Occupancy rating 0,26,7,2,5,14,0,11,1,5,5,3,2,1,5,1,0,0,4
S01008698,Occupancy rating -1 or less,6,1,1,0,4,0,4,0,4,0,0,0,0,1,1,0,0,0
S01008699,All households,470,214,109,105,229,38,122,51,50,21,69,48,21,27,8,0,1,18
S01008699,Occupancy rating +2 or more,79,37,21,16,40,12,26,12,9,5,2,0,2,2,1,0,0,1
S01008699,Occupancy rating +1,181,100,48,52,79,22,48,27,15,6,9,6,3,2,0,0,0,2
S01008699,Occupancy rating 0,163,63,30,33,88,4,37,11,21,5,47,34,13,12,1,0,1,10
S01008699,Occupancy rating -1 or less,47,14,10,4,22,0,11,1,5,5,11,8,3,11,6,0,0,5
S01008700,All households,248,68,32,36,167,42,110,51,47,12,15,11,4,13,7,0,0,6
S01008700,Occupancy rating +2 or more,160,47,24,23,109,36,72,36,27,9,1,0,1,4,2,0,0,2
S01008700,Occupancy rating +1,46,11,5,6,32,4,23,11,11,1,5,3,2,3,2,0,0,1
S01008700,Occupancy rating 0,30,6,2,4,21,1,12,3,7,2,8,7,1,3,1,0,0,2
S01008700,Occupancy rating -1 or less,12,4,1,3,5,1,3,1,2,0,1,1,0,3,2,0,0,1
S01008701,All households,200,103,14,89,89,2,59,26,28,5,28,18,10,8,4,0,0,4
S01008701,Occupancy rating +2 or more,32,16,0,16,16,0,12,6,6,0,4,2,2,0,0,0,0,0
S01008701,Occupancy rating +1,45,18,2,16,26,0,21,10,9,2,5,2,3,1,1,0,0,0
S01008701,Occupancy rating 0,77,45,11,34,28,1,18,7,9,2,9,8,1,4,2,0,0,2
S01008701,Occupancy rating -1 or less,46,24,1,23,19,1,8,3,4,1,10,6,4,3,1,0,0,2
S01008702,All households,312,131,10,121,145,5,106,75,27,4,34,30,4,36,6,15,0,15
S01008702,Occupancy rating +2 or more,16,6,0,6,9,1,7,4,2,1,1,1,0,1,0,0,0,1
S01008702,Occupancy rating +1,69,33,3,30,34,3,29,28,1,0,2,2,0,2,1,0,0,1
S01008702,Occupancy rating 0,128,59,4,55,61,1,45,32,12,1,15,14,1,8,0,3,0,5
S01008702,Occupancy rating -1 or less,99,33,3,30,41,0,25,11,12,2,16,13,3,25,5,12,0,8
S01008703,All households,456,199,38,161,228,8,139,57,68,14,81,61,20,29,7,2,0,20
S01008703,Occupancy rating +2 or more,70,23,3,20,44,0,29,21,6,2,15,12,3,3,1,0,0,2
S01008703,Occupancy rating +1,162,81,14,67,72,3,47,23,22,2,22,18,4,9,3,0,0,6
S01008703,Occupancy rating 0,159,73,14,59,73,5,40,13,21,6,28,20,8,13,1,2,0,10
S01008703,Occupancy rating -1 or less,65,22,7,15,39,0,23,0,19,4,16,11,5,4,2,0,0,2
S01008704,All households,307,109,20,89,173,12,102,39,48,15,59,37,22,25,12,1,0,12
S01008704,Occupancy rating +2 or more,101,51,12,39,47,8,29,14,10,5,10,6,4,3,2,0,0,1
S01008704,Occupancy rating +1,87,33,4,29,52,1,33,15,11,7,18,12,6,2,0,0,0,2
S01008704,Occupancy rating 0,77,20,4,16,49,1,30,6,21,3,18,11,7,8,2,0,0,6
S01008704,Occupancy rating -1 or less,42,5,0,5,25,2,10,4,6,0,13,8,5,12,8,1,0,3
S01008705,All households,236,100,42,58,120,7,67,22,36,9,46,31,15,16,5,1,0,10
S01008705,Occupancy rating +2 or more,39,18,3,15,19,3,13,6,4,3,3,1,2,2,0,0,0,2
S01008705,Occupancy rating +1,76,37,11,26,39,1,28,15,9,4,10,8,2,0,0,0,0,0
S01008705,Occupancy rating 0,91,37,22,15,47,1,22,0,20,2,24,18,6,7,2,0,0,5
S01008705,Occupancy rating -1 or less,30,8,6,2,15,2,4,1,3,0,9,4,5,7,3,1,0,3
S01008706,All households,243,87,21,66,143,5,77,21,46,10,61,47,14,13,7,1,1,4
S01008706,Occupancy rating +2 or more,25,16,3,13,9,1,5,3,2,0,3,2,1,0,0,0,0,0
S01008706,Occupancy rating +1,59,23,5,18,34,1,24,7,12,5,9,5,4,2,1,0,0,1
S01008706,Occupancy rating 0,111,39,8,31,64,2,34,9,23,2,28,25,3,8,4,1,0,3
S01008706,Occupancy rating -1 or less,48,9,5,4,36,1,14,2,9,3,21,15,6,3,2,0,1,0
S01008707,All households,387,163,22,141,195,9,90,20,50,20,96,84,12,29,15,1,1,12
S01008707,Occupancy rating +2 or more,56,31,4,27,23,1,14,6,4,4,8,7,1,2,2,0,0,0
S01008707,Occupancy rating +1,109,51,6,45,54,7,25,7,14,4,22,19,3,4,1,0,0,3
S01008707,Occupancy rating 0,154,51,7,44,89,0,39,5,25,9,50,44,6,14,7,0,1,6
S01008707,Occupancy rating -1 or less,68,30,5,25,29,1,12,2,7,3,16,14,2,9,5,1,0,3
S01008708,All households,452,247,26,221,182,4,94,32,51,11,84,62,22,23,11,0,0,12
S01008708,Occupancy rating +2 or more,56,30,3,27,25,0,16,7,7,2,9,4,5,1,1,0,0,0
S01008708,Occupancy rating +1,165,110,12,98,52,2,28,20,6,2,22,17,5,3,1,0,0,2
S01008708,Occupancy rating 0,174,80,8,72,84,2,41,4,31,6,41,32,9,10,3,0,0,7
S01008708,Occupancy rating -1 or less,57,27,3,24,21,0,9,1,7,1,12,9,3,9,6,0,0,3
S01008709,All households,299,73,24,49,206,8,120,36,62,22,78,55,23,20,11,0,1,8
S01008709,Occupancy rating +2 or more,64,24,10,14,39,4,27,15,7,5,8,6,2,1,1,0,0,0
S01008709,Occupancy rating +1,93,30,7,23,59,1,38,16,17,5,20,15,5,4,1,0,1,2
S01008709,Occupancy rating 0,91,14,5,9,70,1,35,3,25,7,34,22,12,7,4,0,0,3
S01008709,Occupancy rating -1 or less,51,5,2,3,38,2,20,2,13,5,16,12,4,8,5,0,0,3
S01008710,All households,208,78,18,60,114,2,70,18,44,8,42,32,10,16,7,2,0,7
S01008710,Occupancy rating +2 or more,20,10,2,8,10,1,9,3,5,1,0,0,0,0,0,0,0,0
S01008710,Occupancy rating +1,61,27,3,24,33,1,23,12,8,3,9,4,5,1,0,0,0,1
S01008710,Occupancy rating 0,87,35,13,22,43,0,28,2,23,3,15,13,2,9,3,2,0,4
S01008710,Occupancy rating -1 or less,40,6,0,6,28,0,10,1,8,1,18,15,3,6,4,0,0,2
S01008711,All households,353,161,66,95,169,15,85,26,38,21,69,51,18,23,5,0,1,17
S01008711,Occupancy rating +2 or more,50,24,13,11,23,4,15,8,3,4,4,3,1,3,0,0,0,3
S01008711,Occupancy rating +1,123,76,26,50,42,6,29,13,12,4,7,3,4,5,0,0,0,5
S01008711,Occupancy rating 0,129,43,21,22,79,2,31,3,18,10,46,38,8,7,0,0,0,7
S01008711,Occupancy rating -1 or less,51,18,6,12,25,3,10,2,5,3,12,7,5,8,5,0,1,2
S01008712,All households,499,220,87,133,237,30,115,48,48,19,92,59,33,42,17,3,2,20
S01008712,Occupancy rating +2 or more,74,32,14,18,38,6,26,18,3,5,6,4,2,4,1,1,0,2
S01008712,Occupancy rating +1,146,69,22,47,70,13,33,18,10,5,24,12,12,7,3,0,1,3
S01008712,Occupancy rating 0,201,90,41,49,93,10,42,10,25,7,41,28,13,18,5,1,1,11
S01008712,Occupancy rating -1 or less,78,29,10,19,36,1,14,2,10,2,21,15,6,13,8,1,0,4
S01008713,All households,292,99,27,72,181,6,80,23,44,13,95,74,21,12,3,0,0,9
S01008713,Occupancy rating +2 or more,24,13,2,11,11,2,9,4,4,1,0,0,0,0,0,0,0,0
S01008713,Occupancy rating +1,117,71,20,51,46,4,28,17,7,4,14,8,6,0,0,0,0,0
S01008713,Occupancy rating 0,109,8,2,6,93,0,33,1,24,8,60,49,11,8,2,0,0,6
S01008713,Occupancy rating -1 or less,42,7,3,4,31,0,10,1,9,0,21,17,4,4,1,0,0,3
S01008714,All households,297,135,44,91,148,31,71,35,25,11,46,36,10,14,3,0,0,11
S01008714,Occupancy rating +2 or more,65,19,8,11,45,17,28,12,10,6,0,0,0,1,0,0,0,1
S01008714,Occupancy rating +1,119,78,21,57,39,12,22,17,4,1,5,4,1,2,1,0,0,1
S01008714,Occupancy rating 0,80,30,13,17,41,1,11,3,5,3,29,24,5,9,1,0,0,8
S01008714,Occupancy rating -1 or less,33,8,2,6,23,1,10,3,6,1,12,8,4,2,1,0,0,1
S01008715,All households,367,144,81,63,202,32,118,51,41,26,52,36,16,21,6,0,1,14
S01008715,Occupancy rating +2 or more,81,31,23,8,48,17,28,21,3,4,3,0,3,2,0,0,0,2
S01008715,Occupancy rating +1,130,61,33,28,61,10,41,21,10,10,10,7,3,8,1,0,0,7
S01008715,Occupancy rating 0,114,45,19,26,64,4,32,7,18,7,28,22,6,5,3,0,0,2
S01008715,Occupancy rating -1 or less,42,7,6,1,29,1,17,2,10,5,11,7,4,6,2,0,1,3
S01008716,All households,295,148,76,72,136,20,81,33,34,14,35,18,17,11,4,0,1,6
S01008716,Occupancy rating +2 or more,41,20,14,6,19,3,14,11,3,0,2,0,2,2,0,0,1,1
S01008716,Occupancy rating +1,114,64,28,36,49,16,29,19,7,3,4,1,3,1,0,0,0,1
S01008716,Occupancy rating 0,112,53,28,25,54,0,30,3,19,8,24,13,11,5,1,0,0,4
S01008716,Occupancy rating -1 or less,28,11,6,5,14,1,8,0,5,3,5,4,1,3,3,0,0,0
S01008717,All households,181,46,8,38,127,6,94,39,42,13,27,21,6,8,6,0,0,2
S01008717,Occupancy rating +2 or more,62,12,3,9,49,3,41,27,10,4,5,4,1,1,1,0,0,0
S01008717,Occupancy rating +1,69,32,5,27,34,3,25,12,9,4,6,5,1,3,2,0,0,1
S01008717,Occupancy rating 0,39,1,0,1,36,0,23,0,19,4,13,9,4,2,1,0,0,1
S01008717,Occupancy rating -1 or less,11,1,0,1,8,0,5,0,4,1,3,3,0,2,2,0,0,0
S01008718,All households,222,61,24,37,149,14,105,45,40,20,30,15,15,12,5,0,0,7
S01008718,Occupancy rating +2 or more,73,19,6,13,54,6,39,28,6,5,9,2,7,0,0,0,0,0
S01008718,Occupancy rating +1,59,22,10,12,36,5,25,10,10,5,6,2,4,1,0,0,0,1
S01008718,Occupancy rating 0,69,17,6,11,47,2,31,7,15,9,14,10,4,5,0,0,0,5
S01008718,Occupancy rating -1 or less,21,3,2,1,12,1,10,0,9,1,1,1,0,6,5,0,0,1
S01008719,All households,420,105,22,83,290,21,207,93,78,36,62,53,9,25,11,3,0,11
S01008719,Occupancy rating +2 or more,104,25,9,16,76,10,60,40,11,9,6,4,2,3,2,0,0,1
S01008719,Occupancy rating +1,143,49,5,44,90,8,73,44,17,12,9,8,1,4,2,0,0,2
S01008719,Occupancy rating 0,140,24,8,16,106,3,63,8,40,15,40,35,5,10,4,2,0,4
S01008719,Occupancy rating -1 or less,33,7,0,7,18,0,11,1,10,0,7,6,1,8,3,1,0,4
S01008720,All households,243,80,30,50,140,14,90,51,21,18,36,19,17,23,6,6,1,10
S01008720,Occupancy rating +2 or more,67,18,6,12,45,6,35,23,6,6,4,3,1,4,2,1,0,1
S01008720,Occupancy rating +1,73,30,14,16,40,5,28,18,4,6,7,2,5,3,0,0,1,2
S01008720,Occupancy rating 0,70,23,8,15,41,2,20,8,8,4,19,9,10,6,0,4,0,2
S01008720,Occupancy rating -1 or less,33,9,2,7,14,1,7,2,3,2,6,5,1,10,4,1,0,5
S01008721,All households,310,61,13,48,241,14,201,80,94,27,26,18,8,8,5,0,0,3
S01008721,Occupancy rating +2 or more,174,34,10,24,137,10,122,53,53,16,5,4,1,3,3,0,0,0
S01008721,Occupancy rating +1,85,27,3,24,57,3,47,27,18,2,7,5,2,1,0,0,0,1
S01008721,Occupancy rating 0,40,0,0,0,37,1,26,0,19,7,10,5,5,3,1,0,0,2
S01008721,Occupancy rating -1 or less,11,0,0,0,10,0,6,0,4,2,4,4,0,1,1,0,0,0
S01008722,All households,480,156,100,56,298,69,209,94,88,27,20,7,13,26,6,1,4,15
S01008722,Occupancy rating +2 or more,280,69,39,30,200,42,148,73,61,14,10,4,6,11,3,0,1,7
S01008722,Occupancy rating +1,63,11,5,6,42,5,30,7,14,9,7,3,4,10,2,1,2,5
S01008722,Occupancy rating 0,112,66,49,17,43,16,24,10,11,3,3,0,3,3,1,0,0,2
S01008722,Occupancy rating -1 or less,25,10,7,3,13,6,7,4,2,1,0,0,0,2,0,0,1,1
S01008723,All households,257,57,23,34,186,22,139,63,57,19,25,12,13,14,4,0,0,10
S01008723,Occupancy rating +2 or more,148,30,12,18,113,16,89,42,36,11,8,3,5,5,1,0,0,4
S01008723,Occupancy rating +1,56,15,7,8,40,5,26,11,11,4,9,3,6,1,0,0,0,1
S01008723,Occupancy rating 0,35,8,3,5,23,1,18,7,9,2,4,3,1,4,3,0,0,1
S01008723,Occupancy rating -1 or less,18,4,1,3,10,0,6,3,1,2,4,3,1,4,0,0,0,4
S01008724,All households,400,120,78,42,262,47,182,65,93,24,33,19,14,18,5,1,2,10
S01008724,Occupancy rating +2 or more,223,47,28,19,162,35,118,46,56,16,9,5,4,14,3,1,2,8
S01008724,Occupancy rating +1,90,41,24,17,48,6,36,13,17,6,6,4,2,1,1,0,0,0
S01008724,Occupancy rating 0,53,10,8,2,41,6,23,4,17,2,12,4,8,2,0,0,0,2
S01008724,Occupancy rating -1 or less,34,22,18,4,11,0,5,2,3,0,6,6,0,1,1,0,0,0
S01008725,All households,343,122,47,75,207,28,150,62,70,18,29,17,12,14,4,0,0,10
S01008725,Occupancy rating +2 or more,161,35,19,16,121,18,93,38,45,10,10,7,3,5,2,0,0,3
S01008725,Occupancy rating +1,110,59,23,36,50,10,33,21,9,3,7,4,3,1,1,0,0,0
S01008725,Occupancy rating 0,49,23,5,18,20,0,14,3,7,4,6,2,4,6,1,0,0,5
S01008725,Occupancy rating -1 or less,23,5,0,5,16,0,10,0,9,1,6,4,2,2,0,0,0,2
S01008726,All households,241,70,31,39,165,19,135,48,71,16,11,7,4,6,1,0,1,4
S01008726,Occupancy rating +2 or more,158,33,17,16,122,11,102,37,52,13,9,7,2,3,1,0,1,1
S01008726,Occupancy rating +1,59,33,11,22,25,5,20,9,10,1,0,0,0,1,0,0,0,1
S01008726,Occupancy rating 0,22,4,3,1,16,2,12,2,8,2,2,0,2,2,0,0,0,2
S01008726,Occupancy rating -1 or less,2,0,0,0,2,1,1,0,1,0,0,0,0,0,0,0,0,0
S01008727,All households,454,144,58,86,279,26,207,88,87,32,46,24,22,31,10,3,2,16
S01008727,Occupancy rating +2 or more,188,43,22,21,132,16,104,41,44,19,12,3,9,13,5,0,2,6
S01008727,Occupancy rating +1,143,61,29,32,78,6,61,34,21,6,11,7,4,4,2,1,0,1
S01008727,Occupancy rating 0,95,26,6,20,59,4,34,12,17,5,21,12,9,10,0,2,0,8
S01008727,Occupancy rating -1 or less,28,14,1,13,10,0,8,1,5,2,2,2,0,4,3,0,0,1
S01008728,All households,229,76,29,47,135,9,82,27,46,9,44,32,12,18,7,0,2,9
S01008728,Occupancy rating +2 or more,61,27,8,19,34,3,25,15,9,1,6,2,4,0,0,0,0,0
S01008728,Occupancy rating +1,70,15,2,13,51,3,30,8,17,5,18,11,7,4,0,0,1,3
S01008728,Occupancy rating 0,65,23,15,8,34,3,19,3,13,3,12,11,1,8,2,0,1,5
S01008728,Occupancy rating -1 or less,33,11,4,7,16,0,8,1,7,0,8,8,0,6,5,0,0,1
S01008729,All households,277,60,25,35,202,14,154,53,86,15,34,24,10,15,6,0,1,8
S01008729,Occupancy rating +2 or more,151,22,12,10,123,11,103,42,51,10,9,6,3,6,3,0,0,3
S01008729,Occupancy rating +1,64,23,8,15,38,2,28,8,18,2,8,5,3,3,2,0,0,1
S01008729,Occupancy rating 0,41,9,3,6,31,1,15,1,12,2,15,11,4,1,0,0,0,1
S01008729,Occupancy rating -1 or less,21,6,2,4,10,0,8,2,5,1,2,2,0,5,1,0,1,3
S01008730,All households,411,186,27,159,205,5,161,92,63,6,39,34,5,20,5,0,1,14
S01008730,Occupancy rating +2 or more,76,28,5,23,42,3,38,23,14,1,1,0,1,6,2,0,0,4
S01008730,Occupancy rating +1,142,67,15,52,72,1,65,36,27,2,6,6,0,3,0,0,0,3
S01008730,Occupancy rating 0,113,48,5,43,56,0,39,23,15,1,17,16,1,9,2,0,1,6
S01008730,Occupancy rating -1 or less,80,43,2,41,35,1,19,10,7,2,15,12,3,2,1,0,0,1
S01008731,All households,226,98,53,45,109,23,64,31,22,11,22,13,9,19,3,0,7,9
S01008731,Occupancy rating +2 or more,50,24,17,7,24,6,16,7,7,2,2,1,1,2,0,0,0,2
S01008731,Occupancy rating +1,91,50,24,26,36,10,23,16,5,2,3,1,2,5,0,0,3,2
S01008731,Occupancy rating 0,59,18,8,10,36,5,18,5,8,5,13,8,5,5,0,0,1,4
S01008731,Occupancy rating -1 or less,26,6,4,2,13,2,7,3,2,2,4,3,1,7,3,0,3,1
S01008732,All households,340,179,38,141,143,14,89,50,34,5,40,26,14,18,5,0,2,11
S01008732,Occupancy rating +2 or more,51,23,7,16,27,9,17,7,10,0,1,0,1,1,0,0,0,1
S01008732,Occupancy rating +1,98,56,18,38,40,3,31,20,10,1,6,2,4,2,0,0,0,2
S01008732,Occupancy rating 0,121,72,10,62,45,2,23,15,6,2,20,13,7,4,0,0,1,3
S01008732,Occupancy rating -1 or less,70,28,3,25,31,0,18,8,8,2,13,11,2,11,5,0,1,5
S01008733,All households,473,247,58,189,202,19,158,118,33,7,25,19,6,24,5,0,1,18
S01008733,Occupancy rating +2 or more,67,29,6,23,34,8,25,20,4,1,1,1,0,4,2,0,0,2
S01008733,Occupancy rating +1,128,70,23,47,54,1,52,43,8,1,1,1,0,4,1,0,0,3
S01008733,Occupancy rating 0,163,81,17,64,75,8,54,41,10,3,13,9,4,7,0,0,1,6
S01008733,Occupancy rating -1 or less,115,67,12,55,39,2,27,14,11,2,10,8,2,9,2,0,0,7
S01008734,All households,266,100,30,70,156,28,110,45,50,15,18,12,6,10,3,0,1,6
S01008734,Occupancy rating +2 or more,118,37,18,19,78,20,52,22,27,3,6,4,2,3,1,0,0,2
S01008734,Occupancy rating +1,78,41,7,34,35,6,27,14,9,4,2,1,1,2,0,0,1,1
S01008734,Occupancy rating 0,52,17,4,13,31,0,23,6,10,7,8,5,3,4,1,0,0,3
S01008734,Occupancy rating -1 or less,18,5,1,4,12,2,8,3,4,1,2,2,0,1,1,0,0,0
S01008735,All households,385,82,58,24,286,56,207,72,99,36,23,11,12,17,7,0,3,7
S01008735,Occupancy rating +2 or more,291,64,47,17,218,49,158,64,68,26,11,3,8,9,2,0,2,5
S01008735,Occupancy rating +1,65,17,10,7,43,7,30,8,18,4,6,3,3,5,3,0,1,1
S01008735,Occupancy rating 0,22,1,1,0,21,0,16,0,10,6,5,4,1,0,0,0,0,0
S01008735,Occupancy rating -1 or less,7,0,0,0,4,0,3,0,3,0,1,1,0,3,2,0,0,1
S01008736,All households,290,80,46,34,192,45,131,32,66,33,16,8,8,18,11,0,2,5
S01008736,Occupancy rating +2 or more,186,48,34,14,130,39,84,27,36,21,7,2,5,8,5,0,1,2
S01008736,Occupancy rating +1,59,18,10,8,38,5,29,3,18,8,4,2,2,3,0,0,1,2
S01008736,Occupancy rating 0,36,14,2,12,18,1,14,2,10,2,3,2,1,4,3,0,0,1
S01008736,Occupancy rating -1 or less,9,0,0,0,6,0,4,0,2,2,2,2,0,3,3,0,0,0
S01008737,All households,339,90,64,26,234,54,157,57,69,31,23,10,13,15,4,1,0,10
S01008737,Occupancy rating +2 or more,229,64,50,14,159,48,100,50,35,15,11,7,4,6,0,0,0,6
S01008737,Occupancy rating +1,68,19,11,8,46,5,35,5,22,8,6,1,5,3,0,0,0,3
S01008737,Occupancy rating 0,27,5,2,3,20,0,16,1,8,7,4,2,2,2,1,1,0,0
S01008737,Occupancy rating -1 or less,15,2,1,1,9,1,6,1,4,1,2,0,2,4,3,0,0,1
S01008738,All households,299,67,51,16,225,54,160,51,77,32,11,6,5,7,3,0,0,4
S01008738,Occupancy rating +2 or more,213,46,35,11,164,50,111,43,42,26,3,1,2,3,1,0,0,2
S01008738,Occupancy rating +1,62,19,16,3,40,4,32,6,20,6,4,2,2,3,1,0,0,2
S01008738,Occupancy rating 0,16,2,0,2,13,0,12,1,11,0,1,1,0,1,1,0,0,0
S01008738,Occupancy rating -1 or less,8,0,0,0,8,0,5,1,4,0,3,2,1,0,0,0,0,0
S01008739,All households,240,68,39,29,161,21,114,42,50,22,26,18,8,11,3,0,0,8
S01008739,Occupancy rating +2 or more,89,27,17,10,60,15,43,29,6,8,2,1,1,2,0,0,0,2
S01008739,Occupancy rating +1,85,29,15,14,55,4,47,13,24,10,4,3,1,1,0,0,0,1
S01008739,Occupancy rating 0,47,11,7,4,33,0,19,0,15,4,14,9,5,3,0,0,0,3
S01008739,Occupancy rating -1 or less,19,1,0,1,13,2,5,0,5,0,6,5,1,5,3,0,0,2
S01008740,All households,227,49,38,11,171,31,119,47,50,22,21,7,14,7,4,0,2,1
S01008740,Occupancy rating +2 or more,115,32,24,8,82,27,52,38,13,1,3,2,1,1,1,0,0,0
S01008740,Occupancy rating +1,71,17,14,3,52,4,39,7,15,17,9,1,8,2,0,0,1,1
S01008740,Occupancy rating 0,33,0,0,0,30,0,23,2,17,4,7,3,4,3,3,0,0,0
S01008740,Occupancy rating -1 or less,8,0,0,0,7,0,5,0,5,0,2,1,1,1,0,0,1,0
S01008741,All households,395,98,65,33,289,64,195,70,86,39,30,16,14,8,3,0,0,5
S01008741,Occupancy rating +2 or more,209,66,46,20,143,53,86,53,27,6,4,1,3,0,0,0,0,0
S01008741,Occupancy rating +1,122,30,19,11,88,11,64,13,32,19,13,6,7,4,1,0,0,3
S01008741,Occupancy rating 0,44,1,0,1,40,0,29,3,17,9,11,7,4,3,2,0,0,1
S01008741,Occupancy rating -1 or less,20,1,0,1,18,0,16,1,10,5,2,2,0,1,0,0,0,1
S01008742,All households,280,156,100,56,110,24,76,39,23,14,10,5,5,14,2,0,0,12
S01008742,Occupancy rating +2 or more,55,11,7,4,41,9,30,19,5,6,2,0,2,3,0,0,0,3
S01008742,Occupancy rating +1,107,71,45,26,35,8,26,14,8,4,1,1,0,1,0,0,0,1
S01008742,Occupancy rating 0,104,66,44,22,29,6,16,6,7,3,7,4,3,9,1,0,0,8
S01008742,Occupancy rating -1 or less,14,8,4,4,5,1,4,0,3,1,0,0,0,1,1,0,0,0
S01008743,All households,485,218,83,135,238,26,139,74,47,18,73,46,27,29,6,3,1,19
S01008743,Occupancy rating +2 or more,78,36,16,20,39,8,27,22,3,2,4,2,2,3,1,0,0,2
S01008743,Occupancy rating +1,173,87,23,64,80,8,57,35,11,11,15,7,8,6,1,0,0,5
S01008743,Occupancy rating 0,172,72,32,40,89,9,36,10,25,1,44,30,14,11,0,1,0,10
S01008743,Occupancy rating -1 or less,62,23,12,11,30,1,19,7,8,4,10,7,3,9,4,2,1,2
S01008744,All households,519,214,106,108,277,43,158,53,80,25,76,49,27,28,8,2,0,18
S01008744,Occupancy rating +2 or more,97,39,21,18,58,15,38,18,16,4,5,1,4,0,0,0,0,0
S01008744,Occupancy rating +1,238,129,66,63,105,22,66,28,25,13,17,9,8,4,1,0,0,3
S01008744,Occupancy rating 0,128,33,15,18,83,4,37,3,27,7,42,32,10,12,1,2,0,9
S01008744,Occupancy rating -1 or less,56,13,4,9,31,2,17,4,12,1,12,7,5,12,6,0,0,6
S01008745,All households,241,97,36,61,134,22,82,45,28,9,30,17,13,10,1,1,0,8
S01008745,Occupancy rating +2 or more,99,34,14,20,63,13,47,32,9,6,3,3,0,2,0,0,0,2
S01008745,Occupancy rating +1,96,59,21,38,36,7,24,12,11,1,5,2,3,1,0,0,0,1
S01008745,Occupancy rating 0,34,3,1,2,26,1,8,1,6,1,17,9,8,5,0,1,0,4
S01008745,Occupancy rating -1 or less,12,1,0,1,9,1,3,0,2,1,5,3,2,2,1,0,0,1
S01008746,All households,572,268,69,199,255,16,154,85,57,12,85,55,30,49,7,9,2,31
S01008746,Occupancy rating +2 or more,78,47,14,33,31,8,20,15,5,0,3,2,1,0,0,0,0,0
S01008746,Occupancy rating +1,213,117,30,87,86,8,60,46,10,4,18,9,9,10,0,1,1,8
S01008746,Occupancy rating 0,188,64,18,46,97,0,47,18,26,3,50,32,18,27,4,5,0,18
S01008746,Occupancy rating -1 or less,93,40,7,33,41,0,27,6,16,5,14,12,2,12,3,3,1,5
S01008747,All households,234,77,42,35,148,29,97,42,42,13,22,13,9,9,1,1,0,7
S01008747,Occupancy rating +2 or more,110,29,20,9,81,20,55,28,23,4,6,4,2,0,0,0,0,0
S01008747,Occupancy rating +1,82,34,17,17,48,9,33,14,11,8,6,4,2,0,0,0,0,0
S01008747,Occupancy rating 0,31,9,4,5,15,0,7,0,6,1,8,5,3,7,0,1,0,6
S01008747,Occupancy rating -1 or less,11,5,1,4,4,0,2,0,2,0,2,0,2,2,1,0,0,1
S01008748,All households,283,64,52,12,207,53,141,57,60,24,13,4,9,12,4,0,2,6
S01008748,Occupancy rating +2 or more,195,46,38,8,145,45,96,48,34,14,4,2,2,4,1,0,1,2
S01008748,Occupancy rating +1,64,16,14,2,43,7,31,9,16,6,5,1,4,5,2,0,1,2
S01008748,Occupancy rating 0,15,1,0,1,12,0,10,0,7,3,2,0,2,2,1,0,0,1
S01008748,Occupancy rating -1 or less,9,1,0,1,7,1,4,0,3,1,2,1,1,1,0,0,0,1
S01008749,All households,402,93,66,27,280,52,198,78,73,47,30,15,15,29,11,1,1,16
S01008749,Occupancy rating +2 or more,261,67,49,18,186,44,131,64,41,26,11,4,7,8,2,0,0,6
S01008749,Occupancy rating +1,90,22,15,7,59,5,42,13,16,13,12,6,6,9,3,0,1,5
S01008749,Occupancy rating 0,33,3,2,1,25,2,19,1,13,5,4,3,1,5,2,0,0,3
S01008749,Occupancy rating -1 or less,18,1,0,1,10,1,6,0,3,3,3,2,1,7,4,1,0,2
S01008750,All households,313,90,57,33,210,54,139,64,52,23,17,8,9,13,6,0,1,6
S01008750,Occupancy rating +2 or more,217,65,40,25,148,46,98,57,28,13,4,1,3,4,2,0,0,2
S01008750,Occupancy rating +1,65,22,16,6,38,7,25,6,11,8,6,4,2,5,1,0,1,3
S01008750,Occupancy rating 0,22,2,1,1,18,1,12,0,10,2,5,1,4,2,1,0,0,1
S01008750,Occupancy rating -1 or less,9,1,0,1,6,0,4,1,3,0,2,2,0,2,2,0,0,0
S01008751,All households,304,127,74,53,163,22,103,48,39,16,38,24,14,14,2,0,2,10
S01008751,Occupancy rating +2 or more,90,28,18,10,60,15,41,19,16,6,4,1,3,2,2,0,0,0
S01008751,Occupancy rating +1,119,66,31,35,51,6,39,25,8,6,6,6,0,2,0,0,0,2
S01008751,Occupancy rating 0,70,24,18,6,38,1,14,3,8,3,23,14,9,8,0,0,2,6
S01008751,Occupancy rating -1 or less,25,9,7,2,14,0,9,1,7,1,5,3,2,2,0,0,0,2
S01008752,All households,459,231,66,165,203,19,88,44,34,10,96,62,34,25,1,3,3,18
S01008752,Occupancy rating +2 or more,24,16,8,8,7,2,5,4,1,0,0,0,0,1,0,0,0,1
S01008752,Occupancy rating +1,210,145,46,99,63,15,39,33,5,1,9,8,1,2,0,0,0,2
S01008752,Occupancy rating 0,177,61,11,50,100,2,34,3,25,6,64,40,24,16,0,3,2,11
S01008752,Occupancy rating -1 or less,48,9,1,8,33,0,10,4,3,3,23,14,9,6,1,0,1,4
S01008753,All households,314,176,59,117,126,9,67,34,22,11,50,31,19,12,4,0,2,6
S01008753,Occupancy rating +2 or more,20,11,4,7,9,1,6,5,1,0,2,1,1,0,0,0,0,0
S01008753,Occupancy rating +1,109,73,29,44,34,8,22,19,1,2,4,3,1,2,0,0,0,2
S01008753,Occupancy rating 0,141,74,21,53,60,0,30,10,14,6,30,18,12,7,1,0,2,4
S01008753,Occupancy rating -1 or less,44,18,5,13,23,0,9,0,6,3,14,9,5,3,3,0,0,0
S01008754,All households,362,193,41,152,141,12,104,79,22,3,25,12,13,28,2,0,0,26
S01008754,Occupancy rating +2 or more,16,8,2,6,8,2,5,5,0,0,1,0,1,0,0,0,0,0
S01008754,Occupancy rating +1,156,91,24,67,63,6,53,51,2,0,4,3,1,2,0,0,0,2
S01008754,Occupancy rating 0,162,84,13,71,61,4,39,20,17,2,18,8,10,17,0,0,0,17
S01008754,Occupancy rating -1 or less,28,10,2,8,9,0,7,3,3,1,2,1,1,9,2,0,0,7
S01008755,All households,541,286,65,221,209,18,118,65,43,10,73,57,16,46,2,3,1,40
S01008755,Occupancy rating +2 or more,28,10,4,6,18,3,8,6,2,0,7,6,1,0,0,0,0,0
S01008755,Occupancy rating +1,165,118,26,92,43,9,34,26,4,4,0,0,0,4,0,0,0,4
S01008755,Occupancy rating 0,249,119,27,92,108,5,54,24,26,4,49,37,12,22,0,3,0,19
S01008755,Occupancy rating -1 or less,99,39,8,31,40,1,22,9,11,2,17,14,3,20,2,0,1,17
S01008756,All households,418,231,66,165,166,20,100,53,32,15,46,27,19,21,2,4,0,15
S01008756,Occupancy rating +2 or more,37,20,6,14,14,2,11,10,0,1,1,0,1,3,0,0,0,3
S01008756,Occupancy rating +1,142,96,38,58,45,14,28,27,0,1,3,1,2,1,0,0,0,1
S01008756,Occupancy rating 0,175,93,16,77,74,3,38,13,18,7,33,20,13,8,0,0,0,8
S01008756,Occupancy rating -1 or less,64,22,6,16,33,1,23,3,14,6,9,6,3,9,2,4,0,3
S01008757,All households,397,238,69,169,148,17,79,45,26,8,52,40,12,11,2,0,3,6
S01008757,Occupancy rating +2 or more,16,12,3,9,4,0,3,3,0,0,1,0,1,0,0,0,0,0
S01008757,Occupancy rating +1,124,83,25,58,41,13,24,21,3,0,4,4,0,0,0,0,0,0
S01008757,Occupancy rating 0,196,120,33,87,70,4,38,19,14,5,28,23,5,6,0,0,2,4
S01008757,Occupancy rating -1 or less,61,23,8,15,33,0,14,2,9,3,19,13,6,5,2,0,1,2
S01008758,All households,444,205,76,129,217,27,113,46,57,10,77,48,29,22,4,1,1,16
S01008758,Occupancy rating +2 or more,37,13,4,9,22,7,11,7,4,0,4,3,1,2,0,1,0,1
S01008758,Occupancy rating +1,199,136,54,82,62,17,34,27,7,0,11,9,2,1,0,0,0,1
S01008758,Occupancy rating 0,150,44,12,32,93,1,47,10,29,8,45,29,16,13,1,0,1,11
S01008758,Occupancy rating -1 or less,58,12,6,6,40,2,21,2,17,2,17,7,10,6,3,0,0,3
S01008759,All households,322,174,59,115,143,16,72,34,29,9,55,39,16,5,1,0,0,4
S01008759,Occupancy rating +2 or more,21,10,3,7,10,4,5,5,0,0,1,1,0,1,0,0,0,1
S01008759,Occupancy rating +1,139,103,45,58,36,9,25,23,2,0,2,1,1,0,0,0,0,0
S01008759,Occupancy rating 0,112,48,4,44,62,1,28,5,16,7,33,21,12,2,0,0,0,2
S01008759,Occupancy rating -1 or less,50,13,7,6,35,2,14,1,11,2,19,16,3,2,1,0,0,1
S01008760,All households,500,253,62,191,228,17,114,37,61,16,97,69,28,19,8,1,1,9
S01008760,Occupancy rating +2 or more,54,26,5,21,27,6,14,4,8,2,7,5,2,1,0,0,0,1
S01008760,Occupancy rating +1,167,104,25,79,61,10,38,21,13,4,13,7,6,2,1,0,0,1
S01008760,Occupancy rating 0,206,94,24,70,104,1,44,9,28,7,59,44,15,8,2,0,1,5
S01008760,Occupancy rating -1 or less,73,29,8,21,36,0,18,3,12,3,18,13,5,8,5,1,0,2
S01008761,All households,295,82,16,66,172,1,137,62,65,10,34,29,5,41,7,4,0,30
S01008761,Occupancy rating +2 or more,36,7,2,5,28,1,26,14,10,2,1,1,0,1,0,0,0,1
S01008761,Occupancy rating +1,106,35,7,28,69,0,65,43,15,7,4,3,1,2,0,0,0,2
S01008761,Occupancy rating 0,99,23,3,20,55,0,31,3,28,0,24,20,4,21,1,4,0,16
S01008761,Occupancy rating -1 or less,54,17,4,13,20,0,15,2,12,1,5,5,0,17,6,0,0,11
S01008762,All households,301,109,48,61,179,33,127,65,43,19,19,16,3,13,0,1,1,11
S01008762,Occupancy rating +2 or more,52,18,11,7,31,10,19,11,6,2,2,2,0,3,0,0,1,2
S01008762,Occupancy rating +1,128,46,18,28,81,16,62,47,12,3,3,2,1,1,0,0,0,1
S01008762,Occupancy rating 0,86,30,13,17,51,7,36,4,19,13,8,8,0,5,0,0,0,5
S01008762,Occupancy rating -1 or less,35,15,6,9,16,0,10,3,6,1,6,4,2,4,0,1,0,3
S01008763,All households,433,147,46,101,258,25,208,98,92,18,25,15,10,28,4,0,0,24
S01008763,Occupancy rating +2 or more,142,39,13,26,98,10,82,42,34,6,6,4,2,5,0,0,0,5
S01008763,Occupancy rating +1,150,62,16,46,83,10,70,42,18,10,3,2,1,5,1,0,0,4
S01008763,Occupancy rating 0,104,38,15,23,57,4,43,12,29,2,10,5,5,9,0,0,0,9
S01008763,Occupancy rating -1 or less,37,8,2,6,20,1,13,2,11,0,6,4,2,9,3,0,0,6
S01008764,All households,306,92,28,64,193,20,155,57,73,25,18,10,8,21,3,4,1,13
S01008764,Occupancy rating +2 or more,128,26,10,16,93,11,79,34,33,12,3,1,2,9,2,1,1,5
S01008764,Occupancy rating +1,87,37,10,27,46,4,38,15,19,4,4,1,3,4,0,1,0,3
S01008764,Occupancy rating 0,65,21,6,15,42,5,31,7,15,9,6,5,1,2,1,0,0,1
S01008764,Occupancy rating -1 or less,26,8,2,6,12,0,7,1,6,0,5,3,2,6,0,2,0,4
S01008765,All households,393,145,41,104,224,15,176,79,76,21,33,19,14,24,7,0,1,16
S01008765,Occupancy rating +2 or more,116,29,13,16,83,10,68,30,29,9,5,4,1,4,2,0,1,1
S01008765,Occupancy rating +1,117,46,10,36,66,5,54,28,22,4,7,4,3,5,2,0,0,3
S01008765,Occupancy rating 0,122,58,15,43,55,0,42,20,15,7,13,5,8,9,1,0,0,8
S01008765,Occupancy rating -1 or less,38,12,3,9,20,0,12,1,10,1,8,6,2,6,2,0,0,4
S01008766,All households,413,103,48,55,287,40,216,80,102,34,31,17,14,23,7,2,1,13
S01008766,Occupancy rating +2 or more,221,57,32,25,158,30,120,59,49,12,8,3,5,6,2,0,1,3
S01008766,Occupancy rating +1,100,28,8,20,65,9,52,14,27,11,4,1,3,7,1,1,0,5
S01008766,Occupancy rating 0,65,15,6,9,45,1,33,4,20,9,11,8,3,5,2,0,0,3
S01008766,Occupancy rating -1 or less,27,3,2,1,19,0,11,3,6,2,8,5,3,5,2,1,0,2
S01008767,All households,266,112,37,75,142,16,99,34,49,16,27,18,9,12,2,2,0,8
S01008767,Occupancy rating +2 or more,67,32,14,18,33,5,28,14,11,3,0,0,0,2,1,0,0,1
S01008767,Occupancy rating +1,105,41,16,25,62,10,38,15,15,8,14,10,4,2,0,0,0,2
S01008767,Occupancy rating 0,54,18,3,15,33,1,23,4,16,3,9,4,5,3,0,0,0,3
S01008767,Occupancy rating -1 or less,40,21,4,17,14,0,10,1,7,2,4,4,0,5,1,2,0,2
S01008768,All households,256,117,23,94,122,9,90,47,34,9,23,19,4,17,2,0,2,13
S01008768,Occupancy rating +2 or more,41,19,9,10,19,3,15,9,5,1,1,0,1,3,1,0,1,1
S01008768,Occupancy rating +1,81,40,8,32,40,3,30,18,6,6,7,6,1,1,0,0,0,1
S01008768,Occupancy rating 0,81,37,3,34,36,1,27,11,15,1,8,7,1,8,0,0,1,7
S01008768,Occupancy rating -1 or less,53,21,3,18,27,2,18,9,8,1,7,6,1,5,1,0,0,4
S01008769,All households,380,157,10,147,170,5,153,125,26,2,12,9,3,53,2,5,0,46
S01008769,Occupancy rating +2 or more,37,13,2,11,24,4,20,20,0,0,0,0,0,0,0,0,0,0
S01008769,Occupancy rating +1,96,49,4,45,44,0,42,38,4,0,2,2,0,3,0,1,0,2
S01008769,Occupancy rating 0,161,74,4,70,69,0,65,53,11,1,4,4,0,18,1,1,0,16
S01008769,Occupancy rating -1 or less,86,21,0,21,33,1,26,14,11,1,6,3,3,32,1,3,0,28
S01008770,All households,431,160,5,155,208,3,171,115,53,3,34,29,5,63,6,6,1,50
S01008770,Occupancy rating +2 or more,64,33,0,33,27,1,26,23,2,1,0,0,0,4,0,0,0,4
S01008770,Occupancy rating +1,104,56,5,51,42,1,38,31,7,0,3,3,0,6,1,2,0,3
S01008770,Occupancy rating 0,163,66,0,66,79,1,72,55,17,0,6,5,1,18,0,1,1,16
S01008770,Occupancy rating -1 or less,100,5,0,5,60,0,35,6,27,2,25,21,4,35,5,3,0,27
S01008771,All households,411,170,20,150,215,16,151,93,53,5,48,42,6,26,2,5,0,19
S01008771,Occupancy rating +2 or more,79,20,3,17,57,7,46,30,14,2,4,3,1,2,1,0,0,1
S01008771,Occupancy rating +1,161,93,6,87,64,5,56,44,11,1,3,3,0,4,0,1,0,3
S01008771,Occupancy rating 0,118,31,4,27,72,3,39,17,20,2,30,25,5,15,0,4,0,11
S01008771,Occupancy rating -1 or less,53,26,7,19,22,1,10,2,8,0,11,11,0,5,1,0,0,4
S01008772,All households,395,175,64,111,200,22,149,72,59,18,29,15,14,20,7,1,2,10
S01008772,Occupancy rating +2 or more,110,30,14,16,78,11,66,29,35,2,1,1,0,2,1,0,0,1
S01008772,Occupancy rating +1,135,78,27,51,52,6,38,33,3,2,8,4,4,5,3,0,0,2
S01008772,Occupancy rating 0,96,34,12,22,54,3,38,9,20,9,13,7,6,8,0,1,1,6
S01008772,Occupancy rating -1 or less,54,33,11,22,16,2,7,1,1,5,7,3,4,5,3,0,1,1
S01008773,All households,596,320,73,247,236,20,181,110,58,13,35,27,8,40,4,2,2,32
S01008773,Occupancy rating +2 or more,54,28,13,15,24,6,17,9,6,2,1,1,0,2,0,0,0,2
S01008773,Occupancy rating +1,185,104,26,78,77,8,63,55,5,3,6,6,0,4,2,0,1,1
S01008773,Occupancy rating 0,215,108,23,85,85,5,60,24,33,3,20,14,6,22,0,1,1,20
S01008773,Occupancy rating -1 or less,142,80,11,69,50,1,41,22,14,5,8,6,2,12,2,1,0,9
S01008774,All households,495,241,34,207,197,12,140,86,46,8,45,35,10,57,4,8,0,45
S01008774,Occupancy rating +2 or more,55,15,2,13,36,7,25,21,2,2,4,2,2,4,0,0,0,4
S01008774,Occupancy rating +1,145,79,17,62,60,4,44,34,9,1,12,9,3,6,0,1,0,5
S01008774,Occupancy rating 0,204,115,12,103,69,1,49,25,21,3,19,15,4,20,1,4,0,15
S01008774,Occupancy rating -1 or less,91,32,3,29,32,0,22,6,14,2,10,9,1,27,3,3,0,21
S01008775,All households,218,74,21,53,119,8,95,56,28,11,16,10,6,25,5,0,1,19
S01008775,Occupancy rating +2 or more,77,20,8,12,51,4,45,29,12,4,2,2,0,6,1,0,1,4
S01008775,Occupancy rating +1,55,20,9,11,30,3,25,18,4,3,2,2,0,5,0,0,0,5
S01008775,Occupancy rating 0,54,19,1,18,28,1,20,9,7,4,7,3,4,7,3,0,0,4
S01008775,Occupancy rating -1 or less,32,15,3,12,10,0,5,0,5,0,5,3,2,7,1,0,0,6
S01008776,All households,467,243,28,215,171,8,103,65,34,4,60,45,15,53,5,2,0,46
S01008776,Occupancy rating +2 or more,47,19,6,13,25,2,20,13,6,1,3,2,1,3,0,0,0,3
S01008776,Occupancy rating +1,107,59,5,54,40,4,26,18,8,0,10,8,2,8,1,1,0,6
S01008776,Occupancy rating 0,181,97,14,83,58,2,37,25,10,2,19,15,4,26,1,1,0,24
S01008776,Occupancy rating -1 or less,132,68,3,65,48,0,20,9,10,1,28,20,8,16,3,0,0,13
S01008777,All households,637,386,86,300,186,18,124,86,26,12,44,19,25,65,8,3,3,51
S01008777,Occupancy rating +2 or more,34,19,5,14,15,2,12,9,2,1,1,0,1,0,0,0,0,0
S01008777,Occupancy rating +1,228,155,34,121,64,7,53,44,5,4,4,3,1,9,1,0,0,8
S01008777,Occupancy rating 0,256,141,34,107,80,8,43,26,12,5,29,10,19,35,2,2,3,28
S01008777,Occupancy rating -1 or less,119,71,13,58,27,1,16,7,7,2,10,6,4,21,5,1,0,15
S01008778,All households,664,349,23,326,242,3,198,155,40,3,41,32,9,73,3,5,0,65
S01008778,Occupancy rating +2 or more,44,21,0,21,23,1,22,19,3,0,0,0,0,0,0,0,0,0
S01008778,Occupancy rating +1,251,154,11,143,93,1,89,81,8,0,3,3,0,4,0,0,0,4
S01008778,Occupancy rating 0,236,114,9,105,79,1,56,40,14,2,22,19,3,43,0,4,0,39
S01008778,Occupancy rating -1 or less,133,60,3,57,47,0,31,15,15,1,16,10,6,26,3,1,0,22
S01008779,All households,402,171,12,159,173,5,153,115,34,4,15,5,10,58,5,3,0,50
S01008779,Occupancy rating +2 or more,86,31,2,29,52,3,47,39,7,1,2,1,1,3,0,0,0,3
S01008779,Occupancy rating +1,187,107,6,101,72,2,69,59,9,1,1,0,1,8,1,0,0,7
S01008779,Occupancy rating 0,88,19,3,16,37,0,29,13,15,1,8,2,6,32,0,2,0,30
S01008779,Occupancy rating -1 or less,41,14,1,13,12,0,8,4,3,1,4,2,2,15,4,1,0,10
S01008780,All households,329,150,5,145,127,1,106,82,22,2,20,18,2,52,4,6,0,42
S01008780,Occupancy rating +2 or more,26,7,1,6,17,1,16,10,6,0,0,0,0,2,1,0,0,1
S01008780,Occupancy rating +1,111,59,2,57,46,0,43,41,2,0,3,3,0,6,0,1,0,5
S01008780,Occupancy rating 0,139,71,1,70,45,0,35,28,7,0,10,9,1,23,0,3,0,20
S01008780,Occupancy rating -1 or less,53,13,1,12,19,0,12,3,7,2,7,6,1,21,3,2,0,16
S01008781,All households,530,261,15,246,199,0,139,99,34,6,60,46,14,70,5,5,0,60
S01008781,Occupancy rating +2 or more,25,15,1,14,10,0,10,10,0,0,0,0,0,0,0,0,0,0
S01008781,Occupancy rating +1,134,77,4,73,55,0,52,48,4,0,3,3,0,2,0,0,0,2
S01008781,Occupancy rating 0,212,84,5,79,86,0,49,26,20,3,37,27,10,42,1,4,0,37
S01008781,Occupancy rating -1 or less,159,85,5,80,48,0,28,15,10,3,20,16,4,26,4,1,0,21
S01008782,All households,400,172,9,163,183,4,154,106,44,4,25,22,3,45,5,5,1,34
S01008782,Occupancy rating +2 or more,50,14,2,12,32,0,30,22,6,2,2,1,1,4,1,0,0,3
S01008782,Occupancy rating +1,132,66,6,60,63,3,57,52,5,0,3,3,0,3,0,1,0,2
S01008782,Occupancy rating 0,150,69,1,68,55,1,43,28,15,0,11,10,1,26,1,4,1,20
S01008782,Occupancy rating -1 or less,68,23,0,23,33,0,24,4,18,2,9,8,1,12,3,0,0,9
S01008783,All households,236,97,4,93,117,1,90,72,18,0,26,20,6,22,2,0,0,20
S01008783,Occupancy rating +2 or more,26,15,0,15,11,0,11,10,1,0,0,0,0,0,0,0,0,0
S01008783,Occupancy rating +1,61,27,2,25,34,0,32,30,2,0,2,1,1,0,0,0,0,0
S01008783,Occupancy rating 0,109,42,2,40,55,1,36,27,9,0,18,14,4,12,0,0,0,12
S01008783,Occupancy rating -1 or less,40,13,0,13,17,0,11,5,6,0,6,5,1,10,2,0,0,8
S01008784,All households,268,132,8,124,111,3,75,59,14,2,33,28,5,25,1,0,0,24
S01008784,Occupancy rating +2 or more,26,15,1,14,10,0,10,9,0,1,0,0,0,1,0,0,0,1
S01008784,Occupancy rating +1,82,51,4,47,29,2,26,25,0,1,1,1,0,2,0,0,0,2
S01008784,Occupancy rating 0,117,57,2,55,47,1,27,18,9,0,19,17,2,13,0,0,0,13
S01008784,Occupancy rating -1 or less,43,9,1,8,25,0,12,7,5,0,13,10,3,9,1,0,0,8
S01008785,All households,485,238,63,175,196,20,99,54,36,9,77,58,19,51,4,8,0,39
S01008785,Occupancy rating +2 or more,34,19,7,12,14,4,8,6,2,0,2,1,1,1,0,0,0,1
S01008785,Occupancy rating +1,177,116,31,85,54,11,39,31,3,5,4,3,1,7,0,0,0,7
S01008785,Occupancy rating 0,188,66,14,52,94,2,39,14,23,2,53,40,13,28,0,7,0,21
S01008785,Occupancy rating -1 or less,86,37,11,26,34,3,13,3,8,2,18,14,4,15,4,1,0,10
S01008786,All households,540,269,29,240,183,11,143,115,27,1,29,21,8,88,3,8,0,77
S01008786,Occupancy rating +2 or more,51,31,8,23,16,4,12,12,0,0,0,0,0,4,0,0,0,4
S01008786,Occupancy rating +1,154,90,7,83,57,4,48,45,3,0,5,4,1,7,0,0,0,7
S01008786,Occupancy rating 0,206,80,10,70,70,2,55,39,15,1,13,9,4,56,0,6,0,50
S01008786,Occupancy rating -1 or less,129,68,4,64,40,1,28,19,9,0,11,8,3,21,3,2,0,16
S01008787,All households,200,93,21,72,93,6,35,11,19,5,52,45,7,14,4,5,0,5
S01008787,Occupancy rating +2 or more,15,12,1,11,1,0,0,0,0,0,1,0,1,2,1,1,0,0
S01008787,Occupancy rating +1,87,66,17,49,19,5,11,9,1,1,3,2,1,2,0,1,0,1
S01008787,Occupancy rating 0,67,10,1,9,51,1,18,1,14,3,32,28,4,6,1,2,0,3
S01008787,Occupancy rating -1 or less,31,5,2,3,22,0,6,1,4,1,16,15,1,4,2,1,0,1
S01008788,All households,376,151,19,132,161,4,127,102,21,4,30,24,6,64,3,4,0,57
S01008788,Occupancy rating +2 or more,14,6,1,5,8,0,8,7,1,0,0,0,0,0,0,0,0,0
S01008788,Occupancy rating +1,98,51,6,45,43,3,39,35,3,1,1,1,0,4,0,1,0,3
S01008788,Occupancy rating 0,155,56,10,46,70,1,54,46,8,0,15,13,2,29,0,2,0,27
S01008788,Occupancy rating -1 or less,109,38,2,36,40,0,26,14,9,3,14,10,4,31,3,1,0,27
S01008789,All households,375,208,94,114,136,27,85,44,26,15,24,15,9,31,11,0,1,19
S01008789,Occupancy rating +2 or more,41,17,6,11,19,4,14,7,3,4,1,1,0,5,2,0,0,3
S01008789,Occupancy rating +1,98,54,27,27,42,12,24,16,5,3,6,4,2,2,1,0,0,1
S01008789,Occupancy rating 0,149,83,41,42,54,8,35,17,11,7,11,6,5,12,3,0,0,9
S01008789,Occupancy rating -1 or less,87,54,20,34,21,3,12,4,7,1,6,4,2,12,5,0,1,6
S01008790,All households,353,183,29,154,114,4,86,51,30,5,24,17,7,56,3,10,1,42
S01008790,Occupancy rating +2 or more,38,16,4,12,18,0,15,9,5,1,3,1,2,4,0,0,0,4
S01008790,Occupancy rating +1,88,45,3,42,33,1,31,23,8,0,1,1,0,10,1,2,0,7
S01008790,Occupancy rating 0,141,72,13,59,45,3,31,15,13,3,11,7,4,24,0,5,0,19
S01008790,Occupancy rating -1 or less,86,50,9,41,18,0,9,4,4,1,9,8,1,18,2,3,1,12
S01008791,All households,421,144,13,131,174,11,126,79,38,9,37,27,10,103,8,15,0,80
S01008791,Occupancy rating +2 or more,47,13,2,11,28,4,20,11,7,2,4,4,0,6,0,1,0,5
S01008791,Occupancy rating +1,132,69,4,65,61,3,54,49,3,2,4,1,3,2,1,1,0,0
S01008791,Occupancy rating 0,158,40,5,35,68,4,42,17,20,5,22,17,5,50,1,7,0,42
S01008791,Occupancy rating -1 or less,84,22,2,20,17,0,10,2,8,0,7,5,2,45,6,6,0,33
S01008792,All households,415,191,34,157,185,11,139,95,35,9,35,24,11,39,8,3,1,27
S01008792,Occupancy rating +2 or more,66,25,6,19,37,3,30,24,3,3,4,2,2,4,3,0,0,1
S01008792,Occupancy rating +1,115,62,14,48,49,3,42,33,8,1,4,4,0,4,0,0,0,4
S01008792,Occupancy rating 0,160,71,8,63,73,3,53,33,17,3,17,11,6,16,1,3,0,12
S01008792,Occupancy rating -1 or less,74,33,6,27,26,2,14,5,7,2,10,7,3,15,4,0,1,10
S01008793,All households,266,164,53,111,66,5,45,28,15,2,16,14,2,36,3,6,1,26
S01008793,Occupancy rating +2 or more,9,3,0,3,4,0,3,2,1,0,1,1,0,2,1,0,0,1
S01008793,Occupancy rating +1,48,28,8,20,14,1,9,5,2,2,4,3,1,6,0,2,0,4
S01008793,Occupancy rating 0,112,75,29,46,26,3,17,12,5,0,6,6,0,11,1,2,1,7
S01008793,Occupancy rating -1 or less,97,58,16,42,22,1,16,9,7,0,5,4,1,17,1,2,0,14
S01008794,All households,492,241,118,123,210,33,126,77,36,13,51,30,21,41,5,3,1,32
S01008794,Occupancy rating +2 or more,27,15,5,10,12,2,10,6,3,1,0,0,0,0,0,0,0,0
S01008794,Occupancy rating +1,137,79,28,51,53,11,41,40,0,1,1,0,1,5,1,0,0,4
S01008794,Occupancy rating 0,234,105,53,52,110,16,58,27,23,8,36,19,17,19,1,3,0,15
S01008794,Occupancy rating -1 or less,94,42,32,10,35,4,17,4,10,3,14,11,3,17,3,0,1,13
S01008795,All households,618,278,40,238,246,12,200,126,56,18,34,27,7,94,5,14,0,75
S01008795,Occupancy rating +2 or more,60,32,5,27,26,3,23,18,3,2,0,0,0,2,1,0,0,1
S01008795,Occupancy rating +1,172,87,15,72,69,6,54,45,7,2,9,6,3,16,0,4,0,12
S01008795,Occupancy rating 0,220,80,11,69,90,1,76,36,29,11,13,12,1,50,0,5,0,45
S01008795,Occupancy rating -1 or less,166,79,9,70,61,2,47,27,17,3,12,9,3,26,4,5,0,17
S01008796,All households,622,330,62,268,220,21,147,88,47,12,52,39,13,72,8,9,0,55
S01008796,Occupancy rating +2 or more,34,21,3,18,13,3,9,4,4,1,1,1,0,0,0,0,0,0
S01008796,Occupancy rating +1,146,81,18,63,61,9,46,41,5,0,6,5,1,4,1,1,0,2
S01008796,Occupancy rating 0,268,140,28,112,92,8,55,27,23,5,29,21,8,36,4,5,0,27
S01008796,Occupancy rating -1 or less,174,88,13,75,54,1,37,16,15,6,16,12,4,32,3,3,0,26
S01008797,All households,579,314,65,249,194,17,151,116,28,7,26,15,11,71,1,12,1,57
S01008797,Occupancy rating +2 or more,34,19,3,16,15,2,13,10,1,2,0,0,0,0,0,0,0,0
S01008797,Occupancy rating +1,131,63,12,51,60,7,50,45,3,2,3,0,3,8,0,1,1,6
S01008797,Occupancy rating 0,264,157,34,123,75,6,55,36,16,3,14,10,4,32,0,6,0,26
S01008797,Occupancy rating -1 or less,150,75,16,59,44,2,33,25,8,0,9,5,4,31,1,5,0,25
S01008798,All households,502,289,61,228,167,11,127,91,28,8,29,20,9,46,1,16,2,27
S01008798,Occupancy rating +2 or more,18,9,2,7,9,1,8,7,1,0,0,0,0,0,0,0,0,0
S01008798,Occupancy rating +1,129,70,15,55,51,5,42,33,8,1,4,2,2,8,0,0,0,8
S01008798,Occupancy rating 0,224,132,35,97,69,4,52,34,14,4,13,7,6,23,0,10,0,13
S01008798,Occupancy rating -1 or less,131,78,9,69,38,1,25,17,5,3,12,11,1,15,1,6,2,6
S01008799,All households,322,114,14,100,134,5,88,53,29,6,41,40,1,74,5,16,0,53
S01008799,Occupancy rating +2 or more,16,8,2,6,7,0,6,3,1,2,1,1,0,1,0,1,0,0
S01008799,Occupancy rating +1,53,27,4,23,23,3,20,18,1,1,0,0,0,3,0,1,0,2
S01008799,Occupancy rating 0,131,68,7,61,47,1,36,24,9,3,10,10,0,16,0,2,0,14
S01008799,Occupancy rating -1 or less,122,11,1,10,57,1,26,8,18,0,30,29,1,54,5,12,0,37
S01008800,All households,651,362,27,335,204,4,179,134,42,3,21,12,9,85,4,7,0,74
S01008800,Occupancy rating +2 or more,7,5,1,4,2,0,2,1,1,0,0,0,0,0,0,0,0,0
S01008800,Occupancy rating +1,101,60,5,55,39,2,37,36,1,0,0,0,0,2,0,0,0,2
S01008800,Occupancy rating 0,249,138,15,123,89,2,80,64,15,1,7,3,4,22,0,5,0,17
S01008800,Occupancy rating -1 or less,294,159,6,153,74,0,60,33,25,2,14,9,5,61,4,2,0,55
S01008801,All households,582,313,18,295,209,10,175,131,36,8,24,18,6,60,3,8,0,49
S01008801,Occupancy rating +2 or more,16,11,1,10,5,0,3,2,0,1,2,1,1,0,0,0,0,0
S01008801,Occupancy rating +1,132,83,5,78,46,4,42,42,0,0,0,0,0,3,0,2,0,1
S01008801,Occupancy rating 0,281,141,9,132,106,4,90,69,19,2,12,8,4,34,2,3,0,29
S01008801,Occupancy rating -1 or less,153,78,3,75,52,2,40,18,17,5,10,9,1,23,1,3,0,19
S01008802,All households,614,343,33,310,207,10,164,128,33,3,33,23,10,64,1,12,0,51
S01008802,Occupancy rating +2 or more,25,18,1,17,5,0,5,4,0,1,0,0,0,2,0,0,0,2
S01008802,Occupancy rating +1,133,88,13,75,40,5,34,31,2,1,1,0,1,5,1,1,0,3
S01008802,Occupancy rating 0,236,119,9,110,84,3,66,48,17,1,15,9,6,33,0,8,0,25
S01008802,Occupancy rating -1 or less,220,118,10,108,78,2,59,45,14,0,17,14,3,24,0,3,0,21
S01008803,All households,575,342,41,301,166,6,126,82,32,12,34,24,10,67,9,7,1,50
S01008803,Occupancy rating +2 or more,36,16,3,13,14,0,11,6,4,1,3,0,3,6,1,0,0,5
S01008803,Occupancy rating +1,130,76,9,67,48,2,43,36,5,2,3,2,1,6,1,1,0,4
S01008803,Occupancy rating 0,208,124,19,105,51,3,37,16,15,6,11,11,0,33,2,3,1,27
S01008803,Occupancy rating -1 or less,201,126,10,116,53,1,35,24,8,3,17,11,6,22,5,3,0,14
S01008804,All households,332,190,15,175,108,2,89,65,23,1,17,12,5,34,1,9,1,23
S01008804,Occupancy rating +2 or more,13,7,2,5,5,0,5,4,1,0,0,0,0,1,0,0,1,0
S01008804,Occupancy rating +1,43,28,2,26,12,0,11,10,1,0,1,1,0,3,0,1,0,2
S01008804,Occupancy rating 0,138,75,5,70,49,2,35,25,10,0,12,9,3,14,0,1,0,13
S01008804,Occupancy rating -1 or less,138,80,6,74,42,0,38,26,11,1,4,2,2,16,1,7,0,8
S01008805,All households,334,152,28,124,103,6,85,60,23,2,12,6,6,79,1,27,0,51
S01008805,Occupancy rating +2 or more,36,19,3,16,15,0,15,10,5,0,0,0,0,2,0,0,0,2
S01008805,Occupancy rating +1,116,67,14,53,41,5,34,28,5,1,2,2,0,8,0,1,0,7
S01008805,Occupancy rating 0,138,53,8,45,36,1,27,18,8,1,8,4,4,49,0,20,0,29
S01008805,Occupancy rating -1 or less,44,13,3,10,11,0,9,4,5,0,2,0,2,20,1,6,0,13
S01008806,All households,558,250,21,229,206,2,183,129,46,8,21,13,8,102,5,25,0,72
S01008806,Occupancy rating +2 or more,26,11,2,9,13,0,13,8,4,1,0,0,0,2,0,1,0,1
S01008806,Occupancy rating +1,176,82,9,73,84,1,80,76,2,2,3,2,1,10,0,1,0,9
S01008806,Occupancy rating 0,235,100,8,92,77,0,65,33,29,3,12,9,3,58,1,13,0,44
S01008806,Occupancy rating -1 or less,121,57,2,55,32,1,25,12,11,2,6,2,4,32,4,10,0,18
S01008807,All households,490,286,41,245,154,4,132,96,28,8,18,9,9,50,4,5,0,41
S01008807,Occupancy rating +2 or more,36,19,7,12,14,0,13,5,7,1,1,1,0,3,1,0,0,2
S01008807,Occupancy rating +1,124,73,9,64,44,2,39,30,8,1,3,2,1,7,0,2,0,5
S01008807,Occupancy rating 0,222,136,18,118,62,0,52,44,5,3,10,3,7,24,1,3,0,20
S01008807,Occupancy rating -1 or less,108,58,7,51,34,2,28,17,8,3,4,3,1,16,2,0,0,14
S01008808,All households,391,198,53,145,155,11,127,92,30,5,17,11,6,38,2,6,0,30
S01008808,Occupancy rating +2 or more,58,31,11,20,25,2,21,18,3,0,2,2,0,2,0,0,0,2
S01008808,Occupancy rating +1,107,50,11,39,51,2,46,37,8,1,3,1,2,6,0,1,0,5
S01008808,Occupancy rating 0,178,97,26,71,61,7,46,29,15,2,8,4,4,20,0,3,0,17
S01008808,Occupancy rating -1 or less,48,20,5,15,18,0,14,8,4,2,4,4,0,10,2,2,0,6
S01008809,All households,324,129,27,102,149,15,119,84,30,5,15,11,4,46,1,17,2,26
S01008809,Occupancy rating +2 or more,114,34,13,21,68,13,51,28,21,2,4,3,1,12,0,3,2,7
S01008809,Occupancy rating +1,82,36,8,28,39,1,34,29,3,2,4,3,1,7,1,3,0,3
S01008809,Occupancy rating 0,79,34,4,30,26,0,23,20,3,0,3,3,0,19,0,10,0,9
S01008809,Occupancy rating -1 or less,49,25,2,23,16,1,11,7,3,1,4,2,2,8,0,1,0,7
S01008810,All households,383,162,24,138,142,4,124,84,36,4,14,11,3,79,5,18,0,56
S01008810,Occupancy rating +2 or more,67,31,6,25,34,0,32,23,8,1,2,2,0,2,0,1,0,1
S01008810,Occupancy rating +1,144,73,10,63,53,3,46,34,9,3,4,3,1,18,2,1,0,15
S01008810,Occupancy rating 0,138,50,7,43,45,1,38,22,16,0,6,4,2,43,1,13,0,29
S01008810,Occupancy rating -1 or less,34,8,1,7,10,0,8,5,3,0,2,2,0,16,2,3,0,11
S01008811,All households,389,145,19,126,136,8,118,80,26,12,10,4,6,108,4,29,1,74
S01008811,Occupancy rating +2 or more,94,46,10,36,43,5,38,22,11,5,0,0,0,5,2,0,0,3
S01008811,Occupancy rating +1,112,42,6,36,46,1,43,32,6,5,2,0,2,24,0,6,1,17
S01008811,Occupancy rating 0,124,39,2,37,39,2,31,22,8,1,6,3,3,46,0,16,0,30
S01008811,Occupancy rating -1 or less,59,18,1,17,8,0,6,4,1,1,2,1,1,33,2,7,0,24
S01008812,All households,260,120,17,103,83,4,65,46,16,3,14,6,8,57,2,18,0,37
S01008812,Occupancy rating +2 or more,38,21,5,16,15,1,12,12,0,0,2,0,2,2,0,0,0,2
S01008812,Occupancy rating +1,102,55,7,48,35,2,29,25,3,1,4,2,2,12,0,3,0,9
S01008812,Occupancy rating 0,75,26,4,22,21,0,15,5,9,1,6,2,4,28,1,10,0,17
S01008812,Occupancy rating -1 or less,45,18,1,17,12,1,9,4,4,1,2,2,0,15,1,5,0,9
S01008813,All households,508,252,37,215,203,9,137,68,51,18,57,36,21,53,5,8,1,39
S01008813,Occupancy rating +2 or more,63,25,7,18,35,5,26,13,8,5,4,0,4,3,1,0,0,2
S01008813,Occupancy rating +1,144,79,12,67,62,4,51,32,14,5,7,5,2,3,0,1,1,1
S01008813,Occupancy rating 0,188,85,9,76,71,0,39,15,19,5,32,19,13,32,1,5,0,26
S01008813,Occupancy rating -1 or less,113,63,9,54,35,0,21,8,10,3,14,12,2,15,3,2,0,10
S01008814,All households,403,148,22,126,187,18,136,86,39,11,33,26,7,68,7,12,0,49
S01008814,Occupancy rating +2 or more,113,39,8,31,67,11,50,36,11,3,6,4,2,7,0,0,0,7
S01008814,Occupancy rating +1,94,34,4,30,48,5,38,24,10,4,5,3,2,12,1,0,0,11
S01008814,Occupancy rating 0,127,53,6,47,48,2,31,17,11,3,15,13,2,26,3,8,0,15
S01008814,Occupancy rating -1 or less,69,22,4,18,24,0,17,9,7,1,7,6,1,23,3,4,0,16
S01008815,All households,557,314,31,283,189,3,150,107,39,4,36,28,8,54,2,7,0,45
S01008815,Occupancy rating +2 or more,23,10,3,7,10,0,10,7,2,1,0,0,0,3,0,0,0,3
S01008815,Occupancy rating +1,127,66,7,59,53,3,46,44,2,0,4,3,1,8,0,0,0,8
S01008815,Occupancy rating 0,241,137,12,125,82,0,64,41,22,1,18,14,4,22,0,2,0,20
S01008815,Occupancy rating -1 or less,166,101,9,92,44,0,30,15,13,2,14,11,3,21,2,5,0,14
S01008816,All households,321,176,34,142,116,13,81,70,10,1,22,13,9,29,4,2,2,21
S01008816,Occupancy rating +2 or more,14,6,0,6,7,0,5,5,0,0,2,1,1,1,0,0,0,1
S01008816,Occupancy rating +1,68,36,8,28,31,6,22,22,0,0,3,1,2,1,0,0,0,1
S01008816,Occupancy rating 0,164,86,22,64,65,6,47,38,8,1,12,6,6,13,0,1,1,11
S01008816,Occupancy rating -1 or less,75,48,4,44,13,1,7,5,2,0,5,5,0,14,4,1,1,8
S01008817,All households,425,189,19,170,196,9,138,85,47,6,49,38,11,40,2,2,0,36
S01008817,Occupancy rating +2 or more,25,6,1,5,17,2,14,11,2,1,1,1,0,2,0,0,0,2
S01008817,Occupancy rating +1,122,67,5,62,54,4,49,41,7,1,1,1,0,1,0,0,0,1
S01008817,Occupancy rating 0,191,87,10,77,85,3,53,27,24,2,29,24,5,19,1,1,0,17
S01008817,Occupancy rating -1 or less,87,29,3,26,40,0,22,6,14,2,18,12,6,18,1,1,0,16
S01008818,All households,371,124,20,104,210,10,161,82,65,14,39,33,6,37,4,3,1,29
S01008818,Occupancy rating +2 or more,77,22,4,18,52,8,40,25,11,4,4,4,0,3,1,0,0,2
S01008818,Occupancy rating +1,103,49,10,39,51,1,45,27,14,4,5,2,3,3,0,0,0,3
S01008818,Occupancy rating 0,124,41,6,35,68,1,56,25,25,6,11,9,2,15,2,0,1,12
S01008818,Occupancy rating -1 or less,67,12,0,12,39,0,20,5,15,0,19,18,1,16,1,3,0,12
S01008819,All households,368,157,30,127,189,13,155,91,54,10,21,16,5,22,2,0,1,19
S01008819,Occupancy rating +2 or more,89,30,9,21,56,9,47,29,12,6,0,0,0,3,2,0,0,1
S01008819,Occupancy rating +1,123,65,13,52,53,3,46,39,6,1,4,2,2,5,0,0,0,5
S01008819,Occupancy rating 0,128,51,5,46,67,1,52,21,29,2,14,12,2,10,0,0,1,9
S01008819,Occupancy rating -1 or less,28,11,3,8,13,0,10,2,7,1,3,2,1,4,0,0,0,4
S01008820,All households,616,315,64,251,234,9,168,98,61,9,57,44,13,67,9,5,2,51
S01008820,Occupancy rating +2 or more,59,19,6,13,34,1,30,18,11,1,3,3,0,6,1,1,0,4
S01008820,Occupancy rating +1,162,84,12,72,65,0,60,47,12,1,5,4,1,13,2,1,0,10
S01008820,Occupancy rating 0,248,128,38,90,94,7,55,27,25,3,32,24,8,26,1,1,0,24
S01008820,Occupancy rating -1 or less,147,84,8,76,41,1,23,6,13,4,17,13,4,22,5,2,2,13
S01008821,All households,271,73,16,57,173,11,145,47,77,21,17,15,2,25,5,0,2,18
S01008821,Occupancy rating +2 or more,154,29,8,21,115,9,104,34,51,19,2,2,0,10,2,0,1,7
S01008821,Occupancy rating +1,48,22,6,16,23,2,18,6,12,0,3,2,1,3,1,0,0,2
S01008821,Occupancy rating 0,41,13,2,11,19,0,14,3,9,2,5,5,0,9,1,0,1,7
S01008821,Occupancy rating -1 or less,28,9,0,9,16,0,9,4,5,0,7,6,1,3,1,0,0,2
S01008822,All households,286,74,28,46,192,21,157,59,77,21,14,7,7,20,7,0,0,13
S01008822,Occupancy rating +2 or more,186,35,17,18,142,14,123,46,59,18,5,2,3,9,3,0,0,6
S01008822,Occupancy rating +1,61,24,9,15,36,7,25,10,13,2,4,2,2,1,0,0,0,1
S01008822,Occupancy rating 0,29,12,2,10,10,0,5,3,2,0,5,3,2,7,1,0,0,6
S01008822,Occupancy rating -1 or less,10,3,0,3,4,0,4,0,3,1,0,0,0,3,3,0,0,0
S01008823,All households,269,81,40,41,178,30,134,51,67,16,14,7,7,10,4,0,0,6
S01008823,Occupancy rating +2 or more,153,36,23,13,113,24,86,34,43,9,3,2,1,4,2,0,0,2
S01008823,Occupancy rating +1,85,40,17,23,44,5,33,15,16,2,6,2,4,1,0,0,0,1
S01008823,Occupancy rating 0,21,5,0,5,14,0,11,2,5,4,3,2,1,2,0,0,0,2
S01008823,Occupancy rating -1 or less,10,0,0,0,7,1,4,0,3,1,2,1,1,3,2,0,0,1
S01008824,All households,510,232,67,165,262,38,194,95,76,23,30,15,15,16,3,0,0,13
S01008824,Occupancy rating +2 or more,175,58,21,37,115,26,87,50,28,9,2,1,1,2,0,0,0,2
S01008824,Occupancy rating +1,184,111,32,79,72,9,55,33,16,6,8,2,6,1,0,0,0,1
S01008824,Occupancy rating 0,118,47,9,38,62,3,43,9,27,7,16,11,5,9,2,0,0,7
S01008824,Occupancy rating -1 or less,33,16,5,11,13,0,9,3,5,1,4,1,3,4,1,0,0,3
S01008825,All households,296,107,38,69,178,21,140,63,67,10,17,12,5,11,1,0,2,8
S01008825,Occupancy rating +2 or more,128,37,16,21,89,12,75,33,35,7,2,1,1,2,0,0,0,2
S01008825,Occupancy rating +1,103,44,15,29,56,8,43,24,18,1,5,4,1,3,1,0,1,1
S01008825,Occupancy rating 0,50,18,6,12,29,1,19,4,13,2,9,6,3,3,0,0,1,2
S01008825,Occupancy rating -1 or less,15,8,1,7,4,0,3,2,1,0,1,1,0,3,0,0,0,3
S01008826,All households,378,204,37,167,158,14,128,76,42,10,16,10,6,16,2,1,2,11
S01008826,Occupancy rating +2 or more,88,28,8,20,56,9,45,23,19,3,2,2,0,4,2,0,0,2
S01008826,Occupancy rating +1,97,51,15,36,44,3,39,30,6,3,2,1,1,2,0,0,0,2
S01008826,Occupancy rating 0,91,50,12,38,34,1,26,13,12,1,7,5,2,7,0,1,1,5
S01008826,Occupancy rating -1 or less,102,75,2,73,24,1,18,10,5,3,5,2,3,3,0,0,1,2
S01008827,All households,273,68,38,30,198,26,162,56,88,18,10,9,1,7,3,0,1,3
S01008827,Occupancy rating +2 or more,220,44,30,14,170,26,136,45,74,17,8,7,1,6,3,0,1,2
S01008827,Occupancy rating +1,33,16,5,11,17,0,15,8,6,1,2,2,0,0,0,0,0,0
S01008827,Occupancy rating 0,15,4,2,2,10,0,10,3,7,0,0,0,0,1,0,0,0,1
S01008827,Occupancy rating -1 or less,5,4,1,3,1,0,1,0,1,0,0,0,0,0,0,0,0,0
S01008828,All households,439,177,63,114,248,38,187,81,79,27,23,13,10,14,1,2,1,10
S01008828,Occupancy rating +2 or more,228,73,43,30,154,36,113,43,56,14,5,3,2,1,0,0,0,1
S01008828,Occupancy rating +1,74,29,7,22,40,1,34,16,13,5,5,4,1,5,1,0,0,4
S01008828,Occupancy rating 0,71,40,9,31,27,1,18,7,6,5,8,3,5,4,0,2,1,1
S01008828,Occupancy rating -1 or less,66,35,4,31,27,0,22,15,4,3,5,3,2,4,0,0,0,4
S01008829,All households,297,88,49,39,186,32,136,47,73,16,18,13,5,23,11,5,0,7
S01008829,Occupancy rating +2 or more,140,32,21,11,101,19,81,32,42,7,1,0,1,7,5,0,0,2
S01008829,Occupancy rating +1,99,48,25,23,47,10,33,14,12,7,4,2,2,4,1,1,0,2
S01008829,Occupancy rating 0,43,4,1,3,31,2,20,1,18,1,9,8,1,8,1,4,0,3
S01008829,Occupancy rating -1 or less,15,4,2,2,7,1,2,0,1,1,4,3,1,4,4,0,0,0
S01008830,All households,334,138,73,65,185,21,143,58,74,11,21,11,10,11,1,1,1,8
S01008830,Occupancy rating +2 or more,178,56,26,30,116,10,99,46,46,7,7,4,3,6,1,1,1,3
S01008830,Occupancy rating +1,87,48,28,20,37,5,28,9,15,4,4,2,2,2,0,0,0,2
S01008830,Occupancy rating 0,48,19,16,3,27,5,13,2,11,0,9,5,4,2,0,0,0,2
S01008830,Occupancy rating -1 or less,21,15,3,12,5,1,3,1,2,0,1,0,1,1,0,0,0,1
S01008831,All households,359,129,85,44,221,47,159,62,76,21,15,4,11,9,5,0,1,3
S01008831,Occupancy rating +2 or more,229,66,50,16,159,39,116,48,53,15,4,1,3,4,2,0,1,1
S01008831,Occupancy rating +1,104,56,31,25,45,7,34,12,17,5,4,0,4,3,1,0,0,2
S01008831,Occupancy rating 0,20,6,4,2,13,1,6,2,3,1,6,3,3,1,1,0,0,0
S01008831,Occupancy rating -1 or less,6,1,0,1,4,0,3,0,3,0,1,0,1,1,1,0,0,0
S01008832,All households,350,140,45,95,196,52,121,64,47,10,23,18,5,14,3,1,2,8
S01008832,Occupancy rating +2 or more,171,49,23,26,119,38,71,30,37,4,10,6,4,3,1,0,1,1
S01008832,Occupancy rating +1,106,56,17,39,47,12,31,24,3,4,4,4,0,3,0,0,1,2
S01008832,Occupancy rating 0,63,32,4,28,26,2,17,10,6,1,7,7,0,5,0,0,0,5
S01008832,Occupancy rating -1 or less,10,3,1,2,4,0,2,0,1,1,2,1,1,3,2,1,0,0
S01008833,All households,526,236,138,98,252,36,187,105,66,16,29,18,11,38,4,9,0,25
S01008833,Occupancy rating +2 or more,193,59,20,39,125,23,92,50,33,9,10,6,4,9,2,0,0,7
S01008833,Occupancy rating +1,134,58,17,41,66,4,54,36,15,3,8,5,3,10,0,1,0,9
S01008833,Occupancy rating 0,161,90,77,13,54,8,37,17,18,2,9,5,4,17,2,7,0,8
S01008833,Occupancy rating -1 or less,38,29,24,5,7,1,4,2,0,2,2,2,0,2,0,1,0,1
S01008834,All households,519,200,79,121,288,42,225,109,96,20,21,14,7,31,7,2,1,21
S01008834,Occupancy rating +2 or more,241,80,29,51,152,32,119,64,43,12,1,1,0,9,4,0,0,5
S01008834,Occupancy rating +1,179,86,41,45,86,8,72,36,31,5,6,3,3,7,0,0,1,6
S01008834,Occupancy rating 0,81,26,9,17,46,1,31,9,19,3,14,10,4,9,0,1,0,8
S01008834,Occupancy rating -1 or less,18,8,0,8,4,1,3,0,3,0,0,0,0,6,3,1,0,2
S01008835,All households,407,162,75,87,230,37,160,76,58,26,33,21,12,15,4,0,2,9
S01008835,Occupancy rating +2 or more,137,31,16,15,103,24,77,41,23,13,2,2,0,3,2,0,0,1
S01008835,Occupancy rating +1,188,114,51,63,72,13,54,30,17,7,5,3,2,2,0,0,0,2
S01008835,Occupancy rating 0,65,14,6,8,43,0,26,3,17,6,17,11,6,8,1,0,2,5
S01008835,Occupancy rating -1 or less,17,3,2,1,12,0,3,2,1,0,9,5,4,2,1,0,0,1
S01008836,All households,413,251,49,202,125,9,93,53,33,7,23,13,10,37,6,7,0,24
S01008836,Occupancy rating +2 or more,30,20,6,14,9,2,7,7,0,0,0,0,0,1,0,0,0,1
S01008836,Occupancy rating +1,170,114,24,90,55,6,45,35,9,1,4,2,2,1,0,1,0,0
S01008836,Occupancy rating 0,150,84,12,72,42,1,30,10,15,5,11,7,4,24,0,5,0,19
S01008836,Occupancy rating -1 or less,63,33,7,26,19,0,11,1,9,1,8,4,4,11,6,1,0,4
S01008837,All households,630,338,32,306,243,7,216,162,46,8,20,16,4,49,3,7,1,38
S01008837,Occupancy rating +2 or more,65,25,6,19,37,4,30,27,3,0,3,2,1,3,0,0,0,3
S01008837,Occupancy rating +1,181,87,11,76,86,1,79,65,13,1,6,5,1,8,0,0,0,8
S01008837,Occupancy rating 0,190,99,6,93,66,0,61,34,24,3,5,4,1,25,1,3,0,21
S01008837,Occupancy rating -1 or less,194,127,9,118,54,2,46,36,6,4,6,5,1,13,2,4,1,6
S01008838,All households,606,324,58,266,234,19,199,142,47,10,16,11,5,48,2,8,0,38
S01008838,Occupancy rating +2 or more,86,35,13,22,48,7,39,23,12,4,2,2,0,3,2,0,0,1
S01008838,Occupancy rating +1,202,110,21,89,88,9,75,62,9,4,4,3,1,4,0,1,0,3
S01008838,Occupancy rating 0,180,95,17,78,56,3,46,25,20,1,7,5,2,29,0,4,0,25
S01008838,Occupancy rating -1 or less,138,84,7,77,42,0,39,32,6,1,3,1,2,12,0,3,0,9
S01008839,All households,549,245,39,206,258,23,220,143,63,14,15,8,7,46,4,8,1,33
S01008839,Occupancy rating +2 or more,114,32,12,20,74,8,63,39,17,7,3,2,1,8,2,0,1,5
S01008839,Occupancy rating +1,157,66,11,55,84,11,70,48,19,3,3,1,2,7,1,0,0,6
S01008839,Occupancy rating 0,192,103,11,92,68,1,60,37,20,3,7,4,3,21,0,7,0,14
S01008839,Occupancy rating -1 or less,86,44,5,39,32,3,27,19,7,1,2,1,1,10,1,1,0,8
S01008840,All households,510,189,45,144,247,24,204,117,79,8,19,11,8,74,8,23,0,43
S01008840,Occupancy rating +2 or more,151,77,19,58,69,10,59,38,18,3,0,0,0,5,2,1,0,2
S01008840,Occupancy rating +1,198,72,22,50,109,13,91,63,26,2,5,2,3,17,0,5,0,12
S01008840,Occupancy rating 0,98,24,3,21,46,0,38,8,28,2,8,6,2,28,1,9,0,18
S01008840,Occupancy rating -1 or less,63,16,1,15,23,1,16,8,7,1,6,3,3,24,5,8,0,11
S01008841,All households,291,100,13,87,146,14,103,71,29,3,29,18,11,45,3,9,0,33
S01008841,Occupancy rating +2 or more,59,25,7,18,32,6,23,22,0,1,3,0,3,2,0,0,0,2
S01008841,Occupancy rating +1,122,55,6,49,61,7,46,37,8,1,8,5,3,6,0,1,0,5
S01008841,Occupancy rating 0,83,17,0,17,42,0,27,11,15,1,15,11,4,24,1,7,0,16
S01008841,Occupancy rating -1 or less,27,3,0,3,11,1,7,1,6,0,3,2,1,13,2,1,0,10
S01008842,All households,433,140,12,128,197,7,165,116,42,7,25,21,4,96,3,18,0,75
S01008842,Occupancy rating +2 or more,72,21,10,11,42,6,30,20,9,1,6,5,1,9,1,1,0,7
S01008842,Occupancy rating +1,178,79,1,78,93,1,90,82,7,1,2,1,1,6,0,1,0,5
S01008842,Occupancy rating 0,132,25,0,25,48,0,33,12,17,4,15,13,2,59,1,11,0,47
S01008842,Occupancy rating -1 or less,51,15,1,14,14,0,12,2,9,1,2,2,0,22,1,5,0,16
S01008843,All households,464,202,24,178,167,6,145,96,42,7,16,8,8,95,6,11,0,78
S01008843,Occupancy rating +2 or more,53,21,4,17,27,3,23,19,3,1,1,0,1,5,1,0,0,4
S01008843,Occupancy rating +1,177,103,11,92,68,2,66,56,7,3,0,0,0,6,0,0,0,6
S01008843,Occupancy rating 0,170,66,8,58,55,0,45,19,23,3,10,5,5,49,1,6,0,42
S01008843,Occupancy rating -1 or less,64,12,1,11,17,1,11,2,9,0,5,3,2,35,4,5,0,26
S01008844,All households,355,131,12,119,154,7,127,91,32,4,20,15,5,70,1,13,0,56
S01008844,Occupancy rating +2 or more,53,26,4,22,25,3,20,18,2,0,2,1,1,2,0,0,0,2
S01008844,Occupancy rating +1,126,47,4,43,66,4,60,52,7,1,2,1,1,13,1,3,0,9
S01008844,Occupancy rating 0,107,31,4,27,39,0,30,10,19,1,9,8,1,37,0,7,0,30
S01008844,Occupancy rating -1 or less,69,27,0,27,24,0,17,11,4,2,7,5,2,18,0,3,0,15
S01008845,All households,420,173,20,153,136,9,114,79,32,3,13,7,6,111,2,50,0,59
S01008845,Occupancy rating +2 or more,118,63,10,53,43,6,31,28,2,1,6,3,3,12,2,5,0,5
S01008845,Occupancy rating +1,121,55,5,50,50,2,47,34,12,1,1,0,1,16,0,9,0,7
S01008845,Occupancy rating 0,133,42,4,38,32,1,26,13,12,1,5,3,2,59,0,25,0,34
S01008845,Occupancy rating -1 or less,48,13,1,12,11,0,10,4,6,0,1,1,0,24,0,11,0,13
S01008846,All households,386,154,29,125,139,7,118,74,39,5,14,9,5,93,7,33,0,53
S01008846,Occupancy rating +2 or more,93,29,5,24,52,3,46,26,17,3,3,1,2,12,5,0,0,7
S01008846,Occupancy rating +1,129,61,10,51,49,3,44,31,13,0,2,2,0,19,1,10,0,8
S01008846,Occupancy rating 0,124,54,12,42,25,1,20,11,8,1,4,2,2,45,0,17,0,28
S01008846,Occupancy rating -1 or less,40,10,2,8,13,0,8,6,1,1,5,4,1,17,1,6,0,10
S01008847,All households,263,90,22,68,105,5,90,61,25,4,10,6,4,68,0,28,0,40
S01008847,Occupancy rating +2 or more,95,39,10,29,50,2,46,26,17,3,2,1,1,6,0,1,0,5
S01008847,Occupancy rating +1,64,27,5,22,24,2,20,19,1,0,2,2,0,13,0,5,0,8
S01008847,Occupancy rating 0,74,18,3,15,26,1,20,13,7,0,5,2,3,30,0,14,0,16
S01008847,Occupancy rating -1 or less,30,6,4,2,5,0,4,3,0,1,1,1,0,19,0,8,0,11
S01008848,All households,384,159,25,134,157,9,138,97,30,11,10,8,2,68,2,30,0,36
S01008848,Occupancy rating +2 or more,157,64,14,50,82,9,70,50,16,4,3,3,0,11,0,4,0,7
S01008848,Occupancy rating +1,82,32,8,24,40,0,39,29,7,3,1,1,0,10,0,2,0,8
S01008848,Occupancy rating 0,113,53,2,51,29,0,23,14,7,2,6,4,2,31,1,16,0,14
S01008848,Occupancy rating -1 or less,32,10,1,9,6,0,6,4,0,2,0,0,0,16,1,8,0,7
S01008849,All households,396,187,33,154,146,22,113,80,31,2,11,9,2,63,0,24,0,39
S01008849,Occupancy rating +2 or more,141,64,20,44,71,18,48,34,13,1,5,5,0,6,0,1,0,5
S01008849,Occupancy rating +1,106,52,8,44,43,2,37,27,9,1,4,4,0,11,0,6,0,5
S01008849,Occupancy rating 0,90,42,4,38,23,2,20,15,5,0,1,0,1,25,0,10,0,15
S01008849,Occupancy rating -1 or less,59,29,1,28,9,0,8,4,4,0,1,0,1,21,0,7,0,14
S01008850,All households,401,159,37,122,180,20,139,92,39,8,21,13,8,62,2,34,1,25
S01008850,Occupancy rating +2 or more,186,74,20,54,108,14,88,59,21,8,6,6,0,4,1,1,0,2
S01008850,Occupancy rating +1,104,47,10,37,39,6,28,19,9,0,5,2,3,18,1,7,1,9
S01008850,Occupancy rating 0,80,24,6,18,30,0,22,14,8,0,8,4,4,26,0,17,0,9
S01008850,Occupancy rating -1 or less,31,14,1,13,3,0,1,0,1,0,2,1,1,14,0,9,0,5
S01008851,All households,634,372,115,257,203,18,162,120,39,3,23,11,12,59,3,10,0,46
S01008851,Occupancy rating +2 or more,139,59,24,35,70,10,53,35,16,2,7,4,3,10,1,1,0,8
S01008851,Occupancy rating +1,140,78,16,62,47,4,41,32,8,1,2,1,1,15,0,2,0,13
S01008851,Occupancy rating 0,164,95,34,61,46,2,37,26,11,0,7,3,4,23,0,6,0,17
S01008851,Occupancy rating -1 or less,191,140,41,99,40,2,31,27,4,0,7,3,4,11,2,1,0,8
S01008852,All households,503,202,46,156,243,45,183,115,58,10,15,8,7,58,4,26,1,27
S01008852,Occupancy rating +2 or more,285,111,34,77,161,38,115,71,37,7,8,4,4,13,2,7,0,4
S01008852,Occupancy rating +1,108,47,10,37,50,5,41,28,11,2,4,2,2,11,0,6,1,4
S01008852,Occupancy rating 0,81,31,1,30,28,2,24,14,9,1,2,1,1,22,2,11,0,9
S01008852,Occupancy rating -1 or less,29,13,1,12,4,0,3,2,1,0,1,1,0,12,0,2,0,10
S01008853,All households,352,146,16,130,137,3,118,82,35,1,16,14,2,69,2,23,0,44
S01008853,Occupancy rating +2 or more,91,36,7,29,51,3,44,36,7,1,4,4,0,4,0,0,0,4
S01008853,Occupancy rating +1,118,62,5,57,38,0,38,24,14,0,0,0,0,18,1,4,0,13
S01008853,Occupancy rating 0,103,38,1,37,40,0,32,18,14,0,8,6,2,25,1,7,0,17
S01008853,Occupancy rating -1 or less,40,10,3,7,8,0,4,4,0,0,4,4,0,22,0,12,0,10
S01008854,All households,483,226,38,188,171,12,143,101,36,6,16,10,6,86,3,37,2,44
S01008854,Occupancy rating +2 or more,160,73,14,59,80,11,65,42,18,5,4,1,3,7,1,0,1,5
S01008854,Occupancy rating +1,135,68,11,57,42,0,37,28,9,0,5,4,1,25,0,9,0,16
S01008854,Occupancy rating 0,132,61,8,53,35,1,31,23,7,1,3,3,0,36,2,18,1,15
S01008854,Occupancy rating -1 or less,56,24,5,19,14,0,10,8,2,0,4,2,2,18,0,10,0,8
S01008855,All households,620,315,45,270,237,9,201,146,49,6,27,15,12,68,2,16,0,50
S01008855,Occupancy rating +2 or more,182,82,12,70,96,8,82,59,21,2,6,2,4,4,0,1,0,3
S01008855,Occupancy rating +1,199,118,20,98,72,0,69,53,14,2,3,0,3,9,0,1,0,8
S01008855,Occupancy rating 0,174,75,10,65,60,1,43,31,10,2,16,11,5,39,0,11,0,28
S01008855,Occupancy rating -1 or less,65,40,3,37,9,0,7,3,4,0,2,2,0,16,2,3,0,11
S01008856,All households,296,118,13,105,128,5,107,78,28,1,16,10,6,50,3,7,0,40
S01008856,Occupancy rating +2 or more,65,22,7,15,41,4,34,24,9,1,3,1,2,2,0,0,0,2
S01008856,Occupancy rating +1,82,29,3,26,43,0,37,28,9,0,6,4,2,10,3,1,0,6
S01008856,Occupancy rating 0,98,40,3,37,38,1,32,23,9,0,5,4,1,20,0,0,0,20
S01008856,Occupancy rating -1 or less,51,27,0,27,6,0,4,3,1,0,2,1,1,18,0,6,0,12
S01008857,All households,434,216,39,177,180,12,147,96,41,10,21,17,4,38,2,6,0,30
S01008857,Occupancy rating +2 or more,107,58,14,44,46,9,37,31,5,1,0,0,0,3,1,0,0,2
S01008857,Occupancy rating +1,108,51,10,41,50,0,40,20,15,5,10,8,2,7,0,3,0,4
S01008857,Occupancy rating 0,179,91,14,77,70,2,62,44,15,3,6,5,1,18,1,3,0,14
S01008857,Occupancy rating -1 or less,40,16,1,15,14,1,8,1,6,1,5,4,1,10,0,0,0,10
S01008858,All households,328,177,41,136,128,13,97,68,26,3,18,10,8,23,3,1,1,18
S01008858,Occupancy rating +2 or more,103,47,15,32,49,9,36,18,16,2,4,0,4,7,1,1,1,4
S01008858,Occupancy rating +1,88,43,8,35,40,3,32,28,3,1,5,3,2,5,1,0,0,4
S01008858,Occupancy rating 0,116,74,16,58,34,1,26,22,4,0,7,5,2,8,1,0,0,7
S01008858,Occupancy rating -1 or less,21,13,2,11,5,0,3,0,3,0,2,2,0,3,0,0,0,3
S01008859,All households,712,416,123,293,232,28,193,145,46,2,11,6,5,64,3,10,1,50
S01008859,Occupancy rating +2 or more,102,39,13,26,60,7,48,33,15,0,5,2,3,3,0,0,0,3
S01008859,Occupancy rating +1,215,128,25,103,73,9,62,51,10,1,2,0,2,14,0,3,0,11
S01008859,Occupancy rating 0,277,174,55,119,72,11,59,44,15,0,2,2,0,31,2,5,0,24
S01008859,Occupancy rating -1 or less,118,75,30,45,27,1,24,17,6,1,2,2,0,16,1,2,1,12
S01008860,All households,500,246,46,200,202,16,163,113,43,7,23,10,13,52,4,13,1,34
S01008860,Occupancy rating +2 or more,104,42,13,29,61,10,50,35,11,4,1,0,1,1,0,0,0,1
S01008860,Occupancy rating +1,163,77,11,66,73,4,61,49,12,0,8,3,5,13,1,5,0,7
S01008860,Occupancy rating 0,163,84,16,68,48,1,38,25,12,1,9,5,4,31,1,7,0,23
S01008860,Occupancy rating -1 or less,70,43,6,37,20,1,14,4,8,2,5,2,3,7,2,1,1,3
S01008861,All households,349,123,39,84,209,28,165,83,70,12,16,6,10,17,3,5,0,9
S01008861,Occupancy rating +2 or more,219,55,24,31,158,25,124,56,58,10,9,3,6,6,3,0,0,3
S01008861,Occupancy rating +1,82,46,9,37,32,3,25,17,7,1,4,1,3,4,0,1,0,3
S01008861,Occupancy rating 0,34,20,5,15,10,0,10,5,4,1,0,0,0,4,0,2,0,2
S01008861,Occupancy rating -1 or less,14,2,1,1,9,0,6,5,1,0,3,2,1,3,0,2,0,1
S01008862,All households,561,318,37,281,204,15,173,141,28,4,16,8,8,39,1,4,0,34
S01008862,Occupancy rating +2 or more,105,45,12,33,53,9,42,32,8,2,2,1,1,7,0,1,0,6
S01008862,Occupancy rating +1,146,88,3,85,52,3,45,37,8,0,4,3,1,6,0,1,0,5
S01008862,Occupancy rating 0,215,129,18,111,77,3,71,61,8,2,3,1,2,9,1,1,0,7
S01008862,Occupancy rating -1 or less,95,56,4,52,22,0,15,11,4,0,7,3,4,17,0,1,0,16
S01008863,All households,392,163,41,122,182,15,152,91,54,7,15,12,3,47,2,3,3,39
S01008863,Occupancy rating +2 or more,121,40,13,27,77,12,61,37,22,2,4,3,1,4,0,0,1,3
S01008863,Occupancy rating +1,123,53,14,39,53,1,49,30,16,3,3,3,0,17,0,3,0,14
S01008863,Occupancy rating 0,123,60,12,48,46,2,38,23,13,2,6,4,2,17,1,0,1,15
S01008863,Occupancy rating -1 or less,25,10,2,8,6,0,4,1,3,0,2,2,0,9,1,0,1,7
S01008864,All households,410,212,94,118,166,14,140,79,58,3,12,8,4,32,0,2,1,29
S01008864,Occupancy rating +2 or more,101,43,13,30,55,4,48,20,27,1,3,0,3,3,0,0,0,3
S01008864,Occupancy rating +1,171,97,42,55,63,7,53,43,10,0,3,2,1,11,0,1,0,10
S01008864,Occupancy rating 0,121,67,35,32,41,3,34,15,18,1,4,4,0,13,0,0,1,12
S01008864,Occupancy rating -1 or less,17,5,4,1,7,0,5,1,3,1,2,2,0,5,0,1,0,4
S01008865,All households,455,219,85,134,181,12,138,84,47,7,31,24,7,55,3,3,1,48
S01008865,Occupancy rating +2 or more,201,129,58,71,71,8,61,53,7,1,2,1,1,1,0,0,0,1
S01008865,Occupancy rating +1,144,64,20,44,64,4,47,22,24,1,13,10,3,16,0,0,1,15
S01008865,Occupancy rating 0,90,20,5,15,42,0,28,9,14,5,14,11,3,28,3,2,0,23
S01008865,Occupancy rating -1 or less,20,6,2,4,4,0,2,0,2,0,2,2,0,10,0,1,0,9
S01008866,All households,467,237,47,190,188,11,163,111,47,5,14,9,5,42,2,1,0,39
S01008866,Occupancy rating +2 or more,124,51,17,34,67,6,59,37,19,3,2,1,1,6,1,0,0,5
S01008866,Occupancy rating +1,165,89,15,74,68,2,61,49,12,0,5,4,1,8,0,0,0,8
S01008866,Occupancy rating 0,147,82,12,70,43,3,34,23,9,2,6,3,3,22,0,1,0,21
S01008866,Occupancy rating -1 or less,31,15,3,12,10,0,9,2,7,0,1,1,0,6,1,0,0,5
S01008867,All households,421,170,54,116,225,28,175,109,61,5,22,11,11,26,2,1,0,23
S01008867,Occupancy rating +2 or more,207,73,30,43,128,24,97,64,32,1,7,2,5,6,1,0,0,5
S01008867,Occupancy rating +1,136,72,17,55,58,3,50,34,12,4,5,4,1,6,0,0,0,6
S01008867,Occupancy rating 0,65,20,5,15,34,1,24,9,15,0,9,5,4,11,1,1,0,9
S01008867,Occupancy rating -1 or less,13,5,2,3,5,0,4,2,2,0,1,0,1,3,0,0,0,3
S01008868,All households,391,180,17,163,135,5,120,93,23,4,10,4,6,76,4,22,0,50
S01008868,Occupancy rating +2 or more,81,29,4,25,46,3,41,25,13,3,2,1,1,6,2,0,0,4
S01008868,Occupancy rating +1,114,53,6,47,44,2,39,32,6,1,3,2,1,17,0,4,0,13
S01008868,Occupancy rating 0,121,55,4,51,27,0,24,21,3,0,3,1,2,39,2,16,0,21
S01008868,Occupancy rating -1 or less,75,43,3,40,18,0,16,15,1,0,2,0,2,14,0,2,0,12
S01008869,All households,615,325,83,242,256,33,205,159,37,9,18,9,9,34,1,9,1,23
S01008869,Occupancy rating +2 or more,212,86,24,62,121,22,89,67,17,5,10,4,6,5,0,2,0,3
S01008869,Occupancy rating +1,193,105,15,90,78,9,67,59,6,2,2,0,2,10,0,2,0,8
S01008869,Occupancy rating 0,146,88,26,62,44,2,37,25,10,2,5,4,1,14,0,4,1,9
S01008869,Occupancy rating -1 or less,64,46,18,28,13,0,12,8,4,0,1,1,0,5,1,1,0,3
S01008870,All households,426,187,32,155,209,26,166,123,38,5,17,11,6,30,2,2,0,26
S01008870,Occupancy rating +2 or more,197,78,23,55,114,19,89,66,19,4,6,3,3,5,0,0,0,5
S01008870,Occupancy rating +1,97,38,6,32,52,5,44,30,13,1,3,2,1,7,1,0,0,6
S01008870,Occupancy rating 0,83,38,1,37,33,2,27,23,4,0,4,2,2,12,1,2,0,9
S01008870,Occupancy rating -1 or less,49,33,2,31,10,0,6,4,2,0,4,4,0,6,0,0,0,6
S01008871,All households,503,202,40,162,230,15,193,122,58,13,22,11,11,71,0,27,0,44
S01008871,Occupancy rating +2 or more,213,82,17,65,123,10,106,65,34,7,7,2,5,8,0,0,0,8
S01008871,Occupancy rating +1,142,66,15,51,63,4,52,34,15,3,7,5,2,13,0,2,0,11
S01008871,Occupancy rating 0,99,40,8,32,34,1,27,16,9,2,6,2,4,25,0,9,0,16
S01008871,Occupancy rating -1 or less,49,14,0,14,10,0,8,7,0,1,2,2,0,25,0,16,0,9
S01008872,All households,401,151,28,123,170,12,148,95,47,6,10,4,6,80,3,37,0,40
S01008872,Occupancy rating +2 or more,135,53,7,46,74,8,63,35,24,4,3,0,3,8,1,1,0,6
S01008872,Occupancy rating +1,141,63,13,50,64,3,59,47,11,1,2,2,0,14,0,6,0,8
S01008872,Occupancy rating 0,98,32,6,26,26,1,22,11,10,1,3,0,3,40,0,20,0,20
S01008872,Occupancy rating -1 or less,27,3,2,1,6,0,4,2,2,0,2,2,0,18,2,10,0,6
S01008873,All households,334,123,29,94,194,28,158,86,65,7,8,1,7,17,2,2,0,13
S01008873,Occupancy rating +2 or more,171,44,20,24,125,24,95,41,49,5,6,0,6,2,1,0,0,1
S01008873,Occupancy rating +1,91,42,8,34,45,3,40,28,11,1,2,1,1,4,1,0,0,3
S01008873,Occupancy rating 0,53,25,1,24,19,1,18,13,5,0,0,0,0,9,0,1,0,8
S01008873,Occupancy rating -1 or less,19,12,0,12,5,0,5,4,0,1,0,0,0,2,0,1,0,1
S01008874,All households,514,277,82,195,196,22,155,101,47,7,19,12,7,41,3,11,0,27
S01008874,Occupancy rating +2 or more,127,72,22,50,55,8,45,36,9,0,2,1,1,0,0,0,0,0
S01008874,Occupancy rating +1,211,122,27,95,81,7,68,50,14,4,6,5,1,8,1,3,0,4
S01008874,Occupancy rating 0,144,70,29,41,50,5,35,10,23,2,10,5,5,24,1,3,0,20
S01008874,Occupancy rating -1 or less,32,13,4,9,10,2,7,5,1,1,1,1,0,9,1,5,0,3
S01008875,All households,502,280,90,190,174,13,137,95,37,5,24,13,11,48,0,9,2,37
S01008875,Occupancy rating +2 or more,52,21,5,16,28,1,24,17,6,1,3,1,2,3,0,1,0,2
S01008875,Occupancy rating +1,172,115,34,81,49,6,42,37,5,0,1,0,1,8,0,0,1,7
S01008875,Occupancy rating 0,203,112,45,67,70,6,51,31,17,3,13,9,4,21,0,4,1,16
S01008875,Occupancy rating -1 or less,75,32,6,26,27,0,20,10,9,1,7,3,4,16,0,4,0,12
S01008876,All households,291,130,93,37,150,26,111,38,60,13,13,5,8,11,2,1,2,6
S01008876,Occupancy rating +2 or more,139,54,26,28,83,14,64,27,28,9,5,2,3,2,0,0,1,1
S01008876,Occupancy rating +1,76,37,32,5,35,7,27,10,15,2,1,0,1,4,1,0,1,2
S01008876,Occupancy rating 0,72,39,35,4,29,4,19,1,16,2,6,3,3,4,1,1,0,2
S01008876,Occupancy rating -1 or less,4,0,0,0,3,1,1,0,1,0,1,0,1,1,0,0,0,1
S01008877,All households,243,82,50,32,148,19,116,43,66,7,13,8,5,13,0,1,0,12
S01008877,Occupancy rating +2 or more,158,53,29,24,104,17,81,37,40,4,6,3,3,1,0,0,0,1
S01008877,Occupancy rating +1,52,18,13,5,29,2,24,4,19,1,3,2,1,5,0,0,0,5
S01008877,Occupancy rating 0,26,7,6,1,13,0,10,2,6,2,3,2,1,6,0,1,0,5
S01008877,Occupancy rating -1 or less,7,4,2,2,2,0,1,0,1,0,1,1,0,1,0,0,0,1
S01008878,All households,459,173,86,87,263,48,163,81,60,22,52,30,22,23,3,2,4,14
S01008878,Occupancy rating +2 or more,155,47,27,20,102,18,77,38,31,8,7,4,3,6,0,0,2,4
S01008878,Occupancy rating +1,205,110,52,58,92,27,61,40,14,7,4,2,2,3,0,0,1,2
S01008878,Occupancy rating 0,76,11,5,6,55,3,21,3,14,4,31,18,13,10,0,1,1,8
S01008878,Occupancy rating -1 or less,23,5,2,3,14,0,4,0,1,3,10,6,4,4,3,1,0,0
S01008879,All households,411,167,85,82,230,23,169,80,61,28,38,24,14,14,3,0,2,9
S01008879,Occupancy rating +2 or more,122,44,20,24,74,10,61,33,18,10,3,2,1,4,0,0,0,4
S01008879,Occupancy rating +1,188,102,56,46,85,11,66,42,17,7,8,4,4,1,0,0,0,1
S01008879,Occupancy rating 0,87,17,6,11,63,2,39,4,25,10,22,17,5,7,3,0,2,2
S01008879,Occupancy rating -1 or less,14,4,3,1,8,0,3,1,1,1,5,1,4,2,0,0,0,2
S01008880,All households,291,116,41,75,156,18,118,50,54,14,20,11,9,19,5,2,3,9
S01008880,Occupancy rating +2 or more,128,35,10,25,89,9,74,30,35,9,6,3,3,4,2,0,0,2
S01008880,Occupancy rating +1,111,72,25,47,36,9,26,20,5,1,1,0,1,3,1,0,0,2
S01008880,Occupancy rating 0,44,5,3,2,29,0,16,0,12,4,13,8,5,10,1,2,2,5
S01008880,Occupancy rating -1 or less,8,4,3,1,2,0,2,0,2,0,0,0,0,2,1,0,1,0
S01008881,All households,264,105,47,58,143,38,97,53,36,8,8,5,3,16,2,1,2,11
S01008881,Occupancy rating +2 or more,192,66,34,32,115,38,71,37,27,7,6,4,2,11,1,0,2,8
S01008881,Occupancy rating +1,34,19,9,10,15,0,15,9,5,1,0,0,0,0,0,0,0,0
S01008881,Occupancy rating 0,29,18,4,14,8,0,7,5,2,0,1,0,1,3,1,0,0,2
S01008881,Occupancy rating -1 or less,9,2,0,2,5,0,4,2,2,0,1,1,0,2,0,1,0,1
S01008882,All households,401,113,43,70,277,27,235,96,119,20,15,8,7,11,4,0,0,7
S01008882,Occupancy rating +2 or more,297,57,33,24,233,24,200,78,105,17,9,6,3,7,3,0,0,4
S01008882,Occupancy rating +1,72,37,6,31,32,3,25,16,7,2,4,2,2,3,1,0,0,2
S01008882,Occupancy rating 0,22,16,3,13,6,0,6,2,4,0,0,0,0,0,0,0,0,0
S01008882,Occupancy rating -1 or less,10,3,1,2,6,0,4,0,3,1,2,0,2,1,0,0,0,1
S01008883,All households,362,104,66,38,250,56,181,61,101,19,13,8,5,8,3,0,0,5
S01008883,Occupancy rating +2 or more,325,90,61,29,231,54,166,58,90,18,11,7,4,4,1,0,0,3
S01008883,Occupancy rating +1,25,14,5,9,9,1,8,3,5,0,0,0,0,2,0,0,0,2
S01008883,Occupancy rating 0,8,0,0,0,7,1,4,0,3,1,2,1,1,1,1,0,0,0
S01008883,Occupancy rating -1 or less,4,0,0,0,3,0,3,0,3,0,0,0,0,1,1,0,0,0
S01008884,All households,316,98,74,24,208,62,137,54,67,16,9,3,6,10,5,0,2,3
S01008884,Occupancy rating +2 or more,276,86,66,20,185,61,120,50,57,13,4,1,3,5,1,0,1,3
S01008884,Occupancy rating +1,27,6,6,0,17,1,14,4,8,2,2,0,2,4,3,0,1,0
S01008884,Occupancy rating 0,12,5,1,4,6,0,3,0,2,1,3,2,1,1,1,0,0,0
S01008884,Occupancy rating -1 or less,1,1,1,0,0,0,0,0,0,0,0,0,0,0,0,0,0,0
S01008885,All households,345,80,56,24,258,38,202,60,122,20,18,11,7,7,2,0,1,4
S01008885,Occupancy rating +2 or more,302,77,55,22,220,36,175,56,101,18,9,6,3,5,1,0,1,3
S01008885,Occupancy rating +1,26,2,1,1,24,1,19,1,18,0,4,2,2,0,0,0,0,0
S01008885,Occupancy rating 0,10,0,0,0,10,1,6,2,2,2,3,3,0,0,0,0,0,0
S01008885,Occupancy rating -1 or less,7,1,0,1,4,0,2,1,1,0,2,0,2,2,1,0,0,1
S01008886,All households,425,197,67,130,200,35,128,64,52,12,37,25,12,28,5,4,0,19
S01008886,Occupancy rating +2 or more,188,84,45,39,97,28,63,38,17,8,6,4,2,7,2,0,0,5
S01008886,Occupancy rating +1,152,90,19,71,57,7,41,22,16,3,9,5,4,5,1,0,0,4
S01008886,Occupancy rating 0,64,15,2,13,38,0,21,4,16,1,17,11,6,11,2,2,0,7
S01008886,Occupancy rating -1 or less,21,8,1,7,8,0,3,0,3,0,5,5,0,5,0,2,0,3
S01008887,All households,358,137,66,71,203,30,146,52,73,21,27,17,10,18,2,4,3,9
S01008887,Occupancy rating +2 or more,211,70,38,32,136,24,102,40,48,14,10,7,3,5,1,0,1,3
S01008887,Occupancy rating +1,101,55,22,33,45,5,29,11,15,3,11,5,6,1,0,0,1,0
S01008887,Occupancy rating 0,37,10,4,6,18,1,13,1,8,4,4,3,1,9,0,4,1,4
S01008887,Occupancy rating -1 or less,9,2,2,0,4,0,2,0,2,0,2,2,0,3,1,0,0,2
S01008888,All households,373,212,44,168,140,12,113,77,32,4,15,8,7,21,3,7,1,10
S01008888,Occupancy rating +2 or more,59,29,11,18,28,4,21,17,4,0,3,1,2,2,0,1,0,1
S01008888,Occupancy rating +1,158,101,21,80,57,6,47,44,1,2,4,3,1,0,0,0,0,0
S01008888,Occupancy rating 0,138,77,11,66,47,2,38,14,22,2,7,3,4,14,1,4,1,8
S01008888,Occupancy rating -1 or less,18,5,1,4,8,0,7,2,5,0,1,1,0,5,2,2,0,1
S01008889,All households,267,102,33,69,149,29,106,58,37,11,14,11,3,16,6,1,0,9
S01008889,Occupancy rating +2 or more,105,36,13,23,67,21,42,20,19,3,4,3,1,2,1,0,0,1
S01008889,Occupancy rating +1,64,30,14,16,29,3,25,14,7,4,1,0,1,5,1,0,0,4
S01008889,Occupancy rating 0,69,23,6,17,41,3,30,20,8,2,8,8,0,5,2,0,0,3
S01008889,Occupancy rating -1 or less,29,13,0,13,12,2,9,4,3,2,1,0,1,4,2,1,0,1
S01008890,All households,308,75,46,29,224,49,155,68,70,17,20,9,11,9,3,0,2,4
S01008890,Occupancy rating +2 or more,199,46,34,12,151,42,103,56,39,8,6,0,6,2,1,0,0,1
S01008890,Occupancy rating +1,69,19,11,8,46,6,35,11,19,5,5,2,3,4,0,0,2,2
S01008890,Occupancy rating 0,26,3,0,3,23,1,16,0,12,4,6,4,2,0,0,0,0,0
S01008890,Occupancy rating -1 or less,14,7,1,6,4,0,1,1,0,0,3,3,0,3,2,0,0,1
S01008891,All households,329,84,53,31,234,51,166,72,77,17,17,9,8,11,4,0,2,5
S01008891,Occupancy rating +2 or more,232,57,35,22,172,42,126,63,51,12,4,3,1,3,0,0,1,2
S01008891,Occupancy rating +1,57,23,15,8,33,8,19,9,9,1,6,2,4,1,1,0,0,0
S01008891,Occupancy rating 0,33,3,2,1,25,1,19,0,15,4,5,2,3,5,1,0,1,3
S01008891,Occupancy rating -1 or less,7,1,1,0,4,0,2,0,2,0,2,2,0,2,2,0,0,0
S01008892,All households,533,265,155,110,246,37,173,93,64,16,36,20,16,22,1,4,0,17
S01008892,Occupancy rating +2 or more,182,63,37,26,116,23,90,51,33,6,3,2,1,3,0,0,0,3
S01008892,Occupancy rating +1,175,103,50,53,70,8,51,35,12,4,11,7,4,2,1,0,0,1
S01008892,Occupancy rating 0,142,79,62,17,48,6,22,4,13,5,20,10,10,15,0,4,0,11
S01008892,Occupancy rating -1 or less,34,20,6,14,12,0,10,3,6,1,2,1,1,2,0,0,0,2
S01008893,All households,353,72,51,21,268,43,212,66,113,33,13,7,6,13,5,1,3,4
S01008893,Occupancy rating +2 or more,296,58,43,15,231,40,182,63,90,29,9,5,4,7,4,0,3,0
S01008893,Occupancy rating +1,41,10,6,4,28,3,22,2,17,3,3,1,2,3,1,0,0,2
S01008893,Occupancy rating 0,13,2,0,2,8,0,8,1,6,1,0,0,0,3,0,1,0,2
S01008893,Occupancy rating -1 or less,3,2,2,0,1,0,0,0,0,0,1,1,0,0,0,0,0,0
S01008894,All households,337,64,43,21,266,50,201,67,103,31,15,9,6,7,3,0,1,3
S01008894,Occupancy rating +2 or more,269,49,36,13,214,44,163,63,77,23,7,5,2,6,2,0,1,3
S01008894,Occupancy rating +1,52,15,7,8,37,6,26,4,17,5,5,2,3,0,0,0,0,0
S01008894,Occupancy rating 0,13,0,0,0,12,0,9,0,6,3,3,2,1,1,1,0,0,0
S01008894,Occupancy rating -1 or less,3,0,0,0,3,0,3,0,3,0,0,0,0,0,0,0,0,0
S01008895,All households,301,94,63,31,195,35,148,49,87,12,12,6,6,12,9,0,1,2
S01008895,Occupancy rating +2 or more,228,66,46,20,156,33,113,45,58,10,10,4,6,6,5,0,0,1
S01008895,Occupancy rating +1,48,17,11,6,30,2,27,4,21,2,1,1,0,1,0,0,0,1
S01008895,Occupancy rating 0,17,8,4,4,8,0,7,0,7,0,1,1,0,1,0,0,1,0
S01008895,Occupancy rating -1 or less,8,3,2,1,1,0,1,0,1,0,0,0,0,4,4,0,0,0
S01008896,All households,208,36,23,13,164,14,140,45,87,8,10,9,1,8,1,1,1,5
S01008896,Occupancy rating +2 or more,147,12,8,4,130,8,115,39,71,5,7,7,0,5,1,0,1,3
S01008896,Occupancy rating +1,28,12,5,7,16,6,9,4,4,1,1,1,0,0,0,0,0,0
S01008896,Occupancy rating 0,27,10,9,1,14,0,13,1,11,1,1,1,0,3,0,1,0,2
S01008896,Occupancy rating -1 or less,6,2,1,1,4,0,3,1,1,1,1,0,1,0,0,0,0,0
S01008897,All households,304,97,54,43,199,44,131,50,65,16,24,14,10,8,4,0,0,4
S01008897,Occupancy rating +2 or more,179,30,21,9,145,34,103,36,54,13,8,6,2,4,2,0,0,2
S01008897,Occupancy rating +1,59,34,19,15,25,5,14,7,6,1,6,2,4,0,0,0,0,0
S01008897,Occupancy rating 0,51,28,11,17,22,4,11,6,4,1,7,5,2,1,0,0,0,1
S01008897,Occupancy rating -1 or less,15,5,3,2,7,1,3,1,1,1,3,1,2,3,2,0,0,1
S01008898,All households,331,55,39,16,266,53,198,70,107,21,15,7,8,10,4,0,1,5
S01008898,Occupancy rating +2 or more,281,50,35,15,225,48,165,68,79,18,12,5,7,6,2,0,1,3
S01008898,Occupancy rating +1,28,4,3,1,24,5,18,2,15,1,1,0,1,0,0,0,0,0
S01008898,Occupancy rating 0,15,1,1,0,13,0,12,0,11,1,1,1,0,1,1,0,0,0
S01008898,Occupancy rating -1 or less,7,0,0,0,4,0,3,0,2,1,1,1,0,3,1,0,0,2
S01008899,All households,389,149,66,83,203,20,97,37,37,23,86,56,30,37,18,0,2,17
S01008899,Occupancy rating +2 or more,71,40,14,26,31,6,19,15,3,1,6,4,2,0,0,0,0,0
S01008899,Occupancy rating +1,163,91,40,51,60,11,35,21,6,8,14,3,11,12,3,0,1,8
S01008899,Occupancy rating 0,99,8,4,4,80,3,31,1,20,10,46,32,14,11,3,0,1,7
S01008899,Occupancy rating -1 or less,56,10,8,2,32,0,12,0,8,4,20,17,3,14,12,0,0,2
S01008900,All households,415,138,63,75,246,22,153,47,58,48,71,40,31,31,12,1,1,17
S01008900,Occupancy rating +2 or more,76,30,15,15,44,7,30,14,7,9,7,4,3,2,1,0,0,1
S01008900,Occupancy rating +1,183,86,39,47,87,12,61,27,21,13,14,3,11,10,5,1,0,4
S01008900,Occupancy rating 0,117,19,7,12,86,1,53,4,25,24,32,21,11,12,3,0,1,8
S01008900,Occupancy rating -1 or less,39,3,2,1,29,2,9,2,5,2,18,12,6,7,3,0,0,4
S01008901,All households,374,122,63,59,225,32,136,52,63,21,57,32,25,27,12,0,0,15
S01008901,Occupancy rating +2 or more,113,40,24,16,66,20,44,22,16,6,2,1,1,7,2,0,0,5
S01008901,Occupancy rating +1,124,62,27,35,60,10,39,23,12,4,11,6,5,2,1,0,0,1
S01008901,Occupancy rating 0,101,15,8,7,76,1,40,3,27,10,35,21,14,10,3,0,0,7
S01008901,Occupancy rating -1 or less,36,5,4,1,23,1,13,4,8,1,9,4,5,8,6,0,0,2
S01008902,All households,485,193,64,129,250,23,142,53,64,25,85,57,28,42,8,3,1,30
S01008902,Occupancy rating +2 or more,96,44,18,26,52,11,35,21,10,4,6,3,3,0,0,0,0,0
S01008902,Occupancy rating +1,182,109,40,69,62,10,38,23,8,7,14,11,3,11,1,0,1,9
S01008902,Occupancy rating 0,142,25,5,20,99,0,52,6,35,11,47,32,15,18,3,1,0,14
S01008902,Occupancy rating -1 or less,65,15,1,14,37,2,17,3,11,3,18,11,7,13,4,2,0,7
S01008903,All households,463,169,87,82,268,44,155,71,57,27,69,35,34,26,6,0,1,19
S01008903,Occupancy rating +2 or more,113,44,21,23,66,17,45,29,8,8,4,2,2,3,0,0,1,2
S01008903,Occupancy rating +1,184,79,37,42,99,25,60,37,13,10,14,7,7,6,1,0,0,5
S01008903,Occupancy rating 0,125,33,23,10,84,2,42,4,30,8,40,18,22,8,1,0,0,7
S01008903,Occupancy rating -1 or less,41,13,6,7,19,0,8,1,6,1,11,8,3,9,4,0,0,5
S01008904,All households,431,137,42,95,213,7,116,38,60,18,90,66,24,81,14,21,1,45
S01008904,Occupancy rating +2 or more,113,73,19,54,39,3,31,24,7,0,5,4,1,1,0,1,0,0
S01008904,Occupancy rating +1,142,42,9,33,79,2,41,11,22,8,36,21,15,21,2,2,0,17
S01008904,Occupancy rating 0,107,14,10,4,65,2,34,2,23,9,29,23,6,28,4,7,0,17
S01008904,Occupancy rating -1 or less,69,8,4,4,30,0,10,1,8,1,20,18,2,31,8,11,1,11
S01008905,All households,510,215,42,173,253,10,134,53,63,18,109,74,35,42,12,7,1,22
S01008905,Occupancy rating +2 or more,84,51,12,39,31,7,21,19,1,1,3,0,3,2,1,1,0,0
S01008905,Occupancy rating +1,206,124,26,98,68,3,47,26,15,6,18,11,7,14,0,2,1,11
S01008905,Occupancy rating 0,137,22,3,19,103,0,47,4,35,8,56,40,16,12,4,2,0,6
S01008905,Occupancy rating -1 or less,83,18,1,17,51,0,19,4,12,3,32,23,9,14,7,2,0,5
S01008906,All households,386,171,13,158,184,7,100,43,42,15,77,62,15,31,8,6,0,17
S01008906,Occupancy rating +2 or more,58,32,5,27,26,2,15,8,5,2,9,8,1,0,0,0,0,0
S01008906,Occupancy rating +1,145,79,4,75,62,5,43,28,11,4,14,12,2,4,1,1,0,2
S01008906,Occupancy rating 0,124,49,4,45,62,0,28,4,18,6,34,26,8,13,3,2,0,8
S01008906,Occupancy rating -1 or less,59,11,0,11,34,0,14,3,8,3,20,16,4,14,4,3,0,7
S01008907,All households,249,65,20,45,161,10,62,9,45,8,89,67,22,23,13,1,0,9
S01008907,Occupancy rating +2 or more,40,21,10,11,18,7,7,4,3,0,4,3,1,1,0,0,0,1
S01008907,Occupancy rating +1,62,17,3,14,41,2,14,1,8,5,25,13,12,4,1,0,0,3
S01008907,Occupancy rating 0,80,16,7,9,54,1,23,2,18,3,30,25,5,10,6,1,0,3
S01008907,Occupancy rating -1 or less,67,11,0,11,48,0,18,2,16,0,30,26,4,8,6,0,0,2
S01008908,All households,421,137,39,98,243,23,132,71,43,18,88,68,20,41,12,2,0,27
S01008908,Occupancy rating +2 or more,51,24,7,17,25,5,18,17,1,0,2,0,2,2,2,0,0,0
S01008908,Occupancy rating +1,175,68,23,45,101,17,66,47,12,7,18,13,5,6,1,0,0,5
S01008908,Occupancy rating 0,140,36,6,30,86,1,35,5,21,9,50,40,10,18,1,2,0,15
S01008908,Occupancy rating -1 or less,55,9,3,6,31,0,13,2,9,2,18,15,3,15,8,0,0,7
S01008909,All households,347,92,32,60,241,22,152,57,68,27,67,49,18,14,2,1,0,11
S01008909,Occupancy rating +2 or more,56,18,6,12,38,3,31,21,8,2,4,1,3,0,0,0,0,0
S01008909,Occupancy rating +1,162,64,23,41,93,18,57,33,18,6,18,16,2,5,0,0,0,5
S01008909,Occupancy rating 0,102,6,3,3,91,1,53,3,35,15,37,28,9,5,0,1,0,4
S01008909,Occupancy rating -1 or less,27,4,0,4,19,0,11,0,7,4,8,4,4,4,2,0,0,2
S01008910,All households,211,70,26,44,127,10,78,31,34,13,39,29,10,14,5,1,0,8
S01008910,Occupancy rating +2 or more,69,32,15,17,34,8,25,18,4,3,1,1,0,3,2,0,0,1
S01008910,Occupancy rating +1,73,25,8,17,46,2,23,7,12,4,21,16,5,2,0,0,0,2
S01008910,Occupancy rating 0,58,11,2,9,42,0,28,6,16,6,14,10,4,5,1,0,0,4
S01008910,Occupancy rating -1 or less,11,2,1,1,5,0,2,0,2,0,3,2,1,4,2,1,0,1
S01008911,All households,432,151,5,146,219,9,170,110,55,5,40,31,9,62,7,4,0,51
S01008911,Occupancy rating +2 or more,52,14,0,14,35,5,29,24,5,0,1,1,0,3,0,0,0,3
S01008911,Occupancy rating +1,121,65,3,62,51,2,44,34,9,1,5,0,5,5,0,0,0,5
S01008911,Occupancy rating 0,191,69,2,67,91,2,70,48,18,4,19,16,3,31,2,3,0,26
S01008911,Occupancy rating -1 or less,68,3,0,3,42,0,27,4,23,0,15,14,1,23,5,1,0,17
S01008912,All households,333,88,42,46,231,30,182,69,90,23,19,9,10,14,5,0,0,9
S01008912,Occupancy rating +2 or more,130,30,16,14,95,19,76,33,35,8,0,0,0,5,1,0,0,4
S01008912,Occupancy rating +1,129,50,24,26,77,8,64,34,22,8,5,2,3,2,1,0,0,1
S01008912,Occupancy rating 0,60,5,1,4,52,2,38,1,31,6,12,6,6,3,0,0,0,3
S01008912,Occupancy rating -1 or less,14,3,1,2,7,1,4,1,2,1,2,1,1,4,3,0,0,1
S01008913,All households,272,57,15,42,188,12,132,53,70,9,44,36,8,27,7,1,1,18
S01008913,Occupancy rating +2 or more,110,30,8,22,77,9,59,38,20,1,9,7,2,3,2,0,0,1
S01008913,Occupancy rating +1,91,25,6,19,58,2,39,11,24,4,17,16,1,8,0,1,1,6
S01008913,Occupancy rating 0,49,2,1,1,40,1,28,4,21,3,11,7,4,7,1,0,0,6
S01008913,Occupancy rating -1 or less,22,0,0,0,13,0,6,0,5,1,7,6,1,9,4,0,0,5
S01008914,All households,398,132,67,65,245,49,148,55,66,27,48,19,29,21,4,1,2,14
S01008914,Occupancy rating +2 or more,121,38,26,12,82,25,51,28,16,7,6,2,4,1,0,0,0,1
S01008914,Occupancy rating +1,167,80,35,45,81,19,53,26,16,11,9,5,4,6,0,1,0,5
S01008914,Occupancy rating 0,77,8,4,4,61,4,34,1,25,8,23,8,15,8,1,0,2,5
S01008914,Occupancy rating -1 or less,33,6,2,4,21,1,10,0,9,1,10,4,6,6,3,0,0,3
S01008915,All households,236,66,43,23,159,25,107,33,61,13,27,14,13,11,4,1,1,5
S01008915,Occupancy rating +2 or more,116,34,22,12,78,17,56,24,25,7,5,1,4,4,1,0,1,2
S01008915,Occupancy rating +1,67,27,18,9,40,6,26,9,14,3,8,5,3,0,0,0,0,0
S01008915,Occupancy rating 0,39,4,2,2,33,1,21,0,19,2,11,5,6,2,0,1,0,1
S01008915,Occupancy rating -1 or less,14,1,1,0,8,1,4,0,3,1,3,3,0,5,3,0,0,2
S01008916,All households,593,302,151,151,270,31,153,61,64,28,86,57,29,21,5,1,2,13
S01008916,Occupancy rating +2 or more,50,24,15,9,26,3,19,10,6,3,4,1,3,0,0,0,0,0
S01008916,Occupancy rating +1,233,146,57,89,86,16,63,44,10,9,7,5,2,1,0,0,0,1
S01008916,Occupancy rating 0,243,110,67,43,120,11,52,6,34,12,57,41,16,13,2,0,1,10
S01008916,Occupancy rating -1 or less,67,22,12,10,38,1,19,1,14,4,18,10,8,7,3,1,1,2
S01008917,All households,379,199,53,146,159,4,82,36,38,8,73,49,24,21,4,1,1,15
S01008917,Occupancy rating +2 or more,28,14,4,10,14,1,11,8,3,0,2,1,1,0,0,0,0,0
S01008917,Occupancy rating +1,141,99,21,78,39,2,29,22,5,2,8,7,1,3,0,0,0,3
S01008917,Occupancy rating 0,158,66,22,44,78,1,32,5,22,5,45,32,13,14,1,1,1,11
S01008917,Occupancy rating -1 or less,52,20,6,14,28,0,10,1,8,1,18,9,9,4,3,0,0,1
S01008918,All households,293,130,10,120,146,4,70,21,45,4,72,63,9,17,6,1,0,10
S01008918,Occupancy rating +2 or more,14,9,0,9,5,1,3,2,1,0,1,1,0,0,0,0,0,0
S01008918,Occupancy rating +1,125,95,5,90,29,3,22,15,6,1,4,4,0,1,1,0,0,0
S01008918,Occupancy rating 0,118,21,2,19,86,0,29,2,25,2,57,49,8,11,1,0,0,10
S01008918,Occupancy rating -1 or less,36,5,3,2,26,0,16,2,13,1,10,9,1,5,4,1,0,0
S01008919,All households,264,112,16,96,131,5,57,15,36,6,69,54,15,21,6,2,1,12
S01008919,Occupancy rating +2 or more,22,11,2,9,10,1,2,2,0,0,7,6,1,1,0,0,0,1
S01008919,Occupancy rating +1,103,79,5,74,22,2,14,11,1,2,6,4,2,2,1,0,0,1
S01008919,Occupancy rating 0,103,14,8,6,77,1,32,2,27,3,44,35,9,12,1,1,1,9
S01008919,Occupancy rating -1 or less,36,8,1,7,22,1,9,0,8,1,12,9,3,6,4,1,0,1
S01008920,All households,586,235,24,211,288,6,241,163,71,7,41,29,12,63,2,8,0,53
S01008920,Occupancy rating +2 or more,86,24,4,20,58,2,51,33,17,1,5,4,1,4,1,0,0,3
S01008920,Occupancy rating +1,153,75,8,67,76,3,70,60,7,3,3,3,0,2,0,0,0,2
S01008920,Occupancy rating 0,224,101,8,93,99,1,82,52,28,2,16,10,6,24,0,2,0,22
S01008920,Occupancy rating -1 or less,123,35,4,31,55,0,38,18,19,1,17,12,5,33,1,6,0,26
S01008921,All households,375,170,46,124,185,15,105,38,60,7,65,47,18,20,4,1,1,14
S01008921,Occupancy rating +2 or more,46,21,6,15,25,4,18,11,7,0,3,1,2,0,0,0,0,0
S01008921,Occupancy rating +1,158,108,29,79,48,10,29,22,6,1,9,4,5,2,0,0,0,2
S01008921,Occupancy rating 0,115,26,8,18,81,1,42,3,35,4,38,29,9,8,0,0,1,7
S01008921,Occupancy rating -1 or less,56,15,3,12,31,0,16,2,12,2,15,13,2,10,4,1,0,5
S01008922,All households,400,173,80,93,213,15,131,60,52,19,67,49,18,14,4,0,0,10
S01008922,Occupancy rating +2 or more,57,21,10,11,35,5,25,17,5,3,5,2,3,1,0,0,0,1
S01008922,Occupancy rating +1,151,77,20,57,73,10,52,34,12,6,11,8,3,1,0,0,0,1
S01008922,Occupancy rating 0,144,66,45,21,73,0,39,5,27,7,34,27,7,5,2,0,0,3
S01008922,Occupancy rating -1 or less,48,9,5,4,32,0,15,4,8,3,17,12,5,7,2,0,0,5
S01008923,All households,394,182,70,112,189,18,102,41,50,11,69,43,26,23,6,2,0,15
S01008923,Occupancy rating +2 or more,36,14,4,10,22,5,16,11,3,2,1,1,0,0,0,0,0,0
S01008923,Occupancy rating +1,174,121,40,81,52,9,32,27,4,1,11,7,4,1,0,0,0,1
S01008923,Occupancy rating 0,142,37,24,13,94,1,45,2,35,8,48,30,18,11,1,1,0,9
S01008923,Occupancy rating -1 or less,42,10,2,8,21,3,9,1,8,0,9,5,4,11,5,1,0,5
S01008924,All households,372,100,36,64,236,8,131,49,62,20,97,76,21,36,17,3,0,16
S01008924,Occupancy rating +2 or more,51,12,1,11,33,1,27,18,7,2,5,5,0,6,2,1,0,3
S01008924,Occupancy rating +1,85,34,10,24,47,2,32,17,9,6,13,7,6,4,0,1,0,3
S01008924,Occupancy rating 0,185,45,21,24,124,5,59,14,34,11,60,47,13,16,6,0,0,10
S01008924,Occupancy rating -1 or less,51,9,4,5,32,0,13,0,12,1,19,17,2,10,9,1,0,0
S01008925,All households,266,58,10,48,184,2,119,46,49,24,63,51,12,24,9,4,0,11
S01008925,Occupancy rating +2 or more,83,38,4,34,40,2,35,31,2,2,3,3,0,5,1,1,0,3
S01008925,Occupancy rating +1,76,16,5,11,56,0,36,11,17,8,20,15,5,4,1,1,0,2
S01008925,Occupancy rating 0,86,4,1,3,72,0,38,3,24,11,34,27,7,10,4,2,0,4
S01008925,Occupancy rating -1 or less,21,0,0,0,16,0,10,1,6,3,6,6,0,5,3,0,0,2
S01008926,All households,242,55,15,40,163,8,127,54,54,19,28,23,5,24,10,0,0,14
S01008926,Occupancy rating +2 or more,64,12,5,7,50,3,37,20,12,5,10,10,0,2,1,0,0,1
S01008926,Occupancy rating +1,93,28,5,23,59,2,52,29,17,6,5,4,1,6,2,0,0,4
S01008926,Occupancy rating 0,67,10,3,7,46,3,32,4,21,7,11,8,3,11,4,0,0,7
S01008926,Occupancy rating -1 or less,18,5,2,3,8,0,6,1,4,1,2,1,1,5,3,0,0,2
S01008927,All households,416,159,12,147,229,2,171,101,68,2,56,47,9,28,3,3,0,22
S01008927,Occupancy rating +2 or more,15,7,2,5,7,0,7,4,3,0,0,0,0,1,0,0,0,1
S01008927,Occupancy rating +1,116,53,2,51,62,1,54,42,11,1,7,7,0,1,0,0,0,1
S01008927,Occupancy rating 0,185,72,8,64,105,1,70,37,33,0,34,28,6,8,0,1,0,7
S01008927,Occupancy rating -1 or less,100,27,0,27,55,0,40,18,21,1,15,12,3,18,3,2,0,13
S01008928,All households,298,96,33,63,182,36,109,52,45,12,37,19,18,20,1,2,0,17
S01008928,Occupancy rating +2 or more,75,27,15,12,48,21,24,18,6,0,3,0,3,0,0,0,0,0
S01008928,Occupancy rating +1,85,36,11,25,47,9,28,12,11,5,10,2,8,2,0,0,0,2
S01008928,Occupancy rating 0,92,26,5,21,57,5,41,20,17,4,11,7,4,9,0,1,0,8
S01008928,Occupancy rating -1 or less,46,7,2,5,30,1,16,2,11,3,13,10,3,9,1,1,0,7
S01008929,All households,475,303,36,267,153,5,70,28,30,12,78,60,18,19,4,2,0,13
S01008929,Occupancy rating +2 or more,27,20,4,16,6,1,5,4,0,1,0,0,0,1,0,0,0,1
S01008929,Occupancy rating +1,188,147,16,131,40,3,27,19,3,5,10,8,2,1,0,1,0,0
S01008929,Occupancy rating 0,193,106,13,93,77,0,28,3,21,4,49,37,12,10,2,1,0,7
S01008929,Occupancy rating -1 or less,67,30,3,27,30,1,10,2,6,2,19,15,4,7,2,0,0,5
S01008930,All households,427,173,59,114,232,8,117,39,56,22,107,91,16,22,8,0,2,12
S01008930,Occupancy rating +2 or more,55,19,5,14,32,1,26,16,6,4,5,4,1,4,0,0,1,3
S01008930,Occupancy rating +1,129,62,13,49,65,6,42,17,16,9,17,14,3,2,1,0,0,1
S01008930,Occupancy rating 0,165,74,34,40,85,1,33,5,23,5,51,41,10,6,0,0,0,6
S01008930,Occupancy rating -1 or less,78,18,7,11,50,0,16,1,11,4,34,32,2,10,7,0,1,2
S01008931,All households,339,131,44,87,190,17,98,25,51,22,75,56,19,18,11,1,0,6
S01008931,Occupancy rating +2 or more,54,29,8,21,25,4,17,12,4,1,4,3,1,0,0,0,0,0
S01008931,Occupancy rating +1,101,51,20,31,48,9,23,9,8,6,16,14,2,2,2,0,0,0
S01008931,Occupancy rating 0,122,42,13,29,73,2,38,4,24,10,33,18,15,7,3,1,0,3
S01008931,Occupancy rating -1 or less,62,9,3,6,44,2,20,0,15,5,22,21,1,9,6,0,0,3
S01008932,All households,404,127,28,99,235,7,153,70,69,14,75,61,14,42,8,2,0,32
S01008932,Occupancy rating +2 or more,68,17,3,14,47,1,39,25,13,1,7,5,2,4,1,0,0,3
S01008932,Occupancy rating +1,104,45,15,30,56,5,45,25,17,3,6,3,3,3,2,1,0,0
S01008932,Occupancy rating 0,147,56,9,47,78,1,48,19,19,10,29,25,4,13,0,1,0,12
S01008932,Occupancy rating -1 or less,85,9,1,8,54,0,21,1,20,0,33,28,5,22,5,0,0,17
S01008933,All households,289,92,15,77,181,6,106,33,61,12,69,54,15,16,8,0,0,8
S01008933,Occupancy rating +2 or more,32,7,0,7,21,0,18,10,6,2,3,3,0,4,2,0,0,2
S01008933,Occupancy rating +1,81,36,3,33,45,3,32,18,6,8,10,8,2,0,0,0,0,0
S01008933,Occupancy rating 0,121,38,8,30,78,3,38,3,33,2,37,30,7,5,1,0,0,4
S01008933,Occupancy rating -1 or less,55,11,4,7,37,0,18,2,16,0,19,13,6,7,5,0,0,2
S01008934,All households,354,135,37,98,205,11,125,46,70,9,69,48,21,14,5,0,0,9
S01008934,Occupancy rating +2 or more,65,19,3,16,42,3,34,11,23,0,5,1,4,4,2,0,0,2
S01008934,Occupancy rating +1,153,78,26,52,73,7,50,29,18,3,16,12,4,2,0,0,0,2
S01008934,Occupancy rating 0,104,30,8,22,67,1,29,5,20,4,37,26,11,7,2,0,0,5
S01008934,Occupancy rating -1 or less,32,8,0,8,23,0,12,1,9,2,11,9,2,1,1,0,0,0
S01008935,All households,377,96,54,42,260,63,166,56,82,28,31,24,7,21,6,0,1,14
S01008935,Occupancy rating +2 or more,212,57,39,18,153,56,91,40,40,11,6,4,2,2,1,0,1,0
S01008935,Occupancy rating +1,95,35,13,22,56,6,45,16,19,10,5,2,3,4,1,0,0,3
S01008935,Occupancy rating 0,54,1,1,0,40,1,24,0,18,6,15,15,0,13,3,0,0,10
S01008935,Occupancy rating -1 or less,16,3,1,2,11,0,6,0,5,1,5,3,2,2,1,0,0,1
S01008936,All households,157,35,20,15,119,24,86,23,58,5,9,4,5,3,1,0,0,2
S01008936,Occupancy rating +2 or more,122,28,17,11,92,20,68,19,44,5,4,2,2,2,0,0,0,2
S01008936,Occupancy rating +1,26,7,3,4,19,3,15,4,11,0,1,0,1,0,0,0,0,0
S01008936,Occupancy rating 0,9,0,0,0,8,1,3,0,3,0,4,2,2,1,1,0,0,0
S01008936,Occupancy rating -1 or less,0,0,0,0,0,0,0,0,0,0,0,0,0,0,0,0,0,0
S01008937,All households,424,195,103,92,218,28,153,65,65,23,37,27,10,11,2,0,0,9
S01008937,Occupancy rating +2 or more,137,51,33,18,84,14,64,25,28,11,6,6,0,2,0,0,0,2
S01008937,Occupancy rating +1,132,84,46,38,48,6,37,22,10,5,5,3,2,0,0,0,0,0
S01008937,Occupancy rating 0,114,49,21,28,60,7,36,11,19,6,17,11,6,5,1,0,0,4
S01008937,Occupancy rating -1 or less,41,11,3,8,26,1,16,7,8,1,9,7,2,4,1,0,0,3
S01008938,All households,285,57,38,19,216,51,150,34,96,20,15,11,4,12,5,0,3,4
S01008938,Occupancy rating +2 or more,207,51,35,16,152,46,97,33,50,14,9,5,4,4,1,0,2,1
S01008938,Occupancy rating +1,49,3,1,2,44,5,36,1,31,4,3,3,0,2,0,0,1,1
S01008938,Occupancy rating 0,24,2,2,0,17,0,14,0,12,2,3,3,0,5,3,0,0,2
S01008938,Occupancy rating -1 or less,5,1,0,1,3,0,3,0,3,0,0,0,0,1,1,0,0,0
S01008939,All households,323,73,57,16,242,58,148,48,68,32,36,23,13,8,4,0,0,4
S01008939,Occupancy rating +2 or more,242,67,53,14,173,57,107,46,45,16,9,3,6,2,1,0,0,1
S01008939,Occupancy rating +1,52,4,3,1,45,1,30,0,17,13,14,11,3,3,1,0,0,2
S01008939,Occupancy rating 0,17,2,1,1,15,0,7,2,4,1,8,5,3,0,0,0,0,0
S01008939,Occupancy rating -1 or less,12,0,0,0,9,0,4,0,2,2,5,4,1,3,2,0,0,1
S01008940,All households,255,47,31,16,202,64,131,55,61,15,7,5,2,6,3,1,1,1
S01008940,Occupancy rating +2 or more,209,40,28,12,167,60,103,46,46,11,4,2,2,2,1,0,1,0
S01008940,Occupancy rating +1,30,5,2,3,24,4,19,7,9,3,1,1,0,1,1,0,0,0
S01008940,Occupancy rating 0,15,2,1,1,10,0,8,2,5,1,2,2,0,3,1,1,0,1
S01008940,Occupancy rating -1 or less,1,0,0,0,1,0,1,0,1,0,0,0,0,0,0,0,0,0
S01008941,All households,350,87,54,33,256,53,181,57,105,19,22,16,6,7,5,0,1,1
S01008941,Occupancy rating +2 or more,265,56,35,21,206,41,150,49,84,17,15,11,4,3,2,0,0,1
S01008941,Occupancy rating +1,55,15,9,6,38,11,23,7,15,1,4,2,2,2,1,0,1,0
S01008941,Occupancy rating 0,23,14,8,6,8,1,5,0,5,0,2,2,0,1,1,0,0,0
S01008941,Occupancy rating -1 or less,7,2,2,0,4,0,3,1,1,1,1,1,0,1,1,0,0,0
S01008942,All households,333,125,52,73,206,28,149,62,67,20,29,21,8,2,1,0,0,1
S01008942,Occupancy rating +2 or more,170,42,28,14,128,24,94,42,38,14,10,8,2,0,0,0,0,0
S01008942,Occupancy rating +1,74,34,12,22,40,3,26,10,13,3,11,7,4,0,0,0,0,0
S01008942,Occupancy rating 0,71,42,12,30,28,1,22,6,13,3,5,4,1,1,0,0,0,1
S01008942,Occupancy rating -1 or less,18,7,0,7,10,0,7,4,3,0,3,2,1,1,1,0,0,0
S01008943,All households,340,79,56,23,258,63,183,72,87,24,12,9,3,3,2,0,0,1
S01008943,Occupancy rating +2 or more,304,72,51,21,231,61,166,70,75,21,4,4,0,1,1,0,0,0
S01008943,Occupancy rating +1,21,5,4,1,16,2,9,1,7,1,5,3,2,0,0,0,0,0
S01008943,Occupancy rating 0,11,2,1,1,7,0,6,0,4,2,1,1,0,2,1,0,0,1
S01008943,Occupancy rating -1 or less,4,0,0,0,4,0,2,1,1,0,2,1,1,0,0,0,0,0
S01008944,All households,429,113,73,40,307,76,203,87,98,18,28,18,10,9,3,0,0,6
S01008944,Occupancy rating +2 or more,326,71,45,26,247,67,162,78,71,13,18,11,7,8,3,0,0,5
S01008944,Occupancy rating +1,63,25,18,7,37,7,26,8,16,2,4,2,2,1,0,0,0,1
S01008944,Occupancy rating 0,30,11,9,2,19,2,12,0,9,3,5,4,1,0,0,0,0,0
S01008944,Occupancy rating -1 or less,10,6,1,5,4,0,3,1,2,0,1,1,0,0,0,0,0,0
S01008945,All households,299,48,32,16,238,42,185,78,85,22,11,5,6,13,6,0,1,6
S01008945,Occupancy rating +2 or more,257,45,32,13,200,42,151,74,62,15,7,3,4,12,6,0,1,5
S01008945,Occupancy rating +1,30,2,0,2,27,0,25,3,20,2,2,2,0,1,0,0,0,1
S01008945,Occupancy rating 0,7,1,0,1,6,0,4,0,1,3,2,0,2,0,0,0,0,0
S01008945,Occupancy rating -1 or less,5,0,0,0,5,0,5,1,2,2,0,0,0,0,0,0,0,0
S01008946,All households,397,113,69,44,271,70,183,77,76,30,18,11,7,13,5,0,2,6
S01008946,Occupancy rating +2 or more,294,72,43,29,216,62,145,60,63,22,9,3,6,6,3,0,1,2
S01008946,Occupancy rating +1,66,29,21,8,37,5,30,16,9,5,2,1,1,0,0,0,0,0
S01008946,Occupancy rating 0,25,11,5,6,12,3,5,1,1,3,4,4,0,2,0,0,1,1
S01008946,Occupancy rating -1 or less,12,1,0,1,6,0,3,0,3,0,3,3,0,5,2,0,0,3
S01008947,All households,449,124,106,18,306,76,206,68,106,32,24,17,7,19,5,0,3,11
S01008947,Occupancy rating +2 or more,325,73,56,17,245,65,168,64,81,23,12,8,4,7,3,0,0,4
S01008947,Occupancy rating +1,82,37,36,1,43,9,28,4,17,7,6,4,2,2,1,0,0,1
S01008947,Occupancy rating 0,31,13,13,0,9,1,6,0,4,2,2,1,1,9,1,0,3,5
S01008947,Occupancy rating -1 or less,11,1,1,0,9,1,4,0,4,0,4,4,0,1,0,0,0,1
S01008948,All households,285,71,35,36,203,21,165,64,72,29,17,8,9,11,5,0,0,6
S01008948,Occupancy rating +2 or more,172,38,20,18,131,16,110,52,41,17,5,1,4,3,2,0,0,1
S01008948,Occupancy rating +1,72,28,12,16,42,2,36,10,18,8,4,2,2,2,0,0,0,2
S01008948,Occupancy rating 0,32,4,3,1,23,2,15,0,11,4,6,4,2,5,2,0,0,3
S01008948,Occupancy rating -1 or less,9,1,0,1,7,1,4,2,2,0,2,1,1,1,1,0,0,0
S01008949,All households,393,121,72,49,259,34,166,43,85,38,59,30,29,13,9,0,0,4
S01008949,Occupancy rating +2 or more,119,49,30,19,66,13,45,26,13,6,8,4,4,4,2,0,0,2
S01008949,Occupancy rating +1,135,49,30,19,84,14,55,14,28,13,15,8,7,2,1,0,0,1
S01008949,Occupancy rating 0,111,22,11,11,87,4,55,3,35,17,28,14,14,2,1,0,0,1
S01008949,Occupancy rating -1 or less,28,1,1,0,22,3,11,0,9,2,8,4,4,5,5,0,0,0
S01008950,All households,420,153,86,67,246,35,163,51,81,31,48,23,25,21,7,2,2,10
S01008950,Occupancy rating +2 or more,121,55,33,22,66,11,50,24,20,6,5,1,4,0,0,0,0,0
S01008950,Occupancy rating +1,173,81,45,36,87,22,53,26,17,10,12,5,7,5,2,0,0,3
S01008950,Occupancy rating 0,92,10,5,5,73,1,48,1,33,14,24,13,11,9,2,0,2,5
S01008950,Occupancy rating -1 or less,34,7,3,4,20,1,12,0,11,1,7,4,3,7,3,2,0,2
S01008951,All households,435,193,76,117,204,30,117,72,38,7,57,38,19,38,9,0,0,29
S01008951,Occupancy rating +2 or more,64,24,11,13,34,7,20,14,4,2,7,5,2,6,1,0,0,5
S01008951,Occupancy rating +1,184,100,41,59,75,14,55,49,5,1,6,5,1,9,4,0,0,5
S01008951,Occupancy rating 0,131,48,20,28,73,7,36,9,23,4,30,18,12,10,0,0,0,10
S01008951,Occupancy rating -1 or less,56,21,4,17,22,2,6,0,6,0,14,10,4,13,4,0,0,9
S01008952,All households,421,193,59,134,199,12,110,52,43,15,77,50,27,29,3,0,1,25
S01008952,Occupancy rating +2 or more,53,26,9,17,23,1,20,12,5,3,2,0,2,4,1,0,1,2
S01008952,Occupancy rating +1,176,109,35,74,64,10,41,31,7,3,13,8,5,3,0,0,0,3
S01008952,Occupancy rating 0,138,42,11,31,78,1,33,7,19,7,44,27,17,18,0,0,0,18
S01008952,Occupancy rating -1 or less,54,16,4,12,34,0,16,2,12,2,18,15,3,4,2,0,0,2
S01008953,All households,424,158,77,81,238,41,137,53,60,24,60,35,25,28,8,0,3,17
S01008953,Occupancy rating +2 or more,131,51,23,28,78,21,46,29,10,7,11,7,4,2,1,0,0,1
S01008953,Occupancy rating +1,155,63,34,29,83,16,51,18,21,12,16,9,7,9,3,0,2,4
S01008953,Occupancy rating 0,98,28,15,13,57,3,30,4,22,4,24,13,11,13,2,0,1,10
S01008953,Occupancy rating -1 or less,40,16,5,11,20,1,10,2,7,1,9,6,3,4,2,0,0,2
S01008954,All households,434,211,111,100,196,35,117,43,51,23,44,21,23,27,7,1,1,18
S01008954,Occupancy rating +2 or more,91,38,20,18,52,13,34,15,13,6,5,1,4,1,0,0,0,1
S01008954,Occupancy rating +1,151,76,47,29,66,12,38,19,11,8,16,7,9,9,1,0,1,7
S01008954,Occupancy rating 0,156,82,36,46,62,8,39,9,25,5,15,9,6,12,5,1,0,6
S01008954,Occupancy rating -1 or less,36,15,8,7,16,2,6,0,2,4,8,4,4,5,1,0,0,4
S01008955,All households,282,91,43,48,183,19,126,50,55,21,38,25,13,8,3,0,0,5
S01008955,Occupancy rating +2 or more,143,41,30,11,97,17,73,34,31,8,7,3,4,5,1,0,0,4
S01008955,Occupancy rating +1,64,23,10,13,40,1,31,10,14,7,8,4,4,1,1,0,0,0
S01008955,Occupancy rating 0,48,13,1,12,33,1,17,6,5,6,15,10,5,2,1,0,0,1
S01008955,Occupancy rating -1 or less,27,14,2,12,13,0,5,0,5,0,8,8,0,0,0,0,0,0
S01008956,All households,406,147,31,116,240,20,183,80,66,37,37,28,9,19,5,1,0,13
S01008956,Occupancy rating +2 or more,118,31,10,21,85,10,71,33,22,16,4,4,0,2,0,0,0,2
S01008956,Occupancy rating +1,125,47,14,33,74,7,60,25,23,12,7,4,3,4,1,1,0,2
S01008956,Occupancy rating 0,112,40,6,34,64,2,43,17,18,8,19,15,4,8,2,0,0,6
S01008956,Occupancy rating -1 or less,51,29,1,28,17,1,9,5,3,1,7,5,2,5,2,0,0,3
S01008957,All households,429,133,41,92,273,42,175,78,71,26,56,34,22,23,11,0,0,12
S01008957,Occupancy rating +2 or more,190,52,20,32,132,29,94,50,27,17,9,5,4,6,2,0,0,4
S01008957,Occupancy rating +1,105,44,15,29,58,10,32,15,12,5,16,9,7,3,1,0,0,2
S01008957,Occupancy rating 0,107,35,4,31,64,2,38,12,24,2,24,13,11,8,4,0,0,4
S01008957,Occupancy rating -1 or less,27,2,2,0,19,1,11,1,8,2,7,7,0,6,4,0,0,2
S01008958,All households,404,228,104,124,162,16,111,53,45,13,35,30,5,14,3,2,1,8
S01008958,Occupancy rating +2 or more,89,24,14,10,63,3,48,21,18,9,12,10,2,2,0,0,0,2
S01008958,Occupancy rating +1,92,42,16,26,49,5,33,16,16,1,11,8,3,1,0,0,0,1
S01008958,Occupancy rating 0,153,106,45,61,40,7,24,13,9,2,9,9,0,7,2,1,0,4
S01008958,Occupancy rating -1 or less,70,56,29,27,10,1,6,3,2,1,3,3,0,4,1,1,1,1
S01008959,All households,380,129,46,83,237,29,175,79,62,34,33,18,15,14,5,1,1,7
S01008959,Occupancy rating +2 or more,123,36,12,24,85,18,62,38,13,11,5,2,3,2,0,0,1,1
S01008959,Occupancy rating +1,126,42,12,30,80,8,59,22,24,13,13,6,7,4,0,0,0,4
S01008959,Occupancy rating 0,93,42,20,22,46,2,34,11,14,9,10,5,5,5,2,1,0,2
S01008959,Occupancy rating -1 or less,38,9,2,7,26,1,20,8,11,1,5,5,0,3,3,0,0,0
S01008960,All households,328,62,7,55,253,6,225,83,121,21,22,17,5,13,11,0,0,2
S01008960,Occupancy rating +2 or more,214,21,4,17,189,5,175,57,103,15,9,9,0,4,4,0,0,0
S01008960,Occupancy rating +1,48,21,2,19,26,1,24,14,8,2,1,0,1,1,1,0,0,0
S01008960,Occupancy rating 0,42,14,1,13,26,0,19,8,8,3,7,4,3,2,1,0,0,1
S01008960,Occupancy rating -1 or less,24,6,0,6,12,0,7,4,2,1,5,4,1,6,5,0,0,1
S01008961,All households,319,99,22,77,209,34,146,63,57,26,29,17,12,11,4,1,1,5
S01008961,Occupancy rating +2 or more,105,14,7,7,90,28,60,27,19,14,2,1,1,1,0,0,1,0
S01008961,Occupancy rating +1,83,31,7,24,52,4,41,18,15,8,7,2,5,0,0,0,0,0
S01008961,Occupancy rating 0,92,39,7,32,45,2,28,11,15,2,15,9,6,8,4,1,0,3
S01008961,Occupancy rating -1 or less,39,15,1,14,22,0,17,7,8,2,5,5,0,2,0,0,0,2
S01008962,All households,275,72,36,36,193,26,145,65,54,26,22,12,10,10,3,0,0,7
S01008962,Occupancy rating +2 or more,114,21,11,10,91,18,67,37,18,12,6,2,4,2,1,0,0,1
S01008962,Occupancy rating +1,114,46,23,23,67,8,55,26,19,10,4,3,1,1,1,0,0,0
S01008962,Occupancy rating 0,39,4,1,3,30,0,20,2,15,3,10,5,5,5,1,0,0,4
S01008962,Occupancy rating -1 or less,8,1,1,0,5,0,3,0,2,1,2,2,0,2,0,0,0,2
S01008963,All households,349,91,58,33,237,52,169,78,66,25,16,11,5,21,5,0,1,15
S01008963,Occupancy rating +2 or more,229,56,37,19,165,44,118,64,37,17,3,1,2,8,3,0,1,4
S01008963,Occupancy rating +1,82,30,19,11,48,7,34,11,17,6,7,6,1,4,1,0,0,3
S01008963,Occupancy rating 0,32,5,2,3,20,0,15,2,11,2,5,4,1,7,0,0,0,7
S01008963,Occupancy rating -1 or less,6,0,0,0,4,1,2,1,1,0,1,0,1,2,1,0,0,1
S01008964,All households,211,42,32,10,166,48,101,31,57,13,17,4,13,3,1,0,0,2
S01008964,Occupancy rating +2 or more,157,36,27,9,119,44,68,25,34,9,7,1,6,2,1,0,0,1
S01008964,Occupancy rating +1,35,5,5,0,30,4,20,6,11,3,6,1,5,0,0,0,0,0
S01008964,Occupancy rating 0,17,0,0,0,17,0,13,0,12,1,4,2,2,0,0,0,0,0
S01008964,Occupancy rating -1 or less,2,1,0,1,0,0,0,0,0,0,0,0,0,1,0,0,0,1
S01008965,All households,321,89,66,23,222,57,159,64,68,27,6,2,4,10,2,0,2,6
S01008965,Occupancy rating +2 or more,252,62,47,15,183,50,130,60,45,25,3,1,2,7,1,0,1,5
S01008965,Occupancy rating +1,36,13,11,2,23,4,18,3,14,1,1,0,1,0,0,0,0,0
S01008965,Occupancy rating 0,21,4,3,1,14,3,9,1,7,1,2,1,1,3,1,0,1,1
S01008965,Occupancy rating -1 or less,12,10,5,5,2,0,2,0,2,0,0,0,0,0,0,0,0,0
S01008966,All households,252,68,49,19,182,29,141,58,64,19,12,6,6,2,2,0,0,0
S01008966,Occupancy rating +2 or more,159,41,29,12,118,24,90,42,37,11,4,0,4,0,0,0,0,0
S01008966,Occupancy rating +1,64,23,18,5,41,5,34,13,14,7,2,0,2,0,0,0,0,0
S01008966,Occupancy rating 0,26,4,2,2,21,0,16,3,12,1,5,5,0,1,1,0,0,0
S01008966,Occupancy rating -1 or less,3,0,0,0,2,0,1,0,1,0,1,1,0,1,1,0,0,0
S01008967,All households,430,93,64,29,323,66,228,86,104,38,29,11,18,14,3,1,0,10
S01008967,Occupancy rating +2 or more,324,72,49,23,246,64,167,77,67,23,15,4,11,6,1,1,0,4
S01008967,Occupancy rating +1,71,20,14,6,48,2,39,5,24,10,7,4,3,3,1,0,0,2
S01008967,Occupancy rating 0,29,1,1,0,25,0,18,2,12,4,7,3,4,3,1,0,0,2
S01008967,Occupancy rating -1 or less,6,0,0,0,4,0,4,2,1,1,0,0,0,2,0,0,0,2
S01008968,All households,398,78,48,30,309,63,223,71,106,46,23,8,15,11,4,0,1,6
S01008968,Occupancy rating +2 or more,275,55,35,20,216,56,151,65,57,29,9,4,5,4,1,0,1,2
S01008968,Occupancy rating +1,79,17,12,5,59,6,47,5,31,11,6,1,5,3,2,0,0,1
S01008968,Occupancy rating 0,35,6,1,5,27,1,19,1,12,6,7,3,4,2,1,0,0,1
S01008968,Occupancy rating -1 or less,9,0,0,0,7,0,6,0,6,0,1,0,1,2,0,0,0,2
S01008969,All households,460,107,61,46,339,72,226,91,103,32,41,19,22,14,6,0,1,7
S01008969,Occupancy rating +2 or more,259,56,36,20,201,55,133,67,54,12,13,2,11,2,1,0,0,1
S01008969,Occupancy rating +1,114,37,16,21,75,16,52,18,24,10,7,3,4,2,2,0,0,0
S01008969,Occupancy rating 0,61,8,6,2,47,1,31,2,22,7,15,9,6,6,1,0,0,5
S01008969,Occupancy rating -1 or less,26,6,3,3,16,0,10,4,3,3,6,5,1,4,2,0,1,1
S01008970,All households,438,113,63,50,309,45,237,97,100,40,27,14,13,16,3,1,0,12
S01008970,Occupancy rating +2 or more,289,65,44,21,220,39,167,71,62,34,14,7,7,4,1,0,0,3
S01008970,Occupancy rating +1,75,23,8,15,48,4,39,17,18,4,5,1,4,4,2,0,0,2
S01008970,Occupancy rating 0,59,22,9,13,34,2,26,8,16,2,6,4,2,3,0,0,0,3
S01008970,Occupancy rating -1 or less,15,3,2,1,7,0,5,1,4,0,2,2,0,5,0,1,0,4
S01008971,All households,273,49,25,24,215,32,174,63,84,27,9,8,1,9,2,0,1,6
S01008971,Occupancy rating +2 or more,220,41,25,16,173,31,136,57,57,22,6,6,0,6,2,0,0,4
S01008971,Occupancy rating +1,36,8,0,8,27,1,26,5,18,3,0,0,0,1,0,0,0,1
S01008971,Occupancy rating 0,16,0,0,0,14,0,11,1,8,2,3,2,1,2,0,0,1,1
S01008971,Occupancy rating -1 or less,1,0,0,0,1,0,1,0,1,0,0,0,0,0,0,0,0,0
S01008972,All households,304,68,30,38,223,46,165,55,91,19,12,9,3,13,3,0,1,9
S01008972,Occupancy rating +2 or more,240,47,26,21,186,43,137,42,76,19,6,5,1,7,3,0,0,4
S01008972,Occupancy rating +1,41,17,3,14,23,3,19,9,10,0,1,1,0,1,0,0,0,1
S01008972,Occupancy rating 0,18,4,1,3,11,0,8,3,5,0,3,1,2,3,0,0,1,2
S01008972,Occupancy rating -1 or less,5,0,0,0,3,0,1,1,0,0,2,2,0,2,0,0,0,2
S01008973,All households,361,140,64,76,197,28,150,83,49,18,19,11,8,24,4,1,2,17
S01008973,Occupancy rating +2 or more,170,45,19,26,116,17,94,55,29,10,5,4,1,9,2,0,1,6
S01008973,Occupancy rating +1,70,33,16,17,35,7,25,14,8,3,3,0,3,2,0,0,0,2
S01008973,Occupancy rating 0,80,41,19,22,32,4,21,10,7,4,7,5,2,7,1,0,1,5
S01008973,Occupancy rating -1 or less,41,21,10,11,14,0,10,4,5,1,4,2,2,6,1,1,0,4
S01008974,All households,374,121,76,45,233,40,151,80,57,14,42,31,11,20,1,0,3,16
S01008974,Occupancy rating +2 or more,148,35,22,13,108,27,75,41,25,9,6,2,4,5,0,0,2,3
S01008974,Occupancy rating +1,105,48,29,19,53,5,40,24,11,5,8,5,3,4,0,0,1,3
S01008974,Occupancy rating 0,93,33,22,11,56,5,31,14,17,0,20,16,4,4,0,0,0,4
S01008974,Occupancy rating -1 or less,28,5,3,2,16,3,5,1,4,0,8,8,0,7,1,0,0,6
S01008975,All households,449,259,171,88,168,50,91,50,30,11,27,21,6,22,2,1,2,17
S01008975,Occupancy rating +2 or more,70,34,21,13,32,9,23,12,9,2,0,0,0,4,1,1,0,2
S01008975,Occupancy rating +1,151,93,53,40,56,16,38,25,11,2,2,2,0,2,0,0,0,2
S01008975,Occupancy rating 0,173,100,73,27,62,20,26,11,8,7,16,11,5,11,0,0,1,10
S01008975,Occupancy rating -1 or less,55,32,24,8,18,5,4,2,2,0,9,8,1,5,1,0,1,3
S01008976,All households,212,51,29,22,157,29,119,40,58,21,9,2,7,4,0,0,0,4
S01008976,Occupancy rating +2 or more,147,38,19,19,107,26,76,36,29,11,5,2,3,2,0,0,0,2
S01008976,Occupancy rating +1,46,13,10,3,31,3,26,4,16,6,2,0,2,2,0,0,0,2
S01008976,Occupancy rating 0,12,0,0,0,12,0,11,0,8,3,1,0,1,0,0,0,0,0
S01008976,Occupancy rating -1 or less,7,0,0,0,7,0,6,0,5,1,1,0,1,0,0,0,0,0
S01008977,All households,256,60,34,26,191,37,142,60,56,26,12,5,7,5,1,0,1,3
S01008977,Occupancy rating +2 or more,180,38,26,12,138,32,101,48,33,20,5,4,1,4,1,0,1,2
S01008977,Occupancy rating +1,43,12,4,8,31,3,23,10,8,5,5,0,5,0,0,0,0,0
S01008977,Occupancy rating 0,22,7,4,3,15,1,12,1,10,1,2,1,1,0,0,0,0,0
S01008977,Occupancy rating -1 or less,11,3,0,3,7,1,6,1,5,0,0,0,0,1,0,0,0,1
S01008978,All households,252,73,25,48,169,22,111,45,46,20,36,24,12,10,3,0,0,7
S01008978,Occupancy rating +2 or more,49,13,1,12,33,8,23,14,4,5,2,0,2,3,0,0,0,3
S01008978,Occupancy rating +1,125,57,22,35,66,14,46,26,15,5,6,4,2,2,1,0,0,1
S01008978,Occupancy rating 0,55,3,2,1,50,0,27,3,16,8,23,16,7,2,0,0,0,2
S01008978,Occupancy rating -1 or less,23,0,0,0,20,0,15,2,11,2,5,4,1,3,2,0,0,1
S01008979,All households,308,71,16,55,205,12,131,44,72,15,62,53,9,32,8,1,0,23
S01008979,Occupancy rating +2 or more,39,11,2,9,28,2,22,7,10,5,4,1,3,0,0,0,0,0
S01008979,Occupancy rating +1,140,56,13,43,79,8,62,33,23,6,9,9,0,5,1,0,0,4
S01008979,Occupancy rating 0,111,4,1,3,85,1,41,4,33,4,43,39,4,22,3,1,0,18
S01008979,Occupancy rating -1 or less,18,0,0,0,13,1,6,0,6,0,6,4,2,5,4,0,0,1
S01008980,All households,334,79,20,59,228,13,143,45,73,25,72,58,14,27,8,3,0,16
S01008980,Occupancy rating +2 or more,67,19,7,12,45,4,36,23,10,3,5,4,1,3,1,1,0,1
S01008980,Occupancy rating +1,133,51,11,40,77,7,54,20,25,9,16,15,1,5,2,0,0,3
S01008980,Occupancy rating 0,99,7,1,6,78,1,42,2,30,10,35,24,11,14,2,2,0,10
S01008980,Occupancy rating -1 or less,35,2,1,1,28,1,11,0,8,3,16,15,1,5,3,0,0,2
S01008981,All households,316,89,60,29,218,51,149,55,54,40,18,7,11,9,7,0,0,2
S01008981,Occupancy rating +2 or more,184,51,38,13,132,36,87,48,26,13,9,4,5,1,0,0,0,1
S01008981,Occupancy rating +1,90,30,17,13,59,15,42,6,23,13,2,0,2,1,1,0,0,0
S01008981,Occupancy rating 0,34,7,4,3,23,0,16,0,4,12,7,3,4,4,3,0,0,1
S01008981,Occupancy rating -1 or less,8,1,1,0,4,0,4,1,1,2,0,0,0,3,3,0,0,0
S01008982,All households,352,115,39,76,219,21,140,58,64,18,58,44,14,18,3,4,0,11
S01008982,Occupancy rating +2 or more,75,32,11,21,42,8,26,19,7,0,8,6,2,1,0,0,0,1
S01008982,Occupancy rating +1,149,70,22,48,77,12,55,33,16,6,10,4,6,2,0,0,0,2
S01008982,Occupancy rating 0,99,12,6,6,79,1,45,6,30,9,33,27,6,8,0,2,0,6
S01008982,Occupancy rating -1 or less,29,1,0,1,21,0,14,0,11,3,7,7,0,7,3,2,0,2
S01008983,All households,314,119,16,103,165,1,111,49,49,13,53,37,16,30,7,3,0,20
S01008983,Occupancy rating +2 or more,24,14,2,12,9,0,8,6,2,0,1,1,0,1,0,1,0,0
S01008983,Occupancy rating +1,154,94,12,82,56,1,51,41,7,3,4,2,2,4,0,0,0,4
S01008983,Occupancy rating 0,105,6,2,4,80,0,42,0,34,8,38,29,9,19,2,2,0,15
S01008983,Occupancy rating -1 or less,31,5,0,5,20,0,10,2,6,2,10,5,5,6,5,0,0,1
S01008984,All households,227,63,20,43,157,12,98,39,49,10,47,37,10,7,5,0,0,2
S01008984,Occupancy rating +2 or more,33,13,0,13,20,1,18,8,7,3,1,1,0,0,0,0,0,0
S01008984,Occupancy rating +1,106,46,19,27,58,10,38,25,10,3,10,6,4,2,0,0,0,2
S01008984,Occupancy rating 0,72,3,1,2,67,1,36,4,28,4,30,25,5,2,2,0,0,0
S01008984,Occupancy rating -1 or less,16,1,0,1,12,0,6,2,4,0,6,5,1,3,3,0,0,0
S01008985,All households,326,121,41,80,184,32,119,47,49,23,33,17,16,21,3,2,0,16
S01008985,Occupancy rating +2 or more,59,26,14,12,31,13,17,12,4,1,1,1,0,2,1,1,0,0
S01008985,Occupancy rating +1,157,80,22,58,77,19,51,29,19,3,7,3,4,0,0,0,0,0
S01008985,Occupancy rating 0,89,11,5,6,61,0,40,6,20,14,21,12,9,17,1,1,0,15
S01008985,Occupancy rating -1 or less,21,4,0,4,15,0,11,0,6,5,4,1,3,2,1,0,0,1
S01008986,All households,343,88,58,30,248,60,169,62,79,28,19,11,8,7,3,0,0,4
S01008986,Occupancy rating +2 or more,170,43,28,15,126,44,78,49,20,9,4,3,1,1,0,0,0,1
S01008986,Occupancy rating +1,115,42,28,14,72,13,51,9,34,8,8,4,4,1,0,0,0,1
S01008986,Occupancy rating 0,43,3,2,1,38,1,31,3,19,9,6,4,2,2,1,0,0,1
S01008986,Occupancy rating -1 or less,15,0,0,0,12,2,9,1,6,2,1,0,1,3,2,0,0,1
S01008987,All households,330,66,42,24,252,58,180,67,70,43,14,2,12,12,2,0,1,9
S01008987,Occupancy rating +2 or more,176,46,28,18,125,43,78,51,16,11,4,0,4,5,1,0,1,3
S01008987,Occupancy rating +1,93,19,13,6,71,14,53,13,25,15,4,0,4,3,0,0,0,3
S01008987,Occupancy rating 0,44,1,1,0,41,1,36,3,20,13,4,2,2,2,0,0,0,2
S01008987,Occupancy rating -1 or less,17,0,0,0,15,0,13,0,9,4,2,0,2,2,1,0,0,1
S01008988,All households,481,198,82,116,253,47,165,91,59,15,41,26,15,30,10,1,1,18
S01008988,Occupancy rating +2 or more,115,41,20,21,71,21,47,31,11,5,3,1,2,3,1,0,0,2
S01008988,Occupancy rating +1,175,97,40,57,75,15,54,42,9,3,6,4,2,3,0,0,0,3
S01008988,Occupancy rating 0,149,48,15,33,87,10,49,13,30,6,28,17,11,14,1,1,1,11
S01008988,Occupancy rating -1 or less,42,12,7,5,20,1,15,5,9,1,4,4,0,10,8,0,0,2
S01008989,All households,323,129,14,115,177,6,141,70,54,17,30,21,9,17,5,0,0,12
S01008989,Occupancy rating +2 or more,37,9,0,9,27,2,24,14,6,4,1,0,1,1,0,0,0,1
S01008989,Occupancy rating +1,85,34,4,30,51,2,44,26,13,5,5,3,2,0,0,0,0,0
S01008989,Occupancy rating 0,137,55,6,49,72,2,52,19,27,6,18,14,4,10,3,0,0,7
S01008989,Occupancy rating -1 or less,64,31,4,27,27,0,21,11,8,2,6,4,2,6,2,0,0,4
S01008990,All households,383,167,25,142,198,6,162,83,59,20,30,19,11,18,3,2,0,13
S01008990,Occupancy rating +2 or more,41,13,1,12,27,0,24,16,2,6,3,1,2,1,0,0,0,1
S01008990,Occupancy rating +1,115,56,11,45,55,3,48,32,10,6,4,1,3,4,1,0,0,3
S01008990,Occupancy rating 0,154,64,10,54,81,2,57,21,31,5,22,17,5,9,0,2,0,7
S01008990,Occupancy rating -1 or less,73,34,3,31,35,1,33,14,16,3,1,0,1,4,2,0,0,2
S01008991,All households,381,99,21,78,271,10,227,83,116,28,34,17,17,11,6,0,0,5
S01008991,Occupancy rating +2 or more,173,38,12,26,135,8,121,47,61,13,6,5,1,0,0,0,0,0
S01008991,Occupancy rating +1,119,52,9,43,64,2,56,30,20,6,6,1,5,3,1,0,0,2
S01008991,Occupancy rating 0,70,7,0,7,59,0,41,4,30,7,18,8,10,4,1,0,0,3
S01008991,Occupancy rating -1 or less,19,2,0,2,13,0,9,2,5,2,4,3,1,4,4,0,0,0
S01008992,All households,270,102,40,62,153,24,114,50,40,24,15,9,6,15,3,2,1,9
S01008992,Occupancy rating +2 or more,85,26,9,17,58,13,42,21,12,9,3,1,2,1,0,0,0,1
S01008992,Occupancy rating +1,89,41,16,25,45,7,35,19,6,10,3,2,1,3,1,0,0,2
S01008992,Occupancy rating 0,78,28,12,16,42,3,32,10,17,5,7,4,3,8,0,2,1,5
S01008992,Occupancy rating -1 or less,18,7,3,4,8,1,5,0,5,0,2,2,0,3,2,0,0,1
S01008993,All households,476,143,67,76,309,45,218,91,93,34,46,28,18,24,6,1,4,13
S01008993,Occupancy rating +2 or more,218,55,30,25,158,31,117,58,46,13,10,3,7,5,1,0,1,3
S01008993,Occupancy rating +1,141,60,30,30,74,10,54,25,19,10,10,8,2,7,2,1,2,2
S01008993,Occupancy rating 0,93,21,5,16,62,4,41,7,24,10,17,12,5,10,1,0,1,8
S01008993,Occupancy rating -1 or less,24,7,2,5,15,0,6,1,4,1,9,5,4,2,2,0,0,0
S01008994,All households,337,98,34,64,224,31,149,69,56,24,44,32,12,15,5,1,1,8
S01008994,Occupancy rating +2 or more,108,27,14,13,81,15,61,41,15,5,5,4,1,0,0,0,0,0
S01008994,Occupancy rating +1,117,50,14,36,64,12,40,21,12,7,12,9,3,3,0,0,1,2
S01008994,Occupancy rating 0,82,19,6,13,55,3,36,7,20,9,16,11,5,8,2,1,0,5
S01008994,Occupancy rating -1 or less,30,2,0,2,24,1,12,0,9,3,11,8,3,4,3,0,0,1
S01008995,All households,352,79,32,47,261,28,204,80,90,34,29,15,14,12,5,0,0,7
S01008995,Occupancy rating +2 or more,209,39,20,19,166,25,130,62,48,20,11,5,6,4,1,0,0,3
S01008995,Occupancy rating +1,87,20,7,13,65,1,57,15,32,10,7,1,6,2,1,0,0,1
S01008995,Occupancy rating 0,35,8,4,4,24,1,15,3,8,4,8,6,2,3,0,0,0,3
S01008995,Occupancy rating -1 or less,21,12,1,11,6,1,2,0,2,0,3,3,0,3,3,0,0,0
S01008996,All households,251,72,36,36,170,28,103,45,32,26,39,17,22,9,4,0,1,4
S01008996,Occupancy rating +2 or more,86,24,14,10,59,17,40,25,9,6,2,2,0,3,2,0,0,1
S01008996,Occupancy rating +1,87,32,18,14,52,10,31,19,5,7,11,3,8,3,0,0,1,2
S01008996,Occupancy rating 0,66,14,3,11,50,1,27,1,14,12,22,11,11,2,1,0,0,1
S01008996,Occupancy rating -1 or less,12,2,1,1,9,0,5,0,4,1,4,1,3,1,1,0,0,0
S01008997,All households,411,111,39,72,282,19,218,87,108,23,45,28,17,18,4,0,0,14
S01008997,Occupancy rating +2 or more,210,46,23,23,158,14,135,62,66,7,9,5,4,6,0,0,0,6
S01008997,Occupancy rating +1,121,47,14,33,67,4,47,19,19,9,16,9,7,7,1,0,0,6
S01008997,Occupancy rating 0,63,12,2,10,47,1,29,5,19,5,17,12,5,4,2,0,0,2
S01008997,Occupancy rating -1 or less,17,6,0,6,10,0,7,1,4,2,3,2,1,1,1,0,0,0
S01008998,All households,236,70,15,55,158,7,105,24,55,26,46,35,11,8,6,1,0,1
S01008998,Occupancy rating +2 or more,80,31,9,22,48,4,41,17,14,10,3,1,2,1,1,0,0,0
S01008998,Occupancy rating +1,52,13,4,9,37,2,26,2,15,9,9,7,2,2,1,0,0,1
S01008998,Occupancy rating 0,79,23,0,23,55,1,26,5,15,6,28,21,7,1,1,0,0,0
S01008998,Occupancy rating -1 or less,25,3,2,1,18,0,12,0,11,1,6,6,0,4,3,1,0,0
S01008999,All households,411,157,86,71,237,41,150,73,60,17,46,27,19,17,9,0,1,7
S01008999,Occupancy rating +2 or more,152,54,31,23,95,24,65,37,21,7,6,4,2,3,2,0,1,0
S01008999,Occupancy rating +1,126,47,30,17,75,10,50,24,18,8,15,8,7,4,1,0,0,3
S01008999,Occupancy rating 0,105,47,21,26,53,5,28,12,14,2,20,12,8,5,2,0,0,3
S01008999,Occupancy rating -1 or less,28,9,4,5,14,2,7,0,7,0,5,3,2,5,4,0,0,1
S01009000,All households,393,95,48,47,289,48,216,96,80,40,25,15,10,9,1,0,1,7
S01009000,Occupancy rating +2 or more,226,44,25,19,178,30,143,78,42,23,5,3,2,4,0,0,1,3
S01009000,Occupancy rating +1,102,30,17,13,69,15,45,10,24,11,9,4,5,3,1,0,0,2
S01009000,Occupancy rating 0,49,20,6,14,29,1,20,7,9,4,8,6,2,0,0,0,0,0
S01009000,Occupancy rating -1 or less,16,1,0,1,13,2,8,1,5,2,3,2,1,2,0,0,0,2
S01009001,All households,323,63,36,27,256,41,198,54,122,22,17,12,5,4,1,0,0,3
S01009001,Occupancy rating +2 or more,232,43,20,23,185,32,145,48,81,16,8,6,2,4,1,0,0,3
S01009001,Occupancy rating +1,51,4,1,3,47,4,38,3,31,4,5,3,2,0,0,0,0,0
S01009001,Occupancy rating 0,34,13,12,1,21,5,13,3,8,2,3,3,0,0,0,0,0,0
S01009001,Occupancy rating -1 or less,6,3,3,0,3,0,2,0,2,0,1,0,1,0,0,0,0,0
S01009002,All households,348,104,48,56,234,26,180,68,96,16,28,15,13,10,3,0,2,5
S01009002,Occupancy rating +2 or more,198,50,24,26,145,17,120,57,56,7,8,2,6,3,0,0,1,2
S01009002,Occupancy rating +1,83,35,16,19,48,8,33,11,19,3,7,4,3,0,0,0,0,0
S01009002,Occupancy rating 0,55,16,7,9,34,1,20,0,14,6,13,9,4,5,1,0,1,3
S01009002,Occupancy rating -1 or less,12,3,1,2,7,0,7,0,7,0,0,0,0,2,2,0,0,0
S01009003,All households,394,96,37,59,289,35,229,98,110,21,25,20,5,9,2,0,0,7
S01009003,Occupancy rating +2 or more,236,44,18,26,191,26,158,63,79,16,7,6,1,1,0,0,0,1
S01009003,Occupancy rating +1,92,32,12,20,57,7,46,29,15,2,4,3,1,3,0,0,0,3
S01009003,Occupancy rating 0,55,17,7,10,34,2,20,2,15,3,12,9,3,4,1,0,0,3
S01009003,Occupancy rating -1 or less,11,3,0,3,7,0,5,4,1,0,2,2,0,1,1,0,0,0
S01009004,All households,270,58,26,32,202,19,147,55,65,27,36,21,15,10,3,0,0,7
S01009004,Occupancy rating +2 or more,134,34,17,17,99,14,75,37,22,16,10,1,9,1,0,0,0,1
S01009004,Occupancy rating +1,85,18,7,11,63,3,48,15,26,7,12,9,3,4,0,0,0,4
S01009004,Occupancy rating 0,40,5,2,3,34,2,21,3,15,3,11,8,3,1,1,0,0,0
S01009004,Occupancy rating -1 or less,11,1,0,1,6,0,3,0,2,1,3,3,0,4,2,0,0,2
S01009005,All households,327,106,32,74,216,27,158,68,66,24,31,19,12,5,1,0,0,4
S01009005,Occupancy rating +2 or more,117,33,15,18,83,13,66,37,20,9,4,2,2,1,0,0,0,1
S01009005,Occupancy rating +1,113,44,14,30,68,12,49,16,22,11,7,4,3,1,1,0,0,0
S01009005,Occupancy rating 0,78,22,2,20,54,2,35,14,18,3,17,11,6,2,0,0,0,2
S01009005,Occupancy rating -1 or less,19,7,1,6,11,0,8,1,6,1,3,2,1,1,0,0,0,1
S01009006,All households,318,80,39,41,223,29,149,53,74,22,45,31,14,15,4,2,1,8
S01009006,Occupancy rating +2 or more,115,39,24,15,76,18,55,34,20,1,3,0,3,0,0,0,0,0
S01009006,Occupancy rating +1,105,35,12,23,67,9,50,18,25,7,8,4,4,3,0,1,0,2
S01009006,Occupancy rating 0,76,3,1,2,64,1,37,1,25,11,26,19,7,9,1,1,1,6
S01009006,Occupancy rating -1 or less,22,3,2,1,16,1,7,0,4,3,8,8,0,3,3,0,0,0
S01009007,All households,290,80,36,44,193,19,126,41,60,25,48,33,15,17,7,0,2,8
S01009007,Occupancy rating +2 or more,96,36,21,15,59,11,46,25,17,4,2,1,1,1,0,0,0,1
S01009007,Occupancy rating +1,91,26,10,16,59,8,39,15,15,9,12,6,6,6,2,0,1,3
S01009007,Occupancy rating 0,79,13,3,10,58,0,34,1,25,8,24,18,6,8,3,0,1,4
S01009007,Occupancy rating -1 or less,24,5,2,3,17,0,7,0,3,4,10,8,2,2,2,0,0,0
S01009008,All households,445,153,67,86,280,59,195,100,75,20,26,13,13,12,2,0,1,9
S01009008,Occupancy rating +2 or more,245,63,38,25,178,48,123,63,44,16,7,2,5,4,1,0,1,2
S01009008,Occupancy rating +1,122,64,25,39,55,10,41,27,12,2,4,1,3,3,0,0,0,3
S01009008,Occupancy rating 0,64,21,3,18,41,1,28,9,17,2,12,8,4,2,0,0,0,2
S01009008,Occupancy rating -1 or less,14,5,1,4,6,0,3,1,2,0,3,2,1,3,1,0,0,2
S01009009,All households,252,127,55,72,113,8,68,30,27,11,37,29,8,12,2,1,2,7
S01009009,Occupancy rating +2 or more,49,22,4,18,25,3,19,15,3,1,3,2,1,2,1,0,0,1
S01009009,Occupancy rating +1,95,52,13,39,38,2,29,13,10,6,7,4,3,5,0,0,2,3
S01009009,Occupancy rating 0,89,51,36,15,35,3,13,2,8,3,19,15,4,3,0,1,0,2
S01009009,Occupancy rating -1 or less,19,2,2,0,15,0,7,0,6,1,8,8,0,2,1,0,0,1
S01009010,All households,404,84,18,66,309,23,249,98,109,42,37,31,6,11,4,0,1,6
S01009010,Occupancy rating +2 or more,214,34,12,22,179,22,149,74,54,21,8,6,2,1,0,0,0,1
S01009010,Occupancy rating +1,90,22,4,18,66,1,55,16,28,11,10,9,1,2,1,0,0,1
S01009010,Occupancy rating 0,78,21,2,19,51,0,37,6,23,8,14,12,2,6,3,0,0,3
S01009010,Occupancy rating -1 or less,22,7,0,7,13,0,8,2,4,2,5,4,1,2,0,0,1,1
S01009011,All households,319,52,8,44,259,14,219,73,107,39,26,12,14,8,5,0,0,3
S01009011,Occupancy rating +2 or more,179,26,4,22,148,6,133,52,57,24,9,4,5,5,4,0,0,1
S01009011,Occupancy rating +1,90,14,2,12,73,7,61,18,33,10,5,0,5,3,1,0,0,2
S01009011,Occupancy rating 0,41,9,1,8,32,1,22,3,14,5,9,6,3,0,0,0,0,0
S01009011,Occupancy rating -1 or less,9,3,1,2,6,0,3,0,3,0,3,2,1,0,0,0,0,0
S01009012,All households,296,55,16,39,235,22,195,76,86,33,18,10,8,6,2,0,1,3
S01009012,Occupancy rating +2 or more,161,33,9,24,127,13,110,62,30,18,4,4,0,1,0,0,0,1
S01009012,Occupancy rating +1,77,14,5,9,59,5,52,8,37,7,2,0,2,4,1,0,1,2
S01009012,Occupancy rating 0,45,2,1,1,42,4,29,5,17,7,9,5,4,1,1,0,0,0
S01009012,Occupancy rating -1 or less,13,6,1,5,7,0,4,1,2,1,3,1,2,0,0,0,0,0
S01009013,All households,363,76,24,52,273,25,218,97,90,31,30,17,13,14,6,0,0,8
S01009013,Occupancy rating +2 or more,211,38,12,26,167,20,140,82,43,15,7,6,1,6,2,0,0,4
S01009013,Occupancy rating +1,95,17,7,10,75,4,58,11,33,14,13,3,10,3,1,0,0,2
S01009013,Occupancy rating 0,42,16,3,13,23,1,14,4,9,1,8,6,2,3,1,0,0,2
S01009013,Occupancy rating -1 or less,15,5,2,3,8,0,6,0,5,1,2,2,0,2,2,0,0,0
S01009014,All households,284,127,48,79,146,12,101,34,52,15,33,19,14,11,5,0,3,3
S01009014,Occupancy rating +2 or more,141,68,31,37,68,9,56,29,18,9,3,1,2,5,3,0,1,1
S01009014,Occupancy rating +1,75,29,7,22,42,3,23,2,17,4,16,9,7,4,1,0,2,1
S01009014,Occupancy rating 0,54,24,7,17,29,0,15,2,11,2,14,9,5,1,1,0,0,0
S01009014,Occupancy rating -1 or less,14,6,3,3,7,0,7,1,6,0,0,0,0,1,0,0,0,1
S01009015,All households,303,120,61,59,171,24,109,48,48,13,38,24,14,12,4,0,3,5
S01009015,Occupancy rating +2 or more,199,85,48,37,108,21,76,41,26,9,11,4,7,6,3,0,2,1
S01009015,Occupancy rating +1,48,19,5,14,24,2,13,6,5,2,9,6,3,5,0,0,1,4
S01009015,Occupancy rating 0,42,10,6,4,31,1,16,0,14,2,14,11,3,1,1,0,0,0
S01009015,Occupancy rating -1 or less,14,6,2,4,8,0,4,1,3,0,4,3,1,0,0,0,0,0
S01009016,All households,250,97,49,48,141,26,96,38,45,13,19,8,11,12,1,0,3,8
S01009016,Occupancy rating +2 or more,180,81,44,37,93,21,63,30,23,10,9,2,7,6,0,0,0,6
S01009016,Occupancy rating +1,43,9,2,7,30,3,21,5,14,2,6,5,1,4,0,0,2,2
S01009016,Occupancy rating 0,22,6,3,3,14,2,9,3,5,1,3,1,2,2,1,0,1,0
S01009016,Occupancy rating -1 or less,5,1,0,1,4,0,3,0,3,0,1,0,1,0,0,0,0,0
S01009017,All households,278,98,27,71,168,23,109,44,48,17,36,20,16,12,1,0,2,9
S01009017,Occupancy rating +2 or more,154,55,23,32,97,17,70,36,28,6,10,4,6,2,0,0,0,2
S01009017,Occupancy rating +1,65,25,3,22,38,4,26,6,14,6,8,2,6,2,1,0,0,1
S01009017,Occupancy rating 0,43,11,1,10,25,1,11,2,6,3,13,9,4,7,0,0,2,5
S01009017,Occupancy rating -1 or less,16,7,0,7,8,1,2,0,0,2,5,5,0,1,0,0,0,1
S01009018,All households,326,109,35,74,195,18,137,62,56,19,40,29,11,22,4,3,3,12
S01009018,Occupancy rating +2 or more,196,68,19,49,123,14,97,56,29,12,12,5,7,5,1,0,0,4
S01009018,Occupancy rating +1,82,26,12,14,48,4,26,5,16,5,18,15,3,8,1,2,1,4
S01009018,Occupancy rating 0,36,11,4,7,18,0,9,0,7,2,9,8,1,7,1,1,1,4
S01009018,Occupancy rating -1 or less,12,4,0,4,6,0,5,1,4,0,1,1,0,2,1,0,1,0
S01009019,All households,221,66,25,41,141,10,105,43,39,23,26,14,12,14,4,0,1,9
S01009019,Occupancy rating +2 or more,129,37,20,17,88,7,73,38,20,15,8,4,4,4,0,0,1,3
S01009019,Occupancy rating +1,52,19,5,14,26,3,13,3,4,6,10,3,7,7,3,0,0,4
S01009019,Occupancy rating 0,29,6,0,6,20,0,13,0,11,2,7,7,0,3,1,0,0,2
S01009019,Occupancy rating -1 or less,11,4,0,4,7,0,6,2,4,0,1,0,1,0,0,0,0,0
S01009020,All households,366,130,49,81,219,15,170,76,79,15,34,24,10,17,5,0,1,11
S01009020,Occupancy rating +2 or more,214,77,31,46,134,14,112,63,38,11,8,5,3,3,1,0,1,1
S01009020,Occupancy rating +1,93,31,10,21,55,1,38,10,25,3,16,11,5,7,0,0,0,7
S01009020,Occupancy rating 0,45,15,5,10,25,0,15,2,13,0,10,8,2,5,3,0,0,2
S01009020,Occupancy rating -1 or less,14,7,3,4,5,0,5,1,3,1,0,0,0,2,1,0,0,1
S01009021,All households,344,133,65,68,194,30,133,54,49,30,31,11,20,17,5,0,2,10
S01009021,Occupancy rating +2 or more,236,85,45,40,142,26,103,46,35,22,13,4,9,9,2,0,2,5
S01009021,Occupancy rating +1,51,19,11,8,28,0,17,5,7,5,11,5,6,4,2,0,0,2
S01009021,Occupancy rating 0,47,21,8,13,23,4,12,3,6,3,7,2,5,3,1,0,0,2
S01009021,Occupancy rating -1 or less,10,8,1,7,1,0,1,0,1,0,0,0,0,1,0,0,0,1
S01009022,All households,447,190,101,89,236,35,165,78,57,30,36,15,21,21,4,0,3,14
S01009022,Occupancy rating +2 or more,282,111,65,46,164,33,115,71,29,15,16,5,11,7,0,0,1,6
S01009022,Occupancy rating +1,94,36,17,19,48,1,33,5,19,9,14,8,6,10,2,0,2,6
S01009022,Occupancy rating 0,55,33,15,18,20,1,15,2,7,6,4,2,2,2,1,0,0,1
S01009022,Occupancy rating -1 or less,16,10,4,6,4,0,2,0,2,0,2,0,2,2,1,0,0,1
S01009023,All households,435,176,92,84,244,39,178,84,72,22,27,4,23,15,4,0,4,7
S01009023,Occupancy rating +2 or more,312,129,66,63,174,37,121,76,37,8,16,3,13,9,2,0,2,5
S01009023,Occupancy rating +1,71,34,20,14,35,2,26,6,10,10,7,1,6,2,0,0,1,1
S01009023,Occupancy rating 0,45,13,6,7,29,0,26,2,20,4,3,0,3,3,2,0,0,1
S01009023,Occupancy rating -1 or less,7,0,0,0,6,0,5,0,5,0,1,0,1,1,0,0,1,0
S01009024,All households,476,198,112,86,256,38,177,80,61,36,41,12,29,22,4,0,5,13
S01009024,Occupancy rating +2 or more,277,114,76,38,155,33,106,64,24,18,16,2,14,8,0,0,1,7
S01009024,Occupancy rating +1,117,46,24,22,67,4,47,15,21,11,16,4,12,4,1,0,1,2
S01009024,Occupancy rating 0,69,32,8,24,29,1,19,1,12,6,9,6,3,8,1,0,3,4
S01009024,Occupancy rating -1 or less,13,6,4,2,5,0,5,0,4,1,0,0,0,2,2,0,0,0
S01009025,All households,433,172,72,100,236,40,163,72,75,16,33,14,19,25,5,0,3,17
S01009025,Occupancy rating +2 or more,288,116,54,62,161,35,114,59,47,8,12,4,8,11,1,0,1,9
S01009025,Occupancy rating +1,85,33,12,21,48,4,35,8,19,8,9,3,6,4,1,0,0,3
S01009025,Occupancy rating 0,55,21,5,16,24,1,13,4,9,0,10,6,4,10,3,0,2,5
S01009025,Occupancy rating -1 or less,5,2,1,1,3,0,1,1,0,0,2,1,1,0,0,0,0,0
S01009026,All households,411,132,59,73,248,35,170,68,59,43,43,13,30,31,8,4,6,13
S01009026,Occupancy rating +2 or more,264,93,45,48,155,30,109,55,27,27,16,6,10,16,5,0,4,7
S01009026,Occupancy rating +1,89,24,10,14,59,3,40,8,19,13,16,3,13,6,1,0,1,4
S01009026,Occupancy rating 0,51,14,3,11,28,2,16,5,9,2,10,4,6,9,2,4,1,2
S01009026,Occupancy rating -1 or less,7,1,1,0,6,0,5,0,4,1,1,0,1,0,0,0,0,0
S01009027,All households,373,139,63,76,215,28,150,80,49,21,37,15,22,19,7,0,5,7
S01009027,Occupancy rating +2 or more,276,101,51,50,163,25,118,65,37,16,20,7,13,12,2,0,3,7
S01009027,Occupancy rating +1,61,19,10,9,38,1,24,13,7,4,13,5,8,4,2,0,2,0
S01009027,Occupancy rating 0,23,13,0,13,8,2,4,2,2,0,2,2,0,2,2,0,0,0
S01009027,Occupancy rating -1 or less,13,6,2,4,6,0,4,0,3,1,2,1,1,1,1,0,0,0
S01009028,All households,232,97,44,53,119,14,97,40,40,17,8,1,7,16,3,0,5,8
S01009028,Occupancy rating +2 or more,155,63,34,29,83,11,68,34,24,10,4,1,3,9,3,0,2,4
S01009028,Occupancy rating +1,45,19,8,11,23,2,19,1,12,6,2,0,2,3,0,0,1,2
S01009028,Occupancy rating 0,28,14,2,12,11,1,10,5,4,1,0,0,0,3,0,0,2,1
S01009028,Occupancy rating -1 or less,4,1,0,1,2,0,0,0,0,0,2,0,2,1,0,0,0,1
S01009029,All households,286,106,47,59,163,23,111,45,42,24,29,11,18,17,3,0,3,11
S01009029,Occupancy rating +2 or more,188,74,35,39,106,21,73,36,19,18,12,2,10,8,0,0,2,6
S01009029,Occupancy rating +1,64,24,10,14,35,2,22,5,12,5,11,5,6,5,0,0,1,4
S01009029,Occupancy rating 0,21,4,1,3,15,0,11,2,9,0,4,2,2,2,1,0,0,1
S01009029,Occupancy rating -1 or less,13,4,1,3,7,0,5,2,2,1,2,2,0,2,2,0,0,0
S01009030,All households,321,105,43,62,193,25,135,56,51,28,33,18,15,23,8,0,0,15
S01009030,Occupancy rating +2 or more,203,74,35,39,117,20,91,43,32,16,6,1,5,12,4,0,0,8
S01009030,Occupancy rating +1,67,22,7,15,43,4,29,11,8,10,10,7,3,2,0,0,0,2
S01009030,Occupancy rating 0,39,7,1,6,25,1,13,2,9,2,11,6,5,7,3,0,0,4
S01009030,Occupancy rating -1 or less,12,2,0,2,8,0,2,0,2,0,6,4,2,2,1,0,0,1
S01009031,All households,356,124,50,74,209,27,139,54,55,30,43,17,26,23,1,0,6,16
S01009031,Occupancy rating +2 or more,227,82,34,48,133,23,93,44,30,19,17,3,14,12,0,0,5,7
S01009031,Occupancy rating +1,81,23,8,15,51,4,31,8,16,7,16,5,11,7,0,0,0,7
S01009031,Occupancy rating 0,37,15,5,10,20,0,13,2,7,4,7,6,1,2,0,0,0,2
S01009031,Occupancy rating -1 or less,11,4,3,1,5,0,2,0,2,0,3,3,0,2,1,0,1,0
S01009032,All households,299,102,59,43,174,31,116,47,38,31,27,16,11,23,8,0,5,10
S01009032,Occupancy rating +2 or more,211,76,48,28,127,30,85,44,19,22,12,6,6,8,4,0,2,2
S01009032,Occupancy rating +1,58,16,6,10,32,1,22,1,14,7,9,5,4,10,2,0,2,6
S01009032,Occupancy rating 0,25,10,5,5,10,0,7,2,3,2,3,2,1,5,2,0,1,2
S01009032,Occupancy rating -1 or less,5,0,0,0,5,0,2,0,2,0,3,3,0,0,0,0,0,0
S01009033,All households,359,141,74,67,198,34,136,43,68,25,28,10,18,20,6,0,4,10
S01009033,Occupancy rating +2 or more,261,111,62,49,141,31,98,38,44,16,12,4,8,9,2,0,0,7
S01009033,Occupancy rating +1,59,20,9,11,34,2,21,5,10,6,11,4,7,5,0,0,3,2
S01009033,Occupancy rating 0,32,10,3,7,17,0,12,0,10,2,5,2,3,5,4,0,0,1
S01009033,Occupancy rating -1 or less,7,0,0,0,6,1,5,0,4,1,0,0,0,1,0,0,1,0
S01009034,All households,283,80,45,35,187,33,126,43,59,24,28,13,15,16,4,0,3,9
S01009034,Occupancy rating +2 or more,204,70,41,29,127,29,88,39,37,12,10,5,5,7,1,0,1,5
S01009034,Occupancy rating +1,52,6,2,4,40,4,26,3,15,8,10,3,7,6,2,0,2,2
S01009034,Occupancy rating 0,20,4,2,2,14,0,7,1,3,3,7,4,3,2,1,0,0,1
S01009034,Occupancy rating -1 or less,7,0,0,0,6,0,5,0,4,1,1,1,0,1,0,0,0,1
S01009035,All households,381,114,58,56,244,37,181,59,82,40,26,15,11,23,12,0,2,9
S01009035,Occupancy rating +2 or more,259,78,43,35,169,34,127,54,49,24,8,2,6,12,5,0,1,6
S01009035,Occupancy rating +1,85,28,14,14,52,3,38,4,24,10,11,7,4,5,3,0,1,1
S01009035,Occupancy rating 0,29,5,0,5,19,0,14,1,7,6,5,4,1,5,3,0,0,2
S01009035,Occupancy rating -1 or less,8,3,1,2,4,0,2,0,2,0,2,2,0,1,1,0,0,0
S01009036,All households,437,144,55,89,277,20,210,67,117,26,47,28,19,16,8,0,1,7
S01009036,Occupancy rating +2 or more,269,87,40,47,174,19,137,49,72,16,18,6,12,8,4,0,1,3
S01009036,Occupancy rating +1,100,42,11,31,56,1,43,16,23,4,12,8,4,2,0,0,0,2
S01009036,Occupancy rating 0,55,14,4,10,38,0,25,1,18,6,13,11,2,3,1,0,0,2
S01009036,Occupancy rating -1 or less,13,1,0,1,9,0,5,1,4,0,4,3,1,3,3,0,0,0
S01009037,All households,367,103,38,65,251,23,172,54,90,28,56,34,22,13,7,0,1,5
S01009037,Occupancy rating +2 or more,217,58,30,28,150,20,110,42,49,19,20,10,10,9,6,0,0,3
S01009037,Occupancy rating +1,68,23,8,15,45,3,32,6,20,6,10,6,4,0,0,0,0,0
S01009037,Occupancy rating 0,62,15,0,15,45,0,21,5,15,1,24,16,8,2,0,0,1,1
S01009037,Occupancy rating -1 or less,20,7,0,7,11,0,9,1,6,2,2,2,0,2,1,0,0,1
S01009038,All households,440,117,41,76,294,39,204,78,94,32,51,29,22,29,9,0,1,19
S01009038,Occupancy rating +2 or more,263,67,29,38,186,33,138,62,59,17,15,6,9,10,2,0,1,7
S01009038,Occupancy rating +1,86,28,7,21,52,3,35,11,16,8,14,8,6,6,0,0,0,6
S01009038,Occupancy rating 0,67,16,5,11,42,3,23,3,14,6,16,10,6,9,6,0,0,3
S01009038,Occupancy rating -1 or less,24,6,0,6,14,0,8,2,5,1,6,5,1,4,1,0,0,3
S01009039,All households,313,117,38,79,181,15,100,40,35,25,66,52,14,15,1,0,1,13
S01009039,Occupancy rating +2 or more,99,39,27,12,58,13,38,26,5,7,7,5,2,2,0,0,0,2
S01009039,Occupancy rating +1,87,30,3,27,54,2,32,10,11,11,20,15,5,3,0,0,0,3
S01009039,Occupancy rating 0,98,33,5,28,58,0,24,3,15,6,34,28,6,7,1,0,0,6
S01009039,Occupancy rating -1 or less,29,15,3,12,11,0,6,1,4,1,5,4,1,3,0,0,1,2
S01009040,All households,338,178,84,94,143,17,84,32,39,13,42,27,15,17,6,0,1,10
S01009040,Occupancy rating +2 or more,113,55,26,29,56,12,33,18,7,8,11,5,6,2,0,0,0,2
S01009040,Occupancy rating +1,107,60,22,38,40,4,20,10,9,1,16,10,6,7,2,0,1,4
S01009040,Occupancy rating 0,81,39,17,22,37,1,24,4,16,4,12,9,3,5,3,0,0,2
S01009040,Occupancy rating -1 or less,37,24,19,5,10,0,7,0,7,0,3,3,0,3,1,0,0,2
S01009041,All households,503,301,129,172,183,32,125,52,57,16,26,14,12,19,2,1,4,12
S01009041,Occupancy rating +2 or more,189,74,36,38,107,23,74,28,34,12,10,4,6,8,1,0,3,4
S01009041,Occupancy rating +1,110,75,26,49,30,5,20,10,6,4,5,3,2,5,1,0,1,3
S01009041,Occupancy rating 0,171,133,60,73,34,4,24,12,12,0,6,4,2,4,0,1,0,3
S01009041,Occupancy rating -1 or less,33,19,7,12,12,0,7,2,5,0,5,3,2,2,0,0,0,2
S01009042,All households,401,170,66,104,208,19,142,51,69,22,47,29,18,23,6,0,3,14
S01009042,Occupancy rating +2 or more,163,69,31,38,86,16,62,31,21,10,8,3,5,8,3,0,2,3
S01009042,Occupancy rating +1,119,68,25,43,48,3,37,14,18,5,8,5,3,3,1,0,0,2
S01009042,Occupancy rating 0,87,17,5,12,63,0,35,4,27,4,28,19,9,7,0,0,1,6
S01009042,Occupancy rating -1 or less,32,16,5,11,11,0,8,2,3,3,3,2,1,5,2,0,0,3
S01009043,All households,293,112,33,79,164,18,109,42,40,27,37,13,24,17,2,0,2,13
S01009043,Occupancy rating +2 or more,134,51,16,35,79,17,56,32,15,9,6,0,6,4,0,0,0,4
S01009043,Occupancy rating +1,93,39,12,27,46,0,32,7,14,11,14,6,8,8,0,0,1,7
S01009043,Occupancy rating 0,55,19,3,16,33,1,19,2,10,7,13,4,9,3,1,0,0,2
S01009043,Occupancy rating -1 or less,11,3,2,1,6,0,2,1,1,0,4,3,1,2,1,0,1,0
S01009044,All households,412,177,95,82,220,42,128,57,47,24,50,33,17,15,1,0,3,11
S01009044,Occupancy rating +2 or more,185,81,45,36,100,27,66,36,20,10,7,2,5,4,0,0,1,3
S01009044,Occupancy rating +1,133,65,34,31,63,14,33,20,6,7,16,9,7,5,0,0,2,3
S01009044,Occupancy rating 0,72,21,9,12,46,1,25,1,18,6,20,17,3,5,1,0,0,4
S01009044,Occupancy rating -1 or less,22,10,7,3,11,0,4,0,3,1,7,5,2,1,0,0,0,1
S01009045,All households,287,95,35,60,176,23,116,46,46,24,37,18,19,16,2,1,0,13
S01009045,Occupancy rating +2 or more,168,58,27,31,104,21,70,33,20,17,13,3,10,6,0,0,0,6
S01009045,Occupancy rating +1,62,12,2,10,45,0,32,7,21,4,13,6,7,5,0,1,0,4
S01009045,Occupancy rating 0,46,22,5,17,21,2,11,4,5,2,8,7,1,3,1,0,0,2
S01009045,Occupancy rating -1 or less,11,3,1,2,6,0,3,2,0,1,3,2,1,2,1,0,0,1
S01009046,All households,363,112,46,66,234,30,169,60,81,28,35,19,16,17,7,0,0,10
S01009046,Occupancy rating +2 or more,253,78,38,40,167,28,122,57,48,17,17,4,13,8,4,0,0,4
S01009046,Occupancy rating +1,58,20,5,15,32,1,22,2,14,6,9,8,1,6,2,0,0,4
S01009046,Occupancy rating 0,38,13,3,10,23,1,18,1,14,3,4,3,1,2,0,0,0,2
S01009046,Occupancy rating -1 or less,14,1,0,1,12,0,7,0,5,2,5,4,1,1,1,0,0,0
S01009047,All households,336,108,51,57,212,14,173,57,82,34,25,16,9,16,7,0,1,8
S01009047,Occupancy rating +2 or more,229,80,41,39,140,13,117,49,48,20,10,7,3,9,3,0,1,5
S01009047,Occupancy rating +1,69,19,6,13,48,1,39,6,22,11,8,5,3,2,0,0,0,2
S01009047,Occupancy rating 0,35,7,3,4,23,0,16,2,11,3,7,4,3,5,4,0,0,1
S01009047,Occupancy rating -1 or less,3,2,1,1,1,0,1,0,1,0,0,0,0,0,0,0,0,0
S01009048,All households,348,100,50,50,218,26,173,64,71,38,19,7,12,30,11,0,2,17
S01009048,Occupancy rating +2 or more,260,74,36,38,170,23,137,58,49,30,10,3,7,16,5,0,1,10
S01009048,Occupancy rating +1,44,13,8,5,24,0,19,3,11,5,5,2,3,7,3,0,1,3
S01009048,Occupancy rating 0,40,12,6,6,22,3,16,3,10,3,3,2,1,6,2,0,0,4
S01009048,Occupancy rating -1 or less,4,1,0,1,2,0,1,0,1,0,1,0,1,1,1,0,0,0
S01009049,All households,274,89,44,45,166,31,118,41,55,22,17,8,9,19,7,0,2,10
S01009049,Occupancy rating +2 or more,187,63,37,26,114,24,84,36,34,14,6,1,5,10,4,0,2,4
S01009049,Occupancy rating +1,53,15,6,9,34,7,20,2,11,7,7,4,3,4,1,0,0,3
S01009049,Occupancy rating 0,26,5,0,5,16,0,12,3,8,1,4,3,1,5,2,0,0,3
S01009049,Occupancy rating -1 or less,8,6,1,5,2,0,2,0,2,0,0,0,0,0,0,0,0,0
S01009050,All households,370,129,57,72,228,35,162,80,61,21,31,16,15,13,5,0,4,4
S01009050,Occupancy rating +2 or more,159,33,9,24,122,22,94,50,28,16,6,2,4,4,3,0,0,1
S01009050,Occupancy rating +1,115,51,14,37,61,6,47,26,19,2,8,3,5,3,0,0,2,1
S01009050,Occupancy rating 0,70,32,25,7,35,7,16,4,10,2,12,9,3,3,1,0,0,2
S01009050,Occupancy rating -1 or less,26,13,9,4,10,0,5,0,4,1,5,2,3,3,1,0,2,0
S01009051,All households,292,66,31,35,220,22,152,46,91,15,46,31,15,6,4,0,0,2
S01009051,Occupancy rating +2 or more,112,29,12,17,81,12,66,31,32,3,3,3,0,2,2,0,0,0
S01009051,Occupancy rating +1,108,32,16,16,75,10,50,13,30,7,15,8,7,1,0,0,0,1
S01009051,Occupancy rating 0,54,5,3,2,46,0,25,1,21,3,21,14,7,3,2,0,0,1
S01009051,Occupancy rating -1 or less,18,0,0,0,18,0,11,1,8,2,7,6,1,0,0,0,0,0
S01009052,All households,305,123,58,65,176,26,125,56,38,31,25,15,10,6,4,0,0,2
S01009052,Occupancy rating +2 or more,104,31,14,17,70,14,51,32,9,10,5,2,3,3,3,0,0,0
S01009052,Occupancy rating +1,113,46,24,22,66,10,49,21,14,14,7,4,3,1,0,0,0,1
S01009052,Occupancy rating 0,68,33,13,20,34,1,23,3,13,7,10,8,2,1,0,0,0,1
S01009052,Occupancy rating -1 or less,20,13,7,6,6,1,2,0,2,0,3,1,2,1,1,0,0,0
S01009053,All households,259,114,22,92,127,7,70,25,31,14,50,41,9,18,8,0,2,8
S01009053,Occupancy rating +2 or more,39,18,6,12,21,2,17,10,2,5,2,2,0,0,0,0,0,0
S01009053,Occupancy rating +1,103,59,7,52,40,5,25,13,8,4,10,6,4,4,0,0,0,4
S01009053,Occupancy rating 0,81,25,7,18,49,0,23,1,19,3,26,23,3,7,2,0,2,3
S01009053,Occupancy rating -1 or less,36,12,2,10,17,0,5,1,2,2,12,10,2,7,6,0,0,1
S01009054,All households,249,65,29,36,170,17,108,48,41,19,45,25,20,14,6,0,1,7
S01009054,Occupancy rating +2 or more,78,30,14,16,47,12,33,26,5,2,2,2,0,1,1,0,0,0
S01009054,Occupancy rating +1,95,31,13,18,61,5,43,20,12,11,13,7,6,3,1,0,1,1
S01009054,Occupancy rating 0,51,0,0,0,46,0,25,1,18,6,21,11,10,5,1,0,0,4
S01009054,Occupancy rating -1 or less,25,4,2,2,16,0,7,1,6,0,9,5,4,5,3,0,0,2
S01009055,All households,361,94,25,69,252,44,174,88,56,30,34,17,17,15,7,0,0,8
S01009055,Occupancy rating +2 or more,211,47,14,33,158,33,115,73,27,15,10,5,5,6,2,0,0,4
S01009055,Occupancy rating +1,78,27,6,21,47,8,33,11,14,8,6,1,5,4,1,0,0,3
S01009055,Occupancy rating 0,62,17,5,12,42,2,25,4,15,6,15,8,7,3,3,0,0,0
S01009055,Occupancy rating -1 or less,10,3,0,3,5,1,1,0,0,1,3,3,0,2,1,0,0,1
S01009056,All households,217,55,20,35,151,12,100,39,39,22,39,23,16,11,6,0,1,4
S01009056,Occupancy rating +2 or more,83,29,12,17,52,7,41,32,5,4,4,1,3,2,1,0,1,0
S01009056,Occupancy rating +1,62,10,4,6,48,5,27,3,12,12,16,7,9,4,1,0,0,3
S01009056,Occupancy rating 0,47,7,1,6,36,0,25,3,16,6,11,8,3,4,3,0,0,1
S01009056,Occupancy rating -1 or less,25,9,3,6,15,0,7,1,6,0,8,7,1,1,1,0,0,0
S01009057,All households,282,118,43,75,149,15,84,39,37,8,50,28,22,15,6,0,0,9
S01009057,Occupancy rating +2 or more,81,35,12,23,44,9,27,18,5,4,8,4,4,2,1,0,0,1
S01009057,Occupancy rating +1,115,54,23,31,57,5,32,15,15,2,20,11,9,4,0,0,0,4
S01009057,Occupancy rating 0,58,21,6,15,32,1,16,5,9,2,15,10,5,5,2,0,0,3
S01009057,Occupancy rating -1 or less,28,8,2,6,16,0,9,1,8,0,7,3,4,4,3,0,0,1
S01009058,All households,385,149,57,92,224,41,143,58,62,23,40,22,18,12,4,0,2,6
S01009058,Occupancy rating +2 or more,131,50,18,32,80,22,56,30,21,5,2,1,1,1,0,0,0,1
S01009058,Occupancy rating +1,125,39,10,29,82,17,56,23,21,12,9,3,6,4,1,0,1,2
S01009058,Occupancy rating 0,108,54,27,27,50,1,24,3,15,6,25,15,10,4,1,0,0,3
S01009058,Occupancy rating -1 or less,21,6,2,4,12,1,7,2,5,0,4,3,1,3,2,0,1,0
S01009059,All households,347,86,34,52,246,12,197,66,104,27,37,27,10,15,4,0,0,11
S01009059,Occupancy rating +2 or more,187,32,14,18,149,5,133,54,64,15,11,6,5,6,2,0,0,4
S01009059,Occupancy rating +1,85,28,12,16,53,5,41,8,24,9,7,6,1,4,1,0,0,3
S01009059,Occupancy rating 0,56,17,6,11,36,2,17,4,11,2,17,14,3,3,0,0,0,3
S01009059,Occupancy rating -1 or less,19,9,2,7,8,0,6,0,5,1,2,1,1,2,1,0,0,1
S01009060,All households,188,21,6,15,156,8,140,44,83,13,8,4,4,11,7,0,0,4
S01009060,Occupancy rating +2 or more,157,10,4,6,141,6,131,43,76,12,4,3,1,6,3,0,0,3
S01009060,Occupancy rating +1,22,9,2,7,10,1,7,1,5,1,2,0,2,3,2,0,0,1
S01009060,Occupancy rating 0,5,2,0,2,3,1,1,0,1,0,1,1,0,0,0,0,0,0
S01009060,Occupancy rating -1 or less,4,0,0,0,2,0,1,0,1,0,1,0,1,2,2,0,0,0
S01009061,All households,326,70,29,41,243,20,177,67,76,34,46,33,13,13,9,0,1,3
S01009061,Occupancy rating +2 or more,106,22,12,10,82,15,63,41,16,6,4,2,2,2,2,0,0,0
S01009061,Occupancy rating +1,114,32,11,21,80,4,59,20,26,13,17,8,9,2,0,0,1,1
S01009061,Occupancy rating 0,84,14,6,8,66,1,44,5,26,13,21,20,1,4,3,0,0,1
S01009061,Occupancy rating -1 or less,22,2,0,2,15,0,11,1,8,2,4,3,1,5,4,0,0,1
S01009062,All households,298,99,45,54,184,26,113,42,41,30,45,25,20,15,5,0,2,8
S01009062,Occupancy rating +2 or more,95,37,22,15,53,14,37,27,4,6,2,2,0,5,1,0,0,4
S01009062,Occupancy rating +1,105,36,17,19,67,12,36,11,11,14,19,8,11,2,0,0,1,1
S01009062,Occupancy rating 0,83,23,6,17,56,0,35,4,22,9,21,14,7,4,2,0,1,1
S01009062,Occupancy rating -1 or less,15,3,0,3,8,0,5,0,4,1,3,1,2,4,2,0,0,2
S01009063,All households,291,62,38,24,216,32,160,61,68,31,24,12,12,13,4,0,2,7
S01009063,Occupancy rating +2 or more,186,49,30,19,133,31,97,53,30,14,5,3,2,4,1,0,0,3
S01009063,Occupancy rating +1,71,7,4,3,57,0,44,7,23,14,13,7,6,7,1,0,2,4
S01009063,Occupancy rating 0,27,4,2,2,21,1,15,0,14,1,5,2,3,2,2,0,0,0
S01009063,Occupancy rating -1 or less,7,2,2,0,5,0,4,1,1,2,1,0,1,0,0,0,0,0
S01009064,All households,264,82,33,49,173,30,106,38,46,22,37,28,9,9,2,0,1,6
S01009064,Occupancy rating +2 or more,80,29,16,13,49,19,26,16,7,3,4,2,2,2,0,0,0,2
S01009064,Occupancy rating +1,94,42,9,33,51,10,34,17,12,5,7,5,2,1,0,0,0,1
S01009064,Occupancy rating 0,68,6,5,1,56,0,38,2,25,11,18,16,2,6,2,0,1,3
S01009064,Occupancy rating -1 or less,22,5,3,2,17,1,8,3,2,3,8,5,3,0,0,0,0,0
S01009065,All households,328,133,55,78,178,24,95,35,45,15,59,49,10,17,7,0,1,9
S01009065,Occupancy rating +2 or more,89,41,25,16,47,12,30,16,11,3,5,4,1,1,0,0,0,1
S01009065,Occupancy rating +1,130,68,29,39,59,10,30,14,9,7,19,14,5,3,1,0,0,2
S01009065,Occupancy rating 0,87,20,0,20,60,1,31,5,21,5,28,26,2,7,2,0,1,4
S01009065,Occupancy rating -1 or less,22,4,1,3,12,1,4,0,4,0,7,5,2,6,4,0,0,2
S01009066,All households,319,108,45,63,201,35,126,48,46,32,40,17,23,10,3,0,1,6
S01009066,Occupancy rating +2 or more,121,46,21,25,74,23,48,37,6,5,3,1,2,1,0,0,0,1
S01009066,Occupancy rating +1,104,35,12,23,66,8,40,9,12,19,18,8,10,3,1,0,1,1
S01009066,Occupancy rating 0,77,25,12,13,49,3,29,2,22,5,17,8,9,3,0,0,0,3
S01009066,Occupancy rating -1 or less,17,2,0,2,12,1,9,0,6,3,2,0,2,3,2,0,0,1
S01009067,All households,302,46,13,33,245,9,222,69,120,33,14,9,5,11,8,0,0,3
S01009067,Occupancy rating +2 or more,217,31,8,23,179,8,163,61,84,18,8,6,2,7,6,0,0,1
S01009067,Occupancy rating +1,50,7,1,6,40,0,39,5,25,9,1,0,1,3,2,0,0,1
S01009067,Occupancy rating 0,29,7,3,4,21,0,17,3,10,4,4,3,1,1,0,0,0,1
S01009067,Occupancy rating -1 or less,6,1,1,0,5,1,3,0,1,2,1,0,1,0,0,0,0,0
S01009068,All households,386,108,43,65,267,28,174,63,66,45,65,45,20,11,4,0,0,7
S01009068,Occupancy rating +2 or more,139,46,19,27,90,13,71,41,13,17,6,3,3,3,0,0,0,3
S01009068,Occupancy rating +1,135,44,20,24,88,12,55,19,18,18,21,13,8,3,2,0,0,1
S01009068,Occupancy rating 0,81,10,3,7,69,3,40,2,29,9,26,19,7,2,0,0,0,2
S01009068,Occupancy rating -1 or less,31,8,1,7,20,0,8,1,6,1,12,10,2,3,2,0,0,1
S01009069,All households,249,48,17,31,192,11,171,76,63,32,10,8,2,9,3,0,0,6
S01009069,Occupancy rating +2 or more,153,22,6,16,125,9,114,64,30,20,2,2,0,6,2,0,0,4
S01009069,Occupancy rating +1,69,19,9,10,48,2,40,11,21,8,6,5,1,2,0,0,0,2
S01009069,Occupancy rating 0,26,7,2,5,18,0,16,1,11,4,2,1,1,1,1,0,0,0
S01009069,Occupancy rating -1 or less,1,0,0,0,1,0,1,0,1,0,0,0,0,0,0,0,0,0
S01009070,All households,269,64,18,46,202,28,148,74,54,20,26,17,9,3,2,0,0,1
S01009070,Occupancy rating +2 or more,130,13,6,7,116,23,91,57,23,11,2,1,1,1,1,0,0,0
S01009070,Occupancy rating +1,81,35,9,26,46,2,36,13,16,7,8,4,4,0,0,0,0,0
S01009070,Occupancy rating 0,46,14,1,13,31,1,19,3,14,2,11,8,3,1,0,0,0,1
S01009070,Occupancy rating -1 or less,12,2,2,0,9,2,2,1,1,0,5,4,1,1,1,0,0,0
S01009071,All households,228,67,30,37,150,16,105,50,44,11,29,18,11,11,3,0,0,8
S01009071,Occupancy rating +2 or more,89,18,8,10,65,12,51,27,19,5,2,0,2,6,2,0,0,4
S01009071,Occupancy rating +1,84,35,16,19,48,3,38,19,15,4,7,1,6,1,0,0,0,1
S01009071,Occupancy rating 0,41,12,6,6,27,1,13,3,8,2,13,10,3,2,0,0,0,2
S01009071,Occupancy rating -1 or less,14,2,0,2,10,0,3,1,2,0,7,7,0,2,1,0,0,1
S01009072,All households,199,38,14,24,154,17,118,32,65,21,19,12,7,7,3,0,0,4
S01009072,Occupancy rating +2 or more,122,24,8,16,92,13,76,25,39,12,3,1,2,6,3,0,0,3
S01009072,Occupancy rating +1,35,8,3,5,27,3,21,6,11,4,3,2,1,0,0,0,0,0
S01009072,Occupancy rating 0,34,3,2,1,30,0,18,1,14,3,12,8,4,1,0,0,0,1
S01009072,Occupancy rating -1 or less,8,3,1,2,5,1,3,0,1,2,1,1,0,0,0,0,0,0
S01009073,All households,251,67,37,30,175,21,101,39,38,24,53,38,15,9,3,0,1,5
S01009073,Occupancy rating +2 or more,88,35,18,17,52,18,31,22,5,4,3,1,2,1,1,0,0,0
S01009073,Occupancy rating +1,86,20,9,11,64,3,41,15,13,13,20,13,7,2,0,0,1,1
S01009073,Occupancy rating 0,52,10,9,1,39,0,23,1,15,7,16,14,2,3,1,0,0,2
S01009073,Occupancy rating -1 or less,25,2,1,1,20,0,6,1,5,0,14,10,4,3,1,0,0,2
S01009074,All households,290,60,22,38,209,24,123,41,49,33,62,34,28,21,9,0,2,10
S01009074,Occupancy rating +2 or more,82,29,9,20,52,15,34,26,3,5,3,1,2,1,0,0,0,1
S01009074,Occupancy rating +1,108,24,10,14,80,9,52,14,19,19,19,9,10,4,1,0,1,2
S01009074,Occupancy rating 0,74,3,1,2,59,0,25,0,18,7,34,19,15,12,5,0,1,6
S01009074,Occupancy rating -1 or less,26,4,2,2,18,0,12,1,9,2,6,5,1,4,3,0,0,1
S01009075,All households,233,70,37,33,149,14,110,46,38,26,25,13,12,14,6,0,0,8
S01009075,Occupancy rating +2 or more,86,25,18,7,59,6,52,35,9,8,1,0,1,2,0,0,0,2
S01009075,Occupancy rating +1,82,34,16,18,44,8,30,10,9,11,6,2,4,4,2,0,0,2
S01009075,Occupancy rating 0,50,9,2,7,36,0,23,0,18,5,13,9,4,5,1,0,0,4
S01009075,Occupancy rating -1 or less,15,2,1,1,10,0,5,1,2,2,5,2,3,3,3,0,0,0
S01009076,All households,381,90,16,74,272,14,227,99,89,39,31,13,18,19,8,1,0,10
S01009076,Occupancy rating +2 or more,193,23,9,14,159,11,137,67,44,26,11,3,8,11,4,1,0,6
S01009076,Occupancy rating +1,111,51,4,47,58,2,48,26,16,6,8,1,7,2,2,0,0,0
S01009076,Occupancy rating 0,52,7,2,5,40,0,31,2,25,4,9,7,2,5,1,0,0,4
S01009076,Occupancy rating -1 or less,25,9,1,8,15,1,11,4,4,3,3,2,1,1,1,0,0,0
S01009077,All households,259,60,19,41,193,30,141,53,57,31,22,15,7,6,2,0,0,4
S01009077,Occupancy rating +2 or more,115,25,5,20,88,26,61,35,13,13,1,1,0,2,0,0,0,2
S01009077,Occupancy rating +1,91,28,11,17,62,4,49,15,22,12,9,5,4,1,0,0,0,1
S01009077,Occupancy rating 0,42,6,3,3,35,0,25,2,18,5,10,7,3,1,1,0,0,0
S01009077,Occupancy rating -1 or less,11,1,0,1,8,0,6,1,4,1,2,2,0,2,1,0,0,1
S01009078,All households,271,22,4,18,238,7,210,67,126,17,21,13,8,11,3,0,0,8
S01009078,Occupancy rating +2 or more,202,20,3,17,176,6,161,60,89,12,9,5,4,6,2,0,0,4
S01009078,Occupancy rating +1,51,2,1,1,45,1,36,6,25,5,8,6,2,4,0,0,0,4
S01009078,Occupancy rating 0,16,0,0,0,15,0,12,1,11,0,3,2,1,1,1,0,0,0
S01009078,Occupancy rating -1 or less,2,0,0,0,2,0,1,0,1,0,1,0,1,0,0,0,0,0
S01009079,All households,388,143,80,63,219,24,143,68,47,28,52,30,22,26,11,0,2,13
S01009079,Occupancy rating +2 or more,128,45,22,23,79,16,60,48,6,6,3,3,0,4,1,0,1,2
S01009079,Occupancy rating +1,125,54,25,29,68,4,45,16,16,13,19,8,11,3,0,0,0,3
S01009079,Occupancy rating 0,108,36,29,7,60,4,30,3,20,7,26,16,10,12,4,0,1,7
S01009079,Occupancy rating -1 or less,27,8,4,4,12,0,8,1,5,2,4,3,1,7,6,0,0,1
S01009080,All households,430,140,64,76,276,38,162,71,53,38,76,51,25,14,9,0,0,5
S01009080,Occupancy rating +2 or more,150,43,23,20,104,24,69,50,11,8,11,6,5,3,1,0,0,2
S01009080,Occupancy rating +1,149,73,29,44,74,12,49,18,13,18,13,10,3,2,1,0,0,1
S01009080,Occupancy rating 0,102,22,12,10,76,2,34,1,22,11,40,28,12,4,2,0,0,2
S01009080,Occupancy rating -1 or less,29,2,0,2,22,0,10,2,7,1,12,7,5,5,5,0,0,0
S01009081,All households,311,102,46,56,203,33,145,70,54,21,25,10,15,6,2,0,1,3
S01009081,Occupancy rating +2 or more,118,29,14,15,88,21,64,41,15,8,3,1,2,1,0,0,1,0
S01009081,Occupancy rating +1,127,48,19,29,75,11,53,24,19,10,11,3,8,4,2,0,0,2
S01009081,Occupancy rating 0,57,23,12,11,33,1,21,3,17,1,11,6,5,1,0,0,0,1
S01009081,Occupancy rating -1 or less,9,2,1,1,7,0,7,2,3,2,0,0,0,0,0,0,0,0
S01009082,All households,426,144,61,83,259,23,178,67,78,33,58,32,26,23,13,0,1,9
S01009082,Occupancy rating +2 or more,145,52,18,34,89,11,72,45,20,7,6,3,3,4,1,0,0,3
S01009082,Occupancy rating +1,142,64,28,36,73,7,50,17,19,14,16,5,11,5,3,0,0,2
S01009082,Occupancy rating 0,103,19,13,6,76,5,44,5,30,9,27,18,9,8,3,0,1,4
S01009082,Occupancy rating -1 or less,36,9,2,7,21,0,12,0,9,3,9,6,3,6,6,0,0,0
S01009083,All households,349,98,29,69,241,27,163,84,56,23,51,36,15,10,5,0,1,4
S01009083,Occupancy rating +2 or more,140,39,11,28,100,17,74,51,17,6,9,5,4,1,1,0,0,0
S01009083,Occupancy rating +1,115,40,11,29,72,7,53,26,18,9,12,9,3,3,2,0,0,1
S01009083,Occupancy rating 0,72,13,4,9,56,2,26,2,17,7,28,21,7,3,0,0,1,2
S01009083,Occupancy rating -1 or less,22,6,3,3,13,1,10,5,4,1,2,1,1,3,2,0,0,1
S01009084,All households,177,28,6,22,140,5,121,46,66,9,14,11,3,9,3,0,0,6
S01009084,Occupancy rating +2 or more,116,19,5,14,92,3,87,34,47,6,2,1,1,5,2,0,0,3
S01009084,Occupancy rating +1,29,7,0,7,20,1,17,10,7,0,2,2,0,2,0,0,0,2
S01009084,Occupancy rating 0,25,2,1,1,22,1,13,2,8,3,8,6,2,1,0,0,0,1
S01009084,Occupancy rating -1 or less,7,0,0,0,6,0,4,0,4,0,2,2,0,1,1,0,0,0
S01009085,All households,280,38,1,37,237,3,223,63,143,17,11,9,2,5,3,0,0,2
S01009085,Occupancy rating +2 or more,168,27,1,26,139,3,132,47,76,9,4,3,1,2,1,0,0,1
S01009085,Occupancy rating +1,80,7,0,7,71,0,66,15,45,6,5,5,0,2,1,0,0,1
S01009085,Occupancy rating 0,29,4,0,4,24,0,23,1,21,1,1,0,1,1,1,0,0,0
S01009085,Occupancy rating -1 or less,3,0,0,0,3,0,2,0,1,1,1,1,0,0,0,0,0,0
S01009086,All households,305,73,26,47,217,20,153,66,66,21,44,27,17,15,7,1,1,6
S01009086,Occupancy rating +2 or more,124,23,7,16,99,13,81,50,29,2,5,1,4,2,2,0,0,0
S01009086,Occupancy rating +1,95,37,15,22,57,7,40,14,15,11,10,4,6,1,1,0,0,0
S01009086,Occupancy rating 0,61,8,4,4,45,0,24,1,17,6,21,16,5,8,2,1,1,4
S01009086,Occupancy rating -1 or less,25,5,0,5,16,0,8,1,5,2,8,6,2,4,2,0,0,2
S01009087,All households,247,65,19,46,168,22,108,44,43,21,38,24,14,14,5,0,0,9
S01009087,Occupancy rating +2 or more,95,29,11,18,63,16,42,24,13,5,5,3,2,3,2,0,0,1
S01009087,Occupancy rating +1,90,26,7,19,61,6,44,19,13,12,11,4,7,3,0,0,0,3
S01009087,Occupancy rating 0,53,10,1,9,35,0,16,1,12,3,19,14,5,8,3,0,0,5
S01009087,Occupancy rating -1 or less,9,0,0,0,9,0,6,0,5,1,3,3,0,0,0,0,0,0
S01009088,All households,385,64,32,32,300,40,236,95,99,42,24,9,15,21,6,0,0,15
S01009088,Occupancy rating +2 or more,264,50,27,23,206,33,170,91,62,17,3,1,2,8,1,0,0,7
S01009088,Occupancy rating +1,80,12,4,8,63,7,43,3,21,19,13,3,10,5,1,0,0,4
S01009088,Occupancy rating 0,32,1,0,1,28,0,20,1,13,6,8,5,3,3,2,0,0,1
S01009088,Occupancy rating -1 or less,9,1,1,0,3,0,3,0,3,0,0,0,0,5,2,0,0,3
S01009089,All households,325,41,7,34,278,16,246,56,167,23,16,12,4,6,4,0,0,2
S01009089,Occupancy rating +2 or more,275,30,6,24,241,15,217,54,142,21,9,7,2,4,2,0,0,2
S01009089,Occupancy rating +1,27,6,1,5,20,0,19,2,16,1,1,1,0,1,1,0,0,0
S01009089,Occupancy rating 0,19,5,0,5,13,1,7,0,7,0,5,3,2,1,1,0,0,0
S01009089,Occupancy rating -1 or less,4,0,0,0,4,0,3,0,2,1,1,1,0,0,0,0,0,0
S01009090,All households,333,89,7,82,236,6,216,113,94,9,14,13,1,8,3,0,1,4
S01009090,Occupancy rating +2 or more,189,25,1,24,161,3,150,69,74,7,8,8,0,3,0,0,1,2
S01009090,Occupancy rating +1,88,34,4,30,52,3,47,36,11,0,2,1,1,2,2,0,0,0
S01009090,Occupancy rating 0,47,26,2,24,18,0,14,6,8,0,4,4,0,3,1,0,0,2
S01009090,Occupancy rating -1 or less,9,4,0,4,5,0,5,2,1,2,0,0,0,0,0,0,0,0
S01009091,All households,223,22,3,19,196,1,182,46,122,14,13,10,3,5,5,0,0,0
S01009091,Occupancy rating +2 or more,191,11,0,11,179,0,168,40,115,13,11,9,2,1,1,0,0,0
S01009091,Occupancy rating +1,16,6,1,5,9,1,8,5,3,0,0,0,0,1,1,0,0,0
S01009091,Occupancy rating 0,13,5,2,3,7,0,5,1,3,1,2,1,1,1,1,0,0,0
S01009091,Occupancy rating -1 or less,3,0,0,0,1,0,1,0,1,0,0,0,0,2,2,0,0,0
S01009092,All households,482,149,74,75,314,53,218,101,88,29,43,29,14,19,11,0,2,6
S01009092,Occupancy rating +2 or more,228,65,35,30,159,32,119,65,42,12,8,6,2,4,2,0,0,2
S01009092,Occupancy rating +1,153,70,32,38,82,18,56,30,13,13,8,6,2,1,0,0,0,1
S01009092,Occupancy rating 0,77,11,5,6,59,2,36,4,29,3,21,15,6,7,5,0,0,2
S01009092,Occupancy rating -1 or less,24,3,2,1,14,1,7,2,4,1,6,2,4,7,4,0,2,1
S01009093,All households,343,102,31,71,231,18,146,64,64,18,67,50,17,10,8,0,0,2
S01009093,Occupancy rating +2 or more,92,26,8,18,64,8,46,32,10,4,10,4,6,2,2,0,0,0
S01009093,Occupancy rating +1,126,53,16,37,72,10,46,25,12,9,16,10,6,1,1,0,0,0
S01009093,Occupancy rating 0,106,22,7,15,80,0,45,7,34,4,35,31,4,4,2,0,0,2
S01009093,Occupancy rating -1 or less,19,1,0,1,15,0,9,0,8,1,6,5,1,3,3,0,0,0
S01009094,All households,290,59,48,11,228,68,147,62,58,27,13,8,5,3,3,0,0,0
S01009094,Occupancy rating +2 or more,240,52,41,11,187,63,115,56,38,21,9,6,3,1,1,0,0,0
S01009094,Occupancy rating +1,42,6,6,0,34,5,26,4,16,6,3,2,1,2,2,0,0,0
S01009094,Occupancy rating 0,4,1,1,0,3,0,3,1,2,0,0,0,0,0,0,0,0,0
S01009094,Occupancy rating -1 or less,4,0,0,0,4,0,3,1,2,0,1,0,1,0,0,0,0,0
S01009095,All households,360,138,51,87,217,32,166,71,70,25,19,14,5,5,1,0,0,4
S01009095,Occupancy rating +2 or more,170,42,21,21,125,23,101,46,39,16,1,1,0,3,0,0,0,3
S01009095,Occupancy rating +1,82,37,14,23,45,5,33,16,15,2,7,4,3,0,0,0,0,0
S01009095,Occupancy rating 0,80,47,12,35,32,4,22,5,12,5,6,5,1,1,1,0,0,0
S01009095,Occupancy rating -1 or less,28,12,4,8,15,0,10,4,4,2,5,4,1,1,0,0,0,1
S01009096,All households,384,104,33,71,265,17,215,84,117,14,33,26,7,15,6,0,1,8
S01009096,Occupancy rating +2 or more,223,33,7,26,182,14,158,65,86,7,10,9,1,8,5,0,0,3
S01009096,Occupancy rating +1,68,30,11,19,35,3,29,10,16,3,3,3,0,3,0,0,1,2
S01009096,Occupancy rating 0,70,33,14,19,35,0,19,8,9,2,16,10,6,2,1,0,0,1
S01009096,Occupancy rating -1 or less,23,8,1,7,13,0,9,1,6,2,4,4,0,2,0,0,0,2
S01009097,All households,347,74,20,54,263,25,224,74,126,24,14,10,4,10,3,0,0,7
S01009097,Occupancy rating +2 or more,227,34,11,23,189,21,163,66,86,11,5,4,1,4,2,0,0,2
S01009097,Occupancy rating +1,86,35,8,27,47,3,39,7,22,10,5,3,2,4,1,0,0,3
S01009097,Occupancy rating 0,25,3,0,3,21,1,16,0,15,1,4,3,1,1,0,0,0,1
S01009097,Occupancy rating -1 or less,9,2,1,1,6,0,6,1,3,2,0,0,0,1,0,0,0,1
S01009098,All households,190,26,12,14,162,28,129,52,54,23,5,3,2,2,2,0,0,0
S01009098,Occupancy rating +2 or more,147,22,10,12,125,28,96,47,33,16,1,0,1,0,0,0,0,0
S01009098,Occupancy rating +1,32,2,2,0,30,0,28,5,16,7,2,1,1,0,0,0,0,0
S01009098,Occupancy rating 0,10,2,0,2,6,0,5,0,5,0,1,1,0,2,2,0,0,0
S01009098,Occupancy rating -1 or less,1,0,0,0,1,0,0,0,0,0,1,1,0,0,0,0,0,0
S01009099,All households,384,172,88,84,201,27,148,70,54,24,26,15,11,11,5,0,0,6
S01009099,Occupancy rating +2 or more,171,58,27,31,111,23,84,47,28,9,4,0,4,2,0,0,0,2
S01009099,Occupancy rating +1,94,38,14,24,53,3,41,17,16,8,9,5,4,3,1,0,0,2
S01009099,Occupancy rating 0,71,40,17,23,29,0,20,5,10,5,9,6,3,2,1,0,0,1
S01009099,Occupancy rating -1 or less,48,36,30,6,8,1,3,1,0,2,4,4,0,4,3,0,0,1
S01009100,All households,397,185,109,76,195,22,110,48,45,17,63,43,20,17,8,0,1,8
S01009100,Occupancy rating +2 or more,75,30,17,13,43,7,35,25,8,2,1,1,0,2,1,0,0,1
S01009100,Occupancy rating +1,133,70,33,37,59,7,38,18,13,7,14,8,6,4,2,0,0,2
S01009100,Occupancy rating 0,140,59,38,21,74,5,30,4,19,7,39,27,12,7,1,0,1,5
S01009100,Occupancy rating -1 or less,49,26,21,5,19,3,7,1,5,1,9,7,2,4,4,0,0,0
S01009101,All households,369,90,46,44,257,29,173,61,65,47,55,34,21,22,7,1,0,14
S01009101,Occupancy rating +2 or more,144,45,25,20,95,19,70,49,12,9,6,2,4,4,0,0,0,4
S01009101,Occupancy rating +1,99,18,6,12,77,5,57,8,26,23,15,8,7,4,0,0,0,4
S01009101,Occupancy rating 0,94,20,12,8,65,4,35,3,18,14,26,16,10,9,4,1,0,4
S01009101,Occupancy rating -1 or less,32,7,3,4,20,1,11,1,9,1,8,8,0,5,3,0,0,2
S01009102,All households,317,69,22,47,236,13,131,41,72,18,92,63,29,12,5,0,0,7
S01009102,Occupancy rating +2 or more,98,37,9,28,60,10,43,30,8,5,7,5,2,1,0,0,0,1
S01009102,Occupancy rating +1,99,29,12,17,66,1,35,8,20,7,30,14,16,4,1,0,0,3
S01009102,Occupancy rating 0,83,2,0,2,78,1,43,3,36,4,34,26,8,3,0,0,0,3
S01009102,Occupancy rating -1 or less,37,1,1,0,32,1,10,0,8,2,21,18,3,4,4,0,0,0
S01009103,All households,246,65,38,27,177,28,135,58,54,23,14,10,4,4,2,0,0,2
S01009103,Occupancy rating +2 or more,161,41,27,14,119,24,93,51,29,13,2,2,0,1,0,0,0,1
S01009103,Occupancy rating +1,58,20,10,10,36,4,29,7,17,5,3,2,1,2,1,0,0,1
S01009103,Occupancy rating 0,26,4,1,3,21,0,12,0,7,5,9,6,3,1,1,0,0,0
S01009103,Occupancy rating -1 or less,1,0,0,0,1,0,1,0,1,0,0,0,0,0,0,0,0,0
S01009104,All households,352,108,49,59,236,22,169,82,64,23,45,32,13,8,1,0,0,7
S01009104,Occupancy rating +2 or more,116,35,15,20,81,16,65,47,12,6,0,0,0,0,0,0,0,0
S01009104,Occupancy rating +1,142,51,21,30,90,4,69,31,27,11,17,8,9,1,0,0,0,1
S01009104,Occupancy rating 0,78,20,13,7,53,0,30,4,20,6,23,20,3,5,0,0,0,5
S01009104,Occupancy rating -1 or less,16,2,0,2,12,2,5,0,5,0,5,4,1,2,1,0,0,1
S01009105,All households,337,95,44,51,231,26,162,60,77,25,43,25,18,11,4,0,0,7
S01009105,Occupancy rating +2 or more,152,37,16,21,112,13,89,40,37,12,10,8,2,3,0,0,0,3
S01009105,Occupancy rating +1,95,28,12,16,65,10,39,15,21,3,16,8,8,2,1,0,0,1
S01009105,Occupancy rating 0,74,25,14,11,45,2,29,5,16,8,14,9,5,4,2,0,0,2
S01009105,Occupancy rating -1 or less,16,5,2,3,9,1,5,0,3,2,3,0,3,2,1,0,0,1
S01009106,All households,264,92,40,52,168,28,112,47,50,15,28,15,13,4,2,0,0,2
S01009106,Occupancy rating +2 or more,70,27,15,12,42,14,25,15,5,5,3,2,1,1,1,0,0,0
S01009106,Occupancy rating +1,129,50,23,27,78,11,57,30,23,4,10,3,7,1,0,0,0,1
S01009106,Occupancy rating 0,59,15,2,13,42,3,28,2,21,5,11,8,3,2,1,0,0,1
S01009106,Occupancy rating -1 or less,6,0,0,0,6,0,2,0,1,1,4,2,2,0,0,0,0,0
S01009107,All households,333,63,32,31,261,28,208,79,98,31,25,16,9,9,4,0,0,5
S01009107,Occupancy rating +2 or more,192,33,22,11,156,24,128,55,59,14,4,3,1,3,1,0,0,2
S01009107,Occupancy rating +1,89,27,9,18,62,4,52,22,19,11,6,3,3,0,0,0,0,0
S01009107,Occupancy rating 0,39,3,1,2,33,0,22,1,17,4,11,6,5,3,1,0,0,2
S01009107,Occupancy rating -1 or less,13,0,0,0,10,0,6,1,3,2,4,4,0,3,2,0,0,1
S01009108,All households,313,81,36,45,225,44,162,74,58,30,19,10,9,7,2,0,1,4
S01009108,Occupancy rating +2 or more,181,33,16,17,145,29,113,62,36,15,3,0,3,3,0,0,1,2
S01009108,Occupancy rating +1,92,42,18,24,49,14,32,12,13,7,3,1,2,1,0,0,0,1
S01009108,Occupancy rating 0,35,6,2,4,29,1,15,0,8,7,13,9,4,0,0,0,0,0
S01009108,Occupancy rating -1 or less,5,0,0,0,2,0,2,0,1,1,0,0,0,3,2,0,0,1
S01009109,All households,263,41,15,26,220,21,185,75,73,37,14,9,5,2,1,0,0,1
S01009109,Occupancy rating +2 or more,199,31,11,20,167,20,142,70,43,29,5,2,3,1,0,0,0,1
S01009109,Occupancy rating +1,37,6,2,4,31,1,26,5,16,5,4,4,0,0,0,0,0,0
S01009109,Occupancy rating 0,23,4,2,2,18,0,13,0,11,2,5,3,2,1,1,0,0,0
S01009109,Occupancy rating -1 or less,4,0,0,0,4,0,4,0,3,1,0,0,0,0,0,0,0,0
S01009110,All households,263,75,36,39,182,35,120,40,55,25,27,14,13,6,1,0,0,5
S01009110,Occupancy rating +2 or more,115,33,14,19,79,21,50,30,15,5,8,4,4,3,1,0,0,2
S01009110,Occupancy rating +1,93,26,11,15,65,9,44,9,23,12,12,6,6,2,0,0,0,2
S01009110,Occupancy rating 0,44,13,10,3,30,4,21,1,13,7,5,3,2,1,0,0,0,1
S01009110,Occupancy rating -1 or less,11,3,1,2,8,1,5,0,4,1,2,1,1,0,0,0,0,0
S01009111,All households,372,123,34,89,240,9,196,81,82,33,35,27,8,9,4,0,0,5
S01009111,Occupancy rating +2 or more,164,32,8,24,130,6,120,58,42,20,4,4,0,2,1,0,0,1
S01009111,Occupancy rating +1,99,44,12,32,53,2,44,18,16,10,7,6,1,2,0,0,0,2
S01009111,Occupancy rating 0,85,35,12,23,48,1,29,5,22,2,18,13,5,2,1,0,0,1
S01009111,Occupancy rating -1 or less,24,12,2,10,9,0,3,0,2,1,6,4,2,3,2,0,0,1
S01009112,All households,238,55,32,23,177,30,137,56,58,23,10,4,6,6,2,0,1,3
S01009112,Occupancy rating +2 or more,163,37,19,18,125,28,92,48,36,8,5,1,4,1,0,0,0,1
S01009112,Occupancy rating +1,58,15,10,5,40,2,35,7,18,10,3,1,2,3,2,0,1,0
S01009112,Occupancy rating 0,17,3,3,0,12,0,10,1,4,5,2,2,0,2,0,0,0,2
S01009112,Occupancy rating -1 or less,0,0,0,0,0,0,0,0,0,0,0,0,0,0,0,0,0,0
S01009113,All households,381,118,36,82,257,39,194,89,81,24,24,17,7,6,3,0,0,3
S01009113,Occupancy rating +2 or more,189,34,18,16,152,26,118,49,55,14,8,5,3,3,2,0,0,1
S01009113,Occupancy rating +1,120,51,15,36,69,11,51,32,12,7,7,5,2,0,0,0,0,0
S01009113,Occupancy rating 0,56,24,2,22,29,1,23,8,12,3,5,3,2,3,1,0,0,2
S01009113,Occupancy rating -1 or less,16,9,1,8,7,1,2,0,2,0,4,4,0,0,0,0,0,0
S01009114,All households,303,69,23,46,218,14,169,57,86,26,35,25,10,16,7,0,1,8
S01009114,Occupancy rating +2 or more,122,18,5,13,98,7,86,29,43,14,5,5,0,6,3,0,0,3
S01009114,Occupancy rating +1,107,35,14,21,67,6,53,19,27,7,8,4,4,5,2,0,0,3
S01009114,Occupancy rating 0,52,14,3,11,36,1,21,7,12,2,14,11,3,2,0,0,0,2
S01009114,Occupancy rating -1 or less,22,2,1,1,17,0,9,2,4,3,8,5,3,3,2,0,1,0
S01009115,All households,259,82,18,64,163,12,129,54,60,15,22,16,6,14,7,0,1,6
S01009115,Occupancy rating +2 or more,98,20,7,13,75,10,63,27,25,11,2,1,1,3,1,0,0,2
S01009115,Occupancy rating +1,68,27,8,19,39,1,33,19,11,3,5,2,3,2,1,0,0,1
S01009115,Occupancy rating 0,74,33,3,30,36,0,25,6,19,0,11,10,1,5,1,0,1,3
S01009115,Occupancy rating -1 or less,19,2,0,2,13,1,8,2,5,1,4,3,1,4,4,0,0,0
S01009116,All households,191,36,14,22,153,21,118,51,40,27,14,6,8,2,1,0,0,1
S01009116,Occupancy rating +2 or more,122,20,7,13,101,15,82,44,22,16,4,1,3,1,1,0,0,0
S01009116,Occupancy rating +1,48,15,7,8,33,4,24,6,9,9,5,2,3,0,0,0,0,0
S01009116,Occupancy rating 0,17,1,0,1,16,2,9,0,8,1,5,3,2,0,0,0,0,0
S01009116,Occupancy rating -1 or less,4,0,0,0,3,0,3,1,1,1,0,0,0,1,0,0,0,1
S01009117,All households,391,133,43,90,244,21,173,70,86,17,50,41,9,14,9,0,1,4
S01009117,Occupancy rating +2 or more,111,32,14,18,78,11,60,29,26,5,7,4,3,1,0,0,0,1
S01009117,Occupancy rating +1,149,59,20,39,90,9,73,38,26,9,8,5,3,0,0,0,0,0
S01009117,Occupancy rating 0,98,28,6,22,63,1,35,3,30,2,27,25,2,7,5,0,1,1
S01009117,Occupancy rating -1 or less,33,14,3,11,13,0,5,0,4,1,8,7,1,6,4,0,0,2
S01009118,All households,215,29,8,21,178,10,158,41,95,22,10,9,1,8,4,0,0,4
S01009118,Occupancy rating +2 or more,148,18,3,15,126,8,112,38,56,18,6,5,1,4,2,0,0,2
S01009118,Occupancy rating +1,38,6,0,6,31,1,28,3,23,2,2,2,0,1,0,0,0,1
S01009118,Occupancy rating 0,26,5,5,0,19,1,17,0,15,2,1,1,0,2,1,0,0,1
S01009118,Occupancy rating -1 or less,3,0,0,0,2,0,1,0,1,0,1,1,0,1,1,0,0,0
S01009119,All households,297,76,37,39,200,21,139,40,60,39,40,27,13,21,10,0,1,10
S01009119,Occupancy rating +2 or more,92,33,13,20,56,13,43,31,6,6,0,0,0,3,1,0,1,1
S01009119,Occupancy rating +1,94,22,9,13,67,7,46,4,22,20,14,6,8,5,3,0,0,2
S01009119,Occupancy rating 0,86,20,14,6,55,1,37,4,24,9,17,14,3,11,4,0,0,7
S01009119,Occupancy rating -1 or less,25,1,1,0,22,0,13,1,8,4,9,7,2,2,2,0,0,0
S01009120,All households,233,70,25,45,157,15,103,35,43,25,39,20,19,6,2,0,1,3
S01009120,Occupancy rating +2 or more,67,21,11,10,45,8,31,22,5,4,6,1,5,1,0,0,0,1
S01009120,Occupancy rating +1,87,37,12,25,50,6,29,11,8,10,15,7,8,0,0,0,0,0
S01009120,Occupancy rating 0,64,8,1,7,53,1,38,1,26,11,14,9,5,3,1,0,0,2
S01009120,Occupancy rating -1 or less,15,4,1,3,9,0,5,1,4,0,4,3,1,2,1,0,1,0
S01009121,All households,380,120,40,80,242,35,161,76,58,27,46,28,18,18,5,0,3,10
S01009121,Occupancy rating +2 or more,100,31,13,18,68,19,46,33,9,4,3,1,2,1,1,0,0,0
S01009121,Occupancy rating +1,162,62,25,37,94,14,69,38,20,11,11,5,6,6,2,0,0,4
S01009121,Occupancy rating 0,92,25,2,23,58,1,34,5,19,10,23,16,7,9,1,0,3,5
S01009121,Occupancy rating -1 or less,26,2,0,2,22,1,12,0,10,2,9,6,3,2,1,0,0,1
S01009122,All households,417,131,53,78,275,32,194,93,65,36,49,26,23,11,4,0,0,7
S01009122,Occupancy rating +2 or more,207,64,35,29,140,21,111,69,29,13,8,4,4,3,1,0,0,2
S01009122,Occupancy rating +1,130,54,15,39,75,9,52,21,15,16,14,6,8,1,0,0,0,1
S01009122,Occupancy rating 0,59,12,3,9,44,1,25,3,16,6,18,11,7,3,0,0,0,3
S01009122,Occupancy rating -1 or less,21,1,0,1,16,1,6,0,5,1,9,5,4,4,3,0,0,1
S01009123,All households,215,35,9,26,170,13,137,49,80,8,20,13,7,10,5,0,0,5
S01009123,Occupancy rating +2 or more,127,22,7,15,102,10,87,35,47,5,5,2,3,3,0,0,0,3
S01009123,Occupancy rating +1,47,7,1,6,37,3,31,12,18,1,3,2,1,3,2,0,0,1
S01009123,Occupancy rating 0,33,5,1,4,26,0,14,2,12,0,12,9,3,2,1,0,0,1
S01009123,Occupancy rating -1 or less,8,1,0,1,5,0,5,0,3,2,0,0,0,2,2,0,0,0
S01009124,All households,217,39,14,25,169,12,131,44,74,13,26,23,3,9,6,0,0,3
S01009124,Occupancy rating +2 or more,118,21,7,14,95,8,80,32,44,4,7,7,0,2,1,0,0,1
S01009124,Occupancy rating +1,48,16,5,11,30,2,23,10,11,2,5,3,2,2,1,0,0,1
S01009124,Occupancy rating 0,41,2,2,0,37,2,24,1,16,7,11,10,1,2,2,0,0,0
S01009124,Occupancy rating -1 or less,10,0,0,0,7,0,4,1,3,0,3,3,0,3,2,0,0,1
S01009125,All households,301,83,36,47,205,38,129,64,45,20,38,21,17,13,4,0,0,9
S01009125,Occupancy rating +2 or more,94,21,11,10,71,15,48,32,14,2,8,4,4,2,0,0,0,2
S01009125,Occupancy rating +1,127,49,19,30,76,19,44,28,6,10,13,8,5,2,1,0,0,1
S01009125,Occupancy rating 0,57,10,5,5,42,2,26,3,17,6,14,7,7,5,1,0,0,4
S01009125,Occupancy rating -1 or less,23,3,1,2,16,2,11,1,8,2,3,2,1,4,2,0,0,2
S01009126,All households,281,123,31,92,146,11,77,24,44,9,58,43,15,12,7,0,0,5
S01009126,Occupancy rating +2 or more,37,13,5,8,22,2,18,9,6,3,2,0,2,2,1,0,0,1
S01009126,Occupancy rating +1,122,81,21,60,38,6,26,14,9,3,6,2,4,3,1,0,0,2
S01009126,Occupancy rating 0,95,24,4,20,69,2,27,1,23,3,40,32,8,2,0,0,0,2
S01009126,Occupancy rating -1 or less,27,5,1,4,17,1,6,0,6,0,10,9,1,5,5,0,0,0
S01009127,All households,269,86,19,67,173,5,102,31,52,19,66,56,10,10,3,0,1,6
S01009127,Occupancy rating +2 or more,39,17,2,15,22,1,19,14,5,0,2,2,0,0,0,0,0,0
S01009127,Occupancy rating +1,88,46,12,34,41,1,33,11,12,10,7,4,3,1,0,0,0,1
S01009127,Occupancy rating 0,111,19,4,15,87,2,46,6,31,9,39,33,6,5,1,0,0,4
S01009127,Occupancy rating -1 or less,31,4,1,3,23,1,4,0,4,0,18,17,1,4,2,0,1,1
S01009128,All households,467,250,107,143,200,20,114,53,39,22,66,51,15,17,3,0,1,13
S01009128,Occupancy rating +2 or more,38,16,6,10,22,4,14,10,1,3,4,3,1,0,0,0,0,0
S01009128,Occupancy rating +1,171,104,26,78,65,7,54,35,11,8,4,2,2,2,0,0,0,2
S01009128,Occupancy rating 0,222,118,69,49,96,8,39,7,23,9,49,38,11,8,1,0,0,7
S01009128,Occupancy rating -1 or less,36,12,6,6,17,1,7,1,4,2,9,8,1,7,2,0,1,4
S01009129,All households,205,70,26,44,123,6,81,27,35,19,36,22,14,12,4,0,1,7
S01009129,Occupancy rating +2 or more,61,24,10,14,35,4,29,20,5,4,2,0,2,2,0,0,0,2
S01009129,Occupancy rating +1,72,33,14,19,36,2,22,6,10,6,12,7,5,3,2,0,0,1
S01009129,Occupancy rating 0,50,10,1,9,34,0,20,0,14,6,14,10,4,6,2,0,1,3
S01009129,Occupancy rating -1 or less,22,3,1,2,18,0,10,1,6,3,8,5,3,1,0,0,0,1
S01009130,All households,271,84,22,62,175,13,128,43,72,13,34,25,9,12,5,0,0,7
S01009130,Occupancy rating +2 or more,89,25,3,22,62,4,55,25,27,3,3,3,0,2,0,0,0,2
S01009130,Occupancy rating +1,99,38,11,27,59,6,36,13,19,4,17,15,2,2,0,0,0,2
S01009130,Occupancy rating 0,66,19,7,12,43,2,31,5,22,4,10,4,6,4,2,0,0,2
S01009130,Occupancy rating -1 or less,17,2,1,1,11,1,6,0,4,2,4,3,1,4,3,0,0,1
S01009131,All households,260,119,46,73,127,15,80,40,30,10,32,23,9,14,5,0,1,8
S01009131,Occupancy rating +2 or more,46,19,8,11,24,5,18,10,5,3,1,0,1,3,2,0,0,1
S01009131,Occupancy rating +1,105,61,26,35,40,9,29,24,2,3,2,0,2,4,0,0,1,3
S01009131,Occupancy rating 0,87,35,10,25,51,1,24,5,16,3,26,21,5,1,0,0,0,1
S01009131,Occupancy rating -1 or less,22,4,2,2,12,0,9,1,7,1,3,2,1,6,3,0,0,3
S01009132,All households,329,68,11,57,254,11,202,83,94,25,41,33,8,7,1,0,0,6
S01009132,Occupancy rating +2 or more,160,21,6,15,138,10,119,52,54,13,9,7,2,1,1,0,0,0
S01009132,Occupancy rating +1,107,41,3,38,64,1,54,29,17,8,9,5,4,2,0,0,0,2
S01009132,Occupancy rating 0,49,3,1,2,44,0,25,1,20,4,19,18,1,2,0,0,0,2
S01009132,Occupancy rating -1 or less,13,3,1,2,8,0,4,1,3,0,4,3,1,2,0,0,0,2
S01009133,All households,301,134,36,98,156,12,106,54,39,13,38,26,12,11,3,0,0,8
S01009133,Occupancy rating +2 or more,48,17,7,10,29,4,23,14,6,3,2,2,0,2,0,0,0,2
S01009133,Occupancy rating +1,137,89,21,68,47,8,35,27,5,3,4,3,1,1,1,0,0,0
S01009133,Occupancy rating 0,89,22,7,15,63,0,41,13,22,6,22,15,7,4,1,0,0,3
S01009133,Occupancy rating -1 or less,27,6,1,5,17,0,7,0,6,1,10,6,4,4,1,0,0,3
S01009134,All households,409,120,51,69,275,36,198,87,83,28,41,22,19,14,6,0,1,7
S01009134,Occupancy rating +2 or more,191,53,21,32,135,22,108,58,32,18,5,1,4,3,1,0,0,2
S01009134,Occupancy rating +1,141,56,28,28,80,13,54,25,25,4,13,8,5,5,1,0,1,3
S01009134,Occupancy rating 0,60,10,2,8,47,1,30,3,21,6,16,7,9,3,1,0,0,2
S01009134,Occupancy rating -1 or less,17,1,0,1,13,0,6,1,5,0,7,6,1,3,3,0,0,0
S01009135,All households,264,110,10,100,144,4,122,49,64,9,18,12,6,10,3,0,0,7
S01009135,Occupancy rating +2 or more,73,16,2,14,55,3,49,19,26,4,3,1,2,2,2,0,0,0
S01009135,Occupancy rating +1,87,44,3,41,43,1,36,17,18,1,6,4,2,0,0,0,0,0
S01009135,Occupancy rating 0,87,43,3,40,40,0,33,13,16,4,7,6,1,4,1,0,0,3
S01009135,Occupancy rating -1 or less,17,7,2,5,6,0,4,0,4,0,2,1,1,4,0,0,0,4
S01009136,All households,275,71,27,44,186,15,158,60,87,11,13,11,2,18,6,1,0,11
S01009136,Occupancy rating +2 or more,147,13,4,9,126,6,116,39,68,9,4,2,2,8,4,0,0,4
S01009136,Occupancy rating +1,90,46,20,26,43,9,31,20,10,1,3,3,0,1,0,0,0,1
S01009136,Occupancy rating 0,33,10,2,8,16,0,10,1,8,1,6,6,0,7,1,1,0,5
S01009136,Occupancy rating -1 or less,5,2,1,1,1,0,1,0,1,0,0,0,0,2,1,0,0,1
S01009137,All households,203,15,2,13,178,3,164,50,98,16,11,8,3,10,5,0,0,5
S01009137,Occupancy rating +2 or more,183,15,2,13,160,2,147,49,83,15,11,8,3,8,5,0,0,3
S01009137,Occupancy rating +1,9,0,0,0,8,0,8,1,7,0,0,0,0,1,0,0,0,1
S01009137,Occupancy rating 0,9,0,0,0,9,1,8,0,7,1,0,0,0,0,0,0,0,0
S01009137,Occupancy rating -1 or less,2,0,0,0,1,0,1,0,1,0,0,0,0,1,0,0,0,1
S01009138,All households,395,138,28,110,241,23,198,91,87,20,20,10,10,16,7,0,1,8
S01009138,Occupancy rating +2 or more,189,36,16,20,145,22,115,56,44,15,8,3,5,8,5,0,0,3
S01009138,Occupancy rating +1,111,52,7,45,56,1,51,27,20,4,4,3,1,3,0,0,1,2
S01009138,Occupancy rating 0,74,39,2,37,32,0,26,6,19,1,6,3,3,3,1,0,0,2
S01009138,Occupancy rating -1 or less,21,11,3,8,8,0,6,2,4,0,2,1,1,2,1,0,0,1
S01009139,All households,239,122,17,105,108,6,68,41,21,6,34,25,9,9,2,1,0,6
S01009139,Occupancy rating +2 or more,40,13,5,8,26,5,19,11,4,4,2,2,0,1,0,1,0,0
S01009139,Occupancy rating +1,60,42,8,34,18,1,14,11,2,1,3,1,2,0,0,0,0,0
S01009139,Occupancy rating 0,109,50,2,48,53,0,31,17,13,1,22,16,6,6,0,0,0,6
S01009139,Occupancy rating -1 or less,30,17,2,15,11,0,4,2,2,0,7,6,1,2,2,0,0,0
S01009140,All households,381,190,49,141,173,18,121,66,39,16,34,24,10,18,4,1,1,12
S01009140,Occupancy rating +2 or more,91,31,13,18,55,10,43,28,9,6,2,2,0,5,0,0,1,4
S01009140,Occupancy rating +1,111,51,14,37,56,5,42,23,13,6,9,4,5,4,1,0,0,3
S01009140,Occupancy rating 0,138,85,19,66,48,2,26,11,11,4,20,15,5,5,2,1,0,2
S01009140,Occupancy rating -1 or less,41,23,3,20,14,1,10,4,6,0,3,3,0,4,1,0,0,3
S01009141,All households,473,278,78,200,184,11,134,79,48,7,39,24,15,11,3,1,0,7
S01009141,Occupancy rating +2 or more,73,30,7,23,43,3,36,22,11,3,4,2,2,0,0,0,0,0
S01009141,Occupancy rating +1,135,73,12,61,62,5,51,38,11,2,6,3,3,0,0,0,0,0
S01009141,Occupancy rating 0,233,162,56,106,64,3,41,15,24,2,20,11,9,7,0,1,0,6
S01009141,Occupancy rating -1 or less,32,13,3,10,15,0,6,4,2,0,9,8,1,4,3,0,0,1
S01009142,All households,393,258,62,196,129,17,94,60,27,7,18,12,6,6,1,0,0,5
S01009142,Occupancy rating +2 or more,56,27,7,20,29,7,21,18,2,1,1,1,0,0,0,0,0,0
S01009142,Occupancy rating +1,81,48,11,37,32,4,24,18,4,2,4,2,2,1,0,0,0,1
S01009142,Occupancy rating 0,202,144,33,111,56,5,41,23,15,3,10,6,4,2,1,0,0,1
S01009142,Occupancy rating -1 or less,54,39,11,28,12,1,8,1,6,1,3,3,0,3,0,0,0,3
S01009143,All households,312,146,67,79,153,19,85,35,33,17,49,36,13,13,6,0,0,7
S01009143,Occupancy rating +2 or more,30,12,7,5,17,3,11,7,3,1,3,3,0,1,1,0,0,0
S01009143,Occupancy rating +1,129,75,21,54,52,11,36,24,9,3,5,4,1,2,0,0,0,2
S01009143,Occupancy rating 0,111,46,27,19,57,4,26,3,16,7,27,17,10,8,3,0,0,5
S01009143,Occupancy rating -1 or less,42,13,12,1,27,1,12,1,5,6,14,12,2,2,2,0,0,0
S01009144,All households,306,83,5,78,207,5,171,101,61,9,31,24,7,16,2,1,0,13
S01009144,Occupancy rating +2 or more,127,27,4,23,100,1,95,65,27,3,4,3,1,0,0,0,0,0
S01009144,Occupancy rating +1,119,44,1,43,70,4,55,33,18,4,11,11,0,5,0,0,0,5
S01009144,Occupancy rating 0,50,8,0,8,33,0,18,3,13,2,15,10,5,9,0,1,0,8
S01009144,Occupancy rating -1 or less,10,4,0,4,4,0,3,0,3,0,1,0,1,2,2,0,0,0
S01009145,All households,497,163,66,97,315,63,195,89,77,29,57,37,20,19,9,0,0,10
S01009145,Occupancy rating +2 or more,136,37,20,17,98,34,58,41,10,7,6,3,3,1,0,0,0,1
S01009145,Occupancy rating +1,196,81,36,45,111,23,73,33,28,12,15,10,5,4,0,0,0,4
S01009145,Occupancy rating 0,129,40,9,31,81,4,53,14,30,9,24,17,7,8,6,0,0,2
S01009145,Occupancy rating -1 or less,36,5,1,4,25,2,11,1,9,1,12,7,5,6,3,0,0,3
S01009146,All households,417,141,46,95,256,21,173,71,68,34,62,43,19,20,1,3,2,14
S01009146,Occupancy rating +2 or more,103,40,19,21,62,15,43,26,11,6,4,1,3,1,0,0,1,0
S01009146,Occupancy rating +1,176,86,23,63,87,4,72,41,16,15,11,6,5,3,1,0,0,2
S01009146,Occupancy rating 0,91,6,2,4,71,1,37,4,27,6,33,27,6,14,0,2,1,11
S01009146,Occupancy rating -1 or less,47,9,2,7,36,1,21,0,14,7,14,9,5,2,0,1,0,1
S01009147,All households,353,98,37,61,236,24,134,47,58,29,78,52,26,19,9,0,0,10
S01009147,Occupancy rating +2 or more,85,29,9,20,56,12,38,29,5,4,6,2,4,0,0,0,0,0
S01009147,Occupancy rating +1,134,47,19,28,84,10,49,16,19,14,25,13,12,3,1,0,0,2
S01009147,Occupancy rating 0,106,16,4,12,82,0,43,2,30,11,39,30,9,8,3,0,0,5
S01009147,Occupancy rating -1 or less,28,6,5,1,14,2,4,0,4,0,8,7,1,8,5,0,0,3
S01009148,All households,260,46,21,25,201,23,132,50,56,26,46,34,12,13,6,0,1,6
S01009148,Occupancy rating +2 or more,99,26,12,14,71,19,51,43,4,4,1,1,0,2,2,0,0,0
S01009148,Occupancy rating +1,75,12,6,6,59,2,39,6,24,9,18,11,7,4,0,0,0,4
S01009148,Occupancy rating 0,60,6,2,4,52,2,31,1,19,11,19,15,4,2,1,0,0,1
S01009148,Occupancy rating -1 or less,26,2,1,1,19,0,11,0,9,2,8,7,1,5,3,0,1,1
S01009149,All households,384,138,47,91,228,32,170,87,65,18,26,17,9,18,3,0,1,14
S01009149,Occupancy rating +2 or more,156,33,17,16,118,18,93,48,36,9,7,4,3,5,1,0,0,4
S01009149,Occupancy rating +1,112,64,23,41,45,9,31,21,7,3,5,4,1,3,2,0,0,1
S01009149,Occupancy rating 0,84,34,6,28,45,5,33,15,14,4,7,3,4,5,0,0,1,4
S01009149,Occupancy rating -1 or less,32,7,1,6,20,0,13,3,8,2,7,6,1,5,0,0,0,5
S01009150,All households,574,409,312,97,158,93,48,42,2,4,17,0,17,7,0,0,4,3
S01009150,Occupancy rating +2 or more,35,24,20,4,11,4,6,4,0,2,1,0,1,0,0,0,0,0
S01009150,Occupancy rating +1,310,213,167,46,97,69,28,28,0,0,0,0,0,0,0,0,0,0
S01009150,Occupancy rating 0,197,145,105,40,46,17,14,10,2,2,15,0,15,6,0,0,3,3
S01009150,Occupancy rating -1 or less,32,27,20,7,4,3,0,0,0,0,1,0,1,1,0,0,1,0
S01009151,All households,474,230,150,80,228,57,140,71,54,15,31,15,16,16,6,0,2,8
S01009151,Occupancy rating +2 or more,123,35,25,10,86,19,58,30,26,2,9,6,3,2,1,0,0,1
S01009151,Occupancy rating +1,227,131,76,55,95,30,58,37,14,7,7,2,5,1,1,0,0,0
S01009151,Occupancy rating 0,106,61,46,15,37,6,19,4,10,5,12,5,7,8,1,0,2,5
S01009151,Occupancy rating -1 or less,18,3,3,0,10,2,5,0,4,1,3,2,1,5,3,0,0,2
S01009152,All households,462,296,115,181,152,44,79,65,13,1,29,16,13,14,2,0,2,10
S01009152,Occupancy rating +2 or more,38,17,8,9,20,6,12,8,4,0,2,1,1,1,0,0,0,1
S01009152,Occupancy rating +1,181,120,64,56,59,28,29,26,3,0,2,1,1,2,0,0,0,2
S01009152,Occupancy rating 0,192,130,37,93,52,8,29,25,3,1,15,6,9,10,1,0,2,7
S01009152,Occupancy rating -1 or less,51,29,6,23,21,2,9,6,3,0,10,8,2,1,1,0,0,0
S01009153,All households,266,132,25,107,117,16,89,60,24,5,12,4,8,17,2,2,2,11
S01009153,Occupancy rating +2 or more,85,31,14,17,51,14,36,25,8,3,1,1,0,3,1,0,1,1
S01009153,Occupancy rating +1,85,47,10,37,35,2,26,19,5,2,7,2,5,3,0,0,1,2
S01009153,Occupancy rating 0,58,31,1,30,21,0,17,11,6,0,4,1,3,6,0,2,0,4
S01009153,Occupancy rating -1 or less,38,23,0,23,10,0,10,5,5,0,0,0,0,5,1,0,0,4
S01009154,All households,438,171,82,89,240,52,180,91,72,17,8,4,4,27,3,0,0,24
S01009154,Occupancy rating +2 or more,222,63,31,32,149,37,108,53,43,12,4,1,3,10,3,0,0,7
S01009154,Occupancy rating +1,85,37,18,19,45,8,35,19,13,3,2,1,1,3,0,0,0,3
S01009154,Occupancy rating 0,92,59,27,32,31,6,23,14,7,2,2,2,0,2,0,0,0,2
S01009154,Occupancy rating -1 or less,39,12,6,6,15,1,14,5,9,0,0,0,0,12,0,0,0,12
S01009155,All households,234,67,23,44,158,27,113,47,55,11,18,7,11,9,3,0,0,6
S01009155,Occupancy rating +2 or more,142,28,15,13,109,22,78,27,43,8,9,2,7,5,1,0,0,4
S01009155,Occupancy rating +1,53,22,3,19,29,4,24,14,9,1,1,0,1,2,1,0,0,1
S01009155,Occupancy rating 0,31,13,5,8,17,1,8,4,2,2,8,5,3,1,0,0,0,1
S01009155,Occupancy rating -1 or less,8,4,0,4,3,0,3,2,1,0,0,0,0,1,1,0,0,0
S01009156,All households,247,77,42,35,163,31,117,53,50,14,15,8,7,7,3,0,0,4
S01009156,Occupancy rating +2 or more,194,53,34,19,136,30,102,45,44,13,4,3,1,5,2,0,0,3
S01009156,Occupancy rating +1,34,17,4,13,17,1,11,6,4,1,5,1,4,0,0,0,0,0
S01009156,Occupancy rating 0,15,6,4,2,8,0,3,2,1,0,5,3,2,1,0,0,0,1
S01009156,Occupancy rating -1 or less,4,1,0,1,2,0,1,0,1,0,1,1,0,1,1,0,0,0
S01009157,All households,366,110,60,50,243,32,156,54,66,36,55,36,19,13,8,0,0,5
S01009157,Occupancy rating +2 or more,151,60,36,24,85,21,58,33,14,11,6,1,5,6,3,0,0,3
S01009157,Occupancy rating +1,129,37,19,18,91,10,63,20,32,11,18,11,7,1,0,0,0,1
S01009157,Occupancy rating 0,64,9,4,5,51,1,26,0,14,12,24,17,7,4,3,0,0,1
S01009157,Occupancy rating -1 or less,22,4,1,3,16,0,9,1,6,2,7,7,0,2,2,0,0,0
S01009158,All households,277,97,59,38,177,23,114,55,41,18,40,31,9,3,0,0,0,3
S01009158,Occupancy rating +2 or more,82,31,20,11,51,10,40,25,9,6,1,0,1,0,0,0,0,0
S01009158,Occupancy rating +1,117,46,28,18,70,12,51,30,15,6,7,3,4,1,0,0,0,1
S01009158,Occupancy rating 0,69,15,8,7,52,1,22,0,16,6,29,27,2,2,0,0,0,2
S01009158,Occupancy rating -1 or less,9,5,3,2,4,0,1,0,1,0,3,1,2,0,0,0,0,0
S01009159,All households,250,99,30,69,144,9,70,29,26,15,65,45,20,7,2,0,0,5
S01009159,Occupancy rating +2 or more,26,9,4,5,16,4,10,8,0,2,2,1,1,1,0,0,0,1
S01009159,Occupancy rating +1,107,58,15,43,48,4,35,18,9,8,9,4,5,1,0,0,0,1
S01009159,Occupancy rating 0,90,26,10,16,60,1,17,1,13,3,42,33,9,4,1,0,0,3
S01009159,Occupancy rating -1 or less,27,6,1,5,20,0,8,2,4,2,12,7,5,1,1,0,0,0
S01009160,All households,327,146,32,114,170,24,114,64,34,16,32,24,8,11,4,0,0,7
S01009160,Occupancy rating +2 or more,71,19,9,10,50,13,35,22,9,4,2,2,0,2,2,0,0,0
S01009160,Occupancy rating +1,92,48,15,33,44,8,31,19,6,6,5,3,2,0,0,0,0,0
S01009160,Occupancy rating 0,125,63,5,58,59,1,37,15,16,6,21,17,4,3,0,0,0,3
S01009160,Occupancy rating -1 or less,39,16,3,13,17,2,11,8,3,0,4,2,2,6,2,0,0,4
S01009161,All households,349,158,65,93,179,25,95,50,35,10,59,41,18,12,0,0,3,9
S01009161,Occupancy rating +2 or more,45,22,7,15,22,4,16,11,1,4,2,1,1,1,0,0,1,0
S01009161,Occupancy rating +1,160,91,36,55,66,14,38,25,9,4,14,8,6,3,0,0,1,2
S01009161,Occupancy rating 0,113,38,20,18,71,7,28,8,19,1,36,25,11,4,0,0,0,4
S01009161,Occupancy rating -1 or less,31,7,2,5,20,0,13,6,6,1,7,7,0,4,0,0,1,3
S01009162,All households,436,249,70,179,167,18,122,81,31,10,27,15,12,20,5,0,3,12
S01009162,Occupancy rating +2 or more,79,34,15,19,42,6,34,28,3,3,2,1,1,3,0,0,0,3
S01009162,Occupancy rating +1,173,105,33,72,64,9,47,40,5,2,8,5,3,4,1,0,1,2
S01009162,Occupancy rating 0,138,87,16,71,44,3,30,11,16,3,11,6,5,7,0,0,1,6
S01009162,Occupancy rating -1 or less,46,23,6,17,17,0,11,2,7,2,6,3,3,6,4,0,1,1
S01009163,All households,233,100,41,59,118,22,77,43,23,11,19,12,7,15,4,0,2,9
S01009163,Occupancy rating +2 or more,108,40,23,17,63,17,46,31,12,3,0,0,0,5,2,0,0,3
S01009163,Occupancy rating +1,71,39,13,26,29,5,18,8,6,4,6,4,2,3,0,0,2,1
S01009163,Occupancy rating 0,39,16,5,11,19,0,11,3,4,4,8,6,2,4,0,0,0,4
S01009163,Occupancy rating -1 or less,15,5,0,5,7,0,2,1,1,0,5,2,3,3,2,0,0,1
S01009164,All households,307,71,38,33,225,26,149,49,73,27,50,32,18,11,1,0,1,9
S01009164,Occupancy rating +2 or more,106,38,19,19,66,18,44,35,6,3,4,2,2,2,0,0,0,2
S01009164,Occupancy rating +1,106,28,16,12,75,7,54,12,29,13,14,8,6,3,0,0,0,3
S01009164,Occupancy rating 0,77,3,2,1,69,1,43,2,30,11,25,17,8,5,0,0,1,4
S01009164,Occupancy rating -1 or less,18,2,1,1,15,0,8,0,8,0,7,5,2,1,1,0,0,0
S01009165,All households,324,106,33,73,197,24,116,50,43,23,57,31,26,21,10,0,1,10
S01009165,Occupancy rating +2 or more,90,39,10,29,49,12,31,26,4,1,6,4,2,2,0,0,0,2
S01009165,Occupancy rating +1,131,45,16,29,81,9,52,19,24,9,20,7,13,5,1,0,1,3
S01009165,Occupancy rating 0,81,15,7,8,57,2,29,5,12,12,26,17,9,9,5,0,0,4
S01009165,Occupancy rating -1 or less,22,7,0,7,10,1,4,0,3,1,5,3,2,5,4,0,0,1
S01009166,All households,399,147,53,94,235,20,139,65,54,20,76,47,29,17,4,0,0,13
S01009166,Occupancy rating +2 or more,81,30,11,19,47,11,31,24,5,2,5,3,2,4,0,0,0,4
S01009166,Occupancy rating +1,165,84,28,56,77,5,59,35,17,7,13,4,9,4,1,0,0,3
S01009166,Occupancy rating 0,112,22,11,11,83,4,34,5,21,8,45,31,14,7,1,0,0,6
S01009166,Occupancy rating -1 or less,41,11,3,8,28,0,15,1,11,3,13,9,4,2,2,0,0,0
S01009167,All households,198,35,17,18,151,15,93,30,42,21,43,26,17,12,7,0,0,5
S01009167,Occupancy rating +2 or more,59,20,9,11,38,9,26,21,4,1,3,1,2,1,1,0,0,0
S01009167,Occupancy rating +1,55,9,5,4,43,4,27,5,14,8,12,6,6,3,1,0,0,2
S01009167,Occupancy rating 0,60,6,3,3,51,2,31,3,19,9,18,12,6,3,3,0,0,0
S01009167,Occupancy rating -1 or less,24,0,0,0,19,0,9,1,5,3,10,7,3,5,2,0,0,3
S01009168,All households,297,94,40,54,195,46,135,63,48,24,14,4,10,8,3,0,2,3
S01009168,Occupancy rating +2 or more,146,31,18,13,115,39,73,40,24,9,3,2,1,0,0,0,0,0
S01009168,Occupancy rating +1,79,31,16,15,45,6,33,13,12,8,6,2,4,3,1,0,1,1
S01009168,Occupancy rating 0,51,22,5,17,25,1,20,7,8,5,4,0,4,4,1,0,1,2
S01009168,Occupancy rating -1 or less,21,10,1,9,10,0,9,3,4,2,1,0,1,1,1,0,0,0
S01009169,All households,420,207,149,58,198,51,103,48,31,24,44,22,22,15,3,0,3,9
S01009169,Occupancy rating +2 or more,118,50,30,20,67,21,43,28,11,4,3,2,1,1,0,0,0,1
S01009169,Occupancy rating +1,165,85,58,27,76,23,37,15,12,10,16,7,9,4,0,0,2,2
S01009169,Occupancy rating 0,104,56,46,10,42,5,16,3,5,8,21,11,10,6,2,0,1,3
S01009169,Occupancy rating -1 or less,33,16,15,1,13,2,7,2,3,2,4,2,2,4,1,0,0,3
S01009170,All households,282,67,21,46,206,15,145,60,62,23,46,32,14,9,5,1,0,3
S01009170,Occupancy rating +2 or more,79,21,7,14,57,8,44,32,10,2,5,3,2,1,1,0,0,0
S01009170,Occupancy rating +1,111,39,11,28,70,7,48,23,14,11,15,10,5,2,0,0,0,2
S01009170,Occupancy rating 0,64,4,1,3,56,0,39,5,26,8,17,12,5,4,3,1,0,0
S01009170,Occupancy rating -1 or less,28,3,2,1,23,0,14,0,12,2,9,7,2,2,1,0,0,1
S01009171,All households,297,98,16,82,186,12,136,47,63,26,38,26,12,13,6,0,1,6
S01009171,Occupancy rating +2 or more,91,22,5,17,67,11,55,29,17,9,1,0,1,2,1,0,0,1
S01009171,Occupancy rating +1,102,45,8,37,54,1,39,13,18,8,14,11,3,3,0,0,1,2
S01009171,Occupancy rating 0,92,27,3,24,57,0,35,5,23,7,22,15,7,8,5,0,0,3
S01009171,Occupancy rating -1 or less,12,4,0,4,8,0,7,0,5,2,1,0,1,0,0,0,0,0
S01009172,All households,288,83,39,44,198,28,164,69,74,21,6,2,4,7,3,0,1,3
S01009172,Occupancy rating +2 or more,204,40,23,17,161,27,130,54,62,14,4,2,2,3,3,0,0,0
S01009172,Occupancy rating +1,62,32,14,18,28,1,26,12,9,5,1,0,1,2,0,0,1,1
S01009172,Occupancy rating 0,16,7,1,6,7,0,6,1,3,2,1,0,1,2,0,0,0,2
S01009172,Occupancy rating -1 or less,6,4,1,3,2,0,2,2,0,0,0,0,0,0,0,0,0,0
S01009173,All households,309,60,28,32,243,32,184,76,74,34,27,17,10,6,3,0,0,3
S01009173,Occupancy rating +2 or more,209,37,17,20,168,28,132,61,53,18,8,5,3,4,2,0,0,2
S01009173,Occupancy rating +1,59,18,8,10,40,4,32,12,12,8,4,2,2,1,0,0,0,1
S01009173,Occupancy rating 0,31,3,3,0,27,0,16,3,6,7,11,8,3,1,1,0,0,0
S01009173,Occupancy rating -1 or less,10,2,0,2,8,0,4,0,3,1,4,2,2,0,0,0,0,0
S01009174,All households,162,17,3,14,139,2,134,35,88,11,3,3,0,6,3,0,0,3
S01009174,Occupancy rating +2 or more,142,16,3,13,124,2,121,33,79,9,1,1,0,2,2,0,0,0
S01009174,Occupancy rating +1,12,1,0,1,10,0,8,1,5,2,2,2,0,1,0,0,0,1
S01009174,Occupancy rating 0,5,0,0,0,5,0,5,1,4,0,0,0,0,0,0,0,0,0
S01009174,Occupancy rating -1 or less,3,0,0,0,0,0,0,0,0,0,0,0,0,3,1,0,0,2
S01009175,All households,300,40,3,37,253,9,222,71,116,35,22,18,4,7,4,0,0,3
S01009175,Occupancy rating +2 or more,230,26,2,24,199,9,175,65,82,28,15,12,3,5,3,0,0,2
S01009175,Occupancy rating +1,54,13,0,13,41,0,36,6,25,5,5,5,0,0,0,0,0,0
S01009175,Occupancy rating 0,15,1,1,0,13,0,11,0,9,2,2,1,1,1,0,0,0,1
S01009175,Occupancy rating -1 or less,1,0,0,0,0,0,0,0,0,0,0,0,0,1,1,0,0,0
S01009176,All households,400,97,61,36,292,63,210,66,107,37,19,7,12,11,5,0,1,5
S01009176,Occupancy rating +2 or more,345,84,52,32,251,58,180,60,90,30,13,6,7,10,5,0,1,4
S01009176,Occupancy rating +1,45,13,9,4,32,5,24,6,14,4,3,0,3,0,0,0,0,0
S01009176,Occupancy rating 0,7,0,0,0,6,0,4,0,2,2,2,0,2,1,0,0,0,1
S01009176,Occupancy rating -1 or less,3,0,0,0,3,0,2,0,1,1,1,1,0,0,0,0,0,0
S01009177,All households,367,114,21,93,243,10,160,78,54,28,73,55,18,10,5,0,0,5
S01009177,Occupancy rating +2 or more,100,32,6,26,66,4,57,46,6,5,5,2,3,2,2,0,0,0
S01009177,Occupancy rating +1,137,62,9,53,73,6,49,22,15,12,18,8,10,2,1,0,0,1
S01009177,Occupancy rating 0,103,17,5,12,83,0,43,9,24,10,40,36,4,3,0,0,0,3
S01009177,Occupancy rating -1 or less,27,3,1,2,21,0,11,1,9,1,10,9,1,3,2,0,0,1
S01009178,All households,320,94,17,77,209,10,124,48,56,20,75,58,17,17,8,0,0,9
S01009178,Occupancy rating +2 or more,64,21,4,17,43,8,31,23,4,4,4,3,1,0,0,0,0,0
S01009178,Occupancy rating +1,113,53,8,45,57,2,45,24,15,6,10,5,5,3,0,0,0,3
S01009178,Occupancy rating 0,105,14,3,11,83,0,36,1,28,7,47,38,9,8,3,0,0,5
S01009178,Occupancy rating -1 or less,38,6,2,4,26,0,12,0,9,3,14,12,2,6,5,0,0,1
S01009179,All households,273,63,15,48,197,16,141,56,55,30,40,28,12,13,5,0,0,8
S01009179,Occupancy rating +2 or more,103,26,5,21,74,12,60,44,11,5,2,1,1,3,0,0,0,3
S01009179,Occupancy rating +1,96,28,6,22,66,4,47,10,19,18,15,10,5,2,0,0,0,2
S01009179,Occupancy rating 0,60,8,3,5,47,0,30,2,21,7,17,12,5,5,2,0,0,3
S01009179,Occupancy rating -1 or less,14,1,1,0,10,0,4,0,4,0,6,5,1,3,3,0,0,0
S01009180,All households,437,133,43,90,284,35,185,70,76,39,64,40,24,20,7,0,2,11
S01009180,Occupancy rating +2 or more,108,21,4,17,85,14,65,45,14,6,6,4,2,2,1,0,0,1
S01009180,Occupancy rating +1,180,88,28,60,88,16,59,22,21,16,13,4,9,4,2,0,0,2
S01009180,Occupancy rating 0,111,20,8,12,82,1,48,1,32,15,33,21,12,9,1,0,1,7
S01009180,Occupancy rating -1 or less,38,4,3,1,29,4,13,2,9,2,12,11,1,5,3,0,1,1
S01009181,All households,361,100,47,53,243,39,162,60,70,32,42,35,7,18,9,0,1,8
S01009181,Occupancy rating +2 or more,142,44,18,26,97,29,66,41,17,8,2,2,0,1,0,0,0,1
S01009181,Occupancy rating +1,102,34,18,16,65,7,47,14,20,13,11,8,3,3,2,0,0,1
S01009181,Occupancy rating 0,95,20,9,11,65,1,43,5,28,10,21,17,4,10,5,0,1,4
S01009181,Occupancy rating -1 or less,22,2,2,0,16,2,6,0,5,1,8,8,0,4,2,0,0,2
S01009182,All households,419,108,40,68,295,30,223,90,107,26,42,28,14,16,6,0,0,10
S01009182,Occupancy rating +2 or more,185,33,8,25,143,16,118,62,47,9,9,5,4,9,3,0,0,6
S01009182,Occupancy rating +1,153,56,26,30,93,12,66,24,35,7,15,9,6,4,1,0,0,3
S01009182,Occupancy rating 0,71,19,6,13,51,1,34,3,22,9,16,12,4,1,0,0,0,1
S01009182,Occupancy rating -1 or less,10,0,0,0,8,1,5,1,3,1,2,2,0,2,2,0,0,0
S01009183,All households,267,36,13,23,220,12,186,70,74,42,22,16,6,11,5,0,0,6
S01009183,Occupancy rating +2 or more,194,19,8,11,171,11,144,60,54,30,16,14,2,4,2,0,0,2
S01009183,Occupancy rating +1,48,15,4,11,31,1,27,8,11,8,3,1,2,2,0,0,0,2
S01009183,Occupancy rating 0,16,2,1,1,10,0,9,2,5,2,1,0,1,4,2,0,0,2
S01009183,Occupancy rating -1 or less,9,0,0,0,8,0,6,0,4,2,2,1,1,1,1,0,0,0
S01009184,All households,376,113,48,65,248,35,165,69,67,29,48,35,13,15,9,0,0,6
S01009184,Occupancy rating +2 or more,136,39,21,18,88,18,64,37,20,7,6,4,2,9,6,0,0,3
S01009184,Occupancy rating +1,122,41,14,27,78,12,52,23,19,10,14,9,5,3,1,0,0,2
S01009184,Occupancy rating 0,86,25,11,14,60,4,35,7,20,8,21,16,5,1,1,0,0,0
S01009184,Occupancy rating -1 or less,32,8,2,6,22,1,14,2,8,4,7,6,1,2,1,0,0,1
S01009185,All households,354,92,44,48,239,21,166,61,68,37,52,38,14,23,7,0,1,15
S01009185,Occupancy rating +2 or more,135,49,25,24,81,14,65,40,16,9,2,1,1,5,1,0,0,4
S01009185,Occupancy rating +1,128,33,14,19,89,5,61,18,25,18,23,15,8,6,0,0,1,5
S01009185,Occupancy rating 0,63,6,3,3,51,1,33,2,23,8,17,14,3,6,3,0,0,3
S01009185,Occupancy rating -1 or less,28,4,2,2,18,1,7,1,4,2,10,8,2,6,3,0,0,3
S01009186,All households,312,69,30,39,226,31,158,57,66,35,37,20,17,17,8,0,1,8
S01009186,Occupancy rating +2 or more,156,36,15,21,116,24,87,42,31,14,5,1,4,4,3,0,0,1
S01009186,Occupancy rating +1,66,18,5,13,43,4,27,12,8,7,12,8,4,5,2,0,1,2
S01009186,Occupancy rating 0,66,11,8,3,50,2,33,2,20,11,15,8,7,5,0,0,0,5
S01009186,Occupancy rating -1 or less,24,4,2,2,17,1,11,1,7,3,5,3,2,3,3,0,0,0
S01009187,All households,215,51,21,30,151,24,114,56,46,12,13,9,4,13,6,0,0,7
S01009187,Occupancy rating +2 or more,142,38,14,24,99,12,85,46,28,11,2,1,1,5,1,0,0,4
S01009187,Occupancy rating +1,38,11,5,6,26,7,15,9,6,0,4,3,1,1,0,0,0,1
S01009187,Occupancy rating 0,28,1,1,0,23,4,12,0,11,1,7,5,2,4,3,0,0,1
S01009187,Occupancy rating -1 or less,7,1,1,0,3,1,2,1,1,0,0,0,0,3,2,0,0,1
S01009188,All households,383,102,46,56,265,26,186,92,66,28,53,36,17,16,9,0,0,7
S01009188,Occupancy rating +2 or more,186,40,17,23,139,20,109,64,31,14,10,4,6,7,3,0,0,4
S01009188,Occupancy rating +1,109,44,18,26,64,4,45,19,18,8,15,10,5,1,1,0,0,0
S01009188,Occupancy rating 0,73,15,9,6,54,2,29,8,16,5,23,19,4,4,1,0,0,3
S01009188,Occupancy rating -1 or less,15,3,2,1,8,0,3,1,1,1,5,3,2,4,4,0,0,0
S01009189,All households,336,113,51,62,214,23,149,54,64,31,42,29,13,9,5,0,0,4
S01009189,Occupancy rating +2 or more,101,43,25,18,57,14,42,34,6,2,1,0,1,1,0,0,0,1
S01009189,Occupancy rating +1,124,48,21,27,73,6,52,18,20,14,15,10,5,3,2,0,0,1
S01009189,Occupancy rating 0,93,19,3,16,70,3,42,2,28,12,25,18,7,4,2,0,0,2
S01009189,Occupancy rating -1 or less,18,3,2,1,14,0,13,0,10,3,1,1,0,1,1,0,0,0
S01009190,All households,309,54,18,36,244,18,210,88,100,22,16,12,4,11,6,0,1,4
S01009190,Occupancy rating +2 or more,203,28,11,17,170,14,148,72,62,14,8,6,2,5,2,0,0,3
S01009190,Occupancy rating +1,71,19,5,14,48,1,46,13,29,4,1,1,0,4,2,0,1,1
S01009190,Occupancy rating 0,29,5,2,3,23,3,14,3,8,3,6,5,1,1,1,0,0,0
S01009190,Occupancy rating -1 or less,6,2,0,2,3,0,2,0,1,1,1,0,1,1,1,0,0,0
S01009191,All households,229,18,1,17,203,2,183,38,129,16,18,15,3,8,5,0,0,3
S01009191,Occupancy rating +2 or more,198,10,1,9,184,2,170,34,120,16,12,9,3,4,2,0,0,2
S01009191,Occupancy rating +1,20,8,0,8,11,0,8,4,4,0,3,3,0,1,1,0,0,0
S01009191,Occupancy rating 0,5,0,0,0,5,0,2,0,2,0,3,3,0,0,0,0,0,0
S01009191,Occupancy rating -1 or less,6,0,0,0,3,0,3,0,3,0,0,0,0,3,2,0,0,1
S01009192,All households,258,55,30,25,195,37,141,53,66,22,17,13,4,8,3,0,0,5
S01009192,Occupancy rating +2 or more,149,32,22,10,115,33,78,39,30,9,4,2,2,2,0,0,0,2
S01009192,Occupancy rating +1,71,18,5,13,49,3,38,11,20,7,8,6,2,4,2,0,0,2
S01009192,Occupancy rating 0,24,1,0,1,22,1,18,2,13,3,3,3,0,1,0,0,0,1
S01009192,Occupancy rating -1 or less,14,4,3,1,9,0,7,1,3,3,2,2,0,1,1,0,0,0
S01009193,All households,127,31,1,30,94,2,88,38,43,7,4,3,1,2,0,0,0,2
S01009193,Occupancy rating +2 or more,90,24,1,23,65,2,62,36,21,5,1,1,0,1,0,0,0,1
S01009193,Occupancy rating +1,28,5,0,5,22,0,20,2,16,2,2,2,0,1,0,0,0,1
S01009193,Occupancy rating 0,5,1,0,1,4,0,3,0,3,0,1,0,1,0,0,0,0,0
S01009193,Occupancy rating -1 or less,4,1,0,1,3,0,3,0,3,0,0,0,0,0,0,0,0,0
S01009194,All households,323,50,25,25,264,41,203,98,75,30,20,12,8,9,5,0,2,2
S01009194,Occupancy rating +2 or more,262,41,21,20,217,38,169,93,55,21,10,7,3,4,1,0,1,2
S01009194,Occupancy rating +1,43,7,3,4,32,3,22,4,11,7,7,4,3,4,3,0,1,0
S01009194,Occupancy rating 0,14,2,1,1,12,0,11,1,8,2,1,0,1,0,0,0,0,0
S01009194,Occupancy rating -1 or less,4,0,0,0,3,0,1,0,1,0,2,1,1,1,1,0,0,0
S01009195,All households,353,90,26,64,255,25,212,75,123,14,18,14,4,8,3,0,1,4
S01009195,Occupancy rating +2 or more,176,28,8,20,144,10,130,39,81,10,4,4,0,4,2,0,0,2
S01009195,Occupancy rating +1,138,61,18,43,75,14,59,35,21,3,2,2,0,2,0,0,1,1
S01009195,Occupancy rating 0,35,0,0,0,34,1,21,0,20,1,12,8,4,1,0,0,0,1
S01009195,Occupancy rating -1 or less,4,1,0,1,2,0,2,1,1,0,0,0,0,1,1,0,0,0
S01009196,All households,298,89,61,28,195,24,141,52,60,29,30,17,13,14,5,0,0,9
S01009196,Occupancy rating +2 or more,145,44,32,12,97,20,71,36,25,10,6,2,4,4,1,0,0,3
S01009196,Occupancy rating +1,89,30,21,9,55,3,41,13,16,12,11,5,6,4,1,0,0,3
S01009196,Occupancy rating 0,51,12,6,6,37,1,25,3,16,6,11,8,3,2,0,0,0,2
S01009196,Occupancy rating -1 or less,13,3,2,1,6,0,4,0,3,1,2,2,0,4,3,0,0,1
S01009197,All households,401,69,30,39,321,30,260,98,134,28,31,22,9,11,3,0,2,6
S01009197,Occupancy rating +2 or more,268,33,12,21,226,23,191,77,95,19,12,10,2,9,2,0,2,5
S01009197,Occupancy rating +1,75,20,8,12,55,5,40,18,16,6,10,7,3,0,0,0,0,0
S01009197,Occupancy rating 0,47,15,9,6,31,2,22,3,16,3,7,5,2,1,0,0,0,1
S01009197,Occupancy rating -1 or less,11,1,1,0,9,0,7,0,7,0,2,0,2,1,1,0,0,0
S01009198,All households,306,72,38,34,227,35,167,64,72,31,25,15,10,7,3,0,0,4
S01009198,Occupancy rating +2 or more,193,43,21,22,146,30,109,50,43,16,7,4,3,4,2,0,0,2
S01009198,Occupancy rating +1,65,18,11,7,47,5,34,11,14,9,8,2,6,0,0,0,0,0
S01009198,Occupancy rating 0,38,8,6,2,30,0,21,3,14,4,9,9,0,0,0,0,0,0
S01009198,Occupancy rating -1 or less,10,3,0,3,4,0,3,0,1,2,1,0,1,3,1,0,0,2
S01009199,All households,248,59,29,30,183,19,138,49,71,18,26,12,14,6,2,0,1,3
S01009199,Occupancy rating +2 or more,146,18,4,14,126,14,102,35,57,10,10,7,3,2,0,0,1,1
S01009199,Occupancy rating +1,64,35,23,12,28,5,21,13,3,5,2,1,1,1,1,0,0,0
S01009199,Occupancy rating 0,33,4,1,3,27,0,14,1,10,3,13,3,10,2,0,0,0,2
S01009199,Occupancy rating -1 or less,5,2,1,1,2,0,1,0,1,0,1,1,0,1,1,0,0,0
S01009200,All households,439,80,33,47,349,43,275,108,137,30,31,26,5,10,6,0,1,3
S01009200,Occupancy rating +2 or more,324,47,23,24,268,35,222,89,112,21,11,11,0,9,5,0,1,3
S01009200,Occupancy rating +1,67,25,6,19,42,4,37,19,14,4,1,0,1,0,0,0,0,0
S01009200,Occupancy rating 0,38,5,2,3,33,4,13,0,9,4,16,13,3,0,0,0,0,0
S01009200,Occupancy rating -1 or less,10,3,2,1,6,0,3,0,2,1,3,2,1,1,1,0,0,0
S01009201,All households,268,72,15,57,185,10,131,60,52,19,44,32,12,11,4,0,0,7
S01009201,Occupancy rating +2 or more,86,23,10,13,61,7,51,35,9,7,3,2,1,2,1,0,0,1
S01009201,Occupancy rating +1,83,30,4,26,50,3,39,19,14,6,8,4,4,3,1,0,0,2
S01009201,Occupancy rating 0,82,18,1,17,59,0,34,4,24,6,25,21,4,5,1,0,0,4
S01009201,Occupancy rating -1 or less,17,1,0,1,15,0,7,2,5,0,8,5,3,1,1,0,0,0
S01009202,All households,190,28,14,14,159,21,129,45,68,16,9,8,1,3,1,0,0,2
S01009202,Occupancy rating +2 or more,139,14,6,8,123,16,102,42,49,11,5,4,1,2,1,0,0,1
S01009202,Occupancy rating +1,40,13,8,5,27,5,20,2,15,3,2,2,0,0,0,0,0,0
S01009202,Occupancy rating 0,10,1,0,1,8,0,7,1,4,2,1,1,0,1,0,0,0,1
S01009202,Occupancy rating -1 or less,1,0,0,0,1,0,0,0,0,0,1,1,0,0,0,0,0,0
S01009203,All households,269,80,40,40,176,22,106,42,44,20,48,32,16,13,8,0,0,5
S01009203,Occupancy rating +2 or more,86,34,17,17,52,15,35,22,6,7,2,2,0,0,0,0,0,0
S01009203,Occupancy rating +1,84,30,11,19,52,5,36,18,13,5,11,8,3,2,1,0,0,1
S01009203,Occupancy rating 0,84,13,10,3,65,2,30,2,22,6,33,20,13,6,3,0,0,3
S01009203,Occupancy rating -1 or less,15,3,2,1,7,0,5,0,3,2,2,2,0,5,4,0,0,1
S01009204,All households,343,68,20,48,255,15,169,70,73,26,71,49,22,20,12,0,1,7
S01009204,Occupancy rating +2 or more,150,31,10,21,112,11,90,48,33,9,11,9,2,7,3,0,0,4
S01009204,Occupancy rating +1,97,27,9,18,67,4,43,16,12,15,20,12,8,3,1,0,0,2
S01009204,Occupancy rating 0,63,7,1,6,52,0,20,4,15,1,32,20,12,4,2,0,1,1
S01009204,Occupancy rating -1 or less,33,3,0,3,24,0,16,2,13,1,8,8,0,6,6,0,0,0
S01009205,All households,307,88,21,67,212,12,183,82,60,41,17,8,9,7,1,0,0,6
S01009205,Occupancy rating +2 or more,165,30,12,18,135,9,118,61,29,28,8,4,4,0,0,0,0,0
S01009205,Occupancy rating +1,106,52,7,45,52,3,44,19,17,8,5,1,4,2,1,0,0,1
S01009205,Occupancy rating 0,29,3,2,1,21,0,19,2,13,4,2,2,0,5,0,0,0,5
S01009205,Occupancy rating -1 or less,7,3,0,3,4,0,2,0,1,1,2,1,1,0,0,0,0,0
S01009206,All households,362,106,21,85,252,19,215,94,83,38,18,8,10,4,0,0,0,4
S01009206,Occupancy rating +2 or more,194,32,13,19,162,17,141,60,56,25,4,2,2,0,0,0,0,0
S01009206,Occupancy rating +1,110,54,7,47,55,2,46,22,17,7,7,1,6,1,0,0,0,1
S01009206,Occupancy rating 0,41,16,1,15,23,0,18,5,9,4,5,4,1,2,0,0,0,2
S01009206,Occupancy rating -1 or less,17,4,0,4,12,0,10,7,1,2,2,1,1,1,0,0,0,1
S01009207,All households,375,121,40,81,249,50,186,107,47,32,13,6,7,5,2,0,0,3
S01009207,Occupancy rating +2 or more,211,41,22,19,168,41,126,75,28,23,1,1,0,2,1,0,0,1
S01009207,Occupancy rating +1,82,28,10,18,53,7,41,26,10,5,5,2,3,1,0,0,0,1
S01009207,Occupancy rating 0,58,32,8,24,24,1,17,6,8,3,6,2,4,2,1,0,0,1
S01009207,Occupancy rating -1 or less,24,20,0,20,4,1,2,0,1,1,1,1,0,0,0,0,0,0
S01009208,All households,294,101,55,46,180,38,128,58,52,18,14,8,6,13,4,1,1,7
S01009208,Occupancy rating +2 or more,175,48,33,15,123,34,86,44,31,11,3,2,1,4,2,0,0,2
S01009208,Occupancy rating +1,61,29,13,16,28,3,22,11,8,3,3,1,2,4,1,0,1,2
S01009208,Occupancy rating 0,46,18,9,9,25,1,16,2,10,4,8,5,3,3,0,1,0,2
S01009208,Occupancy rating -1 or less,12,6,0,6,4,0,4,1,3,0,0,0,0,2,1,0,0,1
S01009209,All households,304,115,51,64,177,41,119,63,35,21,17,11,6,12,3,0,1,8
S01009209,Occupancy rating +2 or more,166,40,22,18,123,32,88,51,21,16,3,2,1,3,1,0,0,2
S01009209,Occupancy rating +1,86,52,21,31,31,5,21,10,8,3,5,3,2,3,1,0,1,1
S01009209,Occupancy rating 0,39,19,6,13,18,3,8,2,4,2,7,5,2,2,0,0,0,2
S01009209,Occupancy rating -1 or less,13,4,2,2,5,1,2,0,2,0,2,1,1,4,1,0,0,3
S01009210,All households,234,41,22,19,184,27,138,66,53,19,19,9,10,9,1,0,1,7
S01009210,Occupancy rating +2 or more,151,19,10,9,128,19,102,55,33,14,7,2,5,4,0,0,0,4
S01009210,Occupancy rating +1,51,17,10,7,32,8,23,10,10,3,1,1,0,2,1,0,0,1
S01009210,Occupancy rating 0,26,3,1,2,20,0,10,1,7,2,10,5,5,3,0,0,1,2
S01009210,Occupancy rating -1 or less,6,2,1,1,4,0,3,0,3,0,1,1,0,0,0,0,0,0
S01009211,All households,259,59,19,40,181,18,130,58,54,18,33,27,6,19,6,0,0,13
S01009211,Occupancy rating +2 or more,121,26,12,14,93,14,71,39,22,10,8,6,2,2,1,0,0,1
S01009211,Occupancy rating +1,70,32,7,25,37,3,29,19,6,4,5,3,2,1,0,0,0,1
S01009211,Occupancy rating 0,56,1,0,1,40,0,24,0,20,4,16,14,2,15,5,0,0,10
S01009211,Occupancy rating -1 or less,12,0,0,0,11,1,6,0,6,0,4,4,0,1,0,0,0,1
S01009212,All households,363,101,49,52,245,44,153,67,55,31,48,30,18,17,7,0,2,8
S01009212,Occupancy rating +2 or more,109,30,14,16,76,23,50,34,10,6,3,2,1,3,1,0,0,2
S01009212,Occupancy rating +1,126,43,17,26,80,17,51,29,12,10,12,4,8,3,0,0,1,2
S01009212,Occupancy rating 0,99,22,15,7,71,4,40,4,24,12,27,20,7,6,3,0,0,3
S01009212,Occupancy rating -1 or less,29,6,3,3,18,0,12,0,9,3,6,4,2,5,3,0,1,1
S01009213,All households,355,105,51,54,229,15,161,52,73,36,53,33,20,21,3,0,2,16
S01009213,Occupancy rating +2 or more,110,42,22,20,65,12,49,26,15,8,4,2,2,3,0,0,0,3
S01009213,Occupancy rating +1,112,38,13,25,68,3,51,23,16,12,14,8,6,6,0,0,2,4
S01009213,Occupancy rating 0,101,21,15,6,71,0,43,1,35,7,28,19,9,9,1,0,0,8
S01009213,Occupancy rating -1 or less,32,4,1,3,25,0,18,2,7,9,7,4,3,3,2,0,0,1
S01009214,All households,397,85,36,49,301,31,235,95,98,42,35,21,14,11,5,0,0,6
S01009214,Occupancy rating +2 or more,241,49,18,31,190,22,156,82,54,20,12,7,5,2,1,0,0,1
S01009214,Occupancy rating +1,91,25,11,14,62,8,44,11,21,12,10,7,3,4,1,0,0,3
S01009214,Occupancy rating 0,58,11,7,4,44,1,31,2,20,9,12,7,5,3,1,0,0,2
S01009214,Occupancy rating -1 or less,7,0,0,0,5,0,4,0,3,1,1,0,1,2,2,0,0,0
S01009215,All households,439,160,69,91,262,34,178,80,73,25,50,31,19,17,6,1,1,9
S01009215,Occupancy rating +2 or more,151,43,25,18,103,21,80,52,18,10,2,1,1,5,1,0,1,3
S01009215,Occupancy rating +1,132,55,19,36,73,8,51,21,21,9,14,8,6,4,2,0,0,2
S01009215,Occupancy rating 0,134,56,21,35,71,5,40,6,29,5,26,17,9,7,2,1,0,4
S01009215,Occupancy rating -1 or less,22,6,4,2,15,0,7,1,5,1,8,5,3,1,1,0,0,0
S01009216,All households,397,114,53,61,273,29,190,90,64,36,54,27,27,10,3,0,0,7
S01009216,Occupancy rating +2 or more,158,42,20,22,115,20,92,62,18,12,3,0,3,1,0,0,0,1
S01009216,Occupancy rating +1,114,40,16,24,73,9,47,24,11,12,17,5,12,1,0,0,0,1
S01009216,Occupancy rating 0,90,27,13,14,60,0,37,3,22,12,23,13,10,3,0,0,0,3
S01009216,Occupancy rating -1 or less,35,5,4,1,25,0,14,1,13,0,11,9,2,5,3,0,0,2
S01009217,All households,279,91,29,62,173,11,96,44,34,18,66,50,16,15,8,0,0,7
S01009217,Occupancy rating +2 or more,54,24,12,12,29,4,22,19,3,0,3,1,2,1,1,0,0,0
S01009217,Occupancy rating +1,105,51,13,38,46,4,31,19,7,5,11,11,0,8,4,0,0,4
S01009217,Occupancy rating 0,87,12,3,9,72,0,32,5,20,7,40,29,11,3,0,0,0,3
S01009217,Occupancy rating -1 or less,33,4,1,3,26,3,11,1,4,6,12,9,3,3,3,0,0,0
S01009218,All households,395,136,85,51,251,53,165,80,62,23,33,14,19,8,3,0,0,5
S01009218,Occupancy rating +2 or more,160,45,29,16,114,32,77,46,24,7,5,3,2,1,0,0,0,1
S01009218,Occupancy rating +1,150,67,40,27,82,19,54,30,13,11,9,4,5,1,0,0,0,1
S01009218,Occupancy rating 0,61,18,12,6,40,1,24,3,18,3,15,5,10,3,0,0,0,3
S01009218,Occupancy rating -1 or less,24,6,4,2,15,1,10,1,7,2,4,2,2,3,3,0,0,0
S01009219,All households,313,125,59,66,172,28,110,46,42,22,34,20,14,16,4,0,0,12
S01009219,Occupancy rating +2 or more,44,15,10,5,28,9,17,12,3,2,2,1,1,1,0,0,0,1
S01009219,Occupancy rating +1,175,96,43,53,74,19,49,32,14,3,6,2,4,5,1,0,0,4
S01009219,Occupancy rating 0,71,7,2,5,57,0,34,1,22,11,23,15,8,7,1,0,0,6
S01009219,Occupancy rating -1 or less,23,7,4,3,13,0,10,1,3,6,3,2,1,3,2,0,0,1
S01009220,All households,264,83,41,42,168,31,85,41,33,11,52,34,18,13,4,0,0,9
S01009220,Occupancy rating +2 or more,94,30,18,12,60,21,34,21,10,3,5,3,2,4,1,0,0,3
S01009220,Occupancy rating +1,89,39,16,23,48,8,31,18,10,3,9,3,6,2,1,0,0,1
S01009220,Occupancy rating 0,72,13,7,6,53,2,16,1,11,4,35,26,9,6,1,0,0,5
S01009220,Occupancy rating -1 or less,9,1,0,1,7,0,4,1,2,1,3,2,1,1,1,0,0,0
S01009221,All households,239,69,40,29,158,23,112,41,47,24,23,16,7,12,6,0,0,6
S01009221,Occupancy rating +2 or more,54,17,13,4,36,10,24,19,5,0,2,0,2,1,0,0,0,1
S01009221,Occupancy rating +1,112,43,21,22,66,12,47,22,13,12,7,3,4,3,1,0,0,2
S01009221,Occupancy rating 0,53,7,4,3,42,0,31,0,23,8,11,10,1,4,3,0,0,1
S01009221,Occupancy rating -1 or less,20,2,2,0,14,1,10,0,6,4,3,3,0,4,2,0,0,2
S01009222,All households,238,80,32,48,148,16,93,37,40,16,39,33,6,10,5,1,0,4
S01009222,Occupancy rating +2 or more,49,20,13,7,28,4,22,20,1,1,2,1,1,1,0,1,0,0
S01009222,Occupancy rating +1,98,48,17,31,47,9,35,16,13,6,3,2,1,3,0,0,0,3
S01009222,Occupancy rating 0,70,11,2,9,58,3,27,1,18,8,28,25,3,1,0,0,0,1
S01009222,Occupancy rating -1 or less,21,1,0,1,15,0,9,0,8,1,6,5,1,5,5,0,0,0
S01009223,All households,244,74,41,33,163,26,107,36,47,24,30,14,16,7,2,0,0,5
S01009223,Occupancy rating +2 or more,75,35,21,14,38,16,20,14,5,1,2,1,1,2,0,0,0,2
S01009223,Occupancy rating +1,105,36,18,18,66,10,45,21,14,10,11,3,8,3,1,0,0,2
S01009223,Occupancy rating 0,57,2,2,0,54,0,38,1,24,13,16,10,6,1,0,0,0,1
S01009223,Occupancy rating -1 or less,7,1,0,1,5,0,4,0,4,0,1,0,1,1,1,0,0,0
S01009224,All households,277,85,39,46,180,15,123,46,52,25,42,21,21,12,4,0,3,5
S01009224,Occupancy rating +2 or more,59,25,15,10,33,4,27,20,7,0,2,2,0,1,0,0,0,1
S01009224,Occupancy rating +1,125,50,21,29,74,11,51,24,13,14,12,6,6,1,0,0,0,1
S01009224,Occupancy rating 0,72,8,2,6,57,0,35,2,26,7,22,9,13,7,2,0,2,3
S01009224,Occupancy rating -1 or less,21,2,1,1,16,0,10,0,6,4,6,4,2,3,2,0,1,0
S01009225,All households,268,108,65,43,153,22,107,53,41,13,24,12,12,7,3,0,0,4
S01009225,Occupancy rating +2 or more,86,35,17,18,50,12,38,24,11,3,0,0,0,1,0,0,0,1
S01009225,Occupancy rating +1,85,33,18,15,50,7,35,25,6,4,8,5,3,2,1,0,0,1
S01009225,Occupancy rating 0,73,28,23,5,42,2,28,4,19,5,12,4,8,3,1,0,0,2
S01009225,Occupancy rating -1 or less,24,12,7,5,11,1,6,0,5,1,4,3,1,1,1,0,0,0
S01009226,All households,507,242,100,142,250,38,169,88,63,18,43,25,18,15,4,0,1,10
S01009226,Occupancy rating +2 or more,84,32,13,19,51,15,35,27,7,1,1,0,1,1,0,0,0,1
S01009226,Occupancy rating +1,229,135,60,75,89,18,66,51,10,5,5,4,1,5,1,0,1,3
S01009226,Occupancy rating 0,167,66,22,44,96,5,57,9,40,8,34,19,15,5,2,0,0,3
S01009226,Occupancy rating -1 or less,27,9,5,4,14,0,11,1,6,4,3,2,1,4,1,0,0,3
S01009227,All households,355,201,114,87,144,26,99,61,27,11,19,13,6,10,6,0,0,4
S01009227,Occupancy rating +2 or more,73,25,19,6,45,6,37,19,13,5,2,1,1,3,2,0,0,1
S01009227,Occupancy rating +1,117,63,29,34,51,12,36,29,4,3,3,2,1,3,1,0,0,2
S01009227,Occupancy rating 0,140,98,58,40,41,7,24,12,9,3,10,8,2,1,1,0,0,0
S01009227,Occupancy rating -1 or less,25,15,8,7,7,1,2,1,1,0,4,2,2,3,2,0,0,1
S01009228,All households,313,149,64,85,157,19,106,48,45,13,32,21,11,7,2,0,0,5
S01009228,Occupancy rating +2 or more,69,23,7,16,45,5,33,19,13,1,7,2,5,1,0,0,0,1
S01009228,Occupancy rating +1,133,69,33,36,63,12,39,23,11,5,12,9,3,1,0,0,0,1
S01009228,Occupancy rating 0,86,44,20,24,39,2,28,6,17,5,9,7,2,3,1,0,0,2
S01009228,Occupancy rating -1 or less,25,13,4,9,10,0,6,0,4,2,4,3,1,2,1,0,0,1
S01009229,All households,293,125,49,76,156,29,101,50,41,10,26,17,9,12,6,1,0,5
S01009229,Occupancy rating +2 or more,94,19,10,9,74,15,56,29,21,6,3,1,2,1,0,0,0,1
S01009229,Occupancy rating +1,92,44,15,29,45,13,27,18,7,2,5,3,2,3,2,0,0,1
S01009229,Occupancy rating 0,89,54,19,35,31,1,15,3,10,2,15,10,5,4,1,1,0,2
S01009229,Occupancy rating -1 or less,18,8,5,3,6,0,3,0,3,0,3,3,0,4,3,0,0,1
S01009230,All households,319,162,30,132,150,17,109,63,41,5,24,19,5,7,1,2,0,4
S01009230,Occupancy rating +2 or more,49,16,7,9,33,4,26,19,7,0,3,2,1,0,0,0,0,0
S01009230,Occupancy rating +1,125,68,13,55,57,12,41,31,8,2,4,2,2,0,0,0,0,0
S01009230,Occupancy rating 0,117,68,9,59,43,1,28,8,17,3,14,12,2,6,1,2,0,3
S01009230,Occupancy rating -1 or less,28,10,1,9,17,0,14,5,9,0,3,3,0,1,0,0,0,1
S01009231,All households,437,136,57,79,287,43,207,94,82,31,37,22,15,14,4,0,0,10
S01009231,Occupancy rating +2 or more,171,40,25,15,127,26,94,48,32,14,7,5,2,4,2,0,0,2
S01009231,Occupancy rating +1,146,54,23,31,88,14,64,31,23,10,10,5,5,4,1,0,0,3
S01009231,Occupancy rating 0,105,40,9,31,62,3,43,15,21,7,16,10,6,3,1,0,0,2
S01009231,Occupancy rating -1 or less,15,2,0,2,10,0,6,0,6,0,4,2,2,3,0,0,0,3
S01009232,All households,309,147,27,120,143,13,74,27,35,12,56,49,7,19,2,1,0,16
S01009232,Occupancy rating +2 or more,40,19,8,11,21,9,10,9,1,0,2,0,2,0,0,0,0,0
S01009232,Occupancy rating +1,144,96,18,78,41,4,31,14,10,7,6,4,2,7,0,0,0,7
S01009232,Occupancy rating 0,95,27,1,26,60,0,24,4,16,4,36,34,2,8,1,1,0,6
S01009232,Occupancy rating -1 or less,30,5,0,5,21,0,9,0,8,1,12,11,1,4,1,0,0,3
S01009233,All households,267,99,58,41,158,34,101,38,40,23,23,7,16,10,3,0,1,6
S01009233,Occupancy rating +2 or more,82,27,17,10,54,24,28,19,6,3,2,0,2,1,0,0,0,1
S01009233,Occupancy rating +1,115,53,31,22,62,9,43,17,19,7,10,3,7,0,0,0,0,0
S01009233,Occupancy rating 0,59,17,10,7,35,1,27,0,15,12,7,1,6,7,3,0,1,3
S01009233,Occupancy rating -1 or less,11,2,0,2,7,0,3,2,0,1,4,3,1,2,0,0,0,2
S01009234,All households,476,179,39,140,274,18,164,56,92,16,92,73,19,23,10,0,0,13
S01009234,Occupancy rating +2 or more,73,26,15,11,47,13,30,16,10,4,4,2,2,0,0,0,0,0
S01009234,Occupancy rating +1,182,100,15,85,80,5,57,37,15,5,18,12,6,2,0,0,0,2
S01009234,Occupancy rating 0,180,45,8,37,122,0,59,3,49,7,63,53,10,13,6,0,0,7
S01009234,Occupancy rating -1 or less,41,8,1,7,25,0,18,0,18,0,7,6,1,8,4,0,0,4
S01009235,All households,457,178,50,128,264,32,168,89,63,16,64,47,17,15,7,1,0,7
S01009235,Occupancy rating +2 or more,121,47,18,29,74,17,52,44,8,0,5,4,1,0,0,0,0,0
S01009235,Occupancy rating +1,173,72,23,49,100,12,68,39,24,5,20,16,4,1,0,0,0,1
S01009235,Occupancy rating 0,119,43,8,35,68,2,34,5,19,10,32,21,11,8,4,1,0,3
S01009235,Occupancy rating -1 or less,44,16,1,15,22,1,14,1,12,1,7,6,1,6,3,0,0,3
S01009236,All households,224,67,43,24,149,30,93,44,34,15,26,10,16,8,0,0,0,8
S01009236,Occupancy rating +2 or more,107,31,23,8,74,23,48,29,14,5,3,1,2,2,0,0,0,2
S01009236,Occupancy rating +1,75,27,16,11,45,7,30,14,10,6,8,4,4,3,0,0,0,3
S01009236,Occupancy rating 0,36,9,4,5,25,0,14,1,10,3,11,3,8,2,0,0,0,2
S01009236,Occupancy rating -1 or less,6,0,0,0,5,0,1,0,0,1,4,2,2,1,0,0,0,1
S01009237,All households,378,118,61,57,253,43,180,80,75,25,30,7,23,7,3,0,1,3
S01009237,Occupancy rating +2 or more,213,51,38,13,158,33,114,49,47,18,11,2,9,4,2,0,0,2
S01009237,Occupancy rating +1,106,48,20,28,57,9,41,22,15,4,7,3,4,1,0,0,1,0
S01009237,Occupancy rating 0,41,11,3,8,28,1,19,8,9,2,8,2,6,2,1,0,0,1
S01009237,Occupancy rating -1 or less,18,8,0,8,10,0,6,1,4,1,4,0,4,0,0,0,0,0
S01009238,All households,335,101,46,55,228,52,132,54,52,26,44,27,17,6,4,0,0,2
S01009238,Occupancy rating +2 or more,115,37,22,15,77,34,42,35,3,4,1,0,1,1,0,0,0,1
S01009238,Occupancy rating +1,117,34,18,16,82,17,50,14,24,12,15,9,6,1,0,0,0,1
S01009238,Occupancy rating 0,71,21,3,18,47,0,29,5,17,7,18,10,8,3,3,0,0,0
S01009238,Occupancy rating -1 or less,32,9,3,6,22,1,11,0,8,3,10,8,2,1,1,0,0,0
S01009239,All households,420,169,69,100,241,25,156,63,76,17,60,38,22,10,2,0,1,7
S01009239,Occupancy rating +2 or more,68,19,8,11,49,16,32,23,9,0,1,1,0,0,0,0,0,0
S01009239,Occupancy rating +1,137,56,19,37,80,9,59,30,18,11,12,7,5,1,0,0,0,1
S01009239,Occupancy rating 0,183,84,36,48,94,0,53,10,38,5,41,28,13,5,0,0,1,4
S01009239,Occupancy rating -1 or less,32,10,6,4,18,0,12,0,11,1,6,2,4,4,2,0,0,2
S01009240,All households,387,217,54,163,156,11,82,32,42,8,63,49,14,14,2,0,1,11
S01009240,Occupancy rating +2 or more,54,36,17,19,18,3,14,11,2,1,1,1,0,0,0,0,0,0
S01009240,Occupancy rating +1,155,117,15,102,37,5,25,15,9,1,7,4,3,1,0,0,0,1
S01009240,Occupancy rating 0,145,51,19,32,85,3,37,5,26,6,45,36,9,9,0,0,0,9
S01009240,Occupancy rating -1 or less,33,13,3,10,16,0,6,1,5,0,10,8,2,4,2,0,1,1
S01009241,All households,453,204,66,138,236,35,127,42,65,20,74,57,17,13,6,0,0,7
S01009241,Occupancy rating +2 or more,96,38,20,18,57,18,33,20,10,3,6,4,2,1,0,0,0,1
S01009241,Occupancy rating +1,158,69,17,52,88,11,53,16,24,13,24,17,7,1,1,0,0,0
S01009241,Occupancy rating 0,163,80,23,57,81,5,36,5,28,3,40,33,7,2,2,0,0,0
S01009241,Occupancy rating -1 or less,36,17,6,11,10,1,5,1,3,1,4,3,1,9,3,0,0,6
S01009242,All households,321,98,36,62,217,49,156,57,63,36,12,3,9,6,2,0,0,4
S01009242,Occupancy rating +2 or more,176,50,32,18,125,45,77,46,18,13,3,0,3,1,0,0,0,1
S01009242,Occupancy rating +1,90,36,3,33,53,4,47,9,20,18,2,1,1,1,0,0,0,1
S01009242,Occupancy rating 0,45,10,1,9,34,0,27,2,20,5,7,2,5,1,1,0,0,0
S01009242,Occupancy rating -1 or less,10,2,0,2,5,0,5,0,5,0,0,0,0,3,1,0,0,2
S01009243,All households,398,91,20,71,293,25,223,84,95,44,45,32,13,14,8,0,0,6
S01009243,Occupancy rating +2 or more,155,36,11,25,118,19,90,59,18,13,9,5,4,1,1,0,0,0
S01009243,Occupancy rating +1,136,37,6,31,94,4,71,21,30,20,19,12,7,5,2,0,0,3
S01009243,Occupancy rating 0,82,17,2,15,60,2,45,4,33,8,13,12,1,5,2,0,0,3
S01009243,Occupancy rating -1 or less,25,1,1,0,21,0,17,0,14,3,4,3,1,3,3,0,0,0
S01009244,All households,337,67,35,32,267,44,211,93,74,44,12,6,6,3,1,0,0,2
S01009244,Occupancy rating +2 or more,219,40,22,18,177,38,138,72,42,24,1,0,1,2,0,0,0,2
S01009244,Occupancy rating +1,85,18,11,7,66,6,54,18,22,14,6,3,3,1,1,0,0,0
S01009244,Occupancy rating 0,25,6,1,5,19,0,16,2,8,6,3,1,2,0,0,0,0,0
S01009244,Occupancy rating -1 or less,8,3,1,2,5,0,3,1,2,0,2,2,0,0,0,0,0,0
S01009245,All households,361,97,31,66,256,38,199,88,79,32,19,11,8,8,2,0,0,6
S01009245,Occupancy rating +2 or more,200,45,19,26,153,32,117,70,35,12,4,1,3,2,1,0,0,1
S01009245,Occupancy rating +1,98,29,4,25,65,5,52,13,26,13,8,5,3,4,1,0,0,3
S01009245,Occupancy rating 0,55,21,6,15,33,1,26,4,16,6,6,4,2,1,0,0,0,1
S01009245,Occupancy rating -1 or less,8,2,2,0,5,0,4,1,2,1,1,1,0,1,0,0,0,1
S01009246,All households,383,135,67,68,234,28,165,83,62,20,41,25,16,14,5,0,2,7
S01009246,Occupancy rating +2 or more,126,46,24,22,79,19,59,46,11,2,1,1,0,1,0,0,0,1
S01009246,Occupancy rating +1,133,49,16,33,78,8,62,33,19,10,8,4,4,6,3,0,1,2
S01009246,Occupancy rating 0,94,30,18,12,59,1,32,3,23,6,26,15,11,5,2,0,0,3
S01009246,Occupancy rating -1 or less,30,10,9,1,18,0,12,1,9,2,6,5,1,2,0,0,1,1
S01009247,All households,429,96,55,41,316,33,218,100,81,37,65,46,19,17,10,0,2,5
S01009247,Occupancy rating +2 or more,130,42,25,17,88,15,71,56,8,7,2,1,1,0,0,0,0,0
S01009247,Occupancy rating +1,167,49,27,22,115,16,80,42,30,8,19,10,9,3,1,0,0,2
S01009247,Occupancy rating 0,100,3,1,2,89,2,53,1,32,20,34,25,9,8,5,0,2,1
S01009247,Occupancy rating -1 or less,32,2,2,0,24,0,14,1,11,2,10,10,0,6,4,0,0,2
S01009248,All households,300,73,38,35,220,40,143,69,48,26,37,23,14,7,2,0,0,5
S01009248,Occupancy rating +2 or more,153,27,16,11,123,29,87,55,22,10,7,4,3,3,1,0,0,2
S01009248,Occupancy rating +1,75,20,8,12,54,10,34,10,14,10,10,5,5,1,0,0,0,1
S01009248,Occupancy rating 0,57,20,10,10,34,1,17,3,9,5,16,12,4,3,1,0,0,2
S01009248,Occupancy rating -1 or less,15,6,4,2,9,0,5,1,3,1,4,2,2,0,0,0,0,0
S01009249,All households,375,137,54,83,218,22,140,55,63,22,56,31,25,20,8,0,2,10
S01009249,Occupancy rating +2 or more,96,40,18,22,55,10,44,30,9,5,1,0,1,1,0,0,0,1
S01009249,Occupancy rating +1,135,60,24,36,74,9,46,20,19,7,19,14,5,1,0,0,1,0
S01009249,Occupancy rating 0,115,31,9,22,71,3,44,5,30,9,24,10,14,13,3,0,1,9
S01009249,Occupancy rating -1 or less,29,6,3,3,18,0,6,0,5,1,12,7,5,5,5,0,0,0
S01009250,All households,278,74,33,41,186,36,116,48,48,20,34,19,15,18,9,0,2,7
S01009250,Occupancy rating +2 or more,89,25,7,18,64,18,43,31,6,6,3,0,3,0,0,0,0,0
S01009250,Occupancy rating +1,93,28,11,17,58,11,41,11,23,7,6,3,3,7,2,0,1,4
S01009250,Occupancy rating 0,78,21,15,6,51,6,28,6,15,7,17,9,8,6,4,0,0,2
S01009250,Occupancy rating -1 or less,18,0,0,0,13,1,4,0,4,0,8,7,1,5,3,0,1,1
S01009251,All households,221,50,26,24,166,24,123,47,51,25,19,12,7,5,2,0,0,3
S01009251,Occupancy rating +2 or more,117,21,8,13,94,20,68,41,17,10,6,5,1,2,0,0,0,2
S01009251,Occupancy rating +1,52,14,6,8,37,1,28,5,17,6,8,3,5,1,1,0,0,0
S01009251,Occupancy rating 0,50,15,12,3,34,3,26,1,16,9,5,4,1,1,1,0,0,0
S01009251,Occupancy rating -1 or less,2,0,0,0,1,0,1,0,1,0,0,0,0,1,0,0,0,1
S01009252,All households,163,23,4,19,134,7,120,31,71,18,7,4,3,6,3,0,0,3
S01009252,Occupancy rating +2 or more,120,17,4,13,99,6,92,30,51,11,1,1,0,4,2,0,0,2
S01009252,Occupancy rating +1,28,5,0,5,22,1,18,1,12,5,3,1,2,1,1,0,0,0
S01009252,Occupancy rating 0,10,1,0,1,8,0,7,0,5,2,1,1,0,1,0,0,0,1
S01009252,Occupancy rating -1 or less,5,0,0,0,5,0,3,0,3,0,2,1,1,0,0,0,0,0
S01009253,All households,239,96,60,36,138,33,70,30,28,12,35,25,10,5,1,2,0,2
S01009253,Occupancy rating +2 or more,71,39,21,18,31,9,21,15,3,3,1,1,0,1,1,0,0,0
S01009253,Occupancy rating +1,87,33,24,9,54,20,28,12,10,6,6,4,2,0,0,0,0,0
S01009253,Occupancy rating 0,58,19,14,5,36,1,16,3,12,1,19,13,6,3,0,2,0,1
S01009253,Occupancy rating -1 or less,23,5,1,4,17,3,5,0,3,2,9,7,2,1,0,0,0,1
S01009254,All households,371,114,54,60,242,29,141,62,61,18,72,40,32,15,5,0,1,9
S01009254,Occupancy rating +2 or more,93,29,11,18,63,17,43,31,8,4,3,1,2,1,0,0,0,1
S01009254,Occupancy rating +1,147,67,28,39,73,9,48,25,16,7,16,11,5,7,1,0,1,5
S01009254,Occupancy rating 0,103,12,10,2,88,2,41,5,29,7,45,25,20,3,1,0,0,2
S01009254,Occupancy rating -1 or less,28,6,5,1,18,1,9,1,8,0,8,3,5,4,3,0,0,1
S01009255,All households,376,209,56,153,148,9,111,71,34,6,28,21,7,19,6,0,0,13
S01009255,Occupancy rating +2 or more,75,32,9,23,42,2,37,26,10,1,3,1,2,1,1,0,0,0
S01009255,Occupancy rating +1,103,61,15,46,40,3,31,23,7,1,6,6,0,2,1,0,0,1
S01009255,Occupancy rating 0,129,81,30,51,43,4,26,13,10,3,13,10,3,5,2,0,0,3
S01009255,Occupancy rating -1 or less,69,35,2,33,23,0,17,9,7,1,6,4,2,11,2,0,0,9
S01009256,All households,222,59,27,32,155,29,109,48,43,18,17,11,6,8,1,0,1,6
S01009256,Occupancy rating +2 or more,110,25,13,12,84,23,58,34,17,7,3,2,1,1,0,0,0,1
S01009256,Occupancy rating +1,66,26,9,17,38,5,29,11,10,8,4,2,2,2,0,0,0,2
S01009256,Occupancy rating 0,38,8,5,3,26,1,17,2,12,3,8,5,3,4,0,0,1,3
S01009256,Occupancy rating -1 or less,8,0,0,0,7,0,5,1,4,0,2,2,0,1,1,0,0,0
S01009257,All households,330,128,37,91,190,24,141,85,43,13,25,15,10,12,4,0,0,8
S01009257,Occupancy rating +2 or more,122,36,23,13,86,16,68,40,23,5,2,0,2,0,0,0,0,0
S01009257,Occupancy rating +1,90,45,5,40,45,7,35,23,8,4,3,2,1,0,0,0,0,0
S01009257,Occupancy rating 0,70,25,4,21,41,1,28,17,10,1,12,10,2,4,2,0,0,2
S01009257,Occupancy rating -1 or less,48,22,5,17,18,0,10,5,2,3,8,3,5,8,2,0,0,6
S01009258,All households,282,80,41,39,193,31,150,84,48,18,12,5,7,9,6,0,0,3
S01009258,Occupancy rating +2 or more,180,50,24,26,126,21,102,66,27,9,3,1,2,4,3,0,0,1
S01009258,Occupancy rating +1,68,21,14,7,46,9,31,15,10,6,6,3,3,1,1,0,0,0
S01009258,Occupancy rating 0,21,4,1,3,16,0,13,3,7,3,3,1,2,1,1,0,0,0
S01009258,Occupancy rating -1 or less,13,5,2,3,5,1,4,0,4,0,0,0,0,3,1,0,0,2
S01009259,All households,380,79,44,35,286,41,227,100,98,29,18,9,9,15,4,0,1,10
S01009259,Occupancy rating +2 or more,254,50,29,21,200,32,166,78,72,16,2,1,1,4,1,0,0,3
S01009259,Occupancy rating +1,77,18,9,9,58,9,41,20,13,8,8,3,5,1,0,0,0,1
S01009259,Occupancy rating 0,41,10,5,5,24,0,17,2,12,3,7,5,2,7,3,0,0,4
S01009259,Occupancy rating -1 or less,8,1,1,0,4,0,3,0,1,2,1,0,1,3,0,0,1,2
S01009260,All households,526,188,48,140,301,31,229,107,95,27,41,27,14,37,8,0,2,27
S01009260,Occupancy rating +2 or more,184,58,18,40,124,21,101,55,40,6,2,1,1,2,2,0,0,0
S01009260,Occupancy rating +1,175,92,20,72,79,8,64,40,15,9,7,3,4,4,0,0,0,4
S01009260,Occupancy rating 0,131,33,8,25,82,1,54,12,33,9,27,19,8,16,1,0,2,13
S01009260,Occupancy rating -1 or less,36,5,2,3,16,1,10,0,7,3,5,4,1,15,5,0,0,10
S01009261,All households,386,162,69,93,209,30,128,72,36,20,51,35,16,15,6,0,1,8
S01009261,Occupancy rating +2 or more,90,26,13,13,62,13,44,27,10,7,5,2,3,2,1,0,0,1
S01009261,Occupancy rating +1,123,54,25,29,66,13,46,33,8,5,7,4,3,3,2,0,0,1
S01009261,Occupancy rating 0,141,71,27,44,64,3,33,10,15,8,28,21,7,6,1,0,0,5
S01009261,Occupancy rating -1 or less,32,11,4,7,17,1,5,2,3,0,11,8,3,4,2,0,1,1
S01009262,All households,293,117,49,68,166,18,79,28,42,9,69,53,16,10,5,0,0,5
S01009262,Occupancy rating +2 or more,49,31,16,15,17,7,9,8,1,0,1,1,0,1,0,0,0,1
S01009262,Occupancy rating +1,102,55,28,27,46,6,27,13,10,4,13,9,4,1,0,0,0,1
S01009262,Occupancy rating 0,115,22,4,18,88,3,39,7,27,5,46,36,10,5,2,0,0,3
S01009262,Occupancy rating -1 or less,27,9,1,8,15,2,4,0,4,0,9,7,2,3,3,0,0,0
S01009263,All households,365,109,14,95,241,12,202,94,96,12,27,24,3,15,3,0,1,11
S01009263,Occupancy rating +2 or more,166,45,4,41,121,5,110,56,47,7,6,5,1,0,0,0,0,0
S01009263,Occupancy rating +1,132,50,7,43,78,4,64,30,31,3,10,9,1,4,1,0,0,3
S01009263,Occupancy rating 0,53,10,3,7,35,2,22,6,14,2,11,10,1,8,0,0,1,7
S01009263,Occupancy rating -1 or less,14,4,0,4,7,1,6,2,4,0,0,0,0,3,2,0,0,1
S01009264,All households,231,55,30,25,168,36,117,58,35,24,15,6,9,8,3,1,0,4
S01009264,Occupancy rating +2 or more,165,42,23,19,120,31,83,51,18,14,6,3,3,3,1,0,0,2
S01009264,Occupancy rating +1,47,10,5,5,34,5,23,7,12,4,6,2,4,3,1,0,0,2
S01009264,Occupancy rating 0,17,3,2,1,12,0,9,0,5,4,3,1,2,2,1,1,0,0
S01009264,Occupancy rating -1 or less,2,0,0,0,2,0,2,0,0,2,0,0,0,0,0,0,0,0
S01009265,All households,376,138,65,73,227,36,146,72,55,19,45,32,13,11,5,0,0,6
S01009265,Occupancy rating +2 or more,146,39,14,25,104,27,72,44,17,11,5,2,3,3,3,0,0,0
S01009265,Occupancy rating +1,112,52,26,26,56,4,44,22,17,5,8,6,2,4,1,0,0,3
S01009265,Occupancy rating 0,87,39,21,18,46,4,22,4,16,2,20,15,5,2,0,0,0,2
S01009265,Occupancy rating -1 or less,31,8,4,4,21,1,8,2,5,1,12,9,3,2,1,0,0,1
S01009266,All households,374,98,46,52,264,54,170,63,62,45,40,27,13,12,5,0,1,6
S01009266,Occupancy rating +2 or more,171,44,21,23,123,36,80,42,27,11,7,5,2,4,2,0,0,2
S01009266,Occupancy rating +1,123,37,18,19,85,15,59,16,21,22,11,7,4,1,0,0,0,1
S01009266,Occupancy rating 0,65,16,7,9,42,2,25,4,10,11,15,10,5,7,3,0,1,3
S01009266,Occupancy rating -1 or less,15,1,0,1,14,1,6,1,4,1,7,5,2,0,0,0,0,0
S01009267,All households,377,136,45,91,222,26,156,76,57,23,40,26,14,19,5,0,2,12
S01009267,Occupancy rating +2 or more,148,32,15,17,111,18,86,50,29,7,7,3,4,5,1,0,0,4
S01009267,Occupancy rating +1,135,64,18,46,67,7,46,22,15,9,14,9,5,4,1,0,0,3
S01009267,Occupancy rating 0,74,34,8,26,33,1,19,3,11,5,13,10,3,7,2,0,2,3
S01009267,Occupancy rating -1 or less,20,6,4,2,11,0,5,1,2,2,6,4,2,3,1,0,0,2
S01009268,All households,431,108,41,67,311,40,206,103,89,14,65,50,15,12,8,0,0,4
S01009268,Occupancy rating +2 or more,159,28,10,18,128,14,102,60,36,6,12,10,2,3,1,0,0,2
S01009268,Occupancy rating +1,146,53,18,35,90,21,61,33,25,3,8,8,0,3,3,0,0,0
S01009268,Occupancy rating 0,103,21,9,12,81,4,35,8,24,3,42,31,11,1,0,0,0,1
S01009268,Occupancy rating -1 or less,23,6,4,2,12,1,8,2,4,2,3,1,2,5,4,0,0,1
S01009269,All households,351,89,37,52,247,20,152,45,73,34,75,53,22,15,7,0,0,8
S01009269,Occupancy rating +2 or more,111,51,24,27,59,13,40,29,9,2,6,3,3,1,0,0,0,1
S01009269,Occupancy rating +1,117,17,7,10,99,5,62,14,29,19,32,19,13,1,0,0,0,1
S01009269,Occupancy rating 0,103,18,5,13,76,2,42,2,28,12,32,27,5,9,6,0,0,3
S01009269,Occupancy rating -1 or less,20,3,1,2,13,0,8,0,7,1,5,4,1,4,1,0,0,3
S01009270,All households,306,125,49,76,169,22,88,45,30,13,59,41,18,12,2,0,7,3
S01009270,Occupancy rating +2 or more,65,30,15,15,34,11,20,15,2,3,3,2,1,1,0,0,1,0
S01009270,Occupancy rating +1,114,51,19,32,63,10,36,24,7,5,17,11,6,0,0,0,0,0
S01009270,Occupancy rating 0,98,37,12,25,54,1,20,5,14,1,33,23,10,7,1,0,5,1
S01009270,Occupancy rating -1 or less,29,7,3,4,18,0,12,1,7,4,6,5,1,4,1,0,1,2
S01009271,All households,349,57,18,39,273,34,216,101,82,33,23,13,10,19,7,0,1,11
S01009271,Occupancy rating +2 or more,211,30,8,22,174,30,133,75,42,16,11,6,5,7,2,0,1,4
S01009271,Occupancy rating +1,98,24,9,15,68,3,59,24,23,12,6,3,3,6,3,0,0,3
S01009271,Occupancy rating 0,31,2,1,1,26,0,21,2,14,5,5,4,1,3,0,0,0,3
S01009271,Occupancy rating -1 or less,9,1,0,1,5,1,3,0,3,0,1,0,1,3,2,0,0,1
S01009272,All households,264,48,23,25,191,10,137,61,54,22,44,25,19,25,11,0,1,13
S01009272,Occupancy rating +2 or more,111,29,13,16,79,10,62,50,9,3,7,3,4,3,1,0,0,2
S01009272,Occupancy rating +1,68,10,4,6,53,0,38,7,16,15,15,7,8,5,3,0,0,2
S01009272,Occupancy rating 0,65,8,5,3,45,0,29,3,22,4,16,12,4,12,4,0,1,7
S01009272,Occupancy rating -1 or less,20,1,1,0,14,0,8,1,7,0,6,3,3,5,3,0,0,2
S01009273,All households,211,47,31,16,158,29,119,65,36,18,10,3,7,6,3,0,0,3
S01009273,Occupancy rating +2 or more,153,32,20,12,115,26,87,54,19,14,2,0,2,6,3,0,0,3
S01009273,Occupancy rating +1,42,10,8,2,32,3,24,10,11,3,5,2,3,0,0,0,0,0
S01009273,Occupancy rating 0,12,3,2,1,9,0,6,1,4,1,3,1,2,0,0,0,0,0
S01009273,Occupancy rating -1 or less,4,2,1,1,2,0,2,0,2,0,0,0,0,0,0,0,0,0
S01009274,All households,255,56,31,25,186,36,126,57,53,16,24,14,10,13,9,0,0,4
S01009274,Occupancy rating +2 or more,161,36,23,13,119,30,87,51,25,11,2,1,1,6,4,0,0,2
S01009274,Occupancy rating +1,56,14,7,7,39,5,23,4,16,3,11,7,4,3,1,0,0,2
S01009274,Occupancy rating 0,28,6,1,5,20,1,10,2,7,1,9,5,4,2,2,0,0,0
S01009274,Occupancy rating -1 or less,10,0,0,0,8,0,6,0,5,1,2,1,1,2,2,0,0,0
S01009275,All households,244,63,19,44,168,16,135,65,52,18,17,8,9,13,1,0,0,12
S01009275,Occupancy rating +2 or more,126,17,7,10,105,11,91,46,30,15,3,1,2,4,0,0,0,4
S01009275,Occupancy rating +1,73,30,7,23,40,5,28,16,9,3,7,3,4,3,0,0,0,3
S01009275,Occupancy rating 0,36,14,4,10,17,0,11,2,9,0,6,3,3,5,1,0,0,4
S01009275,Occupancy rating -1 or less,9,2,1,1,6,0,5,1,4,0,1,1,0,1,0,0,0,1
S01009276,All households,373,79,36,43,278,50,201,90,71,40,27,21,6,16,7,0,1,8
S01009276,Occupancy rating +2 or more,241,43,18,25,192,45,139,78,35,26,8,7,1,6,0,0,1,5
S01009276,Occupancy rating +1,72,16,8,8,52,4,36,8,19,9,12,10,2,4,3,0,0,1
S01009276,Occupancy rating 0,48,18,9,9,24,0,20,3,12,5,4,3,1,6,4,0,0,2
S01009276,Occupancy rating -1 or less,12,2,1,1,10,1,6,1,5,0,3,1,2,0,0,0,0,0
S01009277,All households,218,38,13,25,175,24,142,78,45,19,9,3,6,5,2,0,0,3
S01009277,Occupancy rating +2 or more,181,28,12,16,149,23,120,71,30,19,6,2,4,4,2,0,0,2
S01009277,Occupancy rating +1,29,10,1,9,19,1,17,6,11,0,1,0,1,0,0,0,0,0
S01009277,Occupancy rating 0,4,0,0,0,3,0,3,1,2,0,0,0,0,1,0,0,0,1
S01009277,Occupancy rating -1 or less,4,0,0,0,4,0,2,0,2,0,2,1,1,0,0,0,0,0
S01009278,All households,235,54,28,26,174,20,137,57,67,13,17,11,6,7,1,0,2,4
S01009278,Occupancy rating +2 or more,147,36,19,17,107,17,84,43,38,3,6,4,2,4,0,0,1,3
S01009278,Occupancy rating +1,64,9,4,5,53,2,45,14,24,7,6,3,3,2,0,0,1,1
S01009278,Occupancy rating 0,19,9,5,4,9,1,5,0,4,1,3,2,1,1,1,0,0,0
S01009278,Occupancy rating -1 or less,5,0,0,0,5,0,3,0,1,2,2,2,0,0,0,0,0,0
S01009279,All households,283,105,38,67,172,18,133,71,43,19,21,14,7,6,4,0,2,0
S01009279,Occupancy rating +2 or more,122,29,11,18,90,9,76,44,24,8,5,3,2,3,3,0,0,0
S01009279,Occupancy rating +1,88,42,16,26,45,8,33,22,7,4,4,3,1,1,1,0,0,0
S01009279,Occupancy rating 0,57,29,9,20,26,1,19,5,8,6,6,3,3,2,0,0,2,0
S01009279,Occupancy rating -1 or less,16,5,2,3,11,0,5,0,4,1,6,5,1,0,0,0,0,0
S01009280,All households,406,139,65,74,251,31,137,55,55,27,83,65,18,16,7,0,0,9
S01009280,Occupancy rating +2 or more,100,51,27,24,48,13,28,20,6,2,7,7,0,1,0,0,0,1
S01009280,Occupancy rating +1,126,39,17,22,82,14,48,28,11,9,20,13,7,5,0,0,0,5
S01009280,Occupancy rating 0,141,39,18,21,97,4,48,4,34,10,45,36,9,5,3,0,0,2
S01009280,Occupancy rating -1 or less,39,10,3,7,24,0,13,3,4,6,11,9,2,5,4,0,0,1
S01009281,All households,375,115,38,77,247,41,145,58,61,26,61,46,15,13,6,0,1,6
S01009281,Occupancy rating +2 or more,105,37,12,25,68,14,50,28,12,10,4,3,1,0,0,0,0,0
S01009281,Occupancy rating +1,151,62,22,40,87,23,53,28,17,8,11,7,4,2,0,0,0,2
S01009281,Occupancy rating 0,84,12,3,9,66,1,31,2,22,7,34,26,8,6,4,0,1,1
S01009281,Occupancy rating -1 or less,35,4,1,3,26,3,11,0,10,1,12,10,2,5,2,0,0,3
S01009282,All households,346,111,47,64,220,23,172,94,62,16,25,17,8,15,5,0,0,10
S01009282,Occupancy rating +2 or more,188,41,22,19,142,18,121,72,40,9,3,2,1,5,0,0,0,5
S01009282,Occupancy rating +1,92,47,17,30,42,4,31,17,11,3,7,4,3,3,2,0,0,1
S01009282,Occupancy rating 0,51,19,8,11,28,1,16,4,9,3,11,7,4,4,0,0,0,4
S01009282,Occupancy rating -1 or less,15,4,0,4,8,0,4,1,2,1,4,4,0,3,3,0,0,0
S01009283,All households,180,36,10,26,135,11,113,56,48,9,11,5,6,9,5,0,0,4
S01009283,Occupancy rating +2 or more,107,19,7,12,85,9,72,45,22,5,4,1,3,3,0,0,0,3
S01009283,Occupancy rating +1,40,14,2,12,26,0,22,10,10,2,4,3,1,0,0,0,0,0
S01009283,Occupancy rating 0,26,3,1,2,21,2,16,1,14,1,3,1,2,2,1,0,0,1
S01009283,Occupancy rating -1 or less,7,0,0,0,3,0,3,0,2,1,0,0,0,4,4,0,0,0
S01009284,All households,311,58,24,34,238,18,192,63,103,26,28,16,12,15,5,0,0,10
S01009284,Occupancy rating +2 or more,212,36,17,19,171,13,146,52,74,20,12,6,6,5,2,0,0,3
S01009284,Occupancy rating +1,64,12,3,9,47,4,33,10,21,2,10,7,3,5,0,0,0,5
S01009284,Occupancy rating 0,30,9,4,5,17,1,10,1,7,2,6,3,3,4,2,0,0,2
S01009284,Occupancy rating -1 or less,5,1,0,1,3,0,3,0,1,2,0,0,0,1,1,0,0,0
S01009285,All households,350,71,23,48,269,24,204,62,108,34,41,31,10,10,8,0,0,2
S01009285,Occupancy rating +2 or more,161,29,8,21,131,15,109,47,46,16,7,6,1,1,1,0,0,0
S01009285,Occupancy rating +1,101,26,9,17,73,6,55,14,30,11,12,9,3,2,1,0,0,1
S01009285,Occupancy rating 0,73,14,6,8,58,2,34,1,27,6,22,16,6,1,1,0,0,0
S01009285,Occupancy rating -1 or less,15,2,0,2,7,1,6,0,5,1,0,0,0,6,5,0,0,1
S01009286,All households,351,107,42,65,234,44,163,95,49,19,27,17,10,10,5,0,1,4
S01009286,Occupancy rating +2 or more,190,39,21,18,147,36,106,65,31,10,5,2,3,4,3,0,0,1
S01009286,Occupancy rating +1,93,41,14,27,49,6,36,21,10,5,7,4,3,3,1,0,1,1
S01009286,Occupancy rating 0,57,24,5,19,32,1,18,8,7,3,13,10,3,1,0,0,0,1
S01009286,Occupancy rating -1 or less,11,3,2,1,6,1,3,1,1,1,2,1,1,2,1,0,0,1
S01009287,All households,339,87,56,31,242,57,165,83,67,15,20,10,10,10,3,0,0,7
S01009287,Occupancy rating +2 or more,258,57,36,21,198,52,138,78,47,13,8,3,5,3,0,0,0,3
S01009287,Occupancy rating +1,51,20,14,6,27,5,15,3,11,1,7,3,4,4,1,0,0,3
S01009287,Occupancy rating 0,27,8,5,3,17,0,12,2,9,1,5,4,1,2,1,0,0,1
S01009287,Occupancy rating -1 or less,3,2,1,1,0,0,0,0,0,0,0,0,0,1,1,0,0,0
S01009288,All households,392,131,70,61,246,59,170,84,72,14,17,9,8,15,5,0,0,10
S01009288,Occupancy rating +2 or more,213,52,34,18,156,47,104,49,43,12,5,3,2,5,1,0,0,4
S01009288,Occupancy rating +1,107,48,27,21,56,10,42,26,14,2,4,1,3,3,2,0,0,1
S01009288,Occupancy rating 0,61,26,9,17,31,2,22,9,13,0,7,4,3,4,1,0,0,3
S01009288,Occupancy rating -1 or less,11,5,0,5,3,0,2,0,2,0,1,1,0,3,1,0,0,2
S01009289,All households,409,117,63,54,280,64,189,98,61,30,27,14,13,12,4,0,0,8
S01009289,Occupancy rating +2 or more,279,66,37,29,207,53,146,84,40,22,8,3,5,6,1,0,0,5
S01009289,Occupancy rating +1,79,33,18,15,43,11,20,13,6,1,12,4,8,3,1,0,0,2
S01009289,Occupancy rating 0,42,14,7,7,26,0,20,1,12,7,6,6,0,2,1,0,0,1
S01009289,Occupancy rating -1 or less,9,4,1,3,4,0,3,0,3,0,1,1,0,1,1,0,0,0
S01009290,All households,288,79,58,21,202,40,146,66,60,20,16,7,9,7,4,0,0,3
S01009290,Occupancy rating +2 or more,243,65,51,14,174,40,123,64,43,16,11,3,8,4,1,0,0,3
S01009290,Occupancy rating +1,38,13,7,6,23,0,19,2,13,4,4,3,1,2,2,0,0,0
S01009290,Occupancy rating 0,7,1,0,1,5,0,4,0,4,0,1,1,0,1,1,0,0,0
S01009290,Occupancy rating -1 or less,0,0,0,0,0,0,0,0,0,0,0,0,0,0,0,0,0,0
S01009291,All households,394,72,33,39,315,45,238,99,93,46,32,17,15,7,4,0,1,2
S01009291,Occupancy rating +2 or more,250,50,26,24,200,39,153,81,47,25,8,1,7,0,0,0,0,0
S01009291,Occupancy rating +1,102,20,6,14,79,5,60,16,30,14,14,10,4,3,1,0,1,1
S01009291,Occupancy rating 0,31,1,1,0,27,1,18,0,11,7,8,4,4,3,2,0,0,1
S01009291,Occupancy rating -1 or less,11,1,0,1,9,0,7,2,5,0,2,2,0,1,1,0,0,0
S01009292,All households,228,72,30,42,145,17,97,38,46,13,31,18,13,11,2,0,0,9
S01009292,Occupancy rating +2 or more,57,19,9,10,36,11,25,16,8,1,0,0,0,2,0,0,0,2
S01009292,Occupancy rating +1,80,40,13,27,39,3,30,15,12,3,6,3,3,1,0,0,0,1
S01009292,Occupancy rating 0,70,10,5,5,55,3,32,6,18,8,20,13,7,5,0,0,0,5
S01009292,Occupancy rating -1 or less,21,3,3,0,15,0,10,1,8,1,5,2,3,3,2,0,0,1
S01009293,All households,297,77,38,39,212,20,160,67,66,27,32,18,14,8,2,1,0,5
S01009293,Occupancy rating +2 or more,145,25,15,10,116,5,104,47,43,14,7,3,4,4,2,1,0,1
S01009293,Occupancy rating +1,76,35,16,19,40,10,26,11,9,6,4,1,3,1,0,0,0,1
S01009293,Occupancy rating 0,56,10,4,6,44,5,23,6,11,6,16,10,6,2,0,0,0,2
S01009293,Occupancy rating -1 or less,20,7,3,4,12,0,7,3,3,1,5,4,1,1,0,0,0,1
S01009294,All households,192,38,15,23,145,15,117,46,55,16,13,10,3,9,3,0,1,5
S01009294,Occupancy rating +2 or more,136,18,9,9,112,12,95,38,44,13,5,3,2,6,1,0,0,5
S01009294,Occupancy rating +1,36,12,6,6,23,2,18,8,7,3,3,3,0,1,0,0,1,0
S01009294,Occupancy rating 0,15,7,0,7,6,1,3,0,3,0,2,2,0,2,2,0,0,0
S01009294,Occupancy rating -1 or less,5,1,0,1,4,0,1,0,1,0,3,2,1,0,0,0,0,0
S01009295,All households,264,56,14,42,205,24,162,83,48,31,19,10,9,3,2,0,0,1
S01009295,Occupancy rating +2 or more,149,25,7,18,122,20,94,56,20,18,8,4,4,2,1,0,0,1
S01009295,Occupancy rating +1,80,28,7,21,52,3,45,27,10,8,4,2,2,0,0,0,0,0
S01009295,Occupancy rating 0,28,2,0,2,25,0,18,0,15,3,7,4,3,1,1,0,0,0
S01009295,Occupancy rating -1 or less,7,1,0,1,6,1,5,0,3,2,0,0,0,0,0,0,0,0
S01009296,All households,187,23,8,15,150,17,119,42,55,22,14,7,7,14,4,0,0,10
S01009296,Occupancy rating +2 or more,118,10,4,6,103,15,85,36,38,11,3,0,3,5,2,0,0,3
S01009296,Occupancy rating +1,34,8,3,5,23,1,18,6,8,4,4,2,2,3,1,0,0,2
S01009296,Occupancy rating 0,30,5,1,4,20,1,13,0,7,6,6,5,1,5,1,0,0,4
S01009296,Occupancy rating -1 or less,5,0,0,0,4,0,3,0,2,1,1,0,1,1,0,0,0,1
S01009297,All households,328,63,14,49,255,22,211,85,91,35,22,11,11,10,4,0,0,6
S01009297,Occupancy rating +2 or more,228,28,11,17,193,18,167,69,73,25,8,2,6,7,3,0,0,4
S01009297,Occupancy rating +1,54,20,2,18,33,3,25,13,6,6,5,2,3,1,0,0,0,1
S01009297,Occupancy rating 0,36,11,0,11,24,1,17,3,10,4,6,5,1,1,1,0,0,0
S01009297,Occupancy rating -1 or less,10,4,1,3,5,0,2,0,2,0,3,2,1,1,0,0,0,1
S01009298,All households,553,276,126,150,265,30,168,92,56,20,67,42,25,12,3,0,1,8
S01009298,Occupancy rating +2 or more,83,29,16,13,54,13,38,24,11,3,3,1,2,0,0,0,0,0
S01009298,Occupancy rating +1,207,104,28,76,101,13,76,59,8,9,12,7,5,2,2,0,0,0
S01009298,Occupancy rating 0,189,93,60,33,88,2,46,8,32,6,40,24,16,8,0,0,1,7
S01009298,Occupancy rating -1 or less,74,50,22,28,22,2,8,1,5,2,12,10,2,2,1,0,0,1
S01009299,All households,484,214,84,130,240,22,186,99,81,6,32,19,13,30,8,0,0,22
S01009299,Occupancy rating +2 or more,174,54,29,25,113,14,95,56,36,3,4,2,2,7,4,0,0,3
S01009299,Occupancy rating +1,152,72,20,52,72,4,57,34,22,1,11,7,4,8,2,0,0,6
S01009299,Occupancy rating 0,122,71,29,42,44,2,28,6,20,2,14,9,5,7,0,0,0,7
S01009299,Occupancy rating -1 or less,36,17,6,11,11,2,6,3,3,0,3,1,2,8,2,0,0,6
S01009300,All households,287,145,31,114,124,10,90,54,32,4,24,17,7,18,3,1,0,14
S01009300,Occupancy rating +2 or more,77,29,4,25,46,7,38,25,13,0,1,1,0,2,2,0,0,0
S01009300,Occupancy rating +1,85,41,12,29,37,3,29,20,8,1,5,4,1,7,1,0,0,6
S01009300,Occupancy rating 0,96,58,10,48,34,0,18,5,10,3,16,10,6,4,0,0,0,4
S01009300,Occupancy rating -1 or less,29,17,5,12,7,0,5,4,1,0,2,2,0,5,0,1,0,4
S01009301,All households,551,302,65,237,232,22,141,77,53,11,69,49,20,17,2,1,0,14
S01009301,Occupancy rating +2 or more,104,36,9,27,67,10,48,30,14,4,9,7,2,1,0,0,0,1
S01009301,Occupancy rating +1,200,145,28,117,53,7,40,32,6,2,6,4,2,2,0,0,0,2
S01009301,Occupancy rating 0,195,95,21,74,90,4,43,13,25,5,43,32,11,10,1,0,0,9
S01009301,Occupancy rating -1 or less,52,26,7,19,22,1,10,2,8,0,11,6,5,4,1,1,0,2
S01009302,All households,450,204,35,169,228,13,117,66,39,12,98,70,28,18,3,0,1,14
S01009302,Occupancy rating +2 or more,50,21,5,16,28,5,20,17,3,0,3,2,1,1,0,0,0,1
S01009302,Occupancy rating +1,148,72,12,60,76,7,57,39,13,5,12,5,7,0,0,0,0,0
S01009302,Occupancy rating 0,210,100,17,83,98,1,33,8,20,5,64,47,17,12,0,0,1,11
S01009302,Occupancy rating -1 or less,42,11,1,10,26,0,7,2,3,2,19,16,3,5,3,0,0,2
S01009303,All households,322,97,49,48,215,35,158,70,67,21,22,8,14,10,3,0,0,7
S01009303,Occupancy rating +2 or more,214,52,37,15,158,30,119,60,45,14,9,3,6,4,2,0,0,2
S01009303,Occupancy rating +1,56,18,6,12,34,4,26,9,11,6,4,1,3,4,0,0,0,4
S01009303,Occupancy rating 0,40,22,6,16,17,1,8,1,6,1,8,3,5,1,0,0,0,1
S01009303,Occupancy rating -1 or less,12,5,0,5,6,0,5,0,5,0,1,1,0,1,1,0,0,0
S01009304,All households,395,97,45,52,281,40,197,74,83,40,44,23,21,17,9,0,1,7
S01009304,Occupancy rating +2 or more,208,54,28,26,151,29,111,63,29,19,11,6,5,3,3,0,0,0
S01009304,Occupancy rating +1,102,28,9,19,74,11,48,8,25,15,15,7,8,0,0,0,0,0
S01009304,Occupancy rating 0,70,12,8,4,46,0,33,2,25,6,13,8,5,12,5,0,1,6
S01009304,Occupancy rating -1 or less,15,3,0,3,10,0,5,1,4,0,5,2,3,2,1,0,0,1
S01009305,All households,412,193,68,125,197,30,138,81,49,8,29,19,10,22,3,0,1,18
S01009305,Occupancy rating +2 or more,140,49,22,27,85,17,67,44,19,4,1,0,1,6,1,0,0,5
S01009305,Occupancy rating +1,138,70,25,45,65,9,48,29,15,4,8,5,3,3,0,0,0,3
S01009305,Occupancy rating 0,110,64,19,45,39,3,18,7,11,0,18,13,5,7,0,0,1,6
S01009305,Occupancy rating -1 or less,24,10,2,8,8,1,5,1,4,0,2,1,1,6,2,0,0,4
S01009306,All households,565,243,46,197,302,22,205,111,74,20,75,58,17,20,6,0,0,14
S01009306,Occupancy rating +2 or more,157,48,14,34,107,12,90,51,30,9,5,3,2,2,0,0,0,2
S01009306,Occupancy rating +1,177,94,18,76,78,6,55,32,17,6,17,11,6,5,0,0,0,5
S01009306,Occupancy rating 0,168,73,11,62,89,2,44,20,20,4,43,34,9,6,0,0,0,6
S01009306,Occupancy rating -1 or less,63,28,3,25,28,2,16,8,7,1,10,10,0,7,6,0,0,1
S01009307,All households,544,273,43,230,247,23,181,108,55,18,43,26,17,24,4,1,1,18
S01009307,Occupancy rating +2 or more,159,51,17,34,100,15,77,39,26,12,8,4,4,8,1,0,1,6
S01009307,Occupancy rating +1,146,85,14,71,57,5,48,36,9,3,4,1,3,4,2,0,0,2
S01009307,Occupancy rating 0,173,102,8,94,67,3,42,25,15,2,22,16,6,4,0,1,0,3
S01009307,Occupancy rating -1 or less,66,35,4,31,23,0,14,8,5,1,9,5,4,8,1,0,0,7
S01009308,All households,304,180,41,139,106,12,77,43,33,1,17,15,2,18,3,1,2,12
S01009308,Occupancy rating +2 or more,64,21,6,15,35,4,28,17,11,0,3,3,0,8,3,0,1,4
S01009308,Occupancy rating +1,83,54,9,45,26,2,19,14,5,0,5,5,0,3,0,1,0,2
S01009308,Occupancy rating 0,133,90,25,65,36,6,24,11,12,1,6,5,1,7,0,0,1,6
S01009308,Occupancy rating -1 or less,24,15,1,14,9,0,6,1,5,0,3,2,1,0,0,0,0,0
S01009309,All households,400,205,35,170,180,14,141,74,59,8,25,14,11,15,2,0,0,13
S01009309,Occupancy rating +2 or more,115,32,11,21,82,9,69,32,34,3,4,2,2,1,1,0,0,0
S01009309,Occupancy rating +1,129,83,14,69,43,3,38,25,11,2,2,0,2,3,1,0,0,2
S01009309,Occupancy rating 0,122,74,7,67,40,2,24,14,8,2,14,8,6,8,0,0,0,8
S01009309,Occupancy rating -1 or less,34,16,3,13,15,0,10,3,6,1,5,4,1,3,0,0,0,3
S01009310,All households,399,115,35,80,267,43,206,101,77,28,18,11,7,17,8,0,0,9
S01009310,Occupancy rating +2 or more,249,51,23,28,193,35,144,72,51,21,14,9,5,5,3,0,0,2
S01009310,Occupancy rating +1,93,41,10,31,49,8,40,24,10,6,1,0,1,3,0,0,0,3
S01009310,Occupancy rating 0,41,17,2,15,21,0,18,5,12,1,3,2,1,3,2,0,0,1
S01009310,Occupancy rating -1 or less,16,6,0,6,4,0,4,0,4,0,0,0,0,6,3,0,0,3
S01009311,All households,274,53,30,23,195,14,132,49,60,23,49,30,19,26,12,0,1,13
S01009311,Occupancy rating +2 or more,117,41,25,16,74,13,56,43,9,4,5,1,4,2,0,0,0,2
S01009311,Occupancy rating +1,72,3,3,0,58,1,39,1,24,14,18,6,12,11,3,0,1,7
S01009311,Occupancy rating 0,60,8,2,6,41,0,22,4,17,1,19,16,3,11,7,0,0,4
S01009311,Occupancy rating -1 or less,25,1,0,1,22,0,15,1,10,4,7,7,0,2,2,0,0,0
S01009312,All households,366,182,45,137,172,10,132,84,36,12,30,19,11,12,2,0,0,10
S01009312,Occupancy rating +2 or more,87,34,19,15,50,5,43,28,11,4,2,2,0,3,1,0,0,2
S01009312,Occupancy rating +1,140,76,17,59,63,4,54,41,8,5,5,1,4,1,0,0,0,1
S01009312,Occupancy rating 0,106,56,7,49,44,1,28,13,13,2,15,10,5,6,0,0,0,6
S01009312,Occupancy rating -1 or less,33,16,2,14,15,0,7,2,4,1,8,6,2,2,1,0,0,1
S01009313,All households,285,133,40,93,140,21,91,46,34,11,28,20,8,12,7,0,0,5
S01009313,Occupancy rating +2 or more,64,19,10,9,43,12,28,17,6,5,3,1,2,2,1,0,0,1
S01009313,Occupancy rating +1,88,36,11,25,50,7,34,21,10,3,9,7,2,2,1,0,0,1
S01009313,Occupancy rating 0,113,71,18,53,36,1,23,8,13,2,12,8,4,6,3,0,0,3
S01009313,Occupancy rating -1 or less,20,7,1,6,11,1,6,0,5,1,4,4,0,2,2,0,0,0
S01009314,All households,258,42,20,22,203,23,162,78,60,24,18,9,9,13,6,0,2,5
S01009314,Occupancy rating +2 or more,163,23,15,8,138,22,107,61,32,14,9,2,7,2,2,0,0,0
S01009314,Occupancy rating +1,58,18,5,13,36,1,34,16,11,7,1,1,0,4,1,0,1,2
S01009314,Occupancy rating 0,27,0,0,0,23,0,18,1,14,3,5,4,1,4,1,0,1,2
S01009314,Occupancy rating -1 or less,10,1,0,1,6,0,3,0,3,0,3,2,1,3,2,0,0,1
S01009315,All households,270,81,33,48,176,20,117,49,43,25,39,24,15,13,5,0,2,6
S01009315,Occupancy rating +2 or more,82,24,9,15,57,10,42,27,8,7,5,2,3,1,0,0,0,1
S01009315,Occupancy rating +1,109,41,15,26,65,10,47,19,20,8,8,4,4,3,1,0,1,1
S01009315,Occupancy rating 0,59,11,7,4,42,0,24,3,12,9,18,14,4,6,3,0,1,2
S01009315,Occupancy rating -1 or less,20,5,2,3,12,0,4,0,3,1,8,4,4,3,1,0,0,2
S01009316,All households,326,110,35,75,206,27,159,57,77,25,20,9,11,10,3,0,0,7
S01009316,Occupancy rating +2 or more,199,49,20,29,147,22,120,47,53,20,5,3,2,3,1,0,0,2
S01009316,Occupancy rating +1,75,39,12,27,36,5,25,8,15,2,6,2,4,0,0,0,0,0
S01009316,Occupancy rating 0,40,16,2,14,19,0,11,1,8,2,8,3,5,5,1,0,0,4
S01009316,Occupancy rating -1 or less,12,6,1,5,4,0,3,1,1,1,1,1,0,2,1,0,0,1
S01009317,All households,358,79,39,40,268,42,198,97,73,28,28,13,15,11,4,0,1,6
S01009317,Occupancy rating +2 or more,266,57,31,26,208,39,157,86,51,20,12,4,8,1,1,0,0,0
S01009317,Occupancy rating +1,58,13,5,8,39,2,29,10,13,6,8,5,3,6,2,0,1,3
S01009317,Occupancy rating 0,28,7,2,5,20,1,11,1,8,2,8,4,4,1,1,0,0,0
S01009317,Occupancy rating -1 or less,6,2,1,1,1,0,1,0,1,0,0,0,0,3,0,0,0,3
S01009318,All households,236,34,17,17,198,19,154,68,63,23,25,10,15,4,3,0,0,1
S01009318,Occupancy rating +2 or more,167,22,13,9,143,17,114,60,42,12,12,3,9,2,1,0,0,1
S01009318,Occupancy rating +1,45,12,4,8,33,1,25,8,11,6,7,3,4,0,0,0,0,0
S01009318,Occupancy rating 0,22,0,0,0,21,1,14,0,10,4,6,4,2,1,1,0,0,0
S01009318,Occupancy rating -1 or less,2,0,0,0,1,0,1,0,0,1,0,0,0,1,1,0,0,0
S01009319,All households,416,114,82,32,295,80,196,93,76,27,19,4,15,7,4,0,1,2
S01009319,Occupancy rating +2 or more,315,88,62,26,225,66,149,79,51,19,10,2,8,2,0,0,1,1
S01009319,Occupancy rating +1,80,22,17,5,57,14,39,14,19,6,4,2,2,1,1,0,0,0
S01009319,Occupancy rating 0,16,3,2,1,10,0,5,0,3,2,5,0,5,3,2,0,0,1
S01009319,Occupancy rating -1 or less,5,1,1,0,3,0,3,0,3,0,0,0,0,1,1,0,0,0
S01009320,All households,352,149,103,46,187,27,139,62,61,16,21,12,9,16,7,1,0,8
S01009320,Occupancy rating +2 or more,147,44,28,16,101,14,81,42,34,5,6,5,1,2,1,0,0,1
S01009320,Occupancy rating +1,93,35,18,17,53,7,41,17,18,6,5,1,4,5,2,1,0,2
S01009320,Occupancy rating 0,101,68,56,12,27,5,14,3,8,3,8,5,3,6,3,0,0,3
S01009320,Occupancy rating -1 or less,11,2,1,1,6,1,3,0,1,2,2,1,1,3,1,0,0,2
S01009321,All households,295,68,28,40,223,50,159,74,69,16,14,7,7,4,2,0,0,2
S01009321,Occupancy rating +2 or more,231,57,24,33,173,40,126,67,45,14,7,2,5,1,0,0,0,1
S01009321,Occupancy rating +1,52,11,4,7,40,10,25,7,17,1,5,3,2,1,0,0,0,1
S01009321,Occupancy rating 0,7,0,0,0,7,0,5,0,4,1,2,2,0,0,0,0,0,0
S01009321,Occupancy rating -1 or less,5,0,0,0,3,0,3,0,3,0,0,0,0,2,2,0,0,0
S01009322,All households,355,86,38,48,261,52,185,96,64,25,24,14,10,8,4,0,0,4
S01009322,Occupancy rating +2 or more,200,34,20,14,162,39,116,76,25,15,7,3,4,4,3,0,0,1
S01009322,Occupancy rating +1,93,35,14,21,57,10,37,17,17,3,10,7,3,1,1,0,0,0
S01009322,Occupancy rating 0,55,15,4,11,37,2,28,3,19,6,7,4,3,3,0,0,0,3
S01009322,Occupancy rating -1 or less,7,2,0,2,5,1,4,0,3,1,0,0,0,0,0,0,0,0
S01009323,All households,327,136,60,76,178,33,110,63,30,17,35,24,11,13,5,0,2,6
S01009323,Occupancy rating +2 or more,118,32,16,16,81,24,53,39,8,6,4,2,2,5,1,0,1,3
S01009323,Occupancy rating +1,102,54,21,33,47,7,34,20,12,2,6,2,4,1,1,0,0,0
S01009323,Occupancy rating 0,81,38,18,20,39,1,19,3,9,7,19,14,5,4,1,0,0,3
S01009323,Occupancy rating -1 or less,26,12,5,7,11,1,4,1,1,2,6,6,0,3,2,0,1,0
S01009324,All households,256,85,34,51,164,18,107,60,30,17,39,29,10,7,2,0,1,4
S01009324,Occupancy rating +2 or more,75,26,12,14,48,8,36,28,6,2,4,3,1,1,0,0,0,1
S01009324,Occupancy rating +1,89,39,15,24,47,7,36,21,10,5,4,2,2,3,1,0,0,2
S01009324,Occupancy rating 0,75,17,4,13,56,3,28,9,11,8,25,19,6,2,1,0,0,1
S01009324,Occupancy rating -1 or less,17,3,3,0,13,0,7,2,3,2,6,5,1,1,0,0,1,0
S01009325,All households,308,82,21,61,220,18,179,67,99,13,23,20,3,6,3,0,0,3
S01009325,Occupancy rating +2 or more,152,36,9,27,113,10,98,42,49,7,5,4,1,3,2,0,0,1
S01009325,Occupancy rating +1,113,39,9,30,73,7,60,22,34,4,6,5,1,1,0,0,0,1
S01009325,Occupancy rating 0,37,5,2,3,30,1,18,1,15,2,11,11,0,2,1,0,0,1
S01009325,Occupancy rating -1 or less,6,2,1,1,4,0,3,2,1,0,1,0,1,0,0,0,0,0
S01009326,All households,210,32,7,25,172,6,130,40,83,7,36,31,5,6,3,0,0,3
S01009326,Occupancy rating +2 or more,106,5,1,4,98,6,84,28,51,5,8,7,1,3,1,0,0,2
S01009326,Occupancy rating +1,71,25,5,20,44,0,35,12,23,0,9,9,0,2,2,0,0,0
S01009326,Occupancy rating 0,28,1,1,0,26,0,9,0,7,2,17,15,2,1,0,0,0,1
S01009326,Occupancy rating -1 or less,5,1,0,1,4,0,2,0,2,0,2,0,2,0,0,0,0,0
S01009327,All households,258,57,34,23,197,51,120,58,45,17,26,15,11,4,2,0,1,1
S01009327,Occupancy rating +2 or more,143,21,13,8,122,36,80,47,24,9,6,1,5,0,0,0,0,0
S01009327,Occupancy rating +1,81,31,17,14,48,14,29,11,11,7,5,2,3,2,0,0,1,1
S01009327,Occupancy rating 0,28,4,4,0,23,0,10,0,9,1,13,10,3,1,1,0,0,0
S01009327,Occupancy rating -1 or less,6,1,0,1,4,1,1,0,1,0,2,2,0,1,1,0,0,0
S01009328,All households,237,25,1,24,200,2,193,65,117,11,5,3,2,12,3,2,0,7
S01009328,Occupancy rating +2 or more,171,6,1,5,164,1,160,48,102,10,3,1,2,1,1,0,0,0
S01009328,Occupancy rating +1,44,17,0,17,25,1,22,16,6,0,2,2,0,2,1,1,0,0
S01009328,Occupancy rating 0,17,1,0,1,8,0,8,1,6,1,0,0,0,8,1,0,0,7
S01009328,Occupancy rating -1 or less,5,1,0,1,3,0,3,0,3,0,0,0,0,1,0,1,0,0
S01009329,All households,203,67,3,64,125,1,103,55,44,4,21,17,4,11,2,0,1,8
S01009329,Occupancy rating +2 or more,73,12,1,11,58,1,53,20,30,3,4,3,1,3,0,0,1,2
S01009329,Occupancy rating +1,75,32,1,31,40,0,34,29,5,0,6,5,1,3,1,0,0,2
S01009329,Occupancy rating 0,49,20,1,19,25,0,14,6,7,1,11,9,2,4,0,0,0,4
S01009329,Occupancy rating -1 or less,6,3,0,3,2,0,2,0,2,0,0,0,0,1,1,0,0,0
S01009330,All households,183,27,3,24,143,2,113,40,66,7,28,23,5,13,8,0,0,5
S01009330,Occupancy rating +2 or more,80,10,1,9,66,2,57,24,31,2,7,5,2,4,3,0,0,1
S01009330,Occupancy rating +1,46,13,1,12,33,0,27,13,14,0,6,6,0,0,0,0,0,0
S01009330,Occupancy rating 0,47,3,1,2,40,0,25,2,18,5,15,12,3,4,2,0,0,2
S01009330,Occupancy rating -1 or less,10,1,0,1,4,0,4,1,3,0,0,0,0,5,3,0,0,2
S01009331,All households,180,15,1,14,158,6,145,36,99,10,7,5,2,7,6,0,0,1
S01009331,Occupancy rating +2 or more,157,13,1,12,137,6,126,35,84,7,5,4,1,7,6,0,0,1
S01009331,Occupancy rating +1,14,0,0,0,14,0,13,0,11,2,1,1,0,0,0,0,0,0
S01009331,Occupancy rating 0,6,2,0,2,4,0,3,0,2,1,1,0,1,0,0,0,0,0
S01009331,Occupancy rating -1 or less,3,0,0,0,3,0,3,1,2,0,0,0,0,0,0,0,0,0
S01009332,All households,333,49,24,25,274,34,221,91,105,25,19,12,7,10,5,0,2,3
S01009332,Occupancy rating +2 or more,261,44,22,22,211,33,167,86,65,16,11,7,4,6,4,0,0,2
S01009332,Occupancy rating +1,55,4,2,2,47,1,41,3,30,8,5,3,2,4,1,0,2,1
S01009332,Occupancy rating 0,13,1,0,1,12,0,9,1,7,1,3,2,1,0,0,0,0,0
S01009332,Occupancy rating -1 or less,4,0,0,0,4,0,4,1,3,0,0,0,0,0,0,0,0,0
S01009333,All households,355,145,59,86,195,15,133,60,59,14,47,32,15,15,4,0,2,9
S01009333,Occupancy rating +2 or more,87,40,12,28,47,8,37,27,7,3,2,0,2,0,0,0,0,0
S01009333,Occupancy rating +1,143,67,16,51,71,3,53,32,17,4,15,11,4,5,1,0,2,2
S01009333,Occupancy rating 0,104,35,30,5,62,4,37,1,31,5,21,13,8,7,1,0,0,6
S01009333,Occupancy rating -1 or less,21,3,1,2,15,0,6,0,4,2,9,8,1,3,2,0,0,1
S01009334,All households,310,126,47,79,169,19,92,38,38,16,58,44,14,15,5,0,0,10
S01009334,Occupancy rating +2 or more,97,43,27,16,54,12,36,23,9,4,6,3,3,0,0,0,0,0
S01009334,Occupancy rating +1,91,37,6,31,50,4,25,10,8,7,21,16,5,4,1,0,0,3
S01009334,Occupancy rating 0,98,40,12,28,51,2,27,4,19,4,22,17,5,7,0,0,0,7
S01009334,Occupancy rating -1 or less,24,6,2,4,14,1,4,1,2,1,9,8,1,4,4,0,0,0
S01009335,All households,337,109,35,74,213,16,153,73,55,25,44,31,13,15,8,0,1,6
S01009335,Occupancy rating +2 or more,136,52,18,34,83,11,70,56,11,3,2,1,1,1,0,0,0,1
S01009335,Occupancy rating +1,107,24,13,11,76,5,53,12,24,17,18,12,6,7,4,0,0,3
S01009335,Occupancy rating 0,69,30,4,26,36,0,22,5,13,4,14,11,3,3,1,0,1,1
S01009335,Occupancy rating -1 or less,25,3,0,3,18,0,8,0,7,1,10,7,3,4,3,0,0,1
S01009336,All households,318,116,32,84,188,15,91,33,42,16,82,60,22,14,5,0,1,8
S01009336,Occupancy rating +2 or more,68,30,17,13,37,10,25,17,4,4,2,0,2,1,1,0,0,0
S01009336,Occupancy rating +1,101,47,5,42,50,4,31,14,10,7,15,10,5,4,1,0,1,2
S01009336,Occupancy rating 0,117,34,10,24,79,1,27,2,20,5,51,40,11,4,1,0,0,3
S01009336,Occupancy rating -1 or less,32,5,0,5,22,0,8,0,8,0,14,10,4,5,2,0,0,3
S01009337,All households,318,99,30,69,199,16,119,49,56,14,64,48,16,20,9,1,1,9
S01009337,Occupancy rating +2 or more,57,25,8,17,30,7,22,15,3,4,1,1,0,2,1,0,0,1
S01009337,Occupancy rating +1,128,60,17,43,64,7,43,28,13,2,14,10,4,4,1,0,0,3
S01009337,Occupancy rating 0,100,10,3,7,80,2,38,4,28,6,40,31,9,10,4,0,1,5
S01009337,Occupancy rating -1 or less,33,4,2,2,25,0,16,2,12,2,9,6,3,4,3,1,0,0
S01009338,All households,401,217,75,142,173,25,110,53,39,18,38,22,16,11,5,0,0,6
S01009338,Occupancy rating +2 or more,85,40,22,18,44,12,29,25,3,1,3,2,1,1,0,0,0,1
S01009338,Occupancy rating +1,108,50,19,31,56,12,37,18,13,6,7,3,4,2,2,0,0,0
S01009338,Occupancy rating 0,178,109,28,81,61,1,38,10,19,9,22,14,8,8,3,0,0,5
S01009338,Occupancy rating -1 or less,30,18,6,12,12,0,6,0,4,2,6,3,3,0,0,0,0,0
S01009339,All households,391,155,44,111,219,15,119,46,60,13,85,64,21,17,10,0,0,7
S01009339,Occupancy rating +2 or more,78,36,12,24,40,9,24,17,5,2,7,4,3,2,1,0,0,1
S01009339,Occupancy rating +1,130,55,14,41,70,4,43,22,18,3,23,14,9,5,2,0,0,3
S01009339,Occupancy rating 0,142,54,16,38,82,1,35,5,23,7,46,39,7,6,4,0,0,2
S01009339,Occupancy rating -1 or less,41,10,2,8,27,1,17,2,14,1,9,7,2,4,3,0,0,1
S01009340,All households,283,102,46,56,169,20,95,38,35,22,54,41,13,12,4,0,0,8
S01009340,Occupancy rating +2 or more,72,32,17,15,39,8,26,21,2,3,5,4,1,1,0,0,0,1
S01009340,Occupancy rating +1,107,49,23,26,57,9,30,14,8,8,18,14,4,1,0,0,0,1
S01009340,Occupancy rating 0,78,17,3,14,55,3,30,2,20,8,22,14,8,6,1,0,0,5
S01009340,Occupancy rating -1 or less,26,4,3,1,18,0,9,1,5,3,9,9,0,4,3,0,0,1
S01009341,All households,270,96,39,57,157,18,96,36,40,20,43,19,24,17,4,0,1,12
S01009341,Occupancy rating +2 or more,77,38,17,21,39,9,27,18,4,5,3,0,3,0,0,0,0,0
S01009341,Occupancy rating +1,113,50,18,32,57,9,33,17,10,6,15,7,8,6,0,0,0,6
S01009341,Occupancy rating 0,62,4,1,3,50,0,30,1,21,8,20,10,10,8,2,0,0,6
S01009341,Occupancy rating -1 or less,18,4,3,1,11,0,6,0,5,1,5,2,3,3,2,0,1,0
S01009342,All households,333,95,39,56,229,27,151,63,61,27,51,31,20,9,1,0,2,6
S01009342,Occupancy rating +2 or more,97,39,20,19,58,15,40,33,6,1,3,2,1,0,0,0,0,0
S01009342,Occupancy rating +1,136,44,15,29,88,10,66,28,27,11,12,6,6,4,0,0,1,3
S01009342,Occupancy rating 0,81,11,4,7,67,2,35,0,21,14,30,19,11,3,0,0,0,3
S01009342,Occupancy rating -1 or less,19,1,0,1,16,0,10,2,7,1,6,4,2,2,1,0,1,0
S01009343,All households,242,60,18,42,170,14,119,48,50,21,37,25,12,12,7,0,0,5
S01009343,Occupancy rating +2 or more,57,18,9,9,39,8,26,19,5,2,5,4,1,0,0,0,0,0
S01009343,Occupancy rating +1,104,38,7,31,65,4,51,28,14,9,10,6,4,1,0,0,0,1
S01009343,Occupancy rating 0,68,2,0,2,58,2,35,1,27,7,21,14,7,8,5,0,0,3
S01009343,Occupancy rating -1 or less,13,2,2,0,8,0,7,0,4,3,1,1,0,3,2,0,0,1
S01009344,All households,288,84,42,42,190,32,115,56,44,15,43,24,19,14,7,0,0,7
S01009344,Occupancy rating +2 or more,54,20,12,8,31,10,19,15,3,1,2,0,2,3,1,0,0,2
S01009344,Occupancy rating +1,128,48,26,22,78,20,50,37,10,3,8,2,6,2,0,0,0,2
S01009344,Occupancy rating 0,84,14,3,11,66,2,36,4,23,9,28,18,10,4,2,0,0,2
S01009344,Occupancy rating -1 or less,22,2,1,1,15,0,10,0,8,2,5,4,1,5,4,0,0,1
S01009345,All households,379,77,30,47,289,31,189,76,83,30,69,47,22,13,8,0,0,5
S01009345,Occupancy rating +2 or more,149,34,10,24,111,23,79,56,13,10,9,5,4,4,1,0,0,3
S01009345,Occupancy rating +1,137,38,16,22,97,6,66,19,37,10,25,18,7,2,1,0,0,1
S01009345,Occupancy rating 0,67,2,2,0,62,1,33,1,25,7,28,21,7,3,2,0,0,1
S01009345,Occupancy rating -1 or less,26,3,2,1,19,1,11,0,8,3,7,3,4,4,4,0,0,0
S01009346,All households,228,15,3,12,201,5,186,54,124,8,10,8,2,12,10,0,0,2
S01009346,Occupancy rating +2 or more,201,14,3,11,181,5,170,52,111,7,6,5,1,6,5,0,0,1
S01009346,Occupancy rating +1,14,1,0,1,9,0,7,0,6,1,2,2,0,4,3,0,0,1
S01009346,Occupancy rating 0,8,0,0,0,7,0,6,1,5,0,1,1,0,1,1,0,0,0
S01009346,Occupancy rating -1 or less,5,0,0,0,4,0,3,1,2,0,1,0,1,1,1,0,0,0
S01009347,All households,216,12,2,10,202,5,190,46,131,13,7,6,1,2,0,0,0,2
S01009347,Occupancy rating +2 or more,206,10,1,9,195,5,183,44,128,11,7,6,1,1,0,0,0,1
S01009347,Occupancy rating +1,6,1,1,0,5,0,5,2,1,2,0,0,0,0,0,0,0,0
S01009347,Occupancy rating 0,4,1,0,1,2,0,2,0,2,0,0,0,0,1,0,0,0,1
S01009347,Occupancy rating -1 or less,0,0,0,0,0,0,0,0,0,0,0,0,0,0,0,0,0,0
S01009348,All households,161,12,2,10,141,3,133,31,93,9,5,3,2,8,7,0,0,1
S01009348,Occupancy rating +2 or more,137,11,2,9,120,3,112,30,76,6,5,3,2,6,6,0,0,0
S01009348,Occupancy rating +1,17,1,0,1,15,0,15,1,12,2,0,0,0,1,1,0,0,0
S01009348,Occupancy rating 0,4,0,0,0,4,0,4,0,4,0,0,0,0,0,0,0,0,0
S01009348,Occupancy rating -1 or less,3,0,0,0,2,0,2,0,1,1,0,0,0,1,0,0,0,1
S01009349,All households,288,45,6,39,232,3,211,76,123,12,18,16,2,11,6,0,0,5
S01009349,Occupancy rating +2 or more,217,18,3,15,193,3,179,60,108,11,11,10,1,6,5,0,0,1
S01009349,Occupancy rating +1,52,26,2,24,25,0,23,15,8,0,2,2,0,1,1,0,0,0
S01009349,Occupancy rating 0,14,1,1,0,10,0,6,1,4,1,4,3,1,3,0,0,0,3
S01009349,Occupancy rating -1 or less,5,0,0,0,4,0,3,0,3,0,1,1,0,1,0,0,0,1
S01009350,All households,240,54,11,43,177,4,145,54,83,8,28,26,2,9,5,0,0,4
S01009350,Occupancy rating +2 or more,95,16,3,13,77,1,74,25,43,6,2,1,1,2,2,0,0,0
S01009350,Occupancy rating +1,83,32,8,24,51,3,44,26,18,0,4,3,1,0,0,0,0,0
S01009350,Occupancy rating 0,49,0,0,0,44,0,23,3,18,2,21,21,0,5,1,0,0,4
S01009350,Occupancy rating -1 or less,13,6,0,6,5,0,4,0,4,0,1,1,0,2,2,0,0,0
S01009351,All households,213,57,3,54,143,2,133,62,67,4,8,6,2,13,6,0,0,7
S01009351,Occupancy rating +2 or more,110,16,0,16,90,2,83,28,53,2,5,4,1,4,3,0,0,1
S01009351,Occupancy rating +1,74,33,2,31,40,0,39,31,7,1,1,0,1,1,1,0,0,0
S01009351,Occupancy rating 0,25,7,1,6,11,0,9,3,6,0,2,2,0,7,1,0,0,6
S01009351,Occupancy rating -1 or less,4,1,0,1,2,0,2,0,1,1,0,0,0,1,1,0,0,0
S01009352,All households,290,41,7,34,241,4,210,82,120,8,27,23,4,8,1,0,0,7
S01009352,Occupancy rating +2 or more,211,28,3,25,180,2,166,65,93,8,12,9,3,3,1,0,0,2
S01009352,Occupancy rating +1,51,13,4,9,36,1,31,16,15,0,4,3,1,2,0,0,0,2
S01009352,Occupancy rating 0,26,0,0,0,23,1,12,1,11,0,10,10,0,3,0,0,0,3
S01009352,Occupancy rating -1 or less,2,0,0,0,2,0,1,0,1,0,1,1,0,0,0,0,0,0
S01009353,All households,147,18,2,16,123,7,106,46,52,8,10,8,2,6,4,0,0,2
S01009353,Occupancy rating +2 or more,106,9,2,7,94,7,81,37,36,8,6,5,1,3,1,0,0,2
S01009353,Occupancy rating +1,26,9,0,9,15,0,13,4,9,0,2,2,0,2,2,0,0,0
S01009353,Occupancy rating 0,13,0,0,0,12,0,10,3,7,0,2,1,1,1,1,0,0,0
S01009353,Occupancy rating -1 or less,2,0,0,0,2,0,2,2,0,0,0,0,0,0,0,0,0,0
S01009354,All households,297,28,3,25,262,5,238,67,154,17,19,15,4,7,3,0,0,4
S01009354,Occupancy rating +2 or more,249,23,2,21,220,5,203,62,126,15,12,10,2,6,3,0,0,3
S01009354,Occupancy rating +1,26,5,1,4,21,0,20,4,14,2,1,1,0,0,0,0,0,0
S01009354,Occupancy rating 0,19,0,0,0,18,0,13,1,12,0,5,3,2,1,0,0,0,1
S01009354,Occupancy rating -1 or less,3,0,0,0,3,0,2,0,2,0,1,1,0,0,0,0,0,0
S01009355,All households,367,82,40,42,275,43,210,95,71,44,22,12,10,10,6,0,0,4
S01009355,Occupancy rating +2 or more,253,57,34,23,189,40,138,88,33,17,11,6,5,7,4,0,0,3
S01009355,Occupancy rating +1,61,12,5,7,49,1,41,2,18,21,7,2,5,0,0,0,0,0
S01009355,Occupancy rating 0,50,13,1,12,35,1,30,5,19,6,4,4,0,2,2,0,0,0
S01009355,Occupancy rating -1 or less,3,0,0,0,2,1,1,0,1,0,0,0,0,1,0,0,0,1
S01009356,All households,411,90,47,43,312,55,222,100,76,46,35,18,17,9,5,0,0,4
S01009356,Occupancy rating +2 or more,258,58,33,25,198,47,141,84,34,23,10,2,8,2,2,0,0,0
S01009356,Occupancy rating +1,112,28,11,17,80,5,62,16,30,16,13,8,5,4,2,0,0,2
S01009356,Occupancy rating 0,36,4,3,1,30,2,17,0,12,5,11,7,4,2,0,0,0,2
S01009356,Occupancy rating -1 or less,5,0,0,0,4,1,2,0,0,2,1,1,0,1,1,0,0,0
S01009357,All households,179,19,1,18,155,7,134,61,63,10,14,12,2,5,1,0,0,4
S01009357,Occupancy rating +2 or more,132,6,0,6,124,7,111,51,50,10,6,6,0,2,0,0,0,2
S01009357,Occupancy rating +1,30,10,0,10,19,0,17,10,7,0,2,2,0,1,1,0,0,0
S01009357,Occupancy rating 0,14,3,1,2,9,0,5,0,5,0,4,4,0,2,0,0,0,2
S01009357,Occupancy rating -1 or less,3,0,0,0,3,0,1,0,1,0,2,0,2,0,0,0,0,0
S01009358,All households,256,28,12,16,217,15,195,75,99,21,7,5,2,11,5,0,0,6
S01009358,Occupancy rating +2 or more,236,25,10,15,203,14,182,73,93,16,7,5,2,8,3,0,0,5
S01009358,Occupancy rating +1,15,3,2,1,11,1,10,2,4,4,0,0,0,1,1,0,0,0
S01009358,Occupancy rating 0,4,0,0,0,3,0,3,0,2,1,0,0,0,1,0,0,0,1
S01009358,Occupancy rating -1 or less,1,0,0,0,0,0,0,0,0,0,0,0,0,1,1,0,0,0
S01009359,All households,277,29,2,27,240,11,203,77,110,16,26,20,6,8,4,0,0,4
S01009359,Occupancy rating +2 or more,190,17,1,16,169,8,148,60,76,12,13,9,4,4,2,0,0,2
S01009359,Occupancy rating +1,64,11,1,10,51,3,41,16,23,2,7,6,1,2,1,0,0,1
S01009359,Occupancy rating 0,21,0,0,0,19,0,13,1,10,2,6,5,1,2,1,0,0,1
S01009359,Occupancy rating -1 or less,2,1,0,1,1,0,1,0,1,0,0,0,0,0,0,0,0,0
S01009360,All households,376,119,54,65,237,37,171,78,70,23,29,17,12,20,9,0,1,10
S01009360,Occupancy rating +2 or more,200,50,25,25,146,30,110,57,39,14,6,3,3,4,1,0,1,2
S01009360,Occupancy rating +1,85,33,16,17,46,5,33,15,14,4,8,4,4,6,1,0,0,5
S01009360,Occupancy rating 0,80,34,13,21,40,1,25,6,15,4,14,10,4,6,3,0,0,3
S01009360,Occupancy rating -1 or less,11,2,0,2,5,1,3,0,2,1,1,0,1,4,4,0,0,0
S01009361,All households,342,103,46,57,231,37,166,73,63,30,28,16,12,8,4,0,0,4
S01009361,Occupancy rating +2 or more,195,46,24,22,148,29,105,59,30,16,14,7,7,1,1,0,0,0
S01009361,Occupancy rating +1,93,34,13,21,58,5,44,14,21,9,9,5,4,1,0,0,0,1
S01009361,Occupancy rating 0,42,20,6,14,19,2,13,0,8,5,4,3,1,3,2,0,0,1
S01009361,Occupancy rating -1 or less,12,3,3,0,6,1,4,0,4,0,1,1,0,3,1,0,0,2
S01009362,All households,417,79,41,38,331,62,244,102,100,42,25,13,12,7,2,0,0,5
S01009362,Occupancy rating +2 or more,278,55,32,23,222,60,156,92,45,19,6,4,2,1,0,0,0,1
S01009362,Occupancy rating +1,89,15,4,11,71,1,60,10,36,14,10,5,5,3,1,0,0,2
S01009362,Occupancy rating 0,39,9,5,4,29,1,22,0,16,6,6,2,4,1,0,0,0,1
S01009362,Occupancy rating -1 or less,11,0,0,0,9,0,6,0,3,3,3,2,1,2,1,0,0,1
S01009363,All households,373,103,40,63,258,36,173,77,70,26,49,28,21,12,4,0,1,7
S01009363,Occupancy rating +2 or more,148,43,17,26,101,28,68,41,19,8,5,1,4,4,2,0,0,2
S01009363,Occupancy rating +1,154,55,20,35,96,6,67,33,20,14,23,11,12,3,1,0,1,1
S01009363,Occupancy rating 0,57,5,3,2,48,2,33,3,26,4,13,12,1,4,1,0,0,3
S01009363,Occupancy rating -1 or less,14,0,0,0,13,0,5,0,5,0,8,4,4,1,0,0,0,1
S01009364,All households,325,61,15,46,246,13,192,76,79,37,41,20,21,18,6,0,1,11
S01009364,Occupancy rating +2 or more,167,36,11,25,122,8,100,53,29,18,14,7,7,9,4,0,0,5
S01009364,Occupancy rating +1,97,19,3,16,74,4,58,23,25,10,12,4,8,4,0,0,0,4
S01009364,Occupancy rating 0,52,6,1,5,43,0,29,0,20,9,14,9,5,3,2,0,0,1
S01009364,Occupancy rating -1 or less,9,0,0,0,7,1,5,0,5,0,1,0,1,2,0,0,1,1
S01009365,All households,277,99,38,61,172,25,113,57,40,16,34,22,12,6,0,1,0,5
S01009365,Occupancy rating +2 or more,100,24,10,14,76,19,50,34,12,4,7,4,3,0,0,0,0,0
S01009365,Occupancy rating +1,113,67,23,44,46,5,39,22,12,5,2,2,0,0,0,0,0,0
S01009365,Occupancy rating 0,52,4,2,2,43,1,20,1,13,6,22,14,8,5,0,1,0,4
S01009365,Occupancy rating -1 or less,12,4,3,1,7,0,4,0,3,1,3,2,1,1,0,0,0,1
S01009366,All households,351,121,65,56,208,24,133,61,49,23,51,28,23,22,6,0,0,16
S01009366,Occupancy rating +2 or more,150,65,40,25,78,14,56,42,10,4,8,3,5,7,1,0,0,6
S01009366,Occupancy rating +1,118,36,16,20,74,10,46,17,19,10,18,11,7,8,3,0,0,5
S01009366,Occupancy rating 0,66,16,7,9,45,0,22,1,16,5,23,12,11,5,1,0,0,4
S01009366,Occupancy rating -1 or less,17,4,2,2,11,0,9,1,4,4,2,2,0,2,1,0,0,1
S01009367,All households,296,101,39,62,181,22,115,47,52,16,44,27,17,14,7,0,1,6
S01009367,Occupancy rating +2 or more,87,35,17,18,52,13,37,27,7,3,2,1,1,0,0,0,0,0
S01009367,Occupancy rating +1,116,59,18,41,55,6,35,19,9,7,14,8,6,2,1,0,0,1
S01009367,Occupancy rating 0,68,4,3,1,61,3,33,0,28,5,25,16,9,3,2,0,0,1
S01009367,Occupancy rating -1 or less,25,3,1,2,13,0,10,1,8,1,3,2,1,9,4,0,1,4
S01009368,All households,211,34,11,23,165,11,116,40,54,22,38,24,14,12,3,0,1,8
S01009368,Occupancy rating +2 or more,74,23,11,12,50,10,39,31,4,4,1,1,0,1,1,0,0,0
S01009368,Occupancy rating +1,65,11,0,11,50,1,38,9,15,14,11,4,7,4,0,0,0,4
S01009368,Occupancy rating 0,58,0,0,0,53,0,32,0,29,3,21,15,6,5,0,0,1,4
S01009368,Occupancy rating -1 or less,14,0,0,0,12,0,7,0,6,1,5,4,1,2,2,0,0,0
S01009369,All households,255,73,34,39,171,24,118,40,56,22,29,21,8,11,4,0,3,4
S01009369,Occupancy rating +2 or more,94,32,15,17,60,15,43,24,14,5,2,1,1,2,1,0,0,1
S01009369,Occupancy rating +1,97,36,16,20,57,7,41,15,19,7,9,5,4,4,2,0,2,0
S01009369,Occupancy rating 0,54,3,2,1,47,2,30,1,21,8,15,13,2,4,0,0,1,3
S01009369,Occupancy rating -1 or less,10,2,1,1,7,0,4,0,2,2,3,2,1,1,1,0,0,0
S01009370,All households,381,103,47,56,252,41,163,78,47,38,48,24,24,26,6,0,2,18
S01009370,Occupancy rating +2 or more,168,56,25,31,111,27,80,51,18,11,4,1,3,1,0,0,0,1
S01009370,Occupancy rating +1,135,37,17,20,88,13,54,24,11,19,21,6,15,10,0,0,2,8
S01009370,Occupancy rating 0,64,10,5,5,45,0,26,3,16,7,19,15,4,9,3,0,0,6
S01009370,Occupancy rating -1 or less,14,0,0,0,8,1,3,0,2,1,4,2,2,6,3,0,0,3
S01009371,All households,242,74,32,42,163,19,119,59,46,14,25,18,7,5,0,0,0,5
S01009371,Occupancy rating +2 or more,91,35,20,15,55,11,43,34,8,1,1,1,0,1,0,0,0,1
S01009371,Occupancy rating +1,83,28,8,20,53,4,40,23,11,6,9,7,2,2,0,0,0,2
S01009371,Occupancy rating 0,54,6,3,3,47,4,29,1,22,6,14,9,5,1,0,0,0,1
S01009371,Occupancy rating -1 or less,14,5,1,4,8,0,7,1,5,1,1,1,0,1,0,0,0,1
S01009372,All households,219,62,24,38,152,11,115,41,45,29,26,18,8,5,2,0,2,1
S01009372,Occupancy rating +2 or more,71,29,13,16,41,6,31,21,5,5,4,2,2,1,0,0,0,1
S01009372,Occupancy rating +1,84,28,10,18,55,4,44,19,9,16,7,3,4,1,0,0,1,0
S01009372,Occupancy rating 0,49,5,1,4,42,1,29,0,23,6,12,10,2,2,1,0,1,0
S01009372,Occupancy rating -1 or less,15,0,0,0,14,0,11,1,8,2,3,3,0,1,1,0,0,0
S01009373,All households,398,158,54,104,227,21,145,71,61,13,61,43,18,13,4,1,1,7
S01009373,Occupancy rating +2 or more,76,30,12,18,44,10,31,24,6,1,3,3,0,2,0,0,0,2
S01009373,Occupancy rating +1,169,92,28,64,76,9,61,43,11,7,6,3,3,1,1,0,0,0
S01009373,Occupancy rating 0,132,33,14,19,91,2,44,3,37,4,45,31,14,8,1,1,1,5
S01009373,Occupancy rating -1 or less,21,3,0,3,16,0,9,1,7,1,7,6,1,2,2,0,0,0
S01009374,All households,432,191,107,84,226,24,161,69,60,32,41,22,19,15,3,0,0,12
S01009374,Occupancy rating +2 or more,133,52,26,26,80,8,67,47,9,11,5,2,3,1,0,0,0,1
S01009374,Occupancy rating +1,134,53,24,29,74,12,47,17,20,10,15,8,7,7,1,0,0,6
S01009374,Occupancy rating 0,129,69,48,21,57,4,37,3,25,9,16,10,6,3,1,0,0,2
S01009374,Occupancy rating -1 or less,36,17,9,8,15,0,10,2,6,2,5,2,3,4,1,0,0,3
S01009375,All households,337,89,35,54,231,24,154,57,66,31,53,38,15,17,5,0,2,10
S01009375,Occupancy rating +2 or more,100,37,18,19,62,11,48,35,9,4,3,1,2,1,0,0,1,0
S01009375,Occupancy rating +1,120,40,11,29,77,10,52,21,18,13,15,10,5,3,0,0,0,3
S01009375,Occupancy rating 0,91,8,6,2,73,2,43,1,29,13,28,21,7,10,2,0,1,7
S01009375,Occupancy rating -1 or less,26,4,0,4,19,1,11,0,10,1,7,6,1,3,3,0,0,0
S01009376,All households,271,102,45,57,162,14,114,48,45,21,34,20,14,7,2,0,0,5
S01009376,Occupancy rating +2 or more,89,36,20,16,53,8,45,38,5,2,0,0,0,0,0,0,0,0
S01009376,Occupancy rating +1,84,25,11,14,57,4,38,8,22,8,15,8,7,2,0,0,0,2
S01009376,Occupancy rating 0,78,39,14,25,38,2,22,2,13,7,14,12,2,1,0,0,0,1
S01009376,Occupancy rating -1 or less,20,2,0,2,14,0,9,0,5,4,5,0,5,4,2,0,0,2
S01009377,All households,373,83,4,79,261,5,202,68,113,21,54,42,12,29,10,0,0,19
S01009377,Occupancy rating +2 or more,142,43,3,40,97,2,90,45,32,13,5,3,2,2,2,0,0,0
S01009377,Occupancy rating +1,132,31,1,30,93,2,60,17,39,4,31,24,7,8,2,0,0,6
S01009377,Occupancy rating 0,78,8,0,8,59,0,43,6,33,4,16,13,3,11,2,0,0,9
S01009377,Occupancy rating -1 or less,21,1,0,1,12,1,9,0,9,0,2,2,0,8,4,0,0,4
S01009378,All households,388,83,20,63,287,21,182,59,91,32,84,69,15,18,8,1,1,8
S01009378,Occupancy rating +2 or more,154,44,16,28,107,12,85,44,28,13,10,7,3,3,2,0,0,1
S01009378,Occupancy rating +1,112,29,4,25,78,6,49,14,24,11,23,17,6,5,1,1,0,3
S01009378,Occupancy rating 0,83,9,0,9,69,1,34,1,27,6,34,29,5,5,1,0,0,4
S01009378,Occupancy rating -1 or less,39,1,0,1,33,2,14,0,12,2,17,16,1,5,4,0,1,0
S01009379,All households,337,51,7,44,269,6,218,61,138,19,45,35,10,17,12,0,0,5
S01009379,Occupancy rating +2 or more,188,26,4,22,154,5,133,40,80,13,16,13,3,8,5,0,0,3
S01009379,Occupancy rating +1,70,16,1,15,52,1,43,15,25,3,8,6,2,2,2,0,0,0
S01009379,Occupancy rating 0,60,8,2,6,48,0,34,4,27,3,14,10,4,4,3,0,0,1
S01009379,Occupancy rating -1 or less,19,1,0,1,15,0,8,2,6,0,7,6,1,3,2,0,0,1
S01009380,All households,200,28,4,24,161,4,136,51,60,25,21,14,7,11,5,1,0,5
S01009380,Occupancy rating +2 or more,119,13,2,11,101,3,88,46,28,14,10,6,4,5,2,0,0,3
S01009380,Occupancy rating +1,42,11,2,9,29,1,25,4,14,7,3,1,2,2,1,1,0,0
S01009380,Occupancy rating 0,34,4,0,4,27,0,20,1,16,3,7,6,1,3,2,0,0,1
S01009380,Occupancy rating -1 or less,5,0,0,0,4,0,3,0,2,1,1,1,0,1,0,0,0,1
S01009381,All households,284,83,21,62,184,10,146,77,55,14,28,14,14,17,8,0,0,9
S01009381,Occupancy rating +2 or more,114,29,13,16,83,9,71,40,21,10,3,2,1,2,1,0,0,1
S01009381,Occupancy rating +1,100,37,4,33,58,1,50,30,17,3,7,2,5,5,3,0,0,2
S01009381,Occupancy rating 0,58,15,3,12,34,0,20,6,13,1,14,7,7,9,4,0,0,5
S01009381,Occupancy rating -1 or less,12,2,1,1,9,0,5,1,4,0,4,3,1,1,0,0,0,1
S01009382,All households,377,140,77,63,223,30,152,73,54,25,41,24,17,14,2,0,1,11
S01009382,Occupancy rating +2 or more,121,33,21,12,85,17,65,47,11,7,3,1,2,3,1,0,0,2
S01009382,Occupancy rating +1,112,40,14,26,66,5,50,21,18,11,11,4,7,6,1,0,1,4
S01009382,Occupancy rating 0,120,58,38,20,57,6,33,4,23,6,18,13,5,5,0,0,0,5
S01009382,Occupancy rating -1 or less,24,9,4,5,15,2,4,1,2,1,9,6,3,0,0,0,0,0
S01009383,All households,439,213,44,169,210,22,130,67,48,15,58,38,20,16,7,0,0,9
S01009383,Occupancy rating +2 or more,85,34,14,20,50,12,33,23,8,2,5,3,2,1,0,0,0,1
S01009383,Occupancy rating +1,140,75,17,58,64,8,44,34,9,1,12,6,6,1,0,0,0,1
S01009383,Occupancy rating 0,169,87,12,75,74,1,46,8,27,11,27,20,7,8,3,0,0,5
S01009383,Occupancy rating -1 or less,45,17,1,16,22,1,7,2,4,1,14,9,5,6,4,0,0,2
S01009384,All households,248,60,26,34,180,29,132,72,52,8,19,8,11,8,1,0,0,7
S01009384,Occupancy rating +2 or more,176,31,19,12,141,25,104,59,38,7,12,2,10,4,0,0,0,4
S01009384,Occupancy rating +1,33,10,3,7,22,2,20,10,9,1,0,0,0,1,0,0,0,1
S01009384,Occupancy rating 0,30,16,2,14,13,2,6,3,3,0,5,4,1,1,0,0,0,1
S01009384,Occupancy rating -1 or less,9,3,2,1,4,0,2,0,2,0,2,2,0,2,1,0,0,1
S01009385,All households,220,54,28,26,152,15,112,60,37,15,25,18,7,14,5,0,1,8
S01009385,Occupancy rating +2 or more,103,28,16,12,74,11,60,36,19,5,3,2,1,1,1,0,0,0
S01009385,Occupancy rating +1,66,21,12,9,42,3,35,23,5,7,4,1,3,3,2,0,0,1
S01009385,Occupancy rating 0,38,4,0,4,27,1,14,0,11,3,12,10,2,7,0,0,1,6
S01009385,Occupancy rating -1 or less,13,1,0,1,9,0,3,1,2,0,6,5,1,3,2,0,0,1
S01009386,All households,279,68,29,39,198,41,124,49,55,20,33,19,14,13,6,0,1,6
S01009386,Occupancy rating +2 or more,121,41,19,22,78,26,48,39,8,1,4,1,3,2,0,0,0,2
S01009386,Occupancy rating +1,89,23,8,15,63,12,39,9,20,10,12,6,6,3,0,0,0,3
S01009386,Occupancy rating 0,54,3,1,2,45,2,30,1,21,8,13,8,5,6,4,0,1,1
S01009386,Occupancy rating -1 or less,15,1,1,0,12,1,7,0,6,1,4,4,0,2,2,0,0,0
S01009387,All households,260,64,26,38,188,25,116,49,45,22,47,34,13,8,3,0,1,4
S01009387,Occupancy rating +2 or more,104,34,19,15,67,19,45,34,8,3,3,1,2,3,0,0,0,3
S01009387,Occupancy rating +1,86,25,6,19,60,6,38,12,15,11,16,8,8,1,0,0,1,0
S01009387,Occupancy rating 0,58,4,1,3,51,0,28,2,21,5,23,22,1,3,2,0,0,1
S01009387,Occupancy rating -1 or less,12,1,0,1,10,0,5,1,1,3,5,3,2,1,1,0,0,0
S01009388,All households,423,157,35,122,252,10,147,55,76,16,95,79,16,14,3,2,0,9
S01009388,Occupancy rating +2 or more,65,29,5,24,34,1,29,16,13,0,4,3,1,2,0,0,0,2
S01009388,Occupancy rating +1,168,85,16,69,80,6,53,29,14,10,21,16,5,3,1,0,0,2
S01009388,Occupancy rating 0,146,35,13,22,108,3,48,7,36,5,57,48,9,3,0,0,0,3
S01009388,Occupancy rating -1 or less,44,8,1,7,30,0,17,3,13,1,13,12,1,6,2,2,0,2
S01009389,All households,460,186,64,122,259,45,186,100,61,25,28,13,15,15,3,0,2,10
S01009389,Occupancy rating +2 or more,193,48,22,26,141,35,103,67,24,12,3,0,3,4,1,0,0,3
S01009389,Occupancy rating +1,96,33,8,25,60,4,46,18,21,7,10,5,5,3,1,0,0,2
S01009389,Occupancy rating 0,140,86,32,54,50,6,34,13,15,6,10,6,4,4,0,0,1,3
S01009389,Occupancy rating -1 or less,31,19,2,17,8,0,3,2,1,0,5,2,3,4,1,0,1,2
S01009390,All households,270,45,15,30,220,10,197,50,132,15,13,12,1,5,3,0,0,2
S01009390,Occupancy rating +2 or more,208,24,10,14,181,8,165,40,115,10,8,7,1,3,2,0,0,1
S01009390,Occupancy rating +1,47,19,4,15,27,2,23,9,11,3,2,2,0,1,1,0,0,0
S01009390,Occupancy rating 0,12,0,0,0,11,0,8,0,6,2,3,3,0,1,0,0,0,1
S01009390,Occupancy rating -1 or less,3,2,1,1,1,0,1,1,0,0,0,0,0,0,0,0,0,0
S01009391,All households,259,41,4,37,209,7,182,64,104,14,20,15,5,9,4,0,1,4
S01009391,Occupancy rating +2 or more,157,26,4,22,127,6,118,51,61,6,3,1,2,4,2,0,1,1
S01009391,Occupancy rating +1,67,15,0,15,49,1,43,13,25,5,5,3,2,3,1,0,0,2
S01009391,Occupancy rating 0,29,0,0,0,28,0,19,0,16,3,9,8,1,1,1,0,0,0
S01009391,Occupancy rating -1 or less,6,0,0,0,5,0,2,0,2,0,3,3,0,1,0,0,0,1
S01009392,All households,193,24,5,19,165,7,150,43,101,6,8,8,0,4,3,1,0,0
S01009392,Occupancy rating +2 or more,134,17,3,14,117,6,107,37,66,4,4,4,0,0,0,0,0,0
S01009392,Occupancy rating +1,39,7,2,5,31,1,28,5,22,1,2,2,0,1,1,0,0,0
S01009392,Occupancy rating 0,18,0,0,0,16,0,15,1,13,1,1,1,0,2,1,1,0,0
S01009392,Occupancy rating -1 or less,2,0,0,0,1,0,0,0,0,0,1,1,0,1,1,0,0,0
S01009393,All households,265,46,19,27,209,21,166,64,69,33,22,15,7,10,6,0,1,3
S01009393,Occupancy rating +2 or more,158,28,11,17,127,16,105,51,39,15,6,5,1,3,1,0,1,1
S01009393,Occupancy rating +1,77,16,6,10,57,4,45,12,18,15,8,5,3,4,4,0,0,0
S01009393,Occupancy rating 0,19,1,1,0,16,1,9,1,6,2,6,4,2,2,0,0,0,2
S01009393,Occupancy rating -1 or less,11,1,1,0,9,0,7,0,6,1,2,1,1,1,1,0,0,0
S01009394,All households,451,188,54,134,250,35,191,98,79,14,24,21,3,13,2,2,1,8
S01009394,Occupancy rating +2 or more,145,29,10,19,112,18,92,48,33,11,2,1,1,4,2,1,1,0
S01009394,Occupancy rating +1,198,114,38,76,81,17,58,41,14,3,6,5,1,3,0,0,0,3
S01009394,Occupancy rating 0,92,37,5,32,51,0,37,7,30,0,14,13,1,4,0,1,0,3
S01009394,Occupancy rating -1 or less,16,8,1,7,6,0,4,2,2,0,2,2,0,2,0,0,0,2
S01009395,All households,305,73,51,22,224,53,152,86,47,19,19,9,10,8,4,0,0,4
S01009395,Occupancy rating +2 or more,245,49,30,19,190,45,133,81,37,15,12,4,8,6,3,0,0,3
S01009395,Occupancy rating +1,44,16,14,2,26,8,15,5,7,3,3,3,0,2,1,0,0,1
S01009395,Occupancy rating 0,13,6,5,1,7,0,4,0,3,1,3,2,1,0,0,0,0,0
S01009395,Occupancy rating -1 or less,3,2,2,0,1,0,0,0,0,0,1,0,1,0,0,0,0,0
S01009396,All households,301,50,24,26,238,52,170,89,62,19,16,11,5,13,7,0,0,6
S01009396,Occupancy rating +2 or more,260,43,19,24,210,46,151,82,54,15,13,10,3,7,3,0,0,4
S01009396,Occupancy rating +1,24,6,4,2,15,5,8,4,3,1,2,1,1,3,2,0,0,1
S01009396,Occupancy rating 0,16,1,1,0,12,0,11,3,5,3,1,0,1,3,2,0,0,1
S01009396,Occupancy rating -1 or less,1,0,0,0,1,1,0,0,0,0,0,0,0,0,0,0,0,0
S01009397,All households,330,113,45,68,207,35,154,79,51,24,18,11,7,10,4,0,0,6
S01009397,Occupancy rating +2 or more,183,18,13,5,158,27,124,56,47,21,7,4,3,7,4,0,0,3
S01009397,Occupancy rating +1,48,26,11,15,22,6,14,11,1,2,2,1,1,0,0,0,0,0
S01009397,Occupancy rating 0,73,51,17,34,20,2,11,10,1,0,7,5,2,2,0,0,0,2
S01009397,Occupancy rating -1 or less,26,18,4,14,7,0,5,2,2,1,2,1,1,1,0,0,0,1
S01009398,All households,308,97,28,69,206,21,160,70,74,16,25,15,10,5,4,0,0,1
S01009398,Occupancy rating +2 or more,132,29,12,17,102,15,81,45,28,8,6,2,4,1,0,0,0,1
S01009398,Occupancy rating +1,99,44,9,35,52,5,42,18,19,5,5,3,2,3,3,0,0,0
S01009398,Occupancy rating 0,66,20,7,13,46,1,32,7,22,3,13,9,4,0,0,0,0,0
S01009398,Occupancy rating -1 or less,11,4,0,4,6,0,5,0,5,0,1,1,0,1,1,0,0,0
S01009399,All households,311,84,45,39,223,37,167,78,57,32,19,11,8,4,1,0,1,2
S01009399,Occupancy rating +2 or more,179,47,31,16,132,29,94,50,31,13,9,5,4,0,0,0,0,0
S01009399,Occupancy rating +1,91,32,13,19,57,7,48,27,13,8,2,1,1,2,0,0,1,1
S01009399,Occupancy rating 0,29,5,1,4,23,1,16,1,6,9,6,3,3,1,0,0,0,1
S01009399,Occupancy rating -1 or less,12,0,0,0,11,0,9,0,7,2,2,2,0,1,1,0,0,0
S01009400,All households,221,58,36,22,152,21,103,38,38,27,28,19,9,11,4,0,2,5
S01009400,Occupancy rating +2 or more,91,27,16,11,61,14,45,26,10,9,2,1,1,3,1,0,0,2
S01009400,Occupancy rating +1,82,24,17,7,53,4,39,12,16,11,10,6,4,5,1,0,1,3
S01009400,Occupancy rating 0,38,5,3,2,32,2,16,0,11,5,14,11,3,1,0,0,1,0
S01009400,Occupancy rating -1 or less,10,2,0,2,6,1,3,0,1,2,2,1,1,2,2,0,0,0
S01009401,All households,284,57,35,22,220,57,144,58,61,25,19,10,9,7,2,0,1,4
S01009401,Occupancy rating +2 or more,207,42,26,16,161,48,104,54,33,17,9,4,5,4,1,0,1,2
S01009401,Occupancy rating +1,59,14,9,5,45,9,29,3,20,6,7,3,4,0,0,0,0,0
S01009401,Occupancy rating 0,16,1,0,1,13,0,10,1,7,2,3,3,0,2,1,0,0,1
S01009401,Occupancy rating -1 or less,2,0,0,0,1,0,1,0,1,0,0,0,0,1,0,0,0,1
S01009402,All households,397,92,61,31,299,59,217,97,92,28,23,14,9,6,5,0,0,1
S01009402,Occupancy rating +2 or more,276,61,40,21,214,54,152,87,53,12,8,5,3,1,1,0,0,0
S01009402,Occupancy rating +1,80,26,18,8,52,4,38,10,20,8,10,4,6,2,2,0,0,0
S01009402,Occupancy rating 0,34,5,3,2,27,0,24,0,17,7,3,3,0,2,2,0,0,0
S01009402,Occupancy rating -1 or less,7,0,0,0,6,1,3,0,2,1,2,2,0,1,0,0,0,1
S01009403,All households,206,38,15,23,164,11,134,54,67,13,19,16,3,4,1,0,1,2
S01009403,Occupancy rating +2 or more,122,25,9,16,96,8,85,45,37,3,3,1,2,1,1,0,0,0
S01009403,Occupancy rating +1,52,9,4,5,41,2,31,9,18,4,8,8,0,2,0,0,1,1
S01009403,Occupancy rating 0,30,4,2,2,25,1,16,0,10,6,8,7,1,1,0,0,0,1
S01009403,Occupancy rating -1 or less,2,0,0,0,2,0,2,0,2,0,0,0,0,0,0,0,0,0
S01009404,All households,232,62,22,40,151,15,85,39,28,18,51,35,16,19,9,0,0,10
S01009404,Occupancy rating +2 or more,87,32,10,22,54,10,36,25,8,3,8,5,3,1,1,0,0,0
S01009404,Occupancy rating +1,70,20,7,13,45,3,25,12,7,6,17,10,7,5,0,0,0,5
S01009404,Occupancy rating 0,54,7,3,4,38,0,17,1,10,6,21,16,5,9,6,0,0,3
S01009404,Occupancy rating -1 or less,21,3,2,1,14,2,7,1,3,3,5,4,1,4,2,0,0,2
S01009405,All households,157,28,13,15,126,21,99,35,43,21,6,1,5,3,1,0,0,2
S01009405,Occupancy rating +2 or more,88,13,3,10,73,16,54,22,23,9,3,1,2,2,1,0,0,1
S01009405,Occupancy rating +1,43,10,7,3,33,5,26,12,9,5,2,0,2,0,0,0,0,0
S01009405,Occupancy rating 0,23,4,3,1,18,0,17,1,10,6,1,0,1,1,0,0,0,1
S01009405,Occupancy rating -1 or less,3,1,0,1,2,0,2,0,1,1,0,0,0,0,0,0,0,0
S01009406,All households,429,153,66,87,263,30,190,91,72,27,43,27,16,13,5,0,1,7
S01009406,Occupancy rating +2 or more,156,42,25,17,112,23,82,53,15,14,7,2,5,2,0,0,0,2
S01009406,Occupancy rating +1,126,59,26,33,64,5,54,23,25,6,5,2,3,3,1,0,0,2
S01009406,Occupancy rating 0,121,44,15,29,72,1,47,12,29,6,24,19,5,5,1,0,1,3
S01009406,Occupancy rating -1 or less,26,8,0,8,15,1,7,3,3,1,7,4,3,3,3,0,0,0
S01009407,All households,227,61,23,38,162,27,117,62,47,8,18,11,7,4,2,0,0,2
S01009407,Occupancy rating +2 or more,99,28,11,17,70,14,54,37,16,1,2,2,0,1,1,0,0,0
S01009407,Occupancy rating +1,76,26,11,15,50,12,35,20,11,4,3,0,3,0,0,0,0,0
S01009407,Occupancy rating 0,39,4,0,4,33,0,21,4,15,2,12,9,3,2,0,0,0,2
S01009407,Occupancy rating -1 or less,13,3,1,2,9,1,7,1,5,1,1,0,1,1,1,0,0,0
S01009408,All households,307,62,15,47,238,22,195,97,75,23,21,16,5,7,3,0,0,4
S01009408,Occupancy rating +2 or more,173,30,9,21,142,13,124,78,32,14,5,4,1,1,1,0,0,0
S01009408,Occupancy rating +1,73,17,2,15,54,8,39,14,20,5,7,4,3,2,0,0,0,2
S01009408,Occupancy rating 0,51,15,4,11,34,1,28,5,19,4,5,4,1,2,1,0,0,1
S01009408,Occupancy rating -1 or less,10,0,0,0,8,0,4,0,4,0,4,4,0,2,1,0,0,1
S01009409,All households,308,95,53,42,202,38,127,59,49,19,37,27,10,11,5,0,1,5
S01009409,Occupancy rating +2 or more,115,41,27,14,71,21,47,37,9,1,3,3,0,3,0,0,1,2
S01009409,Occupancy rating +1,104,31,17,14,68,11,43,17,17,9,14,9,5,5,2,0,0,3
S01009409,Occupancy rating 0,65,19,7,12,45,5,28,3,18,7,12,10,2,1,1,0,0,0
S01009409,Occupancy rating -1 or less,24,4,2,2,18,1,9,2,5,2,8,5,3,2,2,0,0,0
S01009410,All households,351,97,28,69,235,19,173,59,73,41,43,32,11,19,10,0,0,9
S01009410,Occupancy rating +2 or more,106,38,13,25,65,12,51,33,12,6,2,0,2,3,1,0,0,2
S01009410,Occupancy rating +1,112,35,8,27,75,5,52,23,16,13,18,12,6,2,1,0,0,1
S01009410,Occupancy rating 0,94,21,7,14,67,2,47,1,30,16,18,16,2,6,2,0,0,4
S01009410,Occupancy rating -1 or less,39,3,0,3,28,0,23,2,15,6,5,4,1,8,6,0,0,2
S01009411,All households,364,108,44,64,234,22,168,65,73,30,44,23,21,22,13,0,0,9
S01009411,Occupancy rating +2 or more,115,46,23,23,66,13,51,40,7,4,2,2,0,3,2,0,0,1
S01009411,Occupancy rating +1,118,36,16,20,74,7,57,21,24,12,10,3,7,8,3,0,0,5
S01009411,Occupancy rating 0,101,22,1,21,72,0,45,4,29,12,27,13,14,7,4,0,0,3
S01009411,Occupancy rating -1 or less,30,4,4,0,22,2,15,0,13,2,5,5,0,4,4,0,0,0
S01009412,All households,407,156,60,96,238,30,161,67,61,33,47,25,22,13,5,0,0,8
S01009412,Occupancy rating +2 or more,104,44,28,16,59,11,43,35,5,3,5,3,2,1,0,0,0,1
S01009412,Occupancy rating +1,137,43,18,25,91,15,62,25,22,15,14,5,9,3,0,0,0,3
S01009412,Occupancy rating 0,136,61,11,50,69,2,45,5,29,11,22,14,8,6,2,0,0,4
S01009412,Occupancy rating -1 or less,30,8,3,5,19,2,11,2,5,4,6,3,3,3,3,0,0,0
S01009413,All households,456,161,74,87,281,37,210,88,81,41,34,20,14,14,8,0,0,6
S01009413,Occupancy rating +2 or more,140,52,24,28,85,14,69,46,11,12,2,1,1,3,1,0,0,2
S01009413,Occupancy rating +1,163,67,32,35,93,18,69,36,23,10,6,3,3,3,2,0,0,1
S01009413,Occupancy rating 0,120,34,14,20,80,4,57,5,38,14,19,13,6,6,3,0,0,3
S01009413,Occupancy rating -1 or less,33,8,4,4,23,1,15,1,9,5,7,3,4,2,2,0,0,0
S01009414,All households,292,70,42,28,213,27,150,77,44,29,36,24,12,9,4,0,2,3
S01009414,Occupancy rating +2 or more,131,36,21,15,93,15,73,55,8,10,5,3,2,2,0,0,1,1
S01009414,Occupancy rating +1,85,20,11,9,63,9,43,18,14,11,11,7,4,2,0,0,1,1
S01009414,Occupancy rating 0,56,10,7,3,45,3,29,4,18,7,13,7,6,1,0,0,0,1
S01009414,Occupancy rating -1 or less,20,4,3,1,12,0,5,0,4,1,7,7,0,4,4,0,0,0
S01009415,All households,386,163,58,105,205,20,149,71,58,20,36,23,13,18,8,0,2,8
S01009415,Occupancy rating +2 or more,103,35,12,23,64,6,53,33,15,5,5,2,3,4,2,0,1,1
S01009415,Occupancy rating +1,136,56,28,28,74,10,55,29,18,8,9,6,3,6,2,0,1,3
S01009415,Occupancy rating 0,114,57,13,44,52,4,31,7,19,5,17,12,5,5,1,0,0,4
S01009415,Occupancy rating -1 or less,33,15,5,10,15,0,10,2,6,2,5,3,2,3,3,0,0,0
S01009416,All households,201,32,21,11,162,24,124,40,53,31,14,11,3,7,5,0,1,1
S01009416,Occupancy rating +2 or more,111,26,17,9,83,16,64,31,17,16,3,1,2,2,1,0,0,1
S01009416,Occupancy rating +1,52,5,3,2,44,6,34,9,17,8,4,3,1,3,2,0,1,0
S01009416,Occupancy rating 0,32,1,1,0,30,1,22,0,15,7,7,7,0,1,1,0,0,0
S01009416,Occupancy rating -1 or less,6,0,0,0,5,1,4,0,4,0,0,0,0,1,1,0,0,0
S01009417,All households,114,14,1,13,96,9,79,29,39,11,8,7,1,4,0,0,0,4
S01009417,Occupancy rating +2 or more,82,10,1,9,70,5,60,25,27,8,5,4,1,2,0,0,0,2
S01009417,Occupancy rating +1,20,2,0,2,18,4,14,4,7,3,0,0,0,0,0,0,0,0
S01009417,Occupancy rating 0,9,1,0,1,6,0,4,0,4,0,2,2,0,2,0,0,0,2
S01009417,Occupancy rating -1 or less,3,1,0,1,2,0,1,0,1,0,1,1,0,0,0,0,0,0
S01009418,All households,517,189,88,101,308,36,227,102,77,48,45,25,20,20,9,0,2,9
S01009418,Occupancy rating +2 or more,150,46,23,23,101,22,74,46,19,9,5,3,2,3,3,0,0,0
S01009418,Occupancy rating +1,172,68,39,29,99,10,77,41,15,21,12,5,7,5,1,0,0,4
S01009418,Occupancy rating 0,147,49,21,28,91,2,65,15,36,14,24,15,9,7,1,0,1,5
S01009418,Occupancy rating -1 or less,48,26,5,21,17,2,11,0,7,4,4,2,2,5,4,0,1,0
S01009419,All households,245,75,34,41,159,16,106,39,50,17,37,25,12,11,4,0,1,6
S01009419,Occupancy rating +2 or more,75,25,13,12,49,10,34,21,8,5,5,3,2,1,0,0,0,1
S01009419,Occupancy rating +1,82,35,17,18,43,5,31,17,10,4,7,4,3,4,2,0,0,2
S01009419,Occupancy rating 0,74,12,4,8,56,1,33,1,25,7,22,16,6,6,2,0,1,3
S01009419,Occupancy rating -1 or less,14,3,0,3,11,0,8,0,7,1,3,2,1,0,0,0,0,0
S01009420,All households,253,66,21,45,176,10,102,30,56,16,64,49,15,11,2,0,0,9
S01009420,Occupancy rating +2 or more,85,46,16,30,39,6,28,19,4,5,5,3,2,0,0,0,0,0
S01009420,Occupancy rating +1,75,10,3,7,59,4,32,8,16,8,23,19,4,6,0,0,0,6
S01009420,Occupancy rating 0,73,5,1,4,64,0,34,2,29,3,30,22,8,4,1,0,0,3
S01009420,Occupancy rating -1 or less,20,5,1,4,14,0,8,1,7,0,6,5,1,1,1,0,0,0
S01009421,All households,295,73,25,48,205,30,116,43,51,22,59,44,15,17,8,0,0,9
S01009421,Occupancy rating +2 or more,116,39,11,28,74,28,45,35,7,3,1,0,1,3,2,0,0,1
S01009421,Occupancy rating +1,94,19,8,11,73,1,44,7,25,12,28,19,9,2,0,0,0,2
S01009421,Occupancy rating 0,62,11,5,6,44,1,23,0,16,7,20,16,4,7,3,0,0,4
S01009421,Occupancy rating -1 or less,23,4,1,3,14,0,4,1,3,0,10,9,1,5,3,0,0,2
S01009422,All households,369,106,48,58,248,38,166,79,64,23,44,26,18,15,4,1,2,8
S01009422,Occupancy rating +2 or more,114,29,16,13,85,18,64,43,12,9,3,1,2,0,0,0,0,0
S01009422,Occupancy rating +1,134,42,21,21,89,17,62,32,23,7,10,4,6,3,1,0,0,2
S01009422,Occupancy rating 0,90,28,10,18,58,3,29,3,22,4,26,18,8,4,0,0,0,4
S01009422,Occupancy rating -1 or less,31,7,1,6,16,0,11,1,7,3,5,3,2,8,3,1,2,2
S01009423,All households,336,45,7,38,280,5,257,99,129,29,18,14,4,11,2,1,1,7
S01009423,Occupancy rating +2 or more,253,36,5,31,211,5,195,91,86,18,11,9,2,6,2,0,0,4
S01009423,Occupancy rating +1,52,7,2,5,43,0,40,7,27,6,3,3,0,2,0,0,1,1
S01009423,Occupancy rating 0,22,2,0,2,18,0,17,1,11,5,1,1,0,2,0,0,0,2
S01009423,Occupancy rating -1 or less,9,0,0,0,8,0,5,0,5,0,3,1,2,1,0,1,0,0
S01009424,All households,250,75,33,42,166,20,133,68,51,14,13,6,7,9,5,0,0,4
S01009424,Occupancy rating +2 or more,124,25,13,12,96,14,78,48,25,5,4,2,2,3,2,0,0,1
S01009424,Occupancy rating +1,72,30,12,18,39,5,32,14,13,5,2,0,2,3,1,0,0,2
S01009424,Occupancy rating 0,45,17,6,11,26,0,20,5,11,4,6,3,3,2,1,0,0,1
S01009424,Occupancy rating -1 or less,9,3,2,1,5,1,3,1,2,0,1,1,0,1,1,0,0,0
S01009425,All households,372,134,54,80,224,52,138,74,41,23,34,26,8,14,5,2,1,6
S01009425,Occupancy rating +2 or more,150,43,24,19,103,36,63,43,9,11,4,2,2,4,2,0,0,2
S01009425,Occupancy rating +1,124,60,19,41,62,12,45,25,14,6,5,3,2,2,1,0,0,1
S01009425,Occupancy rating 0,74,24,8,16,45,2,22,5,11,6,21,17,4,5,1,2,0,2
S01009425,Occupancy rating -1 or less,24,7,3,4,14,2,8,1,7,0,4,4,0,3,1,0,1,1
S01009426,All households,415,183,84,99,218,32,124,66,39,19,62,43,19,14,8,0,0,6
S01009426,Occupancy rating +2 or more,65,23,14,9,39,7,30,21,6,3,2,1,1,3,1,0,0,2
S01009426,Occupancy rating +1,164,90,39,51,71,13,52,35,10,7,6,4,2,3,2,0,0,1
S01009426,Occupancy rating 0,157,64,29,35,89,10,35,7,22,6,44,30,14,4,3,0,0,1
S01009426,Occupancy rating -1 or less,29,6,2,4,19,2,7,3,1,3,10,8,2,4,2,0,0,2
S01009427,All households,326,153,70,83,161,22,99,45,37,17,40,31,9,12,3,0,1,8
S01009427,Occupancy rating +2 or more,66,29,9,20,37,10,23,15,7,1,4,2,2,0,0,0,0,0
S01009427,Occupancy rating +1,141,86,41,45,52,10,37,27,6,4,5,3,2,3,1,0,1,1
S01009427,Occupancy rating 0,102,34,19,15,60,1,33,2,21,10,26,21,5,8,1,0,0,7
S01009427,Occupancy rating -1 or less,17,4,1,3,12,1,6,1,3,2,5,5,0,1,1,0,0,0
S01009428,All households,235,51,19,32,177,15,117,50,47,20,45,39,6,7,6,0,0,1
S01009428,Occupancy rating +2 or more,81,27,12,15,54,12,41,28,11,2,1,0,1,0,0,0,0,0
S01009428,Occupancy rating +1,65,15,3,12,50,2,39,14,12,13,9,8,1,0,0,0,0,0
S01009428,Occupancy rating 0,61,4,0,4,54,0,23,4,15,4,31,27,4,3,2,0,0,1
S01009428,Occupancy rating -1 or less,28,5,4,1,19,1,14,4,9,1,4,4,0,4,4,0,0,0
S01009429,All households,341,126,67,59,205,38,113,46,40,27,54,35,19,10,5,0,0,5
S01009429,Occupancy rating +2 or more,62,23,13,10,39,10,27,13,6,8,2,2,0,0,0,0,0,0
S01009429,Occupancy rating +1,126,56,20,36,69,21,40,29,6,5,8,3,5,1,0,0,0,1
S01009429,Occupancy rating 0,99,29,20,9,66,6,31,3,19,9,29,17,12,4,2,0,0,2
S01009429,Occupancy rating -1 or less,54,18,14,4,31,1,15,1,9,5,15,13,2,5,3,0,0,2
S01009430,All households,338,120,67,53,200,18,130,52,46,32,52,38,14,18,7,0,0,11
S01009430,Occupancy rating +2 or more,91,31,15,16,56,7,41,24,9,8,8,4,4,4,1,0,0,3
S01009430,Occupancy rating +1,116,52,29,23,60,6,45,23,13,9,9,7,2,4,1,0,0,3
S01009430,Occupancy rating 0,95,29,19,10,62,4,31,4,16,11,27,20,7,4,1,0,0,3
S01009430,Occupancy rating -1 or less,36,8,4,4,22,1,13,1,8,4,8,7,1,6,4,0,0,2
S01009431,All households,330,122,54,68,193,34,117,55,45,17,42,31,11,15,7,1,1,6
S01009431,Occupancy rating +2 or more,101,37,15,22,61,14,43,27,8,8,4,2,2,3,1,0,0,2
S01009431,Occupancy rating +1,121,59,22,37,60,16,38,23,11,4,6,5,1,2,0,0,0,2
S01009431,Occupancy rating 0,91,21,14,7,63,4,30,4,21,5,29,22,7,7,4,0,1,2
S01009431,Occupancy rating -1 or less,17,5,3,2,9,0,6,1,5,0,3,2,1,3,2,1,0,0
S01009432,All households,321,85,31,54,218,18,140,48,57,35,60,44,16,18,11,0,0,7
S01009432,Occupancy rating +2 or more,113,53,20,33,58,14,42,34,4,4,2,2,0,2,0,0,0,2
S01009432,Occupancy rating +1,97,18,6,12,73,3,46,6,24,16,24,15,9,6,2,0,0,4
S01009432,Occupancy rating 0,85,12,5,7,69,1,39,6,22,11,29,22,7,4,3,0,0,1
S01009432,Occupancy rating -1 or less,26,2,0,2,18,0,13,2,7,4,5,5,0,6,6,0,0,0
S01009433,All households,330,92,41,51,222,16,133,50,64,19,73,51,22,16,9,0,0,7
S01009433,Occupancy rating +2 or more,104,51,26,25,49,13,33,26,6,1,3,1,2,4,2,0,0,2
S01009433,Occupancy rating +1,108,26,8,18,81,3,49,20,20,9,29,17,12,1,1,0,0,0
S01009433,Occupancy rating 0,96,14,7,7,73,0,40,3,30,7,33,26,7,9,5,0,0,4
S01009433,Occupancy rating -1 or less,22,1,0,1,19,0,11,1,8,2,8,7,1,2,1,0,0,1
S01009434,All households,248,83,33,50,156,27,92,34,36,22,37,29,8,9,3,1,1,4
S01009434,Occupancy rating +2 or more,56,17,7,10,39,11,24,14,5,5,4,1,3,0,0,0,0,0
S01009434,Occupancy rating +1,91,42,17,25,46,8,30,18,8,4,8,7,1,3,1,0,1,1
S01009434,Occupancy rating 0,74,21,7,14,50,7,25,1,19,5,18,17,1,3,0,1,0,2
S01009434,Occupancy rating -1 or less,27,3,2,1,21,1,13,1,4,8,7,4,3,3,2,0,0,1
S01009435,All households,347,122,37,85,204,14,112,41,50,21,78,61,17,21,11,0,2,8
S01009435,Occupancy rating +2 or more,80,29,12,17,50,7,35,23,9,3,8,8,0,1,0,0,0,1
S01009435,Occupancy rating +1,126,56,14,42,65,6,36,13,14,9,23,13,10,5,2,0,2,1
S01009435,Occupancy rating 0,109,29,9,20,70,1,34,4,24,6,35,30,5,10,5,0,0,5
S01009435,Occupancy rating -1 or less,32,8,2,6,19,0,7,1,3,3,12,10,2,5,4,0,0,1
S01009436,All households,298,81,32,49,209,17,146,63,66,17,46,35,11,8,4,0,0,4
S01009436,Occupancy rating +2 or more,65,14,6,8,50,5,42,30,12,0,3,1,2,1,0,0,0,1
S01009436,Occupancy rating +1,137,53,20,33,83,11,58,29,23,6,14,10,4,1,0,0,0,1
S01009436,Occupancy rating 0,75,9,5,4,63,0,38,3,24,11,25,20,5,3,2,0,0,1
S01009436,Occupancy rating -1 or less,21,5,1,4,13,1,8,1,7,0,4,4,0,3,2,0,0,1
S01009437,All households,318,121,61,60,184,27,130,48,57,25,27,15,12,13,8,0,0,5
S01009437,Occupancy rating +2 or more,99,36,18,18,63,18,43,26,11,6,2,1,1,0,0,0,0,0
S01009437,Occupancy rating +1,110,44,15,29,63,2,54,21,22,11,7,2,5,3,2,0,0,1
S01009437,Occupancy rating 0,84,29,19,10,49,6,29,1,21,7,14,9,5,6,2,0,0,4
S01009437,Occupancy rating -1 or less,25,12,9,3,9,1,4,0,3,1,4,3,1,4,4,0,0,0
S01009438,All households,410,157,77,80,231,36,148,67,62,19,47,30,17,22,12,0,1,9
S01009438,Occupancy rating +2 or more,133,49,23,26,83,19,61,50,8,3,3,1,2,1,0,0,0,1
S01009438,Occupancy rating +1,145,70,25,45,69,10,44,12,25,7,15,8,7,6,3,0,0,3
S01009438,Occupancy rating 0,100,34,25,9,60,5,30,1,24,5,25,18,7,6,2,0,1,3
S01009438,Occupancy rating -1 or less,32,4,4,0,19,2,13,4,5,4,4,3,1,9,7,0,0,2
S01009439,All households,386,97,45,52,277,24,177,69,73,35,76,50,26,12,5,0,2,5
S01009439,Occupancy rating +2 or more,148,54,28,26,94,17,70,55,12,3,7,4,3,0,0,0,0,0
S01009439,Occupancy rating +1,120,19,9,10,96,6,56,10,27,19,34,17,17,5,3,0,1,1
S01009439,Occupancy rating 0,92,21,7,14,64,1,38,4,23,11,25,22,3,7,2,0,1,4
S01009439,Occupancy rating -1 or less,26,3,1,2,23,0,13,0,11,2,10,7,3,0,0,0,0,0
S01009440,All households,328,137,56,81,183,40,107,47,44,16,36,24,12,8,3,0,1,4
S01009440,Occupancy rating +2 or more,103,49,17,32,52,18,31,21,4,6,3,1,2,2,1,0,0,1
S01009440,Occupancy rating +1,120,48,20,28,70,15,41,24,14,3,14,9,5,2,0,0,0,2
S01009440,Occupancy rating 0,80,26,13,13,52,4,31,2,23,6,17,13,4,2,0,0,1,1
S01009440,Occupancy rating -1 or less,25,14,6,8,9,3,4,0,3,1,2,1,1,2,2,0,0,0
S01009441,All households,370,117,38,79,243,23,139,54,64,21,81,66,15,10,4,0,1,5
S01009441,Occupancy rating +2 or more,74,28,15,13,45,9,31,22,6,3,5,5,0,1,0,0,1,0
S01009441,Occupancy rating +1,113,45,14,31,68,9,47,26,11,10,12,10,2,0,0,0,0,0
S01009441,Occupancy rating 0,145,35,4,31,104,5,50,5,38,7,49,38,11,6,1,0,0,5
S01009441,Occupancy rating -1 or less,38,9,5,4,26,0,11,1,9,1,15,13,2,3,3,0,0,0
S01009442,All households,216,41,11,30,169,13,141,57,65,19,15,11,4,6,4,0,0,2
S01009442,Occupancy rating +2 or more,144,25,8,17,119,9,100,50,39,11,10,7,3,0,0,0,0,0
S01009442,Occupancy rating +1,37,10,2,8,26,3,21,4,12,5,2,2,0,1,0,0,0,1
S01009442,Occupancy rating 0,24,5,1,4,16,1,12,1,9,2,3,2,1,3,2,0,0,1
S01009442,Occupancy rating -1 or less,11,1,0,1,8,0,8,2,5,1,0,0,0,2,2,0,0,0
S01009443,All households,288,80,32,48,193,25,142,61,55,26,26,19,7,15,6,0,1,8
S01009443,Occupancy rating +2 or more,134,32,16,16,100,16,80,39,25,16,4,4,0,2,0,0,0,2
S01009443,Occupancy rating +1,89,38,14,24,46,6,34,20,9,5,6,5,1,5,3,0,0,2
S01009443,Occupancy rating 0,49,6,1,5,38,3,21,2,15,4,14,9,5,5,1,0,1,3
S01009443,Occupancy rating -1 or less,16,4,1,3,9,0,7,0,6,1,2,1,1,3,2,0,0,1
S01009444,All households,305,46,24,22,249,25,208,80,89,39,16,9,7,10,6,0,1,3
S01009444,Occupancy rating +2 or more,196,24,10,14,167,21,140,67,51,22,6,3,3,5,3,0,1,1
S01009444,Occupancy rating +1,75,19,11,8,54,3,45,12,23,10,6,3,3,2,0,0,0,2
S01009444,Occupancy rating 0,25,2,2,0,21,1,18,1,11,6,2,2,0,2,2,0,0,0
S01009444,Occupancy rating -1 or less,9,1,1,0,7,0,5,0,4,1,2,1,1,1,1,0,0,0
S01009445,All households,320,80,40,40,224,24,165,64,61,40,35,23,12,16,8,0,2,6
S01009445,Occupancy rating +2 or more,130,41,22,19,87,18,67,45,13,9,2,1,1,2,1,0,1,0
S01009445,Occupancy rating +1,117,37,16,21,77,6,60,17,25,18,11,7,4,3,1,0,1,1
S01009445,Occupancy rating 0,51,2,2,0,45,0,29,2,18,9,16,10,6,4,1,0,0,3
S01009445,Occupancy rating -1 or less,22,0,0,0,15,0,9,0,5,4,6,5,1,7,5,0,0,2
S01009446,All households,471,231,97,134,226,22,132,57,54,21,72,53,19,14,5,1,0,8
S01009446,Occupancy rating +2 or more,86,36,12,24,47,9,33,23,6,4,5,4,1,3,1,0,0,2
S01009446,Occupancy rating +1,174,108,36,72,64,9,47,30,10,7,8,3,5,2,1,0,0,1
S01009446,Occupancy rating 0,152,56,27,29,90,1,36,1,26,9,53,42,11,6,0,1,0,5
S01009446,Occupancy rating -1 or less,59,31,22,9,25,3,16,3,12,1,6,4,2,3,3,0,0,0
S01009447,All households,238,84,27,57,144,20,90,49,26,15,34,23,11,10,5,0,0,5
S01009447,Occupancy rating +2 or more,68,23,6,17,44,11,30,23,2,5,3,1,2,1,0,0,0,1
S01009447,Occupancy rating +1,83,27,10,17,53,6,36,20,11,5,11,7,4,3,1,0,0,2
S01009447,Occupancy rating 0,71,28,10,18,39,3,18,5,11,2,18,13,5,4,2,0,0,2
S01009447,Occupancy rating -1 or less,16,6,1,5,8,0,6,1,2,3,2,2,0,2,2,0,0,0
S01009448,All households,343,78,35,43,259,23,196,90,72,34,40,26,14,6,4,0,0,2
S01009448,Occupancy rating +2 or more,179,45,19,26,133,11,115,70,33,12,7,3,4,1,1,0,0,0
S01009448,Occupancy rating +1,96,27,13,14,68,10,42,18,11,13,16,7,9,1,0,0,0,1
S01009448,Occupancy rating 0,56,4,1,3,49,2,32,1,26,5,15,14,1,3,2,0,0,1
S01009448,Occupancy rating -1 or less,12,2,2,0,9,0,7,1,2,4,2,2,0,1,1,0,0,0
S01009449,All households,231,69,38,31,154,20,104,44,38,22,30,23,7,8,4,0,0,4
S01009449,Occupancy rating +2 or more,78,28,21,7,49,10,34,24,8,2,5,4,1,1,1,0,0,0
S01009449,Occupancy rating +1,92,34,15,19,57,10,36,17,8,11,11,8,3,1,0,0,0,1
S01009449,Occupancy rating 0,42,6,1,5,34,0,24,3,14,7,10,8,2,2,0,0,0,2
S01009449,Occupancy rating -1 or less,19,1,1,0,14,0,10,0,8,2,4,3,1,4,3,0,0,1
S01009450,All households,307,127,39,88,172,14,91,33,43,15,67,49,18,8,0,0,0,8
S01009450,Occupancy rating +2 or more,41,23,8,15,18,3,13,11,1,1,2,1,1,0,0,0,0,0
S01009450,Occupancy rating +1,126,71,23,48,53,9,33,20,7,6,11,7,4,2,0,0,0,2
S01009450,Occupancy rating 0,118,26,6,20,86,2,37,1,28,8,47,37,10,6,0,0,0,6
S01009450,Occupancy rating -1 or less,22,7,2,5,15,0,8,1,7,0,7,4,3,0,0,0,0,0
S01009451,All households,427,127,51,76,286,22,187,68,83,36,77,56,21,14,6,0,0,8
S01009451,Occupancy rating +2 or more,107,39,22,17,68,14,47,33,7,7,7,3,4,0,0,0,0,0
S01009451,Occupancy rating +1,159,68,20,48,89,7,68,32,21,15,14,5,9,2,1,0,0,1
S01009451,Occupancy rating 0,122,16,7,9,100,1,56,3,43,10,43,36,7,6,3,0,0,3
S01009451,Occupancy rating -1 or less,39,4,2,2,29,0,16,0,12,4,13,12,1,6,2,0,0,4
S01009452,All households,269,120,52,68,142,18,90,41,36,13,34,23,11,7,1,0,0,6
S01009452,Occupancy rating +2 or more,53,22,9,13,31,7,22,15,5,2,2,2,0,0,0,0,0,0
S01009452,Occupancy rating +1,120,60,19,41,59,8,43,23,15,5,8,4,4,1,0,0,0,1
S01009452,Occupancy rating 0,76,29,19,10,42,3,19,2,13,4,20,13,7,5,1,0,0,4
S01009452,Occupancy rating -1 or less,20,9,5,4,10,0,6,1,3,2,4,4,0,1,0,0,0,1
S01009453,All households,493,202,78,124,281,34,187,86,69,32,60,49,11,10,5,0,0,5
S01009453,Occupancy rating +2 or more,110,36,18,18,73,13,53,36,13,4,7,5,2,1,1,0,0,0
S01009453,Occupancy rating +1,202,98,34,64,104,19,73,40,22,11,12,9,3,0,0,0,0,0
S01009453,Occupancy rating 0,143,52,18,34,87,2,53,10,29,14,32,28,4,4,1,0,0,3
S01009453,Occupancy rating -1 or less,38,16,8,8,17,0,8,0,5,3,9,7,2,5,3,0,0,2
S01009454,All households,397,119,54,65,269,35,200,90,94,16,34,21,13,9,2,0,0,7
S01009454,Occupancy rating +2 or more,224,49,25,24,170,23,140,68,60,12,7,5,2,5,1,0,0,4
S01009454,Occupancy rating +1,111,49,26,23,61,10,39,18,18,3,12,6,6,1,0,0,0,1
S01009454,Occupancy rating 0,45,14,1,13,29,1,17,4,13,0,11,8,3,2,1,0,0,1
S01009454,Occupancy rating -1 or less,17,7,2,5,9,1,4,0,3,1,4,2,2,1,0,0,0,1
S01009455,All households,386,118,57,61,255,57,183,93,68,22,15,6,9,13,7,1,0,5
S01009455,Occupancy rating +2 or more,271,62,38,24,202,52,143,76,47,20,7,2,5,7,5,0,0,2
S01009455,Occupancy rating +1,58,27,10,17,29,4,23,11,11,1,2,1,1,2,0,0,0,2
S01009455,Occupancy rating 0,43,19,6,13,22,1,15,4,10,1,6,3,3,2,1,1,0,0
S01009455,Occupancy rating -1 or less,14,10,3,7,2,0,2,2,0,0,0,0,0,2,1,0,0,1
S01009456,All households,358,159,62,97,186,23,132,79,35,18,31,23,8,13,3,1,1,8
S01009456,Occupancy rating +2 or more,97,30,14,16,65,7,57,37,15,5,1,0,1,2,1,0,0,1
S01009456,Occupancy rating +1,99,48,24,24,50,8,39,30,6,3,3,1,2,1,1,0,0,0
S01009456,Occupancy rating 0,133,66,19,47,59,6,31,10,12,9,22,18,4,8,0,0,1,7
S01009456,Occupancy rating -1 or less,29,15,5,10,12,2,5,2,2,1,5,4,1,2,1,1,0,0
S01009457,All households,254,59,26,33,185,29,141,75,52,14,15,10,5,10,2,0,1,7
S01009457,Occupancy rating +2 or more,151,36,17,19,112,25,84,53,23,8,3,1,2,3,1,0,0,2
S01009457,Occupancy rating +1,65,18,7,11,44,4,37,19,14,4,3,2,1,3,0,0,0,3
S01009457,Occupancy rating 0,25,2,1,1,20,0,12,2,9,1,8,6,2,3,0,0,1,2
S01009457,Occupancy rating -1 or less,13,3,1,2,9,0,8,1,6,1,1,1,0,1,1,0,0,0
S01009458,All households,332,140,63,77,182,26,126,62,52,12,30,19,11,10,5,0,0,5
S01009458,Occupancy rating +2 or more,141,48,28,20,91,21,66,35,24,7,4,3,1,2,1,0,0,1
S01009458,Occupancy rating +1,65,32,15,17,33,5,23,17,3,3,5,3,2,0,0,0,0,0
S01009458,Occupancy rating 0,97,45,16,29,49,0,32,10,21,1,17,10,7,3,0,0,0,3
S01009458,Occupancy rating -1 or less,29,15,4,11,9,0,5,0,4,1,4,3,1,5,4,0,0,1
S01009459,All households,457,223,86,137,225,25,162,72,73,17,38,25,13,9,3,0,0,6
S01009459,Occupancy rating +2 or more,127,43,17,26,82,13,63,37,21,5,6,3,3,2,1,0,0,1
S01009459,Occupancy rating +1,119,56,22,34,63,8,48,24,23,1,7,5,2,0,0,0,0,0
S01009459,Occupancy rating 0,158,91,32,59,63,4,43,9,24,10,16,13,3,4,2,0,0,2
S01009459,Occupancy rating -1 or less,53,33,15,18,17,0,8,2,5,1,9,4,5,3,0,0,0,3
S01009460,All households,399,152,47,105,231,12,148,51,82,15,71,50,21,16,5,0,2,9
S01009460,Occupancy rating +2 or more,69,26,9,17,40,4,29,21,7,1,7,5,2,3,1,0,1,1
S01009460,Occupancy rating +1,143,80,27,53,58,8,39,22,13,4,11,5,6,5,2,0,1,2
S01009460,Occupancy rating 0,147,36,9,27,107,0,67,7,54,6,40,29,11,4,0,0,0,4
S01009460,Occupancy rating -1 or less,40,10,2,8,26,0,13,1,8,4,13,11,2,4,2,0,0,2
S01009461,All households,201,19,3,16,171,5,155,63,81,11,11,8,3,11,6,0,1,4
S01009461,Occupancy rating +2 or more,175,17,3,14,151,5,137,56,73,8,9,6,3,7,4,0,1,2
S01009461,Occupancy rating +1,17,1,0,1,15,0,13,6,5,2,2,2,0,1,0,0,0,1
S01009461,Occupancy rating 0,7,0,0,0,4,0,4,1,2,1,0,0,0,3,2,0,0,1
S01009461,Occupancy rating -1 or less,2,1,0,1,1,0,1,0,1,0,0,0,0,0,0,0,0,0
S01009462,All households,292,78,51,27,204,29,144,61,62,21,31,16,15,10,6,0,0,4
S01009462,Occupancy rating +2 or more,115,32,19,13,81,18,57,33,22,2,6,1,5,2,2,0,0,0
S01009462,Occupancy rating +1,111,45,31,14,65,10,48,27,14,7,7,2,5,1,0,0,0,1
S01009462,Occupancy rating 0,48,0,0,0,44,1,33,1,22,10,10,7,3,4,2,0,0,2
S01009462,Occupancy rating -1 or less,18,1,1,0,14,0,6,0,4,2,8,6,2,3,2,0,0,1
S01009463,All households,306,86,45,41,214,47,132,58,45,29,35,21,14,6,4,0,0,2
S01009463,Occupancy rating +2 or more,148,39,24,15,107,28,71,39,14,18,8,3,5,2,1,0,0,1
S01009463,Occupancy rating +1,93,35,15,20,57,15,37,19,13,5,5,3,2,1,1,0,0,0
S01009463,Occupancy rating 0,56,9,5,4,44,3,21,0,17,4,20,13,7,3,2,0,0,1
S01009463,Occupancy rating -1 or less,9,3,1,2,6,1,3,0,1,2,2,2,0,0,0,0,0,0
S01009464,All households,378,111,54,57,259,30,204,95,84,25,25,17,8,8,7,0,0,1
S01009464,Occupancy rating +2 or more,175,48,27,21,127,20,103,61,29,13,4,2,2,0,0,0,0,0
S01009464,Occupancy rating +1,115,47,21,26,65,9,53,25,25,3,3,0,3,3,2,0,0,1
S01009464,Occupancy rating 0,68,9,2,7,56,1,41,9,25,7,14,11,3,3,3,0,0,0
S01009464,Occupancy rating -1 or less,20,7,4,3,11,0,7,0,5,2,4,4,0,2,2,0,0,0
S01009465,All households,269,92,47,45,170,29,114,41,51,22,27,20,7,7,3,0,2,2
S01009465,Occupancy rating +2 or more,118,39,22,17,78,20,52,22,19,11,6,5,1,1,1,0,0,0
S01009465,Occupancy rating +1,81,27,15,12,53,8,36,13,15,8,9,5,4,1,0,0,1,0
S01009465,Occupancy rating 0,54,24,10,14,28,0,18,4,11,3,10,9,1,2,0,0,1,1
S01009465,Occupancy rating -1 or less,16,2,0,2,11,1,8,2,6,0,2,1,1,3,2,0,0,1
S01009466,All households,256,64,37,27,180,45,119,58,38,23,16,9,7,12,7,0,1,4
S01009466,Occupancy rating +2 or more,170,37,24,13,128,32,86,45,24,17,10,3,7,5,2,0,0,3
S01009466,Occupancy rating +1,53,18,8,10,32,10,19,8,9,2,3,3,0,3,2,0,1,0
S01009466,Occupancy rating 0,27,7,4,3,17,3,11,4,4,3,3,3,0,3,2,0,0,1
S01009466,Occupancy rating -1 or less,6,2,1,1,3,0,3,1,1,1,0,0,0,1,1,0,0,0
S01009467,All households,330,76,40,36,244,43,176,80,68,28,25,17,8,10,5,0,2,3
S01009467,Occupancy rating +2 or more,219,45,29,16,169,36,125,62,42,21,8,4,4,5,2,0,2,1
S01009467,Occupancy rating +1,73,19,6,13,52,6,38,15,19,4,8,7,1,2,1,0,0,1
S01009467,Occupancy rating 0,32,10,4,6,20,1,11,3,5,3,8,5,3,2,1,0,0,1
S01009467,Occupancy rating -1 or less,6,2,1,1,3,0,2,0,2,0,1,1,0,1,1,0,0,0
S01009468,All households,385,177,75,102,200,37,131,57,54,20,32,20,12,8,4,0,1,3
S01009468,Occupancy rating +2 or more,108,42,17,25,62,17,43,23,13,7,2,2,0,4,2,0,0,2
S01009468,Occupancy rating +1,127,67,25,42,59,14,40,23,9,8,5,3,2,1,1,0,0,0
S01009468,Occupancy rating 0,120,59,27,32,59,5,38,9,24,5,16,10,6,2,0,0,1,1
S01009468,Occupancy rating -1 or less,30,9,6,3,20,1,10,2,8,0,9,5,4,1,1,0,0,0
S01009469,All households,393,151,73,78,240,34,172,91,59,22,34,24,10,2,0,0,0,2
S01009469,Occupancy rating +2 or more,169,43,27,16,125,24,95,49,33,13,6,3,3,1,0,0,0,1
S01009469,Occupancy rating +1,135,66,34,32,68,8,50,34,11,5,10,9,1,1,0,0,0,1
S01009469,Occupancy rating 0,72,33,10,23,39,2,24,8,12,4,13,9,4,0,0,0,0,0
S01009469,Occupancy rating -1 or less,17,9,2,7,8,0,3,0,3,0,5,3,2,0,0,0,0,0
S01009470,All households,232,78,38,40,149,35,89,44,33,12,25,20,5,5,2,0,0,3
S01009470,Occupancy rating +2 or more,102,40,19,21,62,24,37,26,7,4,1,0,1,0,0,0,0,0
S01009470,Occupancy rating +1,79,32,18,14,47,9,35,16,15,4,3,2,1,0,0,0,0,0
S01009470,Occupancy rating 0,40,5,1,4,32,2,15,2,9,4,15,12,3,3,0,0,0,3
S01009470,Occupancy rating -1 or less,11,1,0,1,8,0,2,0,2,0,6,6,0,2,2,0,0,0
S01009471,All households,414,250,133,117,146,26,93,54,26,13,27,17,10,18,4,3,2,9
S01009471,Occupancy rating +2 or more,57,20,12,8,36,4,28,16,7,5,4,1,3,1,0,0,0,1
S01009471,Occupancy rating +1,169,114,54,60,53,13,36,29,5,2,4,3,1,2,0,1,0,1
S01009471,Occupancy rating 0,158,107,61,46,44,7,25,9,11,5,12,9,3,7,0,1,1,5
S01009471,Occupancy rating -1 or less,30,9,6,3,13,2,4,0,3,1,7,4,3,8,4,1,1,2
S01009472,All households,435,162,50,112,249,25,148,62,71,15,76,66,10,24,5,0,3,16
S01009472,Occupancy rating +2 or more,153,37,17,20,108,19,80,43,28,9,9,7,2,8,2,0,1,5
S01009472,Occupancy rating +1,113,65,20,45,45,5,26,14,8,4,14,13,1,3,0,0,2,1
S01009472,Occupancy rating 0,126,46,10,36,72,1,31,4,26,1,40,35,5,8,1,0,0,7
S01009472,Occupancy rating -1 or less,43,14,3,11,24,0,11,1,9,1,13,11,2,5,2,0,0,3
S01009473,All households,464,203,52,151,232,26,140,69,54,17,66,57,9,29,11,2,1,15
S01009473,Occupancy rating +2 or more,53,26,11,15,27,6,20,10,9,1,1,1,0,0,0,0,0,0
S01009473,Occupancy rating +1,154,73,15,58,80,16,53,41,7,5,11,9,2,1,0,0,0,1
S01009473,Occupancy rating 0,201,82,21,61,105,3,56,14,32,10,46,40,6,14,3,2,1,8
S01009473,Occupancy rating -1 or less,56,22,5,17,20,1,11,4,6,1,8,7,1,14,8,0,0,6
S01009474,All households,403,149,31,118,236,19,160,58,84,18,57,43,14,18,9,0,0,9
S01009474,Occupancy rating +2 or more,131,37,11,26,89,14,70,31,31,8,5,3,2,5,4,0,0,1
S01009474,Occupancy rating +1,129,54,9,45,71,4,46,18,24,4,21,15,6,4,2,0,0,2
S01009474,Occupancy rating 0,118,50,10,40,64,1,37,7,24,6,26,21,5,4,1,0,0,3
S01009474,Occupancy rating -1 or less,25,8,1,7,12,0,7,2,5,0,5,4,1,5,2,0,0,3
S01009475,All households,222,41,14,27,169,16,137,69,61,7,16,15,1,12,10,0,0,2
S01009475,Occupancy rating +2 or more,162,26,11,15,131,12,106,58,45,3,13,12,1,5,4,0,0,1
S01009475,Occupancy rating +1,36,11,3,8,23,2,20,9,8,3,1,1,0,2,2,0,0,0
S01009475,Occupancy rating 0,20,4,0,4,12,2,8,2,5,1,2,2,0,4,3,0,0,1
S01009475,Occupancy rating -1 or less,4,0,0,0,3,0,3,0,3,0,0,0,0,1,1,0,0,0
S01009476,All households,169,35,8,27,123,4,114,32,71,11,5,4,1,11,6,0,1,4
S01009476,Occupancy rating +2 or more,125,20,5,15,99,3,93,26,58,9,3,2,1,6,3,0,1,2
S01009476,Occupancy rating +1,29,13,3,10,14,0,12,4,7,1,2,2,0,2,1,0,0,1
S01009476,Occupancy rating 0,12,2,0,2,9,1,8,2,5,1,0,0,0,1,1,0,0,0
S01009476,Occupancy rating -1 or less,3,0,0,0,1,0,1,0,1,0,0,0,0,2,1,0,0,1
S01009477,All households,358,169,74,95,179,22,137,56,65,16,20,16,4,10,2,0,1,7
S01009477,Occupancy rating +2 or more,147,39,21,18,103,13,84,32,42,10,6,5,1,5,1,0,1,3
S01009477,Occupancy rating +1,98,57,28,29,41,9,31,16,11,4,1,1,0,0,0,0,0,0
S01009477,Occupancy rating 0,85,57,18,39,26,0,15,6,9,0,11,8,3,2,0,0,0,2
S01009477,Occupancy rating -1 or less,28,16,7,9,9,0,7,2,3,2,2,2,0,3,1,0,0,2
S01009478,All households,480,239,48,191,224,18,162,99,50,13,44,33,11,17,1,3,0,13
S01009478,Occupancy rating +2 or more,122,54,16,38,65,9,54,35,13,6,2,1,1,3,1,0,0,2
S01009478,Occupancy rating +1,122,71,14,57,49,8,37,26,9,2,4,4,0,2,0,0,0,2
S01009478,Occupancy rating 0,182,87,14,73,86,1,57,33,22,2,28,19,9,9,0,2,0,7
S01009478,Occupancy rating -1 or less,54,27,4,23,24,0,14,5,6,3,10,9,1,3,0,1,0,2
S01009479,All households,420,194,66,128,199,27,142,76,47,19,30,16,14,27,1,5,1,20
S01009479,Occupancy rating +2 or more,164,59,27,32,102,18,80,44,26,10,4,0,4,3,0,0,0,3
S01009479,Occupancy rating +1,104,61,18,43,37,6,28,15,7,6,3,2,1,6,0,1,0,5
S01009479,Occupancy rating 0,100,48,12,36,43,3,25,12,10,3,15,9,6,9,0,3,1,5
S01009479,Occupancy rating -1 or less,52,26,9,17,17,0,9,5,4,0,8,5,3,9,1,1,0,7
S01009480,All households,420,162,97,65,246,44,174,98,57,19,28,13,15,12,3,1,3,5
S01009480,Occupancy rating +2 or more,213,58,23,35,151,22,120,68,39,13,9,4,5,4,1,0,1,2
S01009480,Occupancy rating +1,111,50,32,18,59,10,41,24,14,3,8,4,4,2,1,0,1,0
S01009480,Occupancy rating 0,76,47,37,10,27,9,11,5,3,3,7,2,5,2,0,1,0,1
S01009480,Occupancy rating -1 or less,20,7,5,2,9,3,2,1,1,0,4,3,1,4,1,0,1,2
S01009481,All households,489,242,63,179,225,32,155,87,54,14,38,24,14,22,5,0,1,16
S01009481,Occupancy rating +2 or more,123,45,20,25,74,22,51,30,17,4,1,0,1,4,1,0,1,2
S01009481,Occupancy rating +1,174,96,20,76,75,7,59,42,12,5,9,3,6,3,1,0,0,2
S01009481,Occupancy rating 0,158,92,22,70,56,2,38,14,19,5,16,14,2,10,1,0,0,9
S01009481,Occupancy rating -1 or less,34,9,1,8,20,1,7,1,6,0,12,7,5,5,2,0,0,3
S01009482,All households,332,164,26,138,157,19,114,71,36,7,24,21,3,11,3,0,1,7
S01009482,Occupancy rating +2 or more,85,33,11,22,50,11,39,28,9,2,0,0,0,2,0,0,1,1
S01009482,Occupancy rating +1,98,60,11,49,38,6,30,24,5,1,2,2,0,0,0,0,0,0
S01009482,Occupancy rating 0,115,59,4,55,52,2,35,17,15,3,15,13,2,4,0,0,0,4
S01009482,Occupancy rating -1 or less,34,12,0,12,17,0,10,2,7,1,7,6,1,5,3,0,0,2
S01009483,All households,403,204,31,173,184,18,134,80,45,9,32,26,6,15,5,1,1,8
S01009483,Occupancy rating +2 or more,129,38,12,26,89,17,64,37,22,5,8,5,3,2,2,0,0,0
S01009483,Occupancy rating +1,113,67,13,54,41,0,35,25,6,4,6,5,1,5,1,0,0,4
S01009483,Occupancy rating 0,123,73,2,71,45,1,28,15,13,0,16,14,2,5,0,1,1,3
S01009483,Occupancy rating -1 or less,38,26,4,22,9,0,7,3,4,0,2,2,0,3,2,0,0,1
S01009484,All households,427,226,95,131,187,40,118,62,41,15,29,20,9,14,7,0,0,7
S01009484,Occupancy rating +2 or more,139,49,28,21,89,29,58,32,20,6,2,1,1,1,0,0,0,1
S01009484,Occupancy rating +1,157,109,52,57,45,9,30,17,9,4,6,5,1,3,1,0,0,2
S01009484,Occupancy rating 0,115,60,12,48,48,2,27,13,9,5,19,13,6,7,3,0,0,4
S01009484,Occupancy rating -1 or less,16,8,3,5,5,0,3,0,3,0,2,1,1,3,3,0,0,0
S01009485,All households,362,133,74,59,211,38,134,55,56,23,39,23,16,18,8,0,0,10
S01009485,Occupancy rating +2 or more,139,51,31,20,86,28,55,37,10,8,3,2,1,2,0,0,0,2
S01009485,Occupancy rating +1,100,44,23,21,53,5,39,14,16,9,9,3,6,3,0,0,0,3
S01009485,Occupancy rating 0,87,31,16,15,51,3,26,3,18,5,22,15,7,5,1,0,0,4
S01009485,Occupancy rating -1 or less,36,7,4,3,21,2,14,1,12,1,5,3,2,8,7,0,0,1
S01009486,All households,313,98,59,39,199,58,116,54,41,21,25,15,10,16,4,0,2,10
S01009486,Occupancy rating +2 or more,155,30,21,9,123,40,76,36,24,16,7,3,4,2,0,0,1,1
S01009486,Occupancy rating +1,87,44,28,16,40,14,22,14,5,3,4,2,2,3,0,0,0,3
S01009486,Occupancy rating 0,59,20,6,14,32,4,15,4,10,1,13,9,4,7,1,0,1,5
S01009486,Occupancy rating -1 or less,12,4,4,0,4,0,3,0,2,1,1,1,0,4,3,0,0,1
S01009487,All households,385,134,64,70,240,49,137,57,60,20,54,32,22,11,1,0,1,9
S01009487,Occupancy rating +2 or more,139,42,30,12,95,33,58,37,15,6,4,4,0,2,0,0,0,2
S01009487,Occupancy rating +1,134,66,28,38,67,11,39,15,16,8,17,8,9,1,0,0,0,1
S01009487,Occupancy rating 0,95,24,5,19,64,5,33,3,25,5,26,14,12,7,1,0,0,6
S01009487,Occupancy rating -1 or less,17,2,1,1,14,0,7,2,4,1,7,6,1,1,0,0,1,0
S01009488,All households,267,64,36,28,193,26,135,40,72,23,32,22,10,10,5,0,0,5
S01009488,Occupancy rating +2 or more,142,55,33,22,84,23,55,34,17,4,6,2,4,3,1,0,0,2
S01009488,Occupancy rating +1,71,7,3,4,59,3,46,6,30,10,10,8,2,5,2,0,0,3
S01009488,Occupancy rating 0,41,2,0,2,38,0,26,0,18,8,12,10,2,1,1,0,0,0
S01009488,Occupancy rating -1 or less,13,0,0,0,12,0,8,0,7,1,4,2,2,1,1,0,0,0
S01009489,All households,389,165,55,110,213,34,132,61,55,16,47,32,15,11,4,0,0,7
S01009489,Occupancy rating +2 or more,101,38,11,27,62,14,42,23,14,5,6,6,0,1,0,0,0,1
S01009489,Occupancy rating +1,113,43,15,28,67,14,44,28,10,6,9,3,6,3,0,0,0,3
S01009489,Occupancy rating 0,138,69,27,42,64,6,36,7,24,5,22,17,5,5,2,0,0,3
S01009489,Occupancy rating -1 or less,37,15,2,13,20,0,10,3,7,0,10,6,4,2,2,0,0,0
S01009490,All households,394,129,42,87,244,20,138,61,61,16,86,66,20,21,10,1,0,10
S01009490,Occupancy rating +2 or more,61,20,11,9,39,7,26,15,6,5,6,5,1,2,1,0,0,1
S01009490,Occupancy rating +1,164,74,18,56,82,8,57,40,10,7,17,11,6,8,4,1,0,3
S01009490,Occupancy rating 0,142,32,13,19,103,3,43,4,35,4,57,45,12,7,2,0,0,5
S01009490,Occupancy rating -1 or less,27,3,0,3,20,2,12,2,10,0,6,5,1,4,3,0,0,1
S01009491,All households,332,120,64,56,201,37,121,53,43,25,43,27,16,11,1,0,2,8
S01009491,Occupancy rating +2 or more,87,23,14,9,63,20,39,21,12,6,4,2,2,1,0,0,1,0
S01009491,Occupancy rating +1,120,48,22,26,70,11,47,24,14,9,12,8,4,2,0,0,0,2
S01009491,Occupancy rating 0,105,40,22,18,61,6,29,7,14,8,26,17,9,4,1,0,0,3
S01009491,Occupancy rating -1 or less,20,9,6,3,7,0,6,1,3,2,1,0,1,4,0,0,1,3
S01009492,All households,310,78,32,46,222,31,149,54,60,35,42,30,12,10,6,0,1,3
S01009492,Occupancy rating +2 or more,96,35,12,23,59,23,35,24,4,7,1,0,1,2,0,0,1,1
S01009492,Occupancy rating +1,107,24,11,13,81,7,63,25,21,17,11,10,1,2,1,0,0,1
S01009492,Occupancy rating 0,80,18,8,10,57,0,36,4,27,5,21,15,6,5,4,0,0,1
S01009492,Occupancy rating -1 or less,27,1,1,0,25,1,15,1,8,6,9,5,4,1,1,0,0,0
S01009493,All households,366,88,70,18,274,72,188,90,68,30,14,3,11,4,2,0,0,2
S01009493,Occupancy rating +2 or more,318,78,62,16,239,66,163,87,48,28,10,2,8,1,1,0,0,0
S01009493,Occupancy rating +1,33,8,7,1,24,5,17,2,13,2,2,0,2,1,0,0,0,1
S01009493,Occupancy rating 0,13,2,1,1,9,1,7,1,6,0,1,0,1,2,1,0,0,1
S01009493,Occupancy rating -1 or less,2,0,0,0,2,0,1,0,1,0,1,1,0,0,0,0,0,0
S01009494,All households,387,98,22,76,281,34,226,85,114,27,21,17,4,8,6,0,0,2
S01009494,Occupancy rating +2 or more,202,31,9,22,166,23,136,50,67,19,7,6,1,5,3,0,0,2
S01009494,Occupancy rating +1,91,23,7,16,67,8,53,24,26,3,6,5,1,1,1,0,0,0
S01009494,Occupancy rating 0,76,32,4,28,43,2,34,9,21,4,7,5,2,1,1,0,0,0
S01009494,Occupancy rating -1 or less,18,12,2,10,5,1,3,2,0,1,1,1,0,1,1,0,0,0
S01009495,All households,375,89,29,60,279,35,217,104,88,25,27,19,8,7,3,0,0,4
S01009495,Occupancy rating +2 or more,196,37,15,22,159,25,129,68,42,19,5,3,2,0,0,0,0,0
S01009495,Occupancy rating +1,108,32,10,22,74,9,56,25,28,3,9,7,2,2,1,0,0,1
S01009495,Occupancy rating 0,63,19,4,15,42,1,30,11,16,3,11,7,4,2,0,0,0,2
S01009495,Occupancy rating -1 or less,8,1,0,1,4,0,2,0,2,0,2,2,0,3,2,0,0,1
S01009496,All households,371,129,59,70,232,43,157,77,58,22,32,21,11,10,4,0,1,5
S01009496,Occupancy rating +2 or more,89,30,17,13,59,19,39,33,5,1,1,0,1,0,0,0,0,0
S01009496,Occupancy rating +1,144,59,27,32,84,21,57,32,16,9,6,6,0,1,0,0,0,1
S01009496,Occupancy rating 0,107,34,13,21,68,2,46,11,26,9,20,13,7,5,1,0,1,3
S01009496,Occupancy rating -1 or less,31,6,2,4,21,1,15,1,11,3,5,2,3,4,3,0,0,1
S01009497,All households,426,105,41,64,306,54,211,98,85,28,41,31,10,15,2,0,3,10
S01009497,Occupancy rating +2 or more,115,22,10,12,90,27,61,43,13,5,2,1,1,3,0,0,0,3
S01009497,Occupancy rating +1,184,57,13,44,124,21,89,50,30,9,14,9,5,3,1,0,1,1
S01009497,Occupancy rating 0,103,24,16,8,70,5,44,3,31,10,21,17,4,9,1,0,2,6
S01009497,Occupancy rating -1 or less,24,2,2,0,22,1,17,2,11,4,4,4,0,0,0,0,0,0
S01009498,All households,276,49,30,19,221,42,160,87,47,26,19,11,8,6,2,0,1,3
S01009498,Occupancy rating +2 or more,217,40,27,13,175,38,130,81,29,20,7,4,3,2,0,0,0,2
S01009498,Occupancy rating +1,46,8,3,5,36,4,24,6,14,4,8,4,4,2,1,0,1,0
S01009498,Occupancy rating 0,12,1,0,1,9,0,6,0,4,2,3,2,1,2,1,0,0,1
S01009498,Occupancy rating -1 or less,1,0,0,0,1,0,0,0,0,0,1,1,0,0,0,0,0,0
S01009499,All households,357,104,44,60,242,40,169,86,57,26,33,22,11,11,7,0,1,3
S01009499,Occupancy rating +2 or more,182,54,31,23,127,33,91,66,12,13,3,1,2,1,1,0,0,0
S01009499,Occupancy rating +1,87,32,11,21,51,5,37,13,19,5,9,5,4,4,2,0,1,1
S01009499,Occupancy rating 0,60,12,1,11,44,0,29,5,18,6,15,12,3,4,3,0,0,1
S01009499,Occupancy rating -1 or less,28,6,1,5,20,2,12,2,8,2,6,4,2,2,1,0,0,1
S01009500,All households,382,142,72,70,228,31,135,59,59,17,62,43,19,12,5,0,2,5
S01009500,Occupancy rating +2 or more,70,28,16,12,42,7,34,24,5,5,1,0,1,0,0,0,0,0
S01009500,Occupancy rating +1,147,68,26,42,76,15,50,32,13,5,11,6,5,3,0,0,2,1
S01009500,Occupancy rating 0,135,39,25,14,92,7,45,3,36,6,40,29,11,4,1,0,0,3
S01009500,Occupancy rating -1 or less,30,7,5,2,18,2,6,0,5,1,10,8,2,5,4,0,0,1
S01009501,All households,315,122,62,60,186,30,117,50,50,17,39,26,13,7,4,0,0,3
S01009501,Occupancy rating +2 or more,70,25,15,10,45,14,26,21,4,1,5,3,2,0,0,0,0,0
S01009501,Occupancy rating +1,116,57,24,33,59,15,43,26,12,5,1,1,0,0,0,0,0,0
S01009501,Occupancy rating 0,105,36,22,14,66,1,37,2,24,11,28,18,10,3,1,0,0,2
S01009501,Occupancy rating -1 or less,24,4,1,3,16,0,11,1,10,0,5,4,1,4,3,0,0,1
S01009502,All households,374,115,41,74,243,23,164,69,66,29,56,34,22,16,9,0,0,7
S01009502,Occupancy rating +2 or more,74,35,11,24,38,9,27,22,1,4,2,1,1,1,0,0,0,1
S01009502,Occupancy rating +1,166,59,20,39,105,10,79,43,22,14,16,7,9,2,1,0,0,1
S01009502,Occupancy rating 0,109,16,9,7,84,3,47,3,33,11,34,22,12,9,5,0,0,4
S01009502,Occupancy rating -1 or less,25,5,1,4,16,1,11,1,10,0,4,4,0,4,3,0,0,1
S01009503,All households,338,114,57,57,218,17,154,74,60,20,47,35,12,6,4,0,0,2
S01009503,Occupancy rating +2 or more,87,35,17,18,51,6,39,30,6,3,6,5,1,1,0,0,0,1
S01009503,Occupancy rating +1,126,48,24,24,78,8,57,36,13,8,13,10,3,0,0,0,0,0
S01009503,Occupancy rating 0,101,26,12,14,73,3,47,8,32,7,23,16,7,2,1,0,0,1
S01009503,Occupancy rating -1 or less,24,5,4,1,16,0,11,0,9,2,5,4,1,3,3,0,0,0
S01009504,All households,314,125,33,92,177,13,105,35,56,14,59,42,17,12,10,0,0,2
S01009504,Occupancy rating +2 or more,77,40,16,24,37,7,29,22,4,3,1,0,1,0,0,0,0,0
S01009504,Occupancy rating +1,104,49,11,38,54,6,36,11,20,5,12,6,6,1,1,0,0,0
S01009504,Occupancy rating 0,97,31,4,27,62,0,27,2,19,6,35,28,7,4,3,0,0,1
S01009504,Occupancy rating -1 or less,36,5,2,3,24,0,13,0,13,0,11,8,3,7,6,0,0,1
S01009505,All households,355,108,29,79,233,10,113,39,57,17,110,77,33,14,8,0,0,6
S01009505,Occupancy rating +2 or more,79,40,16,24,39,8,26,16,6,4,5,3,2,0,0,0,0,0
S01009505,Occupancy rating +1,115,43,5,38,71,2,38,18,14,6,31,16,15,1,1,0,0,0
S01009505,Occupancy rating 0,128,18,4,14,101,0,41,4,32,5,60,48,12,9,3,0,0,6
S01009505,Occupancy rating -1 or less,33,7,4,3,22,0,8,1,5,2,14,10,4,4,4,0,0,0
S01009506,All households,348,123,46,77,209,16,119,55,50,14,74,58,16,16,6,0,1,9
S01009506,Occupancy rating +2 or more,72,30,10,20,40,5,30,25,4,1,5,1,4,2,1,0,0,1
S01009506,Occupancy rating +1,127,65,23,42,58,5,34,20,10,4,19,14,5,4,1,0,0,3
S01009506,Occupancy rating 0,106,21,8,13,80,4,38,6,25,7,38,32,6,5,2,0,1,2
S01009506,Occupancy rating -1 or less,43,7,5,2,31,2,17,4,11,2,12,11,1,5,2,0,0,3
S01009507,All households,346,76,28,48,258,21,181,66,93,22,56,31,25,12,8,0,0,4
S01009507,Occupancy rating +2 or more,153,33,9,24,114,14,93,48,33,12,7,2,5,6,4,0,0,2
S01009507,Occupancy rating +1,99,30,12,18,69,7,44,16,24,4,18,9,9,0,0,0,0,0
S01009507,Occupancy rating 0,70,10,4,6,58,0,32,1,28,3,26,16,10,2,1,0,0,1
S01009507,Occupancy rating -1 or less,24,3,3,0,17,0,12,1,8,3,5,4,1,4,3,0,0,1
S01009508,All households,397,135,42,93,239,19,141,62,60,19,79,68,11,23,7,1,0,15
S01009508,Occupancy rating +2 or more,98,40,14,26,57,9,42,30,10,2,6,4,2,1,0,0,0,1
S01009508,Occupancy rating +1,132,64,17,47,66,10,46,28,10,8,10,8,2,2,0,0,0,2
S01009508,Occupancy rating 0,127,23,10,13,94,0,42,2,32,8,52,46,6,10,1,1,0,8
S01009508,Occupancy rating -1 or less,40,8,1,7,22,0,11,2,8,1,11,10,1,10,6,0,0,4
S01009509,All households,421,143,66,77,250,23,166,54,74,38,61,39,22,28,14,1,0,13
S01009509,Occupancy rating +2 or more,115,47,31,16,64,17,43,28,6,9,4,3,1,4,1,0,0,3
S01009509,Occupancy rating +1,129,50,26,24,75,6,52,17,21,14,17,7,10,4,1,0,0,3
S01009509,Occupancy rating 0,130,36,6,30,86,0,54,7,37,10,32,22,10,8,3,0,0,5
S01009509,Occupancy rating -1 or less,47,10,3,7,25,0,17,2,10,5,8,7,1,12,9,1,0,2
S01009510,All households,301,75,47,28,213,40,157,74,48,35,16,12,4,13,5,0,0,8
S01009510,Occupancy rating +2 or more,219,64,42,22,150,38,106,71,21,14,6,4,2,5,0,0,0,5
S01009510,Occupancy rating +1,54,11,5,6,41,1,33,2,14,17,7,6,1,2,2,0,0,0
S01009510,Occupancy rating 0,19,0,0,0,15,1,11,1,7,3,3,2,1,4,3,0,0,1
S01009510,Occupancy rating -1 or less,9,0,0,0,7,0,7,0,6,1,0,0,0,2,0,0,0,2
S01009511,All households,257,59,45,14,188,49,116,45,44,27,23,13,10,10,2,0,2,6
S01009511,Occupancy rating +2 or more,196,55,42,13,136,48,83,45,23,15,5,3,2,5,1,0,0,4
S01009511,Occupancy rating +1,36,4,3,1,31,1,21,0,12,9,9,3,6,1,0,0,1,0
S01009511,Occupancy rating 0,16,0,0,0,16,0,9,0,6,3,7,5,2,0,0,0,0,0
S01009511,Occupancy rating -1 or less,9,0,0,0,5,0,3,0,3,0,2,2,0,4,1,0,1,2
S01009512,All households,313,57,34,23,248,38,183,75,74,34,27,18,9,8,5,0,0,3
S01009512,Occupancy rating +2 or more,198,42,25,17,152,32,113,62,32,19,7,2,5,4,3,0,0,1
S01009512,Occupancy rating +1,72,13,7,6,58,5,44,9,24,11,9,6,3,1,0,0,0,1
S01009512,Occupancy rating 0,35,1,1,0,32,1,23,2,17,4,8,7,1,2,1,0,0,1
S01009512,Occupancy rating -1 or less,8,1,1,0,6,0,3,2,1,0,3,3,0,1,1,0,0,0
S01009513,All households,245,49,28,21,194,37,142,68,48,26,15,13,2,2,1,0,0,1
S01009513,Occupancy rating +2 or more,174,39,22,17,134,32,99,65,24,10,3,2,1,1,1,0,0,0
S01009513,Occupancy rating +1,47,7,5,2,39,5,28,3,16,9,6,6,0,1,0,0,0,1
S01009513,Occupancy rating 0,22,2,1,1,20,0,14,0,7,7,6,5,1,0,0,0,0,0
S01009513,Occupancy rating -1 or less,2,1,0,1,1,0,1,0,1,0,0,0,0,0,0,0,0,0
S01009514,All households,282,46,16,30,231,36,170,75,65,30,25,12,13,5,2,0,0,3
S01009514,Occupancy rating +2 or more,174,28,13,15,144,30,106,65,28,13,8,4,4,2,0,0,0,2
S01009514,Occupancy rating +1,75,17,3,14,55,5,40,9,23,8,10,3,7,3,2,0,0,1
S01009514,Occupancy rating 0,24,0,0,0,24,1,21,1,13,7,2,2,0,0,0,0,0,0
S01009514,Occupancy rating -1 or less,9,1,0,1,8,0,3,0,1,2,5,3,2,0,0,0,0,0
S01009515,All households,362,136,73,63,218,44,126,55,53,18,48,28,20,8,5,0,0,3
S01009515,Occupancy rating +2 or more,69,27,16,11,42,15,24,19,4,1,3,1,2,0,0,0,0,0
S01009515,Occupancy rating +1,137,61,29,32,75,15,53,27,17,9,7,4,3,1,0,0,0,1
S01009515,Occupancy rating 0,131,44,26,18,85,13,42,7,27,8,30,18,12,2,1,0,0,1
S01009515,Occupancy rating -1 or less,25,4,2,2,16,1,7,2,5,0,8,5,3,5,4,0,0,1
S01009516,All households,399,131,83,48,256,57,166,86,65,15,33,18,15,12,6,0,0,6
S01009516,Occupancy rating +2 or more,108,33,15,18,75,19,54,38,16,0,2,2,0,0,0,0,0,0
S01009516,Occupancy rating +1,160,58,36,22,98,26,68,41,19,8,4,1,3,4,2,0,0,2
S01009516,Occupancy rating 0,107,38,30,8,64,7,36,6,25,5,21,10,11,5,1,0,0,4
S01009516,Occupancy rating -1 or less,24,2,2,0,19,5,8,1,5,2,6,5,1,3,3,0,0,0
S01009517,All households,347,54,8,46,281,6,248,83,146,19,27,25,2,12,6,0,0,6
S01009517,Occupancy rating +2 or more,247,31,5,26,212,4,193,67,113,13,15,15,0,4,2,0,0,2
S01009517,Occupancy rating +1,63,16,2,14,42,2,33,12,20,1,7,7,0,5,3,0,0,2
S01009517,Occupancy rating 0,34,7,1,6,25,0,20,4,12,4,5,3,2,2,0,0,0,2
S01009517,Occupancy rating -1 or less,3,0,0,0,2,0,2,0,1,1,0,0,0,1,1,0,0,0
S01009518,All households,319,44,2,42,260,3,236,73,145,18,21,18,3,15,6,0,0,9
S01009518,Occupancy rating +2 or more,227,22,1,21,200,2,189,60,112,17,9,7,2,5,2,0,0,3
S01009518,Occupancy rating +1,68,19,1,18,41,1,32,12,19,1,8,7,1,8,3,0,0,5
S01009518,Occupancy rating 0,15,1,0,1,13,0,11,1,10,0,2,2,0,1,1,0,0,0
S01009518,Occupancy rating -1 or less,9,2,0,2,6,0,4,0,4,0,2,2,0,1,0,0,0,1
S01009519,All households,195,44,11,33,145,13,117,49,50,18,15,8,7,6,4,0,1,1
S01009519,Occupancy rating +2 or more,98,17,4,13,80,8,69,43,17,9,3,3,0,1,0,0,1,0
S01009519,Occupancy rating +1,63,21,5,16,39,5,27,6,13,8,7,2,5,3,3,0,0,0
S01009519,Occupancy rating 0,26,5,2,3,20,0,16,0,15,1,4,2,2,1,0,0,0,1
S01009519,Occupancy rating -1 or less,8,1,0,1,6,0,5,0,5,0,1,1,0,1,1,0,0,0
S01009520,All households,328,70,17,53,248,22,202,82,89,31,24,19,5,10,4,0,0,6
S01009520,Occupancy rating +2 or more,169,28,8,20,136,17,111,59,41,11,8,4,4,5,2,0,0,3
S01009520,Occupancy rating +1,89,21,5,16,65,4,54,16,26,12,7,6,1,3,2,0,0,1
S01009520,Occupancy rating 0,55,16,0,16,38,1,32,6,19,7,5,5,0,1,0,0,0,1
S01009520,Occupancy rating -1 or less,15,5,4,1,9,0,5,1,3,1,4,4,0,1,0,0,0,1
S01009521,All households,363,95,56,39,242,50,134,63,45,26,58,41,17,26,14,0,3,9
S01009521,Occupancy rating +2 or more,129,49,31,18,79,26,51,40,5,6,2,1,1,1,0,0,0,1
S01009521,Occupancy rating +1,111,27,15,12,78,17,41,17,15,9,20,11,9,6,1,0,1,4
S01009521,Occupancy rating 0,79,15,7,8,58,5,28,3,17,8,25,20,5,6,2,0,2,2
S01009521,Occupancy rating -1 or less,44,4,3,1,27,2,14,3,8,3,11,9,2,13,11,0,0,2
S01009522,All households,376,70,16,54,278,26,173,64,82,27,79,64,15,28,17,0,2,9
S01009522,Occupancy rating +2 or more,132,31,8,23,97,19,65,45,14,6,13,9,4,4,1,0,1,2
S01009522,Occupancy rating +1,124,27,4,23,90,7,58,16,30,12,25,18,7,7,3,0,0,4
S01009522,Occupancy rating 0,93,12,4,8,71,0,38,3,31,4,33,30,3,10,8,0,0,2
S01009522,Occupancy rating -1 or less,27,0,0,0,20,0,12,0,7,5,8,7,1,7,5,0,1,1
S01009523,All households,263,92,46,46,155,17,89,32,39,18,49,31,18,16,9,0,0,7
S01009523,Occupancy rating +2 or more,61,25,11,14,36,6,24,13,6,5,6,3,3,0,0,0,0,0
S01009523,Occupancy rating +1,104,48,24,24,51,8,30,15,10,5,13,8,5,5,2,0,0,3
S01009523,Occupancy rating 0,74,15,10,5,53,1,31,4,21,6,21,13,8,6,3,0,0,3
S01009523,Occupancy rating -1 or less,24,4,1,3,15,2,4,0,2,2,9,7,2,5,4,0,0,1
S01009524,All households,341,150,45,105,178,12,122,64,51,7,44,34,10,13,4,2,0,7
S01009524,Occupancy rating +2 or more,97,29,10,19,67,12,50,33,13,4,5,4,1,1,0,1,0,0
S01009524,Occupancy rating +1,95,48,15,33,45,0,40,23,15,2,5,3,2,2,2,0,0,0
S01009524,Occupancy rating 0,118,67,16,51,44,0,23,5,17,1,21,15,6,7,0,1,0,6
S01009524,Occupancy rating -1 or less,31,6,4,2,22,0,9,3,6,0,13,12,1,3,2,0,0,1
S01009525,All households,254,95,35,60,148,27,82,34,28,20,39,30,9,11,1,1,0,9
S01009525,Occupancy rating +2 or more,78,35,18,17,42,13,26,15,5,6,3,2,1,1,0,0,0,1
S01009525,Occupancy rating +1,92,40,14,26,48,10,27,16,6,5,11,8,3,4,0,1,0,3
S01009525,Occupancy rating 0,73,20,3,17,48,4,22,2,11,9,22,17,5,5,0,0,0,5
S01009525,Occupancy rating -1 or less,11,0,0,0,10,0,7,1,6,0,3,3,0,1,1,0,0,0
S01009526,All households,365,156,31,125,197,18,152,104,39,9,27,17,10,12,2,0,0,10
S01009526,Occupancy rating +2 or more,74,22,12,10,51,7,42,27,11,4,2,2,0,1,0,0,0,1
S01009526,Occupancy rating +1,171,90,18,72,80,9,69,60,8,1,2,1,1,1,0,0,0,1
S01009526,Occupancy rating 0,96,36,1,35,54,2,34,12,18,4,18,11,7,6,0,0,0,6
S01009526,Occupancy rating -1 or less,24,8,0,8,12,0,7,5,2,0,5,3,2,4,2,0,0,2
S01009527,All households,384,216,71,145,145,19,107,72,25,10,19,11,8,23,5,0,0,18
S01009527,Occupancy rating +2 or more,67,23,10,13,43,5,37,26,7,4,1,1,0,1,0,0,0,1
S01009527,Occupancy rating +1,156,96,33,63,58,12,40,33,5,2,6,2,4,2,0,0,0,2
S01009527,Occupancy rating 0,128,77,24,53,38,2,27,12,11,4,9,5,4,13,1,0,0,12
S01009527,Occupancy rating -1 or less,33,20,4,16,6,0,3,1,2,0,3,3,0,7,4,0,0,3
S01009528,All households,355,228,128,100,118,43,56,39,14,3,19,8,11,9,2,0,0,7
S01009528,Occupancy rating +2 or more,49,29,12,17,19,3,15,9,4,2,1,1,0,1,1,0,0,0
S01009528,Occupancy rating +1,160,107,70,37,53,29,21,16,5,0,3,0,3,0,0,0,0,0
S01009528,Occupancy rating 0,117,75,38,37,36,6,15,10,4,1,15,7,8,6,1,0,0,5
S01009528,Occupancy rating -1 or less,29,17,8,9,10,5,5,4,1,0,0,0,0,2,0,0,0,2
S01009529,All households,247,84,38,46,155,31,114,51,44,19,10,4,6,8,3,1,1,3
S01009529,Occupancy rating +2 or more,151,35,19,16,112,21,87,46,26,15,4,1,3,4,2,0,1,1
S01009529,Occupancy rating +1,55,26,12,14,26,9,16,3,11,2,1,1,0,3,0,1,0,2
S01009529,Occupancy rating 0,30,15,5,10,14,1,10,2,6,2,3,1,2,1,1,0,0,0
S01009529,Occupancy rating -1 or less,11,8,2,6,3,0,1,0,1,0,2,1,1,0,0,0,0,0
S01009530,All households,255,63,42,21,185,38,135,67,51,17,12,8,4,7,3,0,2,2
S01009530,Occupancy rating +2 or more,195,50,34,16,143,37,101,53,37,11,5,4,1,2,1,0,0,1
S01009530,Occupancy rating +1,43,11,7,4,28,0,24,13,7,4,4,2,2,4,1,0,2,1
S01009530,Occupancy rating 0,13,2,1,1,11,1,8,1,5,2,2,1,1,0,0,0,0,0
S01009530,Occupancy rating -1 or less,4,0,0,0,3,0,2,0,2,0,1,1,0,1,1,0,0,0
S01009531,All households,432,208,95,113,214,33,128,57,49,22,53,33,20,10,5,0,0,5
S01009531,Occupancy rating +2 or more,89,40,20,20,48,17,30,19,4,7,1,0,1,1,0,0,0,1
S01009531,Occupancy rating +1,155,83,33,50,72,11,51,27,13,11,10,4,6,0,0,0,0,0
S01009531,Occupancy rating 0,147,72,37,35,72,4,38,5,29,4,30,19,11,3,1,0,0,2
S01009531,Occupancy rating -1 or less,41,13,5,8,22,1,9,6,3,0,12,10,2,6,4,0,0,2
S01009532,All households,437,195,98,97,231,57,126,67,35,24,48,25,23,11,0,0,3,8
S01009532,Occupancy rating +2 or more,63,28,18,10,35,14,21,16,3,2,0,0,0,0,0,0,0,0
S01009532,Occupancy rating +1,216,116,53,63,96,34,57,43,7,7,5,1,4,4,0,0,1,3
S01009532,Occupancy rating 0,128,42,23,19,79,6,38,4,21,13,35,20,15,7,0,0,2,5
S01009532,Occupancy rating -1 or less,30,9,4,5,21,3,10,4,4,2,8,4,4,0,0,0,0,0
S01009533,All households,440,223,72,151,209,16,131,73,42,16,62,41,21,8,4,0,0,4
S01009533,Occupancy rating +2 or more,51,23,6,17,28,1,23,19,3,1,4,3,1,0,0,0,0,0
S01009533,Occupancy rating +1,174,105,42,63,69,11,49,34,10,5,9,6,3,0,0,0,0,0
S01009533,Occupancy rating 0,171,80,19,61,88,1,47,15,22,10,40,27,13,3,0,0,0,3
S01009533,Occupancy rating -1 or less,44,15,5,10,24,3,12,5,7,0,9,5,4,5,4,0,0,1
S01009534,All households,427,200,62,138,212,15,118,56,51,11,79,62,17,15,9,0,1,5
S01009534,Occupancy rating +2 or more,76,43,12,31,33,4,23,17,5,1,6,5,1,0,0,0,0,0
S01009534,Occupancy rating +1,132,67,12,55,63,6,35,20,12,3,22,16,6,2,1,0,1,0
S01009534,Occupancy rating 0,171,81,37,44,83,3,46,15,25,6,34,28,6,7,3,0,0,4
S01009534,Occupancy rating -1 or less,48,9,1,8,33,2,14,4,9,1,17,13,4,6,5,0,0,1
S01009535,All households,297,136,27,109,137,6,81,26,45,10,50,42,8,24,7,0,0,17
S01009535,Occupancy rating +2 or more,37,20,4,16,17,3,13,6,5,2,1,1,0,0,0,0,0,0
S01009535,Occupancy rating +1,104,62,12,50,37,3,27,16,8,3,7,6,1,5,1,0,0,4
S01009535,Occupancy rating 0,123,50,10,40,63,0,35,3,27,5,28,21,7,10,1,0,0,9
S01009535,Occupancy rating -1 or less,33,4,1,3,20,0,6,1,5,0,14,14,0,9,5,0,0,4
S01009536,All households,228,73,30,43,148,18,96,26,54,16,34,31,3,7,1,1,0,5
S01009536,Occupancy rating +2 or more,81,21,6,15,58,10,43,13,22,8,5,5,0,2,0,0,0,2
S01009536,Occupancy rating +1,74,35,12,23,36,8,21,11,5,5,7,6,1,3,1,0,0,2
S01009536,Occupancy rating 0,51,13,9,4,37,0,21,0,18,3,16,15,1,1,0,1,0,0
S01009536,Occupancy rating -1 or less,22,4,3,1,17,0,11,2,9,0,6,5,1,1,0,0,0,1
S01009537,All households,280,124,46,78,149,28,93,48,36,9,28,23,5,7,3,0,2,2
S01009537,Occupancy rating +2 or more,76,20,10,10,53,14,38,24,11,3,1,0,1,3,2,0,0,1
S01009537,Occupancy rating +1,99,63,26,37,35,9,21,13,7,1,5,5,0,1,0,0,1,0
S01009537,Occupancy rating 0,77,35,7,28,41,5,21,8,10,3,15,12,3,1,0,0,0,1
S01009537,Occupancy rating -1 or less,28,6,3,3,20,0,13,3,8,2,7,6,1,2,1,0,1,0
S01009538,All households,401,221,55,166,171,12,124,69,41,14,35,31,4,9,2,0,0,7
S01009538,Occupancy rating +2 or more,87,35,10,25,50,5,42,29,11,2,3,3,0,2,1,0,0,1
S01009538,Occupancy rating +1,162,100,23,77,61,6,48,31,9,8,7,5,2,1,0,0,0,1
S01009538,Occupancy rating 0,127,76,22,54,47,0,27,7,18,2,20,18,2,4,0,0,0,4
S01009538,Occupancy rating -1 or less,25,10,0,10,13,1,7,2,3,2,5,5,0,2,1,0,0,1
S01009539,All households,389,107,62,45,266,40,182,94,62,26,44,28,16,16,5,0,1,10
S01009539,Occupancy rating +2 or more,154,44,32,12,109,23,80,53,20,7,6,2,4,1,0,0,0,1
S01009539,Occupancy rating +1,133,42,18,24,82,14,51,30,11,10,17,10,7,9,1,0,1,7
S01009539,Occupancy rating 0,80,18,10,8,58,2,38,9,23,6,18,15,3,4,3,0,0,1
S01009539,Occupancy rating -1 or less,22,3,2,1,17,1,13,2,8,3,3,1,2,2,1,0,0,1
S01009540,All households,459,235,63,172,213,28,129,65,51,13,56,32,24,11,2,0,0,9
S01009540,Occupancy rating +2 or more,80,22,12,10,57,15,41,28,9,4,1,0,1,1,0,0,0,1
S01009540,Occupancy rating +1,167,100,23,77,66,11,45,27,12,6,10,5,5,1,0,0,0,1
S01009540,Occupancy rating 0,170,92,23,69,73,2,39,8,28,3,32,19,13,5,1,0,0,4
S01009540,Occupancy rating -1 or less,42,21,5,16,17,0,4,2,2,0,13,8,5,4,1,0,0,3
S01009541,All households,321,87,29,58,227,30,176,86,66,24,21,16,5,7,2,0,1,4
S01009541,Occupancy rating +2 or more,159,38,13,25,119,16,97,57,27,13,6,4,2,2,1,0,0,1
S01009541,Occupancy rating +1,92,31,10,21,60,9,44,24,14,6,7,6,1,1,0,0,0,1
S01009541,Occupancy rating 0,58,16,5,11,38,2,29,4,21,4,7,5,2,4,1,0,1,2
S01009541,Occupancy rating -1 or less,12,2,1,1,10,3,6,1,4,1,1,1,0,0,0,0,0,0
S01009542,All households,380,171,40,131,198,16,118,46,57,15,64,47,17,11,5,0,0,6
S01009542,Occupancy rating +2 or more,62,30,12,18,30,5,22,16,5,1,3,3,0,2,1,0,0,1
S01009542,Occupancy rating +1,161,89,19,70,70,10,49,26,15,8,11,7,4,2,0,0,0,2
S01009542,Occupancy rating 0,122,41,8,33,76,1,38,3,31,4,37,28,9,5,2,0,0,3
S01009542,Occupancy rating -1 or less,35,11,1,10,22,0,9,1,6,2,13,9,4,2,2,0,0,0
S01009543,All households,279,115,56,59,154,32,110,63,25,22,12,7,5,10,3,0,1,6
S01009543,Occupancy rating +2 or more,100,25,9,16,74,19,55,36,10,9,0,0,0,1,0,0,1,0
S01009543,Occupancy rating +1,85,40,22,18,44,9,32,19,7,6,3,0,3,1,0,0,0,1
S01009543,Occupancy rating 0,81,43,21,22,33,4,21,8,8,5,8,6,2,5,2,0,0,3
S01009543,Occupancy rating -1 or less,13,7,4,3,3,0,2,0,0,2,1,1,0,3,1,0,0,2
S01009544,All households,432,170,73,97,248,41,181,104,63,14,26,15,11,14,5,0,1,8
S01009544,Occupancy rating +2 or more,120,36,16,20,83,20,61,36,23,2,2,0,2,1,1,0,0,0
S01009544,Occupancy rating +1,169,72,31,41,95,17,74,51,20,3,4,3,1,2,1,0,0,1
S01009544,Occupancy rating 0,123,55,24,31,60,4,41,16,18,7,15,8,7,8,1,0,0,7
S01009544,Occupancy rating -1 or less,20,7,2,5,10,0,5,1,2,2,5,4,1,3,2,0,1,0
S01009545,All households,344,92,48,44,240,35,151,69,58,24,54,38,16,12,6,0,1,5
S01009545,Occupancy rating +2 or more,119,23,13,10,93,22,68,41,18,9,3,2,1,3,1,0,0,2
S01009545,Occupancy rating +1,122,41,18,23,77,10,47,23,14,10,20,16,4,4,2,0,0,2
S01009545,Occupancy rating 0,83,23,13,10,57,1,28,5,19,4,28,20,8,3,2,0,1,0
S01009545,Occupancy rating -1 or less,20,5,4,1,13,2,8,0,7,1,3,0,3,2,1,0,0,1
S01009546,All households,414,102,33,69,294,17,226,107,90,29,51,35,16,18,10,0,0,8
S01009546,Occupancy rating +2 or more,158,33,15,18,120,9,104,67,30,7,7,6,1,5,4,0,0,1
S01009546,Occupancy rating +1,149,53,15,38,91,4,69,32,26,11,18,11,7,5,2,0,0,3
S01009546,Occupancy rating 0,84,15,3,12,65,2,43,8,27,8,20,14,6,4,1,0,0,3
S01009546,Occupancy rating -1 or less,23,1,0,1,18,2,10,0,7,3,6,4,2,4,3,0,0,1
S01009547,All households,337,98,32,66,219,27,126,68,39,19,66,50,16,20,12,0,1,7
S01009547,Occupancy rating +2 or more,101,26,14,12,71,13,53,39,9,5,5,3,2,4,2,0,0,2
S01009547,Occupancy rating +1,121,45,14,31,71,13,44,25,13,6,14,10,4,5,2,0,1,2
S01009547,Occupancy rating 0,88,24,3,21,59,1,22,3,11,8,36,28,8,5,2,0,0,3
S01009547,Occupancy rating -1 or less,27,3,1,2,18,0,7,1,6,0,11,9,2,6,6,0,0,0
S01009548,All households,317,106,55,51,202,21,139,62,50,27,42,30,12,9,4,0,1,4
S01009548,Occupancy rating +2 or more,102,36,20,16,65,9,55,32,13,10,1,1,0,1,1,0,0,0
S01009548,Occupancy rating +1,119,50,27,23,67,9,44,22,15,7,14,11,3,2,0,0,0,2
S01009548,Occupancy rating 0,80,19,7,12,57,2,31,6,18,7,24,16,8,4,2,0,0,2
S01009548,Occupancy rating -1 or less,16,1,1,0,13,1,9,2,4,3,3,2,1,2,1,0,1,0
S01009549,All households,348,101,43,58,226,28,165,80,58,27,33,24,9,21,7,0,2,12
S01009549,Occupancy rating +2 or more,136,33,14,19,98,11,83,57,16,10,4,3,1,5,1,0,1,3
S01009549,Occupancy rating +1,115,34,17,17,73,12,45,16,18,11,16,10,6,8,2,0,1,5
S01009549,Occupancy rating 0,76,29,10,19,42,2,30,7,19,4,10,9,1,5,2,0,0,3
S01009549,Occupancy rating -1 or less,21,5,2,3,13,3,7,0,5,2,3,2,1,3,2,0,0,1
S01009550,All households,208,48,25,23,157,21,107,34,50,23,29,20,9,3,1,0,1,1
S01009550,Occupancy rating +2 or more,105,25,14,11,80,20,53,26,17,10,7,3,4,0,0,0,0,0
S01009550,Occupancy rating +1,54,12,3,9,40,1,33,8,16,9,6,5,1,2,1,0,1,0
S01009550,Occupancy rating 0,40,10,7,3,29,0,18,0,14,4,11,8,3,1,0,0,0,1
S01009550,Occupancy rating -1 or less,9,1,1,0,8,0,3,0,3,0,5,4,1,0,0,0,0,0
S01009551,All households,229,65,26,39,154,15,107,43,49,15,32,17,15,10,5,0,1,4
S01009551,Occupancy rating +2 or more,92,29,12,17,62,11,46,31,12,3,5,3,2,1,0,0,0,1
S01009551,Occupancy rating +1,72,19,6,13,50,3,29,10,16,3,18,8,10,3,1,0,1,1
S01009551,Occupancy rating 0,57,17,8,9,35,1,27,2,18,7,7,4,3,5,3,0,0,2
S01009551,Occupancy rating -1 or less,8,0,0,0,7,0,5,0,3,2,2,2,0,1,1,0,0,0
S01009552,All households,398,113,61,52,268,51,177,83,63,31,40,26,14,17,5,0,6,6
S01009552,Occupancy rating +2 or more,187,46,29,17,133,41,87,58,16,13,5,2,3,8,4,0,2,2
S01009552,Occupancy rating +1,117,47,22,25,63,6,49,16,22,11,8,5,3,7,0,0,3,4
S01009552,Occupancy rating 0,79,16,9,7,61,2,34,5,23,6,25,19,6,2,1,0,1,0
S01009552,Occupancy rating -1 or less,15,4,1,3,11,2,7,4,2,1,2,0,2,0,0,0,0,0
S01009553,All households,421,162,55,107,241,24,139,70,56,13,78,51,27,18,8,0,2,8
S01009553,Occupancy rating +2 or more,117,44,21,23,72,12,54,40,12,2,6,2,4,1,0,0,0,1
S01009553,Occupancy rating +1,123,54,16,38,66,8,37,21,12,4,21,6,15,3,0,0,2,1
S01009553,Occupancy rating 0,136,55,14,41,75,3,34,6,23,5,38,31,7,6,1,0,0,5
S01009553,Occupancy rating -1 or less,45,9,4,5,28,1,14,3,9,2,13,12,1,8,7,0,0,1
S01009554,All households,311,121,36,85,185,27,124,59,39,26,34,27,7,5,4,0,0,1
S01009554,Occupancy rating +2 or more,116,33,10,23,81,15,63,38,11,14,3,2,1,2,1,0,0,1
S01009554,Occupancy rating +1,92,46,20,26,44,10,29,13,9,7,5,3,2,2,2,0,0,0
S01009554,Occupancy rating 0,79,37,5,32,42,2,21,7,11,3,19,16,3,0,0,0,0,0
S01009554,Occupancy rating -1 or less,24,5,1,4,18,0,11,1,8,2,7,6,1,1,1,0,0,0
S01009555,All households,364,142,53,89,206,35,131,66,45,20,40,28,12,16,9,0,1,6
S01009555,Occupancy rating +2 or more,153,46,23,23,103,25,71,42,17,12,7,4,3,4,2,0,0,2
S01009555,Occupancy rating +1,98,53,15,38,41,4,32,14,13,5,5,2,3,4,3,0,0,1
S01009555,Occupancy rating 0,87,34,13,21,49,5,24,9,13,2,20,16,4,4,2,0,1,1
S01009555,Occupancy rating -1 or less,26,9,2,7,13,1,4,1,2,1,8,6,2,4,2,0,0,2
S01009556,All households,338,92,27,65,223,25,131,57,51,23,67,50,17,23,11,0,0,12
S01009556,Occupancy rating +2 or more,104,26,13,13,75,15,52,34,11,7,8,1,7,3,0,0,0,3
S01009556,Occupancy rating +1,110,44,6,38,62,5,41,22,16,3,16,12,4,4,3,0,0,1
S01009556,Occupancy rating 0,95,20,7,13,64,3,29,1,19,9,32,27,5,11,6,0,0,5
S01009556,Occupancy rating -1 or less,29,2,1,1,22,2,9,0,5,4,11,10,1,5,2,0,0,3
S01009557,All households,300,94,27,67,195,22,115,47,56,12,58,32,26,11,3,0,0,8
S01009557,Occupancy rating +2 or more,94,25,11,14,66,18,41,26,12,3,7,2,5,3,2,0,0,1
S01009557,Occupancy rating +1,120,52,14,38,64,4,37,18,15,4,23,12,11,4,0,0,0,4
S01009557,Occupancy rating 0,61,10,2,8,50,0,29,1,24,4,21,13,8,1,0,0,0,1
S01009557,Occupancy rating -1 or less,25,7,0,7,15,0,8,2,5,1,7,5,2,3,1,0,0,2
S01009558,All households,291,83,26,57,194,18,112,44,55,13,64,46,18,14,5,1,1,7
S01009558,Occupancy rating +2 or more,89,32,15,17,53,13,35,20,10,5,5,4,1,4,1,0,1,2
S01009558,Occupancy rating +1,106,43,9,34,59,5,36,21,12,3,18,11,7,4,0,1,0,3
S01009558,Occupancy rating 0,76,6,1,5,67,0,35,3,27,5,32,24,8,3,1,0,0,2
S01009558,Occupancy rating -1 or less,20,2,1,1,15,0,6,0,6,0,9,7,2,3,3,0,0,0
S01009559,All households,374,124,40,84,223,18,140,56,58,26,65,45,20,27,13,0,1,13
S01009559,Occupancy rating +2 or more,127,43,20,23,78,16,48,33,11,4,14,9,5,6,2,0,0,4
S01009559,Occupancy rating +1,103,32,7,25,66,1,49,21,18,10,16,11,5,5,1,0,0,4
S01009559,Occupancy rating 0,101,34,10,24,59,1,32,2,21,9,26,18,8,8,4,0,1,3
S01009559,Occupancy rating -1 or less,43,15,3,12,20,0,11,0,8,3,9,7,2,8,6,0,0,2
S01009560,All households,351,124,38,86,203,27,100,42,40,18,76,53,23,24,11,1,0,12
S01009560,Occupancy rating +2 or more,131,53,14,39,77,19,38,25,10,3,20,13,7,1,0,0,0,1
S01009560,Occupancy rating +1,105,38,14,24,61,6,28,10,9,9,27,17,10,6,1,0,0,5
S01009560,Occupancy rating 0,94,29,9,20,52,2,27,6,16,5,23,18,5,13,7,1,0,5
S01009560,Occupancy rating -1 or less,21,4,1,3,13,0,7,1,5,1,6,5,1,4,3,0,0,1
S01009561,All households,258,106,36,70,138,20,78,30,40,8,40,29,11,14,5,0,0,9
S01009561,Occupancy rating +2 or more,86,37,13,24,46,12,26,16,8,2,8,6,2,3,0,0,0,3
S01009561,Occupancy rating +1,77,34,10,24,38,2,24,8,14,2,12,9,3,5,2,0,0,3
S01009561,Occupancy rating 0,73,29,11,18,42,6,20,4,14,2,16,11,5,2,1,0,0,1
S01009561,Occupancy rating -1 or less,22,6,2,4,12,0,8,2,4,2,4,3,1,4,2,0,0,2
S01009562,All households,316,92,39,53,212,30,142,66,58,18,40,24,16,12,5,0,0,7
S01009562,Occupancy rating +2 or more,122,40,22,18,81,21,57,38,12,7,3,2,1,1,1,0,0,0
S01009562,Occupancy rating +1,114,40,11,29,71,6,53,26,22,5,12,5,7,3,1,0,0,2
S01009562,Occupancy rating 0,66,11,6,5,50,3,24,2,16,6,23,16,7,5,2,0,0,3
S01009562,Occupancy rating -1 or less,14,1,0,1,10,0,8,0,8,0,2,1,1,3,1,0,0,2
S01009563,All households,373,132,67,65,231,51,127,54,61,12,53,32,21,10,1,1,0,8
S01009563,Occupancy rating +2 or more,103,42,29,13,61,23,35,26,8,1,3,1,2,0,0,0,0,0
S01009563,Occupancy rating +1,156,60,22,38,94,23,52,24,23,5,19,11,8,2,0,0,0,2
S01009563,Occupancy rating 0,95,28,15,13,61,3,33,3,25,5,25,14,11,6,0,1,0,5
S01009563,Occupancy rating -1 or less,19,2,1,1,15,2,7,1,5,1,6,6,0,2,1,0,0,1
S01009564,All households,315,109,74,35,201,48,122,40,51,31,31,19,12,5,2,0,0,3
S01009564,Occupancy rating +2 or more,146,39,24,15,106,39,62,32,12,18,5,2,3,1,0,0,0,1
S01009564,Occupancy rating +1,74,21,11,10,52,6,33,8,18,7,13,7,6,1,0,0,0,1
S01009564,Occupancy rating 0,73,33,25,8,37,3,23,0,18,5,11,9,2,3,2,0,0,1
S01009564,Occupancy rating -1 or less,22,16,14,2,6,0,4,0,3,1,2,1,1,0,0,0,0,0
S01009565,All households,246,77,18,59,159,28,94,21,56,17,37,27,10,10,6,0,0,4
S01009565,Occupancy rating +2 or more,87,33,13,20,53,20,30,13,14,3,3,2,1,1,0,0,0,1
S01009565,Occupancy rating +1,69,20,4,16,46,5,31,8,16,7,10,5,5,3,0,0,0,3
S01009565,Occupancy rating 0,67,16,0,16,49,3,28,0,21,7,18,14,4,2,2,0,0,0
S01009565,Occupancy rating -1 or less,23,8,1,7,11,0,5,0,5,0,6,6,0,4,4,0,0,0
S01009566,All households,431,110,46,64,305,23,233,89,108,36,49,39,10,16,8,0,0,8
S01009566,Occupancy rating +2 or more,170,53,24,29,114,13,99,54,36,9,2,1,1,3,1,0,0,2
S01009566,Occupancy rating +1,139,32,9,23,102,6,77,29,31,17,19,13,6,5,3,0,0,2
S01009566,Occupancy rating 0,103,21,12,9,78,3,50,4,36,10,25,22,3,4,0,0,0,4
S01009566,Occupancy rating -1 or less,19,4,1,3,11,1,7,2,5,0,3,3,0,4,4,0,0,0
S01009567,All households,414,152,63,89,248,30,163,67,70,26,55,35,20,14,4,0,0,10
S01009567,Occupancy rating +2 or more,129,58,25,33,69,17,43,31,9,3,9,4,5,2,1,0,0,1
S01009567,Occupancy rating +1,134,49,18,31,81,8,61,31,22,8,12,7,5,4,0,0,0,4
S01009567,Occupancy rating 0,126,40,19,21,80,5,50,5,32,13,25,17,8,6,2,0,0,4
S01009567,Occupancy rating -1 or less,25,5,1,4,18,0,9,0,7,2,9,7,2,2,1,0,0,1
S01009568,All households,333,112,51,61,208,29,123,45,59,19,56,38,18,13,8,0,0,5
S01009568,Occupancy rating +2 or more,105,33,16,17,71,20,41,25,13,3,10,7,3,1,1,0,0,0
S01009568,Occupancy rating +1,121,48,14,34,71,6,47,16,20,11,18,10,8,2,0,0,0,2
S01009568,Occupancy rating 0,86,24,15,9,57,2,32,4,25,3,23,18,5,5,2,0,0,3
S01009568,Occupancy rating -1 or less,21,7,6,1,9,1,3,0,1,2,5,3,2,5,5,0,0,0
S01009569,All households,363,102,60,42,249,49,154,62,70,22,46,27,19,12,5,0,0,7
S01009569,Occupancy rating +2 or more,122,45,29,16,76,34,41,33,5,3,1,0,1,1,1,0,0,0
S01009569,Occupancy rating +1,137,36,17,19,97,13,62,24,27,11,22,14,8,4,1,0,0,3
S01009569,Occupancy rating 0,87,18,12,6,64,2,41,5,30,6,21,12,9,5,2,0,0,3
S01009569,Occupancy rating -1 or less,17,3,2,1,12,0,10,0,8,2,2,1,1,2,1,0,0,1
S01009570,All households,240,68,35,33,163,23,102,47,44,11,38,26,12,9,3,0,0,6
S01009570,Occupancy rating +2 or more,75,23,16,7,51,14,33,28,4,1,4,2,2,1,1,0,0,0
S01009570,Occupancy rating +1,77,23,7,16,49,6,28,16,10,2,15,10,5,5,0,0,0,5
S01009570,Occupancy rating 0,71,18,9,9,51,1,33,3,24,6,17,12,5,2,1,0,0,1
S01009570,Occupancy rating -1 or less,17,4,3,1,12,2,8,0,6,2,2,2,0,1,1,0,0,0
S01009571,All households,297,93,24,69,180,15,102,39,42,21,63,48,15,24,9,0,1,14
S01009571,Occupancy rating +2 or more,95,33,16,17,58,10,36,19,9,8,12,6,6,4,1,0,0,3
S01009571,Occupancy rating +1,99,46,6,40,50,5,35,17,11,7,10,9,1,3,1,0,0,2
S01009571,Occupancy rating 0,74,12,2,10,52,0,27,1,21,5,25,19,6,10,3,0,1,6
S01009571,Occupancy rating -1 or less,29,2,0,2,20,0,4,2,1,1,16,14,2,7,4,0,0,3
S01009572,All households,499,194,58,136,286,38,166,70,73,23,82,61,21,19,6,1,1,11
S01009572,Occupancy rating +2 or more,128,47,21,26,80,21,51,30,13,8,8,4,4,1,0,0,1,0
S01009572,Occupancy rating +1,182,89,26,63,90,10,63,33,22,8,17,11,6,3,0,1,0,2
S01009572,Occupancy rating 0,143,46,8,38,90,6,41,7,27,7,43,34,9,7,2,0,0,5
S01009572,Occupancy rating -1 or less,46,12,3,9,26,1,11,0,11,0,14,12,2,8,4,0,0,4
S01009573,All households,329,109,38,71,203,18,124,56,56,12,61,38,23,17,8,0,1,8
S01009573,Occupancy rating +2 or more,112,42,21,21,68,17,44,30,9,5,7,3,4,2,0,0,0,2
S01009573,Occupancy rating +1,107,41,11,30,62,1,42,18,20,4,19,9,10,4,2,0,1,1
S01009573,Occupancy rating 0,82,25,6,19,51,0,29,8,18,3,22,13,9,6,2,0,0,4
S01009573,Occupancy rating -1 or less,28,1,0,1,22,0,9,0,9,0,13,13,0,5,4,0,0,1
S01009574,All households,447,154,69,85,260,39,156,71,61,24,65,38,27,33,12,3,1,17
S01009574,Occupancy rating +2 or more,133,53,27,26,77,26,47,40,6,1,4,0,4,3,1,0,0,2
S01009574,Occupancy rating +1,163,67,29,38,86,8,59,22,23,14,19,9,10,10,4,0,0,6
S01009574,Occupancy rating 0,115,28,11,17,75,3,40,6,26,8,32,20,12,12,4,3,1,4
S01009574,Occupancy rating -1 or less,36,6,2,4,22,2,10,3,6,1,10,9,1,8,3,0,0,5
S01009575,All households,232,73,38,35,152,19,107,48,43,16,26,19,7,7,3,0,0,4
S01009575,Occupancy rating +2 or more,83,25,5,20,57,9,45,35,7,3,3,3,0,1,1,0,0,0
S01009575,Occupancy rating +1,60,14,4,10,43,3,30,11,11,8,10,6,4,3,0,0,0,3
S01009575,Occupancy rating 0,68,28,23,5,39,5,25,2,18,5,9,6,3,1,0,0,0,1
S01009575,Occupancy rating -1 or less,21,6,6,0,13,2,7,0,7,0,4,4,0,2,2,0,0,0
S01009576,All households,223,44,15,29,171,28,130,77,27,26,13,8,5,8,4,0,0,4
S01009576,Occupancy rating +2 or more,151,23,9,14,123,19,99,65,17,17,5,3,2,5,2,0,0,3
S01009576,Occupancy rating +1,49,16,6,10,33,8,23,11,4,8,2,1,1,0,0,0,0,0
S01009576,Occupancy rating 0,17,5,0,5,11,1,6,1,4,1,4,3,1,1,1,0,0,0
S01009576,Occupancy rating -1 or less,6,0,0,0,4,0,2,0,2,0,2,1,1,2,1,0,0,1
S01009577,All households,253,30,11,19,208,22,168,84,56,28,18,11,7,15,7,0,0,8
S01009577,Occupancy rating +2 or more,196,21,8,13,165,20,138,78,38,22,7,5,2,10,4,0,0,6
S01009577,Occupancy rating +1,32,3,2,1,25,1,19,6,9,4,5,3,2,4,2,0,0,2
S01009577,Occupancy rating 0,20,4,1,3,15,0,9,0,7,2,6,3,3,1,1,0,0,0
S01009577,Occupancy rating -1 or less,5,2,0,2,3,1,2,0,2,0,0,0,0,0,0,0,0,0
S01009578,All households,312,81,28,53,215,24,158,68,62,28,33,25,8,16,8,0,0,8
S01009578,Occupancy rating +2 or more,111,36,10,26,72,11,56,41,10,5,5,5,0,3,1,0,0,2
S01009578,Occupancy rating +1,95,17,3,14,75,5,61,20,29,12,9,8,1,3,1,0,0,2
S01009578,Occupancy rating 0,78,24,14,10,50,7,30,4,16,10,13,9,4,4,3,0,0,1
S01009578,Occupancy rating -1 or less,28,4,1,3,18,1,11,3,7,1,6,3,3,6,3,0,0,3
S01009579,All households,443,125,19,106,300,34,225,91,98,36,41,30,11,18,8,0,1,9
S01009579,Occupancy rating +2 or more,179,24,3,21,150,16,128,58,54,16,6,3,3,5,2,0,0,3
S01009579,Occupancy rating +1,99,31,10,21,66,13,46,14,24,8,7,5,2,2,1,0,0,1
S01009579,Occupancy rating 0,142,66,6,60,69,5,40,18,13,9,24,19,5,7,2,0,1,4
S01009579,Occupancy rating -1 or less,23,4,0,4,15,0,11,1,7,3,4,3,1,4,3,0,0,1
S01009580,All households,355,52,15,37,294,27,244,84,128,32,23,13,10,9,3,1,0,5
S01009580,Occupancy rating +2 or more,244,23,7,16,214,21,185,69,89,27,8,4,4,7,3,0,0,4
S01009580,Occupancy rating +1,83,28,7,21,54,5,41,14,23,4,8,3,5,1,0,1,0,0
S01009580,Occupancy rating 0,23,0,0,0,23,1,16,1,14,1,6,5,1,0,0,0,0,0
S01009580,Occupancy rating -1 or less,5,1,1,0,3,0,2,0,2,0,1,1,0,1,0,0,0,1
S01009581,All households,258,73,29,44,175,26,116,64,33,19,33,23,10,10,3,0,0,7
S01009581,Occupancy rating +2 or more,96,28,13,15,68,20,48,37,7,4,0,0,0,0,0,0,0,0
S01009581,Occupancy rating +1,84,24,7,17,57,4,42,24,8,10,11,7,4,3,1,0,0,2
S01009581,Occupancy rating 0,56,10,8,2,40,2,21,1,16,4,17,13,4,6,2,0,0,4
S01009581,Occupancy rating -1 or less,22,11,1,10,10,0,5,2,2,1,5,3,2,1,0,0,0,1
S01009582,All households,240,81,42,39,146,19,90,36,42,12,37,27,10,13,7,0,2,4
S01009582,Occupancy rating +2 or more,64,25,14,11,39,8,24,20,4,0,7,6,1,0,0,0,0,0
S01009582,Occupancy rating +1,84,32,10,22,50,5,36,14,18,4,9,5,4,2,0,0,1,1
S01009582,Occupancy rating 0,70,21,15,6,45,5,21,1,13,7,19,15,4,4,2,0,0,2
S01009582,Occupancy rating -1 or less,22,3,3,0,12,1,9,1,7,1,2,1,1,7,5,0,1,1
S01009583,All households,336,96,41,55,221,23,142,52,69,21,56,39,17,19,11,0,0,8
S01009583,Occupancy rating +2 or more,112,40,17,23,70,13,52,34,13,5,5,3,2,2,0,0,0,2
S01009583,Occupancy rating +1,103,27,4,23,67,6,46,13,25,8,15,10,5,9,4,0,0,5
S01009583,Occupancy rating 0,107,27,20,7,74,4,38,5,25,8,32,24,8,6,5,0,0,1
S01009583,Occupancy rating -1 or less,14,2,0,2,10,0,6,0,6,0,4,2,2,2,2,0,0,0
S01009584,All households,219,52,29,23,154,38,101,45,42,14,15,9,6,13,6,0,1,6
S01009584,Occupancy rating +2 or more,144,38,25,13,100,33,62,37,20,5,5,3,2,6,2,0,1,3
S01009584,Occupancy rating +1,47,13,4,9,34,5,23,6,12,5,6,2,4,0,0,0,0,0
S01009584,Occupancy rating 0,22,0,0,0,17,0,14,2,8,4,3,3,0,5,2,0,0,3
S01009584,Occupancy rating -1 or less,6,1,0,1,3,0,2,0,2,0,1,1,0,2,2,0,0,0
S01009585,All households,408,108,36,72,285,19,202,87,77,38,64,44,20,15,11,1,0,3
S01009585,Occupancy rating +2 or more,122,34,12,22,87,7,70,56,13,1,10,5,5,1,0,0,0,1
S01009585,Occupancy rating +1,142,38,5,33,101,9,71,25,26,20,21,14,7,3,2,0,0,1
S01009585,Occupancy rating 0,107,28,15,13,73,2,46,4,30,12,25,20,5,6,4,1,0,1
S01009585,Occupancy rating -1 or less,37,8,4,4,24,1,15,2,8,5,8,5,3,5,5,0,0,0
S01009586,All households,313,112,56,56,188,44,123,58,43,22,21,14,7,13,7,0,0,6
S01009586,Occupancy rating +2 or more,124,33,15,18,89,28,60,35,15,10,1,0,1,2,1,0,0,1
S01009586,Occupancy rating +1,76,22,8,14,51,9,36,15,13,8,6,2,4,3,0,0,0,3
S01009586,Occupancy rating 0,94,48,29,19,42,6,24,7,14,3,12,10,2,4,2,0,0,2
S01009586,Occupancy rating -1 or less,19,9,4,5,6,1,3,1,1,1,2,2,0,4,4,0,0,0
S01009587,All households,370,169,93,76,193,35,117,53,42,22,41,28,13,8,3,0,0,5
S01009587,Occupancy rating +2 or more,118,51,35,16,66,16,49,31,7,11,1,1,0,1,0,0,0,1
S01009587,Occupancy rating +1,142,72,36,36,68,18,40,17,18,5,10,5,5,2,1,0,0,1
S01009587,Occupancy rating 0,92,37,16,21,53,1,25,5,16,4,27,20,7,2,1,0,0,1
S01009587,Occupancy rating -1 or less,18,9,6,3,6,0,3,0,1,2,3,2,1,3,1,0,0,2
S01009588,All households,436,128,68,60,285,41,170,67,78,25,74,41,33,23,8,0,1,14
S01009588,Occupancy rating +2 or more,131,48,27,21,79,24,49,34,12,3,6,2,4,4,0,0,0,4
S01009588,Occupancy rating +1,174,50,22,28,116,15,75,31,33,11,26,12,14,8,2,0,0,6
S01009588,Occupancy rating 0,102,26,15,11,70,1,37,2,26,9,32,23,9,6,3,0,1,2
S01009588,Occupancy rating -1 or less,29,4,4,0,20,1,9,0,7,2,10,4,6,5,3,0,0,2
S01009589,All households,356,71,36,35,260,28,178,49,92,37,54,28,26,25,15,0,1,9
S01009589,Occupancy rating +2 or more,157,62,32,30,93,25,66,41,19,6,2,0,2,2,1,0,0,1
S01009589,Occupancy rating +1,115,2,1,1,107,3,73,5,44,24,31,15,16,6,2,0,1,3
S01009589,Occupancy rating 0,61,6,3,3,47,0,29,2,20,7,18,12,6,8,4,0,0,4
S01009589,Occupancy rating -1 or less,23,1,0,1,13,0,10,1,9,0,3,1,2,9,8,0,0,1
S01009590,All households,267,43,19,24,217,36,173,59,90,24,8,4,4,7,5,0,0,2
S01009590,Occupancy rating +2 or more,201,30,12,18,168,28,134,56,64,14,6,3,3,3,3,0,0,0
S01009590,Occupancy rating +1,49,10,6,4,37,6,29,3,19,7,2,1,1,2,1,0,0,1
S01009590,Occupancy rating 0,13,2,1,1,9,2,7,0,6,1,0,0,0,2,1,0,0,1
S01009590,Occupancy rating -1 or less,4,1,0,1,3,0,3,0,1,2,0,0,0,0,0,0,0,0
S01009591,All households,307,102,30,72,196,26,156,83,43,30,14,8,6,9,3,0,0,6
S01009591,Occupancy rating +2 or more,175,42,20,22,129,23,99,50,31,18,7,5,2,4,2,0,0,2
S01009591,Occupancy rating +1,60,20,5,15,39,3,31,20,3,8,5,2,3,1,0,0,0,1
S01009591,Occupancy rating 0,51,28,5,23,21,0,19,9,6,4,2,1,1,2,0,0,0,2
S01009591,Occupancy rating -1 or less,21,12,0,12,7,0,7,4,3,0,0,0,0,2,1,0,0,1
S01009592,All households,246,47,29,18,196,47,139,75,36,28,10,6,4,3,1,0,0,2
S01009592,Occupancy rating +2 or more,180,29,19,10,151,37,110,67,21,22,4,3,1,0,0,0,0,0
S01009592,Occupancy rating +1,47,15,7,8,32,9,19,8,7,4,4,3,1,0,0,0,0,0
S01009592,Occupancy rating 0,15,1,1,0,12,1,9,0,7,2,2,0,2,2,0,0,0,2
S01009592,Occupancy rating -1 or less,4,2,2,0,1,0,1,0,1,0,0,0,0,1,1,0,0,0
S01009593,All households,223,27,14,13,184,26,149,61,54,34,9,7,2,12,3,0,1,8
S01009593,Occupancy rating +2 or more,183,24,12,12,152,24,123,57,43,23,5,4,1,7,2,0,0,5
S01009593,Occupancy rating +1,27,3,2,1,23,2,17,2,7,8,4,3,1,1,0,0,0,1
S01009593,Occupancy rating 0,12,0,0,0,8,0,8,2,4,2,0,0,0,4,1,0,1,2
S01009593,Occupancy rating -1 or less,1,0,0,0,1,0,1,0,0,1,0,0,0,0,0,0,0,0
S01009594,All households,263,49,15,34,200,19,170,77,68,25,11,4,7,14,7,0,0,7
S01009594,Occupancy rating +2 or more,158,17,5,12,136,15,116,63,40,13,5,2,3,5,3,0,0,2
S01009594,Occupancy rating +1,79,29,9,20,45,3,37,13,17,7,5,2,3,5,3,0,0,2
S01009594,Occupancy rating 0,20,3,1,2,13,0,13,0,8,5,0,0,0,4,1,0,0,3
S01009594,Occupancy rating -1 or less,6,0,0,0,6,1,4,1,3,0,1,0,1,0,0,0,0,0
S01009595,All households,174,21,6,15,146,5,127,41,69,17,14,6,8,7,5,0,0,2
S01009595,Occupancy rating +2 or more,139,15,4,11,120,3,109,40,61,8,8,3,5,4,4,0,0,0
S01009595,Occupancy rating +1,18,3,1,2,15,2,10,0,5,5,3,1,2,0,0,0,0,0
S01009595,Occupancy rating 0,11,3,1,2,6,0,6,0,2,4,0,0,0,2,1,0,0,1
S01009595,Occupancy rating -1 or less,6,0,0,0,5,0,2,1,1,0,3,2,1,1,0,0,0,1
S01009596,All households,355,112,24,88,226,20,139,65,37,37,67,43,24,17,10,0,0,7
S01009596,Occupancy rating +2 or more,105,29,5,24,72,10,51,37,4,10,11,5,6,4,1,0,0,3
S01009596,Occupancy rating +1,85,22,7,15,60,5,40,20,6,14,15,7,8,3,1,0,0,2
S01009596,Occupancy rating 0,131,49,9,40,77,5,41,7,23,11,31,25,6,5,4,0,0,1
S01009596,Occupancy rating -1 or less,34,12,3,9,17,0,7,1,4,2,10,6,4,5,4,0,0,1
S01009597,All households,361,118,25,93,230,6,147,48,75,24,77,61,16,13,4,0,0,9
S01009597,Occupancy rating +2 or more,84,29,4,25,51,2,45,27,12,6,4,3,1,4,1,0,0,3
S01009597,Occupancy rating +1,105,35,8,27,68,3,39,15,17,7,26,17,9,2,0,0,0,2
S01009597,Occupancy rating 0,134,40,9,31,91,1,50,4,36,10,40,34,6,3,1,0,0,2
S01009597,Occupancy rating -1 or less,38,14,4,10,20,0,13,2,10,1,7,7,0,4,2,0,0,2
S01009598,All households,303,125,27,98,167,13,94,30,49,15,60,40,20,11,5,0,1,5
S01009598,Occupancy rating +2 or more,52,13,1,12,35,5,27,12,14,1,3,2,1,4,1,0,0,3
S01009598,Occupancy rating +1,73,28,9,19,45,6,25,8,13,4,14,7,7,0,0,0,0,0
S01009598,Occupancy rating 0,152,78,16,62,70,2,33,10,14,9,35,25,10,4,3,0,0,1
S01009598,Occupancy rating -1 or less,26,6,1,5,17,0,9,0,8,1,8,6,2,3,1,0,1,1
S01009599,All households,403,141,48,93,248,22,171,73,65,33,55,40,15,14,4,0,0,10
S01009599,Occupancy rating +2 or more,125,44,18,26,81,14,65,46,12,7,2,2,0,0,0,0,0,0
S01009599,Occupancy rating +1,117,32,7,25,79,5,54,22,19,13,20,15,5,6,2,0,0,4
S01009599,Occupancy rating 0,124,51,19,32,68,2,41,5,25,11,25,18,7,5,1,0,0,4
S01009599,Occupancy rating -1 or less,37,14,4,10,20,1,11,0,9,2,8,5,3,3,1,0,0,2
S01009600,All households,330,160,69,91,163,15,88,34,37,17,60,45,15,7,4,0,0,3
S01009600,Occupancy rating +2 or more,51,21,3,18,29,5,22,16,4,2,2,2,0,1,1,0,0,0
S01009600,Occupancy rating +1,87,30,10,20,56,2,33,8,14,11,21,15,6,1,0,0,0,1
S01009600,Occupancy rating 0,152,86,46,40,63,7,27,8,16,3,29,22,7,3,1,0,0,2
S01009600,Occupancy rating -1 or less,40,23,10,13,15,1,6,2,3,1,8,6,2,2,2,0,0,0
S01009601,All households,296,97,20,77,186,15,135,60,55,20,36,27,9,13,4,0,0,9
S01009601,Occupancy rating +2 or more,91,26,5,21,64,9,50,38,8,4,5,4,1,1,0,0,0,1
S01009601,Occupancy rating +1,85,37,8,29,46,4,35,18,12,5,7,5,2,2,0,0,0,2
S01009601,Occupancy rating 0,87,23,6,17,58,2,36,3,23,10,20,14,6,6,1,0,0,5
S01009601,Occupancy rating -1 or less,33,11,1,10,18,0,14,1,12,1,4,4,0,4,3,0,0,1
S01009602,All households,291,39,16,23,241,20,209,94,93,22,12,7,5,11,6,0,0,5
S01009602,Occupancy rating +2 or more,218,23,9,14,189,18,163,82,66,15,8,5,3,6,3,0,0,3
S01009602,Occupancy rating +1,53,14,7,7,35,2,30,10,19,1,3,1,2,4,2,0,0,2
S01009602,Occupancy rating 0,17,2,0,2,15,0,14,2,7,5,1,1,0,0,0,0,0,0
S01009602,Occupancy rating -1 or less,3,0,0,0,2,0,2,0,1,1,0,0,0,1,1,0,0,0
S01009603,All households,234,48,18,30,173,16,140,82,41,17,17,9,8,13,7,0,1,5
S01009603,Occupancy rating +2 or more,155,18,9,9,129,11,111,71,27,13,7,3,4,8,4,0,1,3
S01009603,Occupancy rating +1,37,12,5,7,24,5,15,7,7,1,4,2,2,1,1,0,0,0
S01009603,Occupancy rating 0,32,13,3,10,16,0,12,4,5,3,4,3,1,3,1,0,0,2
S01009603,Occupancy rating -1 or less,10,5,1,4,4,0,2,0,2,0,2,1,1,1,1,0,0,0
S01009604,All households,377,108,54,54,251,32,184,82,64,38,35,24,11,18,11,0,0,7
S01009604,Occupancy rating +2 or more,168,40,10,30,121,12,105,65,28,12,4,4,0,7,4,0,0,3
S01009604,Occupancy rating +1,95,19,12,7,72,8,50,15,19,16,14,9,5,4,2,0,0,2
S01009604,Occupancy rating 0,96,42,28,14,50,11,24,1,14,9,15,11,4,4,3,0,0,1
S01009604,Occupancy rating -1 or less,18,7,4,3,8,1,5,1,3,1,2,0,2,3,2,0,0,1
S01009605,All households,348,126,48,78,208,26,144,58,58,28,38,24,14,14,8,1,1,4
S01009605,Occupancy rating +2 or more,112,24,7,17,84,14,65,36,20,9,5,2,3,4,3,0,0,1
S01009605,Occupancy rating +1,92,34,6,28,54,6,43,14,20,9,5,3,2,4,1,1,0,2
S01009605,Occupancy rating 0,117,60,30,30,54,4,28,7,15,6,22,16,6,3,2,0,0,1
S01009605,Occupancy rating -1 or less,27,8,5,3,16,2,8,1,3,4,6,3,3,3,2,0,1,0
S01009606,All households,218,44,10,34,168,12,146,64,65,17,10,7,3,6,3,0,0,3
S01009606,Occupancy rating +2 or more,171,29,6,23,139,9,128,61,53,14,2,1,1,3,1,0,0,2
S01009606,Occupancy rating +1,28,6,2,4,22,2,14,3,9,2,6,5,1,0,0,0,0,0
S01009606,Occupancy rating 0,18,9,2,7,7,1,4,0,3,1,2,1,1,2,1,0,0,1
S01009606,Occupancy rating -1 or less,1,0,0,0,0,0,0,0,0,0,0,0,0,1,1,0,0,0
S01009607,All households,208,25,18,7,174,38,125,55,49,21,11,7,4,9,5,1,0,3
S01009607,Occupancy rating +2 or more,162,20,14,6,139,35,102,50,39,13,2,1,1,3,2,0,0,1
S01009607,Occupancy rating +1,27,4,3,1,20,1,16,4,6,6,3,0,3,3,1,1,0,1
S01009607,Occupancy rating 0,16,1,1,0,12,2,6,0,4,2,4,4,0,3,2,0,0,1
S01009607,Occupancy rating -1 or less,3,0,0,0,3,0,1,1,0,0,2,2,0,0,0,0,0,0
S01009608,All households,287,114,62,52,165,13,123,52,60,11,29,19,10,8,4,0,1,3
S01009608,Occupancy rating +2 or more,97,25,13,12,70,8,60,28,27,5,2,2,0,2,2,0,0,0
S01009608,Occupancy rating +1,93,42,19,23,51,2,39,20,16,3,10,6,4,0,0,0,0,0
S01009608,Occupancy rating 0,78,40,25,15,36,2,22,4,15,3,12,7,5,2,1,0,0,1
S01009608,Occupancy rating -1 or less,19,7,5,2,8,1,2,0,2,0,5,4,1,4,1,0,1,2
S01009609,All households,358,103,41,62,239,34,181,79,82,20,24,16,8,16,4,0,1,11
S01009609,Occupancy rating +2 or more,172,40,16,24,129,21,102,48,45,9,6,3,3,3,2,0,0,1
S01009609,Occupancy rating +1,99,37,18,19,57,11,42,22,15,5,4,2,2,5,0,0,0,5
S01009609,Occupancy rating 0,66,14,2,12,46,2,32,8,19,5,12,9,3,6,1,0,1,4
S01009609,Occupancy rating -1 or less,21,12,5,7,7,0,5,1,3,1,2,2,0,2,1,0,0,1
S01009610,All households,500,196,80,116,294,52,191,98,73,20,51,34,17,10,7,0,0,3
S01009610,Occupancy rating +2 or more,165,48,24,24,114,25,83,53,23,7,6,1,5,3,1,0,0,2
S01009610,Occupancy rating +1,160,76,35,41,83,21,54,30,19,5,8,5,3,1,1,0,0,0
S01009610,Occupancy rating 0,143,58,19,39,83,5,47,14,26,7,31,25,6,2,2,0,0,0
S01009610,Occupancy rating -1 or less,32,14,2,12,14,1,7,1,5,1,6,3,3,4,3,0,0,1
S01009611,All households,218,33,14,19,179,36,129,69,45,15,14,8,6,6,4,0,1,1
S01009611,Occupancy rating +2 or more,147,18,8,10,125,30,89,57,25,7,6,4,2,4,2,0,1,1
S01009611,Occupancy rating +1,49,13,6,7,36,6,27,11,13,3,3,1,2,0,0,0,0,0
S01009611,Occupancy rating 0,19,2,0,2,15,0,12,1,7,4,3,1,2,2,2,0,0,0
S01009611,Occupancy rating -1 or less,3,0,0,0,3,0,1,0,0,1,2,2,0,0,0,0,0,0
S01009612,All households,272,91,40,51,169,26,115,42,49,24,28,19,9,12,2,0,1,9
S01009612,Occupancy rating +2 or more,95,29,13,16,64,13,48,25,13,10,3,1,2,2,2,0,0,0
S01009612,Occupancy rating +1,88,36,16,20,49,7,34,15,12,7,8,5,3,3,0,0,0,3
S01009612,Occupancy rating 0,71,22,8,14,44,5,24,2,17,5,15,11,4,5,0,0,1,4
S01009612,Occupancy rating -1 or less,18,4,3,1,12,1,9,0,7,2,2,2,0,2,0,0,0,2
S01009613,All households,181,32,13,19,141,17,118,51,45,22,6,3,3,8,3,0,0,5
S01009613,Occupancy rating +2 or more,126,21,10,11,103,12,89,44,31,14,2,1,1,2,2,0,0,0
S01009613,Occupancy rating +1,33,7,2,5,24,4,17,4,8,5,3,2,1,2,1,0,0,1
S01009613,Occupancy rating 0,15,4,1,3,9,1,8,2,4,2,0,0,0,2,0,0,0,2
S01009613,Occupancy rating -1 or less,7,0,0,0,5,0,4,1,2,1,1,0,1,2,0,0,0,2
S01009614,All households,223,60,33,27,152,27,113,51,43,19,12,7,5,11,5,0,2,4
S01009614,Occupancy rating +2 or more,119,30,16,14,84,20,62,35,14,13,2,0,2,5,2,0,1,2
S01009614,Occupancy rating +1,67,23,12,11,40,7,30,12,16,2,3,1,2,4,2,0,1,1
S01009614,Occupancy rating 0,34,7,5,2,25,0,18,4,11,3,7,6,1,2,1,0,0,1
S01009614,Occupancy rating -1 or less,3,0,0,0,3,0,3,0,2,1,0,0,0,0,0,0,0,0
S01009615,All households,174,39,24,15,126,37,78,32,36,10,11,7,4,9,2,0,1,6
S01009615,Occupancy rating +2 or more,81,16,10,6,65,23,41,26,11,4,1,1,0,0,0,0,0,0
S01009615,Occupancy rating +1,58,15,11,4,38,10,23,5,13,5,5,3,2,5,0,0,1,4
S01009615,Occupancy rating 0,29,6,2,4,21,4,13,1,11,1,4,2,2,2,1,0,0,1
S01009615,Occupancy rating -1 or less,6,2,1,1,2,0,1,0,1,0,1,1,0,2,1,0,0,1
S01009616,All households,324,92,37,55,219,21,162,74,59,29,36,24,12,13,5,1,1,6
S01009616,Occupancy rating +2 or more,117,22,7,15,92,12,78,41,23,14,2,1,1,3,1,0,0,2
S01009616,Occupancy rating +1,108,45,23,22,62,7,50,31,11,8,5,1,4,1,0,0,0,1
S01009616,Occupancy rating 0,80,19,5,14,56,2,29,2,21,6,25,20,5,5,2,1,0,2
S01009616,Occupancy rating -1 or less,19,6,2,4,9,0,5,0,4,1,4,2,2,4,2,0,1,1
S01009617,All households,297,65,18,47,221,29,171,71,72,28,21,9,12,11,6,0,0,5
S01009617,Occupancy rating +2 or more,172,20,8,12,148,22,116,51,46,19,10,4,6,4,1,0,0,3
S01009617,Occupancy rating +1,67,20,4,16,45,6,36,17,14,5,3,2,1,2,1,0,0,1
S01009617,Occupancy rating 0,40,21,4,17,17,0,12,1,8,3,5,2,3,2,2,0,0,0
S01009617,Occupancy rating -1 or less,18,4,2,2,11,1,7,2,4,1,3,1,2,3,2,0,0,1
S01009618,All households,333,110,41,69,211,27,143,78,48,17,41,32,9,12,7,1,0,4
S01009618,Occupancy rating +2 or more,61,15,13,2,43,10,28,20,5,3,5,3,2,3,3,0,0,0
S01009618,Occupancy rating +1,152,62,17,45,86,15,63,48,11,4,8,5,3,4,2,0,0,2
S01009618,Occupancy rating 0,82,15,5,10,64,0,44,7,29,8,20,16,4,3,1,0,0,2
S01009618,Occupancy rating -1 or less,38,18,6,12,18,2,8,3,3,2,8,8,0,2,1,1,0,0
S01009619,All households,302,124,55,69,173,17,122,56,48,18,34,26,8,5,3,0,1,1
S01009619,Occupancy rating +2 or more,68,17,5,12,48,5,39,21,11,7,4,3,1,3,2,0,0,1
S01009619,Occupancy rating +1,102,49,22,27,53,3,41,25,13,3,9,6,3,0,0,0,0,0
S01009619,Occupancy rating 0,112,55,25,30,57,4,37,9,21,7,16,14,2,0,0,0,0,0
S01009619,Occupancy rating -1 or less,20,3,3,0,15,5,5,1,3,1,5,3,2,2,1,0,1,0
S01009620,All households,391,157,86,71,220,26,136,57,54,25,58,34,24,14,4,0,1,9
S01009620,Occupancy rating +2 or more,94,44,27,17,47,11,33,27,3,3,3,1,2,3,1,0,0,2
S01009620,Occupancy rating +1,162,73,31,42,86,12,58,27,19,12,16,10,6,3,1,0,1,1
S01009620,Occupancy rating 0,110,31,22,9,73,3,37,2,26,9,33,20,13,6,2,0,0,4
S01009620,Occupancy rating -1 or less,25,9,6,3,14,0,8,1,6,1,6,3,3,2,0,0,0,2
S01009621,All households,394,173,64,109,208,34,125,68,39,18,49,32,17,13,5,0,1,7
S01009621,Occupancy rating +2 or more,141,36,18,18,103,23,72,56,8,8,8,2,6,2,0,0,0,2
S01009621,Occupancy rating +1,96,45,12,33,48,8,29,7,17,5,11,6,5,3,1,0,0,2
S01009621,Occupancy rating 0,116,71,27,44,41,2,22,5,12,5,17,12,5,4,3,0,0,1
S01009621,Occupancy rating -1 or less,41,21,7,14,16,1,2,0,2,0,13,12,1,4,1,0,1,2
S01009622,All households,394,195,51,144,187,17,112,54,46,12,58,41,17,12,3,0,0,9
S01009622,Occupancy rating +2 or more,73,24,7,17,47,8,35,26,6,3,4,3,1,2,0,0,0,2
S01009622,Occupancy rating +1,130,78,16,62,52,6,39,24,12,3,7,3,4,0,0,0,0,0
S01009622,Occupancy rating 0,149,75,23,52,67,3,29,4,21,4,35,28,7,7,3,0,0,4
S01009622,Occupancy rating -1 or less,42,18,5,13,21,0,9,0,7,2,12,7,5,3,0,0,0,3
S01009623,All households,243,87,38,49,151,24,89,36,34,19,38,30,8,5,3,0,1,1
S01009623,Occupancy rating +2 or more,55,22,11,11,32,8,21,13,5,3,3,2,1,1,1,0,0,0
S01009623,Occupancy rating +1,103,43,16,27,58,10,37,22,6,9,11,8,3,2,1,0,0,1
S01009623,Occupancy rating 0,67,17,9,8,49,6,25,1,20,4,18,15,3,1,0,0,1,0
S01009623,Occupancy rating -1 or less,18,5,2,3,12,0,6,0,3,3,6,5,1,1,1,0,0,0
S01009624,All households,408,137,69,68,258,30,162,82,52,28,66,44,22,13,6,0,2,5
S01009624,Occupancy rating +2 or more,113,56,31,25,56,11,42,35,5,2,3,0,3,1,0,0,1,0
S01009624,Occupancy rating +1,148,52,20,32,95,12,65,41,14,10,18,10,8,1,0,0,0,1
S01009624,Occupancy rating 0,115,24,14,10,85,3,47,5,27,15,35,27,8,6,2,0,1,3
S01009624,Occupancy rating -1 or less,32,5,4,1,22,4,8,1,6,1,10,7,3,5,4,0,0,1
S01009625,All households,378,115,59,56,252,33,156,44,81,31,63,42,21,11,4,1,0,6
S01009625,Occupancy rating +2 or more,107,51,24,27,54,17,29,22,6,1,8,6,2,2,1,0,0,1
S01009625,Occupancy rating +1,162,51,28,23,106,15,72,21,36,15,19,11,8,5,0,1,0,4
S01009625,Occupancy rating 0,93,11,5,6,82,1,49,1,34,14,32,22,10,0,0,0,0,0
S01009625,Occupancy rating -1 or less,16,2,2,0,10,0,6,0,5,1,4,3,1,4,3,0,0,1
S01009626,All households,231,55,25,30,156,16,80,23,39,18,60,40,20,20,9,0,2,9
S01009626,Occupancy rating +2 or more,83,37,16,21,44,12,25,18,5,2,7,5,2,2,1,0,0,1
S01009626,Occupancy rating +1,64,9,5,4,53,2,28,5,14,9,23,17,6,2,0,0,1,1
S01009626,Occupancy rating 0,53,7,3,4,37,2,16,0,13,3,19,12,7,9,5,0,0,4
S01009626,Occupancy rating -1 or less,31,2,1,1,22,0,11,0,7,4,11,6,5,7,3,0,1,3
S01009627,All households,342,102,59,43,223,31,141,43,61,37,51,40,11,17,7,0,0,10
S01009627,Occupancy rating +2 or more,132,57,33,24,74,22,45,31,10,4,7,6,1,1,0,0,0,1
S01009627,Occupancy rating +1,109,24,13,11,79,8,55,11,26,18,16,12,4,6,0,0,0,6
S01009627,Occupancy rating 0,76,17,11,6,56,1,32,1,20,11,23,17,6,3,2,0,0,1
S01009627,Occupancy rating -1 or less,25,4,2,2,14,0,9,0,5,4,5,5,0,7,5,0,0,2
S01009628,All households,265,112,86,26,148,46,76,42,19,15,26,15,11,5,3,0,2,0
S01009628,Occupancy rating +2 or more,72,23,15,8,47,16,28,25,1,2,3,1,2,2,0,0,2,0
S01009628,Occupancy rating +1,110,54,39,15,55,24,26,15,7,4,5,2,3,1,1,0,0,0
S01009628,Occupancy rating 0,71,31,29,2,39,5,19,2,9,8,15,10,5,1,1,0,0,0
S01009628,Occupancy rating -1 or less,12,4,3,1,7,1,3,0,2,1,3,2,1,1,1,0,0,0
S01009629,All households,435,95,40,55,321,35,200,66,104,30,86,61,25,19,8,0,0,11
S01009629,Occupancy rating +2 or more,107,33,19,14,72,18,50,38,10,2,4,1,3,2,1,0,0,1
S01009629,Occupancy rating +1,172,53,16,37,112,16,66,20,36,10,30,15,15,7,2,0,0,5
S01009629,Occupancy rating 0,116,7,5,2,101,1,59,5,42,12,41,34,7,8,3,0,0,5
S01009629,Occupancy rating -1 or less,40,2,0,2,36,0,25,3,16,6,11,11,0,2,2,0,0,0
S01009630,All households,343,91,35,56,238,20,138,53,57,28,80,58,22,14,6,1,1,6
S01009630,Occupancy rating +2 or more,86,34,16,18,52,11,33,28,3,2,8,4,4,0,0,0,0,0
S01009630,Occupancy rating +1,128,51,18,33,75,5,53,21,19,13,17,10,7,2,0,0,1,1
S01009630,Occupancy rating 0,96,3,0,3,83,2,39,3,24,12,42,34,8,10,5,1,0,4
S01009630,Occupancy rating -1 or less,33,3,1,2,28,2,13,1,11,1,13,10,3,2,1,0,0,1
S01009631,All households,406,236,56,180,158,18,95,54,28,13,45,27,18,12,2,1,0,9
S01009631,Occupancy rating +2 or more,55,21,7,14,32,9,21,17,3,1,2,0,2,2,0,0,0,2
S01009631,Occupancy rating +1,160,104,24,80,53,4,45,33,5,7,4,2,2,3,1,1,0,1
S01009631,Occupancy rating 0,160,93,22,71,63,4,21,3,15,3,38,25,13,4,0,0,0,4
S01009631,Occupancy rating -1 or less,31,18,3,15,10,1,8,1,5,2,1,0,1,3,1,0,0,2
S01009632,All households,306,145,64,81,154,14,82,40,31,11,58,51,7,7,2,0,0,5
S01009632,Occupancy rating +2 or more,32,12,3,9,18,1,14,10,4,0,3,3,0,2,1,0,0,1
S01009632,Occupancy rating +1,125,74,25,49,50,8,30,24,3,3,12,9,3,1,0,0,0,1
S01009632,Occupancy rating 0,99,36,20,16,61,2,27,4,17,6,32,28,4,2,0,0,0,2
S01009632,Occupancy rating -1 or less,50,23,16,7,25,3,11,2,7,2,11,11,0,2,1,0,0,1
S01009633,All households,297,79,23,56,200,15,110,39,59,12,75,53,22,18,8,0,1,9
S01009633,Occupancy rating +2 or more,88,36,9,27,51,11,31,22,4,5,9,5,4,1,0,0,0,1
S01009633,Occupancy rating +1,101,35,11,24,59,2,35,15,19,1,22,15,7,7,1,0,1,5
S01009633,Occupancy rating 0,73,3,2,1,67,1,33,1,26,6,33,26,7,3,2,0,0,1
S01009633,Occupancy rating -1 or less,35,5,1,4,23,1,11,1,10,0,11,7,4,7,5,0,0,2
S01009634,All households,253,102,56,46,145,26,83,39,30,14,36,20,16,6,2,0,1,3
S01009634,Occupancy rating +2 or more,58,32,21,11,26,9,16,15,1,0,1,0,1,0,0,0,0,0
S01009634,Occupancy rating +1,92,43,21,22,48,13,27,20,2,5,8,5,3,1,0,0,0,1
S01009634,Occupancy rating 0,74,19,9,10,51,4,27,3,19,5,20,14,6,4,2,0,1,1
S01009634,Occupancy rating -1 or less,29,8,5,3,20,0,13,1,8,4,7,1,6,1,0,0,0,1
S01009635,All households,414,157,48,109,238,27,162,79,67,16,49,27,22,19,5,0,3,11
S01009635,Occupancy rating +2 or more,121,33,14,19,82,14,62,46,15,1,6,2,4,6,2,0,0,4
S01009635,Occupancy rating +1,155,68,25,43,84,9,60,28,25,7,15,8,7,3,0,0,1,2
S01009635,Occupancy rating 0,112,52,7,45,56,3,30,4,19,7,23,15,8,4,0,0,1,3
S01009635,Occupancy rating -1 or less,26,4,2,2,16,1,10,1,8,1,5,2,3,6,3,0,1,2
S01009636,All households,521,268,67,201,242,20,128,71,46,11,94,70,24,11,4,1,0,6
S01009636,Occupancy rating +2 or more,65,27,7,20,38,7,25,20,2,3,6,4,2,0,0,0,0,0
S01009636,Occupancy rating +1,203,133,32,101,66,10,44,37,5,2,12,6,6,4,2,0,0,2
S01009636,Occupancy rating 0,209,91,22,69,112,3,49,13,30,6,60,46,14,6,2,1,0,3
S01009636,Occupancy rating -1 or less,44,17,6,11,26,0,10,1,9,0,16,14,2,1,0,0,0,1
S01009637,All households,340,134,42,92,192,22,125,52,48,25,45,33,12,14,8,0,1,5
S01009637,Occupancy rating +2 or more,99,32,12,20,64,11,50,35,10,5,3,1,2,3,3,0,0,0
S01009637,Occupancy rating +1,115,47,16,31,66,10,40,11,16,13,16,13,3,2,1,0,0,1
S01009637,Occupancy rating 0,104,46,11,35,53,1,33,6,20,7,19,14,5,5,2,0,0,3
S01009637,Occupancy rating -1 or less,22,9,3,6,9,0,2,0,2,0,7,5,2,4,2,0,1,1
S01009638,All households,292,73,35,38,206,24,118,33,61,24,64,52,12,13,9,1,0,3
S01009638,Occupancy rating +2 or more,107,39,16,23,67,21,41,26,7,8,5,3,2,1,1,0,0,0
S01009638,Occupancy rating +1,72,9,2,7,60,1,35,3,26,6,24,19,5,3,2,0,0,1
S01009638,Occupancy rating 0,83,17,13,4,58,2,27,3,16,8,29,25,4,8,5,1,0,2
S01009638,Occupancy rating -1 or less,30,8,4,4,21,0,15,1,12,2,6,5,1,1,1,0,0,0
S01009639,All households,325,86,56,30,228,48,155,70,62,23,25,18,7,11,4,0,1,6
S01009639,Occupancy rating +2 or more,228,49,31,18,172,41,120,59,45,16,11,7,4,7,3,0,0,4
S01009639,Occupancy rating +1,62,31,19,12,29,5,20,7,9,4,4,3,1,2,0,0,1,1
S01009639,Occupancy rating 0,21,2,2,0,18,2,11,2,7,2,5,4,1,1,0,0,0,1
S01009639,Occupancy rating -1 or less,14,4,4,0,9,0,4,2,1,1,5,4,1,1,1,0,0,0
S01009640,All households,363,215,80,135,143,35,74,36,32,6,34,30,4,5,2,0,0,3
S01009640,Occupancy rating +2 or more,60,25,17,8,34,14,20,12,7,1,0,0,0,1,0,0,0,1
S01009640,Occupancy rating +1,118,74,30,44,43,14,23,9,10,4,6,5,1,1,0,0,0,1
S01009640,Occupancy rating 0,161,107,29,78,53,7,22,10,11,1,24,21,3,1,0,0,0,1
S01009640,Occupancy rating -1 or less,24,9,4,5,13,0,9,5,4,0,4,4,0,2,2,0,0,0
S01009641,All households,479,271,129,142,201,35,126,81,31,14,40,34,6,7,1,0,1,5
S01009641,Occupancy rating +2 or more,91,37,17,20,54,10,41,27,9,5,3,2,1,0,0,0,0,0
S01009641,Occupancy rating +1,165,92,33,59,73,16,47,36,5,6,10,8,2,0,0,0,0,0
S01009641,Occupancy rating 0,175,112,60,52,59,7,34,17,14,3,18,16,2,4,0,0,0,4
S01009641,Occupancy rating -1 or less,48,30,19,11,15,2,4,1,3,0,9,8,1,3,1,0,1,1
S01009642,All households,482,226,77,149,239,30,167,86,67,14,42,25,17,17,5,0,1,11
S01009642,Occupancy rating +2 or more,158,58,28,30,99,16,77,38,29,10,6,5,1,1,0,0,0,1
S01009642,Occupancy rating +1,169,92,29,63,74,12,53,33,17,3,9,5,4,3,2,0,0,1
S01009642,Occupancy rating 0,119,54,14,40,56,1,31,13,17,1,24,14,10,9,1,0,1,7
S01009642,Occupancy rating -1 or less,36,22,6,16,10,1,6,2,4,0,3,1,2,4,2,0,0,2
S01009643,All households,218,29,3,26,185,14,157,52,84,21,14,13,1,4,2,0,0,2
S01009643,Occupancy rating +2 or more,111,13,3,10,96,7,87,42,34,11,2,2,0,2,1,0,0,1
S01009643,Occupancy rating +1,74,14,0,14,60,6,48,9,32,7,6,6,0,0,0,0,0,0
S01009643,Occupancy rating 0,28,1,0,1,26,1,20,1,16,3,5,4,1,1,0,0,0,1
S01009643,Occupancy rating -1 or less,5,1,0,1,3,0,2,0,2,0,1,1,0,1,1,0,0,0
S01009644,All households,339,85,39,46,244,40,159,50,73,36,45,31,14,10,0,1,0,9
S01009644,Occupancy rating +2 or more,151,48,23,25,96,25,64,31,25,8,7,6,1,7,0,0,0,7
S01009644,Occupancy rating +1,108,31,14,17,76,14,52,16,16,20,10,7,3,1,0,1,0,0
S01009644,Occupancy rating 0,61,4,2,2,56,1,31,1,24,6,24,16,8,1,0,0,0,1
S01009644,Occupancy rating -1 or less,19,2,0,2,16,0,12,2,8,2,4,2,2,1,0,0,0,1
S01009645,All households,301,106,55,51,184,27,116,41,48,27,41,26,15,11,5,0,1,5
S01009645,Occupancy rating +2 or more,71,31,16,15,40,9,30,17,7,6,1,1,0,0,0,0,0,0
S01009645,Occupancy rating +1,111,44,21,23,67,11,49,22,16,11,7,2,5,0,0,0,0,0
S01009645,Occupancy rating 0,96,23,14,9,65,5,34,2,23,9,26,18,8,8,3,0,1,4
S01009645,Occupancy rating -1 or less,23,8,4,4,12,2,3,0,2,1,7,5,2,3,2,0,0,1
S01009646,All households,244,70,28,42,158,18,102,37,46,19,38,25,13,16,7,0,1,8
S01009646,Occupancy rating +2 or more,96,42,16,26,52,9,38,26,10,2,5,4,1,2,0,0,0,2
S01009646,Occupancy rating +1,86,19,10,9,60,8,39,10,18,11,13,8,5,7,2,0,1,4
S01009646,Occupancy rating 0,39,6,2,4,30,1,15,1,10,4,14,9,5,3,2,0,0,1
S01009646,Occupancy rating -1 or less,23,3,0,3,16,0,10,0,8,2,6,4,2,4,3,0,0,1
S01009647,All households,318,158,54,104,152,23,84,45,28,11,45,37,8,8,4,1,1,2
S01009647,Occupancy rating +2 or more,81,37,18,19,43,9,31,23,4,4,3,1,2,1,0,1,0,0
S01009647,Occupancy rating +1,118,67,19,48,49,12,26,19,3,4,11,8,3,2,1,0,0,1
S01009647,Occupancy rating 0,101,48,12,36,50,2,20,2,15,3,28,26,2,3,1,0,1,1
S01009647,Occupancy rating -1 or less,18,6,5,1,10,0,7,1,6,0,3,2,1,2,2,0,0,0
S01009648,All households,394,130,71,59,252,42,162,60,76,26,48,25,23,12,7,0,1,4
S01009648,Occupancy rating +2 or more,123,42,20,22,79,23,53,33,17,3,3,2,1,2,2,0,0,0
S01009648,Occupancy rating +1,159,66,39,27,92,14,59,23,21,15,19,7,12,1,0,0,0,1
S01009648,Occupancy rating 0,85,18,8,10,62,4,38,2,30,6,20,15,5,5,2,0,1,2
S01009648,Occupancy rating -1 or less,27,4,4,0,19,1,12,2,8,2,6,1,5,4,3,0,0,1
S01009649,All households,451,147,58,89,283,34,201,78,92,31,48,35,13,21,10,0,1,10
S01009649,Occupancy rating +2 or more,212,70,27,43,131,28,96,53,33,10,7,5,2,11,4,0,0,7
S01009649,Occupancy rating +1,123,44,17,27,75,5,54,18,26,10,16,9,7,4,1,0,1,2
S01009649,Occupancy rating 0,96,25,13,12,67,1,45,6,29,10,21,17,4,4,3,0,0,1
S01009649,Occupancy rating -1 or less,20,8,1,7,10,0,6,1,4,1,4,4,0,2,2,0,0,0
S01009650,All households,343,88,67,21,252,66,173,83,55,35,13,3,10,3,2,0,0,1
S01009650,Occupancy rating +2 or more,255,70,56,14,184,52,126,74,32,20,6,1,5,1,0,0,0,1
S01009650,Occupancy rating +1,61,15,10,5,46,13,32,7,14,11,1,0,1,0,0,0,0,0
S01009650,Occupancy rating 0,25,3,1,2,20,1,13,2,8,3,6,2,4,2,2,0,0,0
S01009650,Occupancy rating -1 or less,2,0,0,0,2,0,2,0,1,1,0,0,0,0,0,0,0,0
S01009651,All households,427,138,75,63,270,59,184,97,65,22,27,19,8,19,7,0,2,10
S01009651,Occupancy rating +2 or more,252,61,33,28,183,48,129,83,31,15,6,4,2,8,3,0,1,4
S01009651,Occupancy rating +1,86,40,21,19,44,10,32,14,15,3,2,2,0,2,0,0,0,2
S01009651,Occupancy rating 0,67,26,16,10,36,1,19,0,15,4,16,10,6,5,1,0,1,3
S01009651,Occupancy rating -1 or less,22,11,5,6,7,0,4,0,4,0,3,3,0,4,3,0,0,1
S01009652,All households,399,166,110,56,220,62,134,77,41,16,24,13,11,13,3,0,1,9
S01009652,Occupancy rating +2 or more,259,91,72,19,160,47,103,64,30,9,10,6,4,8,2,0,1,5
S01009652,Occupancy rating +1,91,51,27,24,39,10,23,9,8,6,6,2,4,1,0,0,0,1
S01009652,Occupancy rating 0,37,19,8,11,16,4,6,4,1,1,6,4,2,2,0,0,0,2
S01009652,Occupancy rating -1 or less,12,5,3,2,5,1,2,0,2,0,2,1,1,2,1,0,0,1
S01009653,All households,229,53,28,25,169,31,125,55,54,16,13,8,5,7,1,0,3,3
S01009653,Occupancy rating +2 or more,172,42,24,18,125,26,94,53,31,10,5,3,2,5,1,0,2,2
S01009653,Occupancy rating +1,41,8,3,5,31,5,24,2,16,6,2,1,1,2,0,0,1,1
S01009653,Occupancy rating 0,13,3,1,2,10,0,7,0,7,0,3,2,1,0,0,0,0,0
S01009653,Occupancy rating -1 or less,3,0,0,0,3,0,0,0,0,0,3,2,1,0,0,0,0,0
S01009654,All households,274,107,58,49,161,23,113,46,55,12,25,15,10,6,2,0,3,1
S01009654,Occupancy rating +2 or more,139,47,32,15,90,21,67,37,23,7,2,1,1,2,0,0,1,1
S01009654,Occupancy rating +1,82,46,22,24,36,2,26,7,16,3,8,5,3,0,0,0,0,0
S01009654,Occupancy rating 0,42,10,2,8,29,0,18,2,14,2,11,7,4,3,2,0,1,0
S01009654,Occupancy rating -1 or less,11,4,2,2,6,0,2,0,2,0,4,2,2,1,0,0,1,0
S01009655,All households,351,96,49,47,233,23,148,60,52,36,62,41,21,22,7,0,2,13
S01009655,Occupancy rating +2 or more,132,52,23,29,76,19,53,46,3,4,4,3,1,4,2,0,0,2
S01009655,Occupancy rating +1,109,28,15,13,75,3,49,10,20,19,23,11,12,6,0,0,2,4
S01009655,Occupancy rating 0,79,12,10,2,60,0,35,3,22,10,25,19,6,7,2,0,0,5
S01009655,Occupancy rating -1 or less,31,4,1,3,22,1,11,1,7,3,10,8,2,5,3,0,0,2
S01009656,All households,387,180,95,85,189,33,109,54,39,16,47,26,21,18,5,0,1,12
S01009656,Occupancy rating +2 or more,110,41,21,20,66,14,48,40,6,2,4,2,2,3,0,0,0,3
S01009656,Occupancy rating +1,141,74,30,44,62,14,30,9,13,8,18,6,12,5,0,0,0,5
S01009656,Occupancy rating 0,112,55,39,16,51,4,28,5,17,6,19,15,4,6,2,0,0,4
S01009656,Occupancy rating -1 or less,24,10,5,5,10,1,3,0,3,0,6,3,3,4,3,0,1,0
S01009657,All households,332,95,39,56,223,32,173,80,63,30,18,7,11,14,7,0,0,7
S01009657,Occupancy rating +2 or more,153,34,16,18,119,23,96,60,22,14,0,0,0,0,0,0,0,0
S01009657,Occupancy rating +1,110,46,16,30,59,6,44,18,19,7,9,2,7,5,3,0,0,2
S01009657,Occupancy rating 0,48,9,5,4,36,2,26,1,20,5,8,5,3,3,1,0,0,2
S01009657,Occupancy rating -1 or less,21,6,2,4,9,1,7,1,2,4,1,0,1,6,3,0,0,3
S01009658,All households,286,46,21,25,231,15,157,72,61,24,59,34,25,9,5,0,1,3
S01009658,Occupancy rating +2 or more,98,21,11,10,75,9,60,44,13,3,6,2,4,2,1,0,0,1
S01009658,Occupancy rating +1,103,21,8,13,81,6,55,26,17,12,20,7,13,1,0,0,0,1
S01009658,Occupancy rating 0,71,4,2,2,63,0,35,1,28,6,28,20,8,4,2,0,1,1
S01009658,Occupancy rating -1 or less,14,0,0,0,12,0,7,1,3,3,5,5,0,2,2,0,0,0
S01009659,All households,230,87,21,66,130,18,97,49,35,13,15,11,4,13,7,0,0,6
S01009659,Occupancy rating +2 or more,96,26,8,18,66,12,53,37,10,6,1,1,0,4,3,0,0,1
S01009659,Occupancy rating +1,62,20,7,13,39,5,27,10,12,5,7,5,2,3,0,0,0,3
S01009659,Occupancy rating 0,60,36,5,31,19,1,13,2,9,2,5,3,2,5,3,0,0,2
S01009659,Occupancy rating -1 or less,12,5,1,4,6,0,4,0,4,0,2,2,0,1,1,0,0,0
S01009660,All households,430,82,34,48,331,34,229,90,103,36,68,48,20,17,9,0,1,7
S01009660,Occupancy rating +2 or more,189,34,13,21,150,22,119,66,39,14,9,4,5,5,3,0,0,2
S01009660,Occupancy rating +1,120,39,18,21,80,12,53,20,23,10,15,10,5,1,0,0,0,1
S01009660,Occupancy rating 0,101,8,3,5,84,0,49,4,34,11,35,29,6,9,4,0,1,4
S01009660,Occupancy rating -1 or less,20,1,0,1,17,0,8,0,7,1,9,5,4,2,2,0,0,0
S01009661,All households,331,72,32,40,251,33,198,102,73,23,20,9,11,8,2,2,1,3
S01009661,Occupancy rating +2 or more,235,41,16,25,188,26,152,81,56,15,10,5,5,6,2,2,1,1
S01009661,Occupancy rating +1,67,23,11,12,43,7,30,18,8,4,6,2,4,1,0,0,0,1
S01009661,Occupancy rating 0,22,6,4,2,15,0,11,2,8,1,4,2,2,1,0,0,0,1
S01009661,Occupancy rating -1 or less,7,2,1,1,5,0,5,1,1,3,0,0,0,0,0,0,0,0
S01009662,All households,292,63,31,32,219,27,160,72,60,28,32,18,14,10,6,0,1,3
S01009662,Occupancy rating +2 or more,168,39,20,19,126,19,99,57,27,15,8,1,7,3,1,0,1,1
S01009662,Occupancy rating +1,68,10,4,6,57,7,40,14,15,11,10,7,3,1,1,0,0,0
S01009662,Occupancy rating 0,38,13,7,6,19,0,13,1,11,1,6,5,1,6,4,0,0,2
S01009662,Occupancy rating -1 or less,18,1,0,1,17,1,8,0,7,1,8,5,3,0,0,0,0,0
S01009663,All households,281,76,33,43,196,16,146,67,56,23,34,22,12,9,3,0,1,5
S01009663,Occupancy rating +2 or more,150,29,15,14,118,12,96,51,32,13,10,6,4,3,1,0,0,2
S01009663,Occupancy rating +1,64,25,10,15,38,4,28,11,11,6,6,4,2,1,0,0,0,1
S01009663,Occupancy rating 0,58,21,8,13,33,0,19,5,12,2,14,9,5,4,1,0,1,2
S01009663,Occupancy rating -1 or less,9,1,0,1,7,0,3,0,1,2,4,3,1,1,1,0,0,0
S01009664,All households,377,103,44,59,261,41,205,90,86,29,15,11,4,13,3,0,1,9
S01009664,Occupancy rating +2 or more,214,59,27,32,152,31,118,67,39,12,3,1,2,3,1,0,1,1
S01009664,Occupancy rating +1,82,24,12,12,53,8,41,19,12,10,4,3,1,5,1,0,0,4
S01009664,Occupancy rating 0,65,19,5,14,42,2,35,3,30,2,5,4,1,4,1,0,0,3
S01009664,Occupancy rating -1 or less,16,1,0,1,14,0,11,1,5,5,3,3,0,1,0,0,0,1
S01009665,All households,293,97,44,53,191,31,127,49,56,22,33,20,13,5,1,0,0,4
S01009665,Occupancy rating +2 or more,126,43,25,18,82,23,55,30,15,10,4,3,1,1,0,0,0,1
S01009665,Occupancy rating +1,68,25,8,17,43,4,35,13,16,6,4,2,2,0,0,0,0,0
S01009665,Occupancy rating 0,74,22,9,13,49,1,31,6,19,6,17,8,9,3,0,0,0,3
S01009665,Occupancy rating -1 or less,25,7,2,5,17,3,6,0,6,0,8,7,1,1,1,0,0,0
S01009666,All households,342,108,59,49,222,40,153,74,57,22,29,14,15,12,6,0,0,6
S01009666,Occupancy rating +2 or more,158,36,20,16,121,24,87,54,23,10,10,3,7,1,0,0,0,1
S01009666,Occupancy rating +1,86,31,11,20,49,8,37,16,14,7,4,1,3,6,5,0,0,1
S01009666,Occupancy rating 0,81,37,25,12,43,7,24,4,16,4,12,8,4,1,0,0,0,1
S01009666,Occupancy rating -1 or less,17,4,3,1,9,1,5,0,4,1,3,2,1,4,1,0,0,3
S01009667,All households,223,59,33,26,159,25,128,57,51,20,6,5,1,5,2,0,2,1
S01009667,Occupancy rating +2 or more,153,37,23,14,114,22,91,47,31,13,1,0,1,2,0,0,2,0
S01009667,Occupancy rating +1,46,13,6,7,30,3,26,10,12,4,1,1,0,3,2,0,0,1
S01009667,Occupancy rating 0,23,9,4,5,14,0,10,0,8,2,4,4,0,0,0,0,0,0
S01009667,Occupancy rating -1 or less,1,0,0,0,1,0,1,0,0,1,0,0,0,0,0,0,0,0
S01009668,All households,243,56,20,36,180,23,137,59,62,16,20,14,6,7,4,0,0,3
S01009668,Occupancy rating +2 or more,130,23,11,12,104,17,79,34,37,8,8,5,3,3,2,0,0,1
S01009668,Occupancy rating +1,68,21,7,14,46,5,37,19,15,3,4,2,2,1,1,0,0,0
S01009668,Occupancy rating 0,35,10,2,8,24,1,16,4,7,5,7,6,1,1,0,0,0,1
S01009668,Occupancy rating -1 or less,10,2,0,2,6,0,5,2,3,0,1,1,0,2,1,0,0,1
S01009669,All households,240,74,45,29,157,35,106,54,38,14,16,8,8,9,1,0,4,4
S01009669,Occupancy rating +2 or more,132,34,20,14,96,26,66,43,17,6,4,2,2,2,0,0,1,1
S01009669,Occupancy rating +1,68,31,20,11,34,6,22,8,10,4,6,1,5,3,0,0,2,1
S01009669,Occupancy rating 0,32,7,4,3,22,3,13,2,9,2,6,5,1,3,1,0,1,1
S01009669,Occupancy rating -1 or less,8,2,1,1,5,0,5,1,2,2,0,0,0,1,0,0,0,1
S01009670,All households,340,99,51,48,229,25,161,65,63,33,43,29,14,12,6,1,0,5
S01009670,Occupancy rating +2 or more,158,39,22,17,117,13,93,48,28,17,11,7,4,2,2,0,0,0
S01009670,Occupancy rating +1,95,37,13,24,54,8,36,15,13,8,10,5,5,4,1,1,0,2
S01009670,Occupancy rating 0,74,20,14,6,49,3,29,2,20,7,17,12,5,5,3,0,0,2
S01009670,Occupancy rating -1 or less,13,3,2,1,9,1,3,0,2,1,5,5,0,1,0,0,0,1
S01009671,All households,262,64,24,40,189,24,135,74,48,13,30,20,10,9,4,0,1,4
S01009671,Occupancy rating +2 or more,139,32,14,18,100,20,74,54,15,5,6,5,1,7,4,0,1,2
S01009671,Occupancy rating +1,81,25,9,16,55,4,41,17,20,4,10,7,3,1,0,0,0,1
S01009671,Occupancy rating 0,34,5,1,4,28,0,17,3,11,3,11,6,5,1,0,0,0,1
S01009671,Occupancy rating -1 or less,8,2,0,2,6,0,3,0,2,1,3,2,1,0,0,0,0,0
S01009672,All households,355,117,49,68,228,32,170,69,71,30,26,19,7,10,7,0,0,3
S01009672,Occupancy rating +2 or more,119,29,10,19,87,20,65,43,19,3,2,2,0,3,2,0,0,1
S01009672,Occupancy rating +1,120,42,15,27,74,12,53,22,19,12,9,4,5,4,2,0,0,2
S01009672,Occupancy rating 0,100,42,22,20,56,0,41,3,25,13,15,13,2,2,2,0,0,0
S01009672,Occupancy rating -1 or less,16,4,2,2,11,0,11,1,8,2,0,0,0,1,1,0,0,0
S01009673,All households,351,109,48,61,231,39,168,65,74,29,24,15,9,11,1,2,1,7
S01009673,Occupancy rating +2 or more,175,38,17,21,133,31,96,48,35,13,6,2,4,4,1,0,0,3
S01009673,Occupancy rating +1,104,55,24,31,47,7,37,14,15,8,3,3,0,2,0,1,0,1
S01009673,Occupancy rating 0,51,12,5,7,35,1,24,3,15,6,10,5,5,4,0,1,1,2
S01009673,Occupancy rating -1 or less,21,4,2,2,16,0,11,0,9,2,5,5,0,1,0,0,0,1
S01009674,All households,392,111,51,60,270,48,190,95,68,27,32,21,11,11,4,0,2,5
S01009674,Occupancy rating +2 or more,239,54,30,24,178,38,134,71,44,19,6,4,2,7,2,0,1,4
S01009674,Occupancy rating +1,89,38,13,25,50,9,35,21,10,4,6,3,3,1,1,0,0,0
S01009674,Occupancy rating 0,51,14,5,9,35,1,16,2,12,2,18,12,6,2,0,0,1,1
S01009674,Occupancy rating -1 or less,13,5,3,2,7,0,5,1,2,2,2,2,0,1,1,0,0,0
S01009675,All households,379,93,42,51,270,50,193,88,75,30,27,16,11,16,5,0,1,10
S01009675,Occupancy rating +2 or more,230,49,23,26,174,37,127,71,40,16,10,5,5,7,2,0,1,4
S01009675,Occupancy rating +1,81,25,10,15,53,6,40,15,15,10,7,5,2,3,2,0,0,1
S01009675,Occupancy rating 0,61,18,8,10,38,7,24,2,18,4,7,4,3,5,1,0,0,4
S01009675,Occupancy rating -1 or less,7,1,1,0,5,0,2,0,2,0,3,2,1,1,0,0,0,1
S01009676,All households,356,114,60,54,229,30,169,74,73,22,30,18,12,13,7,0,0,6
S01009676,Occupancy rating +2 or more,178,47,26,21,121,20,97,58,33,6,4,1,3,10,4,0,0,6
S01009676,Occupancy rating +1,93,40,22,18,52,6,38,13,17,8,8,6,2,1,1,0,0,0
S01009676,Occupancy rating 0,63,17,8,9,44,4,26,2,17,7,14,8,6,2,2,0,0,0
S01009676,Occupancy rating -1 or less,22,10,4,6,12,0,8,1,6,1,4,3,1,0,0,0,0,0
S01009677,All households,268,88,35,53,171,23,133,63,59,11,15,8,7,9,4,0,1,4
S01009677,Occupancy rating +2 or more,174,48,19,29,123,21,96,49,39,8,6,4,2,3,2,0,0,1
S01009677,Occupancy rating +1,54,23,7,16,29,2,24,14,9,1,3,1,2,2,0,0,0,2
S01009677,Occupancy rating 0,28,13,5,8,13,0,7,0,6,1,6,3,3,2,1,0,1,0
S01009677,Occupancy rating -1 or less,12,4,4,0,6,0,6,0,5,1,0,0,0,2,1,0,0,1
S01009678,All households,273,81,48,33,184,43,115,52,37,26,26,17,9,8,1,0,1,6
S01009678,Occupancy rating +2 or more,125,35,20,15,90,26,59,38,10,11,5,3,2,0,0,0,0,0
S01009678,Occupancy rating +1,95,34,21,13,57,15,37,13,14,10,5,3,2,4,0,0,1,3
S01009678,Occupancy rating 0,39,10,6,4,29,1,15,0,10,5,13,10,3,0,0,0,0,0
S01009678,Occupancy rating -1 or less,14,2,1,1,8,1,4,1,3,0,3,1,2,4,1,0,0,3
S01009679,All households,434,174,65,109,244,32,179,86,76,17,33,25,8,16,3,2,1,10
S01009679,Occupancy rating +2 or more,174,55,23,32,114,17,93,56,29,8,4,3,1,5,0,0,0,5
S01009679,Occupancy rating +1,98,39,13,26,57,11,39,18,18,3,7,4,3,2,1,1,0,0
S01009679,Occupancy rating 0,130,68,25,43,56,3,33,9,21,3,20,16,4,6,1,1,0,4
S01009679,Occupancy rating -1 or less,32,12,4,8,17,1,14,3,8,3,2,2,0,3,1,0,1,1
S01009680,All households,356,108,51,57,241,28,171,67,69,35,42,28,14,7,3,0,0,4
S01009680,Occupancy rating +2 or more,127,29,17,12,96,17,75,42,22,11,4,1,3,2,1,0,0,1
S01009680,Occupancy rating +1,119,48,21,27,68,9,54,19,20,15,5,3,2,3,1,0,0,2
S01009680,Occupancy rating 0,80,26,11,15,54,2,29,3,19,7,23,15,8,0,0,0,0,0
S01009680,Occupancy rating -1 or less,30,5,2,3,23,0,13,3,8,2,10,9,1,2,1,0,0,1
S01009681,All households,245,76,19,57,162,13,128,58,47,23,21,13,8,7,3,0,0,4
S01009681,Occupancy rating +2 or more,115,33,9,24,82,8,69,42,20,7,5,3,2,0,0,0,0,0
S01009681,Occupancy rating +1,80,34,9,25,43,5,31,13,11,7,7,4,3,3,0,0,0,3
S01009681,Occupancy rating 0,44,8,1,7,33,0,25,3,13,9,8,5,3,3,2,0,0,1
S01009681,Occupancy rating -1 or less,6,1,0,1,4,0,3,0,3,0,1,1,0,1,1,0,0,0
S01009682,All households,278,79,39,40,192,37,136,68,51,17,19,14,5,7,5,0,0,2
S01009682,Occupancy rating +2 or more,179,44,24,20,134,33,95,58,29,8,6,4,2,1,1,0,0,0
S01009682,Occupancy rating +1,64,28,8,20,35,2,28,9,14,5,5,4,1,1,0,0,0,1
S01009682,Occupancy rating 0,31,7,7,0,21,1,13,1,8,4,7,6,1,3,2,0,0,1
S01009682,Occupancy rating -1 or less,4,0,0,0,2,1,0,0,0,0,1,0,1,2,2,0,0,0
S01009683,All households,364,126,80,46,225,45,156,67,58,31,24,11,13,13,3,2,1,7
S01009683,Occupancy rating +2 or more,209,51,35,16,153,32,114,57,37,20,7,3,4,5,1,0,1,3
S01009683,Occupancy rating +1,76,30,16,14,43,8,28,9,11,8,7,3,4,3,0,0,0,3
S01009683,Occupancy rating 0,62,32,25,7,26,5,11,1,8,2,10,5,5,4,2,1,0,1
S01009683,Occupancy rating -1 or less,17,13,4,9,3,0,3,0,2,1,0,0,0,1,0,1,0,0
S01009684,All households,395,61,24,37,319,33,257,91,128,38,29,19,10,15,8,0,0,7
S01009684,Occupancy rating +2 or more,277,36,15,21,232,32,193,72,95,26,7,3,4,9,3,0,0,6
S01009684,Occupancy rating +1,62,19,7,12,40,1,30,14,11,5,9,7,2,3,3,0,0,0
S01009684,Occupancy rating 0,34,3,0,3,30,0,23,5,14,4,7,3,4,1,0,0,0,1
S01009684,Occupancy rating -1 or less,22,3,2,1,17,0,11,0,8,3,6,6,0,2,2,0,0,0
S01009685,All households,264,80,27,53,174,22,131,57,58,16,21,11,10,10,5,0,0,5
S01009685,Occupancy rating +2 or more,102,22,4,18,76,13,61,38,19,4,2,1,1,4,3,0,0,1
S01009685,Occupancy rating +1,75,28,14,14,44,5,32,13,12,7,7,3,4,3,0,0,0,3
S01009685,Occupancy rating 0,74,25,7,18,47,4,33,6,22,5,10,6,4,2,1,0,0,1
S01009685,Occupancy rating -1 or less,13,5,2,3,7,0,5,0,5,0,2,1,1,1,1,0,0,0
S01009686,All households,544,211,80,131,296,44,176,82,75,19,76,56,20,37,11,6,4,16
S01009686,Occupancy rating +2 or more,159,54,17,37,94,22,62,35,22,5,10,5,5,11,4,2,1,4
S01009686,Occupancy rating +1,161,62,31,31,95,19,53,31,16,6,23,16,7,4,0,0,1,3
S01009686,Occupancy rating 0,159,69,27,42,78,3,44,10,27,7,31,25,6,12,1,2,2,7
S01009686,Occupancy rating -1 or less,65,26,5,21,29,0,17,6,10,1,12,10,2,10,6,2,0,2
S01009687,All households,299,71,38,33,217,23,167,65,81,21,27,18,9,11,4,0,1,6
S01009687,Occupancy rating +2 or more,130,28,20,8,98,14,81,46,23,12,3,2,1,4,3,0,0,1
S01009687,Occupancy rating +1,86,30,14,16,54,6,41,16,23,2,7,4,3,2,0,0,1,1
S01009687,Occupancy rating 0,72,13,4,9,55,3,37,2,29,6,15,11,4,4,0,0,0,4
S01009687,Occupancy rating -1 or less,11,0,0,0,10,0,8,1,6,1,2,1,1,1,1,0,0,0
S01009688,All households,456,201,69,132,243,27,125,46,64,15,91,71,20,12,5,0,0,7
S01009688,Occupancy rating +2 or more,62,24,11,13,37,12,22,15,5,2,3,2,1,1,0,0,0,1
S01009688,Occupancy rating +1,174,107,25,82,65,6,48,28,12,8,11,6,5,2,1,0,0,1
S01009688,Occupancy rating 0,168,58,26,32,104,8,41,3,34,4,55,47,8,6,2,0,0,4
S01009688,Occupancy rating -1 or less,52,12,7,5,37,1,14,0,13,1,22,16,6,3,2,0,0,1
S01009689,All households,333,174,63,111,149,16,103,47,47,9,30,21,9,10,1,2,0,7
S01009689,Occupancy rating +2 or more,100,33,14,19,62,10,45,23,17,5,7,3,4,5,0,0,0,5
S01009689,Occupancy rating +1,77,40,12,28,35,4,23,15,8,0,8,4,4,2,1,0,0,1
S01009689,Occupancy rating 0,121,81,31,50,38,1,27,6,18,3,10,10,0,2,0,2,0,0
S01009689,Occupancy rating -1 or less,35,20,6,14,14,1,8,3,4,1,5,4,1,1,0,0,0,1
S01009690,All households,347,138,42,96,198,26,135,70,49,16,37,25,12,11,4,0,0,7
S01009690,Occupancy rating +2 or more,133,41,19,22,90,15,66,40,18,8,9,5,4,2,0,0,0,2
S01009690,Occupancy rating +1,100,46,14,32,53,10,35,19,11,5,8,7,1,1,1,0,0,0
S01009690,Occupancy rating 0,87,40,8,32,44,1,25,10,13,2,18,11,7,3,1,0,0,2
S01009690,Occupancy rating -1 or less,27,11,1,10,11,0,9,1,7,1,2,2,0,5,2,0,0,3
S01009691,All households,260,64,50,14,185,40,123,55,56,12,22,15,7,11,4,0,0,7
S01009691,Occupancy rating +2 or more,127,15,8,7,109,20,86,44,33,9,3,2,1,3,0,0,0,3
S01009691,Occupancy rating +1,71,24,18,6,45,16,20,8,11,1,9,8,1,2,1,0,0,1
S01009691,Occupancy rating 0,53,24,23,1,25,4,12,1,9,2,9,5,4,4,1,0,0,3
S01009691,Occupancy rating -1 or less,9,1,1,0,6,0,5,2,3,0,1,0,1,2,2,0,0,0
S01009692,All households,484,145,86,59,320,78,216,115,77,24,26,13,13,19,7,0,4,8
S01009692,Occupancy rating +2 or more,307,90,59,31,213,58,146,90,41,15,9,5,4,4,1,0,1,2
S01009692,Occupancy rating +1,116,43,24,19,71,18,44,20,18,6,9,1,8,2,1,0,1,0
S01009692,Occupancy rating 0,46,10,3,7,26,0,20,5,13,2,6,5,1,10,4,0,2,4
S01009692,Occupancy rating -1 or less,15,2,0,2,10,2,6,0,5,1,2,2,0,3,1,0,0,2
S01009693,All households,252,50,39,11,199,32,147,52,66,29,20,10,10,3,1,0,2,0
S01009693,Occupancy rating +2 or more,167,37,29,8,129,30,90,45,33,12,9,4,5,1,0,0,1,0
S01009693,Occupancy rating +1,64,11,9,2,53,2,43,6,25,12,8,4,4,0,0,0,0,0
S01009693,Occupancy rating 0,18,1,1,0,16,0,13,1,8,4,3,2,1,1,0,0,1,0
S01009693,Occupancy rating -1 or less,3,1,0,1,1,0,1,0,0,1,0,0,0,1,1,0,0,0
S01009694,All households,453,135,89,46,308,84,200,101,78,21,24,12,12,10,3,0,2,5
S01009694,Occupancy rating +2 or more,303,73,54,19,225,68,148,81,55,12,9,4,5,5,1,0,2,2
S01009694,Occupancy rating +1,106,45,23,22,61,14,39,18,16,5,8,5,3,0,0,0,0,0
S01009694,Occupancy rating 0,34,14,10,4,17,1,10,0,6,4,6,3,3,3,1,0,0,2
S01009694,Occupancy rating -1 or less,10,3,2,1,5,1,3,2,1,0,1,0,1,2,1,0,0,1
S01009695,All households,278,66,40,26,203,42,143,79,47,17,18,16,2,9,5,0,0,4
S01009695,Occupancy rating +2 or more,182,34,23,11,146,33,107,65,30,12,6,5,1,2,2,0,0,0
S01009695,Occupancy rating +1,65,25,14,11,37,8,24,11,9,4,5,5,0,3,2,0,0,1
S01009695,Occupancy rating 0,25,6,2,4,16,1,9,3,5,1,6,5,1,3,0,0,0,3
S01009695,Occupancy rating -1 or less,6,1,1,0,4,0,3,0,3,0,1,1,0,1,1,0,0,0
S01009696,All households,443,151,89,62,279,44,210,98,89,23,25,16,9,13,3,0,2,8
S01009696,Occupancy rating +2 or more,280,84,51,33,193,34,147,73,53,21,12,7,5,3,0,0,1,2
S01009696,Occupancy rating +1,95,46,25,21,47,7,36,22,13,1,4,3,1,2,0,0,0,2
S01009696,Occupancy rating 0,52,14,8,6,31,2,20,2,17,1,9,6,3,7,2,0,1,4
S01009696,Occupancy rating -1 or less,16,7,5,2,8,1,7,1,6,0,0,0,0,1,1,0,0,0
S01009697,All households,314,89,51,38,210,36,160,84,58,18,14,4,10,15,4,2,0,9
S01009697,Occupancy rating +2 or more,188,45,33,12,137,28,105,64,28,13,4,0,4,6,1,1,0,4
S01009697,Occupancy rating +1,68,24,9,15,39,5,33,17,13,3,1,0,1,5,1,1,0,3
S01009697,Occupancy rating 0,45,20,9,11,23,2,14,3,9,2,7,3,4,2,1,0,0,1
S01009697,Occupancy rating -1 or less,13,0,0,0,11,1,8,0,8,0,2,1,1,2,1,0,0,1
S01009698,All households,232,49,9,40,171,22,134,61,48,25,15,9,6,12,5,1,0,6
S01009698,Occupancy rating +2 or more,154,28,7,21,121,22,93,48,32,13,6,3,3,5,5,0,0,0
S01009698,Occupancy rating +1,43,13,1,12,28,0,25,11,7,7,3,1,2,2,0,1,0,1
S01009698,Occupancy rating 0,25,5,1,4,16,0,12,2,8,2,4,3,1,4,0,0,0,4
S01009698,Occupancy rating -1 or less,10,3,0,3,6,0,4,0,1,3,2,2,0,1,0,0,0,1
S01009699,All households,236,85,45,40,141,47,79,45,23,11,15,4,11,10,6,0,0,4
S01009699,Occupancy rating +2 or more,140,41,26,15,96,41,47,31,11,5,8,1,7,3,2,0,0,1
S01009699,Occupancy rating +1,56,28,10,18,25,6,18,11,4,3,1,0,1,3,1,0,0,2
S01009699,Occupancy rating 0,31,13,7,6,15,0,11,3,5,3,4,1,3,3,2,0,0,1
S01009699,Occupancy rating -1 or less,9,3,2,1,5,0,3,0,3,0,2,2,0,1,1,0,0,0
S01009700,All households,297,93,45,48,194,39,128,64,41,23,27,14,13,10,5,3,0,2
S01009700,Occupancy rating +2 or more,147,42,21,21,103,29,67,46,14,7,7,2,5,2,1,1,0,0
S01009700,Occupancy rating +1,76,31,14,17,44,6,32,14,10,8,6,5,1,1,0,0,0,1
S01009700,Occupancy rating 0,60,18,9,9,38,4,23,4,12,7,11,5,6,4,3,0,0,1
S01009700,Occupancy rating -1 or less,14,2,1,1,9,0,6,0,5,1,3,2,1,3,1,2,0,0
S01009701,All households,229,97,66,31,127,49,68,34,21,13,10,6,4,5,1,0,2,2
S01009701,Occupancy rating +2 or more,146,57,38,19,88,44,39,26,4,9,5,3,2,1,0,0,1,0
S01009701,Occupancy rating +1,31,12,7,5,16,1,13,5,6,2,2,1,1,3,0,0,1,2
S01009701,Occupancy rating 0,36,19,13,6,16,4,11,3,7,1,1,0,1,1,1,0,0,0
S01009701,Occupancy rating -1 or less,16,9,8,1,7,0,5,0,4,1,2,2,0,0,0,0,0,0
S01009702,All households,265,60,24,36,194,38,135,57,53,25,21,15,6,11,3,1,0,7
S01009702,Occupancy rating +2 or more,156,36,17,19,117,33,80,41,25,14,4,3,1,3,1,0,0,2
S01009702,Occupancy rating +1,74,17,4,13,54,5,39,13,18,8,10,7,3,3,1,1,0,1
S01009702,Occupancy rating 0,32,7,3,4,22,0,15,3,9,3,7,5,2,3,0,0,0,3
S01009702,Occupancy rating -1 or less,3,0,0,0,1,0,1,0,1,0,0,0,0,2,1,0,0,1
S01009703,All households,285,115,76,39,164,21,113,59,38,16,30,17,13,6,2,0,0,4
S01009703,Occupancy rating +2 or more,129,43,29,14,83,13,65,43,14,8,5,3,2,3,1,0,0,2
S01009703,Occupancy rating +1,85,40,25,15,44,5,29,14,10,5,10,5,5,1,0,0,0,1
S01009703,Occupancy rating 0,58,26,18,8,30,2,15,2,11,2,13,8,5,2,1,0,0,1
S01009703,Occupancy rating -1 or less,13,6,4,2,7,1,4,0,3,1,2,1,1,0,0,0,0,0
S01009704,All households,440,148,75,73,282,53,195,99,73,23,34,28,6,10,1,0,2,7
S01009704,Occupancy rating +2 or more,250,76,46,30,171,42,119,74,31,14,10,5,5,3,0,0,2,1
S01009704,Occupancy rating +1,100,34,17,17,62,9,45,20,19,6,8,8,0,4,0,0,0,4
S01009704,Occupancy rating 0,75,31,10,21,43,2,26,5,19,2,15,14,1,1,0,0,0,1
S01009704,Occupancy rating -1 or less,15,7,2,5,6,0,5,0,4,1,1,1,0,2,1,0,0,1
S01009705,All households,363,149,74,75,200,33,136,68,47,21,31,21,10,14,6,0,2,6
S01009705,Occupancy rating +2 or more,126,49,29,20,76,23,50,35,10,5,3,0,3,1,1,0,0,0
S01009705,Occupancy rating +1,103,39,22,17,60,8,43,25,10,8,9,5,4,4,1,0,1,2
S01009705,Occupancy rating 0,111,51,17,34,52,2,34,7,19,8,16,13,3,8,4,0,0,4
S01009705,Occupancy rating -1 or less,23,10,6,4,12,0,9,1,8,0,3,3,0,1,0,0,1,0
S01009706,All households,295,123,64,59,160,29,111,42,50,19,20,14,6,12,5,1,2,4
S01009706,Occupancy rating +2 or more,144,55,33,22,87,21,60,34,17,9,6,4,2,2,0,0,0,2
S01009706,Occupancy rating +1,81,38,13,25,38,7,26,6,15,5,5,2,3,5,3,1,1,0
S01009706,Occupancy rating 0,56,25,15,10,28,1,20,1,15,4,7,6,1,3,0,0,1,2
S01009706,Occupancy rating -1 or less,14,5,3,2,7,0,5,1,3,1,2,2,0,2,2,0,0,0
S01009707,All households,218,79,31,48,132,12,104,43,42,19,16,7,9,7,2,0,0,5
S01009707,Occupancy rating +2 or more,131,46,17,29,82,11,63,33,23,7,8,2,6,3,0,0,0,3
S01009707,Occupancy rating +1,45,14,8,6,31,1,25,5,12,8,5,3,2,0,0,0,0,0
S01009707,Occupancy rating 0,33,12,3,9,17,0,14,5,5,4,3,2,1,4,2,0,0,2
S01009707,Occupancy rating -1 or less,9,7,3,4,2,0,2,0,2,0,0,0,0,0,0,0,0,0
S01009708,All households,258,68,31,37,186,34,129,66,50,13,23,12,11,4,0,0,0,4
S01009708,Occupancy rating +2 or more,148,26,16,10,122,29,88,50,31,7,5,1,4,0,0,0,0,0
S01009708,Occupancy rating +1,56,23,12,11,33,5,24,13,7,4,4,2,2,0,0,0,0,0
S01009708,Occupancy rating 0,43,14,3,11,26,0,16,2,12,2,10,6,4,3,0,0,0,3
S01009708,Occupancy rating -1 or less,11,5,0,5,5,0,1,1,0,0,4,3,1,1,0,0,0,1
S01009709,All households,394,155,78,77,229,41,164,82,48,34,24,15,9,10,3,1,2,4
S01009709,Occupancy rating +2 or more,204,72,39,33,126,35,85,53,19,13,6,3,3,6,2,0,1,3
S01009709,Occupancy rating +1,109,51,25,26,56,5,47,22,15,10,4,2,2,2,0,0,1,1
S01009709,Occupancy rating 0,66,26,11,15,39,0,27,5,13,9,12,9,3,1,0,1,0,0
S01009709,Occupancy rating -1 or less,15,6,3,3,8,1,5,2,1,2,2,1,1,1,1,0,0,0
S01009710,All households,246,82,31,51,159,17,115,45,54,16,27,19,8,5,3,0,1,1
S01009710,Occupancy rating +2 or more,125,38,19,19,85,12,63,28,28,7,10,6,4,2,2,0,0,0
S01009710,Occupancy rating +1,64,18,8,10,45,4,35,13,15,7,6,4,2,1,0,0,1,0
S01009710,Occupancy rating 0,49,23,3,20,25,1,15,3,10,2,9,7,2,1,0,0,0,1
S01009710,Occupancy rating -1 or less,8,3,1,2,4,0,2,1,1,0,2,2,0,1,1,0,0,0
S01009711,All households,341,114,57,57,207,32,134,52,53,29,41,30,11,20,7,1,2,10
S01009711,Occupancy rating +2 or more,126,31,17,14,91,15,70,37,17,16,6,3,3,4,2,0,0,2
S01009711,Occupancy rating +1,102,38,13,25,58,12,36,12,18,6,10,8,2,6,2,0,1,3
S01009711,Occupancy rating 0,92,35,23,12,49,5,23,3,13,7,21,16,5,8,2,1,1,4
S01009711,Occupancy rating -1 or less,21,10,4,6,9,0,5,0,5,0,4,3,1,2,1,0,0,1
S01009712,All households,277,95,36,59,174,30,121,49,44,28,23,13,10,8,4,0,0,4
S01009712,Occupancy rating +2 or more,154,47,17,30,102,26,69,33,17,19,7,5,2,5,4,0,0,1
S01009712,Occupancy rating +1,69,25,10,15,43,4,33,14,12,7,6,2,4,1,0,0,0,1
S01009712,Occupancy rating 0,44,20,8,12,22,0,16,2,12,2,6,4,2,2,0,0,0,2
S01009712,Occupancy rating -1 or less,10,3,1,2,7,0,3,0,3,0,4,2,2,0,0,0,0,0
S01009713,All households,444,164,90,74,268,70,161,87,56,18,37,22,15,12,2,1,3,6
S01009713,Occupancy rating +2 or more,235,71,39,32,160,54,99,60,27,12,7,2,5,4,1,0,2,1
S01009713,Occupancy rating +1,109,50,28,22,55,9,35,21,14,0,11,8,3,4,0,0,1,3
S01009713,Occupancy rating 0,80,33,20,13,45,7,22,5,11,6,16,11,5,2,1,0,0,1
S01009713,Occupancy rating -1 or less,20,10,3,7,8,0,5,1,4,0,3,1,2,2,0,1,0,1
S01009714,All households,453,164,99,65,276,69,179,98,61,20,28,17,11,13,4,0,2,7
S01009714,Occupancy rating +2 or more,285,100,72,28,180,61,111,72,28,11,8,5,3,5,3,0,0,2
S01009714,Occupancy rating +1,96,44,16,28,48,8,33,19,10,4,7,2,5,4,1,0,2,1
S01009714,Occupancy rating 0,58,16,7,9,40,0,28,6,17,5,12,10,2,2,0,0,0,2
S01009714,Occupancy rating -1 or less,14,4,4,0,8,0,7,1,6,0,1,0,1,2,0,0,0,2
S01009715,All households,334,134,49,85,186,35,126,73,40,13,25,11,14,14,3,2,2,7
S01009715,Occupancy rating +2 or more,182,67,28,39,111,32,72,48,16,8,7,5,2,4,0,0,1,3
S01009715,Occupancy rating +1,80,31,13,18,47,3,36,21,12,3,8,4,4,2,0,1,1,0
S01009715,Occupancy rating 0,61,34,8,26,21,0,13,3,8,2,8,2,6,6,2,1,0,3
S01009715,Occupancy rating -1 or less,11,2,0,2,7,0,5,1,4,0,2,0,2,2,1,0,0,1
S01009716,All households,329,93,64,29,192,56,116,58,38,20,20,5,15,44,7,22,2,13
S01009716,Occupancy rating +2 or more,201,68,51,17,125,44,75,44,19,12,6,2,4,8,2,1,1,4
S01009716,Occupancy rating +1,85,22,11,11,48,9,31,14,12,5,8,1,7,15,1,9,0,5
S01009716,Occupancy rating 0,34,3,2,1,15,3,10,0,7,3,2,0,2,16,2,10,1,3
S01009716,Occupancy rating -1 or less,9,0,0,0,4,0,0,0,0,0,4,2,2,5,2,2,0,1
S01009717,All households,327,104,36,68,152,27,88,36,42,10,37,26,11,71,3,61,0,7
S01009717,Occupancy rating +2 or more,77,32,14,18,39,18,19,9,6,4,2,1,1,6,0,3,0,3
S01009717,Occupancy rating +1,94,44,12,32,41,7,33,17,11,5,1,1,0,9,0,7,0,2
S01009717,Occupancy rating 0,122,20,8,12,61,0,30,9,20,1,31,22,9,41,0,39,0,2
S01009717,Occupancy rating -1 or less,34,8,2,6,11,2,6,1,5,0,3,2,1,15,3,12,0,0
S01009718,All households,327,85,48,37,181,17,106,48,38,20,58,32,26,61,5,35,1,20
S01009718,Occupancy rating +2 or more,87,29,19,10,54,9,43,30,7,6,2,0,2,4,0,3,0,1
S01009718,Occupancy rating +1,109,46,22,24,48,8,24,15,4,5,16,9,7,15,1,4,1,9
S01009718,Occupancy rating 0,99,8,6,2,61,0,33,3,24,6,28,16,12,30,0,23,0,7
S01009718,Occupancy rating -1 or less,32,2,1,1,18,0,6,0,3,3,12,7,5,12,4,5,0,3
S01009719,All households,342,121,65,56,186,29,118,44,44,30,39,21,18,35,1,20,0,14
S01009719,Occupancy rating +2 or more,107,40,27,13,65,19,43,28,10,5,3,2,1,2,0,1,0,1
S01009719,Occupancy rating +1,106,55,23,32,45,7,34,11,11,12,4,1,3,6,0,2,0,4
S01009719,Occupancy rating 0,102,24,14,10,56,3,33,5,17,11,20,9,11,22,1,14,0,7
S01009719,Occupancy rating -1 or less,27,2,1,1,20,0,8,0,6,2,12,9,3,5,0,3,0,2
S01009720,All households,379,137,90,47,176,31,121,58,37,26,24,15,9,66,7,31,4,24
S01009720,Occupancy rating +2 or more,114,46,25,21,59,18,40,30,6,4,1,0,1,9,2,3,0,4
S01009720,Occupancy rating +1,124,46,30,16,60,12,46,21,14,11,2,1,1,18,0,6,2,10
S01009720,Occupancy rating 0,115,42,34,8,50,1,30,7,15,8,19,12,7,23,1,16,2,4
S01009720,Occupancy rating -1 or less,26,3,1,2,7,0,5,0,2,3,2,2,0,16,4,6,0,6
S01009721,All households,221,28,7,21,40,6,31,19,8,4,3,2,1,153,2,140,0,11
S01009721,Occupancy rating +2 or more,24,6,4,2,13,4,9,4,2,3,0,0,0,5,1,4,0,0
S01009721,Occupancy rating +1,36,10,3,7,10,2,7,5,1,1,1,1,0,16,0,13,0,3
S01009721,Occupancy rating 0,93,11,0,11,11,0,10,7,3,0,1,1,0,71,0,65,0,6
S01009721,Occupancy rating -1 or less,68,1,0,1,6,0,5,3,2,0,1,0,1,61,1,58,0,2
S01009722,All households,387,147,56,91,76,23,46,36,9,1,7,2,5,164,2,151,2,9
S01009722,Occupancy rating +2 or more,114,51,32,19,50,19,26,22,4,0,5,1,4,13,2,10,0,1
S01009722,Occupancy rating +1,77,36,13,23,15,3,12,10,1,1,0,0,0,26,0,24,1,1
S01009722,Occupancy rating 0,116,36,7,29,6,1,3,3,0,0,2,1,1,74,0,70,0,4
S01009722,Occupancy rating -1 or less,80,24,4,20,5,0,5,1,4,0,0,0,0,51,0,47,1,3
S01009723,All households,302,112,59,53,65,10,49,38,7,4,6,5,1,125,0,117,1,7
S01009723,Occupancy rating +2 or more,56,20,15,5,27,7,19,12,4,3,1,0,1,9,0,7,1,1
S01009723,Occupancy rating +1,39,19,9,10,8,1,6,6,0,0,1,1,0,12,0,12,0,0
S01009723,Occupancy rating 0,129,47,22,25,18,2,15,14,1,0,1,1,0,64,0,61,0,3
S01009723,Occupancy rating -1 or less,78,26,13,13,12,0,9,6,2,1,3,3,0,40,0,37,0,3
S01009724,All households,495,192,89,103,160,22,95,55,27,13,43,28,15,143,8,109,1,25
S01009724,Occupancy rating +2 or more,52,22,11,11,28,11,16,12,2,2,1,0,1,2,0,2,0,0
S01009724,Occupancy rating +1,124,63,31,32,44,8,31,24,5,2,5,3,2,17,1,13,0,3
S01009724,Occupancy rating 0,254,97,42,55,67,3,38,19,12,7,26,15,11,90,2,71,1,16
S01009724,Occupancy rating -1 or less,65,10,5,5,21,0,10,0,8,2,11,10,1,34,5,23,0,6
S01009725,All households,251,47,22,25,70,18,40,24,11,5,12,5,7,134,4,115,0,15
S01009725,Occupancy rating +2 or more,59,18,10,8,34,14,19,12,4,3,1,0,1,7,2,3,0,2
S01009725,Occupancy rating +1,55,16,8,8,18,4,9,8,1,0,5,2,3,21,0,21,0,0
S01009725,Occupancy rating 0,83,7,2,5,15,0,11,4,5,2,4,1,3,61,1,51,0,9
S01009725,Occupancy rating -1 or less,54,6,2,4,3,0,1,0,1,0,2,2,0,45,1,40,0,4
S01009726,All households,209,47,10,37,49,14,30,19,7,4,5,1,4,113,5,101,1,6
S01009726,Occupancy rating +2 or more,54,15,4,11,30,13,14,7,4,3,3,1,2,9,0,6,0,3
S01009726,Occupancy rating +1,34,9,1,8,7,0,7,7,0,0,0,0,0,18,1,14,1,2
S01009726,Occupancy rating 0,75,15,5,10,8,1,6,4,1,1,1,0,1,52,1,50,0,1
S01009726,Occupancy rating -1 or less,46,8,0,8,4,0,3,1,2,0,1,0,1,34,3,31,0,0
S01009727,All households,331,72,25,47,226,30,178,64,96,18,18,15,3,33,1,16,3,13
S01009727,Occupancy rating +2 or more,196,42,19,23,144,25,115,51,55,9,4,3,1,10,0,3,3,4
S01009727,Occupancy rating +1,67,24,4,20,38,4,28,10,14,4,6,6,0,5,0,4,0,1
S01009727,Occupancy rating 0,55,6,2,4,39,1,31,3,25,3,7,6,1,10,1,5,0,4
S01009727,Occupancy rating -1 or less,13,0,0,0,5,0,4,0,2,2,1,0,1,8,0,4,0,4
S01009728,All households,333,94,57,37,211,36,154,75,51,28,21,12,9,28,4,9,0,15
S01009728,Occupancy rating +2 or more,249,78,51,27,165,34,120,68,30,22,11,5,6,6,0,2,0,4
S01009728,Occupancy rating +1,52,13,6,7,29,1,24,7,12,5,4,3,1,10,2,2,0,6
S01009728,Occupancy rating 0,24,2,0,2,14,0,9,0,8,1,5,3,2,8,1,4,0,3
S01009728,Occupancy rating -1 or less,8,1,0,1,3,1,1,0,1,0,1,1,0,4,1,1,0,2
S01009729,All households,282,63,50,13,204,54,133,72,38,23,17,6,11,15,2,5,4,4
S01009729,Occupancy rating +2 or more,234,53,43,10,171,52,108,64,24,20,11,4,7,10,1,2,3,4
S01009729,Occupancy rating +1,33,9,7,2,22,2,17,6,9,2,3,1,2,2,0,2,0,0
S01009729,Occupancy rating 0,14,1,0,1,10,0,8,2,5,1,2,1,1,3,1,1,1,0
S01009729,Occupancy rating -1 or less,1,0,0,0,1,0,0,0,0,0,1,0,1,0,0,0,0,0
S01009730,All households,241,69,30,39,136,19,99,51,31,17,18,14,4,36,1,20,0,15
S01009730,Occupancy rating +2 or more,92,31,17,14,55,12,42,32,4,6,1,1,0,6,0,3,0,3
S01009730,Occupancy rating +1,68,24,11,13,40,7,29,14,9,6,4,4,0,4,0,1,0,3
S01009730,Occupancy rating 0,67,14,2,12,37,0,28,5,18,5,9,7,2,16,0,10,0,6
S01009730,Occupancy rating -1 or less,14,0,0,0,4,0,0,0,0,0,4,2,2,10,1,6,0,3
S01009731,All households,274,86,63,23,159,66,89,41,30,18,4,2,2,29,4,18,2,5
S01009731,Occupancy rating +2 or more,226,77,57,20,141,64,74,39,23,12,3,1,2,8,3,2,1,2
S01009731,Occupancy rating +1,27,7,4,3,10,2,8,2,4,2,0,0,0,10,1,6,1,2
S01009731,Occupancy rating 0,16,2,2,0,5,0,4,0,1,3,1,1,0,9,0,8,0,1
S01009731,Occupancy rating -1 or less,5,0,0,0,3,0,3,0,2,1,0,0,0,2,0,2,0,0
S01009732,All households,344,87,44,43,138,41,83,47,25,11,14,9,5,119,7,96,0,16
S01009732,Occupancy rating +2 or more,160,48,31,17,96,39,53,33,14,6,4,2,2,16,2,6,0,8
S01009732,Occupancy rating +1,59,16,9,7,26,2,20,12,4,4,4,2,2,17,1,13,0,3
S01009732,Occupancy rating 0,86,17,3,14,13,0,8,2,6,0,5,4,1,56,2,52,0,2
S01009732,Occupancy rating -1 or less,39,6,1,5,3,0,2,0,1,1,1,1,0,30,2,25,0,3
S01009733,All households,227,65,28,37,151,20,118,69,40,9,13,4,9,11,2,1,1,7
S01009733,Occupancy rating +2 or more,124,34,18,16,85,14,69,37,27,5,2,1,1,5,1,0,1,3
S01009733,Occupancy rating +1,66,20,7,13,45,5,35,23,9,3,5,2,3,1,0,0,0,1
S01009733,Occupancy rating 0,31,8,2,6,20,1,13,8,4,1,6,1,5,3,1,0,0,2
S01009733,Occupancy rating -1 or less,6,3,1,2,1,0,1,1,0,0,0,0,0,2,0,1,0,1
S01009734,All households,385,113,56,57,255,43,177,75,73,29,35,24,11,17,3,5,0,9
S01009734,Occupancy rating +2 or more,270,68,35,33,194,41,137,61,57,19,16,10,6,8,2,2,0,4
S01009734,Occupancy rating +1,69,35,16,19,31,1,25,8,9,8,5,3,2,3,0,0,0,3
S01009734,Occupancy rating 0,39,10,5,5,23,1,13,5,6,2,9,8,1,6,1,3,0,2
S01009734,Occupancy rating -1 or less,7,0,0,0,7,0,2,1,1,0,5,3,2,0,0,0,0,0
S01009735,All households,327,74,55,19,227,71,133,70,48,15,23,10,13,26,1,12,0,13
S01009735,Occupancy rating +2 or more,287,66,49,17,207,67,123,67,43,13,17,7,10,14,1,4,0,9
S01009735,Occupancy rating +1,14,6,6,0,7,2,3,0,2,1,2,0,2,1,0,1,0,0
S01009735,Occupancy rating 0,17,1,0,1,9,1,5,3,2,0,3,3,0,7,0,3,0,4
S01009735,Occupancy rating -1 or less,9,1,0,1,4,1,2,0,1,1,1,0,1,4,0,4,0,0
S01009736,All households,332,123,91,32,70,23,44,28,12,4,3,1,2,139,0,126,2,11
S01009736,Occupancy rating +2 or more,73,25,16,9,36,17,17,7,7,3,2,1,1,12,0,7,1,4
S01009736,Occupancy rating +1,65,33,25,8,12,3,9,9,0,0,0,0,0,20,0,19,0,1
S01009736,Occupancy rating 0,143,54,41,13,17,2,14,11,2,1,1,0,1,72,0,68,1,3
S01009736,Occupancy rating -1 or less,51,11,9,2,5,1,4,1,3,0,0,0,0,35,0,32,0,3
S01009737,All households,323,51,29,22,261,26,204,99,87,18,31,20,11,11,4,1,1,5
S01009737,Occupancy rating +2 or more,114,23,11,12,91,13,74,47,24,3,4,2,2,0,0,0,0,0
S01009737,Occupancy rating +1,128,13,6,7,111,12,89,48,34,7,10,6,4,4,2,0,0,2
S01009737,Occupancy rating 0,71,14,12,2,51,0,37,3,27,7,14,12,2,6,2,1,1,2
S01009737,Occupancy rating -1 or less,10,1,0,1,8,1,4,1,2,1,3,0,3,1,0,0,0,1
S01009738,All households,214,76,24,52,131,13,99,61,26,12,19,11,8,7,1,0,1,5
S01009738,Occupancy rating +2 or more,59,12,7,5,45,5,37,29,5,3,3,1,2,2,1,0,1,0
S01009738,Occupancy rating +1,100,44,10,34,55,8,41,28,8,5,6,3,3,1,0,0,0,1
S01009738,Occupancy rating 0,43,18,5,13,22,0,15,1,11,3,7,5,2,3,0,0,0,3
S01009738,Occupancy rating -1 or less,12,2,2,0,9,0,6,3,2,1,3,2,1,1,0,0,0,1
S01009739,All households,275,44,4,40,220,7,190,60,108,22,23,15,8,11,1,2,0,8
S01009739,Occupancy rating +2 or more,153,25,2,23,123,7,112,45,56,11,4,3,1,5,1,2,0,2
S01009739,Occupancy rating +1,69,11,2,9,56,0,51,15,29,7,5,3,2,2,0,0,0,2
S01009739,Occupancy rating 0,43,7,0,7,32,0,23,0,20,3,9,7,2,4,0,0,0,4
S01009739,Occupancy rating -1 or less,10,1,0,1,9,0,4,0,3,1,5,2,3,0,0,0,0,0
S01009740,All households,243,68,29,39,153,26,90,37,36,17,37,31,6,22,6,1,2,13
S01009740,Occupancy rating +2 or more,83,29,10,19,53,15,33,21,8,4,5,4,1,1,1,0,0,0
S01009740,Occupancy rating +1,75,21,12,9,47,6,31,10,13,8,10,8,2,7,0,0,1,6
S01009740,Occupancy rating 0,71,16,5,11,44,4,23,6,12,5,17,15,2,11,4,1,1,5
S01009740,Occupancy rating -1 or less,14,2,2,0,9,1,3,0,3,0,5,4,1,3,1,0,0,2
S01009741,All households,164,15,4,11,145,6,131,12,111,8,8,8,0,4,2,0,0,2
S01009741,Occupancy rating +2 or more,59,7,2,5,51,0,50,11,37,2,1,1,0,1,1,0,0,0
S01009741,Occupancy rating +1,68,5,1,4,62,4,52,1,48,3,6,6,0,1,0,0,0,1
S01009741,Occupancy rating 0,35,3,1,2,31,2,28,0,25,3,1,1,0,1,0,0,0,1
S01009741,Occupancy rating -1 or less,2,0,0,0,1,0,1,0,1,0,0,0,0,1,1,0,0,0
S01009742,All households,206,44,15,29,158,28,122,55,45,22,8,5,3,4,1,0,1,2
S01009742,Occupancy rating +2 or more,144,27,8,19,113,23,87,47,26,14,3,1,2,4,1,0,1,2
S01009742,Occupancy rating +1,33,11,5,6,22,4,17,4,9,4,1,1,0,0,0,0,0,0
S01009742,Occupancy rating 0,22,5,2,3,17,1,14,3,7,4,2,2,0,0,0,0,0,0
S01009742,Occupancy rating -1 or less,7,1,0,1,6,0,4,1,3,0,2,1,1,0,0,0,0,0
S01009743,All households,425,111,64,47,302,57,211,108,74,29,34,22,12,12,8,0,0,4
S01009743,Occupancy rating +2 or more,265,61,35,26,202,44,145,91,37,17,13,7,6,2,0,0,0,2
S01009743,Occupancy rating +1,92,31,17,14,59,12,40,15,21,4,7,5,2,2,1,0,0,1
S01009743,Occupancy rating 0,52,13,8,5,32,0,20,2,13,5,12,10,2,7,6,0,0,1
S01009743,Occupancy rating -1 or less,16,6,4,2,9,1,6,0,3,3,2,0,2,1,1,0,0,0
S01009744,All households,306,80,34,46,214,35,161,84,56,21,18,10,8,12,3,0,2,7
S01009744,Occupancy rating +2 or more,198,39,16,23,152,28,115,72,32,11,9,3,6,7,1,0,2,4
S01009744,Occupancy rating +1,73,35,16,19,34,7,25,11,11,3,2,2,0,4,2,0,0,2
S01009744,Occupancy rating 0,28,4,2,2,23,0,18,1,11,6,5,3,2,1,0,0,0,1
S01009744,Occupancy rating -1 or less,7,2,0,2,5,0,3,0,2,1,2,2,0,0,0,0,0,0
S01009745,All households,455,106,57,49,341,51,261,110,119,32,29,22,7,8,4,0,0,4
S01009745,Occupancy rating +2 or more,297,57,29,28,235,39,181,86,81,14,15,10,5,5,2,0,0,3
S01009745,Occupancy rating +1,102,34,16,18,68,9,54,20,25,9,5,5,0,0,0,0,0,0
S01009745,Occupancy rating 0,46,14,11,3,29,3,19,3,9,7,7,5,2,3,2,0,0,1
S01009745,Occupancy rating -1 or less,10,1,1,0,9,0,7,1,4,2,2,2,0,0,0,0,0,0
S01009746,All households,237,58,15,43,171,19,138,70,52,16,14,8,6,8,2,0,0,6
S01009746,Occupancy rating +2 or more,151,28,8,20,120,17,98,53,36,9,5,4,1,3,0,0,0,3
S01009746,Occupancy rating +1,61,24,4,20,34,2,26,13,8,5,6,3,3,3,1,0,0,2
S01009746,Occupancy rating 0,21,6,3,3,13,0,10,3,5,2,3,1,2,2,1,0,0,1
S01009746,Occupancy rating -1 or less,4,0,0,0,4,0,4,1,3,0,0,0,0,0,0,0,0,0
S01009747,All households,344,150,57,93,183,20,130,73,46,11,33,22,11,11,4,0,0,7
S01009747,Occupancy rating +2 or more,99,33,15,18,63,10,51,38,11,2,2,1,1,3,1,0,0,2
S01009747,Occupancy rating +1,138,78,31,47,58,10,43,28,12,3,5,4,1,2,1,0,0,1
S01009747,Occupancy rating 0,88,36,10,26,48,0,27,5,17,5,21,14,7,4,1,0,0,3
S01009747,Occupancy rating -1 or less,19,3,1,2,14,0,9,2,6,1,5,3,2,2,1,0,0,1
S01009748,All households,299,61,30,31,229,34,172,89,61,22,23,13,10,9,4,0,2,3
S01009748,Occupancy rating +2 or more,164,29,14,15,131,24,102,61,32,9,5,3,2,4,1,0,2,1
S01009748,Occupancy rating +1,75,13,6,7,60,10,45,25,13,7,5,4,1,2,1,0,0,1
S01009748,Occupancy rating 0,50,17,10,7,32,0,23,3,15,5,9,3,6,1,1,0,0,0
S01009748,Occupancy rating -1 or less,10,2,0,2,6,0,2,0,1,1,4,3,1,2,1,0,0,1
S01009749,All households,425,126,65,61,281,41,207,92,79,36,33,15,18,18,7,0,2,9
S01009749,Occupancy rating +2 or more,229,49,29,20,170,33,125,68,38,19,12,4,8,10,2,0,2,6
S01009749,Occupancy rating +1,99,35,17,18,61,7,47,18,19,10,7,2,5,3,2,0,0,1
S01009749,Occupancy rating 0,72,28,15,13,41,1,27,5,16,6,13,8,5,3,1,0,0,2
S01009749,Occupancy rating -1 or less,25,14,4,10,9,0,8,1,6,1,1,1,0,2,2,0,0,0
S01009750,All households,311,109,54,55,194,25,137,56,60,21,32,22,10,8,3,0,1,4
S01009750,Occupancy rating +2 or more,133,48,20,28,84,14,66,39,18,9,4,4,0,1,0,0,0,1
S01009750,Occupancy rating +1,86,35,14,21,49,9,33,16,12,5,7,5,2,2,1,0,1,0
S01009750,Occupancy rating 0,65,10,8,2,52,1,34,1,27,6,17,9,8,3,1,0,0,2
S01009750,Occupancy rating -1 or less,27,16,12,4,9,1,4,0,3,1,4,4,0,2,1,0,0,1
S01009751,All households,355,123,46,77,220,14,154,79,56,19,52,30,22,12,4,0,0,8
S01009751,Occupancy rating +2 or more,119,31,13,18,88,6,72,50,16,6,10,5,5,0,0,0,0,0
S01009751,Occupancy rating +1,109,53,22,31,53,8,36,18,12,6,9,6,3,3,0,0,0,3
S01009751,Occupancy rating 0,92,30,11,19,58,0,39,10,23,6,19,10,9,4,1,0,0,3
S01009751,Occupancy rating -1 or less,35,9,0,9,21,0,7,1,5,1,14,9,5,5,3,0,0,2
S01009752,All households,260,71,39,32,179,37,128,58,52,18,14,9,5,10,3,1,0,6
S01009752,Occupancy rating +2 or more,188,36,19,17,147,31,105,53,38,14,11,7,4,5,0,0,0,5
S01009752,Occupancy rating +1,51,28,17,11,20,5,14,5,8,1,1,1,0,3,1,1,0,1
S01009752,Occupancy rating 0,17,6,3,3,11,1,8,0,6,2,2,1,1,0,0,0,0,0
S01009752,Occupancy rating -1 or less,4,1,0,1,1,0,1,0,0,1,0,0,0,2,2,0,0,0
S01009753,All households,333,130,99,31,192,36,138,65,59,14,18,10,8,11,6,0,1,4
S01009753,Occupancy rating +2 or more,164,37,19,18,122,21,91,50,33,8,10,7,3,5,2,0,1,2
S01009753,Occupancy rating +1,73,32,25,7,37,7,28,8,16,4,2,1,1,4,3,0,0,1
S01009753,Occupancy rating 0,84,52,47,5,31,8,18,7,9,2,5,2,3,1,0,0,0,1
S01009753,Occupancy rating -1 or less,12,9,8,1,2,0,1,0,1,0,1,0,1,1,1,0,0,0
S01009754,All households,383,138,58,80,233,43,157,82,67,8,33,25,8,12,1,1,1,9
S01009754,Occupancy rating +2 or more,189,49,30,19,135,31,98,54,38,6,6,3,3,5,1,0,1,3
S01009754,Occupancy rating +1,94,43,10,33,49,8,31,22,9,0,10,7,3,2,0,1,0,1
S01009754,Occupancy rating 0,79,38,16,22,37,4,23,5,17,1,10,9,1,4,0,0,0,4
S01009754,Occupancy rating -1 or less,21,8,2,6,12,0,5,1,3,1,7,6,1,1,0,0,0,1
S01009755,All households,281,76,37,39,195,24,143,60,65,18,28,21,7,10,4,0,1,5
S01009755,Occupancy rating +2 or more,156,41,20,21,108,21,82,41,34,7,5,5,0,7,1,0,1,5
S01009755,Occupancy rating +1,77,23,12,11,53,3,39,13,18,8,11,6,5,1,1,0,0,0
S01009755,Occupancy rating 0,38,10,4,6,28,0,20,5,12,3,8,7,1,0,0,0,0,0
S01009755,Occupancy rating -1 or less,10,2,1,1,6,0,2,1,1,0,4,3,1,2,2,0,0,0
S01009756,All households,320,80,38,42,233,40,166,76,71,19,27,13,14,7,4,0,1,2
S01009756,Occupancy rating +2 or more,218,53,28,25,161,33,120,63,43,14,8,3,5,4,2,0,1,1
S01009756,Occupancy rating +1,48,10,3,7,37,4,25,9,13,3,8,4,4,1,0,0,0,1
S01009756,Occupancy rating 0,44,14,7,7,30,2,18,4,12,2,10,6,4,0,0,0,0,0
S01009756,Occupancy rating -1 or less,10,3,0,3,5,1,3,0,3,0,1,0,1,2,2,0,0,0
S01009757,All households,271,48,23,25,212,41,152,70,69,13,19,14,5,11,2,1,3,5
S01009757,Occupancy rating +2 or more,219,39,20,19,174,39,127,63,57,7,8,4,4,6,2,0,3,1
S01009757,Occupancy rating +1,23,4,1,3,18,2,12,5,3,4,4,4,0,1,0,0,0,1
S01009757,Occupancy rating 0,23,5,2,3,15,0,11,2,8,1,4,3,1,3,0,0,0,3
S01009757,Occupancy rating -1 or less,6,0,0,0,5,0,2,0,1,1,3,3,0,1,0,1,0,0
S01009758,All households,242,82,10,72,150,13,114,46,45,23,23,17,6,10,4,1,1,4
S01009758,Occupancy rating +2 or more,71,13,4,9,57,6,48,25,15,8,3,2,1,1,1,0,0,0
S01009758,Occupancy rating +1,65,24,5,19,41,6,30,12,13,5,5,4,1,0,0,0,0,0
S01009758,Occupancy rating 0,83,41,1,40,38,0,28,9,14,5,10,6,4,4,0,1,1,2
S01009758,Occupancy rating -1 or less,23,4,0,4,14,1,8,0,3,5,5,5,0,5,3,0,0,2
S01009759,All households,417,145,22,123,251,11,113,29,65,19,127,100,27,21,11,2,0,8
S01009759,Occupancy rating +2 or more,22,16,3,13,6,1,5,3,2,0,0,0,0,0,0,0,0,0
S01009759,Occupancy rating +1,160,94,11,83,63,7,44,25,13,6,12,10,2,3,1,0,0,2
S01009759,Occupancy rating 0,163,22,6,16,133,2,47,0,36,11,84,62,22,8,3,1,0,4
S01009759,Occupancy rating -1 or less,72,13,2,11,49,1,17,1,14,2,31,28,3,10,7,1,0,2
S01009760,All households,407,138,46,92,245,23,104,34,53,17,118,77,41,24,10,4,2,8
S01009760,Occupancy rating +2 or more,55,28,5,23,27,4,16,11,4,1,7,3,4,0,0,0,0,0
S01009760,Occupancy rating +1,163,88,33,55,74,14,35,20,10,5,25,15,10,1,0,0,0,1
S01009760,Occupancy rating 0,137,16,5,11,110,4,34,3,24,7,72,49,23,11,4,1,1,5
S01009760,Occupancy rating -1 or less,52,6,3,3,34,1,19,0,15,4,14,10,4,12,6,3,1,2
S01009761,All households,377,106,27,79,256,23,180,74,71,35,53,32,21,15,8,1,1,5
S01009761,Occupancy rating +2 or more,120,30,12,18,86,16,55,30,14,11,15,6,9,4,2,0,0,2
S01009761,Occupancy rating +1,105,29,5,24,74,6,60,30,17,13,8,5,3,2,1,0,0,1
S01009761,Occupancy rating 0,120,44,9,35,72,0,50,13,28,9,22,14,8,4,2,0,1,1
S01009761,Occupancy rating -1 or less,32,3,1,2,24,1,15,1,12,2,8,7,1,5,3,1,0,1
S01009762,All households,416,155,45,110,222,4,122,35,61,26,96,60,36,39,18,8,0,13
S01009762,Occupancy rating +2 or more,46,21,3,18,25,3,19,10,4,5,3,3,0,0,0,0,0,0
S01009762,Occupancy rating +1,151,93,23,70,56,1,37,18,13,6,18,11,7,2,0,0,0,2
S01009762,Occupancy rating 0,154,29,16,13,105,0,51,5,38,8,54,30,24,20,9,2,0,9
S01009762,Occupancy rating -1 or less,65,12,3,9,36,0,15,2,6,7,21,16,5,17,9,6,0,2
S01009763,All households,264,52,10,42,191,13,156,42,84,30,22,18,4,21,14,2,0,5
S01009763,Occupancy rating +2 or more,168,23,3,20,136,9,111,25,63,23,16,14,2,9,7,0,0,2
S01009763,Occupancy rating +1,39,13,6,7,23,4,19,12,3,4,0,0,0,3,1,0,0,2
S01009763,Occupancy rating 0,36,13,1,12,20,0,16,4,10,2,4,3,1,3,3,0,0,0
S01009763,Occupancy rating -1 or less,21,3,0,3,12,0,10,1,8,1,2,1,1,6,3,2,0,1
S01009764,All households,291,109,24,85,160,3,102,31,59,12,55,42,13,22,16,1,0,5
S01009764,Occupancy rating +2 or more,46,11,1,10,30,1,23,17,5,1,6,5,1,5,5,0,0,0
S01009764,Occupancy rating +1,87,40,12,28,46,2,35,10,22,3,9,5,4,1,1,0,0,0
S01009764,Occupancy rating 0,113,48,7,41,56,0,33,2,26,5,23,17,6,9,6,0,0,3
S01009764,Occupancy rating -1 or less,45,10,4,6,28,0,11,2,6,3,17,15,2,7,4,1,0,2
S01009765,All households,382,118,54,64,248,13,168,42,102,24,67,43,24,16,10,0,0,6
S01009765,Occupancy rating +2 or more,61,15,1,14,42,4,34,12,20,2,4,4,0,4,1,0,0,3
S01009765,Occupancy rating +1,109,31,5,26,77,2,54,21,22,11,21,12,9,1,0,0,0,1
S01009765,Occupancy rating 0,160,63,41,22,94,4,60,7,43,10,30,21,9,3,2,0,0,1
S01009765,Occupancy rating -1 or less,52,9,7,2,35,3,20,2,17,1,12,6,6,8,7,0,0,1
S01009766,All households,231,57,17,40,165,8,129,47,61,21,28,24,4,9,4,3,0,2
S01009766,Occupancy rating +2 or more,65,18,7,11,46,3,41,23,15,3,2,1,1,1,1,0,0,0
S01009766,Occupancy rating +1,74,28,7,21,46,3,36,17,13,6,7,6,1,0,0,0,0,0
S01009766,Occupancy rating 0,65,9,1,8,54,2,40,5,25,10,12,12,0,2,0,0,0,2
S01009766,Occupancy rating -1 or less,27,2,2,0,19,0,12,2,8,2,7,5,2,6,3,3,0,0
S01009767,All households,227,86,31,55,127,10,78,26,26,26,39,27,12,14,5,0,1,8
S01009767,Occupancy rating +2 or more,48,18,5,13,29,3,23,9,3,11,3,1,2,1,0,0,0,1
S01009767,Occupancy rating +1,58,23,9,14,34,1,27,12,9,6,6,5,1,1,0,0,0,1
S01009767,Occupancy rating 0,94,38,17,21,50,3,21,5,9,7,26,18,8,6,2,0,0,4
S01009767,Occupancy rating -1 or less,27,7,0,7,14,3,7,0,5,2,4,3,1,6,3,0,1,2
S01009768,All households,279,96,16,80,170,2,111,37,61,13,57,44,13,13,6,0,1,6
S01009768,Occupancy rating +2 or more,38,6,0,6,32,0,28,15,11,2,4,3,1,0,0,0,0,0
S01009768,Occupancy rating +1,98,48,8,40,49,1,44,17,25,2,4,4,0,1,0,0,0,1
S01009768,Occupancy rating 0,85,19,5,14,61,1,25,3,17,5,35,25,10,5,2,0,0,3
S01009768,Occupancy rating -1 or less,58,23,3,20,28,0,14,2,8,4,14,12,2,7,4,0,1,2
S01009769,All households,249,59,4,55,180,3,146,63,69,14,31,25,6,10,5,0,0,5
S01009769,Occupancy rating +2 or more,66,17,1,16,48,1,45,25,19,1,2,1,1,1,0,0,0,1
S01009769,Occupancy rating +1,94,29,2,27,63,1,58,32,19,7,4,3,1,2,1,0,0,1
S01009769,Occupancy rating 0,68,12,1,11,53,1,35,6,24,5,17,15,2,3,1,0,0,2
S01009769,Occupancy rating -1 or less,21,1,0,1,16,0,8,0,7,1,8,6,2,4,3,0,0,1
S01009770,All households,257,47,12,35,193,13,149,57,74,18,31,20,11,17,12,1,0,4
S01009770,Occupancy rating +2 or more,99,14,5,9,82,6,68,33,30,5,8,4,4,3,1,0,0,2
S01009770,Occupancy rating +1,69,15,3,12,51,6,40,17,15,8,5,2,3,3,3,0,0,0
S01009770,Occupancy rating 0,62,16,4,12,41,0,27,6,17,4,14,11,3,5,4,0,0,1
S01009770,Occupancy rating -1 or less,27,2,0,2,19,1,14,1,12,1,4,3,1,6,4,1,0,1
S01009771,All households,294,52,19,33,224,6,190,51,106,33,28,21,7,18,12,1,0,5
S01009771,Occupancy rating +2 or more,149,29,8,21,113,4,100,46,40,14,9,8,1,7,3,0,0,4
S01009771,Occupancy rating +1,91,20,9,11,67,2,57,4,39,14,8,3,5,4,4,0,0,0
S01009771,Occupancy rating 0,37,3,2,1,32,0,22,1,18,3,10,9,1,2,2,0,0,0
S01009771,Occupancy rating -1 or less,17,0,0,0,12,0,11,0,9,2,1,1,0,5,3,1,0,1
S01009772,All households,271,87,21,66,170,12,128,41,69,18,30,22,8,14,8,2,0,4
S01009772,Occupancy rating +2 or more,57,8,1,7,47,4,38,17,17,4,5,3,2,2,2,0,0,0
S01009772,Occupancy rating +1,80,38,9,29,42,3,33,9,17,7,6,2,4,0,0,0,0,0
S01009772,Occupancy rating 0,95,31,11,20,58,4,40,13,23,4,14,12,2,6,3,0,0,3
S01009772,Occupancy rating -1 or less,39,10,0,10,23,1,17,2,12,3,5,5,0,6,3,2,0,1
S01009773,All households,179,13,1,12,152,0,141,32,95,14,11,6,5,14,8,3,0,3
S01009773,Occupancy rating +2 or more,128,8,0,8,116,0,107,21,74,12,9,5,4,4,1,1,0,2
S01009773,Occupancy rating +1,16,2,1,1,13,0,13,5,8,0,0,0,0,1,1,0,0,0
S01009773,Occupancy rating 0,20,0,0,0,13,0,11,4,6,1,2,1,1,7,5,1,0,1
S01009773,Occupancy rating -1 or less,15,3,0,3,10,0,10,2,7,1,0,0,0,2,1,1,0,0
S01009774,All households,151,6,1,5,130,0,115,16,94,5,15,12,3,15,11,0,0,4
S01009774,Occupancy rating +2 or more,116,4,0,4,106,0,96,15,77,4,10,9,1,6,3,0,0,3
S01009774,Occupancy rating +1,12,1,1,0,8,0,7,1,6,0,1,0,1,3,2,0,0,1
S01009774,Occupancy rating 0,14,1,0,1,9,0,6,0,5,1,3,2,1,4,4,0,0,0
S01009774,Occupancy rating -1 or less,9,0,0,0,7,0,6,0,6,0,1,1,0,2,2,0,0,0
S01009775,All households,359,135,60,75,182,16,87,27,35,25,79,39,40,42,19,8,0,15
S01009775,Occupancy rating +2 or more,90,57,21,36,31,8,16,14,2,0,7,5,2,2,1,0,0,1
S01009775,Occupancy rating +1,108,42,18,24,55,7,25,6,10,9,23,7,16,11,1,3,0,7
S01009775,Occupancy rating 0,94,18,9,9,60,1,30,5,11,14,29,12,17,16,7,4,0,5
S01009775,Occupancy rating -1 or less,67,18,12,6,36,0,16,2,12,2,20,15,5,13,10,1,0,2
S01009776,All households,307,112,25,87,186,9,58,19,24,15,119,95,24,9,4,1,0,4
S01009776,Occupancy rating +2 or more,28,15,5,10,13,3,7,5,1,1,3,0,3,0,0,0,0,0
S01009776,Occupancy rating +1,103,67,17,50,36,2,19,11,5,3,15,10,5,0,0,0,0,0
S01009776,Occupancy rating 0,116,18,0,18,92,3,22,2,10,10,67,55,12,6,3,1,0,2
S01009776,Occupancy rating -1 or less,60,12,3,9,45,1,10,1,8,1,34,30,4,3,1,0,0,2
S01009777,All households,266,137,32,105,112,3,61,29,24,8,48,42,6,17,8,1,1,7
S01009777,Occupancy rating +2 or more,29,17,8,9,12,0,11,9,1,1,1,0,1,0,0,0,0,0
S01009777,Occupancy rating +1,68,35,9,26,32,2,19,12,5,2,11,9,2,1,0,0,0,1
S01009777,Occupancy rating 0,119,65,11,54,47,1,26,8,16,2,20,17,3,7,2,1,1,3
S01009777,Occupancy rating -1 or less,50,20,4,16,21,0,5,0,2,3,16,16,0,9,6,0,0,3
S01009778,All households,415,183,90,93,203,35,103,44,35,24,65,31,34,29,10,3,2,14
S01009778,Occupancy rating +2 or more,80,35,16,19,41,9,28,21,5,2,4,2,2,4,1,0,0,3
S01009778,Occupancy rating +1,123,58,27,31,56,14,22,7,7,8,20,7,13,9,1,0,2,6
S01009778,Occupancy rating 0,133,66,35,31,62,9,32,12,14,6,21,11,10,5,4,0,0,1
S01009778,Occupancy rating -1 or less,79,24,12,12,44,3,21,4,9,8,20,11,9,11,4,3,0,4
S01009779,All households,290,133,85,48,138,7,71,42,20,9,60,45,15,19,10,2,1,6
S01009779,Occupancy rating +2 or more,46,17,9,8,28,1,23,18,4,1,4,4,0,1,0,1,0,0
S01009779,Occupancy rating +1,74,36,17,19,35,2,27,19,4,4,6,4,2,3,0,0,0,3
S01009779,Occupancy rating 0,122,65,48,17,53,4,18,5,9,4,31,22,9,4,2,0,1,1
S01009779,Occupancy rating -1 or less,48,15,11,4,22,0,3,0,3,0,19,15,4,11,8,1,0,2
S01009780,All households,219,45,9,36,151,2,74,24,31,19,75,56,19,23,18,1,0,4
S01009780,Occupancy rating +2 or more,47,15,1,14,27,0,19,7,3,9,8,5,3,5,2,0,0,3
S01009780,Occupancy rating +1,60,14,1,13,42,1,19,10,4,5,22,17,5,4,4,0,0,0
S01009780,Occupancy rating 0,73,13,5,8,56,1,27,5,18,4,28,22,6,4,3,0,0,1
S01009780,Occupancy rating -1 or less,39,3,2,1,26,0,9,2,6,1,17,12,5,10,9,1,0,0
S01009781,All households,224,61,30,31,137,11,61,14,21,26,65,37,28,26,15,2,0,9
S01009781,Occupancy rating +2 or more,67,36,11,25,30,6,17,12,5,0,7,6,1,1,1,0,0,0
S01009781,Occupancy rating +1,63,6,4,2,50,2,23,1,8,14,25,8,17,7,2,0,0,5
S01009781,Occupancy rating 0,64,14,10,4,43,3,15,1,6,8,25,19,6,7,4,2,0,1
S01009781,Occupancy rating -1 or less,30,5,5,0,14,0,6,0,2,4,8,4,4,11,8,0,0,3
S01009782,All households,200,32,3,29,152,1,101,26,61,14,50,39,11,16,11,1,0,4
S01009782,Occupancy rating +2 or more,49,17,3,14,31,0,21,12,8,1,10,5,5,1,0,0,0,1
S01009782,Occupancy rating +1,67,6,0,6,59,1,49,13,28,8,9,6,3,2,1,0,0,1
S01009782,Occupancy rating 0,48,6,0,6,37,0,21,1,18,2,16,13,3,5,4,0,0,1
S01009782,Occupancy rating -1 or less,36,3,0,3,25,0,10,0,7,3,15,15,0,8,6,1,0,1
S01009783,All households,310,87,24,63,212,7,116,41,51,24,89,56,33,11,8,0,0,3
S01009783,Occupancy rating +2 or more,42,16,5,11,25,1,17,14,1,2,7,2,5,1,1,0,0,0
S01009783,Occupancy rating +1,82,34,6,28,45,2,38,18,14,6,5,3,2,3,2,0,0,1
S01009783,Occupancy rating 0,124,28,11,17,93,3,37,6,21,10,53,33,20,3,2,0,0,1
S01009783,Occupancy rating -1 or less,62,9,2,7,49,1,24,3,15,6,24,18,6,4,3,0,0,1
S01009784,All households,309,102,34,68,183,14,89,17,51,21,80,49,31,24,11,3,1,9
S01009784,Occupancy rating +2 or more,86,52,16,36,34,8,15,11,4,0,11,4,7,0,0,0,0,0
S01009784,Occupancy rating +1,83,21,8,13,56,2,31,3,17,11,23,16,7,6,2,1,1,2
S01009784,Occupancy rating 0,99,26,10,16,68,4,28,2,20,6,36,22,14,5,4,1,0,0
S01009784,Occupancy rating -1 or less,41,3,0,3,25,0,15,1,10,4,10,7,3,13,5,1,0,7
S01009785,All households,339,101,40,61,200,19,86,30,32,24,95,50,45,38,16,0,0,22
S01009785,Occupancy rating +2 or more,91,47,17,30,42,10,26,19,4,3,6,2,4,2,1,0,0,1
S01009785,Occupancy rating +1,97,25,11,14,60,6,28,8,7,13,26,13,13,12,2,0,0,10
S01009785,Occupancy rating 0,114,25,10,15,72,2,21,2,17,2,49,25,24,17,7,0,0,10
S01009785,Occupancy rating -1 or less,37,4,2,2,26,1,11,1,4,6,14,10,4,7,6,0,0,1
S01009786,All households,425,176,60,116,216,10,87,30,39,18,119,90,29,33,17,0,2,14
S01009786,Occupancy rating +2 or more,74,44,20,24,27,6,20,15,3,2,1,1,0,3,1,0,1,1
S01009786,Occupancy rating +1,133,68,24,44,58,1,21,8,6,7,36,23,13,7,1,0,0,6
S01009786,Occupancy rating 0,131,35,14,21,82,2,21,3,15,3,59,46,13,14,9,0,1,4
S01009786,Occupancy rating -1 or less,87,29,2,27,49,1,25,4,15,6,23,20,3,9,6,0,0,3
S01009787,All households,366,110,54,56,216,24,97,43,31,23,95,55,40,40,23,1,2,14
S01009787,Occupancy rating +2 or more,85,47,21,26,36,7,26,22,2,2,3,1,2,2,0,0,0,2
S01009787,Occupancy rating +1,120,39,19,20,70,11,30,14,5,11,29,13,16,11,3,0,0,8
S01009787,Occupancy rating 0,101,16,9,7,75,6,26,6,13,7,43,26,17,10,6,0,1,3
S01009787,Occupancy rating -1 or less,60,8,5,3,35,0,15,1,11,3,20,15,5,17,14,1,1,1
S01009788,All households,404,166,104,62,209,34,109,45,42,22,66,32,34,29,19,0,0,10
S01009788,Occupancy rating +2 or more,144,84,51,33,58,18,32,25,2,5,8,2,6,2,1,0,0,1
S01009788,Occupancy rating +1,149,62,41,21,82,14,41,15,15,11,27,15,12,5,2,0,0,3
S01009788,Occupancy rating 0,83,16,9,7,56,2,28,5,17,6,26,13,13,11,6,0,0,5
S01009788,Occupancy rating -1 or less,28,4,3,1,13,0,8,0,8,0,5,2,3,11,10,0,0,1
S01009789,All households,399,138,79,59,221,23,121,45,45,31,77,36,41,40,16,2,2,20
S01009789,Occupancy rating +2 or more,105,57,27,30,47,10,34,24,6,4,3,0,3,1,0,0,0,1
S01009789,Occupancy rating +1,148,63,42,21,72,8,39,17,9,13,25,8,17,13,1,1,0,11
S01009789,Occupancy rating 0,103,13,6,7,75,4,35,2,22,11,36,20,16,15,5,1,2,7
S01009789,Occupancy rating -1 or less,43,5,4,1,27,1,13,2,8,3,13,8,5,11,10,0,0,1
S01009790,All households,259,80,41,39,156,11,84,27,35,22,61,31,30,23,9,0,3,11
S01009790,Occupancy rating +2 or more,71,45,23,22,25,6,16,12,2,2,3,1,2,1,0,0,0,1
S01009790,Occupancy rating +1,92,26,13,13,59,4,31,14,10,7,24,13,11,7,1,0,1,5
S01009790,Occupancy rating 0,63,6,3,3,49,1,23,1,14,8,25,11,14,8,2,0,2,4
S01009790,Occupancy rating -1 or less,33,3,2,1,23,0,14,0,9,5,9,6,3,7,6,0,0,1
S01009791,All households,281,90,41,49,171,17,83,27,33,23,71,45,26,20,10,2,1,7
S01009791,Occupancy rating +2 or more,75,42,22,20,32,8,18,15,2,1,6,3,3,1,0,0,0,1
S01009791,Occupancy rating +1,94,35,13,22,55,8,27,10,8,9,20,12,8,4,1,0,1,2
S01009791,Occupancy rating 0,74,9,4,5,58,1,24,0,15,9,33,20,13,7,3,2,0,2
S01009791,Occupancy rating -1 or less,38,4,2,2,26,0,14,2,8,4,12,10,2,8,6,0,0,2
S01009792,All households,323,55,0,55,244,6,210,66,117,27,28,20,8,24,11,5,0,8
S01009792,Occupancy rating +2 or more,197,29,0,29,161,5,145,53,73,19,11,7,4,7,3,0,0,4
S01009792,Occupancy rating +1,69,17,0,17,49,1,41,11,25,5,7,4,3,3,1,0,0,2
S01009792,Occupancy rating 0,38,6,0,6,24,0,16,1,13,2,8,7,1,8,3,4,0,1
S01009792,Occupancy rating -1 or less,19,3,0,3,10,0,8,1,6,1,2,2,0,6,4,1,0,1
S01009793,All households,416,151,64,87,242,39,165,71,66,28,38,15,23,23,7,4,0,12
S01009793,Occupancy rating +2 or more,114,27,20,7,82,20,56,26,18,12,6,1,5,5,2,0,0,3
S01009793,Occupancy rating +1,152,80,34,46,69,15,49,35,10,4,5,1,4,3,1,0,0,2
S01009793,Occupancy rating 0,103,22,4,18,68,3,47,3,33,11,18,7,11,13,2,4,0,7
S01009793,Occupancy rating -1 or less,47,22,6,16,23,1,13,7,5,1,9,6,3,2,2,0,0,0
S01009794,All households,199,41,10,31,151,2,140,50,74,16,9,5,4,7,5,0,1,1
S01009794,Occupancy rating +2 or more,114,19,4,15,95,2,89,34,47,8,4,1,3,0,0,0,0,0
S01009794,Occupancy rating +1,69,21,6,15,45,0,42,14,21,7,3,2,1,3,1,0,1,1
S01009794,Occupancy rating 0,10,0,0,0,8,0,7,2,4,1,1,1,0,2,2,0,0,0
S01009794,Occupancy rating -1 or less,6,1,0,1,3,0,2,0,2,0,1,1,0,2,2,0,0,0
S01009795,All households,287,42,12,30,233,6,198,59,101,38,29,16,13,12,7,1,0,4
S01009795,Occupancy rating +2 or more,203,32,10,22,165,4,145,50,70,25,16,10,6,6,3,0,0,3
S01009795,Occupancy rating +1,59,9,2,7,46,2,38,7,21,10,6,4,2,4,2,1,0,1
S01009795,Occupancy rating 0,17,1,0,1,14,0,10,1,6,3,4,0,4,2,2,0,0,0
S01009795,Occupancy rating -1 or less,8,0,0,0,8,0,5,1,4,0,3,2,1,0,0,0,0,0
S01009796,All households,310,88,55,33,212,21,174,68,75,31,17,8,9,10,6,0,1,3
S01009796,Occupancy rating +2 or more,132,14,8,6,115,6,105,42,51,12,4,2,2,3,2,0,0,1
S01009796,Occupancy rating +1,93,43,23,20,48,5,40,19,11,10,3,2,1,2,2,0,0,0
S01009796,Occupancy rating 0,60,25,21,4,33,8,19,6,6,7,6,2,4,2,0,0,1,1
S01009796,Occupancy rating -1 or less,25,6,3,3,16,2,10,1,7,2,4,2,2,3,2,0,0,1
S01009797,All households,306,75,28,47,214,18,158,54,75,29,38,20,18,17,6,2,0,9
S01009797,Occupancy rating +2 or more,133,36,17,19,93,9,75,39,25,11,9,5,4,4,1,0,0,3
S01009797,Occupancy rating +1,104,23,8,15,74,5,55,14,29,12,14,8,6,7,3,0,0,4
S01009797,Occupancy rating 0,52,15,3,12,35,3,20,1,15,4,12,6,6,2,1,0,0,1
S01009797,Occupancy rating -1 or less,17,1,0,1,12,1,8,0,6,2,3,1,2,4,1,2,0,1
S01009798,All households,255,43,18,25,198,9,168,47,100,21,21,14,7,14,7,1,0,6
S01009798,Occupancy rating +2 or more,139,26,9,17,110,7,99,41,48,10,4,2,2,3,2,0,0,1
S01009798,Occupancy rating +1,72,15,9,6,53,1,44,6,31,7,8,4,4,4,2,0,0,2
S01009798,Occupancy rating 0,34,2,0,2,27,1,19,0,18,1,7,6,1,5,2,1,0,2
S01009798,Occupancy rating -1 or less,10,0,0,0,8,0,6,0,3,3,2,2,0,2,1,0,0,1
S01009799,All households,363,139,66,73,188,13,81,17,38,26,94,60,34,36,20,0,1,15
S01009799,Occupancy rating +2 or more,75,34,13,21,34,7,20,11,2,7,7,2,5,7,0,0,0,7
S01009799,Occupancy rating +1,84,26,9,17,52,1,22,4,11,7,29,19,10,6,3,0,0,3
S01009799,Occupancy rating 0,145,65,34,31,69,3,31,2,18,11,35,24,11,11,7,0,0,4
S01009799,Occupancy rating -1 or less,59,14,10,4,33,2,8,0,7,1,23,15,8,12,10,0,1,1
S01009800,All households,424,92,34,58,298,23,165,61,73,31,110,79,31,34,15,0,1,18
S01009800,Occupancy rating +2 or more,114,47,23,24,66,14,45,31,9,5,7,3,4,1,0,0,0,1
S01009800,Occupancy rating +1,124,25,5,20,88,4,52,24,16,12,32,19,13,11,2,0,1,8
S01009800,Occupancy rating 0,127,16,4,12,100,4,47,6,31,10,49,39,10,11,6,0,0,5
S01009800,Occupancy rating -1 or less,59,4,2,2,44,1,21,0,17,4,22,18,4,11,7,0,0,4
S01009801,All households,344,93,41,52,207,21,103,33,43,27,83,54,29,44,25,2,1,16
S01009801,Occupancy rating +2 or more,132,65,28,37,61,17,39,27,6,6,5,1,4,6,2,0,1,3
S01009801,Occupancy rating +1,95,21,9,12,62,3,27,4,13,10,32,14,18,12,4,2,0,6
S01009801,Occupancy rating 0,86,7,4,3,64,1,30,2,19,9,33,28,5,15,10,0,0,5
S01009801,Occupancy rating -1 or less,31,0,0,0,20,0,7,0,5,2,13,11,2,11,9,0,0,2
S01009802,All households,431,133,40,93,277,16,151,53,82,16,110,73,37,21,10,0,0,11
S01009802,Occupancy rating +2 or more,82,37,12,25,44,5,34,27,7,0,5,5,0,1,0,0,0,1
S01009802,Occupancy rating +1,150,60,19,41,86,10,51,22,24,5,25,16,9,4,2,0,0,2
S01009802,Occupancy rating 0,149,31,5,26,111,0,50,4,39,7,61,40,21,7,3,0,0,4
S01009802,Occupancy rating -1 or less,50,5,4,1,36,1,16,0,12,4,19,12,7,9,5,0,0,4
S01009803,All households,371,157,92,65,181,10,98,35,46,17,73,47,26,33,13,10,0,10
S01009803,Occupancy rating +2 or more,93,55,23,32,37,9,25,23,1,1,3,0,3,1,0,0,0,1
S01009803,Occupancy rating +1,101,21,7,14,69,1,38,10,21,7,30,18,12,11,1,5,0,5
S01009803,Occupancy rating 0,98,31,20,11,55,0,24,2,14,8,31,25,6,12,6,4,0,2
S01009803,Occupancy rating -1 or less,79,50,42,8,20,0,11,0,10,1,9,4,5,9,6,1,0,2
S01009804,All households,208,90,12,78,108,1,84,46,33,5,23,16,7,10,1,1,1,7
S01009804,Occupancy rating +2 or more,56,25,6,19,30,0,29,16,13,0,1,1,0,1,0,0,1,0
S01009804,Occupancy rating +1,46,24,3,21,22,1,21,15,4,2,0,0,0,0,0,0,0,0
S01009804,Occupancy rating 0,76,30,1,29,40,0,23,15,6,2,17,10,7,6,0,0,0,6
S01009804,Occupancy rating -1 or less,30,11,2,9,16,0,11,0,10,1,5,5,0,3,1,1,0,1
S01009805,All households,374,104,45,59,222,14,120,37,56,27,88,59,29,48,23,5,3,17
S01009805,Occupancy rating +2 or more,108,52,32,20,50,10,37,24,4,9,3,1,2,6,2,0,1,3
S01009805,Occupancy rating +1,117,36,7,29,72,4,42,11,23,8,26,17,9,9,2,1,1,5
S01009805,Occupancy rating 0,107,11,4,7,75,0,39,2,27,10,36,27,9,21,11,3,0,7
S01009805,Occupancy rating -1 or less,42,5,2,3,25,0,2,0,2,0,23,14,9,12,8,1,1,2
S01009806,All households,446,229,112,117,191,26,103,39,44,20,62,29,33,26,9,0,4,13
S01009806,Occupancy rating +2 or more,78,43,18,25,33,5,25,23,0,2,3,1,2,2,0,0,1,1
S01009806,Occupancy rating +1,163,77,40,37,76,15,38,10,19,9,23,8,15,10,1,0,1,8
S01009806,Occupancy rating 0,109,37,20,17,66,5,32,5,20,7,29,16,13,6,3,0,0,3
S01009806,Occupancy rating -1 or less,96,72,34,38,16,1,8,1,5,2,7,4,3,8,5,0,2,1
S01009807,All households,461,173,67,106,268,20,165,53,81,31,83,56,27,20,6,3,2,9
S01009807,Occupancy rating +2 or more,102,53,19,34,48,7,38,32,3,3,3,0,3,1,1,0,0,0
S01009807,Occupancy rating +1,139,42,17,25,96,10,60,18,28,14,26,14,12,1,0,1,0,0
S01009807,Occupancy rating 0,166,62,27,35,91,2,55,3,40,12,34,22,12,13,3,2,1,7
S01009807,Occupancy rating -1 or less,54,16,4,12,33,1,12,0,10,2,20,20,0,5,2,0,1,2
S01009808,All households,428,189,27,162,218,13,109,22,69,18,96,73,23,21,7,2,0,12
S01009808,Occupancy rating +2 or more,59,27,9,18,28,6,19,14,4,1,3,1,2,4,2,0,0,2
S01009808,Occupancy rating +1,108,63,11,52,44,4,20,3,11,6,20,14,6,1,0,0,0,1
S01009808,Occupancy rating 0,181,71,6,65,100,3,45,5,32,8,52,39,13,10,0,2,0,8
S01009808,Occupancy rating -1 or less,80,28,1,27,46,0,25,0,22,3,21,19,2,6,5,0,0,1
S01009809,All households,338,137,49,88,192,15,112,48,41,23,65,40,25,9,5,0,0,4
S01009809,Occupancy rating +2 or more,84,36,12,24,48,7,39,30,6,3,2,0,2,0,0,0,0,0
S01009809,Occupancy rating +1,116,60,23,37,53,5,33,14,11,8,15,7,8,3,0,0,0,3
S01009809,Occupancy rating 0,87,20,7,13,66,2,29,2,16,11,35,25,10,1,1,0,0,0
S01009809,Occupancy rating -1 or less,51,21,7,14,25,1,11,2,8,1,13,8,5,5,4,0,0,1
S01009810,All households,453,226,85,141,197,15,100,43,44,13,82,65,17,30,9,2,3,16
S01009810,Occupancy rating +2 or more,47,15,8,7,29,5,19,13,3,3,5,1,4,3,0,0,0,3
S01009810,Occupancy rating +1,168,111,43,68,53,10,31,21,9,1,12,9,3,4,1,0,0,3
S01009810,Occupancy rating 0,173,78,28,50,81,0,29,8,16,5,52,44,8,14,3,2,1,8
S01009810,Occupancy rating -1 or less,65,22,6,16,34,0,21,1,16,4,13,11,2,9,5,0,2,2
S01009811,All households,520,221,96,125,265,34,129,55,45,29,102,54,48,34,12,0,6,16
S01009811,Occupancy rating +2 or more,104,58,32,26,43,16,19,17,0,2,8,3,5,3,1,0,0,2
S01009811,Occupancy rating +1,183,94,41,53,82,11,50,27,10,13,21,7,14,7,2,0,2,3
S01009811,Occupancy rating 0,167,58,20,38,97,3,42,9,24,9,52,30,22,12,3,0,3,6
S01009811,Occupancy rating -1 or less,66,11,3,8,43,4,18,2,11,5,21,14,7,12,6,0,1,5
S01009812,All households,376,164,75,89,200,26,104,42,43,19,70,32,38,12,6,0,2,4
S01009812,Occupancy rating +2 or more,106,64,30,34,42,12,27,21,3,3,3,1,2,0,0,0,0,0
S01009812,Occupancy rating +1,147,63,35,28,83,12,43,20,17,6,28,11,17,1,0,0,0,1
S01009812,Occupancy rating 0,99,35,9,26,57,2,25,1,15,9,30,13,17,7,4,0,1,2
S01009812,Occupancy rating -1 or less,24,2,1,1,18,0,9,0,8,1,9,7,2,4,2,0,1,1
S01009813,All households,335,164,77,87,152,7,77,17,47,13,68,45,23,19,10,0,1,8
S01009813,Occupancy rating +2 or more,62,43,16,27,17,4,11,8,1,2,2,1,1,2,1,0,0,1
S01009813,Occupancy rating +1,52,9,4,5,42,0,12,1,3,8,30,16,14,1,0,0,0,1
S01009813,Occupancy rating 0,166,98,50,48,60,3,32,7,23,2,25,20,5,8,4,0,0,4
S01009813,Occupancy rating -1 or less,55,14,7,7,33,0,22,1,20,1,11,8,3,8,5,0,1,2
S01009814,All households,362,132,63,69,207,31,129,31,62,36,47,30,17,23,10,0,0,13
S01009814,Occupancy rating +2 or more,137,51,28,23,80,20,55,18,22,15,5,1,4,6,1,0,0,5
S01009814,Occupancy rating +1,113,48,13,35,58,10,41,13,17,11,7,3,4,7,3,0,0,4
S01009814,Occupancy rating 0,64,18,11,7,42,1,20,0,14,6,21,17,4,4,2,0,0,2
S01009814,Occupancy rating -1 or less,48,15,11,4,27,0,13,0,9,4,14,9,5,6,4,0,0,2
S01009815,All households,346,140,55,85,186,12,116,50,46,20,58,41,17,20,7,3,1,9
S01009815,Occupancy rating +2 or more,85,48,21,27,37,4,30,27,2,1,3,1,2,0,0,0,0,0
S01009815,Occupancy rating +1,111,33,14,19,73,6,46,20,17,9,21,17,4,5,0,2,0,3
S01009815,Occupancy rating 0,76,11,5,6,54,2,25,2,16,7,27,19,8,11,5,1,1,4
S01009815,Occupancy rating -1 or less,74,48,15,33,22,0,15,1,11,3,7,4,3,4,2,0,0,2
S01009816,All households,326,110,36,74,199,20,127,58,57,12,52,33,19,17,8,0,1,8
S01009816,Occupancy rating +2 or more,96,48,17,31,46,10,35,30,3,2,1,1,0,2,1,0,0,1
S01009816,Occupancy rating +1,135,51,17,34,81,8,49,22,21,6,24,14,10,3,0,0,1,2
S01009816,Occupancy rating 0,64,7,2,5,49,2,30,3,23,4,17,10,7,8,5,0,0,3
S01009816,Occupancy rating -1 or less,31,4,0,4,23,0,13,3,10,0,10,8,2,4,2,0,0,2
S01009817,All households,343,158,84,74,165,22,96,38,35,23,47,31,16,20,9,0,2,9
S01009817,Occupancy rating +2 or more,99,50,30,20,48,11,34,25,6,3,3,1,2,1,0,0,0,1
S01009817,Occupancy rating +1,78,18,11,7,52,4,29,4,12,13,19,9,10,8,1,0,1,6
S01009817,Occupancy rating 0,136,80,40,40,48,5,25,6,13,6,18,16,2,8,5,0,1,2
S01009817,Occupancy rating -1 or less,30,10,3,7,17,2,8,3,4,1,7,5,2,3,3,0,0,0
S01009818,All households,421,130,83,47,265,78,155,65,41,49,32,10,22,26,8,0,2,16
S01009818,Occupancy rating +2 or more,258,74,49,25,181,67,96,53,14,29,18,3,15,3,0,0,0,3
S01009818,Occupancy rating +1,108,40,24,16,55,11,34,11,10,13,10,4,6,13,4,0,2,7
S01009818,Occupancy rating 0,39,14,8,6,19,0,15,1,10,4,4,3,1,6,4,0,0,2
S01009818,Occupancy rating -1 or less,16,2,2,0,10,0,10,0,7,3,0,0,0,4,0,0,0,4
S01009819,All households,306,134,66,68,161,30,98,38,36,24,33,19,14,11,2,1,2,6
S01009819,Occupancy rating +2 or more,146,52,27,25,94,26,57,32,16,9,11,5,6,0,0,0,0,0
S01009819,Occupancy rating +1,57,17,12,5,38,4,27,6,12,9,7,3,4,2,0,0,0,2
S01009819,Occupancy rating 0,43,17,11,6,20,0,12,0,7,5,8,6,2,6,2,1,1,2
S01009819,Occupancy rating -1 or less,60,48,16,32,9,0,2,0,1,1,7,5,2,3,0,0,1,2
S01009820,All households,445,186,100,86,234,31,141,47,61,33,62,31,31,25,15,0,3,7
S01009820,Occupancy rating +2 or more,183,79,55,24,101,23,70,37,21,12,8,1,7,3,1,0,2,0
S01009820,Occupancy rating +1,115,40,18,22,67,4,43,8,22,13,20,6,14,8,5,0,1,2
S01009820,Occupancy rating 0,77,26,12,14,44,3,18,2,11,5,23,18,5,7,4,0,0,3
S01009820,Occupancy rating -1 or less,70,41,15,26,22,1,10,0,7,3,11,6,5,7,5,0,0,2
S01009821,All households,255,63,43,20,177,20,116,31,58,27,41,28,13,15,6,0,1,8
S01009821,Occupancy rating +2 or more,145,48,33,15,94,19,64,25,27,12,11,9,2,3,1,0,1,1
S01009821,Occupancy rating +1,71,10,5,5,56,1,39,5,23,11,16,9,7,5,1,0,0,4
S01009821,Occupancy rating 0,23,3,3,0,18,0,9,1,5,3,9,7,2,2,0,0,0,2
S01009821,Occupancy rating -1 or less,16,2,2,0,9,0,4,0,3,1,5,3,2,5,4,0,0,1
S01009822,All households,191,48,22,26,128,8,80,31,36,13,40,28,12,15,7,0,1,7
S01009822,Occupancy rating +2 or more,78,24,6,18,53,3,40,20,19,1,10,7,3,1,0,0,1,0
S01009822,Occupancy rating +1,63,21,13,8,36,3,20,8,9,3,13,7,6,6,4,0,0,2
S01009822,Occupancy rating 0,38,3,3,0,28,2,13,3,4,6,13,11,2,7,3,0,0,4
S01009822,Occupancy rating -1 or less,12,0,0,0,11,0,7,0,4,3,4,3,1,1,0,0,0,1
S01009823,All households,306,112,49,63,176,9,92,25,34,33,75,45,30,18,8,0,1,9
S01009823,Occupancy rating +2 or more,59,32,18,14,26,4,17,8,2,7,5,0,5,1,0,0,0,1
S01009823,Occupancy rating +1,120,65,26,39,54,3,32,15,6,11,19,11,8,1,1,0,0,0
S01009823,Occupancy rating 0,87,7,4,3,72,1,32,2,19,11,39,23,16,8,2,0,1,5
S01009823,Occupancy rating -1 or less,40,8,1,7,24,1,11,0,7,4,12,11,1,8,5,0,0,3
S01009824,All households,365,103,51,52,238,18,136,40,76,20,84,48,36,24,13,0,0,11
S01009824,Occupancy rating +2 or more,108,40,19,21,65,9,48,24,21,3,8,6,2,3,0,0,0,3
S01009824,Occupancy rating +1,123,50,21,29,69,8,41,14,21,6,20,6,14,4,2,0,0,2
S01009824,Occupancy rating 0,89,9,8,1,72,1,33,1,24,8,38,23,15,8,4,0,0,4
S01009824,Occupancy rating -1 or less,45,4,3,1,32,0,14,1,10,3,18,13,5,9,7,0,0,2
S01009825,All households,449,169,66,103,249,21,143,48,64,31,85,55,30,31,17,2,0,12
S01009825,Occupancy rating +2 or more,84,32,18,14,48,8,37,23,8,6,3,2,1,4,1,2,0,1
S01009825,Occupancy rating +1,161,70,36,34,84,11,54,19,18,17,19,13,6,7,3,0,0,4
S01009825,Occupancy rating 0,118,24,7,17,83,2,36,5,24,7,45,27,18,11,6,0,0,5
S01009825,Occupancy rating -1 or less,86,43,5,38,34,0,16,1,14,1,18,13,5,9,7,0,0,2
S01009826,All households,228,61,29,32,137,13,63,17,30,16,61,28,33,30,17,0,2,11
S01009826,Occupancy rating +2 or more,75,41,18,23,32,9,16,11,3,2,7,1,6,2,0,0,1,1
S01009826,Occupancy rating +1,75,14,8,6,53,4,21,6,8,7,28,12,16,8,4,0,0,4
S01009826,Occupancy rating 0,54,6,3,3,36,0,17,0,14,3,19,11,8,12,7,0,1,4
S01009826,Occupancy rating -1 or less,24,0,0,0,16,0,9,0,5,4,7,4,3,8,6,0,0,2
S01009827,All households,367,131,60,71,214,25,118,32,59,27,71,43,28,22,9,0,2,11
S01009827,Occupancy rating +2 or more,91,50,25,25,40,12,21,17,2,2,7,1,6,1,1,0,0,0
S01009827,Occupancy rating +1,139,62,29,33,67,11,41,13,18,10,15,7,8,10,2,0,2,6
S01009827,Occupancy rating 0,88,10,4,6,74,2,35,1,24,10,37,26,11,4,1,0,0,3
S01009827,Occupancy rating -1 or less,49,9,2,7,33,0,21,1,15,5,12,9,3,7,5,0,0,2
S01009828,All households,394,195,103,92,171,17,65,19,26,20,89,42,47,28,12,0,2,14
S01009828,Occupancy rating +2 or more,64,29,17,12,33,7,21,10,5,6,5,2,3,2,1,0,1,0
S01009828,Occupancy rating +1,113,64,34,30,46,8,22,7,8,7,16,6,10,3,0,0,0,3
S01009828,Occupancy rating 0,145,75,37,38,62,2,12,2,5,5,48,24,24,8,4,0,0,4
S01009828,Occupancy rating -1 or less,72,27,15,12,30,0,10,0,8,2,20,10,10,15,7,0,1,7
S01009829,All households,512,239,74,165,262,26,156,75,60,21,80,60,20,11,5,0,1,5
S01009829,Occupancy rating +2 or more,117,51,14,37,66,18,47,41,4,2,1,0,1,0,0,0,0,0
S01009829,Occupancy rating +1,116,26,8,18,87,4,47,13,23,11,36,26,10,3,0,0,1,2
S01009829,Occupancy rating 0,229,145,46,99,81,3,46,19,23,4,32,24,8,3,2,0,0,1
S01009829,Occupancy rating -1 or less,50,17,6,11,28,1,16,2,10,4,11,10,1,5,3,0,0,2
S01009830,All households,329,87,32,55,221,17,126,46,56,24,78,47,31,21,9,0,2,10
S01009830,Occupancy rating +2 or more,91,47,16,31,44,6,37,33,4,0,1,1,0,0,0,0,0,0
S01009830,Occupancy rating +1,135,33,13,20,94,11,49,12,24,13,34,20,14,8,1,0,0,7
S01009830,Occupancy rating 0,71,5,2,3,58,0,25,1,17,7,33,21,12,8,5,0,2,1
S01009830,Occupancy rating -1 or less,32,2,1,1,25,0,15,0,11,4,10,5,5,5,3,0,0,2
S01009831,All households,313,77,33,44,220,12,143,41,67,35,65,50,15,16,4,0,0,12
S01009831,Occupancy rating +2 or more,104,55,26,29,48,7,37,31,4,2,4,3,1,1,0,0,0,1
S01009831,Occupancy rating +1,104,17,6,11,81,4,51,8,31,12,26,21,5,6,0,0,0,6
S01009831,Occupancy rating 0,72,5,1,4,60,1,36,1,21,14,23,18,5,7,2,0,0,5
S01009831,Occupancy rating -1 or less,33,0,0,0,31,0,19,1,11,7,12,8,4,2,2,0,0,0
S01009832,All households,474,189,95,94,264,28,175,62,79,34,61,36,25,21,5,0,3,13
S01009832,Occupancy rating +2 or more,142,62,23,39,76,14,60,41,9,10,2,1,1,4,1,0,2,1
S01009832,Occupancy rating +1,195,101,55,46,89,11,57,16,32,9,21,10,11,5,0,0,1,4
S01009832,Occupancy rating 0,93,17,11,6,73,2,45,4,27,14,26,14,12,3,1,0,0,2
S01009832,Occupancy rating -1 or less,44,9,6,3,26,1,13,1,11,1,12,11,1,9,3,0,0,6
S01009833,All households,238,78,21,57,146,6,112,56,41,15,28,19,9,14,4,1,1,8
S01009833,Occupancy rating +2 or more,56,19,6,13,36,1,32,19,7,6,3,2,1,1,1,0,0,0
S01009833,Occupancy rating +1,85,34,8,26,46,3,38,25,11,2,5,1,4,5,1,0,0,4
S01009833,Occupancy rating 0,73,22,6,16,47,0,31,8,17,6,16,13,3,4,0,1,0,3
S01009833,Occupancy rating -1 or less,24,3,1,2,17,2,11,4,6,1,4,3,1,4,2,0,1,1
S01009834,All households,372,128,23,105,225,7,125,35,73,17,93,60,33,19,10,2,0,7
S01009834,Occupancy rating +2 or more,57,18,1,17,38,2,30,13,13,4,6,4,2,1,0,0,0,1
S01009834,Occupancy rating +1,133,80,11,69,50,3,39,17,20,2,8,5,3,3,1,1,0,1
S01009834,Occupancy rating 0,130,25,9,16,99,1,43,3,30,10,55,40,15,6,1,1,0,4
S01009834,Occupancy rating -1 or less,52,5,2,3,38,1,13,2,10,1,24,11,13,9,8,0,0,1
S01009835,All households,258,106,42,64,139,9,59,14,24,21,71,51,20,13,5,1,0,7
S01009835,Occupancy rating +2 or more,43,29,18,11,12,2,8,4,2,2,2,1,1,2,0,0,0,2
S01009835,Occupancy rating +1,91,57,19,38,32,4,15,6,1,8,13,6,7,2,0,0,0,2
S01009835,Occupancy rating 0,85,11,3,8,70,2,29,3,16,10,39,32,7,4,2,1,0,1
S01009835,Occupancy rating -1 or less,39,9,2,7,25,1,7,1,5,1,17,12,5,5,3,0,0,2
S01009836,All households,414,128,58,70,256,29,171,58,64,49,56,29,27,30,9,0,2,19
S01009836,Occupancy rating +2 or more,141,51,24,27,88,15,61,29,20,12,12,8,4,2,0,0,1,1
S01009836,Occupancy rating +1,143,60,25,35,73,7,58,26,15,17,8,3,5,10,3,0,0,7
S01009836,Occupancy rating 0,96,13,7,6,73,6,40,3,22,15,27,13,14,10,2,0,1,7
S01009836,Occupancy rating -1 or less,34,4,2,2,22,1,12,0,7,5,9,5,4,8,4,0,0,4
S01009837,All households,368,187,99,88,158,16,81,34,28,19,61,25,36,23,8,1,3,11
S01009837,Occupancy rating +2 or more,33,20,11,9,11,4,6,5,0,1,1,1,0,2,0,1,0,1
S01009837,Occupancy rating +1,185,125,69,56,57,10,38,25,7,6,9,5,4,3,0,0,1,2
S01009837,Occupancy rating 0,114,30,14,16,76,1,30,3,18,9,45,15,30,8,2,0,2,4
S01009837,Occupancy rating -1 or less,36,12,5,7,14,1,7,1,3,3,6,4,2,10,6,0,0,4
S01009838,All households,433,233,85,148,173,13,82,46,27,9,78,55,23,27,10,1,2,14
S01009838,Occupancy rating +2 or more,71,37,20,17,34,6,24,17,6,1,4,4,0,0,0,0,0,0
S01009838,Occupancy rating +1,133,82,38,44,48,5,28,15,6,7,15,9,6,3,0,0,0,3
S01009838,Occupancy rating 0,168,90,19,71,65,2,23,12,11,0,40,28,12,13,5,0,2,6
S01009838,Occupancy rating -1 or less,61,24,8,16,26,0,7,2,4,1,19,14,5,11,5,1,0,5
S01009839,All households,615,385,52,333,194,6,88,46,32,10,100,84,16,36,8,3,0,25
S01009839,Occupancy rating +2 or more,34,24,4,20,9,1,8,6,2,0,0,0,0,1,1,0,0,0
S01009839,Occupancy rating +1,111,81,12,69,29,1,21,17,4,0,7,6,1,1,0,0,0,1
S01009839,Occupancy rating 0,283,175,23,152,88,3,35,18,14,3,50,44,6,20,2,0,0,18
S01009839,Occupancy rating -1 or less,187,105,13,92,68,1,24,5,12,7,43,34,9,14,5,3,0,6
S01009840,All households,475,205,103,102,224,35,124,53,32,39,65,32,33,46,19,0,4,23
S01009840,Occupancy rating +2 or more,108,52,28,24,53,16,35,23,4,8,2,1,1,3,0,0,0,3
S01009840,Occupancy rating +1,163,91,37,54,61,12,35,19,6,10,14,9,5,11,2,0,1,8
S01009840,Occupancy rating 0,137,39,25,14,84,5,43,10,16,17,36,13,23,14,4,0,2,8
S01009840,Occupancy rating -1 or less,67,23,13,10,26,2,11,1,6,4,13,9,4,18,13,0,1,4
S01009841,All households,461,276,40,236,162,8,87,33,42,12,67,52,15,23,5,4,0,14
S01009841,Occupancy rating +2 or more,25,13,0,13,10,3,7,7,0,0,0,0,0,2,0,1,0,1
S01009841,Occupancy rating +1,117,83,11,72,32,2,18,10,5,3,12,9,3,2,0,1,0,1
S01009841,Occupancy rating 0,215,110,23,87,95,3,49,13,28,8,43,35,8,10,1,2,0,7
S01009841,Occupancy rating -1 or less,104,70,6,64,25,0,13,3,9,1,12,8,4,9,4,0,0,5
S01009842,All households,332,155,15,140,149,4,88,33,45,10,57,46,11,28,9,4,0,15
S01009842,Occupancy rating +2 or more,50,17,3,14,31,4,23,11,10,2,4,4,0,2,1,1,0,0
S01009842,Occupancy rating +1,67,39,7,32,23,0,18,13,4,1,5,4,1,5,2,0,0,3
S01009842,Occupancy rating 0,157,71,2,69,71,0,39,8,25,6,32,25,7,15,4,2,0,9
S01009842,Occupancy rating -1 or less,58,28,3,25,24,0,8,1,6,1,16,13,3,6,2,1,0,3
S01009843,All households,310,153,43,110,129,5,68,25,34,9,56,32,24,28,14,0,1,13
S01009843,Occupancy rating +2 or more,56,30,16,14,23,2,14,9,5,0,7,5,2,3,1,0,1,1
S01009843,Occupancy rating +1,73,38,10,28,32,2,20,7,11,2,10,5,5,3,1,0,0,2
S01009843,Occupancy rating 0,132,68,15,53,57,1,26,9,10,7,30,17,13,7,4,0,0,3
S01009843,Occupancy rating -1 or less,49,17,2,15,17,0,8,0,8,0,9,5,4,15,8,0,0,7
S01009844,All households,361,247,72,175,98,2,48,23,22,3,48,35,13,16,7,0,0,9
S01009844,Occupancy rating +2 or more,13,8,3,5,4,1,1,1,0,0,2,2,0,1,0,0,0,1
S01009844,Occupancy rating +1,44,33,8,25,11,1,8,4,3,1,2,2,0,0,0,0,0,0
S01009844,Occupancy rating 0,178,126,37,89,47,0,21,13,7,1,26,18,8,5,2,0,0,3
S01009844,Occupancy rating -1 or less,126,80,24,56,36,0,18,5,12,1,18,13,5,10,5,0,0,5
S01009845,All households,440,252,19,233,152,0,73,34,35,4,79,59,20,36,3,3,0,30
S01009845,Occupancy rating +2 or more,8,3,0,3,5,0,1,1,0,0,4,2,2,0,0,0,0,0
S01009845,Occupancy rating +1,53,31,3,28,19,0,12,11,1,0,7,4,3,3,0,0,0,3
S01009845,Occupancy rating 0,196,112,9,103,74,0,37,16,18,3,37,30,7,10,0,0,0,10
S01009845,Occupancy rating -1 or less,183,106,7,99,54,0,23,6,16,1,31,23,8,23,3,3,0,17
S01009846,All households,461,219,46,173,215,10,126,65,39,22,79,59,20,27,8,3,1,15
S01009846,Occupancy rating +2 or more,65,36,11,25,27,2,22,20,1,1,3,0,3,2,0,0,0,2
S01009846,Occupancy rating +1,117,57,6,51,58,4,43,28,3,12,11,5,6,2,0,0,0,2
S01009846,Occupancy rating 0,194,86,20,66,96,4,45,13,24,8,47,38,9,12,3,2,0,7
S01009846,Occupancy rating -1 or less,85,40,9,31,34,0,16,4,11,1,18,16,2,11,5,1,1,4
S01009847,All households,322,150,26,124,148,2,70,35,29,6,76,63,13,24,6,5,0,13
S01009847,Occupancy rating +2 or more,16,4,0,4,10,0,10,9,1,0,0,0,0,2,2,0,0,0
S01009847,Occupancy rating +1,55,23,4,19,29,1,14,9,4,1,14,9,5,3,0,1,0,2
S01009847,Occupancy rating 0,167,83,15,68,74,0,31,16,12,3,43,37,6,10,1,3,0,6
S01009847,Occupancy rating -1 or less,84,40,7,33,35,1,15,1,12,2,19,17,2,9,3,1,0,5
S01009848,All households,383,133,55,78,211,24,119,47,41,31,68,34,34,39,19,4,1,15
S01009848,Occupancy rating +2 or more,107,56,16,40,49,11,33,27,5,1,5,5,0,2,0,1,0,1
S01009848,Occupancy rating +1,129,56,26,30,66,8,42,19,9,14,16,5,11,7,1,0,1,5
S01009848,Occupancy rating 0,92,15,11,4,65,4,31,1,20,10,30,14,16,12,8,1,0,3
S01009848,Occupancy rating -1 or less,55,6,2,4,31,1,13,0,7,6,17,10,7,18,10,2,0,6
S01009849,All households,445,239,114,125,177,33,87,47,29,11,57,30,27,29,4,2,2,21
S01009849,Occupancy rating +2 or more,32,23,12,11,8,2,4,4,0,0,2,1,1,1,0,0,0,1
S01009849,Occupancy rating +1,238,157,80,77,78,28,40,34,3,3,10,5,5,3,0,2,0,1
S01009849,Occupancy rating 0,122,42,17,25,66,2,29,8,15,6,35,17,18,14,1,0,1,12
S01009849,Occupancy rating -1 or less,53,17,5,12,25,1,14,1,11,2,10,7,3,11,3,0,1,7
S01009850,All households,472,236,95,141,215,30,127,59,43,25,58,30,28,21,0,1,4,16
S01009850,Occupancy rating +2 or more,73,34,17,17,37,6,30,13,11,6,1,0,1,2,0,0,0,2
S01009850,Occupancy rating +1,155,93,58,35,56,16,26,20,4,2,14,4,10,6,0,1,1,4
S01009850,Occupancy rating 0,156,63,15,48,85,4,47,19,16,12,34,19,15,8,0,0,2,6
S01009850,Occupancy rating -1 or less,88,46,5,41,37,4,24,7,12,5,9,7,2,5,0,0,1,4
S01009851,All households,470,243,130,113,208,34,111,54,34,23,63,30,33,19,5,0,3,11
S01009851,Occupancy rating +2 or more,50,20,6,14,27,8,18,13,4,1,1,0,1,3,0,0,0,3
S01009851,Occupancy rating +1,219,143,81,62,73,21,44,32,8,4,8,2,6,3,2,0,0,1
S01009851,Occupancy rating 0,157,70,37,33,80,3,40,7,19,14,37,21,16,7,1,0,1,5
S01009851,Occupancy rating -1 or less,44,10,6,4,28,2,9,2,3,4,17,7,10,6,2,0,2,2
S01009852,All households,257,97,63,34,142,20,84,21,43,20,38,15,23,18,8,2,1,7
S01009852,Occupancy rating +2 or more,97,49,31,18,46,13,28,12,12,4,5,1,4,2,0,0,1,1
S01009852,Occupancy rating +1,86,34,22,12,47,6,26,7,13,6,15,7,8,5,2,1,0,2
S01009852,Occupancy rating 0,54,10,6,4,37,1,25,2,14,9,11,3,8,7,3,0,0,4
S01009852,Occupancy rating -1 or less,20,4,4,0,12,0,5,0,4,1,7,4,3,4,3,1,0,0
S01009853,All households,413,165,89,76,216,27,128,45,58,25,61,39,22,32,13,2,4,13
S01009853,Occupancy rating +2 or more,77,43,22,21,32,13,17,11,3,3,2,1,1,2,0,0,1,1
S01009853,Occupancy rating +1,173,98,57,41,72,10,47,30,12,5,15,9,6,3,1,0,1,1
S01009853,Occupancy rating 0,111,18,7,11,78,4,41,1,29,11,33,22,11,15,5,0,1,9
S01009853,Occupancy rating -1 or less,52,6,3,3,34,0,23,3,14,6,11,7,4,12,7,2,1,2
S01009854,All households,398,149,56,93,230,9,145,47,71,27,76,46,30,19,13,1,0,5
S01009854,Occupancy rating +2 or more,48,17,8,9,31,2,23,9,10,4,6,5,1,0,0,0,0,0
S01009854,Occupancy rating +1,126,43,22,21,82,7,62,31,24,7,13,7,6,1,0,0,0,1
S01009854,Occupancy rating 0,161,69,19,50,85,0,44,7,25,12,41,26,15,7,4,0,0,3
S01009854,Occupancy rating -1 or less,63,20,7,13,32,0,16,0,12,4,16,8,8,11,9,1,0,1
S01009855,All households,250,87,43,44,139,14,93,30,35,28,32,15,17,24,8,3,2,11
S01009855,Occupancy rating +2 or more,92,42,23,19,50,7,38,19,7,12,5,2,3,0,0,0,0,0
S01009855,Occupancy rating +1,88,37,17,20,44,5,28,10,8,10,11,5,6,7,4,0,1,2
S01009855,Occupancy rating 0,50,4,2,2,35,2,22,1,16,5,11,4,7,11,4,1,0,6
S01009855,Occupancy rating -1 or less,20,4,1,3,10,0,5,0,4,1,5,4,1,6,0,2,1,3
S01009856,All households,308,139,80,59,139,13,80,30,30,20,46,22,24,30,9,8,1,12
S01009856,Occupancy rating +2 or more,128,65,38,27,60,12,43,27,9,7,5,2,3,3,2,0,0,1
S01009856,Occupancy rating +1,80,41,21,20,32,0,16,3,6,7,16,3,13,7,1,2,1,3
S01009856,Occupancy rating 0,49,12,7,5,29,1,14,0,10,4,14,10,4,8,3,0,0,5
S01009856,Occupancy rating -1 or less,51,21,14,7,18,0,7,0,5,2,11,7,4,12,3,6,0,3
S01009857,All households,374,109,74,35,228,23,148,42,73,33,57,29,28,37,11,2,4,20
S01009857,Occupancy rating +2 or more,129,47,32,15,75,13,45,25,16,4,17,8,9,7,1,0,2,4
S01009857,Occupancy rating +1,118,42,29,13,72,8,44,16,17,11,20,7,13,4,0,0,0,4
S01009857,Occupancy rating 0,85,13,10,3,58,2,46,1,31,14,10,8,2,14,5,1,2,6
S01009857,Occupancy rating -1 or less,42,7,3,4,23,0,13,0,9,4,10,6,4,12,5,1,0,6
S01009858,All households,337,118,72,46,193,19,128,56,46,26,46,32,14,26,11,2,0,13
S01009858,Occupancy rating +2 or more,89,41,33,8,44,6,36,22,12,2,2,2,0,4,0,0,0,4
S01009858,Occupancy rating +1,142,64,35,29,73,11,52,28,12,12,10,6,4,5,2,1,0,2
S01009858,Occupancy rating 0,71,7,4,3,56,2,28,4,14,10,26,16,10,8,3,0,0,5
S01009858,Occupancy rating -1 or less,35,6,0,6,20,0,12,2,8,2,8,8,0,9,6,1,0,2
S01009859,All households,580,323,90,233,226,26,107,48,39,20,93,56,37,31,9,3,1,18
S01009859,Occupancy rating +2 or more,76,44,11,33,29,10,15,13,2,0,4,3,1,3,0,1,1,1
S01009859,Occupancy rating +1,123,61,24,37,58,7,30,13,8,9,21,11,10,4,0,1,0,3
S01009859,Occupancy rating 0,255,149,40,109,95,8,42,16,18,8,45,27,18,11,1,0,0,10
S01009859,Occupancy rating -1 or less,126,69,15,54,44,1,20,6,11,3,23,15,8,13,8,1,0,4
S01009860,All households,503,263,109,154,192,18,92,44,28,20,82,42,40,48,12,9,1,26
S01009860,Occupancy rating +2 or more,66,32,12,20,33,6,22,15,3,4,5,0,5,1,0,0,0,1
S01009860,Occupancy rating +1,145,75,25,50,58,8,29,19,6,4,21,10,11,12,1,4,1,6
S01009860,Occupancy rating 0,195,117,52,65,59,4,30,8,14,8,25,15,10,19,3,5,0,11
S01009860,Occupancy rating -1 or less,97,39,20,19,42,0,11,2,5,4,31,17,14,16,8,0,0,8
S01009861,All households,524,257,47,210,215,14,106,51,45,10,95,65,30,52,18,2,0,32
S01009861,Occupancy rating +2 or more,63,23,4,19,35,4,15,7,7,1,16,12,4,5,0,0,0,5
S01009861,Occupancy rating +1,126,69,12,57,44,3,34,25,5,4,7,2,5,13,5,1,0,7
S01009861,Occupancy rating 0,220,126,18,108,79,3,39,18,20,1,37,25,12,15,4,1,0,10
S01009861,Occupancy rating -1 or less,115,39,13,26,57,4,18,1,13,4,35,26,9,19,9,0,0,10
S01009862,All households,607,365,52,313,195,4,119,60,45,14,72,50,22,47,12,2,1,32
S01009862,Occupancy rating +2 or more,33,25,8,17,6,3,2,1,1,0,1,1,0,2,1,0,0,1
S01009862,Occupancy rating +1,127,87,21,66,35,0,26,16,7,3,9,7,2,5,1,1,0,3
S01009862,Occupancy rating 0,266,159,11,148,94,1,50,31,14,5,43,29,14,13,2,1,0,10
S01009862,Occupancy rating -1 or less,181,94,12,82,60,0,41,12,23,6,19,13,6,27,8,0,1,18
S01009863,All households,461,255,37,218,160,5,108,63,37,8,47,42,5,46,1,10,0,35
S01009863,Occupancy rating +2 or more,24,8,0,8,14,1,8,6,2,0,5,5,0,2,0,0,0,2
S01009863,Occupancy rating +1,84,50,7,43,31,1,28,24,2,2,2,1,1,3,0,0,0,3
S01009863,Occupancy rating 0,227,145,25,120,66,3,48,27,17,4,15,14,1,16,1,4,0,11
S01009863,Occupancy rating -1 or less,126,52,5,47,49,0,24,6,16,2,25,22,3,25,0,6,0,19
S01009864,All households,317,157,31,126,117,6,70,43,20,7,41,21,20,43,5,12,0,26
S01009864,Occupancy rating +2 or more,24,16,5,11,8,0,5,5,0,0,3,1,2,0,0,0,0,0
S01009864,Occupancy rating +1,123,63,13,50,52,6,33,27,2,4,13,7,6,8,0,3,0,5
S01009864,Occupancy rating 0,126,60,8,52,44,0,26,10,13,3,18,9,9,22,1,6,0,15
S01009864,Occupancy rating -1 or less,44,18,5,13,13,0,6,1,5,0,7,4,3,13,4,3,0,6
S01009865,All households,245,135,24,111,89,6,61,29,23,9,22,11,11,21,5,3,0,13
S01009865,Occupancy rating +2 or more,31,16,5,11,12,2,6,2,2,2,4,2,2,3,0,1,0,2
S01009865,Occupancy rating +1,78,50,5,45,27,1,23,13,7,3,3,2,1,1,0,0,0,1
S01009865,Occupancy rating 0,85,40,4,36,34,3,22,13,9,0,9,5,4,11,2,1,0,8
S01009865,Occupancy rating -1 or less,51,29,10,19,16,0,10,1,5,4,6,2,4,6,3,1,0,2
S01009866,All households,455,198,63,135,208,21,136,70,45,21,51,29,22,49,9,5,3,32
S01009866,Occupancy rating +2 or more,58,26,11,15,29,6,21,13,6,2,2,0,2,3,1,0,0,2
S01009866,Occupancy rating +1,151,73,22,51,71,9,48,38,4,6,14,5,9,7,1,0,1,5
S01009866,Occupancy rating 0,157,67,23,44,69,4,41,17,15,9,24,16,8,21,3,4,1,13
S01009866,Occupancy rating -1 or less,89,32,7,25,39,2,26,2,20,4,11,8,3,18,4,1,1,12
S01009867,All households,595,313,59,254,204,20,151,112,30,9,33,19,14,78,3,19,0,56
S01009867,Occupancy rating +2 or more,81,44,7,37,34,8,22,19,3,0,4,0,4,3,0,0,0,3
S01009867,Occupancy rating +1,195,115,18,97,72,3,65,51,11,3,4,1,3,8,0,4,0,4
S01009867,Occupancy rating 0,243,125,32,93,77,6,51,37,10,4,20,14,6,41,1,7,0,33
S01009867,Occupancy rating -1 or less,76,29,2,27,21,3,13,5,6,2,5,4,1,26,2,8,0,16
S01009868,All households,308,116,13,103,121,4,101,56,34,11,16,10,6,71,6,16,0,49
S01009868,Occupancy rating +2 or more,26,10,2,8,12,2,8,8,0,0,2,1,1,4,1,1,0,2
S01009868,Occupancy rating +1,115,66,6,60,47,2,43,32,7,4,2,1,1,2,0,0,0,2
S01009868,Occupancy rating 0,119,35,4,31,42,0,35,10,19,6,7,5,2,42,1,11,0,30
S01009868,Occupancy rating -1 or less,48,5,1,4,20,0,15,6,8,1,5,3,2,23,4,4,0,15
S01009869,All households,269,121,14,107,96,3,76,39,33,4,17,11,6,52,6,20,0,26
S01009869,Occupancy rating +2 or more,21,8,1,7,8,1,5,4,1,0,2,0,2,5,0,3,0,2
S01009869,Occupancy rating +1,76,40,2,38,30,2,28,23,5,0,0,0,0,6,1,1,0,4
S01009869,Occupancy rating 0,113,55,8,47,34,0,28,8,16,4,6,4,2,24,1,10,0,13
S01009869,Occupancy rating -1 or less,59,18,3,15,24,0,15,4,11,0,9,7,2,17,4,6,0,7
S01009870,All households,274,111,22,89,115,4,78,39,31,8,33,21,12,48,11,6,0,31
S01009870,Occupancy rating +2 or more,20,7,4,3,11,0,8,6,1,1,3,1,2,2,1,0,0,1
S01009870,Occupancy rating +1,85,48,11,37,31,4,22,15,4,3,5,4,1,6,1,1,0,4
S01009870,Occupancy rating 0,101,35,2,33,46,0,34,17,14,3,12,8,4,20,0,2,0,18
S01009870,Occupancy rating -1 or less,68,21,5,16,27,0,14,1,12,1,13,8,5,20,9,3,0,8
S01009871,All households,587,362,124,238,197,38,114,50,50,14,45,27,18,28,6,5,3,14
S01009871,Occupancy rating +2 or more,62,23,8,15,32,9,23,6,14,3,0,0,0,7,4,0,1,2
S01009871,Occupancy rating +1,133,83,31,52,46,16,25,18,6,1,5,3,2,4,0,0,0,4
S01009871,Occupancy rating 0,280,196,65,131,77,9,41,18,16,7,27,17,10,7,0,1,1,5
S01009871,Occupancy rating -1 or less,112,60,20,40,42,4,25,8,14,3,13,7,6,10,2,4,1,3
S01009872,All households,365,174,18,156,140,10,111,56,47,8,19,9,10,51,9,7,1,34
S01009872,Occupancy rating +2 or more,24,11,3,8,12,1,11,8,3,0,0,0,0,1,1,0,0,0
S01009872,Occupancy rating +1,92,44,5,39,33,3,25,22,1,2,5,2,3,15,3,0,1,11
S01009872,Occupancy rating 0,173,94,7,87,55,4,43,20,21,2,8,4,4,24,2,3,0,19
S01009872,Occupancy rating -1 or less,76,25,3,22,40,2,32,6,22,4,6,3,3,11,3,4,0,4
S01009873,All households,445,219,104,115,188,27,137,60,57,20,24,12,12,38,11,1,1,25
S01009873,Occupancy rating +2 or more,125,24,10,14,91,20,67,26,31,10,4,1,3,10,5,0,0,5
S01009873,Occupancy rating +1,102,52,17,35,42,1,37,23,12,2,4,1,3,8,2,0,0,6
S01009873,Occupancy rating 0,118,75,40,35,34,4,19,7,6,6,11,7,4,9,1,0,0,8
S01009873,Occupancy rating -1 or less,100,68,37,31,21,2,14,4,8,2,5,3,2,11,3,1,1,6
S01009874,All households,497,211,78,133,252,29,154,65,60,29,69,50,19,34,16,4,1,13
S01009874,Occupancy rating +2 or more,158,44,19,25,100,18,74,33,27,14,8,4,4,14,9,2,0,3
S01009874,Occupancy rating +1,149,89,41,48,55,9,41,24,13,4,5,1,4,5,1,1,1,2
S01009874,Occupancy rating 0,143,63,16,47,73,1,30,7,15,8,42,32,10,7,2,0,0,5
S01009874,Occupancy rating -1 or less,47,15,2,13,24,1,9,1,5,3,14,13,1,8,4,1,0,3
S01009875,All households,307,128,21,107,141,3,100,38,57,5,38,27,11,38,10,8,0,20
S01009875,Occupancy rating +2 or more,37,20,1,19,16,1,12,8,4,0,3,2,1,1,0,0,0,1
S01009875,Occupancy rating +1,61,32,4,28,24,0,20,10,8,2,4,3,1,5,0,1,0,4
S01009875,Occupancy rating 0,119,56,14,42,52,0,33,15,16,2,19,11,8,11,3,3,0,5
S01009875,Occupancy rating -1 or less,90,20,2,18,49,2,35,5,29,1,12,11,1,21,7,4,0,10
S01009876,All households,322,139,17,122,155,6,69,11,49,9,80,64,16,28,7,5,1,15
S01009876,Occupancy rating +2 or more,53,37,8,29,14,4,5,3,2,0,5,5,0,2,1,0,0,1
S01009876,Occupancy rating +1,65,24,3,21,37,2,18,5,8,5,17,13,4,4,0,0,0,4
S01009876,Occupancy rating 0,99,19,2,17,68,0,32,1,27,4,36,29,7,12,0,2,1,9
S01009876,Occupancy rating -1 or less,105,59,4,55,36,0,14,2,12,0,22,17,5,10,6,3,0,1
S01009877,All households,360,132,62,70,184,21,142,62,56,24,21,12,9,44,21,1,4,18
S01009877,Occupancy rating +2 or more,181,55,34,21,105,17,82,43,27,12,6,1,5,21,12,0,1,8
S01009877,Occupancy rating +1,99,49,21,28,44,4,36,14,13,9,4,3,1,6,4,0,1,1
S01009877,Occupancy rating 0,52,18,4,14,25,0,16,4,9,3,9,7,2,9,1,1,1,6
S01009877,Occupancy rating -1 or less,28,10,3,7,10,0,8,1,7,0,2,1,1,8,4,0,1,3
S01009878,All households,252,85,14,71,124,7,95,25,52,18,22,12,10,43,18,9,1,15
S01009878,Occupancy rating +2 or more,47,21,6,15,21,3,18,13,4,1,0,0,0,5,0,0,1,4
S01009878,Occupancy rating +1,71,31,4,27,33,4,23,4,12,7,6,3,3,7,1,2,0,4
S01009878,Occupancy rating 0,83,28,4,24,39,0,31,8,18,5,8,4,4,16,6,6,0,4
S01009878,Occupancy rating -1 or less,51,5,0,5,31,0,23,0,18,5,8,5,3,15,11,1,0,3
S01009879,All households,332,77,23,54,228,29,188,77,86,25,11,8,3,27,10,1,1,15
S01009879,Occupancy rating +2 or more,242,47,20,27,178,27,147,66,65,16,4,2,2,17,6,1,1,9
S01009879,Occupancy rating +1,48,17,1,16,27,1,23,7,12,4,3,3,0,4,3,0,0,1
S01009879,Occupancy rating 0,28,10,2,8,14,0,12,4,5,3,2,1,1,4,0,0,0,4
S01009879,Occupancy rating -1 or less,14,3,0,3,9,1,6,0,4,2,2,2,0,2,1,0,0,1
S01009880,All households,258,72,20,52,153,17,119,30,73,16,17,11,6,33,19,0,1,13
S01009880,Occupancy rating +2 or more,116,33,10,23,69,15,47,22,16,9,7,2,5,14,6,0,0,8
S01009880,Occupancy rating +1,62,30,7,23,28,2,24,6,16,2,2,2,0,4,1,0,1,2
S01009880,Occupancy rating 0,46,5,3,2,33,0,29,2,22,5,4,3,1,8,6,0,0,2
S01009880,Occupancy rating -1 or less,34,4,0,4,23,0,19,0,19,0,4,4,0,7,6,0,0,1
S01009881,All households,179,55,5,50,78,2,58,22,32,4,18,10,8,46,19,7,0,20
S01009881,Occupancy rating +2 or more,36,21,1,20,15,0,14,10,4,0,1,0,1,0,0,0,0,0
S01009881,Occupancy rating +1,50,19,1,18,21,2,17,9,6,2,2,1,1,10,0,3,0,7
S01009881,Occupancy rating 0,42,11,2,9,24,0,15,2,12,1,9,5,4,7,3,2,0,2
S01009881,Occupancy rating -1 or less,51,4,1,3,18,0,12,1,10,1,6,4,2,29,16,2,0,11
S01009882,All households,613,292,16,276,240,0,189,128,55,6,51,40,11,81,5,13,0,63
S01009882,Occupancy rating +2 or more,31,16,1,15,15,0,13,12,0,1,2,1,1,0,0,0,0,0
S01009882,Occupancy rating +1,142,81,5,76,53,0,47,41,6,0,6,4,2,8,1,0,0,7
S01009882,Occupancy rating 0,239,131,10,121,84,0,73,58,13,2,11,8,3,24,0,6,0,18
S01009882,Occupancy rating -1 or less,201,64,0,64,88,0,56,17,36,3,32,27,5,49,4,7,0,38
S01009883,All households,280,65,9,56,160,2,131,47,74,10,27,19,8,55,16,7,0,32
S01009883,Occupancy rating +2 or more,23,3,0,3,16,2,11,7,3,1,3,2,1,4,1,0,0,3
S01009883,Occupancy rating +1,98,51,8,43,39,0,39,32,4,3,0,0,0,8,1,0,0,7
S01009883,Occupancy rating 0,76,9,1,8,49,0,38,4,33,1,11,7,4,18,1,1,0,16
S01009883,Occupancy rating -1 or less,83,2,0,2,56,0,43,4,34,5,13,10,3,25,13,6,0,6
S01009884,All households,316,96,19,77,160,1,137,59,68,10,22,13,9,60,20,1,0,39
S01009884,Occupancy rating +2 or more,28,10,0,10,14,1,13,11,2,0,0,0,0,4,1,0,0,3
S01009884,Occupancy rating +1,104,52,13,39,48,0,47,39,7,1,1,0,1,4,0,0,0,4
S01009884,Occupancy rating 0,102,27,5,22,52,0,39,8,27,4,13,7,6,23,5,0,0,18
S01009884,Occupancy rating -1 or less,82,7,1,6,46,0,38,1,32,5,8,6,2,29,14,1,0,14
S01009885,All households,251,42,11,31,153,5,122,39,72,11,26,21,5,56,28,5,0,23
S01009885,Occupancy rating +2 or more,79,28,8,20,44,4,39,24,11,4,1,0,1,7,3,1,0,3
S01009885,Occupancy rating +1,62,8,2,6,45,1,37,13,19,5,7,6,1,9,2,2,0,5
S01009885,Occupancy rating 0,57,5,1,4,37,0,27,2,24,1,10,7,3,15,4,0,0,11
S01009885,Occupancy rating -1 or less,53,1,0,1,27,0,19,0,18,1,8,8,0,25,19,2,0,4
S01009886,All households,277,103,46,57,120,7,91,23,55,13,22,11,11,54,22,6,3,23
S01009886,Occupancy rating +2 or more,60,23,6,17,30,2,24,18,4,2,4,2,2,7,2,1,0,4
S01009886,Occupancy rating +1,70,25,17,8,29,3,20,3,14,3,6,3,3,16,3,1,1,11
S01009886,Occupancy rating 0,72,35,16,19,25,1,18,2,13,3,6,2,4,12,3,3,2,4
S01009886,Occupancy rating -1 or less,75,20,7,13,36,1,29,0,24,5,6,4,2,19,14,1,0,4
S01009887,All households,490,274,36,238,159,9,110,40,63,7,40,25,15,57,12,16,0,29
S01009887,Occupancy rating +2 or more,26,17,2,15,7,1,3,2,1,0,3,1,2,2,0,0,0,2
S01009887,Occupancy rating +1,71,44,5,39,24,4,17,13,2,2,3,2,1,3,0,0,0,3
S01009887,Occupancy rating 0,224,151,19,132,58,3,46,17,27,2,9,5,4,15,2,3,0,10
S01009887,Occupancy rating -1 or less,169,62,10,52,70,1,44,8,33,3,25,17,8,37,10,13,0,14
S01009888,All households,280,112,17,95,129,4,95,22,61,12,30,20,10,39,13,5,0,21
S01009888,Occupancy rating +2 or more,21,8,1,7,10,1,8,4,4,0,1,1,0,3,0,0,0,3
S01009888,Occupancy rating +1,71,45,5,40,23,3,19,13,4,2,1,0,1,3,1,0,0,2
S01009888,Occupancy rating 0,96,36,11,25,46,0,30,3,22,5,16,10,6,14,2,3,0,9
S01009888,Occupancy rating -1 or less,92,23,0,23,50,0,38,2,31,5,12,9,3,19,10,2,0,7
S01009889,All households,370,169,41,128,159,9,106,50,50,6,44,30,14,42,11,3,0,28
S01009889,Occupancy rating +2 or more,35,21,8,13,12,2,8,3,4,1,2,1,1,2,1,0,0,1
S01009889,Occupancy rating +1,59,30,9,21,26,2,22,16,5,1,2,1,1,3,1,0,0,2
S01009889,Occupancy rating 0,193,98,21,77,78,4,49,28,20,1,25,15,10,17,3,0,0,14
S01009889,Occupancy rating -1 or less,83,20,3,17,43,1,27,3,21,3,15,13,2,20,6,3,0,11
S01009890,All households,278,143,18,125,121,6,80,37,38,5,35,28,7,14,7,1,0,6
S01009890,Occupancy rating +2 or more,11,6,4,2,4,0,2,2,0,0,2,1,1,1,0,0,0,1
S01009890,Occupancy rating +1,36,17,2,15,19,4,14,9,3,2,1,0,1,0,0,0,0,0
S01009890,Occupancy rating 0,125,68,5,63,56,2,39,22,15,2,15,10,5,1,0,0,0,1
S01009890,Occupancy rating -1 or less,106,52,7,45,42,0,25,4,20,1,17,17,0,12,7,1,0,4
S01009891,All households,430,254,58,196,143,18,98,48,36,14,27,17,10,33,3,2,0,28
S01009891,Occupancy rating +2 or more,26,8,6,2,17,6,9,9,0,0,2,1,1,1,1,0,0,0
S01009891,Occupancy rating +1,107,64,24,40,40,5,31,23,3,5,4,2,2,3,0,0,0,3
S01009891,Occupancy rating 0,192,128,19,109,50,4,35,14,18,3,11,5,6,14,1,2,0,11
S01009891,Occupancy rating -1 or less,105,54,9,45,36,3,23,2,15,6,10,9,1,15,1,0,0,14
S01009892,All households,468,273,41,232,175,11,115,70,35,10,49,29,20,20,3,1,1,15
S01009892,Occupancy rating +2 or more,32,17,3,14,15,4,10,9,1,0,1,0,1,0,0,0,0,0
S01009892,Occupancy rating +1,74,38,6,32,35,0,21,16,3,2,14,8,6,1,0,0,0,1
S01009892,Occupancy rating 0,210,133,21,112,73,5,51,38,10,3,17,10,7,4,2,0,0,2
S01009892,Occupancy rating -1 or less,152,85,11,74,52,2,33,7,21,5,17,11,6,15,1,1,1,12
S01009893,All households,420,229,28,201,146,4,114,44,60,10,28,17,11,45,9,3,1,32
S01009893,Occupancy rating +2 or more,19,9,4,5,8,0,8,3,3,2,0,0,0,2,0,0,0,2
S01009893,Occupancy rating +1,81,54,12,42,21,3,18,13,4,1,0,0,0,6,1,1,1,3
S01009893,Occupancy rating 0,212,137,12,125,61,1,44,21,18,5,16,9,7,14,0,1,0,13
S01009893,Occupancy rating -1 or less,108,29,0,29,56,0,44,7,35,2,12,8,4,23,8,1,0,14
S01009894,All households,476,261,71,190,186,20,92,46,33,13,74,50,24,29,8,4,2,15
S01009894,Occupancy rating +2 or more,19,7,1,6,9,1,7,4,1,2,1,1,0,3,0,0,0,3
S01009894,Occupancy rating +1,177,120,49,71,57,14,31,27,2,2,12,8,4,0,0,0,0,0
S01009894,Occupancy rating 0,180,82,14,68,85,4,35,10,20,5,46,34,12,13,1,2,2,8
S01009894,Occupancy rating -1 or less,100,52,7,45,35,1,19,5,10,4,15,7,8,13,7,2,0,4
S01009895,All households,408,248,36,212,138,4,96,40,42,14,38,21,17,22,5,3,3,11
S01009895,Occupancy rating +2 or more,19,9,2,7,8,1,7,5,1,1,0,0,0,2,1,0,0,1
S01009895,Occupancy rating +1,96,65,12,53,30,0,22,16,4,2,8,3,5,1,0,0,0,1
S01009895,Occupancy rating 0,177,101,13,88,67,2,44,17,19,8,21,12,9,9,0,0,2,7
S01009895,Occupancy rating -1 or less,116,73,9,64,33,1,23,2,18,3,9,6,3,10,4,3,1,2
S01009896,All households,470,224,58,166,202,11,115,41,57,17,76,45,31,44,11,7,0,26
S01009896,Occupancy rating +2 or more,32,13,2,11,17,1,13,10,2,1,3,1,2,2,1,0,0,1
S01009896,Occupancy rating +1,116,73,16,57,36,4,28,18,4,6,4,0,4,7,1,3,0,3
S01009896,Occupancy rating 0,198,96,32,64,90,5,37,9,23,5,48,30,18,12,0,1,0,11
S01009896,Occupancy rating -1 or less,124,42,8,34,59,1,37,4,28,5,21,14,7,23,9,3,0,11
S01009897,All households,497,244,82,162,221,23,157,82,53,22,41,20,21,32,6,4,6,16
S01009897,Occupancy rating +2 or more,73,38,20,18,32,11,18,10,5,3,3,2,1,3,1,0,0,2
S01009897,Occupancy rating +1,144,88,33,55,51,6,42,38,2,2,3,1,2,5,1,0,1,3
S01009897,Occupancy rating 0,182,79,20,59,91,5,67,27,30,10,19,7,12,12,0,0,5,7
S01009897,Occupancy rating -1 or less,98,39,9,30,47,1,30,7,16,7,16,10,6,12,4,4,0,4
S01009898,All households,259,86,35,51,137,14,70,17,37,16,53,33,20,36,9,3,3,21
S01009898,Occupancy rating +2 or more,20,10,2,8,10,3,6,5,1,0,1,1,0,0,0,0,0,0
S01009898,Occupancy rating +1,96,62,28,34,30,8,12,7,4,1,10,6,4,4,0,0,0,4
S01009898,Occupancy rating 0,84,10,3,7,60,3,29,4,15,10,28,16,12,14,1,1,3,9
S01009898,Occupancy rating -1 or less,59,4,2,2,37,0,23,1,17,5,14,10,4,18,8,2,0,8
S01009899,All households,464,255,60,195,185,8,143,92,42,9,34,19,15,24,4,2,0,18
S01009899,Occupancy rating +2 or more,23,14,7,7,9,1,7,7,0,0,1,1,0,0,0,0,0,0
S01009899,Occupancy rating +1,151,93,28,65,57,6,46,41,2,3,5,2,3,1,0,0,0,1
S01009899,Occupancy rating 0,204,109,20,89,80,1,65,36,26,3,14,9,5,15,1,2,0,12
S01009899,Occupancy rating -1 or less,86,39,5,34,39,0,25,8,14,3,14,7,7,8,3,0,0,5
S01009900,All households,499,254,19,235,202,8,154,111,38,5,40,26,14,43,2,2,0,39
S01009900,Occupancy rating +2 or more,23,11,1,10,12,0,10,8,1,1,2,1,1,0,0,0,0,0
S01009900,Occupancy rating +1,177,91,5,86,81,6,73,70,2,1,2,0,2,5,0,1,0,4
S01009900,Occupancy rating 0,237,123,11,112,83,2,59,27,31,1,22,15,7,31,0,1,0,30
S01009900,Occupancy rating -1 or less,62,29,2,27,26,0,12,6,4,2,14,10,4,7,2,0,0,5
S01009901,All households,456,199,28,171,221,8,182,123,50,9,31,23,8,36,11,1,1,23
S01009901,Occupancy rating +2 or more,62,17,2,15,41,4,33,19,11,3,4,1,3,4,1,0,0,3
S01009901,Occupancy rating +1,187,102,12,90,82,2,75,67,8,0,5,4,1,3,0,0,0,3
S01009901,Occupancy rating 0,166,70,14,56,78,1,63,32,28,3,14,11,3,18,3,1,1,13
S01009901,Occupancy rating -1 or less,41,10,0,10,20,1,11,5,3,3,8,7,1,11,7,0,0,4
S01009902,All households,495,265,133,132,190,26,115,48,46,21,49,19,30,40,9,3,8,20
S01009902,Occupancy rating +2 or more,81,37,16,21,37,3,31,16,10,5,3,1,2,7,3,0,1,3
S01009902,Occupancy rating +1,207,147,80,67,56,19,36,25,8,3,1,0,1,4,2,0,0,2
S01009902,Occupancy rating 0,143,62,26,36,63,3,32,4,17,11,28,11,17,18,1,3,6,8
S01009902,Occupancy rating -1 or less,64,19,11,8,34,1,16,3,11,2,17,7,10,11,3,0,1,7
S01009903,All households,272,80,7,73,142,6,119,50,57,12,17,8,9,50,23,0,0,27
S01009903,Occupancy rating +2 or more,111,28,2,26,71,5,62,29,25,8,4,2,2,12,6,0,0,6
S01009903,Occupancy rating +1,58,22,1,21,26,1,23,14,8,1,2,1,1,10,7,0,0,3
S01009903,Occupancy rating 0,61,20,0,20,27,0,21,7,12,2,6,4,2,14,3,0,0,11
S01009903,Occupancy rating -1 or less,42,10,4,6,18,0,13,0,12,1,5,1,4,14,7,0,0,7
S01009904,All households,456,245,85,160,175,11,142,96,34,12,22,20,2,36,3,1,2,30
S01009904,Occupancy rating +2 or more,42,13,3,10,24,3,21,11,9,1,0,0,0,5,2,0,0,3
S01009904,Occupancy rating +1,127,74,12,62,53,2,50,40,6,4,1,0,1,0,0,0,0,0
S01009904,Occupancy rating 0,246,142,64,78,84,6,60,42,13,5,18,17,1,20,1,1,0,18
S01009904,Occupancy rating -1 or less,41,16,6,10,14,0,11,3,6,2,3,3,0,11,0,0,2,9
S01009905,All households,372,181,26,155,131,4,105,53,48,4,22,18,4,60,9,18,0,33
S01009905,Occupancy rating +2 or more,31,13,3,10,13,0,12,6,5,1,1,0,1,5,0,0,0,5
S01009905,Occupancy rating +1,116,74,10,64,34,3,31,26,4,1,0,0,0,8,1,3,0,4
S01009905,Occupancy rating 0,145,75,13,62,54,1,42,18,22,2,11,9,2,16,0,6,0,10
S01009905,Occupancy rating -1 or less,80,19,0,19,30,0,20,3,17,0,10,9,1,31,8,9,0,14
S01009906,All households,331,137,11,126,151,9,116,66,41,9,26,17,9,43,3,8,2,30
S01009906,Occupancy rating +2 or more,29,11,1,10,16,2,13,10,1,2,1,0,1,2,0,0,0,2
S01009906,Occupancy rating +1,75,36,4,32,35,4,30,27,3,0,1,0,1,4,0,0,0,4
S01009906,Occupancy rating 0,152,79,5,74,52,3,43,27,13,3,6,3,3,21,0,3,2,16
S01009906,Occupancy rating -1 or less,75,11,1,10,48,0,30,2,24,4,18,14,4,16,3,5,0,8
S01009907,All households,592,451,36,415,109,2,80,59,17,4,27,20,7,32,3,6,0,23
S01009907,Occupancy rating +2 or more,10,9,1,8,1,0,1,1,0,0,0,0,0,0,0,0,0,0
S01009907,Occupancy rating +1,40,26,0,26,12,0,9,8,0,1,3,1,2,2,0,0,0,2
S01009907,Occupancy rating 0,282,224,16,208,52,2,41,37,4,0,9,7,2,6,0,2,0,4
S01009907,Occupancy rating -1 or less,260,192,19,173,44,0,29,13,13,3,15,12,3,24,3,4,0,17
S01009908,All households,492,198,23,175,248,11,207,114,82,11,30,20,10,46,5,4,1,36
S01009908,Occupancy rating +2 or more,114,27,2,25,78,6,70,37,30,3,2,2,0,9,3,0,1,5
S01009908,Occupancy rating +1,136,67,8,59,63,3,58,44,12,2,2,1,1,6,1,1,0,4
S01009908,Occupancy rating 0,178,86,11,75,70,0,57,28,26,3,13,9,4,22,1,1,0,20
S01009908,Occupancy rating -1 or less,64,18,2,16,37,2,22,5,14,3,13,8,5,9,0,2,0,7
S01009909,All households,471,241,29,212,172,5,145,97,37,11,22,11,11,58,6,3,2,47
S01009909,Occupancy rating +2 or more,61,18,3,15,38,2,32,25,5,2,4,2,2,5,2,0,0,3
S01009909,Occupancy rating +1,117,58,9,49,51,2,46,37,7,2,3,2,1,8,0,0,1,7
S01009909,Occupancy rating 0,182,100,5,95,55,1,45,27,15,3,9,5,4,27,1,0,1,25
S01009909,Occupancy rating -1 or less,111,65,12,53,28,0,22,8,10,4,6,2,4,18,3,3,0,12
S01009910,All households,278,128,12,116,111,3,92,51,34,7,16,12,4,39,0,3,0,36
S01009910,Occupancy rating +2 or more,44,9,2,7,28,1,24,18,3,3,3,2,1,7,0,1,0,6
S01009910,Occupancy rating +1,85,50,2,48,27,1,26,19,5,2,0,0,0,8,0,0,0,8
S01009910,Occupancy rating 0,106,51,4,47,39,0,29,13,16,0,10,7,3,16,0,1,0,15
S01009910,Occupancy rating -1 or less,43,18,4,14,17,1,13,1,10,2,3,3,0,8,0,1,0,7
S01009911,All households,415,142,37,105,250,16,206,89,91,26,28,14,14,23,7,0,4,12
S01009911,Occupancy rating +2 or more,168,46,22,24,115,15,91,37,44,10,9,5,4,7,1,0,2,4
S01009911,Occupancy rating +1,119,48,12,36,67,1,59,37,15,7,7,2,5,4,2,0,0,2
S01009911,Occupancy rating 0,79,23,2,21,48,0,42,14,24,4,6,2,4,8,0,0,2,6
S01009911,Occupancy rating -1 or less,49,25,1,24,20,0,14,1,8,5,6,5,1,4,4,0,0,0
S01009912,All households,365,137,73,64,201,24,159,68,73,18,18,14,4,27,13,0,0,14
S01009912,Occupancy rating +2 or more,218,68,29,39,133,19,107,51,44,12,7,6,1,17,8,0,0,9
S01009912,Occupancy rating +1,75,35,16,19,38,4,30,11,17,2,4,1,3,2,0,0,0,2
S01009912,Occupancy rating 0,49,24,18,6,20,0,14,3,9,2,6,6,0,5,2,0,0,3
S01009912,Occupancy rating -1 or less,23,10,10,0,10,1,8,3,3,2,1,1,0,3,3,0,0,0
S01009913,All households,232,45,8,37,145,11,121,40,54,27,13,9,4,42,23,0,2,17
S01009913,Occupancy rating +2 or more,145,23,6,17,97,9,84,26,34,24,4,2,2,25,13,0,2,10
S01009913,Occupancy rating +1,39,9,1,8,21,1,16,5,9,2,4,2,2,9,5,0,0,4
S01009913,Occupancy rating 0,33,12,1,11,17,1,12,8,4,0,4,4,0,4,2,0,0,2
S01009913,Occupancy rating -1 or less,15,1,0,1,10,0,9,1,7,1,1,1,0,4,3,0,0,1
S01009914,All households,408,133,60,73,251,50,175,75,76,24,26,9,17,24,14,1,0,9
S01009914,Occupancy rating +2 or more,241,67,32,35,167,37,123,58,47,18,7,2,5,7,5,0,0,2
S01009914,Occupancy rating +1,110,57,28,29,49,11,30,15,14,1,8,4,4,4,2,1,0,1
S01009914,Occupancy rating 0,36,7,0,7,23,2,13,2,7,4,8,3,5,6,3,0,0,3
S01009914,Occupancy rating -1 or less,21,2,0,2,12,0,9,0,8,1,3,0,3,7,4,0,0,3
S01009915,All households,402,161,55,106,213,25,167,85,61,21,21,7,14,28,13,3,0,12
S01009915,Occupancy rating +2 or more,259,108,39,69,141,19,114,72,32,10,8,4,4,10,4,0,0,6
S01009915,Occupancy rating +1,97,47,15,32,45,6,30,12,11,7,9,2,7,5,1,1,0,3
S01009915,Occupancy rating 0,27,4,1,3,14,0,10,1,7,2,4,1,3,9,6,1,0,2
S01009915,Occupancy rating -1 or less,19,2,0,2,13,0,13,0,11,2,0,0,0,4,2,1,0,1
S01009916,All households,315,69,35,34,209,26,162,50,90,22,21,10,11,37,21,0,1,15
S01009916,Occupancy rating +2 or more,191,50,30,20,126,21,91,43,32,16,14,6,8,15,6,0,1,8
S01009916,Occupancy rating +1,68,17,5,12,41,5,35,3,26,6,1,0,1,10,6,0,0,4
S01009916,Occupancy rating 0,24,1,0,1,17,0,13,1,12,0,4,3,1,6,4,0,0,2
S01009916,Occupancy rating -1 or less,32,1,0,1,25,0,23,3,20,0,2,1,1,6,5,0,0,1
S01009917,All households,331,133,49,84,176,14,148,70,62,16,14,6,8,22,8,1,0,13
S01009917,Occupancy rating +2 or more,131,49,23,26,79,10,64,29,27,8,5,2,3,3,0,0,0,3
S01009917,Occupancy rating +1,101,50,15,35,47,2,44,28,13,3,1,1,0,4,1,0,0,3
S01009917,Occupancy rating 0,75,33,11,22,35,1,26,11,13,2,8,3,5,7,2,1,0,4
S01009917,Occupancy rating -1 or less,24,1,0,1,15,1,14,2,9,3,0,0,0,8,5,0,0,3
S01009918,All households,277,64,24,40,197,18,157,77,59,21,22,9,13,16,9,1,0,6
S01009918,Occupancy rating +2 or more,180,31,16,15,140,16,111,68,33,10,13,4,9,9,6,0,0,3
S01009918,Occupancy rating +1,55,19,5,14,33,2,28,5,16,7,3,2,1,3,1,0,0,2
S01009918,Occupancy rating 0,31,9,3,6,19,0,14,4,8,2,5,2,3,3,2,0,0,1
S01009918,Occupancy rating -1 or less,11,5,0,5,5,0,4,0,2,2,1,1,0,1,0,1,0,0
S01009919,All households,587,264,90,174,265,29,160,88,58,14,76,38,38,58,4,7,1,46
S01009919,Occupancy rating +2 or more,61,39,22,17,22,7,12,10,2,0,3,1,2,0,0,0,0,0
S01009919,Occupancy rating +1,204,97,51,46,92,12,67,45,17,5,13,3,10,15,0,1,0,14
S01009919,Occupancy rating 0,218,78,9,69,110,9,60,29,24,7,41,23,18,30,3,3,1,23
S01009919,Occupancy rating -1 or less,104,50,8,42,41,1,21,4,15,2,19,11,8,13,1,3,0,9
S01009920,All households,519,265,43,222,204,12,160,131,20,9,32,17,15,50,1,3,1,45
S01009920,Occupancy rating +2 or more,20,8,2,6,11,1,7,5,1,1,3,1,2,1,0,0,0,1
S01009920,Occupancy rating +1,177,94,15,79,79,7,71,67,2,2,1,0,1,4,1,0,0,3
S01009920,Occupancy rating 0,274,143,19,124,98,4,77,59,13,5,17,8,9,33,0,3,0,30
S01009920,Occupancy rating -1 or less,48,20,7,13,16,0,5,0,4,1,11,8,3,12,0,0,1,11
S01009921,All households,398,221,29,192,143,7,122,100,17,5,14,8,6,34,0,1,0,33
S01009921,Occupancy rating +2 or more,28,13,2,11,13,0,13,10,3,0,0,0,0,2,0,0,0,2
S01009921,Occupancy rating +1,115,64,8,56,46,3,41,40,0,1,2,0,2,5,0,0,0,5
S01009921,Occupancy rating 0,188,110,12,98,64,3,55,44,9,2,6,4,2,14,0,1,0,13
S01009921,Occupancy rating -1 or less,67,34,7,27,20,1,13,6,5,2,6,4,2,13,0,0,0,13
S01009922,All households,619,335,47,288,225,10,178,124,42,12,37,16,21,59,3,7,1,48
S01009922,Occupancy rating +2 or more,36,17,4,13,17,1,13,8,3,2,3,2,1,2,2,0,0,0
S01009922,Occupancy rating +1,224,134,19,115,87,4,81,72,4,5,2,0,2,3,0,0,0,3
S01009922,Occupancy rating 0,286,158,21,137,83,5,61,40,20,1,17,6,11,45,1,4,1,39
S01009922,Occupancy rating -1 or less,73,26,3,23,38,0,23,4,15,4,15,8,7,9,0,3,0,6
S01009923,All households,566,381,87,294,161,10,123,88,18,17,28,18,10,24,5,1,0,18
S01009923,Occupancy rating +2 or more,57,26,9,17,29,2,26,16,6,4,1,1,0,2,0,0,0,2
S01009923,Occupancy rating +1,112,68,21,47,41,5,33,27,1,5,3,1,2,3,1,0,0,2
S01009923,Occupancy rating 0,234,170,34,136,58,3,43,28,9,6,12,8,4,6,1,0,0,5
S01009923,Occupancy rating -1 or less,163,117,23,94,33,0,21,17,2,2,12,8,4,13,3,1,0,9
S01009924,All households,581,311,57,254,213,7,156,110,37,9,50,30,20,57,8,2,2,45
S01009924,Occupancy rating +2 or more,42,16,6,10,25,1,21,17,3,1,3,0,3,1,0,0,0,1
S01009924,Occupancy rating +1,149,93,20,73,51,1,47,38,7,2,3,1,2,5,1,0,0,4
S01009924,Occupancy rating 0,278,148,27,121,97,5,67,44,22,1,25,14,11,33,2,2,1,28
S01009924,Occupancy rating -1 or less,112,54,4,50,40,0,21,11,5,5,19,15,4,18,5,0,1,12
S01009925,All households,408,222,21,201,149,4,125,101,20,4,20,15,5,37,3,0,0,34
S01009925,Occupancy rating +2 or more,17,5,0,5,12,0,11,10,1,0,1,1,0,0,0,0,0,0
S01009925,Occupancy rating +1,88,49,6,43,37,0,35,32,2,1,2,1,1,2,1,0,0,1
S01009925,Occupancy rating 0,217,121,12,109,77,4,63,51,10,2,10,8,2,19,0,0,0,19
S01009925,Occupancy rating -1 or less,86,47,3,44,23,0,16,8,7,1,7,5,2,16,2,0,0,14
S01009926,All households,375,150,46,104,179,13,136,77,44,15,30,15,15,46,5,3,2,36
S01009926,Occupancy rating +2 or more,64,32,16,16,31,9,21,15,3,3,1,0,1,1,1,0,0,0
S01009926,Occupancy rating +1,128,62,18,44,52,2,46,30,10,6,4,1,3,14,1,1,1,11
S01009926,Occupancy rating 0,128,50,10,40,61,2,45,30,12,3,14,7,7,17,2,1,1,13
S01009926,Occupancy rating -1 or less,55,6,2,4,35,0,24,2,19,3,11,7,4,14,1,1,0,12
S01009927,All households,278,135,49,86,122,18,81,39,34,8,23,14,9,21,2,3,1,15
S01009927,Occupancy rating +2 or more,61,22,14,8,39,12,26,13,12,1,1,1,0,0,0,0,0,0
S01009927,Occupancy rating +1,75,45,13,32,28,4,20,12,6,2,4,2,2,2,0,0,0,2
S01009927,Occupancy rating 0,89,30,4,26,45,2,31,13,14,4,12,7,5,14,1,2,1,10
S01009927,Occupancy rating -1 or less,53,38,18,20,10,0,4,1,2,1,6,4,2,5,1,1,0,3
S01009928,All households,429,204,32,172,208,10,180,104,57,19,18,11,7,17,3,0,1,13
S01009928,Occupancy rating +2 or more,136,52,10,42,82,2,80,49,24,7,0,0,0,2,0,0,0,2
S01009928,Occupancy rating +1,148,75,11,64,70,6,60,40,13,7,4,2,2,3,0,0,0,3
S01009928,Occupancy rating 0,118,72,11,61,42,1,34,14,17,3,7,4,3,4,0,0,1,3
S01009928,Occupancy rating -1 or less,27,5,0,5,14,1,6,1,3,2,7,5,2,8,3,0,0,5
S01009929,All households,234,80,37,43,138,14,108,52,43,13,16,5,11,16,3,0,0,13
S01009929,Occupancy rating +2 or more,95,23,9,14,67,2,61,31,24,6,4,1,3,5,1,0,0,4
S01009929,Occupancy rating +1,60,25,15,10,33,6,23,13,7,3,4,0,4,2,0,0,0,2
S01009929,Occupancy rating 0,58,25,13,12,28,6,16,5,8,3,6,2,4,5,0,0,0,5
S01009929,Occupancy rating -1 or less,21,7,0,7,10,0,8,3,4,1,2,2,0,4,2,0,0,2
S01009930,All households,460,203,36,167,221,5,184,120,51,13,32,11,21,36,4,1,0,31
S01009930,Occupancy rating +2 or more,39,17,4,13,21,3,17,13,4,0,1,0,1,1,1,0,0,0
S01009930,Occupancy rating +1,148,64,13,51,82,1,79,67,8,4,2,0,2,2,0,0,0,2
S01009930,Occupancy rating 0,197,97,13,84,80,1,66,38,23,5,13,6,7,20,0,1,0,19
S01009930,Occupancy rating -1 or less,76,25,6,19,38,0,22,2,16,4,16,5,11,13,3,0,0,10
S01009931,All households,463,244,27,217,197,5,169,134,28,7,23,14,9,22,1,2,0,19
S01009931,Occupancy rating +2 or more,35,9,3,6,26,1,19,13,4,2,6,3,3,0,0,0,0,0
S01009931,Occupancy rating +1,153,78,8,70,74,0,71,64,4,3,3,1,2,1,0,1,0,0
S01009931,Occupancy rating 0,236,144,12,132,78,2,65,53,10,2,11,8,3,14,0,1,0,13
S01009931,Occupancy rating -1 or less,39,13,4,9,19,2,14,4,10,0,3,2,1,7,1,0,0,6
S01009932,All households,374,183,43,140,156,6,131,105,23,3,19,10,9,35,2,3,2,28
S01009932,Occupancy rating +2 or more,35,17,7,10,17,1,15,10,4,1,1,0,1,1,1,0,0,0
S01009932,Occupancy rating +1,145,84,25,59,57,4,52,51,1,0,1,1,0,4,0,1,1,2
S01009932,Occupancy rating 0,162,70,8,62,74,1,59,42,16,1,14,7,7,18,0,1,1,16
S01009932,Occupancy rating -1 or less,32,12,3,9,8,0,5,2,2,1,3,2,1,12,1,1,0,10
S01009933,All households,534,306,58,248,180,10,103,56,39,8,67,45,22,48,15,3,1,29
S01009933,Occupancy rating +2 or more,43,28,7,21,14,2,11,9,1,1,1,1,0,1,1,0,0,0
S01009933,Occupancy rating +1,195,152,34,118,37,5,28,25,3,0,4,3,1,6,0,1,1,4
S01009933,Occupancy rating 0,191,85,11,74,91,3,47,14,28,5,41,23,18,15,3,0,0,12
S01009933,Occupancy rating -1 or less,105,41,6,35,38,0,17,8,7,2,21,18,3,26,11,2,0,13
S01009934,All households,436,165,53,112,227,13,180,85,77,18,34,22,12,44,11,2,3,28
S01009934,Occupancy rating +2 or more,136,45,25,20,81,8,69,36,23,10,4,2,2,10,4,0,2,4
S01009934,Occupancy rating +1,120,55,14,41,60,2,52,27,21,4,6,4,2,5,2,0,0,3
S01009934,Occupancy rating 0,127,44,12,32,62,2,46,19,23,4,14,9,5,21,3,1,1,16
S01009934,Occupancy rating -1 or less,53,21,2,19,24,1,13,3,10,0,10,7,3,8,2,1,0,5
S01009935,All households,386,274,119,155,102,18,47,26,10,11,37,21,16,10,2,0,1,7
S01009935,Occupancy rating +2 or more,29,18,12,6,11,5,5,3,1,1,1,0,1,0,0,0,0,0
S01009935,Occupancy rating +1,83,56,30,26,26,4,18,12,3,3,4,1,3,1,0,0,0,1
S01009935,Occupancy rating 0,177,131,60,71,44,7,19,10,4,5,18,12,6,2,0,0,0,2
S01009935,Occupancy rating -1 or less,97,69,17,52,21,2,5,1,2,2,14,8,6,7,2,0,1,4
S01009936,All households,397,262,75,187,117,5,80,54,24,2,32,17,15,18,8,1,0,9
S01009936,Occupancy rating +2 or more,32,10,2,8,17,1,16,6,10,0,0,0,0,5,3,0,0,2
S01009936,Occupancy rating +1,89,69,19,50,18,1,16,12,4,0,1,0,1,2,1,0,0,1
S01009936,Occupancy rating 0,180,114,29,85,63,2,35,26,7,2,26,14,12,3,1,1,0,1
S01009936,Occupancy rating -1 or less,96,69,25,44,19,1,13,10,3,0,5,3,2,8,3,0,0,5
S01009937,All households,266,139,68,71,111,8,46,10,28,8,57,45,12,16,3,1,1,11
S01009937,Occupancy rating +2 or more,23,11,7,4,12,2,8,1,4,3,2,0,2,0,0,0,0,0
S01009937,Occupancy rating +1,66,50,16,34,16,3,11,8,1,2,2,1,1,0,0,0,0,0
S01009937,Occupancy rating 0,94,53,34,19,35,1,13,0,11,2,21,17,4,6,0,0,1,5
S01009937,Occupancy rating -1 or less,83,25,11,14,48,2,14,1,12,1,32,27,5,10,3,1,0,6
S01009938,All households,570,344,171,173,201,37,100,52,31,17,64,41,23,25,12,0,1,12
S01009938,Occupancy rating +2 or more,70,48,21,27,22,9,11,6,4,1,2,2,0,0,0,0,0,0
S01009938,Occupancy rating +1,181,102,42,60,77,11,47,34,6,7,19,8,11,2,0,0,0,2
S01009938,Occupancy rating 0,239,153,81,72,75,17,28,9,12,7,30,23,7,11,4,0,1,6
S01009938,Occupancy rating -1 or less,80,41,27,14,27,0,14,3,9,2,13,8,5,12,8,0,0,4
S01009939,All households,521,314,36,278,187,7,77,28,42,7,103,84,19,20,10,1,1,8
S01009939,Occupancy rating +2 or more,24,19,4,15,5,0,5,3,2,0,0,0,0,0,0,0,0,0
S01009939,Occupancy rating +1,151,119,13,106,31,4,19,15,3,1,8,3,5,1,0,0,0,1
S01009939,Occupancy rating 0,186,82,13,69,94,3,34,8,20,6,57,47,10,10,2,1,1,6
S01009939,Occupancy rating -1 or less,160,94,6,88,57,0,19,2,17,0,38,34,4,9,8,0,0,1
S01009940,All households,438,203,67,136,210,17,93,38,30,25,100,74,26,25,10,1,0,14
S01009940,Occupancy rating +2 or more,29,11,4,7,16,1,10,8,1,1,5,3,2,2,1,0,0,1
S01009940,Occupancy rating +1,161,112,42,70,47,11,27,22,2,3,9,6,3,2,0,0,0,2
S01009940,Occupancy rating 0,141,39,8,31,96,3,36,4,19,13,57,46,11,6,0,0,0,6
S01009940,Occupancy rating -1 or less,107,41,13,28,51,2,20,4,8,8,29,19,10,15,9,1,0,5
S01009941,All households,320,45,12,33,252,10,207,47,127,33,35,27,8,23,12,0,0,11
S01009941,Occupancy rating +2 or more,130,19,6,13,104,7,89,28,49,12,8,6,2,7,2,0,0,5
S01009941,Occupancy rating +1,96,20,6,14,70,1,59,16,31,12,10,8,2,6,2,0,0,4
S01009941,Occupancy rating 0,66,4,0,4,54,1,43,3,33,7,10,8,2,8,6,0,0,2
S01009941,Occupancy rating -1 or less,28,2,0,2,24,1,16,0,14,2,7,5,2,2,2,0,0,0
S01009942,All households,486,211,74,137,228,26,115,37,56,22,87,58,29,47,20,0,2,25
S01009942,Occupancy rating +2 or more,80,46,19,27,30,11,16,13,3,0,3,1,2,4,0,0,0,4
S01009942,Occupancy rating +1,162,91,37,54,63,13,39,20,11,8,11,4,7,8,3,0,0,5
S01009942,Occupancy rating 0,135,27,7,20,91,1,37,3,24,10,53,37,16,17,3,0,2,12
S01009942,Occupancy rating -1 or less,109,47,11,36,44,1,23,1,18,4,20,16,4,18,14,0,0,4
S01009943,All households,424,172,65,107,232,24,101,39,44,18,107,78,29,20,4,7,1,8
S01009943,Occupancy rating +2 or more,39,22,7,15,17,4,11,8,3,0,2,1,1,0,0,0,0,0
S01009943,Occupancy rating +1,161,104,38,66,57,14,35,24,3,8,8,5,3,0,0,0,0,0
S01009943,Occupancy rating 0,144,31,13,18,104,4,40,5,28,7,60,45,15,9,0,4,1,4
S01009943,Occupancy rating -1 or less,80,15,7,8,54,2,15,2,10,3,37,27,10,11,4,3,0,4
S01009944,All households,344,121,53,68,194,23,105,27,46,32,66,41,25,29,19,0,0,10
S01009944,Occupancy rating +2 or more,94,46,20,26,46,14,31,17,9,5,1,1,0,2,1,0,0,1
S01009944,Occupancy rating +1,119,48,18,30,67,7,38,9,13,16,22,14,8,4,2,0,0,2
S01009944,Occupancy rating 0,82,14,4,10,58,2,28,1,17,10,28,17,11,10,4,0,0,6
S01009944,Occupancy rating -1 or less,49,13,11,2,23,0,8,0,7,1,15,9,6,13,12,0,0,1
S01009945,All households,500,229,95,134,244,20,109,41,47,21,115,77,38,27,6,4,1,16
S01009945,Occupancy rating +2 or more,81,53,20,33,25,5,17,14,2,1,3,3,0,3,1,2,0,0
S01009945,Occupancy rating +1,195,122,51,71,68,13,42,22,14,6,13,11,2,5,1,1,0,3
S01009945,Occupancy rating 0,159,34,13,21,114,2,40,4,25,11,72,47,25,11,3,0,1,7
S01009945,Occupancy rating -1 or less,65,20,11,9,37,0,10,1,6,3,27,16,11,8,1,1,0,6
S01009946,All households,348,110,48,62,210,22,127,43,57,27,61,36,25,28,14,1,2,11
S01009946,Occupancy rating +2 or more,122,67,32,35,54,13,39,29,6,4,2,2,0,1,0,0,0,1
S01009946,Occupancy rating +1,115,29,13,16,77,6,48,14,21,13,23,10,13,9,1,1,2,5
S01009946,Occupancy rating 0,76,12,1,11,52,2,26,0,19,7,24,16,8,12,8,0,0,4
S01009946,Occupancy rating -1 or less,35,2,2,0,27,1,14,0,11,3,12,8,4,6,5,0,0,1
S01009947,All households,266,103,47,56,153,15,98,35,38,25,40,20,20,10,3,0,0,7
S01009947,Occupancy rating +2 or more,84,48,27,21,36,10,25,14,7,4,1,0,1,0,0,0,0,0
S01009947,Occupancy rating +1,93,31,10,21,58,5,32,17,4,11,21,6,15,4,0,0,0,4
S01009947,Occupancy rating 0,54,7,4,3,44,0,30,4,21,5,14,11,3,3,2,0,0,1
S01009947,Occupancy rating -1 or less,35,17,6,11,15,0,11,0,6,5,4,3,1,3,1,0,0,2
S01009948,All households,431,224,91,133,189,19,90,38,35,17,80,53,27,18,4,1,2,11
S01009948,Occupancy rating +2 or more,64,34,12,22,26,8,15,13,2,0,3,2,1,4,1,0,0,3
S01009948,Occupancy rating +1,141,75,34,41,62,9,33,15,12,6,20,9,11,4,0,0,0,4
S01009948,Occupancy rating 0,152,69,32,37,76,0,35,7,18,10,41,30,11,7,1,1,1,4
S01009948,Occupancy rating -1 or less,74,46,13,33,25,2,7,3,3,1,16,12,4,3,2,0,1,0
S01009949,All households,368,137,65,72,206,27,107,30,54,23,72,40,32,25,8,1,1,15
S01009949,Occupancy rating +2 or more,100,64,27,37,34,11,20,12,4,4,3,1,2,2,1,0,0,1
S01009949,Occupancy rating +1,123,49,28,21,68,9,42,14,18,10,17,9,8,6,1,1,0,4
S01009949,Occupancy rating 0,93,10,7,3,76,4,37,3,27,7,35,21,14,7,1,0,1,5
S01009949,Occupancy rating -1 or less,52,14,3,11,28,3,8,1,5,2,17,9,8,10,5,0,0,5
S01009950,All households,256,45,29,16,199,26,153,49,75,29,20,6,14,12,6,1,0,5
S01009950,Occupancy rating +2 or more,209,40,26,14,162,25,123,47,54,22,14,2,12,7,2,0,0,5
S01009950,Occupancy rating +1,29,4,3,1,23,1,20,2,15,3,2,1,1,2,2,0,0,0
S01009950,Occupancy rating 0,11,1,0,1,9,0,8,0,5,3,1,1,0,1,1,0,0,0
S01009950,Occupancy rating -1 or less,7,0,0,0,5,0,2,0,1,1,3,2,1,2,1,1,0,0
S01009951,All households,259,40,18,22,199,23,162,55,72,35,14,8,6,20,14,0,0,6
S01009951,Occupancy rating +2 or more,222,33,16,17,176,23,145,54,63,28,8,4,4,13,8,0,0,5
S01009951,Occupancy rating +1,16,4,2,2,11,0,10,1,5,4,1,0,1,1,1,0,0,0
S01009951,Occupancy rating 0,8,0,0,0,7,0,5,0,3,2,2,1,1,1,1,0,0,0
S01009951,Occupancy rating -1 or less,13,3,0,3,5,0,2,0,1,1,3,3,0,5,4,0,0,1
S01009952,All households,311,97,70,27,197,20,156,59,71,26,21,14,7,17,8,0,3,6
S01009952,Occupancy rating +2 or more,179,37,20,17,138,13,115,53,44,18,10,7,3,4,1,0,1,2
S01009952,Occupancy rating +1,62,25,19,6,32,1,26,3,16,7,5,3,2,5,2,0,1,2
S01009952,Occupancy rating 0,55,29,25,4,23,6,13,2,10,1,4,3,1,3,0,0,1,2
S01009952,Occupancy rating -1 or less,15,6,6,0,4,0,2,1,1,0,2,1,1,5,5,0,0,0
S01009953,All households,358,96,35,61,236,37,163,59,74,30,36,17,19,26,14,0,2,10
S01009953,Occupancy rating +2 or more,183,42,18,24,127,22,92,39,42,11,13,5,8,14,7,0,1,6
S01009953,Occupancy rating +1,106,37,12,25,67,11,45,18,15,12,11,5,6,2,2,0,0,0
S01009953,Occupancy rating 0,48,14,5,9,28,4,20,1,13,6,4,1,3,6,3,0,1,2
S01009953,Occupancy rating -1 or less,21,3,0,3,14,0,6,1,4,1,8,6,2,4,2,0,0,2
S01009954,All households,214,47,20,27,138,10,119,38,59,22,9,6,3,29,16,4,1,8
S01009954,Occupancy rating +2 or more,131,18,10,8,103,8,89,33,38,18,6,5,1,10,3,0,1,6
S01009954,Occupancy rating +1,44,16,6,10,20,2,17,4,11,2,1,1,0,8,6,1,0,1
S01009954,Occupancy rating 0,32,13,4,9,12,0,10,1,8,1,2,0,2,7,4,2,0,1
S01009954,Occupancy rating -1 or less,7,0,0,0,3,0,3,0,2,1,0,0,0,4,3,1,0,0
S01009955,All households,447,199,82,117,230,31,157,58,73,26,42,27,15,18,6,0,0,12
S01009955,Occupancy rating +2 or more,149,48,23,25,93,13,74,28,38,8,6,5,1,8,1,0,0,7
S01009955,Occupancy rating +1,128,64,33,31,61,15,36,16,10,10,10,5,5,3,2,0,0,1
S01009955,Occupancy rating 0,114,54,18,36,54,3,34,12,16,6,17,11,6,6,2,0,0,4
S01009955,Occupancy rating -1 or less,56,33,8,25,22,0,13,2,9,2,9,6,3,1,1,0,0,0
S01009956,All households,324,110,52,58,183,20,112,39,45,28,51,37,14,31,12,0,1,18
S01009956,Occupancy rating +2 or more,116,51,26,25,61,14,46,26,10,10,1,1,0,4,1,0,0,3
S01009956,Occupancy rating +1,113,50,20,30,55,5,28,12,7,9,22,15,7,8,0,0,1,7
S01009956,Occupancy rating 0,64,5,3,2,47,1,25,1,18,6,21,16,5,12,6,0,0,6
S01009956,Occupancy rating -1 or less,31,4,3,1,20,0,13,0,10,3,7,5,2,7,5,0,0,2
S01009957,All households,294,68,33,35,212,27,170,57,77,36,15,6,9,14,6,0,0,8
S01009957,Occupancy rating +2 or more,207,34,17,17,167,18,139,49,62,28,10,4,6,6,2,0,0,4
S01009957,Occupancy rating +1,63,29,14,15,31,8,19,8,7,4,4,2,2,3,0,0,0,3
S01009957,Occupancy rating 0,16,5,2,3,9,1,7,0,3,4,1,0,1,2,2,0,0,0
S01009957,Occupancy rating -1 or less,8,0,0,0,5,0,5,0,5,0,0,0,0,3,2,0,0,1
S01009958,All households,371,79,28,51,273,30,210,85,88,37,33,15,18,19,6,0,0,13
S01009958,Occupancy rating +2 or more,241,58,25,33,180,26,138,70,49,19,16,10,6,3,1,0,0,2
S01009958,Occupancy rating +1,84,17,2,15,61,4,47,10,24,13,10,4,6,6,1,0,0,5
S01009958,Occupancy rating 0,35,3,1,2,26,0,20,4,13,3,6,0,6,6,1,0,0,5
S01009958,Occupancy rating -1 or less,11,1,0,1,6,0,5,1,2,2,1,1,0,4,3,0,0,1
S01009959,All households,288,100,58,42,183,32,129,50,50,29,22,9,13,5,3,0,0,2
S01009959,Occupancy rating +2 or more,184,58,38,20,124,24,92,38,35,19,8,3,5,2,1,0,0,1
S01009959,Occupancy rating +1,65,25,14,11,37,7,21,9,6,6,9,1,8,3,2,0,0,1
S01009959,Occupancy rating 0,29,12,5,7,17,1,11,3,5,3,5,5,0,0,0,0,0,0
S01009959,Occupancy rating -1 or less,10,5,1,4,5,0,5,0,4,1,0,0,0,0,0,0,0,0
S01009960,All households,395,155,121,34,222,30,170,54,80,36,22,12,10,18,5,1,0,12
S01009960,Occupancy rating +2 or more,194,26,16,10,160,17,132,46,63,23,11,5,6,8,3,0,0,5
S01009960,Occupancy rating +1,80,42,27,15,33,9,20,7,6,7,4,2,2,5,1,0,0,4
S01009960,Occupancy rating 0,93,73,67,6,18,2,11,0,7,4,5,3,2,2,0,0,0,2
S01009960,Occupancy rating -1 or less,28,14,11,3,11,2,7,1,4,2,2,2,0,3,1,1,0,1
S01009961,All households,293,99,56,43,174,22,111,34,51,26,41,15,26,20,2,0,3,15
S01009961,Occupancy rating +2 or more,135,54,35,19,71,18,45,23,13,9,8,2,6,10,2,0,2,6
S01009961,Occupancy rating +1,98,39,21,18,58,4,40,9,20,11,14,6,8,1,0,0,0,1
S01009961,Occupancy rating 0,43,1,0,1,35,0,21,2,13,6,14,6,8,7,0,0,0,7
S01009961,Occupancy rating -1 or less,17,5,0,5,10,0,5,0,5,0,5,1,4,2,0,0,1,1
S01009962,All households,599,332,70,262,245,26,158,97,40,21,61,34,27,22,4,0,2,16
S01009962,Occupancy rating +2 or more,60,21,7,14,38,7,29,16,7,6,2,0,2,1,0,0,0,1
S01009962,Occupancy rating +1,185,107,28,79,77,14,56,42,6,8,7,3,4,1,0,0,0,1
S01009962,Occupancy rating 0,229,132,27,105,87,4,52,26,20,6,31,17,14,10,1,0,1,8
S01009962,Occupancy rating -1 or less,125,72,8,64,43,1,21,13,7,1,21,14,7,10,3,0,1,6
S01009963,All households,301,64,38,26,216,28,166,54,74,38,22,9,13,21,9,1,1,10
S01009963,Occupancy rating +2 or more,177,46,30,16,125,25,91,47,32,12,9,4,5,6,1,0,1,4
S01009963,Occupancy rating +1,87,17,7,10,62,2,53,7,31,15,7,2,5,8,3,0,0,5
S01009963,Occupancy rating 0,30,0,0,0,25,1,19,0,10,9,5,2,3,5,3,1,0,1
S01009963,Occupancy rating -1 or less,7,1,1,0,4,0,3,0,1,2,1,1,0,2,2,0,0,0
S01009964,All households,344,79,24,55,249,22,193,70,87,36,34,19,15,16,10,0,0,6
S01009964,Occupancy rating +2 or more,160,17,9,8,135,15,111,42,47,22,9,5,4,8,5,0,0,3
S01009964,Occupancy rating +1,90,43,12,31,46,6,38,18,12,8,2,1,1,1,1,0,0,0
S01009964,Occupancy rating 0,60,9,1,8,47,1,32,10,18,4,14,7,7,4,1,0,0,3
S01009964,Occupancy rating -1 or less,34,10,2,8,21,0,12,0,10,2,9,6,3,3,3,0,0,0
S01009965,All households,298,82,55,27,201,35,146,55,55,36,20,10,10,15,5,1,1,8
S01009965,Occupancy rating +2 or more,144,28,17,11,112,24,80,42,24,14,8,4,4,4,1,0,0,3
S01009965,Occupancy rating +1,77,23,12,11,51,9,39,11,15,13,3,1,2,3,0,0,1,2
S01009965,Occupancy rating 0,47,17,13,4,25,1,18,2,10,6,6,3,3,5,2,0,0,3
S01009965,Occupancy rating -1 or less,30,14,13,1,13,1,9,0,6,3,3,2,1,3,2,1,0,0
S01009966,All households,292,46,24,22,230,30,172,55,68,49,28,12,16,16,8,2,1,5
S01009966,Occupancy rating +2 or more,110,28,15,13,80,14,58,30,15,13,8,3,5,2,0,0,1,1
S01009966,Occupancy rating +1,88,15,9,6,72,14,53,19,19,15,5,3,2,1,1,0,0,0
S01009966,Occupancy rating 0,66,2,0,2,57,2,47,6,24,17,8,2,6,7,4,1,0,2
S01009966,Occupancy rating -1 or less,28,1,0,1,21,0,14,0,10,4,7,4,3,6,3,1,0,2
S01009967,All households,383,148,54,94,227,40,158,68,56,34,29,12,17,8,3,1,1,3
S01009967,Occupancy rating +2 or more,177,40,17,23,135,32,96,41,40,15,7,2,5,2,1,0,1,0
S01009967,Occupancy rating +1,124,67,27,40,55,7,40,23,7,10,8,4,4,2,0,0,0,2
S01009967,Occupancy rating 0,46,22,7,15,21,1,10,2,3,5,10,5,5,3,1,1,0,1
S01009967,Occupancy rating -1 or less,36,19,3,16,16,0,12,2,6,4,4,1,3,1,1,0,0,0
S01009968,All households,232,50,34,16,166,24,123,33,45,45,19,10,9,16,5,1,1,9
S01009968,Occupancy rating +2 or more,99,31,25,6,66,16,45,19,10,16,5,3,2,2,0,0,1,1
S01009968,Occupancy rating +1,70,13,6,7,52,6,41,12,14,15,5,2,3,5,0,0,0,5
S01009968,Occupancy rating 0,37,1,1,0,30,2,25,1,12,12,3,1,2,6,3,0,0,3
S01009968,Occupancy rating -1 or less,26,5,2,3,18,0,12,1,9,2,6,4,2,3,2,1,0,0
S01009969,All households,364,117,65,52,229,42,159,57,81,21,28,18,10,18,6,3,1,8
S01009969,Occupancy rating +2 or more,237,62,38,24,167,34,120,48,64,8,13,9,4,8,2,0,0,6
S01009969,Occupancy rating +1,51,22,9,13,27,2,19,8,6,5,6,3,3,2,0,1,1,0
S01009969,Occupancy rating 0,49,20,11,9,27,5,16,1,10,5,6,4,2,2,2,0,0,0
S01009969,Occupancy rating -1 or less,27,13,7,6,8,1,4,0,1,3,3,2,1,6,2,2,0,2
S01009970,All households,476,222,89,133,238,15,89,23,46,20,134,95,39,16,2,1,1,12
S01009970,Occupancy rating +2 or more,58,40,10,30,18,8,9,8,1,0,1,1,0,0,0,0,0,0
S01009970,Occupancy rating +1,169,115,38,77,52,5,28,13,6,9,19,12,7,2,0,0,0,2
S01009970,Occupancy rating 0,181,50,34,16,122,2,38,1,32,5,82,59,23,9,1,0,1,7
S01009970,Occupancy rating -1 or less,68,17,7,10,46,0,14,1,7,6,32,23,9,5,1,1,0,3
S01009971,All households,488,167,45,122,298,17,170,59,74,37,111,72,39,23,11,2,0,10
S01009971,Occupancy rating +2 or more,97,28,7,21,66,4,51,26,17,8,11,7,4,3,1,1,0,1
S01009971,Occupancy rating +1,186,99,27,72,81,9,56,26,14,16,16,9,7,6,3,0,0,3
S01009971,Occupancy rating 0,146,26,8,18,111,4,48,7,32,9,59,39,20,9,3,1,0,5
S01009971,Occupancy rating -1 or less,59,14,3,11,40,0,15,0,11,4,25,17,8,5,4,0,0,1
S01009972,All households,364,124,63,61,231,26,153,60,67,26,52,39,13,9,2,0,0,7
S01009972,Occupancy rating +2 or more,154,41,17,24,112,17,84,39,31,14,11,9,2,1,0,0,0,1
S01009972,Occupancy rating +1,92,34,15,19,57,6,39,17,16,6,12,8,4,1,0,0,0,1
S01009972,Occupancy rating 0,70,20,14,6,46,2,22,4,12,6,22,15,7,4,1,0,0,3
S01009972,Occupancy rating -1 or less,48,29,17,12,16,1,8,0,8,0,7,7,0,3,1,0,0,2
S01009973,All households,283,58,13,45,207,5,136,38,66,32,66,40,26,18,11,0,0,7
S01009973,Occupancy rating +2 or more,58,11,1,10,44,1,37,15,17,5,6,2,4,3,2,0,0,1
S01009973,Occupancy rating +1,112,41,11,30,68,3,51,22,19,10,14,8,6,3,2,0,0,1
S01009973,Occupancy rating 0,92,5,1,4,78,1,41,0,26,15,36,24,12,9,5,0,0,4
S01009973,Occupancy rating -1 or less,21,1,0,1,17,0,7,1,4,2,10,6,4,3,2,0,0,1
S01009974,All households,294,110,39,71,171,8,70,24,30,16,93,65,28,13,4,0,0,9
S01009974,Occupancy rating +2 or more,31,14,5,9,17,4,9,6,1,2,4,4,0,0,0,0,0,0
S01009974,Occupancy rating +1,93,57,22,35,34,2,19,14,3,2,13,7,6,2,1,0,0,1
S01009974,Occupancy rating 0,122,24,5,19,91,1,35,4,22,9,55,39,16,7,2,0,0,5
S01009974,Occupancy rating -1 or less,48,15,7,8,29,1,7,0,4,3,21,15,6,4,1,0,0,3
S01009975,All households,398,191,78,113,182,9,75,29,27,19,98,61,37,25,15,0,1,9
S01009975,Occupancy rating +2 or more,52,23,9,14,25,1,14,8,4,2,10,6,4,4,1,0,1,2
S01009975,Occupancy rating +1,115,75,29,46,35,3,18,11,3,4,14,6,8,5,2,0,0,3
S01009975,Occupancy rating 0,168,74,33,41,89,4,33,7,15,11,52,33,19,5,2,0,0,3
S01009975,Occupancy rating -1 or less,63,19,7,12,33,1,10,3,5,2,22,16,6,11,10,0,0,1
S01009976,All households,255,120,29,91,128,4,61,23,28,10,63,48,15,7,5,0,0,2
S01009976,Occupancy rating +2 or more,20,11,2,9,9,1,5,3,1,1,3,1,2,0,0,0,0,0
S01009976,Occupancy rating +1,89,63,11,52,26,3,19,15,2,2,4,4,0,0,0,0,0,0
S01009976,Occupancy rating 0,103,34,13,21,67,0,28,5,17,6,39,29,10,2,2,0,0,0
S01009976,Occupancy rating -1 or less,43,12,3,9,26,0,9,0,8,1,17,14,3,5,3,0,0,2
S01009977,All households,555,337,113,224,196,24,80,38,22,20,92,43,49,22,9,2,1,10
S01009977,Occupancy rating +2 or more,41,20,2,18,21,3,15,10,2,3,3,0,3,0,0,0,0,0
S01009977,Occupancy rating +1,154,106,39,67,47,9,20,14,2,4,18,8,10,1,1,0,0,0
S01009977,Occupancy rating 0,217,120,41,79,88,6,33,13,13,7,49,25,24,9,4,1,0,4
S01009977,Occupancy rating -1 or less,143,91,31,60,40,6,12,1,5,6,22,10,12,12,4,1,1,6
S01009978,All households,444,156,27,129,261,5,128,33,73,22,128,87,41,27,11,2,0,14
S01009978,Occupancy rating +2 or more,51,24,6,18,27,0,19,10,8,1,8,5,3,0,0,0,0,0
S01009978,Occupancy rating +1,133,65,13,52,62,4,40,18,13,9,18,13,5,6,1,0,0,5
S01009978,Occupancy rating 0,188,56,8,48,121,0,46,3,33,10,75,52,23,11,3,1,0,7
S01009978,Occupancy rating -1 or less,72,11,0,11,51,1,23,2,19,2,27,17,10,10,7,1,0,2
S01009979,All households,258,127,43,84,121,8,58,24,15,19,55,27,28,10,4,1,1,4
S01009979,Occupancy rating +2 or more,23,14,3,11,8,1,6,3,2,1,1,0,1,1,0,0,0,1
S01009979,Occupancy rating +1,104,57,19,38,45,6,28,20,3,5,11,6,5,2,1,1,0,0
S01009979,Occupancy rating 0,83,32,11,21,47,0,18,1,8,9,29,13,16,4,1,0,1,2
S01009979,Occupancy rating -1 or less,48,24,10,14,21,1,6,0,2,4,14,8,6,3,2,0,0,1
S01009980,All households,250,84,35,49,145,7,61,22,21,18,77,49,28,21,5,3,1,12
S01009980,Occupancy rating +2 or more,31,14,7,7,13,1,6,4,0,2,6,4,2,4,0,0,1,3
S01009980,Occupancy rating +1,99,52,19,33,38,4,27,15,6,6,7,4,3,9,1,2,0,6
S01009980,Occupancy rating 0,81,14,8,6,63,0,20,1,10,9,43,29,14,4,1,1,0,2
S01009980,Occupancy rating -1 or less,39,4,1,3,31,2,8,2,5,1,21,12,9,4,3,0,0,1
S01009981,All households,303,117,43,74,170,5,83,28,42,13,82,53,29,16,11,1,0,4
S01009981,Occupancy rating +2 or more,36,18,3,15,18,1,13,8,3,2,4,1,3,0,0,0,0,0
S01009981,Occupancy rating +1,108,68,25,43,38,3,24,15,8,1,11,7,4,2,0,0,0,2
S01009981,Occupancy rating 0,107,19,9,10,85,0,31,2,22,7,54,38,16,3,2,1,0,0
S01009981,Occupancy rating -1 or less,52,12,6,6,29,1,15,3,9,3,13,7,6,11,9,0,0,2
S01009982,All households,428,119,23,96,293,9,151,50,74,27,133,96,37,16,9,1,0,6
S01009982,Occupancy rating +2 or more,79,18,3,15,60,3,40,21,14,5,17,14,3,1,0,1,0,0
S01009982,Occupancy rating +1,153,64,14,50,85,5,57,25,21,11,23,14,9,4,1,0,0,3
S01009982,Occupancy rating 0,134,24,5,19,109,0,39,3,25,11,70,57,13,1,1,0,0,0
S01009982,Occupancy rating -1 or less,62,13,1,12,39,1,15,1,14,0,23,11,12,10,7,0,0,3
S01009983,All households,289,138,16,122,134,2,43,10,28,5,89,74,15,17,5,1,0,11
S01009983,Occupancy rating +2 or more,15,12,1,11,3,0,2,2,0,0,1,1,0,0,0,0,0,0
S01009983,Occupancy rating +1,92,60,7,53,29,1,9,4,5,0,19,15,4,3,0,1,0,2
S01009983,Occupancy rating 0,121,45,5,40,69,0,20,3,13,4,49,40,9,7,2,0,0,5
S01009983,Occupancy rating -1 or less,61,21,3,18,33,1,12,1,10,1,20,18,2,7,3,0,0,4
S01009984,All households,350,143,27,116,190,4,124,40,70,14,62,51,11,17,7,0,1,9
S01009984,Occupancy rating +2 or more,38,18,5,13,20,2,17,13,4,0,1,1,0,0,0,0,0,0
S01009984,Occupancy rating +1,116,64,10,54,51,2,40,20,15,5,9,8,1,1,0,0,0,1
S01009984,Occupancy rating 0,133,41,6,35,88,0,52,5,42,5,36,30,6,4,1,0,0,3
S01009984,Occupancy rating -1 or less,63,20,6,14,31,0,15,2,9,4,16,12,4,12,6,0,1,5
S01009985,All households,270,107,10,97,139,3,69,26,28,15,67,46,21,24,18,0,1,5
S01009985,Occupancy rating +2 or more,40,8,1,7,32,3,20,11,5,4,9,3,6,0,0,0,0,0
S01009985,Occupancy rating +1,85,46,6,40,34,0,21,9,7,5,13,6,7,5,4,0,0,1
S01009985,Occupancy rating 0,101,39,2,37,57,0,21,5,11,5,36,29,7,5,4,0,0,1
S01009985,Occupancy rating -1 or less,44,14,1,13,16,0,7,1,5,1,9,8,1,14,10,0,1,3
S01009986,All households,280,115,32,83,149,14,51,19,18,14,84,49,35,16,8,0,0,8
S01009986,Occupancy rating +2 or more,25,14,2,12,11,2,9,5,1,3,0,0,0,0,0,0,0,0
S01009986,Occupancy rating +1,111,71,22,49,37,7,17,13,1,3,13,3,10,3,1,0,0,2
S01009986,Occupancy rating 0,106,22,5,17,79,3,20,1,12,7,56,37,19,5,1,0,0,4
S01009986,Occupancy rating -1 or less,38,8,3,5,22,2,5,0,4,1,15,9,6,8,6,0,0,2
S01009987,All households,472,240,136,104,214,24,115,49,39,27,75,45,30,18,8,0,1,9
S01009987,Occupancy rating +2 or more,47,28,9,19,17,2,14,12,1,1,1,0,1,2,0,0,0,2
S01009987,Occupancy rating +1,185,105,47,58,80,16,50,32,10,8,14,9,5,0,0,0,0,0
S01009987,Occupancy rating 0,156,69,54,15,80,4,35,3,19,13,41,22,19,7,1,0,1,5
S01009987,Occupancy rating -1 or less,84,38,26,12,37,2,16,2,9,5,19,14,5,9,7,0,0,2
S01009988,All households,270,120,59,61,134,14,54,23,17,14,66,28,38,16,3,1,2,10
S01009988,Occupancy rating +2 or more,17,11,5,6,6,1,4,4,0,0,1,1,0,0,0,0,0,0
S01009988,Occupancy rating +1,126,87,42,45,34,8,20,15,1,4,6,3,3,5,0,1,1,3
S01009988,Occupancy rating 0,99,15,7,8,75,5,24,3,12,9,46,18,28,9,1,0,1,7
S01009988,Occupancy rating -1 or less,28,7,5,2,19,0,6,1,4,1,13,6,7,2,2,0,0,0
S01009989,All households,354,112,46,66,216,17,127,49,52,26,72,40,32,26,11,1,1,13
S01009989,Occupancy rating +2 or more,116,57,21,36,59,11,39,34,2,3,9,2,7,0,0,0,0,0
S01009989,Occupancy rating +1,128,44,20,24,72,4,40,12,15,13,28,20,8,12,2,1,1,8
S01009989,Occupancy rating 0,78,8,5,3,62,2,35,3,26,6,25,12,13,8,5,0,0,3
S01009989,Occupancy rating -1 or less,32,3,0,3,23,0,13,0,9,4,10,6,4,6,4,0,0,2
S01009990,All households,302,87,19,68,202,18,114,53,45,16,70,53,17,13,2,0,1,10
S01009990,Occupancy rating +2 or more,79,34,11,23,44,9,35,32,3,0,0,0,0,1,0,0,0,1
S01009990,Occupancy rating +1,129,48,7,41,77,9,36,14,14,8,32,26,6,4,0,0,0,4
S01009990,Occupancy rating 0,66,4,1,3,59,0,31,5,22,4,28,22,6,3,1,0,0,2
S01009990,Occupancy rating -1 or less,28,1,0,1,22,0,12,2,6,4,10,5,5,5,1,0,1,3
S01009991,All households,333,95,20,75,217,11,142,46,65,31,64,55,9,21,8,1,0,12
S01009991,Occupancy rating +2 or more,92,55,11,44,35,2,31,29,1,1,2,2,0,2,0,0,0,2
S01009991,Occupancy rating +1,117,26,7,19,85,7,51,15,26,10,27,22,5,6,0,0,0,6
S01009991,Occupancy rating 0,81,8,1,7,68,2,43,2,28,13,23,19,4,5,2,1,0,2
S01009991,Occupancy rating -1 or less,43,6,1,5,29,0,17,0,10,7,12,12,0,8,6,0,0,2
S01009992,All households,330,126,59,67,181,15,78,23,26,29,88,44,44,23,10,1,2,10
S01009992,Occupancy rating +2 or more,60,24,13,11,35,7,14,9,2,3,14,4,10,1,0,0,0,1
S01009992,Occupancy rating +1,127,73,32,41,46,5,26,12,5,9,15,6,9,8,2,1,1,4
S01009992,Occupancy rating 0,93,17,9,8,67,1,25,2,11,12,41,21,20,9,4,0,0,5
S01009992,Occupancy rating -1 or less,50,12,5,7,33,2,13,0,8,5,18,13,5,5,4,0,1,0
S01009993,All households,349,90,26,64,246,18,160,61,69,30,68,42,26,13,3,0,0,10
S01009993,Occupancy rating +2 or more,108,49,13,36,58,9,43,38,3,2,6,4,2,1,0,0,0,1
S01009993,Occupancy rating +1,125,28,9,19,93,6,60,15,30,15,27,14,13,4,0,0,0,4
S01009993,Occupancy rating 0,84,10,4,6,68,2,41,7,24,10,25,16,9,6,2,0,0,4
S01009993,Occupancy rating -1 or less,32,3,0,3,27,1,16,1,12,3,10,8,2,2,1,0,0,1
S01009994,All households,302,88,22,66,204,13,127,39,68,20,64,55,9,10,2,1,0,7
S01009994,Occupancy rating +2 or more,94,55,10,45,39,9,28,23,5,0,2,2,0,0,0,0,0,0
S01009994,Occupancy rating +1,104,25,10,15,75,3,45,13,27,5,27,23,4,4,0,0,0,4
S01009994,Occupancy rating 0,71,5,2,3,62,1,38,2,26,10,23,19,4,4,1,1,0,2
S01009994,Occupancy rating -1 or less,33,3,0,3,28,0,16,1,10,5,12,11,1,2,1,0,0,1
S01009995,All households,269,59,19,40,201,10,125,48,55,22,66,38,28,9,2,0,0,7
S01009995,Occupancy rating +2 or more,68,30,10,20,38,7,30,24,4,2,1,0,1,0,0,0,0,0
S01009995,Occupancy rating +1,106,23,9,14,81,3,49,20,23,6,29,14,15,2,0,0,0,2
S01009995,Occupancy rating 0,63,3,0,3,56,0,32,3,20,9,24,15,9,4,1,0,0,3
S01009995,Occupancy rating -1 or less,32,3,0,3,26,0,14,1,8,5,12,9,3,3,1,0,0,2
S01009996,All households,310,81,37,44,215,7,127,50,53,24,81,66,15,14,5,1,0,8
S01009996,Occupancy rating +2 or more,72,28,8,20,43,3,38,34,2,2,2,1,1,1,0,0,0,1
S01009996,Occupancy rating +1,112,21,5,16,88,2,44,15,20,9,42,32,10,3,0,0,0,3
S01009996,Occupancy rating 0,93,27,22,5,63,2,36,1,25,10,25,22,3,3,1,1,0,1
S01009996,Occupancy rating -1 or less,33,5,2,3,21,0,9,0,6,3,12,11,1,7,4,0,0,3
S01009997,All households,251,75,24,51,157,14,107,50,42,15,36,25,11,19,6,1,0,12
S01009997,Occupancy rating +2 or more,87,46,15,31,40,9,31,28,2,1,0,0,0,1,0,0,0,1
S01009997,Occupancy rating +1,91,26,8,18,59,4,42,19,17,6,13,7,6,6,0,0,0,6
S01009997,Occupancy rating 0,46,1,1,0,35,0,24,2,16,6,11,7,4,10,4,1,0,5
S01009997,Occupancy rating -1 or less,27,2,0,2,23,1,10,1,7,2,12,11,1,2,2,0,0,0
S01009998,All households,246,63,43,20,155,32,108,34,47,27,15,6,9,28,10,1,2,15
S01009998,Occupancy rating +2 or more,168,48,35,13,106,25,75,33,27,15,6,2,4,14,4,0,2,8
S01009998,Occupancy rating +1,49,10,6,4,32,6,21,1,14,6,5,1,4,7,2,1,0,4
S01009998,Occupancy rating 0,20,3,1,2,12,1,8,0,4,4,3,2,1,5,3,0,0,2
S01009998,Occupancy rating -1 or less,9,2,1,1,5,0,4,0,2,2,1,1,0,2,1,0,0,1
S01009999,All households,285,63,35,28,212,32,139,46,62,31,41,25,16,10,7,0,0,3
S01009999,Occupancy rating +2 or more,153,44,28,16,108,27,72,35,25,12,9,4,5,1,0,0,0,1
S01009999,Occupancy rating +1,75,13,5,8,59,4,40,11,22,7,15,10,5,3,2,0,0,1
S01009999,Occupancy rating 0,35,4,2,2,29,1,15,0,8,7,13,10,3,2,1,0,0,1
S01009999,Occupancy rating -1 or less,22,2,0,2,16,0,12,0,7,5,4,1,3,4,4,0,0,0
S01010000,All households,269,76,13,63,179,11,116,56,43,17,52,41,11,14,3,1,0,10
S01010000,Occupancy rating +2 or more,88,38,5,33,48,10,37,33,3,1,1,0,1,2,0,1,0,1
S01010000,Occupancy rating +1,97,30,6,24,62,1,42,21,15,6,19,15,4,5,0,0,0,5
S01010000,Occupancy rating 0,63,8,2,6,53,0,27,1,20,6,26,22,4,2,0,0,0,2
S01010000,Occupancy rating -1 or less,21,0,0,0,16,0,10,1,5,4,6,4,2,5,3,0,0,2
S01010001,All households,332,88,45,43,230,13,154,62,68,24,63,52,11,14,7,2,0,5
S01010001,Occupancy rating +2 or more,109,41,14,27,67,9,56,42,10,4,2,2,0,1,0,1,0,0
S01010001,Occupancy rating +1,123,20,10,10,94,2,64,17,36,11,28,24,4,9,4,1,0,4
S01010001,Occupancy rating 0,79,22,19,3,54,2,25,3,15,7,27,21,6,3,2,0,0,1
S01010001,Occupancy rating -1 or less,21,5,2,3,15,0,9,0,7,2,6,5,1,1,1,0,0,0
S01010002,All households,336,96,37,59,217,13,146,66,50,30,58,44,14,23,9,0,2,12
S01010002,Occupancy rating +2 or more,98,47,18,29,51,8,42,35,5,2,1,1,0,0,0,0,0,0
S01010002,Occupancy rating +1,130,38,16,22,85,5,50,28,14,8,30,21,9,7,0,0,1,6
S01010002,Occupancy rating 0,66,7,2,5,55,0,33,1,23,9,22,19,3,4,1,0,0,3
S01010002,Occupancy rating -1 or less,42,4,1,3,26,0,21,2,8,11,5,3,2,12,8,0,1,3
S01010003,All households,279,63,22,41,202,27,146,54,65,27,29,20,9,14,9,0,0,5
S01010003,Occupancy rating +2 or more,127,45,18,27,80,22,56,33,17,6,2,0,2,2,1,0,0,1
S01010003,Occupancy rating +1,86,15,4,11,69,4,51,20,23,8,14,9,5,2,0,0,0,2
S01010003,Occupancy rating 0,48,3,0,3,39,1,30,1,18,11,8,6,2,6,4,0,0,2
S01010003,Occupancy rating -1 or less,18,0,0,0,14,0,9,0,7,2,5,5,0,4,4,0,0,0
S01010004,All households,273,62,39,23,201,35,151,46,61,44,15,5,10,10,4,0,0,6
S01010004,Occupancy rating +2 or more,199,51,36,15,146,34,105,42,33,30,7,1,6,2,1,0,0,1
S01010004,Occupancy rating +1,40,8,3,5,31,1,26,2,15,9,4,2,2,1,0,0,0,1
S01010004,Occupancy rating 0,26,1,0,1,20,0,16,2,10,4,4,2,2,5,2,0,0,3
S01010004,Occupancy rating -1 or less,8,2,0,2,4,0,4,0,3,1,0,0,0,2,1,0,0,1
S01010005,All households,488,321,52,269,158,10,102,67,21,14,46,21,25,9,0,1,0,8
S01010005,Occupancy rating +2 or more,61,45,17,28,15,2,11,6,3,2,2,0,2,1,0,0,0,1
S01010005,Occupancy rating +1,85,37,9,28,43,5,25,17,2,6,13,3,10,5,0,1,0,4
S01010005,Occupancy rating 0,221,158,18,140,61,2,42,30,8,4,17,10,7,2,0,0,0,2
S01010005,Occupancy rating -1 or less,121,81,8,73,39,1,24,14,8,2,14,8,6,1,0,0,0,1
S01010006,All households,586,384,81,303,177,13,119,83,24,12,45,22,23,25,4,1,4,16
S01010006,Occupancy rating +2 or more,43,35,13,22,8,0,7,6,1,0,1,1,0,0,0,0,0,0
S01010006,Occupancy rating +1,174,126,41,85,44,6,34,29,2,3,4,3,1,4,1,0,0,3
S01010006,Occupancy rating 0,253,145,15,130,91,6,55,34,15,6,30,14,16,17,1,1,4,11
S01010006,Occupancy rating -1 or less,116,78,12,66,34,1,23,14,6,3,10,4,6,4,2,0,0,2
S01010007,All households,429,162,51,111,245,31,191,66,90,35,23,14,9,22,6,1,1,14
S01010007,Occupancy rating +2 or more,185,45,17,28,135,24,104,36,52,16,7,1,6,5,1,0,1,3
S01010007,Occupancy rating +1,100,44,19,25,49,3,43,12,19,12,3,2,1,7,4,0,0,3
S01010007,Occupancy rating 0,96,53,11,42,36,2,29,12,15,2,5,4,1,7,1,0,0,6
S01010007,Occupancy rating -1 or less,48,20,4,16,25,2,15,6,4,5,8,7,1,3,0,1,0,2
S01010008,All households,410,265,39,226,127,6,89,59,23,7,32,15,17,18,3,1,0,14
S01010008,Occupancy rating +2 or more,20,10,3,7,10,0,9,7,2,0,1,1,0,0,0,0,0,0
S01010008,Occupancy rating +1,156,109,15,94,45,5,38,34,2,2,2,0,2,2,0,0,0,2
S01010008,Occupancy rating 0,166,106,16,90,50,1,31,15,13,3,18,8,10,10,0,1,0,9
S01010008,Occupancy rating -1 or less,68,40,5,35,22,0,11,3,6,2,11,6,5,6,3,0,0,3
S01010009,All households,416,310,26,284,96,3,78,60,13,5,15,7,8,10,1,3,0,6
S01010009,Occupancy rating +2 or more,9,7,0,7,2,0,2,1,1,0,0,0,0,0,0,0,0,0
S01010009,Occupancy rating +1,53,33,1,32,20,2,18,14,2,2,0,0,0,0,0,0,0,0
S01010009,Occupancy rating 0,201,147,12,135,48,1,39,32,6,1,8,4,4,6,0,1,0,5
S01010009,Occupancy rating -1 or less,153,123,13,110,26,0,19,13,4,2,7,3,4,4,1,2,0,1
S01010010,All households,451,152,48,104,271,45,201,82,87,32,25,15,10,28,12,1,0,15
S01010010,Occupancy rating +2 or more,230,56,30,26,160,39,113,50,44,19,8,3,5,14,5,0,0,9
S01010010,Occupancy rating +1,66,18,4,14,45,4,38,11,23,4,3,1,2,3,2,0,0,1
S01010010,Occupancy rating 0,104,51,11,40,49,2,40,19,16,5,7,6,1,4,4,0,0,0
S01010010,Occupancy rating -1 or less,51,27,3,24,17,0,10,2,4,4,7,5,2,7,1,1,0,5
S01010011,All households,544,387,120,267,141,23,95,76,9,10,23,12,11,16,2,0,1,13
S01010011,Occupancy rating +2 or more,38,24,8,16,9,3,5,3,0,2,1,0,1,5,1,0,0,4
S01010011,Occupancy rating +1,176,123,48,75,53,14,38,34,1,3,1,0,1,0,0,0,0,0
S01010011,Occupancy rating 0,245,180,47,133,59,6,41,37,2,2,12,6,6,6,0,0,1,5
S01010011,Occupancy rating -1 or less,85,60,17,43,20,0,11,2,6,3,9,6,3,5,1,0,0,4
S01010012,All households,348,101,53,48,230,23,154,52,63,39,53,27,26,17,10,0,0,7
S01010012,Occupancy rating +2 or more,187,75,38,37,110,17,82,43,22,17,11,0,11,2,0,0,0,2
S01010012,Occupancy rating +1,88,20,13,7,64,4,43,8,21,14,17,10,7,4,2,0,0,2
S01010012,Occupancy rating 0,49,0,0,0,42,2,20,1,14,5,20,12,8,7,4,0,0,3
S01010012,Occupancy rating -1 or less,24,6,2,4,14,0,9,0,6,3,5,5,0,4,4,0,0,0
S01010013,All households,457,249,45,204,185,18,132,80,36,16,35,22,13,23,5,3,0,15
S01010013,Occupancy rating +2 or more,83,23,9,14,57,7,44,18,14,12,6,3,3,3,1,0,0,2
S01010013,Occupancy rating +1,77,43,6,37,32,6,24,16,7,1,2,1,1,2,0,0,0,2
S01010013,Occupancy rating 0,220,140,23,117,71,5,48,38,9,1,18,11,7,9,2,2,0,5
S01010013,Occupancy rating -1 or less,77,43,7,36,25,0,16,8,6,2,9,7,2,9,2,1,0,6
S01010014,All households,523,254,57,197,238,17,196,108,69,19,25,11,14,31,7,1,0,23
S01010014,Occupancy rating +2 or more,93,36,11,25,52,7,42,30,11,1,3,1,2,5,3,0,0,2
S01010014,Occupancy rating +1,183,89,25,64,88,10,72,54,12,6,6,2,4,6,1,0,0,5
S01010014,Occupancy rating 0,151,60,8,52,78,0,64,22,34,8,14,7,7,13,3,1,0,9
S01010014,Occupancy rating -1 or less,96,69,13,56,20,0,18,2,12,4,2,1,1,7,0,0,0,7
S01010015,All households,392,149,22,127,201,2,170,121,44,5,29,21,8,42,7,1,0,34
S01010015,Occupancy rating +2 or more,53,19,3,16,33,1,29,22,5,2,3,3,0,1,0,0,0,1
S01010015,Occupancy rating +1,108,44,3,41,60,1,55,41,12,2,4,2,2,4,0,0,0,4
S01010015,Occupancy rating 0,176,76,15,61,84,0,70,52,17,1,14,10,4,16,1,1,0,14
S01010015,Occupancy rating -1 or less,55,10,1,9,24,0,16,6,10,0,8,6,2,21,6,0,0,15
S01010016,All households,325,130,80,50,170,28,102,24,47,31,40,16,24,25,11,1,4,9
S01010016,Occupancy rating +2 or more,105,60,33,27,43,15,25,17,5,3,3,0,3,2,0,0,0,2
S01010016,Occupancy rating +1,93,29,13,16,57,7,33,5,13,15,17,5,12,7,0,0,3,4
S01010016,Occupancy rating 0,92,33,27,6,52,5,35,1,23,11,12,8,4,7,4,1,0,2
S01010016,Occupancy rating -1 or less,35,8,7,1,18,1,9,1,6,2,8,3,5,9,7,0,1,1
S01010017,All households,339,125,58,67,192,15,74,26,33,15,103,65,38,22,6,0,2,14
S01010017,Occupancy rating +2 or more,73,48,22,26,25,7,16,15,0,1,2,2,0,0,0,0,0,0
S01010017,Occupancy rating +1,104,56,23,33,41,4,16,9,4,3,21,8,13,7,1,0,0,6
S01010017,Occupancy rating 0,109,15,7,8,84,3,27,2,18,7,54,32,22,10,3,0,1,6
S01010017,Occupancy rating -1 or less,53,6,6,0,42,1,15,0,11,4,26,23,3,5,2,0,1,2
S01010018,All households,525,268,111,157,225,30,124,57,56,11,71,44,27,32,9,0,3,20
S01010018,Occupancy rating +2 or more,64,33,12,21,30,4,22,20,2,0,4,4,0,1,0,0,0,1
S01010018,Occupancy rating +1,239,161,72,89,76,16,52,32,18,2,8,6,2,2,0,0,0,2
S01010018,Occupancy rating 0,141,39,15,24,84,7,35,2,25,8,42,22,20,18,2,0,2,14
S01010018,Occupancy rating -1 or less,81,35,12,23,35,3,15,3,11,1,17,12,5,11,7,0,1,3
S01010019,All households,409,215,70,145,178,17,53,23,16,14,108,78,30,16,5,0,2,9
S01010019,Occupancy rating +2 or more,41,25,7,18,14,5,7,6,1,0,2,2,0,2,0,0,0,2
S01010019,Occupancy rating +1,180,128,40,88,50,8,24,16,3,5,18,9,9,2,0,0,1,1
S01010019,Occupancy rating 0,121,35,13,22,77,3,12,1,5,6,62,46,16,9,3,0,1,5
S01010019,Occupancy rating -1 or less,67,27,10,17,37,1,10,0,7,3,26,21,5,3,2,0,0,1
S01010020,All households,346,144,65,79,172,21,85,20,39,26,66,31,35,30,14,0,2,14
S01010020,Occupancy rating +2 or more,99,58,30,28,35,10,19,10,5,4,6,1,5,6,2,0,0,4
S01010020,Occupancy rating +1,140,70,31,39,65,6,35,8,16,11,24,9,15,5,1,0,0,4
S01010020,Occupancy rating 0,73,12,4,8,50,2,24,1,14,9,24,14,10,11,4,0,2,5
S01010020,Occupancy rating -1 or less,34,4,0,4,22,3,7,1,4,2,12,7,5,8,7,0,0,1
S01010021,All households,400,206,45,161,169,8,73,12,44,17,88,66,22,25,8,1,1,15
S01010021,Occupancy rating +2 or more,38,14,9,5,22,4,10,3,6,1,8,6,2,2,0,0,0,2
S01010021,Occupancy rating +1,139,93,16,77,40,3,21,6,7,8,16,12,4,6,2,0,0,4
S01010021,Occupancy rating 0,122,58,9,49,59,1,23,3,15,5,35,22,13,5,0,0,0,5
S01010021,Occupancy rating -1 or less,101,41,11,30,48,0,19,0,16,3,29,26,3,12,6,1,1,4
S01010022,All households,468,202,56,146,221,10,131,52,52,27,80,53,27,45,11,6,3,25
S01010022,Occupancy rating +2 or more,42,15,2,13,25,0,24,15,8,1,1,1,0,2,0,1,0,1
S01010022,Occupancy rating +1,160,108,32,76,50,5,38,21,10,7,7,5,2,2,1,0,0,1
S01010022,Occupancy rating 0,177,54,14,40,104,5,47,12,23,12,52,32,20,19,3,2,3,11
S01010022,Occupancy rating -1 or less,89,25,8,17,42,0,22,4,11,7,20,15,5,22,7,3,0,12
S01010023,All households,387,227,119,108,148,16,51,24,20,7,81,51,30,12,3,0,2,7
S01010023,Occupancy rating +2 or more,20,10,7,3,10,4,2,2,0,0,4,3,1,0,0,0,0,0
S01010023,Occupancy rating +1,120,81,45,36,37,9,18,16,2,0,10,4,6,2,1,0,0,1
S01010023,Occupancy rating 0,166,95,42,53,67,0,24,5,14,5,43,27,16,4,1,0,1,2
S01010023,Occupancy rating -1 or less,81,41,25,16,34,3,7,1,4,2,24,17,7,6,1,0,1,4
S01010024,All households,402,215,56,159,157,5,91,55,24,12,61,41,20,30,6,3,0,21
S01010024,Occupancy rating +2 or more,25,15,2,13,9,0,8,7,1,0,1,1,0,1,0,0,0,1
S01010024,Occupancy rating +1,122,71,14,57,50,2,40,28,7,5,8,6,2,1,0,0,0,1
S01010024,Occupancy rating 0,188,110,32,78,61,1,29,13,11,5,31,24,7,17,3,2,0,12
S01010024,Occupancy rating -1 or less,67,19,8,11,37,2,14,7,5,2,21,10,11,11,3,1,0,7
S01010025,All households,316,182,34,148,106,7,50,18,23,9,49,26,23,28,6,5,0,17
S01010025,Occupancy rating +2 or more,25,18,3,15,5,0,4,3,1,0,1,0,1,2,0,0,0,2
S01010025,Occupancy rating +1,92,53,12,41,33,5,17,10,2,5,11,6,5,6,1,3,0,2
S01010025,Occupancy rating 0,138,80,12,68,45,2,18,5,11,2,25,13,12,13,1,1,0,11
S01010025,Occupancy rating -1 or less,61,31,7,24,23,0,11,0,9,2,12,7,5,7,4,1,0,2
S01010026,All households,492,241,35,206,201,10,116,70,32,14,75,47,28,50,10,14,0,26
S01010026,Occupancy rating +2 or more,38,16,2,14,20,0,19,18,0,1,1,0,1,2,0,0,0,2
S01010026,Occupancy rating +1,138,83,20,63,47,6,36,23,10,3,5,4,1,8,0,2,0,6
S01010026,Occupancy rating 0,221,115,11,104,90,3,45,22,16,7,42,24,18,16,4,4,0,8
S01010026,Occupancy rating -1 or less,95,27,2,25,44,1,16,7,6,3,27,19,8,24,6,8,0,10
S01010027,All households,483,239,65,174,165,4,99,55,37,7,62,42,20,79,9,24,2,44
S01010027,Occupancy rating +2 or more,62,39,5,34,20,1,16,14,2,0,3,3,0,3,0,0,0,3
S01010027,Occupancy rating +1,155,87,19,68,50,2,38,27,6,5,10,5,5,18,0,6,1,11
S01010027,Occupancy rating 0,164,74,27,47,59,1,30,11,17,2,28,18,10,31,1,13,0,17
S01010027,Occupancy rating -1 or less,102,39,14,25,36,0,15,3,12,0,21,16,5,27,8,5,1,13
S01010028,All households,381,204,82,122,149,19,64,37,22,5,66,37,29,28,4,6,2,16
S01010028,Occupancy rating +2 or more,11,3,1,2,8,3,3,1,1,1,2,1,1,0,0,0,0,0
S01010028,Occupancy rating +1,85,54,19,35,31,3,22,20,2,0,6,2,4,0,0,0,0,0
S01010028,Occupancy rating 0,200,117,51,66,71,9,29,13,13,3,33,15,18,12,0,4,1,7
S01010028,Occupancy rating -1 or less,85,30,11,19,39,4,10,3,6,1,25,19,6,16,4,2,1,9
S01010029,All households,398,228,107,121,146,23,61,28,20,13,62,37,25,24,8,1,2,13
S01010029,Occupancy rating +2 or more,51,31,15,16,20,5,13,11,0,2,2,1,1,0,0,0,0,0
S01010029,Occupancy rating +1,128,85,46,39,37,14,18,12,2,4,5,4,1,6,1,0,1,4
S01010029,Occupancy rating 0,153,85,31,54,57,3,16,3,9,4,38,22,16,11,3,1,1,6
S01010029,Occupancy rating -1 or less,66,27,15,12,32,1,14,2,9,3,17,10,7,7,4,0,0,3
S01010030,All households,429,190,42,148,185,10,130,82,38,10,45,35,10,54,3,14,1,36
S01010030,Occupancy rating +2 or more,52,15,2,13,36,2,28,22,3,3,6,4,2,1,0,0,0,1
S01010030,Occupancy rating +1,193,101,22,79,77,4,68,49,15,4,5,5,0,15,0,2,0,13
S01010030,Occupancy rating 0,126,55,11,44,46,2,21,7,12,2,23,18,5,25,1,7,1,16
S01010030,Occupancy rating -1 or less,58,19,7,12,26,2,13,4,8,1,11,8,3,13,2,5,0,6
S01010031,All households,423,214,7,207,110,2,97,83,13,1,11,7,4,99,0,43,0,56
S01010031,Occupancy rating +2 or more,65,38,3,35,25,2,23,23,0,0,0,0,0,2,0,1,0,1
S01010031,Occupancy rating +1,111,61,1,60,29,0,24,22,2,0,5,2,3,21,0,6,0,15
S01010031,Occupancy rating 0,169,83,3,80,46,0,41,30,10,1,5,5,0,40,0,22,0,18
S01010031,Occupancy rating -1 or less,78,32,0,32,10,0,9,8,1,0,1,0,1,36,0,14,0,22
S01010032,All households,298,136,3,133,84,0,78,60,18,0,6,5,1,78,4,25,0,49
S01010032,Occupancy rating +2 or more,21,7,1,6,10,0,10,10,0,0,0,0,0,4,0,0,0,4
S01010032,Occupancy rating +1,91,56,1,55,20,0,20,18,2,0,0,0,0,15,0,3,0,12
S01010032,Occupancy rating 0,127,54,1,53,42,0,39,31,8,0,3,3,0,31,2,11,0,18
S01010032,Occupancy rating -1 or less,59,19,0,19,12,0,9,1,8,0,3,2,1,28,2,11,0,15
S01010033,All households,503,279,54,225,182,8,123,57,56,10,51,28,23,42,4,11,0,27
S01010033,Occupancy rating +2 or more,17,8,2,6,8,0,6,2,3,1,2,1,1,1,0,0,0,1
S01010033,Occupancy rating +1,129,87,23,64,41,4,33,28,4,1,4,1,3,1,0,0,0,1
S01010033,Occupancy rating 0,197,92,17,75,84,2,49,23,20,6,33,20,13,21,2,5,0,14
S01010033,Occupancy rating -1 or less,160,92,12,80,49,2,35,4,29,2,12,6,6,19,2,6,0,11
S01010034,All households,498,265,104,161,200,21,91,49,28,14,88,44,44,33,6,3,1,23
S01010034,Occupancy rating +2 or more,43,21,10,11,22,8,9,5,1,3,5,2,3,0,0,0,0,0
S01010034,Occupancy rating +1,147,100,35,65,43,7,28,22,2,4,8,1,7,4,1,0,0,3
S01010034,Occupancy rating 0,215,115,40,75,88,6,38,19,14,5,44,26,18,12,0,1,1,10
S01010034,Occupancy rating -1 or less,93,29,19,10,47,0,16,3,11,2,31,15,16,17,5,2,0,10
S01010035,All households,401,228,42,186,129,8,72,37,27,8,49,39,10,44,9,10,0,25
S01010035,Occupancy rating +2 or more,27,12,2,10,12,2,10,5,5,0,0,0,0,3,0,2,0,1
S01010035,Occupancy rating +1,97,61,15,46,27,2,21,15,3,3,4,1,3,9,1,2,0,6
S01010035,Occupancy rating 0,172,107,16,91,50,3,22,10,8,4,25,20,5,15,4,2,0,9
S01010035,Occupancy rating -1 or less,105,48,9,39,40,1,19,7,11,1,20,18,2,17,4,4,0,9
S01010036,All households,423,150,0,150,79,0,67,51,15,1,12,10,2,194,1,97,0,96
S01010036,Occupancy rating +2 or more,32,11,0,11,11,0,10,8,2,0,1,1,0,10,0,6,0,4
S01010036,Occupancy rating +1,131,80,0,80,29,0,28,27,1,0,1,1,0,22,0,7,0,15
S01010036,Occupancy rating 0,186,36,0,36,25,0,20,9,10,1,5,3,2,125,1,65,0,59
S01010036,Occupancy rating -1 or less,74,23,0,23,14,0,9,7,2,0,5,5,0,37,0,19,0,18
S01010037,All households,376,201,94,107,154,27,74,34,24,16,53,31,22,21,6,2,2,11
S01010037,Occupancy rating +2 or more,41,20,9,11,20,4,9,5,1,3,7,2,5,1,0,0,1,0
S01010037,Occupancy rating +1,100,66,23,43,33,10,18,15,3,0,5,2,3,1,1,0,0,0
S01010037,Occupancy rating 0,169,92,51,41,65,9,27,10,8,9,29,19,10,12,2,2,0,8
S01010037,Occupancy rating -1 or less,66,23,11,12,36,4,20,4,12,4,12,8,4,7,3,0,1,3
S01010038,All households,568,286,93,193,222,16,119,72,33,14,87,55,32,60,5,24,2,29
S01010038,Occupancy rating +2 or more,48,21,7,14,26,5,16,9,7,0,5,1,4,1,0,0,0,1
S01010038,Occupancy rating +1,145,95,42,53,49,7,36,31,3,2,6,4,2,1,0,1,0,0
S01010038,Occupancy rating 0,188,84,26,58,87,4,41,17,17,7,42,27,15,17,0,6,0,11
S01010038,Occupancy rating -1 or less,187,86,18,68,60,0,26,15,6,5,34,23,11,41,5,17,2,17
S01010039,All households,593,287,11,276,148,2,133,110,22,1,13,8,5,158,0,96,0,62
S01010039,Occupancy rating +2 or more,18,12,0,12,5,0,5,4,1,0,0,0,0,1,0,0,0,1
S01010039,Occupancy rating +1,76,44,2,42,28,0,27,25,2,0,1,0,1,4,0,0,0,4
S01010039,Occupancy rating 0,248,131,8,123,73,1,66,61,5,0,6,4,2,44,0,22,0,22
S01010039,Occupancy rating -1 or less,251,100,1,99,42,1,35,20,14,1,6,4,2,109,0,74,0,35
S01010040,All households,415,199,24,175,166,5,122,90,23,9,39,26,13,50,3,13,0,34
S01010040,Occupancy rating +2 or more,38,11,2,9,25,1,23,21,2,0,1,0,1,2,0,0,0,2
S01010040,Occupancy rating +1,130,69,8,61,50,1,42,32,8,2,7,6,1,11,0,2,0,9
S01010040,Occupancy rating 0,175,99,11,88,62,3,43,29,9,5,16,11,5,14,0,6,0,8
S01010040,Occupancy rating -1 or less,72,20,3,17,29,0,14,8,4,2,15,9,6,23,3,5,0,15
S01010041,All households,451,289,28,261,101,9,79,72,5,2,13,10,3,61,1,34,1,25
S01010041,Occupancy rating +2 or more,23,14,0,14,7,1,5,5,0,0,1,1,0,2,0,1,0,1
S01010041,Occupancy rating +1,104,72,4,68,28,0,27,27,0,0,1,0,1,4,0,4,0,0
S01010041,Occupancy rating 0,212,141,14,127,41,6,34,31,2,1,1,0,1,30,0,18,0,12
S01010041,Occupancy rating -1 or less,112,62,10,52,25,2,13,9,3,1,10,9,1,25,1,11,1,12
S01010042,All households,621,284,25,259,212,7,155,101,48,6,50,37,13,125,10,37,0,78
S01010042,Occupancy rating +2 or more,28,17,2,15,9,0,8,7,1,0,1,1,0,2,0,1,0,1
S01010042,Occupancy rating +1,178,106,11,95,67,6,59,51,7,1,2,2,0,5,0,2,0,3
S01010042,Occupancy rating 0,265,118,7,111,90,1,60,33,22,5,29,20,9,57,1,17,0,39
S01010042,Occupancy rating -1 or less,150,43,5,38,46,0,28,10,18,0,18,14,4,61,9,17,0,35
S01010043,All households,451,251,57,194,166,12,85,43,31,11,69,48,21,34,8,4,0,22
S01010043,Occupancy rating +2 or more,22,12,1,11,10,2,5,4,1,0,3,2,1,0,0,0,0,0
S01010043,Occupancy rating +1,85,48,8,40,36,6,24,16,5,3,6,3,3,1,0,0,0,1
S01010043,Occupancy rating 0,221,131,32,99,80,3,41,18,17,6,36,25,11,10,0,1,0,9
S01010043,Occupancy rating -1 or less,123,60,16,44,40,1,15,5,8,2,24,18,6,23,8,3,0,12
S01010044,All households,649,349,91,258,253,24,157,89,52,16,72,51,21,47,7,5,4,31
S01010044,Occupancy rating +2 or more,42,21,10,11,20,1,15,9,3,3,4,1,3,1,1,0,0,0
S01010044,Occupancy rating +1,228,141,30,111,83,13,64,55,9,0,6,2,4,4,1,1,0,2
S01010044,Occupancy rating 0,269,138,38,100,107,7,58,22,27,9,42,30,12,24,0,2,3,19
S01010044,Occupancy rating -1 or less,110,49,13,36,43,3,20,3,13,4,20,18,2,18,5,2,1,10
S01010045,All households,258,114,60,54,115,9,39,13,13,13,67,46,21,29,14,1,2,12
S01010045,Occupancy rating +2 or more,39,20,12,8,17,3,9,7,1,1,5,3,2,2,0,0,1,1
S01010045,Occupancy rating +1,64,34,16,18,27,3,13,4,4,5,11,6,5,3,0,0,0,3
S01010045,Occupancy rating 0,101,43,22,21,47,3,13,2,7,4,31,25,6,11,7,0,0,4
S01010045,Occupancy rating -1 or less,54,17,10,7,24,0,4,0,1,3,20,12,8,13,7,1,1,4
S01010046,All households,431,224,57,167,174,13,90,49,26,15,71,44,27,33,5,0,1,27
S01010046,Occupancy rating +2 or more,44,19,6,13,23,3,17,10,3,4,3,1,2,2,1,0,0,1
S01010046,Occupancy rating +1,165,105,24,81,57,8,39,29,4,6,10,7,3,3,0,0,0,3
S01010046,Occupancy rating 0,156,71,19,52,65,1,27,10,14,3,37,22,15,20,0,0,1,19
S01010046,Occupancy rating -1 or less,66,29,8,21,29,1,7,0,5,2,21,14,7,8,4,0,0,4
S01010047,All households,471,265,97,168,185,19,70,36,22,12,96,60,36,21,8,1,1,11
S01010047,Occupancy rating +2 or more,46,24,8,16,22,7,11,10,0,1,4,2,2,0,0,0,0,0
S01010047,Occupancy rating +1,146,97,36,61,45,8,26,17,4,5,11,6,5,4,0,0,1,3
S01010047,Occupancy rating 0,187,108,41,67,73,2,21,7,9,5,50,34,16,6,2,1,0,3
S01010047,Occupancy rating -1 or less,92,36,12,24,45,2,12,2,9,1,31,18,13,11,6,0,0,5
S01010048,All households,551,308,96,212,205,18,99,41,36,22,88,55,33,38,14,8,4,12
S01010048,Occupancy rating +2 or more,43,18,6,12,24,4,13,7,3,3,7,2,5,1,0,0,0,1
S01010048,Occupancy rating +1,150,101,30,71,47,9,27,17,5,5,11,7,4,2,0,1,0,1
S01010048,Occupancy rating 0,223,134,43,91,79,4,38,15,13,10,37,25,12,10,1,1,1,7
S01010048,Occupancy rating -1 or less,135,55,17,38,55,1,21,2,15,4,33,21,12,25,13,6,3,3
S01010049,All households,395,184,59,125,181,4,66,17,39,10,111,76,35,30,11,2,1,16
S01010049,Occupancy rating +2 or more,26,17,6,11,9,0,5,3,1,1,4,3,1,0,0,0,0,0
S01010049,Occupancy rating +1,79,44,7,37,32,3,14,8,4,2,15,11,4,3,2,0,0,1
S01010049,Occupancy rating 0,188,87,33,54,93,0,34,5,24,5,59,35,24,8,4,1,0,3
S01010049,Occupancy rating -1 or less,102,36,13,23,47,1,13,1,10,2,33,27,6,19,5,1,1,12
S01010050,All households,540,268,79,189,235,13,89,53,21,15,133,94,39,37,12,7,0,18
S01010050,Occupancy rating +2 or more,34,14,0,14,18,0,9,4,2,3,9,8,1,2,0,0,0,2
S01010050,Occupancy rating +1,154,111,34,77,41,6,28,25,2,1,7,6,1,2,0,0,0,2
S01010050,Occupancy rating 0,236,104,33,71,120,6,37,18,9,10,77,54,23,12,2,3,0,7
S01010050,Occupancy rating -1 or less,116,39,12,27,56,1,15,6,8,1,40,26,14,21,10,4,0,7
S01010051,All households,431,257,105,152,139,15,51,28,14,9,73,55,18,35,5,9,1,20
S01010051,Occupancy rating +2 or more,31,18,7,11,13,3,5,3,0,2,5,4,1,0,0,0,0,0
S01010051,Occupancy rating +1,96,70,33,37,24,3,13,12,1,0,8,4,4,2,0,0,0,2
S01010051,Occupancy rating 0,206,118,52,66,74,7,28,12,10,6,39,33,6,14,0,6,0,8
S01010051,Occupancy rating -1 or less,98,51,13,38,28,2,5,1,3,1,21,14,7,19,5,3,1,10
S01010052,All households,372,219,36,183,119,4,64,32,19,13,51,37,14,34,8,2,1,23
S01010052,Occupancy rating +2 or more,33,19,0,19,12,0,11,11,0,0,1,1,0,2,0,0,0,2
S01010052,Occupancy rating +1,85,63,14,49,22,2,17,10,2,5,3,2,1,0,0,0,0,0
S01010052,Occupancy rating 0,154,87,15,72,56,1,23,8,10,5,32,22,10,11,1,1,0,9
S01010052,Occupancy rating -1 or less,100,50,7,43,29,1,13,3,7,3,15,12,3,21,7,1,1,12
S01010053,All households,384,134,33,101,193,13,99,45,38,16,81,46,35,57,16,7,0,34
S01010053,Occupancy rating +2 or more,68,29,11,18,34,9,16,11,2,3,9,5,4,5,1,0,0,4
S01010053,Occupancy rating +1,69,19,6,13,46,2,17,7,6,4,27,9,18,4,0,0,0,4
S01010053,Occupancy rating 0,138,65,16,49,58,1,31,18,7,6,26,17,9,15,6,1,0,8
S01010053,Occupancy rating -1 or less,109,21,0,21,55,1,35,9,23,3,19,15,4,33,9,6,0,18
S01010054,All households,248,76,19,57,147,1,58,19,27,12,88,64,24,25,13,1,1,10
S01010054,Occupancy rating +2 or more,34,10,3,7,19,0,8,5,0,3,11,7,4,5,1,1,0,3
S01010054,Occupancy rating +1,94,44,12,32,47,1,28,11,12,5,18,11,7,3,1,0,1,1
S01010054,Occupancy rating 0,80,12,4,8,59,0,17,3,12,2,42,34,8,9,6,0,0,3
S01010054,Occupancy rating -1 or less,40,10,0,10,22,0,5,0,3,2,17,12,5,8,5,0,0,3
S01010055,All households,457,194,56,138,209,12,118,58,44,16,79,53,26,54,20,7,1,26
S01010055,Occupancy rating +2 or more,38,16,4,12,20,2,14,9,1,4,4,1,3,2,1,0,0,1
S01010055,Occupancy rating +1,122,71,17,54,48,4,33,19,11,3,11,8,3,3,1,1,0,1
S01010055,Occupancy rating 0,196,89,31,58,91,3,50,24,21,5,38,27,11,16,6,2,1,7
S01010055,Occupancy rating -1 or less,101,18,4,14,50,3,21,6,11,4,26,17,9,33,12,4,0,17
S01010056,All households,214,95,20,75,104,3,53,17,27,9,48,35,13,15,4,2,0,9
S01010056,Occupancy rating +2 or more,14,6,1,5,7,0,4,1,2,1,3,1,2,1,0,0,0,1
S01010056,Occupancy rating +1,64,39,8,31,24,3,18,10,5,3,3,3,0,1,1,0,0,0
S01010056,Occupancy rating 0,87,29,5,24,52,0,23,5,14,4,29,22,7,6,0,2,0,4
S01010056,Occupancy rating -1 or less,49,21,6,15,21,0,8,1,6,1,13,9,4,7,3,0,0,4
S01010057,All households,216,103,33,70,99,5,45,16,25,4,49,30,19,14,4,1,1,8
S01010057,Occupancy rating +2 or more,13,6,4,2,7,1,5,2,2,1,1,0,1,0,0,0,0,0
S01010057,Occupancy rating +1,68,46,16,30,22,4,13,11,2,0,5,2,3,0,0,0,0,0
S01010057,Occupancy rating 0,98,40,8,32,48,0,19,3,14,2,29,19,10,10,0,1,1,8
S01010057,Occupancy rating -1 or less,37,11,5,6,22,0,8,0,7,1,14,9,5,4,4,0,0,0
S01010058,All households,355,121,22,99,190,6,83,37,34,12,101,66,35,44,14,5,1,24
S01010058,Occupancy rating +2 or more,28,9,1,8,17,0,13,8,4,1,4,2,2,2,0,0,0,2
S01010058,Occupancy rating +1,89,38,8,30,48,3,29,14,10,5,16,9,7,3,0,0,0,3
S01010058,Occupancy rating 0,146,52,11,41,78,3,26,11,12,3,49,33,16,16,8,2,0,6
S01010058,Occupancy rating -1 or less,92,22,2,20,47,0,15,4,8,3,32,22,10,23,6,3,1,13
S01010059,All households,371,209,35,174,144,9,89,59,24,6,46,35,11,18,6,5,0,7
S01010059,Occupancy rating +2 or more,30,14,4,10,15,1,12,8,4,0,2,2,0,1,0,0,0,1
S01010059,Occupancy rating +1,76,43,3,40,32,3,25,24,1,0,4,2,2,1,1,0,0,0
S01010059,Occupancy rating 0,175,101,18,83,66,5,36,22,9,5,25,21,4,8,2,2,0,4
S01010059,Occupancy rating -1 or less,90,51,10,41,31,0,16,5,10,1,15,10,5,8,3,3,0,2
S01010060,All households,493,259,55,204,202,11,118,48,48,22,73,46,27,32,14,1,2,15
S01010060,Occupancy rating +2 or more,66,20,9,11,40,3,29,15,10,4,8,4,4,6,2,1,1,2
S01010060,Occupancy rating +1,98,56,13,43,39,3,28,18,4,6,8,5,3,3,0,0,0,3
S01010060,Occupancy rating 0,206,117,25,92,78,4,41,13,21,7,33,22,11,11,5,0,0,6
S01010060,Occupancy rating -1 or less,123,66,8,58,45,1,20,2,13,5,24,15,9,12,7,0,1,4
S01010061,All households,253,96,25,71,138,5,98,49,39,10,35,28,7,19,5,5,2,7
S01010061,Occupancy rating +2 or more,43,16,5,11,26,2,23,21,2,0,1,1,0,1,0,0,1,0
S01010061,Occupancy rating +1,100,55,13,42,43,3,32,20,10,2,8,8,0,2,0,0,1,1
S01010061,Occupancy rating 0,83,18,4,14,53,0,37,7,23,7,16,10,6,12,3,3,0,6
S01010061,Occupancy rating -1 or less,27,7,3,4,16,0,6,1,4,1,10,9,1,4,2,2,0,0
S01010062,All households,344,112,38,74,205,27,93,35,41,17,85,53,32,27,14,1,3,9
S01010062,Occupancy rating +2 or more,57,24,13,11,30,13,17,10,2,5,0,0,0,3,2,0,0,1
S01010062,Occupancy rating +1,105,67,20,47,37,9,22,17,4,1,6,3,3,1,0,0,1,0
S01010062,Occupancy rating 0,107,12,5,7,87,3,34,5,23,6,50,37,13,8,2,1,2,3
S01010062,Occupancy rating -1 or less,75,9,0,9,51,2,20,3,12,5,29,13,16,15,10,0,0,5
S01010063,All households,546,303,74,229,212,10,108,62,30,16,94,64,30,31,9,5,0,17
S01010063,Occupancy rating +2 or more,33,22,2,20,10,1,6,6,0,0,3,3,0,1,0,0,0,1
S01010063,Occupancy rating +1,134,81,12,69,50,5,29,20,5,4,16,9,7,3,1,0,0,2
S01010063,Occupancy rating 0,246,142,39,103,95,4,47,25,14,8,44,29,15,9,1,1,0,7
S01010063,Occupancy rating -1 or less,133,58,21,37,57,0,26,11,11,4,31,23,8,18,7,4,0,7
S01010064,All households,264,107,41,66,144,6,91,38,34,19,47,42,5,13,3,2,1,7
S01010064,Occupancy rating +2 or more,32,13,8,5,18,2,15,10,3,2,1,1,0,1,0,0,0,1
S01010064,Occupancy rating +1,116,68,26,42,45,3,34,22,8,4,8,7,1,3,0,0,1,2
S01010064,Occupancy rating 0,82,17,4,13,62,1,34,5,18,11,27,23,4,3,0,1,0,2
S01010064,Occupancy rating -1 or less,34,9,3,6,19,0,8,1,5,2,11,11,0,6,3,1,0,2
S01010065,All households,413,182,65,117,199,23,87,33,28,26,89,54,35,32,11,0,2,19
S01010065,Occupancy rating +2 or more,86,43,23,20,42,16,21,20,0,1,5,3,2,1,0,0,0,1
S01010065,Occupancy rating +1,133,78,26,52,48,4,27,12,7,8,17,6,11,7,1,0,1,5
S01010065,Occupancy rating 0,111,28,8,20,73,3,25,0,12,13,45,29,16,10,4,0,1,5
S01010065,Occupancy rating -1 or less,83,33,8,25,36,0,14,1,9,4,22,16,6,14,6,0,0,8
S01010066,All households,342,118,39,79,194,16,83,27,40,16,95,64,31,30,18,4,0,8
S01010066,Occupancy rating +2 or more,43,22,8,14,21,8,11,10,1,0,2,0,2,0,0,0,0,0
S01010066,Occupancy rating +1,110,47,18,29,58,6,32,9,14,9,20,8,12,5,2,0,0,3
S01010066,Occupancy rating 0,111,29,7,22,73,2,27,6,16,5,44,34,10,9,5,2,0,2
S01010066,Occupancy rating -1 or less,78,20,6,14,42,0,13,2,9,2,29,22,7,16,11,2,0,3
S01010067,All households,297,122,49,73,148,1,60,27,21,12,87,64,23,27,13,3,0,11
S01010067,Occupancy rating +2 or more,21,11,4,7,9,1,5,3,1,1,3,3,0,1,0,0,0,1
S01010067,Occupancy rating +1,79,44,10,34,34,0,20,15,3,2,14,8,6,1,0,0,0,1
S01010067,Occupancy rating 0,134,50,26,24,73,0,26,7,16,3,47,36,11,11,3,3,0,5
S01010067,Occupancy rating -1 or less,63,17,9,8,32,0,9,2,1,6,23,17,6,14,10,0,0,4
S01010068,All households,338,169,59,110,143,12,95,52,35,8,36,27,9,26,8,2,0,16
S01010068,Occupancy rating +2 or more,42,22,0,22,18,1,16,14,2,0,1,1,0,2,1,0,0,1
S01010068,Occupancy rating +1,77,39,9,30,33,1,31,18,10,3,1,1,0,5,2,0,0,3
S01010068,Occupancy rating 0,137,67,33,34,64,7,35,13,18,4,22,17,5,6,0,0,0,6
S01010068,Occupancy rating -1 or less,82,41,17,24,28,3,13,7,5,1,12,8,4,13,5,2,0,6
S01010069,All households,340,93,30,63,232,22,176,55,65,56,34,27,7,15,7,1,1,6
S01010069,Occupancy rating +2 or more,94,18,5,13,73,8,63,21,20,22,2,1,1,3,3,0,0,0
S01010069,Occupancy rating +1,124,46,20,26,73,12,50,19,16,15,11,8,3,5,0,1,1,3
S01010069,Occupancy rating 0,100,21,2,19,72,2,54,15,21,18,16,14,2,7,4,0,0,3
S01010069,Occupancy rating -1 or less,22,8,3,5,14,0,9,0,8,1,5,4,1,0,0,0,0,0
S01010070,All households,238,34,8,26,186,5,149,44,59,46,32,18,14,18,11,1,0,6
S01010070,Occupancy rating +2 or more,80,18,4,14,58,3,52,25,11,16,3,2,1,4,3,0,0,1
S01010070,Occupancy rating +1,78,15,4,11,61,0,52,14,19,19,9,6,3,2,1,0,0,1
S01010070,Occupancy rating 0,63,0,0,0,55,2,36,4,24,8,17,9,8,8,5,0,0,3
S01010070,Occupancy rating -1 or less,17,1,0,1,12,0,9,1,5,3,3,1,2,4,2,1,0,1
S01010071,All households,367,137,75,62,209,26,127,49,48,30,56,30,26,21,10,1,1,9
S01010071,Occupancy rating +2 or more,124,38,27,11,77,16,51,32,10,9,10,5,5,9,4,1,0,4
S01010071,Occupancy rating +1,123,52,25,27,67,5,42,10,19,13,20,11,9,4,3,0,0,1
S01010071,Occupancy rating 0,86,38,15,23,47,5,22,6,11,5,20,11,9,1,0,0,0,1
S01010071,Occupancy rating -1 or less,34,9,8,1,18,0,12,1,8,3,6,3,3,7,3,0,1,3
S01010072,All households,370,135,58,77,216,32,141,45,56,40,43,21,22,19,7,2,3,7
S01010072,Occupancy rating +2 or more,70,22,12,10,45,12,31,16,11,4,2,0,2,3,2,0,0,1
S01010072,Occupancy rating +1,133,59,31,28,69,15,44,23,7,14,10,5,5,5,2,0,1,2
S01010072,Occupancy rating 0,89,15,8,7,68,2,43,4,26,13,23,10,13,6,1,0,1,4
S01010072,Occupancy rating -1 or less,78,39,7,32,34,3,23,2,12,9,8,6,2,5,2,2,1,0
S01010073,All households,349,105,71,34,226,45,147,49,62,36,34,18,16,18,6,3,2,7
S01010073,Occupancy rating +2 or more,125,31,23,8,93,26,59,31,20,8,8,2,6,1,0,0,0,1
S01010073,Occupancy rating +1,131,55,35,20,72,14,47,16,18,13,11,4,7,4,0,0,2,2
S01010073,Occupancy rating 0,68,11,6,5,50,5,36,2,22,12,9,6,3,7,3,0,0,4
S01010073,Occupancy rating -1 or less,25,8,7,1,11,0,5,0,2,3,6,6,0,6,3,3,0,0
S01010074,All households,306,91,34,57,197,50,124,44,41,39,23,14,9,18,10,0,0,8
S01010074,Occupancy rating +2 or more,116,33,15,18,78,24,48,22,12,14,6,4,2,5,4,0,0,1
S01010074,Occupancy rating +1,88,29,12,17,59,16,36,18,11,7,7,5,2,0,0,0,0,0
S01010074,Occupancy rating 0,66,19,5,14,39,5,28,3,11,14,6,3,3,8,2,0,0,6
S01010074,Occupancy rating -1 or less,36,10,2,8,21,5,12,1,7,4,4,2,2,5,4,0,0,1
S01010075,All households,303,105,62,43,187,42,102,40,32,30,43,25,18,11,5,0,2,4
S01010075,Occupancy rating +2 or more,60,32,23,9,27,8,16,12,2,2,3,2,1,1,0,0,1,0
S01010075,Occupancy rating +1,131,46,22,24,82,26,47,25,10,12,9,3,6,3,1,0,0,2
S01010075,Occupancy rating 0,80,22,14,8,55,3,30,3,14,13,22,13,9,3,0,0,1,2
S01010075,Occupancy rating -1 or less,32,5,3,2,23,5,9,0,6,3,9,7,2,4,4,0,0,0
S01010076,All households,276,62,24,38,193,20,119,37,48,34,54,31,23,21,11,1,1,8
S01010076,Occupancy rating +2 or more,57,21,12,9,36,8,23,16,5,2,5,1,4,0,0,0,0,0
S01010076,Occupancy rating +1,93,31,9,22,60,8,40,18,11,11,12,5,7,2,0,0,1,1
S01010076,Occupancy rating 0,88,7,2,5,73,4,41,3,23,15,28,18,10,8,2,0,0,6
S01010076,Occupancy rating -1 or less,38,3,1,2,24,0,15,0,9,6,9,7,2,11,9,1,0,1
S01010077,All households,302,127,50,77,155,10,80,39,27,14,65,35,30,20,10,2,0,8
S01010077,Occupancy rating +2 or more,58,25,8,17,29,1,21,15,4,2,7,3,4,4,1,1,0,2
S01010077,Occupancy rating +1,97,54,21,33,39,4,24,17,2,5,11,3,8,4,1,0,0,3
S01010077,Occupancy rating 0,94,36,16,20,56,3,23,6,12,5,30,18,12,2,1,0,0,1
S01010077,Occupancy rating -1 or less,53,12,5,7,31,2,12,1,9,2,17,11,6,10,7,1,0,2
S01010078,All households,229,37,18,19,178,11,146,54,62,30,21,6,15,14,10,0,0,4
S01010078,Occupancy rating +2 or more,130,22,13,9,105,8,92,49,28,15,5,1,4,3,1,0,0,2
S01010078,Occupancy rating +1,41,8,3,5,31,2,23,4,12,7,6,2,4,2,2,0,0,0
S01010078,Occupancy rating 0,37,4,0,4,31,1,23,1,15,7,7,3,4,2,2,0,0,0
S01010078,Occupancy rating -1 or less,21,3,2,1,11,0,8,0,7,1,3,0,3,7,5,0,0,2
S01010079,All households,349,57,36,21,277,52,208,71,80,57,17,8,9,15,6,0,2,7
S01010079,Occupancy rating +2 or more,235,38,25,13,191,44,140,61,50,29,7,4,3,6,2,0,1,3
S01010079,Occupancy rating +1,65,17,11,6,48,7,36,9,13,14,5,2,3,0,0,0,0,0
S01010079,Occupancy rating 0,41,2,0,2,32,1,27,1,14,12,4,2,2,7,3,0,1,3
S01010079,Occupancy rating -1 or less,8,0,0,0,6,0,5,0,3,2,1,0,1,2,1,0,0,1
S01010080,All households,284,79,54,25,195,46,138,46,50,42,11,3,8,10,3,1,0,6
S01010080,Occupancy rating +2 or more,127,41,27,14,85,24,58,27,19,12,3,1,2,1,0,0,0,1
S01010080,Occupancy rating +1,99,33,24,9,64,21,41,17,11,13,2,1,1,2,0,0,0,2
S01010080,Occupancy rating 0,49,4,3,1,40,0,35,1,19,15,5,0,5,5,1,1,0,3
S01010080,Occupancy rating -1 or less,9,1,0,1,6,1,4,1,1,2,1,1,0,2,2,0,0,0
S01010081,All households,300,84,48,36,197,53,122,46,44,32,22,9,13,19,12,1,2,4
S01010081,Occupancy rating +2 or more,186,49,28,21,128,45,78,40,23,15,5,2,3,9,4,0,2,3
S01010081,Occupancy rating +1,68,25,15,10,41,4,30,6,13,11,7,4,3,2,2,0,0,0
S01010081,Occupancy rating 0,27,7,4,3,13,1,5,0,2,3,7,1,6,7,5,1,0,1
S01010081,Occupancy rating -1 or less,19,3,1,2,15,3,9,0,6,3,3,2,1,1,1,0,0,0
S01010082,All households,407,146,69,77,242,25,170,79,50,41,47,32,15,19,8,3,1,7
S01010082,Occupancy rating +2 or more,155,38,20,18,113,15,92,40,29,23,6,2,4,4,3,0,0,1
S01010082,Occupancy rating +1,144,73,36,37,64,8,48,27,10,11,8,5,3,7,3,1,0,3
S01010082,Occupancy rating 0,83,33,11,22,47,0,26,11,10,5,21,14,7,3,1,0,1,1
S01010082,Occupancy rating -1 or less,25,2,2,0,18,2,4,1,1,2,12,11,1,5,1,2,0,2
S01010083,All households,348,152,77,75,175,22,98,38,34,26,55,31,24,21,12,0,0,9
S01010083,Occupancy rating +2 or more,50,31,20,11,18,2,13,7,4,2,3,1,2,1,1,0,0,0
S01010083,Occupancy rating +1,124,64,36,28,60,16,35,25,7,3,9,5,4,0,0,0,0,0
S01010083,Occupancy rating 0,124,52,18,34,66,4,38,5,17,16,24,14,10,6,1,0,0,5
S01010083,Occupancy rating -1 or less,50,5,3,2,31,0,12,1,6,5,19,11,8,14,10,0,0,4
S01010084,All households,442,187,74,113,235,29,124,52,46,26,82,42,40,20,10,1,2,7
S01010084,Occupancy rating +2 or more,58,31,14,17,27,8,18,9,7,2,1,1,0,0,0,0,0,0
S01010084,Occupancy rating +1,165,79,34,45,85,15,48,33,7,8,22,9,13,1,0,0,0,1
S01010084,Occupancy rating 0,166,64,21,43,95,4,44,10,22,12,47,24,23,7,2,1,1,3
S01010084,Occupancy rating -1 or less,53,13,5,8,28,2,14,0,10,4,12,8,4,12,8,0,1,3
S01010085,All households,311,77,40,37,221,40,158,44,63,51,23,7,16,13,7,0,0,6
S01010085,Occupancy rating +2 or more,156,51,26,25,104,29,72,39,19,14,3,2,1,1,0,0,0,1
S01010085,Occupancy rating +1,88,22,12,10,62,7,48,3,21,24,7,2,5,4,1,0,0,3
S01010085,Occupancy rating 0,52,3,2,1,44,3,33,2,20,11,8,0,8,5,4,0,0,1
S01010085,Occupancy rating -1 or less,15,1,0,1,11,1,5,0,3,2,5,3,2,3,2,0,0,1
S01010086,All households,414,142,76,66,249,22,130,44,52,34,97,50,47,23,10,0,3,10
S01010086,Occupancy rating +2 or more,65,38,24,14,26,4,18,11,5,2,4,1,3,1,0,0,1,0
S01010086,Occupancy rating +1,169,77,36,41,91,16,53,30,13,10,22,5,17,1,0,0,0,1
S01010086,Occupancy rating 0,122,15,8,7,94,2,40,2,21,17,52,28,24,13,4,0,2,7
S01010086,Occupancy rating -1 or less,58,12,8,4,38,0,19,1,13,5,19,16,3,8,6,0,0,2
S01010087,All households,247,59,42,17,179,40,123,48,47,28,16,6,10,9,2,0,0,7
S01010087,Occupancy rating +2 or more,144,46,35,11,96,35,59,38,15,6,2,0,2,2,0,0,0,2
S01010087,Occupancy rating +1,55,9,5,4,44,5,34,9,15,10,5,1,4,2,0,0,0,2
S01010087,Occupancy rating 0,38,3,1,2,31,0,24,1,14,9,7,4,3,4,1,0,0,3
S01010087,Occupancy rating -1 or less,10,1,1,0,8,0,6,0,3,3,2,1,1,1,1,0,0,0
S01010088,All households,295,48,2,46,231,6,195,67,113,15,30,22,8,16,10,1,1,4
S01010088,Occupancy rating +2 or more,196,16,1,15,172,5,155,55,87,13,12,8,4,8,7,0,1,0
S01010088,Occupancy rating +1,53,19,0,19,29,1,24,5,18,1,4,3,1,5,2,0,0,3
S01010088,Occupancy rating 0,33,13,1,12,20,0,12,6,5,1,8,7,1,0,0,0,0,0
S01010088,Occupancy rating -1 or less,13,0,0,0,10,0,4,1,3,0,6,4,2,3,1,1,0,1
S01010089,All households,365,184,77,107,164,26,105,41,35,29,33,19,14,17,5,4,1,7
S01010089,Occupancy rating +2 or more,56,20,8,12,34,9,25,11,10,4,0,0,0,2,1,0,0,1
S01010089,Occupancy rating +1,97,50,30,20,47,11,29,15,8,6,7,4,3,0,0,0,0,0
S01010089,Occupancy rating 0,144,89,33,56,48,3,32,10,9,13,13,5,8,7,2,1,1,3
S01010089,Occupancy rating -1 or less,68,25,6,19,35,3,19,5,8,6,13,10,3,8,2,3,0,3
S01010090,All households,435,128,46,82,285,14,214,69,106,39,57,43,14,22,8,4,0,10
S01010090,Occupancy rating +2 or more,133,33,13,20,95,8,86,34,44,8,1,1,0,5,4,0,0,1
S01010090,Occupancy rating +1,121,41,11,30,76,3,62,23,26,13,11,7,4,4,1,0,0,3
S01010090,Occupancy rating 0,133,37,15,22,87,2,49,9,27,13,36,27,9,9,3,2,0,4
S01010090,Occupancy rating -1 or less,48,17,7,10,27,1,17,3,9,5,9,8,1,4,0,2,0,2
S01010091,All households,343,75,12,63,249,11,194,72,96,26,44,30,14,19,7,3,1,8
S01010091,Occupancy rating +2 or more,123,19,3,16,103,2,94,43,44,7,7,5,2,1,1,0,0,0
S01010091,Occupancy rating +1,94,29,6,23,62,9,50,17,24,9,3,1,2,3,2,0,0,1
S01010091,Occupancy rating 0,93,24,3,21,62,0,42,12,23,7,20,14,6,7,1,0,1,5
S01010091,Occupancy rating -1 or less,33,3,0,3,22,0,8,0,5,3,14,10,4,8,3,3,0,2
S01010092,All households,446,158,70,88,246,34,129,51,50,28,83,44,39,42,18,0,2,22
S01010092,Occupancy rating +2 or more,73,26,11,15,44,15,25,12,8,5,4,1,3,3,1,0,0,2
S01010092,Occupancy rating +1,179,93,42,51,80,13,49,33,9,7,18,9,9,6,1,0,0,5
S01010092,Occupancy rating 0,133,26,11,15,88,4,38,5,21,12,46,24,22,19,4,0,2,13
S01010092,Occupancy rating -1 or less,61,13,6,7,34,2,17,1,12,4,15,10,5,14,12,0,0,2
S01010093,All households,386,119,38,81,243,25,155,63,61,31,63,40,23,24,12,2,1,9
S01010093,Occupancy rating +2 or more,99,32,16,16,64,15,45,28,12,5,4,2,2,3,1,1,0,1
S01010093,Occupancy rating +1,128,55,19,36,68,8,50,27,8,15,10,5,5,5,2,0,0,3
S01010093,Occupancy rating 0,109,21,1,20,78,2,40,1,30,9,36,24,12,10,4,0,1,5
S01010093,Occupancy rating -1 or less,50,11,2,9,33,0,20,7,11,2,13,9,4,6,5,1,0,0
S01010094,All households,291,91,62,29,188,24,121,37,51,33,43,26,17,12,6,0,0,6
S01010094,Occupancy rating +2 or more,115,36,25,11,77,14,56,29,16,11,7,3,4,2,0,0,0,2
S01010094,Occupancy rating +1,88,25,15,10,59,8,34,7,15,12,17,10,7,4,1,0,0,3
S01010094,Occupancy rating 0,61,24,17,7,35,2,23,1,15,7,10,7,3,2,2,0,0,0
S01010094,Occupancy rating -1 or less,27,6,5,1,17,0,8,0,5,3,9,6,3,4,3,0,0,1
S01010095,All households,279,61,37,24,208,39,145,51,51,43,24,15,9,10,8,0,0,2
S01010095,Occupancy rating +2 or more,106,29,23,6,76,20,48,24,14,10,8,5,3,1,0,0,0,1
S01010095,Occupancy rating +1,94,28,11,17,65,17,45,23,11,11,3,2,1,1,0,0,0,1
S01010095,Occupancy rating 0,56,4,3,1,50,0,38,3,19,16,12,7,5,2,2,0,0,0
S01010095,Occupancy rating -1 or less,23,0,0,0,17,2,14,1,7,6,1,1,0,6,6,0,0,0
S01010096,All households,292,64,33,31,212,20,158,45,81,32,34,20,14,16,10,0,0,6
S01010096,Occupancy rating +2 or more,94,13,8,5,77,11,63,24,28,11,3,3,0,4,2,0,0,2
S01010096,Occupancy rating +1,110,44,19,25,64,8,50,18,24,8,6,1,5,2,0,0,0,2
S01010096,Occupancy rating 0,60,4,3,1,52,0,33,1,22,10,19,12,7,4,3,0,0,1
S01010096,Occupancy rating -1 or less,28,3,3,0,19,1,12,2,7,3,6,4,2,6,5,0,0,1
S01010097,All households,286,63,43,20,208,31,135,40,62,33,42,29,13,15,8,0,1,6
S01010097,Occupancy rating +2 or more,137,44,32,12,90,27,55,33,15,7,8,3,5,3,1,0,0,2
S01010097,Occupancy rating +1,63,12,8,4,48,3,38,5,16,17,7,4,3,3,1,0,1,1
S01010097,Occupancy rating 0,61,7,3,4,50,0,30,1,23,6,20,17,3,4,2,0,0,2
S01010097,Occupancy rating -1 or less,25,0,0,0,20,1,12,1,8,3,7,5,2,5,4,0,0,1
S01010098,All households,277,54,36,18,207,33,150,40,80,30,24,13,11,16,6,0,0,10
S01010098,Occupancy rating +2 or more,147,41,31,10,102,28,70,32,27,11,4,1,3,4,2,0,0,2
S01010098,Occupancy rating +1,76,9,3,6,59,3,49,8,28,13,7,1,6,8,1,0,0,7
S01010098,Occupancy rating 0,38,3,2,1,32,0,21,0,16,5,11,10,1,3,3,0,0,0
S01010098,Occupancy rating -1 or less,16,1,0,1,14,2,10,0,9,1,2,1,1,1,0,0,0,1
S01010099,All households,285,77,44,33,188,37,124,30,58,36,27,11,16,20,12,0,0,8
S01010099,Occupancy rating +2 or more,129,44,27,17,81,28,46,23,16,7,7,2,5,4,3,0,0,1
S01010099,Occupancy rating +1,87,23,11,12,58,7,40,7,17,16,11,4,7,6,2,0,0,4
S01010099,Occupancy rating 0,51,8,6,2,36,1,28,0,17,11,7,3,4,7,4,0,0,3
S01010099,Occupancy rating -1 or less,18,2,0,2,13,1,10,0,8,2,2,2,0,3,3,0,0,0
S01010100,All households,382,104,58,46,259,34,181,75,69,37,44,18,26,19,8,0,4,7
S01010100,Occupancy rating +2 or more,179,49,29,20,127,21,97,58,27,12,9,5,4,3,2,0,0,1
S01010100,Occupancy rating +1,117,48,26,22,64,10,42,14,18,10,12,6,6,5,3,0,0,2
S01010100,Occupancy rating 0,61,4,3,1,49,2,30,2,18,10,17,5,12,8,1,0,4,3
S01010100,Occupancy rating -1 or less,25,3,0,3,19,1,12,1,6,5,6,2,4,3,2,0,0,1
S01010101,All households,299,75,44,31,204,29,147,54,52,41,28,20,8,20,6,0,1,13
S01010101,Occupancy rating +2 or more,136,34,22,12,96,18,74,43,19,12,4,3,1,6,3,0,0,3
S01010101,Occupancy rating +1,81,24,17,7,52,9,34,8,10,16,9,5,4,5,2,0,1,2
S01010101,Occupancy rating 0,66,15,5,10,44,2,29,1,18,10,13,10,3,7,1,0,0,6
S01010101,Occupancy rating -1 or less,16,2,0,2,12,0,10,2,5,3,2,2,0,2,0,0,0,2
S01010102,All households,324,45,10,35,264,7,217,51,116,50,40,24,16,15,6,2,0,7
S01010102,Occupancy rating +2 or more,153,15,3,12,132,7,118,32,62,24,7,3,4,6,3,0,0,3
S01010102,Occupancy rating +1,87,18,6,12,65,0,57,14,26,17,8,5,3,4,2,0,0,2
S01010102,Occupancy rating 0,67,10,1,9,52,0,33,4,21,8,19,12,7,5,1,2,0,2
S01010102,Occupancy rating -1 or less,17,2,0,2,15,0,9,1,7,1,6,4,2,0,0,0,0,0
S01010103,All households,355,67,19,48,276,7,224,56,124,44,45,30,15,12,4,1,0,7
S01010103,Occupancy rating +2 or more,125,20,4,16,104,2,95,32,43,20,7,6,1,1,0,0,0,1
S01010103,Occupancy rating +1,119,38,13,25,78,3,67,22,34,11,8,2,6,3,1,0,0,2
S01010103,Occupancy rating 0,81,6,2,4,70,2,44,1,32,11,24,18,6,5,1,1,0,3
S01010103,Occupancy rating -1 or less,30,3,0,3,24,0,18,1,15,2,6,4,2,3,2,0,0,1
S01010104,All households,267,51,11,40,204,3,167,41,101,25,34,30,4,12,6,1,0,5
S01010104,Occupancy rating +2 or more,119,25,7,18,89,2,78,31,38,9,9,8,1,5,3,0,0,2
S01010104,Occupancy rating +1,77,14,2,12,60,0,51,9,31,11,9,9,0,3,0,0,0,3
S01010104,Occupancy rating 0,56,12,2,10,41,1,27,1,22,4,13,11,2,3,3,0,0,0
S01010104,Occupancy rating -1 or less,15,0,0,0,14,0,11,0,10,1,3,2,1,1,0,1,0,0
S01010105,All households,165,45,6,39,106,0,54,17,21,16,52,35,17,14,9,2,0,3
S01010105,Occupancy rating +2 or more,17,6,1,5,10,0,6,3,1,2,4,4,0,1,1,0,0,0
S01010105,Occupancy rating +1,60,31,3,28,27,0,18,10,4,4,9,3,6,2,1,0,0,1
S01010105,Occupancy rating 0,56,4,1,3,46,0,21,0,13,8,25,18,7,6,2,2,0,2
S01010105,Occupancy rating -1 or less,32,4,1,3,23,0,9,4,3,2,14,10,4,5,5,0,0,0
S01010106,All households,219,92,35,57,114,11,48,10,21,17,55,37,18,13,4,1,2,6
S01010106,Occupancy rating +2 or more,12,6,1,5,6,1,4,1,3,0,1,1,0,0,0,0,0,0
S01010106,Occupancy rating +1,86,63,24,39,21,8,10,9,0,1,3,2,1,2,0,1,0,1
S01010106,Occupancy rating 0,72,11,4,7,56,0,27,0,15,12,29,19,10,5,0,0,2,3
S01010106,Occupancy rating -1 or less,49,12,6,6,31,2,7,0,3,4,22,15,7,6,4,0,0,2
S01010107,All households,404,177,41,136,198,12,93,39,36,18,93,70,23,29,7,11,3,8
S01010107,Occupancy rating +2 or more,34,17,3,14,17,3,10,6,4,0,4,1,3,0,0,0,0,0
S01010107,Occupancy rating +1,128,86,15,71,36,3,29,26,1,2,4,1,3,6,2,1,2,1
S01010107,Occupancy rating 0,149,44,19,25,98,5,34,3,17,14,59,46,13,7,0,5,0,2
S01010107,Occupancy rating -1 or less,93,30,4,26,47,1,20,4,14,2,26,22,4,16,5,5,1,5
S01010108,All households,374,172,66,106,182,13,117,59,30,28,52,28,24,20,11,1,1,7
S01010108,Occupancy rating +2 or more,28,4,2,2,22,2,16,11,3,2,4,3,1,2,1,0,0,1
S01010108,Occupancy rating +1,123,55,18,37,66,5,50,39,3,8,11,7,4,2,0,1,1,0
S01010108,Occupancy rating 0,139,74,32,42,60,5,33,6,15,12,22,11,11,5,3,0,0,2
S01010108,Occupancy rating -1 or less,84,39,14,25,34,1,18,3,9,6,15,7,8,11,7,0,0,4
S01010109,All households,326,97,13,84,198,8,114,63,32,19,76,60,16,31,10,9,0,12
S01010109,Occupancy rating +2 or more,67,21,4,17,43,4,35,25,7,3,4,3,1,3,1,0,0,2
S01010109,Occupancy rating +1,105,47,2,45,55,3,34,27,3,4,18,12,6,3,1,1,0,1
S01010109,Occupancy rating 0,97,17,3,14,66,1,31,9,14,8,34,26,8,14,3,6,0,5
S01010109,Occupancy rating -1 or less,57,12,4,8,34,0,14,2,8,4,20,19,1,11,5,2,0,4
S01010110,All households,431,193,82,111,220,26,98,38,37,23,96,58,38,18,9,1,0,8
S01010110,Occupancy rating +2 or more,15,12,3,9,2,0,2,1,1,0,0,0,0,1,1,0,0,0
S01010110,Occupancy rating +1,201,137,59,78,64,22,36,32,3,1,6,2,4,0,0,0,0,0
S01010110,Occupancy rating 0,143,19,7,12,117,2,48,3,28,17,67,36,31,7,1,1,0,5
S01010110,Occupancy rating -1 or less,72,25,13,12,37,2,12,2,5,5,23,20,3,10,7,0,0,3
S01010111,All households,446,171,51,120,249,9,112,34,51,27,128,89,39,26,11,3,1,11
S01010111,Occupancy rating +2 or more,56,18,4,14,34,1,20,10,4,6,13,7,6,4,1,0,0,3
S01010111,Occupancy rating +1,121,65,16,49,54,6,31,18,8,5,17,11,6,2,1,0,0,1
S01010111,Occupancy rating 0,161,53,20,33,97,1,32,1,23,8,64,46,18,11,6,0,0,5
S01010111,Occupancy rating -1 or less,108,35,11,24,64,1,29,5,16,8,34,25,9,9,3,3,1,2
S01010112,All households,419,140,28,112,262,7,107,39,47,21,148,104,44,17,10,0,1,6
S01010112,Occupancy rating +2 or more,35,19,2,17,13,0,6,3,3,0,7,6,1,3,1,0,1,1
S01010112,Occupancy rating +1,118,51,8,43,67,4,39,26,6,7,24,12,12,0,0,0,0,0
S01010112,Occupancy rating 0,177,51,12,39,122,3,43,7,24,12,76,57,19,4,2,0,0,2
S01010112,Occupancy rating -1 or less,89,19,6,13,60,0,19,3,14,2,41,29,12,10,7,0,0,3
S01010113,All households,244,81,14,67,154,11,71,20,37,14,72,55,17,9,6,1,0,2
S01010113,Occupancy rating +2 or more,31,17,1,16,14,5,6,6,0,0,3,3,0,0,0,0,0,0
S01010113,Occupancy rating +1,84,41,5,36,42,5,24,11,7,6,13,9,4,1,1,0,0,0
S01010113,Occupancy rating 0,84,13,6,7,67,1,29,2,21,6,37,28,9,4,1,1,0,2
S01010113,Occupancy rating -1 or less,45,10,2,8,31,0,12,1,9,2,19,15,4,4,4,0,0,0
S01010114,All households,366,145,41,104,200,12,91,30,43,18,97,57,40,21,8,1,1,11
S01010114,Occupancy rating +2 or more,30,18,3,15,9,0,6,6,0,0,3,1,2,3,1,0,0,2
S01010114,Occupancy rating +1,114,72,24,48,42,5,25,14,5,6,12,6,6,0,0,0,0,0
S01010114,Occupancy rating 0,152,38,11,27,106,3,45,7,30,8,58,38,20,8,2,0,1,5
S01010114,Occupancy rating -1 or less,70,17,3,14,43,4,15,3,8,4,24,12,12,10,5,1,0,4
S01010115,All households,230,47,8,39,165,4,115,30,59,26,46,36,10,18,12,0,0,6
S01010115,Occupancy rating +2 or more,55,17,4,13,36,2,32,16,12,4,2,1,1,2,0,0,0,2
S01010115,Occupancy rating +1,85,27,4,23,56,2,38,12,10,16,16,12,4,2,1,0,0,1
S01010115,Occupancy rating 0,66,3,0,3,53,0,35,1,30,4,18,16,2,10,7,0,0,3
S01010115,Occupancy rating -1 or less,24,0,0,0,20,0,10,1,7,2,10,7,3,4,4,0,0,0
S01010116,All households,397,70,7,63,284,4,203,78,89,36,77,56,21,43,15,10,0,18
S01010116,Occupancy rating +2 or more,92,30,3,27,58,1,50,39,7,4,7,6,1,4,2,0,0,2
S01010116,Occupancy rating +1,155,32,2,30,116,2,92,34,42,16,22,16,6,7,0,1,0,6
S01010116,Occupancy rating 0,104,7,1,6,75,1,39,3,28,8,35,25,10,22,7,8,0,7
S01010116,Occupancy rating -1 or less,46,1,1,0,35,0,22,2,12,8,13,9,4,10,6,1,0,3
S01010117,All households,261,60,10,50,178,3,138,52,67,19,37,26,11,23,11,3,0,9
S01010117,Occupancy rating +2 or more,116,21,1,20,88,2,79,36,33,10,7,6,1,7,4,0,0,3
S01010117,Occupancy rating +1,63,23,4,19,37,1,29,10,16,3,7,6,1,3,1,1,0,1
S01010117,Occupancy rating 0,55,9,3,6,39,0,23,5,13,5,16,7,9,7,1,2,0,4
S01010117,Occupancy rating -1 or less,27,7,2,5,14,0,7,1,5,1,7,7,0,6,5,0,0,1
S01010118,All households,277,96,31,65,153,4,54,12,31,11,95,70,25,28,15,0,0,13
S01010118,Occupancy rating +2 or more,25,9,4,5,14,0,8,2,5,1,6,2,4,2,0,0,0,2
S01010118,Occupancy rating +1,90,53,14,39,30,2,18,10,4,4,10,6,4,7,3,0,0,4
S01010118,Occupancy rating 0,102,26,13,13,70,2,18,0,13,5,50,36,14,6,3,0,0,3
S01010118,Occupancy rating -1 or less,60,8,0,8,39,0,10,0,9,1,29,26,3,13,9,0,0,4
S01010119,All households,209,50,13,37,146,5,69,21,33,15,72,49,23,13,10,0,0,3
S01010119,Occupancy rating +2 or more,19,9,0,9,10,0,9,7,2,0,1,0,1,0,0,0,0,0
S01010119,Occupancy rating +1,58,21,7,14,36,3,15,10,3,2,18,10,8,1,1,0,0,0
S01010119,Occupancy rating 0,99,16,6,10,75,2,39,4,22,13,34,27,7,8,5,0,0,3
S01010119,Occupancy rating -1 or less,33,4,0,4,25,0,6,0,6,0,19,12,7,4,4,0,0,0
S01010120,All households,444,144,35,109,271,7,108,30,47,31,156,114,42,29,15,1,2,11
S01010120,Occupancy rating +2 or more,63,29,5,24,32,3,20,13,2,5,9,6,3,2,0,0,1,1
S01010120,Occupancy rating +1,120,65,17,48,53,2,26,10,8,8,25,14,11,2,1,0,1,0
S01010120,Occupancy rating 0,180,40,11,29,131,1,42,3,26,13,88,67,21,9,3,0,0,6
S01010120,Occupancy rating -1 or less,81,10,2,8,55,1,20,4,11,5,34,27,7,16,11,1,0,4
S01010121,All households,321,138,46,92,166,4,80,28,36,16,82,55,27,17,13,0,0,4
S01010121,Occupancy rating +2 or more,29,14,4,10,13,1,8,6,2,0,4,2,2,2,0,0,0,2
S01010121,Occupancy rating +1,117,76,23,53,41,2,24,16,4,4,15,10,5,0,0,0,0,0
S01010121,Occupancy rating 0,112,31,10,21,75,1,28,4,18,6,46,34,12,6,5,0,0,1
S01010121,Occupancy rating -1 or less,63,17,9,8,37,0,20,2,12,6,17,9,8,9,8,0,0,1
S01010122,All households,198,86,26,60,101,3,48,14,15,19,50,31,19,11,6,1,1,3
S01010122,Occupancy rating +2 or more,18,5,2,3,13,0,5,0,3,2,8,7,1,0,0,0,0,0
S01010122,Occupancy rating +1,66,35,9,26,29,1,19,10,6,3,9,7,2,2,2,0,0,0
S01010122,Occupancy rating 0,70,34,10,24,34,2,15,3,2,10,17,10,7,2,1,0,0,1
S01010122,Occupancy rating -1 or less,44,12,5,7,25,0,9,1,4,4,16,7,9,7,3,1,1,2
S01010123,All households,299,92,23,69,180,7,80,17,46,17,93,64,29,27,16,1,0,10
S01010123,Occupancy rating +2 or more,33,14,2,12,17,2,9,4,3,2,6,3,3,2,1,0,0,1
S01010123,Occupancy rating +1,104,48,12,36,54,4,26,8,9,9,24,14,10,2,1,0,0,1
S01010123,Occupancy rating 0,119,25,7,18,79,0,33,4,24,5,46,36,10,15,7,1,0,7
S01010123,Occupancy rating -1 or less,43,5,2,3,30,1,12,1,10,1,17,11,6,8,7,0,0,1
S01010124,All households,293,100,13,87,180,2,109,41,49,19,69,50,19,13,6,4,0,3
S01010124,Occupancy rating +2 or more,28,15,1,14,13,0,11,11,0,0,2,2,0,0,0,0,0,0
S01010124,Occupancy rating +1,129,65,9,56,62,1,50,27,18,5,11,8,3,2,0,0,0,2
S01010124,Occupancy rating 0,98,13,3,10,79,0,39,2,25,12,40,26,14,6,2,4,0,0
S01010124,Occupancy rating -1 or less,38,7,0,7,26,1,9,1,6,2,16,14,2,5,4,0,0,1
S01010125,All households,242,80,12,68,143,3,76,29,40,7,64,48,16,19,11,0,0,8
S01010125,Occupancy rating +2 or more,25,15,5,10,9,0,9,9,0,0,0,0,0,1,0,0,0,1
S01010125,Occupancy rating +1,80,43,3,40,36,2,26,15,8,3,8,5,3,1,1,0,0,0
S01010125,Occupancy rating 0,98,15,3,12,75,0,31,4,24,3,44,38,6,8,3,0,0,5
S01010125,Occupancy rating -1 or less,39,7,1,6,23,1,10,1,8,1,12,5,7,9,7,0,0,2
S01010126,All households,312,90,30,60,207,6,138,46,61,31,63,39,24,15,8,0,0,7
S01010126,Occupancy rating +2 or more,76,28,9,19,46,3,40,22,12,6,3,0,3,2,0,0,0,2
S01010126,Occupancy rating +1,113,50,17,33,61,2,44,20,17,7,15,9,6,2,1,0,0,1
S01010126,Occupancy rating 0,95,9,3,6,79,0,42,2,25,15,37,25,12,7,3,0,0,4
S01010126,Occupancy rating -1 or less,28,3,1,2,21,1,12,2,7,3,8,5,3,4,4,0,0,0
S01010127,All households,296,116,48,68,149,18,73,26,23,24,58,27,31,31,11,0,5,15
S01010127,Occupancy rating +2 or more,51,21,12,9,22,6,13,6,3,4,3,1,2,8,0,0,3,5
S01010127,Occupancy rating +1,83,41,22,19,39,9,22,14,5,3,8,5,3,3,1,0,0,2
S01010127,Occupancy rating 0,105,29,9,20,68,2,28,2,11,15,38,19,19,8,2,0,2,4
S01010127,Occupancy rating -1 or less,57,25,5,20,20,1,10,4,4,2,9,2,7,12,8,0,0,4
S01010128,All households,214,72,13,59,129,5,43,9,29,5,81,63,18,13,7,0,1,5
S01010128,Occupancy rating +2 or more,25,14,3,11,11,1,6,3,3,0,4,3,1,0,0,0,0,0
S01010128,Occupancy rating +1,67,33,6,27,34,3,14,5,8,1,17,14,3,0,0,0,0,0
S01010128,Occupancy rating 0,81,16,2,14,60,1,19,1,16,2,40,30,10,5,2,0,0,3
S01010128,Occupancy rating -1 or less,41,9,2,7,24,0,4,0,2,2,20,16,4,8,5,0,1,2
S01010129,All households,350,148,29,119,185,10,76,27,40,9,99,71,28,17,9,4,0,4
S01010129,Occupancy rating +2 or more,36,14,6,8,20,2,12,9,2,1,6,4,2,2,1,0,0,1
S01010129,Occupancy rating +1,119,79,14,65,40,6,31,15,13,3,3,2,1,0,0,0,0,0
S01010129,Occupancy rating 0,125,29,7,22,89,1,24,1,19,4,64,46,18,7,4,0,0,3
S01010129,Occupancy rating -1 or less,70,26,2,24,36,1,9,2,6,1,26,19,7,8,4,4,0,0
S01010130,All households,206,79,46,33,115,18,49,22,17,10,48,32,16,12,8,0,0,4
S01010130,Occupancy rating +2 or more,30,10,3,7,20,7,12,8,3,1,1,0,1,0,0,0,0,0
S01010130,Occupancy rating +1,65,29,12,17,33,8,14,9,1,4,11,4,7,3,2,0,0,1
S01010130,Occupancy rating 0,83,33,25,8,47,3,15,4,8,3,29,23,6,3,2,0,0,1
S01010130,Occupancy rating -1 or less,28,7,6,1,15,0,8,1,5,2,7,5,2,6,4,0,0,2
S01010131,All households,376,103,56,47,257,29,200,81,83,36,28,17,11,16,5,0,1,10
S01010131,Occupancy rating +2 or more,170,49,25,24,117,20,93,55,24,14,4,2,2,4,1,0,0,3
S01010131,Occupancy rating +1,123,36,22,14,81,7,65,24,24,17,9,3,6,6,0,0,0,6
S01010131,Occupancy rating 0,61,10,3,7,46,2,31,2,26,3,13,10,3,5,3,0,1,1
S01010131,Occupancy rating -1 or less,22,8,6,2,13,0,11,0,9,2,2,2,0,1,1,0,0,0
S01010132,All households,497,215,98,117,253,38,107,41,39,27,108,70,38,29,11,5,1,12
S01010132,Occupancy rating +2 or more,84,37,20,17,47,23,19,15,2,2,5,1,4,0,0,0,0,0
S01010132,Occupancy rating +1,138,82,42,40,53,11,26,12,4,10,16,6,10,3,0,0,0,3
S01010132,Occupancy rating 0,184,80,27,53,88,2,35,11,16,8,51,37,14,16,6,3,1,6
S01010132,Occupancy rating -1 or less,91,16,9,7,65,2,27,3,17,7,36,26,10,10,5,2,0,3
S01010133,All households,380,192,73,119,166,27,77,31,25,21,62,37,25,22,10,2,2,8
S01010133,Occupancy rating +2 or more,58,40,22,18,18,6,9,7,0,2,3,2,1,0,0,0,0,0
S01010133,Occupancy rating +1,86,31,9,22,51,9,25,5,11,9,17,8,9,4,1,0,0,3
S01010133,Occupancy rating 0,171,99,33,66,64,9,33,16,9,8,22,15,7,8,5,0,1,2
S01010133,Occupancy rating -1 or less,65,22,9,13,33,3,10,3,5,2,20,12,8,10,4,2,1,3
S01010134,All households,551,274,125,149,247,35,114,56,43,15,98,66,32,30,14,0,3,13
S01010134,Occupancy rating +2 or more,77,44,28,16,32,12,18,9,7,2,2,0,2,1,1,0,0,0
S01010134,Occupancy rating +1,162,90,42,48,69,15,41,29,10,2,13,5,8,3,0,0,1,2
S01010134,Occupancy rating 0,234,121,44,77,100,6,39,13,17,9,55,40,15,13,7,0,1,5
S01010134,Occupancy rating -1 or less,78,19,11,8,46,2,16,5,9,2,28,21,7,13,6,0,1,6
S01010135,All households,365,145,77,68,206,27,103,36,39,28,76,39,37,14,6,0,3,5
S01010135,Occupancy rating +2 or more,90,54,33,21,36,12,20,18,1,1,4,3,1,0,0,0,0,0
S01010135,Occupancy rating +1,120,50,28,22,67,10,38,15,12,11,19,9,10,3,0,0,0,3
S01010135,Occupancy rating 0,104,26,8,18,74,5,31,1,18,12,38,16,22,4,0,0,2,2
S01010135,Occupancy rating -1 or less,51,15,8,7,29,0,14,2,8,4,15,11,4,7,6,0,1,0
S01010136,All households,367,124,48,76,222,25,132,55,54,23,65,33,32,21,9,0,3,9
S01010136,Occupancy rating +2 or more,122,36,18,18,83,14,57,31,15,11,12,6,6,3,2,0,0,1
S01010136,Occupancy rating +1,104,38,15,23,62,9,38,19,14,5,15,5,10,4,1,0,2,1
S01010136,Occupancy rating 0,83,31,7,24,49,1,23,4,15,4,25,12,13,3,2,0,1,0
S01010136,Occupancy rating -1 or less,58,19,8,11,28,1,14,1,10,3,13,10,3,11,4,0,0,7
S01010137,All households,583,329,180,149,233,42,98,41,31,26,93,56,37,21,6,3,5,7
S01010137,Occupancy rating +2 or more,19,10,4,6,9,4,5,4,1,0,0,0,0,0,0,0,0,0
S01010137,Occupancy rating +1,228,161,94,67,66,29,32,28,2,2,5,2,3,1,0,0,1,0
S01010137,Occupancy rating 0,242,118,60,58,111,7,40,8,17,15,64,38,26,13,1,1,4,7
S01010137,Occupancy rating -1 or less,94,40,22,18,47,2,21,1,11,9,24,16,8,7,5,2,0,0
S01010138,All households,660,472,128,344,175,21,74,39,20,15,80,55,25,13,5,1,1,6
S01010138,Occupancy rating +2 or more,50,28,11,17,21,4,15,13,1,1,2,2,0,1,1,0,0,0
S01010138,Occupancy rating +1,104,77,20,57,25,5,12,9,1,2,8,2,6,2,1,0,0,1
S01010138,Occupancy rating 0,407,317,81,236,86,11,38,13,15,10,37,25,12,4,1,1,1,1
S01010138,Occupancy rating -1 or less,99,50,16,34,43,1,9,4,3,2,33,26,7,6,2,0,0,4
S01010139,All households,552,273,115,158,240,32,122,48,41,33,86,47,39,39,11,3,8,17
S01010139,Occupancy rating +2 or more,46,23,12,11,22,7,13,10,3,0,2,0,2,1,0,0,0,1
S01010139,Occupancy rating +1,194,108,55,53,84,19,46,28,10,8,19,9,10,2,1,0,1,0
S01010139,Occupancy rating 0,218,103,31,72,92,4,44,7,20,17,44,27,17,23,5,2,5,11
S01010139,Occupancy rating -1 or less,94,39,17,22,42,2,19,3,8,8,21,11,10,13,5,1,2,5
S01010140,All households,384,171,21,150,200,5,131,54,56,21,64,59,5,13,4,2,1,6
S01010140,Occupancy rating +2 or more,57,23,7,16,34,3,25,13,7,5,6,4,2,0,0,0,0,0
S01010140,Occupancy rating +1,95,35,0,35,57,2,47,26,13,8,8,8,0,3,0,0,0,3
S01010140,Occupancy rating 0,171,92,11,81,75,0,43,10,30,3,32,32,0,4,1,1,0,2
S01010140,Occupancy rating -1 or less,61,21,3,18,34,0,16,5,6,5,18,15,3,6,3,1,1,1
S01010141,All households,447,224,68,156,198,16,72,29,29,14,110,74,36,25,7,1,1,16
S01010141,Occupancy rating +2 or more,25,16,4,12,8,0,8,6,1,1,0,0,0,1,0,0,0,1
S01010141,Occupancy rating +1,118,70,29,41,45,11,22,13,7,2,12,7,5,3,0,0,0,3
S01010141,Occupancy rating 0,215,103,19,84,102,2,29,8,14,7,71,49,22,10,2,1,0,7
S01010141,Occupancy rating -1 or less,89,35,16,19,43,3,13,2,7,4,27,18,9,11,5,0,1,5
S01010142,All households,288,121,32,89,149,7,84,32,33,19,58,41,17,18,5,0,1,12
S01010142,Occupancy rating +2 or more,46,19,6,13,24,4,17,10,4,3,3,2,1,3,0,0,0,3
S01010142,Occupancy rating +1,69,33,12,21,35,1,28,14,9,5,6,2,4,1,0,0,0,1
S01010142,Occupancy rating 0,128,52,10,42,70,2,26,7,12,7,42,32,10,6,2,0,0,4
S01010142,Occupancy rating -1 or less,45,17,4,13,20,0,13,1,8,4,7,5,2,8,3,0,1,4
S01010143,All households,391,182,106,76,194,30,95,31,38,26,69,40,29,15,5,0,3,7
S01010143,Occupancy rating +2 or more,18,11,9,2,7,1,5,5,0,0,1,0,1,0,0,0,0,0
S01010143,Occupancy rating +1,192,141,81,60,49,19,27,20,3,4,3,1,2,2,0,0,1,1
S01010143,Occupancy rating 0,131,21,11,10,104,9,43,5,22,16,52,29,23,6,1,0,0,5
S01010143,Occupancy rating -1 or less,50,9,5,4,34,1,20,1,13,6,13,10,3,7,4,0,2,1
S01010144,All households,372,175,25,150,179,6,96,50,33,13,77,48,29,18,4,0,0,14
S01010144,Occupancy rating +2 or more,36,19,5,14,17,2,13,10,2,1,2,1,1,0,0,0,0,0
S01010144,Occupancy rating +1,90,50,8,42,39,1,24,15,4,5,14,8,6,1,0,0,0,1
S01010144,Occupancy rating 0,156,75,7,68,73,3,34,14,17,3,36,24,12,8,3,0,0,5
S01010144,Occupancy rating -1 or less,90,31,5,26,50,0,25,11,10,4,25,15,10,9,1,0,0,8
S01010145,All households,397,175,74,101,196,12,120,58,43,19,64,44,20,26,11,1,0,14
S01010145,Occupancy rating +2 or more,61,22,10,12,36,4,28,18,6,4,4,2,2,3,1,0,0,2
S01010145,Occupancy rating +1,89,48,21,27,41,5,30,18,8,4,6,2,4,0,0,0,0,0
S01010145,Occupancy rating 0,179,90,35,55,77,2,41,16,16,9,34,26,8,12,4,1,0,7
S01010145,Occupancy rating -1 or less,68,15,8,7,42,1,21,6,13,2,20,14,6,11,6,0,0,5
S01010146,All households,406,212,37,175,166,5,86,32,37,17,75,51,24,28,10,4,0,14
S01010146,Occupancy rating +2 or more,32,13,3,10,16,1,11,7,3,1,4,4,0,3,1,0,0,2
S01010146,Occupancy rating +1,82,55,11,44,26,1,17,10,3,4,8,4,4,1,0,0,0,1
S01010146,Occupancy rating 0,205,111,17,94,84,3,41,11,21,9,40,26,14,10,2,3,0,5
S01010146,Occupancy rating -1 or less,87,33,6,27,40,0,17,4,10,3,23,17,6,14,7,1,0,6
S01010147,All households,494,250,44,206,221,7,96,35,39,22,118,98,20,23,12,1,1,9
S01010147,Occupancy rating +2 or more,34,23,5,18,8,0,8,3,2,3,0,0,0,3,1,0,0,2
S01010147,Occupancy rating +1,120,65,11,54,52,2,26,16,6,4,24,17,7,3,0,0,1,2
S01010147,Occupancy rating 0,247,124,22,102,116,4,40,9,21,10,72,61,11,7,2,0,0,5
S01010147,Occupancy rating -1 or less,93,38,6,32,45,1,22,7,10,5,22,20,2,10,9,1,0,0
S01010148,All households,356,135,29,106,196,16,81,20,40,21,99,68,31,25,9,1,1,14
S01010148,Occupancy rating +2 or more,32,20,5,15,12,2,6,3,1,2,4,3,1,0,0,0,0,0
S01010148,Occupancy rating +1,103,54,12,42,46,10,21,14,5,2,15,8,7,3,0,0,0,3
S01010148,Occupancy rating 0,144,45,8,37,89,3,31,2,19,10,55,39,16,10,4,1,0,5
S01010148,Occupancy rating -1 or less,77,16,4,12,49,1,23,1,15,7,25,18,7,12,5,0,1,6
S01010149,All households,231,77,17,60,138,8,96,52,37,7,34,25,9,16,8,0,0,8
S01010149,Occupancy rating +2 or more,61,19,3,16,41,2,39,31,7,1,0,0,0,1,0,0,0,1
S01010149,Occupancy rating +1,86,36,11,25,47,6,35,14,17,4,6,5,1,3,0,0,0,3
S01010149,Occupancy rating 0,55,12,2,10,38,0,18,4,12,2,20,14,6,5,3,0,0,2
S01010149,Occupancy rating -1 or less,29,10,1,9,12,0,4,3,1,0,8,6,2,7,5,0,0,2
S01010150,All households,325,148,70,78,157,27,72,31,20,21,58,28,30,20,4,0,2,14
S01010150,Occupancy rating +2 or more,27,18,6,12,8,2,6,5,1,0,0,0,0,1,0,0,0,1
S01010150,Occupancy rating +1,161,95,49,46,62,22,30,20,4,6,10,0,10,4,0,0,0,4
S01010150,Occupancy rating 0,92,25,11,14,59,1,24,5,6,13,34,17,17,8,3,0,2,3
S01010150,Occupancy rating -1 or less,45,10,4,6,28,2,12,1,9,2,14,11,3,7,1,0,0,6
S01010151,All households,329,153,90,63,155,40,57,18,21,18,58,24,34,21,7,1,3,10
S01010151,Occupancy rating +2 or more,49,33,18,15,16,10,5,2,1,2,1,0,1,0,0,0,0,0
S01010151,Occupancy rating +1,145,95,54,41,48,22,17,9,3,5,9,3,6,2,1,0,1,0
S01010151,Occupancy rating 0,87,18,13,5,59,7,23,4,12,7,29,11,18,10,1,0,2,7
S01010151,Occupancy rating -1 or less,48,7,5,2,32,1,12,3,5,4,19,10,9,9,5,1,0,3
S01010152,All households,425,163,90,73,230,36,128,55,41,32,66,37,29,32,7,6,5,14
S01010152,Occupancy rating +2 or more,45,25,13,12,20,5,12,5,4,3,3,1,2,0,0,0,0,0
S01010152,Occupancy rating +1,201,100,61,39,96,27,57,44,8,5,12,4,8,5,0,0,3,2
S01010152,Occupancy rating 0,118,28,12,16,73,1,38,5,13,20,34,19,15,17,5,2,1,9
S01010152,Occupancy rating -1 or less,61,10,4,6,41,3,21,1,16,4,17,13,4,10,2,4,1,3
S01010153,All households,491,244,138,106,226,36,119,43,53,23,71,41,30,21,5,0,4,12
S01010153,Occupancy rating +2 or more,82,37,20,17,44,11,23,13,6,4,10,5,5,1,0,0,0,1
S01010153,Occupancy rating +1,190,127,68,59,62,18,39,29,9,1,5,1,4,1,0,0,0,1
S01010153,Occupancy rating 0,129,33,21,12,87,4,42,1,27,14,41,24,17,9,2,0,2,5
S01010153,Occupancy rating -1 or less,90,47,29,18,33,3,15,0,11,4,15,11,4,10,3,0,2,5
S01010154,All households,432,184,107,77,218,34,100,44,30,26,84,32,52,30,12,3,6,9
S01010154,Occupancy rating +2 or more,69,39,24,15,30,8,19,16,2,1,3,0,3,0,0,0,0,0
S01010154,Occupancy rating +1,204,124,72,52,72,20,36,23,8,5,16,4,12,8,1,0,3,4
S01010154,Occupancy rating 0,109,12,6,6,86,4,39,3,18,18,43,17,26,11,2,3,2,4
S01010154,Occupancy rating -1 or less,50,9,5,4,30,2,6,2,2,2,22,11,11,11,9,0,1,1
S01010155,All households,362,169,115,54,170,25,99,38,30,31,46,17,29,23,9,0,2,12
S01010155,Occupancy rating +2 or more,60,33,23,10,26,10,16,11,4,1,0,0,0,1,0,0,0,1
S01010155,Occupancy rating +1,153,94,57,37,55,12,34,25,1,8,9,1,8,4,1,0,1,2
S01010155,Occupancy rating 0,104,32,26,6,64,2,35,2,15,18,27,10,17,8,4,0,0,4
S01010155,Occupancy rating -1 or less,45,10,9,1,25,1,14,0,10,4,10,6,4,10,4,0,1,5
S01010156,All households,281,129,81,48,133,22,64,17,24,23,47,24,23,19,9,0,1,9
S01010156,Occupancy rating +2 or more,49,23,18,5,25,9,13,7,3,3,3,2,1,1,0,0,0,1
S01010156,Occupancy rating +1,102,55,30,25,44,9,25,8,9,8,10,4,6,3,1,0,0,2
S01010156,Occupancy rating 0,74,20,16,4,47,3,19,2,9,8,25,15,10,7,2,0,0,5
S01010156,Occupancy rating -1 or less,56,31,17,14,17,1,7,0,3,4,9,3,6,8,6,0,1,1
S01010157,All households,267,101,48,53,146,17,61,23,21,17,68,32,36,20,11,0,0,9
S01010157,Occupancy rating +2 or more,76,34,16,18,39,13,17,13,3,1,9,5,4,3,2,0,0,1
S01010157,Occupancy rating +1,112,46,22,24,63,2,31,8,11,12,30,8,22,3,2,0,0,1
S01010157,Occupancy rating 0,55,15,8,7,32,2,10,1,6,3,20,13,7,8,3,0,0,5
S01010157,Occupancy rating -1 or less,24,6,2,4,12,0,3,1,1,1,9,6,3,6,4,0,0,2
S01010158,All households,461,188,94,94,241,40,119,43,48,28,82,37,45,32,10,3,3,16
S01010158,Occupancy rating +2 or more,66,38,20,18,26,8,15,13,1,1,3,0,3,2,0,0,0,2
S01010158,Occupancy rating +1,217,128,65,63,84,28,39,27,7,5,17,5,12,5,0,0,1,4
S01010158,Occupancy rating 0,109,13,7,6,87,3,39,3,25,11,45,23,22,9,2,1,1,5
S01010158,Occupancy rating -1 or less,69,9,2,7,44,1,26,0,15,11,17,9,8,16,8,2,1,5
S01010159,All households,353,144,72,72,188,38,85,30,32,23,65,28,37,21,11,0,3,7
S01010159,Occupancy rating +2 or more,100,53,31,22,47,22,21,15,4,2,4,1,3,0,0,0,0,0
S01010159,Occupancy rating +1,109,43,25,18,64,13,30,12,9,9,21,6,15,2,0,0,0,2
S01010159,Occupancy rating 0,107,43,13,30,52,1,26,3,13,10,25,10,15,12,6,0,3,3
S01010159,Occupancy rating -1 or less,37,5,3,2,25,2,8,0,6,2,15,11,4,7,5,0,0,2
S01010160,All households,308,154,26,128,128,0,94,38,51,5,34,26,8,26,6,2,0,18
S01010160,Occupancy rating +2 or more,17,8,3,5,9,0,8,6,2,0,1,1,0,0,0,0,0,0
S01010160,Occupancy rating +1,92,62,11,51,27,0,24,17,5,2,3,3,0,3,0,0,0,3
S01010160,Occupancy rating 0,116,58,8,50,48,0,34,11,22,1,14,9,5,10,0,1,0,9
S01010160,Occupancy rating -1 or less,83,26,4,22,44,0,28,4,22,2,16,13,3,13,6,1,0,6
S01010161,All households,259,73,20,53,169,5,105,29,57,19,59,37,22,17,13,0,1,3
S01010161,Occupancy rating +2 or more,50,16,4,12,34,1,24,9,12,3,9,5,4,0,0,0,0,0
S01010161,Occupancy rating +1,84,37,12,25,47,1,37,17,12,8,9,6,3,0,0,0,0,0
S01010161,Occupancy rating 0,84,12,2,10,65,1,35,2,27,6,29,16,13,7,4,0,0,3
S01010161,Occupancy rating -1 or less,41,8,2,6,23,2,9,1,6,2,12,10,2,10,9,0,1,0
S01010162,All households,360,130,37,93,203,5,50,17,26,7,148,112,36,27,18,0,0,9
S01010162,Occupancy rating +2 or more,25,18,2,16,6,0,4,4,0,0,2,1,1,1,1,0,0,0
S01010162,Occupancy rating +1,116,74,22,52,41,4,16,11,5,0,21,13,8,1,0,0,0,1
S01010162,Occupancy rating 0,147,26,11,15,115,1,24,2,18,4,90,72,18,6,3,0,0,3
S01010162,Occupancy rating -1 or less,72,12,2,10,41,0,6,0,3,3,35,26,9,19,14,0,0,5
S01010163,All households,239,56,17,39,168,15,77,22,30,25,76,51,25,15,11,1,1,2
S01010163,Occupancy rating +2 or more,65,31,10,21,34,10,20,11,5,4,4,3,1,0,0,0,0,0
S01010163,Occupancy rating +1,70,17,3,14,52,3,21,7,5,9,28,17,11,1,0,0,1,0
S01010163,Occupancy rating 0,70,5,3,2,60,2,26,3,13,10,32,22,10,5,4,1,0,0
S01010163,Occupancy rating -1 or less,34,3,1,2,22,0,10,1,7,2,12,9,3,9,7,0,0,2
S01010164,All households,282,70,29,41,180,15,99,25,42,32,66,43,23,32,16,0,2,14
S01010164,Occupancy rating +2 or more,93,44,20,24,42,13,25,20,2,3,4,2,2,7,2,0,1,4
S01010164,Occupancy rating +1,85,16,5,11,67,2,39,3,17,19,26,14,12,2,1,0,0,1
S01010164,Occupancy rating 0,64,10,4,6,43,0,21,2,15,4,22,16,6,11,6,0,1,4
S01010164,Occupancy rating -1 or less,40,0,0,0,28,0,14,0,8,6,14,11,3,12,7,0,0,5
S01010165,All households,275,84,18,66,165,14,56,20,14,22,95,63,32,26,13,3,2,8
S01010165,Occupancy rating +2 or more,50,23,8,15,26,9,13,11,0,2,4,1,3,1,1,0,0,0
S01010165,Occupancy rating +1,96,47,7,40,46,3,22,8,6,8,21,10,11,3,0,0,1,2
S01010165,Occupancy rating 0,91,8,2,6,70,2,15,0,5,10,53,39,14,13,4,2,1,6
S01010165,Occupancy rating -1 or less,38,6,1,5,23,0,6,1,3,2,17,13,4,9,8,1,0,0
S01010166,All households,347,150,57,93,175,18,101,34,35,32,56,31,25,22,11,0,0,11
S01010166,Occupancy rating +2 or more,69,44,19,25,25,11,11,11,0,0,3,3,0,0,0,0,0,0
S01010166,Occupancy rating +1,111,45,15,30,63,2,44,19,10,15,17,6,11,3,0,0,0,3
S01010166,Occupancy rating 0,111,39,13,26,64,3,36,4,16,16,25,17,8,8,3,0,0,5
S01010166,Occupancy rating -1 or less,56,22,10,12,23,2,10,0,9,1,11,5,6,11,8,0,0,3
S01010167,All households,472,250,89,161,209,41,92,46,21,25,76,52,24,13,6,2,1,4
S01010167,Occupancy rating +2 or more,26,15,5,10,11,2,5,3,0,2,4,1,3,0,0,0,0,0
S01010167,Occupancy rating +1,150,91,39,52,59,26,30,29,0,1,3,3,0,0,0,0,0,0
S01010167,Occupancy rating 0,212,112,36,76,95,7,40,11,12,17,48,33,15,5,1,1,1,2
S01010167,Occupancy rating -1 or less,84,32,9,23,44,6,17,3,9,5,21,15,6,8,5,1,0,2
S01010168,All households,236,77,28,49,147,9,75,34,32,9,63,45,18,12,8,0,0,4
S01010168,Occupancy rating +2 or more,35,13,2,11,22,1,17,15,1,1,4,4,0,0,0,0,0,0
S01010168,Occupancy rating +1,98,50,22,28,47,7,35,17,17,1,5,5,0,1,1,0,0,0
S01010168,Occupancy rating 0,72,9,3,6,59,1,20,2,12,6,38,23,15,4,3,0,0,1
S01010168,Occupancy rating -1 or less,31,5,1,4,19,0,3,0,2,1,16,13,3,7,4,0,0,3
S01010169,All households,367,109,25,84,236,8,126,51,60,15,102,68,34,22,16,1,0,5
S01010169,Occupancy rating +2 or more,30,19,3,16,11,0,9,8,1,0,2,1,1,0,0,0,0,0
S01010169,Occupancy rating +1,113,50,17,33,62,6,46,31,12,3,10,6,4,1,0,0,0,1
S01010169,Occupancy rating 0,132,21,3,18,100,1,44,8,27,9,55,34,21,11,6,1,0,4
S01010169,Occupancy rating -1 or less,92,19,2,17,63,1,27,4,20,3,35,27,8,10,10,0,0,0
S01010170,All households,271,112,21,91,148,10,66,32,14,20,72,51,21,11,4,0,0,7
S01010170,Occupancy rating +2 or more,33,19,7,12,14,4,6,5,0,1,4,2,2,0,0,0,0,0
S01010170,Occupancy rating +1,97,52,7,45,43,5,28,20,1,7,10,5,5,2,1,0,0,1
S01010170,Occupancy rating 0,102,38,6,32,59,1,20,3,9,8,38,30,8,5,1,0,0,4
S01010170,Occupancy rating -1 or less,39,3,1,2,32,0,12,4,4,4,20,14,6,4,2,0,0,2
S01010171,All households,489,207,78,129,254,13,94,23,50,21,147,109,38,28,16,0,0,12
S01010171,Occupancy rating +2 or more,55,30,13,17,25,8,10,6,3,1,7,3,4,0,0,0,0,0
S01010171,Occupancy rating +1,147,85,24,61,56,3,36,16,10,10,17,10,7,6,3,0,0,3
S01010171,Occupancy rating 0,200,65,32,33,123,2,33,1,24,8,88,72,16,12,5,0,0,7
S01010171,Occupancy rating -1 or less,87,27,9,18,50,0,15,0,13,2,35,24,11,10,8,0,0,2
S01010172,All households,481,316,146,170,157,28,66,44,15,7,63,46,17,8,3,0,0,5
S01010172,Occupancy rating +2 or more,15,8,6,2,7,2,5,4,1,0,0,0,0,0,0,0,0,0
S01010172,Occupancy rating +1,243,188,84,104,55,17,34,32,2,0,4,4,0,0,0,0,0,0
S01010172,Occupancy rating 0,146,62,29,33,80,7,22,7,11,4,51,38,13,4,0,0,0,4
S01010172,Occupancy rating -1 or less,77,58,27,31,15,2,5,1,1,3,8,4,4,4,3,0,0,1
S01010173,All households,331,111,68,43,187,31,101,30,44,27,55,23,32,33,18,0,1,14
S01010173,Occupancy rating +2 or more,117,58,39,19,55,20,28,19,4,5,7,4,3,4,3,0,0,1
S01010173,Occupancy rating +1,98,23,10,13,68,6,39,8,18,13,23,8,15,7,1,0,1,5
S01010173,Occupancy rating 0,79,22,12,10,46,4,21,3,12,6,21,9,12,11,4,0,0,7
S01010173,Occupancy rating -1 or less,37,8,7,1,18,1,13,0,10,3,4,2,2,11,10,0,0,1
S01010174,All households,250,88,55,33,141,18,96,31,42,23,27,10,17,21,6,0,1,14
S01010174,Occupancy rating +2 or more,83,38,19,19,45,15,29,25,3,1,1,1,0,0,0,0,0,0
S01010174,Occupancy rating +1,59,9,5,4,43,0,32,4,15,13,11,2,9,7,0,0,1,6
S01010174,Occupancy rating 0,59,15,11,4,33,3,21,2,13,6,9,4,5,11,4,0,0,7
S01010174,Occupancy rating -1 or less,49,26,20,6,20,0,14,0,11,3,6,3,3,3,2,0,0,1
S01010175,All households,216,80,36,44,118,11,69,23,28,18,38,23,15,18,8,0,1,9
S01010175,Occupancy rating +2 or more,52,23,9,14,25,5,17,12,2,3,3,0,3,4,0,0,0,4
S01010175,Occupancy rating +1,79,36,14,22,38,3,23,10,6,7,12,9,3,5,2,0,1,2
S01010175,Occupancy rating 0,60,17,11,6,41,3,22,0,17,5,16,10,6,2,2,0,0,0
S01010175,Occupancy rating -1 or less,25,4,2,2,14,0,7,1,3,3,7,4,3,7,4,0,0,3
S01010176,All households,369,181,91,90,155,16,89,35,39,15,50,27,23,33,12,3,2,16
S01010176,Occupancy rating +2 or more,74,38,22,16,35,6,19,10,6,3,10,5,5,1,0,0,0,1
S01010176,Occupancy rating +1,173,115,57,58,52,9,34,21,10,3,9,2,7,6,2,2,0,2
S01010176,Occupancy rating 0,77,16,10,6,47,1,27,2,19,6,19,11,8,14,3,1,1,9
S01010176,Occupancy rating -1 or less,45,12,2,10,21,0,9,2,4,3,12,9,3,12,7,0,1,4
S01010177,All households,315,88,36,52,199,8,82,26,37,19,109,72,37,28,11,2,1,14
S01010177,Occupancy rating +2 or more,39,18,5,13,21,1,14,8,2,4,6,3,3,0,0,0,0,0
S01010177,Occupancy rating +1,121,52,23,29,64,6,32,17,9,6,26,18,8,5,2,0,0,3
S01010177,Occupancy rating 0,100,11,4,7,77,0,24,1,15,8,53,37,16,12,4,1,1,6
S01010177,Occupancy rating -1 or less,55,7,4,3,37,1,12,0,11,1,24,14,10,11,5,1,0,5
S01010178,All households,391,112,37,75,242,16,100,18,57,25,126,89,37,37,18,0,1,18
S01010178,Occupancy rating +2 or more,63,19,4,15,44,6,19,3,9,7,19,13,6,0,0,0,0,0
S01010178,Occupancy rating +1,101,31,6,25,62,4,28,9,13,6,30,21,9,8,3,0,0,5
S01010178,Occupancy rating 0,164,46,19,27,101,6,42,6,26,10,53,35,18,17,10,0,0,7
S01010178,Occupancy rating -1 or less,63,16,8,8,35,0,11,0,9,2,24,20,4,12,5,0,1,6
S01010179,All households,387,133,45,88,216,18,99,37,33,29,99,56,43,38,20,1,0,17
S01010179,Occupancy rating +2 or more,53,16,3,13,32,1,20,13,4,3,11,6,5,5,2,0,0,3
S01010179,Occupancy rating +1,142,79,26,53,55,13,29,17,6,6,13,8,5,8,4,0,0,4
S01010179,Occupancy rating 0,111,19,9,10,84,1,37,5,18,14,46,27,19,8,3,1,0,4
S01010179,Occupancy rating -1 or less,81,19,7,12,45,3,13,2,5,6,29,15,14,17,11,0,0,6
S01010180,All households,215,36,9,27,156,3,101,38,51,12,52,40,12,23,11,1,0,11
S01010180,Occupancy rating +2 or more,63,15,3,12,47,1,36,26,7,3,10,8,2,1,0,0,0,1
S01010180,Occupancy rating +1,72,13,3,10,55,0,36,6,28,2,19,15,4,4,1,0,0,3
S01010180,Occupancy rating 0,52,8,3,5,34,1,18,4,9,5,15,13,2,10,5,0,0,5
S01010180,Occupancy rating -1 or less,28,0,0,0,20,1,11,2,7,2,8,4,4,8,5,1,0,2
S01010181,All households,272,88,41,47,152,17,61,22,21,18,74,47,27,32,20,0,1,11
S01010181,Occupancy rating +2 or more,61,30,14,16,30,10,15,11,1,3,5,3,2,1,0,0,0,1
S01010181,Occupancy rating +1,83,30,12,18,47,3,22,9,9,4,22,11,11,6,1,0,1,4
S01010181,Occupancy rating 0,83,19,11,8,53,2,18,2,8,8,33,21,12,11,8,0,0,3
S01010181,Occupancy rating -1 or less,45,9,4,5,22,2,6,0,3,3,14,12,2,14,11,0,0,3
S01010182,All households,307,93,24,69,200,22,148,79,40,29,30,18,12,14,7,1,2,4
S01010182,Occupancy rating +2 or more,90,20,7,13,66,11,48,31,9,8,7,3,4,4,2,0,0,2
S01010182,Occupancy rating +1,89,32,10,22,54,7,42,27,7,8,5,4,1,3,2,0,1,0
S01010182,Occupancy rating 0,101,28,3,25,68,4,48,20,19,9,16,9,7,5,2,0,1,2
S01010182,Occupancy rating -1 or less,27,13,4,9,12,0,10,1,5,4,2,2,0,2,1,1,0,0
S01010183,All households,232,89,43,46,129,15,55,25,17,13,59,34,25,14,5,0,2,7
S01010183,Occupancy rating +2 or more,36,23,11,12,12,2,9,9,0,0,1,1,0,1,1,0,0,0
S01010183,Occupancy rating +1,101,53,26,27,45,10,24,14,7,3,11,3,8,3,0,0,1,2
S01010183,Occupancy rating 0,67,8,4,4,53,2,17,1,7,9,34,21,13,6,1,0,1,4
S01010183,Occupancy rating -1 or less,28,5,2,3,19,1,5,1,3,1,13,9,4,4,3,0,0,1
S01010184,All households,286,108,47,61,154,12,61,16,27,18,81,52,29,24,11,0,2,11
S01010184,Occupancy rating +2 or more,39,24,4,20,14,5,5,5,0,0,4,4,0,1,1,0,0,0
S01010184,Occupancy rating +1,99,58,29,29,38,6,17,9,6,2,15,6,9,3,0,0,0,3
S01010184,Occupancy rating 0,90,15,8,7,68,0,25,1,11,13,43,29,14,7,2,0,2,3
S01010184,Occupancy rating -1 or less,58,11,6,5,34,1,14,1,10,3,19,13,6,13,8,0,0,5
S01010185,All households,282,92,30,62,161,20,60,15,32,13,81,60,21,29,13,0,2,14
S01010185,Occupancy rating +2 or more,56,25,11,14,30,16,13,13,0,0,1,0,1,1,0,0,0,1
S01010185,Occupancy rating +1,66,29,5,24,26,0,11,1,7,3,15,7,8,11,1,0,2,8
S01010185,Occupancy rating 0,99,20,7,13,70,2,26,1,17,8,42,36,6,9,6,0,0,3
S01010185,Occupancy rating -1 or less,61,18,7,11,35,2,10,0,8,2,23,17,6,8,6,0,0,2
S01010186,All households,246,49,14,35,184,14,135,47,61,27,35,23,12,13,8,0,2,3
S01010186,Occupancy rating +2 or more,96,37,11,26,57,10,41,29,6,6,6,2,4,2,0,0,1,1
S01010186,Occupancy rating +1,71,8,3,5,61,4,48,15,21,12,9,7,2,2,2,0,0,0
S01010186,Occupancy rating 0,54,2,0,2,48,0,34,2,24,8,14,11,3,4,3,0,1,0
S01010186,Occupancy rating -1 or less,25,2,0,2,18,0,12,1,10,1,6,3,3,5,3,0,0,2
S01010187,All households,294,101,16,85,182,14,129,54,43,32,39,23,16,11,9,0,0,2
S01010187,Occupancy rating +2 or more,57,15,4,11,41,9,32,17,10,5,0,0,0,1,0,0,0,1
S01010187,Occupancy rating +1,79,28,8,20,51,4,38,20,6,12,9,6,3,0,0,0,0,0
S01010187,Occupancy rating 0,120,56,4,52,60,1,40,17,14,9,19,13,6,4,3,0,0,1
S01010187,Occupancy rating -1 or less,38,2,0,2,30,0,19,0,13,6,11,4,7,6,6,0,0,0
S01010188,All households,304,98,22,76,195,18,142,57,57,28,35,19,16,11,3,0,0,8
S01010188,Occupancy rating +2 or more,107,23,4,19,80,8,67,29,29,9,5,2,3,4,2,0,0,2
S01010188,Occupancy rating +1,119,55,15,40,62,9,46,23,13,10,7,3,4,2,0,0,0,2
S01010188,Occupancy rating 0,46,7,1,6,35,1,19,3,9,7,15,10,5,4,1,0,0,3
S01010188,Occupancy rating -1 or less,32,13,2,11,18,0,10,2,6,2,8,4,4,1,0,0,0,1
S01010189,All households,336,54,6,48,273,5,242,67,140,35,26,19,7,9,6,0,0,3
S01010189,Occupancy rating +2 or more,210,37,2,35,170,5,154,51,81,22,11,7,4,3,2,0,0,1
S01010189,Occupancy rating +1,74,12,3,9,62,0,54,11,38,5,8,7,1,0,0,0,0,0
S01010189,Occupancy rating 0,36,3,1,2,32,0,27,5,17,5,5,3,2,1,0,0,0,1
S01010189,Occupancy rating -1 or less,16,2,0,2,9,0,7,0,4,3,2,2,0,5,4,0,0,1
S01010190,All households,253,25,1,24,213,3,184,64,88,32,26,19,7,15,7,1,0,7
S01010190,Occupancy rating +2 or more,205,20,1,19,176,3,154,63,67,24,19,15,4,9,3,0,0,6
S01010190,Occupancy rating +1,26,4,0,4,22,0,18,0,13,5,4,3,1,0,0,0,0,0
S01010190,Occupancy rating 0,15,0,0,0,12,0,10,1,6,3,2,1,1,3,2,1,0,0
S01010190,Occupancy rating -1 or less,7,1,0,1,3,0,2,0,2,0,1,0,1,3,2,0,0,1
S01010191,All households,266,54,13,41,197,4,156,43,96,17,37,30,7,15,6,0,0,9
S01010191,Occupancy rating +2 or more,140,40,6,34,96,3,81,31,45,5,12,10,2,4,1,0,0,3
S01010191,Occupancy rating +1,68,10,5,5,52,1,36,10,21,5,15,13,2,6,1,0,0,5
S01010191,Occupancy rating 0,35,3,1,2,30,0,23,0,18,5,7,4,3,2,1,0,0,1
S01010191,Occupancy rating -1 or less,23,1,1,0,19,0,16,2,12,2,3,3,0,3,3,0,0,0
S01010192,All households,294,41,4,37,234,1,202,46,120,36,31,25,6,19,12,0,0,7
S01010192,Occupancy rating +2 or more,152,21,2,19,122,1,114,37,60,17,7,5,2,9,6,0,0,3
S01010192,Occupancy rating +1,78,16,2,14,58,0,48,7,31,10,10,7,3,4,2,0,0,2
S01010192,Occupancy rating 0,40,1,0,1,37,0,28,1,21,6,9,9,0,2,2,0,0,0
S01010192,Occupancy rating -1 or less,24,3,0,3,17,0,12,1,8,3,5,4,1,4,2,0,0,2
S01010193,All households,329,115,48,67,201,18,149,46,70,33,34,27,7,13,3,1,1,8
S01010193,Occupancy rating +2 or more,101,28,9,19,71,14,54,22,20,12,3,2,1,2,1,0,0,1
S01010193,Occupancy rating +1,105,43,12,31,57,3,45,16,20,9,9,7,2,5,1,1,1,2
S01010193,Occupancy rating 0,81,17,7,10,60,1,42,6,26,10,17,14,3,4,1,0,0,3
S01010193,Occupancy rating -1 or less,42,27,20,7,13,0,8,2,4,2,5,4,1,2,0,0,0,2
S01010194,All households,268,91,58,33,150,18,76,15,28,33,56,16,40,27,15,0,3,9
S01010194,Occupancy rating +2 or more,114,78,52,26,35,15,16,14,0,2,4,0,4,1,0,0,0,1
S01010194,Occupancy rating +1,79,6,1,5,67,3,31,1,12,18,33,7,26,6,1,0,3,2
S01010194,Occupancy rating 0,42,7,5,2,28,0,18,0,8,10,10,6,4,7,5,0,0,2
S01010194,Occupancy rating -1 or less,33,0,0,0,20,0,11,0,8,3,9,3,6,13,9,0,0,4
S01010195,All households,212,69,40,29,125,15,74,16,40,18,36,21,15,18,12,0,0,6
S01010195,Occupancy rating +2 or more,84,51,31,20,33,11,19,10,8,1,3,0,3,0,0,0,0,0
S01010195,Occupancy rating +1,65,15,8,7,45,3,31,6,14,11,11,5,6,5,2,0,0,3
S01010195,Occupancy rating 0,46,3,1,2,37,1,18,0,15,3,18,13,5,6,4,0,0,2
S01010195,Occupancy rating -1 or less,17,0,0,0,10,0,6,0,3,3,4,3,1,7,6,0,0,1
S01010196,All households,274,71,41,30,170,17,92,32,25,35,61,34,27,33,12,0,0,21
S01010196,Occupancy rating +2 or more,100,47,27,20,53,16,29,24,1,4,8,5,3,0,0,0,0,0
S01010196,Occupancy rating +1,77,12,9,3,52,0,26,7,4,15,26,10,16,13,3,0,0,10
S01010196,Occupancy rating 0,63,9,3,6,44,1,29,1,15,13,14,9,5,10,3,0,0,7
S01010196,Occupancy rating -1 or less,34,3,2,1,21,0,8,0,5,3,13,10,3,10,6,0,0,4
S01010197,All households,260,63,31,32,173,15,77,16,37,24,81,34,47,24,14,0,1,9
S01010197,Occupancy rating +2 or more,78,47,29,18,30,11,16,14,2,0,3,0,3,1,0,0,1,0
S01010197,Occupancy rating +1,84,13,2,11,67,3,27,1,10,16,37,14,23,4,1,0,0,3
S01010197,Occupancy rating 0,60,2,0,2,47,0,17,1,12,4,30,14,16,11,7,0,0,4
S01010197,Occupancy rating -1 or less,38,1,0,1,29,1,17,0,13,4,11,6,5,8,6,0,0,2
S01010198,All households,394,118,68,50,242,27,126,36,58,32,89,48,41,34,15,1,3,15
S01010198,Occupancy rating +2 or more,142,87,51,36,52,22,27,22,2,3,3,2,1,3,0,0,1,2
S01010198,Occupancy rating +1,110,20,13,7,84,5,40,7,18,15,39,17,22,6,0,0,2,4
S01010198,Occupancy rating 0,95,8,3,5,72,0,39,7,26,6,33,22,11,15,10,1,0,4
S01010198,Occupancy rating -1 or less,47,3,1,2,34,0,20,0,12,8,14,7,7,10,5,0,0,5
S01010199,All households,232,71,30,41,144,16,45,13,17,15,83,49,34,17,11,0,1,5
S01010199,Occupancy rating +2 or more,59,32,20,12,26,13,9,9,0,0,4,3,1,1,0,0,1,0
S01010199,Occupancy rating +1,73,26,4,22,44,3,21,3,8,10,20,11,9,3,1,0,0,2
S01010199,Occupancy rating 0,77,7,5,2,64,0,14,1,8,5,50,28,22,6,5,0,0,1
S01010199,Occupancy rating -1 or less,23,6,1,5,10,0,1,0,1,0,9,7,2,7,5,0,0,2
S01010200,All households,305,112,77,35,164,26,89,27,33,29,49,22,27,29,16,0,5,8
S01010200,Occupancy rating +2 or more,96,51,39,12,43,18,25,22,2,1,0,0,0,2,2,0,0,0
S01010200,Occupancy rating +1,85,24,9,15,55,4,33,5,13,15,18,8,10,6,2,0,4,0
S01010200,Occupancy rating 0,83,31,24,7,45,3,22,0,12,10,20,8,12,7,3,0,0,4
S01010200,Occupancy rating -1 or less,41,6,5,1,21,1,9,0,6,3,11,6,5,14,9,0,1,4
S01010201,All households,253,66,29,37,168,28,102,22,51,29,38,22,16,19,13,0,0,6
S01010201,Occupancy rating +2 or more,87,39,16,23,46,20,24,19,3,2,2,1,1,2,0,0,0,2
S01010201,Occupancy rating +1,85,19,12,7,63,6,41,2,29,10,16,9,7,3,0,0,0,3
S01010201,Occupancy rating 0,57,6,1,5,47,1,33,1,17,15,13,10,3,4,3,0,0,1
S01010201,Occupancy rating -1 or less,24,2,0,2,12,1,4,0,2,2,7,2,5,10,10,0,0,0
S01010202,All households,365,143,21,122,199,3,71,10,53,8,125,100,25,23,13,0,1,9
S01010202,Occupancy rating +2 or more,16,9,2,7,7,0,3,2,1,0,4,3,1,0,0,0,0,0
S01010202,Occupancy rating +1,131,99,14,85,32,3,15,6,6,3,14,8,6,0,0,0,0,0
S01010202,Occupancy rating 0,134,19,1,18,104,0,35,2,29,4,69,55,14,11,3,0,0,8
S01010202,Occupancy rating -1 or less,84,16,4,12,56,0,18,0,17,1,38,34,4,12,10,0,1,1
S01010203,All households,260,49,8,41,198,13,138,56,67,15,47,36,11,13,7,1,0,5
S01010203,Occupancy rating +2 or more,60,16,4,12,43,5,35,21,10,4,3,2,1,1,1,0,0,0
S01010203,Occupancy rating +1,100,24,3,21,71,7,57,29,24,4,7,5,2,5,1,0,0,4
S01010203,Occupancy rating 0,70,9,1,8,60,0,32,4,23,5,28,21,7,1,1,0,0,0
S01010203,Occupancy rating -1 or less,30,0,0,0,24,1,14,2,10,2,9,8,1,6,4,1,0,1
S01010204,All households,381,154,47,107,203,12,76,28,31,17,115,74,41,24,11,0,2,11
S01010204,Occupancy rating +2 or more,22,12,4,8,10,2,5,5,0,0,3,0,3,0,0,0,0,0
S01010204,Occupancy rating +1,152,101,30,71,46,4,29,20,3,6,13,6,7,5,0,0,1,4
S01010204,Occupancy rating 0,127,23,6,17,98,4,28,3,16,9,66,43,23,6,3,0,1,2
S01010204,Occupancy rating -1 or less,80,18,7,11,49,2,14,0,12,2,33,25,8,13,8,0,0,5
S01010205,All households,355,170,52,118,161,14,84,45,20,19,63,37,26,24,12,1,3,8
S01010205,Occupancy rating +2 or more,53,33,10,23,18,2,15,10,4,1,1,1,0,2,1,0,1,0
S01010205,Occupancy rating +1,136,82,31,51,47,11,25,18,4,3,11,5,6,7,1,0,2,4
S01010205,Occupancy rating 0,99,31,9,22,63,0,31,12,8,11,32,19,13,5,2,1,0,2
S01010205,Occupancy rating -1 or less,67,24,2,22,33,1,13,5,4,4,19,12,7,10,8,0,0,2
S01010206,All households,255,104,5,99,137,0,49,9,37,3,88,81,7,14,5,1,0,8
S01010206,Occupancy rating +2 or more,20,15,1,14,5,0,1,0,1,0,4,4,0,0,0,0,0,0
S01010206,Occupancy rating +1,53,42,2,40,11,0,8,3,4,1,3,3,0,0,0,0,0,0
S01010206,Occupancy rating 0,80,34,2,32,43,0,17,4,12,1,26,19,7,3,0,1,0,2
S01010206,Occupancy rating -1 or less,102,13,0,13,78,0,23,2,20,1,55,55,0,11,5,0,0,6
S01010207,All households,285,113,18,95,153,6,69,14,48,7,78,64,14,19,10,1,1,7
S01010207,Occupancy rating +2 or more,41,33,2,31,7,0,7,5,1,1,0,0,0,1,1,0,0,0
S01010207,Occupancy rating +1,69,47,8,39,21,3,13,9,4,0,5,2,3,1,1,0,0,0
S01010207,Occupancy rating 0,79,15,5,10,61,3,28,0,23,5,30,23,7,3,0,0,0,3
S01010207,Occupancy rating -1 or less,96,18,3,15,64,0,21,0,20,1,43,39,4,14,8,1,1,4
S01010208,All households,565,343,74,269,191,14,118,63,36,19,59,42,17,31,6,3,0,22
S01010208,Occupancy rating +2 or more,21,17,4,13,4,1,2,2,0,0,1,0,1,0,0,0,0,0
S01010208,Occupancy rating +1,235,160,25,135,74,9,58,50,4,4,7,5,2,1,0,0,0,1
S01010208,Occupancy rating 0,202,109,30,79,71,3,41,8,21,12,27,19,8,22,2,3,0,17
S01010208,Occupancy rating -1 or less,107,57,15,42,42,1,17,3,11,3,24,18,6,8,4,0,0,4
S01010209,All households,468,226,81,145,223,27,105,49,37,19,91,60,31,19,8,0,0,11
S01010209,Occupancy rating +2 or more,52,26,10,16,24,9,11,8,2,1,4,3,1,2,1,0,0,1
S01010209,Occupancy rating +1,184,108,31,77,73,14,46,37,4,5,13,9,4,3,0,0,0,3
S01010209,Occupancy rating 0,176,78,32,46,92,4,32,3,22,7,56,39,17,6,2,0,0,4
S01010209,Occupancy rating -1 or less,56,14,8,6,34,0,16,1,9,6,18,9,9,8,5,0,0,3
S01010210,All households,416,158,86,72,225,34,133,46,54,33,58,30,28,33,10,0,4,19
S01010210,Occupancy rating +2 or more,107,50,33,17,54,17,34,21,5,8,3,0,3,3,1,0,1,1
S01010210,Occupancy rating +1,144,68,39,29,65,10,41,18,13,10,14,5,9,11,2,0,1,8
S01010210,Occupancy rating 0,119,31,11,20,75,3,45,5,30,10,27,16,11,13,4,0,1,8
S01010210,Occupancy rating -1 or less,46,9,3,6,31,4,13,2,6,5,14,9,5,6,3,0,1,2
S01010211,All households,452,217,98,119,220,32,95,29,45,21,93,66,27,15,5,1,1,8
S01010211,Occupancy rating +2 or more,48,27,14,13,20,6,11,7,4,0,3,3,0,1,0,0,0,1
S01010211,Occupancy rating +1,172,108,42,66,61,15,32,14,14,4,14,7,7,3,0,0,0,3
S01010211,Occupancy rating 0,155,62,31,31,87,10,28,6,13,9,49,34,15,6,1,1,1,3
S01010211,Occupancy rating -1 or less,77,20,11,9,52,1,24,2,14,8,27,22,5,5,4,0,0,1
S01010212,All households,559,290,81,209,249,16,100,34,50,16,133,88,45,20,7,3,1,9
S01010212,Occupancy rating +2 or more,31,13,5,8,18,2,12,7,2,3,4,1,3,0,0,0,0,0
S01010212,Occupancy rating +1,161,104,38,66,56,8,26,14,8,4,22,10,12,1,0,0,0,1
S01010212,Occupancy rating 0,254,128,28,100,123,5,48,12,28,8,70,53,17,3,0,1,0,2
S01010212,Occupancy rating -1 or less,113,45,10,35,52,1,14,1,12,1,37,24,13,16,7,2,1,6
S01010213,All households,476,202,108,94,243,39,125,52,45,28,79,46,33,31,8,0,5,18
S01010213,Occupancy rating +2 or more,58,31,21,10,26,8,16,13,2,1,2,2,0,1,0,0,0,1
S01010213,Occupancy rating +1,241,139,70,69,96,26,51,33,12,6,19,9,10,6,1,0,1,4
S01010213,Occupancy rating 0,121,23,14,9,86,4,40,4,22,14,42,24,18,12,0,0,3,9
S01010213,Occupancy rating -1 or less,56,9,3,6,35,1,18,2,9,7,16,11,5,12,7,0,1,4
S01010214,All households,396,102,52,50,260,37,162,54,66,42,61,36,25,34,20,0,2,12
S01010214,Occupancy rating +2 or more,147,51,30,21,89,25,55,33,13,9,9,6,3,7,4,0,1,2
S01010214,Occupancy rating +1,129,34,12,22,89,10,55,17,18,20,24,8,16,6,1,0,0,5
S01010214,Occupancy rating 0,78,14,10,4,55,2,33,2,20,11,20,16,4,9,4,0,1,4
S01010214,Occupancy rating -1 or less,42,3,0,3,27,0,19,2,15,2,8,6,2,12,11,0,0,1
S01010215,All households,492,265,133,132,202,25,66,32,27,7,111,71,40,25,9,0,2,14
S01010215,Occupancy rating +2 or more,38,23,10,13,13,3,8,8,0,0,2,2,0,2,0,0,0,2
S01010215,Occupancy rating +1,190,140,65,75,48,15,22,18,3,1,11,7,4,2,0,0,0,2
S01010215,Occupancy rating 0,175,71,40,31,95,6,21,4,14,3,68,42,26,9,2,0,0,7
S01010215,Occupancy rating -1 or less,89,31,18,13,46,1,15,2,10,3,30,20,10,12,7,0,2,3
S01010216,All households,361,195,67,128,141,14,60,30,24,6,67,37,30,25,6,4,3,12
S01010216,Occupancy rating +2 or more,24,15,2,13,9,0,6,4,2,0,3,1,2,0,0,0,0,0
S01010216,Occupancy rating +1,100,59,24,35,38,8,22,17,4,1,8,7,1,3,1,2,0,0
S01010216,Occupancy rating 0,183,100,34,66,66,4,21,5,13,3,41,23,18,17,2,2,2,11
S01010216,Occupancy rating -1 or less,54,21,7,14,28,2,11,4,5,2,15,6,9,5,3,0,1,1
S01010217,All households,406,197,26,171,181,7,79,40,34,5,95,74,21,28,6,3,0,19
S01010217,Occupancy rating +2 or more,58,26,7,19,31,2,22,20,1,1,7,7,0,1,1,0,0,0
S01010217,Occupancy rating +1,106,61,9,52,39,3,19,11,6,2,17,14,3,6,0,1,0,5
S01010217,Occupancy rating 0,126,44,4,40,67,2,23,6,17,0,42,32,10,15,2,2,0,11
S01010217,Occupancy rating -1 or less,116,66,6,60,44,0,15,3,10,2,29,21,8,6,3,0,0,3
S01010218,All households,587,324,60,264,235,17,123,59,56,8,95,64,31,28,9,2,1,16
S01010218,Occupancy rating +2 or more,43,24,2,22,18,1,15,11,3,1,2,1,1,1,0,0,0,1
S01010218,Occupancy rating +1,182,125,22,103,53,7,37,26,8,3,9,5,4,4,0,0,1,3
S01010218,Occupancy rating 0,263,142,28,114,109,8,48,19,27,2,53,34,19,12,2,1,0,9
S01010218,Occupancy rating -1 or less,99,33,8,25,55,1,23,3,18,2,31,24,7,11,7,1,0,3
S01010219,All households,274,144,27,117,96,5,45,12,29,4,46,31,15,34,10,8,0,16
S01010219,Occupancy rating +2 or more,26,18,6,12,8,3,2,1,1,0,3,0,3,0,0,0,0,0
S01010219,Occupancy rating +1,54,40,4,36,13,0,12,6,4,2,1,0,1,1,0,0,0,1
S01010219,Occupancy rating 0,118,64,10,54,43,2,15,3,11,1,26,15,11,11,2,5,0,4
S01010219,Occupancy rating -1 or less,76,22,7,15,32,0,16,2,13,1,16,16,0,22,8,3,0,11
S01010220,All households,279,129,4,125,108,0,95,67,25,3,13,12,1,42,4,14,0,24
S01010220,Occupancy rating +2 or more,11,6,1,5,5,0,4,4,0,0,1,1,0,0,0,0,0,0
S01010220,Occupancy rating +1,132,83,1,82,45,0,45,40,4,1,0,0,0,4,1,2,0,1
S01010220,Occupancy rating 0,113,33,2,31,52,0,43,21,20,2,9,8,1,28,1,9,0,18
S01010220,Occupancy rating -1 or less,23,7,0,7,6,0,3,2,1,0,3,3,0,10,2,3,0,5
S01010221,All households,260,135,51,84,106,5,39,20,11,8,62,37,25,19,6,4,4,5
S01010221,Occupancy rating +2 or more,20,6,2,4,13,0,4,3,0,1,9,6,3,1,0,0,0,1
S01010221,Occupancy rating +1,65,42,10,32,20,3,12,9,0,3,5,1,4,3,1,0,2,0
S01010221,Occupancy rating 0,102,49,23,26,50,1,14,6,6,2,35,20,15,3,0,2,0,1
S01010221,Occupancy rating -1 or less,73,38,16,22,23,1,9,2,5,2,13,10,3,12,5,2,2,3
S01010222,All households,285,144,24,120,121,14,70,36,17,17,37,25,12,20,2,7,1,10
S01010222,Occupancy rating +2 or more,27,13,1,12,14,6,5,4,1,0,3,3,0,0,0,0,0,0
S01010222,Occupancy rating +1,74,38,4,34,34,5,24,18,3,3,5,1,4,2,0,1,0,1
S01010222,Occupancy rating 0,131,73,12,61,51,2,34,14,9,11,15,10,5,7,0,3,0,4
S01010222,Occupancy rating -1 or less,53,20,7,13,22,1,7,0,4,3,14,11,3,11,2,3,1,5
S01010223,All households,337,201,63,138,114,10,60,39,12,9,44,31,13,22,8,1,0,13
S01010223,Occupancy rating +2 or more,24,10,2,8,13,3,7,5,1,1,3,3,0,1,1,0,0,0
S01010223,Occupancy rating +1,103,70,17,53,30,2,23,20,1,2,5,4,1,3,1,0,0,2
S01010223,Occupancy rating 0,162,97,30,67,53,4,22,11,6,5,27,15,12,12,3,1,0,8
S01010223,Occupancy rating -1 or less,48,24,14,10,18,1,8,3,4,1,9,9,0,6,3,0,0,3
S01010224,All households,469,192,61,131,248,2,99,35,46,18,147,102,45,29,15,0,1,13
S01010224,Occupancy rating +2 or more,38,19,2,17,16,0,13,7,5,1,3,2,1,3,1,0,0,2
S01010224,Occupancy rating +1,144,75,23,52,64,0,35,20,9,6,29,14,15,5,1,0,0,4
S01010224,Occupancy rating 0,193,75,28,47,112,1,37,5,22,10,74,57,17,6,1,0,0,5
S01010224,Occupancy rating -1 or less,94,23,8,15,56,1,14,3,10,1,41,29,12,15,12,0,1,2
S01010225,All households,431,194,38,156,196,11,100,51,38,11,85,61,24,41,12,5,3,21
S01010225,Occupancy rating +2 or more,36,16,8,8,19,2,15,10,3,2,2,1,1,1,1,0,0,0
S01010225,Occupancy rating +1,137,86,20,66,49,7,34,27,5,2,8,4,4,2,0,1,0,1
S01010225,Occupancy rating 0,177,69,5,64,90,2,39,13,21,5,49,36,13,18,1,2,3,12
S01010225,Occupancy rating -1 or less,81,23,5,18,38,0,12,1,9,2,26,20,6,20,10,2,0,8
S01010226,All households,394,215,33,182,158,3,91,18,65,8,64,52,12,21,10,3,0,8
S01010226,Occupancy rating +2 or more,19,14,5,9,5,0,3,0,2,1,2,1,1,0,0,0,0,0
S01010226,Occupancy rating +1,72,48,8,40,24,1,22,7,11,4,1,0,1,0,0,0,0,0
S01010226,Occupancy rating 0,173,100,12,88,64,2,32,8,23,1,30,22,8,9,2,2,0,5
S01010226,Occupancy rating -1 or less,130,53,8,45,65,0,34,3,29,2,31,29,2,12,8,1,0,3
S01010227,All households,294,119,25,94,158,1,85,13,63,9,72,59,13,17,7,1,0,9
S01010227,Occupancy rating +2 or more,11,5,2,3,6,0,4,2,2,0,2,1,1,0,0,0,0,0
S01010227,Occupancy rating +1,51,34,10,24,17,0,11,3,6,2,6,5,1,0,0,0,0,0
S01010227,Occupancy rating 0,127,49,8,41,73,1,39,8,27,4,33,27,6,5,1,0,0,4
S01010227,Occupancy rating -1 or less,105,31,5,26,62,0,31,0,28,3,31,26,5,12,6,1,0,5
S01010228,All households,384,211,87,124,161,21,75,45,15,15,65,43,22,12,4,0,2,6
S01010228,Occupancy rating +2 or more,16,9,3,6,7,2,2,2,0,0,3,1,2,0,0,0,0,0
S01010228,Occupancy rating +1,82,51,28,23,30,10,18,18,0,0,2,1,1,1,0,0,0,1
S01010228,Occupancy rating 0,188,107,39,68,77,8,34,19,8,7,35,23,12,4,0,0,2,2
S01010228,Occupancy rating -1 or less,98,44,17,27,47,1,21,6,7,8,25,18,7,7,4,0,0,3
S01010229,All households,508,219,64,155,266,8,145,48,61,36,113,74,39,23,7,3,3,10
S01010229,Occupancy rating +2 or more,50,25,5,20,24,3,17,9,5,3,4,4,0,1,0,0,0,1
S01010229,Occupancy rating +1,140,77,27,50,61,1,50,23,20,7,10,6,4,2,0,0,0,2
S01010229,Occupancy rating 0,230,89,23,66,131,3,57,12,28,17,71,45,26,10,2,2,3,3
S01010229,Occupancy rating -1 or less,88,28,9,19,50,1,21,4,8,9,28,19,9,10,5,1,0,4
S01010230,All households,577,324,74,250,203,12,102,36,61,5,89,48,41,50,12,13,1,24
S01010230,Occupancy rating +2 or more,28,19,3,16,8,0,6,3,3,0,2,1,1,1,0,1,0,0
S01010230,Occupancy rating +1,138,100,26,74,35,5,25,22,3,0,5,3,2,3,1,1,0,1
S01010230,Occupancy rating 0,246,126,26,100,109,6,44,5,36,3,59,30,29,11,1,4,0,6
S01010230,Occupancy rating -1 or less,165,79,19,60,51,1,27,6,19,2,23,14,9,35,10,7,1,17
S01010231,All households,514,248,94,154,227,15,92,33,49,10,120,90,30,39,17,3,1,18
S01010231,Occupancy rating +2 or more,33,20,5,15,11,0,7,4,3,0,4,2,2,2,1,0,0,1
S01010231,Occupancy rating +1,100,55,22,33,42,10,16,10,3,3,16,14,2,3,0,1,0,2
S01010231,Occupancy rating 0,236,113,43,70,111,5,46,15,26,5,60,46,14,12,5,2,0,5
S01010231,Occupancy rating -1 or less,145,60,24,36,63,0,23,4,17,2,40,28,12,22,11,0,1,10
S01010232,All households,485,193,27,166,253,4,127,32,74,21,122,82,40,39,10,7,0,22
S01010232,Occupancy rating +2 or more,44,19,2,17,24,2,13,7,4,2,9,5,4,1,0,0,0,1
S01010232,Occupancy rating +1,123,69,10,59,50,1,28,14,10,4,21,12,9,4,1,1,0,2
S01010232,Occupancy rating 0,201,75,11,64,112,1,56,8,38,10,55,38,17,14,3,2,0,9
S01010232,Occupancy rating -1 or less,117,30,4,26,67,0,30,3,22,5,37,27,10,20,6,4,0,10
S01010233,All households,476,206,37,169,247,13,114,34,63,17,120,86,34,23,7,2,1,13
S01010233,Occupancy rating +2 or more,47,33,5,28,13,1,9,4,4,1,3,0,3,1,0,0,0,1
S01010233,Occupancy rating +1,119,68,15,53,51,9,28,15,8,5,14,11,3,0,0,0,0,0
S01010233,Occupancy rating 0,176,58,7,51,112,1,48,11,30,7,63,41,22,6,2,0,0,4
S01010233,Occupancy rating -1 or less,134,47,10,37,71,2,29,4,21,4,40,34,6,16,5,2,1,8
S01010234,All households,562,296,83,213,162,24,110,64,38,8,28,16,12,104,10,32,0,62
S01010234,Occupancy rating +2 or more,38,23,6,17,14,2,11,10,1,0,1,0,1,1,0,0,0,1
S01010234,Occupancy rating +1,183,123,48,75,49,10,37,25,10,2,2,2,0,11,1,1,0,9
S01010234,Occupancy rating 0,216,94,16,78,72,10,46,23,19,4,16,11,5,50,2,18,0,30
S01010234,Occupancy rating -1 or less,125,56,13,43,27,2,16,6,8,2,9,3,6,42,7,13,0,22
S01010235,All households,446,170,0,170,130,3,109,86,21,2,18,12,6,146,6,71,0,69
S01010235,Occupancy rating +2 or more,19,7,0,7,9,1,7,7,0,0,1,1,0,3,0,2,0,1
S01010235,Occupancy rating +1,90,58,0,58,29,1,27,26,1,0,1,1,0,3,0,2,0,1
S01010235,Occupancy rating 0,203,94,0,94,63,1,58,50,7,1,4,4,0,46,1,24,0,21
S01010235,Occupancy rating -1 or less,134,11,0,11,29,0,17,3,13,1,12,6,6,94,5,43,0,46
S01010236,All households,378,159,34,125,148,9,110,63,36,11,29,16,13,71,4,19,0,48
S01010236,Occupancy rating +2 or more,56,12,3,9,30,3,26,14,9,3,1,1,0,14,2,3,0,9
S01010236,Occupancy rating +1,132,78,19,59,46,5,40,29,9,2,1,0,1,8,0,3,0,5
S01010236,Occupancy rating 0,141,51,10,41,53,1,37,20,12,5,15,7,8,37,0,10,0,27
S01010236,Occupancy rating -1 or less,49,18,2,16,19,0,7,0,6,1,12,8,4,12,2,3,0,7
S01010237,All households,353,157,35,122,137,10,95,64,25,6,32,16,16,59,3,11,0,45
S01010237,Occupancy rating +2 or more,54,35,11,24,17,3,13,13,0,0,1,0,1,2,0,0,0,2
S01010237,Occupancy rating +1,140,75,12,63,53,5,41,34,5,2,7,5,2,12,0,4,0,8
S01010237,Occupancy rating 0,123,39,8,31,47,2,31,15,12,4,14,8,6,37,0,5,0,32
S01010237,Occupancy rating -1 or less,36,8,4,4,20,0,10,2,8,0,10,3,7,8,3,2,0,3
S01010238,All households,455,211,40,171,183,17,123,78,30,15,43,27,16,61,3,15,2,41
S01010238,Occupancy rating +2 or more,44,30,11,19,14,3,10,8,1,1,1,0,1,0,0,0,0,0
S01010238,Occupancy rating +1,178,113,13,100,59,3,51,47,1,3,5,3,2,6,0,1,0,5
S01010238,Occupancy rating 0,166,58,12,46,68,10,39,19,13,7,19,13,6,40,1,12,1,26
S01010238,Occupancy rating -1 or less,67,10,4,6,42,1,23,4,15,4,18,11,7,15,2,2,1,10
S01010239,All households,424,213,78,135,156,11,71,38,25,8,74,34,40,55,17,4,0,34
S01010239,Occupancy rating +2 or more,40,26,9,17,14,2,10,8,1,1,2,0,2,0,0,0,0,0
S01010239,Occupancy rating +1,130,90,34,56,30,6,20,15,2,3,4,1,3,10,2,1,0,7
S01010239,Occupancy rating 0,151,58,22,36,71,2,26,12,12,2,43,20,23,22,1,3,0,18
S01010239,Occupancy rating -1 or less,103,39,13,26,41,1,15,3,10,2,25,13,12,23,14,0,0,9
S01010240,All households,398,200,39,161,158,9,107,70,24,13,42,21,21,40,7,9,0,24
S01010240,Occupancy rating +2 or more,21,14,4,10,5,0,4,4,0,0,1,0,1,2,0,0,0,2
S01010240,Occupancy rating +1,135,72,12,60,58,1,54,42,6,6,3,1,2,5,0,2,0,3
S01010240,Occupancy rating 0,171,86,19,67,64,5,36,18,12,6,23,9,14,21,1,5,0,15
S01010240,Occupancy rating -1 or less,71,28,4,24,31,3,13,6,6,1,15,11,4,12,6,2,0,4
S01010241,All households,623,354,89,265,213,21,131,96,27,8,61,30,31,56,4,15,1,36
S01010241,Occupancy rating +2 or more,44,21,6,15,21,6,14,14,0,0,1,0,1,2,0,2,0,0
S01010241,Occupancy rating +1,148,80,14,66,63,8,43,41,2,0,12,2,10,5,0,2,0,3
S01010241,Occupancy rating 0,340,217,60,157,91,6,57,36,15,6,28,20,8,32,1,3,1,27
S01010241,Occupancy rating -1 or less,91,36,9,27,38,1,17,5,10,2,20,8,12,17,3,8,0,6
S01010242,All households,455,252,29,223,165,1,92,48,37,7,72,49,23,38,7,11,0,20
S01010242,Occupancy rating +2 or more,14,7,0,7,7,0,4,4,0,0,3,2,1,0,0,0,0,0
S01010242,Occupancy rating +1,73,51,9,42,20,1,14,10,3,1,5,5,0,2,0,1,0,1
S01010242,Occupancy rating 0,232,124,10,114,91,0,49,24,20,5,42,29,13,17,3,4,0,10
S01010242,Occupancy rating -1 or less,136,70,10,60,47,0,25,10,14,1,22,13,9,19,4,6,0,9
S01010243,All households,610,364,29,335,203,8,109,59,42,8,86,63,23,43,10,4,0,29
S01010243,Occupancy rating +2 or more,32,23,2,21,8,0,4,2,1,1,4,3,1,1,0,0,0,1
S01010243,Occupancy rating +1,78,45,8,37,32,1,20,13,7,0,11,9,2,1,0,0,0,1
S01010243,Occupancy rating 0,296,182,12,170,102,3,48,27,16,5,51,35,16,12,2,0,0,10
S01010243,Occupancy rating -1 or less,204,114,7,107,61,4,37,17,18,2,20,16,4,29,8,4,0,17
S01010244,All households,440,271,60,211,138,11,59,23,20,16,68,51,17,31,6,10,1,14
S01010244,Occupancy rating +2 or more,14,9,4,5,5,0,2,2,0,0,3,3,0,0,0,0,0,0
S01010244,Occupancy rating +1,94,59,17,42,31,2,17,10,2,5,12,6,6,4,0,2,0,2
S01010244,Occupancy rating 0,203,133,28,105,58,8,21,9,6,6,29,25,4,12,2,4,1,5
S01010244,Occupancy rating -1 or less,129,70,11,59,44,1,19,2,12,5,24,17,7,15,4,4,0,7
S01010245,All households,509,240,65,175,228,4,84,48,20,16,140,95,45,41,19,7,0,15
S01010245,Occupancy rating +2 or more,45,22,3,19,20,1,8,7,0,1,11,4,7,3,2,0,0,1
S01010245,Occupancy rating +1,139,70,16,54,63,1,34,28,4,2,28,18,10,6,2,1,0,3
S01010245,Occupancy rating 0,235,112,38,74,110,2,33,11,13,9,75,54,21,13,3,4,0,6
S01010245,Occupancy rating -1 or less,90,36,8,28,35,0,9,2,3,4,26,19,7,19,12,2,0,5
S01010246,All households,433,185,41,144,212,6,84,33,31,20,122,82,40,36,3,8,1,24
S01010246,Occupancy rating +2 or more,27,16,7,9,9,0,5,4,1,0,4,3,1,2,0,0,0,2
S01010246,Occupancy rating +1,126,78,19,59,44,2,23,15,2,6,19,12,7,4,0,0,0,4
S01010246,Occupancy rating 0,168,46,7,39,105,3,40,8,21,11,62,41,21,17,1,5,0,11
S01010246,Occupancy rating -1 or less,112,45,8,37,54,1,16,6,7,3,37,26,11,13,2,3,1,7
S01010247,All households,356,143,70,73,192,18,137,58,47,32,37,21,16,21,6,2,0,13
S01010247,Occupancy rating +2 or more,31,12,6,6,18,2,14,9,2,3,2,2,0,1,0,0,0,1
S01010247,Occupancy rating +1,143,65,26,39,74,14,55,38,13,4,5,2,3,4,1,0,0,3
S01010247,Occupancy rating 0,133,53,30,23,73,1,51,10,23,18,21,13,8,7,2,1,0,4
S01010247,Occupancy rating -1 or less,49,13,8,5,27,1,17,1,9,7,9,4,5,9,3,1,0,5
S01010248,All households,456,185,47,138,164,15,126,85,29,12,23,12,11,107,5,30,1,71
S01010248,Occupancy rating +2 or more,37,22,6,16,13,3,9,6,3,0,1,1,0,2,0,0,0,2
S01010248,Occupancy rating +1,162,83,23,60,68,7,58,49,6,3,3,1,2,11,0,2,0,9
S01010248,Occupancy rating 0,202,69,14,55,65,5,50,29,16,5,10,5,5,68,2,15,1,50
S01010248,Occupancy rating -1 or less,55,11,4,7,18,0,9,1,4,4,9,5,4,26,3,13,0,10
S01010249,All households,403,195,40,155,123,8,93,73,15,5,22,13,9,85,3,32,1,49
S01010249,Occupancy rating +2 or more,25,10,3,7,10,0,8,8,0,0,2,0,2,5,0,1,0,4
S01010249,Occupancy rating +1,163,100,26,74,49,3,45,44,1,0,1,1,0,14,0,4,0,10
S01010249,Occupancy rating 0,165,71,11,60,48,5,33,19,11,3,10,5,5,46,0,20,1,25
S01010249,Occupancy rating -1 or less,50,14,0,14,16,0,7,2,3,2,9,7,2,20,3,7,0,10
S01010250,All households,390,130,22,108,148,7,114,81,27,6,27,13,14,112,4,49,1,58
S01010250,Occupancy rating +2 or more,45,13,2,11,27,3,22,18,4,0,2,0,2,5,0,4,0,1
S01010250,Occupancy rating +1,149,62,14,48,59,2,55,49,3,3,2,1,1,28,0,12,0,16
S01010250,Occupancy rating 0,143,42,5,37,41,1,29,12,14,3,11,4,7,60,0,25,0,35
S01010250,Occupancy rating -1 or less,53,13,1,12,21,1,8,2,6,0,12,8,4,19,4,8,1,6
S01010251,All households,317,99,10,89,126,1,103,57,40,6,22,17,5,92,5,40,0,47
S01010251,Occupancy rating +2 or more,26,9,3,6,13,0,13,9,4,0,0,0,0,4,0,0,0,4
S01010251,Occupancy rating +1,89,40,2,38,43,0,42,34,6,2,1,1,0,6,0,6,0,0
S01010251,Occupancy rating 0,116,31,4,27,38,1,29,9,19,1,8,7,1,47,1,17,0,29
S01010251,Occupancy rating -1 or less,86,19,1,18,32,0,19,5,11,3,13,9,4,35,4,17,0,14
S01010252,All households,297,104,14,90,140,8,98,55,35,8,34,22,12,53,5,9,3,36
S01010252,Occupancy rating +2 or more,50,16,4,12,26,1,17,8,8,1,8,5,3,8,2,0,1,5
S01010252,Occupancy rating +1,82,40,5,35,38,3,32,25,6,1,3,1,2,4,0,2,0,2
S01010252,Occupancy rating 0,116,36,4,32,55,4,38,20,14,4,13,9,4,25,1,5,1,18
S01010252,Occupancy rating -1 or less,49,12,1,11,21,0,11,2,7,2,10,7,3,16,2,2,1,11
S01010253,All households,364,200,60,140,133,9,64,34,21,9,60,43,17,31,5,12,1,13
S01010253,Occupancy rating +2 or more,53,38,14,24,15,2,12,12,0,0,1,1,0,0,0,0,0,0
S01010253,Occupancy rating +1,54,21,5,16,26,0,13,8,2,3,13,9,4,7,0,4,0,3
S01010253,Occupancy rating 0,191,112,29,83,66,5,28,12,13,3,33,25,8,13,1,6,0,6
S01010253,Occupancy rating -1 or less,66,29,12,17,26,2,11,2,6,3,13,8,5,11,4,2,1,4
S01010254,All households,581,285,109,176,226,23,134,64,43,27,69,45,24,70,11,21,4,34
S01010254,Occupancy rating +2 or more,40,25,10,15,13,3,6,4,1,1,4,0,4,2,0,0,0,2
S01010254,Occupancy rating +1,136,66,11,55,58,8,41,27,5,9,9,6,3,12,0,5,1,6
S01010254,Occupancy rating 0,272,135,57,78,105,9,60,31,25,4,36,25,11,32,4,12,1,15
S01010254,Occupancy rating -1 or less,133,59,31,28,50,3,27,2,12,13,20,14,6,24,7,4,2,11
S01010255,All households,353,168,47,121,139,8,75,38,31,6,56,39,17,46,23,9,0,14
S01010255,Occupancy rating +2 or more,43,21,7,14,20,1,12,8,2,2,7,4,3,2,0,0,0,2
S01010255,Occupancy rating +1,70,29,4,25,34,2,23,15,6,2,9,2,7,7,2,2,0,3
S01010255,Occupancy rating 0,169,86,26,60,57,3,28,11,17,0,26,22,4,26,16,5,0,5
S01010255,Occupancy rating -1 or less,71,32,10,22,28,2,12,4,6,2,14,11,3,11,5,2,0,4
S01010256,All households,516,292,71,221,194,10,80,42,28,10,104,72,32,30,7,10,0,13
S01010256,Occupancy rating +2 or more,29,16,2,14,12,2,10,8,2,0,0,0,0,1,0,0,0,1
S01010256,Occupancy rating +1,79,40,20,20,34,3,20,14,3,3,11,6,5,5,0,4,0,1
S01010256,Occupancy rating 0,277,156,33,123,110,5,38,17,16,5,67,49,18,11,2,3,0,6
S01010256,Occupancy rating -1 or less,131,80,16,64,38,0,12,3,7,2,26,17,9,13,5,3,0,5
S01010257,All households,497,269,28,241,104,3,65,57,5,3,36,18,18,124,0,94,1,29
S01010257,Occupancy rating +2 or more,12,8,0,8,4,0,4,3,1,0,0,0,0,0,0,0,0,0
S01010257,Occupancy rating +1,50,39,6,33,8,1,5,5,0,0,2,1,1,3,0,3,0,0
S01010257,Occupancy rating 0,181,103,13,90,64,2,38,33,3,2,24,11,13,14,0,8,0,6
S01010257,Occupancy rating -1 or less,254,119,9,110,28,0,18,16,1,1,10,6,4,107,0,83,1,23
S01010258,All households,424,192,3,189,75,2,69,58,9,2,4,1,3,157,2,112,0,43
S01010258,Occupancy rating +2 or more,10,7,1,6,3,0,3,2,0,1,0,0,0,0,0,0,0,0
S01010258,Occupancy rating +1,69,43,2,41,23,2,20,19,1,0,1,0,1,3,0,3,0,0
S01010258,Occupancy rating 0,150,61,0,61,29,0,28,24,3,1,1,0,1,60,0,44,0,16
S01010258,Occupancy rating -1 or less,195,81,0,81,20,0,18,13,5,0,2,1,1,94,2,65,0,27
S01010259,All households,468,290,88,202,130,11,57,32,24,1,62,40,22,48,7,22,2,17
S01010259,Occupancy rating +2 or more,32,24,11,13,7,1,4,4,0,0,2,1,1,1,0,0,1,0
S01010259,Occupancy rating +1,104,78,32,46,19,6,8,8,0,0,5,2,3,7,0,5,0,2
S01010259,Occupancy rating 0,248,157,35,122,68,2,31,16,14,1,35,23,12,23,2,10,1,10
S01010259,Occupancy rating -1 or less,84,31,10,21,36,2,14,4,10,0,20,14,6,17,5,7,0,5
S01010260,All households,685,420,57,363,175,8,133,111,15,7,34,16,18,90,3,53,0,34
S01010260,Occupancy rating +2 or more,33,17,4,13,16,1,12,11,1,0,3,2,1,0,0,0,0,0
S01010260,Occupancy rating +1,108,75,16,59,29,3,24,20,3,1,2,1,1,4,0,3,0,1
S01010260,Occupancy rating 0,328,217,25,192,79,4,61,50,5,6,14,6,8,32,0,20,0,12
S01010260,Occupancy rating -1 or less,216,111,12,99,51,0,36,30,6,0,15,7,8,54,3,30,0,21
S01010261,All households,526,302,127,175,136,23,71,47,19,5,42,26,16,88,4,64,0,20
S01010261,Occupancy rating +2 or more,61,37,18,19,20,7,6,3,1,2,7,2,5,4,0,3,0,1
S01010261,Occupancy rating +1,79,50,17,33,21,4,16,12,3,1,1,0,1,8,0,8,0,0
S01010261,Occupancy rating 0,273,179,73,106,55,6,29,24,4,1,20,13,7,39,2,26,0,11
S01010261,Occupancy rating -1 or less,113,36,19,17,40,6,20,8,11,1,14,11,3,37,2,27,0,8
S01010262,All households,535,328,151,177,137,36,59,37,9,13,42,10,32,70,4,46,1,19
S01010262,Occupancy rating +2 or more,60,45,28,17,13,6,7,7,0,0,0,0,0,2,0,0,0,2
S01010262,Occupancy rating +1,114,59,30,29,47,15,20,13,2,5,12,0,12,8,0,5,1,2
S01010262,Occupancy rating 0,233,144,53,91,44,8,19,11,4,4,17,6,11,45,2,28,0,15
S01010262,Occupancy rating -1 or less,128,80,40,40,33,7,13,6,3,4,13,4,9,15,2,13,0,0
S01010263,All households,422,222,14,208,107,3,94,82,9,3,10,6,4,93,1,48,0,44
S01010263,Occupancy rating +2 or more,19,9,1,8,8,1,6,2,3,1,1,1,0,2,0,2,0,0
S01010263,Occupancy rating +1,68,38,5,33,26,1,24,21,1,2,1,0,1,4,0,1,0,3
S01010263,Occupancy rating 0,171,96,7,89,33,1,30,29,1,0,2,0,2,42,0,25,0,17
S01010263,Occupancy rating -1 or less,164,79,1,78,40,0,34,30,4,0,6,5,1,45,1,20,0,24
S01010264,All households,557,373,38,335,105,4,95,88,5,2,6,3,3,79,0,52,0,27
S01010264,Occupancy rating +2 or more,25,12,0,12,11,1,10,10,0,0,0,0,0,2,0,0,0,2
S01010264,Occupancy rating +1,80,62,4,58,16,0,14,13,0,1,2,1,1,2,0,1,0,1
S01010264,Occupancy rating 0,270,186,23,163,53,3,49,44,4,1,1,1,0,31,0,20,0,11
S01010264,Occupancy rating -1 or less,182,113,11,102,25,0,22,21,1,0,3,1,2,44,0,31,0,13
S01010265,All households,573,324,5,319,132,1,126,118,7,1,5,3,2,117,4,78,0,35
S01010265,Occupancy rating +2 or more,33,20,1,19,12,0,12,11,1,0,0,0,0,1,0,0,0,1
S01010265,Occupancy rating +1,79,55,1,54,15,1,14,14,0,0,0,0,0,9,0,4,0,5
S01010265,Occupancy rating 0,215,122,1,121,59,0,59,56,3,0,0,0,0,34,2,20,0,12
S01010265,Occupancy rating -1 or less,246,127,2,125,46,0,41,37,3,1,5,3,2,73,2,54,0,17
S01010266,All households,237,87,15,72,74,3,56,33,21,2,15,9,6,76,4,40,0,32
S01010266,Occupancy rating +2 or more,38,24,7,17,10,1,6,3,3,0,3,1,2,4,1,1,0,2
S01010266,Occupancy rating +1,46,22,3,19,15,1,14,11,3,0,0,0,0,9,0,4,0,5
S01010266,Occupancy rating 0,94,27,3,24,42,1,32,19,11,2,9,6,3,25,0,9,0,16
S01010266,Occupancy rating -1 or less,59,14,2,12,7,0,4,0,4,0,3,2,1,38,3,26,0,9
S01010267,All households,318,151,2,149,45,1,39,27,12,0,5,4,1,122,2,71,0,49
S01010267,Occupancy rating +2 or more,28,20,0,20,2,0,2,1,1,0,0,0,0,6,0,3,0,3
S01010267,Occupancy rating +1,37,20,1,19,5,1,3,2,1,0,1,1,0,12,0,7,0,5
S01010267,Occupancy rating 0,79,33,1,32,15,0,13,11,2,0,2,1,1,31,0,15,0,16
S01010267,Occupancy rating -1 or less,174,78,0,78,23,0,21,13,8,0,2,2,0,73,2,46,0,25
S01010268,All households,417,223,35,188,109,6,86,58,22,6,17,13,4,85,7,43,0,35
S01010268,Occupancy rating +2 or more,36,17,2,15,13,1,12,9,1,2,0,0,0,6,2,1,0,3
S01010268,Occupancy rating +1,93,56,13,43,33,5,25,20,4,1,3,2,1,4,2,2,0,0
S01010268,Occupancy rating 0,179,97,10,87,43,0,36,25,9,2,7,5,2,39,1,19,0,19
S01010268,Occupancy rating -1 or less,109,53,10,43,20,0,13,4,8,1,7,6,1,36,2,21,0,13
S01010269,All households,320,173,19,154,62,0,56,41,13,2,6,3,3,85,3,53,0,29
S01010269,Occupancy rating +2 or more,14,6,0,6,7,0,7,5,2,0,0,0,0,1,0,1,0,0
S01010269,Occupancy rating +1,60,36,2,34,13,0,12,11,1,0,1,1,0,11,0,5,0,6
S01010269,Occupancy rating 0,151,77,7,70,33,0,28,22,5,1,5,2,3,41,0,29,0,12
S01010269,Occupancy rating -1 or less,95,54,10,44,9,0,9,3,5,1,0,0,0,32,3,18,0,11
S01010270,All households,817,581,198,383,141,29,81,62,14,5,31,7,24,95,3,49,2,41
S01010270,Occupancy rating +2 or more,30,15,3,12,15,5,9,7,2,0,1,0,1,0,0,0,0,0
S01010270,Occupancy rating +1,173,131,48,83,34,13,20,17,2,1,1,0,1,8,0,4,0,4
S01010270,Occupancy rating 0,448,333,113,220,71,9,43,33,7,3,19,4,15,44,0,19,2,23
S01010270,Occupancy rating -1 or less,166,102,34,68,21,2,9,5,3,1,10,3,7,43,3,26,0,14
S01010271,All households,327,118,14,104,93,9,65,42,18,5,19,5,14,116,3,79,0,34
S01010271,Occupancy rating +2 or more,24,10,0,10,12,3,7,4,3,0,2,1,1,2,1,0,0,1
S01010271,Occupancy rating +1,76,48,8,40,24,2,20,17,2,1,2,0,2,4,0,2,0,2
S01010271,Occupancy rating 0,131,41,6,35,35,2,24,13,8,3,9,1,8,55,0,36,0,19
S01010271,Occupancy rating -1 or less,96,19,0,19,22,2,14,8,5,1,6,3,3,55,2,41,0,12
S01010272,All households,703,482,77,405,136,7,97,67,28,2,32,21,11,85,4,40,0,41
S01010272,Occupancy rating +2 or more,35,24,1,23,10,0,9,5,3,1,1,1,0,1,0,0,0,1
S01010272,Occupancy rating +1,79,67,15,52,10,1,6,4,2,0,3,2,1,2,0,2,0,0
S01010272,Occupancy rating 0,362,295,45,250,61,2,47,42,5,0,12,8,4,6,1,2,0,3
S01010272,Occupancy rating -1 or less,227,96,16,80,55,4,35,16,18,1,16,10,6,76,3,36,0,37
S01010273,All households,409,194,5,189,101,1,90,84,6,0,10,5,5,114,2,73,0,39
S01010273,Occupancy rating +2 or more,11,3,0,3,8,0,7,7,0,0,1,1,0,0,0,0,0,0
S01010273,Occupancy rating +1,46,30,2,28,7,1,6,6,0,0,0,0,0,9,0,6,0,3
S01010273,Occupancy rating 0,178,95,1,94,57,0,52,49,3,0,5,3,2,26,0,17,0,9
S01010273,Occupancy rating -1 or less,174,66,2,64,29,0,25,22,3,0,4,1,3,79,2,50,0,27
S01010274,All households,342,176,13,163,76,2,72,64,5,3,2,1,1,90,2,50,0,38
S01010274,Occupancy rating +2 or more,31,15,2,13,13,1,12,11,1,0,0,0,0,3,0,0,0,3
S01010274,Occupancy rating +1,97,61,5,56,31,1,29,28,0,1,1,0,1,5,0,1,0,4
S01010274,Occupancy rating 0,140,81,5,76,24,0,23,19,2,2,1,1,0,35,0,21,0,14
S01010274,Occupancy rating -1 or less,74,19,1,18,8,0,8,6,2,0,0,0,0,47,2,28,0,17
S01010275,All households,357,165,4,161,91,0,81,71,9,1,10,6,4,101,1,66,0,34
S01010275,Occupancy rating +2 or more,18,10,0,10,6,0,6,5,1,0,0,0,0,2,0,0,0,2
S01010275,Occupancy rating +1,49,23,2,21,19,0,16,14,2,0,3,1,2,7,0,6,0,1
S01010275,Occupancy rating 0,108,54,1,53,28,0,24,21,2,1,4,3,1,26,0,16,0,10
S01010275,Occupancy rating -1 or less,182,78,1,77,38,0,35,31,4,0,3,2,1,66,1,44,0,21
S01010276,All households,625,345,4,341,176,4,158,116,35,7,14,9,5,104,5,50,1,48
S01010276,Occupancy rating +2 or more,59,36,2,34,22,1,20,17,2,1,1,1,0,1,0,0,0,1
S01010276,Occupancy rating +1,153,104,1,103,39,3,34,31,1,2,2,1,1,10,1,3,0,6
S01010276,Occupancy rating 0,272,156,1,155,83,0,78,58,17,3,5,4,1,33,1,15,1,16
S01010276,Occupancy rating -1 or less,141,49,0,49,32,0,26,10,15,1,6,3,3,60,3,32,0,25
S01010277,All households,305,134,44,90,143,21,74,33,26,15,48,22,26,28,4,8,1,15
S01010277,Occupancy rating +2 or more,23,8,4,4,15,6,6,2,3,1,3,3,0,0,0,0,0,0
S01010277,Occupancy rating +1,98,53,25,28,41,10,23,13,5,5,8,4,4,4,0,1,0,3
S01010277,Occupancy rating 0,128,54,10,44,65,3,36,16,13,7,26,11,15,9,0,1,1,7
S01010277,Occupancy rating -1 or less,56,19,5,14,22,2,9,2,5,2,11,4,7,15,4,6,0,5
S01010278,All households,330,157,42,115,152,6,66,23,31,12,80,53,27,21,9,4,0,8
S01010278,Occupancy rating +2 or more,19,5,2,3,13,0,6,4,1,1,7,2,5,1,1,0,0,0
S01010278,Occupancy rating +1,83,64,17,47,19,5,11,7,1,3,3,2,1,0,0,0,0,0
S01010278,Occupancy rating 0,160,78,20,58,71,0,29,10,13,6,42,28,14,11,5,3,0,3
S01010278,Occupancy rating -1 or less,68,10,3,7,49,1,20,2,16,2,28,21,7,9,3,1,0,5
S01010279,All households,312,137,18,119,98,3,60,32,24,4,35,22,13,77,4,38,1,34
S01010279,Occupancy rating +2 or more,22,9,3,6,8,2,6,5,0,1,0,0,0,5,2,1,0,2
S01010279,Occupancy rating +1,67,39,11,28,21,1,18,15,3,0,2,0,2,7,0,3,0,4
S01010279,Occupancy rating 0,130,64,3,61,37,0,19,10,8,1,18,12,6,29,0,13,1,15
S01010279,Occupancy rating -1 or less,93,25,1,24,32,0,17,2,13,2,15,10,5,36,2,21,0,13
S01010280,All households,426,184,15,169,120,2,95,63,27,5,23,16,7,122,1,50,0,71
S01010280,Occupancy rating +2 or more,31,11,1,10,17,1,16,13,3,0,0,0,0,3,0,0,0,3
S01010280,Occupancy rating +1,114,53,4,49,40,0,38,31,6,1,2,1,1,21,0,10,0,11
S01010280,Occupancy rating 0,179,84,6,78,43,0,28,13,11,4,15,11,4,52,0,20,0,32
S01010280,Occupancy rating -1 or less,102,36,4,32,20,1,13,6,7,0,6,4,2,46,1,20,0,25
S01010281,All households,466,261,16,245,128,1,120,87,30,3,7,3,4,77,1,38,0,38
S01010281,Occupancy rating +2 or more,15,10,2,8,5,0,5,2,3,0,0,0,0,0,0,0,0,0
S01010281,Occupancy rating +1,116,81,3,78,28,1,26,22,2,2,1,0,1,7,0,2,0,5
S01010281,Occupancy rating 0,191,96,7,89,53,0,50,40,9,1,3,2,1,42,0,22,0,20
S01010281,Occupancy rating -1 or less,144,74,4,70,42,0,39,23,16,0,3,1,2,28,1,14,0,13
S01010282,All households,645,411,77,334,152,11,112,74,34,4,29,18,11,82,7,44,0,31
S01010282,Occupancy rating +2 or more,11,6,1,5,4,1,2,1,1,0,1,0,1,1,0,1,0,0
S01010282,Occupancy rating +1,99,54,12,42,42,4,35,31,3,1,3,2,1,3,0,2,0,1
S01010282,Occupancy rating 0,333,219,48,171,71,4,50,34,14,2,17,11,6,43,2,21,0,20
S01010282,Occupancy rating -1 or less,202,132,16,116,35,2,25,8,16,1,8,5,3,35,5,20,0,10
S01010283,All households,296,129,8,121,84,2,64,46,13,5,18,14,4,83,6,23,0,54
S01010283,Occupancy rating +2 or more,24,13,0,13,6,0,6,4,1,1,0,0,0,5,1,3,0,1
S01010283,Occupancy rating +1,137,80,6,74,38,2,35,33,0,2,1,0,1,19,1,6,0,12
S01010283,Occupancy rating 0,100,30,2,28,27,0,14,4,8,2,13,12,1,43,0,12,0,31
S01010283,Occupancy rating -1 or less,35,6,0,6,13,0,9,5,4,0,4,2,2,16,4,2,0,10
S01010284,All households,638,353,25,328,174,4,156,128,28,0,14,9,5,111,1,57,1,52
S01010284,Occupancy rating +2 or more,29,14,0,14,13,0,13,10,3,0,0,0,0,2,1,0,0,1
S01010284,Occupancy rating +1,120,73,1,72,35,1,32,26,6,0,2,1,1,12,0,6,0,6
S01010284,Occupancy rating 0,354,212,15,197,84,2,78,70,8,0,4,2,2,58,0,29,0,29
S01010284,Occupancy rating -1 or less,135,54,9,45,42,1,33,22,11,0,8,6,2,39,0,22,1,16
S01010285,All households,420,170,26,144,123,4,88,45,37,6,31,25,6,127,4,70,0,53
S01010285,Occupancy rating +2 or more,25,13,4,9,10,0,10,5,3,2,0,0,0,2,0,1,0,1
S01010285,Occupancy rating +1,107,59,11,48,30,2,24,20,4,0,4,3,1,18,0,10,0,8
S01010285,Occupancy rating 0,174,72,8,64,58,2,36,16,16,4,20,16,4,44,1,27,0,16
S01010285,Occupancy rating -1 or less,114,26,3,23,25,0,18,4,14,0,7,6,1,63,3,32,0,28
S01010286,All households,365,127,7,120,114,0,93,55,34,4,21,13,8,124,3,60,0,61
S01010286,Occupancy rating +2 or more,34,17,2,15,14,0,13,9,4,0,1,1,0,3,0,2,0,1
S01010286,Occupancy rating +1,117,60,2,58,43,0,39,34,4,1,4,1,3,14,1,6,0,7
S01010286,Occupancy rating 0,156,37,1,36,35,0,25,8,15,2,10,6,4,84,0,41,0,43
S01010286,Occupancy rating -1 or less,58,13,2,11,22,0,16,4,11,1,6,5,1,23,2,11,0,10
S01010287,All households,387,112,21,91,114,4,95,65,26,4,15,5,10,161,8,96,1,56
S01010287,Occupancy rating +2 or more,74,23,7,16,43,2,40,30,9,1,1,1,0,8,1,3,0,4
S01010287,Occupancy rating +1,97,45,9,36,26,0,25,19,6,0,1,0,1,26,0,15,1,10
S01010287,Occupancy rating 0,121,30,4,26,29,1,22,12,8,2,6,2,4,62,1,38,0,23
S01010287,Occupancy rating -1 or less,95,14,1,13,16,1,8,4,3,1,7,2,5,65,6,40,0,19
S01010288,All households,349,86,11,75,125,3,112,75,31,6,10,4,6,138,3,73,0,62
S01010288,Occupancy rating +2 or more,69,14,5,9,44,2,41,31,8,2,1,0,1,11,1,1,0,9
S01010288,Occupancy rating +1,69,24,4,20,28,0,24,20,4,0,4,1,3,17,0,9,0,8
S01010288,Occupancy rating 0,106,27,1,26,30,1,27,14,10,3,2,1,1,49,1,23,0,25
S01010288,Occupancy rating -1 or less,105,21,1,20,23,0,20,10,9,1,3,2,1,61,1,40,0,20
S01010289,All households,380,163,6,157,180,5,166,102,53,11,9,4,5,37,1,16,0,20
S01010289,Occupancy rating +2 or more,95,31,1,30,59,2,56,31,22,3,1,0,1,5,0,2,0,3
S01010289,Occupancy rating +1,107,56,4,52,46,0,44,34,10,0,2,1,1,5,0,2,0,3
S01010289,Occupancy rating 0,119,54,1,53,52,3,45,29,14,2,4,2,2,13,0,4,0,9
S01010289,Occupancy rating -1 or less,59,22,0,22,23,0,21,8,7,6,2,1,1,14,1,8,0,5
S01010290,All households,278,120,10,110,80,3,62,35,22,5,15,7,8,78,1,37,0,40
S01010290,Occupancy rating +2 or more,29,12,1,11,12,2,7,5,2,0,3,0,3,5,0,1,0,4
S01010290,Occupancy rating +1,69,45,2,43,17,1,15,15,0,0,1,0,1,7,0,2,0,5
S01010290,Occupancy rating 0,115,45,4,41,32,0,22,10,8,4,10,7,3,38,0,19,0,19
S01010290,Occupancy rating -1 or less,65,18,3,15,19,0,18,5,12,1,1,0,1,28,1,15,0,12
S01010291,All households,481,168,49,119,128,6,85,49,29,7,37,20,17,185,6,114,1,64
S01010291,Occupancy rating +2 or more,49,20,7,13,20,2,15,11,3,1,3,2,1,9,1,4,0,4
S01010291,Occupancy rating +1,101,40,15,25,35,3,28,23,4,1,4,1,3,26,0,17,0,9
S01010291,Occupancy rating 0,192,60,23,37,46,1,26,15,8,3,19,12,7,86,0,53,1,32
S01010291,Occupancy rating -1 or less,139,48,4,44,27,0,16,0,14,2,11,5,6,64,5,40,0,19
S01010292,All households,409,127,15,112,110,6,89,55,25,9,15,4,11,172,1,83,0,88
S01010292,Occupancy rating +2 or more,43,20,2,18,17,1,14,11,1,2,2,0,2,6,0,4,0,2
S01010292,Occupancy rating +1,158,83,10,73,58,5,49,42,7,0,4,1,3,17,0,4,0,13
S01010292,Occupancy rating 0,116,15,3,12,18,0,13,1,10,2,5,1,4,83,0,35,0,48
S01010292,Occupancy rating -1 or less,92,9,0,9,17,0,13,1,7,5,4,2,2,66,1,40,0,25
S01010293,All households,373,137,36,101,90,5,71,37,29,5,14,11,3,146,6,77,0,63
S01010293,Occupancy rating +2 or more,17,10,3,7,4,1,3,2,1,0,0,0,0,3,0,0,0,3
S01010293,Occupancy rating +1,61,32,6,26,20,1,18,18,0,0,1,0,1,9,0,8,0,1
S01010293,Occupancy rating 0,184,80,25,55,35,3,25,14,9,2,7,6,1,69,0,32,0,37
S01010293,Occupancy rating -1 or less,111,15,2,13,31,0,25,3,19,3,6,5,1,65,6,37,0,22
S01010294,All households,275,69,15,54,66,2,49,25,17,7,15,8,7,140,3,92,0,45
S01010294,Occupancy rating +2 or more,33,21,7,14,11,2,7,6,0,1,2,1,1,1,0,1,0,0
S01010294,Occupancy rating +1,87,37,6,31,23,0,20,14,5,1,3,1,2,27,1,18,0,8
S01010294,Occupancy rating 0,91,10,2,8,18,0,13,3,7,3,5,3,2,63,1,32,0,30
S01010294,Occupancy rating -1 or less,64,1,0,1,14,0,9,2,5,2,5,3,2,49,1,41,0,7
S01010295,All households,427,124,11,113,104,3,79,48,24,7,22,14,8,199,8,108,0,83
S01010295,Occupancy rating +2 or more,46,18,1,17,12,2,9,7,1,1,1,0,1,16,1,5,0,10
S01010295,Occupancy rating +1,104,51,5,46,36,1,32,22,8,2,3,1,2,17,2,5,0,10
S01010295,Occupancy rating 0,185,45,4,41,37,0,26,14,10,2,11,8,3,103,1,60,0,42
S01010295,Occupancy rating -1 or less,92,10,1,9,19,0,12,5,5,2,7,5,2,63,4,38,0,21
S01010296,All households,291,107,19,88,103,0,69,27,29,13,34,18,16,81,3,46,0,32
S01010296,Occupancy rating +2 or more,29,12,2,10,14,0,12,8,1,3,2,0,2,3,0,2,0,1
S01010296,Occupancy rating +1,79,40,6,34,27,0,19,10,5,4,8,3,5,12,0,5,0,7
S01010296,Occupancy rating 0,108,43,10,33,32,0,23,7,12,4,9,5,4,33,0,18,0,15
S01010296,Occupancy rating -1 or less,75,12,1,11,30,0,15,2,11,2,15,10,5,33,3,21,0,9
S01010297,All households,676,392,90,302,205,24,117,85,19,13,64,32,32,79,5,32,1,41
S01010297,Occupancy rating +2 or more,46,26,8,18,20,3,13,11,1,1,4,2,2,0,0,0,0,0
S01010297,Occupancy rating +1,153,89,31,58,61,14,37,28,4,5,10,3,7,3,0,0,0,3
S01010297,Occupancy rating 0,335,210,36,174,86,7,54,38,10,6,25,12,13,39,2,17,0,20
S01010297,Occupancy rating -1 or less,142,67,15,52,38,0,13,8,4,1,25,15,10,37,3,15,1,18
S01010298,All households,515,309,145,164,131,17,92,59,28,5,22,12,10,75,5,31,0,39
S01010298,Occupancy rating +2 or more,41,19,6,13,16,4,11,8,2,1,1,1,0,6,1,1,0,4
S01010298,Occupancy rating +1,94,58,19,39,31,3,26,24,1,1,2,0,2,5,1,3,0,1
S01010298,Occupancy rating 0,278,194,103,91,51,4,37,25,11,1,10,6,4,33,0,12,0,21
S01010298,Occupancy rating -1 or less,102,38,17,21,33,6,18,2,14,2,9,5,4,31,3,15,0,13
S01010299,All households,292,168,69,99,86,6,46,23,18,5,34,17,17,38,14,8,1,15
S01010299,Occupancy rating +2 or more,31,20,9,11,7,1,4,3,1,0,2,2,0,4,3,0,0,1
S01010299,Occupancy rating +1,73,50,17,33,19,2,10,8,2,0,7,1,6,4,1,1,0,2
S01010299,Occupancy rating 0,131,72,32,40,39,2,19,10,6,3,18,8,10,20,3,7,1,9
S01010299,Occupancy rating -1 or less,57,26,11,15,21,1,13,2,9,2,7,6,1,10,7,0,0,3
S01010300,All households,478,220,74,146,144,9,89,50,27,12,46,29,17,114,4,50,0,60
S01010300,Occupancy rating +2 or more,22,10,3,7,10,0,9,5,3,1,1,1,0,2,0,1,0,1
S01010300,Occupancy rating +1,86,51,8,43,27,3,19,16,1,2,5,2,3,8,0,3,0,5
S01010300,Occupancy rating 0,260,128,53,75,70,6,42,24,12,6,22,17,5,62,2,26,0,34
S01010300,Occupancy rating -1 or less,110,31,10,21,37,0,19,5,11,3,18,9,9,42,2,20,0,20
S01010301,All households,283,122,7,115,89,6,65,44,19,2,18,15,3,72,2,41,0,29
S01010301,Occupancy rating +2 or more,22,12,3,9,8,1,7,6,1,0,0,0,0,2,0,1,0,1
S01010301,Occupancy rating +1,96,53,1,52,31,2,27,23,3,1,2,1,1,12,0,7,0,5
S01010301,Occupancy rating 0,124,52,3,49,32,3,18,12,6,0,11,10,1,40,0,24,0,16
S01010301,Occupancy rating -1 or less,41,5,0,5,18,0,13,3,9,1,5,4,1,18,2,9,0,7
S01010302,All households,388,233,65,168,128,13,58,24,24,10,57,44,13,27,4,7,4,12
S01010302,Occupancy rating +2 or more,26,18,4,14,7,2,4,3,1,0,1,0,1,1,0,0,0,1
S01010302,Occupancy rating +1,74,51,12,39,19,4,12,10,0,2,3,2,1,4,1,1,1,1
S01010302,Occupancy rating 0,161,99,34,65,56,7,23,8,10,5,26,20,6,6,0,3,1,2
S01010302,Occupancy rating -1 or less,127,65,15,50,46,0,19,3,13,3,27,22,5,16,3,3,2,8
S01010303,All households,250,95,20,75,132,1,72,13,54,5,59,50,9,23,8,4,0,11
S01010303,Occupancy rating +2 or more,15,10,5,5,5,0,5,1,4,0,0,0,0,0,0,0,0,0
S01010303,Occupancy rating +1,54,39,8,31,14,1,8,5,2,1,5,2,3,1,0,0,0,1
S01010303,Occupancy rating 0,106,32,5,27,68,0,35,5,28,2,33,29,4,6,0,1,0,5
S01010303,Occupancy rating -1 or less,75,14,2,12,45,0,24,2,20,2,21,19,2,16,8,3,0,5
S01010304,All households,332,200,38,162,81,4,48,26,17,5,29,22,7,51,2,24,0,25
S01010304,Occupancy rating +2 or more,20,10,4,6,7,1,5,5,0,0,1,0,1,3,0,0,0,3
S01010304,Occupancy rating +1,68,47,8,39,13,1,11,7,1,3,1,1,0,8,0,6,0,2
S01010304,Occupancy rating 0,158,98,17,81,33,2,21,10,10,1,10,8,2,27,1,17,0,9
S01010304,Occupancy rating -1 or less,86,45,9,36,28,0,11,4,6,1,17,13,4,13,1,1,0,11
S01010305,All households,478,260,86,174,159,14,103,64,18,21,42,17,25,59,2,25,1,31
S01010305,Occupancy rating +2 or more,43,20,9,11,20,3,11,8,0,3,6,0,6,3,1,0,1,1
S01010305,Occupancy rating +1,88,46,22,24,33,3,26,20,5,1,4,0,4,9,1,3,0,5
S01010305,Occupancy rating 0,260,162,46,116,76,6,50,30,8,12,20,8,12,22,0,11,0,11
S01010305,Occupancy rating -1 or less,87,32,9,23,30,2,16,6,5,5,12,9,3,25,0,11,0,14
S01010306,All households,449,226,16,210,150,4,104,75,21,8,42,27,15,73,1,39,0,33
S01010306,Occupancy rating +2 or more,34,10,1,9,21,2,12,7,2,3,7,3,4,3,0,2,0,1
S01010306,Occupancy rating +1,103,66,6,60,32,2,27,23,4,0,3,0,3,5,0,1,0,4
S01010306,Occupancy rating 0,206,101,7,94,68,0,46,35,6,5,22,16,6,37,1,22,0,14
S01010306,Occupancy rating -1 or less,106,49,2,47,29,0,19,10,9,0,10,8,2,28,0,14,0,14
S01010307,All households,428,163,24,139,162,7,136,91,37,8,19,12,7,103,2,41,0,60
S01010307,Occupancy rating +2 or more,43,20,4,16,22,2,20,14,4,2,0,0,0,1,1,0,0,0
S01010307,Occupancy rating +1,126,62,11,51,46,3,41,34,5,2,2,1,1,18,1,5,0,12
S01010307,Occupancy rating 0,191,65,9,56,71,2,58,39,16,3,11,9,2,55,0,20,0,35
S01010307,Occupancy rating -1 or less,68,16,0,16,23,0,17,4,12,1,6,2,4,29,0,16,0,13
S01010308,All households,480,168,36,132,164,4,129,78,46,5,31,25,6,148,2,67,1,78
S01010308,Occupancy rating +2 or more,75,22,9,13,41,3,36,19,14,3,2,2,0,12,0,2,0,10
S01010308,Occupancy rating +1,149,80,12,68,51,1,44,37,7,0,6,4,2,18,0,7,0,11
S01010308,Occupancy rating 0,199,61,14,47,54,0,42,20,21,1,12,9,3,84,0,40,1,43
S01010308,Occupancy rating -1 or less,57,5,1,4,18,0,7,2,4,1,11,10,1,34,2,18,0,14
S01010309,All households,264,160,52,108,93,5,64,41,11,12,24,9,15,11,2,0,0,9
S01010309,Occupancy rating +2 or more,6,1,0,1,5,2,3,3,0,0,0,0,0,0,0,0,0,0
S01010309,Occupancy rating +1,72,43,18,25,28,1,26,22,3,1,1,0,1,1,0,0,0,1
S01010309,Occupancy rating 0,131,90,26,64,37,1,19,12,3,4,17,9,8,4,0,0,0,4
S01010309,Occupancy rating -1 or less,55,26,8,18,23,1,16,4,5,7,6,0,6,6,2,0,0,4
S01010310,All households,381,209,25,184,146,0,76,28,40,8,70,51,19,26,9,3,1,13
S01010310,Occupancy rating +2 or more,28,19,4,15,9,0,7,6,1,0,2,1,1,0,0,0,0,0
S01010310,Occupancy rating +1,92,63,5,58,25,0,14,11,2,1,11,7,4,4,1,0,0,3
S01010310,Occupancy rating 0,161,95,14,81,55,0,30,8,19,3,25,18,7,11,1,3,1,6
S01010310,Occupancy rating -1 or less,100,32,2,30,57,0,25,3,18,4,32,25,7,11,7,0,0,4
S01010311,All households,351,144,42,102,172,10,68,21,31,16,94,54,40,35,16,3,1,15
S01010311,Occupancy rating +2 or more,21,13,2,11,7,0,4,4,0,0,3,2,1,1,1,0,0,0
S01010311,Occupancy rating +1,121,71,25,46,49,7,25,15,8,2,17,12,5,1,0,0,0,1
S01010311,Occupancy rating 0,134,41,13,28,77,3,26,2,15,9,48,28,20,16,4,2,1,9
S01010311,Occupancy rating -1 or less,75,19,2,17,39,0,13,0,8,5,26,12,14,17,11,1,0,5
S01010312,All households,425,192,45,147,201,13,71,26,31,14,117,78,39,32,17,2,1,12
S01010312,Occupancy rating +2 or more,32,19,3,16,13,1,10,4,4,2,2,2,0,0,0,0,0,0
S01010312,Occupancy rating +1,136,85,23,62,48,8,24,17,4,3,16,9,7,3,1,1,0,1
S01010312,Occupancy rating 0,170,65,11,54,96,2,20,4,10,6,74,49,25,9,5,1,1,2
S01010312,Occupancy rating -1 or less,87,23,8,15,44,2,17,1,13,3,25,18,7,20,11,0,0,9
S01010313,All households,356,201,43,158,137,9,62,20,28,14,66,40,26,18,5,2,0,11
S01010313,Occupancy rating +2 or more,45,27,13,14,17,5,9,5,1,3,3,0,3,1,0,0,0,1
S01010313,Occupancy rating +1,104,72,15,57,29,1,19,11,7,1,9,4,5,3,1,0,0,2
S01010313,Occupancy rating 0,149,86,10,76,58,3,22,4,13,5,33,21,12,5,1,1,0,3
S01010313,Occupancy rating -1 or less,58,16,5,11,33,0,12,0,7,5,21,15,6,9,3,1,0,5
S01010314,All households,550,321,71,250,182,13,94,43,35,16,75,46,29,47,14,12,0,21
S01010314,Occupancy rating +2 or more,34,12,1,11,22,3,15,11,2,2,4,4,0,0,0,0,0,0
S01010314,Occupancy rating +1,149,98,18,80,45,7,28,13,5,10,10,7,3,6,3,0,0,3
S01010314,Occupancy rating 0,244,149,39,110,74,2,32,13,18,1,40,27,13,21,6,3,0,12
S01010314,Occupancy rating -1 or less,123,62,13,49,41,1,19,6,10,3,21,8,13,20,5,9,0,6
S01010315,All households,409,133,32,101,231,4,136,50,68,18,91,68,23,45,11,6,2,26
S01010315,Occupancy rating +2 or more,80,36,9,27,40,2,35,27,5,3,3,1,2,4,0,2,1,1
S01010315,Occupancy rating +1,129,59,20,39,63,1,49,15,28,6,13,9,4,7,2,1,0,4
S01010315,Occupancy rating 0,121,30,2,28,79,0,35,7,21,7,44,35,9,12,2,0,0,10
S01010315,Occupancy rating -1 or less,79,8,1,7,49,1,17,1,14,2,31,23,8,22,7,3,1,11
S01010316,All households,304,173,17,156,110,3,44,23,16,5,63,46,17,21,5,5,0,11
S01010316,Occupancy rating +2 or more,17,12,2,10,5,1,2,1,1,0,2,0,2,0,0,0,0,0
S01010316,Occupancy rating +1,46,25,2,23,20,1,14,12,0,2,5,5,0,1,0,1,0,0
S01010316,Occupancy rating 0,178,108,9,99,57,1,20,8,9,3,36,26,10,13,2,4,0,7
S01010316,Occupancy rating -1 or less,63,28,4,24,28,0,8,2,6,0,20,15,5,7,3,0,0,4
S01010317,All households,394,151,35,116,146,8,120,94,21,5,18,10,8,97,3,48,0,46
S01010317,Occupancy rating +2 or more,22,7,2,5,13,1,11,6,4,1,1,0,1,2,0,1,0,1
S01010317,Occupancy rating +1,128,61,4,57,61,3,57,55,2,0,1,1,0,6,0,2,0,4
S01010317,Occupancy rating 0,194,75,26,49,58,4,44,31,11,2,10,6,4,61,2,27,0,32
S01010317,Occupancy rating -1 or less,50,8,3,5,14,0,8,2,4,2,6,3,3,28,1,18,0,9
S01010318,All households,304,164,27,137,106,5,50,32,14,4,51,38,13,34,1,16,0,17
S01010318,Occupancy rating +2 or more,7,5,2,3,1,0,0,0,0,0,1,1,0,1,0,1,0,0
S01010318,Occupancy rating +1,52,32,4,28,19,1,14,12,2,0,4,2,2,1,0,1,0,0
S01010318,Occupancy rating 0,139,76,11,65,55,4,26,17,6,3,25,17,8,8,0,3,0,5
S01010318,Occupancy rating -1 or less,106,51,10,41,31,0,10,3,6,1,21,18,3,24,1,11,0,12
S01010319,All households,407,203,31,172,143,4,108,72,30,6,31,20,11,61,4,21,1,35
S01010319,Occupancy rating +2 or more,34,8,5,3,23,3,16,11,4,1,4,0,4,3,0,0,0,3
S01010319,Occupancy rating +1,97,62,4,58,26,1,23,20,2,1,2,1,1,9,2,2,0,5
S01010319,Occupancy rating 0,213,110,17,93,75,0,55,38,15,2,20,18,2,28,1,12,1,14
S01010319,Occupancy rating -1 or less,63,23,5,18,19,0,14,3,9,2,5,1,4,21,1,7,0,13
S01010320,All households,437,269,49,220,108,6,74,54,14,6,28,17,11,60,4,26,0,30
S01010320,Occupancy rating +2 or more,14,8,3,5,6,1,5,3,0,2,0,0,0,0,0,0,0,0
S01010320,Occupancy rating +1,121,75,16,59,39,3,30,28,2,0,6,4,2,7,0,3,0,4
S01010320,Occupancy rating 0,158,85,21,64,40,2,23,17,5,1,15,9,6,33,0,16,0,17
S01010320,Occupancy rating -1 or less,144,101,9,92,23,0,16,6,7,3,7,4,3,20,4,7,0,9
S01010321,All households,432,257,31,226,127,6,84,62,12,10,37,20,17,48,4,15,1,28
S01010321,Occupancy rating +2 or more,15,7,1,6,8,0,8,7,1,0,0,0,0,0,0,0,0,0
S01010321,Occupancy rating +1,93,59,12,47,31,2,25,19,2,4,4,4,0,3,1,1,0,1
S01010321,Occupancy rating 0,198,119,13,106,60,3,37,25,7,5,20,10,10,19,0,7,0,12
S01010321,Occupancy rating -1 or less,126,72,5,67,28,1,14,11,2,1,13,6,7,26,3,7,1,15
S01010322,All households,549,228,48,180,216,16,181,121,44,16,19,13,6,105,5,38,1,61
S01010322,Occupancy rating +2 or more,85,30,7,23,54,6,48,24,17,7,0,0,0,1,0,0,0,1
S01010322,Occupancy rating +1,197,100,27,73,79,7,68,61,5,2,4,4,0,18,2,5,0,11
S01010322,Occupancy rating 0,174,65,9,56,57,2,46,29,13,4,9,6,3,52,0,15,1,36
S01010322,Occupancy rating -1 or less,93,33,5,28,26,1,19,7,9,3,6,3,3,34,3,18,0,13
S01010323,All households,377,230,88,142,127,4,43,21,16,6,80,51,29,20,5,5,2,8
S01010323,Occupancy rating +2 or more,14,9,0,9,4,0,1,1,0,0,3,2,1,1,0,0,0,1
S01010323,Occupancy rating +1,67,48,9,39,18,2,12,10,1,1,4,3,1,1,0,0,0,1
S01010323,Occupancy rating 0,197,124,55,69,67,2,20,7,8,5,45,28,17,6,0,3,0,3
S01010323,Occupancy rating -1 or less,99,49,24,25,38,0,10,3,7,0,28,18,10,12,5,2,2,3
S01010324,All households,403,206,110,96,160,31,77,23,25,29,52,27,25,37,13,2,2,20
S01010324,Occupancy rating +2 or more,73,45,28,17,26,8,17,9,4,4,1,1,0,2,1,0,0,1
S01010324,Occupancy rating +1,180,111,59,52,65,18,32,14,10,8,15,7,8,4,2,0,0,2
S01010324,Occupancy rating 0,86,26,11,15,46,1,23,0,9,14,22,14,8,14,3,1,1,9
S01010324,Occupancy rating -1 or less,64,24,12,12,23,4,5,0,2,3,14,5,9,17,7,1,1,8
S01010325,All households,501,232,144,88,239,44,118,50,41,27,77,35,42,30,9,0,7,14
S01010325,Occupancy rating +2 or more,51,33,19,14,18,10,8,6,1,1,0,0,0,0,0,0,0,0
S01010325,Occupancy rating +1,242,148,89,59,85,24,50,35,10,5,11,3,8,9,2,0,0,7
S01010325,Occupancy rating 0,135,29,18,11,90,6,43,5,22,16,41,19,22,16,6,0,6,4
S01010325,Occupancy rating -1 or less,73,22,18,4,46,4,17,4,8,5,25,13,12,5,1,0,1,3
S01010326,All households,494,236,56,180,228,9,92,29,45,18,127,96,31,30,21,2,0,7
S01010326,Occupancy rating +2 or more,47,23,5,18,22,0,13,5,7,1,9,7,2,2,0,1,0,1
S01010326,Occupancy rating +1,142,87,24,63,52,5,27,16,9,2,20,10,10,3,1,1,0,1
S01010326,Occupancy rating 0,194,87,15,72,97,4,35,7,17,11,58,46,12,10,5,0,0,5
S01010326,Occupancy rating -1 or less,111,39,12,27,57,0,17,1,12,4,40,33,7,15,15,0,0,0
S01010327,All households,362,106,27,79,224,5,135,48,73,14,84,57,27,32,18,5,0,9
S01010327,Occupancy rating +2 or more,61,25,3,22,35,1,27,19,6,2,7,3,4,1,0,0,0,1
S01010327,Occupancy rating +1,107,39,8,31,59,1,41,22,16,3,17,13,4,9,6,2,0,1
S01010327,Occupancy rating 0,146,37,15,22,96,3,45,6,32,7,48,33,15,13,6,3,0,4
S01010327,Occupancy rating -1 or less,48,5,1,4,34,0,22,1,19,2,12,8,4,9,6,0,0,3
S01010328,All households,445,156,66,90,254,32,157,59,68,30,65,33,32,35,11,4,5,15
S01010328,Occupancy rating +2 or more,103,27,9,18,75,15,56,32,17,7,4,4,0,1,0,0,0,1
S01010328,Occupancy rating +1,131,68,31,37,59,6,37,18,15,4,16,8,8,4,1,0,0,3
S01010328,Occupancy rating 0,140,38,21,17,84,7,49,9,27,13,28,13,15,18,4,3,3,8
S01010328,Occupancy rating -1 or less,71,23,5,18,36,4,15,0,9,6,17,8,9,12,6,1,2,3
S01010329,All households,290,117,47,70,140,23,72,32,25,15,45,17,28,33,10,0,4,19
S01010329,Occupancy rating +2 or more,38,21,6,15,15,5,9,5,4,0,1,1,0,2,0,0,0,2
S01010329,Occupancy rating +1,136,77,34,43,57,16,35,25,5,5,6,2,4,2,0,0,0,2
S01010329,Occupancy rating 0,82,13,5,8,52,1,20,1,12,7,31,11,20,17,1,0,4,12
S01010329,Occupancy rating -1 or less,34,6,2,4,16,1,8,1,4,3,7,3,4,12,9,0,0,3
S01010330,All households,299,107,33,74,159,9,66,22,27,17,84,57,27,33,15,0,1,17
S01010330,Occupancy rating +2 or more,41,14,6,8,23,4,10,6,4,0,9,7,2,4,0,0,0,4
S01010330,Occupancy rating +1,111,63,18,45,43,4,22,12,4,6,17,9,8,5,4,0,0,1
S01010330,Occupancy rating 0,89,17,7,10,65,1,21,3,8,10,43,32,11,7,2,0,0,5
S01010330,Occupancy rating -1 or less,58,13,2,11,28,0,13,1,11,1,15,9,6,17,9,0,1,7
S01010331,All households,520,273,124,149,216,27,92,44,28,20,97,68,29,31,7,0,5,19
S01010331,Occupancy rating +2 or more,54,34,10,24,19,6,12,11,1,0,1,1,0,1,0,0,0,1
S01010331,Occupancy rating +1,207,131,66,65,69,17,35,25,5,5,17,13,4,7,1,0,1,5
S01010331,Occupancy rating 0,189,81,37,44,97,4,36,7,16,13,57,39,18,11,1,0,1,9
S01010331,Occupancy rating -1 or less,70,27,11,16,31,0,9,1,6,2,22,15,7,12,5,0,3,4
S01010332,All households,279,74,30,44,170,16,80,22,27,31,74,45,29,35,23,1,0,11
S01010332,Occupancy rating +2 or more,101,52,21,31,46,12,26,16,5,5,8,4,4,3,0,0,0,3
S01010332,Occupancy rating +1,79,12,6,6,57,4,23,3,6,14,30,16,14,10,6,0,0,4
S01010332,Occupancy rating 0,66,10,3,7,45,0,21,3,10,8,24,17,7,11,9,1,0,1
S01010332,Occupancy rating -1 or less,33,0,0,0,22,0,10,0,6,4,12,8,4,11,8,0,0,3
S01010333,All households,487,205,77,128,244,25,119,52,45,22,100,66,34,38,11,7,1,19
S01010333,Occupancy rating +2 or more,82,37,15,22,45,10,27,18,6,3,8,7,1,0,0,0,0,0
S01010333,Occupancy rating +1,152,77,30,47,66,11,37,17,10,10,18,10,8,9,1,0,0,8
S01010333,Occupancy rating 0,190,71,22,49,101,2,44,14,22,8,55,38,17,18,5,3,1,9
S01010333,Occupancy rating -1 or less,63,20,10,10,32,2,11,3,7,1,19,11,8,11,5,4,0,2
S01010334,All households,433,137,47,90,276,36,133,59,53,21,107,79,28,20,11,0,1,8
S01010334,Occupancy rating +2 or more,43,24,13,11,19,7,11,9,1,1,1,1,0,0,0,0,0,0
S01010334,Occupancy rating +1,183,74,24,50,106,21,64,44,13,7,21,16,5,3,1,0,0,2
S01010334,Occupancy rating 0,149,20,6,14,120,7,44,3,29,12,69,51,18,9,4,0,0,5
S01010334,Occupancy rating -1 or less,58,19,4,15,31,1,14,3,10,1,16,11,5,8,6,0,1,1
S01010335,All households,345,130,78,52,185,23,96,26,45,25,66,34,32,30,12,1,2,15
S01010335,Occupancy rating +2 or more,106,57,28,29,47,16,25,21,2,2,6,1,5,2,0,0,0,2
S01010335,Occupancy rating +1,88,17,6,11,64,4,33,4,15,14,27,10,17,7,0,0,1,6
S01010335,Occupancy rating 0,109,47,38,9,51,3,23,1,15,7,25,18,7,11,6,1,0,4
S01010335,Occupancy rating -1 or less,42,9,6,3,23,0,15,0,13,2,8,5,3,10,6,0,1,3
S01010336,All households,379,210,38,172,162,8,57,18,29,10,97,72,25,7,6,0,0,1
S01010336,Occupancy rating +2 or more,22,15,6,9,7,2,4,3,0,1,1,1,0,0,0,0,0,0
S01010336,Occupancy rating +1,129,104,18,86,25,5,16,9,5,2,4,1,3,0,0,0,0,0
S01010336,Occupancy rating 0,174,77,13,64,95,1,30,5,19,6,64,50,14,2,1,0,0,1
S01010336,Occupancy rating -1 or less,54,14,1,13,35,0,7,1,5,1,28,20,8,5,5,0,0,0
S01010337,All households,278,92,44,48,164,20,87,27,27,33,57,34,23,22,15,0,0,7
S01010337,Occupancy rating +2 or more,44,18,9,9,26,0,16,7,4,5,10,4,6,0,0,0,0,0
S01010337,Occupancy rating +1,111,62,29,33,47,14,23,18,5,0,10,5,5,2,1,0,0,1
S01010337,Occupancy rating 0,87,8,4,4,70,4,40,1,14,25,26,20,6,9,6,0,0,3
S01010337,Occupancy rating -1 or less,36,4,2,2,21,2,8,1,4,3,11,5,6,11,8,0,0,3
S01010338,All households,356,134,38,96,201,10,80,27,35,18,111,80,31,21,10,2,1,8
S01010338,Occupancy rating +2 or more,29,13,2,11,14,0,9,7,0,2,5,3,2,2,0,0,0,2
S01010338,Occupancy rating +1,138,89,25,64,47,10,22,15,3,4,15,12,3,2,1,0,0,1
S01010338,Occupancy rating 0,120,17,9,8,96,0,38,4,26,8,58,39,19,7,0,2,1,4
S01010338,Occupancy rating -1 or less,69,15,2,13,44,0,11,1,6,4,33,26,7,10,9,0,0,1
S01010339,All households,284,77,49,28,177,31,84,24,37,23,62,38,24,30,18,0,1,11
S01010339,Occupancy rating +2 or more,110,60,42,18,50,24,24,20,2,2,2,0,2,0,0,0,0,0
S01010339,Occupancy rating +1,82,8,5,3,64,4,36,4,15,17,24,12,12,10,1,0,1,8
S01010339,Occupancy rating 0,63,8,2,6,44,3,16,0,14,2,25,19,6,11,8,0,0,3
S01010339,Occupancy rating -1 or less,29,1,0,1,19,0,8,0,6,2,11,7,4,9,9,0,0,0
S01010340,All households,349,133,37,96,196,26,84,24,47,13,86,63,23,20,8,2,3,7
S01010340,Occupancy rating +2 or more,64,32,10,22,29,9,14,10,3,1,6,1,5,3,0,0,3,0
S01010340,Occupancy rating +1,125,76,20,56,44,12,23,10,10,3,9,6,3,5,1,1,0,3
S01010340,Occupancy rating 0,97,14,4,10,80,2,31,2,22,7,47,38,9,3,1,0,0,2
S01010340,Occupancy rating -1 or less,63,11,3,8,43,3,16,2,12,2,24,18,6,9,6,1,0,2
S01010341,All households,253,94,37,57,138,14,93,33,40,20,31,24,7,21,13,0,0,8
S01010341,Occupancy rating +2 or more,89,34,20,14,49,9,34,18,9,7,6,3,3,6,4,0,0,2
S01010341,Occupancy rating +1,76,31,9,22,42,5,27,12,10,5,10,7,3,3,2,0,0,1
S01010341,Occupancy rating 0,64,23,5,18,36,0,25,3,14,8,11,10,1,5,2,0,0,3
S01010341,Occupancy rating -1 or less,24,6,3,3,11,0,7,0,7,0,4,4,0,7,5,0,0,2
S01010342,All households,302,128,29,99,162,12,123,48,57,18,27,18,9,12,8,2,1,1
S01010342,Occupancy rating +2 or more,38,9,3,6,26,2,21,15,5,1,3,1,2,3,1,2,0,0
S01010342,Occupancy rating +1,79,31,9,22,48,4,35,15,13,7,9,6,3,0,0,0,0,0
S01010342,Occupancy rating 0,131,70,12,58,58,6,45,12,25,8,7,4,3,3,2,0,1,0
S01010342,Occupancy rating -1 or less,54,18,5,13,30,0,22,6,14,2,8,7,1,6,5,0,0,1
S01010343,All households,365,89,15,74,260,9,208,66,99,43,43,29,14,16,7,0,0,9
S01010343,Occupancy rating +2 or more,92,22,5,17,68,3,60,29,21,10,5,4,1,2,0,0,0,2
S01010343,Occupancy rating +1,110,23,0,23,86,6,68,22,32,14,12,10,2,1,1,0,0,0
S01010343,Occupancy rating 0,115,34,5,29,76,0,58,13,29,16,18,11,7,5,3,0,0,2
S01010343,Occupancy rating -1 or less,48,10,5,5,30,0,22,2,17,3,8,4,4,8,3,0,0,5
S01010344,All households,419,243,64,179,162,17,59,26,24,9,86,59,27,14,5,0,4,5
S01010344,Occupancy rating +2 or more,46,33,16,17,11,5,6,5,1,0,0,0,0,2,0,0,2,0
S01010344,Occupancy rating +1,143,104,28,76,38,11,17,11,2,4,10,5,5,1,1,0,0,0
S01010344,Occupancy rating 0,157,75,18,57,77,1,24,6,15,3,52,37,15,5,0,0,0,5
S01010344,Occupancy rating -1 or less,73,31,2,29,36,0,12,4,6,2,24,17,7,6,4,0,2,0
S01010345,All households,160,30,6,24,116,4,92,19,63,10,20,14,6,14,8,0,0,6
S01010345,Occupancy rating +2 or more,126,18,1,17,99,3,82,19,56,7,14,11,3,9,5,0,0,4
S01010345,Occupancy rating +1,19,10,5,5,6,1,4,0,3,1,1,0,1,3,1,0,0,2
S01010345,Occupancy rating 0,11,2,0,2,9,0,4,0,2,2,5,3,2,0,0,0,0,0
S01010345,Occupancy rating -1 or less,4,0,0,0,2,0,2,0,2,0,0,0,0,2,2,0,0,0
S01010346,All households,410,117,38,79,269,26,201,74,88,39,42,31,11,24,10,2,1,11
S01010346,Occupancy rating +2 or more,161,37,18,19,118,16,94,40,36,18,8,6,2,6,2,0,0,4
S01010346,Occupancy rating +1,124,41,10,31,79,10,54,28,16,10,15,9,6,4,1,0,0,3
S01010346,Occupancy rating 0,97,32,8,24,58,0,44,6,29,9,14,11,3,7,2,2,0,3
S01010346,Occupancy rating -1 or less,28,7,2,5,14,0,9,0,7,2,5,5,0,7,5,0,1,1
S01010347,All households,466,195,72,123,247,19,109,48,44,17,119,86,33,24,11,0,0,13
S01010347,Occupancy rating +2 or more,59,31,14,17,28,5,19,15,3,1,4,3,1,0,0,0,0,0
S01010347,Occupancy rating +1,148,83,33,50,62,7,35,21,8,6,20,10,10,3,1,0,0,2
S01010347,Occupancy rating 0,187,62,18,44,115,4,40,9,24,7,71,53,18,10,3,0,0,7
S01010347,Occupancy rating -1 or less,72,19,7,12,42,3,15,3,9,3,24,20,4,11,7,0,0,4
S01010348,All households,483,173,81,92,285,43,145,67,54,24,97,61,36,25,9,0,3,13
S01010348,Occupancy rating +2 or more,127,60,29,31,67,20,42,33,7,2,5,3,2,0,0,0,0,0
S01010348,Occupancy rating +1,173,74,33,41,89,13,44,22,14,8,32,18,14,10,2,0,1,7
S01010348,Occupancy rating 0,136,29,12,17,97,4,52,11,31,10,41,25,16,10,4,0,2,4
S01010348,Occupancy rating -1 or less,47,10,7,3,32,6,7,1,2,4,19,15,4,5,3,0,0,2
S01010349,All households,443,197,85,112,224,26,128,49,48,31,70,45,25,22,10,1,1,10
S01010349,Occupancy rating +2 or more,130,71,35,36,58,10,41,34,5,2,7,6,1,1,0,0,0,1
S01010349,Occupancy rating +1,118,49,17,32,67,9,36,8,16,12,22,10,12,2,0,0,0,2
S01010349,Occupancy rating 0,123,53,17,36,63,3,36,6,19,11,24,16,8,7,3,1,0,3
S01010349,Occupancy rating -1 or less,72,24,16,8,36,4,15,1,8,6,17,13,4,12,7,0,1,4
S01010350,All households,475,206,85,121,251,16,100,37,41,22,135,105,30,18,5,1,2,10
S01010350,Occupancy rating +2 or more,48,31,14,17,17,3,11,7,2,2,3,1,2,0,0,0,0,0
S01010350,Occupancy rating +1,182,112,46,66,61,9,38,23,8,7,14,9,5,9,2,1,0,6
S01010350,Occupancy rating 0,169,49,21,28,118,3,36,7,18,11,79,67,12,2,0,0,1,1
S01010350,Occupancy rating -1 or less,76,14,4,10,55,1,15,0,13,2,39,28,11,7,3,0,1,3
S01010351,All households,398,143,43,100,216,14,110,46,48,16,92,69,23,39,10,11,0,18
S01010351,Occupancy rating +2 or more,89,43,16,27,44,8,31,21,8,2,5,3,2,2,1,0,0,1
S01010351,Occupancy rating +1,110,53,18,35,49,5,28,11,13,4,16,7,9,8,0,1,0,7
S01010351,Occupancy rating 0,138,40,6,34,82,0,38,11,20,7,44,37,7,16,4,6,0,6
S01010351,Occupancy rating -1 or less,61,7,3,4,41,1,13,3,7,3,27,22,5,13,5,4,0,4
S01010352,All households,276,129,44,85,127,25,56,26,15,15,46,23,23,20,4,1,2,13
S01010352,Occupancy rating +2 or more,23,14,6,8,8,2,6,5,0,1,0,0,0,1,0,0,0,1
S01010352,Occupancy rating +1,123,76,26,50,46,19,21,17,2,2,6,3,3,1,1,0,0,0
S01010352,Occupancy rating 0,67,10,4,6,48,1,18,2,8,8,29,14,15,9,0,0,1,8
S01010352,Occupancy rating -1 or less,63,29,8,21,25,3,11,2,5,4,11,6,5,9,3,1,1,4
S01010353,All households,562,315,84,231,219,15,90,38,41,11,114,95,19,28,15,1,3,9
S01010353,Occupancy rating +2 or more,26,16,2,14,9,0,7,4,3,0,2,2,0,1,1,0,0,0
S01010353,Occupancy rating +1,154,113,28,85,40,5,29,21,7,1,6,4,2,1,0,0,0,1
S01010353,Occupancy rating 0,266,133,44,89,126,5,40,9,23,8,81,67,14,7,2,0,1,4
S01010353,Occupancy rating -1 or less,116,53,10,43,44,5,14,4,8,2,25,22,3,19,12,1,2,4
S01010354,All households,375,152,54,98,190,11,93,40,42,11,86,47,39,33,6,10,2,15
S01010354,Occupancy rating +2 or more,54,27,11,16,24,5,14,9,4,1,5,4,1,3,0,0,2,1
S01010354,Occupancy rating +1,119,66,20,46,50,5,29,17,11,1,16,8,8,3,0,1,0,2
S01010354,Occupancy rating 0,133,42,16,26,78,1,34,12,17,5,43,22,21,13,2,1,0,10
S01010354,Occupancy rating -1 or less,69,17,7,10,38,0,16,2,10,4,22,13,9,14,4,8,0,2
S01010355,All households,402,207,47,160,164,19,74,31,27,16,71,43,28,31,11,1,1,18
S01010355,Occupancy rating +2 or more,56,32,15,17,20,5,10,8,2,0,5,2,3,4,1,0,0,3
S01010355,Occupancy rating +1,122,60,13,47,54,13,28,12,9,7,13,5,8,8,0,0,1,7
S01010355,Occupancy rating 0,156,93,13,80,55,1,27,11,11,5,27,20,7,8,1,1,0,6
S01010355,Occupancy rating -1 or less,68,22,6,16,35,0,9,0,5,4,26,16,10,11,9,0,0,2
S01010356,All households,308,107,10,97,168,3,112,47,45,20,53,30,23,33,14,8,0,11
S01010356,Occupancy rating +2 or more,45,10,0,10,35,1,31,15,11,5,3,2,1,0,0,0,0,0
S01010356,Occupancy rating +1,106,54,7,47,43,1,31,22,6,3,11,6,5,9,4,3,0,2
S01010356,Occupancy rating 0,106,29,2,27,61,1,35,8,18,9,25,12,13,16,5,5,0,6
S01010356,Occupancy rating -1 or less,51,14,1,13,29,0,15,2,10,3,14,10,4,8,5,0,0,3
S01010357,All households,340,187,42,145,133,13,64,27,24,13,56,32,24,20,6,2,3,9
S01010357,Occupancy rating +2 or more,52,14,4,10,37,6,25,11,8,6,6,4,2,1,0,0,1,0
S01010357,Occupancy rating +1,66,41,11,30,23,4,13,7,4,2,6,3,3,2,0,0,0,2
S01010357,Occupancy rating 0,151,86,19,67,54,3,22,9,9,4,29,17,12,11,3,0,1,7
S01010357,Occupancy rating -1 or less,71,46,8,38,19,0,4,0,3,1,15,8,7,6,3,2,1,0
S01010358,All households,507,312,100,212,167,17,74,22,30,22,76,55,21,28,6,3,1,18
S01010358,Occupancy rating +2 or more,44,34,14,20,10,2,6,4,1,1,2,2,0,0,0,0,0,0
S01010358,Occupancy rating +1,130,83,32,51,42,8,25,13,4,8,9,6,3,5,0,1,1,3
S01010358,Occupancy rating 0,211,121,29,92,82,4,27,5,14,8,51,33,18,8,0,0,0,8
S01010358,Occupancy rating -1 or less,122,74,25,49,33,3,16,0,11,5,14,14,0,15,6,2,0,7
S01010359,All households,456,213,98,115,219,12,62,26,23,13,145,106,39,24,3,1,1,19
S01010359,Occupancy rating +2 or more,19,11,7,4,8,1,3,3,0,0,4,3,1,0,0,0,0,0
S01010359,Occupancy rating +1,177,133,61,72,41,10,26,21,2,3,5,5,0,3,0,0,0,3
S01010359,Occupancy rating 0,180,49,19,30,122,1,22,0,14,8,99,72,27,9,2,1,0,6
S01010359,Occupancy rating -1 or less,80,20,11,9,48,0,11,2,7,2,37,26,11,12,1,0,1,10
S01010360,All households,285,137,24,113,126,0,73,29,32,12,53,40,13,22,4,4,0,14
S01010360,Occupancy rating +2 or more,28,21,4,17,7,0,6,6,0,0,1,0,1,0,0,0,0,0
S01010360,Occupancy rating +1,93,51,8,43,39,0,28,15,7,6,11,8,3,3,1,0,0,2
S01010360,Occupancy rating 0,108,46,9,37,47,0,23,3,17,3,24,18,6,15,3,3,0,9
S01010360,Occupancy rating -1 or less,56,19,3,16,33,0,16,5,8,3,17,14,3,4,0,1,0,3
S01010361,All households,402,269,51,218,114,7,44,20,17,7,63,49,14,19,7,0,2,10
S01010361,Occupancy rating +2 or more,19,15,4,11,3,0,3,2,0,1,0,0,0,1,0,0,0,1
S01010361,Occupancy rating +1,87,64,23,41,21,4,15,11,3,1,2,1,1,2,0,0,1,1
S01010361,Occupancy rating 0,198,130,18,112,61,2,17,7,8,2,42,32,10,7,1,0,1,5
S01010361,Occupancy rating -1 or less,98,60,6,54,29,1,9,0,6,3,19,16,3,9,6,0,0,3
S01010362,All households,611,501,83,418,83,15,48,25,17,6,20,13,7,27,3,4,3,17
S01010362,Occupancy rating +2 or more,36,21,11,10,15,8,6,6,0,0,1,0,1,0,0,0,0,0
S01010362,Occupancy rating +1,61,42,17,25,16,6,8,4,2,2,2,2,0,3,0,0,0,3
S01010362,Occupancy rating 0,316,268,32,236,39,1,27,12,11,4,11,9,2,9,1,2,1,5
S01010362,Occupancy rating -1 or less,198,170,23,147,13,0,7,3,4,0,6,2,4,15,2,2,2,9
S01010363,All households,394,179,52,127,178,12,132,63,49,20,34,23,11,37,5,8,0,24
S01010363,Occupancy rating +2 or more,143,64,18,46,76,5,66,44,14,8,5,3,2,3,0,2,0,1
S01010363,Occupancy rating +1,137,73,27,46,47,6,32,13,15,4,9,6,3,17,0,2,0,15
S01010363,Occupancy rating 0,65,12,2,10,41,1,25,5,15,5,15,11,4,12,1,4,0,7
S01010363,Occupancy rating -1 or less,49,30,5,25,14,0,9,1,5,3,5,3,2,5,4,0,0,1
S01010364,All households,337,62,39,23,256,27,204,64,93,47,25,11,14,19,7,0,0,12
S01010364,Occupancy rating +2 or more,236,54,37,17,175,25,142,60,53,29,8,2,6,7,2,0,0,5
S01010364,Occupancy rating +1,61,7,2,5,51,2,42,3,29,10,7,4,3,3,0,0,0,3
S01010364,Occupancy rating 0,28,0,0,0,21,0,14,1,7,6,7,4,3,7,3,0,0,4
S01010364,Occupancy rating -1 or less,12,1,0,1,9,0,6,0,4,2,3,1,2,2,2,0,0,0
S01010365,All households,449,172,57,115,245,25,197,81,81,35,23,13,10,32,6,7,0,19
S01010365,Occupancy rating +2 or more,218,75,33,42,135,19,112,47,49,16,4,3,1,8,2,1,0,5
S01010365,Occupancy rating +1,121,61,17,44,56,4,47,25,11,11,5,2,3,4,1,0,0,3
S01010365,Occupancy rating 0,77,20,6,14,42,2,30,9,14,7,10,5,5,15,2,4,0,9
S01010365,Occupancy rating -1 or less,33,16,1,15,12,0,8,0,7,1,4,3,1,5,1,2,0,2
S01010366,All households,502,201,42,159,251,25,197,97,72,28,29,15,14,50,6,12,2,30
S01010366,Occupancy rating +2 or more,163,50,27,23,108,20,82,39,28,15,6,2,4,5,1,0,1,3
S01010366,Occupancy rating +1,137,61,3,58,67,2,59,29,23,7,6,4,2,9,1,1,0,7
S01010366,Occupancy rating 0,167,85,11,74,64,3,49,28,17,4,12,8,4,18,1,3,1,13
S01010366,Occupancy rating -1 or less,35,5,1,4,12,0,7,1,4,2,5,1,4,18,3,8,0,7
S01010367,All households,507,202,61,141,264,29,198,98,80,20,37,20,17,41,5,12,0,24
S01010367,Occupancy rating +2 or more,224,78,26,52,138,17,112,58,42,12,9,6,3,8,3,1,0,4
S01010367,Occupancy rating +1,186,94,28,66,84,10,63,35,23,5,11,7,4,8,0,1,0,7
S01010367,Occupancy rating 0,82,27,7,20,36,2,20,4,13,3,14,7,7,19,1,8,0,10
S01010367,Occupancy rating -1 or less,15,3,0,3,6,0,3,1,2,0,3,0,3,6,1,2,0,3
S01010368,All households,355,154,43,111,177,22,132,82,42,8,23,16,7,24,5,5,1,13
S01010368,Occupancy rating +2 or more,159,51,16,35,100,19,72,39,29,4,9,6,3,8,5,0,1,2
S01010368,Occupancy rating +1,118,65,21,44,48,3,41,36,4,1,4,4,0,5,0,1,0,4
S01010368,Occupancy rating 0,57,27,5,22,23,0,15,7,7,1,8,4,4,7,0,2,0,5
S01010368,Occupancy rating -1 or less,21,11,1,10,6,0,4,0,2,2,2,2,0,4,0,2,0,2
S01010369,All households,433,219,26,193,160,4,130,79,40,11,26,22,4,54,4,19,2,29
S01010369,Occupancy rating +2 or more,56,18,5,13,36,2,32,15,11,6,2,2,0,2,0,1,0,1
S01010369,Occupancy rating +1,109,60,11,49,42,1,40,33,5,2,1,1,0,7,1,1,1,4
S01010369,Occupancy rating 0,211,117,9,108,67,0,50,27,20,3,17,15,2,27,0,9,0,18
S01010369,Occupancy rating -1 or less,57,24,1,23,15,1,8,4,4,0,6,4,2,18,3,8,1,6
S01010370,All households,335,106,17,89,164,6,139,83,48,8,19,13,6,65,3,20,0,42
S01010370,Occupancy rating +2 or more,139,45,13,32,81,4,71,42,23,6,6,4,2,13,1,1,0,11
S01010370,Occupancy rating +1,92,31,3,28,48,2,38,27,11,0,8,7,1,13,1,4,0,8
S01010370,Occupancy rating 0,69,16,0,16,25,0,23,11,11,1,2,1,1,28,1,9,0,18
S01010370,Occupancy rating -1 or less,35,14,1,13,10,0,7,3,3,1,3,1,2,11,0,6,0,5
S01010371,All households,461,154,28,126,187,14,156,92,54,10,17,7,10,120,6,48,0,66
S01010371,Occupancy rating +2 or more,131,41,13,28,76,11,63,36,22,5,2,1,1,14,3,0,0,11
S01010371,Occupancy rating +1,110,42,6,36,44,0,40,27,9,4,4,1,3,24,1,15,0,8
S01010371,Occupancy rating 0,128,42,8,34,44,3,35,23,11,1,6,1,5,42,2,16,0,24
S01010371,Occupancy rating -1 or less,92,29,1,28,23,0,18,6,12,0,5,4,1,40,0,17,0,23
S01010372,All households,226,64,20,44,116,5,98,50,39,9,13,8,5,46,4,9,1,32
S01010372,Occupancy rating +2 or more,95,19,8,11,66,1,62,31,28,3,3,1,2,10,0,1,0,9
S01010372,Occupancy rating +1,61,23,6,17,27,3,21,13,6,2,3,1,2,11,0,1,0,10
S01010372,Occupancy rating 0,58,21,6,15,19,1,11,6,4,1,7,6,1,18,3,5,1,9
S01010372,Occupancy rating -1 or less,12,1,0,1,4,0,4,0,1,3,0,0,0,7,1,2,0,4
S01010373,All households,408,172,41,131,145,8,124,76,37,11,13,10,3,91,4,35,1,51
S01010373,Occupancy rating +2 or more,50,18,5,13,31,2,29,21,5,3,0,0,0,1,0,1,0,0
S01010373,Occupancy rating +1,149,73,15,58,60,4,51,35,16,0,5,4,1,16,0,6,0,10
S01010373,Occupancy rating 0,171,77,17,60,42,1,37,18,13,6,4,3,1,52,1,20,1,30
S01010373,Occupancy rating -1 or less,38,4,4,0,12,1,7,2,3,2,4,3,1,22,3,8,0,11
S01010374,All households,469,188,36,152,191,16,152,84,59,9,23,15,8,90,8,45,0,37
S01010374,Occupancy rating +2 or more,147,54,11,43,82,13,58,28,27,3,11,8,3,11,1,4,0,6
S01010374,Occupancy rating +1,132,66,10,56,57,2,52,36,13,3,3,2,1,9,2,4,0,3
S01010374,Occupancy rating 0,104,42,7,35,33,1,28,12,14,2,4,2,2,29,2,10,0,17
S01010374,Occupancy rating -1 or less,86,26,8,18,19,0,14,8,5,1,5,3,2,41,3,27,0,11
S01010375,All households,219,61,16,45,44,2,33,23,9,1,9,4,5,114,1,75,0,38
S01010375,Occupancy rating +2 or more,29,18,5,13,10,0,9,6,3,0,1,0,1,1,0,0,0,1
S01010375,Occupancy rating +1,52,23,4,19,17,1,14,13,1,0,2,1,1,12,0,4,0,8
S01010375,Occupancy rating 0,72,8,4,4,14,1,8,4,3,1,5,3,2,50,0,28,0,22
S01010375,Occupancy rating -1 or less,66,12,3,9,3,0,2,0,2,0,1,0,1,51,1,43,0,7
S01010376,All households,367,132,18,114,101,0,91,61,25,5,10,4,6,134,1,96,0,37
S01010376,Occupancy rating +2 or more,34,10,3,7,16,0,14,7,6,1,2,0,2,8,0,4,0,4
S01010376,Occupancy rating +1,82,38,2,36,30,0,29,23,5,1,1,0,1,14,0,9,0,5
S01010376,Occupancy rating 0,170,60,10,50,48,0,42,29,11,2,6,4,2,62,0,44,0,18
S01010376,Occupancy rating -1 or less,81,24,3,21,7,0,6,2,3,1,1,0,1,50,1,39,0,10
S01010377,All households,375,158,12,146,96,2,73,35,31,7,21,16,5,121,6,73,0,42
S01010377,Occupancy rating +2 or more,56,23,7,16,25,1,18,12,5,1,6,3,3,8,1,2,0,5
S01010377,Occupancy rating +1,67,21,0,21,26,1,19,8,9,2,6,5,1,20,0,10,0,10
S01010377,Occupancy rating 0,128,54,4,50,26,0,19,9,8,2,7,6,1,48,2,30,0,16
S01010377,Occupancy rating -1 or less,124,60,1,59,19,0,17,6,9,2,2,2,0,45,3,31,0,11
S01010378,All households,272,58,9,49,68,4,50,27,18,5,14,8,6,146,1,104,1,40
S01010378,Occupancy rating +2 or more,42,18,3,15,17,2,12,6,5,1,3,2,1,7,0,6,0,1
S01010378,Occupancy rating +1,53,15,4,11,23,1,20,14,4,2,2,1,1,15,0,8,1,6
S01010378,Occupancy rating 0,102,17,1,16,19,1,12,6,5,1,6,2,4,66,1,48,0,17
S01010378,Occupancy rating -1 or less,75,8,1,7,9,0,6,1,4,1,3,3,0,58,0,42,0,16
S01010379,All households,446,148,29,119,106,7,82,51,24,7,17,7,10,192,4,131,0,57
S01010379,Occupancy rating +2 or more,74,37,6,31,31,4,25,13,9,3,2,1,1,6,2,0,0,4
S01010379,Occupancy rating +1,130,58,12,46,31,1,24,20,4,0,6,3,3,41,0,24,0,17
S01010379,Occupancy rating 0,161,36,9,27,35,2,24,15,6,3,9,3,6,90,0,62,0,28
S01010379,Occupancy rating -1 or less,81,17,2,15,9,0,9,3,5,1,0,0,0,55,2,45,0,8
S01010380,All households,521,223,48,175,201,13,161,102,45,14,27,10,17,97,3,53,0,41
S01010380,Occupancy rating +2 or more,81,34,13,21,43,3,38,23,12,3,2,1,1,4,0,1,0,3
S01010380,Occupancy rating +1,160,82,18,64,66,7,54,40,11,3,5,1,4,12,0,4,0,8
S01010380,Occupancy rating 0,216,89,13,76,72,2,58,35,16,7,12,5,7,55,1,30,0,24
S01010380,Occupancy rating -1 or less,64,18,4,14,20,1,11,4,6,1,8,3,5,26,2,18,0,6
S01010381,All households,372,190,10,180,97,1,82,69,12,1,14,10,4,85,2,56,0,27
S01010381,Occupancy rating +2 or more,13,5,1,4,8,0,8,6,2,0,0,0,0,0,0,0,0,0
S01010381,Occupancy rating +1,72,44,1,43,22,0,22,22,0,0,0,0,0,6,0,3,0,3
S01010381,Occupancy rating 0,144,71,6,65,38,1,32,29,3,0,5,5,0,35,0,21,0,14
S01010381,Occupancy rating -1 or less,143,70,2,68,29,0,20,12,7,1,9,5,4,44,2,32,0,10
S01010382,All households,483,210,33,177,150,10,116,89,20,7,24,20,4,123,2,67,1,53
S01010382,Occupancy rating +2 or more,22,14,2,12,8,2,5,5,0,0,1,1,0,0,0,0,0,0
S01010382,Occupancy rating +1,130,76,10,66,43,2,39,34,5,0,2,1,1,11,0,3,0,8
S01010382,Occupancy rating 0,256,106,18,88,82,6,61,50,6,5,15,13,2,68,1,38,0,29
S01010382,Occupancy rating -1 or less,75,14,3,11,17,0,11,0,9,2,6,5,1,44,1,26,1,16
S01010383,All households,393,215,40,175,115,2,78,51,18,9,35,22,13,63,3,34,0,26
S01010383,Occupancy rating +2 or more,16,10,4,6,5,0,3,3,0,0,2,1,1,1,0,0,0,1
S01010383,Occupancy rating +1,60,38,10,28,19,2,13,7,4,2,4,2,2,3,0,1,0,2
S01010383,Occupancy rating 0,185,106,20,86,52,0,32,22,6,4,20,12,8,27,1,14,0,12
S01010383,Occupancy rating -1 or less,132,61,6,55,39,0,30,19,8,3,9,7,2,32,2,19,0,11
S01010384,All households,454,187,29,158,153,8,127,91,28,8,18,8,10,114,1,55,0,58
S01010384,Occupancy rating +2 or more,44,19,5,14,23,2,21,17,3,1,0,0,0,2,0,1,0,1
S01010384,Occupancy rating +1,120,63,3,60,48,3,45,37,6,2,0,0,0,9,0,7,0,2
S01010384,Occupancy rating 0,219,89,17,72,66,3,50,33,14,3,13,6,7,64,0,27,0,37
S01010384,Occupancy rating -1 or less,71,16,4,12,16,0,11,4,5,2,5,2,3,39,1,20,0,18
S01010385,All households,498,229,47,182,179,10,129,101,23,5,40,22,18,90,3,50,1,36
S01010385,Occupancy rating +2 or more,22,9,6,3,13,1,7,6,1,0,5,1,4,0,0,0,0,0
S01010385,Occupancy rating +1,99,47,8,39,50,5,41,40,1,0,4,1,3,2,0,1,0,1
S01010385,Occupancy rating 0,275,143,30,113,86,4,68,51,14,3,14,10,4,46,1,20,0,25
S01010385,Occupancy rating -1 or less,102,30,3,27,30,0,13,4,7,2,17,10,7,42,2,29,1,10
S01010386,All households,528,283,63,220,158,12,101,65,25,11,45,33,12,87,8,37,1,41
S01010386,Occupancy rating +2 or more,25,10,5,5,14,3,10,6,2,2,1,1,0,1,0,0,0,1
S01010386,Occupancy rating +1,86,42,8,34,31,3,22,15,3,4,6,3,3,13,0,6,0,7
S01010386,Occupancy rating 0,258,154,40,114,75,6,43,34,7,2,26,19,7,29,3,13,0,13
S01010386,Occupancy rating -1 or less,159,77,10,67,38,0,26,10,13,3,12,10,2,44,5,18,1,20
S01010387,All households,587,251,40,211,182,9,134,93,32,9,39,22,17,154,4,67,1,82
S01010387,Occupancy rating +2 or more,35,20,6,14,13,0,11,7,4,0,2,0,2,2,0,1,0,1
S01010387,Occupancy rating +1,191,104,11,93,76,4,68,59,6,3,4,3,1,11,0,2,0,9
S01010387,Occupancy rating 0,260,83,15,68,74,4,47,25,17,5,23,11,12,103,4,46,0,53
S01010387,Occupancy rating -1 or less,101,44,8,36,19,1,8,2,5,1,10,8,2,38,0,18,1,19
S01010388,All households,584,290,62,228,234,24,125,76,26,23,85,46,39,60,4,24,1,31
S01010388,Occupancy rating +2 or more,42,19,8,11,21,8,11,9,1,1,2,1,1,2,0,0,0,2
S01010388,Occupancy rating +1,112,55,20,35,51,6,29,23,2,4,16,1,15,6,0,0,0,6
S01010388,Occupancy rating 0,314,168,27,141,120,7,66,36,14,16,47,33,14,26,1,15,1,9
S01010388,Occupancy rating -1 or less,116,48,7,41,42,3,19,8,9,2,20,11,9,26,3,9,0,14
S01010389,All households,668,380,11,369,197,1,170,140,22,8,26,18,8,91,2,33,0,56
S01010389,Occupancy rating +2 or more,44,30,0,30,13,0,12,10,2,0,1,1,0,1,0,1,0,0
S01010389,Occupancy rating +1,88,50,3,47,33,1,29,26,2,1,3,1,2,5,0,2,0,3
S01010389,Occupancy rating 0,278,157,5,152,97,0,88,78,6,4,9,5,4,24,0,12,0,12
S01010389,Occupancy rating -1 or less,258,143,3,140,54,0,41,26,12,3,13,11,2,61,2,18,0,41
S01010390,All households,716,451,39,412,218,3,178,138,32,8,37,22,15,47,4,19,0,24
S01010390,Occupancy rating +2 or more,24,13,3,10,11,0,10,6,1,3,1,0,1,0,0,0,0,0
S01010390,Occupancy rating +1,81,36,3,33,40,3,33,26,5,2,4,3,1,5,0,1,0,4
S01010390,Occupancy rating 0,389,269,14,255,100,0,82,73,8,1,18,10,8,20,2,7,0,11
S01010390,Occupancy rating -1 or less,222,133,19,114,67,0,53,33,18,2,14,9,5,22,2,11,0,9
S01010391,All households,541,331,38,293,168,7,118,102,13,3,43,29,14,42,1,12,1,28
S01010391,Occupancy rating +2 or more,13,6,1,5,7,0,7,6,1,0,0,0,0,0,0,0,0,0
S01010391,Occupancy rating +1,98,56,6,50,38,0,34,33,1,0,4,3,1,4,0,2,0,2
S01010391,Occupancy rating 0,314,188,20,168,97,6,62,54,7,1,29,19,10,29,1,7,0,21
S01010391,Occupancy rating -1 or less,116,81,11,70,26,1,15,9,4,2,10,7,3,9,0,3,1,5
S01010392,All households,416,212,5,207,163,1,146,103,41,2,16,11,5,41,1,15,0,25
S01010392,Occupancy rating +2 or more,71,32,0,32,37,1,33,29,3,1,3,3,0,2,0,0,0,2
S01010392,Occupancy rating +1,115,66,2,64,46,0,42,31,10,1,4,2,2,3,0,2,0,1
S01010392,Occupancy rating 0,161,90,3,87,56,0,53,38,15,0,3,2,1,15,0,5,0,10
S01010392,Occupancy rating -1 or less,69,24,0,24,24,0,18,5,13,0,6,4,2,21,1,8,0,12
S01010393,All households,634,369,81,288,202,15,162,128,24,10,25,10,15,63,2,26,0,35
S01010393,Occupancy rating +2 or more,49,22,6,16,26,6,19,11,5,3,1,0,1,1,0,1,0,0
S01010393,Occupancy rating +1,105,52,14,38,50,6,40,34,5,1,4,1,3,3,0,0,0,3
S01010393,Occupancy rating 0,305,188,43,145,81,3,70,57,8,5,8,4,4,36,0,17,0,19
S01010393,Occupancy rating -1 or less,175,107,18,89,45,0,33,26,6,1,12,5,7,23,2,8,0,13
S01010394,All households,516,324,97,227,152,15,78,42,25,11,59,35,24,40,6,9,1,24
S01010394,Occupancy rating +2 or more,36,24,6,18,11,2,9,7,2,0,0,0,0,1,0,0,0,1
S01010394,Occupancy rating +1,155,104,47,57,43,12,26,22,2,2,5,0,5,8,0,4,0,4
S01010394,Occupancy rating 0,207,117,32,85,74,1,29,7,14,8,44,28,16,16,2,4,1,9
S01010394,Occupancy rating -1 or less,118,79,12,67,24,0,14,6,7,1,10,7,3,15,4,1,0,10
S01010395,All households,637,384,95,289,193,16,133,86,38,9,44,24,20,60,3,15,2,40
S01010395,Occupancy rating +2 or more,55,27,10,17,28,10,17,17,0,0,1,0,1,0,0,0,0,0
S01010395,Occupancy rating +1,145,74,23,51,58,3,38,18,17,3,17,9,8,13,0,4,0,9
S01010395,Occupancy rating 0,247,152,34,118,68,3,47,29,14,4,18,10,8,27,1,7,1,18
S01010395,Occupancy rating -1 or less,190,131,28,103,39,0,31,22,7,2,8,5,3,20,2,4,1,13
S01010396,All households,585,272,85,187,233,23,157,102,42,13,53,24,29,80,1,36,0,43
S01010396,Occupancy rating +2 or more,39,17,4,13,21,1,20,12,6,2,0,0,0,1,0,0,0,1
S01010396,Occupancy rating +1,172,94,29,65,74,10,61,52,5,4,3,1,2,4,0,0,0,4
S01010396,Occupancy rating 0,266,123,38,85,98,10,57,32,19,6,31,13,18,45,0,20,0,25
S01010396,Occupancy rating -1 or less,108,38,14,24,40,2,19,6,12,1,19,10,9,30,1,16,0,13
S01010397,All households,294,141,30,111,103,6,88,50,31,7,9,2,7,50,0,32,0,18
S01010397,Occupancy rating +2 or more,51,22,3,19,28,2,24,20,4,0,2,0,2,1,0,1,0,0
S01010397,Occupancy rating +1,76,42,5,37,27,1,25,14,10,1,1,0,1,7,0,7,0,0
S01010397,Occupancy rating 0,114,53,10,43,34,1,31,16,10,5,2,0,2,27,0,12,0,15
S01010397,Occupancy rating -1 or less,53,24,12,12,14,2,8,0,7,1,4,2,2,15,0,12,0,3
S01010398,All households,583,248,71,177,248,16,205,139,48,18,27,16,11,87,8,35,0,44
S01010398,Occupancy rating +2 or more,90,39,17,22,46,6,38,20,11,7,2,2,0,5,2,1,0,2
S01010398,Occupancy rating +1,217,111,30,81,101,8,90,71,13,6,3,2,1,5,0,1,0,4
S01010398,Occupancy rating 0,227,85,21,64,86,1,66,45,19,2,19,11,8,56,1,25,0,30
S01010398,Occupancy rating -1 or less,49,13,3,10,15,1,11,3,5,3,3,1,2,21,5,8,0,8
S01010399,All households,615,291,43,248,236,15,213,154,47,12,8,5,3,88,2,33,1,52
S01010399,Occupancy rating +2 or more,112,41,11,30,69,9,58,41,10,7,2,1,1,2,0,1,0,1
S01010399,Occupancy rating +1,190,113,14,99,63,0,63,52,10,1,0,0,0,14,0,4,0,10
S01010399,Occupancy rating 0,268,133,16,117,92,6,82,60,19,3,4,3,1,43,0,14,1,28
S01010399,Occupancy rating -1 or less,45,4,2,2,12,0,10,1,8,1,2,1,1,29,2,14,0,13
S01010400,All households,530,217,71,146,247,20,198,109,73,16,29,21,8,66,8,23,2,33
S01010400,Occupancy rating +2 or more,202,80,35,45,114,15,96,55,35,6,3,3,0,8,2,1,2,3
S01010400,Occupancy rating +1,160,77,10,67,70,5,57,30,21,6,8,4,4,13,1,7,0,5
S01010400,Occupancy rating 0,114,38,7,31,50,0,39,21,14,4,11,7,4,26,0,11,0,15
S01010400,Occupancy rating -1 or less,54,22,19,3,13,0,6,3,3,0,7,7,0,19,5,4,0,10
S01010401,All households,400,214,84,130,136,16,107,69,24,14,13,7,6,50,4,20,0,26
S01010401,Occupancy rating +2 or more,83,29,7,22,52,9,39,21,11,7,4,2,2,2,0,0,0,2
S01010401,Occupancy rating +1,86,40,8,32,34,2,29,21,5,3,3,1,2,12,1,2,0,9
S01010401,Occupancy rating 0,169,113,65,48,36,5,28,23,3,2,3,2,1,20,2,9,0,9
S01010401,Occupancy rating -1 or less,62,32,4,28,14,0,11,4,5,2,3,2,1,16,1,9,0,6
S01010402,All households,513,188,54,134,255,22,219,128,71,20,14,2,12,70,3,19,2,46
S01010402,Occupancy rating +2 or more,204,63,19,44,130,14,111,63,36,12,5,0,5,11,1,3,1,6
S01010402,Occupancy rating +1,139,50,10,40,73,5,64,41,20,3,4,0,4,16,0,3,0,13
S01010402,Occupancy rating 0,137,63,18,45,44,3,38,22,12,4,3,1,2,30,2,8,0,20
S01010402,Occupancy rating -1 or less,33,12,7,5,8,0,6,2,3,1,2,1,1,13,0,5,1,7
S01010403,All households,509,198,56,142,253,25,204,123,66,15,24,15,9,58,3,27,1,27
S01010403,Occupancy rating +2 or more,232,86,36,50,137,18,115,72,37,6,4,1,3,9,0,2,0,7
S01010403,Occupancy rating +1,162,76,16,60,71,5,59,41,11,7,7,6,1,15,2,6,0,7
S01010403,Occupancy rating 0,83,33,4,29,32,2,21,6,15,0,9,5,4,18,0,9,0,9
S01010403,Occupancy rating -1 or less,32,3,0,3,13,0,9,4,3,2,4,3,1,16,1,10,1,4
S01010404,All households,406,189,62,127,186,19,155,88,52,15,12,5,7,31,7,9,1,14
S01010404,Occupancy rating +2 or more,131,39,11,28,85,12,70,38,24,8,3,1,2,7,3,0,1,3
S01010404,Occupancy rating +1,102,46,10,36,52,5,45,31,11,3,2,0,2,4,2,0,0,2
S01010404,Occupancy rating 0,115,75,33,42,28,2,24,11,9,4,2,1,1,12,0,7,0,5
S01010404,Occupancy rating -1 or less,58,29,8,21,21,0,16,8,8,0,5,3,2,8,2,2,0,4
S01010405,All households,408,165,36,129,200,11,172,104,55,13,17,12,5,43,3,11,0,29
S01010405,Occupancy rating +2 or more,136,43,10,33,88,7,78,41,32,5,3,1,2,5,1,0,0,4
S01010405,Occupancy rating +1,114,54,15,39,54,4,47,36,9,2,3,3,0,6,0,2,0,4
S01010405,Occupancy rating 0,104,42,8,34,47,0,39,23,11,5,8,6,2,15,1,2,0,12
S01010405,Occupancy rating -1 or less,54,26,3,23,11,0,8,4,3,1,3,2,1,17,1,7,0,9
S01010406,All households,435,195,26,169,152,10,133,86,42,5,9,6,3,88,5,42,0,41
S01010406,Occupancy rating +2 or more,99,38,7,31,58,8,48,23,22,3,2,1,1,3,0,0,0,3
S01010406,Occupancy rating +1,103,53,11,42,40,1,37,32,4,1,2,2,0,10,1,2,0,7
S01010406,Occupancy rating 0,122,51,5,46,32,1,29,19,9,1,2,1,1,39,2,18,0,19
S01010406,Occupancy rating -1 or less,111,53,3,50,22,0,19,12,7,0,3,2,1,36,2,22,0,12
S01010407,All households,418,131,31,100,110,5,84,55,23,6,21,12,9,177,3,113,0,61
S01010407,Occupancy rating +2 or more,80,29,14,15,40,2,34,25,9,0,4,1,3,11,1,5,0,5
S01010407,Occupancy rating +1,105,50,7,43,27,2,23,17,4,2,2,1,1,28,0,16,0,12
S01010407,Occupancy rating 0,148,32,7,25,30,1,19,10,8,1,10,6,4,86,1,57,0,28
S01010407,Occupancy rating -1 or less,85,20,3,17,13,0,8,3,2,3,5,4,1,52,1,35,0,16
S01010408,All households,272,135,62,73,126,11,91,28,56,7,24,16,8,11,4,0,1,6
S01010408,Occupancy rating +2 or more,77,17,8,9,58,5,49,15,32,2,4,2,2,2,1,0,0,1
S01010408,Occupancy rating +1,95,66,35,31,25,5,20,12,6,2,0,0,0,4,1,0,0,3
S01010408,Occupancy rating 0,46,10,1,9,32,1,16,0,14,2,15,10,5,4,1,0,1,2
S01010408,Occupancy rating -1 or less,54,42,18,24,11,0,6,1,4,1,5,4,1,1,1,0,0,0
S01010409,All households,245,42,28,14,196,23,147,31,83,33,26,13,13,7,5,0,0,2
S01010409,Occupancy rating +2 or more,172,27,18,9,140,20,107,28,61,18,13,8,5,5,3,0,0,2
S01010409,Occupancy rating +1,43,11,8,3,31,3,22,3,13,6,6,3,3,1,1,0,0,0
S01010409,Occupancy rating 0,23,2,0,2,21,0,16,0,8,8,5,1,4,0,0,0,0,0
S01010409,Occupancy rating -1 or less,7,2,2,0,4,0,2,0,1,1,2,1,1,1,1,0,0,0
S01010410,All households,248,83,27,56,156,18,120,31,65,24,18,13,5,9,2,3,0,4
S01010410,Occupancy rating +2 or more,142,40,15,25,100,14,78,22,40,16,8,6,2,2,1,0,0,1
S01010410,Occupancy rating +1,35,10,4,6,23,1,18,3,10,5,4,2,2,2,1,0,0,1
S01010410,Occupancy rating 0,56,33,8,25,20,0,16,6,8,2,4,3,1,3,0,1,0,2
S01010410,Occupancy rating -1 or less,15,0,0,0,13,3,8,0,7,1,2,2,0,2,0,2,0,0
S01010411,All households,365,58,32,26,291,33,233,50,153,30,25,12,13,16,7,2,2,5
S01010411,Occupancy rating +2 or more,280,47,30,17,226,31,181,49,107,25,14,4,10,7,2,0,1,4
S01010411,Occupancy rating +1,52,8,2,6,42,1,34,1,29,4,7,4,3,2,1,0,1,0
S01010411,Occupancy rating 0,21,3,0,3,14,1,11,0,10,1,2,2,0,4,2,1,0,1
S01010411,Occupancy rating -1 or less,12,0,0,0,9,0,7,0,7,0,2,2,0,3,2,1,0,0
S01010412,All households,424,216,29,187,163,13,136,82,44,10,14,9,5,45,6,10,1,28
S01010412,Occupancy rating +2 or more,112,52,16,36,56,12,41,21,16,4,3,2,1,4,0,0,0,4
S01010412,Occupancy rating +1,151,87,8,79,56,1,50,37,9,4,5,4,1,8,1,1,1,5
S01010412,Occupancy rating 0,105,46,4,42,41,0,37,22,14,1,4,1,3,18,0,5,0,13
S01010412,Occupancy rating -1 or less,56,31,1,30,10,0,8,2,5,1,2,2,0,15,5,4,0,6
S01010413,All households,340,127,66,61,190,53,118,52,53,13,19,8,11,23,5,4,1,13
S01010413,Occupancy rating +2 or more,206,71,39,32,129,45,75,37,32,6,9,2,7,6,2,0,0,4
S01010413,Occupancy rating +1,89,42,21,21,43,8,31,12,16,3,4,3,1,4,1,0,1,2
S01010413,Occupancy rating 0,32,9,3,6,14,0,9,2,4,3,5,2,3,9,2,2,0,5
S01010413,Occupancy rating -1 or less,13,5,3,2,4,0,3,1,1,1,1,1,0,4,0,2,0,2
S01010414,All households,497,188,102,86,271,33,199,66,106,27,39,26,13,38,4,11,2,21
S01010414,Occupancy rating +2 or more,206,42,21,21,158,27,119,41,58,20,12,6,6,6,0,2,1,3
S01010414,Occupancy rating +1,134,80,34,46,48,4,37,18,17,2,7,4,3,6,2,1,0,3
S01010414,Occupancy rating 0,88,25,14,11,45,1,29,6,18,5,15,12,3,18,0,6,1,11
S01010414,Occupancy rating -1 or less,69,41,33,8,20,1,14,1,13,0,5,4,1,8,2,2,0,4
S01010415,All households,555,291,117,174,231,32,147,70,55,22,52,34,18,33,7,11,1,14
S01010415,Occupancy rating +2 or more,116,44,20,24,68,13,50,27,17,6,5,3,2,4,2,0,0,2
S01010415,Occupancy rating +1,162,90,43,47,63,14,46,24,14,8,3,2,1,9,1,3,0,5
S01010415,Occupancy rating 0,208,126,45,81,72,4,40,18,18,4,28,16,12,10,0,6,1,3
S01010415,Occupancy rating -1 or less,69,31,9,22,28,1,11,1,6,4,16,13,3,10,4,2,0,4
S01010416,All households,322,112,42,70,196,32,145,58,60,27,19,9,10,14,5,3,0,6
S01010416,Occupancy rating +2 or more,113,31,20,11,79,24,53,23,20,10,2,0,2,3,3,0,0,0
S01010416,Occupancy rating +1,99,45,18,27,54,7,43,19,18,6,4,2,2,0,0,0,0,0
S01010416,Occupancy rating 0,83,36,4,32,45,1,36,16,13,7,8,4,4,2,0,1,0,1
S01010416,Occupancy rating -1 or less,27,0,0,0,18,0,13,0,9,4,5,3,2,9,2,2,0,5
S01010417,All households,286,125,55,70,144,10,119,54,47,18,15,11,4,17,3,3,2,9
S01010417,Occupancy rating +2 or more,89,18,9,9,71,5,60,24,27,9,6,5,1,0,0,0,0,0
S01010417,Occupancy rating +1,95,53,20,33,39,4,35,22,7,6,0,0,0,3,1,0,2,0
S01010417,Occupancy rating 0,91,49,23,26,31,1,21,8,11,2,9,6,3,11,0,3,0,8
S01010417,Occupancy rating -1 or less,11,5,3,2,3,0,3,0,2,1,0,0,0,3,2,0,0,1
S01010418,All households,561,247,41,206,277,14,231,134,83,14,32,21,11,37,2,6,1,28
S01010418,Occupancy rating +2 or more,148,50,17,33,97,6,88,42,36,10,3,0,3,1,0,0,0,1
S01010418,Occupancy rating +1,185,91,9,82,91,6,80,59,20,1,5,3,2,3,0,1,0,2
S01010418,Occupancy rating 0,179,74,8,66,77,2,59,33,23,3,16,12,4,28,2,4,1,21
S01010418,Occupancy rating -1 or less,49,32,7,25,12,0,4,0,4,0,8,6,2,5,0,1,0,4
S01010419,All households,500,219,72,147,247,22,202,95,82,25,23,16,7,34,5,4,1,24
S01010419,Occupancy rating +2 or more,160,47,28,19,111,16,90,36,41,13,5,3,2,2,0,2,0,0
S01010419,Occupancy rating +1,150,80,20,60,66,4,60,42,16,2,2,1,1,4,2,0,0,2
S01010419,Occupancy rating 0,155,73,18,55,61,2,46,16,21,9,13,9,4,21,1,2,1,17
S01010419,Occupancy rating -1 or less,35,19,6,13,9,0,6,1,4,1,3,3,0,7,2,0,0,5
S01010420,All households,290,101,87,14,179,25,128,28,69,31,26,12,14,10,5,0,1,4
S01010420,Occupancy rating +2 or more,143,30,20,10,109,19,83,26,36,21,7,5,2,4,2,0,0,2
S01010420,Occupancy rating +1,56,15,14,1,39,0,28,0,21,7,11,2,9,2,1,0,0,1
S01010420,Occupancy rating 0,75,47,46,1,25,6,12,2,9,1,7,4,3,3,1,0,1,1
S01010420,Occupancy rating -1 or less,16,9,7,2,6,0,5,0,3,2,1,1,0,1,1,0,0,0
S01010421,All households,346,98,58,40,233,19,195,55,106,34,19,9,10,15,5,0,3,7
S01010421,Occupancy rating +2 or more,198,45,35,10,149,14,126,30,76,20,9,3,6,4,2,0,0,2
S01010421,Occupancy rating +1,77,27,14,13,47,2,41,19,13,9,4,1,3,3,1,0,2,0
S01010421,Occupancy rating 0,57,22,8,14,30,3,22,6,12,4,5,4,1,5,0,0,0,5
S01010421,Occupancy rating -1 or less,14,4,1,3,7,0,6,0,5,1,1,1,0,3,2,0,1,0
S01010422,All households,483,181,105,76,284,28,214,69,115,30,42,23,19,18,6,1,0,11
S01010422,Occupancy rating +2 or more,236,50,24,26,178,24,144,55,70,19,10,3,7,8,2,0,0,6
S01010422,Occupancy rating +1,80,29,17,12,49,0,36,9,22,5,13,6,7,2,1,0,0,1
S01010422,Occupancy rating 0,116,74,50,24,39,3,29,5,19,5,7,5,2,3,1,0,0,2
S01010422,Occupancy rating -1 or less,51,28,14,14,18,1,5,0,4,1,12,9,3,5,2,1,0,2
S01010423,All households,490,270,60,210,182,5,88,50,34,4,89,63,26,38,4,11,2,21
S01010423,Occupancy rating +2 or more,49,31,13,18,16,4,8,7,1,0,4,3,1,2,1,0,0,1
S01010423,Occupancy rating +1,113,65,18,47,43,0,28,21,7,0,15,7,8,5,0,2,1,2
S01010423,Occupancy rating 0,209,120,24,96,76,1,35,19,13,3,40,32,8,13,0,4,1,8
S01010423,Occupancy rating -1 or less,119,54,5,49,47,0,17,3,13,1,30,21,9,18,3,5,0,10
S01010424,All households,471,259,87,172,179,10,96,52,30,14,73,53,20,33,11,2,1,19
S01010424,Occupancy rating +2 or more,47,27,18,9,20,3,13,4,5,4,4,2,2,0,0,0,0,0
S01010424,Occupancy rating +1,115,61,21,40,50,4,35,24,6,5,11,5,6,4,0,0,0,4
S01010424,Occupancy rating 0,220,134,34,100,74,2,37,17,16,4,35,27,8,12,2,2,1,7
S01010424,Occupancy rating -1 or less,89,37,14,23,35,1,11,7,3,1,23,19,4,17,9,0,0,8
S01010425,All households,621,355,66,289,238,13,120,63,46,11,105,76,29,28,6,9,1,12
S01010425,Occupancy rating +2 or more,42,17,3,14,22,1,19,13,3,3,2,1,1,3,0,1,0,2
S01010425,Occupancy rating +1,100,59,8,51,41,2,25,15,7,3,14,7,7,0,0,0,0,0
S01010425,Occupancy rating 0,348,217,41,176,120,10,55,30,22,3,55,45,10,11,4,4,0,3
S01010425,Occupancy rating -1 or less,131,62,14,48,55,0,21,5,14,2,34,23,11,14,2,4,1,7
S01010426,All households,406,222,23,199,171,3,117,68,39,10,51,32,19,13,3,1,0,9
S01010426,Occupancy rating +2 or more,66,25,8,17,39,1,35,19,12,4,3,1,2,2,0,0,0,2
S01010426,Occupancy rating +1,66,37,1,36,29,1,23,14,6,3,5,1,4,0,0,0,0,0
S01010426,Occupancy rating 0,190,115,8,107,68,1,46,27,16,3,21,15,6,7,0,1,0,6
S01010426,Occupancy rating -1 or less,84,45,6,39,35,0,13,8,5,0,22,15,7,4,3,0,0,1
S01010427,All households,499,238,85,153,232,17,140,35,83,22,75,50,25,29,13,0,2,14
S01010427,Occupancy rating +2 or more,84,41,20,21,40,6,28,13,9,6,6,3,3,3,1,0,1,1
S01010427,Occupancy rating +1,152,88,38,50,56,8,32,16,11,5,16,12,4,8,3,0,1,4
S01010427,Occupancy rating 0,143,55,14,41,79,3,45,4,33,8,31,17,14,9,2,0,0,7
S01010427,Occupancy rating -1 or less,120,54,13,41,57,0,35,2,30,3,22,18,4,9,7,0,0,2
S01010428,All households,319,114,52,62,193,30,132,35,72,25,31,20,11,12,5,2,1,4
S01010428,Occupancy rating +2 or more,135,23,8,15,108,9,91,23,50,18,8,5,3,4,0,0,1,3
S01010428,Occupancy rating +1,101,55,25,30,45,16,23,8,13,2,6,4,2,1,1,0,0,0
S01010428,Occupancy rating 0,63,22,10,12,34,3,14,3,7,4,17,11,6,7,4,2,0,1
S01010428,Occupancy rating -1 or less,20,14,9,5,6,2,4,1,2,1,0,0,0,0,0,0,0,0
S01010429,All households,388,80,32,48,283,19,232,91,114,27,32,17,15,25,8,4,3,10
S01010429,Occupancy rating +2 or more,247,44,20,24,195,16,164,71,75,18,15,7,8,8,3,0,1,4
S01010429,Occupancy rating +1,98,32,11,21,60,3,46,18,23,5,11,6,5,6,2,1,1,2
S01010429,Occupancy rating 0,30,2,0,2,19,0,13,1,8,4,6,4,2,9,2,3,0,4
S01010429,Occupancy rating -1 or less,13,2,1,1,9,0,9,1,8,0,0,0,0,2,1,0,1,0
S01010430,All households,451,219,49,170,199,20,96,36,47,13,83,59,24,33,6,14,1,12
S01010430,Occupancy rating +2 or more,31,15,5,10,16,5,10,8,2,0,1,1,0,0,0,0,0,0
S01010430,Occupancy rating +1,211,148,29,119,55,15,30,23,3,4,10,5,5,8,0,3,0,5
S01010430,Occupancy rating 0,132,31,14,17,87,0,35,3,29,3,52,37,15,14,0,9,1,4
S01010430,Occupancy rating -1 or less,77,25,1,24,41,0,21,2,13,6,20,16,4,11,6,2,0,3
S01010431,All households,258,53,22,31,191,18,157,42,86,29,16,11,5,14,7,0,1,6
S01010431,Occupancy rating +2 or more,177,27,10,17,144,17,119,38,65,16,8,5,3,6,0,0,1,5
S01010431,Occupancy rating +1,52,17,7,10,31,1,27,4,15,8,3,3,0,4,4,0,0,0
S01010431,Occupancy rating 0,18,5,4,1,11,0,8,0,4,4,3,2,1,2,2,0,0,0
S01010431,Occupancy rating -1 or less,11,4,1,3,5,0,3,0,2,1,2,1,1,2,1,0,0,1
S01010432,All households,464,221,44,177,197,5,108,48,42,18,84,58,26,46,10,15,1,20
S01010432,Occupancy rating +2 or more,33,21,6,15,11,0,10,9,1,0,1,0,1,1,0,0,0,1
S01010432,Occupancy rating +1,139,90,22,68,46,3,32,26,2,4,11,7,4,3,0,1,0,2
S01010432,Occupancy rating 0,214,89,13,76,101,2,50,11,26,13,49,30,19,24,2,10,1,11
S01010432,Occupancy rating -1 or less,78,21,3,18,39,0,16,2,13,1,23,21,2,18,8,4,0,6
S01010433,All households,338,153,6,147,160,1,94,23,65,6,65,50,15,25,12,0,1,12
S01010433,Occupancy rating +2 or more,19,13,0,13,6,1,5,2,3,0,0,0,0,0,0,0,0,0
S01010433,Occupancy rating +1,79,53,3,50,25,0,15,9,5,1,10,7,3,1,0,0,1,0
S01010433,Occupancy rating 0,121,33,2,31,77,0,45,8,35,2,32,24,8,11,4,0,0,7
S01010433,Occupancy rating -1 or less,119,54,1,53,52,0,29,4,22,3,23,19,4,13,8,0,0,5
S01010434,All households,331,161,34,127,141,2,69,30,33,6,70,51,19,29,9,3,4,13
S01010434,Occupancy rating +2 or more,21,14,2,12,7,1,6,5,1,0,0,0,0,0,0,0,0,0
S01010434,Occupancy rating +1,154,109,23,86,36,1,24,21,2,1,11,9,2,9,0,1,3,5
S01010434,Occupancy rating 0,103,25,9,16,68,0,29,3,23,3,39,25,14,10,2,2,0,6
S01010434,Occupancy rating -1 or less,53,13,0,13,30,0,10,1,7,2,20,17,3,10,7,0,1,2
S01010435,All households,291,102,61,41,176,20,101,35,37,29,55,30,25,13,3,2,1,7
S01010435,Occupancy rating +2 or more,92,38,18,20,54,12,38,24,7,7,4,2,2,0,0,0,0,0
S01010435,Occupancy rating +1,90,38,23,15,48,4,28,6,9,13,16,6,10,4,0,0,1,3
S01010435,Occupancy rating 0,80,15,9,6,57,2,28,4,17,7,27,16,11,8,3,2,0,3
S01010435,Occupancy rating -1 or less,29,11,11,0,17,2,7,1,4,2,8,6,2,1,0,0,0,1
S01010436,All households,433,232,39,193,159,11,93,43,38,12,55,34,21,42,13,8,2,19
S01010436,Occupancy rating +2 or more,36,20,5,15,15,1,9,6,2,1,5,2,3,1,0,0,0,1
S01010436,Occupancy rating +1,122,84,17,67,34,5,22,20,1,1,7,1,6,4,0,3,0,1
S01010436,Occupancy rating 0,185,98,14,84,71,3,41,17,17,7,27,19,8,16,5,5,1,5
S01010436,Occupancy rating -1 or less,90,30,3,27,39,2,21,0,18,3,16,12,4,21,8,0,1,12
S01010437,All households,269,106,42,64,139,26,67,26,30,11,46,30,16,24,8,1,3,12
S01010437,Occupancy rating +2 or more,51,21,15,6,30,13,14,9,4,1,3,0,3,0,0,0,0,0
S01010437,Occupancy rating +1,95,43,20,23,45,11,25,13,5,7,9,6,3,7,1,0,1,5
S01010437,Occupancy rating 0,58,13,3,10,40,2,14,3,10,1,24,18,6,5,1,0,1,3
S01010437,Occupancy rating -1 or less,65,29,4,25,24,0,14,1,11,2,10,6,4,12,6,1,1,4
S01010438,All households,370,139,24,115,211,3,120,38,70,12,88,71,17,20,9,0,0,11
S01010438,Occupancy rating +2 or more,51,20,1,19,29,1,24,14,7,3,4,2,2,2,0,0,0,2
S01010438,Occupancy rating +1,110,55,9,46,51,2,32,18,13,1,17,13,4,4,1,0,0,3
S01010438,Occupancy rating 0,132,44,9,35,83,0,41,5,32,4,42,35,7,5,2,0,0,3
S01010438,Occupancy rating -1 or less,77,20,5,15,48,0,23,1,18,4,25,21,4,9,6,0,0,3
S01010439,All households,512,242,35,207,231,3,134,77,47,10,94,66,28,39,11,9,0,19
S01010439,Occupancy rating +2 or more,28,14,5,9,14,0,13,10,1,2,1,1,0,0,0,0,0,0
S01010439,Occupancy rating +1,187,120,10,110,65,2,47,45,1,1,16,12,4,2,0,0,0,2
S01010439,Occupancy rating 0,207,75,10,65,112,1,59,20,34,5,52,38,14,20,0,7,0,13
S01010439,Occupancy rating -1 or less,90,33,10,23,40,0,15,2,11,2,25,15,10,17,11,2,0,4
S01010440,All households,322,143,43,100,163,15,92,39,36,17,56,41,15,16,7,0,1,8
S01010440,Occupancy rating +2 or more,84,32,14,18,51,9,37,21,10,6,5,1,4,1,0,0,0,1
S01010440,Occupancy rating +1,87,54,17,37,31,2,26,13,5,8,3,1,2,2,2,0,0,0
S01010440,Occupancy rating 0,106,44,9,35,53,4,22,5,14,3,27,20,7,9,2,0,1,6
S01010440,Occupancy rating -1 or less,45,13,3,10,28,0,7,0,7,0,21,19,2,4,3,0,0,1
S01010441,All households,488,274,18,256,193,2,140,96,32,12,51,35,16,21,4,2,1,14
S01010441,Occupancy rating +2 or more,47,23,1,22,24,0,21,14,5,2,3,1,2,0,0,0,0,0
S01010441,Occupancy rating +1,144,84,7,77,59,0,53,44,5,4,6,4,2,1,0,0,1,0
S01010441,Occupancy rating 0,218,133,8,125,76,2,55,34,15,6,19,12,7,9,1,2,0,6
S01010441,Occupancy rating -1 or less,79,34,2,32,34,0,11,4,7,0,23,18,5,11,3,0,0,8
S01010442,All households,383,178,12,166,176,2,96,54,32,10,78,58,20,29,6,3,0,20
S01010442,Occupancy rating +2 or more,26,10,0,10,15,1,13,11,1,1,1,1,0,1,1,0,0,0
S01010442,Occupancy rating +1,77,50,2,48,26,1,18,12,4,2,7,5,2,1,0,0,0,1
S01010442,Occupancy rating 0,197,91,6,85,94,0,51,29,16,6,43,31,12,12,2,1,0,9
S01010442,Occupancy rating -1 or less,83,27,4,23,41,0,14,2,11,1,27,21,6,15,3,2,0,10
S01010443,All households,228,69,36,33,144,17,84,32,33,19,43,26,17,15,8,0,0,7
S01010443,Occupancy rating +2 or more,47,20,8,12,24,8,13,10,3,0,3,1,2,3,1,0,0,2
S01010443,Occupancy rating +1,96,39,20,19,56,8,35,18,8,9,13,6,7,1,0,0,0,1
S01010443,Occupancy rating 0,48,4,2,2,40,0,23,3,14,6,17,15,2,4,2,0,0,2
S01010443,Occupancy rating -1 or less,37,6,6,0,24,1,13,1,8,4,10,4,6,7,5,0,0,2
S01010444,All households,289,89,50,39,174,24,91,25,35,31,59,29,30,26,14,1,0,11
S01010444,Occupancy rating +2 or more,72,38,23,15,31,11,15,9,4,2,5,1,4,3,1,1,0,1
S01010444,Occupancy rating +1,107,41,24,17,63,11,33,12,10,11,19,7,12,3,1,0,0,2
S01010444,Occupancy rating 0,71,6,2,4,55,2,31,2,15,14,22,11,11,10,5,0,0,5
S01010444,Occupancy rating -1 or less,39,4,1,3,25,0,12,2,6,4,13,10,3,10,7,0,0,3
S01010445,All households,307,83,44,39,194,13,117,39,46,32,64,38,26,30,17,0,1,12
S01010445,Occupancy rating +2 or more,82,29,11,18,51,6,41,25,9,7,4,2,2,2,0,0,0,2
S01010445,Occupancy rating +1,104,31,14,17,65,6,36,12,14,10,23,9,14,8,4,0,1,3
S01010445,Occupancy rating 0,81,22,18,4,49,1,29,2,19,8,19,12,7,10,5,0,0,5
S01010445,Occupancy rating -1 or less,40,1,1,0,29,0,11,0,4,7,18,15,3,10,8,0,0,2
S01010446,All households,329,79,40,39,227,24,159,52,70,37,44,19,25,23,10,0,2,11
S01010446,Occupancy rating +2 or more,119,32,18,14,84,11,68,32,21,15,5,2,3,3,0,0,1,2
S01010446,Occupancy rating +1,98,34,14,20,59,11,38,18,8,12,10,1,9,5,2,0,1,2
S01010446,Occupancy rating 0,80,9,5,4,62,2,38,1,31,6,22,12,10,9,4,0,0,5
S01010446,Occupancy rating -1 or less,32,4,3,1,22,0,15,1,10,4,7,4,3,6,4,0,0,2
S01010447,All households,521,253,83,170,244,17,123,44,65,14,104,72,32,24,8,1,3,12
S01010447,Occupancy rating +2 or more,68,30,11,19,35,2,29,14,12,3,4,1,3,3,0,0,0,3
S01010447,Occupancy rating +1,169,100,40,60,65,11,38,25,10,3,16,6,10,4,1,0,0,3
S01010447,Occupancy rating 0,185,84,25,59,90,4,33,3,25,5,53,39,14,11,4,1,2,4
S01010447,Occupancy rating -1 or less,99,39,7,32,54,0,23,2,18,3,31,26,5,6,3,0,1,2
S01010448,All households,360,113,58,55,224,21,163,55,71,37,40,22,18,23,7,0,2,14
S01010448,Occupancy rating +2 or more,107,38,19,19,64,8,54,21,24,9,2,2,0,5,3,0,0,2
S01010448,Occupancy rating +1,141,63,32,31,71,9,53,30,15,8,9,2,7,7,0,0,2,5
S01010448,Occupancy rating 0,79,6,3,3,65,1,43,4,27,12,21,12,9,8,2,0,0,6
S01010448,Occupancy rating -1 or less,33,6,4,2,24,3,13,0,5,8,8,6,2,3,2,0,0,1
S01010449,All households,370,133,68,65,203,34,112,38,50,24,57,29,28,34,11,1,4,18
S01010449,Occupancy rating +2 or more,43,23,14,9,20,9,11,9,2,0,0,0,0,0,0,0,0,0
S01010449,Occupancy rating +1,162,85,44,41,71,21,44,29,10,5,6,3,3,6,1,0,0,5
S01010449,Occupancy rating 0,123,20,8,12,88,3,41,0,28,13,44,20,24,15,2,1,3,9
S01010449,Occupancy rating -1 or less,42,5,2,3,24,1,16,0,10,6,7,6,1,13,8,0,1,4
S01010450,All households,407,177,64,113,200,32,99,44,34,21,69,31,38,30,7,1,1,21
S01010450,Occupancy rating +2 or more,64,27,13,14,35,6,26,13,5,8,3,1,2,2,0,0,0,2
S01010450,Occupancy rating +1,184,102,38,64,77,24,43,29,8,6,10,3,7,5,0,0,0,5
S01010450,Occupancy rating 0,91,15,6,9,67,2,21,1,16,4,44,20,24,9,1,1,0,7
S01010450,Occupancy rating -1 or less,68,33,7,26,21,0,9,1,5,3,12,7,5,14,6,0,1,7
S01010451,All households,438,221,55,166,196,16,112,39,56,17,68,45,23,21,8,1,3,9
S01010451,Occupancy rating +2 or more,68,29,10,19,39,4,30,11,12,7,5,3,2,0,0,0,0,0
S01010451,Occupancy rating +1,147,97,36,61,46,11,27,20,5,2,8,6,2,4,0,0,3,1
S01010451,Occupancy rating 0,162,72,8,64,83,1,40,7,27,6,42,25,17,7,2,1,0,4
S01010451,Occupancy rating -1 or less,61,23,1,22,28,0,15,1,12,2,13,11,2,10,6,0,0,4
S01010452,All households,408,178,109,69,216,35,113,42,45,26,68,28,40,14,9,0,1,4
S01010452,Occupancy rating +2 or more,71,36,26,10,35,15,18,10,5,3,2,1,1,0,0,0,0,0
S01010452,Occupancy rating +1,187,113,68,45,71,17,43,26,11,6,11,3,8,3,1,0,0,2
S01010452,Occupancy rating 0,106,21,10,11,80,3,37,5,20,12,40,16,24,5,2,0,1,2
S01010452,Occupancy rating -1 or less,44,8,5,3,30,0,15,1,9,5,15,8,7,6,6,0,0,0
S01010453,All households,372,193,22,171,156,10,82,35,37,10,64,50,14,23,4,2,2,15
S01010453,Occupancy rating +2 or more,43,13,6,7,28,6,20,12,4,4,2,0,2,2,0,0,1,1
S01010453,Occupancy rating +1,114,83,9,74,30,3,22,15,6,1,5,3,2,1,0,0,0,1
S01010453,Occupancy rating 0,147,65,6,59,69,1,30,6,19,5,38,31,7,13,0,1,1,11
S01010453,Occupancy rating -1 or less,68,32,1,31,29,0,10,2,8,0,19,16,3,7,4,1,0,2
S01010454,All households,383,147,83,64,210,33,122,48,46,28,55,32,23,26,7,0,5,14
S01010454,Occupancy rating +2 or more,64,37,19,18,26,7,18,12,6,0,1,1,0,1,1,0,0,0
S01010454,Occupancy rating +1,183,94,55,39,85,21,53,32,11,10,11,7,4,4,0,0,0,4
S01010454,Occupancy rating 0,100,13,7,6,73,4,38,4,20,14,31,19,12,14,2,0,4,8
S01010454,Occupancy rating -1 or less,36,3,2,1,26,1,13,0,9,4,12,5,7,7,4,0,1,2
S01010455,All households,604,357,135,222,231,33,90,50,31,9,108,65,43,16,0,0,1,15
S01010455,Occupancy rating +2 or more,44,21,10,11,22,5,11,7,3,1,6,1,5,1,0,0,0,1
S01010455,Occupancy rating +1,280,214,88,126,64,26,33,31,2,0,5,3,2,2,0,0,0,2
S01010455,Occupancy rating 0,207,91,27,64,107,2,33,11,16,6,72,44,28,9,0,0,0,9
S01010455,Occupancy rating -1 or less,73,31,10,21,38,0,13,1,10,2,25,17,8,4,0,0,1,3
S01010456,All households,313,157,97,60,149,23,84,37,31,16,42,24,18,7,2,0,0,5
S01010456,Occupancy rating +2 or more,44,25,16,9,18,2,14,10,2,2,2,1,1,1,1,0,0,0
S01010456,Occupancy rating +1,140,85,42,43,55,18,33,27,3,3,4,2,2,0,0,0,0,0
S01010456,Occupancy rating 0,74,13,11,2,57,3,29,0,20,9,25,16,9,4,1,0,0,3
S01010456,Occupancy rating -1 or less,55,34,28,6,19,0,8,0,6,2,11,5,6,2,0,0,0,2
S01010457,All households,340,175,62,113,146,19,86,27,47,12,41,22,19,19,7,1,3,8
S01010457,Occupancy rating +2 or more,48,26,13,13,21,4,15,11,4,0,2,1,1,1,1,0,0,0
S01010457,Occupancy rating +1,131,91,31,60,35,12,21,11,6,4,2,0,2,5,2,0,1,2
S01010457,Occupancy rating 0,102,35,8,27,59,3,33,4,26,3,23,10,13,8,1,1,1,5
S01010457,Occupancy rating -1 or less,59,23,10,13,31,0,17,1,11,5,14,11,3,5,3,0,1,1
S01010458,All households,411,198,84,114,198,37,91,34,37,20,70,44,26,15,5,0,3,7
S01010458,Occupancy rating +2 or more,47,27,16,11,20,10,8,6,2,0,2,2,0,0,0,0,0,0
S01010458,Occupancy rating +1,185,120,55,65,64,25,34,22,5,7,5,3,2,1,0,0,0,1
S01010458,Occupancy rating 0,131,42,10,32,83,1,38,6,23,9,44,28,16,6,1,0,2,3
S01010458,Occupancy rating -1 or less,48,9,3,6,31,1,11,0,7,4,19,11,8,8,4,0,1,3
S01010459,All households,258,97,55,42,138,17,72,27,27,18,49,19,30,23,8,4,0,11
S01010459,Occupancy rating +2 or more,54,29,17,12,24,5,19,15,1,3,0,0,0,1,0,0,0,1
S01010459,Occupancy rating +1,108,53,31,22,51,7,28,12,7,9,16,2,14,4,2,0,0,2
S01010459,Occupancy rating 0,71,13,5,8,48,3,19,0,15,4,26,14,12,10,1,2,0,7
S01010459,Occupancy rating -1 or less,25,2,2,0,15,2,6,0,4,2,7,3,4,8,5,2,0,1
S01010460,All households,346,147,48,99,178,16,139,55,74,10,23,11,12,21,8,4,1,8
S01010460,Occupancy rating +2 or more,140,44,15,29,91,4,80,21,52,7,7,3,4,5,2,0,0,3
S01010460,Occupancy rating +1,146,91,30,61,49,10,37,30,6,1,2,1,1,6,2,1,1,2
S01010460,Occupancy rating 0,47,8,3,5,34,2,19,4,14,1,13,7,6,5,2,2,0,1
S01010460,Occupancy rating -1 or less,13,4,0,4,4,0,3,0,2,1,1,0,1,5,2,1,0,2
S01010461,All households,386,174,72,102,197,26,98,39,42,17,73,43,30,15,2,0,1,12
S01010461,Occupancy rating +2 or more,51,24,12,12,27,8,16,9,4,3,3,1,2,0,0,0,0,0
S01010461,Occupancy rating +1,169,103,53,50,62,13,35,27,4,4,14,7,7,4,1,0,0,3
S01010461,Occupancy rating 0,104,28,6,22,69,4,31,1,24,6,34,20,14,7,1,0,1,5
S01010461,Occupancy rating -1 or less,62,19,1,18,39,1,16,2,10,4,22,15,7,4,0,0,0,4
S01010462,All households,437,236,21,215,174,0,75,18,50,7,99,83,16,27,12,0,0,15
S01010462,Occupancy rating +2 or more,23,13,6,7,10,0,5,3,0,2,5,5,0,0,0,0,0,0
S01010462,Occupancy rating +1,125,85,9,76,38,0,20,13,7,0,18,13,5,2,1,0,0,1
S01010462,Occupancy rating 0,143,62,3,59,71,0,31,2,26,3,40,31,9,10,1,0,0,9
S01010462,Occupancy rating -1 or less,146,76,3,73,55,0,19,0,17,2,36,34,2,15,10,0,0,5
S01010463,All households,376,164,87,77,191,20,130,46,62,22,41,25,16,21,9,0,4,8
S01010463,Occupancy rating +2 or more,130,59,35,24,67,8,49,25,17,7,10,4,6,4,0,0,2,2
S01010463,Occupancy rating +1,106,46,23,23,57,8,42,17,19,6,7,3,4,3,1,0,1,1
S01010463,Occupancy rating 0,70,22,15,7,40,1,26,3,18,5,13,9,4,8,5,0,1,2
S01010463,Occupancy rating -1 or less,70,37,14,23,27,3,13,1,8,4,11,9,2,6,3,0,0,3
S01010464,All households,248,97,55,42,141,14,91,34,34,23,36,17,19,10,2,0,0,8
S01010464,Occupancy rating +2 or more,52,32,19,13,20,4,15,10,3,2,1,0,1,0,0,0,0,0
S01010464,Occupancy rating +1,119,57,31,26,59,9,43,23,11,9,7,3,4,3,0,0,0,3
S01010464,Occupancy rating 0,53,3,3,0,46,0,24,1,13,10,22,9,13,4,1,0,0,3
S01010464,Occupancy rating -1 or less,24,5,2,3,16,1,9,0,7,2,6,5,1,3,1,0,0,2
S01010465,All households,451,167,33,134,263,22,198,92,81,25,43,28,15,21,6,3,0,12
S01010465,Occupancy rating +2 or more,112,33,8,25,77,7,63,36,22,5,7,4,3,2,1,0,0,1
S01010465,Occupancy rating +1,193,94,19,75,96,11,74,46,20,8,11,6,5,3,0,1,0,2
S01010465,Occupancy rating 0,103,25,3,22,69,3,48,5,35,8,18,12,6,9,0,2,0,7
S01010465,Occupancy rating -1 or less,43,15,3,12,21,1,13,5,4,4,7,6,1,7,5,0,0,2
S01010466,All households,458,190,25,165,211,18,169,93,60,16,24,13,11,57,3,18,1,35
S01010466,Occupancy rating +2 or more,113,27,4,23,81,13,63,33,23,7,5,2,3,5,1,2,0,2
S01010466,Occupancy rating +1,134,67,8,59,61,4,54,35,15,4,3,3,0,6,1,3,0,2
S01010466,Occupancy rating 0,152,59,8,51,55,1,42,22,15,5,12,6,6,38,1,11,1,25
S01010466,Occupancy rating -1 or less,59,37,5,32,14,0,10,3,7,0,4,2,2,8,0,2,0,6
S01010467,All households,476,248,125,123,205,42,129,70,41,18,34,16,18,23,5,4,1,13
S01010467,Occupancy rating +2 or more,182,95,45,50,86,20,61,41,15,5,5,3,2,1,0,0,0,1
S01010467,Occupancy rating +1,155,81,45,36,66,16,38,19,10,9,12,2,10,8,0,1,0,7
S01010467,Occupancy rating 0,110,65,30,35,37,6,20,8,8,4,11,5,6,8,1,3,0,4
S01010467,Occupancy rating -1 or less,29,7,5,2,16,0,10,2,8,0,6,6,0,6,4,0,1,1
S01010468,All households,417,141,61,80,211,16,159,71,76,12,36,23,13,65,13,12,2,38
S01010468,Occupancy rating +2 or more,195,58,16,42,123,10,105,48,51,6,8,5,3,14,5,1,2,6
S01010468,Occupancy rating +1,120,45,22,23,55,2,37,16,18,3,16,10,6,20,1,4,0,15
S01010468,Occupancy rating 0,80,33,21,12,26,4,13,7,5,1,9,6,3,21,3,6,0,12
S01010468,Occupancy rating -1 or less,22,5,2,3,7,0,4,0,2,2,3,2,1,10,4,1,0,5
S01010469,All households,405,303,65,238,87,3,60,36,17,7,24,14,10,15,2,5,0,8
S01010469,Occupancy rating +2 or more,20,14,3,11,6,0,5,4,1,0,1,0,1,0,0,0,0,0
S01010469,Occupancy rating +1,112,93,35,58,17,2,12,10,2,0,3,2,1,2,0,0,0,2
S01010469,Occupancy rating 0,140,97,8,89,37,1,24,13,6,5,12,8,4,6,0,4,0,2
S01010469,Occupancy rating -1 or less,133,99,19,80,27,0,19,9,8,2,8,4,4,7,2,1,0,4
S01010470,All households,364,153,77,76,191,24,104,46,40,18,63,29,34,20,8,0,1,11
S01010470,Occupancy rating +2 or more,61,30,17,13,30,8,18,10,6,2,4,2,2,1,1,0,0,0
S01010470,Occupancy rating +1,172,94,44,50,71,12,44,27,10,7,15,3,12,7,2,0,1,4
S01010470,Occupancy rating 0,93,20,12,8,67,4,33,6,21,6,30,15,15,6,1,0,0,5
S01010470,Occupancy rating -1 or less,38,9,4,5,23,0,9,3,3,3,14,9,5,6,4,0,0,2
S01010471,All households,316,130,73,57,166,13,100,41,42,17,53,35,18,20,7,0,1,12
S01010471,Occupancy rating +2 or more,84,54,29,25,28,4,21,16,4,1,3,2,1,2,0,0,1,1
S01010471,Occupancy rating +1,126,59,36,23,65,7,46,21,15,10,12,6,6,2,0,0,0,2
S01010471,Occupancy rating 0,73,11,8,3,50,1,19,3,14,2,30,22,8,12,6,0,0,6
S01010471,Occupancy rating -1 or less,33,6,0,6,23,1,14,1,9,4,8,5,3,4,1,0,0,3
S01010472,All households,290,134,20,114,124,5,94,62,23,9,25,16,9,32,5,14,0,13
S01010472,Occupancy rating +2 or more,50,24,6,18,25,2,18,13,5,0,5,3,2,1,0,0,0,1
S01010472,Occupancy rating +1,87,54,9,45,30,0,28,17,7,4,2,2,0,3,0,1,0,2
S01010472,Occupancy rating 0,118,51,3,48,52,3,39,29,7,3,10,7,3,15,0,10,0,5
S01010472,Occupancy rating -1 or less,35,5,2,3,17,0,9,3,4,2,8,4,4,13,5,3,0,5
S01010473,All households,435,239,44,195,170,13,123,69,35,19,34,17,17,26,7,6,2,11
S01010473,Occupancy rating +2 or more,56,25,6,19,29,5,22,12,9,1,2,1,1,2,0,0,0,2
S01010473,Occupancy rating +1,128,73,22,51,53,5,40,22,11,7,8,2,6,2,0,1,0,1
S01010473,Occupancy rating 0,170,97,10,87,62,2,47,28,12,7,13,6,7,11,2,4,0,5
S01010473,Occupancy rating -1 or less,81,44,6,38,26,1,14,7,3,4,11,8,3,11,5,1,2,3
S01010474,All households,431,198,47,151,146,4,98,45,44,9,44,21,23,87,10,27,0,50
S01010474,Occupancy rating +2 or more,72,49,15,34,20,3,16,11,5,0,1,1,0,3,2,0,0,1
S01010474,Occupancy rating +1,174,104,29,75,50,1,42,26,10,6,7,1,6,20,0,10,0,10
S01010474,Occupancy rating 0,138,36,3,33,58,0,29,7,21,1,29,15,14,44,3,15,0,26
S01010474,Occupancy rating -1 or less,47,9,0,9,18,0,11,1,8,2,7,4,3,20,5,2,0,13
S01010475,All households,384,185,32,153,174,8,141,94,40,7,25,15,10,25,3,12,1,9
S01010475,Occupancy rating +2 or more,48,22,5,17,24,1,22,13,7,2,1,0,1,2,0,2,0,0
S01010475,Occupancy rating +1,117,66,13,53,48,2,40,25,13,2,6,5,1,3,0,1,0,2
S01010475,Occupancy rating 0,180,92,13,79,78,5,61,52,7,2,12,6,6,10,2,3,1,4
S01010475,Occupancy rating -1 or less,39,5,1,4,24,0,18,4,13,1,6,4,2,10,1,6,0,3
S01010476,All households,523,233,139,94,233,29,139,61,54,24,65,30,35,57,9,14,2,32
S01010476,Occupancy rating +2 or more,152,68,33,35,79,12,61,30,22,9,6,2,4,5,2,0,0,3
S01010476,Occupancy rating +1,172,75,46,29,82,13,43,22,16,5,26,9,17,15,1,4,2,8
S01010476,Occupancy rating 0,150,76,55,21,50,3,24,6,12,6,23,14,9,24,1,8,0,15
S01010476,Occupancy rating -1 or less,49,14,5,9,22,1,11,3,4,4,10,5,5,13,5,2,0,6
S01010477,All households,354,144,73,71,190,23,115,47,40,28,52,26,26,20,6,0,2,12
S01010477,Occupancy rating +2 or more,52,25,14,11,27,5,18,12,5,1,4,1,3,0,0,0,0,0
S01010477,Occupancy rating +1,184,99,47,52,83,16,56,33,14,9,11,1,10,2,1,0,0,1
S01010477,Occupancy rating 0,79,16,11,5,53,2,25,2,11,12,26,16,10,10,0,0,2,8
S01010477,Occupancy rating -1 or less,39,4,1,3,27,0,16,0,10,6,11,8,3,8,5,0,0,3
S01010478,All households,628,396,104,292,213,25,118,64,43,11,70,49,21,19,2,0,1,16
S01010478,Occupancy rating +2 or more,29,21,6,15,7,1,4,3,0,1,2,1,1,1,0,0,0,1
S01010478,Occupancy rating +1,164,104,34,70,60,18,35,31,2,2,7,6,1,0,0,0,0,0
S01010478,Occupancy rating 0,323,226,53,173,86,4,49,25,18,6,33,24,9,11,0,0,1,10
S01010478,Occupancy rating -1 or less,112,45,11,34,60,2,30,5,23,2,28,18,10,7,2,0,0,5
S01010479,All households,512,212,106,106,278,33,162,71,71,20,83,57,26,22,3,2,3,14
S01010479,Occupancy rating +2 or more,97,46,20,26,50,13,31,22,5,4,6,1,5,1,0,0,1,0
S01010479,Occupancy rating +1,210,104,54,50,100,19,63,41,14,8,18,11,7,6,0,1,0,5
S01010479,Occupancy rating 0,149,49,25,24,91,0,49,5,37,7,42,31,11,9,1,1,1,6
S01010479,Occupancy rating -1 or less,56,13,7,6,37,1,19,3,15,1,17,14,3,6,2,0,1,3
S01010480,All households,285,104,57,47,167,27,97,31,52,14,43,19,24,14,5,0,2,7
S01010480,Occupancy rating +2 or more,58,23,12,11,33,7,23,14,7,2,3,0,3,2,0,0,0,2
S01010480,Occupancy rating +1,128,64,36,28,60,19,29,16,11,2,12,4,8,4,1,0,1,2
S01010480,Occupancy rating 0,78,11,7,4,62,1,39,1,31,7,22,10,12,5,3,0,1,1
S01010480,Occupancy rating -1 or less,21,6,2,4,12,0,6,0,3,3,6,5,1,3,1,0,0,2
S01010481,All households,267,81,27,54,157,7,70,27,34,9,80,65,15,29,13,1,1,14
S01010481,Occupancy rating +2 or more,45,27,13,14,18,4,12,12,0,0,2,2,0,0,0,0,0,0
S01010481,Occupancy rating +1,76,33,8,25,39,2,25,13,10,2,12,9,3,4,0,0,0,4
S01010481,Occupancy rating 0,90,12,3,9,65,1,20,2,13,5,44,37,7,13,4,1,1,7
S01010481,Occupancy rating -1 or less,56,9,3,6,35,0,13,0,11,2,22,17,5,12,9,0,0,3
S01010482,All households,354,121,70,51,203,26,115,42,58,15,62,30,32,30,13,1,4,12
S01010482,Occupancy rating +2 or more,98,57,38,19,40,11,25,20,3,2,4,0,4,1,1,0,0,0
S01010482,Occupancy rating +1,123,45,21,24,70,9,43,17,20,6,18,6,12,8,3,0,2,3
S01010482,Occupancy rating 0,97,14,6,8,73,6,36,4,27,5,31,17,14,10,3,1,2,4
S01010482,Occupancy rating -1 or less,36,5,5,0,20,0,11,1,8,2,9,7,2,11,6,0,0,5
S01010483,All households,526,226,105,121,277,27,173,75,74,24,77,42,35,23,9,0,0,14
S01010483,Occupancy rating +2 or more,83,39,18,21,44,5,33,23,8,2,6,1,5,0,0,0,0,0
S01010483,Occupancy rating +1,239,133,63,70,103,16,68,44,16,8,19,11,8,3,0,0,0,3
S01010483,Occupancy rating 0,135,37,14,23,83,4,42,4,27,11,37,19,18,15,5,0,0,10
S01010483,Occupancy rating -1 or less,69,17,10,7,47,2,30,4,23,3,15,11,4,5,4,0,0,1
S01010484,All households,246,76,28,48,150,9,84,37,29,18,57,26,31,20,10,2,0,8
S01010484,Occupancy rating +2 or more,57,29,10,19,26,2,21,18,3,0,3,1,2,2,2,0,0,0
S01010484,Occupancy rating +1,101,37,12,25,58,6,35,19,5,11,17,8,9,6,1,1,0,4
S01010484,Occupancy rating 0,60,9,5,4,44,1,19,0,13,6,24,12,12,7,3,1,0,3
S01010484,Occupancy rating -1 or less,28,1,1,0,22,0,9,0,8,1,13,5,8,5,4,0,0,1
S01010485,All households,396,112,68,44,248,28,164,54,74,36,56,35,21,36,16,0,3,17
S01010485,Occupancy rating +2 or more,164,61,41,20,94,15,72,39,20,13,7,4,3,9,2,0,0,7
S01010485,Occupancy rating +1,105,32,18,14,68,9,43,13,21,9,16,11,5,5,0,0,1,4
S01010485,Occupancy rating 0,84,16,6,10,59,2,36,2,23,11,21,12,9,9,2,0,2,5
S01010485,Occupancy rating -1 or less,43,3,3,0,27,2,13,0,10,3,12,8,4,13,12,0,0,1
S01010486,All households,371,90,59,31,266,24,218,86,87,45,24,11,13,15,9,0,0,6
S01010486,Occupancy rating +2 or more,226,65,42,23,156,19,124,67,34,23,13,7,6,5,2,0,0,3
S01010486,Occupancy rating +1,75,19,13,6,54,3,46,13,21,12,5,2,3,2,1,0,0,1
S01010486,Occupancy rating 0,49,4,4,0,41,1,35,3,23,9,5,1,4,4,2,0,0,2
S01010486,Occupancy rating -1 or less,21,2,0,2,15,1,13,3,9,1,1,1,0,4,4,0,0,0
S01010487,All households,432,147,99,48,258,27,166,44,77,45,65,33,32,27,13,0,2,12
S01010487,Occupancy rating +2 or more,98,48,32,16,48,10,37,25,9,3,1,1,0,2,0,0,0,2
S01010487,Occupancy rating +1,173,82,57,25,83,12,54,17,21,16,17,8,9,8,3,0,1,4
S01010487,Occupancy rating 0,118,12,8,4,96,4,58,2,38,18,34,17,17,10,5,0,1,4
S01010487,Occupancy rating -1 or less,43,5,2,3,31,1,17,0,9,8,13,7,6,7,5,0,0,2
S01010488,All households,338,94,20,74,222,9,93,30,47,16,120,97,23,22,9,0,0,13
S01010488,Occupancy rating +2 or more,43,17,5,12,24,3,13,10,3,0,8,5,3,2,1,0,0,1
S01010488,Occupancy rating +1,111,61,12,49,48,5,28,16,7,5,15,12,3,2,0,0,0,2
S01010488,Occupancy rating 0,130,11,2,9,112,1,39,3,27,9,72,59,13,7,2,0,0,5
S01010488,Occupancy rating -1 or less,54,5,1,4,38,0,13,1,10,2,25,21,4,11,6,0,0,5
S01010489,All households,450,190,78,112,240,16,127,55,50,22,97,63,34,20,8,0,4,8
S01010489,Occupancy rating +2 or more,94,44,19,25,48,7,36,25,6,5,5,3,2,2,0,0,1,1
S01010489,Occupancy rating +1,147,79,28,51,64,8,39,28,5,6,17,8,9,4,1,0,0,3
S01010489,Occupancy rating 0,130,24,9,15,100,1,37,2,29,6,62,42,20,6,1,0,2,3
S01010489,Occupancy rating -1 or less,79,43,22,21,28,0,15,0,10,5,13,10,3,8,6,0,1,1
S01010490,All households,308,102,28,74,175,4,73,16,43,14,98,79,19,31,19,0,0,12
S01010490,Occupancy rating +2 or more,44,28,12,16,16,3,10,3,2,5,3,1,2,0,0,0,0,0
S01010490,Occupancy rating +1,91,52,11,41,38,0,23,10,10,3,15,11,4,1,0,0,0,1
S01010490,Occupancy rating 0,129,18,4,14,95,1,27,2,21,4,67,58,9,16,7,0,0,9
S01010490,Occupancy rating -1 or less,44,4,1,3,26,0,13,1,10,2,13,9,4,14,12,0,0,2
S01010491,All households,417,155,33,122,252,6,95,21,59,15,151,119,32,10,7,0,0,3
S01010491,Occupancy rating +2 or more,35,23,4,19,12,1,5,3,2,0,6,4,2,0,0,0,0,0
S01010491,Occupancy rating +1,120,70,15,55,50,4,27,11,10,6,19,12,7,0,0,0,0,0
S01010491,Occupancy rating 0,186,42,9,33,141,1,48,6,36,6,92,76,16,3,2,0,0,1
S01010491,Occupancy rating -1 or less,76,20,5,15,49,0,15,1,11,3,34,27,7,7,5,0,0,2
S01010492,All households,255,106,51,55,131,4,47,12,24,11,80,61,19,18,8,0,3,7
S01010492,Occupancy rating +2 or more,26,14,2,12,10,0,6,0,2,4,4,2,2,2,1,0,0,1
S01010492,Occupancy rating +1,47,20,6,14,26,3,8,6,1,1,15,13,2,1,1,0,0,0
S01010492,Occupancy rating 0,116,54,34,20,54,1,16,5,9,2,37,25,12,8,4,0,2,2
S01010492,Occupancy rating -1 or less,66,18,9,9,41,0,17,1,12,4,24,21,3,7,2,0,1,4
S01010493,All households,308,104,14,90,189,2,77,24,43,10,110,89,21,15,7,1,0,7
S01010493,Occupancy rating +2 or more,28,11,0,11,17,1,9,3,1,5,7,5,2,0,0,0,0,0
S01010493,Occupancy rating +1,105,63,9,54,39,0,24,14,9,1,15,10,5,3,2,0,0,1
S01010493,Occupancy rating 0,121,20,4,16,95,1,31,6,22,3,63,52,11,6,2,0,0,4
S01010493,Occupancy rating -1 or less,54,10,1,9,38,0,13,1,11,1,25,22,3,6,3,1,0,2
S01010494,All households,252,69,11,58,172,2,105,30,55,20,65,46,19,11,6,0,0,5
S01010494,Occupancy rating +2 or more,29,7,0,7,21,0,18,12,4,2,3,1,2,1,1,0,0,0
S01010494,Occupancy rating +1,76,36,8,28,36,1,29,14,9,6,6,5,1,4,1,0,0,3
S01010494,Occupancy rating 0,91,14,2,12,74,1,31,3,19,9,42,30,12,3,1,0,0,2
S01010494,Occupancy rating -1 or less,56,12,1,11,41,0,27,1,23,3,14,10,4,3,3,0,0,0
S01010495,All households,418,182,37,145,218,6,79,24,38,17,133,101,32,18,12,1,1,4
S01010495,Occupancy rating +2 or more,42,26,4,22,16,1,9,5,1,3,6,3,3,0,0,0,0,0
S01010495,Occupancy rating +1,133,84,17,67,49,4,19,12,2,5,26,18,8,0,0,0,0,0
S01010495,Occupancy rating 0,166,57,14,43,98,1,36,6,23,7,61,46,15,11,7,0,1,3
S01010495,Occupancy rating -1 or less,77,15,2,13,55,0,15,1,12,2,40,34,6,7,5,1,0,1
S01010496,All households,388,154,45,109,207,8,86,32,40,14,113,81,32,27,12,0,0,15
S01010496,Occupancy rating +2 or more,37,21,5,16,14,0,7,6,1,0,7,3,4,2,2,0,0,0
S01010496,Occupancy rating +1,101,58,23,35,41,5,21,12,7,2,15,9,6,2,0,0,0,2
S01010496,Occupancy rating 0,159,57,12,45,90,1,41,11,20,10,48,33,15,12,4,0,0,8
S01010496,Occupancy rating -1 or less,91,18,5,13,62,2,17,3,12,2,43,36,7,11,6,0,0,5
S01010497,All households,285,75,12,63,189,2,111,29,56,26,76,57,19,21,13,1,0,7
S01010497,Occupancy rating +2 or more,39,14,1,13,25,1,16,12,2,2,8,5,3,0,0,0,0,0
S01010497,Occupancy rating +1,70,16,1,15,50,1,32,13,13,6,17,10,7,4,3,0,0,1
S01010497,Occupancy rating 0,121,34,10,24,75,0,45,2,31,12,30,24,6,12,7,1,0,4
S01010497,Occupancy rating -1 or less,55,11,0,11,39,0,18,2,10,6,21,18,3,5,3,0,0,2
S01010498,All households,357,115,31,84,213,6,99,32,39,28,108,72,36,29,16,0,1,12
S01010498,Occupancy rating +2 or more,33,14,1,13,19,2,8,6,2,0,9,2,7,0,0,0,0,0
S01010498,Occupancy rating +1,101,52,13,39,46,2,31,14,9,8,13,8,5,3,0,0,0,3
S01010498,Occupancy rating 0,159,42,14,28,103,2,42,9,18,15,59,40,19,14,6,0,1,7
S01010498,Occupancy rating -1 or less,64,7,3,4,45,0,18,3,10,5,27,22,5,12,10,0,0,2
S01010499,All households,451,257,78,179,171,14,65,19,37,9,92,72,20,23,10,2,0,11
S01010499,Occupancy rating +2 or more,18,8,1,7,10,1,4,3,1,0,5,5,0,0,0,0,0,0
S01010499,Occupancy rating +1,115,82,27,55,30,9,12,7,2,3,9,7,2,3,3,0,0,0
S01010499,Occupancy rating 0,228,137,45,92,82,3,28,6,16,6,51,40,11,9,0,2,0,7
S01010499,Occupancy rating -1 or less,90,30,5,25,49,1,21,3,18,0,27,20,7,11,7,0,0,4
S01010500,All households,398,89,17,72,284,8,130,28,80,22,146,98,48,25,18,0,0,7
S01010500,Occupancy rating +2 or more,93,24,7,17,66,3,47,14,27,6,16,9,7,3,1,0,0,2
S01010500,Occupancy rating +1,98,33,5,28,60,2,31,12,13,6,27,14,13,5,3,0,0,2
S01010500,Occupancy rating 0,128,16,2,14,107,1,34,1,26,7,72,53,19,5,3,0,0,2
S01010500,Occupancy rating -1 or less,79,16,3,13,51,2,18,1,14,3,31,22,9,12,11,0,0,1
S01010501,All households,430,180,68,112,228,13,130,37,64,29,85,55,30,22,11,0,0,11
S01010501,Occupancy rating +2 or more,67,34,12,22,27,6,17,7,6,4,4,1,3,6,2,0,0,4
S01010501,Occupancy rating +1,139,52,13,39,83,4,60,27,19,14,19,10,9,4,1,0,0,3
S01010501,Occupancy rating 0,154,58,24,34,88,2,38,2,26,10,48,35,13,8,5,0,0,3
S01010501,Occupancy rating -1 or less,70,36,19,17,30,1,15,1,13,1,14,9,5,4,3,0,0,1
S01010502,All households,331,99,18,81,211,2,139,43,70,26,70,49,21,21,13,1,0,7
S01010502,Occupancy rating +2 or more,55,25,1,24,29,0,24,11,8,5,5,3,2,1,1,0,0,0
S01010502,Occupancy rating +1,100,38,9,29,58,1,45,20,18,7,12,6,6,4,2,0,0,2
S01010502,Occupancy rating 0,130,29,7,22,94,0,55,8,37,10,39,28,11,7,4,0,0,3
S01010502,Occupancy rating -1 or less,46,7,1,6,30,1,15,4,7,4,14,12,2,9,6,1,0,2
S01010503,All households,321,125,48,77,174,14,70,29,24,17,90,51,39,22,9,0,1,12
S01010503,Occupancy rating +2 or more,43,20,5,15,23,3,16,13,0,3,4,3,1,0,0,0,0,0
S01010503,Occupancy rating +1,128,82,36,46,41,6,18,12,3,3,17,8,9,5,0,0,0,5
S01010503,Occupancy rating 0,106,16,5,11,83,4,23,2,14,7,56,31,25,7,2,0,0,5
S01010503,Occupancy rating -1 or less,44,7,2,5,27,1,13,2,7,4,13,9,4,10,7,0,1,2
S01010504,All households,247,87,36,51,153,28,109,58,44,7,16,9,7,7,3,0,0,4
S01010504,Occupancy rating +2 or more,165,51,21,30,112,26,79,50,22,7,7,5,2,2,0,0,0,2
S01010504,Occupancy rating +1,43,25,11,14,18,1,13,4,9,0,4,2,2,0,0,0,0,0
S01010504,Occupancy rating 0,28,8,3,5,17,1,12,3,9,0,4,2,2,3,1,0,0,2
S01010504,Occupancy rating -1 or less,11,3,1,2,6,0,5,1,4,0,1,0,1,2,2,0,0,0
S01010505,All households,244,69,34,35,163,20,117,62,42,13,26,16,10,12,3,0,1,8
S01010505,Occupancy rating +2 or more,125,36,20,16,86,16,62,42,15,5,8,4,4,3,1,0,1,1
S01010505,Occupancy rating +1,78,23,12,11,50,4,37,17,16,4,9,7,2,5,0,0,0,5
S01010505,Occupancy rating 0,28,5,0,5,20,0,12,2,7,3,8,4,4,3,1,0,0,2
S01010505,Occupancy rating -1 or less,13,5,2,3,7,0,6,1,4,1,1,1,0,1,1,0,0,0
S01010506,All households,380,122,46,76,238,35,166,79,66,21,37,24,13,20,5,0,0,15
S01010506,Occupancy rating +2 or more,222,68,36,32,144,24,104,63,32,9,16,8,8,10,2,0,0,8
S01010506,Occupancy rating +1,81,32,6,26,47,6,31,10,15,6,10,7,3,2,1,0,0,1
S01010506,Occupancy rating 0,51,8,3,5,36,5,26,6,15,5,5,4,1,7,2,0,0,5
S01010506,Occupancy rating -1 or less,26,14,1,13,11,0,5,0,4,1,6,5,1,1,0,0,0,1
S01010507,All households,345,120,45,75,214,23,155,50,72,33,36,21,15,11,3,0,1,7
S01010507,Occupancy rating +2 or more,136,57,27,30,79,14,61,29,18,14,4,1,3,0,0,0,0,0
S01010507,Occupancy rating +1,106,44,13,31,59,8,45,19,18,8,6,3,3,3,0,0,0,3
S01010507,Occupancy rating 0,75,15,3,12,55,1,36,2,28,6,18,12,6,5,1,0,1,3
S01010507,Occupancy rating -1 or less,28,4,2,2,21,0,13,0,8,5,8,5,3,3,2,0,0,1
S01010508,All households,449,154,65,89,280,49,196,97,83,16,35,20,15,15,1,0,3,11
S01010508,Occupancy rating +2 or more,243,90,50,40,148,40,103,62,33,8,5,3,2,5,0,0,0,5
S01010508,Occupancy rating +1,118,37,12,25,77,7,55,27,22,6,15,5,10,4,1,0,2,1
S01010508,Occupancy rating 0,74,22,2,20,49,2,34,6,26,2,13,10,3,3,0,0,1,2
S01010508,Occupancy rating -1 or less,14,5,1,4,6,0,4,2,2,0,2,2,0,3,0,0,0,3
S01010509,All households,393,91,37,54,276,34,221,105,82,34,21,14,7,26,3,0,2,21
S01010509,Occupancy rating +2 or more,250,57,25,32,184,25,149,83,43,23,10,5,5,9,1,0,0,8
S01010509,Occupancy rating +1,83,25,10,15,55,7,45,17,21,7,3,3,0,3,0,0,0,3
S01010509,Occupancy rating 0,43,5,2,3,29,2,23,5,16,2,4,3,1,9,1,0,1,7
S01010509,Occupancy rating -1 or less,17,4,0,4,8,0,4,0,2,2,4,3,1,5,1,0,1,3
S01010510,All households,340,105,62,43,216,46,152,59,63,30,18,4,14,19,7,0,0,12
S01010510,Occupancy rating +2 or more,186,59,32,27,123,32,88,44,29,15,3,2,1,4,0,0,0,4
S01010510,Occupancy rating +1,80,22,15,7,54,7,41,14,18,9,6,1,5,4,1,0,0,3
S01010510,Occupancy rating 0,57,19,11,8,32,7,18,0,14,4,7,1,6,6,4,0,0,2
S01010510,Occupancy rating -1 or less,17,5,4,1,7,0,5,1,2,2,2,0,2,5,2,0,0,3
S01010511,All households,369,116,57,59,230,16,149,56,74,19,65,47,18,23,8,0,2,13
S01010511,Occupancy rating +2 or more,121,52,26,26,67,9,54,40,12,2,4,2,2,2,0,0,0,2
S01010511,Occupancy rating +1,98,26,13,13,66,3,42,12,18,12,21,13,8,6,1,0,0,5
S01010511,Occupancy rating 0,114,29,13,16,76,3,47,4,39,4,26,21,5,9,4,0,1,4
S01010511,Occupancy rating -1 or less,36,9,5,4,21,1,6,0,5,1,14,11,3,6,3,0,1,2
S01010512,All households,281,104,66,38,164,27,106,38,48,20,31,18,13,13,4,0,0,9
S01010512,Occupancy rating +2 or more,109,32,19,13,76,18,49,26,14,9,9,3,6,1,0,0,0,1
S01010512,Occupancy rating +1,83,34,20,14,44,8,30,11,12,7,6,2,4,5,3,0,0,2
S01010512,Occupancy rating 0,76,35,26,9,36,1,22,1,18,3,13,10,3,5,0,0,0,5
S01010512,Occupancy rating -1 or less,13,3,1,2,8,0,5,0,4,1,3,3,0,2,1,0,0,1
S01010513,All households,300,63,40,23,222,30,171,72,74,25,21,7,14,15,5,0,0,10
S01010513,Occupancy rating +2 or more,195,48,33,15,142,24,110,58,39,13,8,3,5,5,2,0,0,3
S01010513,Occupancy rating +1,64,11,7,4,51,6,40,10,20,10,5,0,5,2,1,0,0,1
S01010513,Occupancy rating 0,33,3,0,3,25,0,19,4,13,2,6,3,3,5,1,0,0,4
S01010513,Occupancy rating -1 or less,8,1,0,1,4,0,2,0,2,0,2,1,1,3,1,0,0,2
S01010514,All households,287,77,43,34,189,20,130,52,57,21,39,25,14,21,12,0,0,9
S01010514,Occupancy rating +2 or more,124,42,26,16,81,13,62,45,12,5,6,3,3,1,0,0,0,1
S01010514,Occupancy rating +1,91,27,16,11,59,5,38,6,20,12,16,10,6,5,1,0,0,4
S01010514,Occupancy rating 0,55,5,1,4,40,2,22,1,19,2,16,11,5,10,7,0,0,3
S01010514,Occupancy rating -1 or less,17,3,0,3,9,0,8,0,6,2,1,1,0,5,4,0,0,1
S01010515,All households,350,97,47,50,233,32,152,60,67,25,49,31,18,20,5,0,0,15
S01010515,Occupancy rating +2 or more,132,47,20,27,82,19,57,41,12,4,6,5,1,3,0,0,0,3
S01010515,Occupancy rating +1,112,32,15,17,77,11,47,14,20,13,19,9,10,3,0,0,0,3
S01010515,Occupancy rating 0,83,14,10,4,62,2,39,5,29,5,21,16,5,7,2,0,0,5
S01010515,Occupancy rating -1 or less,23,4,2,2,12,0,9,0,6,3,3,1,2,7,3,0,0,4
S01010516,All households,270,98,35,63,157,24,107,59,33,15,26,23,3,15,5,1,0,9
S01010516,Occupancy rating +2 or more,146,39,19,20,101,18,75,42,20,13,8,5,3,6,3,0,0,3
S01010516,Occupancy rating +1,52,21,8,13,28,4,19,12,6,1,5,5,0,3,0,0,0,3
S01010516,Occupancy rating 0,56,34,7,27,19,2,8,4,3,1,9,9,0,3,1,1,0,1
S01010516,Occupancy rating -1 or less,16,4,1,3,9,0,5,1,4,0,4,4,0,3,1,0,0,2
S01010517,All households,362,99,32,67,224,18,147,63,67,17,59,40,19,39,9,2,1,27
S01010517,Occupancy rating +2 or more,145,42,23,19,94,13,73,39,26,8,8,4,4,9,2,0,0,7
S01010517,Occupancy rating +1,105,37,6,31,60,3,42,22,14,6,15,7,8,8,2,0,0,6
S01010517,Occupancy rating 0,76,12,2,10,51,1,26,2,21,3,24,18,6,13,1,1,0,11
S01010517,Occupancy rating -1 or less,36,8,1,7,19,1,6,0,6,0,12,11,1,9,4,1,1,3
S01010518,All households,293,88,27,61,167,17,122,59,49,14,28,19,9,38,6,5,1,26
S01010518,Occupancy rating +2 or more,155,52,17,35,93,16,72,52,15,5,5,2,3,10,2,1,0,7
S01010518,Occupancy rating +1,65,19,7,12,33,1,23,5,15,3,9,4,5,13,0,2,1,10
S01010518,Occupancy rating 0,48,6,1,5,33,0,23,0,17,6,10,9,1,9,1,2,0,6
S01010518,Occupancy rating -1 or less,25,11,2,9,8,0,4,2,2,0,4,4,0,6,3,0,0,3
S01010519,All households,282,50,16,34,205,26,135,52,64,19,44,31,13,27,9,1,0,17
S01010519,Occupancy rating +2 or more,120,35,11,24,81,25,53,36,12,5,3,1,2,4,0,0,0,4
S01010519,Occupancy rating +1,66,10,4,6,47,1,36,11,20,5,10,6,4,9,1,0,0,8
S01010519,Occupancy rating 0,71,5,1,4,58,0,32,4,20,8,26,21,5,8,3,1,0,4
S01010519,Occupancy rating -1 or less,25,0,0,0,19,0,14,1,12,1,5,3,2,6,5,0,0,1
S01010520,All households,410,127,70,57,263,37,187,72,95,20,39,18,21,20,9,0,0,11
S01010520,Occupancy rating +2 or more,172,63,37,26,104,26,72,43,23,6,6,2,4,5,2,0,0,3
S01010520,Occupancy rating +1,127,46,25,21,77,9,58,23,30,5,10,2,8,4,1,0,0,3
S01010520,Occupancy rating 0,87,12,6,6,68,2,49,3,40,6,17,11,6,7,3,0,0,4
S01010520,Occupancy rating -1 or less,24,6,2,4,14,0,8,3,2,3,6,3,3,4,3,0,0,1
S01010521,All households,339,112,53,59,203,18,141,60,66,15,44,28,16,24,10,0,0,14
S01010521,Occupancy rating +2 or more,118,42,21,21,73,13,59,30,21,8,1,0,1,3,2,0,0,1
S01010521,Occupancy rating +1,122,51,24,27,66,5,48,26,17,5,13,6,7,5,1,0,0,4
S01010521,Occupancy rating 0,70,14,6,8,49,0,24,2,20,2,25,19,6,7,2,0,0,5
S01010521,Occupancy rating -1 or less,29,5,2,3,15,0,10,2,8,0,5,3,2,9,5,0,0,4
S01010522,All households,283,129,51,78,128,11,97,38,51,8,20,14,6,26,7,4,1,14
S01010522,Occupancy rating +2 or more,58,21,5,16,34,4,28,14,12,2,2,0,2,3,0,0,1,2
S01010522,Occupancy rating +1,81,41,16,25,38,4,32,16,13,3,2,2,0,2,0,1,0,1
S01010522,Occupancy rating 0,109,55,27,28,43,3,30,7,20,3,10,7,3,11,1,3,0,7
S01010522,Occupancy rating -1 or less,35,12,3,9,13,0,7,1,6,0,6,5,1,10,6,0,0,4
S01010523,All households,258,63,20,43,177,14,103,30,65,8,60,48,12,18,8,0,0,10
S01010523,Occupancy rating +2 or more,83,26,12,14,54,13,33,20,10,3,8,6,2,3,0,0,0,3
S01010523,Occupancy rating +1,89,29,6,23,58,0,30,9,18,3,28,24,4,2,1,0,0,1
S01010523,Occupancy rating 0,66,7,2,5,52,1,30,0,28,2,21,17,4,7,4,0,0,3
S01010523,Occupancy rating -1 or less,20,1,0,1,13,0,10,1,9,0,3,1,2,6,3,0,0,3
S01010524,All households,234,63,26,37,157,26,124,78,30,16,7,3,4,14,4,0,1,9
S01010524,Occupancy rating +2 or more,170,40,17,23,122,25,93,60,20,13,4,0,4,8,2,0,1,5
S01010524,Occupancy rating +1,37,13,5,8,21,1,19,14,3,2,1,1,0,3,1,0,0,2
S01010524,Occupancy rating 0,16,6,2,4,10,0,8,2,5,1,2,2,0,0,0,0,0,0
S01010524,Occupancy rating -1 or less,11,4,2,2,4,0,4,2,2,0,0,0,0,3,1,0,0,2
S01010525,All households,259,67,31,36,176,44,125,49,57,19,7,3,4,16,6,0,2,8
S01010525,Occupancy rating +2 or more,187,48,20,28,132,43,87,44,35,8,2,0,2,7,3,0,1,3
S01010525,Occupancy rating +1,44,15,11,4,28,1,23,3,12,8,4,2,2,1,1,0,0,0
S01010525,Occupancy rating 0,20,4,0,4,12,0,11,1,7,3,1,1,0,4,1,0,1,2
S01010525,Occupancy rating -1 or less,8,0,0,0,4,0,4,1,3,0,0,0,0,4,1,0,0,3
S01010526,All households,364,129,62,67,210,22,163,80,67,16,25,12,13,25,9,0,2,14
S01010526,Occupancy rating +2 or more,143,34,13,21,103,12,87,59,24,4,4,4,0,6,1,0,0,5
S01010526,Occupancy rating +1,119,60,32,28,54,7,37,16,16,5,10,4,6,5,3,0,0,2
S01010526,Occupancy rating 0,82,32,15,17,41,2,32,3,24,5,7,4,3,9,2,0,2,5
S01010526,Occupancy rating -1 or less,20,3,2,1,12,1,7,2,3,2,4,0,4,5,3,0,0,2
S01010527,All households,455,193,88,105,248,28,158,88,56,14,62,39,23,14,4,0,2,8
S01010527,Occupancy rating +2 or more,176,69,38,31,104,19,80,61,15,4,5,4,1,3,0,0,2,1
S01010527,Occupancy rating +1,164,92,37,55,66,2,48,23,18,7,16,8,8,6,2,0,0,4
S01010527,Occupancy rating 0,93,27,12,15,63,7,27,4,21,2,29,20,9,3,1,0,0,2
S01010527,Occupancy rating -1 or less,22,5,1,4,15,0,3,0,2,1,12,7,5,2,1,0,0,1
S01010528,All households,265,80,34,46,165,20,130,62,55,13,15,5,10,20,4,4,1,11
S01010528,Occupancy rating +2 or more,178,61,27,34,108,17,88,56,24,8,3,2,1,9,3,0,1,5
S01010528,Occupancy rating +1,42,6,3,3,28,3,18,2,13,3,7,0,7,8,0,4,0,4
S01010528,Occupancy rating 0,27,4,1,3,22,0,17,4,11,2,5,3,2,1,0,0,0,1
S01010528,Occupancy rating -1 or less,18,9,3,6,7,0,7,0,7,0,0,0,0,2,1,0,0,1
S01010529,All households,283,65,28,37,194,34,140,62,58,20,20,12,8,24,7,0,3,14
S01010529,Occupancy rating +2 or more,183,41,17,24,132,28,98,53,33,12,6,3,3,10,2,0,1,7
S01010529,Occupancy rating +1,56,17,8,9,34,5,26,7,14,5,3,1,2,5,2,0,2,1
S01010529,Occupancy rating 0,34,5,1,4,23,0,13,0,10,3,10,7,3,6,3,0,0,3
S01010529,Occupancy rating -1 or less,10,2,2,0,5,1,3,2,1,0,1,1,0,3,0,0,0,3
S01010530,All households,278,70,37,33,195,26,151,83,54,14,18,10,8,13,3,0,2,8
S01010530,Occupancy rating +2 or more,192,48,27,21,136,23,107,67,32,8,6,3,3,8,1,0,2,5
S01010530,Occupancy rating +1,51,15,7,8,33,2,26,12,10,4,5,2,3,3,2,0,0,1
S01010530,Occupancy rating 0,25,5,1,4,18,1,13,3,8,2,4,3,1,2,0,0,0,2
S01010530,Occupancy rating -1 or less,10,2,2,0,8,0,5,1,4,0,3,2,1,0,0,0,0,0
S01010531,All households,496,170,89,81,312,58,221,104,84,33,33,14,19,14,5,0,0,9
S01010531,Occupancy rating +2 or more,277,81,43,38,189,44,140,80,43,17,5,1,4,7,3,0,0,4
S01010531,Occupancy rating +1,108,45,18,27,61,10,43,19,15,9,8,4,4,2,0,0,0,2
S01010531,Occupancy rating 0,82,36,25,11,43,2,26,3,17,6,15,8,7,3,0,0,0,3
S01010531,Occupancy rating -1 or less,29,8,3,5,19,2,12,2,9,1,5,1,4,2,2,0,0,0
S01010532,All households,245,72,30,42,164,35,118,52,47,19,11,6,5,9,1,0,0,8
S01010532,Occupancy rating +2 or more,178,53,23,30,122,29,88,48,29,11,5,1,4,3,0,0,0,3
S01010532,Occupancy rating +1,32,5,2,3,24,4,19,3,11,5,1,1,0,3,0,0,0,3
S01010532,Occupancy rating 0,21,9,4,5,11,1,7,0,4,3,3,3,0,1,0,0,0,1
S01010532,Occupancy rating -1 or less,14,5,1,4,7,1,4,1,3,0,2,1,1,2,1,0,0,1
S01010533,All households,272,111,65,46,148,29,106,54,35,17,13,7,6,13,3,0,1,9
S01010533,Occupancy rating +2 or more,141,41,25,16,93,20,67,37,21,9,6,2,4,7,2,0,0,5
S01010533,Occupancy rating +1,55,25,18,7,27,6,21,8,7,6,0,0,0,3,0,0,1,2
S01010533,Occupancy rating 0,64,40,20,20,23,3,16,8,7,1,4,2,2,1,1,0,0,0
S01010533,Occupancy rating -1 or less,12,5,2,3,5,0,2,1,0,1,3,3,0,2,0,0,0,2
S01010534,All households,374,101,47,54,255,28,183,78,80,25,44,31,13,18,10,0,2,6
S01010534,Occupancy rating +2 or more,189,48,29,19,138,21,111,60,34,17,6,3,3,3,1,0,1,1
S01010534,Occupancy rating +1,87,35,9,26,50,7,32,13,15,4,11,7,4,2,1,0,0,1
S01010534,Occupancy rating 0,75,18,9,9,52,0,29,3,24,2,23,19,4,5,3,0,1,1
S01010534,Occupancy rating -1 or less,23,0,0,0,15,0,11,2,7,2,4,2,2,8,5,0,0,3
S01010535,All households,305,85,36,49,208,36,145,70,64,11,27,19,8,12,5,0,1,6
S01010535,Occupancy rating +2 or more,210,56,27,29,144,30,104,56,42,6,10,7,3,10,4,0,1,5
S01010535,Occupancy rating +1,58,18,6,12,39,5,28,9,17,2,6,4,2,1,1,0,0,0
S01010535,Occupancy rating 0,23,6,1,5,16,0,11,5,3,3,5,3,2,1,0,0,0,1
S01010535,Occupancy rating -1 or less,14,5,2,3,9,1,2,0,2,0,6,5,1,0,0,0,0,0
S01010536,All households,397,150,75,75,227,29,162,65,75,22,36,19,17,20,7,0,0,13
S01010536,Occupancy rating +2 or more,109,40,19,21,69,12,55,36,13,6,2,0,2,0,0,0,0,0
S01010536,Occupancy rating +1,101,30,13,17,65,10,48,20,21,7,7,2,5,6,1,0,0,5
S01010536,Occupancy rating 0,154,75,41,34,70,5,44,6,32,6,21,13,8,9,3,0,0,6
S01010536,Occupancy rating -1 or less,33,5,2,3,23,2,15,3,9,3,6,4,2,5,3,0,0,2
S01010537,All households,330,126,36,90,177,24,117,56,46,15,36,23,13,27,3,0,2,22
S01010537,Occupancy rating +2 or more,123,43,13,30,75,14,56,34,17,5,5,1,4,5,0,0,1,4
S01010537,Occupancy rating +1,95,47,16,31,46,6,29,15,9,5,11,5,6,2,1,0,1,0
S01010537,Occupancy rating 0,89,28,5,23,47,3,25,6,14,5,19,16,3,14,1,0,0,13
S01010537,Occupancy rating -1 or less,23,8,2,6,9,1,7,1,6,0,1,1,0,6,1,0,0,5
S01010538,All households,337,85,11,74,233,11,169,73,92,4,53,47,6,19,5,0,0,14
S01010538,Occupancy rating +2 or more,123,34,8,26,84,9,69,47,20,2,6,4,2,5,1,0,0,4
S01010538,Occupancy rating +1,88,29,1,28,57,2,46,17,29,0,9,8,1,2,0,0,0,2
S01010538,Occupancy rating 0,99,20,2,18,74,0,42,8,32,2,32,29,3,5,0,0,0,5
S01010538,Occupancy rating -1 or less,27,2,0,2,18,0,12,1,11,0,6,6,0,7,4,0,0,3
S01010539,All households,496,172,46,126,282,28,223,137,68,18,31,23,8,42,11,0,1,30
S01010539,Occupancy rating +2 or more,199,60,21,39,130,20,103,66,29,8,7,4,3,9,2,0,0,7
S01010539,Occupancy rating +1,139,51,13,38,75,6,62,43,13,6,7,5,2,13,3,0,1,9
S01010539,Occupancy rating 0,123,50,8,42,61,2,46,20,23,3,13,10,3,12,3,0,0,9
S01010539,Occupancy rating -1 or less,35,11,4,7,16,0,12,8,3,1,4,4,0,8,3,0,0,5
S01010540,All households,298,97,47,50,189,33,134,77,43,14,22,18,4,12,4,0,0,8
S01010540,Occupancy rating +2 or more,178,55,35,20,119,26,87,62,19,6,6,4,2,4,3,0,0,1
S01010540,Occupancy rating +1,74,29,8,21,40,7,28,12,11,5,5,3,2,5,0,0,0,5
S01010540,Occupancy rating 0,36,11,4,7,22,0,16,3,10,3,6,6,0,3,1,0,0,2
S01010540,Occupancy rating -1 or less,10,2,0,2,8,0,3,0,3,0,5,5,0,0,0,0,0,0
S01010541,All households,362,91,29,62,257,42,184,94,65,25,31,19,12,14,5,0,0,9
S01010541,Occupancy rating +2 or more,218,50,18,32,164,33,121,71,35,15,10,5,5,4,1,0,0,3
S01010541,Occupancy rating +1,72,24,7,17,45,4,36,18,13,5,5,2,3,3,1,0,0,2
S01010541,Occupancy rating 0,59,14,2,12,42,5,23,4,14,5,14,10,4,3,2,0,0,1
S01010541,Occupancy rating -1 or less,13,3,2,1,6,0,4,1,3,0,2,2,0,4,1,0,0,3
S01010542,All households,388,107,60,47,269,36,200,109,70,21,33,18,15,12,3,0,1,8
S01010542,Occupancy rating +2 or more,223,55,31,24,164,30,125,78,31,16,9,5,4,4,2,0,0,2
S01010542,Occupancy rating +1,84,33,19,14,49,4,38,27,10,1,7,2,5,2,0,0,0,2
S01010542,Occupancy rating 0,58,16,9,7,40,2,24,3,18,3,14,9,5,2,0,0,0,2
S01010542,Occupancy rating -1 or less,23,3,1,2,16,0,13,1,11,1,3,2,1,4,1,0,1,2
S01010543,All households,255,62,30,32,178,26,138,71,47,20,14,6,8,15,5,0,3,7
S01010543,Occupancy rating +2 or more,184,40,25,15,137,23,110,66,29,15,4,3,1,7,2,0,1,4
S01010543,Occupancy rating +1,43,20,5,15,20,3,14,2,9,3,3,0,3,3,0,0,2,1
S01010543,Occupancy rating 0,20,2,0,2,16,0,9,2,6,1,7,3,4,2,1,0,0,1
S01010543,Occupancy rating -1 or less,8,0,0,0,5,0,5,1,3,1,0,0,0,3,2,0,0,1
S01010544,All households,370,110,60,50,250,30,178,72,77,29,42,27,15,10,5,0,2,3
S01010544,Occupancy rating +2 or more,189,57,33,24,129,19,102,60,26,16,8,8,0,3,1,0,2,0
S01010544,Occupancy rating +1,103,42,22,20,58,10,39,10,21,8,9,5,4,3,1,0,0,2
S01010544,Occupancy rating 0,61,11,5,6,48,1,25,2,21,2,22,12,10,2,1,0,0,1
S01010544,Occupancy rating -1 or less,17,0,0,0,15,0,12,0,9,3,3,2,1,2,2,0,0,0
S01010545,All households,344,139,73,66,195,32,134,63,59,12,29,21,8,10,5,0,0,5
S01010545,Occupancy rating +2 or more,170,54,33,21,111,23,84,42,34,8,4,3,1,5,4,0,0,1
S01010545,Occupancy rating +1,80,40,15,25,38,5,28,16,9,3,5,2,3,2,0,0,0,2
S01010545,Occupancy rating 0,68,37,22,15,31,4,15,5,10,0,12,10,2,0,0,0,0,0
S01010545,Occupancy rating -1 or less,26,8,3,5,15,0,7,0,6,1,8,6,2,3,1,0,0,2
S01010546,All households,369,146,78,68,211,38,143,77,51,15,30,21,9,12,1,0,0,11
S01010546,Occupancy rating +2 or more,181,60,39,21,118,28,84,53,23,8,6,4,2,3,0,0,0,3
S01010546,Occupancy rating +1,74,36,14,22,37,6,26,14,6,6,5,3,2,1,0,0,0,1
S01010546,Occupancy rating 0,87,36,24,12,46,3,27,8,18,1,16,12,4,5,1,0,0,4
S01010546,Occupancy rating -1 or less,27,14,1,13,10,1,6,2,4,0,3,2,1,3,0,0,0,3
S01010547,All households,313,79,37,42,221,39,164,74,67,23,18,13,5,13,3,0,1,9
S01010547,Occupancy rating +2 or more,218,52,27,25,158,33,118,65,37,16,7,6,1,8,1,0,1,6
S01010547,Occupancy rating +1,52,17,7,10,32,5,23,5,14,4,4,2,2,3,1,0,0,2
S01010547,Occupancy rating 0,32,7,2,5,25,1,19,3,13,3,5,4,1,0,0,0,0,0
S01010547,Occupancy rating -1 or less,11,3,1,2,6,0,4,1,3,0,2,1,1,2,1,0,0,1
S01010548,All households,299,74,48,26,212,62,136,69,50,17,14,6,8,13,6,0,0,7
S01010548,Occupancy rating +2 or more,213,50,33,17,154,53,96,55,31,10,5,2,3,9,3,0,0,6
S01010548,Occupancy rating +1,63,23,15,8,39,6,28,12,12,4,5,2,3,1,1,0,0,0
S01010548,Occupancy rating 0,17,1,0,1,15,1,12,2,7,3,2,2,0,1,0,0,0,1
S01010548,Occupancy rating -1 or less,6,0,0,0,4,2,0,0,0,0,2,0,2,2,2,0,0,0
S01010549,All households,366,61,26,35,287,35,230,100,119,11,22,18,4,18,3,0,2,13
S01010549,Occupancy rating +2 or more,227,28,12,16,195,23,164,82,75,7,8,5,3,4,1,0,1,2
S01010549,Occupancy rating +1,94,24,9,15,60,11,44,13,30,1,5,5,0,10,1,0,0,9
S01010549,Occupancy rating 0,42,8,4,4,32,1,22,5,14,3,9,8,1,2,0,0,1,1
S01010549,Occupancy rating -1 or less,3,1,1,0,0,0,0,0,0,0,0,0,0,2,1,0,0,1
S01010550,All households,236,72,38,34,156,21,109,45,51,13,26,14,12,8,1,0,0,7
S01010550,Occupancy rating +2 or more,120,35,20,15,81,15,59,31,24,4,7,2,5,4,1,0,0,3
S01010550,Occupancy rating +1,63,22,9,13,39,6,28,12,11,5,5,2,3,2,0,0,0,2
S01010550,Occupancy rating 0,41,14,8,6,25,0,16,1,13,2,9,6,3,2,0,0,0,2
S01010550,Occupancy rating -1 or less,12,1,1,0,11,0,6,1,3,2,5,4,1,0,0,0,0,0
S01010551,All households,267,53,14,39,206,18,159,68,71,20,29,24,5,8,5,0,1,2
S01010551,Occupancy rating +2 or more,198,41,12,29,152,16,123,62,49,12,13,10,3,5,2,0,1,2
S01010551,Occupancy rating +1,39,11,2,9,26,2,22,4,13,5,2,2,0,2,2,0,0,0
S01010551,Occupancy rating 0,21,0,0,0,21,0,11,2,7,2,10,9,1,0,0,0,0,0
S01010551,Occupancy rating -1 or less,9,1,0,1,7,0,3,0,2,1,4,3,1,1,1,0,0,0
S01010552,All households,334,88,31,57,234,29,171,83,70,18,34,21,13,12,5,0,0,7
S01010552,Occupancy rating +2 or more,226,56,24,32,161,23,119,73,37,9,19,10,9,9,4,0,0,5
S01010552,Occupancy rating +1,54,17,5,12,35,6,25,8,10,7,4,4,0,2,1,0,0,1
S01010552,Occupancy rating 0,41,11,1,10,30,0,21,1,18,2,9,5,4,0,0,0,0,0
S01010552,Occupancy rating -1 or less,13,4,1,3,8,0,6,1,5,0,2,2,0,1,0,0,0,1
S01010553,All households,261,55,14,41,198,22,155,87,53,15,21,11,10,8,4,0,0,4
S01010553,Occupancy rating +2 or more,200,45,9,36,153,19,124,74,40,10,10,5,5,2,2,0,0,0
S01010553,Occupancy rating +1,41,8,4,4,30,3,20,10,7,3,7,4,3,3,1,0,0,2
S01010553,Occupancy rating 0,17,2,1,1,13,0,9,3,5,1,4,2,2,2,0,0,0,2
S01010553,Occupancy rating -1 or less,3,0,0,0,2,0,2,0,1,1,0,0,0,1,1,0,0,0
S01010554,All households,396,176,84,92,196,21,133,70,53,10,42,30,12,24,9,0,0,15
S01010554,Occupancy rating +2 or more,157,74,44,30,79,16,56,32,20,4,7,3,4,4,1,0,0,3
S01010554,Occupancy rating +1,127,64,27,37,56,4,43,27,14,2,9,4,5,7,4,0,0,3
S01010554,Occupancy rating 0,74,26,10,16,39,1,22,8,10,4,16,13,3,9,1,0,0,8
S01010554,Occupancy rating -1 or less,38,12,3,9,22,0,12,3,9,0,10,10,0,4,3,0,0,1
S01010555,All households,450,173,62,111,243,23,171,96,65,10,49,34,15,34,11,0,0,23
S01010555,Occupancy rating +2 or more,169,60,26,34,98,17,72,43,25,4,9,3,6,11,5,0,0,6
S01010555,Occupancy rating +1,126,52,17,35,66,4,52,35,15,2,10,8,2,8,2,0,0,6
S01010555,Occupancy rating 0,95,41,12,29,44,1,27,11,12,4,16,10,6,10,2,0,0,8
S01010555,Occupancy rating -1 or less,60,20,7,13,35,1,20,7,13,0,14,13,1,5,2,0,0,3
S01010556,All households,410,159,93,66,241,19,153,53,75,25,69,47,22,10,6,0,0,4
S01010556,Occupancy rating +2 or more,113,36,16,20,74,8,54,31,16,7,12,5,7,3,3,0,0,0
S01010556,Occupancy rating +1,99,42,19,23,57,7,41,15,15,11,9,7,2,0,0,0,0,0
S01010556,Occupancy rating 0,152,56,35,21,92,4,50,6,39,5,38,26,12,4,1,0,0,3
S01010556,Occupancy rating -1 or less,46,25,23,2,18,0,8,1,5,2,10,9,1,3,2,0,0,1
S01010557,All households,278,82,55,27,183,30,109,38,51,20,44,29,15,13,7,0,1,5
S01010557,Occupancy rating +2 or more,110,26,19,7,81,23,51,24,18,9,7,4,3,3,2,0,0,1
S01010557,Occupancy rating +1,83,37,23,14,45,7,30,11,15,4,8,3,5,1,1,0,0,0
S01010557,Occupancy rating 0,65,14,8,6,47,0,23,2,15,6,24,17,7,4,1,0,1,2
S01010557,Occupancy rating -1 or less,20,5,5,0,10,0,5,1,3,1,5,5,0,5,3,0,0,2
S01010558,All households,385,134,68,66,230,64,136,71,54,11,30,23,7,21,6,0,3,12
S01010558,Occupancy rating +2 or more,191,56,35,21,131,46,83,55,21,7,2,1,1,4,1,0,1,2
S01010558,Occupancy rating +1,103,54,22,32,43,14,28,13,14,1,1,1,0,6,0,0,1,5
S01010558,Occupancy rating 0,72,23,10,13,40,4,19,2,15,2,17,14,3,9,3,0,1,5
S01010558,Occupancy rating -1 or less,19,1,1,0,16,0,6,1,4,1,10,7,3,2,2,0,0,0
S01010559,All households,351,126,91,35,220,51,150,75,56,19,19,11,8,5,2,0,2,1
S01010559,Occupancy rating +2 or more,245,60,40,20,180,43,125,65,44,16,12,7,5,5,2,0,2,1
S01010559,Occupancy rating +1,42,19,12,7,23,4,18,8,9,1,1,0,1,0,0,0,0,0
S01010559,Occupancy rating 0,53,40,33,7,13,3,7,2,3,2,3,2,1,0,0,0,0,0
S01010559,Occupancy rating -1 or less,11,7,6,1,4,1,0,0,0,0,3,2,1,0,0,0,0,0
S01010560,All households,291,79,42,37,200,53,123,53,44,26,24,12,12,12,5,0,0,7
S01010560,Occupancy rating +2 or more,204,46,26,20,150,46,92,44,28,20,12,7,5,8,3,0,0,5
S01010560,Occupancy rating +1,56,23,10,13,33,5,22,9,10,3,6,1,5,0,0,0,0,0
S01010560,Occupancy rating 0,23,8,5,3,13,1,7,0,4,3,5,3,2,2,1,0,0,1
S01010560,Occupancy rating -1 or less,8,2,1,1,4,1,2,0,2,0,1,1,0,2,1,0,0,1
S01010561,All households,301,77,54,23,216,39,161,72,68,21,16,8,8,8,5,0,0,3
S01010561,Occupancy rating +2 or more,222,58,46,12,159,36,116,58,42,16,7,4,3,5,2,0,0,3
S01010561,Occupancy rating +1,46,11,7,4,35,3,27,12,11,4,5,1,4,0,0,0,0,0
S01010561,Occupancy rating 0,29,8,1,7,21,0,17,2,14,1,4,3,1,0,0,0,0,0
S01010561,Occupancy rating -1 or less,4,0,0,0,1,0,1,0,1,0,0,0,0,3,3,0,0,0
S01010562,All households,314,84,47,37,218,37,159,64,60,35,22,10,12,12,7,0,2,3
S01010562,Occupancy rating +2 or more,175,55,28,27,118,27,88,53,20,15,3,2,1,2,1,0,0,1
S01010562,Occupancy rating +1,95,26,17,9,65,10,46,10,22,14,9,5,4,4,2,0,1,1
S01010562,Occupancy rating 0,36,2,1,1,30,0,22,1,16,5,8,3,5,4,2,0,1,1
S01010562,Occupancy rating -1 or less,8,1,1,0,5,0,3,0,2,1,2,0,2,2,2,0,0,0
S01010563,All households,211,63,30,33,134,8,100,38,39,23,26,15,11,14,6,0,1,7
S01010563,Occupancy rating +2 or more,88,33,14,19,50,4,41,29,8,4,5,5,0,5,2,0,0,3
S01010563,Occupancy rating +1,52,15,11,4,33,4,21,5,10,6,8,1,7,4,1,0,1,2
S01010563,Occupancy rating 0,57,15,5,10,38,0,30,3,15,12,8,4,4,4,2,0,0,2
S01010563,Occupancy rating -1 or less,14,0,0,0,13,0,8,1,6,1,5,5,0,1,1,0,0,0
S01010564,All households,269,127,45,82,134,19,79,43,20,16,36,16,20,8,1,0,2,5
S01010564,Occupancy rating +2 or more,68,32,18,14,36,5,30,19,7,4,1,1,0,0,0,0,0,0
S01010564,Occupancy rating +1,68,23,9,14,43,10,25,15,6,4,8,0,8,2,0,0,1,1
S01010564,Occupancy rating 0,110,64,16,48,42,2,19,7,5,7,21,11,10,4,0,0,0,4
S01010564,Occupancy rating -1 or less,23,8,2,6,13,2,5,2,2,1,6,4,2,2,1,0,1,0
S01010565,All households,276,79,43,36,183,27,128,47,61,20,28,9,19,14,4,0,1,9
S01010565,Occupancy rating +2 or more,135,42,25,17,90,16,68,37,22,9,6,1,5,3,1,0,1,1
S01010565,Occupancy rating +1,79,24,12,12,51,9,28,7,17,4,14,5,9,4,1,0,0,3
S01010565,Occupancy rating 0,48,12,6,6,34,2,26,3,17,6,6,2,4,2,0,0,0,2
S01010565,Occupancy rating -1 or less,14,1,0,1,8,0,6,0,5,1,2,1,1,5,2,0,0,3
S01010566,All households,453,119,54,65,316,38,248,109,107,32,30,20,10,18,4,3,1,10
S01010566,Occupancy rating +2 or more,329,87,44,43,232,30,191,97,73,21,11,6,5,10,2,0,1,7
S01010566,Occupancy rating +1,69,20,6,14,47,7,33,12,17,4,7,3,4,2,0,1,0,1
S01010566,Occupancy rating 0,39,8,3,5,28,1,18,0,12,6,9,9,0,3,1,2,0,0
S01010566,Occupancy rating -1 or less,16,4,1,3,9,0,6,0,5,1,3,2,1,3,1,0,0,2
S01010567,All households,379,80,26,54,283,25,237,97,103,37,21,11,10,16,7,0,0,9
S01010567,Occupancy rating +2 or more,305,60,24,36,233,23,198,85,83,30,12,6,6,12,4,0,0,8
S01010567,Occupancy rating +1,39,10,1,9,27,0,24,10,8,6,3,2,1,2,1,0,0,1
S01010567,Occupancy rating 0,19,5,1,4,14,2,8,1,7,0,4,1,3,0,0,0,0,0
S01010567,Occupancy rating -1 or less,16,5,0,5,9,0,7,1,5,1,2,2,0,2,2,0,0,0
S01010568,All households,391,75,27,48,297,28,227,99,98,30,42,29,13,19,9,0,3,7
S01010568,Occupancy rating +2 or more,243,44,12,32,191,23,158,88,50,20,10,6,4,8,3,0,1,4
S01010568,Occupancy rating +1,79,18,7,11,56,5,36,9,21,6,15,8,7,5,1,0,1,3
S01010568,Occupancy rating 0,56,11,8,3,41,0,28,1,24,3,13,12,1,4,3,0,1,0
S01010568,Occupancy rating -1 or less,13,2,0,2,9,0,5,1,3,1,4,3,1,2,2,0,0,0
S01010569,All households,295,64,21,43,216,24,172,80,64,28,20,12,8,15,4,0,1,10
S01010569,Occupancy rating +2 or more,205,40,14,26,160,20,130,73,36,21,10,8,2,5,1,0,0,4
S01010569,Occupancy rating +1,54,14,6,8,35,4,25,4,16,5,6,2,4,5,3,0,1,1
S01010569,Occupancy rating 0,29,7,1,6,17,0,15,3,10,2,2,1,1,5,0,0,0,5
S01010569,Occupancy rating -1 or less,7,3,0,3,4,0,2,0,2,0,2,1,1,0,0,0,0,0
S01010570,All households,467,142,72,70,302,28,193,83,82,28,81,49,32,23,14,0,1,8
S01010570,Occupancy rating +2 or more,197,73,35,38,119,17,92,64,21,7,10,6,4,5,2,0,0,3
S01010570,Occupancy rating +1,119,32,19,13,83,7,52,15,30,7,24,12,12,4,1,0,0,3
S01010570,Occupancy rating 0,122,29,16,13,84,4,39,4,25,10,41,27,14,9,7,0,1,1
S01010570,Occupancy rating -1 or less,29,8,2,6,16,0,10,0,6,4,6,4,2,5,4,0,0,1
S01010571,All households,398,173,41,132,210,16,162,88,57,17,32,20,12,15,4,0,0,11
S01010571,Occupancy rating +2 or more,109,34,16,18,72,8,57,33,14,10,7,3,4,3,0,0,0,3
S01010571,Occupancy rating +1,142,73,14,59,66,7,54,30,19,5,5,3,2,3,1,0,0,2
S01010571,Occupancy rating 0,121,54,9,45,63,1,46,23,22,1,16,12,4,4,1,0,0,3
S01010571,Occupancy rating -1 or less,26,12,2,10,9,0,5,2,2,1,4,2,2,5,2,0,0,3
S01010572,All households,336,110,30,80,190,11,129,45,60,24,50,32,18,36,12,0,1,23
S01010572,Occupancy rating +2 or more,87,32,7,25,53,5,45,29,12,4,3,1,2,2,1,0,0,1
S01010572,Occupancy rating +1,112,32,7,25,70,5,51,10,28,13,14,6,8,10,0,0,1,9
S01010572,Occupancy rating 0,115,43,15,28,60,1,30,6,18,6,29,22,7,12,4,0,0,8
S01010572,Occupancy rating -1 or less,22,3,1,2,7,0,3,0,2,1,4,3,1,12,7,0,0,5
S01010573,All households,222,60,14,46,148,15,105,36,53,16,28,12,16,14,7,0,0,7
S01010573,Occupancy rating +2 or more,70,27,5,22,41,9,31,23,5,3,1,0,1,2,2,0,0,0
S01010573,Occupancy rating +1,70,13,3,10,54,5,38,8,25,5,11,4,7,3,1,0,0,2
S01010573,Occupancy rating 0,69,17,5,12,45,1,32,4,22,6,12,7,5,7,3,0,0,4
S01010573,Occupancy rating -1 or less,13,3,1,2,8,0,4,1,1,2,4,1,3,2,1,0,0,1
S01010574,All households,236,46,25,21,180,21,144,53,78,13,15,9,6,10,4,0,3,3
S01010574,Occupancy rating +2 or more,155,31,18,13,117,17,95,43,49,3,5,4,1,7,2,0,3,2
S01010574,Occupancy rating +1,54,14,7,7,39,4,31,6,16,9,4,4,0,1,1,0,0,0
S01010574,Occupancy rating 0,23,1,0,1,20,0,14,3,10,1,6,1,5,2,1,0,0,1
S01010574,Occupancy rating -1 or less,4,0,0,0,4,0,4,1,3,0,0,0,0,0,0,0,0,0
S01010575,All households,284,58,36,22,214,44,148,68,61,19,22,9,13,12,5,0,1,6
S01010575,Occupancy rating +2 or more,225,47,28,19,168,42,117,59,45,13,9,4,5,10,5,0,0,5
S01010575,Occupancy rating +1,39,9,6,3,29,2,21,9,10,2,6,2,4,1,0,0,1,0
S01010575,Occupancy rating 0,19,2,2,0,16,0,10,0,6,4,6,2,4,1,0,0,0,1
S01010575,Occupancy rating -1 or less,1,0,0,0,1,0,0,0,0,0,1,1,0,0,0,0,0,0
S01010576,All households,326,62,36,26,248,36,194,85,75,34,18,8,10,16,10,0,3,3
S01010576,Occupancy rating +2 or more,233,48,25,23,177,33,139,78,46,15,5,0,5,8,5,0,1,2
S01010576,Occupancy rating +1,58,14,11,3,42,1,33,4,19,10,8,5,3,2,1,0,1,0
S01010576,Occupancy rating 0,32,0,0,0,26,2,19,3,8,8,5,3,2,6,4,0,1,1
S01010576,Occupancy rating -1 or less,3,0,0,0,3,0,3,0,2,1,0,0,0,0,0,0,0,0
S01010577,All households,354,94,38,56,233,15,140,51,60,29,78,52,26,27,11,0,0,16
S01010577,Occupancy rating +2 or more,132,57,23,34,68,10,56,44,8,4,2,1,1,7,0,0,0,7
S01010577,Occupancy rating +1,99,12,4,8,83,1,44,7,19,18,38,21,17,4,2,0,0,2
S01010577,Occupancy rating 0,89,22,9,13,58,4,27,0,22,5,27,21,6,9,4,0,0,5
S01010577,Occupancy rating -1 or less,34,3,2,1,24,0,13,0,11,2,11,9,2,7,5,0,0,2
S01010578,All households,203,30,10,20,159,11,117,30,52,35,31,18,13,14,5,0,1,8
S01010578,Occupancy rating +2 or more,80,12,1,11,64,3,57,28,15,14,4,2,2,4,0,0,1,3
S01010578,Occupancy rating +1,63,13,6,7,46,4,30,2,17,11,12,5,7,4,1,0,0,3
S01010578,Occupancy rating 0,49,4,2,2,40,4,23,0,15,8,13,10,3,5,3,0,0,2
S01010578,Occupancy rating -1 or less,11,1,1,0,9,0,7,0,5,2,2,1,1,1,1,0,0,0
S01010579,All households,325,96,36,60,207,24,165,75,65,25,18,10,8,22,10,1,4,7
S01010579,Occupancy rating +2 or more,137,33,12,21,99,13,79,50,22,7,7,5,2,5,0,0,2,3
S01010579,Occupancy rating +1,116,49,22,27,63,9,48,19,20,9,6,2,4,4,1,0,1,2
S01010579,Occupancy rating 0,58,12,2,10,37,2,31,3,20,8,4,2,2,9,6,1,1,1
S01010579,Occupancy rating -1 or less,14,2,0,2,8,0,7,3,3,1,1,1,0,4,3,0,0,1
S01010580,All households,305,153,17,136,145,15,110,75,26,9,20,13,7,7,2,0,0,5
S01010580,Occupancy rating +2 or more,63,19,7,12,43,10,33,24,6,3,0,0,0,1,0,0,0,1
S01010580,Occupancy rating +1,77,39,5,34,37,4,30,21,6,3,3,0,3,1,0,0,0,1
S01010580,Occupancy rating 0,146,88,3,85,55,1,41,30,8,3,13,11,2,3,1,0,0,2
S01010580,Occupancy rating -1 or less,19,7,2,5,10,0,6,0,6,0,4,2,2,2,1,0,0,1
S01010581,All households,243,92,18,74,140,7,113,51,52,10,20,13,7,11,3,0,0,8
S01010581,Occupancy rating +2 or more,86,18,3,15,65,5,55,27,20,8,5,4,1,3,1,0,0,2
S01010581,Occupancy rating +1,51,26,4,22,22,2,17,11,5,1,3,2,1,3,1,0,0,2
S01010581,Occupancy rating 0,87,48,11,37,38,0,30,12,18,0,8,4,4,1,0,0,0,1
S01010581,Occupancy rating -1 or less,19,0,0,0,15,0,11,1,9,1,4,3,1,4,1,0,0,3
S01010582,All households,185,46,17,29,130,13,107,46,50,11,10,7,3,9,1,0,0,8
S01010582,Occupancy rating +2 or more,114,19,8,11,90,12,77,35,34,8,1,0,1,5,0,0,0,5
S01010582,Occupancy rating +1,49,20,7,13,28,1,22,9,12,1,5,4,1,1,0,0,0,1
S01010582,Occupancy rating 0,16,3,2,1,12,0,8,2,4,2,4,3,1,1,0,0,0,1
S01010582,Occupancy rating -1 or less,6,4,0,4,0,0,0,0,0,0,0,0,0,2,1,0,0,1
S01010583,All households,440,132,45,87,302,43,231,100,103,28,28,24,4,6,2,0,0,4
S01010583,Occupancy rating +2 or more,186,40,23,17,145,31,108,63,34,11,6,5,1,1,0,0,0,1
S01010583,Occupancy rating +1,167,65,22,43,100,12,82,28,40,14,6,5,1,2,0,0,0,2
S01010583,Occupancy rating 0,72,25,0,25,46,0,34,8,24,2,12,10,2,1,0,0,0,1
S01010583,Occupancy rating -1 or less,15,2,0,2,11,0,7,1,5,1,4,4,0,2,2,0,0,0
S01010584,All households,312,63,10,53,241,10,187,63,108,16,44,35,9,8,4,0,0,4
S01010584,Occupancy rating +2 or more,183,35,8,27,147,9,125,51,63,11,13,7,6,1,0,0,0,1
S01010584,Occupancy rating +1,57,19,2,17,36,1,29,11,15,3,6,5,1,2,1,0,0,1
S01010584,Occupancy rating 0,60,7,0,7,49,0,26,1,23,2,23,21,2,4,2,0,0,2
S01010584,Occupancy rating -1 or less,12,2,0,2,9,0,7,0,7,0,2,2,0,1,1,0,0,0
S01010585,All households,304,36,1,35,250,4,206,72,123,11,40,34,6,18,5,0,0,13
S01010585,Occupancy rating +2 or more,180,17,1,16,154,4,133,48,78,7,17,14,3,9,2,0,0,7
S01010585,Occupancy rating +1,73,17,0,17,54,0,47,23,22,2,7,5,2,2,1,0,0,1
S01010585,Occupancy rating 0,43,0,0,0,38,0,23,1,20,2,15,14,1,5,0,0,0,5
S01010585,Occupancy rating -1 or less,8,2,0,2,4,0,3,0,3,0,1,1,0,2,2,0,0,0
S01010586,All households,305,56,24,32,237,26,196,77,92,27,15,8,7,12,7,0,0,5
S01010586,Occupancy rating +2 or more,243,47,20,27,186,24,151,68,64,19,11,7,4,10,5,0,0,5
S01010586,Occupancy rating +1,34,6,2,4,28,2,24,6,16,2,2,0,2,0,0,0,0,0
S01010586,Occupancy rating 0,17,2,1,1,15,0,14,2,7,5,1,0,1,0,0,0,0,0
S01010586,Occupancy rating -1 or less,11,1,1,0,8,0,7,1,5,1,1,1,0,2,2,0,0,0
S01010587,All households,293,66,33,33,214,35,167,78,63,26,12,7,5,13,5,0,1,7
S01010587,Occupancy rating +2 or more,191,39,21,18,147,33,114,60,39,15,0,0,0,5,2,0,1,2
S01010587,Occupancy rating +1,59,16,8,8,40,2,33,15,10,8,5,3,2,3,1,0,0,2
S01010587,Occupancy rating 0,30,9,2,7,18,0,13,3,8,2,5,3,2,3,2,0,0,1
S01010587,Occupancy rating -1 or less,13,2,2,0,9,0,7,0,6,1,2,1,1,2,0,0,0,2
S01010588,All households,268,71,22,49,185,27,137,48,68,21,21,14,7,12,3,0,0,9
S01010588,Occupancy rating +2 or more,147,35,15,20,105,21,79,30,34,15,5,3,2,7,2,0,0,5
S01010588,Occupancy rating +1,76,21,4,17,52,6,40,14,20,6,6,4,2,3,1,0,0,2
S01010588,Occupancy rating 0,39,14,3,11,23,0,14,4,10,0,9,7,2,2,0,0,0,2
S01010588,Occupancy rating -1 or less,6,1,0,1,5,0,4,0,4,0,1,0,1,0,0,0,0,0
S01010589,All households,299,115,24,91,174,11,121,60,47,14,42,24,18,10,6,0,0,4
S01010589,Occupancy rating +2 or more,66,15,3,12,48,6,35,22,9,4,7,2,5,3,2,0,0,1
S01010589,Occupancy rating +1,86,34,7,27,51,5,36,23,9,4,10,8,2,1,0,0,0,1
S01010589,Occupancy rating 0,121,64,13,51,54,0,38,15,19,4,16,9,7,3,2,0,0,1
S01010589,Occupancy rating -1 or less,26,2,1,1,21,0,12,0,10,2,9,5,4,3,2,0,0,1
S01010590,All households,293,32,12,20,249,15,219,58,132,29,15,11,4,12,4,0,1,7
S01010590,Occupancy rating +2 or more,262,28,9,19,226,15,203,57,119,27,8,6,2,8,2,0,1,5
S01010590,Occupancy rating +1,24,3,3,0,18,0,13,0,11,2,5,3,2,3,1,0,0,2
S01010590,Occupancy rating 0,4,0,0,0,4,0,3,1,2,0,1,1,0,0,0,0,0,0
S01010590,Occupancy rating -1 or less,3,1,0,1,1,0,0,0,0,0,1,1,0,1,1,0,0,0
S01010591,All households,303,63,5,58,230,6,181,78,96,7,43,42,1,10,2,0,0,8
S01010591,Occupancy rating +2 or more,124,20,4,16,101,6,93,52,36,5,2,2,0,3,1,0,0,2
S01010591,Occupancy rating +1,99,37,1,36,62,0,54,21,31,2,8,8,0,0,0,0,0,0
S01010591,Occupancy rating 0,67,6,0,6,56,0,28,4,24,0,28,27,1,5,0,0,0,5
S01010591,Occupancy rating -1 or less,13,0,0,0,11,0,6,1,5,0,5,5,0,2,1,0,0,1
S01010592,All households,273,120,18,102,145,15,101,60,29,12,29,25,4,8,2,0,0,6
S01010592,Occupancy rating +2 or more,75,24,8,16,49,10,35,26,7,2,4,3,1,2,1,0,0,1
S01010592,Occupancy rating +1,98,42,6,36,52,5,42,23,14,5,5,4,1,4,1,0,0,3
S01010592,Occupancy rating 0,86,51,4,47,34,0,20,11,5,4,14,12,2,1,0,0,0,1
S01010592,Occupancy rating -1 or less,14,3,0,3,10,0,4,0,3,1,6,6,0,1,0,0,0,1
S01010593,All households,259,61,26,35,188,29,144,51,74,19,15,10,5,10,2,0,0,8
S01010593,Occupancy rating +2 or more,179,40,18,22,134,22,106,38,53,15,6,4,2,5,1,0,0,4
S01010593,Occupancy rating +1,57,16,7,9,39,7,29,13,12,4,3,3,0,2,0,0,0,2
S01010593,Occupancy rating 0,15,4,1,3,9,0,4,0,4,0,5,3,2,2,0,0,0,2
S01010593,Occupancy rating -1 or less,8,1,0,1,6,0,5,0,5,0,1,0,1,1,1,0,0,0
S01010594,All households,281,71,13,58,183,14,141,54,77,10,28,22,6,27,5,0,1,21
S01010594,Occupancy rating +2 or more,93,22,6,16,69,9,56,22,31,3,4,3,1,2,0,0,1,1
S01010594,Occupancy rating +1,117,48,7,41,67,5,57,30,24,3,5,5,0,2,1,0,0,1
S01010594,Occupancy rating 0,60,1,0,1,38,0,26,2,20,4,12,9,3,21,2,0,0,19
S01010594,Occupancy rating -1 or less,11,0,0,0,9,0,2,0,2,0,7,5,2,2,2,0,0,0
S01010595,All households,310,61,3,58,238,6,179,47,121,11,53,40,13,11,3,0,0,8
S01010595,Occupancy rating +2 or more,141,30,3,27,111,6,90,34,50,6,15,14,1,0,0,0,0,0
S01010595,Occupancy rating +1,91,26,0,26,60,0,49,7,39,3,11,7,4,5,1,0,0,4
S01010595,Occupancy rating 0,66,4,0,4,57,0,33,5,27,1,24,16,8,5,1,0,0,4
S01010595,Occupancy rating -1 or less,12,1,0,1,10,0,7,1,5,1,3,3,0,1,1,0,0,0
S01010596,All households,310,57,17,40,236,15,203,85,95,23,18,16,2,17,6,0,0,11
S01010596,Occupancy rating +2 or more,218,43,15,28,163,11,146,67,61,18,6,5,1,12,5,0,0,7
S01010596,Occupancy rating +1,62,10,2,8,51,3,44,16,24,4,4,3,1,1,0,0,0,1
S01010596,Occupancy rating 0,22,3,0,3,15,0,10,1,8,1,5,5,0,4,1,0,0,3
S01010596,Occupancy rating -1 or less,8,1,0,1,7,1,3,1,2,0,3,3,0,0,0,0,0,0
S01010597,All households,274,69,3,66,193,4,146,64,75,7,43,39,4,12,4,0,0,8
S01010597,Occupancy rating +2 or more,115,32,2,30,80,3,71,39,29,3,6,4,2,3,0,0,0,3
S01010597,Occupancy rating +1,77,18,0,18,58,0,46,17,28,1,12,10,2,1,0,0,0,1
S01010597,Occupancy rating 0,65,16,1,15,47,0,25,5,17,3,22,22,0,2,0,0,0,2
S01010597,Occupancy rating -1 or less,17,3,0,3,8,1,4,3,1,0,3,3,0,6,4,0,0,2
S01010598,All households,404,91,7,84,287,8,230,80,136,14,49,44,5,26,10,0,0,16
S01010598,Occupancy rating +2 or more,191,28,2,26,157,7,137,46,81,10,13,12,1,6,5,0,0,1
S01010598,Occupancy rating +1,125,58,4,54,65,1,58,30,25,3,6,4,2,2,1,0,0,1
S01010598,Occupancy rating 0,70,4,1,3,52,0,31,2,29,0,21,19,2,14,1,0,0,13
S01010598,Occupancy rating -1 or less,18,1,0,1,13,0,4,2,1,1,9,9,0,4,3,0,0,1
S01010599,All households,248,55,13,42,185,27,142,59,71,12,16,13,3,8,1,0,0,7
S01010599,Occupancy rating +2 or more,145,26,7,19,118,19,95,38,48,9,4,2,2,1,0,0,0,1
S01010599,Occupancy rating +1,74,26,6,20,48,8,36,21,13,2,4,3,1,0,0,0,0,0
S01010599,Occupancy rating 0,27,3,0,3,18,0,10,0,9,1,8,8,0,6,0,0,0,6
S01010599,Occupancy rating -1 or less,2,0,0,0,1,0,1,0,1,0,0,0,0,1,1,0,0,0
S01010600,All households,427,135,62,73,268,62,187,91,61,35,19,9,10,24,6,0,1,17
S01010600,Occupancy rating +2 or more,251,59,34,25,184,47,132,72,39,21,5,1,4,8,2,0,1,5
S01010600,Occupancy rating +1,104,49,21,28,52,15,33,11,11,11,4,2,2,3,0,0,0,3
S01010600,Occupancy rating 0,48,17,6,11,22,0,15,7,7,1,7,4,3,9,1,0,0,8
S01010600,Occupancy rating -1 or less,24,10,1,9,10,0,7,1,4,2,3,2,1,4,3,0,0,1
S01010601,All households,302,84,50,34,203,65,128,50,62,16,10,4,6,15,6,0,1,8
S01010601,Occupancy rating +2 or more,201,60,37,23,136,59,75,40,27,8,2,1,1,5,0,0,1,4
S01010601,Occupancy rating +1,67,16,10,6,47,6,39,9,22,8,2,0,2,4,1,0,0,3
S01010601,Occupancy rating 0,29,8,3,5,17,0,11,1,10,0,6,3,3,4,3,0,0,1
S01010601,Occupancy rating -1 or less,5,0,0,0,3,0,3,0,3,0,0,0,0,2,2,0,0,0
S01010602,All households,260,113,26,87,136,13,111,50,43,18,12,7,5,11,1,0,0,10
S01010602,Occupancy rating +2 or more,88,31,14,17,53,9,41,17,16,8,3,1,2,4,0,0,0,4
S01010602,Occupancy rating +1,100,51,8,43,47,2,43,28,11,4,2,2,0,2,0,0,0,2
S01010602,Occupancy rating 0,62,27,2,25,32,2,25,5,15,5,5,3,2,3,1,0,0,2
S01010602,Occupancy rating -1 or less,10,4,2,2,4,0,2,0,1,1,2,1,1,2,0,0,0,2
S01010603,All households,369,117,59,58,233,45,169,78,61,30,19,7,12,19,4,0,1,14
S01010603,Occupancy rating +2 or more,201,65,44,21,128,35,90,55,24,11,3,1,2,8,2,0,0,6
S01010603,Occupancy rating +1,105,45,15,30,58,9,43,19,14,10,6,1,5,2,0,0,0,2
S01010603,Occupancy rating 0,55,5,0,5,42,0,32,3,21,8,10,5,5,8,1,0,1,6
S01010603,Occupancy rating -1 or less,8,2,0,2,5,1,4,1,2,1,0,0,0,1,1,0,0,0
S01010604,All households,193,33,15,18,145,28,104,38,54,12,13,10,3,15,5,0,3,7
S01010604,Occupancy rating +2 or more,140,26,12,14,108,26,72,34,32,6,10,8,2,6,2,0,1,3
S01010604,Occupancy rating +1,38,7,3,4,26,1,23,4,15,4,2,1,1,5,2,0,2,1
S01010604,Occupancy rating 0,12,0,0,0,9,0,9,0,7,2,0,0,0,3,0,0,0,3
S01010604,Occupancy rating -1 or less,3,0,0,0,2,1,0,0,0,0,1,1,0,1,1,0,0,0
S01010605,All households,387,105,67,38,268,53,186,77,77,32,29,10,19,14,3,0,3,8
S01010605,Occupancy rating +2 or more,268,81,50,31,178,49,114,64,34,16,15,3,12,9,2,0,2,5
S01010605,Occupancy rating +1,86,22,16,6,63,4,50,10,26,14,9,4,5,1,0,0,1,0
S01010605,Occupancy rating 0,24,0,0,0,22,0,18,3,13,2,4,2,2,2,0,0,0,2
S01010605,Occupancy rating -1 or less,9,2,1,1,5,0,4,0,4,0,1,1,0,2,1,0,0,1
S01010606,All households,371,118,64,54,231,37,138,57,60,21,56,39,17,22,9,0,1,12
S01010606,Occupancy rating +2 or more,158,63,33,30,92,26,59,38,15,6,7,5,2,3,1,0,0,2
S01010606,Occupancy rating +1,121,50,28,22,66,9,39,18,13,8,18,11,7,5,1,0,1,3
S01010606,Occupancy rating 0,72,3,2,1,61,1,32,1,24,7,28,21,7,8,3,0,0,5
S01010606,Occupancy rating -1 or less,20,2,1,1,12,1,8,0,8,0,3,2,1,6,4,0,0,2
S01010607,All households,346,83,43,40,244,39,183,63,84,36,22,8,14,19,3,0,3,13
S01010607,Occupancy rating +2 or more,251,62,39,23,178,38,132,55,51,26,8,0,8,11,2,0,1,8
S01010607,Occupancy rating +1,61,14,3,11,45,1,36,6,24,6,8,5,3,2,0,0,1,1
S01010607,Occupancy rating 0,23,7,1,6,11,0,8,0,5,3,3,1,2,5,0,0,1,4
S01010607,Occupancy rating -1 or less,11,0,0,0,10,0,7,2,4,1,3,2,1,1,1,0,0,0
S01010608,All households,306,109,27,82,171,11,73,17,42,14,87,65,22,26,6,1,0,19
S01010608,Occupancy rating +2 or more,63,33,13,20,26,6,18,11,3,4,2,1,1,4,0,0,0,4
S01010608,Occupancy rating +1,92,46,7,39,39,3,20,6,9,5,16,9,7,7,0,1,0,6
S01010608,Occupancy rating 0,118,17,5,12,93,2,31,0,27,4,60,48,12,8,2,0,0,6
S01010608,Occupancy rating -1 or less,33,13,2,11,13,0,4,0,3,1,9,7,2,7,4,0,0,3
S01010609,All households,242,59,18,41,161,14,95,33,45,17,52,36,16,22,4,0,0,18
S01010609,Occupancy rating +2 or more,59,22,7,15,36,6,27,20,6,1,3,2,1,1,0,0,0,1
S01010609,Occupancy rating +1,92,26,8,18,59,6,37,11,15,11,16,11,5,7,1,0,0,6
S01010609,Occupancy rating 0,73,10,3,7,51,1,23,1,19,3,27,19,8,12,3,0,0,9
S01010609,Occupancy rating -1 or less,18,1,0,1,15,1,8,1,5,2,6,4,2,2,0,0,0,2
S01010610,All households,318,116,65,51,192,42,130,68,41,21,20,6,14,10,2,0,1,7
S01010610,Occupancy rating +2 or more,202,67,44,23,131,33,92,52,27,13,6,1,5,4,2,0,1,1
S01010610,Occupancy rating +1,72,27,8,19,41,6,24,10,10,4,11,5,6,4,0,0,0,4
S01010610,Occupancy rating 0,32,16,8,8,14,3,8,2,4,2,3,0,3,2,0,0,0,2
S01010610,Occupancy rating -1 or less,12,6,5,1,6,0,6,4,0,2,0,0,0,0,0,0,0,0
S01010611,All households,496,237,64,173,246,32,151,70,62,19,63,39,24,13,2,0,0,11
S01010611,Occupancy rating +2 or more,76,31,15,16,43,13,29,21,7,1,1,1,0,2,0,0,0,2
S01010611,Occupancy rating +1,147,72,27,45,74,14,47,30,13,4,13,8,5,1,0,0,0,1
S01010611,Occupancy rating 0,186,75,18,57,106,4,64,15,36,13,38,23,15,5,0,0,0,5
S01010611,Occupancy rating -1 or less,87,59,4,55,23,1,11,4,6,1,11,7,4,5,2,0,0,3
S01010612,All households,316,68,28,40,228,28,168,75,68,25,32,22,10,20,7,0,0,13
S01010612,Occupancy rating +2 or more,137,40,16,24,95,17,75,59,13,3,3,1,2,2,1,0,0,1
S01010612,Occupancy rating +1,86,10,5,5,68,7,50,12,22,16,11,6,5,8,2,0,0,6
S01010612,Occupancy rating 0,77,17,6,11,53,4,35,3,29,3,14,11,3,7,2,0,0,5
S01010612,Occupancy rating -1 or less,16,1,1,0,12,0,8,1,4,3,4,4,0,3,2,0,0,1
S01010613,All households,341,139,72,67,178,26,118,48,43,27,34,20,14,24,5,2,1,16
S01010613,Occupancy rating +2 or more,148,56,30,26,89,17,68,33,24,11,4,0,4,3,1,0,0,2
S01010613,Occupancy rating +1,107,44,17,27,51,4,31,15,6,10,16,7,9,12,2,1,1,8
S01010613,Occupancy rating 0,63,33,22,11,27,3,15,0,9,6,9,8,1,3,0,1,0,2
S01010613,Occupancy rating -1 or less,23,6,3,3,11,2,4,0,4,0,5,5,0,6,2,0,0,4
S01010614,All households,264,120,47,73,131,10,86,32,36,18,35,27,8,13,5,0,2,6
S01010614,Occupancy rating +2 or more,49,25,10,15,22,2,18,11,6,1,2,1,1,2,0,0,0,2
S01010614,Occupancy rating +1,76,28,3,25,46,6,34,15,10,9,6,4,2,2,1,0,0,1
S01010614,Occupancy rating 0,105,53,28,25,47,2,24,2,14,8,21,17,4,5,2,0,1,2
S01010614,Occupancy rating -1 or less,34,14,6,8,16,0,10,4,6,0,6,5,1,4,2,0,1,1
S01010615,All households,383,131,21,110,222,11,168,71,85,12,43,32,11,30,6,1,2,21
S01010615,Occupancy rating +2 or more,87,28,3,25,59,6,50,31,17,2,3,1,2,0,0,0,0,0
S01010615,Occupancy rating +1,137,41,7,34,85,4,71,31,35,5,10,4,6,11,2,0,1,8
S01010615,Occupancy rating 0,106,37,7,30,56,1,39,6,28,5,16,14,2,13,1,1,0,11
S01010615,Occupancy rating -1 or less,53,25,4,21,22,0,8,3,5,0,14,13,1,6,3,0,1,2
S01010616,All households,359,90,50,40,246,46,170,55,81,34,30,17,13,23,5,0,4,14
S01010616,Occupancy rating +2 or more,235,77,45,32,153,42,99,49,34,16,12,7,5,5,0,0,1,4
S01010616,Occupancy rating +1,75,8,3,5,59,3,43,4,28,11,13,8,5,8,1,0,3,4
S01010616,Occupancy rating 0,34,3,2,1,26,1,21,1,13,7,4,2,2,5,2,0,0,3
S01010616,Occupancy rating -1 or less,15,2,0,2,8,0,7,1,6,0,1,0,1,5,2,0,0,3
S01010617,All households,360,73,36,37,267,40,196,73,81,42,31,19,12,20,11,0,1,8
S01010617,Occupancy rating +2 or more,215,49,24,25,158,32,115,65,35,15,11,6,5,8,2,0,0,6
S01010617,Occupancy rating +1,96,19,10,9,70,5,55,8,31,16,10,6,4,7,6,0,1,0
S01010617,Occupancy rating 0,44,4,2,2,36,3,25,0,14,11,8,6,2,4,2,0,0,2
S01010617,Occupancy rating -1 or less,5,1,0,1,3,0,1,0,1,0,2,1,1,1,1,0,0,0
S01010618,All households,307,63,21,42,235,20,183,64,69,50,32,20,12,9,0,0,0,9
S01010618,Occupancy rating +2 or more,140,31,10,21,104,14,84,40,27,17,6,5,1,5,0,0,0,5
S01010618,Occupancy rating +1,113,28,10,18,84,6,68,21,24,23,10,4,6,1,0,0,0,1
S01010618,Occupancy rating 0,43,3,1,2,38,0,25,3,15,7,13,9,4,2,0,0,0,2
S01010618,Occupancy rating -1 or less,11,1,0,1,9,0,6,0,3,3,3,2,1,1,0,0,0,1
S01010619,All households,318,129,13,116,150,7,99,62,32,5,44,35,9,39,4,1,0,34
S01010619,Occupancy rating +2 or more,46,20,6,14,19,4,13,6,5,2,2,1,1,7,1,0,0,6
S01010619,Occupancy rating +1,95,38,4,34,55,3,44,38,5,1,8,6,2,2,0,0,0,2
S01010619,Occupancy rating 0,110,45,3,42,48,0,25,8,15,2,23,19,4,17,0,1,0,16
S01010619,Occupancy rating -1 or less,67,26,0,26,28,0,17,10,7,0,11,9,2,13,3,0,0,10
S01010620,All households,369,207,22,185,109,4,83,50,31,2,22,18,4,53,5,3,1,44
S01010620,Occupancy rating +2 or more,35,14,7,7,17,3,12,6,6,0,2,0,2,4,0,0,1,3
S01010620,Occupancy rating +1,73,44,3,41,24,0,22,18,3,1,2,1,1,5,1,0,0,4
S01010620,Occupancy rating 0,135,85,9,76,24,1,20,11,8,1,3,3,0,26,0,3,0,23
S01010620,Occupancy rating -1 or less,126,64,3,61,44,0,29,15,14,0,15,14,1,18,4,0,0,14
S01010621,All households,432,165,41,124,222,32,171,79,76,16,19,16,3,45,3,2,1,39
S01010621,Occupancy rating +2 or more,181,43,24,19,126,29,96,43,38,15,1,0,1,12,3,1,1,7
S01010621,Occupancy rating +1,116,69,9,60,42,3,34,29,5,0,5,5,0,5,0,0,0,5
S01010621,Occupancy rating 0,98,33,6,27,43,0,33,4,28,1,10,8,2,22,0,1,0,21
S01010621,Occupancy rating -1 or less,37,20,2,18,11,0,8,3,5,0,3,3,0,6,0,0,0,6
S01010622,All households,333,149,51,98,169,9,93,46,33,14,67,53,14,15,5,0,1,9
S01010622,Occupancy rating +2 or more,71,39,23,16,32,4,24,17,3,4,4,3,1,0,0,0,0,0
S01010622,Occupancy rating +1,100,47,8,39,48,4,34,19,8,7,10,6,4,5,0,0,1,4
S01010622,Occupancy rating 0,124,49,14,35,69,1,27,9,15,3,41,34,7,6,2,0,0,4
S01010622,Occupancy rating -1 or less,38,14,6,8,20,0,8,1,7,0,12,10,2,4,3,0,0,1
S01010623,All households,278,29,6,23,235,4,197,47,139,11,34,29,5,14,6,0,0,8
S01010623,Occupancy rating +2 or more,126,17,5,12,104,4,94,33,56,5,6,5,1,5,2,0,0,3
S01010623,Occupancy rating +1,59,7,0,7,49,0,42,7,31,4,7,7,0,3,1,0,0,2
S01010623,Occupancy rating 0,75,4,1,3,66,0,49,5,42,2,17,14,3,5,3,0,0,2
S01010623,Occupancy rating -1 or less,18,1,0,1,16,0,12,2,10,0,4,3,1,1,0,0,0,1
S01010624,All households,244,78,23,55,152,16,97,37,45,15,39,28,11,14,3,0,1,10
S01010624,Occupancy rating +2 or more,89,34,12,22,51,12,37,26,6,5,2,2,0,4,0,0,0,4
S01010624,Occupancy rating +1,79,27,4,23,50,2,35,9,18,8,13,10,3,2,0,0,0,2
S01010624,Occupancy rating 0,52,11,6,5,36,2,17,1,14,2,17,10,7,5,3,0,1,1
S01010624,Occupancy rating -1 or less,24,6,1,5,15,0,8,1,7,0,7,6,1,3,0,0,0,3
S01010625,All households,333,81,47,34,239,62,155,74,54,27,22,5,17,13,9,0,0,4
S01010625,Occupancy rating +2 or more,256,52,40,12,199,59,124,61,44,19,16,4,12,5,5,0,0,0
S01010625,Occupancy rating +1,48,14,5,9,33,3,25,10,8,7,5,0,5,1,0,0,0,1
S01010625,Occupancy rating 0,22,12,2,10,7,0,6,3,2,1,1,1,0,3,1,0,0,2
S01010625,Occupancy rating -1 or less,7,3,0,3,0,0,0,0,0,0,0,0,0,4,3,0,0,1
S01010626,All households,368,104,59,45,245,67,156,74,60,22,22,7,15,19,5,0,3,11
S01010626,Occupancy rating +2 or more,274,65,40,25,197,58,130,69,44,17,9,2,7,12,4,0,2,6
S01010626,Occupancy rating +1,47,19,12,7,24,7,11,3,5,3,6,2,4,4,0,0,0,4
S01010626,Occupancy rating 0,34,15,5,10,17,2,10,1,7,2,5,1,4,2,1,0,0,1
S01010626,Occupancy rating -1 or less,13,5,2,3,7,0,5,1,4,0,2,2,0,1,0,0,1,0
S01010627,All households,401,177,58,119,168,23,120,66,46,8,25,14,11,56,12,3,2,39
S01010627,Occupancy rating +2 or more,166,56,23,33,97,20,71,41,25,5,6,2,4,13,3,0,0,10
S01010627,Occupancy rating +1,82,43,8,35,31,2,26,17,7,2,3,1,2,8,3,0,0,5
S01010627,Occupancy rating 0,100,51,21,30,30,1,18,6,11,1,11,8,3,19,3,3,0,13
S01010627,Occupancy rating -1 or less,53,27,6,21,10,0,5,2,3,0,5,3,2,16,3,0,2,11
S01010628,All households,472,218,91,127,206,23,142,72,57,13,41,21,20,48,9,3,1,35
S01010628,Occupancy rating +2 or more,195,84,41,43,101,16,75,40,29,6,10,3,7,10,1,1,0,8
S01010628,Occupancy rating +1,103,47,15,32,47,6,32,14,15,3,9,7,2,9,2,0,0,7
S01010628,Occupancy rating 0,128,66,29,37,44,1,24,13,9,2,19,9,10,18,3,1,1,13
S01010628,Occupancy rating -1 or less,46,21,6,15,14,0,11,5,4,2,3,2,1,11,3,1,0,7
S01010629,All households,445,196,100,96,225,36,148,61,63,24,41,26,15,24,8,0,1,15
S01010629,Occupancy rating +2 or more,229,80,37,43,141,28,99,40,42,17,14,10,4,8,3,0,1,4
S01010629,Occupancy rating +1,87,46,26,20,37,7,21,10,8,3,9,5,4,4,1,0,0,3
S01010629,Occupancy rating 0,95,49,23,26,37,1,22,6,12,4,14,8,6,9,2,0,0,7
S01010629,Occupancy rating -1 or less,34,21,14,7,10,0,6,5,1,0,4,3,1,3,2,0,0,1
S01010630,All households,252,83,23,60,154,9,100,42,42,16,45,30,15,15,3,0,1,11
S01010630,Occupancy rating +2 or more,97,38,17,21,56,5,48,26,9,13,3,0,3,3,0,0,0,3
S01010630,Occupancy rating +1,70,28,2,26,39,3,25,12,12,1,11,7,4,3,0,0,0,3
S01010630,Occupancy rating 0,65,12,2,10,48,1,21,2,17,2,26,20,6,5,0,0,1,4
S01010630,Occupancy rating -1 or less,20,5,2,3,11,0,6,2,4,0,5,3,2,4,3,0,0,1
S01010631,All households,326,148,62,86,139,16,96,59,25,12,27,19,8,39,3,0,3,33
S01010631,Occupancy rating +2 or more,60,26,9,17,30,6,23,16,2,5,1,1,0,4,0,0,1,3
S01010631,Occupancy rating +1,135,75,22,53,52,5,45,36,6,3,2,1,1,8,1,0,0,7
S01010631,Occupancy rating 0,99,41,29,12,41,4,18,3,11,4,19,14,5,17,0,0,1,16
S01010631,Occupancy rating -1 or less,32,6,2,4,16,1,10,4,6,0,5,3,2,10,2,0,1,7
S01010632,All households,486,198,116,82,259,38,150,64,61,25,71,38,33,29,11,0,3,15
S01010632,Occupancy rating +2 or more,132,59,40,19,70,21,40,24,12,4,9,5,4,3,1,0,0,2
S01010632,Occupancy rating +1,183,96,51,45,80,14,47,29,12,6,19,8,11,7,0,0,1,6
S01010632,Occupancy rating 0,136,38,21,17,88,1,50,7,29,14,37,22,15,10,4,0,2,4
S01010632,Occupancy rating -1 or less,35,5,4,1,21,2,13,4,8,1,6,3,3,9,6,0,0,3
S01010633,All households,476,197,101,96,253,26,147,47,76,24,80,51,29,26,11,0,2,13
S01010633,Occupancy rating +2 or more,109,47,37,10,62,15,44,25,12,7,3,1,2,0,0,0,0,0
S01010633,Occupancy rating +1,177,99,49,50,72,8,47,19,22,6,17,9,8,6,1,0,0,5
S01010633,Occupancy rating 0,133,39,15,24,85,3,38,1,28,9,44,27,17,9,2,0,2,5
S01010633,Occupancy rating -1 or less,57,12,0,12,34,0,18,2,14,2,16,14,2,11,8,0,0,3
S01010634,All households,264,67,34,33,170,21,100,28,54,18,49,18,31,27,13,0,1,13
S01010634,Occupancy rating +2 or more,110,47,22,25,57,19,31,19,7,5,7,3,4,6,3,0,0,3
S01010634,Occupancy rating +1,74,9,7,2,59,1,32,8,17,7,26,6,20,6,2,0,1,3
S01010634,Occupancy rating 0,61,9,4,5,41,1,28,1,21,6,12,6,6,11,6,0,0,5
S01010634,Occupancy rating -1 or less,19,2,1,1,13,0,9,0,9,0,4,3,1,4,2,0,0,2
S01010635,All households,351,128,78,50,191,22,121,39,55,27,48,36,12,32,10,0,1,21
S01010635,Occupancy rating +2 or more,119,52,31,21,65,16,43,30,8,5,6,4,2,2,0,0,0,2
S01010635,Occupancy rating +1,91,26,10,16,54,5,34,8,18,8,15,9,6,11,0,0,0,11
S01010635,Occupancy rating 0,96,32,21,11,54,1,32,1,23,8,21,18,3,10,3,0,1,6
S01010635,Occupancy rating -1 or less,45,18,16,2,18,0,12,0,6,6,6,5,1,9,7,0,0,2
S01010636,All households,386,139,55,84,228,34,157,79,62,16,37,20,17,19,4,0,3,12
S01010636,Occupancy rating +2 or more,202,70,28,42,129,27,93,59,25,9,9,3,6,3,1,0,0,2
S01010636,Occupancy rating +1,105,54,24,30,44,4,31,18,8,5,9,4,5,7,1,0,0,6
S01010636,Occupancy rating 0,57,7,1,6,44,2,30,1,27,2,12,8,4,6,1,0,1,4
S01010636,Occupancy rating -1 or less,22,8,2,6,11,1,3,1,2,0,7,5,2,3,1,0,2,0
S01010637,All households,352,232,77,155,97,15,65,43,16,6,17,4,13,23,3,0,0,20
S01010637,Occupancy rating +2 or more,44,23,10,13,18,4,12,8,2,2,2,0,2,3,1,0,0,2
S01010637,Occupancy rating +1,65,43,8,35,20,2,17,10,5,2,1,0,1,2,0,0,0,2
S01010637,Occupancy rating 0,167,120,40,80,38,7,22,16,4,2,9,2,7,9,0,0,0,9
S01010637,Occupancy rating -1 or less,76,46,19,27,21,2,14,9,5,0,5,2,3,9,2,0,0,7
S01010638,All households,417,193,119,74,203,36,122,63,42,17,45,26,19,21,7,0,1,13
S01010638,Occupancy rating +2 or more,115,44,27,17,67,21,44,29,10,5,2,0,2,4,3,0,0,1
S01010638,Occupancy rating +1,124,65,41,24,56,7,44,29,11,4,5,2,3,3,2,0,0,1
S01010638,Occupancy rating 0,119,49,39,10,63,6,27,5,17,5,30,20,10,7,0,0,1,6
S01010638,Occupancy rating -1 or less,59,35,12,23,17,2,7,0,4,3,8,4,4,7,2,0,0,5
S01010639,All households,555,214,69,145,292,26,177,91,62,24,89,70,19,49,12,0,0,37
S01010639,Occupancy rating +2 or more,106,40,19,21,59,11,43,26,5,12,5,3,2,7,1,0,0,6
S01010639,Occupancy rating +1,182,97,29,68,79,13,53,38,14,1,13,7,6,6,3,0,0,3
S01010639,Occupancy rating 0,201,67,18,49,115,1,59,24,25,10,55,46,9,19,1,0,0,18
S01010639,Occupancy rating -1 or less,66,10,3,7,39,1,22,3,18,1,16,14,2,17,7,0,0,10
S01010640,All households,411,185,32,153,176,13,123,76,30,17,40,27,13,50,9,0,1,40
S01010640,Occupancy rating +2 or more,119,38,13,25,70,10,45,27,11,7,15,8,7,11,1,0,1,9
S01010640,Occupancy rating +1,102,55,8,47,38,2,30,19,8,3,6,5,1,9,1,0,0,8
S01010640,Occupancy rating 0,105,43,7,36,47,1,33,21,9,3,13,9,4,15,0,0,0,15
S01010640,Occupancy rating -1 or less,85,49,4,45,21,0,15,9,2,4,6,5,1,15,7,0,0,8
S01010641,All households,531,263,68,195,237,11,147,59,77,11,79,60,19,31,5,0,0,26
S01010641,Occupancy rating +2 or more,54,17,7,10,36,6,25,17,5,3,5,1,4,1,1,0,0,0
S01010641,Occupancy rating +1,131,67,14,53,59,4,45,26,13,6,10,8,2,5,1,0,0,4
S01010641,Occupancy rating 0,253,138,42,96,102,1,56,12,42,2,45,36,9,13,1,0,0,12
S01010641,Occupancy rating -1 or less,93,41,5,36,40,0,21,4,17,0,19,15,4,12,2,0,0,10
S01010642,All households,451,157,51,106,265,15,134,48,67,19,116,90,26,29,9,0,1,19
S01010642,Occupancy rating +2 or more,99,43,14,29,55,10,38,31,4,3,7,1,6,1,1,0,0,0
S01010642,Occupancy rating +1,126,61,12,49,57,4,32,8,16,8,21,16,5,8,1,0,1,6
S01010642,Occupancy rating 0,177,46,20,26,124,0,46,8,33,5,78,63,15,7,0,0,0,7
S01010642,Occupancy rating -1 or less,49,7,5,2,29,1,18,1,14,3,10,10,0,13,7,0,0,6
S01010643,All households,287,72,13,59,194,3,114,34,66,14,77,62,15,21,7,0,0,14
S01010643,Occupancy rating +2 or more,50,17,0,17,29,2,23,13,6,4,4,3,1,4,1,0,0,3
S01010643,Occupancy rating +1,90,36,7,29,47,1,27,14,10,3,19,13,6,7,0,0,0,7
S01010643,Occupancy rating 0,117,15,5,10,97,0,54,5,43,6,43,37,6,5,2,0,0,3
S01010643,Occupancy rating -1 or less,30,4,1,3,21,0,10,2,7,1,11,9,2,5,4,0,0,1
S01010644,All households,346,178,36,142,149,11,74,25,41,8,64,52,12,19,6,0,0,13
S01010644,Occupancy rating +2 or more,46,25,10,15,19,3,13,8,4,1,3,2,1,2,1,0,0,1
S01010644,Occupancy rating +1,108,69,12,57,36,8,23,12,7,4,5,2,3,3,0,0,0,3
S01010644,Occupancy rating 0,151,70,13,57,72,0,32,5,25,2,40,34,6,9,1,0,0,8
S01010644,Occupancy rating -1 or less,41,14,1,13,22,0,6,0,5,1,16,14,2,5,4,0,0,1
S01010645,All households,278,123,30,93,147,12,128,66,44,18,7,5,2,8,2,0,1,5
S01010645,Occupancy rating +2 or more,68,17,13,4,50,8,42,28,5,9,0,0,0,1,1,0,0,0
S01010645,Occupancy rating +1,98,47,13,34,49,2,46,23,19,4,1,1,0,2,0,0,0,2
S01010645,Occupancy rating 0,86,43,4,39,38,2,32,11,17,4,4,3,1,5,1,0,1,3
S01010645,Occupancy rating -1 or less,26,16,0,16,10,0,8,4,3,1,2,1,1,0,0,0,0,0
S01010646,All households,287,75,27,48,193,24,150,71,47,32,19,11,8,19,8,0,1,10
S01010646,Occupancy rating +2 or more,150,33,17,16,112,20,86,50,19,17,6,2,4,5,4,0,0,1
S01010646,Occupancy rating +1,87,26,8,18,59,4,49,18,18,13,6,3,3,2,0,0,0,2
S01010646,Occupancy rating 0,39,12,1,11,17,0,14,2,10,2,3,3,0,10,3,0,1,6
S01010646,Occupancy rating -1 or less,11,4,1,3,5,0,1,1,0,0,4,3,1,2,1,0,0,1
S01010647,All households,306,121,35,86,178,14,142,74,42,26,22,9,13,7,3,0,1,3
S01010647,Occupancy rating +2 or more,118,37,11,26,79,10,65,48,10,7,4,0,4,2,0,0,0,2
S01010647,Occupancy rating +1,95,42,17,25,52,4,41,15,15,11,7,2,5,1,0,0,1,0
S01010647,Occupancy rating 0,67,29,5,24,36,0,28,8,12,8,8,5,3,2,2,0,0,0
S01010647,Occupancy rating -1 or less,26,13,2,11,11,0,8,3,5,0,3,2,1,2,1,0,0,1
S01010648,All households,306,116,44,72,174,17,131,60,43,28,26,15,11,16,7,0,0,9
S01010648,Occupancy rating +2 or more,123,45,28,17,77,13,58,29,17,12,6,3,3,1,0,0,0,1
S01010648,Occupancy rating +1,80,24,4,20,49,2,39,18,13,8,8,6,2,7,3,0,0,4
S01010648,Occupancy rating 0,86,42,10,32,40,2,28,12,10,6,10,6,4,4,1,0,0,3
S01010648,Occupancy rating -1 or less,17,5,2,3,8,0,6,1,3,2,2,0,2,4,3,0,0,1
S01010649,All households,280,112,64,48,160,30,114,58,43,13,16,8,8,8,2,0,0,6
S01010649,Occupancy rating +2 or more,129,40,22,18,86,19,63,36,18,9,4,2,2,3,0,0,0,3
S01010649,Occupancy rating +1,63,18,12,6,42,2,34,12,18,4,6,3,3,3,0,0,0,3
S01010649,Occupancy rating 0,70,42,25,17,26,7,14,8,6,0,5,3,2,2,2,0,0,0
S01010649,Occupancy rating -1 or less,18,12,5,7,6,2,3,2,1,0,1,0,1,0,0,0,0,0
S01010650,All households,196,62,15,47,124,7,99,43,43,13,18,12,6,10,5,0,0,5
S01010650,Occupancy rating +2 or more,91,14,7,7,71,5,62,35,24,3,4,2,2,6,3,0,0,3
S01010650,Occupancy rating +1,42,17,2,15,23,1,18,5,7,6,4,2,2,2,0,0,0,2
S01010650,Occupancy rating 0,43,22,3,19,21,1,12,3,7,2,8,6,2,0,0,0,0,0
S01010650,Occupancy rating -1 or less,20,9,3,6,9,0,7,0,5,2,2,2,0,2,2,0,0,0
S01010651,All households,295,100,35,65,178,13,127,54,48,25,38,13,25,17,8,0,0,9
S01010651,Occupancy rating +2 or more,125,37,11,26,85,12,63,44,13,6,10,2,8,3,0,0,0,3
S01010651,Occupancy rating +1,70,22,11,11,43,0,31,5,17,9,12,2,10,5,2,0,0,3
S01010651,Occupancy rating 0,84,38,13,25,38,1,28,5,13,10,9,4,5,8,5,0,0,3
S01010651,Occupancy rating -1 or less,16,3,0,3,12,0,5,0,5,0,7,5,2,1,1,0,0,0
S01010652,All households,309,77,19,58,220,24,159,65,66,28,37,24,13,12,5,0,0,7
S01010652,Occupancy rating +2 or more,139,28,9,19,107,19,78,45,24,9,10,7,3,4,0,0,0,4
S01010652,Occupancy rating +1,89,29,4,25,57,1,45,11,21,13,11,6,5,3,1,0,0,2
S01010652,Occupancy rating 0,70,19,6,13,46,4,28,9,13,6,14,9,5,5,4,0,0,1
S01010652,Occupancy rating -1 or less,11,1,0,1,10,0,8,0,8,0,2,2,0,0,0,0,0,0
S01010653,All households,300,117,43,74,167,20,130,78,32,20,17,13,4,16,3,0,4,9
S01010653,Occupancy rating +2 or more,101,29,13,16,65,10,53,40,7,6,2,2,0,7,1,0,0,6
S01010653,Occupancy rating +1,88,39,18,21,45,6,34,22,6,6,5,3,2,4,0,0,2,2
S01010653,Occupancy rating 0,90,42,10,32,46,4,37,15,16,6,5,4,1,2,1,0,1,0
S01010653,Occupancy rating -1 or less,21,7,2,5,11,0,6,1,3,2,5,4,1,3,1,0,1,1
S01010654,All households,348,127,42,85,197,12,135,52,52,31,50,31,19,24,4,0,1,19
S01010654,Occupancy rating +2 or more,102,35,14,21,64,4,49,28,15,6,11,7,4,3,0,0,0,3
S01010654,Occupancy rating +1,104,36,10,26,61,7,34,14,13,7,20,15,5,7,0,0,0,7
S01010654,Occupancy rating 0,115,51,18,33,56,1,40,8,18,14,15,6,9,8,3,0,0,5
S01010654,Occupancy rating -1 or less,27,5,0,5,16,0,12,2,6,4,4,3,1,6,1,0,1,4
S01010655,All households,380,106,55,51,257,26,210,99,87,24,21,14,7,17,4,0,2,11
S01010655,Occupancy rating +2 or more,274,84,46,38,176,21,144,84,50,10,11,8,3,14,3,0,2,9
S01010655,Occupancy rating +1,57,11,6,5,44,5,36,10,19,7,3,2,1,2,0,0,0,2
S01010655,Occupancy rating 0,39,9,3,6,29,0,23,3,14,6,6,3,3,1,1,0,0,0
S01010655,Occupancy rating -1 or less,10,2,0,2,8,0,7,2,4,1,1,1,0,0,0,0,0,0
S01010656,All households,182,32,13,19,138,22,90,33,46,11,26,18,8,12,8,0,0,4
S01010656,Occupancy rating +2 or more,86,13,7,6,66,17,45,22,21,2,4,3,1,7,4,0,0,3
S01010656,Occupancy rating +1,49,14,4,10,34,4,25,9,11,5,5,2,3,1,1,0,0,0
S01010656,Occupancy rating 0,39,5,2,3,33,1,20,2,14,4,12,9,3,1,1,0,0,0
S01010656,Occupancy rating -1 or less,8,0,0,0,5,0,0,0,0,0,5,4,1,3,2,0,0,1
S01010657,All households,248,41,19,22,189,28,147,71,52,24,14,8,6,18,7,0,2,9
S01010657,Occupancy rating +2 or more,204,35,17,18,157,26,124,67,38,19,7,2,5,12,5,0,2,5
S01010657,Occupancy rating +1,29,5,2,3,22,2,16,4,11,1,4,3,1,2,0,0,0,2
S01010657,Occupancy rating 0,13,1,0,1,9,0,7,0,3,4,2,2,0,3,2,0,0,1
S01010657,Occupancy rating -1 or less,2,0,0,0,1,0,0,0,0,0,1,1,0,1,0,0,0,1
S01010658,All households,296,69,30,39,201,32,153,70,59,24,16,9,7,26,9,0,0,17
S01010658,Occupancy rating +2 or more,195,38,19,19,143,28,109,51,39,19,6,2,4,14,6,0,0,8
S01010658,Occupancy rating +1,47,12,4,8,32,2,26,14,9,3,4,2,2,3,0,0,0,3
S01010658,Occupancy rating 0,37,13,4,9,19,2,14,4,9,1,3,3,0,5,1,0,0,4
S01010658,Occupancy rating -1 or less,17,6,3,3,7,0,4,1,2,1,3,2,1,4,2,0,0,2
S01010659,All households,276,61,19,42,199,34,144,75,50,19,21,9,12,16,2,0,3,11
S01010659,Occupancy rating +2 or more,223,48,16,32,163,29,123,69,41,13,11,5,6,12,2,0,2,8
S01010659,Occupancy rating +1,32,6,1,5,22,4,13,2,7,4,5,3,2,4,0,0,1,3
S01010659,Occupancy rating 0,18,6,2,4,12,1,7,4,1,2,4,0,4,0,0,0,0,0
S01010659,Occupancy rating -1 or less,3,1,0,1,2,0,1,0,1,0,1,1,0,0,0,0,0,0
S01010660,All households,285,107,62,45,169,25,109,36,53,20,35,18,17,9,1,0,0,8
S01010660,Occupancy rating +2 or more,142,56,37,19,84,22,49,27,14,8,13,6,7,2,0,0,0,2
S01010660,Occupancy rating +1,81,44,21,23,34,3,27,8,13,6,4,3,1,3,1,0,0,2
S01010660,Occupancy rating 0,57,6,3,3,47,0,30,1,23,6,17,8,9,4,0,0,0,4
S01010660,Occupancy rating -1 or less,5,1,1,0,4,0,3,0,3,0,1,1,0,0,0,0,0,0
S01010661,All households,307,132,66,66,156,21,112,68,27,17,23,15,8,19,1,0,4,14
S01010661,Occupancy rating +2 or more,114,36,18,18,71,12,55,40,9,6,4,0,4,7,1,0,1,5
S01010661,Occupancy rating +1,99,49,20,29,47,6,37,21,10,6,4,3,1,3,0,0,0,3
S01010661,Occupancy rating 0,77,42,26,16,31,2,16,5,6,5,13,11,2,4,0,0,2,2
S01010661,Occupancy rating -1 or less,17,5,2,3,7,1,4,2,2,0,2,1,1,5,0,0,1,4
S01010662,All households,310,70,37,33,227,32,165,68,70,27,30,21,9,13,3,0,2,8
S01010662,Occupancy rating +2 or more,199,47,28,19,146,29,108,60,36,12,9,7,2,6,1,0,1,4
S01010662,Occupancy rating +1,55,10,3,7,42,2,33,6,14,13,7,5,2,3,0,0,1,2
S01010662,Occupancy rating 0,46,10,5,5,35,1,20,2,16,2,14,9,5,1,0,0,0,1
S01010662,Occupancy rating -1 or less,10,3,1,2,4,0,4,0,4,0,0,0,0,3,2,0,0,1
S01010663,All households,381,76,38,38,285,42,219,99,85,35,24,10,14,20,4,0,1,15
S01010663,Occupancy rating +2 or more,292,56,30,26,224,39,174,92,54,28,11,5,6,12,1,0,0,11
S01010663,Occupancy rating +1,52,15,7,8,35,3,23,3,19,1,9,3,6,2,0,0,1,1
S01010663,Occupancy rating 0,31,5,1,4,22,0,18,3,10,5,4,2,2,4,2,0,0,2
S01010663,Occupancy rating -1 or less,6,0,0,0,4,0,4,1,2,1,0,0,0,2,1,0,0,1
S01010664,All households,337,74,30,44,243,38,185,87,74,24,20,11,9,20,9,0,3,8
S01010664,Occupancy rating +2 or more,264,58,25,33,198,38,147,82,49,16,13,6,7,8,3,0,1,4
S01010664,Occupancy rating +1,43,12,5,7,26,0,21,2,14,5,5,3,2,5,4,0,1,0
S01010664,Occupancy rating 0,17,4,0,4,10,0,9,1,6,2,1,1,0,3,1,0,0,2
S01010664,Occupancy rating -1 or less,13,0,0,0,9,0,8,2,5,1,1,1,0,4,1,0,1,2
S01010665,All households,430,139,68,71,271,38,193,104,67,22,40,29,11,20,7,0,0,13
S01010665,Occupancy rating +2 or more,298,93,50,43,196,35,144,85,46,13,17,12,5,9,4,0,0,5
S01010665,Occupancy rating +1,70,24,13,11,41,2,28,13,10,5,11,7,4,5,1,0,0,4
S01010665,Occupancy rating 0,42,16,5,11,23,1,14,5,8,1,8,7,1,3,1,0,0,2
S01010665,Occupancy rating -1 or less,20,6,0,6,11,0,7,1,3,3,4,3,1,3,1,0,0,2
S01010666,All households,416,132,76,56,263,41,188,75,95,18,34,23,11,21,8,0,4,9
S01010666,Occupancy rating +2 or more,231,56,37,19,164,34,116,57,49,10,14,7,7,11,2,0,4,5
S01010666,Occupancy rating +1,82,32,19,13,46,6,34,14,16,4,6,5,1,4,2,0,0,2
S01010666,Occupancy rating 0,83,39,18,21,41,1,29,4,22,3,11,8,3,3,2,0,0,1
S01010666,Occupancy rating -1 or less,20,5,2,3,12,0,9,0,8,1,3,3,0,3,2,0,0,1
S01010667,All households,288,75,29,46,205,26,164,61,79,24,15,8,7,8,1,0,2,5
S01010667,Occupancy rating +2 or more,203,52,20,32,145,21,117,48,51,18,7,3,4,6,1,0,1,4
S01010667,Occupancy rating +1,48,14,7,7,34,3,26,12,11,3,5,2,3,0,0,0,0,0
S01010667,Occupancy rating 0,30,7,1,6,22,2,17,1,13,3,3,3,0,1,0,0,1,0
S01010667,Occupancy rating -1 or less,7,2,1,1,4,0,4,0,4,0,0,0,0,1,0,0,0,1
S01010668,All households,503,159,85,74,323,51,249,133,85,31,23,13,10,21,3,0,1,17
S01010668,Occupancy rating +2 or more,304,89,54,35,205,46,157,105,33,19,2,0,2,10,2,0,0,8
S01010668,Occupancy rating +1,99,30,14,16,63,3,51,24,19,8,9,4,5,6,1,0,1,4
S01010668,Occupancy rating 0,78,30,15,15,44,2,33,4,25,4,9,6,3,4,0,0,0,4
S01010668,Occupancy rating -1 or less,22,10,2,8,11,0,8,0,8,0,3,3,0,1,0,0,0,1
S01010669,All households,266,90,48,42,162,27,124,55,45,24,11,6,5,14,6,0,4,4
S01010669,Occupancy rating +2 or more,174,58,32,26,112,21,84,46,24,14,7,2,5,4,3,0,0,1
S01010669,Occupancy rating +1,54,18,9,9,31,3,25,6,13,6,3,3,0,5,2,0,3,0
S01010669,Occupancy rating 0,28,12,6,6,14,1,12,2,7,3,1,1,0,2,1,0,1,0
S01010669,Occupancy rating -1 or less,10,2,1,1,5,2,3,1,1,1,0,0,0,3,0,0,0,3
S01010670,All households,296,82,31,51,202,31,146,72,59,15,25,15,10,12,4,0,1,7
S01010670,Occupancy rating +2 or more,186,45,18,27,137,25,102,58,32,12,10,5,5,4,4,0,0,0
S01010670,Occupancy rating +1,59,22,8,14,32,4,24,8,14,2,4,1,3,5,0,0,1,4
S01010670,Occupancy rating 0,38,11,5,6,24,1,15,3,11,1,8,6,2,3,0,0,0,3
S01010670,Occupancy rating -1 or less,13,4,0,4,9,1,5,3,2,0,3,3,0,0,0,0,0,0
S01010671,All households,329,101,38,63,212,33,145,75,54,16,34,20,14,16,6,0,0,10
S01010671,Occupancy rating +2 or more,210,62,27,35,145,29,108,67,29,12,8,3,5,3,1,0,0,2
S01010671,Occupancy rating +1,73,26,7,19,40,2,21,5,12,4,17,9,8,7,1,0,0,6
S01010671,Occupancy rating 0,36,11,4,7,21,2,14,3,11,0,5,5,0,4,3,0,0,1
S01010671,Occupancy rating -1 or less,10,2,0,2,6,0,2,0,2,0,4,3,1,2,1,0,0,1
S01010672,All households,321,123,40,83,185,23,105,49,41,15,57,41,16,13,2,0,1,10
S01010672,Occupancy rating +2 or more,144,57,23,34,80,17,54,34,13,7,9,3,6,7,2,0,1,4
S01010672,Occupancy rating +1,90,32,13,19,55,6,31,10,18,3,18,12,6,3,0,0,0,3
S01010672,Occupancy rating 0,53,18,3,15,34,0,12,2,5,5,22,20,2,1,0,0,0,1
S01010672,Occupancy rating -1 or less,34,16,1,15,16,0,8,3,5,0,8,6,2,2,0,0,0,2
S01010673,All households,419,154,56,98,245,43,171,86,57,28,31,19,12,20,8,0,0,12
S01010673,Occupancy rating +2 or more,220,62,28,34,151,34,109,63,30,16,8,4,4,7,4,0,0,3
S01010673,Occupancy rating +1,98,48,15,33,44,5,31,13,9,9,8,4,4,6,0,0,0,6
S01010673,Occupancy rating 0,78,37,12,25,36,3,24,8,14,2,9,7,2,5,3,0,0,2
S01010673,Occupancy rating -1 or less,23,7,1,6,14,1,7,2,4,1,6,4,2,2,1,0,0,1
S01010674,All households,419,134,38,96,260,30,194,95,81,18,36,26,10,25,5,0,3,17
S01010674,Occupancy rating +2 or more,231,63,23,40,156,25,124,77,36,11,7,4,3,12,1,0,2,9
S01010674,Occupancy rating +1,91,37,8,29,47,3,37,14,18,5,7,5,2,7,2,0,1,4
S01010674,Occupancy rating 0,69,25,5,20,40,1,26,4,20,2,13,12,1,4,1,0,0,3
S01010674,Occupancy rating -1 or less,28,9,2,7,17,1,7,0,7,0,9,5,4,2,1,0,0,1
S01010675,All households,273,64,38,26,194,30,149,79,50,20,15,8,7,15,4,0,4,7
S01010675,Occupancy rating +2 or more,185,37,21,16,140,27,107,67,26,14,6,0,6,8,3,0,0,5
S01010675,Occupancy rating +1,56,19,13,6,33,3,26,8,13,5,4,4,0,4,0,0,2,2
S01010675,Occupancy rating 0,27,7,4,3,17,0,12,4,8,0,5,4,1,3,1,0,2,0
S01010675,Occupancy rating -1 or less,5,1,0,1,4,0,4,0,3,1,0,0,0,0,0,0,0,0
S01010676,All households,392,131,47,84,249,42,179,90,62,27,28,11,17,12,6,0,1,5
S01010676,Occupancy rating +2 or more,229,69,31,38,155,36,106,65,23,18,13,3,10,5,2,0,0,3
S01010676,Occupancy rating +1,85,34,10,24,48,5,38,16,18,4,5,1,4,3,1,0,1,1
S01010676,Occupancy rating 0,57,22,6,16,34,1,23,4,15,4,10,7,3,1,0,0,0,1
S01010676,Occupancy rating -1 or less,21,6,0,6,12,0,12,5,6,1,0,0,0,3,3,0,0,0
S01010677,All households,224,62,29,33,157,29,108,59,35,14,20,13,7,5,2,0,2,1
S01010677,Occupancy rating +2 or more,150,40,23,17,107,21,78,46,21,11,8,4,4,3,1,0,1,1
S01010677,Occupancy rating +1,40,13,6,7,26,8,15,9,5,1,3,0,3,1,1,0,0,0
S01010677,Occupancy rating 0,20,4,0,4,15,0,9,2,6,1,6,6,0,1,0,0,1,0
S01010677,Occupancy rating -1 or less,14,5,0,5,9,0,6,2,3,1,3,3,0,0,0,0,0,0
S01010678,All households,273,80,35,45,177,18,135,65,51,19,24,7,17,16,2,0,3,11
S01010678,Occupancy rating +2 or more,175,52,23,29,117,18,92,52,26,14,7,1,6,6,1,0,0,5
S01010678,Occupancy rating +1,60,16,9,7,37,0,29,12,12,5,8,3,5,7,0,0,1,6
S01010678,Occupancy rating 0,27,9,3,6,16,0,11,1,10,0,5,1,4,2,1,0,1,0
S01010678,Occupancy rating -1 or less,11,3,0,3,7,0,3,0,3,0,4,2,2,1,0,0,1,0
S01010679,All households,282,113,42,71,157,18,113,67,33,13,26,15,11,12,2,0,2,8
S01010679,Occupancy rating +2 or more,127,44,20,24,81,16,59,47,8,4,6,1,5,2,1,0,0,1
S01010679,Occupancy rating +1,71,28,11,17,39,2,33,18,10,5,4,1,3,4,1,0,1,2
S01010679,Occupancy rating 0,68,31,10,21,32,0,17,2,11,4,15,12,3,5,0,0,0,5
S01010679,Occupancy rating -1 or less,16,10,1,9,5,0,4,0,4,0,1,1,0,1,0,0,1,0
S01010680,All households,315,135,63,72,158,17,105,57,36,12,36,25,11,22,3,0,0,19
S01010680,Occupancy rating +2 or more,129,54,24,30,70,13,53,40,9,4,4,0,4,5,0,0,0,5
S01010680,Occupancy rating +1,83,29,9,20,45,1,29,15,12,2,15,9,6,9,1,0,0,8
S01010680,Occupancy rating 0,78,33,19,14,39,3,20,2,13,5,16,15,1,6,1,0,0,5
S01010680,Occupancy rating -1 or less,25,19,11,8,4,0,3,0,2,1,1,1,0,2,1,0,0,1
S01010681,All households,461,170,40,130,271,12,197,72,109,16,62,46,16,20,7,0,1,12
S01010681,Occupancy rating +2 or more,172,60,20,40,104,11,86,51,29,6,7,4,3,8,3,0,1,4
S01010681,Occupancy rating +1,147,52,12,40,90,1,63,14,40,9,26,16,10,5,1,0,0,4
S01010681,Occupancy rating 0,101,33,8,25,63,0,36,3,32,1,27,25,2,5,2,0,0,3
S01010681,Occupancy rating -1 or less,41,25,0,25,14,0,12,4,8,0,2,1,1,2,1,0,0,1
S01010682,All households,398,97,41,56,282,29,228,110,87,31,25,15,10,19,6,0,1,12
S01010682,Occupancy rating +2 or more,284,68,35,33,208,24,169,94,53,22,15,8,7,8,2,0,1,5
S01010682,Occupancy rating +1,66,23,4,19,38,4,30,11,14,5,4,3,1,5,1,0,0,4
S01010682,Occupancy rating 0,40,6,2,4,28,1,23,3,16,4,4,3,1,6,3,0,0,3
S01010682,Occupancy rating -1 or less,8,0,0,0,8,0,6,2,4,0,2,1,1,0,0,0,0,0
S01010683,All households,423,124,63,61,271,37,214,111,75,28,20,6,14,28,8,0,2,18
S01010683,Occupancy rating +2 or more,290,76,40,36,201,35,158,93,44,21,8,1,7,13,3,0,1,9
S01010683,Occupancy rating +1,76,27,12,15,41,2,33,12,16,5,6,2,4,8,2,0,0,6
S01010683,Occupancy rating 0,44,16,9,7,24,0,19,4,13,2,5,2,3,4,2,0,0,2
S01010683,Occupancy rating -1 or less,13,5,2,3,5,0,4,2,2,0,1,1,0,3,1,0,1,1
S01010684,All households,361,102,58,44,241,42,178,103,48,27,21,14,7,18,2,0,2,14
S01010684,Occupancy rating +2 or more,262,68,38,30,183,37,138,89,31,18,8,5,3,11,1,0,1,9
S01010684,Occupancy rating +1,63,22,13,9,38,5,24,9,10,5,9,5,4,3,0,0,1,2
S01010684,Occupancy rating 0,31,10,6,4,17,0,13,4,5,4,4,4,0,4,1,0,0,3
S01010684,Occupancy rating -1 or less,5,2,1,1,3,0,3,1,2,0,0,0,0,0,0,0,0,0
S01010685,All households,294,96,49,47,186,26,144,93,34,17,16,11,5,12,5,0,4,3
S01010685,Occupancy rating +2 or more,202,65,31,34,130,23,101,76,14,11,6,4,2,7,3,0,1,3
S01010685,Occupancy rating +1,50,19,9,10,30,0,26,12,9,5,4,2,2,1,0,0,1,0
S01010685,Occupancy rating 0,31,10,7,3,20,2,12,4,7,1,6,5,1,1,0,0,1,0
S01010685,Occupancy rating -1 or less,11,2,2,0,6,1,5,1,4,0,0,0,0,3,2,0,1,0
S01010686,All households,309,94,46,48,201,29,147,74,57,16,25,13,12,14,6,0,3,5
S01010686,Occupancy rating +2 or more,210,58,33,25,144,27,107,60,36,11,10,3,7,8,4,0,2,2
S01010686,Occupancy rating +1,51,21,8,13,29,1,23,9,13,1,5,3,2,1,0,0,1,0
S01010686,Occupancy rating 0,36,13,5,8,20,0,13,4,6,3,7,5,2,3,0,0,0,3
S01010686,Occupancy rating -1 or less,12,2,0,2,8,1,4,1,2,1,3,2,1,2,2,0,0,0
S01010687,All households,379,133,73,60,231,38,172,81,65,26,21,15,6,15,7,0,0,8
S01010687,Occupancy rating +2 or more,255,86,51,35,162,33,122,66,34,22,7,4,3,7,3,0,0,4
S01010687,Occupancy rating +1,72,30,12,18,40,2,30,13,16,1,8,5,3,2,0,0,0,2
S01010687,Occupancy rating 0,42,13,9,4,25,3,16,2,12,2,6,6,0,4,2,0,0,2
S01010687,Occupancy rating -1 or less,10,4,1,3,4,0,4,0,3,1,0,0,0,2,2,0,0,0
S01010688,All households,335,124,47,77,202,42,135,66,52,17,25,8,17,9,2,0,0,7
S01010688,Occupancy rating +2 or more,221,74,32,42,143,39,93,57,23,13,11,3,8,4,0,0,0,4
S01010688,Occupancy rating +1,70,37,12,25,31,3,22,9,13,0,6,2,4,2,1,0,0,1
S01010688,Occupancy rating 0,31,10,3,7,19,0,14,0,12,2,5,3,2,2,1,0,0,1
S01010688,Occupancy rating -1 or less,13,3,0,3,9,0,6,0,4,2,3,0,3,1,0,0,0,1
S01010689,All households,378,132,83,49,235,51,165,108,40,17,19,9,10,11,5,0,0,6
S01010689,Occupancy rating +2 or more,267,83,50,33,179,46,127,96,18,13,6,2,4,5,4,0,0,1
S01010689,Occupancy rating +1,61,23,13,10,34,5,21,10,9,2,8,4,4,4,0,0,0,4
S01010689,Occupancy rating 0,41,21,16,5,18,0,14,1,11,2,4,2,2,2,1,0,0,1
S01010689,Occupancy rating -1 or less,9,5,4,1,4,0,3,1,2,0,1,1,0,0,0,0,0,0
S01010690,All households,330,145,78,67,170,20,121,57,56,8,29,19,10,15,2,0,1,12
S01010690,Occupancy rating +2 or more,164,69,39,30,91,17,71,45,23,3,3,2,1,4,0,0,0,4
S01010690,Occupancy rating +1,64,23,12,11,34,2,23,10,9,4,9,5,4,7,2,0,1,4
S01010690,Occupancy rating 0,79,37,22,15,39,1,23,0,22,1,15,11,4,3,0,0,0,3
S01010690,Occupancy rating -1 or less,23,16,5,11,6,0,4,2,2,0,2,1,1,1,0,0,0,1
S01010691,All households,325,88,39,49,218,33,161,92,55,14,24,14,10,19,7,0,2,10
S01010691,Occupancy rating +2 or more,222,63,30,33,150,30,112,68,35,9,8,4,4,9,1,0,1,7
S01010691,Occupancy rating +1,62,14,6,8,44,2,34,17,15,2,8,4,4,4,3,0,0,1
S01010691,Occupancy rating 0,24,6,1,5,16,1,11,5,3,3,4,2,2,2,2,0,0,0
S01010691,Occupancy rating -1 or less,17,5,2,3,8,0,4,2,2,0,4,4,0,4,1,0,1,2
S01010692,All households,307,92,34,58,199,20,144,53,72,19,35,24,11,16,6,0,2,8
S01010692,Occupancy rating +2 or more,127,33,16,17,87,15,69,36,24,9,3,2,1,7,3,0,2,2
S01010692,Occupancy rating +1,91,44,12,32,46,3,37,15,16,6,6,1,5,1,1,0,0,0
S01010692,Occupancy rating 0,69,14,6,8,49,0,28,2,23,3,21,16,5,6,1,0,0,5
S01010692,Occupancy rating -1 or less,20,1,0,1,17,2,10,0,9,1,5,5,0,2,1,0,0,1
S01010693,All households,216,68,28,40,142,28,105,54,39,12,9,6,3,6,0,0,1,5
S01010693,Occupancy rating +2 or more,148,40,22,18,107,25,77,49,19,9,5,5,0,1,0,0,0,1
S01010693,Occupancy rating +1,44,17,5,12,23,2,18,4,12,2,3,1,2,4,0,0,1,3
S01010693,Occupancy rating 0,18,7,0,7,11,1,9,1,7,1,1,0,1,0,0,0,0,0
S01010693,Occupancy rating -1 or less,6,4,1,3,1,0,1,0,1,0,0,0,0,1,0,0,0,1
S01010694,All households,270,91,51,40,172,34,121,65,35,21,17,9,8,7,1,0,2,4
S01010694,Occupancy rating +2 or more,195,64,41,23,127,29,89,54,19,16,9,4,5,4,1,0,1,2
S01010694,Occupancy rating +1,52,22,9,13,28,5,19,9,8,2,4,2,2,2,0,0,0,2
S01010694,Occupancy rating 0,17,4,1,3,12,0,10,2,6,2,2,2,0,1,0,0,1,0
S01010694,Occupancy rating -1 or less,6,1,0,1,5,0,3,0,2,1,2,1,1,0,0,0,0,0
S01010695,All households,304,81,30,51,209,35,157,75,49,33,17,12,5,14,7,0,1,6
S01010695,Occupancy rating +2 or more,220,52,25,27,159,29,122,64,32,26,8,6,2,9,5,0,0,4
S01010695,Occupancy rating +1,49,19,4,15,28,4,18,7,8,3,6,3,3,2,0,0,1,1
S01010695,Occupancy rating 0,26,10,1,9,14,2,10,1,8,1,2,2,0,2,1,0,0,1
S01010695,Occupancy rating -1 or less,9,0,0,0,8,0,7,3,1,3,1,1,0,1,1,0,0,0
S01010696,All households,402,111,48,63,267,47,189,75,84,30,31,22,9,24,12,0,1,11
S01010696,Occupancy rating +2 or more,218,55,28,27,155,36,115,58,42,15,4,4,0,8,5,0,1,2
S01010696,Occupancy rating +1,98,29,11,18,63,9,40,14,19,7,14,6,8,6,2,0,0,4
S01010696,Occupancy rating 0,71,27,9,18,40,2,27,3,17,7,11,10,1,4,1,0,0,3
S01010696,Occupancy rating -1 or less,15,0,0,0,9,0,7,0,6,1,2,2,0,6,4,0,0,2
S01010697,All households,458,132,52,80,302,58,219,84,102,33,25,16,9,24,11,0,1,12
S01010697,Occupancy rating +2 or more,333,102,46,56,221,50,161,76,65,20,10,7,3,10,4,0,0,6
S01010697,Occupancy rating +1,66,15,2,13,48,6,37,7,21,9,5,5,0,3,1,0,0,2
S01010697,Occupancy rating 0,41,8,2,6,26,1,19,1,14,4,6,3,3,7,5,0,0,2
S01010697,Occupancy rating -1 or less,18,7,2,5,7,1,2,0,2,0,4,1,3,4,1,0,1,2
S01010698,All households,338,104,46,58,214,29,144,77,51,16,41,32,9,20,5,0,1,14
S01010698,Occupancy rating +2 or more,215,71,29,42,133,25,99,63,27,9,9,5,4,11,3,0,1,7
S01010698,Occupancy rating +1,75,26,15,11,45,4,33,12,14,7,8,6,2,4,1,0,0,3
S01010698,Occupancy rating 0,37,4,2,2,29,0,11,2,9,0,18,15,3,4,0,0,0,4
S01010698,Occupancy rating -1 or less,11,3,0,3,7,0,1,0,1,0,6,6,0,1,1,0,0,0
S01010699,All households,250,63,16,47,175,19,141,63,59,19,15,7,8,12,3,0,1,8
S01010699,Occupancy rating +2 or more,161,38,10,28,116,18,89,51,26,12,9,3,6,7,0,0,1,6
S01010699,Occupancy rating +1,48,18,3,15,28,1,25,9,12,4,2,1,1,2,1,0,0,1
S01010699,Occupancy rating 0,28,5,2,3,21,0,19,2,16,1,2,1,1,2,1,0,0,1
S01010699,Occupancy rating -1 or less,13,2,1,1,10,0,8,1,5,2,2,2,0,1,1,0,0,0
S01010700,All households,258,67,26,41,174,28,132,56,58,18,14,6,8,17,6,0,2,9
S01010700,Occupancy rating +2 or more,182,42,17,25,130,25,100,46,39,15,5,0,5,10,3,0,1,6
S01010700,Occupancy rating +1,48,16,4,12,28,1,23,9,12,2,4,1,3,4,1,0,0,3
S01010700,Occupancy rating 0,22,8,5,3,12,2,6,1,4,1,4,4,0,2,1,0,1,0
S01010700,Occupancy rating -1 or less,6,1,0,1,4,0,3,0,3,0,1,1,0,1,1,0,0,0
S01010701,All households,432,111,54,57,301,31,226,88,103,35,44,29,15,20,5,0,1,14
S01010701,Occupancy rating +2 or more,230,57,28,29,163,18,136,67,49,20,9,5,4,10,2,0,1,7
S01010701,Occupancy rating +1,124,41,23,18,79,12,53,19,24,10,14,10,4,4,1,0,0,3
S01010701,Occupancy rating 0,60,10,1,9,47,1,33,1,28,4,13,9,4,3,0,0,0,3
S01010701,Occupancy rating -1 or less,18,3,2,1,12,0,4,1,2,1,8,5,3,3,2,0,0,1
S01010702,All households,417,102,49,53,298,53,227,122,71,34,18,8,10,17,4,0,0,13
S01010702,Occupancy rating +2 or more,323,77,36,41,234,41,179,108,47,24,14,7,7,12,4,0,0,8
S01010702,Occupancy rating +1,67,18,11,7,47,9,36,14,17,5,2,1,1,2,0,0,0,2
S01010702,Occupancy rating 0,16,2,1,1,12,2,8,0,5,3,2,0,2,2,0,0,0,2
S01010702,Occupancy rating -1 or less,11,5,1,4,5,1,4,0,2,2,0,0,0,1,0,0,0,1
S01010703,All households,341,70,30,40,254,44,186,88,69,29,24,10,14,17,5,0,2,10
S01010703,Occupancy rating +2 or more,259,52,25,27,196,42,143,77,45,21,11,5,6,11,4,0,1,6
S01010703,Occupancy rating +1,52,14,2,12,35,2,27,9,12,6,6,1,5,3,0,0,1,2
S01010703,Occupancy rating 0,23,3,2,1,19,0,12,2,9,1,7,4,3,1,1,0,0,0
S01010703,Occupancy rating -1 or less,7,1,1,0,4,0,4,0,3,1,0,0,0,2,0,0,0,2
S01010704,All households,300,105,53,52,181,30,121,47,51,23,30,24,6,14,3,0,3,8
S01010704,Occupancy rating +2 or more,135,42,15,27,91,19,66,33,19,14,6,6,0,2,0,0,0,2
S01010704,Occupancy rating +1,84,29,16,13,49,6,32,10,15,7,11,8,3,6,1,0,0,5
S01010704,Occupancy rating 0,61,25,19,6,33,5,20,3,15,2,8,5,3,3,0,0,3,0
S01010704,Occupancy rating -1 or less,20,9,3,6,8,0,3,1,2,0,5,5,0,3,2,0,0,1
S01010705,All households,463,112,52,60,333,40,244,103,108,33,49,32,17,18,7,0,3,8
S01010705,Occupancy rating +2 or more,260,55,34,21,197,39,152,78,53,21,6,3,3,8,3,0,2,3
S01010705,Occupancy rating +1,107,48,16,32,58,1,44,19,20,5,13,7,6,1,0,0,0,1
S01010705,Occupancy rating 0,80,7,2,5,65,0,40,5,29,6,25,19,6,8,3,0,1,4
S01010705,Occupancy rating -1 or less,16,2,0,2,13,0,8,1,6,1,5,3,2,1,1,0,0,0
S01010706,All households,293,89,28,61,196,18,138,65,58,15,40,30,10,8,5,0,0,3
S01010706,Occupancy rating +2 or more,111,28,8,20,82,9,69,41,21,7,4,3,1,1,1,0,0,0
S01010706,Occupancy rating +1,96,45,15,30,50,7,34,20,11,3,9,5,4,1,0,0,0,1
S01010706,Occupancy rating 0,66,11,4,7,50,1,29,4,20,5,20,17,3,5,3,0,0,2
S01010706,Occupancy rating -1 or less,20,5,1,4,14,1,6,0,6,0,7,5,2,1,1,0,0,0
S01010707,All households,265,53,27,26,189,26,157,76,52,29,6,1,5,23,9,0,4,10
S01010707,Occupancy rating +2 or more,201,36,20,16,149,23,126,70,35,21,0,0,0,16,6,0,1,9
S01010707,Occupancy rating +1,41,15,6,9,22,3,16,6,7,3,3,1,2,4,1,0,3,0
S01010707,Occupancy rating 0,19,1,0,1,16,0,13,0,8,5,3,0,3,2,1,0,0,1
S01010707,Occupancy rating -1 or less,4,1,1,0,2,0,2,0,2,0,0,0,0,1,1,0,0,0
S01010708,All households,252,85,48,37,157,18,108,51,41,16,31,13,18,10,4,0,0,6
S01010708,Occupancy rating +2 or more,129,55,35,20,72,14,54,35,14,5,4,0,4,2,0,0,0,2
S01010708,Occupancy rating +1,77,23,11,12,49,3,32,13,12,7,14,5,9,5,1,0,0,4
S01010708,Occupancy rating 0,39,7,2,5,31,1,18,3,11,4,12,7,5,1,1,0,0,0
S01010708,Occupancy rating -1 or less,7,0,0,0,5,0,4,0,4,0,1,1,0,2,2,0,0,0
S01010709,All households,299,72,44,28,219,22,171,64,78,29,26,18,8,8,3,0,0,5
S01010709,Occupancy rating +2 or more,172,48,35,13,123,18,100,44,44,12,5,3,2,1,0,0,0,1
S01010709,Occupancy rating +1,72,14,5,9,56,4,44,17,18,9,8,7,1,2,0,0,0,2
S01010709,Occupancy rating 0,45,9,4,5,32,0,23,3,13,7,9,5,4,4,2,0,0,2
S01010709,Occupancy rating -1 or less,10,1,0,1,8,0,4,0,3,1,4,3,1,1,1,0,0,0
S01010710,All households,316,87,39,48,216,23,138,61,55,22,55,31,24,13,6,0,1,6
S01010710,Occupancy rating +2 or more,126,36,17,19,89,17,64,39,17,8,8,6,2,1,0,0,0,1
S01010710,Occupancy rating +1,87,26,13,13,57,5,28,14,8,6,24,9,15,4,1,0,0,3
S01010710,Occupancy rating 0,70,16,9,7,49,1,32,6,20,6,16,10,6,5,2,0,1,2
S01010710,Occupancy rating -1 or less,33,9,0,9,21,0,14,2,10,2,7,6,1,3,3,0,0,0
S01010711,All households,319,78,46,32,231,35,177,71,79,27,19,12,7,10,0,0,2,8
S01010711,Occupancy rating +2 or more,237,48,33,15,181,33,140,61,55,24,8,6,2,8,0,0,2,6
S01010711,Occupancy rating +1,44,14,6,8,28,2,22,7,12,3,4,1,3,2,0,0,0,2
S01010711,Occupancy rating 0,30,14,7,7,16,0,9,2,7,0,7,5,2,0,0,0,0,0
S01010711,Occupancy rating -1 or less,8,2,0,2,6,0,6,1,5,0,0,0,0,0,0,0,0,0
S01010712,All households,269,56,22,34,192,15,135,43,68,24,42,28,14,21,6,0,1,14
S01010712,Occupancy rating +2 or more,124,29,10,19,90,12,67,35,20,12,11,3,8,5,1,0,0,4
S01010712,Occupancy rating +1,69,15,5,10,46,2,32,6,18,8,12,8,4,8,1,0,0,7
S01010712,Occupancy rating 0,64,10,6,4,49,1,30,2,24,4,18,16,2,5,3,0,0,2
S01010712,Occupancy rating -1 or less,12,2,1,1,7,0,6,0,6,0,1,1,0,3,1,0,1,1
S01010713,All households,322,77,39,38,216,21,153,62,69,22,42,24,18,29,9,0,1,19
S01010713,Occupancy rating +2 or more,148,53,30,23,90,17,69,49,13,7,4,3,1,5,0,0,1,4
S01010713,Occupancy rating +1,82,12,5,7,59,3,44,11,22,11,12,4,8,11,2,0,0,9
S01010713,Occupancy rating 0,75,11,4,7,57,1,34,2,29,3,22,14,8,7,1,0,0,6
S01010713,Occupancy rating -1 or less,17,1,0,1,10,0,6,0,5,1,4,3,1,6,6,0,0,0
S01010714,All households,380,166,77,89,188,22,108,54,43,11,58,38,20,26,5,0,5,16
S01010714,Occupancy rating +2 or more,81,33,17,16,42,10,29,20,7,2,3,1,2,6,2,0,2,2
S01010714,Occupancy rating +1,128,68,29,39,55,10,36,24,9,3,9,5,4,5,0,0,1,4
S01010714,Occupancy rating 0,139,54,27,27,76,2,38,10,22,6,36,24,12,9,0,0,2,7
S01010714,Occupancy rating -1 or less,32,11,4,7,15,0,5,0,5,0,10,8,2,6,3,0,0,3
S01010715,All households,340,129,61,68,195,35,117,53,44,20,43,23,20,16,5,0,1,10
S01010715,Occupancy rating +2 or more,138,50,28,22,85,22,58,33,17,8,5,3,2,3,1,0,0,2
S01010715,Occupancy rating +1,104,45,19,26,50,9,32,15,9,8,9,3,6,9,3,0,1,5
S01010715,Occupancy rating 0,81,31,14,17,48,3,24,5,15,4,21,12,9,2,0,0,0,2
S01010715,Occupancy rating -1 or less,17,3,0,3,12,1,3,0,3,0,8,5,3,2,1,0,0,1
S01010716,All households,444,202,64,138,209,26,147,67,52,28,36,24,12,33,5,0,4,24
S01010716,Occupancy rating +2 or more,131,49,23,26,75,14,55,28,12,15,6,0,6,7,2,0,1,4
S01010716,Occupancy rating +1,129,73,23,50,54,10,37,21,13,3,7,6,1,2,1,0,0,1
S01010716,Occupancy rating 0,124,51,15,36,55,1,38,11,20,7,16,12,4,18,1,0,3,14
S01010716,Occupancy rating -1 or less,60,29,3,26,25,1,17,7,7,3,7,6,1,6,1,0,0,5
S01010717,All households,272,66,39,27,196,40,133,59,50,24,23,6,17,10,2,0,4,4
S01010717,Occupancy rating +2 or more,194,53,33,20,133,40,84,47,21,16,9,2,7,8,1,0,4,3
S01010717,Occupancy rating +1,54,10,5,5,44,0,36,12,17,7,8,2,6,0,0,0,0,0
S01010717,Occupancy rating 0,23,2,1,1,19,0,13,0,12,1,6,2,4,2,1,0,0,1
S01010717,Occupancy rating -1 or less,1,1,0,1,0,0,0,0,0,0,0,0,0,0,0,0,0,0
S01010718,All households,393,101,32,69,272,31,204,78,90,36,37,24,13,20,4,0,1,15
S01010718,Occupancy rating +2 or more,217,38,20,18,173,25,143,62,55,26,5,3,2,6,1,0,1,4
S01010718,Occupancy rating +1,78,28,5,23,43,4,30,7,18,5,9,3,6,7,0,0,0,7
S01010718,Occupancy rating 0,73,25,5,20,45,2,23,7,13,3,20,15,5,3,1,0,0,2
S01010718,Occupancy rating -1 or less,25,10,2,8,11,0,8,2,4,2,3,3,0,4,2,0,0,2
S01010719,All households,282,94,45,49,180,30,127,47,60,20,23,13,10,8,2,0,0,6
S01010719,Occupancy rating +2 or more,140,42,24,18,94,22,65,30,27,8,7,6,1,4,0,0,0,4
S01010719,Occupancy rating +1,93,37,14,23,54,7,39,15,19,5,8,3,5,2,1,0,0,1
S01010719,Occupancy rating 0,37,13,6,7,22,1,17,1,10,6,4,1,3,2,1,0,0,1
S01010719,Occupancy rating -1 or less,12,2,1,1,10,0,6,1,4,1,4,3,1,0,0,0,0,0
S01010720,All households,336,112,84,28,210,45,139,52,53,34,26,16,10,14,3,0,1,10
S01010720,Occupancy rating +2 or more,227,61,47,14,156,40,108,49,36,23,8,4,4,10,2,0,0,8
S01010720,Occupancy rating +1,50,19,15,4,29,3,20,2,9,9,6,2,4,2,1,0,0,1
S01010720,Occupancy rating 0,51,29,21,8,20,2,8,1,5,2,10,9,1,2,0,0,1,1
S01010720,Occupancy rating -1 or less,8,3,1,2,5,0,3,0,3,0,2,1,1,0,0,0,0,0
S01010721,All households,296,92,43,49,195,35,144,76,48,20,16,7,9,9,3,0,2,4
S01010721,Occupancy rating +2 or more,201,57,30,27,140,34,99,56,27,16,7,1,6,4,1,0,1,2
S01010721,Occupancy rating +1,66,28,11,17,36,1,31,17,11,3,4,3,1,2,1,0,1,0
S01010721,Occupancy rating 0,20,4,2,2,13,0,9,2,7,0,4,2,2,3,1,0,0,2
S01010721,Occupancy rating -1 or less,9,3,0,3,6,0,5,1,3,1,1,1,0,0,0,0,0,0
S01010722,All households,394,130,77,53,240,37,162,76,70,16,41,30,11,24,10,0,7,7
S01010722,Occupancy rating +2 or more,196,67,47,20,120,26,85,51,27,7,9,6,3,9,4,0,2,3
S01010722,Occupancy rating +1,89,31,12,19,56,8,42,21,19,2,6,3,3,2,0,0,2,0
S01010722,Occupancy rating 0,84,24,16,8,53,3,28,2,21,5,22,17,5,7,2,0,3,2
S01010722,Occupancy rating -1 or less,25,8,2,6,11,0,7,2,3,2,4,4,0,6,4,0,0,2
S01010723,All households,329,60,28,32,249,24,209,84,94,31,16,11,5,20,10,0,0,10
S01010723,Occupancy rating +2 or more,248,40,20,20,195,23,165,68,73,24,7,5,2,13,5,0,0,8
S01010723,Occupancy rating +1,41,13,4,9,27,1,25,12,9,4,1,0,1,1,0,0,0,1
S01010723,Occupancy rating 0,31,5,2,3,22,0,15,4,8,3,7,5,2,4,4,0,0,0
S01010723,Occupancy rating -1 or less,9,2,2,0,5,0,4,0,4,0,1,1,0,2,1,0,0,1
S01010724,All households,354,74,43,31,264,34,198,86,88,24,32,16,16,16,5,0,1,10
S01010724,Occupancy rating +2 or more,225,39,24,15,179,27,144,71,54,19,8,3,5,7,2,0,1,4
S01010724,Occupancy rating +1,75,24,15,9,50,6,31,13,16,2,13,5,8,1,0,0,0,1
S01010724,Occupancy rating 0,43,10,4,6,27,1,19,2,14,3,7,5,2,6,2,0,0,4
S01010724,Occupancy rating -1 or less,11,1,0,1,8,0,4,0,4,0,4,3,1,2,1,0,0,1
S01010725,All households,287,67,30,37,204,31,161,77,50,34,12,8,4,16,4,0,0,12
S01010725,Occupancy rating +2 or more,232,53,27,26,169,29,134,70,40,24,6,3,3,10,1,0,0,9
S01010725,Occupancy rating +1,34,9,1,8,21,2,15,4,5,6,4,3,1,4,2,0,0,2
S01010725,Occupancy rating 0,14,3,1,2,10,0,8,1,4,3,2,2,0,1,0,0,0,1
S01010725,Occupancy rating -1 or less,7,2,1,1,4,0,4,2,1,1,0,0,0,1,1,0,0,0
S01010726,All households,415,122,65,57,278,62,183,91,62,30,33,17,16,15,9,0,0,6
S01010726,Occupancy rating +2 or more,289,69,38,31,212,57,143,80,43,20,12,4,8,8,5,0,0,3
S01010726,Occupancy rating +1,72,34,15,19,35,4,28,10,12,6,3,0,3,3,2,0,0,1
S01010726,Occupancy rating 0,47,17,11,6,28,1,11,1,6,4,16,13,3,2,0,0,0,2
S01010726,Occupancy rating -1 or less,7,2,1,1,3,0,1,0,1,0,2,0,2,2,2,0,0,0
S01010727,All households,243,38,22,16,193,27,158,71,67,20,8,2,6,12,6,0,1,5
S01010727,Occupancy rating +2 or more,189,26,17,9,154,23,127,68,46,13,4,1,3,9,5,0,0,4
S01010727,Occupancy rating +1,23,5,2,3,16,3,11,2,8,1,2,0,2,2,1,0,0,1
S01010727,Occupancy rating 0,22,3,1,2,18,1,16,1,9,6,1,0,1,1,0,0,1,0
S01010727,Occupancy rating -1 or less,9,4,2,2,5,0,4,0,4,0,1,1,0,0,0,0,0,0
S01010728,All households,204,33,13,20,165,32,123,53,60,10,10,3,7,6,4,0,0,2
S01010728,Occupancy rating +2 or more,163,24,11,13,137,28,104,49,47,8,5,1,4,2,1,0,0,1
S01010728,Occupancy rating +1,29,7,0,7,19,3,13,1,10,2,3,1,2,3,2,0,0,1
S01010728,Occupancy rating 0,9,1,1,0,7,1,5,3,2,0,1,0,1,1,1,0,0,0
S01010728,Occupancy rating -1 or less,3,1,1,0,2,0,1,0,1,0,1,1,0,0,0,0,0,0
S01010729,All households,269,44,24,20,210,24,177,70,71,36,9,5,4,15,7,0,3,5
S01010729,Occupancy rating +2 or more,193,34,20,14,153,24,125,61,43,21,4,2,2,6,2,0,2,2
S01010729,Occupancy rating +1,46,6,4,2,36,0,34,8,15,11,2,1,1,4,3,0,0,1
S01010729,Occupancy rating 0,26,4,0,4,19,0,16,1,12,3,3,2,1,3,2,0,0,1
S01010729,Occupancy rating -1 or less,4,0,0,0,2,0,2,0,1,1,0,0,0,2,0,0,1,1
S01010730,All households,343,73,35,38,248,32,189,93,77,19,27,18,9,22,7,0,2,13
S01010730,Occupancy rating +2 or more,268,57,30,27,197,31,149,83,49,17,17,9,8,14,4,0,2,8
S01010730,Occupancy rating +1,50,12,5,7,33,0,28,7,20,1,5,4,1,5,1,0,0,4
S01010730,Occupancy rating 0,20,4,0,4,14,1,11,2,8,1,2,2,0,2,1,0,0,1
S01010730,Occupancy rating -1 or less,5,0,0,0,4,0,1,1,0,0,3,3,0,1,1,0,0,0
S01010731,All households,399,134,66,68,246,25,185,81,75,29,36,27,9,19,4,0,1,14
S01010731,Occupancy rating +2 or more,219,67,30,37,145,21,117,59,45,13,7,4,3,7,1,0,0,6
S01010731,Occupancy rating +1,97,36,17,19,55,3,39,16,12,11,13,9,4,6,1,0,1,4
S01010731,Occupancy rating 0,63,23,13,10,34,1,20,5,13,2,13,11,2,6,2,0,0,4
S01010731,Occupancy rating -1 or less,20,8,6,2,12,0,9,1,5,3,3,3,0,0,0,0,0,0
S01010732,All households,334,80,29,51,229,15,147,63,52,32,67,49,18,25,8,1,2,14
S01010732,Occupancy rating +2 or more,137,42,14,28,93,11,75,52,14,9,7,4,3,2,0,0,0,2
S01010732,Occupancy rating +1,88,22,7,15,57,3,30,8,12,10,24,19,5,9,3,0,2,4
S01010732,Occupancy rating 0,71,13,7,6,53,0,32,3,19,10,21,13,8,5,1,0,0,4
S01010732,Occupancy rating -1 or less,38,3,1,2,26,1,10,0,7,3,15,13,2,9,4,1,0,4
S01010733,All households,246,80,27,53,153,7,95,33,48,14,51,41,10,13,4,0,1,8
S01010733,Occupancy rating +2 or more,72,32,11,21,39,2,34,21,9,4,3,2,1,1,0,0,0,1
S01010733,Occupancy rating +1,91,36,13,23,49,3,33,11,15,7,13,8,5,6,1,0,1,4
S01010733,Occupancy rating 0,57,6,2,4,48,2,16,0,14,2,30,27,3,3,1,0,0,2
S01010733,Occupancy rating -1 or less,26,6,1,5,17,0,12,1,10,1,5,4,1,3,2,0,0,1
S01010734,All households,362,109,34,75,232,15,152,56,75,21,65,53,12,21,10,0,0,11
S01010734,Occupancy rating +2 or more,137,42,15,27,94,12,72,41,26,5,10,8,2,1,0,0,0,1
S01010734,Occupancy rating +1,113,44,13,31,65,2,42,11,22,9,21,16,5,4,0,0,0,4
S01010734,Occupancy rating 0,81,19,6,13,50,1,26,4,16,6,23,19,4,12,8,0,0,4
S01010734,Occupancy rating -1 or less,31,4,0,4,23,0,12,0,11,1,11,10,1,4,2,0,0,2
S01010735,All households,244,55,13,42,178,6,117,32,72,13,55,44,11,11,7,0,0,4
S01010735,Occupancy rating +2 or more,115,42,11,31,72,3,53,26,21,6,16,11,5,1,1,0,0,0
S01010735,Occupancy rating +1,66,6,1,5,58,2,37,1,31,5,19,15,4,2,1,0,0,1
S01010735,Occupancy rating 0,44,4,1,3,35,1,19,2,16,1,15,13,2,5,4,0,0,1
S01010735,Occupancy rating -1 or less,19,3,0,3,13,0,8,3,4,1,5,5,0,3,1,0,0,2
S01010736,All households,218,50,28,22,160,26,121,60,49,12,13,6,7,8,2,0,1,5
S01010736,Occupancy rating +2 or more,137,36,24,12,98,18,77,50,19,8,3,2,1,3,0,0,1,2
S01010736,Occupancy rating +1,58,14,4,10,42,7,29,10,16,3,6,2,4,2,1,0,0,1
S01010736,Occupancy rating 0,22,0,0,0,19,1,14,0,13,1,4,2,2,3,1,0,0,2
S01010736,Occupancy rating -1 or less,1,0,0,0,1,0,1,0,1,0,0,0,0,0,0,0,0,0
S01010737,All households,487,172,95,77,294,46,195,96,70,29,53,36,17,21,9,0,1,11
S01010737,Occupancy rating +2 or more,206,61,35,26,140,30,103,67,25,11,7,5,2,5,2,0,1,2
S01010737,Occupancy rating +1,163,63,31,32,93,15,59,25,27,7,19,12,7,7,1,0,0,6
S01010737,Occupancy rating 0,97,42,26,16,49,0,27,4,14,9,22,18,4,6,3,0,0,3
S01010737,Occupancy rating -1 or less,21,6,3,3,12,1,6,0,4,2,5,1,4,3,3,0,0,0
S01010738,All households,235,58,29,29,168,21,110,47,38,25,37,16,21,9,3,0,1,5
S01010738,Occupancy rating +2 or more,101,32,17,15,69,11,53,39,10,4,5,2,3,0,0,0,0,0
S01010738,Occupancy rating +1,75,19,10,9,53,8,33,7,10,16,12,3,9,3,0,0,0,3
S01010738,Occupancy rating 0,46,6,1,5,35,2,19,1,14,4,14,9,5,5,3,0,0,2
S01010738,Occupancy rating -1 or less,13,1,1,0,11,0,5,0,4,1,6,2,4,1,0,0,1,0
S01010739,All households,388,116,39,77,247,30,171,83,74,14,46,32,14,25,4,0,0,21
S01010739,Occupancy rating +2 or more,149,46,16,30,95,20,73,56,14,3,2,0,2,8,0,0,0,8
S01010739,Occupancy rating +1,132,45,13,32,80,9,52,25,21,6,19,13,6,7,1,0,0,6
S01010739,Occupancy rating 0,88,20,9,11,61,1,39,1,34,4,21,17,4,7,2,0,0,5
S01010739,Occupancy rating -1 or less,19,5,1,4,11,0,7,1,5,1,4,2,2,3,1,0,0,2
S01010740,All households,260,132,45,87,118,5,70,30,29,11,43,34,9,10,2,0,2,6
S01010740,Occupancy rating +2 or more,58,26,11,15,32,4,22,14,4,4,6,4,2,0,0,0,0,0
S01010740,Occupancy rating +1,66,32,9,23,33,1,23,13,5,5,9,8,1,1,0,0,1,0
S01010740,Occupancy rating 0,112,56,19,37,47,0,22,3,17,2,25,20,5,9,2,0,1,6
S01010740,Occupancy rating -1 or less,24,18,6,12,6,0,3,0,3,0,3,2,1,0,0,0,0,0
S01010741,All households,249,65,36,29,179,32,118,53,50,15,29,16,13,5,2,0,1,2
S01010741,Occupancy rating +2 or more,148,39,24,15,108,27,69,45,22,2,12,6,6,1,0,0,0,1
S01010741,Occupancy rating +1,64,22,11,11,38,2,31,8,17,6,5,3,2,4,2,0,1,1
S01010741,Occupancy rating 0,32,2,1,1,30,2,18,0,11,7,10,7,3,0,0,0,0,0
S01010741,Occupancy rating -1 or less,5,2,0,2,3,1,0,0,0,0,2,0,2,0,0,0,0,0
S01010742,All households,308,90,50,40,200,28,134,49,68,17,38,25,13,18,9,0,1,8
S01010742,Occupancy rating +2 or more,126,42,30,12,82,23,53,27,20,6,6,2,4,2,0,0,0,2
S01010742,Occupancy rating +1,82,30,14,16,50,4,40,15,21,4,6,4,2,2,0,0,1,1
S01010742,Occupancy rating 0,74,14,5,9,52,1,29,6,17,6,22,17,5,8,3,0,0,5
S01010742,Occupancy rating -1 or less,26,4,1,3,16,0,12,1,10,1,4,2,2,6,6,0,0,0
S01010743,All households,273,68,34,34,186,15,125,36,71,18,46,34,12,19,10,0,1,8
S01010743,Occupancy rating +2 or more,107,32,16,16,71,13,53,30,15,8,5,4,1,4,2,0,1,1
S01010743,Occupancy rating +1,69,16,8,8,50,2,26,5,16,5,22,15,7,3,0,0,0,3
S01010743,Occupancy rating 0,71,16,8,8,49,0,35,1,30,4,14,11,3,6,2,0,0,4
S01010743,Occupancy rating -1 or less,26,4,2,2,16,0,11,0,10,1,5,4,1,6,6,0,0,0
S01010744,All households,459,132,60,72,311,41,221,106,85,30,49,36,13,16,7,0,1,8
S01010744,Occupancy rating +2 or more,223,67,31,36,152,26,119,84,20,15,7,6,1,4,1,0,1,2
S01010744,Occupancy rating +1,136,49,22,27,82,14,52,19,26,7,16,10,6,5,2,0,0,3
S01010744,Occupancy rating 0,78,14,7,7,62,1,39,3,28,8,22,18,4,2,0,0,0,2
S01010744,Occupancy rating -1 or less,22,2,0,2,15,0,11,0,11,0,4,2,2,5,4,0,0,1
S01010745,All households,327,156,61,95,158,30,102,54,37,11,26,16,10,13,5,0,2,6
S01010745,Occupancy rating +2 or more,134,42,25,17,85,21,60,38,15,7,4,1,3,7,1,0,1,5
S01010745,Occupancy rating +1,80,47,20,27,32,3,25,12,9,4,4,3,1,1,1,0,0,0
S01010745,Occupancy rating 0,71,44,12,32,24,5,10,2,8,0,9,7,2,3,1,0,1,1
S01010745,Occupancy rating -1 or less,42,23,4,19,17,1,7,2,5,0,9,5,4,2,2,0,0,0
S01010746,All households,441,126,45,81,300,42,223,101,89,33,35,21,14,15,4,0,2,9
S01010746,Occupancy rating +2 or more,290,75,34,41,208,40,156,86,48,22,12,7,5,7,2,0,0,5
S01010746,Occupancy rating +1,88,33,5,28,49,2,33,11,17,5,14,9,5,6,2,0,1,3
S01010746,Occupancy rating 0,58,17,6,11,39,0,30,4,20,6,9,5,4,2,0,0,1,1
S01010746,Occupancy rating -1 or less,5,1,0,1,4,0,4,0,4,0,0,0,0,0,0,0,0,0
S01010747,All households,357,111,42,69,234,19,160,71,62,27,55,36,19,12,4,0,0,8
S01010747,Occupancy rating +2 or more,163,49,18,31,111,11,88,52,24,12,12,8,4,3,1,0,0,2
S01010747,Occupancy rating +1,113,38,12,26,69,8,40,12,20,8,21,14,7,6,1,0,0,5
S01010747,Occupancy rating 0,66,21,9,12,43,0,23,5,14,4,20,12,8,2,1,0,0,1
S01010747,Occupancy rating -1 or less,15,3,3,0,11,0,9,2,4,3,2,2,0,1,1,0,0,0
S01010748,All households,280,76,43,33,196,31,143,75,49,19,22,17,5,8,2,0,2,4
S01010748,Occupancy rating +2 or more,183,45,29,16,133,26,103,65,27,11,4,4,0,5,2,0,1,2
S01010748,Occupancy rating +1,63,20,11,9,41,4,25,7,13,5,12,8,4,2,0,0,1,1
S01010748,Occupancy rating 0,24,10,2,8,14,1,9,2,4,3,4,3,1,0,0,0,0,0
S01010748,Occupancy rating -1 or less,10,1,1,0,8,0,6,1,5,0,2,2,0,1,0,0,0,1
S01010749,All households,261,65,29,36,184,28,135,61,54,20,21,14,7,12,4,0,0,8
S01010749,Occupancy rating +2 or more,164,42,19,23,117,23,87,48,28,11,7,5,2,5,2,0,0,3
S01010749,Occupancy rating +1,69,18,8,10,46,4,32,9,16,7,10,7,3,5,0,0,0,5
S01010749,Occupancy rating 0,23,2,1,1,19,1,15,4,9,2,3,2,1,2,2,0,0,0
S01010749,Occupancy rating -1 or less,5,3,1,2,2,0,1,0,1,0,1,0,1,0,0,0,0,0
S01010750,All households,287,70,35,35,209,52,143,85,39,19,14,8,6,8,0,0,1,7
S01010750,Occupancy rating +2 or more,221,54,30,24,162,45,110,69,27,14,7,3,4,5,0,0,1,4
S01010750,Occupancy rating +1,41,11,4,7,28,7,17,9,6,2,4,3,1,2,0,0,0,2
S01010750,Occupancy rating 0,21,5,1,4,15,0,13,6,4,3,2,2,0,1,0,0,0,1
S01010750,Occupancy rating -1 or less,4,0,0,0,4,0,3,1,2,0,1,0,1,0,0,0,0,0
S01010751,All households,333,113,44,69,205,25,129,53,63,13,51,33,18,15,6,0,1,8
S01010751,Occupancy rating +2 or more,169,76,30,46,92,19,64,42,16,6,9,5,4,1,0,0,0,1
S01010751,Occupancy rating +1,91,17,6,11,70,2,38,8,26,4,30,20,10,4,0,0,0,4
S01010751,Occupancy rating 0,50,18,7,11,26,3,17,2,13,2,6,2,4,6,4,0,0,2
S01010751,Occupancy rating -1 or less,23,2,1,1,17,1,10,1,8,1,6,6,0,4,2,0,1,1
S01010752,All households,332,104,39,65,208,20,139,62,66,11,49,38,11,20,3,0,3,14
S01010752,Occupancy rating +2 or more,133,44,20,24,82,15,63,43,18,2,4,4,0,7,0,0,2,5
S01010752,Occupancy rating +1,102,35,10,25,61,5,35,15,18,2,21,14,7,6,0,0,1,5
S01010752,Occupancy rating 0,77,20,9,11,51,0,34,2,25,7,17,15,2,6,3,0,0,3
S01010752,Occupancy rating -1 or less,20,5,0,5,14,0,7,2,5,0,7,5,2,1,0,0,0,1
S01010753,All households,434,125,34,91,295,23,208,78,106,24,64,44,20,14,7,0,0,7
S01010753,Occupancy rating +2 or more,184,46,18,28,134,20,110,59,37,14,4,3,1,4,3,0,0,1
S01010753,Occupancy rating +1,116,36,6,30,77,2,47,13,28,6,28,19,9,3,1,0,0,2
S01010753,Occupancy rating 0,115,39,9,30,69,1,39,5,30,4,29,21,8,7,3,0,0,4
S01010753,Occupancy rating -1 or less,19,4,1,3,15,0,12,1,11,0,3,1,2,0,0,0,0,0
S01010754,All households,357,167,83,84,174,28,111,53,39,19,35,27,8,16,4,0,1,11
S01010754,Occupancy rating +2 or more,156,52,29,23,95,25,59,34,16,9,11,7,4,9,2,0,1,6
S01010754,Occupancy rating +1,96,62,29,33,31,1,23,13,6,4,7,6,1,3,1,0,0,2
S01010754,Occupancy rating 0,63,28,14,14,33,2,20,2,12,6,11,10,1,2,1,0,0,1
S01010754,Occupancy rating -1 or less,42,25,11,14,15,0,9,4,5,0,6,4,2,2,0,0,0,2
S01010755,All households,298,107,53,54,176,29,119,51,46,22,28,16,12,15,6,0,0,9
S01010755,Occupancy rating +2 or more,127,45,21,24,76,19,55,36,9,10,2,1,1,6,3,0,0,3
S01010755,Occupancy rating +1,93,35,18,17,54,7,36,14,14,8,11,5,6,4,1,0,0,3
S01010755,Occupancy rating 0,66,24,13,11,39,3,23,1,19,3,13,9,4,3,0,0,0,3
S01010755,Occupancy rating -1 or less,12,3,1,2,7,0,5,0,4,1,2,1,1,2,2,0,0,0
S01010756,All households,286,83,50,33,193,34,149,66,63,20,10,6,4,10,4,0,2,4
S01010756,Occupancy rating +2 or more,179,51,33,18,124,28,94,51,32,11,2,1,1,4,3,0,0,1
S01010756,Occupancy rating +1,62,24,16,8,37,6,30,14,15,1,1,0,1,1,0,0,0,1
S01010756,Occupancy rating 0,35,6,1,5,26,0,19,1,13,5,7,5,2,3,0,0,2,1
S01010756,Occupancy rating -1 or less,10,2,0,2,6,0,6,0,3,3,0,0,0,2,1,0,0,1
S01010757,All households,365,123,64,59,226,46,158,95,41,22,22,10,12,16,3,0,1,12
S01010757,Occupancy rating +2 or more,266,86,51,35,169,37,125,82,27,16,7,1,6,11,2,0,1,8
S01010757,Occupancy rating +1,60,22,7,15,36,6,20,10,7,3,10,6,4,2,0,0,0,2
S01010757,Occupancy rating 0,31,11,4,7,18,2,12,3,6,3,4,2,2,2,1,0,0,1
S01010757,Occupancy rating -1 or less,8,4,2,2,3,1,1,0,1,0,1,1,0,1,0,0,0,1
S01010758,All households,305,86,52,34,198,43,129,58,48,23,26,14,12,21,3,3,2,13
S01010758,Occupancy rating +2 or more,204,52,37,15,140,39,90,48,26,16,11,4,7,12,1,1,2,8
S01010758,Occupancy rating +1,56,18,9,9,35,2,27,8,14,5,6,4,2,3,1,0,0,2
S01010758,Occupancy rating 0,37,13,6,7,20,2,11,2,7,2,7,5,2,4,1,0,0,3
S01010758,Occupancy rating -1 or less,8,3,0,3,3,0,1,0,1,0,2,1,1,2,0,2,0,0
S01010759,All households,279,115,57,58,158,23,106,42,43,21,29,22,7,6,2,0,0,4
S01010759,Occupancy rating +2 or more,106,47,27,20,56,15,37,18,11,8,4,3,1,3,1,0,0,2
S01010759,Occupancy rating +1,86,28,11,17,57,6,42,19,15,8,9,5,4,1,0,0,0,1
S01010759,Occupancy rating 0,75,35,15,20,40,2,23,5,13,5,15,13,2,0,0,0,0,0
S01010759,Occupancy rating -1 or less,12,5,4,1,5,0,4,0,4,0,1,1,0,2,1,0,0,1
S01010760,All households,306,135,83,52,161,45,98,53,34,11,18,9,9,10,0,2,2,6
S01010760,Occupancy rating +2 or more,180,75,52,23,102,37,62,44,12,6,3,2,1,3,0,0,1,2
S01010760,Occupancy rating +1,75,40,23,17,31,6,18,8,6,4,7,2,5,4,0,0,0,4
S01010760,Occupancy rating 0,43,18,7,11,22,1,16,1,14,1,5,3,2,3,0,2,1,0
S01010760,Occupancy rating -1 or less,8,2,1,1,6,1,2,0,2,0,3,2,1,0,0,0,0,0
S01010761,All households,222,61,33,28,147,23,110,57,40,13,14,4,10,14,6,0,2,6
S01010761,Occupancy rating +2 or more,148,40,25,15,99,22,75,47,23,5,2,0,2,9,4,0,2,3
S01010761,Occupancy rating +1,53,12,5,7,38,1,29,9,14,6,8,2,6,3,2,0,0,1
S01010761,Occupancy rating 0,11,2,0,2,8,0,4,1,1,2,4,2,2,1,0,0,0,1
S01010761,Occupancy rating -1 or less,10,7,3,4,2,0,2,0,2,0,0,0,0,1,0,0,0,1
S01010762,All households,263,73,43,30,179,30,130,66,50,14,19,8,11,11,5,0,1,5
S01010762,Occupancy rating +2 or more,174,43,26,17,128,25,94,57,29,8,9,3,6,3,2,0,0,1
S01010762,Occupancy rating +1,55,20,11,9,32,3,25,8,13,4,4,3,1,3,0,0,1,2
S01010762,Occupancy rating 0,24,7,4,3,15,2,8,1,6,1,5,2,3,2,1,0,0,1
S01010762,Occupancy rating -1 or less,10,3,2,1,4,0,3,0,2,1,1,0,1,3,2,0,0,1
S01010763,All households,316,115,63,52,190,29,128,56,58,14,33,20,13,11,6,0,1,4
S01010763,Occupancy rating +2 or more,175,58,34,24,114,26,81,48,26,7,7,1,6,3,1,0,1,1
S01010763,Occupancy rating +1,78,35,18,17,39,2,24,5,15,4,13,9,4,4,2,0,0,2
S01010763,Occupancy rating 0,50,20,9,11,27,0,19,2,16,1,8,6,2,3,2,0,0,1
S01010763,Occupancy rating -1 or less,13,2,2,0,10,1,4,1,1,2,5,4,1,1,1,0,0,0
S01010764,All households,289,107,48,59,172,36,120,69,39,12,16,9,7,10,0,1,3,6
S01010764,Occupancy rating +2 or more,191,63,32,31,127,33,88,58,23,7,6,1,5,1,0,0,1,0
S01010764,Occupancy rating +1,64,31,12,19,27,2,20,5,11,4,5,4,1,6,0,1,1,4
S01010764,Occupancy rating 0,25,12,3,9,12,0,9,4,4,1,3,2,1,1,0,0,0,1
S01010764,Occupancy rating -1 or less,9,1,1,0,6,1,3,2,1,0,2,2,0,2,0,0,1,1
S01010765,All households,471,153,83,70,300,57,205,105,69,31,38,24,14,18,5,0,4,9
S01010765,Occupancy rating +2 or more,293,98,54,44,189,49,133,86,28,19,7,2,5,6,0,0,3,3
S01010765,Occupancy rating +1,92,31,14,17,57,3,39,14,18,7,15,9,6,4,2,0,0,2
S01010765,Occupancy rating 0,72,23,14,9,43,4,27,5,18,4,12,10,2,6,2,0,1,3
S01010765,Occupancy rating -1 or less,14,1,1,0,11,1,6,0,5,1,4,3,1,2,1,0,0,1
S01010766,All households,359,127,76,51,218,47,136,59,53,24,35,24,11,14,5,0,0,9
S01010766,Occupancy rating +2 or more,195,66,38,28,122,41,73,40,20,13,8,4,4,7,3,0,0,4
S01010766,Occupancy rating +1,67,24,16,8,41,4,29,10,12,7,8,4,4,2,1,0,0,1
S01010766,Occupancy rating 0,83,33,20,13,45,1,28,9,16,3,16,13,3,5,1,0,0,4
S01010766,Occupancy rating -1 or less,14,4,2,2,10,1,6,0,5,1,3,3,0,0,0,0,0,0
S01010767,All households,347,130,67,63,206,38,124,58,50,16,44,28,16,11,5,0,0,6
S01010767,Occupancy rating +2 or more,163,63,36,27,98,29,61,40,10,11,8,5,3,2,0,0,0,2
S01010767,Occupancy rating +1,110,40,17,23,64,8,40,14,22,4,16,8,8,6,4,0,0,2
S01010767,Occupancy rating 0,59,23,13,10,36,1,17,3,13,1,18,13,5,0,0,0,0,0
S01010767,Occupancy rating -1 or less,15,4,1,3,8,0,6,1,5,0,2,2,0,3,1,0,0,2
S01010768,All households,284,110,73,37,166,38,101,50,38,13,27,22,5,8,3,0,1,4
S01010768,Occupancy rating +2 or more,134,54,38,16,78,25,49,36,11,2,4,3,1,2,1,0,0,1
S01010768,Occupancy rating +1,80,23,16,7,54,9,36,11,18,7,9,6,3,3,0,0,0,3
S01010768,Occupancy rating 0,58,29,18,11,27,4,13,3,7,3,10,9,1,2,1,0,1,0
S01010768,Occupancy rating -1 or less,12,4,1,3,7,0,3,0,2,1,4,4,0,1,1,0,0,0
S01010769,All households,217,56,36,20,151,27,116,62,35,19,8,4,4,10,3,0,0,7
S01010769,Occupancy rating +2 or more,172,42,26,16,123,27,92,56,20,16,4,2,2,7,1,0,0,6
S01010769,Occupancy rating +1,31,10,8,2,18,0,17,4,10,3,1,1,0,3,2,0,0,1
S01010769,Occupancy rating 0,13,4,2,2,9,0,6,1,5,0,3,1,2,0,0,0,0,0
S01010769,Occupancy rating -1 or less,1,0,0,0,1,0,1,1,0,0,0,0,0,0,0,0,0,0
S01010770,All households,385,127,51,76,252,30,189,82,81,26,33,17,16,6,0,0,0,6
S01010770,Occupancy rating +2 or more,193,52,22,30,136,20,108,63,29,16,8,3,5,5,0,0,0,5
S01010770,Occupancy rating +1,84,21,12,9,62,10,40,15,20,5,12,8,4,1,0,0,0,1
S01010770,Occupancy rating 0,98,51,15,36,47,0,35,4,28,3,12,6,6,0,0,0,0,0
S01010770,Occupancy rating -1 or less,10,3,2,1,7,0,6,0,4,2,1,0,1,0,0,0,0,0
S01010771,All households,445,188,105,83,239,52,151,82,50,19,36,18,18,18,6,0,1,11
S01010771,Occupancy rating +2 or more,256,110,69,41,137,41,87,63,15,9,9,6,3,9,3,0,1,5
S01010771,Occupancy rating +1,104,43,23,20,59,10,39,12,17,10,10,1,9,2,0,0,0,2
S01010771,Occupancy rating 0,68,32,12,20,32,1,22,4,18,0,9,6,3,4,2,0,0,2
S01010771,Occupancy rating -1 or less,17,3,1,2,11,0,3,3,0,0,8,5,3,3,1,0,0,2
S01010772,All households,376,133,58,75,221,39,155,103,31,21,27,13,14,22,5,2,4,11
S01010772,Occupancy rating +2 or more,224,72,36,36,146,32,106,78,16,12,8,4,4,6,2,0,0,4
S01010772,Occupancy rating +1,83,35,12,23,44,6,30,19,7,4,8,4,4,4,1,0,2,1
S01010772,Occupancy rating 0,53,21,7,14,22,1,15,5,6,4,6,4,2,10,1,2,1,6
S01010772,Occupancy rating -1 or less,16,5,3,2,9,0,4,1,2,1,5,1,4,2,1,0,1,0
S01010773,All households,336,87,38,49,229,30,174,90,55,29,25,14,11,20,10,0,2,8
S01010773,Occupancy rating +2 or more,207,40,16,24,155,27,118,69,29,20,10,6,4,12,4,0,2,6
S01010773,Occupancy rating +1,74,28,14,14,43,3,34,17,14,3,6,3,3,3,2,0,0,1
S01010773,Occupancy rating 0,43,14,8,6,28,0,20,4,10,6,8,4,4,1,0,0,0,1
S01010773,Occupancy rating -1 or less,12,5,0,5,3,0,2,0,2,0,1,1,0,4,4,0,0,0
S01010774,All households,325,108,57,51,200,28,134,58,51,25,38,19,19,17,4,0,1,12
S01010774,Occupancy rating +2 or more,169,52,30,22,112,18,82,46,23,13,12,8,4,5,1,0,1,3
S01010774,Occupancy rating +1,85,28,14,14,52,8,34,10,13,11,10,2,8,5,1,0,0,4
S01010774,Occupancy rating 0,60,28,13,15,28,2,14,1,12,1,12,6,6,4,0,0,0,4
S01010774,Occupancy rating -1 or less,11,0,0,0,8,0,4,1,3,0,4,3,1,3,2,0,0,1
S01010775,All households,266,56,16,40,202,25,161,74,63,24,16,7,9,8,5,0,1,2
S01010775,Occupancy rating +2 or more,172,40,13,27,129,21,102,57,31,14,6,3,3,3,2,0,0,1
S01010775,Occupancy rating +1,59,10,3,7,46,4,36,11,17,8,6,3,3,3,2,0,0,1
S01010775,Occupancy rating 0,30,6,0,6,24,0,20,5,13,2,4,1,3,0,0,0,0,0
S01010775,Occupancy rating -1 or less,5,0,0,0,3,0,3,1,2,0,0,0,0,2,1,0,1,0
S01010776,All households,266,116,48,68,145,20,98,38,40,20,27,17,10,5,1,0,1,3
S01010776,Occupancy rating +2 or more,115,40,18,22,70,14,52,34,11,7,4,1,3,5,1,0,1,3
S01010776,Occupancy rating +1,72,36,18,18,36,4,19,2,12,5,13,9,4,0,0,0,0,0
S01010776,Occupancy rating 0,66,33,11,22,33,2,23,1,15,7,8,5,3,0,0,0,0,0
S01010776,Occupancy rating -1 or less,13,7,1,6,6,0,4,1,2,1,2,2,0,0,0,0,0,0
S01010777,All households,270,142,55,87,122,13,86,34,35,17,23,11,12,6,2,0,1,3
S01010777,Occupancy rating +2 or more,87,42,17,25,44,9,32,15,12,5,3,1,2,1,0,0,0,1
S01010777,Occupancy rating +1,84,41,13,28,41,3,27,12,10,5,11,5,6,2,1,0,1,0
S01010777,Occupancy rating 0,78,44,20,24,31,1,21,5,10,6,9,5,4,3,1,0,0,2
S01010777,Occupancy rating -1 or less,21,15,5,10,6,0,6,2,3,1,0,0,0,0,0,0,0,0
S01010778,All households,239,103,17,86,129,5,74,32,34,8,50,39,11,7,6,0,0,1
S01010778,Occupancy rating +2 or more,68,26,5,21,41,3,30,19,9,2,8,4,4,1,1,0,0,0
S01010778,Occupancy rating +1,88,45,8,37,43,2,24,9,12,3,17,11,6,0,0,0,0,0
S01010778,Occupancy rating 0,66,29,4,25,36,0,16,3,11,2,20,19,1,1,0,0,0,1
S01010778,Occupancy rating -1 or less,17,3,0,3,9,0,4,1,2,1,5,5,0,5,5,0,0,0
S01010779,All households,355,139,54,85,198,31,122,55,48,19,45,34,11,18,8,0,0,10
S01010779,Occupancy rating +2 or more,117,31,13,18,83,17,60,34,17,9,6,5,1,3,3,0,0,0
S01010779,Occupancy rating +1,116,69,28,41,46,12,27,17,6,4,7,4,3,1,0,0,0,1
S01010779,Occupancy rating 0,97,31,11,20,57,1,28,3,20,5,28,23,5,9,0,0,0,9
S01010779,Occupancy rating -1 or less,25,8,2,6,12,1,7,1,5,1,4,2,2,5,5,0,0,0
S01010780,All households,261,83,42,41,163,25,109,48,39,22,29,16,13,15,2,0,3,10
S01010780,Occupancy rating +2 or more,131,47,23,24,80,20,56,37,13,6,4,2,2,4,0,0,2,2
S01010780,Occupancy rating +1,74,17,8,9,52,5,34,10,17,7,13,6,7,5,0,0,1,4
S01010780,Occupancy rating 0,46,15,8,7,28,0,16,1,8,7,12,8,4,3,2,0,0,1
S01010780,Occupancy rating -1 or less,10,4,3,1,3,0,3,0,1,2,0,0,0,3,0,0,0,3
S01010781,All households,350,116,44,72,222,22,169,82,65,22,31,17,14,12,5,1,1,5
S01010781,Occupancy rating +2 or more,191,52,26,26,137,17,113,64,38,11,7,3,4,2,0,0,1,1
S01010781,Occupancy rating +1,93,41,13,28,48,3,33,11,16,6,12,6,6,4,0,0,0,4
S01010781,Occupancy rating 0,53,19,4,15,29,2,17,7,7,3,10,6,4,5,5,0,0,0
S01010781,Occupancy rating -1 or less,13,4,1,3,8,0,6,0,4,2,2,2,0,1,0,1,0,0
S01010782,All households,293,130,45,85,152,20,110,54,48,8,22,16,6,11,4,0,2,5
S01010782,Occupancy rating +2 or more,128,49,20,29,76,14,56,30,23,3,6,2,4,3,1,0,1,1
S01010782,Occupancy rating +1,84,44,16,28,38,3,32,18,12,2,3,1,2,2,0,0,0,2
S01010782,Occupancy rating 0,50,24,9,15,24,3,13,2,8,3,8,8,0,2,1,0,1,0
S01010782,Occupancy rating -1 or less,31,13,0,13,14,0,9,4,5,0,5,5,0,4,2,0,0,2
S01010783,All households,275,111,50,61,144,19,96,41,37,18,29,17,12,20,4,6,1,9
S01010783,Occupancy rating +2 or more,86,33,15,18,50,9,39,21,10,8,2,1,1,3,1,0,0,2
S01010783,Occupancy rating +1,92,45,19,26,47,8,35,19,12,4,4,2,2,0,0,0,0,0
S01010783,Occupancy rating 0,83,28,14,14,43,2,18,1,14,3,23,14,9,12,0,6,1,5
S01010783,Occupancy rating -1 or less,14,5,2,3,4,0,4,0,1,3,0,0,0,5,3,0,0,2
S01010784,All households,345,123,61,62,217,14,127,52,59,16,76,51,25,5,3,0,0,2
S01010784,Occupancy rating +2 or more,96,48,27,21,48,6,37,27,10,0,5,4,1,0,0,0,0,0
S01010784,Occupancy rating +1,117,43,17,26,73,7,43,22,11,10,23,11,12,1,0,0,0,1
S01010784,Occupancy rating 0,102,27,14,13,73,1,33,2,27,4,39,30,9,2,1,0,0,1
S01010784,Occupancy rating -1 or less,30,5,3,2,23,0,14,1,11,2,9,6,3,2,2,0,0,0
S01010785,All households,301,77,37,40,214,28,163,80,59,24,23,11,12,10,2,0,1,7
S01010785,Occupancy rating +2 or more,202,50,28,22,149,27,114,60,35,19,8,4,4,3,1,0,0,2
S01010785,Occupancy rating +1,63,23,8,15,37,1,31,15,11,5,5,2,3,3,1,0,0,2
S01010785,Occupancy rating 0,28,3,1,2,23,0,15,3,12,0,8,4,4,2,0,0,1,1
S01010785,Occupancy rating -1 or less,8,1,0,1,5,0,3,2,1,0,2,1,1,2,0,0,0,2
S01010786,All households,255,65,21,44,179,17,143,45,80,18,19,15,4,11,3,1,1,6
S01010786,Occupancy rating +2 or more,157,42,12,30,107,12,94,34,53,7,1,1,0,8,2,1,1,4
S01010786,Occupancy rating +1,68,16,6,10,49,5,36,10,19,7,8,6,2,3,1,0,0,2
S01010786,Occupancy rating 0,25,5,2,3,20,0,12,1,7,4,8,7,1,0,0,0,0,0
S01010786,Occupancy rating -1 or less,5,2,1,1,3,0,1,0,1,0,2,1,1,0,0,0,0,0
S01010787,All households,384,102,44,58,271,42,205,88,94,23,24,8,16,11,1,0,2,8
S01010787,Occupancy rating +2 or more,240,58,28,30,177,32,140,76,50,14,5,2,3,5,1,0,1,3
S01010787,Occupancy rating +1,86,34,12,22,52,9,36,8,22,6,7,2,5,0,0,0,0,0
S01010787,Occupancy rating 0,40,9,4,5,26,1,17,2,13,2,8,2,6,5,0,0,1,4
S01010787,Occupancy rating -1 or less,18,1,0,1,16,0,12,2,9,1,4,2,2,1,0,0,0,1
S01010788,All households,274,81,37,44,186,20,142,66,55,21,24,13,11,7,3,0,0,4
S01010788,Occupancy rating +2 or more,168,45,24,21,120,17,93,49,28,16,10,5,5,3,1,0,0,2
S01010788,Occupancy rating +1,58,24,9,15,34,3,27,11,12,4,4,3,1,0,0,0,0,0
S01010788,Occupancy rating 0,33,8,3,5,22,0,13,3,9,1,9,4,5,3,1,0,0,2
S01010788,Occupancy rating -1 or less,15,4,1,3,10,0,9,3,6,0,1,1,0,1,1,0,0,0
S01010789,All households,292,70,33,37,206,27,156,59,68,29,23,13,10,16,6,1,1,8
S01010789,Occupancy rating +2 or more,165,43,23,20,119,24,91,43,34,14,4,1,3,3,1,0,0,2
S01010789,Occupancy rating +1,63,13,7,6,42,1,36,13,15,8,5,2,3,8,2,0,1,5
S01010789,Occupancy rating 0,56,12,3,9,40,2,26,3,16,7,12,8,4,4,2,1,0,1
S01010789,Occupancy rating -1 or less,8,2,0,2,5,0,3,0,3,0,2,2,0,1,1,0,0,0
S01010790,All households,282,77,52,25,187,23,149,70,56,23,15,4,11,18,6,0,1,11
S01010790,Occupancy rating +2 or more,188,49,34,15,130,22,103,59,32,12,5,1,4,9,3,0,1,5
S01010790,Occupancy rating +1,59,22,13,9,33,1,27,9,14,4,5,2,3,4,1,0,0,3
S01010790,Occupancy rating 0,31,6,5,1,21,0,17,1,9,7,4,1,3,4,2,0,0,2
S01010790,Occupancy rating -1 or less,4,0,0,0,3,0,2,1,1,0,1,0,1,1,0,0,0,1
S01010791,All households,369,98,51,47,254,53,185,94,68,23,16,6,10,17,8,0,1,8
S01010791,Occupancy rating +2 or more,241,58,28,30,175,39,133,77,42,14,3,1,2,8,3,0,1,4
S01010791,Occupancy rating +1,90,36,20,16,52,12,36,10,18,8,4,2,2,2,2,0,0,0
S01010791,Occupancy rating 0,26,3,2,1,18,1,9,4,4,1,8,3,5,5,2,0,0,3
S01010791,Occupancy rating -1 or less,12,1,1,0,9,1,7,3,4,0,1,0,1,2,1,0,0,1
S01010792,All households,287,107,29,78,169,16,117,46,52,19,36,28,8,11,3,0,1,7
S01010792,Occupancy rating +2 or more,97,31,10,21,63,9,49,26,17,6,5,3,2,3,1,0,1,1
S01010792,Occupancy rating +1,91,42,12,30,47,6,33,14,11,8,8,4,4,2,0,0,0,2
S01010792,Occupancy rating 0,79,30,7,23,46,1,26,5,18,3,19,18,1,3,0,0,0,3
S01010792,Occupancy rating -1 or less,20,4,0,4,13,0,9,1,6,2,4,3,1,3,2,0,0,1
S01010793,All households,275,61,33,28,207,26,151,68,60,23,30,17,13,7,0,0,0,7
S01010793,Occupancy rating +2 or more,195,46,23,23,143,25,105,56,36,13,13,4,9,6,0,0,0,6
S01010793,Occupancy rating +1,51,7,3,4,43,1,32,10,14,8,10,6,4,1,0,0,0,1
S01010793,Occupancy rating 0,28,8,7,1,20,0,13,2,9,2,7,7,0,0,0,0,0,0
S01010793,Occupancy rating -1 or less,1,0,0,0,1,0,1,0,1,0,0,0,0,0,0,0,0,0
S01010794,All households,234,62,19,43,166,18,126,59,51,16,22,16,6,6,3,0,0,3
S01010794,Occupancy rating +2 or more,159,40,13,27,118,17,96,48,36,12,5,2,3,1,0,0,0,1
S01010794,Occupancy rating +1,47,17,5,12,29,1,23,11,10,2,5,3,2,1,1,0,0,0
S01010794,Occupancy rating 0,23,4,1,3,16,0,5,0,5,0,11,10,1,3,1,0,0,2
S01010794,Occupancy rating -1 or less,5,1,0,1,3,0,2,0,0,2,1,1,0,1,1,0,0,0
S01010795,All households,445,141,67,74,287,63,196,89,79,28,28,18,10,17,10,1,1,5
S01010795,Occupancy rating +2 or more,258,66,34,32,185,42,137,70,50,17,6,3,3,7,5,0,1,1
S01010795,Occupancy rating +1,107,41,18,23,63,18,39,16,14,9,6,3,3,3,1,0,0,2
S01010795,Occupancy rating 0,68,29,13,16,36,3,18,3,13,2,15,12,3,3,1,1,0,1
S01010795,Occupancy rating -1 or less,12,5,2,3,3,0,2,0,2,0,1,0,1,4,3,0,0,1
S01010796,All households,341,78,38,40,247,36,198,87,86,25,13,3,10,16,5,3,3,5
S01010796,Occupancy rating +2 or more,252,48,26,22,196,32,158,74,64,20,6,1,5,8,2,2,1,3
S01010796,Occupancy rating +1,62,23,9,14,37,3,31,11,17,3,3,1,2,2,0,1,0,1
S01010796,Occupancy rating 0,22,6,3,3,11,1,7,2,3,2,3,0,3,5,2,0,2,1
S01010796,Occupancy rating -1 or less,5,1,0,1,3,0,2,0,2,0,1,1,0,1,1,0,0,0
S01010797,All households,329,80,32,48,242,29,193,86,79,28,20,7,13,7,2,0,0,5
S01010797,Occupancy rating +2 or more,236,58,22,36,172,24,143,74,52,17,5,0,5,6,2,0,0,4
S01010797,Occupancy rating +1,65,11,6,5,53,3,38,11,19,8,12,6,6,1,0,0,0,1
S01010797,Occupancy rating 0,23,10,3,7,13,2,10,1,6,3,1,0,1,0,0,0,0,0
S01010797,Occupancy rating -1 or less,5,1,1,0,4,0,2,0,2,0,2,1,1,0,0,0,0,0
S01010798,All households,293,80,31,49,200,31,152,66,65,21,17,8,9,13,6,0,5,2
S01010798,Occupancy rating +2 or more,220,56,21,35,156,29,121,62,45,14,6,2,4,8,2,0,4,2
S01010798,Occupancy rating +1,43,15,7,8,26,2,18,2,12,4,6,4,2,2,2,0,0,0
S01010798,Occupancy rating 0,23,5,3,2,16,0,12,2,7,3,4,2,2,2,1,0,1,0
S01010798,Occupancy rating -1 or less,7,4,0,4,2,0,1,0,1,0,1,0,1,1,1,0,0,0
S01010799,All households,530,276,119,157,232,45,148,88,45,15,39,19,20,22,3,2,2,15
S01010799,Occupancy rating +2 or more,199,79,42,37,115,29,77,47,21,9,9,5,4,5,2,1,0,2
S01010799,Occupancy rating +1,164,94,36,58,62,10,43,28,11,4,9,4,5,8,0,1,2,5
S01010799,Occupancy rating 0,132,83,35,48,42,5,20,7,11,2,17,7,10,7,1,0,0,6
S01010799,Occupancy rating -1 or less,35,20,6,14,13,1,8,6,2,0,4,3,1,2,0,0,0,2
S01010800,All households,360,139,45,94,215,33,139,60,56,23,43,23,20,6,2,0,0,4
S01010800,Occupancy rating +2 or more,116,43,17,26,73,20,48,33,9,6,5,2,3,0,0,0,0,0
S01010800,Occupancy rating +1,165,87,27,60,77,12,51,27,12,12,14,8,6,1,0,0,0,1
S01010800,Occupancy rating 0,70,7,1,6,61,1,38,0,33,5,22,11,11,2,1,0,0,1
S01010800,Occupancy rating -1 or less,9,2,0,2,4,0,2,0,2,0,2,2,0,3,1,0,0,2
S01010801,All households,354,131,72,59,211,39,136,61,53,22,36,24,12,12,2,0,2,8
S01010801,Occupancy rating +2 or more,133,47,24,23,81,22,55,36,13,6,4,3,1,5,0,0,1,4
S01010801,Occupancy rating +1,114,28,11,17,83,15,52,20,21,11,16,12,4,3,0,0,0,3
S01010801,Occupancy rating 0,97,52,35,17,43,2,28,5,19,4,13,7,6,2,1,0,1,0
S01010801,Occupancy rating -1 or less,10,4,2,2,4,0,1,0,0,1,3,2,1,2,1,0,0,1
S01010802,All households,263,84,32,52,166,31,114,52,44,18,21,11,10,13,3,1,1,8
S01010802,Occupancy rating +2 or more,154,51,23,28,100,30,66,46,12,8,4,2,2,3,0,0,0,3
S01010802,Occupancy rating +1,63,22,7,15,37,0,30,4,20,6,7,3,4,4,1,1,1,1
S01010802,Occupancy rating 0,37,7,1,6,24,1,15,1,11,3,8,4,4,6,2,0,0,4
S01010802,Occupancy rating -1 or less,9,4,1,3,5,0,3,1,1,1,2,2,0,0,0,0,0,0
S01010803,All households,280,110,39,71,157,21,90,33,42,15,46,34,12,13,4,1,0,8
S01010803,Occupancy rating +2 or more,123,42,16,26,79,17,55,25,22,8,7,5,2,2,0,1,0,1
S01010803,Occupancy rating +1,75,38,13,25,34,3,17,5,7,5,14,10,4,3,0,0,0,3
S01010803,Occupancy rating 0,64,24,7,17,37,1,15,3,10,2,21,15,6,3,1,0,0,2
S01010803,Occupancy rating -1 or less,18,6,3,3,7,0,3,0,3,0,4,4,0,5,3,0,0,2
S01010804,All households,283,112,46,66,166,36,109,45,51,13,21,13,8,5,2,0,1,2
S01010804,Occupancy rating +2 or more,183,71,30,41,111,34,72,42,24,6,5,3,2,1,0,0,0,1
S01010804,Occupancy rating +1,60,25,11,14,32,2,24,3,16,5,6,4,2,3,1,0,1,1
S01010804,Occupancy rating 0,34,16,5,11,17,0,10,0,8,2,7,4,3,1,1,0,0,0
S01010804,Occupancy rating -1 or less,6,0,0,0,6,0,3,0,3,0,3,2,1,0,0,0,0,0
S01010805,All households,377,109,43,66,251,45,165,73,63,29,41,30,11,17,4,0,2,11
S01010805,Occupancy rating +2 or more,250,70,37,33,174,43,115,67,31,17,16,8,8,6,0,0,2,4
S01010805,Occupancy rating +1,76,24,4,20,49,2,31,3,19,9,16,14,2,3,1,0,0,2
S01010805,Occupancy rating 0,35,7,0,7,23,0,15,2,11,2,8,8,0,5,2,0,0,3
S01010805,Occupancy rating -1 or less,16,8,2,6,5,0,4,1,2,1,1,0,1,3,1,0,0,2
S01010806,All households,458,193,61,132,245,22,156,76,56,24,67,46,21,20,8,0,1,11
S01010806,Occupancy rating +2 or more,153,50,20,30,100,13,78,51,18,9,9,0,9,3,0,0,0,3
S01010806,Occupancy rating +1,127,54,21,33,67,7,39,17,13,9,21,15,6,6,3,0,1,2
S01010806,Occupancy rating 0,138,72,15,57,60,1,29,4,19,6,30,26,4,6,1,0,0,5
S01010806,Occupancy rating -1 or less,40,17,5,12,18,1,10,4,6,0,7,5,2,5,4,0,0,1
S01010807,All households,244,64,33,31,167,28,112,45,50,17,27,20,7,13,6,1,0,6
S01010807,Occupancy rating +2 or more,163,52,28,24,109,27,72,39,21,12,10,7,3,2,0,0,0,2
S01010807,Occupancy rating +1,52,9,3,6,40,1,31,6,21,4,8,5,3,3,1,1,0,1
S01010807,Occupancy rating 0,19,3,2,1,13,0,5,0,4,1,8,7,1,3,2,0,0,1
S01010807,Occupancy rating -1 or less,10,0,0,0,5,0,4,0,4,0,1,1,0,5,3,0,0,2
S01010808,All households,230,57,21,36,167,23,117,50,60,7,27,23,4,6,0,0,1,5
S01010808,Occupancy rating +2 or more,152,43,18,25,106,21,80,48,27,5,5,4,1,3,0,0,1,2
S01010808,Occupancy rating +1,59,13,3,10,44,2,30,2,26,2,12,12,0,2,0,0,0,2
S01010808,Occupancy rating 0,14,0,0,0,14,0,5,0,5,0,9,6,3,0,0,0,0,0
S01010808,Occupancy rating -1 or less,5,1,0,1,3,0,2,0,2,0,1,1,0,1,0,0,0,1
S01010809,All households,328,92,30,62,224,33,173,81,65,27,18,7,11,12,5,0,2,5
S01010809,Occupancy rating +2 or more,211,52,17,35,158,29,128,71,37,20,1,0,1,1,0,0,0,1
S01010809,Occupancy rating +1,70,24,9,15,41,4,29,9,18,2,8,5,3,5,1,0,2,2
S01010809,Occupancy rating 0,41,16,4,12,21,0,15,1,9,5,6,1,5,4,2,0,0,2
S01010809,Occupancy rating -1 or less,6,0,0,0,4,0,1,0,1,0,3,1,2,2,2,0,0,0
S01010810,All households,249,110,55,55,129,25,88,45,32,11,16,9,7,10,5,0,1,4
S01010810,Occupancy rating +2 or more,161,72,34,38,86,21,60,35,18,7,5,2,3,3,3,0,0,0
S01010810,Occupancy rating +1,50,22,12,10,27,3,19,8,8,3,5,3,2,1,0,0,1,0
S01010810,Occupancy rating 0,29,13,7,6,13,1,6,2,3,1,6,4,2,3,1,0,0,2
S01010810,Occupancy rating -1 or less,9,3,2,1,3,0,3,0,3,0,0,0,0,3,1,0,0,2
S01010811,All households,414,153,68,85,247,42,178,99,63,16,27,10,17,14,5,0,1,8
S01010811,Occupancy rating +2 or more,275,96,45,51,172,35,126,80,35,11,11,3,8,7,2,0,0,5
S01010811,Occupancy rating +1,85,39,17,22,42,6,27,15,10,2,9,2,7,4,2,0,1,1
S01010811,Occupancy rating 0,45,16,5,11,26,1,20,3,14,3,5,3,2,3,1,0,0,2
S01010811,Occupancy rating -1 or less,9,2,1,1,7,0,5,1,4,0,2,2,0,0,0,0,0,0
S01010812,All households,238,97,45,52,121,17,94,45,31,18,10,5,5,20,7,0,3,10
S01010812,Occupancy rating +2 or more,134,51,28,23,76,16,56,36,12,8,4,2,2,7,3,0,1,3
S01010812,Occupancy rating +1,57,24,8,16,27,1,23,7,9,7,3,1,2,6,1,0,1,4
S01010812,Occupancy rating 0,34,19,8,11,10,0,8,1,4,3,2,1,1,5,2,0,1,2
S01010812,Occupancy rating -1 or less,13,3,1,2,8,0,7,1,6,0,1,1,0,2,1,0,0,1
S01010813,All households,249,88,30,58,154,17,113,63,34,16,24,17,7,7,2,0,1,4
S01010813,Occupancy rating +2 or more,102,27,10,17,72,12,56,40,8,8,4,2,2,3,1,0,0,2
S01010813,Occupancy rating +1,43,16,5,11,26,3,21,9,8,4,2,0,2,1,1,0,0,0
S01010813,Occupancy rating 0,73,33,12,21,39,1,27,12,12,3,11,9,2,1,0,0,0,1
S01010813,Occupancy rating -1 or less,31,12,3,9,17,1,9,2,6,1,7,6,1,2,0,0,1,1
S01010814,All households,307,122,48,74,167,28,119,64,43,12,20,13,7,18,5,0,2,11
S01010814,Occupancy rating +2 or more,189,73,37,36,107,22,75,48,22,5,10,3,7,9,3,0,0,6
S01010814,Occupancy rating +1,76,35,5,30,39,4,31,13,14,4,4,4,0,2,0,0,0,2
S01010814,Occupancy rating 0,33,10,5,5,17,2,10,2,6,2,5,5,0,6,2,0,1,3
S01010814,Occupancy rating -1 or less,9,4,1,3,4,0,3,1,1,1,1,1,0,1,0,0,1,0
S01010815,All households,208,77,36,41,127,15,98,53,38,7,14,7,7,4,2,0,0,2
S01010815,Occupancy rating +2 or more,128,44,21,23,83,12,67,45,19,3,4,2,2,1,0,0,0,1
S01010815,Occupancy rating +1,48,21,9,12,26,2,19,8,7,4,5,2,3,1,1,0,0,0
S01010815,Occupancy rating 0,22,9,4,5,13,1,9,0,9,0,3,1,2,0,0,0,0,0
S01010815,Occupancy rating -1 or less,10,3,2,1,5,0,3,0,3,0,2,2,0,2,1,0,0,1
S01010816,All households,293,112,85,27,173,37,115,43,59,13,21,12,9,8,2,0,0,6
S01010816,Occupancy rating +2 or more,173,43,29,14,125,26,89,38,43,8,10,6,4,5,1,0,0,4
S01010816,Occupancy rating +1,47,26,17,9,21,6,10,4,5,1,5,2,3,0,0,0,0,0
S01010816,Occupancy rating 0,53,29,27,2,24,5,13,0,9,4,6,4,2,0,0,0,0,0
S01010816,Occupancy rating -1 or less,20,14,12,2,3,0,3,1,2,0,0,0,0,3,1,0,0,2
S01010817,All households,376,100,37,63,273,37,209,81,100,28,27,20,7,3,2,0,0,1
S01010817,Occupancy rating +2 or more,278,62,24,38,215,34,170,75,79,16,11,8,3,1,1,0,0,0
S01010817,Occupancy rating +1,59,28,9,19,31,3,22,6,8,8,6,5,1,0,0,0,0,0
S01010817,Occupancy rating 0,28,10,4,6,17,0,11,0,8,3,6,4,2,1,0,0,0,1
S01010817,Occupancy rating -1 or less,11,0,0,0,10,0,6,0,5,1,4,3,1,1,1,0,0,0
S01010818,All households,507,219,113,106,278,40,203,89,96,18,35,26,9,10,3,0,1,6
S01010818,Occupancy rating +2 or more,249,55,33,22,192,32,151,66,73,12,9,6,3,2,1,0,0,1
S01010818,Occupancy rating +1,95,60,37,23,33,4,26,15,8,3,3,2,1,2,1,0,1,0
S01010818,Occupancy rating 0,123,80,34,46,39,4,19,7,9,3,16,11,5,4,0,0,0,4
S01010818,Occupancy rating -1 or less,40,24,9,15,14,0,7,1,6,0,7,7,0,2,1,0,0,1
S01010819,All households,374,119,59,60,245,51,154,74,56,24,40,21,19,10,4,0,1,5
S01010819,Occupancy rating +2 or more,148,31,16,15,112,23,79,44,26,9,10,6,4,5,2,0,0,3
S01010819,Occupancy rating +1,120,54,29,25,65,19,34,20,9,5,12,5,7,1,1,0,0,0
S01010819,Occupancy rating 0,79,29,11,18,47,7,29,7,16,6,11,7,4,3,0,0,1,2
S01010819,Occupancy rating -1 or less,27,5,3,2,21,2,12,3,5,4,7,3,4,1,1,0,0,0
S01010820,All households,217,54,24,30,156,21,117,51,50,16,18,13,5,7,2,0,2,3
S01010820,Occupancy rating +2 or more,167,41,22,19,123,21,94,45,38,11,8,6,2,3,1,0,1,1
S01010820,Occupancy rating +1,24,8,1,7,14,0,13,3,8,2,1,0,1,2,1,0,1,0
S01010820,Occupancy rating 0,19,4,0,4,13,0,10,3,4,3,3,2,1,2,0,0,0,2
S01010820,Occupancy rating -1 or less,7,1,1,0,6,0,0,0,0,0,6,5,1,0,0,0,0,0
S01010821,All households,245,51,34,17,185,47,131,51,54,26,7,4,3,9,4,0,0,5
S01010821,Occupancy rating +2 or more,200,37,31,6,159,47,109,47,41,21,3,1,2,4,1,0,0,3
S01010821,Occupancy rating +1,27,9,2,7,16,0,13,3,8,2,3,2,1,2,0,0,0,2
S01010821,Occupancy rating 0,13,5,1,4,7,0,6,1,3,2,1,1,0,1,1,0,0,0
S01010821,Occupancy rating -1 or less,5,0,0,0,3,0,3,0,2,1,0,0,0,2,2,0,0,0
S01010822,All households,280,71,9,62,191,10,162,73,67,22,19,14,5,18,6,0,2,10
S01010822,Occupancy rating +2 or more,176,27,6,21,141,8,123,54,52,17,10,6,4,8,2,0,0,6
S01010822,Occupancy rating +1,62,27,2,25,29,2,23,13,8,2,4,3,1,6,1,0,1,4
S01010822,Occupancy rating 0,28,12,1,11,14,0,12,5,5,2,2,2,0,2,1,0,1,0
S01010822,Occupancy rating -1 or less,14,5,0,5,7,0,4,1,2,1,3,3,0,2,2,0,0,0
S01010823,All households,147,16,4,12,123,3,99,31,59,9,21,17,4,8,5,0,0,3
S01010823,Occupancy rating +2 or more,57,9,2,7,46,2,39,24,14,1,5,4,1,2,2,0,0,0
S01010823,Occupancy rating +1,46,7,2,5,38,1,29,6,19,4,8,6,2,1,0,0,0,1
S01010823,Occupancy rating 0,32,0,0,0,30,0,23,0,19,4,7,6,1,2,0,0,0,2
S01010823,Occupancy rating -1 or less,12,0,0,0,9,0,8,1,7,0,1,1,0,3,3,0,0,0
S01010824,All households,250,31,5,26,208,14,176,36,121,19,18,13,5,11,7,0,0,4
S01010824,Occupancy rating +2 or more,166,19,3,16,142,13,122,32,76,14,7,5,2,5,3,0,0,2
S01010824,Occupancy rating +1,52,9,1,8,42,1,38,4,31,3,3,2,1,1,0,0,0,1
S01010824,Occupancy rating 0,23,2,1,1,19,0,14,0,12,2,5,4,1,2,1,0,0,1
S01010824,Occupancy rating -1 or less,9,1,0,1,5,0,2,0,2,0,3,2,1,3,3,0,0,0
S01010825,All households,125,15,9,6,104,7,89,27,54,8,8,6,2,6,3,0,0,3
S01010825,Occupancy rating +2 or more,93,6,2,4,86,5,78,24,48,6,3,2,1,1,1,0,0,0
S01010825,Occupancy rating +1,23,6,5,1,14,2,9,3,4,2,3,3,0,3,1,0,0,2
S01010825,Occupancy rating 0,8,2,1,1,4,0,2,0,2,0,2,1,1,2,1,0,0,1
S01010825,Occupancy rating -1 or less,1,1,1,0,0,0,0,0,0,0,0,0,0,0,0,0,0,0
S01010826,All households,315,88,38,50,215,27,161,67,65,29,27,22,5,12,8,0,0,4
S01010826,Occupancy rating +2 or more,179,40,21,19,134,20,110,54,36,20,4,2,2,5,3,0,0,2
S01010826,Occupancy rating +1,80,37,13,24,40,4,28,8,14,6,8,7,1,3,1,0,0,2
S01010826,Occupancy rating 0,38,8,3,5,28,3,18,4,12,2,7,6,1,2,2,0,0,0
S01010826,Occupancy rating -1 or less,18,3,1,2,13,0,5,1,3,1,8,7,1,2,2,0,0,0
S01010827,All households,221,32,14,18,182,17,151,53,67,31,14,7,7,7,4,0,0,3
S01010827,Occupancy rating +2 or more,124,17,8,9,106,15,84,47,18,19,7,2,5,1,1,0,0,0
S01010827,Occupancy rating +1,66,10,4,6,53,2,49,6,32,11,2,1,1,3,2,0,0,1
S01010827,Occupancy rating 0,22,4,2,2,18,0,13,0,12,1,5,4,1,0,0,0,0,0
S01010827,Occupancy rating -1 or less,9,1,0,1,5,0,5,0,5,0,0,0,0,3,1,0,0,2
S01010828,All households,441,80,25,55,349,21,307,92,172,43,21,13,8,12,10,0,1,1
S01010828,Occupancy rating +2 or more,331,51,16,35,272,20,242,80,130,32,10,5,5,8,6,0,1,1
S01010828,Occupancy rating +1,71,25,9,16,45,0,37,12,20,5,8,5,3,1,1,0,0,0
S01010828,Occupancy rating 0,29,3,0,3,25,1,21,0,17,4,3,3,0,1,1,0,0,0
S01010828,Occupancy rating -1 or less,10,1,0,1,7,0,7,0,5,2,0,0,0,2,2,0,0,0
S01010829,All households,464,197,67,130,258,46,195,97,57,41,17,9,8,9,1,0,3,5
S01010829,Occupancy rating +2 or more,176,43,14,29,131,26,101,54,25,22,4,1,3,2,0,0,1,1
S01010829,Occupancy rating +1,156,93,26,67,61,13,45,28,11,6,3,1,2,2,0,0,2,0
S01010829,Occupancy rating 0,99,48,22,26,49,4,37,12,13,12,8,5,3,2,1,0,0,1
S01010829,Occupancy rating -1 or less,33,13,5,8,17,3,12,3,8,1,2,2,0,3,0,0,0,3
S01010830,All households,231,63,29,34,162,22,114,36,43,35,26,12,14,6,4,0,0,2
S01010830,Occupancy rating +2 or more,94,17,8,9,76,10,62,25,17,20,4,1,3,1,1,0,0,0
S01010830,Occupancy rating +1,69,28,15,13,39,9,24,7,12,5,6,2,4,2,0,0,0,2
S01010830,Occupancy rating 0,46,10,2,8,34,1,23,3,12,8,10,5,5,2,2,0,0,0
S01010830,Occupancy rating -1 or less,22,8,4,4,13,2,5,1,2,2,6,4,2,1,1,0,0,0
S01010831,All households,197,25,6,19,160,6,147,31,104,12,7,3,4,12,7,0,0,5
S01010831,Occupancy rating +2 or more,139,20,5,15,114,6,105,28,71,6,3,1,2,5,4,0,0,1
S01010831,Occupancy rating +1,33,3,1,2,29,0,28,3,20,5,1,1,0,1,0,0,0,1
S01010831,Occupancy rating 0,20,2,0,2,13,0,11,0,10,1,2,0,2,5,2,0,0,3
S01010831,Occupancy rating -1 or less,5,0,0,0,4,0,3,0,3,0,1,1,0,1,1,0,0,0
S01010832,All households,284,72,19,53,203,15,162,36,81,45,26,14,12,9,5,0,0,4
S01010832,Occupancy rating +2 or more,82,24,7,17,57,11,44,23,11,10,2,1,1,1,1,0,0,0
S01010832,Occupancy rating +1,99,33,12,21,65,4,52,9,27,16,9,5,4,1,1,0,0,0
S01010832,Occupancy rating 0,79,15,0,15,61,0,48,3,31,14,13,7,6,3,2,0,0,1
S01010832,Occupancy rating -1 or less,24,0,0,0,20,0,18,1,12,5,2,1,1,4,1,0,0,3
S01010833,All households,348,84,31,53,257,31,218,71,110,37,8,3,5,7,4,0,1,2
S01010833,Occupancy rating +2 or more,222,28,11,17,190,26,162,55,83,24,2,1,1,4,3,0,0,1
S01010833,Occupancy rating +1,72,34,12,22,36,4,29,14,10,5,3,1,2,2,1,0,0,1
S01010833,Occupancy rating 0,46,19,7,12,26,1,22,1,13,8,3,1,2,1,0,0,1,0
S01010833,Occupancy rating -1 or less,8,3,1,2,5,0,5,1,4,0,0,0,0,0,0,0,0,0
S01010834,All households,422,129,58,71,284,74,192,81,81,30,18,7,11,9,3,0,1,5
S01010834,Occupancy rating +2 or more,231,49,22,27,178,55,116,55,41,20,7,3,4,4,1,0,0,3
S01010834,Occupancy rating +1,123,47,28,19,74,15,55,20,29,6,4,2,2,2,1,0,1,0
S01010834,Occupancy rating 0,51,24,7,17,25,2,16,5,8,3,7,2,5,2,0,0,0,2
S01010834,Occupancy rating -1 or less,17,9,1,8,7,2,5,1,3,1,0,0,0,1,1,0,0,0
S01010835,All households,270,55,31,24,211,52,142,57,50,35,17,6,11,4,1,0,1,2
S01010835,Occupancy rating +2 or more,206,44,28,16,161,50,103,52,28,23,8,1,7,1,0,0,0,1
S01010835,Occupancy rating +1,47,10,3,7,36,1,28,4,14,10,7,5,2,1,0,0,0,1
S01010835,Occupancy rating 0,13,1,0,1,11,0,9,1,6,2,2,0,2,1,0,0,1,0
S01010835,Occupancy rating -1 or less,4,0,0,0,3,1,2,0,2,0,0,0,0,1,1,0,0,0
S01010836,All households,384,154,54,100,215,30,150,76,51,23,35,20,15,15,5,0,1,9
S01010836,Occupancy rating +2 or more,175,60,29,31,110,20,83,45,26,12,7,4,3,5,2,0,0,3
S01010836,Occupancy rating +1,116,63,22,41,51,8,37,22,8,7,6,0,6,2,1,0,0,1
S01010836,Occupancy rating 0,77,29,3,26,43,2,22,6,12,4,19,13,6,5,1,0,0,4
S01010836,Occupancy rating -1 or less,16,2,0,2,11,0,8,3,5,0,3,3,0,3,1,0,1,1
S01010837,All households,289,77,47,30,203,37,116,43,44,29,50,27,23,9,4,0,0,5
S01010837,Occupancy rating +2 or more,123,50,32,18,73,26,44,31,5,8,3,1,2,0,0,0,0,0
S01010837,Occupancy rating +1,94,21,10,11,69,9,39,11,17,11,21,10,11,4,1,0,0,3
S01010837,Occupancy rating 0,56,3,2,1,50,1,29,1,21,7,20,11,9,3,1,0,0,2
S01010837,Occupancy rating -1 or less,16,3,3,0,11,1,4,0,1,3,6,5,1,2,2,0,0,0
S01010838,All households,330,97,45,52,212,23,151,37,83,31,38,22,16,21,11,0,0,10
S01010838,Occupancy rating +2 or more,94,44,24,20,48,11,31,15,8,8,6,3,3,2,1,0,0,1
S01010838,Occupancy rating +1,116,39,16,23,73,7,56,19,26,11,10,3,7,4,2,0,0,2
S01010838,Occupancy rating 0,90,13,5,8,68,5,47,3,33,11,16,11,5,9,6,0,0,3
S01010838,Occupancy rating -1 or less,30,1,0,1,23,0,17,0,16,1,6,5,1,6,2,0,0,4
S01010839,All households,339,132,62,70,195,35,113,41,62,10,47,24,23,12,7,0,0,5
S01010839,Occupancy rating +2 or more,112,45,24,21,65,22,36,23,9,4,7,2,5,2,2,0,0,0
S01010839,Occupancy rating +1,127,67,32,35,56,12,33,17,13,3,11,5,6,4,1,0,0,3
S01010839,Occupancy rating 0,73,13,5,8,57,1,34,1,31,2,22,11,11,3,1,0,0,2
S01010839,Occupancy rating -1 or less,27,7,1,6,17,0,10,0,9,1,7,6,1,3,3,0,0,0
S01010840,All households,300,175,84,91,123,15,79,39,20,20,29,16,13,2,1,0,0,1
S01010840,Occupancy rating +2 or more,63,28,11,17,35,4,28,12,7,9,3,0,3,0,0,0,0,0
S01010840,Occupancy rating +1,115,71,39,32,43,7,32,18,7,7,4,2,2,1,1,0,0,0
S01010840,Occupancy rating 0,89,57,26,31,32,1,14,6,4,4,17,11,6,0,0,0,0,0
S01010840,Occupancy rating -1 or less,33,19,8,11,13,3,5,3,2,0,5,3,2,1,0,0,0,1
S01010841,All households,390,164,56,108,213,29,143,69,49,25,41,22,19,13,6,1,2,4
S01010841,Occupancy rating +2 or more,63,19,10,9,44,5,37,20,12,5,2,1,1,0,0,0,0,0
S01010841,Occupancy rating +1,175,93,31,62,80,21,55,35,11,9,4,3,1,2,1,0,1,0
S01010841,Occupancy rating 0,125,47,12,35,73,2,43,14,21,8,28,13,15,5,1,0,1,3
S01010841,Occupancy rating -1 or less,27,5,3,2,16,1,8,0,5,3,7,5,2,6,4,1,0,1
S01010842,All households,613,409,171,238,189,39,89,52,24,13,61,42,19,15,2,2,1,10
S01010842,Occupancy rating +2 or more,37,22,13,9,14,1,11,5,3,3,2,2,0,1,0,0,0,1
S01010842,Occupancy rating +1,202,142,64,78,58,16,34,28,4,2,8,4,4,2,0,1,0,1
S01010842,Occupancy rating 0,278,187,77,110,83,19,31,13,12,6,33,25,8,8,0,0,1,7
S01010842,Occupancy rating -1 or less,96,58,17,41,34,3,13,6,5,2,18,11,7,4,2,1,0,1
S01010843,All households,407,244,117,127,149,32,85,48,22,15,32,22,10,14,1,0,1,12
S01010843,Occupancy rating +2 or more,37,18,8,10,18,6,11,6,2,3,1,0,1,1,0,0,0,1
S01010843,Occupancy rating +1,111,76,41,35,35,14,20,17,3,0,1,0,1,0,0,0,0,0
S01010843,Occupancy rating 0,178,94,37,57,74,11,43,21,11,11,20,13,7,10,0,0,0,10
S01010843,Occupancy rating -1 or less,81,56,31,25,22,1,11,4,6,1,10,9,1,3,1,0,1,1
S01010844,All households,289,81,43,38,203,41,140,51,63,26,22,8,14,5,3,0,0,2
S01010844,Occupancy rating +2 or more,175,41,25,16,131,34,90,41,36,13,7,0,7,3,2,0,0,1
S01010844,Occupancy rating +1,71,25,12,13,44,6,31,9,15,7,7,6,1,2,1,0,0,1
S01010844,Occupancy rating 0,35,12,5,7,23,1,17,1,11,5,5,2,3,0,0,0,0,0
S01010844,Occupancy rating -1 or less,8,3,1,2,5,0,2,0,1,1,3,0,3,0,0,0,0,0
S01010845,All households,259,58,32,26,190,34,129,45,55,29,27,10,17,11,4,0,0,7
S01010845,Occupancy rating +2 or more,96,15,9,6,77,28,44,22,11,11,5,1,4,4,0,0,0,4
S01010845,Occupancy rating +1,95,37,21,16,57,3,49,19,22,8,5,1,4,1,0,0,0,1
S01010845,Occupancy rating 0,50,3,1,2,45,2,26,2,16,8,17,8,9,2,0,0,0,2
S01010845,Occupancy rating -1 or less,18,3,1,2,11,1,10,2,6,2,0,0,0,4,4,0,0,0
S01010846,All households,296,72,21,51,206,11,121,31,54,36,74,40,34,18,9,0,0,9
S01010846,Occupancy rating +2 or more,75,36,13,23,38,8,28,20,5,3,2,1,1,1,1,0,0,0
S01010846,Occupancy rating +1,105,26,6,20,76,3,48,10,21,17,25,12,13,3,1,0,0,2
S01010846,Occupancy rating 0,82,8,1,7,66,0,28,0,16,12,38,20,18,8,3,0,0,5
S01010846,Occupancy rating -1 or less,34,2,1,1,26,0,17,1,12,4,9,7,2,6,4,0,0,2
S01010847,All households,259,61,14,47,191,13,153,49,67,37,25,20,5,7,5,0,0,2
S01010847,Occupancy rating +2 or more,103,18,6,12,83,7,72,30,22,20,4,3,1,2,1,0,0,1
S01010847,Occupancy rating +1,79,24,3,21,54,3,48,16,23,9,3,2,1,1,0,0,0,1
S01010847,Occupancy rating 0,59,15,4,11,44,2,26,1,18,7,16,13,3,0,0,0,0,0
S01010847,Occupancy rating -1 or less,18,4,1,3,10,1,7,2,4,1,2,2,0,4,4,0,0,0
S01010848,All households,260,70,26,44,170,7,86,19,43,24,77,44,33,20,10,0,0,10
S01010848,Occupancy rating +2 or more,64,38,16,22,25,3,17,12,3,2,5,4,1,1,1,0,0,0
S01010848,Occupancy rating +1,85,21,7,14,61,4,27,6,10,11,30,12,18,3,0,0,0,3
S01010848,Occupancy rating 0,67,5,2,3,55,0,24,1,17,6,31,18,13,7,4,0,0,3
S01010848,Occupancy rating -1 or less,44,6,1,5,29,0,18,0,13,5,11,10,1,9,5,0,0,4
S01010849,All households,364,100,34,66,229,18,124,28,60,36,87,56,31,35,22,0,3,10
S01010849,Occupancy rating +2 or more,128,69,22,47,56,12,40,24,10,6,4,3,1,3,2,0,0,1
S01010849,Occupancy rating +1,101,20,7,13,70,5,38,1,19,18,27,14,13,11,4,0,3,4
S01010849,Occupancy rating 0,92,9,4,5,72,1,36,3,23,10,35,25,10,11,7,0,0,4
S01010849,Occupancy rating -1 or less,43,2,1,1,31,0,10,0,8,2,21,14,7,10,9,0,0,1
S01010850,All households,373,143,37,106,212,16,107,38,46,23,89,63,26,18,8,0,1,9
S01010850,Occupancy rating +2 or more,68,37,13,24,28,4,18,14,4,0,6,4,2,3,1,0,0,2
S01010850,Occupancy rating +1,152,78,19,59,71,10,42,22,13,7,19,13,6,3,0,0,0,3
S01010850,Occupancy rating 0,100,17,1,16,78,0,29,0,18,11,49,36,13,5,2,0,0,3
S01010850,Occupancy rating -1 or less,53,11,4,7,35,2,18,2,11,5,15,10,5,7,5,0,1,1
S01010851,All households,347,110,30,80,221,15,117,42,51,24,89,70,19,16,12,0,0,4
S01010851,Occupancy rating +2 or more,74,41,14,27,33,9,20,14,4,2,4,1,3,0,0,0,0,0
S01010851,Occupancy rating +1,129,55,13,42,73,4,51,26,17,8,18,9,9,1,0,0,0,1
S01010851,Occupancy rating 0,98,10,2,8,81,1,29,1,21,7,51,45,6,7,5,0,0,2
S01010851,Occupancy rating -1 or less,46,4,1,3,34,1,17,1,9,7,16,15,1,8,7,0,0,1
S01010852,All households,306,80,36,44,201,22,132,48,45,39,47,16,31,25,14,0,4,7
S01010852,Occupancy rating +2 or more,75,27,13,14,47,13,29,24,3,2,5,0,5,1,1,0,0,0
S01010852,Occupancy rating +1,135,44,20,24,84,7,59,24,17,18,18,8,10,7,2,0,3,2
S01010852,Occupancy rating 0,65,8,3,5,49,0,30,0,16,14,19,5,14,8,5,0,0,3
S01010852,Occupancy rating -1 or less,31,1,0,1,21,2,14,0,9,5,5,3,2,9,6,0,1,2
S01010853,All households,358,86,35,51,252,35,159,51,64,44,58,31,27,20,14,0,0,6
S01010853,Occupancy rating +2 or more,103,30,12,18,73,22,47,25,9,13,4,2,2,0,0,0,0,0
S01010853,Occupancy rating +1,120,36,13,23,80,10,52,22,18,12,18,10,8,4,3,0,0,1
S01010853,Occupancy rating 0,93,12,5,7,74,2,47,4,29,14,25,12,13,7,3,0,0,4
S01010853,Occupancy rating -1 or less,42,8,5,3,25,1,13,0,8,5,11,7,4,9,8,0,0,1
S01010854,All households,384,112,36,76,252,13,140,36,67,37,99,74,25,20,13,0,0,7
S01010854,Occupancy rating +2 or more,73,42,16,26,30,3,20,7,10,3,7,4,3,1,0,0,0,1
S01010854,Occupancy rating +1,141,56,16,40,83,8,50,26,15,9,25,17,8,2,1,0,0,1
S01010854,Occupancy rating 0,118,8,4,4,103,1,51,1,31,19,51,40,11,7,5,0,0,2
S01010854,Occupancy rating -1 or less,52,6,0,6,36,1,19,2,11,6,16,13,3,10,7,0,0,3
S01010855,All households,223,55,30,25,151,23,85,25,39,21,43,21,22,17,11,0,0,6
S01010855,Occupancy rating +2 or more,56,19,7,12,37,16,20,13,4,3,1,0,1,0,0,0,0,0
S01010855,Occupancy rating +1,74,26,14,12,44,5,27,12,8,7,12,5,7,4,0,0,0,4
S01010855,Occupancy rating 0,65,8,8,0,51,0,26,0,20,6,25,13,12,6,4,0,0,2
S01010855,Occupancy rating -1 or less,28,2,1,1,19,2,12,0,7,5,5,3,2,7,7,0,0,0
S01010856,All households,455,215,87,128,222,34,119,44,53,22,69,43,26,18,11,0,0,7
S01010856,Occupancy rating +2 or more,75,37,19,18,38,10,23,14,9,0,5,5,0,0,0,0,0,0
S01010856,Occupancy rating +1,192,117,54,63,73,20,48,26,13,9,5,0,5,2,1,0,0,1
S01010856,Occupancy rating 0,122,42,5,37,75,3,30,1,19,10,42,26,16,5,0,0,0,5
S01010856,Occupancy rating -1 or less,66,19,9,10,36,1,18,3,12,3,17,12,5,11,10,0,0,1
S01010857,All households,324,73,16,57,232,9,157,42,90,25,66,48,18,19,16,0,0,3
S01010857,Occupancy rating +2 or more,75,18,3,15,54,4,46,26,16,4,4,4,0,3,1,0,0,2
S01010857,Occupancy rating +1,123,43,8,35,79,5,57,15,35,7,17,16,1,1,1,0,0,0
S01010857,Occupancy rating 0,89,6,2,4,77,0,41,0,31,10,36,21,15,6,5,0,0,1
S01010857,Occupancy rating -1 or less,37,6,3,3,22,0,13,1,8,4,9,7,2,9,9,0,0,0
S01010858,All households,330,116,48,68,194,31,104,39,43,22,59,37,22,20,6,0,0,14
S01010858,Occupancy rating +2 or more,60,20,9,11,38,8,24,14,6,4,6,4,2,2,0,0,0,2
S01010858,Occupancy rating +1,139,73,30,43,63,15,40,23,10,7,8,6,2,3,0,0,0,3
S01010858,Occupancy rating 0,81,13,6,7,61,3,23,1,15,7,35,23,12,7,2,0,0,5
S01010858,Occupancy rating -1 or less,50,10,3,7,32,5,17,1,12,4,10,4,6,8,4,0,0,4
S01010859,All households,304,103,57,46,186,19,106,23,46,37,61,41,20,15,9,0,2,4
S01010859,Occupancy rating +2 or more,70,30,16,14,40,7,25,18,3,4,8,7,1,0,0,0,0,0
S01010859,Occupancy rating +1,93,32,17,15,58,9,35,5,17,13,14,6,8,3,1,0,1,1
S01010859,Occupancy rating 0,106,35,20,15,65,2,34,0,20,14,29,21,8,6,4,0,1,1
S01010859,Occupancy rating -1 or less,35,6,4,2,23,1,12,0,6,6,10,7,3,6,4,0,0,2
S01010860,All households,279,95,33,62,167,21,106,42,33,31,40,26,14,17,9,0,0,8
S01010860,Occupancy rating +2 or more,73,28,13,15,44,11,26,18,4,4,7,3,4,1,0,0,0,1
S01010860,Occupancy rating +1,89,31,7,24,54,7,36,19,10,7,11,8,3,4,1,0,0,3
S01010860,Occupancy rating 0,88,30,12,18,52,2,32,4,12,16,18,12,6,6,4,0,0,2
S01010860,Occupancy rating -1 or less,29,6,1,5,17,1,12,1,7,4,4,3,1,6,4,0,0,2
S01010861,All households,332,159,49,110,148,22,71,23,28,20,55,40,15,25,16,0,1,8
S01010861,Occupancy rating +2 or more,46,22,9,13,22,5,10,7,1,2,7,2,5,2,1,0,0,1
S01010861,Occupancy rating +1,128,87,30,57,36,13,21,12,6,3,2,2,0,5,2,0,0,3
S01010861,Occupancy rating 0,118,42,7,35,71,2,32,4,16,12,37,29,8,5,3,0,1,1
S01010861,Occupancy rating -1 or less,40,8,3,5,19,2,8,0,5,3,9,7,2,13,10,0,0,3
S01010862,All households,266,131,26,105,118,10,43,7,23,13,65,41,24,17,8,0,0,9
S01010862,Occupancy rating +2 or more,19,9,2,7,9,2,5,2,1,2,2,0,2,1,0,0,0,1
S01010862,Occupancy rating +1,68,41,10,31,26,6,14,4,5,5,6,2,4,1,0,0,0,1
S01010862,Occupancy rating 0,133,69,12,57,56,2,13,1,10,2,41,28,13,8,3,0,0,5
S01010862,Occupancy rating -1 or less,46,12,2,10,27,0,11,0,7,4,16,11,5,7,5,0,0,2
S01010863,All households,317,92,47,45,214,33,148,53,62,33,33,13,20,11,4,1,0,6
S01010863,Occupancy rating +2 or more,188,53,34,19,130,28,94,43,31,20,8,2,6,5,3,0,0,2
S01010863,Occupancy rating +1,65,26,9,17,38,2,29,9,14,6,7,1,6,1,0,0,0,1
S01010863,Occupancy rating 0,40,9,2,7,28,2,16,1,12,3,10,4,6,3,0,1,0,2
S01010863,Occupancy rating -1 or less,24,4,2,2,18,1,9,0,5,4,8,6,2,2,1,0,0,1
S01010864,All households,250,73,32,41,174,37,120,46,46,28,17,11,6,3,1,0,0,2
S01010864,Occupancy rating +2 or more,142,24,12,12,116,29,82,39,29,14,5,4,1,2,0,0,0,2
S01010864,Occupancy rating +1,62,31,13,18,31,7,24,5,11,8,0,0,0,0,0,0,0,0
S01010864,Occupancy rating 0,35,14,7,7,20,1,10,2,5,3,9,4,5,1,1,0,0,0
S01010864,Occupancy rating -1 or less,11,4,0,4,7,0,4,0,1,3,3,3,0,0,0,0,0,0
S01010865,All households,345,118,71,47,210,67,125,58,36,31,18,9,9,17,2,8,1,6
S01010865,Occupancy rating +2 or more,188,53,34,19,131,45,84,43,23,18,2,1,1,4,1,0,1,2
S01010865,Occupancy rating +1,89,36,23,13,49,18,23,11,4,8,8,3,5,4,1,0,0,3
S01010865,Occupancy rating 0,63,28,13,15,26,4,14,4,8,2,8,5,3,9,0,8,0,1
S01010865,Occupancy rating -1 or less,5,1,1,0,4,0,4,0,1,3,0,0,0,0,0,0,0,0
S01010866,All households,312,117,82,35,180,49,117,41,47,29,14,8,6,15,5,1,4,5
S01010866,Occupancy rating +2 or more,173,48,31,17,119,28,88,37,28,23,3,1,2,6,1,1,1,3
S01010866,Occupancy rating +1,56,28,17,11,25,6,16,3,9,4,3,2,1,3,0,0,1,2
S01010866,Occupancy rating 0,56,23,16,7,30,11,12,1,9,2,7,4,3,3,1,0,2,0
S01010866,Occupancy rating -1 or less,27,18,18,0,6,4,1,0,1,0,1,1,0,3,3,0,0,0
S01010867,All households,285,101,55,46,176,34,125,44,55,26,17,9,8,8,4,1,2,1
S01010867,Occupancy rating +2 or more,166,47,26,21,116,26,81,37,30,14,9,4,5,3,2,0,1,0
S01010867,Occupancy rating +1,60,26,16,10,31,4,24,4,14,6,3,2,1,3,1,0,1,1
S01010867,Occupancy rating 0,39,18,8,10,20,4,15,2,9,4,1,1,0,1,0,1,0,0
S01010867,Occupancy rating -1 or less,20,10,5,5,9,0,5,1,2,2,4,2,2,1,1,0,0,0
S01010868,All households,306,92,49,43,193,41,138,56,48,34,14,6,8,21,12,0,1,8
S01010868,Occupancy rating +2 or more,146,28,14,14,111,29,78,38,25,15,4,1,3,7,4,0,0,3
S01010868,Occupancy rating +1,92,39,26,13,49,7,37,12,13,12,5,3,2,4,1,0,0,3
S01010868,Occupancy rating 0,49,19,9,10,25,4,17,4,8,5,4,2,2,5,3,0,1,1
S01010868,Occupancy rating -1 or less,19,6,0,6,8,1,6,2,2,2,1,0,1,5,4,0,0,1
S01010869,All households,290,73,34,39,203,36,147,41,67,39,20,9,11,14,8,0,2,4
S01010869,Occupancy rating +2 or more,213,52,28,24,154,30,113,38,48,27,11,8,3,7,3,0,1,3
S01010869,Occupancy rating +1,54,18,6,12,31,5,21,2,10,9,5,0,5,5,3,0,1,1
S01010869,Occupancy rating 0,16,1,0,1,14,1,10,1,6,3,3,0,3,1,1,0,0,0
S01010869,Occupancy rating -1 or less,7,2,0,2,4,0,3,0,3,0,1,1,0,1,1,0,0,0
S01010870,All households,407,192,100,92,196,36,114,43,50,21,46,24,22,19,5,0,0,14
S01010870,Occupancy rating +2 or more,90,32,16,16,52,12,31,12,12,7,9,4,5,6,2,0,0,4
S01010870,Occupancy rating +1,177,99,54,45,77,21,49,25,19,5,7,3,4,1,0,0,0,1
S01010870,Occupancy rating 0,115,55,27,28,51,1,28,3,16,9,22,12,10,9,2,0,0,7
S01010870,Occupancy rating -1 or less,25,6,3,3,16,2,6,3,3,0,8,5,3,3,1,0,0,2
S01010871,All households,408,183,86,97,206,26,143,48,67,28,37,23,14,19,4,2,0,13
S01010871,Occupancy rating +2 or more,102,26,14,12,75,15,54,25,23,6,6,1,5,1,0,0,0,1
S01010871,Occupancy rating +1,151,89,36,53,57,8,41,16,16,9,8,5,3,5,2,0,0,3
S01010871,Occupancy rating 0,112,54,26,28,52,2,35,5,22,8,15,12,3,6,1,0,0,5
S01010871,Occupancy rating -1 or less,43,14,10,4,22,1,13,2,6,5,8,5,3,7,1,2,0,4
S01010872,All households,403,213,69,144,174,20,108,56,33,19,46,28,18,16,5,3,0,8
S01010872,Occupancy rating +2 or more,69,27,10,17,38,3,31,21,8,2,4,1,3,4,2,0,0,2
S01010872,Occupancy rating +1,141,85,28,57,53,12,37,24,10,3,4,3,1,3,0,0,0,3
S01010872,Occupancy rating 0,147,84,26,58,62,3,32,10,12,10,27,17,10,1,0,0,0,1
S01010872,Occupancy rating -1 or less,46,17,5,12,21,2,8,1,3,4,11,7,4,8,3,3,0,2
S01010873,All households,400,292,152,140,103,19,42,26,9,7,42,29,13,5,2,0,1,2
S01010873,Occupancy rating +2 or more,25,16,4,12,9,1,7,6,1,0,1,1,0,0,0,0,0,0
S01010873,Occupancy rating +1,104,82,36,46,22,6,14,11,0,3,2,0,2,0,0,0,0,0
S01010873,Occupancy rating 0,214,161,96,65,50,9,14,7,3,4,27,16,11,3,0,0,1,2
S01010873,Occupancy rating -1 or less,57,33,16,17,22,3,7,2,5,0,12,12,0,2,2,0,0,0
S01010874,All households,307,96,37,59,194,14,146,41,62,43,34,22,12,17,8,0,0,9
S01010874,Occupancy rating +2 or more,136,35,15,20,94,13,78,32,30,16,3,1,2,7,3,0,0,4
S01010874,Occupancy rating +1,97,47,15,32,47,1,37,9,15,13,9,8,1,3,1,0,0,2
S01010874,Occupancy rating 0,47,8,3,5,34,0,19,0,10,9,15,6,9,5,4,0,0,1
S01010874,Occupancy rating -1 or less,27,6,4,2,19,0,12,0,7,5,7,7,0,2,0,0,0,2
S01010875,All households,257,107,40,67,134,9,89,36,39,14,36,28,8,16,3,3,0,10
S01010875,Occupancy rating +2 or more,50,18,8,10,31,3,26,15,6,5,2,2,0,1,0,0,0,1
S01010875,Occupancy rating +1,90,54,24,30,35,5,23,16,7,0,7,7,0,1,0,0,0,1
S01010875,Occupancy rating 0,84,25,6,19,51,1,29,4,20,5,21,14,7,8,1,0,0,7
S01010875,Occupancy rating -1 or less,33,10,2,8,17,0,11,1,6,4,6,5,1,6,2,3,0,1
S01010876,All households,393,178,48,130,196,14,102,46,40,16,80,51,29,19,4,4,2,9
S01010876,Occupancy rating +2 or more,50,19,7,12,30,1,23,15,5,3,6,2,4,1,0,0,0,1
S01010876,Occupancy rating +1,148,88,25,63,58,11,38,23,10,5,9,7,2,2,0,0,0,2
S01010876,Occupancy rating 0,145,59,14,45,79,0,31,7,18,6,48,30,18,7,0,1,1,5
S01010876,Occupancy rating -1 or less,50,12,2,10,29,2,10,1,7,2,17,12,5,9,4,3,1,1
S01010877,All households,467,189,51,138,259,31,150,51,61,38,78,51,27,19,5,1,1,12
S01010877,Occupancy rating +2 or more,136,38,15,23,94,21,67,20,25,22,6,3,3,4,1,0,0,3
S01010877,Occupancy rating +1,105,52,10,42,50,5,35,19,10,6,10,3,7,3,2,0,0,1
S01010877,Occupancy rating 0,175,84,23,61,84,4,32,9,17,6,48,35,13,7,0,1,1,5
S01010877,Occupancy rating -1 or less,51,15,3,12,31,1,16,3,9,4,14,10,4,5,2,0,0,3
S01010878,All households,512,234,125,109,264,43,159,80,57,22,62,30,32,14,5,0,1,8
S01010878,Occupancy rating +2 or more,84,23,13,10,59,13,42,27,11,4,4,1,3,2,0,0,0,2
S01010878,Occupancy rating +1,236,143,91,52,91,21,62,41,13,8,8,5,3,2,0,0,0,2
S01010878,Occupancy rating 0,122,33,9,24,87,8,39,10,21,8,40,17,23,2,1,0,1,0
S01010878,Occupancy rating -1 or less,70,35,12,23,27,1,16,2,12,2,10,7,3,8,4,0,0,4
S01010879,All households,387,136,43,93,239,27,168,70,64,34,44,27,17,12,4,0,2,6
S01010879,Occupancy rating +2 or more,109,36,12,24,71,15,51,28,13,10,5,4,1,2,1,0,0,1
S01010879,Occupancy rating +1,134,50,16,34,84,9,61,28,17,16,14,9,5,0,0,0,0,0
S01010879,Occupancy rating 0,107,42,13,29,59,2,45,12,27,6,12,5,7,6,2,0,0,4
S01010879,Occupancy rating -1 or less,37,8,2,6,25,1,11,2,7,2,13,9,4,4,1,0,2,1
S01010880,All households,268,114,43,71,147,15,74,21,30,23,58,42,16,7,3,0,1,3
S01010880,Occupancy rating +2 or more,47,28,14,14,19,6,12,8,0,4,1,1,0,0,0,0,0,0
S01010880,Occupancy rating +1,107,67,21,46,40,7,28,12,8,8,5,2,3,0,0,0,0,0
S01010880,Occupancy rating 0,79,11,3,8,65,1,21,0,14,7,43,32,11,3,1,0,0,2
S01010880,Occupancy rating -1 or less,35,8,5,3,23,1,13,1,8,4,9,7,2,4,2,0,1,1
S01010881,All households,285,96,64,32,172,37,100,39,41,20,35,12,23,17,4,0,2,11
S01010881,Occupancy rating +2 or more,80,30,17,13,49,17,30,18,8,4,2,0,2,1,0,0,0,1
S01010881,Occupancy rating +1,138,62,44,18,72,17,40,19,12,9,15,4,11,4,0,0,0,4
S01010881,Occupancy rating 0,46,2,1,1,36,2,21,1,16,4,13,6,7,8,1,0,2,5
S01010881,Occupancy rating -1 or less,21,2,2,0,15,1,9,1,5,3,5,2,3,4,3,0,0,1
S01010882,All households,203,45,16,29,150,12,112,23,53,36,26,14,12,8,6,0,0,2
S01010882,Occupancy rating +2 or more,76,21,11,10,55,8,42,20,10,12,5,3,2,0,0,0,0,0
S01010882,Occupancy rating +1,55,8,3,5,45,4,32,3,20,9,9,5,4,2,1,0,0,1
S01010882,Occupancy rating 0,52,12,1,11,40,0,31,0,17,14,9,4,5,0,0,0,0,0
S01010882,Occupancy rating -1 or less,20,4,1,3,10,0,7,0,6,1,3,2,1,6,5,0,0,1
S01010883,All households,336,102,28,74,221,14,173,42,93,38,34,14,20,13,7,0,0,6
S01010883,Occupancy rating +2 or more,136,7,3,4,122,1,111,27,59,25,10,2,8,7,4,0,0,3
S01010883,Occupancy rating +1,99,54,19,35,45,12,30,13,14,3,3,3,0,0,0,0,0,0
S01010883,Occupancy rating 0,78,33,5,28,42,1,28,2,16,10,13,5,8,3,1,0,0,2
S01010883,Occupancy rating -1 or less,23,8,1,7,12,0,4,0,4,0,8,4,4,3,2,0,0,1
S01010884,All households,408,227,68,159,168,23,73,27,27,19,72,53,19,13,9,0,1,3
S01010884,Occupancy rating +2 or more,77,41,17,24,36,12,21,12,5,4,3,2,1,0,0,0,0,0
S01010884,Occupancy rating +1,113,67,21,46,45,9,20,9,6,5,16,12,4,1,1,0,0,0
S01010884,Occupancy rating 0,145,85,21,64,57,1,25,5,11,9,31,23,8,3,2,0,1,0
S01010884,Occupancy rating -1 or less,73,34,9,25,30,1,7,1,5,1,22,16,6,9,6,0,0,3
S01010885,All households,541,298,86,212,224,14,113,52,45,16,97,77,20,19,5,1,0,13
S01010885,Occupancy rating +2 or more,35,19,10,9,16,1,15,9,4,2,0,0,0,0,0,0,0,0
S01010885,Occupancy rating +1,113,65,17,48,44,4,34,24,6,4,6,4,2,4,0,1,0,3
S01010885,Occupancy rating 0,272,151,39,112,112,8,40,14,22,4,64,48,16,9,2,0,0,7
S01010885,Occupancy rating -1 or less,121,63,20,43,52,1,24,5,13,6,27,25,2,6,3,0,0,3
S01010886,All households,250,130,26,104,114,11,68,31,26,11,35,16,19,6,2,1,0,3
S01010886,Occupancy rating +2 or more,44,20,9,11,24,7,15,10,2,3,2,1,1,0,0,0,0,0
S01010886,Occupancy rating +1,93,52,10,42,41,4,27,13,11,3,10,3,7,0,0,0,0,0
S01010886,Occupancy rating 0,89,46,5,41,38,0,19,7,9,3,19,9,10,5,1,1,0,3
S01010886,Occupancy rating -1 or less,24,12,2,10,11,0,7,1,4,2,4,3,1,1,1,0,0,0
S01010887,All households,458,252,110,142,183,30,82,27,36,19,71,41,30,23,15,1,0,7
S01010887,Occupancy rating +2 or more,44,20,11,9,23,7,13,6,4,3,3,0,3,1,1,0,0,0
S01010887,Occupancy rating +1,181,127,57,70,51,12,28,18,7,3,11,7,4,3,1,0,0,2
S01010887,Occupancy rating 0,173,83,34,49,80,5,32,3,19,10,43,24,19,10,5,1,0,4
S01010887,Occupancy rating -1 or less,60,22,8,14,29,6,9,0,6,3,14,10,4,9,8,0,0,1
S01010888,All households,437,217,60,157,206,23,126,76,28,22,57,32,25,14,8,1,0,5
S01010888,Occupancy rating +2 or more,71,23,11,12,47,7,36,28,5,3,4,0,4,1,0,0,0,1
S01010888,Occupancy rating +1,115,59,21,38,54,14,35,25,2,8,5,2,3,2,2,0,0,0
S01010888,Occupancy rating 0,185,99,23,76,80,2,45,21,15,9,33,20,13,6,1,1,0,4
S01010888,Occupancy rating -1 or less,66,36,5,31,25,0,10,2,6,2,15,10,5,5,5,0,0,0
S01010889,All households,344,221,50,171,116,12,67,40,13,14,37,24,13,7,3,1,0,3
S01010889,Occupancy rating +2 or more,25,14,3,11,11,1,10,8,2,0,0,0,0,0,0,0,0,0
S01010889,Occupancy rating +1,98,67,18,49,30,5,23,22,0,1,2,1,1,1,0,1,0,0
S01010889,Occupancy rating 0,155,96,23,73,56,6,23,6,7,10,27,19,8,3,1,0,0,2
S01010889,Occupancy rating -1 or less,66,44,6,38,19,0,11,4,4,3,8,4,4,3,2,0,0,1
S01010890,All households,507,320,180,140,163,33,69,41,16,12,61,23,38,24,4,0,4,16
S01010890,Occupancy rating +2 or more,45,37,20,17,8,5,3,3,0,0,0,0,0,0,0,0,0,0
S01010890,Occupancy rating +1,189,129,69,60,56,15,32,23,3,6,9,5,4,4,0,0,0,4
S01010890,Occupancy rating 0,213,129,76,53,73,10,28,12,13,3,35,14,21,11,2,0,2,7
S01010890,Occupancy rating -1 or less,60,25,15,10,26,3,6,3,0,3,17,4,13,9,2,0,2,5
S01010891,All households,280,200,87,113,69,13,33,20,6,7,23,18,5,11,2,5,3,1
S01010891,Occupancy rating +2 or more,14,8,3,5,6,2,1,0,1,0,3,1,2,0,0,0,0,0
S01010891,Occupancy rating +1,99,75,30,45,24,4,16,13,1,2,4,3,1,0,0,0,0,0
S01010891,Occupancy rating 0,120,87,47,40,29,6,13,7,2,4,10,9,1,4,0,4,0,0
S01010891,Occupancy rating -1 or less,47,30,7,23,10,1,3,0,2,1,6,5,1,7,2,1,3,1
S01010892,All households,531,336,141,195,179,29,95,58,26,11,55,34,21,16,6,0,1,9
S01010892,Occupancy rating +2 or more,54,29,13,16,24,5,16,9,5,2,3,2,1,1,0,0,0,1
S01010892,Occupancy rating +1,153,92,39,53,58,14,38,32,4,2,6,4,2,3,0,0,1,2
S01010892,Occupancy rating 0,247,166,72,94,74,6,33,12,15,6,35,22,13,7,4,0,0,3
S01010892,Occupancy rating -1 or less,77,49,17,32,23,4,8,5,2,1,11,6,5,5,2,0,0,3
S01010893,All households,327,211,79,132,103,16,49,24,16,9,38,17,21,13,4,1,1,7
S01010893,Occupancy rating +2 or more,41,24,12,12,16,4,9,6,2,1,3,0,3,1,0,0,0,1
S01010893,Occupancy rating +1,77,44,17,27,30,8,11,4,4,3,11,4,7,3,1,0,0,2
S01010893,Occupancy rating 0,158,109,37,72,45,3,26,12,10,4,16,8,8,4,1,1,0,2
S01010893,Occupancy rating -1 or less,51,34,13,21,12,1,3,2,0,1,8,5,3,5,2,0,1,2
S01010894,All households,312,137,36,101,163,14,100,49,43,8,49,36,13,12,4,2,1,5
S01010894,Occupancy rating +2 or more,31,11,3,8,19,2,14,7,7,0,3,2,1,1,0,0,0,1
S01010894,Occupancy rating +1,142,81,16,65,61,9,49,40,6,3,3,2,1,0,0,0,0,0
S01010894,Occupancy rating 0,103,30,11,19,65,0,31,2,24,5,34,27,7,8,3,1,1,3
S01010894,Occupancy rating -1 or less,36,15,6,9,18,3,6,0,6,0,9,5,4,3,1,1,0,1
S01010895,All households,256,160,49,111,92,7,49,27,12,10,36,27,9,4,1,0,1,2
S01010895,Occupancy rating +2 or more,41,21,8,13,20,4,12,9,3,0,4,2,2,0,0,0,0,0
S01010895,Occupancy rating +1,70,43,14,29,27,2,20,14,2,4,5,4,1,0,0,0,0,0
S01010895,Occupancy rating 0,117,79,20,59,36,1,15,4,6,5,20,17,3,2,0,0,1,1
S01010895,Occupancy rating -1 or less,28,17,7,10,9,0,2,0,1,1,7,4,3,2,1,0,0,1
S01010896,All households,339,147,47,100,176,19,88,38,26,24,69,43,26,16,8,0,1,7
S01010896,Occupancy rating +2 or more,38,14,6,8,23,4,18,12,4,2,1,1,0,1,1,0,0,0
S01010896,Occupancy rating +1,118,57,20,37,58,14,33,18,8,7,11,8,3,3,2,0,0,1
S01010896,Occupancy rating 0,130,55,14,41,67,1,25,7,6,12,41,24,17,8,2,0,1,5
S01010896,Occupancy rating -1 or less,53,21,7,14,28,0,12,1,8,3,16,10,6,4,3,0,0,1
S01010897,All households,380,143,44,99,218,18,107,39,38,30,93,62,31,19,12,0,1,6
S01010897,Occupancy rating +2 or more,41,20,5,15,21,1,17,11,2,4,3,3,0,0,0,0,0,0
S01010897,Occupancy rating +1,136,77,29,48,58,15,32,21,7,4,11,7,4,1,1,0,0,0
S01010897,Occupancy rating 0,142,38,9,29,97,0,41,2,20,19,56,32,24,7,2,0,1,4
S01010897,Occupancy rating -1 or less,61,8,1,7,42,2,17,5,9,3,23,20,3,11,9,0,0,2
S01010898,All households,253,79,29,50,157,7,92,30,30,32,58,28,30,17,9,0,2,6
S01010898,Occupancy rating +2 or more,78,42,18,24,35,3,29,22,5,2,3,2,1,1,0,0,0,1
S01010898,Occupancy rating +1,74,16,6,10,53,2,24,5,6,13,27,8,19,5,1,0,2,2
S01010898,Occupancy rating 0,69,19,5,14,44,1,25,3,10,12,18,12,6,6,4,0,0,2
S01010898,Occupancy rating -1 or less,32,2,0,2,25,1,14,0,9,5,10,6,4,5,4,0,0,1
S01010899,All households,221,48,22,26,164,11,125,37,55,33,28,19,9,9,7,0,0,2
S01010899,Occupancy rating +2 or more,56,20,8,12,35,5,27,19,5,3,3,2,1,1,0,0,0,1
S01010899,Occupancy rating +1,65,12,7,5,53,1,46,14,23,9,6,4,2,0,0,0,0,0
S01010899,Occupancy rating 0,76,14,5,9,60,5,42,4,22,16,13,8,5,2,2,0,0,0
S01010899,Occupancy rating -1 or less,24,2,2,0,16,0,10,0,5,5,6,5,1,6,5,0,0,1
S01010900,All households,298,83,11,72,199,17,94,28,40,26,88,74,14,16,7,2,0,7
S01010900,Occupancy rating +2 or more,40,16,1,15,23,7,15,7,4,4,1,1,0,1,0,1,0,0
S01010900,Occupancy rating +1,103,52,8,44,50,8,23,17,1,5,19,14,5,1,0,0,0,1
S01010900,Occupancy rating 0,96,10,1,9,80,1,36,1,24,11,43,38,5,6,1,0,0,5
S01010900,Occupancy rating -1 or less,59,5,1,4,46,1,20,3,11,6,25,21,4,8,6,1,0,1
S01010901,All households,205,66,22,44,129,11,55,16,21,18,63,42,21,10,5,0,0,5
S01010901,Occupancy rating +2 or more,23,11,3,8,12,2,9,4,4,1,1,1,0,0,0,0,0,0
S01010901,Occupancy rating +1,72,38,16,22,33,4,17,7,5,5,12,9,3,1,0,0,0,1
S01010901,Occupancy rating 0,80,13,1,12,63,1,21,2,10,9,41,26,15,4,2,0,0,2
S01010901,Occupancy rating -1 or less,30,4,2,2,21,4,8,3,2,3,9,6,3,5,3,0,0,2
S01010902,All households,453,173,84,89,254,36,160,66,55,39,58,34,24,26,13,2,0,11
S01010902,Occupancy rating +2 or more,126,53,22,31,72,18,50,31,12,7,4,3,1,1,0,1,0,0
S01010902,Occupancy rating +1,157,79,40,39,74,13,46,27,10,9,15,8,7,4,1,1,0,2
S01010902,Occupancy rating 0,114,25,12,13,78,5,47,7,24,16,26,13,13,11,6,0,0,5
S01010902,Occupancy rating -1 or less,56,16,10,6,30,0,17,1,9,7,13,10,3,10,6,0,0,4
S01010903,All households,427,204,90,114,216,26,98,40,32,26,92,61,31,7,5,0,0,2
S01010903,Occupancy rating +2 or more,68,35,15,20,33,7,18,14,2,2,8,7,1,0,0,0,0,0
S01010903,Occupancy rating +1,131,63,23,40,68,11,35,19,6,10,22,12,10,0,0,0,0,0
S01010903,Occupancy rating 0,155,75,37,38,77,5,32,4,16,12,40,26,14,3,1,0,0,2
S01010903,Occupancy rating -1 or less,73,31,15,16,38,3,13,3,8,2,22,16,6,4,4,0,0,0
S01010904,All households,271,130,23,107,131,6,79,37,32,10,46,31,15,10,5,0,0,5
S01010904,Occupancy rating +2 or more,40,13,4,9,26,1,22,16,5,1,3,1,2,1,0,0,0,1
S01010904,Occupancy rating +1,76,40,7,33,36,4,26,16,7,3,6,3,3,0,0,0,0,0
S01010904,Occupancy rating 0,106,56,7,49,46,1,20,4,12,4,25,17,8,4,2,0,0,2
S01010904,Occupancy rating -1 or less,49,21,5,16,23,0,11,1,8,2,12,10,2,5,3,0,0,2
S01010905,All households,290,93,14,79,180,8,104,50,42,12,68,53,15,17,3,0,0,14
S01010905,Occupancy rating +2 or more,61,13,1,12,44,4,35,14,19,2,5,4,1,4,1,0,0,3
S01010905,Occupancy rating +1,90,34,8,26,52,0,34,24,8,2,18,15,3,4,1,0,0,3
S01010905,Occupancy rating 0,97,32,4,28,61,3,26,9,10,7,32,24,8,4,0,0,0,4
S01010905,Occupancy rating -1 or less,42,14,1,13,23,1,9,3,5,1,13,10,3,5,1,0,0,4
S01010906,All households,383,92,26,66,268,7,170,55,79,36,91,64,27,23,13,0,0,10
S01010906,Occupancy rating +2 or more,72,19,6,13,53,2,41,25,12,4,10,7,3,0,0,0,0,0
S01010906,Occupancy rating +1,129,47,15,32,75,4,53,26,18,9,18,12,6,7,3,0,0,4
S01010906,Occupancy rating 0,133,17,3,14,109,1,57,3,33,21,51,37,14,7,3,0,0,4
S01010906,Occupancy rating -1 or less,49,9,2,7,31,0,19,1,16,2,12,8,4,9,7,0,0,2
S01010907,All households,199,34,4,30,156,3,137,59,68,10,16,10,6,9,6,0,0,3
S01010907,Occupancy rating +2 or more,143,26,2,24,113,3,103,58,41,4,7,4,3,4,2,0,0,2
S01010907,Occupancy rating +1,38,4,1,3,31,0,27,0,21,6,4,3,1,3,2,0,0,1
S01010907,Occupancy rating 0,10,3,1,2,7,0,5,0,5,0,2,1,1,0,0,0,0,0
S01010907,Occupancy rating -1 or less,8,1,0,1,5,0,2,1,1,0,3,2,1,2,2,0,0,0
S01010908,All households,274,103,52,51,160,14,113,39,37,37,33,24,9,11,5,0,0,6
S01010908,Occupancy rating +2 or more,75,21,9,12,50,5,43,16,8,19,2,1,1,4,1,0,0,3
S01010908,Occupancy rating +1,84,37,17,20,45,4,39,21,11,7,2,1,1,2,0,0,0,2
S01010908,Occupancy rating 0,79,37,25,12,41,1,20,2,13,5,20,16,4,1,1,0,0,0
S01010908,Occupancy rating -1 or less,36,8,1,7,24,4,11,0,5,6,9,6,3,4,3,0,0,1
S01010909,All households,284,85,20,65,188,29,140,47,59,34,19,10,9,11,2,4,0,5
S01010909,Occupancy rating +2 or more,110,28,14,14,81,21,57,26,17,14,3,1,2,1,0,0,0,1
S01010909,Occupancy rating +1,85,24,3,21,57,7,47,19,18,10,3,0,3,4,0,0,0,4
S01010909,Occupancy rating 0,65,27,3,24,37,1,28,1,19,8,8,5,3,1,1,0,0,0
S01010909,Occupancy rating -1 or less,24,6,0,6,13,0,8,1,5,2,5,4,1,5,1,4,0,0
S01010910,All households,273,154,35,119,109,6,62,26,26,10,41,34,7,10,4,0,1,5
S01010910,Occupancy rating +2 or more,23,16,5,11,7,1,4,3,0,1,2,1,1,0,0,0,0,0
S01010910,Occupancy rating +1,109,74,18,56,33,4,19,16,3,0,10,7,3,2,0,0,1,1
S01010910,Occupancy rating 0,98,49,10,39,46,0,29,6,17,6,17,15,2,3,0,0,0,3
S01010910,Occupancy rating -1 or less,43,15,2,13,23,1,10,1,6,3,12,11,1,5,4,0,0,1
S01010911,All households,360,231,100,131,112,17,56,32,10,14,39,26,13,17,3,1,3,10
S01010911,Occupancy rating +2 or more,37,18,6,12,18,4,10,7,2,1,4,3,1,1,0,0,0,1
S01010911,Occupancy rating +1,129,91,36,55,38,8,27,21,1,5,3,1,2,0,0,0,0,0
S01010911,Occupancy rating 0,140,87,44,43,40,2,13,2,4,7,25,17,8,13,1,1,3,8
S01010911,Occupancy rating -1 or less,54,35,14,21,16,3,6,2,3,1,7,5,2,3,2,0,0,1
S01010912,All households,392,213,102,111,156,29,80,37,26,17,47,29,18,23,8,7,1,7
S01010912,Occupancy rating +2 or more,46,18,6,12,28,9,17,11,3,3,2,1,1,0,0,0,0,0
S01010912,Occupancy rating +1,96,54,31,23,42,11,23,12,7,4,8,4,4,0,0,0,0,0
S01010912,Occupancy rating 0,178,100,50,50,72,9,31,12,11,8,32,22,10,6,2,0,1,3
S01010912,Occupancy rating -1 or less,72,41,15,26,14,0,9,2,5,2,5,2,3,17,6,7,0,4
S01010913,All households,293,111,28,83,169,15,127,50,53,24,27,16,11,13,5,1,1,6
S01010913,Occupancy rating +2 or more,86,18,7,11,67,8,56,31,15,10,3,3,0,1,0,0,0,1
S01010913,Occupancy rating +1,94,36,11,25,55,5,42,14,21,7,8,3,5,3,0,0,1,2
S01010913,Occupancy rating 0,92,50,10,40,38,1,24,5,12,7,13,7,6,4,1,0,0,3
S01010913,Occupancy rating -1 or less,21,7,0,7,9,1,5,0,5,0,3,3,0,5,4,1,0,0
S01010914,All households,255,59,14,45,184,13,130,47,54,29,41,22,19,12,9,0,0,3
S01010914,Occupancy rating +2 or more,106,36,11,25,67,13,46,33,7,6,8,3,5,3,1,0,0,2
S01010914,Occupancy rating +1,73,9,2,7,61,0,45,7,24,14,16,8,8,3,3,0,0,0
S01010914,Occupancy rating 0,55,13,1,12,40,0,26,6,14,6,14,8,6,2,1,0,0,1
S01010914,Occupancy rating -1 or less,21,1,0,1,16,0,13,1,9,3,3,3,0,4,4,0,0,0
S01010915,All households,271,50,17,33,203,10,153,42,68,43,40,25,15,18,9,0,0,9
S01010915,Occupancy rating +2 or more,108,34,12,22,72,10,57,34,13,10,5,4,1,2,0,0,0,2
S01010915,Occupancy rating +1,78,8,2,6,68,0,52,6,28,18,16,8,8,2,1,0,0,1
S01010915,Occupancy rating 0,62,7,2,5,44,0,34,1,20,13,10,6,4,11,6,0,0,5
S01010915,Occupancy rating -1 or less,23,1,1,0,19,0,10,1,7,2,9,7,2,3,2,0,0,1
S01010916,All households,333,194,43,151,129,11,64,24,22,18,54,40,14,10,1,6,1,2
S01010916,Occupancy rating +2 or more,37,21,10,11,16,3,11,5,0,6,2,1,1,0,0,0,0,0
S01010916,Occupancy rating +1,93,56,22,34,37,7,22,16,3,3,8,2,6,0,0,0,0,0
S01010916,Occupancy rating 0,132,83,9,74,45,0,20,1,13,6,25,20,5,4,0,1,1,2
S01010916,Occupancy rating -1 or less,71,34,2,32,31,1,11,2,6,3,19,17,2,6,1,5,0,0
S01010917,All households,369,173,66,107,183,23,114,45,37,32,46,30,16,13,3,0,0,10
S01010917,Occupancy rating +2 or more,93,36,20,16,56,7,42,24,8,10,7,6,1,1,0,0,0,1
S01010917,Occupancy rating +1,135,69,32,37,62,13,36,17,12,7,13,3,10,4,2,0,0,2
S01010917,Occupancy rating 0,101,46,8,38,50,2,29,4,13,12,19,17,2,5,0,0,0,5
S01010917,Occupancy rating -1 or less,40,22,6,16,15,1,7,0,4,3,7,4,3,3,1,0,0,2
S01010918,All households,334,119,78,41,200,37,116,50,45,21,47,32,15,15,7,1,0,7
S01010918,Occupancy rating +2 or more,90,31,19,12,59,21,37,29,6,2,1,0,1,0,0,0,0,0
S01010918,Occupancy rating +1,88,24,13,11,59,7,40,10,16,14,12,7,5,5,0,0,0,5
S01010918,Occupancy rating 0,131,60,42,18,68,9,33,9,19,5,26,21,5,3,1,0,0,2
S01010918,Occupancy rating -1 or less,25,4,4,0,14,0,6,2,4,0,8,4,4,7,6,1,0,0
S01010919,All households,335,99,32,67,218,28,130,34,56,40,60,36,24,18,10,0,1,7
S01010919,Occupancy rating +2 or more,96,46,21,25,48,14,32,23,3,6,2,0,2,2,1,0,0,1
S01010919,Occupancy rating +1,119,33,8,25,81,12,49,11,18,20,20,11,9,5,0,0,1,4
S01010919,Occupancy rating 0,84,14,2,12,66,1,32,0,23,9,33,20,13,4,2,0,0,2
S01010919,Occupancy rating -1 or less,36,6,1,5,23,1,17,0,12,5,5,5,0,7,7,0,0,0
S01010920,All households,254,87,22,65,149,4,76,27,24,25,69,55,14,18,10,0,0,8
S01010920,Occupancy rating +2 or more,56,19,4,15,36,2,29,15,10,4,5,4,1,1,0,0,0,1
S01010920,Occupancy rating +1,87,42,14,28,40,1,20,7,5,8,19,13,6,5,2,0,0,3
S01010920,Occupancy rating 0,79,22,3,19,56,1,20,4,6,10,35,30,5,1,0,0,0,1
S01010920,Occupancy rating -1 or less,32,4,1,3,17,0,7,1,3,3,10,8,2,11,8,0,0,3
S01010921,All households,257,75,30,45,159,10,98,32,41,25,51,23,28,23,9,0,1,13
S01010921,Occupancy rating +2 or more,76,42,18,24,32,8,23,19,2,2,1,1,0,2,0,0,0,2
S01010921,Occupancy rating +1,84,20,6,14,54,1,32,12,13,7,21,9,12,10,1,0,1,8
S01010921,Occupancy rating 0,61,4,1,3,51,1,30,0,18,12,20,9,11,6,3,0,0,3
S01010921,Occupancy rating -1 or less,36,9,5,4,22,0,13,1,8,4,9,4,5,5,5,0,0,0
S01010922,All households,346,107,58,49,206,20,115,42,45,28,71,48,23,33,17,0,1,15
S01010922,Occupancy rating +2 or more,114,59,27,32,55,11,41,35,2,4,3,2,1,0,0,0,0,0
S01010922,Occupancy rating +1,82,15,4,11,59,6,30,5,11,14,23,12,11,8,1,0,0,7
S01010922,Occupancy rating 0,113,27,23,4,69,3,33,2,24,7,33,25,8,17,11,0,0,6
S01010922,Occupancy rating -1 or less,37,6,4,2,23,0,11,0,8,3,12,9,3,8,5,0,1,2
S01010923,All households,398,139,61,78,240,21,160,65,58,37,59,36,23,19,9,0,0,10
S01010923,Occupancy rating +2 or more,80,23,10,13,57,12,39,30,5,4,6,3,3,0,0,0,0,0
S01010923,Occupancy rating +1,136,45,19,26,88,6,62,28,19,15,20,9,11,3,1,0,0,2
S01010923,Occupancy rating 0,135,60,27,33,67,2,40,5,21,14,25,17,8,8,2,0,0,6
S01010923,Occupancy rating -1 or less,47,11,5,6,28,1,19,2,13,4,8,7,1,8,6,0,0,2
S01010924,All households,260,81,43,38,161,15,104,36,37,31,42,19,23,18,8,0,1,9
S01010924,Occupancy rating +2 or more,83,29,13,16,51,9,36,25,3,8,6,1,5,3,0,0,0,3
S01010924,Occupancy rating +1,72,25,14,11,43,3,26,5,9,12,14,3,11,4,1,0,1,2
S01010924,Occupancy rating 0,78,22,13,9,49,3,32,6,20,6,14,8,6,7,3,0,0,4
S01010924,Occupancy rating -1 or less,27,5,3,2,18,0,10,0,5,5,8,7,1,4,4,0,0,0
S01010925,All households,386,122,50,72,241,38,105,28,49,28,98,66,32,23,11,0,1,11
S01010925,Occupancy rating +2 or more,80,38,18,20,41,18,18,13,2,3,5,1,4,1,0,0,0,1
S01010925,Occupancy rating +1,117,51,22,29,64,16,29,11,8,10,19,9,10,2,0,0,0,2
S01010925,Occupancy rating 0,140,26,7,19,103,2,41,3,24,14,60,47,13,11,4,0,1,6
S01010925,Occupancy rating -1 or less,49,7,3,4,33,2,17,1,15,1,14,9,5,9,7,0,0,2
S01010926,All households,352,119,49,70,219,20,132,53,41,38,67,47,20,14,4,0,0,10
S01010926,Occupancy rating +2 or more,119,56,29,27,63,12,49,42,5,2,2,1,1,0,0,0,0,0
S01010926,Occupancy rating +1,95,25,12,13,66,5,40,7,14,19,21,11,10,4,0,0,0,4
S01010926,Occupancy rating 0,98,35,7,28,58,2,25,4,10,11,31,24,7,5,2,0,0,3
S01010926,Occupancy rating -1 or less,40,3,1,2,32,1,18,0,12,6,13,11,2,5,2,0,0,3
S01010927,All households,251,70,29,41,163,15,95,41,35,19,53,37,16,18,7,0,1,10
S01010927,Occupancy rating +2 or more,50,24,12,12,25,4,19,13,3,3,2,0,2,1,0,0,0,1
S01010927,Occupancy rating +1,99,35,14,21,59,9,38,24,9,5,12,7,5,5,1,0,1,3
S01010927,Occupancy rating 0,68,6,2,4,57,2,24,2,14,8,31,23,8,5,3,0,0,2
S01010927,Occupancy rating -1 or less,34,5,1,4,22,0,14,2,9,3,8,7,1,7,3,0,0,4
S01010928,All households,311,97,30,67,200,23,107,35,47,25,70,59,11,14,7,0,2,5
S01010928,Occupancy rating +2 or more,74,33,14,19,41,12,22,17,3,2,7,7,0,0,0,0,0,0
S01010928,Occupancy rating +1,115,38,10,28,75,8,42,14,14,14,25,21,4,2,1,0,1,0
S01010928,Occupancy rating 0,92,25,6,19,60,2,29,3,19,7,29,24,5,7,3,0,0,4
S01010928,Occupancy rating -1 or less,30,1,0,1,24,1,14,1,11,2,9,7,2,5,3,0,1,1
S01010929,All households,271,77,30,47,174,11,92,28,35,29,71,51,20,20,7,0,3,10
S01010929,Occupancy rating +2 or more,49,24,11,13,25,4,15,12,1,2,6,4,2,0,0,0,0,0
S01010929,Occupancy rating +1,88,33,13,20,50,6,29,13,7,9,15,11,4,5,0,0,1,4
S01010929,Occupancy rating 0,94,13,2,11,72,1,33,1,19,13,38,27,11,9,3,0,2,4
S01010929,Occupancy rating -1 or less,40,7,4,3,27,0,15,2,8,5,12,9,3,6,4,0,0,2
S01010930,All households,357,69,25,44,276,28,232,110,105,17,16,10,6,12,1,0,0,11
S01010930,Occupancy rating +2 or more,252,42,17,25,207,23,177,94,70,13,7,4,3,3,0,0,0,3
S01010930,Occupancy rating +1,68,17,5,12,45,5,35,13,21,1,5,4,1,6,1,0,0,5
S01010930,Occupancy rating 0,33,9,3,6,22,0,18,2,13,3,4,2,2,2,0,0,0,2
S01010930,Occupancy rating -1 or less,4,1,0,1,2,0,2,1,1,0,0,0,0,1,0,0,0,1
S01010931,All households,203,64,26,38,132,16,97,49,31,17,19,9,10,7,4,0,1,2
S01010931,Occupancy rating +2 or more,125,46,21,25,78,12,61,38,18,5,5,2,3,1,1,0,0,0
S01010931,Occupancy rating +1,45,12,4,8,30,4,20,9,4,7,6,3,3,3,1,0,1,1
S01010931,Occupancy rating 0,28,6,1,5,20,0,13,1,7,5,7,4,3,2,1,0,0,1
S01010931,Occupancy rating -1 or less,5,0,0,0,4,0,3,1,2,0,1,0,1,1,1,0,0,0
S01010932,All households,277,111,44,67,162,13,111,59,43,9,38,18,20,4,1,0,0,3
S01010932,Occupancy rating +2 or more,70,19,8,11,49,4,43,31,9,3,2,0,2,2,1,0,0,1
S01010932,Occupancy rating +1,83,37,18,19,46,5,34,21,10,3,7,4,3,0,0,0,0,0
S01010932,Occupancy rating 0,92,45,13,32,46,4,24,5,17,2,18,11,7,1,0,0,0,1
S01010932,Occupancy rating -1 or less,32,10,5,5,21,0,10,2,7,1,11,3,8,1,0,0,0,1
S01010933,All households,276,46,16,30,214,10,193,75,101,17,11,8,3,16,7,0,1,8
S01010933,Occupancy rating +2 or more,208,32,12,20,167,10,151,67,71,13,6,5,1,9,3,0,1,5
S01010933,Occupancy rating +1,38,6,3,3,29,0,28,7,18,3,1,0,1,3,1,0,0,2
S01010933,Occupancy rating 0,21,7,0,7,13,0,10,1,8,1,3,3,0,1,1,0,0,0
S01010933,Occupancy rating -1 or less,9,1,1,0,5,0,4,0,4,0,1,0,1,3,2,0,0,1
S01010934,All households,424,105,38,67,305,42,248,103,108,37,15,9,6,14,5,1,0,8
S01010934,Occupancy rating +2 or more,250,40,20,20,206,32,170,77,63,30,4,3,1,4,2,0,0,2
S01010934,Occupancy rating +1,91,37,12,25,53,7,43,19,21,3,3,1,2,1,0,0,0,1
S01010934,Occupancy rating 0,63,22,3,19,35,1,26,7,15,4,8,5,3,6,2,1,0,3
S01010934,Occupancy rating -1 or less,20,6,3,3,11,2,9,0,9,0,0,0,0,3,1,0,0,2
S01010935,All households,323,125,82,43,186,46,125,62,41,22,15,8,7,12,5,0,0,7
S01010935,Occupancy rating +2 or more,174,48,33,15,124,40,83,47,26,10,1,1,0,2,1,0,0,1
S01010935,Occupancy rating +1,65,31,15,16,31,4,23,7,8,8,4,1,3,3,1,0,0,2
S01010935,Occupancy rating 0,67,37,29,8,26,2,16,6,6,4,8,4,4,4,1,0,0,3
S01010935,Occupancy rating -1 or less,17,9,5,4,5,0,3,2,1,0,2,2,0,3,2,0,0,1
S01010936,All households,404,228,94,134,155,34,105,63,28,14,16,8,8,21,5,0,1,15
S01010936,Occupancy rating +2 or more,90,27,13,14,58,16,40,17,16,7,2,1,1,5,2,0,0,3
S01010936,Occupancy rating +1,110,60,24,36,43,8,31,23,4,4,4,0,4,7,1,0,1,5
S01010936,Occupancy rating 0,145,99,45,54,39,8,22,16,4,2,9,7,2,7,0,0,0,7
S01010936,Occupancy rating -1 or less,59,42,12,30,15,2,12,7,4,1,1,0,1,2,2,0,0,0
S01010937,All households,323,92,38,54,218,27,162,80,50,32,29,15,14,13,7,1,0,5
S01010937,Occupancy rating +2 or more,154,38,15,23,111,19,89,61,12,16,3,0,3,5,4,0,0,1
S01010937,Occupancy rating +1,96,34,13,21,58,8,43,16,15,12,7,3,4,4,1,0,0,3
S01010937,Occupancy rating 0,63,18,8,10,42,0,26,2,20,4,16,10,6,3,1,1,0,1
S01010937,Occupancy rating -1 or less,10,2,2,0,7,0,4,1,3,0,3,2,1,1,1,0,0,0
S01010938,All households,369,131,56,75,225,25,119,43,49,27,81,56,25,13,8,0,0,5
S01010938,Occupancy rating +2 or more,81,36,18,18,43,9,28,19,3,6,6,3,3,2,1,0,0,1
S01010938,Occupancy rating +1,153,74,32,42,76,13,40,21,11,8,23,13,10,3,0,0,0,3
S01010938,Occupancy rating 0,96,16,2,14,78,2,40,3,26,11,36,26,10,2,1,0,0,1
S01010938,Occupancy rating -1 or less,39,5,4,1,28,1,11,0,9,2,16,14,2,6,6,0,0,0
S01010939,All households,199,32,12,20,162,17,124,49,52,23,21,7,14,5,3,0,0,2
S01010939,Occupancy rating +2 or more,111,25,11,14,86,16,64,41,13,10,6,0,6,0,0,0,0,0
S01010939,Occupancy rating +1,50,7,1,6,42,1,35,8,18,9,6,2,4,1,0,0,0,1
S01010939,Occupancy rating 0,29,0,0,0,25,0,19,0,15,4,6,4,2,4,3,0,0,1
S01010939,Occupancy rating -1 or less,9,0,0,0,9,0,6,0,6,0,3,1,2,0,0,0,0,0
S01010940,All households,268,42,31,11,217,52,152,56,59,37,13,7,6,9,3,0,1,5
S01010940,Occupancy rating +2 or more,200,39,29,10,156,49,102,54,26,22,5,3,2,5,2,0,1,2
S01010940,Occupancy rating +1,44,2,1,1,40,3,32,2,19,11,5,2,3,2,0,0,0,2
S01010940,Occupancy rating 0,21,1,1,0,19,0,17,0,13,4,2,1,1,1,0,0,0,1
S01010940,Occupancy rating -1 or less,3,0,0,0,2,0,1,0,1,0,1,1,0,1,1,0,0,0
S01010941,All households,323,48,29,19,269,48,202,65,91,46,19,11,8,6,2,0,0,4
S01010941,Occupancy rating +2 or more,240,45,27,18,192,47,138,61,47,30,7,3,4,3,0,0,0,3
S01010941,Occupancy rating +1,49,1,1,0,48,0,44,1,32,11,4,0,4,0,0,0,0,0
S01010941,Occupancy rating 0,25,2,1,1,21,1,15,3,7,5,5,5,0,2,1,0,0,1
S01010941,Occupancy rating -1 or less,9,0,0,0,8,0,5,0,5,0,3,3,0,1,1,0,0,0
S01010942,All households,268,51,30,21,212,46,157,63,62,32,9,3,6,5,2,0,1,2
S01010942,Occupancy rating +2 or more,213,44,27,17,166,41,121,59,42,20,4,2,2,3,1,0,0,2
S01010942,Occupancy rating +1,39,2,0,2,37,4,28,4,13,11,5,1,4,0,0,0,0,0
S01010942,Occupancy rating 0,13,4,2,2,7,0,7,0,6,1,0,0,0,2,1,0,1,0
S01010942,Occupancy rating -1 or less,3,1,1,0,2,1,1,0,1,0,0,0,0,0,0,0,0,0
S01010943,All households,244,45,17,28,188,17,114,43,48,23,57,33,24,11,3,0,1,7
S01010943,Occupancy rating +2 or more,76,17,10,7,58,16,38,29,4,5,4,3,1,1,0,0,1,0
S01010943,Occupancy rating +1,94,24,7,17,66,1,43,12,21,10,22,9,13,4,1,0,0,3
S01010943,Occupancy rating 0,57,4,0,4,52,0,28,2,18,8,24,15,9,1,0,0,0,1
S01010943,Occupancy rating -1 or less,17,0,0,0,12,0,5,0,5,0,7,6,1,5,2,0,0,3
S01010944,All households,295,124,50,74,162,25,85,36,32,17,52,38,14,9,3,0,1,5
S01010944,Occupancy rating +2 or more,77,37,21,16,40,9,25,21,3,1,6,3,3,0,0,0,0,0
S01010944,Occupancy rating +1,110,60,20,40,48,13,25,13,8,4,10,6,4,2,0,0,1,1
S01010944,Occupancy rating 0,82,23,9,14,54,2,24,2,16,6,28,22,6,5,1,0,0,4
S01010944,Occupancy rating -1 or less,26,4,0,4,20,1,11,0,5,6,8,7,1,2,2,0,0,0
S01010945,All households,222,57,20,37,155,19,108,41,39,28,28,13,15,10,6,0,0,4
S01010945,Occupancy rating +2 or more,99,32,12,20,66,12,51,36,7,8,3,2,1,1,0,0,0,1
S01010945,Occupancy rating +1,59,10,6,4,48,4,32,4,14,14,12,4,8,1,0,0,0,1
S01010945,Occupancy rating 0,52,13,2,11,36,2,23,1,17,5,11,6,5,3,1,0,0,2
S01010945,Occupancy rating -1 or less,12,2,0,2,5,1,2,0,1,1,2,1,1,5,5,0,0,0
S01010946,All households,344,97,61,36,232,31,150,43,63,44,51,26,25,15,7,0,0,8
S01010946,Occupancy rating +2 or more,103,49,26,23,54,15,36,23,8,5,3,2,1,0,0,0,0,0
S01010946,Occupancy rating +1,122,38,28,10,79,12,55,17,23,15,12,2,10,5,1,0,0,4
S01010946,Occupancy rating 0,87,7,5,2,71,3,44,3,23,18,24,12,12,9,5,0,0,4
S01010946,Occupancy rating -1 or less,32,3,2,1,28,1,15,0,9,6,12,10,2,1,1,0,0,0
S01010947,All households,242,73,29,44,156,20,90,35,31,24,46,27,19,13,3,0,0,10
S01010947,Occupancy rating +2 or more,81,30,11,19,49,12,34,23,5,6,3,1,2,2,0,0,0,2
S01010947,Occupancy rating +1,77,24,10,14,51,6,27,9,10,8,18,12,6,2,0,0,0,2
S01010947,Occupancy rating 0,61,14,5,9,40,2,20,3,10,7,18,11,7,7,1,0,0,6
S01010947,Occupancy rating -1 or less,23,5,3,2,16,0,9,0,6,3,7,3,4,2,2,0,0,0
S01010948,All households,288,76,28,48,200,32,132,56,53,23,36,26,10,12,4,1,0,7
S01010948,Occupancy rating +2 or more,106,32,14,18,72,22,48,40,4,4,2,1,1,2,0,0,0,2
S01010948,Occupancy rating +1,87,14,4,10,73,5,55,14,30,11,13,9,4,0,0,0,0,0
S01010948,Occupancy rating 0,77,27,9,18,44,5,24,2,17,5,15,11,4,6,2,1,0,3
S01010948,Occupancy rating -1 or less,18,3,1,2,11,0,5,0,2,3,6,5,1,4,2,0,0,2
S01010949,All households,344,47,30,17,283,26,231,83,97,51,26,14,12,14,6,0,0,8
S01010949,Occupancy rating +2 or more,236,38,25,13,194,26,156,70,53,33,12,6,6,4,2,0,0,2
S01010949,Occupancy rating +1,74,4,2,2,65,0,56,12,28,16,9,5,4,5,3,0,0,2
S01010949,Occupancy rating 0,30,5,3,2,22,0,18,1,15,2,4,3,1,3,1,0,0,2
S01010949,Occupancy rating -1 or less,4,0,0,0,2,0,1,0,1,0,1,0,1,2,0,0,0,2
S01010950,All households,380,108,47,61,260,57,149,59,59,31,54,37,17,12,3,0,0,9
S01010950,Occupancy rating +2 or more,158,42,23,19,114,41,61,33,16,12,12,7,5,2,1,0,0,1
S01010950,Occupancy rating +1,121,46,20,26,71,16,44,24,15,5,11,7,4,4,0,0,0,4
S01010950,Occupancy rating 0,75,18,3,15,53,0,34,2,20,12,19,14,5,4,0,0,0,4
S01010950,Occupancy rating -1 or less,26,2,1,1,22,0,10,0,8,2,12,9,3,2,2,0,0,0
S01010951,All households,258,57,30,27,195,25,130,46,53,31,40,30,10,6,3,1,1,1
S01010951,Occupancy rating +2 or more,107,34,22,12,73,22,48,33,12,3,3,1,2,0,0,0,0,0
S01010951,Occupancy rating +1,79,19,5,14,58,3,37,12,14,11,18,13,5,2,0,0,1,1
S01010951,Occupancy rating 0,63,4,3,1,56,0,39,1,22,16,17,14,3,3,2,1,0,0
S01010951,Occupancy rating -1 or less,9,0,0,0,8,0,6,0,5,1,2,2,0,1,1,0,0,0
S01010952,All households,199,30,14,16,162,7,126,44,61,21,29,22,7,7,2,0,0,5
S01010952,Occupancy rating +2 or more,85,10,4,6,72,6,60,25,20,15,6,4,2,3,0,0,0,3
S01010952,Occupancy rating +1,63,16,8,8,47,1,40,18,19,3,6,5,1,0,0,0,0,0
S01010952,Occupancy rating 0,39,3,1,2,34,0,20,1,17,2,14,10,4,2,1,0,0,1
S01010952,Occupancy rating -1 or less,12,1,1,0,9,0,6,0,5,1,3,3,0,2,1,0,0,1
S01010953,All households,225,51,25,26,164,16,114,37,46,31,34,18,16,10,7,0,0,3
S01010953,Occupancy rating +2 or more,83,20,9,11,60,12,44,24,11,9,4,0,4,3,2,0,0,1
S01010953,Occupancy rating +1,77,19,9,10,56,2,44,10,20,14,10,3,7,2,1,0,0,1
S01010953,Occupancy rating 0,51,11,7,4,37,2,19,0,12,7,16,12,4,3,2,0,0,1
S01010953,Occupancy rating -1 or less,14,1,0,1,11,0,7,3,3,1,4,3,1,2,2,0,0,0
S01010954,All households,206,41,15,26,156,12,128,63,45,20,16,8,8,9,5,0,1,3
S01010954,Occupancy rating +2 or more,94,11,7,4,79,8,69,47,13,9,2,2,0,4,2,0,1,1
S01010954,Occupancy rating +1,70,23,7,16,46,4,35,16,13,6,7,3,4,1,0,0,0,1
S01010954,Occupancy rating 0,26,1,1,0,25,0,20,0,15,5,5,2,3,0,0,0,0,0
S01010954,Occupancy rating -1 or less,16,6,0,6,6,0,4,0,4,0,2,1,1,4,3,0,0,1
S01010955,All households,345,44,17,27,287,17,243,75,143,25,27,18,9,14,8,0,0,6
S01010955,Occupancy rating +2 or more,212,28,12,16,177,16,151,61,72,18,10,6,4,7,4,0,0,3
S01010955,Occupancy rating +1,70,12,3,9,57,1,54,13,38,3,2,1,1,1,1,0,0,0
S01010955,Occupancy rating 0,47,4,2,2,40,0,27,1,24,2,13,9,4,3,1,0,0,2
S01010955,Occupancy rating -1 or less,16,0,0,0,13,0,11,0,9,2,2,2,0,3,2,0,0,1
S01010956,All households,304,89,26,63,205,24,161,75,57,29,20,12,8,10,6,0,0,4
S01010956,Occupancy rating +2 or more,182,50,16,34,130,19,108,57,35,16,3,0,3,2,1,0,0,1
S01010956,Occupancy rating +1,61,21,6,15,36,4,26,8,12,6,6,4,2,4,1,0,0,3
S01010956,Occupancy rating 0,42,13,2,11,26,1,20,10,5,5,5,4,1,3,3,0,0,0
S01010956,Occupancy rating -1 or less,19,5,2,3,13,0,7,0,5,2,6,4,2,1,1,0,0,0
S01010957,All households,231,44,29,15,182,23,143,56,53,34,16,8,8,5,3,0,0,2
S01010957,Occupancy rating +2 or more,152,32,18,14,118,20,90,50,26,14,8,3,5,2,1,0,0,1
S01010957,Occupancy rating +1,53,8,7,1,43,3,36,6,19,11,4,2,2,2,1,0,0,1
S01010957,Occupancy rating 0,21,4,4,0,16,0,12,0,7,5,4,3,1,1,1,0,0,0
S01010957,Occupancy rating -1 or less,5,0,0,0,5,0,5,0,1,4,0,0,0,0,0,0,0,0
S01010958,All households,224,66,41,25,155,39,96,48,25,23,20,10,10,3,2,0,0,1
S01010958,Occupancy rating +2 or more,104,23,12,11,81,25,52,32,9,11,4,2,2,0,0,0,0,0
S01010958,Occupancy rating +1,71,35,25,10,36,10,22,12,5,5,4,1,3,0,0,0,0,0
S01010958,Occupancy rating 0,38,6,3,3,30,4,16,3,8,5,10,5,5,2,1,0,0,1
S01010958,Occupancy rating -1 or less,11,2,1,1,8,0,6,1,3,2,2,2,0,1,1,0,0,0
S01010959,All households,290,118,56,62,162,13,115,57,49,9,34,24,10,10,2,0,3,5
S01010959,Occupancy rating +2 or more,88,21,14,7,63,9,49,24,19,6,5,3,2,4,1,0,1,2
S01010959,Occupancy rating +1,79,45,16,29,33,3,27,16,9,2,3,2,1,1,0,0,0,1
S01010959,Occupancy rating 0,91,41,20,21,47,1,30,12,17,1,16,11,5,3,0,0,1,2
S01010959,Occupancy rating -1 or less,32,11,6,5,19,0,9,5,4,0,10,8,2,2,1,0,1,0
S01010960,All households,441,115,44,71,300,30,223,90,97,36,47,29,18,26,8,0,2,16
S01010960,Occupancy rating +2 or more,218,72,29,43,141,24,111,64,39,8,6,3,3,5,1,0,0,4
S01010960,Occupancy rating +1,106,30,12,18,71,4,54,16,24,14,13,5,8,5,0,0,2,3
S01010960,Occupancy rating 0,83,9,2,7,64,1,42,8,22,12,21,15,6,10,4,0,0,6
S01010960,Occupancy rating -1 or less,34,4,1,3,24,1,16,2,12,2,7,6,1,6,3,0,0,3
S01010961,All households,246,74,40,34,162,25,101,37,37,27,36,20,16,10,5,0,1,4
S01010961,Occupancy rating +2 or more,67,21,12,9,45,9,35,20,8,7,1,0,1,1,0,0,0,1
S01010961,Occupancy rating +1,105,44,23,21,60,13,36,15,10,11,11,7,4,1,1,0,0,0
S01010961,Occupancy rating 0,42,4,2,2,35,0,18,1,13,4,17,10,7,3,1,0,1,1
S01010961,Occupancy rating -1 or less,32,5,3,2,22,3,12,1,6,5,7,3,4,5,3,0,0,2
S01010962,All households,314,160,60,100,144,31,101,68,15,18,12,3,9,10,3,0,2,5
S01010962,Occupancy rating +2 or more,96,45,17,28,48,11,36,28,4,4,1,0,1,3,1,0,1,1
S01010962,Occupancy rating +1,117,60,25,35,54,16,35,25,4,6,3,1,2,3,1,0,0,2
S01010962,Occupancy rating 0,66,34,12,22,28,0,21,14,3,4,7,1,6,4,1,0,1,2
S01010962,Occupancy rating -1 or less,35,21,6,15,14,4,9,1,4,4,1,1,0,0,0,0,0,0
S01010963,All households,395,112,56,56,270,33,193,55,99,39,44,23,21,13,5,0,0,8
S01010963,Occupancy rating +2 or more,156,28,14,14,122,12,106,34,56,16,4,3,1,6,2,0,0,4
S01010963,Occupancy rating +1,124,56,28,28,65,14,43,15,23,5,8,5,3,3,1,0,0,2
S01010963,Occupancy rating 0,92,23,10,13,68,4,36,4,16,16,28,13,15,1,0,0,0,1
S01010963,Occupancy rating -1 or less,23,5,4,1,15,3,8,2,4,2,4,2,2,3,2,0,0,1
S01010964,All households,216,43,21,22,169,37,119,44,40,35,13,9,4,4,0,0,1,3
S01010964,Occupancy rating +2 or more,106,25,10,15,79,30,47,31,10,6,2,2,0,2,0,0,0,2
S01010964,Occupancy rating +1,60,9,5,4,50,6,41,8,13,20,3,1,2,1,0,0,1,0
S01010964,Occupancy rating 0,43,9,6,3,34,1,26,4,15,7,7,5,2,0,0,0,0,0
S01010964,Occupancy rating -1 or less,7,0,0,0,6,0,5,1,2,2,1,1,0,1,0,0,0,1
S01010965,All households,230,73,30,43,135,9,78,36,22,20,48,33,15,22,9,0,1,12
S01010965,Occupancy rating +2 or more,54,21,10,11,30,6,22,14,1,7,2,1,1,3,0,0,0,3
S01010965,Occupancy rating +1,87,40,16,24,41,3,26,17,2,7,12,7,5,6,1,0,1,4
S01010965,Occupancy rating 0,66,9,3,6,47,0,21,3,12,6,26,20,6,10,5,0,0,5
S01010965,Occupancy rating -1 or less,23,3,1,2,17,0,9,2,7,0,8,5,3,3,3,0,0,0
S01010966,All households,309,89,45,44,215,37,142,65,61,16,36,20,16,5,1,0,0,4
S01010966,Occupancy rating +2 or more,103,33,18,15,70,17,53,39,12,2,0,0,0,0,0,0,0,0
S01010966,Occupancy rating +1,113,38,17,21,74,13,45,20,18,7,16,11,5,1,0,0,0,1
S01010966,Occupancy rating 0,69,13,9,4,54,6,32,5,21,6,16,6,10,2,0,0,0,2
S01010966,Occupancy rating -1 or less,24,5,1,4,17,1,12,1,10,1,4,3,1,2,1,0,0,1
S01010967,All households,309,103,39,64,190,18,110,43,51,16,62,39,23,16,9,0,0,7
S01010967,Occupancy rating +2 or more,52,20,8,12,30,5,24,14,8,2,1,1,0,2,1,0,0,1
S01010967,Occupancy rating +1,110,52,19,33,55,10,32,23,4,5,13,6,7,3,1,0,0,2
S01010967,Occupancy rating 0,101,18,8,10,78,3,35,3,23,9,40,27,13,5,3,0,0,2
S01010967,Occupancy rating -1 or less,46,13,4,9,27,0,19,3,16,0,8,5,3,6,4,0,0,2
S01010968,All households,316,77,36,41,216,46,134,67,49,18,36,20,16,23,6,0,3,14
S01010968,Occupancy rating +2 or more,155,42,25,17,111,35,69,47,15,7,7,5,2,2,0,0,0,2
S01010968,Occupancy rating +1,89,22,9,13,59,9,39,17,15,7,11,4,7,8,1,0,1,6
S01010968,Occupancy rating 0,57,12,2,10,37,1,25,3,18,4,11,7,4,8,3,0,2,3
S01010968,Occupancy rating -1 or less,15,1,0,1,9,1,1,0,1,0,7,4,3,5,2,0,0,3
S01010969,All households,264,91,50,41,166,33,114,69,28,17,19,13,6,7,2,0,0,5
S01010969,Occupancy rating +2 or more,149,32,18,14,112,25,81,58,16,7,6,4,2,5,1,0,0,4
S01010969,Occupancy rating +1,56,28,12,16,27,2,20,8,6,6,5,3,2,1,1,0,0,0
S01010969,Occupancy rating 0,30,10,4,6,19,4,10,3,3,4,5,4,1,1,0,0,0,1
S01010969,Occupancy rating -1 or less,29,21,16,5,8,2,3,0,3,0,3,2,1,0,0,0,0,0
S01010970,All households,428,142,70,72,265,37,190,84,75,31,38,25,13,21,5,0,3,13
S01010970,Occupancy rating +2 or more,156,43,25,18,107,26,78,43,25,10,3,2,1,6,1,0,0,5
S01010970,Occupancy rating +1,124,53,26,27,68,8,54,27,19,8,6,4,2,3,1,0,1,1
S01010970,Occupancy rating 0,110,30,14,16,70,3,42,12,19,11,25,18,7,10,1,0,2,7
S01010970,Occupancy rating -1 or less,38,16,5,11,20,0,16,2,12,2,4,1,3,2,2,0,0,0
S01010971,All households,401,60,20,40,327,44,221,89,90,42,62,53,9,14,7,0,0,7
S01010971,Occupancy rating +2 or more,244,43,14,29,198,39,145,77,44,24,14,11,3,3,1,0,0,2
S01010971,Occupancy rating +1,78,13,6,7,65,4,42,8,27,7,19,17,2,0,0,0,0,0
S01010971,Occupancy rating 0,58,1,0,1,52,1,28,3,16,9,23,21,2,5,3,0,0,2
S01010971,Occupancy rating -1 or less,21,3,0,3,12,0,6,1,3,2,6,4,2,6,3,0,0,3
S01010972,All households,333,73,35,38,243,18,159,57,76,26,66,48,18,17,12,0,0,5
S01010972,Occupancy rating +2 or more,98,35,20,15,63,11,45,33,9,3,7,5,2,0,0,0,0,0
S01010972,Occupancy rating +1,94,22,7,15,69,3,51,18,21,12,15,11,4,3,2,0,0,1
S01010972,Occupancy rating 0,114,12,6,6,94,4,57,6,41,10,33,25,8,8,5,0,0,3
S01010972,Occupancy rating -1 or less,27,4,2,2,17,0,6,0,5,1,11,7,4,6,5,0,0,1
S01010973,All households,205,51,28,23,143,28,101,41,31,29,14,10,4,11,4,0,0,7
S01010973,Occupancy rating +2 or more,109,40,24,16,67,24,42,35,3,4,1,1,0,2,0,0,0,2
S01010973,Occupancy rating +1,55,5,4,1,46,3,34,2,12,20,9,6,3,4,1,0,0,3
S01010973,Occupancy rating 0,31,6,0,6,22,1,18,1,12,5,3,2,1,3,1,0,0,2
S01010973,Occupancy rating -1 or less,10,0,0,0,8,0,7,3,4,0,1,1,0,2,2,0,0,0
S01010974,All households,298,86,42,44,193,27,137,41,50,46,29,15,14,19,6,0,1,12
S01010974,Occupancy rating +2 or more,96,43,23,20,52,11,38,20,11,7,3,1,2,1,0,0,0,1
S01010974,Occupancy rating +1,106,33,16,17,68,14,48,17,13,18,6,4,2,5,0,0,1,4
S01010974,Occupancy rating 0,70,7,2,5,56,1,38,3,16,19,17,9,8,7,0,0,0,7
S01010974,Occupancy rating -1 or less,26,3,1,2,17,1,13,1,10,2,3,1,2,6,6,0,0,0
S01010975,All households,195,45,30,15,137,13,89,32,43,14,35,20,15,13,2,0,2,9
S01010975,Occupancy rating +2 or more,46,16,9,7,26,6,19,13,3,3,1,1,0,4,1,0,1,2
S01010975,Occupancy rating +1,67,22,15,7,42,6,31,19,12,0,5,4,1,3,0,0,0,3
S01010975,Occupancy rating 0,54,5,5,0,45,0,24,0,16,8,21,10,11,4,0,0,1,3
S01010975,Occupancy rating -1 or less,28,2,1,1,24,1,15,0,12,3,8,5,3,2,1,0,0,1
S01010976,All households,211,55,22,33,144,20,96,35,42,19,28,12,16,12,6,0,1,5
S01010976,Occupancy rating +2 or more,53,15,6,9,35,5,26,12,11,3,4,2,2,3,0,0,1,2
S01010976,Occupancy rating +1,76,23,9,14,51,14,35,20,8,7,2,0,2,2,0,0,0,2
S01010976,Occupancy rating 0,63,13,7,6,47,1,30,3,19,8,16,6,10,3,2,0,0,1
S01010976,Occupancy rating -1 or less,19,4,0,4,11,0,5,0,4,1,6,4,2,4,4,0,0,0
S01010977,All households,312,89,50,39,216,36,143,55,64,24,37,22,15,7,2,0,1,4
S01010977,Occupancy rating +2 or more,112,39,21,18,73,17,52,28,18,6,4,2,2,0,0,0,0,0
S01010977,Occupancy rating +1,111,36,20,16,74,16,51,23,19,9,7,4,3,1,0,0,0,1
S01010977,Occupancy rating 0,66,13,9,4,48,1,27,4,15,8,20,12,8,5,1,0,1,3
S01010977,Occupancy rating -1 or less,23,1,0,1,21,2,13,0,12,1,6,4,2,1,1,0,0,0
S01010978,All households,354,147,78,69,189,19,110,43,44,23,60,45,15,18,5,0,0,13
S01010978,Occupancy rating +2 or more,77,29,15,14,43,6,29,17,7,5,8,5,3,5,2,0,0,3
S01010978,Occupancy rating +1,110,57,23,34,52,9,31,15,10,6,12,8,4,1,1,0,0,0
S01010978,Occupancy rating 0,129,49,33,16,73,3,36,9,21,6,34,28,6,7,1,0,0,6
S01010978,Occupancy rating -1 or less,38,12,7,5,21,1,14,2,6,6,6,4,2,5,1,0,0,4
S01010979,All households,324,83,37,46,215,24,146,42,76,28,45,27,18,26,11,0,2,13
S01010979,Occupancy rating +2 or more,120,50,27,23,66,16,42,28,9,5,8,5,3,4,1,0,1,2
S01010979,Occupancy rating +1,104,20,5,15,75,5,54,11,31,12,16,7,9,9,1,0,1,7
S01010979,Occupancy rating 0,71,10,5,5,54,3,36,2,25,9,15,10,5,7,5,0,0,2
S01010979,Occupancy rating -1 or less,29,3,0,3,20,0,14,1,11,2,6,5,1,6,4,0,0,2
S01010980,All households,348,137,54,83,203,32,123,51,50,22,48,28,20,8,5,0,0,3
S01010980,Occupancy rating +2 or more,119,34,17,17,82,21,54,32,18,4,7,3,4,3,2,0,0,1
S01010980,Occupancy rating +1,95,31,11,20,63,9,40,14,18,8,14,6,8,1,0,0,0,1
S01010980,Occupancy rating 0,110,63,25,38,45,2,24,3,13,8,19,14,5,2,1,0,0,1
S01010980,Occupancy rating -1 or less,24,9,1,8,13,0,5,2,1,2,8,5,3,2,2,0,0,0
S01010981,All households,330,104,50,54,210,33,133,61,51,21,44,22,22,16,10,0,3,3
S01010981,Occupancy rating +2 or more,104,26,11,15,73,21,49,31,10,8,3,0,3,5,2,0,2,1
S01010981,Occupancy rating +1,113,33,15,18,77,6,57,25,22,10,14,5,9,3,2,0,1,0
S01010981,Occupancy rating 0,84,36,21,15,45,6,20,5,13,2,19,12,7,3,2,0,0,1
S01010981,Occupancy rating -1 or less,29,9,3,6,15,0,7,0,6,1,8,5,3,5,4,0,0,1
S01010982,All households,447,114,44,70,316,47,249,116,87,46,20,8,12,17,6,0,2,9
S01010982,Occupancy rating +2 or more,285,60,29,31,220,37,175,93,52,30,8,2,6,5,2,0,0,3
S01010982,Occupancy rating +1,83,31,9,22,47,7,38,17,14,7,2,0,2,5,1,0,2,2
S01010982,Occupancy rating 0,57,15,3,12,38,2,28,5,16,7,8,5,3,4,1,0,0,3
S01010982,Occupancy rating -1 or less,22,8,3,5,11,1,8,1,5,2,2,1,1,3,2,0,0,1
S01010983,All households,388,137,72,65,244,46,160,73,64,23,38,29,9,7,1,0,0,6
S01010983,Occupancy rating +2 or more,143,41,26,15,99,31,64,37,20,7,4,3,1,3,0,0,0,3
S01010983,Occupancy rating +1,136,64,35,29,71,12,52,29,13,10,7,3,4,1,0,0,0,1
S01010983,Occupancy rating 0,83,25,9,16,57,1,31,3,24,4,25,21,4,1,0,0,0,1
S01010983,Occupancy rating -1 or less,26,7,2,5,17,2,13,4,7,2,2,2,0,2,1,0,0,1
S01010984,All households,300,83,57,26,208,61,131,59,52,20,16,10,6,9,6,0,0,3
S01010984,Occupancy rating +2 or more,190,45,34,11,140,52,86,48,24,14,2,2,0,5,3,0,0,2
S01010984,Occupancy rating +1,70,29,16,13,40,6,29,10,13,6,5,2,3,1,0,0,0,1
S01010984,Occupancy rating 0,28,8,6,2,19,2,11,0,11,0,6,3,3,1,1,0,0,0
S01010984,Occupancy rating -1 or less,12,1,1,0,9,1,5,1,4,0,3,3,0,2,2,0,0,0
S01010985,All households,244,59,28,31,166,29,96,21,53,22,41,24,17,19,8,0,1,10
S01010985,Occupancy rating +2 or more,117,39,21,18,76,27,43,19,18,6,6,4,2,2,0,0,0,2
S01010985,Occupancy rating +1,62,8,7,1,49,2,33,2,23,8,14,7,7,5,1,0,0,4
S01010985,Occupancy rating 0,45,8,0,8,30,0,15,0,9,6,15,9,6,7,3,0,1,3
S01010985,Occupancy rating -1 or less,20,4,0,4,11,0,5,0,3,2,6,4,2,5,4,0,0,1
S01010986,All households,179,18,10,8,152,9,136,39,85,12,7,3,4,9,5,0,2,2
S01010986,Occupancy rating +2 or more,114,9,4,5,104,4,97,29,60,8,3,1,2,1,0,0,1,0
S01010986,Occupancy rating +1,40,7,5,2,32,5,26,9,17,0,1,1,0,1,1,0,0,0
S01010986,Occupancy rating 0,19,2,1,1,12,0,9,1,5,3,3,1,2,5,2,0,1,2
S01010986,Occupancy rating -1 or less,6,0,0,0,4,0,4,0,3,1,0,0,0,2,2,0,0,0
S01010987,All households,219,27,13,14,190,12,167,43,115,9,11,9,2,2,2,0,0,0
S01010987,Occupancy rating +2 or more,163,13,5,8,149,6,136,39,90,7,7,7,0,1,1,0,0,0
S01010987,Occupancy rating +1,48,14,8,6,34,6,26,4,21,1,2,1,1,0,0,0,0,0
S01010987,Occupancy rating 0,7,0,0,0,7,0,5,0,4,1,2,1,1,0,0,0,0,0
S01010987,Occupancy rating -1 or less,1,0,0,0,0,0,0,0,0,0,0,0,0,1,1,0,0,0
S01010988,All households,205,17,4,13,186,11,158,37,101,20,17,14,3,2,2,0,0,0
S01010988,Occupancy rating +2 or more,151,10,3,7,141,10,124,32,77,15,7,4,3,0,0,0,0,0
S01010988,Occupancy rating +1,35,6,1,5,29,1,23,5,14,4,5,5,0,0,0,0,0,0
S01010988,Occupancy rating 0,16,0,0,0,15,0,10,0,9,1,5,5,0,1,1,0,0,0
S01010988,Occupancy rating -1 or less,3,1,0,1,1,0,1,0,1,0,0,0,0,1,1,0,0,0
S01010989,All households,357,58,4,54,286,3,265,121,134,10,18,11,7,13,7,0,0,6
S01010989,Occupancy rating +2 or more,213,18,1,17,191,1,183,86,91,6,7,3,4,4,3,0,0,1
S01010989,Occupancy rating +1,89,25,1,24,61,2,57,26,29,2,2,1,1,3,1,0,0,2
S01010989,Occupancy rating 0,43,13,1,12,26,0,19,8,9,2,7,6,1,4,2,0,0,2
S01010989,Occupancy rating -1 or less,12,2,1,1,8,0,6,1,5,0,2,1,1,2,1,0,0,1
S01010990,All households,319,74,46,28,229,25,162,61,68,33,42,25,17,16,6,0,0,10
S01010990,Occupancy rating +2 or more,119,36,26,10,81,20,57,32,19,6,4,2,2,2,1,0,0,1
S01010990,Occupancy rating +1,118,25,13,12,87,4,64,24,23,17,19,9,10,6,1,0,0,5
S01010990,Occupancy rating 0,66,12,6,6,48,1,32,4,20,8,15,10,5,6,3,0,0,3
S01010990,Occupancy rating -1 or less,16,1,1,0,13,0,9,1,6,2,4,4,0,2,1,0,0,1
S01010991,All households,198,24,10,14,163,20,123,53,46,24,20,11,9,11,8,0,0,3
S01010991,Occupancy rating +2 or more,112,15,5,10,93,18,71,36,25,10,4,2,2,4,2,0,0,2
S01010991,Occupancy rating +1,52,9,5,4,41,2,31,10,12,9,8,5,3,2,1,0,0,1
S01010991,Occupancy rating 0,26,0,0,0,22,0,16,7,5,4,6,3,3,4,4,0,0,0
S01010991,Occupancy rating -1 or less,8,0,0,0,7,0,5,0,4,1,2,1,1,1,1,0,0,0
S01010992,All households,184,14,2,12,158,3,148,44,95,9,7,6,1,12,7,1,0,4
S01010992,Occupancy rating +2 or more,150,5,0,5,138,2,132,38,87,7,4,4,0,7,3,1,0,3
S01010992,Occupancy rating +1,18,6,1,5,11,0,10,4,5,1,1,1,0,1,1,0,0,0
S01010992,Occupancy rating 0,10,1,0,1,7,1,5,2,2,1,1,0,1,2,1,0,0,1
S01010992,Occupancy rating -1 or less,6,2,1,1,2,0,1,0,1,0,1,1,0,2,2,0,0,0
S01010993,All households,252,47,19,28,196,23,151,64,66,21,22,13,9,9,6,0,1,2
S01010993,Occupancy rating +2 or more,135,29,9,20,104,15,85,49,28,8,4,1,3,2,2,0,0,0
S01010993,Occupancy rating +1,73,16,9,7,54,4,37,12,18,7,13,7,6,3,2,0,0,1
S01010993,Occupancy rating 0,36,2,1,1,31,3,24,2,17,5,4,4,0,3,1,0,1,1
S01010993,Occupancy rating -1 or less,8,0,0,0,7,1,5,1,3,1,1,1,0,1,1,0,0,0
S01010994,All households,390,70,23,47,309,43,245,100,114,31,21,12,9,11,7,0,0,4
S01010994,Occupancy rating +2 or more,273,34,16,18,234,39,187,79,86,22,8,4,4,5,2,0,0,3
S01010994,Occupancy rating +1,83,31,5,26,50,4,41,21,13,7,5,2,3,2,1,0,0,1
S01010994,Occupancy rating 0,25,5,2,3,20,0,12,0,11,1,8,6,2,0,0,0,0,0
S01010994,Occupancy rating -1 or less,9,0,0,0,5,0,5,0,4,1,0,0,0,4,4,0,0,0
S01010995,All households,290,49,14,35,236,29,190,93,64,33,17,10,7,5,2,0,0,3
S01010995,Occupancy rating +2 or more,172,28,7,21,143,26,113,78,26,9,4,2,2,1,0,0,0,1
S01010995,Occupancy rating +1,77,20,7,13,55,3,43,13,18,12,9,5,4,2,0,0,0,2
S01010995,Occupancy rating 0,37,1,0,1,35,0,33,1,20,12,2,2,0,1,1,0,0,0
S01010995,Occupancy rating -1 or less,4,0,0,0,3,0,1,1,0,0,2,1,1,1,1,0,0,0
S01010996,All households,235,61,28,33,169,22,140,58,65,17,7,2,5,5,3,0,0,2
S01010996,Occupancy rating +2 or more,154,32,15,17,121,18,102,48,44,10,1,0,1,1,1,0,0,0
S01010996,Occupancy rating +1,61,27,12,15,32,3,28,8,15,5,1,0,1,2,1,0,0,1
S01010996,Occupancy rating 0,19,1,0,1,16,1,10,2,6,2,5,2,3,2,1,0,0,1
S01010996,Occupancy rating -1 or less,1,1,1,0,0,0,0,0,0,0,0,0,0,0,0,0,0,0
S01010997,All households,290,75,50,25,211,57,143,73,48,22,11,3,8,4,0,0,1,3
S01010997,Occupancy rating +2 or more,229,52,38,14,175,53,115,67,33,15,7,2,5,2,0,0,1,1
S01010997,Occupancy rating +1,46,17,7,10,28,4,22,5,12,5,2,0,2,1,0,0,0,1
S01010997,Occupancy rating 0,10,4,3,1,5,0,3,1,1,1,2,1,1,1,0,0,0,1
S01010997,Occupancy rating -1 or less,5,2,2,0,3,0,3,0,2,1,0,0,0,0,0,0,0,0
S01010998,All households,216,34,21,13,175,24,137,52,61,24,14,8,6,7,2,0,0,5
S01010998,Occupancy rating +2 or more,178,28,18,10,145,24,114,46,47,21,7,4,3,5,1,0,0,4
S01010998,Occupancy rating +1,24,5,2,3,18,0,15,4,9,2,3,1,2,1,1,0,0,0
S01010998,Occupancy rating 0,11,1,1,0,9,0,7,2,4,1,2,1,1,1,0,0,0,1
S01010998,Occupancy rating -1 or less,3,0,0,0,3,0,1,0,1,0,2,2,0,0,0,0,0,0
S01010999,All households,412,141,77,64,258,74,170,76,77,17,14,8,6,13,4,0,0,9
S01010999,Occupancy rating +2 or more,231,38,19,19,188,63,121,59,47,15,4,2,2,5,1,0,0,4
S01010999,Occupancy rating +1,90,47,23,24,41,6,34,15,18,1,1,0,1,2,1,0,0,1
S01010999,Occupancy rating 0,58,31,18,13,24,4,12,2,9,1,8,6,2,3,0,0,0,3
S01010999,Occupancy rating -1 or less,33,25,17,8,5,1,3,0,3,0,1,0,1,3,2,0,0,1
S01011000,All households,345,86,37,49,244,18,194,77,74,43,32,22,10,15,7,0,1,7
S01011000,Occupancy rating +2 or more,156,38,15,23,117,11,102,50,28,24,4,0,4,1,1,0,0,0
S01011000,Occupancy rating +1,103,38,18,20,62,5,52,25,18,9,5,1,4,3,0,0,0,3
S01011000,Occupancy rating 0,64,5,2,3,50,1,30,2,22,6,19,17,2,9,4,0,1,4
S01011000,Occupancy rating -1 or less,22,5,2,3,15,1,10,0,6,4,4,4,0,2,2,0,0,0
S01011001,All households,273,81,44,37,185,25,131,48,56,27,29,17,12,7,5,0,1,1
S01011001,Occupancy rating +2 or more,97,34,18,16,63,15,46,30,10,6,2,0,2,0,0,0,0,0
S01011001,Occupancy rating +1,88,20,7,13,66,7,48,13,25,10,11,6,5,2,2,0,0,0
S01011001,Occupancy rating 0,61,23,15,8,36,2,22,3,10,9,12,9,3,2,1,0,0,1
S01011001,Occupancy rating -1 or less,27,4,4,0,20,1,15,2,11,2,4,2,2,3,2,0,1,0
S01011002,All households,314,100,53,47,197,27,127,48,45,34,43,27,16,17,5,1,1,10
S01011002,Occupancy rating +2 or more,99,39,20,19,55,11,42,23,11,8,2,2,0,5,1,0,0,4
S01011002,Occupancy rating +1,116,42,22,20,70,11,49,22,14,13,10,3,7,4,0,1,1,2
S01011002,Occupancy rating 0,66,10,6,4,50,1,25,2,13,10,24,17,7,6,2,0,0,4
S01011002,Occupancy rating -1 or less,33,9,5,4,22,4,11,1,7,3,7,5,2,2,2,0,0,0
S01011003,All households,280,79,43,36,183,27,122,36,61,25,34,20,14,18,11,0,0,7
S01011003,Occupancy rating +2 or more,80,37,22,15,42,11,27,19,6,2,4,2,2,1,0,0,0,1
S01011003,Occupancy rating +1,112,37,18,19,71,11,48,16,20,12,12,9,3,4,1,0,0,3
S01011003,Occupancy rating 0,64,3,2,1,52,4,34,1,24,9,14,6,8,9,6,0,0,3
S01011003,Occupancy rating -1 or less,24,2,1,1,18,1,13,0,11,2,4,3,1,4,4,0,0,0
S01011004,All households,249,46,22,24,194,21,144,61,66,17,29,24,5,9,5,0,0,4
S01011004,Occupancy rating +2 or more,128,21,9,12,102,11,82,40,34,8,9,8,1,5,4,0,0,1
S01011004,Occupancy rating +1,70,14,9,5,54,8,37,16,17,4,9,6,3,2,1,0,0,1
S01011004,Occupancy rating 0,41,8,3,5,32,0,24,5,14,5,8,7,1,1,0,0,0,1
S01011004,Occupancy rating -1 or less,10,3,1,2,6,2,1,0,1,0,3,3,0,1,0,0,0,1
S01011005,All households,337,127,41,86,196,30,120,65,45,10,46,29,17,14,0,0,1,13
S01011005,Occupancy rating +2 or more,70,24,7,17,45,14,29,18,9,2,2,1,1,1,0,0,1,0
S01011005,Occupancy rating +1,145,70,24,46,73,11,54,40,10,4,8,4,4,2,0,0,0,2
S01011005,Occupancy rating 0,96,25,9,16,61,3,30,7,19,4,28,18,10,10,0,0,0,10
S01011005,Occupancy rating -1 or less,26,8,1,7,17,2,7,0,7,0,8,6,2,1,0,0,0,1
S01011006,All households,422,91,39,52,312,31,229,105,91,33,52,27,25,19,7,0,0,12
S01011006,Occupancy rating +2 or more,132,24,11,13,105,10,90,49,31,10,5,2,3,3,2,0,0,1
S01011006,Occupancy rating +1,155,57,25,32,98,19,68,51,11,6,11,4,7,0,0,0,0,0
S01011006,Occupancy rating 0,99,7,2,5,83,2,53,5,34,14,28,18,10,9,2,0,0,7
S01011006,Occupancy rating -1 or less,36,3,1,2,26,0,18,0,15,3,8,3,5,7,3,0,0,4
S01011007,All households,280,65,36,29,197,19,121,47,52,22,57,33,24,18,8,0,2,8
S01011007,Occupancy rating +2 or more,77,29,14,15,45,9,30,24,6,0,6,1,5,3,0,0,1,2
S01011007,Occupancy rating +1,103,31,17,14,69,7,48,22,14,12,14,7,7,3,1,0,0,2
S01011007,Occupancy rating 0,71,4,4,0,61,2,28,0,21,7,31,19,12,6,2,0,1,3
S01011007,Occupancy rating -1 or less,29,1,1,0,22,1,15,1,11,3,6,6,0,6,5,0,0,1
S01011008,All households,332,86,44,42,233,39,155,62,51,42,39,23,16,13,6,0,1,6
S01011008,Occupancy rating +2 or more,102,43,20,23,59,14,42,34,5,3,3,1,2,0,0,0,0,0
S01011008,Occupancy rating +1,145,35,18,17,103,23,68,26,19,23,12,5,7,7,2,0,0,5
S01011008,Occupancy rating 0,56,1,0,1,52,1,32,2,19,11,19,12,7,3,1,0,1,1
S01011008,Occupancy rating -1 or less,29,7,6,1,19,1,13,0,8,5,5,5,0,3,3,0,0,0
S01011009,All households,222,60,18,42,150,8,102,44,39,19,40,20,20,12,2,0,0,10
S01011009,Occupancy rating +2 or more,40,14,7,7,24,2,20,15,3,2,2,1,1,2,1,0,0,1
S01011009,Occupancy rating +1,89,31,7,24,57,4,42,25,13,4,11,3,8,1,0,0,0,1
S01011009,Occupancy rating 0,66,13,4,9,47,1,25,2,13,10,21,10,11,6,0,0,0,6
S01011009,Occupancy rating -1 or less,27,2,0,2,22,1,15,2,10,3,6,6,0,3,1,0,0,2
S01011010,All households,335,187,52,135,126,15,80,48,25,7,31,18,13,22,4,0,0,18
S01011010,Occupancy rating +2 or more,46,25,10,15,19,2,17,9,6,2,0,0,0,2,0,0,0,2
S01011010,Occupancy rating +1,114,74,20,54,37,6,28,23,4,1,3,1,2,3,0,0,0,3
S01011010,Occupancy rating 0,143,73,18,55,57,4,30,15,12,3,23,13,10,13,3,0,0,10
S01011010,Occupancy rating -1 or less,32,15,4,11,13,3,5,1,3,1,5,4,1,4,1,0,0,3
S01011011,All households,435,235,89,146,182,18,110,61,32,17,54,41,13,18,4,0,1,13
S01011011,Occupancy rating +2 or more,51,26,15,11,23,2,20,18,0,2,1,0,1,2,0,0,0,2
S01011011,Occupancy rating +1,155,104,30,74,50,10,36,28,4,4,4,4,0,1,0,0,0,1
S01011011,Occupancy rating 0,192,91,40,51,88,6,42,13,18,11,40,29,11,13,3,0,1,9
S01011011,Occupancy rating -1 or less,37,14,4,10,21,0,12,2,10,0,9,8,1,2,1,0,0,1
S01011012,All households,313,95,23,72,202,17,103,43,51,9,82,54,28,16,9,0,0,7
S01011012,Occupancy rating +2 or more,61,24,9,15,36,7,23,16,6,1,6,2,4,1,1,0,0,0
S01011012,Occupancy rating +1,121,55,9,46,65,5,37,23,13,1,23,13,10,1,0,0,0,1
S01011012,Occupancy rating 0,83,8,3,5,66,2,31,3,23,5,33,21,12,9,4,0,0,5
S01011012,Occupancy rating -1 or less,48,8,2,6,35,3,12,1,9,2,20,18,2,5,4,0,0,1
S01011013,All households,375,126,77,49,238,40,150,57,65,28,48,25,23,11,5,0,0,6
S01011013,Occupancy rating +2 or more,82,33,23,10,49,19,28,21,4,3,2,0,2,0,0,0,0,0
S01011013,Occupancy rating +1,184,80,46,34,100,18,69,32,26,11,13,7,6,4,1,0,0,3
S01011013,Occupancy rating 0,78,6,5,1,68,1,41,3,27,11,26,13,13,4,2,0,0,2
S01011013,Occupancy rating -1 or less,31,7,3,4,21,2,12,1,8,3,7,5,2,3,2,0,0,1
S01011014,All households,364,106,31,75,245,17,184,85,62,37,44,33,11,13,5,0,0,8
S01011014,Occupancy rating +2 or more,112,29,12,17,83,12,67,37,20,10,4,3,1,0,0,0,0,0
S01011014,Occupancy rating +1,142,57,14,43,85,5,76,43,20,13,4,2,2,0,0,0,0,0
S01011014,Occupancy rating 0,77,14,3,11,56,0,27,2,15,10,29,23,6,7,2,0,0,5
S01011014,Occupancy rating -1 or less,33,6,2,4,21,0,14,3,7,4,7,5,2,6,3,0,0,3
S01011015,All households,200,64,37,27,129,7,102,48,26,28,20,16,4,7,2,0,0,5
S01011015,Occupancy rating +2 or more,59,13,7,6,44,3,40,29,5,6,1,0,1,2,0,0,0,2
S01011015,Occupancy rating +1,64,28,10,18,35,3,31,19,9,3,1,1,0,1,0,0,0,1
S01011015,Occupancy rating 0,61,22,19,3,38,1,24,0,9,15,13,11,2,1,0,0,0,1
S01011015,Occupancy rating -1 or less,16,1,1,0,12,0,7,0,3,4,5,4,1,3,2,0,0,1
S01011016,All households,311,49,4,45,241,2,216,80,121,15,23,15,8,21,10,1,0,10
S01011016,Occupancy rating +2 or more,196,15,1,14,172,2,162,57,94,11,8,5,3,9,6,1,0,2
S01011016,Occupancy rating +1,58,19,3,16,38,0,34,18,14,2,4,4,0,1,0,0,0,1
S01011016,Occupancy rating 0,43,10,0,10,25,0,16,3,11,2,9,5,4,8,3,0,0,5
S01011016,Occupancy rating -1 or less,14,5,0,5,6,0,4,2,2,0,2,1,1,3,1,0,0,2
S01011017,All households,352,72,27,45,275,50,203,99,79,25,22,16,6,5,1,0,0,4
S01011017,Occupancy rating +2 or more,243,41,19,22,199,44,145,83,46,16,10,8,2,3,1,0,0,2
S01011017,Occupancy rating +1,71,22,6,16,48,6,38,16,17,5,4,2,2,1,0,0,0,1
S01011017,Occupancy rating 0,31,9,2,7,21,0,13,0,9,4,8,6,2,1,0,0,0,1
S01011017,Occupancy rating -1 or less,7,0,0,0,7,0,7,0,7,0,0,0,0,0,0,0,0,0
S01011018,All households,366,110,55,55,236,33,171,63,80,28,32,13,19,20,6,0,3,11
S01011018,Occupancy rating +2 or more,140,37,18,19,98,17,74,44,24,6,7,2,5,5,0,0,1,4
S01011018,Occupancy rating +1,119,56,26,30,60,9,41,13,19,9,10,5,5,3,1,0,0,2
S01011018,Occupancy rating 0,83,15,9,6,60,5,44,5,28,11,11,5,6,8,3,0,1,4
S01011018,Occupancy rating -1 or less,24,2,2,0,18,2,12,1,9,2,4,1,3,4,2,0,1,1
S01011019,All households,408,80,36,44,308,32,235,101,105,29,41,28,13,20,6,0,1,13
S01011019,Occupancy rating +2 or more,233,43,20,23,181,22,152,81,55,16,7,3,4,9,2,0,1,6
S01011019,Occupancy rating +1,69,16,2,14,51,7,37,13,21,3,7,3,4,2,0,0,0,2
S01011019,Occupancy rating 0,89,18,11,7,65,3,39,6,26,7,23,18,5,6,1,0,0,5
S01011019,Occupancy rating -1 or less,17,3,3,0,11,0,7,1,3,3,4,4,0,3,3,0,0,0
S01011020,All households,202,51,17,34,144,15,116,62,46,8,13,6,7,7,5,0,0,2
S01011020,Occupancy rating +2 or more,130,30,9,21,98,12,83,54,26,3,3,2,1,2,1,0,0,1
S01011020,Occupancy rating +1,38,14,7,7,24,2,20,7,8,5,2,0,2,0,0,0,0,0
S01011020,Occupancy rating 0,21,5,1,4,13,1,6,1,5,0,6,2,4,3,2,0,0,1
S01011020,Occupancy rating -1 or less,13,2,0,2,9,0,7,0,7,0,2,2,0,2,2,0,0,0
S01011021,All households,351,99,53,46,222,29,151,49,60,42,42,28,14,30,9,0,3,18
S01011021,Occupancy rating +2 or more,149,60,36,24,85,23,56,28,13,15,6,1,5,4,0,0,1,3
S01011021,Occupancy rating +1,105,17,6,11,75,3,57,17,19,21,15,10,5,13,2,0,2,9
S01011021,Occupancy rating 0,61,15,9,6,39,2,23,3,17,3,14,12,2,7,3,0,0,4
S01011021,Occupancy rating -1 or less,36,7,2,5,23,1,15,1,11,3,7,5,2,6,4,0,0,2
S01011022,All households,233,53,28,25,166,14,104,43,43,18,48,33,15,14,7,0,0,7
S01011022,Occupancy rating +2 or more,85,33,18,15,52,7,41,29,6,6,4,4,0,0,0,0,0,0
S01011022,Occupancy rating +1,73,17,9,8,51,4,36,10,16,10,11,6,5,5,1,0,0,4
S01011022,Occupancy rating 0,57,3,1,2,50,3,16,3,11,2,31,21,10,4,2,0,0,2
S01011022,Occupancy rating -1 or less,18,0,0,0,13,0,11,1,10,0,2,2,0,5,4,0,0,1
S01011023,All households,350,100,47,53,238,22,171,74,71,26,45,30,15,12,3,1,0,8
S01011023,Occupancy rating +2 or more,142,37,13,24,100,17,79,49,24,6,4,4,0,5,1,0,0,4
S01011023,Occupancy rating +1,113,40,19,21,72,3,55,22,24,9,14,8,6,1,0,0,0,1
S01011023,Occupancy rating 0,71,18,14,4,47,2,26,3,17,6,19,13,6,6,2,1,0,3
S01011023,Occupancy rating -1 or less,24,5,1,4,19,0,11,0,6,5,8,5,3,0,0,0,0,0
S01011024,All households,302,61,25,36,225,19,124,36,65,23,82,57,25,16,7,0,1,8
S01011024,Occupancy rating +2 or more,97,32,15,17,62,11,44,30,11,3,7,4,3,3,1,0,0,2
S01011024,Occupancy rating +1,86,24,9,15,58,5,34,5,16,13,19,12,7,4,0,0,0,4
S01011024,Occupancy rating 0,79,5,1,4,71,1,28,1,22,5,42,33,9,3,2,0,0,1
S01011024,Occupancy rating -1 or less,40,0,0,0,34,2,18,0,16,2,14,8,6,6,4,0,1,1
S01011025,All households,276,62,18,44,194,10,130,48,54,28,54,34,20,20,4,0,0,16
S01011025,Occupancy rating +2 or more,44,17,7,10,26,5,18,15,2,1,3,3,0,1,0,0,0,1
S01011025,Occupancy rating +1,114,33,9,24,77,4,59,32,17,10,14,5,9,4,1,0,0,3
S01011025,Occupancy rating 0,74,5,0,5,61,1,36,0,25,11,24,17,7,8,0,0,0,8
S01011025,Occupancy rating -1 or less,44,7,2,5,30,0,17,1,10,6,13,9,4,7,3,0,0,4
S01011026,All households,235,59,7,52,162,15,118,46,46,26,29,20,9,14,2,0,0,12
S01011026,Occupancy rating +2 or more,46,15,1,14,31,5,25,23,2,0,1,0,1,0,0,0,0,0
S01011026,Occupancy rating +1,89,23,2,21,62,9,44,22,16,6,9,6,3,4,0,0,0,4
S01011026,Occupancy rating 0,71,12,3,9,51,0,36,0,20,16,15,10,5,8,1,0,0,7
S01011026,Occupancy rating -1 or less,29,9,1,8,18,1,13,1,8,4,4,4,0,2,1,0,0,1
S01011027,All households,418,146,70,76,254,21,142,51,76,15,91,67,24,18,8,0,0,10
S01011027,Occupancy rating +2 or more,98,39,18,21,57,11,39,31,5,3,7,5,2,2,0,0,0,2
S01011027,Occupancy rating +1,132,44,16,28,82,6,49,15,29,5,27,19,8,6,0,0,0,6
S01011027,Occupancy rating 0,148,54,31,23,87,3,43,3,35,5,41,28,13,7,5,0,0,2
S01011027,Occupancy rating -1 or less,40,9,5,4,28,1,11,2,7,2,16,15,1,3,3,0,0,0
S01011028,All households,425,127,56,71,276,37,145,41,84,20,94,66,28,22,12,0,0,10
S01011028,Occupancy rating +2 or more,76,31,20,11,43,9,25,11,9,5,9,5,4,2,1,0,0,1
S01011028,Occupancy rating +1,166,77,30,47,88,25,45,27,16,2,18,11,7,1,0,0,0,1
S01011028,Occupancy rating 0,142,16,5,11,118,1,60,2,49,9,57,44,13,8,3,0,0,5
S01011028,Occupancy rating -1 or less,41,3,1,2,27,2,15,1,10,4,10,6,4,11,8,0,0,3
S01011029,All households,264,75,26,49,179,21,124,48,54,22,34,21,13,10,3,0,0,7
S01011029,Occupancy rating +2 or more,80,31,16,15,48,15,32,24,7,1,1,0,1,1,0,0,0,1
S01011029,Occupancy rating +1,92,34,8,26,56,4,43,20,13,10,9,2,7,2,0,0,0,2
S01011029,Occupancy rating 0,73,10,2,8,58,2,36,2,27,7,20,15,5,5,2,0,0,3
S01011029,Occupancy rating -1 or less,19,0,0,0,17,0,13,2,7,4,4,4,0,2,1,0,0,1
S01011030,All households,369,62,16,46,291,34,222,84,96,42,35,21,14,16,10,0,0,6
S01011030,Occupancy rating +2 or more,156,28,6,22,126,21,101,65,25,11,4,3,1,2,2,0,0,0
S01011030,Occupancy rating +1,113,27,8,19,84,11,64,16,29,19,9,2,7,2,2,0,0,0
S01011030,Occupancy rating 0,73,2,1,1,66,2,46,2,36,8,18,13,5,5,0,0,0,5
S01011030,Occupancy rating -1 or less,27,5,1,4,15,0,11,1,6,4,4,3,1,7,6,0,0,1
S01011031,All households,320,95,56,39,213,29,130,47,58,25,54,37,17,12,7,0,1,4
S01011031,Occupancy rating +2 or more,64,27,18,9,37,8,26,16,6,4,3,2,1,0,0,0,0,0
S01011031,Occupancy rating +1,136,55,30,25,80,18,51,30,13,8,11,6,5,1,0,0,0,1
S01011031,Occupancy rating 0,96,11,7,4,79,3,45,1,33,11,31,22,9,6,3,0,1,2
S01011031,Occupancy rating -1 or less,24,2,1,1,17,0,8,0,6,2,9,7,2,5,4,0,0,1
S01011032,All households,353,113,53,60,227,27,131,48,48,35,69,43,26,13,6,0,2,5
S01011032,Occupancy rating +2 or more,86,28,12,16,56,13,36,23,7,6,7,2,5,2,2,0,0,0
S01011032,Occupancy rating +1,157,80,39,41,72,13,48,23,12,13,11,8,3,5,1,0,2,2
S01011032,Occupancy rating 0,83,4,2,2,74,1,35,1,19,15,38,22,16,5,3,0,0,2
S01011032,Occupancy rating -1 or less,27,1,0,1,25,0,12,1,10,1,13,11,2,1,0,0,0,1
S01011033,All households,275,79,25,54,188,22,144,56,63,25,22,10,12,8,3,0,1,4
S01011033,Occupancy rating +2 or more,74,23,7,16,50,5,44,23,15,6,1,0,1,1,0,0,0,1
S01011033,Occupancy rating +1,121,47,13,34,74,16,54,28,18,8,4,2,2,0,0,0,0,0
S01011033,Occupancy rating 0,68,8,4,4,55,1,39,5,25,9,15,7,8,5,2,0,0,3
S01011033,Occupancy rating -1 or less,12,1,1,0,9,0,7,0,5,2,2,1,1,2,1,0,1,0
S01011034,All households,331,140,79,61,177,25,125,51,52,22,27,12,15,14,5,0,3,6
S01011034,Occupancy rating +2 or more,77,23,13,10,51,4,44,21,15,8,3,1,2,3,2,0,0,1
S01011034,Occupancy rating +1,94,37,13,24,52,7,41,20,13,8,4,3,1,5,1,0,1,3
S01011034,Occupancy rating 0,138,69,45,24,66,10,37,10,21,6,19,8,11,3,0,0,1,2
S01011034,Occupancy rating -1 or less,22,11,8,3,8,4,3,0,3,0,1,0,1,3,2,0,1,0
S01011035,All households,252,47,15,32,191,14,134,47,65,22,43,25,18,14,5,0,0,9
S01011035,Occupancy rating +2 or more,66,8,2,6,56,4,46,21,15,10,6,2,4,2,0,0,0,2
S01011035,Occupancy rating +1,86,30,10,20,54,6,44,22,18,4,4,1,3,2,1,0,0,1
S01011035,Occupancy rating 0,70,8,3,5,58,3,31,3,23,5,24,15,9,4,0,0,0,4
S01011035,Occupancy rating -1 or less,30,1,0,1,23,1,13,1,9,3,9,7,2,6,4,0,0,2
S01011036,All households,285,82,25,57,194,24,144,62,65,17,26,17,9,9,4,0,1,4
S01011036,Occupancy rating +2 or more,106,21,7,14,83,12,68,36,25,7,3,3,0,2,1,0,0,1
S01011036,Occupancy rating +1,107,46,17,29,58,9,42,23,15,4,7,4,3,3,1,0,0,2
S01011036,Occupancy rating 0,51,12,0,12,36,2,26,2,20,4,8,4,4,3,2,0,1,0
S01011036,Occupancy rating -1 or less,21,3,1,2,17,1,8,1,5,2,8,6,2,1,0,0,0,1
S01011037,All households,409,127,38,89,264,23,176,56,97,23,65,46,19,18,8,0,0,10
S01011037,Occupancy rating +2 or more,101,30,11,19,68,10,54,30,18,6,4,0,4,3,1,0,0,2
S01011037,Occupancy rating +1,156,66,10,56,85,10,59,22,30,7,16,8,8,5,0,0,0,5
S01011037,Occupancy rating 0,116,20,10,10,90,1,50,3,38,9,39,32,7,6,4,0,0,2
S01011037,Occupancy rating -1 or less,36,11,7,4,21,2,13,1,11,1,6,6,0,4,3,0,0,1
S01011038,All households,337,89,39,50,221,12,146,53,68,25,63,40,23,27,18,0,1,8
S01011038,Occupancy rating +2 or more,89,38,11,27,50,8,39,33,3,3,3,1,2,1,0,0,0,1
S01011038,Occupancy rating +1,103,24,8,16,73,2,47,15,21,11,24,11,13,6,3,0,0,3
S01011038,Occupancy rating 0,108,23,18,5,73,2,44,4,30,10,27,21,6,12,7,0,1,4
S01011038,Occupancy rating -1 or less,37,4,2,2,25,0,16,1,14,1,9,7,2,8,8,0,0,0
S01011039,All households,392,166,69,97,210,29,156,68,67,21,25,11,14,16,7,0,0,9
S01011039,Occupancy rating +2 or more,100,21,12,9,76,15,58,35,17,6,3,1,2,3,1,0,0,2
S01011039,Occupancy rating +1,113,40,10,30,70,6,57,29,17,11,7,2,5,3,0,0,0,3
S01011039,Occupancy rating 0,154,98,43,55,48,6,31,4,23,4,11,6,5,8,4,0,0,4
S01011039,Occupancy rating -1 or less,25,7,4,3,16,2,10,0,10,0,4,2,2,2,2,0,0,0
S01011040,All households,285,63,26,37,208,22,128,47,62,19,58,44,14,14,5,0,3,6
S01011040,Occupancy rating +2 or more,74,28,12,16,45,7,35,30,5,0,3,1,2,1,0,0,1,0
S01011040,Occupancy rating +1,97,31,13,18,63,13,39,16,15,8,11,5,6,3,0,0,1,2
S01011040,Occupancy rating 0,80,3,0,3,71,0,37,0,31,6,34,29,5,6,3,0,0,3
S01011040,Occupancy rating -1 or less,34,1,1,0,29,2,17,1,11,5,10,9,1,4,2,0,1,1
S01011041,All households,292,64,31,33,203,24,116,36,60,20,63,50,13,25,15,0,2,8
S01011041,Occupancy rating +2 or more,88,28,14,14,57,14,37,21,12,4,6,6,0,3,2,0,0,1
S01011041,Occupancy rating +1,82,22,9,13,56,7,32,12,12,8,17,13,4,4,1,0,1,2
S01011041,Occupancy rating 0,93,11,6,5,72,2,35,2,27,6,35,26,9,10,6,0,1,3
S01011041,Occupancy rating -1 or less,29,3,2,1,18,1,12,1,9,2,5,5,0,8,6,0,0,2
S01011042,All households,333,75,22,53,248,26,197,90,87,20,25,20,5,10,7,0,0,3
S01011042,Occupancy rating +2 or more,179,31,13,18,145,20,115,57,49,9,10,8,2,3,2,0,0,1
S01011042,Occupancy rating +1,88,27,5,22,60,6,48,24,18,6,6,3,3,1,0,0,0,1
S01011042,Occupancy rating 0,50,12,3,9,36,0,27,5,18,4,9,9,0,2,1,0,0,1
S01011042,Occupancy rating -1 or less,16,5,1,4,7,0,7,4,2,1,0,0,0,4,4,0,0,0
S01011043,All households,310,93,37,56,202,37,119,44,58,17,46,32,14,15,6,0,1,8
S01011043,Occupancy rating +2 or more,87,27,17,10,60,21,36,23,11,2,3,1,2,0,0,0,0,0
S01011043,Occupancy rating +1,104,37,15,22,64,14,37,19,13,5,13,7,6,3,0,0,1,2
S01011043,Occupancy rating 0,86,23,2,21,59,2,35,2,25,8,22,19,3,4,1,0,0,3
S01011043,Occupancy rating -1 or less,33,6,3,3,19,0,11,0,9,2,8,5,3,8,5,0,0,3
S01011044,All households,307,98,31,67,189,14,122,46,51,25,53,36,17,20,8,1,0,11
S01011044,Occupancy rating +2 or more,82,22,9,13,56,6,41,24,12,5,9,5,4,4,2,0,0,2
S01011044,Occupancy rating +1,107,54,13,41,52,5,38,21,9,8,9,5,4,1,1,0,0,0
S01011044,Occupancy rating 0,88,19,8,11,63,1,33,1,22,10,29,21,8,6,2,1,0,3
S01011044,Occupancy rating -1 or less,30,3,1,2,18,2,10,0,8,2,6,5,1,9,3,0,0,6
S01011045,All households,369,112,52,60,251,38,168,80,75,13,45,33,12,6,2,0,0,4
S01011045,Occupancy rating +2 or more,243,71,29,42,169,38,111,66,36,9,20,14,6,3,1,0,0,2
S01011045,Occupancy rating +1,69,18,7,11,48,0,35,13,19,3,13,10,3,3,1,0,0,2
S01011045,Occupancy rating 0,48,20,14,6,28,0,18,1,16,1,10,7,3,0,0,0,0,0
S01011045,Occupancy rating -1 or less,9,3,2,1,6,0,4,0,4,0,2,2,0,0,0,0,0,0
S01011046,All households,362,90,35,55,255,28,204,99,70,35,23,15,8,17,7,0,3,7
S01011046,Occupancy rating +2 or more,241,56,21,35,181,22,147,85,39,23,12,9,3,4,3,0,1,0
S01011046,Occupancy rating +1,71,26,12,14,37,4,28,11,11,6,5,2,3,8,2,0,2,4
S01011046,Occupancy rating 0,38,7,2,5,28,1,23,3,14,6,4,2,2,3,1,0,0,2
S01011046,Occupancy rating -1 or less,12,1,0,1,9,1,6,0,6,0,2,2,0,2,1,0,0,1
S01011047,All households,396,76,31,45,306,57,229,98,98,33,20,13,7,14,5,0,1,8
S01011047,Occupancy rating +2 or more,267,55,23,32,203,52,146,81,45,20,5,2,3,9,4,0,1,4
S01011047,Occupancy rating +1,76,17,8,9,58,2,49,13,29,7,7,4,3,1,0,0,0,1
S01011047,Occupancy rating 0,46,4,0,4,40,2,30,2,22,6,8,7,1,2,0,0,0,2
S01011047,Occupancy rating -1 or less,7,0,0,0,5,1,4,2,2,0,0,0,0,2,1,0,0,1
S01011048,All households,440,152,84,68,278,50,193,75,88,30,35,23,12,10,2,0,2,6
S01011048,Occupancy rating +2 or more,204,53,31,22,149,37,104,52,38,14,8,2,6,2,0,0,0,2
S01011048,Occupancy rating +1,112,45,24,21,64,12,43,15,18,10,9,6,3,3,0,0,1,2
S01011048,Occupancy rating 0,104,52,27,25,50,1,34,7,21,6,15,13,2,2,0,0,1,1
S01011048,Occupancy rating -1 or less,20,2,2,0,15,0,12,1,11,0,3,2,1,3,2,0,0,1
S01011049,All households,322,99,51,48,217,43,140,71,49,20,34,21,13,6,1,0,1,4
S01011049,Occupancy rating +2 or more,160,51,26,25,109,29,75,56,11,8,5,3,2,0,0,0,0,0
S01011049,Occupancy rating +1,101,34,16,18,64,13,37,12,20,5,14,7,7,3,0,0,0,3
S01011049,Occupancy rating 0,49,11,8,3,37,1,23,3,14,6,13,10,3,1,0,0,1,0
S01011049,Occupancy rating -1 or less,12,3,1,2,7,0,5,0,4,1,2,1,1,2,1,0,0,1
S01011050,All households,323,73,31,42,240,39,177,70,77,30,24,15,9,10,2,0,0,8
S01011050,Occupancy rating +2 or more,226,57,25,32,165,34,123,65,43,15,8,5,3,4,1,0,0,3
S01011050,Occupancy rating +1,63,13,5,8,47,4,36,4,21,11,7,3,4,3,0,0,0,3
S01011050,Occupancy rating 0,26,3,1,2,21,1,14,1,10,3,6,5,1,2,0,0,0,2
S01011050,Occupancy rating -1 or less,8,0,0,0,7,0,4,0,3,1,3,2,1,1,1,0,0,0
S01011051,All households,428,149,77,72,267,40,201,88,84,29,26,11,15,12,2,0,0,10
S01011051,Occupancy rating +2 or more,239,62,28,34,171,28,134,71,47,16,9,3,6,6,1,0,0,5
S01011051,Occupancy rating +1,87,34,21,13,50,7,36,12,16,8,7,3,4,3,0,0,0,3
S01011051,Occupancy rating 0,82,44,25,19,36,4,24,4,16,4,8,3,5,2,1,0,0,1
S01011051,Occupancy rating -1 or less,20,9,3,6,10,1,7,1,5,1,2,2,0,1,0,0,0,1
S01011052,All households,366,115,72,43,234,57,150,64,69,17,27,18,9,17,9,0,1,7
S01011052,Occupancy rating +2 or more,177,50,33,17,122,35,81,41,29,11,6,3,3,5,2,0,0,3
S01011052,Occupancy rating +1,86,37,23,14,45,16,27,13,11,3,2,2,0,4,1,0,0,3
S01011052,Occupancy rating 0,74,23,13,10,49,5,30,6,21,3,14,10,4,2,1,0,0,1
S01011052,Occupancy rating -1 or less,29,5,3,2,18,1,12,4,8,0,5,3,2,6,5,0,1,0
S01011053,All households,295,90,34,56,194,34,116,56,46,14,44,28,16,11,2,0,0,9
S01011053,Occupancy rating +2 or more,104,31,10,21,71,22,49,34,8,7,0,0,0,2,0,0,0,2
S01011053,Occupancy rating +1,86,36,13,23,48,9,30,14,12,4,9,3,6,2,0,0,0,2
S01011053,Occupancy rating 0,82,19,9,10,61,3,28,6,19,3,30,22,8,2,0,0,0,2
S01011053,Occupancy rating -1 or less,23,4,2,2,14,0,9,2,7,0,5,3,2,5,2,0,0,3
S01011054,All households,244,74,38,36,165,26,117,63,43,11,22,16,6,5,1,0,0,4
S01011054,Occupancy rating +2 or more,148,42,21,21,103,19,79,53,22,4,5,5,0,3,0,0,0,3
S01011054,Occupancy rating +1,49,20,9,11,28,4,18,5,8,5,6,2,4,1,1,0,0,0
S01011054,Occupancy rating 0,37,9,7,2,27,2,17,5,10,2,8,8,0,1,0,0,0,1
S01011054,Occupancy rating -1 or less,10,3,1,2,7,1,3,0,3,0,3,1,2,0,0,0,0,0
S01011055,All households,228,61,25,36,161,17,132,51,61,20,12,8,4,6,2,0,0,4
S01011055,Occupancy rating +2 or more,131,36,14,22,93,13,77,41,26,10,3,2,1,2,0,0,0,2
S01011055,Occupancy rating +1,64,20,7,13,43,3,36,7,21,8,4,2,2,1,0,0,0,1
S01011055,Occupancy rating 0,28,5,4,1,21,1,15,2,11,2,5,4,1,2,2,0,0,0
S01011055,Occupancy rating -1 or less,5,0,0,0,4,0,4,1,3,0,0,0,0,1,0,0,0,1
S01011056,All households,271,52,21,31,204,34,156,71,67,18,14,7,7,15,6,0,4,5
S01011056,Occupancy rating +2 or more,211,42,19,23,162,33,122,64,44,14,7,3,4,7,3,0,2,2
S01011056,Occupancy rating +1,27,5,2,3,17,0,17,5,9,3,0,0,0,5,2,0,1,2
S01011056,Occupancy rating 0,26,4,0,4,19,1,12,2,9,1,6,3,3,3,1,0,1,1
S01011056,Occupancy rating -1 or less,7,1,0,1,6,0,5,0,5,0,1,1,0,0,0,0,0,0
S01011057,All households,238,64,29,35,163,19,123,52,43,28,21,11,10,11,3,0,3,5
S01011057,Occupancy rating +2 or more,131,32,15,17,97,17,75,42,19,14,5,2,3,2,0,0,0,2
S01011057,Occupancy rating +1,60,21,8,13,34,2,25,6,11,8,7,2,5,5,0,0,3,2
S01011057,Occupancy rating 0,32,9,4,5,22,0,19,4,9,6,3,2,1,1,0,0,0,1
S01011057,Occupancy rating -1 or less,15,2,2,0,10,0,4,0,4,0,6,5,1,3,3,0,0,0
S01011058,All households,251,46,21,25,190,23,150,63,64,23,17,10,7,15,2,0,3,10
S01011058,Occupancy rating +2 or more,190,38,18,20,143,22,111,57,36,18,10,5,5,9,1,0,1,7
S01011058,Occupancy rating +1,40,5,3,2,30,1,25,5,16,4,4,2,2,5,1,0,2,2
S01011058,Occupancy rating 0,18,2,0,2,15,0,12,0,11,1,3,3,0,1,0,0,0,1
S01011058,Occupancy rating -1 or less,3,1,0,1,2,0,2,1,1,0,0,0,0,0,0,0,0,0
S01011059,All households,248,54,24,30,177,16,151,69,60,22,10,4,6,17,6,0,0,11
S01011059,Occupancy rating +2 or more,172,44,20,24,121,13,106,53,43,10,2,1,1,7,1,0,0,6
S01011059,Occupancy rating +1,41,8,3,5,30,1,28,12,9,7,1,0,1,3,1,0,0,2
S01011059,Occupancy rating 0,28,2,1,1,22,2,14,4,5,5,6,2,4,4,1,0,0,3
S01011059,Occupancy rating -1 or less,7,0,0,0,4,0,3,0,3,0,1,1,0,3,3,0,0,0
S01011060,All households,402,154,91,63,240,55,159,67,67,25,26,12,14,8,4,0,0,4
S01011060,Occupancy rating +2 or more,224,66,37,29,156,43,107,49,38,20,6,4,2,2,2,0,0,0
S01011060,Occupancy rating +1,84,36,15,21,46,9,28,12,13,3,9,3,6,2,0,0,0,2
S01011060,Occupancy rating 0,82,49,38,11,30,2,19,6,11,2,9,3,6,3,1,0,0,2
S01011060,Occupancy rating -1 or less,12,3,1,2,8,1,5,0,5,0,2,2,0,1,1,0,0,0
S01011061,All households,404,142,67,75,248,27,163,85,63,15,58,34,24,14,3,0,2,9
S01011061,Occupancy rating +2 or more,113,41,19,22,70,15,51,38,9,4,4,1,3,2,0,0,0,2
S01011061,Occupancy rating +1,135,55,26,29,80,10,57,38,15,4,13,6,7,0,0,0,0,0
S01011061,Occupancy rating 0,122,38,21,17,76,2,41,6,29,6,33,22,11,8,0,0,2,6
S01011061,Occupancy rating -1 or less,34,8,1,7,22,0,14,3,10,1,8,5,3,4,3,0,0,1
S01011062,All households,423,170,72,98,243,35,177,69,74,34,31,14,17,10,4,0,2,4
S01011062,Occupancy rating +2 or more,202,63,34,29,135,23,101,56,29,16,11,3,8,4,2,0,1,1
S01011062,Occupancy rating +1,114,47,18,29,64,8,46,10,24,12,10,4,6,3,1,0,0,2
S01011062,Occupancy rating 0,78,42,15,27,34,3,24,3,15,6,7,6,1,2,0,0,1,1
S01011062,Occupancy rating -1 or less,29,18,5,13,10,1,6,0,6,0,3,1,2,1,1,0,0,0
S01011063,All households,472,160,84,76,300,54,181,67,80,34,65,40,25,12,6,0,1,5
S01011063,Occupancy rating +2 or more,184,57,36,21,124,32,79,41,27,11,13,8,5,3,2,0,0,1
S01011063,Occupancy rating +1,131,50,17,33,76,17,41,17,12,12,18,8,10,5,1,0,1,3
S01011063,Occupancy rating 0,125,44,27,17,80,4,48,7,32,9,28,19,9,1,0,0,0,1
S01011063,Occupancy rating -1 or less,32,9,4,5,20,1,13,2,9,2,6,5,1,3,3,0,0,0
S01011064,All households,480,173,85,88,293,48,216,98,78,40,29,15,14,14,5,0,1,8
S01011064,Occupancy rating +2 or more,238,79,46,33,155,29,121,67,35,19,5,3,2,4,2,0,0,2
S01011064,Occupancy rating +1,128,55,27,28,71,14,48,21,17,10,9,3,6,2,0,0,1,1
S01011064,Occupancy rating 0,98,30,12,18,61,3,44,10,23,11,14,9,5,7,2,0,0,5
S01011064,Occupancy rating -1 or less,16,9,0,9,6,2,3,0,3,0,1,0,1,1,1,0,0,0
S01011065,All households,289,64,27,37,208,31,152,77,54,21,25,17,8,17,7,0,4,6
S01011065,Occupancy rating +2 or more,174,37,17,20,127,25,97,60,29,8,5,2,3,10,3,0,3,4
S01011065,Occupancy rating +1,59,13,3,10,43,5,34,16,8,10,4,3,1,3,1,0,1,1
S01011065,Occupancy rating 0,45,12,6,6,30,1,18,1,14,3,11,7,4,3,2,0,0,1
S01011065,Occupancy rating -1 or less,11,2,1,1,8,0,3,0,3,0,5,5,0,1,1,0,0,0
S01011066,All households,231,70,39,31,147,25,100,52,30,18,22,13,9,14,6,0,5,3
S01011066,Occupancy rating +2 or more,146,39,21,18,98,21,72,43,14,15,5,2,3,9,4,0,2,3
S01011066,Occupancy rating +1,46,16,11,5,27,3,17,7,9,1,7,4,3,3,0,0,3,0
S01011066,Occupancy rating 0,27,10,7,3,17,0,8,2,5,1,9,7,2,0,0,0,0,0
S01011066,Occupancy rating -1 or less,12,5,0,5,5,1,3,0,2,1,1,0,1,2,2,0,0,0
S01011067,All households,284,121,74,47,156,31,105,44,47,14,20,13,7,7,4,0,2,1
S01011067,Occupancy rating +2 or more,141,53,29,24,86,21,61,37,20,4,4,3,1,2,0,0,1,1
S01011067,Occupancy rating +1,78,43,25,18,34,4,21,5,10,6,9,6,3,1,1,0,0,0
S01011067,Occupancy rating 0,56,23,19,4,31,5,21,2,15,4,5,3,2,2,1,0,1,0
S01011067,Occupancy rating -1 or less,9,2,1,1,5,1,2,0,2,0,2,1,1,2,2,0,0,0
S01011068,All households,238,78,39,39,152,26,103,50,44,9,23,18,5,8,4,0,1,3
S01011068,Occupancy rating +2 or more,140,54,27,27,85,22,59,43,12,4,4,4,0,1,0,0,0,1
S01011068,Occupancy rating +1,49,16,8,8,30,3,19,5,11,3,8,4,4,3,1,0,1,1
S01011068,Occupancy rating 0,33,6,4,2,24,1,16,2,13,1,7,7,0,3,2,0,0,1
S01011068,Occupancy rating -1 or less,16,2,0,2,13,0,9,0,8,1,4,3,1,1,1,0,0,0
S01011069,All households,251,80,43,37,158,23,105,42,42,21,30,19,11,13,1,0,2,10
S01011069,Occupancy rating +2 or more,135,41,28,13,85,15,64,34,18,12,6,3,3,9,1,0,1,7
S01011069,Occupancy rating +1,51,18,5,13,32,8,19,7,8,4,5,3,2,1,0,0,0,1
S01011069,Occupancy rating 0,52,19,9,10,31,0,17,1,13,3,14,10,4,2,0,0,1,1
S01011069,Occupancy rating -1 or less,13,2,1,1,10,0,5,0,3,2,5,3,2,1,0,0,0,1
S01011070,All households,274,91,47,44,177,26,138,58,59,21,13,10,3,6,2,0,1,3
S01011070,Occupancy rating +2 or more,168,59,33,26,106,17,87,48,29,10,2,1,1,3,1,0,1,1
S01011070,Occupancy rating +1,58,24,10,14,33,6,25,10,13,2,2,2,0,1,0,0,0,1
S01011070,Occupancy rating 0,39,8,4,4,29,1,19,0,13,6,9,7,2,2,1,0,0,1
S01011070,Occupancy rating -1 or less,9,0,0,0,9,2,7,0,4,3,0,0,0,0,0,0,0,0
S01011071,All households,357,94,52,42,237,42,176,83,54,39,19,7,12,26,6,0,7,13
S01011071,Occupancy rating +2 or more,242,62,32,30,167,33,126,79,25,22,8,1,7,13,0,0,4,9
S01011071,Occupancy rating +1,59,18,10,8,37,5,29,4,12,13,3,1,2,4,2,0,1,1
S01011071,Occupancy rating 0,47,14,10,4,25,4,15,0,13,2,6,4,2,8,3,0,2,3
S01011071,Occupancy rating -1 or less,9,0,0,0,8,0,6,0,4,2,2,1,1,1,1,0,0,0
S01011072,All households,407,84,39,45,309,32,233,102,94,37,44,29,15,14,5,0,1,8
S01011072,Occupancy rating +2 or more,263,48,25,23,209,30,169,91,58,20,10,2,8,6,1,0,0,5
S01011072,Occupancy rating +1,76,25,11,14,51,2,38,8,18,12,11,8,3,0,0,0,0,0
S01011072,Occupancy rating 0,53,10,3,7,41,0,19,3,14,2,22,18,4,2,1,0,0,1
S01011072,Occupancy rating -1 or less,15,1,0,1,8,0,7,0,4,3,1,1,0,6,3,0,1,2
S01011073,All households,286,77,36,41,194,30,145,57,63,25,19,9,10,15,5,0,1,9
S01011073,Occupancy rating +2 or more,184,49,25,24,128,25,94,46,36,12,9,3,6,7,1,0,0,6
S01011073,Occupancy rating +1,62,18,8,10,38,4,30,11,12,7,4,3,1,6,3,0,0,3
S01011073,Occupancy rating 0,31,7,2,5,23,1,17,0,11,6,5,2,3,1,0,0,1,0
S01011073,Occupancy rating -1 or less,9,3,1,2,5,0,4,0,4,0,1,1,0,1,1,0,0,0
S01011074,All households,280,94,37,57,178,25,128,65,49,14,25,12,13,8,3,0,1,4
S01011074,Occupancy rating +2 or more,170,66,25,41,100,19,73,47,21,5,8,2,6,4,2,0,1,1
S01011074,Occupancy rating +1,65,20,11,9,43,6,32,15,15,2,5,2,3,2,0,0,0,2
S01011074,Occupancy rating 0,37,7,0,7,29,0,20,3,11,6,9,5,4,1,0,0,0,1
S01011074,Occupancy rating -1 or less,8,1,1,0,6,0,3,0,2,1,3,3,0,1,1,0,0,0
S01011075,All households,322,100,53,47,215,25,135,51,62,22,55,35,20,7,1,0,0,6
S01011075,Occupancy rating +2 or more,93,31,15,16,62,13,47,29,12,6,2,0,2,0,0,0,0,0
S01011075,Occupancy rating +1,133,57,30,27,74,11,46,15,24,7,17,8,9,2,0,0,0,2
S01011075,Occupancy rating 0,77,12,8,4,64,1,34,6,21,7,29,22,7,1,0,0,0,1
S01011075,Occupancy rating -1 or less,19,0,0,0,15,0,8,1,5,2,7,5,2,4,1,0,0,3
S01011076,All households,348,143,86,57,187,23,141,53,60,28,23,17,6,18,8,0,1,9
S01011076,Occupancy rating +2 or more,156,59,34,25,93,15,74,32,24,18,4,1,3,4,1,0,0,3
S01011076,Occupancy rating +1,96,43,21,22,50,6,38,17,15,6,6,3,3,3,2,0,0,1
S01011076,Occupancy rating 0,79,37,29,8,36,2,24,4,17,3,10,10,0,6,2,0,0,4
S01011076,Occupancy rating -1 or less,17,4,2,2,8,0,5,0,4,1,3,3,0,5,3,0,1,1
S01011077,All households,337,108,49,59,216,38,112,37,57,18,66,47,19,13,9,0,1,3
S01011077,Occupancy rating +2 or more,89,31,11,20,57,24,32,21,9,2,1,0,1,1,1,0,0,0
S01011077,Occupancy rating +1,78,29,8,21,49,7,31,12,9,10,11,3,8,0,0,0,0,0
S01011077,Occupancy rating 0,137,42,27,15,92,7,41,4,33,4,44,37,7,3,0,0,0,3
S01011077,Occupancy rating -1 or less,33,6,3,3,18,0,8,0,6,2,10,7,3,9,8,0,1,0
S01011078,All households,466,121,59,62,331,72,221,86,108,27,38,18,20,14,7,0,2,5
S01011078,Occupancy rating +2 or more,314,65,45,20,241,67,155,64,72,19,19,9,10,8,5,0,0,3
S01011078,Occupancy rating +1,80,26,8,18,51,4,39,20,14,5,8,4,4,3,1,0,2,0
S01011078,Occupancy rating 0,57,24,5,19,31,1,20,1,16,3,10,5,5,2,0,0,0,2
S01011078,Occupancy rating -1 or less,15,6,1,5,8,0,7,1,6,0,1,0,1,1,1,0,0,0
S01011079,All households,488,176,72,104,291,40,218,95,92,31,33,12,21,21,4,0,3,14
S01011079,Occupancy rating +2 or more,270,89,47,42,175,27,133,68,48,17,15,6,9,6,2,0,1,3
S01011079,Occupancy rating +1,114,46,14,32,66,9,52,20,22,10,5,0,5,2,0,0,0,2
S01011079,Occupancy rating 0,76,30,9,21,38,4,25,5,16,4,9,5,4,8,0,0,2,6
S01011079,Occupancy rating -1 or less,28,11,2,9,12,0,8,2,6,0,4,1,3,5,2,0,0,3
S01011080,All households,461,172,74,98,270,46,190,92,71,27,34,19,15,19,7,0,2,10
S01011080,Occupancy rating +2 or more,233,66,40,26,162,32,125,72,38,15,5,3,2,5,1,0,2,2
S01011080,Occupancy rating +1,115,49,20,29,60,12,37,14,17,6,11,4,7,6,3,0,0,3
S01011080,Occupancy rating 0,84,45,11,34,35,2,20,3,12,5,13,7,6,4,1,0,0,3
S01011080,Occupancy rating -1 or less,29,12,3,9,13,0,8,3,4,1,5,5,0,4,2,0,0,2
S01011081,All households,352,105,42,63,235,40,151,53,71,27,44,30,14,12,6,0,1,5
S01011081,Occupancy rating +2 or more,158,63,30,33,94,27,61,44,13,4,6,2,4,1,0,0,0,1
S01011081,Occupancy rating +1,98,23,6,17,70,9,48,8,25,15,13,9,4,5,3,0,1,1
S01011081,Occupancy rating 0,75,17,5,12,55,4,30,1,23,6,21,16,5,3,2,0,0,1
S01011081,Occupancy rating -1 or less,21,2,1,1,16,0,12,0,10,2,4,3,1,3,1,0,0,2
S01011082,All households,269,145,95,50,113,17,80,35,28,17,16,7,9,11,4,0,3,4
S01011082,Occupancy rating +2 or more,63,22,11,11,40,9,31,22,7,2,0,0,0,1,0,0,0,1
S01011082,Occupancy rating +1,72,35,22,13,37,3,26,7,10,9,8,3,5,0,0,0,0,0
S01011082,Occupancy rating 0,115,83,58,25,29,4,19,6,8,5,6,3,3,3,2,0,1,0
S01011082,Occupancy rating -1 or less,19,5,4,1,7,1,4,0,3,1,2,1,1,7,2,0,2,3
S01011083,All households,347,100,55,45,224,37,158,74,52,32,29,17,12,23,12,0,3,8
S01011083,Occupancy rating +2 or more,190,46,19,27,135,24,105,59,29,17,6,5,1,9,2,0,3,4
S01011083,Occupancy rating +1,72,19,13,6,48,5,32,13,9,10,11,6,5,5,4,0,0,1
S01011083,Occupancy rating 0,69,28,19,9,36,7,20,2,13,5,9,5,4,5,3,0,0,2
S01011083,Occupancy rating -1 or less,16,7,4,3,5,1,1,0,1,0,3,1,2,4,3,0,0,1
S01011084,All households,330,81,43,38,231,35,174,85,58,31,22,12,10,18,6,0,1,11
S01011084,Occupancy rating +2 or more,232,49,29,20,171,32,127,71,34,22,12,8,4,12,5,0,1,6
S01011084,Occupancy rating +1,52,17,7,10,34,3,26,9,10,7,5,1,4,1,0,0,0,1
S01011084,Occupancy rating 0,33,12,6,6,18,0,16,5,10,1,2,1,1,3,1,0,0,2
S01011084,Occupancy rating -1 or less,13,3,1,2,8,0,5,0,4,1,3,2,1,2,0,0,0,2
S01011085,All households,383,81,45,36,287,45,210,120,65,25,32,20,12,15,8,0,4,3
S01011085,Occupancy rating +2 or more,264,44,25,19,211,37,164,107,37,20,10,5,5,9,6,0,2,1
S01011085,Occupancy rating +1,61,23,13,10,36,6,24,10,10,4,6,3,3,2,0,0,1,1
S01011085,Occupancy rating 0,49,13,6,7,33,2,18,3,14,1,13,10,3,3,2,0,0,1
S01011085,Occupancy rating -1 or less,9,1,1,0,7,0,4,0,4,0,3,2,1,1,0,0,1,0
S01011086,All households,273,69,47,22,190,39,143,63,55,25,8,3,5,14,5,0,0,9
S01011086,Occupancy rating +2 or more,190,41,30,11,143,35,104,56,32,16,4,2,2,6,2,0,0,4
S01011086,Occupancy rating +1,44,15,8,7,26,4,20,4,10,6,2,0,2,3,0,0,0,3
S01011086,Occupancy rating 0,28,11,7,4,14,0,14,2,10,2,0,0,0,3,1,0,0,2
S01011086,Occupancy rating -1 or less,11,2,2,0,7,0,5,1,3,1,2,1,1,2,2,0,0,0
S01011087,All households,262,73,26,47,182,36,113,49,48,16,33,18,15,7,3,0,0,4
S01011087,Occupancy rating +2 or more,93,25,11,14,67,21,43,27,11,5,3,2,1,1,0,0,0,1
S01011087,Occupancy rating +1,96,34,7,27,62,12,41,20,16,5,9,5,4,0,0,0,0,0
S01011087,Occupancy rating 0,62,13,8,5,44,3,23,1,18,4,18,10,8,5,2,0,0,3
S01011087,Occupancy rating -1 or less,11,1,0,1,9,0,6,1,3,2,3,1,2,1,1,0,0,0
S01011088,All households,453,173,91,82,263,38,181,74,79,28,44,29,15,17,9,0,0,8
S01011088,Occupancy rating +2 or more,255,84,39,45,163,31,116,61,41,14,16,10,6,8,5,0,0,3
S01011088,Occupancy rating +1,104,46,20,26,55,4,34,9,15,10,17,10,7,3,1,0,0,2
S01011088,Occupancy rating 0,80,40,30,10,35,1,24,4,16,4,10,8,2,5,2,0,0,3
S01011088,Occupancy rating -1 or less,14,3,2,1,10,2,7,0,7,0,1,1,0,1,1,0,0,0
S01011089,All households,310,107,52,55,197,40,123,61,48,14,34,24,10,6,0,0,0,6
S01011089,Occupancy rating +2 or more,118,38,25,13,79,25,53,36,12,5,1,0,1,1,0,0,0,1
S01011089,Occupancy rating +1,97,46,14,32,51,8,39,22,12,5,4,3,1,0,0,0,0,0
S01011089,Occupancy rating 0,80,22,12,10,54,6,24,3,18,3,24,16,8,4,0,0,0,4
S01011089,Occupancy rating -1 or less,15,1,1,0,13,1,7,0,6,1,5,5,0,1,0,0,0,1
S01011090,All households,304,67,36,31,222,32,173,92,60,21,17,7,10,15,6,0,3,6
S01011090,Occupancy rating +2 or more,235,52,25,27,175,29,134,80,44,10,12,5,7,8,1,0,3,4
S01011090,Occupancy rating +1,41,11,7,4,29,3,24,10,5,9,2,1,1,1,1,0,0,0
S01011090,Occupancy rating 0,22,3,3,0,14,0,11,2,9,0,3,1,2,5,3,0,0,2
S01011090,Occupancy rating -1 or less,6,1,1,0,4,0,4,0,2,2,0,0,0,1,1,0,0,0
S01011091,All households,260,49,19,30,200,25,161,87,46,28,14,7,7,11,4,0,2,5
S01011091,Occupancy rating +2 or more,210,40,16,24,163,23,131,81,33,17,9,4,5,7,3,0,1,3
S01011091,Occupancy rating +1,33,8,2,6,22,2,18,4,8,6,2,1,1,3,1,0,1,1
S01011091,Occupancy rating 0,11,1,1,0,10,0,8,1,3,4,2,1,1,0,0,0,0,0
S01011091,Occupancy rating -1 or less,6,0,0,0,5,0,4,1,2,1,1,1,0,1,0,0,0,1
S01011092,All households,181,45,4,41,126,5,80,26,51,3,41,36,5,10,3,0,0,7
S01011092,Occupancy rating +2 or more,35,6,2,4,28,4,20,13,7,0,4,4,0,1,0,0,0,1
S01011092,Occupancy rating +1,49,14,1,13,33,1,22,8,14,0,10,9,1,2,1,0,0,1
S01011092,Occupancy rating 0,85,23,1,22,57,0,32,4,25,3,25,22,3,5,1,0,0,4
S01011092,Occupancy rating -1 or less,12,2,0,2,8,0,6,1,5,0,2,1,1,2,1,0,0,1
S01011093,All households,239,32,15,17,191,29,153,78,63,12,9,6,3,16,10,1,1,4
S01011093,Occupancy rating +2 or more,194,24,13,11,161,27,129,73,47,9,5,4,1,9,4,0,1,4
S01011093,Occupancy rating +1,24,6,1,5,15,1,12,5,5,2,2,0,2,3,3,0,0,0
S01011093,Occupancy rating 0,18,1,0,1,13,1,10,0,9,1,2,2,0,4,3,1,0,0
S01011093,Occupancy rating -1 or less,3,1,1,0,2,0,2,0,2,0,0,0,0,0,0,0,0,0
S01011094,All households,196,37,16,21,151,18,121,58,52,11,12,9,3,8,3,0,0,5
S01011094,Occupancy rating +2 or more,156,29,11,18,126,17,102,53,42,7,7,6,1,1,0,0,0,1
S01011094,Occupancy rating +1,26,6,5,1,17,1,13,5,4,4,3,1,2,3,1,0,0,2
S01011094,Occupancy rating 0,14,2,0,2,8,0,6,0,6,0,2,2,0,4,2,0,0,2
S01011094,Occupancy rating -1 or less,0,0,0,0,0,0,0,0,0,0,0,0,0,0,0,0,0,0
S01011095,All households,318,61,32,29,251,29,199,99,75,25,23,12,11,6,3,0,1,2
S01011095,Occupancy rating +2 or more,248,49,25,24,195,29,158,87,53,18,8,6,2,4,3,0,1,0
S01011095,Occupancy rating +1,46,11,7,4,35,0,30,10,14,6,5,1,4,0,0,0,0,0
S01011095,Occupancy rating 0,13,1,0,1,10,0,4,0,3,1,6,3,3,2,0,0,0,2
S01011095,Occupancy rating -1 or less,11,0,0,0,11,0,7,2,5,0,4,2,2,0,0,0,0,0
S01011096,All households,223,50,14,36,160,18,120,52,58,10,22,15,7,13,5,0,2,6
S01011096,Occupancy rating +2 or more,138,29,9,20,103,13,82,43,31,8,8,5,3,6,2,0,1,3
S01011096,Occupancy rating +1,46,19,4,15,27,4,20,8,11,1,3,2,1,0,0,0,0,0
S01011096,Occupancy rating 0,27,1,0,1,20,1,12,1,10,1,7,5,2,6,2,0,1,3
S01011096,Occupancy rating -1 or less,12,1,1,0,10,0,6,0,6,0,4,3,1,1,1,0,0,0
S01011097,All households,284,57,18,39,216,25,174,80,76,18,17,13,4,11,7,0,1,3
S01011097,Occupancy rating +2 or more,217,41,14,27,167,22,136,71,53,12,9,5,4,9,6,0,1,2
S01011097,Occupancy rating +1,34,9,4,5,25,2,18,5,12,1,5,5,0,0,0,0,0,0
S01011097,Occupancy rating 0,28,6,0,6,20,1,17,3,9,5,2,2,0,2,1,0,0,1
S01011097,Occupancy rating -1 or less,5,1,0,1,4,0,3,1,2,0,1,1,0,0,0,0,0,0
S01011098,All households,346,105,49,56,232,35,183,95,68,20,14,5,9,9,1,0,0,8
S01011098,Occupancy rating +2 or more,158,43,24,19,115,25,89,62,21,6,1,0,1,0,0,0,0,0
S01011098,Occupancy rating +1,89,22,12,10,65,8,52,22,25,5,5,1,4,2,0,0,0,2
S01011098,Occupancy rating 0,84,38,12,26,42,2,36,10,18,8,4,2,2,4,0,0,0,4
S01011098,Occupancy rating -1 or less,15,2,1,1,10,0,6,1,4,1,4,2,2,3,1,0,0,2
S01011099,All households,358,106,28,78,233,16,155,69,63,23,62,43,19,19,7,0,0,12
S01011099,Occupancy rating +2 or more,107,31,13,18,71,10,56,37,11,8,5,4,1,5,1,0,0,4
S01011099,Occupancy rating +1,97,37,3,34,56,4,40,24,9,7,12,6,6,4,0,0,0,4
S01011099,Occupancy rating 0,115,34,12,22,76,2,40,7,27,6,34,24,10,5,2,0,0,3
S01011099,Occupancy rating -1 or less,39,4,0,4,30,0,19,1,16,2,11,9,2,5,4,0,0,1
S01011100,All households,210,68,37,31,133,30,90,34,35,21,13,5,8,9,3,0,2,4
S01011100,Occupancy rating +2 or more,103,29,18,11,71,16,51,24,16,11,4,2,2,3,2,0,0,1
S01011100,Occupancy rating +1,66,29,15,14,35,13,18,8,4,6,4,1,3,2,0,0,1,1
S01011100,Occupancy rating 0,31,5,3,2,24,1,18,2,13,3,5,2,3,2,0,0,1,1
S01011100,Occupancy rating -1 or less,10,5,1,4,3,0,3,0,2,1,0,0,0,2,1,0,0,1
S01011101,All households,247,72,33,39,165,14,110,40,48,22,41,24,17,10,6,0,0,4
S01011101,Occupancy rating +2 or more,63,25,15,10,38,6,31,24,5,2,1,1,0,0,0,0,0,0
S01011101,Occupancy rating +1,75,22,8,14,52,7,26,10,6,10,19,9,10,1,0,0,0,1
S01011101,Occupancy rating 0,84,25,10,15,53,1,36,6,24,6,16,10,6,6,4,0,0,2
S01011101,Occupancy rating -1 or less,25,0,0,0,22,0,17,0,13,4,5,4,1,3,2,0,0,1
S01011102,All households,330,125,33,92,183,21,100,54,35,11,62,38,24,22,8,0,0,14
S01011102,Occupancy rating +2 or more,46,18,7,11,28,5,19,10,7,2,4,1,3,0,0,0,0,0
S01011102,Occupancy rating +1,150,81,21,60,65,12,49,39,7,3,4,0,4,4,1,0,0,3
S01011102,Occupancy rating 0,105,21,3,18,77,4,27,4,18,5,46,33,13,7,2,0,0,5
S01011102,Occupancy rating -1 or less,29,5,2,3,13,0,5,1,3,1,8,4,4,11,5,0,0,6
S01011103,All households,312,155,65,90,134,15,92,45,37,10,27,19,8,23,4,0,1,18
S01011103,Occupancy rating +2 or more,65,22,10,12,41,8,32,20,8,4,1,0,1,2,0,0,0,2
S01011103,Occupancy rating +1,74,38,12,26,32,3,24,12,8,4,5,3,2,4,0,0,1,3
S01011103,Occupancy rating 0,140,84,36,48,47,4,29,13,14,2,14,10,4,9,1,0,0,8
S01011103,Occupancy rating -1 or less,33,11,7,4,14,0,7,0,7,0,7,6,1,8,3,0,0,5
S01011104,All households,294,127,60,67,152,36,96,46,35,15,20,10,10,15,2,0,0,13
S01011104,Occupancy rating +2 or more,143,33,21,12,105,25,72,34,26,12,8,4,4,5,1,0,0,4
S01011104,Occupancy rating +1,58,34,16,18,19,7,10,4,4,2,2,0,2,5,0,0,0,5
S01011104,Occupancy rating 0,76,52,21,31,23,3,13,7,5,1,7,4,3,1,0,0,0,1
S01011104,Occupancy rating -1 or less,17,8,2,6,5,1,1,1,0,0,3,2,1,4,1,0,0,3
S01011105,All households,405,152,51,101,232,41,152,83,54,15,39,28,11,21,7,0,1,13
S01011105,Occupancy rating +2 or more,91,26,9,17,63,12,49,31,13,5,2,2,0,2,1,0,0,1
S01011105,Occupancy rating +1,161,64,24,40,95,19,55,37,13,5,21,14,7,2,1,0,0,1
S01011105,Occupancy rating 0,113,49,16,33,51,7,33,10,18,5,11,8,3,13,3,0,1,9
S01011105,Occupancy rating -1 or less,40,13,2,11,23,3,15,5,10,0,5,4,1,4,2,0,0,2
S01011106,All households,352,47,11,36,291,9,220,59,154,7,62,57,5,14,11,0,0,3
S01011106,Occupancy rating +2 or more,153,20,8,12,130,6,117,39,77,1,7,6,1,3,2,0,0,1
S01011106,Occupancy rating +1,83,20,3,17,59,2,42,15,23,4,15,14,1,4,3,0,0,1
S01011106,Occupancy rating 0,94,5,0,5,85,1,56,5,49,2,28,25,3,4,3,0,0,1
S01011106,Occupancy rating -1 or less,22,2,0,2,17,0,5,0,5,0,12,12,0,3,3,0,0,0
S01011107,All households,324,48,7,41,254,2,202,62,124,16,50,44,6,22,11,0,0,11
S01011107,Occupancy rating +2 or more,140,26,6,20,111,1,103,38,57,8,7,7,0,3,3,0,0,0
S01011107,Occupancy rating +1,68,10,1,9,54,1,44,20,23,1,9,4,5,4,2,0,0,2
S01011107,Occupancy rating 0,95,12,0,12,74,0,47,4,38,5,27,26,1,9,2,0,0,7
S01011107,Occupancy rating -1 or less,21,0,0,0,15,0,8,0,6,2,7,7,0,6,4,0,0,2
S01011108,All households,216,56,30,26,151,12,106,41,46,19,33,16,17,9,5,1,1,2
S01011108,Occupancy rating +2 or more,70,14,4,10,55,5,46,25,17,4,4,1,3,1,1,0,0,0
S01011108,Occupancy rating +1,62,18,10,8,42,1,34,15,11,8,7,2,5,2,1,0,0,1
S01011108,Occupancy rating 0,67,24,16,8,42,5,20,1,14,5,17,9,8,1,1,0,0,0
S01011108,Occupancy rating -1 or less,17,0,0,0,12,1,6,0,4,2,5,4,1,5,2,1,1,1
S01011109,All households,389,128,63,65,251,39,187,100,59,28,25,15,10,10,3,0,0,7
S01011109,Occupancy rating +2 or more,158,39,23,16,119,25,88,59,15,14,6,5,1,0,0,0,0,0
S01011109,Occupancy rating +1,137,59,29,30,76,12,58,35,17,6,6,2,4,2,0,0,0,2
S01011109,Occupancy rating 0,74,27,9,18,45,2,32,4,22,6,11,6,5,2,1,0,0,1
S01011109,Occupancy rating -1 or less,20,3,2,1,11,0,9,2,5,2,2,2,0,6,2,0,0,4
S01011110,All households,314,110,22,88,187,18,138,57,65,16,31,18,13,17,7,0,0,10
S01011110,Occupancy rating +2 or more,81,16,7,9,60,10,48,31,15,2,2,2,0,5,0,0,0,5
S01011110,Occupancy rating +1,101,39,7,32,60,5,49,22,19,8,6,2,4,2,2,0,0,0
S01011110,Occupancy rating 0,113,53,8,45,56,3,33,4,24,5,20,11,9,4,2,0,0,2
S01011110,Occupancy rating -1 or less,19,2,0,2,11,0,8,0,7,1,3,3,0,6,3,0,0,3
S01011111,All households,407,153,50,103,232,16,148,62,67,19,68,45,23,22,13,0,0,9
S01011111,Occupancy rating +2 or more,124,49,12,37,72,9,58,37,14,7,5,3,2,3,0,0,0,3
S01011111,Occupancy rating +1,130,64,24,40,61,2,41,20,16,5,18,10,8,5,3,0,0,2
S01011111,Occupancy rating 0,114,30,12,18,77,4,43,4,32,7,30,23,7,7,4,0,0,3
S01011111,Occupancy rating -1 or less,39,10,2,8,22,1,6,1,5,0,15,9,6,7,6,0,0,1
S01011112,All households,328,56,13,43,250,9,206,71,114,21,35,25,10,22,8,0,1,13
S01011112,Occupancy rating +2 or more,208,39,11,28,160,6,139,48,80,11,15,8,7,9,5,0,1,3
S01011112,Occupancy rating +1,74,13,2,11,58,3,47,22,19,6,8,7,1,3,1,0,0,2
S01011112,Occupancy rating 0,30,3,0,3,21,0,15,1,11,3,6,5,1,6,0,0,0,6
S01011112,Occupancy rating -1 or less,16,1,0,1,11,0,5,0,4,1,6,5,1,4,2,0,0,2
S01011113,All households,446,149,83,66,274,56,175,86,52,37,43,22,21,23,3,0,4,16
S01011113,Occupancy rating +2 or more,172,54,32,22,115,32,78,50,18,10,5,3,2,3,0,0,0,3
S01011113,Occupancy rating +1,157,64,36,28,85,19,56,33,10,13,10,5,5,8,1,0,1,6
S01011113,Occupancy rating 0,87,24,11,13,54,5,29,3,15,11,20,9,11,9,1,0,2,6
S01011113,Occupancy rating -1 or less,30,7,4,3,20,0,12,0,9,3,8,5,3,3,1,0,1,1
S01011114,All households,296,60,27,33,222,26,175,91,55,29,21,12,9,14,5,0,1,8
S01011114,Occupancy rating +2 or more,182,28,14,14,148,22,116,75,25,16,10,5,5,6,1,0,1,4
S01011114,Occupancy rating +1,76,26,10,16,48,3,38,14,15,9,7,4,3,2,1,0,0,1
S01011114,Occupancy rating 0,27,5,2,3,18,1,15,2,9,4,2,1,1,4,2,0,0,2
S01011114,Occupancy rating -1 or less,11,1,1,0,8,0,6,0,6,0,2,2,0,2,1,0,0,1
S01011115,All households,411,148,60,88,244,20,180,85,69,26,44,30,14,19,8,0,2,9
S01011115,Occupancy rating +2 or more,88,24,11,13,62,11,50,34,14,2,1,0,1,2,1,0,1,0
S01011115,Occupancy rating +1,145,50,19,31,91,7,73,40,21,12,11,7,4,4,2,0,0,2
S01011115,Occupancy rating 0,139,65,26,39,68,2,47,10,27,10,19,12,7,6,2,0,0,4
S01011115,Occupancy rating -1 or less,39,9,4,5,23,0,10,1,7,2,13,11,2,7,3,0,1,3
S01011116,All households,269,47,22,25,208,31,149,66,60,23,28,19,9,14,6,0,2,6
S01011116,Occupancy rating +2 or more,149,20,10,10,123,20,92,52,26,14,11,7,4,6,3,0,0,3
S01011116,Occupancy rating +1,79,21,8,13,56,10,41,14,21,6,5,3,2,2,2,0,0,0
S01011116,Occupancy rating 0,36,6,4,2,25,1,12,0,10,2,12,9,3,5,1,0,1,3
S01011116,Occupancy rating -1 or less,5,0,0,0,4,0,4,0,3,1,0,0,0,1,0,0,1,0
S01011117,All households,359,135,67,68,202,45,137,67,55,15,20,11,9,22,2,0,0,20
S01011117,Occupancy rating +2 or more,195,50,30,20,139,38,92,44,39,9,9,4,5,6,2,0,0,4
S01011117,Occupancy rating +1,78,38,25,13,36,5,27,15,8,4,4,1,3,4,0,0,0,4
S01011117,Occupancy rating 0,64,36,11,25,24,2,15,7,6,2,7,6,1,4,0,0,0,4
S01011117,Occupancy rating -1 or less,22,11,1,10,3,0,3,1,2,0,0,0,0,8,0,0,0,8
S01011118,All households,399,145,81,64,230,50,163,60,84,19,17,11,6,24,11,1,1,11
S01011118,Occupancy rating +2 or more,265,79,42,37,178,46,123,41,67,15,9,6,3,8,2,0,1,5
S01011118,Occupancy rating +1,62,23,5,18,35,2,26,14,9,3,7,4,3,4,2,0,0,2
S01011118,Occupancy rating 0,61,38,31,7,15,2,12,5,6,1,1,1,0,8,4,0,0,4
S01011118,Occupancy rating -1 or less,11,5,3,2,2,0,2,0,2,0,0,0,0,4,3,1,0,0
S01011119,All households,422,123,71,52,275,60,193,100,74,19,22,11,11,24,9,0,3,12
S01011119,Occupancy rating +2 or more,269,58,29,29,201,44,147,80,53,14,10,3,7,10,5,0,0,5
S01011119,Occupancy rating +1,76,39,21,18,33,7,22,13,7,2,4,2,2,4,0,0,3,1
S01011119,Occupancy rating 0,57,23,21,2,33,8,19,6,11,2,6,5,1,1,0,0,0,1
S01011119,Occupancy rating -1 or less,20,3,0,3,8,1,5,1,3,1,2,1,1,9,4,0,0,5
S01011120,All households,293,54,38,16,229,70,156,81,49,26,3,1,2,10,2,0,5,3
S01011120,Occupancy rating +2 or more,260,50,37,13,207,69,137,79,38,20,1,0,1,3,0,0,3,0
S01011120,Occupancy rating +1,23,3,1,2,15,1,13,2,5,6,1,1,0,5,0,0,2,3
S01011120,Occupancy rating 0,8,1,0,1,6,0,5,0,5,0,1,0,1,1,1,0,0,0
S01011120,Occupancy rating -1 or less,2,0,0,0,1,0,1,0,1,0,0,0,0,1,1,0,0,0
S01011121,All households,313,174,67,107,115,14,87,56,23,8,14,7,7,24,1,0,0,23
S01011121,Occupancy rating +2 or more,58,21,5,16,35,9,24,17,5,2,2,1,1,2,0,0,0,2
S01011121,Occupancy rating +1,45,19,6,13,23,0,20,10,7,3,3,1,2,3,0,0,0,3
S01011121,Occupancy rating 0,159,111,48,63,39,4,29,22,5,2,6,2,4,9,0,0,0,9
S01011121,Occupancy rating -1 or less,51,23,8,15,18,1,14,7,6,1,3,3,0,10,1,0,0,9
S01011122,All households,302,99,35,64,187,28,126,61,50,15,33,21,12,16,6,0,0,10
S01011122,Occupancy rating +2 or more,123,41,18,23,77,20,55,38,14,3,2,1,1,5,0,0,0,5
S01011122,Occupancy rating +1,91,40,14,26,47,8,31,16,11,4,8,4,4,4,2,0,0,2
S01011122,Occupancy rating 0,69,14,3,11,51,0,31,6,19,6,20,16,4,4,1,0,0,3
S01011122,Occupancy rating -1 or less,19,4,0,4,12,0,9,1,6,2,3,0,3,3,3,0,0,0
S01011123,All households,490,148,85,63,313,45,205,79,95,31,63,30,33,29,11,0,1,17
S01011123,Occupancy rating +2 or more,167,51,23,28,112,26,81,45,29,7,5,2,3,4,1,0,0,3
S01011123,Occupancy rating +1,191,88,54,34,95,19,67,33,21,13,9,1,8,8,1,0,1,6
S01011123,Occupancy rating 0,104,8,7,1,85,0,44,1,34,9,41,23,18,11,4,0,0,7
S01011123,Occupancy rating -1 or less,28,1,1,0,21,0,13,0,11,2,8,4,4,6,5,0,0,1
S01011124,All households,277,78,33,45,186,17,129,43,72,14,40,25,15,13,7,0,1,5
S01011124,Occupancy rating +2 or more,104,26,9,17,75,4,68,21,43,4,3,2,1,3,1,0,0,2
S01011124,Occupancy rating +1,111,48,21,27,59,9,36,22,9,5,14,10,4,4,2,0,1,1
S01011124,Occupancy rating 0,51,3,2,1,46,4,21,0,17,4,21,12,9,2,1,0,0,1
S01011124,Occupancy rating -1 or less,11,1,1,0,6,0,4,0,3,1,2,1,1,4,3,0,0,1
S01011125,All households,220,75,13,62,138,8,79,33,31,15,51,36,15,7,5,2,0,0
S01011125,Occupancy rating +2 or more,29,6,1,5,23,3,16,10,3,3,4,2,2,0,0,0,0,0
S01011125,Occupancy rating +1,66,29,7,22,35,3,24,14,7,3,8,4,4,2,2,0,0,0
S01011125,Occupancy rating 0,99,33,5,28,62,2,29,9,13,7,31,23,8,4,2,2,0,0
S01011125,Occupancy rating -1 or less,26,7,0,7,18,0,10,0,8,2,8,7,1,1,1,0,0,0
S01011126,All households,184,32,27,5,142,14,114,38,64,12,14,6,8,10,5,0,0,5
S01011126,Occupancy rating +2 or more,90,7,4,3,79,5,72,31,33,8,2,0,2,4,2,0,0,2
S01011126,Occupancy rating +1,42,3,2,1,35,4,28,7,19,2,3,3,0,4,1,0,0,3
S01011126,Occupancy rating 0,46,22,21,1,22,5,11,0,9,2,6,1,5,2,2,0,0,0
S01011126,Occupancy rating -1 or less,6,0,0,0,6,0,3,0,3,0,3,2,1,0,0,0,0,0
S01011127,All households,153,2,1,1,147,1,141,32,107,2,5,4,1,4,4,0,0,0
S01011127,Occupancy rating +2 or more,116,2,1,1,112,0,111,31,78,2,1,1,0,2,2,0,0,0
S01011127,Occupancy rating +1,25,0,0,0,25,1,20,0,20,0,4,3,1,0,0,0,0,0
S01011127,Occupancy rating 0,8,0,0,0,8,0,8,1,7,0,0,0,0,0,0,0,0,0
S01011127,Occupancy rating -1 or less,4,0,0,0,2,0,2,0,2,0,0,0,0,2,2,0,0,0
S01011128,All households,341,135,44,91,197,23,151,72,68,11,23,15,8,9,1,0,1,7
S01011128,Occupancy rating +2 or more,117,33,12,21,83,11,70,37,30,3,2,2,0,1,0,0,0,1
S01011128,Occupancy rating +1,99,35,16,19,60,9,46,24,17,5,5,2,3,4,0,0,0,4
S01011128,Occupancy rating 0,107,60,14,46,44,2,28,11,15,2,14,9,5,3,1,0,0,2
S01011128,Occupancy rating -1 or less,18,7,2,5,10,1,7,0,6,1,2,2,0,1,0,0,1,0
S01011129,All households,356,50,33,17,296,30,252,82,152,18,14,5,9,10,2,0,0,8
S01011129,Occupancy rating +2 or more,282,32,22,10,242,22,214,73,132,9,6,4,2,8,1,0,0,7
S01011129,Occupancy rating +1,55,14,10,4,40,8,29,8,15,6,3,0,3,1,1,0,0,0
S01011129,Occupancy rating 0,18,4,1,3,13,0,8,1,4,3,5,1,4,1,0,0,0,1
S01011129,Occupancy rating -1 or less,1,0,0,0,1,0,1,0,1,0,0,0,0,0,0,0,0,0
S01011130,All households,296,119,62,57,167,25,118,64,47,7,24,11,13,10,5,0,0,5
S01011130,Occupancy rating +2 or more,94,33,19,14,60,11,46,30,13,3,3,1,2,1,1,0,0,0
S01011130,Occupancy rating +1,82,36,19,17,45,8,33,20,11,2,4,0,4,1,0,0,0,1
S01011130,Occupancy rating 0,101,48,23,25,50,5,34,14,18,2,11,7,4,3,0,0,0,3
S01011130,Occupancy rating -1 or less,19,2,1,1,12,1,5,0,5,0,6,3,3,5,4,0,0,1
S01011131,All households,318,121,45,76,175,23,135,74,38,23,17,11,6,22,3,2,0,17
S01011131,Occupancy rating +2 or more,144,43,22,21,93,17,72,41,23,8,4,2,2,8,2,0,0,6
S01011131,Occupancy rating +1,87,38,14,24,45,5,38,21,9,8,2,2,0,4,1,0,0,3
S01011131,Occupancy rating 0,62,30,8,22,28,1,19,10,4,5,8,5,3,4,0,0,0,4
S01011131,Occupancy rating -1 or less,25,10,1,9,9,0,6,2,2,2,3,2,1,6,0,2,0,4
S01011132,All households,374,100,57,43,248,38,191,78,80,33,19,9,10,26,8,0,2,16
S01011132,Occupancy rating +2 or more,238,57,42,15,170,35,125,56,51,18,10,6,4,11,5,0,2,4
S01011132,Occupancy rating +1,95,31,8,23,57,2,49,16,21,12,6,3,3,7,3,0,0,4
S01011132,Occupancy rating 0,28,12,7,5,14,1,10,5,4,1,3,0,3,2,0,0,0,2
S01011132,Occupancy rating -1 or less,13,0,0,0,7,0,7,1,4,2,0,0,0,6,0,0,0,6
S01011133,All households,190,55,34,21,123,24,81,25,31,25,18,7,11,12,4,0,0,8
S01011133,Occupancy rating +2 or more,116,42,27,15,71,20,45,18,14,13,6,2,4,3,2,0,0,1
S01011133,Occupancy rating +1,50,12,6,6,33,4,26,7,10,9,3,0,3,5,0,0,0,5
S01011133,Occupancy rating 0,19,1,1,0,15,0,9,0,6,3,6,4,2,3,1,0,0,2
S01011133,Occupancy rating -1 or less,5,0,0,0,4,0,1,0,1,0,3,1,2,1,1,0,0,0
S01011134,All households,401,175,76,99,211,33,150,74,48,28,28,15,13,15,2,0,1,12
S01011134,Occupancy rating +2 or more,169,49,27,22,114,20,87,49,22,16,7,1,6,6,1,0,1,4
S01011134,Occupancy rating +1,132,77,27,50,50,8,35,19,8,8,7,2,5,5,0,0,0,5
S01011134,Occupancy rating 0,86,44,20,24,39,4,24,6,14,4,11,9,2,3,0,0,0,3
S01011134,Occupancy rating -1 or less,14,5,2,3,8,1,4,0,4,0,3,3,0,1,1,0,0,0
S01011135,All households,337,97,54,43,222,29,144,67,54,23,49,28,21,18,7,0,2,9
S01011135,Occupancy rating +2 or more,82,20,11,9,61,14,40,22,13,5,7,3,4,1,1,0,0,0
S01011135,Occupancy rating +1,119,45,26,19,70,10,50,37,8,5,10,5,5,4,1,0,0,3
S01011135,Occupancy rating 0,107,25,15,10,75,5,44,7,25,12,26,18,8,7,0,0,1,6
S01011135,Occupancy rating -1 or less,29,7,2,5,16,0,10,1,8,1,6,2,4,6,5,0,1,0
S01011136,All households,284,77,36,41,192,28,136,64,47,25,28,12,16,15,6,0,0,9
S01011136,Occupancy rating +2 or more,139,33,21,12,99,18,79,38,24,17,2,1,1,7,4,0,0,3
S01011136,Occupancy rating +1,85,37,14,23,46,8,33,19,9,5,5,3,2,2,0,0,0,2
S01011136,Occupancy rating 0,48,6,1,5,38,0,21,7,11,3,17,5,12,4,0,0,0,4
S01011136,Occupancy rating -1 or less,12,1,0,1,9,2,3,0,3,0,4,3,1,2,2,0,0,0
S01011137,All households,186,38,13,25,137,12,89,35,41,13,36,30,6,11,5,0,0,6
S01011137,Occupancy rating +2 or more,93,24,9,15,61,7,50,27,17,6,4,2,2,8,4,0,0,4
S01011137,Occupancy rating +1,43,9,4,5,34,4,22,6,11,5,8,6,2,0,0,0,0,0
S01011137,Occupancy rating 0,43,5,0,5,36,1,15,2,11,2,20,18,2,2,1,0,0,1
S01011137,Occupancy rating -1 or less,7,0,0,0,6,0,2,0,2,0,4,4,0,1,0,0,0,1
S01011138,All households,254,60,18,42,185,12,126,39,67,20,47,28,19,9,4,0,1,4
S01011138,Occupancy rating +2 or more,77,12,4,8,64,6,49,20,24,5,9,5,4,1,1,0,0,0
S01011138,Occupancy rating +1,90,32,10,22,57,6,46,15,23,8,5,4,1,1,0,0,0,1
S01011138,Occupancy rating 0,70,14,4,10,51,0,26,2,17,7,25,14,11,5,1,0,1,3
S01011138,Occupancy rating -1 or less,17,2,0,2,13,0,5,2,3,0,8,5,3,2,2,0,0,0
S01011139,All households,281,55,19,36,219,9,192,62,120,10,18,13,5,7,2,1,0,4
S01011139,Occupancy rating +2 or more,159,15,5,10,141,5,127,38,85,4,9,7,2,3,1,0,0,2
S01011139,Occupancy rating +1,57,20,8,12,36,3,31,16,13,2,2,0,2,1,0,0,0,1
S01011139,Occupancy rating 0,52,19,6,13,31,0,28,8,17,3,3,3,0,2,1,0,0,1
S01011139,Occupancy rating -1 or less,13,1,0,1,11,1,6,0,5,1,4,3,1,1,0,1,0,0
S01011140,All households,232,75,23,52,151,12,112,39,59,14,27,14,13,6,4,0,0,2
S01011140,Occupancy rating +2 or more,55,13,4,9,41,5,32,15,16,1,4,1,3,1,0,0,0,1
S01011140,Occupancy rating +1,74,26,3,23,47,2,36,18,11,7,9,2,7,1,0,0,0,1
S01011140,Occupancy rating 0,89,35,15,20,53,5,37,5,28,4,11,9,2,1,1,0,0,0
S01011140,Occupancy rating -1 or less,14,1,1,0,10,0,7,1,4,2,3,2,1,3,3,0,0,0
S01011141,All households,230,60,26,34,157,10,113,46,47,20,34,23,11,13,5,0,0,8
S01011141,Occupancy rating +2 or more,64,10,6,4,50,6,43,27,9,7,1,0,1,4,2,0,0,2
S01011141,Occupancy rating +1,64,25,7,18,38,2,28,14,12,2,8,2,6,1,0,0,0,1
S01011141,Occupancy rating 0,89,25,13,12,59,2,35,4,20,11,22,18,4,5,0,0,0,5
S01011141,Occupancy rating -1 or less,13,0,0,0,10,0,7,1,6,0,3,3,0,3,3,0,0,0
S01011142,All households,334,58,17,41,264,40,202,83,91,28,22,11,11,12,2,0,2,8
S01011142,Occupancy rating +2 or more,241,38,16,22,196,36,150,71,64,15,10,6,4,7,2,0,1,4
S01011142,Occupancy rating +1,52,9,1,8,42,3,34,8,17,9,5,1,4,1,0,0,1,0
S01011142,Occupancy rating 0,31,9,0,9,19,0,14,2,9,3,5,3,2,3,0,0,0,3
S01011142,Occupancy rating -1 or less,10,2,0,2,7,1,4,2,1,1,2,1,1,1,0,0,0,1
S01011143,All households,398,93,61,32,288,52,205,83,94,28,31,22,9,17,9,0,2,6
S01011143,Occupancy rating +2 or more,274,69,48,21,197,39,147,69,59,19,11,8,3,8,3,0,1,4
S01011143,Occupancy rating +1,78,18,11,7,57,12,38,10,22,6,7,5,2,3,1,0,1,1
S01011143,Occupancy rating 0,39,5,2,3,31,1,19,4,12,3,11,8,3,3,2,0,0,1
S01011143,Occupancy rating -1 or less,7,1,0,1,3,0,1,0,1,0,2,1,1,3,3,0,0,0
S01011144,All households,303,73,37,36,219,30,166,63,76,27,23,13,10,11,8,0,1,2
S01011144,Occupancy rating +2 or more,181,38,18,20,139,23,109,51,46,12,7,6,1,4,3,0,0,1
S01011144,Occupancy rating +1,73,23,10,13,48,7,33,8,14,11,8,4,4,2,1,0,0,1
S01011144,Occupancy rating 0,37,11,8,3,23,0,18,4,11,3,5,2,3,3,2,0,1,0
S01011144,Occupancy rating -1 or less,12,1,1,0,9,0,6,0,5,1,3,1,2,2,2,0,0,0
S01011145,All households,267,57,29,28,197,33,151,68,59,24,13,7,6,13,3,0,0,10
S01011145,Occupancy rating +2 or more,194,39,24,15,148,29,115,57,44,14,4,2,2,7,2,0,0,5
S01011145,Occupancy rating +1,45,13,4,9,27,4,21,9,6,6,2,1,1,5,0,0,0,5
S01011145,Occupancy rating 0,21,4,1,3,17,0,12,2,7,3,5,3,2,0,0,0,0,0
S01011145,Occupancy rating -1 or less,7,1,0,1,5,0,3,0,2,1,2,1,1,1,1,0,0,0
S01011146,All households,306,68,30,38,224,33,145,59,69,17,46,28,18,14,8,0,0,6
S01011146,Occupancy rating +2 or more,165,32,12,20,127,26,94,47,37,10,7,5,2,6,1,0,0,5
S01011146,Occupancy rating +1,72,21,9,12,48,5,30,12,14,4,13,6,7,3,3,0,0,0
S01011146,Occupancy rating 0,57,15,9,6,40,2,17,0,14,3,21,13,8,2,1,0,0,1
S01011146,Occupancy rating -1 or less,12,0,0,0,9,0,4,0,4,0,5,4,1,3,3,0,0,0
S01011147,All households,450,155,63,92,276,30,206,99,77,30,40,20,20,19,10,0,0,9
S01011147,Occupancy rating +2 or more,245,71,38,33,165,21,129,77,38,14,15,7,8,9,4,0,0,5
S01011147,Occupancy rating +1,111,45,10,35,63,8,45,19,16,10,10,5,5,3,2,0,0,1
S01011147,Occupancy rating 0,76,34,13,21,40,1,28,3,20,5,11,5,6,2,0,0,0,2
S01011147,Occupancy rating -1 or less,18,5,2,3,8,0,4,0,3,1,4,3,1,5,4,0,0,1
S01011148,All households,329,89,32,57,228,33,165,79,59,27,30,20,10,12,4,0,1,7
S01011148,Occupancy rating +2 or more,215,48,16,32,160,29,120,68,34,18,11,6,5,7,4,0,1,2
S01011148,Occupancy rating +1,72,31,12,19,39,3,31,10,14,7,5,2,3,2,0,0,0,2
S01011148,Occupancy rating 0,30,6,2,4,22,1,13,1,10,2,8,6,2,2,0,0,0,2
S01011148,Occupancy rating -1 or less,12,4,2,2,7,0,1,0,1,0,6,6,0,1,0,0,0,1
S01011149,All households,265,67,21,46,179,5,155,53,91,11,19,10,9,19,1,0,2,16
S01011149,Occupancy rating +2 or more,162,27,10,17,130,5,119,45,64,10,6,3,3,5,0,0,0,5
S01011149,Occupancy rating +1,53,14,4,10,34,0,28,5,23,0,6,4,2,5,0,0,2,3
S01011149,Occupancy rating 0,30,12,4,8,11,0,6,2,3,1,5,2,3,7,1,0,0,6
S01011149,Occupancy rating -1 or less,20,14,3,11,4,0,2,1,1,0,2,1,1,2,0,0,0,2
S01011150,All households,175,30,0,30,137,2,115,44,71,0,20,16,4,8,3,0,0,5
S01011150,Occupancy rating +2 or more,119,18,0,18,96,2,89,41,48,0,5,4,1,5,1,0,0,4
S01011150,Occupancy rating +1,34,9,0,9,25,0,16,3,13,0,9,6,3,0,0,0,0,0
S01011150,Occupancy rating 0,18,1,0,1,16,0,10,0,10,0,6,6,0,1,0,0,0,1
S01011150,Occupancy rating -1 or less,4,2,0,2,0,0,0,0,0,0,0,0,0,2,2,0,0,0
S01011151,All households,218,46,11,35,158,6,139,53,80,6,13,12,1,14,3,0,1,10
S01011151,Occupancy rating +2 or more,132,14,5,9,114,4,105,42,62,1,5,5,0,4,1,0,0,3
S01011151,Occupancy rating +1,43,19,5,14,22,2,18,7,8,3,2,2,0,2,0,0,0,2
S01011151,Occupancy rating 0,27,6,0,6,15,0,11,3,6,2,4,3,1,6,0,0,1,5
S01011151,Occupancy rating -1 or less,16,7,1,6,7,0,5,1,4,0,2,2,0,2,2,0,0,0
S01011152,All households,341,134,67,67,189,42,121,58,46,17,26,15,11,18,5,0,0,13
S01011152,Occupancy rating +2 or more,200,61,36,25,133,36,85,46,25,14,12,4,8,6,2,0,0,4
S01011152,Occupancy rating +1,75,43,18,25,29,3,22,9,12,1,4,3,1,3,0,0,0,3
S01011152,Occupancy rating 0,49,26,12,14,18,2,9,3,5,1,7,6,1,5,1,0,0,4
S01011152,Occupancy rating -1 or less,17,4,1,3,9,1,5,0,4,1,3,2,1,4,2,0,0,2
S01011153,All households,455,221,87,134,211,39,150,77,58,15,22,13,9,23,4,0,4,15
S01011153,Occupancy rating +2 or more,179,61,29,32,113,25,83,41,32,10,5,2,3,5,3,0,1,1
S01011153,Occupancy rating +1,134,83,29,54,47,10,36,26,7,3,1,1,0,4,0,0,0,4
S01011153,Occupancy rating 0,113,63,25,38,41,4,24,7,15,2,13,7,6,9,0,0,1,8
S01011153,Occupancy rating -1 or less,29,14,4,10,10,0,7,3,4,0,3,3,0,5,1,0,2,2
S01011154,All households,348,210,81,129,128,26,72,42,19,11,30,24,6,10,0,0,1,9
S01011154,Occupancy rating +2 or more,97,41,18,23,54,13,34,21,7,6,7,7,0,2,0,0,1,1
S01011154,Occupancy rating +1,79,52,19,33,27,8,16,13,3,0,3,2,1,0,0,0,0,0
S01011154,Occupancy rating 0,134,93,40,53,36,5,16,8,6,2,15,10,5,5,0,0,0,5
S01011154,Occupancy rating -1 or less,38,24,4,20,11,0,6,0,3,3,5,5,0,3,0,0,0,3
S01011155,All households,348,177,89,88,163,33,101,40,45,16,29,12,17,8,4,0,1,3
S01011155,Occupancy rating +2 or more,108,39,17,22,67,16,45,23,19,3,6,4,2,2,1,0,0,1
S01011155,Occupancy rating +1,108,60,24,36,46,9,28,11,9,8,9,2,7,2,1,0,0,1
S01011155,Occupancy rating 0,97,59,39,20,37,6,22,6,14,2,9,4,5,1,0,0,0,1
S01011155,Occupancy rating -1 or less,35,19,9,10,13,2,6,0,3,3,5,2,3,3,2,0,1,0
S01011156,All households,249,62,24,38,178,30,132,63,52,17,16,6,10,9,4,0,1,4
S01011156,Occupancy rating +2 or more,152,35,17,18,116,28,83,52,22,9,5,2,3,1,1,0,0,0
S01011156,Occupancy rating +1,72,25,7,18,43,2,35,10,18,7,6,2,4,4,1,0,1,2
S01011156,Occupancy rating 0,22,2,0,2,17,0,13,1,11,1,4,2,2,3,1,0,0,2
S01011156,Occupancy rating -1 or less,3,0,0,0,2,0,1,0,1,0,1,0,1,1,1,0,0,0
S01011157,All households,284,94,42,52,185,41,133,72,38,23,11,8,3,5,2,0,0,3
S01011157,Occupancy rating +2 or more,174,63,26,37,109,32,73,55,10,8,4,3,1,2,1,0,0,1
S01011157,Occupancy rating +1,85,26,13,13,58,9,44,14,20,10,5,4,1,1,1,0,0,0
S01011157,Occupancy rating 0,24,5,3,2,17,0,15,3,7,5,2,1,1,2,0,0,0,2
S01011157,Occupancy rating -1 or less,1,0,0,0,1,0,1,0,1,0,0,0,0,0,0,0,0,0
S01011158,All households,233,60,42,18,165,44,106,61,22,23,15,10,5,8,2,0,2,4
S01011158,Occupancy rating +2 or more,196,50,37,13,141,41,89,60,15,14,11,6,5,5,1,0,1,3
S01011158,Occupancy rating +1,24,6,3,3,17,3,12,1,5,6,2,2,0,1,0,0,0,1
S01011158,Occupancy rating 0,12,4,2,2,6,0,5,0,2,3,1,1,0,2,1,0,1,0
S01011158,Occupancy rating -1 or less,1,0,0,0,1,0,0,0,0,0,1,1,0,0,0,0,0,0
S01011159,All households,300,149,80,69,144,30,94,46,31,17,20,14,6,7,2,0,1,4
S01011159,Occupancy rating +2 or more,107,43,29,14,63,21,41,27,9,5,1,1,0,1,0,0,1,0
S01011159,Occupancy rating +1,110,71,39,32,38,7,29,15,8,6,2,1,1,1,0,0,0,1
S01011159,Occupancy rating 0,65,25,8,17,38,2,21,4,11,6,15,11,4,2,1,0,0,1
S01011159,Occupancy rating -1 or less,18,10,4,6,5,0,3,0,3,0,2,1,1,3,1,0,0,2
S01011160,All households,393,108,44,64,268,34,191,83,80,28,43,32,11,17,5,0,0,12
S01011160,Occupancy rating +2 or more,169,50,26,24,116,28,87,54,19,14,1,1,0,3,1,0,0,2
S01011160,Occupancy rating +1,100,32,9,23,66,6,50,22,24,4,10,6,4,2,0,0,0,2
S01011160,Occupancy rating 0,98,19,8,11,73,0,47,7,31,9,26,21,5,6,1,0,0,5
S01011160,Occupancy rating -1 or less,26,7,1,6,13,0,7,0,6,1,6,4,2,6,3,0,0,3
S01011161,All households,269,68,29,39,187,28,116,47,56,13,43,27,16,14,5,0,0,9
S01011161,Occupancy rating +2 or more,107,27,10,17,78,19,50,30,15,5,9,6,3,2,1,0,0,1
S01011161,Occupancy rating +1,90,39,19,20,48,9,30,17,11,2,9,4,5,3,1,0,0,2
S01011161,Occupancy rating 0,60,2,0,2,53,0,31,0,26,5,22,14,8,5,0,0,0,5
S01011161,Occupancy rating -1 or less,12,0,0,0,8,0,5,0,4,1,3,3,0,4,3,0,0,1
S01011162,All households,187,36,16,20,138,15,86,36,37,13,37,28,9,13,6,0,1,6
S01011162,Occupancy rating +2 or more,106,22,11,11,82,12,61,31,21,9,9,8,1,2,1,0,0,1
S01011162,Occupancy rating +1,32,7,2,5,22,1,14,5,7,2,7,1,6,3,1,0,1,1
S01011162,Occupancy rating 0,41,7,3,4,29,2,10,0,8,2,17,15,2,5,2,0,0,3
S01011162,Occupancy rating -1 or less,8,0,0,0,5,0,1,0,1,0,4,4,0,3,2,0,0,1
S01011163,All households,352,113,38,75,220,22,146,66,53,27,52,34,18,19,5,0,4,10
S01011163,Occupancy rating +2 or more,98,32,7,25,64,13,47,37,4,6,4,1,3,2,1,0,1,0
S01011163,Occupancy rating +1,113,46,15,31,66,7,49,24,16,9,10,8,2,1,0,0,0,1
S01011163,Occupancy rating 0,114,34,16,18,69,1,40,4,25,11,28,18,10,11,2,0,3,6
S01011163,Occupancy rating -1 or less,27,1,0,1,21,1,10,1,8,1,10,7,3,5,2,0,0,3
S01011164,All households,282,70,22,48,201,19,150,54,77,19,32,28,4,11,3,0,1,7
S01011164,Occupancy rating +2 or more,154,41,20,21,107,13,92,39,44,9,2,1,1,6,3,0,0,3
S01011164,Occupancy rating +1,77,24,1,23,52,5,41,15,17,9,6,6,0,1,0,0,0,1
S01011164,Occupancy rating 0,43,4,1,3,36,0,15,0,14,1,21,19,2,3,0,0,1,2
S01011164,Occupancy rating -1 or less,8,1,0,1,6,1,2,0,2,0,3,2,1,1,0,0,0,1
S01011165,All households,356,124,52,72,220,30,131,53,54,24,59,36,23,12,2,0,0,10
S01011165,Occupancy rating +2 or more,71,27,12,15,43,8,32,22,6,4,3,0,3,1,0,0,0,1
S01011165,Occupancy rating +1,150,68,27,41,80,21,52,27,17,8,7,2,5,2,0,0,0,2
S01011165,Occupancy rating 0,99,25,11,14,69,1,34,3,22,9,34,25,9,5,0,0,0,5
S01011165,Occupancy rating -1 or less,36,4,2,2,28,0,13,1,9,3,15,9,6,4,2,0,0,2
S01011166,All households,229,60,39,21,165,33,116,57,44,15,16,10,6,4,3,0,0,1
S01011166,Occupancy rating +2 or more,157,45,29,16,110,26,80,46,25,9,4,2,2,2,1,0,0,1
S01011166,Occupancy rating +1,51,14,9,5,36,7,25,9,13,3,4,2,2,1,1,0,0,0
S01011166,Occupancy rating 0,18,1,1,0,17,0,10,1,6,3,7,5,2,0,0,0,0,0
S01011166,Occupancy rating -1 or less,3,0,0,0,2,0,1,1,0,0,1,1,0,1,1,0,0,0
S01011167,All households,279,57,25,32,213,42,165,91,54,20,6,2,4,9,0,0,0,9
S01011167,Occupancy rating +2 or more,225,38,19,19,180,39,138,85,40,13,3,1,2,7,0,0,0,7
S01011167,Occupancy rating +1,28,10,3,7,17,3,13,3,6,4,1,1,0,1,0,0,0,1
S01011167,Occupancy rating 0,19,6,1,5,12,0,10,1,7,2,2,0,2,1,0,0,0,1
S01011167,Occupancy rating -1 or less,7,3,2,1,4,0,4,2,1,1,0,0,0,0,0,0,0,0
S01011168,All households,355,93,42,51,246,38,188,88,74,26,20,10,10,16,4,0,1,11
S01011168,Occupancy rating +2 or more,261,53,25,28,200,35,155,80,54,21,10,4,6,8,1,0,1,6
S01011168,Occupancy rating +1,60,27,14,13,29,2,23,7,13,3,4,3,1,4,1,0,0,3
S01011168,Occupancy rating 0,27,11,3,8,14,1,9,1,6,2,4,2,2,2,1,0,0,1
S01011168,Occupancy rating -1 or less,7,2,0,2,3,0,1,0,1,0,2,1,1,2,1,0,0,1
S01011169,All households,346,57,11,46,269,15,228,82,134,12,26,22,4,20,7,0,1,12
S01011169,Occupancy rating +2 or more,207,31,8,23,169,9,145,53,82,10,15,13,2,7,4,0,0,3
S01011169,Occupancy rating +1,77,17,3,14,57,5,48,17,29,2,4,3,1,3,3,0,0,0
S01011169,Occupancy rating 0,48,8,0,8,36,1,29,11,18,0,6,5,1,4,0,0,0,4
S01011169,Occupancy rating -1 or less,14,1,0,1,7,0,6,1,5,0,1,1,0,6,0,0,1,5
S01011170,All households,400,119,47,72,262,35,203,100,77,26,24,15,9,19,3,0,1,15
S01011170,Occupancy rating +2 or more,263,65,28,37,187,27,151,87,46,18,9,7,2,11,1,0,1,9
S01011170,Occupancy rating +1,78,35,12,23,39,7,25,11,12,2,7,2,5,4,0,0,0,4
S01011170,Occupancy rating 0,43,15,4,11,26,1,18,1,12,5,7,6,1,2,1,0,0,1
S01011170,Occupancy rating -1 or less,16,4,3,1,10,0,9,1,7,1,1,0,1,2,1,0,0,1
S01011171,All households,409,138,72,66,249,53,178,87,58,33,18,7,11,22,7,0,3,12
S01011171,Occupancy rating +2 or more,274,78,44,34,185,45,134,76,31,27,6,0,6,11,1,0,3,7
S01011171,Occupancy rating +1,61,28,11,17,28,6,18,2,12,4,4,2,2,5,5,0,0,0
S01011171,Occupancy rating 0,55,26,14,12,24,2,15,6,9,0,7,5,2,5,1,0,0,4
S01011171,Occupancy rating -1 or less,19,6,3,3,12,0,11,3,6,2,1,0,1,1,0,0,0,1
S01011172,All households,339,117,57,60,204,48,134,68,49,17,22,7,15,18,9,0,1,8
S01011172,Occupancy rating +2 or more,208,67,38,29,130,43,78,50,18,10,9,0,9,11,7,0,1,3
S01011172,Occupancy rating +1,65,24,11,13,39,3,30,11,14,5,6,5,1,2,1,0,0,1
S01011172,Occupancy rating 0,46,20,4,16,22,2,15,3,10,2,5,1,4,4,1,0,0,3
S01011172,Occupancy rating -1 or less,20,6,4,2,13,0,11,4,7,0,2,1,1,1,0,0,0,1
S01011173,All households,224,61,45,16,156,45,100,41,47,12,11,6,5,7,3,0,0,4
S01011173,Occupancy rating +2 or more,151,35,29,6,111,40,66,34,25,7,5,1,4,5,3,0,0,2
S01011173,Occupancy rating +1,33,11,6,5,21,2,16,4,8,4,3,2,1,1,0,0,0,1
S01011173,Occupancy rating 0,32,12,8,4,19,3,13,3,9,1,3,3,0,1,0,0,0,1
S01011173,Occupancy rating -1 or less,8,3,2,1,5,0,5,0,5,0,0,0,0,0,0,0,0,0
S01011174,All households,219,83,49,34,125,34,76,45,19,12,15,12,3,11,0,0,3,8
S01011174,Occupancy rating +2 or more,157,56,38,18,92,33,57,37,12,8,2,1,1,9,0,0,3,6
S01011174,Occupancy rating +1,27,9,5,4,17,1,12,5,3,4,4,3,1,1,0,0,0,1
S01011174,Occupancy rating 0,20,10,4,6,10,0,6,3,3,0,4,4,0,0,0,0,0,0
S01011174,Occupancy rating -1 or less,15,8,2,6,6,0,1,0,1,0,5,4,1,1,0,0,0,1
S01011175,All households,259,115,68,47,139,34,83,32,35,16,22,16,6,5,3,0,1,1
S01011175,Occupancy rating +2 or more,95,38,21,17,56,21,35,21,8,6,0,0,0,1,1,0,0,0
S01011175,Occupancy rating +1,86,42,25,17,43,10,23,7,9,7,10,8,2,1,0,0,0,1
S01011175,Occupancy rating 0,62,31,18,13,30,3,19,4,12,3,8,5,3,1,0,0,1,0
S01011175,Occupancy rating -1 or less,16,4,4,0,10,0,6,0,6,0,4,3,1,2,2,0,0,0
S01011176,All households,274,105,65,40,159,53,95,56,26,13,11,7,4,10,2,0,2,6
S01011176,Occupancy rating +2 or more,197,76,49,27,116,43,67,43,15,9,6,3,3,5,1,0,1,3
S01011176,Occupancy rating +1,50,25,15,10,22,7,13,7,5,1,2,1,1,3,1,0,1,1
S01011176,Occupancy rating 0,20,3,1,2,16,2,12,5,6,1,2,2,0,1,0,0,0,1
S01011176,Occupancy rating -1 or less,7,1,0,1,5,1,3,1,0,2,1,1,0,1,0,0,0,1
S01011177,All households,402,150,87,63,231,58,139,74,49,16,34,18,16,21,6,0,1,14
S01011177,Occupancy rating +2 or more,221,82,52,30,131,43,81,55,16,10,7,1,6,8,3,0,0,5
S01011177,Occupancy rating +1,93,35,13,22,54,13,32,9,20,3,9,6,3,4,0,0,0,4
S01011177,Occupancy rating 0,67,26,16,10,37,2,21,8,10,3,14,8,6,4,1,0,0,3
S01011177,Occupancy rating -1 or less,21,7,6,1,9,0,5,2,3,0,4,3,1,5,2,0,1,2
S01011178,All households,206,43,20,23,154,17,107,39,58,10,30,18,12,9,3,0,1,5
S01011178,Occupancy rating +2 or more,112,23,12,11,84,12,66,36,22,8,6,4,2,5,1,0,1,3
S01011178,Occupancy rating +1,55,13,5,8,40,5,23,3,18,2,12,5,7,2,1,0,0,1
S01011178,Occupancy rating 0,23,4,0,4,19,0,13,0,13,0,6,4,2,0,0,0,0,0
S01011178,Occupancy rating -1 or less,16,3,3,0,11,0,5,0,5,0,6,5,1,2,1,0,0,1
S01011179,All households,272,93,36,57,166,21,107,41,42,24,38,19,19,13,7,0,2,4
S01011179,Occupancy rating +2 or more,78,24,12,12,52,12,37,25,9,3,3,0,3,2,1,0,1,0
S01011179,Occupancy rating +1,99,41,13,28,56,9,34,12,10,12,13,8,5,2,0,0,0,2
S01011179,Occupancy rating 0,68,24,8,16,40,0,25,4,16,5,15,9,6,4,3,0,0,1
S01011179,Occupancy rating -1 or less,27,4,3,1,18,0,11,0,7,4,7,2,5,5,3,0,1,1
S01011180,All households,301,102,45,57,186,26,110,36,50,24,50,35,15,13,4,0,1,8
S01011180,Occupancy rating +2 or more,71,22,6,16,48,14,31,21,7,3,3,1,2,1,0,0,0,1
S01011180,Occupancy rating +1,89,35,10,25,50,2,28,7,13,8,20,11,9,4,1,0,0,3
S01011180,Occupancy rating 0,108,36,23,13,66,7,39,5,23,11,20,16,4,6,2,0,0,4
S01011180,Occupancy rating -1 or less,33,9,6,3,22,3,12,3,7,2,7,7,0,2,1,0,1,0
S01011181,All households,198,46,11,35,148,25,113,59,35,19,10,4,6,4,1,0,0,3
S01011181,Occupancy rating +2 or more,136,27,9,18,106,17,83,47,23,13,6,4,2,3,1,0,0,2
S01011181,Occupancy rating +1,34,11,0,11,23,7,15,7,5,3,1,0,1,0,0,0,0,0
S01011181,Occupancy rating 0,18,8,2,6,9,1,6,1,3,2,2,0,2,1,0,0,0,1
S01011181,Occupancy rating -1 or less,10,0,0,0,10,0,9,4,4,1,1,0,1,0,0,0,0,0
S01011182,All households,166,26,8,18,132,17,111,60,29,22,4,1,3,8,3,0,1,4
S01011182,Occupancy rating +2 or more,117,15,3,12,96,14,79,44,21,14,3,1,2,6,2,0,0,4
S01011182,Occupancy rating +1,39,10,5,5,29,2,26,16,4,6,1,0,1,0,0,0,0,0
S01011182,Occupancy rating 0,7,1,0,1,5,1,4,0,2,2,0,0,0,1,1,0,0,0
S01011182,Occupancy rating -1 or less,3,0,0,0,2,0,2,0,2,0,0,0,0,1,0,0,1,0
S01011183,All households,226,50,24,26,163,20,118,50,43,25,25,15,10,13,8,0,1,4
S01011183,Occupancy rating +2 or more,132,31,17,14,94,12,77,40,23,14,5,4,1,7,5,0,0,2
S01011183,Occupancy rating +1,57,18,7,11,36,6,20,10,6,4,10,4,6,3,2,0,0,1
S01011183,Occupancy rating 0,24,1,0,1,21,1,14,0,10,4,6,4,2,2,0,0,1,1
S01011183,Occupancy rating -1 or less,13,0,0,0,12,1,7,0,4,3,4,3,1,1,1,0,0,0
S01011184,All households,307,40,20,20,256,38,196,70,104,22,22,11,11,11,2,0,0,9
S01011184,Occupancy rating +2 or more,252,36,18,18,208,36,156,67,74,15,16,8,8,8,2,0,0,6
S01011184,Occupancy rating +1,36,2,1,1,32,2,26,3,19,4,4,2,2,2,0,0,0,2
S01011184,Occupancy rating 0,14,1,0,1,12,0,12,0,10,2,0,0,0,1,0,0,0,1
S01011184,Occupancy rating -1 or less,5,1,1,0,4,0,2,0,1,1,2,1,1,0,0,0,0,0
S01011185,All households,296,74,51,23,212,42,148,64,46,38,22,9,13,10,4,0,0,6
S01011185,Occupancy rating +2 or more,159,48,34,14,109,28,77,46,16,15,4,1,3,2,1,0,0,1
S01011185,Occupancy rating +1,87,22,16,6,63,10,44,17,11,16,9,3,6,2,1,0,0,1
S01011185,Occupancy rating 0,39,2,1,1,32,3,22,1,15,6,7,3,4,5,2,0,0,3
S01011185,Occupancy rating -1 or less,11,2,0,2,8,1,5,0,4,1,2,2,0,1,0,0,0,1
S01011186,All households,456,178,98,80,259,53,161,74,54,33,45,29,16,19,9,0,1,9
S01011186,Occupancy rating +2 or more,157,43,21,22,112,35,73,43,21,9,4,2,2,2,0,0,0,2
S01011186,Occupancy rating +1,141,64,39,25,74,16,49,21,15,13,9,5,4,3,1,0,0,2
S01011186,Occupancy rating 0,111,46,20,26,57,1,32,9,13,10,24,16,8,8,3,0,1,4
S01011186,Occupancy rating -1 or less,47,25,18,7,16,1,7,1,5,1,8,6,2,6,5,0,0,1
S01011187,All households,287,65,29,36,217,35,168,74,46,48,14,9,5,5,1,0,0,4
S01011187,Occupancy rating +2 or more,173,40,23,17,132,29,103,60,16,27,0,0,0,1,0,0,0,1
S01011187,Occupancy rating +1,67,9,3,6,56,6,44,10,18,16,6,3,3,2,0,0,0,2
S01011187,Occupancy rating 0,40,13,2,11,25,0,18,4,10,4,7,6,1,2,1,0,0,1
S01011187,Occupancy rating -1 or less,7,3,1,2,4,0,3,0,2,1,1,0,1,0,0,0,0,0
S01011188,All households,442,163,71,92,266,37,173,69,76,28,56,38,18,13,6,0,1,6
S01011188,Occupancy rating +2 or more,173,69,33,36,102,31,66,48,14,4,5,2,3,2,1,0,0,1
S01011188,Occupancy rating +1,116,26,11,15,86,4,61,15,30,16,21,14,7,4,0,0,1,3
S01011188,Occupancy rating 0,129,62,26,36,63,2,35,6,23,6,26,20,6,4,3,0,0,1
S01011188,Occupancy rating -1 or less,24,6,1,5,15,0,11,0,9,2,4,2,2,3,2,0,0,1
S01011189,All households,356,110,39,71,231,34,153,72,54,27,44,30,14,15,6,0,0,9
S01011189,Occupancy rating +2 or more,150,42,17,25,106,19,80,35,32,13,7,4,3,2,2,0,0,0
S01011189,Occupancy rating +1,109,43,12,31,63,11,42,30,6,6,10,7,3,3,1,0,0,2
S01011189,Occupancy rating 0,71,22,9,13,45,2,25,4,13,8,18,13,5,4,1,0,0,3
S01011189,Occupancy rating -1 or less,26,3,1,2,17,2,6,3,3,0,9,6,3,6,2,0,0,4
S01011190,All households,288,101,55,46,177,17,119,54,46,19,41,25,16,10,4,0,1,5
S01011190,Occupancy rating +2 or more,82,30,15,15,52,6,37,21,10,6,9,3,6,0,0,0,0,0
S01011190,Occupancy rating +1,98,36,14,22,60,7,44,22,14,8,9,4,5,2,0,0,1,1
S01011190,Occupancy rating 0,79,28,21,7,47,4,29,10,14,5,14,12,2,4,1,0,0,3
S01011190,Occupancy rating -1 or less,29,7,5,2,18,0,9,1,8,0,9,6,3,4,3,0,0,1
S01011191,All households,241,71,32,39,160,18,104,47,41,16,38,27,11,10,7,0,0,3
S01011191,Occupancy rating +2 or more,68,28,10,18,39,8,29,21,6,2,2,1,1,1,1,0,0,0
S01011191,Occupancy rating +1,101,31,13,18,67,9,43,24,11,8,15,9,6,3,2,0,0,1
S01011191,Occupancy rating 0,46,8,6,2,36,1,20,2,17,1,15,12,3,2,0,0,0,2
S01011191,Occupancy rating -1 or less,26,4,3,1,18,0,12,0,7,5,6,5,1,4,4,0,0,0
S01011192,All households,290,70,21,49,206,16,143,60,61,22,47,34,13,14,9,0,1,4
S01011192,Occupancy rating +2 or more,100,37,10,27,62,7,49,45,4,0,6,2,4,1,0,0,0,1
S01011192,Occupancy rating +1,105,26,9,17,75,7,51,14,26,11,17,12,5,4,1,0,1,2
S01011192,Occupancy rating 0,70,6,1,5,59,2,39,1,30,8,18,15,3,5,4,0,0,1
S01011192,Occupancy rating -1 or less,15,1,1,0,10,0,4,0,1,3,6,5,1,4,4,0,0,0
S01011193,All households,286,81,16,65,189,7,127,47,63,17,55,37,18,16,8,0,0,8
S01011193,Occupancy rating +2 or more,113,39,5,34,73,5,51,36,12,3,17,10,7,1,0,0,0,1
S01011193,Occupancy rating +1,91,28,7,21,61,2,41,9,23,9,18,14,4,2,1,0,0,1
S01011193,Occupancy rating 0,67,11,2,9,47,0,28,2,22,4,19,13,6,9,5,0,0,4
S01011193,Occupancy rating -1 or less,15,3,2,1,8,0,7,0,6,1,1,0,1,4,2,0,0,2
S01011194,All households,302,83,20,63,202,13,121,48,54,19,68,52,16,17,15,0,0,2
S01011194,Occupancy rating +2 or more,105,38,7,31,65,6,48,34,9,5,11,8,3,2,2,0,0,0
S01011194,Occupancy rating +1,97,29,4,25,65,4,36,8,22,6,25,19,6,3,2,0,0,1
S01011194,Occupancy rating 0,74,9,4,5,55,1,31,5,19,7,23,17,6,10,9,0,0,1
S01011194,Occupancy rating -1 or less,26,7,5,2,17,2,6,1,4,1,9,8,1,2,2,0,0,0
S01011195,All households,318,84,20,64,222,16,143,59,62,22,63,49,14,12,8,0,0,4
S01011195,Occupancy rating +2 or more,151,68,15,53,83,12,59,45,11,3,12,9,3,0,0,0,0,0
S01011195,Occupancy rating +1,82,5,1,4,72,2,51,7,32,12,19,12,7,5,3,0,0,2
S01011195,Occupancy rating 0,68,11,4,7,51,2,26,6,13,7,23,20,3,6,4,0,0,2
S01011195,Occupancy rating -1 or less,17,0,0,0,16,0,7,1,6,0,9,8,1,1,1,0,0,0
S01011196,All households,409,144,62,82,248,16,163,78,63,22,69,52,17,17,10,0,1,6
S01011196,Occupancy rating +2 or more,126,40,15,25,85,7,69,46,15,8,9,5,4,1,1,0,0,0
S01011196,Occupancy rating +1,112,27,12,15,81,5,53,24,21,8,23,16,7,4,0,0,1,3
S01011196,Occupancy rating 0,113,54,29,25,51,2,30,6,19,5,19,15,4,8,5,0,0,3
S01011196,Occupancy rating -1 or less,58,23,6,17,31,2,11,2,8,1,18,16,2,4,4,0,0,0
S01011197,All households,348,93,23,70,241,17,157,61,68,28,67,47,20,14,9,0,0,5
S01011197,Occupancy rating +2 or more,129,49,7,42,77,10,54,36,9,9,13,9,4,3,2,0,0,1
S01011197,Occupancy rating +1,101,23,6,17,76,2,53,21,26,6,21,13,8,2,1,0,0,1
S01011197,Occupancy rating 0,94,17,7,10,71,2,40,3,25,12,29,22,7,6,4,0,0,2
S01011197,Occupancy rating -1 or less,24,4,3,1,17,3,10,1,8,1,4,3,1,3,2,0,0,1
S01011198,All households,241,60,25,35,165,15,110,39,48,23,40,30,10,16,11,0,0,5
S01011198,Occupancy rating +2 or more,95,36,15,21,57,10,42,30,10,2,5,2,3,2,1,0,0,1
S01011198,Occupancy rating +1,67,11,2,9,51,1,33,7,14,12,17,12,5,5,4,0,0,1
S01011198,Occupancy rating 0,55,13,8,5,38,4,24,2,17,5,10,9,1,4,1,0,0,3
S01011198,Occupancy rating -1 or less,24,0,0,0,19,0,11,0,7,4,8,7,1,5,5,0,0,0
S01011199,All households,342,105,29,76,229,21,157,67,64,26,51,34,17,8,5,0,1,2
S01011199,Occupancy rating +2 or more,112,30,8,22,79,13,57,43,5,9,9,4,5,3,2,0,0,1
S01011199,Occupancy rating +1,111,35,6,29,73,6,53,21,25,7,14,11,3,3,2,0,0,1
S01011199,Occupancy rating 0,88,32,11,21,55,2,30,3,19,8,23,17,6,1,1,0,0,0
S01011199,Occupancy rating -1 or less,31,8,4,4,22,0,17,0,15,2,5,2,3,1,0,0,1,0
S01011200,All households,356,129,37,92,217,31,150,75,53,22,36,31,5,10,5,0,1,4
S01011200,Occupancy rating +2 or more,119,33,15,18,85,19,58,39,12,7,8,7,1,1,1,0,0,0
S01011200,Occupancy rating +1,106,41,9,32,63,10,46,25,14,7,7,5,2,2,1,0,0,1
S01011200,Occupancy rating 0,101,40,12,28,57,2,39,8,24,7,16,14,2,4,1,0,1,2
S01011200,Occupancy rating -1 or less,30,15,1,14,12,0,7,3,3,1,5,5,0,3,2,0,0,1
S01011201,All households,267,90,52,38,165,19,125,56,47,22,21,9,12,12,5,0,0,7
S01011201,Occupancy rating +2 or more,124,41,22,19,81,13,58,44,7,7,10,4,6,2,1,0,0,1
S01011201,Occupancy rating +1,71,21,9,12,47,3,40,9,22,9,4,2,2,3,2,0,0,1
S01011201,Occupancy rating 0,57,20,16,4,31,3,22,3,15,4,6,2,4,6,1,0,0,5
S01011201,Occupancy rating -1 or less,15,8,5,3,6,0,5,0,3,2,1,1,0,1,1,0,0,0
S01011202,All households,390,127,41,86,250,30,158,71,61,26,62,49,13,13,6,1,1,5
S01011202,Occupancy rating +2 or more,118,34,9,25,82,12,65,41,16,8,5,2,3,2,0,0,0,2
S01011202,Occupancy rating +1,130,56,18,38,70,13,49,21,18,10,8,7,1,4,0,1,1,2
S01011202,Occupancy rating 0,100,27,11,16,69,3,32,7,19,6,34,30,4,4,3,0,0,1
S01011202,Occupancy rating -1 or less,42,10,3,7,29,2,12,2,8,2,15,10,5,3,3,0,0,0
S01011203,All households,364,125,64,61,224,30,157,54,75,28,37,30,7,15,8,0,2,5
S01011203,Occupancy rating +2 or more,99,32,14,18,67,10,51,27,17,7,6,4,2,0,0,0,0,0
S01011203,Occupancy rating +1,141,60,30,30,78,13,55,20,25,10,10,8,2,3,0,0,1,2
S01011203,Occupancy rating 0,103,27,16,11,67,6,45,7,29,9,16,13,3,9,6,0,1,2
S01011203,Occupancy rating -1 or less,21,6,4,2,12,1,6,0,4,2,5,5,0,3,2,0,0,1
S01011204,All households,235,55,29,26,172,28,126,53,51,22,18,9,9,8,1,0,0,7
S01011204,Occupancy rating +2 or more,155,34,16,18,117,24,87,43,30,14,6,2,4,4,1,0,0,3
S01011204,Occupancy rating +1,54,15,9,6,37,3,29,8,15,6,5,2,3,2,0,0,0,2
S01011204,Occupancy rating 0,23,6,4,2,16,0,9,2,5,2,7,5,2,1,0,0,0,1
S01011204,Occupancy rating -1 or less,3,0,0,0,2,1,1,0,1,0,0,0,0,1,0,0,0,1
S01011205,All households,237,24,1,23,204,3,172,38,120,14,29,25,4,9,8,0,0,1
S01011205,Occupancy rating +2 or more,162,18,0,18,138,3,128,33,85,10,7,6,1,6,5,0,0,1
S01011205,Occupancy rating +1,40,5,0,5,35,0,31,5,24,2,4,3,1,0,0,0,0,0
S01011205,Occupancy rating 0,27,1,1,0,25,0,11,0,9,2,14,12,2,1,1,0,0,0
S01011205,Occupancy rating -1 or less,8,0,0,0,6,0,2,0,2,0,4,4,0,2,2,0,0,0
S01011206,All households,264,43,13,30,210,10,168,53,86,29,32,25,7,11,7,0,0,4
S01011206,Occupancy rating +2 or more,128,23,4,19,102,8,89,41,37,11,5,3,2,3,2,0,0,1
S01011206,Occupancy rating +1,80,13,5,8,63,2,49,11,28,10,12,9,3,4,3,0,0,1
S01011206,Occupancy rating 0,39,3,2,1,32,0,22,1,15,6,10,8,2,4,2,0,0,2
S01011206,Occupancy rating -1 or less,17,4,2,2,13,0,8,0,6,2,5,5,0,0,0,0,0,0
S01011207,All households,326,108,47,61,208,15,164,58,77,29,29,15,14,10,3,0,0,7
S01011207,Occupancy rating +2 or more,139,26,10,16,107,6,90,33,44,13,11,7,4,6,2,0,0,4
S01011207,Occupancy rating +1,74,19,5,14,53,3,41,17,13,11,9,4,5,2,1,0,0,1
S01011207,Occupancy rating 0,73,38,20,18,34,6,22,7,12,3,6,3,3,1,0,0,0,1
S01011207,Occupancy rating -1 or less,40,25,12,13,14,0,11,1,8,2,3,1,2,1,0,0,0,1
S01011208,All households,345,70,22,48,257,21,211,71,104,36,25,15,10,18,10,1,0,7
S01011208,Occupancy rating +2 or more,170,17,3,14,143,9,124,46,58,20,10,4,6,10,7,0,0,3
S01011208,Occupancy rating +1,96,32,5,27,62,8,49,23,20,6,5,3,2,2,0,0,0,2
S01011208,Occupancy rating 0,64,17,12,5,43,3,32,2,22,8,8,6,2,4,1,1,0,2
S01011208,Occupancy rating -1 or less,15,4,2,2,9,1,6,0,4,2,2,2,0,2,2,0,0,0
S01011209,All households,283,88,37,51,187,19,118,50,50,18,50,31,19,8,2,0,1,5
S01011209,Occupancy rating +2 or more,88,22,8,14,63,12,47,30,11,6,4,1,3,3,0,0,1,2
S01011209,Occupancy rating +1,85,30,7,23,54,3,38,19,15,4,13,7,6,1,1,0,0,0
S01011209,Occupancy rating 0,89,34,21,13,53,2,24,0,18,6,27,17,10,2,0,0,0,2
S01011209,Occupancy rating -1 or less,21,2,1,1,17,2,9,1,6,2,6,6,0,2,1,0,0,1
S01011210,All households,272,50,18,32,212,25,169,61,82,26,18,12,6,10,5,0,0,5
S01011210,Occupancy rating +2 or more,198,20,8,12,173,23,141,52,68,21,9,6,3,5,1,0,0,4
S01011210,Occupancy rating +1,23,7,1,6,14,1,9,5,2,2,4,1,3,2,1,0,0,1
S01011210,Occupancy rating 0,40,21,9,12,19,1,13,4,6,3,5,5,0,0,0,0,0,0
S01011210,Occupancy rating -1 or less,11,2,0,2,6,0,6,0,6,0,0,0,0,3,3,0,0,0
S01011211,All households,252,35,13,22,206,14,163,60,83,20,29,18,11,11,7,0,0,4
S01011211,Occupancy rating +2 or more,150,18,4,14,131,7,114,45,56,13,10,5,5,1,0,0,0,1
S01011211,Occupancy rating +1,46,9,4,5,35,6,23,10,12,1,6,5,1,2,1,0,0,1
S01011211,Occupancy rating 0,42,7,5,2,32,1,22,5,11,6,9,6,3,3,1,0,0,2
S01011211,Occupancy rating -1 or less,14,1,0,1,8,0,4,0,4,0,4,2,2,5,5,0,0,0
S01011212,All households,213,35,14,21,168,19,99,42,39,18,50,41,9,10,5,0,0,5
S01011212,Occupancy rating +2 or more,56,9,6,3,46,9,35,30,3,2,2,0,2,1,0,0,0,1
S01011212,Occupancy rating +1,73,25,7,18,44,10,28,11,8,9,6,3,3,4,2,0,0,2
S01011212,Occupancy rating 0,53,0,0,0,52,0,22,0,16,6,30,27,3,1,0,0,0,1
S01011212,Occupancy rating -1 or less,31,1,1,0,26,0,14,1,12,1,12,11,1,4,3,0,0,1
S01011213,All households,421,89,30,59,305,30,179,76,75,28,96,75,21,27,10,0,0,17
S01011213,Occupancy rating +2 or more,138,42,14,28,89,21,61,44,15,2,7,3,4,7,3,0,0,4
S01011213,Occupancy rating +1,155,43,16,27,107,8,69,29,23,17,30,24,6,5,2,0,0,3
S01011213,Occupancy rating 0,82,2,0,2,74,1,30,2,23,5,43,33,10,6,2,0,0,4
S01011213,Occupancy rating -1 or less,46,2,0,2,35,0,19,1,14,4,16,15,1,9,3,0,0,6
S01011214,All households,349,80,34,46,249,34,137,42,68,27,78,57,21,20,9,0,1,10
S01011214,Occupancy rating +2 or more,123,41,24,17,81,29,48,33,11,4,4,3,1,1,1,0,0,0
S01011214,Occupancy rating +1,121,29,7,22,86,5,51,7,28,16,30,18,12,6,2,0,1,3
S01011214,Occupancy rating 0,76,8,3,5,59,0,26,1,20,5,33,27,6,9,3,0,0,6
S01011214,Occupancy rating -1 or less,29,2,0,2,23,0,12,1,9,2,11,9,2,4,3,0,0,1
S01011215,All households,260,94,33,61,160,19,94,24,52,18,47,35,12,6,3,0,1,2
S01011215,Occupancy rating +2 or more,50,24,11,13,26,8,18,11,3,4,0,0,0,0,0,0,0,0
S01011215,Occupancy rating +1,80,21,11,10,57,9,30,10,12,8,18,13,5,2,1,0,0,1
S01011215,Occupancy rating 0,86,35,8,27,49,1,28,3,22,3,20,14,6,2,1,0,0,1
S01011215,Occupancy rating -1 or less,44,14,3,11,28,1,18,0,15,3,9,8,1,2,1,0,1,0
S01011216,All households,240,111,30,81,118,10,63,19,38,6,45,28,17,11,8,0,0,3
S01011216,Occupancy rating +2 or more,55,32,13,19,20,5,13,10,3,0,2,1,1,3,1,0,0,2
S01011216,Occupancy rating +1,83,39,10,29,43,3,23,6,15,2,17,10,7,1,1,0,0,0
S01011216,Occupancy rating 0,77,32,4,28,43,1,20,1,16,3,22,16,6,2,2,0,0,0
S01011216,Occupancy rating -1 or less,25,8,3,5,12,1,7,2,4,1,4,1,3,5,4,0,0,1
S01011217,All households,380,152,52,100,205,19,102,34,51,17,84,56,28,23,11,0,0,12
S01011217,Occupancy rating +2 or more,97,58,35,23,37,10,25,16,7,2,2,0,2,2,1,0,0,1
S01011217,Occupancy rating +1,124,41,12,29,77,8,37,15,15,7,32,18,14,6,1,0,0,5
S01011217,Occupancy rating 0,114,42,4,38,63,1,26,3,16,7,36,28,8,9,5,0,0,4
S01011217,Occupancy rating -1 or less,45,11,1,10,28,0,14,0,13,1,14,10,4,6,4,0,0,2
S01011218,All households,282,84,23,61,174,13,91,24,52,15,70,57,13,24,15,0,1,8
S01011218,Occupancy rating +2 or more,78,42,10,32,36,10,21,11,6,4,5,2,3,0,0,0,0,0
S01011218,Occupancy rating +1,91,29,10,19,54,2,34,10,17,7,18,13,5,8,5,0,0,3
S01011218,Occupancy rating 0,79,6,3,3,63,1,28,2,22,4,34,30,4,10,5,0,1,4
S01011218,Occupancy rating -1 or less,34,7,0,7,21,0,8,1,7,0,13,12,1,6,5,0,0,1
S01011219,All households,352,113,40,73,224,19,143,60,59,24,62,41,21,15,8,0,0,7
S01011219,Occupancy rating +2 or more,92,38,15,23,53,12,40,32,7,1,1,0,1,1,0,0,0,1
S01011219,Occupancy rating +1,120,45,16,29,70,4,50,22,19,9,16,7,9,5,2,0,0,3
S01011219,Occupancy rating 0,108,20,5,15,83,3,42,5,24,13,38,28,10,5,2,0,0,3
S01011219,Occupancy rating -1 or less,32,10,4,6,18,0,11,1,9,1,7,6,1,4,4,0,0,0
S01011220,All households,425,160,51,109,247,35,140,49,57,34,72,46,26,18,10,0,0,8
S01011220,Occupancy rating +2 or more,118,50,18,32,64,22,34,23,7,4,8,5,3,4,2,0,0,2
S01011220,Occupancy rating +1,162,77,25,52,80,10,55,24,17,14,15,10,5,5,2,0,0,3
S01011220,Occupancy rating 0,109,26,5,21,80,2,40,2,25,13,38,23,15,3,2,0,0,1
S01011220,Occupancy rating -1 or less,36,7,3,4,23,1,11,0,8,3,11,8,3,6,4,0,0,2
S01011221,All households,449,174,67,107,252,24,157,57,80,20,71,50,21,23,12,0,1,10
S01011221,Occupancy rating +2 or more,106,50,24,26,53,16,32,25,5,2,5,4,1,3,1,0,0,2
S01011221,Occupancy rating +1,198,99,36,63,94,8,67,30,27,10,19,12,7,5,0,0,0,5
S01011221,Occupancy rating 0,108,16,4,12,87,0,46,2,39,5,41,30,11,5,3,0,1,1
S01011221,Occupancy rating -1 or less,37,9,3,6,18,0,12,0,9,3,6,4,2,10,8,0,0,2
S01011222,All households,312,105,56,49,196,29,121,54,50,17,46,24,22,11,6,0,2,3
S01011222,Occupancy rating +2 or more,73,27,12,15,46,13,32,28,3,1,1,0,1,0,0,0,0,0
S01011222,Occupancy rating +1,129,58,34,24,69,11,42,24,12,6,16,8,8,2,0,0,1,1
S01011222,Occupancy rating 0,82,14,8,6,64,4,35,1,25,9,25,13,12,4,1,0,1,2
S01011222,Occupancy rating -1 or less,28,6,2,4,17,1,12,1,10,1,4,3,1,5,5,0,0,0
S01011223,All households,361,109,58,51,233,39,148,73,56,19,46,36,10,19,11,0,1,7
S01011223,Occupancy rating +2 or more,99,33,18,15,60,16,42,26,10,6,2,1,1,6,2,0,1,3
S01011223,Occupancy rating +1,153,53,27,26,96,23,59,38,18,3,14,9,5,4,2,0,0,2
S01011223,Occupancy rating 0,76,14,9,5,59,0,35,7,19,9,24,20,4,3,1,0,0,2
S01011223,Occupancy rating -1 or less,33,9,4,5,18,0,12,2,9,1,6,6,0,6,6,0,0,0
S01011224,All households,350,159,73,86,174,29,103,47,34,22,42,27,15,17,8,0,1,8
S01011224,Occupancy rating +2 or more,88,27,18,9,58,12,39,21,13,5,7,1,6,3,1,0,0,2
S01011224,Occupancy rating +1,116,66,34,32,46,9,31,16,7,8,6,3,3,4,3,0,0,1
S01011224,Occupancy rating 0,118,56,17,39,57,8,27,9,10,8,22,17,5,5,1,0,1,3
S01011224,Occupancy rating -1 or less,28,10,4,6,13,0,6,1,4,1,7,6,1,5,3,0,0,2
S01011225,All households,327,120,43,77,193,22,109,53,35,21,62,40,22,14,8,0,0,6
S01011225,Occupancy rating +2 or more,90,37,16,21,50,13,29,22,4,3,8,5,3,3,0,0,0,3
S01011225,Occupancy rating +1,127,58,20,38,69,8,48,27,11,10,13,10,3,0,0,0,0,0
S01011225,Occupancy rating 0,79,16,5,11,55,1,24,4,13,7,30,15,15,8,5,0,0,3
S01011225,Occupancy rating -1 or less,31,9,2,7,19,0,8,0,7,1,11,10,1,3,3,0,0,0
S01011226,All households,455,150,100,50,293,67,189,81,72,36,37,25,12,12,8,0,0,4
S01011226,Occupancy rating +2 or more,223,56,32,24,164,42,110,58,37,15,12,7,5,3,1,0,0,2
S01011226,Occupancy rating +1,120,45,26,19,74,19,46,16,15,15,9,5,4,1,0,0,0,1
S01011226,Occupancy rating 0,86,43,37,6,38,5,22,4,14,4,11,8,3,5,4,0,0,1
S01011226,Occupancy rating -1 or less,26,6,5,1,17,1,11,3,6,2,5,5,0,3,3,0,0,0
S01011227,All households,397,211,56,155,178,25,104,58,31,15,49,34,15,8,4,0,0,4
S01011227,Occupancy rating +2 or more,116,46,15,31,68,16,48,31,13,4,4,3,1,2,0,0,0,2
S01011227,Occupancy rating +1,103,55,15,40,47,6,31,20,5,6,10,5,5,1,1,0,0,0
S01011227,Occupancy rating 0,141,89,23,66,49,2,23,7,11,5,24,19,5,3,1,0,0,2
S01011227,Occupancy rating -1 or less,37,21,3,18,14,1,2,0,2,0,11,7,4,2,2,0,0,0
S01011228,All households,450,249,116,133,188,33,107,55,40,12,48,33,15,13,5,0,0,8
S01011228,Occupancy rating +2 or more,100,42,24,18,54,13,37,19,13,5,4,1,3,4,2,0,0,2
S01011228,Occupancy rating +1,145,78,26,52,64,15,36,24,7,5,13,7,6,3,0,0,0,3
S01011228,Occupancy rating 0,154,93,44,49,58,3,30,11,17,2,25,21,4,3,1,0,0,2
S01011228,Occupancy rating -1 or less,51,36,22,14,12,2,4,1,3,0,6,4,2,3,2,0,0,1
S01011229,All households,286,137,50,87,142,24,60,28,25,7,58,41,17,7,1,0,1,5
S01011229,Occupancy rating +2 or more,65,37,13,24,26,10,14,7,5,2,2,1,1,2,0,0,0,2
S01011229,Occupancy rating +1,102,53,21,32,49,10,29,18,9,2,10,8,2,0,0,0,0,0
S01011229,Occupancy rating 0,94,37,13,24,54,3,15,3,10,2,36,25,11,3,0,0,1,2
S01011229,Occupancy rating -1 or less,25,10,3,7,13,1,2,0,1,1,10,7,3,2,1,0,0,1
S01011230,All households,500,283,81,202,190,16,94,42,37,15,80,48,32,27,14,0,0,13
S01011230,Occupancy rating +2 or more,62,40,9,31,21,4,13,10,2,1,4,2,2,1,0,0,0,1
S01011230,Occupancy rating +1,245,177,50,127,63,6,40,24,11,5,17,9,8,5,2,0,0,3
S01011230,Occupancy rating 0,150,54,18,36,84,5,31,6,17,8,48,32,16,12,5,0,0,7
S01011230,Occupancy rating -1 or less,43,12,4,8,22,1,10,2,7,1,11,5,6,9,7,0,0,2
S01011231,All households,298,113,60,53,178,19,102,41,39,22,57,33,24,7,3,0,1,3
S01011231,Occupancy rating +2 or more,49,25,13,12,23,4,16,13,3,0,3,1,2,1,0,0,0,1
S01011231,Occupancy rating +1,107,47,26,21,59,10,39,23,9,7,10,8,2,1,0,0,0,1
S01011231,Occupancy rating 0,110,32,16,16,75,2,38,5,20,13,35,21,14,3,1,0,1,1
S01011231,Occupancy rating -1 or less,32,9,5,4,21,3,9,0,7,2,9,3,6,2,2,0,0,0
S01011232,All households,513,279,54,225,225,29,162,98,47,17,34,26,8,9,2,0,0,7
S01011232,Occupancy rating +2 or more,91,26,6,20,65,9,53,35,11,7,3,1,2,0,0,0,0,0
S01011232,Occupancy rating +1,178,110,27,83,66,13,44,31,5,8,9,5,4,2,0,0,0,2
S01011232,Occupancy rating 0,171,98,13,85,71,5,51,28,21,2,15,14,1,2,0,0,0,2
S01011232,Occupancy rating -1 or less,73,45,8,37,23,2,14,4,10,0,7,6,1,5,2,0,0,3
S01011233,All households,158,51,21,30,101,9,70,28,27,15,22,17,5,6,4,0,1,1
S01011233,Occupancy rating +2 or more,71,23,11,12,46,8,36,17,9,10,2,1,1,2,1,0,0,1
S01011233,Occupancy rating +1,43,10,3,7,33,0,21,9,11,1,12,8,4,0,0,0,0,0
S01011233,Occupancy rating 0,33,14,5,9,16,0,11,2,5,4,5,5,0,3,2,0,1,0
S01011233,Occupancy rating -1 or less,11,4,2,2,6,1,2,0,2,0,3,3,0,1,1,0,0,0
S01011234,All households,456,155,47,108,276,12,160,57,78,25,104,84,20,25,9,0,2,14
S01011234,Occupancy rating +2 or more,143,73,28,45,68,8,52,40,8,4,8,2,6,2,1,0,0,1
S01011234,Occupancy rating +1,163,53,11,42,98,1,61,17,27,17,36,26,10,12,2,0,2,8
S01011234,Occupancy rating 0,120,25,7,18,88,2,38,0,35,3,48,46,2,7,2,0,0,5
S01011234,Occupancy rating -1 or less,30,4,1,3,22,1,9,0,8,1,12,10,2,4,4,0,0,0
S01011235,All households,195,90,22,68,98,11,51,28,18,5,36,29,7,7,5,0,0,2
S01011235,Occupancy rating +2 or more,47,16,5,11,29,8,19,13,5,1,2,2,0,2,1,0,0,1
S01011235,Occupancy rating +1,65,30,7,23,33,3,18,8,6,4,12,7,5,2,2,0,0,0
S01011235,Occupancy rating 0,68,40,9,31,26,0,10,4,6,0,16,15,1,2,1,0,0,1
S01011235,Occupancy rating -1 or less,15,4,1,3,10,0,4,3,1,0,6,5,1,1,1,0,0,0
S01011236,All households,284,130,51,79,154,20,91,40,31,20,43,27,16,0,0,0,0,0
S01011236,Occupancy rating +2 or more,68,27,14,13,41,12,27,15,9,3,2,2,0,0,0,0,0,0
S01011236,Occupancy rating +1,96,46,15,31,50,6,36,18,8,10,8,2,6,0,0,0,0,0
S01011236,Occupancy rating 0,84,37,15,22,47,1,22,6,11,5,24,17,7,0,0,0,0,0
S01011236,Occupancy rating -1 or less,36,20,7,13,16,1,6,1,3,2,9,6,3,0,0,0,0,0
S01011237,All households,331,106,36,70,208,19,111,35,56,20,78,50,28,17,12,0,0,5
S01011237,Occupancy rating +2 or more,95,40,13,27,55,16,32,18,9,5,7,2,5,0,0,0,0,0
S01011237,Occupancy rating +1,124,54,15,39,67,3,42,14,22,6,22,12,10,3,2,0,0,1
S01011237,Occupancy rating 0,87,9,6,3,70,0,32,2,21,9,38,25,13,8,5,0,0,3
S01011237,Occupancy rating -1 or less,25,3,2,1,16,0,5,1,4,0,11,11,0,6,5,0,0,1
S01011238,All households,334,148,35,113,160,9,85,38,42,5,66,47,19,26,6,0,5,15
S01011238,Occupancy rating +2 or more,61,31,6,25,27,1,21,17,2,2,5,3,2,3,0,0,1,2
S01011238,Occupancy rating +1,128,69,23,46,58,6,25,14,10,1,27,15,12,1,0,0,1,0
S01011238,Occupancy rating 0,100,33,4,29,53,0,28,6,20,2,25,22,3,14,2,0,3,9
S01011238,Occupancy rating -1 or less,45,15,2,13,22,2,11,1,10,0,9,7,2,8,4,0,0,4
S01011239,All households,427,268,90,178,151,13,103,57,37,9,35,21,14,8,2,0,5,1
S01011239,Occupancy rating +2 or more,78,34,18,16,43,6,33,25,6,2,4,0,4,1,1,0,0,0
S01011239,Occupancy rating +1,115,81,21,60,34,3,23,17,6,0,8,5,3,0,0,0,0,0
S01011239,Occupancy rating 0,168,114,39,75,53,3,36,12,18,6,14,9,5,1,0,0,1,0
S01011239,Occupancy rating -1 or less,66,39,12,27,21,1,11,3,7,1,9,7,2,6,1,0,4,1
S01011240,All households,481,348,80,268,125,22,76,43,24,9,27,17,10,8,2,0,2,4
S01011240,Occupancy rating +2 or more,49,30,8,22,19,2,15,9,3,3,2,2,0,0,0,0,0,0
S01011240,Occupancy rating +1,141,101,25,76,38,11,25,19,3,3,2,1,1,2,1,0,0,1
S01011240,Occupancy rating 0,214,163,41,122,46,6,24,11,12,1,16,9,7,5,0,0,2,3
S01011240,Occupancy rating -1 or less,77,54,6,48,22,3,12,4,6,2,7,5,2,1,1,0,0,0
S01011241,All households,540,282,110,172,237,37,157,69,50,38,43,25,18,21,11,0,1,9
S01011241,Occupancy rating +2 or more,185,52,25,27,124,19,93,43,30,20,12,3,9,9,5,0,1,3
S01011241,Occupancy rating +1,137,85,24,61,49,8,31,16,6,9,10,8,2,3,2,0,0,1
S01011241,Occupancy rating 0,153,103,52,51,44,8,25,9,11,5,11,8,3,6,2,0,0,4
S01011241,Occupancy rating -1 or less,65,42,9,33,20,2,8,1,3,4,10,6,4,3,2,0,0,1
S01011242,All households,383,170,73,97,197,32,124,53,45,26,41,26,15,16,6,1,2,7
S01011242,Occupancy rating +2 or more,121,28,12,16,88,16,64,31,19,14,8,4,4,5,2,0,0,3
S01011242,Occupancy rating +1,159,105,46,59,52,15,31,18,6,7,6,5,1,2,0,0,1,1
S01011242,Occupancy rating 0,78,29,12,17,45,0,23,3,16,4,22,15,7,4,1,1,1,1
S01011242,Occupancy rating -1 or less,25,8,3,5,12,1,6,1,4,1,5,2,3,5,3,0,0,2
S01011243,All households,545,336,114,222,200,19,100,58,25,17,81,65,16,9,3,0,1,5
S01011243,Occupancy rating +2 or more,66,25,6,19,40,7,30,21,5,4,3,3,0,1,1,0,0,0
S01011243,Occupancy rating +1,190,123,26,97,65,5,46,31,8,7,14,11,3,2,0,0,1,1
S01011243,Occupancy rating 0,209,140,63,77,65,4,16,4,8,4,45,34,11,4,1,0,0,3
S01011243,Occupancy rating -1 or less,80,48,19,29,30,3,8,2,4,2,19,17,2,2,1,0,0,1
S01011244,All households,409,252,49,203,147,12,83,44,28,11,52,35,17,10,4,0,0,6
S01011244,Occupancy rating +2 or more,46,23,8,15,22,4,16,5,6,5,2,1,1,1,1,0,0,0
S01011244,Occupancy rating +1,138,88,23,65,46,7,36,29,5,2,3,1,2,4,2,0,0,2
S01011244,Occupancy rating 0,176,114,11,103,59,1,25,10,13,2,33,23,10,3,0,0,0,3
S01011244,Occupancy rating -1 or less,49,27,7,20,20,0,6,0,4,2,14,10,4,2,1,0,0,1
S01011245,All households,446,203,63,140,223,33,122,59,41,22,68,47,21,20,7,0,1,12
S01011245,Occupancy rating +2 or more,108,42,12,30,64,19,41,30,9,2,4,2,2,2,0,0,0,2
S01011245,Occupancy rating +1,146,74,21,53,70,11,48,24,15,9,11,8,3,2,1,0,0,1
S01011245,Occupancy rating 0,154,79,27,52,66,3,23,3,12,8,40,28,12,9,3,0,0,6
S01011245,Occupancy rating -1 or less,38,8,3,5,23,0,10,2,5,3,13,9,4,7,3,0,1,3
S01011246,All households,439,173,53,120,254,37,179,103,54,22,38,20,18,12,5,0,0,7
S01011246,Occupancy rating +2 or more,173,40,15,25,128,24,96,63,21,12,8,3,5,5,2,0,0,3
S01011246,Occupancy rating +1,129,61,19,42,67,7,51,25,19,7,9,5,4,1,0,0,0,1
S01011246,Occupancy rating 0,116,70,17,53,44,5,24,15,7,2,15,7,8,2,2,0,0,0
S01011246,Occupancy rating -1 or less,21,2,2,0,15,1,8,0,7,1,6,5,1,4,1,0,0,3
S01011247,All households,357,91,47,44,252,62,163,84,52,27,27,9,18,14,7,0,0,7
S01011247,Occupancy rating +2 or more,223,50,27,23,168,43,118,67,30,21,7,3,4,5,2,0,0,3
S01011247,Occupancy rating +1,75,20,9,11,50,10,33,16,13,4,7,2,5,5,4,0,0,1
S01011247,Occupancy rating 0,39,13,7,6,23,3,9,1,6,2,11,4,7,3,1,0,0,2
S01011247,Occupancy rating -1 or less,20,8,4,4,11,6,3,0,3,0,2,0,2,1,0,0,0,1
S01011248,All households,317,85,35,50,221,24,166,70,59,37,31,16,15,11,5,0,2,4
S01011248,Occupancy rating +2 or more,178,48,26,22,128,21,100,60,25,15,7,4,3,2,1,0,0,1
S01011248,Occupancy rating +1,92,31,5,26,57,2,39,7,19,13,16,8,8,4,1,0,2,1
S01011248,Occupancy rating 0,36,4,3,1,30,1,24,2,14,8,5,2,3,2,0,0,0,2
S01011248,Occupancy rating -1 or less,11,2,1,1,6,0,3,1,1,1,3,2,1,3,3,0,0,0
S01011249,All households,308,83,28,55,218,41,156,56,71,29,21,12,9,7,2,0,1,4
S01011249,Occupancy rating +2 or more,178,48,17,31,128,29,91,42,32,17,8,6,2,2,1,0,0,1
S01011249,Occupancy rating +1,67,19,8,11,46,10,33,11,18,4,3,0,3,2,0,0,0,2
S01011249,Occupancy rating 0,50,16,3,13,32,2,24,2,16,6,6,4,2,2,0,0,1,1
S01011249,Occupancy rating -1 or less,13,0,0,0,12,0,8,1,5,2,4,2,2,1,1,0,0,0
S01011250,All households,446,113,21,92,311,18,163,55,87,21,130,95,35,22,7,0,1,14
S01011250,Occupancy rating +2 or more,109,43,9,34,63,9,43,29,9,5,11,5,6,3,0,0,1,2
S01011250,Occupancy rating +1,170,58,9,49,105,7,60,25,25,10,38,28,10,7,2,0,0,5
S01011250,Occupancy rating 0,125,7,1,6,112,2,46,1,42,3,64,49,15,6,1,0,0,5
S01011250,Occupancy rating -1 or less,42,5,2,3,31,0,14,0,11,3,17,13,4,6,4,0,0,2
S01011251,All households,385,114,51,63,258,19,154,67,62,25,85,58,27,13,8,0,1,4
S01011251,Occupancy rating +2 or more,126,59,31,28,65,12,48,40,7,1,5,4,1,2,2,0,0,0
S01011251,Occupancy rating +1,117,38,9,29,77,6,46,20,16,10,25,13,12,2,0,0,0,2
S01011251,Occupancy rating 0,115,14,9,5,97,1,43,6,30,7,53,39,14,4,3,0,0,1
S01011251,Occupancy rating -1 or less,27,3,2,1,19,0,17,1,9,7,2,2,0,5,3,0,1,1
S01011252,All households,344,94,30,64,226,15,123,39,62,22,88,65,23,24,14,0,0,10
S01011252,Occupancy rating +2 or more,83,36,12,24,47,9,32,22,5,5,6,3,3,0,0,0,0,0
S01011252,Occupancy rating +1,106,48,10,38,52,4,35,15,13,7,13,9,4,6,3,0,0,3
S01011252,Occupancy rating 0,117,10,8,2,100,2,43,2,33,8,55,42,13,7,2,0,0,5
S01011252,Occupancy rating -1 or less,38,0,0,0,27,0,13,0,11,2,14,11,3,11,9,0,0,2
S01011253,All households,391,161,59,102,207,18,115,32,60,23,74,47,27,23,12,0,1,10
S01011253,Occupancy rating +2 or more,95,42,11,31,53,7,43,23,11,9,3,0,3,0,0,0,0,0
S01011253,Occupancy rating +1,136,64,13,51,65,6,33,6,19,8,26,14,12,7,2,0,1,4
S01011253,Occupancy rating 0,114,45,32,13,64,5,26,3,18,5,33,23,10,5,3,0,0,2
S01011253,Occupancy rating -1 or less,46,10,3,7,25,0,13,0,12,1,12,10,2,11,7,0,0,4
S01011254,All households,359,55,23,32,292,31,232,83,99,50,29,19,10,12,6,0,0,6
S01011254,Occupancy rating +2 or more,195,35,15,20,158,23,127,61,41,25,8,4,4,2,2,0,0,0
S01011254,Occupancy rating +1,111,18,7,11,90,8,68,20,29,19,14,9,5,3,1,0,0,2
S01011254,Occupancy rating 0,38,1,1,0,32,0,27,2,22,3,5,4,1,5,2,0,0,3
S01011254,Occupancy rating -1 or less,15,1,0,1,12,0,10,0,7,3,2,2,0,2,1,0,0,1
S01011255,All households,267,34,8,26,226,13,199,59,121,19,14,9,5,7,7,0,0,0
S01011255,Occupancy rating +2 or more,213,26,7,19,183,12,164,53,96,15,7,5,2,4,4,0,0,0
S01011255,Occupancy rating +1,36,8,1,7,27,1,22,6,15,1,4,3,1,1,1,0,0,0
S01011255,Occupancy rating 0,10,0,0,0,9,0,7,0,4,3,2,0,2,1,1,0,0,0
S01011255,Occupancy rating -1 or less,8,0,0,0,7,0,6,0,6,0,1,1,0,1,1,0,0,0
S01011256,All households,169,25,8,17,140,6,119,31,81,7,15,12,3,4,3,0,0,1
S01011256,Occupancy rating +2 or more,101,16,5,11,85,5,76,24,48,4,4,4,0,0,0,0,0,0
S01011256,Occupancy rating +1,41,7,2,5,33,0,26,6,18,2,7,5,2,1,1,0,0,0
S01011256,Occupancy rating 0,24,1,1,0,21,1,16,1,14,1,4,3,1,2,1,0,0,1
S01011256,Occupancy rating -1 or less,3,1,0,1,1,0,1,0,1,0,0,0,0,1,1,0,0,0
S01011257,All households,188,54,35,19,132,35,90,38,26,26,7,1,6,2,0,0,0,2
S01011257,Occupancy rating +2 or more,155,46,29,17,108,31,71,37,17,17,6,1,5,1,0,0,0,1
S01011257,Occupancy rating +1,26,8,6,2,17,4,12,1,5,6,1,0,1,1,0,0,0,1
S01011257,Occupancy rating 0,7,0,0,0,7,0,7,0,4,3,0,0,0,0,0,0,0,0
S01011257,Occupancy rating -1 or less,0,0,0,0,0,0,0,0,0,0,0,0,0,0,0,0,0,0
S01011258,All households,229,52,33,19,169,25,113,40,52,21,31,19,12,8,5,0,0,3
S01011258,Occupancy rating +2 or more,137,25,14,11,111,17,82,36,34,12,12,8,4,1,0,0,0,1
S01011258,Occupancy rating +1,49,16,10,6,31,4,18,3,7,8,9,4,5,2,1,0,0,1
S01011258,Occupancy rating 0,30,8,7,1,19,1,10,1,9,0,8,6,2,3,2,0,0,1
S01011258,Occupancy rating -1 or less,13,3,2,1,8,3,3,0,2,1,2,1,1,2,2,0,0,0
S01011259,All households,383,164,84,80,201,35,127,55,39,33,39,24,15,18,8,0,1,9
S01011259,Occupancy rating +2 or more,133,32,16,16,92,18,67,33,14,20,7,3,4,9,2,0,0,7
S01011259,Occupancy rating +1,141,85,50,35,54,14,30,15,9,6,10,6,4,2,1,0,0,1
S01011259,Occupancy rating 0,96,45,18,27,46,3,25,6,13,6,18,11,7,5,3,0,1,1
S01011259,Occupancy rating -1 or less,13,2,0,2,9,0,5,1,3,1,4,4,0,2,2,0,0,0
S01011260,All households,336,114,61,53,216,48,141,55,56,30,27,15,12,6,4,0,0,2
S01011260,Occupancy rating +2 or more,197,57,38,19,138,38,91,44,30,17,9,4,5,2,2,0,0,0
S01011260,Occupancy rating +1,74,29,17,12,43,8,25,9,10,6,10,6,4,2,1,0,0,1
S01011260,Occupancy rating 0,53,23,4,19,28,1,20,2,12,6,7,5,2,2,1,0,0,1
S01011260,Occupancy rating -1 or less,12,5,2,3,7,1,5,0,4,1,1,0,1,0,0,0,0,0
S01011261,All households,310,78,39,39,217,17,109,35,41,33,91,59,32,15,7,0,0,8
S01011261,Occupancy rating +2 or more,107,40,23,17,66,16,40,26,6,8,10,6,4,1,0,0,0,1
S01011261,Occupancy rating +1,102,31,13,18,65,1,32,6,13,13,32,18,14,6,3,0,0,3
S01011261,Occupancy rating 0,69,5,3,2,60,0,26,2,16,8,34,24,10,4,1,0,0,3
S01011261,Occupancy rating -1 or less,32,2,0,2,26,0,11,1,6,4,15,11,4,4,3,0,0,1
S01011262,All households,223,74,32,42,140,15,82,33,32,17,43,23,20,9,3,0,2,4
S01011262,Occupancy rating +2 or more,89,38,17,21,49,9,34,21,5,8,6,2,4,2,0,0,0,2
S01011262,Occupancy rating +1,75,33,14,19,42,4,27,12,10,5,11,4,7,0,0,0,0,0
S01011262,Occupancy rating 0,42,2,1,1,37,1,14,0,10,4,22,14,8,3,0,0,2,1
S01011262,Occupancy rating -1 or less,17,1,0,1,12,1,7,0,7,0,4,3,1,4,3,0,0,1
S01011263,All households,431,106,36,70,307,20,215,76,118,21,72,54,18,18,10,0,0,8
S01011263,Occupancy rating +2 or more,169,38,13,25,129,13,104,54,45,5,12,10,2,2,1,0,0,1
S01011263,Occupancy rating +1,131,53,19,34,72,4,52,18,31,3,16,9,7,6,3,0,0,3
S01011263,Occupancy rating 0,101,14,4,10,81,2,46,2,33,11,33,26,7,6,3,0,0,3
S01011263,Occupancy rating -1 or less,30,1,0,1,25,1,13,2,9,2,11,9,2,4,3,0,0,1
S01011264,All households,259,58,20,38,190,12,119,35,55,29,59,40,19,11,5,0,1,5
S01011264,Occupancy rating +2 or more,90,32,9,23,56,8,39,27,6,6,9,3,6,2,1,0,0,1
S01011264,Occupancy rating +1,72,20,9,11,51,2,32,6,13,13,17,12,5,1,0,0,0,1
S01011264,Occupancy rating 0,73,3,2,1,65,2,38,2,28,8,25,19,6,5,2,0,1,2
S01011264,Occupancy rating -1 or less,24,3,0,3,18,0,10,0,8,2,8,6,2,3,2,0,0,1
S01011265,All households,468,152,50,102,299,16,150,36,80,34,133,103,30,17,12,0,0,5
S01011265,Occupancy rating +2 or more,53,31,12,19,21,2,17,11,3,3,2,2,0,1,0,0,0,1
S01011265,Occupancy rating +1,164,80,20,60,84,10,51,23,13,15,23,17,6,0,0,0,0,0
S01011265,Occupancy rating 0,195,29,11,18,164,3,68,2,51,15,93,73,20,2,1,0,0,1
S01011265,Occupancy rating -1 or less,56,12,7,5,30,1,14,0,13,1,15,11,4,14,11,0,0,3
S01011266,All households,383,104,58,46,261,42,160,61,59,40,59,37,22,18,11,0,1,6
S01011266,Occupancy rating +2 or more,169,63,39,24,104,34,64,48,8,8,6,5,1,2,1,0,0,1
S01011266,Occupancy rating +1,112,23,11,12,85,6,57,12,32,13,22,8,14,4,1,0,1,2
S01011266,Occupancy rating 0,76,17,7,10,54,1,30,0,15,15,23,18,5,5,4,0,0,1
S01011266,Occupancy rating -1 or less,26,1,1,0,18,1,9,1,4,4,8,6,2,7,5,0,0,2
S01011267,All households,266,80,41,39,174,40,106,46,37,23,28,15,13,12,7,0,1,4
S01011267,Occupancy rating +2 or more,120,23,17,6,96,31,61,35,14,12,4,0,4,1,1,0,0,0
S01011267,Occupancy rating +1,81,41,19,22,40,6,27,6,13,8,7,3,4,0,0,0,0,0
S01011267,Occupancy rating 0,52,15,4,11,31,3,13,4,7,2,15,10,5,6,3,0,1,2
S01011267,Occupancy rating -1 or less,13,1,1,0,7,0,5,1,3,1,2,2,0,5,3,0,0,2
S01011268,All households,186,73,38,35,110,17,81,42,22,17,12,7,5,3,2,0,0,1
S01011268,Occupancy rating +2 or more,90,25,15,10,65,12,50,31,11,8,3,0,3,0,0,0,0,0
S01011268,Occupancy rating +1,39,14,5,9,25,2,22,9,4,9,1,1,0,0,0,0,0,0
S01011268,Occupancy rating 0,40,25,17,8,13,2,7,2,5,0,4,4,0,2,1,0,0,1
S01011268,Occupancy rating -1 or less,17,9,1,8,7,1,2,0,2,0,4,2,2,1,1,0,0,0
S01011269,All households,279,132,62,70,144,28,83,36,29,18,33,22,11,3,1,1,1,0
S01011269,Occupancy rating +2 or more,78,22,10,12,56,19,36,18,12,6,1,0,1,0,0,0,0,0
S01011269,Occupancy rating +1,84,50,21,29,34,6,21,11,4,6,7,4,3,0,0,0,0,0
S01011269,Occupancy rating 0,91,46,28,18,43,2,23,5,12,6,18,13,5,2,0,1,1,0
S01011269,Occupancy rating -1 or less,26,14,3,11,11,1,3,2,1,0,7,5,2,1,1,0,0,0
S01011270,All households,349,158,51,107,177,18,108,48,39,21,51,40,11,14,4,0,1,9
S01011270,Occupancy rating +2 or more,87,38,18,20,47,13,30,21,5,4,4,3,1,2,1,0,0,1
S01011270,Occupancy rating +1,103,54,11,43,47,1,32,15,8,9,14,8,6,2,0,0,0,2
S01011270,Occupancy rating 0,121,56,21,35,60,4,36,9,20,7,20,17,3,5,1,0,0,4
S01011270,Occupancy rating -1 or less,38,10,1,9,23,0,10,3,6,1,13,12,1,5,2,0,1,2
S01011271,All households,357,119,55,64,227,35,143,70,46,27,49,25,24,11,2,0,1,8
S01011271,Occupancy rating +2 or more,142,55,25,30,86,23,59,50,6,3,4,2,2,1,0,0,0,1
S01011271,Occupancy rating +1,112,36,12,24,75,11,44,16,14,14,20,7,13,1,0,0,0,1
S01011271,Occupancy rating 0,77,19,16,3,53,1,33,3,22,8,19,12,7,5,1,0,1,3
S01011271,Occupancy rating -1 or less,26,9,2,7,13,0,7,1,4,2,6,4,2,4,1,0,0,3
S01011272,All households,380,169,57,112,195,22,108,53,34,21,65,44,21,16,7,0,1,8
S01011272,Occupancy rating +2 or more,88,41,13,28,45,11,32,22,4,6,2,1,1,2,0,0,0,2
S01011272,Occupancy rating +1,158,89,36,53,65,8,43,28,9,6,14,9,5,4,2,0,0,2
S01011272,Occupancy rating 0,106,30,6,24,69,1,29,2,18,9,39,27,12,7,2,0,1,4
S01011272,Occupancy rating -1 or less,28,9,2,7,16,2,4,1,3,0,10,7,3,3,3,0,0,0
S01011273,All households,339,73,27,46,252,17,138,42,68,28,97,76,21,14,11,0,1,2
S01011273,Occupancy rating +2 or more,96,42,19,23,54,12,39,33,3,3,3,1,2,0,0,0,0,0
S01011273,Occupancy rating +1,116,20,6,14,91,4,48,9,27,12,39,27,12,5,3,0,1,1
S01011273,Occupancy rating 0,93,8,0,8,80,0,43,0,32,11,37,32,5,5,4,0,0,1
S01011273,Occupancy rating -1 or less,34,3,2,1,27,1,8,0,6,2,18,16,2,4,4,0,0,0
S01011274,All households,395,138,33,105,245,15,141,52,71,18,89,66,23,12,5,0,0,7
S01011274,Occupancy rating +2 or more,134,57,16,41,76,8,57,32,21,4,11,10,1,1,0,0,0,1
S01011274,Occupancy rating +1,131,54,13,41,73,7,37,16,17,4,29,19,10,4,1,0,0,3
S01011274,Occupancy rating 0,99,21,2,19,73,0,39,4,27,8,34,24,10,5,2,0,0,3
S01011274,Occupancy rating -1 or less,31,6,2,4,23,0,8,0,6,2,15,13,2,2,2,0,0,0
S01011275,All households,277,70,14,56,188,14,103,31,50,22,71,53,18,19,11,0,0,8
S01011275,Occupancy rating +2 or more,77,28,8,20,45,9,30,18,8,4,6,4,2,4,2,0,0,2
S01011275,Occupancy rating +1,102,31,4,27,65,4,37,12,14,11,24,14,10,6,0,0,0,6
S01011275,Occupancy rating 0,64,5,2,3,56,1,26,0,20,6,29,25,4,3,3,0,0,0
S01011275,Occupancy rating -1 or less,34,6,0,6,22,0,10,1,8,1,12,10,2,6,6,0,0,0
S01011276,All households,405,110,40,70,277,37,161,50,75,36,79,54,25,18,10,0,0,8
S01011276,Occupancy rating +2 or more,143,51,18,33,91,24,61,37,15,9,6,2,4,1,0,0,0,1
S01011276,Occupancy rating +1,144,51,20,31,90,12,47,9,25,13,31,24,7,3,2,0,0,1
S01011276,Occupancy rating 0,87,3,1,2,74,0,41,2,26,13,33,20,13,10,6,0,0,4
S01011276,Occupancy rating -1 or less,31,5,1,4,22,1,12,2,9,1,9,8,1,4,2,0,0,2
S01011277,All households,284,69,26,43,207,18,167,79,50,38,22,14,8,8,2,0,1,5
S01011277,Occupancy rating +2 or more,112,23,9,14,88,8,77,46,20,11,3,1,2,1,0,0,0,1
S01011277,Occupancy rating +1,121,40,15,25,77,9,63,31,15,17,5,3,2,4,0,0,1,3
S01011277,Occupancy rating 0,46,6,2,4,37,0,24,0,15,9,13,9,4,3,2,0,0,1
S01011277,Occupancy rating -1 or less,5,0,0,0,5,1,3,2,0,1,1,1,0,0,0,0,0,0
S01011278,All households,230,72,16,56,154,9,126,64,41,21,19,15,4,4,2,0,0,2
S01011278,Occupancy rating +2 or more,74,19,6,13,55,4,49,30,8,11,2,0,2,0,0,0,0,0
S01011278,Occupancy rating +1,96,35,5,30,59,5,50,27,16,7,4,3,1,2,1,0,0,1
S01011278,Occupancy rating 0,52,16,4,12,34,0,22,5,14,3,12,11,1,2,1,0,0,1
S01011278,Occupancy rating -1 or less,8,2,1,1,6,0,5,2,3,0,1,1,0,0,0,0,0,0
S01011279,All households,302,90,43,47,206,35,139,65,42,32,32,20,12,6,5,0,0,1
S01011279,Occupancy rating +2 or more,101,24,5,19,76,18,56,35,12,9,2,2,0,1,0,0,0,1
S01011279,Occupancy rating +1,136,44,20,24,92,15,66,29,19,18,11,5,6,0,0,0,0,0
S01011279,Occupancy rating 0,43,9,5,4,30,1,14,1,8,5,15,10,5,4,4,0,0,0
S01011279,Occupancy rating -1 or less,22,13,13,0,8,1,3,0,3,0,4,3,1,1,1,0,0,0
S01011280,All households,231,29,16,13,199,34,152,67,46,39,13,8,5,3,2,0,0,1
S01011280,Occupancy rating +2 or more,167,24,14,10,142,31,108,65,18,25,3,1,2,1,0,0,0,1
S01011280,Occupancy rating +1,39,2,1,1,37,3,27,2,16,9,7,4,3,0,0,0,0,0
S01011280,Occupancy rating 0,20,3,1,2,16,0,14,0,10,4,2,2,0,1,1,0,0,0
S01011280,Occupancy rating -1 or less,5,0,0,0,4,0,3,0,2,1,1,1,0,1,1,0,0,0
S01011281,All households,238,43,14,29,187,17,152,53,76,23,18,12,6,8,6,0,1,1
S01011281,Occupancy rating +2 or more,149,18,10,8,129,16,105,41,51,13,8,4,4,2,1,0,1,0
S01011281,Occupancy rating +1,41,10,2,8,26,1,21,10,5,6,4,3,1,5,4,0,0,1
S01011281,Occupancy rating 0,40,12,1,11,28,0,22,2,17,3,6,5,1,0,0,0,0,0
S01011281,Occupancy rating -1 or less,8,3,1,2,4,0,4,0,3,1,0,0,0,1,1,0,0,0
S01011282,All households,341,67,29,38,267,12,229,76,122,31,26,19,7,7,5,0,0,2
S01011282,Occupancy rating +2 or more,169,19,8,11,148,8,133,54,67,12,7,6,1,2,1,0,0,1
S01011282,Occupancy rating +1,87,16,4,12,69,1,57,16,31,10,11,6,5,2,1,0,0,1
S01011282,Occupancy rating 0,73,29,16,13,42,2,32,5,20,7,8,7,1,2,2,0,0,0
S01011282,Occupancy rating -1 or less,12,3,1,2,8,1,7,1,4,2,0,0,0,1,1,0,0,0
S01011283,All households,251,26,2,24,222,8,203,63,115,25,11,8,3,3,3,0,0,0
S01011283,Occupancy rating +2 or more,175,13,1,12,162,8,147,55,73,19,7,5,2,0,0,0,0,0
S01011283,Occupancy rating +1,44,9,1,8,34,0,31,8,18,5,3,3,0,1,1,0,0,0
S01011283,Occupancy rating 0,26,4,0,4,21,0,20,0,20,0,1,0,1,1,1,0,0,0
S01011283,Occupancy rating -1 or less,6,0,0,0,5,0,5,0,4,1,0,0,0,1,1,0,0,0
S01011284,All households,192,14,1,13,177,3,163,42,106,15,11,9,2,1,1,0,0,0
S01011284,Occupancy rating +2 or more,163,12,0,12,150,2,141,42,89,10,7,6,1,1,1,0,0,0
S01011284,Occupancy rating +1,19,1,0,1,18,1,14,0,12,2,3,2,1,0,0,0,0,0
S01011284,Occupancy rating 0,7,1,1,0,6,0,5,0,3,2,1,1,0,0,0,0,0,0
S01011284,Occupancy rating -1 or less,3,0,0,0,3,0,3,0,2,1,0,0,0,0,0,0,0,0
S01011285,All households,297,79,27,52,195,16,121,51,52,18,58,41,17,23,14,0,2,7
S01011285,Occupancy rating +2 or more,66,27,12,15,36,6,25,20,4,1,5,3,2,3,0,0,0,3
S01011285,Occupancy rating +1,118,45,10,35,69,7,46,28,9,9,16,13,3,4,2,0,1,1
S01011285,Occupancy rating 0,91,6,5,1,74,2,39,2,29,8,33,21,12,11,7,0,1,3
S01011285,Occupancy rating -1 or less,22,1,0,1,16,1,11,1,10,0,4,4,0,5,5,0,0,0
S01011286,All households,298,93,35,58,194,12,115,41,52,22,67,50,17,11,6,0,0,5
S01011286,Occupancy rating +2 or more,78,35,13,22,40,5,27,15,7,5,8,5,3,3,2,0,0,1
S01011286,Occupancy rating +1,108,49,16,33,58,5,43,24,14,5,10,8,2,1,0,0,0,1
S01011286,Occupancy rating 0,75,5,4,1,66,2,35,1,24,10,29,23,6,4,1,0,0,3
S01011286,Occupancy rating -1 or less,37,4,2,2,30,0,10,1,7,2,20,14,6,3,3,0,0,0
S01011287,All households,337,89,32,57,233,17,134,51,57,26,82,59,23,15,9,0,2,4
S01011287,Occupancy rating +2 or more,99,31,12,19,68,15,42,25,12,5,11,6,5,0,0,0,0,0
S01011287,Occupancy rating +1,107,38,12,26,66,0,46,20,15,11,20,11,9,3,1,0,1,1
S01011287,Occupancy rating 0,91,13,5,8,72,1,32,6,19,7,39,33,6,6,2,0,1,3
S01011287,Occupancy rating -1 or less,40,7,3,4,27,1,14,0,11,3,12,9,3,6,6,0,0,0
S01011288,All households,318,80,39,41,228,28,128,47,55,26,72,54,18,10,5,0,0,5
S01011288,Occupancy rating +2 or more,107,41,20,21,65,15,43,34,8,1,7,4,3,1,0,0,0,1
S01011288,Occupancy rating +1,85,21,6,15,62,5,38,9,19,10,19,12,7,2,0,0,0,2
S01011288,Occupancy rating 0,101,15,13,2,80,7,43,4,24,15,30,23,7,6,4,0,0,2
S01011288,Occupancy rating -1 or less,25,3,0,3,21,1,4,0,4,0,16,15,1,1,1,0,0,0
S01011289,All households,431,155,72,83,263,22,168,65,75,28,73,52,21,13,7,0,0,6
S01011289,Occupancy rating +2 or more,106,47,24,23,58,10,45,35,6,4,3,2,1,1,1,0,0,0
S01011289,Occupancy rating +1,161,70,32,38,90,8,52,24,15,13,30,16,14,1,0,0,0,1
S01011289,Occupancy rating 0,127,35,16,19,85,4,53,5,40,8,28,26,2,7,3,0,0,4
S01011289,Occupancy rating -1 or less,37,3,0,3,30,0,18,1,14,3,12,8,4,4,3,0,0,1
S01011290,All households,503,190,66,124,287,32,180,78,59,43,75,51,24,26,9,0,1,16
S01011290,Occupancy rating +2 or more,135,44,18,26,87,19,64,38,14,12,4,3,1,4,1,0,0,3
S01011290,Occupancy rating +1,186,97,28,69,83,10,60,35,12,13,13,5,8,6,2,0,0,4
S01011290,Occupancy rating 0,137,31,12,19,94,2,43,4,24,15,49,36,13,12,2,0,1,9
S01011290,Occupancy rating -1 or less,45,18,8,10,23,1,13,1,9,3,9,7,2,4,4,0,0,0
S01011291,All households,407,162,56,106,228,29,144,68,58,18,55,39,16,17,7,0,2,8
S01011291,Occupancy rating +2 or more,90,31,11,20,57,16,41,27,9,5,0,0,0,2,0,0,0,2
S01011291,Occupancy rating +1,168,91,29,62,74,12,54,37,11,6,8,4,4,3,2,0,1,0
S01011291,Occupancy rating 0,111,36,15,21,70,0,37,3,29,5,33,23,10,5,0,0,1,4
S01011291,Occupancy rating -1 or less,38,4,1,3,27,1,12,1,9,2,14,12,2,7,5,0,0,2
S01011292,All households,332,139,61,78,178,11,101,48,37,16,66,44,22,15,7,0,0,8
S01011292,Occupancy rating +2 or more,61,29,12,17,31,5,22,15,4,3,4,2,2,1,0,0,0,1
S01011292,Occupancy rating +1,128,60,8,52,64,4,43,27,14,2,17,8,9,4,3,0,0,1
S01011292,Occupancy rating 0,105,38,32,6,63,2,28,4,14,10,33,26,7,4,1,0,0,3
S01011292,Occupancy rating -1 or less,38,12,9,3,20,0,8,2,5,1,12,8,4,6,3,0,0,3
S01011293,All households,341,122,61,61,209,25,130,42,56,32,54,46,8,10,6,0,0,4
S01011293,Occupancy rating +2 or more,76,33,13,20,43,8,33,17,12,4,2,1,1,0,0,0,0,0
S01011293,Occupancy rating +1,141,59,28,31,78,10,48,24,12,12,20,17,3,4,1,0,0,3
S01011293,Occupancy rating 0,97,29,20,9,66,5,34,0,25,9,27,23,4,2,1,0,0,1
S01011293,Occupancy rating -1 or less,27,1,0,1,22,2,15,1,7,7,5,5,0,4,4,0,0,0
S01011294,All households,487,266,123,143,203,44,109,56,34,19,50,36,14,18,6,0,1,11
S01011294,Occupancy rating +2 or more,101,40,15,25,58,11,42,28,11,3,5,3,2,3,0,0,1,2
S01011294,Occupancy rating +1,139,82,25,57,51,12,29,20,5,4,10,7,3,6,2,0,0,4
S01011294,Occupancy rating 0,192,116,69,47,72,14,31,8,15,8,27,20,7,4,0,0,0,4
S01011294,Occupancy rating -1 or less,55,28,14,14,22,7,7,0,3,4,8,6,2,5,4,0,0,1
S01011295,All households,448,143,63,80,297,61,197,95,77,25,39,23,16,8,3,0,0,5
S01011295,Occupancy rating +2 or more,258,53,40,13,203,51,142,76,48,18,10,4,6,2,2,0,0,0
S01011295,Occupancy rating +1,110,52,16,36,56,9,39,17,18,4,8,4,4,2,1,0,0,1
S01011295,Occupancy rating 0,68,35,7,28,30,0,12,1,8,3,18,13,5,3,0,0,0,3
S01011295,Occupancy rating -1 or less,12,3,0,3,8,1,4,1,3,0,3,2,1,1,0,0,0,1
S01011296,All households,280,115,62,53,160,25,110,56,35,19,25,16,9,5,3,0,0,2
S01011296,Occupancy rating +2 or more,102,34,17,17,67,13,52,37,11,4,2,1,1,1,0,0,0,1
S01011296,Occupancy rating +1,77,30,17,13,46,8,29,9,13,7,9,6,3,1,0,0,0,1
S01011296,Occupancy rating 0,81,44,23,21,37,4,26,10,9,7,7,5,2,0,0,0,0,0
S01011296,Occupancy rating -1 or less,20,7,5,2,10,0,3,0,2,1,7,4,3,3,3,0,0,0
S01011297,All households,311,63,32,31,238,12,152,41,66,45,74,55,19,10,6,0,0,4
S01011297,Occupancy rating +2 or more,94,40,19,21,52,5,41,30,8,3,6,4,2,2,2,0,0,0
S01011297,Occupancy rating +1,77,11,6,5,64,3,47,7,21,19,14,10,4,2,0,0,0,2
S01011297,Occupancy rating 0,99,11,6,5,86,3,47,3,25,19,36,25,11,2,0,0,0,2
S01011297,Occupancy rating -1 or less,41,1,1,0,36,1,17,1,12,4,18,16,2,4,4,0,0,0
S01011298,All households,230,45,16,29,170,8,102,30,55,17,60,39,21,15,7,0,1,7
S01011298,Occupancy rating +2 or more,90,36,11,25,49,8,36,29,6,1,5,2,3,5,0,0,1,4
S01011298,Occupancy rating +1,64,4,4,0,58,0,27,1,18,8,31,19,12,2,1,0,0,1
S01011298,Occupancy rating 0,54,3,1,2,47,0,27,0,20,7,20,15,5,4,3,0,0,1
S01011298,Occupancy rating -1 or less,22,2,0,2,16,0,12,0,11,1,4,3,1,4,3,0,0,1
S01011299,All households,197,46,22,24,136,21,107,47,41,19,8,1,7,15,6,0,0,9
S01011299,Occupancy rating +2 or more,145,33,18,15,104,20,79,40,28,11,5,1,4,8,3,0,0,5
S01011299,Occupancy rating +1,36,11,4,7,21,1,19,6,6,7,1,0,1,4,1,0,0,3
S01011299,Occupancy rating 0,10,1,0,1,8,0,6,1,5,0,2,0,2,1,0,0,0,1
S01011299,Occupancy rating -1 or less,6,1,0,1,3,0,3,0,2,1,0,0,0,2,2,0,0,0
S01011300,All households,423,138,56,82,265,28,165,63,64,38,72,50,22,20,11,0,1,8
S01011300,Occupancy rating +2 or more,95,39,20,19,55,11,40,29,5,6,4,3,1,1,1,0,0,0
S01011300,Occupancy rating +1,164,65,23,42,98,14,63,32,18,13,21,12,9,1,0,0,0,1
S01011300,Occupancy rating 0,129,30,12,18,87,3,46,2,31,13,38,27,11,12,5,0,1,6
S01011300,Occupancy rating -1 or less,35,4,1,3,25,0,16,0,10,6,9,8,1,6,5,0,0,1
S01011301,All households,309,89,41,48,214,31,161,84,55,22,22,12,10,6,3,0,0,3
S01011301,Occupancy rating +2 or more,215,63,34,29,149,27,115,67,34,14,7,4,3,3,1,0,0,2
S01011301,Occupancy rating +1,54,13,6,7,39,2,29,13,13,3,8,3,5,2,1,0,0,1
S01011301,Occupancy rating 0,33,10,1,9,23,2,15,4,8,3,6,4,2,0,0,0,0,0
S01011301,Occupancy rating -1 or less,7,3,0,3,3,0,2,0,0,2,1,1,0,1,1,0,0,0
S01011302,All households,522,304,142,162,203,41,112,53,44,15,50,24,26,15,4,0,3,8
S01011302,Occupancy rating +2 or more,71,31,15,16,40,8,27,19,6,2,5,3,2,0,0,0,0,0
S01011302,Occupancy rating +1,220,143,62,81,71,19,44,29,10,5,8,2,6,6,2,0,1,3
S01011302,Occupancy rating 0,185,108,53,55,73,13,32,3,22,7,28,13,15,4,1,0,1,2
S01011302,Occupancy rating -1 or less,46,22,12,10,19,1,9,2,6,1,9,6,3,5,1,0,1,3
S01011303,All households,427,111,43,68,302,45,227,92,101,34,30,18,12,14,6,0,1,7
S01011303,Occupancy rating +2 or more,206,39,15,24,164,25,130,72,39,19,9,5,4,3,2,0,0,1
S01011303,Occupancy rating +1,128,44,14,30,80,14,57,10,38,9,9,7,2,4,1,0,1,2
S01011303,Occupancy rating 0,72,21,9,12,47,4,33,6,22,5,10,5,5,4,2,0,0,2
S01011303,Occupancy rating -1 or less,21,7,5,2,11,2,7,4,2,1,2,1,1,3,1,0,0,2
S01011304,All households,282,74,31,43,189,12,112,37,44,31,65,47,18,19,12,0,1,6
S01011304,Occupancy rating +2 or more,78,31,14,17,45,6,35,22,7,6,4,2,2,2,1,0,0,1
S01011304,Occupancy rating +1,102,30,9,21,69,5,40,14,14,12,24,16,8,3,1,0,0,2
S01011304,Occupancy rating 0,78,13,8,5,56,1,28,1,19,8,27,19,8,9,6,0,1,2
S01011304,Occupancy rating -1 or less,24,0,0,0,19,0,9,0,4,5,10,10,0,5,4,0,0,1
S01011305,All households,342,86,22,64,244,20,160,61,78,21,64,41,23,12,6,0,1,5
S01011305,Occupancy rating +2 or more,126,21,6,15,104,11,86,36,45,5,7,5,2,1,0,0,1,0
S01011305,Occupancy rating +1,89,36,8,28,51,7,31,23,6,2,13,6,7,2,1,0,0,1
S01011305,Occupancy rating 0,97,27,6,21,66,0,32,2,17,13,34,23,11,4,1,0,0,3
S01011305,Occupancy rating -1 or less,30,2,2,0,23,2,11,0,10,1,10,7,3,5,4,0,0,1
S01011306,All households,282,89,40,49,189,32,100,54,33,13,57,44,13,4,2,0,0,2
S01011306,Occupancy rating +2 or more,100,31,15,16,68,14,49,40,4,5,5,4,1,1,0,0,0,1
S01011306,Occupancy rating +1,109,43,19,24,65,14,27,14,8,5,24,17,7,1,1,0,0,0
S01011306,Occupancy rating 0,60,10,6,4,49,4,19,0,16,3,26,21,5,1,0,0,0,1
S01011306,Occupancy rating -1 or less,13,5,0,5,7,0,5,0,5,0,2,2,0,1,1,0,0,0
S01011307,All households,188,41,17,24,131,22,101,43,42,16,8,5,3,16,6,0,3,7
S01011307,Occupancy rating +2 or more,136,32,13,19,94,18,70,32,27,11,6,4,2,10,2,0,3,5
S01011307,Occupancy rating +1,34,6,2,4,25,4,21,9,7,5,0,0,0,3,2,0,0,1
S01011307,Occupancy rating 0,15,2,1,1,10,0,8,1,7,0,2,1,1,3,2,0,0,1
S01011307,Occupancy rating -1 or less,3,1,1,0,2,0,2,1,1,0,0,0,0,0,0,0,0,0
S01011308,All households,186,48,18,30,133,19,103,45,38,20,11,4,7,5,1,0,1,3
S01011308,Occupancy rating +2 or more,125,25,9,16,97,15,79,40,26,13,3,0,3,3,1,0,0,2
S01011308,Occupancy rating +1,39,18,8,10,19,4,12,4,4,4,3,1,2,2,0,0,1,1
S01011308,Occupancy rating 0,17,4,0,4,13,0,10,1,6,3,3,1,2,0,0,0,0,0
S01011308,Occupancy rating -1 or less,5,1,1,0,4,0,2,0,2,0,2,2,0,0,0,0,0,0
S01011309,All households,333,104,61,43,221,56,154,78,52,24,11,7,4,8,5,0,0,3
S01011309,Occupancy rating +2 or more,239,61,41,20,173,47,122,68,37,17,4,2,2,5,3,0,0,2
S01011309,Occupancy rating +1,56,23,12,11,32,8,22,10,8,4,2,1,1,1,0,0,0,1
S01011309,Occupancy rating 0,28,13,7,6,13,1,8,0,6,2,4,4,0,2,2,0,0,0
S01011309,Occupancy rating -1 or less,10,7,1,6,3,0,2,0,1,1,1,0,1,0,0,0,0,0
S01011310,All households,341,122,62,60,207,41,129,64,47,18,37,25,12,12,3,0,4,5
S01011310,Occupancy rating +2 or more,155,45,28,17,106,30,71,46,20,5,5,3,2,4,2,0,2,0
S01011310,Occupancy rating +1,88,38,16,22,47,8,32,16,12,4,7,5,2,3,0,0,1,2
S01011310,Occupancy rating 0,75,34,17,17,38,3,18,2,10,6,17,11,6,3,0,0,0,3
S01011310,Occupancy rating -1 or less,23,5,1,4,16,0,8,0,5,3,8,6,2,2,1,0,1,0
S01011311,All households,305,78,48,30,216,50,151,84,45,22,15,8,7,11,2,1,2,6
S01011311,Occupancy rating +2 or more,223,51,37,14,166,49,113,72,27,14,4,1,3,6,1,1,1,3
S01011311,Occupancy rating +1,53,19,8,11,32,1,26,10,12,4,5,2,3,2,0,0,0,2
S01011311,Occupancy rating 0,24,6,3,3,15,0,10,2,4,4,5,4,1,3,1,0,1,1
S01011311,Occupancy rating -1 or less,5,2,0,2,3,0,2,0,2,0,1,1,0,0,0,0,0,0
S01011312,All households,493,123,67,56,362,101,240,119,88,33,21,11,10,8,2,0,1,5
S01011312,Occupancy rating +2 or more,387,89,53,36,291,86,197,102,70,25,8,5,3,7,2,0,1,4
S01011312,Occupancy rating +1,72,28,11,17,44,15,24,13,8,3,5,1,4,0,0,0,0,0
S01011312,Occupancy rating 0,29,6,3,3,22,0,17,4,8,5,5,3,2,1,0,0,0,1
S01011312,Occupancy rating -1 or less,5,0,0,0,5,0,2,0,2,0,3,2,1,0,0,0,0,0
S01011313,All households,368,163,74,89,196,35,133,49,58,26,28,19,9,9,5,0,2,2
S01011313,Occupancy rating +2 or more,145,42,18,24,97,21,69,33,21,15,7,2,5,6,4,0,1,1
S01011313,Occupancy rating +1,116,62,19,43,53,7,41,12,22,7,5,4,1,1,0,0,0,1
S01011313,Occupancy rating 0,83,50,31,19,32,5,16,4,9,3,11,8,3,1,1,0,0,0
S01011313,Occupancy rating -1 or less,24,9,6,3,14,2,7,0,6,1,5,5,0,1,0,0,1,0
S01011314,All households,487,159,62,97,318,43,234,91,106,37,41,28,13,10,4,1,1,4
S01011314,Occupancy rating +2 or more,270,67,30,37,201,30,153,71,67,15,18,12,6,2,0,0,1,1
S01011314,Occupancy rating +1,118,51,19,32,65,9,49,17,19,13,7,6,1,2,2,0,0,0
S01011314,Occupancy rating 0,83,35,13,22,45,4,29,3,18,8,12,8,4,3,1,0,0,2
S01011314,Occupancy rating -1 or less,16,6,0,6,7,0,3,0,2,1,4,2,2,3,1,1,0,1
S01011315,All households,168,39,18,21,116,15,75,31,36,8,26,16,10,13,6,0,0,7
S01011315,Occupancy rating +2 or more,68,14,7,7,53,7,42,21,20,1,4,2,2,1,0,0,0,1
S01011315,Occupancy rating +1,47,19,6,13,27,7,18,7,5,6,2,0,2,1,1,0,0,0
S01011315,Occupancy rating 0,42,5,5,0,31,0,12,2,9,1,19,13,6,6,1,0,0,5
S01011315,Occupancy rating -1 or less,11,1,0,1,5,1,3,1,2,0,1,1,0,5,4,0,0,1
S01011316,All households,311,79,39,40,219,28,123,48,54,21,68,52,16,13,7,0,0,6
S01011316,Occupancy rating +2 or more,104,25,12,13,79,17,51,29,15,7,11,5,6,0,0,0,0,0
S01011316,Occupancy rating +1,99,32,14,18,63,8,39,15,15,9,16,11,5,4,2,0,0,2
S01011316,Occupancy rating 0,75,18,10,8,54,2,24,3,18,3,28,24,4,3,2,0,0,1
S01011316,Occupancy rating -1 or less,33,4,3,1,23,1,9,1,6,2,13,12,1,6,3,0,0,3
S01011317,All households,392,165,119,46,222,74,139,72,49,18,9,7,2,5,2,0,1,2
S01011317,Occupancy rating +2 or more,222,76,54,22,144,54,90,51,26,13,0,0,0,2,1,0,0,1
S01011317,Occupancy rating +1,114,63,52,11,49,16,28,15,11,2,5,4,1,2,0,0,1,1
S01011317,Occupancy rating 0,44,21,10,11,23,4,16,5,8,3,3,2,1,0,0,0,0,0
S01011317,Occupancy rating -1 or less,12,5,3,2,6,0,5,1,4,0,1,1,0,1,1,0,0,0
S01011318,All households,520,255,152,103,259,90,140,75,45,20,29,17,12,6,2,0,3,1
S01011318,Occupancy rating +2 or more,206,77,56,21,129,43,77,42,25,10,9,5,4,0,0,0,0,0
S01011318,Occupancy rating +1,157,86,52,34,69,29,31,17,10,4,9,5,4,2,1,0,1,0
S01011318,Occupancy rating 0,127,77,35,42,48,17,27,16,5,6,4,2,2,2,0,0,2,0
S01011318,Occupancy rating -1 or less,30,15,9,6,13,1,5,0,5,0,7,5,2,2,1,0,0,1
S01011319,All households,398,137,107,30,253,72,168,69,66,33,13,7,6,8,2,0,2,4
S01011319,Occupancy rating +2 or more,225,43,28,15,177,51,116,56,40,20,10,4,6,5,0,0,2,3
S01011319,Occupancy rating +1,77,30,20,10,46,8,37,11,16,10,1,1,0,1,0,0,0,1
S01011319,Occupancy rating 0,79,51,47,4,26,11,14,2,9,3,1,1,0,2,2,0,0,0
S01011319,Occupancy rating -1 or less,17,13,12,1,4,2,1,0,1,0,1,1,0,0,0,0,0,0
S01011320,All households,303,171,92,79,126,33,75,30,38,7,18,7,11,6,0,0,1,5
S01011320,Occupancy rating +2 or more,76,27,20,7,49,12,32,17,13,2,5,4,1,0,0,0,0,0
S01011320,Occupancy rating +1,81,43,25,18,35,15,18,6,10,2,2,2,0,3,0,0,0,3
S01011320,Occupancy rating 0,123,91,41,50,32,6,20,7,10,3,6,1,5,0,0,0,0,0
S01011320,Occupancy rating -1 or less,23,10,6,4,10,0,5,0,5,0,5,0,5,3,0,0,1,2
S01011321,All households,252,69,25,44,181,18,132,48,57,27,31,23,8,2,0,0,0,2
S01011321,Occupancy rating +2 or more,76,21,7,14,55,10,43,24,14,5,2,1,1,0,0,0,0,0
S01011321,Occupancy rating +1,83,30,14,16,51,6,39,19,12,8,6,4,2,2,0,0,0,2
S01011321,Occupancy rating 0,61,15,2,13,46,1,32,3,19,10,13,11,2,0,0,0,0,0
S01011321,Occupancy rating -1 or less,32,3,2,1,29,1,18,2,12,4,10,7,3,0,0,0,0,0
S01011322,All households,251,67,28,39,179,15,135,40,74,21,29,17,12,5,1,0,0,4
S01011322,Occupancy rating +2 or more,112,25,14,11,87,10,72,27,31,14,5,4,1,0,0,0,0,0
S01011322,Occupancy rating +1,81,35,13,22,44,3,32,12,18,2,9,4,5,2,0,0,0,2
S01011322,Occupancy rating 0,43,5,1,4,37,1,25,1,20,4,11,6,5,1,0,0,0,1
S01011322,Occupancy rating -1 or less,15,2,0,2,11,1,6,0,5,1,4,3,1,2,1,0,0,1
S01011323,All households,374,96,29,67,268,25,169,46,94,29,74,43,31,10,5,0,0,5
S01011323,Occupancy rating +2 or more,92,27,12,15,65,9,52,27,18,7,4,3,1,0,0,0,0,0
S01011323,Occupancy rating +1,129,50,13,37,77,14,49,13,28,8,14,6,8,2,0,0,0,2
S01011323,Occupancy rating 0,125,13,2,11,107,1,57,5,41,11,49,29,20,5,2,0,0,3
S01011323,Occupancy rating -1 or less,28,6,2,4,19,1,11,1,7,3,7,5,2,3,3,0,0,0
S01011324,All households,202,73,29,44,123,14,87,36,33,18,22,12,10,6,2,0,1,3
S01011324,Occupancy rating +2 or more,77,18,11,7,54,8,41,24,12,5,5,2,3,5,2,0,1,2
S01011324,Occupancy rating +1,59,27,14,13,32,6,22,6,8,8,4,1,3,0,0,0,0,0
S01011324,Occupancy rating 0,51,21,4,17,29,0,21,5,11,5,8,5,3,1,0,0,0,1
S01011324,Occupancy rating -1 or less,15,7,0,7,8,0,3,1,2,0,5,4,1,0,0,0,0,0
S01011325,All households,472,291,104,187,169,21,92,56,27,9,56,37,19,12,2,1,1,8
S01011325,Occupancy rating +2 or more,34,18,9,9,15,3,11,8,2,1,1,0,1,1,0,0,0,1
S01011325,Occupancy rating +1,139,92,39,53,46,7,29,25,0,4,10,6,4,1,0,0,0,1
S01011325,Occupancy rating 0,197,123,44,79,69,9,40,18,20,2,20,10,10,5,1,1,0,3
S01011325,Occupancy rating -1 or less,102,58,12,46,39,2,12,5,5,2,25,21,4,5,1,0,1,3
S01011326,All households,521,349,151,198,163,38,75,52,20,3,50,31,19,9,2,0,2,5
S01011326,Occupancy rating +2 or more,53,25,13,12,26,7,16,9,4,3,3,1,2,2,1,0,1,0
S01011326,Occupancy rating +1,156,109,55,54,47,15,23,19,4,0,9,6,3,0,0,0,0,0
S01011326,Occupancy rating 0,224,161,63,98,60,13,26,20,6,0,21,10,11,3,0,0,1,2
S01011326,Occupancy rating -1 or less,88,54,20,34,30,3,10,4,6,0,17,14,3,4,1,0,0,3
S01011327,All households,400,215,109,106,181,46,109,79,22,8,26,12,14,4,3,0,1,0
S01011327,Occupancy rating +2 or more,107,29,21,8,76,26,44,33,9,2,6,1,5,2,1,0,1,0
S01011327,Occupancy rating +1,86,42,24,18,44,8,30,25,2,3,6,4,2,0,0,0,0,0
S01011327,Occupancy rating 0,127,89,43,46,38,8,22,13,7,2,8,3,5,0,0,0,0,0
S01011327,Occupancy rating -1 or less,80,55,21,34,23,4,13,8,4,1,6,4,2,2,2,0,0,0
S01011328,All households,355,148,78,70,193,50,123,62,48,13,20,15,5,14,7,0,0,7
S01011328,Occupancy rating +2 or more,182,75,45,30,101,32,62,41,16,5,7,3,4,6,1,0,0,5
S01011328,Occupancy rating +1,89,34,21,13,52,13,37,17,16,4,2,2,0,3,3,0,0,0
S01011328,Occupancy rating 0,59,24,7,17,31,3,20,4,12,4,8,7,1,4,2,0,0,2
S01011328,Occupancy rating -1 or less,25,15,5,10,9,2,4,0,4,0,3,3,0,1,1,0,0,0
S01011329,All households,484,222,127,95,246,68,132,63,43,26,46,31,15,16,6,0,1,9
S01011329,Occupancy rating +2 or more,190,54,39,15,130,41,81,39,26,16,8,3,5,6,3,0,0,3
S01011329,Occupancy rating +1,147,86,44,42,57,22,29,19,8,2,6,3,3,4,2,0,0,2
S01011329,Occupancy rating 0,117,67,42,25,44,4,18,2,9,7,22,17,5,6,1,0,1,4
S01011329,Occupancy rating -1 or less,30,15,2,13,15,1,4,3,0,1,10,8,2,0,0,0,0,0
S01011330,All households,324,91,60,31,223,48,153,57,69,27,22,12,10,10,4,0,1,5
S01011330,Occupancy rating +2 or more,213,61,41,20,147,44,97,45,36,16,6,2,4,5,3,0,0,2
S01011330,Occupancy rating +1,67,24,15,9,40,4,33,12,15,6,3,1,2,3,1,0,1,1
S01011330,Occupancy rating 0,33,6,4,2,25,0,14,0,11,3,11,7,4,2,0,0,0,2
S01011330,Occupancy rating -1 or less,11,0,0,0,11,0,9,0,7,2,2,2,0,0,0,0,0,0
S01011331,All households,336,89,70,19,242,67,162,76,63,23,13,7,6,5,1,0,1,3
S01011331,Occupancy rating +2 or more,241,52,40,12,188,50,136,72,50,14,2,1,1,1,0,0,0,1
S01011331,Occupancy rating +1,77,33,27,6,42,16,20,4,10,6,6,3,3,2,0,0,0,2
S01011331,Occupancy rating 0,11,3,3,0,6,0,4,0,1,3,2,1,1,2,1,0,1,0
S01011331,Occupancy rating -1 or less,7,1,0,1,6,1,2,0,2,0,3,2,1,0,0,0,0,0
S01011332,All households,385,76,50,26,300,83,197,102,63,32,20,13,7,9,1,0,4,4
S01011332,Occupancy rating +2 or more,278,53,36,17,220,69,145,83,39,23,6,2,4,5,0,0,3,2
S01011332,Occupancy rating +1,81,22,13,9,57,11,39,19,15,5,7,5,2,2,0,0,0,2
S01011332,Occupancy rating 0,22,1,1,0,19,0,12,0,9,3,7,6,1,2,1,0,1,0
S01011332,Occupancy rating -1 or less,4,0,0,0,4,3,1,0,0,1,0,0,0,0,0,0,0,0
S01011333,All households,386,161,113,48,218,77,135,71,36,28,6,2,4,7,1,0,3,3
S01011333,Occupancy rating +2 or more,226,60,43,17,162,52,106,55,27,24,4,1,3,4,1,0,1,2
S01011333,Occupancy rating +1,100,60,43,17,38,19,18,14,2,2,1,0,1,2,0,0,1,1
S01011333,Occupancy rating 0,50,36,24,12,13,4,8,1,6,1,1,1,0,1,0,0,1,0
S01011333,Occupancy rating -1 or less,10,5,3,2,5,2,3,1,1,1,0,0,0,0,0,0,0,0
S01011334,All households,297,73,41,32,207,26,161,81,55,25,20,10,10,17,7,0,1,9
S01011334,Occupancy rating +2 or more,198,36,16,20,155,23,122,67,40,15,10,5,5,7,3,0,0,4
S01011334,Occupancy rating +1,45,14,9,5,27,2,21,10,9,2,4,3,1,4,3,0,1,0
S01011334,Occupancy rating 0,36,14,11,3,18,1,13,2,6,5,4,2,2,4,0,0,0,4
S01011334,Occupancy rating -1 or less,18,9,5,4,7,0,5,2,0,3,2,0,2,2,1,0,0,1
S01011335,All households,438,122,82,40,306,77,207,117,67,23,22,13,9,10,3,0,3,4
S01011335,Occupancy rating +2 or more,264,44,29,15,217,59,149,84,49,16,9,6,3,3,2,0,0,1
S01011335,Occupancy rating +1,86,32,12,20,50,11,35,22,7,6,4,1,3,4,0,0,2,2
S01011335,Occupancy rating 0,63,34,32,2,26,4,18,10,7,1,4,2,2,3,1,0,1,1
S01011335,Occupancy rating -1 or less,25,12,9,3,13,3,5,1,4,0,5,4,1,0,0,0,0,0
S01011336,All households,266,86,39,47,165,26,101,35,59,7,38,26,12,15,5,0,2,8
S01011336,Occupancy rating +2 or more,101,31,16,15,67,19,43,22,19,2,5,3,2,3,1,0,0,2
S01011336,Occupancy rating +1,67,35,15,20,29,3,20,7,11,2,6,3,3,3,0,0,1,2
S01011336,Occupancy rating 0,71,17,8,9,51,3,29,6,21,2,19,13,6,3,1,0,1,1
S01011336,Occupancy rating -1 or less,27,3,0,3,18,1,9,0,8,1,8,7,1,6,3,0,0,3
S01011337,All households,287,53,27,26,226,46,170,89,50,31,10,4,6,8,3,0,0,5
S01011337,Occupancy rating +2 or more,211,32,16,16,173,37,133,73,36,24,3,1,2,6,2,0,0,4
S01011337,Occupancy rating +1,55,19,9,10,36,9,24,11,8,5,3,1,2,0,0,0,0,0
S01011337,Occupancy rating 0,16,1,1,0,14,0,11,4,5,2,3,1,2,1,0,0,0,1
S01011337,Occupancy rating -1 or less,5,1,1,0,3,0,2,1,1,0,1,1,0,1,1,0,0,0
S01011338,All households,270,60,19,41,198,21,133,49,57,27,44,37,7,12,5,0,1,6
S01011338,Occupancy rating +2 or more,112,18,6,12,91,16,71,41,18,12,4,4,0,3,0,0,1,2
S01011338,Occupancy rating +1,89,34,10,24,51,5,36,7,19,10,10,6,4,4,3,0,0,1
S01011338,Occupancy rating 0,61,6,2,4,51,0,23,1,17,5,28,25,3,4,1,0,0,3
S01011338,Occupancy rating -1 or less,8,2,1,1,5,0,3,0,3,0,2,2,0,1,1,0,0,0
S01011339,All households,219,52,27,25,151,16,89,31,40,18,46,36,10,16,8,0,1,7
S01011339,Occupancy rating +2 or more,103,33,18,15,62,13,46,25,13,8,3,1,2,8,4,0,1,3
S01011339,Occupancy rating +1,58,15,7,8,41,3,22,3,13,6,16,10,6,2,0,0,0,2
S01011339,Occupancy rating 0,39,2,1,1,36,0,18,3,12,3,18,16,2,1,1,0,0,0
S01011339,Occupancy rating -1 or less,19,2,1,1,12,0,3,0,2,1,9,9,0,5,3,0,0,2
S01011340,All households,290,89,41,48,186,22,110,40,50,20,54,29,25,15,5,0,1,9
S01011340,Occupancy rating +2 or more,107,45,25,20,61,12,44,36,6,2,5,1,4,1,0,0,0,1
S01011340,Occupancy rating +1,97,34,10,24,60,6,28,3,14,11,26,11,15,3,0,0,0,3
S01011340,Occupancy rating 0,63,10,6,4,50,3,25,1,19,5,22,16,6,3,0,0,0,3
S01011340,Occupancy rating -1 or less,23,0,0,0,15,1,13,0,11,2,1,1,0,8,5,0,1,2
S01011341,All households,346,145,53,92,187,10,130,50,58,22,47,35,12,14,5,0,0,9
S01011341,Occupancy rating +2 or more,108,29,12,17,76,5,65,32,22,11,6,3,3,3,1,0,0,2
S01011341,Occupancy rating +1,95,37,12,25,55,3,37,10,20,7,15,15,0,3,1,0,0,2
S01011341,Occupancy rating 0,116,69,25,44,41,2,21,8,10,3,18,12,6,6,2,0,0,4
S01011341,Occupancy rating -1 or less,27,10,4,6,15,0,7,0,6,1,8,5,3,2,1,0,0,1
S01011342,All households,325,121,48,73,197,32,138,61,55,22,27,20,7,7,3,0,1,3
S01011342,Occupancy rating +2 or more,148,41,19,22,104,22,80,41,30,9,2,2,0,3,0,0,1,2
S01011342,Occupancy rating +1,89,46,16,30,41,3,30,12,13,5,8,6,2,2,2,0,0,0
S01011342,Occupancy rating 0,71,27,12,15,42,7,24,7,10,7,11,7,4,2,1,0,0,1
S01011342,Occupancy rating -1 or less,17,7,1,6,10,0,4,1,2,1,6,5,1,0,0,0,0,0
S01011343,All households,434,203,64,139,210,27,125,60,45,20,58,38,20,21,8,0,3,10
S01011343,Occupancy rating +2 or more,88,42,15,27,43,9,28,18,8,2,6,1,5,3,2,0,0,1
S01011343,Occupancy rating +1,158,90,28,62,65,12,42,24,11,7,11,6,5,3,0,0,0,3
S01011343,Occupancy rating 0,143,54,16,38,83,5,48,18,20,10,30,22,8,6,1,0,2,3
S01011343,Occupancy rating -1 or less,45,17,5,12,19,1,7,0,6,1,11,9,2,9,5,0,1,3
S01011344,All households,401,129,56,73,262,37,136,46,60,30,89,62,27,10,5,0,1,4
S01011344,Occupancy rating +2 or more,78,32,20,12,46,16,28,18,7,3,2,1,1,0,0,0,0,0
S01011344,Occupancy rating +1,143,62,25,37,79,17,38,21,10,7,24,16,8,2,0,0,1,1
S01011344,Occupancy rating 0,125,29,9,20,94,2,48,5,29,14,44,31,13,2,1,0,0,1
S01011344,Occupancy rating -1 or less,55,6,2,4,43,2,22,2,14,6,19,14,5,6,4,0,0,2
S01011345,All households,357,124,44,80,223,10,115,36,54,25,98,71,27,10,5,0,2,3
S01011345,Occupancy rating +2 or more,73,39,11,28,32,6,24,17,5,2,2,2,0,2,0,0,1,1
S01011345,Occupancy rating +1,116,59,19,40,55,2,32,15,8,9,21,13,8,2,0,0,1,1
S01011345,Occupancy rating 0,124,17,10,7,106,2,42,2,29,11,62,46,16,1,0,0,0,1
S01011345,Occupancy rating -1 or less,44,9,4,5,30,0,17,2,12,3,13,10,3,5,5,0,0,0
S01011346,All households,325,107,53,54,210,27,130,59,46,25,53,33,20,8,5,0,1,2
S01011346,Occupancy rating +2 or more,62,23,11,12,39,10,25,20,4,1,4,1,3,0,0,0,0,0
S01011346,Occupancy rating +1,134,62,31,31,72,11,50,33,9,8,11,4,7,0,0,0,0,0
S01011346,Occupancy rating 0,103,18,8,10,81,5,42,5,26,11,34,26,8,4,2,0,0,2
S01011346,Occupancy rating -1 or less,26,4,3,1,18,1,13,1,7,5,4,2,2,4,3,0,1,0
S01011347,All households,547,259,100,159,274,42,182,77,73,32,50,32,18,14,5,0,2,7
S01011347,Occupancy rating +2 or more,129,38,19,19,90,17,64,38,15,11,9,5,4,1,0,0,0,1
S01011347,Occupancy rating +1,198,114,50,64,80,19,53,29,13,11,8,4,4,4,1,0,1,2
S01011347,Occupancy rating 0,175,93,28,65,77,5,52,10,33,9,20,14,6,5,0,0,1,4
S01011347,Occupancy rating -1 or less,45,14,3,11,27,1,13,0,12,1,13,9,4,4,4,0,0,0
S01011348,All households,424,157,64,93,253,28,165,64,72,29,60,43,17,14,6,0,1,7
S01011348,Occupancy rating +2 or more,120,45,17,28,73,7,62,39,13,10,4,0,4,2,1,0,0,1
S01011348,Occupancy rating +1,133,52,17,35,78,14,54,20,25,9,10,4,6,3,1,0,0,2
S01011348,Occupancy rating 0,146,51,28,23,90,6,44,3,31,10,40,34,6,5,3,0,1,1
S01011348,Occupancy rating -1 or less,25,9,2,7,12,1,5,2,3,0,6,5,1,4,1,0,0,3
S01011349,All households,367,91,17,74,267,17,227,76,116,35,23,12,11,9,5,0,0,4
S01011349,Occupancy rating +2 or more,165,24,8,16,140,14,121,40,57,24,5,2,3,1,0,0,0,1
S01011349,Occupancy rating +1,118,39,6,33,74,1,63,28,28,7,10,4,6,5,5,0,0,0
S01011349,Occupancy rating 0,64,25,3,22,37,2,29,6,20,3,6,5,1,2,0,0,0,2
S01011349,Occupancy rating -1 or less,20,3,0,3,16,0,14,2,11,1,2,1,1,1,0,0,0,1
S01011350,All households,275,61,37,24,202,37,148,65,60,23,17,6,11,12,6,0,1,5
S01011350,Occupancy rating +2 or more,171,33,22,11,131,26,101,56,28,17,4,1,3,7,2,0,1,4
S01011350,Occupancy rating +1,73,17,9,8,54,10,35,9,22,4,9,3,6,2,1,0,0,1
S01011350,Occupancy rating 0,20,9,5,4,9,1,7,0,6,1,1,1,0,2,2,0,0,0
S01011350,Occupancy rating -1 or less,11,2,1,1,8,0,5,0,4,1,3,1,2,1,1,0,0,0
S01011351,All households,353,156,52,104,190,18,117,48,52,17,55,33,22,7,2,0,0,5
S01011351,Occupancy rating +2 or more,59,23,12,11,36,8,27,21,5,1,1,1,0,0,0,0,0,0
S01011351,Occupancy rating +1,122,67,21,46,53,7,36,19,10,7,10,3,7,2,0,0,0,2
S01011351,Occupancy rating 0,133,46,16,30,84,3,46,7,31,8,35,24,11,3,1,0,0,2
S01011351,Occupancy rating -1 or less,39,20,3,17,17,0,8,1,6,1,9,5,4,2,1,0,0,1
S01011352,All households,328,149,61,88,168,24,111,51,42,18,33,20,13,11,6,0,0,5
S01011352,Occupancy rating +2 or more,90,27,10,17,60,9,45,24,16,5,6,3,3,3,2,0,0,1
S01011352,Occupancy rating +1,108,50,16,34,55,8,35,15,14,6,12,6,6,3,3,0,0,0
S01011352,Occupancy rating 0,100,59,30,29,38,7,21,8,8,5,10,6,4,3,0,0,0,3
S01011352,Occupancy rating -1 or less,30,13,5,8,15,0,10,4,4,2,5,5,0,2,1,0,0,1
S01011353,All households,274,86,36,50,182,18,132,47,45,40,32,21,11,6,1,0,0,5
S01011353,Occupancy rating +2 or more,98,38,19,19,60,7,51,32,12,7,2,1,1,0,0,0,0,0
S01011353,Occupancy rating +1,88,26,5,21,60,9,46,11,13,22,5,3,2,2,0,0,0,2
S01011353,Occupancy rating 0,67,19,12,7,46,2,26,3,15,8,18,10,8,2,1,0,0,1
S01011353,Occupancy rating -1 or less,21,3,0,3,16,0,9,1,5,3,7,7,0,2,0,0,0,2
S01011354,All households,313,80,40,40,221,34,145,58,53,34,42,28,14,12,8,0,0,4
S01011354,Occupancy rating +2 or more,169,50,27,23,115,27,80,46,19,15,8,1,7,4,2,0,0,2
S01011354,Occupancy rating +1,78,23,10,13,50,7,31,10,10,11,12,10,2,5,3,0,0,2
S01011354,Occupancy rating 0,46,4,1,3,41,0,22,1,13,8,19,14,5,1,1,0,0,0
S01011354,Occupancy rating -1 or less,20,3,2,1,15,0,12,1,11,0,3,3,0,2,2,0,0,0
S01011355,All households,433,153,81,72,269,46,180,80,75,25,43,22,21,11,3,0,1,7
S01011355,Occupancy rating +2 or more,174,45,24,21,126,30,89,56,23,10,7,4,3,3,1,0,1,1
S01011355,Occupancy rating +1,123,51,18,33,68,12,41,15,15,11,15,4,11,4,1,0,0,3
S01011355,Occupancy rating 0,105,46,31,15,57,3,38,7,27,4,16,10,6,2,1,0,0,1
S01011355,Occupancy rating -1 or less,31,11,8,3,18,1,12,2,10,0,5,4,1,2,0,0,0,2
S01011356,All households,392,88,34,54,287,38,219,95,85,39,30,14,16,17,10,0,0,7
S01011356,Occupancy rating +2 or more,254,52,22,30,195,34,150,73,52,25,11,4,7,7,5,0,0,2
S01011356,Occupancy rating +1,81,20,8,12,56,4,44,16,19,9,8,4,4,5,3,0,0,2
S01011356,Occupancy rating 0,40,14,3,11,22,0,14,3,8,3,8,4,4,4,2,0,0,2
S01011356,Occupancy rating -1 or less,17,2,1,1,14,0,11,3,6,2,3,2,1,1,0,0,0,1
S01011357,All households,354,90,50,40,252,47,172,65,75,32,33,20,13,12,4,0,1,7
S01011357,Occupancy rating +2 or more,145,24,12,12,119,24,87,37,40,10,8,3,5,2,0,0,0,2
S01011357,Occupancy rating +1,96,32,15,17,61,17,34,19,11,4,10,5,5,3,1,0,0,2
S01011357,Occupancy rating 0,86,28,21,7,54,4,35,6,16,13,15,12,3,4,2,0,0,2
S01011357,Occupancy rating -1 or less,27,6,2,4,18,2,16,3,8,5,0,0,0,3,1,0,1,1
S01011358,All households,186,16,5,11,161,5,136,40,71,25,20,14,6,9,5,0,0,4
S01011358,Occupancy rating +2 or more,121,13,5,8,103,3,91,34,44,13,9,7,2,5,2,0,0,3
S01011358,Occupancy rating +1,49,3,0,3,43,1,33,4,20,9,9,7,2,3,2,0,0,1
S01011358,Occupancy rating 0,14,0,0,0,13,1,10,2,7,1,2,0,2,1,1,0,0,0
S01011358,Occupancy rating -1 or less,2,0,0,0,2,0,2,0,0,2,0,0,0,0,0,0,0,0
S01011359,All households,368,146,69,77,212,40,141,73,44,24,31,12,19,10,7,0,0,3
S01011359,Occupancy rating +2 or more,86,28,15,13,56,16,37,22,10,5,3,1,2,2,0,0,0,2
S01011359,Occupancy rating +1,131,49,28,21,80,18,51,33,9,9,11,4,7,2,2,0,0,0
S01011359,Occupancy rating 0,120,56,21,35,62,4,43,16,20,7,15,6,9,2,1,0,0,1
S01011359,Occupancy rating -1 or less,31,13,5,8,14,2,10,2,5,3,2,1,1,4,4,0,0,0
S01011360,All households,354,130,12,118,209,11,127,46,64,17,71,56,15,15,2,0,0,13
S01011360,Occupancy rating +2 or more,55,19,4,15,35,10,19,15,3,1,6,4,2,1,0,0,0,1
S01011360,Occupancy rating +1,119,51,3,48,65,0,48,24,18,6,17,12,5,3,0,0,0,3
S01011360,Occupancy rating 0,128,42,5,37,81,1,42,5,30,7,38,32,6,5,0,0,0,5
S01011360,Occupancy rating -1 or less,52,18,0,18,28,0,18,2,13,3,10,8,2,6,2,0,0,4
S01011361,All households,343,223,35,188,112,10,63,31,26,6,39,25,14,8,3,0,0,5
S01011361,Occupancy rating +2 or more,27,17,4,13,10,1,5,4,1,0,4,4,0,0,0,0,0,0
S01011361,Occupancy rating +1,164,117,21,96,47,7,28,20,6,2,12,8,4,0,0,0,0,0
S01011361,Occupancy rating 0,116,68,7,61,43,1,23,6,14,3,19,12,7,5,1,0,0,4
S01011361,Occupancy rating -1 or less,36,21,3,18,12,1,7,1,5,1,4,1,3,3,2,0,0,1
S01011362,All households,199,27,13,14,159,8,140,47,78,15,11,4,7,13,7,0,0,6
S01011362,Occupancy rating +2 or more,146,17,7,10,121,6,110,44,56,10,5,2,3,8,4,0,0,4
S01011362,Occupancy rating +1,29,4,2,2,23,2,17,0,14,3,4,1,3,2,1,0,0,1
S01011362,Occupancy rating 0,14,2,1,1,11,0,9,2,5,2,2,1,1,1,1,0,0,0
S01011362,Occupancy rating -1 or less,10,4,3,1,4,0,4,1,3,0,0,0,0,2,1,0,0,1
S01011363,All households,429,180,70,110,226,30,163,75,59,29,33,24,9,23,8,0,4,11
S01011363,Occupancy rating +2 or more,136,33,17,16,98,19,77,49,15,13,2,2,0,5,2,0,1,2
S01011363,Occupancy rating +1,135,77,25,52,53,8,39,21,13,5,6,3,3,5,2,0,0,3
S01011363,Occupancy rating 0,119,57,22,35,54,3,33,3,23,7,18,15,3,8,3,0,1,4
S01011363,Occupancy rating -1 or less,39,13,6,7,21,0,14,2,8,4,7,4,3,5,1,0,2,2
S01011364,All households,272,67,28,39,197,36,135,48,67,20,26,17,9,8,3,0,0,5
S01011364,Occupancy rating +2 or more,105,25,11,14,77,20,53,27,23,3,4,2,2,3,2,0,0,1
S01011364,Occupancy rating +1,100,30,14,16,67,13,44,20,14,10,10,8,2,3,1,0,0,2
S01011364,Occupancy rating 0,49,9,2,7,38,2,26,1,21,4,10,5,5,2,0,0,0,2
S01011364,Occupancy rating -1 or less,18,3,1,2,15,1,12,0,9,3,2,2,0,0,0,0,0,0
S01011365,All households,207,15,7,8,182,8,151,35,96,20,23,15,8,10,8,0,0,2
S01011365,Occupancy rating +2 or more,128,9,3,6,113,5,97,25,62,10,11,7,4,6,5,0,0,1
S01011365,Occupancy rating +1,53,5,3,2,45,3,38,9,24,5,4,3,1,3,2,0,0,1
S01011365,Occupancy rating 0,20,0,0,0,20,0,15,1,10,4,5,2,3,0,0,0,0,0
S01011365,Occupancy rating -1 or less,6,1,1,0,4,0,1,0,0,1,3,3,0,1,1,0,0,0
S01011366,All households,238,101,44,57,130,29,80,47,26,7,21,9,12,7,1,0,0,6
S01011366,Occupancy rating +2 or more,31,11,5,6,20,5,13,13,0,0,2,1,1,0,0,0,0,0
S01011366,Occupancy rating +1,128,65,29,36,61,20,34,31,2,1,7,3,4,2,0,0,0,2
S01011366,Occupancy rating 0,60,21,10,11,35,2,22,1,15,6,11,4,7,4,0,0,0,4
S01011366,Occupancy rating -1 or less,19,4,0,4,14,2,11,2,9,0,1,1,0,1,1,0,0,0
S01011367,All households,400,150,68,82,239,30,148,57,61,30,61,40,21,11,4,0,0,7
S01011367,Occupancy rating +2 or more,91,39,21,18,52,10,39,26,7,6,3,2,1,0,0,0,0,0
S01011367,Occupancy rating +1,161,83,37,46,76,16,50,27,16,7,10,5,5,2,0,0,0,2
S01011367,Occupancy rating 0,115,20,7,13,91,4,46,3,28,15,41,31,10,4,1,0,0,3
S01011367,Occupancy rating -1 or less,33,8,3,5,20,0,13,1,10,2,7,2,5,5,3,0,0,2
S01011368,All households,291,28,2,26,252,4,224,65,130,29,24,17,7,11,3,0,0,8
S01011368,Occupancy rating +2 or more,200,14,1,13,181,3,169,51,97,21,9,4,5,5,2,0,0,3
S01011368,Occupancy rating +1,58,13,1,12,42,1,37,12,20,5,4,3,1,3,0,0,0,3
S01011368,Occupancy rating 0,31,1,0,1,28,0,18,2,13,3,10,9,1,2,0,0,0,2
S01011368,Occupancy rating -1 or less,2,0,0,0,1,0,0,0,0,0,1,1,0,1,1,0,0,0
S01011369,All households,380,150,55,95,206,30,133,41,68,24,43,25,18,24,12,0,2,10
S01011369,Occupancy rating +2 or more,118,53,31,22,62,24,32,21,10,1,6,1,5,3,2,0,1,0
S01011369,Occupancy rating +1,140,57,17,40,73,6,52,17,23,12,15,7,8,10,4,0,1,5
S01011369,Occupancy rating 0,102,35,7,28,60,0,42,3,28,11,18,13,5,7,2,0,0,5
S01011369,Occupancy rating -1 or less,20,5,0,5,11,0,7,0,7,0,4,4,0,4,4,0,0,0
S01011370,All households,307,54,25,29,234,12,197,78,102,17,25,14,11,19,8,0,1,10
S01011370,Occupancy rating +2 or more,181,31,17,14,145,5,134,63,67,4,6,3,3,5,4,0,0,1
S01011370,Occupancy rating +1,61,17,6,11,39,6,29,8,16,5,4,2,2,5,0,0,1,4
S01011370,Occupancy rating 0,51,6,2,4,38,0,26,5,15,6,12,7,5,7,3,0,0,4
S01011370,Occupancy rating -1 or less,14,0,0,0,12,1,8,2,4,2,3,2,1,2,1,0,0,1
S01011371,All households,503,256,72,184,235,21,139,61,61,17,75,51,24,12,5,0,4,3
S01011371,Occupancy rating +2 or more,60,17,2,15,42,3,36,17,16,3,3,2,1,1,1,0,0,0
S01011371,Occupancy rating +1,210,122,49,73,87,17,58,38,14,6,12,7,5,1,0,0,1,0
S01011371,Occupancy rating 0,186,97,15,82,83,0,37,5,26,6,46,35,11,6,1,0,3,2
S01011371,Occupancy rating -1 or less,47,20,6,14,23,1,8,1,5,2,14,7,7,4,3,0,0,1
S01011372,All households,411,243,66,177,150,22,78,39,36,3,50,29,21,18,7,1,2,8
S01011372,Occupancy rating +2 or more,28,17,5,12,11,0,9,6,3,0,2,1,1,0,0,0,0,0
S01011372,Occupancy rating +1,173,120,37,83,53,21,28,24,4,0,4,1,3,0,0,0,0,0
S01011372,Occupancy rating 0,159,84,15,69,69,1,32,8,22,2,36,20,16,6,1,1,1,3
S01011372,Occupancy rating -1 or less,51,22,9,13,17,0,9,1,7,1,8,7,1,12,6,0,1,5
S01011373,All households,350,165,47,118,172,14,103,45,41,17,55,37,18,13,6,0,0,7
S01011373,Occupancy rating +2 or more,65,30,16,14,35,4,29,19,6,4,2,1,1,0,0,0,0,0
S01011373,Occupancy rating +1,150,90,21,69,59,9,37,22,10,5,13,10,3,1,0,0,0,1
S01011373,Occupancy rating 0,96,34,9,25,56,0,27,3,18,6,29,18,11,6,2,0,0,4
S01011373,Occupancy rating -1 or less,39,11,1,10,22,1,10,1,7,2,11,8,3,6,4,0,0,2
S01011374,All households,276,62,15,47,208,8,160,46,92,22,40,24,16,6,1,0,0,5
S01011374,Occupancy rating +2 or more,91,19,5,14,71,3,61,28,26,7,7,5,2,1,0,0,0,1
S01011374,Occupancy rating +1,107,35,6,29,70,5,52,15,30,7,13,7,6,2,0,0,0,2
S01011374,Occupancy rating 0,59,3,0,3,55,0,39,3,29,7,16,9,7,1,0,0,0,1
S01011374,Occupancy rating -1 or less,19,5,4,1,12,0,8,0,7,1,4,3,1,2,1,0,0,1
S01011375,All households,295,113,31,82,177,20,114,36,53,25,43,18,25,5,3,0,0,2
S01011375,Occupancy rating +2 or more,98,24,11,13,74,19,51,23,18,10,4,1,3,0,0,0,0,0
S01011375,Occupancy rating +1,110,60,13,47,49,1,37,12,16,9,11,1,10,1,1,0,0,0
S01011375,Occupancy rating 0,70,22,5,17,45,0,23,1,16,6,22,10,12,3,1,0,0,2
S01011375,Occupancy rating -1 or less,17,7,2,5,9,0,3,0,3,0,6,6,0,1,1,0,0,0
S01011376,All households,326,210,93,117,111,20,59,38,16,5,32,22,10,5,0,0,0,5
S01011376,Occupancy rating +2 or more,13,7,2,5,6,0,6,2,2,2,0,0,0,0,0,0,0,0
S01011376,Occupancy rating +1,191,138,64,74,53,17,35,33,2,0,1,1,0,0,0,0,0,0
S01011376,Occupancy rating 0,95,49,17,32,41,1,15,2,11,2,25,17,8,5,0,0,0,5
S01011376,Occupancy rating -1 or less,27,16,10,6,11,2,3,1,1,1,6,4,2,0,0,0,0,0
S01011377,All households,262,81,37,44,179,26,135,50,52,33,18,9,9,2,1,0,1,0
S01011377,Occupancy rating +2 or more,165,36,24,12,128,23,97,34,41,22,8,3,5,1,1,0,0,0
S01011377,Occupancy rating +1,59,27,6,21,32,2,26,13,7,6,4,3,1,0,0,0,0,0
S01011377,Occupancy rating 0,26,14,6,8,12,1,7,2,1,4,4,2,2,0,0,0,0,0
S01011377,Occupancy rating -1 or less,12,4,1,3,7,0,5,1,3,1,2,1,1,1,0,0,1,0
S01011378,All households,362,111,71,40,245,67,148,48,62,38,30,15,15,6,2,0,3,1
S01011378,Occupancy rating +2 or more,152,37,22,15,114,31,77,30,35,12,6,3,3,1,0,0,0,1
S01011378,Occupancy rating +1,121,45,31,14,73,25,39,15,11,13,9,4,5,3,0,0,3,0
S01011378,Occupancy rating 0,76,26,15,11,48,7,29,3,13,13,12,6,6,2,2,0,0,0
S01011378,Occupancy rating -1 or less,13,3,3,0,10,4,3,0,3,0,3,2,1,0,0,0,0,0
S01011379,All households,342,65,25,40,266,27,218,72,97,49,21,13,8,11,6,0,1,4
S01011379,Occupancy rating +2 or more,235,36,16,20,191,24,156,57,70,29,11,7,4,8,5,0,1,2
S01011379,Occupancy rating +1,80,28,8,20,52,3,44,15,16,13,5,3,2,0,0,0,0,0
S01011379,Occupancy rating 0,20,0,0,0,18,0,15,0,10,5,3,1,2,2,0,0,0,2
S01011379,Occupancy rating -1 or less,7,1,1,0,5,0,3,0,1,2,2,2,0,1,1,0,0,0
S01011380,All households,357,175,60,115,174,26,113,45,50,18,35,16,19,8,2,0,0,6
S01011380,Occupancy rating +2 or more,99,46,24,22,51,13,33,16,13,4,5,3,2,2,1,0,0,1
S01011380,Occupancy rating +1,116,66,19,47,49,10,29,16,8,5,10,2,8,1,0,0,0,1
S01011380,Occupancy rating 0,121,54,16,38,63,3,44,12,23,9,16,8,8,4,0,0,0,4
S01011380,Occupancy rating -1 or less,21,9,1,8,11,0,7,1,6,0,4,3,1,1,1,0,0,0
S01011381,All households,302,120,43,77,176,29,121,56,48,17,26,15,11,6,1,0,0,5
S01011381,Occupancy rating +2 or more,93,16,11,5,75,13,57,26,21,10,5,1,4,2,0,0,0,2
S01011381,Occupancy rating +1,111,58,20,38,53,10,36,21,10,5,7,5,2,0,0,0,0,0
S01011381,Occupancy rating 0,65,28,7,21,35,5,18,7,9,2,12,8,4,2,1,0,0,1
S01011381,Occupancy rating -1 or less,33,18,5,13,13,1,10,2,8,0,2,1,1,2,0,0,0,2
S01011382,All households,286,135,28,107,136,5,86,44,38,4,45,35,10,15,4,1,1,9
S01011382,Occupancy rating +2 or more,45,14,5,9,30,2,27,11,15,1,1,1,0,1,0,0,0,1
S01011382,Occupancy rating +1,89,53,8,45,34,2,19,16,3,0,13,12,1,2,0,0,0,2
S01011382,Occupancy rating 0,109,52,10,42,51,1,31,17,11,3,19,12,7,6,2,0,1,3
S01011382,Occupancy rating -1 or less,43,16,5,11,21,0,9,0,9,0,12,10,2,6,2,1,0,3
S01011383,All households,394,213,62,151,172,19,81,38,36,7,72,46,26,9,1,0,0,8
S01011383,Occupancy rating +2 or more,55,28,13,15,25,4,15,11,4,0,6,4,2,2,0,0,0,2
S01011383,Occupancy rating +1,81,37,17,20,44,8,25,16,8,1,11,7,4,0,0,0,0,0
S01011383,Occupancy rating 0,207,122,26,96,82,6,31,9,16,6,45,30,15,3,1,0,0,2
S01011383,Occupancy rating -1 or less,51,26,6,20,21,1,10,2,8,0,10,5,5,4,0,0,0,4
S01011384,All households,328,118,22,96,192,8,93,38,44,11,91,67,24,18,8,0,2,8
S01011384,Occupancy rating +2 or more,54,34,5,29,18,2,14,10,3,1,2,2,0,2,0,0,0,2
S01011384,Occupancy rating +1,117,53,12,41,62,3,40,24,12,4,19,16,3,2,1,0,0,1
S01011384,Occupancy rating 0,104,14,1,13,83,1,27,3,20,4,55,39,16,7,2,0,1,4
S01011384,Occupancy rating -1 or less,53,17,4,13,29,2,12,1,9,2,15,10,5,7,5,0,1,1
S01011385,All households,441,162,73,89,255,15,136,54,48,34,104,65,39,24,6,0,1,17
S01011385,Occupancy rating +2 or more,79,36,15,21,42,7,30,24,3,3,5,3,2,1,0,0,0,1
S01011385,Occupancy rating +1,166,87,37,50,75,7,43,20,9,14,25,13,12,4,0,0,0,4
S01011385,Occupancy rating 0,128,26,14,12,92,1,42,7,24,11,49,31,18,10,0,0,1,9
S01011385,Occupancy rating -1 or less,68,13,7,6,46,0,21,3,12,6,25,18,7,9,6,0,0,3
S01011386,All households,208,36,8,28,153,8,75,19,35,21,70,49,21,19,14,0,0,5
S01011386,Occupancy rating +2 or more,58,16,6,10,41,6,26,17,6,3,9,5,4,1,0,0,0,1
S01011386,Occupancy rating +1,81,10,1,9,66,2,29,2,12,15,35,24,11,5,2,0,0,3
S01011386,Occupancy rating 0,46,8,1,7,32,0,15,0,12,3,17,13,4,6,6,0,0,0
S01011386,Occupancy rating -1 or less,23,2,0,2,14,0,5,0,5,0,9,7,2,7,6,0,0,1
S01011387,All households,366,151,48,103,188,14,109,37,49,23,65,48,17,27,11,0,2,14
S01011387,Occupancy rating +2 or more,102,38,18,20,60,11,47,21,20,6,2,1,1,4,1,0,0,3
S01011387,Occupancy rating +1,97,40,12,28,52,2,27,8,12,7,23,16,7,5,0,0,0,5
S01011387,Occupancy rating 0,122,60,13,47,53,1,26,4,14,8,26,20,6,9,5,0,0,4
S01011387,Occupancy rating -1 or less,45,13,5,8,23,0,9,4,3,2,14,11,3,9,5,0,2,2
S01011388,All households,435,109,23,86,314,11,268,95,147,26,35,30,5,12,7,0,0,5
S01011388,Occupancy rating +2 or more,157,21,3,18,132,4,120,52,59,9,8,6,2,4,2,0,0,2
S01011388,Occupancy rating +1,157,50,12,38,103,6,88,30,51,7,9,9,0,4,2,0,0,2
S01011388,Occupancy rating 0,92,28,7,21,60,1,47,11,29,7,12,9,3,4,3,0,0,1
S01011388,Occupancy rating -1 or less,29,10,1,9,19,0,13,2,8,3,6,6,0,0,0,0,0,0
S01011389,All households,415,191,73,118,193,22,120,62,37,21,51,34,17,31,2,12,2,15
S01011389,Occupancy rating +2 or more,64,22,7,15,41,10,29,15,6,8,2,1,1,1,1,0,0,0
S01011389,Occupancy rating +1,135,72,24,48,61,11,40,29,8,3,10,2,8,2,0,0,0,2
S01011389,Occupancy rating 0,156,57,20,37,81,1,43,17,18,8,37,30,7,18,0,8,2,8
S01011389,Occupancy rating -1 or less,60,40,22,18,10,0,8,1,5,2,2,1,1,10,1,4,0,5
S01011390,All households,342,109,51,58,207,24,133,40,54,39,50,25,25,26,16,0,2,8
S01011390,Occupancy rating +2 or more,111,50,22,28,59,17,38,26,8,4,4,1,3,2,1,0,0,1
S01011390,Occupancy rating +1,113,40,20,20,69,5,47,14,13,20,17,8,9,4,1,0,0,3
S01011390,Occupancy rating 0,83,15,7,8,59,2,38,0,23,15,19,10,9,9,6,0,2,1
S01011390,Occupancy rating -1 or less,35,4,2,2,20,0,10,0,10,0,10,6,4,11,8,0,0,3
S01011391,All households,254,52,25,27,183,19,111,35,48,28,53,35,18,19,13,0,0,6
S01011391,Occupancy rating +2 or more,69,27,16,11,39,10,28,23,3,2,1,0,1,3,1,0,0,2
S01011391,Occupancy rating +1,69,20,6,14,46,5,31,11,10,10,10,8,2,3,1,0,0,2
S01011391,Occupancy rating 0,86,2,2,0,76,4,39,0,25,14,33,21,12,8,6,0,0,2
S01011391,Occupancy rating -1 or less,30,3,1,2,22,0,13,1,10,2,9,6,3,5,5,0,0,0
S01011392,All households,287,83,25,58,196,21,117,37,53,27,58,38,20,8,3,0,1,4
S01011392,Occupancy rating +2 or more,59,27,8,19,30,8,16,13,3,0,6,2,4,2,1,0,0,1
S01011392,Occupancy rating +1,104,45,15,30,55,8,41,21,9,11,6,5,1,4,2,0,0,2
S01011392,Occupancy rating 0,84,7,0,7,75,5,40,0,30,10,30,17,13,2,0,0,1,1
S01011392,Occupancy rating -1 or less,40,4,2,2,36,0,20,3,11,6,16,14,2,0,0,0,0,0
S01011393,All households,374,138,68,70,220,35,142,57,58,27,43,21,22,16,8,0,1,7
S01011393,Occupancy rating +2 or more,112,34,22,12,75,17,52,31,15,6,6,2,4,3,3,0,0,0
S01011393,Occupancy rating +1,123,50,27,23,66,14,34,16,9,9,18,7,11,7,2,0,1,4
S01011393,Occupancy rating 0,103,41,12,29,59,1,45,10,24,11,13,7,6,3,2,0,0,1
S01011393,Occupancy rating -1 or less,36,13,7,6,20,3,11,0,10,1,6,5,1,3,1,0,0,2
S01011394,All households,212,53,29,24,153,3,134,23,98,13,16,11,5,6,4,0,0,2
S01011394,Occupancy rating +2 or more,144,20,6,14,121,0,109,20,81,8,12,8,4,3,3,0,0,0
S01011394,Occupancy rating +1,20,6,2,4,14,0,13,3,8,2,1,0,1,0,0,0,0,0
S01011394,Occupancy rating 0,36,19,14,5,15,2,11,0,9,2,2,2,0,2,0,0,0,2
S01011394,Occupancy rating -1 or less,12,8,7,1,3,1,1,0,0,1,1,1,0,1,1,0,0,0
S01011395,All households,409,190,63,127,204,26,113,62,24,27,65,41,24,15,4,0,6,5
S01011395,Occupancy rating +2 or more,80,24,9,15,54,9,38,23,8,7,7,1,6,2,0,0,1,1
S01011395,Occupancy rating +1,104,44,18,26,56,6,38,21,9,8,12,9,3,4,0,0,3,1
S01011395,Occupancy rating 0,174,99,30,69,71,7,29,16,5,8,35,24,11,4,2,0,2,0
S01011395,Occupancy rating -1 or less,51,23,6,17,23,4,8,2,2,4,11,7,4,5,2,0,0,3
S01011396,All households,402,206,98,108,178,22,107,44,37,26,49,32,17,18,7,0,4,7
S01011396,Occupancy rating +2 or more,115,43,21,22,69,14,50,24,14,12,5,3,2,3,1,0,1,1
S01011396,Occupancy rating +1,102,54,30,24,46,3,33,14,12,7,10,5,5,2,0,0,0,2
S01011396,Occupancy rating 0,147,85,38,47,54,5,21,5,10,6,28,21,7,8,2,0,2,4
S01011396,Occupancy rating -1 or less,38,24,9,15,9,0,3,1,1,1,6,3,3,5,4,0,1,0
S01011397,All households,364,164,61,103,183,21,107,35,55,17,55,35,20,17,6,0,3,8
S01011397,Occupancy rating +2 or more,97,40,22,18,54,10,41,21,13,7,3,2,1,3,1,0,0,2
S01011397,Occupancy rating +1,99,46,14,32,47,7,27,8,15,4,13,7,6,6,1,0,1,4
S01011397,Occupancy rating 0,129,60,18,42,66,4,33,5,24,4,29,17,12,3,1,0,1,1
S01011397,Occupancy rating -1 or less,39,18,7,11,16,0,6,1,3,2,10,9,1,5,3,0,1,1
S01011398,All households,322,121,52,69,183,17,109,30,52,27,57,38,19,18,9,0,1,8
S01011398,Occupancy rating +2 or more,78,30,9,21,47,8,31,21,8,2,8,5,3,1,0,0,1,0
S01011398,Occupancy rating +1,115,52,14,38,58,9,30,8,10,12,19,9,10,5,2,0,0,3
S01011398,Occupancy rating 0,93,34,25,9,53,0,33,1,24,8,20,15,5,6,3,0,0,3
S01011398,Occupancy rating -1 or less,36,5,4,1,25,0,15,0,10,5,10,9,1,6,4,0,0,2
S01011399,All households,240,76,26,50,152,16,85,38,30,17,51,28,23,12,6,0,0,6
S01011399,Occupancy rating +2 or more,34,15,7,8,18,3,14,12,0,2,1,0,1,1,1,0,0,0
S01011399,Occupancy rating +1,100,47,14,33,52,12,33,25,6,2,7,2,5,1,0,0,0,1
S01011399,Occupancy rating 0,82,10,3,7,67,1,29,0,18,11,37,22,15,5,1,0,0,4
S01011399,Occupancy rating -1 or less,24,4,2,2,15,0,9,1,6,2,6,4,2,5,4,0,0,1
S01011400,All households,357,161,46,115,182,20,124,71,40,13,38,26,12,14,1,0,1,12
S01011400,Occupancy rating +2 or more,103,24,9,15,78,10,63,30,23,10,5,3,2,1,0,0,0,1
S01011400,Occupancy rating +1,126,73,18,55,52,6,39,30,6,3,7,3,4,1,0,0,0,1
S01011400,Occupancy rating 0,93,47,14,33,41,3,17,9,8,0,21,16,5,5,0,0,1,4
S01011400,Occupancy rating -1 or less,35,17,5,12,11,1,5,2,3,0,5,4,1,7,1,0,0,6
S01011401,All households,287,100,50,50,176,22,126,62,43,21,28,19,9,11,6,0,0,5
S01011401,Occupancy rating +2 or more,106,42,21,21,61,10,45,31,11,3,6,2,4,3,2,0,0,1
S01011401,Occupancy rating +1,103,31,13,18,69,10,49,27,13,9,10,6,4,3,1,0,0,2
S01011401,Occupancy rating 0,60,20,11,9,40,2,29,4,17,8,9,9,0,0,0,0,0,0
S01011401,Occupancy rating -1 or less,18,7,5,2,6,0,3,0,2,1,3,2,1,5,3,0,0,2
S01011402,All households,492,198,135,63,275,70,140,58,47,35,65,26,39,19,5,0,5,9
S01011402,Occupancy rating +2 or more,159,53,40,13,103,26,62,35,17,10,15,3,12,3,0,0,0,3
S01011402,Occupancy rating +1,219,114,80,34,97,36,48,19,14,15,13,6,7,8,3,0,4,1
S01011402,Occupancy rating 0,84,23,11,12,54,4,23,3,13,7,27,11,16,7,2,0,0,5
S01011402,Occupancy rating -1 or less,30,8,4,4,21,4,7,1,3,3,10,6,4,1,0,0,1,0
S01011403,All households,208,59,18,41,138,7,103,29,51,23,28,17,11,11,8,0,1,2
S01011403,Occupancy rating +2 or more,91,24,10,14,64,3,57,18,27,12,4,3,1,3,2,0,0,1
S01011403,Occupancy rating +1,48,16,4,12,31,3,24,9,12,3,4,0,4,1,0,0,0,1
S01011403,Occupancy rating 0,42,11,2,9,29,1,14,0,9,5,14,10,4,2,1,0,1,0
S01011403,Occupancy rating -1 or less,27,8,2,6,14,0,8,2,3,3,6,4,2,5,5,0,0,0
S01011404,All households,468,213,88,125,239,31,148,53,60,35,60,32,28,16,6,0,3,7
S01011404,Occupancy rating +2 or more,119,45,26,19,73,13,54,24,18,12,6,3,3,1,0,0,0,1
S01011404,Occupancy rating +1,158,88,39,49,65,10,42,18,11,13,13,6,7,5,1,0,2,2
S01011404,Occupancy rating 0,150,68,18,50,77,5,39,9,27,3,33,19,14,5,2,0,1,2
S01011404,Occupancy rating -1 or less,41,12,5,7,24,3,13,2,4,7,8,4,4,5,3,0,0,2
S01011405,All households,298,108,45,63,175,41,104,37,47,20,30,18,12,15,8,0,0,7
S01011405,Occupancy rating +2 or more,157,60,35,25,91,30,56,26,21,9,5,5,0,6,2,0,0,4
S01011405,Occupancy rating +1,89,42,9,33,44,11,23,7,11,5,10,3,7,3,2,0,0,1
S01011405,Occupancy rating 0,37,3,0,3,31,0,20,2,12,6,11,9,2,3,1,0,0,2
S01011405,Occupancy rating -1 or less,15,3,1,2,9,0,5,2,3,0,4,1,3,3,3,0,0,0
S01011406,All households,287,87,54,33,189,34,115,44,45,26,40,18,22,11,5,0,0,6
S01011406,Occupancy rating +2 or more,131,50,33,17,80,26,47,28,12,7,7,1,6,1,0,0,0,1
S01011406,Occupancy rating +1,76,24,13,11,50,6,35,13,12,10,9,3,6,2,1,0,0,1
S01011406,Occupancy rating 0,52,9,5,4,39,0,27,3,16,8,12,8,4,4,0,0,0,4
S01011406,Occupancy rating -1 or less,28,4,3,1,20,2,6,0,5,1,12,6,6,4,4,0,0,0
S01011407,All households,506,173,84,89,317,51,211,89,83,39,55,33,22,16,6,0,2,8
S01011407,Occupancy rating +2 or more,156,63,41,22,91,30,55,34,13,8,6,4,2,2,2,0,0,0
S01011407,Occupancy rating +1,202,78,39,39,120,20,88,45,26,17,12,4,8,4,0,0,1,3
S01011407,Occupancy rating 0,104,17,3,14,80,0,51,7,34,10,29,18,11,7,3,0,0,4
S01011407,Occupancy rating -1 or less,44,15,1,14,26,1,17,3,10,4,8,7,1,3,1,0,1,1
S01011408,All households,369,120,59,61,234,34,138,46,59,33,62,36,26,15,8,0,0,7
S01011408,Occupancy rating +2 or more,103,45,26,19,57,20,32,26,6,0,5,4,1,1,0,0,0,1
S01011408,Occupancy rating +1,144,66,28,38,74,12,47,16,18,13,15,5,10,4,2,0,0,2
S01011408,Occupancy rating 0,86,7,4,3,73,1,41,3,23,15,31,19,12,6,3,0,0,3
S01011408,Occupancy rating -1 or less,36,2,1,1,30,1,18,1,12,5,11,8,3,4,3,0,0,1
S01011409,All households,362,113,41,72,237,17,136,43,73,20,84,65,19,12,5,0,0,7
S01011409,Occupancy rating +2 or more,79,30,15,15,47,9,33,25,7,1,5,3,2,2,0,0,0,2
S01011409,Occupancy rating +1,113,51,13,38,61,6,35,12,15,8,20,13,7,1,0,0,0,1
S01011409,Occupancy rating 0,131,25,8,17,101,1,54,4,42,8,46,37,9,5,2,0,0,3
S01011409,Occupancy rating -1 or less,39,7,5,2,28,1,14,2,9,3,13,12,1,4,3,0,0,1
S01011410,All households,316,129,70,59,178,29,110,50,39,21,39,19,20,9,5,0,1,3
S01011410,Occupancy rating +2 or more,51,22,12,10,29,9,19,14,1,4,1,0,1,0,0,0,0,0
S01011410,Occupancy rating +1,138,73,41,32,63,15,40,28,7,5,8,4,4,2,1,0,0,1
S01011410,Occupancy rating 0,89,22,13,9,63,3,34,7,22,5,26,14,12,4,1,0,1,2
S01011410,Occupancy rating -1 or less,38,12,4,8,23,2,17,1,9,7,4,1,3,3,3,0,0,0
S01011411,All households,285,87,64,23,186,24,124,35,57,32,38,18,20,12,3,0,1,8
S01011411,Occupancy rating +2 or more,93,46,34,12,46,11,29,14,11,4,6,0,6,1,0,0,0,1
S01011411,Occupancy rating +1,101,35,27,8,63,12,44,20,11,13,7,4,3,3,1,0,0,2
S01011411,Occupancy rating 0,64,4,2,2,57,1,39,1,24,14,17,10,7,3,0,0,0,3
S01011411,Occupancy rating -1 or less,27,2,1,1,20,0,12,0,11,1,8,4,4,5,2,0,1,2
S01011412,All households,357,84,60,24,262,57,182,63,67,52,23,8,15,11,4,0,1,6
S01011412,Occupancy rating +2 or more,217,58,39,19,157,38,115,46,38,31,4,0,4,2,0,0,0,2
S01011412,Occupancy rating +1,105,25,21,4,77,19,47,16,16,15,11,5,6,3,1,0,0,2
S01011412,Occupancy rating 0,25,1,0,1,23,0,16,1,11,4,7,2,5,1,0,0,1,0
S01011412,Occupancy rating -1 or less,10,0,0,0,5,0,4,0,2,2,1,1,0,5,3,0,0,2
S01011413,All households,218,46,6,40,164,13,134,48,68,18,17,12,5,8,4,0,0,4
S01011413,Occupancy rating +2 or more,85,16,2,14,67,12,52,20,25,7,3,1,2,2,0,0,0,2
S01011413,Occupancy rating +1,76,24,3,21,51,1,45,25,17,3,5,3,2,1,0,0,0,1
S01011413,Occupancy rating 0,44,4,1,3,37,0,30,3,20,7,7,7,0,3,2,0,0,1
S01011413,Occupancy rating -1 or less,13,2,0,2,9,0,7,0,6,1,2,1,1,2,2,0,0,0
S01011414,All households,377,134,50,84,235,31,141,48,59,34,63,42,21,8,4,0,1,3
S01011414,Occupancy rating +2 or more,99,29,11,18,69,18,47,19,16,12,4,3,1,1,0,0,1,0
S01011414,Occupancy rating +1,137,67,22,45,68,11,41,26,7,8,16,10,6,2,0,0,0,2
S01011414,Occupancy rating 0,101,29,15,14,69,1,40,2,25,13,28,19,9,3,2,0,0,1
S01011414,Occupancy rating -1 or less,40,9,2,7,29,1,13,1,11,1,15,10,5,2,2,0,0,0
S01011415,All households,408,164,57,107,233,23,174,65,73,36,36,15,21,11,6,0,0,5
S01011415,Occupancy rating +2 or more,123,34,9,25,86,12,67,28,28,11,7,1,6,3,2,0,0,1
S01011415,Occupancy rating +1,129,48,21,27,79,7,64,27,21,16,8,2,6,2,1,0,0,1
S01011415,Occupancy rating 0,130,72,23,49,55,4,36,9,20,7,15,9,6,3,3,0,0,0
S01011415,Occupancy rating -1 or less,26,10,4,6,13,0,7,1,4,2,6,3,3,3,0,0,0,3
S01011416,All households,240,37,11,26,196,20,161,55,63,43,15,9,6,7,2,0,0,5
S01011416,Occupancy rating +2 or more,134,24,11,13,108,16,87,45,20,22,5,3,2,2,0,0,0,2
S01011416,Occupancy rating +1,61,12,0,12,47,4,38,9,21,8,5,3,2,2,1,0,0,1
S01011416,Occupancy rating 0,36,0,0,0,34,0,29,0,17,12,5,3,2,2,0,0,0,2
S01011416,Occupancy rating -1 or less,9,1,0,1,7,0,7,1,5,1,0,0,0,1,1,0,0,0
S01011417,All households,374,128,75,53,227,44,144,58,59,27,39,17,22,19,11,1,2,5
S01011417,Occupancy rating +2 or more,114,31,21,10,79,26,47,31,9,7,6,0,6,4,2,0,0,2
S01011417,Occupancy rating +1,155,80,46,34,74,17,47,23,14,10,10,6,4,1,1,0,0,0
S01011417,Occupancy rating 0,73,9,3,6,57,0,37,2,27,8,20,9,11,7,3,1,1,2
S01011417,Occupancy rating -1 or less,32,8,5,3,17,1,13,2,9,2,3,2,1,7,5,0,1,1
S01011418,All households,264,94,41,53,161,19,96,40,39,17,46,23,23,9,4,0,0,5
S01011418,Occupancy rating +2 or more,28,13,6,7,15,3,9,7,2,0,3,1,2,0,0,0,0,0
S01011418,Occupancy rating +1,122,65,26,39,55,12,39,31,6,2,4,2,2,2,0,0,0,2
S01011418,Occupancy rating 0,78,12,8,4,62,2,35,0,25,10,25,14,11,4,1,0,0,3
S01011418,Occupancy rating -1 or less,36,4,1,3,29,2,13,2,6,5,14,6,8,3,3,0,0,0
S01011419,All households,253,85,37,48,161,15,111,50,37,24,35,22,13,7,5,0,0,2
S01011419,Occupancy rating +2 or more,53,13,7,6,40,5,33,25,6,2,2,2,0,0,0,0,0,0
S01011419,Occupancy rating +1,96,43,20,23,51,8,33,19,9,5,10,1,9,2,1,0,0,1
S01011419,Occupancy rating 0,76,23,7,16,50,1,28,5,14,9,21,17,4,3,2,0,0,1
S01011419,Occupancy rating -1 or less,28,6,3,3,20,1,17,1,8,8,2,2,0,2,2,0,0,0
S01011420,All households,250,115,33,82,127,12,68,31,25,12,47,28,19,8,1,0,0,7
S01011420,Occupancy rating +2 or more,42,23,5,18,19,4,15,12,2,1,0,0,0,0,0,0,0,0
S01011420,Occupancy rating +1,61,26,9,17,34,8,21,11,3,7,5,1,4,1,0,0,0,1
S01011420,Occupancy rating 0,110,54,14,40,53,0,25,8,14,3,28,18,10,3,0,0,0,3
S01011420,Occupancy rating -1 or less,37,12,5,7,21,0,7,0,6,1,14,9,5,4,1,0,0,3
S01011421,All households,233,46,3,43,174,4,144,53,80,11,26,24,2,13,8,0,1,4
S01011421,Occupancy rating +2 or more,82,15,2,13,64,1,56,29,23,4,7,5,2,3,2,0,0,1
S01011421,Occupancy rating +1,88,23,1,22,63,3,55,20,31,4,5,5,0,2,1,0,0,1
S01011421,Occupancy rating 0,48,3,0,3,40,0,28,3,22,3,12,12,0,5,2,0,1,2
S01011421,Occupancy rating -1 or less,15,5,0,5,7,0,5,1,4,0,2,2,0,3,3,0,0,0
S01011422,All households,264,54,26,28,193,16,119,45,46,28,58,28,30,17,11,0,0,6
S01011422,Occupancy rating +2 or more,108,39,22,17,68,13,50,36,11,3,5,3,2,1,1,0,0,0
S01011422,Occupancy rating +1,69,8,2,6,59,0,36,9,16,11,23,8,15,2,0,0,0,2
S01011422,Occupancy rating 0,65,7,2,5,48,3,24,0,13,11,21,12,9,10,6,0,0,4
S01011422,Occupancy rating -1 or less,22,0,0,0,18,0,9,0,6,3,9,5,4,4,4,0,0,0
S01011423,All households,221,62,19,43,146,16,91,16,58,17,39,27,12,13,5,0,0,8
S01011423,Occupancy rating +2 or more,61,22,3,19,37,4,27,9,17,1,6,5,1,2,0,0,0,2
S01011423,Occupancy rating +1,66,29,12,17,35,10,16,5,7,4,9,6,3,2,1,0,0,1
S01011423,Occupancy rating 0,66,10,3,7,51,1,34,2,24,8,16,12,4,5,1,0,0,4
S01011423,Occupancy rating -1 or less,28,1,1,0,23,1,14,0,10,4,8,4,4,4,3,0,0,1
S01011424,All households,237,69,36,33,160,17,116,32,50,34,27,10,17,8,3,0,1,4
S01011424,Occupancy rating +2 or more,79,34,19,15,45,12,30,19,6,5,3,0,3,0,0,0,0,0
S01011424,Occupancy rating +1,75,27,13,14,46,2,37,12,14,11,7,1,6,2,0,0,0,2
S01011424,Occupancy rating 0,62,5,3,2,54,3,38,0,23,15,13,7,6,3,1,0,1,1
S01011424,Occupancy rating -1 or less,21,3,1,2,15,0,11,1,7,3,4,2,2,3,2,0,0,1
S01011425,All households,348,84,35,49,244,30,151,48,75,28,63,38,25,20,9,0,0,11
S01011425,Occupancy rating +2 or more,139,44,22,22,93,23,67,36,19,12,3,1,2,2,1,0,0,1
S01011425,Occupancy rating +1,73,15,10,5,53,7,29,8,13,8,17,5,12,5,1,0,0,4
S01011425,Occupancy rating 0,100,22,2,20,70,0,41,3,33,5,29,21,8,8,3,0,0,5
S01011425,Occupancy rating -1 or less,36,3,1,2,28,0,14,1,10,3,14,11,3,5,4,0,0,1
S01011426,All households,356,47,13,34,297,23,245,76,141,28,29,18,11,12,5,0,0,7
S01011426,Occupancy rating +2 or more,237,24,6,18,208,18,178,62,100,16,12,5,7,5,1,0,0,4
S01011426,Occupancy rating +1,72,10,2,8,59,4,41,10,24,7,14,11,3,3,3,0,0,0
S01011426,Occupancy rating 0,34,9,4,5,23,1,20,4,13,3,2,2,0,2,1,0,0,1
S01011426,Occupancy rating -1 or less,13,4,1,3,7,0,6,0,4,2,1,0,1,2,0,0,0,2
S01011427,All households,303,106,39,67,185,19,133,50,55,28,33,24,9,12,6,0,1,5
S01011427,Occupancy rating +2 or more,87,27,8,19,54,8,44,19,17,8,2,1,1,6,3,0,1,2
S01011427,Occupancy rating +1,90,42,17,25,46,8,36,24,5,7,2,1,1,2,1,0,0,1
S01011427,Occupancy rating 0,97,34,13,21,62,1,38,6,23,9,23,19,4,1,1,0,0,0
S01011427,Occupancy rating -1 or less,29,3,1,2,23,2,15,1,10,4,6,3,3,3,1,0,0,2
S01011428,All households,243,84,43,41,156,21,107,49,31,27,28,19,9,3,2,0,0,1
S01011428,Occupancy rating +2 or more,57,21,12,9,36,7,29,19,6,4,0,0,0,0,0,0,0,0
S01011428,Occupancy rating +1,95,40,24,16,55,10,41,25,8,8,4,1,3,0,0,0,0,0
S01011428,Occupancy rating 0,75,21,6,15,53,4,28,4,12,12,21,16,5,1,0,0,0,1
S01011428,Occupancy rating -1 or less,16,2,1,1,12,0,9,1,5,3,3,2,1,2,2,0,0,0
S01011429,All households,240,52,19,33,178,10,151,52,72,27,17,9,8,10,6,0,0,4
S01011429,Occupancy rating +2 or more,151,29,10,19,119,9,101,44,38,19,9,3,6,3,1,0,0,2
S01011429,Occupancy rating +1,54,17,7,10,35,1,32,7,21,4,2,1,1,2,1,0,0,1
S01011429,Occupancy rating 0,25,6,2,4,16,0,11,1,9,1,5,4,1,3,3,0,0,0
S01011429,Occupancy rating -1 or less,10,0,0,0,8,0,7,0,4,3,1,1,0,2,1,0,0,1
S01011430,All households,368,84,30,54,275,31,210,85,86,39,34,20,14,9,2,0,0,7
S01011430,Occupancy rating +2 or more,136,30,15,15,105,16,82,47,19,16,7,3,4,1,0,0,0,1
S01011430,Occupancy rating +1,115,33,10,23,77,10,60,27,23,10,7,5,2,5,1,0,0,4
S01011430,Occupancy rating 0,83,14,3,11,69,4,50,7,38,5,15,10,5,0,0,0,0,0
S01011430,Occupancy rating -1 or less,34,7,2,5,24,1,18,4,6,8,5,2,3,3,1,0,0,2
S01011431,All households,506,190,90,100,292,44,181,64,74,43,67,33,34,24,8,0,2,14
S01011431,Occupancy rating +2 or more,107,38,20,18,68,16,51,28,11,12,1,0,1,1,0,0,0,1
S01011431,Occupancy rating +1,209,110,45,65,94,20,60,34,14,12,14,8,6,5,1,0,0,4
S01011431,Occupancy rating 0,140,31,19,12,97,7,48,1,31,16,42,19,23,12,3,0,1,8
S01011431,Occupancy rating -1 or less,50,11,6,5,33,1,22,1,18,3,10,6,4,6,4,0,1,1
S01011432,All households,467,157,62,95,298,38,204,84,74,46,56,28,28,12,4,0,1,7
S01011432,Occupancy rating +2 or more,92,27,8,19,64,14,46,28,9,9,4,1,3,1,0,0,0,1
S01011432,Occupancy rating +1,174,76,31,45,97,20,66,52,7,7,11,4,7,1,0,0,1,0
S01011432,Occupancy rating 0,146,48,20,28,93,2,67,2,41,24,24,12,12,5,1,0,0,4
S01011432,Occupancy rating -1 or less,55,6,3,3,44,2,25,2,17,6,17,11,6,5,3,0,0,2
S01011433,All households,369,101,33,68,240,9,132,44,71,17,99,74,25,28,17,0,2,9
S01011433,Occupancy rating +2 or more,57,31,11,20,25,3,21,16,3,2,1,1,0,1,0,0,0,1
S01011433,Occupancy rating +1,110,51,18,33,55,5,40,23,11,6,10,6,4,4,3,0,1,0
S01011433,Occupancy rating 0,125,11,1,10,104,1,45,4,35,6,58,43,15,10,2,0,1,7
S01011433,Occupancy rating -1 or less,77,8,3,5,56,0,26,1,22,3,30,24,6,13,12,0,0,1
S01011434,All households,250,73,37,36,171,26,111,46,38,27,34,16,18,6,2,0,0,4
S01011434,Occupancy rating +2 or more,84,20,8,12,61,12,43,19,13,11,6,2,4,3,0,0,0,3
S01011434,Occupancy rating +1,95,43,24,19,52,10,37,24,8,5,5,3,2,0,0,0,0,0
S01011434,Occupancy rating 0,43,3,1,2,37,1,20,0,14,6,16,6,10,3,2,0,0,1
S01011434,Occupancy rating -1 or less,28,7,4,3,21,3,11,3,3,5,7,5,2,0,0,0,0,0
S01011435,All households,374,92,41,51,267,28,206,80,84,42,33,18,15,15,8,0,1,6
S01011435,Occupancy rating +2 or more,160,33,16,17,122,13,99,47,38,14,10,4,6,5,2,0,0,3
S01011435,Occupancy rating +1,137,44,18,26,92,10,72,28,29,15,10,6,4,1,0,0,0,1
S01011435,Occupancy rating 0,60,8,5,3,46,5,30,5,14,11,11,6,5,6,4,0,1,1
S01011435,Occupancy rating -1 or less,17,7,2,5,7,0,5,0,3,2,2,2,0,3,2,0,0,1
S01011436,All households,370,163,43,120,198,22,120,49,46,25,56,37,19,9,2,0,2,5
S01011436,Occupancy rating +2 or more,40,12,4,8,27,7,19,10,6,3,1,1,0,1,0,0,0,1
S01011436,Occupancy rating +1,132,71,27,44,60,13,42,24,10,8,5,4,1,1,0,0,0,1
S01011436,Occupancy rating 0,146,63,7,56,80,1,44,13,22,9,35,20,15,3,0,0,0,3
S01011436,Occupancy rating -1 or less,52,17,5,12,31,1,15,2,8,5,15,12,3,4,2,0,2,0
S01011437,All households,354,130,45,85,218,24,128,56,40,32,66,43,23,6,3,0,1,2
S01011437,Occupancy rating +2 or more,52,18,3,15,34,5,25,20,1,4,4,1,3,0,0,0,0,0
S01011437,Occupancy rating +1,111,44,21,23,67,16,42,30,6,6,9,6,3,0,0,0,0,0
S01011437,Occupancy rating 0,136,54,14,40,79,3,40,5,20,15,36,23,13,3,1,0,1,1
S01011437,Occupancy rating -1 or less,55,14,7,7,38,0,21,1,13,7,17,13,4,3,2,0,0,1
S01011438,All households,241,75,25,50,155,14,83,21,42,20,58,36,22,11,4,0,0,7
S01011438,Occupancy rating +2 or more,28,7,2,5,21,6,12,7,3,2,3,2,1,0,0,0,0,0
S01011438,Occupancy rating +1,94,53,19,34,40,6,21,10,6,5,13,7,6,1,0,0,0,1
S01011438,Occupancy rating 0,83,11,3,8,68,1,38,4,25,9,29,20,9,4,1,0,0,3
S01011438,Occupancy rating -1 or less,36,4,1,3,26,1,12,0,8,4,13,7,6,6,3,0,0,3
S01011439,All households,396,122,57,65,264,30,180,64,70,46,54,30,24,10,4,0,1,5
S01011439,Occupancy rating +2 or more,92,28,13,15,64,9,53,30,10,13,2,1,1,0,0,0,0,0
S01011439,Occupancy rating +1,160,63,29,34,94,18,62,29,20,13,14,3,11,3,0,0,0,3
S01011439,Occupancy rating 0,102,24,13,11,75,3,42,3,25,14,30,20,10,3,0,0,1,2
S01011439,Occupancy rating -1 or less,42,7,2,5,31,0,23,2,15,6,8,6,2,4,4,0,0,0
S01011440,All households,276,89,42,47,175,16,123,62,38,23,36,26,10,12,6,0,0,6
S01011440,Occupancy rating +2 or more,49,17,6,11,32,6,23,19,3,1,3,3,0,0,0,0,0,0
S01011440,Occupancy rating +1,127,53,26,27,71,8,55,36,10,9,8,6,2,3,3,0,0,0
S01011440,Occupancy rating 0,77,15,6,9,56,2,35,5,21,9,19,14,5,6,1,0,0,5
S01011440,Occupancy rating -1 or less,23,4,4,0,16,0,10,2,4,4,6,3,3,3,2,0,0,1
S01011441,All households,343,103,33,70,228,16,154,66,50,38,58,39,19,12,4,0,1,7
S01011441,Occupancy rating +2 or more,87,27,10,17,60,10,46,27,7,12,4,3,1,0,0,0,0,0
S01011441,Occupancy rating +1,134,56,18,38,77,5,55,30,15,10,17,9,8,1,1,0,0,0
S01011441,Occupancy rating 0,87,12,0,12,68,1,38,5,21,12,29,22,7,7,1,0,1,5
S01011441,Occupancy rating -1 or less,35,8,5,3,23,0,15,4,7,4,8,5,3,4,2,0,0,2
S01011442,All households,327,133,54,79,177,26,109,32,52,25,42,26,16,17,9,0,0,8
S01011442,Occupancy rating +2 or more,62,28,11,17,34,5,27,13,10,4,2,0,2,0,0,0,0,0
S01011442,Occupancy rating +1,119,49,22,27,64,17,39,16,14,9,8,5,3,6,2,0,0,4
S01011442,Occupancy rating 0,116,45,17,28,67,3,38,2,25,11,26,20,6,4,2,0,0,2
S01011442,Occupancy rating -1 or less,30,11,4,7,12,1,5,1,3,1,6,1,5,7,5,0,0,2
S01011443,All households,288,109,55,54,171,22,107,47,43,17,42,27,15,8,5,0,0,3
S01011443,Occupancy rating +2 or more,79,30,21,9,47,10,34,22,8,4,3,1,2,2,1,0,0,1
S01011443,Occupancy rating +1,95,42,20,22,52,8,37,22,11,4,7,4,3,1,1,0,0,0
S01011443,Occupancy rating 0,78,29,11,18,48,3,24,1,16,7,21,14,7,1,1,0,0,0
S01011443,Occupancy rating -1 or less,36,8,3,5,24,1,12,2,8,2,11,8,3,4,2,0,0,2
S01011444,All households,334,110,40,70,203,23,132,50,55,27,48,29,19,21,14,0,1,6
S01011444,Occupancy rating +2 or more,70,31,16,15,38,8,27,17,7,3,3,1,2,1,1,0,0,0
S01011444,Occupancy rating +1,127,64,20,44,62,11,42,26,7,9,9,4,5,1,0,0,0,1
S01011444,Occupancy rating 0,97,14,4,10,75,3,43,4,29,10,29,20,9,8,4,0,0,4
S01011444,Occupancy rating -1 or less,40,1,0,1,28,1,20,3,12,5,7,4,3,11,9,0,1,1
S01011445,All households,251,90,30,60,152,12,113,50,49,14,27,19,8,9,5,0,0,4
S01011445,Occupancy rating +2 or more,72,19,4,15,53,8,43,27,14,2,2,1,1,0,0,0,0,0
S01011445,Occupancy rating +1,87,41,16,25,44,4,32,17,13,2,8,5,3,2,0,0,0,2
S01011445,Occupancy rating 0,74,29,10,19,43,0,31,5,19,7,12,9,3,2,1,0,0,1
S01011445,Occupancy rating -1 or less,18,1,0,1,12,0,7,1,3,3,5,4,1,5,4,0,0,1
S01011446,All households,231,82,41,41,137,14,98,38,41,19,25,16,9,12,3,0,0,9
S01011446,Occupancy rating +2 or more,91,28,11,17,61,10,49,24,16,9,2,0,2,2,1,0,0,1
S01011446,Occupancy rating +1,71,32,11,21,37,1,30,13,12,5,6,5,1,2,0,0,0,2
S01011446,Occupancy rating 0,49,19,17,2,27,3,15,1,9,5,9,5,4,3,0,0,0,3
S01011446,Occupancy rating -1 or less,20,3,2,1,12,0,4,0,4,0,8,6,2,5,2,0,0,3
S01011447,All households,369,91,37,54,261,14,161,52,84,25,86,63,23,17,5,0,1,11
S01011447,Occupancy rating +2 or more,81,29,12,17,52,2,46,25,17,4,4,2,2,0,0,0,0,0
S01011447,Occupancy rating +1,112,42,16,26,67,9,47,24,18,5,11,5,6,3,1,0,0,2
S01011447,Occupancy rating 0,117,14,7,7,93,2,48,2,33,13,43,33,10,10,1,0,1,8
S01011447,Occupancy rating -1 or less,59,6,2,4,49,1,20,1,16,3,28,23,5,4,3,0,0,1
S01011448,All households,377,109,38,71,251,28,181,76,65,40,42,21,21,17,10,0,1,6
S01011448,Occupancy rating +2 or more,135,33,13,20,97,15,77,41,26,10,5,2,3,5,3,0,0,2
S01011448,Occupancy rating +1,100,29,14,15,70,10,52,29,9,14,8,3,5,1,1,0,0,0
S01011448,Occupancy rating 0,103,38,6,32,58,2,36,6,16,14,20,9,11,7,2,0,1,4
S01011448,Occupancy rating -1 or less,39,9,5,4,26,1,16,0,14,2,9,7,2,4,4,0,0,0
S01011449,All households,276,129,56,73,134,14,79,27,34,18,41,19,22,13,2,0,0,11
S01011449,Occupancy rating +2 or more,39,12,6,6,23,4,13,7,3,3,6,1,5,4,0,0,0,4
S01011449,Occupancy rating +1,96,54,18,36,42,8,30,15,10,5,4,0,4,0,0,0,0,0
S01011449,Occupancy rating 0,107,55,29,26,47,2,26,5,13,8,19,11,8,5,0,0,0,5
S01011449,Occupancy rating -1 or less,34,8,3,5,22,0,10,0,8,2,12,7,5,4,2,0,0,2
S01011450,All households,239,50,23,27,177,18,127,33,75,19,32,18,14,12,7,0,2,3
S01011450,Occupancy rating +2 or more,139,19,8,11,113,10,91,23,55,13,12,7,5,7,3,0,2,2
S01011450,Occupancy rating +1,52,22,10,12,30,7,20,9,10,1,3,0,3,0,0,0,0,0
S01011450,Occupancy rating 0,34,7,4,3,24,1,10,1,5,4,13,8,5,3,2,0,0,1
S01011450,Occupancy rating -1 or less,14,2,1,1,10,0,6,0,5,1,4,3,1,2,2,0,0,0
S01011451,All households,212,22,3,19,175,5,153,30,95,28,17,10,7,15,13,0,0,2
S01011451,Occupancy rating +2 or more,156,17,3,14,130,4,118,25,70,23,8,5,3,9,7,0,0,2
S01011451,Occupancy rating +1,27,4,0,4,19,1,13,3,9,1,5,4,1,4,4,0,0,0
S01011451,Occupancy rating 0,18,1,0,1,17,0,14,0,10,4,3,0,3,0,0,0,0,0
S01011451,Occupancy rating -1 or less,11,0,0,0,9,0,8,2,6,0,1,1,0,2,2,0,0,0
S01011452,All households,412,147,35,112,247,21,181,73,72,36,45,31,14,18,10,0,1,7
S01011452,Occupancy rating +2 or more,164,39,17,22,117,13,97,44,32,21,7,6,1,8,6,0,0,2
S01011452,Occupancy rating +1,101,49,13,36,49,4,37,17,13,7,8,4,4,3,2,0,0,1
S01011452,Occupancy rating 0,116,53,4,49,58,2,36,12,18,6,20,12,8,5,1,0,1,3
S01011452,Occupancy rating -1 or less,31,6,1,5,23,2,11,0,9,2,10,9,1,2,1,0,0,1
S01011453,All households,301,94,48,46,189,23,131,43,56,32,35,20,15,18,10,0,1,7
S01011453,Occupancy rating +2 or more,121,54,31,23,66,20,43,34,4,5,3,1,2,1,1,0,0,0
S01011453,Occupancy rating +1,82,21,11,10,53,2,41,3,22,16,10,2,8,8,1,0,1,6
S01011453,Occupancy rating 0,63,17,5,12,43,1,27,2,18,7,15,10,5,3,3,0,0,0
S01011453,Occupancy rating -1 or less,35,2,1,1,27,0,20,4,12,4,7,7,0,6,5,0,0,1
S01011454,All households,351,114,68,46,224,22,135,51,58,26,67,47,20,13,6,0,1,6
S01011454,Occupancy rating +2 or more,71,32,18,14,39,9,29,24,3,2,1,0,1,0,0,0,0,0
S01011454,Occupancy rating +1,110,41,19,22,66,11,45,22,10,13,10,6,4,3,0,0,0,3
S01011454,Occupancy rating 0,120,37,29,8,78,2,40,3,29,8,36,26,10,5,3,0,0,2
S01011454,Occupancy rating -1 or less,50,4,2,2,41,0,21,2,16,3,20,15,5,5,3,0,1,1
S01011455,All households,329,105,52,53,208,21,122,42,52,28,65,31,34,16,7,0,1,8
S01011455,Occupancy rating +2 or more,89,46,21,25,40,13,25,16,7,2,2,1,1,3,1,0,0,2
S01011455,Occupancy rating +1,120,45,25,20,72,8,51,21,16,14,13,4,9,3,0,0,0,3
S01011455,Occupancy rating 0,89,11,5,6,71,0,36,3,25,8,35,21,14,7,3,0,1,3
S01011455,Occupancy rating -1 or less,31,3,1,2,25,0,10,2,4,4,15,5,10,3,3,0,0,0
S01011456,All households,356,121,47,74,216,26,132,48,46,38,58,27,31,19,12,0,0,7
S01011456,Occupancy rating +2 or more,110,52,27,25,57,17,32,25,5,2,8,3,5,1,0,0,0,1
S01011456,Occupancy rating +1,99,27,7,20,68,4,47,16,17,14,17,5,12,4,1,0,0,3
S01011456,Occupancy rating 0,103,34,10,24,63,4,36,7,16,13,23,12,11,6,3,0,0,3
S01011456,Occupancy rating -1 or less,44,8,3,5,28,1,17,0,8,9,10,7,3,8,8,0,0,0
S01011457,All households,382,105,33,72,253,16,150,60,59,31,87,53,34,24,17,0,0,7
S01011457,Occupancy rating +2 or more,99,50,14,36,47,8,31,28,3,0,8,5,3,2,2,0,0,0
S01011457,Occupancy rating +1,133,43,10,33,85,8,47,29,8,10,30,17,13,5,1,0,0,4
S01011457,Occupancy rating 0,96,11,9,2,79,0,45,1,31,13,34,24,10,6,4,0,0,2
S01011457,Occupancy rating -1 or less,54,1,0,1,42,0,27,2,17,8,15,7,8,11,10,0,0,1
S01011458,All households,374,54,18,36,303,6,257,67,135,55,40,25,15,17,12,0,0,5
S01011458,Occupancy rating +2 or more,191,24,6,18,161,1,145,38,74,33,15,10,5,6,4,0,0,2
S01011458,Occupancy rating +1,102,22,8,14,80,3,70,26,31,13,7,5,2,0,0,0,0,0
S01011458,Occupancy rating 0,60,8,4,4,44,0,31,3,21,7,13,7,6,8,7,0,0,1
S01011458,Occupancy rating -1 or less,21,0,0,0,18,2,11,0,9,2,5,3,2,3,1,0,0,2
S01011459,All households,420,94,22,72,301,13,220,78,118,24,68,42,26,25,9,0,2,14
S01011459,Occupancy rating +2 or more,144,33,7,26,108,9,90,38,42,10,9,6,3,3,1,0,0,2
S01011459,Occupancy rating +1,154,53,13,40,95,4,78,38,37,3,13,9,4,6,1,0,1,4
S01011459,Occupancy rating 0,82,3,1,2,70,0,39,2,30,7,31,17,14,9,3,0,1,5
S01011459,Occupancy rating -1 or less,40,5,1,4,28,0,13,0,9,4,15,10,5,7,4,0,0,3
S01011460,All households,292,75,34,41,204,10,141,45,80,16,53,37,16,13,4,0,0,9
S01011460,Occupancy rating +2 or more,74,12,3,9,60,3,56,25,26,5,1,1,0,2,0,0,0,2
S01011460,Occupancy rating +1,80,25,11,14,53,2,41,19,20,2,10,3,7,2,0,0,0,2
S01011460,Occupancy rating 0,87,26,13,13,58,2,27,0,20,7,29,24,5,3,0,0,0,3
S01011460,Occupancy rating -1 or less,51,12,7,5,33,3,17,1,14,2,13,9,4,6,4,0,0,2
S01011461,All households,332,123,28,95,185,7,111,35,51,25,67,52,15,24,4,0,0,20
S01011461,Occupancy rating +2 or more,36,18,5,13,18,1,13,8,4,1,4,2,2,0,0,0,0,0
S01011461,Occupancy rating +1,113,57,12,45,53,5,39,21,9,9,9,6,3,3,0,0,0,3
S01011461,Occupancy rating 0,123,44,11,33,67,1,32,3,21,8,34,27,7,12,1,0,0,11
S01011461,Occupancy rating -1 or less,60,4,0,4,47,0,27,3,17,7,20,17,3,9,3,0,0,6
S01011462,All households,404,154,62,92,239,31,175,55,80,40,33,18,15,11,2,0,0,9
S01011462,Occupancy rating +2 or more,149,35,14,21,112,8,96,30,46,20,8,7,1,2,1,0,0,1
S01011462,Occupancy rating +1,122,50,28,22,70,22,41,16,17,8,7,3,4,2,0,0,0,2
S01011462,Occupancy rating 0,94,51,15,36,40,1,27,8,10,9,12,4,8,3,0,0,0,3
S01011462,Occupancy rating -1 or less,39,18,5,13,17,0,11,1,7,3,6,4,2,4,1,0,0,3
S01011463,All households,307,95,48,47,199,24,136,61,57,18,39,27,12,13,8,0,0,5
S01011463,Occupancy rating +2 or more,86,28,14,14,55,10,43,25,7,11,2,2,0,3,2,0,0,1
S01011463,Occupancy rating +1,134,57,27,30,75,12,53,31,18,4,10,6,4,2,0,0,0,2
S01011463,Occupancy rating 0,64,5,3,2,55,2,31,3,25,3,22,14,8,4,2,0,0,2
S01011463,Occupancy rating -1 or less,23,5,4,1,14,0,9,2,7,0,5,5,0,4,4,0,0,0
S01011464,All households,223,62,6,56,154,2,139,43,83,13,13,10,3,7,5,0,0,2
S01011464,Occupancy rating +2 or more,97,9,2,7,87,1,81,22,51,8,5,5,0,1,1,0,0,0
S01011464,Occupancy rating +1,70,36,2,34,34,1,32,15,14,3,1,1,0,0,0,0,0,0
S01011464,Occupancy rating 0,31,10,1,9,18,0,16,5,9,2,2,2,0,3,2,0,0,1
S01011464,Occupancy rating -1 or less,25,7,1,6,15,0,10,1,9,0,5,2,3,3,2,0,0,1
S01011465,All households,223,65,21,44,137,5,72,22,35,15,60,43,17,21,6,0,3,12
S01011465,Occupancy rating +2 or more,56,24,10,14,28,2,23,15,6,2,3,0,3,4,0,0,1,3
S01011465,Occupancy rating +1,58,17,4,13,37,1,19,4,7,8,17,10,7,4,1,0,1,2
S01011465,Occupancy rating 0,68,14,3,11,46,0,19,2,14,3,27,22,5,8,2,0,1,5
S01011465,Occupancy rating -1 or less,41,10,4,6,26,2,11,1,8,2,13,11,2,5,3,0,0,2
S01011466,All households,316,150,51,99,151,18,88,40,36,12,45,31,14,15,6,0,1,8
S01011466,Occupancy rating +2 or more,39,13,5,8,24,3,19,10,9,0,2,1,1,2,2,0,0,0
S01011466,Occupancy rating +1,128,71,21,50,54,12,37,24,10,3,5,5,0,3,1,0,0,2
S01011466,Occupancy rating 0,115,50,16,34,57,2,25,6,13,6,30,20,10,8,1,0,1,6
S01011466,Occupancy rating -1 or less,34,16,9,7,16,1,7,0,4,3,8,5,3,2,2,0,0,0
S01011467,All households,231,77,24,53,141,9,94,33,48,13,38,23,15,13,6,0,0,7
S01011467,Occupancy rating +2 or more,67,18,3,15,48,5,35,11,23,1,8,4,4,1,1,0,0,0
S01011467,Occupancy rating +1,77,33,11,22,43,3,31,21,7,3,9,4,5,1,1,0,0,0
S01011467,Occupancy rating 0,64,20,9,11,38,1,23,1,13,9,14,10,4,6,1,0,0,5
S01011467,Occupancy rating -1 or less,23,6,1,5,12,0,5,0,5,0,7,5,2,5,3,0,0,2
S01011468,All households,310,49,4,45,243,2,218,57,148,13,23,18,5,18,13,0,0,5
S01011468,Occupancy rating +2 or more,179,23,2,21,152,2,142,44,89,9,8,7,1,4,2,0,0,2
S01011468,Occupancy rating +1,74,23,2,21,46,0,39,13,24,2,7,5,2,5,4,0,0,1
S01011468,Occupancy rating 0,40,1,0,1,34,0,28,0,26,2,6,4,2,5,3,0,0,2
S01011468,Occupancy rating -1 or less,17,2,0,2,11,0,9,0,9,0,2,2,0,4,4,0,0,0
S01011469,All households,318,77,15,62,211,12,128,27,69,32,71,49,22,30,12,0,0,18
S01011469,Occupancy rating +2 or more,111,31,6,25,73,6,55,15,30,10,12,9,3,7,4,0,0,3
S01011469,Occupancy rating +1,101,32,7,25,65,4,37,8,18,11,24,14,10,4,1,0,0,3
S01011469,Occupancy rating 0,70,11,2,9,55,2,26,3,14,9,27,21,6,4,2,0,0,2
S01011469,Occupancy rating -1 or less,36,3,0,3,18,0,10,1,7,2,8,5,3,15,5,0,0,10
S01011470,All households,491,171,66,105,298,44,199,76,78,45,55,26,29,22,10,0,3,9
S01011470,Occupancy rating +2 or more,186,50,26,24,130,25,96,45,31,20,9,3,6,6,1,0,1,4
S01011470,Occupancy rating +1,165,73,32,41,88,14,56,27,14,15,18,10,8,4,1,0,0,3
S01011470,Occupancy rating 0,99,38,5,33,58,3,31,2,23,6,24,10,14,3,2,0,1,0
S01011470,Occupancy rating -1 or less,41,10,3,7,22,2,16,2,10,4,4,3,1,9,6,0,1,2
S01011471,All households,455,197,115,82,243,42,147,70,47,30,54,26,28,15,5,0,4,6
S01011471,Occupancy rating +2 or more,116,27,12,15,87,17,63,39,15,9,7,2,5,2,1,0,0,1
S01011471,Occupancy rating +1,160,87,45,42,72,19,41,23,12,6,12,4,8,1,0,0,0,1
S01011471,Occupancy rating 0,133,64,42,22,63,4,28,6,11,11,31,19,12,6,1,0,1,4
S01011471,Occupancy rating -1 or less,46,19,16,3,21,2,15,2,9,4,4,1,3,6,3,0,3,0
S01011472,All households,535,311,88,223,207,36,110,57,41,12,61,41,20,17,5,0,0,12
S01011472,Occupancy rating +2 or more,95,42,20,22,51,18,28,20,8,0,5,4,1,2,1,0,0,1
S01011472,Occupancy rating +1,188,120,33,87,66,14,40,23,11,6,12,4,8,2,0,0,0,2
S01011472,Occupancy rating 0,202,123,28,95,73,4,33,12,17,4,36,27,9,6,2,0,0,4
S01011472,Occupancy rating -1 or less,50,26,7,19,17,0,9,2,5,2,8,6,2,7,2,0,0,5
S01011473,All households,431,269,136,133,151,34,74,43,19,12,43,22,21,11,3,0,4,4
S01011473,Occupancy rating +2 or more,40,21,9,12,19,3,14,9,2,3,2,0,2,0,0,0,0,0
S01011473,Occupancy rating +1,223,154,87,67,67,28,33,28,3,2,6,2,4,2,1,0,1,0
S01011473,Occupancy rating 0,131,72,30,42,52,2,18,6,8,4,32,19,13,7,1,0,3,3
S01011473,Occupancy rating -1 or less,37,22,10,12,13,1,9,0,6,3,3,1,2,2,1,0,0,1
S01011474,All households,481,273,117,156,194,40,91,43,33,15,63,41,22,14,3,1,1,9
S01011474,Occupancy rating +2 or more,48,28,7,21,19,9,7,4,3,0,3,1,2,1,0,0,0,1
S01011474,Occupancy rating +1,222,146,62,84,74,24,40,30,5,5,10,5,5,2,0,1,0,1
S01011474,Occupancy rating 0,165,77,36,41,83,3,39,8,22,9,41,27,14,5,1,0,1,3
S01011474,Occupancy rating -1 or less,46,22,12,10,18,4,5,1,3,1,9,8,1,6,2,0,0,4
S01011475,All households,391,250,119,131,133,25,60,30,21,9,48,37,11,8,2,1,0,5
S01011475,Occupancy rating +2 or more,37,20,6,14,16,5,9,5,3,1,2,1,1,1,1,0,0,0
S01011475,Occupancy rating +1,192,141,74,67,51,19,29,21,6,2,3,3,0,0,0,0,0,0
S01011475,Occupancy rating 0,120,63,28,35,54,1,16,1,9,6,37,28,9,3,0,0,0,3
S01011475,Occupancy rating -1 or less,42,26,11,15,12,0,6,3,3,0,6,5,1,4,1,1,0,2
S01011476,All households,198,43,26,17,149,17,117,39,48,30,15,9,6,6,2,0,0,4
S01011476,Occupancy rating +2 or more,118,28,20,8,87,15,66,28,24,14,6,3,3,3,1,0,0,2
S01011476,Occupancy rating +1,49,11,4,7,37,1,34,11,10,13,2,0,2,1,0,0,0,1
S01011476,Occupancy rating 0,26,4,2,2,21,1,14,0,12,2,6,5,1,1,0,0,0,1
S01011476,Occupancy rating -1 or less,5,0,0,0,4,0,3,0,2,1,1,1,0,1,1,0,0,0
S01011477,All households,335,51,24,27,276,49,200,82,72,46,27,19,8,8,3,0,1,4
S01011477,Occupancy rating +2 or more,232,43,21,22,184,44,133,76,33,24,7,3,4,5,1,0,1,3
S01011477,Occupancy rating +1,73,5,1,4,67,2,48,4,26,18,17,13,4,1,1,0,0,0
S01011477,Occupancy rating 0,23,1,1,0,20,3,14,2,10,2,3,3,0,2,1,0,0,1
S01011477,Occupancy rating -1 or less,7,2,1,1,5,0,5,0,3,2,0,0,0,0,0,0,0,0
S01011478,All households,442,129,57,72,297,40,231,73,124,34,26,11,15,16,4,0,3,9
S01011478,Occupancy rating +2 or more,262,48,29,19,208,28,172,54,91,27,8,3,5,6,1,0,1,4
S01011478,Occupancy rating +1,105,42,15,27,58,9,45,16,24,5,4,1,3,5,2,0,0,3
S01011478,Occupancy rating 0,64,36,13,23,27,3,13,3,8,2,11,6,5,1,0,0,0,1
S01011478,Occupancy rating -1 or less,11,3,0,3,4,0,1,0,1,0,3,1,2,4,1,0,2,1
S01011479,All households,380,120,48,72,246,50,163,83,56,24,33,15,18,14,2,0,2,10
S01011479,Occupancy rating +2 or more,197,56,25,31,136,35,97,48,31,18,4,2,2,5,1,0,0,4
S01011479,Occupancy rating +1,123,49,22,27,70,12,47,31,12,4,11,5,6,4,1,0,0,3
S01011479,Occupancy rating 0,48,12,1,11,32,2,16,3,11,2,14,4,10,4,0,0,2,2
S01011479,Occupancy rating -1 or less,12,3,0,3,8,1,3,1,2,0,4,4,0,1,0,0,0,1
S01011480,All households,467,161,77,84,288,50,210,91,91,28,28,20,8,18,6,0,2,10
S01011480,Occupancy rating +2 or more,265,68,42,26,191,41,144,64,60,20,6,3,3,6,2,0,2,2
S01011480,Occupancy rating +1,129,72,30,42,52,9,40,21,16,3,3,1,2,5,2,0,0,3
S01011480,Occupancy rating 0,57,20,4,16,33,0,20,5,12,3,13,12,1,4,0,0,0,4
S01011480,Occupancy rating -1 or less,16,1,1,0,12,0,6,1,3,2,6,4,2,3,2,0,0,1
S01011481,All households,336,87,31,56,236,20,181,65,98,18,35,24,11,13,6,0,0,7
S01011481,Occupancy rating +2 or more,150,31,6,25,115,10,102,43,55,4,3,3,0,4,4,0,0,0
S01011481,Occupancy rating +1,101,34,16,18,63,7,43,17,20,6,13,7,6,4,1,0,0,3
S01011481,Occupancy rating 0,65,17,7,10,45,1,28,4,17,7,16,13,3,3,0,0,0,3
S01011481,Occupancy rating -1 or less,20,5,2,3,13,2,8,1,6,1,3,1,2,2,1,0,0,1
S01011482,All households,424,155,81,74,244,41,137,47,60,30,66,43,23,25,8,0,3,14
S01011482,Occupancy rating +2 or more,125,49,26,23,76,24,45,25,15,5,7,2,5,0,0,0,0,0
S01011482,Occupancy rating +1,147,66,20,46,76,12,50,21,14,15,14,7,7,5,2,0,1,2
S01011482,Occupancy rating 0,115,25,21,4,76,5,31,1,22,8,40,32,8,14,4,0,2,8
S01011482,Occupancy rating -1 or less,37,15,14,1,16,0,11,0,9,2,5,2,3,6,2,0,0,4
S01011483,All households,221,57,13,44,156,15,117,51,46,20,24,11,13,8,5,0,0,3
S01011483,Occupancy rating +2 or more,84,13,4,9,69,10,56,30,17,9,3,1,2,2,2,0,0,0
S01011483,Occupancy rating +1,66,15,4,11,47,5,34,14,12,8,8,2,6,4,2,0,0,2
S01011483,Occupancy rating 0,55,24,5,19,30,0,21,5,13,3,9,6,3,1,1,0,0,0
S01011483,Occupancy rating -1 or less,16,5,0,5,10,0,6,2,4,0,4,2,2,1,0,0,0,1
S01011484,All households,381,126,57,69,226,24,134,52,52,30,68,40,28,29,13,0,2,14
S01011484,Occupancy rating +2 or more,95,47,20,27,44,11,30,28,2,0,3,2,1,4,1,0,1,2
S01011484,Occupancy rating +1,131,47,18,29,77,9,49,19,16,14,19,11,8,7,0,0,0,7
S01011484,Occupancy rating 0,111,24,13,11,76,2,41,4,25,12,33,20,13,11,7,0,1,3
S01011484,Occupancy rating -1 or less,44,8,6,2,29,2,14,1,9,4,13,7,6,7,5,0,0,2
S01011485,All households,371,91,42,49,253,25,137,38,65,34,91,54,37,27,14,0,6,7
S01011485,Occupancy rating +2 or more,120,59,28,31,59,16,37,28,5,4,6,3,3,2,0,0,1,1
S01011485,Occupancy rating +1,112,20,10,10,83,7,41,7,18,16,35,12,23,9,1,0,4,4
S01011485,Occupancy rating 0,89,12,4,8,71,2,35,1,25,9,34,26,8,6,6,0,0,0
S01011485,Occupancy rating -1 or less,50,0,0,0,40,0,24,2,17,5,16,13,3,10,7,0,1,2
S01011486,All households,235,74,42,32,150,17,77,26,33,18,56,44,12,11,6,0,1,4
S01011486,Occupancy rating +2 or more,58,29,12,17,28,7,21,19,1,1,0,0,0,1,0,0,0,1
S01011486,Occupancy rating +1,45,13,3,10,31,3,23,5,13,5,5,4,1,1,0,0,0,1
S01011486,Occupancy rating 0,91,27,25,2,61,5,20,1,12,7,36,30,6,3,2,0,0,1
S01011486,Occupancy rating -1 or less,41,5,2,3,30,2,13,1,7,5,15,10,5,6,4,0,1,1
S01011487,All households,429,107,34,73,291,18,161,50,81,30,112,75,37,31,16,0,0,15
S01011487,Occupancy rating +2 or more,113,46,17,29,65,12,43,29,13,1,10,5,5,2,1,0,0,1
S01011487,Occupancy rating +1,106,31,7,24,71,4,39,14,12,13,28,13,15,4,1,0,0,3
S01011487,Occupancy rating 0,149,26,10,16,115,2,59,7,40,12,54,43,11,8,2,0,0,6
S01011487,Occupancy rating -1 or less,61,4,0,4,40,0,20,0,16,4,20,14,6,17,12,0,0,5
S01011488,All households,284,62,31,31,213,23,104,36,48,20,86,51,35,9,7,0,0,2
S01011488,Occupancy rating +2 or more,68,28,15,13,40,15,21,18,2,1,4,1,3,0,0,0,0,0
S01011488,Occupancy rating +1,97,25,13,12,71,5,43,16,16,11,23,15,8,1,1,0,0,0
S01011488,Occupancy rating 0,86,7,3,4,75,3,28,2,22,4,44,25,19,4,4,0,0,0
S01011488,Occupancy rating -1 or less,33,2,0,2,27,0,12,0,8,4,15,10,5,4,2,0,0,2
S01011489,All households,260,48,4,44,198,2,162,34,105,23,34,30,4,14,8,0,0,6
S01011489,Occupancy rating +2 or more,100,22,2,20,71,0,64,24,35,5,7,6,1,7,3,0,0,4
S01011489,Occupancy rating +1,78,12,2,10,64,1,54,8,35,11,9,8,1,2,1,0,0,1
S01011489,Occupancy rating 0,58,13,0,13,44,1,31,2,24,5,12,10,2,1,0,0,0,1
S01011489,Occupancy rating -1 or less,24,1,0,1,19,0,13,0,11,2,6,6,0,4,4,0,0,0
S01011490,All households,473,179,57,122,281,33,182,89,74,19,66,37,29,13,7,0,1,5
S01011490,Occupancy rating +2 or more,78,29,5,24,49,2,43,26,17,0,4,1,3,0,0,0,0,0
S01011490,Occupancy rating +1,174,72,21,51,101,20,66,44,17,5,15,7,8,1,1,0,0,0
S01011490,Occupancy rating 0,180,71,27,44,103,7,62,16,33,13,34,20,14,6,1,0,1,4
S01011490,Occupancy rating -1 or less,41,7,4,3,28,4,11,3,7,1,13,9,4,6,5,0,0,1
S01011491,All households,262,121,37,84,127,12,72,35,25,12,43,27,16,14,6,0,0,8
S01011491,Occupancy rating +2 or more,46,16,7,9,28,5,16,11,3,2,7,4,3,2,0,0,0,2
S01011491,Occupancy rating +1,68,38,9,29,30,4,22,12,5,5,4,2,2,0,0,0,0,0
S01011491,Occupancy rating 0,110,58,18,40,46,2,27,11,13,3,17,13,4,6,1,0,0,5
S01011491,Occupancy rating -1 or less,38,9,3,6,23,1,7,1,4,2,15,8,7,6,5,0,0,1
S01011492,All households,395,190,43,147,177,6,108,63,40,5,63,47,16,28,7,1,1,19
S01011492,Occupancy rating +2 or more,65,36,5,31,28,1,25,20,5,0,2,0,2,1,0,0,0,1
S01011492,Occupancy rating +1,153,81,7,74,62,1,46,34,11,1,15,8,7,10,0,0,1,9
S01011492,Occupancy rating 0,136,67,28,39,59,2,23,6,14,3,34,29,5,10,3,1,0,6
S01011492,Occupancy rating -1 or less,41,6,3,3,28,2,14,3,10,1,12,10,2,7,4,0,0,3
S01011493,All households,170,15,2,13,149,4,137,30,89,18,8,7,1,6,5,0,0,1
S01011493,Occupancy rating +2 or more,88,10,2,8,76,4,69,25,36,8,3,3,0,2,2,0,0,0
S01011493,Occupancy rating +1,54,5,0,5,46,0,44,5,31,8,2,2,0,3,2,0,0,1
S01011493,Occupancy rating 0,21,0,0,0,20,0,17,0,15,2,3,2,1,1,1,0,0,0
S01011493,Occupancy rating -1 or less,7,0,0,0,7,0,7,0,7,0,0,0,0,0,0,0,0,0
S01011494,All households,332,107,64,43,212,25,152,66,59,27,35,14,21,13,9,0,0,4
S01011494,Occupancy rating +2 or more,86,31,17,14,54,8,44,28,11,5,2,1,1,1,1,0,0,0
S01011494,Occupancy rating +1,133,46,21,25,84,12,60,37,15,8,12,3,9,3,1,0,0,2
S01011494,Occupancy rating 0,89,27,24,3,58,5,35,1,23,11,18,9,9,4,2,0,0,2
S01011494,Occupancy rating -1 or less,24,3,2,1,16,0,13,0,10,3,3,1,2,5,5,0,0,0
S01011495,All households,369,129,52,77,226,21,128,42,44,42,77,49,28,14,4,0,1,9
S01011495,Occupancy rating +2 or more,89,43,17,26,45,10,29,16,5,8,6,3,3,1,0,0,0,1
S01011495,Occupancy rating +1,133,65,25,40,65,8,40,21,2,17,17,8,9,3,0,0,1,2
S01011495,Occupancy rating 0,105,14,6,8,86,2,40,2,27,11,44,29,15,5,2,0,0,3
S01011495,Occupancy rating -1 or less,42,7,4,3,30,1,19,3,10,6,10,9,1,5,2,0,0,3
S01011496,All households,308,118,29,89,174,5,91,40,40,11,78,57,21,16,8,0,0,8
S01011496,Occupancy rating +2 or more,32,13,5,8,18,0,13,8,4,1,5,2,3,1,1,0,0,0
S01011496,Occupancy rating +1,127,64,13,51,60,4,29,25,3,1,27,18,9,3,0,0,0,3
S01011496,Occupancy rating 0,103,28,7,21,71,0,40,4,27,9,31,26,5,4,1,0,0,3
S01011496,Occupancy rating -1 or less,46,13,4,9,25,1,9,3,6,0,15,11,4,8,6,0,0,2
S01011497,All households,256,73,11,62,176,8,142,59,62,21,26,19,7,7,2,0,0,5
S01011497,Occupancy rating +2 or more,86,19,3,16,67,7,56,25,21,10,4,2,2,0,0,0,0,0
S01011497,Occupancy rating +1,66,23,2,21,43,1,38,25,10,3,4,3,1,0,0,0,0,0
S01011497,Occupancy rating 0,87,24,4,20,57,0,41,7,26,8,16,12,4,6,1,0,0,5
S01011497,Occupancy rating -1 or less,17,7,2,5,9,0,7,2,5,0,2,2,0,1,1,0,0,0
S01011498,All households,230,30,5,25,193,7,162,42,84,36,24,17,7,7,5,0,0,2
S01011498,Occupancy rating +2 or more,106,15,3,12,91,4,83,28,38,17,4,3,1,0,0,0,0,0
S01011498,Occupancy rating +1,68,10,2,8,56,2,47,14,22,11,7,4,3,2,0,0,0,2
S01011498,Occupancy rating 0,43,4,0,4,37,1,25,0,18,7,11,9,2,2,2,0,0,0
S01011498,Occupancy rating -1 or less,13,1,0,1,9,0,7,0,6,1,2,1,1,3,3,0,0,0
S01011499,All households,370,142,41,101,209,24,148,48,69,31,37,24,13,19,5,0,1,13
S01011499,Occupancy rating +2 or more,83,23,8,15,58,9,46,23,16,7,3,1,2,2,0,0,0,2
S01011499,Occupancy rating +1,158,76,21,55,76,13,57,22,26,9,6,4,2,6,0,0,1,5
S01011499,Occupancy rating 0,95,36,9,27,56,1,34,1,22,11,21,12,9,3,1,0,0,2
S01011499,Occupancy rating -1 or less,34,7,3,4,19,1,11,2,5,4,7,7,0,8,4,0,0,4
S01011500,All households,219,66,25,41,145,15,109,38,49,22,21,13,8,8,3,0,1,4
S01011500,Occupancy rating +2 or more,58,15,10,5,42,9,31,21,8,2,2,1,1,1,0,0,0,1
S01011500,Occupancy rating +1,69,22,7,15,46,5,34,16,12,6,7,4,3,1,0,0,0,1
S01011500,Occupancy rating 0,73,27,7,20,44,0,34,1,21,12,10,8,2,2,0,0,1,1
S01011500,Occupancy rating -1 or less,19,2,1,1,13,1,10,0,8,2,2,0,2,4,3,0,0,1
S01011501,All households,325,126,43,83,186,16,91,33,33,25,79,53,26,13,7,0,1,5
S01011501,Occupancy rating +2 or more,26,13,4,9,13,5,7,3,2,2,1,1,0,0,0,0,0,0
S01011501,Occupancy rating +1,109,52,17,35,56,8,35,22,6,7,13,5,8,1,0,0,0,1
S01011501,Occupancy rating 0,136,45,15,30,83,2,37,6,19,12,44,29,15,8,4,0,1,3
S01011501,Occupancy rating -1 or less,54,16,7,9,34,1,12,2,6,4,21,18,3,4,3,0,0,1
S01011502,All households,305,63,34,29,232,28,156,54,65,37,48,29,19,10,3,0,2,5
S01011502,Occupancy rating +2 or more,61,17,12,5,40,8,27,20,6,1,5,2,3,4,0,0,1,3
S01011502,Occupancy rating +1,115,37,16,21,78,20,52,29,12,11,6,3,3,0,0,0,0,0
S01011502,Occupancy rating 0,101,8,5,3,90,0,63,4,38,21,27,19,8,3,2,0,1,0
S01011502,Occupancy rating -1 or less,28,1,1,0,24,0,14,1,9,4,10,5,5,3,1,0,0,2
S01011503,All households,253,60,28,32,183,13,124,42,47,35,46,25,21,10,7,0,0,3
S01011503,Occupancy rating +2 or more,64,18,9,9,46,7,34,17,10,7,5,2,3,0,0,0,0,0
S01011503,Occupancy rating +1,82,26,10,16,54,4,40,22,8,10,10,4,6,2,0,0,0,2
S01011503,Occupancy rating 0,72,14,8,6,56,1,38,2,24,12,17,7,10,2,1,0,0,1
S01011503,Occupancy rating -1 or less,35,2,1,1,27,1,12,1,5,6,14,12,2,6,6,0,0,0
S01011504,All households,237,68,40,28,151,18,99,30,45,24,34,14,20,18,5,0,1,12
S01011504,Occupancy rating +2 or more,92,41,24,17,49,10,36,22,10,4,3,0,3,2,0,0,0,2
S01011504,Occupancy rating +1,62,19,12,7,37,6,24,5,8,11,7,3,4,6,1,0,0,5
S01011504,Occupancy rating 0,55,3,2,1,45,2,29,3,18,8,14,4,10,7,2,0,1,4
S01011504,Occupancy rating -1 or less,28,5,2,3,20,0,10,0,9,1,10,7,3,3,2,0,0,1
S01011505,All households,322,115,30,85,190,7,114,41,57,16,69,43,26,17,6,0,1,10
S01011505,Occupancy rating +2 or more,48,17,6,11,29,1,27,16,10,1,1,0,1,2,0,0,0,2
S01011505,Occupancy rating +1,139,75,23,52,62,4,43,21,18,4,15,10,5,2,0,0,1,1
S01011505,Occupancy rating 0,96,14,1,13,77,2,32,3,23,6,43,24,19,5,1,0,0,4
S01011505,Occupancy rating -1 or less,39,9,0,9,22,0,12,1,6,5,10,9,1,8,5,0,0,3
S01011506,All households,237,79,45,34,153,28,93,43,34,16,32,10,22,5,4,0,1,0
S01011506,Occupancy rating +2 or more,66,19,13,6,45,11,32,20,9,3,2,0,2,2,1,0,1,0
S01011506,Occupancy rating +1,99,53,25,28,46,17,27,21,3,3,2,0,2,0,0,0,0,0
S01011506,Occupancy rating 0,56,6,6,0,49,0,26,1,15,10,23,7,16,1,1,0,0,0
S01011506,Occupancy rating -1 or less,16,1,1,0,13,0,8,1,7,0,5,3,2,2,2,0,0,0
S01011507,All households,293,113,52,61,165,18,99,42,35,22,48,20,28,15,9,0,1,5
S01011507,Occupancy rating +2 or more,64,29,13,16,34,8,24,17,6,1,2,0,2,1,0,0,0,1
S01011507,Occupancy rating +1,114,58,30,28,56,9,38,20,8,10,9,3,6,0,0,0,0,0
S01011507,Occupancy rating 0,80,17,6,11,57,0,32,5,19,8,25,9,16,6,3,0,1,2
S01011507,Occupancy rating -1 or less,35,9,3,6,18,1,5,0,2,3,12,8,4,8,6,0,0,2
S01011508,All households,468,196,21,175,252,17,189,73,89,27,46,29,17,20,7,0,2,11
S01011508,Occupancy rating +2 or more,104,27,7,20,75,7,64,34,23,7,4,2,2,2,0,0,1,1
S01011508,Occupancy rating +1,140,57,8,49,80,7,65,26,29,10,8,5,3,3,2,0,1,0
S01011508,Occupancy rating 0,177,95,5,90,74,3,46,12,28,6,25,18,7,8,1,0,0,7
S01011508,Occupancy rating -1 or less,47,17,1,16,23,0,14,1,9,4,9,4,5,7,4,0,0,3
S01011509,All households,247,62,21,41,166,18,113,41,37,35,35,21,14,19,11,0,2,6
S01011509,Occupancy rating +2 or more,74,23,8,15,46,13,31,22,6,3,2,1,1,5,2,0,1,2
S01011509,Occupancy rating +1,91,29,9,20,58,4,44,14,15,15,10,3,7,4,3,0,0,1
S01011509,Occupancy rating 0,57,7,3,4,44,1,25,4,9,12,18,14,4,6,3,0,1,2
S01011509,Occupancy rating -1 or less,25,3,1,2,18,0,13,1,7,5,5,3,2,4,3,0,0,1
S01011510,All households,435,113,45,68,282,26,161,39,87,35,95,71,24,40,22,0,3,15
S01011510,Occupancy rating +2 or more,99,48,19,29,49,14,32,18,10,4,3,2,1,2,0,0,1,1
S01011510,Occupancy rating +1,145,41,19,22,96,10,63,19,34,10,23,17,6,8,1,0,2,5
S01011510,Occupancy rating 0,130,17,3,14,96,2,47,0,30,17,47,38,9,17,10,0,0,7
S01011510,Occupancy rating -1 or less,61,7,4,3,41,0,19,2,13,4,22,14,8,13,11,0,0,2
S01011511,All households,255,95,30,65,144,17,86,33,38,15,41,19,22,16,7,0,1,8
S01011511,Occupancy rating +2 or more,32,13,5,8,19,10,9,8,1,0,0,0,0,0,0,0,0,0
S01011511,Occupancy rating +1,126,70,23,47,55,6,44,21,17,6,5,0,5,1,0,0,1,0
S01011511,Occupancy rating 0,69,10,2,8,50,0,26,4,14,8,24,13,11,9,3,0,0,6
S01011511,Occupancy rating -1 or less,28,2,0,2,20,1,7,0,6,1,12,6,6,6,4,0,0,2
S01011512,All households,482,209,55,154,257,10,127,57,59,11,120,105,15,16,7,0,1,8
S01011512,Occupancy rating +2 or more,37,20,4,16,16,1,12,8,4,0,3,3,0,1,0,0,0,1
S01011512,Occupancy rating +1,167,102,20,82,64,7,42,32,8,2,15,13,2,1,1,0,0,0
S01011512,Occupancy rating 0,209,71,25,46,132,2,53,13,35,5,77,66,11,6,1,0,1,4
S01011512,Occupancy rating -1 or less,69,16,6,10,45,0,20,4,12,4,25,23,2,8,5,0,0,3
S01011513,All households,358,142,42,100,195,10,110,46,46,18,75,52,23,21,12,0,2,7
S01011513,Occupancy rating +2 or more,55,25,13,12,29,2,25,18,6,1,2,2,0,1,0,0,1,0
S01011513,Occupancy rating +1,111,56,16,40,53,6,36,18,11,7,11,2,9,2,1,0,0,1
S01011513,Occupancy rating 0,144,53,13,40,82,2,35,7,19,9,45,36,9,9,6,0,1,2
S01011513,Occupancy rating -1 or less,48,8,0,8,31,0,14,3,10,1,17,12,5,9,5,0,0,4
S01011514,All households,337,77,35,42,229,18,143,33,74,36,68,35,33,31,20,0,1,10
S01011514,Occupancy rating +2 or more,117,51,18,33,62,13,37,22,9,6,12,4,8,4,0,0,1,3
S01011514,Occupancy rating +1,89,6,2,4,77,4,49,3,29,17,24,13,11,6,3,0,0,3
S01011514,Occupancy rating 0,80,18,13,5,54,1,35,7,19,9,18,13,5,8,6,0,0,2
S01011514,Occupancy rating -1 or less,51,2,2,0,36,0,22,1,17,4,14,5,9,13,11,0,0,2
S01011515,All households,280,134,18,116,144,11,110,54,43,13,23,12,11,2,0,0,0,2
S01011515,Occupancy rating +2 or more,51,19,6,13,31,5,24,16,6,2,2,2,0,1,0,0,0,1
S01011515,Occupancy rating +1,76,26,4,22,50,3,41,22,13,6,6,0,6,0,0,0,0,0
S01011515,Occupancy rating 0,107,66,7,59,40,2,30,9,18,3,8,7,1,1,0,0,0,1
S01011515,Occupancy rating -1 or less,46,23,1,22,23,1,15,7,6,2,7,3,4,0,0,0,0,0
S01011516,All households,358,90,11,79,258,12,230,86,110,34,16,9,7,10,7,0,0,3
S01011516,Occupancy rating +2 or more,146,27,5,22,116,10,105,55,34,16,1,0,1,3,3,0,0,0
S01011516,Occupancy rating +1,112,32,6,26,77,1,69,22,39,8,7,4,3,3,1,0,0,2
S01011516,Occupancy rating 0,70,15,0,15,53,1,47,5,34,8,5,4,1,2,1,0,0,1
S01011516,Occupancy rating -1 or less,30,16,0,16,12,0,9,4,3,2,3,1,2,2,2,0,0,0
S01011517,All households,225,56,32,24,157,19,103,30,49,24,35,14,21,12,6,0,1,5
S01011517,Occupancy rating +2 or more,68,24,10,14,41,10,26,16,6,4,5,2,3,3,0,0,0,3
S01011517,Occupancy rating +1,74,20,14,6,53,7,36,13,15,8,10,4,6,1,0,0,0,1
S01011517,Occupancy rating 0,51,9,7,2,38,2,24,1,16,7,12,3,9,4,2,0,1,1
S01011517,Occupancy rating -1 or less,32,3,1,2,25,0,17,0,12,5,8,5,3,4,4,0,0,0
S01011518,All households,302,115,65,50,175,23,103,32,39,32,49,22,27,12,4,0,2,6
S01011518,Occupancy rating +2 or more,64,28,12,16,36,9,19,12,2,5,8,2,6,0,0,0,0,0
S01011518,Occupancy rating +1,97,29,16,13,65,7,41,14,17,10,17,9,8,3,1,0,0,2
S01011518,Occupancy rating 0,104,48,30,18,52,7,30,6,15,9,15,7,8,4,1,0,2,1
S01011518,Occupancy rating -1 or less,37,10,7,3,22,0,13,0,5,8,9,4,5,5,2,0,0,3
S01011519,All households,310,78,41,37,216,17,157,56,58,43,42,22,20,16,4,0,1,11
S01011519,Occupancy rating +2 or more,65,26,16,10,39,7,28,20,6,2,4,4,0,0,0,0,0,0
S01011519,Occupancy rating +1,97,37,18,19,58,7,42,29,5,8,9,2,7,2,0,0,1,1
S01011519,Occupancy rating 0,89,11,6,5,74,3,59,5,31,23,12,5,7,4,0,0,0,4
S01011519,Occupancy rating -1 or less,59,4,1,3,45,0,28,2,16,10,17,11,6,10,4,0,0,6
S01011520,All households,273,101,54,47,161,8,91,30,35,26,62,38,24,11,3,0,1,7
S01011520,Occupancy rating +2 or more,40,19,6,13,20,5,13,10,3,0,2,1,1,1,0,0,0,1
S01011520,Occupancy rating +1,93,43,15,28,47,2,33,14,5,14,12,8,4,3,0,0,1,2
S01011520,Occupancy rating 0,106,35,30,5,67,1,28,2,16,10,38,21,17,4,1,0,0,3
S01011520,Occupancy rating -1 or less,34,4,3,1,27,0,17,4,11,2,10,8,2,3,2,0,0,1
S01011521,All households,441,171,52,119,244,20,144,53,69,22,80,53,27,26,13,0,1,12
S01011521,Occupancy rating +2 or more,77,31,14,17,44,6,31,20,9,2,7,3,4,2,0,0,1,1
S01011521,Occupancy rating +1,141,69,22,47,68,10,41,20,13,8,17,7,10,4,2,0,0,2
S01011521,Occupancy rating 0,152,57,13,44,85,3,47,10,27,10,35,26,9,10,4,0,0,6
S01011521,Occupancy rating -1 or less,71,14,3,11,47,1,25,3,20,2,21,17,4,10,7,0,0,3
S01011522,All households,463,222,83,139,221,23,130,48,60,22,68,38,30,20,5,0,2,13
S01011522,Occupancy rating +2 or more,61,17,4,13,43,5,37,15,17,5,1,1,0,1,0,0,0,1
S01011522,Occupancy rating +1,167,105,36,69,61,13,37,21,11,5,11,5,6,1,0,0,1,0
S01011522,Occupancy rating 0,168,61,28,33,94,3,45,8,27,10,46,26,20,13,1,0,1,11
S01011522,Occupancy rating -1 or less,67,39,15,24,23,2,11,4,5,2,10,6,4,5,4,0,0,1
S01011523,All households,340,124,24,100,200,13,134,56,48,30,53,33,20,16,7,0,1,8
S01011523,Occupancy rating +2 or more,54,19,6,13,33,6,22,17,1,4,5,2,3,2,1,0,0,1
S01011523,Occupancy rating +1,93,41,11,30,52,3,34,21,8,5,15,8,7,0,0,0,0,0
S01011523,Occupancy rating 0,127,47,4,43,75,3,50,14,21,15,22,15,7,5,2,0,0,3
S01011523,Occupancy rating -1 or less,66,17,3,14,40,1,28,4,18,6,11,8,3,9,4,0,1,4
S01011524,All households,396,127,38,89,252,22,201,82,70,49,29,21,8,17,7,0,2,8
S01011524,Occupancy rating +2 or more,101,31,10,21,67,7,59,35,18,6,1,0,1,3,2,0,0,1
S01011524,Occupancy rating +1,163,51,16,35,109,10,83,37,26,20,16,13,3,3,1,0,1,1
S01011524,Occupancy rating 0,111,38,10,28,64,5,50,8,22,20,9,7,2,9,3,0,0,6
S01011524,Occupancy rating -1 or less,21,7,2,5,12,0,9,2,4,3,3,1,2,2,1,0,1,0
S01011525,All households,348,82,32,50,257,14,208,77,99,32,35,23,12,9,4,0,0,5
S01011525,Occupancy rating +2 or more,136,15,3,12,117,6,100,32,57,11,11,9,2,4,1,0,0,3
S01011525,Occupancy rating +1,110,47,16,31,62,3,55,40,8,7,4,0,4,1,1,0,0,0
S01011525,Occupancy rating 0,77,17,12,5,57,5,35,4,22,9,17,13,4,3,1,0,0,2
S01011525,Occupancy rating -1 or less,25,3,1,2,21,0,18,1,12,5,3,1,2,1,1,0,0,0
S01011526,All households,422,120,41,79,291,33,189,60,87,42,69,40,29,11,5,0,1,5
S01011526,Occupancy rating +2 or more,131,43,25,18,87,20,60,29,21,10,7,3,4,1,1,0,0,0
S01011526,Occupancy rating +1,113,25,11,14,86,10,58,22,27,9,18,6,12,2,1,0,0,1
S01011526,Occupancy rating 0,137,48,2,46,84,0,50,8,26,16,34,22,12,5,1,0,1,3
S01011526,Occupancy rating -1 or less,41,4,3,1,34,3,21,1,13,7,10,9,1,3,2,0,0,1
S01011527,All households,290,56,33,23,221,44,144,56,52,36,33,16,17,13,7,0,0,6
S01011527,Occupancy rating +2 or more,160,28,20,8,126,36,85,41,31,13,5,1,4,6,4,0,0,2
S01011527,Occupancy rating +1,62,13,6,7,46,6,28,7,9,12,12,7,5,3,1,0,0,2
S01011527,Occupancy rating 0,52,13,6,7,37,2,24,7,8,9,11,6,5,2,0,0,0,2
S01011527,Occupancy rating -1 or less,16,2,1,1,12,0,7,1,4,2,5,2,3,2,2,0,0,0
S01011528,All households,495,203,73,130,280,48,155,75,59,21,77,48,29,12,5,0,1,6
S01011528,Occupancy rating +2 or more,96,36,20,16,57,18,36,25,10,1,3,1,2,3,1,0,0,2
S01011528,Occupancy rating +1,164,77,29,48,87,25,50,40,4,6,12,2,10,0,0,0,0,0
S01011528,Occupancy rating 0,182,75,19,56,105,4,54,8,35,11,47,32,15,2,0,0,0,2
S01011528,Occupancy rating -1 or less,53,15,5,10,31,1,15,2,10,3,15,13,2,7,4,0,1,2
S01011529,All households,291,139,54,85,147,14,68,31,27,10,65,46,19,5,3,0,0,2
S01011529,Occupancy rating +2 or more,23,7,5,2,16,6,8,6,1,1,2,2,0,0,0,0,0,0
S01011529,Occupancy rating +1,84,50,17,33,33,5,24,17,5,2,4,2,2,1,1,0,0,0
S01011529,Occupancy rating 0,137,65,29,36,70,1,27,5,16,6,42,31,11,2,1,0,0,1
S01011529,Occupancy rating -1 or less,47,17,3,14,28,2,9,3,5,1,17,11,6,2,1,0,0,1
S01011530,All households,468,200,72,128,246,29,154,59,56,39,63,33,30,22,9,0,0,13
S01011530,Occupancy rating +2 or more,88,40,15,25,45,13,29,11,9,9,3,1,2,3,1,0,0,2
S01011530,Occupancy rating +1,164,90,37,53,74,14,51,36,8,7,9,2,7,0,0,0,0,0
S01011530,Occupancy rating 0,159,59,18,41,95,1,53,11,26,16,41,22,19,5,1,0,0,4
S01011530,Occupancy rating -1 or less,57,11,2,9,32,1,21,1,13,7,10,8,2,14,7,0,0,7
S01011531,All households,473,137,72,65,314,44,219,79,104,36,51,24,27,22,12,0,1,9
S01011531,Occupancy rating +2 or more,180,35,22,13,138,17,109,32,59,18,12,7,5,7,5,0,0,2
S01011531,Occupancy rating +1,172,74,25,49,93,17,65,43,17,5,11,4,7,5,1,0,1,3
S01011531,Occupancy rating 0,98,27,24,3,68,7,37,1,23,13,24,11,13,3,1,0,0,2
S01011531,Occupancy rating -1 or less,23,1,1,0,15,3,8,3,5,0,4,2,2,7,5,0,0,2
S01011532,All households,237,42,6,36,186,8,150,44,91,15,28,23,5,9,4,0,1,4
S01011532,Occupancy rating +2 or more,162,25,3,22,134,5,115,40,67,8,14,10,4,3,0,0,1,2
S01011532,Occupancy rating +1,44,14,2,12,29,3,19,4,10,5,7,6,1,1,1,0,0,0
S01011532,Occupancy rating 0,20,0,0,0,15,0,11,0,10,1,4,4,0,5,3,0,0,2
S01011532,Occupancy rating -1 or less,11,3,1,2,8,0,5,0,4,1,3,3,0,0,0,0,0,0
S01011533,All households,315,142,51,91,163,7,93,34,34,25,63,34,29,10,5,0,2,3
S01011533,Occupancy rating +2 or more,52,23,10,13,27,1,24,16,5,3,2,1,1,2,0,0,1,1
S01011533,Occupancy rating +1,133,87,27,60,44,4,31,12,8,11,9,4,5,2,0,0,0,2
S01011533,Occupancy rating 0,91,20,8,12,69,2,31,6,16,9,36,18,18,2,1,0,1,0
S01011533,Occupancy rating -1 or less,39,12,6,6,23,0,7,0,5,2,16,11,5,4,4,0,0,0
S01011534,All households,341,115,47,68,213,16,137,52,64,21,60,38,22,13,6,0,0,7
S01011534,Occupancy rating +2 or more,64,19,4,15,44,6,37,19,11,7,1,1,0,1,0,0,0,1
S01011534,Occupancy rating +1,139,63,29,34,72,9,47,29,13,5,16,7,9,4,1,0,0,3
S01011534,Occupancy rating 0,109,25,13,12,79,1,43,3,34,6,35,24,11,5,4,0,0,1
S01011534,Occupancy rating -1 or less,29,8,1,7,18,0,10,1,6,3,8,6,2,3,1,0,0,2
S01011535,All households,467,229,78,151,227,31,90,36,40,14,106,75,31,11,4,0,3,4
S01011535,Occupancy rating +2 or more,91,47,14,33,42,12,28,16,6,6,2,2,0,2,1,0,0,1
S01011535,Occupancy rating +1,157,100,17,83,55,10,22,14,8,0,23,10,13,2,0,0,0,2
S01011535,Occupancy rating 0,182,69,41,28,109,8,32,4,21,7,69,52,17,4,1,0,2,1
S01011535,Occupancy rating -1 or less,37,13,6,7,21,1,8,2,5,1,12,11,1,3,2,0,1,0
S01011536,All households,269,62,19,43,198,16,157,54,57,46,25,10,15,9,5,0,0,4
S01011536,Occupancy rating +2 or more,116,15,8,7,100,13,79,28,26,25,8,0,8,1,0,0,0,1
S01011536,Occupancy rating +1,74,23,4,19,48,2,43,21,11,11,3,2,1,3,2,0,0,1
S01011536,Occupancy rating 0,57,17,2,15,38,1,27,4,15,8,10,4,6,2,1,0,0,1
S01011536,Occupancy rating -1 or less,22,7,5,2,12,0,8,1,5,2,4,4,0,3,2,0,0,1
S01011537,All households,252,89,14,75,159,7,124,57,51,16,28,14,14,4,1,0,0,3
S01011537,Occupancy rating +2 or more,56,14,5,9,40,4,34,19,13,2,2,0,2,2,0,0,0,2
S01011537,Occupancy rating +1,112,55,7,48,57,2,47,31,11,5,8,6,2,0,0,0,0,0
S01011537,Occupancy rating 0,71,19,1,18,51,0,37,5,24,8,14,6,8,1,0,0,0,1
S01011537,Occupancy rating -1 or less,13,1,1,0,11,1,6,2,3,1,4,2,2,1,1,0,0,0
S01011538,All households,259,52,21,31,200,20,162,63,67,32,18,8,10,7,3,1,1,2
S01011538,Occupancy rating +2 or more,153,25,8,17,126,14,107,50,38,19,5,1,4,2,1,0,0,1
S01011538,Occupancy rating +1,79,25,13,12,52,6,41,13,19,9,5,3,2,2,0,1,1,0
S01011538,Occupancy rating 0,18,1,0,1,16,0,12,0,8,4,4,3,1,1,0,0,0,1
S01011538,Occupancy rating -1 or less,9,1,0,1,6,0,2,0,2,0,4,1,3,2,2,0,0,0
S01011539,All households,312,102,44,58,192,25,108,37,40,31,59,30,29,18,9,0,0,9
S01011539,Occupancy rating +2 or more,106,51,22,29,55,18,33,28,4,1,4,1,3,0,0,0,0,0
S01011539,Occupancy rating +1,103,35,16,19,63,6,32,8,13,11,25,10,15,5,1,0,0,4
S01011539,Occupancy rating 0,70,15,6,9,51,1,29,1,16,12,21,13,8,4,2,0,0,2
S01011539,Occupancy rating -1 or less,33,1,0,1,23,0,14,0,7,7,9,6,3,9,6,0,0,3
S01011540,All households,431,106,49,57,297,33,186,69,77,40,78,42,36,28,15,0,2,11
S01011540,Occupancy rating +2 or more,87,36,13,23,51,11,39,28,9,2,1,1,0,0,0,0,0,0
S01011540,Occupancy rating +1,182,62,33,29,115,14,77,38,28,11,24,6,18,5,1,0,2,2
S01011540,Occupancy rating 0,105,5,2,3,89,5,48,2,25,21,36,24,12,11,6,0,0,5
S01011540,Occupancy rating -1 or less,57,3,1,2,42,3,22,1,15,6,17,11,6,12,8,0,0,4
S01011541,All households,382,99,34,65,262,12,158,52,80,26,92,66,26,21,13,0,0,8
S01011541,Occupancy rating +2 or more,61,22,9,13,39,5,33,25,6,2,1,0,1,0,0,0,0,0
S01011541,Occupancy rating +1,137,62,20,42,69,7,43,22,13,8,19,12,7,6,2,0,0,4
S01011541,Occupancy rating 0,121,9,4,5,109,0,56,4,41,11,53,41,12,3,1,0,0,2
S01011541,Occupancy rating -1 or less,63,6,1,5,45,0,26,1,20,5,19,13,6,12,10,0,0,2
S01011542,All households,374,86,37,49,265,26,166,56,71,39,73,44,29,23,10,0,0,13
S01011542,Occupancy rating +2 or more,83,33,18,15,49,13,30,25,3,2,6,5,1,1,0,0,0,1
S01011542,Occupancy rating +1,120,42,11,31,75,11,46,26,11,9,18,7,11,3,0,0,0,3
S01011542,Occupancy rating 0,116,6,5,1,101,1,65,5,36,24,35,25,10,9,2,0,0,7
S01011542,Occupancy rating -1 or less,55,5,3,2,40,1,25,0,21,4,14,7,7,10,8,0,0,2
S01011543,All households,325,88,27,61,222,9,134,41,67,26,79,56,23,15,7,0,1,7
S01011543,Occupancy rating +2 or more,44,23,7,16,21,4,16,12,3,1,1,1,0,0,0,0,0,0
S01011543,Occupancy rating +1,96,43,10,33,52,3,41,26,12,3,8,4,4,1,0,0,0,1
S01011543,Occupancy rating 0,116,15,7,8,98,2,47,2,30,15,49,38,11,3,0,0,0,3
S01011543,Occupancy rating -1 or less,69,7,3,4,51,0,30,1,22,7,21,13,8,11,7,0,1,3
S01011544,All households,295,100,50,50,179,11,125,41,48,36,43,29,14,16,11,0,1,4
S01011544,Occupancy rating +2 or more,49,29,10,19,20,2,16,12,2,2,2,1,1,0,0,0,0,0
S01011544,Occupancy rating +1,92,35,17,18,57,5,44,19,10,15,8,3,5,0,0,0,0,0
S01011544,Occupancy rating 0,103,30,21,9,68,4,45,5,25,15,19,11,8,5,4,0,0,1
S01011544,Occupancy rating -1 or less,51,6,2,4,34,0,20,5,11,4,14,14,0,11,7,0,1,3
S01011545,All households,252,75,47,28,166,11,106,41,38,27,49,23,26,11,2,0,0,9
S01011545,Occupancy rating +2 or more,50,23,17,6,26,6,20,17,2,1,0,0,0,1,0,0,0,1
S01011545,Occupancy rating +1,102,44,24,20,55,3,38,21,7,10,14,4,10,3,0,0,0,3
S01011545,Occupancy rating 0,72,6,5,1,61,1,33,0,22,11,27,14,13,5,1,0,0,4
S01011545,Occupancy rating -1 or less,28,2,1,1,24,1,15,3,7,5,8,5,3,2,1,0,0,1
S01011546,All households,236,25,1,24,206,6,175,34,111,30,25,20,5,5,5,0,0,0
S01011546,Occupancy rating +2 or more,144,14,0,14,128,3,111,23,70,18,14,11,3,2,2,0,0,0
S01011546,Occupancy rating +1,60,10,1,9,48,3,40,11,24,5,5,4,1,2,2,0,0,0
S01011546,Occupancy rating 0,28,1,0,1,26,0,20,0,14,6,6,5,1,1,1,0,0,0
S01011546,Occupancy rating -1 or less,4,0,0,0,4,0,4,0,3,1,0,0,0,0,0,0,0,0
S01011547,All households,216,40,3,37,172,5,141,33,88,20,26,22,4,4,3,0,0,1
S01011547,Occupancy rating +2 or more,100,14,3,11,86,5,75,19,44,12,6,3,3,0,0,0,0,0
S01011547,Occupancy rating +1,67,22,0,22,44,0,38,13,21,4,6,6,0,1,1,0,0,0
S01011547,Occupancy rating 0,44,3,0,3,38,0,26,1,21,4,12,11,1,3,2,0,0,1
S01011547,Occupancy rating -1 or less,5,1,0,1,4,0,2,0,2,0,2,2,0,0,0,0,0,0
S01011548,All households,331,108,60,48,212,37,131,46,60,25,44,21,23,11,8,0,1,2
S01011548,Occupancy rating +2 or more,112,40,24,16,71,23,43,26,13,4,5,1,4,1,1,0,0,0
S01011548,Occupancy rating +1,133,60,30,30,72,11,47,19,15,13,14,6,8,1,0,0,0,1
S01011548,Occupancy rating 0,60,6,4,2,50,2,31,1,24,6,17,8,9,4,2,0,1,1
S01011548,Occupancy rating -1 or less,26,2,2,0,19,1,10,0,8,2,8,6,2,5,5,0,0,0
S01011549,All households,318,62,28,34,244,33,185,75,67,43,26,16,10,12,7,0,0,5
S01011549,Occupancy rating +2 or more,163,33,18,15,126,21,96,56,22,18,9,5,4,4,3,0,0,1
S01011549,Occupancy rating +1,98,26,8,18,69,12,50,18,17,15,7,3,4,3,1,0,0,2
S01011549,Occupancy rating 0,39,3,2,1,33,0,28,1,19,8,5,4,1,3,2,0,0,1
S01011549,Occupancy rating -1 or less,18,0,0,0,16,0,11,0,9,2,5,4,1,2,1,0,0,1
S01011550,All households,277,38,19,19,233,37,171,66,61,44,25,11,14,6,1,0,2,3
S01011550,Occupancy rating +2 or more,171,29,14,15,138,31,103,56,28,19,4,2,2,4,0,0,2,2
S01011550,Occupancy rating +1,70,7,4,3,61,6,46,9,20,17,9,3,6,2,1,0,0,1
S01011550,Occupancy rating 0,30,2,1,1,28,0,20,1,11,8,8,4,4,0,0,0,0,0
S01011550,Occupancy rating -1 or less,6,0,0,0,6,0,2,0,2,0,4,2,2,0,0,0,0,0
S01011551,All households,227,55,24,31,158,24,98,33,41,24,36,22,14,14,10,0,1,3
S01011551,Occupancy rating +2 or more,105,34,13,21,66,17,47,22,19,6,2,2,0,5,3,0,0,2
S01011551,Occupancy rating +1,65,13,5,8,48,5,30,9,12,9,13,5,8,4,2,0,1,1
S01011551,Occupancy rating 0,45,7,6,1,35,1,16,2,6,8,18,12,6,3,3,0,0,0
S01011551,Occupancy rating -1 or less,12,1,0,1,9,1,5,0,4,1,3,3,0,2,2,0,0,0
S01011552,All households,269,48,16,32,207,23,153,51,67,35,31,13,18,14,5,0,0,9
S01011552,Occupancy rating +2 or more,104,24,7,17,78,15,58,32,19,7,5,1,4,2,0,0,0,2
S01011552,Occupancy rating +1,97,18,7,11,75,5,59,19,23,17,11,5,6,4,1,0,0,3
S01011552,Occupancy rating 0,51,4,0,4,41,2,27,0,17,10,12,5,7,6,3,0,0,3
S01011552,Occupancy rating -1 or less,17,2,2,0,13,1,9,0,8,1,3,2,1,2,1,0,0,1
S01011553,All households,267,32,2,30,219,3,196,46,125,25,20,15,5,16,11,0,0,5
S01011553,Occupancy rating +2 or more,230,28,2,26,192,1,180,42,115,23,11,7,4,10,7,0,0,3
S01011553,Occupancy rating +1,14,2,0,2,12,2,8,4,2,2,2,2,0,0,0,0,0,0
S01011553,Occupancy rating 0,14,2,0,2,9,0,6,0,6,0,3,2,1,3,2,0,0,1
S01011553,Occupancy rating -1 or less,9,0,0,0,6,0,2,0,2,0,4,4,0,3,2,0,0,1
S01011554,All households,372,111,64,47,243,34,152,59,53,40,57,30,27,18,9,0,0,9
S01011554,Occupancy rating +2 or more,101,38,23,15,62,13,45,23,12,10,4,4,0,1,0,0,0,1
S01011554,Occupancy rating +1,128,48,22,26,77,13,53,33,11,9,11,3,8,3,2,0,0,1
S01011554,Occupancy rating 0,91,12,8,4,72,4,37,3,17,17,31,14,17,7,2,0,0,5
S01011554,Occupancy rating -1 or less,52,13,11,2,32,4,17,0,13,4,11,9,2,7,5,0,0,2
S01011555,All households,236,71,25,46,150,6,90,34,39,17,54,32,22,15,7,0,0,8
S01011555,Occupancy rating +2 or more,40,15,6,9,25,4,17,12,5,0,4,4,0,0,0,0,0,0
S01011555,Occupancy rating +1,75,39,13,26,33,2,21,15,2,4,10,3,7,3,2,0,0,1
S01011555,Occupancy rating 0,73,11,3,8,57,0,31,4,19,8,26,17,9,5,1,0,0,4
S01011555,Occupancy rating -1 or less,48,6,3,3,35,0,21,3,13,5,14,8,6,7,4,0,0,3
S01011556,All households,251,109,33,76,131,6,68,25,30,13,57,41,16,11,4,0,1,6
S01011556,Occupancy rating +2 or more,36,17,6,11,17,3,11,6,4,1,3,2,1,2,1,0,0,1
S01011556,Occupancy rating +1,79,43,17,26,33,2,24,14,7,3,7,5,2,3,0,0,1,2
S01011556,Occupancy rating 0,94,36,4,32,56,1,21,5,10,6,34,24,10,2,0,0,0,2
S01011556,Occupancy rating -1 or less,42,13,6,7,25,0,12,0,9,3,13,10,3,4,3,0,0,1
S01011557,All households,303,74,32,42,207,13,133,51,54,28,61,35,26,22,10,0,0,12
S01011557,Occupancy rating +2 or more,55,19,10,9,34,3,26,19,3,4,5,2,3,2,1,0,0,1
S01011557,Occupancy rating +1,102,44,14,30,52,5,40,28,7,5,7,3,4,6,1,0,0,5
S01011557,Occupancy rating 0,100,8,5,3,84,4,43,2,27,14,37,24,13,8,3,0,0,5
S01011557,Occupancy rating -1 or less,46,3,3,0,37,1,24,2,17,5,12,6,6,6,5,0,0,1
S01011558,All households,242,72,16,56,160,13,105,30,51,24,42,29,13,10,6,0,0,4
S01011558,Occupancy rating +2 or more,51,20,6,14,29,6,20,11,7,2,3,1,2,2,2,0,0,0
S01011558,Occupancy rating +1,88,44,9,35,44,6,32,17,10,5,6,4,2,0,0,0,0,0
S01011558,Occupancy rating 0,66,5,0,5,59,0,36,2,25,9,23,18,5,2,0,0,0,2
S01011558,Occupancy rating -1 or less,37,3,1,2,28,1,17,0,9,8,10,6,4,6,4,0,0,2
S01011559,All households,246,70,20,50,160,13,105,33,40,32,42,25,17,16,10,0,0,6
S01011559,Occupancy rating +2 or more,63,24,11,13,39,10,27,17,6,4,2,1,1,0,0,0,0,0
S01011559,Occupancy rating +1,76,33,7,26,41,2,28,12,8,8,11,3,8,2,1,0,0,1
S01011559,Occupancy rating 0,71,10,2,8,57,1,34,3,18,13,22,17,5,4,3,0,0,1
S01011559,Occupancy rating -1 or less,36,3,0,3,23,0,16,1,8,7,7,4,3,10,6,0,0,4
S01011560,All households,318,96,46,50,203,12,130,45,49,36,61,28,33,19,12,0,0,7
S01011560,Occupancy rating +2 or more,68,31,15,16,32,3,25,19,4,2,4,1,3,5,2,0,0,3
S01011560,Occupancy rating +1,101,31,16,15,67,8,46,24,10,12,13,4,9,3,1,0,0,2
S01011560,Occupancy rating 0,115,32,15,17,75,1,37,1,18,18,37,19,18,8,6,0,0,2
S01011560,Occupancy rating -1 or less,34,2,0,2,29,0,22,1,17,4,7,4,3,3,3,0,0,0
S01011561,All households,302,69,30,39,206,20,119,19,57,43,67,41,26,27,10,0,2,15
S01011561,Occupancy rating +2 or more,95,54,24,30,38,11,22,13,4,5,5,2,3,3,0,0,0,3
S01011561,Occupancy rating +1,93,12,6,6,74,7,35,4,12,19,32,19,13,7,0,0,2,5
S01011561,Occupancy rating 0,75,3,0,3,64,2,40,2,26,12,22,14,8,8,4,0,0,4
S01011561,Occupancy rating -1 or less,39,0,0,0,30,0,22,0,15,7,8,6,2,9,6,0,0,3
S01011562,All households,270,84,28,56,169,3,81,20,46,15,85,54,31,17,11,0,0,6
S01011562,Occupancy rating +2 or more,36,14,6,8,20,0,13,7,5,1,7,5,2,2,0,0,0,2
S01011562,Occupancy rating +1,97,45,11,34,47,2,24,12,6,6,21,6,15,5,3,0,0,2
S01011562,Occupancy rating 0,98,19,9,10,76,1,34,1,27,6,41,31,10,3,2,0,0,1
S01011562,Occupancy rating -1 or less,39,6,2,4,26,0,10,0,8,2,16,12,4,7,6,0,0,1
S01011563,All households,287,59,20,39,202,14,101,19,60,22,87,54,33,26,13,0,1,12
S01011563,Occupancy rating +2 or more,45,15,3,12,25,4,17,8,4,5,4,2,2,5,3,0,0,2
S01011563,Occupancy rating +1,99,27,10,17,67,8,37,6,23,8,22,10,12,5,3,0,0,2
S01011563,Occupancy rating 0,101,11,5,6,83,2,33,2,23,8,48,33,15,7,2,0,0,5
S01011563,Occupancy rating -1 or less,42,6,2,4,27,0,14,3,10,1,13,9,4,9,5,0,1,3
S01011564,All households,410,121,57,64,264,24,186,63,91,32,54,31,23,25,16,0,1,8
S01011564,Occupancy rating +2 or more,99,38,15,23,59,9,46,29,15,2,4,4,0,2,2,0,0,0
S01011564,Occupancy rating +1,171,67,33,34,99,10,77,32,32,13,12,3,9,5,1,0,0,4
S01011564,Occupancy rating 0,85,8,4,4,69,3,45,2,28,15,21,11,10,8,4,0,1,3
S01011564,Occupancy rating -1 or less,55,8,5,3,37,2,18,0,16,2,17,13,4,10,9,0,0,1
S01011565,All households,365,77,35,42,274,13,186,63,75,48,75,49,26,14,6,0,1,7
S01011565,Occupancy rating +2 or more,78,24,11,13,53,5,44,28,12,4,4,3,1,1,1,0,0,0
S01011565,Occupancy rating +1,127,31,16,15,94,7,66,29,24,13,21,12,9,2,0,0,0,2
S01011565,Occupancy rating 0,108,14,6,8,89,0,49,2,26,21,40,28,12,5,3,0,1,1
S01011565,Occupancy rating -1 or less,52,8,2,6,38,1,27,4,13,10,10,6,4,6,2,0,0,4
S01011566,All households,374,97,19,78,256,16,138,47,60,31,102,67,35,21,12,0,0,9
S01011566,Occupancy rating +2 or more,80,30,11,19,49,6,35,26,4,5,8,6,2,1,1,0,0,0
S01011566,Occupancy rating +1,125,51,5,46,71,7,41,16,14,11,23,14,9,3,1,0,0,2
S01011566,Occupancy rating 0,125,11,2,9,105,3,48,4,33,11,54,39,15,9,3,0,0,6
S01011566,Occupancy rating -1 or less,44,5,1,4,31,0,14,1,9,4,17,8,9,8,7,0,0,1
S01011567,All households,454,176,91,85,258,40,160,49,59,52,58,32,26,20,6,0,1,13
S01011567,Occupancy rating +2 or more,75,35,20,15,38,17,21,14,2,5,0,0,0,2,1,0,0,1
S01011567,Occupancy rating +1,153,65,33,32,86,19,59,27,17,15,8,4,4,2,0,0,0,2
S01011567,Occupancy rating 0,170,55,28,27,101,2,61,6,29,26,38,22,16,14,4,0,1,9
S01011567,Occupancy rating -1 or less,56,21,10,11,33,2,19,2,11,6,12,6,6,2,1,0,0,1
S01011568,All households,320,64,29,35,238,25,168,46,97,25,45,26,19,18,5,0,1,12
S01011568,Occupancy rating +2 or more,114,40,20,20,73,17,50,29,18,3,6,3,3,1,0,0,0,1
S01011568,Occupancy rating +1,102,15,7,8,81,6,61,14,40,7,14,7,7,6,0,0,0,6
S01011568,Occupancy rating 0,75,8,2,6,62,2,39,2,28,9,21,12,9,5,2,0,0,3
S01011568,Occupancy rating -1 or less,29,1,0,1,22,0,18,1,11,6,4,4,0,6,3,0,1,2
S01011569,All households,414,126,60,66,258,25,191,72,74,45,42,24,18,30,15,0,3,12
S01011569,Occupancy rating +2 or more,100,33,12,21,64,9,53,34,13,6,2,0,2,3,1,0,0,2
S01011569,Occupancy rating +1,151,53,26,27,92,8,71,30,25,16,13,7,6,6,0,0,1,5
S01011569,Occupancy rating 0,119,30,19,11,77,8,49,8,25,16,20,14,6,12,7,0,0,5
S01011569,Occupancy rating -1 or less,44,10,3,7,25,0,18,0,11,7,7,3,4,9,7,0,2,0
S01011570,All households,329,122,44,78,193,28,105,39,42,24,60,39,21,14,6,0,1,7
S01011570,Occupancy rating +2 or more,73,31,12,19,41,14,26,17,5,4,1,1,0,1,0,0,1,0
S01011570,Occupancy rating +1,112,43,22,21,66,10,37,21,6,10,19,11,8,3,1,0,0,2
S01011570,Occupancy rating 0,107,34,6,28,66,2,33,1,26,6,31,21,10,7,2,0,0,5
S01011570,Occupancy rating -1 or less,37,14,4,10,20,2,9,0,5,4,9,6,3,3,3,0,0,0
S01011571,All households,389,218,68,150,152,21,66,33,22,11,65,30,35,19,6,0,4,9
S01011571,Occupancy rating +2 or more,29,15,8,7,12,3,8,4,2,2,1,0,1,2,0,0,0,2
S01011571,Occupancy rating +1,119,83,33,50,36,10,17,13,4,0,9,5,4,0,0,0,0,0
S01011571,Occupancy rating 0,189,100,24,76,81,5,33,15,11,7,43,20,23,8,1,0,3,4
S01011571,Occupancy rating -1 or less,52,20,3,17,23,3,8,1,5,2,12,5,7,9,5,0,1,3
S01011572,All households,294,125,35,90,148,17,84,38,34,12,47,30,17,21,5,0,3,13
S01011572,Occupancy rating +2 or more,66,20,8,12,40,5,34,20,12,2,1,0,1,6,2,0,2,2
S01011572,Occupancy rating +1,91,48,12,36,37,7,15,10,2,3,15,7,8,6,1,0,0,5
S01011572,Occupancy rating 0,96,41,10,31,48,3,21,7,10,4,24,17,7,7,1,0,1,5
S01011572,Occupancy rating -1 or less,41,16,5,11,23,2,14,1,10,3,7,6,1,2,1,0,0,1
S01011573,All households,474,181,66,115,284,19,231,73,126,32,34,28,6,9,5,0,2,2
S01011573,Occupancy rating +2 or more,146,22,3,19,121,3,105,32,62,11,13,11,2,3,2,0,1,0
S01011573,Occupancy rating +1,95,21,7,14,71,8,56,19,30,7,7,6,1,3,1,0,0,2
S01011573,Occupancy rating 0,175,111,39,72,63,7,48,18,21,9,8,7,1,1,1,0,0,0
S01011573,Occupancy rating -1 or less,58,27,17,10,29,1,22,4,13,5,6,4,2,2,1,0,1,0
S01011574,All households,296,60,29,31,216,10,165,43,87,35,41,29,12,20,10,0,0,10
S01011574,Occupancy rating +2 or more,84,19,8,11,62,4,55,21,28,6,3,3,0,3,1,0,0,2
S01011574,Occupancy rating +1,104,31,18,13,71,6,54,21,26,7,11,7,4,2,0,0,0,2
S01011574,Occupancy rating 0,73,7,2,5,61,0,39,1,23,15,22,15,7,5,2,0,0,3
S01011574,Occupancy rating -1 or less,35,3,1,2,22,0,17,0,10,7,5,4,1,10,7,0,0,3
S01011575,All households,229,81,30,51,142,16,93,23,53,17,33,20,13,6,3,0,0,3
S01011575,Occupancy rating +2 or more,72,26,8,18,45,8,32,13,18,1,5,4,1,1,0,0,0,1
S01011575,Occupancy rating +1,63,23,6,17,40,6,28,7,15,6,6,3,3,0,0,0,0,0
S01011575,Occupancy rating 0,64,19,8,11,40,1,23,2,13,8,16,11,5,5,3,0,0,2
S01011575,Occupancy rating -1 or less,30,13,8,5,17,1,10,1,7,2,6,2,4,0,0,0,0,0
S01011576,All households,374,171,52,119,183,13,78,22,34,22,92,58,34,20,6,0,3,11
S01011576,Occupancy rating +2 or more,64,38,12,26,25,3,17,13,2,2,5,1,4,1,0,0,0,1
S01011576,Occupancy rating +1,128,78,26,52,49,8,19,6,4,9,22,9,13,1,0,0,0,1
S01011576,Occupancy rating 0,129,45,9,36,73,1,29,3,18,8,43,28,15,11,4,0,3,4
S01011576,Occupancy rating -1 or less,53,10,5,5,36,1,13,0,10,3,22,20,2,7,2,0,0,5
S01011577,All households,328,123,27,96,189,8,127,49,50,28,54,40,14,16,4,0,0,12
S01011577,Occupancy rating +2 or more,61,14,2,12,44,0,38,25,5,8,6,3,3,3,2,0,0,1
S01011577,Occupancy rating +1,144,70,21,49,71,8,51,22,18,11,12,9,3,3,0,0,0,3
S01011577,Occupancy rating 0,99,35,4,31,60,0,30,1,22,7,30,23,7,4,1,0,0,3
S01011577,Occupancy rating -1 or less,24,4,0,4,14,0,8,1,5,2,6,5,1,6,1,0,0,5
S01011578,All households,355,116,27,89,225,9,135,38,64,33,81,58,23,14,7,0,0,7
S01011578,Occupancy rating +2 or more,75,23,9,14,52,2,47,19,23,5,3,1,2,0,0,0,0,0
S01011578,Occupancy rating +1,113,57,14,43,51,5,32,13,7,12,14,9,5,5,1,0,0,4
S01011578,Occupancy rating 0,122,21,4,17,96,2,43,5,23,15,51,40,11,5,2,0,0,3
S01011578,Occupancy rating -1 or less,45,15,0,15,26,0,13,1,11,1,13,8,5,4,4,0,0,0
S01011579,All households,413,91,49,42,308,45,237,67,107,63,26,11,15,14,6,0,2,6
S01011579,Occupancy rating +2 or more,275,59,35,24,214,36,162,57,71,34,16,7,9,2,0,0,1,1
S01011579,Occupancy rating +1,76,23,11,12,50,8,39,8,15,16,3,0,3,3,0,0,0,3
S01011579,Occupancy rating 0,44,6,3,3,31,1,24,2,13,9,6,4,2,7,4,0,1,2
S01011579,Occupancy rating -1 or less,18,3,0,3,13,0,12,0,8,4,1,0,1,2,2,0,0,0
S01011580,All households,311,82,28,54,216,10,126,37,75,14,80,58,22,13,12,0,0,1
S01011580,Occupancy rating +2 or more,98,20,7,13,75,5,58,16,37,5,12,7,5,3,3,0,0,0
S01011580,Occupancy rating +1,83,38,11,27,44,2,30,17,11,2,12,8,4,1,1,0,0,0
S01011580,Occupancy rating 0,94,22,10,12,70,2,26,3,18,5,42,31,11,2,1,0,0,1
S01011580,Occupancy rating -1 or less,36,2,0,2,27,1,12,1,9,2,14,12,2,7,7,0,0,0
S01011581,All households,463,269,126,143,175,29,88,34,36,18,58,28,30,19,10,0,4,5
S01011581,Occupancy rating +2 or more,53,19,11,8,32,5,26,17,8,1,1,0,1,2,2,0,0,0
S01011581,Occupancy rating +1,159,108,42,66,49,17,25,14,7,4,7,0,7,2,0,0,1,1
S01011581,Occupancy rating 0,172,104,51,53,66,5,25,2,13,10,36,20,16,2,2,0,0,0
S01011581,Occupancy rating -1 or less,79,38,22,16,28,2,12,1,8,3,14,8,6,13,6,0,3,4
S01011582,All households,477,151,47,104,313,44,230,96,79,55,39,22,17,13,4,0,2,7
S01011582,Occupancy rating +2 or more,224,43,20,23,173,32,123,54,47,22,18,12,6,8,3,0,2,3
S01011582,Occupancy rating +1,115,39,15,24,74,6,60,24,18,18,8,4,4,2,0,0,0,2
S01011582,Occupancy rating 0,114,62,12,50,51,6,38,17,8,13,7,5,2,1,0,0,0,1
S01011582,Occupancy rating -1 or less,24,7,0,7,15,0,9,1,6,2,6,1,5,2,1,0,0,1
S01011583,All households,332,131,36,95,184,9,122,64,40,18,53,31,22,17,7,0,0,10
S01011583,Occupancy rating +2 or more,58,29,14,15,29,5,23,17,2,4,1,0,1,0,0,0,0,0
S01011583,Occupancy rating +1,94,44,13,31,45,3,34,23,6,5,8,5,3,5,0,0,0,5
S01011583,Occupancy rating 0,136,46,5,41,87,1,52,24,22,6,34,20,14,3,2,0,0,1
S01011583,Occupancy rating -1 or less,44,12,4,8,23,0,13,0,10,3,10,6,4,9,5,0,0,4
S01011584,All households,325,115,43,72,192,18,132,47,48,37,42,24,18,18,7,0,1,10
S01011584,Occupancy rating +2 or more,71,23,15,8,47,8,38,25,6,7,1,1,0,1,0,0,1,0
S01011584,Occupancy rating +1,111,48,18,30,60,9,41,14,13,14,10,6,4,3,0,0,0,3
S01011584,Occupancy rating 0,113,39,9,30,64,0,42,8,22,12,22,10,12,10,5,0,0,5
S01011584,Occupancy rating -1 or less,30,5,1,4,21,1,11,0,7,4,9,7,2,4,2,0,0,2
S01011585,All households,336,116,52,64,207,23,105,36,46,23,79,50,29,13,4,0,0,9
S01011585,Occupancy rating +2 or more,80,40,27,13,38,11,25,16,5,4,2,2,0,2,0,0,0,2
S01011585,Occupancy rating +1,118,58,21,37,58,8,32,19,8,5,18,8,10,2,0,0,0,2
S01011585,Occupancy rating 0,102,12,2,10,83,2,30,0,21,9,51,36,15,7,3,0,0,4
S01011585,Occupancy rating -1 or less,36,6,2,4,28,2,18,1,12,5,8,4,4,2,1,0,0,1
S01011586,All households,239,77,31,46,152,14,93,33,30,30,45,33,12,10,4,0,1,5
S01011586,Occupancy rating +2 or more,57,25,16,9,31,7,18,14,2,2,6,3,3,1,1,0,0,0
S01011586,Occupancy rating +1,64,26,7,19,37,6,24,13,4,7,7,5,2,1,0,0,0,1
S01011586,Occupancy rating 0,85,20,4,16,62,1,39,4,17,18,22,18,4,3,0,0,1,2
S01011586,Occupancy rating -1 or less,33,6,4,2,22,0,12,2,7,3,10,7,3,5,3,0,0,2
S01011587,All households,236,56,22,34,167,13,78,24,34,20,76,48,28,13,7,0,1,5
S01011587,Occupancy rating +2 or more,65,26,10,16,35,6,24,15,6,3,5,3,2,4,0,0,0,4
S01011587,Occupancy rating +1,74,25,11,14,49,6,22,6,6,10,21,14,7,0,0,0,0,0
S01011587,Occupancy rating 0,67,3,1,2,58,1,20,1,14,5,37,22,15,6,6,0,0,0
S01011587,Occupancy rating -1 or less,30,2,0,2,25,0,12,2,8,2,13,9,4,3,1,0,1,1
S01011588,All households,302,76,37,39,199,20,109,32,56,21,70,48,22,27,16,0,0,11
S01011588,Occupancy rating +2 or more,102,48,22,26,51,13,32,23,6,3,6,5,1,3,2,0,0,1
S01011588,Occupancy rating +1,75,7,4,3,63,4,37,5,21,11,22,13,9,5,2,0,0,3
S01011588,Occupancy rating 0,86,19,10,9,57,3,26,3,21,2,28,21,7,10,8,0,0,2
S01011588,Occupancy rating -1 or less,39,2,1,1,28,0,14,1,8,5,14,9,5,9,4,0,0,5
S01011589,All households,347,87,56,31,233,33,155,49,66,40,45,28,17,27,11,0,1,15
S01011589,Occupancy rating +2 or more,139,48,26,22,88,25,60,40,14,6,3,2,1,3,1,0,0,2
S01011589,Occupancy rating +1,75,9,7,2,59,3,38,6,18,14,18,11,7,7,1,0,1,5
S01011589,Occupancy rating 0,106,26,20,6,72,3,50,3,30,17,19,13,6,8,4,0,0,4
S01011589,Occupancy rating -1 or less,27,4,3,1,14,2,7,0,4,3,5,2,3,9,5,0,0,4
S01011590,All households,287,91,42,49,181,17,118,35,54,29,46,21,25,15,9,0,1,5
S01011590,Occupancy rating +2 or more,98,46,23,23,50,12,35,25,6,4,3,0,3,2,0,0,0,2
S01011590,Occupancy rating +1,66,10,4,6,52,4,33,3,19,11,15,4,11,4,2,0,1,1
S01011590,Occupancy rating 0,92,34,14,20,53,1,33,5,17,11,19,14,5,5,3,0,0,2
S01011590,Occupancy rating -1 or less,31,1,1,0,26,0,17,2,12,3,9,3,6,4,4,0,0,0
S01011591,All households,268,104,26,78,145,13,93,29,38,26,39,20,19,19,12,0,1,6
S01011591,Occupancy rating +2 or more,67,29,13,16,34,6,23,19,2,2,5,0,5,4,0,0,1,3
S01011591,Occupancy rating +1,64,24,1,23,38,4,26,5,11,10,8,4,4,2,1,0,0,1
S01011591,Occupancy rating 0,108,45,12,33,56,3,31,5,17,9,22,16,6,7,6,0,0,1
S01011591,Occupancy rating -1 or less,29,6,0,6,17,0,13,0,8,5,4,0,4,6,5,0,0,1
S01011592,All households,353,134,44,90,203,20,101,47,38,16,82,58,24,16,4,0,1,11
S01011592,Occupancy rating +2 or more,26,8,3,5,18,1,13,9,3,1,4,2,2,0,0,0,0,0
S01011592,Occupancy rating +1,187,108,34,74,78,17,45,33,6,6,16,11,5,1,0,0,0,1
S01011592,Occupancy rating 0,110,14,6,8,85,1,33,4,22,7,51,40,11,11,3,0,0,8
S01011592,Occupancy rating -1 or less,30,4,1,3,22,1,10,1,7,2,11,5,6,4,1,0,1,2
S01011593,All households,325,113,55,58,197,30,126,48,55,23,41,22,19,15,7,0,1,7
S01011593,Occupancy rating +2 or more,119,34,16,18,82,12,64,30,25,9,6,4,2,3,0,0,0,3
S01011593,Occupancy rating +1,81,31,13,18,48,10,30,10,13,7,8,3,5,2,2,0,0,0
S01011593,Occupancy rating 0,99,43,23,20,50,6,24,6,13,5,20,13,7,6,2,0,1,3
S01011593,Occupancy rating -1 or less,26,5,3,2,17,2,8,2,4,2,7,2,5,4,3,0,0,1
S01011594,All households,221,97,43,54,115,19,73,32,27,14,23,13,10,9,5,0,1,3
S01011594,Occupancy rating +2 or more,55,19,11,8,33,7,25,12,6,7,1,0,1,3,2,0,0,1
S01011594,Occupancy rating +1,54,25,8,17,27,5,17,8,5,4,5,1,4,2,1,0,1,0
S01011594,Occupancy rating 0,89,51,23,28,37,3,23,10,10,3,11,7,4,1,0,0,0,1
S01011594,Occupancy rating -1 or less,23,2,1,1,18,4,8,2,6,0,6,5,1,3,2,0,0,1
S01011595,All households,301,125,19,106,166,24,115,52,44,19,27,14,13,10,2,0,0,8
S01011595,Occupancy rating +2 or more,102,20,6,14,80,18,57,26,20,11,5,2,3,2,1,0,0,1
S01011595,Occupancy rating +1,50,22,4,18,28,2,24,11,9,4,2,1,1,0,0,0,0,0
S01011595,Occupancy rating 0,112,69,6,63,39,2,24,14,7,3,13,7,6,4,1,0,0,3
S01011595,Occupancy rating -1 or less,37,14,3,11,19,2,10,1,8,1,7,4,3,4,0,0,0,4
S01011596,All households,489,202,65,137,267,28,169,82,57,30,70,41,29,20,7,0,0,13
S01011596,Occupancy rating +2 or more,112,39,15,24,73,11,55,23,21,11,7,3,4,0,0,0,0,0
S01011596,Occupancy rating +1,200,104,28,76,95,9,73,52,13,8,13,6,7,1,1,0,0,0
S01011596,Occupancy rating 0,133,46,15,31,77,7,30,5,17,8,40,25,15,10,1,0,0,9
S01011596,Occupancy rating -1 or less,44,13,7,6,22,1,11,2,6,3,10,7,3,9,5,0,0,4
S01011597,All households,268,133,27,106,129,8,101,41,41,19,20,11,9,6,4,0,0,2
S01011597,Occupancy rating +2 or more,50,16,5,11,32,3,26,12,8,6,3,1,2,2,2,0,0,0
S01011597,Occupancy rating +1,93,54,14,40,39,2,35,21,10,4,2,0,2,0,0,0,0,0
S01011597,Occupancy rating 0,99,52,5,47,44,3,31,8,17,6,10,5,5,3,2,0,0,1
S01011597,Occupancy rating -1 or less,26,11,3,8,14,0,9,0,6,3,5,5,0,1,0,0,0,1
S01011598,All households,544,382,61,321,143,4,64,38,21,5,75,55,20,19,4,0,0,15
S01011598,Occupancy rating +2 or more,29,24,8,16,5,1,3,0,3,0,1,1,0,0,0,0,0,0
S01011598,Occupancy rating +1,211,175,29,146,34,0,31,30,1,0,3,3,0,2,0,0,0,2
S01011598,Occupancy rating 0,229,146,18,128,76,3,22,7,13,2,51,37,14,7,0,0,0,7
S01011598,Occupancy rating -1 or less,75,37,6,31,28,0,8,1,4,3,20,14,6,10,4,0,0,6
S01011599,All households,362,121,60,61,220,27,130,50,55,25,63,38,25,21,8,0,1,12
S01011599,Occupancy rating +2 or more,63,28,19,9,34,5,25,18,4,3,4,1,3,1,1,0,0,0
S01011599,Occupancy rating +1,162,80,38,42,75,17,52,29,15,8,6,3,3,7,1,0,0,6
S01011599,Occupancy rating 0,101,7,3,4,85,4,38,3,28,7,43,25,18,9,3,0,1,5
S01011599,Occupancy rating -1 or less,36,6,0,6,26,1,15,0,8,7,10,9,1,4,3,0,0,1
S01011600,All households,392,168,81,87,210,30,123,59,42,22,57,37,20,14,4,0,0,10
S01011600,Occupancy rating +2 or more,55,26,18,8,28,9,17,12,3,2,2,2,0,1,1,0,0,0
S01011600,Occupancy rating +1,155,78,27,51,74,16,45,34,3,8,13,8,5,3,0,0,0,3
S01011600,Occupancy rating 0,138,50,26,24,85,5,46,11,26,9,34,21,13,3,0,0,0,3
S01011600,Occupancy rating -1 or less,44,14,10,4,23,0,15,2,10,3,8,6,2,7,3,0,0,4
S01011601,All households,316,46,11,35,256,13,196,70,99,27,47,38,9,14,6,0,0,8
S01011601,Occupancy rating +2 or more,108,15,3,12,91,7,75,33,32,10,9,6,3,2,1,0,0,1
S01011601,Occupancy rating +1,127,29,7,22,93,6,75,35,31,9,12,9,3,5,2,0,0,3
S01011601,Occupancy rating 0,59,1,1,0,54,0,33,0,29,4,21,19,2,4,0,0,0,4
S01011601,Occupancy rating -1 or less,22,1,0,1,18,0,13,2,7,4,5,4,1,3,3,0,0,0
S01011602,All households,266,88,35,53,155,15,98,32,42,24,42,29,13,23,12,0,4,7
S01011602,Occupancy rating +2 or more,78,34,16,18,41,6,30,17,8,5,5,4,1,3,1,0,1,1
S01011602,Occupancy rating +1,90,30,10,20,52,8,33,13,13,7,11,7,4,8,1,0,2,5
S01011602,Occupancy rating 0,57,14,3,11,36,1,20,1,12,7,15,11,4,7,5,0,1,1
S01011602,Occupancy rating -1 or less,41,10,6,4,26,0,15,1,9,5,11,7,4,5,5,0,0,0
S01011603,All households,443,245,118,127,180,28,95,40,37,18,57,35,22,18,7,0,0,11
S01011603,Occupancy rating +2 or more,62,33,15,18,28,7,14,7,3,4,7,5,2,1,1,0,0,0
S01011603,Occupancy rating +1,109,56,25,31,52,11,29,16,9,4,12,5,7,1,0,0,0,1
S01011603,Occupancy rating 0,203,123,63,60,70,10,32,13,14,5,28,19,9,10,3,0,0,7
S01011603,Occupancy rating -1 or less,69,33,15,18,30,0,20,4,11,5,10,6,4,6,3,0,0,3
S01011604,All households,293,94,42,52,182,29,94,26,52,16,59,40,19,17,9,0,0,8
S01011604,Occupancy rating +2 or more,65,35,11,24,30,10,15,10,4,1,5,2,3,0,0,0,0,0
S01011604,Occupancy rating +1,105,41,25,16,61,17,33,15,13,5,11,10,1,3,0,0,0,3
S01011604,Occupancy rating 0,82,10,2,8,64,2,34,1,25,8,28,17,11,8,5,0,0,3
S01011604,Occupancy rating -1 or less,41,8,4,4,27,0,12,0,10,2,15,11,4,6,4,0,0,2
S01011605,All households,376,136,70,66,221,44,134,37,59,38,43,24,19,19,6,0,0,13
S01011605,Occupancy rating +2 or more,77,35,17,18,42,17,23,14,5,4,2,2,0,0,0,0,0,0
S01011605,Occupancy rating +1,137,64,32,32,71,16,46,18,14,14,9,6,3,2,0,0,0,2
S01011605,Occupancy rating 0,111,24,12,12,77,6,43,4,31,8,28,14,14,10,0,0,0,10
S01011605,Occupancy rating -1 or less,51,13,9,4,31,5,22,1,9,12,4,2,2,7,6,0,0,1
S01011606,All households,342,46,6,40,286,3,242,56,150,36,41,29,12,10,5,0,0,5
S01011606,Occupancy rating +2 or more,190,26,2,24,161,3,143,44,81,18,15,9,6,3,1,0,0,2
S01011606,Occupancy rating +1,81,15,3,12,65,0,53,10,34,9,12,8,4,1,1,0,0,0
S01011606,Occupancy rating 0,51,4,1,3,43,0,31,1,26,4,12,11,1,4,2,0,0,2
S01011606,Occupancy rating -1 or less,20,1,0,1,17,0,15,1,9,5,2,1,1,2,1,0,0,1
S01011607,All households,231,56,7,49,169,14,134,48,55,31,21,13,8,6,3,0,0,3
S01011607,Occupancy rating +2 or more,84,7,2,5,76,9,64,33,19,12,3,0,3,1,0,0,0,1
S01011607,Occupancy rating +1,70,22,3,19,45,4,34,12,13,9,7,5,2,3,2,0,0,1
S01011607,Occupancy rating 0,52,22,1,21,29,1,21,1,16,4,7,4,3,1,1,0,0,0
S01011607,Occupancy rating -1 or less,25,5,1,4,19,0,15,2,7,6,4,4,0,1,0,0,0,1
S01011608,All households,360,58,10,48,285,10,233,89,101,43,42,34,8,17,7,0,0,10
S01011608,Occupancy rating +2 or more,177,25,6,19,148,7,132,57,56,19,9,9,0,4,0,0,0,4
S01011608,Occupancy rating +1,90,27,4,23,62,2,52,26,18,8,8,5,3,1,1,0,0,0
S01011608,Occupancy rating 0,77,5,0,5,64,1,42,4,27,11,21,17,4,8,3,0,0,5
S01011608,Occupancy rating -1 or less,16,1,0,1,11,0,7,2,0,5,4,3,1,4,3,0,0,1
S01011609,All households,479,217,49,168,229,12,110,35,55,20,107,74,33,33,13,0,0,20
S01011609,Occupancy rating +2 or more,65,33,12,21,25,7,13,6,2,5,5,3,2,7,2,0,0,5
S01011609,Occupancy rating +1,192,123,25,98,60,2,41,22,14,5,17,8,9,9,3,0,0,6
S01011609,Occupancy rating 0,143,40,11,29,95,1,36,5,24,7,58,40,18,8,2,0,0,6
S01011609,Occupancy rating -1 or less,79,21,1,20,49,2,20,2,15,3,27,23,4,9,6,0,0,3
S01011610,All households,362,115,43,72,230,16,128,43,57,28,86,53,33,17,9,0,1,7
S01011610,Occupancy rating +2 or more,88,26,12,14,61,8,38,22,12,4,15,6,9,1,0,0,0,1
S01011610,Occupancy rating +1,108,40,10,30,64,2,40,14,14,12,22,9,13,4,1,0,0,3
S01011610,Occupancy rating 0,120,40,16,24,75,6,36,5,24,7,33,26,7,5,2,0,1,2
S01011610,Occupancy rating -1 or less,46,9,5,4,30,0,14,2,7,5,16,12,4,7,6,0,0,1
S01011611,All households,258,74,22,52,172,12,137,47,57,33,23,18,5,12,5,0,0,7
S01011611,Occupancy rating +2 or more,100,28,9,19,69,6,60,27,20,13,3,1,2,3,2,0,0,1
S01011611,Occupancy rating +1,87,30,8,22,53,4,41,17,14,10,8,7,1,4,0,0,0,4
S01011611,Occupancy rating 0,51,11,3,8,36,1,27,2,16,9,8,7,1,4,2,0,0,2
S01011611,Occupancy rating -1 or less,20,5,2,3,14,1,9,1,7,1,4,3,1,1,1,0,0,0
S01011612,All households,211,22,2,20,178,1,165,51,98,16,12,11,1,11,5,0,0,6
S01011612,Occupancy rating +2 or more,171,18,1,17,146,1,138,48,79,11,7,7,0,7,2,0,0,5
S01011612,Occupancy rating +1,28,3,0,3,24,0,21,3,15,3,3,3,0,1,0,0,0,1
S01011612,Occupancy rating 0,8,1,1,0,5,0,4,0,3,1,1,1,0,2,2,0,0,0
S01011612,Occupancy rating -1 or less,4,0,0,0,3,0,2,0,1,1,1,0,1,1,1,0,0,0
S01011613,All households,374,58,28,30,305,47,228,97,78,53,30,22,8,11,6,0,0,5
S01011613,Occupancy rating +2 or more,240,43,22,21,194,41,144,83,37,24,9,4,5,3,1,0,0,2
S01011613,Occupancy rating +1,86,10,3,7,74,4,58,12,26,20,12,11,1,2,2,0,0,0
S01011613,Occupancy rating 0,38,5,3,2,29,2,20,2,13,5,7,6,1,4,2,0,0,2
S01011613,Occupancy rating -1 or less,10,0,0,0,8,0,6,0,2,4,2,1,1,2,1,0,0,1
S01011614,All households,183,51,20,31,123,14,91,36,37,18,18,6,12,9,5,0,0,4
S01011614,Occupancy rating +2 or more,68,14,6,8,50,2,46,25,13,8,2,1,1,4,3,0,0,1
S01011614,Occupancy rating +1,48,17,7,10,31,4,20,6,9,5,7,2,5,0,0,0,0,0
S01011614,Occupancy rating 0,49,19,7,12,27,6,14,4,7,3,7,2,5,3,2,0,0,1
S01011614,Occupancy rating -1 or less,18,1,0,1,15,2,11,1,8,2,2,1,1,2,0,0,0,2
S01011615,All households,296,79,28,51,198,16,119,39,53,27,63,44,19,19,14,0,0,5
S01011615,Occupancy rating +2 or more,94,42,17,25,51,9,39,25,7,7,3,3,0,1,1,0,0,0
S01011615,Occupancy rating +1,95,32,10,22,59,5,39,12,19,8,15,11,4,4,1,0,0,3
S01011615,Occupancy rating 0,81,5,1,4,67,1,29,2,19,8,37,25,12,9,8,0,0,1
S01011615,Occupancy rating -1 or less,26,0,0,0,21,1,12,0,8,4,8,5,3,5,4,0,0,1
S01011616,All households,211,83,32,51,116,17,58,26,20,12,41,28,13,12,5,0,0,7
S01011616,Occupancy rating +2 or more,48,22,9,13,26,7,17,11,4,2,2,0,2,0,0,0,0,0
S01011616,Occupancy rating +1,76,40,15,25,32,9,20,13,5,2,3,2,1,4,1,0,0,3
S01011616,Occupancy rating 0,64,18,7,11,42,0,16,1,9,6,26,18,8,4,1,0,0,3
S01011616,Occupancy rating -1 or less,23,3,1,2,16,1,5,1,2,2,10,8,2,4,3,0,0,1
S01011617,All households,388,135,54,81,234,30,133,56,47,30,71,40,31,19,10,0,0,9
S01011617,Occupancy rating +2 or more,70,32,15,17,37,12,23,16,5,2,2,1,1,1,0,0,0,1
S01011617,Occupancy rating +1,143,65,27,38,76,14,46,32,6,8,16,8,8,2,0,0,0,2
S01011617,Occupancy rating 0,118,29,10,19,83,3,42,4,22,16,38,24,14,6,4,0,0,2
S01011617,Occupancy rating -1 or less,57,9,2,7,38,1,22,4,14,4,15,7,8,10,6,0,0,4
S01011618,All households,277,90,41,49,175,15,106,35,47,24,54,40,14,12,7,0,2,3
S01011618,Occupancy rating +2 or more,88,42,23,19,43,12,29,20,4,5,2,2,0,3,0,0,0,3
S01011618,Occupancy rating +1,101,38,14,24,63,1,44,14,18,12,18,8,10,0,0,0,0,0
S01011618,Occupancy rating 0,60,7,4,3,50,1,21,1,15,5,28,24,4,3,1,0,2,0
S01011618,Occupancy rating -1 or less,28,3,0,3,19,1,12,0,10,2,6,6,0,6,6,0,0,0
S01011619,All households,406,90,17,73,293,14,237,83,115,39,42,28,14,23,12,0,0,11
S01011619,Occupancy rating +2 or more,193,41,10,31,146,12,124,61,52,11,10,6,4,6,3,0,0,3
S01011619,Occupancy rating +1,126,33,4,29,88,2,76,17,40,19,10,4,6,5,1,0,0,4
S01011619,Occupancy rating 0,72,15,3,12,47,0,31,4,19,8,16,14,2,10,7,0,0,3
S01011619,Occupancy rating -1 or less,15,1,0,1,12,0,6,1,4,1,6,4,2,2,1,0,0,1
S01011620,All households,394,51,3,48,331,11,283,103,155,25,37,27,10,12,5,0,0,7
S01011620,Occupancy rating +2 or more,271,35,1,34,230,7,203,90,96,17,20,16,4,6,2,0,0,4
S01011620,Occupancy rating +1,80,11,1,10,66,4,52,11,37,4,10,5,5,3,1,0,0,2
S01011620,Occupancy rating 0,35,4,1,3,29,0,24,1,20,3,5,5,0,2,1,0,0,1
S01011620,Occupancy rating -1 or less,8,1,0,1,6,0,4,1,2,1,2,1,1,1,1,0,0,0
S01011621,All households,286,59,23,36,210,16,148,45,74,29,46,26,20,17,14,0,0,3
S01011621,Occupancy rating +2 or more,128,33,17,16,93,16,66,39,15,12,11,3,8,2,0,0,0,2
S01011621,Occupancy rating +1,75,22,5,17,49,0,36,4,24,8,13,6,7,4,3,0,0,1
S01011621,Occupancy rating 0,64,4,1,3,56,0,39,2,30,7,17,13,4,4,4,0,0,0
S01011621,Occupancy rating -1 or less,19,0,0,0,12,0,7,0,5,2,5,4,1,7,7,0,0,0
S01011622,All households,230,37,9,28,181,10,157,46,94,17,14,8,6,12,5,0,1,6
S01011622,Occupancy rating +2 or more,178,28,5,23,147,8,132,43,77,12,7,5,2,3,2,0,0,1
S01011622,Occupancy rating +1,28,9,4,5,17,2,12,3,9,0,3,1,2,2,1,0,1,0
S01011622,Occupancy rating 0,13,0,0,0,9,0,8,0,5,3,1,1,0,4,1,0,0,3
S01011622,Occupancy rating -1 or less,11,0,0,0,8,0,5,0,3,2,3,1,2,3,1,0,0,2
S01011623,All households,314,107,49,58,190,27,112,35,52,25,51,37,14,17,7,0,2,8
S01011623,Occupancy rating +2 or more,86,30,14,16,53,13,33,13,13,7,7,4,3,3,1,0,1,1
S01011623,Occupancy rating +1,95,33,11,22,57,8,38,12,16,10,11,9,2,5,1,0,0,4
S01011623,Occupancy rating 0,100,33,21,12,64,6,32,8,18,6,26,19,7,3,0,0,1,2
S01011623,Occupancy rating -1 or less,33,11,3,8,16,0,9,2,5,2,7,5,2,6,5,0,0,1
S01011624,All households,294,70,18,52,211,14,150,60,72,18,47,33,14,13,7,0,0,6
S01011624,Occupancy rating +2 or more,132,25,6,19,105,6,87,42,34,11,12,8,4,2,1,0,0,1
S01011624,Occupancy rating +1,91,35,10,25,53,5,39,17,18,4,9,6,3,3,0,0,0,3
S01011624,Occupancy rating 0,56,8,2,6,44,2,21,0,18,3,21,15,6,4,2,0,0,2
S01011624,Occupancy rating -1 or less,15,2,0,2,9,1,3,1,2,0,5,4,1,4,4,0,0,0
S01011625,All households,240,73,29,44,156,10,112,51,43,18,34,25,9,11,4,0,0,7
S01011625,Occupancy rating +2 or more,57,19,11,8,38,5,33,26,6,1,0,0,0,0,0,0,0,0
S01011625,Occupancy rating +1,74,24,10,14,45,3,33,16,9,8,9,6,3,5,1,0,0,4
S01011625,Occupancy rating 0,73,21,4,17,50,2,29,7,15,7,19,14,5,2,1,0,0,1
S01011625,Occupancy rating -1 or less,36,9,4,5,23,0,17,2,13,2,6,5,1,4,2,0,0,2
S01011626,All households,289,54,10,44,224,9,185,45,107,33,30,23,7,11,3,0,0,8
S01011626,Occupancy rating +2 or more,160,27,5,22,130,5,116,39,58,19,9,6,3,3,0,0,0,3
S01011626,Occupancy rating +1,74,25,4,21,46,4,36,6,24,6,6,5,1,3,1,0,0,2
S01011626,Occupancy rating 0,41,1,0,1,37,0,24,0,17,7,13,11,2,3,1,0,0,2
S01011626,Occupancy rating -1 or less,14,1,1,0,11,0,9,0,8,1,2,1,1,2,1,0,0,1
S01011627,All households,260,43,7,36,209,6,180,58,107,15,23,19,4,8,4,0,0,4
S01011627,Occupancy rating +2 or more,150,21,3,18,124,2,116,48,64,4,6,5,1,5,3,0,0,2
S01011627,Occupancy rating +1,65,19,3,16,46,3,38,10,20,8,5,2,3,0,0,0,0,0
S01011627,Occupancy rating 0,35,1,1,0,32,1,19,0,18,1,12,12,0,2,0,0,0,2
S01011627,Occupancy rating -1 or less,10,2,0,2,7,0,7,0,5,2,0,0,0,1,1,0,0,0
S01011628,All households,410,68,28,40,331,49,244,82,108,54,38,20,18,11,6,0,0,5
S01011628,Occupancy rating +2 or more,209,33,20,13,173,32,130,60,51,19,11,5,6,3,0,0,0,3
S01011628,Occupancy rating +1,127,29,8,21,94,14,67,18,31,18,13,6,7,4,3,0,0,1
S01011628,Occupancy rating 0,54,5,0,5,49,2,38,4,23,11,9,6,3,0,0,0,0,0
S01011628,Occupancy rating -1 or less,20,1,0,1,15,1,9,0,3,6,5,3,2,4,3,0,0,1
S01011629,All households,240,54,26,28,162,15,94,32,37,25,53,30,23,24,15,0,1,8
S01011629,Occupancy rating +2 or more,71,25,11,14,44,8,27,17,3,7,9,3,6,2,1,0,0,1
S01011629,Occupancy rating +1,79,22,15,7,53,5,31,11,8,12,17,9,8,4,1,0,1,2
S01011629,Occupancy rating 0,68,6,0,6,54,2,30,4,20,6,22,15,7,8,5,0,0,3
S01011629,Occupancy rating -1 or less,22,1,0,1,11,0,6,0,6,0,5,3,2,10,8,0,0,2
S01011630,All households,255,60,33,27,183,22,112,34,48,30,49,30,19,12,8,0,0,4
S01011630,Occupancy rating +2 or more,89,28,15,13,61,11,47,26,10,11,3,0,3,0,0,0,0,0
S01011630,Occupancy rating +1,55,10,5,5,41,7,20,5,9,6,14,9,5,4,1,0,0,3
S01011630,Occupancy rating 0,78,19,10,9,56,3,30,2,19,9,23,16,7,3,2,0,0,1
S01011630,Occupancy rating -1 or less,33,3,3,0,25,1,15,1,10,4,9,5,4,5,5,0,0,0
S01011631,All households,245,70,12,58,160,7,87,25,39,23,66,46,20,15,9,0,0,6
S01011631,Occupancy rating +2 or more,59,29,5,24,29,2,19,12,3,4,8,4,4,1,0,0,0,1
S01011631,Occupancy rating +1,75,24,4,20,48,3,25,8,10,7,20,16,4,3,0,0,0,3
S01011631,Occupancy rating 0,72,12,3,9,55,2,29,4,18,7,24,14,10,5,5,0,0,0
S01011631,Occupancy rating -1 or less,39,5,0,5,28,0,14,1,8,5,14,12,2,6,4,0,0,2
S01011632,All households,315,91,36,55,200,9,117,45,48,24,74,46,28,24,15,0,0,9
S01011632,Occupancy rating +2 or more,66,28,10,18,37,3,26,18,6,2,8,2,6,1,0,0,0,1
S01011632,Occupancy rating +1,107,40,19,21,63,6,42,27,8,7,15,10,5,4,1,0,0,3
S01011632,Occupancy rating 0,93,19,4,15,68,0,34,0,23,11,34,23,11,6,4,0,0,2
S01011632,Occupancy rating -1 or less,49,4,3,1,32,0,15,0,11,4,17,11,6,13,10,0,0,3
S01011633,All households,321,94,43,51,215,31,122,46,53,23,62,37,25,12,8,0,0,4
S01011633,Occupancy rating +2 or more,79,33,11,22,46,20,26,21,3,2,0,0,0,0,0,0,0,0
S01011633,Occupancy rating +1,83,18,8,10,64,8,39,19,14,6,17,8,9,1,1,0,0,0
S01011633,Occupancy rating 0,115,36,21,15,73,3,34,3,20,11,36,24,12,6,4,0,0,2
S01011633,Occupancy rating -1 or less,44,7,3,4,32,0,23,3,16,4,9,5,4,5,3,0,0,2
S01011634,All households,235,75,21,54,146,13,87,27,41,19,46,36,10,14,8,0,0,6
S01011634,Occupancy rating +2 or more,80,35,12,23,44,7,30,16,12,2,7,5,2,1,0,0,0,1
S01011634,Occupancy rating +1,73,21,4,17,52,3,34,9,14,11,15,11,4,0,0,0,0,0
S01011634,Occupancy rating 0,67,16,4,12,42,3,18,1,11,6,21,18,3,9,5,0,0,4
S01011634,Occupancy rating -1 or less,15,3,1,2,8,0,5,1,4,0,3,2,1,4,3,0,0,1
S01011635,All households,274,72,22,50,179,14,117,41,51,25,48,30,18,23,14,0,0,9
S01011635,Occupancy rating +2 or more,116,35,12,23,79,10,54,27,17,10,15,9,6,2,1,0,0,1
S01011635,Occupancy rating +1,81,16,2,14,56,3,40,9,22,9,13,8,5,9,4,0,0,5
S01011635,Occupancy rating 0,53,17,6,11,30,1,16,2,10,4,13,9,4,6,4,0,0,2
S01011635,Occupancy rating -1 or less,24,4,2,2,14,0,7,3,2,2,7,4,3,6,5,0,0,1
S01011636,All households,283,74,29,45,191,21,102,21,47,34,68,50,18,18,10,0,1,7
S01011636,Occupancy rating +2 or more,59,20,12,8,39,10,24,10,10,4,5,2,3,0,0,0,0,0
S01011636,Occupancy rating +1,105,44,12,32,54,8,31,8,9,14,15,10,5,7,1,0,0,6
S01011636,Occupancy rating 0,79,5,3,2,68,1,31,1,20,10,36,29,7,6,4,0,1,1
S01011636,Occupancy rating -1 or less,40,5,2,3,30,2,16,2,8,6,12,9,3,5,5,0,0,0
S01011637,All households,299,103,35,68,187,13,114,35,48,31,60,34,26,9,8,0,0,1
S01011637,Occupancy rating +2 or more,75,31,12,19,42,7,28,12,9,7,7,1,6,2,2,0,0,0
S01011637,Occupancy rating +1,94,39,12,27,53,5,37,19,10,8,11,6,5,2,1,0,0,1
S01011637,Occupancy rating 0,87,20,7,13,65,0,34,2,21,11,31,21,10,2,2,0,0,0
S01011637,Occupancy rating -1 or less,43,13,4,9,27,1,15,2,8,5,11,6,5,3,3,0,0,0
S01011638,All households,260,116,57,59,134,20,82,38,24,20,32,18,14,10,4,0,1,5
S01011638,Occupancy rating +2 or more,38,13,6,7,25,2,22,14,3,5,1,1,0,0,0,0,0,0
S01011638,Occupancy rating +1,94,44,23,21,49,9,33,17,9,7,7,4,3,1,0,0,0,1
S01011638,Occupancy rating 0,98,46,24,22,51,6,21,5,8,8,24,13,11,1,0,0,0,1
S01011638,Occupancy rating -1 or less,30,13,4,9,9,3,6,2,4,0,0,0,0,8,4,0,1,3
S01011639,All households,250,80,39,41,156,15,75,25,34,16,66,41,25,14,7,1,1,5
S01011639,Occupancy rating +2 or more,46,21,10,11,25,7,14,7,4,3,4,0,4,0,0,0,0,0
S01011639,Occupancy rating +1,93,37,20,17,54,5,31,16,10,5,18,11,7,2,0,0,1,1
S01011639,Occupancy rating 0,74,18,7,11,51,1,20,2,15,3,30,23,7,5,2,1,0,2
S01011639,Occupancy rating -1 or less,37,4,2,2,26,2,10,0,5,5,14,7,7,7,5,0,0,2
S01011640,All households,259,66,26,40,173,14,120,38,54,28,39,23,16,20,14,0,0,6
S01011640,Occupancy rating +2 or more,82,31,14,17,47,11,36,24,8,4,0,0,0,4,3,0,0,1
S01011640,Occupancy rating +1,102,29,10,19,70,2,50,13,21,16,18,7,11,3,0,0,0,3
S01011640,Occupancy rating 0,54,6,2,4,42,1,26,1,19,6,15,13,2,6,6,0,0,0
S01011640,Occupancy rating -1 or less,21,0,0,0,14,0,8,0,6,2,6,3,3,7,5,0,0,2
S01011641,All households,195,42,27,15,150,22,114,39,51,24,14,6,8,3,1,0,0,2
S01011641,Occupancy rating +2 or more,88,19,9,10,68,9,58,27,24,7,1,0,1,1,0,0,0,1
S01011641,Occupancy rating +1,77,19,14,5,57,12,39,12,15,12,6,3,3,1,0,0,0,1
S01011641,Occupancy rating 0,26,3,3,0,23,1,15,0,10,5,7,3,4,0,0,0,0,0
S01011641,Occupancy rating -1 or less,4,1,1,0,2,0,2,0,2,0,0,0,0,1,1,0,0,0
S01011642,All households,352,107,35,72,236,36,162,65,64,33,38,26,12,9,3,0,0,6
S01011642,Occupancy rating +2 or more,155,35,24,11,118,34,82,42,27,13,2,2,0,2,1,0,0,1
S01011642,Occupancy rating +1,109,59,7,52,49,2,41,20,13,8,6,5,1,1,0,0,0,1
S01011642,Occupancy rating 0,63,7,2,5,53,0,31,2,19,10,22,15,7,3,1,0,0,2
S01011642,Occupancy rating -1 or less,25,6,2,4,16,0,8,1,5,2,8,4,4,3,1,0,0,2
S01011643,All households,238,66,33,33,155,15,132,48,68,16,8,8,0,17,4,0,3,10
S01011643,Occupancy rating +2 or more,101,11,2,9,85,5,80,31,44,5,0,0,0,5,2,0,1,2
S01011643,Occupancy rating +1,52,18,6,12,33,6,25,10,9,6,2,2,0,1,0,0,0,1
S01011643,Occupancy rating 0,53,19,9,10,27,2,19,6,9,4,6,6,0,7,1,0,0,6
S01011643,Occupancy rating -1 or less,32,18,16,2,10,2,8,1,6,1,0,0,0,4,1,0,2,1
S01011644,All households,339,132,100,32,199,30,144,54,65,25,25,17,8,8,4,0,0,4
S01011644,Occupancy rating +2 or more,129,46,30,16,82,13,67,43,17,7,2,0,2,1,1,0,0,0
S01011644,Occupancy rating +1,66,25,17,8,39,7,30,7,17,6,2,1,1,2,0,0,0,2
S01011644,Occupancy rating 0,114,45,40,5,66,9,38,2,27,9,19,14,5,3,1,0,0,2
S01011644,Occupancy rating -1 or less,30,16,13,3,12,1,9,2,4,3,2,2,0,2,2,0,0,0
S01011645,All households,257,86,47,39,152,37,81,34,31,16,34,21,13,19,6,0,2,11
S01011645,Occupancy rating +2 or more,79,33,19,14,44,15,27,18,7,2,2,2,0,2,1,0,0,1
S01011645,Occupancy rating +1,106,44,23,21,58,19,27,14,7,6,12,6,6,4,1,0,0,3
S01011645,Occupancy rating 0,56,3,1,2,43,3,21,2,12,7,19,13,6,10,1,0,2,7
S01011645,Occupancy rating -1 or less,16,6,4,2,7,0,6,0,5,1,1,0,1,3,3,0,0,0
S01011646,All households,262,36,17,19,218,40,166,62,65,39,12,10,2,8,2,0,0,6
S01011646,Occupancy rating +2 or more,191,29,14,15,160,38,117,55,42,20,5,3,2,2,0,0,0,2
S01011646,Occupancy rating +1,45,6,3,3,35,1,32,6,14,12,2,2,0,4,0,0,0,4
S01011646,Occupancy rating 0,22,1,0,1,20,1,14,1,8,5,5,5,0,1,1,0,0,0
S01011646,Occupancy rating -1 or less,4,0,0,0,3,0,3,0,1,2,0,0,0,1,1,0,0,0
S01011647,All households,330,59,14,45,260,21,203,67,100,36,36,29,7,11,5,0,1,5
S01011647,Occupancy rating +2 or more,150,22,5,17,125,19,96,41,43,12,10,6,4,3,2,0,0,1
S01011647,Occupancy rating +1,110,31,8,23,76,1,68,24,34,10,7,7,0,3,1,0,1,1
S01011647,Occupancy rating 0,55,5,1,4,48,0,33,2,20,11,15,13,2,2,0,0,0,2
S01011647,Occupancy rating -1 or less,15,1,0,1,11,1,6,0,3,3,4,3,1,3,2,0,0,1
S01011648,All households,276,63,10,53,200,12,149,48,89,12,39,28,11,13,5,0,0,8
S01011648,Occupancy rating +2 or more,146,29,4,25,111,9,99,38,59,2,3,2,1,6,3,0,0,3
S01011648,Occupancy rating +1,62,26,5,21,35,3,23,8,13,2,9,5,4,1,0,0,0,1
S01011648,Occupancy rating 0,57,8,1,7,44,0,19,1,14,4,25,19,6,5,2,0,0,3
S01011648,Occupancy rating -1 or less,11,0,0,0,10,0,8,1,3,4,2,2,0,1,0,0,0,1
S01011649,All households,243,86,37,49,140,11,83,40,35,8,46,36,10,17,3,0,1,13
S01011649,Occupancy rating +2 or more,59,17,5,12,41,2,36,19,17,0,3,3,0,1,0,0,0,1
S01011649,Occupancy rating +1,89,44,18,26,44,6,29,18,7,4,9,8,1,1,0,0,0,1
S01011649,Occupancy rating 0,71,18,11,7,44,2,15,3,9,3,27,19,8,9,1,0,1,7
S01011649,Occupancy rating -1 or less,24,7,3,4,11,1,3,0,2,1,7,6,1,6,2,0,0,4
S01011650,All households,308,85,37,48,207,27,143,61,61,21,37,19,18,16,7,0,0,9
S01011650,Occupancy rating +2 or more,133,45,19,26,86,16,66,38,20,8,4,1,3,2,0,0,0,2
S01011650,Occupancy rating +1,86,27,16,11,59,8,38,18,14,6,13,6,7,0,0,0,0,0
S01011650,Occupancy rating 0,60,11,1,10,43,2,29,3,21,5,12,5,7,6,2,0,0,4
S01011650,Occupancy rating -1 or less,29,2,1,1,19,1,10,2,6,2,8,7,1,8,5,0,0,3
S01011651,All households,446,182,65,117,247,46,148,53,70,25,53,32,21,17,6,0,2,9
S01011651,Occupancy rating +2 or more,123,49,22,27,72,21,47,28,13,6,4,1,3,2,0,0,0,2
S01011651,Occupancy rating +1,178,95,34,61,79,21,48,22,19,7,10,5,5,4,1,0,2,1
S01011651,Occupancy rating 0,105,25,5,20,74,3,41,3,31,7,30,20,10,6,1,0,0,5
S01011651,Occupancy rating -1 or less,40,13,4,9,22,1,12,0,7,5,9,6,3,5,4,0,0,1
S01011652,All households,311,93,25,68,198,19,147,57,58,32,32,23,9,20,9,0,0,11
S01011652,Occupancy rating +2 or more,125,37,15,22,85,11,69,33,22,14,5,2,3,3,1,0,0,2
S01011652,Occupancy rating +1,98,32,6,26,63,6,46,18,15,13,11,6,5,3,0,0,0,3
S01011652,Occupancy rating 0,69,20,3,17,40,0,27,6,16,5,13,12,1,9,4,0,0,5
S01011652,Occupancy rating -1 or less,19,4,1,3,10,2,5,0,5,0,3,3,0,5,4,0,0,1
S01011653,All households,340,82,41,41,229,20,139,44,62,33,70,40,30,29,14,0,2,13
S01011653,Occupancy rating +2 or more,129,46,24,22,78,16,51,29,18,4,11,7,4,5,4,0,0,1
S01011653,Occupancy rating +1,94,27,14,13,61,2,36,13,15,8,23,7,16,6,2,0,1,3
S01011653,Occupancy rating 0,78,5,3,2,63,1,38,2,18,18,24,18,6,10,2,0,1,7
S01011653,Occupancy rating -1 or less,39,4,0,4,27,1,14,0,11,3,12,8,4,8,6,0,0,2
S01011654,All households,521,246,100,146,251,33,150,79,54,17,68,44,24,24,6,0,0,18
S01011654,Occupancy rating +2 or more,122,46,19,27,75,13,58,34,19,5,4,3,1,1,0,0,0,1
S01011654,Occupancy rating +1,168,96,39,57,67,13,43,30,11,2,11,5,6,5,1,0,0,4
S01011654,Occupancy rating 0,158,78,31,47,72,6,33,10,16,7,33,22,11,8,2,0,0,6
S01011654,Occupancy rating -1 or less,73,26,11,15,37,1,16,5,8,3,20,14,6,10,3,0,0,7
S01011655,All households,471,237,89,148,211,19,101,55,21,25,91,64,27,23,9,0,0,14
S01011655,Occupancy rating +2 or more,48,27,10,17,18,5,11,11,0,0,2,2,0,3,2,0,0,1
S01011655,Occupancy rating +1,152,74,29,45,75,7,44,29,6,9,24,13,11,3,0,0,0,3
S01011655,Occupancy rating 0,165,83,37,46,76,5,30,10,10,10,41,30,11,6,3,0,0,3
S01011655,Occupancy rating -1 or less,106,53,13,40,42,2,16,5,5,6,24,19,5,11,4,0,0,7
S01011656,All households,287,120,23,97,151,7,86,30,35,21,58,39,19,16,8,0,0,8
S01011656,Occupancy rating +2 or more,44,28,9,19,15,4,9,6,0,3,2,1,1,1,0,0,0,1
S01011656,Occupancy rating +1,102,57,10,47,43,1,32,20,7,5,10,7,3,2,0,0,0,2
S01011656,Occupancy rating 0,83,20,3,17,59,0,31,3,17,11,28,18,10,4,2,0,0,2
S01011656,Occupancy rating -1 or less,58,15,1,14,34,2,14,1,11,2,18,13,5,9,6,0,0,3
S01011657,All households,281,150,34,116,120,4,71,32,26,13,45,34,11,11,4,0,1,6
S01011657,Occupancy rating +2 or more,30,12,7,5,18,1,14,4,5,5,3,2,1,0,0,0,0,0
S01011657,Occupancy rating +1,79,47,12,35,32,3,25,19,5,1,4,4,0,0,0,0,0,0
S01011657,Occupancy rating 0,121,68,11,57,49,0,24,7,12,5,25,18,7,4,1,0,0,3
S01011657,Occupancy rating -1 or less,51,23,4,19,21,0,8,2,4,2,13,10,3,7,3,0,1,3
S01011658,All households,304,106,37,69,186,27,116,44,44,28,43,26,17,12,5,0,0,7
S01011658,Occupancy rating +2 or more,49,27,12,15,22,7,15,12,2,1,0,0,0,0,0,0,0,0
S01011658,Occupancy rating +1,116,45,18,27,67,14,42,25,8,9,11,5,6,4,0,0,0,4
S01011658,Occupancy rating 0,92,26,7,19,62,3,34,3,23,8,25,18,7,4,2,0,0,2
S01011658,Occupancy rating -1 or less,47,8,0,8,35,3,25,4,11,10,7,3,4,4,3,0,0,1
S01011659,All households,353,112,52,60,228,34,126,47,43,36,68,53,15,13,6,0,3,4
S01011659,Occupancy rating +2 or more,98,38,30,8,60,21,37,26,5,6,2,1,1,0,0,0,0,0
S01011659,Occupancy rating +1,121,51,15,36,69,8,46,18,13,15,15,10,5,1,0,0,1,0
S01011659,Occupancy rating 0,101,18,3,15,76,3,34,2,20,12,39,34,5,7,4,0,2,1
S01011659,Occupancy rating -1 or less,33,5,4,1,23,2,9,1,5,3,12,8,4,5,2,0,0,3
S01011660,All households,379,106,38,68,251,36,180,66,64,50,35,18,17,22,11,0,1,10
S01011660,Occupancy rating +2 or more,139,38,23,15,98,19,73,38,19,16,6,2,4,3,1,0,0,2
S01011660,Occupancy rating +1,129,34,12,22,88,17,61,26,21,14,10,5,5,7,4,0,0,3
S01011660,Occupancy rating 0,82,22,0,22,52,0,33,1,19,13,19,11,8,8,3,0,1,4
S01011660,Occupancy rating -1 or less,29,12,3,9,13,0,13,1,5,7,0,0,0,4,3,0,0,1
S01011661,All households,246,88,26,62,151,28,88,31,40,17,35,23,12,7,2,0,4,1
S01011661,Occupancy rating +2 or more,63,24,12,12,39,16,23,15,6,2,0,0,0,0,0,0,0,0
S01011661,Occupancy rating +1,95,47,11,36,46,11,30,11,14,5,5,2,3,2,0,0,2,0
S01011661,Occupancy rating 0,63,11,3,8,49,0,22,3,11,8,27,19,8,3,0,0,2,1
S01011661,Occupancy rating -1 or less,25,6,0,6,17,1,13,2,9,2,3,2,1,2,2,0,0,0
S01011662,All households,237,46,16,30,181,11,154,54,80,20,16,13,3,10,7,0,0,3
S01011662,Occupancy rating +2 or more,120,26,7,19,91,5,85,39,37,9,1,0,1,3,3,0,0,0
S01011662,Occupancy rating +1,72,15,7,8,54,5,42,12,28,2,7,6,1,3,0,0,0,3
S01011662,Occupancy rating 0,34,3,0,3,29,1,23,3,12,8,5,4,1,2,2,0,0,0
S01011662,Occupancy rating -1 or less,11,2,2,0,7,0,4,0,3,1,3,3,0,2,2,0,0,0
S01011663,All households,428,164,21,143,235,13,144,47,68,29,78,57,21,29,16,0,0,13
S01011663,Occupancy rating +2 or more,53,25,3,22,28,3,22,9,9,4,3,3,0,0,0,0,0,0
S01011663,Occupancy rating +1,160,88,12,76,71,9,46,32,10,4,16,11,5,1,0,0,0,1
S01011663,Occupancy rating 0,149,37,3,34,97,1,50,3,34,13,46,34,12,15,8,0,0,7
S01011663,Occupancy rating -1 or less,66,14,3,11,39,0,26,3,15,8,13,9,4,13,8,0,0,5
S01011664,All households,408,99,46,53,276,26,160,52,63,45,90,45,45,33,23,0,2,8
S01011664,Occupancy rating +2 or more,118,55,32,23,62,17,37,34,2,1,8,3,5,1,0,0,0,1
S01011664,Occupancy rating +1,128,26,7,19,96,4,63,11,28,24,29,6,23,6,3,0,1,2
S01011664,Occupancy rating 0,102,14,5,9,73,4,38,4,19,15,31,24,7,15,11,0,1,3
S01011664,Occupancy rating -1 or less,60,4,2,2,45,1,22,3,14,5,22,12,10,11,9,0,0,2
S01011665,All households,428,180,71,109,228,24,125,53,48,24,79,48,31,20,8,0,0,12
S01011665,Occupancy rating +2 or more,62,21,5,16,39,7,28,19,7,2,4,3,1,2,1,0,0,1
S01011665,Occupancy rating +1,190,106,42,64,79,14,51,27,16,8,14,7,7,5,1,0,0,4
S01011665,Occupancy rating 0,133,44,18,26,80,2,34,4,19,11,44,26,18,9,4,0,0,5
S01011665,Occupancy rating -1 or less,43,9,6,3,30,1,12,3,6,3,17,12,5,4,2,0,0,2
S01011666,All households,454,218,90,128,214,34,112,50,36,26,68,43,25,22,6,0,0,16
S01011666,Occupancy rating +2 or more,114,56,16,40,56,16,36,23,10,3,4,3,1,2,0,0,0,2
S01011666,Occupancy rating +1,140,71,26,45,66,13,31,19,6,6,22,12,10,3,1,0,0,2
S01011666,Occupancy rating 0,151,67,36,31,76,5,36,8,13,15,35,25,10,8,1,0,0,7
S01011666,Occupancy rating -1 or less,49,24,12,12,16,0,9,0,7,2,7,3,4,9,4,0,0,5
S01011667,All households,375,179,59,120,184,22,124,57,49,18,38,30,8,12,5,0,1,6
S01011667,Occupancy rating +2 or more,111,32,14,18,76,8,62,37,19,6,6,4,2,3,0,0,0,3
S01011667,Occupancy rating +1,105,53,17,36,49,9,32,13,13,6,8,5,3,3,1,0,0,2
S01011667,Occupancy rating 0,115,72,20,52,40,2,20,2,15,3,18,16,2,3,2,0,0,1
S01011667,Occupancy rating -1 or less,44,22,8,14,19,3,10,5,2,3,6,5,1,3,2,0,1,0
S01011668,All households,429,123,32,91,278,16,149,57,62,30,113,84,29,28,15,0,1,12
S01011668,Occupancy rating +2 or more,72,23,8,15,45,8,33,28,3,2,4,1,3,4,1,0,1,2
S01011668,Occupancy rating +1,144,63,17,46,79,5,49,26,14,9,25,19,6,2,0,0,0,2
S01011668,Occupancy rating 0,124,23,4,19,89,1,32,1,18,13,56,41,15,12,7,0,0,5
S01011668,Occupancy rating -1 or less,89,14,3,11,65,2,35,2,27,6,28,23,5,10,7,0,0,3
S01011669,All households,299,97,48,49,178,40,107,52,37,18,31,14,17,24,9,0,2,13
S01011669,Occupancy rating +2 or more,129,26,12,14,97,24,65,34,19,12,8,1,7,6,2,0,1,3
S01011669,Occupancy rating +1,94,51,28,23,42,11,25,14,9,2,6,4,2,1,0,0,0,1
S01011669,Occupancy rating 0,55,15,5,10,28,3,14,4,7,3,11,6,5,12,5,0,1,6
S01011669,Occupancy rating -1 or less,21,5,3,2,11,2,3,0,2,1,6,3,3,5,2,0,0,3
S01011670,All households,234,77,20,57,145,6,86,22,45,19,53,43,10,12,5,0,0,7
S01011670,Occupancy rating +2 or more,35,16,5,11,17,2,13,9,3,1,2,1,1,2,0,0,0,2
S01011670,Occupancy rating +1,84,52,11,41,30,4,20,11,6,3,6,5,1,2,1,0,0,1
S01011670,Occupancy rating 0,85,5,2,3,77,0,38,2,27,9,39,32,7,3,0,0,0,3
S01011670,Occupancy rating -1 or less,30,4,2,2,21,0,15,0,9,6,6,5,1,5,4,0,0,1
S01011671,All households,316,113,60,53,189,32,130,60,40,30,27,16,11,14,6,0,1,7
S01011671,Occupancy rating +2 or more,117,30,20,10,84,17,62,41,11,10,5,1,4,3,2,0,0,1
S01011671,Occupancy rating +1,102,54,28,26,47,13,30,13,10,7,4,2,2,1,0,0,0,1
S01011671,Occupancy rating 0,69,22,10,12,42,1,27,4,12,11,14,9,5,5,2,0,1,2
S01011671,Occupancy rating -1 or less,28,7,2,5,16,1,11,2,7,2,4,4,0,5,2,0,0,3
S01011672,All households,275,96,58,38,166,24,106,47,40,19,36,22,14,13,6,0,0,7
S01011672,Occupancy rating +2 or more,110,40,23,17,67,15,50,27,15,8,2,1,1,3,1,0,0,2
S01011672,Occupancy rating +1,69,21,9,12,46,4,28,13,10,5,14,7,7,2,0,0,0,2
S01011672,Occupancy rating 0,68,27,22,5,37,4,17,5,8,4,16,11,5,4,4,0,0,0
S01011672,Occupancy rating -1 or less,28,8,4,4,16,1,11,2,7,2,4,3,1,4,1,0,0,3
S01011673,All households,275,76,32,44,178,12,120,45,47,28,46,32,14,21,10,0,0,11
S01011673,Occupancy rating +2 or more,63,22,12,10,40,10,29,19,8,2,1,1,0,1,0,0,0,1
S01011673,Occupancy rating +1,103,47,16,31,51,2,38,22,8,8,11,6,5,5,1,0,0,4
S01011673,Occupancy rating 0,76,6,4,2,64,0,35,4,19,12,29,20,9,6,2,0,0,4
S01011673,Occupancy rating -1 or less,33,1,0,1,23,0,18,0,12,6,5,5,0,9,7,0,0,2
S01011674,All households,434,113,51,62,306,30,224,89,97,38,52,31,21,15,6,0,1,8
S01011674,Occupancy rating +2 or more,180,45,20,25,133,17,109,57,41,11,7,5,2,2,2,0,0,0
S01011674,Occupancy rating +1,144,41,19,22,98,10,66,26,28,12,22,12,10,5,0,0,1,4
S01011674,Occupancy rating 0,87,23,10,13,57,3,37,4,23,10,17,10,7,7,3,0,0,4
S01011674,Occupancy rating -1 or less,23,4,2,2,18,0,12,2,5,5,6,4,2,1,1,0,0,0
S01011675,All households,387,112,44,68,261,31,164,59,65,40,66,41,25,14,7,0,1,6
S01011675,Occupancy rating +2 or more,106,40,22,18,64,17,43,27,11,5,4,2,2,2,1,0,0,1
S01011675,Occupancy rating +1,138,49,12,37,88,9,66,30,23,13,13,5,8,1,0,0,0,1
S01011675,Occupancy rating 0,104,18,8,10,79,3,44,2,26,16,32,22,10,7,3,0,1,3
S01011675,Occupancy rating -1 or less,39,5,2,3,30,2,11,0,5,6,17,12,5,4,3,0,0,1
S01011676,All households,311,109,43,66,188,22,104,39,37,28,62,43,19,14,8,0,0,6
S01011676,Occupancy rating +2 or more,65,30,18,12,35,10,17,14,0,3,8,5,3,0,0,0,0,0
S01011676,Occupancy rating +1,90,41,17,24,48,6,34,21,5,8,8,5,3,1,0,0,0,1
S01011676,Occupancy rating 0,92,27,6,21,59,2,30,4,15,11,27,18,9,6,3,0,0,3
S01011676,Occupancy rating -1 or less,64,11,2,9,46,4,23,0,17,6,19,15,4,7,5,0,0,2
S01011677,All households,258,80,10,70,162,7,114,40,59,15,41,33,8,16,7,0,0,9
S01011677,Occupancy rating +2 or more,110,22,3,19,86,5,67,26,34,7,14,12,2,2,1,0,0,1
S01011677,Occupancy rating +1,63,25,2,23,35,1,23,11,10,2,11,10,1,3,2,0,0,1
S01011677,Occupancy rating 0,50,21,4,17,24,0,13,2,7,4,11,7,4,5,1,0,0,4
S01011677,Occupancy rating -1 or less,35,12,1,11,17,1,11,1,8,2,5,4,1,6,3,0,0,3
S01011678,All households,222,86,30,56,125,15,67,23,32,12,43,24,19,11,5,0,2,4
S01011678,Occupancy rating +2 or more,56,19,9,10,35,9,22,11,8,3,4,2,2,2,1,0,0,1
S01011678,Occupancy rating +1,78,45,11,34,32,4,16,8,5,3,12,5,7,1,0,0,0,1
S01011678,Occupancy rating 0,54,10,5,5,44,2,20,2,14,4,22,15,7,0,0,0,0,0
S01011678,Occupancy rating -1 or less,34,12,5,7,14,0,9,2,5,2,5,2,3,8,4,0,2,2
S01011679,All households,204,26,7,19,173,4,146,55,78,13,23,16,7,5,1,0,0,4
S01011679,Occupancy rating +2 or more,110,16,5,11,93,3,83,46,30,7,7,5,2,1,0,0,0,1
S01011679,Occupancy rating +1,60,9,2,7,51,1,41,9,28,4,9,6,3,0,0,0,0,0
S01011679,Occupancy rating 0,22,1,0,1,19,0,14,0,13,1,5,3,2,2,1,0,0,1
S01011679,Occupancy rating -1 or less,12,0,0,0,10,0,8,0,7,1,2,2,0,2,0,0,0,2
S01011680,All households,454,149,75,74,275,30,171,51,86,34,74,37,37,30,11,0,2,17
S01011680,Occupancy rating +2 or more,135,48,29,19,81,19,56,33,19,4,6,4,2,6,1,0,0,5
S01011680,Occupancy rating +1,133,54,22,32,76,5,45,16,15,14,26,6,20,3,0,0,0,3
S01011680,Occupancy rating 0,127,36,19,17,83,3,47,2,32,13,33,21,12,8,2,0,0,6
S01011680,Occupancy rating -1 or less,59,11,5,6,35,3,23,0,20,3,9,6,3,13,8,0,2,3
S01011681,All households,345,86,38,48,244,25,167,58,72,37,52,39,13,15,9,0,0,6
S01011681,Occupancy rating +2 or more,96,27,14,13,66,12,48,24,22,2,6,5,1,3,1,0,0,2
S01011681,Occupancy rating +1,116,30,14,16,81,11,56,26,17,13,14,9,5,5,2,0,0,3
S01011681,Occupancy rating 0,91,24,10,14,64,2,40,7,20,13,22,17,5,3,2,0,0,1
S01011681,Occupancy rating -1 or less,42,5,0,5,33,0,23,1,13,9,10,8,2,4,4,0,0,0
S01011682,All households,182,43,10,33,126,21,85,39,33,13,20,10,10,13,6,0,0,7
S01011682,Occupancy rating +2 or more,121,31,8,23,84,13,61,30,23,8,10,6,4,6,2,0,0,4
S01011682,Occupancy rating +1,41,9,1,8,30,7,16,6,6,4,7,2,5,2,1,0,0,1
S01011682,Occupancy rating 0,12,1,0,1,9,1,7,2,4,1,1,0,1,2,1,0,0,1
S01011682,Occupancy rating -1 or less,8,2,1,1,3,0,1,1,0,0,2,2,0,3,2,0,0,1
S01011683,All households,306,92,28,64,193,17,144,57,61,26,32,18,14,21,11,0,1,9
S01011683,Occupancy rating +2 or more,121,31,12,19,83,12,67,41,17,9,4,4,0,7,5,0,1,1
S01011683,Occupancy rating +1,104,43,13,30,54,3,46,14,25,7,5,3,2,7,1,0,0,6
S01011683,Occupancy rating 0,57,14,2,12,41,1,23,1,13,9,17,8,9,2,0,0,0,2
S01011683,Occupancy rating -1 or less,24,4,1,3,15,1,8,1,6,1,6,3,3,5,5,0,0,0
S01011684,All households,234,74,37,37,150,20,104,38,45,21,26,17,9,10,6,0,0,4
S01011684,Occupancy rating +2 or more,106,34,17,17,69,13,51,25,16,10,5,0,5,3,3,0,0,0
S01011684,Occupancy rating +1,64,24,10,14,38,6,24,10,10,4,8,7,1,2,1,0,0,1
S01011684,Occupancy rating 0,50,13,9,4,35,1,25,3,16,6,9,7,2,2,0,0,0,2
S01011684,Occupancy rating -1 or less,14,3,1,2,8,0,4,0,3,1,4,3,1,3,2,0,0,1
S01011685,All households,279,44,12,32,216,16,176,49,102,25,24,16,8,19,11,0,1,7
S01011685,Occupancy rating +2 or more,184,31,6,25,144,14,117,41,61,15,13,10,3,9,4,0,1,4
S01011685,Occupancy rating +1,49,4,2,2,40,1,35,5,25,5,4,1,3,5,3,0,0,2
S01011685,Occupancy rating 0,31,5,2,3,24,0,20,2,13,5,4,2,2,2,1,0,0,1
S01011685,Occupancy rating -1 or less,15,4,2,2,8,1,4,1,3,0,3,3,0,3,3,0,0,0
S01011686,All households,344,80,25,55,255,35,196,78,82,36,24,11,13,9,5,0,0,4
S01011686,Occupancy rating +2 or more,178,26,7,19,149,24,113,58,36,19,12,4,8,3,2,0,0,1
S01011686,Occupancy rating +1,86,28,12,16,54,6,45,14,21,10,3,0,3,4,1,0,0,3
S01011686,Occupancy rating 0,65,24,5,19,41,4,30,4,20,6,7,5,2,0,0,0,0,0
S01011686,Occupancy rating -1 or less,15,2,1,1,11,1,8,2,5,1,2,2,0,2,2,0,0,0
S01011687,All households,386,126,58,68,248,18,164,68,72,24,66,41,25,12,6,0,3,3
S01011687,Occupancy rating +2 or more,69,27,8,19,42,5,35,21,12,2,2,1,1,0,0,0,0,0
S01011687,Occupancy rating +1,142,52,23,29,89,11,63,41,19,3,15,5,10,1,0,0,1,0
S01011687,Occupancy rating 0,127,38,23,15,81,1,48,5,30,13,32,23,9,8,3,0,2,3
S01011687,Occupancy rating -1 or less,48,9,4,5,36,1,18,1,11,6,17,12,5,3,3,0,0,0
S01011688,All households,307,67,18,49,224,19,185,56,101,28,20,13,7,16,8,0,1,7
S01011688,Occupancy rating +2 or more,165,31,7,24,130,16,110,34,60,16,4,2,2,4,2,0,0,2
S01011688,Occupancy rating +1,84,22,7,15,59,2,48,18,23,7,9,6,3,3,2,0,0,1
S01011688,Occupancy rating 0,40,9,3,6,25,1,19,4,11,4,5,4,1,6,3,0,0,3
S01011688,Occupancy rating -1 or less,18,5,1,4,10,0,8,0,7,1,2,1,1,3,1,0,1,1
S01011689,All households,248,37,12,25,195,21,161,65,71,25,13,7,6,16,9,0,1,6
S01011689,Occupancy rating +2 or more,191,27,9,18,152,16,130,57,58,15,6,3,3,12,6,0,1,5
S01011689,Occupancy rating +1,36,6,2,4,30,5,22,7,9,6,3,2,1,0,0,0,0,0
S01011689,Occupancy rating 0,11,3,0,3,7,0,6,1,3,2,1,0,1,1,1,0,0,0
S01011689,Occupancy rating -1 or less,10,1,1,0,6,0,3,0,1,2,3,2,1,3,2,0,0,1
S01011690,All households,396,98,25,73,285,15,228,89,116,23,42,32,10,13,5,0,0,8
S01011690,Occupancy rating +2 or more,197,22,3,19,170,9,150,68,70,12,11,8,3,5,4,0,0,1
S01011690,Occupancy rating +1,97,35,13,22,60,6,49,18,27,4,5,3,2,2,0,0,0,2
S01011690,Occupancy rating 0,74,32,5,27,37,0,22,2,15,5,15,12,3,5,1,0,0,4
S01011690,Occupancy rating -1 or less,28,9,4,5,18,0,7,1,4,2,11,9,2,1,0,0,0,1
S01011691,All households,224,35,13,22,180,15,132,39,78,15,33,24,9,9,7,0,0,2
S01011691,Occupancy rating +2 or more,139,25,11,14,111,10,86,31,47,8,15,13,2,3,3,0,0,0
S01011691,Occupancy rating +1,48,9,2,7,37,4,25,7,14,4,8,7,1,2,1,0,0,1
S01011691,Occupancy rating 0,30,1,0,1,26,1,19,1,16,2,6,3,3,3,2,0,0,1
S01011691,Occupancy rating -1 or less,7,0,0,0,6,0,2,0,1,1,4,1,3,1,1,0,0,0
S01011692,All households,455,134,63,71,294,32,185,55,78,52,77,45,32,27,10,0,3,14
S01011692,Occupancy rating +2 or more,121,60,31,29,58,15,39,26,5,8,4,2,2,3,0,0,1,2
S01011692,Occupancy rating +1,157,38,18,20,111,7,77,23,33,21,27,14,13,8,2,0,1,5
S01011692,Occupancy rating 0,134,29,13,16,96,8,57,4,34,19,31,19,12,9,3,0,0,6
S01011692,Occupancy rating -1 or less,43,7,1,6,29,2,12,2,6,4,15,10,5,7,5,0,1,1
S01011693,All households,367,118,42,76,239,22,179,82,68,29,38,26,12,10,7,0,0,3
S01011693,Occupancy rating +2 or more,139,36,16,20,100,13,80,45,30,5,7,4,3,3,3,0,0,0
S01011693,Occupancy rating +1,104,31,10,21,71,6,53,23,18,12,12,7,5,2,1,0,0,1
S01011693,Occupancy rating 0,89,40,13,27,47,1,33,11,14,8,13,11,2,2,1,0,0,1
S01011693,Occupancy rating -1 or less,35,11,3,8,21,2,13,3,6,4,6,4,2,3,2,0,0,1
S01011694,All households,200,41,6,35,150,4,125,41,74,10,21,18,3,9,6,0,0,3
S01011694,Occupancy rating +2 or more,96,15,0,15,80,2,71,31,33,7,7,6,1,1,1,0,0,0
S01011694,Occupancy rating +1,54,10,2,8,42,1,35,5,28,2,6,6,0,2,1,0,0,1
S01011694,Occupancy rating 0,41,15,4,11,24,1,17,4,12,1,6,4,2,2,1,0,0,1
S01011694,Occupancy rating -1 or less,9,1,0,1,4,0,2,1,1,0,2,2,0,4,3,0,0,1
S01011695,All households,333,48,13,35,274,13,235,69,130,36,26,18,8,11,5,0,0,6
S01011695,Occupancy rating +2 or more,230,37,8,29,187,13,164,56,88,20,10,7,3,6,2,0,0,4
S01011695,Occupancy rating +1,67,10,4,6,55,0,48,12,27,9,7,5,2,2,1,0,0,1
S01011695,Occupancy rating 0,28,1,1,0,24,0,20,0,13,7,4,3,1,3,2,0,0,1
S01011695,Occupancy rating -1 or less,8,0,0,0,8,0,3,1,2,0,5,3,2,0,0,0,0,0
S01011696,All households,351,27,1,26,316,4,279,89,166,24,33,30,3,8,3,0,1,4
S01011696,Occupancy rating +2 or more,312,25,1,24,281,4,256,88,146,22,21,20,1,6,2,0,0,4
S01011696,Occupancy rating +1,18,0,0,0,18,0,15,1,12,2,3,3,0,0,0,0,0,0
S01011696,Occupancy rating 0,17,2,0,2,14,0,8,0,8,0,6,5,1,1,0,0,1,0
S01011696,Occupancy rating -1 or less,4,0,0,0,3,0,0,0,0,0,3,2,1,1,1,0,0,0
S01011697,All households,398,92,34,58,292,18,220,70,125,25,54,34,20,14,7,1,0,6
S01011697,Occupancy rating +2 or more,213,45,10,35,166,12,149,58,82,9,5,3,2,2,1,0,0,1
S01011697,Occupancy rating +1,92,33,12,21,55,4,39,10,23,6,12,6,6,4,2,0,0,2
S01011697,Occupancy rating 0,65,12,11,1,47,2,19,2,10,7,26,20,6,6,2,1,0,3
S01011697,Occupancy rating -1 or less,28,2,1,1,24,0,13,0,10,3,11,5,6,2,2,0,0,0
S01011698,All households,271,85,39,46,168,15,115,35,53,27,38,17,21,18,9,0,1,8
S01011698,Occupancy rating +2 or more,70,28,17,11,41,5,34,19,10,5,2,0,2,1,0,0,0,1
S01011698,Occupancy rating +1,108,42,16,26,63,8,42,16,14,12,13,6,7,3,1,0,0,2
S01011698,Occupancy rating 0,62,6,2,4,48,2,27,0,21,6,19,8,11,8,5,0,0,3
S01011698,Occupancy rating -1 or less,31,9,4,5,16,0,12,0,8,4,4,3,1,6,3,0,1,2
S01011699,All households,387,108,38,70,272,43,194,65,91,38,35,24,11,7,3,0,0,4
S01011699,Occupancy rating +2 or more,180,46,17,29,133,36,93,52,29,12,4,3,1,1,0,0,0,1
S01011699,Occupancy rating +1,118,31,9,22,85,5,67,8,40,19,13,8,5,2,1,0,0,1
S01011699,Occupancy rating 0,71,24,8,16,45,0,32,4,21,7,13,9,4,2,1,0,0,1
S01011699,Occupancy rating -1 or less,18,7,4,3,9,2,2,1,1,0,5,4,1,2,1,0,0,1
S01011700,All households,354,143,58,85,196,35,132,41,51,40,29,14,15,15,9,0,2,4
S01011700,Occupancy rating +2 or more,153,50,32,18,97,20,74,28,26,20,3,0,3,6,5,0,1,0
S01011700,Occupancy rating +1,96,43,11,32,50,12,28,8,9,11,10,3,7,3,0,0,1,2
S01011700,Occupancy rating 0,72,34,11,23,35,1,20,4,9,7,14,11,3,3,1,0,0,2
S01011700,Occupancy rating -1 or less,33,16,4,12,14,2,10,1,7,2,2,0,2,3,3,0,0,0
S01011701,All households,444,132,42,90,303,39,216,93,91,32,48,33,15,9,2,0,0,7
S01011701,Occupancy rating +2 or more,220,42,14,28,174,24,138,63,53,22,12,5,7,4,1,0,0,3
S01011701,Occupancy rating +1,112,51,16,35,59,11,42,16,21,5,6,4,2,2,0,0,0,2
S01011701,Occupancy rating 0,91,35,11,24,55,3,30,14,13,3,22,18,4,1,0,0,0,1
S01011701,Occupancy rating -1 or less,21,4,1,3,15,1,6,0,4,2,8,6,2,2,1,0,0,1
S01011702,All households,335,113,56,57,211,35,153,74,51,28,23,12,11,11,7,0,0,4
S01011702,Occupancy rating +2 or more,135,36,21,15,97,21,76,42,20,14,0,0,0,2,2,0,0,0
S01011702,Occupancy rating +1,91,40,20,20,47,8,34,23,9,2,5,2,3,4,4,0,0,0
S01011702,Occupancy rating 0,77,31,13,18,42,4,28,6,13,9,10,5,5,4,0,0,0,4
S01011702,Occupancy rating -1 or less,32,6,2,4,25,2,15,3,9,3,8,5,3,1,1,0,0,0
S01011703,All households,255,73,38,35,170,23,133,45,64,24,14,9,5,12,5,0,0,7
S01011703,Occupancy rating +2 or more,175,48,29,19,119,22,90,37,36,17,7,3,4,8,2,0,0,6
S01011703,Occupancy rating +1,49,19,9,10,26,1,23,6,13,4,2,1,1,4,3,0,0,1
S01011703,Occupancy rating 0,22,4,0,4,18,0,14,2,10,2,4,4,0,0,0,0,0,0
S01011703,Occupancy rating -1 or less,9,2,0,2,7,0,6,0,5,1,1,1,0,0,0,0,0,0
S01011704,All households,274,59,17,42,202,17,156,37,96,23,29,17,12,13,6,1,1,5
S01011704,Occupancy rating +2 or more,148,19,3,16,123,16,101,28,57,16,6,1,5,6,3,0,1,2
S01011704,Occupancy rating +1,74,21,8,13,51,1,43,7,31,5,7,5,2,2,2,0,0,0
S01011704,Occupancy rating 0,37,16,4,12,18,0,9,2,5,2,9,7,2,3,0,1,0,2
S01011704,Occupancy rating -1 or less,15,3,2,1,10,0,3,0,3,0,7,4,3,2,1,0,0,1
S01011705,All households,318,91,35,56,211,16,128,39,57,32,67,52,15,16,8,0,1,7
S01011705,Occupancy rating +2 or more,128,44,21,23,82,9,62,30,25,7,11,6,5,2,1,0,0,1
S01011705,Occupancy rating +1,80,36,10,26,41,5,24,8,10,6,12,8,4,3,0,0,1,2
S01011705,Occupancy rating 0,77,7,2,5,61,1,27,1,11,15,33,29,4,9,5,0,0,4
S01011705,Occupancy rating -1 or less,33,4,2,2,27,1,15,0,11,4,11,9,2,2,2,0,0,0
S01011706,All households,450,164,84,80,266,37,173,66,71,36,56,28,28,20,7,0,2,11
S01011706,Occupancy rating +2 or more,191,69,45,24,116,32,77,48,21,8,7,1,6,6,2,0,1,3
S01011706,Occupancy rating +1,117,45,23,22,69,4,47,12,21,14,18,9,9,3,0,0,1,2
S01011706,Occupancy rating 0,112,43,12,31,64,1,38,6,20,12,25,14,11,5,2,0,0,3
S01011706,Occupancy rating -1 or less,30,7,4,3,17,0,11,0,9,2,6,4,2,6,3,0,0,3
S01011707,All households,283,54,29,25,218,39,157,57,62,38,22,7,15,11,6,0,0,5
S01011707,Occupancy rating +2 or more,186,44,22,22,136,30,100,50,35,15,6,2,4,6,3,0,0,3
S01011707,Occupancy rating +1,60,6,4,2,54,6,41,7,15,19,7,1,6,0,0,0,0,0
S01011707,Occupancy rating 0,28,4,3,1,21,3,12,0,9,3,6,2,4,3,3,0,0,0
S01011707,Occupancy rating -1 or less,9,0,0,0,7,0,4,0,3,1,3,2,1,2,0,0,0,2
S01011708,All households,448,185,82,103,241,25,151,59,51,41,65,39,26,22,14,1,0,7
S01011708,Occupancy rating +2 or more,158,77,46,31,79,16,58,32,15,11,5,4,1,2,2,0,0,0
S01011708,Occupancy rating +1,118,47,17,30,65,4,43,16,12,15,18,9,9,6,2,0,0,4
S01011708,Occupancy rating 0,137,54,16,38,73,4,41,11,18,12,28,18,10,10,7,1,0,2
S01011708,Occupancy rating -1 or less,35,7,3,4,24,1,9,0,6,3,14,8,6,4,3,0,0,1
S01011709,All households,370,73,37,36,279,32,194,61,92,41,53,28,25,18,5,0,0,13
S01011709,Occupancy rating +2 or more,174,46,23,23,126,22,92,48,37,7,12,6,6,2,0,0,0,2
S01011709,Occupancy rating +1,109,21,11,10,84,7,59,13,31,15,18,8,10,4,0,0,0,4
S01011709,Occupancy rating 0,61,5,2,3,49,3,30,0,16,14,16,9,7,7,2,0,0,5
S01011709,Occupancy rating -1 or less,26,1,1,0,20,0,13,0,8,5,7,5,2,5,3,0,0,2
S01011710,All households,257,55,21,34,179,12,97,35,51,11,70,50,20,23,12,0,1,10
S01011710,Occupancy rating +2 or more,39,13,9,4,25,6,15,12,2,1,4,4,0,1,1,0,0,0
S01011710,Occupancy rating +1,78,29,6,23,46,4,26,15,6,5,16,11,5,3,0,0,1,2
S01011710,Occupancy rating 0,91,5,3,2,76,2,35,1,31,3,39,27,12,10,5,0,0,5
S01011710,Occupancy rating -1 or less,49,8,3,5,32,0,21,7,12,2,11,8,3,9,6,0,0,3
S01011711,All households,321,110,48,62,200,20,99,38,40,21,81,54,27,11,8,0,1,2
S01011711,Occupancy rating +2 or more,41,26,15,11,14,3,10,10,0,0,1,0,1,1,1,0,0,0
S01011711,Occupancy rating +1,131,59,21,38,72,13,43,26,11,6,16,8,8,0,0,0,0,0
S01011711,Occupancy rating 0,110,20,10,10,88,3,35,1,19,15,50,37,13,2,0,0,1,1
S01011711,Occupancy rating -1 or less,39,5,2,3,26,1,11,1,10,0,14,9,5,8,7,0,0,1
S01011712,All households,294,138,38,100,147,14,87,47,26,14,46,28,18,9,2,0,1,6
S01011712,Occupancy rating +2 or more,25,15,6,9,9,3,6,5,0,1,0,0,0,1,0,0,0,1
S01011712,Occupancy rating +1,139,77,20,57,59,8,44,31,8,5,7,4,3,3,1,0,0,2
S01011712,Occupancy rating 0,107,38,10,28,68,3,31,10,15,6,34,21,13,1,0,0,0,1
S01011712,Occupancy rating -1 or less,23,8,2,6,11,0,6,1,3,2,5,3,2,4,1,0,1,2
S01011713,All households,389,122,66,56,255,33,198,96,58,44,24,12,12,12,5,0,0,7
S01011713,Occupancy rating +2 or more,143,29,9,20,112,19,90,63,12,15,3,1,2,2,1,0,0,1
S01011713,Occupancy rating +1,146,60,29,31,82,10,65,32,16,17,7,4,3,4,0,0,0,4
S01011713,Occupancy rating 0,74,23,21,2,49,4,33,1,22,10,12,6,6,2,1,0,0,1
S01011713,Occupancy rating -1 or less,26,10,7,3,12,0,10,0,8,2,2,1,1,4,3,0,0,1
S01011714,All households,194,26,2,24,163,3,144,31,98,15,16,15,1,5,2,0,0,3
S01011714,Occupancy rating +2 or more,81,14,2,12,65,1,60,21,33,6,4,4,0,2,1,0,0,1
S01011714,Occupancy rating +1,75,12,0,12,61,2,52,9,37,6,7,7,0,2,1,0,0,1
S01011714,Occupancy rating 0,32,0,0,0,31,0,27,1,24,2,4,3,1,1,0,0,0,1
S01011714,Occupancy rating -1 or less,6,0,0,0,6,0,5,0,4,1,1,1,0,0,0,0,0,0
S01011715,All households,297,112,40,72,179,19,99,35,41,23,61,49,12,6,3,0,0,3
S01011715,Occupancy rating +2 or more,47,19,10,9,28,5,20,9,8,3,3,3,0,0,0,0,0,0
S01011715,Occupancy rating +1,99,49,19,30,49,8,35,23,7,5,6,3,3,1,0,0,0,1
S01011715,Occupancy rating 0,119,39,11,28,78,4,35,2,20,13,39,33,6,2,1,0,0,1
S01011715,Occupancy rating -1 or less,32,5,0,5,24,2,9,1,6,2,13,10,3,3,2,0,0,1
S01011716,All households,351,81,14,67,261,16,214,65,119,30,31,21,10,9,3,0,0,6
S01011716,Occupancy rating +2 or more,152,32,5,27,114,9,101,44,43,14,4,3,1,6,1,0,0,5
S01011716,Occupancy rating +1,104,29,6,23,74,6,56,15,34,7,12,8,4,1,1,0,0,0
S01011716,Occupancy rating 0,77,15,0,15,61,0,48,5,35,8,13,10,3,1,1,0,0,0
S01011716,Occupancy rating -1 or less,18,5,3,2,12,1,9,1,7,1,2,0,2,1,0,0,0,1
S01011717,All households,294,60,35,25,224,31,173,80,53,40,20,6,14,10,4,0,0,6
S01011717,Occupancy rating +2 or more,166,34,21,13,129,26,97,64,14,19,6,0,6,3,2,0,0,1
S01011717,Occupancy rating +1,79,23,11,12,52,4,43,14,18,11,5,3,2,4,0,0,0,4
S01011717,Occupancy rating 0,38,3,3,0,33,1,25,2,16,7,7,3,4,2,1,0,0,1
S01011717,Occupancy rating -1 or less,11,0,0,0,10,0,8,0,5,3,2,0,2,1,1,0,0,0
S01011718,All households,289,48,5,43,233,3,199,54,129,16,31,18,13,8,3,0,0,5
S01011718,Occupancy rating +2 or more,197,28,3,25,167,3,149,45,95,9,15,10,5,2,1,0,0,1
S01011718,Occupancy rating +1,54,17,2,15,35,0,31,8,20,3,4,1,3,2,0,0,0,2
S01011718,Occupancy rating 0,30,2,0,2,25,0,17,0,14,3,8,6,2,3,1,0,0,2
S01011718,Occupancy rating -1 or less,8,1,0,1,6,0,2,1,0,1,4,1,3,1,1,0,0,0
S01011719,All households,224,29,7,22,186,5,163,48,77,38,18,13,5,9,3,0,0,6
S01011719,Occupancy rating +2 or more,130,13,5,8,112,2,106,41,43,22,4,3,1,5,0,0,0,5
S01011719,Occupancy rating +1,54,3,0,3,51,2,40,5,24,11,9,5,4,0,0,0,0,0
S01011719,Occupancy rating 0,31,10,2,8,18,1,12,2,6,4,5,5,0,3,2,0,0,1
S01011719,Occupancy rating -1 or less,9,3,0,3,5,0,5,0,4,1,0,0,0,1,1,0,0,0
S01011720,All households,213,37,9,28,169,28,124,54,41,29,17,6,11,7,3,0,0,4
S01011720,Occupancy rating +2 or more,134,17,6,11,112,24,83,45,20,18,5,2,3,5,3,0,0,2
S01011720,Occupancy rating +1,42,7,0,7,34,1,26,5,13,8,7,3,4,1,0,0,0,1
S01011720,Occupancy rating 0,31,11,3,8,20,3,13,3,7,3,4,1,3,0,0,0,0,0
S01011720,Occupancy rating -1 or less,6,2,0,2,3,0,2,1,1,0,1,0,1,1,0,0,0,1
S01011721,All households,305,77,34,43,220,31,141,62,58,21,48,24,24,8,3,0,0,5
S01011721,Occupancy rating +2 or more,107,28,12,16,77,16,56,42,10,4,5,2,3,2,1,0,0,1
S01011721,Occupancy rating +1,96,27,15,12,68,10,43,17,19,7,15,8,7,1,1,0,0,0
S01011721,Occupancy rating 0,80,20,6,14,57,5,30,0,22,8,22,12,10,3,1,0,0,2
S01011721,Occupancy rating -1 or less,22,2,1,1,18,0,12,3,7,2,6,2,4,2,0,0,0,2
S01011722,All households,317,108,59,49,194,24,125,48,45,32,45,27,18,15,7,0,0,8
S01011722,Occupancy rating +2 or more,103,32,12,20,70,14,53,34,11,8,3,0,3,1,0,0,0,1
S01011722,Occupancy rating +1,89,28,18,10,58,6,37,10,12,15,15,6,9,3,1,0,0,2
S01011722,Occupancy rating 0,99,43,26,17,48,2,31,4,18,9,15,11,4,8,3,0,0,5
S01011722,Occupancy rating -1 or less,26,5,3,2,18,2,4,0,4,0,12,10,2,3,3,0,0,0
S01011723,All households,397,107,42,65,278,40,200,77,92,31,38,20,18,12,6,0,0,6
S01011723,Occupancy rating +2 or more,159,34,11,23,119,17,95,62,26,7,7,5,2,6,2,0,0,4
S01011723,Occupancy rating +1,115,30,13,17,83,19,52,12,28,12,12,3,9,2,1,0,0,1
S01011723,Occupancy rating 0,107,40,18,22,65,4,43,3,31,9,18,11,7,2,1,0,0,1
S01011723,Occupancy rating -1 or less,16,3,0,3,11,0,10,0,7,3,1,1,0,2,2,0,0,0
S01011724,All households,261,50,4,46,198,1,147,38,100,9,50,37,13,13,12,0,0,1
S01011724,Occupancy rating +2 or more,102,27,2,25,70,1,63,32,28,3,6,4,2,5,5,0,0,0
S01011724,Occupancy rating +1,90,15,1,14,73,0,52,5,43,4,21,12,9,2,1,0,0,1
S01011724,Occupancy rating 0,51,3,0,3,45,0,26,0,24,2,19,17,2,3,3,0,0,0
S01011724,Occupancy rating -1 or less,18,5,1,4,10,0,6,1,5,0,4,4,0,3,3,0,0,0
S01011725,All households,219,29,6,23,180,9,158,48,83,27,13,9,4,10,5,0,0,5
S01011725,Occupancy rating +2 or more,139,18,4,14,117,5,103,39,48,16,9,5,4,4,2,0,0,2
S01011725,Occupancy rating +1,53,8,2,6,40,1,37,8,24,5,2,2,0,5,2,0,0,3
S01011725,Occupancy rating 0,22,3,0,3,19,2,15,1,9,5,2,2,0,0,0,0,0,0
S01011725,Occupancy rating -1 or less,5,0,0,0,4,1,3,0,2,1,0,0,0,1,1,0,0,0
S01011726,All households,208,39,5,34,165,8,138,48,73,17,19,15,4,4,2,0,0,2
S01011726,Occupancy rating +2 or more,120,21,3,18,98,7,81,34,41,6,10,7,3,1,0,0,0,1
S01011726,Occupancy rating +1,61,15,2,13,46,1,39,14,19,6,6,5,1,0,0,0,0,0
S01011726,Occupancy rating 0,20,2,0,2,18,0,15,0,11,4,3,3,0,0,0,0,0,0
S01011726,Occupancy rating -1 or less,7,1,0,1,3,0,3,0,2,1,0,0,0,3,2,0,0,1
S01011727,All households,261,39,4,35,213,6,189,51,115,23,18,12,6,9,5,0,1,3
S01011727,Occupancy rating +2 or more,205,14,1,13,185,6,168,43,106,19,11,6,5,6,4,0,0,2
S01011727,Occupancy rating +1,35,21,3,18,12,0,10,8,2,0,2,2,0,2,0,0,1,1
S01011727,Occupancy rating 0,13,1,0,1,12,0,8,0,5,3,4,4,0,0,0,0,0,0
S01011727,Occupancy rating -1 or less,8,3,0,3,4,0,3,0,2,1,1,0,1,1,1,0,0,0
S01011728,All households,393,106,36,70,266,24,164,60,64,40,78,41,37,21,10,0,0,11
S01011728,Occupancy rating +2 or more,143,47,18,29,95,20,63,44,11,8,12,3,9,1,1,0,0,0
S01011728,Occupancy rating +1,115,33,8,25,79,4,48,12,21,15,27,14,13,3,0,0,0,3
S01011728,Occupancy rating 0,106,21,7,14,75,0,45,3,29,13,30,18,12,10,5,0,0,5
S01011728,Occupancy rating -1 or less,29,5,3,2,17,0,8,1,3,4,9,6,3,7,4,0,0,3
S01011729,All households,302,94,42,52,186,18,101,36,40,25,67,44,23,22,8,0,1,13
S01011729,Occupancy rating +2 or more,89,35,21,14,51,8,38,24,10,4,5,0,5,3,0,0,0,3
S01011729,Occupancy rating +1,98,31,14,17,60,7,24,7,8,9,29,18,11,7,1,0,1,5
S01011729,Occupancy rating 0,86,26,7,19,54,2,31,4,18,9,21,16,5,6,1,0,0,5
S01011729,Occupancy rating -1 or less,29,2,0,2,21,1,8,1,4,3,12,10,2,6,6,0,0,0
S01011730,All households,431,160,64,96,261,50,182,100,40,42,29,15,14,10,2,0,0,8
S01011730,Occupancy rating +2 or more,158,34,19,15,123,26,93,66,12,15,4,1,3,1,0,0,0,1
S01011730,Occupancy rating +1,131,46,14,32,82,16,57,27,15,15,9,2,7,3,0,0,0,3
S01011730,Occupancy rating 0,91,47,27,20,42,7,22,4,10,8,13,11,2,2,0,0,0,2
S01011730,Occupancy rating -1 or less,51,33,4,29,14,1,10,3,3,4,3,1,2,4,2,0,0,2
S01011731,All households,352,106,59,47,233,30,154,57,66,31,49,27,22,13,6,0,0,7
S01011731,Occupancy rating +2 or more,120,38,16,22,79,14,58,37,12,9,7,2,5,3,0,0,0,3
S01011731,Occupancy rating +1,139,43,26,17,94,8,65,16,31,18,21,9,12,2,1,0,0,1
S01011731,Occupancy rating 0,75,24,16,8,46,6,24,2,18,4,16,13,3,5,4,0,0,1
S01011731,Occupancy rating -1 or less,18,1,1,0,14,2,7,2,5,0,5,3,2,3,1,0,0,2
S01011732,All households,299,38,17,21,252,32,208,82,69,57,12,2,10,9,3,0,1,5
S01011732,Occupancy rating +2 or more,178,28,15,13,148,28,117,68,27,22,3,2,1,2,1,0,0,1
S01011732,Occupancy rating +1,75,9,2,7,62,3,55,13,19,23,4,0,4,4,1,0,1,2
S01011732,Occupancy rating 0,38,1,0,1,35,1,31,1,19,11,3,0,3,2,1,0,0,1
S01011732,Occupancy rating -1 or less,8,0,0,0,7,0,5,0,4,1,2,0,2,1,0,0,0,1
S01011733,All households,352,93,47,46,246,38,167,63,63,41,41,24,17,13,10,0,1,2
S01011733,Occupancy rating +2 or more,147,43,30,13,102,27,68,47,11,10,7,3,4,2,1,0,0,1
S01011733,Occupancy rating +1,102,28,4,24,72,4,51,12,21,18,17,9,8,2,1,0,0,1
S01011733,Occupancy rating 0,84,18,10,8,61,7,39,4,26,9,15,11,4,5,5,0,0,0
S01011733,Occupancy rating -1 or less,19,4,3,1,11,0,9,0,5,4,2,1,1,4,3,0,1,0
S01011734,All households,335,106,51,55,209,41,135,44,60,31,33,22,11,20,7,0,0,13
S01011734,Occupancy rating +2 or more,149,51,26,25,95,25,64,30,22,12,6,2,4,3,1,0,0,2
S01011734,Occupancy rating +1,82,12,4,8,65,7,44,7,23,14,14,11,3,5,1,0,0,4
S01011734,Occupancy rating 0,78,30,11,19,40,4,25,7,13,5,11,7,4,8,3,0,0,5
S01011734,Occupancy rating -1 or less,26,13,10,3,9,5,2,0,2,0,2,2,0,4,2,0,0,2
S01011735,All households,288,44,26,18,230,47,161,70,50,41,22,14,8,14,9,0,2,3
S01011735,Occupancy rating +2 or more,202,38,22,16,161,44,110,59,28,23,7,3,4,3,2,0,0,1
S01011735,Occupancy rating +1,51,4,3,1,41,2,32,9,11,12,7,5,2,6,3,0,2,1
S01011735,Occupancy rating 0,26,1,0,1,23,0,15,0,9,6,8,6,2,2,2,0,0,0
S01011735,Occupancy rating -1 or less,9,1,1,0,5,1,4,2,2,0,0,0,0,3,2,0,0,1
S01011736,All households,317,93,38,55,205,12,132,37,68,27,61,43,18,19,7,0,0,12
S01011736,Occupancy rating +2 or more,110,47,24,23,61,10,43,22,12,9,8,2,6,2,0,0,0,2
S01011736,Occupancy rating +1,115,36,9,27,74,1,54,11,35,8,19,12,7,5,2,0,0,3
S01011736,Occupancy rating 0,68,6,3,3,53,1,28,3,17,8,24,20,4,9,3,0,0,6
S01011736,Occupancy rating -1 or less,24,4,2,2,17,0,7,1,4,2,10,9,1,3,2,0,0,1
S01011737,All households,294,93,42,51,186,23,112,32,62,18,51,33,18,15,5,0,1,9
S01011737,Occupancy rating +2 or more,123,42,24,18,78,19,48,25,14,9,11,4,7,3,0,0,0,3
S01011737,Occupancy rating +1,92,35,8,27,49,1,30,6,18,6,18,11,7,8,3,0,0,5
S01011737,Occupancy rating 0,59,14,9,5,43,1,25,0,23,2,17,13,4,2,1,0,0,1
S01011737,Occupancy rating -1 or less,20,2,1,1,16,2,9,1,7,1,5,5,0,2,1,0,1,0
S01011738,All households,466,177,41,136,258,21,173,63,76,34,64,46,18,31,11,0,0,20
S01011738,Occupancy rating +2 or more,174,57,22,35,111,12,90,50,28,12,9,8,1,6,3,0,0,3
S01011738,Occupancy rating +1,145,69,9,60,71,8,39,11,19,9,24,16,8,5,1,0,0,4
S01011738,Occupancy rating 0,87,18,3,15,60,1,34,2,22,10,25,19,6,9,3,0,0,6
S01011738,Occupancy rating -1 or less,60,33,7,26,16,0,10,0,7,3,6,3,3,11,4,0,0,7
S01011739,All households,226,70,34,36,141,17,90,33,34,23,34,17,17,15,4,0,1,10
S01011739,Occupancy rating +2 or more,100,48,28,20,49,13,34,29,1,4,2,1,1,3,2,0,0,1
S01011739,Occupancy rating +1,72,8,4,4,60,3,38,3,21,14,19,10,9,4,2,0,0,2
S01011739,Occupancy rating 0,43,12,2,10,27,0,16,1,10,5,11,4,7,4,0,0,0,4
S01011739,Occupancy rating -1 or less,11,2,0,2,5,1,2,0,2,0,2,2,0,4,0,0,1,3
S01011740,All households,356,146,34,112,182,23,95,28,51,16,64,42,22,28,16,0,0,12
S01011740,Occupancy rating +2 or more,123,59,21,38,60,20,32,21,6,5,8,4,4,4,0,0,0,4
S01011740,Occupancy rating +1,116,47,9,38,60,1,32,4,22,6,27,15,12,9,6,0,0,3
S01011740,Occupancy rating 0,87,27,3,24,50,2,27,3,19,5,21,17,4,10,7,0,0,3
S01011740,Occupancy rating -1 or less,30,13,1,12,12,0,4,0,4,0,8,6,2,5,3,0,0,2
S01011741,All households,296,104,33,71,173,20,101,31,40,30,52,35,17,19,8,0,1,10
S01011741,Occupancy rating +2 or more,124,56,20,36,65,18,41,25,8,8,6,3,3,3,2,0,1,0
S01011741,Occupancy rating +1,102,31,7,24,64,1,39,5,18,16,24,16,8,7,0,0,0,7
S01011741,Occupancy rating 0,44,11,4,7,27,0,14,0,9,5,13,9,4,6,4,0,0,2
S01011741,Occupancy rating -1 or less,26,6,2,4,17,1,7,1,5,1,9,7,2,3,2,0,0,1
S01011742,All households,333,100,43,57,227,33,136,48,60,28,58,38,20,6,4,0,0,2
S01011742,Occupancy rating +2 or more,109,38,21,17,71,23,44,35,6,3,4,4,0,0,0,0,0,0
S01011742,Occupancy rating +1,116,30,11,19,86,7,57,11,28,18,22,12,10,0,0,0,0,0
S01011742,Occupancy rating 0,72,16,6,10,54,1,30,1,22,7,23,14,9,2,1,0,0,1
S01011742,Occupancy rating -1 or less,36,16,5,11,16,2,5,1,4,0,9,8,1,4,3,0,0,1
S01011743,All households,379,138,62,76,228,31,141,65,55,21,56,38,18,13,5,0,1,7
S01011743,Occupancy rating +2 or more,142,71,30,41,71,20,47,42,1,4,4,1,3,0,0,0,0,0
S01011743,Occupancy rating +1,117,28,11,17,84,8,53,12,31,10,23,14,9,5,1,0,1,3
S01011743,Occupancy rating 0,91,35,19,16,50,1,27,8,15,4,22,19,3,6,4,0,0,2
S01011743,Occupancy rating -1 or less,29,4,2,2,23,2,14,3,8,3,7,4,3,2,0,0,0,2
S01011744,All households,462,214,99,115,234,35,132,74,38,20,67,47,20,14,5,0,1,8
S01011744,Occupancy rating +2 or more,78,38,19,19,39,11,25,21,3,1,3,2,1,1,0,0,0,1
S01011744,Occupancy rating +1,172,95,44,51,76,15,47,32,8,7,14,8,6,1,0,0,0,1
S01011744,Occupancy rating 0,156,64,29,35,86,6,50,20,19,11,30,20,10,6,2,0,1,3
S01011744,Occupancy rating -1 or less,56,17,7,10,33,3,10,1,8,1,20,17,3,6,3,0,0,3
S01011745,All households,398,191,139,52,193,41,96,44,35,17,56,29,27,14,2,0,2,10
S01011745,Occupancy rating +2 or more,99,50,35,15,49,14,32,28,1,3,3,1,2,0,0,0,0,0
S01011745,Occupancy rating +1,119,60,31,29,58,14,25,11,10,4,19,10,9,1,0,0,0,1
S01011745,Occupancy rating 0,141,68,62,6,66,9,31,3,20,8,26,13,13,7,1,0,1,5
S01011745,Occupancy rating -1 or less,39,13,11,2,20,4,8,2,4,2,8,5,3,6,1,0,1,4
S01011746,All households,215,58,29,29,138,14,84,32,37,15,40,29,11,19,9,0,0,10
S01011746,Occupancy rating +2 or more,98,38,22,16,57,13,37,28,8,1,7,7,0,3,0,0,0,3
S01011746,Occupancy rating +1,61,13,4,9,44,1,26,3,16,7,17,8,9,4,3,0,0,1
S01011746,Occupancy rating 0,39,5,1,4,27,0,15,1,9,5,12,11,1,7,2,0,0,5
S01011746,Occupancy rating -1 or less,17,2,2,0,10,0,6,0,4,2,4,3,1,5,4,0,0,1
S01011747,All households,413,120,36,84,266,24,124,31,56,37,118,83,35,27,15,0,0,12
S01011747,Occupancy rating +2 or more,155,85,29,56,67,20,38,27,3,8,9,4,5,3,1,0,0,2
S01011747,Occupancy rating +1,120,20,4,16,92,4,47,4,23,20,41,24,17,8,3,0,0,5
S01011747,Occupancy rating 0,104,10,3,7,86,0,29,0,24,5,57,45,12,8,4,0,0,4
S01011747,Occupancy rating -1 or less,34,5,0,5,21,0,10,0,6,4,11,10,1,8,7,0,0,1
S01011748,All households,375,130,40,90,217,12,116,42,54,20,89,67,22,28,11,0,2,15
S01011748,Occupancy rating +2 or more,140,73,30,43,64,11,40,30,7,3,13,8,5,3,1,0,0,2
S01011748,Occupancy rating +1,121,30,4,26,82,0,42,10,20,12,40,27,13,9,2,0,2,5
S01011748,Occupancy rating 0,81,21,4,17,50,1,27,2,20,5,22,21,1,10,3,0,0,7
S01011748,Occupancy rating -1 or less,33,6,2,4,21,0,7,0,7,0,14,11,3,6,5,0,0,1
S01011749,All households,370,168,12,156,182,6,91,42,43,6,85,68,17,20,6,0,0,14
S01011749,Occupancy rating +2 or more,116,47,5,42,65,6,34,17,14,3,25,19,6,4,1,0,0,3
S01011749,Occupancy rating +1,120,61,2,59,54,0,33,19,14,0,21,16,5,5,2,0,0,3
S01011749,Occupancy rating 0,81,33,2,31,40,0,14,4,9,1,26,21,5,8,2,0,0,6
S01011749,Occupancy rating -1 or less,53,27,3,24,23,0,10,2,6,2,13,12,1,3,1,0,0,2
S01011750,All households,398,130,63,67,248,36,135,47,63,25,77,49,28,20,8,0,0,12
S01011750,Occupancy rating +2 or more,149,61,34,27,85,26,50,35,10,5,9,5,4,3,0,0,0,3
S01011750,Occupancy rating +1,113,23,11,12,86,9,47,9,26,12,30,21,9,4,1,0,0,3
S01011750,Occupancy rating 0,109,42,17,25,61,1,31,2,21,8,29,19,10,6,3,0,0,3
S01011750,Occupancy rating -1 or less,27,4,1,3,16,0,7,1,6,0,9,4,5,7,4,0,0,3
S01011751,All households,532,253,50,203,248,8,124,56,54,14,116,93,23,31,5,0,1,25
S01011751,Occupancy rating +2 or more,94,53,13,40,39,5,30,18,10,2,4,2,2,2,0,0,1,1
S01011751,Occupancy rating +1,235,162,30,132,69,3,47,34,8,5,19,14,5,4,1,0,0,3
S01011751,Occupancy rating 0,150,23,4,19,109,0,37,3,29,5,72,60,12,18,1,0,0,17
S01011751,Occupancy rating -1 or less,53,15,3,12,31,0,10,1,7,2,21,17,4,7,3,0,0,4
S01011752,All households,460,193,55,138,246,25,147,61,62,24,74,48,26,21,7,0,0,14
S01011752,Occupancy rating +2 or more,147,96,36,60,51,15,31,24,4,3,5,2,3,0,0,0,0,0
S01011752,Occupancy rating +1,182,73,14,59,101,7,71,34,26,11,23,12,11,8,1,0,0,7
S01011752,Occupancy rating 0,109,20,2,18,80,1,41,3,28,10,38,28,10,9,2,0,0,7
S01011752,Occupancy rating -1 or less,22,4,3,1,14,2,4,0,4,0,8,6,2,4,4,0,0,0
S01011753,All households,366,119,47,72,238,39,160,80,56,24,39,27,12,9,2,0,1,6
S01011753,Occupancy rating +2 or more,168,54,40,14,111,37,63,41,16,6,11,5,6,3,1,0,0,2
S01011753,Occupancy rating +1,132,61,6,55,70,2,60,36,16,8,8,6,2,1,0,0,1,0
S01011753,Occupancy rating 0,51,2,1,1,44,0,29,2,17,10,15,11,4,5,1,0,0,4
S01011753,Occupancy rating -1 or less,15,2,0,2,13,0,8,1,7,0,5,5,0,0,0,0,0,0
S01011754,All households,339,106,58,48,227,41,129,47,63,19,57,35,22,6,3,0,0,3
S01011754,Occupancy rating +2 or more,156,61,36,25,95,30,51,36,12,3,14,8,6,0,0,0,0,0
S01011754,Occupancy rating +1,109,26,16,10,80,9,46,8,25,13,25,14,11,3,1,0,0,2
S01011754,Occupancy rating 0,61,18,6,12,42,1,27,3,21,3,14,11,3,1,1,0,0,0
S01011754,Occupancy rating -1 or less,13,1,0,1,10,1,5,0,5,0,4,2,2,2,1,0,0,1
S01011755,All households,456,197,38,159,243,18,166,63,70,33,59,45,14,16,6,0,0,10
S01011755,Occupancy rating +2 or more,143,71,21,50,71,17,53,42,8,3,1,0,1,1,0,0,0,1
S01011755,Occupancy rating +1,152,56,8,48,91,0,62,17,26,19,29,19,10,5,0,0,0,5
S01011755,Occupancy rating 0,136,60,7,53,70,1,45,3,33,9,24,21,3,6,4,0,0,2
S01011755,Occupancy rating -1 or less,25,10,2,8,11,0,6,1,3,2,5,5,0,4,2,0,0,2
S01011756,All households,430,139,37,102,276,26,169,63,77,29,81,53,28,15,9,0,0,6
S01011756,Occupancy rating +2 or more,174,67,23,44,106,25,72,49,17,6,9,2,7,1,1,0,0,0
S01011756,Occupancy rating +1,118,26,5,21,89,1,55,10,28,17,33,21,12,3,1,0,0,2
S01011756,Occupancy rating 0,100,36,6,30,61,0,32,4,25,3,29,21,8,3,3,0,0,0
S01011756,Occupancy rating -1 or less,38,10,3,7,20,0,10,0,7,3,10,9,1,8,4,0,0,4
S01011757,All households,327,123,59,64,195,17,126,40,63,23,52,33,19,9,5,0,0,4
S01011757,Occupancy rating +2 or more,95,34,21,13,61,13,41,26,14,1,7,2,5,0,0,0,0,0
S01011757,Occupancy rating +1,86,22,5,17,62,1,46,12,22,12,15,8,7,2,1,0,0,1
S01011757,Occupancy rating 0,115,57,28,29,55,3,31,1,24,6,21,17,4,3,1,0,0,2
S01011757,Occupancy rating -1 or less,31,10,5,5,17,0,8,1,3,4,9,6,3,4,3,0,0,1
S01011758,All households,252,69,21,48,175,16,120,44,52,24,39,22,17,8,6,0,0,2
S01011758,Occupancy rating +2 or more,113,37,11,26,75,14,58,35,14,9,3,0,3,1,0,0,0,1
S01011758,Occupancy rating +1,63,8,0,8,53,2,35,7,21,7,16,5,11,2,2,0,0,0
S01011758,Occupancy rating 0,65,21,9,12,41,0,22,2,13,7,19,16,3,3,3,0,0,0
S01011758,Occupancy rating -1 or less,11,3,1,2,6,0,5,0,4,1,1,1,0,2,1,0,0,1
S01011759,All households,340,83,43,40,242,39,163,58,69,36,40,29,11,15,10,0,1,4
S01011759,Occupancy rating +2 or more,155,54,29,25,101,28,66,47,13,6,7,4,3,0,0,0,0,0
S01011759,Occupancy rating +1,102,14,6,8,81,6,59,9,28,22,16,11,5,7,2,0,1,4
S01011759,Occupancy rating 0,66,12,6,6,50,4,32,1,24,7,14,11,3,4,4,0,0,0
S01011759,Occupancy rating -1 or less,17,3,2,1,10,1,6,1,4,1,3,3,0,4,4,0,0,0
S01011760,All households,411,133,53,80,260,32,158,69,65,24,70,42,28,18,5,0,0,13
S01011760,Occupancy rating +2 or more,127,43,30,13,83,27,46,37,7,2,10,5,5,1,0,0,0,1
S01011760,Occupancy rating +1,127,41,8,33,82,5,57,21,26,10,20,9,11,4,2,0,0,2
S01011760,Occupancy rating 0,119,42,13,29,73,0,45,10,27,8,28,19,9,4,0,0,0,4
S01011760,Occupancy rating -1 or less,38,7,2,5,22,0,10,1,5,4,12,9,3,9,3,0,0,6
S01011761,All households,272,64,19,45,189,6,126,37,74,15,57,43,14,19,9,0,0,10
S01011761,Occupancy rating +2 or more,86,34,14,20,50,4,34,18,12,4,12,7,5,2,1,0,0,1
S01011761,Occupancy rating +1,100,25,4,21,69,1,52,19,24,9,16,13,3,6,2,0,0,4
S01011761,Occupancy rating 0,67,2,1,1,60,1,35,0,34,1,24,18,6,5,1,0,0,4
S01011761,Occupancy rating -1 or less,19,3,0,3,10,0,5,0,4,1,5,5,0,6,5,0,0,1
S01011762,All households,322,130,31,99,173,17,88,34,38,16,68,45,23,19,7,0,0,12
S01011762,Occupancy rating +2 or more,111,54,20,34,57,16,31,22,7,2,10,5,5,0,0,0,0,0
S01011762,Occupancy rating +1,112,52,8,44,54,1,37,9,18,10,16,10,6,6,0,0,0,6
S01011762,Occupancy rating 0,82,22,2,20,53,0,16,2,10,4,37,26,11,7,2,0,0,5
S01011762,Occupancy rating -1 or less,17,2,1,1,9,0,4,1,3,0,5,4,1,6,5,0,0,1
S01011763,All households,350,113,52,61,222,22,163,67,59,37,37,24,13,15,9,0,1,5
S01011763,Occupancy rating +2 or more,113,36,17,19,74,10,61,43,10,8,3,2,1,3,2,0,0,1
S01011763,Occupancy rating +1,124,46,22,24,75,10,52,17,20,15,13,8,5,3,2,0,0,1
S01011763,Occupancy rating 0,92,26,11,15,60,2,43,6,24,13,15,10,5,6,4,0,0,2
S01011763,Occupancy rating -1 or less,21,5,2,3,13,0,7,1,5,1,6,4,2,3,1,0,1,1
S01011764,All households,136,12,6,6,112,11,81,29,30,22,20,12,8,12,9,0,0,3
S01011764,Occupancy rating +2 or more,64,11,6,5,50,10,36,26,3,7,4,2,2,3,1,0,0,2
S01011764,Occupancy rating +1,37,1,0,1,35,0,25,2,14,9,10,4,6,1,0,0,0,1
S01011764,Occupancy rating 0,25,0,0,0,21,1,16,0,11,5,4,4,0,4,4,0,0,0
S01011764,Occupancy rating -1 or less,10,0,0,0,6,0,4,1,2,1,2,2,0,4,4,0,0,0
S01011765,All households,380,64,15,49,307,21,238,91,106,41,48,27,21,9,7,0,1,1
S01011765,Occupancy rating +2 or more,185,24,4,20,158,12,134,76,40,18,12,7,5,3,2,0,0,1
S01011765,Occupancy rating +1,99,24,6,18,71,8,54,12,32,10,9,4,5,4,3,0,1,0
S01011765,Occupancy rating 0,61,3,2,1,57,0,38,0,27,11,19,12,7,1,1,0,0,0
S01011765,Occupancy rating -1 or less,35,13,3,10,21,1,12,3,7,2,8,4,4,1,1,0,0,0
S01011766,All households,209,38,14,24,164,20,126,58,52,16,18,9,9,7,5,0,0,2
S01011766,Occupancy rating +2 or more,144,26,11,15,116,17,89,48,33,8,10,3,7,2,2,0,0,0
S01011766,Occupancy rating +1,38,8,3,5,27,1,23,9,10,4,3,3,0,3,1,0,0,2
S01011766,Occupancy rating 0,19,2,0,2,17,1,12,1,9,2,4,2,2,0,0,0,0,0
S01011766,Occupancy rating -1 or less,8,2,0,2,4,1,2,0,0,2,1,1,0,2,2,0,0,0
S01011767,All households,443,190,81,109,236,32,138,71,39,28,66,41,25,17,4,0,0,13
S01011767,Occupancy rating +2 or more,134,55,28,27,79,18,56,41,9,6,5,3,2,0,0,0,0,0
S01011767,Occupancy rating +1,135,54,14,40,72,6,51,27,9,15,15,9,6,9,0,0,0,9
S01011767,Occupancy rating 0,146,70,35,35,70,7,27,3,18,6,36,22,14,6,2,0,0,4
S01011767,Occupancy rating -1 or less,28,11,4,7,15,1,4,0,3,1,10,7,3,2,2,0,0,0
S01011768,All households,342,129,26,103,209,20,112,49,49,14,77,57,20,4,1,0,1,2
S01011768,Occupancy rating +2 or more,78,31,7,24,47,15,27,19,6,2,5,2,3,0,0,0,0,0
S01011768,Occupancy rating +1,133,65,15,50,66,5,45,25,12,8,16,11,5,2,0,0,1,1
S01011768,Occupancy rating 0,104,27,4,23,75,0,29,2,25,2,46,37,9,2,1,0,0,1
S01011768,Occupancy rating -1 or less,27,6,0,6,21,0,11,3,6,2,10,7,3,0,0,0,0,0
S01011769,All households,321,140,52,88,167,39,83,37,31,15,45,23,22,14,7,2,0,5
S01011769,Occupancy rating +2 or more,67,31,8,23,35,10,24,22,1,1,1,0,1,1,1,0,0,0
S01011769,Occupancy rating +1,137,68,27,41,67,20,33,12,12,9,14,6,8,2,1,0,0,1
S01011769,Occupancy rating 0,97,37,15,22,52,6,25,3,17,5,21,11,10,8,2,2,0,4
S01011769,Occupancy rating -1 or less,20,4,2,2,13,3,1,0,1,0,9,6,3,3,3,0,0,0
S01011770,All households,409,179,71,108,215,28,119,54,47,18,68,31,37,15,4,0,0,11
S01011770,Occupancy rating +2 or more,91,40,14,26,49,16,29,18,6,5,4,1,3,2,0,0,0,2
S01011770,Occupancy rating +1,183,105,44,61,75,11,48,29,13,6,16,5,11,3,0,0,0,3
S01011770,Occupancy rating 0,100,25,8,17,68,1,34,5,23,6,33,19,14,7,2,0,0,5
S01011770,Occupancy rating -1 or less,35,9,5,4,23,0,8,2,5,1,15,6,9,3,2,0,0,1
S01011771,All households,238,26,11,15,205,12,172,64,85,23,21,14,7,7,2,0,0,5
S01011771,Occupancy rating +2 or more,169,21,9,12,144,12,125,61,50,14,7,5,2,4,2,0,0,2
S01011771,Occupancy rating +1,36,4,2,2,32,0,23,3,15,5,9,5,4,0,0,0,0,0
S01011771,Occupancy rating 0,24,0,0,0,22,0,18,0,16,2,4,3,1,2,0,0,0,2
S01011771,Occupancy rating -1 or less,9,1,0,1,7,0,6,0,4,2,1,1,0,1,0,0,0,1
S01011772,All households,390,55,26,29,315,40,259,94,118,47,16,11,5,20,13,0,2,5
S01011772,Occupancy rating +2 or more,339,46,22,24,278,35,232,90,106,36,11,7,4,15,9,0,2,4
S01011772,Occupancy rating +1,33,7,4,3,25,4,19,3,8,8,2,2,0,1,1,0,0,0
S01011772,Occupancy rating 0,12,1,0,1,9,1,6,1,2,3,2,2,0,2,1,0,0,1
S01011772,Occupancy rating -1 or less,6,1,0,1,3,0,2,0,2,0,1,0,1,2,2,0,0,0
S01011773,All households,200,24,6,18,171,5,150,38,90,22,16,13,3,5,3,0,1,1
S01011773,Occupancy rating +2 or more,122,14,1,13,105,4,98,27,57,14,3,2,1,3,2,0,0,1
S01011773,Occupancy rating +1,55,10,5,5,43,1,34,11,20,3,8,8,0,2,1,0,1,0
S01011773,Occupancy rating 0,18,0,0,0,18,0,14,0,10,4,4,2,2,0,0,0,0,0
S01011773,Occupancy rating -1 or less,5,0,0,0,5,0,4,0,3,1,1,1,0,0,0,0,0,0
S01011774,All households,354,91,23,68,253,4,201,58,118,25,48,39,9,10,3,0,0,7
S01011774,Occupancy rating +2 or more,158,20,4,16,132,2,125,41,74,10,5,4,1,6,1,0,0,5
S01011774,Occupancy rating +1,101,45,10,35,55,2,43,15,22,6,10,6,4,1,0,0,0,1
S01011774,Occupancy rating 0,76,21,5,16,53,0,21,1,13,7,32,28,4,2,1,0,0,1
S01011774,Occupancy rating -1 or less,19,5,4,1,13,0,12,1,9,2,1,1,0,1,1,0,0,0
S01011775,All households,228,34,5,29,189,10,158,35,110,13,21,15,6,5,4,0,0,1
S01011775,Occupancy rating +2 or more,164,23,2,21,138,8,122,30,81,11,8,6,2,3,2,0,0,1
S01011775,Occupancy rating +1,42,7,3,4,34,2,27,5,20,2,5,5,0,1,1,0,0,0
S01011775,Occupancy rating 0,18,4,0,4,14,0,6,0,6,0,8,4,4,0,0,0,0,0
S01011775,Occupancy rating -1 or less,4,0,0,0,3,0,3,0,3,0,0,0,0,1,1,0,0,0
S01011776,All households,319,15,3,12,274,7,250,63,167,20,17,16,1,30,24,0,0,6
S01011776,Occupancy rating +2 or more,264,12,1,11,232,5,212,52,146,14,15,14,1,20,14,0,0,6
S01011776,Occupancy rating +1,35,2,1,1,30,1,28,11,13,4,1,1,0,3,3,0,0,0
S01011776,Occupancy rating 0,13,1,1,0,7,0,6,0,4,2,1,1,0,5,5,0,0,0
S01011776,Occupancy rating -1 or less,7,0,0,0,5,1,4,0,4,0,0,0,0,2,2,0,0,0
S01011777,All households,264,72,18,54,184,14,147,48,85,14,23,16,7,8,5,0,1,2
S01011777,Occupancy rating +2 or more,112,26,6,20,84,10,68,21,45,2,6,5,1,2,1,0,0,1
S01011777,Occupancy rating +1,89,28,9,19,58,4,52,23,21,8,2,1,1,3,1,0,1,1
S01011777,Occupancy rating 0,54,16,3,13,37,0,24,2,18,4,13,8,5,1,1,0,0,0
S01011777,Occupancy rating -1 or less,9,2,0,2,5,0,3,2,1,0,2,2,0,2,2,0,0,0
S01011778,All households,261,83,37,46,171,8,139,46,76,17,24,19,5,7,3,0,0,4
S01011778,Occupancy rating +2 or more,125,16,6,10,107,1,100,32,54,14,6,4,2,2,1,0,0,1
S01011778,Occupancy rating +1,56,23,4,19,32,1,27,13,11,3,4,2,2,1,1,0,0,0
S01011778,Occupancy rating 0,56,28,16,12,25,3,9,1,8,0,13,12,1,3,0,0,0,3
S01011778,Occupancy rating -1 or less,24,16,11,5,7,3,3,0,3,0,1,1,0,1,1,0,0,0
S01011779,All households,324,85,43,42,231,33,188,73,88,27,10,8,2,8,5,0,1,2
S01011779,Occupancy rating +2 or more,176,32,16,16,140,21,113,51,50,12,6,5,1,4,3,0,0,1
S01011779,Occupancy rating +1,90,27,18,9,62,9,50,17,24,9,3,3,0,1,0,0,0,1
S01011779,Occupancy rating 0,44,19,5,14,24,2,21,4,12,5,1,0,1,1,1,0,0,0
S01011779,Occupancy rating -1 or less,14,7,4,3,5,1,4,1,2,1,0,0,0,2,1,0,1,0
S01011780,All households,315,33,15,18,270,19,231,81,111,39,20,10,10,12,8,0,2,2
S01011780,Occupancy rating +2 or more,233,24,11,13,204,12,181,69,82,30,11,4,7,5,4,0,0,1
S01011780,Occupancy rating +1,47,5,2,3,41,6,33,10,18,5,2,2,0,1,0,0,1,0
S01011780,Occupancy rating 0,20,1,0,1,16,0,13,0,11,2,3,2,1,3,1,0,1,1
S01011780,Occupancy rating -1 or less,15,3,2,1,9,1,4,2,0,2,4,2,2,3,3,0,0,0
S01011781,All households,214,41,20,21,169,16,136,42,70,24,17,9,8,4,3,0,0,1
S01011781,Occupancy rating +2 or more,141,19,5,14,120,4,108,35,54,19,8,6,2,2,1,0,0,1
S01011781,Occupancy rating +1,48,17,11,6,29,12,16,5,8,3,1,1,0,2,2,0,0,0
S01011781,Occupancy rating 0,17,2,2,0,15,0,8,0,7,1,7,1,6,0,0,0,0,0
S01011781,Occupancy rating -1 or less,8,3,2,1,5,0,4,2,1,1,1,1,0,0,0,0,0,0
S01011782,All households,271,60,23,37,198,29,157,53,63,41,12,7,5,13,2,0,2,9
S01011782,Occupancy rating +2 or more,189,39,14,25,143,24,114,49,36,29,5,2,3,7,2,0,0,5
S01011782,Occupancy rating +1,59,20,8,12,37,5,27,4,15,8,5,3,2,2,0,0,2,0
S01011782,Occupancy rating 0,19,0,0,0,15,0,13,0,10,3,2,2,0,4,0,0,0,4
S01011782,Occupancy rating -1 or less,4,1,1,0,3,0,3,0,2,1,0,0,0,0,0,0,0,0
S01011783,All households,213,27,11,16,179,19,146,52,57,37,14,8,6,7,3,0,0,4
S01011783,Occupancy rating +2 or more,121,11,4,7,109,14,93,41,27,25,2,1,1,1,1,0,0,0
S01011783,Occupancy rating +1,61,16,7,9,45,3,36,10,16,10,6,2,4,0,0,0,0,0
S01011783,Occupancy rating 0,23,0,0,0,19,1,13,0,12,1,5,4,1,4,0,0,0,4
S01011783,Occupancy rating -1 or less,8,0,0,0,6,1,4,1,2,1,1,1,0,2,2,0,0,0
S01011784,All households,349,108,47,61,230,15,154,68,49,37,61,38,23,11,9,0,0,2
S01011784,Occupancy rating +2 or more,100,39,14,25,61,7,51,42,7,2,3,3,0,0,0,0,0,0
S01011784,Occupancy rating +1,116,40,17,23,73,4,48,13,18,17,21,7,14,3,2,0,0,1
S01011784,Occupancy rating 0,108,27,15,12,76,4,42,11,18,13,30,22,8,5,5,0,0,0
S01011784,Occupancy rating -1 or less,25,2,1,1,20,0,13,2,6,5,7,6,1,3,2,0,0,1
S01011785,All households,389,117,77,40,261,32,164,78,53,33,65,37,28,11,7,0,0,4
S01011785,Occupancy rating +2 or more,120,24,10,14,94,8,78,62,12,4,8,3,5,2,0,0,0,2
S01011785,Occupancy rating +1,125,38,25,13,86,11,47,12,17,18,28,11,17,1,0,0,0,1
S01011785,Occupancy rating 0,118,45,34,11,68,11,34,4,21,9,23,18,5,5,4,0,0,1
S01011785,Occupancy rating -1 or less,26,10,8,2,13,2,5,0,3,2,6,5,1,3,3,0,0,0
S01011786,All households,124,4,0,4,109,0,96,22,69,5,13,11,2,11,7,0,0,4
S01011786,Occupancy rating +2 or more,102,4,0,4,93,0,84,22,58,4,9,8,1,5,3,0,0,2
S01011786,Occupancy rating +1,15,0,0,0,13,0,10,0,9,1,3,2,1,2,2,0,0,0
S01011786,Occupancy rating 0,6,0,0,0,2,0,1,0,1,0,1,1,0,4,2,0,0,2
S01011786,Occupancy rating -1 or less,1,0,0,0,1,0,1,0,1,0,0,0,0,0,0,0,0,0
S01011787,All households,483,196,76,120,265,22,151,45,72,34,92,57,35,22,13,0,3,6
S01011787,Occupancy rating +2 or more,123,57,21,36,63,7,46,23,17,6,10,6,4,3,2,0,1,0
S01011787,Occupancy rating +1,143,64,32,32,75,10,46,16,18,12,19,8,11,4,1,0,1,2
S01011787,Occupancy rating 0,150,55,17,38,85,2,40,2,28,10,43,27,16,10,6,0,1,3
S01011787,Occupancy rating -1 or less,67,20,6,14,42,3,19,4,9,6,20,16,4,5,4,0,0,1
S01011788,All households,225,20,9,11,193,13,174,55,105,14,6,3,3,12,7,0,0,5
S01011788,Occupancy rating +2 or more,205,19,9,10,176,13,157,53,91,13,6,3,3,10,6,0,0,4
S01011788,Occupancy rating +1,9,0,0,0,8,0,8,1,7,0,0,0,0,1,1,0,0,0
S01011788,Occupancy rating 0,4,0,0,0,4,0,4,0,3,1,0,0,0,0,0,0,0,0
S01011788,Occupancy rating -1 or less,7,1,0,1,5,0,5,1,4,0,0,0,0,1,0,0,0,1
S01011789,All households,284,73,40,33,204,28,140,59,53,28,36,18,18,7,2,0,0,5
S01011789,Occupancy rating +2 or more,145,43,26,17,100,20,73,39,23,11,7,4,3,2,1,0,0,1
S01011789,Occupancy rating +1,62,16,8,8,45,6,30,13,9,8,9,4,5,1,0,0,0,1
S01011789,Occupancy rating 0,57,10,6,4,44,1,29,6,14,9,14,6,8,3,1,0,0,2
S01011789,Occupancy rating -1 or less,20,4,0,4,15,1,8,1,7,0,6,4,2,1,0,0,0,1
S01011790,All households,404,101,27,74,286,22,196,81,86,29,68,51,17,17,7,0,2,8
S01011790,Occupancy rating +2 or more,151,33,5,28,115,16,88,49,29,10,11,5,6,3,2,0,0,1
S01011790,Occupancy rating +1,113,38,14,24,68,6,47,26,13,8,15,11,4,7,2,0,2,3
S01011790,Occupancy rating 0,98,19,6,13,75,0,46,4,33,9,29,24,5,4,1,0,0,3
S01011790,Occupancy rating -1 or less,42,11,2,9,28,0,15,2,11,2,13,11,2,3,2,0,0,1
S01011791,All households,347,123,46,77,211,29,127,52,53,22,55,32,23,13,4,0,1,8
S01011791,Occupancy rating +2 or more,66,24,9,15,38,4,28,17,7,4,6,4,2,4,1,0,0,3
S01011791,Occupancy rating +1,134,60,20,40,71,18,38,24,7,7,15,9,6,3,0,0,0,3
S01011791,Occupancy rating 0,115,36,16,20,75,3,46,8,30,8,26,13,13,4,1,0,1,2
S01011791,Occupancy rating -1 or less,32,3,1,2,27,4,15,3,9,3,8,6,2,2,2,0,0,0
S01011792,All households,515,286,157,129,221,45,141,60,53,28,35,17,18,8,1,0,3,4
S01011792,Occupancy rating +2 or more,101,22,10,12,77,14,58,26,23,9,5,1,4,2,1,0,1,0
S01011792,Occupancy rating +1,122,69,34,35,51,13,31,16,7,8,7,4,3,2,0,0,0,2
S01011792,Occupancy rating 0,227,151,82,69,74,16,44,17,16,11,14,6,8,2,0,0,2,0
S01011792,Occupancy rating -1 or less,65,44,31,13,19,2,8,1,7,0,9,6,3,2,0,0,0,2
S01011793,All households,327,131,66,65,187,22,145,75,44,26,20,7,13,9,3,0,2,4
S01011793,Occupancy rating +2 or more,114,30,15,15,82,8,69,42,18,9,5,3,2,2,1,0,0,1
S01011793,Occupancy rating +1,131,65,34,31,62,12,48,27,14,7,2,0,2,4,1,0,0,3
S01011793,Occupancy rating 0,67,32,16,16,34,1,21,5,8,8,12,3,9,1,0,0,1,0
S01011793,Occupancy rating -1 or less,15,4,1,3,9,1,7,1,4,2,1,1,0,2,1,0,1,0
S01011794,All households,414,152,51,101,254,34,162,66,79,17,58,42,16,8,3,0,1,4
S01011794,Occupancy rating +2 or more,64,20,10,10,44,13,29,18,9,2,2,1,1,0,0,0,0,0
S01011794,Occupancy rating +1,148,55,18,37,92,17,65,39,23,3,10,7,3,1,0,0,0,1
S01011794,Occupancy rating 0,161,74,22,52,84,3,50,7,36,7,31,24,7,3,0,0,1,2
S01011794,Occupancy rating -1 or less,41,3,1,2,34,1,18,2,11,5,15,10,5,4,3,0,0,1
S01011795,All households,317,114,34,80,193,20,115,60,36,19,58,46,12,10,4,0,0,6
S01011795,Occupancy rating +2 or more,47,11,6,5,35,7,25,15,5,5,3,1,2,1,0,0,0,1
S01011795,Occupancy rating +1,132,70,16,54,61,8,46,34,9,3,7,6,1,1,1,0,0,0
S01011795,Occupancy rating 0,105,25,9,16,76,2,37,8,19,10,37,30,7,4,0,0,0,4
S01011795,Occupancy rating -1 or less,33,8,3,5,21,3,7,3,3,1,11,9,2,4,3,0,0,1
S01011796,All households,354,146,56,90,191,13,111,39,51,21,67,46,21,17,5,0,1,11
S01011796,Occupancy rating +2 or more,58,31,14,17,27,7,19,10,5,4,1,1,0,0,0,0,0,0
S01011796,Occupancy rating +1,110,48,16,32,60,3,39,21,12,6,18,8,10,2,0,0,0,2
S01011796,Occupancy rating 0,133,60,25,35,67,2,34,6,23,5,31,24,7,6,0,0,1,5
S01011796,Occupancy rating -1 or less,53,7,1,6,37,1,19,2,11,6,17,13,4,9,5,0,0,4
S01011797,All households,385,67,36,31,304,38,251,95,105,51,15,7,8,14,7,0,0,7
S01011797,Occupancy rating +2 or more,246,51,27,24,192,30,155,76,49,30,7,3,4,3,0,0,0,3
S01011797,Occupancy rating +1,100,13,7,6,81,6,69,17,37,15,6,2,4,6,3,0,0,3
S01011797,Occupancy rating 0,29,3,2,1,23,1,20,2,14,4,2,2,0,3,2,0,0,1
S01011797,Occupancy rating -1 or less,10,0,0,0,8,1,7,0,5,2,0,0,0,2,2,0,0,0
S01011798,All households,242,78,33,45,152,15,99,36,45,18,38,20,18,12,7,0,0,5
S01011798,Occupancy rating +2 or more,55,19,7,12,36,6,27,18,5,4,3,0,3,0,0,0,0,0
S01011798,Occupancy rating +1,94,45,18,27,45,8,27,18,6,3,10,6,4,4,1,0,0,3
S01011798,Occupancy rating 0,63,7,5,2,51,1,31,0,25,6,19,9,10,5,5,0,0,0
S01011798,Occupancy rating -1 or less,30,7,3,4,20,0,14,0,9,5,6,5,1,3,1,0,0,2
S01011799,All households,357,63,31,32,279,40,189,71,65,53,50,26,24,15,6,0,2,7
S01011799,Occupancy rating +2 or more,170,40,20,20,126,28,90,50,20,20,8,2,6,4,2,0,1,1
S01011799,Occupancy rating +1,88,20,8,12,63,9,44,19,13,12,10,3,7,5,1,0,1,3
S01011799,Occupancy rating 0,72,2,2,0,67,1,42,0,25,17,24,15,9,3,1,0,0,2
S01011799,Occupancy rating -1 or less,27,1,1,0,23,2,13,2,7,4,8,6,2,3,2,0,0,1
S01011800,All households,219,56,31,25,157,24,103,40,37,26,30,15,15,6,2,0,2,2
S01011800,Occupancy rating +2 or more,63,22,12,10,41,12,29,23,3,3,0,0,0,0,0,0,0,0
S01011800,Occupancy rating +1,91,29,16,13,59,8,38,14,12,12,13,6,7,3,0,0,2,1
S01011800,Occupancy rating 0,49,3,1,2,44,2,30,2,18,10,12,7,5,2,1,0,0,1
S01011800,Occupancy rating -1 or less,16,2,2,0,13,2,6,1,4,1,5,2,3,1,1,0,0,0
S01011801,All households,253,75,17,58,169,13,107,36,57,14,49,33,16,9,5,0,0,4
S01011801,Occupancy rating +2 or more,61,24,9,15,35,8,27,22,4,1,0,0,0,2,1,0,0,1
S01011801,Occupancy rating +1,96,34,6,28,61,3,38,14,20,4,20,11,9,1,1,0,0,0
S01011801,Occupancy rating 0,68,10,1,9,55,2,32,0,25,7,21,16,5,3,1,0,0,2
S01011801,Occupancy rating -1 or less,28,7,1,6,18,0,10,0,8,2,8,6,2,3,2,0,0,1
S01011802,All households,361,151,71,80,202,33,109,37,48,24,60,45,15,8,3,0,0,5
S01011802,Occupancy rating +2 or more,98,51,26,25,47,19,24,16,6,2,4,3,1,0,0,0,0,0
S01011802,Occupancy rating +1,138,55,23,32,79,9,54,21,19,14,16,10,6,4,0,0,0,4
S01011802,Occupancy rating 0,104,40,19,21,63,4,23,0,17,6,36,28,8,1,0,0,0,1
S01011802,Occupancy rating -1 or less,21,5,3,2,13,1,8,0,6,2,4,4,0,3,3,0,0,0
S01011803,All households,236,63,26,37,166,20,111,39,48,24,35,23,12,7,1,0,1,5
S01011803,Occupancy rating +2 or more,86,26,12,14,59,14,41,27,11,3,4,2,2,1,0,0,1,0
S01011803,Occupancy rating +1,66,23,9,14,41,5,29,7,11,11,7,3,4,2,0,0,0,2
S01011803,Occupancy rating 0,59,11,3,8,46,1,29,5,15,9,16,12,4,2,0,0,0,2
S01011803,Occupancy rating -1 or less,25,3,2,1,20,0,12,0,11,1,8,6,2,2,1,0,0,1
S01011804,All households,379,165,72,93,197,14,131,72,43,16,52,36,16,17,3,0,0,14
S01011804,Occupancy rating +2 or more,150,65,27,38,82,10,62,45,10,7,10,7,3,3,1,0,0,2
S01011804,Occupancy rating +1,118,56,23,33,55,4,39,20,13,6,12,8,4,7,0,0,0,7
S01011804,Occupancy rating 0,76,24,12,12,50,0,27,4,20,3,23,14,9,2,0,0,0,2
S01011804,Occupancy rating -1 or less,35,20,10,10,10,0,3,3,0,0,7,7,0,5,2,0,0,3
S01011805,All households,279,136,49,87,128,25,87,39,35,13,16,9,7,15,1,2,0,12
S01011805,Occupancy rating +2 or more,134,61,27,34,70,16,51,25,18,8,3,2,1,3,0,0,0,3
S01011805,Occupancy rating +1,78,43,16,27,31,7,20,11,5,4,4,1,3,4,0,0,0,4
S01011805,Occupancy rating 0,40,13,2,11,20,2,14,3,10,1,4,2,2,7,1,2,0,4
S01011805,Occupancy rating -1 or less,27,19,4,15,7,0,2,0,2,0,5,4,1,1,0,0,0,1
S01011806,All households,362,131,59,72,227,43,157,69,68,20,27,19,8,4,1,0,2,1
S01011806,Occupancy rating +2 or more,221,57,28,29,160,38,111,62,36,13,11,7,4,4,1,0,2,1
S01011806,Occupancy rating +1,68,36,17,19,32,4,22,4,16,2,6,3,3,0,0,0,0,0
S01011806,Occupancy rating 0,48,23,10,13,25,1,19,2,13,4,5,5,0,0,0,0,0,0
S01011806,Occupancy rating -1 or less,25,15,4,11,10,0,5,1,3,1,5,4,1,0,0,0,0,0
S01011807,All households,444,114,49,65,314,47,237,101,91,45,30,15,15,16,4,0,4,8
S01011807,Occupancy rating +2 or more,327,84,41,43,230,41,174,86,59,29,15,7,8,13,3,0,4,6
S01011807,Occupancy rating +1,70,16,6,10,53,6,39,13,15,11,8,4,4,1,1,0,0,0
S01011807,Occupancy rating 0,29,9,2,7,19,0,15,2,11,2,4,2,2,1,0,0,0,1
S01011807,Occupancy rating -1 or less,18,5,0,5,12,0,9,0,6,3,3,2,1,1,0,0,0,1
S01011808,All households,287,103,52,51,175,26,124,48,61,15,25,12,13,9,1,0,0,8
S01011808,Occupancy rating +2 or more,158,44,23,21,110,21,84,38,37,9,5,0,5,4,0,0,0,4
S01011808,Occupancy rating +1,67,32,16,16,32,4,21,7,11,3,7,3,4,3,0,0,0,3
S01011808,Occupancy rating 0,50,22,11,11,27,1,14,2,10,2,12,8,4,1,0,0,0,1
S01011808,Occupancy rating -1 or less,12,5,2,3,6,0,5,1,3,1,1,1,0,1,1,0,0,0
S01011809,All households,302,81,38,43,207,23,172,82,62,28,12,7,5,14,4,0,0,10
S01011809,Occupancy rating +2 or more,200,48,27,21,142,18,117,63,36,18,7,3,4,10,2,0,0,8
S01011809,Occupancy rating +1,69,23,8,15,46,3,41,18,14,9,2,1,1,0,0,0,0,0
S01011809,Occupancy rating 0,23,6,2,4,14,2,11,1,9,1,1,1,0,3,2,0,0,1
S01011809,Occupancy rating -1 or less,10,4,1,3,5,0,3,0,3,0,2,2,0,1,0,0,0,1
S01011810,All households,413,124,49,75,275,36,219,101,84,34,20,8,12,14,5,0,2,7
S01011810,Occupancy rating +2 or more,287,82,29,53,198,31,157,76,55,26,10,3,7,7,0,0,2,5
S01011810,Occupancy rating +1,69,25,12,13,42,3,32,15,14,3,7,3,4,2,2,0,0,0
S01011810,Occupancy rating 0,38,9,3,6,27,0,24,9,11,4,3,2,1,2,1,0,0,1
S01011810,Occupancy rating -1 or less,19,8,5,3,8,2,6,1,4,1,0,0,0,3,2,0,0,1
S01011811,All households,436,117,57,60,303,48,234,94,97,43,21,13,8,16,6,0,2,8
S01011811,Occupancy rating +2 or more,320,85,44,41,223,41,175,79,61,35,7,3,4,12,4,0,1,7
S01011811,Occupancy rating +1,71,13,6,7,56,6,44,12,24,8,6,3,3,2,1,0,0,1
S01011811,Occupancy rating 0,32,11,5,6,19,0,13,2,11,0,6,5,1,2,1,0,1,0
S01011811,Occupancy rating -1 or less,13,8,2,6,5,1,2,1,1,0,2,2,0,0,0,0,0,0
S01011812,All households,275,66,40,26,191,23,154,74,61,19,14,10,4,18,7,0,0,11
S01011812,Occupancy rating +2 or more,197,43,27,16,143,18,117,62,39,16,8,5,3,11,4,0,0,7
S01011812,Occupancy rating +1,45,13,9,4,29,4,22,9,11,2,3,2,1,3,0,0,0,3
S01011812,Occupancy rating 0,26,6,2,4,16,1,12,3,8,1,3,3,0,4,3,0,0,1
S01011812,Occupancy rating -1 or less,7,4,2,2,3,0,3,0,3,0,0,0,0,0,0,0,0,0
S01011813,All households,306,66,28,38,229,32,177,80,73,24,20,10,10,11,1,0,1,9
S01011813,Occupancy rating +2 or more,203,36,20,16,161,27,126,62,48,16,8,2,6,6,1,0,1,4
S01011813,Occupancy rating +1,59,22,6,16,33,4,25,9,12,4,4,1,3,4,0,0,0,4
S01011813,Occupancy rating 0,30,5,1,4,24,0,17,3,10,4,7,6,1,1,0,0,0,1
S01011813,Occupancy rating -1 or less,14,3,1,2,11,1,9,6,3,0,1,1,0,0,0,0,0,0
S01011814,All households,297,76,39,37,216,37,162,61,80,21,17,10,7,5,2,0,1,2
S01011814,Occupancy rating +2 or more,208,44,23,21,161,36,116,47,53,16,9,6,3,3,1,0,0,2
S01011814,Occupancy rating +1,55,22,12,10,32,0,29,10,15,4,3,2,1,1,0,0,1,0
S01011814,Occupancy rating 0,27,7,3,4,19,1,15,4,10,1,3,2,1,1,1,0,0,0
S01011814,Occupancy rating -1 or less,7,3,1,2,4,0,2,0,2,0,2,0,2,0,0,0,0,0
S01011815,All households,313,82,28,54,217,27,163,57,87,19,27,21,6,14,9,0,1,4
S01011815,Occupancy rating +2 or more,198,52,24,28,140,20,114,52,50,12,6,5,1,6,3,0,1,2
S01011815,Occupancy rating +1,60,15,3,12,42,6,27,5,17,5,9,6,3,3,2,0,0,1
S01011815,Occupancy rating 0,48,11,1,10,32,1,20,0,18,2,11,9,2,5,4,0,0,1
S01011815,Occupancy rating -1 or less,7,4,0,4,3,0,2,0,2,0,1,1,0,0,0,0,0,0
S01011816,All households,257,59,24,35,190,31,149,63,58,28,10,7,3,8,4,0,0,4
S01011816,Occupancy rating +2 or more,215,47,21,26,161,31,125,58,43,24,5,2,3,7,3,0,0,4
S01011816,Occupancy rating +1,23,4,2,2,18,0,16,3,10,3,2,2,0,1,1,0,0,0
S01011816,Occupancy rating 0,17,7,1,6,10,0,8,2,5,1,2,2,0,0,0,0,0,0
S01011816,Occupancy rating -1 or less,2,1,0,1,1,0,0,0,0,0,1,1,0,0,0,0,0,0
S01011817,All households,294,77,35,42,205,29,165,62,80,23,11,5,6,12,3,0,0,9
S01011817,Occupancy rating +2 or more,217,51,25,26,156,24,122,54,54,14,10,4,6,10,3,0,0,7
S01011817,Occupancy rating +1,43,16,7,9,26,4,21,1,14,6,1,1,0,1,0,0,0,1
S01011817,Occupancy rating 0,24,5,2,3,18,1,17,5,9,3,0,0,0,1,0,0,0,1
S01011817,Occupancy rating -1 or less,10,5,1,4,5,0,5,2,3,0,0,0,0,0,0,0,0,0
S01011818,All households,486,155,65,90,319,50,225,91,102,32,44,36,8,12,2,0,1,9
S01011818,Occupancy rating +2 or more,261,72,37,35,181,32,143,67,57,19,6,5,1,8,2,0,1,5
S01011818,Occupancy rating +1,133,54,21,33,77,16,46,20,19,7,15,13,2,2,0,0,0,2
S01011818,Occupancy rating 0,68,21,6,15,45,1,28,3,19,6,16,12,4,2,0,0,0,2
S01011818,Occupancy rating -1 or less,24,8,1,7,16,1,8,1,7,0,7,6,1,0,0,0,0,0
S01011819,All households,438,185,73,112,231,29,148,77,50,21,54,34,20,22,3,0,1,18
S01011819,Occupancy rating +2 or more,164,66,30,36,95,24,67,48,12,7,4,2,2,3,0,0,0,3
S01011819,Occupancy rating +1,145,69,27,42,71,2,54,27,18,9,15,7,8,5,0,0,1,4
S01011819,Occupancy rating 0,104,36,11,25,56,2,23,2,16,5,31,21,10,12,2,0,0,10
S01011819,Occupancy rating -1 or less,25,14,5,9,9,1,4,0,4,0,4,4,0,2,1,0,0,1
S01011820,All households,319,105,61,44,197,32,135,52,66,17,30,19,11,17,2,0,0,15
S01011820,Occupancy rating +2 or more,175,51,32,19,117,24,81,32,37,12,12,7,5,7,1,0,0,6
S01011820,Occupancy rating +1,75,22,9,13,49,7,31,15,12,4,11,5,6,4,0,0,0,4
S01011820,Occupancy rating 0,51,21,16,5,25,1,19,2,16,1,5,5,0,5,1,0,0,4
S01011820,Occupancy rating -1 or less,18,11,4,7,6,0,4,3,1,0,2,2,0,1,0,0,0,1
S01011821,All households,223,113,27,86,101,10,73,37,31,5,18,13,5,9,1,0,1,7
S01011821,Occupancy rating +2 or more,47,14,3,11,32,5,23,12,9,2,4,2,2,1,1,0,0,0
S01011821,Occupancy rating +1,64,32,10,22,29,4,17,11,6,0,8,6,2,3,0,0,0,3
S01011821,Occupancy rating 0,62,36,10,26,22,1,18,4,11,3,3,2,1,4,0,0,1,3
S01011821,Occupancy rating -1 or less,50,31,4,27,18,0,15,10,5,0,3,3,0,1,0,0,0,1
S01011822,All households,410,226,77,149,158,20,106,55,40,11,32,25,7,26,1,0,1,24
S01011822,Occupancy rating +2 or more,110,44,26,18,60,15,42,25,12,5,3,3,0,6,0,0,1,5
S01011822,Occupancy rating +1,77,37,9,28,35,2,26,15,6,5,7,4,3,5,0,0,0,5
S01011822,Occupancy rating 0,108,59,20,39,43,3,28,11,16,1,12,10,2,6,0,0,0,6
S01011822,Occupancy rating -1 or less,115,86,22,64,20,0,10,4,6,0,10,8,2,9,1,0,0,8
S01011823,All households,290,101,38,63,181,28,119,52,45,22,34,26,8,8,2,0,0,6
S01011823,Occupancy rating +2 or more,138,45,20,25,92,22,67,38,19,10,3,1,2,1,0,0,0,1
S01011823,Occupancy rating +1,75,27,9,18,43,4,31,12,13,6,8,4,4,5,1,0,0,4
S01011823,Occupancy rating 0,55,12,4,8,42,2,18,0,13,5,22,20,2,1,1,0,0,0
S01011823,Occupancy rating -1 or less,22,17,5,12,4,0,3,2,0,1,1,1,0,1,0,0,0,1
S01011824,All households,316,106,43,63,195,10,139,66,60,13,46,29,17,15,4,0,0,11
S01011824,Occupancy rating +2 or more,136,43,18,25,92,7,81,56,18,7,4,3,1,1,1,0,0,0
S01011824,Occupancy rating +1,72,10,4,6,52,0,34,5,24,5,18,12,6,10,0,0,0,10
S01011824,Occupancy rating 0,56,20,8,12,33,0,17,2,14,1,16,10,6,3,2,0,0,1
S01011824,Occupancy rating -1 or less,52,33,13,20,18,3,7,3,4,0,8,4,4,1,1,0,0,0
S01011825,All households,275,110,44,66,157,24,101,55,32,14,32,17,15,8,3,0,0,5
S01011825,Occupancy rating +2 or more,140,49,26,23,88,22,57,36,15,6,9,2,7,3,1,0,0,2
S01011825,Occupancy rating +1,67,24,10,14,41,2,30,16,9,5,9,5,4,2,0,0,0,2
S01011825,Occupancy rating 0,59,30,6,24,27,0,13,2,8,3,14,10,4,2,1,0,0,1
S01011825,Occupancy rating -1 or less,9,7,2,5,1,0,1,1,0,0,0,0,0,1,1,0,0,0
S01011826,All households,320,123,49,74,184,18,144,70,62,12,22,15,7,13,1,0,0,12
S01011826,Occupancy rating +2 or more,165,54,31,23,109,16,88,43,37,8,5,1,4,2,1,0,0,1
S01011826,Occupancy rating +1,60,25,8,17,33,1,29,15,12,2,3,2,1,2,0,0,0,2
S01011826,Occupancy rating 0,55,24,7,17,25,1,18,5,11,2,6,5,1,6,0,0,0,6
S01011826,Occupancy rating -1 or less,40,20,3,17,17,0,9,7,2,0,8,7,1,3,0,0,0,3
S01011827,All households,289,132,59,73,152,34,102,68,22,12,16,6,10,5,2,0,1,2
S01011827,Occupancy rating +2 or more,169,73,34,39,95,25,65,55,7,3,5,2,3,1,1,0,0,0
S01011827,Occupancy rating +1,55,21,8,13,31,7,18,8,5,5,6,3,3,3,0,0,1,2
S01011827,Occupancy rating 0,41,22,12,10,18,1,14,4,8,2,3,1,2,1,1,0,0,0
S01011827,Occupancy rating -1 or less,24,16,5,11,8,1,5,1,2,2,2,0,2,0,0,0,0,0
S01011828,All households,411,133,62,71,262,37,209,105,76,28,16,7,9,16,5,0,4,7
S01011828,Occupancy rating +2 or more,274,77,38,39,185,29,151,90,39,22,5,3,2,12,3,0,4,5
S01011828,Occupancy rating +1,85,27,9,18,55,7,44,11,29,4,4,1,3,3,2,0,0,1
S01011828,Occupancy rating 0,27,11,6,5,16,1,12,4,6,2,3,0,3,0,0,0,0,0
S01011828,Occupancy rating -1 or less,25,18,9,9,6,0,2,0,2,0,4,3,1,1,0,0,0,1
S01011829,All households,195,63,27,36,124,14,102,59,30,13,8,3,5,8,2,0,0,6
S01011829,Occupancy rating +2 or more,137,36,14,22,97,13,79,51,18,10,5,1,4,4,1,0,0,3
S01011829,Occupancy rating +1,28,12,8,4,14,1,12,3,9,0,1,1,0,2,0,0,0,2
S01011829,Occupancy rating 0,20,6,1,5,12,0,10,4,3,3,2,1,1,2,1,0,0,1
S01011829,Occupancy rating -1 or less,10,9,4,5,1,0,1,1,0,0,0,0,0,0,0,0,0,0
S01011830,All households,279,107,46,61,156,26,113,67,34,12,17,11,6,16,5,0,1,10
S01011830,Occupancy rating +2 or more,179,56,18,38,113,21,86,53,21,12,6,5,1,10,4,0,1,5
S01011830,Occupancy rating +1,50,24,12,12,24,5,14,8,6,0,5,2,3,2,1,0,0,1
S01011830,Occupancy rating 0,36,17,11,6,17,0,12,6,6,0,5,4,1,2,0,0,0,2
S01011830,Occupancy rating -1 or less,14,10,5,5,2,0,1,0,1,0,1,0,1,2,0,0,0,2
S01011831,All households,425,155,86,69,253,45,178,94,63,21,30,23,7,17,3,0,5,9
S01011831,Occupancy rating +2 or more,251,88,50,38,155,32,111,68,31,12,12,7,5,8,1,0,2,5
S01011831,Occupancy rating +1,99,32,23,9,59,11,38,18,15,5,10,9,1,8,2,0,3,3
S01011831,Occupancy rating 0,59,27,12,15,32,2,25,8,14,3,5,4,1,0,0,0,0,0
S01011831,Occupancy rating -1 or less,16,8,1,7,7,0,4,0,3,1,3,3,0,1,0,0,0,1
S01011832,All households,405,140,70,70,252,50,177,91,65,21,25,17,8,13,0,0,4,9
S01011832,Occupancy rating +2 or more,263,76,38,38,180,39,130,72,42,16,11,5,6,7,0,0,2,5
S01011832,Occupancy rating +1,77,29,12,17,46,10,30,14,13,3,6,6,0,2,0,0,1,1
S01011832,Occupancy rating 0,40,19,8,11,18,1,11,3,6,2,6,5,1,3,0,0,0,3
S01011832,Occupancy rating -1 or less,25,16,12,4,8,0,6,2,4,0,2,1,1,1,0,0,1,0
S01011833,All households,360,61,33,28,287,47,214,75,106,33,26,14,12,12,6,0,2,4
S01011833,Occupancy rating +2 or more,282,47,28,19,226,43,174,69,84,21,9,5,4,9,5,0,2,2
S01011833,Occupancy rating +1,42,7,3,4,33,3,21,5,9,7,9,4,5,2,1,0,0,1
S01011833,Occupancy rating 0,30,6,1,5,24,0,18,1,13,4,6,3,3,0,0,0,0,0
S01011833,Occupancy rating -1 or less,6,1,1,0,4,1,1,0,0,1,2,2,0,1,0,0,0,1
S01011834,All households,180,22,11,11,155,19,131,48,75,8,5,5,0,3,1,0,1,1
S01011834,Occupancy rating +2 or more,149,12,7,5,135,16,115,43,67,5,4,4,0,2,1,0,0,1
S01011834,Occupancy rating +1,22,8,3,5,14,3,11,4,6,1,0,0,0,0,0,0,0,0
S01011834,Occupancy rating 0,7,1,1,0,6,0,5,1,2,2,1,1,0,0,0,0,0,0
S01011834,Occupancy rating -1 or less,2,1,0,1,0,0,0,0,0,0,0,0,0,1,0,0,1,0
S01011835,All households,278,58,25,33,205,21,169,82,62,25,15,13,2,15,5,0,2,8
S01011835,Occupancy rating +2 or more,214,38,18,20,167,18,141,75,48,18,8,7,1,9,4,0,1,4
S01011835,Occupancy rating +1,41,12,5,7,25,3,16,5,7,4,6,5,1,4,1,0,0,3
S01011835,Occupancy rating 0,16,7,2,5,8,0,7,2,4,1,1,1,0,1,0,0,1,0
S01011835,Occupancy rating -1 or less,7,1,0,1,5,0,5,0,3,2,0,0,0,1,0,0,0,1
S01011836,All households,332,76,35,41,247,43,184,100,58,26,20,13,7,9,2,0,2,5
S01011836,Occupancy rating +2 or more,250,53,27,26,191,35,143,91,35,17,13,7,6,6,1,0,1,4
S01011836,Occupancy rating +1,50,13,3,10,36,8,27,6,15,6,1,1,0,1,0,0,0,1
S01011836,Occupancy rating 0,26,9,5,4,16,0,11,3,5,3,5,4,1,1,1,0,0,0
S01011836,Occupancy rating -1 or less,6,1,0,1,4,0,3,0,3,0,1,1,0,1,0,0,1,0
S01011837,All households,255,44,21,23,206,35,157,74,62,21,14,8,6,5,3,0,0,2
S01011837,Occupancy rating +2 or more,217,37,18,19,176,35,131,68,47,16,10,8,2,4,2,0,0,2
S01011837,Occupancy rating +1,25,4,2,2,21,0,18,5,9,4,3,0,3,0,0,0,0,0
S01011837,Occupancy rating 0,11,3,1,2,7,0,7,1,5,1,0,0,0,1,1,0,0,0
S01011837,Occupancy rating -1 or less,2,0,0,0,2,0,1,0,1,0,1,0,1,0,0,0,0,0
S01011838,All households,327,64,38,26,245,46,182,78,75,29,17,8,9,18,4,1,1,12
S01011838,Occupancy rating +2 or more,258,43,29,14,204,44,149,70,55,24,11,7,4,11,1,0,1,9
S01011838,Occupancy rating +1,40,13,9,4,24,2,21,7,13,1,1,0,1,3,1,0,0,2
S01011838,Occupancy rating 0,20,5,0,5,12,0,9,1,6,2,3,0,3,3,2,0,0,1
S01011838,Occupancy rating -1 or less,9,3,0,3,5,0,3,0,1,2,2,1,1,1,0,1,0,0
S01011839,All households,444,141,74,67,295,49,227,110,88,29,19,9,10,8,2,0,0,6
S01011839,Occupancy rating +2 or more,288,81,46,35,203,34,166,90,56,20,3,0,3,4,1,0,0,3
S01011839,Occupancy rating +1,101,41,22,19,57,13,37,15,18,4,7,2,5,3,0,0,0,3
S01011839,Occupancy rating 0,42,17,6,11,25,1,20,5,11,4,4,2,2,0,0,0,0,0
S01011839,Occupancy rating -1 or less,13,2,0,2,10,1,4,0,3,1,5,5,0,1,1,0,0,0
S01011840,All households,406,100,43,57,290,29,223,93,103,27,38,21,17,16,5,0,1,10
S01011840,Occupancy rating +2 or more,234,51,20,31,180,24,146,76,57,13,10,4,6,3,1,0,0,2
S01011840,Occupancy rating +1,102,42,21,21,56,5,41,17,19,5,10,5,5,4,1,0,0,3
S01011840,Occupancy rating 0,56,5,1,4,44,0,30,0,23,7,14,9,5,7,1,0,1,5
S01011840,Occupancy rating -1 or less,14,2,1,1,10,0,6,0,4,2,4,3,1,2,2,0,0,0
S01011841,All households,415,126,72,54,277,41,183,71,86,26,53,38,15,12,6,0,0,6
S01011841,Occupancy rating +2 or more,201,49,25,24,148,32,110,53,44,13,6,4,2,4,1,0,0,3
S01011841,Occupancy rating +1,91,29,11,18,61,7,42,14,18,10,12,9,3,1,0,0,0,1
S01011841,Occupancy rating 0,103,44,34,10,58,2,27,3,21,3,29,23,6,1,1,0,0,0
S01011841,Occupancy rating -1 or less,20,4,2,2,10,0,4,1,3,0,6,2,4,6,4,0,0,2
S01011842,All households,462,194,99,95,254,38,164,63,71,30,52,33,19,14,4,0,1,9
S01011842,Occupancy rating +2 or more,165,62,30,32,103,22,72,32,27,13,9,4,5,0,0,0,0,0
S01011842,Occupancy rating +1,130,62,29,33,66,8,47,27,13,7,11,6,5,2,0,0,1,1
S01011842,Occupancy rating 0,123,57,32,25,61,8,34,4,21,9,19,14,5,5,3,0,0,2
S01011842,Occupancy rating -1 or less,44,13,8,5,24,0,11,0,10,1,13,9,4,7,1,0,0,6
S01011843,All households,415,100,44,56,297,48,222,111,95,16,27,15,12,18,6,0,0,12
S01011843,Occupancy rating +2 or more,317,73,32,41,234,43,181,101,70,10,10,7,3,10,4,0,0,6
S01011843,Occupancy rating +1,48,15,5,10,29,4,17,6,9,2,8,3,5,4,1,0,0,3
S01011843,Occupancy rating 0,45,11,6,5,30,1,21,4,14,3,8,5,3,4,1,0,0,3
S01011843,Occupancy rating -1 or less,5,1,1,0,4,0,3,0,2,1,1,0,1,0,0,0,0,0
S01011844,All households,295,66,39,27,223,44,164,57,94,13,15,8,7,6,2,0,2,2
S01011844,Occupancy rating +2 or more,236,53,31,22,180,38,132,47,75,10,10,5,5,3,1,0,1,1
S01011844,Occupancy rating +1,36,6,2,4,28,5,20,6,11,3,3,1,2,2,1,0,1,0
S01011844,Occupancy rating 0,17,5,4,1,11,0,9,4,5,0,2,2,0,1,0,0,0,1
S01011844,Occupancy rating -1 or less,6,2,2,0,4,1,3,0,3,0,0,0,0,0,0,0,0,0
S01011845,All households,382,125,66,59,242,39,159,62,81,16,44,31,13,15,4,0,0,11
S01011845,Occupancy rating +2 or more,183,46,29,17,132,32,94,41,43,10,6,4,2,5,1,0,0,4
S01011845,Occupancy rating +1,88,39,22,17,46,3,32,16,14,2,11,8,3,3,0,0,0,3
S01011845,Occupancy rating 0,92,36,13,23,54,3,29,4,21,4,22,15,7,2,1,0,0,1
S01011845,Occupancy rating -1 or less,19,4,2,2,10,1,4,1,3,0,5,4,1,5,2,0,0,3
S01011846,All households,385,107,49,58,267,44,189,82,77,30,34,18,16,11,2,0,0,9
S01011846,Occupancy rating +2 or more,248,47,21,26,197,39,143,68,55,20,15,10,5,4,1,0,0,3
S01011846,Occupancy rating +1,66,32,12,20,31,3,20,11,7,2,8,2,6,3,0,0,0,3
S01011846,Occupancy rating 0,63,27,15,12,33,2,22,3,13,6,9,5,4,3,1,0,0,2
S01011846,Occupancy rating -1 or less,8,1,1,0,6,0,4,0,2,2,2,1,1,1,0,0,0,1
S01011847,All households,178,35,14,21,141,23,111,50,51,10,7,2,5,2,0,0,0,2
S01011847,Occupancy rating +2 or more,137,23,11,12,114,18,91,47,36,8,5,1,4,0,0,0,0,0
S01011847,Occupancy rating +1,28,10,3,7,18,4,14,3,9,2,0,0,0,0,0,0,0,0
S01011847,Occupancy rating 0,9,1,0,1,6,1,4,0,4,0,1,0,1,2,0,0,0,2
S01011847,Occupancy rating -1 or less,4,1,0,1,3,0,2,0,2,0,1,1,0,0,0,0,0,0
S01011848,All households,305,75,37,38,219,37,164,79,67,18,18,9,9,11,4,1,0,6
S01011848,Occupancy rating +2 or more,208,42,22,20,162,32,122,67,42,13,8,5,3,4,1,0,0,3
S01011848,Occupancy rating +1,64,27,14,13,36,5,27,9,13,5,4,0,4,1,0,0,0,1
S01011848,Occupancy rating 0,27,6,1,5,17,0,11,3,8,0,6,4,2,4,2,0,0,2
S01011848,Occupancy rating -1 or less,6,0,0,0,4,0,4,0,4,0,0,0,0,2,1,1,0,0
S01011849,All households,352,106,35,71,228,29,167,71,75,21,32,20,12,18,9,0,2,7
S01011849,Occupancy rating +2 or more,176,40,18,22,132,23,103,56,34,13,6,5,1,4,3,0,1,0
S01011849,Occupancy rating +1,93,38,10,28,51,5,35,7,24,4,11,6,5,4,2,0,0,2
S01011849,Occupancy rating 0,72,26,7,19,38,1,26,8,14,4,11,7,4,8,3,0,1,4
S01011849,Occupancy rating -1 or less,11,2,0,2,7,0,3,0,3,0,4,2,2,2,1,0,0,1
S01011850,All households,314,100,42,58,204,33,149,67,63,19,22,12,10,10,1,0,0,9
S01011850,Occupancy rating +2 or more,215,61,30,31,151,30,108,53,43,12,13,7,6,3,1,0,0,2
S01011850,Occupancy rating +1,58,20,9,11,37,3,27,10,12,5,7,4,3,1,0,0,0,1
S01011850,Occupancy rating 0,33,15,3,12,13,0,11,4,6,1,2,1,1,5,0,0,0,5
S01011850,Occupancy rating -1 or less,8,4,0,4,3,0,3,0,2,1,0,0,0,1,0,0,0,1
S01011851,All households,368,100,44,56,255,35,188,76,81,31,32,15,17,13,5,0,1,7
S01011851,Occupancy rating +2 or more,169,46,23,23,122,21,97,44,35,18,4,1,3,1,1,0,0,0
S01011851,Occupancy rating +1,98,32,13,19,62,8,49,24,18,7,5,2,3,4,2,0,0,2
S01011851,Occupancy rating 0,67,13,6,7,51,5,30,5,20,5,16,7,9,3,0,0,1,2
S01011851,Occupancy rating -1 or less,34,9,2,7,20,1,12,3,8,1,7,5,2,5,2,0,0,3
S01011852,All households,460,174,98,76,260,43,180,67,82,31,37,27,10,26,5,0,2,19
S01011852,Occupancy rating +2 or more,160,37,24,13,119,29,83,35,36,12,7,6,1,4,0,0,0,4
S01011852,Occupancy rating +1,87,38,21,17,45,5,38,19,16,3,2,2,0,4,1,0,2,1
S01011852,Occupancy rating 0,161,84,49,35,68,9,40,8,17,15,19,13,6,9,1,0,0,8
S01011852,Occupancy rating -1 or less,52,15,4,11,28,0,19,5,13,1,9,6,3,9,3,0,0,6
S01011853,All households,304,75,25,50,217,32,145,60,64,21,40,26,14,12,4,0,0,8
S01011853,Occupancy rating +2 or more,157,24,14,10,130,24,101,39,46,16,5,2,3,3,2,0,0,1
S01011853,Occupancy rating +1,62,21,6,15,40,5,24,12,10,2,11,6,5,1,0,0,0,1
S01011853,Occupancy rating 0,56,18,3,15,32,2,13,4,7,2,17,12,5,6,1,0,0,5
S01011853,Occupancy rating -1 or less,29,12,2,10,15,1,7,5,1,1,7,6,1,2,1,0,0,1
S01011854,All households,356,113,66,47,223,62,139,70,50,19,22,13,9,20,5,0,3,12
S01011854,Occupancy rating +2 or more,230,75,52,23,146,49,91,55,25,11,6,4,2,9,2,0,2,5
S01011854,Occupancy rating +1,52,16,8,8,35,7,22,8,8,6,6,3,3,1,1,0,0,0
S01011854,Occupancy rating 0,60,19,5,14,34,6,21,7,13,1,7,5,2,7,2,0,1,4
S01011854,Occupancy rating -1 or less,14,3,1,2,8,0,5,0,4,1,3,1,2,3,0,0,0,3
S01011855,All households,364,99,56,43,249,45,154,53,70,31,50,23,27,16,3,0,0,13
S01011855,Occupancy rating +2 or more,103,21,18,3,79,24,48,24,20,4,7,4,3,3,0,0,0,3
S01011855,Occupancy rating +1,119,44,20,24,71,14,49,20,23,6,8,3,5,4,0,0,0,4
S01011855,Occupancy rating 0,110,33,18,15,71,6,39,6,17,16,26,10,16,6,2,0,0,4
S01011855,Occupancy rating -1 or less,32,1,0,1,28,1,18,3,10,5,9,6,3,3,1,0,0,2
S01011856,All households,309,80,60,20,223,65,147,73,57,17,11,5,6,6,1,0,2,3
S01011856,Occupancy rating +2 or more,261,69,50,19,188,58,123,65,45,13,7,4,3,4,1,0,1,2
S01011856,Occupancy rating +1,32,9,9,0,22,7,14,6,7,1,1,0,1,1,0,0,0,1
S01011856,Occupancy rating 0,13,2,1,1,10,0,7,2,2,3,3,1,2,1,0,0,1,0
S01011856,Occupancy rating -1 or less,3,0,0,0,3,0,3,0,3,0,0,0,0,0,0,0,0,0
S01011857,All households,301,87,47,40,206,38,151,58,72,21,17,6,11,8,2,0,2,4
S01011857,Occupancy rating +2 or more,191,49,29,20,137,29,106,52,41,13,2,1,1,5,2,0,1,2
S01011857,Occupancy rating +1,55,21,10,11,34,4,24,5,15,4,6,3,3,0,0,0,0,0
S01011857,Occupancy rating 0,44,13,8,5,28,5,14,1,10,3,9,2,7,3,0,0,1,2
S01011857,Occupancy rating -1 or less,11,4,0,4,7,0,7,0,6,1,0,0,0,0,0,0,0,0
S01011858,All households,403,115,83,32,284,89,163,75,71,17,32,23,9,4,0,0,2,2
S01011858,Occupancy rating +2 or more,294,84,63,21,207,76,120,61,46,13,11,8,3,3,0,0,1,2
S01011858,Occupancy rating +1,60,22,14,8,38,11,25,10,13,2,2,1,1,0,0,0,0,0
S01011858,Occupancy rating 0,30,5,3,2,24,1,12,4,7,1,11,8,3,1,0,0,1,0
S01011858,Occupancy rating -1 or less,19,4,3,1,15,1,6,0,5,1,8,6,2,0,0,0,0,0
S01011859,All households,446,196,127,69,238,75,140,69,52,19,23,8,15,12,3,0,2,7
S01011859,Occupancy rating +2 or more,211,73,46,27,132,53,73,47,21,5,6,2,4,6,0,0,1,5
S01011859,Occupancy rating +1,108,58,33,25,48,13,32,18,7,7,3,0,3,2,0,0,0,2
S01011859,Occupancy rating 0,100,52,38,14,46,8,26,3,17,6,12,5,7,2,1,0,1,0
S01011859,Occupancy rating -1 or less,27,13,10,3,12,1,9,1,7,1,2,1,1,2,2,0,0,0
S01011860,All households,206,50,21,29,144,21,112,47,49,16,11,9,2,12,4,0,2,6
S01011860,Occupancy rating +2 or more,139,37,18,19,94,18,72,39,24,9,4,3,1,8,4,0,1,3
S01011860,Occupancy rating +1,35,6,2,4,27,2,23,6,11,6,2,2,0,2,0,0,1,1
S01011860,Occupancy rating 0,27,7,1,6,19,0,15,1,13,1,4,4,0,1,0,0,0,1
S01011860,Occupancy rating -1 or less,5,0,0,0,4,1,2,1,1,0,1,0,1,1,0,0,0,1
S01011861,All households,343,111,43,68,222,45,148,77,58,13,29,20,9,10,1,0,2,7
S01011861,Occupancy rating +2 or more,217,62,28,34,150,37,103,64,31,8,10,5,5,5,0,0,2,3
S01011861,Occupancy rating +1,73,31,11,20,40,7,25,8,13,4,8,5,3,2,1,0,0,1
S01011861,Occupancy rating 0,34,13,2,11,20,0,14,2,11,1,6,5,1,1,0,0,0,1
S01011861,Occupancy rating -1 or less,19,5,2,3,12,1,6,3,3,0,5,5,0,2,0,0,0,2
S01011862,All households,425,119,77,42,289,80,198,102,75,21,11,6,5,17,6,1,3,7
S01011862,Occupancy rating +2 or more,318,80,47,33,233,68,157,87,55,15,8,5,3,5,2,0,1,2
S01011862,Occupancy rating +1,54,21,19,2,28,8,19,7,10,2,1,0,1,5,1,0,1,3
S01011862,Occupancy rating 0,39,16,9,7,20,2,17,6,8,3,1,0,1,3,2,0,1,0
S01011862,Occupancy rating -1 or less,14,2,2,0,8,2,5,2,2,1,1,1,0,4,1,1,0,2
S01011863,All households,328,103,56,47,216,54,133,47,61,25,29,18,11,9,2,0,0,7
S01011863,Occupancy rating +2 or more,198,46,34,12,148,42,93,32,44,17,13,6,7,4,1,0,0,3
S01011863,Occupancy rating +1,58,23,6,17,34,7,23,10,8,5,4,3,1,1,1,0,0,0
S01011863,Occupancy rating 0,51,26,15,11,24,4,10,3,4,3,10,8,2,1,0,0,0,1
S01011863,Occupancy rating -1 or less,21,8,1,7,10,1,7,2,5,0,2,1,1,3,0,0,0,3
S01011864,All households,315,76,44,32,233,52,160,78,64,18,21,11,10,6,3,0,0,3
S01011864,Occupancy rating +2 or more,249,56,35,21,191,47,133,72,48,13,11,6,5,2,1,0,0,1
S01011864,Occupancy rating +1,41,12,9,3,27,5,17,4,9,4,5,2,3,2,1,0,0,1
S01011864,Occupancy rating 0,14,2,0,2,11,0,6,0,5,1,5,3,2,1,1,0,0,0
S01011864,Occupancy rating -1 or less,11,6,0,6,4,0,4,2,2,0,0,0,0,1,0,0,0,1
S01011865,All households,291,124,70,54,157,30,106,43,46,17,21,12,9,10,3,1,2,4
S01011865,Occupancy rating +2 or more,136,47,29,18,86,20,63,28,25,10,3,1,2,3,1,0,0,2
S01011865,Occupancy rating +1,72,38,24,14,34,6,23,12,9,2,5,1,4,0,0,0,0,0
S01011865,Occupancy rating 0,66,32,15,17,31,4,18,3,10,5,9,7,2,3,0,0,1,2
S01011865,Occupancy rating -1 or less,17,7,2,5,6,0,2,0,2,0,4,3,1,4,2,1,1,0
S01011866,All households,341,88,55,33,243,41,172,69,86,17,30,18,12,10,3,0,0,7
S01011866,Occupancy rating +2 or more,177,42,30,12,132,33,96,43,47,6,3,1,2,3,0,0,0,3
S01011866,Occupancy rating +1,99,33,18,15,62,6,48,24,15,9,8,3,5,4,2,0,0,2
S01011866,Occupancy rating 0,45,9,4,5,34,2,18,2,15,1,14,10,4,2,0,0,0,2
S01011866,Occupancy rating -1 or less,20,4,3,1,15,0,10,0,9,1,5,4,1,1,1,0,0,0
S01011867,All households,444,167,82,85,258,34,167,60,90,17,57,37,20,19,7,0,1,11
S01011867,Occupancy rating +2 or more,124,30,16,14,89,10,69,29,36,4,10,7,3,5,2,0,0,3
S01011867,Occupancy rating +1,116,48,24,24,65,14,38,20,15,3,13,6,7,3,1,0,1,1
S01011867,Occupancy rating 0,169,80,41,39,83,8,45,8,30,7,30,21,9,6,0,0,0,6
S01011867,Occupancy rating -1 or less,35,9,1,8,21,2,15,3,9,3,4,3,1,5,4,0,0,1
S01011868,All households,416,167,80,87,231,30,164,68,78,18,37,26,11,18,5,0,1,12
S01011868,Occupancy rating +2 or more,156,36,18,18,117,23,88,43,35,10,6,4,2,3,2,0,0,1
S01011868,Occupancy rating +1,113,56,27,29,54,7,41,16,20,5,6,3,3,3,0,0,1,2
S01011868,Occupancy rating 0,115,62,32,30,44,0,28,7,18,3,16,11,5,9,2,0,0,7
S01011868,Occupancy rating -1 or less,32,13,3,10,16,0,7,2,5,0,9,8,1,3,1,0,0,2
S01011869,All households,409,191,73,118,204,29,141,70,57,14,34,17,17,14,1,0,0,13
S01011869,Occupancy rating +2 or more,126,34,18,16,90,13,69,37,22,10,8,2,6,2,0,0,0,2
S01011869,Occupancy rating +1,120,74,25,49,45,8,29,20,8,1,8,5,3,1,0,0,0,1
S01011869,Occupancy rating 0,118,59,24,35,54,8,31,10,18,3,15,9,6,5,0,0,0,5
S01011869,Occupancy rating -1 or less,45,24,6,18,15,0,12,3,9,0,3,1,2,6,1,0,0,5
S01011870,All households,315,106,36,70,198,28,130,55,56,19,40,32,8,11,3,0,3,5
S01011870,Occupancy rating +2 or more,113,29,16,13,81,20,59,34,17,8,2,1,1,3,0,0,2,1
S01011870,Occupancy rating +1,83,22,7,15,61,7,39,14,18,7,15,12,3,0,0,0,0,0
S01011870,Occupancy rating 0,85,40,9,31,40,1,25,6,16,3,14,10,4,5,1,0,1,3
S01011870,Occupancy rating -1 or less,34,15,4,11,16,0,7,1,5,1,9,9,0,3,2,0,0,1
S01011871,All households,438,96,37,59,328,35,250,109,112,29,43,27,16,14,6,0,1,7
S01011871,Occupancy rating +2 or more,233,45,15,30,182,29,142,71,56,15,11,4,7,6,1,0,0,5
S01011871,Occupancy rating +1,123,28,12,16,91,6,68,27,35,6,17,11,6,4,2,0,1,1
S01011871,Occupancy rating 0,70,20,10,10,47,0,34,10,17,7,13,10,3,3,2,0,0,1
S01011871,Occupancy rating -1 or less,12,3,0,3,8,0,6,1,4,1,2,2,0,1,1,0,0,0
S01011872,All households,365,72,25,47,283,40,225,112,97,16,18,11,7,10,5,0,0,5
S01011872,Occupancy rating +2 or more,282,46,20,26,230,38,180,94,75,11,12,8,4,6,4,0,0,2
S01011872,Occupancy rating +1,46,15,1,14,30,2,28,15,12,1,0,0,0,1,0,0,0,1
S01011872,Occupancy rating 0,31,11,4,7,19,0,15,2,9,4,4,2,2,1,0,0,0,1
S01011872,Occupancy rating -1 or less,6,0,0,0,4,0,2,1,1,0,2,1,1,2,1,0,0,1
S01011873,All households,339,76,18,58,250,26,194,99,75,20,30,17,13,13,4,0,2,7
S01011873,Occupancy rating +2 or more,194,34,13,21,153,22,120,63,41,16,11,5,6,7,3,0,1,3
S01011873,Occupancy rating +1,84,27,5,22,54,4,43,27,14,2,7,4,3,3,0,0,1,2
S01011873,Occupancy rating 0,49,14,0,14,33,0,26,8,17,1,7,4,3,2,1,0,0,1
S01011873,Occupancy rating -1 or less,12,1,0,1,10,0,5,1,3,1,5,4,1,1,0,0,0,1
S01011874,All households,285,73,30,43,205,22,157,78,62,17,26,16,10,7,3,0,1,3
S01011874,Occupancy rating +2 or more,160,35,17,18,123,16,103,60,34,9,4,2,2,2,0,0,0,2
S01011874,Occupancy rating +1,57,13,6,7,43,6,34,12,17,5,3,1,2,1,1,0,0,0
S01011874,Occupancy rating 0,53,22,7,15,29,0,14,6,6,2,15,10,5,2,1,0,0,1
S01011874,Occupancy rating -1 or less,15,3,0,3,10,0,6,0,5,1,4,3,1,2,1,0,1,0
S01011875,All households,322,114,69,45,200,44,130,62,48,20,26,14,12,8,2,0,1,5
S01011875,Occupancy rating +2 or more,136,39,26,13,96,30,60,36,22,2,6,4,2,1,0,0,0,1
S01011875,Occupancy rating +1,92,37,23,14,49,8,35,20,9,6,6,5,1,6,1,0,1,4
S01011875,Occupancy rating 0,80,36,19,17,44,6,30,6,15,9,8,3,5,0,0,0,0,0
S01011875,Occupancy rating -1 or less,14,2,1,1,11,0,5,0,2,3,6,2,4,1,1,0,0,0
S01011876,All households,398,111,37,74,277,40,212,83,100,29,25,11,14,10,1,0,1,8
S01011876,Occupancy rating +2 or more,255,53,18,35,196,32,155,65,69,21,9,5,4,6,0,0,1,5
S01011876,Occupancy rating +1,83,36,11,25,45,5,37,14,18,5,3,2,1,2,1,0,0,1
S01011876,Occupancy rating 0,48,19,7,12,27,3,17,4,11,2,7,1,6,2,0,0,0,2
S01011876,Occupancy rating -1 or less,12,3,1,2,9,0,3,0,2,1,6,3,3,0,0,0,0,0
S01011877,All households,262,86,36,50,169,41,107,57,34,16,21,9,12,7,1,0,0,6
S01011877,Occupancy rating +2 or more,119,34,15,19,84,28,50,30,13,7,6,2,4,1,0,0,0,1
S01011877,Occupancy rating +1,90,33,15,18,55,10,37,23,10,4,8,4,4,2,0,0,0,2
S01011877,Occupancy rating 0,36,14,6,8,20,1,14,4,7,3,5,3,2,2,0,0,0,2
S01011877,Occupancy rating -1 or less,17,5,0,5,10,2,6,0,4,2,2,0,2,2,1,0,0,1
S01011878,All households,379,68,36,32,294,51,211,94,86,31,32,24,8,17,7,0,2,8
S01011878,Occupancy rating +2 or more,258,35,19,16,215,41,157,74,61,22,17,14,3,8,4,0,0,4
S01011878,Occupancy rating +1,68,22,10,12,43,10,27,12,11,4,6,4,2,3,1,0,1,1
S01011878,Occupancy rating 0,37,8,6,2,25,0,19,5,9,5,6,3,3,4,2,0,0,2
S01011878,Occupancy rating -1 or less,16,3,1,2,11,0,8,3,5,0,3,3,0,2,0,0,1,1
S01011879,All households,218,54,24,30,158,18,128,47,66,15,12,10,2,6,3,0,2,1
S01011879,Occupancy rating +2 or more,160,34,19,15,121,16,99,43,43,13,6,6,0,5,3,0,1,1
S01011879,Occupancy rating +1,28,12,3,9,15,0,12,2,9,1,3,3,0,1,0,0,1,0
S01011879,Occupancy rating 0,22,6,2,4,16,2,11,2,9,0,3,1,2,0,0,0,0,0
S01011879,Occupancy rating -1 or less,8,2,0,2,6,0,6,0,5,1,0,0,0,0,0,0,0,0
S01011880,All households,241,48,24,24,187,30,149,60,73,16,8,3,5,6,2,0,1,3
S01011880,Occupancy rating +2 or more,156,25,10,15,131,27,101,46,49,6,3,1,2,0,0,0,0,0
S01011880,Occupancy rating +1,46,14,10,4,30,1,28,10,11,7,1,1,0,2,1,0,0,1
S01011880,Occupancy rating 0,34,8,4,4,23,1,18,4,11,3,4,1,3,3,0,0,1,2
S01011880,Occupancy rating -1 or less,5,1,0,1,3,1,2,0,2,0,0,0,0,1,1,0,0,0
S01011881,All households,371,129,68,61,228,28,165,68,86,11,35,31,4,14,5,0,2,7
S01011881,Occupancy rating +2 or more,138,38,23,15,95,15,76,38,33,5,4,3,1,5,1,0,1,3
S01011881,Occupancy rating +1,115,57,34,23,56,9,37,18,16,3,10,8,2,2,0,0,1,1
S01011881,Occupancy rating 0,89,29,7,22,59,1,44,12,30,2,14,14,0,1,0,0,0,1
S01011881,Occupancy rating -1 or less,29,5,4,1,18,3,8,0,7,1,7,6,1,6,4,0,0,2
S01011882,All households,450,153,114,39,288,51,186,81,66,39,51,29,22,9,1,0,2,6
S01011882,Occupancy rating +2 or more,167,49,39,10,116,27,82,51,22,9,7,4,3,2,0,0,1,1
S01011882,Occupancy rating +1,146,56,35,21,85,19,60,20,23,17,6,3,3,5,0,0,1,4
S01011882,Occupancy rating 0,117,45,37,8,72,4,38,9,18,11,30,14,16,0,0,0,0,0
S01011882,Occupancy rating -1 or less,20,3,3,0,15,1,6,1,3,2,8,8,0,2,1,0,0,1
S01011883,All households,439,102,53,49,322,48,247,120,99,28,27,19,8,15,6,0,0,9
S01011883,Occupancy rating +2 or more,271,52,27,25,213,42,162,101,45,16,9,4,5,6,3,0,0,3
S01011883,Occupancy rating +1,93,33,17,16,56,3,47,16,24,7,6,6,0,4,2,0,0,2
S01011883,Occupancy rating 0,68,16,9,7,48,3,35,3,27,5,10,7,3,4,1,0,0,3
S01011883,Occupancy rating -1 or less,7,1,0,1,5,0,3,0,3,0,2,2,0,1,0,0,0,1
S01011884,All households,169,35,15,20,125,10,104,50,38,16,11,3,8,9,3,0,0,6
S01011884,Occupancy rating +2 or more,118,22,9,13,90,9,76,38,25,13,5,1,4,6,2,0,0,4
S01011884,Occupancy rating +1,34,10,5,5,22,0,20,11,7,2,2,2,0,2,0,0,0,2
S01011884,Occupancy rating 0,13,2,1,1,10,1,6,0,5,1,3,0,3,1,1,0,0,0
S01011884,Occupancy rating -1 or less,4,1,0,1,3,0,2,1,1,0,1,0,1,0,0,0,0,0
S01011885,All households,270,45,23,22,217,22,181,81,82,18,14,10,4,8,2,0,2,4
S01011885,Occupancy rating +2 or more,190,28,13,15,157,18,133,69,53,11,6,5,1,5,2,0,1,2
S01011885,Occupancy rating +1,52,11,7,4,41,3,35,8,22,5,3,2,1,0,0,0,0,0
S01011885,Occupancy rating 0,19,5,3,2,12,1,9,3,4,2,2,0,2,2,0,0,1,1
S01011885,Occupancy rating -1 or less,9,1,0,1,7,0,4,1,3,0,3,3,0,1,0,0,0,1
S01011886,All households,368,85,44,41,271,40,188,93,72,23,43,33,10,12,4,1,0,7
S01011886,Occupancy rating +2 or more,229,50,30,20,173,36,128,76,40,12,9,7,2,6,2,0,0,4
S01011886,Occupancy rating +1,66,26,13,13,38,1,29,13,11,5,8,5,3,2,1,0,0,1
S01011886,Occupancy rating 0,49,7,0,7,42,1,23,4,14,5,18,13,5,0,0,0,0,0
S01011886,Occupancy rating -1 or less,24,2,1,1,18,2,8,0,7,1,8,8,0,4,1,1,0,2
S01011887,All households,230,52,35,17,162,13,118,37,54,27,31,17,14,16,7,0,3,6
S01011887,Occupancy rating +2 or more,113,42,28,14,69,11,57,35,18,4,1,1,0,2,1,0,0,1
S01011887,Occupancy rating +1,70,7,6,1,55,1,39,2,21,16,15,6,9,8,2,0,3,3
S01011887,Occupancy rating 0,32,2,1,1,29,1,18,0,11,7,10,7,3,1,1,0,0,0
S01011887,Occupancy rating -1 or less,15,1,0,1,9,0,4,0,4,0,5,3,2,5,3,0,0,2
S01011888,All households,369,110,52,58,236,13,147,44,85,18,76,49,27,23,9,0,0,14
S01011888,Occupancy rating +2 or more,108,34,19,15,73,12,48,28,17,3,13,6,7,1,0,0,0,1
S01011888,Occupancy rating +1,128,52,22,30,70,1,49,13,27,9,20,9,11,6,1,0,0,5
S01011888,Occupancy rating 0,109,20,10,10,80,0,43,3,35,5,37,29,8,9,1,0,0,8
S01011888,Occupancy rating -1 or less,24,4,1,3,13,0,7,0,6,1,6,5,1,7,7,0,0,0
S01011889,All households,430,172,107,65,245,39,179,83,79,17,27,15,12,13,3,0,1,9
S01011889,Occupancy rating +2 or more,211,62,31,31,146,27,114,59,46,9,5,3,2,3,1,0,0,2
S01011889,Occupancy rating +1,105,49,32,17,52,5,44,19,19,6,3,1,2,4,1,0,0,3
S01011889,Occupancy rating 0,97,53,37,16,39,6,19,5,12,2,14,9,5,5,1,0,1,3
S01011889,Occupancy rating -1 or less,17,8,7,1,8,1,2,0,2,0,5,2,3,1,0,0,0,1
S01011890,All households,300,91,36,55,193,24,144,54,72,18,25,10,15,16,7,0,1,8
S01011890,Occupancy rating +2 or more,161,42,16,26,113,17,88,40,37,11,8,3,5,6,1,0,0,5
S01011890,Occupancy rating +1,71,21,12,9,49,3,40,9,25,6,6,2,4,1,0,0,0,1
S01011890,Occupancy rating 0,60,25,7,18,27,4,13,5,7,1,10,5,5,8,5,0,1,2
S01011890,Occupancy rating -1 or less,8,3,1,2,4,0,3,0,3,0,1,0,1,1,1,0,0,0
S01011891,All households,378,177,78,99,180,15,117,50,48,19,48,39,9,21,6,1,0,14
S01011891,Occupancy rating +2 or more,57,15,8,7,39,6,29,15,9,5,4,2,2,3,0,0,0,3
S01011891,Occupancy rating +1,88,36,14,22,51,6,35,23,8,4,10,8,2,1,0,0,0,1
S01011891,Occupancy rating 0,193,111,51,60,71,3,40,12,21,7,28,24,4,11,3,0,0,8
S01011891,Occupancy rating -1 or less,40,15,5,10,19,0,13,0,10,3,6,5,1,6,3,1,0,2
S01011892,All households,503,226,35,191,255,21,195,95,83,17,39,32,7,22,2,3,2,15
S01011892,Occupancy rating +2 or more,137,41,13,28,96,11,82,38,34,10,3,2,1,0,0,0,0,0
S01011892,Occupancy rating +1,178,106,17,89,69,7,52,34,14,4,10,8,2,3,1,0,0,2
S01011892,Occupancy rating 0,146,70,3,67,66,3,46,19,25,2,17,16,1,10,1,1,0,8
S01011892,Occupancy rating -1 or less,42,9,2,7,24,0,15,4,10,1,9,6,3,9,0,2,2,5
S01011893,All households,500,210,70,140,273,36,190,114,64,12,47,35,12,17,2,1,2,12
S01011893,Occupancy rating +2 or more,138,35,17,18,103,25,73,44,23,6,5,2,3,0,0,0,0,0
S01011893,Occupancy rating +1,174,92,29,63,81,8,69,49,17,3,4,4,0,1,0,0,0,1
S01011893,Occupancy rating 0,141,61,20,41,68,3,38,17,19,2,27,19,8,12,0,0,2,10
S01011893,Occupancy rating -1 or less,47,22,4,18,21,0,10,4,5,1,11,10,1,4,2,1,0,1
S01011894,All households,291,108,36,72,160,19,118,44,54,20,23,11,12,23,5,3,0,15
S01011894,Occupancy rating +2 or more,123,47,24,23,73,13,58,30,21,7,2,0,2,3,1,1,0,1
S01011894,Occupancy rating +1,72,29,9,20,36,4,24,7,11,6,8,3,5,7,1,1,0,5
S01011894,Occupancy rating 0,65,24,3,21,32,1,24,5,16,3,7,3,4,9,2,1,0,6
S01011894,Occupancy rating -1 or less,31,8,0,8,19,1,12,2,6,4,6,5,1,4,1,0,0,3
S01011895,All households,305,99,52,47,197,57,127,67,51,9,13,6,7,9,2,0,0,7
S01011895,Occupancy rating +2 or more,212,57,36,21,151,45,101,54,38,9,5,1,4,4,0,0,0,4
S01011895,Occupancy rating +1,53,25,9,16,26,7,16,9,7,0,3,2,1,2,2,0,0,0
S01011895,Occupancy rating 0,35,15,6,9,18,5,8,4,4,0,5,3,2,2,0,0,0,2
S01011895,Occupancy rating -1 or less,5,2,1,1,2,0,2,0,2,0,0,0,0,1,0,0,0,1
S01011896,All households,421,165,81,84,245,48,174,80,72,22,23,14,9,11,2,0,0,9
S01011896,Occupancy rating +2 or more,195,50,34,16,143,35,101,51,36,14,7,4,3,2,1,0,0,1
S01011896,Occupancy rating +1,142,85,40,45,55,11,37,25,10,2,7,3,4,2,0,0,0,2
S01011896,Occupancy rating 0,71,28,7,21,38,2,30,3,21,6,6,4,2,5,0,0,0,5
S01011896,Occupancy rating -1 or less,13,2,0,2,9,0,6,1,5,0,3,3,0,2,1,0,0,1
S01011897,All households,436,119,75,44,305,54,217,90,98,29,34,21,13,12,5,0,1,6
S01011897,Occupancy rating +2 or more,264,70,51,19,189,38,142,75,51,16,9,6,3,5,2,0,1,2
S01011897,Occupancy rating +1,110,39,18,21,70,13,45,15,24,6,12,7,5,1,0,0,0,1
S01011897,Occupancy rating 0,55,9,6,3,43,3,28,0,21,7,12,8,4,3,1,0,0,2
S01011897,Occupancy rating -1 or less,7,1,0,1,3,0,2,0,2,0,1,0,1,3,2,0,0,1
S01011898,All households,246,38,17,21,198,25,159,56,86,17,14,10,4,10,5,0,2,3
S01011898,Occupancy rating +2 or more,211,24,15,9,177,25,143,48,79,16,9,6,3,10,5,0,2,3
S01011898,Occupancy rating +1,24,9,2,7,15,0,13,8,4,1,2,1,1,0,0,0,0,0
S01011898,Occupancy rating 0,10,4,0,4,6,0,3,0,3,0,3,3,0,0,0,0,0,0
S01011898,Occupancy rating -1 or less,1,1,0,1,0,0,0,0,0,0,0,0,0,0,0,0,0,0
S01011899,All households,352,97,55,42,251,59,180,84,70,26,12,5,7,4,3,0,0,1
S01011899,Occupancy rating +2 or more,227,57,34,23,169,52,113,67,34,12,4,1,3,1,1,0,0,0
S01011899,Occupancy rating +1,96,36,21,15,60,7,48,16,21,11,5,2,3,0,0,0,0,0
S01011899,Occupancy rating 0,26,4,0,4,19,0,17,1,13,3,2,1,1,3,2,0,0,1
S01011899,Occupancy rating -1 or less,3,0,0,0,3,0,2,0,2,0,1,1,0,0,0,0,0,0
S01011900,All households,293,57,32,25,229,43,161,56,70,35,25,16,9,7,3,0,0,4
S01011900,Occupancy rating +2 or more,235,47,27,20,182,39,128,52,54,22,15,9,6,6,2,0,0,4
S01011900,Occupancy rating +1,47,9,5,4,38,4,26,4,11,11,8,6,2,0,0,0,0,0
S01011900,Occupancy rating 0,7,1,0,1,6,0,4,0,3,1,2,1,1,0,0,0,0,0
S01011900,Occupancy rating -1 or less,4,0,0,0,3,0,3,0,2,1,0,0,0,1,1,0,0,0
S01011901,All households,397,123,44,79,257,49,182,77,81,24,26,16,10,17,4,0,2,11
S01011901,Occupancy rating +2 or more,233,55,29,26,170,39,120,47,58,15,11,4,7,8,1,0,1,6
S01011901,Occupancy rating +1,102,46,12,34,54,10,41,24,10,7,3,2,1,2,1,0,0,1
S01011901,Occupancy rating 0,50,18,2,16,27,0,16,5,9,2,11,10,1,5,1,0,1,3
S01011901,Occupancy rating -1 or less,12,4,1,3,6,0,5,1,4,0,1,0,1,2,1,0,0,1
S01011902,All households,465,125,84,41,325,76,220,97,90,33,29,9,20,15,5,2,2,6
S01011902,Occupancy rating +2 or more,338,82,54,28,246,71,162,85,58,19,13,4,9,10,3,1,1,5
S01011902,Occupancy rating +1,85,37,26,11,47,4,35,10,19,6,8,3,5,1,1,0,0,0
S01011902,Occupancy rating 0,31,5,3,2,24,1,16,1,8,7,7,2,5,2,0,1,1,0
S01011902,Occupancy rating -1 or less,11,1,1,0,8,0,7,1,5,1,1,0,1,2,1,0,0,1
S01011903,All households,352,90,68,22,251,56,182,85,65,32,13,6,7,11,3,0,2,6
S01011903,Occupancy rating +2 or more,268,66,52,14,194,45,139,77,43,19,10,4,6,8,1,0,2,5
S01011903,Occupancy rating +1,65,22,15,7,42,9,32,6,15,11,1,1,0,1,0,0,0,1
S01011903,Occupancy rating 0,16,1,0,1,14,2,10,2,6,2,2,1,1,1,1,0,0,0
S01011903,Occupancy rating -1 or less,3,1,1,0,1,0,1,0,1,0,0,0,0,1,1,0,0,0
S01011904,All households,324,77,49,28,237,50,170,81,65,24,17,12,5,10,3,0,0,7
S01011904,Occupancy rating +2 or more,218,41,27,14,174,39,127,72,40,15,8,5,3,3,0,0,0,3
S01011904,Occupancy rating +1,80,30,17,13,46,10,30,8,16,6,6,5,1,4,1,0,0,3
S01011904,Occupancy rating 0,20,4,4,0,15,1,11,1,8,2,3,2,1,1,1,0,0,0
S01011904,Occupancy rating -1 or less,6,2,1,1,2,0,2,0,1,1,0,0,0,2,1,0,0,1
S01011905,All households,280,37,25,12,233,32,179,51,100,28,22,14,8,10,6,0,0,4
S01011905,Occupancy rating +2 or more,230,23,18,5,202,28,159,46,89,24,15,9,6,5,3,0,0,2
S01011905,Occupancy rating +1,28,9,3,6,18,4,12,4,5,3,2,1,1,1,0,0,0,1
S01011905,Occupancy rating 0,11,3,2,1,7,0,3,0,3,0,4,3,1,1,1,0,0,0
S01011905,Occupancy rating -1 or less,11,2,2,0,6,0,5,1,3,1,1,1,0,3,2,0,0,1
S01011906,All households,201,56,25,31,140,28,103,63,34,6,9,5,4,5,1,0,0,4
S01011906,Occupancy rating +2 or more,119,27,11,16,91,21,69,48,19,2,1,1,0,1,0,0,0,1
S01011906,Occupancy rating +1,59,25,11,14,32,7,23,13,7,3,2,2,0,2,0,0,0,2
S01011906,Occupancy rating 0,19,4,3,1,14,0,9,1,7,1,5,2,3,1,1,0,0,0
S01011906,Occupancy rating -1 or less,4,0,0,0,3,0,2,1,1,0,1,0,1,1,0,0,0,1
S01011907,All households,338,101,36,65,228,31,171,81,63,27,26,18,8,9,4,0,0,5
S01011907,Occupancy rating +2 or more,173,46,21,25,123,24,97,59,26,12,2,1,1,4,1,0,0,3
S01011907,Occupancy rating +1,110,39,12,27,70,7,53,18,25,10,10,6,4,1,0,0,0,1
S01011907,Occupancy rating 0,46,15,2,13,29,0,19,4,11,4,10,8,2,2,1,0,0,1
S01011907,Occupancy rating -1 or less,9,1,1,0,6,0,2,0,1,1,4,3,1,2,2,0,0,0
S01011908,All households,147,25,7,18,117,10,92,44,36,12,15,12,3,5,5,0,0,0
S01011908,Occupancy rating +2 or more,65,15,3,12,50,6,41,28,9,4,3,3,0,0,0,0,0,0
S01011908,Occupancy rating +1,56,8,4,4,48,4,37,15,19,3,7,6,1,0,0,0,0,0
S01011908,Occupancy rating 0,22,1,0,1,17,0,12,1,8,3,5,3,2,4,4,0,0,0
S01011908,Occupancy rating -1 or less,4,1,0,1,2,0,2,0,0,2,0,0,0,1,1,0,0,0
S01011909,All households,404,78,9,69,308,4,268,101,143,24,36,25,11,18,6,0,0,12
S01011909,Occupancy rating +2 or more,183,32,5,27,147,2,138,67,62,9,7,4,3,4,2,0,0,2
S01011909,Occupancy rating +1,137,30,2,28,101,2,85,26,47,12,14,9,5,6,1,0,0,5
S01011909,Occupancy rating 0,68,11,2,9,52,0,37,5,29,3,15,12,3,5,0,0,0,5
S01011909,Occupancy rating -1 or less,16,5,0,5,8,0,8,3,5,0,0,0,0,3,3,0,0,0
S01011910,All households,464,201,65,136,246,16,140,66,55,19,90,74,16,17,9,0,0,8
S01011910,Occupancy rating +2 or more,41,24,8,16,16,2,12,9,2,1,2,2,0,1,0,0,0,1
S01011910,Occupancy rating +1,162,94,31,63,67,10,50,44,6,0,7,6,1,1,0,0,0,1
S01011910,Occupancy rating 0,212,75,24,51,126,4,55,9,30,16,67,56,11,11,5,0,0,6
S01011910,Occupancy rating -1 or less,49,8,2,6,37,0,23,4,17,2,14,10,4,4,4,0,0,0
S01011911,All households,285,89,48,41,186,25,120,44,51,25,41,18,23,10,2,0,0,8
S01011911,Occupancy rating +2 or more,76,34,19,15,41,12,27,20,3,4,2,1,1,1,0,0,0,1
S01011911,Occupancy rating +1,105,32,16,16,71,6,51,20,19,12,14,5,9,2,0,0,0,2
S01011911,Occupancy rating 0,89,21,12,9,63,7,37,4,26,7,19,9,10,5,1,0,0,4
S01011911,Occupancy rating -1 or less,15,2,1,1,11,0,5,0,3,2,6,3,3,2,1,0,0,1
S01011912,All households,327,107,49,58,198,19,118,42,54,22,61,43,18,22,8,0,1,13
S01011912,Occupancy rating +2 or more,52,24,13,11,27,7,20,15,5,0,0,0,0,1,0,0,1,0
S01011912,Occupancy rating +1,118,60,23,37,56,9,36,23,9,4,11,5,6,2,0,0,0,2
S01011912,Occupancy rating 0,117,21,12,9,87,2,40,4,25,11,45,35,10,9,4,0,0,5
S01011912,Occupancy rating -1 or less,40,2,1,1,28,1,22,0,15,7,5,3,2,10,4,0,0,6
S01011913,All households,365,143,48,95,211,15,135,63,54,18,61,49,12,11,7,0,0,4
S01011913,Occupancy rating +2 or more,59,20,8,12,38,9,29,27,0,2,0,0,0,1,0,0,0,1
S01011913,Occupancy rating +1,120,66,15,51,52,2,43,23,11,9,7,6,1,2,1,0,0,1
S01011913,Occupancy rating 0,145,52,23,29,89,4,49,12,32,5,36,28,8,4,2,0,0,2
S01011913,Occupancy rating -1 or less,41,5,2,3,32,0,14,1,11,2,18,15,3,4,4,0,0,0
S01011914,All households,360,102,34,68,235,10,127,35,83,9,98,75,23,23,8,0,1,14
S01011914,Occupancy rating +2 or more,59,36,15,21,22,5,15,12,3,0,2,1,1,1,0,0,0,1
S01011914,Occupancy rating +1,108,51,11,40,52,4,32,21,9,2,16,10,6,5,1,0,0,4
S01011914,Occupancy rating 0,142,12,6,6,119,0,57,2,50,5,62,48,14,11,1,0,1,9
S01011914,Occupancy rating -1 or less,51,3,2,1,42,1,23,0,21,2,18,16,2,6,6,0,0,0
S01011915,All households,337,99,52,47,221,16,153,56,61,36,52,30,22,17,3,2,0,12
S01011915,Occupancy rating +2 or more,104,43,27,16,61,11,46,41,0,5,4,3,1,0,0,0,0,0
S01011915,Occupancy rating +1,100,19,7,12,75,1,56,9,29,18,18,6,12,6,0,1,0,5
S01011915,Occupancy rating 0,108,34,17,17,66,4,38,6,21,11,24,19,5,8,2,1,0,5
S01011915,Occupancy rating -1 or less,25,3,1,2,19,0,13,0,11,2,6,2,4,3,1,0,0,2
S01011916,All households,232,61,29,32,157,16,104,29,54,21,37,24,13,14,6,0,0,8
S01011916,Occupancy rating +2 or more,65,29,15,14,36,7,28,22,5,1,1,0,1,0,0,0,0,0
S01011916,Occupancy rating +1,83,26,10,16,52,8,32,7,15,10,12,6,6,5,1,0,0,4
S01011916,Occupancy rating 0,59,5,4,1,51,1,33,0,25,8,17,11,6,3,1,0,0,2
S01011916,Occupancy rating -1 or less,25,1,0,1,18,0,11,0,9,2,7,7,0,6,4,0,0,2
S01011917,All households,232,73,34,39,142,17,85,38,28,19,40,28,12,17,8,0,1,8
S01011917,Occupancy rating +2 or more,40,17,8,9,22,5,15,13,2,0,2,2,0,1,0,0,0,1
S01011917,Occupancy rating +1,105,51,24,27,50,10,34,25,4,5,6,3,3,4,0,0,1,3
S01011917,Occupancy rating 0,63,2,1,1,57,2,29,0,17,12,26,18,8,4,2,0,0,2
S01011917,Occupancy rating -1 or less,24,3,1,2,13,0,7,0,5,2,6,5,1,8,6,0,0,2
S01011918,All households,368,158,38,120,195,8,115,35,61,19,72,56,16,15,8,0,0,7
S01011918,Occupancy rating +2 or more,56,19,6,13,36,3,26,17,7,2,7,4,3,1,1,0,0,0
S01011918,Occupancy rating +1,116,63,11,52,51,3,33,12,13,8,15,9,6,2,0,0,0,2
S01011918,Occupancy rating 0,157,66,18,48,85,2,48,5,34,9,35,30,5,6,4,0,0,2
S01011918,Occupancy rating -1 or less,39,10,3,7,23,0,8,1,7,0,15,13,2,6,3,0,0,3
S01011919,All households,390,142,32,110,220,18,153,82,52,19,49,38,11,28,10,3,0,15
S01011919,Occupancy rating +2 or more,87,33,17,16,52,11,38,27,5,6,3,2,1,2,0,1,0,1
S01011919,Occupancy rating +1,115,49,7,42,61,5,50,31,13,6,6,6,0,5,1,0,0,4
S01011919,Occupancy rating 0,137,47,5,42,80,2,50,19,25,6,28,21,7,10,1,1,0,8
S01011919,Occupancy rating -1 or less,51,13,3,10,27,0,15,5,9,1,12,9,3,11,8,1,0,2
S01011920,All households,291,106,41,65,164,21,97,44,30,23,46,31,15,21,6,1,0,14
S01011920,Occupancy rating +2 or more,81,38,17,21,39,9,25,21,2,2,5,2,3,4,1,1,0,2
S01011920,Occupancy rating +1,97,39,15,24,53,8,38,17,10,11,7,4,3,5,0,0,0,5
S01011920,Occupancy rating 0,83,27,8,19,50,2,20,4,11,5,28,21,7,6,1,0,0,5
S01011920,Occupancy rating -1 or less,30,2,1,1,22,2,14,2,7,5,6,4,2,6,4,0,0,2
S01011921,All households,285,103,45,58,166,16,87,40,34,13,63,52,11,16,6,0,1,9
S01011921,Occupancy rating +2 or more,59,27,7,20,30,3,26,18,7,1,1,1,0,2,1,0,0,1
S01011921,Occupancy rating +1,96,46,20,26,46,13,22,12,6,4,11,5,6,4,0,0,0,4
S01011921,Occupancy rating 0,100,25,16,9,70,0,31,9,18,4,39,35,4,5,3,0,0,2
S01011921,Occupancy rating -1 or less,30,5,2,3,20,0,8,1,3,4,12,11,1,5,2,0,1,2
S01011922,All households,356,120,37,83,225,20,140,55,58,27,65,40,25,11,4,0,0,7
S01011922,Occupancy rating +2 or more,86,30,19,11,54,16,36,29,5,2,2,0,2,2,1,0,0,1
S01011922,Occupancy rating +1,96,30,11,19,64,3,46,17,13,16,15,5,10,2,0,0,0,2
S01011922,Occupancy rating 0,142,60,7,53,79,1,45,8,28,9,33,27,6,3,0,0,0,3
S01011922,Occupancy rating -1 or less,32,0,0,0,28,0,13,1,12,0,15,8,7,4,3,0,0,1
S01011923,All households,383,127,40,87,232,12,150,56,82,12,70,46,24,24,12,0,0,12
S01011923,Occupancy rating +2 or more,78,25,7,18,51,4,39,29,7,3,8,4,4,2,1,0,0,1
S01011923,Occupancy rating +1,116,44,10,34,69,5,50,24,22,4,14,7,7,3,1,0,0,2
S01011923,Occupancy rating 0,141,44,18,26,89,3,47,3,39,5,39,28,11,8,3,0,0,5
S01011923,Occupancy rating -1 or less,48,14,5,9,23,0,14,0,14,0,9,7,2,11,7,0,0,4
S01011924,All households,206,69,27,42,130,20,83,28,40,15,27,23,4,7,4,0,0,3
S01011924,Occupancy rating +2 or more,41,8,1,7,33,12,18,11,4,3,3,3,0,0,0,0,0,0
S01011924,Occupancy rating +1,78,33,17,16,45,7,30,13,11,6,8,5,3,0,0,0,0,0
S01011924,Occupancy rating 0,73,24,9,15,46,1,32,4,22,6,13,13,0,3,1,0,0,2
S01011924,Occupancy rating -1 or less,14,4,0,4,6,0,3,0,3,0,3,2,1,4,3,0,0,1
S01011925,All households,264,46,4,42,203,4,180,52,107,21,19,15,4,15,5,1,0,9
S01011925,Occupancy rating +2 or more,163,24,4,20,131,2,121,40,66,15,8,5,3,8,3,1,0,4
S01011925,Occupancy rating +1,64,18,0,18,45,2,40,10,26,4,3,2,1,1,0,0,0,1
S01011925,Occupancy rating 0,28,4,0,4,21,0,14,1,12,1,7,7,0,3,0,0,0,3
S01011925,Occupancy rating -1 or less,9,0,0,0,6,0,5,1,3,1,1,1,0,3,2,0,0,1
S01011926,All households,298,97,36,61,188,15,120,55,51,14,53,34,19,13,5,0,1,7
S01011926,Occupancy rating +2 or more,76,27,11,16,47,6,40,33,3,4,1,0,1,2,0,0,1,1
S01011926,Occupancy rating +1,104,37,9,28,65,7,42,17,20,5,16,8,8,2,1,0,0,1
S01011926,Occupancy rating 0,91,27,13,14,60,1,32,5,23,4,27,20,7,4,2,0,0,2
S01011926,Occupancy rating -1 or less,27,6,3,3,16,1,6,0,5,1,9,6,3,5,2,0,0,3
S01011927,All households,285,95,34,61,180,17,109,48,42,19,54,41,13,10,6,0,2,2
S01011927,Occupancy rating +2 or more,54,17,3,14,35,8,23,15,7,1,4,2,2,2,1,0,0,1
S01011927,Occupancy rating +1,90,38,16,22,52,7,38,24,10,4,7,5,2,0,0,0,0,0
S01011927,Occupancy rating 0,114,37,12,25,74,1,36,6,17,13,37,28,9,3,2,0,1,0
S01011927,Occupancy rating -1 or less,27,3,3,0,19,1,12,3,8,1,6,6,0,5,3,0,1,1
S01011928,All households,338,117,47,70,209,22,145,81,38,26,42,23,19,12,6,0,0,6
S01011928,Occupancy rating +2 or more,103,30,14,16,72,13,55,44,5,6,4,1,3,1,1,0,0,0
S01011928,Occupancy rating +1,110,41,12,29,68,8,53,31,14,8,7,4,3,1,0,0,0,1
S01011928,Occupancy rating 0,101,43,18,25,54,1,30,6,15,9,23,14,9,4,2,0,0,2
S01011928,Occupancy rating -1 or less,24,3,3,0,15,0,7,0,4,3,8,4,4,6,3,0,0,3
S01011929,All households,319,117,68,49,183,22,115,46,50,19,46,21,25,19,5,0,0,14
S01011929,Occupancy rating +2 or more,72,22,9,13,49,13,30,26,4,0,6,3,3,1,0,0,0,1
S01011929,Occupancy rating +1,77,29,8,21,43,3,31,11,13,7,9,4,5,5,0,0,0,5
S01011929,Occupancy rating 0,144,59,46,13,76,6,45,7,27,11,25,10,15,9,5,0,0,4
S01011929,Occupancy rating -1 or less,26,7,5,2,15,0,9,2,6,1,6,4,2,4,0,0,0,4
S01011930,All households,294,100,45,55,178,19,111,56,46,9,48,35,13,16,5,0,0,11
S01011930,Occupancy rating +2 or more,111,40,23,17,71,16,51,42,8,1,4,3,1,0,0,0,0,0
S01011930,Occupancy rating +1,72,23,7,16,47,2,28,7,16,5,17,12,5,2,1,0,0,1
S01011930,Occupancy rating 0,92,35,15,20,46,0,25,7,17,1,21,17,4,11,3,0,0,8
S01011930,Occupancy rating -1 or less,19,2,0,2,14,1,7,0,5,2,6,3,3,3,1,0,0,2
S01011931,All households,250,76,22,54,156,6,96,29,45,22,54,36,18,18,6,0,1,11
S01011931,Occupancy rating +2 or more,84,40,10,30,44,3,31,18,6,7,10,7,3,0,0,0,0,0
S01011931,Occupancy rating +1,84,24,7,17,57,3,31,7,18,6,23,13,10,3,1,0,0,2
S01011931,Occupancy rating 0,53,9,5,4,35,0,23,3,14,6,12,8,4,9,3,0,1,5
S01011931,Occupancy rating -1 or less,29,3,0,3,20,0,11,1,7,3,9,8,1,6,2,0,0,4
S01011932,All households,300,102,12,90,174,5,130,67,50,13,39,27,12,24,4,4,0,16
S01011932,Occupancy rating +2 or more,36,18,3,15,18,4,14,11,1,2,0,0,0,0,0,0,0,0
S01011932,Occupancy rating +1,116,45,3,42,70,1,63,48,13,2,6,1,5,1,0,0,0,1
S01011932,Occupancy rating 0,125,33,4,29,75,0,48,7,32,9,27,21,6,17,1,2,0,14
S01011932,Occupancy rating -1 or less,23,6,2,4,11,0,5,1,4,0,6,5,1,6,3,2,0,1
S01011933,All households,344,164,35,129,150,16,109,58,34,17,25,12,13,30,8,6,0,16
S01011933,Occupancy rating +2 or more,75,31,10,21,43,13,28,18,7,3,2,2,0,1,1,0,0,0
S01011933,Occupancy rating +1,121,59,11,48,56,2,45,29,8,8,9,3,6,6,0,2,0,4
S01011933,Occupancy rating 0,105,57,12,45,38,1,26,9,11,6,11,6,5,10,3,2,0,5
S01011933,Occupancy rating -1 or less,43,17,2,15,13,0,10,2,8,0,3,1,2,13,4,2,0,7
S01011934,All households,520,181,78,103,294,41,206,104,80,22,47,31,16,45,6,19,1,19
S01011934,Occupancy rating +2 or more,150,43,22,21,102,18,79,52,20,7,5,1,4,5,1,2,0,2
S01011934,Occupancy rating +1,210,104,39,65,102,20,66,45,16,5,16,9,7,4,0,0,1,3
S01011934,Occupancy rating 0,117,28,13,15,67,3,49,7,34,8,15,12,3,22,0,13,0,9
S01011934,Occupancy rating -1 or less,43,6,4,2,23,0,12,0,10,2,11,9,2,14,5,4,0,5
S01011935,All households,459,238,61,177,172,18,120,73,37,10,34,23,11,49,3,12,0,34
S01011935,Occupancy rating +2 or more,77,33,24,9,38,7,29,19,7,3,2,1,1,6,0,0,0,6
S01011935,Occupancy rating +1,121,79,23,56,38,8,28,26,2,0,2,1,1,4,1,2,0,1
S01011935,Occupancy rating 0,149,74,11,63,61,2,43,23,15,5,16,10,6,14,0,4,0,10
S01011935,Occupancy rating -1 or less,112,52,3,49,35,1,20,5,13,2,14,11,3,25,2,6,0,17
S01011936,All households,380,190,39,151,159,17,106,55,42,9,36,18,18,31,1,6,2,22
S01011936,Occupancy rating +2 or more,109,47,19,28,59,16,38,21,13,4,5,1,4,3,0,0,1,2
S01011936,Occupancy rating +1,92,56,10,46,34,1,29,16,12,1,4,1,3,2,0,0,0,2
S01011936,Occupancy rating 0,122,54,6,48,49,0,27,13,10,4,22,13,9,19,1,4,0,14
S01011936,Occupancy rating -1 or less,57,33,4,29,17,0,12,5,7,0,5,3,2,7,0,2,1,4
S01011937,All households,408,214,66,148,143,20,89,65,18,6,34,25,9,51,4,8,1,38
S01011937,Occupancy rating +2 or more,18,8,3,5,9,1,8,5,1,2,0,0,0,1,0,0,0,1
S01011937,Occupancy rating +1,103,54,8,46,47,8,38,36,2,0,1,0,1,2,0,0,0,2
S01011937,Occupancy rating 0,194,103,32,71,64,10,31,18,11,2,23,18,5,27,0,3,1,23
S01011937,Occupancy rating -1 or less,93,49,23,26,23,1,12,6,4,2,10,7,3,21,4,5,0,12
S01011938,All households,400,209,67,142,175,31,110,73,32,5,34,21,13,16,3,1,1,11
S01011938,Occupancy rating +2 or more,91,32,19,13,56,12,39,30,9,0,5,2,3,3,0,0,0,3
S01011938,Occupancy rating +1,142,85,28,57,55,16,35,26,6,3,4,3,1,2,0,0,0,2
S01011938,Occupancy rating 0,133,74,18,56,53,3,31,16,13,2,19,13,6,6,2,1,0,3
S01011938,Occupancy rating -1 or less,34,18,2,16,11,0,5,1,4,0,6,3,3,5,1,0,1,3
S01011939,All households,446,261,27,234,139,11,95,63,28,4,33,25,8,46,1,10,2,33
S01011939,Occupancy rating +2 or more,56,18,5,13,37,5,32,21,10,1,0,0,0,1,0,0,0,1
S01011939,Occupancy rating +1,123,83,7,76,34,4,25,18,6,1,5,4,1,6,0,3,0,3
S01011939,Occupancy rating 0,178,105,10,95,50,2,29,17,10,2,19,12,7,23,0,4,1,18
S01011939,Occupancy rating -1 or less,89,55,5,50,18,0,9,7,2,0,9,9,0,16,1,3,1,11
S01011940,All households,266,144,39,105,100,7,63,38,21,4,30,22,8,22,4,2,0,16
S01011940,Occupancy rating +2 or more,17,5,0,5,12,1,11,7,2,2,0,0,0,0,0,0,0,0
S01011940,Occupancy rating +1,64,36,8,28,26,3,19,19,0,0,4,3,1,2,0,1,0,1
S01011940,Occupancy rating 0,139,82,27,55,46,1,24,11,11,2,21,15,6,11,0,1,0,10
S01011940,Occupancy rating -1 or less,46,21,4,17,16,2,9,1,8,0,5,4,1,9,4,0,0,5
S01011941,All households,441,261,28,233,136,3,103,77,21,5,30,23,7,44,1,3,1,39
S01011941,Occupancy rating +2 or more,30,20,4,16,9,1,6,5,1,0,2,1,1,1,0,0,0,1
S01011941,Occupancy rating +1,101,52,7,45,43,2,37,30,5,2,4,2,2,6,0,0,0,6
S01011941,Occupancy rating 0,210,131,10,121,58,0,48,35,11,2,10,10,0,21,0,1,0,20
S01011941,Occupancy rating -1 or less,100,58,7,51,26,0,12,7,4,1,14,10,4,16,1,2,1,12
S01011942,All households,573,369,103,266,157,25,94,70,18,6,38,28,10,47,3,7,2,35
S01011942,Occupancy rating +2 or more,43,25,4,21,17,4,13,9,2,2,0,0,0,1,0,0,1,0
S01011942,Occupancy rating +1,139,98,32,66,36,8,26,24,2,0,2,1,1,5,0,2,0,3
S01011942,Occupancy rating 0,277,183,60,123,73,10,42,29,10,3,21,17,4,21,1,0,0,20
S01011942,Occupancy rating -1 or less,114,63,7,56,31,3,13,8,4,1,15,10,5,20,2,5,1,12
S01011943,All households,715,434,123,311,231,19,143,96,40,7,69,47,22,50,6,9,0,35
S01011943,Occupancy rating +2 or more,45,31,12,19,12,2,9,6,0,3,1,0,1,2,1,0,0,1
S01011943,Occupancy rating +1,168,115,36,79,50,10,37,35,1,1,3,3,0,3,0,0,0,3
S01011943,Occupancy rating 0,355,225,65,160,111,5,65,44,18,3,41,26,15,19,0,2,0,17
S01011943,Occupancy rating -1 or less,147,63,10,53,58,2,32,11,21,0,24,18,6,26,5,7,0,14
S01011944,All households,188,41,23,18,142,28,108,56,35,17,6,5,1,5,3,0,0,2
S01011944,Occupancy rating +2 or more,133,26,14,12,105,20,83,42,26,15,2,1,1,2,1,0,0,1
S01011944,Occupancy rating +1,37,11,9,2,25,7,16,10,5,1,2,2,0,1,1,0,0,0
S01011944,Occupancy rating 0,14,4,0,4,9,1,7,3,3,1,1,1,0,1,0,0,0,1
S01011944,Occupancy rating -1 or less,4,0,0,0,3,0,2,1,1,0,1,1,0,1,1,0,0,0
S01011945,All households,313,54,36,18,248,66,172,79,68,25,10,2,8,11,3,0,3,5
S01011945,Occupancy rating +2 or more,280,43,28,15,228,65,156,76,58,22,7,1,6,9,3,0,2,4
S01011945,Occupancy rating +1,22,5,3,2,15,1,12,2,8,2,2,0,2,2,0,0,1,1
S01011945,Occupancy rating 0,10,6,5,1,4,0,3,1,2,0,1,1,0,0,0,0,0,0
S01011945,Occupancy rating -1 or less,1,0,0,0,1,0,1,0,0,1,0,0,0,0,0,0,0,0
S01011946,All households,377,138,73,65,220,59,123,54,54,15,38,26,12,19,8,0,2,9
S01011946,Occupancy rating +2 or more,132,33,14,19,98,30,66,36,26,4,2,0,2,1,1,0,0,0
S01011946,Occupancy rating +1,88,35,18,17,49,13,29,13,10,6,7,5,2,4,0,0,0,4
S01011946,Occupancy rating 0,116,54,36,18,58,15,22,3,15,4,21,14,7,4,2,0,0,2
S01011946,Occupancy rating -1 or less,41,16,5,11,15,1,6,2,3,1,8,7,1,10,5,0,2,3
S01011947,All households,214,51,39,12,161,43,100,48,32,20,18,11,7,2,2,0,0,0
S01011947,Occupancy rating +2 or more,71,10,4,6,61,15,44,32,8,4,2,2,0,0,0,0,0,0
S01011947,Occupancy rating +1,44,4,3,1,39,3,29,8,8,13,7,4,3,1,1,0,0,0
S01011947,Occupancy rating 0,91,35,30,5,55,23,25,8,14,3,7,4,3,1,1,0,0,0
S01011947,Occupancy rating -1 or less,8,2,2,0,6,2,2,0,2,0,2,1,1,0,0,0,0,0
S01011948,All households,527,235,137,98,275,56,190,88,79,23,29,18,11,17,7,0,0,10
S01011948,Occupancy rating +2 or more,255,66,44,22,181,42,133,66,50,17,6,4,2,8,3,0,0,5
S01011948,Occupancy rating +1,87,41,17,24,42,4,30,10,15,5,8,4,4,4,2,0,0,2
S01011948,Occupancy rating 0,161,109,64,45,48,10,26,12,13,1,12,7,5,4,1,0,0,3
S01011948,Occupancy rating -1 or less,24,19,12,7,4,0,1,0,1,0,3,3,0,1,1,0,0,0
S01011949,All households,392,113,80,33,268,84,159,80,53,26,25,16,9,11,2,0,4,5
S01011949,Occupancy rating +2 or more,311,85,60,25,218,78,130,72,39,19,10,7,3,8,1,0,3,4
S01011949,Occupancy rating +1,58,22,15,7,34,5,22,7,10,5,7,4,3,2,1,0,1,0
S01011949,Occupancy rating 0,20,5,4,1,14,1,6,1,3,2,7,5,2,1,0,0,0,1
S01011949,Occupancy rating -1 or less,3,1,1,0,2,0,1,0,1,0,1,0,1,0,0,0,0,0
S01011950,All households,348,117,83,34,217,62,131,61,50,20,24,13,11,14,10,0,0,4
S01011950,Occupancy rating +2 or more,160,41,25,16,117,33,76,45,19,12,8,3,5,2,2,0,0,0
S01011950,Occupancy rating +1,106,39,23,16,61,17,36,14,19,3,8,5,3,6,4,0,0,2
S01011950,Occupancy rating 0,65,32,31,1,31,11,13,1,8,4,7,5,2,2,0,0,0,2
S01011950,Occupancy rating -1 or less,17,5,4,1,8,1,6,1,4,1,1,0,1,4,4,0,0,0
S01011951,All households,306,88,64,24,206,38,132,50,58,24,36,23,13,12,1,0,1,10
S01011951,Occupancy rating +2 or more,143,41,31,10,99,31,63,28,26,9,5,1,4,3,1,0,0,2
S01011951,Occupancy rating +1,95,41,31,10,52,6,41,18,15,8,5,3,2,2,0,0,0,2
S01011951,Occupancy rating 0,61,6,2,4,49,1,25,4,14,7,23,17,6,6,0,0,1,5
S01011951,Occupancy rating -1 or less,7,0,0,0,6,0,3,0,3,0,3,2,1,1,0,0,0,1
S01011952,All households,200,33,16,17,166,33,128,55,64,9,5,2,3,1,1,0,0,0
S01011952,Occupancy rating +2 or more,153,26,13,13,127,29,95,47,42,6,3,1,2,0,0,0,0,0
S01011952,Occupancy rating +1,41,6,3,3,34,4,28,8,18,2,2,1,1,1,1,0,0,0
S01011952,Occupancy rating 0,5,1,0,1,4,0,4,0,3,1,0,0,0,0,0,0,0,0
S01011952,Occupancy rating -1 or less,1,0,0,0,1,0,1,0,1,0,0,0,0,0,0,0,0,0
S01011953,All households,325,95,63,32,224,35,162,69,75,18,27,16,11,6,5,0,1,0
S01011953,Occupancy rating +2 or more,213,48,38,10,164,31,121,58,50,13,12,6,6,1,1,0,0,0
S01011953,Occupancy rating +1,67,32,20,12,34,3,23,10,12,1,8,3,5,1,0,0,1,0
S01011953,Occupancy rating 0,41,15,5,10,24,1,17,1,12,4,6,6,0,2,2,0,0,0
S01011953,Occupancy rating -1 or less,4,0,0,0,2,0,1,0,1,0,1,1,0,2,2,0,0,0
S01011954,All households,230,83,50,33,143,25,91,39,38,14,27,16,11,4,3,0,0,1
S01011954,Occupancy rating +2 or more,69,20,11,9,48,8,39,26,10,3,1,1,0,1,1,0,0,0
S01011954,Occupancy rating +1,80,21,13,8,58,13,35,10,19,6,10,5,5,1,1,0,0,0
S01011954,Occupancy rating 0,63,32,22,10,30,4,14,2,7,5,12,9,3,1,0,0,0,1
S01011954,Occupancy rating -1 or less,18,10,4,6,7,0,3,1,2,0,4,1,3,1,1,0,0,0
S01011955,All households,467,180,97,83,272,51,181,81,64,36,40,23,17,15,6,0,1,8
S01011955,Occupancy rating +2 or more,188,48,25,23,134,28,96,54,31,11,10,5,5,6,4,0,0,2
S01011955,Occupancy rating +1,146,65,31,34,77,19,51,25,13,13,7,4,3,4,0,0,0,4
S01011955,Occupancy rating 0,111,63,38,25,44,2,25,2,13,10,17,10,7,4,2,0,0,2
S01011955,Occupancy rating -1 or less,22,4,3,1,17,2,9,0,7,2,6,4,2,1,0,0,1,0
S01011956,All households,392,77,39,38,302,40,237,80,127,30,25,16,9,13,8,0,1,4
S01011956,Occupancy rating +2 or more,254,39,18,21,209,32,168,68,85,15,9,8,1,6,4,0,0,2
S01011956,Occupancy rating +1,81,20,14,6,59,5,47,12,28,7,7,4,3,2,1,0,0,1
S01011956,Occupancy rating 0,41,15,5,10,22,1,14,0,8,6,7,3,4,4,2,0,1,1
S01011956,Occupancy rating -1 or less,16,3,2,1,12,2,8,0,6,2,2,1,1,1,1,0,0,0
S01011957,All households,325,96,36,60,220,35,158,75,62,21,27,13,14,9,6,0,0,3
S01011957,Occupancy rating +2 or more,189,46,16,30,141,23,112,59,43,10,6,1,5,2,2,0,0,0
S01011957,Occupancy rating +1,73,28,12,16,41,10,26,13,11,2,5,2,3,4,2,0,0,2
S01011957,Occupancy rating 0,51,17,7,10,31,2,16,3,5,8,13,8,5,3,2,0,0,1
S01011957,Occupancy rating -1 or less,12,5,1,4,7,0,4,0,3,1,3,2,1,0,0,0,0,0
S01011958,All households,481,142,71,71,317,53,236,116,81,39,28,14,14,22,9,0,1,12
S01011958,Occupancy rating +2 or more,280,58,36,22,214,41,160,89,46,25,13,6,7,8,2,0,0,6
S01011958,Occupancy rating +1,95,37,18,19,53,7,41,17,17,7,5,1,4,5,3,0,1,1
S01011958,Occupancy rating 0,86,38,13,25,43,5,29,10,13,6,9,6,3,5,2,0,0,3
S01011958,Occupancy rating -1 or less,20,9,4,5,7,0,6,0,5,1,1,1,0,4,2,0,0,2
S01011959,All households,365,92,44,48,258,42,191,84,75,32,25,14,11,15,4,0,2,9
S01011959,Occupancy rating +2 or more,231,56,27,29,166,30,127,66,46,15,9,4,5,9,2,0,0,7
S01011959,Occupancy rating +1,91,25,11,14,64,11,42,15,16,11,11,6,5,2,1,0,1,0
S01011959,Occupancy rating 0,38,11,6,5,25,1,19,2,12,5,5,4,1,2,0,0,0,2
S01011959,Occupancy rating -1 or less,5,0,0,0,3,0,3,1,1,1,0,0,0,2,1,0,1,0
S01011960,All households,325,63,18,45,247,29,205,97,91,17,13,7,6,15,5,0,0,10
S01011960,Occupancy rating +2 or more,202,26,8,18,170,17,147,73,63,11,6,4,2,6,2,0,0,4
S01011960,Occupancy rating +1,72,18,5,13,52,8,40,18,18,4,4,2,2,2,1,0,0,1
S01011960,Occupancy rating 0,45,17,4,13,22,3,16,6,8,2,3,1,2,6,2,0,0,4
S01011960,Occupancy rating -1 or less,6,2,1,1,3,1,2,0,2,0,0,0,0,1,0,0,0,1
S01011961,All households,311,82,33,49,224,21,171,86,65,20,32,24,8,5,5,0,0,0
S01011961,Occupancy rating +2 or more,153,34,14,20,118,11,97,61,28,8,10,4,6,1,1,0,0,0
S01011961,Occupancy rating +1,89,25,9,16,62,6,42,19,17,6,14,13,1,2,2,0,0,0
S01011961,Occupancy rating 0,62,22,10,12,38,4,28,6,17,5,6,5,1,2,2,0,0,0
S01011961,Occupancy rating -1 or less,7,1,0,1,6,0,4,0,3,1,2,2,0,0,0,0,0,0
S01011962,All households,264,36,15,21,216,29,176,81,77,18,11,8,3,12,8,0,3,1
S01011962,Occupancy rating +2 or more,200,21,10,11,173,26,138,71,55,12,9,8,1,6,3,0,2,1
S01011962,Occupancy rating +1,35,6,1,5,28,2,26,9,13,4,0,0,0,1,1,0,0,0
S01011962,Occupancy rating 0,21,6,3,3,11,1,10,1,8,1,0,0,0,4,3,0,1,0
S01011962,Occupancy rating -1 or less,8,3,1,2,4,0,2,0,1,1,2,0,2,1,1,0,0,0
S01011963,All households,231,70,36,34,149,22,106,43,59,4,21,10,11,12,2,0,1,9
S01011963,Occupancy rating +2 or more,118,21,7,14,91,14,73,29,42,2,4,3,1,6,2,0,0,4
S01011963,Occupancy rating +1,48,14,6,8,32,5,20,11,8,1,7,2,5,2,0,0,0,2
S01011963,Occupancy rating 0,47,28,18,10,17,3,5,0,5,0,9,4,5,2,0,0,1,1
S01011963,Occupancy rating -1 or less,18,7,5,2,9,0,8,3,4,1,1,1,0,2,0,0,0,2
S01011964,All households,453,134,50,84,310,64,215,107,77,31,31,22,9,9,5,0,0,4
S01011964,Occupancy rating +2 or more,242,49,18,31,193,53,128,74,38,16,12,6,6,0,0,0,0,0
S01011964,Occupancy rating +1,120,52,23,29,65,5,53,21,27,5,7,6,1,3,1,0,0,2
S01011964,Occupancy rating 0,73,29,8,21,39,4,25,9,8,8,10,9,1,5,3,0,0,2
S01011964,Occupancy rating -1 or less,18,4,1,3,13,2,9,3,4,2,2,1,1,1,1,0,0,0
S01011965,All households,381,139,87,52,229,59,139,60,64,15,31,19,12,13,3,0,2,8
S01011965,Occupancy rating +2 or more,189,56,36,20,131,44,80,45,29,6,7,2,5,2,0,0,0,2
S01011965,Occupancy rating +1,108,52,28,24,51,10,33,14,15,4,8,4,4,5,0,0,1,4
S01011965,Occupancy rating 0,67,26,19,7,36,4,21,1,15,5,11,8,3,5,2,0,1,2
S01011965,Occupancy rating -1 or less,17,5,4,1,11,1,5,0,5,0,5,5,0,1,1,0,0,0
S01011966,All households,351,83,47,36,261,49,182,83,77,22,30,17,13,7,5,1,0,1
S01011966,Occupancy rating +2 or more,231,40,19,21,190,42,137,69,56,12,11,5,6,1,0,0,0,1
S01011966,Occupancy rating +1,68,32,22,10,34,5,27,9,11,7,2,1,1,2,2,0,0,0
S01011966,Occupancy rating 0,37,9,5,4,25,1,13,5,6,2,11,8,3,3,2,1,0,0
S01011966,Occupancy rating -1 or less,15,2,1,1,12,1,5,0,4,1,6,3,3,1,1,0,0,0
S01011967,All households,420,100,40,60,302,41,232,105,99,28,29,15,14,18,7,0,3,8
S01011967,Occupancy rating +2 or more,287,58,22,36,219,32,171,84,72,15,16,11,5,10,4,0,2,4
S01011967,Occupancy rating +1,92,38,17,21,50,6,37,18,12,7,7,3,4,4,1,0,0,3
S01011967,Occupancy rating 0,34,3,1,2,27,3,18,3,12,3,6,1,5,4,2,0,1,1
S01011967,Occupancy rating -1 or less,7,1,0,1,6,0,6,0,3,3,0,0,0,0,0,0,0,0
S01011968,All households,478,176,60,116,283,41,196,88,84,24,46,31,15,19,4,0,1,14
S01011968,Occupancy rating +2 or more,183,61,24,37,117,24,88,43,36,9,5,2,3,5,2,0,0,3
S01011968,Occupancy rating +1,159,85,26,59,71,11,51,33,10,8,9,6,3,3,0,0,0,3
S01011968,Occupancy rating 0,111,24,8,16,77,4,44,12,27,5,29,20,9,10,1,0,1,8
S01011968,Occupancy rating -1 or less,25,6,2,4,18,2,13,0,11,2,3,3,0,1,1,0,0,0
S01011969,All households,480,146,66,80,316,53,217,98,80,39,46,29,17,18,4,0,3,11
S01011969,Occupancy rating +2 or more,182,43,20,23,135,34,94,53,27,14,7,4,3,4,0,0,0,4
S01011969,Occupancy rating +1,172,75,37,38,96,15,68,32,23,13,13,6,7,1,1,0,0,0
S01011969,Occupancy rating 0,100,23,8,15,66,1,44,10,23,11,21,15,6,11,2,0,3,6
S01011969,Occupancy rating -1 or less,26,5,1,4,19,3,11,3,7,1,5,4,1,2,1,0,0,1
S01011970,All households,432,142,55,87,270,24,187,76,86,25,59,45,14,20,6,0,0,14
S01011970,Occupancy rating +2 or more,91,27,14,13,60,12,44,31,10,3,4,4,0,4,0,0,0,4
S01011970,Occupancy rating +1,107,46,16,30,59,8,45,28,11,6,6,4,2,2,0,0,0,2
S01011970,Occupancy rating 0,166,49,18,31,108,2,75,17,44,14,31,21,10,9,4,0,0,5
S01011970,Occupancy rating -1 or less,68,20,7,13,43,2,23,0,21,2,18,16,2,5,2,0,0,3
S01011971,All households,243,78,37,41,160,30,110,42,58,10,20,14,6,5,5,0,0,0
S01011971,Occupancy rating +2 or more,155,47,27,20,107,22,78,36,32,10,7,5,2,1,1,0,0,0
S01011971,Occupancy rating +1,63,25,7,18,38,8,22,6,16,0,8,4,4,0,0,0,0,0
S01011971,Occupancy rating 0,17,3,2,1,11,0,6,0,6,0,5,5,0,3,3,0,0,0
S01011971,Occupancy rating -1 or less,8,3,1,2,4,0,4,0,4,0,0,0,0,1,1,0,0,0
S01011972,All households,512,149,69,80,340,56,252,136,86,30,32,13,19,23,4,0,1,18
S01011972,Occupancy rating +2 or more,326,81,41,40,234,46,176,117,43,16,12,4,8,11,1,0,1,9
S01011972,Occupancy rating +1,121,55,25,30,61,8,45,16,22,7,8,2,6,5,1,0,0,4
S01011972,Occupancy rating 0,50,12,2,10,34,2,24,3,16,5,8,4,4,4,1,0,0,3
S01011972,Occupancy rating -1 or less,15,1,1,0,11,0,7,0,5,2,4,3,1,3,1,0,0,2
S01011973,All households,272,68,35,33,202,36,145,69,52,24,21,11,10,2,0,0,0,2
S01011973,Occupancy rating +2 or more,161,34,19,15,127,28,96,51,32,13,3,0,3,0,0,0,0,0
S01011973,Occupancy rating +1,66,26,13,13,39,8,23,15,4,4,8,3,5,1,0,0,0,1
S01011973,Occupancy rating 0,40,8,3,5,31,0,23,3,13,7,8,6,2,1,0,0,0,1
S01011973,Occupancy rating -1 or less,5,0,0,0,5,0,3,0,3,0,2,2,0,0,0,0,0,0
S01011974,All households,320,76,38,38,232,39,178,90,66,22,15,7,8,12,1,0,2,9
S01011974,Occupancy rating +2 or more,215,44,25,19,165,32,128,75,39,14,5,2,3,6,1,0,1,4
S01011974,Occupancy rating +1,61,18,8,10,40,3,31,11,16,4,6,3,3,3,0,0,1,2
S01011974,Occupancy rating 0,34,10,5,5,24,3,18,4,10,4,3,1,2,0,0,0,0,0
S01011974,Occupancy rating -1 or less,10,4,0,4,3,1,1,0,1,0,1,1,0,3,0,0,0,3
S01011975,All households,199,46,22,24,145,23,106,58,31,17,16,10,6,8,3,0,2,3
S01011975,Occupancy rating +2 or more,111,19,11,8,88,17,65,45,11,9,6,2,4,4,1,0,1,2
S01011975,Occupancy rating +1,47,13,7,6,32,5,23,12,6,5,4,2,2,2,1,0,1,0
S01011975,Occupancy rating 0,31,13,4,9,16,1,14,1,11,2,1,1,0,2,1,0,0,1
S01011975,Occupancy rating -1 or less,10,1,0,1,9,0,4,0,3,1,5,5,0,0,0,0,0,0
S01011976,All households,353,105,55,50,240,46,164,74,66,24,30,22,8,8,2,0,0,6
S01011976,Occupancy rating +2 or more,187,51,30,21,132,34,94,50,32,12,4,2,2,4,1,0,0,3
S01011976,Occupancy rating +1,87,32,19,13,52,9,37,17,15,5,6,5,1,3,1,0,0,2
S01011976,Occupancy rating 0,61,16,6,10,44,2,27,7,15,5,15,12,3,1,0,0,0,1
S01011976,Occupancy rating -1 or less,18,6,0,6,12,1,6,0,4,2,5,3,2,0,0,0,0,0
S01011977,All households,508,170,81,89,319,48,227,98,79,50,44,27,17,19,10,0,3,6
S01011977,Occupancy rating +2 or more,226,54,26,28,165,37,120,66,32,22,8,5,3,7,4,0,0,3
S01011977,Occupancy rating +1,128,53,28,25,69,9,53,24,13,16,7,4,3,6,1,0,2,3
S01011977,Occupancy rating 0,118,55,25,30,58,2,36,3,25,8,20,12,8,5,4,0,1,0
S01011977,Occupancy rating -1 or less,36,8,2,6,27,0,18,5,9,4,9,6,3,1,1,0,0,0
S01011978,All households,351,145,90,55,200,46,124,55,53,16,30,16,14,6,5,0,1,0
S01011978,Occupancy rating +2 or more,115,39,24,15,75,24,49,29,16,4,2,0,2,1,1,0,0,0
S01011978,Occupancy rating +1,113,54,33,21,58,17,34,23,7,4,7,2,5,1,1,0,0,0
S01011978,Occupancy rating 0,96,41,29,12,52,4,27,2,20,5,21,14,7,3,2,0,1,0
S01011978,Occupancy rating -1 or less,27,11,4,7,15,1,14,1,10,3,0,0,0,1,1,0,0,0
S01011979,All households,397,98,51,47,283,51,219,107,86,26,13,5,8,16,8,0,0,8
S01011979,Occupancy rating +2 or more,272,52,22,30,210,44,160,85,57,18,6,3,3,10,5,0,0,5
S01011979,Occupancy rating +1,68,27,13,14,39,2,34,14,16,4,3,1,2,2,1,0,0,1
S01011979,Occupancy rating 0,49,17,15,2,28,4,20,7,10,3,4,1,3,4,2,0,0,2
S01011979,Occupancy rating -1 or less,8,2,1,1,6,1,5,1,3,1,0,0,0,0,0,0,0,0
S01011980,All households,182,52,22,30,128,19,101,55,36,10,8,3,5,2,1,0,0,1
S01011980,Occupancy rating +2 or more,122,33,16,17,89,17,66,41,20,5,6,3,3,0,0,0,0,0
S01011980,Occupancy rating +1,38,12,5,7,25,2,21,11,7,3,2,0,2,1,0,0,0,1
S01011980,Occupancy rating 0,14,3,1,2,10,0,10,3,6,1,0,0,0,1,1,0,0,0
S01011980,Occupancy rating -1 or less,8,4,0,4,4,0,4,0,3,1,0,0,0,0,0,0,0,0
S01011981,All households,396,118,48,70,259,44,191,96,75,20,24,15,9,19,9,1,0,9
S01011981,Occupancy rating +2 or more,237,58,24,34,171,32,130,72,45,13,9,6,3,8,4,0,0,4
S01011981,Occupancy rating +1,86,37,16,21,45,10,30,18,8,4,5,3,2,4,2,0,0,2
S01011981,Occupancy rating 0,57,20,7,13,33,1,23,4,16,3,9,5,4,4,1,1,0,2
S01011981,Occupancy rating -1 or less,16,3,1,2,10,1,8,2,6,0,1,1,0,3,2,0,0,1
S01011982,All households,414,112,34,78,291,54,213,109,77,27,24,18,6,11,3,0,2,6
S01011982,Occupancy rating +2 or more,279,71,26,45,203,45,155,92,43,20,3,0,3,5,2,0,2,1
S01011982,Occupancy rating +1,82,23,4,19,57,8,44,15,23,6,5,4,1,2,1,0,0,1
S01011982,Occupancy rating 0,44,15,3,12,28,1,12,2,9,1,15,13,2,1,0,0,0,1
S01011982,Occupancy rating -1 or less,9,3,1,2,3,0,2,0,2,0,1,1,0,3,0,0,0,3
S01011983,All households,351,129,68,61,206,57,136,79,38,19,13,6,7,16,4,0,1,11
S01011983,Occupancy rating +2 or more,199,61,42,19,134,49,82,56,15,11,3,0,3,4,1,0,0,3
S01011983,Occupancy rating +1,90,41,17,24,45,8,33,18,11,4,4,2,2,4,0,0,1,3
S01011983,Occupancy rating 0,46,23,9,14,18,0,14,3,9,2,4,3,1,5,0,0,0,5
S01011983,Occupancy rating -1 or less,16,4,0,4,9,0,7,2,3,2,2,1,1,3,3,0,0,0
S01011984,All households,315,125,73,52,176,17,114,47,49,18,45,32,13,14,8,0,0,6
S01011984,Occupancy rating +2 or more,81,20,11,9,58,9,42,25,10,7,7,4,3,3,2,0,0,1
S01011984,Occupancy rating +1,70,28,15,13,40,4,28,18,5,5,8,5,3,2,1,0,0,1
S01011984,Occupancy rating 0,129,65,39,26,59,4,31,4,23,4,24,19,5,5,1,0,0,4
S01011984,Occupancy rating -1 or less,35,12,8,4,19,0,13,0,11,2,6,4,2,4,4,0,0,0
S01011985,All households,293,82,47,35,205,38,149,75,49,25,18,10,8,6,3,0,0,3
S01011985,Occupancy rating +2 or more,171,50,32,18,120,31,77,43,22,12,12,7,5,1,1,0,0,0
S01011985,Occupancy rating +1,64,14,7,7,50,4,42,21,12,9,4,2,2,0,0,0,0,0
S01011985,Occupancy rating 0,29,7,4,3,22,2,19,6,11,2,1,1,0,0,0,0,0,0
S01011985,Occupancy rating -1 or less,29,11,4,7,13,1,11,5,4,2,1,0,1,5,2,0,0,3
S01011986,All households,320,127,45,82,184,20,114,40,53,21,50,38,12,9,2,0,0,7
S01011986,Occupancy rating +2 or more,60,25,13,12,33,8,22,13,7,2,3,2,1,2,1,0,0,1
S01011986,Occupancy rating +1,103,42,15,27,61,11,44,22,10,12,6,2,4,0,0,0,0,0
S01011986,Occupancy rating 0,130,51,11,40,74,1,42,5,30,7,31,25,6,5,0,0,0,5
S01011986,Occupancy rating -1 or less,27,9,6,3,16,0,6,0,6,0,10,9,1,2,1,0,0,1
S01011987,All households,403,99,51,48,291,48,191,83,84,24,52,32,20,13,7,0,0,6
S01011987,Occupancy rating +2 or more,160,38,26,12,119,32,82,53,21,8,5,1,4,3,1,0,0,2
S01011987,Occupancy rating +1,117,29,10,19,83,13,58,24,23,11,12,6,6,5,1,0,0,4
S01011987,Occupancy rating 0,97,29,14,15,66,2,37,5,27,5,27,19,8,2,2,0,0,0
S01011987,Occupancy rating -1 or less,29,3,1,2,23,1,14,1,13,0,8,6,2,3,3,0,0,0
S01011988,All households,297,92,56,36,198,49,141,84,41,16,8,2,6,7,3,1,0,3
S01011988,Occupancy rating +2 or more,208,61,39,22,145,40,101,70,22,9,4,2,2,2,1,0,0,1
S01011988,Occupancy rating +1,63,21,12,9,39,7,31,13,13,5,1,0,1,3,1,0,0,2
S01011988,Occupancy rating 0,22,10,5,5,11,1,7,0,6,1,3,0,3,1,1,0,0,0
S01011988,Occupancy rating -1 or less,4,0,0,0,3,1,2,1,0,1,0,0,0,1,0,1,0,0
S01011989,All households,379,93,61,32,277,54,175,78,71,26,48,28,20,9,4,0,1,4
S01011989,Occupancy rating +2 or more,206,46,32,14,159,42,108,61,32,15,9,5,4,1,1,0,0,0
S01011989,Occupancy rating +1,85,28,20,8,55,10,31,13,14,4,14,6,8,2,0,0,0,2
S01011989,Occupancy rating 0,66,13,5,8,49,2,29,2,22,5,18,13,5,4,1,0,1,2
S01011989,Occupancy rating -1 or less,22,6,4,2,14,0,7,2,3,2,7,4,3,2,2,0,0,0
S01011990,All households,364,121,79,42,234,70,145,66,51,28,19,11,8,9,1,0,1,7
S01011990,Occupancy rating +2 or more,232,70,45,25,157,56,95,52,24,19,6,2,4,5,1,0,0,4
S01011990,Occupancy rating +1,87,39,26,13,48,11,35,12,15,8,2,2,0,0,0,0,0,0
S01011990,Occupancy rating 0,31,4,4,0,25,3,13,1,11,1,9,6,3,2,0,0,0,2
S01011990,Occupancy rating -1 or less,14,8,4,4,4,0,2,1,1,0,2,1,1,2,0,0,1,1
S01011991,All households,298,84,53,31,201,29,137,49,59,29,35,21,14,13,3,0,0,10
S01011991,Occupancy rating +2 or more,141,43,28,15,95,21,66,33,21,12,8,2,6,3,1,0,0,2
S01011991,Occupancy rating +1,76,30,19,11,44,5,32,13,12,7,7,2,5,2,1,0,0,1
S01011991,Occupancy rating 0,63,10,5,5,47,2,31,3,22,6,14,12,2,6,0,0,0,6
S01011991,Occupancy rating -1 or less,18,1,1,0,15,1,8,0,4,4,6,5,1,2,1,0,0,1
S01011992,All households,472,178,93,85,282,71,179,80,73,26,32,21,11,12,4,0,0,8
S01011992,Occupancy rating +2 or more,240,65,30,35,169,50,111,54,36,21,8,3,5,6,3,0,0,3
S01011992,Occupancy rating +1,129,62,32,30,65,11,44,21,22,1,10,9,1,2,0,0,0,2
S01011992,Occupancy rating 0,79,41,28,13,36,9,18,5,10,3,9,5,4,2,1,0,0,1
S01011992,Occupancy rating -1 or less,24,10,3,7,12,1,6,0,5,1,5,4,1,2,0,0,0,2
S01011993,All households,460,237,124,113,201,26,133,65,47,21,42,35,7,22,5,0,0,17
S01011993,Occupancy rating +2 or more,80,34,17,17,46,8,35,20,9,6,3,3,0,0,0,0,0,0
S01011993,Occupancy rating +1,112,54,22,32,54,12,37,20,14,3,5,2,3,4,1,0,0,3
S01011993,Occupancy rating 0,201,119,69,50,77,5,45,20,16,9,27,24,3,5,0,0,0,5
S01011993,Occupancy rating -1 or less,67,30,16,14,24,1,16,5,8,3,7,6,1,13,4,0,0,9
S01011994,All households,305,61,47,14,226,76,145,91,30,24,5,3,2,18,5,0,4,9
S01011994,Occupancy rating +2 or more,271,53,42,11,203,71,127,86,22,19,5,3,2,15,5,0,3,7
S01011994,Occupancy rating +1,21,6,5,1,12,4,8,3,3,2,0,0,0,3,0,0,1,2
S01011994,Occupancy rating 0,8,1,0,1,7,1,6,1,3,2,0,0,0,0,0,0,0,0
S01011994,Occupancy rating -1 or less,5,1,0,1,4,0,4,1,2,1,0,0,0,0,0,0,0,0
S01011995,All households,324,71,25,46,244,32,203,85,86,32,9,5,4,9,1,0,0,8
S01011995,Occupancy rating +2 or more,243,48,15,33,186,27,153,71,59,23,6,3,3,9,1,0,0,8
S01011995,Occupancy rating +1,56,15,8,7,41,4,35,13,14,8,2,1,1,0,0,0,0,0
S01011995,Occupancy rating 0,19,6,2,4,13,0,13,1,11,1,0,0,0,0,0,0,0,0
S01011995,Occupancy rating -1 or less,6,2,0,2,4,1,2,0,2,0,1,1,0,0,0,0,0,0
S01011996,All households,254,92,50,42,153,22,99,40,43,16,32,19,13,9,4,0,0,5
S01011996,Occupancy rating +2 or more,106,40,22,18,64,15,43,25,14,4,6,3,3,2,1,0,0,1
S01011996,Occupancy rating +1,67,23,14,9,43,4,25,9,11,5,14,7,7,1,0,0,0,1
S01011996,Occupancy rating 0,65,24,11,13,37,3,26,5,14,7,8,6,2,4,1,0,0,3
S01011996,Occupancy rating -1 or less,16,5,3,2,9,0,5,1,4,0,4,3,1,2,2,0,0,0
S01011997,All households,422,148,56,92,262,35,175,85,67,23,52,35,17,12,6,0,0,6
S01011997,Occupancy rating +2 or more,171,47,22,25,121,27,86,48,27,11,8,4,4,3,1,0,0,2
S01011997,Occupancy rating +1,104,51,17,34,50,5,38,24,11,3,7,4,3,3,2,0,0,1
S01011997,Occupancy rating 0,130,46,14,32,79,3,46,12,26,8,30,20,10,5,2,0,0,3
S01011997,Occupancy rating -1 or less,17,4,3,1,12,0,5,1,3,1,7,7,0,1,1,0,0,0
S01011998,All households,220,43,22,21,172,34,132,60,59,13,6,5,1,5,2,0,1,2
S01011998,Occupancy rating +2 or more,167,21,15,6,142,29,109,56,44,9,4,4,0,4,1,0,1,2
S01011998,Occupancy rating +1,43,21,7,14,21,4,17,4,10,3,0,0,0,1,1,0,0,0
S01011998,Occupancy rating 0,8,1,0,1,7,1,5,0,4,1,1,0,1,0,0,0,0,0
S01011998,Occupancy rating -1 or less,2,0,0,0,2,0,1,0,1,0,1,1,0,0,0,0,0,0
S01011999,All households,291,95,36,59,187,30,132,67,48,17,25,17,8,9,2,0,1,6
S01011999,Occupancy rating +2 or more,153,47,21,26,103,21,72,42,24,6,10,7,3,3,0,0,0,3
S01011999,Occupancy rating +1,83,29,7,22,50,7,36,21,12,3,7,5,2,4,1,0,0,3
S01011999,Occupancy rating 0,44,15,5,10,27,2,19,4,8,7,6,3,3,2,1,0,1,0
S01011999,Occupancy rating -1 or less,11,4,3,1,7,0,5,0,4,1,2,2,0,0,0,0,0,0
S01012000,All households,198,44,21,23,145,27,106,56,42,8,12,7,5,9,1,0,0,8
S01012000,Occupancy rating +2 or more,112,16,9,7,91,23,67,37,25,5,1,1,0,5,0,0,0,5
S01012000,Occupancy rating +1,53,21,7,14,31,4,24,15,7,2,3,1,2,1,0,0,0,1
S01012000,Occupancy rating 0,32,7,5,2,22,0,15,4,10,1,7,4,3,3,1,0,0,2
S01012000,Occupancy rating -1 or less,1,0,0,0,1,0,0,0,0,0,1,1,0,0,0,0,0,0
S01012001,All households,296,106,49,57,186,30,139,59,60,20,17,7,10,4,2,0,0,2
S01012001,Occupancy rating +2 or more,109,25,15,10,83,16,64,39,21,4,3,0,3,1,1,0,0,0
S01012001,Occupancy rating +1,87,39,15,24,48,7,39,14,19,6,2,0,2,0,0,0,0,0
S01012001,Occupancy rating 0,88,37,16,21,50,6,34,6,19,9,10,6,4,1,0,0,0,1
S01012001,Occupancy rating -1 or less,12,5,3,2,5,1,2,0,1,1,2,1,1,2,1,0,0,1
S01012002,All households,243,71,46,25,167,40,110,45,41,24,17,13,4,5,3,0,1,1
S01012002,Occupancy rating +2 or more,110,30,20,10,80,24,52,32,12,8,4,3,1,0,0,0,0,0
S01012002,Occupancy rating +1,72,18,9,9,52,10,36,8,19,9,6,4,2,2,2,0,0,0
S01012002,Occupancy rating 0,55,23,17,6,31,6,20,5,9,6,5,4,1,1,0,0,0,1
S01012002,Occupancy rating -1 or less,6,0,0,0,4,0,2,0,1,1,2,2,0,2,1,0,1,0
S01012003,All households,241,76,30,46,155,28,101,44,34,23,26,12,14,10,4,0,0,6
S01012003,Occupancy rating +2 or more,110,22,11,11,80,21,52,30,13,9,7,3,4,8,3,0,0,5
S01012003,Occupancy rating +1,66,26,11,15,39,5,28,9,10,9,6,3,3,1,0,0,0,1
S01012003,Occupancy rating 0,49,25,8,17,24,2,13,4,7,2,9,4,5,0,0,0,0,0
S01012003,Occupancy rating -1 or less,16,3,0,3,12,0,8,1,4,3,4,2,2,1,1,0,0,0
S01012004,All households,398,133,84,49,253,52,179,83,74,22,22,15,7,12,2,1,1,8
S01012004,Occupancy rating +2 or more,213,58,44,14,150,42,103,54,38,11,5,5,0,5,1,0,1,3
S01012004,Occupancy rating +1,88,35,19,16,50,8,38,19,13,6,4,0,4,3,0,0,0,3
S01012004,Occupancy rating 0,81,34,16,18,44,1,33,8,20,5,10,7,3,3,1,0,0,2
S01012004,Occupancy rating -1 or less,16,6,5,1,9,1,5,2,3,0,3,3,0,1,0,1,0,0
S01012005,All households,334,67,19,48,257,29,203,68,100,35,25,19,6,10,5,0,2,3
S01012005,Occupancy rating +2 or more,204,30,8,22,171,25,134,48,68,18,12,8,4,3,2,0,1,0
S01012005,Occupancy rating +1,70,25,6,19,42,2,35,12,12,11,5,3,2,3,1,0,1,1
S01012005,Occupancy rating 0,49,12,5,7,35,2,27,7,14,6,6,6,0,2,0,0,0,2
S01012005,Occupancy rating -1 or less,11,0,0,0,9,0,7,1,6,0,2,2,0,2,2,0,0,0
S01012006,All households,280,80,28,52,186,24,149,81,57,11,13,5,8,14,4,1,2,7
S01012006,Occupancy rating +2 or more,198,47,21,26,141,21,115,69,39,7,5,3,2,10,3,0,1,6
S01012006,Occupancy rating +1,43,17,6,11,24,3,18,8,7,3,3,1,2,2,0,1,1,0
S01012006,Occupancy rating 0,28,10,1,9,16,0,12,1,10,1,4,1,3,2,1,0,0,1
S01012006,Occupancy rating -1 or less,11,6,0,6,5,0,4,3,1,0,1,0,1,0,0,0,0,0
S01012007,All households,374,134,81,53,220,47,146,77,54,15,27,10,17,20,4,0,2,14
S01012007,Occupancy rating +2 or more,184,50,31,19,127,35,88,52,25,11,4,1,3,7,3,0,0,4
S01012007,Occupancy rating +1,93,29,20,9,57,7,39,19,18,2,11,4,7,7,1,0,0,6
S01012007,Occupancy rating 0,81,52,28,24,27,5,15,5,9,1,7,4,3,2,0,0,1,1
S01012007,Occupancy rating -1 or less,16,3,2,1,9,0,4,1,2,1,5,1,4,4,0,0,1,3
S01012008,All households,421,142,53,89,266,51,169,81,69,19,46,30,16,13,3,0,1,9
S01012008,Occupancy rating +2 or more,225,59,27,32,162,44,111,65,35,11,7,2,5,4,1,0,1,2
S01012008,Occupancy rating +1,87,37,16,21,46,5,26,6,17,3,15,11,4,4,1,0,0,3
S01012008,Occupancy rating 0,77,36,9,27,38,2,23,9,10,4,13,8,5,3,0,0,0,3
S01012008,Occupancy rating -1 or less,32,10,1,9,20,0,9,1,7,1,11,9,2,2,1,0,0,1
S01012009,All households,300,98,37,61,190,38,127,56,51,20,25,17,8,12,4,0,0,8
S01012009,Occupancy rating +2 or more,162,47,23,24,110,31,77,41,23,13,2,2,0,5,1,0,0,4
S01012009,Occupancy rating +1,72,30,7,23,40,5,27,9,16,2,8,5,3,2,1,0,0,1
S01012009,Occupancy rating 0,47,15,5,10,29,1,16,5,7,4,12,7,5,3,1,0,0,2
S01012009,Occupancy rating -1 or less,19,6,2,4,11,1,7,1,5,1,3,3,0,2,1,0,0,1
S01012010,All households,524,173,91,82,317,80,199,107,71,21,38,13,25,34,8,0,4,22
S01012010,Occupancy rating +2 or more,317,87,59,28,223,74,138,85,36,17,11,1,10,7,2,0,1,4
S01012010,Occupancy rating +1,107,58,28,30,44,5,28,12,14,2,11,3,8,5,1,0,2,2
S01012010,Occupancy rating 0,60,18,4,14,32,1,18,6,11,1,13,7,6,10,1,0,1,8
S01012010,Occupancy rating -1 or less,40,10,0,10,18,0,15,4,10,1,3,2,1,12,4,0,0,8
S01012011,All households,537,217,119,98,290,58,176,92,65,19,56,46,10,30,3,4,0,23
S01012011,Occupancy rating +2 or more,201,63,44,19,129,41,85,55,19,11,3,2,1,9,0,0,0,9
S01012011,Occupancy rating +1,149,79,41,38,62,10,40,26,12,2,12,9,3,8,1,0,0,7
S01012011,Occupancy rating 0,140,57,25,32,76,7,40,10,26,4,29,23,6,7,1,2,0,4
S01012011,Occupancy rating -1 or less,47,18,9,9,23,0,11,1,8,2,12,12,0,6,1,2,0,3
S01012012,All households,320,112,77,35,202,50,142,85,35,22,10,6,4,6,1,0,3,2
S01012012,Occupancy rating +2 or more,172,35,19,16,135,40,93,62,19,12,2,1,1,2,0,0,1,1
S01012012,Occupancy rating +1,83,48,39,9,35,5,27,17,8,2,3,2,1,0,0,0,0,0
S01012012,Occupancy rating 0,56,27,17,10,27,5,18,4,7,7,4,3,1,2,0,0,1,1
S01012012,Occupancy rating -1 or less,9,2,2,0,5,0,4,2,1,1,1,0,1,2,1,0,1,0
S01012013,All households,357,113,48,65,232,47,162,92,43,27,23,15,8,12,1,0,2,9
S01012013,Occupancy rating +2 or more,227,69,32,37,152,40,106,67,20,19,6,3,3,6,1,0,1,4
S01012013,Occupancy rating +1,71,28,14,14,43,5,32,18,11,3,6,3,3,0,0,0,0,0
S01012013,Occupancy rating 0,52,14,1,13,33,2,21,7,10,4,10,8,2,5,0,0,1,4
S01012013,Occupancy rating -1 or less,7,2,1,1,4,0,3,0,2,1,1,1,0,1,0,0,0,1
S01012014,All households,402,176,77,99,198,28,139,68,52,19,31,20,11,28,9,0,2,17
S01012014,Occupancy rating +2 or more,161,55,30,25,98,22,72,37,23,12,4,4,0,8,2,0,2,4
S01012014,Occupancy rating +1,91,36,18,18,48,4,36,21,11,4,8,5,3,7,1,0,0,6
S01012014,Occupancy rating 0,124,77,27,50,40,2,25,10,12,3,13,8,5,7,3,0,0,4
S01012014,Occupancy rating -1 or less,26,8,2,6,12,0,6,0,6,0,6,3,3,6,3,0,0,3
S01012015,All households,420,128,71,57,274,62,174,69,75,30,38,34,4,18,7,0,0,11
S01012015,Occupancy rating +2 or more,200,53,37,16,140,44,93,49,29,15,3,1,2,7,3,0,0,4
S01012015,Occupancy rating +1,110,42,23,19,67,16,42,15,16,11,9,7,2,1,0,0,0,1
S01012015,Occupancy rating 0,72,18,6,12,47,0,28,4,20,4,19,19,0,7,3,0,0,4
S01012015,Occupancy rating -1 or less,38,15,5,10,20,2,11,1,10,0,7,7,0,3,1,0,0,2
S01012016,All households,360,104,47,57,238,39,180,100,57,23,19,9,10,18,3,0,1,14
S01012016,Occupancy rating +2 or more,233,63,25,38,160,33,120,81,26,13,7,2,5,10,1,0,0,9
S01012016,Occupancy rating +1,73,26,17,9,45,3,37,14,16,7,5,2,3,2,0,0,1,1
S01012016,Occupancy rating 0,39,11,5,6,27,3,19,4,12,3,5,3,2,1,0,0,0,1
S01012016,Occupancy rating -1 or less,15,4,0,4,6,0,4,1,3,0,2,2,0,5,2,0,0,3
S01012017,All households,221,62,25,37,150,23,121,71,33,17,6,2,4,9,4,0,0,5
S01012017,Occupancy rating +2 or more,160,39,16,23,115,20,92,61,20,11,3,1,2,6,4,0,0,2
S01012017,Occupancy rating +1,39,14,5,9,25,3,20,10,6,4,2,0,2,0,0,0,0,0
S01012017,Occupancy rating 0,14,5,4,1,8,0,7,0,5,2,1,1,0,1,0,0,0,1
S01012017,Occupancy rating -1 or less,8,4,0,4,2,0,2,0,2,0,0,0,0,2,0,0,0,2
S01012018,All households,374,103,41,62,261,51,177,88,71,18,33,22,11,10,3,0,2,5
S01012018,Occupancy rating +2 or more,253,66,32,34,182,45,125,74,40,11,12,6,6,5,2,0,1,2
S01012018,Occupancy rating +1,60,17,7,10,40,5,29,11,15,3,6,3,3,3,1,0,1,1
S01012018,Occupancy rating 0,41,14,2,12,27,1,15,3,10,2,11,9,2,0,0,0,0,0
S01012018,Occupancy rating -1 or less,20,6,0,6,12,0,8,0,6,2,4,4,0,2,0,0,0,2
S01012019,All households,371,129,37,92,237,28,183,62,97,24,26,13,13,5,4,0,0,1
S01012019,Occupancy rating +2 or more,187,37,14,23,150,20,125,47,62,16,5,3,2,0,0,0,0,0
S01012019,Occupancy rating +1,75,25,9,16,48,4,36,12,18,6,8,5,3,2,2,0,0,0
S01012019,Occupancy rating 0,81,52,9,43,28,4,16,2,14,0,8,1,7,1,0,0,0,1
S01012019,Occupancy rating -1 or less,28,15,5,10,11,0,6,1,3,2,5,4,1,2,2,0,0,0
S01012020,All households,361,175,88,87,179,27,128,49,58,21,24,16,8,7,2,0,0,5
S01012020,Occupancy rating +2 or more,124,23,11,12,97,16,75,25,36,14,6,4,2,4,1,0,0,3
S01012020,Occupancy rating +1,70,41,19,22,28,3,23,13,9,1,2,0,2,1,1,0,0,0
S01012020,Occupancy rating 0,136,97,50,47,37,7,19,8,7,4,11,8,3,2,0,0,0,2
S01012020,Occupancy rating -1 or less,31,14,8,6,17,1,11,3,6,2,5,4,1,0,0,0,0,0
S01012021,All households,225,59,14,45,158,21,123,41,53,29,14,9,5,8,4,0,1,3
S01012021,Occupancy rating +2 or more,139,33,10,23,105,18,81,35,29,17,6,2,4,1,1,0,0,0
S01012021,Occupancy rating +1,43,19,3,16,24,3,20,5,8,7,1,0,1,0,0,0,0,0
S01012021,Occupancy rating 0,25,3,0,3,17,0,15,1,10,4,2,2,0,5,3,0,1,1
S01012021,Occupancy rating -1 or less,18,4,1,3,12,0,7,0,6,1,5,5,0,2,0,0,0,2
S01012022,All households,289,79,23,56,205,17,149,66,60,23,39,29,10,5,3,0,0,2
S01012022,Occupancy rating +2 or more,80,19,7,12,60,6,48,26,17,5,6,2,4,1,1,0,0,0
S01012022,Occupancy rating +1,123,43,11,32,80,10,60,33,20,7,10,9,1,0,0,0,0,0
S01012022,Occupancy rating 0,65,13,5,8,51,1,35,6,19,10,15,12,3,1,1,0,0,0
S01012022,Occupancy rating -1 or less,21,4,0,4,14,0,6,1,4,1,8,6,2,3,1,0,0,2
S01012023,All households,228,67,23,44,155,26,117,47,51,19,12,4,8,6,3,0,1,2
S01012023,Occupancy rating +2 or more,166,39,13,26,124,25,92,39,40,13,7,3,4,3,1,0,0,2
S01012023,Occupancy rating +1,32,14,8,6,17,1,14,4,8,2,2,0,2,1,1,0,0,0
S01012023,Occupancy rating 0,24,11,1,10,12,0,9,4,3,2,3,1,2,1,0,0,1,0
S01012023,Occupancy rating -1 or less,6,3,1,2,2,0,2,0,0,2,0,0,0,1,1,0,0,0
S01012024,All households,363,87,28,59,263,27,206,88,96,22,30,19,11,13,7,0,0,6
S01012024,Occupancy rating +2 or more,211,40,12,28,168,21,137,69,59,9,10,7,3,3,2,0,0,1
S01012024,Occupancy rating +1,80,27,11,16,50,3,40,14,20,6,7,4,3,3,1,0,0,2
S01012024,Occupancy rating 0,52,15,5,10,33,0,22,4,13,5,11,7,4,4,2,0,0,2
S01012024,Occupancy rating -1 or less,20,5,0,5,12,3,7,1,4,2,2,1,1,3,2,0,0,1
S01012025,All households,288,72,38,34,205,26,152,55,64,33,27,14,13,11,6,0,1,4
S01012025,Occupancy rating +2 or more,141,28,12,16,113,17,88,41,31,16,8,3,5,0,0,0,0,0
S01012025,Occupancy rating +1,89,34,18,16,52,6,37,10,15,12,9,6,3,3,2,0,0,1
S01012025,Occupancy rating 0,44,7,6,1,32,2,20,2,14,4,10,5,5,5,2,0,1,2
S01012025,Occupancy rating -1 or less,14,3,2,1,8,1,7,2,4,1,0,0,0,3,2,0,0,1
S01012026,All households,211,30,5,25,171,11,144,23,104,17,16,13,3,10,6,0,0,4
S01012026,Occupancy rating +2 or more,160,10,3,7,141,10,121,19,89,13,10,9,1,9,6,0,0,3
S01012026,Occupancy rating +1,19,8,1,7,11,1,10,3,3,4,0,0,0,0,0,0,0,0
S01012026,Occupancy rating 0,25,10,1,9,14,0,10,1,9,0,4,3,1,1,0,0,0,1
S01012026,Occupancy rating -1 or less,7,2,0,2,5,0,3,0,3,0,2,1,1,0,0,0,0,0
S01012027,All households,311,54,18,36,243,27,192,70,93,29,24,12,12,14,6,2,1,5
S01012027,Occupancy rating +2 or more,210,39,9,30,165,23,136,60,60,16,6,1,5,6,3,1,0,2
S01012027,Occupancy rating +1,62,11,7,4,48,4,37,9,19,9,7,4,3,3,1,0,1,1
S01012027,Occupancy rating 0,23,2,0,2,20,0,11,0,9,2,9,6,3,1,0,1,0,0
S01012027,Occupancy rating -1 or less,16,2,2,0,10,0,8,1,5,2,2,1,1,4,2,0,0,2
S01012028,All households,375,74,35,39,290,44,226,90,92,44,20,11,9,11,5,0,1,5
S01012028,Occupancy rating +2 or more,305,62,28,34,237,41,184,85,62,37,12,5,7,6,3,0,0,3
S01012028,Occupancy rating +1,45,9,5,4,33,1,28,5,18,5,4,3,1,3,2,0,1,0
S01012028,Occupancy rating 0,18,3,2,1,14,1,10,0,9,1,3,2,1,1,0,0,0,1
S01012028,Occupancy rating -1 or less,7,0,0,0,6,1,4,0,3,1,1,1,0,1,0,0,0,1
S01012029,All households,418,131,48,83,271,26,207,74,87,46,38,16,22,16,4,0,2,10
S01012029,Occupancy rating +2 or more,181,55,24,31,121,14,102,41,42,19,5,2,3,5,1,0,1,3
S01012029,Occupancy rating +1,123,53,19,34,66,8,50,25,13,12,8,1,7,4,1,0,1,2
S01012029,Occupancy rating 0,91,19,5,14,68,4,42,5,24,13,22,10,12,4,1,0,0,3
S01012029,Occupancy rating -1 or less,23,4,0,4,16,0,13,3,8,2,3,3,0,3,1,0,0,2
S01012030,All households,249,62,17,45,177,20,138,41,66,31,19,9,10,10,7,0,0,3
S01012030,Occupancy rating +2 or more,149,30,9,21,115,13,95,31,46,18,7,2,5,4,3,0,0,1
S01012030,Occupancy rating +1,60,21,4,17,36,7,24,7,10,7,5,3,2,3,2,0,0,1
S01012030,Occupancy rating 0,25,5,2,3,18,0,14,2,7,5,4,1,3,2,1,0,0,1
S01012030,Occupancy rating -1 or less,15,6,2,4,8,0,5,1,3,1,3,3,0,1,1,0,0,0
S01012031,All households,231,43,30,13,184,46,128,52,52,24,10,6,4,4,2,0,0,2
S01012031,Occupancy rating +2 or more,194,40,29,11,153,46,100,46,40,14,7,5,2,1,0,0,0,1
S01012031,Occupancy rating +1,24,3,1,2,20,0,19,6,6,7,1,0,1,1,0,0,0,1
S01012031,Occupancy rating 0,10,0,0,0,8,0,7,0,5,2,1,0,1,2,2,0,0,0
S01012031,Occupancy rating -1 or less,3,0,0,0,3,0,2,0,1,1,1,1,0,0,0,0,0,0
S01012032,All households,142,34,15,19,95,14,70,33,25,12,11,5,6,13,5,0,2,6
S01012032,Occupancy rating +2 or more,116,28,11,17,79,14,57,31,18,8,8,2,6,9,5,0,1,3
S01012032,Occupancy rating +1,9,1,1,0,7,0,6,0,3,3,1,1,0,1,0,0,0,1
S01012032,Occupancy rating 0,13,4,3,1,6,0,5,2,2,1,1,1,0,3,0,0,1,2
S01012032,Occupancy rating -1 or less,4,1,0,1,3,0,2,0,2,0,1,1,0,0,0,0,0,0
S01012033,All households,373,139,70,69,223,36,157,68,51,38,30,11,19,11,6,0,0,5
S01012033,Occupancy rating +2 or more,152,49,24,25,98,24,72,42,14,16,2,0,2,5,3,0,0,2
S01012033,Occupancy rating +1,129,54,30,24,71,8,56,20,25,11,7,0,7,4,1,0,0,3
S01012033,Occupancy rating 0,73,31,14,17,40,2,22,5,8,9,16,8,8,2,2,0,0,0
S01012033,Occupancy rating -1 or less,19,5,2,3,14,2,7,1,4,2,5,3,2,0,0,0,0,0
S01012034,All households,386,151,61,90,226,26,156,69,67,20,44,29,15,9,5,0,1,3
S01012034,Occupancy rating +2 or more,147,48,21,27,95,16,74,32,33,9,5,4,1,4,1,0,1,2
S01012034,Occupancy rating +1,113,55,21,34,58,8,41,31,8,2,9,4,5,0,0,0,0,0
S01012034,Occupancy rating 0,93,35,16,19,56,2,32,5,19,8,22,15,7,2,1,0,0,1
S01012034,Occupancy rating -1 or less,33,13,3,10,17,0,9,1,7,1,8,6,2,3,3,0,0,0
S01012035,All households,431,153,59,94,269,44,191,74,75,42,34,20,14,9,5,0,0,4
S01012035,Occupancy rating +2 or more,199,46,23,23,151,33,107,47,37,23,11,4,7,2,1,0,0,1
S01012035,Occupancy rating +1,104,55,19,36,48,6,40,13,17,10,2,2,0,1,0,0,0,1
S01012035,Occupancy rating 0,93,45,16,29,46,3,31,7,17,7,12,7,5,2,1,0,0,1
S01012035,Occupancy rating -1 or less,35,7,1,6,24,2,13,7,4,2,9,7,2,4,3,0,0,1
S01012036,All households,385,127,51,76,249,50,171,62,67,42,28,15,13,9,5,0,0,4
S01012036,Occupancy rating +2 or more,225,62,26,36,159,43,108,44,37,27,8,4,4,4,2,0,0,2
S01012036,Occupancy rating +1,83,32,16,16,49,5,37,11,19,7,7,2,5,2,1,0,0,1
S01012036,Occupancy rating 0,59,27,6,21,30,2,21,6,9,6,7,4,3,2,1,0,0,1
S01012036,Occupancy rating -1 or less,18,6,3,3,11,0,5,1,2,2,6,5,1,1,1,0,0,0
S01012037,All households,438,152,58,94,273,34,154,45,77,32,85,67,18,13,7,0,0,6
S01012037,Occupancy rating +2 or more,112,62,29,33,49,17,26,18,3,5,6,3,3,1,0,0,0,1
S01012037,Occupancy rating +1,170,45,19,26,122,13,76,23,40,13,33,26,7,3,0,0,0,3
S01012037,Occupancy rating 0,111,36,5,31,72,4,41,3,25,13,27,20,7,3,2,0,0,1
S01012037,Occupancy rating -1 or less,45,9,5,4,30,0,11,1,9,1,19,18,1,6,5,0,0,1
S01012038,All households,366,110,25,85,235,11,100,25,53,22,124,100,24,21,11,2,0,8
S01012038,Occupancy rating +2 or more,70,37,6,31,32,6,18,14,3,1,8,4,4,1,1,0,0,0
S01012038,Occupancy rating +1,124,46,11,35,73,3,35,8,16,11,35,30,5,5,1,0,0,4
S01012038,Occupancy rating 0,119,20,7,13,97,2,33,2,24,7,62,48,14,2,2,0,0,0
S01012038,Occupancy rating -1 or less,53,7,1,6,33,0,14,1,10,3,19,18,1,13,7,2,0,4
S01012039,All households,413,119,63,56,271,34,168,64,67,37,69,38,31,23,8,4,1,10
S01012039,Occupancy rating +2 or more,119,53,34,19,65,21,37,29,6,2,7,2,5,1,0,0,0,1
S01012039,Occupancy rating +1,145,51,24,27,86,11,59,29,14,16,16,7,9,8,1,4,0,3
S01012039,Occupancy rating 0,111,7,4,3,97,1,59,5,38,16,37,23,14,7,2,0,1,4
S01012039,Occupancy rating -1 or less,38,8,1,7,23,1,13,1,9,3,9,6,3,7,5,0,0,2
S01012040,All households,255,52,21,31,183,15,137,49,59,29,31,18,13,20,10,2,0,8
S01012040,Occupancy rating +2 or more,145,30,13,17,105,11,86,40,30,16,8,5,3,10,5,2,0,3
S01012040,Occupancy rating +1,59,12,7,5,42,4,28,8,13,7,10,7,3,5,2,0,0,3
S01012040,Occupancy rating 0,44,8,1,7,32,0,21,1,15,5,11,5,6,4,2,0,0,2
S01012040,Occupancy rating -1 or less,7,2,0,2,4,0,2,0,1,1,2,1,1,1,1,0,0,0
S01012041,All households,382,106,45,61,265,39,161,48,79,34,65,40,25,11,7,0,0,4
S01012041,Occupancy rating +2 or more,124,40,19,21,84,25,56,38,10,8,3,1,2,0,0,0,0,0
S01012041,Occupancy rating +1,126,45,21,24,77,14,44,7,23,14,19,11,8,4,2,0,0,2
S01012041,Occupancy rating 0,101,16,4,12,81,0,49,3,36,10,32,21,11,4,3,0,0,1
S01012041,Occupancy rating -1 or less,31,5,1,4,23,0,12,0,10,2,11,7,4,3,2,0,0,1
S01012042,All households,408,142,79,63,247,31,155,44,61,50,61,36,25,19,9,0,3,7
S01012042,Occupancy rating +2 or more,125,68,39,29,56,21,30,21,6,3,5,2,3,1,0,0,0,1
S01012042,Occupancy rating +1,131,42,21,21,86,7,58,20,16,22,21,10,11,3,0,0,2,1
S01012042,Occupancy rating 0,110,24,14,10,77,2,51,2,30,19,24,16,8,9,5,0,1,3
S01012042,Occupancy rating -1 or less,42,8,5,3,28,1,16,1,9,6,11,8,3,6,4,0,0,2
S01012043,All households,380,109,24,85,248,20,132,42,64,26,96,67,29,23,11,1,0,11
S01012043,Occupancy rating +2 or more,92,34,11,23,51,8,36,17,14,5,7,4,3,7,5,1,0,1
S01012043,Occupancy rating +1,116,43,8,35,69,10,37,19,11,7,22,14,8,4,2,0,0,2
S01012043,Occupancy rating 0,130,27,4,23,95,2,40,3,26,11,53,39,14,8,2,0,0,6
S01012043,Occupancy rating -1 or less,42,5,1,4,33,0,19,3,13,3,14,10,4,4,2,0,0,2
S01012044,All households,474,232,108,124,227,38,124,45,48,31,65,43,22,15,2,2,3,8
S01012044,Occupancy rating +2 or more,110,55,29,26,50,14,33,20,8,5,3,3,0,5,0,2,0,3
S01012044,Occupancy rating +1,165,99,38,61,64,15,36,17,11,8,13,8,5,2,0,0,2,0
S01012044,Occupancy rating 0,145,55,27,28,85,8,39,6,21,12,38,24,14,5,1,0,1,3
S01012044,Occupancy rating -1 or less,54,23,14,9,28,1,16,2,8,6,11,8,3,3,1,0,0,2
S01012045,All households,583,309,76,233,255,26,171,82,66,23,58,44,14,19,6,5,0,8
S01012045,Occupancy rating +2 or more,108,38,21,17,66,16,48,24,17,7,2,0,2,4,1,3,0,0
S01012045,Occupancy rating +1,185,105,21,84,79,6,63,40,17,6,10,5,5,1,1,0,0,0
S01012045,Occupancy rating 0,230,131,30,101,89,3,50,14,26,10,36,30,6,10,3,2,0,5
S01012045,Occupancy rating -1 or less,60,35,4,31,21,1,10,4,6,0,10,9,1,4,1,0,0,3
S01012046,All households,376,191,78,113,171,26,76,23,34,19,69,43,26,14,7,2,1,4
S01012046,Occupancy rating +2 or more,59,39,15,24,18,7,8,4,2,2,3,2,1,2,0,2,0,0
S01012046,Occupancy rating +1,127,77,31,46,50,15,28,15,9,4,7,4,3,0,0,0,0,0
S01012046,Occupancy rating 0,141,55,23,32,78,3,33,3,19,11,42,24,18,8,3,0,1,4
S01012046,Occupancy rating -1 or less,49,20,9,11,25,1,7,1,4,2,17,13,4,4,4,0,0,0
S01012047,All households,548,301,143,158,232,36,112,45,51,16,84,43,41,15,7,2,1,5
S01012047,Occupancy rating +2 or more,57,20,10,10,35,4,28,15,10,3,3,2,1,2,1,0,0,1
S01012047,Occupancy rating +1,189,123,44,79,64,18,37,21,15,1,9,5,4,2,0,0,1,1
S01012047,Occupancy rating 0,211,113,59,54,95,11,34,7,20,7,50,25,25,3,0,1,0,2
S01012047,Occupancy rating -1 or less,91,45,30,15,38,3,13,2,6,5,22,11,11,8,6,1,0,1
S01012048,All households,402,213,86,127,170,22,91,44,40,7,57,46,11,19,5,1,3,10
S01012048,Occupancy rating +2 or more,34,11,4,7,23,3,15,13,2,0,5,4,1,0,0,0,0,0
S01012048,Occupancy rating +1,134,89,26,63,41,9,25,17,8,0,7,4,3,4,0,0,1,3
S01012048,Occupancy rating 0,171,78,32,46,82,9,41,13,23,5,32,26,6,11,3,0,2,6
S01012048,Occupancy rating -1 or less,63,35,24,11,24,1,10,1,7,2,13,12,1,4,2,1,0,1
S01012049,All households,347,157,47,110,185,20,125,55,44,26,40,22,18,5,1,0,1,3
S01012049,Occupancy rating +2 or more,78,31,11,20,46,8,38,21,9,8,0,0,0,1,0,0,0,1
S01012049,Occupancy rating +1,125,66,19,47,57,9,42,22,10,10,6,3,3,2,1,0,0,1
S01012049,Occupancy rating 0,116,53,15,38,62,0,35,10,18,7,27,13,14,1,0,0,0,1
S01012049,Occupancy rating -1 or less,28,7,2,5,20,3,10,2,7,1,7,6,1,1,0,0,1,0
S01012050,All households,423,116,25,91,295,22,208,65,110,33,65,41,24,12,4,1,0,7
S01012050,Occupancy rating +2 or more,128,32,8,24,93,9,78,40,30,8,6,3,3,3,1,0,0,2
S01012050,Occupancy rating +1,152,47,8,39,103,9,74,20,43,11,20,13,7,2,0,0,0,2
S01012050,Occupancy rating 0,123,36,9,27,84,3,52,5,34,13,29,18,11,3,2,0,0,1
S01012050,Occupancy rating -1 or less,20,1,0,1,15,1,4,0,3,1,10,7,3,4,1,1,0,2
S01012051,All households,255,123,64,59,123,19,81,28,37,16,23,13,10,9,3,0,1,5
S01012051,Occupancy rating +2 or more,91,18,7,11,72,10,58,21,24,13,4,2,2,1,0,0,0,1
S01012051,Occupancy rating +1,41,19,5,14,17,4,7,5,2,0,6,4,2,5,1,0,1,3
S01012051,Occupancy rating 0,100,75,42,33,23,4,13,2,8,3,6,3,3,2,1,0,0,1
S01012051,Occupancy rating -1 or less,23,11,10,1,11,1,3,0,3,0,7,4,3,1,1,0,0,0
S01012052,All households,469,239,97,142,211,38,133,53,58,22,40,22,18,19,4,0,2,13
S01012052,Occupancy rating +2 or more,90,40,24,16,47,15,30,17,8,5,2,0,2,3,0,0,1,2
S01012052,Occupancy rating +1,164,83,39,44,79,14,54,31,19,4,11,7,4,2,0,0,0,2
S01012052,Occupancy rating 0,155,87,24,63,59,6,39,3,24,12,14,8,6,9,2,0,0,7
S01012052,Occupancy rating -1 or less,60,29,10,19,26,3,10,2,7,1,13,7,6,5,2,0,1,2
S01012053,All households,461,201,65,136,253,38,135,48,56,31,80,56,24,7,1,0,0,6
S01012053,Occupancy rating +2 or more,60,37,14,23,22,5,16,11,3,2,1,1,0,1,0,0,0,1
S01012053,Occupancy rating +1,215,125,39,86,90,26,50,33,9,8,14,5,9,0,0,0,0,0
S01012053,Occupancy rating 0,133,27,8,19,102,6,49,3,33,13,47,36,11,4,1,0,0,3
S01012053,Occupancy rating -1 or less,53,12,4,8,39,1,20,1,11,8,18,14,4,2,0,0,0,2
S01012054,All households,443,214,36,178,212,8,109,49,47,13,95,69,26,17,6,1,0,10
S01012054,Occupancy rating +2 or more,61,38,12,26,22,4,17,12,4,1,1,0,1,1,0,0,0,1
S01012054,Occupancy rating +1,206,142,20,122,62,4,39,28,9,2,19,10,9,2,1,0,0,1
S01012054,Occupancy rating 0,128,25,3,22,95,0,34,7,20,7,61,47,14,8,1,1,0,6
S01012054,Occupancy rating -1 or less,48,9,1,8,33,0,19,2,14,3,14,12,2,6,4,0,0,2
S01012055,All households,463,211,98,113,239,37,119,57,46,16,83,57,26,13,5,0,0,8
S01012055,Occupancy rating +2 or more,68,37,20,17,31,9,20,14,4,2,2,1,1,0,0,0,0,0
S01012055,Occupancy rating +1,191,100,45,55,89,24,49,36,8,5,16,10,6,2,1,0,0,1
S01012055,Occupancy rating 0,164,66,31,35,90,4,38,6,26,6,48,36,12,8,2,0,0,6
S01012055,Occupancy rating -1 or less,40,8,2,6,29,0,12,1,8,3,17,10,7,3,2,0,0,1
S01012056,All households,354,120,72,48,217,37,154,67,58,29,26,18,8,17,4,5,1,7
S01012056,Occupancy rating +2 or more,151,33,15,18,108,17,89,50,24,15,2,1,1,10,1,5,0,4
S01012056,Occupancy rating +1,92,31,18,13,59,13,37,15,16,6,9,8,1,2,2,0,0,0
S01012056,Occupancy rating 0,89,48,32,16,38,6,24,2,16,6,8,5,3,3,1,0,0,2
S01012056,Occupancy rating -1 or less,22,8,7,1,12,1,4,0,2,2,7,4,3,2,0,0,1,1
S01012057,All households,316,81,48,33,229,39,168,69,64,35,22,15,7,6,4,0,0,2
S01012057,Occupancy rating +2 or more,203,58,40,18,142,33,101,58,26,17,8,4,4,3,2,0,0,1
S01012057,Occupancy rating +1,78,15,7,8,61,4,47,10,25,12,10,8,2,2,2,0,0,0
S01012057,Occupancy rating 0,26,7,1,6,18,2,14,1,9,4,2,1,1,1,0,0,0,1
S01012057,Occupancy rating -1 or less,9,1,0,1,8,0,6,0,4,2,2,2,0,0,0,0,0,0
S01012058,All households,328,102,47,55,212,44,138,55,55,28,30,14,16,14,3,0,1,10
S01012058,Occupancy rating +2 or more,163,36,20,16,123,36,78,39,25,14,9,2,7,4,1,0,0,3
S01012058,Occupancy rating +1,95,44,20,24,48,7,32,14,10,8,9,5,4,3,1,0,1,1
S01012058,Occupancy rating 0,53,16,5,11,31,1,20,1,17,2,10,6,4,6,1,0,0,5
S01012058,Occupancy rating -1 or less,17,6,2,4,10,0,8,1,3,4,2,1,1,1,0,0,0,1
S01012059,All households,412,161,70,91,242,30,135,64,48,23,77,45,32,9,6,0,0,3
S01012059,Occupancy rating +2 or more,81,28,15,13,53,14,31,25,3,3,8,5,3,0,0,0,0,0
S01012059,Occupancy rating +1,164,84,34,50,78,14,50,36,10,4,14,9,5,2,1,0,0,1
S01012059,Occupancy rating 0,117,37,16,21,78,1,42,3,27,12,35,19,16,2,1,0,0,1
S01012059,Occupancy rating -1 or less,50,12,5,7,33,1,12,0,8,4,20,12,8,5,4,0,0,1
S01012060,All households,408,154,86,68,238,27,146,54,60,32,65,36,29,16,5,0,0,11
S01012060,Occupancy rating +2 or more,103,34,21,13,64,11,51,25,17,9,2,2,0,5,0,0,0,5
S01012060,Occupancy rating +1,128,51,20,31,74,9,51,23,16,12,14,8,6,3,1,0,0,2
S01012060,Occupancy rating 0,138,57,38,19,78,6,35,5,20,10,37,20,17,3,0,0,0,3
S01012060,Occupancy rating -1 or less,39,12,7,5,22,1,9,1,7,1,12,6,6,5,4,0,0,1
S01012061,All households,440,143,45,98,283,47,196,80,76,40,40,27,13,14,4,0,0,10
S01012061,Occupancy rating +2 or more,203,39,25,14,159,33,123,55,40,28,3,1,2,5,1,0,0,4
S01012061,Occupancy rating +1,111,47,9,38,61,11,39,17,15,7,11,6,5,3,1,0,0,2
S01012061,Occupancy rating 0,97,43,9,34,49,3,28,8,16,4,18,12,6,5,1,0,0,4
S01012061,Occupancy rating -1 or less,29,14,2,12,14,0,6,0,5,1,8,8,0,1,1,0,0,0
S01012062,All households,335,77,29,48,246,23,193,68,90,35,30,18,12,12,5,0,1,6
S01012062,Occupancy rating +2 or more,161,27,14,13,132,16,106,39,48,19,10,7,3,2,1,0,0,1
S01012062,Occupancy rating +1,91,29,8,21,60,5,50,22,20,8,5,3,2,2,0,0,0,2
S01012062,Occupancy rating 0,60,18,5,13,38,2,25,6,13,6,11,6,5,4,1,0,1,2
S01012062,Occupancy rating -1 or less,23,3,2,1,16,0,12,1,9,2,4,2,2,4,3,0,0,1
S01012063,All households,235,82,6,76,146,6,112,46,59,7,28,23,5,7,3,1,0,3
S01012063,Occupancy rating +2 or more,48,9,2,7,38,3,32,12,15,5,3,2,1,1,0,0,0,1
S01012063,Occupancy rating +1,80,38,2,36,42,3,34,24,9,1,5,5,0,0,0,0,0,0
S01012063,Occupancy rating 0,77,29,1,28,44,0,32,5,26,1,12,10,2,4,2,1,0,1
S01012063,Occupancy rating -1 or less,30,6,1,5,22,0,14,5,9,0,8,6,2,2,1,0,0,1
S01012064,All households,276,85,16,69,180,0,93,30,50,13,87,62,25,11,6,0,0,5
S01012064,Occupancy rating +2 or more,51,21,1,20,29,0,24,14,8,2,5,5,0,1,1,0,0,0
S01012064,Occupancy rating +1,62,16,4,12,45,0,23,10,9,4,22,11,11,1,1,0,0,0
S01012064,Occupancy rating 0,124,40,10,30,79,0,33,6,22,5,46,37,9,5,2,0,0,3
S01012064,Occupancy rating -1 or less,39,8,1,7,27,0,13,0,11,2,14,9,5,4,2,0,0,2
S01012065,All households,261,94,16,78,155,3,57,17,35,5,95,71,24,12,7,0,0,5
S01012065,Occupancy rating +2 or more,41,12,3,9,29,2,16,11,4,1,11,4,7,0,0,0,0,0
S01012065,Occupancy rating +1,62,21,2,19,39,1,18,5,12,1,20,13,7,2,1,0,0,1
S01012065,Occupancy rating 0,106,42,7,35,58,0,11,0,9,2,47,39,8,6,3,0,0,3
S01012065,Occupancy rating -1 or less,52,19,4,15,29,0,12,1,10,1,17,15,2,4,3,0,0,1
S01012066,All households,382,145,22,123,223,3,125,37,64,24,95,71,24,14,9,0,0,5
S01012066,Occupancy rating +2 or more,63,36,2,34,25,0,18,11,4,3,7,3,4,2,1,0,0,1
S01012066,Occupancy rating +1,133,80,11,69,52,2,38,20,12,6,12,6,6,1,0,0,0,1
S01012066,Occupancy rating 0,133,20,4,16,106,0,51,4,35,12,55,48,7,7,5,0,0,2
S01012066,Occupancy rating -1 or less,53,9,5,4,40,1,18,2,13,3,21,14,7,4,3,0,0,1
S01012067,All households,250,102,19,83,140,3,53,11,29,13,84,54,30,8,4,0,0,4
S01012067,Occupancy rating +2 or more,41,27,2,25,13,0,9,5,4,0,4,2,2,1,1,0,0,0
S01012067,Occupancy rating +1,63,36,10,26,26,2,9,3,5,1,15,7,8,1,0,0,0,1
S01012067,Occupancy rating 0,96,27,7,20,66,1,23,3,12,8,42,32,10,3,1,0,0,2
S01012067,Occupancy rating -1 or less,50,12,0,12,35,0,12,0,8,4,23,13,10,3,2,0,0,1
S01012068,All households,268,132,38,94,120,8,47,12,25,10,65,43,22,16,12,0,0,4
S01012068,Occupancy rating +2 or more,42,25,0,25,16,3,7,5,0,2,6,3,3,1,1,0,0,0
S01012068,Occupancy rating +1,63,38,11,27,25,1,10,5,4,1,14,10,4,0,0,0,0,0
S01012068,Occupancy rating 0,117,54,17,37,57,4,20,2,13,5,33,25,8,6,4,0,0,2
S01012068,Occupancy rating -1 or less,46,15,10,5,22,0,10,0,8,2,12,5,7,9,7,0,0,2
S01012069,All households,292,174,31,143,108,6,58,31,22,5,44,34,10,10,4,2,0,4
S01012069,Occupancy rating +2 or more,25,14,2,12,9,1,5,3,1,1,3,1,2,2,1,0,0,1
S01012069,Occupancy rating +1,97,73,12,61,24,2,19,18,1,0,3,3,0,0,0,0,0,0
S01012069,Occupancy rating 0,128,73,11,62,52,1,27,8,16,3,24,20,4,3,1,2,0,0
S01012069,Occupancy rating -1 or less,42,14,6,8,23,2,7,2,4,1,14,10,4,5,2,0,0,3
S01012070,All households,449,288,91,197,138,13,65,33,21,11,60,39,21,23,4,3,0,16
S01012070,Occupancy rating +2 or more,32,19,9,10,13,3,7,6,1,0,3,1,2,0,0,0,0,0
S01012070,Occupancy rating +1,147,112,25,87,33,8,17,13,0,4,8,4,4,2,0,1,0,1
S01012070,Occupancy rating 0,196,122,42,80,65,2,32,10,16,6,31,19,12,9,0,1,0,8
S01012070,Occupancy rating -1 or less,74,35,15,20,27,0,9,4,4,1,18,15,3,12,4,1,0,7
S01012071,All households,692,443,87,356,216,21,109,59,35,15,86,65,21,33,4,1,2,26
S01012071,Occupancy rating +2 or more,33,17,2,15,15,2,9,5,4,0,4,4,0,1,1,0,0,0
S01012071,Occupancy rating +1,216,159,30,129,53,13,29,25,1,3,11,10,1,4,0,1,0,3
S01012071,Occupancy rating 0,290,171,34,137,104,5,53,24,21,8,46,33,13,15,1,0,1,13
S01012071,Occupancy rating -1 or less,153,96,21,75,44,1,18,5,9,4,25,18,7,13,2,0,1,10
S01012072,All households,722,471,110,361,213,22,123,70,47,6,68,42,26,38,3,3,3,29
S01012072,Occupancy rating +2 or more,55,17,4,13,35,3,28,8,18,2,4,3,1,3,1,0,0,2
S01012072,Occupancy rating +1,219,156,38,118,58,11,42,34,6,2,5,1,4,5,0,0,1,4
S01012072,Occupancy rating 0,315,211,46,165,86,7,39,23,16,0,40,25,15,18,0,2,2,14
S01012072,Occupancy rating -1 or less,133,87,22,65,34,1,14,5,7,2,19,13,6,12,2,1,0,9
S01012073,All households,320,108,25,83,199,5,152,66,69,17,42,33,9,13,5,0,0,8
S01012073,Occupancy rating +2 or more,100,19,3,16,78,2,68,28,33,7,8,5,3,3,2,0,0,1
S01012073,Occupancy rating +1,124,68,18,50,54,3,45,34,8,3,6,5,1,2,0,0,0,2
S01012073,Occupancy rating 0,75,15,2,13,55,0,33,3,25,5,22,18,4,5,1,0,0,4
S01012073,Occupancy rating -1 or less,21,6,2,4,12,0,6,1,3,2,6,5,1,3,2,0,0,1
S01012074,All households,343,145,35,110,190,19,147,59,73,15,24,18,6,8,3,1,0,4
S01012074,Occupancy rating +2 or more,100,20,10,10,79,7,67,22,36,9,5,5,0,1,1,0,0,0
S01012074,Occupancy rating +1,130,74,16,58,55,10,44,31,12,1,1,0,1,1,0,0,0,1
S01012074,Occupancy rating 0,93,44,7,37,48,2,31,5,21,5,15,11,4,1,0,1,0,0
S01012074,Occupancy rating -1 or less,20,7,2,5,8,0,5,1,4,0,3,2,1,5,2,0,0,3
S01012075,All households,269,47,9,38,220,8,187,51,102,34,25,17,8,2,0,0,0,2
S01012075,Occupancy rating +2 or more,146,19,4,15,127,6,112,35,57,20,9,3,6,0,0,0,0,0
S01012075,Occupancy rating +1,66,16,3,13,50,0,43,13,23,7,7,6,1,0,0,0,0,0
S01012075,Occupancy rating 0,46,10,2,8,34,1,27,2,18,7,6,5,1,2,0,0,0,2
S01012075,Occupancy rating -1 or less,11,2,0,2,9,1,5,1,4,0,3,3,0,0,0,0,0,0
S01012076,All households,382,178,76,102,193,33,126,57,54,15,34,22,12,11,4,0,1,6
S01012076,Occupancy rating +2 or more,81,28,7,21,53,6,43,24,14,5,4,2,2,0,0,0,0,0
S01012076,Occupancy rating +1,93,42,20,22,48,10,33,13,15,5,5,3,2,3,0,0,1,2
S01012076,Occupancy rating 0,166,90,42,48,73,15,42,18,20,4,16,11,5,3,0,0,0,3
S01012076,Occupancy rating -1 or less,42,18,7,11,19,2,8,2,5,1,9,6,3,5,4,0,0,1
S01012077,All households,363,144,29,115,207,11,122,60,47,15,74,58,16,12,4,0,0,8
S01012077,Occupancy rating +2 or more,67,22,6,16,45,3,34,22,9,3,8,5,3,0,0,0,0,0
S01012077,Occupancy rating +1,107,54,12,42,51,6,38,22,13,3,7,6,1,2,0,0,0,2
S01012077,Occupancy rating 0,157,63,11,52,89,2,40,15,20,5,47,36,11,5,1,0,0,4
S01012077,Occupancy rating -1 or less,32,5,0,5,22,0,10,1,5,4,12,11,1,5,3,0,0,2
S01012078,All households,367,122,17,105,234,13,175,56,89,30,46,35,11,11,5,0,0,6
S01012078,Occupancy rating +2 or more,148,34,7,27,110,10,93,41,41,11,7,6,1,4,1,0,0,3
S01012078,Occupancy rating +1,90,40,6,34,47,2,36,12,15,9,9,8,1,3,1,0,0,2
S01012078,Occupancy rating 0,96,35,4,31,59,0,36,2,24,10,23,15,8,2,1,0,0,1
S01012078,Occupancy rating -1 or less,33,13,0,13,18,1,10,1,9,0,7,6,1,2,2,0,0,0
S01012079,All households,448,188,78,110,235,36,133,55,52,26,66,41,25,25,9,0,4,12
S01012079,Occupancy rating +2 or more,73,25,9,16,45,8,29,21,6,2,8,6,2,3,1,0,1,1
S01012079,Occupancy rating +1,140,69,36,33,66,20,40,24,11,5,6,1,5,5,0,0,1,4
S01012079,Occupancy rating 0,173,84,29,55,81,7,43,10,21,12,31,20,11,8,2,0,1,5
S01012079,Occupancy rating -1 or less,62,10,4,6,43,1,21,0,14,7,21,14,7,9,6,0,1,2
S01012080,All households,352,109,25,84,231,7,117,37,63,17,107,93,14,12,5,0,0,7
S01012080,Occupancy rating +2 or more,55,25,6,19,29,3,22,11,7,4,4,4,0,1,0,0,0,1
S01012080,Occupancy rating +1,113,44,10,34,66,2,37,21,11,5,27,22,5,3,0,0,0,3
S01012080,Occupancy rating 0,133,30,8,22,102,2,45,4,37,4,55,49,6,1,0,0,0,1
S01012080,Occupancy rating -1 or less,51,10,1,9,34,0,13,1,8,4,21,18,3,7,5,0,0,2
S01012081,All households,387,193,42,151,176,12,92,38,40,14,72,52,20,18,5,0,4,9
S01012081,Occupancy rating +2 or more,46,18,8,10,25,4,14,10,3,1,7,6,1,3,1,0,1,1
S01012081,Occupancy rating +1,93,51,17,34,38,7,22,13,4,5,9,3,6,4,0,0,2,2
S01012081,Occupancy rating 0,196,112,14,98,78,1,41,11,26,4,36,27,9,6,1,0,1,4
S01012081,Occupancy rating -1 or less,52,12,3,9,35,0,15,4,7,4,20,16,4,5,3,0,0,2
S01012082,All households,323,152,45,107,160,18,81,28,33,20,61,36,25,11,4,0,0,7
S01012082,Occupancy rating +2 or more,38,25,7,18,11,5,6,3,2,1,0,0,0,2,1,0,0,1
S01012082,Occupancy rating +1,119,69,26,43,49,11,28,17,6,5,10,3,7,1,0,0,0,1
S01012082,Occupancy rating 0,117,51,11,40,63,0,31,8,13,10,32,19,13,3,1,0,0,2
S01012082,Occupancy rating -1 or less,49,7,1,6,37,2,16,0,12,4,19,14,5,5,2,0,0,3
S01012083,All households,383,204,61,143,160,25,81,30,38,13,54,38,16,19,6,0,0,13
S01012083,Occupancy rating +2 or more,58,31,10,21,26,9,15,7,7,1,2,2,0,1,1,0,0,0
S01012083,Occupancy rating +1,124,78,27,51,43,15,21,13,6,2,7,2,5,3,1,0,0,2
S01012083,Occupancy rating 0,145,80,21,59,59,1,30,9,14,7,28,21,7,6,1,0,0,5
S01012083,Occupancy rating -1 or less,56,15,3,12,32,0,15,1,11,3,17,13,4,9,3,0,0,6
S01012084,All households,238,54,32,22,177,27,120,44,48,28,30,15,15,7,4,0,0,3
S01012084,Occupancy rating +2 or more,75,19,13,6,56,17,34,23,7,4,5,4,1,0,0,0,0,0
S01012084,Occupancy rating +1,88,22,13,9,65,8,50,17,20,13,7,5,2,1,0,0,0,1
S01012084,Occupancy rating 0,60,12,5,7,45,2,29,3,17,9,14,4,10,3,1,0,0,2
S01012084,Occupancy rating -1 or less,15,1,1,0,11,0,7,1,4,2,4,2,2,3,3,0,0,0
S01012085,All households,301,102,44,58,189,32,136,48,49,39,21,8,13,10,6,0,0,4
S01012085,Occupancy rating +2 or more,130,40,22,18,88,21,64,34,20,10,3,1,2,2,1,0,0,1
S01012085,Occupancy rating +1,82,28,9,19,53,9,39,9,10,20,5,0,5,1,0,0,0,1
S01012085,Occupancy rating 0,71,31,13,18,39,2,26,2,15,9,11,6,5,1,1,0,0,0
S01012085,Occupancy rating -1 or less,18,3,0,3,9,0,7,3,4,0,2,1,1,6,4,0,0,2
S01012086,All households,448,175,60,115,255,33,131,44,51,36,91,60,31,18,10,0,0,8
S01012086,Occupancy rating +2 or more,110,47,22,25,62,16,38,24,7,7,8,4,4,1,1,0,0,0
S01012086,Occupancy rating +1,119,43,18,25,75,11,39,10,20,9,25,15,10,1,0,0,0,1
S01012086,Occupancy rating 0,153,58,16,42,87,3,44,9,17,18,40,30,10,8,5,0,0,3
S01012086,Occupancy rating -1 or less,66,27,4,23,31,3,10,1,7,2,18,11,7,8,4,0,0,4
S01012087,All households,364,155,69,86,200,41,106,38,42,26,53,38,15,9,6,0,0,3
S01012087,Occupancy rating +2 or more,80,36,20,16,43,11,30,17,7,6,2,1,1,1,1,0,0,0
S01012087,Occupancy rating +1,120,49,28,21,68,23,34,14,14,6,11,9,2,3,1,0,0,2
S01012087,Occupancy rating 0,112,48,14,34,62,6,28,6,12,10,28,21,7,2,2,0,0,0
S01012087,Occupancy rating -1 or less,52,22,7,15,27,1,14,1,9,4,12,7,5,3,2,0,0,1
S01012088,All households,286,75,15,60,201,14,156,43,97,16,31,19,12,10,6,0,0,4
S01012088,Occupancy rating +2 or more,126,19,3,16,105,10,84,29,48,7,11,5,6,2,2,0,0,0
S01012088,Occupancy rating +1,100,48,11,37,51,3,42,11,24,7,6,5,1,1,0,0,0,1
S01012088,Occupancy rating 0,47,6,1,5,37,1,27,2,23,2,9,7,2,4,2,0,0,2
S01012088,Occupancy rating -1 or less,13,2,0,2,8,0,3,1,2,0,5,2,3,3,2,0,0,1
S01012089,All households,357,107,29,78,240,33,185,60,78,47,22,17,5,10,5,0,1,4
S01012089,Occupancy rating +2 or more,198,40,25,15,154,31,115,52,37,26,8,7,1,4,1,0,1,2
S01012089,Occupancy rating +1,63,17,1,16,46,1,41,3,25,13,4,2,2,0,0,0,0,0
S01012089,Occupancy rating 0,85,48,3,45,34,1,25,5,12,8,8,6,2,3,2,0,0,1
S01012089,Occupancy rating -1 or less,11,2,0,2,6,0,4,0,4,0,2,2,0,3,2,0,0,1
S01012090,All households,356,63,32,31,285,52,214,95,77,42,19,8,11,8,3,0,0,5
S01012090,Occupancy rating +2 or more,266,53,28,25,208,46,157,86,45,26,5,0,5,5,2,0,0,3
S01012090,Occupancy rating +1,57,7,3,4,50,5,37,8,20,9,8,4,4,0,0,0,0,0
S01012090,Occupancy rating 0,27,3,1,2,23,1,18,1,10,7,4,2,2,1,1,0,0,0
S01012090,Occupancy rating -1 or less,6,0,0,0,4,0,2,0,2,0,2,2,0,2,0,0,0,2
S01012091,All households,244,78,31,47,161,25,111,42,43,26,25,14,11,5,3,0,0,2
S01012091,Occupancy rating +2 or more,81,24,12,12,56,16,36,21,9,6,4,2,2,1,0,0,0,1
S01012091,Occupancy rating +1,91,38,18,20,52,9,36,16,12,8,7,3,4,1,1,0,0,0
S01012091,Occupancy rating 0,55,11,1,10,42,0,30,3,18,9,12,7,5,2,1,0,0,1
S01012091,Occupancy rating -1 or less,17,5,0,5,11,0,9,2,4,3,2,2,0,1,1,0,0,0
S01012092,All households,214,54,18,36,149,26,113,46,39,28,10,6,4,11,3,0,1,7
S01012092,Occupancy rating +2 or more,91,16,7,9,74,20,53,26,19,8,1,0,1,1,0,0,1,0
S01012092,Occupancy rating +1,75,28,7,21,43,6,36,17,8,11,1,0,1,4,0,0,0,4
S01012092,Occupancy rating 0,32,5,1,4,26,0,20,2,9,9,6,5,1,1,1,0,0,0
S01012092,Occupancy rating -1 or less,16,5,3,2,6,0,4,1,3,0,2,1,1,5,2,0,0,3
S01012093,All households,295,148,41,107,143,29,99,42,37,20,15,8,7,4,1,0,2,1
S01012093,Occupancy rating +2 or more,86,32,13,19,53,7,43,20,12,11,3,2,1,1,1,0,0,0
S01012093,Occupancy rating +1,111,60,18,42,51,15,31,15,11,5,5,2,3,0,0,0,0,0
S01012093,Occupancy rating 0,87,51,9,42,33,7,20,6,11,3,6,4,2,3,0,0,2,1
S01012093,Occupancy rating -1 or less,11,5,1,4,6,0,5,1,3,1,1,0,1,0,0,0,0,0
S01012094,All households,317,76,37,39,230,43,167,69,62,36,20,8,12,11,3,0,1,7
S01012094,Occupancy rating +2 or more,237,53,29,24,178,40,129,63,39,27,9,5,4,6,0,0,1,5
S01012094,Occupancy rating +1,50,18,5,13,31,3,23,4,12,7,5,0,5,1,1,0,0,0
S01012094,Occupancy rating 0,24,5,3,2,17,0,13,2,9,2,4,2,2,2,1,0,0,1
S01012094,Occupancy rating -1 or less,6,0,0,0,4,0,2,0,2,0,2,1,1,2,1,0,0,1
S01012095,All households,410,106,24,82,287,16,208,54,108,46,63,46,17,17,11,0,0,6
S01012095,Occupancy rating +2 or more,172,44,12,32,125,10,108,38,47,23,7,3,4,3,1,0,0,2
S01012095,Occupancy rating +1,134,54,10,44,76,6,54,14,27,13,16,12,4,4,3,0,0,1
S01012095,Occupancy rating 0,74,3,0,3,63,0,34,2,27,5,29,23,6,8,6,0,0,2
S01012095,Occupancy rating -1 or less,30,5,2,3,23,0,12,0,7,5,11,8,3,2,1,0,0,1
S01012096,All households,388,128,63,65,233,32,128,46,52,30,73,46,27,27,10,0,2,15
S01012096,Occupancy rating +2 or more,83,40,17,23,39,9,30,27,2,1,0,0,0,4,1,0,1,2
S01012096,Occupancy rating +1,138,46,29,17,86,19,49,15,20,14,18,8,10,6,1,0,1,4
S01012096,Occupancy rating 0,116,34,11,23,75,3,37,3,22,12,35,21,14,7,4,0,0,3
S01012096,Occupancy rating -1 or less,51,8,6,2,33,1,12,1,8,3,20,17,3,10,4,0,0,6
S01012097,All households,279,59,33,26,207,27,126,50,53,23,54,36,18,13,6,0,2,5
S01012097,Occupancy rating +2 or more,66,19,11,8,47,12,34,24,6,4,1,0,1,0,0,0,0,0
S01012097,Occupancy rating +1,102,36,18,18,64,13,40,21,15,4,11,6,5,2,0,0,1,1
S01012097,Occupancy rating 0,74,1,1,0,68,2,37,5,21,11,29,19,10,5,1,0,1,3
S01012097,Occupancy rating -1 or less,37,3,3,0,28,0,15,0,11,4,13,11,2,6,5,0,0,1
S01012098,All households,277,86,39,47,174,15,94,35,39,20,65,43,22,17,7,0,1,9
S01012098,Occupancy rating +2 or more,73,34,13,21,37,9,24,19,4,1,4,1,3,2,0,0,0,2
S01012098,Occupancy rating +1,94,39,19,20,52,5,35,15,11,9,12,8,4,3,0,0,1,2
S01012098,Occupancy rating 0,75,9,6,3,60,1,24,0,17,7,35,25,10,6,2,0,0,4
S01012098,Occupancy rating -1 or less,35,4,1,3,25,0,11,1,7,3,14,9,5,6,5,0,0,1
S01012099,All households,348,122,54,68,208,26,103,30,46,27,79,46,33,18,10,0,0,8
S01012099,Occupancy rating +2 or more,70,38,14,24,32,8,17,13,3,1,7,3,4,0,0,0,0,0
S01012099,Occupancy rating +1,118,47,13,34,67,11,37,15,9,13,19,7,12,4,2,0,0,2
S01012099,Occupancy rating 0,116,29,23,6,82,6,33,2,23,8,43,28,15,5,0,0,0,5
S01012099,Occupancy rating -1 or less,44,8,4,4,27,1,16,0,11,5,10,8,2,9,8,0,0,1
S01012100,All households,493,170,90,80,296,40,168,71,65,32,88,49,39,27,10,0,2,15
S01012100,Occupancy rating +2 or more,116,44,16,28,70,14,50,33,11,6,6,0,6,2,1,0,0,1
S01012100,Occupancy rating +1,161,77,41,36,82,18,47,26,12,9,17,9,8,2,0,0,0,2
S01012100,Occupancy rating 0,153,39,26,13,102,6,52,10,30,12,44,29,15,12,2,0,2,8
S01012100,Occupancy rating -1 or less,63,10,7,3,42,2,19,2,12,5,21,11,10,11,7,0,0,4
S01012101,All households,311,68,40,28,233,40,164,54,73,37,29,11,18,10,2,0,1,7
S01012101,Occupancy rating +2 or more,223,51,33,18,167,37,119,48,46,25,11,3,8,5,0,0,0,5
S01012101,Occupancy rating +1,52,14,7,7,38,3,28,6,14,8,7,3,4,0,0,0,0,0
S01012101,Occupancy rating 0,28,3,0,3,23,0,14,0,11,3,9,3,6,2,0,0,1,1
S01012101,Occupancy rating -1 or less,8,0,0,0,5,0,3,0,2,1,2,2,0,3,2,0,0,1
S01012102,All households,319,122,26,96,182,8,92,31,45,16,82,68,14,15,3,4,0,8
S01012102,Occupancy rating +2 or more,42,15,5,10,25,2,19,13,3,3,4,4,0,2,0,0,0,2
S01012102,Occupancy rating +1,102,57,16,41,44,3,29,14,9,6,12,8,4,1,0,0,0,1
S01012102,Occupancy rating 0,136,45,4,41,83,3,32,3,22,7,48,40,8,8,0,3,0,5
S01012102,Occupancy rating -1 or less,39,5,1,4,30,0,12,1,11,0,18,16,2,4,3,1,0,0
S01012103,All households,425,147,31,116,267,27,177,65,79,33,63,38,25,11,5,0,0,6
S01012103,Occupancy rating +2 or more,113,38,7,31,75,9,64,32,24,8,2,1,1,0,0,0,0,0
S01012103,Occupancy rating +1,163,74,21,53,86,16,56,25,22,9,14,11,3,3,1,0,0,2
S01012103,Occupancy rating 0,108,29,3,26,75,1,38,4,23,11,36,19,17,4,1,0,0,3
S01012103,Occupancy rating -1 or less,41,6,0,6,31,1,19,4,10,5,11,7,4,4,3,0,0,1
S01012104,All households,345,70,28,42,267,16,221,68,128,25,30,25,5,8,1,0,2,5
S01012104,Occupancy rating +2 or more,234,36,16,20,195,13,170,59,92,19,12,10,2,3,0,0,1,2
S01012104,Occupancy rating +1,63,18,6,12,42,3,33,3,25,5,6,5,1,3,1,0,0,2
S01012104,Occupancy rating 0,40,14,5,9,25,0,15,6,8,1,10,8,2,1,0,0,0,1
S01012104,Occupancy rating -1 or less,8,2,1,1,5,0,3,0,3,0,2,2,0,1,0,0,1,0
S01012105,All households,492,165,69,96,303,37,224,86,92,46,42,27,15,24,8,0,1,15
S01012105,Occupancy rating +2 or more,210,39,14,25,160,22,129,46,61,22,9,7,2,11,3,0,1,7
S01012105,Occupancy rating +1,116,57,31,26,56,8,43,25,9,9,5,4,1,3,1,0,0,2
S01012105,Occupancy rating 0,130,57,21,36,68,7,39,11,16,12,22,15,7,5,1,0,0,4
S01012105,Occupancy rating -1 or less,36,12,3,9,19,0,13,4,6,3,6,1,5,5,3,0,0,2
S01012106,All households,497,182,45,137,306,41,234,84,120,30,31,18,13,9,5,0,0,4
S01012106,Occupancy rating +2 or more,177,26,6,20,146,13,124,37,72,15,9,4,5,5,2,0,0,3
S01012106,Occupancy rating +1,200,110,26,84,89,19,65,37,19,9,5,3,2,1,1,0,0,0
S01012106,Occupancy rating 0,106,44,13,31,59,7,39,9,24,6,13,10,3,3,2,0,0,1
S01012106,Occupancy rating -1 or less,14,2,0,2,12,2,6,1,5,0,4,1,3,0,0,0,0,0
S01012107,All households,279,97,30,67,171,25,139,52,57,30,7,4,3,11,4,0,1,6
S01012107,Occupancy rating +2 or more,186,54,21,33,124,24,99,42,40,17,1,0,1,8,3,0,0,5
S01012107,Occupancy rating +1,36,11,2,9,25,1,22,8,5,9,2,0,2,0,0,0,0,0
S01012107,Occupancy rating 0,43,24,7,17,17,0,15,2,9,4,2,2,0,2,1,0,1,0
S01012107,Occupancy rating -1 or less,14,8,0,8,5,0,3,0,3,0,2,2,0,1,0,0,0,1
S01012108,All households,632,424,229,195,193,59,76,43,21,12,58,19,39,15,2,1,3,9
S01012108,Occupancy rating +2 or more,40,20,10,10,18,4,8,5,1,2,6,2,4,2,1,0,0,1
S01012108,Occupancy rating +1,276,206,109,97,69,36,30,22,6,2,3,1,2,1,0,0,0,1
S01012108,Occupancy rating 0,246,149,90,59,88,18,32,15,10,7,38,12,26,9,0,1,1,7
S01012108,Occupancy rating -1 or less,70,49,20,29,18,1,6,1,4,1,11,4,7,3,1,0,2,0
S01012109,All households,560,331,54,277,204,14,113,58,42,13,77,68,9,25,6,3,1,15
S01012109,Occupancy rating +2 or more,75,48,9,39,27,4,19,12,5,2,4,3,1,0,0,0,0,0
S01012109,Occupancy rating +1,149,93,20,73,52,6,29,14,12,3,17,13,4,4,0,0,0,4
S01012109,Occupancy rating 0,254,147,19,128,91,3,56,31,20,5,32,30,2,16,5,1,1,9
S01012109,Occupancy rating -1 or less,82,43,6,37,34,1,9,1,5,3,24,22,2,5,1,2,0,2
S01012110,All households,458,288,110,178,160,28,99,62,27,10,33,23,10,10,3,0,2,5
S01012110,Occupancy rating +2 or more,32,20,9,11,12,2,10,5,3,2,0,0,0,0,0,0,0,0
S01012110,Occupancy rating +1,155,105,49,56,49,14,32,26,4,2,3,3,0,1,0,0,0,1
S01012110,Occupancy rating 0,209,126,46,80,78,9,50,29,16,5,19,11,8,5,1,0,2,2
S01012110,Occupancy rating -1 or less,62,37,6,31,21,3,7,2,4,1,11,9,2,4,2,0,0,2
S01012111,All households,309,183,53,130,110,8,69,26,31,12,33,24,9,16,8,1,1,6
S01012111,Occupancy rating +2 or more,43,23,7,16,18,2,15,12,2,1,1,0,1,2,1,0,0,1
S01012111,Occupancy rating +1,87,51,11,40,34,3,23,3,14,6,8,4,4,2,1,0,0,1
S01012111,Occupancy rating 0,137,93,31,62,39,3,20,9,7,4,16,13,3,5,2,1,1,1
S01012111,Occupancy rating -1 or less,42,16,4,12,19,0,11,2,8,1,8,7,1,7,4,0,0,3
S01012112,All households,423,226,130,96,191,42,119,62,34,23,30,14,16,6,6,0,0,0
S01012112,Occupancy rating +2 or more,82,20,11,9,60,15,45,19,14,12,0,0,0,2,2,0,0,0
S01012112,Occupancy rating +1,142,88,58,30,52,17,31,25,5,1,4,2,2,2,2,0,0,0
S01012112,Occupancy rating 0,163,97,50,47,66,9,36,18,10,8,21,9,12,0,0,0,0,0
S01012112,Occupancy rating -1 or less,36,21,11,10,13,1,7,0,5,2,5,3,2,2,2,0,0,0
S01012113,All households,511,228,107,121,273,58,179,77,76,26,36,23,13,10,1,1,3,5
S01012113,Occupancy rating +2 or more,154,58,27,31,95,31,64,39,21,4,0,0,0,1,0,0,0,1
S01012113,Occupancy rating +1,154,69,35,34,83,15,52,22,22,8,16,10,6,2,0,0,0,2
S01012113,Occupancy rating 0,170,89,40,49,75,10,52,15,25,12,13,8,5,6,1,1,2,2
S01012113,Occupancy rating -1 or less,33,12,5,7,20,2,11,1,8,2,7,5,2,1,0,0,1,0
S01012114,All households,357,114,52,62,237,38,170,58,82,30,29,18,11,6,0,0,2,4
S01012114,Occupancy rating +2 or more,205,49,30,19,154,28,113,42,51,20,13,9,4,2,0,0,2,0
S01012114,Occupancy rating +1,88,46,20,26,39,9,27,11,14,2,3,1,2,3,0,0,0,3
S01012114,Occupancy rating 0,52,17,2,15,34,0,24,4,13,7,10,5,5,1,0,0,0,1
S01012114,Occupancy rating -1 or less,12,2,0,2,10,1,6,1,4,1,3,3,0,0,0,0,0,0
S01012115,All households,257,99,48,51,152,29,78,31,35,12,45,24,21,6,3,0,0,3
S01012115,Occupancy rating +2 or more,59,24,14,10,33,14,14,9,2,3,5,4,1,2,2,0,0,0
S01012115,Occupancy rating +1,86,30,17,13,56,11,34,17,14,3,11,5,6,0,0,0,0,0
S01012115,Occupancy rating 0,86,35,13,22,49,3,25,3,16,6,21,11,10,2,0,0,0,2
S01012115,Occupancy rating -1 or less,26,10,4,6,14,1,5,2,3,0,8,4,4,2,1,0,0,1
S01012116,All households,283,108,51,57,166,37,98,37,51,10,31,22,9,9,3,1,0,5
S01012116,Occupancy rating +2 or more,77,28,17,11,48,20,26,18,6,2,2,2,0,1,1,0,0,0
S01012116,Occupancy rating +1,96,41,22,19,54,15,32,16,15,1,7,3,4,1,0,0,0,1
S01012116,Occupancy rating 0,79,33,11,22,42,2,25,2,18,5,15,12,3,4,1,0,0,3
S01012116,Occupancy rating -1 or less,31,6,1,5,22,0,15,1,12,2,7,5,2,3,1,1,0,1
S01012117,All households,289,54,15,39,229,9,204,54,134,16,16,13,3,6,5,0,0,1
S01012117,Occupancy rating +2 or more,136,15,3,12,118,5,112,25,80,7,1,1,0,3,3,0,0,0
S01012117,Occupancy rating +1,89,19,3,16,69,4,59,26,28,5,6,5,1,1,0,0,0,1
S01012117,Occupancy rating 0,57,19,9,10,36,0,29,3,23,3,7,5,2,2,2,0,0,0
S01012117,Occupancy rating -1 or less,7,1,0,1,6,0,4,0,3,1,2,2,0,0,0,0,0,0
S01012118,All households,226,35,1,34,182,13,155,42,89,24,14,10,4,9,5,0,0,4
S01012118,Occupancy rating +2 or more,124,17,0,17,103,9,90,35,46,9,4,4,0,4,0,0,0,4
S01012118,Occupancy rating +1,62,14,0,14,47,3,38,6,22,10,6,3,3,1,1,0,0,0
S01012118,Occupancy rating 0,32,2,1,1,28,1,24,0,20,4,3,2,1,2,2,0,0,0
S01012118,Occupancy rating -1 or less,8,2,0,2,4,0,3,1,1,1,1,1,0,2,2,0,0,0
S01012119,All households,349,61,29,32,278,44,209,77,94,38,25,12,13,10,8,0,0,2
S01012119,Occupancy rating +2 or more,221,46,23,23,172,39,125,68,41,16,8,2,6,3,2,0,0,1
S01012119,Occupancy rating +1,80,9,3,6,69,2,58,7,38,13,9,6,3,2,2,0,0,0
S01012119,Occupancy rating 0,36,5,2,3,27,2,21,2,12,7,4,1,3,4,3,0,0,1
S01012119,Occupancy rating -1 or less,12,1,1,0,10,1,5,0,3,2,4,3,1,1,1,0,0,0
S01012120,All households,256,87,28,59,157,18,94,36,42,16,45,31,14,12,8,0,0,4
S01012120,Occupancy rating +2 or more,79,37,19,18,42,11,26,20,4,2,5,3,2,0,0,0,0,0
S01012120,Occupancy rating +1,80,32,7,25,46,6,31,8,13,10,9,4,5,2,0,0,0,2
S01012120,Occupancy rating 0,55,10,1,9,41,1,18,2,13,3,22,19,3,4,3,0,0,1
S01012120,Occupancy rating -1 or less,42,8,1,7,28,0,19,6,12,1,9,5,4,6,5,0,0,1
S01012121,All households,404,141,62,79,245,31,148,57,61,30,66,47,19,18,12,0,0,6
S01012121,Occupancy rating +2 or more,118,54,31,23,63,16,44,36,7,1,3,3,0,1,1,0,0,0
S01012121,Occupancy rating +1,121,41,17,24,77,9,49,11,20,18,19,8,11,3,1,0,0,2
S01012121,Occupancy rating 0,105,29,7,22,74,5,39,7,23,9,30,24,6,2,1,0,0,1
S01012121,Occupancy rating -1 or less,60,17,7,10,31,1,16,3,11,2,14,12,2,12,9,0,0,3
S01012122,All households,318,89,41,48,211,30,129,36,44,49,52,26,26,18,8,0,2,8
S01012122,Occupancy rating +2 or more,125,66,30,36,58,21,35,28,3,4,2,1,1,1,1,0,0,0
S01012122,Occupancy rating +1,108,19,9,10,85,9,52,8,17,27,24,9,15,4,0,0,1,3
S01012122,Occupancy rating 0,55,3,2,1,44,0,31,0,20,11,13,9,4,8,3,0,1,4
S01012122,Occupancy rating -1 or less,30,1,0,1,24,0,11,0,4,7,13,7,6,5,4,0,0,1
S01012123,All households,212,71,18,53,129,15,85,23,37,25,29,16,13,12,4,0,1,7
S01012123,Occupancy rating +2 or more,80,26,13,13,52,12,38,13,15,10,2,1,1,2,1,0,1,0
S01012123,Occupancy rating +1,53,21,2,19,31,3,20,7,6,7,8,3,5,1,0,0,0,1
S01012123,Occupancy rating 0,55,11,1,10,36,0,20,2,12,6,16,10,6,8,2,0,0,6
S01012123,Occupancy rating -1 or less,24,13,2,11,10,0,7,1,4,2,3,2,1,1,1,0,0,0
S01012124,All households,262,109,16,93,141,11,101,56,30,15,29,19,10,12,4,2,0,6
S01012124,Occupancy rating +2 or more,41,12,5,7,29,8,20,16,1,3,1,0,1,0,0,0,0,0
S01012124,Occupancy rating +1,89,39,4,35,46,3,37,26,3,8,6,3,3,4,1,0,0,3
S01012124,Occupancy rating 0,99,43,7,36,51,0,34,11,20,3,17,12,5,5,2,1,0,2
S01012124,Occupancy rating -1 or less,33,15,0,15,15,0,10,3,6,1,5,4,1,3,1,1,0,1
S01012125,All households,504,318,78,240,172,6,90,52,31,7,76,55,21,14,4,1,1,8
S01012125,Occupancy rating +2 or more,30,16,7,9,13,2,10,9,1,0,1,0,1,1,0,0,0,1
S01012125,Occupancy rating +1,109,71,21,50,38,2,27,17,7,3,9,5,4,0,0,0,0,0
S01012125,Occupancy rating 0,255,153,21,132,94,1,47,25,18,4,46,34,12,8,1,0,1,6
S01012125,Occupancy rating -1 or less,110,78,29,49,27,1,6,1,5,0,20,16,4,5,3,1,0,1
S01012126,All households,389,191,16,175,179,6,147,73,54,20,26,18,8,19,7,3,1,8
S01012126,Occupancy rating +2 or more,95,37,3,34,56,4,45,28,12,5,7,3,4,2,2,0,0,0
S01012126,Occupancy rating +1,123,57,2,55,59,2,52,23,23,6,5,3,2,7,0,1,0,6
S01012126,Occupancy rating 0,121,69,5,64,46,0,42,18,16,8,4,4,0,6,3,1,0,2
S01012126,Occupancy rating -1 or less,50,28,6,22,18,0,8,4,3,1,10,8,2,4,2,1,1,0
S01012127,All households,552,361,35,326,163,10,105,63,33,9,48,36,12,28,1,8,1,18
S01012127,Occupancy rating +2 or more,34,23,2,21,11,0,7,6,0,1,4,2,2,0,0,0,0,0
S01012127,Occupancy rating +1,151,102,16,86,47,5,37,31,2,4,5,2,3,2,0,0,0,2
S01012127,Occupancy rating 0,256,178,12,166,71,4,43,20,21,2,24,22,2,7,0,2,0,5
S01012127,Occupancy rating -1 or less,111,58,5,53,34,1,18,6,10,2,15,10,5,19,1,6,1,11
S01012128,All households,278,118,17,101,139,3,81,51,22,8,55,44,11,21,1,2,1,17
S01012128,Occupancy rating +2 or more,23,9,1,8,14,2,11,6,3,2,1,0,1,0,0,0,0,0
S01012128,Occupancy rating +1,92,47,7,40,42,1,33,27,2,4,8,5,3,3,0,0,1,2
S01012128,Occupancy rating 0,120,55,8,47,58,0,31,15,14,2,27,22,5,7,0,2,0,5
S01012128,Occupancy rating -1 or less,43,7,1,6,25,0,6,3,3,0,19,17,2,11,1,0,0,10
S01012129,All households,440,273,54,219,154,15,87,56,22,9,52,33,19,13,4,0,1,8
S01012129,Occupancy rating +2 or more,55,28,9,19,26,5,18,16,0,2,3,1,2,1,0,0,1,0
S01012129,Occupancy rating +1,138,86,10,76,51,7,36,27,5,4,8,2,6,1,0,0,0,1
S01012129,Occupancy rating 0,183,119,28,91,60,2,25,9,13,3,33,24,9,4,1,0,0,3
S01012129,Occupancy rating -1 or less,64,40,7,33,17,1,8,4,4,0,8,6,2,7,3,0,0,4
S01012130,All households,687,464,174,290,208,38,138,83,46,9,32,18,14,15,3,0,2,10
S01012130,Occupancy rating +2 or more,59,28,11,17,28,2,23,13,7,3,3,2,1,3,0,0,1,2
S01012130,Occupancy rating +1,260,175,71,104,84,23,58,47,9,2,3,3,0,1,1,0,0,0
S01012130,Occupancy rating 0,308,226,82,144,76,9,49,22,25,2,18,10,8,6,0,0,1,5
S01012130,Occupancy rating -1 or less,60,35,10,25,20,4,8,1,5,2,8,3,5,5,2,0,0,3
S01012131,All households,610,382,66,316,202,27,114,70,30,14,61,44,17,26,3,6,0,17
S01012131,Occupancy rating +2 or more,59,30,5,25,29,5,22,20,2,0,2,2,0,0,0,0,0,0
S01012131,Occupancy rating +1,165,105,28,77,54,9,34,26,4,4,11,4,7,6,0,0,0,6
S01012131,Occupancy rating 0,289,200,29,171,79,9,41,19,16,6,29,22,7,10,1,3,0,6
S01012131,Occupancy rating -1 or less,97,47,4,43,40,4,17,5,8,4,19,16,3,10,2,3,0,5
S01012132,All households,426,246,36,210,141,14,77,49,23,5,50,41,9,39,6,14,0,19
S01012132,Occupancy rating +2 or more,41,26,5,21,12,2,8,6,2,0,2,1,1,3,0,1,0,2
S01012132,Occupancy rating +1,137,97,19,78,38,8,25,21,4,0,5,3,2,2,0,2,0,0
S01012132,Occupancy rating 0,181,98,11,87,64,2,29,16,9,4,33,30,3,19,2,7,0,10
S01012132,Occupancy rating -1 or less,67,25,1,24,27,2,15,6,8,1,10,7,3,15,4,4,0,7
S01012133,All households,421,234,26,208,166,6,125,63,48,14,35,27,8,21,6,1,0,14
S01012133,Occupancy rating +2 or more,59,26,6,20,32,1,27,16,7,4,4,3,1,1,1,0,0,0
S01012133,Occupancy rating +1,122,71,9,62,49,2,41,22,13,6,6,2,4,2,0,0,0,2
S01012133,Occupancy rating 0,155,81,8,73,65,3,46,18,26,2,16,14,2,9,1,0,0,8
S01012133,Occupancy rating -1 or less,85,56,3,53,20,0,11,7,2,2,9,8,1,9,4,1,0,4
S01012134,All households,606,297,136,161,289,59,187,103,53,31,43,31,12,20,4,5,2,9
S01012134,Occupancy rating +2 or more,139,35,15,20,101,16,76,46,18,12,9,6,3,3,0,1,0,2
S01012134,Occupancy rating +1,213,108,39,69,96,20,69,43,15,11,7,5,2,9,0,4,1,4
S01012134,Occupancy rating 0,215,135,71,64,76,20,36,13,16,7,20,13,7,4,1,0,0,3
S01012134,Occupancy rating -1 or less,39,19,11,8,16,3,6,1,4,1,7,7,0,4,3,0,1,0
S01012135,All households,570,380,76,304,170,7,82,47,27,8,81,55,26,20,7,2,2,9
S01012135,Occupancy rating +2 or more,26,14,3,11,10,1,7,5,2,0,2,1,1,2,2,0,0,0
S01012135,Occupancy rating +1,115,78,20,58,35,1,24,19,3,2,10,6,4,2,0,0,0,2
S01012135,Occupancy rating 0,297,203,39,164,87,5,34,15,14,5,48,33,15,7,0,1,2,4
S01012135,Occupancy rating -1 or less,132,85,14,71,38,0,17,8,8,1,21,15,6,9,5,1,0,3
S01012136,All households,516,325,28,297,160,2,95,49,38,8,63,42,21,31,1,16,0,14
S01012136,Occupancy rating +2 or more,14,8,0,8,6,1,4,1,3,0,1,0,1,0,0,0,0,0
S01012136,Occupancy rating +1,99,78,9,69,20,0,15,14,0,1,5,1,4,1,0,0,0,1
S01012136,Occupancy rating 0,274,171,16,155,92,1,55,28,22,5,36,29,7,11,0,5,0,6
S01012136,Occupancy rating -1 or less,129,68,3,65,42,0,21,6,13,2,21,12,9,19,1,11,0,7
S01012137,All households,463,309,105,204,142,18,76,46,21,9,48,36,12,12,1,1,1,9
S01012137,Occupancy rating +2 or more,38,25,6,19,13,0,12,6,3,3,1,0,1,0,0,0,0,0
S01012137,Occupancy rating +1,130,91,39,52,39,5,26,22,3,1,8,3,5,0,0,0,0,0
S01012137,Occupancy rating 0,236,156,55,101,71,11,31,16,11,4,29,24,5,9,0,1,1,7
S01012137,Occupancy rating -1 or less,59,37,5,32,19,2,7,2,4,1,10,9,1,3,1,0,0,2
S01012138,All households,460,209,81,128,228,31,162,71,67,24,35,20,15,23,7,8,2,6
S01012138,Occupancy rating +2 or more,134,33,18,15,95,13,75,29,35,11,7,3,4,6,3,0,0,3
S01012138,Occupancy rating +1,170,96,50,46,67,14,49,30,16,3,4,3,1,7,0,7,0,0
S01012138,Occupancy rating 0,126,68,10,58,52,4,30,11,11,8,18,11,7,6,1,1,1,3
S01012138,Occupancy rating -1 or less,30,12,3,9,14,0,8,1,5,2,6,3,3,4,3,0,1,0
S01012139,All households,462,192,113,79,256,26,183,73,75,35,47,25,22,14,3,4,0,7
S01012139,Occupancy rating +2 or more,114,37,19,18,73,8,62,30,23,9,3,2,1,4,0,2,0,2
S01012139,Occupancy rating +1,154,74,44,30,76,10,61,32,20,9,5,3,2,4,0,2,0,2
S01012139,Occupancy rating 0,160,68,43,25,90,7,50,11,29,10,33,15,18,2,0,0,0,2
S01012139,Occupancy rating -1 or less,34,13,7,6,17,1,10,0,3,7,6,5,1,4,3,0,0,1
S01012140,All households,205,38,20,18,156,27,119,44,49,26,10,6,4,11,2,1,1,7
S01012140,Occupancy rating +2 or more,153,26,14,12,122,25,92,41,32,19,5,3,2,5,1,0,1,3
S01012140,Occupancy rating +1,35,10,6,4,23,2,19,3,11,5,2,0,2,2,0,1,0,1
S01012140,Occupancy rating 0,12,1,0,1,8,0,6,0,4,2,2,2,0,3,1,0,0,2
S01012140,Occupancy rating -1 or less,5,1,0,1,3,0,2,0,2,0,1,1,0,1,0,0,0,1
S01012141,All households,412,102,60,42,301,50,213,65,103,45,38,21,17,9,7,0,0,2
S01012141,Occupancy rating +2 or more,243,57,39,18,181,41,127,56,50,21,13,6,7,5,4,0,0,1
S01012141,Occupancy rating +1,114,35,16,19,77,8,55,8,33,14,14,9,5,2,2,0,0,0
S01012141,Occupancy rating 0,39,7,5,2,32,1,22,1,15,6,9,4,5,0,0,0,0,0
S01012141,Occupancy rating -1 or less,16,3,0,3,11,0,9,0,5,4,2,2,0,2,1,0,0,1
S01012142,All households,395,94,66,28,280,58,197,71,87,39,25,16,9,21,10,0,1,10
S01012142,Occupancy rating +2 or more,277,66,46,20,200,51,139,60,54,25,10,6,4,11,4,0,1,6
S01012142,Occupancy rating +1,74,23,16,7,48,6,35,11,18,6,7,5,2,3,2,0,0,1
S01012142,Occupancy rating 0,32,4,3,1,24,1,17,0,12,5,6,3,3,4,1,0,0,3
S01012142,Occupancy rating -1 or less,12,1,1,0,8,0,6,0,3,3,2,2,0,3,3,0,0,0
S01012143,All households,376,114,80,34,252,56,177,59,68,50,19,11,8,10,3,0,2,5
S01012143,Occupancy rating +2 or more,272,71,59,12,194,50,130,50,44,36,14,7,7,7,2,0,1,4
S01012143,Occupancy rating +1,81,41,20,21,40,6,33,9,15,9,1,1,0,0,0,0,0,0
S01012143,Occupancy rating 0,20,2,1,1,16,0,12,0,7,5,4,3,1,2,0,0,1,1
S01012143,Occupancy rating -1 or less,3,0,0,0,2,0,2,0,2,0,0,0,0,1,1,0,0,0
S01012144,All households,449,130,90,40,305,55,216,71,100,45,34,17,17,14,4,2,1,7
S01012144,Occupancy rating +2 or more,261,69,51,18,188,44,133,58,54,21,11,4,7,4,2,0,0,2
S01012144,Occupancy rating +1,124,52,34,18,67,9,51,11,25,15,7,5,2,5,0,2,0,3
S01012144,Occupancy rating 0,46,5,2,3,39,2,27,1,19,7,10,4,6,2,1,0,0,1
S01012144,Occupancy rating -1 or less,18,4,3,1,11,0,5,1,2,2,6,4,2,3,1,0,1,1
S01012145,All households,399,91,61,30,293,51,213,66,108,39,29,19,10,15,7,0,3,5
S01012145,Occupancy rating +2 or more,315,75,56,19,232,47,169,61,83,25,16,8,8,8,3,0,2,3
S01012145,Occupancy rating +1,64,16,5,11,43,3,32,5,19,8,8,6,2,5,3,0,1,1
S01012145,Occupancy rating 0,16,0,0,0,15,1,10,0,6,4,4,4,0,1,1,0,0,0
S01012145,Occupancy rating -1 or less,4,0,0,0,3,0,2,0,0,2,1,1,0,1,0,0,0,1
S01012146,All households,572,308,112,196,233,27,112,58,42,12,94,64,30,31,7,13,0,11
S01012146,Occupancy rating +2 or more,52,37,14,23,15,3,11,10,0,1,1,1,0,0,0,0,0,0
S01012146,Occupancy rating +1,212,137,36,101,74,16,43,32,8,3,15,5,10,1,0,0,0,1
S01012146,Occupancy rating 0,246,121,55,66,103,8,40,13,22,5,55,38,17,22,1,13,0,8
S01012146,Occupancy rating -1 or less,62,13,7,6,41,0,18,3,12,3,23,20,3,8,6,0,0,2
S01012147,All households,407,191,65,126,194,17,85,40,30,15,92,61,31,22,3,0,2,17
S01012147,Occupancy rating +2 or more,43,28,15,13,15,6,8,6,1,1,1,0,1,0,0,0,0,0
S01012147,Occupancy rating +1,165,103,28,75,54,10,33,25,4,4,11,5,6,8,1,0,1,6
S01012147,Occupancy rating 0,157,53,20,33,95,0,33,9,18,6,62,41,21,9,1,0,1,7
S01012147,Occupancy rating -1 or less,42,7,2,5,30,1,11,0,7,4,18,15,3,5,1,0,0,4
S01012148,All households,364,133,43,90,219,18,103,45,40,18,98,72,26,12,4,0,0,8
S01012148,Occupancy rating +2 or more,27,17,6,11,10,8,2,1,1,0,0,0,0,0,0,0,0,0
S01012148,Occupancy rating +1,158,93,27,66,63,8,44,37,3,4,11,6,5,2,0,0,0,2
S01012148,Occupancy rating 0,129,21,10,11,103,2,46,4,31,11,55,39,16,5,0,0,0,5
S01012148,Occupancy rating -1 or less,50,2,0,2,43,0,11,3,5,3,32,27,5,5,4,0,0,1
S01012149,All households,335,106,24,82,207,16,148,58,58,32,43,33,10,22,12,0,1,9
S01012149,Occupancy rating +2 or more,121,25,8,17,90,8,78,36,28,14,4,2,2,6,3,0,0,3
S01012149,Occupancy rating +1,93,49,11,38,40,7,25,17,3,5,8,6,2,4,0,0,1,3
S01012149,Occupancy rating 0,92,30,4,26,59,1,30,5,16,9,28,23,5,3,1,0,0,2
S01012149,Occupancy rating -1 or less,29,2,1,1,18,0,15,0,11,4,3,2,1,9,8,0,0,1
S01012150,All households,359,133,63,70,208,28,114,37,48,29,66,46,20,18,6,0,1,11
S01012150,Occupancy rating +2 or more,68,35,13,22,31,6,19,12,6,1,6,4,2,2,0,0,0,2
S01012150,Occupancy rating +1,125,51,29,22,68,16,37,18,9,10,15,8,7,6,0,0,1,5
S01012150,Occupancy rating 0,123,39,15,24,78,4,43,4,24,15,31,24,7,6,2,0,0,4
S01012150,Occupancy rating -1 or less,43,8,6,2,31,2,15,3,9,3,14,10,4,4,4,0,0,0
S01012151,All households,397,198,84,114,184,33,101,34,47,20,50,36,14,15,7,0,1,7
S01012151,Occupancy rating +2 or more,116,57,24,33,59,19,36,23,4,9,4,3,1,0,0,0,0,0
S01012151,Occupancy rating +1,107,52,24,28,54,10,30,7,18,5,14,10,4,1,1,0,0,0
S01012151,Occupancy rating 0,122,64,20,44,51,3,26,4,19,3,22,15,7,7,2,0,0,5
S01012151,Occupancy rating -1 or less,52,25,16,9,20,1,9,0,6,3,10,8,2,7,4,0,1,2
S01012152,All households,362,173,37,136,173,17,97,37,35,25,59,42,17,16,11,0,0,5
S01012152,Occupancy rating +2 or more,43,22,9,13,18,6,12,11,1,0,0,0,0,3,2,0,0,1
S01012152,Occupancy rating +1,145,83,19,64,61,8,40,20,7,13,13,8,5,1,0,0,0,1
S01012152,Occupancy rating 0,135,65,9,56,63,2,31,6,17,8,30,23,7,7,5,0,0,2
S01012152,Occupancy rating -1 or less,39,3,0,3,31,1,14,0,10,4,16,11,5,5,4,0,0,1
S01012153,All households,329,205,28,177,109,1,57,27,26,4,51,38,13,15,1,3,0,11
S01012153,Occupancy rating +2 or more,13,1,0,1,10,0,7,3,3,1,3,2,1,2,0,0,0,2
S01012153,Occupancy rating +1,68,43,10,33,24,1,16,13,2,1,7,4,3,1,0,0,0,1
S01012153,Occupancy rating 0,182,124,12,112,55,0,25,8,16,1,30,22,8,3,0,1,0,2
S01012153,Occupancy rating -1 or less,66,37,6,31,20,0,9,3,5,1,11,10,1,9,1,2,0,6
S01012154,All households,513,333,64,269,161,13,100,67,28,5,48,32,16,19,4,5,2,8
S01012154,Occupancy rating +2 or more,15,6,4,2,8,0,8,7,1,0,0,0,0,1,0,0,0,1
S01012154,Occupancy rating +1,137,101,23,78,35,7,26,25,1,0,2,1,1,1,0,1,0,0
S01012154,Occupancy rating 0,288,189,33,156,91,5,51,29,17,5,35,23,12,8,2,2,1,3
S01012154,Occupancy rating -1 or less,73,37,4,33,27,1,15,6,9,0,11,8,3,9,2,2,1,4
S01012155,All households,357,237,46,191,109,7,72,42,18,12,30,18,12,11,2,0,0,9
S01012155,Occupancy rating +2 or more,33,16,2,14,17,2,14,9,1,4,1,0,1,0,0,0,0,0
S01012155,Occupancy rating +1,86,53,10,43,31,4,22,19,1,2,5,3,2,2,0,0,0,2
S01012155,Occupancy rating 0,171,122,27,95,46,1,28,10,13,5,17,10,7,3,1,0,0,2
S01012155,Occupancy rating -1 or less,67,46,7,39,15,0,8,4,3,1,7,5,2,6,1,0,0,5
S01012156,All households,372,214,70,144,142,16,63,39,13,11,63,39,24,16,7,0,0,9
S01012156,Occupancy rating +2 or more,40,19,6,13,20,4,14,9,4,1,2,1,1,1,0,0,0,1
S01012156,Occupancy rating +1,122,82,21,61,37,6,23,20,2,1,8,4,4,3,2,0,0,1
S01012156,Occupancy rating 0,154,95,41,54,57,2,23,10,6,7,32,19,13,2,0,0,0,2
S01012156,Occupancy rating -1 or less,56,18,2,16,28,4,3,0,1,2,21,15,6,10,5,0,0,5
S01012157,All households,487,212,63,149,253,22,161,59,76,26,70,49,21,22,3,2,2,15
S01012157,Occupancy rating +2 or more,101,35,14,21,64,9,51,21,24,6,4,3,1,2,0,0,0,2
S01012157,Occupancy rating +1,160,78,16,62,79,5,54,19,24,11,20,12,8,3,0,0,1,2
S01012157,Occupancy rating 0,178,85,30,55,81,6,44,17,21,6,31,21,10,12,3,1,1,7
S01012157,Occupancy rating -1 or less,48,14,3,11,29,2,12,2,7,3,15,13,2,5,0,1,0,4
S01012158,All households,487,170,36,134,302,15,233,110,93,30,54,37,17,15,5,1,1,8
S01012158,Occupancy rating +2 or more,201,56,13,43,139,13,115,71,27,17,11,6,5,6,2,0,1,3
S01012158,Occupancy rating +1,159,66,16,50,92,2,75,25,42,8,15,10,5,1,0,0,0,1
S01012158,Occupancy rating 0,98,38,4,34,56,0,38,13,22,3,18,15,3,4,0,1,0,3
S01012158,Occupancy rating -1 or less,29,10,3,7,15,0,5,1,2,2,10,6,4,4,3,0,0,1
S01012159,All households,229,66,39,27,158,25,124,62,37,25,9,4,5,5,2,0,1,2
S01012159,Occupancy rating +2 or more,129,45,26,19,83,18,62,43,10,9,3,1,2,1,1,0,0,0
S01012159,Occupancy rating +1,65,17,11,6,47,6,40,17,13,10,1,1,0,1,1,0,0,0
S01012159,Occupancy rating 0,24,3,2,1,20,1,15,1,11,3,4,2,2,1,0,0,0,1
S01012159,Occupancy rating -1 or less,11,1,0,1,8,0,7,1,3,3,1,0,1,2,0,0,1,1
S01012160,All households,293,75,39,36,209,32,149,67,47,35,28,16,12,9,4,0,0,5
S01012160,Occupancy rating +2 or more,151,40,21,19,109,24,77,44,21,12,8,6,2,2,1,0,0,1
S01012160,Occupancy rating +1,98,31,18,13,65,6,45,21,9,15,14,7,7,2,0,0,0,2
S01012160,Occupancy rating 0,34,2,0,2,29,1,22,1,13,8,6,3,3,3,2,0,0,1
S01012160,Occupancy rating -1 or less,10,2,0,2,6,1,5,1,4,0,0,0,0,2,1,0,0,1
S01012161,All households,208,68,21,47,130,9,58,22,24,12,63,48,15,10,3,0,1,6
S01012161,Occupancy rating +2 or more,39,19,9,10,17,4,11,11,0,0,2,1,1,3,0,0,1,2
S01012161,Occupancy rating +1,74,37,9,28,37,4,21,8,8,5,12,9,3,0,0,0,0,0
S01012161,Occupancy rating 0,68,11,3,8,54,1,22,2,15,5,31,23,8,3,2,0,0,1
S01012161,Occupancy rating -1 or less,27,1,0,1,22,0,4,1,1,2,18,15,3,4,1,0,0,3
S01012162,All households,386,140,24,116,235,7,144,53,74,17,84,70,14,11,5,0,0,6
S01012162,Occupancy rating +2 or more,75,22,3,19,53,4,45,32,11,2,4,4,0,0,0,0,0,0
S01012162,Occupancy rating +1,147,72,13,59,75,1,50,16,28,6,24,20,4,0,0,0,0,0
S01012162,Occupancy rating 0,129,41,6,35,81,1,36,4,24,8,44,35,9,7,1,0,0,6
S01012162,Occupancy rating -1 or less,35,5,2,3,26,1,13,1,11,1,12,11,1,4,4,0,0,0
S01012163,All households,384,191,31,160,177,14,118,48,59,11,45,38,7,16,8,0,0,8
S01012163,Occupancy rating +2 or more,72,27,7,20,43,6,35,21,8,6,2,0,2,2,0,0,0,2
S01012163,Occupancy rating +1,94,37,3,34,55,3,39,17,21,1,13,11,2,2,1,0,0,1
S01012163,Occupancy rating 0,157,98,17,81,58,4,33,5,24,4,21,20,1,1,0,0,0,1
S01012163,Occupancy rating -1 or less,61,29,4,25,21,1,11,5,6,0,9,7,2,11,7,0,0,4
S01012164,All households,413,78,8,70,319,6,266,84,159,23,47,41,6,16,9,0,0,7
S01012164,Occupancy rating +2 or more,144,29,3,26,112,1,105,43,57,5,6,6,0,3,2,0,0,1
S01012164,Occupancy rating +1,142,32,2,30,105,4,84,30,45,9,17,14,3,5,2,0,0,3
S01012164,Occupancy rating 0,105,13,0,13,88,0,68,10,49,9,20,17,3,4,2,0,0,2
S01012164,Occupancy rating -1 or less,22,4,3,1,14,1,9,1,8,0,4,4,0,4,3,0,0,1
S01012165,All households,452,199,40,159,233,17,115,47,58,10,101,73,28,20,4,0,1,15
S01012165,Occupancy rating +2 or more,68,40,8,32,27,7,17,12,5,0,3,3,0,1,1,0,0,0
S01012165,Occupancy rating +1,192,108,21,87,79,9,45,27,15,3,25,11,14,5,0,0,1,4
S01012165,Occupancy rating 0,149,40,9,31,101,1,43,8,29,6,57,48,9,8,0,0,0,8
S01012165,Occupancy rating -1 or less,43,11,2,9,26,0,10,0,9,1,16,11,5,6,3,0,0,3
S01012166,All households,292,112,22,90,169,9,84,35,29,20,76,56,20,11,2,0,0,9
S01012166,Occupancy rating +2 or more,79,45,8,37,34,7,25,21,2,2,2,2,0,0,0,0,0,0
S01012166,Occupancy rating +1,99,38,10,28,56,1,29,10,12,7,26,22,4,5,0,0,0,5
S01012166,Occupancy rating 0,76,19,4,15,54,1,20,2,11,7,33,20,13,3,0,0,0,3
S01012166,Occupancy rating -1 or less,38,10,0,10,25,0,10,2,4,4,15,12,3,3,2,0,0,1
S01012167,All households,425,212,48,164,199,36,126,56,45,25,37,19,18,14,1,0,0,13
S01012167,Occupancy rating +2 or more,92,32,14,18,60,18,39,25,9,5,3,1,2,0,0,0,0,0
S01012167,Occupancy rating +1,138,75,11,64,63,14,37,19,9,9,12,5,7,0,0,0,0,0
S01012167,Occupancy rating 0,140,72,16,56,58,3,38,10,20,8,17,9,8,10,1,0,0,9
S01012167,Occupancy rating -1 or less,55,33,7,26,18,1,12,2,7,3,5,4,1,4,0,0,0,4
S01012168,All households,379,125,66,59,237,42,159,61,63,35,36,14,22,17,6,1,3,7
S01012168,Occupancy rating +2 or more,193,63,37,26,126,37,82,44,23,15,7,0,7,4,1,1,0,2
S01012168,Occupancy rating +1,104,38,18,20,57,5,42,12,23,7,10,3,7,9,3,0,3,3
S01012168,Occupancy rating 0,63,19,9,10,42,0,26,4,10,12,16,9,7,2,1,0,0,1
S01012168,Occupancy rating -1 or less,19,5,2,3,12,0,9,1,7,1,3,2,1,2,1,0,0,1
S01012169,All households,429,170,65,105,248,44,151,82,54,15,53,30,23,11,3,0,0,8
S01012169,Occupancy rating +2 or more,139,54,20,34,84,22,54,40,8,6,8,4,4,1,0,0,0,1
S01012169,Occupancy rating +1,151,73,30,43,74,11,48,31,12,5,15,7,8,4,0,0,0,4
S01012169,Occupancy rating 0,104,34,13,21,67,10,36,11,21,4,21,11,10,3,1,0,0,2
S01012169,Occupancy rating -1 or less,35,9,2,7,23,1,13,0,13,0,9,8,1,3,2,0,0,1
S01012170,All households,543,271,132,139,252,51,146,66,54,26,55,30,25,20,3,0,4,13
S01012170,Occupancy rating +2 or more,99,42,23,19,56,14,38,27,9,2,4,4,0,1,0,0,0,1
S01012170,Occupancy rating +1,213,127,55,72,80,22,48,27,13,8,10,3,7,6,0,0,2,4
S01012170,Occupancy rating 0,194,91,49,42,94,14,44,8,24,12,36,19,17,9,1,0,2,6
S01012170,Occupancy rating -1 or less,37,11,5,6,22,1,16,4,8,4,5,4,1,4,2,0,0,2
S01012171,All households,470,171,74,97,277,32,174,74,64,36,71,44,27,22,11,0,2,9
S01012171,Occupancy rating +2 or more,140,61,27,34,79,23,52,45,4,3,4,3,1,0,0,0,0,0
S01012171,Occupancy rating +1,160,68,27,41,88,6,54,21,16,17,28,15,13,4,0,0,1,3
S01012171,Occupancy rating 0,126,31,17,14,88,3,54,6,34,14,31,20,11,7,3,0,1,3
S01012171,Occupancy rating -1 or less,44,11,3,8,22,0,14,2,10,2,8,6,2,11,8,0,0,3
S01012172,All households,360,146,57,89,200,34,113,38,56,19,53,32,21,14,6,1,1,6
S01012172,Occupancy rating +2 or more,77,39,20,19,36,13,18,12,5,1,5,3,2,2,0,1,0,1
S01012172,Occupancy rating +1,143,62,12,50,79,15,49,25,14,10,15,7,8,2,0,0,0,2
S01012172,Occupancy rating 0,111,38,22,16,67,5,36,1,28,7,26,17,9,6,2,0,1,3
S01012172,Occupancy rating -1 or less,29,7,3,4,18,1,10,0,9,1,7,5,2,4,4,0,0,0
S01012173,All households,289,91,62,29,190,49,122,49,41,32,19,7,12,8,4,0,1,3
S01012173,Occupancy rating +2 or more,173,64,44,20,107,34,66,33,20,13,7,3,4,2,1,0,0,1
S01012173,Occupancy rating +1,79,19,14,5,58,14,36,15,8,13,8,1,7,2,1,0,0,1
S01012173,Occupancy rating 0,29,6,3,3,21,0,18,1,13,4,3,3,0,2,0,0,1,1
S01012173,Occupancy rating -1 or less,8,2,1,1,4,1,2,0,0,2,1,0,1,2,2,0,0,0
S01012174,All households,301,40,7,33,254,6,211,52,121,38,37,25,12,7,4,0,0,3
S01012174,Occupancy rating +2 or more,181,18,3,15,158,6,139,42,75,22,13,7,6,5,4,0,0,1
S01012174,Occupancy rating +1,72,15,3,12,56,0,44,7,28,9,12,8,4,1,0,0,0,1
S01012174,Occupancy rating 0,38,4,1,3,34,0,26,1,18,7,8,6,2,0,0,0,0,0
S01012174,Occupancy rating -1 or less,10,3,0,3,6,0,2,2,0,0,4,4,0,1,0,0,0,1
S01012175,All households,385,145,34,111,229,24,171,74,64,33,34,21,13,11,6,0,0,5
S01012175,Occupancy rating +2 or more,144,27,13,14,112,18,81,39,27,15,13,7,6,5,5,0,0,0
S01012175,Occupancy rating +1,110,48,7,41,60,6,48,22,13,13,6,4,2,2,0,0,0,2
S01012175,Occupancy rating 0,102,52,11,41,47,0,33,10,18,5,14,10,4,3,1,0,0,2
S01012175,Occupancy rating -1 or less,29,18,3,15,10,0,9,3,6,0,1,0,1,1,0,0,0,1
S01012176,All households,367,119,35,84,231,14,186,89,55,42,31,18,13,17,10,0,0,7
S01012176,Occupancy rating +2 or more,120,21,15,6,95,9,82,55,15,12,4,1,3,4,1,0,0,3
S01012176,Occupancy rating +1,140,71,15,56,66,5,52,28,13,11,9,6,3,3,1,0,0,2
S01012176,Occupancy rating 0,86,26,5,21,55,0,40,6,18,16,15,9,6,5,3,0,0,2
S01012176,Occupancy rating -1 or less,21,1,0,1,15,0,12,0,9,3,3,2,1,5,5,0,0,0
S01012177,All households,242,47,22,25,189,20,150,58,54,38,19,14,5,6,3,0,1,2
S01012177,Occupancy rating +2 or more,122,18,11,7,103,14,85,40,26,19,4,3,1,1,0,0,0,1
S01012177,Occupancy rating +1,82,25,11,14,55,5,46,17,19,10,4,3,1,2,1,0,1,0
S01012177,Occupancy rating 0,28,1,0,1,25,0,14,1,7,6,11,8,3,2,1,0,0,1
S01012177,Occupancy rating -1 or less,10,3,0,3,6,1,5,0,2,3,0,0,0,1,1,0,0,0
S01012178,All households,212,40,21,19,168,16,143,66,45,32,9,6,3,4,2,0,0,2
S01012178,Occupancy rating +2 or more,96,16,10,6,80,9,70,46,18,6,1,1,0,0,0,0,0,0
S01012178,Occupancy rating +1,69,21,11,10,46,6,39,19,7,13,1,1,0,2,1,0,0,1
S01012178,Occupancy rating 0,38,2,0,2,35,1,27,1,17,9,7,4,3,1,0,0,0,1
S01012178,Occupancy rating -1 or less,9,1,0,1,7,0,7,0,3,4,0,0,0,1,1,0,0,0
S01012179,All households,301,126,75,51,160,30,89,39,32,18,41,21,20,15,7,0,1,7
S01012179,Occupancy rating +2 or more,113,38,16,22,71,13,50,32,9,9,8,3,5,4,1,0,0,3
S01012179,Occupancy rating +1,72,28,8,20,42,9,20,6,11,3,13,4,9,2,0,0,0,2
S01012179,Occupancy rating 0,93,55,48,7,36,7,15,1,10,4,14,11,3,2,1,0,0,1
S01012179,Occupancy rating -1 or less,23,5,3,2,11,1,4,0,2,2,6,3,3,7,5,0,1,1
S01012180,All households,273,99,64,35,159,33,87,36,33,18,39,24,15,15,7,0,1,7
S01012180,Occupancy rating +2 or more,77,34,22,12,42,11,30,16,9,5,1,1,0,1,1,0,0,0
S01012180,Occupancy rating +1,124,55,38,17,64,17,34,16,10,8,13,5,8,5,1,0,1,3
S01012180,Occupancy rating 0,51,7,3,4,39,2,18,4,9,5,19,13,6,5,2,0,0,3
S01012180,Occupancy rating -1 or less,21,3,1,2,14,3,5,0,5,0,6,5,1,4,3,0,0,1
S01012181,All households,384,190,94,96,170,26,114,47,45,22,30,18,12,24,3,0,2,19
S01012181,Occupancy rating +2 or more,126,47,31,16,76,15,53,23,22,8,8,3,5,3,0,0,1,2
S01012181,Occupancy rating +1,127,72,39,33,47,8,32,18,5,9,7,3,4,8,1,0,1,6
S01012181,Occupancy rating 0,100,57,18,39,34,3,21,4,13,4,10,7,3,9,1,0,0,8
S01012181,Occupancy rating -1 or less,31,14,6,8,13,0,8,2,5,1,5,5,0,4,1,0,0,3
S01012182,All households,431,115,12,103,297,14,245,97,116,32,38,27,11,19,8,2,0,9
S01012182,Occupancy rating +2 or more,143,25,4,21,117,5,104,45,44,15,8,6,2,1,1,0,0,0
S01012182,Occupancy rating +1,174,63,2,61,106,9,90,46,35,9,7,5,2,5,2,0,0,3
S01012182,Occupancy rating 0,86,18,3,15,59,0,41,3,31,7,18,12,6,9,3,2,0,4
S01012182,Occupancy rating -1 or less,28,9,3,6,15,0,10,3,6,1,5,4,1,4,2,0,0,2
S01012183,All households,408,217,44,173,183,17,120,71,37,12,46,28,18,8,4,0,0,4
S01012183,Occupancy rating +2 or more,75,44,13,31,31,2,26,18,7,1,3,2,1,0,0,0,0,0
S01012183,Occupancy rating +1,147,74,10,64,71,7,50,35,12,3,14,7,7,2,1,0,0,1
S01012183,Occupancy rating 0,135,78,17,61,52,7,25,10,10,5,20,13,7,5,2,0,0,3
S01012183,Occupancy rating -1 or less,51,21,4,17,29,1,19,8,8,3,9,6,3,1,1,0,0,0
S01012184,All households,280,133,8,125,134,9,101,66,26,9,24,16,8,13,3,0,0,10
S01012184,Occupancy rating +2 or more,50,11,1,10,36,3,29,20,7,2,4,3,1,3,0,0,0,3
S01012184,Occupancy rating +1,107,72,7,65,34,3,30,27,3,0,1,0,1,1,1,0,0,0
S01012184,Occupancy rating 0,83,38,0,38,44,3,28,14,9,5,13,9,4,1,0,0,0,1
S01012184,Occupancy rating -1 or less,40,12,0,12,20,0,14,5,7,2,6,4,2,8,2,0,0,6
S01012185,All households,506,370,32,338,124,5,70,44,22,4,49,36,13,12,1,1,1,9
S01012185,Occupancy rating +2 or more,29,13,3,10,16,2,12,9,2,1,2,2,0,0,0,0,0,0
S01012185,Occupancy rating +1,98,75,9,66,22,2,19,15,1,3,1,1,0,1,0,0,0,1
S01012185,Occupancy rating 0,243,184,10,174,56,1,29,18,11,0,26,18,8,3,0,0,1,2
S01012185,Occupancy rating -1 or less,136,98,10,88,30,0,10,2,8,0,20,15,5,8,1,1,0,6
S01012186,All households,344,134,70,64,197,35,111,47,42,22,51,28,23,13,2,0,1,10
S01012186,Occupancy rating +2 or more,101,42,30,12,58,19,34,21,8,5,5,4,1,1,0,0,0,1
S01012186,Occupancy rating +1,106,47,17,30,55,8,37,18,13,6,10,3,7,4,1,0,1,2
S01012186,Occupancy rating 0,111,36,20,16,69,7,31,7,16,8,31,17,14,6,1,0,0,5
S01012186,Occupancy rating -1 or less,26,9,3,6,15,1,9,1,5,3,5,4,1,2,0,0,0,2
S01012187,All households,382,210,74,136,165,21,89,37,29,23,55,34,21,7,1,0,0,6
S01012187,Occupancy rating +2 or more,43,21,7,14,21,1,19,16,1,2,1,0,1,1,0,0,0,1
S01012187,Occupancy rating +1,125,73,19,54,51,13,28,14,6,8,10,5,5,1,0,0,0,1
S01012187,Occupancy rating 0,149,75,26,49,71,6,34,7,16,11,31,17,14,3,0,0,0,3
S01012187,Occupancy rating -1 or less,65,41,22,19,22,1,8,0,6,2,13,12,1,2,1,0,0,1
S01012188,All households,252,85,49,36,160,28,112,62,31,19,20,13,7,7,3,0,1,3
S01012188,Occupancy rating +2 or more,114,31,19,12,81,19,58,40,12,6,4,3,1,2,1,0,1,0
S01012188,Occupancy rating +1,83,32,17,15,50,7,35,21,9,5,8,4,4,1,0,0,0,1
S01012188,Occupancy rating 0,45,19,11,8,24,2,17,1,8,8,5,5,0,2,1,0,0,1
S01012188,Occupancy rating -1 or less,10,3,2,1,5,0,2,0,2,0,3,1,2,2,1,0,0,1
S01012189,All households,245,72,31,41,167,16,126,40,68,18,25,5,20,6,3,0,0,3
S01012189,Occupancy rating +2 or more,95,28,9,19,67,11,51,20,27,4,5,2,3,0,0,0,0,0
S01012189,Occupancy rating +1,91,33,14,19,56,5,45,19,19,7,6,2,4,2,1,0,0,1
S01012189,Occupancy rating 0,51,11,8,3,36,0,24,1,17,6,12,1,11,4,2,0,0,2
S01012189,Occupancy rating -1 or less,8,0,0,0,8,0,6,0,5,1,2,0,2,0,0,0,0,0
S01012190,All households,210,40,10,30,169,11,141,45,85,11,17,14,3,1,0,0,0,1
S01012190,Occupancy rating +2 or more,108,12,2,10,96,9,83,22,55,6,4,3,1,0,0,0,0,0
S01012190,Occupancy rating +1,61,19,7,12,41,2,38,21,17,0,1,1,0,1,0,0,0,1
S01012190,Occupancy rating 0,38,8,1,7,30,0,18,2,12,4,12,10,2,0,0,0,0,0
S01012190,Occupancy rating -1 or less,3,1,0,1,2,0,2,0,1,1,0,0,0,0,0,0,0,0
S01012191,All households,322,52,18,34,261,29,198,66,79,53,34,17,17,9,7,0,0,2
S01012191,Occupancy rating +2 or more,206,27,13,14,175,24,133,56,46,31,18,9,9,4,2,0,0,2
S01012191,Occupancy rating +1,72,20,5,15,49,5,35,9,18,8,9,3,6,3,3,0,0,0
S01012191,Occupancy rating 0,38,5,0,5,31,0,25,1,12,12,6,4,2,2,2,0,0,0
S01012191,Occupancy rating -1 or less,6,0,0,0,6,0,5,0,3,2,1,1,0,0,0,0,0,0
S01012192,All households,187,32,16,16,147,26,111,37,51,23,10,4,6,8,4,0,1,3
S01012192,Occupancy rating +2 or more,122,18,9,9,100,23,75,30,32,13,2,1,1,4,2,0,0,2
S01012192,Occupancy rating +1,44,11,6,5,30,3,25,6,12,7,2,2,0,3,1,0,1,1
S01012192,Occupancy rating 0,13,2,1,1,11,0,7,1,5,1,4,0,4,0,0,0,0,0
S01012192,Occupancy rating -1 or less,8,1,0,1,6,0,4,0,2,2,2,1,1,1,1,0,0,0
S01012193,All households,175,12,2,10,153,5,136,35,80,21,12,10,2,10,3,0,0,7
S01012193,Occupancy rating +2 or more,98,11,2,9,81,4,73,31,32,10,4,3,1,6,2,0,0,4
S01012193,Occupancy rating +1,43,0,0,0,42,1,37,3,26,8,4,4,0,1,0,0,0,1
S01012193,Occupancy rating 0,29,1,0,1,27,0,23,1,20,2,4,3,1,1,0,0,0,1
S01012193,Occupancy rating -1 or less,5,0,0,0,3,0,3,0,2,1,0,0,0,2,1,0,0,1
S01012194,All households,179,22,4,18,156,10,130,22,89,19,16,11,5,1,1,0,0,0
S01012194,Occupancy rating +2 or more,123,12,2,10,110,8,94,20,63,11,8,6,2,1,1,0,0,0
S01012194,Occupancy rating +1,39,9,2,7,30,2,24,2,16,6,4,3,1,0,0,0,0,0
S01012194,Occupancy rating 0,12,0,0,0,12,0,9,0,7,2,3,2,1,0,0,0,0,0
S01012194,Occupancy rating -1 or less,5,1,0,1,4,0,3,0,3,0,1,0,1,0,0,0,0,0
S01012195,All households,423,90,46,44,316,36,247,63,128,56,33,19,14,17,8,0,1,8
S01012195,Occupancy rating +2 or more,218,39,15,24,175,22,147,47,71,29,6,4,2,4,3,0,0,1
S01012195,Occupancy rating +1,112,34,19,15,76,11,58,15,26,17,7,3,4,2,0,0,0,2
S01012195,Occupancy rating 0,67,12,9,3,47,1,32,1,22,9,14,8,6,8,2,0,1,5
S01012195,Occupancy rating -1 or less,26,5,3,2,18,2,10,0,9,1,6,4,2,3,3,0,0,0
S01012196,All households,211,50,16,34,152,4,124,33,71,20,24,21,3,9,3,0,0,6
S01012196,Occupancy rating +2 or more,110,16,4,12,91,4,82,23,44,15,5,4,1,3,1,0,0,2
S01012196,Occupancy rating +1,51,18,5,13,30,0,24,8,13,3,6,5,1,3,1,0,0,2
S01012196,Occupancy rating 0,40,14,6,8,24,0,15,2,12,1,9,8,1,2,0,0,0,2
S01012196,Occupancy rating -1 or less,10,2,1,1,7,0,3,0,2,1,4,4,0,1,1,0,0,0
S01012197,All households,311,99,52,47,202,25,127,40,57,30,50,28,22,10,4,0,1,5
S01012197,Occupancy rating +2 or more,126,43,20,23,81,15,55,31,14,10,11,6,5,2,0,0,0,2
S01012197,Occupancy rating +1,83,19,12,7,59,7,36,8,18,10,16,7,9,5,2,0,0,3
S01012197,Occupancy rating 0,91,34,19,15,55,3,32,1,23,8,20,14,6,2,2,0,0,0
S01012197,Occupancy rating -1 or less,11,3,1,2,7,0,4,0,2,2,3,1,2,1,0,0,1,0
S01012198,All households,403,162,59,103,230,19,165,61,79,25,46,31,15,11,3,0,0,8
S01012198,Occupancy rating +2 or more,113,26,9,17,85,4,72,34,24,14,9,6,3,2,1,0,0,1
S01012198,Occupancy rating +1,138,62,18,44,73,9,52,17,28,7,12,10,2,3,0,0,0,3
S01012198,Occupancy rating 0,122,59,23,36,60,3,36,10,22,4,21,12,9,3,0,0,0,3
S01012198,Occupancy rating -1 or less,30,15,9,6,12,3,5,0,5,0,4,3,1,3,2,0,0,1
S01012199,All households,309,98,41,57,206,25,137,39,52,46,44,28,16,5,2,0,0,3
S01012199,Occupancy rating +2 or more,134,45,22,23,88,21,62,27,20,15,5,2,3,1,1,0,0,0
S01012199,Occupancy rating +1,80,23,8,15,55,2,39,11,9,19,14,8,6,2,0,0,0,2
S01012199,Occupancy rating 0,83,27,9,18,54,2,30,0,18,12,22,15,7,2,1,0,0,1
S01012199,Occupancy rating -1 or less,12,3,2,1,9,0,6,1,5,0,3,3,0,0,0,0,0,0
S01012200,All households,278,86,39,47,185,20,114,36,52,26,51,33,18,7,5,0,0,2
S01012200,Occupancy rating +2 or more,97,30,11,19,67,11,49,24,14,11,7,2,5,0,0,0,0,0
S01012200,Occupancy rating +1,67,23,10,13,41,5,25,6,13,6,11,5,6,3,2,0,0,1
S01012200,Occupancy rating 0,87,27,15,12,57,4,29,6,18,5,24,17,7,3,2,0,0,1
S01012200,Occupancy rating -1 or less,27,6,3,3,20,0,11,0,7,4,9,9,0,1,1,0,0,0
S01012201,All households,318,90,34,56,216,29,151,54,73,24,36,19,17,12,9,0,0,3
S01012201,Occupancy rating +2 or more,111,31,14,17,74,11,58,29,20,9,5,3,2,6,3,0,0,3
S01012201,Occupancy rating +1,97,29,15,14,67,14,43,16,17,10,10,4,6,1,1,0,0,0
S01012201,Occupancy rating 0,87,27,4,23,59,4,39,9,25,5,16,10,6,1,1,0,0,0
S01012201,Occupancy rating -1 or less,23,3,1,2,16,0,11,0,11,0,5,2,3,4,4,0,0,0
S01012202,All households,239,56,22,34,174,29,108,36,51,21,37,27,10,9,4,0,0,5
S01012202,Occupancy rating +2 or more,117,17,6,11,98,23,64,26,33,5,11,9,2,2,1,0,0,1
S01012202,Occupancy rating +1,66,25,12,13,36,4,20,6,6,8,12,8,4,5,2,0,0,3
S01012202,Occupancy rating 0,45,11,3,8,32,1,21,4,10,7,10,7,3,2,1,0,0,1
S01012202,Occupancy rating -1 or less,11,3,1,2,8,1,3,0,2,1,4,3,1,0,0,0,0,0
S01012203,All households,316,63,26,37,238,45,175,73,54,48,18,9,9,15,6,0,1,8
S01012203,Occupancy rating +2 or more,198,32,14,18,161,32,121,58,36,27,8,3,5,5,1,0,0,4
S01012203,Occupancy rating +1,77,17,8,9,56,11,39,11,12,16,6,2,4,4,1,0,0,3
S01012203,Occupancy rating 0,28,12,4,8,13,0,11,4,3,4,2,2,0,3,2,0,0,1
S01012203,Occupancy rating -1 or less,13,2,0,2,8,2,4,0,3,1,2,2,0,3,2,0,1,0
S01012204,All households,270,30,9,21,230,13,197,66,83,48,20,8,12,10,7,0,0,3
S01012204,Occupancy rating +2 or more,154,24,6,18,126,8,112,49,33,30,6,2,4,4,3,0,0,1
S01012204,Occupancy rating +1,68,6,3,3,59,3,47,17,17,13,9,2,7,3,2,0,0,1
S01012204,Occupancy rating 0,36,0,0,0,35,0,30,0,25,5,5,4,1,1,1,0,0,0
S01012204,Occupancy rating -1 or less,12,0,0,0,10,2,8,0,8,0,0,0,0,2,1,0,0,1
S01012205,All households,273,56,13,43,209,18,166,76,60,30,25,15,10,8,6,0,0,2
S01012205,Occupancy rating +2 or more,132,27,6,21,102,13,88,52,19,17,1,1,0,3,3,0,0,0
S01012205,Occupancy rating +1,82,19,4,15,61,4,51,19,26,6,6,1,5,2,1,0,0,1
S01012205,Occupancy rating 0,45,9,3,6,34,1,18,5,10,3,15,12,3,2,1,0,0,1
S01012205,Occupancy rating -1 or less,14,1,0,1,12,0,9,0,5,4,3,1,2,1,1,0,0,0
S01012206,All households,317,62,25,37,249,18,190,55,92,43,41,26,15,6,3,0,0,3
S01012206,Occupancy rating +2 or more,114,32,15,17,82,13,66,41,18,7,3,2,1,0,0,0,0,0
S01012206,Occupancy rating +1,105,22,9,13,80,3,65,7,33,25,12,7,5,3,1,0,0,2
S01012206,Occupancy rating 0,76,7,1,6,66,2,45,5,32,8,19,12,7,3,2,0,0,1
S01012206,Occupancy rating -1 or less,22,1,0,1,21,0,14,2,9,3,7,5,2,0,0,0,0,0
S01012207,All households,401,130,67,63,253,38,144,42,75,27,71,45,26,18,11,0,3,4
S01012207,Occupancy rating +2 or more,136,60,31,29,76,23,48,30,13,5,5,2,3,0,0,0,0,0
S01012207,Occupancy rating +1,144,47,26,21,91,13,53,10,32,11,25,12,13,6,3,0,2,1
S01012207,Occupancy rating 0,90,19,8,11,64,2,31,1,22,8,31,25,6,7,4,0,1,2
S01012207,Occupancy rating -1 or less,31,4,2,2,22,0,12,1,8,3,10,6,4,5,4,0,0,1
S01012208,All households,457,152,65,87,286,39,171,55,81,35,76,48,28,19,9,0,0,10
S01012208,Occupancy rating +2 or more,164,58,23,35,101,18,72,41,19,12,11,4,7,5,4,0,0,1
S01012208,Occupancy rating +1,163,65,31,34,91,17,51,12,27,12,23,13,10,7,3,0,0,4
S01012208,Occupancy rating 0,101,27,10,17,70,3,38,1,28,9,29,21,8,4,2,0,0,2
S01012208,Occupancy rating -1 or less,29,2,1,1,24,1,10,1,7,2,13,10,3,3,0,0,0,3
S01012209,All households,318,104,49,55,200,22,129,49,58,22,49,27,22,14,10,0,2,2
S01012209,Occupancy rating +2 or more,132,48,18,30,82,14,58,41,11,6,10,2,8,2,1,0,1,0
S01012209,Occupancy rating +1,93,28,11,17,59,6,34,6,17,11,19,10,9,6,5,0,1,0
S01012209,Occupancy rating 0,81,25,17,8,53,2,32,2,26,4,19,14,5,3,2,0,0,1
S01012209,Occupancy rating -1 or less,12,3,3,0,6,0,5,0,4,1,1,1,0,3,2,0,0,1
S01012210,All households,385,165,100,65,204,43,112,31,56,25,49,30,19,16,8,0,2,6
S01012210,Occupancy rating +2 or more,86,37,22,15,48,20,26,14,5,7,2,0,2,1,0,0,0,1
S01012210,Occupancy rating +1,112,48,33,15,61,19,36,11,18,7,6,1,5,3,1,0,1,1
S01012210,Occupancy rating 0,142,59,28,31,77,3,42,6,26,10,32,23,9,6,3,0,0,3
S01012210,Occupancy rating -1 or less,45,21,17,4,18,1,8,0,7,1,9,6,3,6,4,0,1,1
S01012211,All households,408,146,63,83,250,32,171,65,83,23,47,27,20,12,6,0,2,4
S01012211,Occupancy rating +2 or more,182,54,25,29,123,22,96,46,43,7,5,5,0,5,2,0,0,3
S01012211,Occupancy rating +1,114,49,20,29,62,8,45,18,20,7,9,5,4,3,1,0,1,1
S01012211,Occupancy rating 0,86,34,15,19,49,2,23,1,16,6,24,12,12,3,2,0,1,0
S01012211,Occupancy rating -1 or less,26,9,3,6,16,0,7,0,4,3,9,5,4,1,1,0,0,0
S01012212,All households,304,51,26,25,244,41,188,72,66,50,15,5,10,9,3,0,1,5
S01012212,Occupancy rating +2 or more,218,42,23,19,170,36,128,65,39,24,6,2,4,6,2,0,1,3
S01012212,Occupancy rating +1,57,7,2,5,48,3,38,6,18,14,7,2,5,2,1,0,0,1
S01012212,Occupancy rating 0,22,1,1,0,20,1,18,1,8,9,1,1,0,1,0,0,0,1
S01012212,Occupancy rating -1 or less,7,1,0,1,6,1,4,0,1,3,1,0,1,0,0,0,0,0
S01012213,All households,336,61,27,34,267,38,200,89,58,53,29,12,17,8,1,0,1,6
S01012213,Occupancy rating +2 or more,191,29,14,15,159,28,125,71,26,28,6,2,4,3,0,0,0,3
S01012213,Occupancy rating +1,96,29,11,18,64,9,50,15,19,16,5,1,4,3,0,0,1,2
S01012213,Occupancy rating 0,35,2,1,1,32,1,19,2,9,8,12,6,6,1,0,0,0,1
S01012213,Occupancy rating -1 or less,14,1,1,0,12,0,6,1,4,1,6,3,3,1,1,0,0,0
S01012214,All households,282,71,50,21,205,39,155,55,61,39,11,6,5,6,2,0,0,4
S01012214,Occupancy rating +2 or more,199,49,37,12,148,35,109,50,35,24,4,3,1,2,0,0,0,2
S01012214,Occupancy rating +1,57,19,10,9,36,3,28,4,17,7,5,2,3,2,1,0,0,1
S01012214,Occupancy rating 0,18,1,1,0,16,0,14,1,6,7,2,1,1,1,0,0,0,1
S01012214,Occupancy rating -1 or less,8,2,2,0,5,1,4,0,3,1,0,0,0,1,1,0,0,0
S01012215,All households,329,61,25,36,260,37,199,74,83,42,24,14,10,8,3,0,1,4
S01012215,Occupancy rating +2 or more,211,39,20,19,171,32,127,67,36,24,12,7,5,1,0,0,0,1
S01012215,Occupancy rating +1,81,17,5,12,61,3,50,7,29,14,8,5,3,3,1,0,0,2
S01012215,Occupancy rating 0,27,4,0,4,19,1,15,0,13,2,3,1,2,4,2,0,1,1
S01012215,Occupancy rating -1 or less,10,1,0,1,9,1,7,0,5,2,1,1,0,0,0,0,0,0
S01012216,All households,282,66,28,38,211,24,174,60,78,36,13,6,7,5,0,0,1,4
S01012216,Occupancy rating +2 or more,221,44,19,25,173,23,142,52,61,29,8,5,3,4,0,0,1,3
S01012216,Occupancy rating +1,38,14,6,8,24,1,20,4,11,5,3,0,3,0,0,0,0,0
S01012216,Occupancy rating 0,21,7,3,4,14,0,12,4,6,2,2,1,1,0,0,0,0,0
S01012216,Occupancy rating -1 or less,2,1,0,1,0,0,0,0,0,0,0,0,0,1,0,0,0,1
S01012217,All households,267,110,22,88,142,13,73,25,31,17,56,47,9,15,4,0,0,11
S01012217,Occupancy rating +2 or more,52,27,9,18,24,9,13,10,2,1,2,0,2,1,0,0,0,1
S01012217,Occupancy rating +1,87,36,7,29,48,3,27,9,9,9,18,17,1,3,0,0,0,3
S01012217,Occupancy rating 0,99,41,6,35,53,1,24,4,14,6,28,22,6,5,1,0,0,4
S01012217,Occupancy rating -1 or less,29,6,0,6,17,0,9,2,6,1,8,8,0,6,3,0,0,3
S01012218,All households,228,98,20,78,120,13,51,12,33,6,56,46,10,10,3,1,0,6
S01012218,Occupancy rating +2 or more,40,25,5,20,14,7,6,3,3,0,1,1,0,1,0,1,0,0
S01012218,Occupancy rating +1,96,54,14,40,39,2,22,8,10,4,15,11,4,3,0,0,0,3
S01012218,Occupancy rating 0,70,16,0,16,50,3,19,1,16,2,28,23,5,4,1,0,0,3
S01012218,Occupancy rating -1 or less,22,3,1,2,17,1,4,0,4,0,12,11,1,2,2,0,0,0
S01012219,All households,415,164,76,88,236,51,111,39,39,33,74,42,32,15,7,0,0,8
S01012219,Occupancy rating +2 or more,121,55,26,29,64,23,32,19,7,6,9,6,3,2,0,0,0,2
S01012219,Occupancy rating +1,161,73,37,36,84,21,43,16,17,10,20,6,14,4,1,0,0,3
S01012219,Occupancy rating 0,99,29,9,20,67,7,29,4,11,14,31,19,12,3,3,0,0,0
S01012219,Occupancy rating -1 or less,34,7,4,3,21,0,7,0,4,3,14,11,3,6,3,0,0,3
S01012220,All households,367,202,71,131,143,22,69,35,17,17,52,32,20,22,6,0,3,13
S01012220,Occupancy rating +2 or more,70,31,8,23,38,13,19,14,4,1,6,4,2,1,0,0,0,1
S01012220,Occupancy rating +1,136,76,25,51,54,7,37,18,7,12,10,3,7,6,0,0,2,4
S01012220,Occupancy rating 0,118,70,26,44,37,2,10,3,4,3,25,19,6,11,3,0,1,7
S01012220,Occupancy rating -1 or less,43,25,12,13,14,0,3,0,2,1,11,6,5,4,3,0,0,1
S01012221,All households,332,155,82,73,161,32,85,35,31,19,44,25,19,16,9,1,1,5
S01012221,Occupancy rating +2 or more,100,59,25,34,40,14,23,22,1,0,3,2,1,1,1,0,0,0
S01012221,Occupancy rating +1,112,49,23,26,62,13,31,10,14,7,18,11,7,1,1,0,0,0
S01012221,Occupancy rating 0,94,44,32,12,43,4,22,3,10,9,17,7,10,7,4,0,0,3
S01012221,Occupancy rating -1 or less,26,3,2,1,16,1,9,0,6,3,6,5,1,7,3,1,1,2
S01012222,All households,402,169,60,109,212,41,125,61,42,22,46,22,24,21,5,3,5,8
S01012222,Occupancy rating +2 or more,99,42,15,27,55,15,37,26,7,4,3,1,2,2,0,0,1,1
S01012222,Occupancy rating +1,147,62,32,30,78,13,55,29,18,8,10,2,8,7,2,0,2,3
S01012222,Occupancy rating 0,114,46,11,35,61,9,25,5,11,9,27,16,11,7,2,0,2,3
S01012222,Occupancy rating -1 or less,42,19,2,17,18,4,8,1,6,1,6,3,3,5,1,3,0,1
S01012223,All households,360,160,79,81,186,39,82,23,39,20,65,48,17,14,5,1,0,8
S01012223,Occupancy rating +2 or more,75,41,19,22,30,9,15,7,6,2,6,5,1,4,1,1,0,2
S01012223,Occupancy rating +1,159,80,38,42,78,25,34,16,11,7,19,14,5,1,0,0,0,1
S01012223,Occupancy rating 0,84,21,11,10,58,4,27,0,17,10,27,20,7,5,0,0,0,5
S01012223,Occupancy rating -1 or less,42,18,11,7,20,1,6,0,5,1,13,9,4,4,4,0,0,0
S01012224,All households,333,106,40,66,215,25,126,47,64,15,64,46,18,12,5,2,0,5
S01012224,Occupancy rating +2 or more,86,31,15,16,54,11,36,21,12,3,7,5,2,1,1,0,0,0
S01012224,Occupancy rating +1,140,54,21,33,86,12,50,21,22,7,24,17,7,0,0,0,0,0
S01012224,Occupancy rating 0,82,18,4,14,56,0,32,5,24,3,24,17,7,8,3,1,0,4
S01012224,Occupancy rating -1 or less,25,3,0,3,19,2,8,0,6,2,9,7,2,3,1,1,0,1
S01012225,All households,459,166,72,94,275,28,153,33,88,32,94,60,34,18,7,2,0,9
S01012225,Occupancy rating +2 or more,108,53,28,25,53,11,39,19,18,2,3,1,2,2,0,2,0,0
S01012225,Occupancy rating +1,156,58,30,28,96,13,44,9,22,13,39,23,16,2,1,0,0,1
S01012225,Occupancy rating 0,145,39,12,27,96,3,53,5,34,14,40,27,13,10,4,0,0,6
S01012225,Occupancy rating -1 or less,50,16,2,14,30,1,17,0,14,3,12,9,3,4,2,0,0,2
S01012226,All households,287,67,26,41,212,31,132,39,64,29,49,30,19,8,6,0,0,2
S01012226,Occupancy rating +2 or more,108,39,17,22,68,23,42,26,11,5,3,1,2,1,0,0,0,1
S01012226,Occupancy rating +1,94,24,9,15,68,7,43,10,20,13,18,9,9,2,2,0,0,0
S01012226,Occupancy rating 0,63,3,0,3,58,0,37,3,25,9,21,15,6,2,2,0,0,0
S01012226,Occupancy rating -1 or less,22,1,0,1,18,1,10,0,8,2,7,5,2,3,2,0,0,1
S01012227,All households,260,59,21,38,193,23,119,34,51,34,51,33,18,8,6,0,0,2
S01012227,Occupancy rating +2 or more,80,30,13,17,49,14,34,22,9,3,1,0,1,1,1,0,0,0
S01012227,Occupancy rating +1,86,24,8,16,62,5,41,9,16,16,16,6,10,0,0,0,0,0
S01012227,Occupancy rating 0,75,2,0,2,70,4,38,3,23,12,28,22,6,3,2,0,0,1
S01012227,Occupancy rating -1 or less,19,3,0,3,12,0,6,0,3,3,6,5,1,4,3,0,0,1
S01012228,All households,252,41,20,21,195,20,139,45,64,30,36,20,16,16,8,3,0,5
S01012228,Occupancy rating +2 or more,92,24,12,12,65,17,47,30,12,5,1,1,0,3,0,1,0,2
S01012228,Occupancy rating +1,80,9,4,5,67,3,53,12,23,18,11,6,5,4,1,2,0,1
S01012228,Occupancy rating 0,56,6,2,4,46,0,31,2,23,6,15,10,5,4,4,0,0,0
S01012228,Occupancy rating -1 or less,24,2,2,0,17,0,8,1,6,1,9,3,6,5,3,0,0,2
S01012229,All households,323,111,22,89,205,22,161,76,59,26,22,13,9,7,3,0,1,3
S01012229,Occupancy rating +2 or more,135,30,7,23,104,13,83,38,30,15,8,3,5,1,1,0,0,0
S01012229,Occupancy rating +1,103,53,11,42,45,8,33,24,5,4,4,2,2,5,2,0,1,2
S01012229,Occupancy rating 0,74,25,4,21,48,1,39,14,18,7,8,7,1,1,0,0,0,1
S01012229,Occupancy rating -1 or less,11,3,0,3,8,0,6,0,6,0,2,1,1,0,0,0,0,0
S01012230,All households,392,106,41,65,278,33,212,85,105,22,33,22,11,8,2,3,0,3
S01012230,Occupancy rating +2 or more,221,34,14,20,186,15,152,58,76,18,19,15,4,1,1,0,0,0
S01012230,Occupancy rating +1,89,39,16,23,49,10,32,16,13,3,7,2,5,1,0,0,0,1
S01012230,Occupancy rating 0,69,31,10,21,35,8,20,9,10,1,7,5,2,3,0,1,0,2
S01012230,Occupancy rating -1 or less,13,2,1,1,8,0,8,2,6,0,0,0,0,3,1,2,0,0
S01012231,All households,289,45,20,25,235,20,197,54,106,37,18,9,9,9,6,0,0,3
S01012231,Occupancy rating +2 or more,220,33,16,17,183,16,151,45,82,24,16,7,9,4,3,0,0,1
S01012231,Occupancy rating +1,49,11,4,7,36,4,32,7,14,11,0,0,0,2,1,0,0,1
S01012231,Occupancy rating 0,16,1,0,1,12,0,11,1,8,2,1,1,0,3,2,0,0,1
S01012231,Occupancy rating -1 or less,4,0,0,0,4,0,3,1,2,0,1,1,0,0,0,0,0,0
S01012232,All households,318,60,26,34,251,27,198,49,112,37,26,11,15,7,4,0,1,2
S01012232,Occupancy rating +2 or more,206,32,12,20,172,17,140,37,78,25,15,5,10,2,2,0,0,0
S01012232,Occupancy rating +1,82,26,14,12,53,7,41,12,19,10,5,2,3,3,2,0,0,1
S01012232,Occupancy rating 0,21,1,0,1,19,2,13,0,11,2,4,2,2,1,0,0,0,1
S01012232,Occupancy rating -1 or less,9,1,0,1,7,1,4,0,4,0,2,2,0,1,0,0,1,0
S01012233,All households,341,39,14,25,299,45,228,74,104,50,26,14,12,3,2,0,0,1
S01012233,Occupancy rating +2 or more,231,23,11,12,207,39,159,66,62,31,9,5,4,1,0,0,0,1
S01012233,Occupancy rating +1,69,11,2,9,57,4,42,8,23,11,11,5,6,1,1,0,0,0
S01012233,Occupancy rating 0,31,3,1,2,28,2,23,0,17,6,3,3,0,0,0,0,0,0
S01012233,Occupancy rating -1 or less,10,2,0,2,7,0,4,0,2,2,3,1,2,1,1,0,0,0
S01012234,All households,393,74,29,45,311,23,258,71,136,51,30,22,8,8,4,0,0,4
S01012234,Occupancy rating +2 or more,258,30,9,21,223,16,197,62,99,36,10,8,2,5,2,0,0,3
S01012234,Occupancy rating +1,87,34,16,18,52,6,41,9,22,10,5,3,2,1,1,0,0,0
S01012234,Occupancy rating 0,39,8,3,5,29,1,17,0,14,3,11,9,2,2,1,0,0,1
S01012234,Occupancy rating -1 or less,9,2,1,1,7,0,3,0,1,2,4,2,2,0,0,0,0,0
S01012235,All households,192,39,26,13,150,36,109,45,31,33,5,2,3,3,1,0,1,1
S01012235,Occupancy rating +2 or more,165,33,22,11,130,33,93,44,23,26,4,1,3,2,0,0,1,1
S01012235,Occupancy rating +1,17,4,3,1,13,2,11,1,4,6,0,0,0,0,0,0,0,0
S01012235,Occupancy rating 0,9,2,1,1,6,1,4,0,3,1,1,1,0,1,1,0,0,0
S01012235,Occupancy rating -1 or less,1,0,0,0,1,0,1,0,1,0,0,0,0,0,0,0,0,0
S01012236,All households,278,99,42,57,177,22,121,41,62,18,34,17,17,2,0,0,1,1
S01012236,Occupancy rating +2 or more,107,28,16,12,79,10,63,26,29,8,6,3,3,0,0,0,0,0
S01012236,Occupancy rating +1,87,41,19,22,45,10,28,12,14,2,7,0,7,1,0,0,0,1
S01012236,Occupancy rating 0,63,20,3,17,42,2,24,2,15,7,16,10,6,1,0,0,1,0
S01012236,Occupancy rating -1 or less,21,10,4,6,11,0,6,1,4,1,5,4,1,0,0,0,0,0
S01012237,All households,319,76,40,36,233,44,171,52,95,24,18,12,6,10,2,1,2,5
S01012237,Occupancy rating +2 or more,243,54,32,22,183,41,134,46,71,17,8,4,4,6,1,0,2,3
S01012237,Occupancy rating +1,46,15,6,9,30,3,20,4,13,3,7,5,2,1,0,0,0,1
S01012237,Occupancy rating 0,22,5,1,4,14,0,11,1,7,3,3,3,0,3,1,1,0,1
S01012237,Occupancy rating -1 or less,8,2,1,1,6,0,6,1,4,1,0,0,0,0,0,0,0,0
S01012238,All households,309,142,54,88,158,20,107,40,55,12,31,17,14,9,3,1,0,5
S01012238,Occupancy rating +2 or more,61,25,14,11,33,4,26,10,14,2,3,2,1,3,2,0,0,1
S01012238,Occupancy rating +1,106,48,17,31,56,13,39,24,10,5,4,2,2,2,0,0,0,2
S01012238,Occupancy rating 0,116,56,20,36,58,3,35,6,24,5,20,13,7,2,0,1,0,1
S01012238,Occupancy rating -1 or less,26,13,3,10,11,0,7,0,7,0,4,0,4,2,1,0,0,1
S01012239,All households,274,107,39,68,154,17,88,28,40,20,49,33,16,13,6,0,0,7
S01012239,Occupancy rating +2 or more,55,17,10,7,36,4,30,14,11,5,2,2,0,2,0,0,0,2
S01012239,Occupancy rating +1,94,50,17,33,40,9,21,11,5,5,10,7,3,4,1,0,0,3
S01012239,Occupancy rating 0,94,29,8,21,60,4,30,3,20,7,26,16,10,5,3,0,0,2
S01012239,Occupancy rating -1 or less,31,11,4,7,18,0,7,0,4,3,11,8,3,2,2,0,0,0
S01012240,All households,391,149,78,71,229,40,152,56,71,25,37,23,14,13,5,0,1,7
S01012240,Occupancy rating +2 or more,140,32,16,16,108,25,75,32,32,11,8,6,2,0,0,0,0,0
S01012240,Occupancy rating +1,116,68,36,32,44,10,28,17,8,3,6,3,3,4,1,0,0,3
S01012240,Occupancy rating 0,107,43,21,22,58,4,42,6,26,10,12,7,5,6,2,0,1,3
S01012240,Occupancy rating -1 or less,28,6,5,1,19,1,7,1,5,1,11,7,4,3,2,0,0,1
S01012241,All households,232,53,20,33,176,27,142,66,61,15,7,6,1,3,3,0,0,0
S01012241,Occupancy rating +2 or more,163,24,10,14,139,24,113,54,47,12,2,1,1,0,0,0,0,0
S01012241,Occupancy rating +1,34,14,4,10,18,2,16,8,6,2,0,0,0,2,2,0,0,0
S01012241,Occupancy rating 0,25,13,6,7,12,1,8,4,4,0,3,3,0,0,0,0,0,0
S01012241,Occupancy rating -1 or less,10,2,0,2,7,0,5,0,4,1,2,2,0,1,1,0,0,0
S01012242,All households,307,61,39,22,239,38,182,62,95,25,19,11,8,7,7,0,0,0
S01012242,Occupancy rating +2 or more,247,53,34,19,192,37,146,60,66,20,9,3,6,2,2,0,0,0
S01012242,Occupancy rating +1,41,6,4,2,32,1,26,2,20,4,5,3,2,3,3,0,0,0
S01012242,Occupancy rating 0,13,2,1,1,10,0,8,0,7,1,2,2,0,1,1,0,0,0
S01012242,Occupancy rating -1 or less,6,0,0,0,5,0,2,0,2,0,3,3,0,1,1,0,0,0
S01012243,All households,244,59,34,25,177,25,139,38,78,23,13,9,4,8,4,1,0,3
S01012243,Occupancy rating +2 or more,157,43,27,16,111,24,84,28,42,14,3,3,0,3,1,0,0,2
S01012243,Occupancy rating +1,56,14,7,7,40,1,34,9,18,7,5,3,2,2,1,1,0,0
S01012243,Occupancy rating 0,19,1,0,1,18,0,15,1,12,2,3,2,1,0,0,0,0,0
S01012243,Occupancy rating -1 or less,12,1,0,1,8,0,6,0,6,0,2,1,1,3,2,0,0,1
S01012244,All households,347,58,23,35,276,36,230,94,116,20,10,7,3,13,2,0,1,10
S01012244,Occupancy rating +2 or more,273,39,16,23,227,33,189,81,92,16,5,4,1,7,2,0,0,5
S01012244,Occupancy rating +1,46,13,6,7,32,3,26,11,12,3,3,1,2,1,0,0,1,0
S01012244,Occupancy rating 0,14,5,1,4,8,0,8,1,6,1,0,0,0,1,0,0,0,1
S01012244,Occupancy rating -1 or less,14,1,0,1,9,0,7,1,6,0,2,2,0,4,0,0,0,4
S01012245,All households,335,118,76,42,207,36,153,66,74,13,18,11,7,10,6,0,1,3
S01012245,Occupancy rating +2 or more,203,50,31,19,149,29,115,53,53,9,5,2,3,4,2,0,0,2
S01012245,Occupancy rating +1,46,16,11,5,28,3,19,6,11,2,6,4,2,2,1,0,1,0
S01012245,Occupancy rating 0,71,44,28,16,24,3,16,7,7,2,5,4,1,3,2,0,0,1
S01012245,Occupancy rating -1 or less,15,8,6,2,6,1,3,0,3,0,2,1,1,1,1,0,0,0
S01012246,All households,301,58,34,24,238,17,191,70,104,17,30,23,7,5,2,0,0,3
S01012246,Occupancy rating +2 or more,234,45,26,19,187,16,158,62,84,12,13,11,2,2,1,0,0,1
S01012246,Occupancy rating +1,32,10,7,3,22,1,17,7,8,2,4,3,1,0,0,0,0,0
S01012246,Occupancy rating 0,21,2,0,2,18,0,9,1,6,2,9,7,2,1,0,0,0,1
S01012246,Occupancy rating -1 or less,14,1,1,0,11,0,7,0,6,1,4,2,2,2,1,0,0,1
S01012247,All households,303,67,31,36,220,36,166,79,71,16,18,12,6,16,5,0,1,10
S01012247,Occupancy rating +2 or more,218,47,19,28,162,27,127,66,49,12,8,4,4,9,4,0,1,4
S01012247,Occupancy rating +1,42,11,6,5,28,3,22,9,12,1,3,3,0,3,1,0,0,2
S01012247,Occupancy rating 0,37,8,6,2,26,6,14,4,8,2,6,4,2,3,0,0,0,3
S01012247,Occupancy rating -1 or less,6,1,0,1,4,0,3,0,2,1,1,1,0,1,0,0,0,1
S01012248,All households,332,82,33,49,235,28,191,87,85,19,16,13,3,15,6,0,1,8
S01012248,Occupancy rating +2 or more,223,46,16,30,171,23,145,78,54,13,3,3,0,6,3,0,0,3
S01012248,Occupancy rating +1,58,27,11,16,30,4,21,5,13,3,5,4,1,1,0,0,1,0
S01012248,Occupancy rating 0,43,9,6,3,30,1,21,4,15,2,8,6,2,4,1,0,0,3
S01012248,Occupancy rating -1 or less,8,0,0,0,4,0,4,0,3,1,0,0,0,4,2,0,0,2
S01012249,All households,365,95,32,63,261,36,198,79,90,29,27,22,5,9,6,0,0,3
S01012249,Occupancy rating +2 or more,240,59,18,41,176,30,137,66,57,14,9,8,1,5,3,0,0,2
S01012249,Occupancy rating +1,70,19,7,12,49,5,39,11,21,7,5,3,2,2,1,0,0,1
S01012249,Occupancy rating 0,46,12,5,7,33,1,20,2,11,7,12,10,2,1,1,0,0,0
S01012249,Occupancy rating -1 or less,9,5,2,3,3,0,2,0,1,1,1,1,0,1,1,0,0,0
S01012250,All households,301,86,33,53,204,38,155,84,62,9,11,7,4,11,3,0,0,8
S01012250,Occupancy rating +2 or more,216,55,23,32,153,33,113,66,41,6,7,4,3,8,2,0,0,6
S01012250,Occupancy rating +1,51,20,7,13,30,4,24,13,10,1,2,1,1,1,0,0,0,1
S01012250,Occupancy rating 0,28,10,3,7,17,1,14,4,8,2,2,2,0,1,0,0,0,1
S01012250,Occupancy rating -1 or less,6,1,0,1,4,0,4,1,3,0,0,0,0,1,1,0,0,0
S01012251,All households,457,180,90,90,263,29,178,70,80,28,56,35,21,14,5,0,1,8
S01012251,Occupancy rating +2 or more,112,31,17,14,79,16,56,25,26,5,7,4,3,2,0,0,0,2
S01012251,Occupancy rating +1,170,67,35,32,100,11,68,32,28,8,21,11,10,3,2,0,1,0
S01012251,Occupancy rating 0,138,69,31,38,64,2,39,9,19,11,23,17,6,5,0,0,0,5
S01012251,Occupancy rating -1 or less,37,13,7,6,20,0,15,4,7,4,5,3,2,4,3,0,0,1
S01012252,All households,333,128,55,73,199,19,138,48,78,12,42,25,17,6,2,1,0,3
S01012252,Occupancy rating +2 or more,86,20,12,8,64,11,45,13,27,5,8,4,4,2,1,0,0,1
S01012252,Occupancy rating +1,111,53,22,31,58,7,46,27,19,0,5,3,2,0,0,0,0,0
S01012252,Occupancy rating 0,113,49,19,30,61,1,35,7,23,5,25,15,10,3,0,1,0,2
S01012252,Occupancy rating -1 or less,23,6,2,4,16,0,12,1,9,2,4,3,1,1,1,0,0,0
S01012253,All households,508,282,127,155,211,26,158,94,44,20,27,11,16,15,2,0,0,13
S01012253,Occupancy rating +2 or more,130,41,20,21,87,15,68,40,18,10,4,0,4,2,0,0,0,2
S01012253,Occupancy rating +1,130,68,25,43,61,6,46,32,8,6,9,2,7,1,1,0,0,0
S01012253,Occupancy rating 0,191,133,59,74,50,5,35,21,10,4,10,6,4,8,0,0,0,8
S01012253,Occupancy rating -1 or less,57,40,23,17,13,0,9,1,8,0,4,3,1,4,1,0,0,3
S01012254,All households,399,148,68,80,232,31,176,73,81,22,25,13,12,19,2,0,3,14
S01012254,Occupancy rating +2 or more,166,41,21,20,119,18,94,48,32,14,7,4,3,6,1,0,2,3
S01012254,Occupancy rating +1,113,51,20,31,59,9,44,13,28,3,6,3,3,3,0,0,0,3
S01012254,Occupancy rating 0,84,43,23,20,36,2,26,9,13,4,8,3,5,5,0,0,0,5
S01012254,Occupancy rating -1 or less,36,13,4,9,18,2,12,3,8,1,4,3,1,5,1,0,1,3
S01012255,All households,475,221,112,109,243,65,152,86,53,13,26,19,7,11,0,2,2,7
S01012255,Occupancy rating +2 or more,186,55,34,21,127,45,79,49,22,8,3,1,2,4,0,0,1,3
S01012255,Occupancy rating +1,112,54,30,24,58,10,41,18,19,4,7,5,2,0,0,0,0,0
S01012255,Occupancy rating 0,133,84,35,49,44,8,22,17,5,0,14,11,3,5,0,1,1,3
S01012255,Occupancy rating -1 or less,44,28,13,15,14,2,10,2,7,1,2,2,0,2,0,1,0,1
S01012256,All households,327,45,22,23,272,36,196,69,109,18,40,25,15,10,5,0,0,5
S01012256,Occupancy rating +2 or more,228,30,12,18,192,33,142,60,68,14,17,12,5,6,3,0,0,3
S01012256,Occupancy rating +1,46,13,8,5,32,2,27,8,17,2,3,2,1,1,0,0,0,1
S01012256,Occupancy rating 0,44,2,2,0,41,0,23,1,20,2,18,9,9,1,0,0,0,1
S01012256,Occupancy rating -1 or less,9,0,0,0,7,1,4,0,4,0,2,2,0,2,2,0,0,0
S01012257,All households,412,116,52,64,286,56,182,72,79,31,48,31,17,10,1,0,0,9
S01012257,Occupancy rating +2 or more,181,40,27,13,140,42,96,48,36,12,2,1,1,1,0,0,0,1
S01012257,Occupancy rating +1,121,51,19,32,67,14,46,20,19,7,7,3,4,3,1,0,0,2
S01012257,Occupancy rating 0,83,14,2,12,65,0,33,4,19,10,32,22,10,4,0,0,0,4
S01012257,Occupancy rating -1 or less,27,11,4,7,14,0,7,0,5,2,7,5,2,2,0,0,0,2
S01012258,All households,297,50,32,18,242,49,173,70,86,17,20,14,6,5,2,0,0,3
S01012258,Occupancy rating +2 or more,243,36,26,10,202,46,148,64,71,13,8,5,3,5,2,0,0,3
S01012258,Occupancy rating +1,33,5,4,1,28,2,20,6,12,2,6,4,2,0,0,0,0,0
S01012258,Occupancy rating 0,17,9,2,7,8,1,2,0,1,1,5,5,0,0,0,0,0,0
S01012258,Occupancy rating -1 or less,4,0,0,0,4,0,3,0,2,1,1,0,1,0,0,0,0,0
S01012259,All households,277,81,51,30,194,62,126,54,54,18,6,3,3,2,0,0,1,1
S01012259,Occupancy rating +2 or more,229,63,43,20,165,57,105,50,42,13,3,2,1,1,0,0,0,1
S01012259,Occupancy rating +1,32,11,7,4,21,5,13,4,6,3,3,1,2,0,0,0,0,0
S01012259,Occupancy rating 0,15,6,0,6,8,0,8,0,6,2,0,0,0,1,0,0,1,0
S01012259,Occupancy rating -1 or less,1,1,1,0,0,0,0,0,0,0,0,0,0,0,0,0,0,0
S01012260,All households,368,113,76,37,250,43,177,58,91,28,30,15,15,5,1,0,1,3
S01012260,Occupancy rating +2 or more,187,44,28,16,143,29,108,41,58,9,6,1,5,0,0,0,0,0
S01012260,Occupancy rating +1,87,37,22,15,48,10,30,13,8,9,8,4,4,2,0,0,0,2
S01012260,Occupancy rating 0,78,30,24,6,47,4,28,2,18,8,15,9,6,1,1,0,0,0
S01012260,Occupancy rating -1 or less,16,2,2,0,12,0,11,2,7,2,1,1,0,2,0,0,1,1
S01012261,All households,322,53,24,29,263,35,206,73,126,7,22,16,6,6,4,0,0,2
S01012261,Occupancy rating +2 or more,240,42,21,21,195,31,155,67,83,5,9,9,0,3,2,0,0,1
S01012261,Occupancy rating +1,48,9,3,6,39,4,30,4,26,0,5,2,3,0,0,0,0,0
S01012261,Occupancy rating 0,23,0,0,0,22,0,16,1,13,2,6,4,2,1,1,0,0,0
S01012261,Occupancy rating -1 or less,11,2,0,2,7,0,5,1,4,0,2,1,1,2,1,0,0,1
S01012262,All households,343,101,33,68,231,28,191,98,75,18,12,7,5,11,4,0,2,5
S01012262,Occupancy rating +2 or more,243,63,26,37,173,24,144,87,46,11,5,2,3,7,2,0,2,3
S01012262,Occupancy rating +1,59,21,4,17,35,4,31,10,15,6,0,0,0,3,1,0,0,2
S01012262,Occupancy rating 0,32,13,3,10,19,0,12,1,10,1,7,5,2,0,0,0,0,0
S01012262,Occupancy rating -1 or less,9,4,0,4,4,0,4,0,4,0,0,0,0,1,1,0,0,0
S01012263,All households,366,168,48,120,184,26,122,56,52,14,36,25,11,14,4,0,0,10
S01012263,Occupancy rating +2 or more,114,41,15,26,71,18,48,34,10,4,5,4,1,2,1,0,0,1
S01012263,Occupancy rating +1,108,54,13,41,49,5,37,17,16,4,7,5,2,5,2,0,0,3
S01012263,Occupancy rating 0,106,57,17,40,46,3,30,5,20,5,13,8,5,3,1,0,0,2
S01012263,Occupancy rating -1 or less,38,16,3,13,18,0,7,0,6,1,11,8,3,4,0,0,0,4
S01012264,All households,222,81,34,47,139,25,95,40,42,13,19,13,6,2,0,0,0,2
S01012264,Occupancy rating +2 or more,106,25,16,9,81,16,62,30,23,9,3,3,0,0,0,0,0,0
S01012264,Occupancy rating +1,50,24,9,15,25,6,17,8,7,2,2,1,1,1,0,0,0,1
S01012264,Occupancy rating 0,50,21,4,17,29,2,14,2,11,1,13,9,4,0,0,0,0,0
S01012264,Occupancy rating -1 or less,16,11,5,6,4,1,2,0,1,1,1,0,1,1,0,0,0,1
S01012265,All households,340,102,49,53,224,35,144,53,63,28,45,27,18,14,10,0,0,4
S01012265,Occupancy rating +2 or more,119,50,26,24,68,19,46,35,9,2,3,0,3,1,1,0,0,0
S01012265,Occupancy rating +1,107,31,14,17,74,11,49,15,19,15,14,8,6,2,1,0,0,1
S01012265,Occupancy rating 0,84,19,8,11,58,3,32,2,22,8,23,16,7,7,5,0,0,2
S01012265,Occupancy rating -1 or less,30,2,1,1,24,2,17,1,13,3,5,3,2,4,3,0,0,1
S01012266,All households,536,211,113,98,315,64,216,113,81,22,35,23,12,10,4,1,1,4
S01012266,Occupancy rating +2 or more,222,58,24,34,160,34,121,71,40,10,5,5,0,4,1,1,0,2
S01012266,Occupancy rating +1,143,68,32,36,73,16,48,26,18,4,9,5,4,2,1,0,0,1
S01012266,Occupancy rating 0,146,71,47,24,72,12,41,15,19,7,19,12,7,3,2,0,1,0
S01012266,Occupancy rating -1 or less,25,14,10,4,10,2,6,1,4,1,2,1,1,1,0,0,0,1
S01012267,All households,318,98,36,62,218,39,160,83,61,16,19,11,8,2,1,0,0,1
S01012267,Occupancy rating +2 or more,194,39,21,18,154,37,107,54,42,11,10,5,5,1,0,0,0,1
S01012267,Occupancy rating +1,80,35,12,23,45,2,39,25,10,4,4,3,1,0,0,0,0,0
S01012267,Occupancy rating 0,33,16,1,15,17,0,13,4,8,1,4,2,2,0,0,0,0,0
S01012267,Occupancy rating -1 or less,11,8,2,6,2,0,1,0,1,0,1,1,0,1,1,0,0,0
S01012268,All households,265,83,32,51,176,15,151,60,69,22,10,6,4,6,3,0,0,3
S01012268,Occupancy rating +2 or more,174,51,20,31,120,13,102,50,40,12,5,2,3,3,2,0,0,1
S01012268,Occupancy rating +1,58,25,9,16,31,2,26,5,15,6,3,2,1,2,0,0,0,2
S01012268,Occupancy rating 0,23,3,1,2,19,0,17,3,11,3,2,2,0,1,1,0,0,0
S01012268,Occupancy rating -1 or less,10,4,2,2,6,0,6,2,3,1,0,0,0,0,0,0,0,0
S01012269,All households,461,164,97,67,288,48,209,92,88,29,31,15,16,9,4,0,0,5
S01012269,Occupancy rating +2 or more,265,78,37,41,183,31,138,73,49,16,14,6,8,4,4,0,0,0
S01012269,Occupancy rating +1,86,28,17,11,56,10,40,13,19,8,6,2,4,2,0,0,0,2
S01012269,Occupancy rating 0,96,49,38,11,44,7,29,5,19,5,8,5,3,3,0,0,0,3
S01012269,Occupancy rating -1 or less,14,9,5,4,5,0,2,1,1,0,3,2,1,0,0,0,0,0
S01012270,All households,348,114,48,66,225,31,147,62,66,19,47,33,14,9,1,2,2,4
S01012270,Occupancy rating +2 or more,136,44,20,24,89,12,65,37,23,5,12,7,5,3,0,1,0,2
S01012270,Occupancy rating +1,115,44,18,26,69,14,44,18,18,8,11,7,4,2,0,0,1,1
S01012270,Occupancy rating 0,80,22,7,15,55,4,31,5,21,5,20,16,4,3,0,1,1,1
S01012270,Occupancy rating -1 or less,17,4,3,1,12,1,7,2,4,1,4,3,1,1,1,0,0,0
S01012271,All households,421,98,28,70,311,32,267,127,112,28,12,7,5,12,6,0,1,5
S01012271,Occupancy rating +2 or more,290,65,19,46,220,26,191,105,68,18,3,0,3,5,4,0,0,1
S01012271,Occupancy rating +1,78,24,7,17,52,6,45,18,24,3,1,0,1,2,0,0,1,1
S01012271,Occupancy rating 0,40,7,1,6,30,0,23,1,15,7,7,6,1,3,1,0,0,2
S01012271,Occupancy rating -1 or less,13,2,1,1,9,0,8,3,5,0,1,1,0,2,1,0,0,1
S01012272,All households,305,89,41,48,209,24,161,69,70,22,24,19,5,7,3,0,0,4
S01012272,Occupancy rating +2 or more,170,32,20,12,134,17,113,54,47,12,4,3,1,4,2,0,0,2
S01012272,Occupancy rating +1,65,27,9,18,37,1,25,10,9,6,11,8,3,1,1,0,0,0
S01012272,Occupancy rating 0,58,26,10,16,30,4,19,4,12,3,7,6,1,2,0,0,0,2
S01012272,Occupancy rating -1 or less,12,4,2,2,8,2,4,1,2,1,2,2,0,0,0,0,0,0
S01012273,All households,297,63,37,26,224,39,167,85,58,24,18,11,7,10,3,1,1,5
S01012273,Occupancy rating +2 or more,204,41,23,18,160,30,123,69,38,16,7,5,2,3,1,0,0,2
S01012273,Occupancy rating +1,58,15,11,4,40,6,29,15,8,6,5,2,3,3,0,0,0,3
S01012273,Occupancy rating 0,30,7,3,4,20,3,13,1,10,2,4,3,1,3,1,1,1,0
S01012273,Occupancy rating -1 or less,5,0,0,0,4,0,2,0,2,0,2,1,1,1,1,0,0,0
S01012274,All households,432,147,40,107,275,25,212,108,82,22,38,19,19,10,3,0,0,7
S01012274,Occupancy rating +2 or more,180,36,14,22,141,18,116,67,34,15,7,1,6,3,1,0,0,2
S01012274,Occupancy rating +1,142,65,15,50,74,6,60,35,22,3,8,2,6,3,0,0,0,3
S01012274,Occupancy rating 0,76,29,7,22,44,1,27,4,19,4,16,11,5,3,1,0,0,2
S01012274,Occupancy rating -1 or less,34,17,4,13,16,0,9,2,7,0,7,5,2,1,1,0,0,0
S01012275,All households,450,228,45,183,179,17,130,75,41,14,32,22,10,43,4,22,2,15
S01012275,Occupancy rating +2 or more,95,42,15,27,50,8,38,26,7,5,4,2,2,3,1,2,0,0
S01012275,Occupancy rating +1,123,64,17,47,56,5,46,30,12,4,5,5,0,3,0,1,0,2
S01012275,Occupancy rating 0,160,78,7,71,56,3,38,15,18,5,15,9,6,26,3,14,2,7
S01012275,Occupancy rating -1 or less,72,44,6,38,17,1,8,4,4,0,8,6,2,11,0,5,0,6
S01012276,All households,463,203,62,141,244,27,189,90,70,29,28,19,9,16,3,3,1,9
S01012276,Occupancy rating +2 or more,185,48,23,25,129,23,106,65,29,12,0,0,0,8,1,3,0,4
S01012276,Occupancy rating +1,100,43,8,35,57,3,46,15,22,9,8,3,5,0,0,0,0,0
S01012276,Occupancy rating 0,116,67,12,55,42,1,27,6,15,6,14,11,3,7,1,0,1,5
S01012276,Occupancy rating -1 or less,62,45,19,26,16,0,10,4,4,2,6,5,1,1,1,0,0,0
S01012277,All households,482,169,42,127,291,30,219,99,95,25,42,33,9,22,8,4,2,8
S01012277,Occupancy rating +2 or more,175,50,13,37,120,17,97,62,26,9,6,4,2,5,4,0,0,1
S01012277,Occupancy rating +1,155,58,18,40,92,9,71,30,30,11,12,11,1,5,1,2,0,2
S01012277,Occupancy rating 0,118,44,6,38,66,4,41,4,32,5,21,17,4,8,1,1,1,5
S01012277,Occupancy rating -1 or less,34,17,5,12,13,0,10,3,7,0,3,1,2,4,2,1,1,0
S01012278,All households,401,238,73,165,133,26,94,45,39,10,13,9,4,30,2,14,3,11
S01012278,Occupancy rating +2 or more,101,35,15,20,62,17,43,20,19,4,2,2,0,4,0,2,0,2
S01012278,Occupancy rating +1,99,59,26,33,35,4,29,16,9,4,2,1,1,5,1,1,1,2
S01012278,Occupancy rating 0,156,115,29,86,27,3,18,8,8,2,6,4,2,14,0,8,0,6
S01012278,Occupancy rating -1 or less,45,29,3,26,9,2,4,1,3,0,3,2,1,7,1,3,2,1
S01012279,All households,407,186,35,151,198,16,133,71,51,11,49,40,9,23,5,7,2,9
S01012279,Occupancy rating +2 or more,91,31,8,23,58,4,50,37,8,5,4,2,2,2,1,0,1,0
S01012279,Occupancy rating +1,117,56,12,44,56,9,38,21,13,4,9,6,3,5,0,3,0,2
S01012279,Occupancy rating 0,145,66,9,57,68,2,37,10,25,2,29,25,4,11,2,4,0,5
S01012279,Occupancy rating -1 or less,54,33,6,27,16,1,8,3,5,0,7,7,0,5,2,0,1,2
S01012280,All households,409,128,53,75,256,27,176,73,74,29,53,35,18,25,8,1,1,15
S01012280,Occupancy rating +2 or more,143,54,22,32,84,16,64,45,9,10,4,2,2,5,1,0,0,4
S01012280,Occupancy rating +1,141,45,21,24,88,10,61,25,27,9,17,7,10,8,1,0,1,6
S01012280,Occupancy rating 0,99,26,9,17,65,1,40,2,31,7,24,20,4,8,4,0,0,4
S01012280,Occupancy rating -1 or less,26,3,1,2,19,0,11,1,7,3,8,6,2,4,2,1,0,1
S01012281,All households,371,173,63,110,182,29,130,65,44,21,23,14,9,16,1,3,2,10
S01012281,Occupancy rating +2 or more,115,46,22,24,68,15,48,32,9,7,5,1,4,1,0,0,0,1
S01012281,Occupancy rating +1,110,41,11,30,64,8,49,20,21,8,7,4,3,5,0,1,1,3
S01012281,Occupancy rating 0,103,59,21,38,37,3,26,9,12,5,8,7,1,7,1,1,0,5
S01012281,Occupancy rating -1 or less,43,27,9,18,13,3,7,4,2,1,3,2,1,3,0,1,1,1
S01012282,All households,466,187,116,71,270,61,180,78,78,24,29,15,14,9,1,5,0,3
S01012282,Occupancy rating +2 or more,209,55,28,27,154,22,121,60,47,14,11,5,6,0,0,0,0,0
S01012282,Occupancy rating +1,125,57,39,18,65,22,39,13,20,6,4,1,3,3,1,1,0,1
S01012282,Occupancy rating 0,117,69,44,25,43,14,18,4,10,4,11,6,5,5,0,4,0,1
S01012282,Occupancy rating -1 or less,15,6,5,1,8,3,2,1,1,0,3,3,0,1,0,0,0,1
S01012283,All households,369,123,50,73,231,23,178,62,88,28,30,22,8,15,6,2,0,7
S01012283,Occupancy rating +2 or more,224,62,32,30,155,21,125,51,56,18,9,8,1,7,2,0,0,5
S01012283,Occupancy rating +1,58,21,11,10,36,1,28,8,16,4,7,5,2,1,1,0,0,0
S01012283,Occupancy rating 0,64,24,4,20,37,1,24,3,15,6,12,7,5,3,2,0,0,1
S01012283,Occupancy rating -1 or less,23,16,3,13,3,0,1,0,1,0,2,2,0,4,1,2,0,1
S01012284,All households,436,230,98,132,186,27,119,67,40,12,40,25,15,20,4,8,1,7
S01012284,Occupancy rating +2 or more,125,56,28,28,66,16,46,34,8,4,4,2,2,3,0,1,1,1
S01012284,Occupancy rating +1,145,71,30,41,71,7,47,29,13,5,17,8,9,3,0,2,0,1
S01012284,Occupancy rating 0,114,68,22,46,41,4,22,3,16,3,15,12,3,5,2,2,0,1
S01012284,Occupancy rating -1 or less,52,35,18,17,8,0,4,1,3,0,4,3,1,9,2,3,0,4
S01012285,All households,266,86,47,39,173,34,130,77,35,18,9,3,6,7,2,1,1,3
S01012285,Occupancy rating +2 or more,158,34,23,11,121,22,96,69,19,8,3,0,3,3,2,0,0,1
S01012285,Occupancy rating +1,46,9,3,6,36,6,27,6,13,8,3,2,1,1,0,0,0,1
S01012285,Occupancy rating 0,27,15,10,5,11,3,6,1,3,2,2,1,1,1,0,0,1,0
S01012285,Occupancy rating -1 or less,35,28,11,17,5,3,1,1,0,0,1,0,1,2,0,1,0,1
S01012286,All households,493,158,47,111,298,33,201,107,75,19,64,42,22,37,5,19,1,12
S01012286,Occupancy rating +2 or more,168,50,19,31,115,19,90,69,17,4,6,2,4,3,0,3,0,0
S01012286,Occupancy rating +1,158,67,16,51,85,11,63,33,24,6,11,5,6,6,0,1,0,5
S01012286,Occupancy rating 0,126,33,8,25,73,2,37,5,23,9,34,26,8,20,2,11,1,6
S01012286,Occupancy rating -1 or less,41,8,4,4,25,1,11,0,11,0,13,9,4,8,3,4,0,1
S01012287,All households,479,196,63,133,271,24,166,62,89,15,81,59,22,12,6,0,0,6
S01012287,Occupancy rating +2 or more,83,37,19,18,45,7,31,25,5,1,7,4,3,1,1,0,0,0
S01012287,Occupancy rating +1,179,90,30,60,86,15,55,26,24,5,16,11,5,3,0,0,0,3
S01012287,Occupancy rating 0,175,62,13,49,110,1,65,9,48,8,44,31,13,3,2,0,0,1
S01012287,Occupancy rating -1 or less,42,7,1,6,30,1,15,2,12,1,14,13,1,5,3,0,0,2
S01012288,All households,377,161,52,109,199,28,119,49,52,18,52,36,16,17,3,1,0,13
S01012288,Occupancy rating +2 or more,108,49,25,24,57,19,35,25,7,3,3,1,2,2,0,0,0,2
S01012288,Occupancy rating +1,123,61,20,41,60,7,38,16,13,9,15,10,5,2,0,0,0,2
S01012288,Occupancy rating 0,111,39,5,34,65,1,36,8,24,4,28,19,9,7,2,1,0,4
S01012288,Occupancy rating -1 or less,35,12,2,10,17,1,10,0,8,2,6,6,0,6,1,0,0,5
S01012289,All households,411,149,78,71,251,68,166,80,67,19,17,11,6,11,0,1,1,9
S01012289,Occupancy rating +2 or more,297,86,51,35,206,61,137,71,50,16,8,4,4,5,0,0,1,4
S01012289,Occupancy rating +1,69,38,19,19,30,6,19,9,9,1,5,3,2,1,0,0,0,1
S01012289,Occupancy rating 0,31,19,7,12,9,1,6,0,5,1,2,2,0,3,0,0,0,3
S01012289,Occupancy rating -1 or less,14,6,1,5,6,0,4,0,3,1,2,2,0,2,0,1,0,1
S01012290,All households,292,132,79,53,150,21,107,38,55,14,22,16,6,10,2,0,3,5
S01012290,Occupancy rating +2 or more,108,41,26,15,66,13,49,25,21,3,4,2,2,1,1,0,0,0
S01012290,Occupancy rating +1,77,33,15,18,40,2,33,7,17,9,5,3,2,4,0,0,1,3
S01012290,Occupancy rating 0,72,35,18,17,36,5,22,6,15,1,9,7,2,1,0,0,1,0
S01012290,Occupancy rating -1 or less,35,23,20,3,8,1,3,0,2,1,4,4,0,4,1,0,1,2
S01012291,All households,421,135,46,89,276,31,203,82,104,17,42,32,10,10,1,0,0,9
S01012291,Occupancy rating +2 or more,203,50,23,27,153,23,116,50,57,9,14,11,3,0,0,0,0,0
S01012291,Occupancy rating +1,108,37,9,28,67,7,49,24,21,4,11,8,3,4,1,0,0,3
S01012291,Occupancy rating 0,93,43,11,32,48,1,32,7,23,2,15,11,4,2,0,0,0,2
S01012291,Occupancy rating -1 or less,17,5,3,2,8,0,6,1,3,2,2,2,0,4,0,0,0,4
S01012292,All households,341,120,74,46,214,66,124,56,56,12,24,16,8,7,1,0,2,4
S01012292,Occupancy rating +2 or more,231,59,48,11,167,59,98,48,41,9,10,7,3,5,1,0,2,2
S01012292,Occupancy rating +1,65,38,13,25,26,5,18,7,10,1,3,1,2,1,0,0,0,1
S01012292,Occupancy rating 0,40,21,11,10,18,2,8,1,5,2,8,5,3,1,0,0,0,1
S01012292,Occupancy rating -1 or less,5,2,2,0,3,0,0,0,0,0,3,3,0,0,0,0,0,0
S01012293,All households,212,70,28,42,136,22,104,46,47,11,10,9,1,6,2,0,1,3
S01012293,Occupancy rating +2 or more,120,31,16,15,86,19,64,36,22,6,3,3,0,3,0,0,1,2
S01012293,Occupancy rating +1,56,28,11,17,28,2,23,7,13,3,3,3,0,0,0,0,0,0
S01012293,Occupancy rating 0,32,11,1,10,21,1,17,3,12,2,3,3,0,0,0,0,0,0
S01012293,Occupancy rating -1 or less,4,0,0,0,1,0,0,0,0,0,1,0,1,3,2,0,0,1
S01012294,All households,371,101,34,67,256,21,193,82,84,27,42,31,11,14,4,0,1,9
S01012294,Occupancy rating +2 or more,170,35,13,22,130,18,104,53,37,14,8,4,4,5,1,0,0,4
S01012294,Occupancy rating +1,101,28,12,16,70,1,56,25,22,9,13,9,4,3,1,0,0,2
S01012294,Occupancy rating 0,79,31,8,23,45,2,24,2,18,4,19,17,2,3,0,0,1,2
S01012294,Occupancy rating -1 or less,21,7,1,6,11,0,9,2,7,0,2,1,1,3,2,0,0,1
S01012295,All households,280,65,11,54,202,9,168,54,96,18,25,21,4,13,6,0,0,7
S01012295,Occupancy rating +2 or more,139,17,3,14,120,6,106,34,65,7,8,5,3,2,1,0,0,1
S01012295,Occupancy rating +1,85,30,3,27,49,2,41,16,17,8,6,6,0,6,2,0,0,4
S01012295,Occupancy rating 0,49,17,5,12,28,1,17,4,10,3,10,9,1,4,2,0,0,2
S01012295,Occupancy rating -1 or less,7,1,0,1,5,0,4,0,4,0,1,1,0,1,1,0,0,0
S01012296,All households,330,66,21,45,259,12,216,75,119,22,31,24,7,5,2,1,0,2
S01012296,Occupancy rating +2 or more,233,36,9,27,195,10,172,64,93,15,13,12,1,2,2,0,0,0
S01012296,Occupancy rating +1,46,16,6,10,28,2,21,7,9,5,5,2,3,2,0,1,0,1
S01012296,Occupancy rating 0,39,10,6,4,29,0,17,1,14,2,12,10,2,0,0,0,0,0
S01012296,Occupancy rating -1 or less,12,4,0,4,7,0,6,3,3,0,1,0,1,1,0,0,0,1
S01012297,All households,253,63,27,36,182,26,145,79,55,11,11,7,4,8,3,0,0,5
S01012297,Occupancy rating +2 or more,199,47,20,27,145,22,116,67,39,10,7,3,4,7,3,0,0,4
S01012297,Occupancy rating +1,38,12,6,6,26,3,23,12,10,1,0,0,0,0,0,0,0,0
S01012297,Occupancy rating 0,14,3,1,2,10,1,6,0,6,0,3,3,0,1,0,0,0,1
S01012297,Occupancy rating -1 or less,2,1,0,1,1,0,0,0,0,0,1,1,0,0,0,0,0,0
S01012298,All households,374,130,69,61,235,36,179,78,73,28,20,12,8,9,1,0,1,7
S01012298,Occupancy rating +2 or more,219,63,32,31,152,29,114,56,42,16,9,5,4,4,0,0,1,3
S01012298,Occupancy rating +1,86,28,10,18,54,5,43,15,18,10,6,4,2,4,1,0,0,3
S01012298,Occupancy rating 0,57,34,25,9,22,2,17,6,9,2,3,2,1,1,0,0,0,1
S01012298,Occupancy rating -1 or less,12,5,2,3,7,0,5,1,4,0,2,1,1,0,0,0,0,0
S01012299,All households,257,47,19,28,202,25,156,78,63,15,21,12,9,8,3,0,0,5
S01012299,Occupancy rating +2 or more,199,34,14,20,159,22,125,70,47,8,12,5,7,6,3,0,0,3
S01012299,Occupancy rating +1,35,11,3,8,22,3,16,5,8,3,3,3,0,2,0,0,0,2
S01012299,Occupancy rating 0,16,2,2,0,14,0,10,1,6,3,4,2,2,0,0,0,0,0
S01012299,Occupancy rating -1 or less,7,0,0,0,7,0,5,2,2,1,2,2,0,0,0,0,0,0
S01012300,All households,294,103,54,49,182,27,135,56,62,17,20,13,7,9,2,0,1,6
S01012300,Occupancy rating +2 or more,138,39,22,17,97,20,73,40,24,9,4,1,3,2,0,0,1,1
S01012300,Occupancy rating +1,71,30,12,18,39,5,27,12,12,3,7,5,2,2,0,0,0,2
S01012300,Occupancy rating 0,73,32,19,13,40,2,31,4,23,4,7,6,1,1,1,0,0,0
S01012300,Occupancy rating -1 or less,12,2,1,1,6,0,4,0,3,1,2,1,1,4,1,0,0,3
S01012301,All households,407,91,37,54,305,45,227,115,80,32,33,20,13,11,2,0,0,9
S01012301,Occupancy rating +2 or more,270,56,26,30,207,34,161,95,45,21,12,6,6,7,1,0,0,6
S01012301,Occupancy rating +1,77,23,7,16,52,8,36,17,15,4,8,6,2,2,1,0,0,1
S01012301,Occupancy rating 0,48,9,3,6,37,3,25,3,16,6,9,5,4,2,0,0,0,2
S01012301,Occupancy rating -1 or less,12,3,1,2,9,0,5,0,4,1,4,3,1,0,0,0,0,0
S01012302,All households,240,65,17,48,164,22,132,72,51,9,10,7,3,11,4,0,0,7
S01012302,Occupancy rating +2 or more,168,38,10,28,121,19,96,60,33,3,6,5,1,9,3,0,0,6
S01012302,Occupancy rating +1,36,14,2,12,22,3,18,7,8,3,1,0,1,0,0,0,0,0
S01012302,Occupancy rating 0,33,13,5,8,20,0,18,5,10,3,2,1,1,0,0,0,0,0
S01012302,Occupancy rating -1 or less,3,0,0,0,1,0,0,0,0,0,1,1,0,2,1,0,0,1
S01012303,All households,378,93,46,47,278,39,220,105,88,27,19,13,6,7,2,0,0,5
S01012303,Occupancy rating +2 or more,274,54,28,26,217,37,174,92,62,20,6,5,1,3,0,0,0,3
S01012303,Occupancy rating +1,60,28,12,16,30,1,22,9,9,4,7,4,3,2,1,0,0,1
S01012303,Occupancy rating 0,35,9,6,3,24,1,18,2,14,2,5,3,2,2,1,0,0,1
S01012303,Occupancy rating -1 or less,9,2,0,2,7,0,6,2,3,1,1,1,0,0,0,0,0,0
S01012304,All households,424,108,45,63,295,54,206,100,78,28,35,22,13,21,7,0,4,10
S01012304,Occupancy rating +2 or more,282,58,28,30,210,48,154,85,54,15,8,3,5,14,5,0,4,5
S01012304,Occupancy rating +1,75,31,12,19,38,6,22,11,6,5,10,6,4,6,2,0,0,4
S01012304,Occupancy rating 0,51,13,4,9,37,0,24,3,15,6,13,10,3,1,0,0,0,1
S01012304,Occupancy rating -1 or less,16,6,1,5,10,0,6,1,3,2,4,3,1,0,0,0,0,0
S01012305,All households,333,127,64,63,197,45,125,53,53,19,27,19,8,9,4,0,0,5
S01012305,Occupancy rating +2 or more,174,53,28,25,120,29,84,41,29,14,7,3,4,1,0,0,0,1
S01012305,Occupancy rating +1,63,23,9,14,38,11,23,8,11,4,4,3,1,2,1,0,0,1
S01012305,Occupancy rating 0,75,39,23,16,32,5,15,4,10,1,12,9,3,4,1,0,0,3
S01012305,Occupancy rating -1 or less,21,12,4,8,7,0,3,0,3,0,4,4,0,2,2,0,0,0
S01012306,All households,308,150,90,60,150,29,96,40,45,11,25,14,11,8,3,0,1,4
S01012306,Occupancy rating +2 or more,91,33,14,19,56,12,42,24,14,4,2,0,2,2,0,0,1,1
S01012306,Occupancy rating +1,78,39,20,19,36,7,23,10,9,4,6,1,5,3,1,0,0,2
S01012306,Occupancy rating 0,116,65,51,14,50,10,25,6,16,3,15,11,4,1,0,0,0,1
S01012306,Occupancy rating -1 or less,23,13,5,8,8,0,6,0,6,0,2,2,0,2,2,0,0,0
S01012307,All households,323,144,49,95,173,37,108,49,41,18,28,19,9,6,1,0,1,4
S01012307,Occupancy rating +2 or more,119,35,17,18,82,23,53,25,20,8,6,4,2,2,0,0,1,1
S01012307,Occupancy rating +1,75,36,11,25,38,11,21,15,2,4,6,4,2,1,0,0,0,1
S01012307,Occupancy rating 0,115,66,19,47,47,2,30,9,16,5,15,11,4,2,1,0,0,1
S01012307,Occupancy rating -1 or less,14,7,2,5,6,1,4,0,3,1,1,0,1,1,0,0,0,1
S01012308,All households,334,75,41,34,248,33,189,67,89,33,26,12,14,11,6,0,0,5
S01012308,Occupancy rating +2 or more,187,53,29,24,131,24,103,62,27,14,4,3,1,3,2,0,0,1
S01012308,Occupancy rating +1,84,18,9,9,63,5,47,3,31,13,11,1,10,3,1,0,0,2
S01012308,Occupancy rating 0,45,3,3,0,39,2,31,1,24,6,6,4,2,3,2,0,0,1
S01012308,Occupancy rating -1 or less,18,1,0,1,15,2,8,1,7,0,5,4,1,2,1,0,0,1
S01012309,All households,245,71,40,31,169,34,115,59,35,21,20,9,11,5,1,0,1,3
S01012309,Occupancy rating +2 or more,146,38,20,18,106,23,76,48,15,13,7,3,4,2,0,0,0,2
S01012309,Occupancy rating +1,40,16,7,9,23,5,15,6,5,4,3,0,3,1,0,0,1,0
S01012309,Occupancy rating 0,52,16,12,4,35,6,20,5,13,2,9,5,4,1,0,0,0,1
S01012309,Occupancy rating -1 or less,7,1,1,0,5,0,4,0,2,2,1,1,0,1,1,0,0,0
S01012310,All households,427,131,52,79,282,58,190,114,56,20,34,18,16,14,5,1,4,4
S01012310,Occupancy rating +2 or more,265,72,28,44,185,48,122,84,27,11,15,7,8,8,4,0,1,3
S01012310,Occupancy rating +1,95,39,18,21,55,8,38,24,10,4,9,4,5,1,0,0,1,0
S01012310,Occupancy rating 0,52,15,5,10,34,2,25,6,16,3,7,5,2,3,1,1,0,1
S01012310,Occupancy rating -1 or less,15,5,1,4,8,0,5,0,3,2,3,2,1,2,0,0,2,0
S01012311,All households,263,90,61,29,162,35,107,49,40,18,20,8,12,11,3,0,1,7
S01012311,Occupancy rating +2 or more,170,59,40,19,109,30,69,41,18,10,10,3,7,2,0,0,0,2
S01012311,Occupancy rating +1,49,18,15,3,30,4,20,4,12,4,6,2,4,1,0,0,0,1
S01012311,Occupancy rating 0,37,12,6,6,17,1,13,3,9,1,3,2,1,8,3,0,1,4
S01012311,Occupancy rating -1 or less,7,1,0,1,6,0,5,1,1,3,1,1,0,0,0,0,0,0
S01012312,All households,439,122,47,75,289,43,221,119,71,31,25,13,12,28,12,3,2,11
S01012312,Occupancy rating +2 or more,290,80,36,44,193,33,149,96,37,16,11,4,7,17,7,0,2,8
S01012312,Occupancy rating +1,89,29,6,23,59,8,46,20,16,10,5,2,3,1,1,0,0,0
S01012312,Occupancy rating 0,52,11,5,6,33,2,23,3,17,3,8,6,2,8,2,3,0,3
S01012312,Occupancy rating -1 or less,8,2,0,2,4,0,3,0,1,2,1,1,0,2,2,0,0,0
S01012313,All households,345,102,42,60,233,35,176,90,69,17,22,10,12,10,3,0,0,7
S01012313,Occupancy rating +2 or more,190,45,18,27,140,28,103,62,32,9,9,3,6,5,3,0,0,2
S01012313,Occupancy rating +1,94,36,14,22,57,6,48,21,22,5,3,1,2,1,0,0,0,1
S01012313,Occupancy rating 0,52,19,9,10,30,1,22,7,12,3,7,4,3,3,0,0,0,3
S01012313,Occupancy rating -1 or less,9,2,1,1,6,0,3,0,3,0,3,2,1,1,0,0,0,1
S01012314,All households,365,106,57,49,242,35,152,60,68,24,55,34,21,17,10,0,1,6
S01012314,Occupancy rating +2 or more,120,35,24,11,78,23,55,37,14,4,0,0,0,7,3,0,0,4
S01012314,Occupancy rating +1,109,44,18,26,63,7,41,19,11,11,15,8,7,2,0,0,0,2
S01012314,Occupancy rating 0,99,21,12,9,75,4,44,2,36,6,27,19,8,3,2,0,1,0
S01012314,Occupancy rating -1 or less,37,6,3,3,26,1,12,2,7,3,13,7,6,5,5,0,0,0
S01012315,All households,400,207,92,115,179,43,113,70,29,14,23,12,11,14,3,3,0,8
S01012315,Occupancy rating +2 or more,157,55,26,29,97,28,67,44,14,9,2,1,1,5,3,0,0,2
S01012315,Occupancy rating +1,89,44,15,29,43,11,25,14,7,4,7,2,5,2,0,0,0,2
S01012315,Occupancy rating 0,100,68,30,38,27,4,13,8,5,0,10,6,4,5,0,3,0,2
S01012315,Occupancy rating -1 or less,54,40,21,19,12,0,8,4,3,1,4,3,1,2,0,0,0,2
S01012316,All households,315,122,59,63,183,31,113,66,32,15,39,28,11,10,6,0,0,4
S01012316,Occupancy rating +2 or more,101,35,16,19,64,16,45,32,7,6,3,3,0,2,2,0,0,0
S01012316,Occupancy rating +1,116,58,28,30,58,13,39,31,6,2,6,2,4,0,0,0,0,0
S01012316,Occupancy rating 0,78,24,13,11,51,2,23,3,14,6,26,20,6,3,1,0,0,2
S01012316,Occupancy rating -1 or less,20,5,2,3,10,0,6,0,5,1,4,3,1,5,3,0,0,2
S01012317,All households,209,42,26,16,159,22,114,45,62,7,23,18,5,8,7,0,0,1
S01012317,Occupancy rating +2 or more,133,19,9,10,110,16,87,42,43,2,7,5,2,4,3,0,0,1
S01012317,Occupancy rating +1,33,9,5,4,23,4,14,3,9,2,5,2,3,1,1,0,0,0
S01012317,Occupancy rating 0,25,6,6,0,18,2,8,0,5,3,8,8,0,1,1,0,0,0
S01012317,Occupancy rating -1 or less,18,8,6,2,8,0,5,0,5,0,3,3,0,2,2,0,0,0
S01012318,All households,329,81,30,51,236,20,186,80,74,32,30,23,7,12,7,0,1,4
S01012318,Occupancy rating +2 or more,113,28,9,19,82,13,67,51,10,6,2,1,1,3,1,0,0,2
S01012318,Occupancy rating +1,104,35,11,24,67,4,59,23,22,14,4,2,2,2,1,0,0,1
S01012318,Occupancy rating 0,86,14,7,7,69,2,47,6,30,11,20,16,4,3,2,0,0,1
S01012318,Occupancy rating -1 or less,26,4,3,1,18,1,13,0,12,1,4,4,0,4,3,0,1,0
S01012319,All households,343,104,44,60,222,34,170,83,64,23,18,12,6,17,5,0,0,12
S01012319,Occupancy rating +2 or more,249,74,33,41,165,29,128,72,42,14,8,4,4,10,1,0,0,9
S01012319,Occupancy rating +1,62,24,8,16,35,4,26,8,11,7,5,4,1,3,1,0,0,2
S01012319,Occupancy rating 0,28,6,3,3,19,1,14,2,11,1,4,3,1,3,2,0,0,1
S01012319,Occupancy rating -1 or less,4,0,0,0,3,0,2,1,0,1,1,1,0,1,1,0,0,0
S01012320,All households,276,68,43,25,197,30,140,42,71,27,27,21,6,11,4,0,2,5
S01012320,Occupancy rating +2 or more,102,29,18,11,71,15,54,34,16,4,2,1,1,2,0,0,0,2
S01012320,Occupancy rating +1,80,15,7,8,63,12,40,6,20,14,11,7,4,2,0,0,1,1
S01012320,Occupancy rating 0,75,20,15,5,51,2,36,1,28,7,13,12,1,4,2,0,1,1
S01012320,Occupancy rating -1 or less,19,4,3,1,12,1,10,1,7,2,1,1,0,3,2,0,0,1
S01012321,All households,339,99,60,39,231,40,164,80,70,14,27,19,8,9,5,0,0,4
S01012321,Occupancy rating +2 or more,192,41,23,18,147,33,108,71,33,4,6,2,4,4,2,0,0,2
S01012321,Occupancy rating +1,68,20,10,10,44,6,32,6,20,6,6,4,2,4,2,0,0,2
S01012321,Occupancy rating 0,55,26,18,8,28,1,15,1,12,2,12,10,2,1,1,0,0,0
S01012321,Occupancy rating -1 or less,24,12,9,3,12,0,9,2,5,2,3,3,0,0,0,0,0,0
S01012322,All households,453,125,62,63,311,57,226,135,77,14,28,21,7,17,7,0,2,8
S01012322,Occupancy rating +2 or more,308,75,40,35,225,45,175,118,48,9,5,4,1,8,4,0,0,4
S01012322,Occupancy rating +1,105,42,20,22,59,11,38,15,19,4,10,8,2,4,0,0,1,3
S01012322,Occupancy rating 0,27,5,2,3,20,1,9,1,7,1,10,6,4,2,2,0,0,0
S01012322,Occupancy rating -1 or less,13,3,0,3,7,0,4,1,3,0,3,3,0,3,1,0,1,1
S01012323,All households,403,111,54,57,278,59,201,119,55,27,18,10,8,14,5,0,2,7
S01012323,Occupancy rating +2 or more,308,84,44,40,214,51,157,96,37,24,6,2,4,10,4,0,1,5
S01012323,Occupancy rating +1,59,15,7,8,43,6,29,17,10,2,8,5,3,1,0,0,1,0
S01012323,Occupancy rating 0,29,12,3,9,16,2,11,6,5,0,3,3,0,1,0,0,0,1
S01012323,Occupancy rating -1 or less,7,0,0,0,5,0,4,0,3,1,1,0,1,2,1,0,0,1
S01012324,All households,365,108,47,61,241,42,176,98,56,22,23,13,10,16,6,0,2,8
S01012324,Occupancy rating +2 or more,226,70,33,37,149,31,111,72,29,10,7,5,2,7,4,0,1,2
S01012324,Occupancy rating +1,94,25,11,14,63,10,44,17,18,9,9,5,4,6,1,0,1,4
S01012324,Occupancy rating 0,38,9,1,8,26,1,19,9,7,3,6,2,4,3,1,0,0,2
S01012324,Occupancy rating -1 or less,7,4,2,2,3,0,2,0,2,0,1,1,0,0,0,0,0,0
S01012325,All households,301,86,58,28,208,78,109,70,28,11,21,14,7,7,3,0,1,3
S01012325,Occupancy rating +2 or more,177,47,32,15,129,59,66,52,11,3,4,2,2,1,0,0,0,1
S01012325,Occupancy rating +1,76,28,19,9,46,15,27,16,7,4,4,4,0,2,0,0,1,1
S01012325,Occupancy rating 0,43,9,6,3,31,3,16,2,10,4,12,8,4,3,2,0,0,1
S01012325,Occupancy rating -1 or less,5,2,1,1,2,1,0,0,0,0,1,0,1,1,1,0,0,0
S01012326,All households,310,172,77,95,128,21,93,52,27,14,14,9,5,10,4,0,2,4
S01012326,Occupancy rating +2 or more,110,41,21,20,65,14,49,34,7,8,2,1,1,4,3,0,0,1
S01012326,Occupancy rating +1,74,44,17,27,26,5,18,13,2,3,3,2,1,4,0,0,2,2
S01012326,Occupancy rating 0,86,55,15,40,29,1,20,4,13,3,8,5,3,2,1,0,0,1
S01012326,Occupancy rating -1 or less,40,32,24,8,8,1,6,1,5,0,1,1,0,0,0,0,0,0
S01012327,All households,366,109,69,40,244,46,157,68,63,26,41,24,17,13,8,1,2,2
S01012327,Occupancy rating +2 or more,177,60,44,16,114,30,79,52,17,10,5,3,2,3,1,1,0,1
S01012327,Occupancy rating +1,100,28,14,14,68,10,43,12,21,10,15,6,9,4,1,0,2,1
S01012327,Occupancy rating 0,73,20,11,9,51,6,28,3,20,5,17,13,4,2,2,0,0,0
S01012327,Occupancy rating -1 or less,16,1,0,1,11,0,7,1,5,1,4,2,2,4,4,0,0,0
S01012328,All households,293,124,75,49,162,47,96,61,24,11,19,7,12,7,1,0,3,3
S01012328,Occupancy rating +2 or more,170,60,41,19,106,39,60,42,10,8,7,1,6,4,0,0,2,2
S01012328,Occupancy rating +1,74,41,25,16,32,5,21,16,2,3,6,3,3,1,0,0,0,1
S01012328,Occupancy rating 0,36,18,8,10,17,2,10,3,7,0,5,3,2,1,0,0,1,0
S01012328,Occupancy rating -1 or less,13,5,1,4,7,1,5,0,5,0,1,0,1,1,1,0,0,0
S01012329,All households,381,106,52,54,260,58,179,95,70,14,23,11,12,15,5,0,1,9
S01012329,Occupancy rating +2 or more,241,61,34,27,176,49,123,77,35,11,4,1,3,4,3,0,0,1
S01012329,Occupancy rating +1,86,24,11,13,56,9,37,17,18,2,10,2,8,6,1,0,1,4
S01012329,Occupancy rating 0,47,18,7,11,26,0,17,1,15,1,9,8,1,3,1,0,0,2
S01012329,Occupancy rating -1 or less,7,3,0,3,2,0,2,0,2,0,0,0,0,2,0,0,0,2
S01012330,All households,280,85,46,39,195,46,134,74,44,16,15,11,4,0,0,0,0,0
S01012330,Occupancy rating +2 or more,185,56,34,22,129,36,88,62,20,6,5,4,1,0,0,0,0,0
S01012330,Occupancy rating +1,61,25,10,15,36,7,27,11,13,3,2,1,1,0,0,0,0,0
S01012330,Occupancy rating 0,31,4,2,2,27,3,17,1,11,5,7,5,2,0,0,0,0,0
S01012330,Occupancy rating -1 or less,3,0,0,0,3,0,2,0,0,2,1,1,0,0,0,0,0,0
S01012331,All households,265,67,27,40,195,24,154,61,75,18,17,9,8,3,1,0,0,2
S01012331,Occupancy rating +2 or more,201,47,16,31,152,21,123,59,52,12,8,3,5,2,1,0,0,1
S01012331,Occupancy rating +1,35,8,2,6,26,1,21,2,14,5,4,2,2,1,0,0,0,1
S01012331,Occupancy rating 0,21,5,3,2,16,2,9,0,8,1,5,4,1,0,0,0,0,0
S01012331,Occupancy rating -1 or less,8,7,6,1,1,0,1,0,1,0,0,0,0,0,0,0,0,0
S01012332,All households,435,113,42,71,314,64,231,114,92,25,19,11,8,8,2,0,0,6
S01012332,Occupancy rating +2 or more,317,74,26,48,239,57,172,94,60,18,10,3,7,4,1,0,0,3
S01012332,Occupancy rating +1,83,31,12,19,50,7,38,18,17,3,5,5,0,2,0,0,0,2
S01012332,Occupancy rating 0,31,7,4,3,22,0,20,2,14,4,2,2,0,2,1,0,0,1
S01012332,Occupancy rating -1 or less,4,1,0,1,3,0,1,0,1,0,2,1,1,0,0,0,0,0
S01012333,All households,452,124,61,63,317,58,233,125,84,24,26,22,4,11,1,0,5,5
S01012333,Occupancy rating +2 or more,313,82,46,36,226,48,165,103,49,13,13,11,2,5,1,0,1,3
S01012333,Occupancy rating +1,100,40,15,25,57,9,41,17,17,7,7,5,2,3,0,0,2,1
S01012333,Occupancy rating 0,35,2,0,2,30,1,24,5,16,3,5,5,0,3,0,0,2,1
S01012333,Occupancy rating -1 or less,4,0,0,0,4,0,3,0,2,1,1,1,0,0,0,0,0,0
S01012334,All households,365,93,45,48,263,69,146,62,61,23,48,35,13,9,1,0,2,6
S01012334,Occupancy rating +2 or more,160,38,25,13,118,50,64,39,17,8,4,3,1,4,0,0,1,3
S01012334,Occupancy rating +1,121,43,17,26,77,15,50,22,19,9,12,8,4,1,0,0,0,1
S01012334,Occupancy rating 0,73,12,3,9,58,4,26,1,20,5,28,20,8,3,0,0,1,2
S01012334,Occupancy rating -1 or less,11,0,0,0,10,0,6,0,5,1,4,4,0,1,1,0,0,0
S01012335,All households,414,105,46,59,301,37,218,82,98,38,46,28,18,8,1,0,1,6
S01012335,Occupancy rating +2 or more,219,58,22,36,157,26,124,68,40,16,7,3,4,4,1,0,0,3
S01012335,Occupancy rating +1,122,33,17,16,87,8,59,13,31,15,20,13,7,2,0,0,1,1
S01012335,Occupancy rating 0,62,13,6,7,48,3,32,1,24,7,13,7,6,1,0,0,0,1
S01012335,Occupancy rating -1 or less,11,1,1,0,9,0,3,0,3,0,6,5,1,1,0,0,0,1
S01012336,All households,275,75,46,29,190,50,115,48,48,19,25,15,10,10,2,0,1,7
S01012336,Occupancy rating +2 or more,135,47,28,19,84,39,44,29,12,3,1,0,1,4,0,0,0,4
S01012336,Occupancy rating +1,99,26,16,10,71,10,51,19,21,11,10,5,5,2,0,0,0,2
S01012336,Occupancy rating 0,32,0,0,0,30,0,16,0,12,4,14,10,4,2,2,0,0,0
S01012336,Occupancy rating -1 or less,9,2,2,0,5,1,4,0,3,1,0,0,0,2,0,0,1,1
S01012337,All households,453,212,113,99,227,37,140,63,55,22,50,29,21,14,3,0,3,8
S01012337,Occupancy rating +2 or more,116,37,21,16,76,22,51,31,14,6,3,2,1,3,0,0,2,1
S01012337,Occupancy rating +1,149,83,44,39,64,9,44,21,13,10,11,2,9,2,0,0,1,1
S01012337,Occupancy rating 0,167,85,45,40,74,4,40,10,24,6,30,20,10,8,2,0,0,6
S01012337,Occupancy rating -1 or less,21,7,3,4,13,2,5,1,4,0,6,5,1,1,1,0,0,0
S01012338,All households,384,195,82,113,180,51,106,61,35,10,23,17,6,9,2,0,0,7
S01012338,Occupancy rating +2 or more,167,68,38,30,96,33,59,36,16,7,4,3,1,3,1,0,0,2
S01012338,Occupancy rating +1,100,56,21,35,40,13,21,15,5,1,6,3,3,4,0,0,0,4
S01012338,Occupancy rating 0,87,53,18,35,33,2,22,10,12,0,9,8,1,1,0,0,0,1
S01012338,Occupancy rating -1 or less,30,18,5,13,11,3,4,0,2,2,4,3,1,1,1,0,0,0
S01012339,All households,366,221,107,114,133,27,80,46,27,7,26,17,9,12,1,1,0,10
S01012339,Occupancy rating +2 or more,88,45,28,17,42,11,29,20,6,3,2,2,0,1,0,0,0,1
S01012339,Occupancy rating +1,111,72,31,41,37,9,22,15,5,2,6,3,3,2,0,0,0,2
S01012339,Occupancy rating 0,129,76,32,44,47,7,24,10,12,2,16,12,4,6,1,0,0,5
S01012339,Occupancy rating -1 or less,38,28,16,12,7,0,5,1,4,0,2,0,2,3,0,1,0,2
S01012340,All households,477,170,100,70,303,51,205,86,89,30,47,33,14,4,2,0,0,2
S01012340,Occupancy rating +2 or more,239,60,30,30,175,43,124,73,39,12,8,4,4,4,2,0,0,2
S01012340,Occupancy rating +1,80,31,15,16,49,4,32,11,14,7,13,9,4,0,0,0,0,0
S01012340,Occupancy rating 0,139,69,49,20,70,3,41,2,30,9,26,20,6,0,0,0,0,0
S01012340,Occupancy rating -1 or less,19,10,6,4,9,1,8,0,6,2,0,0,0,0,0,0,0,0
S01012341,All households,404,94,28,66,301,44,245,128,92,25,12,4,8,9,3,0,0,6
S01012341,Occupancy rating +2 or more,299,60,22,38,238,37,194,110,64,20,7,3,4,1,0,0,0,1
S01012341,Occupancy rating +1,70,29,3,26,37,5,30,14,13,3,2,0,2,4,1,0,0,3
S01012341,Occupancy rating 0,28,5,3,2,20,0,18,3,13,2,2,0,2,3,2,0,0,1
S01012341,Occupancy rating -1 or less,7,0,0,0,6,2,3,1,2,0,1,1,0,1,0,0,0,1
S01012342,All households,403,121,62,59,276,49,196,96,76,24,31,18,13,6,1,0,1,4
S01012342,Occupancy rating +2 or more,237,67,32,35,169,37,126,73,41,12,6,4,2,1,0,0,1,0
S01012342,Occupancy rating +1,88,31,17,14,55,7,40,16,20,4,8,4,4,2,1,0,0,1
S01012342,Occupancy rating 0,69,20,11,9,46,4,26,7,12,7,16,10,6,3,0,0,0,3
S01012342,Occupancy rating -1 or less,9,3,2,1,6,1,4,0,3,1,1,0,1,0,0,0,0,0
S01012343,All households,448,120,39,81,318,52,241,137,83,21,25,14,11,10,3,0,3,4
S01012343,Occupancy rating +2 or more,285,60,27,33,219,41,171,106,49,16,7,2,5,6,2,0,1,3
S01012343,Occupancy rating +1,103,46,10,36,56,9,42,23,14,5,5,3,2,1,0,0,1,0
S01012343,Occupancy rating 0,50,8,1,7,40,2,25,8,17,0,13,9,4,2,1,0,1,0
S01012343,Occupancy rating -1 or less,10,6,1,5,3,0,3,0,3,0,0,0,0,1,0,0,0,1
S01012344,All households,296,120,36,84,171,16,123,64,44,15,32,23,9,5,1,0,0,4
S01012344,Occupancy rating +2 or more,84,28,15,13,55,9,44,29,13,2,2,2,0,1,0,0,0,1
S01012344,Occupancy rating +1,100,41,10,31,56,7,41,27,10,4,8,3,5,3,0,0,0,3
S01012344,Occupancy rating 0,87,37,9,28,50,0,31,5,19,7,19,15,4,0,0,0,0,0
S01012344,Occupancy rating -1 or less,25,14,2,12,10,0,7,3,2,2,3,3,0,1,1,0,0,0
S01012345,All households,321,98,44,54,218,41,153,68,65,20,24,18,6,5,1,0,0,4
S01012345,Occupancy rating +2 or more,141,39,19,20,100,26,70,40,24,6,4,4,0,2,0,0,0,2
S01012345,Occupancy rating +1,91,26,10,16,63,13,43,19,17,7,7,4,3,2,1,0,0,1
S01012345,Occupancy rating 0,68,26,10,16,41,0,32,8,18,6,9,7,2,1,0,0,0,1
S01012345,Occupancy rating -1 or less,21,7,5,2,14,2,8,1,6,1,4,3,1,0,0,0,0,0
S01012346,All households,361,126,47,79,219,42,164,75,66,23,13,6,7,16,4,5,0,7
S01012346,Occupancy rating +2 or more,240,78,37,41,149,37,109,59,37,13,3,1,2,13,4,3,0,6
S01012346,Occupancy rating +1,80,34,6,28,46,5,35,12,16,7,6,3,3,0,0,0,0,0
S01012346,Occupancy rating 0,37,13,4,9,21,0,18,4,12,2,3,1,2,3,0,2,0,1
S01012346,Occupancy rating -1 or less,4,1,0,1,3,0,2,0,1,1,1,1,0,0,0,0,0,0
S01012347,All households,364,127,85,42,226,33,164,80,63,21,29,18,11,11,2,0,0,9
S01012347,Occupancy rating +2 or more,185,50,30,20,130,24,102,58,36,8,4,1,3,5,2,0,0,3
S01012347,Occupancy rating +1,87,34,22,12,50,5,34,16,12,6,11,9,2,3,0,0,0,3
S01012347,Occupancy rating 0,80,38,29,9,39,4,23,5,13,5,12,6,6,3,0,0,0,3
S01012347,Occupancy rating -1 or less,12,5,4,1,7,0,5,1,2,2,2,2,0,0,0,0,0,0
S01012348,All households,325,87,46,41,232,56,148,70,68,10,28,18,10,6,2,0,3,1
S01012348,Occupancy rating +2 or more,198,40,19,21,157,45,102,54,42,6,10,8,2,1,0,0,0,1
S01012348,Occupancy rating +1,65,29,16,13,34,5,24,10,12,2,5,2,3,2,0,0,2,0
S01012348,Occupancy rating 0,53,17,10,7,34,4,19,5,12,2,11,6,5,2,2,0,0,0
S01012348,Occupancy rating -1 or less,9,1,1,0,7,2,3,1,2,0,2,2,0,1,0,0,1,0
S01012349,All households,402,110,62,48,284,49,186,81,72,33,49,36,13,8,3,0,1,4
S01012349,Occupancy rating +2 or more,149,55,32,23,93,26,64,43,8,13,3,1,2,1,0,0,0,1
S01012349,Occupancy rating +1,150,42,22,20,105,19,74,37,26,11,12,6,6,3,0,0,1,2
S01012349,Occupancy rating 0,87,10,8,2,73,2,42,1,32,9,29,26,3,4,3,0,0,1
S01012349,Occupancy rating -1 or less,16,3,0,3,13,2,6,0,6,0,5,3,2,0,0,0,0,0
S01012350,All households,337,96,52,44,233,52,141,55,59,27,40,30,10,8,2,0,0,6
S01012350,Occupancy rating +2 or more,182,47,33,14,133,45,79,47,22,10,9,6,3,2,1,0,0,1
S01012350,Occupancy rating +1,78,37,15,22,40,6,27,8,10,9,7,3,4,1,0,0,0,1
S01012350,Occupancy rating 0,62,10,4,6,49,1,25,0,20,5,23,20,3,3,0,0,0,3
S01012350,Occupancy rating -1 or less,15,2,0,2,11,0,10,0,7,3,1,1,0,2,1,0,0,1
S01012351,All households,373,114,61,53,253,28,175,68,82,25,50,40,10,6,1,0,1,4
S01012351,Occupancy rating +2 or more,138,42,22,20,95,19,71,50,17,4,5,4,1,1,1,0,0,0
S01012351,Occupancy rating +1,143,54,29,25,87,7,61,18,26,17,19,14,5,2,0,0,0,2
S01012351,Occupancy rating 0,79,10,3,7,66,2,40,0,36,4,24,21,3,3,0,0,1,2
S01012351,Occupancy rating -1 or less,13,8,7,1,5,0,3,0,3,0,2,1,1,0,0,0,0,0
S01012352,All households,350,135,64,71,206,33,154,61,72,21,19,12,7,9,2,0,1,6
S01012352,Occupancy rating +2 or more,150,44,19,25,105,21,81,46,29,6,3,0,3,1,1,0,0,0
S01012352,Occupancy rating +1,124,65,35,30,57,10,42,10,21,11,5,3,2,2,0,0,0,2
S01012352,Occupancy rating 0,58,17,8,9,36,1,26,3,19,4,9,7,2,5,0,0,1,4
S01012352,Occupancy rating -1 or less,18,9,2,7,8,1,5,2,3,0,2,2,0,1,1,0,0,0
S01012353,All households,453,261,108,153,181,27,117,68,37,12,37,21,16,11,2,0,1,8
S01012353,Occupancy rating +2 or more,116,45,18,27,70,17,48,31,12,5,5,3,2,1,0,0,0,1
S01012353,Occupancy rating +1,145,85,31,54,57,6,44,33,8,3,7,1,6,3,0,0,0,3
S01012353,Occupancy rating 0,134,93,47,46,38,3,19,3,13,3,16,11,5,3,1,0,0,2
S01012353,Occupancy rating -1 or less,58,38,12,26,16,1,6,1,4,1,9,6,3,4,1,0,1,2
S01012354,All households,385,157,96,61,213,48,148,66,59,23,17,9,8,15,1,1,5,8
S01012354,Occupancy rating +2 or more,204,74,52,22,124,34,87,51,30,6,3,3,0,6,0,0,3,3
S01012354,Occupancy rating +1,110,52,30,22,55,11,38,11,17,10,6,2,4,3,1,0,0,2
S01012354,Occupancy rating 0,63,28,12,16,30,3,21,4,10,7,6,2,4,5,0,1,2,2
S01012354,Occupancy rating -1 or less,8,3,2,1,4,0,2,0,2,0,2,2,0,1,0,0,0,1
S01012355,All households,377,110,42,68,254,36,203,108,64,31,15,12,3,13,3,0,2,8
S01012355,Occupancy rating +2 or more,286,83,32,51,195,25,161,100,40,21,9,7,2,8,2,0,1,5
S01012355,Occupancy rating +1,58,21,8,13,34,8,24,7,12,5,2,1,1,3,1,0,0,2
S01012355,Occupancy rating 0,28,5,1,4,21,2,16,1,10,5,3,3,0,2,0,0,1,1
S01012355,Occupancy rating -1 or less,5,1,1,0,4,1,2,0,2,0,1,1,0,0,0,0,0,0
S01012356,All households,320,111,60,51,204,39,142,82,47,13,23,13,10,5,2,0,1,2
S01012356,Occupancy rating +2 or more,176,53,34,19,121,30,86,58,20,8,5,2,3,2,1,0,0,1
S01012356,Occupancy rating +1,87,35,15,20,51,7,37,20,13,4,7,3,4,1,0,0,1,0
S01012356,Occupancy rating 0,41,17,8,9,24,2,14,4,10,0,8,6,2,0,0,0,0,0
S01012356,Occupancy rating -1 or less,16,6,3,3,8,0,5,0,4,1,3,2,1,2,1,0,0,1
S01012357,All households,355,74,37,37,269,47,210,124,55,31,12,7,5,12,2,0,1,9
S01012357,Occupancy rating +2 or more,284,58,32,26,219,43,169,112,34,23,7,4,3,7,1,0,1,5
S01012357,Occupancy rating +1,47,9,2,7,37,3,30,8,16,6,4,3,1,1,0,0,0,1
S01012357,Occupancy rating 0,20,3,2,1,13,1,11,4,5,2,1,0,1,4,1,0,0,3
S01012357,Occupancy rating -1 or less,4,4,1,3,0,0,0,0,0,0,0,0,0,0,0,0,0,0
S01012358,All households,343,79,36,43,253,45,193,117,52,24,15,9,6,11,1,0,2,8
S01012358,Occupancy rating +2 or more,253,54,27,27,188,36,143,92,39,12,9,5,4,11,1,0,2,8
S01012358,Occupancy rating +1,64,13,5,8,51,6,41,23,10,8,4,2,2,0,0,0,0,0
S01012358,Occupancy rating 0,22,10,3,7,12,2,8,2,2,4,2,2,0,0,0,0,0,0
S01012358,Occupancy rating -1 or less,4,2,1,1,2,1,1,0,1,0,0,0,0,0,0,0,0,0
S01012359,All households,367,124,51,73,237,27,150,75,55,20,60,48,12,6,4,0,0,2
S01012359,Occupancy rating +2 or more,92,37,16,21,55,12,40,38,1,1,3,3,0,0,0,0,0,0
S01012359,Occupancy rating +1,146,66,26,40,80,12,54,29,12,13,14,10,4,0,0,0,0,0
S01012359,Occupancy rating 0,102,18,9,9,82,1,47,7,34,6,34,28,6,2,1,0,0,1
S01012359,Occupancy rating -1 or less,27,3,0,3,20,2,9,1,8,0,9,7,2,4,3,0,0,1
S01012360,All households,324,98,31,67,210,18,138,45,72,21,54,46,8,16,7,1,0,8
S01012360,Occupancy rating +2 or more,76,30,15,15,45,8,33,24,3,6,4,4,0,1,0,0,0,1
S01012360,Occupancy rating +1,96,39,7,32,54,6,37,19,11,7,11,6,5,3,1,0,0,2
S01012360,Occupancy rating 0,118,26,7,19,86,2,55,1,48,6,29,27,2,6,1,0,0,5
S01012360,Occupancy rating -1 or less,34,3,2,1,25,2,13,1,10,2,10,9,1,6,5,1,0,0
S01012361,All households,275,83,34,49,179,17,112,51,47,14,50,37,13,13,4,0,0,9
S01012361,Occupancy rating +2 or more,65,23,11,12,40,8,28,26,2,0,4,2,2,2,1,0,0,1
S01012361,Occupancy rating +1,100,38,14,24,62,7,41,23,9,9,14,7,7,0,0,0,0,0
S01012361,Occupancy rating 0,86,19,7,12,62,2,34,2,28,4,26,22,4,5,0,0,0,5
S01012361,Occupancy rating -1 or less,24,3,2,1,15,0,9,0,8,1,6,6,0,6,3,0,0,3
S01012362,All households,306,65,22,43,224,13,136,38,81,17,75,62,13,17,8,0,1,8
S01012362,Occupancy rating +2 or more,56,19,9,10,36,3,31,19,8,4,2,1,1,1,0,0,1,0
S01012362,Occupancy rating +1,112,37,7,30,70,9,44,17,21,6,17,14,3,5,1,0,0,4
S01012362,Occupancy rating 0,107,6,4,2,94,1,49,1,44,4,44,37,7,7,4,0,0,3
S01012362,Occupancy rating -1 or less,31,3,2,1,24,0,12,1,8,3,12,10,2,4,3,0,0,1
S01012363,All households,575,322,110,212,230,35,145,81,47,17,50,32,18,23,4,10,2,7
S01012363,Occupancy rating +2 or more,130,46,22,24,78,12,55,37,12,6,11,4,7,6,2,2,1,1
S01012363,Occupancy rating +1,184,110,41,69,70,15,44,27,10,7,11,7,4,4,1,1,1,1
S01012363,Occupancy rating 0,207,130,36,94,69,8,40,16,20,4,21,15,6,8,1,2,0,5
S01012363,Occupancy rating -1 or less,54,36,11,25,13,0,6,1,5,0,7,6,1,5,0,5,0,0
S01012364,All households,375,190,79,111,178,32,126,72,36,18,20,10,10,7,2,0,0,5
S01012364,Occupancy rating +2 or more,121,35,15,20,86,17,67,41,17,9,2,1,1,0,0,0,0,0
S01012364,Occupancy rating +1,104,51,15,36,51,7,35,21,8,6,9,3,6,2,0,0,0,2
S01012364,Occupancy rating 0,114,79,34,45,33,7,19,8,8,3,7,4,3,2,2,0,0,0
S01012364,Occupancy rating -1 or less,36,25,15,10,8,1,5,2,3,0,2,2,0,3,0,0,0,3
S01012365,All households,443,142,58,84,290,61,199,94,77,28,30,15,15,11,6,0,1,4
S01012365,Occupancy rating +2 or more,193,46,26,20,144,30,106,56,32,18,8,2,6,3,1,0,0,2
S01012365,Occupancy rating +1,131,34,16,18,97,25,63,29,28,6,9,5,4,0,0,0,0,0
S01012365,Occupancy rating 0,99,50,14,36,44,5,27,9,15,3,12,7,5,5,3,0,1,1
S01012365,Occupancy rating -1 or less,20,12,2,10,5,1,3,0,2,1,1,1,0,3,2,0,0,1
S01012366,All households,513,276,118,158,233,46,156,90,46,20,31,21,10,4,0,0,1,3
S01012366,Occupancy rating +2 or more,142,54,24,30,86,17,65,47,10,8,4,2,2,2,0,0,1,1
S01012366,Occupancy rating +1,156,73,31,42,83,15,53,26,19,8,15,9,6,0,0,0,0,0
S01012366,Occupancy rating 0,179,120,56,64,57,13,33,14,15,4,11,9,2,2,0,0,0,2
S01012366,Occupancy rating -1 or less,36,29,7,22,7,1,5,3,2,0,1,1,0,0,0,0,0,0
S01012367,All households,420,118,61,57,293,61,191,90,61,40,41,24,17,9,3,0,1,5
S01012367,Occupancy rating +2 or more,207,45,21,24,158,44,107,66,24,17,7,4,3,4,2,0,0,2
S01012367,Occupancy rating +1,146,63,33,30,80,14,55,22,18,15,11,6,5,3,1,0,1,1
S01012367,Occupancy rating 0,58,9,6,3,47,2,26,2,16,8,19,11,8,2,0,0,0,2
S01012367,Occupancy rating -1 or less,9,1,1,0,8,1,3,0,3,0,4,3,1,0,0,0,0,0
S01012368,All households,261,69,36,33,188,43,131,67,38,26,14,8,6,4,1,0,0,3
S01012368,Occupancy rating +2 or more,159,34,21,13,122,33,84,51,18,15,5,2,3,3,0,0,0,3
S01012368,Occupancy rating +1,60,21,11,10,39,6,29,11,12,6,4,3,1,0,0,0,0,0
S01012368,Occupancy rating 0,33,11,2,9,22,4,15,4,6,5,3,1,2,0,0,0,0,0
S01012368,Occupancy rating -1 or less,9,3,2,1,5,0,3,1,2,0,2,2,0,1,1,0,0,0
S01012369,All households,375,97,45,52,267,54,184,69,84,31,29,16,13,11,4,0,1,6
S01012369,Occupancy rating +2 or more,189,47,27,20,140,46,91,48,28,15,3,1,2,2,2,0,0,0
S01012369,Occupancy rating +1,113,33,11,22,78,6,61,17,30,14,11,3,8,2,1,0,0,1
S01012369,Occupancy rating 0,61,15,5,10,40,2,27,4,21,2,11,8,3,6,1,0,1,4
S01012369,Occupancy rating -1 or less,12,2,2,0,9,0,5,0,5,0,4,4,0,1,0,0,0,1
S01012370,All households,516,255,131,124,256,38,185,96,67,22,33,20,13,5,0,0,0,5
S01012370,Occupancy rating +2 or more,130,23,13,10,105,13,90,43,34,13,2,1,1,2,0,0,0,2
S01012370,Occupancy rating +1,142,82,39,43,59,14,41,30,9,2,4,2,2,1,0,0,0,1
S01012370,Occupancy rating 0,216,135,69,66,79,10,48,23,19,6,21,13,8,2,0,0,0,2
S01012370,Occupancy rating -1 or less,28,15,10,5,13,1,6,0,5,1,6,4,2,0,0,0,0,0
S01012371,All households,486,235,82,153,242,46,145,79,54,12,51,34,17,9,3,0,0,6
S01012371,Occupancy rating +2 or more,115,32,12,20,80,16,57,35,14,8,7,4,3,3,0,0,0,3
S01012371,Occupancy rating +1,158,72,30,42,85,21,52,31,19,2,12,7,5,1,0,0,0,1
S01012371,Occupancy rating 0,186,114,36,78,68,7,33,11,20,2,28,19,9,4,2,0,0,2
S01012371,Occupancy rating -1 or less,27,17,4,13,9,2,3,2,1,0,4,4,0,1,1,0,0,0
S01012372,All households,450,261,109,152,180,37,103,60,30,13,40,30,10,9,1,0,1,7
S01012372,Occupancy rating +2 or more,99,40,17,23,59,15,40,29,8,3,4,1,3,0,0,0,0,0
S01012372,Occupancy rating +1,129,69,24,45,57,12,32,22,4,6,13,12,1,3,1,0,1,1
S01012372,Occupancy rating 0,196,140,62,78,54,9,26,8,15,3,19,14,5,2,0,0,0,2
S01012372,Occupancy rating -1 or less,26,12,6,6,10,1,5,1,3,1,4,3,1,4,0,0,0,4
S01012373,All households,479,182,63,119,287,52,205,103,81,21,30,13,17,10,2,0,3,5
S01012373,Occupancy rating +2 or more,205,45,24,21,155,35,114,70,34,10,6,2,4,5,1,0,3,1
S01012373,Occupancy rating +1,123,63,30,33,59,10,44,20,19,5,5,1,4,1,1,0,0,0
S01012373,Occupancy rating 0,132,67,7,60,62,7,39,13,20,6,16,7,9,3,0,0,0,3
S01012373,Occupancy rating -1 or less,19,7,2,5,11,0,8,0,8,0,3,3,0,1,0,0,0,1
S01012374,All households,402,105,59,46,286,32,203,88,88,27,51,34,17,11,7,0,1,3
S01012374,Occupancy rating +2 or more,120,23,15,8,97,15,76,57,12,7,6,4,2,0,0,0,0,0
S01012374,Occupancy rating +1,163,69,35,34,92,17,67,29,26,12,8,5,3,2,0,0,1,1
S01012374,Occupancy rating 0,101,10,8,2,85,0,52,1,45,6,33,22,11,6,4,0,0,2
S01012374,Occupancy rating -1 or less,18,3,1,2,12,0,8,1,5,2,4,3,1,3,3,0,0,0
S01012375,All households,429,138,71,67,283,41,177,70,82,25,65,41,24,8,1,0,1,6
S01012375,Occupancy rating +2 or more,140,41,26,15,97,24,69,53,12,4,4,2,2,2,0,0,0,2
S01012375,Occupancy rating +1,143,61,28,33,81,12,53,10,30,13,16,6,10,1,0,0,0,1
S01012375,Occupancy rating 0,125,31,14,17,90,5,49,7,35,7,36,26,10,4,0,0,1,3
S01012375,Occupancy rating -1 or less,21,5,3,2,15,0,6,0,5,1,9,7,2,1,1,0,0,0
S01012376,All households,407,105,35,70,288,40,225,103,92,30,23,15,8,14,4,0,0,10
S01012376,Occupancy rating +2 or more,297,76,24,52,213,36,163,85,61,17,14,8,6,8,2,0,0,6
S01012376,Occupancy rating +1,64,17,8,9,43,3,38,14,15,9,2,2,0,4,2,0,0,2
S01012376,Occupancy rating 0,36,8,0,8,26,1,19,3,13,3,6,4,2,2,0,0,0,2
S01012376,Occupancy rating -1 or less,10,4,3,1,6,0,5,1,3,1,1,1,0,0,0,0,0,0
S01012377,All households,324,107,35,72,204,43,146,66,52,28,15,11,4,13,2,1,2,8
S01012377,Occupancy rating +2 or more,205,50,18,32,146,40,104,57,32,15,2,1,1,9,2,0,2,5
S01012377,Occupancy rating +1,67,31,12,19,34,2,29,8,11,10,3,1,2,2,0,0,0,2
S01012377,Occupancy rating 0,42,22,4,18,19,1,10,1,7,2,8,8,0,1,0,0,0,1
S01012377,Occupancy rating -1 or less,10,4,1,3,5,0,3,0,2,1,2,1,1,1,0,1,0,0
S01012378,All households,250,52,18,34,192,35,141,81,45,15,16,10,6,6,2,0,0,4
S01012378,Occupancy rating +2 or more,182,30,9,21,148,31,109,70,27,12,8,4,4,4,2,0,0,2
S01012378,Occupancy rating +1,37,12,6,6,24,2,17,8,7,2,5,3,2,1,0,0,0,1
S01012378,Occupancy rating 0,21,8,2,6,12,0,10,3,6,1,2,2,0,1,0,0,0,1
S01012378,Occupancy rating -1 or less,10,2,1,1,8,2,5,0,5,0,1,1,0,0,0,0,0,0
S01012379,All households,227,62,32,30,153,26,115,64,40,11,12,8,4,12,3,3,0,6
S01012379,Occupancy rating +2 or more,161,43,23,20,112,25,84,53,24,7,3,1,2,6,2,0,0,4
S01012379,Occupancy rating +1,35,14,7,7,18,0,16,9,6,1,2,2,0,3,1,0,0,2
S01012379,Occupancy rating 0,24,4,2,2,18,1,12,2,8,2,5,4,1,2,0,2,0,0
S01012379,Occupancy rating -1 or less,7,1,0,1,5,0,3,0,2,1,2,1,1,1,0,1,0,0
S01012380,All households,423,158,48,110,259,31,183,78,80,25,45,26,19,6,1,0,0,5
S01012380,Occupancy rating +2 or more,151,43,17,26,106,20,79,52,21,6,7,3,4,2,0,0,0,2
S01012380,Occupancy rating +1,141,61,22,39,79,9,58,18,27,13,12,5,7,1,0,0,0,1
S01012380,Occupancy rating 0,109,51,8,43,58,2,37,8,26,3,19,12,7,0,0,0,0,0
S01012380,Occupancy rating -1 or less,22,3,1,2,16,0,9,0,6,3,7,6,1,3,1,0,0,2
S01012381,All households,456,222,136,86,225,48,132,64,51,17,45,38,7,9,1,0,0,8
S01012381,Occupancy rating +2 or more,145,53,23,30,88,20,60,34,19,7,8,7,1,4,1,0,0,3
S01012381,Occupancy rating +1,104,48,31,17,54,17,29,17,8,4,8,7,1,2,0,0,0,2
S01012381,Occupancy rating 0,183,108,76,32,73,11,36,11,20,5,26,22,4,2,0,0,0,2
S01012381,Occupancy rating -1 or less,24,13,6,7,10,0,7,2,4,1,3,2,1,1,0,0,0,1
S01012382,All households,437,133,62,71,296,53,222,98,84,40,21,12,9,8,5,0,1,2
S01012382,Occupancy rating +2 or more,257,61,31,30,192,39,148,84,46,18,5,2,3,4,2,0,0,2
S01012382,Occupancy rating +1,106,36,16,20,69,12,50,13,25,12,7,6,1,1,1,0,0,0
S01012382,Occupancy rating 0,63,28,13,15,33,2,23,1,12,10,8,3,5,2,1,0,1,0
S01012382,Occupancy rating -1 or less,11,8,2,6,2,0,1,0,1,0,1,1,0,1,1,0,0,0
S01012383,All households,424,164,84,80,256,57,175,98,58,19,24,18,6,4,1,0,1,2
S01012383,Occupancy rating +2 or more,177,65,41,24,111,22,85,61,17,7,4,4,0,1,1,0,0,0
S01012383,Occupancy rating +1,129,50,22,28,77,21,50,26,17,7,6,3,3,2,0,0,0,2
S01012383,Occupancy rating 0,103,45,19,26,57,13,34,10,21,3,10,9,1,1,0,0,1,0
S01012383,Occupancy rating -1 or less,15,4,2,2,11,1,6,1,3,2,4,2,2,0,0,0,0,0
S01012384,All households,267,114,51,63,145,23,105,54,39,12,17,12,5,8,2,0,0,6
S01012384,Occupancy rating +2 or more,114,42,20,22,71,14,55,33,18,4,2,1,1,1,1,0,0,0
S01012384,Occupancy rating +1,76,29,16,13,44,4,36,17,15,4,4,3,1,3,0,0,0,3
S01012384,Occupancy rating 0,72,40,14,26,28,4,13,3,6,4,11,8,3,4,1,0,0,3
S01012384,Occupancy rating -1 or less,5,3,1,2,2,1,1,1,0,0,0,0,0,0,0,0,0,0
S01012385,All households,332,125,28,97,202,26,159,77,60,22,17,8,9,5,3,1,0,1
S01012385,Occupancy rating +2 or more,168,41,18,23,123,17,100,56,31,13,6,3,3,4,3,0,0,1
S01012385,Occupancy rating +1,84,34,5,29,49,6,38,18,15,5,5,1,4,1,0,1,0,0
S01012385,Occupancy rating 0,63,40,3,37,23,3,14,3,8,3,6,4,2,0,0,0,0,0
S01012385,Occupancy rating -1 or less,17,10,2,8,7,0,7,0,6,1,0,0,0,0,0,0,0,0
S01012386,All households,440,155,51,104,271,23,180,73,87,20,68,50,18,14,6,0,0,8
S01012386,Occupancy rating +2 or more,90,22,9,13,65,9,50,33,14,3,6,5,1,3,1,0,0,2
S01012386,Occupancy rating +1,167,75,28,47,87,10,58,34,17,7,19,12,7,5,2,0,0,3
S01012386,Occupancy rating 0,140,45,10,35,93,3,60,5,47,8,30,22,8,2,0,0,0,2
S01012386,Occupancy rating -1 or less,43,13,4,9,26,1,12,1,9,2,13,11,2,4,3,0,0,1
S01012387,All households,407,111,50,61,280,44,197,97,80,20,39,23,16,16,3,0,2,11
S01012387,Occupancy rating +2 or more,265,75,36,39,182,36,138,87,39,12,8,3,5,8,2,0,1,5
S01012387,Occupancy rating +1,72,17,9,8,48,6,28,6,17,5,14,8,6,7,1,0,1,5
S01012387,Occupancy rating 0,59,16,5,11,42,2,24,4,18,2,16,11,5,1,0,0,0,1
S01012387,Occupancy rating -1 or less,11,3,0,3,8,0,7,0,6,1,1,1,0,0,0,0,0,0
S01012388,All households,306,98,36,62,200,26,164,83,72,9,10,2,8,8,0,0,0,8
S01012388,Occupancy rating +2 or more,201,53,19,34,145,23,117,70,39,8,5,0,5,3,0,0,0,3
S01012388,Occupancy rating +1,64,29,11,18,31,3,25,12,12,1,3,1,2,4,0,0,0,4
S01012388,Occupancy rating 0,31,13,5,8,17,0,16,1,15,0,1,1,0,1,0,0,0,1
S01012388,Occupancy rating -1 or less,10,3,1,2,7,0,6,0,6,0,1,0,1,0,0,0,0,0
S01012389,All households,339,88,25,63,242,20,192,58,106,28,30,21,9,9,2,0,1,6
S01012389,Occupancy rating +2 or more,199,48,18,30,149,18,124,44,61,19,7,4,3,2,0,0,0,2
S01012389,Occupancy rating +1,77,21,3,18,53,2,39,10,22,7,12,8,4,3,1,0,0,2
S01012389,Occupancy rating 0,47,13,3,10,31,0,21,4,15,2,10,8,2,3,0,0,1,2
S01012389,Occupancy rating -1 or less,16,6,1,5,9,0,8,0,8,0,1,1,0,1,1,0,0,0
S01012390,All households,307,88,34,54,207,15,173,69,78,26,19,7,12,12,5,0,0,7
S01012390,Occupancy rating +2 or more,202,51,19,32,148,15,128,55,57,16,5,0,5,3,3,0,0,0
S01012390,Occupancy rating +1,59,20,8,12,31,0,25,9,6,10,6,1,5,8,1,0,0,7
S01012390,Occupancy rating 0,34,16,6,10,17,0,13,2,11,0,4,4,0,1,1,0,0,0
S01012390,Occupancy rating -1 or less,12,1,1,0,11,0,7,3,4,0,4,2,2,0,0,0,0,0
S01012391,All households,412,93,25,68,312,29,257,79,159,19,26,16,10,7,3,0,1,3
S01012391,Occupancy rating +2 or more,288,73,22,51,212,25,181,57,109,15,6,2,4,3,1,0,1,1
S01012391,Occupancy rating +1,69,10,2,8,58,2,46,14,28,4,10,5,5,1,0,0,0,1
S01012391,Occupancy rating 0,45,8,1,7,36,2,24,7,17,0,10,9,1,1,0,0,0,1
S01012391,Occupancy rating -1 or less,10,2,0,2,6,0,6,1,5,0,0,0,0,2,2,0,0,0
S01012392,All households,327,103,25,78,211,26,145,46,75,24,40,29,11,13,4,0,0,9
S01012392,Occupancy rating +2 or more,164,32,11,21,127,18,101,36,46,19,8,4,4,5,1,0,0,4
S01012392,Occupancy rating +1,57,24,8,16,31,7,18,3,12,3,6,3,3,2,1,0,0,1
S01012392,Occupancy rating 0,89,40,4,36,45,1,22,7,13,2,22,18,4,4,2,0,0,2
S01012392,Occupancy rating -1 or less,17,7,2,5,8,0,4,0,4,0,4,4,0,2,0,0,0,2
S01012393,All households,377,104,41,63,254,31,185,80,72,33,38,23,15,19,4,0,0,15
S01012393,Occupancy rating +2 or more,216,60,21,39,152,29,109,66,25,18,14,6,8,4,0,0,0,4
S01012393,Occupancy rating +1,80,18,8,10,58,2,51,10,30,11,5,4,1,4,0,0,0,4
S01012393,Occupancy rating 0,50,16,6,10,30,0,14,2,10,2,16,10,6,4,1,0,0,3
S01012393,Occupancy rating -1 or less,31,10,6,4,14,0,11,2,7,2,3,3,0,7,3,0,0,4
S01012394,All households,276,82,20,62,176,19,104,38,47,19,53,46,7,18,6,0,1,11
S01012394,Occupancy rating +2 or more,97,23,11,12,71,13,55,27,17,11,3,2,1,3,1,0,0,2
S01012394,Occupancy rating +1,87,44,5,39,40,6,25,10,10,5,9,7,2,3,1,0,0,2
S01012394,Occupancy rating 0,78,14,4,10,59,0,22,1,18,3,37,34,3,5,1,0,0,4
S01012394,Occupancy rating -1 or less,14,1,0,1,6,0,2,0,2,0,4,3,1,7,3,0,1,3
S01012395,All households,279,103,50,53,155,29,102,43,42,17,24,14,10,21,6,0,0,15
S01012395,Occupancy rating +2 or more,111,37,22,15,72,20,49,24,15,10,3,1,2,2,0,0,0,2
S01012395,Occupancy rating +1,102,45,21,24,49,8,34,17,13,4,7,3,4,8,2,0,0,6
S01012395,Occupancy rating 0,48,13,4,9,27,1,14,1,10,3,12,8,4,8,1,0,0,7
S01012395,Occupancy rating -1 or less,18,8,3,5,7,0,5,1,4,0,2,2,0,3,3,0,0,0
S01012396,All households,312,132,48,84,163,30,109,51,50,8,24,17,7,17,6,0,0,11
S01012396,Occupancy rating +2 or more,123,41,21,20,78,25,46,30,12,4,7,1,6,4,1,0,0,3
S01012396,Occupancy rating +1,93,48,23,25,41,4,33,17,14,2,4,3,1,4,2,0,0,2
S01012396,Occupancy rating 0,68,30,3,27,34,1,26,3,22,1,7,7,0,4,0,0,0,4
S01012396,Occupancy rating -1 or less,28,13,1,12,10,0,4,1,2,1,6,6,0,5,3,0,0,2
S01012397,All households,418,166,74,92,231,51,139,69,50,20,41,18,23,21,4,0,3,14
S01012397,Occupancy rating +2 or more,205,66,35,31,133,41,81,49,23,9,11,3,8,6,1,0,0,5
S01012397,Occupancy rating +1,103,43,17,26,53,8,31,11,14,6,14,3,11,7,1,0,2,4
S01012397,Occupancy rating 0,74,34,15,19,35,2,20,6,11,3,13,10,3,5,0,0,1,4
S01012397,Occupancy rating -1 or less,36,23,7,16,10,0,7,3,2,2,3,2,1,3,2,0,0,1
S01012398,All households,432,186,69,117,211,24,152,77,53,22,35,20,15,35,4,0,0,31
S01012398,Occupancy rating +2 or more,156,50,16,34,97,16,74,38,22,14,7,3,4,9,0,0,0,9
S01012398,Occupancy rating +1,108,53,23,30,50,4,38,23,11,4,8,3,5,5,1,0,0,4
S01012398,Occupancy rating 0,115,54,23,31,50,3,32,13,18,1,15,10,5,11,0,0,0,11
S01012398,Occupancy rating -1 or less,53,29,7,22,14,1,8,3,2,3,5,4,1,10,3,0,0,7
S01012399,All households,287,98,48,50,170,22,109,42,55,12,39,23,16,19,3,0,0,16
S01012399,Occupancy rating +2 or more,100,33,20,13,64,14,46,25,18,3,4,2,2,3,0,0,0,3
S01012399,Occupancy rating +1,109,52,24,28,52,7,33,13,12,8,12,6,6,5,0,0,0,5
S01012399,Occupancy rating 0,67,12,4,8,45,1,23,4,18,1,21,14,7,10,3,0,0,7
S01012399,Occupancy rating -1 or less,11,1,0,1,9,0,7,0,7,0,2,1,1,1,0,0,0,1
S01012400,All households,274,103,22,81,153,21,96,38,44,14,36,19,17,18,2,0,0,16
S01012400,Occupancy rating +2 or more,77,25,8,17,52,17,33,16,11,6,2,1,1,0,0,0,0,0
S01012400,Occupancy rating +1,88,37,11,26,48,3,32,17,11,4,13,5,8,3,0,0,0,3
S01012400,Occupancy rating 0,71,22,2,20,37,1,20,4,12,4,16,10,6,12,2,0,0,10
S01012400,Occupancy rating -1 or less,38,19,1,18,16,0,11,1,10,0,5,3,2,3,0,0,0,3
S01012401,All households,408,198,36,162,194,24,138,68,51,19,32,20,12,16,3,0,0,13
S01012401,Occupancy rating +2 or more,114,38,15,23,73,15,52,29,18,5,6,2,4,3,0,0,0,3
S01012401,Occupancy rating +1,104,39,9,30,58,5,43,21,12,10,10,5,5,7,2,0,0,5
S01012401,Occupancy rating 0,119,71,5,66,45,3,29,13,13,3,13,11,2,3,1,0,0,2
S01012401,Occupancy rating -1 or less,71,50,7,43,18,1,14,5,8,1,3,2,1,3,0,0,0,3
S01012402,All households,184,47,12,35,130,7,104,39,55,10,19,10,9,7,3,0,0,4
S01012402,Occupancy rating +2 or more,131,32,8,24,99,6,86,37,42,7,7,4,3,0,0,0,0,0
S01012402,Occupancy rating +1,39,9,2,7,24,1,15,1,11,3,8,3,5,6,2,0,0,4
S01012402,Occupancy rating 0,11,3,1,2,7,0,3,1,2,0,4,3,1,1,1,0,0,0
S01012402,Occupancy rating -1 or less,3,3,1,2,0,0,0,0,0,0,0,0,0,0,0,0,0,0
S01012403,All households,437,116,49,67,303,25,244,103,89,52,34,20,14,18,6,0,1,11
S01012403,Occupancy rating +2 or more,295,78,32,46,208,20,175,90,54,31,13,6,7,9,3,0,1,5
S01012403,Occupancy rating +1,83,24,14,10,58,4,45,8,24,13,9,6,3,1,0,0,0,1
S01012403,Occupancy rating 0,51,13,3,10,33,1,22,4,11,7,10,8,2,5,2,0,0,3
S01012403,Occupancy rating -1 or less,8,1,0,1,4,0,2,1,0,1,2,0,2,3,1,0,0,2
S01012404,All households,448,166,58,108,247,26,179,77,77,25,42,22,20,35,6,0,3,26
S01012404,Occupancy rating +2 or more,190,69,29,40,116,21,86,49,23,14,9,4,5,5,1,0,0,4
S01012404,Occupancy rating +1,107,37,10,27,60,3,45,14,23,8,12,5,7,10,0,0,2,8
S01012404,Occupancy rating 0,93,32,14,18,49,2,30,10,18,2,17,11,6,12,2,0,1,9
S01012404,Occupancy rating -1 or less,58,28,5,23,22,0,18,4,13,1,4,2,2,8,3,0,0,5
S01012405,All households,274,57,16,41,210,24,168,65,86,17,18,11,7,7,2,0,1,4
S01012405,Occupancy rating +2 or more,209,36,12,24,168,24,133,55,67,11,11,7,4,5,2,0,1,2
S01012405,Occupancy rating +1,36,10,2,8,25,0,20,7,9,4,5,4,1,1,0,0,0,1
S01012405,Occupancy rating 0,20,5,1,4,14,0,12,1,10,1,2,0,2,1,0,0,0,1
S01012405,Occupancy rating -1 or less,9,6,1,5,3,0,3,2,0,1,0,0,0,0,0,0,0,0
S01012406,All households,260,82,36,46,172,22,135,52,63,20,15,11,4,6,2,0,0,4
S01012406,Occupancy rating +2 or more,176,46,17,29,128,19,100,45,38,17,9,7,2,2,0,0,0,2
S01012406,Occupancy rating +1,46,20,12,8,24,3,17,5,11,1,4,4,0,2,0,0,0,2
S01012406,Occupancy rating 0,31,14,6,8,16,0,14,2,11,1,2,0,2,1,1,0,0,0
S01012406,Occupancy rating -1 or less,7,2,1,1,4,0,4,0,3,1,0,0,0,1,1,0,0,0
S01012407,All households,335,97,44,53,220,24,166,64,86,16,30,19,11,18,2,0,3,13
S01012407,Occupancy rating +2 or more,211,54,19,35,149,20,121,55,54,12,8,4,4,8,0,0,2,6
S01012407,Occupancy rating +1,73,27,13,14,41,3,27,6,17,4,11,6,5,5,0,0,1,4
S01012407,Occupancy rating 0,39,12,10,2,22,1,12,2,10,0,9,7,2,5,2,0,0,3
S01012407,Occupancy rating -1 or less,12,4,2,2,8,0,6,1,5,0,2,2,0,0,0,0,0,0
S01012408,All households,250,65,23,42,177,26,138,47,72,19,13,8,5,8,2,0,2,4
S01012408,Occupancy rating +2 or more,163,35,15,20,123,21,94,40,45,9,8,6,2,5,1,0,1,3
S01012408,Occupancy rating +1,61,19,5,14,39,4,32,4,21,7,3,1,2,3,1,0,1,1
S01012408,Occupancy rating 0,20,9,3,6,11,1,8,2,3,3,2,1,1,0,0,0,0,0
S01012408,Occupancy rating -1 or less,6,2,0,2,4,0,4,1,3,0,0,0,0,0,0,0,0,0
S01012409,All households,311,116,48,68,191,24,145,62,65,18,22,9,13,4,1,0,2,1
S01012409,Occupancy rating +2 or more,184,59,30,29,124,20,96,47,37,12,8,2,6,1,1,0,0,0
S01012409,Occupancy rating +1,70,24,12,12,44,3,33,12,18,3,8,3,5,2,0,0,2,0
S01012409,Occupancy rating 0,47,29,6,23,17,1,12,2,8,2,4,2,2,1,0,0,0,1
S01012409,Occupancy rating -1 or less,10,4,0,4,6,0,4,1,2,1,2,2,0,0,0,0,0,0
S01012410,All households,420,110,35,75,289,23,229,88,107,34,37,25,12,21,4,1,1,15
S01012410,Occupancy rating +2 or more,266,70,20,50,189,20,160,81,57,22,9,7,2,7,2,0,0,5
S01012410,Occupancy rating +1,92,26,12,14,60,3,41,7,25,9,16,7,9,6,1,0,0,5
S01012410,Occupancy rating 0,51,13,3,10,31,0,21,0,19,2,10,9,1,7,1,0,1,5
S01012410,Occupancy rating -1 or less,11,1,0,1,9,0,7,0,6,1,2,2,0,1,0,1,0,0
S01012411,All households,410,131,33,98,260,21,187,75,87,25,52,33,19,19,5,0,0,14
S01012411,Occupancy rating +2 or more,254,92,25,67,157,20,120,64,43,13,17,11,6,5,0,0,0,5
S01012411,Occupancy rating +1,86,17,4,13,64,1,42,10,24,8,21,12,9,5,0,0,0,5
S01012411,Occupancy rating 0,49,16,4,12,27,0,19,0,15,4,8,6,2,6,3,0,0,3
S01012411,Occupancy rating -1 or less,21,6,0,6,12,0,6,1,5,0,6,4,2,3,2,0,0,1
S01012412,All households,281,89,40,49,183,18,142,61,56,25,23,10,13,9,4,0,0,5
S01012412,Occupancy rating +2 or more,167,47,26,21,118,13,96,46,36,14,9,2,7,2,0,0,0,2
S01012412,Occupancy rating +1,67,19,7,12,45,3,34,11,13,10,8,5,3,3,2,0,0,1
S01012412,Occupancy rating 0,42,20,7,13,19,1,12,4,7,1,6,3,3,3,2,0,0,1
S01012412,Occupancy rating -1 or less,5,3,0,3,1,1,0,0,0,0,0,0,0,1,0,0,0,1
S01012413,All households,419,121,65,56,282,52,210,100,84,26,20,9,11,16,5,0,4,7
S01012413,Occupancy rating +2 or more,266,68,39,29,191,46,139,76,47,16,6,1,5,7,0,0,1,6
S01012413,Occupancy rating +1,91,27,14,13,62,6,48,19,22,7,8,5,3,2,1,0,0,1
S01012413,Occupancy rating 0,46,17,9,8,23,0,19,4,12,3,4,1,3,6,3,0,3,0
S01012413,Occupancy rating -1 or less,16,9,3,6,6,0,4,1,3,0,2,2,0,1,1,0,0,0
S01012414,All households,341,144,71,73,189,29,145,80,46,19,15,10,5,8,2,0,4,2
S01012414,Occupancy rating +2 or more,245,96,43,53,143,24,111,70,31,10,8,5,3,6,2,0,3,1
S01012414,Occupancy rating +1,46,21,11,10,25,4,17,6,6,5,4,3,1,0,0,0,0,0
S01012414,Occupancy rating 0,47,26,16,10,20,1,16,4,8,4,3,2,1,1,0,0,0,1
S01012414,Occupancy rating -1 or less,3,1,1,0,1,0,1,0,1,0,0,0,0,1,0,0,1,0
S01012415,All households,203,41,19,22,156,30,115,34,57,24,11,3,8,6,1,0,1,4
S01012415,Occupancy rating +2 or more,145,23,13,10,118,28,82,29,34,19,8,2,6,4,0,0,1,3
S01012415,Occupancy rating +1,35,11,5,6,23,1,20,4,13,3,2,0,2,1,1,0,0,0
S01012415,Occupancy rating 0,19,6,1,5,13,0,12,1,10,1,1,1,0,0,0,0,0,0
S01012415,Occupancy rating -1 or less,4,1,0,1,2,1,1,0,0,1,0,0,0,1,0,0,0,1
S01012416,All households,216,54,29,25,150,34,106,40,43,23,10,4,6,12,5,0,2,5
S01012416,Occupancy rating +2 or more,157,31,16,15,120,32,81,36,29,16,7,3,4,6,2,0,1,3
S01012416,Occupancy rating +1,33,11,7,4,19,2,14,3,6,5,3,1,2,3,1,0,1,1
S01012416,Occupancy rating 0,21,11,6,5,10,0,10,1,7,2,0,0,0,0,0,0,0,0
S01012416,Occupancy rating -1 or less,5,1,0,1,1,0,1,0,1,0,0,0,0,3,2,0,0,1
S01012417,All households,299,101,53,48,184,44,123,58,46,19,17,11,6,14,3,0,2,9
S01012417,Occupancy rating +2 or more,161,53,28,25,105,36,69,41,17,11,0,0,0,3,1,0,0,2
S01012417,Occupancy rating +1,68,25,15,10,40,8,30,13,13,4,2,0,2,3,1,0,1,1
S01012417,Occupancy rating 0,52,19,8,11,29,0,20,3,13,4,9,8,1,4,0,0,0,4
S01012417,Occupancy rating -1 or less,18,4,2,2,10,0,4,1,3,0,6,3,3,4,1,0,1,2
S01012418,All households,343,85,44,41,240,45,166,94,44,28,29,14,15,18,5,0,2,11
S01012418,Occupancy rating +2 or more,221,47,25,22,163,38,116,76,21,19,9,5,4,11,5,0,0,6
S01012418,Occupancy rating +1,58,26,10,16,29,4,21,13,4,4,4,2,2,3,0,0,0,3
S01012418,Occupancy rating 0,52,12,9,3,37,3,22,5,14,3,12,5,7,3,0,0,2,1
S01012418,Occupancy rating -1 or less,12,0,0,0,11,0,7,0,5,2,4,2,2,1,0,0,0,1
S01012419,All households,313,70,43,27,224,41,164,80,66,18,19,10,9,19,10,0,2,7
S01012419,Occupancy rating +2 or more,201,43,28,15,147,33,107,63,32,12,7,0,7,11,5,0,1,5
S01012419,Occupancy rating +1,60,17,10,7,38,6,26,11,12,3,6,4,2,5,3,0,1,1
S01012419,Occupancy rating 0,39,8,4,4,30,2,23,4,16,3,5,5,0,1,1,0,0,0
S01012419,Occupancy rating -1 or less,13,2,1,1,9,0,8,2,6,0,1,1,0,2,1,0,0,1
S01012420,All households,362,95,56,39,256,30,172,70,67,35,54,36,18,11,5,0,1,5
S01012420,Occupancy rating +2 or more,137,35,25,10,99,19,73,49,15,9,7,3,4,3,2,0,1,0
S01012420,Occupancy rating +1,104,26,13,13,76,7,58,20,24,14,11,9,2,2,1,0,0,1
S01012420,Occupancy rating 0,92,28,13,15,60,4,33,1,22,10,23,15,8,4,1,0,0,3
S01012420,Occupancy rating -1 or less,29,6,5,1,21,0,8,0,6,2,13,9,4,2,1,0,0,1
S01012421,All households,325,97,53,44,210,38,139,64,46,29,33,21,12,18,6,0,0,12
S01012421,Occupancy rating +2 or more,153,36,16,20,113,28,79,51,15,13,6,2,4,4,1,0,0,3
S01012421,Occupancy rating +1,96,46,26,20,43,7,26,12,6,8,10,7,3,7,3,0,0,4
S01012421,Occupancy rating 0,53,11,8,3,39,3,24,1,16,7,12,9,3,3,0,0,0,3
S01012421,Occupancy rating -1 or less,23,4,3,1,15,0,10,0,9,1,5,3,2,4,2,0,0,2
S01012422,All households,402,131,59,72,255,40,172,87,61,24,43,26,17,16,8,0,1,7
S01012422,Occupancy rating +2 or more,211,75,36,39,128,26,91,63,22,6,11,6,5,8,2,0,1,5
S01012422,Occupancy rating +1,103,35,12,23,67,9,47,21,17,9,11,3,8,1,0,0,0,1
S01012422,Occupancy rating 0,64,12,9,3,49,2,29,3,17,9,18,14,4,3,3,0,0,0
S01012422,Occupancy rating -1 or less,24,9,2,7,11,3,5,0,5,0,3,3,0,4,3,0,0,1
S01012423,All households,346,85,44,41,247,40,181,86,55,40,26,14,12,14,6,0,2,6
S01012423,Occupancy rating +2 or more,188,46,22,24,136,26,104,58,28,18,6,3,3,6,2,0,1,3
S01012423,Occupancy rating +1,95,29,15,14,65,10,51,22,12,17,4,2,2,1,0,0,0,1
S01012423,Occupancy rating 0,51,10,7,3,36,3,20,6,11,3,13,7,6,5,2,0,1,2
S01012423,Occupancy rating -1 or less,12,0,0,0,10,1,6,0,4,2,3,2,1,2,2,0,0,0
S01012424,All households,414,129,61,68,274,39,188,79,79,30,47,36,11,11,5,0,0,6
S01012424,Occupancy rating +2 or more,164,45,22,23,118,23,84,45,30,9,11,9,2,1,1,0,0,0
S01012424,Occupancy rating +1,141,51,28,23,86,12,62,33,21,8,12,8,4,4,1,0,0,3
S01012424,Occupancy rating 0,75,23,9,14,48,2,27,1,18,8,19,14,5,4,1,0,0,3
S01012424,Occupancy rating -1 or less,34,10,2,8,22,2,15,0,10,5,5,5,0,2,2,0,0,0
S01012425,All households,307,129,62,67,168,22,96,34,47,15,50,38,12,10,2,0,1,7
S01012425,Occupancy rating +2 or more,61,24,16,8,35,11,23,16,3,4,1,1,0,2,0,0,0,2
S01012425,Occupancy rating +1,100,45,16,29,52,9,32,14,14,4,11,10,1,3,0,0,1,2
S01012425,Occupancy rating 0,108,46,23,23,59,2,31,4,23,4,26,19,7,3,1,0,0,2
S01012425,Occupancy rating -1 or less,38,14,7,7,22,0,10,0,7,3,12,8,4,2,1,0,0,1
S01012426,All households,237,94,33,61,136,20,74,27,41,6,42,31,11,7,5,0,0,2
S01012426,Occupancy rating +2 or more,64,30,15,15,33,14,14,10,4,0,5,5,0,1,1,0,0,0
S01012426,Occupancy rating +1,86,42,11,31,43,2,31,15,13,3,10,6,4,1,1,0,0,0
S01012426,Occupancy rating 0,72,21,7,14,47,4,21,2,17,2,22,15,7,4,2,0,0,2
S01012426,Occupancy rating -1 or less,15,1,0,1,13,0,8,0,7,1,5,5,0,1,1,0,0,0
S01012427,All households,300,100,42,58,188,22,119,49,58,12,47,33,14,12,3,0,1,8
S01012427,Occupancy rating +2 or more,81,34,21,13,46,11,34,28,5,1,1,1,0,1,0,0,0,1
S01012427,Occupancy rating +1,108,39,9,30,66,11,41,19,14,8,14,9,5,3,1,0,0,2
S01012427,Occupancy rating 0,83,22,9,13,58,0,36,2,32,2,22,15,7,3,0,0,0,3
S01012427,Occupancy rating -1 or less,28,5,3,2,18,0,8,0,7,1,10,8,2,5,2,0,1,2
S01012428,All households,286,78,46,32,202,28,148,63,62,23,26,17,9,6,3,0,0,3
S01012428,Occupancy rating +2 or more,149,49,30,19,97,24,72,48,15,9,1,1,0,3,1,0,0,2
S01012428,Occupancy rating +1,85,22,12,10,62,2,48,12,26,10,12,6,6,1,0,0,0,1
S01012428,Occupancy rating 0,43,5,2,3,37,1,25,3,18,4,11,8,3,1,1,0,0,0
S01012428,Occupancy rating -1 or less,9,2,2,0,6,1,3,0,3,0,2,2,0,1,1,0,0,0
S01012429,All households,286,122,65,57,150,26,95,50,35,10,29,21,8,14,7,0,3,4
S01012429,Occupancy rating +2 or more,130,54,33,21,72,17,46,29,12,5,9,5,4,4,3,0,1,0
S01012429,Occupancy rating +1,74,40,24,16,30,7,21,15,6,0,2,2,0,4,1,0,1,2
S01012429,Occupancy rating 0,61,20,6,14,38,2,26,6,16,4,10,7,3,3,0,0,1,2
S01012429,Occupancy rating -1 or less,21,8,2,6,10,0,2,0,1,1,8,7,1,3,3,0,0,0
S01012430,All households,277,107,52,55,163,31,96,48,37,11,36,19,17,7,4,0,0,3
S01012430,Occupancy rating +2 or more,153,56,32,24,95,18,67,40,21,6,10,2,8,2,0,0,0,2
S01012430,Occupancy rating +1,62,24,11,13,36,10,14,5,6,3,12,7,5,2,1,0,0,1
S01012430,Occupancy rating 0,48,22,7,15,26,3,10,2,7,1,13,9,4,0,0,0,0,0
S01012430,Occupancy rating -1 or less,14,5,2,3,6,0,5,1,3,1,1,1,0,3,3,0,0,0
S01012431,All households,432,168,109,59,245,46,164,68,67,29,35,19,16,19,5,0,4,10
S01012431,Occupancy rating +2 or more,220,62,39,23,149,34,102,49,33,20,13,7,6,9,2,0,1,6
S01012431,Occupancy rating +1,91,40,20,20,49,7,31,13,12,6,11,6,5,2,0,0,2,0
S01012431,Occupancy rating 0,75,36,25,11,34,4,22,5,15,2,8,5,3,5,2,0,0,3
S01012431,Occupancy rating -1 or less,46,30,25,5,13,1,9,1,7,1,3,1,2,3,1,0,1,1
S01012432,All households,352,131,76,55,209,54,127,64,45,18,28,17,11,12,5,1,2,4
S01012432,Occupancy rating +2 or more,162,49,33,16,110,37,67,43,14,10,6,3,3,3,0,0,2,1
S01012432,Occupancy rating +1,95,38,23,15,55,9,38,19,15,4,8,5,3,2,0,1,0,1
S01012432,Occupancy rating 0,64,29,17,12,33,7,15,2,9,4,11,6,5,2,1,0,0,1
S01012432,Occupancy rating -1 or less,31,15,3,12,11,1,7,0,7,0,3,3,0,5,4,0,0,1
S01012433,All households,265,118,54,64,141,27,95,50,31,14,19,13,6,6,0,0,1,5
S01012433,Occupancy rating +2 or more,78,21,10,11,54,12,39,22,9,8,3,1,2,3,0,0,0,3
S01012433,Occupancy rating +1,101,58,29,29,41,10,29,20,7,2,2,1,1,2,0,0,1,1
S01012433,Occupancy rating 0,66,29,12,17,37,5,23,8,12,3,9,7,2,0,0,0,0,0
S01012433,Occupancy rating -1 or less,20,10,3,7,9,0,4,0,3,1,5,4,1,1,0,0,0,1
S01012434,All households,334,136,54,82,181,20,117,44,52,21,44,30,14,17,9,0,1,7
S01012434,Occupancy rating +2 or more,71,28,14,14,41,9,27,17,8,2,5,4,1,2,1,0,0,1
S01012434,Occupancy rating +1,126,66,30,36,59,8,45,20,16,9,6,4,2,1,0,0,1,0
S01012434,Occupancy rating 0,110,35,7,28,66,2,38,7,21,10,26,19,7,9,5,0,0,4
S01012434,Occupancy rating -1 or less,27,7,3,4,15,1,7,0,7,0,7,3,4,5,3,0,0,2
S01012435,All households,311,129,46,83,169,15,115,54,49,12,39,28,11,13,6,0,2,5
S01012435,Occupancy rating +2 or more,68,27,6,21,41,6,32,21,9,2,3,3,0,0,0,0,0,0
S01012435,Occupancy rating +1,106,50,28,22,53,7,35,21,10,4,11,7,4,3,2,0,1,0
S01012435,Occupancy rating 0,99,37,9,28,55,0,35,9,21,5,20,14,6,7,3,0,1,3
S01012435,Occupancy rating -1 or less,38,15,3,12,20,2,13,3,9,1,5,4,1,3,1,0,0,2
S01012436,All households,345,128,34,94,210,36,117,34,65,18,57,41,16,7,4,0,0,3
S01012436,Occupancy rating +2 or more,82,24,11,13,57,15,39,18,15,6,3,3,0,1,0,0,0,1
S01012436,Occupancy rating +1,128,65,17,48,62,17,32,13,11,8,13,11,2,1,0,0,0,1
S01012436,Occupancy rating 0,101,29,2,27,71,3,40,3,33,4,28,20,8,1,1,0,0,0
S01012436,Occupancy rating -1 or less,34,10,4,6,20,1,6,0,6,0,13,7,6,4,3,0,0,1
S01012437,All households,336,117,58,59,205,27,144,63,66,15,34,14,20,14,5,0,2,7
S01012437,Occupancy rating +2 or more,132,43,32,11,86,17,63,41,18,4,6,1,5,3,2,0,0,1
S01012437,Occupancy rating +1,96,24,14,10,65,8,45,18,23,4,12,4,8,7,1,0,2,4
S01012437,Occupancy rating 0,89,43,8,35,43,2,27,4,19,4,14,7,7,3,2,0,0,1
S01012437,Occupancy rating -1 or less,19,7,4,3,11,0,9,0,6,3,2,2,0,1,0,0,0,1
S01012438,All households,260,48,18,30,205,18,158,56,72,30,29,25,4,7,4,0,0,3
S01012438,Occupancy rating +2 or more,130,24,12,12,103,12,86,44,32,10,5,3,2,3,2,0,0,1
S01012438,Occupancy rating +1,76,23,6,17,52,6,36,10,18,8,10,9,1,1,0,0,0,1
S01012438,Occupancy rating 0,42,1,0,1,39,0,28,2,17,9,11,10,1,2,2,0,0,0
S01012438,Occupancy rating -1 or less,12,0,0,0,11,0,8,0,5,3,3,3,0,1,0,0,0,1
S01012439,All households,355,126,58,68,219,29,147,69,63,15,43,32,11,10,4,0,0,6
S01012439,Occupancy rating +2 or more,143,33,18,15,106,25,75,45,25,5,6,2,4,4,1,0,0,3
S01012439,Occupancy rating +1,83,34,10,24,49,3,34,12,15,7,12,8,4,0,0,0,0,0
S01012439,Occupancy rating 0,96,47,28,19,44,0,28,10,16,2,16,13,3,5,3,0,0,2
S01012439,Occupancy rating -1 or less,33,12,2,10,20,1,10,2,7,1,9,9,0,1,0,0,0,1
S01012440,All households,221,57,29,28,158,22,125,50,43,32,11,4,7,6,3,0,0,3
S01012440,Occupancy rating +2 or more,148,33,21,12,113,20,84,41,26,17,9,3,6,2,1,0,0,1
S01012440,Occupancy rating +1,42,8,4,4,32,2,29,7,12,10,1,1,0,2,1,0,0,1
S01012440,Occupancy rating 0,24,11,3,8,11,0,10,2,4,4,1,0,1,2,1,0,0,1
S01012440,Occupancy rating -1 or less,7,5,1,4,2,0,2,0,1,1,0,0,0,0,0,0,0,0
S01012441,All households,387,90,49,41,282,36,225,128,66,31,21,11,10,15,6,0,3,6
S01012441,Occupancy rating +2 or more,237,49,29,20,183,23,154,108,33,13,6,3,3,5,2,0,1,2
S01012441,Occupancy rating +1,80,23,12,11,54,12,36,11,16,9,6,3,3,3,1,0,2,0
S01012441,Occupancy rating 0,53,14,6,8,35,1,27,8,11,8,7,4,3,4,2,0,0,2
S01012441,Occupancy rating -1 or less,17,4,2,2,10,0,8,1,6,1,2,1,1,3,1,0,0,2
S01012442,All households,423,123,44,79,282,35,199,86,77,36,48,39,9,18,10,0,1,7
S01012442,Occupancy rating +2 or more,256,71,30,41,175,29,132,71,38,23,14,11,3,10,5,0,0,5
S01012442,Occupancy rating +1,98,41,11,30,53,6,33,11,15,7,14,11,3,4,1,0,1,2
S01012442,Occupancy rating 0,53,10,3,7,41,0,24,3,18,3,17,14,3,2,2,0,0,0
S01012442,Occupancy rating -1 or less,16,1,0,1,13,0,10,1,6,3,3,3,0,2,2,0,0,0
S01012443,All households,313,79,41,38,223,27,173,73,74,26,23,14,9,11,5,0,0,6
S01012443,Occupancy rating +2 or more,190,41,22,19,145,23,117,57,46,14,5,0,5,4,2,0,0,2
S01012443,Occupancy rating +1,61,19,9,10,39,4,29,13,12,4,6,4,2,3,1,0,0,2
S01012443,Occupancy rating 0,47,14,8,6,29,0,19,1,13,5,10,9,1,4,2,0,0,2
S01012443,Occupancy rating -1 or less,15,5,2,3,10,0,8,2,3,3,2,1,1,0,0,0,0,0
S01012444,All households,292,69,39,30,216,46,151,66,57,28,19,11,8,7,3,0,1,3
S01012444,Occupancy rating +2 or more,220,53,34,19,164,43,110,52,39,19,11,6,5,3,0,0,1,2
S01012444,Occupancy rating +1,47,12,4,8,33,3,28,10,14,4,2,0,2,2,2,0,0,0
S01012444,Occupancy rating 0,15,3,1,2,11,0,9,4,3,2,2,2,0,1,0,0,0,1
S01012444,Occupancy rating -1 or less,10,1,0,1,8,0,4,0,1,3,4,3,1,1,1,0,0,0
S01012445,All households,183,20,7,13,156,18,126,32,77,17,12,10,2,7,2,0,1,4
S01012445,Occupancy rating +2 or more,146,15,6,9,130,15,109,31,62,16,6,6,0,1,1,0,0,0
S01012445,Occupancy rating +1,13,3,1,2,8,3,3,1,2,0,2,1,1,2,1,0,0,1
S01012445,Occupancy rating 0,19,1,0,1,15,0,12,0,11,1,3,2,1,3,0,0,1,2
S01012445,Occupancy rating -1 or less,5,1,0,1,3,0,2,0,2,0,1,1,0,1,0,0,0,1
S01012446,All households,252,113,45,68,130,19,79,33,29,17,32,15,17,9,4,0,0,5
S01012446,Occupancy rating +2 or more,77,32,14,18,44,9,26,15,6,5,9,3,6,1,0,0,0,1
S01012446,Occupancy rating +1,79,39,5,34,39,5,28,11,11,6,6,2,4,1,0,0,0,1
S01012446,Occupancy rating 0,77,34,20,14,40,4,23,7,11,5,13,8,5,3,1,0,0,2
S01012446,Occupancy rating -1 or less,19,8,6,2,7,1,2,0,1,1,4,2,2,4,3,0,0,1
S01012447,All households,354,76,40,36,269,48,187,71,82,34,34,18,16,9,4,0,0,5
S01012447,Occupancy rating +2 or more,215,41,26,15,169,39,118,54,45,19,12,6,6,5,0,0,0,5
S01012447,Occupancy rating +1,99,32,13,19,65,7,50,16,24,10,8,6,2,2,2,0,0,0
S01012447,Occupancy rating 0,32,3,1,2,27,2,15,1,9,5,10,3,7,2,2,0,0,0
S01012447,Occupancy rating -1 or less,8,0,0,0,8,0,4,0,4,0,4,3,1,0,0,0,0,0
S01012448,All households,361,75,27,48,268,32,206,76,108,22,30,20,10,18,8,0,2,8
S01012448,Occupancy rating +2 or more,256,55,23,32,192,31,153,65,74,14,8,6,2,9,4,0,1,4
S01012448,Occupancy rating +1,58,10,3,7,45,1,34,5,23,6,10,6,4,3,1,0,0,2
S01012448,Occupancy rating 0,40,10,1,9,25,0,16,4,11,1,9,7,2,5,2,0,1,2
S01012448,Occupancy rating -1 or less,7,0,0,0,6,0,3,2,0,1,3,1,2,1,1,0,0,0
S01012449,All households,252,69,29,40,175,19,120,54,40,26,36,24,12,8,4,0,0,4
S01012449,Occupancy rating +2 or more,101,28,19,9,73,12,54,29,15,10,7,4,3,0,0,0,0,0
S01012449,Occupancy rating +1,89,24,5,19,62,6,45,23,13,9,11,4,7,3,1,0,0,2
S01012449,Occupancy rating 0,48,13,4,9,32,1,15,2,7,6,16,14,2,3,1,0,0,2
S01012449,Occupancy rating -1 or less,14,4,1,3,8,0,6,0,5,1,2,2,0,2,2,0,0,0
S01012450,All households,322,67,26,41,235,28,187,72,85,30,20,11,9,20,8,0,3,9
S01012450,Occupancy rating +2 or more,213,44,17,27,157,25,126,64,47,15,6,4,2,12,6,0,2,4
S01012450,Occupancy rating +1,61,15,6,9,45,3,37,5,23,9,5,3,2,1,0,0,0,1
S01012450,Occupancy rating 0,33,6,2,4,23,0,18,2,11,5,5,2,3,4,1,0,0,3
S01012450,Occupancy rating -1 or less,15,2,1,1,10,0,6,1,4,1,4,2,2,3,1,0,1,1
S01012451,All households,397,114,84,30,277,91,165,72,65,28,21,12,9,6,3,0,0,3
S01012451,Occupancy rating +2 or more,347,101,76,25,242,87,144,67,54,23,11,4,7,4,1,0,0,3
S01012451,Occupancy rating +1,35,9,6,3,25,2,15,4,7,4,8,6,2,1,1,0,0,0
S01012451,Occupancy rating 0,13,4,2,2,8,2,4,1,2,1,2,2,0,1,1,0,0,0
S01012451,Occupancy rating -1 or less,2,0,0,0,2,0,2,0,2,0,0,0,0,0,0,0,0,0
S01012452,All households,301,123,79,44,173,43,104,47,44,13,26,17,9,5,2,0,0,3
S01012452,Occupancy rating +2 or more,140,51,36,15,87,26,55,30,21,4,6,2,4,2,0,0,0,2
S01012452,Occupancy rating +1,113,57,34,23,56,12,35,15,14,6,9,6,3,0,0,0,0,0
S01012452,Occupancy rating 0,38,13,7,6,24,4,12,2,7,3,8,7,1,1,1,0,0,0
S01012452,Occupancy rating -1 or less,10,2,2,0,6,1,2,0,2,0,3,2,1,2,1,0,0,1
S01012453,All households,322,49,34,15,263,55,203,90,90,23,5,3,2,10,4,0,0,6
S01012453,Occupancy rating +2 or more,296,42,28,14,246,54,188,86,80,22,4,2,2,8,3,0,0,5
S01012453,Occupancy rating +1,20,5,5,0,14,1,13,3,9,1,0,0,0,1,1,0,0,0
S01012453,Occupancy rating 0,5,2,1,1,3,0,2,1,1,0,1,1,0,0,0,0,0,0
S01012453,Occupancy rating -1 or less,1,0,0,0,0,0,0,0,0,0,0,0,0,1,0,0,0,1
S01012454,All households,301,81,57,24,214,68,126,52,53,21,20,8,12,6,1,0,1,4
S01012454,Occupancy rating +2 or more,237,64,44,20,171,63,99,47,39,13,9,3,6,2,0,0,0,2
S01012454,Occupancy rating +1,49,16,12,4,31,3,23,5,12,6,5,2,3,2,1,0,1,0
S01012454,Occupancy rating 0,12,1,1,0,10,1,4,0,2,2,5,2,3,1,0,0,0,1
S01012454,Occupancy rating -1 or less,3,0,0,0,2,1,0,0,0,0,1,1,0,1,0,0,0,1
S01012455,All households,246,47,31,16,190,47,138,59,68,11,5,2,3,9,3,0,1,5
S01012455,Occupancy rating +2 or more,219,40,28,12,171,47,121,55,59,7,3,1,2,8,3,0,1,4
S01012455,Occupancy rating +1,18,5,2,3,12,0,10,2,4,4,2,1,1,1,0,0,0,1
S01012455,Occupancy rating 0,8,1,0,1,7,0,7,2,5,0,0,0,0,0,0,0,0,0
S01012455,Occupancy rating -1 or less,1,1,1,0,0,0,0,0,0,0,0,0,0,0,0,0,0,0
S01012456,All households,300,54,37,17,239,58,166,75,70,21,15,8,7,7,4,0,0,3
S01012456,Occupancy rating +2 or more,262,48,35,13,209,56,144,70,55,19,9,5,4,5,3,0,0,2
S01012456,Occupancy rating +1,23,4,1,3,18,2,12,5,6,1,4,1,3,1,0,0,0,1
S01012456,Occupancy rating 0,11,1,1,0,10,0,9,0,8,1,1,1,0,0,0,0,0,0
S01012456,Occupancy rating -1 or less,4,1,0,1,2,0,1,0,1,0,1,1,0,1,1,0,0,0
S01012457,All households,380,72,48,24,300,85,201,114,51,36,14,6,8,8,4,0,0,4
S01012457,Occupancy rating +2 or more,335,66,42,24,262,80,174,108,38,28,8,2,6,7,3,0,0,4
S01012457,Occupancy rating +1,27,5,5,0,22,4,15,6,6,3,3,2,1,0,0,0,0,0
S01012457,Occupancy rating 0,14,0,0,0,13,1,9,0,7,2,3,2,1,1,1,0,0,0
S01012457,Occupancy rating -1 or less,4,1,1,0,3,0,3,0,0,3,0,0,0,0,0,0,0,0
S01012458,All households,330,69,46,23,252,66,170,59,84,27,16,10,6,9,5,0,1,3
S01012458,Occupancy rating +2 or more,288,60,42,18,227,64,152,57,71,24,11,6,5,1,1,0,0,0
S01012458,Occupancy rating +1,30,6,3,3,19,2,13,2,9,2,4,3,1,5,2,0,1,2
S01012458,Occupancy rating 0,3,1,0,1,2,0,2,0,2,0,0,0,0,0,0,0,0,0
S01012458,Occupancy rating -1 or less,9,2,1,1,4,0,3,0,2,1,1,1,0,3,2,0,0,1
S01012459,All households,271,43,26,17,216,26,170,54,86,30,20,14,6,12,5,0,1,6
S01012459,Occupancy rating +2 or more,201,36,21,15,159,23,125,53,50,22,11,7,4,6,1,0,0,5
S01012459,Occupancy rating +1,45,6,4,2,35,3,29,1,23,5,3,3,0,4,2,0,1,1
S01012459,Occupancy rating 0,20,1,1,0,18,0,12,0,10,2,6,4,2,1,1,0,0,0
S01012459,Occupancy rating -1 or less,5,0,0,0,4,0,4,0,3,1,0,0,0,1,1,0,0,0
S01012460,All households,242,63,47,16,169,44,117,51,44,22,8,3,5,10,2,1,0,7
S01012460,Occupancy rating +2 or more,174,46,33,13,122,34,85,44,28,13,3,1,2,6,1,0,0,5
S01012460,Occupancy rating +1,50,17,14,3,32,9,21,6,10,5,2,0,2,1,0,0,0,1
S01012460,Occupancy rating 0,15,0,0,0,13,0,10,1,6,3,3,2,1,2,1,0,0,1
S01012460,Occupancy rating -1 or less,3,0,0,0,2,1,1,0,0,1,0,0,0,1,0,1,0,0
S01012461,All households,250,82,37,45,161,29,92,34,36,22,40,24,16,7,3,0,0,4
S01012461,Occupancy rating +2 or more,89,22,11,11,67,10,45,18,17,10,12,5,7,0,0,0,0,0
S01012461,Occupancy rating +1,68,24,12,12,42,13,21,10,8,3,8,6,2,2,1,0,0,1
S01012461,Occupancy rating 0,72,29,11,18,41,6,23,5,9,9,12,7,5,2,0,0,0,2
S01012461,Occupancy rating -1 or less,21,7,3,4,11,0,3,1,2,0,8,6,2,3,2,0,0,1
S01012462,All households,386,157,68,89,214,37,118,48,46,24,59,38,21,15,7,0,0,8
S01012462,Occupancy rating +2 or more,71,29,18,11,39,10,22,14,6,2,7,4,3,3,1,0,0,2
S01012462,Occupancy rating +1,139,60,35,25,79,20,50,28,15,7,9,6,3,0,0,0,0,0
S01012462,Occupancy rating 0,144,62,15,47,74,5,36,5,19,12,33,23,10,8,4,0,0,4
S01012462,Occupancy rating -1 or less,32,6,0,6,22,2,10,1,6,3,10,5,5,4,2,0,0,2
S01012463,All households,256,80,24,56,158,17,100,39,39,22,41,23,18,18,9,0,0,9
S01012463,Occupancy rating +2 or more,78,26,11,15,50,13,33,26,5,2,4,1,3,2,1,0,0,1
S01012463,Occupancy rating +1,70,22,7,15,45,3,31,10,10,11,11,5,6,3,0,0,0,3
S01012463,Occupancy rating 0,86,30,6,24,48,1,29,3,17,9,18,10,8,8,4,0,0,4
S01012463,Occupancy rating -1 or less,22,2,0,2,15,0,7,0,7,0,8,7,1,5,4,0,0,1
S01012464,All households,255,56,13,43,190,6,126,58,44,24,58,35,23,9,7,0,0,2
S01012464,Occupancy rating +2 or more,84,29,9,20,55,3,42,32,7,3,10,6,4,0,0,0,0,0
S01012464,Occupancy rating +1,96,22,3,19,72,1,49,25,12,12,22,13,9,2,1,0,0,1
S01012464,Occupancy rating 0,54,4,0,4,48,1,28,0,21,7,19,9,10,2,2,0,0,0
S01012464,Occupancy rating -1 or less,21,1,1,0,15,1,7,1,4,2,7,7,0,5,4,0,0,1
S01012465,All households,286,55,22,33,216,22,141,63,48,30,53,34,19,15,9,0,0,6
S01012465,Occupancy rating +2 or more,102,31,14,17,71,16,54,38,8,8,1,1,0,0,0,0,0,0
S01012465,Occupancy rating +1,87,16,6,10,65,3,44,22,11,11,18,12,6,6,2,0,0,4
S01012465,Occupancy rating 0,75,4,1,3,64,3,37,2,26,9,24,13,11,7,5,0,0,2
S01012465,Occupancy rating -1 or less,22,4,1,3,16,0,6,1,3,2,10,8,2,2,2,0,0,0
S01012466,All households,349,110,61,49,218,38,137,53,44,40,43,29,14,21,6,0,0,15
S01012466,Occupancy rating +2 or more,197,59,38,21,134,31,95,43,27,25,8,4,4,4,1,0,0,3
S01012466,Occupancy rating +1,81,34,17,17,42,5,27,9,11,7,10,8,2,5,2,0,0,3
S01012466,Occupancy rating 0,54,13,6,7,32,2,13,1,4,8,17,11,6,9,1,0,0,8
S01012466,Occupancy rating -1 or less,17,4,0,4,10,0,2,0,2,0,8,6,2,3,2,0,0,1
S01012467,All households,307,89,44,45,205,35,122,46,53,23,48,33,15,13,8,1,1,3
S01012467,Occupancy rating +2 or more,108,34,17,17,72,20,50,30,14,6,2,2,0,2,0,0,1,1
S01012467,Occupancy rating +1,125,44,20,24,79,13,47,16,21,10,19,10,9,2,2,0,0,0
S01012467,Occupancy rating 0,59,8,6,2,45,2,20,0,14,6,23,18,5,6,3,1,0,2
S01012467,Occupancy rating -1 or less,15,3,1,2,9,0,5,0,4,1,4,3,1,3,3,0,0,0
S01012468,All households,316,86,44,42,215,36,140,46,67,27,39,20,19,15,7,0,2,6
S01012468,Occupancy rating +2 or more,164,55,28,27,105,23,69,33,25,11,13,7,6,4,1,0,2,1
S01012468,Occupancy rating +1,97,27,13,14,65,11,41,11,24,6,13,4,9,5,0,0,0,5
S01012468,Occupancy rating 0,45,3,2,1,40,2,28,2,18,8,10,6,4,2,2,0,0,0
S01012468,Occupancy rating -1 or less,10,1,1,0,5,0,2,0,0,2,3,3,0,4,4,0,0,0
S01012469,All households,333,87,60,27,236,45,178,87,67,24,13,9,4,10,3,0,2,5
S01012469,Occupancy rating +2 or more,246,54,36,18,186,36,146,80,49,17,4,3,1,6,1,0,1,4
S01012469,Occupancy rating +1,63,23,17,6,37,8,24,5,14,5,5,4,1,3,1,0,1,1
S01012469,Occupancy rating 0,19,10,7,3,9,1,5,0,3,2,3,1,2,0,0,0,0,0
S01012469,Occupancy rating -1 or less,5,0,0,0,4,0,3,2,1,0,1,1,0,1,1,0,0,0
S01012470,All households,492,205,95,110,269,53,160,73,61,26,56,33,23,18,7,0,1,10
S01012470,Occupancy rating +2 or more,188,68,40,28,115,38,70,34,22,14,7,3,4,5,1,0,1,3
S01012470,Occupancy rating +1,185,98,46,52,84,11,59,37,17,5,14,9,5,3,0,0,0,3
S01012470,Occupancy rating 0,89,27,8,19,57,3,27,2,21,4,27,15,12,5,1,0,0,4
S01012470,Occupancy rating -1 or less,30,12,1,11,13,1,4,0,1,3,8,6,2,5,5,0,0,0
S01012471,All households,352,79,51,28,263,75,175,80,68,27,13,9,4,10,6,0,0,4
S01012471,Occupancy rating +2 or more,300,63,42,21,231,71,152,80,54,18,8,6,2,6,3,0,0,3
S01012471,Occupancy rating +1,37,13,9,4,22,3,18,0,11,7,1,1,0,2,1,0,0,1
S01012471,Occupancy rating 0,11,3,0,3,7,1,3,0,2,1,3,2,1,1,1,0,0,0
S01012471,Occupancy rating -1 or less,4,0,0,0,3,0,2,0,1,1,1,0,1,1,1,0,0,0
S01012472,All households,317,75,54,21,234,76,140,63,59,18,18,9,9,8,4,0,1,3
S01012472,Occupancy rating +2 or more,242,61,42,19,174,64,102,55,35,12,8,4,4,7,3,0,1,3
S01012472,Occupancy rating +1,57,13,11,2,44,10,28,8,16,4,6,3,3,0,0,0,0,0
S01012472,Occupancy rating 0,15,1,1,0,13,2,7,0,5,2,4,2,2,1,1,0,0,0
S01012472,Occupancy rating -1 or less,3,0,0,0,3,0,3,0,3,0,0,0,0,0,0,0,0,0
S01012473,All households,218,34,16,18,175,34,127,48,55,24,14,4,10,9,5,0,1,3
S01012473,Occupancy rating +2 or more,162,24,10,14,134,27,99,45,38,16,8,2,6,4,2,0,1,1
S01012473,Occupancy rating +1,40,8,6,2,32,7,19,2,12,5,6,2,4,0,0,0,0,0
S01012473,Occupancy rating 0,8,2,0,2,3,0,3,0,3,0,0,0,0,3,2,0,0,1
S01012473,Occupancy rating -1 or less,8,0,0,0,6,0,6,1,2,3,0,0,0,2,1,0,0,1
S01012474,All households,371,169,98,71,187,34,122,61,36,25,31,17,14,15,5,1,2,7
S01012474,Occupancy rating +2 or more,180,65,40,25,108,25,80,47,19,14,3,1,2,7,1,1,2,3
S01012474,Occupancy rating +1,76,32,15,17,43,5,25,8,12,5,13,6,7,1,1,0,0,0
S01012474,Occupancy rating 0,99,67,42,25,29,3,15,6,4,5,11,7,4,3,1,0,0,2
S01012474,Occupancy rating -1 or less,16,5,1,4,7,1,2,0,1,1,4,3,1,4,2,0,0,2
S01012475,All households,300,90,54,36,193,53,116,49,45,22,24,10,14,17,2,0,2,13
S01012475,Occupancy rating +2 or more,160,46,29,17,114,39,70,42,18,10,5,0,5,0,0,0,0,0
S01012475,Occupancy rating +1,76,38,20,18,36,13,17,6,6,5,6,2,4,2,0,0,1,1
S01012475,Occupancy rating 0,57,5,4,1,38,1,26,0,20,6,11,6,5,14,1,0,1,12
S01012475,Occupancy rating -1 or less,7,1,1,0,5,0,3,1,1,1,2,2,0,1,1,0,0,0
S01012476,All households,422,121,64,57,284,50,161,67,63,31,73,55,18,17,4,1,2,10
S01012476,Occupancy rating +2 or more,144,53,31,22,89,27,56,40,9,7,6,5,1,2,0,0,0,2
S01012476,Occupancy rating +1,152,56,24,32,90,18,50,25,20,5,22,15,7,6,0,0,2,4
S01012476,Occupancy rating 0,108,8,7,1,92,5,47,2,29,16,40,31,9,8,4,1,0,3
S01012476,Occupancy rating -1 or less,18,4,2,2,13,0,8,0,5,3,5,4,1,1,0,0,0,1
S01012477,All households,283,60,28,32,217,34,158,70,58,30,25,17,8,6,3,0,0,3
S01012477,Occupancy rating +2 or more,189,44,21,23,144,32,105,67,20,18,7,4,3,1,0,0,0,1
S01012477,Occupancy rating +1,60,12,5,7,46,2,35,3,23,9,9,6,3,2,1,0,0,1
S01012477,Occupancy rating 0,33,4,2,2,26,0,17,0,14,3,9,7,2,3,2,0,0,1
S01012477,Occupancy rating -1 or less,1,0,0,0,1,0,1,0,1,0,0,0,0,0,0,0,0,0
S01012478,All households,368,107,58,49,252,36,153,57,63,33,63,40,23,9,3,0,0,6
S01012478,Occupancy rating +2 or more,135,49,27,22,84,18,61,35,19,7,5,4,1,2,0,0,0,2
S01012478,Occupancy rating +1,137,52,28,24,83,15,48,20,16,12,20,9,11,2,0,0,0,2
S01012478,Occupancy rating 0,78,5,2,3,70,3,37,1,24,12,30,21,9,3,1,0,0,2
S01012478,Occupancy rating -1 or less,18,1,1,0,15,0,7,1,4,2,8,6,2,2,2,0,0,0
S01012479,All households,261,45,24,21,205,23,159,54,73,32,23,12,11,11,5,0,0,6
S01012479,Occupancy rating +2 or more,181,42,23,19,135,22,103,49,37,17,10,6,4,4,1,0,0,3
S01012479,Occupancy rating +1,49,2,0,2,43,1,34,4,22,8,8,3,5,4,2,0,0,2
S01012479,Occupancy rating 0,24,0,0,0,21,0,17,1,12,4,4,2,2,3,2,0,0,1
S01012479,Occupancy rating -1 or less,7,1,1,0,6,0,5,0,2,3,1,1,0,0,0,0,0,0
S01012480,All households,339,196,44,152,124,15,84,67,14,3,25,17,8,19,1,6,0,12
S01012480,Occupancy rating +2 or more,37,18,1,17,18,3,12,8,4,0,3,1,2,1,0,1,0,0
S01012480,Occupancy rating +1,128,77,16,61,49,5,41,39,2,0,3,1,2,2,0,0,0,2
S01012480,Occupancy rating 0,144,84,23,61,48,6,28,18,7,3,14,11,3,12,0,4,0,8
S01012480,Occupancy rating -1 or less,30,17,4,13,9,1,3,2,1,0,5,4,1,4,1,1,0,2
S01012481,All households,419,207,50,157,170,16,118,64,41,13,36,21,15,42,1,5,1,35
S01012481,Occupancy rating +2 or more,132,44,21,23,83,10,64,32,24,8,9,6,3,5,0,0,0,5
S01012481,Occupancy rating +1,111,66,17,49,39,4,29,20,7,2,6,1,5,6,1,0,0,5
S01012481,Occupancy rating 0,111,61,9,52,34,1,19,10,8,1,14,9,5,16,0,2,0,14
S01012481,Occupancy rating -1 or less,65,36,3,33,14,1,6,2,2,2,7,5,2,15,0,3,1,11
S01012482,All households,439,244,156,88,163,44,101,51,32,18,18,9,9,32,6,1,4,21
S01012482,Occupancy rating +2 or more,169,61,40,21,99,26,63,28,23,12,10,4,6,9,3,0,3,3
S01012482,Occupancy rating +1,101,61,33,28,30,9,20,14,3,3,1,1,0,10,1,1,0,8
S01012482,Occupancy rating 0,137,105,74,31,27,7,16,8,6,2,4,2,2,5,1,0,0,4
S01012482,Occupancy rating -1 or less,32,17,9,8,7,2,2,1,0,1,3,2,1,8,1,0,1,6
S01012483,All households,570,354,116,238,185,29,114,71,34,9,42,23,19,31,1,4,0,26
S01012483,Occupancy rating +2 or more,107,33,13,20,73,13,49,26,16,7,11,4,7,1,0,0,0,1
S01012483,Occupancy rating +1,147,96,27,69,43,6,29,25,3,1,8,4,4,8,0,0,0,8
S01012483,Occupancy rating 0,216,153,56,97,50,7,25,16,9,0,18,12,6,13,0,1,0,12
S01012483,Occupancy rating -1 or less,100,72,20,52,19,3,11,4,6,1,5,3,2,9,1,3,0,5
S01012484,All households,366,144,61,83,209,37,149,64,67,18,23,15,8,13,4,1,2,6
S01012484,Occupancy rating +2 or more,225,60,27,33,156,26,123,48,59,16,7,3,4,9,3,0,1,5
S01012484,Occupancy rating +1,94,58,27,31,35,10,15,9,5,1,10,8,2,1,0,0,1,0
S01012484,Occupancy rating 0,35,19,5,14,15,1,9,6,3,0,5,4,1,1,0,1,0,0
S01012484,Occupancy rating -1 or less,12,7,2,5,3,0,2,1,0,1,1,0,1,2,1,0,0,1
S01012485,All households,384,133,59,74,244,50,162,90,48,24,32,25,7,7,5,0,0,2
S01012485,Occupancy rating +2 or more,257,72,40,32,181,40,124,66,39,19,17,12,5,4,3,0,0,1
S01012485,Occupancy rating +1,66,37,14,23,28,8,19,13,3,3,1,1,0,1,1,0,0,0
S01012485,Occupancy rating 0,39,14,4,10,24,1,15,8,5,2,8,6,2,1,0,0,0,1
S01012485,Occupancy rating -1 or less,22,10,1,9,11,1,4,3,1,0,6,6,0,1,1,0,0,0
S01012486,All households,268,104,73,31,160,54,91,46,32,13,15,7,8,4,3,0,0,1
S01012486,Occupancy rating +2 or more,194,66,45,21,125,42,77,41,25,11,6,2,4,3,2,0,0,1
S01012486,Occupancy rating +1,41,22,16,6,19,7,9,4,5,0,3,1,2,0,0,0,0,0
S01012486,Occupancy rating 0,26,14,12,2,11,5,3,0,2,1,3,3,0,1,1,0,0,0
S01012486,Occupancy rating -1 or less,7,2,0,2,5,0,2,1,0,1,3,1,2,0,0,0,0,0
S01012487,All households,306,128,37,91,162,20,113,59,40,14,29,16,13,16,7,0,1,8
S01012487,Occupancy rating +2 or more,88,23,9,14,60,11,45,25,13,7,4,2,2,5,2,0,0,3
S01012487,Occupancy rating +1,97,54,15,39,40,9,28,18,8,2,3,1,2,3,2,0,0,1
S01012487,Occupancy rating 0,96,45,11,34,48,0,34,16,15,3,14,9,5,3,0,0,1,2
S01012487,Occupancy rating -1 or less,25,6,2,4,14,0,6,0,4,2,8,4,4,5,3,0,0,2
S01012488,All households,483,226,104,122,243,32,179,87,57,35,32,19,13,14,3,0,1,10
S01012488,Occupancy rating +2 or more,139,44,30,14,89,12,74,40,18,16,3,2,1,6,2,0,0,4
S01012488,Occupancy rating +1,130,53,22,31,76,13,54,28,16,10,9,4,5,1,0,0,0,1
S01012488,Occupancy rating 0,176,116,51,65,56,5,38,18,14,6,13,8,5,4,1,0,0,3
S01012488,Occupancy rating -1 or less,38,13,1,12,22,2,13,1,9,3,7,5,2,3,0,0,1,2
S01012489,All households,553,281,51,230,244,11,140,83,44,13,93,76,17,28,18,0,0,10
S01012489,Occupancy rating +2 or more,61,27,6,21,33,5,24,21,3,0,4,3,1,1,0,0,0,1
S01012489,Occupancy rating +1,160,89,14,75,66,2,44,23,15,6,20,15,5,5,2,0,0,3
S01012489,Occupancy rating 0,235,129,24,105,97,2,50,29,15,6,45,40,5,9,6,0,0,3
S01012489,Occupancy rating -1 or less,97,36,7,29,48,2,22,10,11,1,24,18,6,13,10,0,0,3
S01012490,All households,606,362,103,259,214,21,123,66,44,13,70,44,26,30,6,2,3,19
S01012490,Occupancy rating +2 or more,50,20,9,11,30,5,24,15,7,2,1,1,0,0,0,0,0,0
S01012490,Occupancy rating +1,194,137,28,109,55,9,42,34,8,0,4,2,2,2,0,1,0,1
S01012490,Occupancy rating 0,259,155,55,100,90,6,42,13,19,10,42,23,19,14,0,0,0,14
S01012490,Occupancy rating -1 or less,103,50,11,39,39,1,15,4,10,1,23,18,5,14,6,1,3,4
S01012491,All households,245,123,21,102,111,6,60,30,23,7,45,35,10,11,2,0,3,6
S01012491,Occupancy rating +2 or more,31,17,5,12,13,1,11,9,1,1,1,1,0,1,0,0,1,0
S01012491,Occupancy rating +1,90,54,6,48,34,4,18,13,3,2,12,7,5,2,0,0,0,2
S01012491,Occupancy rating 0,93,37,9,28,51,1,26,8,16,2,24,22,2,5,1,0,0,4
S01012491,Occupancy rating -1 or less,31,15,1,14,13,0,5,0,3,2,8,5,3,3,1,0,2,0
S01012492,All households,490,293,82,211,170,22,95,53,31,11,53,32,21,27,3,7,0,17
S01012492,Occupancy rating +2 or more,39,16,6,10,21,1,17,9,6,2,3,1,2,2,1,0,0,1
S01012492,Occupancy rating +1,187,132,28,104,53,9,40,34,5,1,4,2,2,2,0,2,0,0
S01012492,Occupancy rating 0,213,119,43,76,73,10,27,9,12,6,36,22,14,21,2,5,0,14
S01012492,Occupancy rating -1 or less,51,26,5,21,23,2,11,1,8,2,10,7,3,2,0,0,0,2
S01012493,All households,409,257,157,100,139,35,93,50,26,17,11,6,5,13,4,1,2,6
S01012493,Occupancy rating +2 or more,120,39,23,16,77,8,65,35,15,15,4,2,2,4,2,0,0,2
S01012493,Occupancy rating +1,32,19,2,17,12,1,8,2,5,1,3,1,2,1,0,0,1,0
S01012493,Occupancy rating 0,229,180,116,64,43,23,19,13,5,1,1,1,0,6,1,1,0,4
S01012493,Occupancy rating -1 or less,28,19,16,3,7,3,1,0,1,0,3,2,1,2,1,0,1,0
S01012494,All households,383,120,64,56,248,40,148,59,60,29,60,38,22,15,8,0,0,7
S01012494,Occupancy rating +2 or more,82,28,15,13,54,14,36,24,10,2,4,3,1,0,0,0,0,0
S01012494,Occupancy rating +1,182,79,41,38,102,23,62,31,20,11,17,10,7,1,1,0,0,0
S01012494,Occupancy rating 0,86,10,6,4,67,2,35,4,19,12,30,19,11,9,3,0,0,6
S01012494,Occupancy rating -1 or less,33,3,2,1,25,1,15,0,11,4,9,6,3,5,4,0,0,1
S01012495,All households,496,197,80,117,262,29,163,66,61,36,70,43,27,37,17,3,0,17
S01012495,Occupancy rating +2 or more,126,58,28,30,64,14,46,34,6,6,4,4,0,4,1,0,0,3
S01012495,Occupancy rating +1,131,50,20,30,77,9,49,22,12,15,19,9,10,4,2,0,0,2
S01012495,Occupancy rating 0,179,78,29,49,88,5,50,7,33,10,33,21,12,13,5,1,0,7
S01012495,Occupancy rating -1 or less,60,11,3,8,33,1,18,3,10,5,14,9,5,16,9,2,0,5
S01012496,All households,314,87,56,31,197,22,119,51,37,31,56,31,25,30,14,1,1,14
S01012496,Occupancy rating +2 or more,127,50,30,20,73,13,53,42,3,8,7,2,5,4,2,0,1,1
S01012496,Occupancy rating +1,85,23,15,8,55,7,26,5,13,8,22,10,12,7,1,0,0,6
S01012496,Occupancy rating 0,70,9,6,3,53,2,30,4,17,9,21,13,8,8,2,1,0,5
S01012496,Occupancy rating -1 or less,32,5,5,0,16,0,10,0,4,6,6,6,0,11,9,0,0,2
S01012497,All households,231,85,34,51,129,19,82,33,24,25,28,20,8,17,7,0,2,8
S01012497,Occupancy rating +2 or more,59,26,12,14,32,7,23,16,1,6,2,1,1,1,0,0,0,1
S01012497,Occupancy rating +1,92,43,12,31,45,11,30,13,8,9,4,3,1,4,0,0,2,2
S01012497,Occupancy rating 0,60,12,8,4,42,0,24,3,15,6,18,12,6,6,3,0,0,3
S01012497,Occupancy rating -1 or less,20,4,2,2,10,1,5,1,0,4,4,4,0,6,4,0,0,2
S01012498,All households,343,105,33,72,208,21,118,36,60,22,69,54,15,30,16,0,2,12
S01012498,Occupancy rating +2 or more,96,43,16,27,50,14,29,23,4,2,7,5,2,3,1,0,0,2
S01012498,Occupancy rating +1,109,44,14,30,57,5,32,9,11,12,20,14,6,8,1,0,1,6
S01012498,Occupancy rating 0,95,16,2,14,68,0,38,4,26,8,30,26,4,11,7,0,1,3
S01012498,Occupancy rating -1 or less,43,2,1,1,33,2,19,0,19,0,12,9,3,8,7,0,0,1
S01012499,All households,277,64,19,45,189,9,105,47,40,18,75,61,14,24,14,0,2,8
S01012499,Occupancy rating +2 or more,85,26,10,16,59,8,42,29,6,7,9,5,4,0,0,0,0,0
S01012499,Occupancy rating +1,84,24,6,18,50,1,32,18,11,3,17,13,4,10,3,0,2,5
S01012499,Occupancy rating 0,76,9,2,7,63,0,25,0,17,8,38,34,4,4,2,0,0,2
S01012499,Occupancy rating -1 or less,32,5,1,4,17,0,6,0,6,0,11,9,2,10,9,0,0,1
S01012500,All households,217,79,17,62,132,18,72,26,26,20,42,36,6,6,2,0,1,3
S01012500,Occupancy rating +2 or more,64,23,11,12,39,11,26,17,5,4,2,2,0,2,1,0,0,1
S01012500,Occupancy rating +1,75,36,3,33,37,5,23,9,5,9,9,5,4,2,0,0,1,1
S01012500,Occupancy rating 0,61,19,2,17,41,2,14,0,12,2,25,24,1,1,0,0,0,1
S01012500,Occupancy rating -1 or less,17,1,1,0,15,0,9,0,4,5,6,5,1,1,1,0,0,0
S01012501,All households,260,83,30,53,151,4,79,30,36,13,68,56,12,26,12,0,1,13
S01012501,Occupancy rating +2 or more,23,11,5,6,9,0,6,5,0,1,3,3,0,3,0,0,0,3
S01012501,Occupancy rating +1,90,44,17,27,44,3,30,21,5,4,11,8,3,2,1,0,0,1
S01012501,Occupancy rating 0,99,18,4,14,69,1,27,2,19,6,41,35,6,12,4,0,1,7
S01012501,Occupancy rating -1 or less,48,10,4,6,29,0,16,2,12,2,13,10,3,9,7,0,0,2
S01012502,All households,360,107,27,80,237,12,110,47,54,9,115,86,29,16,7,0,0,9
S01012502,Occupancy rating +2 or more,62,28,7,21,34,4,27,17,7,3,3,2,1,0,0,0,0,0
S01012502,Occupancy rating +1,118,64,17,47,50,6,30,23,6,1,14,9,5,4,2,0,0,2
S01012502,Occupancy rating 0,122,10,2,8,107,2,39,4,31,4,66,49,17,5,1,0,0,4
S01012502,Occupancy rating -1 or less,58,5,1,4,46,0,14,3,10,1,32,26,6,7,4,0,0,3
S01012503,All households,308,131,56,75,165,19,93,30,37,26,53,39,14,12,3,1,1,7
S01012503,Occupancy rating +2 or more,82,34,17,17,46,13,28,15,8,5,5,1,4,2,1,0,0,1
S01012503,Occupancy rating +1,77,35,10,25,36,5,20,8,5,7,11,6,5,6,1,1,1,3
S01012503,Occupancy rating 0,108,46,18,28,59,1,30,6,14,10,28,24,4,3,1,0,0,2
S01012503,Occupancy rating -1 or less,41,16,11,5,24,0,15,1,10,4,9,8,1,1,0,0,0,1
S01012504,All households,282,87,33,54,177,17,93,37,41,15,67,48,19,18,10,0,2,6
S01012504,Occupancy rating +2 or more,62,25,13,12,34,8,23,16,4,3,3,2,1,3,1,0,0,2
S01012504,Occupancy rating +1,98,35,15,20,59,9,29,11,14,4,21,15,6,4,4,0,0,0
S01012504,Occupancy rating 0,97,21,4,17,71,0,36,8,21,7,35,24,11,5,1,0,2,2
S01012504,Occupancy rating -1 or less,25,6,1,5,13,0,5,2,2,1,8,7,1,6,4,0,0,2
S01012505,All households,515,217,83,134,270,39,153,73,51,29,78,55,23,28,10,0,1,17
S01012505,Occupancy rating +2 or more,139,43,24,19,88,18,65,41,12,12,5,4,1,8,3,0,0,5
S01012505,Occupancy rating +1,161,94,35,59,62,19,33,20,9,4,10,6,4,5,2,0,1,2
S01012505,Occupancy rating 0,166,68,18,50,91,1,41,10,20,11,49,34,15,7,1,0,0,6
S01012505,Occupancy rating -1 or less,49,12,6,6,29,1,14,2,10,2,14,11,3,8,4,0,0,4
S01012506,All households,241,98,48,50,137,29,92,41,35,16,16,11,5,6,2,0,1,3
S01012506,Occupancy rating +2 or more,110,22,16,6,87,24,61,29,24,8,2,1,1,1,0,0,0,1
S01012506,Occupancy rating +1,71,42,15,27,27,4,18,7,6,5,5,1,4,2,0,0,1,1
S01012506,Occupancy rating 0,49,28,15,13,20,0,13,5,5,3,7,7,0,1,0,0,0,1
S01012506,Occupancy rating -1 or less,11,6,2,4,3,1,0,0,0,0,2,2,0,2,2,0,0,0
S01012507,All households,482,189,84,105,273,33,180,87,60,33,60,35,25,20,5,0,0,15
S01012507,Occupancy rating +2 or more,135,43,17,26,89,18,68,35,22,11,3,0,3,3,0,0,0,3
S01012507,Occupancy rating +1,200,108,47,61,89,11,64,42,13,9,14,6,8,3,0,0,0,3
S01012507,Occupancy rating 0,113,26,15,11,79,3,42,10,21,11,34,21,13,8,0,0,0,8
S01012507,Occupancy rating -1 or less,34,12,5,7,16,1,6,0,4,2,9,8,1,6,5,0,0,1
S01012508,All households,399,179,68,111,207,27,141,66,53,22,39,24,15,13,5,0,1,7
S01012508,Occupancy rating +2 or more,109,28,15,13,79,10,61,26,22,13,8,5,3,2,0,0,0,2
S01012508,Occupancy rating +1,140,79,33,46,60,12,43,26,12,5,5,3,2,1,1,0,0,0
S01012508,Occupancy rating 0,133,67,19,48,59,5,31,13,16,2,23,13,10,7,3,0,0,4
S01012508,Occupancy rating -1 or less,17,5,1,4,9,0,6,1,3,2,3,3,0,3,1,0,1,1
S01012509,All households,256,98,55,43,146,22,100,39,42,19,24,10,14,12,3,0,1,8
S01012509,Occupancy rating +2 or more,124,31,20,11,87,14,68,28,28,12,5,0,5,6,3,0,1,2
S01012509,Occupancy rating +1,90,54,30,24,35,8,19,10,6,3,8,3,5,1,0,0,0,1
S01012509,Occupancy rating 0,34,11,5,6,19,0,10,1,7,2,9,7,2,4,0,0,0,4
S01012509,Occupancy rating -1 or less,8,2,0,2,5,0,3,0,1,2,2,0,2,1,0,0,0,1
S01012510,All households,381,110,39,71,263,40,190,69,92,29,33,21,12,8,3,0,0,5
S01012510,Occupancy rating +2 or more,169,39,19,20,127,26,96,45,38,13,5,5,0,3,2,0,0,1
S01012510,Occupancy rating +1,133,52,16,36,79,14,55,20,23,12,10,7,3,2,0,0,0,2
S01012510,Occupancy rating 0,69,19,4,15,48,0,32,4,24,4,16,7,9,2,0,0,0,2
S01012510,Occupancy rating -1 or less,10,0,0,0,9,0,7,0,7,0,2,2,0,1,1,0,0,0
S01012511,All households,316,129,46,83,176,18,137,68,44,25,21,13,8,11,1,0,2,8
S01012511,Occupancy rating +2 or more,108,35,21,14,71,8,58,37,12,9,5,4,1,2,1,0,0,1
S01012511,Occupancy rating +1,95,43,15,28,51,3,44,23,12,9,4,1,3,1,0,0,0,1
S01012511,Occupancy rating 0,90,44,9,35,40,7,25,6,15,4,8,5,3,6,0,0,2,4
S01012511,Occupancy rating -1 or less,23,7,1,6,14,0,10,2,5,3,4,3,1,2,0,0,0,2
S01012512,All households,286,87,30,57,186,19,129,44,66,19,38,29,9,13,6,0,0,7
S01012512,Occupancy rating +2 or more,131,40,21,19,86,16,67,31,25,11,3,2,1,5,2,0,0,3
S01012512,Occupancy rating +1,66,22,5,17,43,2,35,11,21,3,6,6,0,1,0,0,0,1
S01012512,Occupancy rating 0,70,21,3,18,45,1,20,2,14,4,24,17,7,4,1,0,0,3
S01012512,Occupancy rating -1 or less,19,4,1,3,12,0,7,0,6,1,5,4,1,3,3,0,0,0
S01012513,All households,234,57,21,36,172,17,128,60,51,17,27,21,6,5,4,0,1,0
S01012513,Occupancy rating +2 or more,132,34,11,23,95,13,77,45,24,8,5,3,2,3,2,0,1,0
S01012513,Occupancy rating +1,60,14,5,9,45,2,34,9,18,7,9,6,3,1,1,0,0,0
S01012513,Occupancy rating 0,32,9,5,4,22,2,14,5,8,1,6,6,0,1,1,0,0,0
S01012513,Occupancy rating -1 or less,10,0,0,0,10,0,3,1,1,1,7,6,1,0,0,0,0,0
S01012514,All households,392,84,13,71,300,14,231,73,135,23,55,45,10,8,2,1,0,5
S01012514,Occupancy rating +2 or more,185,29,7,22,153,5,135,44,80,11,13,11,2,3,1,0,0,2
S01012514,Occupancy rating +1,124,47,6,41,75,7,56,28,24,4,12,10,2,2,0,1,0,1
S01012514,Occupancy rating 0,73,7,0,7,63,1,36,1,28,7,26,21,5,3,1,0,0,2
S01012514,Occupancy rating -1 or less,10,1,0,1,9,1,4,0,3,1,4,3,1,0,0,0,0,0
S01012515,All households,319,150,80,70,156,25,94,41,33,20,37,21,16,13,7,0,2,4
S01012515,Occupancy rating +2 or more,63,24,10,14,37,8,26,16,5,5,3,2,1,2,1,0,0,1
S01012515,Occupancy rating +1,76,28,5,23,45,7,29,15,7,7,9,3,6,3,1,0,1,1
S01012515,Occupancy rating 0,144,85,55,30,53,7,28,8,14,6,18,12,6,6,3,0,1,2
S01012515,Occupancy rating -1 or less,36,13,10,3,21,3,11,2,7,2,7,4,3,2,2,0,0,0
S01012516,All households,301,85,46,39,212,40,126,47,59,20,46,33,13,4,3,0,0,1
S01012516,Occupancy rating +2 or more,119,25,11,14,93,27,56,24,23,9,10,7,3,1,1,0,0,0
S01012516,Occupancy rating +1,81,28,14,14,53,7,36,16,15,5,10,5,5,0,0,0,0,0
S01012516,Occupancy rating 0,86,31,20,11,52,6,26,6,14,6,20,15,5,3,2,0,0,1
S01012516,Occupancy rating -1 or less,15,1,1,0,14,0,8,1,7,0,6,6,0,0,0,0,0,0
S01012517,All households,410,167,61,106,234,24,159,56,79,24,51,35,16,9,3,0,0,6
S01012517,Occupancy rating +2 or more,98,22,5,17,74,9,59,19,31,9,6,4,2,2,1,0,0,1
S01012517,Occupancy rating +1,104,55,26,29,49,9,36,19,13,4,4,2,2,0,0,0,0,0
S01012517,Occupancy rating 0,173,79,24,55,90,4,54,16,29,9,32,22,10,4,1,0,0,3
S01012517,Occupancy rating -1 or less,35,11,6,5,21,2,10,2,6,2,9,7,2,3,1,0,0,2
S01012518,All households,277,113,53,60,160,32,109,49,46,14,19,11,8,4,1,0,0,3
S01012518,Occupancy rating +2 or more,139,40,23,17,96,29,64,31,25,8,3,1,2,3,1,0,0,2
S01012518,Occupancy rating +1,71,35,17,18,35,2,29,14,13,2,4,1,3,1,0,0,0,1
S01012518,Occupancy rating 0,51,32,10,22,19,1,10,1,5,4,8,7,1,0,0,0,0,0
S01012518,Occupancy rating -1 or less,16,6,3,3,10,0,6,3,3,0,4,2,2,0,0,0,0,0
S01012519,All households,279,133,68,65,133,31,84,48,27,9,18,13,5,13,6,0,1,6
S01012519,Occupancy rating +2 or more,104,34,21,13,65,18,43,27,13,3,4,3,1,5,2,0,0,3
S01012519,Occupancy rating +1,70,42,17,25,25,2,22,12,5,5,1,1,0,3,1,0,1,1
S01012519,Occupancy rating 0,84,47,27,20,34,9,16,8,8,0,9,6,3,3,1,0,0,2
S01012519,Occupancy rating -1 or less,21,10,3,7,9,2,3,1,1,1,4,3,1,2,2,0,0,0
S01012520,All households,345,97,70,27,227,43,163,71,63,29,21,9,12,21,2,0,5,14
S01012520,Occupancy rating +2 or more,212,29,19,10,173,29,132,61,48,23,12,5,7,10,2,0,4,4
S01012520,Occupancy rating +1,56,27,16,11,25,6,15,6,6,3,4,3,1,4,0,0,0,4
S01012520,Occupancy rating 0,60,34,31,3,20,6,12,4,6,2,2,1,1,6,0,0,0,6
S01012520,Occupancy rating -1 or less,17,7,4,3,9,2,4,0,3,1,3,0,3,1,0,0,1,0
S01012521,All households,270,126,52,74,130,24,86,46,33,7,20,13,7,14,0,0,0,14
S01012521,Occupancy rating +2 or more,113,39,28,11,67,14,49,25,22,2,4,3,1,7,0,0,0,7
S01012521,Occupancy rating +1,70,40,15,25,30,8,18,11,4,3,4,1,3,0,0,0,0,0
S01012521,Occupancy rating 0,70,40,6,34,25,2,16,10,5,1,7,6,1,5,0,0,0,5
S01012521,Occupancy rating -1 or less,17,7,3,4,8,0,3,0,2,1,5,3,2,2,0,0,0,2
S01012522,All households,360,84,48,36,265,57,193,81,72,40,15,9,6,11,5,0,1,5
S01012522,Occupancy rating +2 or more,278,58,37,21,214,50,154,74,48,32,10,5,5,6,2,0,1,3
S01012522,Occupancy rating +1,57,17,10,7,37,7,28,6,17,5,2,1,1,3,2,0,0,1
S01012522,Occupancy rating 0,16,5,1,4,10,0,9,1,6,2,1,1,0,1,0,0,0,1
S01012522,Occupancy rating -1 or less,9,4,0,4,4,0,2,0,1,1,2,2,0,1,1,0,0,0
S01012523,All households,385,113,70,43,256,48,172,71,68,33,36,12,24,16,3,0,2,11
S01012523,Occupancy rating +2 or more,232,65,42,23,159,38,113,60,34,19,8,2,6,8,0,0,2,6
S01012523,Occupancy rating +1,91,36,20,16,52,6,33,10,15,8,13,3,10,3,1,0,0,2
S01012523,Occupancy rating 0,50,12,8,4,36,3,23,1,17,5,10,5,5,2,0,0,0,2
S01012523,Occupancy rating -1 or less,12,0,0,0,9,1,3,0,2,1,5,2,3,3,2,0,0,1
S01012524,All households,467,218,139,79,241,62,164,84,55,25,15,8,7,8,1,0,3,4
S01012524,Occupancy rating +2 or more,241,92,63,29,147,39,105,61,35,9,3,1,2,2,0,0,2,0
S01012524,Occupancy rating +1,123,61,43,18,60,18,35,18,11,6,7,2,5,2,1,0,0,1
S01012524,Occupancy rating 0,82,56,29,27,24,4,17,4,5,8,3,3,0,2,0,0,0,2
S01012524,Occupancy rating -1 or less,21,9,4,5,10,1,7,1,4,2,2,2,0,2,0,0,1,1
S01012525,All households,341,118,59,59,215,27,174,88,57,29,14,9,5,8,3,0,0,5
S01012525,Occupancy rating +2 or more,200,55,31,24,141,20,119,65,35,19,2,1,1,4,0,0,0,4
S01012525,Occupancy rating +1,84,38,18,20,45,4,37,16,15,6,4,4,0,1,1,0,0,0
S01012525,Occupancy rating 0,50,22,8,14,26,3,17,7,6,4,6,2,4,2,1,0,0,1
S01012525,Occupancy rating -1 or less,7,3,2,1,3,0,1,0,1,0,2,2,0,1,1,0,0,0
S01012526,All households,334,83,61,22,241,60,161,66,67,28,20,9,11,10,4,0,0,6
S01012526,Occupancy rating +2 or more,229,46,39,7,180,51,118,55,47,16,11,5,6,3,1,0,0,2
S01012526,Occupancy rating +1,77,32,19,13,41,8,28,11,11,6,5,1,4,4,2,0,0,2
S01012526,Occupancy rating 0,23,4,2,2,17,0,13,0,8,5,4,3,1,2,0,0,0,2
S01012526,Occupancy rating -1 or less,5,1,1,0,3,1,2,0,1,1,0,0,0,1,1,0,0,0
S01012527,All households,285,77,40,37,202,50,130,67,45,18,22,7,15,6,3,0,0,3
S01012527,Occupancy rating +2 or more,175,41,22,19,133,43,86,58,20,8,4,0,4,1,0,0,0,1
S01012527,Occupancy rating +1,63,27,14,13,34,6,25,9,11,5,3,2,1,2,0,0,0,2
S01012527,Occupancy rating 0,36,9,4,5,26,1,15,0,11,4,10,2,8,1,1,0,0,0
S01012527,Occupancy rating -1 or less,11,0,0,0,9,0,4,0,3,1,5,3,2,2,2,0,0,0
S01012528,All households,337,95,35,60,220,22,144,50,67,27,54,30,24,22,12,0,2,8
S01012528,Occupancy rating +2 or more,105,31,14,17,72,7,52,31,18,3,13,6,7,2,1,0,0,1
S01012528,Occupancy rating +1,126,41,13,28,76,10,50,14,24,12,16,7,9,9,4,0,1,4
S01012528,Occupancy rating 0,75,17,8,9,53,4,31,5,15,11,18,12,6,5,2,0,1,2
S01012528,Occupancy rating -1 or less,31,6,0,6,19,1,11,0,10,1,7,5,2,6,5,0,0,1
S01012529,All households,342,131,59,72,207,25,135,54,49,32,47,34,13,4,2,0,2,0
S01012529,Occupancy rating +2 or more,142,43,22,21,98,19,72,33,25,14,7,4,3,1,0,0,1,0
S01012529,Occupancy rating +1,87,46,27,19,40,5,27,10,8,9,8,8,0,1,0,0,1,0
S01012529,Occupancy rating 0,86,37,8,29,48,1,26,10,9,7,21,15,6,1,1,0,0,0
S01012529,Occupancy rating -1 or less,27,5,2,3,21,0,10,1,7,2,11,7,4,1,1,0,0,0
S01012530,All households,400,126,87,39,267,65,183,76,66,41,19,9,10,7,1,0,0,6
S01012530,Occupancy rating +2 or more,258,77,53,24,179,55,117,63,32,22,7,2,5,2,0,0,0,2
S01012530,Occupancy rating +1,85,28,22,6,54,9,37,9,18,10,8,4,4,3,0,0,0,3
S01012530,Occupancy rating 0,45,19,10,9,26,1,24,3,12,9,1,0,1,0,0,0,0,0
S01012530,Occupancy rating -1 or less,12,2,2,0,8,0,5,1,4,0,3,3,0,2,1,0,0,1
S01012531,All households,332,98,42,56,222,34,158,65,74,19,30,20,10,12,7,0,0,5
S01012531,Occupancy rating +2 or more,184,49,23,26,131,29,96,48,40,8,6,5,1,4,2,0,0,2
S01012531,Occupancy rating +1,101,39,18,21,59,4,42,15,22,5,13,6,7,3,2,0,0,1
S01012531,Occupancy rating 0,38,10,1,9,24,1,17,2,9,6,6,4,2,4,3,0,0,1
S01012531,Occupancy rating -1 or less,9,0,0,0,8,0,3,0,3,0,5,5,0,1,0,0,0,1
S01012532,All households,348,94,50,44,246,44,175,74,76,25,27,16,11,8,2,0,1,5
S01012532,Occupancy rating +2 or more,182,47,27,20,132,26,99,60,31,8,7,4,3,3,0,0,1,2
S01012532,Occupancy rating +1,81,21,8,13,58,12,38,10,17,11,8,4,4,2,0,0,0,2
S01012532,Occupancy rating 0,73,22,12,10,49,5,34,4,24,6,10,7,3,2,1,0,0,1
S01012532,Occupancy rating -1 or less,12,4,3,1,7,1,4,0,4,0,2,1,1,1,1,0,0,0
S01012533,All households,274,115,47,68,147,28,96,48,30,18,23,12,11,12,2,0,1,9
S01012533,Occupancy rating +2 or more,69,20,9,11,47,10,34,20,9,5,3,1,2,2,1,0,0,1
S01012533,Occupancy rating +1,144,80,27,53,63,15,42,27,10,5,6,2,4,1,0,0,0,1
S01012533,Occupancy rating 0,50,12,9,3,29,3,15,0,9,6,11,7,4,9,1,0,1,7
S01012533,Occupancy rating -1 or less,11,3,2,1,8,0,5,1,2,2,3,2,1,0,0,0,0,0
S01012534,All households,288,129,64,65,151,20,101,44,41,16,30,16,14,8,3,0,1,4
S01012534,Occupancy rating +2 or more,79,24,16,8,53,11,38,22,10,6,4,0,4,2,2,0,0,0
S01012534,Occupancy rating +1,88,44,16,28,41,4,31,18,9,4,6,3,3,3,0,0,0,3
S01012534,Occupancy rating 0,91,51,29,22,39,4,23,4,16,3,12,8,4,1,0,0,0,1
S01012534,Occupancy rating -1 or less,30,10,3,7,18,1,9,0,6,3,8,5,3,2,1,0,1,0
S01012535,All households,361,117,61,56,218,26,151,55,69,27,41,25,16,26,16,0,1,9
S01012535,Occupancy rating +2 or more,100,33,20,13,66,15,50,30,15,5,1,1,0,1,1,0,0,0
S01012535,Occupancy rating +1,135,61,29,32,67,8,47,20,20,7,12,6,6,7,3,0,0,4
S01012535,Occupancy rating 0,98,19,10,9,70,3,49,4,33,12,18,10,8,9,4,0,1,4
S01012535,Occupancy rating -1 or less,28,4,2,2,15,0,5,1,1,3,10,8,2,9,8,0,0,1
S01012536,All households,312,80,33,47,221,34,137,52,56,29,50,34,16,11,4,0,0,7
S01012536,Occupancy rating +2 or more,126,41,21,20,82,26,51,35,9,7,5,3,2,3,0,0,0,3
S01012536,Occupancy rating +1,91,25,8,17,66,7,42,14,16,12,17,10,7,0,0,0,0,0
S01012536,Occupancy rating 0,73,11,2,9,57,1,33,3,23,7,23,17,6,5,1,0,0,4
S01012536,Occupancy rating -1 or less,22,3,2,1,16,0,11,0,8,3,5,4,1,3,3,0,0,0
S01012537,All households,334,107,52,55,214,28,142,56,51,35,44,24,20,13,1,7,0,5
S01012537,Occupancy rating +2 or more,81,30,15,15,51,9,40,28,7,5,2,1,1,0,0,0,0,0
S01012537,Occupancy rating +1,121,35,16,19,82,10,54,24,16,14,18,9,9,4,0,2,0,2
S01012537,Occupancy rating 0,106,33,15,18,67,9,40,3,22,15,18,12,6,6,1,4,0,1
S01012537,Occupancy rating -1 or less,26,9,6,3,14,0,8,1,6,1,6,2,4,3,0,1,0,2
S01012538,All households,476,135,54,81,327,48,195,74,95,26,84,59,25,14,6,0,1,7
S01012538,Occupancy rating +2 or more,165,51,24,27,112,25,78,46,27,5,9,5,4,2,1,0,0,1
S01012538,Occupancy rating +1,150,58,24,34,88,16,56,26,22,8,16,8,8,4,1,0,1,2
S01012538,Occupancy rating 0,125,18,2,16,101,7,45,1,35,9,49,37,12,6,4,0,0,2
S01012538,Occupancy rating -1 or less,36,8,4,4,26,0,16,1,11,4,10,9,1,2,0,0,0,2
S01012539,All households,315,100,50,50,197,32,129,50,49,30,36,19,17,18,10,1,0,7
S01012539,Occupancy rating +2 or more,138,46,20,26,87,22,61,28,22,11,4,2,2,5,4,0,0,1
S01012539,Occupancy rating +1,96,36,22,14,58,9,36,18,9,9,13,5,8,2,1,0,0,1
S01012539,Occupancy rating 0,59,13,6,7,40,0,23,4,12,7,17,12,5,6,1,1,0,4
S01012539,Occupancy rating -1 or less,22,5,2,3,12,1,9,0,6,3,2,0,2,5,4,0,0,1
S01012540,All households,299,93,47,46,198,21,133,38,60,35,44,28,16,8,4,0,0,4
S01012540,Occupancy rating +2 or more,93,36,16,20,56,15,38,24,9,5,3,2,1,1,0,0,0,1
S01012540,Occupancy rating +1,109,38,19,19,69,4,47,12,19,16,18,10,8,2,0,0,0,2
S01012540,Occupancy rating 0,77,16,10,6,58,2,37,2,26,9,19,13,6,3,2,0,0,1
S01012540,Occupancy rating -1 or less,20,3,2,1,15,0,11,0,6,5,4,3,1,2,2,0,0,0
S01012541,All households,442,111,41,70,308,34,222,90,94,38,52,30,22,23,8,0,3,12
S01012541,Occupancy rating +2 or more,203,33,12,21,158,22,127,58,49,20,9,4,5,12,2,0,2,8
S01012541,Occupancy rating +1,120,47,20,27,71,10,53,27,16,10,8,2,6,2,1,0,0,1
S01012541,Occupancy rating 0,89,21,6,15,64,0,33,4,23,6,31,21,10,4,1,0,0,3
S01012541,Occupancy rating -1 or less,30,10,3,7,15,2,9,1,6,2,4,3,1,5,4,0,1,0
S01012542,All households,380,102,57,45,261,51,172,69,77,26,38,19,19,17,5,0,5,7
S01012542,Occupancy rating +2 or more,217,62,38,24,152,36,106,56,38,12,10,4,6,3,0,0,1,2
S01012542,Occupancy rating +1,88,22,10,12,61,15,34,10,18,6,12,3,9,5,0,0,2,3
S01012542,Occupancy rating 0,54,14,9,5,37,0,24,2,16,6,13,9,4,3,0,0,1,2
S01012542,Occupancy rating -1 or less,21,4,0,4,11,0,8,1,5,2,3,3,0,6,5,0,1,0
S01012543,All households,276,54,22,32,214,26,160,70,71,19,28,16,12,8,4,0,0,4
S01012543,Occupancy rating +2 or more,179,37,17,20,139,21,110,63,39,8,8,5,3,3,1,0,0,2
S01012543,Occupancy rating +1,51,12,2,10,38,5,23,4,15,4,10,7,3,1,0,0,0,1
S01012543,Occupancy rating 0,35,5,3,2,28,0,19,2,11,6,9,3,6,2,2,0,0,0
S01012543,Occupancy rating -1 or less,11,0,0,0,9,0,8,1,6,1,1,1,0,2,1,0,0,1
S01012544,All households,341,88,31,57,240,32,171,74,75,22,37,33,4,13,6,1,2,4
S01012544,Occupancy rating +2 or more,180,41,18,23,132,24,103,55,40,8,5,3,2,7,4,0,1,2
S01012544,Occupancy rating +1,84,26,9,17,58,7,40,16,16,8,11,10,1,0,0,0,0,0
S01012544,Occupancy rating 0,60,20,4,16,37,1,21,2,15,4,15,14,1,3,0,0,1,2
S01012544,Occupancy rating -1 or less,17,1,0,1,13,0,7,1,4,2,6,6,0,3,2,1,0,0
S01012545,All households,214,73,47,26,136,9,99,42,42,15,28,19,9,5,2,0,0,3
S01012545,Occupancy rating +2 or more,78,21,8,13,57,2,49,27,16,6,6,2,4,0,0,0,0,0
S01012545,Occupancy rating +1,42,17,11,6,24,5,17,8,5,4,2,1,1,1,0,0,0,1
S01012545,Occupancy rating 0,71,23,18,5,45,2,26,6,16,4,17,14,3,3,1,0,0,2
S01012545,Occupancy rating -1 or less,23,12,10,2,10,0,7,1,5,1,3,2,1,1,1,0,0,0
S01012546,All households,322,65,32,33,248,33,172,64,77,31,43,31,12,9,4,0,0,5
S01012546,Occupancy rating +2 or more,167,45,24,21,118,26,87,50,27,10,5,4,1,4,1,0,0,3
S01012546,Occupancy rating +1,88,13,5,8,73,5,50,13,22,15,18,12,6,2,1,0,0,1
S01012546,Occupancy rating 0,59,5,1,4,52,2,31,1,24,6,19,14,5,2,1,0,0,1
S01012546,Occupancy rating -1 or less,8,2,2,0,5,0,4,0,4,0,1,1,0,1,1,0,0,0
S01012547,All households,312,77,47,30,228,47,162,67,64,31,19,8,11,7,2,0,1,4
S01012547,Occupancy rating +2 or more,212,50,30,20,160,39,115,61,36,18,6,1,5,2,0,0,1,1
S01012547,Occupancy rating +1,56,16,10,6,38,6,29,4,17,8,3,0,3,2,1,0,0,1
S01012547,Occupancy rating 0,31,8,6,2,21,2,11,2,6,3,8,5,3,2,1,0,0,1
S01012547,Occupancy rating -1 or less,13,3,1,2,9,0,7,0,5,2,2,2,0,1,0,0,0,1
S01012548,All households,394,138,76,62,247,51,180,77,66,37,16,7,9,9,4,0,0,5
S01012548,Occupancy rating +2 or more,240,76,47,29,159,37,119,56,39,24,3,0,3,5,3,0,0,2
S01012548,Occupancy rating +1,96,44,20,24,51,13,34,13,12,9,4,2,2,1,1,0,0,0
S01012548,Occupancy rating 0,53,18,9,9,32,0,23,7,12,4,9,5,4,3,0,0,0,3
S01012548,Occupancy rating -1 or less,5,0,0,0,5,1,4,1,3,0,0,0,0,0,0,0,0,0
S01012549,All households,251,90,37,53,153,15,94,39,41,14,44,28,16,8,4,0,0,4
S01012549,Occupancy rating +2 or more,63,31,15,16,29,5,23,18,5,0,1,1,0,3,1,0,0,2
S01012549,Occupancy rating +1,104,46,11,35,56,6,43,20,16,7,7,6,1,2,0,0,0,2
S01012549,Occupancy rating 0,62,11,10,1,51,3,20,1,13,6,28,17,11,0,0,0,0,0
S01012549,Occupancy rating -1 or less,22,2,1,1,17,1,8,0,7,1,8,4,4,3,3,0,0,0
S01012550,All households,345,87,52,35,244,27,154,63,62,29,63,42,21,14,7,0,3,4
S01012550,Occupancy rating +2 or more,173,51,28,23,119,20,88,50,23,15,11,7,4,3,0,0,1,2
S01012550,Occupancy rating +1,94,23,13,10,67,4,45,11,26,8,18,7,11,4,1,0,1,2
S01012550,Occupancy rating 0,58,10,8,2,44,3,15,1,8,6,26,20,6,4,3,0,1,0
S01012550,Occupancy rating -1 or less,20,3,3,0,14,0,6,1,5,0,8,8,0,3,3,0,0,0
S01012551,All households,319,57,29,28,247,42,185,67,77,41,20,12,8,15,7,0,2,6
S01012551,Occupancy rating +2 or more,215,40,20,20,167,38,123,62,38,23,6,2,4,8,2,0,1,5
S01012551,Occupancy rating +1,70,13,7,6,55,4,44,5,24,15,7,6,1,2,2,0,0,0
S01012551,Occupancy rating 0,28,3,2,1,21,0,15,0,12,3,6,3,3,4,3,0,0,1
S01012551,Occupancy rating -1 or less,6,1,0,1,4,0,3,0,3,0,1,1,0,1,0,0,1,0
S01012552,All households,352,53,32,21,291,49,225,88,91,46,17,11,6,8,3,0,0,5
S01012552,Occupancy rating +2 or more,243,31,18,13,207,38,162,76,59,27,7,5,2,5,2,0,0,3
S01012552,Occupancy rating +1,76,16,12,4,60,10,44,9,20,15,6,3,3,0,0,0,0,0
S01012552,Occupancy rating 0,26,6,2,4,18,1,15,3,8,4,2,2,0,2,0,0,0,2
S01012552,Occupancy rating -1 or less,7,0,0,0,6,0,4,0,4,0,2,1,1,1,1,0,0,0
S01012553,All households,347,90,23,67,251,14,205,85,103,17,32,23,9,6,2,0,0,4
S01012553,Occupancy rating +2 or more,195,35,11,24,158,9,143,65,67,11,6,6,0,2,1,0,0,1
S01012553,Occupancy rating +1,96,36,9,27,57,5,42,15,23,4,10,7,3,3,1,0,0,2
S01012553,Occupancy rating 0,51,16,2,14,34,0,20,5,13,2,14,9,5,1,0,0,0,1
S01012553,Occupancy rating -1 or less,5,3,1,2,2,0,0,0,0,0,2,1,1,0,0,0,0,0
S01012554,All households,190,41,14,27,143,29,99,42,39,18,15,11,4,6,3,0,1,2
S01012554,Occupancy rating +2 or more,109,26,9,17,83,21,58,33,16,9,4,4,0,0,0,0,0,0
S01012554,Occupancy rating +1,50,14,5,9,33,8,22,8,9,5,3,0,3,3,2,0,0,1
S01012554,Occupancy rating 0,19,0,0,0,17,0,15,0,13,2,2,2,0,2,0,0,1,1
S01012554,Occupancy rating -1 or less,12,1,0,1,10,0,4,1,1,2,6,5,1,1,1,0,0,0
S01012555,All households,211,40,13,27,164,20,130,49,63,18,14,9,5,7,2,1,0,4
S01012555,Occupancy rating +2 or more,144,33,11,22,109,15,90,47,32,11,4,2,2,2,0,0,0,2
S01012555,Occupancy rating +1,47,6,1,5,40,4,31,1,25,5,5,3,2,1,1,0,0,0
S01012555,Occupancy rating 0,17,1,1,0,12,1,6,1,5,0,5,4,1,4,1,1,0,2
S01012555,Occupancy rating -1 or less,3,0,0,0,3,0,3,0,1,2,0,0,0,0,0,0,0,0
S01012556,All households,221,38,26,12,182,31,139,59,49,31,12,4,8,1,1,0,0,0
S01012556,Occupancy rating +2 or more,187,34,23,11,152,29,116,57,34,25,7,2,5,1,1,0,0,0
S01012556,Occupancy rating +1,20,3,2,1,17,2,14,1,11,2,1,0,1,0,0,0,0,0
S01012556,Occupancy rating 0,12,1,1,0,11,0,8,1,3,4,3,1,2,0,0,0,0,0
S01012556,Occupancy rating -1 or less,2,0,0,0,2,0,1,0,1,0,1,1,0,0,0,0,0,0
S01012557,All households,249,42,28,14,190,41,134,58,49,27,15,4,11,17,9,1,0,7
S01012557,Occupancy rating +2 or more,198,34,25,9,154,40,106,52,30,24,8,1,7,10,4,0,0,6
S01012557,Occupancy rating +1,25,7,3,4,18,1,15,5,8,2,2,1,1,0,0,0,0,0
S01012557,Occupancy rating 0,17,1,0,1,14,0,9,1,8,0,5,2,3,2,1,1,0,0
S01012557,Occupancy rating -1 or less,9,0,0,0,4,0,4,0,3,1,0,0,0,5,4,0,0,1
S01012558,All households,279,106,34,72,160,14,100,41,41,18,46,24,22,13,8,0,0,5
S01012558,Occupancy rating +2 or more,65,27,10,17,38,6,28,17,7,4,4,3,1,0,0,0,0,0
S01012558,Occupancy rating +1,93,39,18,21,50,8,29,19,5,5,13,4,9,4,1,0,0,3
S01012558,Occupancy rating 0,95,31,5,26,60,0,36,4,24,8,24,12,12,4,3,0,0,1
S01012558,Occupancy rating -1 or less,26,9,1,8,12,0,7,1,5,1,5,5,0,5,4,0,0,1
S01012559,All households,457,257,118,139,191,42,107,52,40,15,42,32,10,9,4,0,0,5
S01012559,Occupancy rating +2 or more,50,19,7,12,30,5,21,17,2,2,4,4,0,1,0,0,0,1
S01012559,Occupancy rating +1,145,92,38,54,53,21,27,21,4,2,5,3,2,0,0,0,0,0
S01012559,Occupancy rating 0,211,126,66,60,81,13,42,13,23,6,26,22,4,4,1,0,0,3
S01012559,Occupancy rating -1 or less,51,20,7,13,27,3,17,1,11,5,7,3,4,4,3,0,0,1
S01012560,All households,264,98,62,36,163,41,96,37,49,10,26,17,9,3,3,0,0,0
S01012560,Occupancy rating +2 or more,101,36,17,19,65,25,37,20,13,4,3,2,1,0,0,0,0,0
S01012560,Occupancy rating +1,82,25,14,11,57,10,37,14,19,4,10,6,4,0,0,0,0,0
S01012560,Occupancy rating 0,73,36,30,6,35,4,20,3,15,2,11,7,4,2,2,0,0,0
S01012560,Occupancy rating -1 or less,8,1,1,0,6,2,2,0,2,0,2,2,0,1,1,0,0,0
S01012561,All households,365,146,76,70,215,35,138,57,68,13,42,26,16,4,2,0,1,1
S01012561,Occupancy rating +2 or more,123,31,12,19,91,18,65,33,28,4,8,6,2,1,1,0,0,0
S01012561,Occupancy rating +1,110,44,23,21,66,12,43,15,21,7,11,5,6,0,0,0,0,0
S01012561,Occupancy rating 0,115,64,39,25,50,4,26,8,16,2,20,13,7,1,1,0,0,0
S01012561,Occupancy rating -1 or less,17,7,2,5,8,1,4,1,3,0,3,2,1,2,0,0,1,1
S01012562,All households,434,217,75,142,207,28,126,71,44,11,53,35,18,10,1,0,0,9
S01012562,Occupancy rating +2 or more,73,27,11,16,44,12,27,16,8,3,5,2,3,2,0,0,0,2
S01012562,Occupancy rating +1,137,81,33,48,56,9,33,21,9,3,14,6,8,0,0,0,0,0
S01012562,Occupancy rating 0,176,90,25,65,80,7,54,28,23,3,19,15,4,6,0,0,0,6
S01012562,Occupancy rating -1 or less,48,19,6,13,27,0,12,6,4,2,15,12,3,2,1,0,0,1
S01012563,All households,271,62,48,14,197,54,134,59,47,28,9,2,7,12,4,1,2,5
S01012563,Occupancy rating +2 or more,235,52,41,11,174,51,116,56,35,25,7,2,5,9,3,0,2,4
S01012563,Occupancy rating +1,21,7,5,2,13,3,9,1,5,3,1,0,1,1,0,0,0,1
S01012563,Occupancy rating 0,10,1,0,1,8,0,7,2,5,0,1,0,1,1,1,0,0,0
S01012563,Occupancy rating -1 or less,5,2,2,0,2,0,2,0,2,0,0,0,0,1,0,1,0,0
S01012564,All households,373,112,73,39,250,57,172,72,70,30,21,10,11,11,3,0,4,4
S01012564,Occupancy rating +2 or more,268,72,51,21,190,47,132,64,46,22,11,6,5,6,1,0,4,1
S01012564,Occupancy rating +1,68,29,18,11,36,8,22,7,11,4,6,1,5,3,1,0,0,2
S01012564,Occupancy rating 0,29,9,4,5,19,2,14,1,9,4,3,2,1,1,1,0,0,0
S01012564,Occupancy rating -1 or less,8,2,0,2,5,0,4,0,4,0,1,1,0,1,0,0,0,1
S01012565,All households,379,153,100,53,208,52,133,65,57,11,23,12,11,18,6,0,3,9
S01012565,Occupancy rating +2 or more,193,49,33,16,138,25,100,46,44,10,13,5,8,6,2,0,0,4
S01012565,Occupancy rating +1,65,32,19,13,31,13,14,11,3,0,4,2,2,2,1,0,0,1
S01012565,Occupancy rating 0,92,53,31,22,31,11,15,7,7,1,5,4,1,8,1,0,3,4
S01012565,Occupancy rating -1 or less,29,19,17,2,8,3,4,1,3,0,1,1,0,2,2,0,0,0
S01012566,All households,445,252,88,164,180,35,110,69,33,8,35,26,9,13,0,0,4,9
S01012566,Occupancy rating +2 or more,131,62,26,36,67,20,41,29,11,1,6,4,2,2,0,0,1,1
S01012566,Occupancy rating +1,101,56,16,40,43,8,33,20,7,6,2,1,1,2,0,0,0,2
S01012566,Occupancy rating 0,169,108,37,71,54,6,29,18,10,1,19,14,5,7,0,0,2,5
S01012566,Occupancy rating -1 or less,44,26,9,17,16,1,7,2,5,0,8,7,1,2,0,0,1,1
S01012567,All households,557,267,90,177,268,38,169,96,59,14,61,45,16,22,4,0,2,16
S01012567,Occupancy rating +2 or more,112,35,14,21,72,6,53,32,16,5,13,8,5,5,1,0,1,3
S01012567,Occupancy rating +1,197,107,30,77,85,18,60,43,14,3,7,6,1,5,2,0,1,2
S01012567,Occupancy rating 0,210,113,42,71,88,12,47,18,24,5,29,22,7,9,0,0,0,9
S01012567,Occupancy rating -1 or less,38,12,4,8,23,2,9,3,5,1,12,9,3,3,1,0,0,2
S01012568,All households,281,90,49,41,180,51,117,49,54,14,12,8,4,11,4,0,1,6
S01012568,Occupancy rating +2 or more,192,40,25,15,146,36,104,43,49,12,6,4,2,6,2,0,0,4
S01012568,Occupancy rating +1,36,15,7,8,19,8,10,6,2,2,1,0,1,2,0,0,1,1
S01012568,Occupancy rating 0,41,23,15,8,15,7,3,0,3,0,5,4,1,3,2,0,0,1
S01012568,Occupancy rating -1 or less,12,12,2,10,0,0,0,0,0,0,0,0,0,0,0,0,0,0
S01012569,All households,315,81,51,30,223,61,145,59,56,30,17,7,10,11,4,1,0,6
S01012569,Occupancy rating +2 or more,255,64,40,24,184,55,118,53,39,26,11,4,7,7,3,1,0,3
S01012569,Occupancy rating +1,43,13,10,3,28,5,20,6,13,1,3,1,2,2,1,0,0,1
S01012569,Occupancy rating 0,10,4,1,3,6,0,4,0,3,1,2,2,0,0,0,0,0,0
S01012569,Occupancy rating -1 or less,7,0,0,0,5,1,3,0,1,2,1,0,1,2,0,0,0,2
S01012570,All households,197,53,23,30,131,13,108,54,38,16,10,8,2,13,5,0,1,7
S01012570,Occupancy rating +2 or more,107,19,10,9,83,10,70,41,20,9,3,3,0,5,1,0,0,4
S01012570,Occupancy rating +1,45,18,6,12,25,2,22,10,10,2,1,1,0,2,1,0,0,1
S01012570,Occupancy rating 0,35,13,4,9,17,0,12,2,6,4,5,3,2,5,2,0,1,2
S01012570,Occupancy rating -1 or less,10,3,3,0,6,1,4,1,2,1,1,1,0,1,1,0,0,0
S01012571,All households,362,115,52,63,234,19,179,89,67,23,36,21,15,13,6,0,1,6
S01012571,Occupancy rating +2 or more,162,40,14,26,117,12,98,56,34,8,7,2,5,5,3,0,0,2
S01012571,Occupancy rating +1,103,43,20,23,56,5,43,23,18,2,8,5,3,4,1,0,0,3
S01012571,Occupancy rating 0,75,26,14,12,45,2,27,8,12,7,16,11,5,4,2,0,1,1
S01012571,Occupancy rating -1 or less,22,6,4,2,16,0,11,2,3,6,5,3,2,0,0,0,0,0
S01012572,All households,224,66,28,38,150,17,115,56,39,20,18,11,7,8,6,0,0,2
S01012572,Occupancy rating +2 or more,125,28,10,18,93,13,72,39,23,10,8,3,5,4,2,0,0,2
S01012572,Occupancy rating +1,54,21,11,10,32,3,26,10,10,6,3,3,0,1,1,0,0,0
S01012572,Occupancy rating 0,33,13,6,7,20,1,14,7,3,4,5,3,2,0,0,0,0,0
S01012572,Occupancy rating -1 or less,12,4,1,3,5,0,3,0,3,0,2,2,0,3,3,0,0,0
S01012573,All households,325,53,22,31,253,24,211,109,77,25,18,6,12,19,8,0,3,8
S01012573,Occupancy rating +2 or more,241,37,18,19,190,17,164,95,54,15,9,3,6,14,4,0,3,7
S01012573,Occupancy rating +1,51,10,2,8,38,6,27,8,10,9,5,1,4,3,2,0,0,1
S01012573,Occupancy rating 0,22,3,1,2,17,0,13,5,7,1,4,2,2,2,2,0,0,0
S01012573,Occupancy rating -1 or less,11,3,1,2,8,1,7,1,6,0,0,0,0,0,0,0,0,0
S01012574,All households,359,82,44,38,267,44,200,84,80,36,23,12,11,10,4,0,0,6
S01012574,Occupancy rating +2 or more,249,48,29,19,193,40,145,69,51,25,8,4,4,8,3,0,0,5
S01012574,Occupancy rating +1,61,19,6,13,41,3,30,13,12,5,8,3,5,1,0,0,0,1
S01012574,Occupancy rating 0,37,10,5,5,26,1,19,2,13,4,6,5,1,1,1,0,0,0
S01012574,Occupancy rating -1 or less,12,5,4,1,7,0,6,0,4,2,1,0,1,0,0,0,0,0
S01012575,All households,289,79,33,46,203,32,143,67,58,18,28,18,10,7,1,0,2,4
S01012575,Occupancy rating +2 or more,190,48,28,20,136,27,99,46,40,13,10,6,4,6,1,0,2,3
S01012575,Occupancy rating +1,60,18,2,16,41,4,31,17,10,4,6,3,3,1,0,0,0,1
S01012575,Occupancy rating 0,31,11,3,8,20,1,9,4,4,1,10,8,2,0,0,0,0,0
S01012575,Occupancy rating -1 or less,8,2,0,2,6,0,4,0,4,0,2,1,1,0,0,0,0,0
S01012576,All households,370,154,64,90,206,36,148,71,61,16,22,12,10,10,2,0,3,5
S01012576,Occupancy rating +2 or more,202,65,31,34,134,29,100,53,40,7,5,2,3,3,1,0,2,0
S01012576,Occupancy rating +1,88,47,18,29,38,3,31,14,12,5,4,2,2,3,1,0,0,2
S01012576,Occupancy rating 0,59,34,13,21,22,4,12,3,6,3,6,3,3,3,0,0,1,2
S01012576,Occupancy rating -1 or less,21,8,2,6,12,0,5,1,3,1,7,5,2,1,0,0,0,1
S01012577,All households,336,94,39,55,233,34,171,71,75,25,28,19,9,9,4,0,0,5
S01012577,Occupancy rating +2 or more,166,48,22,26,116,24,89,44,33,12,3,2,1,2,1,0,0,1
S01012577,Occupancy rating +1,98,36,15,21,61,9,46,24,15,7,6,4,2,1,0,0,0,1
S01012577,Occupancy rating 0,55,4,1,3,46,1,30,2,23,5,15,9,6,5,2,0,0,3
S01012577,Occupancy rating -1 or less,17,6,1,5,10,0,6,1,4,1,4,4,0,1,1,0,0,0
S01012578,All households,463,193,122,71,253,56,168,82,71,15,29,15,14,17,5,0,1,11
S01012578,Occupancy rating +2 or more,227,62,39,23,161,44,109,55,44,10,8,4,4,4,2,0,0,2
S01012578,Occupancy rating +1,97,44,21,23,47,8,31,17,13,1,8,5,3,6,2,0,1,3
S01012578,Occupancy rating 0,118,82,59,23,33,3,21,9,10,2,9,4,5,3,0,0,0,3
S01012578,Occupancy rating -1 or less,21,5,3,2,12,1,7,1,4,2,4,2,2,4,1,0,0,3
S01012579,All households,287,68,24,44,207,17,158,62,68,28,32,26,6,12,7,0,0,5
S01012579,Occupancy rating +2 or more,157,37,13,24,114,9,99,45,41,13,6,5,1,6,4,0,0,2
S01012579,Occupancy rating +1,62,19,5,14,42,7,27,14,9,4,8,8,0,1,1,0,0,0
S01012579,Occupancy rating 0,54,10,5,5,40,1,23,3,10,10,16,11,5,4,1,0,0,3
S01012579,Occupancy rating -1 or less,14,2,1,1,11,0,9,0,8,1,2,2,0,1,1,0,0,0
S01012580,All households,325,91,27,64,223,22,186,99,69,18,15,6,9,11,6,0,1,4
S01012580,Occupancy rating +2 or more,218,60,18,42,152,19,125,80,34,11,8,2,6,6,3,0,1,2
S01012580,Occupancy rating +1,63,24,6,18,37,1,34,14,15,5,2,0,2,2,1,0,0,1
S01012580,Occupancy rating 0,34,6,2,4,27,1,22,4,16,2,4,3,1,1,1,0,0,0
S01012580,Occupancy rating -1 or less,10,1,1,0,7,1,5,1,4,0,1,1,0,2,1,0,0,1
S01012581,All households,331,113,53,60,207,11,129,55,57,17,67,40,27,11,4,0,0,7
S01012581,Occupancy rating +2 or more,109,37,25,12,70,8,54,34,18,2,8,6,2,2,1,0,0,1
S01012581,Occupancy rating +1,107,44,16,28,57,3,37,16,13,8,17,7,10,6,1,0,0,5
S01012581,Occupancy rating 0,81,23,9,14,55,0,25,3,18,4,30,22,8,3,2,0,0,1
S01012581,Occupancy rating -1 or less,34,9,3,6,25,0,13,2,8,3,12,5,7,0,0,0,0,0
S01012582,All households,365,82,26,56,273,35,209,77,95,37,29,19,10,10,4,0,0,6
S01012582,Occupancy rating +2 or more,254,59,23,36,188,24,149,67,61,21,15,9,6,7,4,0,0,3
S01012582,Occupancy rating +1,58,11,0,11,46,10,32,8,15,9,4,2,2,1,0,0,0,1
S01012582,Occupancy rating 0,41,12,3,9,29,1,20,2,13,5,8,7,1,0,0,0,0,0
S01012582,Occupancy rating -1 or less,12,0,0,0,10,0,8,0,6,2,2,1,1,2,0,0,0,2
S01012583,All households,326,112,40,72,205,21,148,73,59,16,36,20,16,9,1,0,0,8
S01012583,Occupancy rating +2 or more,109,31,11,20,77,4,69,42,22,5,4,2,2,1,0,0,0,1
S01012583,Occupancy rating +1,118,50,17,33,67,13,43,27,13,3,11,1,10,1,0,0,0,1
S01012583,Occupancy rating 0,76,29,12,17,41,3,24,4,17,3,14,12,2,6,1,0,0,5
S01012583,Occupancy rating -1 or less,23,2,0,2,20,1,12,0,7,5,7,5,2,1,0,0,0,1
S01012584,All households,331,95,50,45,225,35,151,70,54,27,39,26,13,11,4,0,0,7
S01012584,Occupancy rating +2 or more,166,44,21,23,116,19,88,47,26,15,9,6,3,6,2,0,0,4
S01012584,Occupancy rating +1,97,30,18,12,66,15,41,20,16,5,10,5,5,1,0,0,0,1
S01012584,Occupancy rating 0,50,18,10,8,31,1,16,3,9,4,14,10,4,1,1,0,0,0
S01012584,Occupancy rating -1 or less,18,3,1,2,12,0,6,0,3,3,6,5,1,3,1,0,0,2
S01012585,All households,404,168,70,98,220,24,140,54,61,25,56,44,12,16,3,0,0,13
S01012585,Occupancy rating +2 or more,114,52,29,23,60,11,41,23,12,6,8,7,1,2,0,0,0,2
S01012585,Occupancy rating +1,146,69,22,47,73,10,52,27,17,8,11,7,4,4,0,0,0,4
S01012585,Occupancy rating 0,108,38,16,22,63,3,32,4,18,10,28,22,6,7,2,0,0,5
S01012585,Occupancy rating -1 or less,36,9,3,6,24,0,15,0,14,1,9,8,1,3,1,0,0,2
S01012586,All households,313,56,15,41,248,28,197,75,89,33,23,13,10,9,6,0,0,3
S01012586,Occupancy rating +2 or more,197,40,11,29,153,22,123,63,45,15,8,3,5,4,2,0,0,2
S01012586,Occupancy rating +1,61,9,2,7,51,5,36,9,17,10,10,7,3,1,0,0,0,1
S01012586,Occupancy rating 0,39,3,2,1,35,1,31,2,21,8,3,2,1,1,1,0,0,0
S01012586,Occupancy rating -1 or less,16,4,0,4,9,0,7,1,6,0,2,1,1,3,3,0,0,0
S01012587,All households,327,57,24,33,252,22,205,89,80,36,25,13,12,18,7,0,1,10
S01012587,Occupancy rating +2 or more,225,32,13,19,184,15,157,82,55,20,12,7,5,9,3,0,1,5
S01012587,Occupancy rating +1,64,17,8,9,43,5,31,6,16,9,7,3,4,4,2,0,0,2
S01012587,Occupancy rating 0,32,6,2,4,22,2,15,1,8,6,5,3,2,4,1,0,0,3
S01012587,Occupancy rating -1 or less,6,2,1,1,3,0,2,0,1,1,1,0,1,1,1,0,0,0
S01012588,All households,256,56,26,30,187,19,147,60,65,22,21,11,10,13,5,0,0,8
S01012588,Occupancy rating +2 or more,149,20,8,12,123,15,99,44,40,15,9,6,3,6,3,0,0,3
S01012588,Occupancy rating +1,58,24,13,11,30,3,25,13,9,3,2,0,2,4,1,0,0,3
S01012588,Occupancy rating 0,42,11,5,6,28,1,17,3,11,3,10,5,5,3,1,0,0,2
S01012588,Occupancy rating -1 or less,7,1,0,1,6,0,6,0,5,1,0,0,0,0,0,0,0,0
S01012589,All households,284,68,32,36,205,24,140,58,52,30,41,25,16,11,6,0,0,5
S01012589,Occupancy rating +2 or more,124,38,23,15,83,20,60,39,13,8,3,1,2,3,1,0,0,2
S01012589,Occupancy rating +1,87,24,7,17,63,3,48,17,15,16,12,6,6,0,0,0,0,0
S01012589,Occupancy rating 0,60,5,1,4,49,1,27,2,20,5,21,15,6,6,3,0,0,3
S01012589,Occupancy rating -1 or less,13,1,1,0,10,0,5,0,4,1,5,3,2,2,2,0,0,0
S01012590,All households,371,146,66,80,210,27,148,66,56,26,35,28,7,15,8,0,2,5
S01012590,Occupancy rating +2 or more,112,38,14,24,73,13,55,25,19,11,5,5,0,1,0,0,0,1
S01012590,Occupancy rating +1,117,44,20,24,72,11,50,33,13,4,11,8,3,1,1,0,0,0
S01012590,Occupancy rating 0,116,57,28,29,50,2,32,7,17,8,16,13,3,9,4,0,2,3
S01012590,Occupancy rating -1 or less,26,7,4,3,15,1,11,1,7,3,3,2,1,4,3,0,0,1
S01012591,All households,385,148,64,84,221,58,119,44,51,24,44,28,16,16,5,0,1,10
S01012591,Occupancy rating +2 or more,90,32,10,22,58,25,29,19,7,3,4,0,4,0,0,0,0,0
S01012591,Occupancy rating +1,162,72,35,37,82,27,49,23,17,9,6,3,3,8,1,0,1,6
S01012591,Occupancy rating 0,102,33,13,20,65,5,35,2,23,10,25,19,6,4,0,0,0,4
S01012591,Occupancy rating -1 or less,31,11,6,5,16,1,6,0,4,2,9,6,3,4,4,0,0,0
S01012592,All households,215,38,9,29,171,22,141,47,65,29,8,5,3,6,3,0,0,3
S01012592,Occupancy rating +2 or more,186,31,8,23,152,20,126,45,56,25,6,4,2,3,0,0,0,3
S01012592,Occupancy rating +1,15,4,0,4,11,1,9,2,5,2,1,1,0,0,0,0,0,0
S01012592,Occupancy rating 0,10,3,1,2,6,1,4,0,3,1,1,0,1,1,1,0,0,0
S01012592,Occupancy rating -1 or less,4,0,0,0,2,0,2,0,1,1,0,0,0,2,2,0,0,0
S01012593,All households,333,68,24,44,260,27,209,82,96,31,24,14,10,5,4,0,0,1
S01012593,Occupancy rating +2 or more,198,40,15,25,154,19,129,64,48,17,6,3,3,4,3,0,0,1
S01012593,Occupancy rating +1,75,18,6,12,57,6,44,13,22,9,7,4,3,0,0,0,0,0
S01012593,Occupancy rating 0,53,10,3,7,43,1,32,4,24,4,10,7,3,0,0,0,0,0
S01012593,Occupancy rating -1 or less,7,0,0,0,6,1,4,1,2,1,1,0,1,1,1,0,0,0
S01012594,All households,212,69,35,34,138,14,102,47,39,16,22,14,8,5,2,0,0,3
S01012594,Occupancy rating +2 or more,85,16,9,7,69,6,58,31,23,4,5,3,2,0,0,0,0,0
S01012594,Occupancy rating +1,72,31,15,16,39,8,28,14,7,7,3,2,1,2,0,0,0,2
S01012594,Occupancy rating 0,42,18,8,10,23,0,13,2,8,3,10,6,4,1,0,0,0,1
S01012594,Occupancy rating -1 or less,13,4,3,1,7,0,3,0,1,2,4,3,1,2,2,0,0,0
S01012595,All households,288,99,40,59,181,18,130,60,32,38,33,21,12,8,3,0,2,3
S01012595,Occupancy rating +2 or more,89,28,13,15,61,11,45,28,6,11,5,2,3,0,0,0,0,0
S01012595,Occupancy rating +1,117,47,18,29,67,4,53,26,11,16,10,7,3,3,1,0,1,1
S01012595,Occupancy rating 0,51,7,3,4,42,3,24,5,13,6,15,10,5,2,1,0,1,0
S01012595,Occupancy rating -1 or less,31,17,6,11,11,0,8,1,2,5,3,2,1,3,1,0,0,2
S01012596,All households,347,103,38,65,236,23,149,57,72,20,64,52,12,8,4,0,0,4
S01012596,Occupancy rating +2 or more,98,23,12,11,74,9,59,30,25,4,6,4,2,1,0,0,0,1
S01012596,Occupancy rating +1,115,51,21,30,61,12,39,20,16,3,10,8,2,3,1,0,0,2
S01012596,Occupancy rating 0,95,20,3,17,72,2,34,4,18,12,36,30,6,3,2,0,0,1
S01012596,Occupancy rating -1 or less,39,9,2,7,29,0,17,3,13,1,12,10,2,1,1,0,0,0
S01012597,All households,177,30,14,16,141,5,123,47,66,10,13,9,4,6,4,0,0,2
S01012597,Occupancy rating +2 or more,118,12,3,9,100,3,90,37,47,6,7,6,1,6,4,0,0,2
S01012597,Occupancy rating +1,34,8,4,4,26,2,22,7,13,2,2,1,1,0,0,0,0,0
S01012597,Occupancy rating 0,16,9,6,3,7,0,5,2,3,0,2,0,2,0,0,0,0,0
S01012597,Occupancy rating -1 or less,9,1,1,0,8,0,6,1,3,2,2,2,0,0,0,0,0,0
S01012598,All households,302,87,36,51,210,28,162,80,50,32,20,11,9,5,0,0,1,4
S01012598,Occupancy rating +2 or more,157,28,14,14,127,17,107,60,25,22,3,1,2,2,0,0,0,2
S01012598,Occupancy rating +1,61,19,4,15,41,7,28,14,10,4,6,4,2,1,0,0,1,0
S01012598,Occupancy rating 0,69,34,16,18,35,4,25,6,13,6,6,3,3,0,0,0,0,0
S01012598,Occupancy rating -1 or less,15,6,2,4,7,0,2,0,2,0,5,3,2,2,0,0,0,2
S01012599,All households,330,136,58,78,187,28,138,67,43,28,21,15,6,7,1,0,1,5
S01012599,Occupancy rating +2 or more,152,45,28,17,105,18,80,37,27,16,7,4,3,2,1,0,0,1
S01012599,Occupancy rating +1,85,42,22,20,41,6,31,23,5,3,4,2,2,2,0,0,0,2
S01012599,Occupancy rating 0,67,36,7,29,31,3,19,6,7,6,9,8,1,0,0,0,0,0
S01012599,Occupancy rating -1 or less,26,13,1,12,10,1,8,1,4,3,1,1,0,3,0,0,1,2
S01012600,All households,308,93,31,62,205,8,171,82,54,35,26,13,13,10,5,0,2,3
S01012600,Occupancy rating +2 or more,151,27,11,16,120,6,102,63,23,16,12,5,7,4,3,0,1,0
S01012600,Occupancy rating +1,84,31,12,19,51,2,43,18,15,10,6,4,2,2,1,0,1,0
S01012600,Occupancy rating 0,57,25,7,18,28,0,20,1,13,6,8,4,4,4,1,0,0,3
S01012600,Occupancy rating -1 or less,16,10,1,9,6,0,6,0,3,3,0,0,0,0,0,0,0,0
S01012601,All households,357,78,31,47,268,25,218,88,98,32,25,15,10,11,6,0,0,5
S01012601,Occupancy rating +2 or more,229,51,17,34,176,23,138,73,54,11,15,7,8,2,0,0,0,2
S01012601,Occupancy rating +1,71,13,9,4,56,1,51,11,25,15,4,3,1,2,2,0,0,0
S01012601,Occupancy rating 0,47,12,5,7,32,1,27,3,18,6,4,4,0,3,1,0,0,2
S01012601,Occupancy rating -1 or less,10,2,0,2,4,0,2,1,1,0,2,1,1,4,3,0,0,1
S01012602,All households,329,184,74,110,135,25,87,42,26,19,23,14,9,10,1,2,0,7
S01012602,Occupancy rating +2 or more,64,18,10,8,46,11,32,15,8,9,3,0,3,0,0,0,0,0
S01012602,Occupancy rating +1,103,71,25,46,31,5,25,17,4,4,1,1,0,1,0,1,0,0
S01012602,Occupancy rating 0,139,81,32,49,49,9,23,8,12,3,17,12,5,9,1,1,0,7
S01012602,Occupancy rating -1 or less,23,14,7,7,9,0,7,2,2,3,2,1,1,0,0,0,0,0
S01012603,All households,337,151,50,101,181,28,128,58,37,33,25,11,14,5,0,0,0,5
S01012603,Occupancy rating +2 or more,87,23,9,14,63,13,49,26,11,12,1,1,0,1,0,0,0,1
S01012603,Occupancy rating +1,89,36,15,21,52,9,38,20,9,9,5,2,3,1,0,0,0,1
S01012603,Occupancy rating 0,137,86,23,63,49,5,28,12,9,7,16,7,9,2,0,0,0,2
S01012603,Occupancy rating -1 or less,24,6,3,3,17,1,13,0,8,5,3,1,2,1,0,0,0,1
S01012604,All households,275,59,26,33,205,32,132,53,40,39,41,21,20,11,6,0,1,4
S01012604,Occupancy rating +2 or more,108,23,10,13,81,23,52,27,12,13,6,3,3,4,0,0,1,3
S01012604,Occupancy rating +1,94,31,13,18,63,9,39,24,9,6,15,8,7,0,0,0,0,0
S01012604,Occupancy rating 0,51,3,1,2,46,0,31,1,13,17,15,7,8,2,2,0,0,0
S01012604,Occupancy rating -1 or less,22,2,2,0,15,0,10,1,6,3,5,3,2,5,4,0,0,1
S01012605,All households,240,75,39,36,161,34,98,40,41,17,29,20,9,4,4,0,0,0
S01012605,Occupancy rating +2 or more,81,21,13,8,60,17,37,21,8,8,6,2,4,0,0,0,0,0
S01012605,Occupancy rating +1,83,39,16,23,44,11,31,19,10,2,2,1,1,0,0,0,0,0
S01012605,Occupancy rating 0,55,13,9,4,39,5,20,0,15,5,14,10,4,3,3,0,0,0
S01012605,Occupancy rating -1 or less,21,2,1,1,18,1,10,0,8,2,7,7,0,1,1,0,0,0
S01012606,All households,249,11,0,11,233,3,223,59,134,30,7,5,2,5,3,0,0,2
S01012606,Occupancy rating +2 or more,222,11,0,11,206,3,199,59,114,26,4,3,1,5,3,0,0,2
S01012606,Occupancy rating +1,16,0,0,0,16,0,15,0,13,2,1,1,0,0,0,0,0,0
S01012606,Occupancy rating 0,9,0,0,0,9,0,7,0,6,1,2,1,1,0,0,0,0,0
S01012606,Occupancy rating -1 or less,2,0,0,0,2,0,2,0,1,1,0,0,0,0,0,0,0,0
S01012607,All households,312,74,24,50,225,31,164,68,64,32,30,17,13,13,9,0,0,4
S01012607,Occupancy rating +2 or more,141,31,14,17,105,14,88,51,24,13,3,0,3,5,3,0,0,2
S01012607,Occupancy rating +1,86,26,5,21,60,15,40,14,17,9,5,1,4,0,0,0,0,0
S01012607,Occupancy rating 0,63,16,4,12,40,0,27,3,17,7,13,9,4,7,5,0,0,2
S01012607,Occupancy rating -1 or less,22,1,1,0,20,2,9,0,6,3,9,7,2,1,1,0,0,0
S01012608,All households,358,117,60,57,232,26,163,58,69,36,43,26,17,9,2,0,2,5
S01012608,Occupancy rating +2 or more,121,39,23,16,80,12,61,31,20,10,7,4,3,2,0,0,1,1
S01012608,Occupancy rating +1,107,42,17,25,63,11,45,23,13,9,7,1,6,2,0,0,0,2
S01012608,Occupancy rating 0,96,26,13,13,66,2,40,2,25,13,24,16,8,4,1,0,1,2
S01012608,Occupancy rating -1 or less,34,10,7,3,23,1,17,2,11,4,5,5,0,1,1,0,0,0
S01012609,All households,383,125,48,77,248,38,140,49,55,36,70,45,25,10,7,0,0,3
S01012609,Occupancy rating +2 or more,73,28,11,17,45,18,26,17,5,4,1,0,1,0,0,0,0,0
S01012609,Occupancy rating +1,159,70,23,47,87,17,56,31,12,13,14,7,7,2,0,0,0,2
S01012609,Occupancy rating 0,109,19,7,12,86,2,42,1,26,15,42,33,9,4,3,0,0,1
S01012609,Occupancy rating -1 or less,42,8,7,1,30,1,16,0,12,4,13,5,8,4,4,0,0,0
S01012610,All households,425,147,45,102,263,13,161,70,67,24,89,70,19,15,5,0,2,8
S01012610,Occupancy rating +2 or more,93,30,18,12,61,9,44,24,11,9,8,5,3,2,1,0,0,1
S01012610,Occupancy rating +1,167,99,23,76,67,3,56,39,13,4,8,5,3,1,0,0,0,1
S01012610,Occupancy rating 0,119,12,3,9,98,1,41,5,28,8,56,45,11,9,2,0,2,5
S01012610,Occupancy rating -1 or less,46,6,1,5,37,0,20,2,15,3,17,15,2,3,2,0,0,1
S01012611,All households,352,102,46,56,245,28,183,83,61,39,34,20,14,5,4,0,1,0
S01012611,Occupancy rating +2 or more,173,54,29,25,117,23,89,58,18,13,5,1,4,2,1,0,1,0
S01012611,Occupancy rating +1,103,42,16,26,60,3,50,20,16,14,7,5,2,1,1,0,0,0
S01012611,Occupancy rating 0,60,5,1,4,55,1,36,5,20,11,18,12,6,0,0,0,0,0
S01012611,Occupancy rating -1 or less,16,1,0,1,13,1,8,0,7,1,4,2,2,2,2,0,0,0
S01012612,All households,294,69,39,30,211,27,149,54,63,32,35,19,16,14,8,1,2,3
S01012612,Occupancy rating +2 or more,128,38,23,15,85,22,56,37,9,10,7,1,6,5,0,1,2,2
S01012612,Occupancy rating +1,85,23,12,11,60,5,48,16,20,12,7,4,3,2,2,0,0,0
S01012612,Occupancy rating 0,62,6,4,2,53,0,36,1,25,10,17,11,6,3,2,0,0,1
S01012612,Occupancy rating -1 or less,19,2,0,2,13,0,9,0,9,0,4,3,1,4,4,0,0,0
S01012613,All households,287,71,27,44,212,20,141,59,49,33,51,31,20,4,1,0,0,3
S01012613,Occupancy rating +2 or more,95,19,11,8,73,12,56,36,9,11,5,2,3,3,0,0,0,3
S01012613,Occupancy rating +1,100,40,15,25,60,7,43,23,10,10,10,6,4,0,0,0,0,0
S01012613,Occupancy rating 0,59,8,1,7,50,0,26,0,21,5,24,15,9,1,1,0,0,0
S01012613,Occupancy rating -1 or less,33,4,0,4,29,1,16,0,9,7,12,8,4,0,0,0,0,0
S01012614,All households,455,133,56,77,309,41,216,98,76,42,52,36,16,13,3,0,2,8
S01012614,Occupancy rating +2 or more,191,38,16,22,148,26,112,59,32,21,10,2,8,5,0,0,0,5
S01012614,Occupancy rating +1,122,36,14,22,85,9,66,31,24,11,10,9,1,1,0,0,0,1
S01012614,Occupancy rating 0,115,50,22,28,61,5,29,6,16,7,27,21,6,4,2,0,0,2
S01012614,Occupancy rating -1 or less,27,9,4,5,15,1,9,2,4,3,5,4,1,3,1,0,2,0
S01012615,All households,306,101,46,55,201,34,147,62,59,26,20,13,7,4,1,0,1,2
S01012615,Occupancy rating +2 or more,175,41,17,24,132,23,103,45,41,17,6,4,2,2,0,0,1,1
S01012615,Occupancy rating +1,77,38,20,18,38,7,23,13,8,2,8,3,5,1,0,0,0,1
S01012615,Occupancy rating 0,40,19,8,11,21,4,13,3,6,4,4,4,0,0,0,0,0,0
S01012615,Occupancy rating -1 or less,14,3,1,2,10,0,8,1,4,3,2,2,0,1,1,0,0,0
S01012616,All households,384,87,52,35,285,35,213,94,88,31,37,23,14,12,5,0,0,7
S01012616,Occupancy rating +2 or more,235,36,27,9,197,32,154,70,63,21,11,5,6,2,1,0,0,1
S01012616,Occupancy rating +1,72,26,14,12,43,2,33,16,13,4,8,5,3,3,0,0,0,3
S01012616,Occupancy rating 0,57,17,8,9,36,0,22,6,11,5,14,10,4,4,1,0,0,3
S01012616,Occupancy rating -1 or less,20,8,3,5,9,1,4,2,1,1,4,3,1,3,3,0,0,0
S01012617,All households,151,22,10,12,121,15,95,41,33,21,11,8,3,8,2,0,2,4
S01012617,Occupancy rating +2 or more,108,13,8,5,90,12,71,36,19,16,7,4,3,5,2,0,1,2
S01012617,Occupancy rating +1,34,8,2,6,25,3,20,5,12,3,2,2,0,1,0,0,1,0
S01012617,Occupancy rating 0,9,1,0,1,6,0,4,0,2,2,2,2,0,2,0,0,0,2
S01012617,Occupancy rating -1 or less,0,0,0,0,0,0,0,0,0,0,0,0,0,0,0,0,0,0
S01012618,All households,209,45,18,27,155,7,123,49,48,26,25,15,10,9,4,0,0,5
S01012618,Occupancy rating +2 or more,109,20,9,11,88,6,78,33,33,12,4,3,1,1,1,0,0,0
S01012618,Occupancy rating +1,53,19,6,13,30,1,20,14,3,3,9,1,8,4,1,0,0,3
S01012618,Occupancy rating 0,38,6,3,3,29,0,17,1,7,9,12,11,1,3,1,0,0,2
S01012618,Occupancy rating -1 or less,9,0,0,0,8,0,8,1,5,2,0,0,0,1,1,0,0,0
S01012619,All households,295,153,63,90,131,23,86,50,23,13,22,14,8,11,2,0,0,9
S01012619,Occupancy rating +2 or more,90,30,13,17,60,14,41,29,8,4,5,2,3,0,0,0,0,0
S01012619,Occupancy rating +1,61,21,6,15,37,4,27,11,8,8,6,2,4,3,0,0,0,3
S01012619,Occupancy rating 0,121,88,41,47,28,5,16,9,7,0,7,6,1,5,1,0,0,4
S01012619,Occupancy rating -1 or less,23,14,3,11,6,0,2,1,0,1,4,4,0,3,1,0,0,2
S01012620,All households,325,81,48,33,233,50,166,82,57,27,17,9,8,11,6,0,1,4
S01012620,Occupancy rating +2 or more,247,50,31,19,189,46,135,71,43,21,8,4,4,8,4,0,0,4
S01012620,Occupancy rating +1,40,15,10,5,25,2,18,6,7,5,5,3,2,0,0,0,0,0
S01012620,Occupancy rating 0,25,9,4,5,13,2,8,5,2,1,3,1,2,3,2,0,1,0
S01012620,Occupancy rating -1 or less,13,7,3,4,6,0,5,0,5,0,1,1,0,0,0,0,0,0
S01012621,All households,277,98,53,45,173,41,112,57,36,19,20,9,11,6,1,0,1,4
S01012621,Occupancy rating +2 or more,172,52,33,19,117,37,76,46,19,11,4,1,3,3,1,0,1,1
S01012621,Occupancy rating +1,54,20,16,4,32,4,22,6,10,6,6,4,2,2,0,0,0,2
S01012621,Occupancy rating 0,48,25,3,22,22,0,14,5,7,2,8,3,5,1,0,0,0,1
S01012621,Occupancy rating -1 or less,3,1,1,0,2,0,0,0,0,0,2,1,1,0,0,0,0,0
S01012622,All households,341,124,45,79,202,37,135,49,66,20,30,18,12,15,6,0,1,8
S01012622,Occupancy rating +2 or more,157,52,25,27,103,26,71,36,27,8,6,2,4,2,0,0,0,2
S01012622,Occupancy rating +1,101,43,12,31,57,8,37,12,17,8,12,5,7,1,0,0,0,1
S01012622,Occupancy rating 0,71,24,6,18,36,1,25,1,21,3,10,9,1,11,5,0,1,5
S01012622,Occupancy rating -1 or less,12,5,2,3,6,2,2,0,1,1,2,2,0,1,1,0,0,0
S01012623,All households,320,128,44,84,183,19,117,51,37,29,47,25,22,9,7,0,0,2
S01012623,Occupancy rating +2 or more,87,38,18,20,48,7,38,25,7,6,3,2,1,1,1,0,0,0
S01012623,Occupancy rating +1,129,61,22,39,68,12,40,22,8,10,16,7,9,0,0,0,0,0
S01012623,Occupancy rating 0,80,23,3,20,53,0,28,4,15,9,25,14,11,4,4,0,0,0
S01012623,Occupancy rating -1 or less,24,6,1,5,14,0,11,0,7,4,3,2,1,4,2,0,0,2
S01012624,All households,334,121,55,66,196,25,119,52,47,20,52,31,21,17,8,0,1,8
S01012624,Occupancy rating +2 or more,106,49,22,27,54,17,34,29,3,2,3,0,3,3,1,0,0,2
S01012624,Occupancy rating +1,125,42,19,23,79,4,47,18,19,10,28,16,12,4,1,0,0,3
S01012624,Occupancy rating 0,79,21,10,11,52,2,31,4,19,8,19,14,5,6,3,0,0,3
S01012624,Occupancy rating -1 or less,24,9,4,5,11,2,7,1,6,0,2,1,1,4,3,0,1,0
S01012625,All households,263,105,31,74,147,22,94,44,33,17,31,19,12,11,4,0,0,7
S01012625,Occupancy rating +2 or more,73,27,5,22,44,11,29,24,2,3,4,1,3,2,1,0,0,1
S01012625,Occupancy rating +1,91,40,16,24,50,8,35,15,12,8,7,3,4,1,0,0,0,1
S01012625,Occupancy rating 0,81,32,8,24,43,3,24,4,16,4,16,13,3,6,2,0,0,4
S01012625,Occupancy rating -1 or less,18,6,2,4,10,0,6,1,3,2,4,2,2,2,1,0,0,1
S01012626,All households,216,60,25,35,152,21,109,55,36,18,22,11,11,4,1,0,0,3
S01012626,Occupancy rating +2 or more,123,29,15,14,92,18,70,42,17,11,4,0,4,2,1,0,0,1
S01012626,Occupancy rating +1,53,19,10,9,32,2,24,11,8,5,6,4,2,2,0,0,0,2
S01012626,Occupancy rating 0,34,11,0,11,23,1,12,1,9,2,10,5,5,0,0,0,0,0
S01012626,Occupancy rating -1 or less,6,1,0,1,5,0,3,1,2,0,2,2,0,0,0,0,0,0
S01012627,All households,241,81,25,56,151,20,93,34,39,20,38,27,11,9,3,0,0,6
S01012627,Occupancy rating +2 or more,94,19,6,13,72,17,50,24,19,7,5,3,2,3,2,0,0,1
S01012627,Occupancy rating +1,69,40,8,32,29,2,22,8,6,8,5,1,4,0,0,0,0,0
S01012627,Occupancy rating 0,64,20,9,11,41,0,15,2,9,4,26,22,4,3,1,0,0,2
S01012627,Occupancy rating -1 or less,14,2,2,0,9,1,6,0,5,1,2,1,1,3,0,0,0,3
S01012628,All households,334,56,19,37,256,35,210,61,128,21,11,6,5,22,10,0,1,11
S01012628,Occupancy rating +2 or more,270,40,11,29,216,29,181,53,112,16,6,4,2,14,7,0,0,7
S01012628,Occupancy rating +1,42,13,5,8,25,5,16,5,9,2,4,1,3,4,2,0,1,1
S01012628,Occupancy rating 0,16,3,3,0,11,1,9,3,4,2,1,1,0,2,0,0,0,2
S01012628,Occupancy rating -1 or less,6,0,0,0,4,0,4,0,3,1,0,0,0,2,1,0,0,1
S01012629,All households,197,53,25,28,135,18,104,41,50,13,13,8,5,9,3,0,2,4
S01012629,Occupancy rating +2 or more,143,28,15,13,109,15,88,34,43,11,6,2,4,6,2,0,1,3
S01012629,Occupancy rating +1,33,18,10,8,15,2,12,6,5,1,1,1,0,0,0,0,0,0
S01012629,Occupancy rating 0,16,5,0,5,8,1,3,1,2,0,4,4,0,3,1,0,1,1
S01012629,Occupancy rating -1 or less,5,2,0,2,3,0,1,0,0,1,2,1,1,0,0,0,0,0
S01012630,All households,508,287,146,141,199,49,119,79,22,18,31,18,13,22,5,1,2,14
S01012630,Occupancy rating +2 or more,142,44,21,23,95,24,65,38,14,13,6,3,3,3,0,0,0,3
S01012630,Occupancy rating +1,123,73,29,44,46,13,27,22,2,3,6,3,3,4,2,0,0,2
S01012630,Occupancy rating 0,176,123,71,52,46,10,19,15,2,2,17,10,7,7,0,0,1,6
S01012630,Occupancy rating -1 or less,67,47,25,22,12,2,8,4,4,0,2,2,0,8,3,1,1,3
S01012631,All households,423,162,33,129,246,19,160,53,84,23,67,47,20,15,8,0,0,7
S01012631,Occupancy rating +2 or more,142,40,12,28,96,9,78,33,34,11,9,5,4,6,3,0,0,3
S01012631,Occupancy rating +1,119,49,11,38,68,8,38,14,16,8,22,15,7,2,0,0,0,2
S01012631,Occupancy rating 0,130,64,8,56,63,1,35,5,28,2,27,21,6,3,1,0,0,2
S01012631,Occupancy rating -1 or less,32,9,2,7,19,1,9,1,6,2,9,6,3,4,4,0,0,0
S01012632,All households,304,74,18,56,219,34,167,72,66,29,18,12,6,11,5,0,1,5
S01012632,Occupancy rating +2 or more,207,45,12,33,158,30,121,58,42,21,7,4,3,4,2,0,1,1
S01012632,Occupancy rating +1,65,23,6,17,38,4,29,13,13,3,5,2,3,4,2,0,0,2
S01012632,Occupancy rating 0,25,4,0,4,18,0,13,1,8,4,5,5,0,3,1,0,0,2
S01012632,Occupancy rating -1 or less,7,2,0,2,5,0,4,0,3,1,1,1,0,0,0,0,0,0
S01012633,All households,283,65,27,38,204,31,158,71,59,28,15,9,6,14,5,0,1,8
S01012633,Occupancy rating +2 or more,191,44,22,22,137,30,103,56,34,13,4,2,2,10,4,0,1,5
S01012633,Occupancy rating +1,54,17,4,13,37,1,33,14,11,8,3,1,2,0,0,0,0,0
S01012633,Occupancy rating 0,28,4,1,3,22,0,18,1,11,6,4,2,2,2,0,0,0,2
S01012633,Occupancy rating -1 or less,10,0,0,0,8,0,4,0,3,1,4,4,0,2,1,0,0,1
S01012634,All households,339,136,60,76,194,27,121,62,42,17,46,28,18,9,3,0,0,6
S01012634,Occupancy rating +2 or more,107,27,16,11,75,17,53,33,14,6,5,2,3,5,2,0,0,3
S01012634,Occupancy rating +1,108,57,23,34,50,6,37,21,13,3,7,6,1,1,0,0,0,1
S01012634,Occupancy rating 0,93,38,17,21,52,2,23,6,11,6,27,16,11,3,1,0,0,2
S01012634,Occupancy rating -1 or less,31,14,4,10,17,2,8,2,4,2,7,4,3,0,0,0,0,0
S01012635,All households,430,81,30,51,334,48,245,102,113,30,41,27,14,15,9,0,0,6
S01012635,Occupancy rating +2 or more,265,41,17,24,217,39,168,86,65,17,10,6,4,7,4,0,0,3
S01012635,Occupancy rating +1,70,16,5,11,53,7,39,15,18,6,7,3,4,1,1,0,0,0
S01012635,Occupancy rating 0,66,22,6,16,41,1,25,0,21,4,15,10,5,3,2,0,0,1
S01012635,Occupancy rating -1 or less,29,2,2,0,23,1,13,1,9,3,9,8,1,4,2,0,0,2
S01012636,All households,250,49,20,29,187,24,141,61,58,22,22,15,7,14,3,0,1,10
S01012636,Occupancy rating +2 or more,151,19,8,11,124,22,98,52,33,13,4,1,3,8,1,0,1,6
S01012636,Occupancy rating +1,53,27,10,17,25,1,20,7,11,2,4,1,3,1,0,0,0,1
S01012636,Occupancy rating 0,33,2,2,0,28,1,16,2,9,5,11,10,1,3,0,0,0,3
S01012636,Occupancy rating -1 or less,13,1,0,1,10,0,7,0,5,2,3,3,0,2,2,0,0,0
S01012637,All households,365,113,49,64,238,27,145,46,74,25,66,43,23,14,4,0,2,8
S01012637,Occupancy rating +2 or more,131,61,25,36,68,17,46,31,12,3,5,2,3,2,0,0,0,2
S01012637,Occupancy rating +1,125,33,18,15,89,8,48,10,26,12,33,22,11,3,0,0,0,3
S01012637,Occupancy rating 0,87,13,6,7,69,1,46,5,31,10,22,16,6,5,3,0,2,0
S01012637,Occupancy rating -1 or less,22,6,0,6,12,1,5,0,5,0,6,3,3,4,1,0,0,3
S01012638,All households,406,150,85,65,237,34,166,65,74,27,37,25,12,19,5,0,3,11
S01012638,Occupancy rating +2 or more,135,40,18,22,92,19,67,39,21,7,6,2,4,3,1,0,0,2
S01012638,Occupancy rating +1,107,32,22,10,71,11,51,19,24,8,9,6,3,4,1,0,1,2
S01012638,Occupancy rating 0,134,64,36,28,60,3,42,6,25,11,15,12,3,10,3,0,2,5
S01012638,Occupancy rating -1 or less,30,14,9,5,14,1,6,1,4,1,7,5,2,2,0,0,0,2
S01012639,All households,360,108,62,46,238,32,163,54,77,32,43,29,14,14,5,0,3,6
S01012639,Occupancy rating +2 or more,110,34,22,12,75,19,55,32,15,8,1,1,0,1,0,0,0,1
S01012639,Occupancy rating +1,129,41,26,15,81,10,56,21,23,12,15,9,6,7,1,0,3,3
S01012639,Occupancy rating 0,89,28,13,15,59,3,39,0,30,9,17,13,4,2,2,0,0,0
S01012639,Occupancy rating -1 or less,32,5,1,4,23,0,13,1,9,3,10,6,4,4,2,0,0,2
S01012640,All households,439,148,54,94,274,36,170,79,53,38,68,45,23,17,5,0,2,10
S01012640,Occupancy rating +2 or more,122,43,13,30,77,19,53,41,5,7,5,3,2,2,1,0,0,1
S01012640,Occupancy rating +1,156,65,27,38,88,13,59,31,15,13,16,9,7,3,0,0,1,2
S01012640,Occupancy rating 0,130,39,14,25,80,2,42,7,26,9,36,25,11,11,4,0,0,7
S01012640,Occupancy rating -1 or less,31,1,0,1,29,2,16,0,7,9,11,8,3,1,0,0,1,0
S01012641,All households,484,193,118,75,274,55,174,75,71,28,45,39,6,17,3,0,3,11
S01012641,Occupancy rating +2 or more,154,39,22,17,113,32,72,41,24,7,9,9,0,2,1,0,0,1
S01012641,Occupancy rating +1,139,63,34,29,73,17,50,25,16,9,6,5,1,3,1,0,0,2
S01012641,Occupancy rating 0,133,58,32,26,67,5,39,6,25,8,23,19,4,8,1,0,3,4
S01012641,Occupancy rating -1 or less,58,33,30,3,21,1,13,3,6,4,7,6,1,4,0,0,0,4
S01012642,All households,380,139,56,83,226,27,127,51,51,25,72,48,24,15,4,0,0,11
S01012642,Occupancy rating +2 or more,79,36,17,19,42,12,27,21,2,4,3,1,2,1,0,0,0,1
S01012642,Occupancy rating +1,133,54,21,33,74,12,50,24,16,10,12,7,5,5,1,0,0,4
S01012642,Occupancy rating 0,137,40,14,26,90,2,42,6,26,10,46,31,15,7,2,0,0,5
S01012642,Occupancy rating -1 or less,31,9,4,5,20,1,8,0,7,1,11,9,2,2,1,0,0,1
S01012643,All households,199,48,24,24,143,18,98,40,38,20,27,23,4,8,1,0,0,7
S01012643,Occupancy rating +2 or more,72,34,16,18,36,11,24,21,2,1,1,1,0,2,0,0,0,2
S01012643,Occupancy rating +1,70,13,8,5,55,4,41,18,15,8,10,7,3,2,1,0,0,1
S01012643,Occupancy rating 0,46,0,0,0,44,3,28,1,18,9,13,12,1,2,0,0,0,2
S01012643,Occupancy rating -1 or less,11,1,0,1,8,0,5,0,3,2,3,3,0,2,0,0,0,2
S01012644,All households,301,89,41,48,200,25,121,40,72,9,54,31,23,12,7,0,3,2
S01012644,Occupancy rating +2 or more,97,30,17,13,63,14,47,25,19,3,2,1,1,4,1,0,2,1
S01012644,Occupancy rating +1,104,45,18,27,58,7,38,11,26,1,13,6,7,1,1,0,0,0
S01012644,Occupancy rating 0,80,13,6,7,61,4,27,2,20,5,30,18,12,6,4,0,1,1
S01012644,Occupancy rating -1 or less,20,1,0,1,18,0,9,2,7,0,9,6,3,1,1,0,0,0
S01012645,All households,368,152,72,80,207,28,157,63,73,21,22,12,10,9,6,0,1,2
S01012645,Occupancy rating +2 or more,182,49,24,25,129,17,104,47,44,13,8,3,5,4,4,0,0,0
S01012645,Occupancy rating +1,58,24,10,14,32,3,23,7,13,3,6,3,3,2,0,0,1,1
S01012645,Occupancy rating 0,107,72,37,35,35,6,24,7,12,5,5,4,1,0,0,0,0,0
S01012645,Occupancy rating -1 or less,21,7,1,6,11,2,6,2,4,0,3,2,1,3,2,0,0,1
S01012646,All households,405,112,32,80,285,39,217,78,109,30,29,16,13,8,2,0,1,5
S01012646,Occupancy rating +2 or more,228,46,11,35,179,28,142,56,72,14,9,6,3,3,1,0,1,1
S01012646,Occupancy rating +1,100,38,18,20,61,10,46,18,20,8,5,1,4,1,0,0,0,1
S01012646,Occupancy rating 0,66,26,3,23,37,0,24,4,12,8,13,7,6,3,0,0,0,3
S01012646,Occupancy rating -1 or less,11,2,0,2,8,1,5,0,5,0,2,2,0,1,1,0,0,0
S01012647,All households,269,43,5,38,213,4,188,71,107,10,21,20,1,13,5,0,0,8
S01012647,Occupancy rating +2 or more,188,34,4,30,150,4,137,67,66,4,9,8,1,4,2,0,0,2
S01012647,Occupancy rating +1,52,4,1,3,42,0,36,3,30,3,6,6,0,6,1,0,0,5
S01012647,Occupancy rating 0,23,5,0,5,16,0,12,1,10,1,4,4,0,2,1,0,0,1
S01012647,Occupancy rating -1 or less,6,0,0,0,5,0,3,0,1,2,2,2,0,1,1,0,0,0
S01012648,All households,229,63,29,34,155,19,87,29,38,20,49,30,19,11,9,0,0,2
S01012648,Occupancy rating +2 or more,87,30,14,16,56,13,33,19,8,6,10,5,5,1,1,0,0,0
S01012648,Occupancy rating +1,60,19,8,11,38,5,23,8,10,5,10,6,4,3,2,0,0,1
S01012648,Occupancy rating 0,60,14,7,7,44,1,20,2,12,6,23,15,8,2,2,0,0,0
S01012648,Occupancy rating -1 or less,22,0,0,0,17,0,11,0,8,3,6,4,2,5,4,0,0,1
S01012649,All households,267,73,30,43,183,25,123,41,55,27,35,28,7,11,5,0,3,3
S01012649,Occupancy rating +2 or more,122,31,16,15,85,19,64,25,27,12,2,1,1,6,1,0,3,2
S01012649,Occupancy rating +1,68,25,12,13,41,5,26,13,6,7,10,9,1,2,2,0,0,0
S01012649,Occupancy rating 0,59,16,2,14,42,1,27,3,18,6,14,10,4,1,0,0,0,1
S01012649,Occupancy rating -1 or less,18,1,0,1,15,0,6,0,4,2,9,8,1,2,2,0,0,0
S01012650,All households,266,83,33,50,173,21,136,68,43,25,16,10,6,10,3,0,0,7
S01012650,Occupancy rating +2 or more,136,31,14,17,101,11,85,49,21,15,5,5,0,4,1,0,0,3
S01012650,Occupancy rating +1,66,21,10,11,41,6,29,13,12,4,6,2,4,4,2,0,0,2
S01012650,Occupancy rating 0,47,22,6,16,25,2,19,5,8,6,4,2,2,0,0,0,0,0
S01012650,Occupancy rating -1 or less,17,9,3,6,6,2,3,1,2,0,1,1,0,2,0,0,0,2
S01012651,All households,327,142,62,80,174,22,103,44,40,19,49,35,14,11,5,0,0,6
S01012651,Occupancy rating +2 or more,68,28,10,18,35,7,23,14,8,1,5,3,2,5,3,0,0,2
S01012651,Occupancy rating +1,120,57,27,30,61,13,37,27,4,6,11,8,3,2,0,0,0,2
S01012651,Occupancy rating 0,108,45,19,26,61,2,33,3,21,9,26,18,8,2,0,0,0,2
S01012651,Occupancy rating -1 or less,31,12,6,6,17,0,10,0,7,3,7,6,1,2,2,0,0,0
S01012652,All households,431,98,47,51,324,41,261,111,90,60,22,14,8,9,4,0,0,5
S01012652,Occupancy rating +2 or more,279,53,30,23,224,35,178,91,48,39,11,7,4,2,1,0,0,1
S01012652,Occupancy rating +1,96,31,9,22,61,5,50,17,20,13,6,3,3,4,0,0,0,4
S01012652,Occupancy rating 0,49,13,7,6,35,1,29,3,19,7,5,4,1,1,1,0,0,0
S01012652,Occupancy rating -1 or less,7,1,1,0,4,0,4,0,3,1,0,0,0,2,2,0,0,0
S01012653,All households,363,101,28,73,242,10,171,64,77,30,61,38,23,20,11,0,0,9
S01012653,Occupancy rating +2 or more,141,42,13,29,97,7,83,41,31,11,7,4,3,2,2,0,0,0
S01012653,Occupancy rating +1,118,49,10,39,64,2,44,19,16,9,18,7,11,5,3,0,0,2
S01012653,Occupancy rating 0,79,8,4,4,64,1,33,2,21,10,30,21,9,7,2,0,0,5
S01012653,Occupancy rating -1 or less,25,2,1,1,17,0,11,2,9,0,6,6,0,6,4,0,0,2
S01012654,All households,326,105,25,80,207,32,156,61,74,21,19,11,8,14,10,0,0,4
S01012654,Occupancy rating +2 or more,187,37,10,27,141,29,103,44,48,11,9,5,4,9,7,0,0,2
S01012654,Occupancy rating +1,60,28,5,23,30,2,26,13,10,3,2,1,1,2,1,0,0,1
S01012654,Occupancy rating 0,66,35,8,27,28,1,21,3,13,5,6,3,3,3,2,0,0,1
S01012654,Occupancy rating -1 or less,13,5,2,3,8,0,6,1,3,2,2,2,0,0,0,0,0,0
S01012655,All households,454,132,47,85,292,42,197,95,71,31,53,35,18,30,14,0,2,14
S01012655,Occupancy rating +2 or more,185,28,12,16,147,23,118,69,36,13,6,4,2,10,6,0,0,4
S01012655,Occupancy rating +1,98,41,19,22,52,9,35,15,14,6,8,4,4,5,1,0,0,4
S01012655,Occupancy rating 0,119,47,12,35,66,7,37,11,16,10,22,13,9,6,1,0,1,4
S01012655,Occupancy rating -1 or less,52,16,4,12,27,3,7,0,5,2,17,14,3,9,6,0,1,2
S01012656,All households,405,175,79,96,215,30,136,48,55,33,49,33,16,15,6,0,0,9
S01012656,Occupancy rating +2 or more,94,37,19,18,55,12,36,19,11,6,7,6,1,2,2,0,0,0
S01012656,Occupancy rating +1,141,69,27,42,68,13,42,21,11,10,13,6,7,4,2,0,0,2
S01012656,Occupancy rating 0,132,58,29,29,67,4,43,5,23,15,20,14,6,7,0,0,0,7
S01012656,Occupancy rating -1 or less,38,11,4,7,25,1,15,3,10,2,9,7,2,2,2,0,0,0
S01012657,All households,272,113,50,63,153,26,89,32,44,13,38,25,13,6,3,0,1,2
S01012657,Occupancy rating +2 or more,63,21,10,11,42,12,26,12,11,3,4,3,1,0,0,0,0,0
S01012657,Occupancy rating +1,91,39,20,19,51,13,28,17,9,2,10,7,3,1,1,0,0,0
S01012657,Occupancy rating 0,101,49,18,31,48,0,30,1,23,6,18,10,8,4,2,0,1,1
S01012657,Occupancy rating -1 or less,17,4,2,2,12,1,5,2,1,2,6,5,1,1,0,0,0,1
S01012658,All households,424,132,69,63,284,40,219,91,70,58,25,16,9,8,6,0,0,2
S01012658,Occupancy rating +2 or more,164,41,25,16,122,19,99,44,33,22,4,1,3,1,1,0,0,0
S01012658,Occupancy rating +1,173,71,33,38,99,15,77,41,19,17,7,5,2,3,1,0,0,2
S01012658,Occupancy rating 0,71,17,8,9,52,3,39,6,16,17,10,8,2,2,2,0,0,0
S01012658,Occupancy rating -1 or less,16,3,3,0,11,3,4,0,2,2,4,2,2,2,2,0,0,0
S01012659,All households,366,43,11,32,314,23,261,65,162,34,30,24,6,9,3,0,0,6
S01012659,Occupancy rating +2 or more,238,27,9,18,206,19,173,52,100,21,14,12,2,5,2,0,0,3
S01012659,Occupancy rating +1,80,13,2,11,66,4,58,9,44,5,4,4,0,1,0,0,0,1
S01012659,Occupancy rating 0,36,1,0,1,33,0,24,3,13,8,9,6,3,2,0,0,0,2
S01012659,Occupancy rating -1 or less,12,2,0,2,9,0,6,1,5,0,3,2,1,1,1,0,0,0
S01012660,All households,326,124,67,57,190,16,131,48,52,31,43,28,15,12,6,0,0,6
S01012660,Occupancy rating +2 or more,116,44,16,28,71,4,56,32,13,11,11,9,2,1,1,0,0,0
S01012660,Occupancy rating +1,93,38,17,21,53,7,35,11,16,8,11,7,4,2,0,0,0,2
S01012660,Occupancy rating 0,91,36,30,6,52,4,31,4,18,9,17,11,6,3,1,0,0,2
S01012660,Occupancy rating -1 or less,26,6,4,2,14,1,9,1,5,3,4,1,3,6,4,0,0,2
S01012661,All households,324,90,34,56,222,28,156,63,51,42,38,18,20,12,7,0,1,4
S01012661,Occupancy rating +2 or more,142,23,11,12,115,17,86,39,28,19,12,5,7,4,3,0,0,1
S01012661,Occupancy rating +1,87,32,10,22,53,10,36,19,9,8,7,3,4,2,0,0,1,1
S01012661,Occupancy rating 0,74,31,12,19,40,0,26,3,13,10,14,7,7,3,1,0,0,2
S01012661,Occupancy rating -1 or less,21,4,1,3,14,1,8,2,1,5,5,3,2,3,3,0,0,0
S01012662,All households,370,145,79,66,209,26,135,70,41,24,48,32,16,16,5,2,1,8
S01012662,Occupancy rating +2 or more,95,29,16,13,65,10,52,35,10,7,3,0,3,1,0,0,0,1
S01012662,Occupancy rating +1,158,78,38,40,75,13,50,32,12,6,12,9,3,5,1,1,0,3
S01012662,Occupancy rating 0,95,32,21,11,57,3,24,2,13,9,30,21,9,6,2,0,1,3
S01012662,Occupancy rating -1 or less,22,6,4,2,12,0,9,1,6,2,3,2,1,4,2,1,0,1
S01012663,All households,301,70,32,38,220,40,156,70,50,36,24,17,7,11,4,0,1,6
S01012663,Occupancy rating +2 or more,144,23,13,10,119,26,86,48,20,18,7,4,3,2,1,0,0,1
S01012663,Occupancy rating +1,90,28,10,18,57,9,44,18,14,12,4,3,1,5,2,0,0,3
S01012663,Occupancy rating 0,54,16,6,10,34,4,20,4,11,5,10,8,2,4,1,0,1,2
S01012663,Occupancy rating -1 or less,13,3,3,0,10,1,6,0,5,1,3,2,1,0,0,0,0,0
S01012664,All households,462,210,77,133,244,36,165,69,67,29,43,29,14,8,3,0,1,4
S01012664,Occupancy rating +2 or more,150,54,21,33,92,17,70,32,24,14,5,4,1,4,2,0,0,2
S01012664,Occupancy rating +1,127,57,27,30,68,15,43,21,19,3,10,5,5,2,0,0,1,1
S01012664,Occupancy rating 0,151,90,28,62,60,2,36,12,18,6,22,17,5,1,1,0,0,0
S01012664,Occupancy rating -1 or less,34,9,1,8,24,2,16,4,6,6,6,3,3,1,0,0,0,1
S01012665,All households,346,122,45,77,210,30,110,51,41,18,70,57,13,14,8,0,1,5
S01012665,Occupancy rating +2 or more,73,30,15,15,43,12,29,20,5,4,2,1,1,0,0,0,0,0
S01012665,Occupancy rating +1,115,57,19,38,53,12,30,22,7,1,11,6,5,5,1,0,1,3
S01012665,Occupancy rating 0,120,27,8,19,87,4,38,6,21,11,45,41,4,6,4,0,0,2
S01012665,Occupancy rating -1 or less,38,8,3,5,27,2,13,3,8,2,12,9,3,3,3,0,0,0
S01012666,All households,337,133,57,76,193,29,108,60,27,21,56,39,17,11,2,0,0,9
S01012666,Occupancy rating +2 or more,38,16,5,11,22,7,15,11,1,3,0,0,0,0,0,0,0,0
S01012666,Occupancy rating +1,140,65,30,35,74,18,52,41,7,4,4,1,3,1,0,0,0,1
S01012666,Occupancy rating 0,115,41,16,25,66,2,27,5,13,9,37,26,11,8,0,0,0,8
S01012666,Occupancy rating -1 or less,44,11,6,5,31,2,14,3,6,5,15,12,3,2,2,0,0,0
S01012667,All households,279,107,39,68,163,28,83,25,38,20,52,34,18,9,3,0,0,6
S01012667,Occupancy rating +2 or more,68,25,9,16,43,13,27,17,4,6,3,0,3,0,0,0,0,0
S01012667,Occupancy rating +1,86,34,13,21,50,12,22,7,9,6,16,8,8,2,0,0,0,2
S01012667,Occupancy rating 0,94,41,11,30,50,1,26,1,18,7,23,19,4,3,0,0,0,3
S01012667,Occupancy rating -1 or less,31,7,6,1,20,2,8,0,7,1,10,7,3,4,3,0,0,1
S01012668,All households,347,128,52,76,202,17,127,46,62,19,58,38,20,17,11,0,0,6
S01012668,Occupancy rating +2 or more,86,44,17,27,42,5,35,23,8,4,2,2,0,0,0,0,0,0
S01012668,Occupancy rating +1,127,53,27,26,72,10,47,18,20,9,15,10,5,2,1,0,0,1
S01012668,Occupancy rating 0,98,24,8,16,66,2,37,5,27,5,27,19,8,8,5,0,0,3
S01012668,Occupancy rating -1 or less,36,7,0,7,22,0,8,0,7,1,14,7,7,7,5,0,0,2
S01012669,All households,296,53,32,21,239,42,167,68,62,37,30,15,15,4,1,0,0,3
S01012669,Occupancy rating +2 or more,167,30,22,8,135,38,86,57,19,10,11,6,5,2,0,0,0,2
S01012669,Occupancy rating +1,81,20,9,11,61,3,51,11,24,16,7,3,4,0,0,0,0,0
S01012669,Occupancy rating 0,38,3,1,2,35,1,25,0,15,10,9,4,5,0,0,0,0,0
S01012669,Occupancy rating -1 or less,10,0,0,0,8,0,5,0,4,1,3,2,1,2,1,0,0,1
S01012670,All households,295,62,40,22,227,46,162,65,61,36,19,10,9,6,2,0,0,4
S01012670,Occupancy rating +2 or more,180,35,24,11,140,41,93,55,22,16,6,3,3,5,2,0,0,3
S01012670,Occupancy rating +1,60,21,13,8,38,5,31,9,15,7,2,1,1,1,0,0,0,1
S01012670,Occupancy rating 0,48,5,3,2,43,0,33,1,21,11,10,5,5,0,0,0,0,0
S01012670,Occupancy rating -1 or less,7,1,0,1,6,0,5,0,3,2,1,1,0,0,0,0,0,0
S01012671,All households,388,113,50,63,260,30,180,69,73,38,50,38,12,15,8,0,1,6
S01012671,Occupancy rating +2 or more,122,40,13,27,79,14,62,36,18,8,3,1,2,3,0,0,1,2
S01012671,Occupancy rating +1,126,51,24,27,73,9,56,29,16,11,8,7,1,2,1,0,0,1
S01012671,Occupancy rating 0,102,17,9,8,84,7,48,3,28,17,29,23,6,1,0,0,0,1
S01012671,Occupancy rating -1 or less,38,5,4,1,24,0,14,1,11,2,10,7,3,9,7,0,0,2
S01012672,All households,361,152,56,96,199,17,109,43,45,21,73,45,28,10,4,0,2,4
S01012672,Occupancy rating +2 or more,61,20,8,12,38,7,26,18,3,5,5,4,1,3,1,0,1,1
S01012672,Occupancy rating +1,132,81,32,49,51,9,28,17,6,5,14,6,8,0,0,0,0,0
S01012672,Occupancy rating 0,119,34,9,25,81,1,42,8,27,7,38,24,14,4,1,0,1,2
S01012672,Occupancy rating -1 or less,49,17,7,10,29,0,13,0,9,4,16,11,5,3,2,0,0,1
S01012673,All households,252,60,24,36,182,7,95,48,21,26,80,52,28,10,4,0,2,4
S01012673,Occupancy rating +2 or more,78,33,16,17,43,5,34,31,2,1,4,3,1,2,0,0,0,2
S01012673,Occupancy rating +1,88,21,7,14,66,2,33,14,6,13,31,18,13,1,0,0,1,0
S01012673,Occupancy rating 0,63,6,1,5,52,0,19,1,10,8,33,22,11,5,3,0,1,1
S01012673,Occupancy rating -1 or less,23,0,0,0,21,0,9,2,3,4,12,9,3,2,1,0,0,1
S01012674,All households,240,73,29,44,150,8,86,30,44,12,56,33,23,17,10,0,0,7
S01012674,Occupancy rating +2 or more,93,41,20,21,51,5,38,25,8,5,8,4,4,1,0,0,0,1
S01012674,Occupancy rating +1,62,18,7,11,40,2,17,4,9,4,21,13,8,4,1,0,0,3
S01012674,Occupancy rating 0,56,11,2,9,40,1,22,1,20,1,17,9,8,5,3,0,0,2
S01012674,Occupancy rating -1 or less,29,3,0,3,19,0,9,0,7,2,10,7,3,7,6,0,0,1
S01012675,All households,361,121,38,83,218,19,132,53,44,35,67,41,26,22,6,0,2,14
S01012675,Occupancy rating +2 or more,69,21,5,16,45,4,36,24,7,5,5,2,3,3,0,0,0,3
S01012675,Occupancy rating +1,131,55,18,37,70,10,42,23,11,8,18,8,10,6,1,0,1,4
S01012675,Occupancy rating 0,117,40,12,28,71,4,33,2,16,15,34,25,9,6,1,0,0,5
S01012675,Occupancy rating -1 or less,44,5,3,2,32,1,21,4,10,7,10,6,4,7,4,0,1,2
S01012676,All households,307,58,23,35,228,19,157,45,77,35,52,38,14,21,8,0,1,12
S01012676,Occupancy rating +2 or more,124,42,18,24,75,16,55,32,15,8,4,1,3,7,0,0,0,7
S01012676,Occupancy rating +1,97,12,4,8,81,2,50,9,32,9,29,21,8,4,1,0,1,2
S01012676,Occupancy rating 0,65,2,1,1,58,1,43,4,24,15,14,11,3,5,3,0,0,2
S01012676,Occupancy rating -1 or less,21,2,0,2,14,0,9,0,6,3,5,5,0,5,4,0,0,1
S01012677,All households,256,79,32,47,170,21,109,50,39,20,40,20,20,7,5,0,0,2
S01012677,Occupancy rating +2 or more,67,21,8,13,46,12,29,21,2,6,5,0,5,0,0,0,0,0
S01012677,Occupancy rating +1,84,32,17,15,51,5,37,23,8,6,9,6,3,1,0,0,0,1
S01012677,Occupancy rating 0,70,21,5,16,49,4,29,4,19,6,16,6,10,0,0,0,0,0
S01012677,Occupancy rating -1 or less,35,5,2,3,24,0,14,2,10,2,10,8,2,6,5,0,0,1
S01012678,All households,268,41,15,26,219,17,170,67,78,25,32,23,9,8,6,0,0,2
S01012678,Occupancy rating +2 or more,166,34,10,24,132,14,107,65,32,10,11,8,3,0,0,0,0,0
S01012678,Occupancy rating +1,59,4,3,1,52,2,38,2,29,7,12,7,5,3,2,0,0,1
S01012678,Occupancy rating 0,36,3,2,1,29,1,19,0,12,7,9,8,1,4,3,0,0,1
S01012678,Occupancy rating -1 or less,7,0,0,0,6,0,6,0,5,1,0,0,0,1,1,0,0,0
S01012679,All households,372,124,55,69,234,43,158,77,56,25,33,21,12,14,7,0,1,6
S01012679,Occupancy rating +2 or more,155,27,10,17,122,28,93,53,32,8,1,0,1,6,3,0,1,2
S01012679,Occupancy rating +1,73,23,11,12,49,9,34,15,10,9,6,4,2,1,0,0,0,1
S01012679,Occupancy rating 0,120,63,27,36,54,6,27,8,12,7,21,15,6,3,1,0,0,2
S01012679,Occupancy rating -1 or less,24,11,7,4,9,0,4,1,2,1,5,2,3,4,3,0,0,1
S01012680,All households,210,37,19,18,168,17,134,44,64,26,17,12,5,5,4,0,1,0
S01012680,Occupancy rating +2 or more,148,19,10,9,127,14,107,42,52,13,6,2,4,2,2,0,0,0
S01012680,Occupancy rating +1,38,12,7,5,26,3,18,0,8,10,5,4,1,0,0,0,0,0
S01012680,Occupancy rating 0,16,6,2,4,8,0,5,2,1,2,3,3,0,2,2,0,0,0
S01012680,Occupancy rating -1 or less,8,0,0,0,7,0,4,0,3,1,3,3,0,1,0,0,1,0
S01012681,All households,311,104,47,57,197,26,136,61,58,17,35,23,12,10,7,0,0,3
S01012681,Occupancy rating +2 or more,143,41,23,18,100,18,73,33,31,9,9,7,2,2,2,0,0,0
S01012681,Occupancy rating +1,82,31,17,14,48,8,32,18,9,5,8,5,3,3,2,0,0,1
S01012681,Occupancy rating 0,56,23,7,16,30,0,19,6,10,3,11,6,5,3,1,0,0,2
S01012681,Occupancy rating -1 or less,30,9,0,9,19,0,12,4,8,0,7,5,2,2,2,0,0,0
S01012682,All households,315,100,62,38,203,45,141,64,48,29,17,11,6,12,4,0,1,7
S01012682,Occupancy rating +2 or more,178,37,23,14,136,34,96,48,31,17,6,4,2,5,2,0,1,2
S01012682,Occupancy rating +1,69,29,17,12,38,7,27,11,8,8,4,2,2,2,1,0,0,1
S01012682,Occupancy rating 0,53,29,19,10,21,3,14,4,7,3,4,3,1,3,0,0,0,3
S01012682,Occupancy rating -1 or less,15,5,3,2,8,1,4,1,2,1,3,2,1,2,1,0,0,1
S01012683,All households,326,99,24,75,212,7,155,69,63,23,50,34,16,15,7,0,1,7
S01012683,Occupancy rating +2 or more,143,48,14,34,92,4,79,51,18,10,9,6,3,3,0,0,0,3
S01012683,Occupancy rating +1,106,31,3,28,72,3,51,15,25,11,18,11,7,3,2,0,0,1
S01012683,Occupancy rating 0,62,16,5,11,41,0,20,2,16,2,21,16,5,5,1,0,1,3
S01012683,Occupancy rating -1 or less,15,4,2,2,7,0,5,1,4,0,2,1,1,4,4,0,0,0
S01012684,All households,219,67,16,51,144,18,104,35,56,13,22,17,5,8,4,0,0,4
S01012684,Occupancy rating +2 or more,104,26,6,20,76,10,59,20,32,7,7,5,2,2,1,0,0,1
S01012684,Occupancy rating +1,82,35,8,27,45,7,35,14,17,4,3,3,0,2,1,0,0,1
S01012684,Occupancy rating 0,29,6,2,4,20,1,8,1,6,1,11,8,3,3,1,0,0,2
S01012684,Occupancy rating -1 or less,4,0,0,0,3,0,2,0,1,1,1,1,0,1,1,0,0,0
S01012685,All households,334,98,40,58,224,15,153,66,62,25,56,38,18,12,6,0,0,6
S01012685,Occupancy rating +2 or more,100,37,21,16,63,10,50,34,12,4,3,3,0,0,0,0,0,0
S01012685,Occupancy rating +1,112,40,14,26,70,5,49,30,12,7,16,8,8,2,0,0,0,2
S01012685,Occupancy rating 0,90,19,4,15,67,0,38,2,23,13,29,20,9,4,2,0,0,2
S01012685,Occupancy rating -1 or less,32,2,1,1,24,0,16,0,15,1,8,7,1,6,4,0,0,2
S01012686,All households,434,146,58,88,273,47,198,86,82,30,28,19,9,15,8,0,1,6
S01012686,Occupancy rating +2 or more,254,58,34,24,190,41,141,62,55,24,8,4,4,6,4,0,0,2
S01012686,Occupancy rating +1,92,42,19,23,48,4,36,16,15,5,8,5,3,2,2,0,0,0
S01012686,Occupancy rating 0,64,40,4,36,20,1,11,6,5,0,8,7,1,4,1,0,0,3
S01012686,Occupancy rating -1 or less,24,6,1,5,15,1,10,2,7,1,4,3,1,3,1,0,1,1
S01012687,All households,235,60,42,18,166,59,100,43,41,16,7,5,2,9,3,0,0,6
S01012687,Occupancy rating +2 or more,211,54,38,16,148,58,87,41,33,13,3,2,1,9,3,0,0,6
S01012687,Occupancy rating +1,10,2,2,0,8,1,6,1,3,2,1,1,0,0,0,0,0,0
S01012687,Occupancy rating 0,13,4,2,2,9,0,7,1,5,1,2,1,1,0,0,0,0,0
S01012687,Occupancy rating -1 or less,1,0,0,0,1,0,0,0,0,0,1,1,0,0,0,0,0,0
S01012688,All households,449,242,101,141,194,31,130,68,41,21,33,24,9,13,3,0,1,9
S01012688,Occupancy rating +2 or more,135,49,26,23,81,16,61,27,21,13,4,2,2,5,2,0,0,3
S01012688,Occupancy rating +1,143,89,38,51,52,12,34,20,10,4,6,4,2,2,0,0,0,2
S01012688,Occupancy rating 0,127,78,30,48,46,3,27,14,9,4,16,13,3,3,0,0,1,2
S01012688,Occupancy rating -1 or less,44,26,7,19,15,0,8,7,1,0,7,5,2,3,1,0,0,2
S01012689,All households,185,30,19,11,148,21,106,49,38,19,21,14,7,7,6,0,1,0
S01012689,Occupancy rating +2 or more,146,27,16,11,116,21,87,46,28,13,8,5,3,3,2,0,1,0
S01012689,Occupancy rating +1,18,2,2,0,16,0,10,2,4,4,6,4,2,0,0,0,0,0
S01012689,Occupancy rating 0,15,1,1,0,11,0,6,0,5,1,5,4,1,3,3,0,0,0
S01012689,Occupancy rating -1 or less,6,0,0,0,5,0,3,1,1,1,2,1,1,1,1,0,0,0
S01012690,All households,202,30,12,18,168,27,125,45,55,25,16,7,9,4,2,0,0,2
S01012690,Occupancy rating +2 or more,136,26,10,16,109,22,83,39,32,12,4,1,3,1,1,0,0,0
S01012690,Occupancy rating +1,41,4,2,2,36,5,27,6,13,8,4,2,2,1,0,0,0,1
S01012690,Occupancy rating 0,24,0,0,0,22,0,14,0,9,5,8,4,4,2,1,0,0,1
S01012690,Occupancy rating -1 or less,1,0,0,0,1,0,1,0,1,0,0,0,0,0,0,0,0,0
S01012691,All households,296,71,32,39,216,36,154,42,85,27,26,18,8,9,6,0,1,2
S01012691,Occupancy rating +2 or more,215,28,14,14,182,33,132,33,76,23,17,12,5,5,4,0,0,1
S01012691,Occupancy rating +1,53,30,16,14,22,3,16,6,6,4,3,3,0,1,0,0,1,0
S01012691,Occupancy rating 0,18,10,1,9,7,0,3,0,3,0,4,2,2,1,0,0,0,1
S01012691,Occupancy rating -1 or less,10,3,1,2,5,0,3,3,0,0,2,1,1,2,2,0,0,0
S01012692,All households,334,108,64,44,218,25,151,63,61,27,42,27,15,8,3,0,2,3
S01012692,Occupancy rating +2 or more,140,25,15,10,112,14,92,45,36,11,6,1,5,3,0,0,1,2
S01012692,Occupancy rating +1,93,43,20,23,49,8,34,12,16,6,7,4,3,1,1,0,0,0
S01012692,Occupancy rating 0,83,34,25,9,45,1,20,5,7,8,24,19,5,4,2,0,1,1
S01012692,Occupancy rating -1 or less,18,6,4,2,12,2,5,1,2,2,5,3,2,0,0,0,0,0
S01012693,All households,321,39,15,24,275,28,222,76,112,34,25,20,5,7,3,0,2,2
S01012693,Occupancy rating +2 or more,280,34,14,20,242,25,201,73,98,30,16,11,5,4,2,0,1,1
S01012693,Occupancy rating +1,22,4,1,3,17,2,10,1,6,3,5,5,0,1,1,0,0,0
S01012693,Occupancy rating 0,15,1,0,1,12,1,7,1,5,1,4,4,0,2,0,0,1,1
S01012693,Occupancy rating -1 or less,4,0,0,0,4,0,4,1,3,0,0,0,0,0,0,0,0,0
S01012694,All households,200,51,24,27,143,17,108,48,50,10,18,14,4,6,2,0,0,4
S01012694,Occupancy rating +2 or more,101,16,9,7,82,8,68,31,34,3,6,3,3,3,0,0,0,3
S01012694,Occupancy rating +1,50,17,7,10,32,6,25,13,10,2,1,1,0,1,1,0,0,0
S01012694,Occupancy rating 0,42,16,7,9,26,3,14,3,6,5,9,8,1,0,0,0,0,0
S01012694,Occupancy rating -1 or less,7,2,1,1,3,0,1,1,0,0,2,2,0,2,1,0,0,1
S01012695,All households,306,52,19,33,242,33,185,73,82,30,24,14,10,12,5,0,1,6
S01012695,Occupancy rating +2 or more,209,34,8,26,169,30,128,60,51,17,11,5,6,6,2,0,1,3
S01012695,Occupancy rating +1,58,17,10,7,39,1,32,10,15,7,6,5,1,2,1,0,0,1
S01012695,Occupancy rating 0,28,0,0,0,24,1,17,2,10,5,6,3,3,4,2,0,0,2
S01012695,Occupancy rating -1 or less,11,1,1,0,10,1,8,1,6,1,1,1,0,0,0,0,0,0
S01012696,All households,272,60,22,38,200,24,163,64,68,31,13,7,6,12,6,0,1,5
S01012696,Occupancy rating +2 or more,209,46,17,29,158,23,125,58,48,19,10,4,6,5,2,0,1,2
S01012696,Occupancy rating +1,45,11,4,7,31,1,27,5,14,8,3,3,0,3,2,0,0,1
S01012696,Occupancy rating 0,11,0,0,0,8,0,8,0,6,2,0,0,0,3,1,0,0,2
S01012696,Occupancy rating -1 or less,7,3,1,2,3,0,3,1,0,2,0,0,0,1,1,0,0,0
S01012697,All households,197,34,14,20,155,24,114,49,47,18,17,9,8,8,6,0,0,2
S01012697,Occupancy rating +2 or more,146,22,10,12,121,22,93,43,35,15,6,3,3,3,1,0,0,2
S01012697,Occupancy rating +1,31,10,4,6,19,1,13,6,5,2,5,2,3,2,2,0,0,0
S01012697,Occupancy rating 0,14,1,0,1,10,0,6,0,6,0,4,3,1,3,3,0,0,0
S01012697,Occupancy rating -1 or less,6,1,0,1,5,1,2,0,1,1,2,1,1,0,0,0,0,0
S01012698,All households,339,89,35,54,241,42,174,97,46,31,25,10,15,9,5,0,1,3
S01012698,Occupancy rating +2 or more,243,49,21,28,189,37,140,81,34,25,12,5,7,5,2,0,1,2
S01012698,Occupancy rating +1,52,16,8,8,34,5,24,15,5,4,5,1,4,2,2,0,0,0
S01012698,Occupancy rating 0,37,21,6,15,15,0,9,1,6,2,6,3,3,1,0,0,0,1
S01012698,Occupancy rating -1 or less,7,3,0,3,3,0,1,0,1,0,2,1,1,1,1,0,0,0
S01012699,All households,429,108,58,50,304,32,218,86,89,43,54,39,15,17,6,0,1,10
S01012699,Occupancy rating +2 or more,266,53,26,27,203,26,154,69,54,31,23,14,9,10,3,0,1,6
S01012699,Occupancy rating +1,92,37,22,15,53,6,38,15,16,7,9,7,2,2,1,0,0,1
S01012699,Occupancy rating 0,49,15,9,6,32,0,19,2,16,1,13,10,3,2,0,0,0,2
S01012699,Occupancy rating -1 or less,22,3,1,2,16,0,7,0,3,4,9,8,1,3,2,0,0,1
S01012700,All households,320,75,30,45,234,38,171,53,85,33,25,18,7,11,4,0,1,6
S01012700,Occupancy rating +2 or more,205,38,16,22,158,27,120,48,56,16,11,6,5,9,3,0,0,6
S01012700,Occupancy rating +1,69,27,13,14,41,8,28,4,16,8,5,4,1,1,0,0,1,0
S01012700,Occupancy rating 0,34,10,1,9,24,2,16,1,9,6,6,6,0,0,0,0,0,0
S01012700,Occupancy rating -1 or less,12,0,0,0,11,1,7,0,4,3,3,2,1,1,1,0,0,0
S01012701,All households,221,39,23,16,177,39,118,38,52,28,20,9,11,5,2,0,0,3
S01012701,Occupancy rating +2 or more,152,27,16,11,123,37,74,33,25,16,12,3,9,2,0,0,0,2
S01012701,Occupancy rating +1,42,9,6,3,31,2,26,5,13,8,3,2,1,2,1,0,0,1
S01012701,Occupancy rating 0,20,3,1,2,16,0,12,0,8,4,4,3,1,1,1,0,0,0
S01012701,Occupancy rating -1 or less,7,0,0,0,7,0,6,0,6,0,1,1,0,0,0,0,0,0
S01012702,All households,254,76,29,47,157,15,125,55,53,17,17,11,6,21,6,0,1,14
S01012702,Occupancy rating +2 or more,132,34,13,21,94,8,81,36,34,11,5,3,2,4,0,0,0,4
S01012702,Occupancy rating +1,68,25,7,18,38,5,30,18,8,4,3,2,1,5,2,0,0,3
S01012702,Occupancy rating 0,37,14,8,6,15,0,8,0,6,2,7,4,3,8,3,0,0,5
S01012702,Occupancy rating -1 or less,17,3,1,2,10,2,6,1,5,0,2,2,0,4,1,0,1,2
S01012703,All households,205,30,10,20,169,4,150,40,83,27,15,11,4,6,3,0,0,3
S01012703,Occupancy rating +2 or more,132,19,5,14,111,2,101,37,52,12,8,7,1,2,1,0,0,1
S01012703,Occupancy rating +1,42,7,3,4,34,2,31,3,18,10,1,1,0,1,0,0,0,1
S01012703,Occupancy rating 0,21,2,2,0,19,0,14,0,11,3,5,3,2,0,0,0,0,0
S01012703,Occupancy rating -1 or less,10,2,0,2,5,0,4,0,2,2,1,0,1,3,2,0,0,1
S01012704,All households,329,104,38,66,212,17,138,35,72,31,57,38,19,13,8,0,1,4
S01012704,Occupancy rating +2 or more,62,31,11,20,31,7,23,13,6,4,1,0,1,0,0,0,0,0
S01012704,Occupancy rating +1,103,33,13,20,69,8,54,15,27,12,7,5,2,1,0,0,0,1
S01012704,Occupancy rating 0,124,33,8,25,82,1,51,5,32,14,30,19,11,9,6,0,0,3
S01012704,Occupancy rating -1 or less,40,7,6,1,30,1,10,2,7,1,19,14,5,3,2,0,1,0
S01012705,All households,257,30,8,22,221,10,194,43,117,34,17,13,4,6,3,0,0,3
S01012705,Occupancy rating +2 or more,178,23,6,17,153,9,137,40,74,23,7,6,1,2,1,0,0,1
S01012705,Occupancy rating +1,48,5,1,4,42,1,34,3,23,8,7,4,3,1,0,0,0,1
S01012705,Occupancy rating 0,21,2,1,1,18,0,15,0,13,2,3,3,0,1,1,0,0,0
S01012705,Occupancy rating -1 or less,10,0,0,0,8,0,8,0,7,1,0,0,0,2,1,0,0,1
S01012706,All households,297,94,41,53,187,14,122,46,52,24,51,36,15,16,4,0,1,11
S01012706,Occupancy rating +2 or more,80,29,17,12,48,7,34,24,6,4,7,5,2,3,1,0,0,2
S01012706,Occupancy rating +1,101,44,15,29,53,5,35,19,9,7,13,9,4,4,0,0,0,4
S01012706,Occupancy rating 0,82,16,8,8,61,2,38,2,25,11,21,16,5,5,1,0,1,3
S01012706,Occupancy rating -1 or less,34,5,1,4,25,0,15,1,12,2,10,6,4,4,2,0,0,2
S01012707,All households,322,48,18,30,266,29,218,69,99,50,19,9,10,8,5,0,0,3
S01012707,Occupancy rating +2 or more,203,36,14,22,165,28,133,59,49,25,4,2,2,2,1,0,0,1
S01012707,Occupancy rating +1,71,11,4,7,60,0,52,9,26,17,8,4,4,0,0,0,0,0
S01012707,Occupancy rating 0,41,1,0,1,36,1,30,1,21,8,5,2,3,4,3,0,0,1
S01012707,Occupancy rating -1 or less,7,0,0,0,5,0,3,0,3,0,2,1,1,2,1,0,0,1
S01012708,All households,332,108,43,65,209,22,113,44,49,20,74,43,31,15,8,0,0,7
S01012708,Occupancy rating +2 or more,64,21,9,12,40,8,28,16,11,1,4,2,2,3,0,0,0,3
S01012708,Occupancy rating +1,125,56,21,35,66,6,50,25,15,10,10,5,5,3,2,0,0,1
S01012708,Occupancy rating 0,104,23,9,14,74,6,26,2,19,5,42,26,16,7,5,0,0,2
S01012708,Occupancy rating -1 or less,39,8,4,4,29,2,9,1,4,4,18,10,8,2,1,0,0,1
S01012709,All households,253,101,53,48,152,25,91,41,29,21,36,23,13,0,0,0,0,0
S01012709,Occupancy rating +2 or more,88,30,17,13,58,14,39,25,7,7,5,1,4,0,0,0,0,0
S01012709,Occupancy rating +1,82,33,9,24,49,4,34,15,12,7,11,7,4,0,0,0,0,0
S01012709,Occupancy rating 0,62,29,23,6,33,7,12,0,8,4,14,11,3,0,0,0,0,0
S01012709,Occupancy rating -1 or less,21,9,4,5,12,0,6,1,2,3,6,4,2,0,0,0,0,0
S01012710,All households,356,151,65,86,193,22,125,60,42,23,46,29,17,12,2,0,4,6
S01012710,Occupancy rating +2 or more,83,28,14,14,53,6,44,26,13,5,3,1,2,2,0,0,0,2
S01012710,Occupancy rating +1,112,54,15,39,55,9,38,22,11,5,8,4,4,3,0,0,1,2
S01012710,Occupancy rating 0,120,46,19,27,70,2,37,11,14,12,31,22,9,4,0,0,2,2
S01012710,Occupancy rating -1 or less,41,23,17,6,15,5,6,1,4,1,4,2,2,3,2,0,1,0
S01012711,All households,435,228,56,172,192,29,99,43,32,24,64,36,28,15,8,0,1,6
S01012711,Occupancy rating +2 or more,104,52,15,37,50,13,33,20,11,2,4,1,3,2,0,0,1,1
S01012711,Occupancy rating +1,151,90,21,69,59,15,32,16,6,10,12,5,7,2,1,0,0,1
S01012711,Occupancy rating 0,138,72,16,56,58,0,25,6,8,11,33,20,13,8,5,0,0,3
S01012711,Occupancy rating -1 or less,42,14,4,10,25,1,9,1,7,1,15,10,5,3,2,0,0,1
S01012712,All households,335,71,53,18,253,56,175,61,81,33,22,14,8,11,9,0,0,2
S01012712,Occupancy rating +2 or more,264,68,51,17,191,52,133,59,51,23,6,4,2,5,3,0,0,2
S01012712,Occupancy rating +1,43,3,2,1,39,3,25,1,18,6,11,8,3,1,1,0,0,0
S01012712,Occupancy rating 0,20,0,0,0,17,0,14,1,11,2,3,2,1,3,3,0,0,0
S01012712,Occupancy rating -1 or less,8,0,0,0,6,1,3,0,1,2,2,0,2,2,2,0,0,0
S01012713,All households,329,120,76,44,194,40,137,50,58,29,17,7,10,15,5,0,0,10
S01012713,Occupancy rating +2 or more,191,58,45,13,124,33,84,36,33,15,7,4,3,9,3,0,0,6
S01012713,Occupancy rating +1,86,40,19,21,44,6,33,13,13,7,5,0,5,2,1,0,0,1
S01012713,Occupancy rating 0,43,17,10,7,22,1,17,1,10,6,4,2,2,4,1,0,0,3
S01012713,Occupancy rating -1 or less,9,5,2,3,4,0,3,0,2,1,1,1,0,0,0,0,0,0
S01012714,All households,264,66,38,28,191,50,123,44,48,31,18,2,16,7,3,0,2,2
S01012714,Occupancy rating +2 or more,193,48,29,19,141,48,89,40,26,23,4,0,4,4,1,0,2,1
S01012714,Occupancy rating +1,40,6,4,2,32,2,22,3,13,6,8,1,7,2,1,0,0,1
S01012714,Occupancy rating 0,24,10,4,6,13,0,9,1,7,1,4,1,3,1,1,0,0,0
S01012714,Occupancy rating -1 or less,7,2,1,1,5,0,3,0,2,1,2,0,2,0,0,0,0,0
S01012715,All households,411,220,74,146,171,31,96,55,27,14,44,27,17,20,6,0,0,14
S01012715,Occupancy rating +2 or more,88,31,11,20,55,14,33,23,7,3,8,4,4,2,0,0,0,2
S01012715,Occupancy rating +1,149,87,36,51,57,15,34,20,7,7,8,5,3,5,2,0,0,3
S01012715,Occupancy rating 0,131,82,21,61,44,1,22,9,11,2,21,15,6,5,0,0,0,5
S01012715,Occupancy rating -1 or less,43,20,6,14,15,1,7,3,2,2,7,3,4,8,4,0,0,4
S01012716,All households,369,114,53,61,241,64,150,68,52,30,27,10,17,14,2,3,0,9
S01012716,Occupancy rating +2 or more,252,55,35,20,193,56,118,53,41,24,19,10,9,4,1,0,0,3
S01012716,Occupancy rating +1,58,28,4,24,28,4,20,8,8,4,4,0,4,2,0,0,0,2
S01012716,Occupancy rating 0,52,29,13,16,17,4,11,7,3,1,2,0,2,6,0,3,0,3
S01012716,Occupancy rating -1 or less,7,2,1,1,3,0,1,0,0,1,2,0,2,2,1,0,0,1
S01012717,All households,581,339,150,189,223,44,137,79,35,23,42,18,24,19,1,0,2,16
S01012717,Occupancy rating +2 or more,142,58,35,23,80,18,58,26,22,10,4,0,4,4,1,0,1,2
S01012717,Occupancy rating +1,163,97,34,63,64,13,46,37,5,4,5,2,3,2,0,0,0,2
S01012717,Occupancy rating 0,212,148,73,75,55,10,24,11,7,6,21,8,13,9,0,0,1,8
S01012717,Occupancy rating -1 or less,64,36,8,28,24,3,9,5,1,3,12,8,4,4,0,0,0,4
S01012718,All households,489,207,74,133,257,32,177,101,54,22,48,25,23,25,7,0,1,17
S01012718,Occupancy rating +2 or more,171,64,31,33,101,19,76,48,19,9,6,1,5,6,3,0,0,3
S01012718,Occupancy rating +1,175,86,30,56,83,11,60,40,17,3,12,6,6,6,0,0,0,6
S01012718,Occupancy rating 0,112,47,8,39,59,1,36,13,15,8,22,12,10,6,1,0,1,4
S01012718,Occupancy rating -1 or less,31,10,5,5,14,1,5,0,3,2,8,6,2,7,3,0,0,4
S01012719,All households,438,230,54,176,183,27,121,69,41,11,35,21,14,25,4,3,0,18
S01012719,Occupancy rating +2 or more,89,34,14,20,54,8,41,22,13,6,5,3,2,1,0,0,0,1
S01012719,Occupancy rating +1,143,88,18,70,52,12,36,26,7,3,4,1,3,3,1,0,0,2
S01012719,Occupancy rating 0,154,84,13,71,58,5,35,18,15,2,18,12,6,12,2,2,0,8
S01012719,Occupancy rating -1 or less,52,24,9,15,19,2,9,3,6,0,8,5,3,9,1,1,0,7
S01012720,All households,318,194,22,172,109,12,83,56,21,6,14,11,3,15,1,3,0,11
S01012720,Occupancy rating +2 or more,48,12,5,7,35,6,26,14,8,4,3,2,1,1,0,0,0,1
S01012720,Occupancy rating +1,85,56,6,50,26,3,23,17,5,1,0,0,0,3,0,0,0,3
S01012720,Occupancy rating 0,157,120,10,110,34,3,26,24,2,0,5,4,1,3,0,0,0,3
S01012720,Occupancy rating -1 or less,28,6,1,5,14,0,8,1,6,1,6,5,1,8,1,3,0,4
S01012721,All households,288,88,52,36,193,32,134,46,56,32,27,16,11,7,3,0,2,2
S01012721,Occupancy rating +2 or more,107,33,17,16,73,21,49,27,10,12,3,1,2,1,0,0,0,1
S01012721,Occupancy rating +1,89,31,19,12,57,9,42,16,17,9,6,2,4,1,0,0,1,0
S01012721,Occupancy rating 0,73,21,14,7,50,0,37,3,23,11,13,9,4,2,0,0,1,1
S01012721,Occupancy rating -1 or less,19,3,2,1,13,2,6,0,6,0,5,4,1,3,3,0,0,0
S01012722,All households,413,219,55,164,176,22,98,43,42,13,56,36,20,18,6,0,0,12
S01012722,Occupancy rating +2 or more,46,23,13,10,21,1,17,10,5,2,3,0,3,2,0,0,0,2
S01012722,Occupancy rating +1,117,63,18,45,52,14,32,22,7,3,6,4,2,2,0,0,0,2
S01012722,Occupancy rating 0,190,106,19,87,78,6,38,9,22,7,34,23,11,6,4,0,0,2
S01012722,Occupancy rating -1 or less,60,27,5,22,25,1,11,2,8,1,13,9,4,8,2,0,0,6
S01012723,All households,358,179,60,119,163,23,87,35,31,21,53,34,19,16,8,0,0,8
S01012723,Occupancy rating +2 or more,50,15,9,6,34,9,23,14,6,3,2,1,1,1,0,0,0,1
S01012723,Occupancy rating +1,92,56,17,39,33,8,19,12,4,3,6,2,4,3,2,0,0,1
S01012723,Occupancy rating 0,166,94,26,68,65,6,31,8,12,11,28,17,11,7,2,0,0,5
S01012723,Occupancy rating -1 or less,50,14,8,6,31,0,14,1,9,4,17,14,3,5,4,0,0,1
S01012724,All households,412,209,84,125,195,25,128,69,39,20,42,26,16,8,2,0,0,6
S01012724,Occupancy rating +2 or more,108,43,23,20,64,15,44,25,13,6,5,2,3,1,0,0,0,1
S01012724,Occupancy rating +1,162,96,30,66,63,8,48,34,9,5,7,4,3,3,0,0,0,3
S01012724,Occupancy rating 0,114,60,28,32,53,2,27,6,13,8,24,16,8,1,0,0,0,1
S01012724,Occupancy rating -1 or less,28,10,3,7,15,0,9,4,4,1,6,4,2,3,2,0,0,1
S01012725,All households,494,276,67,209,201,26,138,54,64,20,37,21,16,17,6,1,0,10
S01012725,Occupancy rating +2 or more,129,43,11,32,82,14,65,18,35,12,3,0,3,4,2,0,0,2
S01012725,Occupancy rating +1,192,136,43,93,54,9,36,25,8,3,9,0,9,2,0,1,0,1
S01012725,Occupancy rating 0,138,77,10,67,52,2,30,8,17,5,20,16,4,9,2,0,0,7
S01012725,Occupancy rating -1 or less,35,20,3,17,13,1,7,3,4,0,5,5,0,2,2,0,0,0
S01012726,All households,283,94,54,40,178,42,86,26,43,17,50,22,28,11,9,0,0,2
S01012726,Occupancy rating +2 or more,125,53,31,22,72,35,31,19,8,4,6,2,4,0,0,0,0,0
S01012726,Occupancy rating +1,84,32,21,11,51,5,25,6,14,5,21,8,13,1,1,0,0,0
S01012726,Occupancy rating 0,43,3,1,2,35,1,21,1,16,4,13,6,7,5,4,0,0,1
S01012726,Occupancy rating -1 or less,31,6,1,5,20,1,9,0,5,4,10,6,4,5,4,0,0,1
S01012727,All households,294,97,32,65,175,19,102,34,38,30,54,37,17,22,16,0,1,5
S01012727,Occupancy rating +2 or more,99,46,20,26,51,12,37,26,8,3,2,2,0,2,1,0,0,1
S01012727,Occupancy rating +1,87,38,10,28,44,6,29,6,9,14,9,5,4,5,1,0,1,3
S01012727,Occupancy rating 0,65,7,0,7,51,1,26,2,15,9,24,16,8,7,6,0,0,1
S01012727,Occupancy rating -1 or less,43,6,2,4,29,0,10,0,6,4,19,14,5,8,8,0,0,0
S01012728,All households,339,107,22,85,213,11,94,20,52,22,108,76,32,19,13,0,1,5
S01012728,Occupancy rating +2 or more,63,25,6,19,37,5,25,10,11,4,7,5,2,1,0,0,1,0
S01012728,Occupancy rating +1,112,56,12,44,56,3,23,7,11,5,30,18,12,0,0,0,0,0
S01012728,Occupancy rating 0,119,20,3,17,88,2,35,3,25,7,51,37,14,11,6,0,0,5
S01012728,Occupancy rating -1 or less,45,6,1,5,32,1,11,0,5,6,20,16,4,7,7,0,0,0
S01012729,All households,346,84,33,51,245,23,164,59,73,32,58,39,19,17,6,0,0,11
S01012729,Occupancy rating +2 or more,145,37,15,22,105,19,77,40,22,15,9,5,4,3,2,0,0,1
S01012729,Occupancy rating +1,112,34,12,22,74,2,58,18,32,8,14,8,6,4,1,0,0,3
S01012729,Occupancy rating 0,69,11,5,6,54,1,23,0,17,6,30,22,8,4,0,0,0,4
S01012729,Occupancy rating -1 or less,20,2,1,1,12,1,6,1,2,3,5,4,1,6,3,0,0,3
S01012730,All households,266,98,18,80,162,19,101,39,47,15,42,23,19,6,2,0,0,4
S01012730,Occupancy rating +2 or more,57,26,12,14,31,8,22,15,4,3,1,0,1,0,0,0,0,0
S01012730,Occupancy rating +1,104,46,5,41,57,10,33,18,12,3,14,8,6,1,0,0,0,1
S01012730,Occupancy rating 0,83,24,1,23,57,1,36,5,25,6,20,9,11,2,0,0,0,2
S01012730,Occupancy rating -1 or less,22,2,0,2,17,0,10,1,6,3,7,6,1,3,2,0,0,1
S01012731,All households,335,94,41,53,230,28,145,51,70,24,57,34,23,11,5,0,2,4
S01012731,Occupancy rating +2 or more,106,43,23,20,61,20,38,27,10,1,3,0,3,2,1,0,0,1
S01012731,Occupancy rating +1,116,39,14,25,73,6,54,21,20,13,13,6,7,4,1,0,2,1
S01012731,Occupancy rating 0,72,11,3,8,59,1,34,2,27,5,24,19,5,2,0,0,0,2
S01012731,Occupancy rating -1 or less,41,1,1,0,37,1,19,1,13,5,17,9,8,3,3,0,0,0
S01012732,All households,292,70,17,53,213,25,136,56,50,30,52,34,18,9,7,0,0,2
S01012732,Occupancy rating +2 or more,90,24,8,16,66,15,45,36,6,3,6,3,3,0,0,0,0,0
S01012732,Occupancy rating +1,94,30,8,22,63,6,46,18,14,14,11,8,3,1,0,0,0,1
S01012732,Occupancy rating 0,78,10,0,10,64,2,39,2,27,10,23,15,8,4,3,0,0,1
S01012732,Occupancy rating -1 or less,30,6,1,5,20,2,6,0,3,3,12,8,4,4,4,0,0,0
S01012733,All households,364,45,2,43,305,6,270,73,171,26,29,26,3,14,6,0,0,8
S01012733,Occupancy rating +2 or more,268,22,0,22,236,6,217,59,138,20,13,11,2,10,4,0,0,6
S01012733,Occupancy rating +1,65,22,2,20,41,0,34,14,17,3,7,7,0,2,1,0,0,1
S01012733,Occupancy rating 0,25,1,0,1,22,0,17,0,15,2,5,5,0,2,1,0,0,1
S01012733,Occupancy rating -1 or less,6,0,0,0,6,0,2,0,1,1,4,3,1,0,0,0,0,0
S01012734,All households,198,12,1,11,181,3,163,40,114,9,15,13,2,5,3,0,0,2
S01012734,Occupancy rating +2 or more,166,11,1,10,150,2,140,38,95,7,8,6,2,5,3,0,0,2
S01012734,Occupancy rating +1,24,1,0,1,23,1,17,1,15,1,5,5,0,0,0,0,0,0
S01012734,Occupancy rating 0,7,0,0,0,7,0,5,1,3,1,2,2,0,0,0,0,0,0
S01012734,Occupancy rating -1 or less,1,0,0,0,1,0,1,0,1,0,0,0,0,0,0,0,0,0
S01012735,All households,213,56,18,38,150,31,82,30,34,18,37,20,17,7,3,0,0,4
S01012735,Occupancy rating +2 or more,78,27,12,15,51,24,27,21,5,1,0,0,0,0,0,0,0,0
S01012735,Occupancy rating +1,65,18,3,15,47,6,29,8,12,9,12,4,8,0,0,0,0,0
S01012735,Occupancy rating 0,52,9,2,7,37,1,18,0,12,6,18,12,6,6,2,0,0,4
S01012735,Occupancy rating -1 or less,18,2,1,1,15,0,8,1,5,2,7,4,3,1,1,0,0,0
S01012736,All households,376,86,26,60,268,16,196,68,89,39,56,34,22,22,13,0,0,9
S01012736,Occupancy rating +2 or more,152,32,11,21,117,9,92,47,29,16,16,6,10,3,1,0,0,2
S01012736,Occupancy rating +1,113,31,9,22,77,4,59,16,30,13,14,8,6,5,1,0,0,4
S01012736,Occupancy rating 0,86,22,6,16,56,0,35,4,22,9,21,15,6,8,7,0,0,1
S01012736,Occupancy rating -1 or less,25,1,0,1,18,3,10,1,8,1,5,5,0,6,4,0,0,2
S01012737,All households,329,77,16,61,237,21,186,84,82,20,30,20,10,15,6,0,0,9
S01012737,Occupancy rating +2 or more,160,30,10,20,125,18,100,53,38,9,7,4,3,5,2,0,0,3
S01012737,Occupancy rating +1,114,35,4,31,74,1,63,28,26,9,10,7,3,5,1,0,0,4
S01012737,Occupancy rating 0,40,10,2,8,28,2,17,3,13,1,9,7,2,2,0,0,0,2
S01012737,Occupancy rating -1 or less,15,2,0,2,10,0,6,0,5,1,4,2,2,3,3,0,0,0
S01012738,All households,255,71,24,47,168,19,103,41,43,19,46,27,19,16,10,0,1,5
S01012738,Occupancy rating +2 or more,93,29,11,18,61,12,44,28,12,4,5,4,1,3,2,0,0,1
S01012738,Occupancy rating +1,95,30,9,21,59,4,34,12,12,10,21,13,8,6,3,0,1,2
S01012738,Occupancy rating 0,51,11,3,8,36,3,19,1,15,3,14,7,7,4,3,0,0,1
S01012738,Occupancy rating -1 or less,16,1,1,0,12,0,6,0,4,2,6,3,3,3,2,0,0,1
S01012739,All households,289,32,0,32,242,2,226,76,136,14,14,9,5,15,9,0,0,6
S01012739,Occupancy rating +2 or more,218,16,0,16,192,2,185,66,109,10,5,4,1,10,4,0,0,6
S01012739,Occupancy rating +1,48,16,0,16,31,0,30,8,20,2,1,0,1,1,1,0,0,0
S01012739,Occupancy rating 0,19,0,0,0,17,0,11,2,7,2,6,4,2,2,2,0,0,0
S01012739,Occupancy rating -1 or less,4,0,0,0,2,0,0,0,0,0,2,1,1,2,2,0,0,0
S01012740,All households,308,43,5,38,257,3,220,70,135,15,34,27,7,8,7,0,0,1
S01012740,Occupancy rating +2 or more,227,34,2,32,188,3,177,63,100,14,8,8,0,5,5,0,0,0
S01012740,Occupancy rating +1,61,7,2,5,52,0,33,5,27,1,19,15,4,2,1,0,0,1
S01012740,Occupancy rating 0,14,2,1,1,11,0,5,1,4,0,6,3,3,1,1,0,0,0
S01012740,Occupancy rating -1 or less,6,0,0,0,6,0,5,1,4,0,1,1,0,0,0,0,0,0
S01012741,All households,272,106,22,84,160,9,136,70,43,23,15,10,5,6,3,0,0,3
S01012741,Occupancy rating +2 or more,114,27,2,25,87,8,76,47,14,15,3,2,1,0,0,0,0,0
S01012741,Occupancy rating +1,83,39,14,25,43,1,39,18,17,4,3,1,2,1,1,0,0,0
S01012741,Occupancy rating 0,57,26,3,23,26,0,18,5,10,3,8,6,2,5,2,0,0,3
S01012741,Occupancy rating -1 or less,18,14,3,11,4,0,3,0,2,1,1,1,0,0,0,0,0,0
S01012742,All households,276,42,22,20,229,40,167,72,51,44,22,16,6,5,3,0,0,2
S01012742,Occupancy rating +2 or more,201,35,19,16,164,35,117,65,25,27,12,10,2,2,1,0,0,1
S01012742,Occupancy rating +1,45,6,3,3,38,5,30,7,13,10,3,1,2,1,0,0,0,1
S01012742,Occupancy rating 0,21,1,0,1,19,0,14,0,7,7,5,3,2,1,1,0,0,0
S01012742,Occupancy rating -1 or less,9,0,0,0,8,0,6,0,6,0,2,2,0,1,1,0,0,0
S01012743,All households,237,47,26,21,186,32,134,50,47,37,20,8,12,4,1,0,0,3
S01012743,Occupancy rating +2 or more,179,42,22,20,136,30,96,47,26,23,10,4,6,1,0,0,0,1
S01012743,Occupancy rating +1,39,4,4,0,33,1,24,2,13,9,8,3,5,2,0,0,0,2
S01012743,Occupancy rating 0,17,1,0,1,16,1,13,1,7,5,2,1,1,0,0,0,0,0
S01012743,Occupancy rating -1 or less,2,0,0,0,1,0,1,0,1,0,0,0,0,1,1,0,0,0
S01012744,All households,277,58,12,46,214,16,182,81,64,37,16,8,8,5,0,0,0,5
S01012744,Occupancy rating +2 or more,141,19,3,16,118,12,102,53,28,21,4,2,2,4,0,0,0,4
S01012744,Occupancy rating +1,88,30,7,23,58,4,51,28,17,6,3,1,2,0,0,0,0,0
S01012744,Occupancy rating 0,36,6,1,5,30,0,24,0,18,6,6,2,4,0,0,0,0,0
S01012744,Occupancy rating -1 or less,12,3,1,2,8,0,5,0,1,4,3,3,0,1,0,0,0,1
S01012745,All households,302,66,37,29,231,49,161,68,61,32,21,11,10,5,1,0,0,4
S01012745,Occupancy rating +2 or more,220,57,32,25,160,43,107,62,28,17,10,6,4,3,0,0,0,3
S01012745,Occupancy rating +1,58,8,4,4,49,4,40,5,28,7,5,3,2,1,0,0,0,1
S01012745,Occupancy rating 0,16,1,1,0,14,2,9,0,4,5,3,1,2,1,1,0,0,0
S01012745,Occupancy rating -1 or less,8,0,0,0,8,0,5,1,1,3,3,1,2,0,0,0,0,0
S01012746,All households,311,67,19,48,232,20,190,75,81,34,22,12,10,12,9,0,0,3
S01012746,Occupancy rating +2 or more,135,22,7,15,112,16,92,46,34,12,4,2,2,1,1,0,0,0
S01012746,Occupancy rating +1,104,38,9,29,65,4,56,27,20,9,5,1,4,1,0,0,0,1
S01012746,Occupancy rating 0,47,5,2,3,38,0,27,1,16,10,11,8,3,4,3,0,0,1
S01012746,Occupancy rating -1 or less,25,2,1,1,17,0,15,1,11,3,2,1,1,6,5,0,0,1
S01012747,All households,348,93,41,52,242,25,161,59,63,39,56,32,24,13,7,0,1,5
S01012747,Occupancy rating +2 or more,153,50,26,24,102,16,78,48,16,14,8,4,4,1,0,0,0,1
S01012747,Occupancy rating +1,91,30,13,17,59,9,36,8,16,12,14,6,8,2,0,0,1,1
S01012747,Occupancy rating 0,77,13,2,11,58,0,34,2,22,10,24,15,9,6,3,0,0,3
S01012747,Occupancy rating -1 or less,27,0,0,0,23,0,13,1,9,3,10,7,3,4,4,0,0,0
S01012748,All households,369,132,49,83,215,12,101,31,41,29,102,67,35,22,8,0,1,13
S01012748,Occupancy rating +2 or more,77,38,13,25,37,2,22,11,6,5,13,6,7,2,0,0,0,2
S01012748,Occupancy rating +1,120,62,25,37,54,7,29,17,4,8,18,8,10,4,3,0,0,1
S01012748,Occupancy rating 0,112,29,11,18,75,0,29,1,19,9,46,35,11,8,2,0,1,5
S01012748,Occupancy rating -1 or less,60,3,0,3,49,3,21,2,12,7,25,18,7,8,3,0,0,5
S01012749,All households,387,126,29,97,245,19,133,47,61,25,93,71,22,16,10,0,0,6
S01012749,Occupancy rating +2 or more,66,31,8,23,35,5,24,17,2,5,6,4,2,0,0,0,0,0
S01012749,Occupancy rating +1,141,62,15,47,76,13,48,25,14,9,15,11,4,3,2,0,0,1
S01012749,Occupancy rating 0,115,21,4,17,90,0,39,3,29,7,51,40,11,4,2,0,0,2
S01012749,Occupancy rating -1 or less,65,12,2,10,44,1,22,2,16,4,21,16,5,9,6,0,0,3
S01012750,All households,336,102,22,80,206,16,116,41,51,24,74,51,23,28,11,0,1,16
S01012750,Occupancy rating +2 or more,57,26,4,22,31,6,23,15,4,4,2,1,1,0,0,0,0,0
S01012750,Occupancy rating +1,104,48,10,38,54,6,36,21,11,4,12,9,3,2,0,0,0,2
S01012750,Occupancy rating 0,127,24,6,18,90,2,44,3,29,12,44,30,14,13,3,0,0,10
S01012750,Occupancy rating -1 or less,48,4,2,2,31,2,13,2,7,4,16,11,5,13,8,0,1,4
S01012751,All households,423,187,80,107,221,58,128,48,53,27,35,24,11,15,8,0,1,6
S01012751,Occupancy rating +2 or more,66,30,14,16,34,13,19,13,4,2,2,1,1,2,0,0,1,1
S01012751,Occupancy rating +1,173,92,44,48,80,37,41,29,7,5,2,1,1,1,1,0,0,0
S01012751,Occupancy rating 0,140,54,14,40,82,6,52,6,29,17,24,19,5,4,1,0,0,3
S01012751,Occupancy rating -1 or less,44,11,8,3,25,2,16,0,13,3,7,3,4,8,6,0,0,2
S01012752,All households,375,118,26,92,236,16,149,63,54,32,71,51,20,21,8,0,3,10
S01012752,Occupancy rating +2 or more,104,30,9,21,71,5,59,33,18,8,7,5,2,3,1,0,0,2
S01012752,Occupancy rating +1,132,70,13,57,57,9,40,27,5,8,8,3,5,5,1,0,1,3
S01012752,Occupancy rating 0,93,9,1,8,78,1,37,2,23,12,40,31,9,6,1,0,1,4
S01012752,Occupancy rating -1 or less,46,9,3,6,30,1,13,1,8,4,16,12,4,7,5,0,1,1
S01012753,All households,235,89,26,63,137,10,72,31,28,13,55,41,14,9,6,0,1,2
S01012753,Occupancy rating +2 or more,40,19,8,11,20,5,11,6,5,0,4,0,4,1,1,0,0,0
S01012753,Occupancy rating +1,61,31,8,23,30,3,24,17,3,4,3,2,1,0,0,0,0,0
S01012753,Occupancy rating 0,99,32,7,25,65,1,27,6,14,7,37,29,8,2,0,0,1,1
S01012753,Occupancy rating -1 or less,35,7,3,4,22,1,10,2,6,2,11,10,1,6,5,0,0,1
S01012754,All households,255,98,41,57,147,16,100,44,33,23,31,16,15,10,2,0,2,6
S01012754,Occupancy rating +2 or more,74,28,16,12,43,10,28,17,4,7,5,2,3,3,0,0,0,3
S01012754,Occupancy rating +1,95,46,19,27,47,3,38,24,9,5,6,2,4,2,0,0,0,2
S01012754,Occupancy rating 0,54,16,6,10,37,2,23,2,15,6,12,8,4,1,0,0,1,0
S01012754,Occupancy rating -1 or less,32,8,0,8,20,1,11,1,5,5,8,4,4,4,2,0,1,1
S01012755,All households,280,149,59,90,120,12,60,27,23,10,48,32,16,11,4,0,0,7
S01012755,Occupancy rating +2 or more,43,16,6,10,26,4,16,5,5,6,6,4,2,1,0,0,0,1
S01012755,Occupancy rating +1,67,35,11,24,31,4,22,16,5,1,5,2,3,1,0,0,0,1
S01012755,Occupancy rating 0,126,81,35,46,40,3,16,5,10,1,21,18,3,5,1,0,0,4
S01012755,Occupancy rating -1 or less,44,17,7,10,23,1,6,1,3,2,16,8,8,4,3,0,0,1
S01012756,All households,271,125,79,46,128,31,78,37,16,25,19,6,13,18,3,0,1,14
S01012756,Occupancy rating +2 or more,66,18,13,5,46,17,27,17,3,7,2,0,2,2,0,0,0,2
S01012756,Occupancy rating +1,98,48,23,25,48,10,33,14,7,12,5,1,4,2,0,0,0,2
S01012756,Occupancy rating 0,81,46,36,10,26,3,13,6,4,3,10,4,6,9,2,0,1,6
S01012756,Occupancy rating -1 or less,26,13,7,6,8,1,5,0,2,3,2,1,1,5,1,0,0,4
S01012757,All households,236,93,40,53,132,15,78,42,20,16,39,21,18,11,3,0,2,6
S01012757,Occupancy rating +2 or more,48,16,13,3,30,4,22,14,6,2,4,2,2,2,0,0,2,0
S01012757,Occupancy rating +1,92,49,17,32,41,6,29,23,3,3,6,2,4,2,0,0,0,2
S01012757,Occupancy rating 0,66,22,9,13,41,5,20,4,9,7,16,11,5,3,0,0,0,3
S01012757,Occupancy rating -1 or less,30,6,1,5,20,0,7,1,2,4,13,6,7,4,3,0,0,1
S01012758,All households,274,97,37,60,167,14,109,40,43,26,44,25,19,10,4,0,1,5
S01012758,Occupancy rating +2 or more,88,21,9,12,64,7,49,22,17,10,8,4,4,3,1,0,0,2
S01012758,Occupancy rating +1,74,44,19,25,27,6,19,12,2,5,2,1,1,3,1,0,1,1
S01012758,Occupancy rating 0,76,23,7,16,51,1,29,5,16,8,21,12,9,2,1,0,0,1
S01012758,Occupancy rating -1 or less,36,9,2,7,25,0,12,1,8,3,13,8,5,2,1,0,0,1
S01012759,All households,342,144,52,92,184,16,110,39,40,31,58,35,23,14,8,0,1,5
S01012759,Occupancy rating +2 or more,70,35,13,22,35,7,23,14,7,2,5,2,3,0,0,0,0,0
S01012759,Occupancy rating +1,96,46,20,26,48,8,34,17,7,10,6,4,2,2,1,0,0,1
S01012759,Occupancy rating 0,129,53,15,38,72,0,40,8,17,15,32,21,11,4,1,0,1,2
S01012759,Occupancy rating -1 or less,47,10,4,6,29,1,13,0,9,4,15,8,7,8,6,0,0,2
S01012760,All households,424,145,50,95,258,20,129,41,60,28,109,77,32,21,5,1,1,14
S01012760,Occupancy rating +2 or more,93,36,16,20,55,9,39,22,9,8,7,5,2,2,1,1,0,0
S01012760,Occupancy rating +1,140,72,23,49,64,8,37,14,16,7,19,13,6,4,1,0,0,3
S01012760,Occupancy rating 0,137,30,8,22,97,3,37,3,24,10,57,36,21,10,1,0,0,9
S01012760,Occupancy rating -1 or less,54,7,3,4,42,0,16,2,11,3,26,23,3,5,2,0,1,2
S01012761,All households,369,143,44,99,215,29,143,69,46,28,43,23,20,11,6,0,0,5
S01012761,Occupancy rating +2 or more,73,20,9,11,51,16,33,26,5,2,2,1,1,2,1,0,0,1
S01012761,Occupancy rating +1,137,53,18,35,82,10,67,37,16,14,5,2,3,2,0,0,0,2
S01012761,Occupancy rating 0,121,60,14,46,57,1,35,6,21,8,21,10,11,4,2,0,0,2
S01012761,Occupancy rating -1 or less,38,10,3,7,25,2,8,0,4,4,15,10,5,3,3,0,0,0
S01012762,All households,315,86,42,44,217,38,131,54,37,40,48,27,21,12,8,1,0,3
S01012762,Occupancy rating +2 or more,132,51,28,23,80,28,51,39,5,7,1,1,0,1,1,0,0,0
S01012762,Occupancy rating +1,114,30,13,17,83,8,56,11,19,26,19,9,10,1,0,0,0,1
S01012762,Occupancy rating 0,53,4,1,3,43,0,19,3,10,6,24,14,10,6,3,1,0,2
S01012762,Occupancy rating -1 or less,16,1,0,1,11,2,5,1,3,1,4,3,1,4,4,0,0,0
S01012763,All households,178,49,23,26,121,12,63,21,20,22,46,20,26,8,4,0,1,3
S01012763,Occupancy rating +2 or more,36,14,7,7,21,4,14,9,1,4,3,1,2,1,1,0,0,0
S01012763,Occupancy rating +1,57,28,10,18,28,5,16,10,3,3,7,1,6,1,0,0,0,1
S01012763,Occupancy rating 0,54,6,5,1,44,1,20,1,11,8,23,10,13,4,1,0,1,2
S01012763,Occupancy rating -1 or less,31,1,1,0,28,2,13,1,5,7,13,8,5,2,2,0,0,0
S01012764,All households,348,128,52,76,199,20,117,42,52,23,62,41,21,21,8,0,2,11
S01012764,Occupancy rating +2 or more,82,28,10,18,50,7,37,22,11,4,6,3,3,4,2,0,0,2
S01012764,Occupancy rating +1,111,52,22,30,54,10,31,15,11,5,13,7,6,5,1,0,0,4
S01012764,Occupancy rating 0,110,41,18,23,62,2,32,4,21,7,28,18,10,7,2,0,1,4
S01012764,Occupancy rating -1 or less,45,7,2,5,33,1,17,1,9,7,15,13,2,5,3,0,1,1
S01012765,All households,296,81,36,45,204,20,142,54,55,33,42,23,19,11,7,0,1,3
S01012765,Occupancy rating +2 or more,125,36,20,16,87,14,67,39,20,8,6,2,4,2,0,0,1,1
S01012765,Occupancy rating +1,80,29,10,19,50,4,37,15,10,12,9,4,5,1,0,0,0,1
S01012765,Occupancy rating 0,60,12,4,8,47,1,25,0,17,8,21,13,8,1,0,0,0,1
S01012765,Occupancy rating -1 or less,31,4,2,2,20,1,13,0,8,5,6,4,2,7,7,0,0,0
S01012766,All households,358,82,24,58,261,25,159,49,78,32,77,47,30,15,7,0,1,7
S01012766,Occupancy rating +2 or more,102,28,8,20,74,9,61,25,26,10,4,1,3,0,0,0,0,0
S01012766,Occupancy rating +1,119,32,11,21,82,14,49,21,19,9,19,9,10,5,1,0,0,4
S01012766,Occupancy rating 0,93,13,3,10,74,1,34,1,25,8,39,26,13,6,2,0,1,3
S01012766,Occupancy rating -1 or less,44,9,2,7,31,1,15,2,8,5,15,11,4,4,4,0,0,0
S01012767,All households,228,35,20,15,192,25,149,63,54,32,18,7,11,1,1,0,0,0
S01012767,Occupancy rating +2 or more,143,27,16,11,115,23,83,56,14,13,9,2,7,1,1,0,0,0
S01012767,Occupancy rating +1,55,8,4,4,47,2,42,5,25,12,3,1,2,0,0,0,0,0
S01012767,Occupancy rating 0,22,0,0,0,22,0,19,2,12,5,3,3,0,0,0,0,0,0
S01012767,Occupancy rating -1 or less,8,0,0,0,8,0,5,0,3,2,3,1,2,0,0,0,0,0
S01012768,All households,291,39,15,24,248,33,187,90,60,37,28,16,12,4,1,0,0,3
S01012768,Occupancy rating +2 or more,177,31,13,18,146,26,114,79,21,14,6,3,3,0,0,0,0,0
S01012768,Occupancy rating +1,64,5,1,4,57,5,43,8,22,13,9,4,5,2,0,0,0,2
S01012768,Occupancy rating 0,37,1,1,0,36,2,26,2,15,9,8,6,2,0,0,0,0,0
S01012768,Occupancy rating -1 or less,13,2,0,2,9,0,4,1,2,1,5,3,2,2,1,0,0,1
S01012769,All households,152,26,3,23,117,6,100,32,58,10,11,4,7,9,6,0,0,3
S01012769,Occupancy rating +2 or more,102,11,2,9,86,3,80,21,49,10,3,2,1,5,3,0,0,2
S01012769,Occupancy rating +1,16,6,1,5,9,1,7,5,2,0,1,1,0,1,1,0,0,0
S01012769,Occupancy rating 0,25,9,0,9,14,1,8,5,3,0,5,0,5,2,1,0,0,1
S01012769,Occupancy rating -1 or less,9,0,0,0,8,1,5,1,4,0,2,1,1,1,1,0,0,0
S01012770,All households,408,160,72,88,230,28,150,68,59,23,52,34,18,18,6,0,3,9
S01012770,Occupancy rating +2 or more,103,28,20,8,70,11,54,29,21,4,5,4,1,5,2,0,0,3
S01012770,Occupancy rating +1,141,72,30,42,68,14,46,31,7,8,8,7,1,1,0,0,0,1
S01012770,Occupancy rating 0,129,51,18,33,71,3,38,7,23,8,30,16,14,7,1,0,2,4
S01012770,Occupancy rating -1 or less,35,9,4,5,21,0,12,1,8,3,9,7,2,5,3,0,1,1
S01012771,All households,357,162,57,105,177,22,109,47,42,20,46,25,21,18,12,0,0,6
S01012771,Occupancy rating +2 or more,83,27,9,18,52,9,37,19,12,6,6,3,3,4,3,0,0,1
S01012771,Occupancy rating +1,142,89,39,50,50,10,32,20,8,4,8,5,3,3,0,0,0,3
S01012771,Occupancy rating 0,89,35,6,29,50,2,27,6,16,5,21,11,10,4,4,0,0,0
S01012771,Occupancy rating -1 or less,43,11,3,8,25,1,13,2,6,5,11,6,5,7,5,0,0,2
S01012772,All households,285,78,30,48,188,22,98,34,39,25,68,42,26,19,12,0,0,7
S01012772,Occupancy rating +2 or more,66,24,13,11,41,10,24,15,4,5,7,5,2,1,0,0,0,1
S01012772,Occupancy rating +1,89,33,9,24,55,7,32,16,10,6,16,11,5,1,0,0,0,1
S01012772,Occupancy rating 0,80,12,4,8,62,4,25,1,15,9,33,20,13,6,2,0,0,4
S01012772,Occupancy rating -1 or less,50,9,4,5,30,1,17,2,10,5,12,6,6,11,10,0,0,1
S01012773,All households,391,126,61,65,243,28,149,63,41,45,66,35,31,22,12,0,0,10
S01012773,Occupancy rating +2 or more,128,43,19,24,79,18,54,29,12,13,7,2,5,6,4,0,0,2
S01012773,Occupancy rating +1,130,41,22,19,83,7,56,27,12,17,20,8,12,6,2,0,0,4
S01012773,Occupancy rating 0,88,31,13,18,52,2,31,7,12,12,19,13,6,5,3,0,0,2
S01012773,Occupancy rating -1 or less,45,11,7,4,29,1,8,0,5,3,20,12,8,5,3,0,0,2
S01012774,All households,408,160,36,124,235,19,167,84,52,31,49,27,22,13,7,0,0,6
S01012774,Occupancy rating +2 or more,116,49,23,26,66,8,57,36,13,8,1,0,1,1,1,0,0,0
S01012774,Occupancy rating +1,164,82,10,72,81,8,64,41,13,10,9,3,6,1,0,0,0,1
S01012774,Occupancy rating 0,96,22,2,20,69,2,34,6,17,11,33,19,14,5,0,0,0,5
S01012774,Occupancy rating -1 or less,32,7,1,6,19,1,12,1,9,2,6,5,1,6,6,0,0,0
S01012775,All households,211,95,33,62,104,19,66,29,21,16,19,8,11,12,4,0,0,8
S01012775,Occupancy rating +2 or more,76,30,16,14,45,10,33,18,8,7,2,0,2,1,1,0,0,0
S01012775,Occupancy rating +1,64,33,12,21,27,6,17,6,7,4,4,2,2,4,2,0,0,2
S01012775,Occupancy rating 0,50,28,5,23,19,1,10,3,3,4,8,3,5,3,0,0,0,3
S01012775,Occupancy rating -1 or less,21,4,0,4,13,2,6,2,3,1,5,3,2,4,1,0,0,3
S01012776,All households,359,131,41,90,214,19,143,58,51,34,52,26,26,14,3,0,1,10
S01012776,Occupancy rating +2 or more,72,31,12,19,41,7,30,20,6,4,4,2,2,0,0,0,0,0
S01012776,Occupancy rating +1,136,58,13,45,74,8,55,31,15,9,11,2,9,4,0,0,0,4
S01012776,Occupancy rating 0,106,30,11,19,69,4,39,6,21,12,26,15,11,7,2,0,0,5
S01012776,Occupancy rating -1 or less,45,12,5,7,30,0,19,1,9,9,11,7,4,3,1,0,1,1
S01012777,All households,365,82,15,67,269,5,225,60,146,19,39,32,7,14,6,0,1,7
S01012777,Occupancy rating +2 or more,122,22,1,21,99,2,90,37,51,2,7,4,3,1,0,0,0,1
S01012777,Occupancy rating +1,133,36,8,28,94,3,77,21,47,9,14,12,2,3,0,0,1,2
S01012777,Occupancy rating 0,85,23,6,17,57,0,42,2,34,6,15,13,2,5,3,0,0,2
S01012777,Occupancy rating -1 or less,25,1,0,1,19,0,16,0,14,2,3,3,0,5,3,0,0,2
S01012778,All households,295,70,19,51,211,7,140,42,77,21,64,48,16,14,6,0,1,7
S01012778,Occupancy rating +2 or more,60,10,2,8,49,1,44,29,12,3,4,2,2,1,0,0,0,1
S01012778,Occupancy rating +1,101,31,9,22,67,4,55,12,35,8,8,7,1,3,2,0,0,1
S01012778,Occupancy rating 0,95,22,6,16,66,1,26,0,21,5,39,31,8,7,3,0,1,3
S01012778,Occupancy rating -1 or less,39,7,2,5,29,1,15,1,9,5,13,8,5,3,1,0,0,2
S01012779,All households,200,75,13,62,116,1,72,21,41,10,43,31,12,9,6,0,0,3
S01012779,Occupancy rating +2 or more,37,20,3,17,17,0,16,11,4,1,1,0,1,0,0,0,0,0
S01012779,Occupancy rating +1,74,44,10,34,28,1,21,10,9,2,6,4,2,2,1,0,0,1
S01012779,Occupancy rating 0,67,9,0,9,54,0,26,0,21,5,28,19,9,4,2,0,0,2
S01012779,Occupancy rating -1 or less,22,2,0,2,17,0,9,0,7,2,8,8,0,3,3,0,0,0
S01012780,All households,346,134,48,86,197,20,97,38,51,8,80,63,17,15,3,0,1,11
S01012780,Occupancy rating +2 or more,42,19,8,11,21,4,11,7,4,0,6,3,3,2,0,0,0,2
S01012780,Occupancy rating +1,113,56,10,46,55,9,39,26,12,1,7,6,1,2,1,0,0,1
S01012780,Occupancy rating 0,142,40,22,18,94,5,37,4,30,3,52,41,11,8,0,0,1,7
S01012780,Occupancy rating -1 or less,49,19,8,11,27,2,10,1,5,4,15,13,2,3,2,0,0,1
S01012781,All households,300,88,23,65,204,31,143,69,51,23,30,19,11,8,1,0,2,5
S01012781,Occupancy rating +2 or more,111,34,15,19,77,15,59,36,11,12,3,1,2,0,0,0,0,0
S01012781,Occupancy rating +1,119,42,6,36,74,14,52,32,15,5,8,4,4,3,0,0,1,2
S01012781,Occupancy rating 0,55,11,2,9,42,2,28,1,21,6,12,8,4,2,0,0,1,1
S01012781,Occupancy rating -1 or less,15,1,0,1,11,0,4,0,4,0,7,6,1,3,1,0,0,2
S01012782,All households,313,131,41,90,164,15,81,36,22,23,68,42,26,18,8,0,2,8
S01012782,Occupancy rating +2 or more,27,13,3,10,14,2,11,10,0,1,1,1,0,0,0,0,0,0
S01012782,Occupancy rating +1,144,101,33,68,39,10,27,24,1,2,2,1,1,4,1,0,1,2
S01012782,Occupancy rating 0,98,10,2,8,81,3,31,1,16,14,47,30,17,7,1,0,1,5
S01012782,Occupancy rating -1 or less,44,7,3,4,30,0,12,1,5,6,18,10,8,7,6,0,0,1
S01012783,All households,322,109,31,78,192,12,110,37,54,19,70,49,21,21,9,0,1,11
S01012783,Occupancy rating +2 or more,32,13,6,7,18,2,13,9,2,2,3,2,1,1,0,0,0,1
S01012783,Occupancy rating +1,132,78,18,60,51,8,36,25,6,5,7,4,3,3,3,0,0,0
S01012783,Occupancy rating 0,105,9,3,6,88,0,42,0,32,10,46,36,10,8,1,0,1,6
S01012783,Occupancy rating -1 or less,53,9,4,5,35,2,19,3,14,2,14,7,7,9,5,0,0,4
S01012784,All households,391,182,56,126,202,17,134,67,46,21,51,38,13,7,2,0,0,5
S01012784,Occupancy rating +2 or more,61,28,5,23,32,4,27,19,7,1,1,1,0,1,0,0,0,1
S01012784,Occupancy rating +1,161,85,30,55,75,9,54,38,10,6,12,5,7,1,0,0,0,1
S01012784,Occupancy rating 0,123,53,12,41,68,2,38,7,19,12,28,22,6,2,1,0,0,1
S01012784,Occupancy rating -1 or less,46,16,9,7,27,2,15,3,10,2,10,10,0,3,1,0,0,2
S01012785,All households,388,187,68,119,184,11,89,36,31,22,84,57,27,17,5,0,0,12
S01012785,Occupancy rating +2 or more,36,17,8,9,19,6,13,10,1,2,0,0,0,0,0,0,0,0
S01012785,Occupancy rating +1,147,100,36,64,43,4,29,19,4,6,10,5,5,4,0,0,0,4
S01012785,Occupancy rating 0,147,49,14,35,91,1,33,6,19,8,57,41,16,7,4,0,0,3
S01012785,Occupancy rating -1 or less,58,21,10,11,31,0,14,1,7,6,17,11,6,6,1,0,0,5
S01012786,All households,423,247,55,192,144,10,67,35,26,6,67,53,14,32,4,6,0,22
S01012786,Occupancy rating +2 or more,26,13,4,9,13,1,9,5,4,0,3,2,1,0,0,0,0,0
S01012786,Occupancy rating +1,160,109,24,85,46,7,27,23,1,3,12,8,4,5,1,2,0,2
S01012786,Occupancy rating 0,183,102,24,78,62,2,22,7,15,0,38,31,7,19,1,4,0,14
S01012786,Occupancy rating -1 or less,54,23,3,20,23,0,9,0,6,3,14,12,2,8,2,0,0,6
S01012787,All households,250,83,15,68,149,7,115,50,49,16,27,22,5,18,7,2,1,8
S01012787,Occupancy rating +2 or more,64,15,0,15,46,3,42,28,10,4,1,1,0,3,2,0,0,1
S01012787,Occupancy rating +1,114,49,10,39,61,3,50,20,22,8,8,7,1,4,2,0,0,2
S01012787,Occupancy rating 0,55,12,2,10,35,0,20,1,16,3,15,13,2,8,2,2,1,3
S01012787,Occupancy rating -1 or less,17,7,3,4,7,1,3,1,1,1,3,1,2,3,1,0,0,2
S01012788,All households,259,83,27,56,162,8,101,35,40,26,53,33,20,14,8,0,0,6
S01012788,Occupancy rating +2 or more,88,32,8,24,52,6,35,23,8,4,11,5,6,4,2,0,0,2
S01012788,Occupancy rating +1,74,24,9,15,48,2,34,10,13,11,12,6,6,2,1,0,0,1
S01012788,Occupancy rating 0,72,21,8,13,47,0,24,2,13,9,23,17,6,4,2,0,0,2
S01012788,Occupancy rating -1 or less,25,6,2,4,15,0,8,0,6,2,7,5,2,4,3,0,0,1
S01012789,All households,325,100,31,69,212,39,137,46,57,34,36,18,18,13,7,1,0,5
S01012789,Occupancy rating +2 or more,124,32,14,18,91,26,61,35,18,8,4,2,2,1,0,0,0,1
S01012789,Occupancy rating +1,98,41,13,28,52,10,38,11,19,8,4,0,4,5,2,0,0,3
S01012789,Occupancy rating 0,78,23,3,20,51,2,28,0,14,14,21,12,9,4,2,1,0,1
S01012789,Occupancy rating -1 or less,25,4,1,3,18,1,10,0,6,4,7,4,3,3,3,0,0,0
S01012790,All households,289,114,41,73,164,12,132,66,55,11,20,16,4,11,0,3,0,8
S01012790,Occupancy rating +2 or more,125,25,6,19,100,5,93,44,39,10,2,2,0,0,0,0,0,0
S01012790,Occupancy rating +1,82,49,6,43,31,1,26,17,9,0,4,2,2,2,0,0,0,2
S01012790,Occupancy rating 0,63,27,21,6,29,6,12,5,7,0,11,10,1,7,0,1,0,6
S01012790,Occupancy rating -1 or less,19,13,8,5,4,0,1,0,0,1,3,2,1,2,0,2,0,0
S01012791,All households,324,101,59,42,211,47,142,55,60,27,22,12,10,12,2,0,2,8
S01012791,Occupancy rating +2 or more,189,45,29,16,140,32,101,43,42,16,7,6,1,4,1,0,0,3
S01012791,Occupancy rating +1,87,46,25,21,40,11,25,11,6,8,4,1,3,1,0,0,1,0
S01012791,Occupancy rating 0,31,6,4,2,22,3,11,0,8,3,8,2,6,3,1,0,0,2
S01012791,Occupancy rating -1 or less,17,4,1,3,9,1,5,1,4,0,3,3,0,4,0,0,1,3
S01012792,All households,496,264,95,169,219,34,139,78,40,21,46,22,24,13,3,1,2,7
S01012792,Occupancy rating +2 or more,81,34,17,17,44,8,33,21,10,2,3,1,2,3,2,0,0,1
S01012792,Occupancy rating +1,168,89,30,59,78,20,50,33,9,8,8,5,3,1,0,0,0,1
S01012792,Occupancy rating 0,201,117,40,77,77,4,48,20,18,10,25,9,16,7,1,1,2,3
S01012792,Occupancy rating -1 or less,46,24,8,16,20,2,8,4,3,1,10,7,3,2,0,0,0,2
S01012793,All households,363,203,60,143,135,10,80,37,23,20,45,26,19,25,6,1,1,17
S01012793,Occupancy rating +2 or more,48,27,11,16,20,3,17,14,1,2,0,0,0,1,0,0,0,1
S01012793,Occupancy rating +1,121,80,26,54,37,6,29,15,11,3,2,0,2,4,0,0,0,4
S01012793,Occupancy rating 0,140,76,17,59,55,1,26,7,5,14,28,17,11,9,1,0,0,8
S01012793,Occupancy rating -1 or less,54,20,6,14,23,0,8,1,6,1,15,9,6,11,5,1,1,4
S01012794,All households,378,223,54,169,144,21,105,69,23,13,18,10,8,11,0,0,1,10
S01012794,Occupancy rating +2 or more,109,56,15,41,52,12,39,30,8,1,1,0,1,1,0,0,0,1
S01012794,Occupancy rating +1,165,106,22,84,56,6,43,33,5,5,7,6,1,3,0,0,1,2
S01012794,Occupancy rating 0,81,48,15,33,27,1,19,5,9,5,7,3,4,6,0,0,0,6
S01012794,Occupancy rating -1 or less,23,13,2,11,9,2,4,1,1,2,3,1,2,1,0,0,0,1
S01012795,All households,439,120,50,70,293,35,144,51,56,37,114,75,39,26,9,0,1,16
S01012795,Occupancy rating +2 or more,110,40,17,23,68,20,38,25,6,7,10,6,4,2,1,0,0,1
S01012795,Occupancy rating +1,155,60,25,35,90,12,48,21,18,9,30,16,14,5,1,0,1,3
S01012795,Occupancy rating 0,116,15,6,9,91,2,33,2,20,11,56,39,17,10,3,0,0,7
S01012795,Occupancy rating -1 or less,58,5,2,3,44,1,25,3,12,10,18,14,4,9,4,0,0,5
S01012796,All households,347,113,33,80,219,12,150,56,69,25,57,43,14,15,7,0,0,8
S01012796,Occupancy rating +2 or more,83,33,11,22,49,7,40,32,7,1,2,1,1,1,0,0,0,1
S01012796,Occupancy rating +1,141,56,11,45,81,3,57,20,28,9,21,13,8,4,2,0,0,2
S01012796,Occupancy rating 0,95,17,8,9,71,2,43,3,28,12,26,23,3,7,3,0,0,4
S01012796,Occupancy rating -1 or less,28,7,3,4,18,0,10,1,6,3,8,6,2,3,2,0,0,1
S01012797,All households,276,54,10,44,203,12,134,63,53,18,57,41,16,19,6,0,1,12
S01012797,Occupancy rating +2 or more,95,30,7,23,63,9,46,39,5,2,8,5,3,2,1,0,0,1
S01012797,Occupancy rating +1,94,18,2,16,66,1,49,21,22,6,16,9,7,10,2,0,1,7
S01012797,Occupancy rating 0,60,5,1,4,50,1,30,3,18,9,19,16,3,5,1,0,0,4
S01012797,Occupancy rating -1 or less,27,1,0,1,24,1,9,0,8,1,14,11,3,2,2,0,0,0
S01012798,All households,329,127,59,68,191,25,144,51,72,21,22,14,8,11,7,0,2,2
S01012798,Occupancy rating +2 or more,181,28,9,19,146,19,115,34,63,18,12,7,5,7,5,0,0,2
S01012798,Occupancy rating +1,60,40,27,13,19,5,12,10,2,0,2,2,0,1,1,0,0,0
S01012798,Occupancy rating 0,69,48,20,28,21,1,14,7,5,2,6,4,2,0,0,0,0,0
S01012798,Occupancy rating -1 or less,19,11,3,8,5,0,3,0,2,1,2,1,1,3,1,0,2,0
S01012799,All households,393,175,86,89,211,44,146,63,62,21,21,15,6,7,2,0,1,4
S01012799,Occupancy rating +2 or more,207,47,24,23,156,33,115,50,48,17,8,4,4,4,2,0,1,1
S01012799,Occupancy rating +1,56,29,11,18,26,4,18,11,6,1,4,3,1,1,0,0,0,1
S01012799,Occupancy rating 0,89,67,33,34,21,7,9,2,4,3,5,4,1,1,0,0,0,1
S01012799,Occupancy rating -1 or less,41,32,18,14,8,0,4,0,4,0,4,4,0,1,0,0,0,1
S01012800,All households,398,143,42,101,246,39,190,67,95,28,17,7,10,9,4,0,1,4
S01012800,Occupancy rating +2 or more,243,65,26,39,173,33,137,48,72,17,3,1,2,5,3,0,0,2
S01012800,Occupancy rating +1,86,45,15,30,39,6,31,11,11,9,2,1,1,2,0,0,1,1
S01012800,Occupancy rating 0,49,24,1,23,24,0,17,6,9,2,7,4,3,1,0,0,0,1
S01012800,Occupancy rating -1 or less,20,9,0,9,10,0,5,2,3,0,5,1,4,1,1,0,0,0
S01012801,All households,252,130,64,66,117,39,67,43,19,5,11,7,4,5,2,0,0,3
S01012801,Occupancy rating +2 or more,85,37,17,20,46,6,37,21,13,3,3,1,2,2,2,0,0,0
S01012801,Occupancy rating +1,93,46,15,31,47,21,23,19,2,2,3,3,0,0,0,0,0,0
S01012801,Occupancy rating 0,66,42,30,12,21,12,5,3,2,0,4,2,2,3,0,0,0,3
S01012801,Occupancy rating -1 or less,8,5,2,3,3,0,2,0,2,0,1,1,0,0,0,0,0,0
S01012802,All households,207,25,7,18,175,17,144,41,74,29,14,6,8,7,4,0,1,2
S01012802,Occupancy rating +2 or more,184,21,4,17,157,17,129,39,68,22,11,5,6,6,3,0,1,2
S01012802,Occupancy rating +1,9,2,2,0,7,0,6,2,3,1,1,1,0,0,0,0,0,0
S01012802,Occupancy rating 0,11,2,1,1,8,0,6,0,0,6,2,0,2,1,1,0,0,0
S01012802,Occupancy rating -1 or less,3,0,0,0,3,0,3,0,3,0,0,0,0,0,0,0,0,0
S01012803,All households,262,54,26,28,202,20,158,55,70,33,24,14,10,6,3,0,0,3
S01012803,Occupancy rating +2 or more,177,46,24,22,130,20,99,52,31,16,11,7,4,1,1,0,0,0
S01012803,Occupancy rating +1,48,6,1,5,41,0,36,2,22,12,5,1,4,1,0,0,0,1
S01012803,Occupancy rating 0,28,2,1,1,23,0,16,0,11,5,7,5,2,3,1,0,0,2
S01012803,Occupancy rating -1 or less,9,0,0,0,8,0,7,1,6,0,1,1,0,1,1,0,0,0
S01012804,All households,351,149,58,91,191,18,121,33,57,31,52,32,20,11,6,0,1,4
S01012804,Occupancy rating +2 or more,85,32,15,17,52,9,39,14,13,12,4,1,3,1,0,0,0,1
S01012804,Occupancy rating +1,78,38,16,22,37,8,23,14,5,4,6,2,4,3,1,0,0,2
S01012804,Occupancy rating 0,143,68,25,43,69,0,42,5,25,12,27,18,9,6,4,0,1,1
S01012804,Occupancy rating -1 or less,45,11,2,9,33,1,17,0,14,3,15,11,4,1,1,0,0,0
S01012805,All households,383,110,46,64,245,24,153,46,64,43,68,38,30,28,13,1,4,10
S01012805,Occupancy rating +2 or more,84,29,19,10,47,10,33,20,8,5,4,0,4,8,0,1,1,6
S01012805,Occupancy rating +1,153,62,21,41,87,12,56,23,18,15,19,6,13,4,2,0,1,1
S01012805,Occupancy rating 0,93,12,2,10,74,1,44,1,27,16,29,20,9,7,3,0,2,2
S01012805,Occupancy rating -1 or less,53,7,4,3,37,1,20,2,11,7,16,12,4,9,8,0,0,1
S01012806,All households,299,89,29,60,203,18,142,45,74,23,43,26,17,7,5,0,0,2
S01012806,Occupancy rating +2 or more,123,28,11,17,94,8,78,26,42,10,8,5,3,1,1,0,0,0
S01012806,Occupancy rating +1,73,29,9,20,44,6,31,17,9,5,7,4,3,0,0,0,0,0
S01012806,Occupancy rating 0,70,23,5,18,46,3,21,1,15,5,22,12,10,1,1,0,0,0
S01012806,Occupancy rating -1 or less,33,9,4,5,19,1,12,1,8,3,6,5,1,5,3,0,0,2
S01012807,All households,218,42,15,27,167,27,132,44,64,24,8,6,2,9,5,0,0,4
S01012807,Occupancy rating +2 or more,182,23,9,14,151,26,118,36,60,22,7,6,1,8,5,0,0,3
S01012807,Occupancy rating +1,23,14,4,10,8,0,8,7,0,1,0,0,0,1,0,0,0,1
S01012807,Occupancy rating 0,12,5,2,3,7,1,5,1,3,1,1,0,1,0,0,0,0,0
S01012807,Occupancy rating -1 or less,1,0,0,0,1,0,1,0,1,0,0,0,0,0,0,0,0,0
S01012808,All households,475,172,95,77,290,49,210,67,99,44,31,14,17,13,7,0,2,4
S01012808,Occupancy rating +2 or more,238,43,21,22,192,26,155,52,77,26,11,5,6,3,1,0,0,2
S01012808,Occupancy rating +1,106,61,27,34,44,17,22,13,4,5,5,2,3,1,1,0,0,0
S01012808,Occupancy rating 0,101,60,42,18,37,5,22,2,11,9,10,4,6,4,2,0,1,1
S01012808,Occupancy rating -1 or less,30,8,5,3,17,1,11,0,7,4,5,3,2,5,3,0,1,1
S01012809,All households,337,178,35,143,153,26,102,48,38,16,25,19,6,6,3,0,0,3
S01012809,Occupancy rating +2 or more,107,31,15,16,74,20,45,17,19,9,9,6,3,2,2,0,0,0
S01012809,Occupancy rating +1,86,45,10,35,40,5,31,15,13,3,4,2,2,1,0,0,0,1
S01012809,Occupancy rating 0,107,78,8,70,27,1,16,12,2,2,10,9,1,2,0,0,0,2
S01012809,Occupancy rating -1 or less,37,24,2,22,12,0,10,4,4,2,2,2,0,1,1,0,0,0
S01012810,All households,481,273,98,175,184,19,111,48,41,22,54,36,18,24,10,0,1,13
S01012810,Occupancy rating +2 or more,69,20,11,9,49,3,42,18,16,8,4,4,0,0,0,0,0,0
S01012810,Occupancy rating +1,139,87,30,57,47,11,31,21,5,5,5,3,2,5,3,0,0,2
S01012810,Occupancy rating 0,179,101,43,58,68,3,28,7,13,8,37,23,14,10,1,0,1,8
S01012810,Occupancy rating -1 or less,94,65,14,51,20,2,10,2,7,1,8,6,2,9,6,0,0,3
S01012811,All households,348,114,69,45,218,37,137,49,53,35,44,22,22,16,7,0,2,7
S01012811,Occupancy rating +2 or more,129,36,23,13,87,13,68,28,25,15,6,3,3,6,2,0,1,3
S01012811,Occupancy rating +1,112,52,30,22,57,18,32,18,9,5,7,2,5,3,2,0,1,0
S01012811,Occupancy rating 0,75,21,12,9,51,4,25,2,13,10,22,12,10,3,1,0,0,2
S01012811,Occupancy rating -1 or less,32,5,4,1,23,2,12,1,6,5,9,5,4,4,2,0,0,2
S01012812,All households,285,87,28,59,182,14,145,54,57,34,23,16,7,16,4,0,0,12
S01012812,Occupancy rating +2 or more,89,13,5,8,74,10,63,26,19,18,1,1,0,2,0,0,0,2
S01012812,Occupancy rating +1,82,45,14,31,35,3,27,20,6,1,5,3,2,2,0,0,0,2
S01012812,Occupancy rating 0,90,28,8,20,56,1,40,7,24,9,15,10,5,6,1,0,0,5
S01012812,Occupancy rating -1 or less,24,1,1,0,17,0,15,1,8,6,2,2,0,6,3,0,0,3
S01012813,All households,372,80,38,42,286,71,198,79,75,44,17,7,10,6,2,0,0,4
S01012813,Occupancy rating +2 or more,263,42,20,22,216,63,143,66,49,28,10,5,5,5,1,0,0,4
S01012813,Occupancy rating +1,85,34,16,18,51,7,41,12,20,9,3,1,2,0,0,0,0,0
S01012813,Occupancy rating 0,14,3,1,2,11,0,10,1,3,6,1,0,1,0,0,0,0,0
S01012813,Occupancy rating -1 or less,10,1,1,0,8,1,4,0,3,1,3,1,2,1,1,0,0,0
S01012814,All households,333,77,17,60,248,9,207,75,107,25,32,23,9,8,3,0,0,5
S01012814,Occupancy rating +2 or more,148,37,13,24,109,3,99,47,45,7,7,5,2,2,0,0,0,2
S01012814,Occupancy rating +1,117,32,3,29,83,6,69,27,34,8,8,7,1,2,0,0,0,2
S01012814,Occupancy rating 0,60,6,1,5,52,0,35,1,25,9,17,11,6,2,1,0,0,1
S01012814,Occupancy rating -1 or less,8,2,0,2,4,0,4,0,3,1,0,0,0,2,2,0,0,0
S01012815,All households,320,60,5,55,248,5,212,64,131,17,31,24,7,12,6,0,0,6
S01012815,Occupancy rating +2 or more,200,28,3,25,166,4,153,51,89,13,9,7,2,6,2,0,0,4
S01012815,Occupancy rating +1,75,23,1,22,48,0,36,6,27,3,12,8,4,4,3,0,0,1
S01012815,Occupancy rating 0,34,8,0,8,25,1,19,6,12,1,5,4,1,1,1,0,0,0
S01012815,Occupancy rating -1 or less,11,1,1,0,9,0,4,1,3,0,5,5,0,1,0,0,0,1
S01012816,All households,229,59,9,50,161,7,123,44,70,9,31,24,7,9,5,0,0,4
S01012816,Occupancy rating +2 or more,104,24,5,19,77,3,69,28,37,4,5,5,0,3,2,0,0,1
S01012816,Occupancy rating +1,73,25,3,22,46,1,38,15,20,3,7,5,2,2,0,0,0,2
S01012816,Occupancy rating 0,37,8,0,8,27,3,12,0,11,1,12,8,4,2,1,0,0,1
S01012816,Occupancy rating -1 or less,15,2,1,1,11,0,4,1,2,1,7,6,1,2,2,0,0,0
S01012817,All households,175,18,1,17,150,3,130,21,94,15,17,14,3,7,4,0,0,3
S01012817,Occupancy rating +2 or more,138,16,0,16,117,3,104,21,71,12,10,8,2,5,2,0,0,3
S01012817,Occupancy rating +1,23,2,1,1,20,0,16,0,15,1,4,3,1,1,1,0,0,0
S01012817,Occupancy rating 0,12,0,0,0,11,0,8,0,7,1,3,3,0,1,1,0,0,0
S01012817,Occupancy rating -1 or less,2,0,0,0,2,0,2,0,1,1,0,0,0,0,0,0,0,0
S01012818,All households,271,24,6,18,232,14,195,47,114,34,23,16,7,15,9,0,0,6
S01012818,Occupancy rating +2 or more,201,21,6,15,170,12,144,46,79,19,14,9,5,10,5,0,0,5
S01012818,Occupancy rating +1,40,3,0,3,35,1,32,0,24,8,2,1,1,2,2,0,0,0
S01012818,Occupancy rating 0,17,0,0,0,15,1,10,1,6,3,4,3,1,2,1,0,0,1
S01012818,Occupancy rating -1 or less,13,0,0,0,12,0,9,0,5,4,3,3,0,1,1,0,0,0
S01012819,All households,365,150,58,92,199,20,100,39,40,21,79,49,30,16,4,0,0,12
S01012819,Occupancy rating +2 or more,77,30,12,18,47,8,36,22,7,7,3,2,1,0,0,0,0,0
S01012819,Occupancy rating +1,143,85,30,55,54,9,31,12,13,6,14,5,9,4,0,0,0,4
S01012819,Occupancy rating 0,106,26,12,14,74,2,24,2,18,4,48,32,16,6,0,0,0,6
S01012819,Occupancy rating -1 or less,39,9,4,5,24,1,9,3,2,4,14,10,4,6,4,0,0,2
S01012820,All households,370,51,8,43,302,5,254,96,125,33,43,36,7,17,9,0,0,8
S01012820,Occupancy rating +2 or more,215,23,2,21,185,5,165,81,72,12,15,13,2,7,4,0,0,3
S01012820,Occupancy rating +1,98,23,5,18,73,0,57,13,33,11,16,12,4,2,2,0,0,0
S01012820,Occupancy rating 0,40,3,0,3,31,0,24,1,15,8,7,6,1,6,2,0,0,4
S01012820,Occupancy rating -1 or less,17,2,1,1,13,0,8,1,5,2,5,5,0,2,1,0,0,1
S01012821,All households,263,43,5,38,207,3,173,50,108,15,31,26,5,13,7,0,0,6
S01012821,Occupancy rating +2 or more,154,28,4,24,122,3,108,43,62,3,11,10,1,4,2,0,0,2
S01012821,Occupancy rating +1,61,12,0,12,45,0,40,7,26,7,5,5,0,4,2,0,0,2
S01012821,Occupancy rating 0,38,3,1,2,31,0,18,0,15,3,13,9,4,4,2,0,0,2
S01012821,Occupancy rating -1 or less,10,0,0,0,9,0,7,0,5,2,2,2,0,1,1,0,0,0
S01012822,All households,256,118,27,91,127,4,49,23,16,10,74,62,12,11,2,0,0,9
S01012822,Occupancy rating +2 or more,20,11,1,10,9,1,7,5,0,2,1,1,0,0,0,0,0,0
S01012822,Occupancy rating +1,83,59,17,42,24,2,16,13,3,0,6,5,1,0,0,0,0,0
S01012822,Occupancy rating 0,93,28,6,22,62,0,21,5,8,8,41,33,8,3,0,0,0,3
S01012822,Occupancy rating -1 or less,60,20,3,17,32,1,5,0,5,0,26,23,3,8,2,0,0,6
S01012823,All households,285,42,3,39,229,5,197,61,116,20,27,15,12,14,10,0,0,4
S01012823,Occupancy rating +2 or more,164,28,2,26,131,2,120,50,61,9,9,2,7,5,5,0,0,0
S01012823,Occupancy rating +1,71,13,1,12,53,3,42,9,27,6,8,6,2,5,2,0,0,3
S01012823,Occupancy rating 0,37,1,0,1,34,0,29,1,23,5,5,4,1,2,1,0,0,1
S01012823,Occupancy rating -1 or less,13,0,0,0,11,0,6,1,5,0,5,3,2,2,2,0,0,0
S01012824,All households,273,73,19,54,182,22,122,43,56,23,38,25,13,18,8,0,0,10
S01012824,Occupancy rating +2 or more,125,32,12,20,89,17,61,26,28,7,11,7,4,4,0,0,0,4
S01012824,Occupancy rating +1,91,34,7,27,53,3,38,16,13,9,12,5,7,4,2,0,0,2
S01012824,Occupancy rating 0,45,7,0,7,34,2,21,1,13,7,11,10,1,4,1,0,0,3
S01012824,Occupancy rating -1 or less,12,0,0,0,6,0,2,0,2,0,4,3,1,6,5,0,0,1
S01012825,All households,269,130,37,93,126,16,71,42,23,6,39,24,15,13,3,0,0,10
S01012825,Occupancy rating +2 or more,54,21,10,11,31,9,20,18,1,1,2,1,1,2,1,0,0,1
S01012825,Occupancy rating +1,125,80,20,60,45,5,30,18,11,1,10,7,3,0,0,0,0,0
S01012825,Occupancy rating 0,71,25,7,18,36,0,16,3,10,3,20,11,9,10,1,0,0,9
S01012825,Occupancy rating -1 or less,19,4,0,4,14,2,5,3,1,1,7,5,2,1,1,0,0,0
S01012826,All households,231,65,5,60,149,3,64,18,33,13,82,65,17,17,13,0,0,4
S01012826,Occupancy rating +2 or more,46,19,2,17,27,2,18,10,6,2,7,4,3,0,0,0,0,0
S01012826,Occupancy rating +1,67,17,2,15,48,1,22,6,9,7,25,21,4,2,1,0,0,1
S01012826,Occupancy rating 0,79,22,1,21,50,0,16,2,11,3,34,28,6,7,6,0,0,1
S01012826,Occupancy rating -1 or less,39,7,0,7,24,0,8,0,7,1,16,12,4,8,6,0,0,2
S01012827,All households,233,36,2,34,185,3,161,43,110,8,21,16,5,12,9,0,0,3
S01012827,Occupancy rating +2 or more,128,23,1,22,100,2,87,30,51,6,11,9,2,5,3,0,0,2
S01012827,Occupancy rating +1,62,5,0,5,55,0,51,11,39,1,4,2,2,2,2,0,0,0
S01012827,Occupancy rating 0,32,7,0,7,23,0,18,2,15,1,5,4,1,2,2,0,0,0
S01012827,Occupancy rating -1 or less,11,1,1,0,7,1,5,0,5,0,1,1,0,3,2,0,0,1
S01012828,All households,254,66,6,60,179,5,155,70,72,13,19,14,5,9,5,0,0,4
S01012828,Occupancy rating +2 or more,127,30,2,28,95,2,92,44,43,5,1,1,0,2,2,0,0,0
S01012828,Occupancy rating +1,88,30,2,28,55,3,45,22,18,5,7,3,4,3,2,0,0,1
S01012828,Occupancy rating 0,31,2,0,2,26,0,16,4,9,3,10,9,1,3,1,0,0,2
S01012828,Occupancy rating -1 or less,8,4,2,2,3,0,2,0,2,0,1,1,0,1,0,0,0,1
S01012829,All households,362,103,37,66,239,20,130,47,55,28,89,65,24,20,9,0,1,10
S01012829,Occupancy rating +2 or more,78,34,9,25,41,8,32,20,8,4,1,1,0,3,0,0,0,3
S01012829,Occupancy rating +1,135,60,26,34,71,9,38,23,11,4,24,16,8,4,2,0,1,1
S01012829,Occupancy rating 0,104,5,0,5,91,2,41,2,23,16,48,36,12,8,3,0,0,5
S01012829,Occupancy rating -1 or less,45,4,2,2,36,1,19,2,13,4,16,12,4,5,4,0,0,1
S01012830,All households,313,113,50,63,188,18,132,50,53,29,38,22,16,12,6,0,3,3
S01012830,Occupancy rating +2 or more,106,29,11,18,71,5,62,27,24,11,4,2,2,6,2,0,1,3
S01012830,Occupancy rating +1,102,52,24,28,48,8,26,13,8,5,14,4,10,2,2,0,0,0
S01012830,Occupancy rating 0,86,26,11,15,56,3,34,5,17,12,19,16,3,4,2,0,2,0
S01012830,Occupancy rating -1 or less,19,6,4,2,13,2,10,5,4,1,1,0,1,0,0,0,0,0
S01012831,All households,333,155,85,70,163,26,93,35,29,29,44,16,28,15,6,0,1,8
S01012831,Occupancy rating +2 or more,90,37,21,16,52,14,32,15,8,9,6,2,4,1,0,0,0,1
S01012831,Occupancy rating +1,126,71,38,33,51,7,35,17,10,8,9,2,7,4,2,0,0,2
S01012831,Occupancy rating 0,84,36,17,19,43,4,20,2,9,9,19,6,13,5,0,0,1,4
S01012831,Occupancy rating -1 or less,33,11,9,2,17,1,6,1,2,3,10,6,4,5,4,0,0,1
S01012832,All households,215,57,21,36,144,11,97,35,39,23,36,19,17,14,7,0,3,4
S01012832,Occupancy rating +2 or more,75,29,10,19,45,6,36,20,12,4,3,1,2,1,0,0,0,1
S01012832,Occupancy rating +1,70,25,9,16,43,5,31,12,10,9,7,4,3,2,0,0,1,1
S01012832,Occupancy rating 0,52,3,2,1,43,0,24,3,12,9,19,8,11,6,4,0,1,1
S01012832,Occupancy rating -1 or less,18,0,0,0,13,0,6,0,5,1,7,6,1,5,3,0,1,1
S01012833,All households,319,102,30,72,189,27,81,31,26,24,81,57,24,28,9,0,1,18
S01012833,Occupancy rating +2 or more,68,31,7,24,36,12,18,14,2,2,6,4,2,1,0,0,0,1
S01012833,Occupancy rating +1,98,51,20,31,45,12,19,12,5,2,14,8,6,2,0,0,0,2
S01012833,Occupancy rating 0,106,11,2,9,80,2,29,4,11,14,49,37,12,15,3,0,1,11
S01012833,Occupancy rating -1 or less,47,9,1,8,28,1,15,1,8,6,12,8,4,10,6,0,0,4
S01012834,All households,289,100,26,74,172,17,96,39,35,22,59,37,22,17,9,0,1,7
S01012834,Occupancy rating +2 or more,88,23,10,13,65,10,47,25,14,8,8,4,4,0,0,0,0,0
S01012834,Occupancy rating +1,99,62,15,47,36,6,25,11,7,7,5,3,2,1,0,0,0,1
S01012834,Occupancy rating 0,68,8,0,8,52,1,17,2,10,5,34,20,14,8,3,0,1,4
S01012834,Occupancy rating -1 or less,34,7,1,6,19,0,7,1,4,2,12,10,2,8,6,0,0,2
S01012835,All households,403,153,60,93,235,27,151,76,48,27,57,33,24,15,2,0,1,12
S01012835,Occupancy rating +2 or more,111,36,24,12,72,12,55,35,18,2,5,1,4,3,1,0,0,2
S01012835,Occupancy rating +1,150,67,21,46,79,14,48,25,10,13,17,10,7,4,0,0,1,3
S01012835,Occupancy rating 0,104,36,9,27,63,1,38,15,14,9,24,16,8,5,1,0,0,4
S01012835,Occupancy rating -1 or less,38,14,6,8,21,0,10,1,6,3,11,6,5,3,0,0,0,3
S01012836,All households,220,21,2,19,193,1,161,43,100,18,31,23,8,6,3,0,0,3
S01012836,Occupancy rating +2 or more,165,17,2,15,145,1,126,34,78,14,18,12,6,3,2,0,0,1
S01012836,Occupancy rating +1,39,4,0,4,33,0,28,9,16,3,5,5,0,2,1,0,0,1
S01012836,Occupancy rating 0,13,0,0,0,12,0,5,0,4,1,7,6,1,1,0,0,0,1
S01012836,Occupancy rating -1 or less,3,0,0,0,3,0,2,0,2,0,1,0,1,0,0,0,0,0
S01012837,All households,414,232,37,195,171,5,77,25,44,8,89,72,17,11,4,0,1,6
S01012837,Occupancy rating +2 or more,49,37,9,28,12,0,10,5,3,2,2,1,1,0,0,0,0,0
S01012837,Occupancy rating +1,181,130,15,115,50,3,30,16,12,2,17,17,0,1,0,0,1,0
S01012837,Occupancy rating 0,134,49,10,39,82,1,24,3,20,1,57,44,13,3,0,0,0,3
S01012837,Occupancy rating -1 or less,50,16,3,13,27,1,13,1,9,3,13,10,3,7,4,0,0,3
S01012838,All households,528,292,31,261,218,4,89,37,38,14,125,104,21,18,4,0,0,14
S01012838,Occupancy rating +2 or more,85,57,5,52,27,0,18,7,7,4,9,8,1,1,0,0,0,1
S01012838,Occupancy rating +1,251,180,17,163,69,4,36,22,13,1,29,25,4,2,0,0,0,2
S01012838,Occupancy rating 0,143,34,4,30,97,0,24,5,13,6,73,57,16,12,3,0,0,9
S01012838,Occupancy rating -1 or less,49,21,5,16,25,0,11,3,5,3,14,14,0,3,1,0,0,2
S01012839,All households,300,85,21,64,206,19,163,72,47,44,24,18,6,9,4,0,0,5
S01012839,Occupancy rating +2 or more,104,20,7,13,83,14,67,43,10,14,2,1,1,1,0,0,0,1
S01012839,Occupancy rating +1,113,50,11,39,59,5,50,26,6,18,4,2,2,4,1,0,0,3
S01012839,Occupancy rating 0,68,13,3,10,53,0,36,3,24,9,17,14,3,2,1,0,0,1
S01012839,Occupancy rating -1 or less,15,2,0,2,11,0,10,0,7,3,1,1,0,2,2,0,0,0
S01012840,All households,285,47,5,42,229,3,202,70,111,21,24,20,4,9,5,0,0,4
S01012840,Occupancy rating +2 or more,183,17,3,14,161,1,152,51,91,10,8,8,0,5,2,0,0,3
S01012840,Occupancy rating +1,63,26,2,24,36,1,30,18,5,7,5,3,2,1,1,0,0,0
S01012840,Occupancy rating 0,30,2,0,2,26,1,15,1,12,2,10,8,2,2,1,0,0,1
S01012840,Occupancy rating -1 or less,9,2,0,2,6,0,5,0,3,2,1,1,0,1,1,0,0,0
S01012841,All households,253,56,17,39,194,21,148,68,50,30,25,16,9,3,1,0,0,2
S01012841,Occupancy rating +2 or more,122,12,3,9,109,15,86,46,24,16,8,6,2,1,0,0,0,1
S01012841,Occupancy rating +1,91,38,11,27,52,6,42,19,12,11,4,1,3,1,0,0,0,1
S01012841,Occupancy rating 0,31,4,2,2,27,0,15,2,10,3,12,8,4,0,0,0,0,0
S01012841,Occupancy rating -1 or less,9,2,1,1,6,0,5,1,4,0,1,1,0,1,1,0,0,0
S01012842,All households,198,36,8,28,157,11,121,58,35,28,25,17,8,5,1,0,0,4
S01012842,Occupancy rating +2 or more,74,7,2,5,63,7,50,24,13,13,6,2,4,4,1,0,0,3
S01012842,Occupancy rating +1,68,28,6,22,40,3,33,29,1,3,4,4,0,0,0,0,0,0
S01012842,Occupancy rating 0,39,1,0,1,38,0,28,5,15,8,10,8,2,0,0,0,0,0
S01012842,Occupancy rating -1 or less,17,0,0,0,16,1,10,0,6,4,5,3,2,1,0,0,0,1
S01012843,All households,381,82,45,37,290,48,221,80,106,35,21,14,7,9,3,0,1,5
S01012843,Occupancy rating +2 or more,271,46,32,14,219,42,168,66,74,28,9,4,5,6,3,0,1,2
S01012843,Occupancy rating +1,55,17,12,5,38,6,27,7,16,4,5,4,1,0,0,0,0,0
S01012843,Occupancy rating 0,43,15,1,14,27,0,21,6,13,2,6,5,1,1,0,0,0,1
S01012843,Occupancy rating -1 or less,12,4,0,4,6,0,5,1,3,1,1,1,0,2,0,0,0,2
S01012844,All households,249,43,19,24,194,15,165,50,83,32,14,4,10,12,6,0,1,5
S01012844,Occupancy rating +2 or more,210,33,18,15,170,12,148,48,73,27,10,3,7,7,2,0,1,4
S01012844,Occupancy rating +1,20,4,0,4,13,2,10,2,6,2,1,0,1,3,2,0,0,1
S01012844,Occupancy rating 0,17,5,1,4,11,1,7,0,4,3,3,1,2,1,1,0,0,0
S01012844,Occupancy rating -1 or less,2,1,0,1,0,0,0,0,0,0,0,0,0,1,1,0,0,0
S01012845,All households,281,80,30,50,196,23,141,44,72,25,32,18,14,5,1,0,0,4
S01012845,Occupancy rating +2 or more,186,38,21,17,144,15,110,39,51,20,19,10,9,4,1,0,0,3
S01012845,Occupancy rating +1,53,25,8,17,27,8,17,4,10,3,2,1,1,1,0,0,0,1
S01012845,Occupancy rating 0,35,16,0,16,19,0,10,1,8,1,9,5,4,0,0,0,0,0
S01012845,Occupancy rating -1 or less,7,1,1,0,6,0,4,0,3,1,2,2,0,0,0,0,0,0
S01012846,All households,543,288,116,172,237,41,117,59,37,21,79,45,34,18,2,4,4,8
S01012846,Occupancy rating +2 or more,73,24,9,15,48,8,35,19,12,4,5,3,2,1,1,0,0,0
S01012846,Occupancy rating +1,238,164,82,82,73,23,36,25,8,3,14,9,5,1,0,0,0,1
S01012846,Occupancy rating 0,161,67,13,54,83,8,33,9,12,12,42,24,18,11,0,4,4,3
S01012846,Occupancy rating -1 or less,71,33,12,21,33,2,13,6,5,2,18,9,9,5,1,0,0,4
S01012847,All households,249,93,54,39,150,17,111,35,56,20,22,13,9,6,4,0,1,1
S01012847,Occupancy rating +2 or more,93,16,5,11,75,11,59,24,25,10,5,1,4,2,2,0,0,0
S01012847,Occupancy rating +1,67,30,11,19,37,2,32,10,16,6,3,2,1,0,0,0,0,0
S01012847,Occupancy rating 0,66,32,28,4,33,3,18,1,13,4,12,9,3,1,0,0,1,0
S01012847,Occupancy rating -1 or less,23,15,10,5,5,1,2,0,2,0,2,1,1,3,2,0,0,1
S01012848,All households,283,55,24,31,210,20,163,41,98,24,27,14,13,18,9,0,0,9
S01012848,Occupancy rating +2 or more,144,29,12,17,111,12,87,30,50,7,12,4,8,4,2,0,0,2
S01012848,Occupancy rating +1,93,24,10,14,66,7,52,11,32,9,7,5,2,3,2,0,0,1
S01012848,Occupancy rating 0,35,2,2,0,26,0,19,0,15,4,7,4,3,7,2,0,0,5
S01012848,Occupancy rating -1 or less,11,0,0,0,7,1,5,0,1,4,1,1,0,4,3,0,0,1
S01012849,All households,345,131,33,98,196,19,127,58,56,13,50,33,17,18,4,0,0,14
S01012849,Occupancy rating +2 or more,52,18,7,11,34,4,28,12,12,4,2,1,1,0,0,0,0,0
S01012849,Occupancy rating +1,133,76,19,57,53,13,38,28,9,1,2,1,1,4,0,0,0,4
S01012849,Occupancy rating 0,117,30,6,24,81,0,48,14,27,7,33,23,10,6,0,0,0,6
S01012849,Occupancy rating -1 or less,43,7,1,6,28,2,13,4,8,1,13,8,5,8,4,0,0,4
S01012850,All households,339,125,70,55,195,29,112,39,31,42,54,31,23,19,3,0,3,13
S01012850,Occupancy rating +2 or more,80,40,24,16,39,11,22,16,3,3,6,2,4,1,0,0,1,0
S01012850,Occupancy rating +1,153,73,43,30,76,16,43,21,9,13,17,11,6,4,1,0,0,3
S01012850,Occupancy rating 0,74,11,3,8,55,1,32,1,11,20,22,12,10,8,1,0,1,6
S01012850,Occupancy rating -1 or less,32,1,0,1,25,1,15,1,8,6,9,6,3,6,1,0,1,4
S01012851,All households,374,127,73,54,228,37,145,71,50,24,46,24,22,19,7,0,0,12
S01012851,Occupancy rating +2 or more,145,56,31,25,88,20,64,35,20,9,4,0,4,1,0,0,0,1
S01012851,Occupancy rating +1,132,52,32,20,76,13,51,34,13,4,12,8,4,4,1,0,0,3
S01012851,Occupancy rating 0,69,17,9,8,46,2,21,1,11,9,23,13,10,6,2,0,0,4
S01012851,Occupancy rating -1 or less,28,2,1,1,18,2,9,1,6,2,7,3,4,8,4,0,0,4
S01012852,All households,298,84,43,41,195,25,150,59,54,37,20,7,13,19,7,0,3,9
S01012852,Occupancy rating +2 or more,174,49,27,22,117,24,89,42,28,19,4,2,2,8,1,0,2,5
S01012852,Occupancy rating +1,85,29,14,15,51,1,44,14,18,12,6,2,4,5,3,0,1,1
S01012852,Occupancy rating 0,33,4,1,3,24,0,15,3,6,6,9,2,7,5,3,0,0,2
S01012852,Occupancy rating -1 or less,6,2,1,1,3,0,2,0,2,0,1,1,0,1,0,0,0,1
S01012853,All households,338,93,56,37,232,51,162,67,47,48,19,12,7,13,6,0,0,7
S01012853,Occupancy rating +2 or more,172,52,27,25,117,24,87,48,20,19,6,4,2,3,0,0,0,3
S01012853,Occupancy rating +1,114,38,28,10,75,22,48,17,13,18,5,4,1,1,1,0,0,0
S01012853,Occupancy rating 0,39,2,1,1,31,4,21,2,12,7,6,3,3,6,4,0,0,2
S01012853,Occupancy rating -1 or less,13,1,0,1,9,1,6,0,2,4,2,1,1,3,1,0,0,2
S01012854,All households,374,128,38,90,223,20,170,76,63,31,33,22,11,23,3,2,2,16
S01012854,Occupancy rating +2 or more,132,29,9,20,98,8,82,35,29,18,8,4,4,5,0,1,1,3
S01012854,Occupancy rating +1,141,70,21,49,67,10,52,31,18,3,5,4,1,4,1,1,1,1
S01012854,Occupancy rating 0,80,23,8,15,47,1,32,10,14,8,14,10,4,10,1,0,0,9
S01012854,Occupancy rating -1 or less,21,6,0,6,11,1,4,0,2,2,6,4,2,4,1,0,0,3
S01012855,All households,284,97,10,87,175,7,147,57,62,28,21,13,8,12,3,0,2,7
S01012855,Occupancy rating +2 or more,109,22,5,17,82,4,74,29,30,15,4,1,3,5,1,0,1,3
S01012855,Occupancy rating +1,75,37,3,34,38,1,36,20,9,7,1,1,0,0,0,0,0,0
S01012855,Occupancy rating 0,80,31,1,30,46,2,32,8,19,5,12,8,4,3,0,0,1,2
S01012855,Occupancy rating -1 or less,20,7,1,6,9,0,5,0,4,1,4,3,1,4,2,0,0,2
S01012856,All households,414,247,113,134,154,17,108,69,22,17,29,14,15,13,7,0,1,5
S01012856,Occupancy rating +2 or more,62,33,16,17,29,2,26,22,2,2,1,1,0,0,0,0,0,0
S01012856,Occupancy rating +1,134,80,35,45,53,8,40,32,4,4,5,1,4,1,0,0,0,1
S01012856,Occupancy rating 0,178,116,52,64,58,5,38,14,14,10,15,6,9,4,2,0,1,1
S01012856,Occupancy rating -1 or less,40,18,10,8,14,2,4,1,2,1,8,6,2,8,5,0,0,3
S01012857,All households,472,258,113,145,199,42,105,51,36,18,52,28,24,15,4,0,2,9
S01012857,Occupancy rating +2 or more,77,35,17,18,41,11,25,16,6,3,5,2,3,1,0,0,1,0
S01012857,Occupancy rating +1,168,104,49,55,60,20,36,22,9,5,4,0,4,4,1,0,0,3
S01012857,Occupancy rating 0,161,87,33,54,69,7,32,13,11,8,30,15,15,5,1,0,1,3
S01012857,Occupancy rating -1 or less,66,32,14,18,29,4,12,0,10,2,13,11,2,5,2,0,0,3
S01012858,All households,422,250,69,181,157,13,93,49,23,21,51,34,17,15,2,1,0,12
S01012858,Occupancy rating +2 or more,31,17,1,16,14,4,10,5,3,2,0,0,0,0,0,0,0,0
S01012858,Occupancy rating +1,101,52,10,42,46,3,34,28,3,3,9,4,5,3,0,1,0,2
S01012858,Occupancy rating 0,230,146,45,101,74,3,38,14,10,14,33,25,8,10,2,0,0,8
S01012858,Occupancy rating -1 or less,60,35,13,22,23,3,11,2,7,2,9,5,4,2,0,0,0,2
S01012859,All households,530,240,44,196,249,24,178,79,83,16,47,33,14,41,7,14,1,19
S01012859,Occupancy rating +2 or more,98,28,4,24,67,6,55,23,25,7,6,4,2,3,1,0,1,1
S01012859,Occupancy rating +1,152,86,12,74,65,10,50,32,16,2,5,4,1,1,0,0,0,1
S01012859,Occupancy rating 0,196,92,22,70,81,6,52,21,28,3,23,20,3,23,4,9,0,10
S01012859,Occupancy rating -1 or less,84,34,6,28,36,2,21,3,14,4,13,5,8,14,2,5,0,7
S01012860,All households,382,157,103,54,214,35,144,50,55,39,35,23,12,11,5,0,0,6
S01012860,Occupancy rating +2 or more,138,32,16,16,103,12,87,31,34,22,4,0,4,3,2,0,0,1
S01012860,Occupancy rating +1,115,54,30,24,57,15,33,16,7,10,9,4,5,4,1,0,0,3
S01012860,Occupancy rating 0,95,54,47,7,39,6,17,2,10,5,16,14,2,2,0,0,0,2
S01012860,Occupancy rating -1 or less,34,17,10,7,15,2,7,1,4,2,6,5,1,2,2,0,0,0
S01012861,All households,322,117,48,69,191,21,142,60,58,24,28,17,11,14,4,0,2,8
S01012861,Occupancy rating +2 or more,104,33,19,14,67,8,57,20,29,8,2,1,1,4,0,0,2,2
S01012861,Occupancy rating +1,116,46,19,27,66,9,46,30,10,6,11,7,4,4,0,0,0,4
S01012861,Occupancy rating 0,78,32,7,25,42,3,30,8,16,6,9,5,4,4,3,0,0,1
S01012861,Occupancy rating -1 or less,24,6,3,3,16,1,9,2,3,4,6,4,2,2,1,0,0,1
S01012862,All households,369,236,80,156,114,13,58,28,19,11,43,32,11,19,3,4,2,10
S01012862,Occupancy rating +2 or more,39,32,18,14,6,0,5,5,0,0,1,1,0,1,0,0,0,1
S01012862,Occupancy rating +1,96,59,19,40,35,10,16,6,6,4,9,4,5,2,0,0,0,2
S01012862,Occupancy rating 0,170,104,30,74,54,2,31,16,10,5,21,17,4,12,2,4,1,5
S01012862,Occupancy rating -1 or less,64,41,13,28,19,1,6,1,3,2,12,10,2,4,1,0,1,2
S01012863,All households,424,281,48,233,119,7,64,39,16,9,48,35,13,24,2,1,0,21
S01012863,Occupancy rating +2 or more,38,19,6,13,18,4,13,11,1,1,1,1,0,1,0,0,0,1
S01012863,Occupancy rating +1,106,84,15,69,19,1,16,10,3,3,2,2,0,3,0,0,0,3
S01012863,Occupancy rating 0,176,110,18,92,59,1,29,16,10,3,29,21,8,7,0,0,0,7
S01012863,Occupancy rating -1 or less,104,68,9,59,23,1,6,2,2,2,16,11,5,13,2,1,0,10
S01012864,All households,469,271,47,224,179,12,93,50,31,12,74,51,23,19,7,0,0,12
S01012864,Occupancy rating +2 or more,36,21,5,16,13,3,6,3,3,0,4,2,2,2,2,0,0,0
S01012864,Occupancy rating +1,153,102,15,87,50,4,33,29,3,1,13,7,6,1,0,0,0,1
S01012864,Occupancy rating 0,199,100,17,83,89,5,44,15,20,9,40,30,10,10,1,0,0,9
S01012864,Occupancy rating -1 or less,81,48,10,38,27,0,10,3,5,2,17,12,5,6,4,0,0,2
S01012865,All households,390,169,104,65,208,32,133,55,54,24,43,23,20,13,4,1,2,6
S01012865,Occupancy rating +2 or more,71,21,12,9,49,6,36,14,16,6,7,3,4,1,0,0,1,0
S01012865,Occupancy rating +1,153,80,46,34,71,15,52,34,14,4,4,2,2,2,0,0,0,2
S01012865,Occupancy rating 0,123,47,30,17,71,11,35,7,18,10,25,16,9,5,2,0,1,2
S01012865,Occupancy rating -1 or less,43,21,16,5,17,0,10,0,6,4,7,2,5,5,2,1,0,2
S01012866,All households,374,159,61,98,192,17,130,48,55,27,45,32,13,23,5,5,3,10
S01012866,Occupancy rating +2 or more,98,55,24,31,41,6,32,22,5,5,3,2,1,2,0,0,1,1
S01012866,Occupancy rating +1,157,67,21,46,84,8,58,25,23,10,18,10,8,6,1,1,2,2
S01012866,Occupancy rating 0,94,31,14,17,55,3,35,1,24,10,17,13,4,8,1,3,0,4
S01012866,Occupancy rating -1 or less,25,6,2,4,12,0,5,0,3,2,7,7,0,7,3,1,0,3
S01012867,All households,396,184,74,110,196,37,89,40,26,23,70,29,41,16,7,0,1,8
S01012867,Occupancy rating +2 or more,49,23,8,15,26,13,10,9,1,0,3,1,2,0,0,0,0,0
S01012867,Occupancy rating +1,161,95,43,52,64,16,32,22,3,7,16,8,8,2,0,0,1,1
S01012867,Occupancy rating 0,127,49,19,30,74,5,32,6,15,11,37,13,24,4,0,0,0,4
S01012867,Occupancy rating -1 or less,59,17,4,13,32,3,15,3,7,5,14,7,7,10,7,0,0,3
S01012868,All households,321,174,53,121,135,17,75,46,16,13,43,23,20,12,2,0,0,10
S01012868,Occupancy rating +2 or more,52,30,12,18,21,4,17,17,0,0,0,0,0,1,0,0,0,1
S01012868,Occupancy rating +1,109,68,19,49,40,8,26,20,4,2,6,4,2,1,0,0,0,1
S01012868,Occupancy rating 0,112,58,15,43,50,3,27,7,11,9,20,7,13,4,0,0,0,4
S01012868,Occupancy rating -1 or less,48,18,7,11,24,2,5,2,1,2,17,12,5,6,2,0,0,4
S01012869,All households,257,106,21,85,140,7,52,13,25,14,81,56,25,11,9,0,0,2
S01012869,Occupancy rating +2 or more,28,18,4,14,10,2,7,5,2,0,1,1,0,0,0,0,0,0
S01012869,Occupancy rating +1,86,48,9,39,35,3,17,5,7,5,15,4,11,3,2,0,0,1
S01012869,Occupancy rating 0,101,26,5,21,71,2,22,3,12,7,47,38,9,4,3,0,0,1
S01012869,Occupancy rating -1 or less,42,14,3,11,24,0,6,0,4,2,18,13,5,4,4,0,0,0
S01012870,All households,450,170,75,95,270,44,185,78,70,37,41,16,25,10,3,0,1,6
S01012870,Occupancy rating +2 or more,130,43,29,14,87,21,63,43,13,7,3,2,1,0,0,0,0,0
S01012870,Occupancy rating +1,156,60,29,31,93,18,67,29,24,14,8,2,6,3,1,0,0,2
S01012870,Occupancy rating 0,123,47,15,32,72,5,46,4,28,14,21,9,12,4,1,0,0,3
S01012870,Occupancy rating -1 or less,41,20,2,18,18,0,9,2,5,2,9,3,6,3,1,0,1,1
S01012871,All households,384,127,55,72,244,36,158,72,56,30,50,27,23,13,5,0,0,8
S01012871,Occupancy rating +2 or more,182,89,34,55,89,20,65,49,7,9,4,1,3,4,1,0,0,3
S01012871,Occupancy rating +1,117,24,14,10,91,12,54,17,26,11,25,16,9,2,0,0,0,2
S01012871,Occupancy rating 0,57,7,3,4,44,3,24,2,16,6,17,7,10,6,3,0,0,3
S01012871,Occupancy rating -1 or less,28,7,4,3,20,1,15,4,7,4,4,3,1,1,1,0,0,0
S01012872,All households,318,95,29,66,200,19,121,40,57,24,60,47,13,23,3,1,1,18
S01012872,Occupancy rating +2 or more,90,49,16,33,40,10,28,23,4,1,2,2,0,1,0,1,0,0
S01012872,Occupancy rating +1,105,33,9,24,68,6,40,14,19,7,22,17,5,4,0,0,0,4
S01012872,Occupancy rating 0,94,7,4,3,72,1,40,3,25,12,31,23,8,15,1,0,1,13
S01012872,Occupancy rating -1 or less,29,6,0,6,20,2,13,0,9,4,5,5,0,3,2,0,0,1
S01012873,All households,338,79,26,53,244,17,164,63,60,41,63,48,15,15,9,0,1,5
S01012873,Occupancy rating +2 or more,96,33,9,24,62,10,44,33,6,5,8,7,1,1,0,0,0,1
S01012873,Occupancy rating +1,132,35,11,24,94,6,69,29,24,16,19,15,4,3,0,0,1,2
S01012873,Occupancy rating 0,79,9,6,3,65,1,39,1,23,15,25,15,10,5,3,0,0,2
S01012873,Occupancy rating -1 or less,31,2,0,2,23,0,12,0,7,5,11,11,0,6,6,0,0,0
S01012874,All households,383,172,59,113,193,23,95,29,41,25,75,49,26,18,10,0,0,8
S01012874,Occupancy rating +2 or more,94,44,15,29,47,13,32,17,10,5,2,0,2,3,1,0,0,2
S01012874,Occupancy rating +1,131,80,22,58,46,8,23,9,9,5,15,10,5,5,2,0,0,3
S01012874,Occupancy rating 0,111,35,17,18,71,0,32,3,16,13,39,26,13,5,2,0,0,3
S01012874,Occupancy rating -1 or less,47,13,5,8,29,2,8,0,6,2,19,13,6,5,5,0,0,0
S01012875,All households,277,111,35,76,141,10,89,34,37,18,42,25,17,25,6,5,2,12
S01012875,Occupancy rating +2 or more,64,33,8,25,25,3,19,10,6,3,3,2,1,6,0,4,0,2
S01012875,Occupancy rating +1,114,62,19,43,45,5,32,22,7,3,8,5,3,7,0,1,0,6
S01012875,Occupancy rating 0,73,12,6,6,53,1,28,2,16,10,24,14,10,8,3,0,2,3
S01012875,Occupancy rating -1 or less,26,4,2,2,18,1,10,0,8,2,7,4,3,4,3,0,0,1
S01012876,All households,371,133,61,72,219,37,106,34,45,27,76,46,30,19,8,0,1,10
S01012876,Occupancy rating +2 or more,98,46,21,25,49,14,30,20,6,4,5,2,3,3,2,0,0,1
S01012876,Occupancy rating +1,130,57,20,37,71,16,34,12,11,11,21,12,9,2,0,0,0,2
S01012876,Occupancy rating 0,98,21,14,7,70,5,26,1,16,9,39,25,14,7,1,0,1,5
S01012876,Occupancy rating -1 or less,45,9,6,3,29,2,16,1,12,3,11,7,4,7,5,0,0,2
S01012877,All households,331,103,57,46,206,35,104,41,36,27,67,29,38,22,12,0,0,10
S01012877,Occupancy rating +2 or more,119,53,33,20,62,24,32,28,3,1,6,4,2,4,0,0,0,4
S01012877,Occupancy rating +1,117,35,17,18,79,11,39,9,15,15,29,11,18,3,2,0,0,1
S01012877,Occupancy rating 0,72,14,6,8,53,0,26,3,15,8,27,12,15,5,3,0,0,2
S01012877,Occupancy rating -1 or less,23,1,1,0,12,0,7,1,3,3,5,2,3,10,7,0,0,3
S01012878,All households,373,87,32,55,275,25,225,84,89,52,25,12,13,11,3,0,4,4
S01012878,Occupancy rating +2 or more,217,41,23,18,174,19,148,59,60,29,7,4,3,2,0,0,2,0
S01012878,Occupancy rating +1,71,19,5,14,51,3,41,12,18,11,7,2,5,1,0,0,1,0
S01012878,Occupancy rating 0,70,26,3,23,41,3,30,13,8,9,8,5,3,3,1,0,1,1
S01012878,Occupancy rating -1 or less,15,1,1,0,9,0,6,0,3,3,3,1,2,5,2,0,0,3
S01012879,All households,323,117,64,53,201,27,145,45,71,29,29,20,9,5,4,0,0,1
S01012879,Occupancy rating +2 or more,160,45,28,17,113,20,90,31,42,17,3,1,2,2,1,0,0,1
S01012879,Occupancy rating +1,98,58,30,28,40,7,30,11,13,6,3,3,0,0,0,0,0,0
S01012879,Occupancy rating 0,46,12,5,7,34,0,21,2,13,6,13,7,6,0,0,0,0,0
S01012879,Occupancy rating -1 or less,19,2,1,1,14,0,4,1,3,0,10,9,1,3,3,0,0,0
S01012880,All households,374,103,62,41,260,56,175,59,86,30,29,19,10,11,3,0,1,7
S01012880,Occupancy rating +2 or more,231,46,25,21,180,50,120,45,59,16,10,7,3,5,2,0,0,3
S01012880,Occupancy rating +1,95,45,26,19,47,4,36,11,17,8,7,2,5,3,0,0,1,2
S01012880,Occupancy rating 0,36,10,10,0,25,0,17,3,8,6,8,6,2,1,0,0,0,1
S01012880,Occupancy rating -1 or less,12,2,1,1,8,2,2,0,2,0,4,4,0,2,1,0,0,1
S01012881,All households,406,154,94,60,232,56,144,65,53,26,32,14,18,20,3,1,3,13
S01012881,Occupancy rating +2 or more,234,90,59,31,136,33,96,41,35,20,7,3,4,8,2,0,2,4
S01012881,Occupancy rating +1,107,45,22,23,56,18,29,19,8,2,9,5,4,6,1,1,0,4
S01012881,Occupancy rating 0,50,16,12,4,30,3,14,4,9,1,13,5,8,4,0,0,0,4
S01012881,Occupancy rating -1 or less,15,3,1,2,10,2,5,1,1,3,3,1,2,2,0,0,1,1
S01012882,All households,287,108,32,76,166,23,84,32,31,21,59,44,15,13,6,0,1,6
S01012882,Occupancy rating +2 or more,67,25,7,18,39,11,24,12,7,5,4,3,1,3,1,0,1,1
S01012882,Occupancy rating +1,101,59,12,47,40,6,27,18,2,7,7,4,3,2,1,0,0,1
S01012882,Occupancy rating 0,94,15,8,7,74,6,26,2,18,6,42,34,8,5,2,0,0,3
S01012882,Occupancy rating -1 or less,25,9,5,4,13,0,7,0,4,3,6,3,3,3,2,0,0,1
S01012883,All households,378,221,80,141,151,19,65,25,31,9,67,44,23,6,1,0,1,4
S01012883,Occupancy rating +2 or more,44,16,11,5,27,8,15,8,5,2,4,3,1,1,0,0,0,1
S01012883,Occupancy rating +1,143,109,34,75,33,5,22,15,6,1,6,4,2,1,0,0,0,1
S01012883,Occupancy rating 0,139,74,27,47,63,4,18,2,10,6,41,26,15,2,0,0,1,1
S01012883,Occupancy rating -1 or less,52,22,8,14,28,2,10,0,10,0,16,11,5,2,1,0,0,1
S01012884,All households,285,145,84,61,129,28,77,31,34,12,24,22,2,11,2,0,0,9
S01012884,Occupancy rating +2 or more,69,11,5,6,55,9,45,16,21,8,1,1,0,3,0,0,0,3
S01012884,Occupancy rating +1,59,36,9,27,22,6,11,8,1,2,5,3,2,1,0,0,0,1
S01012884,Occupancy rating 0,91,44,24,20,41,12,16,6,9,1,13,13,0,6,2,0,0,4
S01012884,Occupancy rating -1 or less,66,54,46,8,11,1,5,1,3,1,5,5,0,1,0,0,0,1
S01012885,All households,270,168,48,120,95,9,56,18,24,14,30,16,14,7,1,1,2,3
S01012885,Occupancy rating +2 or more,25,17,6,11,7,1,5,2,3,0,1,0,1,1,0,0,1,0
S01012885,Occupancy rating +1,111,89,26,63,21,5,15,11,1,3,1,1,0,1,0,0,1,0
S01012885,Occupancy rating 0,93,49,13,36,43,2,25,4,11,10,16,8,8,1,0,1,0,0
S01012885,Occupancy rating -1 or less,41,13,3,10,24,1,11,1,9,1,12,7,5,4,1,0,0,3
S01012886,All households,315,70,40,30,237,44,168,55,70,43,25,10,15,8,2,0,0,6
S01012886,Occupancy rating +2 or more,209,51,30,21,155,39,109,49,36,24,7,2,5,3,0,0,0,3
S01012886,Occupancy rating +1,67,16,9,7,49,4,37,5,19,13,8,5,3,2,0,0,0,2
S01012886,Occupancy rating 0,26,2,1,1,23,1,15,1,10,4,7,0,7,1,0,0,0,1
S01012886,Occupancy rating -1 or less,13,1,0,1,10,0,7,0,5,2,3,3,0,2,2,0,0,0
S01012887,All households,352,123,54,69,224,55,145,62,63,20,24,7,17,5,2,0,1,2
S01012887,Occupancy rating +2 or more,200,65,33,32,133,30,92,50,29,13,11,1,10,2,1,0,0,1
S01012887,Occupancy rating +1,105,46,17,29,57,22,28,9,13,6,7,3,4,2,0,0,1,1
S01012887,Occupancy rating 0,41,11,4,7,30,3,22,3,19,0,5,2,3,0,0,0,0,0
S01012887,Occupancy rating -1 or less,6,1,0,1,4,0,3,0,2,1,1,1,0,1,1,0,0,0
S01012888,All households,333,80,49,31,246,49,176,63,75,38,21,15,6,7,3,0,1,3
S01012888,Occupancy rating +2 or more,243,53,35,18,187,43,135,52,58,25,9,6,3,3,1,0,0,2
S01012888,Occupancy rating +1,53,16,9,7,34,2,26,6,11,9,6,5,1,3,1,0,1,1
S01012888,Occupancy rating 0,27,9,4,5,17,1,11,4,3,4,5,3,2,1,1,0,0,0
S01012888,Occupancy rating -1 or less,10,2,1,1,8,3,4,1,3,0,1,1,0,0,0,0,0,0
S01012889,All households,342,68,13,55,262,11,214,82,110,22,37,27,10,12,7,0,0,5
S01012889,Occupancy rating +2 or more,189,30,4,26,156,7,137,60,67,10,12,11,1,3,2,0,0,1
S01012889,Occupancy rating +1,83,25,7,18,55,4,48,20,23,5,3,1,2,3,2,0,0,1
S01012889,Occupancy rating 0,53,12,2,10,39,0,23,2,16,5,16,10,6,2,0,0,0,2
S01012889,Occupancy rating -1 or less,17,1,0,1,12,0,6,0,4,2,6,5,1,4,3,0,0,1
S01012890,All households,300,92,30,62,194,16,105,31,60,14,73,44,29,14,9,0,0,5
S01012890,Occupancy rating +2 or more,45,11,5,6,33,3,25,9,14,2,5,2,3,1,0,0,0,1
S01012890,Occupancy rating +1,136,74,22,52,58,8,38,20,13,5,12,9,3,4,2,0,0,2
S01012890,Occupancy rating 0,89,4,2,2,82,3,31,2,23,6,48,28,20,3,2,0,0,1
S01012890,Occupancy rating -1 or less,30,3,1,2,21,2,11,0,10,1,8,5,3,6,5,0,0,1
S01012891,All households,255,98,42,56,142,20,90,28,37,25,32,20,12,15,3,0,2,10
S01012891,Occupancy rating +2 or more,54,24,12,12,28,6,20,8,6,6,2,1,1,2,0,0,1,1
S01012891,Occupancy rating +1,102,52,19,33,47,13,30,17,8,5,4,2,2,3,1,0,0,2
S01012891,Occupancy rating 0,72,16,10,6,48,0,28,2,15,11,20,13,7,8,1,0,1,6
S01012891,Occupancy rating -1 or less,27,6,1,5,19,1,12,1,8,3,6,4,2,2,1,0,0,1
S01012892,All households,566,247,95,152,291,32,138,64,36,38,121,82,39,28,11,0,1,16
S01012892,Occupancy rating +2 or more,120,69,31,38,51,13,33,24,5,4,5,4,1,0,0,0,0,0
S01012892,Occupancy rating +1,186,80,32,48,102,13,59,35,11,13,30,16,14,4,0,0,0,4
S01012892,Occupancy rating 0,167,64,25,39,90,3,32,3,11,18,55,39,16,13,6,0,1,6
S01012892,Occupancy rating -1 or less,93,34,7,27,48,3,14,2,9,3,31,23,8,11,5,0,0,6
S01012893,All households,369,143,60,83,210,26,92,40,31,21,92,61,31,16,8,0,0,8
S01012893,Occupancy rating +2 or more,66,30,16,14,34,14,17,14,3,0,3,2,1,2,1,0,0,1
S01012893,Occupancy rating +1,145,79,31,48,63,10,36,23,6,7,17,6,11,3,0,0,0,3
S01012893,Occupancy rating 0,105,20,7,13,80,2,28,3,14,11,50,37,13,5,2,0,0,3
S01012893,Occupancy rating -1 or less,53,14,6,8,33,0,11,0,8,3,22,16,6,6,5,0,0,1
S01012894,All households,311,71,31,40,219,11,167,53,94,20,41,33,8,21,8,0,1,12
S01012894,Occupancy rating +2 or more,164,28,10,18,127,9,114,41,62,11,4,3,1,9,5,0,0,4
S01012894,Occupancy rating +1,67,17,3,14,43,0,31,9,14,8,12,9,3,7,2,0,0,5
S01012894,Occupancy rating 0,68,24,17,7,40,1,18,3,14,1,21,17,4,4,0,0,1,3
S01012894,Occupancy rating -1 or less,12,2,1,1,9,1,4,0,4,0,4,4,0,1,1,0,0,0
S01012895,All households,197,45,13,32,143,13,118,40,59,19,12,9,3,9,7,0,0,2
S01012895,Occupancy rating +2 or more,130,23,11,12,101,12,83,37,33,13,6,6,0,6,5,0,0,1
S01012895,Occupancy rating +1,39,14,1,13,25,1,22,2,15,5,2,2,0,0,0,0,0,0
S01012895,Occupancy rating 0,22,8,1,7,14,0,10,1,9,0,4,1,3,0,0,0,0,0
S01012895,Occupancy rating -1 or less,6,0,0,0,3,0,3,0,2,1,0,0,0,3,2,0,0,1
S01012896,All households,482,252,96,156,225,45,129,69,35,25,51,23,28,5,1,0,0,4
S01012896,Occupancy rating +2 or more,121,56,32,24,65,17,45,35,8,2,3,1,2,0,0,0,0,0
S01012896,Occupancy rating +1,185,94,33,61,89,24,52,28,12,12,13,5,8,2,0,0,0,2
S01012896,Occupancy rating 0,143,89,28,61,53,3,27,6,12,9,23,10,13,1,0,0,0,1
S01012896,Occupancy rating -1 or less,33,13,3,10,18,1,5,0,3,2,12,7,5,2,1,0,0,1
S01012897,All households,248,61,18,43,178,17,139,54,70,15,22,16,6,9,5,0,0,4
S01012897,Occupancy rating +2 or more,121,24,7,17,94,10,79,39,33,7,5,4,1,3,1,0,0,2
S01012897,Occupancy rating +1,79,32,11,21,47,7,36,13,20,3,4,2,2,0,0,0,0,0
S01012897,Occupancy rating 0,41,5,0,5,32,0,23,2,16,5,9,6,3,4,2,0,0,2
S01012897,Occupancy rating -1 or less,7,0,0,0,5,0,1,0,1,0,4,4,0,2,2,0,0,0
S01012898,All households,177,15,1,14,152,1,136,28,87,21,15,11,4,10,9,0,0,1
S01012898,Occupancy rating +2 or more,148,12,0,12,130,0,117,27,75,15,13,10,3,6,5,0,0,1
S01012898,Occupancy rating +1,19,2,1,1,15,1,12,1,8,3,2,1,1,2,2,0,0,0
S01012898,Occupancy rating 0,7,1,0,1,5,0,5,0,3,2,0,0,0,1,1,0,0,0
S01012898,Occupancy rating -1 or less,3,0,0,0,2,0,2,0,1,1,0,0,0,1,1,0,0,0
S01012899,All households,317,184,58,126,124,19,69,32,23,14,36,12,24,9,4,0,0,5
S01012899,Occupancy rating +2 or more,29,10,4,6,18,5,10,8,1,1,3,1,2,1,0,0,0,1
S01012899,Occupancy rating +1,146,87,32,55,59,14,37,21,9,7,8,2,6,0,0,0,0,0
S01012899,Occupancy rating 0,121,77,21,56,42,0,20,2,12,6,22,8,14,2,1,0,0,1
S01012899,Occupancy rating -1 or less,21,10,1,9,5,0,2,1,1,0,3,1,2,6,3,0,0,3
S01012900,All households,226,47,17,30,171,26,122,53,47,22,23,14,9,8,7,0,0,1
S01012900,Occupancy rating +2 or more,153,37,13,24,112,23,83,42,29,12,6,3,3,4,4,0,0,0
S01012900,Occupancy rating +1,35,6,2,4,29,2,20,6,7,7,7,4,3,0,0,0,0,0
S01012900,Occupancy rating 0,30,4,2,2,23,1,16,4,9,3,6,4,2,3,2,0,0,1
S01012900,Occupancy rating -1 or less,8,0,0,0,7,0,3,1,2,0,4,3,1,1,1,0,0,0
S01012901,All households,336,144,40,104,178,25,120,44,56,20,33,20,13,14,4,0,0,10
S01012901,Occupancy rating +2 or more,89,30,13,17,58,17,34,18,9,7,7,3,4,1,1,0,0,0
S01012901,Occupancy rating +1,104,43,16,27,59,8,39,14,19,6,12,7,5,2,0,0,0,2
S01012901,Occupancy rating 0,119,64,10,54,53,0,42,10,25,7,11,7,4,2,1,0,0,1
S01012901,Occupancy rating -1 or less,24,7,1,6,8,0,5,2,3,0,3,3,0,9,2,0,0,7
S01012902,All households,359,133,33,100,217,36,147,66,63,18,34,19,15,9,2,0,1,6
S01012902,Occupancy rating +2 or more,120,43,21,22,76,30,44,34,3,7,2,1,1,1,0,0,1,0
S01012902,Occupancy rating +1,91,26,3,23,62,4,49,17,25,7,9,3,6,3,1,0,0,2
S01012902,Occupancy rating 0,123,59,9,50,61,2,39,14,22,3,20,14,6,3,0,0,0,3
S01012902,Occupancy rating -1 or less,25,5,0,5,18,0,15,1,13,1,3,1,2,2,1,0,0,1
S01012903,All households,400,170,48,122,214,34,135,54,60,21,45,34,11,16,3,0,0,13
S01012903,Occupancy rating +2 or more,118,52,29,23,66,26,38,24,6,8,2,1,1,0,0,0,0,0
S01012903,Occupancy rating +1,107,40,11,29,66,5,47,18,19,10,14,10,4,1,0,0,0,1
S01012903,Occupancy rating 0,137,67,7,60,63,1,40,12,27,1,22,18,4,7,0,0,0,7
S01012903,Occupancy rating -1 or less,38,11,1,10,19,2,10,0,8,2,7,5,2,8,3,0,0,5
S01012904,All households,371,117,41,76,240,20,139,51,67,21,81,58,23,14,6,0,1,7
S01012904,Occupancy rating +2 or more,92,39,24,15,52,13,36,27,7,2,3,3,0,1,0,0,0,1
S01012904,Occupancy rating +1,130,47,12,35,80,4,54,18,21,15,22,14,8,3,1,0,1,1
S01012904,Occupancy rating 0,127,29,4,25,92,2,42,6,32,4,48,33,15,6,2,0,0,4
S01012904,Occupancy rating -1 or less,22,2,1,1,16,1,7,0,7,0,8,8,0,4,3,0,0,1
S01012905,All households,272,103,24,79,162,15,87,24,43,20,60,47,13,7,4,0,0,3
S01012905,Occupancy rating +2 or more,75,38,15,23,37,10,20,15,3,2,7,4,3,0,0,0,0,0
S01012905,Occupancy rating +1,60,17,4,13,43,4,25,6,11,8,14,11,3,0,0,0,0,0
S01012905,Occupancy rating 0,107,46,5,41,56,0,33,3,21,9,23,17,6,5,3,0,0,2
S01012905,Occupancy rating -1 or less,30,2,0,2,26,1,9,0,8,1,16,15,1,2,1,0,0,1
S01012906,All households,482,225,83,142,245,30,162,69,68,25,53,28,25,12,2,0,3,7
S01012906,Occupancy rating +2 or more,72,24,15,9,47,9,36,20,7,9,2,1,1,1,0,0,0,1
S01012906,Occupancy rating +1,175,102,30,72,72,15,54,36,14,4,3,1,2,1,0,0,1,0
S01012906,Occupancy rating 0,174,72,25,47,98,5,56,11,37,8,37,20,17,4,0,0,1,3
S01012906,Occupancy rating -1 or less,61,27,13,14,28,1,16,2,10,4,11,6,5,6,2,0,1,3
S01012907,All households,449,199,89,110,242,54,135,53,57,25,53,31,22,8,3,0,1,4
S01012907,Occupancy rating +2 or more,101,40,26,14,61,20,36,24,9,3,5,4,1,0,0,0,0,0
S01012907,Occupancy rating +1,166,69,36,33,95,21,57,25,24,8,17,9,8,2,1,0,0,1
S01012907,Occupancy rating 0,152,79,22,57,68,11,29,3,16,10,28,15,13,5,1,0,1,3
S01012907,Occupancy rating -1 or less,30,11,5,6,18,2,13,1,8,4,3,3,0,1,1,0,0,0
S01012908,All households,355,154,60,94,195,41,113,42,51,20,41,21,20,6,1,0,1,4
S01012908,Occupancy rating +2 or more,94,32,21,11,61,22,36,24,8,4,3,1,2,1,0,0,0,1
S01012908,Occupancy rating +1,136,75,26,49,60,13,31,12,14,5,16,8,8,1,0,0,0,1
S01012908,Occupancy rating 0,96,40,10,30,53,4,35,6,20,9,14,7,7,3,0,0,1,2
S01012908,Occupancy rating -1 or less,29,7,3,4,21,2,11,0,9,2,8,5,3,1,1,0,0,0
S01012909,All households,331,173,87,86,150,30,93,37,42,14,27,17,10,8,3,0,0,5
S01012909,Occupancy rating +2 or more,53,23,15,8,30,7,21,10,9,2,2,1,1,0,0,0,0,0
S01012909,Occupancy rating +1,123,63,24,39,57,12,39,20,13,6,6,3,3,3,0,0,0,3
S01012909,Occupancy rating 0,136,78,44,34,56,10,31,7,18,6,15,10,5,2,1,0,0,1
S01012909,Occupancy rating -1 or less,19,9,4,5,7,1,2,0,2,0,4,3,1,3,2,0,0,1
S01012910,All households,485,265,83,182,200,26,113,53,40,20,61,30,31,20,9,0,2,9
S01012910,Occupancy rating +2 or more,98,46,25,21,48,17,30,21,7,2,1,1,0,4,0,0,1,3
S01012910,Occupancy rating +1,151,77,27,50,69,7,50,22,18,10,12,7,5,5,2,0,1,2
S01012910,Occupancy rating 0,190,118,23,95,68,2,27,9,13,5,39,19,20,4,2,0,0,2
S01012910,Occupancy rating -1 or less,46,24,8,16,15,0,6,1,2,3,9,3,6,7,5,0,0,2
S01012911,All households,340,119,60,59,210,49,131,53,48,30,30,18,12,11,3,0,2,6
S01012911,Occupancy rating +2 or more,132,36,21,15,94,29,60,35,13,12,5,1,4,2,1,0,0,1
S01012911,Occupancy rating +1,108,46,27,19,61,15,42,17,15,10,4,3,1,1,0,0,0,1
S01012911,Occupancy rating 0,77,32,9,23,41,5,22,1,16,5,14,9,5,4,1,0,1,2
S01012911,Occupancy rating -1 or less,23,5,3,2,14,0,7,0,4,3,7,5,2,4,1,0,1,2
S01012912,All households,339,144,64,80,180,42,97,36,36,25,41,24,17,15,5,0,7,3
S01012912,Occupancy rating +2 or more,84,34,16,18,49,23,24,13,4,7,2,1,1,1,0,0,1,0
S01012912,Occupancy rating +1,134,75,33,42,57,14,35,16,11,8,8,5,3,2,0,0,2,0
S01012912,Occupancy rating 0,94,29,13,16,57,4,31,6,17,8,22,12,10,8,2,0,3,3
S01012912,Occupancy rating -1 or less,27,6,2,4,17,1,7,1,4,2,9,6,3,4,3,0,1,0
S01012913,All households,417,165,91,74,237,43,139,51,62,26,55,34,21,15,4,0,1,10
S01012913,Occupancy rating +2 or more,100,36,23,13,63,17,42,24,14,4,4,2,2,1,1,0,0,0
S01012913,Occupancy rating +1,158,84,44,40,70,20,32,18,7,7,18,10,8,4,0,0,1,3
S01012913,Occupancy rating 0,131,39,19,20,85,6,51,7,32,12,28,18,10,7,3,0,0,4
S01012913,Occupancy rating -1 or less,28,6,5,1,19,0,14,2,9,3,5,4,1,3,0,0,0,3
S01012914,All households,410,150,42,108,244,32,152,71,60,21,60,34,26,16,3,0,0,13
S01012914,Occupancy rating +2 or more,135,46,16,30,87,18,60,35,15,10,9,1,8,2,0,0,0,2
S01012914,Occupancy rating +1,133,55,14,41,75,9,50,20,22,8,16,6,10,3,0,0,0,3
S01012914,Occupancy rating 0,115,42,7,35,66,5,37,16,19,2,24,19,5,7,3,0,0,4
S01012914,Occupancy rating -1 or less,27,7,5,2,16,0,5,0,4,1,11,8,3,4,0,0,0,4
S01012915,All households,447,150,56,94,284,21,213,70,120,23,50,29,21,13,3,0,0,10
S01012915,Occupancy rating +2 or more,194,34,13,21,157,12,135,42,85,8,10,3,7,3,0,0,0,3
S01012915,Occupancy rating +1,126,61,13,48,62,5,49,24,16,9,8,4,4,3,1,0,0,2
S01012915,Occupancy rating 0,107,46,24,22,56,2,26,4,17,5,28,19,9,5,1,0,0,4
S01012915,Occupancy rating -1 or less,20,9,6,3,9,2,3,0,2,1,4,3,1,2,1,0,0,1
S01012916,All households,331,142,52,90,178,48,103,40,42,21,27,20,7,11,4,0,1,6
S01012916,Occupancy rating +2 or more,104,29,14,15,73,28,43,27,11,5,2,1,1,2,1,0,0,1
S01012916,Occupancy rating +1,81,33,8,25,44,8,31,10,11,10,5,4,1,4,2,0,1,1
S01012916,Occupancy rating 0,120,68,26,42,48,9,23,2,16,5,16,12,4,4,1,0,0,3
S01012916,Occupancy rating -1 or less,26,12,4,8,13,3,6,1,4,1,4,3,1,1,0,0,0,1
S01012917,All households,270,48,34,14,217,31,154,39,76,39,32,18,14,5,1,0,0,4
S01012917,Occupancy rating +2 or more,159,43,29,14,115,29,76,31,26,19,10,7,3,1,0,0,0,1
S01012917,Occupancy rating +1,78,4,4,0,71,2,54,5,35,14,15,7,8,3,0,0,0,3
S01012917,Occupancy rating 0,29,1,1,0,27,0,21,3,14,4,6,4,2,1,1,0,0,0
S01012917,Occupancy rating -1 or less,4,0,0,0,4,0,3,0,1,2,1,0,1,0,0,0,0,0
S01012918,All households,255,124,46,78,123,19,80,30,38,12,24,11,13,8,4,0,0,4
S01012918,Occupancy rating +2 or more,56,28,20,8,28,12,15,11,1,3,1,0,1,0,0,0,0,0
S01012918,Occupancy rating +1,77,36,13,23,38,6,27,8,12,7,5,2,3,3,1,0,0,2
S01012918,Occupancy rating 0,101,55,12,43,44,1,28,10,16,2,15,7,8,2,1,0,0,1
S01012918,Occupancy rating -1 or less,21,5,1,4,13,0,10,1,9,0,3,2,1,3,2,0,0,1
S01012919,All households,229,91,58,33,129,35,67,29,29,9,27,11,16,9,4,0,0,5
S01012919,Occupancy rating +2 or more,90,39,29,10,50,23,23,14,4,5,4,0,4,1,0,0,0,1
S01012919,Occupancy rating +1,69,26,19,7,42,11,23,12,8,3,8,5,3,1,0,0,0,1
S01012919,Occupancy rating 0,53,21,7,14,29,1,17,2,15,0,11,4,7,3,2,0,0,1
S01012919,Occupancy rating -1 or less,17,5,3,2,8,0,4,1,2,1,4,2,2,4,2,0,0,2
S01012920,All households,258,72,38,34,182,48,118,51,33,34,16,7,9,4,2,0,0,2
S01012920,Occupancy rating +2 or more,148,25,15,10,122,37,78,38,22,18,7,2,5,1,1,0,0,0
S01012920,Occupancy rating +1,73,33,13,20,38,8,26,10,7,9,4,3,1,2,0,0,0,2
S01012920,Occupancy rating 0,30,12,9,3,17,2,10,3,3,4,5,2,3,1,1,0,0,0
S01012920,Occupancy rating -1 or less,7,2,1,1,5,1,4,0,1,3,0,0,0,0,0,0,0,0
S01012921,All households,338,128,52,76,199,40,111,39,50,22,48,32,16,11,4,0,1,6
S01012921,Occupancy rating +2 or more,97,41,29,12,53,24,23,17,4,2,6,1,5,3,1,0,1,1
S01012921,Occupancy rating +1,102,41,17,24,61,11,38,10,17,11,12,8,4,0,0,0,0,0
S01012921,Occupancy rating 0,110,37,4,33,69,5,41,11,22,8,23,19,4,4,1,0,0,3
S01012921,Occupancy rating -1 or less,29,9,2,7,16,0,9,1,7,1,7,4,3,4,2,0,0,2
S01012922,All households,437,142,52,90,280,42,177,51,103,23,61,49,12,15,9,0,0,6
S01012922,Occupancy rating +2 or more,145,50,28,22,93,23,60,22,31,7,10,9,1,2,1,0,0,1
S01012922,Occupancy rating +1,129,35,12,23,92,14,61,16,38,7,17,13,4,2,1,0,0,1
S01012922,Occupancy rating 0,137,52,8,44,78,4,47,12,28,7,27,22,5,7,6,0,0,1
S01012922,Occupancy rating -1 or less,26,5,4,1,17,1,9,1,6,2,7,5,2,4,1,0,0,3
S01012923,All households,306,98,38,60,197,24,130,38,59,33,43,31,12,11,1,0,0,10
S01012923,Occupancy rating +2 or more,120,38,24,14,80,22,55,27,14,14,3,1,2,2,1,0,0,1
S01012923,Occupancy rating +1,77,15,4,11,60,0,44,5,26,13,16,8,8,2,0,0,0,2
S01012923,Occupancy rating 0,83,44,9,35,34,2,23,6,12,5,9,8,1,5,0,0,0,5
S01012923,Occupancy rating -1 or less,26,1,1,0,23,0,8,0,7,1,15,14,1,2,0,0,0,2
S01012924,All households,243,99,24,75,142,21,94,33,42,19,27,17,10,2,0,0,0,2
S01012924,Occupancy rating +2 or more,73,25,18,7,47,14,31,24,7,0,2,2,0,1,0,0,0,1
S01012924,Occupancy rating +1,63,14,1,13,49,5,33,1,21,11,11,4,7,0,0,0,0,0
S01012924,Occupancy rating 0,98,57,5,52,40,2,27,8,12,7,11,8,3,1,0,0,0,1
S01012924,Occupancy rating -1 or less,9,3,0,3,6,0,3,0,2,1,3,3,0,0,0,0,0,0
S01012925,All households,194,37,14,23,151,30,104,37,48,19,17,12,5,6,3,0,0,3
S01012925,Occupancy rating +2 or more,123,25,11,14,96,25,68,30,25,13,3,0,3,2,1,0,0,1
S01012925,Occupancy rating +1,47,9,2,7,35,4,25,7,15,3,6,4,2,3,1,0,0,2
S01012925,Occupancy rating 0,18,3,1,2,15,1,8,0,5,3,6,6,0,0,0,0,0,0
S01012925,Occupancy rating -1 or less,6,0,0,0,5,0,3,0,3,0,2,2,0,1,1,0,0,0
S01012926,All households,333,128,36,92,197,31,127,52,52,23,39,23,16,8,1,0,0,7
S01012926,Occupancy rating +2 or more,113,34,16,18,78,29,44,32,8,4,5,0,5,1,1,0,0,0
S01012926,Occupancy rating +1,87,40,13,27,46,1,38,10,18,10,7,5,2,1,0,0,0,1
S01012926,Occupancy rating 0,108,45,4,41,59,1,39,9,21,9,19,11,8,4,0,0,0,4
S01012926,Occupancy rating -1 or less,25,9,3,6,14,0,6,1,5,0,8,7,1,2,0,0,0,2
S01012927,All households,339,108,32,76,222,33,143,51,70,22,46,31,15,9,3,0,0,6
S01012927,Occupancy rating +2 or more,118,42,23,19,76,29,44,28,12,4,3,2,1,0,0,0,0,0
S01012927,Occupancy rating +1,84,18,5,13,65,3,50,11,25,14,12,5,7,1,0,0,0,1
S01012927,Occupancy rating 0,107,38,4,34,63,1,42,12,27,3,20,14,6,6,2,0,0,4
S01012927,Occupancy rating -1 or less,30,10,0,10,18,0,7,0,6,1,11,10,1,2,1,0,0,1
S01012928,All households,353,121,74,47,214,29,156,53,72,31,29,18,11,18,6,0,4,8
S01012928,Occupancy rating +2 or more,150,48,31,17,100,17,77,42,23,12,6,2,4,2,2,0,0,0
S01012928,Occupancy rating +1,109,37,23,14,66,7,51,7,32,12,8,3,5,6,1,0,3,2
S01012928,Occupancy rating 0,80,35,19,16,38,2,22,2,14,6,14,12,2,7,1,0,1,5
S01012928,Occupancy rating -1 or less,14,1,1,0,10,3,6,2,3,1,1,1,0,3,2,0,0,1
S01012929,All households,340,112,57,55,223,61,132,40,62,30,30,21,9,5,2,0,1,2
S01012929,Occupancy rating +2 or more,149,49,33,16,100,45,50,23,16,11,5,2,3,0,0,0,0,0
S01012929,Occupancy rating +1,97,25,17,8,71,12,47,9,24,14,12,8,4,1,0,0,0,1
S01012929,Occupancy rating 0,75,30,6,24,42,3,30,8,18,4,9,7,2,3,1,0,1,1
S01012929,Occupancy rating -1 or less,19,8,1,7,10,1,5,0,4,1,4,4,0,1,1,0,0,0
S01012930,All households,512,302,135,167,200,46,115,63,39,13,39,22,17,10,2,0,1,7
S01012930,Occupancy rating +2 or more,104,47,25,22,57,15,40,18,17,5,2,1,1,0,0,0,0,0
S01012930,Occupancy rating +1,159,92,34,58,66,18,44,30,11,3,4,2,2,1,0,0,0,1
S01012930,Occupancy rating 0,218,147,69,78,66,12,26,14,9,3,28,17,11,5,1,0,1,3
S01012930,Occupancy rating -1 or less,31,16,7,9,11,1,5,1,2,2,5,2,3,4,1,0,0,3
S01012931,All households,435,176,75,101,247,34,155,70,64,21,58,34,24,12,5,0,1,6
S01012931,Occupancy rating +2 or more,122,40,20,20,78,12,63,33,23,7,3,0,3,4,1,0,0,3
S01012931,Occupancy rating +1,179,91,44,47,88,21,53,35,11,7,14,7,7,0,0,0,0,0
S01012931,Occupancy rating 0,111,39,10,29,64,0,34,2,26,6,30,18,12,8,4,0,1,3
S01012931,Occupancy rating -1 or less,23,6,1,5,17,1,5,0,4,1,11,9,2,0,0,0,0,0
S01012932,All households,211,56,29,27,146,19,105,38,44,23,22,13,9,9,3,0,2,4
S01012932,Occupancy rating +2 or more,120,20,12,8,96,15,76,34,26,16,5,4,1,4,1,0,2,1
S01012932,Occupancy rating +1,46,24,9,15,19,3,11,2,6,3,5,3,2,3,1,0,0,2
S01012932,Occupancy rating 0,37,10,6,4,25,1,15,2,10,3,9,4,5,2,1,0,0,1
S01012932,Occupancy rating -1 or less,8,2,2,0,6,0,3,0,2,1,3,2,1,0,0,0,0,0
S01012933,All households,352,123,57,66,214,28,144,49,60,35,42,25,17,15,6,0,2,7
S01012933,Occupancy rating +2 or more,147,54,32,22,89,21,63,36,20,7,5,3,2,4,1,0,1,2
S01012933,Occupancy rating +1,105,45,16,29,57,7,37,11,16,10,13,5,8,3,1,0,0,2
S01012933,Occupancy rating 0,74,22,7,15,47,0,30,1,17,12,17,14,3,5,3,0,1,1
S01012933,Occupancy rating -1 or less,26,2,2,0,21,0,14,1,7,6,7,3,4,3,1,0,0,2
S01012934,All households,360,143,61,82,206,39,114,51,34,29,53,33,20,11,2,0,0,9
S01012934,Occupancy rating +2 or more,116,34,18,16,82,21,54,34,10,10,7,3,4,0,0,0,0,0
S01012934,Occupancy rating +1,128,80,32,48,47,13,27,14,7,6,7,3,4,1,0,0,0,1
S01012934,Occupancy rating 0,89,22,8,14,59,5,25,2,12,11,29,19,10,8,1,0,0,7
S01012934,Occupancy rating -1 or less,27,7,3,4,18,0,8,1,5,2,10,8,2,2,1,0,0,1
S01012935,All households,363,108,67,41,245,36,169,49,88,32,40,24,16,10,5,0,0,5
S01012935,Occupancy rating +2 or more,121,44,35,9,72,23,47,26,15,6,2,0,2,5,3,0,0,2
S01012935,Occupancy rating +1,129,59,31,28,70,7,53,19,25,9,10,5,5,0,0,0,0,0
S01012935,Occupancy rating 0,88,5,1,4,79,4,53,3,37,13,22,13,9,4,1,0,0,3
S01012935,Occupancy rating -1 or less,25,0,0,0,24,2,16,1,11,4,6,6,0,1,1,0,0,0
S01012936,All households,351,138,59,79,198,40,116,55,43,18,42,27,15,15,6,0,3,6
S01012936,Occupancy rating +2 or more,79,23,13,10,53,18,31,15,10,6,4,2,2,3,1,0,2,0
S01012936,Occupancy rating +1,151,82,31,51,66,18,43,30,11,2,5,3,2,3,2,0,0,1
S01012936,Occupancy rating 0,91,25,12,13,60,3,30,8,16,6,27,18,9,6,2,0,1,3
S01012936,Occupancy rating -1 or less,30,8,3,5,19,1,12,2,6,4,6,4,2,3,1,0,0,2
S01012937,All households,314,115,40,75,189,22,131,47,63,21,36,20,16,10,3,0,1,6
S01012937,Occupancy rating +2 or more,113,33,14,19,79,8,66,30,30,6,5,1,4,1,1,0,0,0
S01012937,Occupancy rating +1,112,47,20,27,61,12,39,13,15,11,10,5,5,4,0,0,0,4
S01012937,Occupancy rating 0,75,34,6,28,37,1,22,4,14,4,14,8,6,4,1,0,1,2
S01012937,Occupancy rating -1 or less,14,1,0,1,12,1,4,0,4,0,7,6,1,1,1,0,0,0
S01012938,All households,307,100,69,31,195,33,146,70,52,24,16,10,6,12,4,0,0,8
S01012938,Occupancy rating +2 or more,197,36,18,18,152,21,122,62,42,18,9,4,5,9,3,0,0,6
S01012938,Occupancy rating +1,44,20,15,5,22,5,14,6,4,4,3,2,1,2,0,0,0,2
S01012938,Occupancy rating 0,58,40,33,7,17,6,8,1,5,2,3,3,0,1,1,0,0,0
S01012938,Occupancy rating -1 or less,8,4,3,1,4,1,2,1,1,0,1,1,0,0,0,0,0,0
S01012939,All households,216,30,13,17,180,24,143,27,85,31,13,6,7,6,4,1,0,1
S01012939,Occupancy rating +2 or more,156,23,9,14,129,17,105,24,59,22,7,3,4,4,3,0,0,1
S01012939,Occupancy rating +1,31,3,3,0,27,5,20,3,11,6,2,0,2,1,1,0,0,0
S01012939,Occupancy rating 0,27,4,1,3,22,2,17,0,14,3,3,2,1,1,0,1,0,0
S01012939,Occupancy rating -1 or less,2,0,0,0,2,0,1,0,1,0,1,1,0,0,0,0,0,0
S01012940,All households,268,47,18,29,219,20,179,73,72,34,20,12,8,2,0,0,0,2
S01012940,Occupancy rating +2 or more,174,26,9,17,148,13,127,59,44,24,8,6,2,0,0,0,0,0
S01012940,Occupancy rating +1,71,19,9,10,50,7,37,11,19,7,6,3,3,2,0,0,0,2
S01012940,Occupancy rating 0,20,2,0,2,18,0,12,3,6,3,6,3,3,0,0,0,0,0
S01012940,Occupancy rating -1 or less,3,0,0,0,3,0,3,0,3,0,0,0,0,0,0,0,0,0
S01012941,All households,257,29,6,23,223,11,200,58,111,31,12,9,3,5,2,0,0,3
S01012941,Occupancy rating +2 or more,221,28,6,22,188,11,169,55,88,26,8,5,3,5,2,0,0,3
S01012941,Occupancy rating +1,23,0,0,0,23,0,22,3,16,3,1,1,0,0,0,0,0,0
S01012941,Occupancy rating 0,11,1,0,1,10,0,8,0,6,2,2,2,0,0,0,0,0,0
S01012941,Occupancy rating -1 or less,2,0,0,0,2,0,1,0,1,0,1,1,0,0,0,0,0,0
S01012942,All households,364,127,57,70,223,16,127,49,63,15,80,52,28,14,5,0,0,9
S01012942,Occupancy rating +2 or more,73,21,13,8,52,8,36,28,8,0,8,3,5,0,0,0,0,0
S01012942,Occupancy rating +1,120,54,21,33,64,7,44,17,19,8,13,8,5,2,1,0,0,1
S01012942,Occupancy rating 0,126,44,19,25,77,0,39,3,31,5,38,27,11,5,0,0,0,5
S01012942,Occupancy rating -1 or less,45,8,4,4,30,1,8,1,5,2,21,14,7,7,4,0,0,3
S01012943,All households,291,64,27,37,224,25,167,52,96,19,32,25,7,3,1,0,0,2
S01012943,Occupancy rating +2 or more,155,27,12,15,126,14,100,34,56,10,12,7,5,2,0,0,0,2
S01012943,Occupancy rating +1,86,27,12,15,58,10,42,15,21,6,6,6,0,1,1,0,0,0
S01012943,Occupancy rating 0,44,8,1,7,36,1,22,3,17,2,13,11,2,0,0,0,0,0
S01012943,Occupancy rating -1 or less,6,2,2,0,4,0,3,0,2,1,1,1,0,0,0,0,0,0
S01012944,All households,207,43,17,26,158,34,107,35,54,18,17,12,5,6,5,0,0,1
S01012944,Occupancy rating +2 or more,163,39,15,24,121,31,80,33,37,10,10,6,4,3,2,0,0,1
S01012944,Occupancy rating +1,30,4,2,2,26,2,21,2,14,5,3,3,0,0,0,0,0,0
S01012944,Occupancy rating 0,11,0,0,0,10,1,6,0,3,3,3,2,1,1,1,0,0,0
S01012944,Occupancy rating -1 or less,3,0,0,0,1,0,0,0,0,0,1,1,0,2,2,0,0,0
S01012945,All households,241,27,3,24,206,13,179,54,106,19,14,8,6,8,7,0,0,1
S01012945,Occupancy rating +2 or more,196,22,1,21,169,9,150,53,80,17,10,7,3,5,4,0,0,1
S01012945,Occupancy rating +1,26,3,1,2,22,4,18,1,15,2,0,0,0,1,1,0,0,0
S01012945,Occupancy rating 0,15,1,0,1,14,0,10,0,10,0,4,1,3,0,0,0,0,0
S01012945,Occupancy rating -1 or less,4,1,1,0,1,0,1,0,1,0,0,0,0,2,2,0,0,0
S01012946,All households,338,69,14,55,258,25,203,78,97,28,30,20,10,11,4,0,1,6
S01012946,Occupancy rating +2 or more,187,19,8,11,164,11,141,60,63,18,12,7,5,4,1,0,0,3
S01012946,Occupancy rating +1,95,37,6,31,58,14,40,16,20,4,4,2,2,0,0,0,0,0
S01012946,Occupancy rating 0,47,13,0,13,27,0,16,2,8,6,11,9,2,7,3,0,1,3
S01012946,Occupancy rating -1 or less,9,0,0,0,9,0,6,0,6,0,3,2,1,0,0,0,0,0
S01012947,All households,151,12,4,8,135,10,117,45,49,23,8,7,1,4,4,0,0,0
S01012947,Occupancy rating +2 or more,139,12,4,8,124,10,108,42,46,20,6,5,1,3,3,0,0,0
S01012947,Occupancy rating +1,7,0,0,0,7,0,7,3,2,2,0,0,0,0,0,0,0,0
S01012947,Occupancy rating 0,3,0,0,0,3,0,2,0,1,1,1,1,0,0,0,0,0,0
S01012947,Occupancy rating -1 or less,2,0,0,0,1,0,0,0,0,0,1,1,0,1,1,0,0,0
S01012948,All households,249,24,4,20,218,27,162,58,68,36,29,15,14,7,6,0,0,1
S01012948,Occupancy rating +2 or more,136,14,3,11,118,20,93,48,27,18,5,3,2,4,3,0,0,1
S01012948,Occupancy rating +1,75,9,1,8,64,7,45,9,24,12,12,6,6,2,2,0,0,0
S01012948,Occupancy rating 0,29,1,0,1,27,0,17,0,14,3,10,4,6,1,1,0,0,0
S01012948,Occupancy rating -1 or less,9,0,0,0,9,0,7,1,3,3,2,2,0,0,0,0,0,0
S01012949,All households,282,68,21,47,208,24,168,83,45,40,16,11,5,6,3,0,0,3
S01012949,Occupancy rating +2 or more,153,22,7,15,128,15,107,70,16,21,6,6,0,3,2,0,0,1
S01012949,Occupancy rating +1,52,20,8,12,31,6,22,3,12,7,3,1,2,1,0,0,0,1
S01012949,Occupancy rating 0,63,26,6,20,36,3,26,9,10,7,7,4,3,1,0,0,0,1
S01012949,Occupancy rating -1 or less,14,0,0,0,13,0,13,1,7,5,0,0,0,1,1,0,0,0
S01012950,All households,273,16,1,15,245,9,220,59,127,34,16,13,3,12,8,0,1,3
S01012950,Occupancy rating +2 or more,225,12,0,12,205,9,186,58,96,32,10,9,1,8,6,0,0,2
S01012950,Occupancy rating +1,28,3,1,2,23,0,21,1,18,2,2,2,0,2,1,0,1,0
S01012950,Occupancy rating 0,13,1,0,1,11,0,8,0,8,0,3,1,2,1,1,0,0,0
S01012950,Occupancy rating -1 or less,7,0,0,0,6,0,5,0,5,0,1,1,0,1,0,0,0,1
S01012951,All households,294,21,3,18,263,3,249,67,159,23,11,9,2,10,6,0,0,4
S01012951,Occupancy rating +2 or more,263,20,3,17,238,3,228,61,147,20,7,7,0,5,1,0,0,4
S01012951,Occupancy rating +1,17,1,0,1,13,0,12,5,4,3,1,0,1,3,3,0,0,0
S01012951,Occupancy rating 0,8,0,0,0,7,0,5,0,5,0,2,2,0,1,1,0,0,0
S01012951,Occupancy rating -1 or less,6,0,0,0,5,0,4,1,3,0,1,0,1,1,1,0,0,0
S01012952,All households,247,52,25,27,188,46,134,46,65,23,8,3,5,7,6,0,0,1
S01012952,Occupancy rating +2 or more,214,41,22,19,167,42,120,43,58,19,5,2,3,6,5,0,0,1
S01012952,Occupancy rating +1,19,8,3,5,11,4,7,3,2,2,0,0,0,0,0,0,0,0
S01012952,Occupancy rating 0,10,3,0,3,7,0,4,0,2,2,3,1,2,0,0,0,0,0
S01012952,Occupancy rating -1 or less,4,0,0,0,3,0,3,0,3,0,0,0,0,1,1,0,0,0
S01012953,All households,292,72,15,57,212,23,160,64,62,34,29,22,7,8,3,0,0,5
S01012953,Occupancy rating +2 or more,131,21,6,15,109,15,85,51,20,14,9,5,4,1,0,0,0,1
S01012953,Occupancy rating +1,72,16,3,13,55,4,44,10,21,13,7,6,1,1,1,0,0,0
S01012953,Occupancy rating 0,67,21,6,15,42,3,28,2,20,6,11,9,2,4,1,0,0,3
S01012953,Occupancy rating -1 or less,22,14,0,14,6,1,3,1,1,1,2,2,0,2,1,0,0,1
S01012954,All households,173,22,9,13,150,12,122,38,64,20,16,10,6,1,1,0,0,0
S01012954,Occupancy rating +2 or more,85,12,7,5,73,8,61,34,22,5,4,2,2,0,0,0,0,0
S01012954,Occupancy rating +1,57,10,2,8,47,4,37,4,25,8,6,5,1,0,0,0,0,0
S01012954,Occupancy rating 0,21,0,0,0,21,0,17,0,11,6,4,2,2,0,0,0,0,0
S01012954,Occupancy rating -1 or less,10,0,0,0,9,0,7,0,6,1,2,1,1,1,1,0,0,0
S01012955,All households,356,88,19,69,257,29,206,64,105,37,22,13,9,11,2,0,0,9
S01012955,Occupancy rating +2 or more,207,41,8,33,161,18,137,38,79,20,6,4,2,5,0,0,0,5
S01012955,Occupancy rating +1,81,27,8,19,53,9,42,18,13,11,2,1,1,1,0,0,0,1
S01012955,Occupancy rating 0,51,18,2,16,30,2,20,8,8,4,8,3,5,3,1,0,0,2
S01012955,Occupancy rating -1 or less,17,2,1,1,13,0,7,0,5,2,6,5,1,2,1,0,0,1
S01012956,All households,458,210,101,109,236,52,146,53,69,24,38,23,15,12,5,0,1,6
S01012956,Occupancy rating +2 or more,152,51,36,15,101,35,63,37,17,9,3,3,0,0,0,0,0,0
S01012956,Occupancy rating +1,123,50,29,21,70,12,41,10,22,9,17,7,10,3,0,0,1,2
S01012956,Occupancy rating 0,123,72,16,56,45,4,28,4,20,4,13,9,4,6,3,0,0,3
S01012956,Occupancy rating -1 or less,60,37,20,17,20,1,14,2,10,2,5,4,1,3,2,0,0,1
S01012957,All households,304,128,56,72,168,28,109,36,51,22,31,15,16,8,4,0,0,4
S01012957,Occupancy rating +2 or more,109,35,23,12,73,22,47,29,10,8,4,0,4,1,0,0,0,1
S01012957,Occupancy rating +1,69,26,7,19,42,4,28,3,19,6,10,4,6,1,0,0,0,1
S01012957,Occupancy rating 0,103,61,23,38,41,1,30,4,18,8,10,6,4,1,0,0,0,1
S01012957,Occupancy rating -1 or less,23,6,3,3,12,1,4,0,4,0,7,5,2,5,4,0,0,1
S01012958,All households,206,50,18,32,152,10,119,51,41,27,23,8,15,4,1,0,0,3
S01012958,Occupancy rating +2 or more,106,24,9,15,82,5,69,44,13,12,8,2,6,0,0,0,0,0
S01012958,Occupancy rating +1,51,16,2,14,32,5,24,6,10,8,3,2,1,3,0,0,0,3
S01012958,Occupancy rating 0,34,10,7,3,24,0,16,0,12,4,8,3,5,0,0,0,0,0
S01012958,Occupancy rating -1 or less,15,0,0,0,14,0,10,1,6,3,4,1,3,1,1,0,0,0
S01012959,All households,228,55,10,45,169,5,132,46,61,25,32,19,13,4,1,0,0,3
S01012959,Occupancy rating +2 or more,86,18,3,15,68,1,64,29,23,12,3,3,0,0,0,0,0,0
S01012959,Occupancy rating +1,80,22,4,18,56,3,42,15,19,8,11,5,6,2,0,0,0,2
S01012959,Occupancy rating 0,47,11,1,10,34,1,21,1,16,4,12,8,4,2,1,0,0,1
S01012959,Occupancy rating -1 or less,15,4,2,2,11,0,5,1,3,1,6,3,3,0,0,0,0,0
S01012960,All households,229,31,14,17,190,20,126,51,47,28,44,22,22,8,6,0,1,1
S01012960,Occupancy rating +2 or more,119,23,11,12,95,15,74,44,17,13,6,4,2,1,1,0,0,0
S01012960,Occupancy rating +1,62,7,3,4,52,4,29,7,14,8,19,5,14,3,1,0,1,1
S01012960,Occupancy rating 0,38,0,0,0,35,0,18,0,12,6,17,12,5,3,3,0,0,0
S01012960,Occupancy rating -1 or less,10,1,0,1,8,1,5,0,4,1,2,1,1,1,1,0,0,0
S01012961,All households,200,38,12,26,156,15,124,40,60,24,17,11,6,6,3,0,0,3
S01012961,Occupancy rating +2 or more,116,16,4,12,100,11,83,38,32,13,6,2,4,0,0,0,0,0
S01012961,Occupancy rating +1,46,17,6,11,27,4,20,2,13,5,3,3,0,2,1,0,0,1
S01012961,Occupancy rating 0,34,4,2,2,27,0,19,0,13,6,8,6,2,3,1,0,0,2
S01012961,Occupancy rating -1 or less,4,1,0,1,2,0,2,0,2,0,0,0,0,1,1,0,0,0
S01012962,All households,236,27,15,12,204,32,158,50,56,52,14,5,9,5,4,0,0,1
S01012962,Occupancy rating +2 or more,154,15,9,6,137,27,103,44,33,26,7,2,5,2,1,0,0,1
S01012962,Occupancy rating +1,56,9,5,4,46,5,38,6,14,18,3,1,2,1,1,0,0,0
S01012962,Occupancy rating 0,22,3,1,2,17,0,14,0,8,6,3,2,1,2,2,0,0,0
S01012962,Occupancy rating -1 or less,4,0,0,0,4,0,3,0,1,2,1,0,1,0,0,0,0,0
S01012963,All households,275,32,6,26,235,16,199,59,113,27,20,12,8,8,6,0,0,2
S01012963,Occupancy rating +2 or more,235,32,6,26,200,15,169,53,92,24,16,10,6,3,2,0,0,1
S01012963,Occupancy rating +1,27,0,0,0,25,1,21,5,13,3,3,2,1,2,2,0,0,0
S01012963,Occupancy rating 0,10,0,0,0,8,0,7,1,6,0,1,0,1,2,1,0,0,1
S01012963,Occupancy rating -1 or less,3,0,0,0,2,0,2,0,2,0,0,0,0,1,1,0,0,0
S01012964,All households,200,22,4,18,170,3,152,30,101,21,15,13,2,8,4,1,1,2
S01012964,Occupancy rating +2 or more,164,20,3,17,141,3,127,30,79,18,11,9,2,3,1,0,0,2
S01012964,Occupancy rating +1,21,2,1,1,16,0,15,0,14,1,1,1,0,3,2,0,1,0
S01012964,Occupancy rating 0,9,0,0,0,8,0,6,0,5,1,2,2,0,1,0,1,0,0
S01012964,Occupancy rating -1 or less,6,0,0,0,5,0,4,0,3,1,1,1,0,1,1,0,0,0
S01012965,All households,229,50,4,46,174,6,137,29,87,21,31,21,10,5,2,0,1,2
S01012965,Occupancy rating +2 or more,119,22,2,20,95,5,83,22,50,11,7,3,4,2,1,0,1,0
S01012965,Occupancy rating +1,57,16,1,15,40,1,32,6,20,6,7,5,2,1,0,0,0,1
S01012965,Occupancy rating 0,35,3,0,3,31,0,17,1,13,3,14,12,2,1,0,0,0,1
S01012965,Occupancy rating -1 or less,18,9,1,8,8,0,5,0,4,1,3,1,2,1,1,0,0,0
S01012966,All households,262,56,17,39,199,14,148,47,75,26,37,24,13,7,5,0,0,2
S01012966,Occupancy rating +2 or more,137,41,11,30,94,13,76,42,27,7,5,3,2,2,0,0,0,2
S01012966,Occupancy rating +1,76,10,3,7,64,1,50,4,29,17,13,7,6,2,2,0,0,0
S01012966,Occupancy rating 0,44,4,2,2,37,0,20,1,17,2,17,13,4,3,3,0,0,0
S01012966,Occupancy rating -1 or less,5,1,1,0,4,0,2,0,2,0,2,1,1,0,0,0,0,0
S01012967,All households,183,46,9,37,123,14,89,30,40,19,20,11,9,14,8,0,0,6
S01012967,Occupancy rating +2 or more,86,35,7,28,47,10,33,25,4,4,4,1,3,4,2,0,0,2
S01012967,Occupancy rating +1,47,9,1,8,36,2,25,3,15,7,9,5,4,2,1,0,0,1
S01012967,Occupancy rating 0,34,2,1,1,27,1,23,2,14,7,3,1,2,5,3,0,0,2
S01012967,Occupancy rating -1 or less,16,0,0,0,13,1,8,0,7,1,4,4,0,3,2,0,0,1
S01012968,All households,271,62,8,54,197,13,134,54,62,18,50,36,14,12,4,0,1,7
S01012968,Occupancy rating +2 or more,89,21,2,19,68,12,52,41,5,6,4,0,4,0,0,0,0,0
S01012968,Occupancy rating +1,87,23,3,20,62,1,44,11,27,6,17,11,6,2,0,0,0,2
S01012968,Occupancy rating 0,80,15,3,12,57,0,32,2,24,6,25,21,4,8,3,0,0,5
S01012968,Occupancy rating -1 or less,15,3,0,3,10,0,6,0,6,0,4,4,0,2,1,0,1,0
S01012969,All households,306,106,48,58,185,33,123,51,55,17,29,20,9,15,5,0,2,8
S01012969,Occupancy rating +2 or more,115,36,12,24,76,23,50,36,10,4,3,2,1,3,1,0,0,2
S01012969,Occupancy rating +1,79,15,3,12,57,5,38,12,18,8,14,9,5,7,2,0,1,4
S01012969,Occupancy rating 0,84,45,29,16,37,3,26,3,19,4,8,7,1,2,1,0,1,0
S01012969,Occupancy rating -1 or less,28,10,4,6,15,2,9,0,8,1,4,2,2,3,1,0,0,2
S01012970,All households,236,57,30,27,169,22,121,50,40,31,26,12,14,10,5,0,0,5
S01012970,Occupancy rating +2 or more,79,14,3,11,65,6,54,37,6,11,5,3,2,0,0,0,0,0
S01012970,Occupancy rating +1,84,28,15,13,51,8,35,10,17,8,8,2,6,5,2,0,0,3
S01012970,Occupancy rating 0,60,14,11,3,42,8,25,3,14,8,9,4,5,4,3,0,0,1
S01012970,Occupancy rating -1 or less,13,1,1,0,11,0,7,0,3,4,4,3,1,1,0,0,0,1
S01012971,All households,299,45,12,33,240,12,146,40,70,36,82,64,18,14,9,0,0,5
S01012971,Occupancy rating +2 or more,82,18,7,11,64,10,51,27,15,9,3,2,1,0,0,0,0,0
S01012971,Occupancy rating +1,86,17,2,15,67,0,45,11,18,16,22,15,7,2,0,0,0,2
S01012971,Occupancy rating 0,90,7,3,4,78,2,39,2,30,7,37,30,7,5,3,0,0,2
S01012971,Occupancy rating -1 or less,41,3,0,3,31,0,11,0,7,4,20,17,3,7,6,0,0,1
S01012972,All households,329,93,43,50,219,23,137,54,60,23,59,44,15,17,12,0,0,5
S01012972,Occupancy rating +2 or more,79,28,14,14,48,7,38,30,3,5,3,1,2,3,1,0,0,2
S01012972,Occupancy rating +1,88,18,7,11,67,3,47,14,26,7,17,13,4,3,2,0,0,1
S01012972,Occupancy rating 0,135,41,20,21,90,12,44,10,25,9,34,26,8,4,3,0,0,1
S01012972,Occupancy rating -1 or less,27,6,2,4,14,1,8,0,6,2,5,4,1,7,6,0,0,1
S01012973,All households,335,102,63,39,222,32,152,51,71,30,38,21,17,11,7,0,0,4
S01012973,Occupancy rating +2 or more,126,36,19,17,88,17,68,45,14,9,3,1,2,2,1,0,0,1
S01012973,Occupancy rating +1,96,17,7,10,78,10,52,5,30,17,16,5,11,1,0,0,0,1
S01012973,Occupancy rating 0,93,40,30,10,47,5,27,1,24,2,15,13,2,6,5,0,0,1
S01012973,Occupancy rating -1 or less,20,9,7,2,9,0,5,0,3,2,4,2,2,2,1,0,0,1
S01012974,All households,446,174,75,99,257,44,166,66,67,33,47,33,14,15,5,0,1,9
S01012974,Occupancy rating +2 or more,120,38,21,17,80,21,55,35,13,7,4,2,2,2,0,0,0,2
S01012974,Occupancy rating +1,142,53,22,31,86,14,61,21,26,14,11,3,8,3,2,0,0,1
S01012974,Occupancy rating 0,140,64,27,37,68,9,37,9,22,6,22,18,4,8,2,0,1,5
S01012974,Occupancy rating -1 or less,44,19,5,14,23,0,13,1,6,6,10,10,0,2,1,0,0,1
S01012975,All households,266,85,57,28,172,21,111,37,44,30,40,27,13,9,4,0,0,5
S01012975,Occupancy rating +2 or more,85,36,18,18,48,9,36,26,7,3,3,2,1,1,0,0,0,1
S01012975,Occupancy rating +1,62,8,2,6,52,0,38,6,13,19,14,8,6,2,0,0,0,2
S01012975,Occupancy rating 0,90,29,25,4,58,9,29,4,17,8,20,16,4,3,2,0,0,1
S01012975,Occupancy rating -1 or less,29,12,12,0,14,3,8,1,7,0,3,1,2,3,2,0,0,1
S01012976,All households,229,65,32,33,157,24,93,42,35,16,40,26,14,7,4,0,0,3
S01012976,Occupancy rating +2 or more,89,29,18,11,60,19,35,28,7,0,6,4,2,0,0,0,0,0
S01012976,Occupancy rating +1,59,17,6,11,41,2,30,9,11,10,9,2,7,1,0,0,0,1
S01012976,Occupancy rating 0,65,19,8,11,43,2,24,5,13,6,17,15,2,3,1,0,0,2
S01012976,Occupancy rating -1 or less,16,0,0,0,13,1,4,0,4,0,8,5,3,3,3,0,0,0
S01012977,All households,287,73,21,52,205,14,130,42,56,32,61,46,15,9,5,0,0,4
S01012977,Occupancy rating +2 or more,90,25,9,16,64,11,44,30,8,6,9,6,3,1,0,0,0,1
S01012977,Occupancy rating +1,109,28,8,20,79,3,58,9,29,20,18,11,7,2,0,0,0,2
S01012977,Occupancy rating 0,68,18,2,16,47,0,22,3,14,5,25,22,3,3,2,0,0,1
S01012977,Occupancy rating -1 or less,20,2,2,0,15,0,6,0,5,1,9,7,2,3,3,0,0,0
S01012978,All households,334,96,26,70,224,18,141,46,63,32,65,47,18,14,5,0,1,8
S01012978,Occupancy rating +2 or more,106,38,9,29,68,9,49,33,10,6,10,7,3,0,0,0,0,0
S01012978,Occupancy rating +1,95,24,3,21,66,3,48,11,18,19,15,11,4,5,0,0,0,5
S01012978,Occupancy rating 0,104,29,12,17,71,6,35,2,28,5,30,21,9,4,2,0,0,2
S01012978,Occupancy rating -1 or less,29,5,2,3,19,0,9,0,7,2,10,8,2,5,3,0,1,1
S01012979,All households,224,36,11,25,181,6,148,44,76,28,27,16,11,7,2,0,1,4
S01012979,Occupancy rating +2 or more,112,29,9,20,82,6,73,40,25,8,3,3,0,1,1,0,0,0
S01012979,Occupancy rating +1,60,2,1,1,54,0,38,4,21,13,16,8,8,4,0,0,1,3
S01012979,Occupancy rating 0,44,5,1,4,37,0,30,0,24,6,7,4,3,2,1,0,0,1
S01012979,Occupancy rating -1 or less,8,0,0,0,8,0,7,0,6,1,1,1,0,0,0,0,0,0
S01012980,All households,311,115,28,87,191,24,114,37,62,15,53,40,13,5,2,0,0,3
S01012980,Occupancy rating +2 or more,53,20,10,10,32,16,16,12,2,2,0,0,0,1,0,0,0,1
S01012980,Occupancy rating +1,107,53,11,42,53,8,39,20,14,5,6,4,2,1,0,0,0,1
S01012980,Occupancy rating 0,110,21,6,15,88,0,46,3,38,5,42,32,10,1,0,0,0,1
S01012980,Occupancy rating -1 or less,41,21,1,20,18,0,13,2,8,3,5,4,1,2,2,0,0,0
S01012981,All households,347,129,32,97,205,14,129,51,57,21,62,37,25,13,6,0,1,6
S01012981,Occupancy rating +2 or more,87,23,11,12,62,9,43,28,13,2,10,4,6,2,0,0,1,1
S01012981,Occupancy rating +1,127,66,16,50,58,3,45,19,17,9,10,7,3,3,1,0,0,2
S01012981,Occupancy rating 0,104,31,3,28,70,2,33,4,21,8,35,21,14,3,1,0,0,2
S01012981,Occupancy rating -1 or less,29,9,2,7,15,0,8,0,6,2,7,5,2,5,4,0,0,1
S01012982,All households,383,132,34,98,241,43,145,52,68,25,53,33,20,10,7,0,0,3
S01012982,Occupancy rating +2 or more,94,33,13,20,60,26,31,25,5,1,3,1,2,1,1,0,0,0
S01012982,Occupancy rating +1,154,77,19,58,75,14,50,21,18,11,11,6,5,2,0,0,0,2
S01012982,Occupancy rating 0,111,17,0,17,92,2,56,5,39,12,34,23,11,2,2,0,0,0
S01012982,Occupancy rating -1 or less,24,5,2,3,14,1,8,1,6,1,5,3,2,5,4,0,0,1
S01012983,All households,326,98,49,49,224,43,149,63,61,25,32,17,15,4,1,0,0,3
S01012983,Occupancy rating +2 or more,170,46,27,19,124,34,84,48,30,6,6,2,4,0,0,0,0,0
S01012983,Occupancy rating +1,93,37,17,20,56,8,39,11,17,11,9,4,5,0,0,0,0,0
S01012983,Occupancy rating 0,53,13,4,9,37,1,20,3,9,8,16,11,5,3,1,0,0,2
S01012983,Occupancy rating -1 or less,10,2,1,1,7,0,6,1,5,0,1,0,1,1,0,0,0,1
S01012984,All households,279,91,40,51,171,19,118,45,55,18,34,15,19,17,7,0,0,10
S01012984,Occupancy rating +2 or more,101,37,22,15,62,13,43,28,12,3,6,1,5,2,0,0,0,2
S01012984,Occupancy rating +1,103,45,17,28,57,5,43,17,17,9,9,4,5,1,0,0,0,1
S01012984,Occupancy rating 0,58,7,1,6,43,1,28,0,22,6,14,7,7,8,1,0,0,7
S01012984,Occupancy rating -1 or less,17,2,0,2,9,0,4,0,4,0,5,3,2,6,6,0,0,0
S01012985,All households,330,97,50,47,228,36,163,54,69,40,29,19,10,5,4,0,1,0
S01012985,Occupancy rating +2 or more,144,50,34,16,92,27,63,35,18,10,2,1,1,2,1,0,1,0
S01012985,Occupancy rating +1,97,26,11,15,71,6,52,14,22,16,13,7,6,0,0,0,0,0
S01012985,Occupancy rating 0,72,20,5,15,50,3,38,5,23,10,9,8,1,2,2,0,0,0
S01012985,Occupancy rating -1 or less,17,1,0,1,15,0,10,0,6,4,5,3,2,1,1,0,0,0
S01012986,All households,394,183,53,130,204,27,125,46,58,21,52,35,17,7,2,0,0,5
S01012986,Occupancy rating +2 or more,86,36,20,16,50,11,37,13,20,4,2,1,1,0,0,0,0,0
S01012986,Occupancy rating +1,128,59,21,38,68,11,49,25,15,9,8,2,6,1,1,0,0,0
S01012986,Occupancy rating 0,152,81,11,70,66,4,34,8,19,7,28,22,6,5,1,0,0,4
S01012986,Occupancy rating -1 or less,28,7,1,6,20,1,5,0,4,1,14,10,4,1,0,0,0,1
S01012987,All households,356,145,77,68,195,37,127,46,59,22,31,15,16,16,3,0,0,13
S01012987,Occupancy rating +2 or more,92,37,21,16,51,12,37,21,11,5,2,0,2,4,1,0,0,3
S01012987,Occupancy rating +1,129,57,25,32,70,17,39,22,10,7,14,6,8,2,0,0,0,2
S01012987,Occupancy rating 0,111,46,27,19,56,8,36,3,25,8,12,6,6,9,2,0,0,7
S01012987,Occupancy rating -1 or less,24,5,4,1,18,0,15,0,13,2,3,3,0,1,0,0,0,1
S01012988,All households,463,204,106,98,251,49,140,56,59,25,62,44,18,8,1,0,2,5
S01012988,Occupancy rating +2 or more,106,43,28,15,62,22,37,26,6,5,3,2,1,1,0,0,1,0
S01012988,Occupancy rating +1,164,76,40,36,86,23,49,18,25,6,14,10,4,2,0,0,0,2
S01012988,Occupancy rating 0,160,70,32,38,87,3,45,12,21,12,39,27,12,3,1,0,1,1
S01012988,Occupancy rating -1 or less,33,15,6,9,16,1,9,0,7,2,6,5,1,2,0,0,0,2
S01012989,All households,409,128,53,75,261,51,154,51,67,36,56,31,25,20,8,0,1,11
S01012989,Occupancy rating +2 or more,138,41,30,11,93,33,50,23,17,10,10,4,6,4,1,0,0,3
S01012989,Occupancy rating +1,143,53,18,35,86,14,59,23,22,14,13,6,7,4,1,0,0,3
S01012989,Occupancy rating 0,101,32,5,27,62,4,34,5,20,9,24,15,9,7,3,0,1,3
S01012989,Occupancy rating -1 or less,27,2,0,2,20,0,11,0,8,3,9,6,3,5,3,0,0,2
S01012990,All households,303,149,86,63,139,15,95,32,39,24,29,17,12,15,6,0,2,7
S01012990,Occupancy rating +2 or more,84,42,27,15,39,9,27,18,5,4,3,1,2,3,3,0,0,0
S01012990,Occupancy rating +1,68,24,10,14,40,4,30,11,13,6,6,2,4,4,0,0,2,2
S01012990,Occupancy rating 0,118,61,31,30,52,2,32,2,17,13,18,12,6,5,1,0,0,4
S01012990,Occupancy rating -1 or less,33,22,18,4,8,0,6,1,4,1,2,2,0,3,2,0,0,1
S01012991,All households,351,101,50,51,231,35,138,48,63,27,58,34,24,19,10,1,0,8
S01012991,Occupancy rating +2 or more,107,41,27,14,64,17,43,25,14,4,4,4,0,2,1,0,0,1
S01012991,Occupancy rating +1,136,50,20,30,84,15,53,21,18,14,16,6,10,2,0,1,0,1
S01012991,Occupancy rating 0,78,8,1,7,64,1,35,1,25,9,28,18,10,6,2,0,0,4
S01012991,Occupancy rating -1 or less,30,2,2,0,19,2,7,1,6,0,10,6,4,9,7,0,0,2
S01012992,All households,380,167,84,83,201,35,122,34,68,20,44,25,19,12,4,0,1,7
S01012992,Occupancy rating +2 or more,108,41,32,9,63,18,42,17,22,3,3,1,2,4,2,0,0,2
S01012992,Occupancy rating +1,125,68,27,41,54,10,36,14,14,8,8,2,6,3,0,0,1,2
S01012992,Occupancy rating 0,117,48,23,25,66,5,33,3,24,6,28,18,10,3,2,0,0,1
S01012992,Occupancy rating -1 or less,30,10,2,8,18,2,11,0,8,3,5,4,1,2,0,0,0,2
S01012993,All households,376,185,76,109,185,24,113,53,45,15,48,34,14,6,1,0,1,4
S01012993,Occupancy rating +2 or more,92,31,16,15,60,17,41,26,9,6,2,1,1,1,1,0,0,0
S01012993,Occupancy rating +1,153,110,42,68,43,5,32,20,8,4,6,3,3,0,0,0,0,0
S01012993,Occupancy rating 0,106,35,12,23,68,1,32,5,22,5,35,25,10,3,0,0,0,3
S01012993,Occupancy rating -1 or less,25,9,6,3,14,1,8,2,6,0,5,5,0,2,0,0,1,1
S01012994,All households,502,286,103,183,204,22,118,49,50,19,64,37,27,12,4,0,0,8
S01012994,Occupancy rating +2 or more,79,31,17,14,48,9,36,16,14,6,3,2,1,0,0,0,0,0
S01012994,Occupancy rating +1,167,115,44,71,48,9,31,13,10,8,8,1,7,4,0,0,0,4
S01012994,Occupancy rating 0,213,124,38,86,85,4,41,19,17,5,40,27,13,4,1,0,0,3
S01012994,Occupancy rating -1 or less,43,16,4,12,23,0,10,1,9,0,13,7,6,4,3,0,0,1
S01012995,All households,331,76,22,54,245,25,177,73,61,43,43,25,18,10,4,0,0,6
S01012995,Occupancy rating +2 or more,92,16,3,13,76,8,63,38,14,11,5,1,4,0,0,0,0,0
S01012995,Occupancy rating +1,133,43,15,28,86,13,61,27,20,14,12,6,6,4,2,0,0,2
S01012995,Occupancy rating 0,92,15,4,11,73,2,48,8,24,16,23,15,8,4,0,0,0,4
S01012995,Occupancy rating -1 or less,14,2,0,2,10,2,5,0,3,2,3,3,0,2,2,0,0,0
S01012996,All households,246,51,19,32,178,8,131,41,39,51,39,23,16,17,8,0,1,8
S01012996,Occupancy rating +2 or more,78,23,9,14,54,5,46,32,6,8,3,1,2,1,1,0,0,0
S01012996,Occupancy rating +1,79,25,9,16,50,2,40,7,17,16,8,2,6,4,0,0,0,4
S01012996,Occupancy rating 0,68,3,1,2,58,1,31,2,10,19,26,18,8,7,3,0,1,3
S01012996,Occupancy rating -1 or less,21,0,0,0,16,0,14,0,6,8,2,2,0,5,4,0,0,1
S01012997,All households,210,66,39,27,136,20,86,31,35,20,30,21,9,8,3,0,0,5
S01012997,Occupancy rating +2 or more,65,23,11,12,40,12,23,15,2,6,5,2,3,2,0,0,0,2
S01012997,Occupancy rating +1,68,15,8,7,52,6,38,12,18,8,8,7,1,1,0,0,0,1
S01012997,Occupancy rating 0,55,23,17,6,30,2,19,3,12,4,9,7,2,2,0,0,0,2
S01012997,Occupancy rating -1 or less,22,5,3,2,14,0,6,1,3,2,8,5,3,3,3,0,0,0
S01012998,All households,414,91,34,57,310,34,222,72,116,34,54,37,17,13,9,0,0,4
S01012998,Occupancy rating +2 or more,184,38,16,22,145,25,114,44,57,13,6,3,3,1,1,0,0,0
S01012998,Occupancy rating +1,105,37,13,24,67,7,50,21,20,9,10,7,3,1,1,0,0,0
S01012998,Occupancy rating 0,94,15,5,10,73,1,42,6,28,8,30,23,7,6,4,0,0,2
S01012998,Occupancy rating -1 or less,31,1,0,1,25,1,16,1,11,4,8,4,4,5,3,0,0,2
S01012999,All households,220,83,37,46,131,17,90,33,37,20,24,18,6,6,4,0,0,2
S01012999,Occupancy rating +2 or more,56,18,9,9,37,9,25,14,6,5,3,2,1,1,1,0,0,0
S01012999,Occupancy rating +1,77,29,9,20,48,3,41,16,16,9,4,4,0,0,0,0,0,0
S01012999,Occupancy rating 0,72,33,19,14,37,3,20,3,13,4,14,10,4,2,0,0,0,2
S01012999,Occupancy rating -1 or less,15,3,0,3,9,2,4,0,2,2,3,2,1,3,3,0,0,0
S01013000,All households,322,131,53,78,183,37,104,41,41,22,42,25,17,8,1,0,0,7
S01013000,Occupancy rating +2 or more,86,37,21,16,48,22,23,15,6,2,3,0,3,1,0,0,0,1
S01013000,Occupancy rating +1,114,44,20,24,67,11,42,19,11,12,14,6,8,3,0,0,0,3
S01013000,Occupancy rating 0,97,39,9,30,57,4,33,6,19,8,20,15,5,1,0,0,0,1
S01013000,Occupancy rating -1 or less,25,11,3,8,11,0,6,1,5,0,5,4,1,3,1,0,0,2
S01013001,All households,156,28,10,18,122,23,86,40,36,10,13,8,5,6,1,0,1,4
S01013001,Occupancy rating +2 or more,110,20,9,11,86,22,60,33,21,6,4,2,2,4,1,0,1,2
S01013001,Occupancy rating +1,23,3,1,2,20,1,13,5,5,3,6,3,3,0,0,0,0,0
S01013001,Occupancy rating 0,20,5,0,5,13,0,10,2,7,1,3,3,0,2,0,0,0,2
S01013001,Occupancy rating -1 or less,3,0,0,0,3,0,3,0,3,0,0,0,0,0,0,0,0,0
S01013002,All households,205,48,21,27,149,27,107,45,51,11,15,7,8,8,1,0,0,7
S01013002,Occupancy rating +2 or more,133,17,9,8,112,24,82,36,36,10,6,2,4,4,1,0,0,3
S01013002,Occupancy rating +1,28,14,8,6,14,2,9,4,5,0,3,1,2,0,0,0,0,0
S01013002,Occupancy rating 0,36,14,3,11,19,1,14,5,9,0,4,2,2,3,0,0,0,3
S01013002,Occupancy rating -1 or less,8,3,1,2,4,0,2,0,1,1,2,2,0,1,0,0,0,1
S01013003,All households,246,34,24,10,211,50,152,61,71,20,9,5,4,1,1,0,0,0
S01013003,Occupancy rating +2 or more,217,24,17,7,192,48,138,60,62,16,6,4,2,1,1,0,0,0
S01013003,Occupancy rating +1,22,9,6,3,13,2,9,1,5,3,2,1,1,0,0,0,0,0
S01013003,Occupancy rating 0,7,1,1,0,6,0,5,0,4,1,1,0,1,0,0,0,0,0
S01013003,Occupancy rating -1 or less,0,0,0,0,0,0,0,0,0,0,0,0,0,0,0,0,0,0
S01013004,All households,264,52,25,27,203,31,149,58,78,13,23,15,8,9,3,0,1,5
S01013004,Occupancy rating +2 or more,197,39,19,20,152,25,117,49,57,11,10,6,4,6,3,0,1,2
S01013004,Occupancy rating +1,42,9,4,5,30,4,22,5,15,2,4,2,2,3,0,0,0,3
S01013004,Occupancy rating 0,20,3,1,2,17,2,8,4,4,0,7,6,1,0,0,0,0,0
S01013004,Occupancy rating -1 or less,5,1,1,0,4,0,2,0,2,0,2,1,1,0,0,0,0,0
S01013005,All households,300,70,41,29,222,41,149,57,68,24,32,20,12,8,2,1,1,4
S01013005,Occupancy rating +2 or more,230,52,31,21,175,40,119,52,48,19,16,10,6,3,0,0,1,2
S01013005,Occupancy rating +1,34,11,8,3,22,1,17,3,12,2,4,4,0,1,0,0,0,1
S01013005,Occupancy rating 0,26,5,2,3,19,0,8,1,5,2,11,6,5,2,0,1,0,1
S01013005,Occupancy rating -1 or less,10,2,0,2,6,0,5,1,3,1,1,0,1,2,2,0,0,0
S01013006,All households,240,39,13,26,191,36,141,59,64,18,14,9,5,10,4,1,1,4
S01013006,Occupancy rating +2 or more,192,27,12,15,160,33,122,50,55,17,5,2,3,5,3,0,0,2
S01013006,Occupancy rating +1,26,9,1,8,16,2,11,7,3,1,3,3,0,1,0,0,0,1
S01013006,Occupancy rating 0,16,3,0,3,13,1,7,2,5,0,5,3,2,0,0,0,0,0
S01013006,Occupancy rating -1 or less,6,0,0,0,2,0,1,0,1,0,1,1,0,4,1,1,1,1
S01013007,All households,397,111,65,46,278,70,188,70,89,29,20,11,9,8,2,0,1,5
S01013007,Occupancy rating +2 or more,280,67,43,24,208,62,141,61,59,21,5,3,2,5,2,0,1,2
S01013007,Occupancy rating +1,68,24,14,10,42,5,30,6,18,6,7,3,4,2,0,0,0,2
S01013007,Occupancy rating 0,38,16,6,10,22,2,15,3,11,1,5,3,2,0,0,0,0,0
S01013007,Occupancy rating -1 or less,11,4,2,2,6,1,2,0,1,1,3,2,1,1,0,0,0,1
S01013008,All households,330,85,44,41,233,37,163,71,72,20,33,22,11,12,7,0,2,3
S01013008,Occupancy rating +2 or more,179,34,20,14,141,33,101,51,37,13,7,4,3,4,2,0,1,1
S01013008,Occupancy rating +1,85,32,19,13,52,3,39,18,17,4,10,5,5,1,0,0,0,1
S01013008,Occupancy rating 0,57,18,4,14,35,1,19,1,15,3,15,12,3,4,3,0,1,0
S01013008,Occupancy rating -1 or less,9,1,1,0,5,0,4,1,3,0,1,1,0,3,2,0,0,1
S01013009,All households,293,106,63,43,178,44,102,30,49,23,32,22,10,9,2,0,0,7
S01013009,Occupancy rating +2 or more,154,45,32,13,108,39,63,26,23,14,6,4,2,1,0,0,0,1
S01013009,Occupancy rating +1,54,24,13,11,28,1,19,3,10,6,8,5,3,2,1,0,0,1
S01013009,Occupancy rating 0,70,35,17,18,32,4,14,1,11,2,14,11,3,3,0,0,0,3
S01013009,Occupancy rating -1 or less,15,2,1,1,10,0,6,0,5,1,4,2,2,3,1,0,0,2
S01013010,All households,246,68,36,32,168,25,129,51,55,23,14,4,10,10,4,1,0,5
S01013010,Occupancy rating +2 or more,192,48,26,22,141,21,110,45,47,18,10,3,7,3,2,0,0,1
S01013010,Occupancy rating +1,31,13,9,4,16,3,11,3,5,3,2,1,1,2,0,0,0,2
S01013010,Occupancy rating 0,14,4,0,4,8,1,5,1,3,1,2,0,2,2,1,0,0,1
S01013010,Occupancy rating -1 or less,9,3,1,2,3,0,3,2,0,1,0,0,0,3,1,1,0,1
S01013011,All households,261,53,28,25,199,19,153,44,96,13,27,20,7,9,6,0,0,3
S01013011,Occupancy rating +2 or more,167,30,17,13,129,13,112,35,70,7,4,4,0,8,5,0,0,3
S01013011,Occupancy rating +1,38,11,6,5,27,3,20,6,9,5,4,1,3,0,0,0,0,0
S01013011,Occupancy rating 0,48,10,4,6,38,3,20,3,16,1,15,12,3,0,0,0,0,0
S01013011,Occupancy rating -1 or less,8,2,1,1,5,0,1,0,1,0,4,3,1,1,1,0,0,0
S01013012,All households,292,106,50,56,179,22,124,45,60,19,33,22,11,7,4,1,0,2
S01013012,Occupancy rating +2 or more,104,31,17,14,70,14,50,23,21,6,6,5,1,3,1,0,0,2
S01013012,Occupancy rating +1,84,33,10,23,50,5,38,16,16,6,7,4,3,1,1,0,0,0
S01013012,Occupancy rating 0,87,39,21,18,47,2,29,6,17,6,16,10,6,1,1,0,0,0
S01013012,Occupancy rating -1 or less,17,3,2,1,12,1,7,0,6,1,4,3,1,2,1,1,0,0
S01013013,All households,297,77,52,25,216,27,158,59,70,29,31,21,10,4,2,0,1,1
S01013013,Occupancy rating +2 or more,199,50,41,9,146,24,111,46,50,15,11,6,5,3,2,0,1,0
S01013013,Occupancy rating +1,62,22,10,12,39,2,30,11,12,7,7,5,2,1,0,0,0,1
S01013013,Occupancy rating 0,28,4,1,3,24,1,14,1,7,6,9,7,2,0,0,0,0,0
S01013013,Occupancy rating -1 or less,8,1,0,1,7,0,3,1,1,1,4,3,1,0,0,0,0,0
S01013014,All households,336,112,60,52,208,37,143,47,68,28,28,19,9,16,1,0,3,12
S01013014,Occupancy rating +2 or more,194,49,30,19,133,30,96,36,45,15,7,3,4,12,1,0,3,8
S01013014,Occupancy rating +1,80,38,17,21,40,6,28,10,12,6,6,4,2,2,0,0,0,2
S01013014,Occupancy rating 0,54,23,11,12,29,1,15,1,9,5,13,11,2,2,0,0,0,2
S01013014,Occupancy rating -1 or less,8,2,2,0,6,0,4,0,2,2,2,1,1,0,0,0,0,0
S01013015,All households,309,72,34,38,227,48,158,54,79,25,21,14,7,10,3,2,1,4
S01013015,Occupancy rating +2 or more,214,48,23,25,163,40,112,48,50,14,11,7,4,3,2,0,0,1
S01013015,Occupancy rating +1,54,16,7,9,37,7,27,4,17,6,3,2,1,1,0,0,1,0
S01013015,Occupancy rating 0,28,6,2,4,20,1,16,1,10,5,3,2,1,2,1,0,0,1
S01013015,Occupancy rating -1 or less,13,2,2,0,7,0,3,1,2,0,4,3,1,4,0,2,0,2
S01013016,All households,244,42,15,27,190,28,143,66,56,21,19,10,9,12,7,0,1,4
S01013016,Occupancy rating +2 or more,201,38,14,24,155,26,124,59,47,18,5,1,4,8,4,0,0,4
S01013016,Occupancy rating +1,22,2,0,2,19,2,13,6,5,2,4,1,3,1,0,0,1,0
S01013016,Occupancy rating 0,17,0,0,0,14,0,6,1,4,1,8,6,2,3,3,0,0,0
S01013016,Occupancy rating -1 or less,4,2,1,1,2,0,0,0,0,0,2,2,0,0,0,0,0,0
S01013017,All households,359,102,57,45,242,35,159,62,78,19,48,29,19,15,7,0,1,7
S01013017,Occupancy rating +2 or more,185,36,21,15,146,27,106,47,46,13,13,8,5,3,1,0,0,2
S01013017,Occupancy rating +1,76,27,12,15,44,3,29,10,14,5,12,4,8,5,3,0,0,2
S01013017,Occupancy rating 0,78,35,22,13,40,5,18,5,12,1,17,13,4,3,1,0,1,1
S01013017,Occupancy rating -1 or less,20,4,2,2,12,0,6,0,6,0,6,4,2,4,2,0,0,2
S01013018,All households,387,90,40,50,275,56,199,72,100,27,20,10,10,22,7,1,0,14
S01013018,Occupancy rating +2 or more,291,62,26,36,216,49,162,65,78,19,5,2,3,13,4,0,0,9
S01013018,Occupancy rating +1,48,17,7,10,30,3,20,4,11,5,7,2,5,1,0,0,0,1
S01013018,Occupancy rating 0,41,10,6,4,26,4,16,3,10,3,6,5,1,5,1,0,0,4
S01013018,Occupancy rating -1 or less,7,1,1,0,3,0,1,0,1,0,2,1,1,3,2,1,0,0
S01013019,All households,355,81,31,50,253,28,205,82,107,16,20,14,6,21,7,4,1,9
S01013019,Occupancy rating +2 or more,219,39,19,20,174,23,144,56,76,12,7,6,1,6,3,0,0,3
S01013019,Occupancy rating +1,57,18,9,9,35,3,28,10,16,2,4,2,2,4,2,1,1,0
S01013019,Occupancy rating 0,51,23,3,20,24,2,19,11,7,1,3,1,2,4,0,1,0,3
S01013019,Occupancy rating -1 or less,28,1,0,1,20,0,14,5,8,1,6,5,1,7,2,2,0,3
S01013020,All households,226,89,61,28,123,24,81,36,28,17,18,9,9,14,7,0,1,6
S01013020,Occupancy rating +2 or more,71,21,15,6,47,13,33,21,9,3,1,1,0,3,1,0,0,2
S01013020,Occupancy rating +1,73,41,26,15,31,8,21,8,8,5,2,1,1,1,0,0,0,1
S01013020,Occupancy rating 0,65,24,17,7,35,2,22,7,9,6,11,6,5,6,3,0,0,3
S01013020,Occupancy rating -1 or less,17,3,3,0,10,1,5,0,2,3,4,1,3,4,3,0,1,0
S01013021,All households,187,43,21,22,134,19,94,38,36,20,21,15,6,10,4,0,0,6
S01013021,Occupancy rating +2 or more,72,23,9,14,49,10,35,22,11,2,4,3,1,0,0,0,0,0
S01013021,Occupancy rating +1,69,20,12,8,47,8,33,12,12,9,6,4,2,2,0,0,0,2
S01013021,Occupancy rating 0,38,0,0,0,32,1,20,1,12,7,11,8,3,6,2,0,0,4
S01013021,Occupancy rating -1 or less,8,0,0,0,6,0,6,3,1,2,0,0,0,2,2,0,0,0
S01013022,All households,186,46,10,36,124,8,72,26,40,6,44,38,6,16,4,0,0,12
S01013022,Occupancy rating +2 or more,63,13,2,11,45,7,35,14,20,1,3,2,1,5,1,0,0,4
S01013022,Occupancy rating +1,39,17,2,15,21,1,13,10,1,2,7,4,3,1,1,0,0,0
S01013022,Occupancy rating 0,69,14,6,8,47,0,20,2,16,2,27,25,2,8,1,0,0,7
S01013022,Occupancy rating -1 or less,15,2,0,2,11,0,4,0,3,1,7,7,0,2,1,0,0,1
S01013023,All households,337,52,34,18,268,51,197,84,81,32,20,11,9,17,7,0,1,9
S01013023,Occupancy rating +2 or more,281,49,31,18,220,50,160,75,63,22,10,6,4,12,6,0,1,5
S01013023,Occupancy rating +1,37,3,3,0,33,1,24,8,10,6,8,4,4,1,0,0,0,1
S01013023,Occupancy rating 0,16,0,0,0,12,0,11,1,6,4,1,0,1,4,1,0,0,3
S01013023,Occupancy rating -1 or less,3,0,0,0,3,0,2,0,2,0,1,1,0,0,0,0,0,0
S01013024,All households,227,67,41,26,154,30,109,41,53,15,15,7,8,6,2,2,0,2
S01013024,Occupancy rating +2 or more,154,42,31,11,110,25,81,36,34,11,4,2,2,2,1,0,0,1
S01013024,Occupancy rating +1,50,21,8,13,28,5,18,2,12,4,5,2,3,1,0,0,0,1
S01013024,Occupancy rating 0,21,3,1,2,15,0,10,3,7,0,5,2,3,3,1,2,0,0
S01013024,Occupancy rating -1 or less,2,1,1,0,1,0,0,0,0,0,1,1,0,0,0,0,0,0
S01013025,All households,211,49,14,35,145,22,112,58,32,22,11,6,5,17,6,0,0,11
S01013025,Occupancy rating +2 or more,160,40,10,30,108,19,85,50,19,16,4,2,2,12,4,0,0,8
S01013025,Occupancy rating +1,24,5,3,2,19,2,14,4,9,1,3,2,1,0,0,0,0,0
S01013025,Occupancy rating 0,16,4,1,3,11,1,8,1,3,4,2,1,1,1,0,0,0,1
S01013025,Occupancy rating -1 or less,11,0,0,0,7,0,5,3,1,1,2,1,1,4,2,0,0,2
S01013026,All households,410,116,26,90,273,24,202,82,81,39,47,31,16,21,12,1,0,8
S01013026,Occupancy rating +2 or more,181,38,10,28,134,14,115,60,39,16,5,2,3,9,5,0,0,4
S01013026,Occupancy rating +1,112,43,11,32,68,7,48,18,20,10,13,8,5,1,1,0,0,0
S01013026,Occupancy rating 0,99,32,3,29,60,3,34,3,20,11,23,15,8,7,3,1,0,3
S01013026,Occupancy rating -1 or less,18,3,2,1,11,0,5,1,2,2,6,6,0,4,3,0,0,1
S01013027,All households,422,128,60,68,269,28,155,44,69,42,86,57,29,25,16,0,1,8
S01013027,Occupancy rating +2 or more,112,45,26,19,66,14,45,28,11,6,7,3,4,1,0,0,0,1
S01013027,Occupancy rating +1,122,34,14,20,84,10,46,14,15,17,28,17,11,4,0,0,1,3
S01013027,Occupancy rating 0,146,43,16,27,93,4,52,2,35,15,37,25,12,10,7,0,0,3
S01013027,Occupancy rating -1 or less,42,6,4,2,26,0,12,0,8,4,14,12,2,10,9,0,0,1
S01013028,All households,191,42,14,28,137,17,101,43,41,17,19,10,9,12,1,0,0,11
S01013028,Occupancy rating +2 or more,112,27,11,16,81,14,61,34,20,7,6,1,5,4,1,0,0,3
S01013028,Occupancy rating +1,54,13,3,10,39,3,30,8,13,9,6,4,2,2,0,0,0,2
S01013028,Occupancy rating 0,21,2,0,2,15,0,8,1,7,0,7,5,2,4,0,0,0,4
S01013028,Occupancy rating -1 or less,4,0,0,0,2,0,2,0,1,1,0,0,0,2,0,0,0,2
S01013029,All households,269,96,45,51,157,30,97,37,46,14,30,19,11,16,5,1,2,8
S01013029,Occupancy rating +2 or more,87,35,18,17,49,19,28,19,9,0,2,1,1,3,0,0,1,2
S01013029,Occupancy rating +1,95,35,18,17,58,6,39,15,16,8,13,6,7,2,0,0,0,2
S01013029,Occupancy rating 0,59,19,6,13,34,4,20,2,15,3,10,9,1,6,0,1,1,4
S01013029,Occupancy rating -1 or less,28,7,3,4,16,1,10,1,6,3,5,3,2,5,5,0,0,0
S01013030,All households,225,41,19,22,163,15,112,36,43,33,36,27,9,21,10,0,1,10
S01013030,Occupancy rating +2 or more,89,22,9,13,62,14,44,29,8,7,4,3,1,5,2,0,0,3
S01013030,Occupancy rating +1,63,16,8,8,46,1,30,5,13,12,15,8,7,1,0,0,0,1
S01013030,Occupancy rating 0,52,2,1,1,42,0,31,2,19,10,11,10,1,8,5,0,0,3
S01013030,Occupancy rating -1 or less,21,1,1,0,13,0,7,0,3,4,6,6,0,7,3,0,1,3
S01013031,All households,291,118,31,87,161,12,99,28,46,25,50,38,12,12,7,0,0,5
S01013031,Occupancy rating +2 or more,67,37,13,24,30,5,19,12,3,4,6,4,2,0,0,0,0,0
S01013031,Occupancy rating +1,94,42,6,36,48,2,35,10,10,15,11,6,5,4,1,0,0,3
S01013031,Occupancy rating 0,100,36,11,25,62,3,34,4,25,5,25,23,2,2,1,0,0,1
S01013031,Occupancy rating -1 or less,30,3,1,2,21,2,11,2,8,1,8,5,3,6,5,0,0,1
S01013032,All households,309,63,5,58,237,6,198,77,105,16,33,26,7,9,9,0,0,0
S01013032,Occupancy rating +2 or more,155,29,2,27,125,4,110,54,50,6,11,9,2,1,1,0,0,0
S01013032,Occupancy rating +1,74,23,3,20,49,2,44,18,21,5,3,2,1,2,2,0,0,0
S01013032,Occupancy rating 0,59,6,0,6,49,0,33,2,26,5,16,13,3,4,4,0,0,0
S01013032,Occupancy rating -1 or less,21,5,0,5,14,0,11,3,8,0,3,2,1,2,2,0,0,0
S01013033,All households,276,65,13,52,202,10,157,67,80,10,35,24,11,9,2,0,0,7
S01013033,Occupancy rating +2 or more,77,14,1,13,63,7,51,34,16,1,5,4,1,0,0,0,0,0
S01013033,Occupancy rating +1,103,31,4,27,68,1,58,24,29,5,9,7,2,4,1,0,0,3
S01013033,Occupancy rating 0,80,18,8,10,60,2,40,5,32,3,18,12,6,2,0,0,0,2
S01013033,Occupancy rating -1 or less,16,2,0,2,11,0,8,4,3,1,3,1,2,3,1,0,0,2
S01013034,All households,296,74,36,38,206,29,131,46,53,32,46,27,19,16,9,1,1,5
S01013034,Occupancy rating +2 or more,99,30,15,15,67,24,40,28,7,5,3,3,0,2,0,0,1,1
S01013034,Occupancy rating +1,93,29,12,17,59,3,43,14,14,15,13,4,9,5,2,0,0,3
S01013034,Occupancy rating 0,79,14,9,5,59,1,36,2,25,9,22,14,8,6,4,1,0,1
S01013034,Occupancy rating -1 or less,25,1,0,1,21,1,12,2,7,3,8,6,2,3,3,0,0,0
S01013035,All households,300,96,34,62,186,18,107,37,52,18,61,37,24,18,9,0,1,8
S01013035,Occupancy rating +2 or more,70,32,13,19,38,8,26,20,3,3,4,2,2,0,0,0,0,0
S01013035,Occupancy rating +1,88,31,12,19,53,7,34,15,16,3,12,6,6,4,0,0,1,3
S01013035,Occupancy rating 0,104,27,7,20,70,2,36,0,26,10,32,22,10,7,3,0,0,4
S01013035,Occupancy rating -1 or less,38,6,2,4,25,1,11,2,7,2,13,7,6,7,6,0,0,1
S01013036,All households,280,59,24,35,199,9,130,44,47,39,60,33,27,22,11,0,1,10
S01013036,Occupancy rating +2 or more,100,44,18,26,54,5,44,34,6,4,5,2,3,2,1,0,0,1
S01013036,Occupancy rating +1,76,10,4,6,63,3,42,9,11,22,18,6,12,3,0,0,0,3
S01013036,Occupancy rating 0,69,4,2,2,54,1,28,1,16,11,25,17,8,11,6,0,1,4
S01013036,Occupancy rating -1 or less,35,1,0,1,28,0,16,0,14,2,12,8,4,6,4,0,0,2
S01013037,All households,283,53,13,40,222,27,170,71,65,34,25,14,11,8,1,0,0,7
S01013037,Occupancy rating +2 or more,147,21,4,17,124,19,99,51,30,18,6,2,4,2,0,0,0,2
S01013037,Occupancy rating +1,93,25,7,18,65,6,52,16,21,15,7,4,3,3,0,0,0,3
S01013037,Occupancy rating 0,32,6,1,5,26,2,17,4,12,1,7,4,3,0,0,0,0,0
S01013037,Occupancy rating -1 or less,11,1,1,0,7,0,2,0,2,0,5,4,1,3,1,0,0,2
S01013038,All households,434,158,77,81,251,32,164,61,70,33,55,33,22,25,7,1,0,17
S01013038,Occupancy rating +2 or more,112,39,21,18,67,16,46,23,15,8,5,5,0,6,2,0,0,4
S01013038,Occupancy rating +1,172,76,34,42,91,14,66,33,20,13,11,6,5,5,1,0,0,4
S01013038,Occupancy rating 0,120,37,19,18,74,1,42,4,27,11,31,14,17,9,0,1,0,8
S01013038,Occupancy rating -1 or less,30,6,3,3,19,1,10,1,8,1,8,8,0,5,4,0,0,1
S01013039,All households,178,20,6,14,150,8,131,43,68,20,11,7,4,8,3,1,0,4
S01013039,Occupancy rating +2 or more,139,14,4,10,123,7,109,39,55,15,7,5,2,2,1,0,0,1
S01013039,Occupancy rating +1,21,5,2,3,13,1,11,1,7,3,1,1,0,3,1,0,0,2
S01013039,Occupancy rating 0,16,1,0,1,12,0,9,3,5,1,3,1,2,3,1,1,0,1
S01013039,Occupancy rating -1 or less,2,0,0,0,2,0,2,0,1,1,0,0,0,0,0,0,0,0
S01013040,All households,324,145,76,69,164,29,109,46,42,21,26,15,11,15,4,0,0,11
S01013040,Occupancy rating +2 or more,116,35,19,16,79,17,58,31,15,12,4,1,3,2,1,0,0,1
S01013040,Occupancy rating +1,93,47,24,23,43,6,30,9,13,8,7,4,3,3,0,0,0,3
S01013040,Occupancy rating 0,86,53,29,24,28,4,17,6,10,1,7,4,3,5,0,0,0,5
S01013040,Occupancy rating -1 or less,29,10,4,6,14,2,4,0,4,0,8,6,2,5,3,0,0,2
S01013041,All households,257,83,28,55,153,19,112,49,44,19,22,11,11,21,10,1,0,10
S01013041,Occupancy rating +2 or more,80,20,7,13,53,6,44,18,18,8,3,0,3,7,4,0,0,3
S01013041,Occupancy rating +1,82,34,13,21,47,11,36,27,3,6,0,0,0,1,0,0,0,1
S01013041,Occupancy rating 0,70,23,6,17,41,0,25,4,18,3,16,8,8,6,2,1,0,3
S01013041,Occupancy rating -1 or less,25,6,2,4,12,2,7,0,5,2,3,3,0,7,4,0,0,3
S01013042,All households,318,76,31,45,217,13,168,68,70,30,36,24,12,25,11,0,0,14
S01013042,Occupancy rating +2 or more,154,37,16,21,107,8,94,47,37,10,5,4,1,10,4,0,0,6
S01013042,Occupancy rating +1,83,19,9,10,62,2,48,19,14,15,12,8,4,2,0,0,0,2
S01013042,Occupancy rating 0,61,17,4,13,37,2,22,2,15,5,13,10,3,7,4,0,0,3
S01013042,Occupancy rating -1 or less,20,3,2,1,11,1,4,0,4,0,6,2,4,6,3,0,0,3
S01013043,All households,278,82,37,45,178,13,118,35,55,28,47,25,22,18,9,0,1,8
S01013043,Occupancy rating +2 or more,77,35,18,17,38,7,28,18,6,4,3,0,3,4,2,0,0,2
S01013043,Occupancy rating +1,98,34,16,18,60,6,38,15,13,10,16,7,9,4,2,0,1,1
S01013043,Occupancy rating 0,71,11,3,8,57,0,38,2,26,10,19,11,8,3,2,0,0,1
S01013043,Occupancy rating -1 or less,32,2,0,2,23,0,14,0,10,4,9,7,2,7,3,0,0,4
S01013044,All households,323,73,32,41,231,27,143,52,54,37,61,42,19,19,10,1,1,7
S01013044,Occupancy rating +2 or more,129,48,23,25,80,20,56,41,7,8,4,3,1,1,0,0,0,1
S01013044,Occupancy rating +1,91,17,5,12,70,4,46,11,20,15,20,12,8,4,0,1,0,3
S01013044,Occupancy rating 0,84,7,3,4,67,3,36,0,23,13,28,20,8,10,6,0,1,3
S01013044,Occupancy rating -1 or less,19,1,1,0,14,0,5,0,4,1,9,7,2,4,4,0,0,0
S01013045,All households,277,77,30,47,182,12,144,41,73,30,26,20,6,18,10,0,1,7
S01013045,Occupancy rating +2 or more,145,41,17,24,101,8,86,34,40,12,7,7,0,3,1,0,0,2
S01013045,Occupancy rating +1,68,19,4,15,43,2,34,5,18,11,7,3,4,6,2,0,1,3
S01013045,Occupancy rating 0,42,11,5,6,27,2,16,2,9,5,9,7,2,4,3,0,0,1
S01013045,Occupancy rating -1 or less,22,6,4,2,11,0,8,0,6,2,3,3,0,5,4,0,0,1
S01013046,All households,214,60,30,30,138,13,90,42,26,22,35,25,10,16,6,0,0,10
S01013046,Occupancy rating +2 or more,78,27,14,13,45,7,32,25,4,3,6,4,2,6,1,0,0,5
S01013046,Occupancy rating +1,66,23,10,13,39,5,27,14,4,9,7,3,4,4,2,0,0,2
S01013046,Occupancy rating 0,51,8,6,2,40,1,22,3,12,7,17,15,2,3,1,0,0,2
S01013046,Occupancy rating -1 or less,19,2,0,2,14,0,9,0,6,3,5,3,2,3,2,0,0,1
S01013047,All households,350,70,21,49,264,12,239,85,134,20,13,10,3,16,1,0,0,15
S01013047,Occupancy rating +2 or more,199,33,11,22,163,10,148,59,76,13,5,4,1,3,0,0,0,3
S01013047,Occupancy rating +1,109,31,8,23,73,2,68,24,39,5,3,2,1,5,1,0,0,4
S01013047,Occupancy rating 0,35,4,1,3,25,0,20,2,16,2,5,4,1,6,0,0,0,6
S01013047,Occupancy rating -1 or less,7,2,1,1,3,0,3,0,3,0,0,0,0,2,0,0,0,2
S01013048,All households,401,172,32,140,213,22,171,96,55,20,20,14,6,16,7,2,0,7
S01013048,Occupancy rating +2 or more,117,26,7,19,87,10,74,36,29,9,3,2,1,4,2,0,0,2
S01013048,Occupancy rating +1,139,60,13,47,76,11,58,37,13,8,7,6,1,3,0,1,0,2
S01013048,Occupancy rating 0,115,69,11,58,43,1,33,19,12,2,9,5,4,3,1,1,0,1
S01013048,Occupancy rating -1 or less,30,17,1,16,7,0,6,4,1,1,1,1,0,6,4,0,0,2
S01013049,All households,354,109,37,72,229,38,171,77,60,34,20,12,8,16,7,1,0,8
S01013049,Occupancy rating +2 or more,182,32,21,11,147,35,106,54,35,17,6,2,4,3,3,0,0,0
S01013049,Occupancy rating +1,106,56,12,44,49,1,38,20,12,6,10,7,3,1,1,0,0,0
S01013049,Occupancy rating 0,49,20,4,16,23,2,20,2,9,9,1,1,0,6,0,0,0,6
S01013049,Occupancy rating -1 or less,17,1,0,1,10,0,7,1,4,2,3,2,1,6,3,1,0,2
S01013050,All households,351,139,46,93,201,24,134,57,41,36,43,21,22,11,4,0,0,7
S01013050,Occupancy rating +2 or more,103,33,16,17,70,14,52,34,6,12,4,0,4,0,0,0,0,0
S01013050,Occupancy rating +1,90,33,13,20,57,4,40,12,16,12,13,5,8,0,0,0,0,0
S01013050,Occupancy rating 0,127,66,15,51,55,4,34,11,13,10,17,12,5,6,4,0,0,2
S01013050,Occupancy rating -1 or less,31,7,2,5,19,2,8,0,6,2,9,4,5,5,0,0,0,5
S01013051,All households,422,129,67,62,278,32,159,62,62,35,87,47,40,15,5,0,2,8
S01013051,Occupancy rating +2 or more,113,36,23,13,75,14,56,31,14,11,5,3,2,2,1,0,0,1
S01013051,Occupancy rating +1,150,63,29,34,84,9,53,28,12,13,22,10,12,3,0,0,1,2
S01013051,Occupancy rating 0,131,27,14,13,99,6,41,3,31,7,52,29,23,5,2,0,1,2
S01013051,Occupancy rating -1 or less,28,3,1,2,20,3,9,0,5,4,8,5,3,5,2,0,0,3
S01013052,All households,391,173,95,78,206,36,116,54,45,17,54,33,21,12,2,0,0,10
S01013052,Occupancy rating +2 or more,99,44,27,17,55,13,38,29,7,2,4,3,1,0,0,0,0,0
S01013052,Occupancy rating +1,158,76,33,43,80,18,47,23,20,4,15,8,7,2,1,0,0,1
S01013052,Occupancy rating 0,88,27,14,13,53,2,24,0,15,9,27,17,10,8,0,0,0,8
S01013052,Occupancy rating -1 or less,46,26,21,5,18,3,7,2,3,2,8,5,3,2,1,0,0,1
S01013053,All households,337,167,62,105,147,20,77,29,36,12,50,33,17,23,4,0,0,19
S01013053,Occupancy rating +2 or more,44,19,5,14,24,6,17,8,7,2,1,1,0,1,0,0,0,1
S01013053,Occupancy rating +1,106,58,27,31,44,10,25,13,8,4,9,5,4,4,1,0,0,3
S01013053,Occupancy rating 0,136,68,19,49,59,4,25,6,14,5,30,20,10,9,0,0,0,9
S01013053,Occupancy rating -1 or less,51,22,11,11,20,0,10,2,7,1,10,7,3,9,3,0,0,6
S01013054,All households,305,97,54,43,192,32,131,58,46,27,29,11,18,16,3,0,1,12
S01013054,Occupancy rating +2 or more,131,40,26,14,87,24,54,35,12,7,9,3,6,4,1,0,0,3
S01013054,Occupancy rating +1,98,45,20,25,49,7,34,16,6,12,8,2,6,4,1,0,0,3
S01013054,Occupancy rating 0,57,8,5,3,44,1,36,6,23,7,7,4,3,5,1,0,1,3
S01013054,Occupancy rating -1 or less,19,4,3,1,12,0,7,1,5,1,5,2,3,3,0,0,0,3
S01013055,All households,336,137,68,69,173,20,109,43,45,21,44,22,22,26,6,3,1,16
S01013055,Occupancy rating +2 or more,94,41,26,15,47,11,33,19,11,3,3,1,2,6,0,1,1,4
S01013055,Occupancy rating +1,132,70,33,37,54,8,37,21,10,6,9,2,7,8,1,0,0,7
S01013055,Occupancy rating 0,86,19,6,13,59,1,33,1,22,10,25,15,10,8,1,2,0,5
S01013055,Occupancy rating -1 or less,24,7,3,4,13,0,6,2,2,2,7,4,3,4,4,0,0,0
S01013056,All households,431,161,73,88,249,37,154,61,58,35,58,29,29,21,6,1,0,14
S01013056,Occupancy rating +2 or more,138,64,39,25,70,26,43,29,8,6,1,1,0,4,0,0,0,4
S01013056,Occupancy rating +1,160,71,27,44,85,8,66,30,20,16,11,4,7,4,1,0,0,3
S01013056,Occupancy rating 0,97,24,7,17,65,1,30,2,18,10,34,17,17,8,2,1,0,5
S01013056,Occupancy rating -1 or less,36,2,0,2,29,2,15,0,12,3,12,7,5,5,3,0,0,2
S01013057,All households,369,109,29,80,234,19,110,35,59,16,105,81,24,26,11,0,0,15
S01013057,Occupancy rating +2 or more,93,36,18,18,57,13,37,23,10,4,7,5,2,0,0,0,0,0
S01013057,Occupancy rating +1,109,32,4,28,67,4,29,7,16,6,34,28,6,10,2,0,0,8
S01013057,Occupancy rating 0,131,35,7,28,85,1,33,2,26,5,51,39,12,11,5,0,0,6
S01013057,Occupancy rating -1 or less,36,6,0,6,25,1,11,3,7,1,13,9,4,5,4,0,0,1
S01013058,All households,213,28,6,22,180,2,154,53,89,12,24,20,4,5,2,0,0,3
S01013058,Occupancy rating +2 or more,145,14,5,9,131,2,119,40,70,9,10,9,1,0,0,0,0,0
S01013058,Occupancy rating +1,48,13,1,12,34,0,29,12,16,1,5,4,1,1,0,0,0,1
S01013058,Occupancy rating 0,14,1,0,1,11,0,4,0,3,1,7,6,1,2,1,0,0,1
S01013058,Occupancy rating -1 or less,6,0,0,0,4,0,2,1,0,1,2,1,1,2,1,0,0,1
S01013059,All households,406,177,105,72,213,61,132,67,49,16,20,8,12,16,2,2,2,10
S01013059,Occupancy rating +2 or more,227,71,43,28,152,50,92,49,32,11,10,3,7,4,2,0,0,2
S01013059,Occupancy rating +1,90,52,30,22,31,9,19,8,8,3,3,1,2,7,0,1,2,4
S01013059,Occupancy rating 0,73,43,30,13,26,2,18,7,9,2,6,4,2,4,0,1,0,3
S01013059,Occupancy rating -1 or less,16,11,2,9,4,0,3,3,0,0,1,0,1,1,0,0,0,1
S01013060,All households,227,75,31,44,142,21,109,54,41,14,12,7,5,10,1,1,1,7
S01013060,Occupancy rating +2 or more,142,36,22,14,104,18,85,40,32,13,1,1,0,2,0,0,1,1
S01013060,Occupancy rating +1,38,15,7,8,21,3,14,9,4,1,4,1,3,2,0,0,0,2
S01013060,Occupancy rating 0,44,23,2,21,15,0,9,5,4,0,6,4,2,6,1,1,0,4
S01013060,Occupancy rating -1 or less,3,1,0,1,2,0,1,0,1,0,1,1,0,0,0,0,0,0
S01013061,All households,362,98,59,39,253,71,169,84,65,20,13,6,7,11,3,3,0,5
S01013061,Occupancy rating +2 or more,303,85,53,32,212,64,144,78,50,16,4,2,2,6,3,2,0,1
S01013061,Occupancy rating +1,44,11,4,7,33,6,22,5,13,4,5,2,3,0,0,0,0,0
S01013061,Occupancy rating 0,12,2,2,0,6,1,3,1,2,0,2,1,1,4,0,1,0,3
S01013061,Occupancy rating -1 or less,3,0,0,0,2,0,0,0,0,0,2,1,1,1,0,0,0,1
S01013062,All households,403,159,87,72,229,50,165,76,70,19,14,10,4,15,2,8,1,4
S01013062,Occupancy rating +2 or more,235,66,35,31,165,36,122,60,51,11,7,5,2,4,1,1,1,1
S01013062,Occupancy rating +1,121,73,46,27,44,13,31,14,12,5,0,0,0,4,0,2,0,2
S01013062,Occupancy rating 0,37,17,5,12,14,0,10,1,6,3,4,3,1,6,1,5,0,0
S01013062,Occupancy rating -1 or less,10,3,1,2,6,1,2,1,1,0,3,2,1,1,0,0,0,1
S01013063,All households,371,138,76,62,205,42,149,68,67,14,14,9,5,28,6,9,0,13
S01013063,Occupancy rating +2 or more,248,65,39,26,172,40,127,59,56,12,5,2,3,11,6,0,0,5
S01013063,Occupancy rating +1,58,34,10,24,17,1,13,8,4,1,3,3,0,7,0,3,0,4
S01013063,Occupancy rating 0,53,34,23,11,12,1,5,0,5,0,6,4,2,7,0,5,0,2
S01013063,Occupancy rating -1 or less,12,5,4,1,4,0,4,1,2,1,0,0,0,3,0,1,0,2
S01013064,All households,386,122,72,50,255,48,161,57,73,31,46,22,24,9,4,0,0,5
S01013064,Occupancy rating +2 or more,136,48,30,18,87,28,56,37,17,2,3,2,1,1,0,0,0,1
S01013064,Occupancy rating +1,122,23,14,9,96,9,60,14,32,14,27,15,12,3,0,0,0,3
S01013064,Occupancy rating 0,103,47,26,21,54,10,33,6,16,11,11,3,8,2,2,0,0,0
S01013064,Occupancy rating -1 or less,25,4,2,2,18,1,12,0,8,4,5,2,3,3,2,0,0,1
S01013065,All households,415,148,53,95,239,36,135,55,55,25,68,34,34,28,3,9,2,14
S01013065,Occupancy rating +2 or more,97,35,16,19,62,19,39,27,7,5,4,2,2,0,0,0,0,0
S01013065,Occupancy rating +1,157,71,35,36,82,15,52,23,20,9,15,5,10,4,1,1,1,1
S01013065,Occupancy rating 0,116,32,1,31,68,1,32,4,21,7,35,20,15,16,1,5,1,9
S01013065,Occupancy rating -1 or less,45,10,1,9,27,1,12,1,7,4,14,7,7,8,1,3,0,4
S01013066,All households,347,150,32,118,180,20,130,59,53,18,30,19,11,17,7,5,1,4
S01013066,Occupancy rating +2 or more,135,46,14,32,87,18,63,42,14,7,6,3,3,2,1,0,0,1
S01013066,Occupancy rating +1,90,34,10,24,52,1,42,10,25,7,9,5,4,4,2,2,0,0
S01013066,Occupancy rating 0,85,47,8,39,32,1,20,7,10,3,11,8,3,6,2,1,0,3
S01013066,Occupancy rating -1 or less,37,23,0,23,9,0,5,0,4,1,4,3,1,5,2,2,1,0
S01013067,All households,396,143,13,130,95,2,76,54,20,2,17,14,3,158,1,105,0,52
S01013067,Occupancy rating +2 or more,31,15,2,13,11,1,10,9,0,1,0,0,0,5,0,3,0,2
S01013067,Occupancy rating +1,80,44,5,39,22,1,18,17,1,0,3,3,0,14,0,8,0,6
S01013067,Occupancy rating 0,175,63,4,59,39,0,27,17,9,1,12,10,2,73,0,52,0,21
S01013067,Occupancy rating -1 or less,110,21,2,19,23,0,21,11,10,0,2,1,1,66,1,42,0,23
S01013068,All households,406,189,38,151,134,6,75,44,27,4,53,46,7,83,5,41,0,37
S01013068,Occupancy rating +2 or more,48,24,7,17,19,4,14,11,2,1,1,1,0,5,0,1,0,4
S01013068,Occupancy rating +1,90,42,9,33,40,2,27,14,10,3,11,9,2,8,1,2,0,5
S01013068,Occupancy rating 0,181,92,15,77,52,0,23,15,8,0,29,24,5,37,1,20,0,16
S01013068,Occupancy rating -1 or less,87,31,7,24,23,0,11,4,7,0,12,12,0,33,3,18,0,12
S01013069,All households,350,131,15,116,102,4,76,41,29,6,22,16,6,117,7,77,0,33
S01013069,Occupancy rating +2 or more,51,14,6,8,23,3,19,9,7,3,1,0,1,14,2,5,0,7
S01013069,Occupancy rating +1,66,39,4,35,20,1,16,10,6,0,3,0,3,7,0,5,0,2
S01013069,Occupancy rating 0,147,59,4,55,33,0,26,16,7,3,7,6,1,55,3,40,0,12
S01013069,Occupancy rating -1 or less,86,19,1,18,26,0,15,6,9,0,11,10,1,41,2,27,0,12
S01013070,All households,301,131,22,109,107,4,70,44,22,4,33,26,7,63,2,36,2,23
S01013070,Occupancy rating +2 or more,37,21,8,13,15,2,12,10,2,0,1,1,0,1,0,1,0,0
S01013070,Occupancy rating +1,76,34,5,29,32,2,22,18,1,3,8,4,4,10,0,4,1,5
S01013070,Occupancy rating 0,109,43,8,35,41,0,25,12,12,1,16,13,3,25,1,14,1,9
S01013070,Occupancy rating -1 or less,79,33,1,32,19,0,11,4,7,0,8,8,0,27,1,17,0,9
S01013071,All households,359,115,12,103,87,2,70,51,13,6,15,10,5,157,4,105,1,47
S01013071,Occupancy rating +2 or more,29,12,4,8,15,0,13,9,1,3,2,1,1,2,1,1,0,0
S01013071,Occupancy rating +1,100,57,4,53,29,1,28,25,2,1,0,0,0,14,0,9,0,5
S01013071,Occupancy rating 0,150,31,2,29,31,1,21,13,6,2,9,5,4,88,1,60,0,27
S01013071,Occupancy rating -1 or less,80,15,2,13,12,0,8,4,4,0,4,4,0,53,2,35,1,15
S01013072,All households,227,75,34,41,137,8,90,30,35,25,39,27,12,15,6,0,0,9
S01013072,Occupancy rating +2 or more,51,23,13,10,28,4,22,17,2,3,2,1,1,0,0,0,0,0
S01013072,Occupancy rating +1,86,31,12,19,52,2,35,9,13,13,15,11,4,3,0,0,0,3
S01013072,Occupancy rating 0,66,16,6,10,44,1,26,3,16,7,17,11,6,6,2,0,0,4
S01013072,Occupancy rating -1 or less,24,5,3,2,13,1,7,1,4,2,5,4,1,6,4,0,0,2
S01013073,All households,352,119,21,98,196,6,111,59,41,11,79,57,22,37,11,10,1,15
S01013073,Occupancy rating +2 or more,59,23,4,19,35,2,25,19,6,0,8,7,1,1,1,0,0,0
S01013073,Occupancy rating +1,135,61,8,53,69,2,48,33,13,2,19,13,6,5,1,1,0,3
S01013073,Occupancy rating 0,120,23,7,16,78,2,36,7,21,8,40,30,10,19,2,6,1,10
S01013073,Occupancy rating -1 or less,38,12,2,10,14,0,2,0,1,1,12,7,5,12,7,3,0,2
S01013074,All households,302,117,35,82,158,4,88,27,44,17,66,52,14,27,9,4,1,13
S01013074,Occupancy rating +2 or more,53,26,3,23,23,0,19,9,6,4,4,1,3,4,2,0,0,2
S01013074,Occupancy rating +1,109,55,24,31,52,2,32,14,14,4,18,15,3,2,1,0,0,1
S01013074,Occupancy rating 0,91,28,4,24,50,0,22,2,14,6,28,24,4,13,2,3,1,7
S01013074,Occupancy rating -1 or less,49,8,4,4,33,2,15,2,10,3,16,12,4,8,4,1,0,3
S01013075,All households,481,270,108,162,178,27,93,35,34,24,58,32,26,33,10,6,1,16
S01013075,Occupancy rating +2 or more,68,31,12,19,34,5,20,6,6,8,9,5,4,3,1,0,0,2
S01013075,Occupancy rating +1,137,84,32,52,47,12,27,18,6,3,8,3,5,6,0,3,0,3
S01013075,Occupancy rating 0,200,130,53,77,59,7,30,9,13,8,22,13,9,11,1,3,0,7
S01013075,Occupancy rating -1 or less,76,25,11,14,38,3,16,2,9,5,19,11,8,13,8,0,1,4
S01013076,All households,172,35,10,25,108,6,84,25,50,9,18,7,11,29,5,13,0,11
S01013076,Occupancy rating +2 or more,97,20,9,11,68,6,55,18,31,6,7,5,2,9,2,3,0,4
S01013076,Occupancy rating +1,31,9,0,9,18,0,15,5,10,0,3,0,3,4,0,1,0,3
S01013076,Occupancy rating 0,35,6,1,5,19,0,12,1,8,3,7,2,5,10,2,7,0,1
S01013076,Occupancy rating -1 or less,9,0,0,0,3,0,2,1,1,0,1,0,1,6,1,2,0,3
S01013077,All households,297,83,34,49,186,24,98,34,46,18,64,41,23,28,13,1,1,13
S01013077,Occupancy rating +2 or more,94,42,20,22,51,18,30,17,8,5,3,1,2,1,0,0,0,1
S01013077,Occupancy rating +1,89,27,9,18,57,5,37,14,14,9,15,6,9,5,1,0,1,3
S01013077,Occupancy rating 0,76,8,2,6,58,0,23,2,17,4,35,25,10,10,4,0,0,6
S01013077,Occupancy rating -1 or less,38,6,3,3,20,1,8,1,7,0,11,9,2,12,8,1,0,3
S01013078,All households,252,90,14,76,149,7,85,31,41,13,57,40,17,13,7,1,0,5
S01013078,Occupancy rating +2 or more,71,20,4,16,47,6,29,19,9,1,12,8,4,4,1,1,0,2
S01013078,Occupancy rating +1,84,36,7,29,45,1,26,6,13,7,18,11,7,3,1,0,0,2
S01013078,Occupancy rating 0,73,27,3,24,43,0,22,4,14,4,21,15,6,3,3,0,0,0
S01013078,Occupancy rating -1 or less,24,7,0,7,14,0,8,2,5,1,6,6,0,3,2,0,0,1
S01013079,All households,376,69,14,55,272,14,223,66,131,26,35,24,11,35,14,6,0,15
S01013079,Occupancy rating +2 or more,258,46,7,39,203,10,178,58,98,22,15,10,5,9,3,2,0,4
S01013079,Occupancy rating +1,56,17,5,12,30,4,20,8,10,2,6,3,3,9,4,0,0,5
S01013079,Occupancy rating 0,49,5,1,4,30,0,19,0,18,1,11,8,3,14,4,4,0,6
S01013079,Occupancy rating -1 or less,13,1,1,0,9,0,6,0,5,1,3,3,0,3,3,0,0,0
S01013080,All households,374,116,68,48,208,37,151,60,66,25,20,12,8,50,5,23,1,21
S01013080,Occupancy rating +2 or more,182,40,23,17,130,21,100,47,40,13,9,5,4,12,3,1,0,8
S01013080,Occupancy rating +1,86,33,13,20,45,6,36,9,19,8,3,2,1,8,0,4,0,4
S01013080,Occupancy rating 0,87,36,32,4,25,7,11,3,5,3,7,4,3,26,2,16,1,7
S01013080,Occupancy rating -1 or less,19,7,0,7,8,3,4,1,2,1,1,1,0,4,0,2,0,2
S01013081,All households,280,66,37,29,200,36,151,73,56,22,13,5,8,14,4,2,0,8
S01013081,Occupancy rating +2 or more,208,47,29,18,155,31,120,68,38,14,4,2,2,6,2,1,0,3
S01013081,Occupancy rating +1,40,16,7,9,20,3,13,2,9,2,4,1,3,4,1,0,0,3
S01013081,Occupancy rating 0,23,3,1,2,20,2,13,1,8,4,5,2,3,0,0,0,0,0
S01013081,Occupancy rating -1 or less,9,0,0,0,5,0,5,2,1,2,0,0,0,4,1,1,0,2
S01013082,All households,395,137,72,65,245,38,194,95,63,36,13,6,7,13,4,2,0,7
S01013082,Occupancy rating +2 or more,245,84,48,36,157,28,127,78,26,23,2,1,1,4,1,0,0,3
S01013082,Occupancy rating +1,111,50,23,27,59,7,47,17,23,7,5,2,3,2,0,1,0,1
S01013082,Occupancy rating 0,31,3,1,2,23,3,14,0,10,4,6,3,3,5,1,1,0,3
S01013082,Occupancy rating -1 or less,8,0,0,0,6,0,6,0,4,2,0,0,0,2,2,0,0,0
S01013083,All households,187,38,19,19,141,23,108,31,51,26,10,6,4,8,1,2,0,5
S01013083,Occupancy rating +2 or more,137,32,15,17,104,22,79,28,36,15,3,1,2,1,0,0,0,1
S01013083,Occupancy rating +1,32,4,3,1,25,1,19,3,8,8,5,3,2,3,1,0,0,2
S01013083,Occupancy rating 0,14,2,1,1,11,0,9,0,7,2,2,2,0,1,0,0,0,1
S01013083,Occupancy rating -1 or less,4,0,0,0,1,0,1,0,0,1,0,0,0,3,0,2,0,1
S01013084,All households,307,55,41,14,244,56,168,64,69,35,20,13,7,8,1,1,1,5
S01013084,Occupancy rating +2 or more,252,48,34,14,201,53,134,64,44,26,14,9,5,3,1,0,1,1
S01013084,Occupancy rating +1,37,6,6,0,28,2,20,0,15,5,6,4,2,3,0,0,0,3
S01013084,Occupancy rating 0,16,1,1,0,14,1,13,0,10,3,0,0,0,1,0,0,0,1
S01013084,Occupancy rating -1 or less,2,0,0,0,1,0,1,0,0,1,0,0,0,1,0,1,0,0
S01013085,All households,259,125,93,32,120,19,78,23,40,15,23,17,6,14,5,1,0,8
S01013085,Occupancy rating +2 or more,85,32,20,12,52,15,32,15,15,2,5,3,2,1,0,0,0,1
S01013085,Occupancy rating +1,66,29,18,11,32,3,24,7,11,6,5,3,2,5,2,0,0,3
S01013085,Occupancy rating 0,64,34,26,8,27,1,17,1,9,7,9,7,2,3,1,0,0,2
S01013085,Occupancy rating -1 or less,44,30,29,1,9,0,5,0,5,0,4,4,0,5,2,1,0,2
S01013086,All households,448,201,63,138,206,27,149,85,49,15,30,17,13,41,4,15,1,21
S01013086,Occupancy rating +2 or more,184,60,30,30,117,23,87,51,25,11,7,5,2,7,1,0,1,5
S01013086,Occupancy rating +1,118,66,18,48,44,3,35,25,8,2,6,2,4,8,1,3,0,4
S01013086,Occupancy rating 0,104,51,11,40,34,1,21,8,11,2,12,7,5,19,1,9,0,9
S01013086,Occupancy rating -1 or less,42,24,4,20,11,0,6,1,5,0,5,3,2,7,1,3,0,3
S01013087,All households,327,89,35,54,220,40,168,71,81,16,12,10,2,18,5,6,1,6
S01013087,Occupancy rating +2 or more,232,53,27,26,171,38,128,59,55,14,5,4,1,8,5,1,1,1
S01013087,Occupancy rating +1,59,25,7,18,31,2,24,7,16,1,5,4,1,3,0,2,0,1
S01013087,Occupancy rating 0,29,9,1,8,14,0,12,4,7,1,2,2,0,6,0,3,0,3
S01013087,Occupancy rating -1 or less,7,2,0,2,4,0,4,1,3,0,0,0,0,1,0,0,0,1
S01013088,All households,388,80,43,37,299,70,213,92,92,29,16,6,10,9,2,1,2,4
S01013088,Occupancy rating +2 or more,325,50,31,19,268,68,188,84,79,25,12,4,8,7,2,0,2,3
S01013088,Occupancy rating +1,49,24,8,16,24,1,21,8,9,4,2,2,0,1,0,0,0,1
S01013088,Occupancy rating 0,11,5,4,1,5,1,3,0,3,0,1,0,1,1,0,1,0,0
S01013088,Occupancy rating -1 or less,3,1,0,1,2,0,1,0,1,0,1,0,1,0,0,0,0,0
S01013089,All households,359,121,66,55,206,33,139,66,51,22,34,18,16,32,3,12,2,15
S01013089,Occupancy rating +2 or more,132,44,29,15,85,21,59,39,16,4,5,3,2,3,0,0,1,2
S01013089,Occupancy rating +1,113,54,28,26,55,8,40,19,13,8,7,2,5,4,0,1,1,2
S01013089,Occupancy rating 0,94,19,8,11,57,3,35,6,21,8,19,10,9,18,2,8,0,8
S01013089,Occupancy rating -1 or less,20,4,1,3,9,1,5,2,1,2,3,3,0,7,1,3,0,3
S01013090,All households,349,92,24,68,173,16,138,78,51,9,19,11,8,84,1,43,1,39
S01013090,Occupancy rating +2 or more,112,30,10,20,77,7,68,36,28,4,2,0,2,5,0,1,0,4
S01013090,Occupancy rating +1,105,45,11,34,47,4,41,33,6,2,2,2,0,13,0,3,0,10
S01013090,Occupancy rating 0,97,12,2,10,41,3,24,6,16,2,14,9,5,44,0,23,1,20
S01013090,Occupancy rating -1 or less,35,5,1,4,8,2,5,3,1,1,1,0,1,22,1,16,0,5
S01013091,All households,254,108,14,94,90,2,73,56,13,4,15,11,4,56,5,33,1,17
S01013091,Occupancy rating +2 or more,21,8,2,6,10,1,9,7,0,2,0,0,0,3,1,0,0,2
S01013091,Occupancy rating +1,61,34,5,29,23,1,20,19,1,0,2,1,1,4,0,3,0,1
S01013091,Occupancy rating 0,120,53,6,47,42,0,33,24,9,0,9,7,2,25,1,16,1,7
S01013091,Occupancy rating -1 or less,52,13,1,12,15,0,11,6,3,2,4,3,1,24,3,14,0,7
S01013092,All households,440,179,56,123,227,19,166,85,69,12,42,31,11,34,7,16,0,11
S01013092,Occupancy rating +2 or more,114,38,17,21,76,11,61,32,25,4,4,3,1,0,0,0,0,0
S01013092,Occupancy rating +1,168,82,24,58,83,7,64,45,16,3,12,7,5,3,1,0,0,2
S01013092,Occupancy rating 0,126,56,14,42,52,0,28,5,19,4,24,19,5,18,0,11,0,7
S01013092,Occupancy rating -1 or less,32,3,1,2,16,1,13,3,9,1,2,2,0,13,6,5,0,2
S01013093,All households,223,71,30,41,149,40,97,50,32,15,12,7,5,3,1,0,0,2
S01013093,Occupancy rating +2 or more,165,45,21,24,118,37,75,40,23,12,6,3,3,2,1,0,0,1
S01013093,Occupancy rating +1,41,20,9,11,20,3,16,10,5,1,1,1,0,1,0,0,0,1
S01013093,Occupancy rating 0,14,5,0,5,9,0,4,0,3,1,5,3,2,0,0,0,0,0
S01013093,Occupancy rating -1 or less,3,1,0,1,2,0,2,0,1,1,0,0,0,0,0,0,0,0
S01013094,All households,230,38,22,16,187,42,135,47,68,20,10,7,3,5,4,0,0,1
S01013094,Occupancy rating +2 or more,198,31,17,14,163,41,114,45,54,15,8,5,3,4,3,0,0,1
S01013094,Occupancy rating +1,25,6,5,1,18,1,16,2,9,5,1,1,0,1,1,0,0,0
S01013094,Occupancy rating 0,5,0,0,0,5,0,4,0,4,0,1,1,0,0,0,0,0,0
S01013094,Occupancy rating -1 or less,2,1,0,1,1,0,1,0,1,0,0,0,0,0,0,0,0,0
S01013095,All households,282,16,6,10,260,26,224,65,138,21,10,7,3,6,5,1,0,0
S01013095,Occupancy rating +2 or more,266,12,5,7,249,26,214,64,130,20,9,7,2,5,5,0,0,0
S01013095,Occupancy rating +1,10,2,1,1,8,0,7,1,5,1,1,0,1,0,0,0,0,0
S01013095,Occupancy rating 0,5,2,0,2,2,0,2,0,2,0,0,0,0,1,0,1,0,0
S01013095,Occupancy rating -1 or less,1,0,0,0,1,0,1,0,1,0,0,0,0,0,0,0,0,0
S01013096,All households,213,72,33,39,127,12,86,39,39,8,29,19,10,14,3,1,1,9
S01013096,Occupancy rating +2 or more,69,23,11,12,44,6,35,23,11,1,3,1,2,2,1,0,1,0
S01013096,Occupancy rating +1,66,21,8,13,44,4,31,11,17,3,9,6,3,1,0,0,0,1
S01013096,Occupancy rating 0,63,24,13,11,29,2,15,4,9,2,12,11,1,10,2,0,0,8
S01013096,Occupancy rating -1 or less,15,4,1,3,10,0,5,1,2,2,5,1,4,1,0,1,0,0
S01013097,All households,248,52,16,36,182,18,152,66,68,18,12,7,5,14,3,1,0,10
S01013097,Occupancy rating +2 or more,163,27,7,20,128,16,110,48,48,14,2,1,1,8,2,0,0,6
S01013097,Occupancy rating +1,60,18,8,10,39,2,28,14,12,2,9,6,3,3,1,0,0,2
S01013097,Occupancy rating 0,23,6,1,5,14,0,13,4,7,2,1,0,1,3,0,1,0,2
S01013097,Occupancy rating -1 or less,2,1,0,1,1,0,1,0,1,0,0,0,0,0,0,0,0,0
S01013098,All households,189,8,2,6,176,6,166,15,143,8,4,3,1,5,5,0,0,0
S01013098,Occupancy rating +2 or more,177,8,2,6,164,6,154,13,134,7,4,3,1,5,5,0,0,0
S01013098,Occupancy rating +1,4,0,0,0,4,0,4,1,3,0,0,0,0,0,0,0,0,0
S01013098,Occupancy rating 0,6,0,0,0,6,0,6,1,5,0,0,0,0,0,0,0,0,0
S01013098,Occupancy rating -1 or less,2,0,0,0,2,0,2,0,1,1,0,0,0,0,0,0,0,0
S01013099,All households,439,184,79,105,242,45,168,87,63,18,29,17,12,13,2,0,1,10
S01013099,Occupancy rating +2 or more,174,44,28,16,128,33,89,48,29,12,6,2,4,2,1,0,0,1
S01013099,Occupancy rating +1,149,86,38,48,61,11,44,26,12,6,6,4,2,2,0,0,0,2
S01013099,Occupancy rating 0,84,37,9,28,43,1,29,10,19,0,13,8,5,4,1,0,1,2
S01013099,Occupancy rating -1 or less,32,17,4,13,10,0,6,3,3,0,4,3,1,5,0,0,0,5
S01013100,All households,265,71,45,26,189,61,122,52,64,6,6,3,3,5,3,0,0,2
S01013100,Occupancy rating +2 or more,219,46,32,14,169,58,106,48,53,5,5,2,3,4,2,0,0,2
S01013100,Occupancy rating +1,32,20,13,7,11,2,9,2,6,1,0,0,0,1,1,0,0,0
S01013100,Occupancy rating 0,13,4,0,4,9,1,7,2,5,0,1,1,0,0,0,0,0,0
S01013100,Occupancy rating -1 or less,1,1,0,1,0,0,0,0,0,0,0,0,0,0,0,0,0,0
S01013101,All households,502,213,102,111,277,39,170,79,69,22,68,38,30,12,4,1,1,6
S01013101,Occupancy rating +2 or more,133,33,22,11,99,23,63,37,15,11,13,6,7,1,0,0,0,1
S01013101,Occupancy rating +1,161,76,39,37,82,10,52,34,15,3,20,11,9,3,0,0,1,2
S01013101,Occupancy rating 0,162,86,34,52,73,6,42,8,28,6,25,16,9,3,2,0,0,1
S01013101,Occupancy rating -1 or less,46,18,7,11,23,0,13,0,11,2,10,5,5,5,2,1,0,2
S01013102,All households,291,116,87,29,170,36,121,54,51,16,13,9,4,5,1,0,0,4
S01013102,Occupancy rating +2 or more,167,40,26,14,124,25,94,47,36,11,5,3,2,3,1,0,0,2
S01013102,Occupancy rating +1,47,23,18,5,23,4,18,3,13,2,1,1,0,1,0,0,0,1
S01013102,Occupancy rating 0,71,52,42,10,18,7,7,4,1,2,4,3,1,1,0,0,0,1
S01013102,Occupancy rating -1 or less,6,1,1,0,5,0,2,0,1,1,3,2,1,0,0,0,0,0
S01013103,All households,289,31,19,12,254,24,206,50,130,26,24,15,9,4,2,0,1,1
S01013103,Occupancy rating +2 or more,249,26,17,9,220,24,179,50,106,23,17,11,6,3,1,0,1,1
S01013103,Occupancy rating +1,23,3,1,2,19,0,15,0,14,1,4,2,2,1,1,0,0,0
S01013103,Occupancy rating 0,12,2,1,1,10,0,9,0,8,1,1,1,0,0,0,0,0,0
S01013103,Occupancy rating -1 or less,5,0,0,0,5,0,3,0,2,1,2,1,1,0,0,0,0,0
S01013104,All households,404,100,63,37,293,53,214,81,92,41,26,17,9,11,4,0,0,7
S01013104,Occupancy rating +2 or more,291,61,40,21,224,47,165,69,66,30,12,7,5,6,2,0,0,4
S01013104,Occupancy rating +1,68,27,17,10,38,5,27,10,13,4,6,5,1,3,1,0,0,2
S01013104,Occupancy rating 0,38,12,6,6,25,1,19,2,11,6,5,3,2,1,0,0,0,1
S01013104,Occupancy rating -1 or less,7,0,0,0,6,0,3,0,2,1,3,2,1,1,1,0,0,0
S01013105,All households,387,115,55,60,260,48,198,80,96,22,14,6,8,12,4,0,1,7
S01013105,Occupancy rating +2 or more,255,47,28,19,203,39,155,64,74,17,9,3,6,5,4,0,0,1
S01013105,Occupancy rating +1,78,45,21,24,31,6,23,13,7,3,2,1,1,2,0,0,0,2
S01013105,Occupancy rating 0,47,20,5,15,24,2,19,3,15,1,3,2,1,3,0,0,0,3
S01013105,Occupancy rating -1 or less,7,3,1,2,2,1,1,0,0,1,0,0,0,2,0,0,1,1
S01013106,All households,350,112,50,62,226,42,146,48,69,29,38,24,14,12,7,0,0,5
S01013106,Occupancy rating +2 or more,165,46,25,21,117,28,82,35,36,11,7,4,3,2,0,0,0,2
S01013106,Occupancy rating +1,88,36,19,17,52,11,34,7,16,11,7,3,4,0,0,0,0,0
S01013106,Occupancy rating 0,67,24,5,19,40,1,21,4,12,5,18,12,6,3,1,0,0,2
S01013106,Occupancy rating -1 or less,30,6,1,5,17,2,9,2,5,2,6,5,1,7,6,0,0,1
S01013107,All households,275,51,25,26,221,52,158,77,57,24,11,6,5,3,1,0,0,2
S01013107,Occupancy rating +2 or more,231,39,18,21,189,49,133,65,51,17,7,3,4,3,1,0,0,2
S01013107,Occupancy rating +1,33,9,6,3,24,2,19,10,4,5,3,2,1,0,0,0,0,0
S01013107,Occupancy rating 0,9,3,1,2,6,1,5,2,1,2,0,0,0,0,0,0,0,0
S01013107,Occupancy rating -1 or less,2,0,0,0,2,0,1,0,1,0,1,1,0,0,0,0,0,0
S01013108,All households,255,74,31,43,172,25,125,52,54,19,22,11,11,9,4,0,1,4
S01013108,Occupancy rating +2 or more,144,34,17,17,107,23,80,39,30,11,4,0,4,3,0,0,1,2
S01013108,Occupancy rating +1,45,22,8,14,21,0,18,10,5,3,3,1,2,2,2,0,0,0
S01013108,Occupancy rating 0,56,18,6,12,34,2,19,3,11,5,13,9,4,4,2,0,0,2
S01013108,Occupancy rating -1 or less,10,0,0,0,10,0,8,0,8,0,2,1,1,0,0,0,0,0
S01013109,All households,412,100,48,52,287,32,230,96,103,31,25,16,9,25,9,0,3,13
S01013109,Occupancy rating +2 or more,283,58,32,26,210,28,168,77,71,20,14,8,6,15,6,0,2,7
S01013109,Occupancy rating +1,79,32,13,19,45,3,36,16,14,6,6,4,2,2,1,0,0,1
S01013109,Occupancy rating 0,37,10,3,7,24,0,19,3,12,4,5,4,1,3,0,0,1,2
S01013109,Occupancy rating -1 or less,13,0,0,0,8,1,7,0,6,1,0,0,0,5,2,0,0,3
S01013110,All households,245,64,24,40,167,29,122,48,49,25,16,9,7,14,9,0,0,5
S01013110,Occupancy rating +2 or more,162,35,13,22,118,21,87,40,30,17,10,6,4,9,6,0,0,3
S01013110,Occupancy rating +1,49,17,8,9,31,7,22,8,10,4,2,0,2,1,0,0,0,1
S01013110,Occupancy rating 0,25,10,2,8,13,1,9,0,5,4,3,2,1,2,1,0,0,1
S01013110,Occupancy rating -1 or less,9,2,1,1,5,0,4,0,4,0,1,1,0,2,2,0,0,0
S01013111,All households,192,62,32,30,123,22,92,31,51,10,9,6,3,7,3,0,0,4
S01013111,Occupancy rating +2 or more,131,34,19,15,95,20,71,26,39,6,4,2,2,2,1,0,0,1
S01013111,Occupancy rating +1,33,16,9,7,14,1,13,4,6,3,0,0,0,3,1,0,0,2
S01013111,Occupancy rating 0,24,11,4,7,13,1,7,1,5,1,5,4,1,0,0,0,0,0
S01013111,Occupancy rating -1 or less,4,1,0,1,1,0,1,0,1,0,0,0,0,2,1,0,0,1
S01013112,All households,265,69,27,42,192,21,139,46,78,15,32,28,4,4,1,0,0,3
S01013112,Occupancy rating +2 or more,120,21,7,14,97,15,80,27,45,8,2,2,0,2,0,0,0,2
S01013112,Occupancy rating +1,64,26,13,13,38,4,29,16,11,2,5,5,0,0,0,0,0,0
S01013112,Occupancy rating 0,70,17,5,12,52,2,25,3,18,4,25,21,4,1,1,0,0,0
S01013112,Occupancy rating -1 or less,11,5,2,3,5,0,5,0,4,1,0,0,0,1,0,0,0,1
S01013113,All households,372,122,76,46,238,48,149,62,60,27,41,20,21,12,5,0,1,6
S01013113,Occupancy rating +2 or more,148,44,28,16,101,34,60,39,13,8,7,3,4,3,1,0,1,1
S01013113,Occupancy rating +1,108,40,23,17,64,7,48,15,22,11,9,4,5,4,0,0,0,4
S01013113,Occupancy rating 0,89,32,22,10,55,6,33,7,20,6,16,9,7,2,1,0,0,1
S01013113,Occupancy rating -1 or less,27,6,3,3,18,1,8,1,5,2,9,4,5,3,3,0,0,0
S01013114,All households,337,100,49,51,223,35,165,69,77,19,23,10,13,14,0,0,1,13
S01013114,Occupancy rating +2 or more,196,57,35,22,131,25,101,56,40,5,5,3,2,8,0,0,0,8
S01013114,Occupancy rating +1,71,21,6,15,48,9,32,8,19,5,7,1,6,2,0,0,0,2
S01013114,Occupancy rating 0,55,21,8,13,31,1,25,4,15,6,5,3,2,3,0,0,0,3
S01013114,Occupancy rating -1 or less,15,1,0,1,13,0,7,1,3,3,6,3,3,1,0,0,1,0
S01013115,All households,320,162,78,84,148,32,92,53,29,10,24,9,15,10,2,0,1,7
S01013115,Occupancy rating +2 or more,88,26,16,10,61,21,36,23,10,3,4,2,2,1,0,0,0,1
S01013115,Occupancy rating +1,96,55,25,30,38,2,31,19,10,2,5,1,4,3,1,0,0,2
S01013115,Occupancy rating 0,97,54,20,34,40,8,20,10,7,3,12,3,9,3,0,0,1,2
S01013115,Occupancy rating -1 or less,39,27,17,10,9,1,5,1,2,2,3,3,0,3,1,0,0,2
S01013116,All households,331,92,58,34,224,60,150,73,54,23,14,3,11,15,5,0,3,7
S01013116,Occupancy rating +2 or more,258,67,48,19,182,51,122,68,38,16,9,2,7,9,4,0,2,3
S01013116,Occupancy rating +1,44,14,9,5,28,7,20,5,10,5,1,0,1,2,0,0,1,1
S01013116,Occupancy rating 0,25,10,1,9,12,2,8,0,6,2,2,0,2,3,1,0,0,2
S01013116,Occupancy rating -1 or less,4,1,0,1,2,0,0,0,0,0,2,1,1,1,0,0,0,1
S01013117,All households,271,88,34,54,174,12,127,54,58,15,35,24,11,9,3,2,0,4
S01013117,Occupancy rating +2 or more,96,21,14,7,75,7,64,31,22,11,4,2,2,0,0,0,0,0
S01013117,Occupancy rating +1,80,33,10,23,45,3,35,18,15,2,7,3,4,2,1,0,0,1
S01013117,Occupancy rating 0,69,29,8,21,37,2,20,3,15,2,15,12,3,3,0,1,0,2
S01013117,Occupancy rating -1 or less,26,5,2,3,17,0,8,2,6,0,9,7,2,4,2,1,0,1
S01013118,All households,195,48,20,28,144,26,109,56,36,17,9,5,4,3,1,0,0,2
S01013118,Occupancy rating +2 or more,150,35,15,20,113,23,88,52,24,12,2,1,1,2,0,0,0,2
S01013118,Occupancy rating +1,27,12,5,7,14,1,9,3,4,2,4,3,1,1,1,0,0,0
S01013118,Occupancy rating 0,11,0,0,0,11,2,7,1,5,1,2,1,1,0,0,0,0,0
S01013118,Occupancy rating -1 or less,7,1,0,1,6,0,5,0,3,2,1,0,1,0,0,0,0,0
S01013119,All households,337,93,37,56,225,38,160,87,51,22,27,17,10,19,3,0,3,13
S01013119,Occupancy rating +2 or more,213,53,24,29,151,35,113,74,28,11,3,1,2,9,2,0,2,5
S01013119,Occupancy rating +1,64,23,7,16,39,1,27,9,11,7,11,6,5,2,1,0,1,0
S01013119,Occupancy rating 0,46,15,5,10,25,2,14,3,7,4,9,6,3,6,0,0,0,6
S01013119,Occupancy rating -1 or less,14,2,1,1,10,0,6,1,5,0,4,4,0,2,0,0,0,2
S01013120,All households,440,160,68,92,264,46,184,96,66,22,34,20,14,16,6,2,2,6
S01013120,Occupancy rating +2 or more,241,73,36,37,162,34,115,65,36,14,13,9,4,6,2,1,1,2
S01013120,Occupancy rating +1,102,44,17,27,56,9,41,24,14,3,6,1,5,2,0,0,0,2
S01013120,Occupancy rating 0,85,39,15,24,42,3,27,7,16,4,12,8,4,4,0,1,1,2
S01013120,Occupancy rating -1 or less,12,4,0,4,4,0,1,0,0,1,3,2,1,4,4,0,0,0
S01013121,All households,146,42,20,22,99,12,77,32,35,10,10,7,3,5,1,0,0,4
S01013121,Occupancy rating +2 or more,67,15,7,8,51,11,39,21,15,3,1,1,0,1,1,0,0,0
S01013121,Occupancy rating +1,37,18,10,8,19,1,17,7,8,2,1,0,1,0,0,0,0,0
S01013121,Occupancy rating 0,29,5,1,4,20,0,14,3,7,4,6,4,2,4,0,0,0,4
S01013121,Occupancy rating -1 or less,13,4,2,2,9,0,7,1,5,1,2,2,0,0,0,0,0,0
S01013122,All households,333,186,32,154,133,11,77,32,38,7,45,30,15,14,5,0,1,8
S01013122,Occupancy rating +2 or more,27,16,3,13,11,0,10,4,5,1,1,1,0,0,0,0,0,0
S01013122,Occupancy rating +1,136,94,21,73,41,10,28,21,7,0,3,2,1,1,0,0,0,1
S01013122,Occupancy rating 0,126,59,5,54,62,0,28,4,18,6,34,23,11,5,0,0,1,4
S01013122,Occupancy rating -1 or less,44,17,3,14,19,1,11,3,8,0,7,4,3,8,5,0,0,3
S01013123,All households,414,210,47,163,189,16,103,35,53,15,70,56,14,15,7,0,2,6
S01013123,Occupancy rating +2 or more,45,17,8,9,26,7,19,8,8,3,0,0,0,2,0,0,0,2
S01013123,Occupancy rating +1,132,86,17,69,43,8,29,18,6,5,6,3,3,3,3,0,0,0
S01013123,Occupancy rating 0,191,89,21,68,97,1,45,8,31,6,51,42,9,5,1,0,2,2
S01013123,Occupancy rating -1 or less,46,18,1,17,23,0,10,1,8,1,13,11,2,5,3,0,0,2
S01013124,All households,334,122,48,74,200,21,132,40,64,28,47,27,20,12,4,0,0,8
S01013124,Occupancy rating +2 or more,51,21,11,10,30,7,21,14,6,1,2,1,1,0,0,0,0,0
S01013124,Occupancy rating +1,147,74,29,45,70,11,50,21,15,14,9,2,7,3,1,0,0,2
S01013124,Occupancy rating 0,113,22,5,17,85,2,51,5,36,10,32,22,10,6,0,0,0,6
S01013124,Occupancy rating -1 or less,23,5,3,2,15,1,10,0,7,3,4,2,2,3,3,0,0,0
S01013125,All households,374,160,72,88,196,26,129,48,54,27,41,26,15,18,7,0,1,10
S01013125,Occupancy rating +2 or more,93,39,19,20,50,15,30,15,9,6,5,1,4,4,1,0,0,3
S01013125,Occupancy rating +1,125,71,26,45,52,10,37,29,4,4,5,4,1,2,1,0,1,0
S01013125,Occupancy rating 0,129,44,23,21,80,1,53,4,36,13,26,19,7,5,1,0,0,4
S01013125,Occupancy rating -1 or less,27,6,4,2,14,0,9,0,5,4,5,2,3,7,4,0,0,3
S01013126,All households,342,122,28,94,207,10,101,31,44,26,96,70,26,13,6,1,0,6
S01013126,Occupancy rating +2 or more,51,29,12,17,22,5,17,10,4,3,0,0,0,0,0,0,0,0
S01013126,Occupancy rating +1,124,73,11,62,48,2,36,17,8,11,10,6,4,3,1,0,0,2
S01013126,Occupancy rating 0,120,9,2,7,106,1,39,3,26,10,66,46,20,5,2,1,0,2
S01013126,Occupancy rating -1 or less,47,11,3,8,31,2,9,1,6,2,20,18,2,5,3,0,0,2
S01013127,All households,378,137,34,103,223,17,92,26,42,24,114,82,32,18,10,0,1,7
S01013127,Occupancy rating +2 or more,82,45,17,28,34,12,17,11,3,3,5,2,3,3,0,0,0,3
S01013127,Occupancy rating +1,121,53,11,42,64,4,33,10,11,12,27,15,12,4,2,0,1,1
S01013127,Occupancy rating 0,123,34,5,29,83,1,26,3,16,7,56,45,11,6,4,0,0,2
S01013127,Occupancy rating -1 or less,52,5,1,4,42,0,16,2,12,2,26,20,6,5,4,0,0,1
S01013128,All households,455,325,51,274,125,10,65,49,14,2,50,41,9,5,4,0,0,1
S01013128,Occupancy rating +2 or more,28,14,4,10,14,3,8,5,1,2,3,2,1,0,0,0,0,0
S01013128,Occupancy rating +1,87,65,12,53,22,4,17,16,1,0,1,0,1,0,0,0,0,0
S01013128,Occupancy rating 0,247,186,28,158,59,3,31,24,7,0,25,20,5,2,2,0,0,0
S01013128,Occupancy rating -1 or less,93,60,7,53,30,0,9,4,5,0,21,19,2,3,2,0,0,1
S01013129,All households,533,225,69,156,284,25,184,88,68,28,75,52,23,24,13,0,0,11
S01013129,Occupancy rating +2 or more,101,35,13,22,66,13,45,23,15,7,8,3,5,0,0,0,0,0
S01013129,Occupancy rating +1,169,66,14,52,98,7,74,47,15,12,17,9,8,5,2,0,0,3
S01013129,Occupancy rating 0,194,88,27,61,92,4,51,15,28,8,37,30,7,14,7,0,0,7
S01013129,Occupancy rating -1 or less,69,36,15,21,28,1,14,3,10,1,13,10,3,5,4,0,0,1
S01013130,All households,340,146,31,115,177,7,86,30,44,12,84,62,22,17,9,0,2,6
S01013130,Occupancy rating +2 or more,43,21,2,19,21,3,15,12,3,0,3,1,2,1,1,0,0,0
S01013130,Occupancy rating +1,125,78,18,60,42,3,24,10,10,4,15,7,8,5,0,0,0,5
S01013130,Occupancy rating 0,125,33,8,25,87,1,32,6,19,7,54,43,11,5,4,0,1,0
S01013130,Occupancy rating -1 or less,47,14,3,11,27,0,15,2,12,1,12,11,1,6,4,0,1,1
S01013131,All households,316,134,27,107,169,9,96,29,53,14,64,48,16,13,7,0,1,5
S01013131,Occupancy rating +2 or more,38,17,4,13,20,2,13,7,5,1,5,3,2,1,0,0,0,1
S01013131,Occupancy rating +1,97,50,15,35,45,4,28,12,11,5,13,10,3,2,1,0,0,1
S01013131,Occupancy rating 0,142,58,7,51,77,2,41,9,25,7,34,29,5,7,3,0,1,3
S01013131,Occupancy rating -1 or less,39,9,1,8,27,1,14,1,12,1,12,6,6,3,3,0,0,0
S01013132,All households,318,163,61,102,149,7,71,29,29,13,71,52,19,6,0,0,1,5
S01013132,Occupancy rating +2 or more,26,14,4,10,12,0,8,5,1,2,4,1,3,0,0,0,0,0
S01013132,Occupancy rating +1,75,46,12,34,26,0,16,10,4,2,10,6,4,3,0,0,0,3
S01013132,Occupancy rating 0,162,83,38,45,78,6,33,10,17,6,39,32,7,1,0,0,1,0
S01013132,Occupancy rating -1 or less,55,20,7,13,33,1,14,4,7,3,18,13,5,2,0,0,0,2
S01013133,All households,441,250,55,195,182,14,117,62,44,11,51,41,10,9,2,0,1,6
S01013133,Occupancy rating +2 or more,37,11,2,9,23,2,20,14,5,1,1,0,1,3,0,0,0,3
S01013133,Occupancy rating +1,186,114,20,94,70,7,52,29,19,4,11,8,3,2,1,0,1,0
S01013133,Occupancy rating 0,172,97,23,74,72,4,37,15,16,6,31,25,6,3,0,0,0,3
S01013133,Occupancy rating -1 or less,46,28,10,18,17,1,8,4,4,0,8,8,0,1,1,0,0,0
S01013134,All households,376,142,65,77,222,23,148,46,71,31,51,35,16,12,6,0,1,5
S01013134,Occupancy rating +2 or more,149,53,27,26,92,16,67,31,25,11,9,5,4,4,2,0,0,2
S01013134,Occupancy rating +1,93,42,14,28,49,5,35,9,15,11,9,8,1,2,1,0,1,0
S01013134,Occupancy rating 0,104,41,21,20,59,1,36,5,23,8,22,16,6,4,1,0,0,3
S01013134,Occupancy rating -1 or less,30,6,3,3,22,1,10,1,8,1,11,6,5,2,2,0,0,0
S01013135,All households,391,198,51,147,178,8,96,31,48,17,74,58,16,15,8,0,2,5
S01013135,Occupancy rating +2 or more,45,26,10,16,17,1,14,7,4,3,2,2,0,2,2,0,0,0
S01013135,Occupancy rating +1,119,71,14,57,45,2,30,18,8,4,13,9,4,3,0,0,1,2
S01013135,Occupancy rating 0,167,85,22,63,77,3,37,5,25,7,37,30,7,5,3,0,0,2
S01013135,Occupancy rating -1 or less,60,16,5,11,39,2,15,1,11,3,22,17,5,5,3,0,1,1
S01013136,All households,395,122,62,60,241,45,147,49,65,33,49,20,29,32,13,0,2,17
S01013136,Occupancy rating +2 or more,157,72,48,24,82,36,43,36,5,2,3,0,3,3,0,0,0,3
S01013136,Occupancy rating +1,109,22,7,15,78,7,48,7,23,18,23,6,17,9,1,0,2,6
S01013136,Occupancy rating 0,94,26,5,21,59,1,42,6,25,11,16,11,5,9,4,0,0,5
S01013136,Occupancy rating -1 or less,35,2,2,0,22,1,14,0,12,2,7,3,4,11,8,0,0,3
S01013137,All households,307,88,48,40,198,24,124,35,52,37,50,22,28,21,12,0,0,9
S01013137,Occupancy rating +2 or more,127,63,35,28,63,20,34,25,4,5,9,1,8,1,1,0,0,0
S01013137,Occupancy rating +1,81,5,3,2,68,2,46,3,24,19,20,5,15,8,1,0,0,7
S01013137,Occupancy rating 0,73,19,9,10,49,2,35,6,18,11,12,8,4,5,5,0,0,0
S01013137,Occupancy rating -1 or less,26,1,1,0,18,0,9,1,6,2,9,8,1,7,5,0,0,2
S01013138,All households,342,141,33,108,194,6,85,31,41,13,103,79,24,7,4,0,0,3
S01013138,Occupancy rating +2 or more,49,26,9,17,22,3,17,12,3,2,2,2,0,1,0,0,0,1
S01013138,Occupancy rating +1,117,62,9,53,54,3,32,15,12,5,19,14,5,1,0,0,0,1
S01013138,Occupancy rating 0,139,46,14,32,92,0,27,4,18,5,65,51,14,1,0,0,0,1
S01013138,Occupancy rating -1 or less,37,7,1,6,26,0,9,0,8,1,17,12,5,4,4,0,0,0
S01013139,All households,409,168,64,104,211,25,100,28,42,30,86,47,39,30,14,0,1,15
S01013139,Occupancy rating +2 or more,101,57,29,28,43,14,24,16,3,5,5,1,4,1,1,0,0,0
S01013139,Occupancy rating +1,129,58,25,33,66,5,33,8,14,11,28,8,20,5,1,0,1,3
S01013139,Occupancy rating 0,130,48,8,40,65,4,29,4,17,8,32,22,10,17,7,0,0,10
S01013139,Occupancy rating -1 or less,49,5,2,3,37,2,14,0,8,6,21,16,5,7,5,0,0,2
S01013140,All households,366,119,54,65,228,32,100,32,51,17,96,48,48,19,8,0,0,11
S01013140,Occupancy rating +2 or more,121,58,29,29,63,23,35,27,6,2,5,4,1,0,0,0,0,0
S01013140,Occupancy rating +1,125,44,20,24,76,8,31,4,17,10,37,11,26,5,0,0,0,5
S01013140,Occupancy rating 0,81,7,4,3,66,1,27,1,21,5,38,24,14,8,2,0,0,6
S01013140,Occupancy rating -1 or less,39,10,1,9,23,0,7,0,7,0,16,9,7,6,6,0,0,0
S01013141,All households,330,146,69,77,160,28,81,32,36,13,51,33,18,24,5,0,0,19
S01013141,Occupancy rating +2 or more,59,28,11,17,30,9,16,9,4,3,5,2,3,1,0,0,0,1
S01013141,Occupancy rating +1,118,67,30,37,46,12,26,15,8,3,8,5,3,5,0,0,0,5
S01013141,Occupancy rating 0,122,39,24,15,70,4,34,8,19,7,32,22,10,13,2,0,0,11
S01013141,Occupancy rating -1 or less,31,12,4,8,14,3,5,0,5,0,6,4,2,5,3,0,0,2
S01013142,All households,517,292,138,154,209,45,73,34,21,18,91,55,36,16,4,0,1,11
S01013142,Occupancy rating +2 or more,45,30,11,19,14,1,8,5,2,1,5,5,0,1,0,0,0,1
S01013142,Occupancy rating +1,265,180,99,81,83,37,34,24,7,3,12,7,5,2,0,0,0,2
S01013142,Occupancy rating 0,157,60,19,41,89,4,28,5,11,12,57,32,25,8,1,0,0,7
S01013142,Occupancy rating -1 or less,50,22,9,13,23,3,3,0,1,2,17,11,6,5,3,0,1,1
S01013143,All households,419,160,77,83,234,31,136,62,52,22,67,41,26,25,7,6,2,10
S01013143,Occupancy rating +2 or more,89,41,25,16,47,13,32,26,5,1,2,1,1,1,1,0,0,0
S01013143,Occupancy rating +1,157,65,28,37,88,15,54,29,12,13,19,10,9,4,0,0,0,4
S01013143,Occupancy rating 0,129,45,17,28,70,3,33,5,23,5,34,23,11,14,2,6,2,4
S01013143,Occupancy rating -1 or less,44,9,7,2,29,0,17,2,12,3,12,7,5,6,4,0,0,2
S01013144,All households,427,151,84,67,255,43,146,60,56,30,66,27,39,21,9,0,1,11
S01013144,Occupancy rating +2 or more,119,46,26,20,73,24,42,29,9,4,7,2,5,0,0,0,0,0
S01013144,Occupancy rating +1,153,61,36,25,85,15,53,22,17,14,17,3,14,7,2,0,0,5
S01013144,Occupancy rating 0,112,35,16,19,70,3,40,8,24,8,27,12,15,7,5,0,1,1
S01013144,Occupancy rating -1 or less,43,9,6,3,27,1,11,1,6,4,15,10,5,7,2,0,0,5
S01013145,All households,336,141,70,71,179,23,116,43,40,33,40,23,17,16,4,0,3,9
S01013145,Occupancy rating +2 or more,72,37,16,21,35,7,27,17,5,5,1,0,1,0,0,0,0,0
S01013145,Occupancy rating +1,126,61,33,28,60,10,38,18,9,11,12,7,5,5,0,0,2,3
S01013145,Occupancy rating 0,110,34,17,17,67,6,38,8,20,10,23,14,9,9,3,0,1,5
S01013145,Occupancy rating -1 or less,28,9,4,5,17,0,13,0,6,7,4,2,2,2,1,0,0,1
S01013146,All households,197,60,35,25,128,14,87,30,40,17,27,13,14,9,4,0,1,4
S01013146,Occupancy rating +2 or more,46,21,12,9,24,4,17,11,4,2,3,1,2,1,0,0,0,1
S01013146,Occupancy rating +1,82,33,17,16,48,10,31,16,9,6,7,4,3,1,1,0,0,0
S01013146,Occupancy rating 0,58,5,5,0,47,0,30,2,20,8,17,8,9,6,2,0,1,3
S01013146,Occupancy rating -1 or less,11,1,1,0,9,0,9,1,7,1,0,0,0,1,1,0,0,0
S01013147,All households,307,93,56,37,197,29,122,40,66,16,46,24,22,17,8,1,1,7
S01013147,Occupancy rating +2 or more,123,37,24,13,83,19,60,32,23,5,4,2,2,3,1,0,0,2
S01013147,Occupancy rating +1,97,45,24,21,49,8,28,5,19,4,13,5,8,3,1,0,0,2
S01013147,Occupancy rating 0,65,10,7,3,47,2,23,3,14,6,22,14,8,8,4,1,1,2
S01013147,Occupancy rating -1 or less,22,1,1,0,18,0,11,0,10,1,7,3,4,3,2,0,0,1
S01013148,All households,381,152,60,92,214,43,133,57,51,25,38,22,16,15,6,0,1,8
S01013148,Occupancy rating +2 or more,87,30,19,11,56,21,32,17,8,7,3,1,2,1,0,0,1,0
S01013148,Occupancy rating +1,155,74,26,48,80,17,58,37,10,11,5,3,2,1,0,0,0,1
S01013148,Occupancy rating 0,109,34,9,25,66,5,37,3,28,6,24,15,9,9,3,0,0,6
S01013148,Occupancy rating -1 or less,30,14,6,8,12,0,6,0,5,1,6,3,3,4,3,0,0,1
S01013149,All households,418,172,69,103,222,23,141,61,58,22,58,41,17,24,10,6,0,8
S01013149,Occupancy rating +2 or more,56,29,11,18,27,6,20,12,6,2,1,1,0,0,0,0,0,0
S01013149,Occupancy rating +1,162,82,28,54,78,14,57,37,14,6,7,4,3,2,0,0,0,2
S01013149,Occupancy rating 0,142,47,23,24,90,3,54,10,33,11,33,21,12,5,3,0,0,2
S01013149,Occupancy rating -1 or less,58,14,7,7,27,0,10,2,5,3,17,15,2,17,7,6,0,4
S01013150,All households,403,138,68,70,262,43,153,62,48,43,66,41,25,3,0,0,0,3
S01013150,Occupancy rating +2 or more,107,40,24,16,66,20,42,23,9,10,4,2,2,1,0,0,0,1
S01013150,Occupancy rating +1,153,49,20,29,103,16,68,30,16,22,19,9,10,1,0,0,0,1
S01013150,Occupancy rating 0,109,38,17,21,70,5,32,6,17,9,33,21,12,1,0,0,0,1
S01013150,Occupancy rating -1 or less,34,11,7,4,23,2,11,3,6,2,10,9,1,0,0,0,0,0
S01013151,All households,261,93,41,52,162,15,123,48,45,30,24,19,5,6,4,0,0,2
S01013151,Occupancy rating +2 or more,103,28,18,10,74,6,63,31,18,14,5,4,1,1,1,0,0,0
S01013151,Occupancy rating +1,87,48,22,26,39,6,28,8,11,9,5,5,0,0,0,0,0,0
S01013151,Occupancy rating 0,59,15,0,15,39,2,26,9,11,6,11,7,4,5,3,0,0,2
S01013151,Occupancy rating -1 or less,12,2,1,1,10,1,6,0,5,1,3,3,0,0,0,0,0,0
S01013152,All households,386,119,59,60,251,29,178,63,77,38,44,29,15,16,6,0,0,10
S01013152,Occupancy rating +2 or more,154,42,25,17,109,15,89,35,37,17,5,3,2,3,1,0,0,2
S01013152,Occupancy rating +1,111,49,22,27,61,7,46,24,11,11,8,6,2,1,1,0,0,0
S01013152,Occupancy rating 0,92,23,9,14,62,5,34,4,22,8,23,17,6,7,2,0,0,5
S01013152,Occupancy rating -1 or less,29,5,3,2,19,2,9,0,7,2,8,3,5,5,2,0,0,3
S01013153,All households,398,151,43,108,227,19,119,33,63,23,89,73,16,20,8,0,1,11
S01013153,Occupancy rating +2 or more,68,29,13,16,38,10,26,14,6,6,2,1,1,1,0,0,0,1
S01013153,Occupancy rating +1,136,75,18,57,54,6,30,15,9,6,18,15,3,7,0,0,1,6
S01013153,Occupancy rating 0,147,42,11,31,101,3,45,4,34,7,53,44,9,4,2,0,0,2
S01013153,Occupancy rating -1 or less,47,5,1,4,34,0,18,0,14,4,16,13,3,8,6,0,0,2
S01013154,All households,452,154,50,104,274,35,129,47,52,30,110,79,31,24,13,0,0,11
S01013154,Occupancy rating +2 or more,104,49,30,19,55,12,41,25,12,4,2,2,0,0,0,0,0,0
S01013154,Occupancy rating +1,174,88,17,71,83,21,33,18,9,6,29,16,13,3,1,0,0,2
S01013154,Occupancy rating 0,133,10,3,7,112,2,44,4,25,15,66,50,16,11,3,0,0,8
S01013154,Occupancy rating -1 or less,41,7,0,7,24,0,11,0,6,5,13,11,2,10,9,0,0,1
S01013155,All households,399,145,24,121,232,2,104,29,58,17,126,97,29,22,14,0,0,8
S01013155,Occupancy rating +2 or more,62,29,4,25,30,1,22,12,7,3,7,5,2,3,1,0,0,2
S01013155,Occupancy rating +1,122,63,6,57,57,1,27,11,11,5,29,21,8,2,1,0,0,1
S01013155,Occupancy rating 0,152,42,12,30,103,0,40,6,29,5,63,48,15,7,3,0,0,4
S01013155,Occupancy rating -1 or less,63,11,2,9,42,0,15,0,11,4,27,23,4,10,9,0,0,1
S01013156,All households,354,104,26,78,231,14,102,31,50,21,115,85,30,19,10,0,0,9
S01013156,Occupancy rating +2 or more,46,15,2,13,31,7,20,13,6,1,4,3,1,0,0,0,0,0
S01013156,Occupancy rating +1,104,48,13,35,55,6,30,16,11,3,19,13,6,1,0,0,0,1
S01013156,Occupancy rating 0,149,31,9,22,107,1,40,2,26,12,66,47,19,11,5,0,0,6
S01013156,Occupancy rating -1 or less,55,10,2,8,38,0,12,0,7,5,26,22,4,7,5,0,0,2
S01013157,All households,430,163,46,117,241,12,127,39,68,20,102,70,32,26,16,0,1,9
S01013157,Occupancy rating +2 or more,79,43,12,31,34,2,28,12,13,3,4,2,2,2,1,0,1,0
S01013157,Occupancy rating +1,143,62,20,42,74,6,43,21,15,7,25,16,9,7,3,0,0,4
S01013157,Occupancy rating 0,162,46,10,36,105,4,44,5,30,9,57,40,17,11,6,0,0,5
S01013157,Occupancy rating -1 or less,46,12,4,8,28,0,12,1,10,1,16,12,4,6,6,0,0,0
S01013158,All households,205,37,18,19,153,19,120,39,54,27,14,7,7,15,6,0,1,8
S01013158,Occupancy rating +2 or more,126,30,18,12,85,14,66,38,21,7,5,2,3,11,4,0,0,7
S01013158,Occupancy rating +1,44,3,0,3,38,4,29,0,17,12,5,3,2,3,1,0,1,1
S01013158,Occupancy rating 0,30,4,0,4,25,1,22,1,14,7,2,1,1,1,1,0,0,0
S01013158,Occupancy rating -1 or less,5,0,0,0,5,0,3,0,2,1,2,1,1,0,0,0,0,0
S01013159,All households,297,80,37,43,207,37,150,62,52,36,20,13,7,10,6,0,1,3
S01013159,Occupancy rating +2 or more,143,35,18,17,107,30,74,40,22,12,3,1,2,1,0,0,0,1
S01013159,Occupancy rating +1,68,20,8,12,46,2,39,14,12,13,5,2,3,2,1,0,1,0
S01013159,Occupancy rating 0,64,21,10,11,39,4,27,6,11,10,8,7,1,4,3,0,0,1
S01013159,Occupancy rating -1 or less,22,4,1,3,15,1,10,2,7,1,4,3,1,3,2,0,0,1
S01013160,All households,264,32,17,15,222,35,170,58,78,34,17,9,8,10,8,0,0,2
S01013160,Occupancy rating +2 or more,175,30,17,13,140,34,103,54,33,16,3,3,0,5,4,0,0,1
S01013160,Occupancy rating +1,56,1,0,1,53,1,45,3,27,15,7,0,7,2,2,0,0,0
S01013160,Occupancy rating 0,26,0,0,0,23,0,16,1,12,3,7,6,1,3,2,0,0,1
S01013160,Occupancy rating -1 or less,7,1,0,1,6,0,6,0,6,0,0,0,0,0,0,0,0,0
S01013161,All households,488,198,72,126,270,31,179,70,84,25,60,39,21,20,8,0,2,10
S01013161,Occupancy rating +2 or more,82,29,12,17,50,13,34,22,9,3,3,1,2,3,0,0,0,3
S01013161,Occupancy rating +1,167,67,18,49,96,13,66,25,31,10,17,9,8,4,3,0,0,1
S01013161,Occupancy rating 0,181,82,33,49,92,4,58,21,31,6,30,22,8,7,1,0,1,5
S01013161,Occupancy rating -1 or less,58,20,9,11,32,1,21,2,13,6,10,7,3,6,4,0,1,1
S01013162,All households,426,197,89,108,207,37,100,36,38,26,70,26,44,22,11,0,3,8
S01013162,Occupancy rating +2 or more,84,47,22,25,37,18,18,11,4,3,1,1,0,0,0,0,0,0
S01013162,Occupancy rating +1,121,48,21,27,70,12,36,16,9,11,22,8,14,3,0,0,0,3
S01013162,Occupancy rating 0,163,85,40,45,72,5,35,8,17,10,32,11,21,6,2,0,0,4
S01013162,Occupancy rating -1 or less,58,17,6,11,28,2,11,1,8,2,15,6,9,13,9,0,3,1
S01013163,All households,253,27,12,15,221,24,170,53,70,47,27,19,8,5,2,0,0,3
S01013163,Occupancy rating +2 or more,109,15,8,7,93,18,70,40,12,18,5,2,3,1,1,0,0,0
S01013163,Occupancy rating +1,69,10,2,8,58,5,47,10,24,13,6,5,1,1,0,0,0,1
S01013163,Occupancy rating 0,52,1,1,0,49,0,35,2,21,12,14,11,3,2,0,0,0,2
S01013163,Occupancy rating -1 or less,23,1,1,0,21,1,18,1,13,4,2,1,1,1,1,0,0,0
S01013164,All households,485,211,68,143,252,31,167,43,80,44,54,34,20,22,11,0,1,10
S01013164,Occupancy rating +2 or more,182,68,34,34,110,25,77,24,34,19,8,4,4,4,2,0,0,2
S01013164,Occupancy rating +1,102,29,12,17,68,5,44,12,17,15,19,8,11,5,1,0,0,4
S01013164,Occupancy rating 0,158,97,20,77,53,1,36,7,22,7,16,14,2,8,5,0,1,2
S01013164,Occupancy rating -1 or less,43,17,2,15,21,0,10,0,7,3,11,8,3,5,3,0,0,2
S01013165,All households,412,153,92,61,243,33,158,65,64,29,52,26,26,16,7,0,0,9
S01013165,Occupancy rating +2 or more,154,55,31,24,95,13,81,45,22,14,1,0,1,4,1,0,0,3
S01013165,Occupancy rating +1,102,32,20,12,69,10,46,15,22,9,13,3,10,1,0,0,0,1
S01013165,Occupancy rating 0,125,57,36,21,59,8,24,4,16,4,27,16,11,9,4,0,0,5
S01013165,Occupancy rating -1 or less,31,9,5,4,20,2,7,1,4,2,11,7,4,2,2,0,0,0
S01013166,All households,387,234,50,184,142,7,65,27,27,11,70,51,19,11,4,0,0,7
S01013166,Occupancy rating +2 or more,18,8,2,6,9,1,4,4,0,0,4,4,0,1,0,0,0,1
S01013166,Occupancy rating +1,129,98,21,77,31,5,21,14,5,2,5,3,2,0,0,0,0,0
S01013166,Occupancy rating 0,193,108,23,85,80,0,33,8,19,6,47,33,14,5,1,0,0,4
S01013166,Occupancy rating -1 or less,47,20,4,16,22,1,7,1,3,3,14,11,3,5,3,0,0,2
S01013167,All households,383,216,29,187,159,9,80,30,39,11,70,53,17,8,2,0,1,5
S01013167,Occupancy rating +2 or more,32,17,2,15,15,3,10,7,3,0,2,1,1,0,0,0,0,0
S01013167,Occupancy rating +1,107,76,15,61,31,5,17,8,4,5,9,5,4,0,0,0,0,0
S01013167,Occupancy rating 0,172,86,9,77,84,0,40,12,24,4,44,36,8,2,0,0,0,2
S01013167,Occupancy rating -1 or less,72,37,3,34,29,1,13,3,8,2,15,11,4,6,2,0,1,3
S01013168,All households,408,162,69,93,224,33,119,37,45,37,72,45,27,22,11,0,0,11
S01013168,Occupancy rating +2 or more,138,60,29,31,72,19,36,18,7,11,17,4,13,6,1,0,0,5
S01013168,Occupancy rating +1,104,31,19,12,67,9,39,14,15,10,19,11,8,6,1,0,0,5
S01013168,Occupancy rating 0,127,60,17,43,66,4,36,5,17,14,26,20,6,1,0,0,0,1
S01013168,Occupancy rating -1 or less,39,11,4,7,19,1,8,0,6,2,10,10,0,9,9,0,0,0
S01013169,All households,436,202,104,98,224,31,130,46,53,31,63,33,30,10,3,0,1,6
S01013169,Occupancy rating +2 or more,78,34,19,15,43,14,20,13,6,1,9,6,3,1,0,0,0,1
S01013169,Occupancy rating +1,148,71,42,29,71,14,45,24,11,10,12,6,6,6,2,0,0,4
S01013169,Occupancy rating 0,166,86,38,48,78,3,45,9,19,17,30,15,15,2,0,0,1,1
S01013169,Occupancy rating -1 or less,44,11,5,6,32,0,20,0,17,3,12,6,6,1,1,0,0,0
S01013170,All households,265,122,50,72,134,9,74,28,28,18,51,32,19,9,3,0,3,3
S01013170,Occupancy rating +2 or more,43,23,16,7,19,3,16,13,2,1,0,0,0,1,1,0,0,0
S01013170,Occupancy rating +1,88,52,10,42,34,5,21,11,4,6,8,2,6,2,0,0,1,1
S01013170,Occupancy rating 0,98,33,17,16,62,1,23,4,11,8,38,26,12,3,1,0,0,2
S01013170,Occupancy rating -1 or less,36,14,7,7,19,0,14,0,11,3,5,4,1,3,1,0,2,0
S01013171,All households,249,53,15,38,187,17,136,35,77,24,34,24,10,9,3,0,0,6
S01013171,Occupancy rating +2 or more,119,27,14,13,89,13,73,27,41,5,3,2,1,3,2,0,0,1
S01013171,Occupancy rating +1,82,18,0,18,63,3,49,8,28,13,11,7,4,1,0,0,0,1
S01013171,Occupancy rating 0,36,6,0,6,26,0,10,0,4,6,16,11,5,4,0,0,0,4
S01013171,Occupancy rating -1 or less,12,2,1,1,9,1,4,0,4,0,4,4,0,1,1,0,0,0
S01013172,All households,319,94,34,60,210,25,136,55,60,21,49,23,26,15,8,0,1,6
S01013172,Occupancy rating +2 or more,111,36,17,19,73,14,56,32,16,8,3,1,2,2,1,0,0,1
S01013172,Occupancy rating +1,104,38,11,27,61,8,42,18,17,7,11,4,7,5,1,0,1,3
S01013172,Occupancy rating 0,79,16,5,11,58,2,27,4,18,5,29,15,14,5,3,0,0,2
S01013172,Occupancy rating -1 or less,25,4,1,3,18,1,11,1,9,1,6,3,3,3,3,0,0,0
S01013173,All households,358,117,31,86,226,17,168,68,76,24,41,26,15,15,3,0,2,10
S01013173,Occupancy rating +2 or more,110,27,8,19,82,11,69,35,25,9,2,1,1,1,0,0,0,1
S01013173,Occupancy rating +1,112,52,14,38,58,6,46,23,14,9,6,5,1,2,0,0,1,1
S01013173,Occupancy rating 0,105,29,7,22,68,0,41,7,29,5,27,17,10,8,1,0,1,6
S01013173,Occupancy rating -1 or less,31,9,2,7,18,0,12,3,8,1,6,3,3,4,2,0,0,2
S01013174,All households,284,48,19,29,227,16,188,54,94,40,23,12,11,9,7,0,0,2
S01013174,Occupancy rating +2 or more,167,36,15,21,127,10,106,38,49,19,11,4,7,4,4,0,0,0
S01013174,Occupancy rating +1,76,7,2,5,66,5,53,14,27,12,8,5,3,3,1,0,0,2
S01013174,Occupancy rating 0,33,5,2,3,27,1,25,1,17,7,1,1,0,1,1,0,0,0
S01013174,Occupancy rating -1 or less,8,0,0,0,7,0,4,1,1,2,3,2,1,1,1,0,0,0
S01013175,All households,343,84,34,50,251,23,191,58,104,29,37,28,9,8,3,0,0,5
S01013175,Occupancy rating +2 or more,144,19,8,11,120,11,102,31,55,16,7,6,1,5,1,0,0,4
S01013175,Occupancy rating +1,114,40,11,29,74,10,59,26,25,8,5,4,1,0,0,0,0,0
S01013175,Occupancy rating 0,63,18,9,9,44,1,27,1,22,4,16,12,4,1,0,0,0,1
S01013175,Occupancy rating -1 or less,22,7,6,1,13,1,3,0,2,1,9,6,3,2,2,0,0,0
S01013176,All households,411,206,81,125,196,37,133,68,40,25,26,16,10,9,5,0,0,4
S01013176,Occupancy rating +2 or more,94,29,8,21,64,15,44,25,11,8,5,3,2,1,1,0,0,0
S01013176,Occupancy rating +1,109,59,26,33,49,10,34,24,7,3,5,2,3,1,0,0,0,1
S01013176,Occupancy rating 0,161,94,38,56,65,9,43,16,16,11,13,8,5,2,0,0,0,2
S01013176,Occupancy rating -1 or less,47,24,9,15,18,3,12,3,6,3,3,3,0,5,4,0,0,1
S01013177,All households,290,115,37,78,165,25,123,51,54,18,17,7,10,10,4,0,0,6
S01013177,Occupancy rating +2 or more,88,29,15,14,58,16,40,23,13,4,2,0,2,1,0,0,0,1
S01013177,Occupancy rating +1,89,37,16,21,48,6,38,16,16,6,4,0,4,4,0,0,0,4
S01013177,Occupancy rating 0,80,33,4,29,45,2,36,11,18,7,7,3,4,2,2,0,0,0
S01013177,Occupancy rating -1 or less,33,16,2,14,14,1,9,1,7,1,4,4,0,3,2,0,0,1
S01013178,All households,346,130,48,82,204,31,140,64,52,24,33,14,19,12,3,0,1,8
S01013178,Occupancy rating +2 or more,100,30,19,11,68,18,46,26,13,7,4,1,3,2,1,0,0,1
S01013178,Occupancy rating +1,124,51,10,41,71,6,53,26,17,10,12,1,11,2,0,0,1,1
S01013178,Occupancy rating 0,91,39,15,24,47,7,28,11,12,5,12,9,3,5,1,0,0,4
S01013178,Occupancy rating -1 or less,31,10,4,6,18,0,13,1,10,2,5,3,2,3,1,0,0,2
S01013179,All households,363,115,38,77,234,32,157,79,35,43,45,29,16,14,7,0,0,7
S01013179,Occupancy rating +2 or more,167,45,26,19,120,24,89,59,15,15,7,2,5,2,0,0,0,2
S01013179,Occupancy rating +1,94,26,2,24,67,6,45,17,11,17,16,8,8,1,0,0,0,1
S01013179,Occupancy rating 0,71,33,7,26,32,1,13,2,5,6,18,15,3,6,3,0,0,3
S01013179,Occupancy rating -1 or less,31,11,3,8,15,1,10,1,4,5,4,4,0,5,4,0,0,1
S01013180,All households,170,32,8,24,133,6,108,40,43,25,19,12,7,5,1,0,1,3
S01013180,Occupancy rating +2 or more,70,12,6,6,57,4,49,27,15,7,4,0,4,1,1,0,0,0
S01013180,Occupancy rating +1,58,14,1,13,42,2,38,13,15,10,2,2,0,2,0,0,0,2
S01013180,Occupancy rating 0,34,5,1,4,28,0,18,0,11,7,10,8,2,1,0,0,1,0
S01013180,Occupancy rating -1 or less,8,1,0,1,6,0,3,0,2,1,3,2,1,1,0,0,0,1
S01013181,All households,310,84,51,33,212,23,158,68,59,31,31,10,21,14,5,0,2,7
S01013181,Occupancy rating +2 or more,106,30,20,10,74,8,64,43,16,5,2,1,1,2,0,0,0,2
S01013181,Occupancy rating +1,107,25,15,10,78,11,54,21,25,8,13,3,10,4,0,0,1,3
S01013181,Occupancy rating 0,73,25,12,13,43,1,32,3,14,15,10,4,6,5,3,0,1,1
S01013181,Occupancy rating -1 or less,24,4,4,0,17,3,8,1,4,3,6,2,4,3,2,0,0,1
S01013182,All households,372,165,90,75,191,29,105,36,44,25,57,32,25,16,5,0,2,9
S01013182,Occupancy rating +2 or more,95,54,31,23,40,8,26,15,5,6,6,2,4,1,0,0,0,1
S01013182,Occupancy rating +1,145,76,44,32,63,13,43,16,18,9,7,2,5,6,2,0,0,4
S01013182,Occupancy rating 0,95,27,13,14,62,6,24,3,15,6,32,20,12,6,2,0,1,3
S01013182,Occupancy rating -1 or less,37,8,2,6,26,2,12,2,6,4,12,8,4,3,1,0,1,1
S01013183,All households,334,76,26,50,247,30,196,72,73,51,21,7,14,11,4,0,0,7
S01013183,Occupancy rating +2 or more,186,28,16,12,152,29,121,64,36,21,2,0,2,6,3,0,0,3
S01013183,Occupancy rating +1,71,10,1,9,59,1,45,4,23,18,13,5,8,2,0,0,0,2
S01013183,Occupancy rating 0,67,35,9,26,32,0,27,4,11,12,5,2,3,0,0,0,0,0
S01013183,Occupancy rating -1 or less,10,3,0,3,4,0,3,0,3,0,1,0,1,3,1,0,0,2
S01013184,All households,279,121,22,99,145,5,65,25,30,10,75,52,23,13,9,0,0,4
S01013184,Occupancy rating +2 or more,52,29,6,23,22,2,10,8,2,0,10,6,4,1,0,0,0,1
S01013184,Occupancy rating +1,122,73,16,57,47,3,26,13,8,5,18,11,7,2,0,0,0,2
S01013184,Occupancy rating 0,81,18,0,18,61,0,22,1,17,4,39,27,12,2,2,0,0,0
S01013184,Occupancy rating -1 or less,24,1,0,1,15,0,7,3,3,1,8,8,0,8,7,0,0,1
S01013185,All households,362,129,48,81,220,23,120,39,65,16,77,50,27,13,10,0,1,2
S01013185,Occupancy rating +2 or more,79,39,19,20,40,13,25,19,5,1,2,2,0,0,0,0,0,0
S01013185,Occupancy rating +1,131,61,19,42,70,8,42,15,20,7,20,12,8,0,0,0,0,0
S01013185,Occupancy rating 0,115,24,8,16,85,2,41,4,30,7,42,29,13,6,3,0,1,2
S01013185,Occupancy rating -1 or less,37,5,2,3,25,0,12,1,10,1,13,7,6,7,7,0,0,0
S01013186,All households,292,92,28,64,186,8,104,35,52,17,74,50,24,14,8,0,1,5
S01013186,Occupancy rating +2 or more,49,19,7,12,30,6,20,18,2,0,4,3,1,0,0,0,0,0
S01013186,Occupancy rating +1,119,61,16,45,57,2,39,14,18,7,16,7,9,1,0,0,1,0
S01013186,Occupancy rating 0,92,7,3,4,77,0,33,2,23,8,44,33,11,8,4,0,0,4
S01013186,Occupancy rating -1 or less,32,5,2,3,22,0,12,1,9,2,10,7,3,5,4,0,0,1
S01013187,All households,386,147,42,105,220,20,127,49,61,17,73,44,29,19,8,0,3,8
S01013187,Occupancy rating +2 or more,103,38,13,25,61,10,47,28,15,4,4,1,3,4,2,0,1,1
S01013187,Occupancy rating +1,127,62,19,43,63,7,35,18,14,3,21,11,10,2,1,0,1,0
S01013187,Occupancy rating 0,119,36,6,30,73,3,36,2,25,9,34,21,13,10,3,0,1,6
S01013187,Occupancy rating -1 or less,37,11,4,7,23,0,9,1,7,1,14,11,3,3,2,0,0,1
S01013188,All households,348,71,29,42,253,34,173,66,69,38,46,26,20,24,14,0,1,9
S01013188,Occupancy rating +2 or more,156,40,18,22,115,24,86,53,24,9,5,0,5,1,1,0,0,0
S01013188,Occupancy rating +1,97,25,9,16,67,8,45,12,22,11,14,9,5,5,1,0,1,3
S01013188,Occupancy rating 0,67,4,2,2,54,2,34,1,18,15,18,10,8,9,6,0,0,3
S01013188,Occupancy rating -1 or less,28,2,0,2,17,0,8,0,5,3,9,7,2,9,6,0,0,3
S01013189,All households,238,51,33,18,173,24,124,40,47,37,25,11,14,14,7,0,0,7
S01013189,Occupancy rating +2 or more,126,39,25,14,82,15,61,30,17,14,6,3,3,5,2,0,0,3
S01013189,Occupancy rating +1,64,10,6,4,49,7,34,10,13,11,8,1,7,5,2,0,0,3
S01013189,Occupancy rating 0,36,1,1,0,31,1,24,0,15,9,6,5,1,4,3,0,0,1
S01013189,Occupancy rating -1 or less,12,1,1,0,11,1,5,0,2,3,5,2,3,0,0,0,0,0
S01013190,All households,367,144,69,75,210,22,140,41,73,26,48,24,24,13,4,0,0,9
S01013190,Occupancy rating +2 or more,101,25,13,12,76,5,63,18,37,8,8,3,5,0,0,0,0,0
S01013190,Occupancy rating +1,118,54,23,31,61,14,38,16,16,6,9,3,6,3,2,0,0,1
S01013190,Occupancy rating 0,111,53,28,25,53,1,31,6,13,12,21,12,9,5,0,0,0,5
S01013190,Occupancy rating -1 or less,37,12,5,7,20,2,8,1,7,0,10,6,4,5,2,0,0,3
S01013191,All households,386,67,36,31,308,26,262,80,130,52,20,14,6,11,7,0,1,3
S01013191,Occupancy rating +2 or more,223,34,14,20,186,18,158,58,71,29,10,6,4,3,0,0,0,3
S01013191,Occupancy rating +1,109,26,17,9,79,8,67,18,35,14,4,4,0,4,4,0,0,0
S01013191,Occupancy rating 0,46,6,5,1,36,0,31,4,20,7,5,3,2,4,3,0,1,0
S01013191,Occupancy rating -1 or less,8,1,0,1,7,0,6,0,4,2,1,1,0,0,0,0,0,0
S01013192,All households,417,155,67,88,247,33,170,72,61,37,44,28,16,15,6,0,2,7
S01013192,Occupancy rating +2 or more,156,47,26,21,108,21,80,39,26,15,7,2,5,1,0,0,1,0
S01013192,Occupancy rating +1,127,50,21,29,75,12,49,21,15,13,14,8,6,2,1,0,1,0
S01013192,Occupancy rating 0,105,51,15,36,46,0,27,10,11,6,19,15,4,8,2,0,0,6
S01013192,Occupancy rating -1 or less,29,7,5,2,18,0,14,2,9,3,4,3,1,4,3,0,0,1
S01013193,All households,356,169,52,117,179,21,118,62,37,19,40,32,8,8,2,0,0,6
S01013193,Occupancy rating +2 or more,62,14,6,8,47,7,39,19,13,7,1,0,1,1,0,0,0,1
S01013193,Occupancy rating +1,163,94,37,57,69,11,52,39,6,7,6,5,1,0,0,0,0,0
S01013193,Occupancy rating 0,88,40,6,34,44,2,22,3,16,3,20,17,3,4,0,0,0,4
S01013193,Occupancy rating -1 or less,43,21,3,18,19,1,5,1,2,2,13,10,3,3,2,0,0,1
S01013194,All households,319,157,32,125,151,12,103,54,34,15,36,27,9,11,2,0,1,8
S01013194,Occupancy rating +2 or more,74,26,9,17,46,8,33,20,9,4,5,4,1,2,0,0,1,1
S01013194,Occupancy rating +1,95,52,10,42,43,3,35,21,7,7,5,4,1,0,0,0,0,0
S01013194,Occupancy rating 0,102,52,9,43,44,1,24,7,13,4,19,14,5,6,2,0,0,4
S01013194,Occupancy rating -1 or less,48,27,4,23,18,0,11,6,5,0,7,5,2,3,0,0,0,3
S01013195,All households,597,354,113,241,217,21,152,86,51,15,44,25,19,26,0,0,0,26
S01013195,Occupancy rating +2 or more,75,26,8,18,47,6,39,11,22,6,2,2,0,2,0,0,0,2
S01013195,Occupancy rating +1,191,115,33,82,74,9,57,39,15,3,8,4,4,2,0,0,0,2
S01013195,Occupancy rating 0,247,153,59,94,79,6,45,30,12,3,28,14,14,15,0,0,0,15
S01013195,Occupancy rating -1 or less,84,60,13,47,17,0,11,6,2,3,6,5,1,7,0,0,0,7
S01013196,All households,371,193,46,147,161,21,107,63,29,15,33,16,17,17,1,0,3,13
S01013196,Occupancy rating +2 or more,39,12,4,8,27,9,17,11,5,1,1,0,1,0,0,0,0,0
S01013196,Occupancy rating +1,141,84,20,64,56,10,41,30,6,5,5,2,3,1,0,0,0,1
S01013196,Occupancy rating 0,153,78,18,60,64,1,37,19,11,7,26,13,13,11,0,0,2,9
S01013196,Occupancy rating -1 or less,38,19,4,15,14,1,12,3,7,2,1,1,0,5,1,0,1,3
S01013197,All households,262,101,64,37,155,27,103,33,41,29,25,7,18,6,2,0,0,4
S01013197,Occupancy rating +2 or more,133,37,30,7,94,21,66,27,17,22,7,0,7,2,0,0,0,2
S01013197,Occupancy rating +1,52,20,8,12,31,4,20,2,13,5,7,4,3,1,1,0,0,0
S01013197,Occupancy rating 0,67,42,24,18,22,1,15,4,9,2,6,1,5,3,1,0,0,2
S01013197,Occupancy rating -1 or less,10,2,2,0,8,1,2,0,2,0,5,2,3,0,0,0,0,0
S01013198,All households,379,160,72,88,209,21,135,56,43,36,53,36,17,10,2,0,2,6
S01013198,Occupancy rating +2 or more,127,47,22,25,77,14,56,34,10,12,7,3,4,3,0,0,2,1
S01013198,Occupancy rating +1,86,31,18,13,53,2,34,11,13,10,17,11,6,2,0,0,0,2
S01013198,Occupancy rating 0,133,75,29,46,57,3,30,11,9,10,24,18,6,1,1,0,0,0
S01013198,Occupancy rating -1 or less,33,7,3,4,22,2,15,0,11,4,5,4,1,4,1,0,0,3
S01013199,All households,488,247,138,109,226,26,162,73,53,36,38,18,20,15,2,0,5,8
S01013199,Occupancy rating +2 or more,116,23,13,10,88,6,72,30,26,16,10,6,4,5,0,0,0,5
S01013199,Occupancy rating +1,199,130,73,57,69,12,49,33,8,8,8,4,4,0,0,0,0,0
S01013199,Occupancy rating 0,140,77,41,36,56,6,35,8,16,11,15,7,8,7,1,0,3,3
S01013199,Occupancy rating -1 or less,33,17,11,6,13,2,6,2,3,1,5,1,4,3,1,0,2,0
S01013200,All households,313,111,50,61,185,13,118,51,51,16,54,35,19,17,9,0,2,6
S01013200,Occupancy rating +2 or more,120,36,22,14,80,11,62,36,18,8,7,1,6,4,3,0,0,1
S01013200,Occupancy rating +1,87,42,16,26,39,1,24,5,12,7,14,10,4,6,1,0,2,3
S01013200,Occupancy rating 0,62,17,6,11,41,1,25,7,17,1,15,10,5,4,3,0,0,1
S01013200,Occupancy rating -1 or less,44,16,6,10,25,0,7,3,4,0,18,14,4,3,2,0,0,1
S01013201,All households,380,195,47,148,167,11,81,25,38,18,75,45,30,18,10,0,1,7
S01013201,Occupancy rating +2 or more,90,51,16,35,38,6,28,16,9,3,4,1,3,1,1,0,0,0
S01013201,Occupancy rating +1,109,59,13,46,45,3,21,6,8,7,21,13,8,5,1,0,0,4
S01013201,Occupancy rating 0,130,65,10,55,58,1,23,2,16,5,34,21,13,7,4,0,1,2
S01013201,Occupancy rating -1 or less,51,20,8,12,26,1,9,1,5,3,16,10,6,5,4,0,0,1
S01013202,All households,235,72,7,65,151,21,79,24,31,24,51,40,11,12,7,0,0,5
S01013202,Occupancy rating +2 or more,81,22,2,20,54,16,32,17,8,7,6,3,3,5,2,0,0,3
S01013202,Occupancy rating +1,62,24,1,23,37,4,23,6,8,9,10,8,2,1,1,0,0,0
S01013202,Occupancy rating 0,66,21,3,18,45,1,16,1,10,5,28,22,6,0,0,0,0,0
S01013202,Occupancy rating -1 or less,26,5,1,4,15,0,8,0,5,3,7,7,0,6,4,0,0,2
S01013203,All households,355,159,46,113,184,15,114,43,60,11,55,34,21,12,6,0,0,6
S01013203,Occupancy rating +2 or more,51,20,9,11,30,4,22,12,8,2,4,2,2,1,0,0,0,1
S01013203,Occupancy rating +1,120,64,22,42,54,9,37,21,13,3,8,3,5,2,0,0,0,2
S01013203,Occupancy rating 0,137,60,11,49,72,2,41,9,26,6,29,20,9,5,3,0,0,2
S01013203,Occupancy rating -1 or less,47,15,4,11,28,0,14,1,13,0,14,9,5,4,3,0,0,1
S01013204,All households,332,88,21,67,235,12,186,72,87,27,37,24,13,9,4,0,0,5
S01013204,Occupancy rating +2 or more,115,18,5,13,95,3,82,43,33,6,10,8,2,2,2,0,0,0
S01013204,Occupancy rating +1,114,44,13,31,68,4,54,22,22,10,10,6,4,2,0,0,0,2
S01013204,Occupancy rating 0,70,18,3,15,51,2,38,4,26,8,11,7,4,1,0,0,0,1
S01013204,Occupancy rating -1 or less,33,8,0,8,21,3,12,3,6,3,6,3,3,4,2,0,0,2
S01013205,All households,240,66,17,49,160,7,92,28,40,24,61,39,22,14,8,0,0,6
S01013205,Occupancy rating +2 or more,66,21,10,11,44,5,28,17,7,4,11,7,4,1,0,0,0,1
S01013205,Occupancy rating +1,90,36,6,30,49,1,38,9,17,12,10,6,4,5,2,0,0,3
S01013205,Occupancy rating 0,58,8,1,7,46,1,19,2,11,6,26,16,10,4,2,0,0,2
S01013205,Occupancy rating -1 or less,26,1,0,1,21,0,7,0,5,2,14,10,4,4,4,0,0,0
S01013206,All households,298,115,35,80,167,12,97,43,34,20,58,37,21,16,11,0,0,5
S01013206,Occupancy rating +2 or more,67,29,10,19,34,4,26,20,4,2,4,4,0,4,2,0,0,2
S01013206,Occupancy rating +1,112,58,17,41,52,6,33,19,8,6,13,7,6,2,1,0,0,1
S01013206,Occupancy rating 0,83,22,7,15,56,1,23,1,15,7,32,21,11,5,3,0,0,2
S01013206,Occupancy rating -1 or less,36,6,1,5,25,1,15,3,7,5,9,5,4,5,5,0,0,0
S01013207,All households,390,174,56,118,200,23,127,58,47,22,50,28,22,16,2,0,0,14
S01013207,Occupancy rating +2 or more,91,22,9,13,66,11,47,27,13,7,8,2,6,3,0,0,0,3
S01013207,Occupancy rating +1,98,37,10,27,57,10,33,17,10,6,14,8,6,4,2,0,0,2
S01013207,Occupancy rating 0,155,87,27,60,63,2,37,12,19,6,24,15,9,5,0,0,0,5
S01013207,Occupancy rating -1 or less,46,28,10,18,14,0,10,2,5,3,4,3,1,4,0,0,0,4
S01013208,All households,436,176,26,150,241,15,144,61,64,19,82,56,26,19,7,0,0,12
S01013208,Occupancy rating +2 or more,65,27,4,23,38,5,29,19,8,2,4,1,3,0,0,0,0,0
S01013208,Occupancy rating +1,146,60,10,50,82,2,56,28,21,7,24,17,7,4,0,0,0,4
S01013208,Occupancy rating 0,180,73,8,65,95,6,50,11,31,8,39,28,11,12,4,0,0,8
S01013208,Occupancy rating -1 or less,45,16,4,12,26,2,9,3,4,2,15,10,5,3,3,0,0,0
S01013209,All households,435,194,73,121,224,33,137,74,41,22,54,36,18,17,6,0,1,10
S01013209,Occupancy rating +2 or more,76,22,11,11,53,9,42,26,8,8,2,0,2,1,1,0,0,0
S01013209,Occupancy rating +1,141,77,34,43,59,15,37,27,7,3,7,4,3,5,1,0,1,3
S01013209,Occupancy rating 0,168,67,22,45,95,8,48,16,23,9,39,29,10,6,2,0,0,4
S01013209,Occupancy rating -1 or less,50,28,6,22,17,1,10,5,3,2,6,3,3,5,2,0,0,3
S01013210,All households,253,75,27,48,176,26,132,44,48,40,18,11,7,2,0,0,0,2
S01013210,Occupancy rating +2 or more,128,32,16,16,95,22,69,31,21,17,4,1,3,1,0,0,0,1
S01013210,Occupancy rating +1,59,20,4,16,38,2,31,8,12,11,5,3,2,1,0,0,0,1
S01013210,Occupancy rating 0,59,21,6,15,38,2,29,5,14,10,7,6,1,0,0,0,0,0
S01013210,Occupancy rating -1 or less,7,2,1,1,5,0,3,0,1,2,2,1,1,0,0,0,0,0
S01013211,All households,411,145,48,97,251,26,168,76,63,29,57,29,28,15,3,0,1,11
S01013211,Occupancy rating +2 or more,117,25,12,13,91,14,72,43,19,10,5,0,5,1,0,0,0,1
S01013211,Occupancy rating +1,109,50,16,34,53,5,42,24,13,5,6,1,5,6,0,0,1,5
S01013211,Occupancy rating 0,146,57,17,40,84,6,42,6,24,12,36,23,13,5,2,0,0,3
S01013211,Occupancy rating -1 or less,39,13,3,10,23,1,12,3,7,2,10,5,5,3,1,0,0,2
S01013212,All households,192,14,2,12,175,2,152,42,73,37,21,13,8,3,1,0,0,2
S01013212,Occupancy rating +2 or more,115,8,1,7,106,2,93,36,38,19,11,7,4,1,1,0,0,0
S01013212,Occupancy rating +1,47,6,1,5,40,0,36,4,22,10,4,3,1,1,0,0,0,1
S01013212,Occupancy rating 0,26,0,0,0,26,0,21,2,11,8,5,2,3,0,0,0,0,0
S01013212,Occupancy rating -1 or less,4,0,0,0,3,0,2,0,2,0,1,1,0,1,0,0,0,1
S01013213,All households,197,21,5,16,170,8,147,50,68,29,15,8,7,6,4,0,0,2
S01013213,Occupancy rating +2 or more,110,14,3,11,94,6,83,36,35,12,5,1,4,2,0,0,0,2
S01013213,Occupancy rating +1,58,5,2,3,51,2,41,12,16,13,8,5,3,2,2,0,0,0
S01013213,Occupancy rating 0,23,2,0,2,20,0,18,2,13,3,2,2,0,1,1,0,0,0
S01013213,Occupancy rating -1 or less,6,0,0,0,5,0,5,0,4,1,0,0,0,1,1,0,0,0
S01013214,All households,159,24,6,18,128,5,110,35,59,16,13,6,7,7,4,0,0,3
S01013214,Occupancy rating +2 or more,55,10,2,8,44,2,41,23,14,4,1,1,0,1,1,0,0,0
S01013214,Occupancy rating +1,63,13,4,9,47,1,44,10,25,9,2,2,0,3,1,0,0,2
S01013214,Occupancy rating 0,35,1,0,1,33,2,22,2,18,2,9,2,7,1,0,0,0,1
S01013214,Occupancy rating -1 or less,6,0,0,0,4,0,3,0,2,1,1,1,0,2,2,0,0,0
S01013215,All households,385,156,21,135,215,15,158,83,50,25,42,30,12,14,3,0,0,11
S01013215,Occupancy rating +2 or more,55,11,2,9,40,8,28,24,2,2,4,3,1,4,1,0,0,3
S01013215,Occupancy rating +1,133,54,10,44,76,4,61,39,11,11,11,5,6,3,0,0,0,3
S01013215,Occupancy rating 0,135,54,6,48,76,2,53,16,26,11,21,18,3,5,1,0,0,4
S01013215,Occupancy rating -1 or less,62,37,3,34,23,1,16,4,11,1,6,4,2,2,1,0,0,1
S01013216,All households,237,59,13,46,163,5,95,27,42,26,63,46,17,15,5,0,0,10
S01013216,Occupancy rating +2 or more,36,15,3,12,21,3,17,14,2,1,1,0,1,0,0,0,0,0
S01013216,Occupancy rating +1,93,30,7,23,58,2,37,11,18,8,19,12,7,5,0,0,0,5
S01013216,Occupancy rating 0,74,9,1,8,60,0,28,2,15,11,32,26,6,5,2,0,0,3
S01013216,Occupancy rating -1 or less,34,5,2,3,24,0,13,0,7,6,11,8,3,5,3,0,0,2
S01013217,All households,279,65,20,45,204,18,132,52,54,26,54,42,12,10,4,0,0,6
S01013217,Occupancy rating +2 or more,99,35,13,22,64,17,44,41,3,0,3,3,0,0,0,0,0,0
S01013217,Occupancy rating +1,96,22,4,18,69,1,48,8,23,17,20,13,7,5,3,0,0,2
S01013217,Occupancy rating 0,61,6,3,3,53,0,33,2,22,9,20,17,3,2,0,0,0,2
S01013217,Occupancy rating -1 or less,23,2,0,2,18,0,7,1,6,0,11,9,2,3,1,0,0,2
S01013218,All households,251,65,13,52,173,11,94,32,33,29,68,56,12,13,6,0,0,7
S01013218,Occupancy rating +2 or more,37,18,5,13,18,4,13,11,2,0,1,1,0,1,1,0,0,0
S01013218,Occupancy rating +1,87,35,5,30,51,5,38,18,9,11,8,3,5,1,0,0,0,1
S01013218,Occupancy rating 0,92,5,2,3,84,0,36,2,18,16,48,41,7,3,1,0,0,2
S01013218,Occupancy rating -1 or less,35,7,1,6,20,2,7,1,4,2,11,11,0,8,4,0,0,4
S01013219,All households,220,52,11,41,157,10,98,44,29,25,49,35,14,11,5,0,1,5
S01013219,Occupancy rating +2 or more,27,9,4,5,18,5,12,12,0,0,1,1,0,0,0,0,0,0
S01013219,Occupancy rating +1,89,36,7,29,51,4,40,28,7,5,7,3,4,2,0,0,0,2
S01013219,Occupancy rating 0,64,3,0,3,56,0,28,3,13,12,28,19,9,5,1,0,1,3
S01013219,Occupancy rating -1 or less,40,4,0,4,32,1,18,1,9,8,13,12,1,4,4,0,0,0
S01013220,All households,313,119,46,73,181,19,92,32,41,19,70,55,15,13,7,0,2,4
S01013220,Occupancy rating +2 or more,67,29,16,13,37,12,20,16,3,1,5,2,3,1,0,0,1,0
S01013220,Occupancy rating +1,111,51,15,36,55,4,37,12,17,8,14,10,4,5,2,0,1,2
S01013220,Occupancy rating 0,100,34,13,21,64,2,26,3,16,7,36,31,5,2,1,0,0,1
S01013220,Occupancy rating -1 or less,35,5,2,3,25,1,9,1,5,3,15,12,3,5,4,0,0,1
S01013221,All households,382,104,32,72,252,34,145,54,67,24,73,55,18,26,13,0,0,13
S01013221,Occupancy rating +2 or more,119,40,14,26,76,23,44,31,10,3,9,3,6,3,0,0,0,3
S01013221,Occupancy rating +1,128,38,9,29,80,7,56,18,25,13,17,13,4,10,5,0,0,5
S01013221,Occupancy rating 0,92,17,6,11,71,2,34,4,25,5,35,31,4,4,1,0,0,3
S01013221,Occupancy rating -1 or less,43,9,3,6,25,2,11,1,7,3,12,8,4,9,7,0,0,2
S01013222,All households,316,154,60,94,151,14,75,28,38,9,62,43,19,11,3,0,1,7
S01013222,Occupancy rating +2 or more,43,21,10,11,20,2,15,6,6,3,3,3,0,2,0,0,0,2
S01013222,Occupancy rating +1,100,53,16,37,47,7,31,15,16,0,9,7,2,0,0,0,0,0
S01013222,Occupancy rating 0,130,59,23,36,64,3,23,6,13,4,38,26,12,7,1,0,1,5
S01013222,Occupancy rating -1 or less,43,21,11,10,20,2,6,1,3,2,12,7,5,2,2,0,0,0
S01013223,All households,637,359,175,184,257,35,160,65,72,23,62,50,12,21,5,0,0,16
S01013223,Occupancy rating +2 or more,115,40,15,25,68,8,58,34,16,8,2,0,2,7,3,0,0,4
S01013223,Occupancy rating +1,210,119,31,88,86,18,57,23,29,5,11,10,1,5,0,0,0,5
S01013223,Occupancy rating 0,234,143,93,50,85,7,38,7,23,8,40,31,9,6,1,0,0,5
S01013223,Occupancy rating -1 or less,78,57,36,21,18,2,7,1,4,2,9,9,0,3,1,0,0,2
S01013224,All households,370,139,38,101,214,13,154,64,66,24,47,27,20,17,7,0,0,10
S01013224,Occupancy rating +2 or more,83,32,6,26,46,6,35,18,12,5,5,1,4,5,2,0,0,3
S01013224,Occupancy rating +1,99,29,9,20,68,2,47,25,16,6,19,7,12,2,0,0,0,2
S01013224,Occupancy rating 0,142,64,18,46,75,4,55,18,27,10,16,14,2,3,1,0,0,2
S01013224,Occupancy rating -1 or less,46,14,5,9,25,1,17,3,11,3,7,5,2,7,4,0,0,3
S01013225,All households,315,87,34,53,203,10,121,32,55,34,72,47,25,25,17,0,0,8
S01013225,Occupancy rating +2 or more,111,60,22,38,50,6,40,23,13,4,4,3,1,1,0,0,0,1
S01013225,Occupancy rating +1,98,17,8,9,74,1,44,7,16,21,29,16,13,7,2,0,0,5
S01013225,Occupancy rating 0,71,8,3,5,53,3,29,2,20,7,21,13,8,10,9,0,0,1
S01013225,Occupancy rating -1 or less,35,2,1,1,26,0,8,0,6,2,18,15,3,7,6,0,0,1
S01013226,All households,207,50,8,42,145,9,115,49,52,14,21,10,11,12,7,0,0,5
S01013226,Occupancy rating +2 or more,81,21,4,17,57,8,46,30,14,2,3,2,1,3,3,0,0,0
S01013226,Occupancy rating +1,87,25,4,21,60,1,49,17,24,8,10,4,6,2,0,0,0,2
S01013226,Occupancy rating 0,28,2,0,2,21,0,14,2,9,3,7,3,4,5,2,0,0,3
S01013226,Occupancy rating -1 or less,11,2,0,2,7,0,6,0,5,1,1,1,0,2,2,0,0,0
S01013227,All households,366,175,68,107,179,20,92,29,50,13,67,44,23,12,3,0,1,8
S01013227,Occupancy rating +2 or more,66,25,7,18,38,7,28,9,15,4,3,2,1,3,0,0,0,3
S01013227,Occupancy rating +1,134,76,34,42,57,10,32,18,9,5,15,10,5,1,0,0,0,1
S01013227,Occupancy rating 0,124,48,19,29,71,2,25,1,20,4,44,30,14,5,0,0,1,4
S01013227,Occupancy rating -1 or less,42,26,8,18,13,1,7,1,6,0,5,2,3,3,3,0,0,0
S01013228,All households,416,239,47,192,169,15,106,58,31,17,48,37,11,8,1,0,0,7
S01013228,Occupancy rating +2 or more,61,22,6,16,39,6,28,24,3,1,5,4,1,0,0,0,0,0
S01013228,Occupancy rating +1,133,91,25,66,40,2,27,23,2,2,11,7,4,2,1,0,0,1
S01013228,Occupancy rating 0,159,86,13,73,69,5,41,9,22,10,23,20,3,4,0,0,0,4
S01013228,Occupancy rating -1 or less,63,40,3,37,21,2,10,2,4,4,9,6,3,2,0,0,0,2
S01013229,All households,370,141,51,90,213,14,123,47,55,21,76,52,24,16,4,0,1,11
S01013229,Occupancy rating +2 or more,78,39,17,22,38,9,27,22,3,2,2,1,1,1,0,0,0,1
S01013229,Occupancy rating +1,138,62,20,42,73,4,57,24,22,11,12,7,5,3,0,0,0,3
S01013229,Occupancy rating 0,117,33,11,22,78,1,30,1,22,7,47,32,15,6,1,0,0,5
S01013229,Occupancy rating -1 or less,37,7,3,4,24,0,9,0,8,1,15,12,3,6,3,0,1,2
S01013230,All households,327,120,67,53,198,37,108,44,42,22,53,26,27,9,5,0,2,2
S01013230,Occupancy rating +2 or more,86,34,20,14,50,13,35,24,9,2,2,1,1,2,1,0,1,0
S01013230,Occupancy rating +1,116,41,24,17,71,15,34,13,12,9,22,9,13,4,1,0,1,2
S01013230,Occupancy rating 0,101,39,18,21,61,7,34,6,17,11,20,10,10,1,1,0,0,0
S01013230,Occupancy rating -1 or less,24,6,5,1,16,2,5,1,4,0,9,6,3,2,2,0,0,0
S01013231,All households,374,167,72,95,197,15,133,60,50,23,49,30,19,10,4,0,1,5
S01013231,Occupancy rating +2 or more,82,42,20,22,39,8,29,19,5,5,2,0,2,1,0,0,0,1
S01013231,Occupancy rating +1,127,58,19,39,66,4,52,34,13,5,10,5,5,3,0,0,0,3
S01013231,Occupancy rating 0,132,55,27,28,73,3,40,5,26,9,30,20,10,4,2,0,1,1
S01013231,Occupancy rating -1 or less,33,12,6,6,19,0,12,2,6,4,7,5,2,2,2,0,0,0
S01013232,All households,331,132,69,63,184,25,115,41,37,37,44,18,26,15,6,0,1,8
S01013232,Occupancy rating +2 or more,99,43,26,17,55,12,39,24,6,9,4,1,3,1,0,0,0,1
S01013232,Occupancy rating +1,116,47,24,23,61,10,37,11,15,11,14,3,11,8,2,0,0,6
S01013232,Occupancy rating 0,92,37,18,19,52,1,31,6,13,12,20,11,9,3,2,0,0,1
S01013232,Occupancy rating -1 or less,24,5,1,4,16,2,8,0,3,5,6,3,3,3,2,0,1,0
S01013233,All households,262,77,45,32,173,28,120,51,33,36,25,6,19,12,3,0,5,4
S01013233,Occupancy rating +2 or more,130,39,26,13,87,25,57,30,8,19,5,2,3,4,1,0,1,2
S01013233,Occupancy rating +1,58,13,7,6,42,2,32,17,5,10,8,2,6,3,0,0,2,1
S01013233,Occupancy rating 0,59,23,10,13,33,0,25,4,16,5,8,1,7,3,1,0,2,0
S01013233,Occupancy rating -1 or less,15,2,2,0,11,1,6,0,4,2,4,1,3,2,1,0,0,1
S01013234,All households,137,14,7,7,118,7,99,36,39,24,12,7,5,5,2,0,0,3
S01013234,Occupancy rating +2 or more,113,12,7,5,97,6,82,32,32,18,9,5,4,4,2,0,0,2
S01013234,Occupancy rating +1,15,1,0,1,14,1,11,3,5,3,2,1,1,0,0,0,0,0
S01013234,Occupancy rating 0,6,0,0,0,6,0,5,1,1,3,1,1,0,0,0,0,0,0
S01013234,Occupancy rating -1 or less,3,1,0,1,1,0,1,0,1,0,0,0,0,1,0,0,0,1
S01013235,All households,386,161,67,94,217,31,143,69,48,26,43,15,28,8,3,0,0,5
S01013235,Occupancy rating +2 or more,93,25,14,11,66,14,49,28,14,7,3,1,2,2,1,0,0,1
S01013235,Occupancy rating +1,150,71,33,38,78,13,50,33,10,7,15,1,14,1,1,0,0,0
S01013235,Occupancy rating 0,113,57,19,38,54,3,36,7,20,9,15,7,8,2,0,0,0,2
S01013235,Occupancy rating -1 or less,30,8,1,7,19,1,8,1,4,3,10,6,4,3,1,0,0,2
S01013236,All households,381,94,42,52,270,63,179,71,69,39,28,16,12,17,4,0,1,12
S01013236,Occupancy rating +2 or more,211,49,22,27,157,47,105,53,33,19,5,0,5,5,1,0,0,4
S01013236,Occupancy rating +1,101,32,16,16,65,13,43,13,16,14,9,5,4,4,0,0,0,4
S01013236,Occupancy rating 0,51,8,2,6,37,2,26,3,17,6,9,8,1,6,2,0,1,3
S01013236,Occupancy rating -1 or less,18,5,2,3,11,1,5,2,3,0,5,3,2,2,1,0,0,1
S01013237,All households,360,125,35,90,221,16,162,58,78,26,43,31,12,14,7,2,1,4
S01013237,Occupancy rating +2 or more,106,29,7,22,77,6,64,32,26,6,7,5,2,0,0,0,0,0
S01013237,Occupancy rating +1,150,74,25,49,75,8,58,26,22,10,9,6,3,1,1,0,0,0
S01013237,Occupancy rating 0,83,15,2,13,58,2,36,0,27,9,20,15,5,10,3,2,1,4
S01013237,Occupancy rating -1 or less,21,7,1,6,11,0,4,0,3,1,7,5,2,3,3,0,0,0
S01013238,All households,389,183,66,117,195,17,101,39,47,15,77,50,27,11,3,0,0,8
S01013238,Occupancy rating +2 or more,55,25,6,19,30,1,24,15,6,3,5,3,2,0,0,0,0,0
S01013238,Occupancy rating +1,132,72,24,48,57,12,36,20,14,2,9,7,2,3,0,0,0,3
S01013238,Occupancy rating 0,149,70,27,43,73,3,25,4,13,8,45,30,15,6,2,0,0,4
S01013238,Occupancy rating -1 or less,53,16,9,7,35,1,16,0,14,2,18,10,8,2,1,0,0,1
S01013239,All households,425,151,43,108,258,21,134,47,59,28,103,68,35,16,4,0,2,10
S01013239,Occupancy rating +2 or more,105,58,20,38,47,11,32,23,7,2,4,2,2,0,0,0,0,0
S01013239,Occupancy rating +1,179,75,15,60,98,9,57,23,18,16,32,18,14,6,1,0,0,5
S01013239,Occupancy rating 0,115,10,6,4,97,1,38,1,28,9,58,40,18,8,1,0,2,5
S01013239,Occupancy rating -1 or less,26,8,2,6,16,0,7,0,6,1,9,8,1,2,2,0,0,0
S01013240,All households,256,97,23,74,144,11,69,22,33,14,64,35,29,15,6,0,0,9
S01013240,Occupancy rating +2 or more,57,29,7,22,26,8,13,11,1,1,5,3,2,2,0,0,0,2
S01013240,Occupancy rating +1,89,37,3,34,48,3,29,11,13,5,16,9,7,4,0,0,0,4
S01013240,Occupancy rating 0,81,24,12,12,53,0,22,0,16,6,31,17,14,4,3,0,0,1
S01013240,Occupancy rating -1 or less,29,7,1,6,17,0,5,0,3,2,12,6,6,5,3,0,0,2
S01013241,All households,336,59,32,27,266,37,213,100,69,44,16,1,15,11,1,0,3,7
S01013241,Occupancy rating +2 or more,211,41,21,20,163,34,127,86,25,16,2,0,2,7,1,0,2,4
S01013241,Occupancy rating +1,83,15,8,7,65,2,52,11,24,17,11,0,11,3,0,0,1,2
S01013241,Occupancy rating 0,37,3,3,0,34,1,32,3,18,11,1,0,1,0,0,0,0,0
S01013241,Occupancy rating -1 or less,5,0,0,0,4,0,2,0,2,0,2,1,1,1,0,0,0,1
S01013242,All households,229,50,36,14,162,25,124,51,49,24,13,4,9,17,7,0,2,8
S01013242,Occupancy rating +2 or more,165,32,22,10,123,22,94,42,38,14,7,1,6,10,3,0,0,7
S01013242,Occupancy rating +1,39,12,9,3,26,2,22,6,7,9,2,0,2,1,1,0,0,0
S01013242,Occupancy rating 0,18,6,5,1,10,1,6,3,2,1,3,3,0,2,1,0,1,0
S01013242,Occupancy rating -1 or less,7,0,0,0,3,0,2,0,2,0,1,0,1,4,2,0,1,1
S01013243,All households,325,106,27,79,209,21,152,56,62,34,36,23,13,10,4,0,0,6
S01013243,Occupancy rating +2 or more,101,26,9,17,73,12,57,36,13,8,4,2,2,2,1,0,0,1
S01013243,Occupancy rating +1,102,43,11,32,56,4,46,19,19,8,6,2,4,3,0,0,0,3
S01013243,Occupancy rating 0,87,22,3,19,61,5,38,1,22,15,18,15,3,4,3,0,0,1
S01013243,Occupancy rating -1 or less,35,15,4,11,19,0,11,0,8,3,8,4,4,1,0,0,0,1
S01013244,All households,351,138,70,68,198,33,113,42,43,28,52,39,13,15,7,0,1,7
S01013244,Occupancy rating +2 or more,110,45,22,23,60,20,35,26,6,3,5,2,3,5,2,0,0,3
S01013244,Occupancy rating +1,106,38,16,22,66,8,42,12,15,15,16,11,5,2,0,0,1,1
S01013244,Occupancy rating 0,109,48,28,20,56,5,27,3,15,9,24,20,4,5,3,0,0,2
S01013244,Occupancy rating -1 or less,26,7,4,3,16,0,9,1,7,1,7,6,1,3,2,0,0,1
S01013245,All households,407,98,44,54,295,33,222,71,112,39,40,25,15,14,4,0,3,7
S01013245,Occupancy rating +2 or more,165,34,20,14,129,21,106,46,44,16,2,2,0,2,1,0,0,1
S01013245,Occupancy rating +1,126,41,20,21,80,11,61,18,31,12,8,4,4,5,1,0,1,3
S01013245,Occupancy rating 0,90,22,4,18,63,1,40,6,28,6,22,15,7,5,2,0,1,2
S01013245,Occupancy rating -1 or less,26,1,0,1,23,0,15,1,9,5,8,4,4,2,0,0,1,1
S01013246,All households,184,44,21,23,130,7,100,35,46,19,23,14,9,10,1,0,1,8
S01013246,Occupancy rating +2 or more,75,23,7,16,49,5,41,20,14,7,3,2,1,3,0,0,0,3
S01013246,Occupancy rating +1,51,17,13,4,32,2,28,12,11,5,2,2,0,2,0,0,0,2
S01013246,Occupancy rating 0,41,1,0,1,36,0,25,3,16,6,11,6,5,4,0,0,1,3
S01013246,Occupancy rating -1 or less,17,3,1,2,13,0,6,0,5,1,7,4,3,1,1,0,0,0
S01013247,All households,338,117,29,88,211,18,121,43,54,24,72,47,25,10,10,0,0,0
S01013247,Occupancy rating +2 or more,69,29,9,20,39,8,28,16,7,5,3,1,2,1,1,0,0,0
S01013247,Occupancy rating +1,129,65,12,53,63,8,40,22,10,8,15,7,8,1,1,0,0,0
S01013247,Occupancy rating 0,94,16,6,10,75,2,34,3,23,8,39,27,12,3,3,0,0,0
S01013247,Occupancy rating -1 or less,46,7,2,5,34,0,19,2,14,3,15,12,3,5,5,0,0,0
S01013248,All households,300,114,38,76,174,16,95,37,35,23,63,42,21,12,8,0,1,3
S01013248,Occupancy rating +2 or more,51,24,14,10,27,5,22,14,5,3,0,0,0,0,0,0,0,0
S01013248,Occupancy rating +1,118,60,20,40,57,9,33,21,8,4,15,9,6,1,0,0,1,0
S01013248,Occupancy rating 0,87,15,1,14,68,1,28,2,18,8,39,27,12,4,2,0,0,2
S01013248,Occupancy rating -1 or less,44,15,3,12,22,1,12,0,4,8,9,6,3,7,6,0,0,1
S01013249,All households,201,52,16,36,141,19,94,39,39,16,28,18,10,8,2,0,0,6
S01013249,Occupancy rating +2 or more,66,18,4,14,47,12,30,19,9,2,5,4,1,1,0,0,0,1
S01013249,Occupancy rating +1,64,22,8,14,40,5,30,17,10,3,5,3,2,2,1,0,0,1
S01013249,Occupancy rating 0,52,5,1,4,44,2,28,3,15,10,14,9,5,3,1,0,0,2
S01013249,Occupancy rating -1 or less,19,7,3,4,10,0,6,0,5,1,4,2,2,2,0,0,0,2
S01013250,All households,339,67,26,41,251,25,190,80,75,35,36,25,11,21,7,0,0,14
S01013250,Occupancy rating +2 or more,207,39,15,24,156,16,131,68,45,18,9,5,4,12,4,0,0,8
S01013250,Occupancy rating +1,82,22,8,14,58,8,39,11,16,12,11,9,2,2,1,0,0,1
S01013250,Occupancy rating 0,37,4,2,2,32,1,17,0,13,4,14,9,5,1,0,0,0,1
S01013250,Occupancy rating -1 or less,13,2,1,1,5,0,3,1,1,1,2,2,0,6,2,0,0,4
S01013251,All households,319,99,29,70,201,13,132,42,78,12,56,46,10,19,12,3,0,4
S01013251,Occupancy rating +2 or more,93,29,8,21,61,7,47,23,21,3,7,5,2,3,2,0,0,1
S01013251,Occupancy rating +1,103,51,12,39,49,6,31,14,14,3,12,10,2,3,2,1,0,0
S01013251,Occupancy rating 0,99,17,7,10,75,0,45,3,37,5,30,25,5,7,4,2,0,1
S01013251,Occupancy rating -1 or less,24,2,2,0,16,0,9,2,6,1,7,6,1,6,4,0,0,2
S01013252,All households,288,82,25,57,189,19,127,48,52,27,43,29,14,17,6,0,0,11
S01013252,Occupancy rating +2 or more,92,20,10,10,67,11,54,33,13,8,2,0,2,5,4,0,0,1
S01013252,Occupancy rating +1,90,36,4,32,50,5,33,13,10,10,12,5,7,4,1,0,0,3
S01013252,Occupancy rating 0,83,23,9,14,54,1,30,0,22,8,23,20,3,6,0,0,0,6
S01013252,Occupancy rating -1 or less,23,3,2,1,18,2,10,2,7,1,6,4,2,2,1,0,0,1
S01013253,All households,316,91,35,56,214,34,142,60,56,26,38,23,15,11,2,0,3,6
S01013253,Occupancy rating +2 or more,116,37,14,23,78,22,53,34,12,7,3,2,1,1,0,0,1,0
S01013253,Occupancy rating +1,99,26,14,12,68,10,47,20,17,10,11,7,4,5,0,0,1,4
S01013253,Occupancy rating 0,84,27,7,20,53,0,31,5,20,6,22,13,9,4,1,0,1,2
S01013253,Occupancy rating -1 or less,17,1,0,1,15,2,11,1,7,3,2,1,1,1,1,0,0,0
S01013254,All households,297,116,43,73,172,17,106,31,52,23,49,35,14,9,3,0,0,6
S01013254,Occupancy rating +2 or more,88,42,18,24,45,11,32,17,11,4,2,1,1,1,0,0,0,1
S01013254,Occupancy rating +1,104,48,15,33,53,3,35,10,15,10,15,10,5,3,0,0,0,3
S01013254,Occupancy rating 0,91,25,10,15,63,2,36,4,24,8,25,19,6,3,2,0,0,1
S01013254,Occupancy rating -1 or less,14,1,0,1,11,1,3,0,2,1,7,5,2,2,1,0,0,1
S01013255,All households,345,88,37,51,243,32,163,61,65,37,48,35,13,14,5,0,1,8
S01013255,Occupancy rating +2 or more,175,56,26,30,116,21,89,49,26,14,6,5,1,3,1,0,0,2
S01013255,Occupancy rating +1,79,17,8,9,58,10,34,10,14,10,14,9,5,4,0,0,0,4
S01013255,Occupancy rating 0,68,8,1,7,57,0,36,2,21,13,21,16,5,3,1,0,0,2
S01013255,Occupancy rating -1 or less,23,7,2,5,12,1,4,0,4,0,7,5,2,4,3,0,1,0
S01013256,All households,322,111,49,62,201,25,140,51,73,16,36,28,8,10,3,0,1,6
S01013256,Occupancy rating +2 or more,123,16,9,7,105,9,89,29,51,9,7,6,1,2,0,0,1,1
S01013256,Occupancy rating +1,90,40,15,25,49,11,27,17,6,4,11,7,4,1,0,0,0,1
S01013256,Occupancy rating 0,93,50,23,27,37,3,21,4,14,3,13,11,2,6,3,0,0,3
S01013256,Occupancy rating -1 or less,16,5,2,3,10,2,3,1,2,0,5,4,1,1,0,0,0,1
S01013257,All households,419,193,104,89,216,42,149,62,58,29,25,20,5,10,3,0,2,5
S01013257,Occupancy rating +2 or more,122,28,17,11,91,19,69,35,21,13,3,2,1,3,1,0,1,1
S01013257,Occupancy rating +1,96,41,20,21,53,9,41,21,12,8,3,3,0,2,0,0,0,2
S01013257,Occupancy rating 0,162,98,43,55,61,13,33,5,21,7,15,13,2,3,2,0,0,1
S01013257,Occupancy rating -1 or less,39,26,24,2,11,1,6,1,4,1,4,2,2,2,0,0,1,1
S01013258,All households,312,65,29,36,237,34,179,85,60,34,24,13,11,10,7,0,0,3
S01013258,Occupancy rating +2 or more,192,37,16,21,151,24,120,70,32,18,7,3,4,4,2,0,0,2
S01013258,Occupancy rating +1,67,18,8,10,48,7,37,14,12,11,4,1,3,1,1,0,0,0
S01013258,Occupancy rating 0,46,9,4,5,33,3,19,1,14,4,11,8,3,4,3,0,0,1
S01013258,Occupancy rating -1 or less,7,1,1,0,5,0,3,0,2,1,2,1,1,1,1,0,0,0
S01013259,All households,361,91,37,54,256,32,154,63,55,36,70,48,22,14,5,0,2,7
S01013259,Occupancy rating +2 or more,124,35,12,23,87,19,60,40,12,8,8,5,3,2,0,0,0,2
S01013259,Occupancy rating +1,132,49,24,25,78,10,51,21,17,13,17,12,5,5,1,0,1,3
S01013259,Occupancy rating 0,84,2,1,1,78,3,35,1,21,13,40,26,14,4,2,0,1,1
S01013259,Occupancy rating -1 or less,21,5,0,5,13,0,8,1,5,2,5,5,0,3,2,0,0,1
S01013260,All households,382,115,36,79,254,22,158,58,68,32,74,57,17,13,5,0,0,8
S01013260,Occupancy rating +2 or more,125,47,21,26,78,15,57,39,11,7,6,4,2,0,0,0,0,0
S01013260,Occupancy rating +1,116,40,10,30,73,4,50,16,19,15,19,13,6,3,0,0,0,3
S01013260,Occupancy rating 0,114,25,4,21,82,3,40,3,28,9,39,31,8,7,2,0,0,5
S01013260,Occupancy rating -1 or less,27,3,1,2,21,0,11,0,10,1,10,9,1,3,3,0,0,0
S01013261,All households,345,105,44,61,228,17,148,56,70,22,63,42,21,12,6,0,0,6
S01013261,Occupancy rating +2 or more,90,31,15,16,59,9,42,29,10,3,8,6,2,0,0,0,0,0
S01013261,Occupancy rating +1,131,58,23,35,70,7,51,25,16,10,12,6,6,3,2,0,0,1
S01013261,Occupancy rating 0,95,15,6,9,75,1,39,1,30,8,35,24,11,5,1,0,0,4
S01013261,Occupancy rating -1 or less,29,1,0,1,24,0,16,1,14,1,8,6,2,4,3,0,0,1
S01013262,All households,276,82,31,51,178,26,116,51,45,20,36,20,16,16,7,0,1,8
S01013262,Occupancy rating +2 or more,104,31,19,12,70,17,49,32,9,8,4,1,3,3,2,0,0,1
S01013262,Occupancy rating +1,68,18,3,15,44,3,30,13,13,4,11,6,5,6,0,0,1,5
S01013262,Occupancy rating 0,84,31,8,23,50,4,27,6,14,7,19,12,7,3,1,0,0,2
S01013262,Occupancy rating -1 or less,20,2,1,1,14,2,10,0,9,1,2,1,1,4,4,0,0,0
S01013263,All households,195,25,14,11,161,11,134,48,70,16,16,8,8,9,3,0,0,6
S01013263,Occupancy rating +2 or more,154,16,10,6,131,8,118,44,63,11,5,4,1,7,3,0,0,4
S01013263,Occupancy rating +1,28,4,2,2,23,3,13,4,4,5,7,1,6,1,0,0,0,1
S01013263,Occupancy rating 0,10,4,2,2,5,0,2,0,2,0,3,2,1,1,0,0,0,1
S01013263,Occupancy rating -1 or less,3,1,0,1,2,0,1,0,1,0,1,1,0,0,0,0,0,0
S01013264,All households,163,11,2,9,147,9,127,26,86,15,11,7,4,5,2,0,0,3
S01013264,Occupancy rating +2 or more,142,10,2,8,129,9,112,26,74,12,8,5,3,3,1,0,0,2
S01013264,Occupancy rating +1,17,1,0,1,15,0,13,0,10,3,2,2,0,1,0,0,0,1
S01013264,Occupancy rating 0,4,0,0,0,3,0,2,0,2,0,1,0,1,1,1,0,0,0
S01013264,Occupancy rating -1 or less,0,0,0,0,0,0,0,0,0,0,0,0,0,0,0,0,0,0
S01013265,All households,201,10,2,8,183,4,166,45,101,20,13,11,2,8,7,0,0,1
S01013265,Occupancy rating +2 or more,189,9,1,8,173,2,161,44,99,18,10,8,2,7,6,0,0,1
S01013265,Occupancy rating +1,5,0,0,0,4,2,1,0,1,0,1,1,0,1,1,0,0,0
S01013265,Occupancy rating 0,6,1,1,0,5,0,3,1,1,1,2,2,0,0,0,0,0,0
S01013265,Occupancy rating -1 or less,1,0,0,0,1,0,1,0,0,1,0,0,0,0,0,0,0,0
S01013266,All households,189,20,5,15,162,6,145,44,83,18,11,7,4,7,6,0,0,1
S01013266,Occupancy rating +2 or more,154,14,5,9,139,6,125,39,71,15,8,6,2,1,0,0,0,1
S01013266,Occupancy rating +1,25,6,0,6,16,0,14,4,8,2,2,1,1,3,3,0,0,0
S01013266,Occupancy rating 0,4,0,0,0,4,0,3,1,2,0,1,0,1,0,0,0,0,0
S01013266,Occupancy rating -1 or less,6,0,0,0,3,0,3,0,2,1,0,0,0,3,3,0,0,0
S01013267,All households,237,75,27,48,152,13,102,42,45,15,37,31,6,10,4,0,0,6
S01013267,Occupancy rating +2 or more,87,24,8,16,60,8,49,32,12,5,3,2,1,3,0,0,0,3
S01013267,Occupancy rating +1,69,19,6,13,47,1,32,7,17,8,14,13,1,3,3,0,0,0
S01013267,Occupancy rating 0,73,30,13,17,41,4,20,3,15,2,17,14,3,2,1,0,0,1
S01013267,Occupancy rating -1 or less,8,2,0,2,4,0,1,0,1,0,3,2,1,2,0,0,0,2
S01013268,All households,328,76,28,48,228,20,155,53,63,39,53,41,12,24,15,0,0,9
S01013268,Occupancy rating +2 or more,121,31,9,22,85,15,64,37,15,12,6,4,2,5,1,0,0,4
S01013268,Occupancy rating +1,89,17,3,14,67,4,46,12,18,16,17,12,5,5,3,0,0,2
S01013268,Occupancy rating 0,95,24,14,10,63,1,42,4,29,9,20,17,3,8,6,0,0,2
S01013268,Occupancy rating -1 or less,23,4,2,2,13,0,3,0,1,2,10,8,2,6,5,0,0,1
S01013269,All households,379,77,17,60,287,20,233,95,110,28,34,29,5,15,5,0,0,10
S01013269,Occupancy rating +2 or more,221,27,9,18,191,19,164,74,68,22,8,6,2,3,2,0,0,1
S01013269,Occupancy rating +1,78,29,7,22,48,0,37,12,23,2,11,9,2,1,1,0,0,0
S01013269,Occupancy rating 0,56,19,1,18,34,1,25,8,14,3,8,7,1,3,1,0,0,2
S01013269,Occupancy rating -1 or less,24,2,0,2,14,0,7,1,5,1,7,7,0,8,1,0,0,7
S01013270,All households,285,37,10,27,239,17,209,66,124,19,13,9,4,9,2,0,0,7
S01013270,Occupancy rating +2 or more,238,30,8,22,205,16,179,62,102,15,10,7,3,3,2,0,0,1
S01013270,Occupancy rating +1,34,7,2,5,24,1,21,4,14,3,2,2,0,3,0,0,0,3
S01013270,Occupancy rating 0,11,0,0,0,8,0,8,0,7,1,0,0,0,3,0,0,0,3
S01013270,Occupancy rating -1 or less,2,0,0,0,2,0,1,0,1,0,1,0,1,0,0,0,0,0
S01013271,All households,242,33,21,12,203,30,161,82,55,24,12,7,5,6,1,0,1,4
S01013271,Occupancy rating +2 or more,223,31,19,12,188,29,149,81,48,20,10,5,5,4,1,0,1,2
S01013271,Occupancy rating +1,13,2,2,0,10,0,10,1,6,3,0,0,0,1,0,0,0,1
S01013271,Occupancy rating 0,5,0,0,0,5,1,2,0,1,1,2,2,0,0,0,0,0,0
S01013271,Occupancy rating -1 or less,1,0,0,0,0,0,0,0,0,0,0,0,0,1,0,0,0,1
S01013272,All households,253,30,12,18,208,8,183,52,109,22,17,14,3,15,9,0,0,6
S01013272,Occupancy rating +2 or more,221,26,10,16,186,5,169,50,98,21,12,9,3,9,5,0,0,4
S01013272,Occupancy rating +1,24,2,1,1,17,3,9,2,7,0,5,5,0,5,3,0,0,2
S01013272,Occupancy rating 0,4,0,0,0,4,0,4,0,3,1,0,0,0,0,0,0,0,0
S01013272,Occupancy rating -1 or less,4,2,1,1,1,0,1,0,1,0,0,0,0,1,1,0,0,0
S01013273,All households,291,20,6,14,259,11,229,41,161,27,19,16,3,12,7,0,0,5
S01013273,Occupancy rating +2 or more,242,19,6,13,216,11,195,37,137,21,10,7,3,7,4,0,0,3
S01013273,Occupancy rating +1,31,1,0,1,27,0,25,4,17,4,2,2,0,3,2,0,0,1
S01013273,Occupancy rating 0,12,0,0,0,11,0,7,0,5,2,4,4,0,1,0,0,0,1
S01013273,Occupancy rating -1 or less,6,0,0,0,5,0,2,0,2,0,3,3,0,1,1,0,0,0
S01013274,All households,348,87,25,62,252,32,182,94,58,30,38,26,12,9,6,0,0,3
S01013274,Occupancy rating +2 or more,190,33,17,16,153,26,116,68,29,19,11,5,6,4,2,0,0,2
S01013274,Occupancy rating +1,93,37,6,31,55,6,43,19,18,6,6,4,2,1,1,0,0,0
S01013274,Occupancy rating 0,51,13,2,11,37,0,20,6,9,5,17,15,2,1,0,0,0,1
S01013274,Occupancy rating -1 or less,14,4,0,4,7,0,3,1,2,0,4,2,2,3,3,0,0,0
S01013275,All households,253,42,12,30,196,11,160,76,70,14,25,17,8,15,11,0,0,4
S01013275,Occupancy rating +2 or more,166,34,11,23,128,9,112,69,36,7,7,3,4,4,2,0,0,2
S01013275,Occupancy rating +1,50,5,0,5,39,2,32,7,20,5,5,2,3,6,5,0,0,1
S01013275,Occupancy rating 0,30,3,1,2,23,0,12,0,10,2,11,10,1,4,3,0,0,1
S01013275,Occupancy rating -1 or less,7,0,0,0,6,0,4,0,4,0,2,2,0,1,1,0,0,0
S01013276,All households,233,43,12,31,185,11,157,59,68,30,17,12,5,5,3,0,0,2
S01013276,Occupancy rating +2 or more,133,27,9,18,104,8,91,43,29,19,5,3,2,2,1,0,0,1
S01013276,Occupancy rating +1,54,6,1,5,47,3,37,11,19,7,7,6,1,1,1,0,0,0
S01013276,Occupancy rating 0,37,7,1,6,29,0,27,5,18,4,2,1,1,1,0,0,0,1
S01013276,Occupancy rating -1 or less,9,3,1,2,5,0,2,0,2,0,3,2,1,1,1,0,0,0
S01013277,All households,363,83,40,43,262,17,174,74,66,34,71,43,28,18,11,0,0,7
S01013277,Occupancy rating +2 or more,126,30,14,16,93,10,71,52,14,5,12,8,4,3,1,0,0,2
S01013277,Occupancy rating +1,122,31,12,19,89,5,58,19,25,14,26,16,10,2,1,0,0,1
S01013277,Occupancy rating 0,90,18,13,5,64,2,35,3,21,11,27,15,12,8,6,0,0,2
S01013277,Occupancy rating -1 or less,25,4,1,3,16,0,10,0,6,4,6,4,2,5,3,0,0,2
S01013278,All households,322,98,34,64,210,20,133,45,61,27,57,41,16,14,8,0,0,6
S01013278,Occupancy rating +2 or more,112,38,8,30,72,12,50,31,12,7,10,6,4,2,2,0,0,0
S01013278,Occupancy rating +1,85,25,11,14,58,5,34,6,22,6,19,14,5,2,0,0,0,2
S01013278,Occupancy rating 0,94,33,14,19,54,3,37,7,20,10,14,11,3,7,3,0,0,4
S01013278,Occupancy rating -1 or less,31,2,1,1,26,0,12,1,7,4,14,10,4,3,3,0,0,0
S01013279,All households,299,82,26,56,190,11,108,38,53,17,71,52,19,27,11,0,1,15
S01013279,Occupancy rating +2 or more,82,29,10,19,52,8,38,26,7,5,6,4,2,1,0,0,1,0
S01013279,Occupancy rating +1,85,24,5,19,54,1,26,5,13,8,27,16,11,7,1,0,0,6
S01013279,Occupancy rating 0,95,25,10,15,63,1,32,7,22,3,30,24,6,7,4,0,0,3
S01013279,Occupancy rating -1 or less,37,4,1,3,21,1,12,0,11,1,8,8,0,12,6,0,0,6
S01013280,All households,227,56,32,24,161,18,122,37,54,31,21,16,5,10,2,0,1,7
S01013280,Occupancy rating +2 or more,110,34,20,14,74,13,60,31,16,13,1,0,1,2,0,0,0,2
S01013280,Occupancy rating +1,64,13,6,7,45,3,30,5,16,9,12,10,2,6,1,0,1,4
S01013280,Occupancy rating 0,42,6,5,1,35,1,27,1,18,8,7,5,2,1,0,0,0,1
S01013280,Occupancy rating -1 or less,11,3,1,2,7,1,5,0,4,1,1,1,0,1,1,0,0,0
S01013281,All households,384,109,61,48,246,26,169,56,76,37,51,33,18,29,18,0,0,11
S01013281,Occupancy rating +2 or more,124,39,15,24,78,14,57,32,15,10,7,4,3,7,5,0,0,2
S01013281,Occupancy rating +1,121,32,18,14,85,8,63,23,27,13,14,8,6,4,1,0,0,3
S01013281,Occupancy rating 0,94,29,21,8,57,2,37,0,26,11,18,13,5,8,3,0,0,5
S01013281,Occupancy rating -1 or less,45,9,7,2,26,2,12,1,8,3,12,8,4,10,9,0,0,1
S01013282,All households,346,119,29,90,190,2,133,43,67,23,55,39,16,37,16,0,1,20
S01013282,Occupancy rating +2 or more,76,43,12,31,30,1,27,18,5,4,2,2,0,3,0,0,0,3
S01013282,Occupancy rating +1,119,37,8,29,65,1,48,17,23,8,16,9,7,17,5,0,0,12
S01013282,Occupancy rating 0,112,29,9,20,72,0,45,6,31,8,27,21,6,11,6,0,1,4
S01013282,Occupancy rating -1 or less,39,10,0,10,23,0,13,2,8,3,10,7,3,6,5,0,0,1
S01013283,All households,310,106,11,95,168,10,123,73,44,6,35,27,8,36,3,1,0,32
S01013283,Occupancy rating +2 or more,44,14,1,13,28,5,22,14,7,1,1,0,1,2,0,0,0,2
S01013283,Occupancy rating +1,123,55,4,51,64,3,55,46,8,1,6,4,2,4,1,0,0,3
S01013283,Occupancy rating 0,114,33,5,28,59,1,38,11,24,3,20,16,4,22,1,0,0,21
S01013283,Occupancy rating -1 or less,29,4,1,3,17,1,8,2,5,1,8,7,1,8,1,1,0,6
S01013284,All households,301,97,17,80,200,18,156,77,64,15,26,18,8,4,0,1,0,3
S01013284,Occupancy rating +2 or more,101,18,4,14,81,8,70,42,23,5,3,1,2,2,0,1,0,1
S01013284,Occupancy rating +1,90,30,6,24,59,8,44,25,14,5,7,5,2,1,0,0,0,1
S01013284,Occupancy rating 0,89,38,7,31,50,1,39,9,25,5,10,7,3,1,0,0,0,1
S01013284,Occupancy rating -1 or less,21,11,0,11,10,1,3,1,2,0,6,5,1,0,0,0,0,0
S01013285,All households,269,60,18,42,196,17,145,61,58,26,34,22,12,13,8,0,0,5
S01013285,Occupancy rating +2 or more,97,19,8,11,77,11,61,32,20,9,5,2,3,1,1,0,0,0
S01013285,Occupancy rating +1,92,35,8,27,54,5,41,26,11,4,8,4,4,3,1,0,0,2
S01013285,Occupancy rating 0,63,5,1,4,52,1,37,3,22,12,14,12,2,6,3,0,0,3
S01013285,Occupancy rating -1 or less,17,1,1,0,13,0,6,0,5,1,7,4,3,3,3,0,0,0
S01013286,All households,284,68,14,54,213,19,162,70,64,28,32,22,10,3,0,0,0,3
S01013286,Occupancy rating +2 or more,115,16,4,12,97,14,75,40,24,11,8,4,4,2,0,0,0,2
S01013286,Occupancy rating +1,105,41,9,32,64,5,51,21,17,13,8,4,4,0,0,0,0,0
S01013286,Occupancy rating 0,48,10,1,9,37,0,23,8,13,2,14,13,1,1,0,0,0,1
S01013286,Occupancy rating -1 or less,16,1,0,1,15,0,13,1,10,2,2,1,1,0,0,0,0,0
S01013287,All households,282,44,14,30,229,12,192,57,94,41,25,15,10,9,3,0,0,6
S01013287,Occupancy rating +2 or more,195,28,8,20,164,9,144,46,66,32,11,6,5,3,1,0,0,2
S01013287,Occupancy rating +1,53,9,4,5,40,2,32,10,16,6,6,2,4,4,1,0,0,3
S01013287,Occupancy rating 0,26,6,2,4,19,1,13,1,9,3,5,4,1,1,0,0,0,1
S01013287,Occupancy rating -1 or less,8,1,0,1,6,0,3,0,3,0,3,3,0,1,1,0,0,0
S01013288,All households,315,115,51,64,186,25,126,55,63,8,35,22,13,14,4,0,1,9
S01013288,Occupancy rating +2 or more,117,28,12,16,86,16,62,27,32,3,8,4,4,3,2,0,0,1
S01013288,Occupancy rating +1,105,44,19,25,59,9,38,23,14,1,12,8,4,2,0,0,0,2
S01013288,Occupancy rating 0,71,33,16,17,32,0,20,4,13,3,12,7,5,6,1,0,0,5
S01013288,Occupancy rating -1 or less,22,10,4,6,9,0,6,1,4,1,3,3,0,3,1,0,1,1
S01013289,All households,303,65,28,37,229,30,176,68,85,23,23,18,5,9,2,0,1,6
S01013289,Occupancy rating +2 or more,198,41,11,30,151,17,125,51,59,15,9,9,0,6,2,0,0,4
S01013289,Occupancy rating +1,78,21,14,7,55,11,37,15,17,5,7,5,2,2,0,0,0,2
S01013289,Occupancy rating 0,20,2,2,0,17,1,11,2,6,3,5,2,3,1,0,0,1,0
S01013289,Occupancy rating -1 or less,7,1,1,0,6,1,3,0,3,0,2,2,0,0,0,0,0,0
S01013290,All households,361,94,27,67,250,14,193,58,109,26,43,28,15,17,6,0,1,10
S01013290,Occupancy rating +2 or more,133,37,13,24,91,5,81,36,38,7,5,2,3,5,3,0,0,2
S01013290,Occupancy rating +1,133,40,12,28,90,7,66,19,40,7,17,12,5,3,0,0,0,3
S01013290,Occupancy rating 0,74,12,1,11,57,0,40,3,26,11,17,12,5,5,1,0,1,3
S01013290,Occupancy rating -1 or less,21,5,1,4,12,2,6,0,5,1,4,2,2,4,2,0,0,2
S01013291,All households,257,38,5,33,214,5,172,47,97,28,37,27,10,5,2,0,0,3
S01013291,Occupancy rating +2 or more,96,23,4,19,73,4,66,38,23,5,3,2,1,0,0,0,0,0
S01013291,Occupancy rating +1,91,12,1,11,76,0,56,7,35,14,20,14,6,3,0,0,0,3
S01013291,Occupancy rating 0,56,2,0,2,53,1,42,1,32,9,10,8,2,1,1,0,0,0
S01013291,Occupancy rating -1 or less,14,1,0,1,12,0,8,1,7,0,4,3,1,1,1,0,0,0
S01013292,All households,284,49,18,31,226,21,176,71,59,46,29,15,14,9,5,0,0,4
S01013292,Occupancy rating +2 or more,169,35,13,22,130,17,109,58,28,23,4,2,2,4,1,0,0,3
S01013292,Occupancy rating +1,66,8,4,4,57,1,41,10,19,12,15,8,7,1,0,0,0,1
S01013292,Occupancy rating 0,43,4,1,3,36,2,25,3,11,11,9,5,4,3,3,0,0,0
S01013292,Occupancy rating -1 or less,6,2,0,2,3,1,1,0,1,0,1,0,1,1,1,0,0,0
S01013293,All households,273,49,16,33,214,21,176,66,85,25,17,12,5,10,4,0,0,6
S01013293,Occupancy rating +2 or more,172,24,8,16,143,19,117,50,49,18,7,4,3,5,1,0,0,4
S01013293,Occupancy rating +1,57,15,5,10,41,2,35,11,18,6,4,4,0,1,1,0,0,0
S01013293,Occupancy rating 0,38,8,1,7,26,0,22,4,17,1,4,2,2,4,2,0,0,2
S01013293,Occupancy rating -1 or less,6,2,2,0,4,0,2,1,1,0,2,2,0,0,0,0,0,0
S01013294,All households,306,83,25,58,211,13,153,57,65,31,45,29,16,12,5,0,0,7
S01013294,Occupancy rating +2 or more,104,19,4,15,81,9,66,33,21,12,6,2,4,4,3,0,0,1
S01013294,Occupancy rating +1,115,43,19,24,69,4,54,19,23,12,11,7,4,3,1,0,0,2
S01013294,Occupancy rating 0,62,10,0,10,48,0,29,5,18,6,19,16,3,4,0,0,0,4
S01013294,Occupancy rating -1 or less,25,11,2,9,13,0,4,0,3,1,9,4,5,1,1,0,0,0
S01013295,All households,324,94,16,78,224,19,166,67,64,35,39,23,16,6,3,0,0,3
S01013295,Occupancy rating +2 or more,109,21,5,16,87,14,67,32,24,11,6,3,3,1,0,0,0,1
S01013295,Occupancy rating +1,91,26,5,21,65,5,52,28,13,11,8,3,5,0,0,0,0,0
S01013295,Occupancy rating 0,94,37,5,32,53,0,36,6,18,12,17,10,7,4,2,0,0,2
S01013295,Occupancy rating -1 or less,30,10,1,9,19,0,11,1,9,1,8,7,1,1,1,0,0,0
S01013296,All households,310,95,45,50,194,26,111,41,31,39,57,30,27,21,9,0,1,11
S01013296,Occupancy rating +2 or more,123,59,30,29,62,18,40,28,7,5,4,1,3,2,0,0,0,2
S01013296,Occupancy rating +1,86,23,7,16,59,6,33,11,4,18,20,6,14,4,1,0,1,2
S01013296,Occupancy rating 0,74,7,3,4,56,2,30,0,14,16,24,16,8,11,5,0,0,6
S01013296,Occupancy rating -1 or less,27,6,5,1,17,0,8,2,6,0,9,7,2,4,3,0,0,1
S01013297,All households,308,107,51,56,192,23,135,47,62,26,34,20,14,9,3,0,0,6
S01013297,Occupancy rating +2 or more,118,46,21,25,70,17,45,31,10,4,8,6,2,2,0,0,0,2
S01013297,Occupancy rating +1,72,17,6,11,54,4,41,11,19,11,9,3,6,1,0,0,0,1
S01013297,Occupancy rating 0,94,35,19,16,54,2,38,3,26,9,14,9,5,5,3,0,0,2
S01013297,Occupancy rating -1 or less,24,9,5,4,14,0,11,2,7,2,3,2,1,1,0,0,0,1
S01013298,All households,310,99,46,53,196,42,113,46,42,25,41,24,17,15,3,0,0,12
S01013298,Occupancy rating +2 or more,124,42,22,20,80,20,52,26,16,10,8,5,3,2,1,0,0,1
S01013298,Occupancy rating +1,107,44,21,23,57,19,32,19,10,3,6,4,2,6,0,0,0,6
S01013298,Occupancy rating 0,59,13,3,10,46,3,23,0,11,12,20,12,8,0,0,0,0,0
S01013298,Occupancy rating -1 or less,20,0,0,0,13,0,6,1,5,0,7,3,4,7,2,0,0,5
S01013299,All households,424,109,43,66,299,33,209,73,96,40,57,42,15,16,9,0,0,7
S01013299,Occupancy rating +2 or more,161,43,13,30,115,17,90,45,33,12,8,7,1,3,1,0,0,2
S01013299,Occupancy rating +1,156,48,24,24,102,12,77,25,39,13,13,9,4,6,3,0,0,3
S01013299,Occupancy rating 0,84,15,5,10,65,4,32,2,19,11,29,21,8,4,3,0,0,1
S01013299,Occupancy rating -1 or less,23,3,1,2,17,0,10,1,5,4,7,5,2,3,2,0,0,1
S01013300,All households,264,90,37,53,157,22,108,54,37,17,27,12,15,17,5,0,3,9
S01013300,Occupancy rating +2 or more,93,24,7,17,66,12,51,34,16,1,3,1,2,3,0,0,0,3
S01013300,Occupancy rating +1,92,41,19,22,49,10,30,16,10,4,9,5,4,2,0,0,0,2
S01013300,Occupancy rating 0,62,21,9,12,32,0,18,3,6,9,14,6,8,9,4,0,2,3
S01013300,Occupancy rating -1 or less,17,4,2,2,10,0,9,1,5,3,1,0,1,3,1,0,1,1
S01013301,All households,217,65,31,34,135,20,82,32,27,23,33,18,15,17,7,0,0,10
S01013301,Occupancy rating +2 or more,88,36,23,13,48,13,29,21,3,5,6,2,4,4,1,0,0,3
S01013301,Occupancy rating +1,66,18,6,12,44,4,29,10,10,9,11,6,5,4,0,0,0,4
S01013301,Occupancy rating 0,49,10,2,8,34,2,20,1,12,7,12,8,4,5,2,0,0,3
S01013301,Occupancy rating -1 or less,14,1,0,1,9,1,4,0,2,2,4,2,2,4,4,0,0,0
S01013302,All households,270,79,25,54,180,21,147,73,54,20,12,10,2,11,7,0,0,4
S01013302,Occupancy rating +2 or more,143,37,12,25,103,14,87,50,27,10,2,1,1,3,1,0,0,2
S01013302,Occupancy rating +1,75,21,5,16,50,5,42,18,16,8,3,2,1,4,2,0,0,2
S01013302,Occupancy rating 0,42,19,8,11,21,2,16,5,10,1,3,3,0,2,2,0,0,0
S01013302,Occupancy rating -1 or less,10,2,0,2,6,0,2,0,1,1,4,4,0,2,2,0,0,0
S01013303,All households,384,109,73,36,246,37,184,87,62,35,25,12,13,29,6,0,0,23
S01013303,Occupancy rating +2 or more,222,58,34,24,155,28,121,74,29,18,6,5,1,9,0,0,0,9
S01013303,Occupancy rating +1,81,13,7,6,60,6,41,10,16,15,13,3,10,8,2,0,0,6
S01013303,Occupancy rating 0,67,35,29,6,25,3,17,3,13,1,5,3,2,7,2,0,0,5
S01013303,Occupancy rating -1 or less,14,3,3,0,6,0,5,0,4,1,1,1,0,5,2,0,0,3
S01013304,All households,422,155,32,123,226,21,139,52,65,22,66,41,25,41,15,0,0,26
S01013304,Occupancy rating +2 or more,119,47,18,29,70,20,44,27,12,5,6,6,0,2,0,0,0,2
S01013304,Occupancy rating +1,142,60,1,59,72,0,43,15,18,10,29,16,13,10,1,0,0,9
S01013304,Occupancy rating 0,121,39,11,28,65,1,37,8,24,5,27,16,11,17,8,0,0,9
S01013304,Occupancy rating -1 or less,40,9,2,7,19,0,15,2,11,2,4,3,1,12,6,0,0,6
S01013305,All households,444,150,58,92,260,23,176,96,58,22,61,42,19,34,4,0,0,30
S01013305,Occupancy rating +2 or more,128,55,23,32,71,9,58,46,8,4,4,1,3,2,0,0,0,2
S01013305,Occupancy rating +1,161,49,12,37,108,8,74,39,23,12,26,18,8,4,1,0,0,3
S01013305,Occupancy rating 0,115,39,20,19,59,5,32,8,20,4,22,16,6,17,1,0,0,16
S01013305,Occupancy rating -1 or less,40,7,3,4,22,1,12,3,7,2,9,7,2,11,2,0,0,9
S01013306,All households,501,245,48,197,217,7,119,70,41,8,91,73,18,39,8,0,1,30
S01013306,Occupancy rating +2 or more,101,64,20,44,35,4,29,26,2,1,2,2,0,2,1,0,0,1
S01013306,Occupancy rating +1,222,129,14,115,85,0,57,37,14,6,28,20,8,8,0,0,0,8
S01013306,Occupancy rating 0,136,39,11,28,76,3,28,7,20,1,45,37,8,21,5,0,1,15
S01013306,Occupancy rating -1 or less,42,13,3,10,21,0,5,0,5,0,16,14,2,8,2,0,0,6
S01013307,All households,436,136,36,100,250,10,177,72,84,21,63,41,22,50,26,0,0,24
S01013307,Occupancy rating +2 or more,133,59,20,39,73,6,59,45,11,3,8,4,4,1,0,0,0,1
S01013307,Occupancy rating +1,144,53,7,46,76,0,57,20,24,13,19,11,8,15,2,0,0,13
S01013307,Occupancy rating 0,115,18,8,10,81,3,47,5,37,5,31,22,9,16,10,0,0,6
S01013307,Occupancy rating -1 or less,44,6,1,5,20,1,14,2,12,0,5,4,1,18,14,0,0,4
S01013308,All households,374,96,15,81,251,10,128,40,72,16,113,81,32,27,15,0,0,12
S01013308,Occupancy rating +2 or more,82,42,10,32,39,6,27,19,7,1,6,4,2,1,0,0,0,1
S01013308,Occupancy rating +1,130,41,3,38,84,3,46,15,28,3,35,22,13,5,1,0,0,4
S01013308,Occupancy rating 0,117,10,2,8,96,1,45,5,31,9,50,39,11,11,5,0,0,6
S01013308,Occupancy rating -1 or less,45,3,0,3,32,0,10,1,6,3,22,16,6,10,9,0,0,1
S01013309,All households,236,52,11,41,168,11,134,52,63,19,23,18,5,16,8,0,0,8
S01013309,Occupancy rating +2 or more,137,26,9,17,105,9,89,30,44,15,7,4,3,6,4,0,0,2
S01013309,Occupancy rating +1,49,17,0,17,31,2,26,14,10,2,3,2,1,1,1,0,0,0
S01013309,Occupancy rating 0,38,7,1,6,25,0,17,6,9,2,8,7,1,6,2,0,0,4
S01013309,Occupancy rating -1 or less,12,2,1,1,7,0,2,2,0,0,5,5,0,3,1,0,0,2
S01013310,All households,241,42,21,21,184,19,126,34,67,25,39,29,10,15,9,0,1,5
S01013310,Occupancy rating +2 or more,85,25,12,13,59,13,42,31,7,4,4,3,1,1,1,0,0,0
S01013310,Occupancy rating +1,73,7,2,5,63,2,44,2,29,13,17,13,4,3,0,0,1,2
S01013310,Occupancy rating 0,58,10,7,3,45,4,31,1,24,6,10,8,2,3,1,0,0,2
S01013310,Occupancy rating -1 or less,25,0,0,0,17,0,9,0,7,2,8,5,3,8,7,0,0,1
S01013311,All households,313,71,25,46,216,13,150,64,59,27,53,39,14,26,13,0,0,13
S01013311,Occupancy rating +2 or more,116,36,15,21,77,11,62,51,7,4,4,2,2,3,0,0,0,3
S01013311,Occupancy rating +1,101,26,5,21,71,2,49,11,26,12,20,14,6,4,0,0,0,4
S01013311,Occupancy rating 0,71,8,4,4,51,0,31,1,20,10,20,18,2,12,9,0,0,3
S01013311,Occupancy rating -1 or less,25,1,1,0,17,0,8,1,6,1,9,5,4,7,4,0,0,3
S01013312,All households,486,192,46,146,263,34,169,67,83,19,60,38,22,31,10,0,0,21
S01013312,Occupancy rating +2 or more,171,69,32,37,100,29,65,42,15,8,6,4,2,2,0,0,0,2
S01013312,Occupancy rating +1,166,76,7,69,84,3,61,21,33,7,20,10,10,6,2,0,0,4
S01013312,Occupancy rating 0,112,41,6,35,60,1,37,3,30,4,22,16,6,11,3,0,0,8
S01013312,Occupancy rating -1 or less,37,6,1,5,19,1,6,1,5,0,12,8,4,12,5,0,0,7
S01013313,All households,276,77,28,49,174,21,109,38,50,21,44,31,13,25,8,0,1,16
S01013313,Occupancy rating +2 or more,126,57,23,34,65,18,38,31,6,1,9,5,4,4,0,0,0,4
S01013313,Occupancy rating +1,68,10,3,7,51,2,32,6,11,15,17,12,5,7,1,0,0,6
S01013313,Occupancy rating 0,63,9,2,7,46,1,32,1,26,5,13,11,2,8,4,0,0,4
S01013313,Occupancy rating -1 or less,19,1,0,1,12,0,7,0,7,0,5,3,2,6,3,0,1,2
S01013314,All households,304,96,43,53,191,27,98,47,37,14,66,39,27,17,7,0,1,9
S01013314,Occupancy rating +2 or more,107,34,13,21,73,22,37,32,3,2,14,5,9,0,0,0,0,0
S01013314,Occupancy rating +1,89,31,14,17,52,3,29,4,16,9,20,12,8,6,2,0,0,4
S01013314,Occupancy rating 0,81,30,16,14,45,2,24,10,13,1,19,15,4,6,3,0,1,2
S01013314,Occupancy rating -1 or less,27,1,0,1,21,0,8,1,5,2,13,7,6,5,2,0,0,3
S01013315,All households,174,6,0,6,165,5,154,34,109,11,6,5,1,3,2,0,0,1
S01013315,Occupancy rating +2 or more,155,6,0,6,146,4,138,32,97,9,4,3,1,3,2,0,0,1
S01013315,Occupancy rating +1,11,0,0,0,11,0,10,2,7,1,1,1,0,0,0,0,0,0
S01013315,Occupancy rating 0,6,0,0,0,6,0,5,0,5,0,1,1,0,0,0,0,0,0
S01013315,Occupancy rating -1 or less,2,0,0,0,2,1,1,0,0,1,0,0,0,0,0,0,0,0
S01013316,All households,273,66,39,27,199,38,146,63,49,34,15,12,3,8,5,1,0,2
S01013316,Occupancy rating +2 or more,187,42,23,19,142,30,105,55,28,22,7,5,2,3,1,0,0,2
S01013316,Occupancy rating +1,41,9,6,3,32,3,25,8,8,9,4,4,0,0,0,0,0,0
S01013316,Occupancy rating 0,30,13,8,5,15,4,8,0,6,2,3,2,1,2,2,0,0,0
S01013316,Occupancy rating -1 or less,15,2,2,0,10,1,8,0,7,1,1,1,0,3,2,1,0,0
S01013317,All households,257,87,29,58,167,26,121,66,39,16,20,14,6,3,1,0,0,2
S01013317,Occupancy rating +2 or more,111,35,15,20,75,18,56,40,8,8,1,1,0,1,0,0,0,1
S01013317,Occupancy rating +1,97,45,11,34,52,8,38,21,13,4,6,4,2,0,0,0,0,0
S01013317,Occupancy rating 0,39,7,3,4,30,0,21,3,14,4,9,7,2,2,1,0,0,1
S01013317,Occupancy rating -1 or less,10,0,0,0,10,0,6,2,4,0,4,2,2,0,0,0,0,0
S01013318,All households,245,52,13,39,180,10,154,68,70,16,16,12,4,13,3,0,1,9
S01013318,Occupancy rating +2 or more,126,24,8,16,96,8,84,39,36,9,4,4,0,6,2,0,0,4
S01013318,Occupancy rating +1,77,24,4,20,52,1,45,27,14,4,6,4,2,1,0,0,0,1
S01013318,Occupancy rating 0,33,2,1,1,28,1,21,1,17,3,6,4,2,3,0,0,0,3
S01013318,Occupancy rating -1 or less,9,2,0,2,4,0,4,1,3,0,0,0,0,3,1,0,1,1
S01013319,All households,209,34,9,25,161,5,122,43,65,14,34,24,10,14,4,0,2,8
S01013319,Occupancy rating +2 or more,119,12,3,9,101,4,86,35,42,9,11,8,3,6,0,0,2,4
S01013319,Occupancy rating +1,52,20,5,15,32,1,29,7,18,4,2,1,1,0,0,0,0,0
S01013319,Occupancy rating 0,25,1,0,1,20,0,4,0,3,1,16,10,6,4,2,0,0,2
S01013319,Occupancy rating -1 or less,13,1,1,0,8,0,3,1,2,0,5,5,0,4,2,0,0,2
S01013320,All households,357,50,5,45,288,5,250,72,159,19,33,26,7,19,8,0,0,11
S01013320,Occupancy rating +2 or more,205,21,4,17,179,5,160,54,92,14,14,13,1,5,3,0,0,2
S01013320,Occupancy rating +1,91,26,1,25,61,0,55,15,38,2,6,1,5,4,1,0,0,3
S01013320,Occupancy rating 0,37,2,0,2,32,0,24,3,18,3,8,7,1,3,1,0,0,2
S01013320,Occupancy rating -1 or less,24,1,0,1,16,0,11,0,11,0,5,5,0,7,3,0,0,4
S01013321,All households,223,95,36,59,115,16,75,42,25,8,24,15,9,13,4,0,0,9
S01013321,Occupancy rating +2 or more,37,14,4,10,21,4,14,12,2,0,3,0,3,2,1,0,0,1
S01013321,Occupancy rating +1,93,48,15,33,44,8,30,19,7,4,6,4,2,1,0,0,0,1
S01013321,Occupancy rating 0,72,25,15,10,43,3,26,10,12,4,14,11,3,4,1,0,0,3
S01013321,Occupancy rating -1 or less,21,8,2,6,7,1,5,1,4,0,1,0,1,6,2,0,0,4
S01013322,All households,267,51,21,30,206,14,149,48,69,32,43,32,11,10,5,0,0,5
S01013322,Occupancy rating +2 or more,114,23,7,16,89,6,76,36,27,13,7,6,1,2,0,0,0,2
S01013322,Occupancy rating +1,67,14,5,9,50,3,36,8,17,11,11,7,4,3,0,0,0,3
S01013322,Occupancy rating 0,70,13,9,4,55,5,30,4,19,7,20,15,5,2,2,0,0,0
S01013322,Occupancy rating -1 or less,16,1,0,1,12,0,7,0,6,1,5,4,1,3,3,0,0,0
S01013323,All households,416,136,37,99,251,19,165,61,71,33,67,50,17,29,10,0,0,19
S01013323,Occupancy rating +2 or more,93,33,6,27,58,5,48,30,13,5,5,4,1,2,2,0,0,0
S01013323,Occupancy rating +1,141,53,14,39,83,7,64,24,23,17,12,7,5,5,0,0,0,5
S01013323,Occupancy rating 0,133,39,11,28,86,5,44,7,28,9,37,31,6,8,3,0,0,5
S01013323,Occupancy rating -1 or less,49,11,6,5,24,2,9,0,7,2,13,8,5,14,5,0,0,9
S01013324,All households,275,89,25,64,161,9,99,37,41,21,53,44,9,25,12,0,0,13
S01013324,Occupancy rating +2 or more,77,24,11,13,50,8,34,25,8,1,8,6,2,3,1,0,0,2
S01013324,Occupancy rating +1,94,32,4,28,56,1,39,9,17,13,16,13,3,6,2,0,0,4
S01013324,Occupancy rating 0,80,25,8,17,46,0,23,3,13,7,23,19,4,9,5,0,0,4
S01013324,Occupancy rating -1 or less,24,8,2,6,9,0,3,0,3,0,6,6,0,7,4,0,0,3
S01013325,All households,353,75,21,54,254,15,127,38,65,24,112,95,17,24,13,0,1,10
S01013325,Occupancy rating +2 or more,77,22,2,20,53,1,44,18,24,2,8,7,1,2,1,0,0,1
S01013325,Occupancy rating +1,113,38,11,27,72,9,41,19,10,12,22,17,5,3,1,0,0,2
S01013325,Occupancy rating 0,124,13,7,6,102,5,32,1,23,8,65,55,10,9,3,0,1,5
S01013325,Occupancy rating -1 or less,39,2,1,1,27,0,10,0,8,2,17,16,1,10,8,0,0,2
S01013326,All households,218,55,20,35,137,6,78,30,32,16,53,30,23,26,8,0,0,18
S01013326,Occupancy rating +2 or more,69,23,9,14,43,5,31,25,3,3,7,1,6,3,0,0,0,3
S01013326,Occupancy rating +1,70,19,5,14,48,1,31,4,17,10,16,9,7,3,1,0,0,2
S01013326,Occupancy rating 0,60,12,5,7,32,0,12,1,9,2,20,14,6,16,7,0,0,9
S01013326,Occupancy rating -1 or less,19,1,1,0,14,0,4,0,3,1,10,6,4,4,0,0,0,4
S01013327,All households,269,57,25,32,193,6,116,41,46,29,71,45,26,19,5,0,0,14
S01013327,Occupancy rating +2 or more,108,39,19,20,67,6,53,35,10,8,8,4,4,2,1,0,0,1
S01013327,Occupancy rating +1,81,8,2,6,65,0,34,5,17,12,31,18,13,8,3,0,0,5
S01013327,Occupancy rating 0,65,9,3,6,50,0,28,1,18,9,22,16,6,6,1,0,0,5
S01013327,Occupancy rating -1 or less,15,1,1,0,11,0,1,0,1,0,10,7,3,3,0,0,0,3
S01013328,All households,236,50,15,35,171,6,102,30,52,20,63,35,28,15,10,0,0,5
S01013328,Occupancy rating +2 or more,72,31,11,20,40,5,34,25,8,1,1,0,1,1,0,0,0,1
S01013328,Occupancy rating +1,79,10,3,7,65,0,39,3,23,13,26,13,13,4,1,0,0,3
S01013328,Occupancy rating 0,56,8,1,7,43,1,18,2,12,4,24,14,10,5,4,0,0,1
S01013328,Occupancy rating -1 or less,29,1,0,1,23,0,11,0,9,2,12,8,4,5,5,0,0,0
S01013329,All households,228,71,35,36,144,11,96,39,38,19,37,22,15,13,4,0,0,9
S01013329,Occupancy rating +2 or more,113,47,26,21,64,10,48,35,9,4,6,3,3,2,0,0,0,2
S01013329,Occupancy rating +1,65,20,9,11,40,1,28,3,16,9,11,5,6,5,0,0,0,5
S01013329,Occupancy rating 0,43,4,0,4,36,0,18,1,12,5,18,12,6,3,2,0,0,1
S01013329,Occupancy rating -1 or less,7,0,0,0,4,0,2,0,1,1,2,2,0,3,2,0,0,1
S01013330,All households,430,95,6,89,307,9,249,99,123,27,49,36,13,28,8,0,0,20
S01013330,Occupancy rating +2 or more,152,17,2,15,129,6,112,40,57,15,11,8,3,6,5,0,0,1
S01013330,Occupancy rating +1,159,60,1,59,92,3,81,49,25,7,8,6,2,7,2,0,0,5
S01013330,Occupancy rating 0,85,14,3,11,61,0,41,10,26,5,20,16,4,10,1,0,0,9
S01013330,Occupancy rating -1 or less,34,4,0,4,25,0,15,0,15,0,10,6,4,5,0,0,0,5
S01013331,All households,248,50,7,43,173,1,149,51,84,14,23,18,5,25,7,0,1,17
S01013331,Occupancy rating +2 or more,93,19,1,18,72,0,69,24,38,7,3,2,1,2,2,0,0,0
S01013331,Occupancy rating +1,93,28,5,23,63,1,59,23,30,6,3,3,0,2,1,0,0,1
S01013331,Occupancy rating 0,45,2,1,1,30,0,16,1,14,1,14,10,4,13,0,0,1,12
S01013331,Occupancy rating -1 or less,17,1,0,1,8,0,5,3,2,0,3,3,0,8,4,0,0,4
S01013332,All households,285,91,45,46,181,20,128,50,53,25,33,25,8,13,6,0,1,6
S01013332,Occupancy rating +2 or more,105,45,21,24,57,10,45,33,4,8,2,2,0,3,1,0,0,2
S01013332,Occupancy rating +1,68,10,2,8,54,2,40,11,22,7,12,9,3,4,1,0,0,3
S01013332,Occupancy rating 0,95,31,21,10,59,7,37,5,22,10,15,11,4,5,3,0,1,1
S01013332,Occupancy rating -1 or less,17,5,1,4,11,1,6,1,5,0,4,3,1,1,1,0,0,0
S01013333,All households,327,73,24,49,239,12,192,73,94,25,35,24,11,15,7,0,2,6
S01013333,Occupancy rating +2 or more,148,28,10,18,116,8,97,49,34,14,11,6,5,4,1,0,1,2
S01013333,Occupancy rating +1,104,24,6,18,76,4,60,20,32,8,12,8,4,4,1,0,0,3
S01013333,Occupancy rating 0,57,18,8,10,37,0,28,3,22,3,9,8,1,2,1,0,0,1
S01013333,Occupancy rating -1 or less,18,3,0,3,10,0,7,1,6,0,3,2,1,5,4,0,1,0
S01013334,All households,294,63,13,50,202,10,131,53,60,18,61,46,15,29,20,0,0,9
S01013334,Occupancy rating +2 or more,97,33,5,28,62,10,51,42,6,3,1,0,1,2,1,0,0,1
S01013334,Occupancy rating +1,89,13,2,11,73,0,44,9,24,11,29,20,9,3,0,0,0,3
S01013334,Occupancy rating 0,74,15,4,11,47,0,26,1,21,4,21,17,4,12,9,0,0,3
S01013334,Occupancy rating -1 or less,34,2,2,0,20,0,10,1,9,0,10,9,1,12,10,0,0,2
S01013335,All households,294,62,23,39,211,4,124,32,71,21,83,66,17,21,11,0,0,10
S01013335,Occupancy rating +2 or more,82,34,13,21,46,1,35,22,7,6,10,5,5,2,1,0,0,1
S01013335,Occupancy rating +1,99,20,7,13,74,1,49,8,33,8,24,22,2,5,1,0,0,4
S01013335,Occupancy rating 0,84,8,3,5,71,1,29,2,24,3,41,33,8,5,3,0,0,2
S01013335,Occupancy rating -1 or less,29,0,0,0,20,1,11,0,7,4,8,6,2,9,6,0,0,3
S01013336,All households,339,103,22,81,210,9,129,39,56,34,72,54,18,26,14,0,0,12
S01013336,Occupancy rating +2 or more,93,21,8,13,70,8,50,24,14,12,12,8,4,2,1,0,0,1
S01013336,Occupancy rating +1,101,38,5,33,56,1,38,12,16,10,17,12,5,7,5,0,0,2
S01013336,Occupancy rating 0,115,38,7,31,68,0,31,3,16,12,37,30,7,9,4,0,0,5
S01013336,Occupancy rating -1 or less,30,6,2,4,16,0,10,0,10,0,6,4,2,8,4,0,0,4
S01013337,All households,365,63,19,44,283,42,209,85,80,44,32,17,15,19,8,0,0,11
S01013337,Occupancy rating +2 or more,207,39,10,29,161,37,114,68,26,20,10,6,4,7,2,0,0,5
S01013337,Occupancy rating +1,80,12,4,8,67,2,51,10,27,14,14,8,6,1,0,0,0,1
S01013337,Occupancy rating 0,61,12,5,7,44,3,35,4,25,6,6,2,4,5,4,0,0,1
S01013337,Occupancy rating -1 or less,17,0,0,0,11,0,9,3,2,4,2,1,1,6,2,0,0,4
S01013338,All households,165,10,2,8,141,3,128,29,93,6,10,8,2,14,10,0,0,4
S01013338,Occupancy rating +2 or more,144,9,1,8,126,3,113,28,80,5,10,8,2,9,7,0,0,2
S01013338,Occupancy rating +1,13,1,1,0,9,0,9,1,7,1,0,0,0,3,3,0,0,0
S01013338,Occupancy rating 0,7,0,0,0,5,0,5,0,5,0,0,0,0,2,0,0,0,2
S01013338,Occupancy rating -1 or less,1,0,0,0,1,0,1,0,1,0,0,0,0,0,0,0,0,0
S01013339,All households,233,43,10,33,181,17,141,67,58,16,23,16,7,9,4,0,0,5
S01013339,Occupancy rating +2 or more,124,20,10,10,101,17,81,53,20,8,3,2,1,3,1,0,0,2
S01013339,Occupancy rating +1,57,15,0,15,41,0,32,10,16,6,9,5,4,1,1,0,0,0
S01013339,Occupancy rating 0,47,8,0,8,37,0,26,4,20,2,11,9,2,2,1,0,0,1
S01013339,Occupancy rating -1 or less,5,0,0,0,2,0,2,0,2,0,0,0,0,3,1,0,0,2
S01013340,All households,335,54,14,40,274,40,209,109,60,40,25,16,9,7,5,0,0,2
S01013340,Occupancy rating +2 or more,202,29,10,19,169,32,134,85,26,23,3,2,1,4,3,0,0,1
S01013340,Occupancy rating +1,88,20,4,16,66,7,51,16,23,12,8,3,5,2,1,0,0,1
S01013340,Occupancy rating 0,40,5,0,5,34,0,22,7,10,5,12,10,2,1,1,0,0,0
S01013340,Occupancy rating -1 or less,5,0,0,0,5,1,2,1,1,0,2,1,1,0,0,0,0,0
S01013341,All households,388,99,19,80,261,21,209,100,92,17,31,21,10,28,5,0,0,23
S01013341,Occupancy rating +2 or more,238,46,10,36,187,20,156,73,69,14,11,6,5,5,1,0,0,4
S01013341,Occupancy rating +1,82,38,6,32,37,1,27,17,9,1,9,7,2,7,1,0,0,6
S01013341,Occupancy rating 0,56,14,3,11,30,0,21,10,9,2,9,6,3,12,2,0,0,10
S01013341,Occupancy rating -1 or less,12,1,0,1,7,0,5,0,5,0,2,2,0,4,1,0,0,3
S01013342,All households,286,103,36,67,170,20,101,38,41,22,49,31,18,13,4,0,1,8
S01013342,Occupancy rating +2 or more,112,44,15,29,66,16,44,30,10,4,6,2,4,2,1,0,1,0
S01013342,Occupancy rating +1,72,24,7,17,47,2,31,5,12,14,14,6,8,1,0,0,0,1
S01013342,Occupancy rating 0,73,29,11,18,39,1,19,3,13,3,19,15,4,5,1,0,0,4
S01013342,Occupancy rating -1 or less,29,6,3,3,18,1,7,0,6,1,10,8,2,5,2,0,0,3
S01013343,All households,276,83,33,50,176,11,133,44,65,24,32,22,10,17,11,0,0,6
S01013343,Occupancy rating +2 or more,82,36,17,19,43,3,37,24,10,3,3,1,2,3,1,0,0,2
S01013343,Occupancy rating +1,90,24,2,22,62,3,45,16,22,7,14,10,4,4,2,0,0,2
S01013343,Occupancy rating 0,81,23,14,9,52,5,37,3,22,12,10,7,3,6,4,0,0,2
S01013343,Occupancy rating -1 or less,23,0,0,0,19,0,14,1,11,2,5,4,1,4,4,0,0,0
S01013344,All households,356,128,64,64,211,29,116,43,52,21,66,39,27,17,11,0,1,5
S01013344,Occupancy rating +2 or more,98,36,14,22,60,17,35,25,7,3,8,1,7,2,1,0,0,1
S01013344,Occupancy rating +1,116,44,20,24,67,9,40,12,19,9,18,10,8,5,3,0,1,1
S01013344,Occupancy rating 0,102,26,10,16,68,3,30,3,19,8,35,23,12,8,5,0,0,3
S01013344,Occupancy rating -1 or less,40,22,20,2,16,0,11,3,7,1,5,5,0,2,2,0,0,0
S01013345,All households,298,73,32,41,205,8,143,55,65,23,54,42,12,20,8,0,1,11
S01013345,Occupancy rating +2 or more,104,38,17,21,63,3,55,39,10,6,5,3,2,3,0,0,0,3
S01013345,Occupancy rating +1,100,24,10,14,72,4,52,11,29,12,16,13,3,4,0,0,1,3
S01013345,Occupancy rating 0,71,10,5,5,54,0,29,4,21,4,25,18,7,7,3,0,0,4
S01013345,Occupancy rating -1 or less,23,1,0,1,16,1,7,1,5,1,8,8,0,6,5,0,0,1
S01013346,All households,282,23,4,19,238,9,201,58,122,21,28,24,4,21,13,0,0,8
S01013346,Occupancy rating +2 or more,171,10,3,7,153,9,135,48,74,13,9,8,1,8,4,0,0,4
S01013346,Occupancy rating +1,56,9,1,8,41,0,33,6,23,4,8,8,0,6,5,0,0,1
S01013346,Occupancy rating 0,44,3,0,3,35,0,25,4,17,4,10,7,3,6,3,0,0,3
S01013346,Occupancy rating -1 or less,11,1,0,1,9,0,8,0,8,0,1,1,0,1,1,0,0,0
S01013347,All households,332,125,19,106,196,18,153,73,66,14,25,13,12,11,5,0,0,6
S01013347,Occupancy rating +2 or more,111,20,6,14,90,13,70,35,30,5,7,4,3,1,1,0,0,0
S01013347,Occupancy rating +1,87,37,7,30,48,4,37,17,16,4,7,3,4,2,1,0,0,1
S01013347,Occupancy rating 0,90,42,6,36,46,1,38,16,17,5,7,5,2,2,0,0,0,2
S01013347,Occupancy rating -1 or less,44,26,0,26,12,0,8,5,3,0,4,1,3,6,3,0,0,3
S01013348,All households,169,29,9,20,136,2,124,41,70,13,10,9,1,4,4,0,0,0
S01013348,Occupancy rating +2 or more,121,21,8,13,99,1,92,35,49,8,6,5,1,1,1,0,0,0
S01013348,Occupancy rating +1,31,7,1,6,23,1,21,5,14,2,1,1,0,1,1,0,0,0
S01013348,Occupancy rating 0,13,1,0,1,11,0,8,1,4,3,3,3,0,1,1,0,0,0
S01013348,Occupancy rating -1 or less,4,0,0,0,3,0,3,0,3,0,0,0,0,1,1,0,0,0
S01013349,All households,359,117,4,113,205,4,158,76,78,4,43,37,6,37,9,0,0,28
S01013349,Occupancy rating +2 or more,83,18,1,17,62,4,52,23,27,2,6,2,4,3,0,0,0,3
S01013349,Occupancy rating +1,144,72,1,71,68,0,63,42,21,0,5,4,1,4,0,0,0,4
S01013349,Occupancy rating 0,100,20,2,18,60,0,32,6,24,2,28,27,1,20,3,0,0,17
S01013349,Occupancy rating -1 or less,32,7,0,7,15,0,11,5,6,0,4,4,0,10,6,0,0,4
S01013350,All households,285,84,42,42,182,10,129,50,46,33,43,30,13,19,8,0,3,8
S01013350,Occupancy rating +2 or more,66,19,6,13,45,7,32,24,5,3,6,3,3,2,0,0,0,2
S01013350,Occupancy rating +1,75,15,6,9,60,0,46,17,16,13,14,8,6,0,0,0,0,0
S01013350,Occupancy rating 0,113,43,28,15,61,3,41,9,17,15,17,13,4,9,3,0,1,5
S01013350,Occupancy rating -1 or less,31,7,2,5,16,0,10,0,8,2,6,6,0,8,5,0,2,1
S01013351,All households,320,80,35,45,215,17,158,65,68,25,40,28,12,25,10,0,0,15
S01013351,Occupancy rating +2 or more,137,30,15,15,103,13,84,49,21,14,6,5,1,4,1,0,0,3
S01013351,Occupancy rating +1,81,17,7,10,58,1,40,5,27,8,17,12,5,6,1,0,0,5
S01013351,Occupancy rating 0,75,28,10,18,40,3,24,10,13,1,13,8,5,7,3,0,0,4
S01013351,Occupancy rating -1 or less,27,5,3,2,14,0,10,1,7,2,4,3,1,8,5,0,0,3
S01013352,All households,355,78,32,46,250,24,170,65,69,36,56,39,17,27,9,0,1,17
S01013352,Occupancy rating +2 or more,143,42,18,24,97,20,71,56,9,6,6,3,3,4,1,0,0,3
S01013352,Occupancy rating +1,97,17,2,15,73,4,49,5,26,18,20,10,10,7,1,0,1,5
S01013352,Occupancy rating 0,91,16,12,4,65,0,42,4,29,9,23,19,4,10,2,0,0,8
S01013352,Occupancy rating -1 or less,24,3,0,3,15,0,8,0,5,3,7,7,0,6,5,0,0,1
S01013353,All households,283,98,33,65,169,5,111,47,52,12,53,32,21,16,7,0,0,9
S01013353,Occupancy rating +2 or more,83,30,8,22,51,2,38,27,8,3,11,5,6,2,1,0,0,1
S01013353,Occupancy rating +1,89,27,6,21,57,2,36,14,17,5,19,12,7,5,1,0,0,4
S01013353,Occupancy rating 0,88,35,16,19,50,1,30,5,21,4,19,12,7,3,1,0,0,2
S01013353,Occupancy rating -1 or less,23,6,3,3,11,0,7,1,6,0,4,3,1,6,4,0,0,2
S01013354,All households,318,84,34,50,224,31,167,81,60,26,26,19,7,10,2,0,1,7
S01013354,Occupancy rating +2 or more,166,36,14,22,127,23,98,52,34,12,6,6,0,3,0,0,0,3
S01013354,Occupancy rating +1,85,25,12,13,57,6,47,20,20,7,4,2,2,3,0,0,1,2
S01013354,Occupancy rating 0,57,22,8,14,33,1,19,8,4,7,13,8,5,2,1,0,0,1
S01013354,Occupancy rating -1 or less,10,1,0,1,7,1,3,1,2,0,3,3,0,2,1,0,0,1
S01013355,All households,274,75,40,35,191,21,136,49,65,22,34,23,11,8,3,0,0,5
S01013355,Occupancy rating +2 or more,127,37,18,19,87,12,70,33,26,11,5,4,1,3,0,0,0,3
S01013355,Occupancy rating +1,84,31,21,10,52,7,34,13,14,7,11,8,3,1,0,0,0,1
S01013355,Occupancy rating 0,48,5,1,4,41,2,24,2,20,2,15,9,6,2,1,0,0,1
S01013355,Occupancy rating -1 or less,15,2,0,2,11,0,8,1,5,2,3,2,1,2,2,0,0,0
S01013356,All households,323,90,20,70,213,24,127,42,56,29,62,42,20,20,12,0,0,8
S01013356,Occupancy rating +2 or more,93,23,8,15,67,15,50,28,11,11,2,1,1,3,2,0,0,1
S01013356,Occupancy rating +1,117,42,10,32,70,7,41,13,17,11,22,12,10,5,2,0,0,3
S01013356,Occupancy rating 0,71,8,1,7,55,0,23,0,18,5,32,26,6,8,4,0,0,4
S01013356,Occupancy rating -1 or less,42,17,1,16,21,2,13,1,10,2,6,3,3,4,4,0,0,0
S01013357,All households,346,79,27,52,253,35,183,84,77,22,35,24,11,14,7,0,0,7
S01013357,Occupancy rating +2 or more,204,46,23,23,152,31,116,63,40,13,5,1,4,6,4,0,0,2
S01013357,Occupancy rating +1,66,21,2,19,44,4,35,19,11,5,5,4,1,1,0,0,0,1
S01013357,Occupancy rating 0,58,10,2,8,44,0,26,2,21,3,18,14,4,4,1,0,0,3
S01013357,Occupancy rating -1 or less,18,2,0,2,13,0,6,0,5,1,7,5,2,3,2,0,0,1
S01013358,All households,382,141,85,56,226,33,157,63,70,24,36,22,14,15,3,0,2,10
S01013358,Occupancy rating +2 or more,161,44,24,20,114,24,84,48,28,8,6,4,2,3,0,0,1,2
S01013358,Occupancy rating +1,88,20,6,14,65,4,47,10,22,15,14,6,8,3,1,0,0,2
S01013358,Occupancy rating 0,101,65,48,17,32,4,17,2,14,1,11,8,3,4,2,0,0,2
S01013358,Occupancy rating -1 or less,32,12,7,5,15,1,9,3,6,0,5,4,1,5,0,0,1,4
S01013359,All households,298,113,43,70,176,25,97,47,37,13,54,38,16,9,5,0,1,3
S01013359,Occupancy rating +2 or more,99,38,21,17,58,15,35,28,2,5,8,8,0,3,2,0,0,1
S01013359,Occupancy rating +1,101,48,13,35,51,4,29,15,11,3,18,11,7,2,0,0,1,1
S01013359,Occupancy rating 0,63,17,7,10,46,5,21,3,14,4,20,14,6,0,0,0,0,0
S01013359,Occupancy rating -1 or less,35,10,2,8,21,1,12,1,10,1,8,5,3,4,3,0,0,1
S01013360,All households,299,83,35,48,189,30,108,45,38,25,51,30,21,27,10,0,0,17
S01013360,Occupancy rating +2 or more,111,37,23,14,70,22,45,35,8,2,3,2,1,4,1,0,0,3
S01013360,Occupancy rating +1,98,29,10,19,59,7,37,6,14,17,15,3,12,10,1,0,0,9
S01013360,Occupancy rating 0,73,12,1,11,54,1,22,3,14,5,31,23,8,7,3,0,0,4
S01013360,Occupancy rating -1 or less,17,5,1,4,6,0,4,1,2,1,2,2,0,6,5,0,0,1
S01013361,All households,280,120,39,81,146,18,91,45,26,20,37,23,14,14,5,0,0,9
S01013361,Occupancy rating +2 or more,58,21,8,13,37,10,25,19,4,2,2,1,1,0,0,0,0,0
S01013361,Occupancy rating +1,100,42,14,28,56,6,39,20,8,11,11,6,5,2,0,0,0,2
S01013361,Occupancy rating 0,97,51,14,37,40,0,20,5,11,4,20,12,8,6,1,0,0,5
S01013361,Occupancy rating -1 or less,25,6,3,3,13,2,7,1,3,3,4,4,0,6,4,0,0,2
S01013362,All households,220,76,46,30,127,20,67,26,34,7,40,30,10,17,5,0,0,12
S01013362,Occupancy rating +2 or more,80,37,23,14,40,13,22,16,5,1,5,3,2,3,0,0,0,3
S01013362,Occupancy rating +1,80,32,18,14,44,6,23,10,12,1,15,10,5,4,1,0,0,3
S01013362,Occupancy rating 0,38,3,1,2,30,1,14,0,11,3,15,13,2,5,1,0,0,4
S01013362,Occupancy rating -1 or less,22,4,4,0,13,0,8,0,6,2,5,4,1,5,3,0,0,2
S01013363,All households,390,173,49,124,196,19,106,52,38,16,71,50,21,21,10,0,0,11
S01013363,Occupancy rating +2 or more,123,61,32,29,60,11,40,36,3,1,9,7,2,2,0,0,0,2
S01013363,Occupancy rating +1,162,99,14,85,59,6,36,14,12,10,17,10,7,4,1,0,0,3
S01013363,Occupancy rating 0,75,8,3,5,62,2,25,1,19,5,35,26,9,5,2,0,0,3
S01013363,Occupancy rating -1 or less,30,5,0,5,15,0,5,1,4,0,10,7,3,10,7,0,0,3
S01013364,All households,366,93,37,56,257,28,196,80,91,25,33,20,13,16,8,0,0,8
S01013364,Occupancy rating +2 or more,174,44,18,26,126,19,103,60,34,9,4,2,2,4,2,0,0,2
S01013364,Occupancy rating +1,97,31,14,17,61,5,49,14,27,8,7,4,3,5,3,0,0,2
S01013364,Occupancy rating 0,65,11,4,7,49,1,31,4,23,4,17,12,5,5,2,0,0,3
S01013364,Occupancy rating -1 or less,30,7,1,6,21,3,13,2,7,4,5,2,3,2,1,0,0,1
S01013365,All households,367,102,26,76,248,31,179,102,53,24,38,25,13,17,6,0,1,10
S01013365,Occupancy rating +2 or more,145,24,10,14,117,16,91,51,22,18,10,5,5,4,1,0,1,2
S01013365,Occupancy rating +1,102,30,8,22,69,11,53,34,15,4,5,2,3,3,2,0,0,1
S01013365,Occupancy rating 0,89,33,4,29,51,4,32,17,13,2,15,11,4,5,2,0,0,3
S01013365,Occupancy rating -1 or less,31,15,4,11,11,0,3,0,3,0,8,7,1,5,1,0,0,4
S01013366,All households,348,70,20,50,270,20,207,71,108,28,43,31,12,8,3,0,0,5
S01013366,Occupancy rating +2 or more,139,25,8,17,111,14,96,52,34,10,1,1,0,3,1,0,0,2
S01013366,Occupancy rating +1,124,30,5,25,92,5,70,14,43,13,17,10,7,2,0,0,0,2
S01013366,Occupancy rating 0,70,13,7,6,55,0,34,3,27,4,21,17,4,2,1,0,0,1
S01013366,Occupancy rating -1 or less,15,2,0,2,12,1,7,2,4,1,4,3,1,1,1,0,0,0
S01013367,All households,221,48,19,29,163,10,138,43,75,20,15,7,8,10,1,0,0,9
S01013367,Occupancy rating +2 or more,126,19,6,13,99,3,92,30,47,15,4,3,1,8,1,0,0,7
S01013367,Occupancy rating +1,45,14,3,11,30,4,23,10,12,1,3,1,2,1,0,0,0,1
S01013367,Occupancy rating 0,40,15,10,5,24,3,15,2,10,3,6,2,4,1,0,0,0,1
S01013367,Occupancy rating -1 or less,10,0,0,0,10,0,8,1,6,1,2,1,1,0,0,0,0,0
S01013368,All households,284,57,26,31,212,23,154,59,64,31,35,22,13,15,6,0,2,7
S01013368,Occupancy rating +2 or more,117,24,9,15,89,10,73,39,26,8,6,5,1,4,3,0,1,0
S01013368,Occupancy rating +1,92,24,14,10,65,10,42,19,14,9,13,3,10,3,0,0,0,3
S01013368,Occupancy rating 0,58,7,2,5,48,3,33,1,21,11,12,10,2,3,0,0,0,3
S01013368,Occupancy rating -1 or less,17,2,1,1,10,0,6,0,3,3,4,4,0,5,3,0,1,1
S01013369,All households,420,145,80,65,263,29,147,56,67,24,87,59,28,12,4,0,0,8
S01013369,Occupancy rating +2 or more,102,40,20,20,60,11,42,34,3,5,7,5,2,2,0,0,0,2
S01013369,Occupancy rating +1,116,42,15,27,72,8,43,16,19,8,21,12,9,2,0,0,0,2
S01013369,Occupancy rating 0,156,55,39,16,98,9,48,5,35,8,41,28,13,3,0,0,0,3
S01013369,Occupancy rating -1 or less,46,8,6,2,33,1,14,1,10,3,18,14,4,5,4,0,0,1
S01013370,All households,298,132,31,101,155,24,91,41,40,10,40,30,10,11,6,0,0,5
S01013370,Occupancy rating +2 or more,56,22,9,13,33,11,19,14,3,2,3,3,0,1,1,0,0,0
S01013370,Occupancy rating +1,106,50,14,36,54,8,36,20,13,3,10,6,4,2,0,0,0,2
S01013370,Occupancy rating 0,106,48,4,44,53,3,27,5,18,4,23,17,6,5,3,0,0,2
S01013370,Occupancy rating -1 or less,30,12,4,8,15,2,9,2,6,1,4,4,0,3,2,0,0,1
S01013371,All households,327,125,80,45,196,49,105,51,35,19,42,29,13,6,2,0,0,4
S01013371,Occupancy rating +2 or more,93,20,13,7,72,27,39,24,10,5,6,6,0,1,0,0,0,1
S01013371,Occupancy rating +1,106,51,29,22,54,16,30,21,6,3,8,3,5,1,0,0,0,1
S01013371,Occupancy rating 0,98,40,26,14,56,5,32,6,17,9,19,13,6,2,0,0,0,2
S01013371,Occupancy rating -1 or less,30,14,12,2,14,1,4,0,2,2,9,7,2,2,2,0,0,0
S01013372,All households,489,166,50,116,307,26,169,55,83,31,112,83,29,16,11,0,0,5
S01013372,Occupancy rating +2 or more,75,32,14,18,42,10,26,16,9,1,6,3,3,1,1,0,0,0
S01013372,Occupancy rating +1,178,83,28,55,93,14,54,32,14,8,25,16,9,2,2,0,0,0
S01013372,Occupancy rating 0,172,32,3,29,133,2,66,5,43,18,65,52,13,7,3,0,0,4
S01013372,Occupancy rating -1 or less,64,19,5,14,39,0,23,2,17,4,16,12,4,6,5,0,0,1
S01013373,All households,451,168,55,113,272,46,153,66,60,27,73,50,23,11,4,0,0,7
S01013373,Occupancy rating +2 or more,118,42,21,21,76,25,44,24,15,5,7,3,4,0,0,0,0,0
S01013373,Occupancy rating +1,161,72,22,50,89,17,60,30,16,14,12,10,2,0,0,0,0,0
S01013373,Occupancy rating 0,125,40,8,32,78,3,36,10,21,5,39,26,13,7,2,0,0,5
S01013373,Occupancy rating -1 or less,47,14,4,10,29,1,13,2,8,3,15,11,4,4,2,0,0,2
S01013374,All households,453,177,80,97,251,31,119,47,53,19,101,73,28,25,12,0,0,13
S01013374,Occupancy rating +2 or more,76,39,17,22,34,8,24,19,3,2,2,1,1,3,1,0,0,2
S01013374,Occupancy rating +1,173,85,30,55,85,17,46,21,15,10,22,16,6,3,0,0,0,3
S01013374,Occupancy rating 0,149,41,25,16,101,5,35,6,25,4,61,48,13,7,1,0,0,6
S01013374,Occupancy rating -1 or less,55,12,8,4,31,1,14,1,10,3,16,8,8,12,10,0,0,2
S01013375,All households,262,81,37,44,166,23,100,40,45,15,43,30,13,15,4,0,1,10
S01013375,Occupancy rating +2 or more,53,20,11,9,30,3,23,18,4,1,4,3,1,3,0,0,0,3
S01013375,Occupancy rating +1,104,50,21,29,53,16,28,16,10,2,9,5,4,1,0,0,0,1
S01013375,Occupancy rating 0,71,8,4,4,59,4,32,4,18,10,23,16,7,4,0,0,1,3
S01013375,Occupancy rating -1 or less,34,3,1,2,24,0,17,2,13,2,7,6,1,7,4,0,0,3
S01013376,All households,272,92,46,46,172,30,97,40,39,18,45,24,21,8,3,0,1,4
S01013376,Occupancy rating +2 or more,99,37,18,19,60,20,31,22,8,1,9,2,7,2,0,0,1,1
S01013376,Occupancy rating +1,100,38,19,19,59,10,32,14,11,7,17,7,10,3,1,0,0,2
S01013376,Occupancy rating 0,60,12,6,6,46,0,29,3,17,9,17,14,3,2,1,0,0,1
S01013376,Occupancy rating -1 or less,13,5,3,2,7,0,5,1,3,1,2,1,1,1,1,0,0,0
S01013377,All households,377,138,69,69,217,42,134,68,43,23,41,29,12,22,7,0,2,13
S01013377,Occupancy rating +2 or more,94,34,22,12,57,12,44,26,15,3,1,0,1,3,1,0,0,2
S01013377,Occupancy rating +1,162,77,36,41,83,25,48,36,6,6,10,5,5,2,0,0,0,2
S01013377,Occupancy rating 0,82,24,8,16,50,1,26,1,15,10,23,17,6,8,1,0,2,5
S01013377,Occupancy rating -1 or less,39,3,3,0,27,4,16,5,7,4,7,7,0,9,5,0,0,4
S01013378,All households,426,130,51,79,281,26,186,77,66,43,69,52,17,15,8,0,0,7
S01013378,Occupancy rating +2 or more,157,48,24,24,108,17,87,49,20,18,4,3,1,1,0,0,0,1
S01013378,Occupancy rating +1,155,56,19,37,97,6,66,26,23,17,25,18,7,2,1,0,0,1
S01013378,Occupancy rating 0,92,23,7,16,59,2,29,2,21,6,28,21,7,10,6,0,0,4
S01013378,Occupancy rating -1 or less,22,3,1,2,17,1,4,0,2,2,12,10,2,2,1,0,0,1
S01013379,All households,345,70,26,44,260,33,185,88,57,40,42,28,14,15,6,0,0,9
S01013379,Occupancy rating +2 or more,123,22,9,13,96,19,75,51,13,11,2,2,0,5,1,0,0,4
S01013379,Occupancy rating +1,115,28,13,15,83,12,61,36,13,12,10,5,5,4,1,0,0,3
S01013379,Occupancy rating 0,81,14,4,10,65,1,37,1,25,11,27,18,9,2,1,0,0,1
S01013379,Occupancy rating -1 or less,26,6,0,6,16,1,12,0,6,6,3,3,0,4,3,0,0,1
S01013380,All households,36,6,4,2,27,4,19,3,8,8,4,2,2,3,2,0,0,1
S01013380,Occupancy rating +2 or more,21,3,2,1,16,4,11,2,6,3,1,0,1,2,1,0,0,1
S01013380,Occupancy rating +1,9,0,0,0,9,0,7,1,2,4,2,1,1,0,0,0,0,0
S01013380,Occupancy rating 0,5,3,2,1,2,0,1,0,0,1,1,1,0,0,0,0,0,0
S01013380,Occupancy rating -1 or less,1,0,0,0,0,0,0,0,0,0,0,0,0,1,1,0,0,0
S01013381,All households,211,60,30,30,146,23,89,32,38,19,34,18,16,5,2,0,0,3
S01013381,Occupancy rating +2 or more,77,29,13,16,47,19,25,16,6,3,3,0,3,1,0,0,0,1
S01013381,Occupancy rating +1,64,16,8,8,47,1,37,15,13,9,9,3,6,1,0,0,0,1
S01013381,Occupancy rating 0,58,13,8,5,44,3,25,1,17,7,16,10,6,1,1,0,0,0
S01013381,Occupancy rating -1 or less,12,2,1,1,8,0,2,0,2,0,6,5,1,2,1,0,0,1
S01013382,All households,225,56,24,32,160,16,126,52,50,24,18,12,6,9,5,0,0,4
S01013382,Occupancy rating +2 or more,107,29,15,14,75,10,65,38,16,11,0,0,0,3,2,0,0,1
S01013382,Occupancy rating +1,64,19,4,15,43,3,34,13,12,9,6,2,4,2,0,0,0,2
S01013382,Occupancy rating 0,39,6,3,3,30,2,21,1,17,3,7,6,1,3,2,0,0,1
S01013382,Occupancy rating -1 or less,15,2,2,0,12,1,6,0,5,1,5,4,1,1,1,0,0,0
S01013383,All households,353,147,72,75,192,31,107,45,45,17,54,26,28,14,7,0,0,7
S01013383,Occupancy rating +2 or more,73,32,12,20,41,9,28,12,10,6,4,3,1,0,0,0,0,0
S01013383,Occupancy rating +1,131,72,40,32,57,9,41,23,12,6,7,4,3,2,1,0,0,1
S01013383,Occupancy rating 0,122,33,16,17,82,11,34,8,22,4,37,16,21,7,3,0,0,4
S01013383,Occupancy rating -1 or less,27,10,4,6,12,2,4,2,1,1,6,3,3,5,3,0,0,2
S01013384,All households,337,126,67,59,193,27,138,55,58,25,28,14,14,18,10,0,0,8
S01013384,Occupancy rating +2 or more,128,48,22,26,79,20,55,36,12,7,4,3,1,1,1,0,0,0
S01013384,Occupancy rating +1,80,19,6,13,54,2,44,10,22,12,8,1,7,7,1,0,0,6
S01013384,Occupancy rating 0,104,47,33,14,50,5,33,8,21,4,12,6,6,7,5,0,0,2
S01013384,Occupancy rating -1 or less,25,12,6,6,10,0,6,1,3,2,4,4,0,3,3,0,0,0
S01013385,All households,217,62,24,38,144,20,106,54,33,19,18,10,8,11,6,0,1,4
S01013385,Occupancy rating +2 or more,108,31,15,16,74,13,59,42,7,10,2,0,2,3,0,0,1,2
S01013385,Occupancy rating +1,49,15,6,9,33,6,24,10,7,7,3,0,3,1,0,0,0,1
S01013385,Occupancy rating 0,50,13,3,10,33,1,20,2,16,2,12,9,3,4,3,0,0,1
S01013385,Occupancy rating -1 or less,10,3,0,3,4,0,3,0,3,0,1,1,0,3,3,0,0,0
S01013386,All households,335,58,18,40,271,37,211,83,102,26,23,13,10,6,5,0,0,1
S01013386,Occupancy rating +2 or more,218,35,13,22,180,28,146,71,59,16,6,3,3,3,2,0,0,1
S01013386,Occupancy rating +1,72,10,2,8,61,8,44,10,28,6,9,4,5,1,1,0,0,0
S01013386,Occupancy rating 0,36,12,3,9,23,0,17,1,13,3,6,4,2,1,1,0,0,0
S01013386,Occupancy rating -1 or less,9,1,0,1,7,1,4,1,2,1,2,2,0,1,1,0,0,0
S01013387,All households,265,79,46,33,174,23,97,32,48,17,54,34,20,12,6,0,0,6
S01013387,Occupancy rating +2 or more,102,47,26,21,54,17,30,25,4,1,7,3,4,1,1,0,0,0
S01013387,Occupancy rating +1,93,30,18,12,58,4,36,7,22,7,18,9,9,5,1,0,0,4
S01013387,Occupancy rating 0,56,0,0,0,52,2,28,0,21,7,22,18,4,4,3,0,0,1
S01013387,Occupancy rating -1 or less,14,2,2,0,10,0,3,0,1,2,7,4,3,2,1,0,0,1
S01013388,All households,382,178,101,77,188,38,116,50,43,23,34,23,11,16,6,0,1,9
S01013388,Occupancy rating +2 or more,119,46,31,15,71,22,46,29,11,6,3,1,2,2,0,0,0,2
S01013388,Occupancy rating +1,126,66,28,38,53,12,36,17,8,11,5,4,1,7,1,0,0,6
S01013388,Occupancy rating 0,109,54,39,15,49,3,27,4,18,5,19,12,7,6,4,0,1,1
S01013388,Occupancy rating -1 or less,28,12,3,9,15,1,7,0,6,1,7,6,1,1,1,0,0,0
S01013389,All households,347,118,34,84,219,19,156,70,61,25,44,32,12,10,4,0,0,6
S01013389,Occupancy rating +2 or more,110,28,11,17,82,16,60,44,12,4,6,4,2,0,0,0,0,0
S01013389,Occupancy rating +1,123,46,16,30,73,3,51,14,25,12,19,14,5,4,0,0,0,4
S01013389,Occupancy rating 0,87,37,5,32,47,0,36,12,17,7,11,8,3,3,1,0,0,2
S01013389,Occupancy rating -1 or less,27,7,2,5,17,0,9,0,7,2,8,6,2,3,3,0,0,0
S01013390,All households,210,71,22,49,124,16,85,40,31,14,23,13,10,15,7,0,0,8
S01013390,Occupancy rating +2 or more,73,28,10,18,43,11,31,26,4,1,1,0,1,2,1,0,0,1
S01013390,Occupancy rating +1,69,26,9,17,37,4,25,8,13,4,8,4,4,6,2,0,0,4
S01013390,Occupancy rating 0,57,15,3,12,37,1,23,5,10,8,13,8,5,5,2,0,0,3
S01013390,Occupancy rating -1 or less,11,2,0,2,7,0,6,1,4,1,1,1,0,2,2,0,0,0
S01013391,All households,173,42,29,13,120,16,91,39,35,17,13,9,4,11,5,0,0,6
S01013391,Occupancy rating +2 or more,67,13,9,4,52,10,39,27,8,4,3,1,2,2,0,0,0,2
S01013391,Occupancy rating +1,53,23,15,8,29,3,22,10,8,4,4,2,2,1,1,0,0,0
S01013391,Occupancy rating 0,39,5,4,1,30,3,21,1,14,6,6,6,0,4,2,0,0,2
S01013391,Occupancy rating -1 or less,14,1,1,0,9,0,9,1,5,3,0,0,0,4,2,0,0,2
S01013392,All households,270,31,3,28,226,5,204,73,112,19,17,14,3,13,8,0,0,5
S01013392,Occupancy rating +2 or more,197,29,3,26,164,5,154,70,71,13,5,3,2,4,3,0,0,1
S01013392,Occupancy rating +1,45,0,0,0,42,0,33,2,29,2,9,8,1,3,0,0,0,3
S01013392,Occupancy rating 0,21,2,0,2,15,0,12,1,7,4,3,3,0,4,3,0,0,1
S01013392,Occupancy rating -1 or less,7,0,0,0,5,0,5,0,5,0,0,0,0,2,2,0,0,0
S01013393,All households,324,116,56,60,195,17,137,54,68,15,41,30,11,13,6,0,1,6
S01013393,Occupancy rating +2 or more,96,28,16,12,67,8,54,29,19,6,5,4,1,1,0,0,0,1
S01013393,Occupancy rating +1,98,35,9,26,61,6,48,20,25,3,7,6,1,2,1,0,0,1
S01013393,Occupancy rating 0,105,50,30,20,50,2,25,4,15,6,23,16,7,5,2,0,0,3
S01013393,Occupancy rating -1 or less,25,3,1,2,17,1,10,1,9,0,6,4,2,5,3,0,1,1
S01013394,All households,288,86,23,63,186,20,115,38,49,28,51,39,12,16,8,0,1,7
S01013394,Occupancy rating +2 or more,96,34,15,19,61,10,49,28,11,10,2,2,0,1,0,0,0,1
S01013394,Occupancy rating +1,80,28,6,22,50,9,30,9,11,10,11,7,4,2,1,0,0,1
S01013394,Occupancy rating 0,82,18,1,17,54,1,27,1,21,5,26,20,6,10,5,0,1,4
S01013394,Occupancy rating -1 or less,30,6,1,5,21,0,9,0,6,3,12,10,2,3,2,0,0,1
S01013395,All households,352,144,31,113,199,6,100,36,58,6,93,79,14,9,2,1,0,6
S01013395,Occupancy rating +2 or more,34,16,0,16,18,2,11,7,4,0,5,2,3,0,0,0,0,0
S01013395,Occupancy rating +1,162,100,23,77,58,3,40,25,13,2,15,13,2,4,0,1,0,3
S01013395,Occupancy rating 0,109,16,6,10,91,1,34,1,32,1,56,48,8,2,0,0,0,2
S01013395,Occupancy rating -1 or less,47,12,2,10,32,0,15,3,9,3,17,16,1,3,2,0,0,1
S01013396,All households,255,28,1,27,218,1,200,85,109,6,17,13,4,9,5,1,0,3
S01013396,Occupancy rating +2 or more,139,14,0,14,121,0,117,53,62,2,4,4,0,4,2,1,0,1
S01013396,Occupancy rating +1,87,14,1,13,71,0,67,29,36,2,4,4,0,2,1,0,0,1
S01013396,Occupancy rating 0,25,0,0,0,24,0,16,3,11,2,8,4,4,1,0,0,0,1
S01013396,Occupancy rating -1 or less,4,0,0,0,2,1,0,0,0,0,1,1,0,2,2,0,0,0
S01013397,All households,376,109,42,67,256,27,182,79,68,35,47,29,18,11,3,0,1,7
S01013397,Occupancy rating +2 or more,127,31,11,20,95,11,78,44,24,10,6,3,3,1,0,0,0,1
S01013397,Occupancy rating +1,143,57,22,35,84,12,59,31,19,9,13,7,6,2,1,0,0,1
S01013397,Occupancy rating 0,84,15,7,8,64,4,37,3,21,13,23,15,8,5,1,0,0,4
S01013397,Occupancy rating -1 or less,22,6,2,4,13,0,8,1,4,3,5,4,1,3,1,0,1,1
S01013398,All households,183,15,5,10,157,5,139,34,87,18,13,8,5,11,7,0,0,4
S01013398,Occupancy rating +2 or more,142,14,4,10,120,5,104,32,61,11,11,7,4,8,5,0,0,3
S01013398,Occupancy rating +1,22,1,1,0,20,0,18,2,13,3,2,1,1,1,1,0,0,0
S01013398,Occupancy rating 0,14,0,0,0,13,0,13,0,10,3,0,0,0,1,1,0,0,0
S01013398,Occupancy rating -1 or less,5,0,0,0,4,0,4,0,3,1,0,0,0,1,0,0,0,1
S01013399,All households,399,79,24,55,302,14,259,96,127,36,29,22,7,18,11,0,0,7
S01013399,Occupancy rating +2 or more,248,42,10,32,197,11,179,79,86,14,7,6,1,9,5,0,0,4
S01013399,Occupancy rating +1,87,24,8,16,62,2,52,13,26,13,8,8,0,1,1,0,0,0
S01013399,Occupancy rating 0,53,13,6,7,35,1,25,3,14,8,9,4,5,5,2,0,0,3
S01013399,Occupancy rating -1 or less,11,0,0,0,8,0,3,1,1,1,5,4,1,3,3,0,0,0
S01013400,All households,314,117,24,93,184,19,121,57,42,22,44,29,15,13,6,0,1,6
S01013400,Occupancy rating +2 or more,82,33,8,25,49,8,39,24,9,6,2,2,0,0,0,0,0,0
S01013400,Occupancy rating +1,128,57,12,45,67,9,47,26,14,7,11,5,6,4,1,0,0,3
S01013400,Occupancy rating 0,79,20,3,17,57,2,29,7,16,6,26,17,9,2,1,0,0,1
S01013400,Occupancy rating -1 or less,25,7,1,6,11,0,6,0,3,3,5,5,0,7,4,0,1,2
S01013401,All households,324,63,6,57,247,3,212,97,99,16,32,27,5,14,5,0,0,9
S01013401,Occupancy rating +2 or more,195,28,3,25,162,2,155,65,76,14,5,4,1,5,3,0,0,2
S01013401,Occupancy rating +1,80,24,2,22,52,1,44,30,12,2,7,7,0,4,2,0,0,2
S01013401,Occupancy rating 0,43,8,1,7,31,0,13,2,11,0,18,14,4,4,0,0,0,4
S01013401,Occupancy rating -1 or less,6,3,0,3,2,0,0,0,0,0,2,2,0,1,0,0,0,1
S01013402,All households,429,102,2,100,301,3,267,108,150,9,31,27,4,26,13,0,1,12
S01013402,Occupancy rating +2 or more,220,30,0,30,185,1,179,69,106,4,5,5,0,5,4,0,0,1
S01013402,Occupancy rating +1,111,44,2,42,59,2,52,27,24,1,5,5,0,8,3,0,1,4
S01013402,Occupancy rating 0,76,26,0,26,41,0,28,12,14,2,13,12,1,9,3,0,0,6
S01013402,Occupancy rating -1 or less,22,2,0,2,16,0,8,0,6,2,8,5,3,4,3,0,0,1
S01013403,All households,332,65,7,58,242,3,210,66,135,9,29,26,3,25,5,0,0,20
S01013403,Occupancy rating +2 or more,181,23,3,20,157,1,146,37,102,7,10,9,1,1,1,0,0,0
S01013403,Occupancy rating +1,77,31,2,29,43,1,39,27,11,1,3,3,0,3,0,0,0,3
S01013403,Occupancy rating 0,44,5,0,5,26,1,16,1,14,1,9,8,1,13,1,0,0,12
S01013403,Occupancy rating -1 or less,30,6,2,4,16,0,9,1,8,0,7,6,1,8,3,0,0,5
S01013404,All households,211,37,1,36,162,4,127,40,78,9,31,28,3,12,6,0,0,6
S01013404,Occupancy rating +2 or more,119,21,0,21,95,2,86,29,51,6,7,6,1,3,3,0,0,0
S01013404,Occupancy rating +1,52,15,1,14,35,2,26,9,16,1,7,7,0,2,1,0,0,1
S01013404,Occupancy rating 0,27,0,0,0,23,0,12,2,9,1,11,9,2,4,1,0,0,3
S01013404,Occupancy rating -1 or less,13,1,0,1,9,0,3,0,2,1,6,6,0,3,1,0,0,2
S01013405,All households,329,120,57,63,203,43,134,65,46,23,26,16,10,6,2,0,0,4
S01013405,Occupancy rating +2 or more,122,37,18,19,83,22,59,37,13,9,2,0,2,2,0,0,0,2
S01013405,Occupancy rating +1,141,70,33,37,71,18,50,26,15,9,3,1,2,0,0,0,0,0
S01013405,Occupancy rating 0,49,10,6,4,36,2,17,0,13,4,17,12,5,3,2,0,0,1
S01013405,Occupancy rating -1 or less,17,3,0,3,13,1,8,2,5,1,4,3,1,1,0,0,0,1
S01013406,All households,270,72,26,46,182,26,108,40,42,26,48,33,15,16,4,0,1,11
S01013406,Occupancy rating +2 or more,52,15,9,6,36,8,28,22,1,5,0,0,0,1,0,0,0,1
S01013406,Occupancy rating +1,116,50,14,36,65,16,33,17,9,7,16,10,6,1,0,0,0,1
S01013406,Occupancy rating 0,77,5,2,3,61,2,37,0,28,9,22,14,8,11,3,0,1,7
S01013406,Occupancy rating -1 or less,25,2,1,1,20,0,10,1,4,5,10,9,1,3,1,0,0,2
S01013407,All households,259,97,37,60,154,23,87,38,36,13,44,27,17,8,1,0,0,7
S01013407,Occupancy rating +2 or more,47,17,8,9,28,5,21,14,5,2,2,1,1,2,0,0,0,2
S01013407,Occupancy rating +1,127,73,28,45,53,17,31,20,7,4,5,3,2,1,0,0,0,1
S01013407,Occupancy rating 0,70,5,1,4,62,1,27,3,18,6,34,21,13,3,0,0,0,3
S01013407,Occupancy rating -1 or less,15,2,0,2,11,0,8,1,6,1,3,2,1,2,1,0,0,1
S01013408,All households,302,102,56,46,189,31,93,35,45,13,65,51,14,11,3,0,0,8
S01013408,Occupancy rating +2 or more,78,30,20,10,47,20,23,14,7,2,4,1,3,1,1,0,0,0
S01013408,Occupancy rating +1,100,34,10,24,63,8,33,18,11,4,22,15,7,3,0,0,0,3
S01013408,Occupancy rating 0,96,30,24,6,63,2,31,2,23,6,30,28,2,3,0,0,0,3
S01013408,Occupancy rating -1 or less,28,8,2,6,16,1,6,1,4,1,9,7,2,4,2,0,0,2
S01013409,All households,428,104,24,80,296,32,197,69,92,36,67,50,17,28,8,0,0,20
S01013409,Occupancy rating +2 or more,168,33,10,23,131,18,108,41,46,21,5,3,2,4,2,0,0,2
S01013409,Occupancy rating +1,134,59,12,47,69,11,42,28,10,4,16,14,2,6,2,0,0,4
S01013409,Occupancy rating 0,89,8,2,6,71,2,38,0,30,8,31,20,11,10,1,0,0,9
S01013409,Occupancy rating -1 or less,37,4,0,4,25,1,9,0,6,3,15,13,2,8,3,0,0,5
S01013410,All households,290,83,14,69,182,10,102,42,56,4,70,62,8,25,7,0,0,18
S01013410,Occupancy rating +2 or more,34,19,6,13,14,3,10,6,4,0,1,0,1,1,0,0,0,1
S01013410,Occupancy rating +1,88,35,3,32,50,3,32,20,11,1,15,15,0,3,1,0,0,2
S01013410,Occupancy rating 0,123,18,4,14,91,2,43,11,29,3,46,40,6,14,1,0,0,13
S01013410,Occupancy rating -1 or less,45,11,1,10,27,2,17,5,12,0,8,7,1,7,5,0,0,2
S01013411,All households,333,113,25,88,204,33,139,63,49,27,32,20,12,16,6,0,0,10
S01013411,Occupancy rating +2 or more,150,35,16,19,112,28,81,40,28,13,3,2,1,3,1,0,0,2
S01013411,Occupancy rating +1,99,49,7,42,47,2,41,19,12,10,4,1,3,3,1,0,0,2
S01013411,Occupancy rating 0,72,28,2,26,38,3,16,4,8,4,19,13,6,6,3,0,0,3
S01013411,Occupancy rating -1 or less,12,1,0,1,7,0,1,0,1,0,6,4,2,4,1,0,0,3
S01013412,All households,364,134,41,93,212,22,151,61,72,18,39,25,14,18,8,0,1,9
S01013412,Occupancy rating +2 or more,135,36,16,20,96,16,75,38,26,11,5,5,0,3,0,0,1,2
S01013412,Occupancy rating +1,122,68,15,53,52,6,39,17,17,5,7,4,3,2,1,0,0,1
S01013412,Occupancy rating 0,80,23,9,14,52,0,29,5,22,2,23,14,9,5,2,0,0,3
S01013412,Occupancy rating -1 or less,27,7,1,6,12,0,8,1,7,0,4,2,2,8,5,0,0,3
S01013413,All households,336,96,57,39,229,42,174,70,79,25,13,8,5,11,1,0,0,10
S01013413,Occupancy rating +2 or more,194,33,18,15,156,30,124,57,53,14,2,2,0,5,0,0,0,5
S01013413,Occupancy rating +1,59,20,3,17,35,2,28,7,11,10,5,2,3,4,0,0,0,4
S01013413,Occupancy rating 0,51,18,15,3,32,8,19,4,14,1,5,4,1,1,1,0,0,0
S01013413,Occupancy rating -1 or less,32,25,21,4,6,2,3,2,1,0,1,0,1,1,0,0,0,1
S01013414,All households,484,259,124,135,203,36,114,64,42,8,53,42,11,22,5,0,0,17
S01013414,Occupancy rating +2 or more,71,23,11,12,47,7,39,23,11,5,1,1,0,1,0,0,0,1
S01013414,Occupancy rating +1,177,111,52,59,61,18,40,30,8,2,3,1,2,5,2,0,0,3
S01013414,Occupancy rating 0,182,96,41,55,78,11,26,8,17,1,41,33,8,8,0,0,0,8
S01013414,Occupancy rating -1 or less,54,29,20,9,17,0,9,3,6,0,8,7,1,8,3,0,0,5
S01013415,All households,385,220,85,135,141,22,73,34,23,16,46,31,15,24,6,0,2,16
S01013415,Occupancy rating +2 or more,46,27,11,16,18,6,11,7,3,1,1,1,0,1,1,0,0,0
S01013415,Occupancy rating +1,98,57,16,41,40,11,23,13,5,5,6,3,3,1,0,0,0,1
S01013415,Occupancy rating 0,196,120,53,67,65,5,33,11,13,9,27,18,9,11,1,0,1,9
S01013415,Occupancy rating -1 or less,45,16,5,11,18,0,6,3,2,1,12,9,3,11,4,0,1,6
S01013416,All households,276,110,37,73,151,15,96,40,37,19,40,26,14,15,2,0,1,12
S01013416,Occupancy rating +2 or more,86,33,11,22,52,9,35,20,10,5,8,3,5,1,0,0,0,1
S01013416,Occupancy rating +1,105,55,20,35,49,6,35,18,12,5,8,4,4,1,0,0,0,1
S01013416,Occupancy rating 0,54,14,2,12,34,0,18,2,9,7,16,12,4,6,1,0,0,5
S01013416,Occupancy rating -1 or less,31,8,4,4,16,0,8,0,6,2,8,7,1,7,1,0,1,5
S01013417,All households,442,211,44,167,201,35,136,73,47,16,30,16,14,30,6,0,2,22
S01013417,Occupancy rating +2 or more,102,31,9,22,67,14,46,27,13,6,7,2,5,4,1,0,1,2
S01013417,Occupancy rating +1,102,48,19,29,51,14,32,18,10,4,5,1,4,3,0,0,0,3
S01013417,Occupancy rating 0,177,103,13,90,61,6,46,24,16,6,9,7,2,13,3,0,1,9
S01013417,Occupancy rating -1 or less,61,29,3,26,22,1,12,4,8,0,9,6,3,10,2,0,0,8
S01013418,All households,256,62,23,39,180,18,122,40,53,29,40,20,20,14,6,0,0,8
S01013418,Occupancy rating +2 or more,108,32,12,20,76,12,58,26,23,9,6,3,3,0,0,0,0,0
S01013418,Occupancy rating +1,94,27,10,17,60,6,38,13,14,11,16,7,9,7,3,0,0,4
S01013418,Occupancy rating 0,39,3,1,2,32,0,20,1,11,8,12,7,5,4,2,0,0,2
S01013418,Occupancy rating -1 or less,15,0,0,0,12,0,6,0,5,1,6,3,3,3,1,0,0,2
S01013419,All households,187,39,16,23,141,22,107,35,49,23,12,7,5,7,4,0,1,2
S01013419,Occupancy rating +2 or more,118,28,12,16,88,17,67,33,23,11,4,1,3,2,1,0,1,0
S01013419,Occupancy rating +1,49,8,3,5,38,5,28,1,18,9,5,3,2,3,2,0,0,1
S01013419,Occupancy rating 0,15,2,1,1,11,0,10,0,7,3,1,1,0,2,1,0,0,1
S01013419,Occupancy rating -1 or less,5,1,0,1,4,0,2,1,1,0,2,2,0,0,0,0,0,0
S01013420,All households,265,98,30,68,161,23,110,47,43,20,28,19,9,6,3,0,1,2
S01013420,Occupancy rating +2 or more,94,27,11,16,65,13,50,30,13,7,2,1,1,2,1,0,0,1
S01013420,Occupancy rating +1,87,39,12,27,46,7,32,14,16,2,7,6,1,2,0,0,1,1
S01013420,Occupancy rating 0,71,30,7,23,40,3,24,3,10,11,13,8,5,1,1,0,0,0
S01013420,Occupancy rating -1 or less,13,2,0,2,10,0,4,0,4,0,6,4,2,1,1,0,0,0
S01013421,All households,278,41,5,36,226,10,196,51,131,14,20,15,5,11,6,0,0,5
S01013421,Occupancy rating +2 or more,182,19,3,16,161,7,148,47,92,9,6,5,1,2,1,0,0,1
S01013421,Occupancy rating +1,55,10,0,10,40,2,32,4,25,3,6,4,2,5,2,0,0,3
S01013421,Occupancy rating 0,34,11,1,10,21,0,15,0,13,2,6,5,1,2,1,0,0,1
S01013421,Occupancy rating -1 or less,7,1,1,0,4,1,1,0,1,0,2,1,1,2,2,0,0,0
S01013422,All households,303,70,39,31,218,23,152,68,62,22,43,28,15,15,6,0,1,8
S01013422,Occupancy rating +2 or more,121,45,25,20,74,13,60,40,14,6,1,1,0,2,0,0,0,2
S01013422,Occupancy rating +1,112,22,13,9,84,10,56,26,20,10,18,9,9,6,2,0,0,4
S01013422,Occupancy rating 0,61,2,0,2,54,0,32,2,24,6,22,16,6,5,2,0,1,2
S01013422,Occupancy rating -1 or less,9,1,1,0,6,0,4,0,4,0,2,2,0,2,2,0,0,0
S01013423,All households,332,79,40,39,240,28,177,67,78,32,35,19,16,13,6,0,1,6
S01013423,Occupancy rating +2 or more,163,30,17,13,131,20,105,46,42,17,6,3,3,2,1,0,0,1
S01013423,Occupancy rating +1,97,40,19,21,55,7,42,15,19,8,6,3,3,2,0,0,0,2
S01013423,Occupancy rating 0,54,6,3,3,44,1,24,4,14,6,19,10,9,4,1,0,1,2
S01013423,Occupancy rating -1 or less,18,3,1,2,10,0,6,2,3,1,4,3,1,5,4,0,0,1
S01013424,All households,188,38,15,23,144,12,115,37,61,17,17,11,6,6,3,0,0,3
S01013424,Occupancy rating +2 or more,122,20,6,14,100,10,83,31,41,11,7,4,3,2,1,0,0,1
S01013424,Occupancy rating +1,37,8,7,1,27,2,22,3,16,3,3,1,2,2,0,0,0,2
S01013424,Occupancy rating 0,27,10,2,8,15,0,9,3,4,2,6,5,1,2,2,0,0,0
S01013424,Occupancy rating -1 or less,2,0,0,0,2,0,1,0,0,1,1,1,0,0,0,0,0,0
S01013425,All households,199,78,32,46,113,13,88,39,35,14,12,8,4,8,7,0,0,1
S01013425,Occupancy rating +2 or more,79,18,10,8,59,8,48,24,16,8,3,1,2,2,1,0,0,1
S01013425,Occupancy rating +1,46,20,7,13,26,1,22,11,10,1,3,2,1,0,0,0,0,0
S01013425,Occupancy rating 0,60,33,13,20,23,4,14,4,6,4,5,4,1,4,4,0,0,0
S01013425,Occupancy rating -1 or less,14,7,2,5,5,0,4,0,3,1,1,1,0,2,2,0,0,0
S01013426,All households,368,116,53,63,234,25,148,65,56,27,61,40,21,18,8,0,1,9
S01013426,Occupancy rating +2 or more,107,31,16,15,73,11,62,39,14,9,0,0,0,3,3,0,0,0
S01013426,Occupancy rating +1,129,55,24,31,72,10,46,23,15,8,16,8,8,2,0,0,1,1
S01013426,Occupancy rating 0,97,23,9,14,68,3,32,2,21,9,33,25,8,6,2,0,0,4
S01013426,Occupancy rating -1 or less,35,7,4,3,21,1,8,1,6,1,12,7,5,7,3,0,0,4
S01013427,All households,171,35,8,27,130,4,111,47,53,11,15,9,6,6,2,0,0,4
S01013427,Occupancy rating +2 or more,123,19,8,11,100,1,93,38,47,8,6,5,1,4,1,0,0,3
S01013427,Occupancy rating +1,31,16,0,16,14,3,10,8,1,1,1,0,1,1,1,0,0,0
S01013427,Occupancy rating 0,11,0,0,0,11,0,6,1,4,1,5,2,3,0,0,0,0,0
S01013427,Occupancy rating -1 or less,6,0,0,0,5,0,2,0,1,1,3,2,1,1,0,0,0,1
S01013428,All households,379,93,29,64,257,15,168,64,80,24,74,47,27,29,12,0,0,17
S01013428,Occupancy rating +2 or more,123,38,19,19,82,11,64,36,23,5,7,5,2,3,1,0,0,2
S01013428,Occupancy rating +1,103,21,5,16,77,3,52,18,25,9,22,14,8,5,1,0,0,4
S01013428,Occupancy rating 0,121,30,4,26,82,1,45,9,27,9,36,23,13,9,3,0,0,6
S01013428,Occupancy rating -1 or less,32,4,1,3,16,0,7,1,5,1,9,5,4,12,7,0,0,5
S01013429,All households,300,88,31,57,201,17,145,66,50,29,39,27,12,11,4,0,0,7
S01013429,Occupancy rating +2 or more,130,41,16,25,86,9,72,48,18,6,5,3,2,3,2,0,0,1
S01013429,Occupancy rating +1,94,31,13,18,61,4,41,14,12,15,16,13,3,2,0,0,0,2
S01013429,Occupancy rating 0,58,15,2,13,39,1,26,2,17,7,12,8,4,4,1,0,0,3
S01013429,Occupancy rating -1 or less,18,1,0,1,15,3,6,2,3,1,6,3,3,2,1,0,0,1
S01013430,All households,277,46,20,26,223,23,169,73,67,29,31,21,10,8,4,0,0,4
S01013430,Occupancy rating +2 or more,133,17,4,13,114,14,90,51,29,10,10,7,3,2,1,0,0,1
S01013430,Occupancy rating +1,84,22,12,10,59,8,42,20,12,10,9,7,2,3,1,0,0,2
S01013430,Occupancy rating 0,50,6,3,3,41,1,32,2,21,9,8,5,3,3,2,0,0,1
S01013430,Occupancy rating -1 or less,10,1,1,0,9,0,5,0,5,0,4,2,2,0,0,0,0,0
S01013431,All households,304,104,50,54,191,24,121,49,48,24,46,27,19,9,5,0,1,3
S01013431,Occupancy rating +2 or more,111,36,22,14,71,15,51,34,11,6,5,3,2,4,3,0,0,1
S01013431,Occupancy rating +1,79,31,12,19,47,7,30,12,11,7,10,5,5,1,1,0,0,0
S01013431,Occupancy rating 0,92,33,16,17,56,1,34,3,21,10,21,15,6,3,1,0,1,1
S01013431,Occupancy rating -1 or less,22,4,0,4,17,1,6,0,5,1,10,4,6,1,0,0,0,1
S01013432,All households,293,76,25,51,201,15,159,73,61,25,27,19,8,16,6,0,0,10
S01013432,Occupancy rating +2 or more,149,31,13,18,114,10,99,56,30,13,5,3,2,4,1,0,0,3
S01013432,Occupancy rating +1,87,25,6,19,55,3,37,13,14,10,15,10,5,7,3,0,0,4
S01013432,Occupancy rating 0,45,16,6,10,26,2,19,3,14,2,5,5,0,3,0,0,0,3
S01013432,Occupancy rating -1 or less,12,4,0,4,6,0,4,1,3,0,2,1,1,2,2,0,0,0
S01013433,All households,309,70,43,27,229,32,174,79,77,18,23,13,10,10,8,0,0,2
S01013433,Occupancy rating +2 or more,200,37,26,11,159,23,126,66,51,9,10,4,6,4,3,0,0,1
S01013433,Occupancy rating +1,58,17,7,10,38,5,28,10,14,4,5,2,3,3,2,0,0,1
S01013433,Occupancy rating 0,42,15,10,5,26,4,15,2,9,4,7,6,1,1,1,0,0,0
S01013433,Occupancy rating -1 or less,9,1,0,1,6,0,5,1,3,1,1,1,0,2,2,0,0,0
S01013434,All households,207,46,23,23,155,14,133,48,67,18,8,7,1,6,3,0,0,3
S01013434,Occupancy rating +2 or more,152,31,17,14,119,13,104,42,51,11,2,1,1,2,1,0,0,1
S01013434,Occupancy rating +1,30,9,3,6,21,1,17,6,8,3,3,3,0,0,0,0,0,0
S01013434,Occupancy rating 0,16,3,1,2,11,0,9,0,7,2,2,2,0,2,1,0,0,1
S01013434,Occupancy rating -1 or less,9,3,2,1,4,0,3,0,1,2,1,1,0,2,1,0,0,1
S01013435,All households,221,22,6,16,198,10,172,51,98,23,16,10,6,1,1,0,0,0
S01013435,Occupancy rating +2 or more,182,10,4,6,172,10,150,44,83,23,12,6,6,0,0,0,0,0
S01013435,Occupancy rating +1,15,3,0,3,12,0,10,3,7,0,2,2,0,0,0,0,0,0
S01013435,Occupancy rating 0,13,6,1,5,6,0,5,1,4,0,1,1,0,1,1,0,0,0
S01013435,Occupancy rating -1 or less,11,3,1,2,8,0,7,3,4,0,1,1,0,0,0,0,0,0
S01013436,All households,339,83,38,45,238,22,158,45,91,22,58,33,25,18,9,0,0,9
S01013436,Occupancy rating +2 or more,135,33,14,19,100,8,84,27,46,11,8,3,5,2,0,0,0,2
S01013436,Occupancy rating +1,110,45,21,24,59,10,40,16,19,5,9,3,6,6,0,0,0,6
S01013436,Occupancy rating 0,57,1,0,1,53,1,21,1,15,5,31,19,12,3,3,0,0,0
S01013436,Occupancy rating -1 or less,37,4,3,1,26,3,13,1,11,1,10,8,2,7,6,0,0,1
S01013437,All households,308,108,22,86,187,18,137,72,37,28,32,19,13,13,6,0,1,6
S01013437,Occupancy rating +2 or more,73,15,5,10,56,11,40,23,8,9,5,3,2,2,2,0,0,0
S01013437,Occupancy rating +1,124,51,11,40,65,7,51,28,12,11,7,2,5,8,1,0,1,6
S01013437,Occupancy rating 0,96,41,5,36,53,0,37,19,12,6,16,11,5,2,2,0,0,0
S01013437,Occupancy rating -1 or less,15,1,1,0,13,0,9,2,5,2,4,3,1,1,1,0,0,0
S01013438,All households,285,111,51,60,163,16,102,48,41,13,45,34,11,11,5,0,0,6
S01013438,Occupancy rating +2 or more,66,27,13,14,38,8,26,15,9,2,4,1,3,1,1,0,0,0
S01013438,Occupancy rating +1,121,66,34,32,52,7,39,27,7,5,6,3,3,3,1,0,0,2
S01013438,Occupancy rating 0,84,16,3,13,63,0,30,4,22,4,33,28,5,5,1,0,0,4
S01013438,Occupancy rating -1 or less,14,2,1,1,10,1,7,2,3,2,2,2,0,2,2,0,0,0
S01013439,All households,351,44,33,11,301,58,225,93,97,35,18,7,11,6,3,0,0,3
S01013439,Occupancy rating +2 or more,282,41,32,9,238,56,174,89,64,21,8,2,6,3,1,0,0,2
S01013439,Occupancy rating +1,52,2,1,1,48,2,41,3,26,12,5,3,2,2,1,0,0,1
S01013439,Occupancy rating 0,14,1,0,1,13,0,9,1,6,2,4,1,3,0,0,0,0,0
S01013439,Occupancy rating -1 or less,3,0,0,0,2,0,1,0,1,0,1,1,0,1,1,0,0,0
S01013440,All households,378,40,22,18,327,59,250,94,113,43,18,8,10,11,5,0,0,6
S01013440,Occupancy rating +2 or more,318,36,20,16,277,56,213,86,91,36,8,3,5,5,3,0,0,2
S01013440,Occupancy rating +1,42,4,2,2,34,3,26,6,16,4,5,2,3,4,2,0,0,2
S01013440,Occupancy rating 0,15,0,0,0,14,0,10,2,6,2,4,2,2,1,0,0,0,1
S01013440,Occupancy rating -1 or less,3,0,0,0,2,0,1,0,0,1,1,1,0,1,0,0,0,1
S01013441,All households,317,75,31,44,230,40,176,75,80,21,14,5,9,12,2,0,1,9
S01013441,Occupancy rating +2 or more,208,43,23,20,160,36,122,54,53,15,2,0,2,5,1,0,1,3
S01013441,Occupancy rating +1,64,22,7,15,41,4,33,16,14,3,4,3,1,1,1,0,0,0
S01013441,Occupancy rating 0,36,10,1,9,20,0,15,4,10,1,5,1,4,6,0,0,0,6
S01013441,Occupancy rating -1 or less,9,0,0,0,9,0,6,1,3,2,3,1,2,0,0,0,0,0
S01013442,All households,328,88,26,62,229,18,181,65,74,42,30,22,8,11,6,0,0,5
S01013442,Occupancy rating +2 or more,157,21,9,12,135,14,115,40,48,27,6,4,2,1,1,0,0,0
S01013442,Occupancy rating +1,93,40,13,27,50,3,45,23,14,8,2,2,0,3,1,0,0,2
S01013442,Occupancy rating 0,60,17,4,13,37,1,17,2,9,6,19,15,4,6,4,0,0,2
S01013442,Occupancy rating -1 or less,18,10,0,10,7,0,4,0,3,1,3,1,2,1,0,0,0,1
S01013443,All households,295,111,41,70,177,23,133,66,56,11,21,17,4,7,2,0,0,5
S01013443,Occupancy rating +2 or more,108,17,10,7,90,15,70,39,26,5,5,4,1,1,1,0,0,0
S01013443,Occupancy rating +1,100,60,21,39,40,4,35,19,13,3,1,1,0,0,0,0,0,0
S01013443,Occupancy rating 0,64,24,6,18,36,4,23,7,14,2,9,6,3,4,1,0,0,3
S01013443,Occupancy rating -1 or less,23,10,4,6,11,0,5,1,3,1,6,6,0,2,0,0,0,2
S01013444,All households,520,259,124,135,235,21,170,98,53,19,44,25,19,26,6,1,2,17
S01013444,Occupancy rating +2 or more,120,35,16,19,83,9,69,37,23,9,5,2,3,2,1,0,0,1
S01013444,Occupancy rating +1,193,106,48,58,84,7,68,53,9,6,9,6,3,3,0,1,0,2
S01013444,Occupancy rating 0,140,81,40,41,50,4,23,6,15,2,23,13,10,9,0,0,2,7
S01013444,Occupancy rating -1 or less,67,37,20,17,18,1,10,2,6,2,7,4,3,12,5,0,0,7
S01013445,All households,252,72,59,13,173,25,140,41,71,28,8,5,3,7,2,0,2,3
S01013445,Occupancy rating +2 or more,166,26,20,6,138,16,120,39,60,21,2,2,0,2,1,0,1,0
S01013445,Occupancy rating +1,43,22,15,7,20,4,11,2,6,3,5,2,3,1,1,0,0,0
S01013445,Occupancy rating 0,34,21,21,0,11,5,6,0,3,3,0,0,0,2,0,0,0,2
S01013445,Occupancy rating -1 or less,9,3,3,0,4,0,3,0,2,1,1,1,0,2,0,0,1,1
S01013446,All households,309,84,46,38,207,28,144,62,57,25,35,20,15,18,9,0,3,6
S01013446,Occupancy rating +2 or more,122,34,22,12,81,21,58,35,19,4,2,1,1,7,3,0,1,3
S01013446,Occupancy rating +1,98,30,17,13,65,6,50,24,15,11,9,5,4,3,2,0,1,0
S01013446,Occupancy rating 0,72,19,6,13,48,1,30,3,18,9,17,9,8,5,1,0,1,3
S01013446,Occupancy rating -1 or less,17,1,1,0,13,0,6,0,5,1,7,5,2,3,3,0,0,0
S01013447,All households,198,18,3,15,179,2,160,30,118,12,17,11,6,1,0,0,0,1
S01013447,Occupancy rating +2 or more,151,6,1,5,144,2,132,25,95,12,10,6,4,1,0,0,0,1
S01013447,Occupancy rating +1,18,0,0,0,18,0,16,2,14,0,2,2,0,0,0,0,0,0
S01013447,Occupancy rating 0,20,12,2,10,8,0,7,3,4,0,1,0,1,0,0,0,0,0
S01013447,Occupancy rating -1 or less,9,0,0,0,9,0,5,0,5,0,4,3,1,0,0,0,0,0
S01013448,All households,390,160,93,67,217,46,164,74,65,25,7,5,2,13,7,0,1,5
S01013448,Occupancy rating +2 or more,192,48,23,25,141,33,102,53,34,15,6,5,1,3,0,0,1,2
S01013448,Occupancy rating +1,92,43,24,19,46,9,37,12,19,6,0,0,0,3,3,0,0,0
S01013448,Occupancy rating 0,84,54,39,15,25,4,20,8,9,3,1,0,1,5,2,0,0,3
S01013448,Occupancy rating -1 or less,22,15,7,8,5,0,5,1,3,1,0,0,0,2,2,0,0,0
S01013449,All households,273,74,31,43,194,23,152,62,71,19,19,10,9,5,2,0,0,3
S01013449,Occupancy rating +2 or more,166,40,19,21,126,18,99,47,39,13,9,5,4,0,0,0,0,0
S01013449,Occupancy rating +1,72,21,11,10,49,4,39,12,22,5,6,3,3,2,0,0,0,2
S01013449,Occupancy rating 0,25,8,1,7,15,1,12,1,10,1,2,1,1,2,1,0,0,1
S01013449,Occupancy rating -1 or less,10,5,0,5,4,0,2,2,0,0,2,1,1,1,1,0,0,0
S01013450,All households,249,65,16,49,180,13,145,62,64,19,22,16,6,4,2,0,0,2
S01013450,Occupancy rating +2 or more,109,13,4,9,95,7,82,38,34,10,6,4,2,1,0,0,0,1
S01013450,Occupancy rating +1,83,35,9,26,48,3,41,18,18,5,4,3,1,0,0,0,0,0
S01013450,Occupancy rating 0,49,15,2,13,33,3,18,6,10,2,12,9,3,1,0,0,0,1
S01013450,Occupancy rating -1 or less,8,2,1,1,4,0,4,0,2,2,0,0,0,2,2,0,0,0
S01013451,All households,296,30,5,25,261,11,225,66,128,31,25,19,6,5,1,0,0,4
S01013451,Occupancy rating +2 or more,220,17,3,14,201,8,177,59,98,20,16,13,3,2,0,0,0,2
S01013451,Occupancy rating +1,58,12,2,10,46,3,37,7,21,9,6,3,3,0,0,0,0,0
S01013451,Occupancy rating 0,16,1,0,1,13,0,10,0,8,2,3,3,0,2,1,0,0,1
S01013451,Occupancy rating -1 or less,2,0,0,0,1,0,1,0,1,0,0,0,0,1,0,0,0,1
S01013452,All households,300,64,23,41,231,17,195,67,103,25,19,16,3,5,3,0,0,2
S01013452,Occupancy rating +2 or more,184,18,9,9,163,15,141,53,69,19,7,7,0,3,2,0,0,1
S01013452,Occupancy rating +1,52,14,7,7,37,1,31,11,17,3,5,2,3,1,0,0,0,1
S01013452,Occupancy rating 0,51,26,6,20,25,0,19,3,14,2,6,6,0,0,0,0,0,0
S01013452,Occupancy rating -1 or less,13,6,1,5,6,1,4,0,3,1,1,1,0,1,1,0,0,0
S01013453,All households,344,106,46,60,222,17,139,63,55,21,66,52,14,16,8,0,1,7
S01013453,Occupancy rating +2 or more,70,19,8,11,49,10,34,22,10,2,5,4,1,2,2,0,0,0
S01013453,Occupancy rating +1,153,69,30,39,81,6,56,37,9,10,19,13,6,3,1,0,0,2
S01013453,Occupancy rating 0,92,15,6,9,71,1,34,4,22,8,36,30,6,6,2,0,0,4
S01013453,Occupancy rating -1 or less,29,3,2,1,21,0,15,0,14,1,6,5,1,5,3,0,1,1
S01013454,All households,317,81,37,44,226,24,184,86,77,21,18,8,10,10,5,0,0,5
S01013454,Occupancy rating +2 or more,155,31,15,16,120,17,99,50,36,13,4,2,2,4,4,0,0,0
S01013454,Occupancy rating +1,88,28,16,12,59,4,47,23,19,5,8,3,5,1,0,0,0,1
S01013454,Occupancy rating 0,61,19,4,15,38,3,31,11,17,3,4,3,1,4,1,0,0,3
S01013454,Occupancy rating -1 or less,13,3,2,1,9,0,7,2,5,0,2,0,2,1,0,0,0,1
S01013455,All households,262,87,29,58,162,22,125,66,44,15,15,6,9,13,2,0,3,8
S01013455,Occupancy rating +2 or more,119,33,12,21,83,16,63,37,21,5,4,0,4,3,2,0,1,0
S01013455,Occupancy rating +1,67,20,5,15,44,4,33,18,10,5,7,3,4,3,0,0,1,2
S01013455,Occupancy rating 0,63,27,9,18,29,0,25,10,10,5,4,3,1,7,0,0,1,6
S01013455,Occupancy rating -1 or less,13,7,3,4,6,2,4,1,3,0,0,0,0,0,0,0,0,0
S01013456,All households,372,147,71,76,210,24,156,66,63,27,30,18,12,15,4,0,1,10
S01013456,Occupancy rating +2 or more,92,19,10,9,72,11,56,31,16,9,5,3,2,1,0,0,0,1
S01013456,Occupancy rating +1,134,60,27,33,70,9,53,26,18,9,8,4,4,4,2,0,0,2
S01013456,Occupancy rating 0,122,64,30,34,52,4,37,9,22,6,11,6,5,6,2,0,1,3
S01013456,Occupancy rating -1 or less,24,4,4,0,16,0,10,0,7,3,6,5,1,4,0,0,0,4
S01013457,All households,384,96,47,49,267,33,159,64,66,29,75,49,26,21,7,0,5,9
S01013457,Occupancy rating +2 or more,106,46,25,21,57,16,38,30,5,3,3,2,1,3,0,0,1,2
S01013457,Occupancy rating +1,154,41,19,22,105,14,69,31,26,12,22,10,12,8,3,0,2,3
S01013457,Occupancy rating 0,95,8,2,6,81,1,36,1,25,10,44,31,13,6,2,0,2,2
S01013457,Occupancy rating -1 or less,29,1,1,0,24,2,16,2,10,4,6,6,0,4,2,0,0,2
S01013458,All households,333,131,35,96,194,24,141,60,54,27,29,20,9,8,4,0,0,4
S01013458,Occupancy rating +2 or more,106,28,12,16,77,16,58,25,23,10,3,2,1,1,0,0,0,1
S01013458,Occupancy rating +1,90,33,10,23,56,3,42,21,15,6,11,7,4,1,0,0,0,1
S01013458,Occupancy rating 0,97,49,8,41,45,4,31,12,11,8,10,6,4,3,1,0,0,2
S01013458,Occupancy rating -1 or less,40,21,5,16,16,1,10,2,5,3,5,5,0,3,3,0,0,0
S01013459,All households,421,206,96,110,201,16,147,73,51,23,38,22,16,14,4,0,0,10
S01013459,Occupancy rating +2 or more,100,30,12,18,66,7,55,31,16,8,4,2,2,4,2,0,0,2
S01013459,Occupancy rating +1,155,88,33,55,64,6,52,30,16,6,6,2,4,3,0,0,0,3
S01013459,Occupancy rating 0,135,76,46,30,55,2,31,9,14,8,22,13,9,4,2,0,0,2
S01013459,Occupancy rating -1 or less,31,12,5,7,16,1,9,3,5,1,6,5,1,3,0,0,0,3
S01013460,All households,346,108,48,60,212,23,137,37,65,35,52,37,15,26,10,0,3,13
S01013460,Occupancy rating +2 or more,132,57,34,23,72,19,49,28,13,8,4,2,2,3,0,0,1,2
S01013460,Occupancy rating +1,89,23,8,15,59,3,41,5,27,9,15,7,8,7,1,0,2,4
S01013460,Occupancy rating 0,103,27,6,21,64,1,39,4,21,14,24,20,4,12,7,0,0,5
S01013460,Occupancy rating -1 or less,22,1,0,1,17,0,8,0,4,4,9,8,1,4,2,0,0,2
S01013461,All households,443,123,45,78,293,15,221,76,121,24,57,44,13,27,14,0,1,12
S01013461,Occupancy rating +2 or more,180,55,24,31,119,11,103,44,50,9,5,3,2,6,1,0,0,5
S01013461,Occupancy rating +1,119,29,8,21,81,4,60,20,33,7,17,10,7,9,2,0,1,6
S01013461,Occupancy rating 0,106,30,10,20,73,0,44,8,30,6,29,26,3,3,3,0,0,0
S01013461,Occupancy rating -1 or less,38,9,3,6,20,0,14,4,8,2,6,5,1,9,8,0,0,1
S01013462,All households,354,87,17,70,259,16,212,102,88,22,31,21,10,8,2,0,0,6
S01013462,Occupancy rating +2 or more,138,19,6,13,115,6,107,61,31,15,2,1,1,4,1,0,0,3
S01013462,Occupancy rating +1,118,38,7,31,80,7,69,31,33,5,4,4,0,0,0,0,0,0
S01013462,Occupancy rating 0,76,21,2,19,53,3,31,9,20,2,19,13,6,2,1,0,0,1
S01013462,Occupancy rating -1 or less,22,9,2,7,11,0,5,1,4,0,6,3,3,2,0,0,0,2
S01013463,All households,216,35,10,25,165,1,111,32,64,15,53,46,7,16,9,0,0,7
S01013463,Occupancy rating +2 or more,58,13,4,9,44,0,38,21,14,3,6,6,0,1,1,0,0,0
S01013463,Occupancy rating +1,84,17,4,13,61,1,37,11,23,3,23,19,4,6,2,0,0,4
S01013463,Occupancy rating 0,59,5,2,3,52,0,33,0,26,7,19,17,2,2,1,0,0,1
S01013463,Occupancy rating -1 or less,15,0,0,0,8,0,3,0,1,2,5,4,1,7,5,0,0,2
S01013464,All households,323,95,56,39,218,36,150,75,47,28,32,15,17,10,1,0,1,8
S01013464,Occupancy rating +2 or more,163,49,33,16,111,23,82,55,16,11,6,2,4,3,1,0,0,2
S01013464,Occupancy rating +1,99,35,22,13,61,11,41,17,15,9,9,2,7,3,0,0,1,2
S01013464,Occupancy rating 0,49,8,1,7,38,2,21,2,12,7,15,9,6,3,0,0,0,3
S01013464,Occupancy rating -1 or less,12,3,0,3,8,0,6,1,4,1,2,2,0,1,0,0,0,1
S01013465,All households,337,130,66,64,190,33,135,69,42,24,22,13,9,17,2,0,2,13
S01013465,Occupancy rating +2 or more,130,49,23,26,77,16,58,34,13,11,3,1,2,4,0,0,0,4
S01013465,Occupancy rating +1,112,46,28,18,64,15,41,25,10,6,8,4,4,2,0,0,0,2
S01013465,Occupancy rating 0,79,30,14,16,46,2,33,9,19,5,11,8,3,3,1,0,2,0
S01013465,Occupancy rating -1 or less,16,5,1,4,3,0,3,1,0,2,0,0,0,8,1,0,0,7
S01013466,All households,116,24,11,13,85,15,66,25,27,14,4,2,2,7,1,0,0,6
S01013466,Occupancy rating +2 or more,81,19,9,10,58,14,43,21,16,6,1,1,0,4,0,0,0,4
S01013466,Occupancy rating +1,17,3,1,2,14,0,13,4,3,6,1,0,1,0,0,0,0,0
S01013466,Occupancy rating 0,13,2,1,1,9,1,6,0,4,2,2,1,1,2,0,0,0,2
S01013466,Occupancy rating -1 or less,5,0,0,0,4,0,4,0,4,0,0,0,0,1,1,0,0,0
S01013467,All households,364,58,25,33,296,39,236,74,145,17,21,12,9,10,2,0,3,5
S01013467,Occupancy rating +2 or more,242,29,10,19,209,25,174,59,107,8,10,5,5,4,0,0,1,3
S01013467,Occupancy rating +1,77,19,11,8,56,8,43,11,28,4,5,3,2,2,0,0,2,0
S01013467,Occupancy rating 0,40,9,4,5,28,6,17,3,10,4,5,4,1,3,2,0,0,1
S01013467,Occupancy rating -1 or less,5,1,0,1,3,0,2,1,0,1,1,0,1,1,0,0,0,1
S01013468,All households,312,156,67,89,148,21,96,38,43,15,31,21,10,8,2,0,0,6
S01013468,Occupancy rating +2 or more,114,38,15,23,74,14,56,29,21,6,4,3,1,2,1,0,0,1
S01013468,Occupancy rating +1,53,23,8,15,28,2,12,2,7,3,14,9,5,2,0,0,0,2
S01013468,Occupancy rating 0,115,82,38,44,30,5,20,5,11,4,5,3,2,3,1,0,0,2
S01013468,Occupancy rating -1 or less,30,13,6,7,16,0,8,2,4,2,8,6,2,1,0,0,0,1
S01013469,All households,329,76,40,36,235,46,159,76,49,34,30,15,15,18,7,0,1,10
S01013469,Occupancy rating +2 or more,217,52,34,18,161,44,109,68,22,19,8,4,4,4,1,0,0,3
S01013469,Occupancy rating +1,56,11,5,6,41,1,29,7,14,8,11,5,6,4,0,0,1,3
S01013469,Occupancy rating 0,44,10,1,9,26,1,18,1,10,7,7,5,2,8,4,0,0,4
S01013469,Occupancy rating -1 or less,12,3,0,3,7,0,3,0,3,0,4,1,3,2,2,0,0,0
S01013470,All households,321,99,34,65,199,15,117,42,53,22,67,48,19,23,11,0,1,11
S01013470,Occupancy rating +2 or more,68,25,13,12,42,5,32,20,6,6,5,4,1,1,0,0,0,1
S01013470,Occupancy rating +1,119,48,10,38,64,7,40,19,14,7,17,9,8,7,2,0,1,4
S01013470,Occupancy rating 0,105,22,8,14,73,0,34,2,25,7,39,31,8,10,7,0,0,3
S01013470,Occupancy rating -1 or less,29,4,3,1,20,3,11,1,8,2,6,4,2,5,2,0,0,3
S01013471,All households,383,95,41,54,265,25,172,68,71,33,68,47,21,23,9,0,1,13
S01013471,Occupancy rating +2 or more,141,54,24,30,85,21,60,46,9,5,4,3,1,2,0,0,0,2
S01013471,Occupancy rating +1,120,26,10,16,85,2,58,20,24,14,25,16,9,9,1,0,0,8
S01013471,Occupancy rating 0,93,12,6,6,76,1,42,2,28,12,33,23,10,5,3,0,1,1
S01013471,Occupancy rating -1 or less,29,3,1,2,19,1,12,0,10,2,6,5,1,7,5,0,0,2
S01013472,All households,208,25,1,24,171,4,159,42,102,15,8,5,3,12,8,0,2,2
S01013472,Occupancy rating +2 or more,155,16,0,16,132,4,124,35,79,10,4,2,2,7,4,0,2,1
S01013472,Occupancy rating +1,32,6,1,5,24,0,22,4,15,3,2,2,0,2,2,0,0,0
S01013472,Occupancy rating 0,15,2,0,2,11,0,10,2,6,2,1,1,0,2,1,0,0,1
S01013472,Occupancy rating -1 or less,6,1,0,1,4,0,3,1,2,0,1,0,1,1,1,0,0,0
S01013473,All households,213,14,3,11,190,5,177,42,119,16,8,7,1,9,7,0,0,2
S01013473,Occupancy rating +2 or more,179,12,3,9,161,5,152,39,98,15,4,3,1,6,5,0,0,1
S01013473,Occupancy rating +1,19,1,0,1,17,0,14,2,11,1,3,3,0,1,1,0,0,0
S01013473,Occupancy rating 0,10,1,0,1,9,0,8,1,7,0,1,1,0,0,0,0,0,0
S01013473,Occupancy rating -1 or less,5,0,0,0,3,0,3,0,3,0,0,0,0,2,1,0,0,1
S01013474,All households,238,44,13,31,186,12,155,47,92,16,19,15,4,8,3,0,0,5
S01013474,Occupancy rating +2 or more,132,14,4,10,117,8,103,28,67,8,6,5,1,1,0,0,0,1
S01013474,Occupancy rating +1,65,26,8,18,38,3,31,16,13,2,4,3,1,1,0,0,0,1
S01013474,Occupancy rating 0,32,3,0,3,26,1,16,3,8,5,9,7,2,3,0,0,0,3
S01013474,Occupancy rating -1 or less,9,1,1,0,5,0,5,0,4,1,0,0,0,3,3,0,0,0
S01013475,All households,246,48,16,32,195,22,149,58,64,27,24,16,8,3,0,0,0,3
S01013475,Occupancy rating +2 or more,137,27,15,12,110,21,83,45,20,18,6,3,3,0,0,0,0,0
S01013475,Occupancy rating +1,56,15,1,14,39,1,29,9,15,5,9,4,5,2,0,0,0,2
S01013475,Occupancy rating 0,36,6,0,6,30,0,26,3,19,4,4,4,0,0,0,0,0,0
S01013475,Occupancy rating -1 or less,17,0,0,0,16,0,11,1,10,0,5,5,0,1,0,0,0,1
S01013476,All households,271,65,26,39,193,42,121,43,50,28,30,14,16,13,6,0,1,6
S01013476,Occupancy rating +2 or more,123,22,11,11,98,31,60,26,21,13,7,2,5,3,1,0,1,1
S01013476,Occupancy rating +1,81,26,12,14,54,10,37,14,13,10,7,3,4,1,0,0,0,1
S01013476,Occupancy rating 0,52,13,1,12,34,0,20,2,14,4,14,8,6,5,1,0,0,4
S01013476,Occupancy rating -1 or less,15,4,2,2,7,1,4,1,2,1,2,1,1,4,4,0,0,0
S01013477,All households,303,129,54,75,153,15,107,53,34,20,31,26,5,21,5,0,1,15
S01013477,Occupancy rating +2 or more,72,25,15,10,45,8,35,23,6,6,2,2,0,2,0,0,1,1
S01013477,Occupancy rating +1,100,49,12,37,46,6,35,20,9,6,5,4,1,5,1,0,0,4
S01013477,Occupancy rating 0,90,35,14,21,50,1,28,7,15,6,21,17,4,5,1,0,0,4
S01013477,Occupancy rating -1 or less,41,20,13,7,12,0,9,3,4,2,3,3,0,9,3,0,0,6
S01013478,All households,358,122,27,95,221,7,174,63,87,24,40,31,9,15,8,0,0,7
S01013478,Occupancy rating +2 or more,138,38,14,24,93,3,87,39,37,11,3,3,0,7,4,0,0,3
S01013478,Occupancy rating +1,103,38,3,35,65,3,51,18,25,8,11,6,5,0,0,0,0,0
S01013478,Occupancy rating 0,90,38,8,30,50,1,30,6,19,5,19,15,4,2,1,0,0,1
S01013478,Occupancy rating -1 or less,27,8,2,6,13,0,6,0,6,0,7,7,0,6,3,0,0,3
S01013479,All households,428,212,88,124,200,29,124,70,41,13,47,35,12,16,2,0,1,13
S01013479,Occupancy rating +2 or more,115,45,19,26,68,16,46,32,7,7,6,2,4,2,0,0,0,2
S01013479,Occupancy rating +1,98,53,17,36,43,4,31,19,8,4,8,7,1,2,0,0,0,2
S01013479,Occupancy rating 0,176,101,50,51,68,7,38,15,21,2,23,20,3,7,1,0,0,6
S01013479,Occupancy rating -1 or less,39,13,2,11,21,2,9,4,5,0,10,6,4,5,1,0,1,3
S01013480,All households,302,99,68,31,182,35,117,47,49,21,30,18,12,21,5,0,1,15
S01013480,Occupancy rating +2 or more,106,46,32,14,59,21,33,20,7,6,5,4,1,1,0,0,0,1
S01013480,Occupancy rating +1,107,37,27,10,66,11,43,22,16,5,12,4,8,4,1,0,1,2
S01013480,Occupancy rating 0,59,13,7,6,40,2,28,3,18,7,10,8,2,6,1,0,0,5
S01013480,Occupancy rating -1 or less,30,3,2,1,17,1,13,2,8,3,3,2,1,10,3,0,0,7
S01013481,All households,189,47,22,25,129,25,87,35,25,27,17,9,8,13,6,0,0,7
S01013481,Occupancy rating +2 or more,108,23,10,13,79,21,54,30,10,14,4,3,1,6,3,0,0,3
S01013481,Occupancy rating +1,43,16,9,7,26,3,16,4,4,8,7,3,4,1,1,0,0,0
S01013481,Occupancy rating 0,24,8,3,5,15,1,9,1,5,3,5,3,2,1,0,0,0,1
S01013481,Occupancy rating -1 or less,14,0,0,0,9,0,8,0,6,2,1,0,1,5,2,0,0,3
