,,All HRPs aged 16 and over,Economically active: Total,Economically active: Employee: Total,Economically active: Employee: Part-time (1),Economically active: Employee: Full-time (1),Economically active: Self-employed (1),Economically active: Unemployed (1),Economically inactive: Total,Economically inactive: Retired,Economically inactive: Student,Economically inactive: Looking after home or family,Economically inactive: Long-term sick or disabled,Economically inactive: Other
S92000003,All HRPs aged 16 and over,2372747,1537351,1241360,205303,1036057,207782,88209,835396,610392,32089,43173,116442,33300
S92000003,Owned: Total,1470981,1024286,844072,98190,745882,164427,15787,446695,411648,5040,5591,16405,8011
S92000003,Owned: Owned outright,660641,283558,214500,48777,165723,62180,6878,377083,358449,2310,2638,8689,4997
S92000003,Owned: Owned with a mortgage or loan or shared ownership,810340,740728,629572,49413,580159,102247,8909,69612,53199,2730,2953,7716,3014
S92000003,Rented or living rent free: Total,901766,513065,397288,107113,290175,43355,72422,388701,198744,27049,37582,100037,25289
S92000003,Rented or living rent free: Social rented,576398,272146,204089,67752,136337,16368,51689,304252,165507,7291,26722,85417,19315
S92000003,Rented or living rent free: Private rented or living rent free,325368,240919,193199,39361,153838,26987,20733,84449,33237,19758,10860,14620,5974
S01006506,All HRPs aged 16 and over,424,316,258,28,230,54,4,108,89,2,6,8,3
S01006506,Owned: Total,297,229,185,16,169,43,1,68,64,0,3,0,1
S01006506,Owned: Owned outright,129,68,48,11,37,20,0,61,58,0,2,0,1
S01006506,Owned: Owned with a mortgage or loan or shared ownership,168,161,137,5,132,23,1,7,6,0,1,0,0
S01006506,Rented or living rent free: Total,127,87,73,12,61,11,3,40,25,2,3,8,2
S01006506,Rented or living rent free: Social rented,42,17,14,4,10,3,0,25,14,1,3,5,2
S01006506,Rented or living rent free: Private rented or living rent free,85,70,59,8,51,8,3,15,11,1,0,3,0
S01006507,All HRPs aged 16 and over,364,254,217,41,176,36,1,110,95,1,3,4,7
S01006507,Owned: Total,255,195,162,22,140,33,0,60,58,1,0,0,1
S01006507,Owned: Owned outright,134,78,63,13,50,15,0,56,54,1,0,0,1
S01006507,Owned: Owned with a mortgage or loan or shared ownership,121,117,99,9,90,18,0,4,4,0,0,0,0
S01006507,Rented or living rent free: Total,109,59,55,19,36,3,1,50,37,0,3,4,6
S01006507,Rented or living rent free: Social rented,90,46,42,19,23,3,1,44,32,0,3,4,5
S01006507,Rented or living rent free: Private rented or living rent free,19,13,13,0,13,0,0,6,5,0,0,0,1
S01006508,All HRPs aged 16 and over,340,280,243,16,227,32,5,60,48,1,2,4,5
S01006508,Owned: Total,280,236,206,14,192,28,2,44,37,0,1,2,4
S01006508,Owned: Owned outright,84,50,42,7,35,8,0,34,33,0,0,1,0
S01006508,Owned: Owned with a mortgage or loan or shared ownership,196,186,164,7,157,20,2,10,4,0,1,1,4
S01006508,Rented or living rent free: Total,60,44,37,2,35,4,3,16,11,1,1,2,1
S01006508,Rented or living rent free: Social rented,19,9,7,2,5,0,2,10,6,1,1,2,0
S01006508,Rented or living rent free: Private rented or living rent free,41,35,30,0,30,4,1,6,5,0,0,0,1
S01006509,All HRPs aged 16 and over,274,183,160,22,138,20,3,91,78,1,3,5,4
S01006509,Owned: Total,192,141,125,17,108,15,1,51,45,0,0,3,3
S01006509,Owned: Owned outright,63,24,22,8,14,2,0,39,34,0,0,2,3
S01006509,Owned: Owned with a mortgage or loan or shared ownership,129,117,103,9,94,13,1,12,11,0,0,1,0
S01006509,Rented or living rent free: Total,82,42,35,5,30,5,2,40,33,1,3,2,1
S01006509,Rented or living rent free: Social rented,62,26,21,5,16,3,2,36,31,0,3,2,0
S01006509,Rented or living rent free: Private rented or living rent free,20,16,14,0,14,2,0,4,2,1,0,0,1
S01006510,All HRPs aged 16 and over,256,159,135,15,120,22,2,97,84,0,2,9,2
S01006510,Owned: Total,170,112,92,7,85,20,0,58,58,0,0,0,0
S01006510,Owned: Owned outright,91,39,30,4,26,9,0,52,52,0,0,0,0
S01006510,Owned: Owned with a mortgage or loan or shared ownership,79,73,62,3,59,11,0,6,6,0,0,0,0
S01006510,Rented or living rent free: Total,86,47,43,8,35,2,2,39,26,0,2,9,2
S01006510,Rented or living rent free: Social rented,58,28,24,4,20,2,2,30,20,0,2,6,2
S01006510,Rented or living rent free: Private rented or living rent free,28,19,19,4,15,0,0,9,6,0,0,3,0
S01006511,All HRPs aged 16 and over,315,194,165,18,147,27,2,121,110,1,1,9,0
S01006511,Owned: Total,262,165,140,14,126,24,1,97,95,1,1,0,0
S01006511,Owned: Owned outright,152,64,54,11,43,10,0,88,88,0,0,0,0
S01006511,Owned: Owned with a mortgage or loan or shared ownership,110,101,86,3,83,14,1,9,7,1,1,0,0
S01006511,Rented or living rent free: Total,53,29,25,4,21,3,1,24,15,0,0,9,0
S01006511,Rented or living rent free: Social rented,35,13,9,3,6,3,1,22,13,0,0,9,0
S01006511,Rented or living rent free: Private rented or living rent free,18,16,16,1,15,0,0,2,2,0,0,0,0
S01006512,All HRPs aged 16 and over,170,147,107,8,99,39,1,23,22,0,1,0,0
S01006512,Owned: Total,143,124,91,8,83,32,1,19,19,0,0,0,0
S01006512,Owned: Owned outright,69,53,34,7,27,19,0,16,16,0,0,0,0
S01006512,Owned: Owned with a mortgage or loan or shared ownership,74,71,57,1,56,13,1,3,3,0,0,0,0
S01006512,Rented or living rent free: Total,27,23,16,0,16,7,0,4,3,0,1,0,0
S01006512,Rented or living rent free: Social rented,4,3,3,0,3,0,0,1,1,0,0,0,0
S01006512,Rented or living rent free: Private rented or living rent free,23,20,13,0,13,7,0,3,2,0,1,0,0
S01006513,All HRPs aged 16 and over,230,148,122,9,113,25,1,82,78,0,1,1,2
S01006513,Owned: Total,209,132,107,9,98,24,1,77,74,0,1,0,2
S01006513,Owned: Owned outright,120,45,36,6,30,9,0,75,72,0,1,0,2
S01006513,Owned: Owned with a mortgage or loan or shared ownership,89,87,71,3,68,15,1,2,2,0,0,0,0
S01006513,Rented or living rent free: Total,21,16,15,0,15,1,0,5,4,0,0,1,0
S01006513,Rented or living rent free: Social rented,2,1,1,0,1,0,0,1,1,0,0,0,0
S01006513,Rented or living rent free: Private rented or living rent free,19,15,14,0,14,1,0,4,3,0,0,1,0
S01006514,All HRPs aged 16 and over,339,251,198,18,180,51,2,88,84,0,2,1,1
S01006514,Owned: Total,286,201,154,16,138,46,1,85,82,0,2,0,1
S01006514,Owned: Owned outright,147,68,50,11,39,17,1,79,78,0,1,0,0
S01006514,Owned: Owned with a mortgage or loan or shared ownership,139,133,104,5,99,29,0,6,4,0,1,0,1
S01006514,Rented or living rent free: Total,53,50,44,2,42,5,1,3,2,0,0,1,0
S01006514,Rented or living rent free: Social rented,7,6,5,0,5,0,1,1,0,0,0,1,0
S01006514,Rented or living rent free: Private rented or living rent free,46,44,39,2,37,5,0,2,2,0,0,0,0
S01006515,All HRPs aged 16 and over,271,211,161,22,139,47,3,60,54,1,2,3,0
S01006515,Owned: Total,233,179,132,19,113,45,2,54,52,1,0,1,0
S01006515,Owned: Owned outright,129,81,56,12,44,25,0,48,47,0,0,1,0
S01006515,Owned: Owned with a mortgage or loan or shared ownership,104,98,76,7,69,20,2,6,5,1,0,0,0
S01006515,Rented or living rent free: Total,38,32,29,3,26,2,1,6,2,0,2,2,0
S01006515,Rented or living rent free: Social rented,7,4,3,1,2,0,1,3,1,0,0,2,0
S01006515,Rented or living rent free: Private rented or living rent free,31,28,26,2,24,2,0,3,1,0,2,0,0
S01006516,All HRPs aged 16 and over,185,129,81,8,73,48,0,56,53,2,0,0,1
S01006516,Owned: Total,153,104,72,7,65,32,0,49,48,0,0,0,1
S01006516,Owned: Owned outright,102,54,36,5,31,18,0,48,47,0,0,0,1
S01006516,Owned: Owned with a mortgage or loan or shared ownership,51,50,36,2,34,14,0,1,1,0,0,0,0
S01006516,Rented or living rent free: Total,32,25,9,1,8,16,0,7,5,2,0,0,0
S01006516,Rented or living rent free: Social rented,4,4,3,0,3,1,0,0,0,0,0,0,0
S01006516,Rented or living rent free: Private rented or living rent free,28,21,6,1,5,15,0,7,5,2,0,0,0
S01006517,All HRPs aged 16 and over,403,288,232,29,203,55,1,115,101,0,5,6,3
S01006517,Owned: Total,344,247,195,19,176,51,1,97,89,0,3,4,1
S01006517,Owned: Owned outright,204,110,83,14,69,27,0,94,86,0,3,4,1
S01006517,Owned: Owned with a mortgage or loan or shared ownership,140,137,112,5,107,24,1,3,3,0,0,0,0
S01006517,Rented or living rent free: Total,59,41,37,10,27,4,0,18,12,0,2,2,2
S01006517,Rented or living rent free: Social rented,27,15,14,8,6,1,0,12,8,0,0,2,2
S01006517,Rented or living rent free: Private rented or living rent free,32,26,23,2,21,3,0,6,4,0,2,0,0
S01006518,All HRPs aged 16 and over,247,171,127,18,109,41,3,76,71,3,1,0,1
S01006518,Owned: Total,226,152,112,16,96,38,2,74,71,1,1,0,1
S01006518,Owned: Owned outright,154,82,58,15,43,23,1,72,69,1,1,0,1
S01006518,Owned: Owned with a mortgage or loan or shared ownership,72,70,54,1,53,15,1,2,2,0,0,0,0
S01006518,Rented or living rent free: Total,21,19,15,2,13,3,1,2,0,2,0,0,0
S01006518,Rented or living rent free: Social rented,1,1,0,0,0,0,1,0,0,0,0,0,0
S01006518,Rented or living rent free: Private rented or living rent free,20,18,15,2,13,3,0,2,0,2,0,0,0
S01006519,All HRPs aged 16 and over,281,222,166,22,144,55,1,59,50,4,4,1,0
S01006519,Owned: Total,261,203,151,22,129,51,1,58,50,3,4,1,0
S01006519,Owned: Owned outright,151,97,67,16,51,30,0,54,48,3,3,0,0
S01006519,Owned: Owned with a mortgage or loan or shared ownership,110,106,84,6,78,21,1,4,2,0,1,1,0
S01006519,Rented or living rent free: Total,20,19,15,0,15,4,0,1,0,1,0,0,0
S01006519,Rented or living rent free: Social rented,2,2,2,0,2,0,0,0,0,0,0,0,0
S01006519,Rented or living rent free: Private rented or living rent free,18,17,13,0,13,4,0,1,0,1,0,0,0
S01006520,All HRPs aged 16 and over,222,197,161,9,152,32,4,25,25,0,0,0,0
S01006520,Owned: Total,174,150,117,9,108,30,3,24,24,0,0,0,0
S01006520,Owned: Owned outright,84,62,47,6,41,15,0,22,22,0,0,0,0
S01006520,Owned: Owned with a mortgage or loan or shared ownership,90,88,70,3,67,15,3,2,2,0,0,0,0
S01006520,Rented or living rent free: Total,48,47,44,0,44,2,1,1,1,0,0,0,0
S01006520,Rented or living rent free: Social rented,1,0,0,0,0,0,0,1,1,0,0,0,0
S01006520,Rented or living rent free: Private rented or living rent free,47,47,44,0,44,2,1,0,0,0,0,0,0
S01006521,All HRPs aged 16 and over,243,203,153,14,139,49,1,40,36,0,2,0,2
S01006521,Owned: Total,197,159,117,13,104,41,1,38,35,0,1,0,2
S01006521,Owned: Owned outright,99,62,40,7,33,21,1,37,34,0,1,0,2
S01006521,Owned: Owned with a mortgage or loan or shared ownership,98,97,77,6,71,20,0,1,1,0,0,0,0
S01006521,Rented or living rent free: Total,46,44,36,1,35,8,0,2,1,0,1,0,0
S01006521,Rented or living rent free: Social rented,3,2,1,0,1,1,0,1,0,0,1,0,0
S01006521,Rented or living rent free: Private rented or living rent free,43,42,35,1,34,7,0,1,1,0,0,0,0
S01006522,All HRPs aged 16 and over,218,161,129,8,121,31,1,57,56,0,0,0,1
S01006522,Owned: Total,200,143,111,8,103,31,1,57,56,0,0,0,1
S01006522,Owned: Owned outright,105,49,37,5,32,12,0,56,55,0,0,0,1
S01006522,Owned: Owned with a mortgage or loan or shared ownership,95,94,74,3,71,19,1,1,1,0,0,0,0
S01006522,Rented or living rent free: Total,18,18,18,0,18,0,0,0,0,0,0,0,0
S01006522,Rented or living rent free: Social rented,2,2,2,0,2,0,0,0,0,0,0,0,0
S01006522,Rented or living rent free: Private rented or living rent free,16,16,16,0,16,0,0,0,0,0,0,0,0
S01006523,All HRPs aged 16 and over,427,277,235,20,215,37,5,150,141,3,4,1,1
S01006523,Owned: Total,360,226,192,17,175,32,2,134,131,0,2,0,1
S01006523,Owned: Owned outright,215,87,73,15,58,13,1,128,127,0,0,0,1
S01006523,Owned: Owned with a mortgage or loan or shared ownership,145,139,119,2,117,19,1,6,4,0,2,0,0
S01006523,Rented or living rent free: Total,67,51,43,3,40,5,3,16,10,3,2,1,0
S01006523,Rented or living rent free: Social rented,9,4,4,1,3,0,0,5,4,0,0,1,0
S01006523,Rented or living rent free: Private rented or living rent free,58,47,39,2,37,5,3,11,6,3,2,0,0
S01006524,All HRPs aged 16 and over,314,197,148,21,127,44,5,117,108,0,1,7,1
S01006524,Owned: Total,247,149,110,17,93,37,2,98,96,0,1,0,1
S01006524,Owned: Owned outright,162,67,47,12,35,18,2,95,94,0,0,0,1
S01006524,Owned: Owned with a mortgage or loan or shared ownership,85,82,63,5,58,19,0,3,2,0,1,0,0
S01006524,Rented or living rent free: Total,67,48,38,4,34,7,3,19,12,0,0,7,0
S01006524,Rented or living rent free: Social rented,11,6,4,0,4,2,0,5,1,0,0,4,0
S01006524,Rented or living rent free: Private rented or living rent free,56,42,34,4,30,5,3,14,11,0,0,3,0
S01006525,All HRPs aged 16 and over,339,219,174,18,156,43,2,120,112,6,1,1,0
S01006525,Owned: Total,283,186,143,15,128,42,1,97,93,2,1,1,0
S01006525,Owned: Owned outright,168,75,52,8,44,22,1,93,91,1,1,0,0
S01006525,Owned: Owned with a mortgage or loan or shared ownership,115,111,91,7,84,20,0,4,2,1,0,1,0
S01006525,Rented or living rent free: Total,56,33,31,3,28,1,1,23,19,4,0,0,0
S01006525,Rented or living rent free: Social rented,24,7,6,2,4,1,0,17,16,1,0,0,0
S01006525,Rented or living rent free: Private rented or living rent free,32,26,25,1,24,0,1,6,3,3,0,0,0
S01006526,All HRPs aged 16 and over,439,271,239,55,184,19,13,168,126,13,7,16,6
S01006526,Owned: Total,179,139,122,11,111,15,2,40,36,1,1,0,2
S01006526,Owned: Owned outright,70,31,28,6,22,3,0,39,36,0,1,0,2
S01006526,Owned: Owned with a mortgage or loan or shared ownership,109,108,94,5,89,12,2,1,0,1,0,0,0
S01006526,Rented or living rent free: Total,260,132,117,44,73,4,11,128,90,12,6,16,4
S01006526,Rented or living rent free: Social rented,195,84,76,25,51,1,7,111,84,3,6,14,4
S01006526,Rented or living rent free: Private rented or living rent free,65,48,41,19,22,3,4,17,6,9,0,2,0
S01006527,All HRPs aged 16 and over,286,177,157,34,123,13,7,109,75,6,12,14,2
S01006527,Owned: Total,120,77,66,9,57,10,1,43,41,0,1,1,0
S01006527,Owned: Owned outright,62,29,23,5,18,6,0,33,31,0,1,1,0
S01006527,Owned: Owned with a mortgage or loan or shared ownership,58,48,43,4,39,4,1,10,10,0,0,0,0
S01006527,Rented or living rent free: Total,166,100,91,25,66,3,6,66,34,6,11,13,2
S01006527,Rented or living rent free: Social rented,122,69,63,21,42,1,5,53,27,3,10,11,2
S01006527,Rented or living rent free: Private rented or living rent free,44,31,28,4,24,2,1,13,7,3,1,2,0
S01006528,All HRPs aged 16 and over,433,269,248,64,184,14,7,164,122,17,6,14,5
S01006528,Owned: Total,225,141,129,19,110,12,0,84,79,0,1,2,2
S01006528,Owned: Owned outright,116,42,38,13,25,4,0,74,70,0,1,2,1
S01006528,Owned: Owned with a mortgage or loan or shared ownership,109,99,91,6,85,8,0,10,9,0,0,0,1
S01006528,Rented or living rent free: Total,208,128,119,45,74,2,7,80,43,17,5,12,3
S01006528,Rented or living rent free: Social rented,120,57,53,20,33,1,3,63,42,1,5,12,3
S01006528,Rented or living rent free: Private rented or living rent free,88,71,66,25,41,1,4,17,1,16,0,0,0
S01006529,All HRPs aged 16 and over,496,321,281,46,235,26,14,175,121,32,9,7,6
S01006529,Owned: Total,210,146,129,14,115,15,2,64,55,3,4,0,2
S01006529,Owned: Owned outright,85,37,30,9,21,6,1,48,43,0,3,0,2
S01006529,Owned: Owned with a mortgage or loan or shared ownership,125,109,99,5,94,9,1,16,12,3,1,0,0
S01006529,Rented or living rent free: Total,286,175,152,32,120,11,12,111,66,29,5,7,4
S01006529,Rented or living rent free: Social rented,112,36,29,11,18,5,2,76,60,1,5,7,3
S01006529,Rented or living rent free: Private rented or living rent free,174,139,123,21,102,6,10,35,6,28,0,0,1
S01006530,All HRPs aged 16 and over,356,227,199,42,157,20,8,129,79,8,5,25,12
S01006530,Owned: Total,162,115,97,15,82,15,3,47,42,1,0,1,3
S01006530,Owned: Owned outright,77,37,30,10,20,7,0,40,37,1,0,1,1
S01006530,Owned: Owned with a mortgage or loan or shared ownership,85,78,67,5,62,8,3,7,5,0,0,0,2
S01006530,Rented or living rent free: Total,194,112,102,27,75,5,5,82,37,7,5,24,9
S01006530,Rented or living rent free: Social rented,134,64,57,14,43,3,4,70,33,1,4,23,9
S01006530,Rented or living rent free: Private rented or living rent free,60,48,45,13,32,2,1,12,4,6,1,1,0
S01006531,All HRPs aged 16 and over,429,251,222,50,172,16,13,178,126,12,12,22,6
S01006531,Owned: Total,155,101,91,15,76,9,1,54,51,1,1,0,1
S01006531,Owned: Owned outright,72,28,26,5,21,2,0,44,41,1,1,0,1
S01006531,Owned: Owned with a mortgage or loan or shared ownership,83,73,65,10,55,7,1,10,10,0,0,0,0
S01006531,Rented or living rent free: Total,274,150,131,35,96,7,12,124,75,11,11,22,5
S01006531,Rented or living rent free: Social rented,202,94,82,23,59,3,9,108,71,0,10,22,5
S01006531,Rented or living rent free: Private rented or living rent free,72,56,49,12,37,4,3,16,4,11,1,0,0
S01006532,All HRPs aged 16 and over,337,211,173,23,150,35,3,126,111,8,0,6,1
S01006532,Owned: Total,251,169,138,17,121,29,2,82,78,3,0,1,0
S01006532,Owned: Owned outright,138,61,48,9,39,12,1,77,74,3,0,0,0
S01006532,Owned: Owned with a mortgage or loan or shared ownership,113,108,90,8,82,17,1,5,4,0,0,1,0
S01006532,Rented or living rent free: Total,86,42,35,6,29,6,1,44,33,5,0,5,1
S01006532,Rented or living rent free: Social rented,10,3,2,1,1,1,0,7,5,1,0,0,1
S01006532,Rented or living rent free: Private rented or living rent free,76,39,33,5,28,5,1,37,28,4,0,5,0
S01006533,All HRPs aged 16 and over,305,228,186,14,172,40,2,77,75,2,0,0,0
S01006533,Owned: Total,277,206,167,11,156,37,2,71,71,0,0,0,0
S01006533,Owned: Owned outright,138,71,52,6,46,17,2,67,67,0,0,0,0
S01006533,Owned: Owned with a mortgage or loan or shared ownership,139,135,115,5,110,20,0,4,4,0,0,0,0
S01006533,Rented or living rent free: Total,28,22,19,3,16,3,0,6,4,2,0,0,0
S01006533,Rented or living rent free: Social rented,2,0,0,0,0,0,0,2,2,0,0,0,0
S01006533,Rented or living rent free: Private rented or living rent free,26,22,19,3,16,3,0,4,2,2,0,0,0
S01006534,All HRPs aged 16 and over,398,300,249,16,233,46,5,98,90,4,3,1,0
S01006534,Owned: Total,327,241,198,11,187,42,1,86,83,0,3,0,0
S01006534,Owned: Owned outright,163,82,67,9,58,14,1,81,79,0,2,0,0
S01006534,Owned: Owned with a mortgage or loan or shared ownership,164,159,131,2,129,28,0,5,4,0,1,0,0
S01006534,Rented or living rent free: Total,71,59,51,5,46,4,4,12,7,4,0,1,0
S01006534,Rented or living rent free: Social rented,6,4,3,0,3,0,1,2,1,0,0,1,0
S01006534,Rented or living rent free: Private rented or living rent free,65,55,48,5,43,4,3,10,6,4,0,0,0
S01006535,All HRPs aged 16 and over,564,460,393,31,362,47,20,104,71,22,5,2,4
S01006535,Owned: Total,375,299,260,14,246,34,5,76,67,3,2,0,4
S01006535,Owned: Owned outright,130,65,52,7,45,12,1,65,61,2,1,0,1
S01006535,Owned: Owned with a mortgage or loan or shared ownership,245,234,208,7,201,22,4,11,6,1,1,0,3
S01006535,Rented or living rent free: Total,189,161,133,17,116,13,15,28,4,19,3,2,0
S01006535,Rented or living rent free: Social rented,15,13,6,1,5,2,5,2,0,0,0,2,0
S01006535,Rented or living rent free: Private rented or living rent free,174,148,127,16,111,11,10,26,4,19,3,0,0
S01006536,All HRPs aged 16 and over,589,505,454,40,414,41,10,84,63,11,0,6,4
S01006536,Owned: Total,350,289,256,16,240,32,1,61,56,1,0,1,3
S01006536,Owned: Owned outright,126,71,57,8,49,13,1,55,53,0,0,0,2
S01006536,Owned: Owned with a mortgage or loan or shared ownership,224,218,199,8,191,19,0,6,3,1,0,1,1
S01006536,Rented or living rent free: Total,239,216,198,24,174,9,9,23,7,10,0,5,1
S01006536,Rented or living rent free: Social rented,25,17,14,2,12,2,1,8,1,2,0,5,0
S01006536,Rented or living rent free: Private rented or living rent free,214,199,184,22,162,7,8,15,6,8,0,0,1
S01006537,All HRPs aged 16 and over,341,202,168,27,141,34,0,139,133,0,2,3,1
S01006537,Owned: Total,313,183,150,25,125,33,0,130,127,0,2,1,0
S01006537,Owned: Owned outright,199,78,61,20,41,17,0,121,119,0,1,1,0
S01006537,Owned: Owned with a mortgage or loan or shared ownership,114,105,89,5,84,16,0,9,8,0,1,0,0
S01006537,Rented or living rent free: Total,28,19,18,2,16,1,0,9,6,0,0,2,1
S01006537,Rented or living rent free: Social rented,7,4,4,1,3,0,0,3,0,0,0,2,1
S01006537,Rented or living rent free: Private rented or living rent free,21,15,14,1,13,1,0,6,6,0,0,0,0
S01006538,All HRPs aged 16 and over,240,156,123,8,115,31,2,84,82,1,0,1,0
S01006538,Owned: Total,230,146,116,8,108,29,1,84,82,1,0,1,0
S01006538,Owned: Owned outright,132,54,40,7,33,13,1,78,78,0,0,0,0
S01006538,Owned: Owned with a mortgage or loan or shared ownership,98,92,76,1,75,16,0,6,4,1,0,1,0
S01006538,Rented or living rent free: Total,10,10,7,0,7,2,1,0,0,0,0,0,0
S01006538,Rented or living rent free: Social rented,3,3,2,0,2,1,0,0,0,0,0,0,0
S01006538,Rented or living rent free: Private rented or living rent free,7,7,5,0,5,1,1,0,0,0,0,0,0
S01006539,All HRPs aged 16 and over,330,219,189,29,160,28,2,111,108,0,1,2,0
S01006539,Owned: Total,294,187,162,23,139,25,0,107,107,0,0,0,0
S01006539,Owned: Owned outright,172,67,58,17,41,9,0,105,105,0,0,0,0
S01006539,Owned: Owned with a mortgage or loan or shared ownership,122,120,104,6,98,16,0,2,2,0,0,0,0
S01006539,Rented or living rent free: Total,36,32,27,6,21,3,2,4,1,0,1,2,0
S01006539,Rented or living rent free: Social rented,7,4,3,1,2,0,1,3,1,0,1,1,0
S01006539,Rented or living rent free: Private rented or living rent free,29,28,24,5,19,3,1,1,0,0,0,1,0
S01006540,All HRPs aged 16 and over,451,327,286,21,265,36,5,124,114,2,3,3,2
S01006540,Owned: Total,358,245,210,16,194,35,0,113,108,1,2,2,0
S01006540,Owned: Owned outright,177,75,65,11,54,10,0,102,101,0,1,0,0
S01006540,Owned: Owned with a mortgage or loan or shared ownership,181,170,145,5,140,25,0,11,7,1,1,2,0
S01006540,Rented or living rent free: Total,93,82,76,5,71,1,5,11,6,1,1,1,2
S01006540,Rented or living rent free: Social rented,7,4,4,1,3,0,0,3,2,0,0,0,1
S01006540,Rented or living rent free: Private rented or living rent free,86,78,72,4,68,1,5,8,4,1,1,1,1
S01006541,All HRPs aged 16 and over,392,197,172,12,160,23,2,195,189,1,2,1,2
S01006541,Owned: Total,300,180,156,12,144,23,1,120,117,0,2,0,1
S01006541,Owned: Owned outright,163,48,39,9,30,8,1,115,112,0,2,0,1
S01006541,Owned: Owned with a mortgage or loan or shared ownership,137,132,117,3,114,15,0,5,5,0,0,0,0
S01006541,Rented or living rent free: Total,92,17,16,0,16,0,1,75,72,1,0,1,1
S01006541,Rented or living rent free: Social rented,72,1,0,0,0,0,1,71,69,0,0,1,1
S01006541,Rented or living rent free: Private rented or living rent free,20,16,16,0,16,0,0,4,3,1,0,0,0
S01006542,All HRPs aged 16 and over,496,297,259,28,231,38,0,199,189,3,1,4,2
S01006542,Owned: Total,417,232,197,27,170,35,0,185,183,0,0,1,1
S01006542,Owned: Owned outright,274,93,75,18,57,18,0,181,180,0,0,0,1
S01006542,Owned: Owned with a mortgage or loan or shared ownership,143,139,122,9,113,17,0,4,3,0,0,1,0
S01006542,Rented or living rent free: Total,79,65,62,1,61,3,0,14,6,3,1,3,1
S01006542,Rented or living rent free: Social rented,7,4,4,0,4,0,0,3,1,0,0,2,0
S01006542,Rented or living rent free: Private rented or living rent free,72,61,58,1,57,3,0,11,5,3,1,1,1
S01006543,All HRPs aged 16 and over,363,202,169,16,153,32,1,161,153,1,2,3,2
S01006543,Owned: Total,345,190,157,15,142,32,1,155,150,0,1,2,2
S01006543,Owned: Owned outright,211,62,46,11,35,16,0,149,145,0,1,1,2
S01006543,Owned: Owned with a mortgage or loan or shared ownership,134,128,111,4,107,16,1,6,5,0,0,1,0
S01006543,Rented or living rent free: Total,18,12,12,1,11,0,0,6,3,1,1,1,0
S01006543,Rented or living rent free: Social rented,4,2,2,0,2,0,0,2,0,0,1,1,0
S01006543,Rented or living rent free: Private rented or living rent free,14,10,10,1,9,0,0,4,3,1,0,0,0
S01006544,All HRPs aged 16 and over,507,414,334,24,310,75,5,93,81,6,4,2,0
S01006544,Owned: Total,348,267,205,21,184,58,4,81,79,0,2,0,0
S01006544,Owned: Owned outright,161,88,66,16,50,21,1,73,72,0,1,0,0
S01006544,Owned: Owned with a mortgage or loan or shared ownership,187,179,139,5,134,37,3,8,7,0,1,0,0
S01006544,Rented or living rent free: Total,159,147,129,3,126,17,1,12,2,6,2,2,0
S01006544,Rented or living rent free: Social rented,10,6,6,1,5,0,0,4,0,3,0,1,0
S01006544,Rented or living rent free: Private rented or living rent free,149,141,123,2,121,17,1,8,2,3,2,1,0
S01006545,All HRPs aged 16 and over,586,366,300,25,275,57,9,220,193,7,0,11,9
S01006545,Owned: Total,454,273,222,20,202,48,3,181,169,1,0,4,7
S01006545,Owned: Owned outright,271,93,69,15,54,24,0,178,166,1,0,4,7
S01006545,Owned: Owned with a mortgage or loan or shared ownership,183,180,153,5,148,24,3,3,3,0,0,0,0
S01006545,Rented or living rent free: Total,132,93,78,5,73,9,6,39,24,6,0,7,2
S01006545,Rented or living rent free: Social rented,39,13,11,1,10,2,0,26,17,0,0,7,2
S01006545,Rented or living rent free: Private rented or living rent free,93,80,67,4,63,7,6,13,7,6,0,0,0
S01006546,All HRPs aged 16 and over,262,173,142,9,133,29,2,89,86,0,0,1,2
S01006546,Owned: Total,245,157,128,9,119,27,2,88,85,0,0,1,2
S01006546,Owned: Owned outright,149,63,47,6,41,14,2,86,83,0,0,1,2
S01006546,Owned: Owned with a mortgage or loan or shared ownership,96,94,81,3,78,13,0,2,2,0,0,0,0
S01006546,Rented or living rent free: Total,17,16,14,0,14,2,0,1,1,0,0,0,0
S01006546,Rented or living rent free: Social rented,0,0,0,0,0,0,0,0,0,0,0,0,0
S01006546,Rented or living rent free: Private rented or living rent free,17,16,14,0,14,2,0,1,1,0,0,0,0
S01006547,All HRPs aged 16 and over,442,267,226,41,185,32,9,175,152,1,1,15,6
S01006547,Owned: Total,275,186,156,25,131,28,2,89,83,0,0,4,2
S01006547,Owned: Owned outright,156,74,58,19,39,15,1,82,79,0,0,3,0
S01006547,Owned: Owned with a mortgage or loan or shared ownership,119,112,98,6,92,13,1,7,4,0,0,1,2
S01006547,Rented or living rent free: Total,167,81,70,16,54,4,7,86,69,1,1,11,4
S01006547,Rented or living rent free: Social rented,131,52,45,13,32,1,6,79,64,1,1,10,3
S01006547,Rented or living rent free: Private rented or living rent free,36,29,25,3,22,3,1,7,5,0,0,1,1
S01006548,All HRPs aged 16 and over,312,176,142,21,121,33,1,136,133,0,1,2,0
S01006548,Owned: Total,295,164,131,21,110,32,1,131,130,0,0,1,0
S01006548,Owned: Owned outright,193,63,50,16,34,12,1,130,129,0,0,1,0
S01006548,Owned: Owned with a mortgage or loan or shared ownership,102,101,81,5,76,20,0,1,1,0,0,0,0
S01006548,Rented or living rent free: Total,17,12,11,0,11,1,0,5,3,0,1,1,0
S01006548,Rented or living rent free: Social rented,2,1,1,0,1,0,0,1,0,0,0,1,0
S01006548,Rented or living rent free: Private rented or living rent free,15,11,10,0,10,1,0,4,3,0,1,0,0
S01006549,All HRPs aged 16 and over,366,239,192,26,166,45,2,127,122,1,1,2,1
S01006549,Owned: Total,306,187,145,19,126,42,0,119,118,0,1,0,0
S01006549,Owned: Owned outright,198,85,71,16,55,14,0,113,113,0,0,0,0
S01006549,Owned: Owned with a mortgage or loan or shared ownership,108,102,74,3,71,28,0,6,5,0,1,0,0
S01006549,Rented or living rent free: Total,60,52,47,7,40,3,2,8,4,1,0,2,1
S01006549,Rented or living rent free: Social rented,8,6,5,3,2,0,1,2,1,0,0,1,0
S01006549,Rented or living rent free: Private rented or living rent free,52,46,42,4,38,3,1,6,3,1,0,1,1
S01006550,All HRPs aged 16 and over,389,233,196,22,174,34,3,156,151,0,2,1,2
S01006550,Owned: Total,358,205,169,18,151,33,3,153,149,0,2,0,2
S01006550,Owned: Owned outright,235,87,62,13,49,23,2,148,145,0,1,0,2
S01006550,Owned: Owned with a mortgage or loan or shared ownership,123,118,107,5,102,10,1,5,4,0,1,0,0
S01006550,Rented or living rent free: Total,31,28,27,4,23,1,0,3,2,0,0,1,0
S01006550,Rented or living rent free: Social rented,1,1,1,0,1,0,0,0,0,0,0,0,0
S01006550,Rented or living rent free: Private rented or living rent free,30,27,26,4,22,1,0,3,2,0,0,1,0
S01006551,All HRPs aged 16 and over,392,221,179,32,147,32,10,171,135,1,4,29,2
S01006551,Owned: Total,167,106,81,12,69,23,2,61,54,0,2,4,1
S01006551,Owned: Owned outright,94,39,29,8,21,8,2,55,50,0,1,3,1
S01006551,Owned: Owned with a mortgage or loan or shared ownership,73,67,52,4,48,15,0,6,4,0,1,1,0
S01006551,Rented or living rent free: Total,225,115,98,20,78,9,8,110,81,1,2,25,1
S01006551,Rented or living rent free: Social rented,192,91,76,20,56,7,8,101,73,1,1,25,1
S01006551,Rented or living rent free: Private rented or living rent free,33,24,22,0,22,2,0,9,8,0,1,0,0
S01006552,All HRPs aged 16 and over,417,321,264,31,233,53,4,96,89,0,1,0,6
S01006552,Owned: Total,353,263,215,22,193,44,4,90,86,0,0,0,4
S01006552,Owned: Owned outright,177,89,68,13,55,18,3,88,85,0,0,0,3
S01006552,Owned: Owned with a mortgage or loan or shared ownership,176,174,147,9,138,26,1,2,1,0,0,0,1
S01006552,Rented or living rent free: Total,64,58,49,9,40,9,0,6,3,0,1,0,2
S01006552,Rented or living rent free: Social rented,9,6,5,2,3,1,0,3,1,0,1,0,1
S01006552,Rented or living rent free: Private rented or living rent free,55,52,44,7,37,8,0,3,2,0,0,0,1
S01006553,All HRPs aged 16 and over,407,196,157,18,139,36,3,211,201,2,2,6,0
S01006553,Owned: Total,267,165,130,13,117,34,1,102,101,0,0,1,0
S01006553,Owned: Owned outright,159,64,48,10,38,15,1,95,94,0,0,1,0
S01006553,Owned: Owned with a mortgage or loan or shared ownership,108,101,82,3,79,19,0,7,7,0,0,0,0
S01006553,Rented or living rent free: Total,140,31,27,5,22,2,2,109,100,2,2,5,0
S01006553,Rented or living rent free: Social rented,116,16,14,3,11,2,0,100,93,2,0,5,0
S01006553,Rented or living rent free: Private rented or living rent free,24,15,13,2,11,0,2,9,7,0,2,0,0
S01006554,All HRPs aged 16 and over,330,227,195,22,173,22,10,103,88,0,4,10,1
S01006554,Owned: Total,230,159,137,13,124,19,3,71,70,0,0,1,0
S01006554,Owned: Owned outright,108,41,31,8,23,7,3,67,66,0,0,1,0
S01006554,Owned: Owned with a mortgage or loan or shared ownership,122,118,106,5,101,12,0,4,4,0,0,0,0
S01006554,Rented or living rent free: Total,100,68,58,9,49,3,7,32,18,0,4,9,1
S01006554,Rented or living rent free: Social rented,70,43,38,7,31,0,5,27,15,0,3,8,1
S01006554,Rented or living rent free: Private rented or living rent free,30,25,20,2,18,3,2,5,3,0,1,1,0
S01006555,All HRPs aged 16 and over,374,274,249,44,205,16,9,100,49,3,10,32,6
S01006555,Owned: Total,180,146,134,14,120,12,0,34,28,1,1,4,0
S01006555,Owned: Owned outright,56,28,25,6,19,3,0,28,25,1,1,1,0
S01006555,Owned: Owned with a mortgage or loan or shared ownership,124,118,109,8,101,9,0,6,3,0,0,3,0
S01006555,Rented or living rent free: Total,194,128,115,30,85,4,9,66,21,2,9,28,6
S01006555,Rented or living rent free: Social rented,143,80,72,22,50,0,8,63,20,2,9,27,5
S01006555,Rented or living rent free: Private rented or living rent free,51,48,43,8,35,4,1,3,1,0,0,1,1
S01006556,All HRPs aged 16 and over,399,220,189,24,165,23,8,179,132,3,10,32,2
S01006556,Owned: Total,186,129,110,11,99,18,1,57,53,0,0,4,0
S01006556,Owned: Owned outright,80,36,31,7,24,4,1,44,42,0,0,2,0
S01006556,Owned: Owned with a mortgage or loan or shared ownership,106,93,79,4,75,14,0,13,11,0,0,2,0
S01006556,Rented or living rent free: Total,213,91,79,13,66,5,7,122,79,3,10,28,2
S01006556,Rented or living rent free: Social rented,183,68,57,12,45,5,6,115,73,2,10,28,2
S01006556,Rented or living rent free: Private rented or living rent free,30,23,22,1,21,0,1,7,6,1,0,0,0
S01006557,All HRPs aged 16 and over,338,219,192,33,159,19,8,119,81,0,6,24,8
S01006557,Owned: Total,136,109,100,12,88,8,1,27,22,0,0,2,3
S01006557,Owned: Owned outright,48,24,21,4,17,3,0,24,19,0,0,2,3
S01006557,Owned: Owned with a mortgage or loan or shared ownership,88,85,79,8,71,5,1,3,3,0,0,0,0
S01006557,Rented or living rent free: Total,202,110,92,21,71,11,7,92,59,0,6,22,5
S01006557,Rented or living rent free: Social rented,180,90,76,20,56,8,6,90,57,0,6,22,5
S01006557,Rented or living rent free: Private rented or living rent free,22,20,16,1,15,3,1,2,2,0,0,0,0
S01006558,All HRPs aged 16 and over,354,269,240,17,223,28,1,85,75,7,0,1,2
S01006558,Owned: Total,247,173,148,9,139,25,0,74,68,3,0,1,2
S01006558,Owned: Owned outright,123,51,40,2,38,11,0,72,67,2,0,1,2
S01006558,Owned: Owned with a mortgage or loan or shared ownership,124,122,108,7,101,14,0,2,1,1,0,0,0
S01006558,Rented or living rent free: Total,107,96,92,8,84,3,1,11,7,4,0,0,0
S01006558,Rented or living rent free: Social rented,2,2,2,0,2,0,0,0,0,0,0,0,0
S01006558,Rented or living rent free: Private rented or living rent free,105,94,90,8,82,3,1,11,7,4,0,0,0
S01006559,All HRPs aged 16 and over,272,201,167,12,155,32,2,71,53,13,1,3,1
S01006559,Owned: Total,194,152,121,8,113,30,1,42,38,3,0,1,0
S01006559,Owned: Owned outright,97,57,41,6,35,16,0,40,37,2,0,1,0
S01006559,Owned: Owned with a mortgage or loan or shared ownership,97,95,80,2,78,14,1,2,1,1,0,0,0
S01006559,Rented or living rent free: Total,78,49,46,4,42,2,1,29,15,10,1,2,1
S01006559,Rented or living rent free: Social rented,16,2,1,1,0,0,1,14,12,0,0,2,0
S01006559,Rented or living rent free: Private rented or living rent free,62,47,45,3,42,2,0,15,3,10,1,0,1
S01006560,All HRPs aged 16 and over,432,295,243,17,226,49,3,137,125,1,3,2,6
S01006560,Owned: Total,329,244,201,15,186,41,2,85,81,0,0,1,3
S01006560,Owned: Owned outright,163,88,71,11,60,17,0,75,72,0,0,1,2
S01006560,Owned: Owned with a mortgage or loan or shared ownership,166,156,130,4,126,24,2,10,9,0,0,0,1
S01006560,Rented or living rent free: Total,103,51,42,2,40,8,1,52,44,1,3,1,3
S01006560,Rented or living rent free: Social rented,40,2,1,0,1,1,0,38,37,0,0,1,0
S01006560,Rented or living rent free: Private rented or living rent free,63,49,41,2,39,7,1,14,7,1,3,0,3
S01006561,All HRPs aged 16 and over,323,232,188,21,167,41,3,91,83,3,2,3,0
S01006561,Owned: Total,283,198,161,18,143,36,1,85,81,0,2,2,0
S01006561,Owned: Owned outright,157,77,59,12,47,17,1,80,77,0,1,2,0
S01006561,Owned: Owned with a mortgage or loan or shared ownership,126,121,102,6,96,19,0,5,4,0,1,0,0
S01006561,Rented or living rent free: Total,40,34,27,3,24,5,2,6,2,3,0,1,0
S01006561,Rented or living rent free: Social rented,5,4,3,0,3,0,1,1,0,0,0,1,0
S01006561,Rented or living rent free: Private rented or living rent free,35,30,24,3,21,5,1,5,2,3,0,0,0
S01006562,All HRPs aged 16 and over,334,208,169,26,143,33,6,126,97,2,1,22,4
S01006562,Owned: Total,228,153,121,17,104,31,1,75,69,0,0,4,2
S01006562,Owned: Owned outright,130,60,48,14,34,12,0,70,67,0,0,2,1
S01006562,Owned: Owned with a mortgage or loan or shared ownership,98,93,73,3,70,19,1,5,2,0,0,2,1
S01006562,Rented or living rent free: Total,106,55,48,9,39,2,5,51,28,2,1,18,2
S01006562,Rented or living rent free: Social rented,77,31,26,8,18,0,5,46,25,1,0,18,2
S01006562,Rented or living rent free: Private rented or living rent free,29,24,22,1,21,2,0,5,3,1,1,0,0
S01006563,All HRPs aged 16 and over,366,248,216,29,187,27,5,118,103,6,0,7,2
S01006563,Owned: Total,267,176,149,18,131,25,2,91,87,1,0,1,2
S01006563,Owned: Owned outright,146,62,52,9,43,8,2,84,82,0,0,1,1
S01006563,Owned: Owned with a mortgage or loan or shared ownership,121,114,97,9,88,17,0,7,5,1,0,0,1
S01006563,Rented or living rent free: Total,99,72,67,11,56,2,3,27,16,5,0,6,0
S01006563,Rented or living rent free: Social rented,25,9,8,4,4,0,1,16,11,0,0,5,0
S01006563,Rented or living rent free: Private rented or living rent free,74,63,59,7,52,2,2,11,5,5,0,1,0
S01006564,All HRPs aged 16 and over,578,429,382,72,310,30,17,149,85,17,5,31,11
S01006564,Owned: Total,251,184,164,10,154,17,3,67,57,4,0,3,3
S01006564,Owned: Owned outright,93,39,29,2,27,8,2,54,50,0,0,2,2
S01006564,Owned: Owned with a mortgage or loan or shared ownership,158,145,135,8,127,9,1,13,7,4,0,1,1
S01006564,Rented or living rent free: Total,327,245,218,62,156,13,14,82,28,13,5,28,8
S01006564,Rented or living rent free: Social rented,165,103,86,29,57,7,10,62,20,3,5,26,8
S01006564,Rented or living rent free: Private rented or living rent free,162,142,132,33,99,6,4,20,8,10,0,2,0
S01006565,All HRPs aged 16 and over,565,442,398,50,348,30,14,123,45,40,6,28,4
S01006565,Owned: Total,239,212,188,16,172,21,3,27,19,3,1,2,2
S01006565,Owned: Owned outright,69,47,41,8,33,4,2,22,16,3,1,0,2
S01006565,Owned: Owned with a mortgage or loan or shared ownership,170,165,147,8,139,17,1,5,3,0,0,2,0
S01006565,Rented or living rent free: Total,326,230,210,34,176,9,11,96,26,37,5,26,2
S01006565,Rented or living rent free: Social rented,115,64,50,13,37,5,9,51,23,0,4,23,1
S01006565,Rented or living rent free: Private rented or living rent free,211,166,160,21,139,4,2,45,3,37,1,3,1
S01006566,All HRPs aged 16 and over,437,352,321,40,281,22,9,85,36,23,5,11,10
S01006566,Owned: Total,253,210,190,17,173,18,2,43,34,1,3,3,2
S01006566,Owned: Owned outright,110,71,63,9,54,8,0,39,33,0,3,2,1
S01006566,Owned: Owned with a mortgage or loan or shared ownership,143,139,127,8,119,10,2,4,1,1,0,1,1
S01006566,Rented or living rent free: Total,184,142,131,23,108,4,7,42,2,22,2,8,8
S01006566,Rented or living rent free: Social rented,18,8,4,1,3,1,3,10,1,0,1,5,3
S01006566,Rented or living rent free: Private rented or living rent free,166,134,127,22,105,3,4,32,1,22,1,3,5
S01006567,All HRPs aged 16 and over,552,397,355,68,287,17,25,155,82,44,4,22,3
S01006567,Owned: Total,195,162,149,11,138,8,5,33,27,4,0,1,1
S01006567,Owned: Owned outright,53,27,25,1,24,2,0,26,24,0,0,1,1
S01006567,Owned: Owned with a mortgage or loan or shared ownership,142,135,124,10,114,6,5,7,3,4,0,0,0
S01006567,Rented or living rent free: Total,357,235,206,57,149,9,20,122,55,40,4,21,2
S01006567,Rented or living rent free: Social rented,161,79,57,18,39,5,17,82,55,3,3,19,2
S01006567,Rented or living rent free: Private rented or living rent free,196,156,149,39,110,4,3,40,0,37,1,2,0
S01006568,All HRPs aged 16 and over,575,517,468,48,420,32,17,58,22,24,1,6,5
S01006568,Owned: Total,278,249,225,14,211,19,5,29,20,4,1,2,2
S01006568,Owned: Owned outright,81,59,50,7,43,9,0,22,18,2,1,0,1
S01006568,Owned: Owned with a mortgage or loan or shared ownership,197,190,175,7,168,10,5,7,2,2,0,2,1
S01006568,Rented or living rent free: Total,297,268,243,34,209,13,12,29,2,20,0,4,3
S01006568,Rented or living rent free: Social rented,17,10,5,0,5,0,5,7,2,0,0,4,1
S01006568,Rented or living rent free: Private rented or living rent free,280,258,238,34,204,13,7,22,0,20,0,0,2
S01006569,All HRPs aged 16 and over,311,242,213,18,195,22,7,69,48,14,2,3,2
S01006569,Owned: Total,162,129,110,6,104,19,0,33,31,0,2,0,0
S01006569,Owned: Owned outright,73,42,35,3,32,7,0,31,30,0,1,0,0
S01006569,Owned: Owned with a mortgage or loan or shared ownership,89,87,75,3,72,12,0,2,1,0,1,0,0
S01006569,Rented or living rent free: Total,149,113,103,12,91,3,7,36,17,14,0,3,2
S01006569,Rented or living rent free: Social rented,36,16,11,2,9,0,5,20,16,0,0,3,1
S01006569,Rented or living rent free: Private rented or living rent free,113,97,92,10,82,3,2,16,1,14,0,0,1
S01006570,All HRPs aged 16 and over,371,288,241,21,220,42,5,83,67,10,1,5,0
S01006570,Owned: Total,247,182,146,9,137,35,1,65,63,2,0,0,0
S01006570,Owned: Owned outright,115,55,47,8,39,7,1,60,59,1,0,0,0
S01006570,Owned: Owned with a mortgage or loan or shared ownership,132,127,99,1,98,28,0,5,4,1,0,0,0
S01006570,Rented or living rent free: Total,124,106,95,12,83,7,4,18,4,8,1,5,0
S01006570,Rented or living rent free: Social rented,8,3,1,0,1,1,1,5,0,0,0,5,0
S01006570,Rented or living rent free: Private rented or living rent free,116,103,94,12,82,6,3,13,4,8,1,0,0
S01006571,All HRPs aged 16 and over,427,351,290,32,258,50,11,76,62,7,2,3,2
S01006571,Owned: Total,289,231,183,13,170,43,5,58,55,1,0,1,1
S01006571,Owned: Owned outright,126,73,53,5,48,16,4,53,52,0,0,0,1
S01006571,Owned: Owned with a mortgage or loan or shared ownership,163,158,130,8,122,27,1,5,3,1,0,1,0
S01006571,Rented or living rent free: Total,138,120,107,19,88,7,6,18,7,6,2,2,1
S01006571,Rented or living rent free: Social rented,18,9,9,1,8,0,0,9,5,0,1,2,1
S01006571,Rented or living rent free: Private rented or living rent free,120,111,98,18,80,7,6,9,2,6,1,0,0
S01006572,All HRPs aged 16 and over,374,279,220,22,198,58,1,95,87,1,1,2,4
S01006572,Owned: Total,318,224,171,19,152,52,1,94,86,1,1,2,4
S01006572,Owned: Owned outright,180,91,72,6,66,18,1,89,83,0,1,2,3
S01006572,Owned: Owned with a mortgage or loan or shared ownership,138,133,99,13,86,34,0,5,3,1,0,0,1
S01006572,Rented or living rent free: Total,56,55,49,3,46,6,0,1,1,0,0,0,0
S01006572,Rented or living rent free: Social rented,4,4,3,1,2,1,0,0,0,0,0,0,0
S01006572,Rented or living rent free: Private rented or living rent free,52,51,46,2,44,5,0,1,1,0,0,0,0
S01006573,All HRPs aged 16 and over,290,235,187,11,176,43,5,55,48,1,0,4,2
S01006573,Owned: Total,230,179,137,9,128,39,3,51,46,0,0,3,2
S01006573,Owned: Owned outright,115,67,50,8,42,15,2,48,44,0,0,3,1
S01006573,Owned: Owned with a mortgage or loan or shared ownership,115,112,87,1,86,24,1,3,2,0,0,0,1
S01006573,Rented or living rent free: Total,60,56,50,2,48,4,2,4,2,1,0,1,0
S01006573,Rented or living rent free: Social rented,4,1,1,0,1,0,0,3,2,0,0,1,0
S01006573,Rented or living rent free: Private rented or living rent free,56,55,49,2,47,4,2,1,0,1,0,0,0
S01006574,All HRPs aged 16 and over,427,338,278,22,256,52,8,89,78,5,4,0,2
S01006574,Owned: Total,316,239,189,19,170,46,4,77,71,1,3,0,2
S01006574,Owned: Owned outright,165,98,72,9,63,23,3,67,63,1,1,0,2
S01006574,Owned: Owned with a mortgage or loan or shared ownership,151,141,117,10,107,23,1,10,8,0,2,0,0
S01006574,Rented or living rent free: Total,111,99,89,3,86,6,4,12,7,4,1,0,0
S01006574,Rented or living rent free: Social rented,8,5,1,0,1,0,4,3,2,0,1,0,0
S01006574,Rented or living rent free: Private rented or living rent free,103,94,88,3,85,6,0,9,5,4,0,0,0
S01006575,All HRPs aged 16 and over,399,326,267,17,250,52,7,73,64,5,1,2,1
S01006575,Owned: Total,296,232,184,10,174,44,4,64,62,1,1,0,0
S01006575,Owned: Owned outright,138,75,55,4,51,17,3,63,61,1,1,0,0
S01006575,Owned: Owned with a mortgage or loan or shared ownership,158,157,129,6,123,27,1,1,1,0,0,0,0
S01006575,Rented or living rent free: Total,103,94,83,7,76,8,3,9,2,4,0,2,1
S01006575,Rented or living rent free: Social rented,4,2,2,1,1,0,0,2,0,0,0,2,0
S01006575,Rented or living rent free: Private rented or living rent free,99,92,81,6,75,8,3,7,2,4,0,0,1
S01006576,All HRPs aged 16 and over,325,270,224,18,206,44,2,55,46,2,0,4,3
S01006576,Owned: Total,226,181,151,7,144,29,1,45,43,0,0,1,1
S01006576,Owned: Owned outright,90,48,40,5,35,7,1,42,40,0,0,1,1
S01006576,Owned: Owned with a mortgage or loan or shared ownership,136,133,111,2,109,22,0,3,3,0,0,0,0
S01006576,Rented or living rent free: Total,99,89,73,11,62,15,1,10,3,2,0,3,2
S01006576,Rented or living rent free: Social rented,4,3,3,1,2,0,0,1,0,0,0,0,1
S01006576,Rented or living rent free: Private rented or living rent free,95,86,70,10,60,15,1,9,3,2,0,3,1
S01006577,All HRPs aged 16 and over,430,366,309,21,288,45,12,64,46,8,4,4,2
S01006577,Owned: Total,258,214,174,8,166,37,3,44,38,2,1,1,2
S01006577,Owned: Owned outright,108,71,52,6,46,18,1,37,34,0,0,1,2
S01006577,Owned: Owned with a mortgage or loan or shared ownership,150,143,122,2,120,19,2,7,4,2,1,0,0
S01006577,Rented or living rent free: Total,172,152,135,13,122,8,9,20,8,6,3,3,0
S01006577,Rented or living rent free: Social rented,12,5,5,1,4,0,0,7,3,0,1,3,0
S01006577,Rented or living rent free: Private rented or living rent free,160,147,130,12,118,8,9,13,5,6,2,0,0
S01006578,All HRPs aged 16 and over,633,539,494,52,442,30,15,94,44,28,2,13,7
S01006578,Owned: Total,321,275,250,15,235,20,5,46,33,8,1,2,2
S01006578,Owned: Owned outright,102,67,58,9,49,5,4,35,30,1,0,2,2
S01006578,Owned: Owned with a mortgage or loan or shared ownership,219,208,192,6,186,15,1,11,3,7,1,0,0
S01006578,Rented or living rent free: Total,312,264,244,37,207,10,10,48,11,20,1,11,5
S01006578,Rented or living rent free: Social rented,49,27,23,4,19,0,4,22,5,2,1,11,3
S01006578,Rented or living rent free: Private rented or living rent free,263,237,221,33,188,10,6,26,6,18,0,0,2
S01006579,All HRPs aged 16 and over,640,549,506,56,450,33,10,91,36,34,4,9,8
S01006579,Owned: Total,286,249,224,10,214,22,3,37,28,0,2,4,3
S01006579,Owned: Owned outright,86,56,49,3,46,4,3,30,28,0,0,1,1
S01006579,Owned: Owned with a mortgage or loan or shared ownership,200,193,175,7,168,18,0,7,0,0,2,3,2
S01006579,Rented or living rent free: Total,354,300,282,46,236,11,7,54,8,34,2,5,5
S01006579,Rented or living rent free: Social rented,17,7,4,1,3,1,2,10,3,1,0,4,2
S01006579,Rented or living rent free: Private rented or living rent free,337,293,278,45,233,10,5,44,5,33,2,1,3
S01006580,All HRPs aged 16 and over,422,356,321,32,289,28,7,66,45,8,1,7,5
S01006580,Owned: Total,250,201,180,9,171,20,1,49,40,3,0,3,3
S01006580,Owned: Owned outright,95,56,48,4,44,8,0,39,36,0,0,2,1
S01006580,Owned: Owned with a mortgage or loan or shared ownership,155,145,132,5,127,12,1,10,4,3,0,1,2
S01006580,Rented or living rent free: Total,172,155,141,23,118,8,6,17,5,5,1,4,2
S01006580,Rented or living rent free: Social rented,11,6,6,2,4,0,0,5,0,0,0,3,2
S01006580,Rented or living rent free: Private rented or living rent free,161,149,135,21,114,8,6,12,5,5,1,1,0
S01006581,All HRPs aged 16 and over,402,285,224,22,202,60,1,117,107,2,6,0,2
S01006581,Owned: Total,346,237,182,20,162,54,1,109,103,2,4,0,0
S01006581,Owned: Owned outright,194,90,63,13,50,27,0,104,99,2,3,0,0
S01006581,Owned: Owned with a mortgage or loan or shared ownership,152,147,119,7,112,27,1,5,4,0,1,0,0
S01006581,Rented or living rent free: Total,56,48,42,2,40,6,0,8,4,0,2,0,2
S01006581,Rented or living rent free: Social rented,4,2,2,0,2,0,0,2,0,0,0,0,2
S01006581,Rented or living rent free: Private rented or living rent free,52,46,40,2,38,6,0,6,4,0,2,0,0
S01006582,All HRPs aged 16 and over,466,398,336,39,297,49,13,68,31,23,2,11,1
S01006582,Owned: Total,172,155,120,3,117,33,2,17,12,3,0,2,0
S01006582,Owned: Owned outright,54,41,26,1,25,13,2,13,12,0,0,1,0
S01006582,Owned: Owned with a mortgage or loan or shared ownership,118,114,94,2,92,20,0,4,0,3,0,1,0
S01006582,Rented or living rent free: Total,294,243,216,36,180,16,11,51,19,20,2,9,1
S01006582,Rented or living rent free: Social rented,55,32,25,7,18,4,3,23,18,1,0,4,0
S01006582,Rented or living rent free: Private rented or living rent free,239,211,191,29,162,12,8,28,1,19,2,5,1
S01006583,All HRPs aged 16 and over,404,355,317,47,270,17,21,49,17,25,1,5,1
S01006583,Owned: Total,178,161,141,11,130,11,9,17,10,6,0,0,1
S01006583,Owned: Owned outright,34,26,20,2,18,1,5,8,7,0,0,0,1
S01006583,Owned: Owned with a mortgage or loan or shared ownership,144,135,121,9,112,10,4,9,3,6,0,0,0
S01006583,Rented or living rent free: Total,226,194,176,36,140,6,12,32,7,19,1,5,0
S01006583,Rented or living rent free: Social rented,14,4,2,0,2,0,2,10,5,0,1,4,0
S01006583,Rented or living rent free: Private rented or living rent free,212,190,174,36,138,6,10,22,2,19,0,1,0
S01006584,All HRPs aged 16 and over,354,318,277,36,241,31,10,36,20,11,2,2,1
S01006584,Owned: Total,168,156,133,7,126,20,3,12,11,1,0,0,0
S01006584,Owned: Owned outright,50,40,26,3,23,12,2,10,9,1,0,0,0
S01006584,Owned: Owned with a mortgage or loan or shared ownership,118,116,107,4,103,8,1,2,2,0,0,0,0
S01006584,Rented or living rent free: Total,186,162,144,29,115,11,7,24,9,10,2,2,1
S01006584,Rented or living rent free: Social rented,15,8,6,3,3,0,2,7,4,0,1,2,0
S01006584,Rented or living rent free: Private rented or living rent free,171,154,138,26,112,11,5,17,5,10,1,0,1
S01006585,All HRPs aged 16 and over,465,330,276,58,218,36,18,135,70,23,3,31,8
S01006585,Owned: Total,149,109,91,15,76,17,1,40,35,2,0,3,0
S01006585,Owned: Owned outright,77,43,33,9,24,9,1,34,31,1,0,2,0
S01006585,Owned: Owned with a mortgage or loan or shared ownership,72,66,58,6,52,8,0,6,4,1,0,1,0
S01006585,Rented or living rent free: Total,316,221,185,43,142,19,17,95,35,21,3,28,8
S01006585,Rented or living rent free: Social rented,159,92,73,20,53,8,11,67,32,0,3,28,4
S01006585,Rented or living rent free: Private rented or living rent free,157,129,112,23,89,11,6,28,3,21,0,0,4
S01006586,All HRPs aged 16 and over,650,481,435,88,347,31,15,169,96,32,3,30,8
S01006586,Owned: Total,202,172,151,14,137,20,1,30,25,2,1,2,0
S01006586,Owned: Owned outright,81,56,48,7,41,8,0,25,22,1,1,1,0
S01006586,Owned: Owned with a mortgage or loan or shared ownership,121,116,103,7,96,12,1,5,3,1,0,1,0
S01006586,Rented or living rent free: Total,448,309,284,74,210,11,14,139,71,30,2,28,8
S01006586,Rented or living rent free: Social rented,200,96,89,18,71,3,4,104,64,6,2,25,7
S01006586,Rented or living rent free: Private rented or living rent free,248,213,195,56,139,8,10,35,7,24,0,3,1
S01006587,All HRPs aged 16 and over,318,268,232,30,202,19,17,50,12,22,1,8,7
S01006587,Owned: Total,66,56,49,3,46,7,0,10,3,5,0,1,1
S01006587,Owned: Owned outright,14,10,10,0,10,0,0,4,2,1,0,0,1
S01006587,Owned: Owned with a mortgage or loan or shared ownership,52,46,39,3,36,7,0,6,1,4,0,1,0
S01006587,Rented or living rent free: Total,252,212,183,27,156,12,17,40,9,17,1,7,6
S01006587,Rented or living rent free: Social rented,90,73,58,11,47,5,10,17,8,1,1,4,3
S01006587,Rented or living rent free: Private rented or living rent free,162,139,125,16,109,7,7,23,1,16,0,3,3
S01006588,All HRPs aged 16 and over,338,297,269,49,220,16,12,41,1,27,2,7,4
S01006588,Owned: Total,93,91,83,7,76,8,0,2,0,1,0,0,1
S01006588,Owned: Owned outright,24,22,21,3,18,1,0,2,0,1,0,0,1
S01006588,Owned: Owned with a mortgage or loan or shared ownership,69,69,62,4,58,7,0,0,0,0,0,0,0
S01006588,Rented or living rent free: Total,245,206,186,42,144,8,12,39,1,26,2,7,3
S01006588,Rented or living rent free: Social rented,44,31,26,5,21,3,2,13,1,1,2,6,3
S01006588,Rented or living rent free: Private rented or living rent free,201,175,160,37,123,5,10,26,0,25,0,1,0
S01006589,All HRPs aged 16 and over,367,302,252,70,182,25,25,65,19,22,2,16,6
S01006589,Owned: Total,92,83,69,8,61,14,0,9,4,4,1,0,0
S01006589,Owned: Owned outright,19,15,10,3,7,5,0,4,2,2,0,0,0
S01006589,Owned: Owned with a mortgage or loan or shared ownership,73,68,59,5,54,9,0,5,2,2,1,0,0
S01006589,Rented or living rent free: Total,275,219,183,62,121,11,25,56,15,18,1,16,6
S01006589,Rented or living rent free: Social rented,104,67,54,20,34,0,13,37,13,2,1,16,5
S01006589,Rented or living rent free: Private rented or living rent free,171,152,129,42,87,11,12,19,2,16,0,0,1
S01006590,All HRPs aged 16 and over,379,337,294,31,263,29,14,42,14,13,3,5,7
S01006590,Owned: Total,167,157,135,10,125,19,3,10,10,0,0,0,0
S01006590,Owned: Owned outright,45,38,31,3,28,7,0,7,7,0,0,0,0
S01006590,Owned: Owned with a mortgage or loan or shared ownership,122,119,104,7,97,12,3,3,3,0,0,0,0
S01006590,Rented or living rent free: Total,212,180,159,21,138,10,11,32,4,13,3,5,7
S01006590,Rented or living rent free: Social rented,29,19,14,5,9,1,4,10,4,0,1,4,1
S01006590,Rented or living rent free: Private rented or living rent free,183,161,145,16,129,9,7,22,0,13,2,1,6
S01006591,All HRPs aged 16 and over,367,332,302,38,264,27,3,35,12,11,3,4,5
S01006591,Owned: Total,209,189,170,11,159,18,1,20,12,4,2,2,0
S01006591,Owned: Owned outright,44,32,27,2,25,5,0,12,11,0,0,1,0
S01006591,Owned: Owned with a mortgage or loan or shared ownership,165,157,143,9,134,13,1,8,1,4,2,1,0
S01006591,Rented or living rent free: Total,158,143,132,27,105,9,2,15,0,7,1,2,5
S01006591,Rented or living rent free: Social rented,20,16,15,5,10,1,0,4,0,0,1,1,2
S01006591,Rented or living rent free: Private rented or living rent free,138,127,117,22,95,8,2,11,0,7,0,1,3
S01006592,All HRPs aged 16 and over,374,342,299,22,277,42,1,32,17,11,1,0,3
S01006592,Owned: Total,224,205,175,6,169,30,0,19,16,1,0,0,2
S01006592,Owned: Owned outright,61,42,32,3,29,10,0,19,16,1,0,0,2
S01006592,Owned: Owned with a mortgage or loan or shared ownership,163,163,143,3,140,20,0,0,0,0,0,0,0
S01006592,Rented or living rent free: Total,150,137,124,16,108,12,1,13,1,10,1,0,1
S01006592,Rented or living rent free: Social rented,4,4,4,1,3,0,0,0,0,0,0,0,0
S01006592,Rented or living rent free: Private rented or living rent free,146,133,120,15,105,12,1,13,1,10,1,0,1
S01006593,All HRPs aged 16 and over,411,364,328,31,297,31,5,47,27,11,1,6,2
S01006593,Owned: Total,242,212,187,16,171,24,1,30,24,3,0,2,1
S01006593,Owned: Owned outright,80,55,49,10,39,5,1,25,22,1,0,2,0
S01006593,Owned: Owned with a mortgage or loan or shared ownership,162,157,138,6,132,19,0,5,2,2,0,0,1
S01006593,Rented or living rent free: Total,169,152,141,15,126,7,4,17,3,8,1,4,1
S01006593,Rented or living rent free: Social rented,5,1,1,0,1,0,0,4,1,0,0,3,0
S01006593,Rented or living rent free: Private rented or living rent free,164,151,140,15,125,7,4,13,2,8,1,1,1
S01006594,All HRPs aged 16 and over,345,246,218,36,182,22,6,99,87,7,0,2,3
S01006594,Owned: Total,175,129,117,13,104,10,2,46,44,1,0,0,1
S01006594,Owned: Owned outright,70,40,36,9,27,3,1,30,29,0,0,0,1
S01006594,Owned: Owned with a mortgage or loan or shared ownership,105,89,81,4,77,7,1,16,15,1,0,0,0
S01006594,Rented or living rent free: Total,170,117,101,23,78,12,4,53,43,6,0,2,2
S01006594,Rented or living rent free: Social rented,58,18,14,5,9,3,1,40,40,0,0,0,0
S01006594,Rented or living rent free: Private rented or living rent free,112,99,87,18,69,9,3,13,3,6,0,2,2
S01006595,All HRPs aged 16 and over,555,492,439,43,396,42,11,63,29,14,9,5,6
S01006595,Owned: Total,275,242,210,17,193,30,2,33,22,1,4,1,5
S01006595,Owned: Owned outright,93,66,55,5,50,10,1,27,20,0,3,1,3
S01006595,Owned: Owned with a mortgage or loan or shared ownership,182,176,155,12,143,20,1,6,2,1,1,0,2
S01006595,Rented or living rent free: Total,280,250,229,26,203,12,9,30,7,13,5,4,1
S01006595,Rented or living rent free: Social rented,32,23,16,5,11,1,6,9,3,0,2,4,0
S01006595,Rented or living rent free: Private rented or living rent free,248,227,213,21,192,11,3,21,4,13,3,0,1
S01006596,All HRPs aged 16 and over,359,312,273,21,252,36,3,47,36,6,0,2,3
S01006596,Owned: Total,202,175,148,13,135,26,1,27,26,0,0,0,1
S01006596,Owned: Owned outright,77,52,38,9,29,13,1,25,24,0,0,0,1
S01006596,Owned: Owned with a mortgage or loan or shared ownership,125,123,110,4,106,13,0,2,2,0,0,0,0
S01006596,Rented or living rent free: Total,157,137,125,8,117,10,2,20,10,6,0,2,2
S01006596,Rented or living rent free: Social rented,20,14,12,2,10,2,0,6,4,2,0,0,0
S01006596,Rented or living rent free: Private rented or living rent free,137,123,113,6,107,8,2,14,6,4,0,2,2
S01006597,All HRPs aged 16 and over,352,305,276,26,250,21,8,47,20,14,0,12,1
S01006597,Owned: Total,171,150,138,8,130,10,2,21,16,1,0,3,1
S01006597,Owned: Owned outright,47,29,25,3,22,3,1,18,15,0,0,2,1
S01006597,Owned: Owned with a mortgage or loan or shared ownership,124,121,113,5,108,7,1,3,1,1,0,1,0
S01006597,Rented or living rent free: Total,181,155,138,18,120,11,6,26,4,13,0,9,0
S01006597,Rented or living rent free: Social rented,19,6,5,1,4,0,1,13,2,3,0,8,0
S01006597,Rented or living rent free: Private rented or living rent free,162,149,133,17,116,11,5,13,2,10,0,1,0
S01006598,All HRPs aged 16 and over,435,355,303,27,276,49,3,80,68,6,2,2,2
S01006598,Owned: Total,323,253,215,25,190,36,2,70,65,1,1,1,2
S01006598,Owned: Owned outright,154,92,77,21,56,13,2,62,60,0,0,1,1
S01006598,Owned: Owned with a mortgage or loan or shared ownership,169,161,138,4,134,23,0,8,5,1,1,0,1
S01006598,Rented or living rent free: Total,112,102,88,2,86,13,1,10,3,5,1,1,0
S01006598,Rented or living rent free: Social rented,3,0,0,0,0,0,0,3,2,0,0,1,0
S01006598,Rented or living rent free: Private rented or living rent free,109,102,88,2,86,13,1,7,1,5,1,0,0
S01006599,All HRPs aged 16 and over,499,324,285,43,242,26,13,175,125,12,7,22,9
S01006599,Owned: Total,241,175,159,21,138,14,2,66,61,2,0,2,1
S01006599,Owned: Owned outright,101,47,39,9,30,6,2,54,51,2,0,0,1
S01006599,Owned: Owned with a mortgage or loan or shared ownership,140,128,120,12,108,8,0,12,10,0,0,2,0
S01006599,Rented or living rent free: Total,258,149,126,22,104,12,11,109,64,10,7,20,8
S01006599,Rented or living rent free: Social rented,130,42,33,6,27,3,6,88,59,0,5,20,4
S01006599,Rented or living rent free: Private rented or living rent free,128,107,93,16,77,9,5,21,5,10,2,0,4
S01006600,All HRPs aged 16 and over,587,387,334,27,307,49,4,200,170,12,5,8,5
S01006600,Owned: Total,321,247,209,15,194,36,2,74,68,0,2,3,1
S01006600,Owned: Owned outright,136,68,61,11,50,6,1,68,64,0,0,3,1
S01006600,Owned: Owned with a mortgage or loan or shared ownership,185,179,148,4,144,30,1,6,4,0,2,0,0
S01006600,Rented or living rent free: Total,266,140,125,12,113,13,2,126,102,12,3,5,4
S01006600,Rented or living rent free: Social rented,122,16,15,3,12,0,1,106,98,0,0,5,3
S01006600,Rented or living rent free: Private rented or living rent free,144,124,110,9,101,13,1,20,4,12,3,0,1
S01006601,All HRPs aged 16 and over,572,452,391,38,353,38,23,120,86,8,6,11,9
S01006601,Owned: Total,357,280,251,22,229,27,2,77,75,2,0,0,0
S01006601,Owned: Owned outright,154,78,69,13,56,8,1,76,74,2,0,0,0
S01006601,Owned: Owned with a mortgage or loan or shared ownership,203,202,182,9,173,19,1,1,1,0,0,0,0
S01006601,Rented or living rent free: Total,215,172,140,16,124,11,21,43,11,6,6,11,9
S01006601,Rented or living rent free: Social rented,93,62,46,9,37,3,13,31,9,3,4,9,6
S01006601,Rented or living rent free: Private rented or living rent free,122,110,94,7,87,8,8,12,2,3,2,2,3
S01006602,All HRPs aged 16 and over,414,261,212,20,192,46,3,153,129,11,5,6,2
S01006602,Owned: Total,327,202,160,16,144,40,2,125,114,2,2,5,2
S01006602,Owned: Owned outright,180,64,47,12,35,16,1,116,110,0,0,4,2
S01006602,Owned: Owned with a mortgage or loan or shared ownership,147,138,113,4,109,24,1,9,4,2,2,1,0
S01006602,Rented or living rent free: Total,87,59,52,4,48,6,1,28,15,9,3,1,0
S01006602,Rented or living rent free: Social rented,4,2,0,0,0,1,1,2,0,0,1,1,0
S01006602,Rented or living rent free: Private rented or living rent free,83,57,52,4,48,5,0,26,15,9,2,0,0
S01006603,All HRPs aged 16 and over,385,234,212,37,175,14,8,151,116,1,11,18,5
S01006603,Owned: Total,194,128,115,14,101,11,2,66,62,0,1,1,2
S01006603,Owned: Owned outright,87,31,28,6,22,2,1,56,54,0,1,1,0
S01006603,Owned: Owned with a mortgage or loan or shared ownership,107,97,87,8,79,9,1,10,8,0,0,0,2
S01006603,Rented or living rent free: Total,191,106,97,23,74,3,6,85,54,1,10,17,3
S01006603,Rented or living rent free: Social rented,166,91,83,21,62,2,6,75,49,1,8,15,2
S01006603,Rented or living rent free: Private rented or living rent free,25,15,14,2,12,1,0,10,5,0,2,2,1
S01006604,All HRPs aged 16 and over,291,188,159,19,140,23,6,103,84,0,5,11,3
S01006604,Owned: Total,212,151,130,12,118,19,2,61,58,0,0,3,0
S01006604,Owned: Owned outright,100,50,44,7,37,5,1,50,50,0,0,0,0
S01006604,Owned: Owned with a mortgage or loan or shared ownership,112,101,86,5,81,14,1,11,8,0,0,3,0
S01006604,Rented or living rent free: Total,79,37,29,7,22,4,4,42,26,0,5,8,3
S01006604,Rented or living rent free: Social rented,64,27,21,6,15,3,3,37,23,0,3,8,3
S01006604,Rented or living rent free: Private rented or living rent free,15,10,8,1,7,1,1,5,3,0,2,0,0
S01006605,All HRPs aged 16 and over,409,240,205,39,166,17,18,169,135,2,7,21,4
S01006605,Owned: Total,192,137,120,15,105,12,5,55,52,0,0,3,0
S01006605,Owned: Owned outright,69,29,23,8,15,4,2,40,40,0,0,0,0
S01006605,Owned: Owned with a mortgage or loan or shared ownership,123,108,97,7,90,8,3,15,12,0,0,3,0
S01006605,Rented or living rent free: Total,217,103,85,24,61,5,13,114,83,2,7,18,4
S01006605,Rented or living rent free: Social rented,196,90,73,22,51,5,12,106,79,1,5,18,3
S01006605,Rented or living rent free: Private rented or living rent free,21,13,12,2,10,0,1,8,4,1,2,0,1
S01006606,All HRPs aged 16 and over,390,223,183,23,160,36,4,167,153,2,1,7,4
S01006606,Owned: Total,290,185,151,18,133,33,1,105,101,0,0,1,3
S01006606,Owned: Owned outright,165,69,57,10,47,11,1,96,93,0,0,1,2
S01006606,Owned: Owned with a mortgage or loan or shared ownership,125,116,94,8,86,22,0,9,8,0,0,0,1
S01006606,Rented or living rent free: Total,100,38,32,5,27,3,3,62,52,2,1,6,1
S01006606,Rented or living rent free: Social rented,70,18,15,2,13,1,2,52,47,0,1,3,1
S01006606,Rented or living rent free: Private rented or living rent free,30,20,17,3,14,2,1,10,5,2,0,3,0
S01006607,All HRPs aged 16 and over,385,268,239,43,196,23,6,117,101,1,6,7,2
S01006607,Owned: Total,260,186,168,21,147,18,0,74,70,1,0,1,2
S01006607,Owned: Owned outright,115,52,44,15,29,8,0,63,60,1,0,1,1
S01006607,Owned: Owned with a mortgage or loan or shared ownership,145,134,124,6,118,10,0,11,10,0,0,0,1
S01006607,Rented or living rent free: Total,125,82,71,22,49,5,6,43,31,0,6,6,0
S01006607,Rented or living rent free: Social rented,108,69,60,21,39,4,5,39,28,0,5,6,0
S01006607,Rented or living rent free: Private rented or living rent free,17,13,11,1,10,1,1,4,3,0,1,0,0
S01006608,All HRPs aged 16 and over,284,210,161,22,139,44,5,74,68,2,0,4,0
S01006608,Owned: Total,247,178,133,20,113,43,2,69,67,0,0,2,0
S01006608,Owned: Owned outright,134,68,48,12,36,18,2,66,65,0,0,1,0
S01006608,Owned: Owned with a mortgage or loan or shared ownership,113,110,85,8,77,25,0,3,2,0,0,1,0
S01006608,Rented or living rent free: Total,37,32,28,2,26,1,3,5,1,2,0,2,0
S01006608,Rented or living rent free: Social rented,14,12,11,1,10,0,1,2,0,0,0,2,0
S01006608,Rented or living rent free: Private rented or living rent free,23,20,17,1,16,1,2,3,1,2,0,0,0
S01006609,All HRPs aged 16 and over,490,292,251,38,213,33,8,198,149,4,12,27,6
S01006609,Owned: Total,294,188,161,17,144,24,3,106,92,0,2,9,3
S01006609,Owned: Owned outright,141,49,41,11,30,8,0,92,83,0,2,5,2
S01006609,Owned: Owned with a mortgage or loan or shared ownership,153,139,120,6,114,16,3,14,9,0,0,4,1
S01006609,Rented or living rent free: Total,196,104,90,21,69,9,5,92,57,4,10,18,3
S01006609,Rented or living rent free: Social rented,163,85,72,17,55,8,5,78,47,3,8,17,3
S01006609,Rented or living rent free: Private rented or living rent free,33,19,18,4,14,1,0,14,10,1,2,1,0
S01006610,All HRPs aged 16 and over,212,122,116,19,97,4,2,90,72,1,3,12,2
S01006610,Owned: Total,124,70,67,9,58,3,0,54,54,0,0,0,0
S01006610,Owned: Owned outright,71,25,23,7,16,2,0,46,46,0,0,0,0
S01006610,Owned: Owned with a mortgage or loan or shared ownership,53,45,44,2,42,1,0,8,8,0,0,0,0
S01006610,Rented or living rent free: Total,88,52,49,10,39,1,2,36,18,1,3,12,2
S01006610,Rented or living rent free: Social rented,79,46,44,10,34,1,1,33,17,1,3,11,1
S01006610,Rented or living rent free: Private rented or living rent free,9,6,5,0,5,0,1,3,1,0,0,1,1
S01006611,All HRPs aged 16 and over,425,257,224,37,187,20,13,168,134,2,11,17,4
S01006611,Owned: Total,243,159,146,14,132,11,2,84,80,0,1,2,1
S01006611,Owned: Owned outright,108,42,39,10,29,3,0,66,64,0,0,1,1
S01006611,Owned: Owned with a mortgage or loan or shared ownership,135,117,107,4,103,8,2,18,16,0,1,1,0
S01006611,Rented or living rent free: Total,182,98,78,23,55,9,11,84,54,2,10,15,3
S01006611,Rented or living rent free: Social rented,159,85,67,18,49,7,11,74,49,1,7,15,2
S01006611,Rented or living rent free: Private rented or living rent free,23,13,11,5,6,2,0,10,5,1,3,0,1
S01006612,All HRPs aged 16 and over,373,260,225,30,195,27,8,113,93,0,4,10,6
S01006612,Owned: Total,296,221,199,26,173,21,1,75,69,0,1,1,4
S01006612,Owned: Owned outright,116,52,47,16,31,4,1,64,61,0,0,0,3
S01006612,Owned: Owned with a mortgage or loan or shared ownership,180,169,152,10,142,17,0,11,8,0,1,1,1
S01006612,Rented or living rent free: Total,77,39,26,4,22,6,7,38,24,0,3,9,2
S01006612,Rented or living rent free: Social rented,61,28,20,3,17,2,6,33,20,0,2,9,2
S01006612,Rented or living rent free: Private rented or living rent free,16,11,6,1,5,4,1,5,4,0,1,0,0
S01006613,All HRPs aged 16 and over,259,229,199,9,190,26,4,30,28,0,1,1,0
S01006613,Owned: Total,235,207,179,8,171,24,4,28,27,0,1,0,0
S01006613,Owned: Owned outright,63,37,32,3,29,5,0,26,25,0,1,0,0
S01006613,Owned: Owned with a mortgage or loan or shared ownership,172,170,147,5,142,19,4,2,2,0,0,0,0
S01006613,Rented or living rent free: Total,24,22,20,1,19,2,0,2,1,0,0,1,0
S01006613,Rented or living rent free: Social rented,2,0,0,0,0,0,0,2,1,0,0,1,0
S01006613,Rented or living rent free: Private rented or living rent free,22,22,20,1,19,2,0,0,0,0,0,0,0
S01006614,All HRPs aged 16 and over,265,247,224,15,209,20,3,18,12,1,0,3,2
S01006614,Owned: Total,246,233,213,13,200,19,1,13,10,0,0,1,2
S01006614,Owned: Owned outright,41,30,27,5,22,2,1,11,10,0,0,0,1
S01006614,Owned: Owned with a mortgage or loan or shared ownership,205,203,186,8,178,17,0,2,0,0,0,1,1
S01006614,Rented or living rent free: Total,19,14,11,2,9,1,2,5,2,1,0,2,0
S01006614,Rented or living rent free: Social rented,4,1,0,0,0,0,1,3,2,0,0,1,0
S01006614,Rented or living rent free: Private rented or living rent free,15,13,11,2,9,1,1,2,0,1,0,1,0
S01006615,All HRPs aged 16 and over,270,247,208,13,195,37,2,23,17,2,2,1,1
S01006615,Owned: Total,246,228,190,7,183,36,2,18,16,1,0,0,1
S01006615,Owned: Owned outright,47,33,27,3,24,4,2,14,13,0,0,0,1
S01006615,Owned: Owned with a mortgage or loan or shared ownership,199,195,163,4,159,32,0,4,3,1,0,0,0
S01006615,Rented or living rent free: Total,24,19,18,6,12,1,0,5,1,1,2,1,0
S01006615,Rented or living rent free: Social rented,7,3,2,0,2,1,0,4,1,1,1,1,0
S01006615,Rented or living rent free: Private rented or living rent free,17,16,16,6,10,0,0,1,0,0,1,0,0
S01006616,All HRPs aged 16 and over,337,304,274,11,263,27,3,33,26,3,1,3,0
S01006616,Owned: Total,299,274,249,11,238,23,2,25,23,2,0,0,0
S01006616,Owned: Owned outright,71,48,45,3,42,3,0,23,21,2,0,0,0
S01006616,Owned: Owned with a mortgage or loan or shared ownership,228,226,204,8,196,20,2,2,2,0,0,0,0
S01006616,Rented or living rent free: Total,38,30,25,0,25,4,1,8,3,1,1,3,0
S01006616,Rented or living rent free: Social rented,8,4,3,0,3,1,0,4,1,0,0,3,0
S01006616,Rented or living rent free: Private rented or living rent free,30,26,22,0,22,3,1,4,2,1,1,0,0
S01006617,All HRPs aged 16 and over,297,217,187,26,161,29,1,80,74,0,1,5,0
S01006617,Owned: Total,255,201,174,22,152,27,0,54,52,0,0,2,0
S01006617,Owned: Owned outright,109,67,59,16,43,8,0,42,42,0,0,0,0
S01006617,Owned: Owned with a mortgage or loan or shared ownership,146,134,115,6,109,19,0,12,10,0,0,2,0
S01006617,Rented or living rent free: Total,42,16,13,4,9,2,1,26,22,0,1,3,0
S01006617,Rented or living rent free: Social rented,34,9,8,4,4,1,0,25,22,0,0,3,0
S01006617,Rented or living rent free: Private rented or living rent free,8,7,5,0,5,1,1,1,0,0,1,0,0
S01006618,All HRPs aged 16 and over,246,192,168,22,146,21,3,54,49,0,0,3,2
S01006618,Owned: Total,231,183,160,21,139,20,3,48,46,0,0,1,1
S01006618,Owned: Owned outright,105,60,50,14,36,8,2,45,45,0,0,0,0
S01006618,Owned: Owned with a mortgage or loan or shared ownership,126,123,110,7,103,12,1,3,1,0,0,1,1
S01006618,Rented or living rent free: Total,15,9,8,1,7,1,0,6,3,0,0,2,1
S01006618,Rented or living rent free: Social rented,2,0,0,0,0,0,0,2,0,0,0,2,0
S01006618,Rented or living rent free: Private rented or living rent free,13,9,8,1,7,1,0,4,3,0,0,0,1
S01006619,All HRPs aged 16 and over,372,293,249,23,226,40,4,79,71,0,5,3,0
S01006619,Owned: Total,325,261,219,17,202,38,4,64,60,0,4,0,0
S01006619,Owned: Owned outright,130,73,55,10,45,16,2,57,56,0,1,0,0
S01006619,Owned: Owned with a mortgage or loan or shared ownership,195,188,164,7,157,22,2,7,4,0,3,0,0
S01006619,Rented or living rent free: Total,47,32,30,6,24,2,0,15,11,0,1,3,0
S01006619,Rented or living rent free: Social rented,29,19,17,5,12,2,0,10,7,0,1,2,0
S01006619,Rented or living rent free: Private rented or living rent free,18,13,13,1,12,0,0,5,4,0,0,1,0
S01006620,All HRPs aged 16 and over,390,296,263,22,241,27,6,94,81,0,3,7,3
S01006620,Owned: Total,311,253,226,19,207,22,5,58,55,0,0,2,1
S01006620,Owned: Owned outright,117,70,62,14,48,7,1,47,45,0,0,2,0
S01006620,Owned: Owned with a mortgage or loan or shared ownership,194,183,164,5,159,15,4,11,10,0,0,0,1
S01006620,Rented or living rent free: Total,79,43,37,3,34,5,1,36,26,0,3,5,2
S01006620,Rented or living rent free: Social rented,50,21,18,3,15,3,0,29,21,0,2,4,2
S01006620,Rented or living rent free: Private rented or living rent free,29,22,19,0,19,2,1,7,5,0,1,1,0
S01006621,All HRPs aged 16 and over,235,193,173,23,150,15,5,42,38,0,2,1,1
S01006621,Owned: Total,212,178,159,21,138,15,4,34,32,0,0,1,1
S01006621,Owned: Owned outright,70,38,35,10,25,3,0,32,30,0,0,1,1
S01006621,Owned: Owned with a mortgage or loan or shared ownership,142,140,124,11,113,12,4,2,2,0,0,0,0
S01006621,Rented or living rent free: Total,23,15,14,2,12,0,1,8,6,0,2,0,0
S01006621,Rented or living rent free: Social rented,18,10,10,1,9,0,0,8,6,0,2,0,0
S01006621,Rented or living rent free: Private rented or living rent free,5,5,4,1,3,0,1,0,0,0,0,0,0
S01006622,All HRPs aged 16 and over,292,267,235,8,227,31,1,25,18,1,0,4,2
S01006622,Owned: Total,262,243,213,7,206,29,1,19,16,1,0,1,1
S01006622,Owned: Owned outright,48,32,29,3,26,3,0,16,13,1,0,1,1
S01006622,Owned: Owned with a mortgage or loan or shared ownership,214,211,184,4,180,26,1,3,3,0,0,0,0
S01006622,Rented or living rent free: Total,30,24,22,1,21,2,0,6,2,0,0,3,1
S01006622,Rented or living rent free: Social rented,5,1,1,0,1,0,0,4,0,0,0,3,1
S01006622,Rented or living rent free: Private rented or living rent free,25,23,21,1,20,2,0,2,2,0,0,0,0
S01006623,All HRPs aged 16 and over,359,260,230,20,210,23,7,99,74,2,2,16,5
S01006623,Owned: Total,213,156,138,8,130,17,1,57,51,2,0,0,4
S01006623,Owned: Owned outright,88,39,35,5,30,4,0,49,47,0,0,0,2
S01006623,Owned: Owned with a mortgage or loan or shared ownership,125,117,103,3,100,13,1,8,4,2,0,0,2
S01006623,Rented or living rent free: Total,146,104,92,12,80,6,6,42,23,0,2,16,1
S01006623,Rented or living rent free: Social rented,102,69,63,9,54,2,4,33,18,0,2,12,1
S01006623,Rented or living rent free: Private rented or living rent free,44,35,29,3,26,4,2,9,5,0,0,4,0
S01006624,All HRPs aged 16 and over,481,377,334,45,289,26,17,104,54,13,2,28,7
S01006624,Owned: Total,223,177,156,15,141,18,3,46,39,3,0,2,2
S01006624,Owned: Owned outright,86,43,37,9,28,6,0,43,39,1,0,1,2
S01006624,Owned: Owned with a mortgage or loan or shared ownership,137,134,119,6,113,12,3,3,0,2,0,1,0
S01006624,Rented or living rent free: Total,258,200,178,30,148,8,14,58,15,10,2,26,5
S01006624,Rented or living rent free: Social rented,109,69,56,17,39,3,10,40,11,2,1,23,3
S01006624,Rented or living rent free: Private rented or living rent free,149,131,122,13,109,5,4,18,4,8,1,3,2
S01006625,All HRPs aged 16 and over,288,207,179,32,147,24,4,81,64,2,5,7,3
S01006625,Owned: Total,166,126,106,18,88,19,1,40,35,0,2,2,1
S01006625,Owned: Owned outright,71,36,32,11,21,3,1,35,31,0,2,1,1
S01006625,Owned: Owned with a mortgage or loan or shared ownership,95,90,74,7,67,16,0,5,4,0,0,1,0
S01006625,Rented or living rent free: Total,122,81,73,14,59,5,3,41,29,2,3,5,2
S01006625,Rented or living rent free: Social rented,72,39,33,9,24,3,3,33,23,1,3,4,2
S01006625,Rented or living rent free: Private rented or living rent free,50,42,40,5,35,2,0,8,6,1,0,1,0
S01006626,All HRPs aged 16 and over,377,242,210,40,170,15,17,135,89,3,15,19,9
S01006626,Owned: Total,137,92,83,8,75,8,1,45,43,0,0,0,2
S01006626,Owned: Owned outright,63,25,21,5,16,3,1,38,37,0,0,0,1
S01006626,Owned: Owned with a mortgage or loan or shared ownership,74,67,62,3,59,5,0,7,6,0,0,0,1
S01006626,Rented or living rent free: Total,240,150,127,32,95,7,16,90,46,3,15,19,7
S01006626,Rented or living rent free: Social rented,201,117,98,27,71,6,13,84,43,3,14,17,7
S01006626,Rented or living rent free: Private rented or living rent free,39,33,29,5,24,1,3,6,3,0,1,2,0
S01006627,All HRPs aged 16 and over,511,405,358,38,320,22,25,106,47,6,15,24,14
S01006627,Owned: Total,200,169,155,11,144,12,2,31,23,0,4,2,2
S01006627,Owned: Owned outright,65,38,33,5,28,5,0,27,20,0,3,2,2
S01006627,Owned: Owned with a mortgage or loan or shared ownership,135,131,122,6,116,7,2,4,3,0,1,0,0
S01006627,Rented or living rent free: Total,311,236,203,27,176,10,23,75,24,6,11,22,12
S01006627,Rented or living rent free: Social rented,163,108,88,8,80,1,19,55,18,0,11,18,8
S01006627,Rented or living rent free: Private rented or living rent free,148,128,115,19,96,9,4,20,6,6,0,4,4
S01006628,All HRPs aged 16 and over,635,540,472,49,423,23,45,95,31,10,6,33,15
S01006628,Owned: Total,212,191,176,7,169,7,8,21,13,1,0,2,5
S01006628,Owned: Owned outright,50,36,32,2,30,1,3,14,10,0,0,2,2
S01006628,Owned: Owned with a mortgage or loan or shared ownership,162,155,144,5,139,6,5,7,3,1,0,0,3
S01006628,Rented or living rent free: Total,423,349,296,42,254,16,37,74,18,9,6,31,10
S01006628,Rented or living rent free: Social rented,153,105,78,7,71,6,21,48,12,2,3,23,8
S01006628,Rented or living rent free: Private rented or living rent free,270,244,218,35,183,10,16,26,6,7,3,8,2
S01006629,All HRPs aged 16 and over,315,234,201,35,166,17,16,81,40,4,12,15,10
S01006629,Owned: Total,104,78,67,6,61,9,2,26,22,0,1,1,2
S01006629,Owned: Owned outright,46,24,22,5,17,2,0,22,20,0,1,1,0
S01006629,Owned: Owned with a mortgage or loan or shared ownership,58,54,45,1,44,7,2,4,2,0,0,0,2
S01006629,Rented or living rent free: Total,211,156,134,29,105,8,14,55,18,4,11,14,8
S01006629,Rented or living rent free: Social rented,196,143,122,26,96,7,14,53,17,4,11,13,8
S01006629,Rented or living rent free: Private rented or living rent free,15,13,12,3,9,1,0,2,1,0,0,1,0
S01006630,All HRPs aged 16 and over,256,152,131,32,99,12,9,104,54,1,12,32,5
S01006630,Owned: Total,110,76,67,9,58,7,2,34,27,0,0,4,3
S01006630,Owned: Owned outright,46,18,15,3,12,1,2,28,23,0,0,3,2
S01006630,Owned: Owned with a mortgage or loan or shared ownership,64,58,52,6,46,6,0,6,4,0,0,1,1
S01006630,Rented or living rent free: Total,146,76,64,23,41,5,7,70,27,1,12,28,2
S01006630,Rented or living rent free: Social rented,133,68,59,22,37,4,5,65,23,1,12,27,2
S01006630,Rented or living rent free: Private rented or living rent free,13,8,5,1,4,1,2,5,4,0,0,1,0
S01006631,All HRPs aged 16 and over,493,331,304,49,255,17,10,162,110,2,10,31,9
S01006631,Owned: Total,193,154,141,18,123,11,2,39,34,1,0,1,3
S01006631,Owned: Owned outright,79,49,46,14,32,3,0,30,28,0,0,0,2
S01006631,Owned: Owned with a mortgage or loan or shared ownership,114,105,95,4,91,8,2,9,6,1,0,1,1
S01006631,Rented or living rent free: Total,300,177,163,31,132,6,8,123,76,1,10,30,6
S01006631,Rented or living rent free: Social rented,242,122,114,25,89,3,5,120,76,1,10,27,6
S01006631,Rented or living rent free: Private rented or living rent free,58,55,49,6,43,3,3,3,0,0,0,3,0
S01006632,All HRPs aged 16 and over,423,293,254,47,207,17,22,130,73,3,8,37,9
S01006632,Owned: Total,109,85,75,10,65,9,1,24,19,1,1,1,2
S01006632,Owned: Owned outright,45,24,19,6,13,4,1,21,18,0,1,1,1
S01006632,Owned: Owned with a mortgage or loan or shared ownership,64,61,56,4,52,5,0,3,1,1,0,0,1
S01006632,Rented or living rent free: Total,314,208,179,37,142,8,21,106,54,2,7,36,7
S01006632,Rented or living rent free: Social rented,272,173,151,35,116,5,17,99,49,2,7,35,6
S01006632,Rented or living rent free: Private rented or living rent free,42,35,28,2,26,3,4,7,5,0,0,1,1
S01006633,All HRPs aged 16 and over,288,185,165,33,132,7,13,103,56,4,7,27,9
S01006633,Owned: Total,82,59,53,6,47,3,3,23,20,1,0,0,2
S01006633,Owned: Owned outright,33,14,11,2,9,1,2,19,19,0,0,0,0
S01006633,Owned: Owned with a mortgage or loan or shared ownership,49,45,42,4,38,2,1,4,1,1,0,0,2
S01006633,Rented or living rent free: Total,206,126,112,27,85,4,10,80,36,3,7,27,7
S01006633,Rented or living rent free: Social rented,187,113,101,23,78,2,10,74,33,3,7,24,7
S01006633,Rented or living rent free: Private rented or living rent free,19,13,11,4,7,2,0,6,3,0,0,3,0
S01006634,All HRPs aged 16 and over,291,184,154,34,120,8,22,107,37,1,16,32,21
S01006634,Owned: Total,42,34,32,2,30,1,1,8,5,0,0,3,0
S01006634,Owned: Owned outright,10,5,5,0,5,0,0,5,4,0,0,1,0
S01006634,Owned: Owned with a mortgage or loan or shared ownership,32,29,27,2,25,1,1,3,1,0,0,2,0
S01006634,Rented or living rent free: Total,249,150,122,32,90,7,21,99,32,1,16,29,21
S01006634,Rented or living rent free: Social rented,239,141,114,31,83,6,21,98,32,1,16,29,20
S01006634,Rented or living rent free: Private rented or living rent free,10,9,8,1,7,1,0,1,0,0,0,0,1
S01006635,All HRPs aged 16 and over,289,204,182,33,149,11,11,85,56,1,5,15,8
S01006635,Owned: Total,128,86,80,15,65,6,0,42,38,1,0,2,1
S01006635,Owned: Owned outright,63,26,24,10,14,2,0,37,34,1,0,2,0
S01006635,Owned: Owned with a mortgage or loan or shared ownership,65,60,56,5,51,4,0,5,4,0,0,0,1
S01006635,Rented or living rent free: Total,161,118,102,18,84,5,11,43,18,0,5,13,7
S01006635,Rented or living rent free: Social rented,139,98,85,13,72,4,9,41,18,0,5,11,7
S01006635,Rented or living rent free: Private rented or living rent free,22,20,17,5,12,1,2,2,0,0,0,2,0
S01006636,All HRPs aged 16 and over,386,255,218,39,179,13,24,131,63,3,11,39,15
S01006636,Owned: Total,46,37,33,6,27,3,1,9,8,0,0,1,0
S01006636,Owned: Owned outright,20,13,10,5,5,2,1,7,6,0,0,1,0
S01006636,Owned: Owned with a mortgage or loan or shared ownership,26,24,23,1,22,1,0,2,2,0,0,0,0
S01006636,Rented or living rent free: Total,340,218,185,33,152,10,23,122,55,3,11,38,15
S01006636,Rented or living rent free: Social rented,324,204,173,33,140,8,23,120,53,3,11,38,15
S01006636,Rented or living rent free: Private rented or living rent free,16,14,12,0,12,2,0,2,2,0,0,0,0
S01006637,All HRPs aged 16 and over,413,291,242,37,205,32,17,122,65,22,3,26,6
S01006637,Owned: Total,156,127,104,8,96,21,2,29,23,3,0,3,0
S01006637,Owned: Owned outright,68,42,35,4,31,6,1,26,22,2,0,2,0
S01006637,Owned: Owned with a mortgage or loan or shared ownership,88,85,69,4,65,15,1,3,1,1,0,1,0
S01006637,Rented or living rent free: Total,257,164,138,29,109,11,15,93,42,19,3,23,6
S01006637,Rented or living rent free: Social rented,129,57,43,10,33,3,11,72,40,1,3,22,6
S01006637,Rented or living rent free: Private rented or living rent free,128,107,95,19,76,8,4,21,2,18,0,1,0
S01006638,All HRPs aged 16 and over,504,376,338,52,286,13,25,128,57,32,2,31,6
S01006638,Owned: Total,182,156,146,10,136,6,4,26,18,5,0,1,2
S01006638,Owned: Owned outright,60,40,34,5,29,4,2,20,17,2,0,0,1
S01006638,Owned: Owned with a mortgage or loan or shared ownership,122,116,112,5,107,2,2,6,1,3,0,1,1
S01006638,Rented or living rent free: Total,322,220,192,42,150,7,21,102,39,27,2,30,4
S01006638,Rented or living rent free: Social rented,136,65,46,12,34,2,17,71,37,3,2,28,1
S01006638,Rented or living rent free: Private rented or living rent free,186,155,146,30,116,5,4,31,2,24,0,2,3
S01006639,All HRPs aged 16 and over,592,384,334,70,264,20,30,208,133,20,1,42,12
S01006639,Owned: Total,152,127,115,11,104,8,4,25,17,1,0,4,3
S01006639,Owned: Owned outright,46,28,24,3,21,2,2,18,15,0,0,3,0
S01006639,Owned: Owned with a mortgage or loan or shared ownership,106,99,91,8,83,6,2,7,2,1,0,1,3
S01006639,Rented or living rent free: Total,440,257,219,59,160,12,26,183,116,19,1,38,9
S01006639,Rented or living rent free: Social rented,247,89,65,14,51,5,19,158,112,1,1,35,9
S01006639,Rented or living rent free: Private rented or living rent free,193,168,154,45,109,7,7,25,4,18,0,3,0
S01006640,All HRPs aged 16 and over,376,321,292,44,248,22,7,55,10,32,3,7,3
S01006640,Owned: Total,145,132,117,7,110,14,1,13,5,4,2,1,1
S01006640,Owned: Owned outright,22,16,15,1,14,1,0,6,5,1,0,0,0
S01006640,Owned: Owned with a mortgage or loan or shared ownership,123,116,102,6,96,13,1,7,0,3,2,1,1
S01006640,Rented or living rent free: Total,231,189,175,37,138,8,6,42,5,28,1,6,2
S01006640,Rented or living rent free: Social rented,31,18,15,3,12,1,2,13,4,2,1,5,1
S01006640,Rented or living rent free: Private rented or living rent free,200,171,160,34,126,7,4,29,1,26,0,1,1
S01006641,All HRPs aged 16 and over,602,504,445,83,362,35,24,98,19,39,4,24,12
S01006641,Owned: Total,221,199,179,16,163,16,4,22,12,4,0,2,4
S01006641,Owned: Owned outright,53,39,35,7,28,3,1,14,11,1,0,1,1
S01006641,Owned: Owned with a mortgage or loan or shared ownership,168,160,144,9,135,13,3,8,1,3,0,1,3
S01006641,Rented or living rent free: Total,381,305,266,67,199,19,20,76,7,35,4,22,8
S01006641,Rented or living rent free: Social rented,127,86,65,15,50,6,15,41,6,3,4,21,7
S01006641,Rented or living rent free: Private rented or living rent free,254,219,201,52,149,13,5,35,1,32,0,1,1
S01006642,All HRPs aged 16 and over,492,372,334,83,251,19,19,120,37,53,1,19,10
S01006642,Owned: Total,176,153,140,7,133,9,4,23,16,3,1,1,2
S01006642,Owned: Owned outright,49,31,29,3,26,2,0,18,15,1,0,1,1
S01006642,Owned: Owned with a mortgage or loan or shared ownership,127,122,111,4,107,7,4,5,1,2,1,0,1
S01006642,Rented or living rent free: Total,316,219,194,76,118,10,15,97,21,50,0,18,8
S01006642,Rented or living rent free: Social rented,98,59,47,15,32,3,9,39,18,0,0,16,5
S01006642,Rented or living rent free: Private rented or living rent free,218,160,147,61,86,7,6,58,3,50,0,2,3
S01006643,All HRPs aged 16 and over,419,344,303,88,215,25,16,75,16,46,2,11,0
S01006643,Owned: Total,159,139,124,10,114,13,2,20,10,6,1,3,0
S01006643,Owned: Owned outright,47,33,27,3,24,6,0,14,10,1,1,2,0
S01006643,Owned: Owned with a mortgage or loan or shared ownership,112,106,97,7,90,7,2,6,0,5,0,1,0
S01006643,Rented or living rent free: Total,260,205,179,78,101,12,14,55,6,40,1,8,0
S01006643,Rented or living rent free: Social rented,31,20,15,4,11,2,3,11,1,1,1,8,0
S01006643,Rented or living rent free: Private rented or living rent free,229,185,164,74,90,10,11,44,5,39,0,0,0
S01006644,All HRPs aged 16 and over,553,432,386,95,291,26,20,121,34,53,1,22,11
S01006644,Owned: Total,172,151,140,11,129,8,3,21,7,9,0,3,2
S01006644,Owned: Owned outright,34,22,19,4,15,2,1,12,7,3,0,0,2
S01006644,Owned: Owned with a mortgage or loan or shared ownership,138,129,121,7,114,6,2,9,0,6,0,3,0
S01006644,Rented or living rent free: Total,381,281,246,84,162,18,17,100,27,44,1,19,9
S01006644,Rented or living rent free: Social rented,137,85,77,15,62,3,5,52,23,1,1,19,8
S01006644,Rented or living rent free: Private rented or living rent free,244,196,169,69,100,15,12,48,4,43,0,0,1
S01006645,All HRPs aged 16 and over,393,265,232,46,186,12,21,128,58,12,14,37,7
S01006645,Owned: Total,67,45,41,10,31,4,0,22,18,0,0,3,1
S01006645,Owned: Owned outright,39,19,18,9,9,1,0,20,17,0,0,2,1
S01006645,Owned: Owned with a mortgage or loan or shared ownership,28,26,23,1,22,3,0,2,1,0,0,1,0
S01006645,Rented or living rent free: Total,326,220,191,36,155,8,21,106,40,12,14,34,6
S01006645,Rented or living rent free: Social rented,272,179,153,22,131,7,19,93,40,2,13,32,6
S01006645,Rented or living rent free: Private rented or living rent free,54,41,38,14,24,1,2,13,0,10,1,2,0
S01006646,All HRPs aged 16 and over,340,248,229,41,188,8,11,92,50,30,0,8,4
S01006646,Owned: Total,87,74,71,6,65,3,0,13,8,2,0,1,2
S01006646,Owned: Owned outright,27,18,17,2,15,1,0,9,7,0,0,1,1
S01006646,Owned: Owned with a mortgage or loan or shared ownership,60,56,54,4,50,2,0,4,1,2,0,0,1
S01006646,Rented or living rent free: Total,253,174,158,35,123,5,11,79,42,28,0,7,2
S01006646,Rented or living rent free: Social rented,84,30,24,3,21,2,4,54,42,4,0,6,2
S01006646,Rented or living rent free: Private rented or living rent free,169,144,134,32,102,3,7,25,0,24,0,1,0
S01006647,All HRPs aged 16 and over,341,240,207,42,165,15,18,101,54,18,9,14,6
S01006647,Owned: Total,87,55,46,5,41,7,2,32,26,2,1,1,2
S01006647,Owned: Owned outright,54,25,23,4,19,1,1,29,24,1,1,1,2
S01006647,Owned: Owned with a mortgage or loan or shared ownership,33,30,23,1,22,6,1,3,2,1,0,0,0
S01006647,Rented or living rent free: Total,254,185,161,37,124,8,16,69,28,16,8,13,4
S01006647,Rented or living rent free: Social rented,161,108,89,21,68,5,14,53,27,3,6,13,4
S01006647,Rented or living rent free: Private rented or living rent free,93,77,72,16,56,3,2,16,1,13,2,0,0
S01006648,All HRPs aged 16 and over,651,529,469,84,385,24,36,122,29,44,1,36,12
S01006648,Owned: Total,177,158,141,11,130,10,7,19,7,5,1,4,2
S01006648,Owned: Owned outright,47,34,28,5,23,4,2,13,6,4,0,2,1
S01006648,Owned: Owned with a mortgage or loan or shared ownership,130,124,113,6,107,6,5,6,1,1,1,2,1
S01006648,Rented or living rent free: Total,474,371,328,73,255,14,29,103,22,39,0,32,10
S01006648,Rented or living rent free: Social rented,185,129,99,23,76,7,23,56,18,2,0,29,7
S01006648,Rented or living rent free: Private rented or living rent free,289,242,229,50,179,7,6,47,4,37,0,3,3
S01006649,All HRPs aged 16 and over,583,463,403,71,332,26,34,120,23,31,7,44,15
S01006649,Owned: Total,150,137,123,7,116,13,1,13,3,6,1,3,0
S01006649,Owned: Owned outright,35,30,24,1,23,6,0,5,3,1,1,0,0
S01006649,Owned: Owned with a mortgage or loan or shared ownership,115,107,99,6,93,7,1,8,0,5,0,3,0
S01006649,Rented or living rent free: Total,433,326,280,64,216,13,33,107,20,25,6,41,15
S01006649,Rented or living rent free: Social rented,204,127,99,20,79,11,17,77,18,1,4,41,13
S01006649,Rented or living rent free: Private rented or living rent free,229,199,181,44,137,2,16,30,2,24,2,0,2
S01006650,All HRPs aged 16 and over,481,384,331,75,256,31,22,97,30,40,1,20,6
S01006650,Owned: Total,195,159,140,13,127,15,4,36,25,5,0,5,1
S01006650,Owned: Owned outright,66,37,31,5,26,4,2,29,25,1,0,2,1
S01006650,Owned: Owned with a mortgage or loan or shared ownership,129,122,109,8,101,11,2,7,0,4,0,3,0
S01006650,Rented or living rent free: Total,286,225,191,62,129,16,18,61,5,35,1,15,5
S01006650,Rented or living rent free: Social rented,78,51,42,15,27,3,6,27,5,5,1,15,1
S01006650,Rented or living rent free: Private rented or living rent free,208,174,149,47,102,13,12,34,0,30,0,0,4
S01006651,All HRPs aged 16 and over,382,257,226,47,179,9,22,125,65,41,3,12,4
S01006651,Owned: Total,100,80,73,8,65,5,2,20,13,4,1,1,1
S01006651,Owned: Owned outright,34,21,18,3,15,2,1,13,10,2,1,0,0
S01006651,Owned: Owned with a mortgage or loan or shared ownership,66,59,55,5,50,3,1,7,3,2,0,1,1
S01006651,Rented or living rent free: Total,282,177,153,39,114,4,20,105,52,37,2,11,3
S01006651,Rented or living rent free: Social rented,129,68,54,7,47,2,12,61,51,0,0,9,1
S01006651,Rented or living rent free: Private rented or living rent free,153,109,99,32,67,2,8,44,1,37,2,2,2
S01006652,All HRPs aged 16 and over,308,246,216,36,180,18,12,62,27,22,3,7,3
S01006652,Owned: Total,111,95,85,6,79,8,2,16,9,4,0,0,3
S01006652,Owned: Owned outright,19,12,11,1,10,1,0,7,6,1,0,0,0
S01006652,Owned: Owned with a mortgage or loan or shared ownership,92,83,74,5,69,7,2,9,3,3,0,0,3
S01006652,Rented or living rent free: Total,197,151,131,30,101,10,10,46,18,18,3,7,0
S01006652,Rented or living rent free: Social rented,51,30,24,4,20,3,3,21,15,1,0,5,0
S01006652,Rented or living rent free: Private rented or living rent free,146,121,107,26,81,7,7,25,3,17,3,2,0
S01006653,All HRPs aged 16 and over,296,244,216,32,184,19,9,52,22,23,0,7,0
S01006653,Owned: Total,162,138,127,11,116,8,3,24,20,3,0,1,0
S01006653,Owned: Owned outright,67,47,41,7,34,4,2,20,18,1,0,1,0
S01006653,Owned: Owned with a mortgage or loan or shared ownership,95,91,86,4,82,4,1,4,2,2,0,0,0
S01006653,Rented or living rent free: Total,134,106,89,21,68,11,6,28,2,20,0,6,0
S01006653,Rented or living rent free: Social rented,21,14,10,1,9,1,3,7,0,1,0,6,0
S01006653,Rented or living rent free: Private rented or living rent free,113,92,79,20,59,10,3,21,2,19,0,0,0
S01006654,All HRPs aged 16 and over,504,326,273,53,220,26,27,178,107,11,4,50,6
S01006654,Owned: Total,177,124,107,11,96,14,3,53,49,1,0,3,0
S01006654,Owned: Owned outright,83,35,33,5,28,1,1,48,45,1,0,2,0
S01006654,Owned: Owned with a mortgage or loan or shared ownership,94,89,74,6,68,13,2,5,4,0,0,1,0
S01006654,Rented or living rent free: Total,327,202,166,42,124,12,24,125,58,10,4,47,6
S01006654,Rented or living rent free: Social rented,240,129,105,28,77,8,16,111,55,0,4,46,6
S01006654,Rented or living rent free: Private rented or living rent free,87,73,61,14,47,4,8,14,3,10,0,1,0
S01006655,All HRPs aged 16 and over,334,261,229,30,199,26,6,73,38,18,2,12,3
S01006655,Owned: Total,185,157,137,13,124,19,1,28,21,5,0,1,1
S01006655,Owned: Owned outright,70,47,41,11,30,5,1,23,20,1,0,1,1
S01006655,Owned: Owned with a mortgage or loan or shared ownership,115,110,96,2,94,14,0,5,1,4,0,0,0
S01006655,Rented or living rent free: Total,149,104,92,17,75,7,5,45,17,13,2,11,2
S01006655,Rented or living rent free: Social rented,45,20,16,7,9,2,2,25,15,0,0,9,1
S01006655,Rented or living rent free: Private rented or living rent free,104,84,76,10,66,5,3,20,2,13,2,2,1
S01006656,All HRPs aged 16 and over,524,432,388,54,334,25,19,92,49,19,7,13,4
S01006656,Owned: Total,199,170,157,7,150,11,2,29,20,4,1,1,3
S01006656,Owned: Owned outright,51,29,28,4,24,1,0,22,18,1,1,1,1
S01006656,Owned: Owned with a mortgage or loan or shared ownership,148,141,129,3,126,10,2,7,2,3,0,0,2
S01006656,Rented or living rent free: Total,325,262,231,47,184,14,17,63,29,15,6,12,1
S01006656,Rented or living rent free: Social rented,116,71,60,15,45,4,7,45,26,1,6,12,0
S01006656,Rented or living rent free: Private rented or living rent free,209,191,171,32,139,10,10,18,3,14,0,0,1
S01006657,All HRPs aged 16 and over,286,224,198,38,160,15,11,62,14,27,2,15,4
S01006657,Owned: Total,112,95,83,15,68,10,2,17,10,3,0,4,0
S01006657,Owned: Owned outright,30,19,16,2,14,2,1,11,8,2,0,1,0
S01006657,Owned: Owned with a mortgage or loan or shared ownership,82,76,67,13,54,8,1,6,2,1,0,3,0
S01006657,Rented or living rent free: Total,174,129,115,23,92,5,9,45,4,24,2,11,4
S01006657,Rented or living rent free: Social rented,87,64,55,11,44,4,5,23,4,3,1,11,4
S01006657,Rented or living rent free: Private rented or living rent free,87,65,60,12,48,1,4,22,0,21,1,0,0
S01006658,All HRPs aged 16 and over,525,402,350,98,252,24,28,123,35,45,10,22,11
S01006658,Owned: Total,121,99,90,16,74,7,2,22,14,6,0,1,1
S01006658,Owned: Owned outright,36,21,20,9,11,1,0,15,13,1,0,0,1
S01006658,Owned: Owned with a mortgage or loan or shared ownership,85,78,70,7,63,6,2,7,1,5,0,1,0
S01006658,Rented or living rent free: Total,404,303,260,82,178,17,26,101,21,39,10,21,10
S01006658,Rented or living rent free: Social rented,204,139,110,19,91,10,19,65,21,5,10,20,9
S01006658,Rented or living rent free: Private rented or living rent free,200,164,150,63,87,7,7,36,0,34,0,1,1
S01006659,All HRPs aged 16 and over,287,212,190,59,131,17,5,75,42,31,0,2,0
S01006659,Owned: Total,159,118,104,22,82,12,2,41,37,3,0,1,0
S01006659,Owned: Owned outright,72,39,34,10,24,4,1,33,30,2,0,1,0
S01006659,Owned: Owned with a mortgage or loan or shared ownership,87,79,70,12,58,8,1,8,7,1,0,0,0
S01006659,Rented or living rent free: Total,128,94,86,37,49,5,3,34,5,28,0,1,0
S01006659,Rented or living rent free: Social rented,11,8,6,3,3,2,0,3,2,0,0,1,0
S01006659,Rented or living rent free: Private rented or living rent free,117,86,80,34,46,3,3,31,3,28,0,0,0
S01006660,All HRPs aged 16 and over,247,190,162,37,125,13,15,57,6,31,5,10,5
S01006660,Owned: Total,65,60,51,7,44,3,6,5,3,2,0,0,0
S01006660,Owned: Owned outright,17,15,11,5,6,0,4,2,1,1,0,0,0
S01006660,Owned: Owned with a mortgage or loan or shared ownership,48,45,40,2,38,3,2,3,2,1,0,0,0
S01006660,Rented or living rent free: Total,182,130,111,30,81,10,9,52,3,29,5,10,5
S01006660,Rented or living rent free: Social rented,81,56,46,10,36,5,5,25,3,5,5,9,3
S01006660,Rented or living rent free: Private rented or living rent free,101,74,65,20,45,5,4,27,0,24,0,1,2
S01006661,All HRPs aged 16 and over,301,220,192,45,147,12,16,81,39,29,2,8,3
S01006661,Owned: Total,153,110,96,10,86,10,4,43,36,3,1,1,2
S01006661,Owned: Owned outright,83,46,44,5,39,1,1,37,33,1,1,1,1
S01006661,Owned: Owned with a mortgage or loan or shared ownership,70,64,52,5,47,9,3,6,3,2,0,0,1
S01006661,Rented or living rent free: Total,148,110,96,35,61,2,12,38,3,26,1,7,1
S01006661,Rented or living rent free: Social rented,22,13,11,4,7,0,2,9,2,0,1,5,1
S01006661,Rented or living rent free: Private rented or living rent free,126,97,85,31,54,2,10,29,1,26,0,2,0
S01006662,All HRPs aged 16 and over,285,221,187,44,143,11,23,64,17,18,7,19,3
S01006662,Owned: Total,55,42,40,4,36,2,0,13,7,2,0,3,1
S01006662,Owned: Owned outright,18,11,10,1,9,1,0,7,6,1,0,0,0
S01006662,Owned: Owned with a mortgage or loan or shared ownership,37,31,30,3,27,1,0,6,1,1,0,3,1
S01006662,Rented or living rent free: Total,230,179,147,40,107,9,23,51,10,16,7,16,2
S01006662,Rented or living rent free: Social rented,153,119,98,19,79,7,14,34,9,1,7,16,1
S01006662,Rented or living rent free: Private rented or living rent free,77,60,49,21,28,2,9,17,1,15,0,0,1
S01006663,All HRPs aged 16 and over,245,194,163,49,114,17,14,51,17,31,2,1,0
S01006663,Owned: Total,86,70,59,8,51,9,2,16,12,3,1,0,0
S01006663,Owned: Owned outright,43,30,25,5,20,5,0,13,12,0,1,0,0
S01006663,Owned: Owned with a mortgage or loan or shared ownership,43,40,34,3,31,4,2,3,0,3,0,0,0
S01006663,Rented or living rent free: Total,159,124,104,41,63,8,12,35,5,28,1,1,0
S01006663,Rented or living rent free: Social rented,14,10,8,0,8,1,1,4,4,0,0,0,0
S01006663,Rented or living rent free: Private rented or living rent free,145,114,96,41,55,7,11,31,1,28,1,1,0
S01006664,All HRPs aged 16 and over,237,179,164,46,118,10,5,58,23,27,0,6,2
S01006664,Owned: Total,95,79,70,8,62,7,2,16,14,2,0,0,0
S01006664,Owned: Owned outright,42,29,25,6,19,4,0,13,12,1,0,0,0
S01006664,Owned: Owned with a mortgage or loan or shared ownership,53,50,45,2,43,3,2,3,2,1,0,0,0
S01006664,Rented or living rent free: Total,142,100,94,38,56,3,3,42,9,25,0,6,2
S01006664,Rented or living rent free: Social rented,25,9,7,1,6,2,0,16,7,2,0,6,1
S01006664,Rented or living rent free: Private rented or living rent free,117,91,87,37,50,1,3,26,2,23,0,0,1
S01006665,All HRPs aged 16 and over,316,232,208,59,149,14,10,84,38,37,1,7,1
S01006665,Owned: Total,121,91,80,15,65,9,2,30,25,3,0,2,0
S01006665,Owned: Owned outright,49,23,18,4,14,5,0,26,23,2,0,1,0
S01006665,Owned: Owned with a mortgage or loan or shared ownership,72,68,62,11,51,4,2,4,2,1,0,1,0
S01006665,Rented or living rent free: Total,195,141,128,44,84,5,8,54,13,34,1,5,1
S01006665,Rented or living rent free: Social rented,36,16,14,2,12,0,2,20,13,1,1,5,0
S01006665,Rented or living rent free: Private rented or living rent free,159,125,114,42,72,5,6,34,0,33,0,0,1
S01006666,All HRPs aged 16 and over,499,269,216,43,173,24,29,230,153,11,7,49,10
S01006666,Owned: Total,48,36,29,4,25,7,0,12,10,1,0,0,1
S01006666,Owned: Owned outright,24,14,11,4,7,3,0,10,10,0,0,0,0
S01006666,Owned: Owned with a mortgage or loan or shared ownership,24,22,18,0,18,4,0,2,0,1,0,0,1
S01006666,Rented or living rent free: Total,451,233,187,39,148,17,29,218,143,10,7,49,9
S01006666,Rented or living rent free: Social rented,426,215,171,34,137,16,28,211,142,4,7,49,9
S01006666,Rented or living rent free: Private rented or living rent free,25,18,16,5,11,1,1,7,1,6,0,0,0
S01006667,All HRPs aged 16 and over,447,284,225,42,183,17,42,163,79,23,7,47,7
S01006667,Owned: Total,57,43,33,6,27,4,6,14,13,0,0,1,0
S01006667,Owned: Owned outright,23,12,10,5,5,1,1,11,11,0,0,0,0
S01006667,Owned: Owned with a mortgage or loan or shared ownership,34,31,23,1,22,3,5,3,2,0,0,1,0
S01006667,Rented or living rent free: Total,390,241,192,36,156,13,36,149,66,23,7,46,7
S01006667,Rented or living rent free: Social rented,340,212,167,26,141,13,32,128,66,2,7,46,7
S01006667,Rented or living rent free: Private rented or living rent free,50,29,25,10,15,0,4,21,0,21,0,0,0
S01006668,All HRPs aged 16 and over,413,303,269,70,199,18,16,110,39,51,3,13,4
S01006668,Owned: Total,174,138,123,15,108,12,3,36,22,12,0,1,1
S01006668,Owned: Owned outright,61,32,25,6,19,4,3,29,22,6,0,0,1
S01006668,Owned: Owned with a mortgage or loan or shared ownership,113,106,98,9,89,8,0,7,0,6,0,1,0
S01006668,Rented or living rent free: Total,239,165,146,55,91,6,13,74,17,39,3,12,3
S01006668,Rented or living rent free: Social rented,75,40,33,6,27,3,4,35,16,2,3,12,2
S01006668,Rented or living rent free: Private rented or living rent free,164,125,113,49,64,3,9,39,1,37,0,0,1
S01006669,All HRPs aged 16 and over,444,261,226,46,180,21,14,183,106,21,3,44,9
S01006669,Owned: Total,103,59,51,9,42,8,0,44,36,2,1,3,2
S01006669,Owned: Owned outright,53,16,12,1,11,4,0,37,34,0,0,1,2
S01006669,Owned: Owned with a mortgage or loan or shared ownership,50,43,39,8,31,4,0,7,2,2,1,2,0
S01006669,Rented or living rent free: Total,341,202,175,37,138,13,14,139,70,19,2,41,7
S01006669,Rented or living rent free: Social rented,215,104,91,16,75,5,8,111,59,3,2,40,7
S01006669,Rented or living rent free: Private rented or living rent free,126,98,84,21,63,8,6,28,11,16,0,1,0
S01006670,All HRPs aged 16 and over,347,225,196,28,168,11,18,122,72,17,3,18,12
S01006670,Owned: Total,147,105,98,7,91,7,0,42,32,2,0,2,6
S01006670,Owned: Owned outright,44,12,12,4,8,0,0,32,27,0,0,2,3
S01006670,Owned: Owned with a mortgage or loan or shared ownership,103,93,86,3,83,7,0,10,5,2,0,0,3
S01006670,Rented or living rent free: Total,200,120,98,21,77,4,18,80,40,15,3,16,6
S01006670,Rented or living rent free: Social rented,97,42,31,6,25,3,8,55,34,0,1,15,5
S01006670,Rented or living rent free: Private rented or living rent free,103,78,67,15,52,1,10,25,6,15,2,1,1
S01006671,All HRPs aged 16 and over,233,170,149,51,98,12,9,63,40,11,4,3,5
S01006671,Owned: Total,97,68,61,13,48,5,2,29,25,1,1,0,2
S01006671,Owned: Owned outright,40,23,19,5,14,3,1,17,13,1,1,0,2
S01006671,Owned: Owned with a mortgage or loan or shared ownership,57,45,42,8,34,2,1,12,12,0,0,0,0
S01006671,Rented or living rent free: Total,136,102,88,38,50,7,7,34,15,10,3,3,3
S01006671,Rented or living rent free: Social rented,62,39,31,12,19,5,3,23,13,1,3,3,3
S01006671,Rented or living rent free: Private rented or living rent free,74,63,57,26,31,2,4,11,2,9,0,0,0
S01006672,All HRPs aged 16 and over,366,252,217,54,163,14,21,114,69,13,15,13,4
S01006672,Owned: Total,90,67,56,5,51,9,2,23,21,1,0,0,1
S01006672,Owned: Owned outright,38,21,17,2,15,2,2,17,17,0,0,0,0
S01006672,Owned: Owned with a mortgage or loan or shared ownership,52,46,39,3,36,7,0,6,4,1,0,0,1
S01006672,Rented or living rent free: Total,276,185,161,49,112,5,19,91,48,12,15,13,3
S01006672,Rented or living rent free: Social rented,206,131,110,27,83,4,17,75,46,0,14,13,2
S01006672,Rented or living rent free: Private rented or living rent free,70,54,51,22,29,1,2,16,2,12,1,0,1
S01006673,All HRPs aged 16 and over,367,277,240,53,187,25,12,90,35,15,4,29,7
S01006673,Owned: Total,89,68,59,12,47,9,0,21,18,1,0,0,2
S01006673,Owned: Owned outright,37,20,15,6,9,5,0,17,16,0,0,0,1
S01006673,Owned: Owned with a mortgage or loan or shared ownership,52,48,44,6,38,4,0,4,2,1,0,0,1
S01006673,Rented or living rent free: Total,278,209,181,41,140,16,12,69,17,14,4,29,5
S01006673,Rented or living rent free: Social rented,209,153,130,30,100,13,10,56,16,2,4,29,5
S01006673,Rented or living rent free: Private rented or living rent free,69,56,51,11,40,3,2,13,1,12,0,0,0
S01006674,All HRPs aged 16 and over,544,317,259,60,199,26,32,227,162,9,11,32,13
S01006674,Owned: Total,67,31,28,10,18,3,0,36,34,1,0,0,1
S01006674,Owned: Owned outright,56,23,21,7,14,2,0,33,31,1,0,0,1
S01006674,Owned: Owned with a mortgage or loan or shared ownership,11,8,7,3,4,1,0,3,3,0,0,0,0
S01006674,Rented or living rent free: Total,477,286,231,50,181,23,32,191,128,8,11,32,12
S01006674,Rented or living rent free: Social rented,445,259,212,44,168,20,27,186,125,8,11,30,12
S01006674,Rented or living rent free: Private rented or living rent free,32,27,19,6,13,3,5,5,3,0,0,2,0
S01006675,All HRPs aged 16 and over,315,234,199,51,148,12,23,81,13,4,20,35,9
S01006675,Owned: Total,19,17,14,1,13,2,1,2,1,0,0,1,0
S01006675,Owned: Owned outright,2,2,1,1,0,1,0,0,0,0,0,0,0
S01006675,Owned: Owned with a mortgage or loan or shared ownership,17,15,13,0,13,1,1,2,1,0,0,1,0
S01006675,Rented or living rent free: Total,296,217,185,50,135,10,22,79,12,4,20,34,9
S01006675,Rented or living rent free: Social rented,284,208,176,47,129,10,22,76,12,3,19,33,9
S01006675,Rented or living rent free: Private rented or living rent free,12,9,9,3,6,0,0,3,0,1,1,1,0
S01006676,All HRPs aged 16 and over,358,230,194,44,150,12,24,128,74,5,9,25,15
S01006676,Owned: Total,71,44,40,9,31,4,0,27,26,0,0,1,0
S01006676,Owned: Owned outright,36,14,14,5,9,0,0,22,21,0,0,1,0
S01006676,Owned: Owned with a mortgage or loan or shared ownership,35,30,26,4,22,4,0,5,5,0,0,0,0
S01006676,Rented or living rent free: Total,287,186,154,35,119,8,24,101,48,5,9,24,15
S01006676,Rented or living rent free: Social rented,252,153,122,27,95,7,24,99,48,3,9,24,15
S01006676,Rented or living rent free: Private rented or living rent free,35,33,32,8,24,1,0,2,0,2,0,0,0
S01006677,All HRPs aged 16 and over,398,274,221,56,165,16,37,124,51,21,3,38,11
S01006677,Owned: Total,113,83,76,7,69,6,1,30,26,4,0,0,0
S01006677,Owned: Owned outright,51,27,25,3,22,1,1,24,22,2,0,0,0
S01006677,Owned: Owned with a mortgage or loan or shared ownership,62,56,51,4,47,5,0,6,4,2,0,0,0
S01006677,Rented or living rent free: Total,285,191,145,49,96,10,36,94,25,17,3,38,11
S01006677,Rented or living rent free: Social rented,237,150,112,31,81,7,31,87,25,10,3,38,11
S01006677,Rented or living rent free: Private rented or living rent free,48,41,33,18,15,3,5,7,0,7,0,0,0
S01006678,All HRPs aged 16 and over,525,369,310,64,246,19,40,156,80,14,14,37,11
S01006678,Owned: Total,129,83,76,9,67,5,2,46,43,2,0,1,0
S01006678,Owned: Owned outright,55,20,18,4,14,1,1,35,33,2,0,0,0
S01006678,Owned: Owned with a mortgage or loan or shared ownership,74,63,58,5,53,4,1,11,10,0,0,1,0
S01006678,Rented or living rent free: Total,396,286,234,55,179,14,38,110,37,12,14,36,11
S01006678,Rented or living rent free: Social rented,366,266,218,49,169,12,36,100,36,3,14,36,11
S01006678,Rented or living rent free: Private rented or living rent free,30,20,16,6,10,2,2,10,1,9,0,0,0
S01006679,All HRPs aged 16 and over,315,231,209,27,182,16,6,84,70,2,2,6,4
S01006679,Owned: Total,241,177,161,16,145,14,2,64,60,0,0,2,2
S01006679,Owned: Owned outright,131,71,64,11,53,5,2,60,56,0,0,2,2
S01006679,Owned: Owned with a mortgage or loan or shared ownership,110,106,97,5,92,9,0,4,4,0,0,0,0
S01006679,Rented or living rent free: Total,74,54,48,11,37,2,4,20,10,2,2,4,2
S01006679,Rented or living rent free: Social rented,40,26,22,5,17,0,4,14,8,0,1,3,2
S01006679,Rented or living rent free: Private rented or living rent free,34,28,26,6,20,2,0,6,2,2,1,1,0
S01006680,All HRPs aged 16 and over,416,288,232,37,195,22,34,128,61,7,12,36,12
S01006680,Owned: Total,62,47,38,5,33,7,2,15,12,0,1,2,0
S01006680,Owned: Owned outright,29,16,12,1,11,4,0,13,11,0,1,1,0
S01006680,Owned: Owned with a mortgage or loan or shared ownership,33,31,26,4,22,3,2,2,1,0,0,1,0
S01006680,Rented or living rent free: Total,354,241,194,32,162,15,32,113,49,7,11,34,12
S01006680,Rented or living rent free: Social rented,345,232,188,31,157,12,32,113,49,7,11,34,12
S01006680,Rented or living rent free: Private rented or living rent free,9,9,6,1,5,3,0,0,0,0,0,0,0
S01006681,All HRPs aged 16 and over,464,288,264,35,229,14,10,176,136,5,4,28,3
S01006681,Owned: Total,184,162,148,16,132,12,2,22,20,1,1,0,0
S01006681,Owned: Owned outright,49,30,29,7,22,1,0,19,18,0,1,0,0
S01006681,Owned: Owned with a mortgage or loan or shared ownership,135,132,119,9,110,11,2,3,2,1,0,0,0
S01006681,Rented or living rent free: Total,280,126,116,19,97,2,8,154,116,4,3,28,3
S01006681,Rented or living rent free: Social rented,222,73,65,14,51,0,8,149,114,1,3,28,3
S01006681,Rented or living rent free: Private rented or living rent free,58,53,51,5,46,2,0,5,2,3,0,0,0
S01006682,All HRPs aged 16 and over,384,273,218,38,180,25,30,111,70,5,6,24,6
S01006682,Owned: Total,56,48,41,3,38,7,0,8,8,0,0,0,0
S01006682,Owned: Owned outright,20,13,12,1,11,1,0,7,7,0,0,0,0
S01006682,Owned: Owned with a mortgage or loan or shared ownership,36,35,29,2,27,6,0,1,1,0,0,0,0
S01006682,Rented or living rent free: Total,328,225,177,35,142,18,30,103,62,5,6,24,6
S01006682,Rented or living rent free: Social rented,299,201,158,32,126,15,28,98,62,0,6,24,6
S01006682,Rented or living rent free: Private rented or living rent free,29,24,19,3,16,3,2,5,0,5,0,0,0
S01006683,All HRPs aged 16 and over,370,283,242,48,194,16,25,87,28,16,8,27,8
S01006683,Owned: Total,89,74,62,7,55,10,2,15,12,1,0,2,0
S01006683,Owned: Owned outright,28,15,11,2,9,3,1,13,12,0,0,1,0
S01006683,Owned: Owned with a mortgage or loan or shared ownership,61,59,51,5,46,7,1,2,0,1,0,1,0
S01006683,Rented or living rent free: Total,281,209,180,41,139,6,23,72,16,15,8,25,8
S01006683,Rented or living rent free: Social rented,217,157,134,28,106,3,20,60,16,3,8,25,8
S01006683,Rented or living rent free: Private rented or living rent free,64,52,46,13,33,3,3,12,0,12,0,0,0
S01006684,All HRPs aged 16 and over,401,284,244,33,211,12,28,117,42,9,8,43,15
S01006684,Owned: Total,97,73,67,6,61,4,2,24,21,1,0,1,1
S01006684,Owned: Owned outright,36,17,15,4,11,2,0,19,19,0,0,0,0
S01006684,Owned: Owned with a mortgage or loan or shared ownership,61,56,52,2,50,2,2,5,2,1,0,1,1
S01006684,Rented or living rent free: Total,304,211,177,27,150,8,26,93,21,8,8,42,14
S01006684,Rented or living rent free: Social rented,247,163,138,20,118,7,18,84,21,3,6,40,14
S01006684,Rented or living rent free: Private rented or living rent free,57,48,39,7,32,1,8,9,0,5,2,2,0
S01006685,All HRPs aged 16 and over,427,313,268,48,220,12,33,114,57,3,7,34,13
S01006685,Owned: Total,147,126,117,11,106,8,1,21,20,0,0,1,0
S01006685,Owned: Owned outright,39,19,17,5,12,2,0,20,19,0,0,1,0
S01006685,Owned: Owned with a mortgage or loan or shared ownership,108,107,100,6,94,6,1,1,1,0,0,0,0
S01006685,Rented or living rent free: Total,280,187,151,37,114,4,32,93,37,3,7,33,13
S01006685,Rented or living rent free: Social rented,223,134,105,31,74,2,27,89,37,0,7,32,13
S01006685,Rented or living rent free: Private rented or living rent free,57,53,46,6,40,2,5,4,0,3,0,1,0
S01006686,All HRPs aged 16 and over,305,207,181,26,155,17,9,98,64,0,4,19,11
S01006686,Owned: Total,160,112,98,10,88,12,2,48,42,0,0,4,2
S01006686,Owned: Owned outright,63,21,16,1,15,3,2,42,37,0,0,3,2
S01006686,Owned: Owned with a mortgage or loan or shared ownership,97,91,82,9,73,9,0,6,5,0,0,1,0
S01006686,Rented or living rent free: Total,145,95,83,16,67,5,7,50,22,0,4,15,9
S01006686,Rented or living rent free: Social rented,111,67,56,13,43,4,7,44,19,0,3,15,7
S01006686,Rented or living rent free: Private rented or living rent free,34,28,27,3,24,1,0,6,3,0,1,0,2
S01006687,All HRPs aged 16 and over,419,275,254,51,203,12,9,144,100,4,10,24,6
S01006687,Owned: Total,221,153,144,22,122,8,1,68,57,3,0,6,2
S01006687,Owned: Owned outright,95,43,39,8,31,3,1,52,46,2,0,3,1
S01006687,Owned: Owned with a mortgage or loan or shared ownership,126,110,105,14,91,5,0,16,11,1,0,3,1
S01006687,Rented or living rent free: Total,198,122,110,29,81,4,8,76,43,1,10,18,4
S01006687,Rented or living rent free: Social rented,134,64,57,18,39,1,6,70,40,0,10,18,2
S01006687,Rented or living rent free: Private rented or living rent free,64,58,53,11,42,3,2,6,3,1,0,0,2
S01006688,All HRPs aged 16 and over,510,236,201,27,174,32,3,274,241,6,5,15,7
S01006688,Owned: Total,296,176,146,15,131,29,1,120,115,1,2,2,0
S01006688,Owned: Owned outright,173,62,51,9,42,11,0,111,108,0,2,1,0
S01006688,Owned: Owned with a mortgage or loan or shared ownership,123,114,95,6,89,18,1,9,7,1,0,1,0
S01006688,Rented or living rent free: Total,214,60,55,12,43,3,2,154,126,5,3,13,7
S01006688,Rented or living rent free: Social rented,173,32,28,4,24,2,2,141,116,2,3,13,7
S01006688,Rented or living rent free: Private rented or living rent free,41,28,27,8,19,1,0,13,10,3,0,0,0
S01006689,All HRPs aged 16 and over,288,232,197,22,175,34,1,56,37,13,1,0,5
S01006689,Owned: Total,222,178,150,13,137,27,1,44,36,5,1,0,2
S01006689,Owned: Owned outright,81,42,36,6,30,6,0,39,35,3,1,0,0
S01006689,Owned: Owned with a mortgage or loan or shared ownership,141,136,114,7,107,21,1,5,1,2,0,0,2
S01006689,Rented or living rent free: Total,66,54,47,9,38,7,0,12,1,8,0,0,3
S01006689,Rented or living rent free: Social rented,6,2,2,0,2,0,0,4,1,0,0,0,3
S01006689,Rented or living rent free: Private rented or living rent free,60,52,45,9,36,7,0,8,0,8,0,0,0
S01006690,All HRPs aged 16 and over,308,211,187,46,141,15,9,97,67,15,2,10,3
S01006690,Owned: Total,196,135,120,20,100,10,5,61,54,3,0,3,1
S01006690,Owned: Owned outright,91,33,29,10,19,3,1,58,53,2,0,2,1
S01006690,Owned: Owned with a mortgage or loan or shared ownership,105,102,91,10,81,7,4,3,1,1,0,1,0
S01006690,Rented or living rent free: Total,112,76,67,26,41,5,4,36,13,12,2,7,2
S01006690,Rented or living rent free: Social rented,40,23,18,7,11,2,3,17,8,0,2,6,1
S01006690,Rented or living rent free: Private rented or living rent free,72,53,49,19,30,3,1,19,5,12,0,1,1
S01006691,All HRPs aged 16 and over,271,213,188,28,160,20,5,58,42,14,0,0,2
S01006691,Owned: Total,179,142,125,13,112,16,1,37,35,2,0,0,0
S01006691,Owned: Owned outright,65,33,27,7,20,6,0,32,30,2,0,0,0
S01006691,Owned: Owned with a mortgage or loan or shared ownership,114,109,98,6,92,10,1,5,5,0,0,0,0
S01006691,Rented or living rent free: Total,92,71,63,15,48,4,4,21,7,12,0,0,2
S01006691,Rented or living rent free: Social rented,21,13,8,2,6,3,2,8,5,1,0,0,2
S01006691,Rented or living rent free: Private rented or living rent free,71,58,55,13,42,1,2,13,2,11,0,0,0
S01006692,All HRPs aged 16 and over,361,229,201,20,181,24,4,132,100,22,0,7,3
S01006692,Owned: Total,268,179,156,11,145,21,2,89,82,2,0,3,2
S01006692,Owned: Owned outright,140,61,49,4,45,11,1,79,76,0,0,2,1
S01006692,Owned: Owned with a mortgage or loan or shared ownership,128,118,107,7,100,10,1,10,6,2,0,1,1
S01006692,Rented or living rent free: Total,93,50,45,9,36,3,2,43,18,20,0,4,1
S01006692,Rented or living rent free: Social rented,37,18,15,4,11,1,2,19,15,0,0,4,0
S01006692,Rented or living rent free: Private rented or living rent free,56,32,30,5,25,2,0,24,3,20,0,0,1
S01006693,All HRPs aged 16 and over,497,373,337,54,283,23,13,124,81,18,5,16,4
S01006693,Owned: Total,257,200,186,19,167,13,1,57,51,2,0,2,2
S01006693,Owned: Owned outright,91,46,39,9,30,7,0,45,42,2,0,0,1
S01006693,Owned: Owned with a mortgage or loan or shared ownership,166,154,147,10,137,6,1,12,9,0,0,2,1
S01006693,Rented or living rent free: Total,240,173,151,35,116,10,12,67,30,16,5,14,2
S01006693,Rented or living rent free: Social rented,119,72,57,17,40,9,6,47,23,3,5,14,2
S01006693,Rented or living rent free: Private rented or living rent free,121,101,94,18,76,1,6,20,7,13,0,0,0
S01006694,All HRPs aged 16 and over,480,219,186,43,143,17,16,261,230,4,9,15,3
S01006694,Owned: Total,122,71,62,6,56,8,1,51,46,1,0,2,2
S01006694,Owned: Owned outright,54,16,14,2,12,2,0,38,36,0,0,2,0
S01006694,Owned: Owned with a mortgage or loan or shared ownership,68,55,48,4,44,6,1,13,10,1,0,0,2
S01006694,Rented or living rent free: Total,358,148,124,37,87,9,15,210,184,3,9,13,1
S01006694,Rented or living rent free: Social rented,343,133,110,34,76,9,14,210,184,3,9,13,1
S01006694,Rented or living rent free: Private rented or living rent free,15,15,14,3,11,0,1,0,0,0,0,0,0
S01006695,All HRPs aged 16 and over,346,202,181,31,150,20,1,144,114,3,3,20,4
S01006695,Owned: Total,218,137,121,18,103,16,0,81,77,0,0,3,1
S01006695,Owned: Owned outright,116,46,35,13,22,11,0,70,67,0,0,3,0
S01006695,Owned: Owned with a mortgage or loan or shared ownership,102,91,86,5,81,5,0,11,10,0,0,0,1
S01006695,Rented or living rent free: Total,128,65,60,13,47,4,1,63,37,3,3,17,3
S01006695,Rented or living rent free: Social rented,105,49,44,10,34,4,1,56,34,0,3,17,2
S01006695,Rented or living rent free: Private rented or living rent free,23,16,16,3,13,0,0,7,3,3,0,0,1
S01006696,All HRPs aged 16 and over,390,237,210,48,162,11,16,153,117,6,4,23,3
S01006696,Owned: Total,158,110,100,11,89,8,2,48,42,1,1,4,0
S01006696,Owned: Owned outright,66,26,22,4,18,3,1,40,37,0,0,3,0
S01006696,Owned: Owned with a mortgage or loan or shared ownership,92,84,78,7,71,5,1,8,5,1,1,1,0
S01006696,Rented or living rent free: Total,232,127,110,37,73,3,14,105,75,5,3,19,3
S01006696,Rented or living rent free: Social rented,187,90,77,30,47,2,11,97,72,1,3,19,2
S01006696,Rented or living rent free: Private rented or living rent free,45,37,33,7,26,1,3,8,3,4,0,0,1
S01006697,All HRPs aged 16 and over,435,271,235,48,187,28,8,164,115,9,7,26,7
S01006697,Owned: Total,205,136,114,18,96,21,1,69,65,1,1,1,1
S01006697,Owned: Owned outright,100,39,32,8,24,6,1,61,59,0,1,1,0
S01006697,Owned: Owned with a mortgage or loan or shared ownership,105,97,82,10,72,15,0,8,6,1,0,0,1
S01006697,Rented or living rent free: Total,230,135,121,30,91,7,7,95,50,8,6,25,6
S01006697,Rented or living rent free: Social rented,192,108,97,29,68,4,7,84,45,2,6,25,6
S01006697,Rented or living rent free: Private rented or living rent free,38,27,24,1,23,3,0,11,5,6,0,0,0
S01006698,All HRPs aged 16 and over,409,216,200,40,160,5,11,193,137,11,5,29,11
S01006698,Owned: Total,110,71,65,8,57,5,1,39,34,3,0,1,1
S01006698,Owned: Owned outright,48,17,13,7,6,3,1,31,29,0,0,1,1
S01006698,Owned: Owned with a mortgage or loan or shared ownership,62,54,52,1,51,2,0,8,5,3,0,0,0
S01006698,Rented or living rent free: Total,299,145,135,32,103,0,10,154,103,8,5,28,10
S01006698,Rented or living rent free: Social rented,251,103,96,29,67,0,7,148,102,4,5,27,10
S01006698,Rented or living rent free: Private rented or living rent free,48,42,39,3,36,0,3,6,1,4,0,1,0
S01006699,All HRPs aged 16 and over,209,148,131,19,112,14,3,61,47,7,2,4,1
S01006699,Owned: Total,147,101,86,8,78,13,2,46,42,2,0,1,1
S01006699,Owned: Owned outright,76,36,29,4,25,6,1,40,39,0,0,1,0
S01006699,Owned: Owned with a mortgage or loan or shared ownership,71,65,57,4,53,7,1,6,3,2,0,0,1
S01006699,Rented or living rent free: Total,62,47,45,11,34,1,1,15,5,5,2,3,0
S01006699,Rented or living rent free: Social rented,28,18,16,7,9,1,1,10,5,0,2,3,0
S01006699,Rented or living rent free: Private rented or living rent free,34,29,29,4,25,0,0,5,0,5,0,0,0
S01006700,All HRPs aged 16 and over,431,255,218,31,187,23,14,176,137,5,2,25,7
S01006700,Owned: Total,219,140,122,9,113,18,0,79,77,0,0,1,1
S01006700,Owned: Owned outright,121,50,41,7,34,9,0,71,71,0,0,0,0
S01006700,Owned: Owned with a mortgage or loan or shared ownership,98,90,81,2,79,9,0,8,6,0,0,1,1
S01006700,Rented or living rent free: Total,212,115,96,22,74,5,14,97,60,5,2,24,6
S01006700,Rented or living rent free: Social rented,150,62,49,13,36,2,11,88,56,0,2,24,6
S01006700,Rented or living rent free: Private rented or living rent free,62,53,47,9,38,3,3,9,4,5,0,0,0
S01006701,All HRPs aged 16 and over,321,214,188,38,150,13,13,107,62,2,13,23,7
S01006701,Owned: Total,140,99,89,11,78,9,1,41,32,2,1,5,1
S01006701,Owned: Owned outright,54,23,21,7,14,2,0,31,27,0,0,3,1
S01006701,Owned: Owned with a mortgage or loan or shared ownership,86,76,68,4,64,7,1,10,5,2,1,2,0
S01006701,Rented or living rent free: Total,181,115,99,27,72,4,12,66,30,0,12,18,6
S01006701,Rented or living rent free: Social rented,168,105,89,26,63,4,12,63,28,0,12,17,6
S01006701,Rented or living rent free: Private rented or living rent free,13,10,10,1,9,0,0,3,2,0,0,1,0
S01006702,All HRPs aged 16 and over,332,212,187,30,157,19,6,120,103,1,5,8,3
S01006702,Owned: Total,231,157,139,20,119,16,2,74,71,0,1,0,2
S01006702,Owned: Owned outright,107,44,39,10,29,5,0,63,60,0,1,0,2
S01006702,Owned: Owned with a mortgage or loan or shared ownership,124,113,100,10,90,11,2,11,11,0,0,0,0
S01006702,Rented or living rent free: Total,101,55,48,10,38,3,4,46,32,1,4,8,1
S01006702,Rented or living rent free: Social rented,90,47,40,7,33,3,4,43,29,1,4,8,1
S01006702,Rented or living rent free: Private rented or living rent free,11,8,8,3,5,0,0,3,3,0,0,0,0
S01006703,All HRPs aged 16 and over,301,199,177,29,148,14,8,102,69,2,12,17,2
S01006703,Owned: Total,152,118,108,15,93,10,0,34,31,0,1,2,0
S01006703,Owned: Owned outright,57,30,25,5,20,5,0,27,26,0,1,0,0
S01006703,Owned: Owned with a mortgage or loan or shared ownership,95,88,83,10,73,5,0,7,5,0,0,2,0
S01006703,Rented or living rent free: Total,149,81,69,14,55,4,8,68,38,2,11,15,2
S01006703,Rented or living rent free: Social rented,134,70,59,13,46,3,8,64,36,2,9,15,2
S01006703,Rented or living rent free: Private rented or living rent free,15,11,10,1,9,1,0,4,2,0,2,0,0
S01006704,All HRPs aged 16 and over,301,183,161,31,130,7,15,118,59,6,11,32,10
S01006704,Owned: Total,105,72,65,7,58,5,2,33,28,0,0,4,1
S01006704,Owned: Owned outright,42,16,12,4,8,3,1,26,23,0,0,2,1
S01006704,Owned: Owned with a mortgage or loan or shared ownership,63,56,53,3,50,2,1,7,5,0,0,2,0
S01006704,Rented or living rent free: Total,196,111,96,24,72,2,13,85,31,6,11,28,9
S01006704,Rented or living rent free: Social rented,186,105,91,22,69,2,12,81,31,4,11,27,8
S01006704,Rented or living rent free: Private rented or living rent free,10,6,5,2,3,0,1,4,0,2,0,1,1
S01006705,All HRPs aged 16 and over,364,204,181,30,151,19,4,160,126,0,4,24,6
S01006705,Owned: Total,184,121,111,12,99,10,0,63,57,0,0,5,1
S01006705,Owned: Owned outright,93,39,35,9,26,4,0,54,51,0,0,2,1
S01006705,Owned: Owned with a mortgage or loan or shared ownership,91,82,76,3,73,6,0,9,6,0,0,3,0
S01006705,Rented or living rent free: Total,180,83,70,18,52,9,4,97,69,0,4,19,5
S01006705,Rented or living rent free: Social rented,164,74,64,17,47,7,3,90,63,0,4,18,5
S01006705,Rented or living rent free: Private rented or living rent free,16,9,6,1,5,2,1,7,6,0,0,1,0
S01006706,All HRPs aged 16 and over,272,186,164,22,142,17,5,86,61,4,6,12,3
S01006706,Owned: Total,140,103,92,5,87,11,0,37,34,1,1,1,0
S01006706,Owned: Owned outright,48,18,16,1,15,2,0,30,29,0,0,1,0
S01006706,Owned: Owned with a mortgage or loan or shared ownership,92,85,76,4,72,9,0,7,5,1,1,0,0
S01006706,Rented or living rent free: Total,132,83,72,17,55,6,5,49,27,3,5,11,3
S01006706,Rented or living rent free: Social rented,117,73,66,17,49,3,4,44,24,2,4,11,3
S01006706,Rented or living rent free: Private rented or living rent free,15,10,6,0,6,3,1,5,3,1,1,0,0
S01006707,All HRPs aged 16 and over,311,213,179,27,152,19,15,98,53,3,16,20,6
S01006707,Owned: Total,122,92,81,5,76,9,2,30,28,0,1,1,0
S01006707,Owned: Owned outright,57,31,28,1,27,2,1,26,26,0,0,0,0
S01006707,Owned: Owned with a mortgage or loan or shared ownership,65,61,53,4,49,7,1,4,2,0,1,1,0
S01006707,Rented or living rent free: Total,189,121,98,22,76,10,13,68,25,3,15,19,6
S01006707,Rented or living rent free: Social rented,171,107,85,21,64,9,13,64,24,1,15,18,6
S01006707,Rented or living rent free: Private rented or living rent free,18,14,13,1,12,1,0,4,1,2,0,1,0
S01006708,All HRPs aged 16 and over,364,211,187,29,158,21,3,153,130,0,3,17,3
S01006708,Owned: Total,200,142,124,9,115,18,0,58,54,0,0,3,1
S01006708,Owned: Owned outright,84,35,31,5,26,4,0,49,48,0,0,1,0
S01006708,Owned: Owned with a mortgage or loan or shared ownership,116,107,93,4,89,14,0,9,6,0,0,2,1
S01006708,Rented or living rent free: Total,164,69,63,20,43,3,3,95,76,0,3,14,2
S01006708,Rented or living rent free: Social rented,144,57,51,19,32,3,3,87,71,0,1,13,2
S01006708,Rented or living rent free: Private rented or living rent free,20,12,12,1,11,0,0,8,5,0,2,1,0
S01006709,All HRPs aged 16 and over,376,239,202,45,157,26,11,137,87,2,21,24,3
S01006709,Owned: Total,168,122,104,16,88,17,1,46,43,0,1,2,0
S01006709,Owned: Owned outright,70,29,27,9,18,2,0,41,38,0,1,2,0
S01006709,Owned: Owned with a mortgage or loan or shared ownership,98,93,77,7,70,15,1,5,5,0,0,0,0
S01006709,Rented or living rent free: Total,208,117,98,29,69,9,10,91,44,2,20,22,3
S01006709,Rented or living rent free: Social rented,186,101,84,25,59,8,9,85,43,1,17,22,2
S01006709,Rented or living rent free: Private rented or living rent free,22,16,14,4,10,1,1,6,1,1,3,0,1
S01006710,All HRPs aged 16 and over,415,242,216,30,186,21,5,173,152,0,6,8,7
S01006710,Owned: Total,238,192,173,21,152,19,0,46,43,0,1,1,1
S01006710,Owned: Owned outright,97,54,47,8,39,7,0,43,41,0,0,1,1
S01006710,Owned: Owned with a mortgage or loan or shared ownership,141,138,126,13,113,12,0,3,2,0,1,0,0
S01006710,Rented or living rent free: Total,177,50,43,9,34,2,5,127,109,0,5,7,6
S01006710,Rented or living rent free: Social rented,166,43,37,9,28,1,5,123,105,0,5,7,6
S01006710,Rented or living rent free: Private rented or living rent free,11,7,6,0,6,1,0,4,4,0,0,0,0
S01006711,All HRPs aged 16 and over,511,289,242,34,208,35,12,222,166,1,6,46,3
S01006711,Owned: Total,244,195,170,19,151,24,1,49,44,0,1,3,1
S01006711,Owned: Owned outright,82,42,36,12,24,6,0,40,38,0,0,2,0
S01006711,Owned: Owned with a mortgage or loan or shared ownership,162,153,134,7,127,18,1,9,6,0,1,1,1
S01006711,Rented or living rent free: Total,267,94,72,15,57,11,11,173,122,1,5,43,2
S01006711,Rented or living rent free: Social rented,245,74,54,14,40,10,10,171,121,1,4,43,2
S01006711,Rented or living rent free: Private rented or living rent free,22,20,18,1,17,1,1,2,1,0,1,0,0
S01006712,All HRPs aged 16 and over,250,141,127,22,105,11,3,109,90,0,1,16,2
S01006712,Owned: Total,170,106,97,14,83,9,0,64,63,0,0,1,0
S01006712,Owned: Owned outright,76,25,23,7,16,2,0,51,51,0,0,0,0
S01006712,Owned: Owned with a mortgage or loan or shared ownership,94,81,74,7,67,7,0,13,12,0,0,1,0
S01006712,Rented or living rent free: Total,80,35,30,8,22,2,3,45,27,0,1,15,2
S01006712,Rented or living rent free: Social rented,70,28,24,7,17,1,3,42,24,0,1,15,2
S01006712,Rented or living rent free: Private rented or living rent free,10,7,6,1,5,1,0,3,3,0,0,0,0
S01006713,All HRPs aged 16 and over,420,264,239,34,205,20,5,156,114,3,11,18,10
S01006713,Owned: Total,215,156,142,13,129,14,0,59,55,0,0,2,2
S01006713,Owned: Owned outright,93,43,38,7,31,5,0,50,48,0,0,2,0
S01006713,Owned: Owned with a mortgage or loan or shared ownership,122,113,104,6,98,9,0,9,7,0,0,0,2
S01006713,Rented or living rent free: Total,205,108,97,21,76,6,5,97,59,3,11,16,8
S01006713,Rented or living rent free: Social rented,187,103,92,21,71,6,5,84,50,1,10,16,7
S01006713,Rented or living rent free: Private rented or living rent free,18,5,5,0,5,0,0,13,9,2,1,0,1
S01006714,All HRPs aged 16 and over,304,185,174,28,146,6,5,119,99,2,4,10,4
S01006714,Owned: Total,182,140,133,15,118,4,3,42,39,0,1,1,1
S01006714,Owned: Owned outright,83,48,45,9,36,1,2,35,33,0,1,1,0
S01006714,Owned: Owned with a mortgage or loan or shared ownership,99,92,88,6,82,3,1,7,6,0,0,0,1
S01006714,Rented or living rent free: Total,122,45,41,13,28,2,2,77,60,2,3,9,3
S01006714,Rented or living rent free: Social rented,104,32,29,9,20,1,2,72,55,2,3,9,3
S01006714,Rented or living rent free: Private rented or living rent free,18,13,12,4,8,1,0,5,5,0,0,0,0
S01006715,All HRPs aged 16 and over,218,146,124,22,102,14,8,72,33,2,17,18,2
S01006715,Owned: Total,87,68,59,9,50,9,0,19,17,1,1,0,0
S01006715,Owned: Owned outright,31,17,15,5,10,2,0,14,13,0,1,0,0
S01006715,Owned: Owned with a mortgage or loan or shared ownership,56,51,44,4,40,7,0,5,4,1,0,0,0
S01006715,Rented or living rent free: Total,131,78,65,13,52,5,8,53,16,1,16,18,2
S01006715,Rented or living rent free: Social rented,122,73,61,12,49,4,8,49,16,0,15,16,2
S01006715,Rented or living rent free: Private rented or living rent free,9,5,4,1,3,1,0,4,0,1,1,2,0
S01006716,All HRPs aged 16 and over,242,168,138,25,113,23,7,74,44,4,9,13,4
S01006716,Owned: Total,122,95,77,5,72,18,0,27,25,0,2,0,0
S01006716,Owned: Owned outright,45,22,17,3,14,5,0,23,23,0,0,0,0
S01006716,Owned: Owned with a mortgage or loan or shared ownership,77,73,60,2,58,13,0,4,2,0,2,0,0
S01006716,Rented or living rent free: Total,120,73,61,20,41,5,7,47,19,4,7,13,4
S01006716,Rented or living rent free: Social rented,113,69,57,20,37,5,7,44,16,4,7,13,4
S01006716,Rented or living rent free: Private rented or living rent free,7,4,4,0,4,0,0,3,3,0,0,0,0
S01006717,All HRPs aged 16 and over,445,269,238,43,195,19,12,176,149,1,6,16,4
S01006717,Owned: Total,223,170,152,20,132,15,3,53,50,0,0,3,0
S01006717,Owned: Owned outright,94,47,43,16,27,4,0,47,44,0,0,3,0
S01006717,Owned: Owned with a mortgage or loan or shared ownership,129,123,109,4,105,11,3,6,6,0,0,0,0
S01006717,Rented or living rent free: Total,222,99,86,23,63,4,9,123,99,1,6,13,4
S01006717,Rented or living rent free: Social rented,210,92,79,22,57,4,9,118,96,1,5,12,4
S01006717,Rented or living rent free: Private rented or living rent free,12,7,7,1,6,0,0,5,3,0,1,1,0
S01006718,All HRPs aged 16 and over,248,161,132,19,113,20,9,87,71,1,6,7,2
S01006718,Owned: Total,131,85,72,7,65,12,1,46,43,0,2,0,1
S01006718,Owned: Owned outright,58,23,18,3,15,5,0,35,33,0,2,0,0
S01006718,Owned: Owned with a mortgage or loan or shared ownership,73,62,54,4,50,7,1,11,10,0,0,0,1
S01006718,Rented or living rent free: Total,117,76,60,12,48,8,8,41,28,1,4,7,1
S01006718,Rented or living rent free: Social rented,101,67,52,12,40,7,8,34,22,0,4,7,1
S01006718,Rented or living rent free: Private rented or living rent free,16,9,8,0,8,1,0,7,6,1,0,0,0
S01006719,All HRPs aged 16 and over,350,251,216,33,183,26,9,99,71,0,5,20,3
S01006719,Owned: Total,204,157,136,11,125,20,1,47,42,0,0,4,1
S01006719,Owned: Owned outright,61,22,17,5,12,5,0,39,37,0,0,1,1
S01006719,Owned: Owned with a mortgage or loan or shared ownership,143,135,119,6,113,15,1,8,5,0,0,3,0
S01006719,Rented or living rent free: Total,146,94,80,22,58,6,8,52,29,0,5,16,2
S01006719,Rented or living rent free: Social rented,131,83,69,20,49,6,8,48,26,0,4,16,2
S01006719,Rented or living rent free: Private rented or living rent free,15,11,11,2,9,0,0,4,3,0,1,0,0
S01006720,All HRPs aged 16 and over,242,177,160,32,128,13,4,65,45,0,4,11,5
S01006720,Owned: Total,137,116,106,12,94,9,1,21,19,0,0,2,0
S01006720,Owned: Owned outright,40,26,24,4,20,1,1,14,14,0,0,0,0
S01006720,Owned: Owned with a mortgage or loan or shared ownership,97,90,82,8,74,8,0,7,5,0,0,2,0
S01006720,Rented or living rent free: Total,105,61,54,20,34,4,3,44,26,0,4,9,5
S01006720,Rented or living rent free: Social rented,91,49,42,19,23,4,3,42,25,0,3,9,5
S01006720,Rented or living rent free: Private rented or living rent free,14,12,12,1,11,0,0,2,1,0,1,0,0
S01006721,All HRPs aged 16 and over,386,254,216,22,194,22,16,132,89,4,13,22,4
S01006721,Owned: Total,207,158,143,10,133,12,3,49,46,0,2,1,0
S01006721,Owned: Owned outright,85,42,38,8,30,4,0,43,42,0,1,0,0
S01006721,Owned: Owned with a mortgage or loan or shared ownership,122,116,105,2,103,8,3,6,4,0,1,1,0
S01006721,Rented or living rent free: Total,179,96,73,12,61,10,13,83,43,4,11,21,4
S01006721,Rented or living rent free: Social rented,166,89,68,11,57,8,13,77,37,4,11,21,4
S01006721,Rented or living rent free: Private rented or living rent free,13,7,5,1,4,2,0,6,6,0,0,0,0
S01006722,All HRPs aged 16 and over,312,198,179,29,150,13,6,114,81,0,7,18,8
S01006722,Owned: Total,187,125,113,11,102,10,2,62,56,0,0,3,3
S01006722,Owned: Owned outright,76,29,27,6,21,1,1,47,46,0,0,1,0
S01006722,Owned: Owned with a mortgage or loan or shared ownership,111,96,86,5,81,9,1,15,10,0,0,2,3
S01006722,Rented or living rent free: Total,125,73,66,18,48,3,4,52,25,0,7,15,5
S01006722,Rented or living rent free: Social rented,112,62,56,16,40,2,4,50,24,0,6,15,5
S01006722,Rented or living rent free: Private rented or living rent free,13,11,10,2,8,1,0,2,1,0,1,0,0
S01006723,All HRPs aged 16 and over,283,187,164,19,145,18,5,96,69,1,3,21,2
S01006723,Owned: Total,172,122,109,9,100,12,1,50,46,0,0,3,1
S01006723,Owned: Owned outright,71,31,25,6,19,6,0,40,40,0,0,0,0
S01006723,Owned: Owned with a mortgage or loan or shared ownership,101,91,84,3,81,6,1,10,6,0,0,3,1
S01006723,Rented or living rent free: Total,111,65,55,10,45,6,4,46,23,1,3,18,1
S01006723,Rented or living rent free: Social rented,93,51,43,9,34,4,4,42,21,1,3,16,1
S01006723,Rented or living rent free: Private rented or living rent free,18,14,12,1,11,2,0,4,2,0,0,2,0
S01006724,All HRPs aged 16 and over,343,241,203,54,149,18,20,102,25,4,29,30,14
S01006724,Owned: Total,68,58,50,6,44,8,0,10,5,0,1,1,3
S01006724,Owned: Owned outright,15,11,7,1,6,4,0,4,3,0,0,0,1
S01006724,Owned: Owned with a mortgage or loan or shared ownership,53,47,43,5,38,4,0,6,2,0,1,1,2
S01006724,Rented or living rent free: Total,275,183,153,48,105,10,20,92,20,4,28,29,11
S01006724,Rented or living rent free: Social rented,263,173,145,44,101,10,18,90,20,4,27,29,10
S01006724,Rented or living rent free: Private rented or living rent free,12,10,8,4,4,0,2,2,0,0,1,0,1
S01006725,All HRPs aged 16 and over,265,183,160,26,134,13,10,82,45,0,10,16,11
S01006725,Owned: Total,131,103,91,11,80,10,2,28,24,0,0,2,2
S01006725,Owned: Owned outright,48,22,20,6,14,1,1,26,24,0,0,1,1
S01006725,Owned: Owned with a mortgage or loan or shared ownership,83,81,71,5,66,9,1,2,0,0,0,1,1
S01006725,Rented or living rent free: Total,134,80,69,15,54,3,8,54,21,0,10,14,9
S01006725,Rented or living rent free: Social rented,124,72,63,14,49,3,6,52,21,0,9,14,8
S01006725,Rented or living rent free: Private rented or living rent free,10,8,6,1,5,0,2,2,0,0,1,0,1
S01006726,All HRPs aged 16 and over,505,386,308,66,242,23,55,119,30,1,40,30,18
S01006726,Owned: Total,70,63,53,6,47,8,2,7,6,1,0,0,0
S01006726,Owned: Owned outright,19,15,12,4,8,2,1,4,4,0,0,0,0
S01006726,Owned: Owned with a mortgage or loan or shared ownership,51,48,41,2,39,6,1,3,2,1,0,0,0
S01006726,Rented or living rent free: Total,435,323,255,60,195,15,53,112,24,0,40,30,18
S01006726,Rented or living rent free: Social rented,411,302,236,55,181,14,52,109,23,0,40,29,17
S01006726,Rented or living rent free: Private rented or living rent free,24,21,19,5,14,1,1,3,1,0,0,1,1
S01006727,All HRPs aged 16 and over,395,253,212,51,161,14,27,142,61,3,23,47,8
S01006727,Owned: Total,60,46,43,6,37,3,0,14,9,1,0,4,0
S01006727,Owned: Owned outright,21,11,10,2,8,1,0,10,8,1,0,1,0
S01006727,Owned: Owned with a mortgage or loan or shared ownership,39,35,33,4,29,2,0,4,1,0,0,3,0
S01006727,Rented or living rent free: Total,335,207,169,45,124,11,27,128,52,2,23,43,8
S01006727,Rented or living rent free: Social rented,319,191,157,41,116,8,26,128,52,2,23,43,8
S01006727,Rented or living rent free: Private rented or living rent free,16,16,12,4,8,3,1,0,0,0,0,0,0
S01006728,All HRPs aged 16 and over,334,223,206,42,164,12,5,111,74,3,9,23,2
S01006728,Owned: Total,177,129,122,17,105,7,0,48,44,1,0,3,0
S01006728,Owned: Owned outright,70,30,28,11,17,2,0,40,38,0,0,2,0
S01006728,Owned: Owned with a mortgage or loan or shared ownership,107,99,94,6,88,5,0,8,6,1,0,1,0
S01006728,Rented or living rent free: Total,157,94,84,25,59,5,5,63,30,2,9,20,2
S01006728,Rented or living rent free: Social rented,148,88,78,24,54,5,5,60,29,2,7,20,2
S01006728,Rented or living rent free: Private rented or living rent free,9,6,6,1,5,0,0,3,1,0,2,0,0
S01006729,All HRPs aged 16 and over,349,215,184,42,142,9,22,134,74,2,22,26,10
S01006729,Owned: Total,100,79,70,8,62,5,4,21,18,0,0,2,1
S01006729,Owned: Owned outright,36,20,18,5,13,1,1,16,15,0,0,1,0
S01006729,Owned: Owned with a mortgage or loan or shared ownership,64,59,52,3,49,4,3,5,3,0,0,1,1
S01006729,Rented or living rent free: Total,249,136,114,34,80,4,18,113,56,2,22,24,9
S01006729,Rented or living rent free: Social rented,234,122,101,31,70,4,17,112,56,2,21,24,9
S01006729,Rented or living rent free: Private rented or living rent free,15,14,13,3,10,0,1,1,0,0,1,0,0
S01006730,All HRPs aged 16 and over,276,211,196,37,159,12,3,65,50,0,2,13,0
S01006730,Owned: Total,189,159,147,17,130,11,1,30,25,0,0,5,0
S01006730,Owned: Owned outright,64,39,38,11,27,0,1,25,23,0,0,2,0
S01006730,Owned: Owned with a mortgage or loan or shared ownership,125,120,109,6,103,11,0,5,2,0,0,3,0
S01006730,Rented or living rent free: Total,87,52,49,20,29,1,2,35,25,0,2,8,0
S01006730,Rented or living rent free: Social rented,81,46,44,16,28,0,2,35,25,0,2,8,0
S01006730,Rented or living rent free: Private rented or living rent free,6,6,5,4,1,1,0,0,0,0,0,0,0
S01006731,All HRPs aged 16 and over,257,174,149,25,124,15,10,83,44,2,3,26,8
S01006731,Owned: Total,129,103,92,11,81,9,2,26,22,0,0,2,2
S01006731,Owned: Owned outright,53,33,28,9,19,4,1,20,19,0,0,1,0
S01006731,Owned: Owned with a mortgage or loan or shared ownership,76,70,64,2,62,5,1,6,3,0,0,1,2
S01006731,Rented or living rent free: Total,128,71,57,14,43,6,8,57,22,2,3,24,6
S01006731,Rented or living rent free: Social rented,123,66,54,14,40,5,7,57,22,2,3,24,6
S01006731,Rented or living rent free: Private rented or living rent free,5,5,3,0,3,1,1,0,0,0,0,0,0
S01006732,All HRPs aged 16 and over,353,286,222,23,199,61,3,67,50,2,5,6,4
S01006732,Owned: Total,265,218,164,14,150,52,2,47,47,0,0,0,0
S01006732,Owned: Owned outright,113,72,48,9,39,24,0,41,41,0,0,0,0
S01006732,Owned: Owned with a mortgage or loan or shared ownership,152,146,116,5,111,28,2,6,6,0,0,0,0
S01006732,Rented or living rent free: Total,88,68,58,9,49,9,1,20,3,2,5,6,4
S01006732,Rented or living rent free: Social rented,26,14,9,3,6,4,1,12,1,0,2,5,4
S01006732,Rented or living rent free: Private rented or living rent free,62,54,49,6,43,5,0,8,2,2,3,1,0
S01006733,All HRPs aged 16 and over,309,271,220,20,200,50,1,38,33,2,1,2,0
S01006733,Owned: Total,283,251,206,17,189,44,1,32,30,0,1,1,0
S01006733,Owned: Owned outright,97,69,50,10,40,19,0,28,27,0,1,0,0
S01006733,Owned: Owned with a mortgage or loan or shared ownership,186,182,156,7,149,25,1,4,3,0,0,1,0
S01006733,Rented or living rent free: Total,26,20,14,3,11,6,0,6,3,2,0,1,0
S01006733,Rented or living rent free: Social rented,7,4,3,3,0,1,0,3,2,0,0,1,0
S01006733,Rented or living rent free: Private rented or living rent free,19,16,11,0,11,5,0,3,1,2,0,0,0
S01006734,All HRPs aged 16 and over,352,307,248,12,236,55,4,45,40,1,0,1,3
S01006734,Owned: Total,308,267,212,11,201,53,2,41,37,1,0,0,3
S01006734,Owned: Owned outright,88,52,34,6,28,18,0,36,34,0,0,0,2
S01006734,Owned: Owned with a mortgage or loan or shared ownership,220,215,178,5,173,35,2,5,3,1,0,0,1
S01006734,Rented or living rent free: Total,44,40,36,1,35,2,2,4,3,0,0,1,0
S01006734,Rented or living rent free: Social rented,5,3,1,1,0,0,2,2,1,0,0,1,0
S01006734,Rented or living rent free: Private rented or living rent free,39,37,35,0,35,2,0,2,2,0,0,0,0
S01006735,All HRPs aged 16 and over,245,160,139,10,129,19,2,85,82,0,1,1,1
S01006735,Owned: Total,229,146,125,10,115,19,2,83,82,0,1,0,0
S01006735,Owned: Owned outright,119,68,55,6,49,11,2,51,50,0,1,0,0
S01006735,Owned: Owned with a mortgage or loan or shared ownership,110,78,70,4,66,8,0,32,32,0,0,0,0
S01006735,Rented or living rent free: Total,16,14,14,0,14,0,0,2,0,0,0,1,1
S01006735,Rented or living rent free: Social rented,4,3,3,0,3,0,0,1,0,0,0,0,1
S01006735,Rented or living rent free: Private rented or living rent free,12,11,11,0,11,0,0,1,0,0,0,1,0
S01006736,All HRPs aged 16 and over,395,373,315,20,295,54,4,22,17,0,3,2,0
S01006736,Owned: Total,355,337,283,15,268,51,3,18,16,0,1,1,0
S01006736,Owned: Owned outright,80,63,48,4,44,15,0,17,16,0,0,1,0
S01006736,Owned: Owned with a mortgage or loan or shared ownership,275,274,235,11,224,36,3,1,0,0,1,0,0
S01006736,Rented or living rent free: Total,40,36,32,5,27,3,1,4,1,0,2,1,0
S01006736,Rented or living rent free: Social rented,15,12,9,3,6,2,1,3,1,0,1,1,0
S01006736,Rented or living rent free: Private rented or living rent free,25,24,23,2,21,1,0,1,0,0,1,0,0
S01006737,All HRPs aged 16 and over,265,192,154,16,138,35,3,73,67,0,4,1,1
S01006737,Owned: Total,219,157,127,13,114,28,2,62,58,0,2,1,1
S01006737,Owned: Owned outright,113,56,45,10,35,10,1,57,54,0,1,1,1
S01006737,Owned: Owned with a mortgage or loan or shared ownership,106,101,82,3,79,18,1,5,4,0,1,0,0
S01006737,Rented or living rent free: Total,46,35,27,3,24,7,1,11,9,0,2,0,0
S01006737,Rented or living rent free: Social rented,16,10,6,2,4,4,0,6,5,0,1,0,0
S01006737,Rented or living rent free: Private rented or living rent free,30,25,21,1,20,3,1,5,4,0,1,0,0
S01006738,All HRPs aged 16 and over,453,396,359,35,324,28,9,57,39,4,2,6,6
S01006738,Owned: Total,269,237,218,16,202,18,1,32,28,1,0,0,3
S01006738,Owned: Owned outright,80,52,44,6,38,7,1,28,27,0,0,0,1
S01006738,Owned: Owned with a mortgage or loan or shared ownership,189,185,174,10,164,11,0,4,1,1,0,0,2
S01006738,Rented or living rent free: Total,184,159,141,19,122,10,8,25,11,3,2,6,3
S01006738,Rented or living rent free: Social rented,88,73,65,14,51,2,6,15,4,2,2,5,2
S01006738,Rented or living rent free: Private rented or living rent free,96,86,76,5,71,8,2,10,7,1,0,1,1
S01006739,All HRPs aged 16 and over,309,252,220,17,203,24,8,57,42,3,3,6,3
S01006739,Owned: Total,226,187,162,11,151,23,2,39,36,0,2,1,0
S01006739,Owned: Owned outright,67,31,24,1,23,6,1,36,35,0,1,0,0
S01006739,Owned: Owned with a mortgage or loan or shared ownership,159,156,138,10,128,17,1,3,1,0,1,1,0
S01006739,Rented or living rent free: Total,83,65,58,6,52,1,6,18,6,3,1,5,3
S01006739,Rented or living rent free: Social rented,8,6,4,1,3,1,1,2,1,0,0,1,0
S01006739,Rented or living rent free: Private rented or living rent free,75,59,54,5,49,0,5,16,5,3,1,4,3
S01006740,All HRPs aged 16 and over,335,220,201,25,176,15,4,115,94,1,6,9,5
S01006740,Owned: Total,228,161,148,12,136,13,0,67,64,0,0,1,2
S01006740,Owned: Owned outright,99,39,34,8,26,5,0,60,58,0,0,0,2
S01006740,Owned: Owned with a mortgage or loan or shared ownership,129,122,114,4,110,8,0,7,6,0,0,1,0
S01006740,Rented or living rent free: Total,107,59,53,13,40,2,4,48,30,1,6,8,3
S01006740,Rented or living rent free: Social rented,91,47,43,13,30,1,3,44,26,1,6,8,3
S01006740,Rented or living rent free: Private rented or living rent free,16,12,10,0,10,1,1,4,4,0,0,0,0
S01006741,All HRPs aged 16 and over,342,181,163,32,131,16,2,161,141,0,1,16,3
S01006741,Owned: Total,216,129,117,20,97,12,0,87,80,0,0,5,2
S01006741,Owned: Owned outright,124,49,44,18,26,5,0,75,69,0,0,4,2
S01006741,Owned: Owned with a mortgage or loan or shared ownership,92,80,73,2,71,7,0,12,11,0,0,1,0
S01006741,Rented or living rent free: Total,126,52,46,12,34,4,2,74,61,0,1,11,1
S01006741,Rented or living rent free: Social rented,108,40,36,12,24,2,2,68,56,0,1,10,1
S01006741,Rented or living rent free: Private rented or living rent free,18,12,10,0,10,2,0,6,5,0,0,1,0
S01006742,All HRPs aged 16 and over,233,124,108,16,92,12,4,109,100,1,2,4,2
S01006742,Owned: Total,142,88,77,6,71,9,2,54,53,1,0,0,0
S01006742,Owned: Owned outright,64,15,13,1,12,1,1,49,48,1,0,0,0
S01006742,Owned: Owned with a mortgage or loan or shared ownership,78,73,64,5,59,8,1,5,5,0,0,0,0
S01006742,Rented or living rent free: Total,91,36,31,10,21,3,2,55,47,0,2,4,2
S01006742,Rented or living rent free: Social rented,79,27,22,10,12,3,2,52,44,0,2,4,2
S01006742,Rented or living rent free: Private rented or living rent free,12,9,9,0,9,0,0,3,3,0,0,0,0
S01006743,All HRPs aged 16 and over,271,184,165,13,152,17,2,87,77,4,4,2,0
S01006743,Owned: Total,209,149,134,10,124,14,1,60,58,1,1,0,0
S01006743,Owned: Owned outright,83,28,24,5,19,3,1,55,55,0,0,0,0
S01006743,Owned: Owned with a mortgage or loan or shared ownership,126,121,110,5,105,11,0,5,3,1,1,0,0
S01006743,Rented or living rent free: Total,62,35,31,3,28,3,1,27,19,3,3,2,0
S01006743,Rented or living rent free: Social rented,48,23,23,2,21,0,0,25,17,3,3,2,0
S01006743,Rented or living rent free: Private rented or living rent free,14,12,8,1,7,3,1,2,2,0,0,0,0
S01006744,All HRPs aged 16 and over,302,239,208,24,184,25,6,63,53,1,1,6,2
S01006744,Owned: Total,220,179,160,16,144,17,2,41,39,1,0,1,0
S01006744,Owned: Owned outright,84,46,42,11,31,4,0,38,36,1,0,1,0
S01006744,Owned: Owned with a mortgage or loan or shared ownership,136,133,118,5,113,13,2,3,3,0,0,0,0
S01006744,Rented or living rent free: Total,82,60,48,8,40,8,4,22,14,0,1,5,2
S01006744,Rented or living rent free: Social rented,55,37,30,5,25,4,3,18,11,0,1,4,2
S01006744,Rented or living rent free: Private rented or living rent free,27,23,18,3,15,4,1,4,3,0,0,1,0
S01006745,All HRPs aged 16 and over,409,234,209,33,176,20,5,175,143,1,8,20,3
S01006745,Owned: Total,213,143,128,13,115,13,2,70,66,1,0,3,0
S01006745,Owned: Owned outright,99,38,35,9,26,2,1,61,58,1,0,2,0
S01006745,Owned: Owned with a mortgage or loan or shared ownership,114,105,93,4,89,11,1,9,8,0,0,1,0
S01006745,Rented or living rent free: Total,196,91,81,20,61,7,3,105,77,0,8,17,3
S01006745,Rented or living rent free: Social rented,165,67,59,16,43,5,3,98,70,0,8,17,3
S01006745,Rented or living rent free: Private rented or living rent free,31,24,22,4,18,2,0,7,7,0,0,0,0
S01006746,All HRPs aged 16 and over,350,230,211,29,182,16,3,120,105,1,2,11,1
S01006746,Owned: Total,219,148,135,14,121,13,0,71,70,1,0,0,0
S01006746,Owned: Owned outright,105,43,37,10,27,6,0,62,61,1,0,0,0
S01006746,Owned: Owned with a mortgage or loan or shared ownership,114,105,98,4,94,7,0,9,9,0,0,0,0
S01006746,Rented or living rent free: Total,131,82,76,15,61,3,3,49,35,0,2,11,1
S01006746,Rented or living rent free: Social rented,112,68,62,15,47,3,3,44,32,0,2,10,0
S01006746,Rented or living rent free: Private rented or living rent free,19,14,14,0,14,0,0,5,3,0,0,1,1
S01006747,All HRPs aged 16 and over,368,226,200,37,163,22,4,142,135,2,2,2,1
S01006747,Owned: Total,326,192,169,29,140,20,3,134,132,0,2,0,0
S01006747,Owned: Owned outright,219,86,77,25,52,7,2,133,132,0,1,0,0
S01006747,Owned: Owned with a mortgage or loan or shared ownership,107,106,92,4,88,13,1,1,0,0,1,0,0
S01006747,Rented or living rent free: Total,42,34,31,8,23,2,1,8,3,2,0,2,1
S01006747,Rented or living rent free: Social rented,8,8,8,3,5,0,0,0,0,0,0,0,0
S01006747,Rented or living rent free: Private rented or living rent free,34,26,23,5,18,2,1,8,3,2,0,2,1
S01006748,All HRPs aged 16 and over,408,263,224,17,207,36,3,145,127,0,5,11,2
S01006748,Owned: Total,310,201,169,14,155,31,1,109,103,0,2,2,2
S01006748,Owned: Owned outright,164,64,55,11,44,9,0,100,96,0,2,1,1
S01006748,Owned: Owned with a mortgage or loan or shared ownership,146,137,114,3,111,22,1,9,7,0,0,1,1
S01006748,Rented or living rent free: Total,98,62,55,3,52,5,2,36,24,0,3,9,0
S01006748,Rented or living rent free: Social rented,50,20,17,3,14,2,1,30,18,0,3,9,0
S01006748,Rented or living rent free: Private rented or living rent free,48,42,38,0,38,3,1,6,6,0,0,0,0
S01006749,All HRPs aged 16 and over,419,289,265,26,239,21,3,130,109,1,4,11,5
S01006749,Owned: Total,291,222,203,16,187,18,1,69,59,1,3,3,3
S01006749,Owned: Owned outright,122,66,59,13,46,6,1,56,50,0,2,3,1
S01006749,Owned: Owned with a mortgage or loan or shared ownership,169,156,144,3,141,12,0,13,9,1,1,0,2
S01006749,Rented or living rent free: Total,128,67,62,10,52,3,2,61,50,0,1,8,2
S01006749,Rented or living rent free: Social rented,95,39,35,10,25,2,2,56,46,0,1,7,2
S01006749,Rented or living rent free: Private rented or living rent free,33,28,27,0,27,1,0,5,4,0,0,1,0
S01006750,All HRPs aged 16 and over,292,190,175,24,151,14,1,102,87,3,2,7,3
S01006750,Owned: Total,216,155,144,17,127,11,0,61,56,1,1,1,2
S01006750,Owned: Owned outright,102,51,47,11,36,4,0,51,48,1,0,1,1
S01006750,Owned: Owned with a mortgage or loan or shared ownership,114,104,97,6,91,7,0,10,8,0,1,0,1
S01006750,Rented or living rent free: Total,76,35,31,7,24,3,1,41,31,2,1,6,1
S01006750,Rented or living rent free: Social rented,62,25,23,7,16,1,1,37,29,1,1,6,0
S01006750,Rented or living rent free: Private rented or living rent free,14,10,8,0,8,2,0,4,2,1,0,0,1
S01006751,All HRPs aged 16 and over,241,133,122,20,102,11,0,108,91,0,3,13,1
S01006751,Owned: Total,131,96,86,10,76,10,0,35,31,0,2,1,1
S01006751,Owned: Owned outright,64,32,27,6,21,5,0,32,28,0,2,1,1
S01006751,Owned: Owned with a mortgage or loan or shared ownership,67,64,59,4,55,5,0,3,3,0,0,0,0
S01006751,Rented or living rent free: Total,110,37,36,10,26,1,0,73,60,0,1,12,0
S01006751,Rented or living rent free: Social rented,94,24,23,9,14,1,0,70,58,0,0,12,0
S01006751,Rented or living rent free: Private rented or living rent free,16,13,13,1,12,0,0,3,2,0,1,0,0
S01006752,All HRPs aged 16 and over,339,213,200,40,160,8,5,126,105,0,5,14,2
S01006752,Owned: Total,232,161,155,32,123,6,0,71,65,0,0,5,1
S01006752,Owned: Owned outright,119,56,55,18,37,1,0,63,59,0,0,3,1
S01006752,Owned: Owned with a mortgage or loan or shared ownership,113,105,100,14,86,5,0,8,6,0,0,2,0
S01006752,Rented or living rent free: Total,107,52,45,8,37,2,5,55,40,0,5,9,1
S01006752,Rented or living rent free: Social rented,93,40,36,6,30,1,3,53,39,0,4,9,1
S01006752,Rented or living rent free: Private rented or living rent free,14,12,9,2,7,1,2,2,1,0,1,0,0
S01006753,All HRPs aged 16 and over,410,275,237,30,207,37,1,135,128,1,1,5,0
S01006753,Owned: Total,337,225,195,23,172,30,0,112,112,0,0,0,0
S01006753,Owned: Owned outright,194,89,71,18,53,18,0,105,105,0,0,0,0
S01006753,Owned: Owned with a mortgage or loan or shared ownership,143,136,124,5,119,12,0,7,7,0,0,0,0
S01006753,Rented or living rent free: Total,73,50,42,7,35,7,1,23,16,1,1,5,0
S01006753,Rented or living rent free: Social rented,40,20,18,6,12,1,1,20,13,1,1,5,0
S01006753,Rented or living rent free: Private rented or living rent free,33,30,24,1,23,6,0,3,3,0,0,0,0
S01006754,All HRPs aged 16 and over,400,270,240,26,214,26,4,130,124,0,1,5,0
S01006754,Owned: Total,361,242,214,25,189,25,3,119,116,0,1,2,0
S01006754,Owned: Owned outright,207,96,80,20,60,14,2,111,109,0,1,1,0
S01006754,Owned: Owned with a mortgage or loan or shared ownership,154,146,134,5,129,11,1,8,7,0,0,1,0
S01006754,Rented or living rent free: Total,39,28,26,1,25,1,1,11,8,0,0,3,0
S01006754,Rented or living rent free: Social rented,13,9,9,1,8,0,0,4,2,0,0,2,0
S01006754,Rented or living rent free: Private rented or living rent free,26,19,17,0,17,1,1,7,6,0,0,1,0
S01006755,All HRPs aged 16 and over,289,241,203,13,190,35,3,48,37,2,4,4,1
S01006755,Owned: Total,218,183,155,10,145,27,1,35,31,0,3,1,0
S01006755,Owned: Owned outright,80,48,35,7,28,12,1,32,30,0,2,0,0
S01006755,Owned: Owned with a mortgage or loan or shared ownership,138,135,120,3,117,15,0,3,1,0,1,1,0
S01006755,Rented or living rent free: Total,71,58,48,3,45,8,2,13,6,2,1,3,1
S01006755,Rented or living rent free: Social rented,15,8,7,1,6,0,1,7,2,0,1,3,1
S01006755,Rented or living rent free: Private rented or living rent free,56,50,41,2,39,8,1,6,4,2,0,0,0
S01006756,All HRPs aged 16 and over,286,265,233,7,226,29,3,21,7,3,7,2,2
S01006756,Owned: Total,207,196,169,3,166,26,1,11,6,0,4,0,1
S01006756,Owned: Owned outright,29,23,18,2,16,5,0,6,6,0,0,0,0
S01006756,Owned: Owned with a mortgage or loan or shared ownership,178,173,151,1,150,21,1,5,0,0,4,0,1
S01006756,Rented or living rent free: Total,79,69,64,4,60,3,2,10,1,3,3,2,1
S01006756,Rented or living rent free: Social rented,5,4,3,0,3,0,1,1,1,0,0,0,0
S01006756,Rented or living rent free: Private rented or living rent free,74,65,61,4,57,3,1,9,0,3,3,2,1
S01006757,All HRPs aged 16 and over,343,288,258,18,240,23,7,55,52,0,0,1,2
S01006757,Owned: Total,306,254,229,17,212,22,3,52,49,0,0,1,2
S01006757,Owned: Owned outright,102,59,54,12,42,5,0,43,43,0,0,0,0
S01006757,Owned: Owned with a mortgage or loan or shared ownership,204,195,175,5,170,17,3,9,6,0,0,1,2
S01006757,Rented or living rent free: Total,37,34,29,1,28,1,4,3,3,0,0,0,0
S01006757,Rented or living rent free: Social rented,5,2,1,1,0,0,1,3,3,0,0,0,0
S01006757,Rented or living rent free: Private rented or living rent free,32,32,28,0,28,1,3,0,0,0,0,0,0
S01006758,All HRPs aged 16 and over,318,270,241,17,224,26,3,48,45,1,0,1,1
S01006758,Owned: Total,296,250,223,15,208,24,3,46,44,0,0,1,1
S01006758,Owned: Owned outright,121,79,69,7,62,9,1,42,40,0,0,1,1
S01006758,Owned: Owned with a mortgage or loan or shared ownership,175,171,154,8,146,15,2,4,4,0,0,0,0
S01006758,Rented or living rent free: Total,22,20,18,2,16,2,0,2,1,1,0,0,0
S01006758,Rented or living rent free: Social rented,1,0,0,0,0,0,0,1,1,0,0,0,0
S01006758,Rented or living rent free: Private rented or living rent free,21,20,18,2,16,2,0,1,0,1,0,0,0
S01006759,All HRPs aged 16 and over,251,196,172,17,155,24,0,55,51,2,0,2,0
S01006759,Owned: Total,226,178,157,16,141,21,0,48,47,0,0,1,0
S01006759,Owned: Owned outright,107,61,55,8,47,6,0,46,45,0,0,1,0
S01006759,Owned: Owned with a mortgage or loan or shared ownership,119,117,102,8,94,15,0,2,2,0,0,0,0
S01006759,Rented or living rent free: Total,25,18,15,1,14,3,0,7,4,2,0,1,0
S01006759,Rented or living rent free: Social rented,6,4,4,0,4,0,0,2,1,0,0,1,0
S01006759,Rented or living rent free: Private rented or living rent free,19,14,11,1,10,3,0,5,3,2,0,0,0
S01006760,All HRPs aged 16 and over,235,200,185,14,171,14,1,35,31,0,2,0,2
S01006760,Owned: Total,210,177,164,12,152,13,0,33,31,0,0,0,2
S01006760,Owned: Owned outright,70,39,36,4,32,3,0,31,30,0,0,0,1
S01006760,Owned: Owned with a mortgage or loan or shared ownership,140,138,128,8,120,10,0,2,1,0,0,0,1
S01006760,Rented or living rent free: Total,25,23,21,2,19,1,1,2,0,0,2,0,0
S01006760,Rented or living rent free: Social rented,1,1,0,0,0,0,1,0,0,0,0,0,0
S01006760,Rented or living rent free: Private rented or living rent free,24,22,21,2,19,1,0,2,0,0,2,0,0
S01006761,All HRPs aged 16 and over,334,255,217,22,195,34,4,79,74,0,0,1,4
S01006761,Owned: Total,313,240,202,21,181,34,4,73,69,0,0,1,3
S01006761,Owned: Owned outright,143,75,64,16,48,10,1,68,67,0,0,0,1
S01006761,Owned: Owned with a mortgage or loan or shared ownership,170,165,138,5,133,24,3,5,2,0,0,1,2
S01006761,Rented or living rent free: Total,21,15,15,1,14,0,0,6,5,0,0,0,1
S01006761,Rented or living rent free: Social rented,2,1,1,1,0,0,0,1,0,0,0,0,1
S01006761,Rented or living rent free: Private rented or living rent free,19,14,14,0,14,0,0,5,5,0,0,0,0
S01006762,All HRPs aged 16 and over,416,224,183,20,163,39,2,192,181,0,1,9,1
S01006762,Owned: Total,290,178,151,18,133,26,1,112,108,0,1,3,0
S01006762,Owned: Owned outright,189,87,75,15,60,11,1,102,101,0,0,1,0
S01006762,Owned: Owned with a mortgage or loan or shared ownership,101,91,76,3,73,15,0,10,7,0,1,2,0
S01006762,Rented or living rent free: Total,126,46,32,2,30,13,1,80,73,0,0,6,1
S01006762,Rented or living rent free: Social rented,77,6,5,1,4,1,0,71,65,0,0,6,0
S01006762,Rented or living rent free: Private rented or living rent free,49,40,27,1,26,12,1,9,8,0,0,0,1
S01006763,All HRPs aged 16 and over,334,312,276,18,258,34,2,22,13,3,1,2,3
S01006763,Owned: Total,301,285,251,14,237,32,2,16,12,1,0,0,3
S01006763,Owned: Owned outright,54,40,30,5,25,10,0,14,11,0,0,0,3
S01006763,Owned: Owned with a mortgage or loan or shared ownership,247,245,221,9,212,22,2,2,1,1,0,0,0
S01006763,Rented or living rent free: Total,33,27,25,4,21,2,0,6,1,2,1,2,0
S01006763,Rented or living rent free: Social rented,2,0,0,0,0,0,0,2,0,1,0,1,0
S01006763,Rented or living rent free: Private rented or living rent free,31,27,25,4,21,2,0,4,1,1,1,1,0
S01006764,All HRPs aged 16 and over,345,309,288,21,267,18,3,36,28,1,2,2,3
S01006764,Owned: Total,311,281,262,19,243,17,2,30,26,1,1,1,1
S01006764,Owned: Owned outright,91,68,65,13,52,2,1,23,22,0,0,0,1
S01006764,Owned: Owned with a mortgage or loan or shared ownership,220,213,197,6,191,15,1,7,4,1,1,1,0
S01006764,Rented or living rent free: Total,34,28,26,2,24,1,1,6,2,0,1,1,2
S01006764,Rented or living rent free: Social rented,3,1,0,0,0,1,0,2,1,0,0,1,0
S01006764,Rented or living rent free: Private rented or living rent free,31,27,26,2,24,0,1,4,1,0,1,0,2
S01006765,All HRPs aged 16 and over,273,241,221,11,210,19,1,32,24,2,2,3,1
S01006765,Owned: Total,248,220,202,10,192,17,1,28,23,0,1,3,1
S01006765,Owned: Owned outright,74,53,46,5,41,7,0,21,19,0,1,1,0
S01006765,Owned: Owned with a mortgage or loan or shared ownership,174,167,156,5,151,10,1,7,4,0,0,2,1
S01006765,Rented or living rent free: Total,25,21,19,1,18,2,0,4,1,2,1,0,0
S01006765,Rented or living rent free: Social rented,2,2,2,1,1,0,0,0,0,0,0,0,0
S01006765,Rented or living rent free: Private rented or living rent free,23,19,17,0,17,2,0,4,1,2,1,0,0
S01006766,All HRPs aged 16 and over,240,205,179,19,160,25,1,35,23,2,6,1,3
S01006766,Owned: Total,225,197,174,17,157,23,0,28,21,1,4,1,1
S01006766,Owned: Owned outright,83,63,51,8,43,12,0,20,17,0,2,0,1
S01006766,Owned: Owned with a mortgage or loan or shared ownership,142,134,123,9,114,11,0,8,4,1,2,1,0
S01006766,Rented or living rent free: Total,15,8,5,2,3,2,1,7,2,1,2,0,2
S01006766,Rented or living rent free: Social rented,4,3,2,0,2,0,1,1,0,0,1,0,0
S01006766,Rented or living rent free: Private rented or living rent free,11,5,3,2,1,2,0,6,2,1,1,0,2
S01006767,All HRPs aged 16 and over,283,213,185,25,160,24,4,70,64,0,3,2,1
S01006767,Owned: Total,227,176,154,19,135,19,3,51,49,0,1,1,0
S01006767,Owned: Owned outright,100,54,43,8,35,10,1,46,44,0,1,1,0
S01006767,Owned: Owned with a mortgage or loan or shared ownership,127,122,111,11,100,9,2,5,5,0,0,0,0
S01006767,Rented or living rent free: Total,56,37,31,6,25,5,1,19,15,0,2,1,1
S01006767,Rented or living rent free: Social rented,35,19,16,6,10,2,1,16,12,0,2,1,1
S01006767,Rented or living rent free: Private rented or living rent free,21,18,15,0,15,3,0,3,3,0,0,0,0
S01006768,All HRPs aged 16 and over,212,183,159,12,147,24,0,29,29,0,0,0,0
S01006768,Owned: Total,209,180,156,12,144,24,0,29,29,0,0,0,0
S01006768,Owned: Owned outright,90,64,55,8,47,9,0,26,26,0,0,0,0
S01006768,Owned: Owned with a mortgage or loan or shared ownership,119,116,101,4,97,15,0,3,3,0,0,0,0
S01006768,Rented or living rent free: Total,3,3,3,0,3,0,0,0,0,0,0,0,0
S01006768,Rented or living rent free: Social rented,1,1,1,0,1,0,0,0,0,0,0,0,0
S01006768,Rented or living rent free: Private rented or living rent free,2,2,2,0,2,0,0,0,0,0,0,0,0
S01006769,All HRPs aged 16 and over,392,299,266,25,241,33,0,93,78,0,1,10,4
S01006769,Owned: Total,332,268,239,18,221,29,0,64,62,0,0,1,1
S01006769,Owned: Owned outright,129,71,64,12,52,7,0,58,56,0,0,1,1
S01006769,Owned: Owned with a mortgage or loan or shared ownership,203,197,175,6,169,22,0,6,6,0,0,0,0
S01006769,Rented or living rent free: Total,60,31,27,7,20,4,0,29,16,0,1,9,3
S01006769,Rented or living rent free: Social rented,41,19,16,6,10,3,0,22,15,0,0,6,1
S01006769,Rented or living rent free: Private rented or living rent free,19,12,11,1,10,1,0,7,1,0,1,3,2
S01006770,All HRPs aged 16 and over,273,209,183,21,162,24,2,64,62,0,2,0,0
S01006770,Owned: Total,263,202,176,20,156,24,2,61,60,0,1,0,0
S01006770,Owned: Owned outright,141,85,73,15,58,10,2,56,55,0,1,0,0
S01006770,Owned: Owned with a mortgage or loan or shared ownership,122,117,103,5,98,14,0,5,5,0,0,0,0
S01006770,Rented or living rent free: Total,10,7,7,1,6,0,0,3,2,0,1,0,0
S01006770,Rented or living rent free: Social rented,3,0,0,0,0,0,0,3,2,0,1,0,0
S01006770,Rented or living rent free: Private rented or living rent free,7,7,7,1,6,0,0,0,0,0,0,0,0
S01006771,All HRPs aged 16 and over,150,132,111,9,102,20,1,18,14,0,2,1,1
S01006771,Owned: Total,142,125,105,9,96,20,0,17,14,0,1,1,1
S01006771,Owned: Owned outright,59,45,36,7,29,9,0,14,13,0,0,1,0
S01006771,Owned: Owned with a mortgage or loan or shared ownership,83,80,69,2,67,11,0,3,1,0,1,0,1
S01006771,Rented or living rent free: Total,8,7,6,0,6,0,1,1,0,0,1,0,0
S01006771,Rented or living rent free: Social rented,1,0,0,0,0,0,0,1,0,0,1,0,0
S01006771,Rented or living rent free: Private rented or living rent free,7,7,6,0,6,0,1,0,0,0,0,0,0
S01006772,All HRPs aged 16 and over,375,306,265,23,242,39,2,69,68,0,0,1,0
S01006772,Owned: Total,352,285,248,22,226,35,2,67,66,0,0,1,0
S01006772,Owned: Owned outright,164,99,85,13,72,12,2,65,65,0,0,0,0
S01006772,Owned: Owned with a mortgage or loan or shared ownership,188,186,163,9,154,23,0,2,1,0,0,1,0
S01006772,Rented or living rent free: Total,23,21,17,1,16,4,0,2,2,0,0,0,0
S01006772,Rented or living rent free: Social rented,3,3,3,0,3,0,0,0,0,0,0,0,0
S01006772,Rented or living rent free: Private rented or living rent free,20,18,14,1,13,4,0,2,2,0,0,0,0
S01006773,All HRPs aged 16 and over,255,207,173,19,154,34,0,48,47,1,0,0,0
S01006773,Owned: Total,240,196,164,19,145,32,0,44,44,0,0,0,0
S01006773,Owned: Owned outright,104,65,56,13,43,9,0,39,39,0,0,0,0
S01006773,Owned: Owned with a mortgage or loan or shared ownership,136,131,108,6,102,23,0,5,5,0,0,0,0
S01006773,Rented or living rent free: Total,15,11,9,0,9,2,0,4,3,1,0,0,0
S01006773,Rented or living rent free: Social rented,5,3,1,0,1,2,0,2,1,1,0,0,0
S01006773,Rented or living rent free: Private rented or living rent free,10,8,8,0,8,0,0,2,2,0,0,0,0
S01006774,All HRPs aged 16 and over,221,196,169,17,152,26,1,25,25,0,0,0,0
S01006774,Owned: Total,212,188,162,16,146,25,1,24,24,0,0,0,0
S01006774,Owned: Owned outright,103,80,72,11,61,8,0,23,23,0,0,0,0
S01006774,Owned: Owned with a mortgage or loan or shared ownership,109,108,90,5,85,17,1,1,1,0,0,0,0
S01006774,Rented or living rent free: Total,9,8,7,1,6,1,0,1,1,0,0,0,0
S01006774,Rented or living rent free: Social rented,2,2,2,1,1,0,0,0,0,0,0,0,0
S01006774,Rented or living rent free: Private rented or living rent free,7,6,5,0,5,1,0,1,1,0,0,0,0
S01006775,All HRPs aged 16 and over,319,231,205,28,177,22,4,88,71,3,3,7,4
S01006775,Owned: Total,209,165,148,13,135,17,0,44,40,0,0,2,2
S01006775,Owned: Owned outright,64,32,30,8,22,2,0,32,30,0,0,1,1
S01006775,Owned: Owned with a mortgage or loan or shared ownership,145,133,118,5,113,15,0,12,10,0,0,1,1
S01006775,Rented or living rent free: Total,110,66,57,15,42,5,4,44,31,3,3,5,2
S01006775,Rented or living rent free: Social rented,80,44,38,14,24,2,4,36,27,0,3,5,1
S01006775,Rented or living rent free: Private rented or living rent free,30,22,19,1,18,3,0,8,4,3,0,0,1
S01006776,All HRPs aged 16 and over,271,150,139,22,117,9,2,121,114,0,1,6,0
S01006776,Owned: Total,136,98,95,12,83,3,0,38,38,0,0,0,0
S01006776,Owned: Owned outright,63,33,30,9,21,3,0,30,30,0,0,0,0
S01006776,Owned: Owned with a mortgage or loan or shared ownership,73,65,65,3,62,0,0,8,8,0,0,0,0
S01006776,Rented or living rent free: Total,135,52,44,10,34,6,2,83,76,0,1,6,0
S01006776,Rented or living rent free: Social rented,117,36,32,8,24,3,1,81,75,0,1,5,0
S01006776,Rented or living rent free: Private rented or living rent free,18,16,12,2,10,3,1,2,1,0,0,1,0
S01006777,All HRPs aged 16 and over,262,198,172,20,152,25,1,64,61,0,1,1,1
S01006777,Owned: Total,251,188,162,19,143,25,1,63,61,0,1,0,1
S01006777,Owned: Owned outright,150,88,73,15,58,14,1,62,60,0,1,0,1
S01006777,Owned: Owned with a mortgage or loan or shared ownership,101,100,89,4,85,11,0,1,1,0,0,0,0
S01006777,Rented or living rent free: Total,11,10,10,1,9,0,0,1,0,0,0,1,0
S01006777,Rented or living rent free: Social rented,3,2,2,0,2,0,0,1,0,0,0,1,0
S01006777,Rented or living rent free: Private rented or living rent free,8,8,8,1,7,0,0,0,0,0,0,0,0
S01006778,All HRPs aged 16 and over,287,201,181,30,151,17,3,86,81,0,2,3,0
S01006778,Owned: Total,252,188,170,29,141,16,2,64,64,0,0,0,0
S01006778,Owned: Owned outright,127,72,64,24,40,7,1,55,55,0,0,0,0
S01006778,Owned: Owned with a mortgage or loan or shared ownership,125,116,106,5,101,9,1,9,9,0,0,0,0
S01006778,Rented or living rent free: Total,35,13,11,1,10,1,1,22,17,0,2,3,0
S01006778,Rented or living rent free: Social rented,25,6,5,1,4,1,0,19,14,0,2,3,0
S01006778,Rented or living rent free: Private rented or living rent free,10,7,6,0,6,0,1,3,3,0,0,0,0
S01006779,All HRPs aged 16 and over,293,173,153,34,119,15,5,120,108,2,2,6,2
S01006779,Owned: Total,166,119,106,16,90,11,2,47,45,0,0,1,1
S01006779,Owned: Owned outright,76,42,39,11,28,3,0,34,32,0,0,1,1
S01006779,Owned: Owned with a mortgage or loan or shared ownership,90,77,67,5,62,8,2,13,13,0,0,0,0
S01006779,Rented or living rent free: Total,127,54,47,18,29,4,3,73,63,2,2,5,1
S01006779,Rented or living rent free: Social rented,111,42,37,15,22,3,2,69,60,1,2,5,1
S01006779,Rented or living rent free: Private rented or living rent free,16,12,10,3,7,1,1,4,3,1,0,0,0
S01006780,All HRPs aged 16 and over,254,173,142,20,122,26,5,81,76,1,0,4,0
S01006780,Owned: Total,199,146,120,16,104,22,4,53,52,1,0,0,0
S01006780,Owned: Owned outright,96,48,37,9,28,9,2,48,48,0,0,0,0
S01006780,Owned: Owned with a mortgage or loan or shared ownership,103,98,83,7,76,13,2,5,4,1,0,0,0
S01006780,Rented or living rent free: Total,55,27,22,4,18,4,1,28,24,0,0,4,0
S01006780,Rented or living rent free: Social rented,41,17,15,4,11,1,1,24,20,0,0,4,0
S01006780,Rented or living rent free: Private rented or living rent free,14,10,7,0,7,3,0,4,4,0,0,0,0
S01006781,All HRPs aged 16 and over,295,178,147,25,122,28,3,117,116,0,1,0,0
S01006781,Owned: Total,269,157,130,21,109,25,2,112,111,0,1,0,0
S01006781,Owned: Owned outright,169,64,49,11,38,14,1,105,105,0,0,0,0
S01006781,Owned: Owned with a mortgage or loan or shared ownership,100,93,81,10,71,11,1,7,6,0,1,0,0
S01006781,Rented or living rent free: Total,26,21,17,4,13,3,1,5,5,0,0,0,0
S01006781,Rented or living rent free: Social rented,9,7,6,1,5,0,1,2,2,0,0,0,0
S01006781,Rented or living rent free: Private rented or living rent free,17,14,11,3,8,3,0,3,3,0,0,0,0
S01006782,All HRPs aged 16 and over,341,268,234,23,211,33,1,73,59,4,2,5,3
S01006782,Owned: Total,274,223,193,17,176,29,1,51,47,0,1,2,1
S01006782,Owned: Owned outright,103,60,48,8,40,11,1,43,42,0,1,0,0
S01006782,Owned: Owned with a mortgage or loan or shared ownership,171,163,145,9,136,18,0,8,5,0,0,2,1
S01006782,Rented or living rent free: Total,67,45,41,6,35,4,0,22,12,4,1,3,2
S01006782,Rented or living rent free: Social rented,25,12,11,2,9,1,0,13,9,0,1,2,1
S01006782,Rented or living rent free: Private rented or living rent free,42,33,30,4,26,3,0,9,3,4,0,1,1
S01006783,All HRPs aged 16 and over,299,177,154,28,126,16,7,122,113,1,3,3,2
S01006783,Owned: Total,251,141,128,21,107,11,2,110,108,1,0,0,1
S01006783,Owned: Owned outright,164,59,55,17,38,3,1,105,104,1,0,0,0
S01006783,Owned: Owned with a mortgage or loan or shared ownership,87,82,73,4,69,8,1,5,4,0,0,0,1
S01006783,Rented or living rent free: Total,48,36,26,7,19,5,5,12,5,0,3,3,1
S01006783,Rented or living rent free: Social rented,38,30,23,6,17,3,4,8,2,0,3,2,1
S01006783,Rented or living rent free: Private rented or living rent free,10,6,3,1,2,2,1,4,3,0,0,1,0
S01006784,All HRPs aged 16 and over,302,225,189,19,170,28,8,77,68,5,0,3,1
S01006784,Owned: Total,249,180,149,10,139,23,8,69,66,0,0,2,1
S01006784,Owned: Owned outright,125,60,47,7,40,8,5,65,64,0,0,0,1
S01006784,Owned: Owned with a mortgage or loan or shared ownership,124,120,102,3,99,15,3,4,2,0,0,2,0
S01006784,Rented or living rent free: Total,53,45,40,9,31,5,0,8,2,5,0,1,0
S01006784,Rented or living rent free: Social rented,1,0,0,0,0,0,0,1,1,0,0,0,0
S01006784,Rented or living rent free: Private rented or living rent free,52,45,40,9,31,5,0,7,1,5,0,1,0
S01006785,All HRPs aged 16 and over,223,187,165,14,151,19,3,36,35,0,1,0,0
S01006785,Owned: Total,208,172,154,12,142,17,1,36,35,0,1,0,0
S01006785,Owned: Owned outright,75,40,33,7,26,6,1,35,35,0,0,0,0
S01006785,Owned: Owned with a mortgage or loan or shared ownership,133,132,121,5,116,11,0,1,0,0,1,0,0
S01006785,Rented or living rent free: Total,15,15,11,2,9,2,2,0,0,0,0,0,0
S01006785,Rented or living rent free: Social rented,2,2,2,0,2,0,0,0,0,0,0,0,0
S01006785,Rented or living rent free: Private rented or living rent free,13,13,9,2,7,2,2,0,0,0,0,0,0
S01006786,All HRPs aged 16 and over,339,274,234,20,214,37,3,65,55,3,2,2,3
S01006786,Owned: Total,301,248,214,18,196,31,3,53,48,2,0,1,2
S01006786,Owned: Owned outright,120,75,60,10,50,13,2,45,42,1,0,1,1
S01006786,Owned: Owned with a mortgage or loan or shared ownership,181,173,154,8,146,18,1,8,6,1,0,0,1
S01006786,Rented or living rent free: Total,38,26,20,2,18,6,0,12,7,1,2,1,1
S01006786,Rented or living rent free: Social rented,13,6,3,0,3,3,0,7,5,0,0,1,1
S01006786,Rented or living rent free: Private rented or living rent free,25,20,17,2,15,3,0,5,2,1,2,0,0
S01006787,All HRPs aged 16 and over,281,191,159,10,149,29,3,90,80,2,1,3,4
S01006787,Owned: Total,228,170,144,4,140,25,1,58,55,0,0,0,3
S01006787,Owned: Owned outright,109,61,50,4,46,11,0,48,47,0,0,0,1
S01006787,Owned: Owned with a mortgage or loan or shared ownership,119,109,94,0,94,14,1,10,8,0,0,0,2
S01006787,Rented or living rent free: Total,53,21,15,6,9,4,2,32,25,2,1,3,1
S01006787,Rented or living rent free: Social rented,32,5,4,4,0,1,0,27,23,0,0,3,1
S01006787,Rented or living rent free: Private rented or living rent free,21,16,11,2,9,3,2,5,2,2,1,0,0
S01006788,All HRPs aged 16 and over,302,266,222,13,209,42,2,36,22,6,2,2,4
S01006788,Owned: Total,251,227,188,11,177,39,0,24,19,3,1,0,1
S01006788,Owned: Owned outright,70,51,37,4,33,14,0,19,18,0,0,0,1
S01006788,Owned: Owned with a mortgage or loan or shared ownership,181,176,151,7,144,25,0,5,1,3,1,0,0
S01006788,Rented or living rent free: Total,51,39,34,2,32,3,2,12,3,3,1,2,3
S01006788,Rented or living rent free: Social rented,3,2,2,0,2,0,0,1,1,0,0,0,0
S01006788,Rented or living rent free: Private rented or living rent free,48,37,32,2,30,3,2,11,2,3,1,2,3
S01006789,All HRPs aged 16 and over,290,183,147,34,113,34,2,107,101,0,0,2,4
S01006789,Owned: Total,208,123,94,23,71,29,0,85,82,0,0,0,3
S01006789,Owned: Owned outright,136,57,44,14,30,13,0,79,76,0,0,0,3
S01006789,Owned: Owned with a mortgage or loan or shared ownership,72,66,50,9,41,16,0,6,6,0,0,0,0
S01006789,Rented or living rent free: Total,82,60,53,11,42,5,2,22,19,0,0,2,1
S01006789,Rented or living rent free: Social rented,14,10,9,3,6,1,0,4,2,0,0,2,0
S01006789,Rented or living rent free: Private rented or living rent free,68,50,44,8,36,4,2,18,17,0,0,0,1
S01006790,All HRPs aged 16 and over,444,242,193,43,150,43,6,202,188,4,4,3,3
S01006790,Owned: Total,266,156,119,24,95,37,0,110,109,0,0,0,1
S01006790,Owned: Owned outright,176,69,50,14,36,19,0,107,106,0,0,0,1
S01006790,Owned: Owned with a mortgage or loan or shared ownership,90,87,69,10,59,18,0,3,3,0,0,0,0
S01006790,Rented or living rent free: Total,178,86,74,19,55,6,6,92,79,4,4,3,2
S01006790,Rented or living rent free: Social rented,129,50,45,13,32,2,3,79,72,4,1,1,1
S01006790,Rented or living rent free: Private rented or living rent free,49,36,29,6,23,4,3,13,7,0,3,2,1
S01006791,All HRPs aged 16 and over,253,177,106,15,91,62,9,76,67,0,0,6,3
S01006791,Owned: Total,124,82,42,8,34,38,2,42,38,0,0,1,3
S01006791,Owned: Owned outright,80,44,20,7,13,22,2,36,35,0,0,0,1
S01006791,Owned: Owned with a mortgage or loan or shared ownership,44,38,22,1,21,16,0,6,3,0,0,1,2
S01006791,Rented or living rent free: Total,129,95,64,7,57,24,7,34,29,0,0,5,0
S01006791,Rented or living rent free: Social rented,21,5,4,1,3,1,0,16,13,0,0,3,0
S01006791,Rented or living rent free: Private rented or living rent free,108,90,60,6,54,23,7,18,16,0,0,2,0
S01006792,All HRPs aged 16 and over,214,155,115,22,93,40,0,59,55,1,0,0,3
S01006792,Owned: Total,90,52,33,8,25,19,0,38,38,0,0,0,0
S01006792,Owned: Owned outright,68,31,16,4,12,15,0,37,37,0,0,0,0
S01006792,Owned: Owned with a mortgage or loan or shared ownership,22,21,17,4,13,4,0,1,1,0,0,0,0
S01006792,Rented or living rent free: Total,124,103,82,14,68,21,0,21,17,1,0,0,3
S01006792,Rented or living rent free: Social rented,3,3,3,0,3,0,0,0,0,0,0,0,0
S01006792,Rented or living rent free: Private rented or living rent free,121,100,79,14,65,21,0,21,17,1,0,0,3
S01006793,All HRPs aged 16 and over,245,157,121,16,105,35,1,88,85,1,2,0,0
S01006793,Owned: Total,131,74,51,5,46,23,0,57,55,0,2,0,0
S01006793,Owned: Owned outright,90,38,25,4,21,13,0,52,50,0,2,0,0
S01006793,Owned: Owned with a mortgage or loan or shared ownership,41,36,26,1,25,10,0,5,5,0,0,0,0
S01006793,Rented or living rent free: Total,114,83,70,11,59,12,1,31,30,1,0,0,0
S01006793,Rented or living rent free: Social rented,40,20,18,6,12,1,1,20,19,1,0,0,0
S01006793,Rented or living rent free: Private rented or living rent free,74,63,52,5,47,11,0,11,11,0,0,0,0
S01006794,All HRPs aged 16 and over,280,163,128,26,102,29,6,117,103,0,3,10,1
S01006794,Owned: Total,194,116,89,10,79,27,0,78,77,0,1,0,0
S01006794,Owned: Owned outright,109,40,27,6,21,13,0,69,68,0,1,0,0
S01006794,Owned: Owned with a mortgage or loan or shared ownership,85,76,62,4,58,14,0,9,9,0,0,0,0
S01006794,Rented or living rent free: Total,86,47,39,16,23,2,6,39,26,0,2,10,1
S01006794,Rented or living rent free: Social rented,69,34,27,12,15,1,6,35,23,0,2,9,1
S01006794,Rented or living rent free: Private rented or living rent free,17,13,12,4,8,1,0,4,3,0,0,1,0
S01006795,All HRPs aged 16 and over,319,202,154,24,130,44,4,117,105,0,4,4,4
S01006795,Owned: Total,244,153,117,14,103,36,0,91,86,0,3,0,2
S01006795,Owned: Owned outright,149,65,47,7,40,18,0,84,81,0,2,0,1
S01006795,Owned: Owned with a mortgage or loan or shared ownership,95,88,70,7,63,18,0,7,5,0,1,0,1
S01006795,Rented or living rent free: Total,75,49,37,10,27,8,4,26,19,0,1,4,2
S01006795,Rented or living rent free: Social rented,29,19,14,6,8,1,4,10,6,0,0,2,2
S01006795,Rented or living rent free: Private rented or living rent free,46,30,23,4,19,7,0,16,13,0,1,2,0
S01006796,All HRPs aged 16 and over,222,164,126,17,109,35,3,58,51,0,4,2,1
S01006796,Owned: Total,170,117,87,12,75,29,1,53,49,0,2,1,1
S01006796,Owned: Owned outright,87,38,20,8,12,17,1,49,47,0,1,0,1
S01006796,Owned: Owned with a mortgage or loan or shared ownership,83,79,67,4,63,12,0,4,2,0,1,1,0
S01006796,Rented or living rent free: Total,52,47,39,5,34,6,2,5,2,0,2,1,0
S01006796,Rented or living rent free: Social rented,21,19,15,3,12,2,2,2,1,0,1,0,0
S01006796,Rented or living rent free: Private rented or living rent free,31,28,24,2,22,4,0,3,1,0,1,1,0
S01006797,All HRPs aged 16 and over,243,200,142,19,123,56,2,43,41,0,0,2,0
S01006797,Owned: Total,137,111,72,10,62,39,0,26,25,0,0,1,0
S01006797,Owned: Owned outright,69,46,27,6,21,19,0,23,22,0,0,1,0
S01006797,Owned: Owned with a mortgage or loan or shared ownership,68,65,45,4,41,20,0,3,3,0,0,0,0
S01006797,Rented or living rent free: Total,106,89,70,9,61,17,2,17,16,0,0,1,0
S01006797,Rented or living rent free: Social rented,5,5,3,1,2,1,1,0,0,0,0,0,0
S01006797,Rented or living rent free: Private rented or living rent free,101,84,67,8,59,16,1,17,16,0,0,1,0
S01006798,All HRPs aged 16 and over,225,186,123,15,108,62,1,39,39,0,0,0,0
S01006798,Owned: Total,140,116,75,10,65,41,0,24,24,0,0,0,0
S01006798,Owned: Owned outright,87,64,33,6,27,31,0,23,23,0,0,0,0
S01006798,Owned: Owned with a mortgage or loan or shared ownership,53,52,42,4,38,10,0,1,1,0,0,0,0
S01006798,Rented or living rent free: Total,85,70,48,5,43,21,1,15,15,0,0,0,0
S01006798,Rented or living rent free: Social rented,9,3,2,0,2,1,0,6,6,0,0,0,0
S01006798,Rented or living rent free: Private rented or living rent free,76,67,46,5,41,20,1,9,9,0,0,0,0
S01006799,All HRPs aged 16 and over,403,261,213,35,178,43,5,142,127,1,3,7,4
S01006799,Owned: Total,266,187,153,22,131,32,2,79,76,0,0,1,2
S01006799,Owned: Owned outright,127,64,50,11,39,13,1,63,61,0,0,0,2
S01006799,Owned: Owned with a mortgage or loan or shared ownership,139,123,103,11,92,19,1,16,15,0,0,1,0
S01006799,Rented or living rent free: Total,137,74,60,13,47,11,3,63,51,1,3,6,2
S01006799,Rented or living rent free: Social rented,112,54,44,11,33,7,3,58,49,0,2,5,2
S01006799,Rented or living rent free: Private rented or living rent free,25,20,16,2,14,4,0,5,2,1,1,1,0
S01006800,All HRPs aged 16 and over,320,235,177,21,156,56,2,85,76,2,5,1,1
S01006800,Owned: Total,262,183,137,17,120,45,1,79,72,2,4,0,1
S01006800,Owned: Owned outright,157,86,61,15,46,25,0,71,66,2,2,0,1
S01006800,Owned: Owned with a mortgage or loan or shared ownership,105,97,76,2,74,20,1,8,6,0,2,0,0
S01006800,Rented or living rent free: Total,58,52,40,4,36,11,1,6,4,0,1,1,0
S01006800,Rented or living rent free: Social rented,4,3,2,0,2,1,0,1,1,0,0,0,0
S01006800,Rented or living rent free: Private rented or living rent free,54,49,38,4,34,10,1,5,3,0,1,1,0
S01006801,All HRPs aged 16 and over,353,259,194,21,173,62,3,94,88,0,0,5,1
S01006801,Owned: Total,287,211,155,16,139,54,2,76,75,0,0,0,1
S01006801,Owned: Owned outright,138,64,41,11,30,23,0,74,74,0,0,0,0
S01006801,Owned: Owned with a mortgage or loan or shared ownership,149,147,114,5,109,31,2,2,1,0,0,0,1
S01006801,Rented or living rent free: Total,66,48,39,5,34,8,1,18,13,0,0,5,0
S01006801,Rented or living rent free: Social rented,2,1,1,1,0,0,0,1,1,0,0,0,0
S01006801,Rented or living rent free: Private rented or living rent free,64,47,38,4,34,8,1,17,12,0,0,5,0
S01006802,All HRPs aged 16 and over,298,206,147,18,129,51,8,92,82,0,2,6,2
S01006802,Owned: Total,147,105,76,8,68,29,0,42,38,0,0,3,1
S01006802,Owned: Owned outright,80,40,27,3,24,13,0,40,36,0,0,3,1
S01006802,Owned: Owned with a mortgage or loan or shared ownership,67,65,49,5,44,16,0,2,2,0,0,0,0
S01006802,Rented or living rent free: Total,151,101,71,10,61,22,8,50,44,0,2,3,1
S01006802,Rented or living rent free: Social rented,53,19,14,3,11,2,3,34,31,0,1,2,0
S01006802,Rented or living rent free: Private rented or living rent free,98,82,57,7,50,20,5,16,13,0,1,1,1
S01006803,All HRPs aged 16 and over,313,185,162,17,145,19,4,128,120,0,0,4,4
S01006803,Owned: Total,180,124,109,8,101,15,0,56,54,0,0,0,2
S01006803,Owned: Owned outright,87,36,27,2,25,9,0,51,50,0,0,0,1
S01006803,Owned: Owned with a mortgage or loan or shared ownership,93,88,82,6,76,6,0,5,4,0,0,0,1
S01006803,Rented or living rent free: Total,133,61,53,9,44,4,4,72,66,0,0,4,2
S01006803,Rented or living rent free: Social rented,104,38,33,4,29,2,3,66,61,0,0,3,2
S01006803,Rented or living rent free: Private rented or living rent free,29,23,20,5,15,2,1,6,5,0,0,1,0
S01006804,All HRPs aged 16 and over,295,221,188,10,178,28,5,74,68,0,2,2,2
S01006804,Owned: Total,231,177,154,6,148,22,1,54,53,0,0,0,1
S01006804,Owned: Owned outright,76,28,21,2,19,6,1,48,47,0,0,0,1
S01006804,Owned: Owned with a mortgage or loan or shared ownership,155,149,133,4,129,16,0,6,6,0,0,0,0
S01006804,Rented or living rent free: Total,64,44,34,4,30,6,4,20,15,0,2,2,1
S01006804,Rented or living rent free: Social rented,38,27,20,3,17,4,3,11,8,0,1,1,1
S01006804,Rented or living rent free: Private rented or living rent free,26,17,14,1,13,2,1,9,7,0,1,1,0
S01006805,All HRPs aged 16 and over,442,324,254,32,222,65,5,118,98,1,6,6,7
S01006805,Owned: Total,315,233,176,17,159,55,2,82,76,0,2,2,2
S01006805,Owned: Owned outright,151,77,43,10,33,33,1,74,70,0,1,2,1
S01006805,Owned: Owned with a mortgage or loan or shared ownership,164,156,133,7,126,22,1,8,6,0,1,0,1
S01006805,Rented or living rent free: Total,127,91,78,15,63,10,3,36,22,1,4,4,5
S01006805,Rented or living rent free: Social rented,63,37,32,11,21,3,2,26,14,1,4,3,4
S01006805,Rented or living rent free: Private rented or living rent free,64,54,46,4,42,7,1,10,8,0,0,1,1
S01006806,All HRPs aged 16 and over,429,317,225,14,211,89,3,112,93,1,7,11,0
S01006806,Owned: Total,321,247,165,10,155,81,1,74,69,0,2,3,0
S01006806,Owned: Owned outright,152,90,45,7,38,44,1,62,61,0,0,1,0
S01006806,Owned: Owned with a mortgage or loan or shared ownership,169,157,120,3,117,37,0,12,8,0,2,2,0
S01006806,Rented or living rent free: Total,108,70,60,4,56,8,2,38,24,1,5,8,0
S01006806,Rented or living rent free: Social rented,29,11,10,0,10,0,1,18,13,0,3,2,0
S01006806,Rented or living rent free: Private rented or living rent free,79,59,50,4,46,8,1,20,11,1,2,6,0
S01006807,All HRPs aged 16 and over,243,203,154,14,140,43,6,40,33,0,3,3,1
S01006807,Owned: Total,182,156,116,10,106,38,2,26,23,0,1,1,1
S01006807,Owned: Owned outright,64,45,24,4,20,19,2,19,17,0,1,0,1
S01006807,Owned: Owned with a mortgage or loan or shared ownership,118,111,92,6,86,19,0,7,6,0,0,1,0
S01006807,Rented or living rent free: Total,61,47,38,4,34,5,4,14,10,0,2,2,0
S01006807,Rented or living rent free: Social rented,4,1,0,0,0,0,1,3,0,0,2,1,0
S01006807,Rented or living rent free: Private rented or living rent free,57,46,38,4,34,5,3,11,10,0,0,1,0
S01006808,All HRPs aged 16 and over,248,184,131,11,120,50,3,64,58,1,2,2,1
S01006808,Owned: Total,214,158,112,9,103,45,1,56,51,1,1,2,1
S01006808,Owned: Owned outright,104,56,31,7,24,25,0,48,46,0,1,0,1
S01006808,Owned: Owned with a mortgage or loan or shared ownership,110,102,81,2,79,20,1,8,5,1,0,2,0
S01006808,Rented or living rent free: Total,34,26,19,2,17,5,2,8,7,0,1,0,0
S01006808,Rented or living rent free: Social rented,7,6,5,1,4,1,0,1,1,0,0,0,0
S01006808,Rented or living rent free: Private rented or living rent free,27,20,14,1,13,4,2,7,6,0,1,0,0
S01006809,All HRPs aged 16 and over,354,222,178,30,148,40,4,132,111,1,4,14,2
S01006809,Owned: Total,209,143,111,16,95,31,1,66,62,1,1,1,1
S01006809,Owned: Owned outright,104,44,34,8,26,10,0,60,58,0,0,1,1
S01006809,Owned: Owned with a mortgage or loan or shared ownership,105,99,77,8,69,21,1,6,4,1,1,0,0
S01006809,Rented or living rent free: Total,145,79,67,14,53,9,3,66,49,0,3,13,1
S01006809,Rented or living rent free: Social rented,116,56,49,11,38,5,2,60,44,0,2,13,1
S01006809,Rented or living rent free: Private rented or living rent free,29,23,18,3,15,4,1,6,5,0,1,0,0
S01006810,All HRPs aged 16 and over,370,255,179,22,157,69,7,115,99,1,4,10,1
S01006810,Owned: Total,252,189,135,18,117,53,1,63,60,0,2,0,1
S01006810,Owned: Owned outright,118,64,41,9,32,22,1,54,53,0,0,0,1
S01006810,Owned: Owned with a mortgage or loan or shared ownership,134,125,94,9,85,31,0,9,7,0,2,0,0
S01006810,Rented or living rent free: Total,118,66,44,4,40,16,6,52,39,1,2,10,0
S01006810,Rented or living rent free: Social rented,76,34,20,0,20,8,6,42,31,1,1,9,0
S01006810,Rented or living rent free: Private rented or living rent free,42,32,24,4,20,8,0,10,8,0,1,1,0
S01006811,All HRPs aged 16 and over,430,338,271,31,240,59,8,92,77,1,7,6,1
S01006811,Owned: Total,305,247,197,17,180,48,2,58,53,0,4,0,1
S01006811,Owned: Owned outright,127,76,51,9,42,24,1,51,47,0,3,0,1
S01006811,Owned: Owned with a mortgage or loan or shared ownership,178,171,146,8,138,24,1,7,6,0,1,0,0
S01006811,Rented or living rent free: Total,125,91,74,14,60,11,6,34,24,1,3,6,0
S01006811,Rented or living rent free: Social rented,55,35,31,8,23,1,3,20,15,1,0,4,0
S01006811,Rented or living rent free: Private rented or living rent free,70,56,43,6,37,10,3,14,9,0,3,2,0
S01006812,All HRPs aged 16 and over,304,258,207,15,192,47,4,46,40,1,3,1,1
S01006812,Owned: Total,207,192,151,8,143,41,0,15,14,0,1,0,0
S01006812,Owned: Owned outright,70,56,36,2,34,20,0,14,14,0,0,0,0
S01006812,Owned: Owned with a mortgage or loan or shared ownership,137,136,115,6,109,21,0,1,0,0,1,0,0
S01006812,Rented or living rent free: Total,97,66,56,7,49,6,4,31,26,1,2,1,1
S01006812,Rented or living rent free: Social rented,45,25,22,6,16,0,3,20,16,1,2,1,0
S01006812,Rented or living rent free: Private rented or living rent free,52,41,34,1,33,6,1,11,10,0,0,0,1
S01006813,All HRPs aged 16 and over,322,233,186,17,169,42,5,89,79,1,2,4,3
S01006813,Owned: Total,236,175,138,9,129,34,3,61,58,0,0,1,2
S01006813,Owned: Owned outright,89,36,26,7,19,8,2,53,53,0,0,0,0
S01006813,Owned: Owned with a mortgage or loan or shared ownership,147,139,112,2,110,26,1,8,5,0,0,1,2
S01006813,Rented or living rent free: Total,86,58,48,8,40,8,2,28,21,1,2,3,1
S01006813,Rented or living rent free: Social rented,62,39,33,5,28,5,1,23,18,1,2,1,1
S01006813,Rented or living rent free: Private rented or living rent free,24,19,15,3,12,3,1,5,3,0,0,2,0
S01006814,All HRPs aged 16 and over,282,218,185,13,172,33,0,64,51,1,3,5,4
S01006814,Owned: Total,261,208,175,13,162,33,0,53,46,1,2,1,3
S01006814,Owned: Owned outright,112,60,50,7,43,10,0,52,46,1,2,1,2
S01006814,Owned: Owned with a mortgage or loan or shared ownership,149,148,125,6,119,23,0,1,0,0,0,0,1
S01006814,Rented or living rent free: Total,21,10,10,0,10,0,0,11,5,0,1,4,1
S01006814,Rented or living rent free: Social rented,8,1,1,0,1,0,0,7,3,0,1,3,0
S01006814,Rented or living rent free: Private rented or living rent free,13,9,9,0,9,0,0,4,2,0,0,1,1
S01006815,All HRPs aged 16 and over,285,174,153,26,127,15,6,111,92,1,5,10,3
S01006815,Owned: Total,150,109,98,12,86,10,1,41,38,0,0,1,2
S01006815,Owned: Owned outright,65,30,25,5,20,4,1,35,33,0,0,1,1
S01006815,Owned: Owned with a mortgage or loan or shared ownership,85,79,73,7,66,6,0,6,5,0,0,0,1
S01006815,Rented or living rent free: Total,135,65,55,14,41,5,5,70,54,1,5,9,1
S01006815,Rented or living rent free: Social rented,124,59,53,14,39,3,3,65,50,1,4,9,1
S01006815,Rented or living rent free: Private rented or living rent free,11,6,2,0,2,2,2,5,4,0,1,0,0
S01006816,All HRPs aged 16 and over,298,213,180,21,159,31,2,85,68,0,1,13,3
S01006816,Owned: Total,228,178,147,14,133,30,1,50,45,0,1,3,1
S01006816,Owned: Owned outright,95,51,38,7,31,13,0,44,42,0,1,1,0
S01006816,Owned: Owned with a mortgage or loan or shared ownership,133,127,109,7,102,17,1,6,3,0,0,2,1
S01006816,Rented or living rent free: Total,70,35,33,7,26,1,1,35,23,0,0,10,2
S01006816,Rented or living rent free: Social rented,54,25,24,6,18,0,1,29,20,0,0,9,0
S01006816,Rented or living rent free: Private rented or living rent free,16,10,9,1,8,1,0,6,3,0,0,1,2
S01006817,All HRPs aged 16 and over,261,211,165,18,147,42,4,50,42,0,3,3,2
S01006817,Owned: Total,169,139,109,13,96,30,0,30,29,0,0,0,1
S01006817,Owned: Owned outright,81,52,34,8,26,18,0,29,28,0,0,0,1
S01006817,Owned: Owned with a mortgage or loan or shared ownership,88,87,75,5,70,12,0,1,1,0,0,0,0
S01006817,Rented or living rent free: Total,92,72,56,5,51,12,4,20,13,0,3,3,1
S01006817,Rented or living rent free: Social rented,47,30,25,4,21,3,2,17,10,0,3,3,1
S01006817,Rented or living rent free: Private rented or living rent free,45,42,31,1,30,9,2,3,3,0,0,0,0
S01006818,All HRPs aged 16 and over,278,217,163,7,156,51,3,61,59,0,1,0,1
S01006818,Owned: Total,228,181,134,6,128,46,1,47,46,0,1,0,0
S01006818,Owned: Owned outright,106,61,39,5,34,22,0,45,44,0,1,0,0
S01006818,Owned: Owned with a mortgage or loan or shared ownership,122,120,95,1,94,24,1,2,2,0,0,0,0
S01006818,Rented or living rent free: Total,50,36,29,1,28,5,2,14,13,0,0,0,1
S01006818,Rented or living rent free: Social rented,17,9,8,1,7,1,0,8,8,0,0,0,0
S01006818,Rented or living rent free: Private rented or living rent free,33,27,21,0,21,4,2,6,5,0,0,0,1
S01006819,All HRPs aged 16 and over,313,269,187,21,166,81,1,44,37,0,4,1,2
S01006819,Owned: Total,242,210,143,15,128,66,1,32,27,0,3,0,2
S01006819,Owned: Owned outright,107,82,46,13,33,36,0,25,22,0,2,0,1
S01006819,Owned: Owned with a mortgage or loan or shared ownership,135,128,97,2,95,30,1,7,5,0,1,0,1
S01006819,Rented or living rent free: Total,71,59,44,6,38,15,0,12,10,0,1,1,0
S01006819,Rented or living rent free: Social rented,10,4,3,2,1,1,0,6,4,0,1,1,0
S01006819,Rented or living rent free: Private rented or living rent free,61,55,41,4,37,14,0,6,6,0,0,0,0
S01006820,All HRPs aged 16 and over,180,135,117,10,107,17,1,45,40,0,2,2,1
S01006820,Owned: Total,161,120,103,9,94,16,1,41,37,0,2,1,1
S01006820,Owned: Owned outright,68,35,31,8,23,4,0,33,32,0,0,0,1
S01006820,Owned: Owned with a mortgage or loan or shared ownership,93,85,72,1,71,12,1,8,5,0,2,1,0
S01006820,Rented or living rent free: Total,19,15,14,1,13,1,0,4,3,0,0,1,0
S01006820,Rented or living rent free: Social rented,4,2,1,0,1,1,0,2,1,0,0,1,0
S01006820,Rented or living rent free: Private rented or living rent free,15,13,13,1,12,0,0,2,2,0,0,0,0
S01006821,All HRPs aged 16 and over,229,192,135,18,117,56,1,37,36,0,1,0,0
S01006821,Owned: Total,177,142,93,11,82,49,0,35,34,0,1,0,0
S01006821,Owned: Owned outright,99,66,38,8,30,28,0,33,32,0,1,0,0
S01006821,Owned: Owned with a mortgage or loan or shared ownership,78,76,55,3,52,21,0,2,2,0,0,0,0
S01006821,Rented or living rent free: Total,52,50,42,7,35,7,1,2,2,0,0,0,0
S01006821,Rented or living rent free: Social rented,3,3,3,3,0,0,0,0,0,0,0,0,0
S01006821,Rented or living rent free: Private rented or living rent free,49,47,39,4,35,7,1,2,2,0,0,0,0
S01006822,All HRPs aged 16 and over,279,238,158,15,143,79,1,41,34,0,2,2,3
S01006822,Owned: Total,220,188,126,14,112,62,0,32,27,0,2,1,2
S01006822,Owned: Owned outright,109,78,44,9,35,34,0,31,27,0,1,1,2
S01006822,Owned: Owned with a mortgage or loan or shared ownership,111,110,82,5,77,28,0,1,0,0,1,0,0
S01006822,Rented or living rent free: Total,59,50,32,1,31,17,1,9,7,0,0,1,1
S01006822,Rented or living rent free: Social rented,5,3,3,0,3,0,0,2,2,0,0,0,0
S01006822,Rented or living rent free: Private rented or living rent free,54,47,29,1,28,17,1,7,5,0,0,1,1
S01006823,All HRPs aged 16 and over,302,220,181,18,163,36,3,82,78,0,1,2,1
S01006823,Owned: Total,249,177,143,15,128,31,3,72,70,0,1,0,1
S01006823,Owned: Owned outright,148,78,62,11,51,14,2,70,69,0,1,0,0
S01006823,Owned: Owned with a mortgage or loan or shared ownership,101,99,81,4,77,17,1,2,1,0,0,0,1
S01006823,Rented or living rent free: Total,53,43,38,3,35,5,0,10,8,0,0,2,0
S01006823,Rented or living rent free: Social rented,4,4,3,1,2,1,0,0,0,0,0,0,0
S01006823,Rented or living rent free: Private rented or living rent free,49,39,35,2,33,4,0,10,8,0,0,2,0
S01006824,All HRPs aged 16 and over,367,255,220,34,186,20,15,112,73,3,7,19,10
S01006824,Owned: Total,180,137,122,8,114,14,1,43,33,1,2,2,5
S01006824,Owned: Owned outright,69,36,29,6,23,7,0,33,29,0,0,2,2
S01006824,Owned: Owned with a mortgage or loan or shared ownership,111,101,93,2,91,7,1,10,4,1,2,0,3
S01006824,Rented or living rent free: Total,187,118,98,26,72,6,14,69,40,2,5,17,5
S01006824,Rented or living rent free: Social rented,171,105,87,23,64,4,14,66,38,2,5,17,4
S01006824,Rented or living rent free: Private rented or living rent free,16,13,11,3,8,2,0,3,2,0,0,0,1
S01006825,All HRPs aged 16 and over,333,243,224,22,202,18,1,90,84,1,2,3,0
S01006825,Owned: Total,282,212,195,13,182,17,0,70,69,0,1,0,0
S01006825,Owned: Owned outright,119,58,54,9,45,4,0,61,61,0,0,0,0
S01006825,Owned: Owned with a mortgage or loan or shared ownership,163,154,141,4,137,13,0,9,8,0,1,0,0
S01006825,Rented or living rent free: Total,51,31,29,9,20,1,1,20,15,1,1,3,0
S01006825,Rented or living rent free: Social rented,34,17,15,8,7,1,1,17,12,1,1,3,0
S01006825,Rented or living rent free: Private rented or living rent free,17,14,14,1,13,0,0,3,3,0,0,0,0
S01006826,All HRPs aged 16 and over,344,263,216,24,192,47,0,81,77,0,1,2,1
S01006826,Owned: Total,270,224,182,18,164,42,0,46,45,0,0,0,1
S01006826,Owned: Owned outright,118,76,61,12,49,15,0,42,42,0,0,0,0
S01006826,Owned: Owned with a mortgage or loan or shared ownership,152,148,121,6,115,27,0,4,3,0,0,0,1
S01006826,Rented or living rent free: Total,74,39,34,6,28,5,0,35,32,0,1,2,0
S01006826,Rented or living rent free: Social rented,51,22,21,6,15,1,0,29,27,0,0,2,0
S01006826,Rented or living rent free: Private rented or living rent free,23,17,13,0,13,4,0,6,5,0,1,0,0
S01006827,All HRPs aged 16 and over,419,275,245,37,208,24,6,144,120,1,5,13,5
S01006827,Owned: Total,246,179,155,11,144,22,2,67,64,0,2,1,0
S01006827,Owned: Owned outright,110,51,42,7,35,9,0,59,59,0,0,0,0
S01006827,Owned: Owned with a mortgage or loan or shared ownership,136,128,113,4,109,13,2,8,5,0,2,1,0
S01006827,Rented or living rent free: Total,173,96,90,26,64,2,4,77,56,1,3,12,5
S01006827,Rented or living rent free: Social rented,131,71,67,20,47,0,4,60,45,0,3,7,5
S01006827,Rented or living rent free: Private rented or living rent free,42,25,23,6,17,2,0,17,11,1,0,5,0
S01006828,All HRPs aged 16 and over,485,333,283,32,251,42,8,152,131,2,2,12,5
S01006828,Owned: Total,303,205,174,17,157,31,0,98,95,0,1,2,0
S01006828,Owned: Owned outright,150,65,52,12,40,13,0,85,84,0,1,0,0
S01006828,Owned: Owned with a mortgage or loan or shared ownership,153,140,122,5,117,18,0,13,11,0,0,2,0
S01006828,Rented or living rent free: Total,182,128,109,15,94,11,8,54,36,2,1,10,5
S01006828,Rented or living rent free: Social rented,99,55,45,10,35,4,6,44,28,2,0,10,4
S01006828,Rented or living rent free: Private rented or living rent free,83,73,64,5,59,7,2,10,8,0,1,0,1
S01006829,All HRPs aged 16 and over,139,126,109,2,107,17,0,13,10,0,2,0,1
S01006829,Owned: Total,132,120,103,2,101,17,0,12,9,0,2,0,1
S01006829,Owned: Owned outright,26,16,13,0,13,3,0,10,8,0,1,0,1
S01006829,Owned: Owned with a mortgage or loan or shared ownership,106,104,90,2,88,14,0,2,1,0,1,0,0
S01006829,Rented or living rent free: Total,7,6,6,0,6,0,0,1,1,0,0,0,0
S01006829,Rented or living rent free: Social rented,1,0,0,0,0,0,0,1,1,0,0,0,0
S01006829,Rented or living rent free: Private rented or living rent free,6,6,6,0,6,0,0,0,0,0,0,0,0
S01006830,All HRPs aged 16 and over,301,200,159,22,137,36,5,101,88,1,1,8,3
S01006830,Owned: Total,222,144,115,12,103,29,0,78,76,1,0,0,1
S01006830,Owned: Owned outright,115,44,35,5,30,9,0,71,70,1,0,0,0
S01006830,Owned: Owned with a mortgage or loan or shared ownership,107,100,80,7,73,20,0,7,6,0,0,0,1
S01006830,Rented or living rent free: Total,79,56,44,10,34,7,5,23,12,0,1,8,2
S01006830,Rented or living rent free: Social rented,70,50,39,10,29,6,5,20,10,0,1,8,1
S01006830,Rented or living rent free: Private rented or living rent free,9,6,5,0,5,1,0,3,2,0,0,0,1
S01006831,All HRPs aged 16 and over,221,143,126,14,112,15,2,78,76,0,0,2,0
S01006831,Owned: Total,205,133,119,11,108,13,1,72,71,0,0,1,0
S01006831,Owned: Owned outright,124,55,47,9,38,7,1,69,68,0,0,1,0
S01006831,Owned: Owned with a mortgage or loan or shared ownership,81,78,72,2,70,6,0,3,3,0,0,0,0
S01006831,Rented or living rent free: Total,16,10,7,3,4,2,1,6,5,0,0,1,0
S01006831,Rented or living rent free: Social rented,1,1,1,1,0,0,0,0,0,0,0,0,0
S01006831,Rented or living rent free: Private rented or living rent free,15,9,6,2,4,2,1,6,5,0,0,1,0
S01006832,All HRPs aged 16 and over,424,291,244,29,215,45,2,133,113,0,7,9,4
S01006832,Owned: Total,332,239,202,26,176,37,0,93,85,0,4,2,2
S01006832,Owned: Owned outright,187,101,84,19,65,17,0,86,81,0,3,0,2
S01006832,Owned: Owned with a mortgage or loan or shared ownership,145,138,118,7,111,20,0,7,4,0,1,2,0
S01006832,Rented or living rent free: Total,92,52,42,3,39,8,2,40,28,0,3,7,2
S01006832,Rented or living rent free: Social rented,47,11,9,1,8,1,1,36,25,0,3,6,2
S01006832,Rented or living rent free: Private rented or living rent free,45,41,33,2,31,7,1,4,3,0,0,1,0
S01006833,All HRPs aged 16 and over,175,115,90,7,83,25,0,60,60,0,0,0,0
S01006833,Owned: Total,156,100,78,5,73,22,0,56,56,0,0,0,0
S01006833,Owned: Owned outright,96,44,35,4,31,9,0,52,52,0,0,0,0
S01006833,Owned: Owned with a mortgage or loan or shared ownership,60,56,43,1,42,13,0,4,4,0,0,0,0
S01006833,Rented or living rent free: Total,19,15,12,2,10,3,0,4,4,0,0,0,0
S01006833,Rented or living rent free: Social rented,3,3,3,1,2,0,0,0,0,0,0,0,0
S01006833,Rented or living rent free: Private rented or living rent free,16,12,9,1,8,3,0,4,4,0,0,0,0
S01006834,All HRPs aged 16 and over,163,154,133,12,121,20,1,9,6,0,1,2,0
S01006834,Owned: Total,133,127,109,8,101,18,0,6,5,0,1,0,0
S01006834,Owned: Owned outright,34,29,27,7,20,2,0,5,5,0,0,0,0
S01006834,Owned: Owned with a mortgage or loan or shared ownership,99,98,82,1,81,16,0,1,0,0,1,0,0
S01006834,Rented or living rent free: Total,30,27,24,4,20,2,1,3,1,0,0,2,0
S01006834,Rented or living rent free: Social rented,15,13,10,4,6,2,1,2,0,0,0,2,0
S01006834,Rented or living rent free: Private rented or living rent free,15,14,14,0,14,0,0,1,1,0,0,0,0
S01006835,All HRPs aged 16 and over,478,259,213,35,178,43,3,219,203,0,2,11,3
S01006835,Owned: Total,259,148,116,11,105,32,0,111,107,0,1,1,2
S01006835,Owned: Owned outright,147,40,26,9,17,14,0,107,103,0,1,1,2
S01006835,Owned: Owned with a mortgage or loan or shared ownership,112,108,90,2,88,18,0,4,4,0,0,0,0
S01006835,Rented or living rent free: Total,219,111,97,24,73,11,3,108,96,0,1,10,1
S01006835,Rented or living rent free: Social rented,128,31,27,17,10,4,0,97,85,0,1,10,1
S01006835,Rented or living rent free: Private rented or living rent free,91,80,70,7,63,7,3,11,11,0,0,0,0
S01006836,All HRPs aged 16 and over,210,184,155,20,135,25,4,26,14,0,2,7,3
S01006836,Owned: Total,149,133,114,6,108,18,1,16,11,0,1,2,2
S01006836,Owned: Owned outright,30,20,12,4,8,8,0,10,8,0,0,2,0
S01006836,Owned: Owned with a mortgage or loan or shared ownership,119,113,102,2,100,10,1,6,3,0,1,0,2
S01006836,Rented or living rent free: Total,61,51,41,14,27,7,3,10,3,0,1,5,1
S01006836,Rented or living rent free: Social rented,29,20,15,11,4,4,1,9,3,0,1,5,0
S01006836,Rented or living rent free: Private rented or living rent free,32,31,26,3,23,3,2,1,0,0,0,0,1
S01006837,All HRPs aged 16 and over,230,169,136,19,117,33,0,61,55,0,1,5,0
S01006837,Owned: Total,193,143,115,14,101,28,0,50,50,0,0,0,0
S01006837,Owned: Owned outright,87,38,29,8,21,9,0,49,49,0,0,0,0
S01006837,Owned: Owned with a mortgage or loan or shared ownership,106,105,86,6,80,19,0,1,1,0,0,0,0
S01006837,Rented or living rent free: Total,37,26,21,5,16,5,0,11,5,0,1,5,0
S01006837,Rented or living rent free: Social rented,27,18,14,4,10,4,0,9,3,0,1,5,0
S01006837,Rented or living rent free: Private rented or living rent free,10,8,7,1,6,1,0,2,2,0,0,0,0
S01006838,All HRPs aged 16 and over,249,193,165,14,151,27,1,56,50,0,5,1,0
S01006838,Owned: Total,200,178,152,12,140,25,1,22,20,0,2,0,0
S01006838,Owned: Owned outright,49,35,28,6,22,6,1,14,14,0,0,0,0
S01006838,Owned: Owned with a mortgage or loan or shared ownership,151,143,124,6,118,19,0,8,6,0,2,0,0
S01006838,Rented or living rent free: Total,49,15,13,2,11,2,0,34,30,0,3,1,0
S01006838,Rented or living rent free: Social rented,39,8,8,1,7,0,0,31,29,0,1,1,0
S01006838,Rented or living rent free: Private rented or living rent free,10,7,5,1,4,2,0,3,1,0,2,0,0
S01006839,All HRPs aged 16 and over,450,323,279,40,239,39,5,127,116,2,1,6,2
S01006839,Owned: Total,351,264,230,30,200,32,2,87,83,1,0,2,1
S01006839,Owned: Owned outright,171,89,76,18,58,13,0,82,80,0,0,1,1
S01006839,Owned: Owned with a mortgage or loan or shared ownership,180,175,154,12,142,19,2,5,3,1,0,1,0
S01006839,Rented or living rent free: Total,99,59,49,10,39,7,3,40,33,1,1,4,1
S01006839,Rented or living rent free: Social rented,71,36,31,6,25,4,1,35,29,1,1,3,1
S01006839,Rented or living rent free: Private rented or living rent free,28,23,18,4,14,3,2,5,4,0,0,1,0
S01006840,All HRPs aged 16 and over,366,275,231,23,208,42,2,91,82,1,3,2,3
S01006840,Owned: Total,351,264,224,22,202,38,2,87,81,1,3,0,2
S01006840,Owned: Owned outright,146,64,46,9,37,16,2,82,78,1,2,0,1
S01006840,Owned: Owned with a mortgage or loan or shared ownership,205,200,178,13,165,22,0,5,3,0,1,0,1
S01006840,Rented or living rent free: Total,15,11,7,1,6,4,0,4,1,0,0,2,1
S01006840,Rented or living rent free: Social rented,4,2,1,0,1,1,0,2,0,0,0,2,0
S01006840,Rented or living rent free: Private rented or living rent free,11,9,6,1,5,3,0,2,1,0,0,0,1
S01006841,All HRPs aged 16 and over,344,291,245,21,224,41,5,53,44,0,6,1,2
S01006841,Owned: Total,321,276,236,19,217,38,2,45,40,0,3,1,1
S01006841,Owned: Owned outright,95,61,48,11,37,12,1,34,31,0,1,1,1
S01006841,Owned: Owned with a mortgage or loan or shared ownership,226,215,188,8,180,26,1,11,9,0,2,0,0
S01006841,Rented or living rent free: Total,23,15,9,2,7,3,3,8,4,0,3,0,1
S01006841,Rented or living rent free: Social rented,12,8,3,2,1,2,3,4,2,0,2,0,0
S01006841,Rented or living rent free: Private rented or living rent free,11,7,6,0,6,1,0,4,2,0,1,0,1
S01006842,All HRPs aged 16 and over,308,236,203,22,181,32,1,72,69,0,1,2,0
S01006842,Owned: Total,291,223,192,19,173,30,1,68,67,0,1,0,0
S01006842,Owned: Owned outright,137,73,61,13,48,11,1,64,63,0,1,0,0
S01006842,Owned: Owned with a mortgage or loan or shared ownership,154,150,131,6,125,19,0,4,4,0,0,0,0
S01006842,Rented or living rent free: Total,17,13,11,3,8,2,0,4,2,0,0,2,0
S01006842,Rented or living rent free: Social rented,6,4,4,1,3,0,0,2,1,0,0,1,0
S01006842,Rented or living rent free: Private rented or living rent free,11,9,7,2,5,2,0,2,1,0,0,1,0
S01006843,All HRPs aged 16 and over,312,257,224,15,209,32,1,55,49,2,2,2,0
S01006843,Owned: Total,294,247,217,13,204,29,1,47,44,1,2,0,0
S01006843,Owned: Owned outright,88,48,41,7,34,6,1,40,39,0,1,0,0
S01006843,Owned: Owned with a mortgage or loan or shared ownership,206,199,176,6,170,23,0,7,5,1,1,0,0
S01006843,Rented or living rent free: Total,18,10,7,2,5,3,0,8,5,1,0,2,0
S01006843,Rented or living rent free: Social rented,5,1,0,0,0,1,0,4,2,0,0,2,0
S01006843,Rented or living rent free: Private rented or living rent free,13,9,7,2,5,2,0,4,3,1,0,0,0
S01006844,All HRPs aged 16 and over,332,274,235,19,216,37,2,58,55,0,0,2,1
S01006844,Owned: Total,305,250,212,18,194,36,2,55,54,0,0,1,0
S01006844,Owned: Owned outright,112,65,52,12,40,11,2,47,46,0,0,1,0
S01006844,Owned: Owned with a mortgage or loan or shared ownership,193,185,160,6,154,25,0,8,8,0,0,0,0
S01006844,Rented or living rent free: Total,27,24,23,1,22,1,0,3,1,0,0,1,1
S01006844,Rented or living rent free: Social rented,4,2,2,0,2,0,0,2,1,0,0,0,1
S01006844,Rented or living rent free: Private rented or living rent free,23,22,21,1,20,1,0,1,0,0,0,1,0
S01006845,All HRPs aged 16 and over,366,312,274,28,246,33,5,54,45,0,0,5,4
S01006845,Owned: Total,342,297,260,26,234,32,5,45,40,0,0,1,4
S01006845,Owned: Owned outright,108,69,58,14,44,7,4,39,37,0,0,0,2
S01006845,Owned: Owned with a mortgage or loan or shared ownership,234,228,202,12,190,25,1,6,3,0,0,1,2
S01006845,Rented or living rent free: Total,24,15,14,2,12,1,0,9,5,0,0,4,0
S01006845,Rented or living rent free: Social rented,4,0,0,0,0,0,0,4,2,0,0,2,0
S01006845,Rented or living rent free: Private rented or living rent free,20,15,14,2,12,1,0,5,3,0,0,2,0
S01006846,All HRPs aged 16 and over,240,188,168,18,150,19,1,52,50,0,0,2,0
S01006846,Owned: Total,206,172,153,18,135,19,0,34,33,0,0,1,0
S01006846,Owned: Owned outright,76,47,37,12,25,10,0,29,28,0,0,1,0
S01006846,Owned: Owned with a mortgage or loan or shared ownership,130,125,116,6,110,9,0,5,5,0,0,0,0
S01006846,Rented or living rent free: Total,34,16,15,0,15,0,1,18,17,0,0,1,0
S01006846,Rented or living rent free: Social rented,22,5,4,0,4,0,1,17,16,0,0,1,0
S01006846,Rented or living rent free: Private rented or living rent free,12,11,11,0,11,0,0,1,1,0,0,0,0
S01006847,All HRPs aged 16 and over,238,200,177,12,165,22,1,38,34,0,2,2,0
S01006847,Owned: Total,232,194,171,11,160,22,1,38,34,0,2,2,0
S01006847,Owned: Owned outright,67,32,29,5,24,3,0,35,33,0,1,1,0
S01006847,Owned: Owned with a mortgage or loan or shared ownership,165,162,142,6,136,19,1,3,1,0,1,1,0
S01006847,Rented or living rent free: Total,6,6,6,1,5,0,0,0,0,0,0,0,0
S01006847,Rented or living rent free: Social rented,0,0,0,0,0,0,0,0,0,0,0,0,0
S01006847,Rented or living rent free: Private rented or living rent free,6,6,6,1,5,0,0,0,0,0,0,0,0
S01006848,All HRPs aged 16 and over,364,280,213,22,191,64,3,84,75,3,1,3,2
S01006848,Owned: Total,271,205,151,19,132,51,3,66,62,0,0,2,2
S01006848,Owned: Owned outright,147,84,62,14,48,20,2,63,60,0,0,2,1
S01006848,Owned: Owned with a mortgage or loan or shared ownership,124,121,89,5,84,31,1,3,2,0,0,0,1
S01006848,Rented or living rent free: Total,93,75,62,3,59,13,0,18,13,3,1,1,0
S01006848,Rented or living rent free: Social rented,8,5,4,2,2,1,0,3,1,1,0,1,0
S01006848,Rented or living rent free: Private rented or living rent free,85,70,58,1,57,12,0,15,12,2,1,0,0
S01006849,All HRPs aged 16 and over,355,329,289,24,265,32,8,26,16,1,4,4,1
S01006849,Owned: Total,291,277,247,14,233,28,2,14,13,0,1,0,0
S01006849,Owned: Owned outright,34,23,19,4,15,4,0,11,10,0,1,0,0
S01006849,Owned: Owned with a mortgage or loan or shared ownership,257,254,228,10,218,24,2,3,3,0,0,0,0
S01006849,Rented or living rent free: Total,64,52,42,10,32,4,6,12,3,1,3,4,1
S01006849,Rented or living rent free: Social rented,56,45,36,10,26,3,6,11,3,1,2,4,1
S01006849,Rented or living rent free: Private rented or living rent free,8,7,6,0,6,1,0,1,0,0,1,0,0
S01006850,All HRPs aged 16 and over,365,306,270,39,231,30,6,59,46,1,4,8,0
S01006850,Owned: Total,286,251,223,24,199,26,2,35,31,0,2,2,0
S01006850,Owned: Owned outright,83,53,47,11,36,6,0,30,27,0,1,2,0
S01006850,Owned: Owned with a mortgage or loan or shared ownership,203,198,176,13,163,20,2,5,4,0,1,0,0
S01006850,Rented or living rent free: Total,79,55,47,15,32,4,4,24,15,1,2,6,0
S01006850,Rented or living rent free: Social rented,61,42,35,13,22,3,4,19,12,1,1,5,0
S01006850,Rented or living rent free: Private rented or living rent free,18,13,12,2,10,1,0,5,3,0,1,1,0
S01006851,All HRPs aged 16 and over,337,229,196,34,162,28,5,108,89,0,2,12,5
S01006851,Owned: Total,220,183,156,18,138,25,2,37,33,0,2,1,1
S01006851,Owned: Owned outright,67,36,29,9,20,6,1,31,30,0,0,0,1
S01006851,Owned: Owned with a mortgage or loan or shared ownership,153,147,127,9,118,19,1,6,3,0,2,1,0
S01006851,Rented or living rent free: Total,117,46,40,16,24,3,3,71,56,0,0,11,4
S01006851,Rented or living rent free: Social rented,107,41,36,14,22,3,2,66,53,0,0,11,2
S01006851,Rented or living rent free: Private rented or living rent free,10,5,4,2,2,0,1,5,3,0,0,0,2
S01006852,All HRPs aged 16 and over,229,175,139,12,127,34,2,54,53,0,1,0,0
S01006852,Owned: Total,207,155,125,11,114,28,2,52,51,0,1,0,0
S01006852,Owned: Owned outright,106,57,42,7,35,14,1,49,48,0,1,0,0
S01006852,Owned: Owned with a mortgage or loan or shared ownership,101,98,83,4,79,14,1,3,3,0,0,0,0
S01006852,Rented or living rent free: Total,22,20,14,1,13,6,0,2,2,0,0,0,0
S01006852,Rented or living rent free: Social rented,6,5,3,1,2,2,0,1,1,0,0,0,0
S01006852,Rented or living rent free: Private rented or living rent free,16,15,11,0,11,4,0,1,1,0,0,0,0
S01006853,All HRPs aged 16 and over,318,258,187,16,171,70,1,60,54,1,2,1,2
S01006853,Owned: Total,241,197,138,12,126,58,1,44,40,1,2,0,1
S01006853,Owned: Owned outright,109,73,45,9,36,28,0,36,33,1,1,0,1
S01006853,Owned: Owned with a mortgage or loan or shared ownership,132,124,93,3,90,30,1,8,7,0,1,0,0
S01006853,Rented or living rent free: Total,77,61,49,4,45,12,0,16,14,0,0,1,1
S01006853,Rented or living rent free: Social rented,2,2,2,0,2,0,0,0,0,0,0,0,0
S01006853,Rented or living rent free: Private rented or living rent free,75,59,47,4,43,12,0,16,14,0,0,1,1
S01006854,All HRPs aged 16 and over,364,254,197,25,172,50,7,110,99,0,7,4,0
S01006854,Owned: Total,275,202,160,13,147,41,1,73,70,0,2,1,0
S01006854,Owned: Owned outright,139,71,55,11,44,16,0,68,67,0,1,0,0
S01006854,Owned: Owned with a mortgage or loan or shared ownership,136,131,105,2,103,25,1,5,3,0,1,1,0
S01006854,Rented or living rent free: Total,89,52,37,12,25,9,6,37,29,0,5,3,0
S01006854,Rented or living rent free: Social rented,73,37,27,10,17,4,6,36,28,0,5,3,0
S01006854,Rented or living rent free: Private rented or living rent free,16,15,10,2,8,5,0,1,1,0,0,0,0
S01006855,All HRPs aged 16 and over,294,233,164,19,145,68,1,61,54,1,1,3,2
S01006855,Owned: Total,224,176,133,16,117,42,1,48,44,0,1,1,2
S01006855,Owned: Owned outright,116,76,55,12,43,20,1,40,37,0,1,0,2
S01006855,Owned: Owned with a mortgage or loan or shared ownership,108,100,78,4,74,22,0,8,7,0,0,1,0
S01006855,Rented or living rent free: Total,70,57,31,3,28,26,0,13,10,1,0,2,0
S01006855,Rented or living rent free: Social rented,11,5,3,1,2,2,0,6,3,1,0,2,0
S01006855,Rented or living rent free: Private rented or living rent free,59,52,28,2,26,24,0,7,7,0,0,0,0
S01006856,All HRPs aged 16 and over,254,200,151,12,139,48,1,54,50,1,0,0,3
S01006856,Owned: Total,154,130,92,4,88,37,1,24,22,0,0,0,2
S01006856,Owned: Owned outright,80,57,39,2,37,17,1,23,21,0,0,0,2
S01006856,Owned: Owned with a mortgage or loan or shared ownership,74,73,53,2,51,20,0,1,1,0,0,0,0
S01006856,Rented or living rent free: Total,100,70,59,8,51,11,0,30,28,1,0,0,1
S01006856,Rented or living rent free: Social rented,1,0,0,0,0,0,0,1,0,1,0,0,0
S01006856,Rented or living rent free: Private rented or living rent free,99,70,59,8,51,11,0,29,28,0,0,0,1
S01006857,All HRPs aged 16 and over,398,319,211,27,184,106,2,79,74,1,0,3,1
S01006857,Owned: Total,232,196,132,16,116,64,0,36,36,0,0,0,0
S01006857,Owned: Owned outright,120,88,49,13,36,39,0,32,32,0,0,0,0
S01006857,Owned: Owned with a mortgage or loan or shared ownership,112,108,83,3,80,25,0,4,4,0,0,0,0
S01006857,Rented or living rent free: Total,166,123,79,11,68,42,2,43,38,1,0,3,1
S01006857,Rented or living rent free: Social rented,25,4,4,0,4,0,0,21,20,0,0,1,0
S01006857,Rented or living rent free: Private rented or living rent free,141,119,75,11,64,42,2,22,18,1,0,2,1
S01006858,All HRPs aged 16 and over,240,182,111,11,100,69,2,58,53,0,2,3,0
S01006858,Owned: Total,203,155,95,9,86,58,2,48,46,0,2,0,0
S01006858,Owned: Owned outright,112,68,35,6,29,32,1,44,43,0,1,0,0
S01006858,Owned: Owned with a mortgage or loan or shared ownership,91,87,60,3,57,26,1,4,3,0,1,0,0
S01006858,Rented or living rent free: Total,37,27,16,2,14,11,0,10,7,0,0,3,0
S01006858,Rented or living rent free: Social rented,2,1,1,0,1,0,0,1,0,0,0,1,0
S01006858,Rented or living rent free: Private rented or living rent free,35,26,15,2,13,11,0,9,7,0,0,2,0
S01006859,All HRPs aged 16 and over,421,314,262,21,241,52,0,107,100,1,1,1,4
S01006859,Owned: Total,381,281,236,21,215,45,0,100,94,0,1,1,4
S01006859,Owned: Owned outright,205,115,97,16,81,18,0,90,86,0,1,1,2
S01006859,Owned: Owned with a mortgage or loan or shared ownership,176,166,139,5,134,27,0,10,8,0,0,0,2
S01006859,Rented or living rent free: Total,40,33,26,0,26,7,0,7,6,1,0,0,0
S01006859,Rented or living rent free: Social rented,1,0,0,0,0,0,0,1,0,1,0,0,0
S01006859,Rented or living rent free: Private rented or living rent free,39,33,26,0,26,7,0,6,6,0,0,0,0
S01006860,All HRPs aged 16 and over,264,169,146,26,120,21,2,95,83,1,0,7,4
S01006860,Owned: Total,133,95,82,13,69,13,0,38,36,1,0,0,1
S01006860,Owned: Owned outright,70,33,27,9,18,6,0,37,35,1,0,0,1
S01006860,Owned: Owned with a mortgage or loan or shared ownership,63,62,55,4,51,7,0,1,1,0,0,0,0
S01006860,Rented or living rent free: Total,131,74,64,13,51,8,2,57,47,0,0,7,3
S01006860,Rented or living rent free: Social rented,107,56,50,13,37,4,2,51,42,0,0,6,3
S01006860,Rented or living rent free: Private rented or living rent free,24,18,14,0,14,4,0,6,5,0,0,1,0
S01006861,All HRPs aged 16 and over,195,183,156,9,147,27,0,12,10,0,1,1,0
S01006861,Owned: Total,169,158,133,8,125,25,0,11,10,0,1,0,0
S01006861,Owned: Owned outright,33,24,20,4,16,4,0,9,8,0,1,0,0
S01006861,Owned: Owned with a mortgage or loan or shared ownership,136,134,113,4,109,21,0,2,2,0,0,0,0
S01006861,Rented or living rent free: Total,26,25,23,1,22,2,0,1,0,0,0,1,0
S01006861,Rented or living rent free: Social rented,2,1,1,1,0,0,0,1,0,0,0,1,0
S01006861,Rented or living rent free: Private rented or living rent free,24,24,22,0,22,2,0,0,0,0,0,0,0
S01006862,All HRPs aged 16 and over,312,203,167,22,145,32,4,109,104,1,2,1,1
S01006862,Owned: Total,223,157,130,14,116,27,0,66,65,0,1,0,0
S01006862,Owned: Owned outright,116,57,41,6,35,16,0,59,59,0,0,0,0
S01006862,Owned: Owned with a mortgage or loan or shared ownership,107,100,89,8,81,11,0,7,6,0,1,0,0
S01006862,Rented or living rent free: Total,89,46,37,8,29,5,4,43,39,1,1,1,1
S01006862,Rented or living rent free: Social rented,68,27,23,8,15,1,3,41,37,1,1,1,1
S01006862,Rented or living rent free: Private rented or living rent free,21,19,14,0,14,4,1,2,2,0,0,0,0
S01006863,All HRPs aged 16 and over,295,192,155,14,141,33,4,103,95,0,2,4,2
S01006863,Owned: Total,221,143,116,9,107,25,2,78,75,0,1,0,2
S01006863,Owned: Owned outright,109,37,29,6,23,7,1,72,70,0,0,0,2
S01006863,Owned: Owned with a mortgage or loan or shared ownership,112,106,87,3,84,18,1,6,5,0,1,0,0
S01006863,Rented or living rent free: Total,74,49,39,5,34,8,2,25,20,0,1,4,0
S01006863,Rented or living rent free: Social rented,48,27,21,3,18,4,2,21,18,0,0,3,0
S01006863,Rented or living rent free: Private rented or living rent free,26,22,18,2,16,4,0,4,2,0,1,1,0
S01006864,All HRPs aged 16 and over,165,144,126,21,105,13,5,21,14,2,0,5,0
S01006864,Owned: Total,89,77,68,6,62,9,0,12,11,0,0,1,0
S01006864,Owned: Owned outright,23,15,14,3,11,1,0,8,8,0,0,0,0
S01006864,Owned: Owned with a mortgage or loan or shared ownership,66,62,54,3,51,8,0,4,3,0,0,1,0
S01006864,Rented or living rent free: Total,76,67,58,15,43,4,5,9,3,2,0,4,0
S01006864,Rented or living rent free: Social rented,62,53,45,12,33,4,4,9,3,2,0,4,0
S01006864,Rented or living rent free: Private rented or living rent free,14,14,13,3,10,0,1,0,0,0,0,0,0
S01006865,All HRPs aged 16 and over,424,300,248,23,225,50,2,124,111,1,4,6,2
S01006865,Owned: Total,324,216,173,13,160,42,1,108,104,1,2,0,1
S01006865,Owned: Owned outright,180,84,66,7,59,18,0,96,92,1,2,0,1
S01006865,Owned: Owned with a mortgage or loan or shared ownership,144,132,107,6,101,24,1,12,12,0,0,0,0
S01006865,Rented or living rent free: Total,100,84,75,10,65,8,1,16,7,0,2,6,1
S01006865,Rented or living rent free: Social rented,18,10,10,2,8,0,0,8,3,0,0,4,1
S01006865,Rented or living rent free: Private rented or living rent free,82,74,65,8,57,8,1,8,4,0,2,2,0
S01006866,All HRPs aged 16 and over,220,130,109,15,94,20,1,90,88,0,1,0,1
S01006866,Owned: Total,197,113,94,12,82,18,1,84,82,0,1,0,1
S01006866,Owned: Owned outright,132,50,39,9,30,10,1,82,81,0,0,0,1
S01006866,Owned: Owned with a mortgage or loan or shared ownership,65,63,55,3,52,8,0,2,1,0,1,0,0
S01006866,Rented or living rent free: Total,23,17,15,3,12,2,0,6,6,0,0,0,0
S01006866,Rented or living rent free: Social rented,5,2,2,1,1,0,0,3,3,0,0,0,0
S01006866,Rented or living rent free: Private rented or living rent free,18,15,13,2,11,2,0,3,3,0,0,0,0
S01006867,All HRPs aged 16 and over,293,176,129,18,111,43,4,117,109,1,0,6,1
S01006867,Owned: Total,242,151,106,14,92,41,4,91,88,1,0,1,1
S01006867,Owned: Owned outright,161,74,52,10,42,20,2,87,85,0,0,1,1
S01006867,Owned: Owned with a mortgage or loan or shared ownership,81,77,54,4,50,21,2,4,3,1,0,0,0
S01006867,Rented or living rent free: Total,51,25,23,4,19,2,0,26,21,0,0,5,0
S01006867,Rented or living rent free: Social rented,23,5,5,2,3,0,0,18,13,0,0,5,0
S01006867,Rented or living rent free: Private rented or living rent free,28,20,18,2,16,2,0,8,8,0,0,0,0
S01006868,All HRPs aged 16 and over,364,243,206,28,178,35,2,121,110,1,2,7,1
S01006868,Owned: Total,229,165,138,10,128,27,0,64,60,0,1,2,1
S01006868,Owned: Owned outright,114,56,46,5,41,10,0,58,55,0,1,2,0
S01006868,Owned: Owned with a mortgage or loan or shared ownership,115,109,92,5,87,17,0,6,5,0,0,0,1
S01006868,Rented or living rent free: Total,135,78,68,18,50,8,2,57,50,1,1,5,0
S01006868,Rented or living rent free: Social rented,106,53,50,17,33,3,0,53,46,1,1,5,0
S01006868,Rented or living rent free: Private rented or living rent free,29,25,18,1,17,5,2,4,4,0,0,0,0
S01006869,All HRPs aged 16 and over,197,143,106,18,88,35,2,54,44,0,2,7,1
S01006869,Owned: Total,114,79,54,8,46,24,1,35,32,0,2,1,0
S01006869,Owned: Owned outright,58,28,17,3,14,11,0,30,28,0,1,1,0
S01006869,Owned: Owned with a mortgage or loan or shared ownership,56,51,37,5,32,13,1,5,4,0,1,0,0
S01006869,Rented or living rent free: Total,83,64,52,10,42,11,1,19,12,0,0,6,1
S01006869,Rented or living rent free: Social rented,14,8,7,2,5,1,0,6,3,0,0,2,1
S01006869,Rented or living rent free: Private rented or living rent free,69,56,45,8,37,10,1,13,9,0,0,4,0
S01006870,All HRPs aged 16 and over,196,133,94,12,82,35,4,63,60,0,1,2,0
S01006870,Owned: Total,158,106,74,9,65,31,1,52,51,0,0,1,0
S01006870,Owned: Owned outright,88,38,22,6,16,16,0,50,50,0,0,0,0
S01006870,Owned: Owned with a mortgage or loan or shared ownership,70,68,52,3,49,15,1,2,1,0,0,1,0
S01006870,Rented or living rent free: Total,38,27,20,3,17,4,3,11,9,0,1,1,0
S01006870,Rented or living rent free: Social rented,18,10,7,1,6,2,1,8,6,0,1,1,0
S01006870,Rented or living rent free: Private rented or living rent free,20,17,13,2,11,2,2,3,3,0,0,0,0
S01006871,All HRPs aged 16 and over,265,187,154,16,138,30,3,78,68,0,4,6,0
S01006871,Owned: Total,205,152,126,13,113,24,2,53,52,0,1,0,0
S01006871,Owned: Owned outright,102,51,38,9,29,11,2,51,51,0,0,0,0
S01006871,Owned: Owned with a mortgage or loan or shared ownership,103,101,88,4,84,13,0,2,1,0,1,0,0
S01006871,Rented or living rent free: Total,60,35,28,3,25,6,1,25,16,0,3,6,0
S01006871,Rented or living rent free: Social rented,47,23,19,3,16,3,1,24,15,0,3,6,0
S01006871,Rented or living rent free: Private rented or living rent free,13,12,9,0,9,3,0,1,1,0,0,0,0
S01006872,All HRPs aged 16 and over,252,206,154,15,139,52,0,46,46,0,0,0,0
S01006872,Owned: Total,183,144,107,9,98,37,0,39,39,0,0,0,0
S01006872,Owned: Owned outright,108,70,49,9,40,21,0,38,38,0,0,0,0
S01006872,Owned: Owned with a mortgage or loan or shared ownership,75,74,58,0,58,16,0,1,1,0,0,0,0
S01006872,Rented or living rent free: Total,69,62,47,6,41,15,0,7,7,0,0,0,0
S01006872,Rented or living rent free: Social rented,1,0,0,0,0,0,0,1,1,0,0,0,0
S01006872,Rented or living rent free: Private rented or living rent free,68,62,47,6,41,15,0,6,6,0,0,0,0
S01006873,All HRPs aged 16 and over,426,239,163,21,142,73,3,187,175,0,6,2,4
S01006873,Owned: Total,315,150,102,12,90,48,0,165,161,0,2,0,2
S01006873,Owned: Owned outright,223,67,42,8,34,25,0,156,153,0,1,0,2
S01006873,Owned: Owned with a mortgage or loan or shared ownership,92,83,60,4,56,23,0,9,8,0,1,0,0
S01006873,Rented or living rent free: Total,111,89,61,9,52,25,3,22,14,0,4,2,2
S01006873,Rented or living rent free: Social rented,15,8,5,2,3,1,2,7,3,0,2,2,0
S01006873,Rented or living rent free: Private rented or living rent free,96,81,56,7,49,24,1,15,11,0,2,0,2
S01006874,All HRPs aged 16 and over,216,172,122,12,110,49,1,44,40,0,1,1,2
S01006874,Owned: Total,143,108,78,4,74,30,0,35,33,0,0,0,2
S01006874,Owned: Owned outright,85,50,35,2,33,15,0,35,33,0,0,0,2
S01006874,Owned: Owned with a mortgage or loan or shared ownership,58,58,43,2,41,15,0,0,0,0,0,0,0
S01006874,Rented or living rent free: Total,73,64,44,8,36,19,1,9,7,0,1,1,0
S01006874,Rented or living rent free: Social rented,6,4,4,2,2,0,0,2,2,0,0,0,0
S01006874,Rented or living rent free: Private rented or living rent free,67,60,40,6,34,19,1,7,5,0,1,1,0
S01006875,All HRPs aged 16 and over,321,199,136,23,113,53,10,122,105,0,7,5,5
S01006875,Owned: Total,187,133,88,11,77,44,1,54,50,0,2,1,1
S01006875,Owned: Owned outright,109,58,34,9,25,24,0,51,49,0,1,1,0
S01006875,Owned: Owned with a mortgage or loan or shared ownership,78,75,54,2,52,20,1,3,1,0,1,0,1
S01006875,Rented or living rent free: Total,134,66,48,12,36,9,9,68,55,0,5,4,4
S01006875,Rented or living rent free: Social rented,90,40,26,8,18,6,8,50,39,0,3,4,4
S01006875,Rented or living rent free: Private rented or living rent free,44,26,22,4,18,3,1,18,16,0,2,0,0
S01006876,All HRPs aged 16 and over,396,292,202,17,185,85,5,104,91,0,4,9,0
S01006876,Owned: Total,310,239,165,14,151,71,3,71,68,0,3,0,0
S01006876,Owned: Owned outright,159,95,62,9,53,33,0,64,62,0,2,0,0
S01006876,Owned: Owned with a mortgage or loan or shared ownership,151,144,103,5,98,38,3,7,6,0,1,0,0
S01006876,Rented or living rent free: Total,86,53,37,3,34,14,2,33,23,0,1,9,0
S01006876,Rented or living rent free: Social rented,44,23,19,3,16,2,2,21,13,0,0,8,0
S01006876,Rented or living rent free: Private rented or living rent free,42,30,18,0,18,12,0,12,10,0,1,1,0
S01006877,All HRPs aged 16 and over,372,296,198,13,185,96,2,76,70,1,0,4,1
S01006877,Owned: Total,275,213,143,9,134,70,0,62,59,1,0,1,1
S01006877,Owned: Owned outright,146,90,50,8,42,40,0,56,54,1,0,1,0
S01006877,Owned: Owned with a mortgage or loan or shared ownership,129,123,93,1,92,30,0,6,5,0,0,0,1
S01006877,Rented or living rent free: Total,97,83,55,4,51,26,2,14,11,0,0,3,0
S01006877,Rented or living rent free: Social rented,7,5,3,1,2,2,0,2,0,0,0,2,0
S01006877,Rented or living rent free: Private rented or living rent free,90,78,52,3,49,24,2,12,11,0,0,1,0
S01006878,All HRPs aged 16 and over,322,231,147,29,118,81,3,91,84,1,2,3,1
S01006878,Owned: Total,201,147,99,18,81,47,1,54,54,0,0,0,0
S01006878,Owned: Owned outright,119,68,36,13,23,31,1,51,51,0,0,0,0
S01006878,Owned: Owned with a mortgage or loan or shared ownership,82,79,63,5,58,16,0,3,3,0,0,0,0
S01006878,Rented or living rent free: Total,121,84,48,11,37,34,2,37,30,1,2,3,1
S01006878,Rented or living rent free: Social rented,48,24,18,5,13,4,2,24,20,1,1,2,0
S01006878,Rented or living rent free: Private rented or living rent free,73,60,30,6,24,30,0,13,10,0,1,1,1
S01006879,All HRPs aged 16 and over,322,243,154,16,138,86,3,79,71,4,2,2,0
S01006879,Owned: Total,185,130,75,7,68,55,0,55,54,0,1,0,0
S01006879,Owned: Owned outright,120,69,35,6,29,34,0,51,50,0,1,0,0
S01006879,Owned: Owned with a mortgage or loan or shared ownership,65,61,40,1,39,21,0,4,4,0,0,0,0
S01006879,Rented or living rent free: Total,137,113,79,9,70,31,3,24,17,4,1,2,0
S01006879,Rented or living rent free: Social rented,5,2,1,0,1,1,0,3,2,0,0,1,0
S01006879,Rented or living rent free: Private rented or living rent free,132,111,78,9,69,30,3,21,15,4,1,1,0
S01006880,All HRPs aged 16 and over,227,185,149,8,141,35,1,42,33,3,3,1,2
S01006880,Owned: Total,185,154,125,5,120,29,0,31,26,2,2,0,1
S01006880,Owned: Owned outright,74,44,36,5,31,8,0,30,26,2,1,0,1
S01006880,Owned: Owned with a mortgage or loan or shared ownership,111,110,89,0,89,21,0,1,0,0,1,0,0
S01006880,Rented or living rent free: Total,42,31,24,3,21,6,1,11,7,1,1,1,1
S01006880,Rented or living rent free: Social rented,9,7,6,2,4,1,0,2,0,0,1,1,0
S01006880,Rented or living rent free: Private rented or living rent free,33,24,18,1,17,5,1,9,7,1,0,0,1
S01006881,All HRPs aged 16 and over,227,178,128,11,117,48,2,49,48,0,0,1,0
S01006881,Owned: Total,180,140,103,9,94,36,1,40,40,0,0,0,0
S01006881,Owned: Owned outright,105,68,48,6,42,19,1,37,37,0,0,0,0
S01006881,Owned: Owned with a mortgage or loan or shared ownership,75,72,55,3,52,17,0,3,3,0,0,0,0
S01006881,Rented or living rent free: Total,47,38,25,2,23,12,1,9,8,0,0,1,0
S01006881,Rented or living rent free: Social rented,3,3,3,1,2,0,0,0,0,0,0,0,0
S01006881,Rented or living rent free: Private rented or living rent free,44,35,22,1,21,12,1,9,8,0,0,1,0
S01006882,All HRPs aged 16 and over,207,105,90,12,78,11,4,102,92,0,2,4,4
S01006882,Owned: Total,101,69,60,4,56,8,1,32,31,0,0,0,1
S01006882,Owned: Owned outright,55,25,20,2,18,5,0,30,30,0,0,0,0
S01006882,Owned: Owned with a mortgage or loan or shared ownership,46,44,40,2,38,3,1,2,1,0,0,0,1
S01006882,Rented or living rent free: Total,106,36,30,8,22,3,3,70,61,0,2,4,3
S01006882,Rented or living rent free: Social rented,91,26,20,7,13,3,3,65,58,0,1,3,3
S01006882,Rented or living rent free: Private rented or living rent free,15,10,10,1,9,0,0,5,3,0,1,1,0
S01006883,All HRPs aged 16 and over,217,144,116,17,99,24,4,73,66,0,1,5,1
S01006883,Owned: Total,154,104,86,12,74,18,0,50,46,0,1,2,1
S01006883,Owned: Owned outright,73,29,24,7,17,5,0,44,41,0,0,2,1
S01006883,Owned: Owned with a mortgage or loan or shared ownership,81,75,62,5,57,13,0,6,5,0,1,0,0
S01006883,Rented or living rent free: Total,63,40,30,5,25,6,4,23,20,0,0,3,0
S01006883,Rented or living rent free: Social rented,41,22,15,3,12,3,4,19,16,0,0,3,0
S01006883,Rented or living rent free: Private rented or living rent free,22,18,15,2,13,3,0,4,4,0,0,0,0
S01006884,All HRPs aged 16 and over,390,254,206,29,177,42,6,136,130,0,1,2,3
S01006884,Owned: Total,321,213,174,23,151,37,2,108,104,0,1,1,2
S01006884,Owned: Owned outright,174,76,57,14,43,18,1,98,96,0,0,0,2
S01006884,Owned: Owned with a mortgage or loan or shared ownership,147,137,117,9,108,19,1,10,8,0,1,1,0
S01006884,Rented or living rent free: Total,69,41,32,6,26,5,4,28,26,0,0,1,1
S01006884,Rented or living rent free: Social rented,44,23,17,4,13,2,4,21,20,0,0,1,0
S01006884,Rented or living rent free: Private rented or living rent free,25,18,15,2,13,3,0,7,6,0,0,0,1
S01006885,All HRPs aged 16 and over,220,149,109,12,97,40,0,71,69,0,1,0,1
S01006885,Owned: Total,193,128,97,12,85,31,0,65,63,0,1,0,1
S01006885,Owned: Owned outright,114,54,34,8,26,20,0,60,59,0,0,0,1
S01006885,Owned: Owned with a mortgage or loan or shared ownership,79,74,63,4,59,11,0,5,4,0,1,0,0
S01006885,Rented or living rent free: Total,27,21,12,0,12,9,0,6,6,0,0,0,0
S01006885,Rented or living rent free: Social rented,9,6,4,0,4,2,0,3,3,0,0,0,0
S01006885,Rented or living rent free: Private rented or living rent free,18,15,8,0,8,7,0,3,3,0,0,0,0
S01006886,All HRPs aged 16 and over,321,246,181,21,160,60,5,75,66,0,2,6,1
S01006886,Owned: Total,218,171,130,16,114,38,3,47,46,0,1,0,0
S01006886,Owned: Owned outright,129,86,62,13,49,22,2,43,43,0,0,0,0
S01006886,Owned: Owned with a mortgage or loan or shared ownership,89,85,68,3,65,16,1,4,3,0,1,0,0
S01006886,Rented or living rent free: Total,103,75,51,5,46,22,2,28,20,0,1,6,1
S01006886,Rented or living rent free: Social rented,30,17,14,2,12,3,0,13,8,0,0,4,1
S01006886,Rented or living rent free: Private rented or living rent free,73,58,37,3,34,19,2,15,12,0,1,2,0
S01006887,All HRPs aged 16 and over,213,178,130,15,115,43,5,35,31,0,2,2,0
S01006887,Owned: Total,170,145,106,8,98,37,2,25,24,0,1,0,0
S01006887,Owned: Owned outright,74,50,31,4,27,17,2,24,24,0,0,0,0
S01006887,Owned: Owned with a mortgage or loan or shared ownership,96,95,75,4,71,20,0,1,0,0,1,0,0
S01006887,Rented or living rent free: Total,43,33,24,7,17,6,3,10,7,0,1,2,0
S01006887,Rented or living rent free: Social rented,18,12,9,5,4,2,1,6,4,0,1,1,0
S01006887,Rented or living rent free: Private rented or living rent free,25,21,15,2,13,4,2,4,3,0,0,1,0
S01006888,All HRPs aged 16 and over,309,250,178,15,163,68,4,59,51,0,4,2,2
S01006888,Owned: Total,257,214,157,14,143,55,2,43,40,0,1,0,2
S01006888,Owned: Owned outright,114,74,43,10,33,29,2,40,38,0,0,0,2
S01006888,Owned: Owned with a mortgage or loan or shared ownership,143,140,114,4,110,26,0,3,2,0,1,0,0
S01006888,Rented or living rent free: Total,52,36,21,1,20,13,2,16,11,0,3,2,0
S01006888,Rented or living rent free: Social rented,22,14,10,0,10,3,1,8,6,0,1,1,0
S01006888,Rented or living rent free: Private rented or living rent free,30,22,11,1,10,10,1,8,5,0,2,1,0
S01006889,All HRPs aged 16 and over,350,252,224,32,192,17,11,98,77,1,4,9,7
S01006889,Owned: Total,194,152,137,11,126,12,3,42,37,0,1,2,2
S01006889,Owned: Owned outright,85,50,43,8,35,6,1,35,33,0,0,0,2
S01006889,Owned: Owned with a mortgage or loan or shared ownership,109,102,94,3,91,6,2,7,4,0,1,2,0
S01006889,Rented or living rent free: Total,156,100,87,21,66,5,8,56,40,1,3,7,5
S01006889,Rented or living rent free: Social rented,147,92,80,21,59,4,8,55,39,1,3,7,5
S01006889,Rented or living rent free: Private rented or living rent free,9,8,7,0,7,1,0,1,1,0,0,0,0
S01006890,All HRPs aged 16 and over,264,206,172,18,154,29,5,58,53,1,1,3,0
S01006890,Owned: Total,224,175,146,14,132,28,1,49,46,1,1,1,0
S01006890,Owned: Owned outright,98,54,36,10,26,17,1,44,42,0,1,1,0
S01006890,Owned: Owned with a mortgage or loan or shared ownership,126,121,110,4,106,11,0,5,4,1,0,0,0
S01006890,Rented or living rent free: Total,40,31,26,4,22,1,4,9,7,0,0,2,0
S01006890,Rented or living rent free: Social rented,28,21,18,3,15,0,3,7,5,0,0,2,0
S01006890,Rented or living rent free: Private rented or living rent free,12,10,8,1,7,1,1,2,2,0,0,0,0
S01006891,All HRPs aged 16 and over,400,290,252,22,230,35,3,110,98,0,5,6,1
S01006891,Owned: Total,280,223,194,15,179,28,1,57,55,0,1,1,0
S01006891,Owned: Owned outright,118,69,56,8,48,12,1,49,48,0,1,0,0
S01006891,Owned: Owned with a mortgage or loan or shared ownership,162,154,138,7,131,16,0,8,7,0,0,1,0
S01006891,Rented or living rent free: Total,120,67,58,7,51,7,2,53,43,0,4,5,1
S01006891,Rented or living rent free: Social rented,94,43,36,7,29,5,2,51,41,0,4,5,1
S01006891,Rented or living rent free: Private rented or living rent free,26,24,22,0,22,2,0,2,2,0,0,0,0
S01006892,All HRPs aged 16 and over,275,185,162,17,145,20,3,90,72,1,4,6,7
S01006892,Owned: Total,141,113,97,8,89,16,0,28,25,0,0,2,1
S01006892,Owned: Owned outright,43,21,15,2,13,6,0,22,20,0,0,2,0
S01006892,Owned: Owned with a mortgage or loan or shared ownership,98,92,82,6,76,10,0,6,5,0,0,0,1
S01006892,Rented or living rent free: Total,134,72,65,9,56,4,3,62,47,1,4,4,6
S01006892,Rented or living rent free: Social rented,128,68,61,8,53,4,3,60,46,1,4,3,6
S01006892,Rented or living rent free: Private rented or living rent free,6,4,4,1,3,0,0,2,1,0,0,1,0
S01006893,All HRPs aged 16 and over,196,139,118,22,96,19,2,57,47,0,6,2,2
S01006893,Owned: Total,127,92,74,8,66,17,1,35,32,0,1,0,2
S01006893,Owned: Owned outright,58,28,20,6,14,7,1,30,28,0,0,0,2
S01006893,Owned: Owned with a mortgage or loan or shared ownership,69,64,54,2,52,10,0,5,4,0,1,0,0
S01006893,Rented or living rent free: Total,69,47,44,14,30,2,1,22,15,0,5,2,0
S01006893,Rented or living rent free: Social rented,64,43,40,14,26,2,1,21,15,0,4,2,0
S01006893,Rented or living rent free: Private rented or living rent free,5,4,4,0,4,0,0,1,0,0,1,0,0
S01006894,All HRPs aged 16 and over,448,265,237,33,204,26,2,183,167,0,0,12,4
S01006894,Owned: Total,319,225,201,22,179,24,0,94,93,0,0,1,0
S01006894,Owned: Owned outright,171,80,69,11,58,11,0,91,90,0,0,1,0
S01006894,Owned: Owned with a mortgage or loan or shared ownership,148,145,132,11,121,13,0,3,3,0,0,0,0
S01006894,Rented or living rent free: Total,129,40,36,11,25,2,2,89,74,0,0,11,4
S01006894,Rented or living rent free: Social rented,114,26,24,10,14,1,1,88,73,0,0,11,4
S01006894,Rented or living rent free: Private rented or living rent free,15,14,12,1,11,1,1,1,1,0,0,0,0
S01006895,All HRPs aged 16 and over,266,195,171,16,155,18,6,71,60,0,2,8,1
S01006895,Owned: Total,168,128,112,10,102,14,2,40,39,0,0,1,0
S01006895,Owned: Owned outright,70,33,29,5,24,4,0,37,37,0,0,0,0
S01006895,Owned: Owned with a mortgage or loan or shared ownership,98,95,83,5,78,10,2,3,2,0,0,1,0
S01006895,Rented or living rent free: Total,98,67,59,6,53,4,4,31,21,0,2,7,1
S01006895,Rented or living rent free: Social rented,61,36,30,4,26,2,4,25,16,0,1,7,1
S01006895,Rented or living rent free: Private rented or living rent free,37,31,29,2,27,2,0,6,5,0,1,0,0
S01006896,All HRPs aged 16 and over,361,253,231,30,201,18,4,108,99,2,4,1,2
S01006896,Owned: Total,273,201,183,20,163,15,3,72,72,0,0,0,0
S01006896,Owned: Owned outright,150,84,76,15,61,6,2,66,66,0,0,0,0
S01006896,Owned: Owned with a mortgage or loan or shared ownership,123,117,107,5,102,9,1,6,6,0,0,0,0
S01006896,Rented or living rent free: Total,88,52,48,10,38,3,1,36,27,2,4,1,2
S01006896,Rented or living rent free: Social rented,50,22,19,9,10,2,1,28,22,1,4,1,0
S01006896,Rented or living rent free: Private rented or living rent free,38,30,29,1,28,1,0,8,5,1,0,0,2
S01006897,All HRPs aged 16 and over,290,221,196,16,180,25,0,69,63,0,2,3,1
S01006897,Owned: Total,253,193,169,13,156,24,0,60,57,0,0,2,1
S01006897,Owned: Owned outright,109,55,45,9,36,10,0,54,52,0,0,2,0
S01006897,Owned: Owned with a mortgage or loan or shared ownership,144,138,124,4,120,14,0,6,5,0,0,0,1
S01006897,Rented or living rent free: Total,37,28,27,3,24,1,0,9,6,0,2,1,0
S01006897,Rented or living rent free: Social rented,17,10,10,1,9,0,0,7,4,0,2,1,0
S01006897,Rented or living rent free: Private rented or living rent free,20,18,17,2,15,1,0,2,2,0,0,0,0
S01006898,All HRPs aged 16 and over,340,251,228,26,202,20,3,89,73,1,6,7,2
S01006898,Owned: Total,264,197,179,16,163,17,1,67,65,0,0,1,1
S01006898,Owned: Owned outright,135,71,65,11,54,6,0,64,62,0,0,1,1
S01006898,Owned: Owned with a mortgage or loan or shared ownership,129,126,114,5,109,11,1,3,3,0,0,0,0
S01006898,Rented or living rent free: Total,76,54,49,10,39,3,2,22,8,1,6,6,1
S01006898,Rented or living rent free: Social rented,48,32,27,9,18,3,2,16,3,1,6,5,1
S01006898,Rented or living rent free: Private rented or living rent free,28,22,22,1,21,0,0,6,5,0,0,1,0
S01006899,All HRPs aged 16 and over,242,204,190,19,171,13,1,38,36,0,0,2,0
S01006899,Owned: Total,224,189,177,16,161,11,1,35,34,0,0,1,0
S01006899,Owned: Owned outright,83,49,45,9,36,3,1,34,33,0,0,1,0
S01006899,Owned: Owned with a mortgage or loan or shared ownership,141,140,132,7,125,8,0,1,1,0,0,0,0
S01006899,Rented or living rent free: Total,18,15,13,3,10,2,0,3,2,0,0,1,0
S01006899,Rented or living rent free: Social rented,5,4,2,2,0,2,0,1,0,0,0,1,0
S01006899,Rented or living rent free: Private rented or living rent free,13,11,11,1,10,0,0,2,2,0,0,0,0
S01006900,All HRPs aged 16 and over,234,186,171,9,162,15,0,48,47,0,0,1,0
S01006900,Owned: Total,216,173,161,8,153,12,0,43,43,0,0,0,0
S01006900,Owned: Owned outright,72,33,30,5,25,3,0,39,39,0,0,0,0
S01006900,Owned: Owned with a mortgage or loan or shared ownership,144,140,131,3,128,9,0,4,4,0,0,0,0
S01006900,Rented or living rent free: Total,18,13,10,1,9,3,0,5,4,0,0,1,0
S01006900,Rented or living rent free: Social rented,3,2,1,0,1,1,0,1,0,0,0,1,0
S01006900,Rented or living rent free: Private rented or living rent free,15,11,9,1,8,2,0,4,4,0,0,0,0
S01006901,All HRPs aged 16 and over,270,189,169,29,140,14,6,81,70,2,2,6,1
S01006901,Owned: Total,144,121,106,10,96,14,1,23,20,0,1,1,1
S01006901,Owned: Owned outright,51,32,29,8,21,3,0,19,17,0,0,1,1
S01006901,Owned: Owned with a mortgage or loan or shared ownership,93,89,77,2,75,11,1,4,3,0,1,0,0
S01006901,Rented or living rent free: Total,126,68,63,19,44,0,5,58,50,2,1,5,0
S01006901,Rented or living rent free: Social rented,106,51,47,19,28,0,4,55,48,1,1,5,0
S01006901,Rented or living rent free: Private rented or living rent free,20,17,16,0,16,0,1,3,2,1,0,0,0
S01006902,All HRPs aged 16 and over,296,219,192,23,169,19,8,77,61,0,6,6,4
S01006902,Owned: Total,151,128,112,9,103,15,1,23,22,0,0,1,0
S01006902,Owned: Owned outright,57,38,35,8,27,3,0,19,19,0,0,0,0
S01006902,Owned: Owned with a mortgage or loan or shared ownership,94,90,77,1,76,12,1,4,3,0,0,1,0
S01006902,Rented or living rent free: Total,145,91,80,14,66,4,7,54,39,0,6,5,4
S01006902,Rented or living rent free: Social rented,125,72,62,14,48,3,7,53,39,0,5,5,4
S01006902,Rented or living rent free: Private rented or living rent free,20,19,18,0,18,1,0,1,0,0,1,0,0
S01006903,All HRPs aged 16 and over,349,249,220,35,185,21,8,100,77,2,8,11,2
S01006903,Owned: Total,201,150,132,20,112,17,1,51,47,0,2,1,1
S01006903,Owned: Owned outright,80,34,25,14,11,9,0,46,44,0,1,0,1
S01006903,Owned: Owned with a mortgage or loan or shared ownership,121,116,107,6,101,8,1,5,3,0,1,1,0
S01006903,Rented or living rent free: Total,148,99,88,15,73,4,7,49,30,2,6,10,1
S01006903,Rented or living rent free: Social rented,123,81,72,14,58,3,6,42,25,2,5,10,0
S01006903,Rented or living rent free: Private rented or living rent free,25,18,16,1,15,1,1,7,5,0,1,0,1
S01006904,All HRPs aged 16 and over,330,207,180,26,154,24,3,123,106,0,6,8,3
S01006904,Owned: Total,221,126,104,11,93,20,2,95,89,0,2,1,3
S01006904,Owned: Owned outright,119,45,35,7,28,10,0,74,70,0,0,1,3
S01006904,Owned: Owned with a mortgage or loan or shared ownership,102,81,69,4,65,10,2,21,19,0,2,0,0
S01006904,Rented or living rent free: Total,109,81,76,15,61,4,1,28,17,0,4,7,0
S01006904,Rented or living rent free: Social rented,53,36,34,14,20,1,1,17,6,0,4,7,0
S01006904,Rented or living rent free: Private rented or living rent free,56,45,42,1,41,3,0,11,11,0,0,0,0
S01006905,All HRPs aged 16 and over,395,225,190,24,166,34,1,170,161,0,2,7,0
S01006905,Owned: Total,291,185,154,14,140,30,1,106,104,0,0,2,0
S01006905,Owned: Owned outright,167,68,58,11,47,9,1,99,99,0,0,0,0
S01006905,Owned: Owned with a mortgage or loan or shared ownership,124,117,96,3,93,21,0,7,5,0,0,2,0
S01006905,Rented or living rent free: Total,104,40,36,10,26,4,0,64,57,0,2,5,0
S01006905,Rented or living rent free: Social rented,85,26,23,9,14,3,0,59,53,0,1,5,0
S01006905,Rented or living rent free: Private rented or living rent free,19,14,13,1,12,1,0,5,4,0,1,0,0
S01006906,All HRPs aged 16 and over,441,240,205,45,160,24,11,201,172,1,8,16,4
S01006906,Owned: Total,193,126,108,14,94,17,1,67,63,0,1,1,2
S01006906,Owned: Owned outright,104,48,40,13,27,7,1,56,53,0,0,1,2
S01006906,Owned: Owned with a mortgage or loan or shared ownership,89,78,68,1,67,10,0,11,10,0,1,0,0
S01006906,Rented or living rent free: Total,248,114,97,31,66,7,10,134,109,1,7,15,2
S01006906,Rented or living rent free: Social rented,223,100,84,29,55,6,10,123,102,1,4,14,2
S01006906,Rented or living rent free: Private rented or living rent free,25,14,13,2,11,1,0,11,7,0,3,1,0
S01006907,All HRPs aged 16 and over,305,220,188,17,171,30,2,85,64,1,3,14,3
S01006907,Owned: Total,176,123,102,7,95,21,0,53,51,0,0,0,2
S01006907,Owned: Owned outright,88,36,32,4,28,4,0,52,50,0,0,0,2
S01006907,Owned: Owned with a mortgage or loan or shared ownership,88,87,70,3,67,17,0,1,1,0,0,0,0
S01006907,Rented or living rent free: Total,129,97,86,10,76,9,2,32,13,1,3,14,1
S01006907,Rented or living rent free: Social rented,53,28,26,8,18,2,0,25,9,1,2,12,1
S01006907,Rented or living rent free: Private rented or living rent free,76,69,60,2,58,7,2,7,4,0,1,2,0
S01006908,All HRPs aged 16 and over,426,278,240,40,200,25,13,148,123,3,3,13,6
S01006908,Owned: Total,267,179,151,21,130,24,4,88,81,0,0,2,5
S01006908,Owned: Owned outright,148,65,55,14,41,7,3,83,79,0,0,0,4
S01006908,Owned: Owned with a mortgage or loan or shared ownership,119,114,96,7,89,17,1,5,2,0,0,2,1
S01006908,Rented or living rent free: Total,159,99,89,19,70,1,9,60,42,3,3,11,1
S01006908,Rented or living rent free: Social rented,100,47,40,15,25,0,7,53,37,3,2,10,1
S01006908,Rented or living rent free: Private rented or living rent free,59,52,49,4,45,1,2,7,5,0,1,1,0
S01006909,All HRPs aged 16 and over,275,236,199,8,191,36,1,39,37,0,2,0,0
S01006909,Owned: Total,254,220,184,7,177,35,1,34,32,0,2,0,0
S01006909,Owned: Owned outright,78,46,36,4,32,9,1,32,31,0,1,0,0
S01006909,Owned: Owned with a mortgage or loan or shared ownership,176,174,148,3,145,26,0,2,1,0,1,0,0
S01006909,Rented or living rent free: Total,21,16,15,1,14,1,0,5,5,0,0,0,0
S01006909,Rented or living rent free: Social rented,3,1,1,0,1,0,0,2,2,0,0,0,0
S01006909,Rented or living rent free: Private rented or living rent free,18,15,14,1,13,1,0,3,3,0,0,0,0
S01006910,All HRPs aged 16 and over,353,294,226,22,204,66,2,59,52,0,2,3,2
S01006910,Owned: Total,284,238,181,18,163,56,1,46,43,0,2,0,1
S01006910,Owned: Owned outright,133,92,65,17,48,26,1,41,39,0,1,0,1
S01006910,Owned: Owned with a mortgage or loan or shared ownership,151,146,116,1,115,30,0,5,4,0,1,0,0
S01006910,Rented or living rent free: Total,69,56,45,4,41,10,1,13,9,0,0,3,1
S01006910,Rented or living rent free: Social rented,6,4,4,0,4,0,0,2,0,0,0,2,0
S01006910,Rented or living rent free: Private rented or living rent free,63,52,41,4,37,10,1,11,9,0,0,1,1
S01006911,All HRPs aged 16 and over,224,211,193,9,184,16,2,13,5,0,3,4,1
S01006911,Owned: Total,184,180,165,3,162,15,0,4,3,0,1,0,0
S01006911,Owned: Owned outright,16,13,8,2,6,5,0,3,3,0,0,0,0
S01006911,Owned: Owned with a mortgage or loan or shared ownership,168,167,157,1,156,10,0,1,0,0,1,0,0
S01006911,Rented or living rent free: Total,40,31,28,6,22,1,2,9,2,0,2,4,1
S01006911,Rented or living rent free: Social rented,30,23,20,6,14,1,2,7,1,0,2,3,1
S01006911,Rented or living rent free: Private rented or living rent free,10,8,8,0,8,0,0,2,1,0,0,1,0
S01006912,All HRPs aged 16 and over,170,142,97,15,82,44,1,28,25,0,1,1,1
S01006912,Owned: Total,128,105,66,8,58,38,1,23,22,0,0,0,1
S01006912,Owned: Owned outright,83,60,32,8,24,27,1,23,22,0,0,0,1
S01006912,Owned: Owned with a mortgage or loan or shared ownership,45,45,34,0,34,11,0,0,0,0,0,0,0
S01006912,Rented or living rent free: Total,42,37,31,7,24,6,0,5,3,0,1,1,0
S01006912,Rented or living rent free: Social rented,4,3,3,2,1,0,0,1,0,0,0,1,0
S01006912,Rented or living rent free: Private rented or living rent free,38,34,28,5,23,6,0,4,3,0,1,0,0
S01006913,All HRPs aged 16 and over,182,170,143,9,134,26,1,12,9,0,3,0,0
S01006913,Owned: Total,158,149,123,8,115,26,0,9,7,0,2,0,0
S01006913,Owned: Owned outright,44,36,25,2,23,11,0,8,7,0,1,0,0
S01006913,Owned: Owned with a mortgage or loan or shared ownership,114,113,98,6,92,15,0,1,0,0,1,0,0
S01006913,Rented or living rent free: Total,24,21,20,1,19,0,1,3,2,0,1,0,0
S01006913,Rented or living rent free: Social rented,1,1,1,0,1,0,0,0,0,0,0,0,0
S01006913,Rented or living rent free: Private rented or living rent free,23,20,19,1,18,0,1,3,2,0,1,0,0
S01006914,All HRPs aged 16 and over,273,238,177,15,162,60,1,35,30,1,0,3,1
S01006914,Owned: Total,212,180,126,11,115,53,1,32,29,0,0,2,1
S01006914,Owned: Owned outright,117,87,50,7,43,36,1,30,29,0,0,0,1
S01006914,Owned: Owned with a mortgage or loan or shared ownership,95,93,76,4,72,17,0,2,0,0,0,2,0
S01006914,Rented or living rent free: Total,61,58,51,4,47,7,0,3,1,1,0,1,0
S01006914,Rented or living rent free: Social rented,6,4,3,2,1,1,0,2,1,0,0,1,0
S01006914,Rented or living rent free: Private rented or living rent free,55,54,48,2,46,6,0,1,0,1,0,0,0
S01006915,All HRPs aged 16 and over,301,250,190,18,172,58,2,51,48,1,2,0,0
S01006915,Owned: Total,259,217,166,15,151,49,2,42,41,0,1,0,0
S01006915,Owned: Owned outright,129,88,62,11,51,26,0,41,40,0,1,0,0
S01006915,Owned: Owned with a mortgage or loan or shared ownership,130,129,104,4,100,23,2,1,1,0,0,0,0
S01006915,Rented or living rent free: Total,42,33,24,3,21,9,0,9,7,1,1,0,0
S01006915,Rented or living rent free: Social rented,17,10,9,3,6,1,0,7,5,1,1,0,0
S01006915,Rented or living rent free: Private rented or living rent free,25,23,15,0,15,8,0,2,2,0,0,0,0
S01006916,All HRPs aged 16 and over,207,178,151,22,129,22,5,29,15,0,5,7,2
S01006916,Owned: Total,142,127,108,10,98,17,2,15,14,0,0,1,0
S01006916,Owned: Owned outright,41,27,18,2,16,8,1,14,13,0,0,1,0
S01006916,Owned: Owned with a mortgage or loan or shared ownership,101,100,90,8,82,9,1,1,1,0,0,0,0
S01006916,Rented or living rent free: Total,65,51,43,12,31,5,3,14,1,0,5,6,2
S01006916,Rented or living rent free: Social rented,53,41,36,11,25,2,3,12,0,0,5,5,2
S01006916,Rented or living rent free: Private rented or living rent free,12,10,7,1,6,3,0,2,1,0,0,1,0
S01006917,All HRPs aged 16 and over,320,305,258,13,245,43,4,15,11,0,1,2,1
S01006917,Owned: Total,281,269,230,9,221,38,1,12,9,0,1,1,1
S01006917,Owned: Owned outright,34,24,18,2,16,6,0,10,8,0,0,1,1
S01006917,Owned: Owned with a mortgage or loan or shared ownership,247,245,212,7,205,32,1,2,1,0,1,0,0
S01006917,Rented or living rent free: Total,39,36,28,4,24,5,3,3,2,0,0,1,0
S01006917,Rented or living rent free: Social rented,23,21,14,3,11,4,3,2,1,0,0,1,0
S01006917,Rented or living rent free: Private rented or living rent free,16,15,14,1,13,1,0,1,1,0,0,0,0
S01006918,All HRPs aged 16 and over,195,147,122,10,112,21,4,48,42,0,1,4,1
S01006918,Owned: Total,158,120,101,5,96,19,0,38,35,0,0,2,1
S01006918,Owned: Owned outright,71,36,32,5,27,4,0,35,34,0,0,0,1
S01006918,Owned: Owned with a mortgage or loan or shared ownership,87,84,69,0,69,15,0,3,1,0,0,2,0
S01006918,Rented or living rent free: Total,37,27,21,5,16,2,4,10,7,0,1,2,0
S01006918,Rented or living rent free: Social rented,25,15,10,4,6,1,4,10,7,0,1,2,0
S01006918,Rented or living rent free: Private rented or living rent free,12,12,11,1,10,1,0,0,0,0,0,0,0
S01006919,All HRPs aged 16 and over,205,143,118,12,106,24,1,62,60,1,0,1,0
S01006919,Owned: Total,169,117,98,9,89,18,1,52,52,0,0,0,0
S01006919,Owned: Owned outright,102,50,43,7,36,6,1,52,52,0,0,0,0
S01006919,Owned: Owned with a mortgage or loan or shared ownership,67,67,55,2,53,12,0,0,0,0,0,0,0
S01006919,Rented or living rent free: Total,36,26,20,3,17,6,0,10,8,1,0,1,0
S01006919,Rented or living rent free: Social rented,22,12,9,3,6,3,0,10,8,1,0,1,0
S01006919,Rented or living rent free: Private rented or living rent free,14,14,11,0,11,3,0,0,0,0,0,0,0
S01006920,All HRPs aged 16 and over,243,164,145,16,129,18,1,79,69,0,3,2,5
S01006920,Owned: Total,161,115,101,7,94,13,1,46,43,0,1,1,1
S01006920,Owned: Owned outright,78,36,28,6,22,7,1,42,40,0,0,1,1
S01006920,Owned: Owned with a mortgage or loan or shared ownership,83,79,73,1,72,6,0,4,3,0,1,0,0
S01006920,Rented or living rent free: Total,82,49,44,9,35,5,0,33,26,0,2,1,4
S01006920,Rented or living rent free: Social rented,63,32,28,8,20,4,0,31,24,0,2,1,4
S01006920,Rented or living rent free: Private rented or living rent free,19,17,16,1,15,1,0,2,2,0,0,0,0
S01006921,All HRPs aged 16 and over,270,246,219,19,200,26,1,24,17,0,2,4,1
S01006921,Owned: Total,252,232,208,18,190,23,1,20,16,0,2,2,0
S01006921,Owned: Owned outright,57,39,31,12,19,8,0,18,16,0,0,2,0
S01006921,Owned: Owned with a mortgage or loan or shared ownership,195,193,177,6,171,15,1,2,0,0,2,0,0
S01006921,Rented or living rent free: Total,18,14,11,1,10,3,0,4,1,0,0,2,1
S01006921,Rented or living rent free: Social rented,6,3,2,1,1,1,0,3,1,0,0,2,0
S01006921,Rented or living rent free: Private rented or living rent free,12,11,9,0,9,2,0,1,0,0,0,0,1
S01006922,All HRPs aged 16 and over,201,154,117,14,103,35,2,47,41,1,2,2,1
S01006922,Owned: Total,170,130,95,13,82,33,2,40,36,0,2,2,0
S01006922,Owned: Owned outright,98,61,44,9,35,16,1,37,36,0,0,1,0
S01006922,Owned: Owned with a mortgage or loan or shared ownership,72,69,51,4,47,17,1,3,0,0,2,1,0
S01006922,Rented or living rent free: Total,31,24,22,1,21,2,0,7,5,1,0,0,1
S01006922,Rented or living rent free: Social rented,2,1,1,0,1,0,0,1,0,0,0,0,1
S01006922,Rented or living rent free: Private rented or living rent free,29,23,21,1,20,2,0,6,5,1,0,0,0
S01006923,All HRPs aged 16 and over,331,213,155,19,136,53,5,118,113,0,0,3,2
S01006923,Owned: Total,276,193,139,17,122,52,2,83,81,0,0,1,1
S01006923,Owned: Owned outright,166,87,53,13,40,33,1,79,77,0,0,1,1
S01006923,Owned: Owned with a mortgage or loan or shared ownership,110,106,86,4,82,19,1,4,4,0,0,0,0
S01006923,Rented or living rent free: Total,55,20,16,2,14,1,3,35,32,0,0,2,1
S01006923,Rented or living rent free: Social rented,38,4,3,1,2,1,0,34,31,0,0,2,1
S01006923,Rented or living rent free: Private rented or living rent free,17,16,13,1,12,0,3,1,1,0,0,0,0
S01006924,All HRPs aged 16 and over,208,181,126,10,116,55,0,27,22,1,3,0,1
S01006924,Owned: Total,174,150,106,9,97,44,0,24,20,0,3,0,1
S01006924,Owned: Owned outright,88,68,40,5,35,28,0,20,20,0,0,0,0
S01006924,Owned: Owned with a mortgage or loan or shared ownership,86,82,66,4,62,16,0,4,0,0,3,0,1
S01006924,Rented or living rent free: Total,34,31,20,1,19,11,0,3,2,1,0,0,0
S01006924,Rented or living rent free: Social rented,1,0,0,0,0,0,0,1,1,0,0,0,0
S01006924,Rented or living rent free: Private rented or living rent free,33,31,20,1,19,11,0,2,1,1,0,0,0
S01006925,All HRPs aged 16 and over,215,153,139,15,124,14,0,62,57,2,0,2,1
S01006925,Owned: Total,177,141,129,13,116,12,0,36,34,1,0,1,0
S01006925,Owned: Owned outright,94,60,57,12,45,3,0,34,33,0,0,1,0
S01006925,Owned: Owned with a mortgage or loan or shared ownership,83,81,72,1,71,9,0,2,1,1,0,0,0
S01006925,Rented or living rent free: Total,38,12,10,2,8,2,0,26,23,1,0,1,1
S01006925,Rented or living rent free: Social rented,26,2,2,2,0,0,0,24,23,0,0,1,0
S01006925,Rented or living rent free: Private rented or living rent free,12,10,8,0,8,2,0,2,0,1,0,0,1
S01006926,All HRPs aged 16 and over,263,231,194,16,178,33,4,32,29,0,3,0,0
S01006926,Owned: Total,231,203,173,15,158,30,0,28,26,0,2,0,0
S01006926,Owned: Owned outright,71,45,38,11,27,7,0,26,25,0,1,0,0
S01006926,Owned: Owned with a mortgage or loan or shared ownership,160,158,135,4,131,23,0,2,1,0,1,0,0
S01006926,Rented or living rent free: Total,32,28,21,1,20,3,4,4,3,0,1,0,0
S01006926,Rented or living rent free: Social rented,13,9,6,0,6,0,3,4,3,0,1,0,0
S01006926,Rented or living rent free: Private rented or living rent free,19,19,15,1,14,3,1,0,0,0,0,0,0
S01006927,All HRPs aged 16 and over,358,346,309,13,296,33,4,12,7,0,3,2,0
S01006927,Owned: Total,294,288,256,6,250,31,1,6,6,0,0,0,0
S01006927,Owned: Owned outright,25,20,16,1,15,4,0,5,5,0,0,0,0
S01006927,Owned: Owned with a mortgage or loan or shared ownership,269,268,240,5,235,27,1,1,1,0,0,0,0
S01006927,Rented or living rent free: Total,64,58,53,7,46,2,3,6,1,0,3,2,0
S01006927,Rented or living rent free: Social rented,27,23,20,6,14,0,3,4,0,0,2,2,0
S01006927,Rented or living rent free: Private rented or living rent free,37,35,33,1,32,2,0,2,1,0,1,0,0
S01006928,All HRPs aged 16 and over,416,343,289,31,258,52,2,73,65,0,1,6,1
S01006928,Owned: Total,305,256,208,20,188,47,1,49,46,0,1,1,1
S01006928,Owned: Owned outright,129,84,61,11,50,22,1,45,44,0,0,1,0
S01006928,Owned: Owned with a mortgage or loan or shared ownership,176,172,147,9,138,25,0,4,2,0,1,0,1
S01006928,Rented or living rent free: Total,111,87,81,11,70,5,1,24,19,0,0,5,0
S01006928,Rented or living rent free: Social rented,32,13,12,4,8,0,1,19,16,0,0,3,0
S01006928,Rented or living rent free: Private rented or living rent free,79,74,69,7,62,5,0,5,3,0,0,2,0
S01006929,All HRPs aged 16 and over,280,238,194,18,176,43,1,42,35,2,4,0,1
S01006929,Owned: Total,261,221,178,17,161,42,1,40,34,2,4,0,0
S01006929,Owned: Owned outright,121,85,60,11,49,24,1,36,33,2,1,0,0
S01006929,Owned: Owned with a mortgage or loan or shared ownership,140,136,118,6,112,18,0,4,1,0,3,0,0
S01006929,Rented or living rent free: Total,19,17,16,1,15,1,0,2,1,0,0,0,1
S01006929,Rented or living rent free: Social rented,1,0,0,0,0,0,0,1,0,0,0,0,1
S01006929,Rented or living rent free: Private rented or living rent free,18,17,16,1,15,1,0,1,1,0,0,0,0
S01006930,All HRPs aged 16 and over,358,274,226,13,213,47,1,84,82,0,0,2,0
S01006930,Owned: Total,344,264,217,13,204,47,0,80,79,0,0,1,0
S01006930,Owned: Owned outright,175,100,78,11,67,22,0,75,75,0,0,0,0
S01006930,Owned: Owned with a mortgage or loan or shared ownership,169,164,139,2,137,25,0,5,4,0,0,1,0
S01006930,Rented or living rent free: Total,14,10,9,0,9,0,1,4,3,0,0,1,0
S01006930,Rented or living rent free: Social rented,2,0,0,0,0,0,0,2,1,0,0,1,0
S01006930,Rented or living rent free: Private rented or living rent free,12,10,9,0,9,0,1,2,2,0,0,0,0
S01006931,All HRPs aged 16 and over,159,125,90,6,84,33,2,34,29,0,2,2,1
S01006931,Owned: Total,96,73,54,4,50,17,2,23,20,0,1,1,1
S01006931,Owned: Owned outright,50,30,19,3,16,9,2,20,18,0,1,1,0
S01006931,Owned: Owned with a mortgage or loan or shared ownership,46,43,35,1,34,8,0,3,2,0,0,0,1
S01006931,Rented or living rent free: Total,63,52,36,2,34,16,0,11,9,0,1,1,0
S01006931,Rented or living rent free: Social rented,2,2,2,0,2,0,0,0,0,0,0,0,0
S01006931,Rented or living rent free: Private rented or living rent free,61,50,34,2,32,16,0,11,9,0,1,1,0
S01006932,All HRPs aged 16 and over,195,172,145,7,138,26,1,23,8,3,8,1,3
S01006932,Owned: Total,157,146,127,3,124,18,1,11,8,0,1,0,2
S01006932,Owned: Owned outright,30,22,17,1,16,4,1,8,8,0,0,0,0
S01006932,Owned: Owned with a mortgage or loan or shared ownership,127,124,110,2,108,14,0,3,0,0,1,0,2
S01006932,Rented or living rent free: Total,38,26,18,4,14,8,0,12,0,3,7,1,1
S01006932,Rented or living rent free: Social rented,32,20,15,4,11,5,0,12,0,3,7,1,1
S01006932,Rented or living rent free: Private rented or living rent free,6,6,3,0,3,3,0,0,0,0,0,0,0
S01006933,All HRPs aged 16 and over,220,197,179,15,164,18,0,23,21,0,0,0,2
S01006933,Owned: Total,209,187,171,14,157,16,0,22,21,0,0,0,1
S01006933,Owned: Owned outright,79,59,54,12,42,5,0,20,19,0,0,0,1
S01006933,Owned: Owned with a mortgage or loan or shared ownership,130,128,117,2,115,11,0,2,2,0,0,0,0
S01006933,Rented or living rent free: Total,11,10,8,1,7,2,0,1,0,0,0,0,1
S01006933,Rented or living rent free: Social rented,1,1,1,1,0,0,0,0,0,0,0,0,0
S01006933,Rented or living rent free: Private rented or living rent free,10,9,7,0,7,2,0,1,0,0,0,0,1
S01006934,All HRPs aged 16 and over,234,174,130,10,120,41,3,60,48,0,4,3,5
S01006934,Owned: Total,159,125,89,6,83,34,2,34,29,0,2,1,2
S01006934,Owned: Owned outright,84,55,32,5,27,22,1,29,24,0,2,1,2
S01006934,Owned: Owned with a mortgage or loan or shared ownership,75,70,57,1,56,12,1,5,5,0,0,0,0
S01006934,Rented or living rent free: Total,75,49,41,4,37,7,1,26,19,0,2,2,3
S01006934,Rented or living rent free: Social rented,25,10,9,2,7,0,1,15,12,0,0,1,2
S01006934,Rented or living rent free: Private rented or living rent free,50,39,32,2,30,7,0,11,7,0,2,1,1
S01006935,All HRPs aged 16 and over,301,208,179,20,159,26,3,93,89,1,2,1,0
S01006935,Owned: Total,283,194,167,20,147,25,2,89,87,0,1,1,0
S01006935,Owned: Owned outright,167,80,69,17,52,11,0,87,86,0,0,1,0
S01006935,Owned: Owned with a mortgage or loan or shared ownership,116,114,98,3,95,14,2,2,1,0,1,0,0
S01006935,Rented or living rent free: Total,18,14,12,0,12,1,1,4,2,1,1,0,0
S01006935,Rented or living rent free: Social rented,2,1,1,0,1,0,0,1,0,0,1,0,0
S01006935,Rented or living rent free: Private rented or living rent free,16,13,11,0,11,1,1,3,2,1,0,0,0
S01006936,All HRPs aged 16 and over,274,196,171,26,145,22,3,78,69,2,3,3,1
S01006936,Owned: Total,237,167,148,23,125,17,2,70,67,1,1,1,0
S01006936,Owned: Owned outright,122,58,47,16,31,10,1,64,62,0,1,1,0
S01006936,Owned: Owned with a mortgage or loan or shared ownership,115,109,101,7,94,7,1,6,5,1,0,0,0
S01006936,Rented or living rent free: Total,37,29,23,3,20,5,1,8,2,1,2,2,1
S01006936,Rented or living rent free: Social rented,22,16,11,3,8,4,1,6,1,1,1,2,1
S01006936,Rented or living rent free: Private rented or living rent free,15,13,12,0,12,1,0,2,1,0,1,0,0
S01006937,All HRPs aged 16 and over,316,240,213,23,190,25,2,76,72,0,0,3,1
S01006937,Owned: Total,284,212,189,21,168,22,1,72,70,0,0,1,1
S01006937,Owned: Owned outright,141,74,66,16,50,7,1,67,65,0,0,1,1
S01006937,Owned: Owned with a mortgage or loan or shared ownership,143,138,123,5,118,15,0,5,5,0,0,0,0
S01006937,Rented or living rent free: Total,32,28,24,2,22,3,1,4,2,0,0,2,0
S01006937,Rented or living rent free: Social rented,5,3,2,0,2,0,1,2,1,0,0,1,0
S01006937,Rented or living rent free: Private rented or living rent free,27,25,22,2,20,3,0,2,1,0,0,1,0
S01006938,All HRPs aged 16 and over,254,170,149,15,134,17,4,84,78,1,0,2,3
S01006938,Owned: Total,183,149,132,13,119,14,3,34,30,0,0,2,2
S01006938,Owned: Owned outright,81,50,43,6,37,7,0,31,29,0,0,0,2
S01006938,Owned: Owned with a mortgage or loan or shared ownership,102,99,89,7,82,7,3,3,1,0,0,2,0
S01006938,Rented or living rent free: Total,71,21,17,2,15,3,1,50,48,1,0,0,1
S01006938,Rented or living rent free: Social rented,51,6,4,1,3,1,1,45,44,0,0,0,1
S01006938,Rented or living rent free: Private rented or living rent free,20,15,13,1,12,2,0,5,4,1,0,0,0
S01006939,All HRPs aged 16 and over,234,180,159,22,137,21,0,54,51,1,2,0,0
S01006939,Owned: Total,223,173,153,21,132,20,0,50,47,1,2,0,0
S01006939,Owned: Owned outright,104,57,54,14,40,3,0,47,46,0,1,0,0
S01006939,Owned: Owned with a mortgage or loan or shared ownership,119,116,99,7,92,17,0,3,1,1,1,0,0
S01006939,Rented or living rent free: Total,11,7,6,1,5,1,0,4,4,0,0,0,0
S01006939,Rented or living rent free: Social rented,2,1,1,1,0,0,0,1,1,0,0,0,0
S01006939,Rented or living rent free: Private rented or living rent free,9,6,5,0,5,1,0,3,3,0,0,0,0
S01006940,All HRPs aged 16 and over,378,299,254,32,222,44,1,79,73,1,1,3,1
S01006940,Owned: Total,335,265,227,28,199,37,1,70,69,0,0,0,1
S01006940,Owned: Owned outright,141,77,59,21,38,17,1,64,64,0,0,0,0
S01006940,Owned: Owned with a mortgage or loan or shared ownership,194,188,168,7,161,20,0,6,5,0,0,0,1
S01006940,Rented or living rent free: Total,43,34,27,4,23,7,0,9,4,1,1,3,0
S01006940,Rented or living rent free: Social rented,6,4,4,1,3,0,0,2,0,0,0,2,0
S01006940,Rented or living rent free: Private rented or living rent free,37,30,23,3,20,7,0,7,4,1,1,1,0
S01006941,All HRPs aged 16 and over,255,196,172,16,156,22,2,59,53,0,0,6,0
S01006941,Owned: Total,229,176,155,14,141,19,2,53,49,0,0,4,0
S01006941,Owned: Owned outright,105,57,48,11,37,8,1,48,46,0,0,2,0
S01006941,Owned: Owned with a mortgage or loan or shared ownership,124,119,107,3,104,11,1,5,3,0,0,2,0
S01006941,Rented or living rent free: Total,26,20,17,2,15,3,0,6,4,0,0,2,0
S01006941,Rented or living rent free: Social rented,15,11,9,2,7,2,0,4,2,0,0,2,0
S01006941,Rented or living rent free: Private rented or living rent free,11,9,8,0,8,1,0,2,2,0,0,0,0
S01006942,All HRPs aged 16 and over,390,309,255,24,231,54,0,81,74,2,2,2,1
S01006942,Owned: Total,352,285,231,20,211,54,0,67,61,1,2,2,1
S01006942,Owned: Owned outright,136,74,61,15,46,13,0,62,57,1,1,2,1
S01006942,Owned: Owned with a mortgage or loan or shared ownership,216,211,170,5,165,41,0,5,4,0,1,0,0
S01006942,Rented or living rent free: Total,38,24,24,4,20,0,0,14,13,1,0,0,0
S01006942,Rented or living rent free: Social rented,13,6,6,3,3,0,0,7,7,0,0,0,0
S01006942,Rented or living rent free: Private rented or living rent free,25,18,18,1,17,0,0,7,6,1,0,0,0
S01006943,All HRPs aged 16 and over,208,201,174,4,170,25,2,7,6,0,1,0,0
S01006943,Owned: Total,193,186,163,3,160,22,1,7,6,0,1,0,0
S01006943,Owned: Owned outright,44,37,33,2,31,4,0,7,6,0,1,0,0
S01006943,Owned: Owned with a mortgage or loan or shared ownership,149,149,130,1,129,18,1,0,0,0,0,0,0
S01006943,Rented or living rent free: Total,15,15,11,1,10,3,1,0,0,0,0,0,0
S01006943,Rented or living rent free: Social rented,1,1,1,1,0,0,0,0,0,0,0,0,0
S01006943,Rented or living rent free: Private rented or living rent free,14,14,10,0,10,3,1,0,0,0,0,0,0
S01006944,All HRPs aged 16 and over,327,312,275,22,253,34,3,15,6,2,2,5,0
S01006944,Owned: Total,259,255,226,15,211,28,1,4,3,0,1,0,0
S01006944,Owned: Owned outright,32,28,24,5,19,4,0,4,3,0,1,0,0
S01006944,Owned: Owned with a mortgage or loan or shared ownership,227,227,202,10,192,24,1,0,0,0,0,0,0
S01006944,Rented or living rent free: Total,68,57,49,7,42,6,2,11,3,2,1,5,0
S01006944,Rented or living rent free: Social rented,39,31,26,5,21,3,2,8,2,0,1,5,0
S01006944,Rented or living rent free: Private rented or living rent free,29,26,23,2,21,3,0,3,1,2,0,0,0
S01006945,All HRPs aged 16 and over,215,171,143,8,135,23,5,44,43,0,1,0,0
S01006945,Owned: Total,201,160,133,7,126,22,5,41,40,0,1,0,0
S01006945,Owned: Owned outright,87,49,39,2,37,7,3,38,38,0,0,0,0
S01006945,Owned: Owned with a mortgage or loan or shared ownership,114,111,94,5,89,15,2,3,2,0,1,0,0
S01006945,Rented or living rent free: Total,14,11,10,1,9,1,0,3,3,0,0,0,0
S01006945,Rented or living rent free: Social rented,4,1,0,0,0,1,0,3,3,0,0,0,0
S01006945,Rented or living rent free: Private rented or living rent free,10,10,10,1,9,0,0,0,0,0,0,0,0
S01006946,All HRPs aged 16 and over,314,265,224,15,209,37,4,49,42,1,1,2,3
S01006946,Owned: Total,283,238,199,14,185,35,4,45,40,0,1,1,3
S01006946,Owned: Owned outright,118,75,63,9,54,8,4,43,40,0,1,0,2
S01006946,Owned: Owned with a mortgage or loan or shared ownership,165,163,136,5,131,27,0,2,0,0,0,1,1
S01006946,Rented or living rent free: Total,31,27,25,1,24,2,0,4,2,1,0,1,0
S01006946,Rented or living rent free: Social rented,6,4,4,0,4,0,0,2,1,0,0,1,0
S01006946,Rented or living rent free: Private rented or living rent free,25,23,21,1,20,2,0,2,1,1,0,0,0
S01006947,All HRPs aged 16 and over,306,282,252,20,232,27,3,24,17,1,3,2,1
S01006947,Owned: Total,251,239,214,10,204,24,1,12,10,0,1,1,0
S01006947,Owned: Owned outright,40,31,26,6,20,5,0,9,9,0,0,0,0
S01006947,Owned: Owned with a mortgage or loan or shared ownership,211,208,188,4,184,19,1,3,1,0,1,1,0
S01006947,Rented or living rent free: Total,55,43,38,10,28,3,2,12,7,1,2,1,1
S01006947,Rented or living rent free: Social rented,39,29,24,8,16,3,2,10,6,1,1,1,1
S01006947,Rented or living rent free: Private rented or living rent free,16,14,14,2,12,0,0,2,1,0,1,0,0
S01006948,All HRPs aged 16 and over,372,253,203,23,180,49,1,119,114,2,0,2,1
S01006948,Owned: Total,291,216,171,20,151,44,1,75,72,0,0,2,1
S01006948,Owned: Owned outright,149,79,54,10,44,25,0,70,68,0,0,1,1
S01006948,Owned: Owned with a mortgage or loan or shared ownership,142,137,117,10,107,19,1,5,4,0,0,1,0
S01006948,Rented or living rent free: Total,81,37,32,3,29,5,0,44,42,2,0,0,0
S01006948,Rented or living rent free: Social rented,54,15,14,3,11,1,0,39,38,1,0,0,0
S01006948,Rented or living rent free: Private rented or living rent free,27,22,18,0,18,4,0,5,4,1,0,0,0
S01006949,All HRPs aged 16 and over,248,209,161,16,145,47,1,39,33,0,4,0,2
S01006949,Owned: Total,228,191,147,14,133,44,0,37,33,0,3,0,1
S01006949,Owned: Owned outright,96,62,42,7,35,20,0,34,31,0,2,0,1
S01006949,Owned: Owned with a mortgage or loan or shared ownership,132,129,105,7,98,24,0,3,2,0,1,0,0
S01006949,Rented or living rent free: Total,20,18,14,2,12,3,1,2,0,0,1,0,1
S01006949,Rented or living rent free: Social rented,4,3,1,0,1,1,1,1,0,0,0,0,1
S01006949,Rented or living rent free: Private rented or living rent free,16,15,13,2,11,2,0,1,0,0,1,0,0
S01006950,All HRPs aged 16 and over,199,186,168,12,156,17,1,13,6,1,1,4,1
S01006950,Owned: Total,152,147,131,3,128,15,1,5,3,0,0,1,1
S01006950,Owned: Owned outright,10,8,7,0,7,0,1,2,2,0,0,0,0
S01006950,Owned: Owned with a mortgage or loan or shared ownership,142,139,124,3,121,15,0,3,1,0,0,1,1
S01006950,Rented or living rent free: Total,47,39,37,9,28,2,0,8,3,1,1,3,0
S01006950,Rented or living rent free: Social rented,37,29,27,8,19,2,0,8,3,1,1,3,0
S01006950,Rented or living rent free: Private rented or living rent free,10,10,10,1,9,0,0,0,0,0,0,0,0
S01006951,All HRPs aged 16 and over,204,160,143,12,131,14,3,44,41,0,1,2,0
S01006951,Owned: Total,170,139,125,11,114,11,3,31,29,0,1,1,0
S01006951,Owned: Owned outright,84,53,43,8,35,7,3,31,29,0,1,1,0
S01006951,Owned: Owned with a mortgage or loan or shared ownership,86,86,82,3,79,4,0,0,0,0,0,0,0
S01006951,Rented or living rent free: Total,34,21,18,1,17,3,0,13,12,0,0,1,0
S01006951,Rented or living rent free: Social rented,26,15,13,1,12,2,0,11,10,0,0,1,0
S01006951,Rented or living rent free: Private rented or living rent free,8,6,5,0,5,1,0,2,2,0,0,0,0
S01006952,All HRPs aged 16 and over,364,265,203,16,187,59,3,99,88,0,1,8,2
S01006952,Owned: Total,285,210,158,10,148,51,1,75,72,0,0,2,1
S01006952,Owned: Owned outright,167,95,61,9,52,34,0,72,69,0,0,2,1
S01006952,Owned: Owned with a mortgage or loan or shared ownership,118,115,97,1,96,17,1,3,3,0,0,0,0
S01006952,Rented or living rent free: Total,79,55,45,6,39,8,2,24,16,0,1,6,1
S01006952,Rented or living rent free: Social rented,23,10,9,2,7,1,0,13,9,0,1,3,0
S01006952,Rented or living rent free: Private rented or living rent free,56,45,36,4,32,7,2,11,7,0,0,3,1
S01006953,All HRPs aged 16 and over,301,252,205,12,193,45,2,49,43,0,2,2,2
S01006953,Owned: Total,278,233,188,11,177,45,0,45,43,0,1,1,0
S01006953,Owned: Owned outright,114,72,56,8,48,16,0,42,41,0,0,1,0
S01006953,Owned: Owned with a mortgage or loan or shared ownership,164,161,132,3,129,29,0,3,2,0,1,0,0
S01006953,Rented or living rent free: Total,23,19,17,1,16,0,2,4,0,0,1,1,2
S01006953,Rented or living rent free: Social rented,4,2,1,0,1,0,1,2,0,0,1,1,0
S01006953,Rented or living rent free: Private rented or living rent free,19,17,16,1,15,0,1,2,0,0,0,0,2
S01006954,All HRPs aged 16 and over,317,260,215,18,197,44,1,57,55,1,1,0,0
S01006954,Owned: Total,296,242,201,16,185,41,0,54,53,0,1,0,0
S01006954,Owned: Owned outright,150,96,80,11,69,16,0,54,53,0,1,0,0
S01006954,Owned: Owned with a mortgage or loan or shared ownership,146,146,121,5,116,25,0,0,0,0,0,0,0
S01006954,Rented or living rent free: Total,21,18,14,2,12,3,1,3,2,1,0,0,0
S01006954,Rented or living rent free: Social rented,5,4,3,1,2,0,1,1,0,1,0,0,0
S01006954,Rented or living rent free: Private rented or living rent free,16,14,11,1,10,3,0,2,2,0,0,0,0
S01006955,All HRPs aged 16 and over,267,198,177,13,164,14,7,69,57,2,5,4,1
S01006955,Owned: Total,160,143,133,5,128,10,0,17,17,0,0,0,0
S01006955,Owned: Owned outright,36,21,20,1,19,1,0,15,15,0,0,0,0
S01006955,Owned: Owned with a mortgage or loan or shared ownership,124,122,113,4,109,9,0,2,2,0,0,0,0
S01006955,Rented or living rent free: Total,107,55,44,8,36,4,7,52,40,2,5,4,1
S01006955,Rented or living rent free: Social rented,86,37,28,5,23,3,6,49,38,1,5,4,1
S01006955,Rented or living rent free: Private rented or living rent free,21,18,16,3,13,1,1,3,2,1,0,0,0
S01006956,All HRPs aged 16 and over,394,353,308,27,281,41,4,41,30,0,4,6,1
S01006956,Owned: Total,335,304,269,18,251,32,3,31,28,0,1,1,1
S01006956,Owned: Owned outright,77,48,39,9,30,8,1,29,27,0,1,0,1
S01006956,Owned: Owned with a mortgage or loan or shared ownership,258,256,230,9,221,24,2,2,1,0,0,1,0
S01006956,Rented or living rent free: Total,59,49,39,9,30,9,1,10,2,0,3,5,0
S01006956,Rented or living rent free: Social rented,35,27,23,8,15,4,0,8,2,0,3,3,0
S01006956,Rented or living rent free: Private rented or living rent free,24,22,16,1,15,5,1,2,0,0,0,2,0
S01006957,All HRPs aged 16 and over,387,330,248,12,236,80,2,57,49,2,4,2,0
S01006957,Owned: Total,332,285,208,10,198,75,2,47,44,0,2,1,0
S01006957,Owned: Owned outright,132,90,57,7,50,33,0,42,41,0,0,1,0
S01006957,Owned: Owned with a mortgage or loan or shared ownership,200,195,151,3,148,42,2,5,3,0,2,0,0
S01006957,Rented or living rent free: Total,55,45,40,2,38,5,0,10,5,2,2,1,0
S01006957,Rented or living rent free: Social rented,8,4,3,0,3,1,0,4,2,0,1,1,0
S01006957,Rented or living rent free: Private rented or living rent free,47,41,37,2,35,4,0,6,3,2,1,0,0
S01006958,All HRPs aged 16 and over,435,256,217,27,190,36,3,179,171,0,3,3,2
S01006958,Owned: Total,398,233,196,23,173,34,3,165,161,0,2,0,2
S01006958,Owned: Owned outright,240,88,74,14,60,11,3,152,150,0,0,0,2
S01006958,Owned: Owned with a mortgage or loan or shared ownership,158,145,122,9,113,23,0,13,11,0,2,0,0
S01006958,Rented or living rent free: Total,37,23,21,4,17,2,0,14,10,0,1,3,0
S01006958,Rented or living rent free: Social rented,8,4,4,2,2,0,0,4,1,0,0,3,0
S01006958,Rented or living rent free: Private rented or living rent free,29,19,17,2,15,2,0,10,9,0,1,0,0
S01006959,All HRPs aged 16 and over,347,194,165,25,140,22,7,153,133,0,7,7,6
S01006959,Owned: Total,177,114,97,12,85,16,1,63,59,0,0,0,4
S01006959,Owned: Owned outright,104,46,33,11,22,13,0,58,56,0,0,0,2
S01006959,Owned: Owned with a mortgage or loan or shared ownership,73,68,64,1,63,3,1,5,3,0,0,0,2
S01006959,Rented or living rent free: Total,170,80,68,13,55,6,6,90,74,0,7,7,2
S01006959,Rented or living rent free: Social rented,133,52,44,10,34,2,6,81,68,0,6,6,1
S01006959,Rented or living rent free: Private rented or living rent free,37,28,24,3,21,4,0,9,6,0,1,1,1
S01006960,All HRPs aged 16 and over,318,296,246,20,226,46,4,22,15,1,0,2,4
S01006960,Owned: Total,274,261,217,7,210,43,1,13,12,0,0,0,1
S01006960,Owned: Owned outright,53,43,33,2,31,10,0,10,10,0,0,0,0
S01006960,Owned: Owned with a mortgage or loan or shared ownership,221,218,184,5,179,33,1,3,2,0,0,0,1
S01006960,Rented or living rent free: Total,44,35,29,13,16,3,3,9,3,1,0,2,3
S01006960,Rented or living rent free: Social rented,32,25,20,12,8,3,2,7,3,1,0,1,2
S01006960,Rented or living rent free: Private rented or living rent free,12,10,9,1,8,0,1,2,0,0,0,1,1
S01006961,All HRPs aged 16 and over,321,307,271,13,258,36,0,14,13,0,1,0,0
S01006961,Owned: Total,301,288,255,10,245,33,0,13,13,0,0,0,0
S01006961,Owned: Owned outright,36,26,25,3,22,1,0,10,10,0,0,0,0
S01006961,Owned: Owned with a mortgage or loan or shared ownership,265,262,230,7,223,32,0,3,3,0,0,0,0
S01006961,Rented or living rent free: Total,20,19,16,3,13,3,0,1,0,0,1,0,0
S01006961,Rented or living rent free: Social rented,1,1,1,0,1,0,0,0,0,0,0,0,0
S01006961,Rented or living rent free: Private rented or living rent free,19,18,15,3,12,3,0,1,0,0,1,0,0
S01006962,All HRPs aged 16 and over,409,265,240,22,218,21,4,144,138,0,0,5,1
S01006962,Owned: Total,369,235,215,18,197,17,3,134,131,0,0,2,1
S01006962,Owned: Owned outright,207,85,74,11,63,8,3,122,122,0,0,0,0
S01006962,Owned: Owned with a mortgage or loan or shared ownership,162,150,141,7,134,9,0,12,9,0,0,2,1
S01006962,Rented or living rent free: Total,40,30,25,4,21,4,1,10,7,0,0,3,0
S01006962,Rented or living rent free: Social rented,4,0,0,0,0,0,0,4,1,0,0,3,0
S01006962,Rented or living rent free: Private rented or living rent free,36,30,25,4,21,4,1,6,6,0,0,0,0
S01006963,All HRPs aged 16 and over,275,208,178,19,159,25,5,67,62,1,1,2,1
S01006963,Owned: Total,248,188,164,16,148,22,2,60,59,0,0,0,1
S01006963,Owned: Owned outright,122,65,59,12,47,6,0,57,57,0,0,0,0
S01006963,Owned: Owned with a mortgage or loan or shared ownership,126,123,105,4,101,16,2,3,2,0,0,0,1
S01006963,Rented or living rent free: Total,27,20,14,3,11,3,3,7,3,1,1,2,0
S01006963,Rented or living rent free: Social rented,3,1,0,0,0,1,0,2,1,0,0,1,0
S01006963,Rented or living rent free: Private rented or living rent free,24,19,14,3,11,2,3,5,2,1,1,1,0
S01006964,All HRPs aged 16 and over,348,290,256,21,235,30,4,58,53,1,2,2,0
S01006964,Owned: Total,283,230,202,16,186,26,2,53,52,0,1,0,0
S01006964,Owned: Owned outright,118,69,61,9,52,8,0,49,48,0,1,0,0
S01006964,Owned: Owned with a mortgage or loan or shared ownership,165,161,141,7,134,18,2,4,4,0,0,0,0
S01006964,Rented or living rent free: Total,65,60,54,5,49,4,2,5,1,1,1,2,0
S01006964,Rented or living rent free: Social rented,3,3,3,0,3,0,0,0,0,0,0,0,0
S01006964,Rented or living rent free: Private rented or living rent free,62,57,51,5,46,4,2,5,1,1,1,2,0
S01006965,All HRPs aged 16 and over,216,146,126,12,114,17,3,70,59,0,3,7,1
S01006965,Owned: Total,175,119,102,10,92,16,1,56,52,0,3,0,1
S01006965,Owned: Owned outright,96,42,34,6,28,7,1,54,51,0,2,0,1
S01006965,Owned: Owned with a mortgage or loan or shared ownership,79,77,68,4,64,9,0,2,1,0,1,0,0
S01006965,Rented or living rent free: Total,41,27,24,2,22,1,2,14,7,0,0,7,0
S01006965,Rented or living rent free: Social rented,21,10,8,1,7,0,2,11,5,0,0,6,0
S01006965,Rented or living rent free: Private rented or living rent free,20,17,16,1,15,1,0,3,2,0,0,1,0
S01006966,All HRPs aged 16 and over,253,174,151,35,116,15,8,79,64,2,2,7,4
S01006966,Owned: Total,152,121,107,17,90,11,3,31,27,0,0,2,2
S01006966,Owned: Owned outright,51,24,20,9,11,1,3,27,25,0,0,1,1
S01006966,Owned: Owned with a mortgage or loan or shared ownership,101,97,87,8,79,10,0,4,2,0,0,1,1
S01006966,Rented or living rent free: Total,101,53,44,18,26,4,5,48,37,2,2,5,2
S01006966,Rented or living rent free: Social rented,84,41,36,14,22,3,2,43,35,2,0,5,1
S01006966,Rented or living rent free: Private rented or living rent free,17,12,8,4,4,1,3,5,2,0,2,0,1
S01006967,All HRPs aged 16 and over,237,194,175,9,166,18,1,43,38,1,1,0,3
S01006967,Owned: Total,226,189,170,8,162,18,1,37,34,0,1,0,2
S01006967,Owned: Owned outright,83,48,43,6,37,4,1,35,33,0,0,0,2
S01006967,Owned: Owned with a mortgage or loan or shared ownership,143,141,127,2,125,14,0,2,1,0,1,0,0
S01006967,Rented or living rent free: Total,11,5,5,1,4,0,0,6,4,1,0,0,1
S01006967,Rented or living rent free: Social rented,1,0,0,0,0,0,0,1,0,0,0,0,1
S01006967,Rented or living rent free: Private rented or living rent free,10,5,5,1,4,0,0,5,4,1,0,0,0
S01006968,All HRPs aged 16 and over,224,166,145,21,124,19,2,58,52,0,2,4,0
S01006968,Owned: Total,162,134,118,14,104,15,1,28,28,0,0,0,0
S01006968,Owned: Owned outright,74,50,44,13,31,5,1,24,24,0,0,0,0
S01006968,Owned: Owned with a mortgage or loan or shared ownership,88,84,74,1,73,10,0,4,4,0,0,0,0
S01006968,Rented or living rent free: Total,62,32,27,7,20,4,1,30,24,0,2,4,0
S01006968,Rented or living rent free: Social rented,45,17,16,6,10,0,1,28,22,0,2,4,0
S01006968,Rented or living rent free: Private rented or living rent free,17,15,11,1,10,4,0,2,2,0,0,0,0
S01006969,All HRPs aged 16 and over,412,284,249,23,226,31,4,128,117,2,1,5,3
S01006969,Owned: Total,324,240,211,17,194,27,2,84,80,1,0,2,1
S01006969,Owned: Owned outright,151,76,63,11,52,11,2,75,71,1,0,2,1
S01006969,Owned: Owned with a mortgage or loan or shared ownership,173,164,148,6,142,16,0,9,9,0,0,0,0
S01006969,Rented or living rent free: Total,88,44,38,6,32,4,2,44,37,1,1,3,2
S01006969,Rented or living rent free: Social rented,47,10,10,2,8,0,0,37,32,1,1,2,1
S01006969,Rented or living rent free: Private rented or living rent free,41,34,28,4,24,4,2,7,5,0,0,1,1
S01006970,All HRPs aged 16 and over,258,214,193,11,182,20,1,44,38,1,1,3,1
S01006970,Owned: Total,227,187,169,9,160,17,1,40,36,0,1,2,1
S01006970,Owned: Owned outright,106,71,64,8,56,6,1,35,34,0,0,0,1
S01006970,Owned: Owned with a mortgage or loan or shared ownership,121,116,105,1,104,11,0,5,2,0,1,2,0
S01006970,Rented or living rent free: Total,31,27,24,2,22,3,0,4,2,1,0,1,0
S01006970,Rented or living rent free: Social rented,10,9,9,1,8,0,0,1,0,1,0,0,0
S01006970,Rented or living rent free: Private rented or living rent free,21,18,15,1,14,3,0,3,2,0,0,1,0
S01006971,All HRPs aged 16 and over,248,142,125,25,100,14,3,106,96,1,2,4,3
S01006971,Owned: Total,135,91,79,15,64,12,0,44,43,0,1,0,0
S01006971,Owned: Owned outright,72,30,26,10,16,4,0,42,42,0,0,0,0
S01006971,Owned: Owned with a mortgage or loan or shared ownership,63,61,53,5,48,8,0,2,1,0,1,0,0
S01006971,Rented or living rent free: Total,113,51,46,10,36,2,3,62,53,1,1,4,3
S01006971,Rented or living rent free: Social rented,101,43,40,10,30,0,3,58,50,1,1,4,2
S01006971,Rented or living rent free: Private rented or living rent free,12,8,6,0,6,2,0,4,3,0,0,0,1
S01006972,All HRPs aged 16 and over,192,162,117,12,105,44,1,30,28,0,0,1,1
S01006972,Owned: Total,162,136,98,9,89,38,0,26,25,0,0,0,1
S01006972,Owned: Owned outright,86,63,41,7,34,22,0,23,23,0,0,0,0
S01006972,Owned: Owned with a mortgage or loan or shared ownership,76,73,57,2,55,16,0,3,2,0,0,0,1
S01006972,Rented or living rent free: Total,30,26,19,3,16,6,1,4,3,0,0,1,0
S01006972,Rented or living rent free: Social rented,5,4,2,1,1,1,1,1,0,0,0,1,0
S01006972,Rented or living rent free: Private rented or living rent free,25,22,17,2,15,5,0,3,3,0,0,0,0
S01006973,All HRPs aged 16 and over,234,172,140,18,122,27,5,62,58,0,1,1,2
S01006973,Owned: Total,194,145,118,13,105,23,4,49,47,0,1,0,1
S01006973,Owned: Owned outright,112,66,48,11,37,15,3,46,45,0,0,0,1
S01006973,Owned: Owned with a mortgage or loan or shared ownership,82,79,70,2,68,8,1,3,2,0,1,0,0
S01006973,Rented or living rent free: Total,40,27,22,5,17,4,1,13,11,0,0,1,1
S01006973,Rented or living rent free: Social rented,24,13,12,4,8,0,1,11,9,0,0,1,1
S01006973,Rented or living rent free: Private rented or living rent free,16,14,10,1,9,4,0,2,2,0,0,0,0
S01006974,All HRPs aged 16 and over,393,318,260,27,233,56,2,75,71,0,2,1,1
S01006974,Owned: Total,334,274,224,19,205,49,1,60,58,0,1,0,1
S01006974,Owned: Owned outright,125,75,58,14,44,17,0,50,50,0,0,0,0
S01006974,Owned: Owned with a mortgage or loan or shared ownership,209,199,166,5,161,32,1,10,8,0,1,0,1
S01006974,Rented or living rent free: Total,59,44,36,8,28,7,1,15,13,0,1,1,0
S01006974,Rented or living rent free: Social rented,33,23,19,7,12,3,1,10,9,0,0,1,0
S01006974,Rented or living rent free: Private rented or living rent free,26,21,17,1,16,4,0,5,4,0,1,0,0
S01006975,All HRPs aged 16 and over,386,323,239,27,212,82,2,63,54,2,2,4,1
S01006975,Owned: Total,322,275,202,21,181,71,2,47,45,0,0,1,1
S01006975,Owned: Owned outright,141,96,61,12,49,34,1,45,44,0,0,1,0
S01006975,Owned: Owned with a mortgage or loan or shared ownership,181,179,141,9,132,37,1,2,1,0,0,0,1
S01006975,Rented or living rent free: Total,64,48,37,6,31,11,0,16,9,2,2,3,0
S01006975,Rented or living rent free: Social rented,9,4,3,1,2,1,0,5,4,0,0,1,0
S01006975,Rented or living rent free: Private rented or living rent free,55,44,34,5,29,10,0,11,5,2,2,2,0
S01006976,All HRPs aged 16 and over,172,145,104,5,99,40,1,27,21,0,2,1,3
S01006976,Owned: Total,142,122,85,5,80,37,0,20,17,0,0,1,2
S01006976,Owned: Owned outright,75,59,36,4,32,23,0,16,14,0,0,0,2
S01006976,Owned: Owned with a mortgage or loan or shared ownership,67,63,49,1,48,14,0,4,3,0,0,1,0
S01006976,Rented or living rent free: Total,30,23,19,0,19,3,1,7,4,0,2,0,1
S01006976,Rented or living rent free: Social rented,1,0,0,0,0,0,0,1,1,0,0,0,0
S01006976,Rented or living rent free: Private rented or living rent free,29,23,19,0,19,3,1,6,3,0,2,0,1
S01006977,All HRPs aged 16 and over,316,266,186,11,175,79,1,50,40,1,2,7,0
S01006977,Owned: Total,198,172,115,4,111,56,1,26,25,0,0,1,0
S01006977,Owned: Owned outright,79,54,26,0,26,27,1,25,25,0,0,0,0
S01006977,Owned: Owned with a mortgage or loan or shared ownership,119,118,89,4,85,29,0,1,0,0,0,1,0
S01006977,Rented or living rent free: Total,118,94,71,7,64,23,0,24,15,1,2,6,0
S01006977,Rented or living rent free: Social rented,11,7,6,3,3,1,0,4,1,0,1,2,0
S01006977,Rented or living rent free: Private rented or living rent free,107,87,65,4,61,22,0,20,14,1,1,4,0
S01006978,All HRPs aged 16 and over,371,277,220,23,197,52,5,94,83,0,2,8,1
S01006978,Owned: Total,263,201,154,12,142,46,1,62,60,0,0,1,1
S01006978,Owned: Owned outright,128,73,47,8,39,25,1,55,54,0,0,0,1
S01006978,Owned: Owned with a mortgage or loan or shared ownership,135,128,107,4,103,21,0,7,6,0,0,1,0
S01006978,Rented or living rent free: Total,108,76,66,11,55,6,4,32,23,0,2,7,0
S01006978,Rented or living rent free: Social rented,46,29,28,8,20,0,1,17,12,0,1,4,0
S01006978,Rented or living rent free: Private rented or living rent free,62,47,38,3,35,6,3,15,11,0,1,3,0
S01006979,All HRPs aged 16 and over,369,255,195,23,172,57,3,114,102,0,5,6,1
S01006979,Owned: Total,257,196,143,15,128,52,1,61,57,0,2,1,1
S01006979,Owned: Owned outright,136,80,50,9,41,30,0,56,53,0,2,1,0
S01006979,Owned: Owned with a mortgage or loan or shared ownership,121,116,93,6,87,22,1,5,4,0,0,0,1
S01006979,Rented or living rent free: Total,112,59,52,8,44,5,2,53,45,0,3,5,0
S01006979,Rented or living rent free: Social rented,68,23,20,4,16,3,0,45,39,0,3,3,0
S01006979,Rented or living rent free: Private rented or living rent free,44,36,32,4,28,2,2,8,6,0,0,2,0
S01006980,All HRPs aged 16 and over,326,258,202,17,185,53,3,68,62,0,1,3,2
S01006980,Owned: Total,261,207,163,13,150,44,0,54,52,0,0,0,2
S01006980,Owned: Owned outright,125,76,53,8,45,23,0,49,49,0,0,0,0
S01006980,Owned: Owned with a mortgage or loan or shared ownership,136,131,110,5,105,21,0,5,3,0,0,0,2
S01006980,Rented or living rent free: Total,65,51,39,4,35,9,3,14,10,0,1,3,0
S01006980,Rented or living rent free: Social rented,6,4,3,0,3,1,0,2,1,0,0,1,0
S01006980,Rented or living rent free: Private rented or living rent free,59,47,36,4,32,8,3,12,9,0,1,2,0
S01006981,All HRPs aged 16 and over,321,271,217,20,197,51,3,50,41,1,1,6,1
S01006981,Owned: Total,230,199,158,12,146,41,0,31,28,0,0,2,1
S01006981,Owned: Owned outright,105,78,62,6,56,16,0,27,26,0,0,0,1
S01006981,Owned: Owned with a mortgage or loan or shared ownership,125,121,96,6,90,25,0,4,2,0,0,2,0
S01006981,Rented or living rent free: Total,91,72,59,8,51,10,3,19,13,1,1,4,0
S01006981,Rented or living rent free: Social rented,41,25,21,4,17,1,3,16,12,1,1,2,0
S01006981,Rented or living rent free: Private rented or living rent free,50,47,38,4,34,9,0,3,1,0,0,2,0
S01006982,All HRPs aged 16 and over,359,297,247,25,222,44,6,62,57,0,5,0,0
S01006982,Owned: Total,280,247,206,18,188,38,3,33,32,0,1,0,0
S01006982,Owned: Owned outright,77,46,35,9,26,9,2,31,30,0,1,0,0
S01006982,Owned: Owned with a mortgage or loan or shared ownership,203,201,171,9,162,29,1,2,2,0,0,0,0
S01006982,Rented or living rent free: Total,79,50,41,7,34,6,3,29,25,0,4,0,0
S01006982,Rented or living rent free: Social rented,59,35,30,7,23,2,3,24,20,0,4,0,0
S01006982,Rented or living rent free: Private rented or living rent free,20,15,11,0,11,4,0,5,5,0,0,0,0
S01006983,All HRPs aged 16 and over,289,238,191,19,172,44,3,51,43,0,1,6,1
S01006983,Owned: Total,240,198,160,17,143,37,1,42,37,0,1,3,1
S01006983,Owned: Owned outright,93,55,43,6,37,12,0,38,35,0,1,1,1
S01006983,Owned: Owned with a mortgage or loan or shared ownership,147,143,117,11,106,25,1,4,2,0,0,2,0
S01006983,Rented or living rent free: Total,49,40,31,2,29,7,2,9,6,0,0,3,0
S01006983,Rented or living rent free: Social rented,15,11,7,0,7,2,2,4,2,0,0,2,0
S01006983,Rented or living rent free: Private rented or living rent free,34,29,24,2,22,5,0,5,4,0,0,1,0
S01006984,All HRPs aged 16 and over,275,230,171,16,155,58,1,45,39,0,1,1,4
S01006984,Owned: Total,214,180,132,14,118,47,1,34,29,0,0,1,4
S01006984,Owned: Owned outright,88,60,35,7,28,24,1,28,26,0,0,0,2
S01006984,Owned: Owned with a mortgage or loan or shared ownership,126,120,97,7,90,23,0,6,3,0,0,1,2
S01006984,Rented or living rent free: Total,61,50,39,2,37,11,0,11,10,0,1,0,0
S01006984,Rented or living rent free: Social rented,13,7,5,2,3,2,0,6,6,0,0,0,0
S01006984,Rented or living rent free: Private rented or living rent free,48,43,34,0,34,9,0,5,4,0,1,0,0
S01006985,All HRPs aged 16 and over,432,302,245,24,221,50,7,130,120,1,1,8,0
S01006985,Owned: Total,314,240,192,15,177,45,3,74,70,1,0,3,0
S01006985,Owned: Owned outright,160,92,73,11,62,18,1,68,66,0,0,2,0
S01006985,Owned: Owned with a mortgage or loan or shared ownership,154,148,119,4,115,27,2,6,4,1,0,1,0
S01006985,Rented or living rent free: Total,118,62,53,9,44,5,4,56,50,0,1,5,0
S01006985,Rented or living rent free: Social rented,94,43,36,8,28,3,4,51,46,0,0,5,0
S01006985,Rented or living rent free: Private rented or living rent free,24,19,17,1,16,2,0,5,4,0,1,0,0
S01006986,All HRPs aged 16 and over,243,202,174,15,159,24,4,41,31,1,5,4,0
S01006986,Owned: Total,198,172,148,10,138,21,3,26,23,1,2,0,0
S01006986,Owned: Owned outright,55,30,24,5,19,5,1,25,23,1,1,0,0
S01006986,Owned: Owned with a mortgage or loan or shared ownership,143,142,124,5,119,16,2,1,0,0,1,0,0
S01006986,Rented or living rent free: Total,45,30,26,5,21,3,1,15,8,0,3,4,0
S01006986,Rented or living rent free: Social rented,29,16,15,5,10,1,0,13,7,0,3,3,0
S01006986,Rented or living rent free: Private rented or living rent free,16,14,11,0,11,2,1,2,1,0,0,1,0
S01006987,All HRPs aged 16 and over,294,196,169,19,150,20,7,98,85,0,6,3,4
S01006987,Owned: Total,201,141,122,8,114,17,2,60,55,0,2,2,1
S01006987,Owned: Owned outright,107,49,43,5,38,5,1,58,55,0,1,2,0
S01006987,Owned: Owned with a mortgage or loan or shared ownership,94,92,79,3,76,12,1,2,0,0,1,0,1
S01006987,Rented or living rent free: Total,93,55,47,11,36,3,5,38,30,0,4,1,3
S01006987,Rented or living rent free: Social rented,61,28,24,7,17,0,4,33,25,0,4,1,3
S01006987,Rented or living rent free: Private rented or living rent free,32,27,23,4,19,3,1,5,5,0,0,0,0
S01006988,All HRPs aged 16 and over,218,189,144,18,126,43,2,29,24,2,0,3,0
S01006988,Owned: Total,159,143,108,7,101,34,1,16,16,0,0,0,0
S01006988,Owned: Owned outright,45,31,19,4,15,12,0,14,14,0,0,0,0
S01006988,Owned: Owned with a mortgage or loan or shared ownership,114,112,89,3,86,22,1,2,2,0,0,0,0
S01006988,Rented or living rent free: Total,59,46,36,11,25,9,1,13,8,2,0,3,0
S01006988,Rented or living rent free: Social rented,33,26,22,10,12,3,1,7,4,2,0,1,0
S01006988,Rented or living rent free: Private rented or living rent free,26,20,14,1,13,6,0,6,4,0,0,2,0
S01006989,All HRPs aged 16 and over,375,317,246,18,228,69,2,58,53,1,0,2,2
S01006989,Owned: Total,331,282,220,13,207,61,1,49,46,0,0,2,1
S01006989,Owned: Owned outright,167,123,87,10,77,35,1,44,42,0,0,1,1
S01006989,Owned: Owned with a mortgage or loan or shared ownership,164,159,133,3,130,26,0,5,4,0,0,1,0
S01006989,Rented or living rent free: Total,44,35,26,5,21,8,1,9,7,1,0,0,1
S01006989,Rented or living rent free: Social rented,12,8,6,4,2,1,1,4,4,0,0,0,0
S01006989,Rented or living rent free: Private rented or living rent free,32,27,20,1,19,7,0,5,3,1,0,0,1
S01006990,All HRPs aged 16 and over,313,286,224,11,213,57,5,27,22,0,3,0,2
S01006990,Owned: Total,256,235,187,7,180,46,2,21,20,0,0,0,1
S01006990,Owned: Owned outright,63,45,27,3,24,17,1,18,18,0,0,0,0
S01006990,Owned: Owned with a mortgage or loan or shared ownership,193,190,160,4,156,29,1,3,2,0,0,0,1
S01006990,Rented or living rent free: Total,57,51,37,4,33,11,3,6,2,0,3,0,1
S01006990,Rented or living rent free: Social rented,10,7,6,2,4,0,1,3,0,0,2,0,1
S01006990,Rented or living rent free: Private rented or living rent free,47,44,31,2,29,11,2,3,2,0,1,0,0
S01006991,All HRPs aged 16 and over,216,129,102,17,85,25,2,87,81,0,3,3,0
S01006991,Owned: Total,123,79,62,5,57,17,0,44,42,0,1,1,0
S01006991,Owned: Owned outright,76,37,26,3,23,11,0,39,38,0,0,1,0
S01006991,Owned: Owned with a mortgage or loan or shared ownership,47,42,36,2,34,6,0,5,4,0,1,0,0
S01006991,Rented or living rent free: Total,93,50,40,12,28,8,2,43,39,0,2,2,0
S01006991,Rented or living rent free: Social rented,69,29,25,8,17,4,0,40,36,0,2,2,0
S01006991,Rented or living rent free: Private rented or living rent free,24,21,15,4,11,4,2,3,3,0,0,0,0
S01006992,All HRPs aged 16 and over,241,203,140,7,133,62,1,38,32,2,0,1,3
S01006992,Owned: Total,205,175,116,6,110,58,1,30,27,0,0,1,2
S01006992,Owned: Owned outright,97,69,38,5,33,30,1,28,26,0,0,1,1
S01006992,Owned: Owned with a mortgage or loan or shared ownership,108,106,78,1,77,28,0,2,1,0,0,0,1
S01006992,Rented or living rent free: Total,36,28,24,1,23,4,0,8,5,2,0,0,1
S01006992,Rented or living rent free: Social rented,2,2,2,0,2,0,0,0,0,0,0,0,0
S01006992,Rented or living rent free: Private rented or living rent free,34,26,22,1,21,4,0,8,5,2,0,0,1
S01006993,All HRPs aged 16 and over,202,167,118,8,110,48,1,35,29,1,3,2,0
S01006993,Owned: Total,168,140,98,6,92,42,0,28,25,1,1,1,0
S01006993,Owned: Owned outright,86,60,35,2,33,25,0,26,24,0,1,1,0
S01006993,Owned: Owned with a mortgage or loan or shared ownership,82,80,63,4,59,17,0,2,1,1,0,0,0
S01006993,Rented or living rent free: Total,34,27,20,2,18,6,1,7,4,0,2,1,0
S01006993,Rented or living rent free: Social rented,4,3,2,0,2,1,0,1,1,0,0,0,0
S01006993,Rented or living rent free: Private rented or living rent free,30,24,18,2,16,5,1,6,3,0,2,1,0
S01006994,All HRPs aged 16 and over,226,187,142,17,125,45,0,39,33,0,0,4,2
S01006994,Owned: Total,175,148,111,14,97,37,0,27,24,0,0,1,2
S01006994,Owned: Owned outright,86,59,39,8,31,20,0,27,24,0,0,1,2
S01006994,Owned: Owned with a mortgage or loan or shared ownership,89,89,72,6,66,17,0,0,0,0,0,0,0
S01006994,Rented or living rent free: Total,51,39,31,3,28,8,0,12,9,0,0,3,0
S01006994,Rented or living rent free: Social rented,6,3,2,1,1,1,0,3,1,0,0,2,0
S01006994,Rented or living rent free: Private rented or living rent free,45,36,29,2,27,7,0,9,8,0,0,1,0
S01006995,All HRPs aged 16 and over,331,290,210,15,195,76,4,41,32,0,4,2,3
S01006995,Owned: Total,252,220,157,9,148,63,0,32,28,0,1,1,2
S01006995,Owned: Owned outright,114,85,44,6,38,41,0,29,27,0,0,1,1
S01006995,Owned: Owned with a mortgage or loan or shared ownership,138,135,113,3,110,22,0,3,1,0,1,0,1
S01006995,Rented or living rent free: Total,79,70,53,6,47,13,4,9,4,0,3,1,1
S01006995,Rented or living rent free: Social rented,12,10,8,3,5,0,2,2,0,0,2,0,0
S01006995,Rented or living rent free: Private rented or living rent free,67,60,45,3,42,13,2,7,4,0,1,1,1
S01006996,All HRPs aged 16 and over,306,224,184,18,166,37,3,82,65,1,3,10,3
S01006996,Owned: Total,220,178,145,6,139,33,0,42,41,0,0,1,0
S01006996,Owned: Owned outright,79,41,32,5,27,9,0,38,38,0,0,0,0
S01006996,Owned: Owned with a mortgage or loan or shared ownership,141,137,113,1,112,24,0,4,3,0,0,1,0
S01006996,Rented or living rent free: Total,86,46,39,12,27,4,3,40,24,1,3,9,3
S01006996,Rented or living rent free: Social rented,75,37,30,11,19,4,3,38,23,1,3,9,2
S01006996,Rented or living rent free: Private rented or living rent free,11,9,9,1,8,0,0,2,1,0,0,0,1
S01006997,All HRPs aged 16 and over,292,250,192,15,177,56,2,42,39,0,2,1,0
S01006997,Owned: Total,247,216,166,10,156,50,0,31,29,0,2,0,0
S01006997,Owned: Owned outright,84,57,41,6,35,16,0,27,27,0,0,0,0
S01006997,Owned: Owned with a mortgage or loan or shared ownership,163,159,125,4,121,34,0,4,2,0,2,0,0
S01006997,Rented or living rent free: Total,45,34,26,5,21,6,2,11,10,0,0,1,0
S01006997,Rented or living rent free: Social rented,19,9,8,3,5,0,1,10,9,0,0,1,0
S01006997,Rented or living rent free: Private rented or living rent free,26,25,18,2,16,6,1,1,1,0,0,0,0
S01006998,All HRPs aged 16 and over,450,364,270,26,244,89,5,86,77,2,0,2,5
S01006998,Owned: Total,365,302,227,22,205,75,0,63,59,1,0,0,3
S01006998,Owned: Owned outright,166,110,66,13,53,44,0,56,53,1,0,0,2
S01006998,Owned: Owned with a mortgage or loan or shared ownership,199,192,161,9,152,31,0,7,6,0,0,0,1
S01006998,Rented or living rent free: Total,85,62,43,4,39,14,5,23,18,1,0,2,2
S01006998,Rented or living rent free: Social rented,31,16,14,2,12,1,1,15,12,0,0,1,2
S01006998,Rented or living rent free: Private rented or living rent free,54,46,29,2,27,13,4,8,6,1,0,1,0
S01006999,All HRPs aged 16 and over,334,272,176,23,153,92,4,62,49,2,1,7,3
S01006999,Owned: Total,253,210,133,18,115,76,1,43,39,1,0,2,1
S01006999,Owned: Owned outright,128,91,44,12,32,46,1,37,34,1,0,1,1
S01006999,Owned: Owned with a mortgage or loan or shared ownership,125,119,89,6,83,30,0,6,5,0,0,1,0
S01006999,Rented or living rent free: Total,81,62,43,5,38,16,3,19,10,1,1,5,2
S01006999,Rented or living rent free: Social rented,6,2,1,0,1,1,0,4,1,1,1,1,0
S01006999,Rented or living rent free: Private rented or living rent free,75,60,42,5,37,15,3,15,9,0,0,4,2
S01007000,All HRPs aged 16 and over,414,283,233,25,208,42,8,131,119,0,4,4,4
S01007000,Owned: Total,287,221,183,15,168,37,1,66,63,0,1,0,2
S01007000,Owned: Owned outright,111,50,35,5,30,14,1,61,58,0,1,0,2
S01007000,Owned: Owned with a mortgage or loan or shared ownership,176,171,148,10,138,23,0,5,5,0,0,0,0
S01007000,Rented or living rent free: Total,127,62,50,10,40,5,7,65,56,0,3,4,2
S01007000,Rented or living rent free: Social rented,107,45,36,6,30,2,7,62,54,0,2,4,2
S01007000,Rented or living rent free: Private rented or living rent free,20,17,14,4,10,3,0,3,2,0,1,0,0
S01007001,All HRPs aged 16 and over,388,272,216,18,198,50,6,116,106,1,5,4,0
S01007001,Owned: Total,300,211,166,11,155,43,2,89,85,0,3,1,0
S01007001,Owned: Owned outright,143,64,48,8,40,16,0,79,78,0,1,0,0
S01007001,Owned: Owned with a mortgage or loan or shared ownership,157,147,118,3,115,27,2,10,7,0,2,1,0
S01007001,Rented or living rent free: Total,88,61,50,7,43,7,4,27,21,1,2,3,0
S01007001,Rented or living rent free: Social rented,55,32,30,5,25,0,2,23,19,1,1,2,0
S01007001,Rented or living rent free: Private rented or living rent free,33,29,20,2,18,7,2,4,2,0,1,1,0
S01007002,All HRPs aged 16 and over,230,169,134,17,117,32,3,61,46,0,3,11,1
S01007002,Owned: Total,150,109,82,3,79,27,0,41,41,0,0,0,0
S01007002,Owned: Owned outright,70,30,12,0,12,18,0,40,40,0,0,0,0
S01007002,Owned: Owned with a mortgage or loan or shared ownership,80,79,70,3,67,9,0,1,1,0,0,0,0
S01007002,Rented or living rent free: Total,80,60,52,14,38,5,3,20,5,0,3,11,1
S01007002,Rented or living rent free: Social rented,45,30,28,13,15,0,2,15,3,0,2,10,0
S01007002,Rented or living rent free: Private rented or living rent free,35,30,24,1,23,5,1,5,2,0,1,1,1
S01007003,All HRPs aged 16 and over,205,161,93,10,83,65,3,44,39,0,2,3,0
S01007003,Owned: Total,150,117,66,9,57,51,0,33,32,0,0,1,0
S01007003,Owned: Owned outright,93,63,28,8,20,35,0,30,29,0,0,1,0
S01007003,Owned: Owned with a mortgage or loan or shared ownership,57,54,38,1,37,16,0,3,3,0,0,0,0
S01007003,Rented or living rent free: Total,55,44,27,1,26,14,3,11,7,0,2,2,0
S01007003,Rented or living rent free: Social rented,10,4,3,1,2,0,1,6,4,0,1,1,0
S01007003,Rented or living rent free: Private rented or living rent free,45,40,24,0,24,14,2,5,3,0,1,1,0
S01007004,All HRPs aged 16 and over,304,237,168,11,157,69,0,67,54,2,4,5,2
S01007004,Owned: Total,239,189,129,9,120,60,0,50,43,1,2,2,2
S01007004,Owned: Owned outright,139,94,48,6,42,46,0,45,41,1,1,1,1
S01007004,Owned: Owned with a mortgage or loan or shared ownership,100,95,81,3,78,14,0,5,2,0,1,1,1
S01007004,Rented or living rent free: Total,65,48,39,2,37,9,0,17,11,1,2,3,0
S01007004,Rented or living rent free: Social rented,12,2,2,0,2,0,0,10,6,1,2,1,0
S01007004,Rented or living rent free: Private rented or living rent free,53,46,37,2,35,9,0,7,5,0,0,2,0
S01007005,All HRPs aged 16 and over,348,280,200,20,180,77,3,68,64,0,2,2,0
S01007005,Owned: Total,283,228,162,13,149,65,1,55,54,0,1,0,0
S01007005,Owned: Owned outright,146,97,60,8,52,37,0,49,49,0,0,0,0
S01007005,Owned: Owned with a mortgage or loan or shared ownership,137,131,102,5,97,28,1,6,5,0,1,0,0
S01007005,Rented or living rent free: Total,65,52,38,7,31,12,2,13,10,0,1,2,0
S01007005,Rented or living rent free: Social rented,15,10,9,0,9,1,0,5,3,0,1,1,0
S01007005,Rented or living rent free: Private rented or living rent free,50,42,29,7,22,11,2,8,7,0,0,1,0
S01007006,All HRPs aged 16 and over,394,280,212,24,188,60,8,114,99,1,2,8,4
S01007006,Owned: Total,253,187,134,10,124,49,4,66,58,0,1,4,3
S01007006,Owned: Owned outright,138,78,46,10,36,30,2,60,54,0,0,4,2
S01007006,Owned: Owned with a mortgage or loan or shared ownership,115,109,88,0,88,19,2,6,4,0,1,0,1
S01007006,Rented or living rent free: Total,141,93,78,14,64,11,4,48,41,1,1,4,1
S01007006,Rented or living rent free: Social rented,70,35,30,8,22,1,4,35,31,0,1,3,0
S01007006,Rented or living rent free: Private rented or living rent free,71,58,48,6,42,10,0,13,10,1,0,1,1
S01007007,All HRPs aged 16 and over,338,266,160,16,144,100,6,72,61,0,2,6,3
S01007007,Owned: Total,247,196,109,10,99,85,2,51,46,0,1,2,2
S01007007,Owned: Owned outright,141,97,46,6,40,50,1,44,40,0,1,2,1
S01007007,Owned: Owned with a mortgage or loan or shared ownership,106,99,63,4,59,35,1,7,6,0,0,0,1
S01007007,Rented or living rent free: Total,91,70,51,6,45,15,4,21,15,0,1,4,1
S01007007,Rented or living rent free: Social rented,26,16,12,2,10,1,3,10,6,0,1,2,1
S01007007,Rented or living rent free: Private rented or living rent free,65,54,39,4,35,14,1,11,9,0,0,2,0
S01007008,All HRPs aged 16 and over,450,285,248,33,215,34,3,165,142,0,7,13,3
S01007008,Owned: Total,252,183,160,13,147,23,0,69,66,0,2,1,0
S01007008,Owned: Owned outright,124,61,54,10,44,7,0,63,61,0,1,1,0
S01007008,Owned: Owned with a mortgage or loan or shared ownership,128,122,106,3,103,16,0,6,5,0,1,0,0
S01007008,Rented or living rent free: Total,198,102,88,20,68,11,3,96,76,0,5,12,3
S01007008,Rented or living rent free: Social rented,153,71,61,16,45,7,3,82,64,0,5,10,3
S01007008,Rented or living rent free: Private rented or living rent free,45,31,27,4,23,4,0,14,12,0,0,2,0
S01007009,All HRPs aged 16 and over,496,306,249,42,207,46,11,190,170,2,1,11,6
S01007009,Owned: Total,331,211,171,23,148,40,0,120,115,2,0,1,2
S01007009,Owned: Owned outright,198,86,63,17,46,23,0,112,109,0,0,1,2
S01007009,Owned: Owned with a mortgage or loan or shared ownership,133,125,108,6,102,17,0,8,6,2,0,0,0
S01007009,Rented or living rent free: Total,165,95,78,19,59,6,11,70,55,0,1,10,4
S01007009,Rented or living rent free: Social rented,112,53,45,16,29,1,7,59,47,0,1,8,3
S01007009,Rented or living rent free: Private rented or living rent free,53,42,33,3,30,5,4,11,8,0,0,2,1
S01007010,All HRPs aged 16 and over,392,211,172,24,148,34,5,181,167,0,5,6,3
S01007010,Owned: Total,271,152,120,13,107,32,0,119,116,0,2,0,1
S01007010,Owned: Owned outright,179,72,54,8,46,18,0,107,104,0,2,0,1
S01007010,Owned: Owned with a mortgage or loan or shared ownership,92,80,66,5,61,14,0,12,12,0,0,0,0
S01007010,Rented or living rent free: Total,121,59,52,11,41,2,5,62,51,0,3,6,2
S01007010,Rented or living rent free: Social rented,79,26,23,8,15,0,3,53,48,0,0,4,1
S01007010,Rented or living rent free: Private rented or living rent free,42,33,29,3,26,2,2,9,3,0,3,2,1
S01007011,All HRPs aged 16 and over,463,268,217,36,181,29,22,195,167,4,7,16,1
S01007011,Owned: Total,221,154,126,16,110,25,3,67,66,0,0,0,1
S01007011,Owned: Owned outright,123,57,44,10,34,12,1,66,66,0,0,0,0
S01007011,Owned: Owned with a mortgage or loan or shared ownership,98,97,82,6,76,13,2,1,0,0,0,0,1
S01007011,Rented or living rent free: Total,242,114,91,20,71,4,19,128,101,4,7,16,0
S01007011,Rented or living rent free: Social rented,179,62,45,15,30,2,15,117,91,4,7,15,0
S01007011,Rented or living rent free: Private rented or living rent free,63,52,46,5,41,2,4,11,10,0,0,1,0
S01007012,All HRPs aged 16 and over,322,191,166,44,122,9,16,131,102,2,10,8,9
S01007012,Owned: Total,143,88,79,13,66,8,1,55,51,0,1,2,1
S01007012,Owned: Owned outright,84,36,34,8,26,1,1,48,45,0,1,2,0
S01007012,Owned: Owned with a mortgage or loan or shared ownership,59,52,45,5,40,7,0,7,6,0,0,0,1
S01007012,Rented or living rent free: Total,179,103,87,31,56,1,15,76,51,2,9,6,8
S01007012,Rented or living rent free: Social rented,160,89,75,28,47,1,13,71,47,2,9,6,7
S01007012,Rented or living rent free: Private rented or living rent free,19,14,12,3,9,0,2,5,4,0,0,0,1
S01007013,All HRPs aged 16 and over,222,174,101,12,89,71,2,48,44,0,0,3,1
S01007013,Owned: Total,190,148,82,8,74,66,0,42,40,0,0,2,0
S01007013,Owned: Owned outright,120,80,46,7,39,34,0,40,38,0,0,2,0
S01007013,Owned: Owned with a mortgage or loan or shared ownership,70,68,36,1,35,32,0,2,2,0,0,0,0
S01007013,Rented or living rent free: Total,32,26,19,4,15,5,2,6,4,0,0,1,1
S01007013,Rented or living rent free: Social rented,5,2,2,1,1,0,0,3,1,0,0,1,1
S01007013,Rented or living rent free: Private rented or living rent free,27,24,17,3,14,5,2,3,3,0,0,0,0
S01007014,All HRPs aged 16 and over,381,323,238,20,218,78,7,58,50,0,6,2,0
S01007014,Owned: Total,312,263,196,13,183,65,2,49,45,0,3,1,0
S01007014,Owned: Owned outright,123,80,53,7,46,27,0,43,42,0,0,1,0
S01007014,Owned: Owned with a mortgage or loan or shared ownership,189,183,143,6,137,38,2,6,3,0,3,0,0
S01007014,Rented or living rent free: Total,69,60,42,7,35,13,5,9,5,0,3,1,0
S01007014,Rented or living rent free: Social rented,9,6,4,2,2,1,1,3,2,0,1,0,0
S01007014,Rented or living rent free: Private rented or living rent free,60,54,38,5,33,12,4,6,3,0,2,1,0
S01007015,All HRPs aged 16 and over,247,195,121,14,107,73,1,52,43,1,3,5,0
S01007015,Owned: Total,158,131,80,9,71,51,0,27,25,0,1,1,0
S01007015,Owned: Owned outright,78,54,27,6,21,27,0,24,23,0,1,0,0
S01007015,Owned: Owned with a mortgage or loan or shared ownership,80,77,53,3,50,24,0,3,2,0,0,1,0
S01007015,Rented or living rent free: Total,89,64,41,5,36,22,1,25,18,1,2,4,0
S01007015,Rented or living rent free: Social rented,17,9,8,1,7,0,1,8,3,1,2,2,0
S01007015,Rented or living rent free: Private rented or living rent free,72,55,33,4,29,22,0,17,15,0,0,2,0
S01007016,All HRPs aged 16 and over,213,190,136,13,123,51,3,23,19,0,1,3,0
S01007016,Owned: Total,165,150,109,10,99,39,2,15,15,0,0,0,0
S01007016,Owned: Owned outright,73,59,36,8,28,22,1,14,14,0,0,0,0
S01007016,Owned: Owned with a mortgage or loan or shared ownership,92,91,73,2,71,17,1,1,1,0,0,0,0
S01007016,Rented or living rent free: Total,48,40,27,3,24,12,1,8,4,0,1,3,0
S01007016,Rented or living rent free: Social rented,8,5,4,3,1,1,0,3,1,0,0,2,0
S01007016,Rented or living rent free: Private rented or living rent free,40,35,23,0,23,11,1,5,3,0,1,1,0
S01007017,All HRPs aged 16 and over,476,300,262,39,223,31,7,176,157,2,3,10,4
S01007017,Owned: Total,281,212,191,26,165,20,1,69,67,0,0,1,1
S01007017,Owned: Owned outright,126,63,53,14,39,10,0,63,63,0,0,0,0
S01007017,Owned: Owned with a mortgage or loan or shared ownership,155,149,138,12,126,10,1,6,4,0,0,1,1
S01007017,Rented or living rent free: Total,195,88,71,13,58,11,6,107,90,2,3,9,3
S01007017,Rented or living rent free: Social rented,162,63,51,12,39,8,4,99,87,2,1,7,2
S01007017,Rented or living rent free: Private rented or living rent free,33,25,20,1,19,3,2,8,3,0,2,2,1
S01007018,All HRPs aged 16 and over,421,272,231,25,206,37,4,149,139,0,6,2,2
S01007018,Owned: Total,341,221,189,16,173,32,0,120,117,0,2,1,0
S01007018,Owned: Owned outright,179,61,49,12,37,12,0,118,116,0,1,1,0
S01007018,Owned: Owned with a mortgage or loan or shared ownership,162,160,140,4,136,20,0,2,1,0,1,0,0
S01007018,Rented or living rent free: Total,80,51,42,9,33,5,4,29,22,0,4,1,2
S01007018,Rented or living rent free: Social rented,55,32,23,7,16,5,4,23,16,0,4,1,2
S01007018,Rented or living rent free: Private rented or living rent free,25,19,19,2,17,0,0,6,6,0,0,0,0
S01007019,All HRPs aged 16 and over,309,189,158,19,139,25,6,120,104,2,2,5,7
S01007019,Owned: Total,205,125,102,11,91,22,1,80,72,0,1,3,4
S01007019,Owned: Owned outright,123,48,35,9,26,12,1,75,71,0,1,2,1
S01007019,Owned: Owned with a mortgage or loan or shared ownership,82,77,67,2,65,10,0,5,1,0,0,1,3
S01007019,Rented or living rent free: Total,104,64,56,8,48,3,5,40,32,2,1,2,3
S01007019,Rented or living rent free: Social rented,64,33,26,5,21,3,4,31,24,2,1,2,2
S01007019,Rented or living rent free: Private rented or living rent free,40,31,30,3,27,0,1,9,8,0,0,0,1
S01007020,All HRPs aged 16 and over,411,249,209,17,192,30,10,162,143,0,2,7,10
S01007020,Owned: Total,256,173,144,12,132,25,4,83,81,0,0,0,2
S01007020,Owned: Owned outright,127,54,46,8,38,7,1,73,71,0,0,0,2
S01007020,Owned: Owned with a mortgage or loan or shared ownership,129,119,98,4,94,18,3,10,10,0,0,0,0
S01007020,Rented or living rent free: Total,155,76,65,5,60,5,6,79,62,0,2,7,8
S01007020,Rented or living rent free: Social rented,89,26,18,2,16,3,5,63,50,0,2,5,6
S01007020,Rented or living rent free: Private rented or living rent free,66,50,47,3,44,2,1,16,12,0,0,2,2
S01007021,All HRPs aged 16 and over,403,240,214,39,175,26,0,163,155,0,4,2,2
S01007021,Owned: Total,304,189,165,24,141,24,0,115,112,0,1,0,2
S01007021,Owned: Owned outright,167,58,51,15,36,7,0,109,108,0,1,0,0
S01007021,Owned: Owned with a mortgage or loan or shared ownership,137,131,114,9,105,17,0,6,4,0,0,0,2
S01007021,Rented or living rent free: Total,99,51,49,15,34,2,0,48,43,0,3,2,0
S01007021,Rented or living rent free: Social rented,68,30,29,13,16,1,0,38,34,0,3,1,0
S01007021,Rented or living rent free: Private rented or living rent free,31,21,20,2,18,1,0,10,9,0,0,1,0
S01007022,All HRPs aged 16 and over,209,132,107,21,86,22,3,77,60,2,1,11,3
S01007022,Owned: Total,136,92,74,13,61,17,1,44,42,0,0,1,1
S01007022,Owned: Owned outright,82,39,31,11,20,7,1,43,41,0,0,1,1
S01007022,Owned: Owned with a mortgage or loan or shared ownership,54,53,43,2,41,10,0,1,1,0,0,0,0
S01007022,Rented or living rent free: Total,73,40,33,8,25,5,2,33,18,2,1,10,2
S01007022,Rented or living rent free: Social rented,62,32,27,8,19,4,1,30,15,2,1,10,2
S01007022,Rented or living rent free: Private rented or living rent free,11,8,6,0,6,1,1,3,3,0,0,0,0
S01007023,All HRPs aged 16 and over,203,132,83,12,71,48,1,71,62,0,2,7,0
S01007023,Owned: Total,122,78,46,4,42,32,0,44,39,0,2,3,0
S01007023,Owned: Owned outright,70,36,20,3,17,16,0,34,33,0,1,0,0
S01007023,Owned: Owned with a mortgage or loan or shared ownership,52,42,26,1,25,16,0,10,6,0,1,3,0
S01007023,Rented or living rent free: Total,81,54,37,8,29,16,1,27,23,0,0,4,0
S01007023,Rented or living rent free: Social rented,30,17,12,4,8,4,1,13,11,0,0,2,0
S01007023,Rented or living rent free: Private rented or living rent free,51,37,25,4,21,12,0,14,12,0,0,2,0
S01007024,All HRPs aged 16 and over,416,294,184,28,156,102,8,122,109,1,3,7,2
S01007024,Owned: Total,322,226,139,20,119,83,4,96,90,0,2,3,1
S01007024,Owned: Owned outright,202,119,60,13,47,55,4,83,78,0,2,2,1
S01007024,Owned: Owned with a mortgage or loan or shared ownership,120,107,79,7,72,28,0,13,12,0,0,1,0
S01007024,Rented or living rent free: Total,94,68,45,8,37,19,4,26,19,1,1,4,1
S01007024,Rented or living rent free: Social rented,32,19,15,5,10,3,1,13,9,1,1,2,0
S01007024,Rented or living rent free: Private rented or living rent free,62,49,30,3,27,16,3,13,10,0,0,2,1
S01007025,All HRPs aged 16 and over,389,229,196,28,168,26,7,160,136,1,2,16,5
S01007025,Owned: Total,224,141,118,10,108,22,1,83,79,0,0,3,1
S01007025,Owned: Owned outright,136,61,48,6,42,13,0,75,71,0,0,3,1
S01007025,Owned: Owned with a mortgage or loan or shared ownership,88,80,70,4,66,9,1,8,8,0,0,0,0
S01007025,Rented or living rent free: Total,165,88,78,18,60,4,6,77,57,1,2,13,4
S01007025,Rented or living rent free: Social rented,144,75,67,18,49,3,5,69,52,1,1,12,3
S01007025,Rented or living rent free: Private rented or living rent free,21,13,11,0,11,1,1,8,5,0,1,1,1
S01007026,All HRPs aged 16 and over,412,221,173,23,150,39,9,191,169,1,3,14,4
S01007026,Owned: Total,312,178,140,20,120,36,2,134,123,1,0,7,3
S01007026,Owned: Owned outright,208,81,66,14,52,14,1,127,119,1,0,6,1
S01007026,Owned: Owned with a mortgage or loan or shared ownership,104,97,74,6,68,22,1,7,4,0,0,1,2
S01007026,Rented or living rent free: Total,100,43,33,3,30,3,7,57,46,0,3,7,1
S01007026,Rented or living rent free: Social rented,69,19,14,1,13,1,4,50,40,0,3,6,1
S01007026,Rented or living rent free: Private rented or living rent free,31,24,19,2,17,2,3,7,6,0,0,1,0
S01007027,All HRPs aged 16 and over,481,283,215,31,184,61,7,198,162,3,7,22,4
S01007027,Owned: Total,338,225,173,21,152,51,1,113,105,2,2,2,2
S01007027,Owned: Owned outright,207,97,73,14,59,23,1,110,104,1,2,2,1
S01007027,Owned: Owned with a mortgage or loan or shared ownership,131,128,100,7,93,28,0,3,1,1,0,0,1
S01007027,Rented or living rent free: Total,143,58,42,10,32,10,6,85,57,1,5,20,2
S01007027,Rented or living rent free: Social rented,98,29,25,7,18,2,2,69,46,1,4,16,2
S01007027,Rented or living rent free: Private rented or living rent free,45,29,17,3,14,8,4,16,11,0,1,4,0
S01007028,All HRPs aged 16 and over,315,218,145,28,117,69,4,97,73,1,2,13,8
S01007028,Owned: Total,231,167,105,16,89,60,2,64,60,0,0,2,2
S01007028,Owned: Owned outright,141,84,45,13,32,37,2,57,54,0,0,1,2
S01007028,Owned: Owned with a mortgage or loan or shared ownership,90,83,60,3,57,23,0,7,6,0,0,1,0
S01007028,Rented or living rent free: Total,84,51,40,12,28,9,2,33,13,1,2,11,6
S01007028,Rented or living rent free: Social rented,21,8,7,5,2,1,0,13,3,1,2,5,2
S01007028,Rented or living rent free: Private rented or living rent free,63,43,33,7,26,8,2,20,10,0,0,6,4
S01007029,All HRPs aged 16 and over,221,159,85,8,77,72,2,62,55,0,2,3,2
S01007029,Owned: Total,201,147,78,8,70,68,1,54,49,0,1,2,2
S01007029,Owned: Owned outright,128,78,35,7,28,43,0,50,46,0,0,2,2
S01007029,Owned: Owned with a mortgage or loan or shared ownership,73,69,43,1,42,25,1,4,3,0,1,0,0
S01007029,Rented or living rent free: Total,20,12,7,0,7,4,1,8,6,0,1,1,0
S01007029,Rented or living rent free: Social rented,6,3,2,0,2,0,1,3,3,0,0,0,0
S01007029,Rented or living rent free: Private rented or living rent free,14,9,5,0,5,4,0,5,3,0,1,1,0
S01007030,All HRPs aged 16 and over,338,219,173,31,142,41,5,119,102,0,5,8,4
S01007030,Owned: Total,219,148,117,18,99,29,2,71,67,0,1,2,1
S01007030,Owned: Owned outright,140,74,58,14,44,16,0,66,62,0,1,2,1
S01007030,Owned: Owned with a mortgage or loan or shared ownership,79,74,59,4,55,13,2,5,5,0,0,0,0
S01007030,Rented or living rent free: Total,119,71,56,13,43,12,3,48,35,0,4,6,3
S01007030,Rented or living rent free: Social rented,95,54,45,12,33,6,3,41,28,0,4,6,3
S01007030,Rented or living rent free: Private rented or living rent free,24,17,11,1,10,6,0,7,7,0,0,0,0
S01007031,All HRPs aged 16 and over,285,184,137,21,116,38,9,101,82,1,3,11,4
S01007031,Owned: Total,152,106,71,8,63,35,0,46,44,0,1,1,0
S01007031,Owned: Owned outright,84,41,20,5,15,21,0,43,42,0,1,0,0
S01007031,Owned: Owned with a mortgage or loan or shared ownership,68,65,51,3,48,14,0,3,2,0,0,1,0
S01007031,Rented or living rent free: Total,133,78,66,13,53,3,9,55,38,1,2,10,4
S01007031,Rented or living rent free: Social rented,92,46,39,9,30,0,7,46,32,1,1,9,3
S01007031,Rented or living rent free: Private rented or living rent free,41,32,27,4,23,3,2,9,6,0,1,1,1
S01007032,All HRPs aged 16 and over,507,304,241,29,212,38,25,203,169,1,2,20,11
S01007032,Owned: Total,271,170,133,10,123,34,3,101,99,1,0,1,0
S01007032,Owned: Owned outright,153,57,44,9,35,12,1,96,95,1,0,0,0
S01007032,Owned: Owned with a mortgage or loan or shared ownership,118,113,89,1,88,22,2,5,4,0,0,1,0
S01007032,Rented or living rent free: Total,236,134,108,19,89,4,22,102,70,0,2,19,11
S01007032,Rented or living rent free: Social rented,153,66,48,14,34,0,18,87,58,0,1,18,10
S01007032,Rented or living rent free: Private rented or living rent free,83,68,60,5,55,4,4,15,12,0,1,1,1
S01007033,All HRPs aged 16 and over,338,220,201,40,161,10,9,118,98,1,4,13,2
S01007033,Owned: Total,207,147,138,17,121,8,1,60,57,0,0,3,0
S01007033,Owned: Owned outright,111,56,50,12,38,6,0,55,53,0,0,2,0
S01007033,Owned: Owned with a mortgage or loan or shared ownership,96,91,88,5,83,2,1,5,4,0,0,1,0
S01007033,Rented or living rent free: Total,131,73,63,23,40,2,8,58,41,1,4,10,2
S01007033,Rented or living rent free: Social rented,114,62,52,20,32,2,8,52,36,1,4,9,2
S01007033,Rented or living rent free: Private rented or living rent free,17,11,11,3,8,0,0,6,5,0,0,1,0
S01007034,All HRPs aged 16 and over,266,174,143,26,117,22,9,92,72,2,7,8,3
S01007034,Owned: Total,167,111,95,12,83,16,0,56,53,0,0,1,2
S01007034,Owned: Owned outright,88,35,31,7,24,4,0,53,50,0,0,1,2
S01007034,Owned: Owned with a mortgage or loan or shared ownership,79,76,64,5,59,12,0,3,3,0,0,0,0
S01007034,Rented or living rent free: Total,99,63,48,14,34,6,9,36,19,2,7,7,1
S01007034,Rented or living rent free: Social rented,74,42,31,13,18,2,9,32,16,2,6,7,1
S01007034,Rented or living rent free: Private rented or living rent free,25,21,17,1,16,4,0,4,3,0,1,0,0
S01007035,All HRPs aged 16 and over,375,213,184,49,135,23,6,162,125,2,7,22,6
S01007035,Owned: Total,178,112,94,21,73,16,2,66,64,0,0,2,0
S01007035,Owned: Owned outright,103,40,31,8,23,8,1,63,61,0,0,2,0
S01007035,Owned: Owned with a mortgage or loan or shared ownership,75,72,63,13,50,8,1,3,3,0,0,0,0
S01007035,Rented or living rent free: Total,197,101,90,28,62,7,4,96,61,2,7,20,6
S01007035,Rented or living rent free: Social rented,174,86,77,26,51,5,4,88,55,2,6,19,6
S01007035,Rented or living rent free: Private rented or living rent free,23,15,13,2,11,2,0,8,6,0,1,1,0
S01007036,All HRPs aged 16 and over,401,251,196,30,166,51,4,150,130,4,1,13,2
S01007036,Owned: Total,283,191,146,18,128,44,1,92,88,1,0,3,0
S01007036,Owned: Owned outright,167,80,58,13,45,22,0,87,86,0,0,1,0
S01007036,Owned: Owned with a mortgage or loan or shared ownership,116,111,88,5,83,22,1,5,2,1,0,2,0
S01007036,Rented or living rent free: Total,118,60,50,12,38,7,3,58,42,3,1,10,2
S01007036,Rented or living rent free: Social rented,86,40,33,10,23,4,3,46,30,3,1,10,2
S01007036,Rented or living rent free: Private rented or living rent free,32,20,17,2,15,3,0,12,12,0,0,0,0
S01007037,All HRPs aged 16 and over,453,281,241,50,191,28,12,172,137,1,5,28,1
S01007037,Owned: Total,277,194,166,24,142,25,3,83,75,0,1,6,1
S01007037,Owned: Owned outright,137,64,51,15,36,10,3,73,69,0,1,3,0
S01007037,Owned: Owned with a mortgage or loan or shared ownership,140,130,115,9,106,15,0,10,6,0,0,3,1
S01007037,Rented or living rent free: Total,176,87,75,26,49,3,9,89,62,1,4,22,0
S01007037,Rented or living rent free: Social rented,158,73,61,25,36,3,9,85,59,1,4,21,0
S01007037,Rented or living rent free: Private rented or living rent free,18,14,14,1,13,0,0,4,3,0,0,1,0
S01007038,All HRPs aged 16 and over,328,232,189,23,166,36,7,96,71,1,4,14,6
S01007038,Owned: Total,215,158,122,10,112,33,3,57,51,0,1,4,1
S01007038,Owned: Owned outright,110,59,40,7,33,18,1,51,47,0,1,2,1
S01007038,Owned: Owned with a mortgage or loan or shared ownership,105,99,82,3,79,15,2,6,4,0,0,2,0
S01007038,Rented or living rent free: Total,113,74,67,13,54,3,4,39,20,1,3,10,5
S01007038,Rented or living rent free: Social rented,75,46,40,9,31,2,4,29,13,1,3,8,4
S01007038,Rented or living rent free: Private rented or living rent free,38,28,27,4,23,1,0,10,7,0,0,2,1
S01007039,All HRPs aged 16 and over,368,248,206,31,175,30,12,120,95,2,6,14,3
S01007039,Owned: Total,232,172,146,18,128,26,0,60,59,0,1,0,0
S01007039,Owned: Owned outright,112,55,46,9,37,9,0,57,57,0,0,0,0
S01007039,Owned: Owned with a mortgage or loan or shared ownership,120,117,100,9,91,17,0,3,2,0,1,0,0
S01007039,Rented or living rent free: Total,136,76,60,13,47,4,12,60,36,2,5,14,3
S01007039,Rented or living rent free: Social rented,120,62,47,11,36,3,12,58,34,2,5,14,3
S01007039,Rented or living rent free: Private rented or living rent free,16,14,13,2,11,1,0,2,2,0,0,0,0
S01007040,All HRPs aged 16 and over,301,188,155,37,118,21,12,113,96,1,5,9,2
S01007040,Owned: Total,181,116,96,16,80,18,2,65,62,0,0,3,0
S01007040,Owned: Owned outright,108,44,36,10,26,7,1,64,61,0,0,3,0
S01007040,Owned: Owned with a mortgage or loan or shared ownership,73,72,60,6,54,11,1,1,1,0,0,0,0
S01007040,Rented or living rent free: Total,120,72,59,21,38,3,10,48,34,1,5,6,2
S01007040,Rented or living rent free: Social rented,102,58,49,21,28,3,6,44,30,1,5,6,2
S01007040,Rented or living rent free: Private rented or living rent free,18,14,10,0,10,0,4,4,4,0,0,0,0
S01007041,All HRPs aged 16 and over,344,217,171,26,145,35,11,127,105,1,1,15,5
S01007041,Owned: Total,238,164,133,18,115,30,1,74,70,0,0,3,1
S01007041,Owned: Owned outright,132,66,54,13,41,11,1,66,64,0,0,1,1
S01007041,Owned: Owned with a mortgage or loan or shared ownership,106,98,79,5,74,19,0,8,6,0,0,2,0
S01007041,Rented or living rent free: Total,106,53,38,8,30,5,10,53,35,1,1,12,4
S01007041,Rented or living rent free: Social rented,90,40,27,7,20,3,10,50,32,1,1,12,4
S01007041,Rented or living rent free: Private rented or living rent free,16,13,11,1,10,2,0,3,3,0,0,0,0
S01007042,All HRPs aged 16 and over,318,208,159,16,143,39,10,110,98,0,3,5,4
S01007042,Owned: Total,227,162,126,10,116,31,5,65,61,0,2,0,2
S01007042,Owned: Owned outright,120,60,37,8,29,18,5,60,57,0,1,0,2
S01007042,Owned: Owned with a mortgage or loan or shared ownership,107,102,89,2,87,13,0,5,4,0,1,0,0
S01007042,Rented or living rent free: Total,91,46,33,6,27,8,5,45,37,0,1,5,2
S01007042,Rented or living rent free: Social rented,64,26,21,5,16,0,5,38,32,0,1,4,1
S01007042,Rented or living rent free: Private rented or living rent free,27,20,12,1,11,8,0,7,5,0,0,1,1
S01007043,All HRPs aged 16 and over,382,304,190,15,175,109,5,78,65,0,1,7,5
S01007043,Owned: Total,281,222,129,9,120,89,4,59,53,0,0,3,3
S01007043,Owned: Owned outright,180,128,54,7,47,70,4,52,48,0,0,3,1
S01007043,Owned: Owned with a mortgage or loan or shared ownership,101,94,75,2,73,19,0,7,5,0,0,0,2
S01007043,Rented or living rent free: Total,101,82,61,6,55,20,1,19,12,0,1,4,2
S01007043,Rented or living rent free: Social rented,10,5,4,1,3,0,1,5,3,0,0,1,1
S01007043,Rented or living rent free: Private rented or living rent free,91,77,57,5,52,20,0,14,9,0,1,3,1
S01007044,All HRPs aged 16 and over,306,180,119,16,103,56,5,126,102,4,3,13,4
S01007044,Owned: Total,228,143,90,12,78,50,3,85,77,2,3,1,2
S01007044,Owned: Owned outright,141,67,42,9,33,22,3,74,71,0,2,0,1
S01007044,Owned: Owned with a mortgage or loan or shared ownership,87,76,48,3,45,28,0,11,6,2,1,1,1
S01007044,Rented or living rent free: Total,78,37,29,4,25,6,2,41,25,2,0,12,2
S01007044,Rented or living rent free: Social rented,37,12,8,2,6,2,2,25,20,0,0,5,0
S01007044,Rented or living rent free: Private rented or living rent free,41,25,21,2,19,4,0,16,5,2,0,7,2
S01007045,All HRPs aged 16 and over,325,232,135,18,117,92,5,93,84,0,1,8,0
S01007045,Owned: Total,278,200,112,13,99,84,4,78,70,0,1,7,0
S01007045,Owned: Owned outright,168,101,39,10,29,58,4,67,62,0,1,4,0
S01007045,Owned: Owned with a mortgage or loan or shared ownership,110,99,73,3,70,26,0,11,8,0,0,3,0
S01007045,Rented or living rent free: Total,47,32,23,5,18,8,1,15,14,0,0,1,0
S01007045,Rented or living rent free: Social rented,7,4,3,1,2,1,0,3,3,0,0,0,0
S01007045,Rented or living rent free: Private rented or living rent free,40,28,20,4,16,7,1,12,11,0,0,1,0
S01007046,All HRPs aged 16 and over,259,188,144,17,127,43,1,71,60,0,4,5,2
S01007046,Owned: Total,217,159,121,14,107,38,0,58,53,0,2,2,1
S01007046,Owned: Owned outright,130,77,56,12,44,21,0,53,49,0,2,1,1
S01007046,Owned: Owned with a mortgage or loan or shared ownership,87,82,65,2,63,17,0,5,4,0,0,1,0
S01007046,Rented or living rent free: Total,42,29,23,3,20,5,1,13,7,0,2,3,1
S01007046,Rented or living rent free: Social rented,14,7,6,0,6,0,1,7,4,0,0,2,1
S01007046,Rented or living rent free: Private rented or living rent free,28,22,17,3,14,5,0,6,3,0,2,1,0
S01007047,All HRPs aged 16 and over,261,195,130,12,118,64,1,66,60,0,3,3,0
S01007047,Owned: Total,231,176,117,11,106,59,0,55,54,0,0,1,0
S01007047,Owned: Owned outright,139,86,44,7,37,42,0,53,52,0,0,1,0
S01007047,Owned: Owned with a mortgage or loan or shared ownership,92,90,73,4,69,17,0,2,2,0,0,0,0
S01007047,Rented or living rent free: Total,30,19,13,1,12,5,1,11,6,0,3,2,0
S01007047,Rented or living rent free: Social rented,7,3,2,0,2,1,0,4,2,0,1,1,0
S01007047,Rented or living rent free: Private rented or living rent free,23,16,11,1,10,4,1,7,4,0,2,1,0
S01007048,All HRPs aged 16 and over,359,270,179,19,160,84,7,89,78,2,3,4,2
S01007048,Owned: Total,295,225,152,16,136,70,3,70,66,0,2,1,1
S01007048,Owned: Owned outright,164,104,50,11,39,53,1,60,59,0,0,0,1
S01007048,Owned: Owned with a mortgage or loan or shared ownership,131,121,102,5,97,17,2,10,7,0,2,1,0
S01007048,Rented or living rent free: Total,64,45,27,3,24,14,4,19,12,2,1,3,1
S01007048,Rented or living rent free: Social rented,27,16,12,2,10,1,3,11,6,2,0,2,1
S01007048,Rented or living rent free: Private rented or living rent free,37,29,15,1,14,13,1,8,6,0,1,1,0
S01007049,All HRPs aged 16 and over,415,275,231,33,198,34,10,140,113,2,8,15,2
S01007049,Owned: Total,244,182,155,16,139,27,0,62,57,1,1,3,0
S01007049,Owned: Owned outright,134,75,62,9,53,13,0,59,57,1,0,1,0
S01007049,Owned: Owned with a mortgage or loan or shared ownership,110,107,93,7,86,14,0,3,0,0,1,2,0
S01007049,Rented or living rent free: Total,171,93,76,17,59,7,10,78,56,1,7,12,2
S01007049,Rented or living rent free: Social rented,133,69,57,14,43,3,9,64,47,1,4,11,1
S01007049,Rented or living rent free: Private rented or living rent free,38,24,19,3,16,4,1,14,9,0,3,1,1
S01007050,All HRPs aged 16 and over,295,181,135,21,114,40,6,114,95,0,2,14,3
S01007050,Owned: Total,218,153,116,19,97,35,2,65,61,0,1,1,2
S01007050,Owned: Owned outright,116,58,38,13,25,18,2,58,57,0,0,1,0
S01007050,Owned: Owned with a mortgage or loan or shared ownership,102,95,78,6,72,17,0,7,4,0,1,0,2
S01007050,Rented or living rent free: Total,77,28,19,2,17,5,4,49,34,0,1,13,1
S01007050,Rented or living rent free: Social rented,49,14,8,0,8,3,3,35,29,0,1,4,1
S01007050,Rented or living rent free: Private rented or living rent free,28,14,11,2,9,2,1,14,5,0,0,9,0
S01007051,All HRPs aged 16 and over,332,237,194,20,174,39,4,95,81,0,3,9,2
S01007051,Owned: Total,233,186,153,13,140,32,1,47,46,0,1,0,0
S01007051,Owned: Owned outright,110,66,50,9,41,15,1,44,44,0,0,0,0
S01007051,Owned: Owned with a mortgage or loan or shared ownership,123,120,103,4,99,17,0,3,2,0,1,0,0
S01007051,Rented or living rent free: Total,99,51,41,7,34,7,3,48,35,0,2,9,2
S01007051,Rented or living rent free: Social rented,65,28,23,3,20,2,3,37,33,0,1,3,0
S01007051,Rented or living rent free: Private rented or living rent free,34,23,18,4,14,5,0,11,2,0,1,6,2
S01007052,All HRPs aged 16 and over,233,165,125,11,114,33,7,68,57,3,3,4,1
S01007052,Owned: Total,188,134,100,8,92,30,4,54,51,1,1,0,1
S01007052,Owned: Owned outright,97,47,29,5,24,16,2,50,49,0,1,0,0
S01007052,Owned: Owned with a mortgage or loan or shared ownership,91,87,71,3,68,14,2,4,2,1,0,0,1
S01007052,Rented or living rent free: Total,45,31,25,3,22,3,3,14,6,2,2,4,0
S01007052,Rented or living rent free: Social rented,22,12,12,2,10,0,0,10,5,2,1,2,0
S01007052,Rented or living rent free: Private rented or living rent free,23,19,13,1,12,3,3,4,1,0,1,2,0
S01007053,All HRPs aged 16 and over,191,143,108,12,96,33,2,48,46,0,1,1,0
S01007053,Owned: Total,167,127,94,10,84,31,2,40,39,0,1,0,0
S01007053,Owned: Owned outright,88,51,32,6,26,17,2,37,36,0,1,0,0
S01007053,Owned: Owned with a mortgage or loan or shared ownership,79,76,62,4,58,14,0,3,3,0,0,0,0
S01007053,Rented or living rent free: Total,24,16,14,2,12,2,0,8,7,0,0,1,0
S01007053,Rented or living rent free: Social rented,1,0,0,0,0,0,0,1,1,0,0,0,0
S01007053,Rented or living rent free: Private rented or living rent free,23,16,14,2,12,2,0,7,6,0,0,1,0
S01007054,All HRPs aged 16 and over,434,270,228,40,188,33,9,164,143,0,0,11,10
S01007054,Owned: Total,293,209,178,23,155,29,2,84,80,0,0,1,3
S01007054,Owned: Owned outright,162,82,66,18,48,14,2,80,78,0,0,1,1
S01007054,Owned: Owned with a mortgage or loan or shared ownership,131,127,112,5,107,15,0,4,2,0,0,0,2
S01007054,Rented or living rent free: Total,141,61,50,17,33,4,7,80,63,0,0,10,7
S01007054,Rented or living rent free: Social rented,98,35,31,12,19,1,3,63,54,0,0,6,3
S01007054,Rented or living rent free: Private rented or living rent free,43,26,19,5,14,3,4,17,9,0,0,4,4
S01007055,All HRPs aged 16 and over,196,158,93,10,83,64,1,38,30,0,1,6,1
S01007055,Owned: Total,163,130,70,7,63,59,1,33,29,0,1,2,1
S01007055,Owned: Owned outright,92,64,25,4,21,38,1,28,26,0,0,1,1
S01007055,Owned: Owned with a mortgage or loan or shared ownership,71,66,45,3,42,21,0,5,3,0,1,1,0
S01007055,Rented or living rent free: Total,33,28,23,3,20,5,0,5,1,0,0,4,0
S01007055,Rented or living rent free: Social rented,3,1,1,0,1,0,0,2,0,0,0,2,0
S01007055,Rented or living rent free: Private rented or living rent free,30,27,22,3,19,5,0,3,1,0,0,2,0
S01007056,All HRPs aged 16 and over,221,180,109,9,100,67,4,41,34,1,0,6,0
S01007056,Owned: Total,185,155,93,8,85,61,1,30,27,1,0,2,0
S01007056,Owned: Owned outright,102,74,28,4,24,45,1,28,25,1,0,2,0
S01007056,Owned: Owned with a mortgage or loan or shared ownership,83,81,65,4,61,16,0,2,2,0,0,0,0
S01007056,Rented or living rent free: Total,36,25,16,1,15,6,3,11,7,0,0,4,0
S01007056,Rented or living rent free: Social rented,6,5,3,0,3,0,2,1,0,0,0,1,0
S01007056,Rented or living rent free: Private rented or living rent free,30,20,13,1,12,6,1,10,7,0,0,3,0
S01007057,All HRPs aged 16 and over,247,135,116,18,98,16,3,112,103,0,0,6,3
S01007057,Owned: Total,205,122,105,17,88,15,2,83,82,0,0,0,1
S01007057,Owned: Owned outright,138,59,53,16,37,6,0,79,78,0,0,0,1
S01007057,Owned: Owned with a mortgage or loan or shared ownership,67,63,52,1,51,9,2,4,4,0,0,0,0
S01007057,Rented or living rent free: Total,42,13,11,1,10,1,1,29,21,0,0,6,2
S01007057,Rented or living rent free: Social rented,31,9,7,1,6,1,1,22,15,0,0,5,2
S01007057,Rented or living rent free: Private rented or living rent free,11,4,4,0,4,0,0,7,6,0,0,1,0
S01007058,All HRPs aged 16 and over,288,148,126,19,107,17,5,140,127,1,2,7,3
S01007058,Owned: Total,181,115,96,14,82,16,3,66,64,1,0,0,1
S01007058,Owned: Owned outright,104,41,34,10,24,6,1,63,61,1,0,0,1
S01007058,Owned: Owned with a mortgage or loan or shared ownership,77,74,62,4,58,10,2,3,3,0,0,0,0
S01007058,Rented or living rent free: Total,107,33,30,5,25,1,2,74,63,0,2,7,2
S01007058,Rented or living rent free: Social rented,100,27,25,5,20,1,1,73,62,0,2,7,2
S01007058,Rented or living rent free: Private rented or living rent free,7,6,5,0,5,0,1,1,1,0,0,0,0
S01007059,All HRPs aged 16 and over,433,283,240,23,217,37,6,150,124,1,6,13,6
S01007059,Owned: Total,323,226,195,12,183,29,2,97,92,0,1,4,0
S01007059,Owned: Owned outright,156,70,57,9,48,12,1,86,83,0,1,2,0
S01007059,Owned: Owned with a mortgage or loan or shared ownership,167,156,138,3,135,17,1,11,9,0,0,2,0
S01007059,Rented or living rent free: Total,110,57,45,11,34,8,4,53,32,1,5,9,6
S01007059,Rented or living rent free: Social rented,79,37,28,9,19,6,3,42,29,1,3,7,2
S01007059,Rented or living rent free: Private rented or living rent free,31,20,17,2,15,2,1,11,3,0,2,2,4
S01007060,All HRPs aged 16 and over,231,161,134,33,101,15,12,70,50,0,8,10,2
S01007060,Owned: Total,133,101,86,13,73,12,3,32,30,0,0,1,1
S01007060,Owned: Owned outright,58,28,21,8,13,6,1,30,28,0,0,1,1
S01007060,Owned: Owned with a mortgage or loan or shared ownership,75,73,65,5,60,6,2,2,2,0,0,0,0
S01007060,Rented or living rent free: Total,98,60,48,20,28,3,9,38,20,0,8,9,1
S01007060,Rented or living rent free: Social rented,90,54,42,16,26,3,9,36,19,0,8,9,0
S01007060,Rented or living rent free: Private rented or living rent free,8,6,6,4,2,0,0,2,1,0,0,0,1
S01007061,All HRPs aged 16 and over,346,296,226,13,213,65,5,50,44,0,2,4,0
S01007061,Owned: Total,289,252,197,12,185,53,2,37,35,0,1,1,0
S01007061,Owned: Owned outright,125,92,57,6,51,33,2,33,32,0,0,1,0
S01007061,Owned: Owned with a mortgage or loan or shared ownership,164,160,140,6,134,20,0,4,3,0,1,0,0
S01007061,Rented or living rent free: Total,57,44,29,1,28,12,3,13,9,0,1,3,0
S01007061,Rented or living rent free: Social rented,7,1,1,0,1,0,0,6,4,0,0,2,0
S01007061,Rented or living rent free: Private rented or living rent free,50,43,28,1,27,12,3,7,5,0,1,1,0
S01007062,All HRPs aged 16 and over,272,225,151,16,135,73,1,47,40,1,3,2,1
S01007062,Owned: Total,229,196,127,14,113,68,1,33,31,0,0,1,1
S01007062,Owned: Owned outright,118,91,49,9,40,41,1,27,27,0,0,0,0
S01007062,Owned: Owned with a mortgage or loan or shared ownership,111,105,78,5,73,27,0,6,4,0,0,1,1
S01007062,Rented or living rent free: Total,43,29,24,2,22,5,0,14,9,1,3,1,0
S01007062,Rented or living rent free: Social rented,8,1,1,1,0,0,0,7,4,1,1,1,0
S01007062,Rented or living rent free: Private rented or living rent free,35,28,23,1,22,5,0,7,5,0,2,0,0
S01007063,All HRPs aged 16 and over,282,190,153,20,133,35,2,92,83,0,1,8,0
S01007063,Owned: Total,214,161,130,16,114,29,2,53,53,0,0,0,0
S01007063,Owned: Owned outright,107,56,44,10,34,11,1,51,51,0,0,0,0
S01007063,Owned: Owned with a mortgage or loan or shared ownership,107,105,86,6,80,18,1,2,2,0,0,0,0
S01007063,Rented or living rent free: Total,68,29,23,4,19,6,0,39,30,0,1,8,0
S01007063,Rented or living rent free: Social rented,40,8,6,2,4,2,0,32,26,0,1,5,0
S01007063,Rented or living rent free: Private rented or living rent free,28,21,17,2,15,4,0,7,4,0,0,3,0
S01007064,All HRPs aged 16 and over,253,200,137,14,123,61,2,53,43,0,2,5,3
S01007064,Owned: Total,192,155,100,7,93,54,1,37,32,0,2,3,0
S01007064,Owned: Owned outright,104,74,38,7,31,35,1,30,28,0,1,1,0
S01007064,Owned: Owned with a mortgage or loan or shared ownership,88,81,62,0,62,19,0,7,4,0,1,2,0
S01007064,Rented or living rent free: Total,61,45,37,7,30,7,1,16,11,0,0,2,3
S01007064,Rented or living rent free: Social rented,31,20,17,4,13,2,1,11,9,0,0,1,1
S01007064,Rented or living rent free: Private rented or living rent free,30,25,20,3,17,5,0,5,2,0,0,1,2
S01007065,All HRPs aged 16 and over,249,185,150,19,131,33,2,64,54,0,2,6,2
S01007065,Owned: Total,205,155,122,11,111,32,1,50,48,0,0,1,1
S01007065,Owned: Owned outright,114,66,45,8,37,21,0,48,46,0,0,1,1
S01007065,Owned: Owned with a mortgage or loan or shared ownership,91,89,77,3,74,11,1,2,2,0,0,0,0
S01007065,Rented or living rent free: Total,44,30,28,8,20,1,1,14,6,0,2,5,1
S01007065,Rented or living rent free: Social rented,23,14,14,8,6,0,0,9,3,0,1,4,1
S01007065,Rented or living rent free: Private rented or living rent free,21,16,14,0,14,1,1,5,3,0,1,1,0
S01007066,All HRPs aged 16 and over,252,208,144,12,132,59,5,44,35,1,1,7,0
S01007066,Owned: Total,211,180,124,8,116,52,4,31,29,0,0,2,0
S01007066,Owned: Owned outright,98,73,38,5,33,34,1,25,24,0,0,1,0
S01007066,Owned: Owned with a mortgage or loan or shared ownership,113,107,86,3,83,18,3,6,5,0,0,1,0
S01007066,Rented or living rent free: Total,41,28,20,4,16,7,1,13,6,1,1,5,0
S01007066,Rented or living rent free: Social rented,12,6,5,3,2,1,0,6,3,0,0,3,0
S01007066,Rented or living rent free: Private rented or living rent free,29,22,15,1,14,6,1,7,3,1,1,2,0
S01007067,All HRPs aged 16 and over,254,193,169,15,154,19,5,61,55,1,2,1,2
S01007067,Owned: Total,232,180,158,14,144,18,4,52,47,1,2,0,2
S01007067,Owned: Owned outright,115,68,56,12,44,8,4,47,43,1,2,0,1
S01007067,Owned: Owned with a mortgage or loan or shared ownership,117,112,102,2,100,10,0,5,4,0,0,0,1
S01007067,Rented or living rent free: Total,22,13,11,1,10,1,1,9,8,0,0,1,0
S01007067,Rented or living rent free: Social rented,5,2,2,1,1,0,0,3,2,0,0,1,0
S01007067,Rented or living rent free: Private rented or living rent free,17,11,9,0,9,1,1,6,6,0,0,0,0
S01007068,All HRPs aged 16 and over,329,210,164,19,145,39,7,119,90,4,7,11,7
S01007068,Owned: Total,200,144,116,10,106,28,0,56,50,0,4,0,2
S01007068,Owned: Owned outright,94,43,37,7,30,6,0,51,48,0,1,0,2
S01007068,Owned: Owned with a mortgage or loan or shared ownership,106,101,79,3,76,22,0,5,2,0,3,0,0
S01007068,Rented or living rent free: Total,129,66,48,9,39,11,7,63,40,4,3,11,5
S01007068,Rented or living rent free: Social rented,105,51,39,7,32,6,6,54,32,4,3,11,4
S01007068,Rented or living rent free: Private rented or living rent free,24,15,9,2,7,5,1,9,8,0,0,0,1
S01007069,All HRPs aged 16 and over,338,242,204,25,179,31,7,96,69,1,7,12,7
S01007069,Owned: Total,231,168,143,10,133,25,0,63,54,0,2,3,4
S01007069,Owned: Owned outright,97,44,39,4,35,5,0,53,48,0,0,3,2
S01007069,Owned: Owned with a mortgage or loan or shared ownership,134,124,104,6,98,20,0,10,6,0,2,0,2
S01007069,Rented or living rent free: Total,107,74,61,15,46,6,7,33,15,1,5,9,3
S01007069,Rented or living rent free: Social rented,70,43,35,11,24,3,5,27,12,1,3,8,3
S01007069,Rented or living rent free: Private rented or living rent free,37,31,26,4,22,3,2,6,3,0,2,1,0
S01007070,All HRPs aged 16 and over,247,168,136,15,121,18,14,79,53,0,6,18,2
S01007070,Owned: Total,162,121,104,11,93,14,3,41,31,0,2,7,1
S01007070,Owned: Owned outright,72,39,32,8,24,5,2,33,26,0,2,4,1
S01007070,Owned: Owned with a mortgage or loan or shared ownership,90,82,72,3,69,9,1,8,5,0,0,3,0
S01007070,Rented or living rent free: Total,85,47,32,4,28,4,11,38,22,0,4,11,1
S01007070,Rented or living rent free: Social rented,69,33,26,3,23,3,4,36,22,0,3,10,1
S01007070,Rented or living rent free: Private rented or living rent free,16,14,6,1,5,1,7,2,0,0,1,1,0
S01007071,All HRPs aged 16 and over,356,265,230,17,213,25,10,91,71,0,4,11,5
S01007071,Owned: Total,249,193,172,9,163,20,1,56,50,0,1,2,3
S01007071,Owned: Owned outright,102,57,48,4,44,8,1,45,42,0,0,1,2
S01007071,Owned: Owned with a mortgage or loan or shared ownership,147,136,124,5,119,12,0,11,8,0,1,1,1
S01007071,Rented or living rent free: Total,107,72,58,8,50,5,9,35,21,0,3,9,2
S01007071,Rented or living rent free: Social rented,92,58,45,6,39,4,9,34,20,0,3,9,2
S01007071,Rented or living rent free: Private rented or living rent free,15,14,13,2,11,1,0,1,1,0,0,0,0
S01007072,All HRPs aged 16 and over,246,209,171,19,152,31,7,37,32,1,1,2,1
S01007072,Owned: Total,213,185,151,17,134,31,3,28,25,0,1,1,1
S01007072,Owned: Owned outright,91,68,54,10,44,14,0,23,23,0,0,0,0
S01007072,Owned: Owned with a mortgage or loan or shared ownership,122,117,97,7,90,17,3,5,2,0,1,1,1
S01007072,Rented or living rent free: Total,33,24,20,2,18,0,4,9,7,1,0,1,0
S01007072,Rented or living rent free: Social rented,16,8,6,0,6,0,2,8,6,1,0,1,0
S01007072,Rented or living rent free: Private rented or living rent free,17,16,14,2,12,0,2,1,1,0,0,0,0
S01007073,All HRPs aged 16 and over,358,251,210,27,183,38,3,107,97,0,2,7,1
S01007073,Owned: Total,325,231,195,23,172,35,1,94,90,0,0,3,1
S01007073,Owned: Owned outright,172,81,66,18,48,14,1,91,87,0,0,3,1
S01007073,Owned: Owned with a mortgage or loan or shared ownership,153,150,129,5,124,21,0,3,3,0,0,0,0
S01007073,Rented or living rent free: Total,33,20,15,4,11,3,2,13,7,0,2,4,0
S01007073,Rented or living rent free: Social rented,20,12,10,4,6,1,1,8,2,0,2,4,0
S01007073,Rented or living rent free: Private rented or living rent free,13,8,5,0,5,2,1,5,5,0,0,0,0
S01007074,All HRPs aged 16 and over,292,216,182,38,144,22,12,76,59,2,8,6,1
S01007074,Owned: Total,186,145,128,19,109,15,2,41,39,1,0,1,0
S01007074,Owned: Owned outright,92,55,49,15,34,4,2,37,36,0,0,1,0
S01007074,Owned: Owned with a mortgage or loan or shared ownership,94,90,79,4,75,11,0,4,3,1,0,0,0
S01007074,Rented or living rent free: Total,106,71,54,19,35,7,10,35,20,1,8,5,1
S01007074,Rented or living rent free: Social rented,94,62,46,18,28,7,9,32,18,0,8,5,1
S01007074,Rented or living rent free: Private rented or living rent free,12,9,8,1,7,0,1,3,2,1,0,0,0
S01007075,All HRPs aged 16 and over,305,210,199,36,163,7,4,95,77,1,5,8,4
S01007075,Owned: Total,174,132,127,19,108,5,0,42,41,0,0,0,1
S01007075,Owned: Owned outright,77,41,39,10,29,2,0,36,36,0,0,0,0
S01007075,Owned: Owned with a mortgage or loan or shared ownership,97,91,88,9,79,3,0,6,5,0,0,0,1
S01007075,Rented or living rent free: Total,131,78,72,17,55,2,4,53,36,1,5,8,3
S01007075,Rented or living rent free: Social rented,106,56,50,12,38,2,4,50,34,1,5,8,2
S01007075,Rented or living rent free: Private rented or living rent free,25,22,22,5,17,0,0,3,2,0,0,0,1
S01007076,All HRPs aged 16 and over,289,222,195,24,171,24,3,67,54,0,5,4,4
S01007076,Owned: Total,214,171,154,18,136,16,1,43,40,0,0,1,2
S01007076,Owned: Owned outright,86,51,41,7,34,9,1,35,34,0,0,0,1
S01007076,Owned: Owned with a mortgage or loan or shared ownership,128,120,113,11,102,7,0,8,6,0,0,1,1
S01007076,Rented or living rent free: Total,75,51,41,6,35,8,2,24,14,0,5,3,2
S01007076,Rented or living rent free: Social rented,60,40,33,5,28,5,2,20,12,0,5,3,0
S01007076,Rented or living rent free: Private rented or living rent free,15,11,8,1,7,3,0,4,2,0,0,0,2
S01007077,All HRPs aged 16 and over,311,201,183,34,149,15,3,110,95,1,0,10,4
S01007077,Owned: Total,239,159,146,21,125,12,1,80,74,1,0,3,2
S01007077,Owned: Owned outright,136,61,54,15,39,6,1,75,69,1,0,3,2
S01007077,Owned: Owned with a mortgage or loan or shared ownership,103,98,92,6,86,6,0,5,5,0,0,0,0
S01007077,Rented or living rent free: Total,72,42,37,13,24,3,2,30,21,0,0,7,2
S01007077,Rented or living rent free: Social rented,54,30,26,11,15,2,2,24,15,0,0,7,2
S01007077,Rented or living rent free: Private rented or living rent free,18,12,11,2,9,1,0,6,6,0,0,0,0
S01007078,All HRPs aged 16 and over,398,241,196,45,151,23,22,157,130,1,4,13,9
S01007078,Owned: Total,248,149,128,23,105,21,0,99,95,0,0,2,2
S01007078,Owned: Owned outright,159,66,56,14,42,10,0,93,91,0,0,2,0
S01007078,Owned: Owned with a mortgage or loan or shared ownership,89,83,72,9,63,11,0,6,4,0,0,0,2
S01007078,Rented or living rent free: Total,150,92,68,22,46,2,22,58,35,1,4,11,7
S01007078,Rented or living rent free: Social rented,121,72,50,20,30,1,21,49,30,1,2,10,6
S01007078,Rented or living rent free: Private rented or living rent free,29,20,18,2,16,1,1,9,5,0,2,1,1
S01007079,All HRPs aged 16 and over,522,276,233,33,200,29,14,246,197,1,4,35,9
S01007079,Owned: Total,288,178,150,19,131,26,2,110,103,1,1,3,2
S01007079,Owned: Owned outright,150,50,40,10,30,9,1,100,94,0,1,3,2
S01007079,Owned: Owned with a mortgage or loan or shared ownership,138,128,110,9,101,17,1,10,9,1,0,0,0
S01007079,Rented or living rent free: Total,234,98,83,14,69,3,12,136,94,0,3,32,7
S01007079,Rented or living rent free: Social rented,187,66,53,14,39,2,11,121,84,0,2,28,7
S01007079,Rented or living rent free: Private rented or living rent free,47,32,30,0,30,1,1,15,10,0,1,4,0
S01007080,All HRPs aged 16 and over,386,228,189,29,160,20,19,158,131,4,4,16,3
S01007080,Owned: Total,227,139,121,8,113,17,1,88,83,0,0,3,2
S01007080,Owned: Owned outright,128,48,40,6,34,7,1,80,78,0,0,1,1
S01007080,Owned: Owned with a mortgage or loan or shared ownership,99,91,81,2,79,10,0,8,5,0,0,2,1
S01007080,Rented or living rent free: Total,159,89,68,21,47,3,18,70,48,4,4,13,1
S01007080,Rented or living rent free: Social rented,121,60,43,17,26,1,16,61,43,4,4,10,0
S01007080,Rented or living rent free: Private rented or living rent free,38,29,25,4,21,2,2,9,5,0,0,3,1
S01007081,All HRPs aged 16 and over,370,259,220,29,191,30,9,111,70,1,14,19,7
S01007081,Owned: Total,198,143,119,9,110,21,3,55,50,0,2,3,0
S01007081,Owned: Owned outright,88,40,32,4,28,8,0,48,45,0,1,2,0
S01007081,Owned: Owned with a mortgage or loan or shared ownership,110,103,87,5,82,13,3,7,5,0,1,1,0
S01007081,Rented or living rent free: Total,172,116,101,20,81,9,6,56,20,1,12,16,7
S01007081,Rented or living rent free: Social rented,130,79,69,19,50,5,5,51,20,1,11,14,5
S01007081,Rented or living rent free: Private rented or living rent free,42,37,32,1,31,4,1,5,0,0,1,2,2
S01007082,All HRPs aged 16 and over,233,160,139,26,113,17,4,73,45,1,6,11,10
S01007082,Owned: Total,141,98,88,11,77,10,0,43,33,1,1,5,3
S01007082,Owned: Owned outright,63,28,24,6,18,4,0,35,28,1,1,4,1
S01007082,Owned: Owned with a mortgage or loan or shared ownership,78,70,64,5,59,6,0,8,5,0,0,1,2
S01007082,Rented or living rent free: Total,92,62,51,15,36,7,4,30,12,0,5,6,7
S01007082,Rented or living rent free: Social rented,66,39,31,11,20,5,3,27,11,0,3,6,7
S01007082,Rented or living rent free: Private rented or living rent free,26,23,20,4,16,2,1,3,1,0,2,0,0
S01007083,All HRPs aged 16 and over,451,259,221,37,184,18,20,192,131,4,7,37,13
S01007083,Owned: Total,154,91,77,11,66,13,1,63,59,1,0,1,2
S01007083,Owned: Owned outright,99,39,33,10,23,6,0,60,56,1,0,1,2
S01007083,Owned: Owned with a mortgage or loan or shared ownership,55,52,44,1,43,7,1,3,3,0,0,0,0
S01007083,Rented or living rent free: Total,297,168,144,26,118,5,19,129,72,3,7,36,11
S01007083,Rented or living rent free: Social rented,244,124,101,24,77,5,18,120,68,2,7,35,8
S01007083,Rented or living rent free: Private rented or living rent free,53,44,43,2,41,0,1,9,4,1,0,1,3
S01007084,All HRPs aged 16 and over,273,163,133,16,117,26,4,110,100,0,0,6,4
S01007084,Owned: Total,197,128,101,13,88,24,3,69,67,0,0,2,0
S01007084,Owned: Owned outright,113,46,31,9,22,12,3,67,65,0,0,2,0
S01007084,Owned: Owned with a mortgage or loan or shared ownership,84,82,70,4,66,12,0,2,2,0,0,0,0
S01007084,Rented or living rent free: Total,76,35,32,3,29,2,1,41,33,0,0,4,4
S01007084,Rented or living rent free: Social rented,43,9,8,2,6,1,0,34,30,0,0,3,1
S01007084,Rented or living rent free: Private rented or living rent free,33,26,24,1,23,1,1,7,3,0,0,1,3
S01007085,All HRPs aged 16 and over,366,272,217,21,196,35,20,94,60,6,5,19,4
S01007085,Owned: Total,206,155,122,7,115,28,5,51,45,0,1,3,2
S01007085,Owned: Owned outright,96,51,35,5,30,12,4,45,42,0,0,1,2
S01007085,Owned: Owned with a mortgage or loan or shared ownership,110,104,87,2,85,16,1,6,3,0,1,2,0
S01007085,Rented or living rent free: Total,160,117,95,14,81,7,15,43,15,6,4,16,2
S01007085,Rented or living rent free: Social rented,61,34,24,8,16,4,6,27,14,1,2,9,1
S01007085,Rented or living rent free: Private rented or living rent free,99,83,71,6,65,3,9,16,1,5,2,7,1
S01007086,All HRPs aged 16 and over,573,411,340,60,280,24,47,162,75,10,8,51,18
S01007086,Owned: Total,143,99,86,9,77,11,2,44,37,0,1,3,3
S01007086,Owned: Owned outright,73,34,25,5,20,9,0,39,34,0,0,2,3
S01007086,Owned: Owned with a mortgage or loan or shared ownership,70,65,61,4,57,2,2,5,3,0,1,1,0
S01007086,Rented or living rent free: Total,430,312,254,51,203,13,45,118,38,10,7,48,15
S01007086,Rented or living rent free: Social rented,286,187,146,37,109,9,32,99,33,9,4,42,11
S01007086,Rented or living rent free: Private rented or living rent free,144,125,108,14,94,4,13,19,5,1,3,6,4
S01007087,All HRPs aged 16 and over,439,293,245,45,200,26,22,146,95,3,7,36,5
S01007087,Owned: Total,158,104,88,18,70,14,2,54,48,1,0,4,1
S01007087,Owned: Owned outright,84,36,26,6,20,9,1,48,44,1,0,2,1
S01007087,Owned: Owned with a mortgage or loan or shared ownership,74,68,62,12,50,5,1,6,4,0,0,2,0
S01007087,Rented or living rent free: Total,281,189,157,27,130,12,20,92,47,2,7,32,4
S01007087,Rented or living rent free: Social rented,169,87,66,19,47,8,13,82,40,1,6,32,3
S01007087,Rented or living rent free: Private rented or living rent free,112,102,91,8,83,4,7,10,7,1,1,0,1
S01007088,All HRPs aged 16 and over,247,160,129,25,104,14,17,87,40,3,9,27,8
S01007088,Owned: Total,91,68,58,2,56,7,3,23,19,1,1,1,1
S01007088,Owned: Owned outright,36,14,9,1,8,3,2,22,19,1,1,1,0
S01007088,Owned: Owned with a mortgage or loan or shared ownership,55,54,49,1,48,4,1,1,0,0,0,0,1
S01007088,Rented or living rent free: Total,156,92,71,23,48,7,14,64,21,2,8,26,7
S01007088,Rented or living rent free: Social rented,122,66,50,17,33,3,13,56,18,2,6,25,5
S01007088,Rented or living rent free: Private rented or living rent free,34,26,21,6,15,4,1,8,3,0,2,1,2
S01007089,All HRPs aged 16 and over,217,165,132,9,123,29,4,52,47,0,1,1,3
S01007089,Owned: Total,197,150,124,9,115,24,2,47,44,0,1,0,2
S01007089,Owned: Owned outright,109,65,49,7,42,15,1,44,41,0,1,0,2
S01007089,Owned: Owned with a mortgage or loan or shared ownership,88,85,75,2,73,9,1,3,3,0,0,0,0
S01007089,Rented or living rent free: Total,20,15,8,0,8,5,2,5,3,0,0,1,1
S01007089,Rented or living rent free: Social rented,5,1,1,0,1,0,0,4,2,0,0,1,1
S01007089,Rented or living rent free: Private rented or living rent free,15,14,7,0,7,5,2,1,1,0,0,0,0
S01007090,All HRPs aged 16 and over,243,197,166,14,152,26,5,46,43,0,0,0,3
S01007090,Owned: Total,206,166,137,11,126,24,5,40,38,0,0,0,2
S01007090,Owned: Owned outright,74,36,28,6,22,6,2,38,37,0,0,0,1
S01007090,Owned: Owned with a mortgage or loan or shared ownership,132,130,109,5,104,18,3,2,1,0,0,0,1
S01007090,Rented or living rent free: Total,37,31,29,3,26,2,0,6,5,0,0,0,1
S01007090,Rented or living rent free: Social rented,4,2,2,0,2,0,0,2,1,0,0,0,1
S01007090,Rented or living rent free: Private rented or living rent free,33,29,27,3,24,2,0,4,4,0,0,0,0
S01007091,All HRPs aged 16 and over,280,236,207,34,173,18,11,44,14,2,14,11,3
S01007091,Owned: Total,157,146,131,12,119,13,2,11,8,0,1,0,2
S01007091,Owned: Owned outright,26,19,16,4,12,3,0,7,6,0,0,0,1
S01007091,Owned: Owned with a mortgage or loan or shared ownership,131,127,115,8,107,10,2,4,2,0,1,0,1
S01007091,Rented or living rent free: Total,123,90,76,22,54,5,9,33,6,2,13,11,1
S01007091,Rented or living rent free: Social rented,114,83,71,19,52,4,8,31,4,2,13,11,1
S01007091,Rented or living rent free: Private rented or living rent free,9,7,5,3,2,1,1,2,2,0,0,0,0
S01007092,All HRPs aged 16 and over,307,169,153,30,123,12,4,138,111,1,5,20,1
S01007092,Owned: Total,161,122,112,17,95,8,2,39,37,0,0,2,0
S01007092,Owned: Owned outright,78,42,36,10,26,5,1,36,34,0,0,2,0
S01007092,Owned: Owned with a mortgage or loan or shared ownership,83,80,76,7,69,3,1,3,3,0,0,0,0
S01007092,Rented or living rent free: Total,146,47,41,13,28,4,2,99,74,1,5,18,1
S01007092,Rented or living rent free: Social rented,133,37,34,12,22,2,1,96,73,1,4,17,1
S01007092,Rented or living rent free: Private rented or living rent free,13,10,7,1,6,2,1,3,1,0,1,1,0
S01007093,All HRPs aged 16 and over,417,286,246,28,218,36,4,131,123,0,1,4,3
S01007093,Owned: Total,372,255,220,24,196,32,3,117,114,0,1,1,1
S01007093,Owned: Owned outright,198,87,70,11,59,15,2,111,110,0,1,0,0
S01007093,Owned: Owned with a mortgage or loan or shared ownership,174,168,150,13,137,17,1,6,4,0,0,1,1
S01007093,Rented or living rent free: Total,45,31,26,4,22,4,1,14,9,0,0,3,2
S01007093,Rented or living rent free: Social rented,12,5,4,1,3,1,0,7,3,0,0,3,1
S01007093,Rented or living rent free: Private rented or living rent free,33,26,22,3,19,3,1,7,6,0,0,0,1
S01007094,All HRPs aged 16 and over,354,246,192,23,169,51,3,108,95,0,3,8,2
S01007094,Owned: Total,313,221,170,19,151,49,2,92,84,0,2,4,2
S01007094,Owned: Owned outright,186,98,71,18,53,26,1,88,81,0,1,4,2
S01007094,Owned: Owned with a mortgage or loan or shared ownership,127,123,99,1,98,23,1,4,3,0,1,0,0
S01007094,Rented or living rent free: Total,41,25,22,4,18,2,1,16,11,0,1,4,0
S01007094,Rented or living rent free: Social rented,21,8,8,3,5,0,0,13,9,0,0,4,0
S01007094,Rented or living rent free: Private rented or living rent free,20,17,14,1,13,2,1,3,2,0,1,0,0
S01007095,All HRPs aged 16 and over,209,159,107,14,93,50,2,50,41,0,0,9,0
S01007095,Owned: Total,183,141,96,11,85,45,0,42,36,0,0,6,0
S01007095,Owned: Owned outright,89,55,32,6,26,23,0,34,31,0,0,3,0
S01007095,Owned: Owned with a mortgage or loan or shared ownership,94,86,64,5,59,22,0,8,5,0,0,3,0
S01007095,Rented or living rent free: Total,26,18,11,3,8,5,2,8,5,0,0,3,0
S01007095,Rented or living rent free: Social rented,4,1,1,0,1,0,0,3,1,0,0,2,0
S01007095,Rented or living rent free: Private rented or living rent free,22,17,10,3,7,5,2,5,4,0,0,1,0
S01007096,All HRPs aged 16 and over,316,252,199,11,188,49,4,64,57,1,3,2,1
S01007096,Owned: Total,261,224,177,8,169,47,0,37,36,0,1,0,0
S01007096,Owned: Owned outright,84,49,35,6,29,14,0,35,34,0,1,0,0
S01007096,Owned: Owned with a mortgage or loan or shared ownership,177,175,142,2,140,33,0,2,2,0,0,0,0
S01007096,Rented or living rent free: Total,55,28,22,3,19,2,4,27,21,1,2,2,1
S01007096,Rented or living rent free: Social rented,38,14,11,2,9,0,3,24,19,1,2,1,1
S01007096,Rented or living rent free: Private rented or living rent free,17,14,11,1,10,2,1,3,2,0,0,1,0
S01007097,All HRPs aged 16 and over,188,155,114,7,107,38,3,33,29,0,2,2,0
S01007097,Owned: Total,167,138,99,6,93,37,2,29,26,0,1,2,0
S01007097,Owned: Owned outright,68,42,23,4,19,19,0,26,25,0,0,1,0
S01007097,Owned: Owned with a mortgage or loan or shared ownership,99,96,76,2,74,18,2,3,1,0,1,1,0
S01007097,Rented or living rent free: Total,21,17,15,1,14,1,1,4,3,0,1,0,0
S01007097,Rented or living rent free: Social rented,3,2,2,0,2,0,0,1,1,0,0,0,0
S01007097,Rented or living rent free: Private rented or living rent free,18,15,13,1,12,1,1,3,2,0,1,0,0
S01007098,All HRPs aged 16 and over,288,227,158,10,148,68,1,61,54,0,0,3,4
S01007098,Owned: Total,266,211,144,10,134,66,1,55,52,0,0,1,2
S01007098,Owned: Owned outright,135,84,55,6,49,28,1,51,49,0,0,1,1
S01007098,Owned: Owned with a mortgage or loan or shared ownership,131,127,89,4,85,38,0,4,3,0,0,0,1
S01007098,Rented or living rent free: Total,22,16,14,0,14,2,0,6,2,0,0,2,2
S01007098,Rented or living rent free: Social rented,2,2,2,0,2,0,0,0,0,0,0,0,0
S01007098,Rented or living rent free: Private rented or living rent free,20,14,12,0,12,2,0,6,2,0,0,2,2
S01007099,All HRPs aged 16 and over,338,254,184,19,165,67,3,84,72,0,4,7,1
S01007099,Owned: Total,278,226,160,15,145,65,1,52,48,0,2,2,0
S01007099,Owned: Owned outright,112,71,55,11,44,15,1,41,41,0,0,0,0
S01007099,Owned: Owned with a mortgage or loan or shared ownership,166,155,105,4,101,50,0,11,7,0,2,2,0
S01007099,Rented or living rent free: Total,60,28,24,4,20,2,2,32,24,0,2,5,1
S01007099,Rented or living rent free: Social rented,42,15,12,0,12,1,2,27,21,0,2,3,1
S01007099,Rented or living rent free: Private rented or living rent free,18,13,12,4,8,1,0,5,3,0,0,2,0
S01007100,All HRPs aged 16 and over,298,222,176,20,156,41,5,76,63,2,2,7,2
S01007100,Owned: Total,226,175,135,15,120,38,2,51,49,0,0,1,1
S01007100,Owned: Owned outright,126,79,58,10,48,20,1,47,45,0,0,1,1
S01007100,Owned: Owned with a mortgage or loan or shared ownership,100,96,77,5,72,18,1,4,4,0,0,0,0
S01007100,Rented or living rent free: Total,72,47,41,5,36,3,3,25,14,2,2,6,1
S01007100,Rented or living rent free: Social rented,41,20,17,4,13,1,2,21,12,1,2,5,1
S01007100,Rented or living rent free: Private rented or living rent free,31,27,24,1,23,2,1,4,2,1,0,1,0
S01007101,All HRPs aged 16 and over,342,231,190,24,166,27,14,111,77,1,12,17,4
S01007101,Owned: Total,161,127,104,7,97,21,2,34,32,1,0,1,0
S01007101,Owned: Owned outright,80,48,39,7,32,8,1,32,31,0,0,1,0
S01007101,Owned: Owned with a mortgage or loan or shared ownership,81,79,65,0,65,13,1,2,1,1,0,0,0
S01007101,Rented or living rent free: Total,181,104,86,17,69,6,12,77,45,0,12,16,4
S01007101,Rented or living rent free: Social rented,154,82,69,13,56,4,9,72,42,0,11,15,4
S01007101,Rented or living rent free: Private rented or living rent free,27,22,17,4,13,2,3,5,3,0,1,1,0
S01007102,All HRPs aged 16 and over,260,186,139,12,127,43,4,74,62,1,3,4,4
S01007102,Owned: Total,206,144,104,5,99,37,3,62,55,1,2,1,3
S01007102,Owned: Owned outright,124,72,48,3,45,21,3,52,50,0,0,0,2
S01007102,Owned: Owned with a mortgage or loan or shared ownership,82,72,56,2,54,16,0,10,5,1,2,1,1
S01007102,Rented or living rent free: Total,54,42,35,7,28,6,1,12,7,0,1,3,1
S01007102,Rented or living rent free: Social rented,6,6,5,1,4,0,1,0,0,0,0,0,0
S01007102,Rented or living rent free: Private rented or living rent free,48,36,30,6,24,6,0,12,7,0,1,3,1
S01007103,All HRPs aged 16 and over,330,219,167,25,142,51,1,111,94,2,3,6,6
S01007103,Owned: Total,256,179,132,13,119,47,0,77,75,0,0,1,1
S01007103,Owned: Owned outright,163,90,65,8,57,25,0,73,71,0,0,1,1
S01007103,Owned: Owned with a mortgage or loan or shared ownership,93,89,67,5,62,22,0,4,4,0,0,0,0
S01007103,Rented or living rent free: Total,74,40,35,12,23,4,1,34,19,2,3,5,5
S01007103,Rented or living rent free: Social rented,66,34,30,10,20,3,1,32,18,2,2,5,5
S01007103,Rented or living rent free: Private rented or living rent free,8,6,5,2,3,1,0,2,1,0,1,0,0
S01007104,All HRPs aged 16 and over,197,134,86,11,75,46,2,63,54,0,2,5,2
S01007104,Owned: Total,161,107,64,10,54,41,2,54,49,0,1,2,2
S01007104,Owned: Owned outright,96,49,22,6,16,26,1,47,44,0,1,0,2
S01007104,Owned: Owned with a mortgage or loan or shared ownership,65,58,42,4,38,15,1,7,5,0,0,2,0
S01007104,Rented or living rent free: Total,36,27,22,1,21,5,0,9,5,0,1,3,0
S01007104,Rented or living rent free: Social rented,2,1,1,0,1,0,0,1,1,0,0,0,0
S01007104,Rented or living rent free: Private rented or living rent free,34,26,21,1,20,5,0,8,4,0,1,3,0
S01007105,All HRPs aged 16 and over,238,132,107,20,87,22,3,106,90,1,4,4,7
S01007105,Owned: Total,182,113,91,14,77,20,2,69,65,0,1,0,3
S01007105,Owned: Owned outright,112,44,34,11,23,9,1,68,65,0,0,0,3
S01007105,Owned: Owned with a mortgage or loan or shared ownership,70,69,57,3,54,11,1,1,0,0,1,0,0
S01007105,Rented or living rent free: Total,56,19,16,6,10,2,1,37,25,1,3,4,4
S01007105,Rented or living rent free: Social rented,40,9,8,3,5,1,0,31,22,1,1,4,3
S01007105,Rented or living rent free: Private rented or living rent free,16,10,8,3,5,1,1,6,3,0,2,0,1
S01007106,All HRPs aged 16 and over,319,188,144,23,121,35,9,131,106,1,5,16,3
S01007106,Owned: Total,248,155,119,20,99,33,3,93,85,0,2,6,0
S01007106,Owned: Owned outright,151,71,52,15,37,16,3,80,76,0,2,2,0
S01007106,Owned: Owned with a mortgage or loan or shared ownership,97,84,67,5,62,17,0,13,9,0,0,4,0
S01007106,Rented or living rent free: Total,71,33,25,3,22,2,6,38,21,1,3,10,3
S01007106,Rented or living rent free: Social rented,51,21,17,3,14,1,3,30,19,1,1,7,2
S01007106,Rented or living rent free: Private rented or living rent free,20,12,8,0,8,1,3,8,2,0,2,3,1
S01007107,All HRPs aged 16 and over,256,197,136,15,121,59,2,59,55,2,0,1,1
S01007107,Owned: Total,231,179,121,13,108,56,2,52,48,2,0,1,1
S01007107,Owned: Owned outright,124,76,45,9,36,29,2,48,46,1,0,0,1
S01007107,Owned: Owned with a mortgage or loan or shared ownership,107,103,76,4,72,27,0,4,2,1,0,1,0
S01007107,Rented or living rent free: Total,25,18,15,2,13,3,0,7,7,0,0,0,0
S01007107,Rented or living rent free: Social rented,6,4,4,1,3,0,0,2,2,0,0,0,0
S01007107,Rented or living rent free: Private rented or living rent free,19,14,11,1,10,3,0,5,5,0,0,0,0
S01007108,All HRPs aged 16 and over,226,166,102,13,89,62,2,60,50,1,1,6,2
S01007108,Owned: Total,185,137,77,7,70,59,1,48,43,0,0,3,2
S01007108,Owned: Owned outright,107,64,23,6,17,40,1,43,39,0,0,2,2
S01007108,Owned: Owned with a mortgage or loan or shared ownership,78,73,54,1,53,19,0,5,4,0,0,1,0
S01007108,Rented or living rent free: Total,41,29,25,6,19,3,1,12,7,1,1,3,0
S01007108,Rented or living rent free: Social rented,8,8,8,2,6,0,0,0,0,0,0,0,0
S01007108,Rented or living rent free: Private rented or living rent free,33,21,17,4,13,3,1,12,7,1,1,3,0
S01007109,All HRPs aged 16 and over,371,226,186,32,154,31,9,145,105,2,5,28,5
S01007109,Owned: Total,188,121,98,14,84,23,0,67,64,0,0,3,0
S01007109,Owned: Owned outright,106,43,31,5,26,12,0,63,60,0,0,3,0
S01007109,Owned: Owned with a mortgage or loan or shared ownership,82,78,67,9,58,11,0,4,4,0,0,0,0
S01007109,Rented or living rent free: Total,183,105,88,18,70,8,9,78,41,2,5,25,5
S01007109,Rented or living rent free: Social rented,157,82,69,15,54,4,9,75,40,2,4,24,5
S01007109,Rented or living rent free: Private rented or living rent free,26,23,19,3,16,4,0,3,1,0,1,1,0
S01007110,All HRPs aged 16 and over,324,222,178,29,149,30,14,102,81,1,5,14,1
S01007110,Owned: Total,191,138,110,8,102,25,3,53,48,1,2,2,0
S01007110,Owned: Owned outright,87,42,33,5,28,8,1,45,42,1,2,0,0
S01007110,Owned: Owned with a mortgage or loan or shared ownership,104,96,77,3,74,17,2,8,6,0,0,2,0
S01007110,Rented or living rent free: Total,133,84,68,21,47,5,11,49,33,0,3,12,1
S01007110,Rented or living rent free: Social rented,110,68,55,17,38,4,9,42,27,0,3,11,1
S01007110,Rented or living rent free: Private rented or living rent free,23,16,13,4,9,1,2,7,6,0,0,1,0
S01007111,All HRPs aged 16 and over,225,145,121,15,106,18,6,80,63,2,5,8,2
S01007111,Owned: Total,173,120,105,13,92,14,1,53,46,1,4,1,1
S01007111,Owned: Owned outright,93,48,41,8,33,6,1,45,43,1,0,1,0
S01007111,Owned: Owned with a mortgage or loan or shared ownership,80,72,64,5,59,8,0,8,3,0,4,0,1
S01007111,Rented or living rent free: Total,52,25,16,2,14,4,5,27,17,1,1,7,1
S01007111,Rented or living rent free: Social rented,40,19,12,1,11,3,4,21,12,1,1,6,1
S01007111,Rented or living rent free: Private rented or living rent free,12,6,4,1,3,1,1,6,5,0,0,1,0
S01007112,All HRPs aged 16 and over,214,136,96,14,82,37,3,78,72,0,0,4,2
S01007112,Owned: Total,192,120,83,12,71,35,2,72,68,0,0,3,1
S01007112,Owned: Owned outright,126,59,44,10,34,13,2,67,64,0,0,2,1
S01007112,Owned: Owned with a mortgage or loan or shared ownership,66,61,39,2,37,22,0,5,4,0,0,1,0
S01007112,Rented or living rent free: Total,22,16,13,2,11,2,1,6,4,0,0,1,1
S01007112,Rented or living rent free: Social rented,8,5,2,1,1,2,1,3,1,0,0,1,1
S01007112,Rented or living rent free: Private rented or living rent free,14,11,11,1,10,0,0,3,3,0,0,0,0
S01007113,All HRPs aged 16 and over,231,145,114,11,103,30,1,86,77,0,1,7,1
S01007113,Owned: Total,193,116,90,9,81,26,0,77,73,0,0,3,1
S01007113,Owned: Owned outright,121,46,31,8,23,15,0,75,72,0,0,2,1
S01007113,Owned: Owned with a mortgage or loan or shared ownership,72,70,59,1,58,11,0,2,1,0,0,1,0
S01007113,Rented or living rent free: Total,38,29,24,2,22,4,1,9,4,0,1,4,0
S01007113,Rented or living rent free: Social rented,12,6,5,2,3,1,0,6,3,0,0,3,0
S01007113,Rented or living rent free: Private rented or living rent free,26,23,19,0,19,3,1,3,1,0,1,1,0
S01007114,All HRPs aged 16 and over,378,237,207,25,182,30,0,141,122,1,2,12,4
S01007114,Owned: Total,318,207,181,18,163,26,0,111,106,0,1,1,3
S01007114,Owned: Owned outright,181,77,65,12,53,12,0,104,101,0,1,0,2
S01007114,Owned: Owned with a mortgage or loan or shared ownership,137,130,116,6,110,14,0,7,5,0,0,1,1
S01007114,Rented or living rent free: Total,60,30,26,7,19,4,0,30,16,1,1,11,1
S01007114,Rented or living rent free: Social rented,41,22,19,6,13,3,0,19,8,1,0,9,1
S01007114,Rented or living rent free: Private rented or living rent free,19,8,7,1,6,1,0,11,8,0,1,2,0
S01007115,All HRPs aged 16 and over,257,156,128,15,113,26,2,101,89,3,2,4,3
S01007115,Owned: Total,209,137,114,12,102,23,0,72,64,2,1,2,3
S01007115,Owned: Owned outright,115,46,33,9,24,13,0,69,63,2,0,2,2
S01007115,Owned: Owned with a mortgage or loan or shared ownership,94,91,81,3,78,10,0,3,1,0,1,0,1
S01007115,Rented or living rent free: Total,48,19,14,3,11,3,2,29,25,1,1,2,0
S01007115,Rented or living rent free: Social rented,37,12,11,3,8,0,1,25,22,0,1,2,0
S01007115,Rented or living rent free: Private rented or living rent free,11,7,3,0,3,3,1,4,3,1,0,0,0
S01007116,All HRPs aged 16 and over,315,280,207,22,185,68,5,35,31,0,1,2,1
S01007116,Owned: Total,298,267,198,22,176,65,4,31,30,0,1,0,0
S01007116,Owned: Owned outright,121,94,67,16,51,24,3,27,27,0,0,0,0
S01007116,Owned: Owned with a mortgage or loan or shared ownership,177,173,131,6,125,41,1,4,3,0,1,0,0
S01007116,Rented or living rent free: Total,17,13,9,0,9,3,1,4,1,0,0,2,1
S01007116,Rented or living rent free: Social rented,6,4,3,0,3,1,0,2,1,0,0,1,0
S01007116,Rented or living rent free: Private rented or living rent free,11,9,6,0,6,2,1,2,0,0,0,1,1
S01007117,All HRPs aged 16 and over,177,122,90,10,80,32,0,55,53,0,2,0,0
S01007117,Owned: Total,163,112,81,9,72,31,0,51,51,0,0,0,0
S01007117,Owned: Owned outright,101,51,35,8,27,16,0,50,50,0,0,0,0
S01007117,Owned: Owned with a mortgage or loan or shared ownership,62,61,46,1,45,15,0,1,1,0,0,0,0
S01007117,Rented or living rent free: Total,14,10,9,1,8,1,0,4,2,0,2,0,0
S01007117,Rented or living rent free: Social rented,7,4,4,1,3,0,0,3,1,0,2,0,0
S01007117,Rented or living rent free: Private rented or living rent free,7,6,5,0,5,1,0,1,1,0,0,0,0
S01007118,All HRPs aged 16 and over,282,201,172,37,135,16,13,81,45,3,9,23,1
S01007118,Owned: Total,114,91,83,11,72,8,0,23,19,0,1,3,0
S01007118,Owned: Owned outright,42,25,23,7,16,2,0,17,16,0,0,1,0
S01007118,Owned: Owned with a mortgage or loan or shared ownership,72,66,60,4,56,6,0,6,3,0,1,2,0
S01007118,Rented or living rent free: Total,168,110,89,26,63,8,13,58,26,3,8,20,1
S01007118,Rented or living rent free: Social rented,143,91,72,25,47,8,11,52,25,3,5,18,1
S01007118,Rented or living rent free: Private rented or living rent free,25,19,17,1,16,0,2,6,1,0,3,2,0
S01007119,All HRPs aged 16 and over,330,213,183,38,145,19,11,117,75,4,11,24,3
S01007119,Owned: Total,156,121,106,16,90,13,2,35,31,1,1,1,1
S01007119,Owned: Owned outright,73,45,38,13,25,6,1,28,26,1,0,1,0
S01007119,Owned: Owned with a mortgage or loan or shared ownership,83,76,68,3,65,7,1,7,5,0,1,0,1
S01007119,Rented or living rent free: Total,174,92,77,22,55,6,9,82,44,3,10,23,2
S01007119,Rented or living rent free: Social rented,158,80,66,22,44,5,9,78,41,3,9,23,2
S01007119,Rented or living rent free: Private rented or living rent free,16,12,11,0,11,1,0,4,3,0,1,0,0
S01007120,All HRPs aged 16 and over,483,318,271,37,234,20,27,165,99,2,10,46,8
S01007120,Owned: Total,199,147,133,14,119,12,2,52,45,0,1,6,0
S01007120,Owned: Owned outright,84,36,32,10,22,3,1,48,43,0,0,5,0
S01007120,Owned: Owned with a mortgage or loan or shared ownership,115,111,101,4,97,9,1,4,2,0,1,1,0
S01007120,Rented or living rent free: Total,284,171,138,23,115,8,25,113,54,2,9,40,8
S01007120,Rented or living rent free: Social rented,213,114,87,21,66,8,19,99,52,2,4,35,6
S01007120,Rented or living rent free: Private rented or living rent free,71,57,51,2,49,0,6,14,2,0,5,5,2
S01007121,All HRPs aged 16 and over,294,122,100,11,89,13,9,172,141,5,2,16,8
S01007121,Owned: Total,88,58,46,7,39,11,1,30,26,1,0,2,1
S01007121,Owned: Owned outright,40,13,8,4,4,4,1,27,24,0,0,2,1
S01007121,Owned: Owned with a mortgage or loan or shared ownership,48,45,38,3,35,7,0,3,2,1,0,0,0
S01007121,Rented or living rent free: Total,206,64,54,4,50,2,8,142,115,4,2,14,7
S01007121,Rented or living rent free: Social rented,148,22,17,2,15,1,4,126,113,1,0,9,3
S01007121,Rented or living rent free: Private rented or living rent free,58,42,37,2,35,1,4,16,2,3,2,5,4
S01007122,All HRPs aged 16 and over,287,168,137,12,125,28,3,119,87,1,3,22,6
S01007122,Owned: Total,165,107,85,4,81,21,1,58,52,0,0,4,2
S01007122,Owned: Owned outright,94,38,29,2,27,9,0,56,51,0,0,4,1
S01007122,Owned: Owned with a mortgage or loan or shared ownership,71,69,56,2,54,12,1,2,1,0,0,0,1
S01007122,Rented or living rent free: Total,122,61,52,8,44,7,2,61,35,1,3,18,4
S01007122,Rented or living rent free: Social rented,88,35,28,7,21,5,2,53,29,1,3,16,4
S01007122,Rented or living rent free: Private rented or living rent free,34,26,24,1,23,2,0,8,6,0,0,2,0
S01007123,All HRPs aged 16 and over,313,187,163,23,140,14,10,126,96,2,4,17,7
S01007123,Owned: Total,205,127,115,14,101,11,1,78,72,1,1,1,3
S01007123,Owned: Owned outright,111,39,36,11,25,3,0,72,67,1,1,0,3
S01007123,Owned: Owned with a mortgage or loan or shared ownership,94,88,79,3,76,8,1,6,5,0,0,1,0
S01007123,Rented or living rent free: Total,108,60,48,9,39,3,9,48,24,1,3,16,4
S01007123,Rented or living rent free: Social rented,82,41,31,8,23,1,9,41,19,1,3,16,2
S01007123,Rented or living rent free: Private rented or living rent free,26,19,17,1,16,2,0,7,5,0,0,0,2
S01007124,All HRPs aged 16 and over,380,264,227,23,204,33,4,116,102,1,3,8,2
S01007124,Owned: Total,277,196,171,14,157,24,1,81,78,0,1,1,1
S01007124,Owned: Owned outright,139,63,55,9,46,8,0,76,74,0,1,0,1
S01007124,Owned: Owned with a mortgage or loan or shared ownership,138,133,116,5,111,16,1,5,4,0,0,1,0
S01007124,Rented or living rent free: Total,103,68,56,9,47,9,3,35,24,1,2,7,1
S01007124,Rented or living rent free: Social rented,80,49,40,8,32,8,1,31,23,1,1,6,0
S01007124,Rented or living rent free: Private rented or living rent free,23,19,16,1,15,1,2,4,1,0,1,1,1
S01007125,All HRPs aged 16 and over,351,220,187,39,148,25,8,131,90,1,12,18,10
S01007125,Owned: Total,212,136,117,16,101,17,2,76,70,0,1,4,1
S01007125,Owned: Owned outright,125,52,40,9,31,11,1,73,68,0,0,4,1
S01007125,Owned: Owned with a mortgage or loan or shared ownership,87,84,77,7,70,6,1,3,2,0,1,0,0
S01007125,Rented or living rent free: Total,139,84,70,23,47,8,6,55,20,1,11,14,9
S01007125,Rented or living rent free: Social rented,107,62,55,19,36,5,2,45,17,1,10,12,5
S01007125,Rented or living rent free: Private rented or living rent free,32,22,15,4,11,3,4,10,3,0,1,2,4
S01007126,All HRPs aged 16 and over,399,266,225,33,192,17,24,133,69,4,10,36,14
S01007126,Owned: Total,114,81,65,9,56,12,4,33,30,1,0,0,2
S01007126,Owned: Owned outright,55,25,21,7,14,3,1,30,29,0,0,0,1
S01007126,Owned: Owned with a mortgage or loan or shared ownership,59,56,44,2,42,9,3,3,1,1,0,0,1
S01007126,Rented or living rent free: Total,285,185,160,24,136,5,20,100,39,3,10,36,12
S01007126,Rented or living rent free: Social rented,247,154,134,22,112,4,16,93,37,2,9,33,12
S01007126,Rented or living rent free: Private rented or living rent free,38,31,26,2,24,1,4,7,2,1,1,3,0
S01007127,All HRPs aged 16 and over,446,325,271,29,242,32,22,121,73,7,3,26,12
S01007127,Owned: Total,141,105,89,14,75,13,3,36,32,0,0,3,1
S01007127,Owned: Owned outright,67,35,29,9,20,5,1,32,29,0,0,2,1
S01007127,Owned: Owned with a mortgage or loan or shared ownership,74,70,60,5,55,8,2,4,3,0,0,1,0
S01007127,Rented or living rent free: Total,305,220,182,15,167,19,19,85,41,7,3,23,11
S01007127,Rented or living rent free: Social rented,179,104,83,8,75,9,12,75,41,6,3,20,5
S01007127,Rented or living rent free: Private rented or living rent free,126,116,99,7,92,10,7,10,0,1,0,3,6
S01007128,All HRPs aged 16 and over,411,225,188,46,142,21,16,186,135,4,7,32,8
S01007128,Owned: Total,184,133,115,27,88,15,3,51,44,2,2,2,1
S01007128,Owned: Owned outright,92,53,47,20,27,4,2,39,37,0,0,1,1
S01007128,Owned: Owned with a mortgage or loan or shared ownership,92,80,68,7,61,11,1,12,7,2,2,1,0
S01007128,Rented or living rent free: Total,227,92,73,19,54,6,13,135,91,2,5,30,7
S01007128,Rented or living rent free: Social rented,203,72,60,15,45,3,9,131,90,2,3,30,6
S01007128,Rented or living rent free: Private rented or living rent free,24,20,13,4,9,3,4,4,1,0,2,0,1
S01007129,All HRPs aged 16 and over,374,280,228,17,211,50,2,94,84,0,4,4,2
S01007129,Owned: Total,324,246,200,12,188,45,1,78,75,0,2,0,1
S01007129,Owned: Owned outright,141,72,52,8,44,20,0,69,69,0,0,0,0
S01007129,Owned: Owned with a mortgage or loan or shared ownership,183,174,148,4,144,25,1,9,6,0,2,0,1
S01007129,Rented or living rent free: Total,50,34,28,5,23,5,1,16,9,0,2,4,1
S01007129,Rented or living rent free: Social rented,10,6,4,2,2,1,1,4,2,0,1,1,0
S01007129,Rented or living rent free: Private rented or living rent free,40,28,24,3,21,4,0,12,7,0,1,3,1
S01007130,All HRPs aged 16 and over,280,171,143,21,122,24,4,109,99,1,2,5,2
S01007130,Owned: Total,236,146,125,17,108,21,0,90,86,0,1,2,1
S01007130,Owned: Owned outright,125,51,43,12,31,8,0,74,72,0,1,0,1
S01007130,Owned: Owned with a mortgage or loan or shared ownership,111,95,82,5,77,13,0,16,14,0,0,2,0
S01007130,Rented or living rent free: Total,44,25,18,4,14,3,4,19,13,1,1,3,1
S01007130,Rented or living rent free: Social rented,21,6,4,3,1,0,2,15,12,0,0,2,1
S01007130,Rented or living rent free: Private rented or living rent free,23,19,14,1,13,3,2,4,1,1,1,1,0
S01007131,All HRPs aged 16 and over,341,211,181,21,160,26,4,130,124,1,0,5,0
S01007131,Owned: Total,274,194,166,16,150,25,3,80,78,0,0,2,0
S01007131,Owned: Owned outright,124,54,50,10,40,4,0,70,70,0,0,0,0
S01007131,Owned: Owned with a mortgage or loan or shared ownership,150,140,116,6,110,21,3,10,8,0,0,2,0
S01007131,Rented or living rent free: Total,67,17,15,5,10,1,1,50,46,1,0,3,0
S01007131,Rented or living rent free: Social rented,45,3,3,0,3,0,0,42,41,0,0,1,0
S01007131,Rented or living rent free: Private rented or living rent free,22,14,12,5,7,1,1,8,5,1,0,2,0
S01007132,All HRPs aged 16 and over,297,193,163,25,138,27,3,104,103,0,0,1,0
S01007132,Owned: Total,271,174,147,22,125,26,1,97,97,0,0,0,0
S01007132,Owned: Owned outright,149,57,45,10,35,12,0,92,92,0,0,0,0
S01007132,Owned: Owned with a mortgage or loan or shared ownership,122,117,102,12,90,14,1,5,5,0,0,0,0
S01007132,Rented or living rent free: Total,26,19,16,3,13,1,2,7,6,0,0,1,0
S01007132,Rented or living rent free: Social rented,7,3,3,0,3,0,0,4,3,0,0,1,0
S01007132,Rented or living rent free: Private rented or living rent free,19,16,13,3,10,1,2,3,3,0,0,0,0
S01007133,All HRPs aged 16 and over,262,191,139,18,121,52,0,71,62,1,1,3,4
S01007133,Owned: Total,210,161,113,12,101,48,0,49,47,0,0,0,2
S01007133,Owned: Owned outright,95,50,28,6,22,22,0,45,44,0,0,0,1
S01007133,Owned: Owned with a mortgage or loan or shared ownership,115,111,85,6,79,26,0,4,3,0,0,0,1
S01007133,Rented or living rent free: Total,52,30,26,6,20,4,0,22,15,1,1,3,2
S01007133,Rented or living rent free: Social rented,11,4,3,1,2,1,0,7,4,0,0,1,2
S01007133,Rented or living rent free: Private rented or living rent free,41,26,23,5,18,3,0,15,11,1,1,2,0
S01007134,All HRPs aged 16 and over,317,216,151,16,135,62,3,101,89,0,0,11,1
S01007134,Owned: Total,233,166,117,11,106,49,0,67,65,0,0,2,0
S01007134,Owned: Owned outright,114,52,35,3,32,17,0,62,61,0,0,1,0
S01007134,Owned: Owned with a mortgage or loan or shared ownership,119,114,82,8,74,32,0,5,4,0,0,1,0
S01007134,Rented or living rent free: Total,84,50,34,5,29,13,3,34,24,0,0,9,1
S01007134,Rented or living rent free: Social rented,39,14,12,1,11,0,2,25,17,0,0,7,1
S01007134,Rented or living rent free: Private rented or living rent free,45,36,22,4,18,13,1,9,7,0,0,2,0
S01007135,All HRPs aged 16 and over,221,155,108,8,100,44,3,66,63,0,1,1,1
S01007135,Owned: Total,200,143,100,7,93,40,3,57,56,0,1,0,0
S01007135,Owned: Owned outright,103,48,27,3,24,20,1,55,54,0,1,0,0
S01007135,Owned: Owned with a mortgage or loan or shared ownership,97,95,73,4,69,20,2,2,2,0,0,0,0
S01007135,Rented or living rent free: Total,21,12,8,1,7,4,0,9,7,0,0,1,1
S01007135,Rented or living rent free: Social rented,6,3,1,0,1,2,0,3,3,0,0,0,0
S01007135,Rented or living rent free: Private rented or living rent free,15,9,7,1,6,2,0,6,4,0,0,1,1
S01007136,All HRPs aged 16 and over,185,150,95,8,87,50,5,35,31,0,3,1,0
S01007136,Owned: Total,153,125,82,8,74,40,3,28,25,0,3,0,0
S01007136,Owned: Owned outright,59,34,14,4,10,19,1,25,22,0,3,0,0
S01007136,Owned: Owned with a mortgage or loan or shared ownership,94,91,68,4,64,21,2,3,3,0,0,0,0
S01007136,Rented or living rent free: Total,32,25,13,0,13,10,2,7,6,0,0,1,0
S01007136,Rented or living rent free: Social rented,0,0,0,0,0,0,0,0,0,0,0,0,0
S01007136,Rented or living rent free: Private rented or living rent free,32,25,13,0,13,10,2,7,6,0,0,1,0
S01007137,All HRPs aged 16 and over,248,226,184,12,172,38,4,22,18,0,2,0,2
S01007137,Owned: Total,225,206,169,10,159,34,3,19,17,0,2,0,0
S01007137,Owned: Owned outright,34,17,14,3,11,1,2,17,16,0,1,0,0
S01007137,Owned: Owned with a mortgage or loan or shared ownership,191,189,155,7,148,33,1,2,1,0,1,0,0
S01007137,Rented or living rent free: Total,23,20,15,2,13,4,1,3,1,0,0,0,2
S01007137,Rented or living rent free: Social rented,4,3,2,0,2,1,0,1,1,0,0,0,0
S01007137,Rented or living rent free: Private rented or living rent free,19,17,13,2,11,3,1,2,0,0,0,0,2
S01007138,All HRPs aged 16 and over,243,180,139,24,115,38,3,63,59,1,0,1,2
S01007138,Owned: Total,208,154,117,21,96,36,1,54,53,1,0,0,0
S01007138,Owned: Owned outright,100,49,35,13,22,13,1,51,51,0,0,0,0
S01007138,Owned: Owned with a mortgage or loan or shared ownership,108,105,82,8,74,23,0,3,2,1,0,0,0
S01007138,Rented or living rent free: Total,35,26,22,3,19,2,2,9,6,0,0,1,2
S01007138,Rented or living rent free: Social rented,6,3,2,0,2,0,1,3,3,0,0,0,0
S01007138,Rented or living rent free: Private rented or living rent free,29,23,20,3,17,2,1,6,3,0,0,1,2
S01007139,All HRPs aged 16 and over,324,226,173,21,152,48,5,98,89,0,2,6,1
S01007139,Owned: Total,266,189,142,14,128,44,3,77,75,0,1,1,0
S01007139,Owned: Owned outright,132,67,46,7,39,19,2,65,65,0,0,0,0
S01007139,Owned: Owned with a mortgage or loan or shared ownership,134,122,96,7,89,25,1,12,10,0,1,1,0
S01007139,Rented or living rent free: Total,58,37,31,7,24,4,2,21,14,0,1,5,1
S01007139,Rented or living rent free: Social rented,24,9,7,2,5,2,0,15,8,0,1,5,1
S01007139,Rented or living rent free: Private rented or living rent free,34,28,24,5,19,2,2,6,6,0,0,0,0
S01007140,All HRPs aged 16 and over,405,277,208,35,173,64,5,128,112,2,3,7,4
S01007140,Owned: Total,308,207,156,20,136,49,2,101,92,2,1,2,4
S01007140,Owned: Owned outright,158,68,46,10,36,22,0,90,83,1,1,2,3
S01007140,Owned: Owned with a mortgage or loan or shared ownership,150,139,110,10,100,27,2,11,9,1,0,0,1
S01007140,Rented or living rent free: Total,97,70,52,15,37,15,3,27,20,0,2,5,0
S01007140,Rented or living rent free: Social rented,37,22,18,7,11,3,1,15,10,0,2,3,0
S01007140,Rented or living rent free: Private rented or living rent free,60,48,34,8,26,12,2,12,10,0,0,2,0
S01007141,All HRPs aged 16 and over,249,179,137,9,128,42,0,70,60,1,2,4,3
S01007141,Owned: Total,207,151,113,8,105,38,0,56,50,1,2,0,3
S01007141,Owned: Owned outright,90,45,28,3,25,17,0,45,43,0,1,0,1
S01007141,Owned: Owned with a mortgage or loan or shared ownership,117,106,85,5,80,21,0,11,7,1,1,0,2
S01007141,Rented or living rent free: Total,42,28,24,1,23,4,0,14,10,0,0,4,0
S01007141,Rented or living rent free: Social rented,9,3,3,0,3,0,0,6,2,0,0,4,0
S01007141,Rented or living rent free: Private rented or living rent free,33,25,21,1,20,4,0,8,8,0,0,0,0
S01007142,All HRPs aged 16 and over,153,145,126,6,120,19,0,8,5,0,3,0,0
S01007142,Owned: Total,142,137,119,5,114,18,0,5,5,0,0,0,0
S01007142,Owned: Owned outright,25,20,15,1,14,5,0,5,5,0,0,0,0
S01007142,Owned: Owned with a mortgage or loan or shared ownership,117,117,104,4,100,13,0,0,0,0,0,0,0
S01007142,Rented or living rent free: Total,11,8,7,1,6,1,0,3,0,0,3,0,0
S01007142,Rented or living rent free: Social rented,1,0,0,0,0,0,0,1,0,0,1,0,0
S01007142,Rented or living rent free: Private rented or living rent free,10,8,7,1,6,1,0,2,0,0,2,0,0
S01007143,All HRPs aged 16 and over,203,190,167,8,159,22,1,13,12,0,0,1,0
S01007143,Owned: Total,188,176,158,6,152,17,1,12,12,0,0,0,0
S01007143,Owned: Owned outright,31,19,14,1,13,4,1,12,12,0,0,0,0
S01007143,Owned: Owned with a mortgage or loan or shared ownership,157,157,144,5,139,13,0,0,0,0,0,0,0
S01007143,Rented or living rent free: Total,15,14,9,2,7,5,0,1,0,0,0,1,0
S01007143,Rented or living rent free: Social rented,3,2,2,0,2,0,0,1,0,0,0,1,0
S01007143,Rented or living rent free: Private rented or living rent free,12,12,7,2,5,5,0,0,0,0,0,0,0
S01007144,All HRPs aged 16 and over,240,178,120,15,105,55,3,62,54,0,2,3,3
S01007144,Owned: Total,156,112,67,5,62,45,0,44,44,0,0,0,0
S01007144,Owned: Owned outright,89,49,23,3,20,26,0,40,40,0,0,0,0
S01007144,Owned: Owned with a mortgage or loan or shared ownership,67,63,44,2,42,19,0,4,4,0,0,0,0
S01007144,Rented or living rent free: Total,84,66,53,10,43,10,3,18,10,0,2,3,3
S01007144,Rented or living rent free: Social rented,9,7,6,3,3,1,0,2,1,0,0,1,0
S01007144,Rented or living rent free: Private rented or living rent free,75,59,47,7,40,9,3,16,9,0,2,2,3
S01007145,All HRPs aged 16 and over,408,216,176,27,149,33,7,192,185,0,3,2,2
S01007145,Owned: Total,333,187,153,22,131,32,2,146,142,0,2,1,1
S01007145,Owned: Owned outright,195,63,56,17,39,7,0,132,129,0,1,1,1
S01007145,Owned: Owned with a mortgage or loan or shared ownership,138,124,97,5,92,25,2,14,13,0,1,0,0
S01007145,Rented or living rent free: Total,75,29,23,5,18,1,5,46,43,0,1,1,1
S01007145,Rented or living rent free: Social rented,45,14,10,2,8,1,3,31,31,0,0,0,0
S01007145,Rented or living rent free: Private rented or living rent free,30,15,13,3,10,0,2,15,12,0,1,1,1
S01007146,All HRPs aged 16 and over,334,199,176,37,139,18,5,135,128,1,1,3,2
S01007146,Owned: Total,267,166,150,27,123,13,3,101,100,0,0,1,0
S01007146,Owned: Owned outright,143,50,45,13,32,3,2,93,92,0,0,1,0
S01007146,Owned: Owned with a mortgage or loan or shared ownership,124,116,105,14,91,10,1,8,8,0,0,0,0
S01007146,Rented or living rent free: Total,67,33,26,10,16,5,2,34,28,1,1,2,2
S01007146,Rented or living rent free: Social rented,37,14,10,5,5,3,1,23,19,1,0,2,1
S01007146,Rented or living rent free: Private rented or living rent free,30,19,16,5,11,2,1,11,9,0,1,0,1
S01007147,All HRPs aged 16 and over,305,186,161,24,137,19,6,119,108,1,1,8,1
S01007147,Owned: Total,280,172,152,20,132,18,2,108,100,0,1,6,1
S01007147,Owned: Owned outright,147,54,45,12,33,8,1,93,88,0,0,4,1
S01007147,Owned: Owned with a mortgage or loan or shared ownership,133,118,107,8,99,10,1,15,12,0,1,2,0
S01007147,Rented or living rent free: Total,25,14,9,4,5,1,4,11,8,1,0,2,0
S01007147,Rented or living rent free: Social rented,12,5,3,2,1,1,1,7,5,0,0,2,0
S01007147,Rented or living rent free: Private rented or living rent free,13,9,6,2,4,0,3,4,3,1,0,0,0
S01007148,All HRPs aged 16 and over,204,140,110,10,100,25,5,64,60,0,1,1,2
S01007148,Owned: Total,191,131,105,9,96,24,2,60,58,0,0,0,2
S01007148,Owned: Owned outright,89,35,25,5,20,9,1,54,52,0,0,0,2
S01007148,Owned: Owned with a mortgage or loan or shared ownership,102,96,80,4,76,15,1,6,6,0,0,0,0
S01007148,Rented or living rent free: Total,13,9,5,1,4,1,3,4,2,0,1,1,0
S01007148,Rented or living rent free: Social rented,5,3,1,1,0,1,1,2,1,0,0,1,0
S01007148,Rented or living rent free: Private rented or living rent free,8,6,4,0,4,0,2,2,1,0,1,0,0
S01007149,All HRPs aged 16 and over,237,136,121,22,99,13,2,101,100,0,0,0,1
S01007149,Owned: Total,224,125,113,18,95,11,1,99,98,0,0,0,1
S01007149,Owned: Owned outright,132,43,38,12,26,4,1,89,89,0,0,0,0
S01007149,Owned: Owned with a mortgage or loan or shared ownership,92,82,75,6,69,7,0,10,9,0,0,0,1
S01007149,Rented or living rent free: Total,13,11,8,4,4,2,1,2,2,0,0,0,0
S01007149,Rented or living rent free: Social rented,4,4,4,3,1,0,0,0,0,0,0,0,0
S01007149,Rented or living rent free: Private rented or living rent free,9,7,4,1,3,2,1,2,2,0,0,0,0
S01007150,All HRPs aged 16 and over,350,151,114,20,94,36,1,199,194,0,2,2,1
S01007150,Owned: Total,314,137,104,18,86,32,1,177,174,0,1,1,1
S01007150,Owned: Owned outright,219,56,41,13,28,14,1,163,160,0,1,1,1
S01007150,Owned: Owned with a mortgage or loan or shared ownership,95,81,63,5,58,18,0,14,14,0,0,0,0
S01007150,Rented or living rent free: Total,36,14,10,2,8,4,0,22,20,0,1,1,0
S01007150,Rented or living rent free: Social rented,13,5,3,2,1,2,0,8,7,0,0,1,0
S01007150,Rented or living rent free: Private rented or living rent free,23,9,7,0,7,2,0,14,13,0,1,0,0
S01007151,All HRPs aged 16 and over,331,228,196,26,170,29,3,103,99,0,1,3,0
S01007151,Owned: Total,311,216,185,22,163,28,3,95,93,0,0,2,0
S01007151,Owned: Owned outright,144,57,44,13,31,10,3,87,85,0,0,2,0
S01007151,Owned: Owned with a mortgage or loan or shared ownership,167,159,141,9,132,18,0,8,8,0,0,0,0
S01007151,Rented or living rent free: Total,20,12,11,4,7,1,0,8,6,0,1,1,0
S01007151,Rented or living rent free: Social rented,3,1,1,0,1,0,0,2,1,0,0,1,0
S01007151,Rented or living rent free: Private rented or living rent free,17,11,10,4,6,1,0,6,5,0,1,0,0
S01007152,All HRPs aged 16 and over,237,137,117,17,100,18,2,100,96,0,2,2,0
S01007152,Owned: Total,212,124,106,13,93,17,1,88,87,0,1,0,0
S01007152,Owned: Owned outright,120,33,24,5,19,8,1,87,86,0,1,0,0
S01007152,Owned: Owned with a mortgage or loan or shared ownership,92,91,82,8,74,9,0,1,1,0,0,0,0
S01007152,Rented or living rent free: Total,25,13,11,4,7,1,1,12,9,0,1,2,0
S01007152,Rented or living rent free: Social rented,13,7,6,3,3,0,1,6,5,0,0,1,0
S01007152,Rented or living rent free: Private rented or living rent free,12,6,5,1,4,1,0,6,4,0,1,1,0
S01007153,All HRPs aged 16 and over,286,171,142,19,123,24,5,115,107,0,1,6,1
S01007153,Owned: Total,240,155,132,16,116,23,0,85,83,0,1,1,0
S01007153,Owned: Owned outright,115,41,37,7,30,4,0,74,74,0,0,0,0
S01007153,Owned: Owned with a mortgage or loan or shared ownership,125,114,95,9,86,19,0,11,9,0,1,1,0
S01007153,Rented or living rent free: Total,46,16,10,3,7,1,5,30,24,0,0,5,1
S01007153,Rented or living rent free: Social rented,31,7,3,1,2,0,4,24,20,0,0,3,1
S01007153,Rented or living rent free: Private rented or living rent free,15,9,7,2,5,1,1,6,4,0,0,2,0
S01007154,All HRPs aged 16 and over,453,215,188,27,161,22,5,238,214,1,2,12,9
S01007154,Owned: Total,308,155,137,18,119,16,2,153,143,0,0,4,6
S01007154,Owned: Owned outright,163,33,30,4,26,3,0,130,123,0,0,2,5
S01007154,Owned: Owned with a mortgage or loan or shared ownership,145,122,107,14,93,13,2,23,20,0,0,2,1
S01007154,Rented or living rent free: Total,145,60,51,9,42,6,3,85,71,1,2,8,3
S01007154,Rented or living rent free: Social rented,90,17,15,3,12,1,1,73,62,1,1,6,3
S01007154,Rented or living rent free: Private rented or living rent free,55,43,36,6,30,5,2,12,9,0,1,2,0
S01007155,All HRPs aged 16 and over,305,167,139,25,114,25,3,138,128,2,3,5,0
S01007155,Owned: Total,237,142,118,17,101,22,2,95,91,1,1,2,0
S01007155,Owned: Owned outright,126,40,28,7,21,10,2,86,83,1,1,1,0
S01007155,Owned: Owned with a mortgage or loan or shared ownership,111,102,90,10,80,12,0,9,8,0,0,1,0
S01007155,Rented or living rent free: Total,68,25,21,8,13,3,1,43,37,1,2,3,0
S01007155,Rented or living rent free: Social rented,40,5,4,3,1,0,1,35,30,0,2,3,0
S01007155,Rented or living rent free: Private rented or living rent free,28,20,17,5,12,3,0,8,7,1,0,0,0
S01007156,All HRPs aged 16 and over,308,202,174,23,151,22,6,106,88,0,8,9,1
S01007156,Owned: Total,242,162,143,13,130,17,2,80,76,0,1,3,0
S01007156,Owned: Owned outright,115,50,45,8,37,3,2,65,65,0,0,0,0
S01007156,Owned: Owned with a mortgage or loan or shared ownership,127,112,98,5,93,14,0,15,11,0,1,3,0
S01007156,Rented or living rent free: Total,66,40,31,10,21,5,4,26,12,0,7,6,1
S01007156,Rented or living rent free: Social rented,32,18,15,5,10,1,2,14,9,0,3,2,0
S01007156,Rented or living rent free: Private rented or living rent free,34,22,16,5,11,4,2,12,3,0,4,4,1
S01007157,All HRPs aged 16 and over,279,204,177,27,150,22,5,75,54,1,9,11,0
S01007157,Owned: Total,182,153,137,15,122,16,0,29,28,0,0,1,0
S01007157,Owned: Owned outright,57,35,29,4,25,6,0,22,22,0,0,0,0
S01007157,Owned: Owned with a mortgage or loan or shared ownership,125,118,108,11,97,10,0,7,6,0,0,1,0
S01007157,Rented or living rent free: Total,97,51,40,12,28,6,5,46,26,1,9,10,0
S01007157,Rented or living rent free: Social rented,73,35,28,7,21,4,3,38,23,0,6,9,0
S01007157,Rented or living rent free: Private rented or living rent free,24,16,12,5,7,2,2,8,3,1,3,1,0
S01007158,All HRPs aged 16 and over,386,294,258,27,231,27,9,92,80,1,2,3,6
S01007158,Owned: Total,322,252,221,18,203,25,6,70,65,0,1,2,2
S01007158,Owned: Owned outright,103,44,31,9,22,8,5,59,56,0,1,0,2
S01007158,Owned: Owned with a mortgage or loan or shared ownership,219,208,190,9,181,17,1,11,9,0,0,2,0
S01007158,Rented or living rent free: Total,64,42,37,9,28,2,3,22,15,1,1,1,4
S01007158,Rented or living rent free: Social rented,35,18,16,5,11,1,1,17,11,1,1,1,3
S01007158,Rented or living rent free: Private rented or living rent free,29,24,21,4,17,1,2,5,4,0,0,0,1
S01007159,All HRPs aged 16 and over,407,262,216,45,171,28,18,145,115,2,10,16,2
S01007159,Owned: Total,251,167,145,22,123,21,1,84,78,0,1,4,1
S01007159,Owned: Owned outright,105,37,29,8,21,8,0,68,64,0,1,2,1
S01007159,Owned: Owned with a mortgage or loan or shared ownership,146,130,116,14,102,13,1,16,14,0,0,2,0
S01007159,Rented or living rent free: Total,156,95,71,23,48,7,17,61,37,2,9,12,1
S01007159,Rented or living rent free: Social rented,112,62,45,21,24,3,14,50,30,2,7,11,0
S01007159,Rented or living rent free: Private rented or living rent free,44,33,26,2,24,4,3,11,7,0,2,1,1
S01007160,All HRPs aged 16 and over,377,233,199,47,152,21,13,144,123,0,2,17,2
S01007160,Owned: Total,242,155,136,20,116,17,2,87,83,0,1,3,0
S01007160,Owned: Owned outright,114,40,28,8,20,12,0,74,71,0,0,3,0
S01007160,Owned: Owned with a mortgage or loan or shared ownership,128,115,108,12,96,5,2,13,12,0,1,0,0
S01007160,Rented or living rent free: Total,135,78,63,27,36,4,11,57,40,0,1,14,2
S01007160,Rented or living rent free: Social rented,104,57,45,22,23,1,11,47,31,0,0,14,2
S01007160,Rented or living rent free: Private rented or living rent free,31,21,18,5,13,3,0,10,9,0,1,0,0
S01007161,All HRPs aged 16 and over,317,204,168,28,140,28,8,113,91,1,10,5,6
S01007161,Owned: Total,235,157,130,13,117,25,2,78,73,0,0,0,5
S01007161,Owned: Owned outright,116,50,38,9,29,11,1,66,63,0,0,0,3
S01007161,Owned: Owned with a mortgage or loan or shared ownership,119,107,92,4,88,14,1,12,10,0,0,0,2
S01007161,Rented or living rent free: Total,82,47,38,15,23,3,6,35,18,1,10,5,1
S01007161,Rented or living rent free: Social rented,41,20,16,8,8,1,3,21,11,0,5,4,1
S01007161,Rented or living rent free: Private rented or living rent free,41,27,22,7,15,2,3,14,7,1,5,1,0
S01007162,All HRPs aged 16 and over,271,168,144,31,113,15,9,103,84,0,5,12,2
S01007162,Owned: Total,117,74,64,5,59,9,1,43,38,0,1,2,2
S01007162,Owned: Owned outright,54,14,13,2,11,0,1,40,37,0,1,1,1
S01007162,Owned: Owned with a mortgage or loan or shared ownership,63,60,51,3,48,9,0,3,1,0,0,1,1
S01007162,Rented or living rent free: Total,154,94,80,26,54,6,8,60,46,0,4,10,0
S01007162,Rented or living rent free: Social rented,90,36,30,10,20,3,3,54,43,0,3,8,0
S01007162,Rented or living rent free: Private rented or living rent free,64,58,50,16,34,3,5,6,3,0,1,2,0
S01007163,All HRPs aged 16 and over,392,226,193,29,164,30,3,166,152,0,4,4,6
S01007163,Owned: Total,304,176,150,13,137,24,2,128,125,0,0,2,1
S01007163,Owned: Owned outright,168,58,47,8,39,10,1,110,109,0,0,1,0
S01007163,Owned: Owned with a mortgage or loan or shared ownership,136,118,103,5,98,14,1,18,16,0,0,1,1
S01007163,Rented or living rent free: Total,88,50,43,16,27,6,1,38,27,0,4,2,5
S01007163,Rented or living rent free: Social rented,60,31,29,13,16,1,1,29,18,0,4,2,5
S01007163,Rented or living rent free: Private rented or living rent free,28,19,14,3,11,5,0,9,9,0,0,0,0
S01007164,All HRPs aged 16 and over,257,155,133,23,110,19,3,102,93,3,3,3,0
S01007164,Owned: Total,207,126,107,16,91,17,2,81,79,0,0,2,0
S01007164,Owned: Owned outright,118,45,34,10,24,9,2,73,72,0,0,1,0
S01007164,Owned: Owned with a mortgage or loan or shared ownership,89,81,73,6,67,8,0,8,7,0,0,1,0
S01007164,Rented or living rent free: Total,50,29,26,7,19,2,1,21,14,3,3,1,0
S01007164,Rented or living rent free: Social rented,19,10,8,3,5,1,1,9,7,1,0,1,0
S01007164,Rented or living rent free: Private rented or living rent free,31,19,18,4,14,1,0,12,7,2,3,0,0
S01007165,All HRPs aged 16 and over,330,220,170,29,141,45,5,110,98,0,3,6,3
S01007165,Owned: Total,266,178,140,24,116,37,1,88,82,0,2,2,2
S01007165,Owned: Owned outright,140,62,43,15,28,18,1,78,72,0,2,2,2
S01007165,Owned: Owned with a mortgage or loan or shared ownership,126,116,97,9,88,19,0,10,10,0,0,0,0
S01007165,Rented or living rent free: Total,64,42,30,5,25,8,4,22,16,0,1,4,1
S01007165,Rented or living rent free: Social rented,16,6,2,1,1,1,3,10,9,0,0,1,0
S01007165,Rented or living rent free: Private rented or living rent free,48,36,28,4,24,7,1,12,7,0,1,3,1
S01007166,All HRPs aged 16 and over,328,192,166,35,131,22,4,136,128,0,2,4,2
S01007166,Owned: Total,253,146,125,23,102,20,1,107,104,0,0,1,2
S01007166,Owned: Owned outright,143,49,38,15,23,10,1,94,92,0,0,0,2
S01007166,Owned: Owned with a mortgage or loan or shared ownership,110,97,87,8,79,10,0,13,12,0,0,1,0
S01007166,Rented or living rent free: Total,75,46,41,12,29,2,3,29,24,0,2,3,0
S01007166,Rented or living rent free: Social rented,33,15,13,3,10,0,2,18,15,0,1,2,0
S01007166,Rented or living rent free: Private rented or living rent free,42,31,28,9,19,2,1,11,9,0,1,1,0
S01007167,All HRPs aged 16 and over,331,212,172,27,145,37,3,119,110,2,1,6,0
S01007167,Owned: Total,308,196,160,20,140,34,2,112,107,2,0,3,0
S01007167,Owned: Owned outright,174,74,56,13,43,17,1,100,98,1,0,1,0
S01007167,Owned: Owned with a mortgage or loan or shared ownership,134,122,104,7,97,17,1,12,9,1,0,2,0
S01007167,Rented or living rent free: Total,23,16,12,7,5,3,1,7,3,0,1,3,0
S01007167,Rented or living rent free: Social rented,7,4,3,2,1,1,0,3,0,0,1,2,0
S01007167,Rented or living rent free: Private rented or living rent free,16,12,9,5,4,2,1,4,3,0,0,1,0
S01007168,All HRPs aged 16 and over,415,257,214,36,178,41,2,158,154,0,1,3,0
S01007168,Owned: Total,395,241,202,31,171,37,2,154,151,0,0,3,0
S01007168,Owned: Owned outright,233,93,74,23,51,17,2,140,137,0,0,3,0
S01007168,Owned: Owned with a mortgage or loan or shared ownership,162,148,128,8,120,20,0,14,14,0,0,0,0
S01007168,Rented or living rent free: Total,20,16,12,5,7,4,0,4,3,0,1,0,0
S01007168,Rented or living rent free: Social rented,3,2,0,0,0,2,0,1,1,0,0,0,0
S01007168,Rented or living rent free: Private rented or living rent free,17,14,12,5,7,2,0,3,2,0,1,0,0
S01007169,All HRPs aged 16 and over,326,201,171,31,140,24,6,125,116,1,1,5,2
S01007169,Owned: Total,249,174,152,20,132,20,2,75,73,0,0,2,0
S01007169,Owned: Owned outright,124,55,44,14,30,9,2,69,67,0,0,2,0
S01007169,Owned: Owned with a mortgage or loan or shared ownership,125,119,108,6,102,11,0,6,6,0,0,0,0
S01007169,Rented or living rent free: Total,77,27,19,11,8,4,4,50,43,1,1,3,2
S01007169,Rented or living rent free: Social rented,59,15,12,8,4,0,3,44,40,0,1,2,1
S01007169,Rented or living rent free: Private rented or living rent free,18,12,7,3,4,4,1,6,3,1,0,1,1
S01007170,All HRPs aged 16 and over,268,206,130,19,111,66,10,62,55,0,0,1,6
S01007170,Owned: Total,198,152,94,11,83,55,3,46,44,0,0,0,2
S01007170,Owned: Owned outright,105,65,30,7,23,32,3,40,40,0,0,0,0
S01007170,Owned: Owned with a mortgage or loan or shared ownership,93,87,64,4,60,23,0,6,4,0,0,0,2
S01007170,Rented or living rent free: Total,70,54,36,8,28,11,7,16,11,0,0,1,4
S01007170,Rented or living rent free: Social rented,7,7,4,0,4,2,1,0,0,0,0,0,0
S01007170,Rented or living rent free: Private rented or living rent free,63,47,32,8,24,9,6,16,11,0,0,1,4
S01007171,All HRPs aged 16 and over,364,266,193,15,178,64,9,98,80,0,2,8,8
S01007171,Owned: Total,220,155,101,6,95,51,3,65,60,0,1,2,2
S01007171,Owned: Owned outright,119,62,32,5,27,28,2,57,53,0,1,1,2
S01007171,Owned: Owned with a mortgage or loan or shared ownership,101,93,69,1,68,23,1,8,7,0,0,1,0
S01007171,Rented or living rent free: Total,144,111,92,9,83,13,6,33,20,0,1,6,6
S01007171,Rented or living rent free: Social rented,12,6,4,2,2,1,1,6,1,0,0,3,2
S01007171,Rented or living rent free: Private rented or living rent free,132,105,88,7,81,12,5,27,19,0,1,3,4
S01007172,All HRPs aged 16 and over,333,210,152,17,135,54,4,123,110,0,1,9,3
S01007172,Owned: Total,261,160,113,12,101,45,2,101,95,0,1,3,2
S01007172,Owned: Owned outright,153,59,40,8,32,17,2,94,89,0,1,2,2
S01007172,Owned: Owned with a mortgage or loan or shared ownership,108,101,73,4,69,28,0,7,6,0,0,1,0
S01007172,Rented or living rent free: Total,72,50,39,5,34,9,2,22,15,0,0,6,1
S01007172,Rented or living rent free: Social rented,7,1,1,0,1,0,0,6,1,0,0,5,0
S01007172,Rented or living rent free: Private rented or living rent free,65,49,38,5,33,9,2,16,14,0,0,1,1
S01007173,All HRPs aged 16 and over,327,273,236,26,210,32,5,54,51,1,0,2,0
S01007173,Owned: Total,283,237,208,19,189,26,3,46,44,0,0,2,0
S01007173,Owned: Owned outright,85,47,42,7,35,4,1,38,38,0,0,0,0
S01007173,Owned: Owned with a mortgage or loan or shared ownership,198,190,166,12,154,22,2,8,6,0,0,2,0
S01007173,Rented or living rent free: Total,44,36,28,7,21,6,2,8,7,1,0,0,0
S01007173,Rented or living rent free: Social rented,18,13,10,3,7,1,2,5,5,0,0,0,0
S01007173,Rented or living rent free: Private rented or living rent free,26,23,18,4,14,5,0,3,2,1,0,0,0
S01007174,All HRPs aged 16 and over,286,220,178,22,156,31,11,66,42,1,10,8,5
S01007174,Owned: Total,204,175,146,11,135,27,2,29,26,0,2,0,1
S01007174,Owned: Owned outright,58,36,26,8,18,9,1,22,20,0,1,0,1
S01007174,Owned: Owned with a mortgage or loan or shared ownership,146,139,120,3,117,18,1,7,6,0,1,0,0
S01007174,Rented or living rent free: Total,82,45,32,11,21,4,9,37,16,1,8,8,4
S01007174,Rented or living rent free: Social rented,65,35,26,10,16,1,8,30,11,0,8,7,4
S01007174,Rented or living rent free: Private rented or living rent free,17,10,6,1,5,3,1,7,5,1,0,1,0
S01007175,All HRPs aged 16 and over,294,157,142,24,118,13,2,137,127,2,2,3,3
S01007175,Owned: Total,212,119,106,16,90,12,1,93,90,0,1,1,1
S01007175,Owned: Owned outright,123,37,33,9,24,4,0,86,83,0,1,1,1
S01007175,Owned: Owned with a mortgage or loan or shared ownership,89,82,73,7,66,8,1,7,7,0,0,0,0
S01007175,Rented or living rent free: Total,82,38,36,8,28,1,1,44,37,2,1,2,2
S01007175,Rented or living rent free: Social rented,35,14,13,4,9,0,1,21,17,1,0,2,1
S01007175,Rented or living rent free: Private rented or living rent free,47,24,23,4,19,1,0,23,20,1,1,0,1
S01007176,All HRPs aged 16 and over,290,187,161,25,136,20,6,103,93,0,3,6,1
S01007176,Owned: Total,187,108,93,15,78,13,2,79,77,0,1,1,0
S01007176,Owned: Owned outright,103,31,25,2,23,4,2,72,70,0,1,1,0
S01007176,Owned: Owned with a mortgage or loan or shared ownership,84,77,68,13,55,9,0,7,7,0,0,0,0
S01007176,Rented or living rent free: Total,103,79,68,10,58,7,4,24,16,0,2,5,1
S01007176,Rented or living rent free: Social rented,45,26,21,6,15,3,2,19,11,0,2,5,1
S01007176,Rented or living rent free: Private rented or living rent free,58,53,47,4,43,4,2,5,5,0,0,0,0
S01007177,All HRPs aged 16 and over,303,183,145,31,114,17,21,120,92,4,6,12,6
S01007177,Owned: Total,152,101,89,8,81,11,1,51,49,0,0,1,1
S01007177,Owned: Owned outright,72,24,18,2,16,5,1,48,46,0,0,1,1
S01007177,Owned: Owned with a mortgage or loan or shared ownership,80,77,71,6,65,6,0,3,3,0,0,0,0
S01007177,Rented or living rent free: Total,151,82,56,23,33,6,20,69,43,4,6,11,5
S01007177,Rented or living rent free: Social rented,129,64,40,21,19,4,20,65,41,4,5,10,5
S01007177,Rented or living rent free: Private rented or living rent free,22,18,16,2,14,2,0,4,2,0,1,1,0
S01007178,All HRPs aged 16 and over,505,325,248,51,197,37,40,180,113,1,21,29,16
S01007178,Owned: Total,176,111,88,12,76,22,1,65,63,0,0,0,2
S01007178,Owned: Owned outright,80,28,23,7,16,5,0,52,50,0,0,0,2
S01007178,Owned: Owned with a mortgage or loan or shared ownership,96,83,65,5,60,17,1,13,13,0,0,0,0
S01007178,Rented or living rent free: Total,329,214,160,39,121,15,39,115,50,1,21,29,14
S01007178,Rented or living rent free: Social rented,289,180,134,36,98,10,36,109,47,0,20,28,14
S01007178,Rented or living rent free: Private rented or living rent free,40,34,26,3,23,5,3,6,3,1,1,1,0
S01007179,All HRPs aged 16 and over,384,252,218,29,189,32,2,132,129,1,1,1,0
S01007179,Owned: Total,354,234,201,24,177,31,2,120,118,1,1,0,0
S01007179,Owned: Owned outright,219,105,84,17,67,19,2,114,112,1,1,0,0
S01007179,Owned: Owned with a mortgage or loan or shared ownership,135,129,117,7,110,12,0,6,6,0,0,0,0
S01007179,Rented or living rent free: Total,30,18,17,5,12,1,0,12,11,0,0,1,0
S01007179,Rented or living rent free: Social rented,13,10,9,3,6,1,0,3,3,0,0,0,0
S01007179,Rented or living rent free: Private rented or living rent free,17,8,8,2,6,0,0,9,8,0,0,1,0
S01007180,All HRPs aged 16 and over,347,185,142,28,114,33,10,162,148,0,1,6,7
S01007180,Owned: Total,298,156,125,22,103,30,1,142,138,0,0,2,2
S01007180,Owned: Owned outright,203,69,53,17,36,15,1,134,130,0,0,2,2
S01007180,Owned: Owned with a mortgage or loan or shared ownership,95,87,72,5,67,15,0,8,8,0,0,0,0
S01007180,Rented or living rent free: Total,49,29,17,6,11,3,9,20,10,0,1,4,5
S01007180,Rented or living rent free: Social rented,34,22,14,6,8,0,8,12,3,0,1,3,5
S01007180,Rented or living rent free: Private rented or living rent free,15,7,3,0,3,3,1,8,7,0,0,1,0
S01007181,All HRPs aged 16 and over,317,193,136,17,119,50,7,124,113,2,1,5,3
S01007181,Owned: Total,267,169,118,12,106,48,3,98,94,0,0,2,2
S01007181,Owned: Owned outright,151,61,42,6,36,17,2,90,88,0,0,1,1
S01007181,Owned: Owned with a mortgage or loan or shared ownership,116,108,76,6,70,31,1,8,6,0,0,1,1
S01007181,Rented or living rent free: Total,50,24,18,5,13,2,4,26,19,2,1,3,1
S01007181,Rented or living rent free: Social rented,23,7,5,2,3,1,1,16,12,2,0,2,0
S01007181,Rented or living rent free: Private rented or living rent free,27,17,13,3,10,1,3,10,7,0,1,1,1
S01007182,All HRPs aged 16 and over,526,322,271,33,238,40,11,204,169,4,2,18,11
S01007182,Owned: Total,369,235,199,16,183,35,1,134,127,1,1,4,1
S01007182,Owned: Owned outright,204,79,63,7,56,16,0,125,118,1,1,4,1
S01007182,Owned: Owned with a mortgage or loan or shared ownership,165,156,136,9,127,19,1,9,9,0,0,0,0
S01007182,Rented or living rent free: Total,157,87,72,17,55,5,10,70,42,3,1,14,10
S01007182,Rented or living rent free: Social rented,87,35,29,9,20,2,4,52,33,2,0,10,7
S01007182,Rented or living rent free: Private rented or living rent free,70,52,43,8,35,3,6,18,9,1,1,4,3
S01007183,All HRPs aged 16 and over,560,315,262,38,224,41,12,245,210,5,2,22,6
S01007183,Owned: Total,326,215,180,19,161,33,2,111,103,3,0,3,2
S01007183,Owned: Owned outright,152,59,44,10,34,13,2,93,90,1,0,1,1
S01007183,Owned: Owned with a mortgage or loan or shared ownership,174,156,136,9,127,20,0,18,13,2,0,2,1
S01007183,Rented or living rent free: Total,234,100,82,19,63,8,10,134,107,2,2,19,4
S01007183,Rented or living rent free: Social rented,158,50,36,13,23,6,8,108,85,2,2,16,3
S01007183,Rented or living rent free: Private rented or living rent free,76,50,46,6,40,2,2,26,22,0,0,3,1
S01007184,All HRPs aged 16 and over,594,349,293,41,252,24,32,245,186,6,1,40,12
S01007184,Owned: Total,309,201,179,18,161,19,3,108,97,2,0,8,1
S01007184,Owned: Owned outright,140,43,37,8,29,5,1,97,89,1,0,6,1
S01007184,Owned: Owned with a mortgage or loan or shared ownership,169,158,142,10,132,14,2,11,8,1,0,2,0
S01007184,Rented or living rent free: Total,285,148,114,23,91,5,29,137,89,4,1,32,11
S01007184,Rented or living rent free: Social rented,172,56,37,15,22,4,15,116,80,1,1,26,8
S01007184,Rented or living rent free: Private rented or living rent free,113,92,77,8,69,1,14,21,9,3,0,6,3
S01007185,All HRPs aged 16 and over,422,258,200,56,144,34,24,164,105,1,17,33,8
S01007185,Owned: Total,152,112,89,16,73,22,1,40,38,0,0,0,2
S01007185,Owned: Owned outright,65,29,22,10,12,7,0,36,34,0,0,0,2
S01007185,Owned: Owned with a mortgage or loan or shared ownership,87,83,67,6,61,15,1,4,4,0,0,0,0
S01007185,Rented or living rent free: Total,270,146,111,40,71,12,23,124,67,1,17,33,6
S01007185,Rented or living rent free: Social rented,203,99,73,30,43,7,19,104,57,1,12,28,6
S01007185,Rented or living rent free: Private rented or living rent free,67,47,38,10,28,5,4,20,10,0,5,5,0
S01007186,All HRPs aged 16 and over,327,203,158,41,117,14,31,124,60,7,8,38,11
S01007186,Owned: Total,89,66,52,7,45,13,1,23,19,0,2,1,1
S01007186,Owned: Owned outright,39,22,16,3,13,6,0,17,15,0,0,1,1
S01007186,Owned: Owned with a mortgage or loan or shared ownership,50,44,36,4,32,7,1,6,4,0,2,0,0
S01007186,Rented or living rent free: Total,238,137,106,34,72,1,30,101,41,7,6,37,10
S01007186,Rented or living rent free: Social rented,181,90,66,24,42,1,23,91,37,7,4,35,8
S01007186,Rented or living rent free: Private rented or living rent free,57,47,40,10,30,0,7,10,4,0,2,2,2
S01007187,All HRPs aged 16 and over,498,287,223,47,176,32,32,211,150,8,9,37,7
S01007187,Owned: Total,156,110,89,14,75,14,7,46,43,0,0,3,0
S01007187,Owned: Owned outright,70,31,23,5,18,3,5,39,36,0,0,3,0
S01007187,Owned: Owned with a mortgage or loan or shared ownership,86,79,66,9,57,11,2,7,7,0,0,0,0
S01007187,Rented or living rent free: Total,342,177,134,33,101,18,25,165,107,8,9,34,7
S01007187,Rented or living rent free: Social rented,205,73,52,18,34,6,15,132,94,6,3,23,6
S01007187,Rented or living rent free: Private rented or living rent free,137,104,82,15,67,12,10,33,13,2,6,11,1
S01007188,All HRPs aged 16 and over,328,225,175,25,150,34,16,103,68,3,4,21,7
S01007188,Owned: Total,165,108,86,7,79,22,0,57,48,2,1,2,4
S01007188,Owned: Owned outright,81,32,22,1,21,10,0,49,44,0,0,2,3
S01007188,Owned: Owned with a mortgage or loan or shared ownership,84,76,64,6,58,12,0,8,4,2,1,0,1
S01007188,Rented or living rent free: Total,163,117,89,18,71,12,16,46,20,1,3,19,3
S01007188,Rented or living rent free: Social rented,69,41,30,10,20,3,8,28,9,1,0,15,3
S01007188,Rented or living rent free: Private rented or living rent free,94,76,59,8,51,9,8,18,11,0,3,4,0
S01007189,All HRPs aged 16 and over,461,229,175,36,139,27,27,232,184,4,9,27,8
S01007189,Owned: Total,180,121,99,10,89,21,1,59,53,0,1,3,2
S01007189,Owned: Owned outright,93,40,27,8,19,12,1,53,49,0,0,3,1
S01007189,Owned: Owned with a mortgage or loan or shared ownership,87,81,72,2,70,9,0,6,4,0,1,0,1
S01007189,Rented or living rent free: Total,281,108,76,26,50,6,26,173,131,4,8,24,6
S01007189,Rented or living rent free: Social rented,227,74,50,21,29,4,20,153,118,4,5,20,6
S01007189,Rented or living rent free: Private rented or living rent free,54,34,26,5,21,2,6,20,13,0,3,4,0
S01007190,All HRPs aged 16 and over,378,188,146,29,117,39,3,190,168,2,1,16,3
S01007190,Owned: Total,265,155,121,16,105,33,1,110,104,2,1,2,1
S01007190,Owned: Owned outright,147,53,43,12,31,10,0,94,92,1,0,0,1
S01007190,Owned: Owned with a mortgage or loan or shared ownership,118,102,78,4,74,23,1,16,12,1,1,2,0
S01007190,Rented or living rent free: Total,113,33,25,13,12,6,2,80,64,0,0,14,2
S01007190,Rented or living rent free: Social rented,77,23,17,9,8,4,2,54,38,0,0,14,2
S01007190,Rented or living rent free: Private rented or living rent free,36,10,8,4,4,2,0,26,26,0,0,0,0
S01007191,All HRPs aged 16 and over,274,180,146,26,120,21,13,94,80,1,3,7,3
S01007191,Owned: Total,157,102,86,11,75,15,1,55,54,0,0,0,1
S01007191,Owned: Owned outright,73,30,24,5,19,6,0,43,43,0,0,0,0
S01007191,Owned: Owned with a mortgage or loan or shared ownership,84,72,62,6,56,9,1,12,11,0,0,0,1
S01007191,Rented or living rent free: Total,117,78,60,15,45,6,12,39,26,1,3,7,2
S01007191,Rented or living rent free: Social rented,66,39,29,12,17,3,7,27,19,1,2,4,1
S01007191,Rented or living rent free: Private rented or living rent free,51,39,31,3,28,3,5,12,7,0,1,3,1
S01007192,All HRPs aged 16 and over,286,181,152,44,108,13,16,105,76,2,9,14,4
S01007192,Owned: Total,147,102,94,18,76,8,0,45,42,0,0,2,1
S01007192,Owned: Owned outright,69,30,28,8,20,2,0,39,37,0,0,1,1
S01007192,Owned: Owned with a mortgage or loan or shared ownership,78,72,66,10,56,6,0,6,5,0,0,1,0
S01007192,Rented or living rent free: Total,139,79,58,26,32,5,16,60,34,2,9,12,3
S01007192,Rented or living rent free: Social rented,125,68,48,21,27,5,15,57,33,2,7,12,3
S01007192,Rented or living rent free: Private rented or living rent free,14,11,10,5,5,0,1,3,1,0,2,0,0
S01007193,All HRPs aged 16 and over,289,190,148,27,121,27,15,99,76,1,4,16,2
S01007193,Owned: Total,176,127,102,11,91,20,5,49,45,0,0,4,0
S01007193,Owned: Owned outright,57,18,16,4,12,2,0,39,37,0,0,2,0
S01007193,Owned: Owned with a mortgage or loan or shared ownership,119,109,86,7,79,18,5,10,8,0,0,2,0
S01007193,Rented or living rent free: Total,113,63,46,16,30,7,10,50,31,1,4,12,2
S01007193,Rented or living rent free: Social rented,95,53,39,13,26,6,8,42,25,1,4,10,2
S01007193,Rented or living rent free: Private rented or living rent free,18,10,7,3,4,1,2,8,6,0,0,2,0
S01007194,All HRPs aged 16 and over,276,170,134,43,91,12,24,106,66,1,14,16,9
S01007194,Owned: Total,96,66,58,10,48,8,0,30,27,1,0,2,0
S01007194,Owned: Owned outright,45,19,15,4,11,4,0,26,24,0,0,2,0
S01007194,Owned: Owned with a mortgage or loan or shared ownership,51,47,43,6,37,4,0,4,3,1,0,0,0
S01007194,Rented or living rent free: Total,180,104,76,33,43,4,24,76,39,0,14,14,9
S01007194,Rented or living rent free: Social rented,148,79,58,28,30,4,17,69,39,0,9,13,8
S01007194,Rented or living rent free: Private rented or living rent free,32,25,18,5,13,0,7,7,0,0,5,1,1
S01007195,All HRPs aged 16 and over,237,159,121,24,97,18,20,78,58,1,6,10,3
S01007195,Owned: Total,120,80,68,9,59,11,1,40,40,0,0,0,0
S01007195,Owned: Owned outright,64,26,21,5,16,4,1,38,38,0,0,0,0
S01007195,Owned: Owned with a mortgage or loan or shared ownership,56,54,47,4,43,7,0,2,2,0,0,0,0
S01007195,Rented or living rent free: Total,117,79,53,15,38,7,19,38,18,1,6,10,3
S01007195,Rented or living rent free: Social rented,102,68,45,13,32,5,18,34,17,1,4,9,3
S01007195,Rented or living rent free: Private rented or living rent free,15,11,8,2,6,2,1,4,1,0,2,1,0
S01007196,All HRPs aged 16 and over,278,206,175,27,148,13,18,72,36,1,17,15,3
S01007196,Owned: Total,128,111,102,10,92,9,0,17,15,1,0,0,1
S01007196,Owned: Owned outright,31,18,16,6,10,2,0,13,12,1,0,0,0
S01007196,Owned: Owned with a mortgage or loan or shared ownership,97,93,86,4,82,7,0,4,3,0,0,0,1
S01007196,Rented or living rent free: Total,150,95,73,17,56,4,18,55,21,0,17,15,2
S01007196,Rented or living rent free: Social rented,130,80,64,16,48,2,14,50,21,0,15,13,1
S01007196,Rented or living rent free: Private rented or living rent free,20,15,9,1,8,2,4,5,0,0,2,2,1
S01007197,All HRPs aged 16 and over,286,205,155,45,110,14,36,81,41,2,8,19,11
S01007197,Owned: Total,45,30,24,3,21,6,0,15,11,0,1,1,2
S01007197,Owned: Owned outright,18,6,5,2,3,1,0,12,9,0,1,1,1
S01007197,Owned: Owned with a mortgage or loan or shared ownership,27,24,19,1,18,5,0,3,2,0,0,0,1
S01007197,Rented or living rent free: Total,241,175,131,42,89,8,36,66,30,2,7,18,9
S01007197,Rented or living rent free: Social rented,222,158,116,36,80,6,36,64,29,2,7,17,9
S01007197,Rented or living rent free: Private rented or living rent free,19,17,15,6,9,2,0,2,1,0,0,1,0
S01007198,All HRPs aged 16 and over,229,156,117,29,88,14,25,73,49,4,9,11,0
S01007198,Owned: Total,97,67,58,8,50,9,0,30,28,0,0,2,0
S01007198,Owned: Owned outright,46,17,16,5,11,1,0,29,27,0,0,2,0
S01007198,Owned: Owned with a mortgage or loan or shared ownership,51,50,42,3,39,8,0,1,1,0,0,0,0
S01007198,Rented or living rent free: Total,132,89,59,21,38,5,25,43,21,4,9,9,0
S01007198,Rented or living rent free: Social rented,113,74,49,19,30,1,24,39,19,2,9,9,0
S01007198,Rented or living rent free: Private rented or living rent free,19,15,10,2,8,4,1,4,2,2,0,0,0
S01007199,All HRPs aged 16 and over,306,200,163,53,110,11,26,106,63,2,11,26,4
S01007199,Owned: Total,114,82,74,12,62,7,1,32,29,0,0,3,0
S01007199,Owned: Owned outright,48,22,20,5,15,1,1,26,24,0,0,2,0
S01007199,Owned: Owned with a mortgage or loan or shared ownership,66,60,54,7,47,6,0,6,5,0,0,1,0
S01007199,Rented or living rent free: Total,192,118,89,41,48,4,25,74,34,2,11,23,4
S01007199,Rented or living rent free: Social rented,177,104,79,38,41,3,22,73,34,2,10,23,4
S01007199,Rented or living rent free: Private rented or living rent free,15,14,10,3,7,1,3,1,0,0,1,0,0
S01007200,All HRPs aged 16 and over,405,277,232,44,188,23,22,128,93,3,5,23,4
S01007200,Owned: Total,242,178,160,17,143,15,3,64,59,0,1,4,0
S01007200,Owned: Owned outright,99,39,35,6,29,2,2,60,56,0,1,3,0
S01007200,Owned: Owned with a mortgage or loan or shared ownership,143,139,125,11,114,13,1,4,3,0,0,1,0
S01007200,Rented or living rent free: Total,163,99,72,27,45,8,19,64,34,3,4,19,4
S01007200,Rented or living rent free: Social rented,130,78,56,26,30,4,18,52,28,3,0,18,3
S01007200,Rented or living rent free: Private rented or living rent free,33,21,16,1,15,4,1,12,6,0,4,1,1
S01007201,All HRPs aged 16 and over,350,208,174,28,146,19,15,142,112,3,5,19,3
S01007201,Owned: Total,217,134,115,11,104,17,2,83,77,1,2,3,0
S01007201,Owned: Owned outright,117,43,33,5,28,9,1,74,72,1,0,1,0
S01007201,Owned: Owned with a mortgage or loan or shared ownership,100,91,82,6,76,8,1,9,5,0,2,2,0
S01007201,Rented or living rent free: Total,133,74,59,17,42,2,13,59,35,2,3,16,3
S01007201,Rented or living rent free: Social rented,116,61,49,17,32,1,11,55,34,2,3,15,1
S01007201,Rented or living rent free: Private rented or living rent free,17,13,10,0,10,1,2,4,1,0,0,1,2
S01007202,All HRPs aged 16 and over,350,224,178,18,160,20,26,126,85,1,9,23,8
S01007202,Owned: Total,205,134,114,8,106,18,2,71,61,0,0,10,0
S01007202,Owned: Owned outright,116,53,41,6,35,10,2,63,54,0,0,9,0
S01007202,Owned: Owned with a mortgage or loan or shared ownership,89,81,73,2,71,8,0,8,7,0,0,1,0
S01007202,Rented or living rent free: Total,145,90,64,10,54,2,24,55,24,1,9,13,8
S01007202,Rented or living rent free: Social rented,126,75,52,9,43,0,23,51,22,1,7,13,8
S01007202,Rented or living rent free: Private rented or living rent free,19,15,12,1,11,2,1,4,2,0,2,0,0
S01007203,All HRPs aged 16 and over,250,172,149,24,125,17,6,78,62,1,2,12,1
S01007203,Owned: Total,182,141,124,18,106,15,2,41,39,0,1,1,0
S01007203,Owned: Owned outright,67,34,31,8,23,1,2,33,32,0,0,1,0
S01007203,Owned: Owned with a mortgage or loan or shared ownership,115,107,93,10,83,14,0,8,7,0,1,0,0
S01007203,Rented or living rent free: Total,68,31,25,6,19,2,4,37,23,1,1,11,1
S01007203,Rented or living rent free: Social rented,53,21,16,6,10,1,4,32,19,0,1,11,1
S01007203,Rented or living rent free: Private rented or living rent free,15,10,9,0,9,1,0,5,4,1,0,0,0
S01007204,All HRPs aged 16 and over,426,313,233,42,191,74,6,113,84,1,9,15,4
S01007204,Owned: Total,272,204,142,20,122,60,2,68,60,0,2,4,2
S01007204,Owned: Owned outright,132,75,45,14,31,30,0,57,52,0,0,4,1
S01007204,Owned: Owned with a mortgage or loan or shared ownership,140,129,97,6,91,30,2,11,8,0,2,0,1
S01007204,Rented or living rent free: Total,154,109,91,22,69,14,4,45,24,1,7,11,2
S01007204,Rented or living rent free: Social rented,68,41,36,19,17,2,3,27,15,1,5,6,0
S01007204,Rented or living rent free: Private rented or living rent free,86,68,55,3,52,12,1,18,9,0,2,5,2
S01007205,All HRPs aged 16 and over,263,186,133,19,114,48,5,77,67,0,3,6,1
S01007205,Owned: Total,176,126,83,12,71,42,1,50,49,0,0,0,1
S01007205,Owned: Owned outright,96,51,31,8,23,19,1,45,44,0,0,0,1
S01007205,Owned: Owned with a mortgage or loan or shared ownership,80,75,52,4,48,23,0,5,5,0,0,0,0
S01007205,Rented or living rent free: Total,87,60,50,7,43,6,4,27,18,0,3,6,0
S01007205,Rented or living rent free: Social rented,11,3,2,0,2,0,1,8,3,0,2,3,0
S01007205,Rented or living rent free: Private rented or living rent free,76,57,48,7,41,6,3,19,15,0,1,3,0
S01007206,All HRPs aged 16 and over,212,120,98,11,87,14,8,92,78,1,2,9,2
S01007206,Owned: Total,124,73,61,7,54,12,0,51,49,0,0,2,0
S01007206,Owned: Owned outright,78,28,21,4,17,7,0,50,48,0,0,2,0
S01007206,Owned: Owned with a mortgage or loan or shared ownership,46,45,40,3,37,5,0,1,1,0,0,0,0
S01007206,Rented or living rent free: Total,88,47,37,4,33,2,8,41,29,1,2,7,2
S01007206,Rented or living rent free: Social rented,45,13,9,1,8,1,3,32,24,0,1,5,2
S01007206,Rented or living rent free: Private rented or living rent free,43,34,28,3,25,1,5,9,5,1,1,2,0
S01007207,All HRPs aged 16 and over,420,276,231,38,193,34,11,144,123,2,4,9,6
S01007207,Owned: Total,304,204,176,23,153,28,0,100,94,1,2,0,3
S01007207,Owned: Owned outright,158,64,55,14,41,9,0,94,89,1,1,0,3
S01007207,Owned: Owned with a mortgage or loan or shared ownership,146,140,121,9,112,19,0,6,5,0,1,0,0
S01007207,Rented or living rent free: Total,116,72,55,15,40,6,11,44,29,1,2,9,3
S01007207,Rented or living rent free: Social rented,76,44,32,12,20,3,9,32,21,0,1,7,3
S01007207,Rented or living rent free: Private rented or living rent free,40,28,23,3,20,3,2,12,8,1,1,2,0
S01007208,All HRPs aged 16 and over,550,365,290,53,237,20,55,185,118,8,8,32,19
S01007208,Owned: Total,214,161,148,21,127,10,3,53,46,0,0,1,6
S01007208,Owned: Owned outright,83,37,33,6,27,3,1,46,42,0,0,1,3
S01007208,Owned: Owned with a mortgage or loan or shared ownership,131,124,115,15,100,7,2,7,4,0,0,0,3
S01007208,Rented or living rent free: Total,336,204,142,32,110,10,52,132,72,8,8,31,13
S01007208,Rented or living rent free: Social rented,201,105,67,22,45,6,32,96,59,5,1,23,8
S01007208,Rented or living rent free: Private rented or living rent free,135,99,75,10,65,4,20,36,13,3,7,8,5
S01007209,All HRPs aged 16 and over,389,248,193,26,167,34,21,141,99,0,4,25,13
S01007209,Owned: Total,188,126,102,13,89,23,1,62,58,0,0,2,2
S01007209,Owned: Owned outright,106,49,35,8,27,14,0,57,54,0,0,1,2
S01007209,Owned: Owned with a mortgage or loan or shared ownership,82,77,67,5,62,9,1,5,4,0,0,1,0
S01007209,Rented or living rent free: Total,201,122,91,13,78,11,20,79,41,0,4,23,11
S01007209,Rented or living rent free: Social rented,78,30,20,6,14,2,8,48,29,0,2,13,4
S01007209,Rented or living rent free: Private rented or living rent free,123,92,71,7,64,9,12,31,12,0,2,10,7
S01007210,All HRPs aged 16 and over,387,253,212,42,170,20,21,134,96,3,8,19,8
S01007210,Owned: Total,170,131,118,18,100,12,1,39,37,0,0,1,1
S01007210,Owned: Owned outright,72,36,32,11,21,3,1,36,34,0,0,1,1
S01007210,Owned: Owned with a mortgage or loan or shared ownership,98,95,86,7,79,9,0,3,3,0,0,0,0
S01007210,Rented or living rent free: Total,217,122,94,24,70,8,20,95,59,3,8,18,7
S01007210,Rented or living rent free: Social rented,151,69,53,17,36,3,13,82,55,3,6,13,5
S01007210,Rented or living rent free: Private rented or living rent free,66,53,41,7,34,5,7,13,4,0,2,5,2
S01007211,All HRPs aged 16 and over,498,277,222,47,175,30,25,221,154,7,15,36,9
S01007211,Owned: Total,207,126,101,18,83,20,5,81,78,1,2,0,0
S01007211,Owned: Owned outright,110,36,24,6,18,9,3,74,72,1,1,0,0
S01007211,Owned: Owned with a mortgage or loan or shared ownership,97,90,77,12,65,11,2,7,6,0,1,0,0
S01007211,Rented or living rent free: Total,291,151,121,29,92,10,20,140,76,6,13,36,9
S01007211,Rented or living rent free: Social rented,242,122,95,27,68,9,18,120,65,5,8,34,8
S01007211,Rented or living rent free: Private rented or living rent free,49,29,26,2,24,1,2,20,11,1,5,2,1
S01007212,All HRPs aged 16 and over,259,184,151,25,126,23,10,75,67,1,2,3,2
S01007212,Owned: Total,186,128,108,14,94,19,1,58,56,0,1,1,0
S01007212,Owned: Owned outright,102,48,37,9,28,10,1,54,52,0,1,1,0
S01007212,Owned: Owned with a mortgage or loan or shared ownership,84,80,71,5,66,9,0,4,4,0,0,0,0
S01007212,Rented or living rent free: Total,73,56,43,11,32,4,9,17,11,1,1,2,2
S01007212,Rented or living rent free: Social rented,20,14,10,3,7,0,4,6,5,0,1,0,0
S01007212,Rented or living rent free: Private rented or living rent free,53,42,33,8,25,4,5,11,6,1,0,2,2
S01007213,All HRPs aged 16 and over,423,241,198,34,164,33,10,182,159,3,7,8,5
S01007213,Owned: Total,294,165,134,21,113,26,5,129,125,1,2,0,1
S01007213,Owned: Owned outright,180,57,48,18,30,7,2,123,120,0,2,0,1
S01007213,Owned: Owned with a mortgage or loan or shared ownership,114,108,86,3,83,19,3,6,5,1,0,0,0
S01007213,Rented or living rent free: Total,129,76,64,13,51,7,5,53,34,2,5,8,4
S01007213,Rented or living rent free: Social rented,58,23,18,6,12,2,3,35,20,1,5,7,2
S01007213,Rented or living rent free: Private rented or living rent free,71,53,46,7,39,5,2,18,14,1,0,1,2
S01007214,All HRPs aged 16 and over,424,231,190,28,162,26,15,193,143,4,6,35,5
S01007214,Owned: Total,160,108,91,6,85,14,3,52,47,0,2,3,0
S01007214,Owned: Owned outright,81,33,25,1,24,6,2,48,44,0,2,2,0
S01007214,Owned: Owned with a mortgage or loan or shared ownership,79,75,66,5,61,8,1,4,3,0,0,1,0
S01007214,Rented or living rent free: Total,264,123,99,22,77,12,12,141,96,4,4,32,5
S01007214,Rented or living rent free: Social rented,208,81,67,19,48,5,9,127,90,4,4,24,5
S01007214,Rented or living rent free: Private rented or living rent free,56,42,32,3,29,7,3,14,6,0,0,8,0
S01007215,All HRPs aged 16 and over,397,243,203,40,163,28,12,154,114,5,7,23,5
S01007215,Owned: Total,204,138,112,23,89,23,3,66,59,2,1,3,1
S01007215,Owned: Owned outright,103,45,33,13,20,10,2,58,55,0,0,2,1
S01007215,Owned: Owned with a mortgage or loan or shared ownership,101,93,79,10,69,13,1,8,4,2,1,1,0
S01007215,Rented or living rent free: Total,193,105,91,17,74,5,9,88,55,3,6,20,4
S01007215,Rented or living rent free: Social rented,108,34,29,7,22,2,3,74,50,1,5,15,3
S01007215,Rented or living rent free: Private rented or living rent free,85,71,62,10,52,3,6,14,5,2,1,5,1
S01007216,All HRPs aged 16 and over,315,197,165,19,146,24,8,118,106,1,4,3,4
S01007216,Owned: Total,254,160,136,13,123,23,1,94,92,0,0,0,2
S01007216,Owned: Owned outright,140,53,43,6,37,10,0,87,86,0,0,0,1
S01007216,Owned: Owned with a mortgage or loan or shared ownership,114,107,93,7,86,13,1,7,6,0,0,0,1
S01007216,Rented or living rent free: Total,61,37,29,6,23,1,7,24,14,1,4,3,2
S01007216,Rented or living rent free: Social rented,31,14,12,3,9,0,2,17,10,1,3,3,0
S01007216,Rented or living rent free: Private rented or living rent free,30,23,17,3,14,1,5,7,4,0,1,0,2
S01007217,All HRPs aged 16 and over,460,287,230,46,184,33,24,173,119,2,11,29,12
S01007217,Owned: Total,244,164,140,22,118,22,2,80,77,0,1,2,0
S01007217,Owned: Owned outright,116,44,34,12,22,9,1,72,71,0,0,1,0
S01007217,Owned: Owned with a mortgage or loan or shared ownership,128,120,106,10,96,13,1,8,6,0,1,1,0
S01007217,Rented or living rent free: Total,216,123,90,24,66,11,22,93,42,2,10,27,12
S01007217,Rented or living rent free: Social rented,171,87,62,23,39,8,17,84,36,2,9,25,12
S01007217,Rented or living rent free: Private rented or living rent free,45,36,28,1,27,3,5,9,6,0,1,2,0
S01007218,All HRPs aged 16 and over,353,235,189,25,164,43,3,118,113,1,2,1,1
S01007218,Owned: Total,319,216,172,19,153,42,2,103,102,0,0,0,1
S01007218,Owned: Owned outright,182,87,62,16,46,24,1,95,95,0,0,0,0
S01007218,Owned: Owned with a mortgage or loan or shared ownership,137,129,110,3,107,18,1,8,7,0,0,0,1
S01007218,Rented or living rent free: Total,34,19,17,6,11,1,1,15,11,1,2,1,0
S01007218,Rented or living rent free: Social rented,14,4,3,1,2,0,1,10,7,0,2,1,0
S01007218,Rented or living rent free: Private rented or living rent free,20,15,14,5,9,1,0,5,4,1,0,0,0
S01007219,All HRPs aged 16 and over,386,236,197,35,162,24,15,150,116,1,3,22,8
S01007219,Owned: Total,214,156,134,13,121,22,0,58,52,0,2,2,2
S01007219,Owned: Owned outright,83,38,32,7,25,6,0,45,44,0,0,0,1
S01007219,Owned: Owned with a mortgage or loan or shared ownership,131,118,102,6,96,16,0,13,8,0,2,2,1
S01007219,Rented or living rent free: Total,172,80,63,22,41,2,15,92,64,1,1,20,6
S01007219,Rented or living rent free: Social rented,146,61,46,16,30,0,15,85,59,1,1,19,5
S01007219,Rented or living rent free: Private rented or living rent free,26,19,17,6,11,2,0,7,5,0,0,1,1
S01007220,All HRPs aged 16 and over,330,212,181,37,144,22,9,118,79,1,4,29,5
S01007220,Owned: Total,191,151,127,15,112,20,4,40,35,1,2,2,0
S01007220,Owned: Owned outright,73,42,33,12,21,5,4,31,28,1,1,1,0
S01007220,Owned: Owned with a mortgage or loan or shared ownership,118,109,94,3,91,15,0,9,7,0,1,1,0
S01007220,Rented or living rent free: Total,139,61,54,22,32,2,5,78,44,0,2,27,5
S01007220,Rented or living rent free: Social rented,107,37,32,15,17,1,4,70,41,0,0,24,5
S01007220,Rented or living rent free: Private rented or living rent free,32,24,22,7,15,1,1,8,3,0,2,3,0
S01007221,All HRPs aged 16 and over,273,183,145,15,130,34,4,90,81,1,3,4,1
S01007221,Owned: Total,230,154,123,7,116,29,2,76,72,0,1,3,0
S01007221,Owned: Owned outright,113,41,26,2,24,14,1,72,70,0,0,2,0
S01007221,Owned: Owned with a mortgage or loan or shared ownership,117,113,97,5,92,15,1,4,2,0,1,1,0
S01007221,Rented or living rent free: Total,43,29,22,8,14,5,2,14,9,1,2,1,1
S01007221,Rented or living rent free: Social rented,24,16,10,6,4,4,2,8,6,0,0,1,1
S01007221,Rented or living rent free: Private rented or living rent free,19,13,12,2,10,1,0,6,3,1,2,0,0
S01007222,All HRPs aged 16 and over,320,216,183,24,159,21,12,104,76,1,11,13,3
S01007222,Owned: Total,215,145,127,11,116,16,2,70,62,1,5,1,1
S01007222,Owned: Owned outright,120,56,50,6,44,6,0,64,60,0,2,1,1
S01007222,Owned: Owned with a mortgage or loan or shared ownership,95,89,77,5,72,10,2,6,2,1,3,0,0
S01007222,Rented or living rent free: Total,105,71,56,13,43,5,10,34,14,0,6,12,2
S01007222,Rented or living rent free: Social rented,82,53,41,11,30,4,8,29,11,0,5,11,2
S01007222,Rented or living rent free: Private rented or living rent free,23,18,15,2,13,1,2,5,3,0,1,1,0
S01007223,All HRPs aged 16 and over,200,147,123,9,114,22,2,53,50,0,1,2,0
S01007223,Owned: Total,175,127,109,6,103,18,0,48,47,0,0,1,0
S01007223,Owned: Owned outright,77,32,26,6,20,6,0,45,45,0,0,0,0
S01007223,Owned: Owned with a mortgage or loan or shared ownership,98,95,83,0,83,12,0,3,2,0,0,1,0
S01007223,Rented or living rent free: Total,25,20,14,3,11,4,2,5,3,0,1,1,0
S01007223,Rented or living rent free: Social rented,3,1,1,0,1,0,0,2,0,0,1,1,0
S01007223,Rented or living rent free: Private rented or living rent free,22,19,13,3,10,4,2,3,3,0,0,0,0
S01007224,All HRPs aged 16 and over,279,163,130,17,113,31,2,116,106,1,4,3,2
S01007224,Owned: Total,203,129,103,11,92,26,0,74,73,0,0,0,1
S01007224,Owned: Owned outright,114,46,30,8,22,16,0,68,68,0,0,0,0
S01007224,Owned: Owned with a mortgage or loan or shared ownership,89,83,73,3,70,10,0,6,5,0,0,0,1
S01007224,Rented or living rent free: Total,76,34,27,6,21,5,2,42,33,1,4,3,1
S01007224,Rented or living rent free: Social rented,52,18,13,6,7,3,2,34,26,1,4,2,1
S01007224,Rented or living rent free: Private rented or living rent free,24,16,14,0,14,2,0,8,7,0,0,1,0
S01007225,All HRPs aged 16 and over,369,270,196,22,174,70,4,99,83,1,4,9,2
S01007225,Owned: Total,267,204,139,12,127,63,2,63,61,0,1,1,0
S01007225,Owned: Owned outright,137,82,42,8,34,39,1,55,55,0,0,0,0
S01007225,Owned: Owned with a mortgage or loan or shared ownership,130,122,97,4,93,24,1,8,6,0,1,1,0
S01007225,Rented or living rent free: Total,102,66,57,10,47,7,2,36,22,1,3,8,2
S01007225,Rented or living rent free: Social rented,18,8,8,2,6,0,0,10,2,0,3,4,1
S01007225,Rented or living rent free: Private rented or living rent free,84,58,49,8,41,7,2,26,20,1,0,4,1
S01007226,All HRPs aged 16 and over,322,236,150,16,134,81,5,86,71,0,6,8,1
S01007226,Owned: Total,237,170,105,13,92,62,3,67,59,0,5,3,0
S01007226,Owned: Owned outright,133,74,33,6,27,39,2,59,54,0,4,1,0
S01007226,Owned: Owned with a mortgage or loan or shared ownership,104,96,72,7,65,23,1,8,5,0,1,2,0
S01007226,Rented or living rent free: Total,85,66,45,3,42,19,2,19,12,0,1,5,1
S01007226,Rented or living rent free: Social rented,8,1,1,0,1,0,0,7,3,0,1,2,1
S01007226,Rented or living rent free: Private rented or living rent free,77,65,44,3,41,19,2,12,9,0,0,3,0
S01007227,All HRPs aged 16 and over,425,267,213,29,184,45,9,158,139,2,2,12,3
S01007227,Owned: Total,316,210,173,22,151,35,2,106,103,2,1,0,0
S01007227,Owned: Owned outright,155,58,44,6,38,12,2,97,95,2,0,0,0
S01007227,Owned: Owned with a mortgage or loan or shared ownership,161,152,129,16,113,23,0,9,8,0,1,0,0
S01007227,Rented or living rent free: Total,109,57,40,7,33,10,7,52,36,0,1,12,3
S01007227,Rented or living rent free: Social rented,73,31,21,4,17,4,6,42,27,0,1,11,3
S01007227,Rented or living rent free: Private rented or living rent free,36,26,19,3,16,6,1,10,9,0,0,1,0
S01007228,All HRPs aged 16 and over,260,195,122,13,109,65,8,65,46,2,1,15,1
S01007228,Owned: Total,156,124,70,6,64,52,2,32,29,2,0,1,0
S01007228,Owned: Owned outright,75,50,19,3,16,31,0,25,22,2,0,1,0
S01007228,Owned: Owned with a mortgage or loan or shared ownership,81,74,51,3,48,21,2,7,7,0,0,0,0
S01007228,Rented or living rent free: Total,104,71,52,7,45,13,6,33,17,0,1,14,1
S01007228,Rented or living rent free: Social rented,18,9,7,0,7,0,2,9,2,0,0,6,1
S01007228,Rented or living rent free: Private rented or living rent free,86,62,45,7,38,13,4,24,15,0,1,8,0
S01007229,All HRPs aged 16 and over,455,341,242,27,215,90,9,114,97,0,4,9,4
S01007229,Owned: Total,274,206,136,15,121,69,1,68,65,0,2,1,0
S01007229,Owned: Owned outright,135,75,37,10,27,37,1,60,58,0,2,0,0
S01007229,Owned: Owned with a mortgage or loan or shared ownership,139,131,99,5,94,32,0,8,7,0,0,1,0
S01007229,Rented or living rent free: Total,181,135,106,12,94,21,8,46,32,0,2,8,4
S01007229,Rented or living rent free: Social rented,15,8,6,1,5,0,2,7,5,0,0,2,0
S01007229,Rented or living rent free: Private rented or living rent free,166,127,100,11,89,21,6,39,27,0,2,6,4
S01007230,All HRPs aged 16 and over,358,241,195,35,160,17,29,117,86,2,10,12,7
S01007230,Owned: Total,119,83,70,9,61,10,3,36,34,0,1,0,1
S01007230,Owned: Owned outright,44,15,12,4,8,1,2,29,28,0,0,0,1
S01007230,Owned: Owned with a mortgage or loan or shared ownership,75,68,58,5,53,9,1,7,6,0,1,0,0
S01007230,Rented or living rent free: Total,239,158,125,26,99,7,26,81,52,2,9,12,6
S01007230,Rented or living rent free: Social rented,221,147,116,24,92,7,24,74,49,2,8,10,5
S01007230,Rented or living rent free: Private rented or living rent free,18,11,9,2,7,0,2,7,3,0,1,2,1
S01007231,All HRPs aged 16 and over,372,202,165,27,138,14,23,170,132,2,12,17,7
S01007231,Owned: Total,134,77,69,9,60,8,0,57,56,0,0,1,0
S01007231,Owned: Owned outright,57,12,9,2,7,3,0,45,45,0,0,0,0
S01007231,Owned: Owned with a mortgage or loan or shared ownership,77,65,60,7,53,5,0,12,11,0,0,1,0
S01007231,Rented or living rent free: Total,238,125,96,18,78,6,23,113,76,2,12,16,7
S01007231,Rented or living rent free: Social rented,162,73,60,12,48,2,11,89,63,1,8,10,7
S01007231,Rented or living rent free: Private rented or living rent free,76,52,36,6,30,4,12,24,13,1,4,6,0
S01007232,All HRPs aged 16 and over,381,230,185,44,141,12,33,151,103,3,9,27,9
S01007232,Owned: Total,90,61,52,4,48,8,1,29,25,1,0,2,1
S01007232,Owned: Owned outright,40,13,10,2,8,2,1,27,23,1,0,2,1
S01007232,Owned: Owned with a mortgage or loan or shared ownership,50,48,42,2,40,6,0,2,2,0,0,0,0
S01007232,Rented or living rent free: Total,291,169,133,40,93,4,32,122,78,2,9,25,8
S01007232,Rented or living rent free: Social rented,236,136,105,35,70,3,28,100,67,1,6,21,5
S01007232,Rented or living rent free: Private rented or living rent free,55,33,28,5,23,1,4,22,11,1,3,4,3
S01007233,All HRPs aged 16 and over,347,251,198,25,173,37,16,96,79,1,4,7,5
S01007233,Owned: Total,215,159,127,15,112,31,1,56,53,0,1,0,2
S01007233,Owned: Owned outright,107,57,40,8,32,16,1,50,49,0,0,0,1
S01007233,Owned: Owned with a mortgage or loan or shared ownership,108,102,87,7,80,15,0,6,4,0,1,0,1
S01007233,Rented or living rent free: Total,132,92,71,10,61,6,15,40,26,1,3,7,3
S01007233,Rented or living rent free: Social rented,87,55,44,8,36,2,9,32,23,1,1,5,2
S01007233,Rented or living rent free: Private rented or living rent free,45,37,27,2,25,4,6,8,3,0,2,2,1
S01007234,All HRPs aged 16 and over,263,159,133,26,107,19,7,104,89,1,3,6,5
S01007234,Owned: Total,162,101,86,17,69,15,0,61,55,0,0,2,4
S01007234,Owned: Owned outright,91,36,31,11,20,5,0,55,52,0,0,1,2
S01007234,Owned: Owned with a mortgage or loan or shared ownership,71,65,55,6,49,10,0,6,3,0,0,1,2
S01007234,Rented or living rent free: Total,101,58,47,9,38,4,7,43,34,1,3,4,1
S01007234,Rented or living rent free: Social rented,60,30,25,5,20,2,3,30,25,1,0,4,0
S01007234,Rented or living rent free: Private rented or living rent free,41,28,22,4,18,2,4,13,9,0,3,0,1
S01007235,All HRPs aged 16 and over,407,242,201,33,168,26,15,165,138,3,6,10,8
S01007235,Owned: Total,202,126,104,13,91,19,3,76,66,2,1,2,5
S01007235,Owned: Owned outright,104,36,28,8,20,6,2,68,63,1,0,2,2
S01007235,Owned: Owned with a mortgage or loan or shared ownership,98,90,76,5,71,13,1,8,3,1,1,0,3
S01007235,Rented or living rent free: Total,205,116,97,20,77,7,12,89,72,1,5,8,3
S01007235,Rented or living rent free: Social rented,94,28,22,8,14,0,6,66,58,0,3,4,1
S01007235,Rented or living rent free: Private rented or living rent free,111,88,75,12,63,7,6,23,14,1,2,4,2
S01007236,All HRPs aged 16 and over,305,194,160,27,133,26,8,111,92,4,3,9,3
S01007236,Owned: Total,205,131,108,18,90,22,1,74,66,1,1,4,2
S01007236,Owned: Owned outright,90,22,15,4,11,7,0,68,62,1,1,2,2
S01007236,Owned: Owned with a mortgage or loan or shared ownership,115,109,93,14,79,15,1,6,4,0,0,2,0
S01007236,Rented or living rent free: Total,100,63,52,9,43,4,7,37,26,3,2,5,1
S01007236,Rented or living rent free: Social rented,51,26,23,7,16,1,2,25,18,3,1,3,0
S01007236,Rented or living rent free: Private rented or living rent free,49,37,29,2,27,3,5,12,8,0,1,2,1
S01007237,All HRPs aged 16 and over,325,200,169,16,153,27,4,125,112,0,1,9,3
S01007237,Owned: Total,276,174,151,14,137,22,1,102,97,0,0,3,2
S01007237,Owned: Owned outright,152,59,49,10,39,9,1,93,90,0,0,1,2
S01007237,Owned: Owned with a mortgage or loan or shared ownership,124,115,102,4,98,13,0,9,7,0,0,2,0
S01007237,Rented or living rent free: Total,49,26,18,2,16,5,3,23,15,0,1,6,1
S01007237,Rented or living rent free: Social rented,21,11,6,0,6,3,2,10,5,0,0,5,0
S01007237,Rented or living rent free: Private rented or living rent free,28,15,12,2,10,2,1,13,10,0,1,1,1
S01007238,All HRPs aged 16 and over,417,260,224,32,192,23,13,157,145,3,2,4,3
S01007238,Owned: Total,266,177,154,12,142,21,2,89,84,3,1,0,1
S01007238,Owned: Owned outright,118,40,31,6,25,8,1,78,76,1,1,0,0
S01007238,Owned: Owned with a mortgage or loan or shared ownership,148,137,123,6,117,13,1,11,8,2,0,0,1
S01007238,Rented or living rent free: Total,151,83,70,20,50,2,11,68,61,0,1,4,2
S01007238,Rented or living rent free: Social rented,123,60,49,16,33,2,9,63,56,0,1,4,2
S01007238,Rented or living rent free: Private rented or living rent free,28,23,21,4,17,0,2,5,5,0,0,0,0
S01007239,All HRPs aged 16 and over,367,203,159,19,140,42,2,164,150,4,4,3,3
S01007239,Owned: Total,313,180,140,17,123,39,1,133,130,2,0,0,1
S01007239,Owned: Owned outright,186,62,47,11,36,14,1,124,121,2,0,0,1
S01007239,Owned: Owned with a mortgage or loan or shared ownership,127,118,93,6,87,25,0,9,9,0,0,0,0
S01007239,Rented or living rent free: Total,54,23,19,2,17,3,1,31,20,2,4,3,2
S01007239,Rented or living rent free: Social rented,26,7,5,1,4,1,1,19,13,0,2,2,2
S01007239,Rented or living rent free: Private rented or living rent free,28,16,14,1,13,2,0,12,7,2,2,1,0
S01007240,All HRPs aged 16 and over,233,161,116,12,104,45,0,72,60,3,0,7,2
S01007240,Owned: Total,136,93,63,6,57,30,0,43,43,0,0,0,0
S01007240,Owned: Owned outright,83,44,28,6,22,16,0,39,39,0,0,0,0
S01007240,Owned: Owned with a mortgage or loan or shared ownership,53,49,35,0,35,14,0,4,4,0,0,0,0
S01007240,Rented or living rent free: Total,97,68,53,6,47,15,0,29,17,3,0,7,2
S01007240,Rented or living rent free: Social rented,8,2,2,0,2,0,0,6,2,0,0,3,1
S01007240,Rented or living rent free: Private rented or living rent free,89,66,51,6,45,15,0,23,15,3,0,4,1
S01007241,All HRPs aged 16 and over,242,183,123,9,114,58,2,59,56,0,0,2,1
S01007241,Owned: Total,191,148,96,6,90,52,0,43,41,0,0,2,0
S01007241,Owned: Owned outright,109,69,34,1,33,35,0,40,38,0,0,2,0
S01007241,Owned: Owned with a mortgage or loan or shared ownership,82,79,62,5,57,17,0,3,3,0,0,0,0
S01007241,Rented or living rent free: Total,51,35,27,3,24,6,2,16,15,0,0,0,1
S01007241,Rented or living rent free: Social rented,4,3,3,1,2,0,0,1,1,0,0,0,0
S01007241,Rented or living rent free: Private rented or living rent free,47,32,24,2,22,6,2,15,14,0,0,0,1
S01007242,All HRPs aged 16 and over,447,275,218,33,185,47,10,172,159,1,3,7,2
S01007242,Owned: Total,346,228,182,26,156,43,3,118,116,0,1,1,0
S01007242,Owned: Owned outright,180,75,62,20,42,11,2,105,104,0,1,0,0
S01007242,Owned: Owned with a mortgage or loan or shared ownership,166,153,120,6,114,32,1,13,12,0,0,1,0
S01007242,Rented or living rent free: Total,101,47,36,7,29,4,7,54,43,1,2,6,2
S01007242,Rented or living rent free: Social rented,54,16,10,3,7,1,5,38,33,0,0,5,0
S01007242,Rented or living rent free: Private rented or living rent free,47,31,26,4,22,3,2,16,10,1,2,1,2
S01007243,All HRPs aged 16 and over,255,164,129,15,114,30,5,91,82,0,1,4,4
S01007243,Owned: Total,207,138,107,12,95,29,2,69,65,0,0,1,3
S01007243,Owned: Owned outright,108,44,31,6,25,13,0,64,60,0,0,1,3
S01007243,Owned: Owned with a mortgage or loan or shared ownership,99,94,76,6,70,16,2,5,5,0,0,0,0
S01007243,Rented or living rent free: Total,48,26,22,3,19,1,3,22,17,0,1,3,1
S01007243,Rented or living rent free: Social rented,25,12,9,2,7,0,3,13,9,0,1,2,1
S01007243,Rented or living rent free: Private rented or living rent free,23,14,13,1,12,1,0,9,8,0,0,1,0
S01007244,All HRPs aged 16 and over,303,197,143,19,124,51,3,106,100,0,2,3,1
S01007244,Owned: Total,226,145,106,13,93,38,1,81,80,0,1,0,0
S01007244,Owned: Owned outright,144,68,41,10,31,26,1,76,75,0,1,0,0
S01007244,Owned: Owned with a mortgage or loan or shared ownership,82,77,65,3,62,12,0,5,5,0,0,0,0
S01007244,Rented or living rent free: Total,77,52,37,6,31,13,2,25,20,0,1,3,1
S01007244,Rented or living rent free: Social rented,16,9,6,1,5,1,2,7,5,0,0,1,1
S01007244,Rented or living rent free: Private rented or living rent free,61,43,31,5,26,12,0,18,15,0,1,2,0
S01007245,All HRPs aged 16 and over,310,193,138,19,119,52,3,117,101,1,4,6,5
S01007245,Owned: Total,190,144,103,12,91,39,2,46,42,0,1,2,1
S01007245,Owned: Owned outright,102,63,36,8,28,26,1,39,36,0,1,1,1
S01007245,Owned: Owned with a mortgage or loan or shared ownership,88,81,67,4,63,13,1,7,6,0,0,1,0
S01007245,Rented or living rent free: Total,120,49,35,7,28,13,1,71,59,1,3,4,4
S01007245,Rented or living rent free: Social rented,67,15,14,3,11,1,0,52,44,0,2,3,3
S01007245,Rented or living rent free: Private rented or living rent free,53,34,21,4,17,12,1,19,15,1,1,1,1
S01007246,All HRPs aged 16 and over,237,179,130,11,119,46,3,58,49,1,2,6,0
S01007246,Owned: Total,171,135,96,7,89,38,1,36,31,1,1,3,0
S01007246,Owned: Owned outright,89,56,36,4,32,20,0,33,30,0,0,3,0
S01007246,Owned: Owned with a mortgage or loan or shared ownership,82,79,60,3,57,18,1,3,1,1,1,0,0
S01007246,Rented or living rent free: Total,66,44,34,4,30,8,2,22,18,0,1,3,0
S01007246,Rented or living rent free: Social rented,25,12,11,3,8,0,1,13,11,0,0,2,0
S01007246,Rented or living rent free: Private rented or living rent free,41,32,23,1,22,8,1,9,7,0,1,1,0
S01007247,All HRPs aged 16 and over,279,195,154,21,133,39,2,84,67,0,5,9,3
S01007247,Owned: Total,149,113,89,12,77,23,1,36,33,0,2,1,0
S01007247,Owned: Owned outright,69,38,25,8,17,12,1,31,30,0,1,0,0
S01007247,Owned: Owned with a mortgage or loan or shared ownership,80,75,64,4,60,11,0,5,3,0,1,1,0
S01007247,Rented or living rent free: Total,130,82,65,9,56,16,1,48,34,0,3,8,3
S01007247,Rented or living rent free: Social rented,28,10,10,3,7,0,0,18,10,0,2,4,2
S01007247,Rented or living rent free: Private rented or living rent free,102,72,55,6,49,16,1,30,24,0,1,4,1
S01007248,All HRPs aged 16 and over,310,183,145,20,125,37,1,127,123,0,0,3,1
S01007248,Owned: Total,289,169,135,16,119,34,0,120,117,0,0,2,1
S01007248,Owned: Owned outright,180,64,51,11,40,13,0,116,113,0,0,2,1
S01007248,Owned: Owned with a mortgage or loan or shared ownership,109,105,84,5,79,21,0,4,4,0,0,0,0
S01007248,Rented or living rent free: Total,21,14,10,4,6,3,1,7,6,0,0,1,0
S01007248,Rented or living rent free: Social rented,6,4,4,3,1,0,0,2,1,0,0,1,0
S01007248,Rented or living rent free: Private rented or living rent free,15,10,6,1,5,3,1,5,5,0,0,0,0
S01007249,All HRPs aged 16 and over,174,110,88,22,66,19,3,64,58,1,5,0,0
S01007249,Owned: Total,129,78,63,17,46,15,0,51,50,0,1,0,0
S01007249,Owned: Owned outright,85,36,29,8,21,7,0,49,48,0,1,0,0
S01007249,Owned: Owned with a mortgage or loan or shared ownership,44,42,34,9,25,8,0,2,2,0,0,0,0
S01007249,Rented or living rent free: Total,45,32,25,5,20,4,3,13,8,1,4,0,0
S01007249,Rented or living rent free: Social rented,21,14,13,1,12,0,1,7,2,1,4,0,0
S01007249,Rented or living rent free: Private rented or living rent free,24,18,12,4,8,4,2,6,6,0,0,0,0
S01007250,All HRPs aged 16 and over,432,302,259,34,225,29,14,130,114,0,3,10,3
S01007250,Owned: Total,267,184,157,17,140,24,3,83,79,0,1,2,1
S01007250,Owned: Owned outright,131,57,45,7,38,11,1,74,72,0,1,0,1
S01007250,Owned: Owned with a mortgage or loan or shared ownership,136,127,112,10,102,13,2,9,7,0,0,2,0
S01007250,Rented or living rent free: Total,165,118,102,17,85,5,11,47,35,0,2,8,2
S01007250,Rented or living rent free: Social rented,90,52,44,12,32,2,6,38,27,0,1,8,2
S01007250,Rented or living rent free: Private rented or living rent free,75,66,58,5,53,3,5,9,8,0,1,0,0
S01007251,All HRPs aged 16 and over,250,138,109,17,92,24,5,112,98,1,5,6,2
S01007251,Owned: Total,126,87,65,1,64,20,2,39,36,1,0,0,2
S01007251,Owned: Owned outright,51,20,11,0,11,9,0,31,29,0,0,0,2
S01007251,Owned: Owned with a mortgage or loan or shared ownership,75,67,54,1,53,11,2,8,7,1,0,0,0
S01007251,Rented or living rent free: Total,124,51,44,16,28,4,3,73,62,0,5,6,0
S01007251,Rented or living rent free: Social rented,100,34,28,9,19,3,3,66,56,0,4,6,0
S01007251,Rented or living rent free: Private rented or living rent free,24,17,16,7,9,1,0,7,6,0,1,0,0
S01007252,All HRPs aged 16 and over,315,218,176,20,156,38,4,97,78,2,8,4,5
S01007252,Owned: Total,221,157,126,13,113,31,0,64,62,0,0,1,1
S01007252,Owned: Owned outright,109,51,40,8,32,11,0,58,57,0,0,1,0
S01007252,Owned: Owned with a mortgage or loan or shared ownership,112,106,86,5,81,20,0,6,5,0,0,0,1
S01007252,Rented or living rent free: Total,94,61,50,7,43,7,4,33,16,2,8,3,4
S01007252,Rented or living rent free: Social rented,52,34,26,5,21,4,4,18,10,1,2,3,2
S01007252,Rented or living rent free: Private rented or living rent free,42,27,24,2,22,3,0,15,6,1,6,0,2
S01007253,All HRPs aged 16 and over,358,215,178,21,157,30,7,143,130,1,3,7,2
S01007253,Owned: Total,298,182,153,19,134,28,1,116,109,1,1,3,2
S01007253,Owned: Owned outright,168,62,50,13,37,11,1,106,102,0,0,3,1
S01007253,Owned: Owned with a mortgage or loan or shared ownership,130,120,103,6,97,17,0,10,7,1,1,0,1
S01007253,Rented or living rent free: Total,60,33,25,2,23,2,6,27,21,0,2,4,0
S01007253,Rented or living rent free: Social rented,31,17,13,1,12,0,4,14,9,0,2,3,0
S01007253,Rented or living rent free: Private rented or living rent free,29,16,12,1,11,2,2,13,12,0,0,1,0
S01007254,All HRPs aged 16 and over,401,224,187,38,149,20,17,177,141,3,7,16,10
S01007254,Owned: Total,164,114,98,13,85,14,2,50,47,0,0,2,1
S01007254,Owned: Owned outright,68,27,21,4,17,5,1,41,39,0,0,2,0
S01007254,Owned: Owned with a mortgage or loan or shared ownership,96,87,77,9,68,9,1,9,8,0,0,0,1
S01007254,Rented or living rent free: Total,237,110,89,25,64,6,15,127,94,3,7,14,9
S01007254,Rented or living rent free: Social rented,181,65,53,19,34,2,10,116,90,2,5,13,6
S01007254,Rented or living rent free: Private rented or living rent free,56,45,36,6,30,4,5,11,4,1,2,1,3
S01007255,All HRPs aged 16 and over,374,253,199,48,151,17,37,121,84,1,9,19,8
S01007255,Owned: Total,128,94,80,12,68,10,4,34,34,0,0,0,0
S01007255,Owned: Owned outright,52,23,20,6,14,2,1,29,29,0,0,0,0
S01007255,Owned: Owned with a mortgage or loan or shared ownership,76,71,60,6,54,8,3,5,5,0,0,0,0
S01007255,Rented or living rent free: Total,246,159,119,36,83,7,33,87,50,1,9,19,8
S01007255,Rented or living rent free: Social rented,215,137,99,31,68,6,32,78,44,1,8,17,8
S01007255,Rented or living rent free: Private rented or living rent free,31,22,20,5,15,1,1,9,6,0,1,2,0
S01007256,All HRPs aged 16 and over,407,268,222,32,190,27,19,139,109,6,8,9,7
S01007256,Owned: Total,190,128,106,14,92,20,2,62,59,0,1,2,0
S01007256,Owned: Owned outright,88,33,23,6,17,9,1,55,53,0,1,1,0
S01007256,Owned: Owned with a mortgage or loan or shared ownership,102,95,83,8,75,11,1,7,6,0,0,1,0
S01007256,Rented or living rent free: Total,217,140,116,18,98,7,17,77,50,6,7,7,7
S01007256,Rented or living rent free: Social rented,137,75,60,9,51,5,10,62,43,4,5,5,5
S01007256,Rented or living rent free: Private rented or living rent free,80,65,56,9,47,2,7,15,7,2,2,2,2
S01007257,All HRPs aged 16 and over,296,201,159,32,127,22,20,95,58,7,7,15,8
S01007257,Owned: Total,114,78,63,7,56,14,1,36,34,1,1,0,0
S01007257,Owned: Owned outright,54,19,15,4,11,4,0,35,34,0,1,0,0
S01007257,Owned: Owned with a mortgage or loan or shared ownership,60,59,48,3,45,10,1,1,0,1,0,0,0
S01007257,Rented or living rent free: Total,182,123,96,25,71,8,19,59,24,6,6,15,8
S01007257,Rented or living rent free: Social rented,130,80,63,21,42,1,16,50,21,3,3,15,8
S01007257,Rented or living rent free: Private rented or living rent free,52,43,33,4,29,7,3,9,3,3,3,0,0
S01007258,All HRPs aged 16 and over,410,230,186,28,158,36,8,180,133,3,13,24,7
S01007258,Owned: Total,209,139,114,14,100,25,0,70,62,0,3,2,3
S01007258,Owned: Owned outright,107,42,31,5,26,11,0,65,60,0,1,1,3
S01007258,Owned: Owned with a mortgage or loan or shared ownership,102,97,83,9,74,14,0,5,2,0,2,1,0
S01007258,Rented or living rent free: Total,201,91,72,14,58,11,8,110,71,3,10,22,4
S01007258,Rented or living rent free: Social rented,150,58,47,14,33,3,8,92,60,2,10,17,3
S01007258,Rented or living rent free: Private rented or living rent free,51,33,25,0,25,8,0,18,11,1,0,5,1
S01007259,All HRPs aged 16 and over,414,241,203,34,169,22,16,173,131,1,4,32,5
S01007259,Owned: Total,207,136,118,15,103,14,4,71,65,0,1,3,2
S01007259,Owned: Owned outright,96,32,23,6,17,6,3,64,60,0,1,3,0
S01007259,Owned: Owned with a mortgage or loan or shared ownership,111,104,95,9,86,8,1,7,5,0,0,0,2
S01007259,Rented or living rent free: Total,207,105,85,19,66,8,12,102,66,1,3,29,3
S01007259,Rented or living rent free: Social rented,150,65,55,16,39,3,7,85,55,0,3,25,2
S01007259,Rented or living rent free: Private rented or living rent free,57,40,30,3,27,5,5,17,11,1,0,4,1
S01007260,All HRPs aged 16 and over,418,286,228,46,182,23,35,132,76,4,12,25,15
S01007260,Owned: Total,181,138,120,10,110,18,0,43,43,0,0,0,0
S01007260,Owned: Owned outright,69,36,27,6,21,9,0,33,33,0,0,0,0
S01007260,Owned: Owned with a mortgage or loan or shared ownership,112,102,93,4,89,9,0,10,10,0,0,0,0
S01007260,Rented or living rent free: Total,237,148,108,36,72,5,35,89,33,4,12,25,15
S01007260,Rented or living rent free: Social rented,210,131,94,29,65,4,33,79,28,3,11,23,14
S01007260,Rented or living rent free: Private rented or living rent free,27,17,14,7,7,1,2,10,5,1,1,2,1
S01007261,All HRPs aged 16 and over,356,203,167,16,151,30,6,153,138,0,1,11,3
S01007261,Owned: Total,285,166,140,14,126,26,0,119,117,0,0,1,1
S01007261,Owned: Owned outright,164,51,41,7,34,10,0,113,111,0,0,1,1
S01007261,Owned: Owned with a mortgage or loan or shared ownership,121,115,99,7,92,16,0,6,6,0,0,0,0
S01007261,Rented or living rent free: Total,71,37,27,2,25,4,6,34,21,0,1,10,2
S01007261,Rented or living rent free: Social rented,56,30,21,2,19,3,6,26,15,0,1,8,2
S01007261,Rented or living rent free: Private rented or living rent free,15,7,6,0,6,1,0,8,6,0,0,2,0
S01007262,All HRPs aged 16 and over,301,192,173,25,148,7,12,109,87,1,1,16,4
S01007262,Owned: Total,197,136,127,12,115,7,2,61,60,1,0,0,0
S01007262,Owned: Owned outright,86,29,27,8,19,2,0,57,57,0,0,0,0
S01007262,Owned: Owned with a mortgage or loan or shared ownership,111,107,100,4,96,5,2,4,3,1,0,0,0
S01007262,Rented or living rent free: Total,104,56,46,13,33,0,10,48,27,0,1,16,4
S01007262,Rented or living rent free: Social rented,83,42,33,10,23,0,9,41,22,0,1,15,3
S01007262,Rented or living rent free: Private rented or living rent free,21,14,13,3,10,0,1,7,5,0,0,1,1
S01007263,All HRPs aged 16 and over,366,222,196,30,166,14,12,144,127,3,5,4,5
S01007263,Owned: Total,245,156,139,20,119,11,6,89,86,0,0,0,3
S01007263,Owned: Owned outright,131,54,46,12,34,8,0,77,74,0,0,0,3
S01007263,Owned: Owned with a mortgage or loan or shared ownership,114,102,93,8,85,3,6,12,12,0,0,0,0
S01007263,Rented or living rent free: Total,121,66,57,10,47,3,6,55,41,3,5,4,2
S01007263,Rented or living rent free: Social rented,100,55,47,8,39,2,6,45,34,1,5,4,1
S01007263,Rented or living rent free: Private rented or living rent free,21,11,10,2,8,1,0,10,7,2,0,0,1
S01007264,All HRPs aged 16 and over,339,195,171,14,157,19,5,144,129,0,3,7,5
S01007264,Owned: Total,235,150,135,10,125,15,0,85,83,0,0,1,1
S01007264,Owned: Owned outright,122,48,41,3,38,7,0,74,73,0,0,1,0
S01007264,Owned: Owned with a mortgage or loan or shared ownership,113,102,94,7,87,8,0,11,10,0,0,0,1
S01007264,Rented or living rent free: Total,104,45,36,4,32,4,5,59,46,0,3,6,4
S01007264,Rented or living rent free: Social rented,91,38,30,4,26,4,4,53,41,0,3,5,4
S01007264,Rented or living rent free: Private rented or living rent free,13,7,6,0,6,0,1,6,5,0,0,1,0
S01007265,All HRPs aged 16 and over,472,298,257,33,224,27,14,174,128,1,8,31,6
S01007265,Owned: Total,255,197,176,17,159,21,0,58,54,1,1,1,1
S01007265,Owned: Owned outright,97,43,38,4,34,5,0,54,51,1,0,1,1
S01007265,Owned: Owned with a mortgage or loan or shared ownership,158,154,138,13,125,16,0,4,3,0,1,0,0
S01007265,Rented or living rent free: Total,217,101,81,16,65,6,14,116,74,0,7,30,5
S01007265,Rented or living rent free: Social rented,182,74,57,14,43,4,13,108,69,0,6,28,5
S01007265,Rented or living rent free: Private rented or living rent free,35,27,24,2,22,2,1,8,5,0,1,2,0
S01007266,All HRPs aged 16 and over,305,203,172,24,148,25,6,102,89,0,3,10,0
S01007266,Owned: Total,186,130,115,10,105,15,0,56,56,0,0,0,0
S01007266,Owned: Owned outright,96,48,40,6,34,8,0,48,48,0,0,0,0
S01007266,Owned: Owned with a mortgage or loan or shared ownership,90,82,75,4,71,7,0,8,8,0,0,0,0
S01007266,Rented or living rent free: Total,119,73,57,14,43,10,6,46,33,0,3,10,0
S01007266,Rented or living rent free: Social rented,68,34,29,10,19,2,3,34,24,0,2,8,0
S01007266,Rented or living rent free: Private rented or living rent free,51,39,28,4,24,8,3,12,9,0,1,2,0
S01007267,All HRPs aged 16 and over,222,171,113,12,101,55,3,51,46,0,1,4,0
S01007267,Owned: Total,116,85,52,5,47,33,0,31,31,0,0,0,0
S01007267,Owned: Owned outright,74,45,26,5,21,19,0,29,29,0,0,0,0
S01007267,Owned: Owned with a mortgage or loan or shared ownership,42,40,26,0,26,14,0,2,2,0,0,0,0
S01007267,Rented or living rent free: Total,106,86,61,7,54,22,3,20,15,0,1,4,0
S01007267,Rented or living rent free: Social rented,14,10,7,1,6,1,2,4,3,0,1,0,0
S01007267,Rented or living rent free: Private rented or living rent free,92,76,54,6,48,21,1,16,12,0,0,4,0
S01007268,All HRPs aged 16 and over,249,184,117,16,101,61,6,65,57,1,2,5,0
S01007268,Owned: Total,145,105,66,7,59,39,0,40,36,0,1,3,0
S01007268,Owned: Owned outright,95,57,35,4,31,22,0,38,35,0,0,3,0
S01007268,Owned: Owned with a mortgage or loan or shared ownership,50,48,31,3,28,17,0,2,1,0,1,0,0
S01007268,Rented or living rent free: Total,104,79,51,9,42,22,6,25,21,1,1,2,0
S01007268,Rented or living rent free: Social rented,6,4,2,0,2,1,1,2,1,1,0,0,0
S01007268,Rented or living rent free: Private rented or living rent free,98,75,49,9,40,21,5,23,20,0,1,2,0
S01007269,All HRPs aged 16 and over,224,133,101,13,88,31,1,91,77,4,5,5,0
S01007269,Owned: Total,180,114,85,12,73,29,0,66,63,0,1,2,0
S01007269,Owned: Owned outright,101,42,28,8,20,14,0,59,57,0,0,2,0
S01007269,Owned: Owned with a mortgage or loan or shared ownership,79,72,57,4,53,15,0,7,6,0,1,0,0
S01007269,Rented or living rent free: Total,44,19,16,1,15,2,1,25,14,4,4,3,0
S01007269,Rented or living rent free: Social rented,24,9,8,1,7,0,1,15,7,2,3,3,0
S01007269,Rented or living rent free: Private rented or living rent free,20,10,8,0,8,2,0,10,7,2,1,0,0
S01007270,All HRPs aged 16 and over,205,153,95,8,87,56,2,52,50,0,0,0,2
S01007270,Owned: Total,110,80,47,2,45,32,1,30,29,0,0,0,1
S01007270,Owned: Owned outright,63,37,18,1,17,19,0,26,25,0,0,0,1
S01007270,Owned: Owned with a mortgage or loan or shared ownership,47,43,29,1,28,13,1,4,4,0,0,0,0
S01007270,Rented or living rent free: Total,95,73,48,6,42,24,1,22,21,0,0,0,1
S01007270,Rented or living rent free: Social rented,15,8,7,1,6,1,0,7,7,0,0,0,0
S01007270,Rented or living rent free: Private rented or living rent free,80,65,41,5,36,23,1,15,14,0,0,0,1
S01007271,All HRPs aged 16 and over,448,299,235,27,208,51,13,149,134,1,5,6,3
S01007271,Owned: Total,333,225,179,12,167,45,1,108,101,1,2,3,1
S01007271,Owned: Owned outright,176,79,53,8,45,25,1,97,92,1,2,2,0
S01007271,Owned: Owned with a mortgage or loan or shared ownership,157,146,126,4,122,20,0,11,9,0,0,1,1
S01007271,Rented or living rent free: Total,115,74,56,15,41,6,12,41,33,0,3,3,2
S01007271,Rented or living rent free: Social rented,54,26,16,6,10,2,8,28,24,0,2,1,1
S01007271,Rented or living rent free: Private rented or living rent free,61,48,40,9,31,4,4,13,9,0,1,2,1
S01007272,All HRPs aged 16 and over,417,257,210,34,176,25,22,160,114,2,16,15,13
S01007272,Owned: Total,164,113,96,9,87,15,2,51,47,0,0,3,1
S01007272,Owned: Owned outright,77,33,28,4,24,4,1,44,44,0,0,0,0
S01007272,Owned: Owned with a mortgage or loan or shared ownership,87,80,68,5,63,11,1,7,3,0,0,3,1
S01007272,Rented or living rent free: Total,253,144,114,25,89,10,20,109,67,2,16,12,12
S01007272,Rented or living rent free: Social rented,229,125,101,25,76,6,18,104,64,2,15,11,12
S01007272,Rented or living rent free: Private rented or living rent free,24,19,13,0,13,4,2,5,3,0,1,1,0
S01007273,All HRPs aged 16 and over,296,191,153,16,137,29,9,105,84,5,5,8,3
S01007273,Owned: Total,201,126,102,11,91,22,2,75,71,0,1,2,1
S01007273,Owned: Owned outright,110,40,26,5,21,13,1,70,66,0,1,2,1
S01007273,Owned: Owned with a mortgage or loan or shared ownership,91,86,76,6,70,9,1,5,5,0,0,0,0
S01007273,Rented or living rent free: Total,95,65,51,5,46,7,7,30,13,5,4,6,2
S01007273,Rented or living rent free: Social rented,62,45,35,3,32,4,6,17,9,3,1,4,0
S01007273,Rented or living rent free: Private rented or living rent free,33,20,16,2,14,3,1,13,4,2,3,2,2
S01007274,All HRPs aged 16 and over,456,259,213,31,182,36,10,197,170,0,2,17,8
S01007274,Owned: Total,210,143,118,17,101,25,0,67,63,0,0,1,3
S01007274,Owned: Owned outright,104,44,31,6,25,13,0,60,56,0,0,1,3
S01007274,Owned: Owned with a mortgage or loan or shared ownership,106,99,87,11,76,12,0,7,7,0,0,0,0
S01007274,Rented or living rent free: Total,246,116,95,14,81,11,10,130,107,0,2,16,5
S01007274,Rented or living rent free: Social rented,146,42,34,5,29,4,4,104,92,0,2,10,0
S01007274,Rented or living rent free: Private rented or living rent free,100,74,61,9,52,7,6,26,15,0,0,6,5
S01007275,All HRPs aged 16 and over,243,148,121,21,100,23,4,95,84,2,0,6,3
S01007275,Owned: Total,188,116,93,12,81,20,3,72,69,1,0,0,2
S01007275,Owned: Owned outright,110,41,31,9,22,8,2,69,66,1,0,0,2
S01007275,Owned: Owned with a mortgage or loan or shared ownership,78,75,62,3,59,12,1,3,3,0,0,0,0
S01007275,Rented or living rent free: Total,55,32,28,9,19,3,1,23,15,1,0,6,1
S01007275,Rented or living rent free: Social rented,41,22,19,6,13,2,1,19,12,1,0,6,0
S01007275,Rented or living rent free: Private rented or living rent free,14,10,9,3,6,1,0,4,3,0,0,0,1
S01007276,All HRPs aged 16 and over,369,237,194,22,172,32,11,132,106,2,13,8,3
S01007276,Owned: Total,264,171,144,6,138,25,2,93,87,1,3,1,1
S01007276,Owned: Owned outright,128,46,35,2,33,10,1,82,81,0,1,0,0
S01007276,Owned: Owned with a mortgage or loan or shared ownership,136,125,109,4,105,15,1,11,6,1,2,1,1
S01007276,Rented or living rent free: Total,105,66,50,16,34,7,9,39,19,1,10,7,2
S01007276,Rented or living rent free: Social rented,75,47,35,11,24,5,7,28,13,1,7,5,2
S01007276,Rented or living rent free: Private rented or living rent free,30,19,15,5,10,2,2,11,6,0,3,2,0
S01007277,All HRPs aged 16 and over,327,201,168,28,140,31,2,126,122,0,1,2,1
S01007277,Owned: Total,283,176,146,17,129,29,1,107,105,0,1,0,1
S01007277,Owned: Owned outright,161,62,47,14,33,14,1,99,98,0,0,0,1
S01007277,Owned: Owned with a mortgage or loan or shared ownership,122,114,99,3,96,15,0,8,7,0,1,0,0
S01007277,Rented or living rent free: Total,44,25,22,11,11,2,1,19,17,0,0,2,0
S01007277,Rented or living rent free: Social rented,25,15,14,9,5,0,1,10,8,0,0,2,0
S01007277,Rented or living rent free: Private rented or living rent free,19,10,8,2,6,2,0,9,9,0,0,0,0
S01007278,All HRPs aged 16 and over,227,150,123,19,104,25,2,77,74,0,1,2,0
S01007278,Owned: Total,213,141,115,17,98,24,2,72,72,0,0,0,0
S01007278,Owned: Owned outright,111,46,37,10,27,8,1,65,65,0,0,0,0
S01007278,Owned: Owned with a mortgage or loan or shared ownership,102,95,78,7,71,16,1,7,7,0,0,0,0
S01007278,Rented or living rent free: Total,14,9,8,2,6,1,0,5,2,0,1,2,0
S01007278,Rented or living rent free: Social rented,3,2,2,1,1,0,0,1,0,0,0,1,0
S01007278,Rented or living rent free: Private rented or living rent free,11,7,6,1,5,1,0,4,2,0,1,1,0
S01007279,All HRPs aged 16 and over,240,173,106,18,88,64,3,67,63,0,2,1,1
S01007279,Owned: Total,158,110,57,8,49,52,1,48,46,0,1,0,1
S01007279,Owned: Owned outright,109,63,32,6,26,30,1,46,44,0,1,0,1
S01007279,Owned: Owned with a mortgage or loan or shared ownership,49,47,25,2,23,22,0,2,2,0,0,0,0
S01007279,Rented or living rent free: Total,82,63,49,10,39,12,2,19,17,0,1,1,0
S01007279,Rented or living rent free: Social rented,8,4,3,2,1,0,1,4,3,0,0,1,0
S01007279,Rented or living rent free: Private rented or living rent free,74,59,46,8,38,12,1,15,14,0,1,0,0
S01007280,All HRPs aged 16 and over,237,186,122,21,101,56,8,51,43,0,3,3,2
S01007280,Owned: Total,109,81,45,8,37,35,1,28,26,0,1,0,1
S01007280,Owned: Owned outright,62,34,15,6,9,19,0,28,26,0,1,0,1
S01007280,Owned: Owned with a mortgage or loan or shared ownership,47,47,30,2,28,16,1,0,0,0,0,0,0
S01007280,Rented or living rent free: Total,128,105,77,13,64,21,7,23,17,0,2,3,1
S01007280,Rented or living rent free: Social rented,12,7,7,1,6,0,0,5,3,0,0,2,0
S01007280,Rented or living rent free: Private rented or living rent free,116,98,70,12,58,21,7,18,14,0,2,1,1
S01007281,All HRPs aged 16 and over,361,284,206,24,182,74,4,77,66,0,1,8,2
S01007281,Owned: Total,248,187,135,17,118,51,1,61,54,0,0,5,2
S01007281,Owned: Owned outright,133,79,46,9,37,32,1,54,48,0,0,4,2
S01007281,Owned: Owned with a mortgage or loan or shared ownership,115,108,89,8,81,19,0,7,6,0,0,1,0
S01007281,Rented or living rent free: Total,113,97,71,7,64,23,3,16,12,0,1,3,0
S01007281,Rented or living rent free: Social rented,13,7,3,1,2,1,3,6,5,0,0,1,0
S01007281,Rented or living rent free: Private rented or living rent free,100,90,68,6,62,22,0,10,7,0,1,2,0
S01007282,All HRPs aged 16 and over,228,175,115,14,101,57,3,53,42,1,3,5,2
S01007282,Owned: Total,96,75,39,1,38,36,0,21,18,1,1,0,1
S01007282,Owned: Owned outright,44,26,9,1,8,17,0,18,15,1,1,0,1
S01007282,Owned: Owned with a mortgage or loan or shared ownership,52,49,30,0,30,19,0,3,3,0,0,0,0
S01007282,Rented or living rent free: Total,132,100,76,13,63,21,3,32,24,0,2,5,1
S01007282,Rented or living rent free: Social rented,18,11,8,4,4,2,1,7,3,0,0,3,1
S01007282,Rented or living rent free: Private rented or living rent free,114,89,68,9,59,19,2,25,21,0,2,2,0
S01007283,All HRPs aged 16 and over,482,240,182,26,156,54,4,242,225,0,2,11,4
S01007283,Owned: Total,324,171,121,11,110,50,0,153,150,0,0,2,1
S01007283,Owned: Owned outright,198,57,35,5,30,22,0,141,140,0,0,0,1
S01007283,Owned: Owned with a mortgage or loan or shared ownership,126,114,86,6,80,28,0,12,10,0,0,2,0
S01007283,Rented or living rent free: Total,158,69,61,15,46,4,4,89,75,0,2,9,3
S01007283,Rented or living rent free: Social rented,92,25,23,9,14,0,2,67,58,0,0,6,3
S01007283,Rented or living rent free: Private rented or living rent free,66,44,38,6,32,4,2,22,17,0,2,3,0
S01007284,All HRPs aged 16 and over,403,262,169,50,119,89,4,141,119,1,4,9,8
S01007284,Owned: Total,284,186,110,28,82,75,1,98,91,0,2,2,3
S01007284,Owned: Owned outright,207,114,61,20,41,52,1,93,87,0,2,1,3
S01007284,Owned: Owned with a mortgage or loan or shared ownership,77,72,49,8,41,23,0,5,4,0,0,1,0
S01007284,Rented or living rent free: Total,119,76,59,22,37,14,3,43,28,1,2,7,5
S01007284,Rented or living rent free: Social rented,58,33,26,15,11,6,1,25,12,1,1,6,5
S01007284,Rented or living rent free: Private rented or living rent free,61,43,33,7,26,8,2,18,16,0,1,1,0
S01007285,All HRPs aged 16 and over,358,236,126,30,96,105,5,122,111,0,2,4,5
S01007285,Owned: Total,259,163,76,16,60,84,3,96,91,0,1,1,3
S01007285,Owned: Owned outright,171,81,33,7,26,46,2,90,87,0,1,0,2
S01007285,Owned: Owned with a mortgage or loan or shared ownership,88,82,43,9,34,38,1,6,4,0,0,1,1
S01007285,Rented or living rent free: Total,99,73,50,14,36,21,2,26,20,0,1,3,2
S01007285,Rented or living rent free: Social rented,40,25,20,8,12,4,1,15,13,0,1,0,1
S01007285,Rented or living rent free: Private rented or living rent free,59,48,30,6,24,17,1,11,7,0,0,3,1
S01007286,All HRPs aged 16 and over,460,305,203,33,170,93,9,155,127,0,12,13,3
S01007286,Owned: Total,278,182,108,20,88,72,2,96,88,0,2,5,1
S01007286,Owned: Owned outright,164,78,43,13,30,33,2,86,80,0,2,3,1
S01007286,Owned: Owned with a mortgage or loan or shared ownership,114,104,65,7,58,39,0,10,8,0,0,2,0
S01007286,Rented or living rent free: Total,182,123,95,13,82,21,7,59,39,0,10,8,2
S01007286,Rented or living rent free: Social rented,93,58,49,12,37,4,5,35,27,0,2,4,2
S01007286,Rented or living rent free: Private rented or living rent free,89,65,46,1,45,17,2,24,12,0,8,4,0
S01007287,All HRPs aged 16 and over,281,189,100,14,86,81,8,92,83,1,1,5,2
S01007287,Owned: Total,182,113,54,9,45,55,4,69,66,0,0,2,1
S01007287,Owned: Owned outright,127,67,30,8,22,33,4,60,57,0,0,2,1
S01007287,Owned: Owned with a mortgage or loan or shared ownership,55,46,24,1,23,22,0,9,9,0,0,0,0
S01007287,Rented or living rent free: Total,99,76,46,5,41,26,4,23,17,1,1,3,1
S01007287,Rented or living rent free: Social rented,42,25,15,4,11,7,3,17,12,1,1,2,1
S01007287,Rented or living rent free: Private rented or living rent free,57,51,31,1,30,19,1,6,5,0,0,1,0
S01007288,All HRPs aged 16 and over,252,170,92,11,81,73,5,82,81,0,0,1,0
S01007288,Owned: Total,166,100,53,7,46,47,0,66,65,0,0,1,0
S01007288,Owned: Owned outright,109,55,28,3,25,27,0,54,54,0,0,0,0
S01007288,Owned: Owned with a mortgage or loan or shared ownership,57,45,25,4,21,20,0,12,11,0,0,1,0
S01007288,Rented or living rent free: Total,86,70,39,4,35,26,5,16,16,0,0,0,0
S01007288,Rented or living rent free: Social rented,14,11,8,0,8,2,1,3,3,0,0,0,0
S01007288,Rented or living rent free: Private rented or living rent free,72,59,31,4,27,24,4,13,13,0,0,0,0
S01007289,All HRPs aged 16 and over,323,222,168,26,142,53,1,101,90,0,1,8,2
S01007289,Owned: Total,284,195,149,24,125,46,0,89,85,0,0,3,1
S01007289,Owned: Owned outright,162,80,57,21,36,23,0,82,79,0,0,2,1
S01007289,Owned: Owned with a mortgage or loan or shared ownership,122,115,92,3,89,23,0,7,6,0,0,1,0
S01007289,Rented or living rent free: Total,39,27,19,2,17,7,1,12,5,0,1,5,1
S01007289,Rented or living rent free: Social rented,10,3,2,0,2,1,0,7,3,0,1,3,0
S01007289,Rented or living rent free: Private rented or living rent free,29,24,17,2,15,6,1,5,2,0,0,2,1
S01007290,All HRPs aged 16 and over,276,219,170,33,137,38,11,57,17,1,17,16,6
S01007290,Owned: Total,120,106,89,10,79,17,0,14,9,0,2,2,1
S01007290,Owned: Owned outright,28,18,15,7,8,3,0,10,8,0,0,1,1
S01007290,Owned: Owned with a mortgage or loan or shared ownership,92,88,74,3,71,14,0,4,1,0,2,1,0
S01007290,Rented or living rent free: Total,156,113,81,23,58,21,11,43,8,1,15,14,5
S01007290,Rented or living rent free: Social rented,131,90,65,21,44,15,10,41,6,1,15,14,5
S01007290,Rented or living rent free: Private rented or living rent free,25,23,16,2,14,6,1,2,2,0,0,0,0
S01007291,All HRPs aged 16 and over,329,186,148,38,110,31,7,143,108,3,4,20,8
S01007291,Owned: Total,175,122,93,17,76,28,1,53,46,0,2,2,3
S01007291,Owned: Owned outright,75,32,20,11,9,11,1,43,40,0,0,2,1
S01007291,Owned: Owned with a mortgage or loan or shared ownership,100,90,73,6,67,17,0,10,6,0,2,0,2
S01007291,Rented or living rent free: Total,154,64,55,21,34,3,6,90,62,3,2,18,5
S01007291,Rented or living rent free: Social rented,108,30,25,10,15,0,5,78,52,2,2,17,5
S01007291,Rented or living rent free: Private rented or living rent free,46,34,30,11,19,3,1,12,10,1,0,1,0
S01007292,All HRPs aged 16 and over,320,237,190,31,159,45,2,83,76,0,3,3,1
S01007292,Owned: Total,265,194,153,21,132,40,1,71,70,0,1,0,0
S01007292,Owned: Owned outright,131,68,53,14,39,14,1,63,62,0,1,0,0
S01007292,Owned: Owned with a mortgage or loan or shared ownership,134,126,100,7,93,26,0,8,8,0,0,0,0
S01007292,Rented or living rent free: Total,55,43,37,10,27,5,1,12,6,0,2,3,1
S01007292,Rented or living rent free: Social rented,31,23,20,8,12,2,1,8,4,0,2,2,0
S01007292,Rented or living rent free: Private rented or living rent free,24,20,17,2,15,3,0,4,2,0,0,1,1
S01007293,All HRPs aged 16 and over,310,247,211,66,145,20,16,63,40,1,10,5,7
S01007293,Owned: Total,150,120,108,25,83,12,0,30,25,0,1,2,2
S01007293,Owned: Owned outright,49,28,26,13,13,2,0,21,19,0,0,1,1
S01007293,Owned: Owned with a mortgage or loan or shared ownership,101,92,82,12,70,10,0,9,6,0,1,1,1
S01007293,Rented or living rent free: Total,160,127,103,41,62,8,16,33,15,1,9,3,5
S01007293,Rented or living rent free: Social rented,140,111,88,39,49,8,15,29,12,1,9,2,5
S01007293,Rented or living rent free: Private rented or living rent free,20,16,15,2,13,0,1,4,3,0,0,1,0
S01007294,All HRPs aged 16 and over,378,247,192,37,155,52,3,131,101,6,8,13,3
S01007294,Owned: Total,271,184,146,23,123,37,1,87,79,4,2,2,0
S01007294,Owned: Owned outright,124,50,39,11,28,10,1,74,71,1,1,1,0
S01007294,Owned: Owned with a mortgage or loan or shared ownership,147,134,107,12,95,27,0,13,8,3,1,1,0
S01007294,Rented or living rent free: Total,107,63,46,14,32,15,2,44,22,2,6,11,3
S01007294,Rented or living rent free: Social rented,66,33,25,12,13,7,1,33,17,1,3,10,2
S01007294,Rented or living rent free: Private rented or living rent free,41,30,21,2,19,8,1,11,5,1,3,1,1
S01007295,All HRPs aged 16 and over,307,163,132,27,105,18,13,144,98,2,6,28,10
S01007295,Owned: Total,67,51,43,5,38,8,0,16,14,0,0,2,0
S01007295,Owned: Owned outright,24,11,9,2,7,2,0,13,13,0,0,0,0
S01007295,Owned: Owned with a mortgage or loan or shared ownership,43,40,34,3,31,6,0,3,1,0,0,2,0
S01007295,Rented or living rent free: Total,240,112,89,22,67,10,13,128,84,2,6,26,10
S01007295,Rented or living rent free: Social rented,200,76,57,15,42,7,12,124,81,2,6,25,10
S01007295,Rented or living rent free: Private rented or living rent free,40,36,32,7,25,3,1,4,3,0,0,1,0
S01007296,All HRPs aged 16 and over,354,238,189,26,163,37,12,116,90,5,5,10,6
S01007296,Owned: Total,180,113,87,9,78,21,5,67,58,4,0,0,5
S01007296,Owned: Owned outright,92,34,20,3,17,9,5,58,53,0,0,0,5
S01007296,Owned: Owned with a mortgage or loan or shared ownership,88,79,67,6,61,12,0,9,5,4,0,0,0
S01007296,Rented or living rent free: Total,174,125,102,17,85,16,7,49,32,1,5,10,1
S01007296,Rented or living rent free: Social rented,73,39,31,10,21,4,4,34,22,0,3,8,1
S01007296,Rented or living rent free: Private rented or living rent free,101,86,71,7,64,12,3,15,10,1,2,2,0
S01007297,All HRPs aged 16 and over,444,321,246,34,212,64,11,123,102,4,4,7,6
S01007297,Owned: Total,307,212,157,21,136,51,4,95,87,0,3,3,2
S01007297,Owned: Owned outright,165,78,53,16,37,22,3,87,82,0,1,2,2
S01007297,Owned: Owned with a mortgage or loan or shared ownership,142,134,104,5,99,29,1,8,5,0,2,1,0
S01007297,Rented or living rent free: Total,137,109,89,13,76,13,7,28,15,4,1,4,4
S01007297,Rented or living rent free: Social rented,25,10,7,5,2,0,3,15,7,0,1,3,4
S01007297,Rented or living rent free: Private rented or living rent free,112,99,82,8,74,13,4,13,8,4,0,1,0
S01007298,All HRPs aged 16 and over,244,161,128,25,103,28,5,83,75,3,1,2,2
S01007298,Owned: Total,166,109,88,13,75,19,2,57,54,0,0,1,2
S01007298,Owned: Owned outright,83,34,26,7,19,7,1,49,46,0,0,1,2
S01007298,Owned: Owned with a mortgage or loan or shared ownership,83,75,62,6,56,12,1,8,8,0,0,0,0
S01007298,Rented or living rent free: Total,78,52,40,12,28,9,3,26,21,3,1,1,0
S01007298,Rented or living rent free: Social rented,55,36,27,10,17,6,3,19,18,0,0,1,0
S01007298,Rented or living rent free: Private rented or living rent free,23,16,13,2,11,3,0,7,3,3,1,0,0
S01007299,All HRPs aged 16 and over,387,273,210,44,166,47,16,114,91,8,4,7,4
S01007299,Owned: Total,218,151,115,21,94,33,3,67,64,1,0,1,1
S01007299,Owned: Owned outright,100,43,31,10,21,12,0,57,55,0,0,1,1
S01007299,Owned: Owned with a mortgage or loan or shared ownership,118,108,84,11,73,21,3,10,9,1,0,0,0
S01007299,Rented or living rent free: Total,169,122,95,23,72,14,13,47,27,7,4,6,3
S01007299,Rented or living rent free: Social rented,85,60,44,15,29,6,10,25,16,3,2,3,1
S01007299,Rented or living rent free: Private rented or living rent free,84,62,51,8,43,8,3,22,11,4,2,3,2
S01007300,All HRPs aged 16 and over,241,159,117,33,84,24,18,82,59,1,2,12,8
S01007300,Owned: Total,124,85,62,15,47,18,5,39,37,0,0,1,1
S01007300,Owned: Owned outright,53,23,12,7,5,9,2,30,30,0,0,0,0
S01007300,Owned: Owned with a mortgage or loan or shared ownership,71,62,50,8,42,9,3,9,7,0,0,1,1
S01007300,Rented or living rent free: Total,117,74,55,18,37,6,13,43,22,1,2,11,7
S01007300,Rented or living rent free: Social rented,99,61,45,16,29,4,12,38,18,1,2,11,6
S01007300,Rented or living rent free: Private rented or living rent free,18,13,10,2,8,2,1,5,4,0,0,0,1
S01007301,All HRPs aged 16 and over,311,195,138,18,120,55,2,116,106,0,1,4,5
S01007301,Owned: Total,236,140,97,14,83,43,0,96,92,0,0,1,3
S01007301,Owned: Owned outright,152,61,35,7,28,26,0,91,88,0,0,1,2
S01007301,Owned: Owned with a mortgage or loan or shared ownership,84,79,62,7,55,17,0,5,4,0,0,0,1
S01007301,Rented or living rent free: Total,75,55,41,4,37,12,2,20,14,0,1,3,2
S01007301,Rented or living rent free: Social rented,18,9,7,1,6,0,2,9,6,0,0,3,0
S01007301,Rented or living rent free: Private rented or living rent free,57,46,34,3,31,12,0,11,8,0,1,0,2
S01007302,All HRPs aged 16 and over,280,188,149,35,114,30,9,92,76,0,1,12,3
S01007302,Owned: Total,170,126,100,22,78,24,2,44,42,0,1,0,1
S01007302,Owned: Owned outright,76,40,28,14,14,10,2,36,34,0,1,0,1
S01007302,Owned: Owned with a mortgage or loan or shared ownership,94,86,72,8,64,14,0,8,8,0,0,0,0
S01007302,Rented or living rent free: Total,110,62,49,13,36,6,7,48,34,0,0,12,2
S01007302,Rented or living rent free: Social rented,83,39,28,7,21,4,7,44,31,0,0,11,2
S01007302,Rented or living rent free: Private rented or living rent free,27,23,21,6,15,2,0,4,3,0,0,1,0
S01007303,All HRPs aged 16 and over,366,241,164,18,146,72,5,125,110,0,9,5,1
S01007303,Owned: Total,276,183,116,14,102,65,2,93,85,0,6,2,0
S01007303,Owned: Owned outright,166,78,42,13,29,34,2,88,81,0,6,1,0
S01007303,Owned: Owned with a mortgage or loan or shared ownership,110,105,74,1,73,31,0,5,4,0,0,1,0
S01007303,Rented or living rent free: Total,90,58,48,4,44,7,3,32,25,0,3,3,1
S01007303,Rented or living rent free: Social rented,34,11,6,1,5,2,3,23,18,0,2,3,0
S01007303,Rented or living rent free: Private rented or living rent free,56,47,42,3,39,5,0,9,7,0,1,0,1
S01007304,All HRPs aged 16 and over,310,185,103,25,78,78,4,125,120,1,3,1,0
S01007304,Owned: Total,219,131,61,10,51,68,2,88,88,0,0,0,0
S01007304,Owned: Owned outright,160,77,29,8,21,47,1,83,83,0,0,0,0
S01007304,Owned: Owned with a mortgage or loan or shared ownership,59,54,32,2,30,21,1,5,5,0,0,0,0
S01007304,Rented or living rent free: Total,91,54,42,15,27,10,2,37,32,1,3,1,0
S01007304,Rented or living rent free: Social rented,29,12,10,2,8,1,1,17,14,0,2,1,0
S01007304,Rented or living rent free: Private rented or living rent free,62,42,32,13,19,9,1,20,18,1,1,0,0
S01007305,All HRPs aged 16 and over,305,213,140,18,122,71,2,92,84,0,0,6,2
S01007305,Owned: Total,229,157,100,12,88,57,0,72,70,0,0,0,2
S01007305,Owned: Owned outright,137,74,43,6,37,31,0,63,63,0,0,0,0
S01007305,Owned: Owned with a mortgage or loan or shared ownership,92,83,57,6,51,26,0,9,7,0,0,0,2
S01007305,Rented or living rent free: Total,76,56,40,6,34,14,2,20,14,0,0,6,0
S01007305,Rented or living rent free: Social rented,39,25,18,4,14,5,2,14,8,0,0,6,0
S01007305,Rented or living rent free: Private rented or living rent free,37,31,22,2,20,9,0,6,6,0,0,0,0
S01007306,All HRPs aged 16 and over,342,234,166,34,132,58,10,108,91,4,4,7,2
S01007306,Owned: Total,231,154,107,17,90,45,2,77,70,2,2,1,2
S01007306,Owned: Owned outright,129,59,37,9,28,20,2,70,65,2,0,1,2
S01007306,Owned: Owned with a mortgage or loan or shared ownership,102,95,70,8,62,25,0,7,5,0,2,0,0
S01007306,Rented or living rent free: Total,111,80,59,17,42,13,8,31,21,2,2,6,0
S01007306,Rented or living rent free: Social rented,69,44,34,10,24,6,4,25,16,2,2,5,0
S01007306,Rented or living rent free: Private rented or living rent free,42,36,25,7,18,7,4,6,5,0,0,1,0
S01007307,All HRPs aged 16 and over,337,236,151,24,127,84,1,101,93,0,2,4,2
S01007307,Owned: Total,255,169,109,11,98,59,1,86,82,0,1,1,2
S01007307,Owned: Owned outright,152,70,36,10,26,33,1,82,79,0,1,0,2
S01007307,Owned: Owned with a mortgage or loan or shared ownership,103,99,73,1,72,26,0,4,3,0,0,1,0
S01007307,Rented or living rent free: Total,82,67,42,13,29,25,0,15,11,0,1,3,0
S01007307,Rented or living rent free: Social rented,6,5,4,2,2,1,0,1,1,0,0,0,0
S01007307,Rented or living rent free: Private rented or living rent free,76,62,38,11,27,24,0,14,10,0,1,3,0
S01007308,All HRPs aged 16 and over,339,216,148,24,124,61,7,123,113,0,0,6,4
S01007308,Owned: Total,250,144,93,15,78,49,2,106,100,0,0,4,2
S01007308,Owned: Owned outright,173,73,40,10,30,31,2,100,95,0,0,4,1
S01007308,Owned: Owned with a mortgage or loan or shared ownership,77,71,53,5,48,18,0,6,5,0,0,0,1
S01007308,Rented or living rent free: Total,89,72,55,9,46,12,5,17,13,0,0,2,2
S01007308,Rented or living rent free: Social rented,28,17,13,4,9,1,3,11,7,0,0,2,2
S01007308,Rented or living rent free: Private rented or living rent free,61,55,42,5,37,11,2,6,6,0,0,0,0
S01007309,All HRPs aged 16 and over,277,200,136,16,120,58,6,77,69,0,2,2,4
S01007309,Owned: Total,197,135,87,8,79,45,3,62,60,0,0,0,2
S01007309,Owned: Owned outright,121,63,30,5,25,31,2,58,56,0,0,0,2
S01007309,Owned: Owned with a mortgage or loan or shared ownership,76,72,57,3,54,14,1,4,4,0,0,0,0
S01007309,Rented or living rent free: Total,80,65,49,8,41,13,3,15,9,0,2,2,2
S01007309,Rented or living rent free: Social rented,30,19,13,3,10,4,2,11,6,0,2,2,1
S01007309,Rented or living rent free: Private rented or living rent free,50,46,36,5,31,9,1,4,3,0,0,0,1
S01007310,All HRPs aged 16 and over,380,228,129,23,106,85,14,152,142,0,0,8,2
S01007310,Owned: Total,275,161,89,14,75,68,4,114,112,0,0,0,2
S01007310,Owned: Owned outright,203,92,51,13,38,39,2,111,109,0,0,0,2
S01007310,Owned: Owned with a mortgage or loan or shared ownership,72,69,38,1,37,29,2,3,3,0,0,0,0
S01007310,Rented or living rent free: Total,105,67,40,9,31,17,10,38,30,0,0,8,0
S01007310,Rented or living rent free: Social rented,34,17,10,2,8,5,2,17,11,0,0,6,0
S01007310,Rented or living rent free: Private rented or living rent free,71,50,30,7,23,12,8,21,19,0,0,2,0
S01007311,All HRPs aged 16 and over,343,246,167,24,143,69,10,97,90,0,0,6,1
S01007311,Owned: Total,178,124,80,12,68,43,1,54,52,0,0,1,1
S01007311,Owned: Owned outright,88,42,23,6,17,18,1,46,44,0,0,1,1
S01007311,Owned: Owned with a mortgage or loan or shared ownership,90,82,57,6,51,25,0,8,8,0,0,0,0
S01007311,Rented or living rent free: Total,165,122,87,12,75,26,9,43,38,0,0,5,0
S01007311,Rented or living rent free: Social rented,84,52,38,6,32,9,5,32,27,0,0,5,0
S01007311,Rented or living rent free: Private rented or living rent free,81,70,49,6,43,17,4,11,11,0,0,0,0
S01007312,All HRPs aged 16 and over,355,220,162,27,135,49,9,135,119,1,6,9,0
S01007312,Owned: Total,269,158,117,21,96,39,2,111,105,0,4,2,0
S01007312,Owned: Owned outright,177,77,54,14,40,22,1,100,99,0,1,0,0
S01007312,Owned: Owned with a mortgage or loan or shared ownership,92,81,63,7,56,17,1,11,6,0,3,2,0
S01007312,Rented or living rent free: Total,86,62,45,6,39,10,7,24,14,1,2,7,0
S01007312,Rented or living rent free: Social rented,36,24,17,4,13,2,5,12,5,0,1,6,0
S01007312,Rented or living rent free: Private rented or living rent free,50,38,28,2,26,8,2,12,9,1,1,1,0
S01007313,All HRPs aged 16 and over,436,297,176,31,145,119,2,139,132,1,1,4,1
S01007313,Owned: Total,344,238,137,27,110,99,2,106,104,0,0,1,1
S01007313,Owned: Owned outright,222,123,54,20,34,67,2,99,97,0,0,1,1
S01007313,Owned: Owned with a mortgage or loan or shared ownership,122,115,83,7,76,32,0,7,7,0,0,0,0
S01007313,Rented or living rent free: Total,92,59,39,4,35,20,0,33,28,1,1,3,0
S01007313,Rented or living rent free: Social rented,22,8,8,1,7,0,0,14,9,1,1,3,0
S01007313,Rented or living rent free: Private rented or living rent free,70,51,31,3,28,20,0,19,19,0,0,0,0
S01007314,All HRPs aged 16 and over,292,225,167,21,146,54,4,67,58,2,0,1,6
S01007314,Owned: Total,225,177,130,12,118,45,2,48,46,0,0,0,2
S01007314,Owned: Owned outright,105,64,40,6,34,23,1,41,39,0,0,0,2
S01007314,Owned: Owned with a mortgage or loan or shared ownership,120,113,90,6,84,22,1,7,7,0,0,0,0
S01007314,Rented or living rent free: Total,67,48,37,9,28,9,2,19,12,2,0,1,4
S01007314,Rented or living rent free: Social rented,30,20,14,7,7,4,2,10,7,0,0,1,2
S01007314,Rented or living rent free: Private rented or living rent free,37,28,23,2,21,5,0,9,5,2,0,0,2
S01007315,All HRPs aged 16 and over,434,301,254,27,227,36,11,133,121,0,4,5,3
S01007315,Owned: Total,326,222,192,17,175,29,1,104,101,0,0,1,2
S01007315,Owned: Owned outright,144,51,47,12,35,4,0,93,91,0,0,1,1
S01007315,Owned: Owned with a mortgage or loan or shared ownership,182,171,145,5,140,25,1,11,10,0,0,0,1
S01007315,Rented or living rent free: Total,108,79,62,10,52,7,10,29,20,0,4,4,1
S01007315,Rented or living rent free: Social rented,67,49,37,7,30,5,7,18,11,0,2,4,1
S01007315,Rented or living rent free: Private rented or living rent free,41,30,25,3,22,2,3,11,9,0,2,0,0
S01007316,All HRPs aged 16 and over,449,259,208,27,181,32,19,190,154,1,4,22,9
S01007316,Owned: Total,238,145,119,5,114,22,4,93,89,1,0,0,3
S01007316,Owned: Owned outright,128,44,38,5,33,4,2,84,81,0,0,0,3
S01007316,Owned: Owned with a mortgage or loan or shared ownership,110,101,81,0,81,18,2,9,8,1,0,0,0
S01007316,Rented or living rent free: Total,211,114,89,22,67,10,15,97,65,0,4,22,6
S01007316,Rented or living rent free: Social rented,165,78,57,19,38,9,12,87,56,0,4,21,6
S01007316,Rented or living rent free: Private rented or living rent free,46,36,32,3,29,1,3,10,9,0,0,1,0
S01007317,All HRPs aged 16 and over,266,208,176,24,152,23,9,58,48,0,5,3,2
S01007317,Owned: Total,172,140,119,12,107,19,2,32,32,0,0,0,0
S01007317,Owned: Owned outright,77,47,37,7,30,9,1,30,30,0,0,0,0
S01007317,Owned: Owned with a mortgage or loan or shared ownership,95,93,82,5,77,10,1,2,2,0,0,0,0
S01007317,Rented or living rent free: Total,94,68,57,12,45,4,7,26,16,0,5,3,2
S01007317,Rented or living rent free: Social rented,60,39,33,8,25,0,6,21,12,0,5,3,1
S01007317,Rented or living rent free: Private rented or living rent free,34,29,24,4,20,4,1,5,4,0,0,0,1
S01007318,All HRPs aged 16 and over,274,183,136,26,110,40,7,91,79,0,1,9,2
S01007318,Owned: Total,158,112,83,6,77,28,1,46,44,0,0,1,1
S01007318,Owned: Owned outright,63,27,21,4,17,6,0,36,34,0,0,1,1
S01007318,Owned: Owned with a mortgage or loan or shared ownership,95,85,62,2,60,22,1,10,10,0,0,0,0
S01007318,Rented or living rent free: Total,116,71,53,20,33,12,6,45,35,0,1,8,1
S01007318,Rented or living rent free: Social rented,94,53,43,16,27,5,5,41,32,0,1,7,1
S01007318,Rented or living rent free: Private rented or living rent free,22,18,10,4,6,7,1,4,3,0,0,1,0
S01007319,All HRPs aged 16 and over,369,237,180,19,161,44,13,132,120,2,0,9,1
S01007319,Owned: Total,236,154,123,10,113,31,0,82,81,0,0,1,0
S01007319,Owned: Owned outright,140,62,46,8,38,16,0,78,77,0,0,1,0
S01007319,Owned: Owned with a mortgage or loan or shared ownership,96,92,77,2,75,15,0,4,4,0,0,0,0
S01007319,Rented or living rent free: Total,133,83,57,9,48,13,13,50,39,2,0,8,1
S01007319,Rented or living rent free: Social rented,87,45,27,7,20,7,11,42,32,2,0,7,1
S01007319,Rented or living rent free: Private rented or living rent free,46,38,30,2,28,6,2,8,7,0,0,1,0
S01007320,All HRPs aged 16 and over,353,230,146,25,121,80,4,123,113,1,1,4,4
S01007320,Owned: Total,254,155,92,20,72,63,0,99,92,1,1,1,4
S01007320,Owned: Owned outright,174,86,45,14,31,41,0,88,83,1,0,0,4
S01007320,Owned: Owned with a mortgage or loan or shared ownership,80,69,47,6,41,22,0,11,9,0,1,1,0
S01007320,Rented or living rent free: Total,99,75,54,5,49,17,4,24,21,0,0,3,0
S01007320,Rented or living rent free: Social rented,16,7,7,1,6,0,0,9,7,0,0,2,0
S01007320,Rented or living rent free: Private rented or living rent free,83,68,47,4,43,17,4,15,14,0,0,1,0
S01007321,All HRPs aged 16 and over,271,175,107,16,91,64,4,96,86,0,1,8,1
S01007321,Owned: Total,200,130,82,14,68,46,2,70,67,0,0,3,0
S01007321,Owned: Owned outright,131,70,37,8,29,32,1,61,59,0,0,2,0
S01007321,Owned: Owned with a mortgage or loan or shared ownership,69,60,45,6,39,14,1,9,8,0,0,1,0
S01007321,Rented or living rent free: Total,71,45,25,2,23,18,2,26,19,0,1,5,1
S01007321,Rented or living rent free: Social rented,16,5,4,1,3,1,0,11,6,0,1,3,1
S01007321,Rented or living rent free: Private rented or living rent free,55,40,21,1,20,17,2,15,13,0,0,2,0
S01007322,All HRPs aged 16 and over,376,240,162,24,138,66,12,136,110,4,4,13,5
S01007322,Owned: Total,233,148,97,17,80,49,2,85,75,0,1,6,3
S01007322,Owned: Owned outright,143,69,38,12,26,30,1,74,68,0,0,4,2
S01007322,Owned: Owned with a mortgage or loan or shared ownership,90,79,59,5,54,19,1,11,7,0,1,2,1
S01007322,Rented or living rent free: Total,143,92,65,7,58,17,10,51,35,4,3,7,2
S01007322,Rented or living rent free: Social rented,102,61,43,7,36,11,7,41,29,4,2,4,2
S01007322,Rented or living rent free: Private rented or living rent free,41,31,22,0,22,6,3,10,6,0,1,3,0
S01007323,All HRPs aged 16 and over,227,150,110,14,96,35,5,77,64,1,1,6,5
S01007323,Owned: Total,164,107,78,10,68,28,1,57,51,0,1,3,2
S01007323,Owned: Owned outright,93,44,29,7,22,15,0,49,45,0,1,2,1
S01007323,Owned: Owned with a mortgage or loan or shared ownership,71,63,49,3,46,13,1,8,6,0,0,1,1
S01007323,Rented or living rent free: Total,63,43,32,4,28,7,4,20,13,1,0,3,3
S01007323,Rented or living rent free: Social rented,39,25,16,3,13,6,3,14,9,1,0,2,2
S01007323,Rented or living rent free: Private rented or living rent free,24,18,16,1,15,1,1,6,4,0,0,1,1
S01007324,All HRPs aged 16 and over,167,106,75,22,53,26,5,61,53,0,1,5,2
S01007324,Owned: Total,91,59,38,14,24,20,1,32,29,0,1,0,2
S01007324,Owned: Owned outright,73,43,28,13,15,14,1,30,28,0,1,0,1
S01007324,Owned: Owned with a mortgage or loan or shared ownership,18,16,10,1,9,6,0,2,1,0,0,0,1
S01007324,Rented or living rent free: Total,76,47,37,8,29,6,4,29,24,0,0,5,0
S01007324,Rented or living rent free: Social rented,30,17,11,4,7,4,2,13,9,0,0,4,0
S01007324,Rented or living rent free: Private rented or living rent free,46,30,26,4,22,2,2,16,15,0,0,1,0
S01007325,All HRPs aged 16 and over,393,245,154,35,119,85,6,148,137,1,2,7,1
S01007325,Owned: Total,256,146,82,22,60,62,2,110,107,1,0,1,1
S01007325,Owned: Owned outright,188,83,38,15,23,43,2,105,102,1,0,1,1
S01007325,Owned: Owned with a mortgage or loan or shared ownership,68,63,44,7,37,19,0,5,5,0,0,0,0
S01007325,Rented or living rent free: Total,137,99,72,13,59,23,4,38,30,0,2,6,0
S01007325,Rented or living rent free: Social rented,61,38,25,8,17,9,4,23,17,0,1,5,0
S01007325,Rented or living rent free: Private rented or living rent free,76,61,47,5,42,14,0,15,13,0,1,1,0
S01007326,All HRPs aged 16 and over,346,217,149,22,127,64,4,129,120,0,0,7,2
S01007326,Owned: Total,197,115,69,9,60,44,2,82,78,0,0,3,1
S01007326,Owned: Owned outright,140,66,35,6,29,30,1,74,71,0,0,2,1
S01007326,Owned: Owned with a mortgage or loan or shared ownership,57,49,34,3,31,14,1,8,7,0,0,1,0
S01007326,Rented or living rent free: Total,149,102,80,13,67,20,2,47,42,0,0,4,1
S01007326,Rented or living rent free: Social rented,45,28,26,7,19,2,0,17,13,0,0,3,1
S01007326,Rented or living rent free: Private rented or living rent free,104,74,54,6,48,18,2,30,29,0,0,1,0
S01007327,All HRPs aged 16 and over,350,217,168,30,138,41,8,133,111,3,2,14,3
S01007327,Owned: Total,194,125,92,9,83,32,1,69,65,0,1,1,2
S01007327,Owned: Owned outright,113,55,30,3,27,25,0,58,55,0,0,1,2
S01007327,Owned: Owned with a mortgage or loan or shared ownership,81,70,62,6,56,7,1,11,10,0,1,0,0
S01007327,Rented or living rent free: Total,156,92,76,21,55,9,7,64,46,3,1,13,1
S01007327,Rented or living rent free: Social rented,110,60,48,20,28,6,6,50,33,2,1,13,1
S01007327,Rented or living rent free: Private rented or living rent free,46,32,28,1,27,3,1,14,13,1,0,0,0
S01007328,All HRPs aged 16 and over,390,245,166,27,139,63,16,145,124,0,1,15,5
S01007328,Owned: Total,203,130,89,12,77,41,0,73,68,0,1,3,1
S01007328,Owned: Owned outright,109,48,30,5,25,18,0,61,59,0,0,1,1
S01007328,Owned: Owned with a mortgage or loan or shared ownership,94,82,59,7,52,23,0,12,9,0,1,2,0
S01007328,Rented or living rent free: Total,187,115,77,15,62,22,16,72,56,0,0,12,4
S01007328,Rented or living rent free: Social rented,148,88,58,13,45,16,14,60,46,0,0,10,4
S01007328,Rented or living rent free: Private rented or living rent free,39,27,19,2,17,6,2,12,10,0,0,2,0
S01007329,All HRPs aged 16 and over,314,208,125,26,99,75,8,106,94,0,4,5,3
S01007329,Owned: Total,180,115,57,8,49,57,1,65,62,0,0,1,2
S01007329,Owned: Owned outright,129,70,25,6,19,45,0,59,58,0,0,1,0
S01007329,Owned: Owned with a mortgage or loan or shared ownership,51,45,32,2,30,12,1,6,4,0,0,0,2
S01007329,Rented or living rent free: Total,134,93,68,18,50,18,7,41,32,0,4,4,1
S01007329,Rented or living rent free: Social rented,58,38,27,10,17,7,4,20,12,0,4,3,1
S01007329,Rented or living rent free: Private rented or living rent free,76,55,41,8,33,11,3,21,20,0,0,1,0
S01007330,All HRPs aged 16 and over,375,207,125,37,88,75,7,168,151,0,5,8,4
S01007330,Owned: Total,277,146,88,21,67,56,2,131,126,0,1,2,2
S01007330,Owned: Owned outright,207,86,49,16,33,36,1,121,118,0,1,1,1
S01007330,Owned: Owned with a mortgage or loan or shared ownership,70,60,39,5,34,20,1,10,8,0,0,1,1
S01007330,Rented or living rent free: Total,98,61,37,16,21,19,5,37,25,0,4,6,2
S01007330,Rented or living rent free: Social rented,53,32,22,13,9,6,4,21,13,0,2,4,2
S01007330,Rented or living rent free: Private rented or living rent free,45,29,15,3,12,13,1,16,12,0,2,2,0
S01007331,All HRPs aged 16 and over,419,289,190,24,166,92,7,130,117,1,1,7,4
S01007331,Owned: Total,282,205,131,13,118,73,1,77,76,0,0,1,0
S01007331,Owned: Owned outright,160,95,47,6,41,48,0,65,64,0,0,1,0
S01007331,Owned: Owned with a mortgage or loan or shared ownership,122,110,84,7,77,25,1,12,12,0,0,0,0
S01007331,Rented or living rent free: Total,137,84,59,11,48,19,6,53,41,1,1,6,4
S01007331,Rented or living rent free: Social rented,86,45,33,11,22,8,4,41,30,1,0,6,4
S01007331,Rented or living rent free: Private rented or living rent free,51,39,26,0,26,11,2,12,11,0,1,0,0
S01007332,All HRPs aged 16 and over,219,131,55,12,43,71,5,88,81,0,1,6,0
S01007332,Owned: Total,178,110,43,10,33,65,2,68,64,0,1,3,0
S01007332,Owned: Owned outright,126,68,19,7,12,47,2,58,57,0,0,1,0
S01007332,Owned: Owned with a mortgage or loan or shared ownership,52,42,24,3,21,18,0,10,7,0,1,2,0
S01007332,Rented or living rent free: Total,41,21,12,2,10,6,3,20,17,0,0,3,0
S01007332,Rented or living rent free: Social rented,18,11,7,0,7,2,2,7,4,0,0,3,0
S01007332,Rented or living rent free: Private rented or living rent free,23,10,5,2,3,4,1,13,13,0,0,0,0
S01007333,All HRPs aged 16 and over,367,217,154,24,130,56,7,150,126,1,9,13,1
S01007333,Owned: Total,269,162,109,11,98,51,2,107,101,0,1,4,1
S01007333,Owned: Owned outright,156,62,36,7,29,25,1,94,92,0,0,2,0
S01007333,Owned: Owned with a mortgage or loan or shared ownership,113,100,73,4,69,26,1,13,9,0,1,2,1
S01007333,Rented or living rent free: Total,98,55,45,13,32,5,5,43,25,1,8,9,0
S01007333,Rented or living rent free: Social rented,64,36,28,10,18,5,3,28,16,0,4,8,0
S01007333,Rented or living rent free: Private rented or living rent free,34,19,17,3,14,0,2,15,9,1,4,1,0
S01007334,All HRPs aged 16 and over,391,202,145,43,102,25,32,189,128,4,13,34,10
S01007334,Owned: Total,101,65,53,9,44,12,0,36,33,0,0,2,1
S01007334,Owned: Owned outright,56,24,16,2,14,8,0,32,30,0,0,1,1
S01007334,Owned: Owned with a mortgage or loan or shared ownership,45,41,37,7,30,4,0,4,3,0,0,1,0
S01007334,Rented or living rent free: Total,290,137,92,34,58,13,32,153,95,4,13,32,9
S01007334,Rented or living rent free: Social rented,250,113,73,31,42,10,30,137,88,4,11,25,9
S01007334,Rented or living rent free: Private rented or living rent free,40,24,19,3,16,3,2,16,7,0,2,7,0
S01007335,All HRPs aged 16 and over,412,230,183,43,140,22,25,182,131,3,11,24,13
S01007335,Owned: Total,199,109,89,11,78,19,1,90,87,0,1,0,2
S01007335,Owned: Owned outright,104,28,23,6,17,5,0,76,73,0,1,0,2
S01007335,Owned: Owned with a mortgage or loan or shared ownership,95,81,66,5,61,14,1,14,14,0,0,0,0
S01007335,Rented or living rent free: Total,213,121,94,32,62,3,24,92,44,3,10,24,11
S01007335,Rented or living rent free: Social rented,186,104,80,32,48,3,21,82,38,3,10,21,10
S01007335,Rented or living rent free: Private rented or living rent free,27,17,14,0,14,0,3,10,6,0,0,3,1
S01007336,All HRPs aged 16 and over,302,195,134,31,103,33,28,107,66,1,12,23,5
S01007336,Owned: Total,114,77,61,9,52,12,4,37,33,0,0,4,0
S01007336,Owned: Owned outright,58,23,15,4,11,5,3,35,32,0,0,3,0
S01007336,Owned: Owned with a mortgage or loan or shared ownership,56,54,46,5,41,7,1,2,1,0,0,1,0
S01007336,Rented or living rent free: Total,188,118,73,22,51,21,24,70,33,1,12,19,5
S01007336,Rented or living rent free: Social rented,67,33,22,6,16,4,7,34,18,1,4,7,4
S01007336,Rented or living rent free: Private rented or living rent free,121,85,51,16,35,17,17,36,15,0,8,12,1
S01007337,All HRPs aged 16 and over,380,178,134,31,103,30,14,202,166,2,8,22,4
S01007337,Owned: Total,195,110,85,16,69,21,4,85,80,2,0,3,0
S01007337,Owned: Owned outright,115,38,24,7,17,10,4,77,73,2,0,2,0
S01007337,Owned: Owned with a mortgage or loan or shared ownership,80,72,61,9,52,11,0,8,7,0,0,1,0
S01007337,Rented or living rent free: Total,185,68,49,15,34,9,10,117,86,0,8,19,4
S01007337,Rented or living rent free: Social rented,144,40,29,12,17,3,8,104,79,0,6,16,3
S01007337,Rented or living rent free: Private rented or living rent free,41,28,20,3,17,6,2,13,7,0,2,3,1
S01007338,All HRPs aged 16 and over,302,197,167,35,132,25,5,105,94,0,1,7,3
S01007338,Owned: Total,207,138,120,15,105,18,0,69,65,0,0,3,1
S01007338,Owned: Owned outright,119,55,45,10,35,10,0,64,62,0,0,2,0
S01007338,Owned: Owned with a mortgage or loan or shared ownership,88,83,75,5,70,8,0,5,3,0,0,1,1
S01007338,Rented or living rent free: Total,95,59,47,20,27,7,5,36,29,0,1,4,2
S01007338,Rented or living rent free: Social rented,88,56,44,18,26,7,5,32,26,0,1,3,2
S01007338,Rented or living rent free: Private rented or living rent free,7,3,3,2,1,0,0,4,3,0,0,1,0
S01007339,All HRPs aged 16 and over,302,167,133,25,108,33,1,135,117,0,3,7,8
S01007339,Owned: Total,220,127,99,17,82,28,0,93,89,0,0,2,2
S01007339,Owned: Owned outright,148,61,43,9,34,18,0,87,84,0,0,1,2
S01007339,Owned: Owned with a mortgage or loan or shared ownership,72,66,56,8,48,10,0,6,5,0,0,1,0
S01007339,Rented or living rent free: Total,82,40,34,8,26,5,1,42,28,0,3,5,6
S01007339,Rented or living rent free: Social rented,56,26,22,4,18,3,1,30,20,0,2,5,3
S01007339,Rented or living rent free: Private rented or living rent free,26,14,12,4,8,2,0,12,8,0,1,0,3
S01007340,All HRPs aged 16 and over,273,132,91,24,67,32,9,141,114,0,1,23,3
S01007340,Owned: Total,152,82,56,14,42,25,1,70,67,0,0,3,0
S01007340,Owned: Owned outright,108,44,26,11,15,17,1,64,61,0,0,3,0
S01007340,Owned: Owned with a mortgage or loan or shared ownership,44,38,30,3,27,8,0,6,6,0,0,0,0
S01007340,Rented or living rent free: Total,121,50,35,10,25,7,8,71,47,0,1,20,3
S01007340,Rented or living rent free: Social rented,82,32,21,7,14,6,5,50,36,0,1,13,0
S01007340,Rented or living rent free: Private rented or living rent free,39,18,14,3,11,1,3,21,11,0,0,7,3
S01007341,All HRPs aged 16 and over,394,182,128,19,109,43,11,212,180,0,5,15,12
S01007341,Owned: Total,303,142,101,11,90,36,5,161,153,0,1,4,3
S01007341,Owned: Owned outright,211,67,45,9,36,18,4,144,140,0,0,3,1
S01007341,Owned: Owned with a mortgage or loan or shared ownership,92,75,56,2,54,18,1,17,13,0,1,1,2
S01007341,Rented or living rent free: Total,91,40,27,8,19,7,6,51,27,0,4,11,9
S01007341,Rented or living rent free: Social rented,39,17,13,4,9,1,3,22,11,0,1,4,6
S01007341,Rented or living rent free: Private rented or living rent free,52,23,14,4,10,6,3,29,16,0,3,7,3
S01007342,All HRPs aged 16 and over,359,204,138,35,103,63,3,155,151,0,1,1,2
S01007342,Owned: Total,317,179,120,30,90,57,2,138,137,0,0,0,1
S01007342,Owned: Owned outright,216,86,61,25,36,23,2,130,129,0,0,0,1
S01007342,Owned: Owned with a mortgage or loan or shared ownership,101,93,59,5,54,34,0,8,8,0,0,0,0
S01007342,Rented or living rent free: Total,42,25,18,5,13,6,1,17,14,0,1,1,1
S01007342,Rented or living rent free: Social rented,5,4,3,2,1,1,0,1,1,0,0,0,0
S01007342,Rented or living rent free: Private rented or living rent free,37,21,15,3,12,5,1,16,13,0,1,1,1
S01007343,All HRPs aged 16 and over,302,182,99,14,85,79,4,120,111,0,3,6,0
S01007343,Owned: Total,167,95,52,5,47,41,2,72,72,0,0,0,0
S01007343,Owned: Owned outright,116,47,20,3,17,25,2,69,69,0,0,0,0
S01007343,Owned: Owned with a mortgage or loan or shared ownership,51,48,32,2,30,16,0,3,3,0,0,0,0
S01007343,Rented or living rent free: Total,135,87,47,9,38,38,2,48,39,0,3,6,0
S01007343,Rented or living rent free: Social rented,18,4,2,1,1,2,0,14,9,0,1,4,0
S01007343,Rented or living rent free: Private rented or living rent free,117,83,45,8,37,36,2,34,30,0,2,2,0
S01007344,All HRPs aged 16 and over,242,122,94,15,79,26,2,120,107,0,4,7,2
S01007344,Owned: Total,173,93,67,9,58,25,1,80,75,0,2,1,2
S01007344,Owned: Owned outright,108,39,24,2,22,14,1,69,65,0,1,1,2
S01007344,Owned: Owned with a mortgage or loan or shared ownership,65,54,43,7,36,11,0,11,10,0,1,0,0
S01007344,Rented or living rent free: Total,69,29,27,6,21,1,1,40,32,0,2,6,0
S01007344,Rented or living rent free: Social rented,31,6,6,0,6,0,0,25,19,0,2,4,0
S01007344,Rented or living rent free: Private rented or living rent free,38,23,21,6,15,1,1,15,13,0,0,2,0
S01007345,All HRPs aged 16 and over,315,189,140,47,93,21,28,126,88,2,14,19,3
S01007345,Owned: Total,95,68,57,12,45,11,0,27,25,0,2,0,0
S01007345,Owned: Owned outright,49,26,21,5,16,5,0,23,22,0,1,0,0
S01007345,Owned: Owned with a mortgage or loan or shared ownership,46,42,36,7,29,6,0,4,3,0,1,0,0
S01007345,Rented or living rent free: Total,220,121,83,35,48,10,28,99,63,2,12,19,3
S01007345,Rented or living rent free: Social rented,201,108,77,34,43,7,24,93,61,2,11,16,3
S01007345,Rented or living rent free: Private rented or living rent free,19,13,6,1,5,3,4,6,2,0,1,3,0
S01007346,All HRPs aged 16 and over,351,182,131,33,98,17,34,169,123,6,4,33,3
S01007346,Owned: Total,104,65,54,9,45,10,1,39,35,0,0,4,0
S01007346,Owned: Owned outright,65,32,24,5,19,7,1,33,31,0,0,2,0
S01007346,Owned: Owned with a mortgage or loan or shared ownership,39,33,30,4,26,3,0,6,4,0,0,2,0
S01007346,Rented or living rent free: Total,247,117,77,24,53,7,33,130,88,6,4,29,3
S01007346,Rented or living rent free: Social rented,184,77,51,16,35,2,24,107,80,0,4,22,1
S01007346,Rented or living rent free: Private rented or living rent free,63,40,26,8,18,5,9,23,8,6,0,7,2
S01007347,All HRPs aged 16 and over,351,180,136,40,96,21,23,171,132,4,1,26,8
S01007347,Owned: Total,160,92,74,12,62,14,4,68,65,0,0,3,0
S01007347,Owned: Owned outright,98,37,27,7,20,8,2,61,59,0,0,2,0
S01007347,Owned: Owned with a mortgage or loan or shared ownership,62,55,47,5,42,6,2,7,6,0,0,1,0
S01007347,Rented or living rent free: Total,191,88,62,28,34,7,19,103,67,4,1,23,8
S01007347,Rented or living rent free: Social rented,162,76,53,24,29,6,17,86,56,2,1,20,7
S01007347,Rented or living rent free: Private rented or living rent free,29,12,9,4,5,1,2,17,11,2,0,3,1
S01007348,All HRPs aged 16 and over,280,163,124,41,83,24,15,117,93,0,6,14,4
S01007348,Owned: Total,118,83,65,13,52,17,1,35,33,0,0,2,0
S01007348,Owned: Owned outright,56,26,17,5,12,9,0,30,29,0,0,1,0
S01007348,Owned: Owned with a mortgage or loan or shared ownership,62,57,48,8,40,8,1,5,4,0,0,1,0
S01007348,Rented or living rent free: Total,162,80,59,28,31,7,14,82,60,0,6,12,4
S01007348,Rented or living rent free: Social rented,139,67,52,26,26,5,10,72,55,0,5,10,2
S01007348,Rented or living rent free: Private rented or living rent free,23,13,7,2,5,2,4,10,5,0,1,2,2
S01007349,All HRPs aged 16 and over,189,119,96,25,71,13,10,70,42,0,17,5,6
S01007349,Owned: Total,95,69,58,8,50,10,1,26,25,0,1,0,0
S01007349,Owned: Owned outright,59,34,32,6,26,2,0,25,24,0,1,0,0
S01007349,Owned: Owned with a mortgage or loan or shared ownership,36,35,26,2,24,8,1,1,1,0,0,0,0
S01007349,Rented or living rent free: Total,94,50,38,17,21,3,9,44,17,0,16,5,6
S01007349,Rented or living rent free: Social rented,74,41,32,16,16,1,8,33,14,0,14,4,1
S01007349,Rented or living rent free: Private rented or living rent free,20,9,6,1,5,2,1,11,3,0,2,1,5
S01007350,All HRPs aged 16 and over,331,164,118,31,87,29,17,167,145,0,1,19,2
S01007350,Owned: Total,167,94,63,14,49,26,5,73,70,0,0,3,0
S01007350,Owned: Owned outright,112,49,30,13,17,14,5,63,61,0,0,2,0
S01007350,Owned: Owned with a mortgage or loan or shared ownership,55,45,33,1,32,12,0,10,9,0,0,1,0
S01007350,Rented or living rent free: Total,164,70,55,17,38,3,12,94,75,0,1,16,2
S01007350,Rented or living rent free: Social rented,72,18,16,7,9,1,1,54,46,0,1,7,0
S01007350,Rented or living rent free: Private rented or living rent free,92,52,39,10,29,2,11,40,29,0,0,9,2
S01007351,All HRPs aged 16 and over,355,172,95,17,78,67,10,183,160,0,5,15,3
S01007351,Owned: Total,265,124,71,12,59,49,4,141,134,0,2,5,0
S01007351,Owned: Owned outright,201,70,36,8,28,31,3,131,127,0,2,2,0
S01007351,Owned: Owned with a mortgage or loan or shared ownership,64,54,35,4,31,18,1,10,7,0,0,3,0
S01007351,Rented or living rent free: Total,90,48,24,5,19,18,6,42,26,0,3,10,3
S01007351,Rented or living rent free: Social rented,42,22,13,5,8,7,2,20,15,0,2,3,0
S01007351,Rented or living rent free: Private rented or living rent free,48,26,11,0,11,11,4,22,11,0,1,7,3
S01007352,All HRPs aged 16 and over,230,146,80,15,65,61,5,84,80,0,1,2,1
S01007352,Owned: Total,152,83,44,7,37,38,1,69,66,0,0,2,1
S01007352,Owned: Owned outright,112,47,22,6,16,24,1,65,64,0,0,0,1
S01007352,Owned: Owned with a mortgage or loan or shared ownership,40,36,22,1,21,14,0,4,2,0,0,2,0
S01007352,Rented or living rent free: Total,78,63,36,8,28,23,4,15,14,0,1,0,0
S01007352,Rented or living rent free: Social rented,13,7,5,4,1,1,1,6,5,0,1,0,0
S01007352,Rented or living rent free: Private rented or living rent free,65,56,31,4,27,22,3,9,9,0,0,0,0
S01007353,All HRPs aged 16 and over,282,160,115,25,90,41,4,122,115,0,3,3,1
S01007353,Owned: Total,227,121,82,15,67,36,3,106,103,0,2,0,1
S01007353,Owned: Owned outright,150,54,34,9,25,18,2,96,93,0,2,0,1
S01007353,Owned: Owned with a mortgage or loan or shared ownership,77,67,48,6,42,18,1,10,10,0,0,0,0
S01007353,Rented or living rent free: Total,55,39,33,10,23,5,1,16,12,0,1,3,0
S01007353,Rented or living rent free: Social rented,29,18,15,5,10,2,1,11,8,0,0,3,0
S01007353,Rented or living rent free: Private rented or living rent free,26,21,18,5,13,3,0,5,4,0,1,0,0
S01007354,All HRPs aged 16 and over,403,208,159,32,127,40,9,195,176,0,6,9,4
S01007354,Owned: Total,310,174,134,24,110,35,5,136,130,0,2,2,2
S01007354,Owned: Owned outright,185,69,47,17,30,18,4,116,113,0,1,1,1
S01007354,Owned: Owned with a mortgage or loan or shared ownership,125,105,87,7,80,17,1,20,17,0,1,1,1
S01007354,Rented or living rent free: Total,93,34,25,8,17,5,4,59,46,0,4,7,2
S01007354,Rented or living rent free: Social rented,38,6,3,2,1,1,2,32,24,0,2,5,1
S01007354,Rented or living rent free: Private rented or living rent free,55,28,22,6,16,4,2,27,22,0,2,2,1
S01007355,All HRPs aged 16 and over,464,264,161,19,142,94,9,200,177,0,3,16,4
S01007355,Owned: Total,356,199,116,15,101,79,4,157,151,0,0,3,3
S01007355,Owned: Owned outright,244,97,50,12,38,45,2,147,143,0,0,2,2
S01007355,Owned: Owned with a mortgage or loan or shared ownership,112,102,66,3,63,34,2,10,8,0,0,1,1
S01007355,Rented or living rent free: Total,108,65,45,4,41,15,5,43,26,0,3,13,1
S01007355,Rented or living rent free: Social rented,30,14,11,0,11,3,0,16,10,0,2,3,1
S01007355,Rented or living rent free: Private rented or living rent free,78,51,34,4,30,12,5,27,16,0,1,10,0
S01007356,All HRPs aged 16 and over,350,191,138,39,99,47,6,159,139,0,3,16,1
S01007356,Owned: Total,263,147,103,28,75,42,2,116,111,0,0,4,1
S01007356,Owned: Owned outright,168,66,43,17,26,23,0,102,101,0,0,1,0
S01007356,Owned: Owned with a mortgage or loan or shared ownership,95,81,60,11,49,19,2,14,10,0,0,3,1
S01007356,Rented or living rent free: Total,87,44,35,11,24,5,4,43,28,0,3,12,0
S01007356,Rented or living rent free: Social rented,48,20,15,8,7,3,2,28,16,0,3,9,0
S01007356,Rented or living rent free: Private rented or living rent free,39,24,20,3,17,2,2,15,12,0,0,3,0
S01007357,All HRPs aged 16 and over,388,221,148,30,118,67,6,167,159,0,0,7,1
S01007357,Owned: Total,277,152,98,22,76,51,3,125,123,0,0,1,1
S01007357,Owned: Owned outright,195,83,48,15,33,33,2,112,110,0,0,1,1
S01007357,Owned: Owned with a mortgage or loan or shared ownership,82,69,50,7,43,18,1,13,13,0,0,0,0
S01007357,Rented or living rent free: Total,111,69,50,8,42,16,3,42,36,0,0,6,0
S01007357,Rented or living rent free: Social rented,58,27,21,5,16,4,2,31,26,0,0,5,0
S01007357,Rented or living rent free: Private rented or living rent free,53,42,29,3,26,12,1,11,10,0,0,1,0
S01007358,All HRPs aged 16 and over,368,263,201,33,168,51,11,105,91,0,3,10,1
S01007358,Owned: Total,289,210,165,24,141,42,3,79,74,0,0,4,1
S01007358,Owned: Owned outright,129,69,51,13,38,17,1,60,57,0,0,2,1
S01007358,Owned: Owned with a mortgage or loan or shared ownership,160,141,114,11,103,25,2,19,17,0,0,2,0
S01007358,Rented or living rent free: Total,79,53,36,9,27,9,8,26,17,0,3,6,0
S01007358,Rented or living rent free: Social rented,39,20,14,4,10,2,4,19,11,0,3,5,0
S01007358,Rented or living rent free: Private rented or living rent free,40,33,22,5,17,7,4,7,6,0,0,1,0
S01007359,All HRPs aged 16 and over,371,205,159,30,129,28,18,166,131,2,5,25,3
S01007359,Owned: Total,244,136,113,19,94,20,3,108,100,0,0,8,0
S01007359,Owned: Owned outright,139,49,37,9,28,10,2,90,88,0,0,2,0
S01007359,Owned: Owned with a mortgage or loan or shared ownership,105,87,76,10,66,10,1,18,12,0,0,6,0
S01007359,Rented or living rent free: Total,127,69,46,11,35,8,15,58,31,2,5,17,3
S01007359,Rented or living rent free: Social rented,96,47,31,8,23,4,12,49,27,2,5,13,2
S01007359,Rented or living rent free: Private rented or living rent free,31,22,15,3,12,4,3,9,4,0,0,4,1
S01007360,All HRPs aged 16 and over,236,122,90,18,72,24,8,114,108,1,2,3,0
S01007360,Owned: Total,194,101,74,12,62,23,4,93,93,0,0,0,0
S01007360,Owned: Owned outright,124,43,23,5,18,17,3,81,81,0,0,0,0
S01007360,Owned: Owned with a mortgage or loan or shared ownership,70,58,51,7,44,6,1,12,12,0,0,0,0
S01007360,Rented or living rent free: Total,42,21,16,6,10,1,4,21,15,1,2,3,0
S01007360,Rented or living rent free: Social rented,19,5,5,4,1,0,0,14,12,0,0,2,0
S01007360,Rented or living rent free: Private rented or living rent free,23,16,11,2,9,1,4,7,3,1,2,1,0
S01007361,All HRPs aged 16 and over,507,255,174,29,145,67,14,252,230,0,3,12,7
S01007361,Owned: Total,382,191,135,22,113,52,4,191,186,0,1,0,4
S01007361,Owned: Owned outright,235,70,48,16,32,21,1,165,162,0,1,0,2
S01007361,Owned: Owned with a mortgage or loan or shared ownership,147,121,87,6,81,31,3,26,24,0,0,0,2
S01007361,Rented or living rent free: Total,125,64,39,7,32,15,10,61,44,0,2,12,3
S01007361,Rented or living rent free: Social rented,53,12,7,1,6,3,2,41,32,0,1,6,2
S01007361,Rented or living rent free: Private rented or living rent free,72,52,32,6,26,12,8,20,12,0,1,6,1
S01007362,All HRPs aged 16 and over,316,184,147,15,132,33,4,132,117,4,4,6,1
S01007362,Owned: Total,247,140,110,11,99,29,1,107,101,3,1,1,1
S01007362,Owned: Owned outright,135,44,31,6,25,13,0,91,85,3,1,1,1
S01007362,Owned: Owned with a mortgage or loan or shared ownership,112,96,79,5,74,16,1,16,16,0,0,0,0
S01007362,Rented or living rent free: Total,69,44,37,4,33,4,3,25,16,1,3,5,0
S01007362,Rented or living rent free: Social rented,24,13,12,2,10,1,0,11,6,0,2,3,0
S01007362,Rented or living rent free: Private rented or living rent free,45,31,25,2,23,3,3,14,10,1,1,2,0
S01007363,All HRPs aged 16 and over,348,163,126,24,102,26,11,185,168,0,2,13,2
S01007363,Owned: Total,236,124,101,19,82,21,2,112,108,0,1,2,1
S01007363,Owned: Owned outright,156,54,39,10,29,13,2,102,98,0,1,2,1
S01007363,Owned: Owned with a mortgage or loan or shared ownership,80,70,62,9,53,8,0,10,10,0,0,0,0
S01007363,Rented or living rent free: Total,112,39,25,5,20,5,9,73,60,0,1,11,1
S01007363,Rented or living rent free: Social rented,78,15,12,3,9,1,2,63,56,0,1,6,0
S01007363,Rented or living rent free: Private rented or living rent free,34,24,13,2,11,4,7,10,4,0,0,5,1
S01007364,All HRPs aged 16 and over,409,239,191,45,146,18,30,170,91,5,14,45,15
S01007364,Owned: Total,176,124,109,20,89,11,4,52,46,0,0,3,3
S01007364,Owned: Owned outright,80,36,30,7,23,4,2,44,39,0,0,2,3
S01007364,Owned: Owned with a mortgage or loan or shared ownership,96,88,79,13,66,7,2,8,7,0,0,1,0
S01007364,Rented or living rent free: Total,233,115,82,25,57,7,26,118,45,5,14,42,12
S01007364,Rented or living rent free: Social rented,204,98,70,22,48,2,26,106,41,3,14,40,8
S01007364,Rented or living rent free: Private rented or living rent free,29,17,12,3,9,5,0,12,4,2,0,2,4
S01007365,All HRPs aged 16 and over,215,125,99,21,78,18,8,90,69,0,7,12,2
S01007365,Owned: Total,143,84,69,13,56,15,0,59,56,0,1,2,0
S01007365,Owned: Owned outright,76,24,20,8,12,4,0,52,50,0,1,1,0
S01007365,Owned: Owned with a mortgage or loan or shared ownership,67,60,49,5,44,11,0,7,6,0,0,1,0
S01007365,Rented or living rent free: Total,72,41,30,8,22,3,8,31,13,0,6,10,2
S01007365,Rented or living rent free: Social rented,58,30,22,8,14,2,6,28,12,0,4,10,2
S01007365,Rented or living rent free: Private rented or living rent free,14,11,8,0,8,1,2,3,1,0,2,0,0
S01007366,All HRPs aged 16 and over,276,112,88,22,66,11,13,164,111,3,9,30,11
S01007366,Owned: Total,97,58,47,9,38,10,1,39,33,0,1,4,1
S01007366,Owned: Owned outright,55,21,17,4,13,4,0,34,29,0,1,3,1
S01007366,Owned: Owned with a mortgage or loan or shared ownership,42,37,30,5,25,6,1,5,4,0,0,1,0
S01007366,Rented or living rent free: Total,179,54,41,13,28,1,12,125,78,3,8,26,10
S01007366,Rented or living rent free: Social rented,139,36,27,7,20,0,9,103,69,3,4,19,8
S01007366,Rented or living rent free: Private rented or living rent free,40,18,14,6,8,1,3,22,9,0,4,7,2
S01007367,All HRPs aged 16 and over,295,165,124,24,100,29,12,130,103,0,3,20,4
S01007367,Owned: Total,173,104,79,10,69,25,0,69,63,0,1,4,1
S01007367,Owned: Owned outright,87,28,19,4,15,9,0,59,55,0,0,3,1
S01007367,Owned: Owned with a mortgage or loan or shared ownership,86,76,60,6,54,16,0,10,8,0,1,1,0
S01007367,Rented or living rent free: Total,122,61,45,14,31,4,12,61,40,0,2,16,3
S01007367,Rented or living rent free: Social rented,54,23,17,6,11,1,5,31,22,0,2,6,1
S01007367,Rented or living rent free: Private rented or living rent free,68,38,28,8,20,3,7,30,18,0,0,10,2
S01007368,All HRPs aged 16 and over,233,137,102,36,66,15,20,96,50,2,11,29,4
S01007368,Owned: Total,99,67,57,17,40,8,2,32,30,0,1,0,1
S01007368,Owned: Owned outright,43,18,16,8,8,1,1,25,25,0,0,0,0
S01007368,Owned: Owned with a mortgage or loan or shared ownership,56,49,41,9,32,7,1,7,5,0,1,0,1
S01007368,Rented or living rent free: Total,134,70,45,19,26,7,18,64,20,2,10,29,3
S01007368,Rented or living rent free: Social rented,117,59,36,15,21,5,18,58,17,2,9,28,2
S01007368,Rented or living rent free: Private rented or living rent free,17,11,9,4,5,2,0,6,3,0,1,1,1
S01007369,All HRPs aged 16 and over,378,237,178,36,142,37,22,141,95,4,5,32,5
S01007369,Owned: Total,242,164,135,23,112,27,2,78,69,1,1,7,0
S01007369,Owned: Owned outright,124,54,45,13,32,8,1,70,65,0,0,5,0
S01007369,Owned: Owned with a mortgage or loan or shared ownership,118,110,90,10,80,19,1,8,4,1,1,2,0
S01007369,Rented or living rent free: Total,136,73,43,13,30,10,20,63,26,3,4,25,5
S01007369,Rented or living rent free: Social rented,85,37,24,11,13,2,11,48,22,1,2,20,3
S01007369,Rented or living rent free: Private rented or living rent free,51,36,19,2,17,8,9,15,4,2,2,5,2
S01007370,All HRPs aged 16 and over,389,267,204,41,163,33,30,122,92,0,3,23,4
S01007370,Owned: Total,239,158,127,16,111,24,7,81,76,0,0,5,0
S01007370,Owned: Owned outright,116,40,26,8,18,9,5,76,72,0,0,4,0
S01007370,Owned: Owned with a mortgage or loan or shared ownership,123,118,101,8,93,15,2,5,4,0,0,1,0
S01007370,Rented or living rent free: Total,150,109,77,25,52,9,23,41,16,0,3,18,4
S01007370,Rented or living rent free: Social rented,58,34,18,4,14,3,13,24,9,0,0,12,3
S01007370,Rented or living rent free: Private rented or living rent free,92,75,59,21,38,6,10,17,7,0,3,6,1
S01007371,All HRPs aged 16 and over,320,216,170,41,129,31,15,104,76,0,5,16,7
S01007371,Owned: Total,239,166,136,25,111,28,2,73,67,0,0,5,1
S01007371,Owned: Owned outright,115,49,38,12,26,10,1,66,61,0,0,4,1
S01007371,Owned: Owned with a mortgage or loan or shared ownership,124,117,98,13,85,18,1,7,6,0,0,1,0
S01007371,Rented or living rent free: Total,81,50,34,16,18,3,13,31,9,0,5,11,6
S01007371,Rented or living rent free: Social rented,31,13,8,6,2,1,4,18,3,0,2,9,4
S01007371,Rented or living rent free: Private rented or living rent free,50,37,26,10,16,2,9,13,6,0,3,2,2
S01007372,All HRPs aged 16 and over,374,219,163,34,129,42,14,155,143,0,3,9,0
S01007372,Owned: Total,310,173,131,23,108,37,5,137,130,0,3,4,0
S01007372,Owned: Owned outright,182,57,34,10,24,21,2,125,119,0,3,3,0
S01007372,Owned: Owned with a mortgage or loan or shared ownership,128,116,97,13,84,16,3,12,11,0,0,1,0
S01007372,Rented or living rent free: Total,64,46,32,11,21,5,9,18,13,0,0,5,0
S01007372,Rented or living rent free: Social rented,18,9,4,1,3,0,5,9,5,0,0,4,0
S01007372,Rented or living rent free: Private rented or living rent free,46,37,28,10,18,5,4,9,8,0,0,1,0
S01007373,All HRPs aged 16 and over,283,163,111,13,98,48,4,120,114,1,2,2,1
S01007373,Owned: Total,249,141,97,11,86,42,2,108,105,1,0,1,1
S01007373,Owned: Owned outright,155,57,33,6,27,23,1,98,96,0,0,1,1
S01007373,Owned: Owned with a mortgage or loan or shared ownership,94,84,64,5,59,19,1,10,9,1,0,0,0
S01007373,Rented or living rent free: Total,34,22,14,2,12,6,2,12,9,0,2,1,0
S01007373,Rented or living rent free: Social rented,5,1,1,0,1,0,0,4,1,0,2,1,0
S01007373,Rented or living rent free: Private rented or living rent free,29,21,13,2,11,6,2,8,8,0,0,0,0
S01007374,All HRPs aged 16 and over,217,154,120,10,110,27,7,63,55,0,3,5,0
S01007374,Owned: Total,172,130,101,8,93,26,3,42,41,0,0,1,0
S01007374,Owned: Owned outright,70,29,22,6,16,5,2,41,41,0,0,0,0
S01007374,Owned: Owned with a mortgage or loan or shared ownership,102,101,79,2,77,21,1,1,0,0,0,1,0
S01007374,Rented or living rent free: Total,45,24,19,2,17,1,4,21,14,0,3,4,0
S01007374,Rented or living rent free: Social rented,32,17,13,2,11,0,4,15,10,0,1,4,0
S01007374,Rented or living rent free: Private rented or living rent free,13,7,6,0,6,1,0,6,4,0,2,0,0
S01007375,All HRPs aged 16 and over,216,125,91,13,78,28,6,91,84,3,0,2,2
S01007375,Owned: Total,187,103,72,9,63,26,5,84,80,2,0,1,1
S01007375,Owned: Owned outright,109,37,23,5,18,11,3,72,70,2,0,0,0
S01007375,Owned: Owned with a mortgage or loan or shared ownership,78,66,49,4,45,15,2,12,10,0,0,1,1
S01007375,Rented or living rent free: Total,29,22,19,4,15,2,1,7,4,1,0,1,1
S01007375,Rented or living rent free: Social rented,4,3,3,1,2,0,0,1,0,0,0,1,0
S01007375,Rented or living rent free: Private rented or living rent free,25,19,16,3,13,2,1,6,4,1,0,0,1
S01007376,All HRPs aged 16 and over,371,234,189,33,156,23,22,137,101,1,11,23,1
S01007376,Owned: Total,208,143,125,12,113,13,5,65,62,1,2,0,0
S01007376,Owned: Owned outright,95,44,36,7,29,6,2,51,50,0,1,0,0
S01007376,Owned: Owned with a mortgage or loan or shared ownership,113,99,89,5,84,7,3,14,12,1,1,0,0
S01007376,Rented or living rent free: Total,163,91,64,21,43,10,17,72,39,0,9,23,1
S01007376,Rented or living rent free: Social rented,134,70,51,17,34,5,14,64,34,0,9,20,1
S01007376,Rented or living rent free: Private rented or living rent free,29,21,13,4,9,5,3,8,5,0,0,3,0
S01007377,All HRPs aged 16 and over,279,204,161,21,140,40,3,75,69,0,2,3,1
S01007377,Owned: Total,260,190,152,19,133,35,3,70,65,0,2,2,1
S01007377,Owned: Owned outright,107,50,37,11,26,13,0,57,53,0,2,2,0
S01007377,Owned: Owned with a mortgage or loan or shared ownership,153,140,115,8,107,22,3,13,12,0,0,0,1
S01007377,Rented or living rent free: Total,19,14,9,2,7,5,0,5,4,0,0,1,0
S01007377,Rented or living rent free: Social rented,5,4,2,0,2,2,0,1,0,0,0,1,0
S01007377,Rented or living rent free: Private rented or living rent free,14,10,7,2,5,3,0,4,4,0,0,0,0
S01007378,All HRPs aged 16 and over,231,160,122,12,110,36,2,71,64,0,0,5,2
S01007378,Owned: Total,192,132,96,8,88,34,2,60,58,0,0,1,1
S01007378,Owned: Owned outright,86,36,21,5,16,14,1,50,49,0,0,0,1
S01007378,Owned: Owned with a mortgage or loan or shared ownership,106,96,75,3,72,20,1,10,9,0,0,1,0
S01007378,Rented or living rent free: Total,39,28,26,4,22,2,0,11,6,0,0,4,1
S01007378,Rented or living rent free: Social rented,14,7,6,3,3,1,0,7,2,0,0,4,1
S01007378,Rented or living rent free: Private rented or living rent free,25,21,20,1,19,1,0,4,4,0,0,0,0
S01007379,All HRPs aged 16 and over,234,138,117,18,99,10,11,96,85,1,3,2,5
S01007379,Owned: Total,140,83,75,9,66,6,2,57,55,0,0,1,1
S01007379,Owned: Owned outright,62,15,14,6,8,1,0,47,46,0,0,0,1
S01007379,Owned: Owned with a mortgage or loan or shared ownership,78,68,61,3,58,5,2,10,9,0,0,1,0
S01007379,Rented or living rent free: Total,94,55,42,9,33,4,9,39,30,1,3,1,4
S01007379,Rented or living rent free: Social rented,79,45,34,8,26,3,8,34,25,1,3,1,4
S01007379,Rented or living rent free: Private rented or living rent free,15,10,8,1,7,1,1,5,5,0,0,0,0
S01007380,All HRPs aged 16 and over,229,169,149,16,133,12,8,60,45,0,4,10,1
S01007380,Owned: Total,152,118,104,5,99,12,2,34,33,0,0,1,0
S01007380,Owned: Owned outright,46,20,15,2,13,4,1,26,26,0,0,0,0
S01007380,Owned: Owned with a mortgage or loan or shared ownership,106,98,89,3,86,8,1,8,7,0,0,1,0
S01007380,Rented or living rent free: Total,77,51,45,11,34,0,6,26,12,0,4,9,1
S01007380,Rented or living rent free: Social rented,61,41,38,10,28,0,3,20,10,0,4,5,1
S01007380,Rented or living rent free: Private rented or living rent free,16,10,7,1,6,0,3,6,2,0,0,4,0
S01007381,All HRPs aged 16 and over,191,117,97,12,85,18,2,74,67,1,3,1,2
S01007381,Owned: Total,163,92,73,11,62,18,1,71,65,1,2,1,2
S01007381,Owned: Owned outright,104,38,29,6,23,9,0,66,62,0,1,1,2
S01007381,Owned: Owned with a mortgage or loan or shared ownership,59,54,44,5,39,9,1,5,3,1,1,0,0
S01007381,Rented or living rent free: Total,28,25,24,1,23,0,1,3,2,0,1,0,0
S01007381,Rented or living rent free: Social rented,4,1,1,0,1,0,0,3,2,0,1,0,0
S01007381,Rented or living rent free: Private rented or living rent free,24,24,23,1,22,0,1,0,0,0,0,0,0
S01007382,All HRPs aged 16 and over,281,199,155,24,131,38,6,82,74,0,3,3,2
S01007382,Owned: Total,231,158,118,18,100,35,5,73,70,0,2,0,1
S01007382,Owned: Owned outright,105,48,33,9,24,12,3,57,55,0,1,0,1
S01007382,Owned: Owned with a mortgage or loan or shared ownership,126,110,85,9,76,23,2,16,15,0,1,0,0
S01007382,Rented or living rent free: Total,50,41,37,6,31,3,1,9,4,0,1,3,1
S01007382,Rented or living rent free: Social rented,23,17,15,4,11,2,0,6,1,0,1,3,1
S01007382,Rented or living rent free: Private rented or living rent free,27,24,22,2,20,1,1,3,3,0,0,0,0
S01007383,All HRPs aged 16 and over,349,213,161,20,141,45,7,136,114,0,3,13,6
S01007383,Owned: Total,266,167,126,14,112,39,2,99,94,0,2,2,1
S01007383,Owned: Owned outright,135,49,34,7,27,15,0,86,81,0,2,2,1
S01007383,Owned: Owned with a mortgage or loan or shared ownership,131,118,92,7,85,24,2,13,13,0,0,0,0
S01007383,Rented or living rent free: Total,83,46,35,6,29,6,5,37,20,0,1,11,5
S01007383,Rented or living rent free: Social rented,40,18,11,4,7,3,4,22,12,0,0,9,1
S01007383,Rented or living rent free: Private rented or living rent free,43,28,24,2,22,3,1,15,8,0,1,2,4
S01007384,All HRPs aged 16 and over,332,237,207,27,180,18,12,95,84,1,1,6,3
S01007384,Owned: Total,247,164,143,18,125,17,4,83,78,1,0,2,2
S01007384,Owned: Owned outright,105,33,27,10,17,6,0,72,68,0,0,2,2
S01007384,Owned: Owned with a mortgage or loan or shared ownership,142,131,116,8,108,11,4,11,10,1,0,0,0
S01007384,Rented or living rent free: Total,85,73,64,9,55,1,8,12,6,0,1,4,1
S01007384,Rented or living rent free: Social rented,18,12,10,2,8,1,1,6,4,0,0,2,0
S01007384,Rented or living rent free: Private rented or living rent free,67,61,54,7,47,0,7,6,2,0,1,2,1
S01007385,All HRPs aged 16 and over,404,220,179,30,149,37,4,184,165,2,1,12,4
S01007385,Owned: Total,330,173,138,17,121,33,2,157,149,0,0,5,3
S01007385,Owned: Owned outright,193,56,40,8,32,15,1,137,130,0,0,5,2
S01007385,Owned: Owned with a mortgage or loan or shared ownership,137,117,98,9,89,18,1,20,19,0,0,0,1
S01007385,Rented or living rent free: Total,74,47,41,13,28,4,2,27,16,2,1,7,1
S01007385,Rented or living rent free: Social rented,35,16,13,7,6,2,1,19,8,2,1,7,1
S01007385,Rented or living rent free: Private rented or living rent free,39,31,28,6,22,2,1,8,8,0,0,0,0
S01007386,All HRPs aged 16 and over,337,202,140,20,120,59,3,135,127,3,0,4,1
S01007386,Owned: Total,314,184,126,18,108,55,3,130,123,3,0,3,1
S01007386,Owned: Owned outright,197,74,53,17,36,20,1,123,117,3,0,2,1
S01007386,Owned: Owned with a mortgage or loan or shared ownership,117,110,73,1,72,35,2,7,6,0,0,1,0
S01007386,Rented or living rent free: Total,23,18,14,2,12,4,0,5,4,0,0,1,0
S01007386,Rented or living rent free: Social rented,2,1,1,1,0,0,0,1,0,0,0,1,0
S01007386,Rented or living rent free: Private rented or living rent free,21,17,13,1,12,4,0,4,4,0,0,0,0
S01007387,All HRPs aged 16 and over,289,191,145,16,129,44,2,98,92,0,4,0,2
S01007387,Owned: Total,270,177,132,15,117,43,2,93,87,0,4,0,2
S01007387,Owned: Owned outright,151,66,45,12,33,21,0,85,80,0,3,0,2
S01007387,Owned: Owned with a mortgage or loan or shared ownership,119,111,87,3,84,22,2,8,7,0,1,0,0
S01007387,Rented or living rent free: Total,19,14,13,1,12,1,0,5,5,0,0,0,0
S01007387,Rented or living rent free: Social rented,4,3,2,0,2,1,0,1,1,0,0,0,0
S01007387,Rented or living rent free: Private rented or living rent free,15,11,11,1,10,0,0,4,4,0,0,0,0
S01007388,All HRPs aged 16 and over,256,175,149,19,130,23,3,81,80,0,0,1,0
S01007388,Owned: Total,241,164,138,19,119,23,3,77,77,0,0,0,0
S01007388,Owned: Owned outright,114,44,33,9,24,9,2,70,70,0,0,0,0
S01007388,Owned: Owned with a mortgage or loan or shared ownership,127,120,105,10,95,14,1,7,7,0,0,0,0
S01007388,Rented or living rent free: Total,15,11,11,0,11,0,0,4,3,0,0,1,0
S01007388,Rented or living rent free: Social rented,3,1,1,0,1,0,0,2,1,0,0,1,0
S01007388,Rented or living rent free: Private rented or living rent free,12,10,10,0,10,0,0,2,2,0,0,0,0
S01007389,All HRPs aged 16 and over,198,177,162,17,145,7,8,21,4,1,3,11,2
S01007389,Owned: Total,55,51,45,5,40,6,0,4,3,1,0,0,0
S01007389,Owned: Owned outright,12,9,8,2,6,1,0,3,3,0,0,0,0
S01007389,Owned: Owned with a mortgage or loan or shared ownership,43,42,37,3,34,5,0,1,0,1,0,0,0
S01007389,Rented or living rent free: Total,143,126,117,12,105,1,8,17,1,0,3,11,2
S01007389,Rented or living rent free: Social rented,55,39,30,8,22,1,8,16,1,0,3,11,1
S01007389,Rented or living rent free: Private rented or living rent free,88,87,87,4,83,0,0,1,0,0,0,0,1
S01007390,All HRPs aged 16 and over,193,167,151,35,116,10,6,26,9,0,3,10,4
S01007390,Owned: Total,54,49,43,11,32,6,0,5,4,0,0,1,0
S01007390,Owned: Owned outright,14,9,7,4,3,2,0,5,4,0,0,1,0
S01007390,Owned: Owned with a mortgage or loan or shared ownership,40,40,36,7,29,4,0,0,0,0,0,0,0
S01007390,Rented or living rent free: Total,139,118,108,24,84,4,6,21,5,0,3,9,4
S01007390,Rented or living rent free: Social rented,63,42,37,11,26,0,5,21,5,0,3,9,4
S01007390,Rented or living rent free: Private rented or living rent free,76,76,71,13,58,4,1,0,0,0,0,0,0
S01007391,All HRPs aged 16 and over,223,142,123,10,113,18,1,81,73,0,0,6,2
S01007391,Owned: Total,210,135,119,10,109,15,1,75,72,0,0,2,1
S01007391,Owned: Owned outright,117,49,40,6,34,8,1,68,66,0,0,2,0
S01007391,Owned: Owned with a mortgage or loan or shared ownership,93,86,79,4,75,7,0,7,6,0,0,0,1
S01007391,Rented or living rent free: Total,13,7,4,0,4,3,0,6,1,0,0,4,1
S01007391,Rented or living rent free: Social rented,2,2,2,0,2,0,0,0,0,0,0,0,0
S01007391,Rented or living rent free: Private rented or living rent free,11,5,2,0,2,3,0,6,1,0,0,4,1
S01007392,All HRPs aged 16 and over,200,116,94,7,87,22,0,84,79,1,2,0,2
S01007392,Owned: Total,186,107,86,7,79,21,0,79,74,1,2,0,2
S01007392,Owned: Owned outright,105,36,27,6,21,9,0,69,65,1,1,0,2
S01007392,Owned: Owned with a mortgage or loan or shared ownership,81,71,59,1,58,12,0,10,9,0,1,0,0
S01007392,Rented or living rent free: Total,14,9,8,0,8,1,0,5,5,0,0,0,0
S01007392,Rented or living rent free: Social rented,3,1,1,0,1,0,0,2,2,0,0,0,0
S01007392,Rented or living rent free: Private rented or living rent free,11,8,7,0,7,1,0,3,3,0,0,0,0
S01007393,All HRPs aged 16 and over,308,151,109,16,93,39,3,157,151,2,1,3,0
S01007393,Owned: Total,220,121,87,12,75,34,0,99,98,0,1,0,0
S01007393,Owned: Owned outright,132,44,28,7,21,16,0,88,87,0,1,0,0
S01007393,Owned: Owned with a mortgage or loan or shared ownership,88,77,59,5,54,18,0,11,11,0,0,0,0
S01007393,Rented or living rent free: Total,88,30,22,4,18,5,3,58,53,2,0,3,0
S01007393,Rented or living rent free: Social rented,58,7,7,2,5,0,0,51,47,1,0,3,0
S01007393,Rented or living rent free: Private rented or living rent free,30,23,15,2,13,5,3,7,6,1,0,0,0
S01007394,All HRPs aged 16 and over,335,148,120,19,101,23,5,187,180,0,2,4,1
S01007394,Owned: Total,286,118,94,13,81,21,3,168,164,0,2,2,0
S01007394,Owned: Owned outright,182,35,28,7,21,6,1,147,146,0,0,1,0
S01007394,Owned: Owned with a mortgage or loan or shared ownership,104,83,66,6,60,15,2,21,18,0,2,1,0
S01007394,Rented or living rent free: Total,49,30,26,6,20,2,2,19,16,0,0,2,1
S01007394,Rented or living rent free: Social rented,6,3,2,2,0,0,1,3,3,0,0,0,0
S01007394,Rented or living rent free: Private rented or living rent free,43,27,24,4,20,2,1,16,13,0,0,2,1
S01007395,All HRPs aged 16 and over,516,313,248,39,209,40,25,203,162,4,0,25,12
S01007395,Owned: Total,272,164,140,15,125,21,3,108,101,0,0,4,3
S01007395,Owned: Owned outright,122,35,26,8,18,8,1,87,83,0,0,3,1
S01007395,Owned: Owned with a mortgage or loan or shared ownership,150,129,114,7,107,13,2,21,18,0,0,1,2
S01007395,Rented or living rent free: Total,244,149,108,24,84,19,22,95,61,4,0,21,9
S01007395,Rented or living rent free: Social rented,69,27,21,6,15,1,5,42,33,0,0,8,1
S01007395,Rented or living rent free: Private rented or living rent free,175,122,87,18,69,18,17,53,28,4,0,13,8
S01007396,All HRPs aged 16 and over,477,283,233,42,191,34,16,194,144,10,4,32,4
S01007396,Owned: Total,283,179,152,19,133,25,2,104,93,0,1,8,2
S01007396,Owned: Owned outright,134,48,37,12,25,10,1,86,77,0,0,7,2
S01007396,Owned: Owned with a mortgage or loan or shared ownership,149,131,115,7,108,15,1,18,16,0,1,1,0
S01007396,Rented or living rent free: Total,194,104,81,23,58,9,14,90,51,10,3,24,2
S01007396,Rented or living rent free: Social rented,58,24,18,8,10,1,5,34,17,0,3,13,1
S01007396,Rented or living rent free: Private rented or living rent free,136,80,63,15,48,8,9,56,34,10,0,11,1
S01007397,All HRPs aged 16 and over,443,271,216,29,187,48,7,172,152,3,3,14,0
S01007397,Owned: Total,333,197,155,15,140,41,1,136,132,1,3,0,0
S01007397,Owned: Owned outright,178,51,35,8,27,16,0,127,125,0,2,0,0
S01007397,Owned: Owned with a mortgage or loan or shared ownership,155,146,120,7,113,25,1,9,7,1,1,0,0
S01007397,Rented or living rent free: Total,110,74,61,14,47,7,6,36,20,2,0,14,0
S01007397,Rented or living rent free: Social rented,40,19,13,2,11,3,3,21,12,0,0,9,0
S01007397,Rented or living rent free: Private rented or living rent free,70,55,48,12,36,4,3,15,8,2,0,5,0
S01007398,All HRPs aged 16 and over,279,179,149,49,100,16,14,100,52,1,16,23,8
S01007398,Owned: Total,125,94,82,21,61,12,0,31,27,0,1,3,0
S01007398,Owned: Owned outright,38,17,14,5,9,3,0,21,20,0,0,1,0
S01007398,Owned: Owned with a mortgage or loan or shared ownership,87,77,68,16,52,9,0,10,7,0,1,2,0
S01007398,Rented or living rent free: Total,154,85,67,28,39,4,14,69,25,1,15,20,8
S01007398,Rented or living rent free: Social rented,135,74,59,27,32,4,11,61,22,1,14,17,7
S01007398,Rented or living rent free: Private rented or living rent free,19,11,8,1,7,0,3,8,3,0,1,3,1
S01007399,All HRPs aged 16 and over,324,204,144,42,102,22,38,120,50,5,11,38,16
S01007399,Owned: Total,101,75,64,11,53,9,2,26,21,0,2,3,0
S01007399,Owned: Owned outright,40,18,12,5,7,5,1,22,19,0,2,1,0
S01007399,Owned: Owned with a mortgage or loan or shared ownership,61,57,52,6,46,4,1,4,2,0,0,2,0
S01007399,Rented or living rent free: Total,223,129,80,31,49,13,36,94,29,5,9,35,16
S01007399,Rented or living rent free: Social rented,196,109,62,23,39,11,36,87,28,4,9,32,14
S01007399,Rented or living rent free: Private rented or living rent free,27,20,18,8,10,2,0,7,1,1,0,3,2
S01007400,All HRPs aged 16 and over,344,205,162,33,129,35,8,139,129,0,2,6,2
S01007400,Owned: Total,279,164,134,23,111,30,0,115,114,0,0,1,0
S01007400,Owned: Owned outright,160,56,45,16,29,11,0,104,103,0,0,1,0
S01007400,Owned: Owned with a mortgage or loan or shared ownership,119,108,89,7,82,19,0,11,11,0,0,0,0
S01007400,Rented or living rent free: Total,65,41,28,10,18,5,8,24,15,0,2,5,2
S01007400,Rented or living rent free: Social rented,30,18,12,6,6,2,4,12,6,0,2,3,1
S01007400,Rented or living rent free: Private rented or living rent free,35,23,16,4,12,3,4,12,9,0,0,2,1
S01007401,All HRPs aged 16 and over,290,196,163,15,148,26,7,94,84,0,4,4,2
S01007401,Owned: Total,250,167,140,10,130,23,4,83,78,0,1,2,2
S01007401,Owned: Owned outright,117,46,32,5,27,13,1,71,67,0,1,1,2
S01007401,Owned: Owned with a mortgage or loan or shared ownership,133,121,108,5,103,10,3,12,11,0,0,1,0
S01007401,Rented or living rent free: Total,40,29,23,5,18,3,3,11,6,0,3,2,0
S01007401,Rented or living rent free: Social rented,6,2,1,0,1,0,1,4,1,0,2,1,0
S01007401,Rented or living rent free: Private rented or living rent free,34,27,22,5,17,3,2,7,5,0,1,1,0
S01007402,All HRPs aged 16 and over,260,157,136,18,118,20,1,103,96,1,2,3,1
S01007402,Owned: Total,246,149,129,18,111,19,1,97,94,1,1,1,0
S01007402,Owned: Owned outright,114,33,27,9,18,6,0,81,78,1,1,1,0
S01007402,Owned: Owned with a mortgage or loan or shared ownership,132,116,102,9,93,13,1,16,16,0,0,0,0
S01007402,Rented or living rent free: Total,14,8,7,0,7,1,0,6,2,0,1,2,1
S01007402,Rented or living rent free: Social rented,5,1,1,0,1,0,0,4,1,0,1,2,0
S01007402,Rented or living rent free: Private rented or living rent free,9,7,6,0,6,1,0,2,1,0,0,0,1
S01007403,All HRPs aged 16 and over,261,229,211,14,197,16,2,32,21,0,6,2,3
S01007403,Owned: Total,132,111,97,9,88,14,0,21,19,0,0,0,2
S01007403,Owned: Owned outright,34,17,14,5,9,3,0,17,15,0,0,0,2
S01007403,Owned: Owned with a mortgage or loan or shared ownership,98,94,83,4,79,11,0,4,4,0,0,0,0
S01007403,Rented or living rent free: Total,129,118,114,5,109,2,2,11,2,0,6,2,1
S01007403,Rented or living rent free: Social rented,16,13,11,1,10,0,2,3,0,0,1,1,1
S01007403,Rented or living rent free: Private rented or living rent free,113,105,103,4,99,2,0,8,2,0,5,1,0
S01007404,All HRPs aged 16 and over,193,134,80,12,68,50,4,59,54,0,2,2,1
S01007404,Owned: Total,101,72,44,9,35,28,0,29,28,0,0,0,1
S01007404,Owned: Owned outright,53,30,19,8,11,11,0,23,23,0,0,0,0
S01007404,Owned: Owned with a mortgage or loan or shared ownership,48,42,25,1,24,17,0,6,5,0,0,0,1
S01007404,Rented or living rent free: Total,92,62,36,3,33,22,4,30,26,0,2,2,0
S01007404,Rented or living rent free: Social rented,23,9,5,1,4,3,1,14,13,0,1,0,0
S01007404,Rented or living rent free: Private rented or living rent free,69,53,31,2,29,19,3,16,13,0,1,2,0
S01007405,All HRPs aged 16 and over,277,209,152,18,134,53,4,68,63,0,1,3,1
S01007405,Owned: Total,239,182,129,13,116,50,3,57,55,0,0,1,1
S01007405,Owned: Owned outright,110,59,33,7,26,24,2,51,50,0,0,1,0
S01007405,Owned: Owned with a mortgage or loan or shared ownership,129,123,96,6,90,26,1,6,5,0,0,0,1
S01007405,Rented or living rent free: Total,38,27,23,5,18,3,1,11,8,0,1,2,0
S01007405,Rented or living rent free: Social rented,5,2,1,0,1,0,1,3,1,0,1,1,0
S01007405,Rented or living rent free: Private rented or living rent free,33,25,22,5,17,3,0,8,7,0,0,1,0
S01007406,All HRPs aged 16 and over,252,169,131,22,109,33,5,83,82,0,0,1,0
S01007406,Owned: Total,233,155,118,20,98,33,4,78,77,0,0,1,0
S01007406,Owned: Owned outright,130,60,42,13,29,17,1,70,70,0,0,0,0
S01007406,Owned: Owned with a mortgage or loan or shared ownership,103,95,76,7,69,16,3,8,7,0,0,1,0
S01007406,Rented or living rent free: Total,19,14,13,2,11,0,1,5,5,0,0,0,0
S01007406,Rented or living rent free: Social rented,2,2,2,0,2,0,0,0,0,0,0,0,0
S01007406,Rented or living rent free: Private rented or living rent free,17,12,11,2,9,0,1,5,5,0,0,0,0
S01007407,All HRPs aged 16 and over,315,195,152,14,138,39,4,120,115,0,0,5,0
S01007407,Owned: Total,265,165,131,11,120,33,1,100,98,0,0,2,0
S01007407,Owned: Owned outright,139,45,36,3,33,9,0,94,92,0,0,2,0
S01007407,Owned: Owned with a mortgage or loan or shared ownership,126,120,95,8,87,24,1,6,6,0,0,0,0
S01007407,Rented or living rent free: Total,50,30,21,3,18,6,3,20,17,0,0,3,0
S01007407,Rented or living rent free: Social rented,32,16,10,1,9,5,1,16,13,0,0,3,0
S01007407,Rented or living rent free: Private rented or living rent free,18,14,11,2,9,1,2,4,4,0,0,0,0
S01007408,All HRPs aged 16 and over,256,169,129,22,107,28,12,87,70,0,4,9,4
S01007408,Owned: Total,181,131,103,15,88,24,4,50,48,0,0,0,2
S01007408,Owned: Owned outright,70,30,17,4,13,10,3,40,40,0,0,0,0
S01007408,Owned: Owned with a mortgage or loan or shared ownership,111,101,86,11,75,14,1,10,8,0,0,0,2
S01007408,Rented or living rent free: Total,75,38,26,7,19,4,8,37,22,0,4,9,2
S01007408,Rented or living rent free: Social rented,59,30,22,6,16,3,5,29,17,0,4,7,1
S01007408,Rented or living rent free: Private rented or living rent free,16,8,4,1,3,1,3,8,5,0,0,2,1
S01007409,All HRPs aged 16 and over,308,218,190,15,175,23,5,90,72,2,4,12,0
S01007409,Owned: Total,228,181,162,11,151,18,1,47,46,1,0,0,0
S01007409,Owned: Owned outright,97,55,48,10,38,6,1,42,42,0,0,0,0
S01007409,Owned: Owned with a mortgage or loan or shared ownership,131,126,114,1,113,12,0,5,4,1,0,0,0
S01007409,Rented or living rent free: Total,80,37,28,4,24,5,4,43,26,1,4,12,0
S01007409,Rented or living rent free: Social rented,59,21,17,3,14,4,0,38,26,0,3,9,0
S01007409,Rented or living rent free: Private rented or living rent free,21,16,11,1,10,1,4,5,0,1,1,3,0
S01007410,All HRPs aged 16 and over,291,157,123,27,96,15,19,134,79,2,17,29,7
S01007410,Owned: Total,101,60,48,4,44,9,3,41,37,0,1,2,1
S01007410,Owned: Owned outright,45,14,11,4,7,2,1,31,30,0,0,1,0
S01007410,Owned: Owned with a mortgage or loan or shared ownership,56,46,37,0,37,7,2,10,7,0,1,1,1
S01007410,Rented or living rent free: Total,190,97,75,23,52,6,16,93,42,2,16,27,6
S01007410,Rented or living rent free: Social rented,166,85,65,21,44,5,15,81,38,0,13,26,4
S01007410,Rented or living rent free: Private rented or living rent free,24,12,10,2,8,1,1,12,4,2,3,1,2
S01007411,All HRPs aged 16 and over,437,248,188,29,159,26,34,189,121,7,19,37,5
S01007411,Owned: Total,155,120,101,8,93,16,3,35,33,0,0,1,1
S01007411,Owned: Owned outright,54,22,17,2,15,3,2,32,30,0,0,1,1
S01007411,Owned: Owned with a mortgage or loan or shared ownership,101,98,84,6,78,13,1,3,3,0,0,0,0
S01007411,Rented or living rent free: Total,282,128,87,21,66,10,31,154,88,7,19,36,4
S01007411,Rented or living rent free: Social rented,238,99,68,16,52,6,25,139,81,4,17,33,4
S01007411,Rented or living rent free: Private rented or living rent free,44,29,19,5,14,4,6,15,7,3,2,3,0
S01007412,All HRPs aged 16 and over,212,123,103,9,94,11,9,89,73,0,2,9,5
S01007412,Owned: Total,138,85,73,3,70,9,3,53,51,0,0,2,0
S01007412,Owned: Owned outright,71,25,21,2,19,3,1,46,45,0,0,1,0
S01007412,Owned: Owned with a mortgage or loan or shared ownership,67,60,52,1,51,6,2,7,6,0,0,1,0
S01007412,Rented or living rent free: Total,74,38,30,6,24,2,6,36,22,0,2,7,5
S01007412,Rented or living rent free: Social rented,62,31,24,5,19,1,6,31,18,0,2,7,4
S01007412,Rented or living rent free: Private rented or living rent free,12,7,6,1,5,1,0,5,4,0,0,0,1
S01007413,All HRPs aged 16 and over,360,297,257,17,240,33,7,63,45,2,6,7,3
S01007413,Owned: Total,310,268,239,13,226,29,0,42,41,0,0,1,0
S01007413,Owned: Owned outright,88,52,44,5,39,8,0,36,36,0,0,0,0
S01007413,Owned: Owned with a mortgage or loan or shared ownership,222,216,195,8,187,21,0,6,5,0,0,1,0
S01007413,Rented or living rent free: Total,50,29,18,4,14,4,7,21,4,2,6,6,3
S01007413,Rented or living rent free: Social rented,27,10,6,2,4,1,3,17,3,1,4,6,3
S01007413,Rented or living rent free: Private rented or living rent free,23,19,12,2,10,3,4,4,1,1,2,0,0
S01007414,All HRPs aged 16 and over,244,204,184,12,172,17,3,40,32,3,1,2,2
S01007414,Owned: Total,225,189,171,7,164,16,2,36,32,3,0,1,0
S01007414,Owned: Owned outright,46,18,16,3,13,1,1,28,28,0,0,0,0
S01007414,Owned: Owned with a mortgage or loan or shared ownership,179,171,155,4,151,15,1,8,4,3,0,1,0
S01007414,Rented or living rent free: Total,19,15,13,5,8,1,1,4,0,0,1,1,2
S01007414,Rented or living rent free: Social rented,7,3,3,1,2,0,0,4,0,0,1,1,2
S01007414,Rented or living rent free: Private rented or living rent free,12,12,10,4,6,1,1,0,0,0,0,0,0
S01007415,All HRPs aged 16 and over,374,235,195,32,163,19,21,139,100,2,9,27,1
S01007415,Owned: Total,195,143,124,11,113,13,6,52,48,0,0,4,0
S01007415,Owned: Owned outright,79,36,28,4,24,5,3,43,43,0,0,0,0
S01007415,Owned: Owned with a mortgage or loan or shared ownership,116,107,96,7,89,8,3,9,5,0,0,4,0
S01007415,Rented or living rent free: Total,179,92,71,21,50,6,15,87,52,2,9,23,1
S01007415,Rented or living rent free: Social rented,162,80,60,20,40,5,15,82,48,2,9,22,1
S01007415,Rented or living rent free: Private rented or living rent free,17,12,11,1,10,1,0,5,4,0,0,1,0
S01007416,All HRPs aged 16 and over,223,143,114,34,80,11,18,80,22,3,18,25,12
S01007416,Owned: Total,68,49,46,5,41,3,0,19,15,0,0,4,0
S01007416,Owned: Owned outright,24,8,7,2,5,1,0,16,13,0,0,3,0
S01007416,Owned: Owned with a mortgage or loan or shared ownership,44,41,39,3,36,2,0,3,2,0,0,1,0
S01007416,Rented or living rent free: Total,155,94,68,29,39,8,18,61,7,3,18,21,12
S01007416,Rented or living rent free: Social rented,140,83,59,28,31,8,16,57,7,2,17,20,11
S01007416,Rented or living rent free: Private rented or living rent free,15,11,9,1,8,0,2,4,0,1,1,1,1
S01007417,All HRPs aged 16 and over,406,322,274,21,253,33,15,84,73,0,3,6,2
S01007417,Owned: Total,342,269,232,11,221,29,8,73,67,0,1,4,1
S01007417,Owned: Owned outright,114,52,39,6,33,8,5,62,61,0,1,0,0
S01007417,Owned: Owned with a mortgage or loan or shared ownership,228,217,193,5,188,21,3,11,6,0,0,4,1
S01007417,Rented or living rent free: Total,64,53,42,10,32,4,7,11,6,0,2,2,1
S01007417,Rented or living rent free: Social rented,16,11,7,1,6,1,3,5,2,0,1,1,1
S01007417,Rented or living rent free: Private rented or living rent free,48,42,35,9,26,3,4,6,4,0,1,1,0
S01007418,All HRPs aged 16 and over,292,190,165,38,127,12,13,102,68,3,9,19,3
S01007418,Owned: Total,176,122,112,19,93,9,1,54,46,0,0,7,1
S01007418,Owned: Owned outright,71,27,25,12,13,2,0,44,37,0,0,6,1
S01007418,Owned: Owned with a mortgage or loan or shared ownership,105,95,87,7,80,7,1,10,9,0,0,1,0
S01007418,Rented or living rent free: Total,116,68,53,19,34,3,12,48,22,3,9,12,2
S01007418,Rented or living rent free: Social rented,93,51,40,15,25,0,11,42,19,2,7,12,2
S01007418,Rented or living rent free: Private rented or living rent free,23,17,13,4,9,3,1,6,3,1,2,0,0
S01007419,All HRPs aged 16 and over,332,231,189,46,143,15,27,101,50,5,12,23,11
S01007419,Owned: Total,144,111,96,12,84,12,3,33,26,1,0,3,3
S01007419,Owned: Owned outright,49,22,17,5,12,5,0,27,22,0,0,3,2
S01007419,Owned: Owned with a mortgage or loan or shared ownership,95,89,79,7,72,7,3,6,4,1,0,0,1
S01007419,Rented or living rent free: Total,188,120,93,34,59,3,24,68,24,4,12,20,8
S01007419,Rented or living rent free: Social rented,171,105,80,30,50,1,24,66,24,4,12,18,8
S01007419,Rented or living rent free: Private rented or living rent free,17,15,13,4,9,2,0,2,0,0,0,2,0
S01007420,All HRPs aged 16 and over,296,247,209,22,187,33,5,49,40,2,1,5,1
S01007420,Owned: Total,244,208,177,14,163,29,2,36,34,0,1,1,0
S01007420,Owned: Owned outright,72,39,31,8,23,6,2,33,32,0,1,0,0
S01007420,Owned: Owned with a mortgage or loan or shared ownership,172,169,146,6,140,23,0,3,2,0,0,1,0
S01007420,Rented or living rent free: Total,52,39,32,8,24,4,3,13,6,2,0,4,1
S01007420,Rented or living rent free: Social rented,16,7,5,3,2,0,2,9,3,1,0,4,1
S01007420,Rented or living rent free: Private rented or living rent free,36,32,27,5,22,4,1,4,3,1,0,0,0
S01007421,All HRPs aged 16 and over,282,209,170,19,151,30,9,73,62,0,5,3,3
S01007421,Owned: Total,209,164,137,9,128,26,1,45,40,0,3,1,1
S01007421,Owned: Owned outright,65,35,28,4,24,6,1,30,28,0,1,1,0
S01007421,Owned: Owned with a mortgage or loan or shared ownership,144,129,109,5,104,20,0,15,12,0,2,0,1
S01007421,Rented or living rent free: Total,73,45,33,10,23,4,8,28,22,0,2,2,2
S01007421,Rented or living rent free: Social rented,48,25,19,5,14,1,5,23,18,0,1,2,2
S01007421,Rented or living rent free: Private rented or living rent free,25,20,14,5,9,3,3,5,4,0,1,0,0
S01007422,All HRPs aged 16 and over,261,180,149,23,126,22,9,81,65,1,3,9,3
S01007422,Owned: Total,202,148,124,18,106,21,3,54,49,0,1,3,1
S01007422,Owned: Owned outright,86,38,31,5,26,6,1,48,45,0,1,1,1
S01007422,Owned: Owned with a mortgage or loan or shared ownership,116,110,93,13,80,15,2,6,4,0,0,2,0
S01007422,Rented or living rent free: Total,59,32,25,5,20,1,6,27,16,1,2,6,2
S01007422,Rented or living rent free: Social rented,38,18,13,4,9,1,4,20,13,1,1,5,0
S01007422,Rented or living rent free: Private rented or living rent free,21,14,12,1,11,0,2,7,3,0,1,1,2
S01007423,All HRPs aged 16 and over,325,237,207,21,186,24,6,88,75,1,1,9,2
S01007423,Owned: Total,236,184,162,11,151,20,2,52,49,0,0,2,1
S01007423,Owned: Owned outright,80,33,30,7,23,2,1,47,45,0,0,2,0
S01007423,Owned: Owned with a mortgage or loan or shared ownership,156,151,132,4,128,18,1,5,4,0,0,0,1
S01007423,Rented or living rent free: Total,89,53,45,10,35,4,4,36,26,1,1,7,1
S01007423,Rented or living rent free: Social rented,54,27,25,7,18,0,2,27,20,0,1,5,1
S01007423,Rented or living rent free: Private rented or living rent free,35,26,20,3,17,4,2,9,6,1,0,2,0
S01007424,All HRPs aged 16 and over,340,214,197,27,170,17,0,126,119,1,5,1,0
S01007424,Owned: Total,311,194,178,22,156,16,0,117,112,1,3,1,0
S01007424,Owned: Owned outright,176,69,61,14,47,8,0,107,104,1,1,1,0
S01007424,Owned: Owned with a mortgage or loan or shared ownership,135,125,117,8,109,8,0,10,8,0,2,0,0
S01007424,Rented or living rent free: Total,29,20,19,5,14,1,0,9,7,0,2,0,0
S01007424,Rented or living rent free: Social rented,8,5,5,2,3,0,0,3,3,0,0,0,0
S01007424,Rented or living rent free: Private rented or living rent free,21,15,14,3,11,1,0,6,4,0,2,0,0
S01007425,All HRPs aged 16 and over,373,246,204,29,175,24,18,127,107,2,5,11,2
S01007425,Owned: Total,293,192,170,19,151,19,3,101,96,2,1,2,0
S01007425,Owned: Owned outright,156,70,57,13,44,11,2,86,84,0,1,1,0
S01007425,Owned: Owned with a mortgage or loan or shared ownership,137,122,113,6,107,8,1,15,12,2,0,1,0
S01007425,Rented or living rent free: Total,80,54,34,10,24,5,15,26,11,0,4,9,2
S01007425,Rented or living rent free: Social rented,64,41,23,8,15,5,13,23,11,0,2,8,2
S01007425,Rented or living rent free: Private rented or living rent free,16,13,11,2,9,0,2,3,0,0,2,1,0
S01007426,All HRPs aged 16 and over,344,201,161,21,140,21,19,143,111,10,6,13,3
S01007426,Owned: Total,198,122,105,10,95,16,1,76,70,2,0,3,1
S01007426,Owned: Owned outright,92,27,23,7,16,4,0,65,63,0,0,2,0
S01007426,Owned: Owned with a mortgage or loan or shared ownership,106,95,82,3,79,12,1,11,7,2,0,1,1
S01007426,Rented or living rent free: Total,146,79,56,11,45,5,18,67,41,8,6,10,2
S01007426,Rented or living rent free: Social rented,99,47,30,8,22,1,16,52,37,3,5,5,2
S01007426,Rented or living rent free: Private rented or living rent free,47,32,26,3,23,4,2,15,4,5,1,5,0
S01007427,All HRPs aged 16 and over,309,185,148,26,122,12,25,124,98,1,6,16,3
S01007427,Owned: Total,170,107,97,13,84,8,2,63,61,0,0,2,0
S01007427,Owned: Owned outright,86,31,27,7,20,3,1,55,55,0,0,0,0
S01007427,Owned: Owned with a mortgage or loan or shared ownership,84,76,70,6,64,5,1,8,6,0,0,2,0
S01007427,Rented or living rent free: Total,139,78,51,13,38,4,23,61,37,1,6,14,3
S01007427,Rented or living rent free: Social rented,120,67,44,9,35,3,20,53,34,0,4,13,2
S01007427,Rented or living rent free: Private rented or living rent free,19,11,7,4,3,1,3,8,3,1,2,1,1
S01007428,All HRPs aged 16 and over,465,279,230,34,196,23,26,186,148,4,5,20,9
S01007428,Owned: Total,271,182,159,13,146,17,6,89,78,1,2,5,3
S01007428,Owned: Owned outright,118,41,32,5,27,5,4,77,69,1,1,3,3
S01007428,Owned: Owned with a mortgage or loan or shared ownership,153,141,127,8,119,12,2,12,9,0,1,2,0
S01007428,Rented or living rent free: Total,194,97,71,21,50,6,20,97,70,3,3,15,6
S01007428,Rented or living rent free: Social rented,123,42,29,9,20,4,9,81,62,2,1,11,5
S01007428,Rented or living rent free: Private rented or living rent free,71,55,42,12,30,2,11,16,8,1,2,4,1
S01007429,All HRPs aged 16 and over,324,230,197,28,169,23,10,94,74,1,1,15,3
S01007429,Owned: Total,213,160,141,17,124,18,1,53,49,0,0,3,1
S01007429,Owned: Owned outright,79,33,30,5,25,3,0,46,43,0,0,2,1
S01007429,Owned: Owned with a mortgage or loan or shared ownership,134,127,111,12,99,15,1,7,6,0,0,1,0
S01007429,Rented or living rent free: Total,111,70,56,11,45,5,9,41,25,1,1,12,2
S01007429,Rented or living rent free: Social rented,62,28,23,8,15,0,5,34,20,1,1,10,2
S01007429,Rented or living rent free: Private rented or living rent free,49,42,33,3,30,5,4,7,5,0,0,2,0
S01007430,All HRPs aged 16 and over,211,131,102,21,81,21,8,80,74,3,1,1,1
S01007430,Owned: Total,133,89,72,13,59,15,2,44,44,0,0,0,0
S01007430,Owned: Owned outright,68,28,23,8,15,4,1,40,40,0,0,0,0
S01007430,Owned: Owned with a mortgage or loan or shared ownership,65,61,49,5,44,11,1,4,4,0,0,0,0
S01007430,Rented or living rent free: Total,78,42,30,8,22,6,6,36,30,3,1,1,1
S01007430,Rented or living rent free: Social rented,30,16,15,5,10,1,0,14,10,1,1,1,1
S01007430,Rented or living rent free: Private rented or living rent free,48,26,15,3,12,5,6,22,20,2,0,0,0
S01007431,All HRPs aged 16 and over,218,151,133,16,117,15,3,67,61,0,1,3,2
S01007431,Owned: Total,201,143,128,15,113,13,2,58,55,0,0,1,2
S01007431,Owned: Owned outright,96,45,41,10,31,2,2,51,50,0,0,0,1
S01007431,Owned: Owned with a mortgage or loan or shared ownership,105,98,87,5,82,11,0,7,5,0,0,1,1
S01007431,Rented or living rent free: Total,17,8,5,1,4,2,1,9,6,0,1,2,0
S01007431,Rented or living rent free: Social rented,10,7,5,1,4,1,1,3,1,0,1,1,0
S01007431,Rented or living rent free: Private rented or living rent free,7,1,0,0,0,1,0,6,5,0,0,1,0
S01007432,All HRPs aged 16 and over,354,227,195,28,167,26,6,127,112,1,4,9,1
S01007432,Owned: Total,270,179,156,19,137,20,3,91,87,0,0,3,1
S01007432,Owned: Owned outright,111,35,30,8,22,5,0,76,72,0,0,3,1
S01007432,Owned: Owned with a mortgage or loan or shared ownership,159,144,126,11,115,15,3,15,15,0,0,0,0
S01007432,Rented or living rent free: Total,84,48,39,9,30,6,3,36,25,1,4,6,0
S01007432,Rented or living rent free: Social rented,56,31,23,5,18,5,3,25,18,0,2,5,0
S01007432,Rented or living rent free: Private rented or living rent free,28,17,16,4,12,1,0,11,7,1,2,1,0
S01007433,All HRPs aged 16 and over,350,212,164,22,142,39,9,138,117,0,2,13,6
S01007433,Owned: Total,238,156,124,11,113,31,1,82,77,0,2,1,2
S01007433,Owned: Owned outright,112,43,29,8,21,14,0,69,64,0,2,1,2
S01007433,Owned: Owned with a mortgage or loan or shared ownership,126,113,95,3,92,17,1,13,13,0,0,0,0
S01007433,Rented or living rent free: Total,112,56,40,11,29,8,8,56,40,0,0,12,4
S01007433,Rented or living rent free: Social rented,70,27,21,6,15,1,5,43,33,0,0,9,1
S01007433,Rented or living rent free: Private rented or living rent free,42,29,19,5,14,7,3,13,7,0,0,3,3
S01007434,All HRPs aged 16 and over,242,157,118,26,92,17,22,85,44,0,11,28,2
S01007434,Owned: Total,107,79,67,8,59,11,1,28,23,0,0,4,1
S01007434,Owned: Owned outright,40,17,14,4,10,3,0,23,20,0,0,2,1
S01007434,Owned: Owned with a mortgage or loan or shared ownership,67,62,53,4,49,8,1,5,3,0,0,2,0
S01007434,Rented or living rent free: Total,135,78,51,18,33,6,21,57,21,0,11,24,1
S01007434,Rented or living rent free: Social rented,111,60,37,10,27,3,20,51,21,0,8,22,0
S01007434,Rented or living rent free: Private rented or living rent free,24,18,14,8,6,3,1,6,0,0,3,2,1
S01007435,All HRPs aged 16 and over,327,224,188,27,161,22,14,103,88,3,2,10,0
S01007435,Owned: Total,229,167,147,16,131,13,7,62,60,0,0,2,0
S01007435,Owned: Owned outright,92,41,35,6,29,4,2,51,50,0,0,1,0
S01007435,Owned: Owned with a mortgage or loan or shared ownership,137,126,112,10,102,9,5,11,10,0,0,1,0
S01007435,Rented or living rent free: Total,98,57,41,11,30,9,7,41,28,3,2,8,0
S01007435,Rented or living rent free: Social rented,62,28,20,9,11,2,6,34,23,1,2,8,0
S01007435,Rented or living rent free: Private rented or living rent free,36,29,21,2,19,7,1,7,5,2,0,0,0
S01007436,All HRPs aged 16 and over,356,217,187,42,145,12,18,139,88,6,11,21,13
S01007436,Owned: Total,138,101,89,13,76,9,3,37,33,1,0,3,0
S01007436,Owned: Owned outright,46,14,11,3,8,3,0,32,30,0,0,2,0
S01007436,Owned: Owned with a mortgage or loan or shared ownership,92,87,78,10,68,6,3,5,3,1,0,1,0
S01007436,Rented or living rent free: Total,218,116,98,29,69,3,15,102,55,5,11,18,13
S01007436,Rented or living rent free: Social rented,185,94,78,27,51,2,14,91,52,3,9,16,11
S01007436,Rented or living rent free: Private rented or living rent free,33,22,20,2,18,1,1,11,3,2,2,2,2
S01007437,All HRPs aged 16 and over,230,147,113,20,93,15,19,83,55,3,10,11,4
S01007437,Owned: Total,110,80,69,9,60,11,0,30,29,0,0,1,0
S01007437,Owned: Owned outright,56,29,22,3,19,7,0,27,26,0,0,1,0
S01007437,Owned: Owned with a mortgage or loan or shared ownership,54,51,47,6,41,4,0,3,3,0,0,0,0
S01007437,Rented or living rent free: Total,120,67,44,11,33,4,19,53,26,3,10,10,4
S01007437,Rented or living rent free: Social rented,91,50,31,10,21,2,17,41,23,2,6,6,4
S01007437,Rented or living rent free: Private rented or living rent free,29,17,13,1,12,2,2,12,3,1,4,4,0
S01007438,All HRPs aged 16 and over,338,211,169,22,147,19,23,127,93,0,9,15,10
S01007438,Owned: Total,195,139,118,11,107,17,4,56,52,0,0,3,1
S01007438,Owned: Owned outright,98,50,41,10,31,7,2,48,46,0,0,1,1
S01007438,Owned: Owned with a mortgage or loan or shared ownership,97,89,77,1,76,10,2,8,6,0,0,2,0
S01007438,Rented or living rent free: Total,143,72,51,11,40,2,19,71,41,0,9,12,9
S01007438,Rented or living rent free: Social rented,117,52,34,6,28,2,16,65,37,0,8,11,9
S01007438,Rented or living rent free: Private rented or living rent free,26,20,17,5,12,0,3,6,4,0,1,1,0
S01007439,All HRPs aged 16 and over,337,201,172,19,153,21,8,136,118,5,2,9,2
S01007439,Owned: Total,232,143,124,12,112,18,1,89,83,3,0,2,1
S01007439,Owned: Owned outright,106,36,28,6,22,7,1,70,68,0,0,1,1
S01007439,Owned: Owned with a mortgage or loan or shared ownership,126,107,96,6,90,11,0,19,15,3,0,1,0
S01007439,Rented or living rent free: Total,105,58,48,7,41,3,7,47,35,2,2,7,1
S01007439,Rented or living rent free: Social rented,69,31,24,3,21,3,4,38,29,1,1,6,1
S01007439,Rented or living rent free: Private rented or living rent free,36,27,24,4,20,0,3,9,6,1,1,1,0
S01007440,All HRPs aged 16 and over,295,184,158,26,132,19,7,111,93,2,1,12,3
S01007440,Owned: Total,183,135,121,10,111,12,2,48,44,1,0,3,0
S01007440,Owned: Owned outright,78,41,33,7,26,6,2,37,34,1,0,2,0
S01007440,Owned: Owned with a mortgage or loan or shared ownership,105,94,88,3,85,6,0,11,10,0,0,1,0
S01007440,Rented or living rent free: Total,112,49,37,16,21,7,5,63,49,1,1,9,3
S01007440,Rented or living rent free: Social rented,102,42,33,15,18,4,5,60,46,1,1,9,3
S01007440,Rented or living rent free: Private rented or living rent free,10,7,4,1,3,3,0,3,3,0,0,0,0
S01007441,All HRPs aged 16 and over,226,157,140,13,127,16,1,69,66,1,1,1,0
S01007441,Owned: Total,213,148,133,12,121,15,0,65,63,1,1,0,0
S01007441,Owned: Owned outright,95,38,32,7,25,6,0,57,56,0,1,0,0
S01007441,Owned: Owned with a mortgage or loan or shared ownership,118,110,101,5,96,9,0,8,7,1,0,0,0
S01007441,Rented or living rent free: Total,13,9,7,1,6,1,1,4,3,0,0,1,0
S01007441,Rented or living rent free: Social rented,7,3,2,0,2,1,0,4,3,0,0,1,0
S01007441,Rented or living rent free: Private rented or living rent free,6,6,5,1,4,0,1,0,0,0,0,0,0
S01007442,All HRPs aged 16 and over,198,131,107,12,95,23,1,67,60,0,0,4,3
S01007442,Owned: Total,187,125,102,12,90,22,1,62,57,0,0,2,3
S01007442,Owned: Owned outright,104,47,35,9,26,12,0,57,55,0,0,0,2
S01007442,Owned: Owned with a mortgage or loan or shared ownership,83,78,67,3,64,10,1,5,2,0,0,2,1
S01007442,Rented or living rent free: Total,11,6,5,0,5,1,0,5,3,0,0,2,0
S01007442,Rented or living rent free: Social rented,2,0,0,0,0,0,0,2,0,0,0,2,0
S01007442,Rented or living rent free: Private rented or living rent free,9,6,5,0,5,1,0,3,3,0,0,0,0
S01007443,All HRPs aged 16 and over,387,208,156,21,135,47,5,179,164,0,1,11,3
S01007443,Owned: Total,285,157,118,13,105,38,1,128,125,0,0,1,2
S01007443,Owned: Owned outright,171,54,39,10,29,15,0,117,114,0,0,1,2
S01007443,Owned: Owned with a mortgage or loan or shared ownership,114,103,79,3,76,23,1,11,11,0,0,0,0
S01007443,Rented or living rent free: Total,102,51,38,8,30,9,4,51,39,0,1,10,1
S01007443,Rented or living rent free: Social rented,68,24,21,6,15,1,2,44,33,0,1,10,0
S01007443,Rented or living rent free: Private rented or living rent free,34,27,17,2,15,8,2,7,6,0,0,0,1
S01007444,All HRPs aged 16 and over,427,253,190,28,162,60,3,174,158,0,4,6,6
S01007444,Owned: Total,364,217,164,23,141,53,0,147,135,0,3,4,5
S01007444,Owned: Owned outright,205,75,56,14,42,19,0,130,122,0,2,2,4
S01007444,Owned: Owned with a mortgage or loan or shared ownership,159,142,108,9,99,34,0,17,13,0,1,2,1
S01007444,Rented or living rent free: Total,63,36,26,5,21,7,3,27,23,0,1,2,1
S01007444,Rented or living rent free: Social rented,35,17,15,4,11,1,1,18,14,0,1,2,1
S01007444,Rented or living rent free: Private rented or living rent free,28,19,11,1,10,6,2,9,9,0,0,0,0
S01007445,All HRPs aged 16 and over,265,174,140,16,124,31,3,91,82,0,3,3,3
S01007445,Owned: Total,242,161,127,11,116,31,3,81,78,0,1,0,2
S01007445,Owned: Owned outright,130,55,42,9,33,13,0,75,73,0,1,0,1
S01007445,Owned: Owned with a mortgage or loan or shared ownership,112,106,85,2,83,18,3,6,5,0,0,0,1
S01007445,Rented or living rent free: Total,23,13,13,5,8,0,0,10,4,0,2,3,1
S01007445,Rented or living rent free: Social rented,10,3,3,1,2,0,0,7,2,0,2,2,1
S01007445,Rented or living rent free: Private rented or living rent free,13,10,10,4,6,0,0,3,2,0,0,1,0
S01007446,All HRPs aged 16 and over,201,147,111,19,92,33,3,54,51,1,0,2,0
S01007446,Owned: Total,180,132,100,16,84,30,2,48,48,0,0,0,0
S01007446,Owned: Owned outright,94,47,32,10,22,14,1,47,47,0,0,0,0
S01007446,Owned: Owned with a mortgage or loan or shared ownership,86,85,68,6,62,16,1,1,1,0,0,0,0
S01007446,Rented or living rent free: Total,21,15,11,3,8,3,1,6,3,1,0,2,0
S01007446,Rented or living rent free: Social rented,4,0,0,0,0,0,0,4,2,1,0,1,0
S01007446,Rented or living rent free: Private rented or living rent free,17,15,11,3,8,3,1,2,1,0,0,1,0
S01007447,All HRPs aged 16 and over,209,138,97,14,83,39,2,71,68,0,2,1,0
S01007447,Owned: Total,185,123,86,11,75,35,2,62,60,0,2,0,0
S01007447,Owned: Owned outright,117,59,39,9,30,19,1,58,58,0,0,0,0
S01007447,Owned: Owned with a mortgage or loan or shared ownership,68,64,47,2,45,16,1,4,2,0,2,0,0
S01007447,Rented or living rent free: Total,24,15,11,3,8,4,0,9,8,0,0,1,0
S01007447,Rented or living rent free: Social rented,7,4,4,2,2,0,0,3,2,0,0,1,0
S01007447,Rented or living rent free: Private rented or living rent free,17,11,7,1,6,4,0,6,6,0,0,0,0
S01007448,All HRPs aged 16 and over,367,238,180,22,158,52,6,129,116,0,2,6,5
S01007448,Owned: Total,314,207,156,17,139,48,3,107,103,0,1,1,2
S01007448,Owned: Owned outright,176,76,49,11,38,26,1,100,97,0,0,1,2
S01007448,Owned: Owned with a mortgage or loan or shared ownership,138,131,107,6,101,22,2,7,6,0,1,0,0
S01007448,Rented or living rent free: Total,53,31,24,5,19,4,3,22,13,0,1,5,3
S01007448,Rented or living rent free: Social rented,28,17,11,4,7,3,3,11,5,0,1,3,2
S01007448,Rented or living rent free: Private rented or living rent free,25,14,13,1,12,1,0,11,8,0,0,2,1
S01007449,All HRPs aged 16 and over,458,292,230,37,193,24,38,166,128,6,6,19,7
S01007449,Owned: Total,256,171,150,17,133,16,5,85,84,0,0,1,0
S01007449,Owned: Owned outright,127,50,40,13,27,8,2,77,76,0,0,1,0
S01007449,Owned: Owned with a mortgage or loan or shared ownership,129,121,110,4,106,8,3,8,8,0,0,0,0
S01007449,Rented or living rent free: Total,202,121,80,20,60,8,33,81,44,6,6,18,7
S01007449,Rented or living rent free: Social rented,166,97,66,17,49,5,26,69,42,4,2,14,7
S01007449,Rented or living rent free: Private rented or living rent free,36,24,14,3,11,3,7,12,2,2,4,4,0
S01007450,All HRPs aged 16 and over,332,199,153,34,119,18,28,133,80,4,13,29,7
S01007450,Owned: Total,145,104,93,14,79,9,2,41,34,0,0,4,3
S01007450,Owned: Owned outright,64,32,27,10,17,4,1,32,27,0,0,2,3
S01007450,Owned: Owned with a mortgage or loan or shared ownership,81,72,66,4,62,5,1,9,7,0,0,2,0
S01007450,Rented or living rent free: Total,187,95,60,20,40,9,26,92,46,4,13,25,4
S01007450,Rented or living rent free: Social rented,157,78,50,15,35,8,20,79,45,2,9,19,4
S01007450,Rented or living rent free: Private rented or living rent free,30,17,10,5,5,1,6,13,1,2,4,6,0
S01007451,All HRPs aged 16 and over,283,180,156,27,129,17,7,103,89,1,2,11,0
S01007451,Owned: Total,205,146,130,21,109,14,2,59,58,0,0,1,0
S01007451,Owned: Owned outright,87,37,33,13,20,3,1,50,49,0,0,1,0
S01007451,Owned: Owned with a mortgage or loan or shared ownership,118,109,97,8,89,11,1,9,9,0,0,0,0
S01007451,Rented or living rent free: Total,78,34,26,6,20,3,5,44,31,1,2,10,0
S01007451,Rented or living rent free: Social rented,60,25,20,6,14,1,4,35,26,0,1,8,0
S01007451,Rented or living rent free: Private rented or living rent free,18,9,6,0,6,2,1,9,5,1,1,2,0
S01007452,All HRPs aged 16 and over,209,138,94,15,79,30,14,71,55,1,5,9,1
S01007452,Owned: Total,109,70,48,4,44,21,1,39,37,0,0,1,1
S01007452,Owned: Owned outright,49,19,11,4,7,8,0,30,30,0,0,0,0
S01007452,Owned: Owned with a mortgage or loan or shared ownership,60,51,37,0,37,13,1,9,7,0,0,1,1
S01007452,Rented or living rent free: Total,100,68,46,11,35,9,13,32,18,1,5,8,0
S01007452,Rented or living rent free: Social rented,79,50,34,7,27,6,10,29,18,1,3,7,0
S01007452,Rented or living rent free: Private rented or living rent free,21,18,12,4,8,3,3,3,0,0,2,1,0
S01007453,All HRPs aged 16 and over,212,187,165,7,158,20,2,25,16,0,4,3,2
S01007453,Owned: Total,194,174,156,7,149,17,1,20,16,0,1,1,2
S01007453,Owned: Owned outright,32,18,15,2,13,3,0,14,12,0,0,0,2
S01007453,Owned: Owned with a mortgage or loan or shared ownership,162,156,141,5,136,14,1,6,4,0,1,1,0
S01007453,Rented or living rent free: Total,18,13,9,0,9,3,1,5,0,0,3,2,0
S01007453,Rented or living rent free: Social rented,5,2,2,0,2,0,0,3,0,0,2,1,0
S01007453,Rented or living rent free: Private rented or living rent free,13,11,7,0,7,3,1,2,0,0,1,1,0
S01007454,All HRPs aged 16 and over,190,130,110,19,91,16,4,60,44,0,3,8,5
S01007454,Owned: Total,111,81,67,8,59,13,1,30,30,0,0,0,0
S01007454,Owned: Owned outright,50,27,22,3,19,4,1,23,23,0,0,0,0
S01007454,Owned: Owned with a mortgage or loan or shared ownership,61,54,45,5,40,9,0,7,7,0,0,0,0
S01007454,Rented or living rent free: Total,79,49,43,11,32,3,3,30,14,0,3,8,5
S01007454,Rented or living rent free: Social rented,61,32,28,8,20,1,3,29,13,0,3,8,5
S01007454,Rented or living rent free: Private rented or living rent free,18,17,15,3,12,2,0,1,1,0,0,0,0
S01007455,All HRPs aged 16 and over,388,245,205,33,172,14,26,143,82,4,19,30,8
S01007455,Owned: Total,149,108,96,5,91,11,1,41,38,2,0,0,1
S01007455,Owned: Owned outright,61,27,20,1,19,6,1,34,33,0,0,0,1
S01007455,Owned: Owned with a mortgage or loan or shared ownership,88,81,76,4,72,5,0,7,5,2,0,0,0
S01007455,Rented or living rent free: Total,239,137,109,28,81,3,25,102,44,2,19,30,7
S01007455,Rented or living rent free: Social rented,210,119,95,25,70,2,22,91,41,2,13,28,7
S01007455,Rented or living rent free: Private rented or living rent free,29,18,14,3,11,1,3,11,3,0,6,2,0
S01007456,All HRPs aged 16 and over,394,256,207,48,159,17,32,138,75,3,16,30,14
S01007456,Owned: Total,147,112,100,13,87,10,2,35,31,0,2,2,0
S01007456,Owned: Owned outright,53,25,24,6,18,1,0,28,25,0,1,2,0
S01007456,Owned: Owned with a mortgage or loan or shared ownership,94,87,76,7,69,9,2,7,6,0,1,0,0
S01007456,Rented or living rent free: Total,247,144,107,35,72,7,30,103,44,3,14,28,14
S01007456,Rented or living rent free: Social rented,199,105,78,28,50,3,24,94,42,3,11,25,13
S01007456,Rented or living rent free: Private rented or living rent free,48,39,29,7,22,4,6,9,2,0,3,3,1
S01007457,All HRPs aged 16 and over,465,312,246,22,224,26,40,153,93,6,7,34,13
S01007457,Owned: Total,237,179,154,15,139,22,3,58,52,2,0,3,1
S01007457,Owned: Owned outright,89,37,31,7,24,5,1,52,48,0,0,3,1
S01007457,Owned: Owned with a mortgage or loan or shared ownership,148,142,123,8,115,17,2,6,4,2,0,0,0
S01007457,Rented or living rent free: Total,228,133,92,7,85,4,37,95,41,4,7,31,12
S01007457,Rented or living rent free: Social rented,190,105,70,4,66,3,32,85,36,3,7,28,11
S01007457,Rented or living rent free: Private rented or living rent free,38,28,22,3,19,1,5,10,5,1,0,3,1
S01007458,All HRPs aged 16 and over,224,146,134,20,114,11,1,78,71,1,2,3,1
S01007458,Owned: Total,192,129,120,13,107,9,0,63,61,1,0,0,1
S01007458,Owned: Owned outright,96,41,39,8,31,2,0,55,54,0,0,0,1
S01007458,Owned: Owned with a mortgage or loan or shared ownership,96,88,81,5,76,7,0,8,7,1,0,0,0
S01007458,Rented or living rent free: Total,32,17,14,7,7,2,1,15,10,0,2,3,0
S01007458,Rented or living rent free: Social rented,23,10,7,3,4,2,1,13,8,0,2,3,0
S01007458,Rented or living rent free: Private rented or living rent free,9,7,7,4,3,0,0,2,2,0,0,0,0
S01007459,All HRPs aged 16 and over,291,155,136,16,120,16,3,136,123,0,2,10,1
S01007459,Owned: Total,199,123,109,12,97,13,1,76,75,0,0,1,0
S01007459,Owned: Owned outright,98,34,28,4,24,5,1,64,63,0,0,1,0
S01007459,Owned: Owned with a mortgage or loan or shared ownership,101,89,81,8,73,8,0,12,12,0,0,0,0
S01007459,Rented or living rent free: Total,92,32,27,4,23,3,2,60,48,0,2,9,1
S01007459,Rented or living rent free: Social rented,74,19,18,3,15,0,1,55,44,0,2,8,1
S01007459,Rented or living rent free: Private rented or living rent free,18,13,9,1,8,3,1,5,4,0,0,1,0
S01007460,All HRPs aged 16 and over,345,204,157,18,139,28,19,141,100,1,8,26,6
S01007460,Owned: Total,190,128,107,8,99,19,2,62,58,1,3,0,0
S01007460,Owned: Owned outright,82,30,23,4,19,6,1,52,49,1,2,0,0
S01007460,Owned: Owned with a mortgage or loan or shared ownership,108,98,84,4,80,13,1,10,9,0,1,0,0
S01007460,Rented or living rent free: Total,155,76,50,10,40,9,17,79,42,0,5,26,6
S01007460,Rented or living rent free: Social rented,130,56,37,9,28,5,14,74,39,0,5,24,6
S01007460,Rented or living rent free: Private rented or living rent free,25,20,13,1,12,4,3,5,3,0,0,2,0
S01007461,All HRPs aged 16 and over,372,223,162,45,117,14,47,149,80,0,12,49,8
S01007461,Owned: Total,92,60,51,5,46,7,2,32,30,0,0,2,0
S01007461,Owned: Owned outright,38,12,7,2,5,4,1,26,24,0,0,2,0
S01007461,Owned: Owned with a mortgage or loan or shared ownership,54,48,44,3,41,3,1,6,6,0,0,0,0
S01007461,Rented or living rent free: Total,280,163,111,40,71,7,45,117,50,0,12,47,8
S01007461,Rented or living rent free: Social rented,237,128,87,34,53,4,37,109,46,0,9,46,8
S01007461,Rented or living rent free: Private rented or living rent free,43,35,24,6,18,3,8,8,4,0,3,1,0
S01007462,All HRPs aged 16 and over,371,271,226,27,199,31,14,100,63,0,7,22,8
S01007462,Owned: Total,212,168,147,14,133,21,0,44,40,0,0,3,1
S01007462,Owned: Owned outright,78,43,37,5,32,6,0,35,33,0,0,1,1
S01007462,Owned: Owned with a mortgage or loan or shared ownership,134,125,110,9,101,15,0,9,7,0,0,2,0
S01007462,Rented or living rent free: Total,159,103,79,13,66,10,14,56,23,0,7,19,7
S01007462,Rented or living rent free: Social rented,86,43,29,12,17,2,12,43,15,0,6,16,6
S01007462,Rented or living rent free: Private rented or living rent free,73,60,50,1,49,8,2,13,8,0,1,3,1
S01007463,All HRPs aged 16 and over,377,212,151,47,104,24,37,165,73,3,28,41,20
S01007463,Owned: Total,108,66,53,9,44,12,1,42,38,1,0,3,0
S01007463,Owned: Owned outright,38,10,5,3,2,4,1,28,25,1,0,2,0
S01007463,Owned: Owned with a mortgage or loan or shared ownership,70,56,48,6,42,8,0,14,13,0,0,1,0
S01007463,Rented or living rent free: Total,269,146,98,38,60,12,36,123,35,2,28,38,20
S01007463,Rented or living rent free: Social rented,250,133,87,36,51,12,34,117,34,2,25,37,19
S01007463,Rented or living rent free: Private rented or living rent free,19,13,11,2,9,0,2,6,1,0,3,1,1
S01007464,All HRPs aged 16 and over,313,162,132,18,114,8,22,151,89,1,11,35,15
S01007464,Owned: Total,91,56,50,3,47,5,1,35,34,0,0,0,1
S01007464,Owned: Owned outright,43,10,9,2,7,1,0,33,33,0,0,0,0
S01007464,Owned: Owned with a mortgage or loan or shared ownership,48,46,41,1,40,4,1,2,1,0,0,0,1
S01007464,Rented or living rent free: Total,222,106,82,15,67,3,21,116,55,1,11,35,14
S01007464,Rented or living rent free: Social rented,201,93,76,13,63,1,16,108,52,1,7,34,14
S01007464,Rented or living rent free: Private rented or living rent free,21,13,6,2,4,2,5,8,3,0,4,1,0
S01007465,All HRPs aged 16 and over,380,207,140,35,105,15,52,173,72,5,18,53,25
S01007465,Owned: Total,83,59,50,6,44,7,2,24,22,0,1,1,0
S01007465,Owned: Owned outright,28,10,8,2,6,1,1,18,18,0,0,0,0
S01007465,Owned: Owned with a mortgage or loan or shared ownership,55,49,42,4,38,6,1,6,4,0,1,1,0
S01007465,Rented or living rent free: Total,297,148,90,29,61,8,50,149,50,5,17,52,25
S01007465,Rented or living rent free: Social rented,262,126,82,28,54,2,42,136,47,4,16,44,25
S01007465,Rented or living rent free: Private rented or living rent free,35,22,8,1,7,6,8,13,3,1,1,8,0
S01007466,All HRPs aged 16 and over,581,335,255,66,189,23,57,246,122,8,11,88,17
S01007466,Owned: Total,157,109,96,12,84,10,3,48,37,0,1,8,2
S01007466,Owned: Owned outright,57,20,17,7,10,2,1,37,30,0,1,4,2
S01007466,Owned: Owned with a mortgage or loan or shared ownership,100,89,79,5,74,8,2,11,7,0,0,4,0
S01007466,Rented or living rent free: Total,424,226,159,54,105,13,54,198,85,8,10,80,15
S01007466,Rented or living rent free: Social rented,302,136,96,38,58,7,33,166,78,7,5,63,13
S01007466,Rented or living rent free: Private rented or living rent free,122,90,63,16,47,6,21,32,7,1,5,17,2
S01007467,All HRPs aged 16 and over,523,290,246,39,207,22,22,233,167,3,9,42,12
S01007467,Owned: Total,271,180,159,14,145,19,2,91,84,0,1,5,1
S01007467,Owned: Owned outright,128,50,42,7,35,7,1,78,76,0,0,1,1
S01007467,Owned: Owned with a mortgage or loan or shared ownership,143,130,117,7,110,12,1,13,8,0,1,4,0
S01007467,Rented or living rent free: Total,252,110,87,25,62,3,20,142,83,3,8,37,11
S01007467,Rented or living rent free: Social rented,159,43,28,7,21,1,14,116,79,1,5,26,5
S01007467,Rented or living rent free: Private rented or living rent free,93,67,59,18,41,2,6,26,4,2,3,11,6
S01007468,All HRPs aged 16 and over,333,251,217,20,197,27,7,82,75,0,0,5,2
S01007468,Owned: Total,291,219,189,14,175,25,5,72,72,0,0,0,0
S01007468,Owned: Owned outright,113,50,46,9,37,2,2,63,63,0,0,0,0
S01007468,Owned: Owned with a mortgage or loan or shared ownership,178,169,143,5,138,23,3,9,9,0,0,0,0
S01007468,Rented or living rent free: Total,42,32,28,6,22,2,2,10,3,0,0,5,2
S01007468,Rented or living rent free: Social rented,13,9,8,2,6,0,1,4,1,0,0,3,0
S01007468,Rented or living rent free: Private rented or living rent free,29,23,20,4,16,2,1,6,2,0,0,2,2
S01007469,All HRPs aged 16 and over,250,179,153,27,126,12,14,71,55,1,3,7,5
S01007469,Owned: Total,160,118,108,16,92,7,3,42,40,0,0,1,1
S01007469,Owned: Owned outright,58,23,21,7,14,2,0,35,34,0,0,0,1
S01007469,Owned: Owned with a mortgage or loan or shared ownership,102,95,87,9,78,5,3,7,6,0,0,1,0
S01007469,Rented or living rent free: Total,90,61,45,11,34,5,11,29,15,1,3,6,4
S01007469,Rented or living rent free: Social rented,77,50,37,9,28,4,9,27,13,1,3,6,4
S01007469,Rented or living rent free: Private rented or living rent free,13,11,8,2,6,1,2,2,2,0,0,0,0
S01007470,All HRPs aged 16 and over,335,183,148,24,124,18,17,152,102,1,10,36,3
S01007470,Owned: Total,121,89,77,11,66,11,1,32,29,0,2,1,0
S01007470,Owned: Owned outright,49,23,19,6,13,4,0,26,25,0,0,1,0
S01007470,Owned: Owned with a mortgage or loan or shared ownership,72,66,58,5,53,7,1,6,4,0,2,0,0
S01007470,Rented or living rent free: Total,214,94,71,13,58,7,16,120,73,1,8,35,3
S01007470,Rented or living rent free: Social rented,180,67,48,7,41,6,13,113,69,0,8,33,3
S01007470,Rented or living rent free: Private rented or living rent free,34,27,23,6,17,1,3,7,4,1,0,2,0
S01007471,All HRPs aged 16 and over,203,133,116,12,104,8,9,70,49,2,5,12,2
S01007471,Owned: Total,120,100,95,4,91,4,1,20,20,0,0,0,0
S01007471,Owned: Owned outright,37,19,18,0,18,1,0,18,18,0,0,0,0
S01007471,Owned: Owned with a mortgage or loan or shared ownership,83,81,77,4,73,3,1,2,2,0,0,0,0
S01007471,Rented or living rent free: Total,83,33,21,8,13,4,8,50,29,2,5,12,2
S01007471,Rented or living rent free: Social rented,68,23,15,7,8,3,5,45,27,2,3,11,2
S01007471,Rented or living rent free: Private rented or living rent free,15,10,6,1,5,1,3,5,2,0,2,1,0
S01007472,All HRPs aged 16 and over,273,141,117,19,98,10,14,132,100,0,6,21,5
S01007472,Owned: Total,147,88,79,6,73,7,2,59,52,0,0,5,2
S01007472,Owned: Owned outright,66,16,15,1,14,1,0,50,45,0,0,3,2
S01007472,Owned: Owned with a mortgage or loan or shared ownership,81,72,64,5,59,6,2,9,7,0,0,2,0
S01007472,Rented or living rent free: Total,126,53,38,13,25,3,12,73,48,0,6,16,3
S01007472,Rented or living rent free: Social rented,102,41,32,11,21,3,6,61,40,0,3,15,3
S01007472,Rented or living rent free: Private rented or living rent free,24,12,6,2,4,0,6,12,8,0,3,1,0
S01007473,All HRPs aged 16 and over,227,134,121,18,103,6,7,93,60,1,4,23,5
S01007473,Owned: Total,121,87,81,8,73,5,1,34,32,0,0,1,1
S01007473,Owned: Owned outright,44,16,13,3,10,2,1,28,27,0,0,0,1
S01007473,Owned: Owned with a mortgage or loan or shared ownership,77,71,68,5,63,3,0,6,5,0,0,1,0
S01007473,Rented or living rent free: Total,106,47,40,10,30,1,6,59,28,1,4,22,4
S01007473,Rented or living rent free: Social rented,96,40,33,10,23,1,6,56,27,1,3,21,4
S01007473,Rented or living rent free: Private rented or living rent free,10,7,7,0,7,0,0,3,1,0,1,1,0
S01007474,All HRPs aged 16 and over,213,155,132,18,114,22,1,58,53,0,0,2,3
S01007474,Owned: Total,184,137,118,16,102,19,0,47,44,0,0,1,2
S01007474,Owned: Owned outright,74,38,30,9,21,8,0,36,33,0,0,1,2
S01007474,Owned: Owned with a mortgage or loan or shared ownership,110,99,88,7,81,11,0,11,11,0,0,0,0
S01007474,Rented or living rent free: Total,29,18,14,2,12,3,1,11,9,0,0,1,1
S01007474,Rented or living rent free: Social rented,22,11,8,1,7,2,1,11,9,0,0,1,1
S01007474,Rented or living rent free: Private rented or living rent free,7,7,6,1,5,1,0,0,0,0,0,0,0
S01007475,All HRPs aged 16 and over,257,183,158,17,141,19,6,74,52,1,7,12,2
S01007475,Owned: Total,208,154,138,14,124,14,2,54,49,0,1,3,1
S01007475,Owned: Owned outright,81,32,27,6,21,3,2,49,44,0,1,3,1
S01007475,Owned: Owned with a mortgage or loan or shared ownership,127,122,111,8,103,11,0,5,5,0,0,0,0
S01007475,Rented or living rent free: Total,49,29,20,3,17,5,4,20,3,1,6,9,1
S01007475,Rented or living rent free: Social rented,27,14,8,2,6,2,4,13,3,1,3,6,0
S01007475,Rented or living rent free: Private rented or living rent free,22,15,12,1,11,3,0,7,0,0,3,3,1
S01007476,All HRPs aged 16 and over,317,169,142,17,125,22,5,148,133,1,7,2,5
S01007476,Owned: Total,249,142,122,14,108,19,1,107,102,0,2,0,3
S01007476,Owned: Owned outright,145,46,39,7,32,7,0,99,96,0,0,0,3
S01007476,Owned: Owned with a mortgage or loan or shared ownership,104,96,83,7,76,12,1,8,6,0,2,0,0
S01007476,Rented or living rent free: Total,68,27,20,3,17,3,4,41,31,1,5,2,2
S01007476,Rented or living rent free: Social rented,47,19,14,3,11,2,3,28,22,0,3,2,1
S01007476,Rented or living rent free: Private rented or living rent free,21,8,6,0,6,1,1,13,9,1,2,0,1
S01007477,All HRPs aged 16 and over,247,176,141,11,130,27,8,71,65,0,2,4,0
S01007477,Owned: Total,194,142,116,8,108,22,4,52,50,0,1,1,0
S01007477,Owned: Owned outright,85,40,33,3,30,5,2,45,45,0,0,0,0
S01007477,Owned: Owned with a mortgage or loan or shared ownership,109,102,83,5,78,17,2,7,5,0,1,1,0
S01007477,Rented or living rent free: Total,53,34,25,3,22,5,4,19,15,0,1,3,0
S01007477,Rented or living rent free: Social rented,25,12,8,1,7,2,2,13,9,0,1,3,0
S01007477,Rented or living rent free: Private rented or living rent free,28,22,17,2,15,3,2,6,6,0,0,0,0
S01007478,All HRPs aged 16 and over,433,271,229,24,205,29,13,162,138,1,6,14,3
S01007478,Owned: Total,284,202,168,9,159,29,5,82,77,1,3,0,1
S01007478,Owned: Owned outright,121,47,39,7,32,6,2,74,72,0,2,0,0
S01007478,Owned: Owned with a mortgage or loan or shared ownership,163,155,129,2,127,23,3,8,5,1,1,0,1
S01007478,Rented or living rent free: Total,149,69,61,15,46,0,8,80,61,0,3,14,2
S01007478,Rented or living rent free: Social rented,83,16,16,5,11,0,0,67,51,0,3,11,2
S01007478,Rented or living rent free: Private rented or living rent free,66,53,45,10,35,0,8,13,10,0,0,3,0
S01007479,All HRPs aged 16 and over,275,200,180,23,157,9,11,75,50,0,6,13,6
S01007479,Owned: Total,192,153,143,15,128,7,3,39,34,0,2,3,0
S01007479,Owned: Owned outright,50,20,17,3,14,1,2,30,28,0,0,2,0
S01007479,Owned: Owned with a mortgage or loan or shared ownership,142,133,126,12,114,6,1,9,6,0,2,1,0
S01007479,Rented or living rent free: Total,83,47,37,8,29,2,8,36,16,0,4,10,6
S01007479,Rented or living rent free: Social rented,39,17,11,4,7,1,5,22,12,0,1,8,1
S01007479,Rented or living rent free: Private rented or living rent free,44,30,26,4,22,1,3,14,4,0,3,2,5
S01007480,All HRPs aged 16 and over,327,264,238,19,219,18,8,63,48,0,5,6,4
S01007480,Owned: Total,252,211,192,11,181,15,4,41,39,0,0,2,0
S01007480,Owned: Owned outright,63,26,21,6,15,3,2,37,36,0,0,1,0
S01007480,Owned: Owned with a mortgage or loan or shared ownership,189,185,171,5,166,12,2,4,3,0,0,1,0
S01007480,Rented or living rent free: Total,75,53,46,8,38,3,4,22,9,0,5,4,4
S01007480,Rented or living rent free: Social rented,35,23,19,5,14,1,3,12,6,0,3,3,0
S01007480,Rented or living rent free: Private rented or living rent free,40,30,27,3,24,2,1,10,3,0,2,1,4
S01007481,All HRPs aged 16 and over,394,183,143,22,121,39,1,211,204,0,3,1,3
S01007481,Owned: Total,359,158,119,18,101,38,1,201,197,0,2,0,2
S01007481,Owned: Owned outright,259,70,47,13,34,23,0,189,185,0,2,0,2
S01007481,Owned: Owned with a mortgage or loan or shared ownership,100,88,72,5,67,15,1,12,12,0,0,0,0
S01007481,Rented or living rent free: Total,35,25,24,4,20,1,0,10,7,0,1,1,1
S01007481,Rented or living rent free: Social rented,4,2,2,1,1,0,0,2,0,0,1,1,0
S01007481,Rented or living rent free: Private rented or living rent free,31,23,22,3,19,1,0,8,7,0,0,0,1
S01007482,All HRPs aged 16 and over,253,115,95,18,77,13,7,138,120,0,2,14,2
S01007482,Owned: Total,135,73,64,14,50,9,0,62,59,0,2,1,0
S01007482,Owned: Owned outright,90,32,29,11,18,3,0,58,56,0,2,0,0
S01007482,Owned: Owned with a mortgage or loan or shared ownership,45,41,35,3,32,6,0,4,3,0,0,1,0
S01007482,Rented or living rent free: Total,118,42,31,4,27,4,7,76,61,0,0,13,2
S01007482,Rented or living rent free: Social rented,92,20,13,1,12,2,5,72,57,0,0,13,2
S01007482,Rented or living rent free: Private rented or living rent free,26,22,18,3,15,2,2,4,4,0,0,0,0
S01007483,All HRPs aged 16 and over,340,221,169,29,140,40,12,119,99,0,3,11,6
S01007483,Owned: Total,227,161,130,17,113,31,0,66,64,0,0,2,0
S01007483,Owned: Owned outright,95,39,29,6,23,10,0,56,56,0,0,0,0
S01007483,Owned: Owned with a mortgage or loan or shared ownership,132,122,101,11,90,21,0,10,8,0,0,2,0
S01007483,Rented or living rent free: Total,113,60,39,12,27,9,12,53,35,0,3,9,6
S01007483,Rented or living rent free: Social rented,78,39,26,9,17,4,9,39,26,0,2,6,5
S01007483,Rented or living rent free: Private rented or living rent free,35,21,13,3,10,5,3,14,9,0,1,3,1
S01007484,All HRPs aged 16 and over,285,169,119,28,91,25,25,116,86,2,1,23,4
S01007484,Owned: Total,135,92,70,13,57,20,2,43,41,0,0,2,0
S01007484,Owned: Owned outright,70,31,25,8,17,6,0,39,38,0,0,1,0
S01007484,Owned: Owned with a mortgage or loan or shared ownership,65,61,45,5,40,14,2,4,3,0,0,1,0
S01007484,Rented or living rent free: Total,150,77,49,15,34,5,23,73,45,2,1,21,4
S01007484,Rented or living rent free: Social rented,87,42,26,10,16,2,14,45,23,0,1,18,3
S01007484,Rented or living rent free: Private rented or living rent free,63,35,23,5,18,3,9,28,22,2,0,3,1
S01007485,All HRPs aged 16 and over,219,136,100,40,60,8,28,83,39,2,10,29,3
S01007485,Owned: Total,47,28,26,7,19,1,1,19,17,0,1,1,0
S01007485,Owned: Owned outright,27,9,8,3,5,0,1,18,16,0,1,1,0
S01007485,Owned: Owned with a mortgage or loan or shared ownership,20,19,18,4,14,1,0,1,1,0,0,0,0
S01007485,Rented or living rent free: Total,172,108,74,33,41,7,27,64,22,2,9,28,3
S01007485,Rented or living rent free: Social rented,153,94,63,28,35,5,26,59,20,2,8,26,3
S01007485,Rented or living rent free: Private rented or living rent free,19,14,11,5,6,2,1,5,2,0,1,2,0
S01007486,All HRPs aged 16 and over,255,134,99,50,49,6,29,121,59,1,13,39,9
S01007486,Owned: Total,45,28,24,5,19,3,1,17,16,0,0,1,0
S01007486,Owned: Owned outright,28,12,11,4,7,1,0,16,15,0,0,1,0
S01007486,Owned: Owned with a mortgage or loan or shared ownership,17,16,13,1,12,2,1,1,1,0,0,0,0
S01007486,Rented or living rent free: Total,210,106,75,45,30,3,28,104,43,1,13,38,9
S01007486,Rented or living rent free: Social rented,193,95,67,39,28,2,26,98,39,1,12,37,9
S01007486,Rented or living rent free: Private rented or living rent free,17,11,8,6,2,1,2,6,4,0,1,1,0
S01007487,All HRPs aged 16 and over,498,283,213,44,169,35,35,215,129,3,13,50,20
S01007487,Owned: Total,184,138,112,18,94,22,4,46,41,0,1,2,2
S01007487,Owned: Owned outright,75,35,25,4,21,9,1,40,36,0,0,2,2
S01007487,Owned: Owned with a mortgage or loan or shared ownership,109,103,87,14,73,13,3,6,5,0,1,0,0
S01007487,Rented or living rent free: Total,314,145,101,26,75,13,31,169,88,3,12,48,18
S01007487,Rented or living rent free: Social rented,184,57,39,14,25,6,12,127,70,1,7,39,10
S01007487,Rented or living rent free: Private rented or living rent free,130,88,62,12,50,7,19,42,18,2,5,9,8
S01007488,All HRPs aged 16 and over,483,310,232,36,196,54,24,173,135,1,3,26,8
S01007488,Owned: Total,293,193,152,16,136,39,2,100,97,0,1,1,1
S01007488,Owned: Owned outright,145,59,38,6,32,20,1,86,84,0,1,1,0
S01007488,Owned: Owned with a mortgage or loan or shared ownership,148,134,114,10,104,19,1,14,13,0,0,0,1
S01007488,Rented or living rent free: Total,190,117,80,20,60,15,22,73,38,1,2,25,7
S01007488,Rented or living rent free: Social rented,89,39,21,10,11,5,13,50,21,1,2,20,6
S01007488,Rented or living rent free: Private rented or living rent free,101,78,59,10,49,10,9,23,17,0,0,5,1
S01007489,All HRPs aged 16 and over,406,241,182,42,140,45,14,165,141,1,5,16,2
S01007489,Owned: Total,282,172,127,22,105,39,6,110,105,1,1,2,1
S01007489,Owned: Owned outright,160,68,43,10,33,20,5,92,91,0,0,1,0
S01007489,Owned: Owned with a mortgage or loan or shared ownership,122,104,84,12,72,19,1,18,14,1,1,1,1
S01007489,Rented or living rent free: Total,124,69,55,20,35,6,8,55,36,0,4,14,1
S01007489,Rented or living rent free: Social rented,71,31,27,12,15,0,4,40,24,0,4,11,1
S01007489,Rented or living rent free: Private rented or living rent free,53,38,28,8,20,6,4,15,12,0,0,3,0
S01007490,All HRPs aged 16 and over,378,203,168,39,129,29,6,175,134,1,10,20,10
S01007490,Owned: Total,244,141,116,20,96,22,3,103,96,1,0,4,2
S01007490,Owned: Owned outright,141,52,40,16,24,9,3,89,86,0,0,2,1
S01007490,Owned: Owned with a mortgage or loan or shared ownership,103,89,76,4,72,13,0,14,10,1,0,2,1
S01007490,Rented or living rent free: Total,134,62,52,19,33,7,3,72,38,0,10,16,8
S01007490,Rented or living rent free: Social rented,105,42,36,15,21,3,3,63,34,0,7,15,7
S01007490,Rented or living rent free: Private rented or living rent free,29,20,16,4,12,4,0,9,4,0,3,1,1
S01007491,All HRPs aged 16 and over,460,328,271,69,202,31,26,132,78,1,13,35,5
S01007491,Owned: Total,260,191,171,27,144,19,1,69,65,0,1,3,0
S01007491,Owned: Owned outright,99,37,33,11,22,4,0,62,61,0,0,1,0
S01007491,Owned: Owned with a mortgage or loan or shared ownership,161,154,138,16,122,15,1,7,4,0,1,2,0
S01007491,Rented or living rent free: Total,200,137,100,42,58,12,25,63,13,1,12,32,5
S01007491,Rented or living rent free: Social rented,155,100,75,33,42,5,20,55,11,0,10,29,5
S01007491,Rented or living rent free: Private rented or living rent free,45,37,25,9,16,7,5,8,2,1,2,3,0
S01007492,All HRPs aged 16 and over,332,194,162,29,133,22,10,138,105,1,0,26,6
S01007492,Owned: Total,199,134,114,12,102,17,3,65,61,0,0,2,2
S01007492,Owned: Owned outright,93,38,30,4,26,5,3,55,54,0,0,0,1
S01007492,Owned: Owned with a mortgage or loan or shared ownership,106,96,84,8,76,12,0,10,7,0,0,2,1
S01007492,Rented or living rent free: Total,133,60,48,17,31,5,7,73,44,1,0,24,4
S01007492,Rented or living rent free: Social rented,109,44,33,14,19,5,6,65,38,1,0,23,3
S01007492,Rented or living rent free: Private rented or living rent free,24,16,15,3,12,0,1,8,6,0,0,1,1
S01007493,All HRPs aged 16 and over,368,242,210,44,166,20,12,126,90,3,4,23,6
S01007493,Owned: Total,225,153,141,14,127,10,2,72,65,0,1,5,1
S01007493,Owned: Owned outright,93,37,32,6,26,4,1,56,54,0,0,2,0
S01007493,Owned: Owned with a mortgage or loan or shared ownership,132,116,109,8,101,6,1,16,11,0,1,3,1
S01007493,Rented or living rent free: Total,143,89,69,30,39,10,10,54,25,3,3,18,5
S01007493,Rented or living rent free: Social rented,113,68,53,25,28,7,8,45,18,3,3,16,5
S01007493,Rented or living rent free: Private rented or living rent free,30,21,16,5,11,3,2,9,7,0,0,2,0
S01007494,All HRPs aged 16 and over,239,146,86,20,66,55,5,93,79,0,7,7,0
S01007494,Owned: Total,177,110,61,14,47,49,0,67,63,0,2,2,0
S01007494,Owned: Owned outright,118,62,26,9,17,36,0,56,55,0,1,0,0
S01007494,Owned: Owned with a mortgage or loan or shared ownership,59,48,35,5,30,13,0,11,8,0,1,2,0
S01007494,Rented or living rent free: Total,62,36,25,6,19,6,5,26,16,0,5,5,0
S01007494,Rented or living rent free: Social rented,26,14,11,4,7,1,2,12,7,0,3,2,0
S01007494,Rented or living rent free: Private rented or living rent free,36,22,14,2,12,5,3,14,9,0,2,3,0
S01007495,All HRPs aged 16 and over,345,243,153,30,123,88,2,102,92,0,1,7,2
S01007495,Owned: Total,258,181,111,22,89,70,0,77,73,0,1,2,1
S01007495,Owned: Owned outright,173,100,53,17,36,47,0,73,70,0,1,1,1
S01007495,Owned: Owned with a mortgage or loan or shared ownership,85,81,58,5,53,23,0,4,3,0,0,1,0
S01007495,Rented or living rent free: Total,87,62,42,8,34,18,2,25,19,0,0,5,1
S01007495,Rented or living rent free: Social rented,19,8,6,0,6,0,2,11,6,0,0,4,1
S01007495,Rented or living rent free: Private rented or living rent free,68,54,36,8,28,18,0,14,13,0,0,1,0
S01007496,All HRPs aged 16 and over,470,263,158,34,124,99,6,207,187,2,3,13,2
S01007496,Owned: Total,322,180,103,22,81,76,1,142,137,0,0,4,1
S01007496,Owned: Owned outright,228,104,53,18,35,50,1,124,124,0,0,0,0
S01007496,Owned: Owned with a mortgage or loan or shared ownership,94,76,50,4,46,26,0,18,13,0,0,4,1
S01007496,Rented or living rent free: Total,148,83,55,12,43,23,5,65,50,2,3,9,1
S01007496,Rented or living rent free: Social rented,50,18,13,3,10,1,4,32,18,2,2,9,1
S01007496,Rented or living rent free: Private rented or living rent free,98,65,42,9,33,22,1,33,32,0,1,0,0
S01007497,All HRPs aged 16 and over,264,160,115,19,96,42,3,104,81,1,9,10,3
S01007497,Owned: Total,130,80,62,6,56,18,0,50,46,0,3,0,1
S01007497,Owned: Owned outright,73,34,22,4,18,12,0,39,36,0,2,0,1
S01007497,Owned: Owned with a mortgage or loan or shared ownership,57,46,40,2,38,6,0,11,10,0,1,0,0
S01007497,Rented or living rent free: Total,134,80,53,13,40,24,3,54,35,1,6,10,2
S01007497,Rented or living rent free: Social rented,54,23,17,10,7,4,2,31,17,0,5,7,2
S01007497,Rented or living rent free: Private rented or living rent free,80,57,36,3,33,20,1,23,18,1,1,3,0
S01007498,All HRPs aged 16 and over,416,217,159,22,137,53,5,199,172,1,6,20,0
S01007498,Owned: Total,275,156,118,16,102,35,3,119,113,0,1,5,0
S01007498,Owned: Owned outright,166,62,42,11,31,18,2,104,100,0,1,3,0
S01007498,Owned: Owned with a mortgage or loan or shared ownership,109,94,76,5,71,17,1,15,13,0,0,2,0
S01007498,Rented or living rent free: Total,141,61,41,6,35,18,2,80,59,1,5,15,0
S01007498,Rented or living rent free: Social rented,67,17,13,3,10,3,1,50,35,0,1,14,0
S01007498,Rented or living rent free: Private rented or living rent free,74,44,28,3,25,15,1,30,24,1,4,1,0
S01007499,All HRPs aged 16 and over,358,243,164,29,135,66,13,115,89,2,3,15,6
S01007499,Owned: Total,207,149,94,14,80,50,5,58,54,0,0,2,2
S01007499,Owned: Owned outright,112,62,31,8,23,29,2,50,47,0,0,1,2
S01007499,Owned: Owned with a mortgage or loan or shared ownership,95,87,63,6,57,21,3,8,7,0,0,1,0
S01007499,Rented or living rent free: Total,151,94,70,15,55,16,8,57,35,2,3,13,4
S01007499,Rented or living rent free: Social rented,86,45,37,9,28,3,5,41,23,1,2,12,3
S01007499,Rented or living rent free: Private rented or living rent free,65,49,33,6,27,13,3,16,12,1,1,1,1
S01007500,All HRPs aged 16 and over,288,154,100,24,76,47,7,134,108,1,4,15,6
S01007500,Owned: Total,129,70,42,9,33,26,2,59,53,0,1,3,2
S01007500,Owned: Owned outright,90,38,20,8,12,17,1,52,49,0,0,1,2
S01007500,Owned: Owned with a mortgage or loan or shared ownership,39,32,22,1,21,9,1,7,4,0,1,2,0
S01007500,Rented or living rent free: Total,159,84,58,15,43,21,5,75,55,1,3,12,4
S01007500,Rented or living rent free: Social rented,52,19,15,6,9,2,2,33,25,0,1,5,2
S01007500,Rented or living rent free: Private rented or living rent free,107,65,43,9,34,19,3,42,30,1,2,7,2
S01007501,All HRPs aged 16 and over,325,167,86,21,65,68,13,158,137,0,4,15,2
S01007501,Owned: Total,213,117,53,15,38,59,5,96,93,0,0,2,1
S01007501,Owned: Owned outright,172,84,38,12,26,42,4,88,86,0,0,1,1
S01007501,Owned: Owned with a mortgage or loan or shared ownership,41,33,15,3,12,17,1,8,7,0,0,1,0
S01007501,Rented or living rent free: Total,112,50,33,6,27,9,8,62,44,0,4,13,1
S01007501,Rented or living rent free: Social rented,45,14,10,3,7,1,3,31,18,0,2,10,1
S01007501,Rented or living rent free: Private rented or living rent free,67,36,23,3,20,8,5,31,26,0,2,3,0
S01007502,All HRPs aged 16 and over,248,152,96,22,74,54,2,96,81,1,2,9,3
S01007502,Owned: Total,160,96,65,12,53,31,0,64,60,0,0,2,2
S01007502,Owned: Owned outright,104,45,26,10,16,19,0,59,55,0,0,2,2
S01007502,Owned: Owned with a mortgage or loan or shared ownership,56,51,39,2,37,12,0,5,5,0,0,0,0
S01007502,Rented or living rent free: Total,88,56,31,10,21,23,2,32,21,1,2,7,1
S01007502,Rented or living rent free: Social rented,37,15,13,6,7,0,2,22,14,1,0,6,1
S01007502,Rented or living rent free: Private rented or living rent free,51,41,18,4,14,23,0,10,7,0,2,1,0
S01007503,All HRPs aged 16 and over,482,281,160,28,132,103,18,201,169,1,7,19,5
S01007503,Owned: Total,308,192,107,19,88,80,5,116,114,0,0,1,1
S01007503,Owned: Owned outright,211,104,48,14,34,54,2,107,106,0,0,0,1
S01007503,Owned: Owned with a mortgage or loan or shared ownership,97,88,59,5,54,26,3,9,8,0,0,1,0
S01007503,Rented or living rent free: Total,174,89,53,9,44,23,13,85,55,1,7,18,4
S01007503,Rented or living rent free: Social rented,83,32,19,6,13,5,8,51,30,1,4,14,2
S01007503,Rented or living rent free: Private rented or living rent free,91,57,34,3,31,18,5,34,25,0,3,4,2
S01007504,All HRPs aged 16 and over,321,192,107,29,78,76,9,129,117,0,0,10,2
S01007504,Owned: Total,199,115,59,16,43,53,3,84,78,0,0,5,1
S01007504,Owned: Owned outright,145,66,28,12,16,37,1,79,75,0,0,4,0
S01007504,Owned: Owned with a mortgage or loan or shared ownership,54,49,31,4,27,16,2,5,3,0,0,1,1
S01007504,Rented or living rent free: Total,122,77,48,13,35,23,6,45,39,0,0,5,1
S01007504,Rented or living rent free: Social rented,39,23,20,6,14,1,2,16,12,0,0,4,0
S01007504,Rented or living rent free: Private rented or living rent free,83,54,28,7,21,22,4,29,27,0,0,1,1
S01007505,All HRPs aged 16 and over,179,127,66,15,51,55,6,52,36,0,2,12,2
S01007505,Owned: Total,109,79,39,6,33,39,1,30,26,0,0,4,0
S01007505,Owned: Owned outright,74,46,16,3,13,29,1,28,24,0,0,4,0
S01007505,Owned: Owned with a mortgage or loan or shared ownership,35,33,23,3,20,10,0,2,2,0,0,0,0
S01007505,Rented or living rent free: Total,70,48,27,9,18,16,5,22,10,0,2,8,2
S01007505,Rented or living rent free: Social rented,31,21,13,6,7,4,4,10,3,0,2,4,1
S01007505,Rented or living rent free: Private rented or living rent free,39,27,14,3,11,12,1,12,7,0,0,4,1
S01007506,All HRPs aged 16 and over,237,142,74,11,63,65,3,95,88,0,2,4,1
S01007506,Owned: Total,176,100,43,6,37,56,1,76,73,0,2,1,0
S01007506,Owned: Owned outright,128,57,19,5,14,38,0,71,68,0,2,1,0
S01007506,Owned: Owned with a mortgage or loan or shared ownership,48,43,24,1,23,18,1,5,5,0,0,0,0
S01007506,Rented or living rent free: Total,61,42,31,5,26,9,2,19,15,0,0,3,1
S01007506,Rented or living rent free: Social rented,6,1,0,0,0,1,0,5,2,0,0,2,1
S01007506,Rented or living rent free: Private rented or living rent free,55,41,31,5,26,8,2,14,13,0,0,1,0
S01007507,All HRPs aged 16 and over,455,257,164,31,133,80,13,198,167,2,6,20,3
S01007507,Owned: Total,276,156,102,17,85,54,0,120,117,1,0,2,0
S01007507,Owned: Owned outright,174,70,40,8,32,30,0,104,102,1,0,1,0
S01007507,Owned: Owned with a mortgage or loan or shared ownership,102,86,62,9,53,24,0,16,15,0,0,1,0
S01007507,Rented or living rent free: Total,179,101,62,14,48,26,13,78,50,1,6,18,3
S01007507,Rented or living rent free: Social rented,105,50,28,5,23,14,8,55,36,0,4,12,3
S01007507,Rented or living rent free: Private rented or living rent free,74,51,34,9,25,12,5,23,14,1,2,6,0
S01007508,All HRPs aged 16 and over,329,191,122,29,93,64,5,138,121,0,4,10,3
S01007508,Owned: Total,214,123,68,16,52,55,0,91,86,0,0,2,3
S01007508,Owned: Owned outright,151,74,34,11,23,40,0,77,73,0,0,1,3
S01007508,Owned: Owned with a mortgage or loan or shared ownership,63,49,34,5,29,15,0,14,13,0,0,1,0
S01007508,Rented or living rent free: Total,115,68,54,13,41,9,5,47,35,0,4,8,0
S01007508,Rented or living rent free: Social rented,50,26,20,8,12,2,4,24,14,0,3,7,0
S01007508,Rented or living rent free: Private rented or living rent free,65,42,34,5,29,7,1,23,21,0,1,1,0
S01007509,All HRPs aged 16 and over,274,173,96,24,72,69,8,101,93,1,3,4,0
S01007509,Owned: Total,199,122,62,17,45,59,1,77,73,0,2,2,0
S01007509,Owned: Owned outright,153,84,35,15,20,48,1,69,65,0,2,2,0
S01007509,Owned: Owned with a mortgage or loan or shared ownership,46,38,27,2,25,11,0,8,8,0,0,0,0
S01007509,Rented or living rent free: Total,75,51,34,7,27,10,7,24,20,1,1,2,0
S01007509,Rented or living rent free: Social rented,25,11,4,1,3,1,6,14,12,0,0,2,0
S01007509,Rented or living rent free: Private rented or living rent free,50,40,30,6,24,9,1,10,8,1,1,0,0
S01007510,All HRPs aged 16 and over,459,222,133,34,99,83,6,237,209,1,5,18,4
S01007510,Owned: Total,307,147,74,17,57,70,3,160,150,0,0,6,4
S01007510,Owned: Owned outright,246,98,43,13,30,53,2,148,139,0,0,5,4
S01007510,Owned: Owned with a mortgage or loan or shared ownership,61,49,31,4,27,17,1,12,11,0,0,1,0
S01007510,Rented or living rent free: Total,152,75,59,17,42,13,3,77,59,1,5,12,0
S01007510,Rented or living rent free: Social rented,79,36,31,12,19,3,2,43,31,1,4,7,0
S01007510,Rented or living rent free: Private rented or living rent free,73,39,28,5,23,10,1,34,28,0,1,5,0
S01007511,All HRPs aged 16 and over,370,181,118,26,92,54,9,189,136,4,11,35,3
S01007511,Owned: Total,184,101,61,10,51,39,1,83,74,0,1,6,2
S01007511,Owned: Owned outright,132,56,28,8,20,27,1,76,70,0,1,4,1
S01007511,Owned: Owned with a mortgage or loan or shared ownership,52,45,33,2,31,12,0,7,4,0,0,2,1
S01007511,Rented or living rent free: Total,186,80,57,16,41,15,8,106,62,4,10,29,1
S01007511,Rented or living rent free: Social rented,143,55,41,13,28,6,8,88,50,3,9,25,1
S01007511,Rented or living rent free: Private rented or living rent free,43,25,16,3,13,9,0,18,12,1,1,4,0
S01007512,All HRPs aged 16 and over,247,134,68,13,55,61,5,113,104,0,1,7,1
S01007512,Owned: Total,163,85,36,6,30,48,1,78,77,0,0,1,0
S01007512,Owned: Owned outright,133,62,25,6,19,37,0,71,70,0,0,1,0
S01007512,Owned: Owned with a mortgage or loan or shared ownership,30,23,11,0,11,11,1,7,7,0,0,0,0
S01007512,Rented or living rent free: Total,84,49,32,7,25,13,4,35,27,0,1,6,1
S01007512,Rented or living rent free: Social rented,37,19,12,4,8,5,2,18,14,0,0,3,1
S01007512,Rented or living rent free: Private rented or living rent free,47,30,20,3,17,8,2,17,13,0,1,3,0
S01007513,All HRPs aged 16 and over,468,286,220,47,173,45,21,182,131,1,10,31,9
S01007513,Owned: Total,249,156,124,18,106,32,0,93,87,0,1,5,0
S01007513,Owned: Owned outright,133,49,40,13,27,9,0,84,80,0,0,4,0
S01007513,Owned: Owned with a mortgage or loan or shared ownership,116,107,84,5,79,23,0,9,7,0,1,1,0
S01007513,Rented or living rent free: Total,219,130,96,29,67,13,21,89,44,1,9,26,9
S01007513,Rented or living rent free: Social rented,161,84,62,22,40,7,15,77,37,1,8,23,8
S01007513,Rented or living rent free: Private rented or living rent free,58,46,34,7,27,6,6,12,7,0,1,3,1
S01007514,All HRPs aged 16 and over,247,155,117,28,89,30,8,92,70,3,3,12,4
S01007514,Owned: Total,140,87,63,13,50,24,0,53,49,0,0,4,0
S01007514,Owned: Owned outright,89,43,32,10,22,11,0,46,44,0,0,2,0
S01007514,Owned: Owned with a mortgage or loan or shared ownership,51,44,31,3,28,13,0,7,5,0,0,2,0
S01007514,Rented or living rent free: Total,107,68,54,15,39,6,8,39,21,3,3,8,4
S01007514,Rented or living rent free: Social rented,34,14,9,4,5,2,3,20,9,1,1,7,2
S01007514,Rented or living rent free: Private rented or living rent free,73,54,45,11,34,4,5,19,12,2,2,1,2
S01007515,All HRPs aged 16 and over,254,146,107,22,85,32,7,108,101,0,2,4,1
S01007515,Owned: Total,207,113,83,15,68,28,2,94,93,0,1,0,0
S01007515,Owned: Owned outright,136,46,30,8,22,14,2,90,90,0,0,0,0
S01007515,Owned: Owned with a mortgage or loan or shared ownership,71,67,53,7,46,14,0,4,3,0,1,0,0
S01007515,Rented or living rent free: Total,47,33,24,7,17,4,5,14,8,0,1,4,1
S01007515,Rented or living rent free: Social rented,9,5,3,1,2,0,2,4,1,0,0,3,0
S01007515,Rented or living rent free: Private rented or living rent free,38,28,21,6,15,4,3,10,7,0,1,1,1
S01007516,All HRPs aged 16 and over,257,164,129,27,102,25,10,93,81,0,4,6,2
S01007516,Owned: Total,118,82,63,8,55,19,0,36,35,0,0,1,0
S01007516,Owned: Owned outright,60,30,21,6,15,9,0,30,30,0,0,0,0
S01007516,Owned: Owned with a mortgage or loan or shared ownership,58,52,42,2,40,10,0,6,5,0,0,1,0
S01007516,Rented or living rent free: Total,139,82,66,19,47,6,10,57,46,0,4,5,2
S01007516,Rented or living rent free: Social rented,85,41,32,10,22,3,6,44,37,0,1,4,2
S01007516,Rented or living rent free: Private rented or living rent free,54,41,34,9,25,3,4,13,9,0,3,1,0
S01007517,All HRPs aged 16 and over,224,96,71,14,57,23,2,128,110,0,3,12,3
S01007517,Owned: Total,152,64,46,7,39,18,0,88,84,0,1,3,0
S01007517,Owned: Owned outright,103,23,17,5,12,6,0,80,78,0,0,2,0
S01007517,Owned: Owned with a mortgage or loan or shared ownership,49,41,29,2,27,12,0,8,6,0,1,1,0
S01007517,Rented or living rent free: Total,72,32,25,7,18,5,2,40,26,0,2,9,3
S01007517,Rented or living rent free: Social rented,37,10,7,3,4,2,1,27,17,0,1,6,3
S01007517,Rented or living rent free: Private rented or living rent free,35,22,18,4,14,3,1,13,9,0,1,3,0
S01007518,All HRPs aged 16 and over,381,204,153,27,126,36,15,177,140,3,2,26,6
S01007518,Owned: Total,228,129,100,16,84,26,3,99,96,1,0,2,0
S01007518,Owned: Owned outright,119,38,23,9,14,12,3,81,80,0,0,1,0
S01007518,Owned: Owned with a mortgage or loan or shared ownership,109,91,77,7,70,14,0,18,16,1,0,1,0
S01007518,Rented or living rent free: Total,153,75,53,11,42,10,12,78,44,2,2,24,6
S01007518,Rented or living rent free: Social rented,119,52,34,7,27,7,11,67,37,1,2,23,4
S01007518,Rented or living rent free: Private rented or living rent free,34,23,19,4,15,3,1,11,7,1,0,1,2
S01007519,All HRPs aged 16 and over,215,114,67,12,55,43,4,101,93,0,1,6,1
S01007519,Owned: Total,165,80,44,11,33,34,2,85,81,0,1,3,0
S01007519,Owned: Owned outright,125,51,23,7,16,26,2,74,72,0,0,2,0
S01007519,Owned: Owned with a mortgage or loan or shared ownership,40,29,21,4,17,8,0,11,9,0,1,1,0
S01007519,Rented or living rent free: Total,50,34,23,1,22,9,2,16,12,0,0,3,1
S01007519,Rented or living rent free: Social rented,12,7,5,1,4,1,1,5,3,0,0,2,0
S01007519,Rented or living rent free: Private rented or living rent free,38,27,18,0,18,8,1,11,9,0,0,1,1
S01007520,All HRPs aged 16 and over,446,249,170,36,134,64,15,197,169,0,7,16,5
S01007520,Owned: Total,298,163,117,25,92,44,2,135,125,0,2,5,3
S01007520,Owned: Owned outright,194,72,43,13,30,28,1,122,114,0,2,4,2
S01007520,Owned: Owned with a mortgage or loan or shared ownership,104,91,74,12,62,16,1,13,11,0,0,1,1
S01007520,Rented or living rent free: Total,148,86,53,11,42,20,13,62,44,0,5,11,2
S01007520,Rented or living rent free: Social rented,63,39,24,7,17,6,9,24,15,0,3,5,1
S01007520,Rented or living rent free: Private rented or living rent free,85,47,29,4,25,14,4,38,29,0,2,6,1
S01007521,All HRPs aged 16 and over,202,122,78,10,68,42,2,80,65,0,2,7,6
S01007521,Owned: Total,103,50,26,5,21,24,0,53,48,0,0,1,4
S01007521,Owned: Owned outright,86,38,17,3,14,21,0,48,44,0,0,1,3
S01007521,Owned: Owned with a mortgage or loan or shared ownership,17,12,9,2,7,3,0,5,4,0,0,0,1
S01007521,Rented or living rent free: Total,99,72,52,5,47,18,2,27,17,0,2,6,2
S01007521,Rented or living rent free: Social rented,7,4,1,0,1,1,2,3,1,0,0,2,0
S01007521,Rented or living rent free: Private rented or living rent free,92,68,51,5,46,17,0,24,16,0,2,4,2
S01007522,All HRPs aged 16 and over,476,243,169,49,120,62,12,233,213,0,3,12,5
S01007522,Owned: Total,325,162,105,25,80,54,3,163,156,0,1,4,2
S01007522,Owned: Owned outright,220,71,45,22,23,25,1,149,143,0,1,3,2
S01007522,Owned: Owned with a mortgage or loan or shared ownership,105,91,60,3,57,29,2,14,13,0,0,1,0
S01007522,Rented or living rent free: Total,151,81,64,24,40,8,9,70,57,0,2,8,3
S01007522,Rented or living rent free: Social rented,99,49,37,13,24,4,8,50,39,0,2,7,2
S01007522,Rented or living rent free: Private rented or living rent free,52,32,27,11,16,4,1,20,18,0,0,1,1
S01007523,All HRPs aged 16 and over,229,147,94,21,73,46,7,82,80,1,1,0,0
S01007523,Owned: Total,160,94,57,18,39,36,1,66,66,0,0,0,0
S01007523,Owned: Owned outright,105,46,22,12,10,23,1,59,59,0,0,0,0
S01007523,Owned: Owned with a mortgage or loan or shared ownership,55,48,35,6,29,13,0,7,7,0,0,0,0
S01007523,Rented or living rent free: Total,69,53,37,3,34,10,6,16,14,1,1,0,0
S01007523,Rented or living rent free: Social rented,11,7,3,0,3,1,3,4,3,0,1,0,0
S01007523,Rented or living rent free: Private rented or living rent free,58,46,34,3,31,9,3,12,11,1,0,0,0
S01007524,All HRPs aged 16 and over,385,251,150,23,127,94,7,134,116,0,3,14,1
S01007524,Owned: Total,262,165,88,12,76,74,3,97,94,0,0,2,1
S01007524,Owned: Owned outright,178,96,44,8,36,50,2,82,80,0,0,2,0
S01007524,Owned: Owned with a mortgage or loan or shared ownership,84,69,44,4,40,24,1,15,14,0,0,0,1
S01007524,Rented or living rent free: Total,123,86,62,11,51,20,4,37,22,0,3,12,0
S01007524,Rented or living rent free: Social rented,25,12,9,1,8,2,1,13,6,0,2,5,0
S01007524,Rented or living rent free: Private rented or living rent free,98,74,53,10,43,18,3,24,16,0,1,7,0
S01007525,All HRPs aged 16 and over,237,137,106,22,84,26,5,100,88,0,4,5,3
S01007525,Owned: Total,162,92,72,15,57,16,4,70,66,0,1,0,3
S01007525,Owned: Owned outright,97,34,26,8,18,5,3,63,61,0,1,0,1
S01007525,Owned: Owned with a mortgage or loan or shared ownership,65,58,46,7,39,11,1,7,5,0,0,0,2
S01007525,Rented or living rent free: Total,75,45,34,7,27,10,1,30,22,0,3,5,0
S01007525,Rented or living rent free: Social rented,39,18,13,2,11,4,1,21,17,0,1,3,0
S01007525,Rented or living rent free: Private rented or living rent free,36,27,21,5,16,6,0,9,5,0,2,2,0
S01007526,All HRPs aged 16 and over,385,188,133,36,97,42,13,197,157,0,5,26,9
S01007526,Owned: Total,194,90,61,14,47,28,1,104,97,0,0,3,4
S01007526,Owned: Owned outright,135,39,24,9,15,14,1,96,91,0,0,2,3
S01007526,Owned: Owned with a mortgage or loan or shared ownership,59,51,37,5,32,14,0,8,6,0,0,1,1
S01007526,Rented or living rent free: Total,191,98,72,22,50,14,12,93,60,0,5,23,5
S01007526,Rented or living rent free: Social rented,119,45,36,14,22,1,8,74,48,0,3,19,4
S01007526,Rented or living rent free: Private rented or living rent free,72,53,36,8,28,13,4,19,12,0,2,4,1
S01007527,All HRPs aged 16 and over,374,218,160,32,128,50,8,156,146,0,2,7,1
S01007527,Owned: Total,276,154,113,15,98,39,2,122,122,0,0,0,0
S01007527,Owned: Owned outright,169,55,38,7,31,16,1,114,114,0,0,0,0
S01007527,Owned: Owned with a mortgage or loan or shared ownership,107,99,75,8,67,23,1,8,8,0,0,0,0
S01007527,Rented or living rent free: Total,98,64,47,17,30,11,6,34,24,0,2,7,1
S01007527,Rented or living rent free: Social rented,59,36,29,15,14,4,3,23,14,0,2,6,1
S01007527,Rented or living rent free: Private rented or living rent free,39,28,18,2,16,7,3,11,10,0,0,1,0
S01007528,All HRPs aged 16 and over,363,226,154,44,110,53,19,137,112,2,7,8,8
S01007528,Owned: Total,175,122,79,17,62,40,3,53,51,0,0,1,1
S01007528,Owned: Owned outright,97,50,29,12,17,18,3,47,46,0,0,0,1
S01007528,Owned: Owned with a mortgage or loan or shared ownership,78,72,50,5,45,22,0,6,5,0,0,1,0
S01007528,Rented or living rent free: Total,188,104,75,27,48,13,16,84,61,2,7,7,7
S01007528,Rented or living rent free: Social rented,102,53,33,15,18,8,12,49,34,0,5,6,4
S01007528,Rented or living rent free: Private rented or living rent free,86,51,42,12,30,5,4,35,27,2,2,1,3
S01007529,All HRPs aged 16 and over,308,162,113,25,88,45,4,146,135,0,2,6,3
S01007529,Owned: Total,248,128,84,17,67,43,1,120,118,0,0,1,1
S01007529,Owned: Owned outright,179,64,41,11,30,23,0,115,114,0,0,0,1
S01007529,Owned: Owned with a mortgage or loan or shared ownership,69,64,43,6,37,20,1,5,4,0,0,1,0
S01007529,Rented or living rent free: Total,60,34,29,8,21,2,3,26,17,0,2,5,2
S01007529,Rented or living rent free: Social rented,33,17,15,6,9,0,2,16,9,0,1,4,2
S01007529,Rented or living rent free: Private rented or living rent free,27,17,14,2,12,2,1,10,8,0,1,1,0
S01007530,All HRPs aged 16 and over,223,149,75,11,64,72,2,74,68,0,2,3,1
S01007530,Owned: Total,140,83,32,5,27,50,1,57,55,0,0,1,1
S01007530,Owned: Owned outright,96,44,12,3,9,31,1,52,51,0,0,0,1
S01007530,Owned: Owned with a mortgage or loan or shared ownership,44,39,20,2,18,19,0,5,4,0,0,1,0
S01007530,Rented or living rent free: Total,83,66,43,6,37,22,1,17,13,0,2,2,0
S01007530,Rented or living rent free: Social rented,3,3,1,0,1,1,1,0,0,0,0,0,0
S01007530,Rented or living rent free: Private rented or living rent free,80,63,42,6,36,21,0,17,13,0,2,2,0
S01007531,All HRPs aged 16 and over,313,207,127,23,104,77,3,106,89,4,5,3,5
S01007531,Owned: Total,184,112,61,9,52,50,1,72,69,0,0,0,3
S01007531,Owned: Owned outright,137,69,32,7,25,37,0,68,65,0,0,0,3
S01007531,Owned: Owned with a mortgage or loan or shared ownership,47,43,29,2,27,13,1,4,4,0,0,0,0
S01007531,Rented or living rent free: Total,129,95,66,14,52,27,2,34,20,4,5,3,2
S01007531,Rented or living rent free: Social rented,42,21,15,6,9,4,2,21,11,2,4,3,1
S01007531,Rented or living rent free: Private rented or living rent free,87,74,51,8,43,23,0,13,9,2,1,0,1
S01007532,All HRPs aged 16 and over,248,168,102,16,86,62,4,80,68,0,2,8,2
S01007532,Owned: Total,157,99,52,10,42,47,0,58,54,0,0,3,1
S01007532,Owned: Owned outright,98,51,25,8,17,26,0,47,45,0,0,2,0
S01007532,Owned: Owned with a mortgage or loan or shared ownership,59,48,27,2,25,21,0,11,9,0,0,1,1
S01007532,Rented or living rent free: Total,91,69,50,6,44,15,4,22,14,0,2,5,1
S01007532,Rented or living rent free: Social rented,33,21,13,4,9,6,2,12,7,0,2,3,0
S01007532,Rented or living rent free: Private rented or living rent free,58,48,37,2,35,9,2,10,7,0,0,2,1
S01007533,All HRPs aged 16 and over,222,154,89,12,77,61,4,68,67,0,0,1,0
S01007533,Owned: Total,144,95,49,7,42,45,1,49,49,0,0,0,0
S01007533,Owned: Owned outright,95,51,24,6,18,26,1,44,44,0,0,0,0
S01007533,Owned: Owned with a mortgage or loan or shared ownership,49,44,25,1,24,19,0,5,5,0,0,0,0
S01007533,Rented or living rent free: Total,78,59,40,5,35,16,3,19,18,0,0,1,0
S01007533,Rented or living rent free: Social rented,13,5,4,0,4,1,0,8,7,0,0,1,0
S01007533,Rented or living rent free: Private rented or living rent free,65,54,36,5,31,15,3,11,11,0,0,0,0
S01007534,All HRPs aged 16 and over,428,230,166,32,134,57,7,198,163,1,7,21,6
S01007534,Owned: Total,259,156,107,16,91,48,1,103,99,0,0,2,2
S01007534,Owned: Owned outright,150,61,44,11,33,17,0,89,86,0,0,1,2
S01007534,Owned: Owned with a mortgage or loan or shared ownership,109,95,63,5,58,31,1,14,13,0,0,1,0
S01007534,Rented or living rent free: Total,169,74,59,16,43,9,6,95,64,1,7,19,4
S01007534,Rented or living rent free: Social rented,127,47,38,12,26,5,4,80,57,0,4,15,4
S01007534,Rented or living rent free: Private rented or living rent free,42,27,21,4,17,4,2,15,7,1,3,4,0
S01007535,All HRPs aged 16 and over,492,280,208,54,154,50,22,212,170,4,8,18,12
S01007535,Owned: Total,262,147,111,20,91,34,2,115,115,0,0,0,0
S01007535,Owned: Owned outright,173,63,43,11,32,18,2,110,110,0,0,0,0
S01007535,Owned: Owned with a mortgage or loan or shared ownership,89,84,68,9,59,16,0,5,5,0,0,0,0
S01007535,Rented or living rent free: Total,230,133,97,34,63,16,20,97,55,4,8,18,12
S01007535,Rented or living rent free: Social rented,203,115,83,30,53,12,20,88,46,4,8,18,12
S01007535,Rented or living rent free: Private rented or living rent free,27,18,14,4,10,4,0,9,9,0,0,0,0
S01007536,All HRPs aged 16 and over,443,277,212,48,164,58,7,166,143,0,4,16,3
S01007536,Owned: Total,277,168,128,23,105,39,1,109,103,0,0,4,2
S01007536,Owned: Owned outright,172,69,46,13,33,22,1,103,98,0,0,3,2
S01007536,Owned: Owned with a mortgage or loan or shared ownership,105,99,82,10,72,17,0,6,5,0,0,1,0
S01007536,Rented or living rent free: Total,166,109,84,25,59,19,6,57,40,0,4,12,1
S01007536,Rented or living rent free: Social rented,66,32,25,10,15,3,4,34,23,0,4,7,0
S01007536,Rented or living rent free: Private rented or living rent free,100,77,59,15,44,16,2,23,17,0,0,5,1
S01007537,All HRPs aged 16 and over,518,291,220,50,170,60,11,227,188,0,3,27,9
S01007537,Owned: Total,308,164,111,17,94,52,1,144,140,0,0,2,2
S01007537,Owned: Owned outright,217,82,49,14,35,32,1,135,132,0,0,1,2
S01007537,Owned: Owned with a mortgage or loan or shared ownership,91,82,62,3,59,20,0,9,8,0,0,1,0
S01007537,Rented or living rent free: Total,210,127,109,33,76,8,10,83,48,0,3,25,7
S01007537,Rented or living rent free: Social rented,117,51,44,18,26,2,5,66,36,0,2,22,6
S01007537,Rented or living rent free: Private rented or living rent free,93,76,65,15,50,6,5,17,12,0,1,3,1
S01007538,All HRPs aged 16 and over,366,261,160,27,133,95,6,105,97,1,3,2,2
S01007538,Owned: Total,261,178,100,17,83,75,3,83,81,0,0,1,1
S01007538,Owned: Owned outright,163,86,38,13,25,46,2,77,75,0,0,1,1
S01007538,Owned: Owned with a mortgage or loan or shared ownership,98,92,62,4,58,29,1,6,6,0,0,0,0
S01007538,Rented or living rent free: Total,105,83,60,10,50,20,3,22,16,1,3,1,1
S01007538,Rented or living rent free: Social rented,14,4,2,1,1,1,1,10,5,1,2,1,1
S01007538,Rented or living rent free: Private rented or living rent free,91,79,58,9,49,19,2,12,11,0,1,0,0
S01007539,All HRPs aged 16 and over,331,166,135,21,114,30,1,165,159,0,0,5,1
S01007539,Owned: Total,298,144,117,17,100,27,0,154,152,0,0,1,1
S01007539,Owned: Owned outright,211,66,48,13,35,18,0,145,143,0,0,1,1
S01007539,Owned: Owned with a mortgage or loan or shared ownership,87,78,69,4,65,9,0,9,9,0,0,0,0
S01007539,Rented or living rent free: Total,33,22,18,4,14,3,1,11,7,0,0,4,0
S01007539,Rented or living rent free: Social rented,1,1,1,1,0,0,0,0,0,0,0,0,0
S01007539,Rented or living rent free: Private rented or living rent free,32,21,17,3,14,3,1,11,7,0,0,4,0
S01007540,All HRPs aged 16 and over,450,228,180,40,140,34,14,222,187,0,4,25,6
S01007540,Owned: Total,260,154,129,20,109,24,1,106,102,0,0,3,1
S01007540,Owned: Owned outright,154,57,49,15,34,7,1,97,94,0,0,2,1
S01007540,Owned: Owned with a mortgage or loan or shared ownership,106,97,80,5,75,17,0,9,8,0,0,1,0
S01007540,Rented or living rent free: Total,190,74,51,20,31,10,13,116,85,0,4,22,5
S01007540,Rented or living rent free: Social rented,134,39,25,10,15,6,8,95,75,0,1,16,3
S01007540,Rented or living rent free: Private rented or living rent free,56,35,26,10,16,4,5,21,10,0,3,6,2
S01007541,All HRPs aged 16 and over,337,199,158,27,131,35,6,138,130,0,1,4,3
S01007541,Owned: Total,267,155,124,13,111,29,2,112,110,0,0,0,2
S01007541,Owned: Owned outright,171,65,54,6,48,11,0,106,104,0,0,0,2
S01007541,Owned: Owned with a mortgage or loan or shared ownership,96,90,70,7,63,18,2,6,6,0,0,0,0
S01007541,Rented or living rent free: Total,70,44,34,14,20,6,4,26,20,0,1,4,1
S01007541,Rented or living rent free: Social rented,27,12,11,6,5,0,1,15,12,0,0,3,0
S01007541,Rented or living rent free: Private rented or living rent free,43,32,23,8,15,6,3,11,8,0,1,1,1
S01007542,All HRPs aged 16 and over,416,286,206,54,152,48,32,130,109,0,5,13,3
S01007542,Owned: Total,259,176,133,28,105,38,5,83,79,0,0,2,2
S01007542,Owned: Owned outright,141,69,42,16,26,24,3,72,69,0,0,1,2
S01007542,Owned: Owned with a mortgage or loan or shared ownership,118,107,91,12,79,14,2,11,10,0,0,1,0
S01007542,Rented or living rent free: Total,157,110,73,26,47,10,27,47,30,0,5,11,1
S01007542,Rented or living rent free: Social rented,111,81,52,24,28,6,23,30,18,0,3,8,1
S01007542,Rented or living rent free: Private rented or living rent free,46,29,21,2,19,4,4,17,12,0,2,3,0
S01007543,All HRPs aged 16 and over,481,317,255,65,190,46,16,164,120,0,8,31,5
S01007543,Owned: Total,278,204,166,27,139,35,3,74,70,0,0,3,1
S01007543,Owned: Owned outright,141,77,63,19,44,11,3,64,62,0,0,1,1
S01007543,Owned: Owned with a mortgage or loan or shared ownership,137,127,103,8,95,24,0,10,8,0,0,2,0
S01007543,Rented or living rent free: Total,203,113,89,38,51,11,13,90,50,0,8,28,4
S01007543,Rented or living rent free: Social rented,142,69,55,24,31,4,10,73,40,0,7,23,3
S01007543,Rented or living rent free: Private rented or living rent free,61,44,34,14,20,7,3,17,10,0,1,5,1
S01007544,All HRPs aged 16 and over,496,243,133,19,114,107,3,253,239,3,1,3,7
S01007544,Owned: Total,409,187,98,15,83,87,2,222,213,2,1,1,5
S01007544,Owned: Owned outright,312,110,53,12,41,57,0,202,194,2,1,1,4
S01007544,Owned: Owned with a mortgage or loan or shared ownership,97,77,45,3,42,30,2,20,19,0,0,0,1
S01007544,Rented or living rent free: Total,87,56,35,4,31,20,1,31,26,1,0,2,2
S01007544,Rented or living rent free: Social rented,9,3,3,0,3,0,0,6,2,0,0,2,2
S01007544,Rented or living rent free: Private rented or living rent free,78,53,32,4,28,20,1,25,24,1,0,0,0
S01007545,All HRPs aged 16 and over,359,218,129,18,111,82,7,141,125,2,3,7,4
S01007545,Owned: Total,257,151,85,11,74,65,1,106,103,1,1,1,0
S01007545,Owned: Owned outright,186,89,42,9,33,46,1,97,95,1,0,1,0
S01007545,Owned: Owned with a mortgage or loan or shared ownership,71,62,43,2,41,19,0,9,8,0,1,0,0
S01007545,Rented or living rent free: Total,102,67,44,7,37,17,6,35,22,1,2,6,4
S01007545,Rented or living rent free: Social rented,30,14,8,2,6,2,4,16,10,0,2,3,1
S01007545,Rented or living rent free: Private rented or living rent free,72,53,36,5,31,15,2,19,12,1,0,3,3
S01007546,All HRPs aged 16 and over,223,155,99,15,84,54,2,68,63,1,0,3,1
S01007546,Owned: Total,181,128,78,13,65,50,0,53,51,1,0,1,0
S01007546,Owned: Owned outright,91,48,20,7,13,28,0,43,41,1,0,1,0
S01007546,Owned: Owned with a mortgage or loan or shared ownership,90,80,58,6,52,22,0,10,10,0,0,0,0
S01007546,Rented or living rent free: Total,42,27,21,2,19,4,2,15,12,0,0,2,1
S01007546,Rented or living rent free: Social rented,13,5,4,1,3,0,1,8,6,0,0,1,1
S01007546,Rented or living rent free: Private rented or living rent free,29,22,17,1,16,4,1,7,6,0,0,1,0
S01007547,All HRPs aged 16 and over,239,181,111,14,97,67,3,58,50,3,0,3,2
S01007547,Owned: Total,162,126,70,7,63,54,2,36,33,1,0,0,2
S01007547,Owned: Owned outright,96,63,30,2,28,32,1,33,31,0,0,0,2
S01007547,Owned: Owned with a mortgage or loan or shared ownership,66,63,40,5,35,22,1,3,2,1,0,0,0
S01007547,Rented or living rent free: Total,77,55,41,7,34,13,1,22,17,2,0,3,0
S01007547,Rented or living rent free: Social rented,16,7,5,1,4,1,1,9,7,1,0,1,0
S01007547,Rented or living rent free: Private rented or living rent free,61,48,36,6,30,12,0,13,10,1,0,2,0
S01007548,All HRPs aged 16 and over,304,193,142,33,109,40,11,111,96,0,5,8,2
S01007548,Owned: Total,202,130,96,19,77,31,3,72,67,0,2,2,1
S01007548,Owned: Owned outright,116,52,32,11,21,18,2,64,60,0,2,1,1
S01007548,Owned: Owned with a mortgage or loan or shared ownership,86,78,64,8,56,13,1,8,7,0,0,1,0
S01007548,Rented or living rent free: Total,102,63,46,14,32,9,8,39,29,0,3,6,1
S01007548,Rented or living rent free: Social rented,49,30,20,8,12,4,6,19,13,0,1,4,1
S01007548,Rented or living rent free: Private rented or living rent free,53,33,26,6,20,5,2,20,16,0,2,2,0
S01007549,All HRPs aged 16 and over,298,168,112,29,83,47,9,130,120,4,1,4,1
S01007549,Owned: Total,187,100,60,12,48,38,2,87,85,1,0,1,0
S01007549,Owned: Owned outright,138,54,29,9,20,25,0,84,82,1,0,1,0
S01007549,Owned: Owned with a mortgage or loan or shared ownership,49,46,31,3,28,13,2,3,3,0,0,0,0
S01007549,Rented or living rent free: Total,111,68,52,17,35,9,7,43,35,3,1,3,1
S01007549,Rented or living rent free: Social rented,50,27,22,10,12,1,4,23,16,2,1,3,1
S01007549,Rented or living rent free: Private rented or living rent free,61,41,30,7,23,8,3,20,19,1,0,0,0
S01007550,All HRPs aged 16 and over,449,216,147,29,118,63,6,233,206,2,5,15,5
S01007550,Owned: Total,287,135,89,18,71,46,0,152,148,0,0,1,3
S01007550,Owned: Owned outright,205,68,38,10,28,30,0,137,133,0,0,1,3
S01007550,Owned: Owned with a mortgage or loan or shared ownership,82,67,51,8,43,16,0,15,15,0,0,0,0
S01007550,Rented or living rent free: Total,162,81,58,11,47,17,6,81,58,2,5,14,2
S01007550,Rented or living rent free: Social rented,67,28,23,3,20,2,3,39,26,1,2,9,1
S01007550,Rented or living rent free: Private rented or living rent free,95,53,35,8,27,15,3,42,32,1,3,5,1
S01007551,All HRPs aged 16 and over,395,256,135,27,108,118,3,139,123,0,4,9,3
S01007551,Owned: Total,283,186,87,18,69,97,2,97,91,0,2,1,3
S01007551,Owned: Owned outright,199,110,44,13,31,64,2,89,83,0,2,1,3
S01007551,Owned: Owned with a mortgage or loan or shared ownership,84,76,43,5,38,33,0,8,8,0,0,0,0
S01007551,Rented or living rent free: Total,112,70,48,9,39,21,1,42,32,0,2,8,0
S01007551,Rented or living rent free: Social rented,18,7,6,3,3,1,0,11,8,0,0,3,0
S01007551,Rented or living rent free: Private rented or living rent free,94,63,42,6,36,20,1,31,24,0,2,5,0
S01007552,All HRPs aged 16 and over,401,249,188,34,154,33,28,152,98,2,7,39,6
S01007552,Owned: Total,191,124,98,7,91,25,1,67,62,0,0,4,1
S01007552,Owned: Owned outright,111,52,39,5,34,12,1,59,55,0,0,3,1
S01007552,Owned: Owned with a mortgage or loan or shared ownership,80,72,59,2,57,13,0,8,7,0,0,1,0
S01007552,Rented or living rent free: Total,210,125,90,27,63,8,27,85,36,2,7,35,5
S01007552,Rented or living rent free: Social rented,173,94,68,22,46,3,23,79,34,2,6,32,5
S01007552,Rented or living rent free: Private rented or living rent free,37,31,22,5,17,5,4,6,2,0,1,3,0
S01007553,All HRPs aged 16 and over,376,191,154,28,126,21,16,185,114,3,13,44,11
S01007553,Owned: Total,172,102,86,6,80,16,0,70,60,0,1,7,2
S01007553,Owned: Owned outright,92,37,27,3,24,10,0,55,47,0,0,6,2
S01007553,Owned: Owned with a mortgage or loan or shared ownership,80,65,59,3,56,6,0,15,13,0,1,1,0
S01007553,Rented or living rent free: Total,204,89,68,22,46,5,16,115,54,3,12,37,9
S01007553,Rented or living rent free: Social rented,189,81,63,20,43,4,14,108,52,3,10,34,9
S01007553,Rented or living rent free: Private rented or living rent free,15,8,5,2,3,1,2,7,2,0,2,3,0
S01007554,All HRPs aged 16 and over,221,97,78,13,65,5,14,124,77,3,15,24,5
S01007554,Owned: Total,77,40,35,4,31,4,1,37,35,0,1,1,0
S01007554,Owned: Owned outright,50,22,19,3,16,3,0,28,27,0,1,0,0
S01007554,Owned: Owned with a mortgage or loan or shared ownership,27,18,16,1,15,1,1,9,8,0,0,1,0
S01007554,Rented or living rent free: Total,144,57,43,9,34,1,13,87,42,3,14,23,5
S01007554,Rented or living rent free: Social rented,137,53,40,9,31,1,12,84,41,3,13,22,5
S01007554,Rented or living rent free: Private rented or living rent free,7,4,3,0,3,0,1,3,1,0,1,1,0
S01007555,All HRPs aged 16 and over,238,137,100,10,90,31,6,101,92,0,2,3,4
S01007555,Owned: Total,175,104,74,7,67,27,3,71,67,0,1,0,3
S01007555,Owned: Owned outright,105,39,28,5,23,11,0,66,63,0,0,0,3
S01007555,Owned: Owned with a mortgage or loan or shared ownership,70,65,46,2,44,16,3,5,4,0,1,0,0
S01007555,Rented or living rent free: Total,63,33,26,3,23,4,3,30,25,0,1,3,1
S01007555,Rented or living rent free: Social rented,34,9,6,1,5,0,3,25,21,0,0,3,1
S01007555,Rented or living rent free: Private rented or living rent free,29,24,20,2,18,4,0,5,4,0,1,0,0
S01007556,All HRPs aged 16 and over,227,121,94,18,76,21,6,106,86,0,1,14,5
S01007556,Owned: Total,105,70,52,6,46,18,0,35,34,0,1,0,0
S01007556,Owned: Owned outright,59,29,19,5,14,10,0,30,30,0,0,0,0
S01007556,Owned: Owned with a mortgage or loan or shared ownership,46,41,33,1,32,8,0,5,4,0,1,0,0
S01007556,Rented or living rent free: Total,122,51,42,12,30,3,6,71,52,0,0,14,5
S01007556,Rented or living rent free: Social rented,103,36,30,10,20,2,4,67,51,0,0,13,3
S01007556,Rented or living rent free: Private rented or living rent free,19,15,12,2,10,1,2,4,1,0,0,1,2
S01007557,All HRPs aged 16 and over,478,285,236,47,189,24,25,193,154,3,11,23,2
S01007557,Owned: Total,248,156,136,21,115,18,2,92,85,1,2,3,1
S01007557,Owned: Owned outright,115,48,42,12,30,5,1,67,65,1,0,1,0
S01007557,Owned: Owned with a mortgage or loan or shared ownership,133,108,94,9,85,13,1,25,20,0,2,2,1
S01007557,Rented or living rent free: Total,230,129,100,26,74,6,23,101,69,2,9,20,1
S01007557,Rented or living rent free: Social rented,196,103,78,24,54,3,22,93,63,2,9,18,1
S01007557,Rented or living rent free: Private rented or living rent free,34,26,22,2,20,3,1,8,6,0,0,2,0
S01007558,All HRPs aged 16 and over,189,112,71,11,60,36,5,77,64,0,3,9,1
S01007558,Owned: Total,143,86,54,7,47,28,4,57,54,0,1,1,1
S01007558,Owned: Owned outright,92,37,21,5,16,14,2,55,54,0,0,0,1
S01007558,Owned: Owned with a mortgage or loan or shared ownership,51,49,33,2,31,14,2,2,0,0,1,1,0
S01007558,Rented or living rent free: Total,46,26,17,4,13,8,1,20,10,0,2,8,0
S01007558,Rented or living rent free: Social rented,10,1,1,0,1,0,0,9,1,0,1,7,0
S01007558,Rented or living rent free: Private rented or living rent free,36,25,16,4,12,8,1,11,9,0,1,1,0
S01007559,All HRPs aged 16 and over,308,232,146,18,128,80,6,76,67,0,2,7,0
S01007559,Owned: Total,165,118,72,7,65,42,4,47,47,0,0,0,0
S01007559,Owned: Owned outright,93,49,26,4,22,22,1,44,44,0,0,0,0
S01007559,Owned: Owned with a mortgage or loan or shared ownership,72,69,46,3,43,20,3,3,3,0,0,0,0
S01007559,Rented or living rent free: Total,143,114,74,11,63,38,2,29,20,0,2,7,0
S01007559,Rented or living rent free: Social rented,14,4,2,2,0,1,1,10,5,0,1,4,0
S01007559,Rented or living rent free: Private rented or living rent free,129,110,72,9,63,37,1,19,15,0,1,3,0
S01007560,All HRPs aged 16 and over,440,239,188,44,144,46,5,201,176,1,4,14,6
S01007560,Owned: Total,275,167,128,27,101,38,1,108,104,0,1,2,1
S01007560,Owned: Owned outright,176,75,57,19,38,17,1,101,99,0,1,1,0
S01007560,Owned: Owned with a mortgage or loan or shared ownership,99,92,71,8,63,21,0,7,5,0,0,1,1
S01007560,Rented or living rent free: Total,165,72,60,17,43,8,4,93,72,1,3,12,5
S01007560,Rented or living rent free: Social rented,92,34,30,11,19,2,2,58,43,0,1,10,4
S01007560,Rented or living rent free: Private rented or living rent free,73,38,30,6,24,6,2,35,29,1,2,2,1
S01007561,All HRPs aged 16 and over,357,174,139,40,99,28,7,183,162,2,2,13,4
S01007561,Owned: Total,233,117,89,19,70,25,3,116,111,0,0,4,1
S01007561,Owned: Owned outright,156,52,38,13,25,12,2,104,99,0,0,4,1
S01007561,Owned: Owned with a mortgage or loan or shared ownership,77,65,51,6,45,13,1,12,12,0,0,0,0
S01007561,Rented or living rent free: Total,124,57,50,21,29,3,4,67,51,2,2,9,3
S01007561,Rented or living rent free: Social rented,80,31,25,10,15,2,4,49,41,0,0,5,3
S01007561,Rented or living rent free: Private rented or living rent free,44,26,25,11,14,1,0,18,10,2,2,4,0
S01007562,All HRPs aged 16 and over,365,233,164,34,130,64,5,132,101,4,9,16,2
S01007562,Owned: Total,211,133,93,14,79,40,0,78,73,1,1,1,2
S01007562,Owned: Owned outright,125,54,29,11,18,25,0,71,68,0,0,1,2
S01007562,Owned: Owned with a mortgage or loan or shared ownership,86,79,64,3,61,15,0,7,5,1,1,0,0
S01007562,Rented or living rent free: Total,154,100,71,20,51,24,5,54,28,3,8,15,0
S01007562,Rented or living rent free: Social rented,53,24,21,13,8,1,2,29,14,1,6,8,0
S01007562,Rented or living rent free: Private rented or living rent free,101,76,50,7,43,23,3,25,14,2,2,7,0
S01007563,All HRPs aged 16 and over,396,236,147,38,109,84,5,160,141,1,6,10,2
S01007563,Owned: Total,248,150,90,22,68,58,2,98,94,0,2,2,0
S01007563,Owned: Owned outright,158,62,28,12,16,32,2,96,92,0,2,2,0
S01007563,Owned: Owned with a mortgage or loan or shared ownership,90,88,62,10,52,26,0,2,2,0,0,0,0
S01007563,Rented or living rent free: Total,148,86,57,16,41,26,3,62,47,1,4,8,2
S01007563,Rented or living rent free: Social rented,45,15,11,7,4,2,2,30,20,0,3,7,0
S01007563,Rented or living rent free: Private rented or living rent free,103,71,46,9,37,24,1,32,27,1,1,1,2
S01007564,All HRPs aged 16 and over,323,215,124,28,96,84,7,108,100,0,3,5,0
S01007564,Owned: Total,215,148,74,16,58,71,3,67,63,0,2,2,0
S01007564,Owned: Owned outright,143,83,32,11,21,48,3,60,58,0,2,0,0
S01007564,Owned: Owned with a mortgage or loan or shared ownership,72,65,42,5,37,23,0,7,5,0,0,2,0
S01007564,Rented or living rent free: Total,108,67,50,12,38,13,4,41,37,0,1,3,0
S01007564,Rented or living rent free: Social rented,28,13,6,4,2,4,3,15,13,0,1,1,0
S01007564,Rented or living rent free: Private rented or living rent free,80,54,44,8,36,9,1,26,24,0,0,2,0
S01007565,All HRPs aged 16 and over,396,247,189,30,159,51,7,149,125,0,6,12,6
S01007565,Owned: Total,274,171,127,18,109,41,3,103,92,0,3,3,5
S01007565,Owned: Owned outright,155,72,43,10,33,26,3,83,75,0,2,1,5
S01007565,Owned: Owned with a mortgage or loan or shared ownership,119,99,84,8,76,15,0,20,17,0,1,2,0
S01007565,Rented or living rent free: Total,122,76,62,12,50,10,4,46,33,0,3,9,1
S01007565,Rented or living rent free: Social rented,47,22,17,7,10,2,3,25,17,0,0,7,1
S01007565,Rented or living rent free: Private rented or living rent free,75,54,45,5,40,8,1,21,16,0,3,2,0
S01007566,All HRPs aged 16 and over,275,189,118,17,101,68,3,86,71,1,6,5,3
S01007566,Owned: Total,196,139,82,10,72,55,2,57,54,0,1,1,1
S01007566,Owned: Owned outright,116,64,30,7,23,33,1,52,50,0,0,1,1
S01007566,Owned: Owned with a mortgage or loan or shared ownership,80,75,52,3,49,22,1,5,4,0,1,0,0
S01007566,Rented or living rent free: Total,79,50,36,7,29,13,1,29,17,1,5,4,2
S01007566,Rented or living rent free: Social rented,26,12,9,4,5,2,1,14,9,1,2,2,0
S01007566,Rented or living rent free: Private rented or living rent free,53,38,27,3,24,11,0,15,8,0,3,2,2
S01007567,All HRPs aged 16 and over,233,175,110,19,91,60,5,58,52,1,0,5,0
S01007567,Owned: Total,172,125,73,14,59,50,2,47,44,1,0,2,0
S01007567,Owned: Owned outright,103,60,28,7,21,31,1,43,41,0,0,2,0
S01007567,Owned: Owned with a mortgage or loan or shared ownership,69,65,45,7,38,19,1,4,3,1,0,0,0
S01007567,Rented or living rent free: Total,61,50,37,5,32,10,3,11,8,0,0,3,0
S01007567,Rented or living rent free: Social rented,9,5,4,0,4,0,1,4,2,0,0,2,0
S01007567,Rented or living rent free: Private rented or living rent free,52,45,33,5,28,10,2,7,6,0,0,1,0
S01007568,All HRPs aged 16 and over,295,206,158,26,132,46,2,89,79,0,2,8,0
S01007568,Owned: Total,191,134,100,16,84,34,0,57,53,0,1,3,0
S01007568,Owned: Owned outright,107,57,40,10,30,17,0,50,46,0,1,3,0
S01007568,Owned: Owned with a mortgage or loan or shared ownership,84,77,60,6,54,17,0,7,7,0,0,0,0
S01007568,Rented or living rent free: Total,104,72,58,10,48,12,2,32,26,0,1,5,0
S01007568,Rented or living rent free: Social rented,18,10,8,4,4,0,2,8,6,0,0,2,0
S01007568,Rented or living rent free: Private rented or living rent free,86,62,50,6,44,12,0,24,20,0,1,3,0
S01007569,All HRPs aged 16 and over,342,227,171,27,144,55,1,115,104,1,1,8,1
S01007569,Owned: Total,203,124,86,11,75,38,0,79,74,0,0,4,1
S01007569,Owned: Owned outright,136,65,37,9,28,28,0,71,67,0,0,3,1
S01007569,Owned: Owned with a mortgage or loan or shared ownership,67,59,49,2,47,10,0,8,7,0,0,1,0
S01007569,Rented or living rent free: Total,139,103,85,16,69,17,1,36,30,1,1,4,0
S01007569,Rented or living rent free: Social rented,35,19,19,6,13,0,0,16,13,0,1,2,0
S01007569,Rented or living rent free: Private rented or living rent free,104,84,66,10,56,17,1,20,17,1,0,2,0
S01007570,All HRPs aged 16 and over,295,188,134,21,113,42,12,107,90,0,6,7,4
S01007570,Owned: Total,218,138,101,13,88,36,1,80,80,0,0,0,0
S01007570,Owned: Owned outright,136,60,37,9,28,22,1,76,76,0,0,0,0
S01007570,Owned: Owned with a mortgage or loan or shared ownership,82,78,64,4,60,14,0,4,4,0,0,0,0
S01007570,Rented or living rent free: Total,77,50,33,8,25,6,11,27,10,0,6,7,4
S01007570,Rented or living rent free: Social rented,48,32,19,8,11,2,11,16,3,0,5,5,3
S01007570,Rented or living rent free: Private rented or living rent free,29,18,14,0,14,4,0,11,7,0,1,2,1
S01007571,All HRPs aged 16 and over,240,167,110,20,90,53,4,73,63,1,1,5,3
S01007571,Owned: Total,162,113,72,12,60,39,2,49,45,0,0,1,3
S01007571,Owned: Owned outright,95,53,26,7,19,26,1,42,41,0,0,0,1
S01007571,Owned: Owned with a mortgage or loan or shared ownership,67,60,46,5,41,13,1,7,4,0,0,1,2
S01007571,Rented or living rent free: Total,78,54,38,8,30,14,2,24,18,1,1,4,0
S01007571,Rented or living rent free: Social rented,7,3,1,1,0,1,1,4,1,0,0,3,0
S01007571,Rented or living rent free: Private rented or living rent free,71,51,37,7,30,13,1,20,17,1,1,1,0
S01007572,All HRPs aged 16 and over,370,239,179,29,150,47,13,131,105,1,11,11,3
S01007572,Owned: Total,263,167,125,19,106,41,1,96,92,0,1,3,0
S01007572,Owned: Owned outright,145,64,45,12,33,18,1,81,79,0,0,2,0
S01007572,Owned: Owned with a mortgage or loan or shared ownership,118,103,80,7,73,23,0,15,13,0,1,1,0
S01007572,Rented or living rent free: Total,107,72,54,10,44,6,12,35,13,1,10,8,3
S01007572,Rented or living rent free: Social rented,82,50,37,8,29,2,11,32,12,1,9,7,3
S01007572,Rented or living rent free: Private rented or living rent free,25,22,17,2,15,4,1,3,1,0,1,1,0
S01007573,All HRPs aged 16 and over,329,291,259,18,241,30,2,38,30,0,3,3,2
S01007573,Owned: Total,274,243,219,13,206,22,2,31,25,0,2,2,2
S01007573,Owned: Owned outright,60,37,33,4,29,4,0,23,20,0,1,1,1
S01007573,Owned: Owned with a mortgage or loan or shared ownership,214,206,186,9,177,18,2,8,5,0,1,1,1
S01007573,Rented or living rent free: Total,55,48,40,5,35,8,0,7,5,0,1,1,0
S01007573,Rented or living rent free: Social rented,9,6,4,2,2,2,0,3,2,0,0,1,0
S01007573,Rented or living rent free: Private rented or living rent free,46,42,36,3,33,6,0,4,3,0,1,0,0
S01007574,All HRPs aged 16 and over,438,280,239,54,185,20,21,158,128,2,6,16,6
S01007574,Owned: Total,258,176,158,24,134,13,5,82,74,0,1,3,4
S01007574,Owned: Owned outright,112,45,37,11,26,4,4,67,62,0,0,3,2
S01007574,Owned: Owned with a mortgage or loan or shared ownership,146,131,121,13,108,9,1,15,12,0,1,0,2
S01007574,Rented or living rent free: Total,180,104,81,30,51,7,16,76,54,2,5,13,2
S01007574,Rented or living rent free: Social rented,155,87,67,27,40,7,13,68,49,1,5,11,2
S01007574,Rented or living rent free: Private rented or living rent free,25,17,14,3,11,0,3,8,5,1,0,2,0
S01007575,All HRPs aged 16 and over,452,255,198,55,143,23,34,197,144,4,13,27,9
S01007575,Owned: Total,207,131,118,19,99,13,0,76,68,2,1,3,2
S01007575,Owned: Owned outright,109,42,36,9,27,6,0,67,61,2,0,2,2
S01007575,Owned: Owned with a mortgage or loan or shared ownership,98,89,82,10,72,7,0,9,7,0,1,1,0
S01007575,Rented or living rent free: Total,245,124,80,36,44,10,34,121,76,2,12,24,7
S01007575,Rented or living rent free: Social rented,219,105,66,27,39,6,33,114,72,0,12,23,7
S01007575,Rented or living rent free: Private rented or living rent free,26,19,14,9,5,4,1,7,4,2,0,1,0
S01007576,All HRPs aged 16 and over,344,203,136,48,88,14,53,141,69,1,15,42,14
S01007576,Owned: Total,91,58,48,9,39,10,0,33,27,1,0,4,1
S01007576,Owned: Owned outright,47,17,14,5,9,3,0,30,25,1,0,3,1
S01007576,Owned: Owned with a mortgage or loan or shared ownership,44,41,34,4,30,7,0,3,2,0,0,1,0
S01007576,Rented or living rent free: Total,253,145,88,39,49,4,53,108,42,0,15,38,13
S01007576,Rented or living rent free: Social rented,237,135,80,38,42,4,51,102,40,0,14,38,10
S01007576,Rented or living rent free: Private rented or living rent free,16,10,8,1,7,0,2,6,2,0,1,0,3
S01007577,All HRPs aged 16 and over,296,179,137,41,96,13,29,117,68,3,15,26,5
S01007577,Owned: Total,107,65,55,9,46,9,1,42,36,0,2,4,0
S01007577,Owned: Owned outright,53,21,16,3,13,4,1,32,28,0,1,3,0
S01007577,Owned: Owned with a mortgage or loan or shared ownership,54,44,39,6,33,5,0,10,8,0,1,1,0
S01007577,Rented or living rent free: Total,189,114,82,32,50,4,28,75,32,3,13,22,5
S01007577,Rented or living rent free: Social rented,176,104,76,32,44,2,26,72,30,3,13,21,5
S01007577,Rented or living rent free: Private rented or living rent free,13,10,6,0,6,2,2,3,2,0,0,1,0
S01007578,All HRPs aged 16 and over,332,193,152,42,110,17,24,139,94,2,13,26,4
S01007578,Owned: Total,109,64,55,10,45,9,0,45,42,0,1,2,0
S01007578,Owned: Owned outright,54,17,14,4,10,3,0,37,35,0,0,2,0
S01007578,Owned: Owned with a mortgage or loan or shared ownership,55,47,41,6,35,6,0,8,7,0,1,0,0
S01007578,Rented or living rent free: Total,223,129,97,32,65,8,24,94,52,2,12,24,4
S01007578,Rented or living rent free: Social rented,192,103,78,25,53,4,21,89,48,2,12,24,3
S01007578,Rented or living rent free: Private rented or living rent free,31,26,19,7,12,4,3,5,4,0,0,0,1
S01007579,All HRPs aged 16 and over,298,198,171,50,121,9,18,100,58,1,10,26,5
S01007579,Owned: Total,96,69,66,10,56,1,2,27,25,0,0,2,0
S01007579,Owned: Owned outright,34,11,10,5,5,0,1,23,21,0,0,2,0
S01007579,Owned: Owned with a mortgage or loan or shared ownership,62,58,56,5,51,1,1,4,4,0,0,0,0
S01007579,Rented or living rent free: Total,202,129,105,40,65,8,16,73,33,1,10,24,5
S01007579,Rented or living rent free: Social rented,179,110,88,33,55,7,15,69,31,1,10,22,5
S01007579,Rented or living rent free: Private rented or living rent free,23,19,17,7,10,1,1,4,2,0,0,2,0
S01007580,All HRPs aged 16 and over,293,193,168,47,121,8,17,100,57,3,10,28,2
S01007580,Owned: Total,128,94,86,13,73,6,2,34,31,1,0,2,0
S01007580,Owned: Owned outright,49,21,20,3,17,1,0,28,28,0,0,0,0
S01007580,Owned: Owned with a mortgage or loan or shared ownership,79,73,66,10,56,5,2,6,3,1,0,2,0
S01007580,Rented or living rent free: Total,165,99,82,34,48,2,15,66,26,2,10,26,2
S01007580,Rented or living rent free: Social rented,135,74,61,29,32,1,12,61,24,2,10,23,2
S01007580,Rented or living rent free: Private rented or living rent free,30,25,21,5,16,1,3,5,2,0,0,3,0
S01007581,All HRPs aged 16 and over,198,119,99,30,69,13,7,79,50,0,6,15,8
S01007581,Owned: Total,103,68,56,11,45,10,2,35,29,0,0,1,5
S01007581,Owned: Owned outright,52,22,18,5,13,3,1,30,25,0,0,1,4
S01007581,Owned: Owned with a mortgage or loan or shared ownership,51,46,38,6,32,7,1,5,4,0,0,0,1
S01007581,Rented or living rent free: Total,95,51,43,19,24,3,5,44,21,0,6,14,3
S01007581,Rented or living rent free: Social rented,75,35,30,15,15,0,5,40,19,0,4,14,3
S01007581,Rented or living rent free: Private rented or living rent free,20,16,13,4,9,3,0,4,2,0,2,0,0
S01007582,All HRPs aged 16 and over,285,185,155,35,120,19,11,100,66,1,7,23,3
S01007582,Owned: Total,134,97,84,10,74,12,1,37,32,0,0,3,2
S01007582,Owned: Owned outright,50,17,14,3,11,3,0,33,28,0,0,3,2
S01007582,Owned: Owned with a mortgage or loan or shared ownership,84,80,70,7,63,9,1,4,4,0,0,0,0
S01007582,Rented or living rent free: Total,151,88,71,25,46,7,10,63,34,1,7,20,1
S01007582,Rented or living rent free: Social rented,127,70,56,21,35,5,9,57,29,1,7,19,1
S01007582,Rented or living rent free: Private rented or living rent free,24,18,15,4,11,2,1,6,5,0,0,1,0
S01007583,All HRPs aged 16 and over,519,315,260,83,177,23,32,204,126,3,11,45,19
S01007583,Owned: Total,131,88,80,16,64,5,3,43,37,0,2,2,2
S01007583,Owned: Owned outright,54,22,19,6,13,2,1,32,29,0,1,0,2
S01007583,Owned: Owned with a mortgage or loan or shared ownership,77,66,61,10,51,3,2,11,8,0,1,2,0
S01007583,Rented or living rent free: Total,388,227,180,67,113,18,29,161,89,3,9,43,17
S01007583,Rented or living rent free: Social rented,338,189,148,61,87,12,29,149,86,2,9,39,13
S01007583,Rented or living rent free: Private rented or living rent free,50,38,32,6,26,6,0,12,3,1,0,4,4
S01007584,All HRPs aged 16 and over,279,188,150,37,113,21,17,91,70,1,4,11,5
S01007584,Owned: Total,144,94,76,13,63,17,1,50,49,0,0,1,0
S01007584,Owned: Owned outright,64,21,16,10,6,4,1,43,43,0,0,0,0
S01007584,Owned: Owned with a mortgage or loan or shared ownership,80,73,60,3,57,13,0,7,6,0,0,1,0
S01007584,Rented or living rent free: Total,135,94,74,24,50,4,16,41,21,1,4,10,5
S01007584,Rented or living rent free: Social rented,100,66,53,19,34,0,13,34,16,1,4,10,3
S01007584,Rented or living rent free: Private rented or living rent free,35,28,21,5,16,4,3,7,5,0,0,0,2
S01007585,All HRPs aged 16 and over,437,220,186,40,146,29,5,217,207,1,1,8,0
S01007585,Owned: Total,368,184,161,32,129,22,1,184,182,0,0,2,0
S01007585,Owned: Owned outright,237,68,59,22,37,9,0,169,169,0,0,0,0
S01007585,Owned: Owned with a mortgage or loan or shared ownership,131,116,102,10,92,13,1,15,13,0,0,2,0
S01007585,Rented or living rent free: Total,69,36,25,8,17,7,4,33,25,1,1,6,0
S01007585,Rented or living rent free: Social rented,36,19,14,7,7,3,2,17,12,1,0,4,0
S01007585,Rented or living rent free: Private rented or living rent free,33,17,11,1,10,4,2,16,13,0,1,2,0
S01007586,All HRPs aged 16 and over,377,237,196,49,147,22,19,140,99,1,11,22,7
S01007586,Owned: Total,203,133,117,19,98,15,1,70,68,0,0,2,0
S01007586,Owned: Owned outright,100,41,36,11,25,4,1,59,58,0,0,1,0
S01007586,Owned: Owned with a mortgage or loan or shared ownership,103,92,81,8,73,11,0,11,10,0,0,1,0
S01007586,Rented or living rent free: Total,174,104,79,30,49,7,18,70,31,1,11,20,7
S01007586,Rented or living rent free: Social rented,139,78,61,25,36,1,16,61,23,1,11,19,7
S01007586,Rented or living rent free: Private rented or living rent free,35,26,18,5,13,6,2,9,8,0,0,1,0
S01007587,All HRPs aged 16 and over,306,191,154,25,129,28,9,115,100,2,2,11,0
S01007587,Owned: Total,218,133,108,14,94,25,0,85,82,1,0,2,0
S01007587,Owned: Owned outright,120,45,31,8,23,14,0,75,73,0,0,2,0
S01007587,Owned: Owned with a mortgage or loan or shared ownership,98,88,77,6,71,11,0,10,9,1,0,0,0
S01007587,Rented or living rent free: Total,88,58,46,11,35,3,9,30,18,1,2,9,0
S01007587,Rented or living rent free: Social rented,39,19,10,5,5,2,7,20,11,1,1,7,0
S01007587,Rented or living rent free: Private rented or living rent free,49,39,36,6,30,1,2,10,7,0,1,2,0
S01007588,All HRPs aged 16 and over,360,207,164,28,136,41,2,153,142,1,4,2,4
S01007588,Owned: Total,307,173,135,22,113,36,2,134,128,0,3,1,2
S01007588,Owned: Owned outright,180,53,38,15,23,14,1,127,123,0,2,1,1
S01007588,Owned: Owned with a mortgage or loan or shared ownership,127,120,97,7,90,22,1,7,5,0,1,0,1
S01007588,Rented or living rent free: Total,53,34,29,6,23,5,0,19,14,1,1,1,2
S01007588,Rented or living rent free: Social rented,24,11,10,4,6,1,0,13,9,1,1,0,2
S01007588,Rented or living rent free: Private rented or living rent free,29,23,19,2,17,4,0,6,5,0,0,1,0
S01007589,All HRPs aged 16 and over,408,278,233,33,200,33,12,130,103,3,5,14,5
S01007589,Owned: Total,270,175,147,24,123,23,5,95,87,1,2,3,2
S01007589,Owned: Owned outright,154,68,55,10,45,11,2,86,81,0,1,2,2
S01007589,Owned: Owned with a mortgage or loan or shared ownership,116,107,92,14,78,12,3,9,6,1,1,1,0
S01007589,Rented or living rent free: Total,138,103,86,9,77,10,7,35,16,2,3,11,3
S01007589,Rented or living rent free: Social rented,20,7,4,2,2,1,2,13,0,0,2,10,1
S01007589,Rented or living rent free: Private rented or living rent free,118,96,82,7,75,9,5,22,16,2,1,1,2
S01007590,All HRPs aged 16 and over,289,158,132,20,112,25,1,131,130,0,0,0,1
S01007590,Owned: Total,268,143,119,18,101,23,1,125,125,0,0,0,0
S01007590,Owned: Owned outright,171,49,40,12,28,8,1,122,122,0,0,0,0
S01007590,Owned: Owned with a mortgage or loan or shared ownership,97,94,79,6,73,15,0,3,3,0,0,0,0
S01007590,Rented or living rent free: Total,21,15,13,2,11,2,0,6,5,0,0,0,1
S01007590,Rented or living rent free: Social rented,2,1,1,0,1,0,0,1,1,0,0,0,0
S01007590,Rented or living rent free: Private rented or living rent free,19,14,12,2,10,2,0,5,4,0,0,0,1
S01007591,All HRPs aged 16 and over,272,191,164,32,132,24,3,81,68,0,1,10,2
S01007591,Owned: Total,183,128,110,20,90,17,1,55,51,0,0,3,1
S01007591,Owned: Owned outright,84,36,29,12,17,7,0,48,45,0,0,2,1
S01007591,Owned: Owned with a mortgage or loan or shared ownership,99,92,81,8,73,10,1,7,6,0,0,1,0
S01007591,Rented or living rent free: Total,89,63,54,12,42,7,2,26,17,0,1,7,1
S01007591,Rented or living rent free: Social rented,41,21,18,8,10,2,1,20,13,0,0,6,1
S01007591,Rented or living rent free: Private rented or living rent free,48,42,36,4,32,5,1,6,4,0,1,1,0
S01007592,All HRPs aged 16 and over,353,222,195,60,135,15,12,131,83,3,6,32,7
S01007592,Owned: Total,147,93,81,17,64,11,1,54,43,0,0,8,3
S01007592,Owned: Owned outright,67,27,21,7,14,5,1,40,33,0,0,6,1
S01007592,Owned: Owned with a mortgage or loan or shared ownership,80,66,60,10,50,6,0,14,10,0,0,2,2
S01007592,Rented or living rent free: Total,206,129,114,43,71,4,11,77,40,3,6,24,4
S01007592,Rented or living rent free: Social rented,122,55,48,23,25,2,5,67,35,2,6,20,4
S01007592,Rented or living rent free: Private rented or living rent free,84,74,66,20,46,2,6,10,5,1,0,4,0
S01007593,All HRPs aged 16 and over,453,269,219,42,177,48,2,184,171,0,1,10,2
S01007593,Owned: Total,350,202,162,27,135,40,0,148,143,0,0,3,2
S01007593,Owned: Owned outright,192,60,41,15,26,19,0,132,128,0,0,2,2
S01007593,Owned: Owned with a mortgage or loan or shared ownership,158,142,121,12,109,21,0,16,15,0,0,1,0
S01007593,Rented or living rent free: Total,103,67,57,15,42,8,2,36,28,0,1,7,0
S01007593,Rented or living rent free: Social rented,55,28,23,8,15,4,1,27,20,0,0,7,0
S01007593,Rented or living rent free: Private rented or living rent free,48,39,34,7,27,4,1,9,8,0,1,0,0
S01007594,All HRPs aged 16 and over,334,232,176,21,155,53,3,102,93,1,1,6,1
S01007594,Owned: Total,269,192,143,16,127,49,0,77,75,0,0,1,1
S01007594,Owned: Owned outright,132,65,41,9,32,24,0,67,67,0,0,0,0
S01007594,Owned: Owned with a mortgage or loan or shared ownership,137,127,102,7,95,25,0,10,8,0,0,1,1
S01007594,Rented or living rent free: Total,65,40,33,5,28,4,3,25,18,1,1,5,0
S01007594,Rented or living rent free: Social rented,35,18,14,5,9,3,1,17,11,0,1,5,0
S01007594,Rented or living rent free: Private rented or living rent free,30,22,19,0,19,1,2,8,7,1,0,0,0
S01007595,All HRPs aged 16 and over,443,297,189,32,157,103,5,146,130,0,3,11,2
S01007595,Owned: Total,275,184,108,14,94,74,2,91,85,0,3,3,0
S01007595,Owned: Owned outright,169,88,42,9,33,45,1,81,77,0,3,1,0
S01007595,Owned: Owned with a mortgage or loan or shared ownership,106,96,66,5,61,29,1,10,8,0,0,2,0
S01007595,Rented or living rent free: Total,168,113,81,18,63,29,3,55,45,0,0,8,2
S01007595,Rented or living rent free: Social rented,57,29,25,9,16,1,3,28,22,0,0,5,1
S01007595,Rented or living rent free: Private rented or living rent free,111,84,56,9,47,28,0,27,23,0,0,3,1
S01007596,All HRPs aged 16 and over,275,154,100,27,73,48,6,121,107,1,5,8,0
S01007596,Owned: Total,191,97,62,20,42,34,1,94,87,0,4,3,0
S01007596,Owned: Owned outright,133,47,31,14,17,16,0,86,80,0,3,3,0
S01007596,Owned: Owned with a mortgage or loan or shared ownership,58,50,31,6,25,18,1,8,7,0,1,0,0
S01007596,Rented or living rent free: Total,84,57,38,7,31,14,5,27,20,1,1,5,0
S01007596,Rented or living rent free: Social rented,4,1,1,1,0,0,0,3,0,1,0,2,0
S01007596,Rented or living rent free: Private rented or living rent free,80,56,37,6,31,14,5,24,20,0,1,3,0
S01007597,All HRPs aged 16 and over,254,177,125,16,109,49,3,77,70,1,1,3,2
S01007597,Owned: Total,179,121,83,9,74,36,2,58,56,0,1,1,0
S01007597,Owned: Owned outright,105,50,27,5,22,21,2,55,53,0,1,1,0
S01007597,Owned: Owned with a mortgage or loan or shared ownership,74,71,56,4,52,15,0,3,3,0,0,0,0
S01007597,Rented or living rent free: Total,75,56,42,7,35,13,1,19,14,1,0,2,2
S01007597,Rented or living rent free: Social rented,10,7,7,3,4,0,0,3,2,0,0,1,0
S01007597,Rented or living rent free: Private rented or living rent free,65,49,35,4,31,13,1,16,12,1,0,1,2
S01007598,All HRPs aged 16 and over,266,179,130,27,103,43,6,87,82,1,1,2,1
S01007598,Owned: Total,198,129,88,16,72,39,2,69,68,0,1,0,0
S01007598,Owned: Owned outright,122,58,33,11,22,23,2,64,63,0,1,0,0
S01007598,Owned: Owned with a mortgage or loan or shared ownership,76,71,55,5,50,16,0,5,5,0,0,0,0
S01007598,Rented or living rent free: Total,68,50,42,11,31,4,4,18,14,1,0,2,1
S01007598,Rented or living rent free: Social rented,12,10,6,4,2,2,2,2,2,0,0,0,0
S01007598,Rented or living rent free: Private rented or living rent free,56,40,36,7,29,2,2,16,12,1,0,2,1
S01007599,All HRPs aged 16 and over,361,260,221,54,167,33,6,101,76,2,6,16,1
S01007599,Owned: Total,224,173,149,32,117,23,1,51,49,0,0,1,1
S01007599,Owned: Owned outright,93,52,38,14,24,13,1,41,40,0,0,1,0
S01007599,Owned: Owned with a mortgage or loan or shared ownership,131,121,111,18,93,10,0,10,9,0,0,0,1
S01007599,Rented or living rent free: Total,137,87,72,22,50,10,5,50,27,2,6,15,0
S01007599,Rented or living rent free: Social rented,67,39,31,13,18,4,4,28,18,1,4,5,0
S01007599,Rented or living rent free: Private rented or living rent free,70,48,41,9,32,6,1,22,9,1,2,10,0
S01007600,All HRPs aged 16 and over,510,293,241,34,207,46,6,217,189,2,1,20,5
S01007600,Owned: Total,337,218,179,20,159,37,2,119,114,0,0,4,1
S01007600,Owned: Owned outright,176,71,55,13,42,14,2,105,103,0,0,2,0
S01007600,Owned: Owned with a mortgage or loan or shared ownership,161,147,124,7,117,23,0,14,11,0,0,2,1
S01007600,Rented or living rent free: Total,173,75,62,14,48,9,4,98,75,2,1,16,4
S01007600,Rented or living rent free: Social rented,91,20,15,4,11,2,3,71,52,2,0,14,3
S01007600,Rented or living rent free: Private rented or living rent free,82,55,47,10,37,7,1,27,23,0,1,2,1
S01007601,All HRPs aged 16 and over,300,246,218,28,190,22,6,54,39,0,2,10,3
S01007601,Owned: Total,230,198,178,17,161,20,0,32,31,0,1,0,0
S01007601,Owned: Owned outright,76,48,44,9,35,4,0,28,27,0,1,0,0
S01007601,Owned: Owned with a mortgage or loan or shared ownership,154,150,134,8,126,16,0,4,4,0,0,0,0
S01007601,Rented or living rent free: Total,70,48,40,11,29,2,6,22,8,0,1,10,3
S01007601,Rented or living rent free: Social rented,21,10,5,3,2,0,5,11,6,0,0,3,2
S01007601,Rented or living rent free: Private rented or living rent free,49,38,35,8,27,2,1,11,2,0,1,7,1
S01007602,All HRPs aged 16 and over,269,200,176,24,152,23,1,69,62,1,1,3,2
S01007602,Owned: Total,236,174,154,21,133,20,0,62,59,0,1,1,1
S01007602,Owned: Owned outright,108,57,50,13,37,7,0,51,49,0,1,0,1
S01007602,Owned: Owned with a mortgage or loan or shared ownership,128,117,104,8,96,13,0,11,10,0,0,1,0
S01007602,Rented or living rent free: Total,33,26,22,3,19,3,1,7,3,1,0,2,1
S01007602,Rented or living rent free: Social rented,3,2,1,1,0,1,0,1,0,0,0,1,0
S01007602,Rented or living rent free: Private rented or living rent free,30,24,21,2,19,2,1,6,3,1,0,1,1
S01007603,All HRPs aged 16 and over,309,249,223,25,198,22,4,60,58,1,0,1,0
S01007603,Owned: Total,279,223,205,22,183,17,1,56,55,0,0,1,0
S01007603,Owned: Owned outright,120,65,63,12,51,2,0,55,54,0,0,1,0
S01007603,Owned: Owned with a mortgage or loan or shared ownership,159,158,142,10,132,15,1,1,1,0,0,0,0
S01007603,Rented or living rent free: Total,30,26,18,3,15,5,3,4,3,1,0,0,0
S01007603,Rented or living rent free: Social rented,5,4,1,0,1,1,2,1,1,0,0,0,0
S01007603,Rented or living rent free: Private rented or living rent free,25,22,17,3,14,4,1,3,2,1,0,0,0
S01007604,All HRPs aged 16 and over,389,243,213,32,181,28,2,146,136,0,2,7,1
S01007604,Owned: Total,364,228,200,29,171,26,2,136,130,0,1,5,0
S01007604,Owned: Owned outright,221,94,80,24,56,12,2,127,124,0,0,3,0
S01007604,Owned: Owned with a mortgage or loan or shared ownership,143,134,120,5,115,14,0,9,6,0,1,2,0
S01007604,Rented or living rent free: Total,25,15,13,3,10,2,0,10,6,0,1,2,1
S01007604,Rented or living rent free: Social rented,8,3,3,1,2,0,0,5,1,0,1,2,1
S01007604,Rented or living rent free: Private rented or living rent free,17,12,10,2,8,2,0,5,5,0,0,0,0
S01007605,All HRPs aged 16 and over,364,240,214,30,184,24,2,124,120,0,3,1,0
S01007605,Owned: Total,330,216,190,26,164,24,2,114,114,0,0,0,0
S01007605,Owned: Owned outright,183,80,68,14,54,11,1,103,103,0,0,0,0
S01007605,Owned: Owned with a mortgage or loan or shared ownership,147,136,122,12,110,13,1,11,11,0,0,0,0
S01007605,Rented or living rent free: Total,34,24,24,4,20,0,0,10,6,0,3,1,0
S01007605,Rented or living rent free: Social rented,1,0,0,0,0,0,0,1,0,0,0,1,0
S01007605,Rented or living rent free: Private rented or living rent free,33,24,24,4,20,0,0,9,6,0,3,0,0
S01007606,All HRPs aged 16 and over,314,205,173,29,144,25,7,109,98,3,1,5,2
S01007606,Owned: Total,249,157,138,21,117,18,1,92,90,0,0,2,0
S01007606,Owned: Owned outright,127,48,43,15,28,4,1,79,78,0,0,1,0
S01007606,Owned: Owned with a mortgage or loan or shared ownership,122,109,95,6,89,14,0,13,12,0,0,1,0
S01007606,Rented or living rent free: Total,65,48,35,8,27,7,6,17,8,3,1,3,2
S01007606,Rented or living rent free: Social rented,3,2,2,1,1,0,0,1,1,0,0,0,0
S01007606,Rented or living rent free: Private rented or living rent free,62,46,33,7,26,7,6,16,7,3,1,3,2
S01007607,All HRPs aged 16 and over,294,206,186,22,164,18,2,88,85,1,1,0,1
S01007607,Owned: Total,270,187,167,18,149,18,2,83,80,1,1,0,1
S01007607,Owned: Owned outright,149,72,64,12,52,6,2,77,75,0,1,0,1
S01007607,Owned: Owned with a mortgage or loan or shared ownership,121,115,103,6,97,12,0,6,5,1,0,0,0
S01007607,Rented or living rent free: Total,24,19,19,4,15,0,0,5,5,0,0,0,0
S01007607,Rented or living rent free: Social rented,1,0,0,0,0,0,0,1,1,0,0,0,0
S01007607,Rented or living rent free: Private rented or living rent free,23,19,19,4,15,0,0,4,4,0,0,0,0
S01007608,All HRPs aged 16 and over,308,200,179,21,158,21,0,108,100,1,0,6,1
S01007608,Owned: Total,280,186,167,19,148,19,0,94,91,0,0,2,1
S01007608,Owned: Owned outright,145,54,46,10,36,8,0,91,89,0,0,2,0
S01007608,Owned: Owned with a mortgage or loan or shared ownership,135,132,121,9,112,11,0,3,2,0,0,0,1
S01007608,Rented or living rent free: Total,28,14,12,2,10,2,0,14,9,1,0,4,0
S01007608,Rented or living rent free: Social rented,6,1,1,0,1,0,0,5,2,0,0,3,0
S01007608,Rented or living rent free: Private rented or living rent free,22,13,11,2,9,2,0,9,7,1,0,1,0
S01007609,All HRPs aged 16 and over,447,291,251,66,185,17,23,156,114,4,9,24,5
S01007609,Owned: Total,227,144,129,24,105,11,4,83,75,0,3,5,0
S01007609,Owned: Owned outright,113,41,38,9,29,2,1,72,70,0,1,1,0
S01007609,Owned: Owned with a mortgage or loan or shared ownership,114,103,91,15,76,9,3,11,5,0,2,4,0
S01007609,Rented or living rent free: Total,220,147,122,42,80,6,19,73,39,4,6,19,5
S01007609,Rented or living rent free: Social rented,168,105,85,28,57,3,17,63,34,3,6,16,4
S01007609,Rented or living rent free: Private rented or living rent free,52,42,37,14,23,3,2,10,5,1,0,3,1
S01007610,All HRPs aged 16 and over,255,157,132,31,101,11,14,98,67,0,6,23,2
S01007610,Owned: Total,134,88,77,11,66,9,2,46,43,0,0,3,0
S01007610,Owned: Owned outright,59,23,19,4,15,4,0,36,36,0,0,0,0
S01007610,Owned: Owned with a mortgage or loan or shared ownership,75,65,58,7,51,5,2,10,7,0,0,3,0
S01007610,Rented or living rent free: Total,121,69,55,20,35,2,12,52,24,0,6,20,2
S01007610,Rented or living rent free: Social rented,77,36,30,13,17,0,6,41,17,0,6,17,1
S01007610,Rented or living rent free: Private rented or living rent free,44,33,25,7,18,2,6,11,7,0,0,3,1
S01007611,All HRPs aged 16 and over,538,281,230,65,165,20,31,257,186,2,11,49,9
S01007611,Owned: Total,230,105,91,14,77,12,2,125,120,1,0,3,1
S01007611,Owned: Owned outright,137,34,27,10,17,6,1,103,99,0,0,3,1
S01007611,Owned: Owned with a mortgage or loan or shared ownership,93,71,64,4,60,6,1,22,21,1,0,0,0
S01007611,Rented or living rent free: Total,308,176,139,51,88,8,29,132,66,1,11,46,8
S01007611,Rented or living rent free: Social rented,193,82,63,36,27,3,16,111,57,0,9,37,8
S01007611,Rented or living rent free: Private rented or living rent free,115,94,76,15,61,5,13,21,9,1,2,9,0
S01007612,All HRPs aged 16 and over,609,405,311,84,227,43,51,204,130,8,2,50,14
S01007612,Owned: Total,177,122,95,20,75,25,2,55,51,0,0,3,1
S01007612,Owned: Owned outright,92,40,30,10,20,9,1,52,50,0,0,1,1
S01007612,Owned: Owned with a mortgage or loan or shared ownership,85,82,65,10,55,16,1,3,1,0,0,2,0
S01007612,Rented or living rent free: Total,432,283,216,64,152,18,49,149,79,8,2,47,13
S01007612,Rented or living rent free: Social rented,203,87,57,27,30,3,27,116,66,3,2,34,11
S01007612,Rented or living rent free: Private rented or living rent free,229,196,159,37,122,15,22,33,13,5,0,13,2
S01007613,All HRPs aged 16 and over,324,221,163,21,142,53,5,103,97,0,0,5,1
S01007613,Owned: Total,251,161,111,15,96,49,1,90,89,0,0,1,0
S01007613,Owned: Owned outright,138,55,32,8,24,22,1,83,82,0,0,1,0
S01007613,Owned: Owned with a mortgage or loan or shared ownership,113,106,79,7,72,27,0,7,7,0,0,0,0
S01007613,Rented or living rent free: Total,73,60,52,6,46,4,4,13,8,0,0,4,1
S01007613,Rented or living rent free: Social rented,8,2,2,0,2,0,0,6,3,0,0,2,1
S01007613,Rented or living rent free: Private rented or living rent free,65,58,50,6,44,4,4,7,5,0,0,2,0
S01007614,All HRPs aged 16 and over,358,241,205,37,168,35,1,117,110,1,1,3,2
S01007614,Owned: Total,328,219,188,29,159,31,0,109,107,0,0,1,1
S01007614,Owned: Owned outright,174,73,57,20,37,16,0,101,100,0,0,1,0
S01007614,Owned: Owned with a mortgage or loan or shared ownership,154,146,131,9,122,15,0,8,7,0,0,0,1
S01007614,Rented or living rent free: Total,30,22,17,8,9,4,1,8,3,1,1,2,1
S01007614,Rented or living rent free: Social rented,7,5,4,3,1,1,0,2,0,0,0,2,0
S01007614,Rented or living rent free: Private rented or living rent free,23,17,13,5,8,3,1,6,3,1,1,0,1
S01007615,All HRPs aged 16 and over,515,332,274,52,222,41,17,183,154,1,5,20,3
S01007615,Owned: Total,358,230,191,29,162,37,2,128,122,1,1,2,2
S01007615,Owned: Owned outright,169,61,50,11,39,10,1,108,105,1,0,0,2
S01007615,Owned: Owned with a mortgage or loan or shared ownership,189,169,141,18,123,27,1,20,17,0,1,2,0
S01007615,Rented or living rent free: Total,157,102,83,23,60,4,15,55,32,0,4,18,1
S01007615,Rented or living rent free: Social rented,66,24,13,4,9,1,10,42,26,0,1,14,1
S01007615,Rented or living rent free: Private rented or living rent free,91,78,70,19,51,3,5,13,6,0,3,4,0
S01007616,All HRPs aged 16 and over,387,244,206,41,165,23,15,143,109,2,4,22,6
S01007616,Owned: Total,222,149,131,23,108,14,4,73,69,2,1,1,0
S01007616,Owned: Owned outright,103,42,37,15,22,5,0,61,60,0,0,1,0
S01007616,Owned: Owned with a mortgage or loan or shared ownership,119,107,94,8,86,9,4,12,9,2,1,0,0
S01007616,Rented or living rent free: Total,165,95,75,18,57,9,11,70,40,0,3,21,6
S01007616,Rented or living rent free: Social rented,92,39,29,11,18,3,7,53,27,0,3,18,5
S01007616,Rented or living rent free: Private rented or living rent free,73,56,46,7,39,6,4,17,13,0,0,3,1
S01007617,All HRPs aged 16 and over,234,147,120,29,91,21,6,87,74,0,2,11,0
S01007617,Owned: Total,128,79,63,10,53,14,2,49,47,0,0,2,0
S01007617,Owned: Owned outright,63,19,12,5,7,6,1,44,43,0,0,1,0
S01007617,Owned: Owned with a mortgage or loan or shared ownership,65,60,51,5,46,8,1,5,4,0,0,1,0
S01007617,Rented or living rent free: Total,106,68,57,19,38,7,4,38,27,0,2,9,0
S01007617,Rented or living rent free: Social rented,80,46,36,15,21,6,4,34,23,0,2,9,0
S01007617,Rented or living rent free: Private rented or living rent free,26,22,21,4,17,1,0,4,4,0,0,0,0
S01007618,All HRPs aged 16 and over,294,147,130,34,96,11,6,147,130,1,1,9,6
S01007618,Owned: Total,180,101,91,16,75,9,1,79,74,0,0,3,2
S01007618,Owned: Owned outright,97,28,27,6,21,1,0,69,64,0,0,3,2
S01007618,Owned: Owned with a mortgage or loan or shared ownership,83,73,64,10,54,8,1,10,10,0,0,0,0
S01007618,Rented or living rent free: Total,114,46,39,18,21,2,5,68,56,1,1,6,4
S01007618,Rented or living rent free: Social rented,99,38,34,14,20,1,3,61,51,1,1,6,2
S01007618,Rented or living rent free: Private rented or living rent free,15,8,5,4,1,1,2,7,5,0,0,0,2
S01007619,All HRPs aged 16 and over,280,169,150,32,118,13,6,111,87,0,2,18,4
S01007619,Owned: Total,175,109,100,16,84,9,0,66,58,0,1,5,2
S01007619,Owned: Owned outright,77,22,19,6,13,3,0,55,50,0,1,3,1
S01007619,Owned: Owned with a mortgage or loan or shared ownership,98,87,81,10,71,6,0,11,8,0,0,2,1
S01007619,Rented or living rent free: Total,105,60,50,16,34,4,6,45,29,0,1,13,2
S01007619,Rented or living rent free: Social rented,83,42,35,10,25,1,6,41,26,0,1,12,2
S01007619,Rented or living rent free: Private rented or living rent free,22,18,15,6,9,3,0,4,3,0,0,1,0
S01007620,All HRPs aged 16 and over,271,176,145,13,132,29,2,95,91,0,0,3,1
S01007620,Owned: Total,241,149,122,11,111,26,1,92,88,0,0,3,1
S01007620,Owned: Owned outright,129,44,37,7,30,6,1,85,84,0,0,1,0
S01007620,Owned: Owned with a mortgage or loan or shared ownership,112,105,85,4,81,20,0,7,4,0,0,2,1
S01007620,Rented or living rent free: Total,30,27,23,2,21,3,1,3,3,0,0,0,0
S01007620,Rented or living rent free: Social rented,1,1,1,0,1,0,0,0,0,0,0,0,0
S01007620,Rented or living rent free: Private rented or living rent free,29,26,22,2,20,3,1,3,3,0,0,0,0
S01007621,All HRPs aged 16 and over,291,180,149,19,130,27,4,111,106,0,2,2,1
S01007621,Owned: Total,265,159,133,18,115,25,1,106,103,0,0,2,1
S01007621,Owned: Owned outright,156,56,46,12,34,9,1,100,97,0,0,2,1
S01007621,Owned: Owned with a mortgage or loan or shared ownership,109,103,87,6,81,16,0,6,6,0,0,0,0
S01007621,Rented or living rent free: Total,26,21,16,1,15,2,3,5,3,0,2,0,0
S01007621,Rented or living rent free: Social rented,2,2,2,1,1,0,0,0,0,0,0,0,0
S01007621,Rented or living rent free: Private rented or living rent free,24,19,14,0,14,2,3,5,3,0,2,0,0
S01007622,All HRPs aged 16 and over,256,151,125,25,100,23,3,105,86,0,1,14,4
S01007622,Owned: Total,155,107,87,14,73,20,0,48,43,0,0,4,1
S01007622,Owned: Owned outright,75,34,26,8,18,8,0,41,38,0,0,2,1
S01007622,Owned: Owned with a mortgage or loan or shared ownership,80,73,61,6,55,12,0,7,5,0,0,2,0
S01007622,Rented or living rent free: Total,101,44,38,11,27,3,3,57,43,0,1,10,3
S01007622,Rented or living rent free: Social rented,46,6,6,4,2,0,0,40,28,0,1,8,3
S01007622,Rented or living rent free: Private rented or living rent free,55,38,32,7,25,3,3,17,15,0,0,2,0
S01007623,All HRPs aged 16 and over,250,165,135,18,117,27,3,85,78,0,3,4,0
S01007623,Owned: Total,205,139,117,12,105,20,2,66,65,0,1,0,0
S01007623,Owned: Owned outright,102,40,33,10,23,6,1,62,61,0,1,0,0
S01007623,Owned: Owned with a mortgage or loan or shared ownership,103,99,84,2,82,14,1,4,4,0,0,0,0
S01007623,Rented or living rent free: Total,45,26,18,6,12,7,1,19,13,0,2,4,0
S01007623,Rented or living rent free: Social rented,16,10,6,1,5,3,1,6,4,0,1,1,0
S01007623,Rented or living rent free: Private rented or living rent free,29,16,12,5,7,4,0,13,9,0,1,3,0
S01007624,All HRPs aged 16 and over,268,207,185,26,159,21,1,61,54,0,0,4,3
S01007624,Owned: Total,243,186,164,21,143,21,1,57,51,0,0,3,3
S01007624,Owned: Owned outright,94,46,41,11,30,5,0,48,44,0,0,1,3
S01007624,Owned: Owned with a mortgage or loan or shared ownership,149,140,123,10,113,16,1,9,7,0,0,2,0
S01007624,Rented or living rent free: Total,25,21,21,5,16,0,0,4,3,0,0,1,0
S01007624,Rented or living rent free: Social rented,2,1,1,0,1,0,0,1,0,0,0,1,0
S01007624,Rented or living rent free: Private rented or living rent free,23,20,20,5,15,0,0,3,3,0,0,0,0
S01007625,All HRPs aged 16 and over,224,152,130,12,118,18,4,72,67,0,0,5,0
S01007625,Owned: Total,192,126,111,11,100,14,1,66,61,0,0,5,0
S01007625,Owned: Owned outright,90,32,27,5,22,4,1,58,55,0,0,3,0
S01007625,Owned: Owned with a mortgage or loan or shared ownership,102,94,84,6,78,10,0,8,6,0,0,2,0
S01007625,Rented or living rent free: Total,32,26,19,1,18,4,3,6,6,0,0,0,0
S01007625,Rented or living rent free: Social rented,4,3,1,0,1,1,1,1,1,0,0,0,0
S01007625,Rented or living rent free: Private rented or living rent free,28,23,18,1,17,3,2,5,5,0,0,0,0
S01007626,All HRPs aged 16 and over,269,226,202,15,187,21,3,43,40,0,0,2,1
S01007626,Owned: Total,232,196,177,11,166,19,0,36,36,0,0,0,0
S01007626,Owned: Owned outright,69,38,33,5,28,5,0,31,31,0,0,0,0
S01007626,Owned: Owned with a mortgage or loan or shared ownership,163,158,144,6,138,14,0,5,5,0,0,0,0
S01007626,Rented or living rent free: Total,37,30,25,4,21,2,3,7,4,0,0,2,1
S01007626,Rented or living rent free: Social rented,3,1,1,1,0,0,0,2,1,0,0,0,1
S01007626,Rented or living rent free: Private rented or living rent free,34,29,24,3,21,2,3,5,3,0,0,2,0
S01007627,All HRPs aged 16 and over,251,169,142,20,122,27,0,82,74,0,3,3,2
S01007627,Owned: Total,198,148,123,14,109,25,0,50,43,0,3,2,2
S01007627,Owned: Owned outright,69,30,23,10,13,7,0,39,35,0,1,1,2
S01007627,Owned: Owned with a mortgage or loan or shared ownership,129,118,100,4,96,18,0,11,8,0,2,1,0
S01007627,Rented or living rent free: Total,53,21,19,6,13,2,0,32,31,0,0,1,0
S01007627,Rented or living rent free: Social rented,29,2,2,0,2,0,0,27,27,0,0,0,0
S01007627,Rented or living rent free: Private rented or living rent free,24,19,17,6,11,2,0,5,4,0,0,1,0
S01007628,All HRPs aged 16 and over,314,181,141,15,126,39,1,133,128,0,1,2,2
S01007628,Owned: Total,268,149,115,13,102,33,1,119,118,0,0,0,1
S01007628,Owned: Owned outright,170,55,38,10,28,16,1,115,114,0,0,0,1
S01007628,Owned: Owned with a mortgage or loan or shared ownership,98,94,77,3,74,17,0,4,4,0,0,0,0
S01007628,Rented or living rent free: Total,46,32,26,2,24,6,0,14,10,0,1,2,1
S01007628,Rented or living rent free: Social rented,4,0,0,0,0,0,0,4,3,0,0,1,0
S01007628,Rented or living rent free: Private rented or living rent free,42,32,26,2,24,6,0,10,7,0,1,1,1
S01007629,All HRPs aged 16 and over,286,192,139,11,128,49,4,94,84,0,3,4,3
S01007629,Owned: Total,224,150,111,10,101,39,0,74,72,0,0,1,1
S01007629,Owned: Owned outright,120,51,27,4,23,24,0,69,67,0,0,1,1
S01007629,Owned: Owned with a mortgage or loan or shared ownership,104,99,84,6,78,15,0,5,5,0,0,0,0
S01007629,Rented or living rent free: Total,62,42,28,1,27,10,4,20,12,0,3,3,2
S01007629,Rented or living rent free: Social rented,22,11,8,1,7,2,1,11,7,0,1,2,1
S01007629,Rented or living rent free: Private rented or living rent free,40,31,20,0,20,8,3,9,5,0,2,1,1
S01007630,All HRPs aged 16 and over,338,244,161,20,141,79,4,94,89,0,1,4,0
S01007630,Owned: Total,282,201,131,15,116,66,4,81,78,0,1,2,0
S01007630,Owned: Owned outright,166,93,54,11,43,36,3,73,71,0,1,1,0
S01007630,Owned: Owned with a mortgage or loan or shared ownership,116,108,77,4,73,30,1,8,7,0,0,1,0
S01007630,Rented or living rent free: Total,56,43,30,5,25,13,0,13,11,0,0,2,0
S01007630,Rented or living rent free: Social rented,5,2,2,1,1,0,0,3,2,0,0,1,0
S01007630,Rented or living rent free: Private rented or living rent free,51,41,28,4,24,13,0,10,9,0,0,1,0
S01007631,All HRPs aged 16 and over,269,177,101,15,86,71,5,92,86,0,1,3,2
S01007631,Owned: Total,212,136,74,10,64,62,0,76,73,0,1,2,0
S01007631,Owned: Owned outright,144,72,37,7,30,35,0,72,70,0,0,2,0
S01007631,Owned: Owned with a mortgage or loan or shared ownership,68,64,37,3,34,27,0,4,3,0,1,0,0
S01007631,Rented or living rent free: Total,57,41,27,5,22,9,5,16,13,0,0,1,2
S01007631,Rented or living rent free: Social rented,8,5,2,0,2,1,2,3,2,0,0,0,1
S01007631,Rented or living rent free: Private rented or living rent free,49,36,25,5,20,8,3,13,11,0,0,1,1
S01007632,All HRPs aged 16 and over,437,274,220,25,195,43,11,163,137,2,10,13,1
S01007632,Owned: Total,284,184,148,15,133,34,2,100,99,1,0,0,0
S01007632,Owned: Owned outright,151,65,46,10,36,19,0,86,85,1,0,0,0
S01007632,Owned: Owned with a mortgage or loan or shared ownership,133,119,102,5,97,15,2,14,14,0,0,0,0
S01007632,Rented or living rent free: Total,153,90,72,10,62,9,9,63,38,1,10,13,1
S01007632,Rented or living rent free: Social rented,98,50,39,10,29,4,7,48,27,0,9,11,1
S01007632,Rented or living rent free: Private rented or living rent free,55,40,33,0,33,5,2,15,11,1,1,2,0
S01007633,All HRPs aged 16 and over,441,273,212,45,167,46,15,168,154,2,1,9,2
S01007633,Owned: Total,291,181,144,24,120,36,1,110,109,0,0,1,0
S01007633,Owned: Owned outright,170,69,46,14,32,23,0,101,100,0,0,1,0
S01007633,Owned: Owned with a mortgage or loan or shared ownership,121,112,98,10,88,13,1,9,9,0,0,0,0
S01007633,Rented or living rent free: Total,150,92,68,21,47,10,14,58,45,2,1,8,2
S01007633,Rented or living rent free: Social rented,112,65,47,16,31,4,14,47,34,2,1,8,2
S01007633,Rented or living rent free: Private rented or living rent free,38,27,21,5,16,6,0,11,11,0,0,0,0
S01007634,All HRPs aged 16 and over,241,163,117,15,102,39,7,78,71,0,4,2,1
S01007634,Owned: Total,163,107,74,6,68,31,2,56,53,0,1,1,1
S01007634,Owned: Owned outright,105,55,28,4,24,26,1,50,48,0,1,0,1
S01007634,Owned: Owned with a mortgage or loan or shared ownership,58,52,46,2,44,5,1,6,5,0,0,1,0
S01007634,Rented or living rent free: Total,78,56,43,9,34,8,5,22,18,0,3,1,0
S01007634,Rented or living rent free: Social rented,16,9,6,3,3,0,3,7,5,0,1,1,0
S01007634,Rented or living rent free: Private rented or living rent free,62,47,37,6,31,8,2,15,13,0,2,0,0
S01007635,All HRPs aged 16 and over,321,131,101,16,85,29,1,190,181,1,1,4,3
S01007635,Owned: Total,274,104,80,10,70,24,0,170,165,1,1,1,2
S01007635,Owned: Owned outright,204,42,30,8,22,12,0,162,157,1,1,1,2
S01007635,Owned: Owned with a mortgage or loan or shared ownership,70,62,50,2,48,12,0,8,8,0,0,0,0
S01007635,Rented or living rent free: Total,47,27,21,6,15,5,1,20,16,0,0,3,1
S01007635,Rented or living rent free: Social rented,9,5,4,3,1,1,0,4,3,0,0,1,0
S01007635,Rented or living rent free: Private rented or living rent free,38,22,17,3,14,4,1,16,13,0,0,2,1
S01007636,All HRPs aged 16 and over,416,226,183,24,159,34,9,190,153,1,6,20,10
S01007636,Owned: Total,257,151,120,13,107,31,0,106,96,1,0,3,6
S01007636,Owned: Owned outright,146,52,33,8,25,19,0,94,85,1,0,2,6
S01007636,Owned: Owned with a mortgage or loan or shared ownership,111,99,87,5,82,12,0,12,11,0,0,1,0
S01007636,Rented or living rent free: Total,159,75,63,11,52,3,9,84,57,0,6,17,4
S01007636,Rented or living rent free: Social rented,114,38,28,6,22,2,8,76,53,0,5,15,3
S01007636,Rented or living rent free: Private rented or living rent free,45,37,35,5,30,1,1,8,4,0,1,2,1
S01007637,All HRPs aged 16 and over,403,250,194,34,160,42,14,153,140,0,2,6,5
S01007637,Owned: Total,233,156,122,13,109,33,1,77,75,0,0,1,1
S01007637,Owned: Owned outright,111,41,30,7,23,10,1,70,68,0,0,1,1
S01007637,Owned: Owned with a mortgage or loan or shared ownership,122,115,92,6,86,23,0,7,7,0,0,0,0
S01007637,Rented or living rent free: Total,170,94,72,21,51,9,13,76,65,0,2,5,4
S01007637,Rented or living rent free: Social rented,124,55,43,16,27,5,7,69,59,0,2,4,4
S01007637,Rented or living rent free: Private rented or living rent free,46,39,29,5,24,4,6,7,6,0,0,1,0
S01007638,All HRPs aged 16 and over,373,228,184,38,146,30,14,145,126,0,1,14,4
S01007638,Owned: Total,234,144,117,16,101,24,3,90,85,0,0,4,1
S01007638,Owned: Owned outright,123,41,30,8,22,9,2,82,77,0,0,4,1
S01007638,Owned: Owned with a mortgage or loan or shared ownership,111,103,87,8,79,15,1,8,8,0,0,0,0
S01007638,Rented or living rent free: Total,139,84,67,22,45,6,11,55,41,0,1,10,3
S01007638,Rented or living rent free: Social rented,90,43,31,14,17,5,7,47,35,0,1,8,3
S01007638,Rented or living rent free: Private rented or living rent free,49,41,36,8,28,1,4,8,6,0,0,2,0
S01007639,All HRPs aged 16 and over,451,308,260,51,209,30,18,143,100,2,13,18,10
S01007639,Owned: Total,255,175,148,19,129,24,3,80,74,1,0,1,4
S01007639,Owned: Owned outright,115,49,40,10,30,8,1,66,62,0,0,1,3
S01007639,Owned: Owned with a mortgage or loan or shared ownership,140,126,108,9,99,16,2,14,12,1,0,0,1
S01007639,Rented or living rent free: Total,196,133,112,32,80,6,15,63,26,1,13,17,6
S01007639,Rented or living rent free: Social rented,157,105,86,29,57,5,14,52,22,1,11,13,5
S01007639,Rented or living rent free: Private rented or living rent free,39,28,26,3,23,1,1,11,4,0,2,4,1
S01007640,All HRPs aged 16 and over,303,215,138,23,115,73,4,88,73,0,5,9,1
S01007640,Owned: Total,144,99,73,10,63,23,3,45,41,0,1,2,1
S01007640,Owned: Owned outright,70,36,22,5,17,13,1,34,30,0,1,2,1
S01007640,Owned: Owned with a mortgage or loan or shared ownership,74,63,51,5,46,10,2,11,11,0,0,0,0
S01007640,Rented or living rent free: Total,159,116,65,13,52,50,1,43,32,0,4,7,0
S01007640,Rented or living rent free: Social rented,17,10,6,2,4,3,1,7,4,0,2,1,0
S01007640,Rented or living rent free: Private rented or living rent free,142,106,59,11,48,47,0,36,28,0,2,6,0
S01007641,All HRPs aged 16 and over,369,253,183,50,133,62,8,116,102,0,8,5,1
S01007641,Owned: Total,239,162,110,16,94,49,3,77,72,0,3,2,0
S01007641,Owned: Owned outright,124,59,29,9,20,28,2,65,63,0,1,1,0
S01007641,Owned: Owned with a mortgage or loan or shared ownership,115,103,81,7,74,21,1,12,9,0,2,1,0
S01007641,Rented or living rent free: Total,130,91,73,34,39,13,5,39,30,0,5,3,1
S01007641,Rented or living rent free: Social rented,74,53,46,25,21,2,5,21,13,0,4,3,1
S01007641,Rented or living rent free: Private rented or living rent free,56,38,27,9,18,11,0,18,17,0,1,0,0
S01007642,All HRPs aged 16 and over,415,227,162,26,136,58,7,188,171,1,4,9,3
S01007642,Owned: Total,275,152,103,16,87,48,1,123,115,1,3,3,1
S01007642,Owned: Owned outright,189,73,44,10,34,29,0,116,109,0,3,3,1
S01007642,Owned: Owned with a mortgage or loan or shared ownership,86,79,59,6,53,19,1,7,6,1,0,0,0
S01007642,Rented or living rent free: Total,140,75,59,10,49,10,6,65,56,0,1,6,2
S01007642,Rented or living rent free: Social rented,67,23,16,5,11,2,5,44,38,0,0,4,2
S01007642,Rented or living rent free: Private rented or living rent free,73,52,43,5,38,8,1,21,18,0,1,2,0
S01007643,All HRPs aged 16 and over,424,254,194,48,146,53,7,170,158,1,1,7,3
S01007643,Owned: Total,307,181,132,26,106,47,2,126,122,0,0,1,3
S01007643,Owned: Owned outright,187,79,50,15,35,28,1,108,106,0,0,0,2
S01007643,Owned: Owned with a mortgage or loan or shared ownership,120,102,82,11,71,19,1,18,16,0,0,1,1
S01007643,Rented or living rent free: Total,117,73,62,22,40,6,5,44,36,1,1,6,0
S01007643,Rented or living rent free: Social rented,69,38,32,13,19,2,4,31,25,1,0,5,0
S01007643,Rented or living rent free: Private rented or living rent free,48,35,30,9,21,4,1,13,11,0,1,1,0
S01007644,All HRPs aged 16 and over,384,217,168,45,123,41,8,167,150,1,9,6,1
S01007644,Owned: Total,249,135,97,13,84,37,1,114,111,0,2,1,0
S01007644,Owned: Owned outright,150,48,29,5,24,18,1,102,99,0,2,1,0
S01007644,Owned: Owned with a mortgage or loan or shared ownership,99,87,68,8,60,19,0,12,12,0,0,0,0
S01007644,Rented or living rent free: Total,135,82,71,32,39,4,7,53,39,1,7,5,1
S01007644,Rented or living rent free: Social rented,106,61,54,27,27,3,4,45,32,1,7,4,1
S01007644,Rented or living rent free: Private rented or living rent free,29,21,17,5,12,1,3,8,7,0,0,1,0
S01007645,All HRPs aged 16 and over,219,161,97,18,79,58,6,58,55,0,1,2,0
S01007645,Owned: Total,141,96,58,10,48,36,2,45,44,0,0,1,0
S01007645,Owned: Owned outright,91,49,21,4,17,27,1,42,42,0,0,0,0
S01007645,Owned: Owned with a mortgage or loan or shared ownership,50,47,37,6,31,9,1,3,2,0,0,1,0
S01007645,Rented or living rent free: Total,78,65,39,8,31,22,4,13,11,0,1,1,0
S01007645,Rented or living rent free: Social rented,13,9,9,2,7,0,0,4,3,0,1,0,0
S01007645,Rented or living rent free: Private rented or living rent free,65,56,30,6,24,22,4,9,8,0,0,1,0
S01007646,All HRPs aged 16 and over,260,168,105,11,94,56,7,92,75,2,2,11,2
S01007646,Owned: Total,123,79,48,4,44,31,0,44,39,0,1,3,1
S01007646,Owned: Owned outright,85,47,28,3,25,19,0,38,35,0,1,2,0
S01007646,Owned: Owned with a mortgage or loan or shared ownership,38,32,20,1,19,12,0,6,4,0,0,1,1
S01007646,Rented or living rent free: Total,137,89,57,7,50,25,7,48,36,2,1,8,1
S01007646,Rented or living rent free: Social rented,19,10,5,1,4,3,2,9,5,0,1,3,0
S01007646,Rented or living rent free: Private rented or living rent free,118,79,52,6,46,22,5,39,31,2,0,5,1
S01007647,All HRPs aged 16 and over,361,215,164,26,138,38,13,146,125,0,6,14,1
S01007647,Owned: Total,238,148,118,15,103,30,0,90,86,0,1,3,0
S01007647,Owned: Owned outright,139,58,44,11,33,14,0,81,78,0,0,3,0
S01007647,Owned: Owned with a mortgage or loan or shared ownership,99,90,74,4,70,16,0,9,8,0,1,0,0
S01007647,Rented or living rent free: Total,123,67,46,11,35,8,13,56,39,0,5,11,1
S01007647,Rented or living rent free: Social rented,55,21,11,2,9,1,9,34,22,0,3,8,1
S01007647,Rented or living rent free: Private rented or living rent free,68,46,35,9,26,7,4,22,17,0,2,3,0
S01007648,All HRPs aged 16 and over,446,281,223,40,183,47,11,165,152,2,2,6,3
S01007648,Owned: Total,271,163,132,18,114,28,3,108,105,0,0,0,3
S01007648,Owned: Owned outright,176,75,56,11,45,16,3,101,99,0,0,0,2
S01007648,Owned: Owned with a mortgage or loan or shared ownership,95,88,76,7,69,12,0,7,6,0,0,0,1
S01007648,Rented or living rent free: Total,175,118,91,22,69,19,8,57,47,2,2,6,0
S01007648,Rented or living rent free: Social rented,41,15,12,1,11,1,2,26,22,1,0,3,0
S01007648,Rented or living rent free: Private rented or living rent free,134,103,79,21,58,18,6,31,25,1,2,3,0
S01007649,All HRPs aged 16 and over,339,223,171,25,146,46,6,116,98,0,4,9,5
S01007649,Owned: Total,206,147,108,11,97,39,0,59,56,0,1,1,1
S01007649,Owned: Owned outright,120,65,49,9,40,16,0,55,53,0,1,0,1
S01007649,Owned: Owned with a mortgage or loan or shared ownership,86,82,59,2,57,23,0,4,3,0,0,1,0
S01007649,Rented or living rent free: Total,133,76,63,14,49,7,6,57,42,0,3,8,4
S01007649,Rented or living rent free: Social rented,62,36,29,8,21,2,5,26,20,0,2,3,1
S01007649,Rented or living rent free: Private rented or living rent free,71,40,34,6,28,5,1,31,22,0,1,5,3
S01007650,All HRPs aged 16 and over,420,266,184,31,153,75,7,154,138,0,2,13,1
S01007650,Owned: Total,273,181,133,18,115,45,3,92,88,0,0,3,1
S01007650,Owned: Owned outright,152,69,46,8,38,20,3,83,80,0,0,2,1
S01007650,Owned: Owned with a mortgage or loan or shared ownership,121,112,87,10,77,25,0,9,8,0,0,1,0
S01007650,Rented or living rent free: Total,147,85,51,13,38,30,4,62,50,0,2,10,0
S01007650,Rented or living rent free: Social rented,39,21,16,6,10,2,3,18,11,0,2,5,0
S01007650,Rented or living rent free: Private rented or living rent free,108,64,35,7,28,28,1,44,39,0,0,5,0
S01007651,All HRPs aged 16 and over,227,167,88,10,78,75,4,60,57,0,1,1,1
S01007651,Owned: Total,130,98,50,3,47,46,2,32,31,0,0,1,0
S01007651,Owned: Owned outright,70,43,14,2,12,29,0,27,27,0,0,0,0
S01007651,Owned: Owned with a mortgage or loan or shared ownership,60,55,36,1,35,17,2,5,4,0,0,1,0
S01007651,Rented or living rent free: Total,97,69,38,7,31,29,2,28,26,0,1,0,1
S01007651,Rented or living rent free: Social rented,17,9,7,1,6,1,1,8,7,0,0,0,1
S01007651,Rented or living rent free: Private rented or living rent free,80,60,31,6,25,28,1,20,19,0,1,0,0
S01007652,All HRPs aged 16 and over,257,147,108,20,88,33,6,110,91,1,5,11,2
S01007652,Owned: Total,172,99,67,7,60,29,3,73,68,0,2,2,1
S01007652,Owned: Owned outright,102,36,24,5,19,10,2,66,63,0,0,2,1
S01007652,Owned: Owned with a mortgage or loan or shared ownership,70,63,43,2,41,19,1,7,5,0,2,0,0
S01007652,Rented or living rent free: Total,85,48,41,13,28,4,3,37,23,1,3,9,1
S01007652,Rented or living rent free: Social rented,46,28,24,10,14,1,3,18,11,0,3,4,0
S01007652,Rented or living rent free: Private rented or living rent free,39,20,17,3,14,3,0,19,12,1,0,5,1
S01007653,All HRPs aged 16 and over,378,250,169,27,142,75,6,128,118,0,1,6,3
S01007653,Owned: Total,292,191,124,16,108,65,2,101,98,0,0,1,2
S01007653,Owned: Owned outright,170,81,47,12,35,33,1,89,87,0,0,0,2
S01007653,Owned: Owned with a mortgage or loan or shared ownership,122,110,77,4,73,32,1,12,11,0,0,1,0
S01007653,Rented or living rent free: Total,86,59,45,11,34,10,4,27,20,0,1,5,1
S01007653,Rented or living rent free: Social rented,51,30,27,9,18,0,3,21,14,0,1,5,1
S01007653,Rented or living rent free: Private rented or living rent free,35,29,18,2,16,10,1,6,6,0,0,0,0
S01007654,All HRPs aged 16 and over,465,292,212,40,172,67,13,173,138,1,10,22,2
S01007654,Owned: Total,256,160,110,11,99,48,2,96,88,1,0,6,1
S01007654,Owned: Owned outright,145,69,40,7,33,28,1,76,74,0,0,2,0
S01007654,Owned: Owned with a mortgage or loan or shared ownership,111,91,70,4,66,20,1,20,14,1,0,4,1
S01007654,Rented or living rent free: Total,209,132,102,29,73,19,11,77,50,0,10,16,1
S01007654,Rented or living rent free: Social rented,125,67,49,12,37,9,9,58,35,0,9,14,0
S01007654,Rented or living rent free: Private rented or living rent free,84,65,53,17,36,10,2,19,15,0,1,2,1
S01007655,All HRPs aged 16 and over,341,235,125,17,108,106,4,106,89,1,2,12,2
S01007655,Owned: Total,211,142,72,8,64,67,3,69,63,0,0,5,1
S01007655,Owned: Owned outright,141,78,32,5,27,44,2,63,58,0,0,4,1
S01007655,Owned: Owned with a mortgage or loan or shared ownership,70,64,40,3,37,23,1,6,5,0,0,1,0
S01007655,Rented or living rent free: Total,130,93,53,9,44,39,1,37,26,1,2,7,1
S01007655,Rented or living rent free: Social rented,17,10,8,1,7,2,0,7,4,1,1,1,0
S01007655,Rented or living rent free: Private rented or living rent free,113,83,45,8,37,37,1,30,22,0,1,6,1
S01007656,All HRPs aged 16 and over,358,230,150,22,128,74,6,128,105,0,7,10,6
S01007656,Owned: Total,142,95,57,9,48,38,0,47,46,0,1,0,0
S01007656,Owned: Owned outright,104,60,32,8,24,28,0,44,43,0,1,0,0
S01007656,Owned: Owned with a mortgage or loan or shared ownership,38,35,25,1,24,10,0,3,3,0,0,0,0
S01007656,Rented or living rent free: Total,216,135,93,13,80,36,6,81,59,0,6,10,6
S01007656,Rented or living rent free: Social rented,7,3,2,0,2,0,1,4,2,0,0,2,0
S01007656,Rented or living rent free: Private rented or living rent free,209,132,91,13,78,36,5,77,57,0,6,8,6
S01007657,All HRPs aged 16 and over,176,128,93,22,71,33,2,48,42,0,0,5,1
S01007657,Owned: Total,110,79,55,14,41,23,1,31,29,0,0,2,0
S01007657,Owned: Owned outright,66,36,20,8,12,15,1,30,28,0,0,2,0
S01007657,Owned: Owned with a mortgage or loan or shared ownership,44,43,35,6,29,8,0,1,1,0,0,0,0
S01007657,Rented or living rent free: Total,66,49,38,8,30,10,1,17,13,0,0,3,1
S01007657,Rented or living rent free: Social rented,11,6,5,1,4,1,0,5,3,0,0,2,0
S01007657,Rented or living rent free: Private rented or living rent free,55,43,33,7,26,9,1,12,10,0,0,1,1
S01007658,All HRPs aged 16 and over,231,143,89,20,69,46,8,88,83,0,1,3,1
S01007658,Owned: Total,158,96,58,10,48,35,3,62,58,0,1,2,1
S01007658,Owned: Owned outright,99,45,24,4,20,20,1,54,51,0,1,1,1
S01007658,Owned: Owned with a mortgage or loan or shared ownership,59,51,34,6,28,15,2,8,7,0,0,1,0
S01007658,Rented or living rent free: Total,73,47,31,10,21,11,5,26,25,0,0,1,0
S01007658,Rented or living rent free: Social rented,4,3,3,2,1,0,0,1,1,0,0,0,0
S01007658,Rented or living rent free: Private rented or living rent free,69,44,28,8,20,11,5,25,24,0,0,1,0
S01007659,All HRPs aged 16 and over,366,214,152,32,120,56,6,152,130,0,6,14,2
S01007659,Owned: Total,230,122,90,13,77,32,0,108,102,0,0,6,0
S01007659,Owned: Owned outright,145,52,33,10,23,19,0,93,90,0,0,3,0
S01007659,Owned: Owned with a mortgage or loan or shared ownership,85,70,57,3,54,13,0,15,12,0,0,3,0
S01007659,Rented or living rent free: Total,136,92,62,19,43,24,6,44,28,0,6,8,2
S01007659,Rented or living rent free: Social rented,69,37,30,16,14,4,3,32,16,0,6,8,2
S01007659,Rented or living rent free: Private rented or living rent free,67,55,32,3,29,20,3,12,12,0,0,0,0
S01007660,All HRPs aged 16 and over,400,253,212,41,171,26,15,147,94,1,6,37,9
S01007660,Owned: Total,149,120,104,13,91,15,1,29,24,0,0,3,2
S01007660,Owned: Owned outright,54,31,26,5,21,5,0,23,21,0,0,1,1
S01007660,Owned: Owned with a mortgage or loan or shared ownership,95,89,78,8,70,10,1,6,3,0,0,2,1
S01007660,Rented or living rent free: Total,251,133,108,28,80,11,14,118,70,1,6,34,7
S01007660,Rented or living rent free: Social rented,204,94,76,22,54,5,13,110,67,1,4,31,7
S01007660,Rented or living rent free: Private rented or living rent free,47,39,32,6,26,6,1,8,3,0,2,3,0
S01007661,All HRPs aged 16 and over,327,192,151,32,119,34,7,135,112,0,7,11,5
S01007661,Owned: Total,205,114,92,19,73,21,1,91,86,0,0,3,2
S01007661,Owned: Owned outright,117,35,24,9,15,11,0,82,77,0,0,3,2
S01007661,Owned: Owned with a mortgage or loan or shared ownership,88,79,68,10,58,10,1,9,9,0,0,0,0
S01007661,Rented or living rent free: Total,122,78,59,13,46,13,6,44,26,0,7,8,3
S01007661,Rented or living rent free: Social rented,57,27,19,8,11,5,3,30,15,0,5,8,2
S01007661,Rented or living rent free: Private rented or living rent free,65,51,40,5,35,8,3,14,11,0,2,0,1
S01007662,All HRPs aged 16 and over,493,251,207,38,169,26,18,242,201,2,4,24,11
S01007662,Owned: Total,286,146,122,14,108,21,3,140,134,0,0,2,4
S01007662,Owned: Owned outright,175,44,31,6,25,12,1,131,125,0,0,2,4
S01007662,Owned: Owned with a mortgage or loan or shared ownership,111,102,91,8,83,9,2,9,9,0,0,0,0
S01007662,Rented or living rent free: Total,207,105,85,24,61,5,15,102,67,2,4,22,7
S01007662,Rented or living rent free: Social rented,128,56,40,11,29,3,13,72,47,0,3,16,6
S01007662,Rented or living rent free: Private rented or living rent free,79,49,45,13,32,2,2,30,20,2,1,6,1
S01007663,All HRPs aged 16 and over,387,212,180,25,155,29,3,175,159,2,2,12,0
S01007663,Owned: Total,276,166,143,18,125,23,0,110,107,1,0,2,0
S01007663,Owned: Owned outright,163,60,47,14,33,13,0,103,101,1,0,1,0
S01007663,Owned: Owned with a mortgage or loan or shared ownership,113,106,96,4,92,10,0,7,6,0,0,1,0
S01007663,Rented or living rent free: Total,111,46,37,7,30,6,3,65,52,1,2,10,0
S01007663,Rented or living rent free: Social rented,67,20,18,5,13,0,2,47,37,0,1,9,0
S01007663,Rented or living rent free: Private rented or living rent free,44,26,19,2,17,6,1,18,15,1,1,1,0
S01007664,All HRPs aged 16 and over,283,154,135,38,97,14,5,129,99,1,5,20,4
S01007664,Owned: Total,143,86,73,18,55,12,1,57,50,0,2,3,2
S01007664,Owned: Owned outright,81,27,21,10,11,5,1,54,49,0,2,2,1
S01007664,Owned: Owned with a mortgage or loan or shared ownership,62,59,52,8,44,7,0,3,1,0,0,1,1
S01007664,Rented or living rent free: Total,140,68,62,20,42,2,4,72,49,1,3,17,2
S01007664,Rented or living rent free: Social rented,105,41,35,10,25,2,4,64,44,1,3,14,2
S01007664,Rented or living rent free: Private rented or living rent free,35,27,27,10,17,0,0,8,5,0,0,3,0
S01007665,All HRPs aged 16 and over,275,184,163,24,139,13,8,91,72,1,5,9,4
S01007665,Owned: Total,190,132,120,9,111,11,1,58,56,0,0,1,1
S01007665,Owned: Owned outright,75,21,18,5,13,2,1,54,52,0,0,1,1
S01007665,Owned: Owned with a mortgage or loan or shared ownership,115,111,102,4,98,9,0,4,4,0,0,0,0
S01007665,Rented or living rent free: Total,85,52,43,15,28,2,7,33,16,1,5,8,3
S01007665,Rented or living rent free: Social rented,46,23,18,7,11,0,5,23,11,0,4,5,3
S01007665,Rented or living rent free: Private rented or living rent free,39,29,25,8,17,2,2,10,5,1,1,3,0
S01007666,All HRPs aged 16 and over,198,120,105,16,89,13,2,78,70,0,2,6,0
S01007666,Owned: Total,177,110,98,15,83,11,1,67,65,0,1,1,0
S01007666,Owned: Owned outright,96,35,30,7,23,5,0,61,61,0,0,0,0
S01007666,Owned: Owned with a mortgage or loan or shared ownership,81,75,68,8,60,6,1,6,4,0,1,1,0
S01007666,Rented or living rent free: Total,21,10,7,1,6,2,1,11,5,0,1,5,0
S01007666,Rented or living rent free: Social rented,7,2,0,0,0,1,1,5,0,0,1,4,0
S01007666,Rented or living rent free: Private rented or living rent free,14,8,7,1,6,1,0,6,5,0,0,1,0
S01007667,All HRPs aged 16 and over,283,188,157,15,142,26,5,95,90,1,1,1,2
S01007667,Owned: Total,251,165,138,14,124,25,2,86,82,1,1,0,2
S01007667,Owned: Owned outright,141,59,47,7,40,10,2,82,78,1,1,0,2
S01007667,Owned: Owned with a mortgage or loan or shared ownership,110,106,91,7,84,15,0,4,4,0,0,0,0
S01007667,Rented or living rent free: Total,32,23,19,1,18,1,3,9,8,0,0,1,0
S01007667,Rented or living rent free: Social rented,9,7,4,1,3,0,3,2,1,0,0,1,0
S01007667,Rented or living rent free: Private rented or living rent free,23,16,15,0,15,1,0,7,7,0,0,0,0
S01007668,All HRPs aged 16 and over,468,292,254,54,200,22,16,176,132,1,4,30,9
S01007668,Owned: Total,264,175,154,27,127,19,2,89,83,1,1,3,1
S01007668,Owned: Owned outright,117,42,35,13,22,7,0,75,71,1,0,2,1
S01007668,Owned: Owned with a mortgage or loan or shared ownership,147,133,119,14,105,12,2,14,12,0,1,1,0
S01007668,Rented or living rent free: Total,204,117,100,27,73,3,14,87,49,0,3,27,8
S01007668,Rented or living rent free: Social rented,169,89,73,18,55,3,13,80,44,0,3,26,7
S01007668,Rented or living rent free: Private rented or living rent free,35,28,27,9,18,0,1,7,5,0,0,1,1
S01007669,All HRPs aged 16 and over,268,179,139,33,106,16,24,89,51,0,6,23,9
S01007669,Owned: Total,86,57,42,6,36,12,3,29,27,0,0,2,0
S01007669,Owned: Owned outright,39,13,8,2,6,4,1,26,26,0,0,0,0
S01007669,Owned: Owned with a mortgage or loan or shared ownership,47,44,34,4,30,8,2,3,1,0,0,2,0
S01007669,Rented or living rent free: Total,182,122,97,27,70,4,21,60,24,0,6,21,9
S01007669,Rented or living rent free: Social rented,165,110,87,25,62,2,21,55,23,0,6,18,8
S01007669,Rented or living rent free: Private rented or living rent free,17,12,10,2,8,2,0,5,1,0,0,3,1
S01007670,All HRPs aged 16 and over,299,197,159,34,125,14,24,102,71,1,10,18,2
S01007670,Owned: Total,124,82,71,9,62,9,2,42,35,0,4,3,0
S01007670,Owned: Owned outright,55,22,20,5,15,1,1,33,28,0,3,2,0
S01007670,Owned: Owned with a mortgage or loan or shared ownership,69,60,51,4,47,8,1,9,7,0,1,1,0
S01007670,Rented or living rent free: Total,175,115,88,25,63,5,22,60,36,1,6,15,2
S01007670,Rented or living rent free: Social rented,150,92,69,23,46,4,19,58,35,1,6,14,2
S01007670,Rented or living rent free: Private rented or living rent free,25,23,19,2,17,1,3,2,1,0,0,1,0
S01007671,All HRPs aged 16 and over,289,201,144,16,128,56,1,88,83,0,0,3,2
S01007671,Owned: Total,242,168,119,13,106,48,1,74,74,0,0,0,0
S01007671,Owned: Owned outright,142,78,49,10,39,28,1,64,64,0,0,0,0
S01007671,Owned: Owned with a mortgage or loan or shared ownership,100,90,70,3,67,20,0,10,10,0,0,0,0
S01007671,Rented or living rent free: Total,47,33,25,3,22,8,0,14,9,0,0,3,2
S01007671,Rented or living rent free: Social rented,9,4,3,0,3,1,0,5,0,0,0,3,2
S01007671,Rented or living rent free: Private rented or living rent free,38,29,22,3,19,7,0,9,9,0,0,0,0
S01007672,All HRPs aged 16 and over,389,199,158,22,136,40,1,190,177,0,5,5,3
S01007672,Owned: Total,355,179,143,21,122,36,0,176,167,0,4,2,3
S01007672,Owned: Owned outright,237,68,51,14,37,17,0,169,162,0,3,2,2
S01007672,Owned: Owned with a mortgage or loan or shared ownership,118,111,92,7,85,19,0,7,5,0,1,0,1
S01007672,Rented or living rent free: Total,34,20,15,1,14,4,1,14,10,0,1,3,0
S01007672,Rented or living rent free: Social rented,5,3,3,1,2,0,0,2,0,0,0,2,0
S01007672,Rented or living rent free: Private rented or living rent free,29,17,12,0,12,4,1,12,10,0,1,1,0
S01007673,All HRPs aged 16 and over,304,215,181,19,162,30,4,89,81,0,3,4,1
S01007673,Owned: Total,250,170,144,15,129,26,0,80,76,0,1,2,1
S01007673,Owned: Owned outright,132,59,47,8,39,12,0,73,71,0,0,1,1
S01007673,Owned: Owned with a mortgage or loan or shared ownership,118,111,97,7,90,14,0,7,5,0,1,1,0
S01007673,Rented or living rent free: Total,54,45,37,4,33,4,4,9,5,0,2,2,0
S01007673,Rented or living rent free: Social rented,13,7,5,1,4,1,1,6,2,0,2,2,0
S01007673,Rented or living rent free: Private rented or living rent free,41,38,32,3,29,3,3,3,3,0,0,0,0
S01007674,All HRPs aged 16 and over,376,224,181,29,152,20,23,152,115,0,10,21,6
S01007674,Owned: Total,226,144,124,15,109,17,3,82,76,0,2,4,0
S01007674,Owned: Owned outright,111,45,36,7,29,7,2,66,64,0,0,2,0
S01007674,Owned: Owned with a mortgage or loan or shared ownership,115,99,88,8,80,10,1,16,12,0,2,2,0
S01007674,Rented or living rent free: Total,150,80,57,14,43,3,20,70,39,0,8,17,6
S01007674,Rented or living rent free: Social rented,116,60,41,9,32,3,16,56,31,0,4,15,6
S01007674,Rented or living rent free: Private rented or living rent free,34,20,16,5,11,0,4,14,8,0,4,2,0
S01007675,All HRPs aged 16 and over,251,162,127,13,114,32,3,89,82,0,3,3,1
S01007675,Owned: Total,215,141,111,10,101,29,1,74,71,0,1,2,0
S01007675,Owned: Owned outright,117,59,43,8,35,16,0,58,56,0,0,2,0
S01007675,Owned: Owned with a mortgage or loan or shared ownership,98,82,68,2,66,13,1,16,15,0,1,0,0
S01007675,Rented or living rent free: Total,36,21,16,3,13,3,2,15,11,0,2,1,1
S01007675,Rented or living rent free: Social rented,14,8,7,0,7,0,1,6,4,0,1,1,0
S01007675,Rented or living rent free: Private rented or living rent free,22,13,9,3,6,3,1,9,7,0,1,0,1
S01007676,All HRPs aged 16 and over,279,205,130,17,113,73,2,74,72,0,0,2,0
S01007676,Owned: Total,231,168,101,14,87,65,2,63,61,0,0,2,0
S01007676,Owned: Owned outright,145,86,47,7,40,39,0,59,58,0,0,1,0
S01007676,Owned: Owned with a mortgage or loan or shared ownership,86,82,54,7,47,26,2,4,3,0,0,1,0
S01007676,Rented or living rent free: Total,48,37,29,3,26,8,0,11,11,0,0,0,0
S01007676,Rented or living rent free: Social rented,8,6,6,1,5,0,0,2,2,0,0,0,0
S01007676,Rented or living rent free: Private rented or living rent free,40,31,23,2,21,8,0,9,9,0,0,0,0
S01007677,All HRPs aged 16 and over,201,127,107,12,95,18,2,74,68,1,2,3,0
S01007677,Owned: Total,167,102,87,8,79,15,0,65,62,0,0,3,0
S01007677,Owned: Owned outright,87,28,21,3,18,7,0,59,58,0,0,1,0
S01007677,Owned: Owned with a mortgage or loan or shared ownership,80,74,66,5,61,8,0,6,4,0,0,2,0
S01007677,Rented or living rent free: Total,34,25,20,4,16,3,2,9,6,1,2,0,0
S01007677,Rented or living rent free: Social rented,9,6,4,0,4,0,2,3,2,0,1,0,0
S01007677,Rented or living rent free: Private rented or living rent free,25,19,16,4,12,3,0,6,4,1,1,0,0
S01007678,All HRPs aged 16 and over,368,194,162,26,136,20,12,174,151,3,5,15,0
S01007678,Owned: Total,211,117,98,10,88,17,2,94,87,2,0,5,0
S01007678,Owned: Owned outright,121,34,27,6,21,5,2,87,82,0,0,5,0
S01007678,Owned: Owned with a mortgage or loan or shared ownership,90,83,71,4,67,12,0,7,5,2,0,0,0
S01007678,Rented or living rent free: Total,157,77,64,16,48,3,10,80,64,1,5,10,0
S01007678,Rented or living rent free: Social rented,119,46,39,11,28,1,6,73,57,1,5,10,0
S01007678,Rented or living rent free: Private rented or living rent free,38,31,25,5,20,2,4,7,7,0,0,0,0
S01007679,All HRPs aged 16 and over,381,196,160,38,122,21,15,185,142,0,17,22,4
S01007679,Owned: Total,221,107,89,19,70,13,5,114,104,0,1,9,0
S01007679,Owned: Owned outright,142,38,27,10,17,7,4,104,95,0,1,8,0
S01007679,Owned: Owned with a mortgage or loan or shared ownership,79,69,62,9,53,6,1,10,9,0,0,1,0
S01007679,Rented or living rent free: Total,160,89,71,19,52,8,10,71,38,0,16,13,4
S01007679,Rented or living rent free: Social rented,133,69,55,16,39,5,9,64,34,0,14,13,3
S01007679,Rented or living rent free: Private rented or living rent free,27,20,16,3,13,3,1,7,4,0,2,0,1
S01007680,All HRPs aged 16 and over,386,253,213,27,186,37,3,133,131,0,1,1,0
S01007680,Owned: Total,356,232,197,21,176,34,1,124,123,0,1,0,0
S01007680,Owned: Owned outright,192,82,68,15,53,14,0,110,110,0,0,0,0
S01007680,Owned: Owned with a mortgage or loan or shared ownership,164,150,129,6,123,20,1,14,13,0,1,0,0
S01007680,Rented or living rent free: Total,30,21,16,6,10,3,2,9,8,0,0,1,0
S01007680,Rented or living rent free: Social rented,2,1,0,0,0,1,0,1,0,0,0,1,0
S01007680,Rented or living rent free: Private rented or living rent free,28,20,16,6,10,2,2,8,8,0,0,0,0
S01007681,All HRPs aged 16 and over,192,113,87,12,75,23,3,79,74,0,0,5,0
S01007681,Owned: Total,134,90,71,8,63,18,1,44,44,0,0,0,0
S01007681,Owned: Owned outright,60,23,18,2,16,4,1,37,37,0,0,0,0
S01007681,Owned: Owned with a mortgage or loan or shared ownership,74,67,53,6,47,14,0,7,7,0,0,0,0
S01007681,Rented or living rent free: Total,58,23,16,4,12,5,2,35,30,0,0,5,0
S01007681,Rented or living rent free: Social rented,37,13,11,4,7,1,1,24,19,0,0,5,0
S01007681,Rented or living rent free: Private rented or living rent free,21,10,5,0,5,4,1,11,11,0,0,0,0
S01007682,All HRPs aged 16 and over,403,266,206,23,183,53,7,137,117,12,2,2,4
S01007682,Owned: Total,310,195,144,17,127,48,3,115,109,2,2,1,1
S01007682,Owned: Owned outright,196,89,66,11,55,21,2,107,104,1,1,1,0
S01007682,Owned: Owned with a mortgage or loan or shared ownership,114,106,78,6,72,27,1,8,5,1,1,0,1
S01007682,Rented or living rent free: Total,93,71,62,6,56,5,4,22,8,10,0,1,3
S01007682,Rented or living rent free: Social rented,4,3,2,1,1,0,1,1,1,0,0,0,0
S01007682,Rented or living rent free: Private rented or living rent free,89,68,60,5,55,5,3,21,7,10,0,1,3
S01007683,All HRPs aged 16 and over,301,196,165,16,149,26,5,105,80,19,0,3,3
S01007683,Owned: Total,196,116,94,10,84,22,0,80,77,0,0,1,2
S01007683,Owned: Owned outright,106,33,26,7,19,7,0,73,71,0,0,1,1
S01007683,Owned: Owned with a mortgage or loan or shared ownership,90,83,68,3,65,15,0,7,6,0,0,0,1
S01007683,Rented or living rent free: Total,105,80,71,6,65,4,5,25,3,19,0,2,1
S01007683,Rented or living rent free: Social rented,8,6,4,0,4,0,2,2,1,0,0,1,0
S01007683,Rented or living rent free: Private rented or living rent free,97,74,67,6,61,4,3,23,2,19,0,1,1
S01007684,All HRPs aged 16 and over,332,189,159,24,135,28,2,143,134,6,0,1,2
S01007684,Owned: Total,315,175,145,20,125,28,2,140,134,3,0,1,2
S01007684,Owned: Owned outright,208,79,66,16,50,11,2,129,124,2,0,1,2
S01007684,Owned: Owned with a mortgage or loan or shared ownership,107,96,79,4,75,17,0,11,10,1,0,0,0
S01007684,Rented or living rent free: Total,17,14,14,4,10,0,0,3,0,3,0,0,0
S01007684,Rented or living rent free: Social rented,3,3,3,1,2,0,0,0,0,0,0,0,0
S01007684,Rented or living rent free: Private rented or living rent free,14,11,11,3,8,0,0,3,0,3,0,0,0
S01007685,All HRPs aged 16 and over,273,189,140,17,123,45,4,84,76,5,1,1,1
S01007685,Owned: Total,247,167,120,13,107,44,3,80,75,4,1,0,0
S01007685,Owned: Owned outright,139,62,45,11,34,17,0,77,74,3,0,0,0
S01007685,Owned: Owned with a mortgage or loan or shared ownership,108,105,75,2,73,27,3,3,1,1,1,0,0
S01007685,Rented or living rent free: Total,26,22,20,4,16,1,1,4,1,1,0,1,1
S01007685,Rented or living rent free: Social rented,3,2,1,1,0,0,1,1,0,0,0,1,0
S01007685,Rented or living rent free: Private rented or living rent free,23,20,19,3,16,1,0,3,1,1,0,0,1
S01007686,All HRPs aged 16 and over,320,196,172,27,145,22,2,124,98,18,2,2,4
S01007686,Owned: Total,241,146,126,17,109,19,1,95,88,3,0,0,4
S01007686,Owned: Owned outright,148,61,47,11,36,13,1,87,80,3,0,0,4
S01007686,Owned: Owned with a mortgage or loan or shared ownership,93,85,79,6,73,6,0,8,8,0,0,0,0
S01007686,Rented or living rent free: Total,79,50,46,10,36,3,1,29,10,15,2,2,0
S01007686,Rented or living rent free: Social rented,5,2,1,0,1,1,0,3,1,1,0,1,0
S01007686,Rented or living rent free: Private rented or living rent free,74,48,45,10,35,2,1,26,9,14,2,1,0
S01007687,All HRPs aged 16 and over,399,262,223,56,167,31,8,137,94,33,5,5,0
S01007687,Owned: Total,243,144,119,25,94,24,1,99,82,15,1,1,0
S01007687,Owned: Owned outright,130,45,39,12,27,6,0,85,81,4,0,0,0
S01007687,Owned: Owned with a mortgage or loan or shared ownership,113,99,80,13,67,18,1,14,1,11,1,1,0
S01007687,Rented or living rent free: Total,156,118,104,31,73,7,7,38,12,18,4,4,0
S01007687,Rented or living rent free: Social rented,8,5,5,1,4,0,0,3,2,0,0,1,0
S01007687,Rented or living rent free: Private rented or living rent free,148,113,99,30,69,7,7,35,10,18,4,3,0
S01007688,All HRPs aged 16 and over,545,386,323,92,231,34,29,159,46,83,8,17,5
S01007688,Owned: Total,151,107,93,13,80,12,2,44,23,14,2,4,1
S01007688,Owned: Owned outright,56,29,24,5,19,4,1,27,20,4,1,2,0
S01007688,Owned: Owned with a mortgage or loan or shared ownership,95,78,69,8,61,8,1,17,3,10,1,2,1
S01007688,Rented or living rent free: Total,394,279,230,79,151,22,27,115,23,69,6,13,4
S01007688,Rented or living rent free: Social rented,76,42,35,13,22,3,4,34,15,3,4,12,0
S01007688,Rented or living rent free: Private rented or living rent free,318,237,195,66,129,19,23,81,8,66,2,1,4
S01007689,All HRPs aged 16 and over,288,201,166,45,121,22,13,87,45,34,2,6,0
S01007689,Owned: Total,95,80,69,9,60,9,2,15,11,4,0,0,0
S01007689,Owned: Owned outright,28,17,15,3,12,2,0,11,9,2,0,0,0
S01007689,Owned: Owned with a mortgage or loan or shared ownership,67,63,54,6,48,7,2,4,2,2,0,0,0
S01007689,Rented or living rent free: Total,193,121,97,36,61,13,11,72,34,30,2,6,0
S01007689,Rented or living rent free: Social rented,45,11,10,6,4,0,1,34,27,1,1,5,0
S01007689,Rented or living rent free: Private rented or living rent free,148,110,87,30,57,13,10,38,7,29,1,1,0
S01007690,All HRPs aged 16 and over,393,249,209,78,131,21,19,144,46,70,6,21,1
S01007690,Owned: Total,114,80,66,13,53,10,4,34,21,12,0,1,0
S01007690,Owned: Owned outright,55,28,20,6,14,5,3,27,19,8,0,0,0
S01007690,Owned: Owned with a mortgage or loan or shared ownership,59,52,46,7,39,5,1,7,2,4,0,1,0
S01007690,Rented or living rent free: Total,279,169,143,65,78,11,15,110,25,58,6,20,1
S01007690,Rented or living rent free: Social rented,73,29,25,9,16,0,4,44,23,0,1,19,1
S01007690,Rented or living rent free: Private rented or living rent free,206,140,118,56,62,11,11,66,2,58,5,1,0
S01007691,All HRPs aged 16 and over,515,335,252,92,160,24,59,180,39,89,4,39,9
S01007691,Owned: Total,60,39,32,8,24,5,2,21,11,8,0,2,0
S01007691,Owned: Owned outright,27,11,9,4,5,2,0,16,11,3,0,2,0
S01007691,Owned: Owned with a mortgage or loan or shared ownership,33,28,23,4,19,3,2,5,0,5,0,0,0
S01007691,Rented or living rent free: Total,455,296,220,84,136,19,57,159,28,81,4,37,9
S01007691,Rented or living rent free: Social rented,182,106,63,16,47,7,36,76,20,10,4,34,8
S01007691,Rented or living rent free: Private rented or living rent free,273,190,157,68,89,12,21,83,8,71,0,3,1
S01007692,All HRPs aged 16 and over,434,270,231,87,144,19,20,164,55,93,0,9,7
S01007692,Owned: Total,96,70,57,15,42,13,0,26,10,15,0,1,0
S01007692,Owned: Owned outright,34,19,15,4,11,4,0,15,9,6,0,0,0
S01007692,Owned: Owned with a mortgage or loan or shared ownership,62,51,42,11,31,9,0,11,1,9,0,1,0
S01007692,Rented or living rent free: Total,338,200,174,72,102,6,20,138,45,78,0,8,7
S01007692,Rented or living rent free: Social rented,73,19,15,2,13,0,4,54,44,3,0,4,3
S01007692,Rented or living rent free: Private rented or living rent free,265,181,159,70,89,6,16,84,1,75,0,4,4
S01007693,All HRPs aged 16 and over,347,215,166,77,89,13,36,132,14,85,3,27,3
S01007693,Owned: Total,36,26,20,10,10,4,2,10,4,5,0,1,0
S01007693,Owned: Owned outright,18,9,5,4,1,2,2,9,4,4,0,1,0
S01007693,Owned: Owned with a mortgage or loan or shared ownership,18,17,15,6,9,2,0,1,0,1,0,0,0
S01007693,Rented or living rent free: Total,311,189,146,67,79,9,34,122,10,80,3,26,3
S01007693,Rented or living rent free: Social rented,96,56,38,11,27,2,16,40,9,6,2,21,2
S01007693,Rented or living rent free: Private rented or living rent free,215,133,108,56,52,7,18,82,1,74,1,5,1
S01007694,All HRPs aged 16 and over,523,302,255,107,148,17,30,221,71,95,8,43,4
S01007694,Owned: Total,73,52,42,10,32,8,2,21,6,12,0,1,2
S01007694,Owned: Owned outright,20,8,5,1,4,2,1,12,6,3,0,1,2
S01007694,Owned: Owned with a mortgage or loan or shared ownership,53,44,37,9,28,6,1,9,0,9,0,0,0
S01007694,Rented or living rent free: Total,450,250,213,97,116,9,28,200,65,83,8,42,2
S01007694,Rented or living rent free: Social rented,207,98,84,33,51,5,9,109,58,4,6,39,2
S01007694,Rented or living rent free: Private rented or living rent free,243,152,129,64,65,4,19,91,7,79,2,3,0
S01007695,All HRPs aged 16 and over,614,333,279,62,217,27,27,281,193,51,1,27,9
S01007695,Owned: Total,179,118,101,14,87,14,3,61,48,7,0,5,1
S01007695,Owned: Owned outright,87,37,29,6,23,5,3,50,41,4,0,4,1
S01007695,Owned: Owned with a mortgage or loan or shared ownership,92,81,72,8,64,9,0,11,7,3,0,1,0
S01007695,Rented or living rent free: Total,435,215,178,48,130,13,24,220,145,44,1,22,8
S01007695,Rented or living rent free: Social rented,209,50,40,14,26,5,5,159,137,2,1,15,4
S01007695,Rented or living rent free: Private rented or living rent free,226,165,138,34,104,8,19,61,8,42,0,7,4
S01007696,All HRPs aged 16 and over,437,244,182,69,113,14,48,193,46,91,11,28,17
S01007696,Owned: Total,68,37,34,8,26,1,2,31,17,10,2,1,1
S01007696,Owned: Owned outright,29,9,8,3,5,1,0,20,15,2,1,1,1
S01007696,Owned: Owned with a mortgage or loan or shared ownership,39,28,26,5,21,0,2,11,2,8,1,0,0
S01007696,Rented or living rent free: Total,369,207,148,61,87,13,46,162,29,81,9,27,16
S01007696,Rented or living rent free: Social rented,132,62,35,12,23,8,19,70,28,7,4,24,7
S01007696,Rented or living rent free: Private rented or living rent free,237,145,113,49,64,5,27,92,1,74,5,3,9
S01007697,All HRPs aged 16 and over,608,329,282,62,220,29,18,279,184,58,5,23,9
S01007697,Owned: Total,220,137,120,17,103,16,1,83,70,8,1,0,4
S01007697,Owned: Owned outright,106,38,34,9,25,3,1,68,63,3,0,0,2
S01007697,Owned: Owned with a mortgage or loan or shared ownership,114,99,86,8,78,13,0,15,7,5,1,0,2
S01007697,Rented or living rent free: Total,388,192,162,45,117,13,17,196,114,50,4,23,5
S01007697,Rented or living rent free: Social rented,177,40,32,10,22,3,5,137,101,12,1,20,3
S01007697,Rented or living rent free: Private rented or living rent free,211,152,130,35,95,10,12,59,13,38,3,3,2
S01007698,All HRPs aged 16 and over,589,408,337,102,235,31,40,181,24,100,5,42,10
S01007698,Owned: Total,106,86,69,12,57,14,3,20,10,5,0,4,1
S01007698,Owned: Owned outright,28,16,10,1,9,4,2,12,7,1,0,4,0
S01007698,Owned: Owned with a mortgage or loan or shared ownership,78,70,59,11,48,10,1,8,3,4,0,0,1
S01007698,Rented or living rent free: Total,483,322,268,90,178,17,37,161,14,95,5,38,9
S01007698,Rented or living rent free: Social rented,129,85,61,19,42,10,14,44,8,5,3,24,4
S01007698,Rented or living rent free: Private rented or living rent free,354,237,207,71,136,7,23,117,6,90,2,14,5
S01007699,All HRPs aged 16 and over,454,304,262,82,180,14,28,150,35,63,18,30,4
S01007699,Owned: Total,99,70,62,7,55,6,2,29,19,6,1,2,1
S01007699,Owned: Owned outright,35,17,13,1,12,2,2,18,15,1,0,1,1
S01007699,Owned: Owned with a mortgage or loan or shared ownership,64,53,49,6,43,4,0,11,4,5,1,1,0
S01007699,Rented or living rent free: Total,355,234,200,75,125,8,26,121,16,57,17,28,3
S01007699,Rented or living rent free: Social rented,90,52,41,12,29,1,10,38,11,1,5,21,0
S01007699,Rented or living rent free: Private rented or living rent free,265,182,159,63,96,7,16,83,5,56,12,7,3
S01007700,All HRPs aged 16 and over,450,316,271,30,241,35,10,134,95,12,3,21,3
S01007700,Owned: Total,345,248,215,18,197,31,2,97,86,5,1,4,1
S01007700,Owned: Owned outright,163,77,65,11,54,12,0,86,79,4,1,1,1
S01007700,Owned: Owned with a mortgage or loan or shared ownership,182,171,150,7,143,19,2,11,7,1,0,3,0
S01007700,Rented or living rent free: Total,105,68,56,12,44,4,8,37,9,7,2,17,2
S01007700,Rented or living rent free: Social rented,37,19,14,7,7,2,3,18,8,0,0,9,1
S01007700,Rented or living rent free: Private rented or living rent free,68,49,42,5,37,2,5,19,1,7,2,8,1
S01007701,All HRPs aged 16 and over,318,184,138,59,79,6,40,134,49,47,3,31,4
S01007701,Owned: Total,61,38,34,12,22,2,2,23,6,15,0,1,1
S01007701,Owned: Owned outright,30,13,12,6,6,0,1,17,5,10,0,1,1
S01007701,Owned: Owned with a mortgage or loan or shared ownership,31,25,22,6,16,2,1,6,1,5,0,0,0
S01007701,Rented or living rent free: Total,257,146,104,47,57,4,38,111,43,32,3,30,3
S01007701,Rented or living rent free: Social rented,161,84,55,25,30,2,27,77,38,6,2,28,3
S01007701,Rented or living rent free: Private rented or living rent free,96,62,49,22,27,2,11,34,5,26,1,2,0
S01007702,All HRPs aged 16 and over,266,196,152,40,112,22,22,70,11,48,4,3,4
S01007702,Owned: Total,82,65,53,5,48,10,2,17,9,8,0,0,0
S01007702,Owned: Owned outright,26,16,14,2,12,2,0,10,8,2,0,0,0
S01007702,Owned: Owned with a mortgage or loan or shared ownership,56,49,39,3,36,8,2,7,1,6,0,0,0
S01007702,Rented or living rent free: Total,184,131,99,35,64,12,20,53,2,40,4,3,4
S01007702,Rented or living rent free: Social rented,17,13,11,4,7,1,1,4,0,0,1,2,1
S01007702,Rented or living rent free: Private rented or living rent free,167,118,88,31,57,11,19,49,2,40,3,1,3
S01007703,All HRPs aged 16 and over,398,244,205,43,162,21,18,154,98,27,5,22,2
S01007703,Owned: Total,229,149,131,15,116,16,2,80,67,5,4,4,0
S01007703,Owned: Owned outright,102,36,31,6,25,5,0,66,58,3,2,3,0
S01007703,Owned: Owned with a mortgage or loan or shared ownership,127,113,100,9,91,11,2,14,9,2,2,1,0
S01007703,Rented or living rent free: Total,169,95,74,28,46,5,16,74,31,22,1,18,2
S01007703,Rented or living rent free: Social rented,73,27,19,8,11,0,8,46,27,4,1,12,2
S01007703,Rented or living rent free: Private rented or living rent free,96,68,55,20,35,5,8,28,4,18,0,6,0
S01007704,All HRPs aged 16 and over,517,283,186,67,119,20,77,234,106,29,14,63,22
S01007704,Owned: Total,80,49,40,10,30,7,2,31,24,2,1,3,1
S01007704,Owned: Owned outright,47,21,15,3,12,5,1,26,22,0,1,2,1
S01007704,Owned: Owned with a mortgage or loan or shared ownership,33,28,25,7,18,2,1,5,2,2,0,1,0
S01007704,Rented or living rent free: Total,437,234,146,57,89,13,75,203,82,27,13,60,21
S01007704,Rented or living rent free: Social rented,348,165,90,33,57,9,66,183,81,13,11,57,21
S01007704,Rented or living rent free: Private rented or living rent free,89,69,56,24,32,4,9,20,1,14,2,3,0
S01007705,All HRPs aged 16 and over,262,181,157,66,91,7,17,81,5,69,0,4,3
S01007705,Owned: Total,25,19,15,4,11,2,2,6,1,4,0,0,1
S01007705,Owned: Owned outright,8,5,4,1,3,0,1,3,1,1,0,0,1
S01007705,Owned: Owned with a mortgage or loan or shared ownership,17,14,11,3,8,2,1,3,0,3,0,0,0
S01007705,Rented or living rent free: Total,237,162,142,62,80,5,15,75,4,65,0,4,2
S01007705,Rented or living rent free: Social rented,31,21,17,4,13,1,3,10,2,5,0,3,0
S01007705,Rented or living rent free: Private rented or living rent free,206,141,125,58,67,4,12,65,2,60,0,1,2
S01007706,All HRPs aged 16 and over,370,236,205,116,89,8,23,134,6,114,1,7,6
S01007706,Owned: Total,41,31,28,7,21,0,3,10,1,6,0,1,2
S01007706,Owned: Owned outright,13,9,7,1,6,0,2,4,0,4,0,0,0
S01007706,Owned: Owned with a mortgage or loan or shared ownership,28,22,21,6,15,0,1,6,1,2,0,1,2
S01007706,Rented or living rent free: Total,329,205,177,109,68,8,20,124,5,108,1,6,4
S01007706,Rented or living rent free: Social rented,37,27,22,9,13,0,5,10,2,2,0,4,2
S01007706,Rented or living rent free: Private rented or living rent free,292,178,155,100,55,8,15,114,3,106,1,2,2
S01007707,All HRPs aged 16 and over,465,338,298,43,255,26,14,127,12,100,7,4,4
S01007707,Owned: Total,123,103,83,9,74,15,5,20,9,11,0,0,0
S01007707,Owned: Owned outright,39,27,19,4,15,5,3,12,5,7,0,0,0
S01007707,Owned: Owned with a mortgage or loan or shared ownership,84,76,64,5,59,10,2,8,4,4,0,0,0
S01007707,Rented or living rent free: Total,342,235,215,34,181,11,9,107,3,89,7,4,4
S01007707,Rented or living rent free: Social rented,20,6,4,3,1,0,2,14,0,1,6,4,3
S01007707,Rented or living rent free: Private rented or living rent free,322,229,211,31,180,11,7,93,3,88,1,0,1
S01007708,All HRPs aged 16 and over,357,251,203,46,157,22,26,106,61,9,7,23,6
S01007708,Owned: Total,119,92,80,13,67,10,2,27,26,1,0,0,0
S01007708,Owned: Owned outright,43,23,20,6,14,2,1,20,20,0,0,0,0
S01007708,Owned: Owned with a mortgage or loan or shared ownership,76,69,60,7,53,8,1,7,6,1,0,0,0
S01007708,Rented or living rent free: Total,238,159,123,33,90,12,24,79,35,8,7,23,6
S01007708,Rented or living rent free: Social rented,141,77,55,20,35,7,15,64,33,5,3,18,5
S01007708,Rented or living rent free: Private rented or living rent free,97,82,68,13,55,5,9,15,2,3,4,5,1
S01007709,All HRPs aged 16 and over,309,175,147,26,121,10,18,134,73,25,2,28,6
S01007709,Owned: Total,92,64,60,7,53,2,2,28,19,5,1,2,1
S01007709,Owned: Owned outright,34,13,12,2,10,0,1,21,16,3,1,1,0
S01007709,Owned: Owned with a mortgage or loan or shared ownership,58,51,48,5,43,2,1,7,3,2,0,1,1
S01007709,Rented or living rent free: Total,217,111,87,19,68,8,16,106,54,20,1,26,5
S01007709,Rented or living rent free: Social rented,124,49,35,7,28,7,7,75,50,1,1,20,3
S01007709,Rented or living rent free: Private rented or living rent free,93,62,52,12,40,1,9,31,4,19,0,6,2
S01007710,All HRPs aged 16 and over,450,314,263,85,178,18,33,136,36,57,9,29,5
S01007710,Owned: Total,69,59,51,8,43,5,3,10,4,6,0,0,0
S01007710,Owned: Owned outright,17,13,11,5,6,2,0,4,3,1,0,0,0
S01007710,Owned: Owned with a mortgage or loan or shared ownership,52,46,40,3,37,3,3,6,1,5,0,0,0
S01007710,Rented or living rent free: Total,381,255,212,77,135,13,30,126,32,51,9,29,5
S01007710,Rented or living rent free: Social rented,166,102,87,29,58,4,11,64,29,1,4,26,4
S01007710,Rented or living rent free: Private rented or living rent free,215,153,125,48,77,9,19,62,3,50,5,3,1
S01007711,All HRPs aged 16 and over,493,298,255,99,156,14,29,195,91,54,2,44,4
S01007711,Owned: Total,83,61,55,12,43,6,0,22,17,3,0,2,0
S01007711,Owned: Owned outright,35,22,19,4,15,3,0,13,11,1,0,1,0
S01007711,Owned: Owned with a mortgage or loan or shared ownership,48,39,36,8,28,3,0,9,6,2,0,1,0
S01007711,Rented or living rent free: Total,410,237,200,87,113,8,29,173,74,51,2,42,4
S01007711,Rented or living rent free: Social rented,248,122,99,38,61,6,17,126,70,12,2,38,4
S01007711,Rented or living rent free: Private rented or living rent free,162,115,101,49,52,2,12,47,4,39,0,4,0
S01007712,All HRPs aged 16 and over,360,238,195,46,149,18,25,122,32,59,4,22,5
S01007712,Owned: Total,147,113,93,15,78,12,8,34,22,9,0,2,1
S01007712,Owned: Owned outright,53,30,20,6,14,6,4,23,17,5,0,1,0
S01007712,Owned: Owned with a mortgage or loan or shared ownership,94,83,73,9,64,6,4,11,5,4,0,1,1
S01007712,Rented or living rent free: Total,213,125,102,31,71,6,17,88,10,50,4,20,4
S01007712,Rented or living rent free: Social rented,56,26,19,3,16,2,5,30,8,3,3,12,4
S01007712,Rented or living rent free: Private rented or living rent free,157,99,83,28,55,4,12,58,2,47,1,8,0
S01007713,All HRPs aged 16 and over,229,145,112,30,82,20,13,84,46,14,2,18,4
S01007713,Owned: Total,93,62,50,8,42,10,2,31,28,0,0,3,0
S01007713,Owned: Owned outright,40,15,14,4,10,1,0,25,24,0,0,1,0
S01007713,Owned: Owned with a mortgage or loan or shared ownership,53,47,36,4,32,9,2,6,4,0,0,2,0
S01007713,Rented or living rent free: Total,136,83,62,22,40,10,11,53,18,14,2,15,4
S01007713,Rented or living rent free: Social rented,76,40,28,10,18,5,7,36,18,2,2,11,3
S01007713,Rented or living rent free: Private rented or living rent free,60,43,34,12,22,5,4,17,0,12,0,4,1
S01007714,All HRPs aged 16 and over,321,215,193,30,163,11,11,106,70,12,2,18,4
S01007714,Owned: Total,155,135,127,14,113,5,3,20,13,2,0,5,0
S01007714,Owned: Owned outright,40,28,24,3,21,2,2,12,9,0,0,3,0
S01007714,Owned: Owned with a mortgage or loan or shared ownership,115,107,103,11,92,3,1,8,4,2,0,2,0
S01007714,Rented or living rent free: Total,166,80,66,16,50,6,8,86,57,10,2,13,4
S01007714,Rented or living rent free: Social rented,86,25,21,3,18,1,3,61,51,0,1,7,2
S01007714,Rented or living rent free: Private rented or living rent free,80,55,45,13,32,5,5,25,6,10,1,6,2
S01007715,All HRPs aged 16 and over,267,155,124,39,85,8,23,112,55,18,10,21,8
S01007715,Owned: Total,70,52,44,9,35,3,5,18,15,0,1,2,0
S01007715,Owned: Owned outright,22,11,10,3,7,1,0,11,9,0,0,2,0
S01007715,Owned: Owned with a mortgage or loan or shared ownership,48,41,34,6,28,2,5,7,6,0,1,0,0
S01007715,Rented or living rent free: Total,197,103,80,30,50,5,18,94,40,18,9,19,8
S01007715,Rented or living rent free: Social rented,108,48,39,14,25,1,8,60,33,0,7,14,6
S01007715,Rented or living rent free: Private rented or living rent free,89,55,41,16,25,4,10,34,7,18,2,5,2
S01007716,All HRPs aged 16 and over,598,314,234,61,173,31,49,284,167,42,11,41,23
S01007716,Owned: Total,117,84,69,12,57,11,4,33,25,5,1,0,2
S01007716,Owned: Owned outright,47,23,15,5,10,4,4,24,20,4,0,0,0
S01007716,Owned: Owned with a mortgage or loan or shared ownership,70,61,54,7,47,7,0,9,5,1,1,0,2
S01007716,Rented or living rent free: Total,481,230,165,49,116,20,45,251,142,37,10,41,21
S01007716,Rented or living rent free: Social rented,255,75,47,14,33,7,21,180,131,2,8,28,11
S01007716,Rented or living rent free: Private rented or living rent free,226,155,118,35,83,13,24,71,11,35,2,13,10
S01007717,All HRPs aged 16 and over,567,315,228,65,163,33,54,252,119,41,16,57,19
S01007717,Owned: Total,113,87,73,10,63,9,5,26,18,4,0,4,0
S01007717,Owned: Owned outright,37,19,15,5,10,4,0,18,14,1,0,3,0
S01007717,Owned: Owned with a mortgage or loan or shared ownership,76,68,58,5,53,5,5,8,4,3,0,1,0
S01007717,Rented or living rent free: Total,454,228,155,55,100,24,49,226,101,37,16,53,19
S01007717,Rented or living rent free: Social rented,244,102,70,28,42,9,23,142,92,1,12,29,8
S01007717,Rented or living rent free: Private rented or living rent free,210,126,85,27,58,15,26,84,9,36,4,24,11
S01007718,All HRPs aged 16 and over,467,238,191,50,141,19,28,229,145,31,7,32,14
S01007718,Owned: Total,135,83,70,13,57,9,4,52,46,1,1,2,2
S01007718,Owned: Owned outright,55,11,9,3,6,1,1,44,40,0,1,1,2
S01007718,Owned: Owned with a mortgage or loan or shared ownership,80,72,61,10,51,8,3,8,6,1,0,1,0
S01007718,Rented or living rent free: Total,332,155,121,37,84,10,24,177,99,30,6,30,12
S01007718,Rented or living rent free: Social rented,158,36,29,9,20,3,4,122,92,3,4,18,5
S01007718,Rented or living rent free: Private rented or living rent free,174,119,92,28,64,7,20,55,7,27,2,12,7
S01007719,All HRPs aged 16 and over,651,355,296,57,239,25,34,296,195,21,6,65,9
S01007719,Owned: Total,232,169,153,18,135,15,1,63,47,3,1,10,2
S01007719,Owned: Owned outright,82,33,29,5,24,3,1,49,41,0,1,6,1
S01007719,Owned: Owned with a mortgage or loan or shared ownership,150,136,124,13,111,12,0,14,6,3,0,4,1
S01007719,Rented or living rent free: Total,419,186,143,39,104,10,33,233,148,18,5,55,7
S01007719,Rented or living rent free: Social rented,266,69,50,20,30,3,16,197,138,11,2,41,5
S01007719,Rented or living rent free: Private rented or living rent free,153,117,93,19,74,7,17,36,10,7,3,14,2
S01007720,All HRPs aged 16 and over,404,185,154,35,119,19,12,219,180,1,2,30,6
S01007720,Owned: Total,242,111,96,15,81,11,4,131,123,0,0,7,1
S01007720,Owned: Owned outright,154,38,36,7,29,0,2,116,110,0,0,6,0
S01007720,Owned: Owned with a mortgage or loan or shared ownership,88,73,60,8,52,11,2,15,13,0,0,1,1
S01007720,Rented or living rent free: Total,162,74,58,20,38,8,8,88,57,1,2,23,5
S01007720,Rented or living rent free: Social rented,120,42,32,14,18,4,6,78,50,0,2,21,5
S01007720,Rented or living rent free: Private rented or living rent free,42,32,26,6,20,4,2,10,7,1,0,2,0
S01007721,All HRPs aged 16 and over,435,276,230,49,181,25,21,159,115,13,3,20,8
S01007721,Owned: Total,202,131,113,14,99,14,4,71,63,5,1,2,0
S01007721,Owned: Owned outright,76,22,17,4,13,2,3,54,50,3,1,0,0
S01007721,Owned: Owned with a mortgage or loan or shared ownership,126,109,96,10,86,12,1,17,13,2,0,2,0
S01007721,Rented or living rent free: Total,233,145,117,35,82,11,17,88,52,8,2,18,8
S01007721,Rented or living rent free: Social rented,137,70,57,23,34,5,8,67,45,3,2,14,3
S01007721,Rented or living rent free: Private rented or living rent free,96,75,60,12,48,6,9,21,7,5,0,4,5
S01007722,All HRPs aged 16 and over,548,285,231,58,173,19,35,263,149,5,22,64,23
S01007722,Owned: Total,157,105,90,18,72,11,4,52,45,2,1,3,1
S01007722,Owned: Owned outright,77,32,25,6,19,4,3,45,39,2,1,2,1
S01007722,Owned: Owned with a mortgage or loan or shared ownership,80,73,65,12,53,7,1,7,6,0,0,1,0
S01007722,Rented or living rent free: Total,391,180,141,40,101,8,31,211,104,3,21,61,22
S01007722,Rented or living rent free: Social rented,297,112,89,22,67,4,19,185,99,0,15,57,14
S01007722,Rented or living rent free: Private rented or living rent free,94,68,52,18,34,4,12,26,5,3,6,4,8
S01007723,All HRPs aged 16 and over,604,262,228,53,175,11,23,342,224,9,10,66,33
S01007723,Owned: Total,167,100,88,17,71,5,7,67,60,1,0,2,4
S01007723,Owned: Owned outright,72,19,14,6,8,1,4,53,50,1,0,2,0
S01007723,Owned: Owned with a mortgage or loan or shared ownership,95,81,74,11,63,4,3,14,10,0,0,0,4
S01007723,Rented or living rent free: Total,437,162,140,36,104,6,16,275,164,8,10,64,29
S01007723,Rented or living rent free: Social rented,316,73,60,16,44,3,10,243,157,2,6,58,20
S01007723,Rented or living rent free: Private rented or living rent free,121,89,80,20,60,3,6,32,7,6,4,6,9
S01007724,All HRPs aged 16 and over,358,246,199,65,134,14,33,112,21,26,6,42,17
S01007724,Owned: Total,75,59,54,7,47,4,1,16,9,2,0,3,2
S01007724,Owned: Owned outright,15,6,6,1,5,0,0,9,6,1,0,2,0
S01007724,Owned: Owned with a mortgage or loan or shared ownership,60,53,48,6,42,4,1,7,3,1,0,1,2
S01007724,Rented or living rent free: Total,283,187,145,58,87,10,32,96,12,24,6,39,15
S01007724,Rented or living rent free: Social rented,92,47,37,20,17,3,7,45,9,3,3,24,6
S01007724,Rented or living rent free: Private rented or living rent free,191,140,108,38,70,7,25,51,3,21,3,15,9
S01007725,All HRPs aged 16 and over,498,308,239,55,184,16,53,190,97,16,16,52,9
S01007725,Owned: Total,154,100,86,14,72,12,2,54,48,2,2,2,0
S01007725,Owned: Owned outright,55,14,10,3,7,2,2,41,37,2,0,2,0
S01007725,Owned: Owned with a mortgage or loan or shared ownership,99,86,76,11,65,10,0,13,11,0,2,0,0
S01007725,Rented or living rent free: Total,344,208,153,41,112,4,51,136,49,14,14,50,9
S01007725,Rented or living rent free: Social rented,153,59,37,10,27,1,21,94,47,2,6,34,5
S01007725,Rented or living rent free: Private rented or living rent free,191,149,116,31,85,3,30,42,2,12,8,16,4
S01007726,All HRPs aged 16 and over,453,283,224,68,156,15,44,170,61,24,10,59,16
S01007726,Owned: Total,132,101,94,23,71,4,3,31,27,1,0,2,1
S01007726,Owned: Owned outright,43,19,18,6,12,1,0,24,22,0,0,1,1
S01007726,Owned: Owned with a mortgage or loan or shared ownership,89,82,76,17,59,3,3,7,5,1,0,1,0
S01007726,Rented or living rent free: Total,321,182,130,45,85,11,41,139,34,23,10,57,15
S01007726,Rented or living rent free: Social rented,143,62,41,19,22,1,20,81,29,11,5,32,4
S01007726,Rented or living rent free: Private rented or living rent free,178,120,89,26,63,10,21,58,5,12,5,25,11
S01007727,All HRPs aged 16 and over,591,347,257,77,180,31,59,244,85,49,18,71,21
S01007727,Owned: Total,119,87,69,19,50,14,4,32,23,7,0,2,0
S01007727,Owned: Owned outright,39,16,10,6,4,4,2,23,18,5,0,0,0
S01007727,Owned: Owned with a mortgage or loan or shared ownership,80,71,59,13,46,10,2,9,5,2,0,2,0
S01007727,Rented or living rent free: Total,472,260,188,58,130,17,55,212,62,42,18,69,21
S01007727,Rented or living rent free: Social rented,238,106,73,27,46,5,28,132,52,9,7,51,13
S01007727,Rented or living rent free: Private rented or living rent free,234,154,115,31,84,12,27,80,10,33,11,18,8
S01007728,All HRPs aged 16 and over,414,290,230,55,175,17,43,124,36,25,13,32,18
S01007728,Owned: Total,98,80,73,10,63,6,1,18,12,3,1,2,0
S01007728,Owned: Owned outright,28,16,14,4,10,2,0,12,11,0,0,1,0
S01007728,Owned: Owned with a mortgage or loan or shared ownership,70,64,59,6,53,4,1,6,1,3,1,1,0
S01007728,Rented or living rent free: Total,316,210,157,45,112,11,42,106,24,22,12,30,18
S01007728,Rented or living rent free: Social rented,104,59,41,12,29,2,16,45,10,6,4,14,11
S01007728,Rented or living rent free: Private rented or living rent free,212,151,116,33,83,9,26,61,14,16,8,16,7
S01007729,All HRPs aged 16 and over,439,334,255,60,195,25,54,105,34,23,9,28,11
S01007729,Owned: Total,117,95,78,11,67,11,6,22,12,4,1,5,0
S01007729,Owned: Owned outright,49,33,27,5,22,1,5,16,9,2,1,4,0
S01007729,Owned: Owned with a mortgage or loan or shared ownership,68,62,51,6,45,10,1,6,3,2,0,1,0
S01007729,Rented or living rent free: Total,322,239,177,49,128,14,48,83,22,19,8,23,11
S01007729,Rented or living rent free: Social rented,90,61,44,12,32,3,14,29,12,0,2,9,6
S01007729,Rented or living rent free: Private rented or living rent free,232,178,133,37,96,11,34,54,10,19,6,14,5
S01007730,All HRPs aged 16 and over,464,337,282,56,226,24,31,127,38,37,6,32,14
S01007730,Owned: Total,142,105,90,8,82,13,2,37,23,9,1,2,2
S01007730,Owned: Owned outright,44,16,13,2,11,3,0,28,21,3,1,2,1
S01007730,Owned: Owned with a mortgage or loan or shared ownership,98,89,77,6,71,10,2,9,2,6,0,0,1
S01007730,Rented or living rent free: Total,322,232,192,48,144,11,29,90,15,28,5,30,12
S01007730,Rented or living rent free: Social rented,54,29,19,2,17,1,9,25,3,12,0,9,1
S01007730,Rented or living rent free: Private rented or living rent free,268,203,173,46,127,10,20,65,12,16,5,21,11
S01007731,All HRPs aged 16 and over,396,315,277,52,225,16,22,81,44,7,3,21,6
S01007731,Owned: Total,121,98,89,7,82,6,3,23,18,0,0,4,1
S01007731,Owned: Owned outright,33,14,10,1,9,2,2,19,17,0,0,2,0
S01007731,Owned: Owned with a mortgage or loan or shared ownership,88,84,79,6,73,4,1,4,1,0,0,2,1
S01007731,Rented or living rent free: Total,275,217,188,45,143,10,19,58,26,7,3,17,5
S01007731,Rented or living rent free: Social rented,105,75,67,18,49,2,6,30,18,0,2,9,1
S01007731,Rented or living rent free: Private rented or living rent free,170,142,121,27,94,8,13,28,8,7,1,8,4
S01007732,All HRPs aged 16 and over,374,255,210,41,169,12,33,119,64,19,6,22,8
S01007732,Owned: Total,126,99,93,9,84,3,3,27,22,2,2,1,0
S01007732,Owned: Owned outright,31,14,13,2,11,0,1,17,17,0,0,0,0
S01007732,Owned: Owned with a mortgage or loan or shared ownership,95,85,80,7,73,3,2,10,5,2,2,1,0
S01007732,Rented or living rent free: Total,248,156,117,32,85,9,30,92,42,17,4,21,8
S01007732,Rented or living rent free: Social rented,93,37,24,3,21,3,10,56,33,1,2,17,3
S01007732,Rented or living rent free: Private rented or living rent free,155,119,93,29,64,6,20,36,9,16,2,4,5
S01007733,All HRPs aged 16 and over,338,248,201,28,173,38,9,90,66,5,6,10,3
S01007733,Owned: Total,271,203,166,24,142,35,2,68,60,0,1,4,3
S01007733,Owned: Owned outright,111,53,39,12,27,12,2,58,54,0,0,2,2
S01007733,Owned: Owned with a mortgage or loan or shared ownership,160,150,127,12,115,23,0,10,6,0,1,2,1
S01007733,Rented or living rent free: Total,67,45,35,4,31,3,7,22,6,5,5,6,0
S01007733,Rented or living rent free: Social rented,3,1,1,0,1,0,0,2,0,0,0,2,0
S01007733,Rented or living rent free: Private rented or living rent free,64,44,34,4,30,3,7,20,6,5,5,4,0
S01007734,All HRPs aged 16 and over,384,230,180,26,154,42,8,154,138,2,2,9,3
S01007734,Owned: Total,306,176,137,18,119,38,1,130,120,2,0,6,2
S01007734,Owned: Owned outright,176,60,46,10,36,14,0,116,109,2,0,5,0
S01007734,Owned: Owned with a mortgage or loan or shared ownership,130,116,91,8,83,24,1,14,11,0,0,1,2
S01007734,Rented or living rent free: Total,78,54,43,8,35,4,7,24,18,0,2,3,1
S01007734,Rented or living rent free: Social rented,26,15,9,2,7,1,5,11,8,0,0,2,1
S01007734,Rented or living rent free: Private rented or living rent free,52,39,34,6,28,3,2,13,10,0,2,1,0
S01007735,All HRPs aged 16 and over,359,233,189,20,169,35,9,126,113,1,4,3,5
S01007735,Owned: Total,300,189,156,16,140,31,2,111,107,0,0,1,3
S01007735,Owned: Owned outright,166,64,49,12,37,14,1,102,99,0,0,1,2
S01007735,Owned: Owned with a mortgage or loan or shared ownership,134,125,107,4,103,17,1,9,8,0,0,0,1
S01007735,Rented or living rent free: Total,59,44,33,4,29,4,7,15,6,1,4,2,2
S01007735,Rented or living rent free: Social rented,21,13,8,0,8,2,3,8,3,0,2,2,1
S01007735,Rented or living rent free: Private rented or living rent free,38,31,25,4,21,2,4,7,3,1,2,0,1
S01007736,All HRPs aged 16 and over,309,214,170,32,138,39,5,95,85,1,1,6,2
S01007736,Owned: Total,246,167,128,24,104,39,0,79,77,0,0,1,1
S01007736,Owned: Owned outright,122,45,32,12,20,13,0,77,75,0,0,1,1
S01007736,Owned: Owned with a mortgage or loan or shared ownership,124,122,96,12,84,26,0,2,2,0,0,0,0
S01007736,Rented or living rent free: Total,63,47,42,8,34,0,5,16,8,1,1,5,1
S01007736,Rented or living rent free: Social rented,15,7,6,2,4,0,1,8,3,0,1,3,1
S01007736,Rented or living rent free: Private rented or living rent free,48,40,36,6,30,0,4,8,5,1,0,2,0
S01007737,All HRPs aged 16 and over,554,332,271,74,197,40,21,222,190,6,5,16,5
S01007737,Owned: Total,272,165,128,20,108,31,6,107,104,1,0,2,0
S01007737,Owned: Owned outright,133,42,28,9,19,10,4,91,88,1,0,2,0
S01007737,Owned: Owned with a mortgage or loan or shared ownership,139,123,100,11,89,21,2,16,16,0,0,0,0
S01007737,Rented or living rent free: Total,282,167,143,54,89,9,15,115,86,5,5,14,5
S01007737,Rented or living rent free: Social rented,147,79,68,28,40,4,7,68,53,1,4,7,3
S01007737,Rented or living rent free: Private rented or living rent free,135,88,75,26,49,5,8,47,33,4,1,7,2
S01007738,All HRPs aged 16 and over,358,194,165,34,131,16,13,164,143,1,6,9,5
S01007738,Owned: Total,269,144,125,24,101,13,6,125,122,0,2,1,0
S01007738,Owned: Owned outright,174,56,49,12,37,3,4,118,115,0,2,1,0
S01007738,Owned: Owned with a mortgage or loan or shared ownership,95,88,76,12,64,10,2,7,7,0,0,0,0
S01007738,Rented or living rent free: Total,89,50,40,10,30,3,7,39,21,1,4,8,5
S01007738,Rented or living rent free: Social rented,58,27,21,6,15,2,4,31,18,0,2,6,5
S01007738,Rented or living rent free: Private rented or living rent free,31,23,19,4,15,1,3,8,3,1,2,2,0
S01007739,All HRPs aged 16 and over,347,136,115,22,93,14,7,211,185,1,2,19,4
S01007739,Owned: Total,166,91,82,12,70,8,1,75,68,1,0,6,0
S01007739,Owned: Owned outright,87,24,19,4,15,4,1,63,57,0,0,6,0
S01007739,Owned: Owned with a mortgage or loan or shared ownership,79,67,63,8,55,4,0,12,11,1,0,0,0
S01007739,Rented or living rent free: Total,181,45,33,10,23,6,6,136,117,0,2,13,4
S01007739,Rented or living rent free: Social rented,159,27,20,7,13,4,3,132,114,0,2,12,4
S01007739,Rented or living rent free: Private rented or living rent free,22,18,13,3,10,2,3,4,3,0,0,1,0
S01007740,All HRPs aged 16 and over,265,155,136,25,111,13,6,110,82,9,6,12,1
S01007740,Owned: Total,202,122,108,17,91,13,1,80,74,3,0,3,0
S01007740,Owned: Owned outright,108,35,32,11,21,3,0,73,70,1,0,2,0
S01007740,Owned: Owned with a mortgage or loan or shared ownership,94,87,76,6,70,10,1,7,4,2,0,1,0
S01007740,Rented or living rent free: Total,63,33,28,8,20,0,5,30,8,6,6,9,1
S01007740,Rented or living rent free: Social rented,27,9,6,1,5,0,3,18,6,3,1,7,1
S01007740,Rented or living rent free: Private rented or living rent free,36,24,22,7,15,0,2,12,2,3,5,2,0
S01007741,All HRPs aged 16 and over,435,185,156,36,120,11,18,250,217,3,2,23,5
S01007741,Owned: Total,195,113,101,22,79,9,3,82,77,0,1,2,2
S01007741,Owned: Owned outright,102,28,22,7,15,5,1,74,72,0,1,0,1
S01007741,Owned: Owned with a mortgage or loan or shared ownership,93,85,79,15,64,4,2,8,5,0,0,2,1
S01007741,Rented or living rent free: Total,240,72,55,14,41,2,15,168,140,3,1,21,3
S01007741,Rented or living rent free: Social rented,203,45,32,5,27,0,13,158,135,0,0,20,3
S01007741,Rented or living rent free: Private rented or living rent free,37,27,23,9,14,2,2,10,5,3,1,1,0
S01007742,All HRPs aged 16 and over,328,175,151,29,122,17,7,153,125,1,3,19,5
S01007742,Owned: Total,206,110,97,12,85,12,1,96,85,1,1,8,1
S01007742,Owned: Owned outright,121,37,31,3,28,6,0,84,77,0,1,5,1
S01007742,Owned: Owned with a mortgage or loan or shared ownership,85,73,66,9,57,6,1,12,8,1,0,3,0
S01007742,Rented or living rent free: Total,122,65,54,17,37,5,6,57,40,0,2,11,4
S01007742,Rented or living rent free: Social rented,85,35,29,8,21,2,4,50,37,0,2,10,1
S01007742,Rented or living rent free: Private rented or living rent free,37,30,25,9,16,3,2,7,3,0,0,1,3
S01007743,All HRPs aged 16 and over,457,289,230,50,180,21,38,168,99,4,12,36,17
S01007743,Owned: Total,214,153,133,20,113,16,4,61,55,1,0,4,1
S01007743,Owned: Owned outright,78,33,25,7,18,6,2,45,43,0,0,2,0
S01007743,Owned: Owned with a mortgage or loan or shared ownership,136,120,108,13,95,10,2,16,12,1,0,2,1
S01007743,Rented or living rent free: Total,243,136,97,30,67,5,34,107,44,3,12,32,16
S01007743,Rented or living rent free: Social rented,188,94,60,11,49,3,31,94,40,3,6,29,16
S01007743,Rented or living rent free: Private rented or living rent free,55,42,37,19,18,2,3,13,4,0,6,3,0
S01007744,All HRPs aged 16 and over,403,199,155,41,114,11,33,204,134,2,17,42,9
S01007744,Owned: Total,128,84,75,14,61,8,1,44,41,0,0,2,1
S01007744,Owned: Owned outright,50,11,10,7,3,1,0,39,36,0,0,2,1
S01007744,Owned: Owned with a mortgage or loan or shared ownership,78,73,65,7,58,7,1,5,5,0,0,0,0
S01007744,Rented or living rent free: Total,275,115,80,27,53,3,32,160,93,2,17,40,8
S01007744,Rented or living rent free: Social rented,243,96,66,23,43,2,28,147,89,0,13,37,8
S01007744,Rented or living rent free: Private rented or living rent free,32,19,14,4,10,1,4,13,4,2,4,3,0
S01007745,All HRPs aged 16 and over,378,229,184,49,135,22,23,149,104,1,8,30,6
S01007745,Owned: Total,174,120,104,18,86,15,1,54,45,0,0,7,2
S01007745,Owned: Owned outright,68,25,22,7,15,3,0,43,36,0,0,6,1
S01007745,Owned: Owned with a mortgage or loan or shared ownership,106,95,82,11,71,12,1,11,9,0,0,1,1
S01007745,Rented or living rent free: Total,204,109,80,31,49,7,22,95,59,1,8,23,4
S01007745,Rented or living rent free: Social rented,163,75,53,19,34,3,19,88,57,1,4,22,4
S01007745,Rented or living rent free: Private rented or living rent free,41,34,27,12,15,4,3,7,2,0,4,1,0
S01007746,All HRPs aged 16 and over,409,273,222,63,159,21,30,136,82,1,13,29,11
S01007746,Owned: Total,207,146,131,20,111,12,3,61,52,0,0,6,3
S01007746,Owned: Owned outright,71,28,24,5,19,2,2,43,37,0,0,6,0
S01007746,Owned: Owned with a mortgage or loan or shared ownership,136,118,107,15,92,10,1,18,15,0,0,0,3
S01007746,Rented or living rent free: Total,202,127,91,43,48,9,27,75,30,1,13,23,8
S01007746,Rented or living rent free: Social rented,181,108,73,30,43,9,26,73,29,0,13,23,8
S01007746,Rented or living rent free: Private rented or living rent free,21,19,18,13,5,0,1,2,1,1,0,0,0
S01007747,All HRPs aged 16 and over,242,147,113,28,85,12,22,95,60,0,10,18,7
S01007747,Owned: Total,121,74,64,5,59,6,4,47,45,0,0,1,1
S01007747,Owned: Owned outright,57,17,14,3,11,1,2,40,38,0,0,1,1
S01007747,Owned: Owned with a mortgage or loan or shared ownership,64,57,50,2,48,5,2,7,7,0,0,0,0
S01007747,Rented or living rent free: Total,121,73,49,23,26,6,18,48,15,0,10,17,6
S01007747,Rented or living rent free: Social rented,88,49,34,19,15,4,11,39,14,0,8,13,4
S01007747,Rented or living rent free: Private rented or living rent free,33,24,15,4,11,2,7,9,1,0,2,4,2
S01007748,All HRPs aged 16 and over,369,210,162,51,111,11,37,159,74,0,29,42,14
S01007748,Owned: Total,93,63,55,5,50,7,1,30,25,0,0,4,1
S01007748,Owned: Owned outright,36,13,12,1,11,1,0,23,21,0,0,2,0
S01007748,Owned: Owned with a mortgage or loan or shared ownership,57,50,43,4,39,6,1,7,4,0,0,2,1
S01007748,Rented or living rent free: Total,276,147,107,46,61,4,36,129,49,0,29,38,13
S01007748,Rented or living rent free: Social rented,257,132,94,41,53,4,34,125,48,0,28,36,13
S01007748,Rented or living rent free: Private rented or living rent free,19,15,13,5,8,0,2,4,1,0,1,2,0
S01007749,All HRPs aged 16 and over,281,185,155,23,132,23,7,96,89,1,2,3,1
S01007749,Owned: Total,260,172,149,21,128,21,2,88,86,1,0,0,1
S01007749,Owned: Owned outright,133,55,46,14,32,8,1,78,77,0,0,0,1
S01007749,Owned: Owned with a mortgage or loan or shared ownership,127,117,103,7,96,13,1,10,9,1,0,0,0
S01007749,Rented or living rent free: Total,21,13,6,2,4,2,5,8,3,0,2,3,0
S01007749,Rented or living rent free: Social rented,5,0,0,0,0,0,0,5,2,0,2,1,0
S01007749,Rented or living rent free: Private rented or living rent free,16,13,6,2,4,2,5,3,1,0,0,2,0
S01007750,All HRPs aged 16 and over,358,184,146,24,122,34,4,174,168,1,1,4,0
S01007750,Owned: Total,337,167,133,18,115,32,2,170,167,0,0,3,0
S01007750,Owned: Owned outright,216,57,47,12,35,10,0,159,158,0,0,1,0
S01007750,Owned: Owned with a mortgage or loan or shared ownership,121,110,86,6,80,22,2,11,9,0,0,2,0
S01007750,Rented or living rent free: Total,21,17,13,6,7,2,2,4,1,1,1,1,0
S01007750,Rented or living rent free: Social rented,5,2,2,2,0,0,0,3,1,0,1,1,0
S01007750,Rented or living rent free: Private rented or living rent free,16,15,11,4,7,2,2,1,0,1,0,0,0
S01007751,All HRPs aged 16 and over,337,162,119,17,102,39,4,175,168,1,4,1,1
S01007751,Owned: Total,308,144,101,14,87,39,4,164,161,1,1,0,1
S01007751,Owned: Owned outright,212,57,36,11,25,18,3,155,153,1,0,0,1
S01007751,Owned: Owned with a mortgage or loan or shared ownership,96,87,65,3,62,21,1,9,8,0,1,0,0
S01007751,Rented or living rent free: Total,29,18,18,3,15,0,0,11,7,0,3,1,0
S01007751,Rented or living rent free: Social rented,0,0,0,0,0,0,0,0,0,0,0,0,0
S01007751,Rented or living rent free: Private rented or living rent free,29,18,18,3,15,0,0,11,7,0,3,1,0
S01007752,All HRPs aged 16 and over,356,149,120,20,100,27,2,207,203,1,0,2,1
S01007752,Owned: Total,290,128,102,17,85,24,2,162,160,1,0,1,0
S01007752,Owned: Owned outright,171,47,36,13,23,10,1,124,123,0,0,1,0
S01007752,Owned: Owned with a mortgage or loan or shared ownership,119,81,66,4,62,14,1,38,37,1,0,0,0
S01007752,Rented or living rent free: Total,66,21,18,3,15,3,0,45,43,0,0,1,1
S01007752,Rented or living rent free: Social rented,40,3,3,0,3,0,0,37,36,0,0,0,1
S01007752,Rented or living rent free: Private rented or living rent free,26,18,15,3,12,3,0,8,7,0,0,1,0
S01007753,All HRPs aged 16 and over,241,140,115,32,83,13,12,101,62,1,12,21,5
S01007753,Owned: Total,120,78,69,14,55,8,1,42,37,0,0,4,1
S01007753,Owned: Owned outright,46,17,14,7,7,3,0,29,27,0,0,2,0
S01007753,Owned: Owned with a mortgage or loan or shared ownership,74,61,55,7,48,5,1,13,10,0,0,2,1
S01007753,Rented or living rent free: Total,121,62,46,18,28,5,11,59,25,1,12,17,4
S01007753,Rented or living rent free: Social rented,102,51,36,12,24,4,11,51,23,1,9,17,1
S01007753,Rented or living rent free: Private rented or living rent free,19,11,10,6,4,1,0,8,2,0,3,0,3
S01007754,All HRPs aged 16 and over,414,215,171,47,124,13,31,199,121,2,20,41,15
S01007754,Owned: Total,185,119,108,19,89,8,3,66,60,0,1,5,0
S01007754,Owned: Owned outright,88,28,27,11,16,0,1,60,55,0,1,4,0
S01007754,Owned: Owned with a mortgage or loan or shared ownership,97,91,81,8,73,8,2,6,5,0,0,1,0
S01007754,Rented or living rent free: Total,229,96,63,28,35,5,28,133,61,2,19,36,15
S01007754,Rented or living rent free: Social rented,208,83,55,25,30,3,25,125,56,2,19,33,15
S01007754,Rented or living rent free: Private rented or living rent free,21,13,8,3,5,2,3,8,5,0,0,3,0
S01007755,All HRPs aged 16 and over,417,208,164,52,112,13,31,209,142,4,25,24,14
S01007755,Owned: Total,166,104,94,16,78,8,2,62,60,0,0,1,1
S01007755,Owned: Owned outright,81,28,24,8,16,3,1,53,51,0,0,1,1
S01007755,Owned: Owned with a mortgage or loan or shared ownership,85,76,70,8,62,5,1,9,9,0,0,0,0
S01007755,Rented or living rent free: Total,251,104,70,36,34,5,29,147,82,4,25,23,13
S01007755,Rented or living rent free: Social rented,223,85,59,30,29,3,23,138,81,4,21,22,10
S01007755,Rented or living rent free: Private rented or living rent free,28,19,11,6,5,2,6,9,1,0,4,1,3
S01007756,All HRPs aged 16 and over,298,158,132,43,89,14,12,140,101,1,9,24,5
S01007756,Owned: Total,145,83,74,12,62,8,1,62,56,0,2,2,2
S01007756,Owned: Owned outright,69,22,21,3,18,0,1,47,44,0,1,0,2
S01007756,Owned: Owned with a mortgage or loan or shared ownership,76,61,53,9,44,8,0,15,12,0,1,2,0
S01007756,Rented or living rent free: Total,153,75,58,31,27,6,11,78,45,1,7,22,3
S01007756,Rented or living rent free: Social rented,124,53,40,20,20,3,10,71,44,1,5,18,3
S01007756,Rented or living rent free: Private rented or living rent free,29,22,18,11,7,3,1,7,1,0,2,4,0
S01007757,All HRPs aged 16 and over,371,182,151,18,133,29,2,189,178,1,5,2,3
S01007757,Owned: Total,350,167,141,15,126,25,1,183,173,1,5,1,3
S01007757,Owned: Owned outright,224,59,49,11,38,9,1,165,159,1,3,1,1
S01007757,Owned: Owned with a mortgage or loan or shared ownership,126,108,92,4,88,16,0,18,14,0,2,0,2
S01007757,Rented or living rent free: Total,21,15,10,3,7,4,1,6,5,0,0,1,0
S01007757,Rented or living rent free: Social rented,2,2,2,0,2,0,0,0,0,0,0,0,0
S01007757,Rented or living rent free: Private rented or living rent free,19,13,8,3,5,4,1,6,5,0,0,1,0
S01007758,All HRPs aged 16 and over,468,230,174,27,147,51,5,238,227,5,0,2,4
S01007758,Owned: Total,384,180,132,21,111,46,2,204,201,1,0,1,1
S01007758,Owned: Owned outright,260,71,49,10,39,20,2,189,188,0,0,1,0
S01007758,Owned: Owned with a mortgage or loan or shared ownership,124,109,83,11,72,26,0,15,13,1,0,0,1
S01007758,Rented or living rent free: Total,84,50,42,6,36,5,3,34,26,4,0,1,3
S01007758,Rented or living rent free: Social rented,8,5,5,3,2,0,0,3,2,0,0,1,0
S01007758,Rented or living rent free: Private rented or living rent free,76,45,37,3,34,5,3,31,24,4,0,0,3
S01007759,All HRPs aged 16 and over,618,356,294,55,239,40,22,262,204,7,3,36,12
S01007759,Owned: Total,250,155,135,22,113,18,2,95,85,1,0,6,3
S01007759,Owned: Owned outright,133,53,44,14,30,8,1,80,75,0,0,3,2
S01007759,Owned: Owned with a mortgage or loan or shared ownership,117,102,91,8,83,10,1,15,10,1,0,3,1
S01007759,Rented or living rent free: Total,368,201,159,33,126,22,20,167,119,6,3,30,9
S01007759,Rented or living rent free: Social rented,110,36,27,4,23,6,3,74,57,2,2,10,3
S01007759,Rented or living rent free: Private rented or living rent free,258,165,132,29,103,16,17,93,62,4,1,20,6
S01007760,All HRPs aged 16 and over,262,147,110,11,99,35,2,115,111,1,2,0,1
S01007760,Owned: Total,239,131,96,11,85,33,2,108,107,0,0,0,1
S01007760,Owned: Owned outright,152,52,36,6,30,15,1,100,100,0,0,0,0
S01007760,Owned: Owned with a mortgage or loan or shared ownership,87,79,60,5,55,18,1,8,7,0,0,0,1
S01007760,Rented or living rent free: Total,23,16,14,0,14,2,0,7,4,1,2,0,0
S01007760,Rented or living rent free: Social rented,3,2,2,0,2,0,0,1,0,1,0,0,0
S01007760,Rented or living rent free: Private rented or living rent free,20,14,12,0,12,2,0,6,4,0,2,0,0
S01007761,All HRPs aged 16 and over,383,257,196,25,171,52,9,126,123,1,0,1,1
S01007761,Owned: Total,324,208,158,18,140,45,5,116,116,0,0,0,0
S01007761,Owned: Owned outright,181,72,53,10,43,14,5,109,109,0,0,0,0
S01007761,Owned: Owned with a mortgage or loan or shared ownership,143,136,105,8,97,31,0,7,7,0,0,0,0
S01007761,Rented or living rent free: Total,59,49,38,7,31,7,4,10,7,1,0,1,1
S01007761,Rented or living rent free: Social rented,5,2,2,0,2,0,0,3,2,0,0,0,1
S01007761,Rented or living rent free: Private rented or living rent free,54,47,36,7,29,7,4,7,5,1,0,1,0
S01007762,All HRPs aged 16 and over,474,270,231,37,194,26,13,204,179,1,1,13,10
S01007762,Owned: Total,265,137,116,18,98,20,1,128,123,0,0,3,2
S01007762,Owned: Owned outright,162,49,41,12,29,7,1,113,112,0,0,0,1
S01007762,Owned: Owned with a mortgage or loan or shared ownership,103,88,75,6,69,13,0,15,11,0,0,3,1
S01007762,Rented or living rent free: Total,209,133,115,19,96,6,12,76,56,1,1,10,8
S01007762,Rented or living rent free: Social rented,23,4,3,2,1,0,1,19,15,1,0,2,1
S01007762,Rented or living rent free: Private rented or living rent free,186,129,112,17,95,6,11,57,41,0,1,8,7
S01007763,All HRPs aged 16 and over,329,115,93,16,77,17,5,214,196,0,1,15,2
S01007763,Owned: Total,123,71,59,5,54,11,1,52,49,0,0,2,1
S01007763,Owned: Owned outright,57,9,5,2,3,4,0,48,46,0,0,1,1
S01007763,Owned: Owned with a mortgage or loan or shared ownership,66,62,54,3,51,7,1,4,3,0,0,1,0
S01007763,Rented or living rent free: Total,206,44,34,11,23,6,4,162,147,0,1,13,1
S01007763,Rented or living rent free: Social rented,184,28,22,7,15,4,2,156,146,0,0,10,0
S01007763,Rented or living rent free: Private rented or living rent free,22,16,12,4,8,2,2,6,1,0,1,3,1
S01007764,All HRPs aged 16 and over,310,220,182,22,160,37,1,90,85,1,0,4,0
S01007764,Owned: Total,288,205,172,19,153,32,1,83,80,0,0,3,0
S01007764,Owned: Owned outright,145,72,59,15,44,13,0,73,72,0,0,1,0
S01007764,Owned: Owned with a mortgage or loan or shared ownership,143,133,113,4,109,19,1,10,8,0,0,2,0
S01007764,Rented or living rent free: Total,22,15,10,3,7,5,0,7,5,1,0,1,0
S01007764,Rented or living rent free: Social rented,4,2,2,1,1,0,0,2,1,0,0,1,0
S01007764,Rented or living rent free: Private rented or living rent free,18,13,8,2,6,5,0,5,4,1,0,0,0
S01007765,All HRPs aged 16 and over,308,165,144,16,128,15,6,143,136,1,0,5,1
S01007765,Owned: Total,288,153,133,12,121,15,5,135,131,0,0,3,1
S01007765,Owned: Owned outright,172,46,38,8,30,6,2,126,124,0,0,1,1
S01007765,Owned: Owned with a mortgage or loan or shared ownership,116,107,95,4,91,9,3,9,7,0,0,2,0
S01007765,Rented or living rent free: Total,20,12,11,4,7,0,1,8,5,1,0,2,0
S01007765,Rented or living rent free: Social rented,2,0,0,0,0,0,0,2,2,0,0,0,0
S01007765,Rented or living rent free: Private rented or living rent free,18,12,11,4,7,0,1,6,3,1,0,2,0
S01007766,All HRPs aged 16 and over,382,213,194,32,162,19,0,169,161,3,1,2,2
S01007766,Owned: Total,361,200,181,28,153,19,0,161,155,2,0,2,2
S01007766,Owned: Owned outright,202,55,46,17,29,9,0,147,143,1,0,1,2
S01007766,Owned: Owned with a mortgage or loan or shared ownership,159,145,135,11,124,10,0,14,12,1,0,1,0
S01007766,Rented or living rent free: Total,21,13,13,4,9,0,0,8,6,1,1,0,0
S01007766,Rented or living rent free: Social rented,5,3,3,1,2,0,0,2,2,0,0,0,0
S01007766,Rented or living rent free: Private rented or living rent free,16,10,10,3,7,0,0,6,4,1,1,0,0
S01007767,All HRPs aged 16 and over,398,236,199,29,170,35,2,162,156,1,0,4,1
S01007767,Owned: Total,369,216,182,26,156,33,1,153,150,1,0,1,1
S01007767,Owned: Owned outright,208,67,57,17,40,9,1,141,139,0,0,1,1
S01007767,Owned: Owned with a mortgage or loan or shared ownership,161,149,125,9,116,24,0,12,11,1,0,0,0
S01007767,Rented or living rent free: Total,29,20,17,3,14,2,1,9,6,0,0,3,0
S01007767,Rented or living rent free: Social rented,1,0,0,0,0,0,0,1,0,0,0,1,0
S01007767,Rented or living rent free: Private rented or living rent free,28,20,17,3,14,2,1,8,6,0,0,2,0
S01007768,All HRPs aged 16 and over,356,192,157,20,137,26,9,164,142,2,2,13,5
S01007768,Owned: Total,229,127,101,12,89,24,2,102,93,0,1,4,4
S01007768,Owned: Owned outright,127,36,27,6,21,8,1,91,86,0,1,2,2
S01007768,Owned: Owned with a mortgage or loan or shared ownership,102,91,74,6,68,16,1,11,7,0,0,2,2
S01007768,Rented or living rent free: Total,127,65,56,8,48,2,7,62,49,2,1,9,1
S01007768,Rented or living rent free: Social rented,51,8,5,0,5,0,3,43,39,1,0,2,1
S01007768,Rented or living rent free: Private rented or living rent free,76,57,51,8,43,2,4,19,10,1,1,7,0
S01007769,All HRPs aged 16 and over,325,183,137,21,116,39,7,142,132,1,6,2,1
S01007769,Owned: Total,287,160,119,19,100,38,3,127,121,0,5,0,1
S01007769,Owned: Owned outright,171,60,42,11,31,15,3,111,105,0,5,0,1
S01007769,Owned: Owned with a mortgage or loan or shared ownership,116,100,77,8,69,23,0,16,16,0,0,0,0
S01007769,Rented or living rent free: Total,38,23,18,2,16,1,4,15,11,1,1,2,0
S01007769,Rented or living rent free: Social rented,14,4,4,2,2,0,0,10,7,0,1,2,0
S01007769,Rented or living rent free: Private rented or living rent free,24,19,14,0,14,1,4,5,4,1,0,0,0
S01007770,All HRPs aged 16 and over,318,199,159,25,134,40,0,119,114,2,0,2,1
S01007770,Owned: Total,276,166,131,16,115,35,0,110,110,0,0,0,0
S01007770,Owned: Owned outright,164,59,42,11,31,17,0,105,105,0,0,0,0
S01007770,Owned: Owned with a mortgage or loan or shared ownership,112,107,89,5,84,18,0,5,5,0,0,0,0
S01007770,Rented or living rent free: Total,42,33,28,9,19,5,0,9,4,2,0,2,1
S01007770,Rented or living rent free: Social rented,4,2,1,1,0,1,0,2,0,0,0,1,1
S01007770,Rented or living rent free: Private rented or living rent free,38,31,27,8,19,4,0,7,4,2,0,1,0
S01007771,All HRPs aged 16 and over,235,114,91,11,80,19,4,121,118,0,2,1,0
S01007771,Owned: Total,226,107,88,10,78,17,2,119,117,0,1,1,0
S01007771,Owned: Owned outright,140,35,27,6,21,7,1,105,105,0,0,0,0
S01007771,Owned: Owned with a mortgage or loan or shared ownership,86,72,61,4,57,10,1,14,12,0,1,1,0
S01007771,Rented or living rent free: Total,9,7,3,1,2,2,2,2,1,0,1,0,0
S01007771,Rented or living rent free: Social rented,0,0,0,0,0,0,0,0,0,0,0,0,0
S01007771,Rented or living rent free: Private rented or living rent free,9,7,3,1,2,2,2,2,1,0,1,0,0
S01007772,All HRPs aged 16 and over,546,286,243,46,197,24,19,260,196,6,2,51,5
S01007772,Owned: Total,276,151,129,14,115,18,4,125,118,0,0,7,0
S01007772,Owned: Owned outright,141,33,29,7,22,4,0,108,104,0,0,4,0
S01007772,Owned: Owned with a mortgage or loan or shared ownership,135,118,100,7,93,14,4,17,14,0,0,3,0
S01007772,Rented or living rent free: Total,270,135,114,32,82,6,15,135,78,6,2,44,5
S01007772,Rented or living rent free: Social rented,172,65,54,17,37,2,9,107,61,5,1,35,5
S01007772,Rented or living rent free: Private rented or living rent free,98,70,60,15,45,4,6,28,17,1,1,9,0
S01007773,All HRPs aged 16 and over,314,199,170,21,149,27,2,115,113,0,0,1,1
S01007773,Owned: Total,304,192,166,20,146,26,0,112,110,0,0,1,1
S01007773,Owned: Owned outright,166,65,56,14,42,9,0,101,99,0,0,1,1
S01007773,Owned: Owned with a mortgage or loan or shared ownership,138,127,110,6,104,17,0,11,11,0,0,0,0
S01007773,Rented or living rent free: Total,10,7,4,1,3,1,2,3,3,0,0,0,0
S01007773,Rented or living rent free: Social rented,3,1,1,0,1,0,0,2,2,0,0,0,0
S01007773,Rented or living rent free: Private rented or living rent free,7,6,3,1,2,1,2,1,1,0,0,0,0
S01007774,All HRPs aged 16 and over,323,301,262,19,243,37,2,22,18,2,1,1,0
S01007774,Owned: Total,298,281,245,17,228,35,1,17,15,1,1,0,0
S01007774,Owned: Owned outright,40,27,20,4,16,7,0,13,13,0,0,0,0
S01007774,Owned: Owned with a mortgage or loan or shared ownership,258,254,225,13,212,28,1,4,2,1,1,0,0
S01007774,Rented or living rent free: Total,25,20,17,2,15,2,1,5,3,1,0,1,0
S01007774,Rented or living rent free: Social rented,5,4,3,0,3,1,0,1,1,0,0,0,0
S01007774,Rented or living rent free: Private rented or living rent free,20,16,14,2,12,1,1,4,2,1,0,1,0
S01007775,All HRPs aged 16 and over,346,268,235,29,206,26,7,78,74,1,0,1,2
S01007775,Owned: Total,314,242,213,21,192,23,6,72,71,1,0,0,0
S01007775,Owned: Owned outright,119,55,47,12,35,3,5,64,64,0,0,0,0
S01007775,Owned: Owned with a mortgage or loan or shared ownership,195,187,166,9,157,20,1,8,7,1,0,0,0
S01007775,Rented or living rent free: Total,32,26,22,8,14,3,1,6,3,0,0,1,2
S01007775,Rented or living rent free: Social rented,2,1,1,1,0,0,0,1,0,0,0,1,0
S01007775,Rented or living rent free: Private rented or living rent free,30,25,21,7,14,3,1,5,3,0,0,0,2
S01007776,All HRPs aged 16 and over,282,222,183,22,161,32,7,60,56,0,1,2,1
S01007776,Owned: Total,239,182,150,14,136,28,4,57,55,0,0,1,1
S01007776,Owned: Owned outright,92,39,32,4,28,6,1,53,51,0,0,1,1
S01007776,Owned: Owned with a mortgage or loan or shared ownership,147,143,118,10,108,22,3,4,4,0,0,0,0
S01007776,Rented or living rent free: Total,43,40,33,8,25,4,3,3,1,0,1,1,0
S01007776,Rented or living rent free: Social rented,1,0,0,0,0,0,0,1,0,0,1,0,0
S01007776,Rented or living rent free: Private rented or living rent free,42,40,33,8,25,4,3,2,1,0,0,1,0
S01007777,All HRPs aged 16 and over,314,292,247,14,233,44,1,22,19,1,1,1,0
S01007777,Owned: Total,291,272,234,9,225,38,0,19,16,1,1,1,0
S01007777,Owned: Owned outright,40,26,20,1,19,6,0,14,12,0,1,1,0
S01007777,Owned: Owned with a mortgage or loan or shared ownership,251,246,214,8,206,32,0,5,4,1,0,0,0
S01007777,Rented or living rent free: Total,23,20,13,5,8,6,1,3,3,0,0,0,0
S01007777,Rented or living rent free: Social rented,1,0,0,0,0,0,0,1,1,0,0,0,0
S01007777,Rented or living rent free: Private rented or living rent free,22,20,13,5,8,6,1,2,2,0,0,0,0
S01007778,All HRPs aged 16 and over,155,141,110,6,104,30,1,14,14,0,0,0,0
S01007778,Owned: Total,144,133,103,6,97,29,1,11,11,0,0,0,0
S01007778,Owned: Owned outright,30,22,14,3,11,8,0,8,8,0,0,0,0
S01007778,Owned: Owned with a mortgage or loan or shared ownership,114,111,89,3,86,21,1,3,3,0,0,0,0
S01007778,Rented or living rent free: Total,11,8,7,0,7,1,0,3,3,0,0,0,0
S01007778,Rented or living rent free: Social rented,1,1,1,0,1,0,0,0,0,0,0,0,0
S01007778,Rented or living rent free: Private rented or living rent free,10,7,6,0,6,1,0,3,3,0,0,0,0
S01007779,All HRPs aged 16 and over,311,232,202,27,175,26,4,79,66,3,3,6,1
S01007779,Owned: Total,269,209,181,23,158,25,3,60,59,0,0,1,0
S01007779,Owned: Owned outright,95,43,34,10,24,9,0,52,52,0,0,0,0
S01007779,Owned: Owned with a mortgage or loan or shared ownership,174,166,147,13,134,16,3,8,7,0,0,1,0
S01007779,Rented or living rent free: Total,42,23,21,4,17,1,1,19,7,3,3,5,1
S01007779,Rented or living rent free: Social rented,17,5,4,1,3,1,0,12,6,0,2,3,1
S01007779,Rented or living rent free: Private rented or living rent free,25,18,17,3,14,0,1,7,1,3,1,2,0
S01007780,All HRPs aged 16 and over,331,281,248,26,222,28,5,50,46,0,0,3,1
S01007780,Owned: Total,296,251,221,19,202,26,4,45,43,0,0,2,0
S01007780,Owned: Owned outright,82,43,38,9,29,3,2,39,37,0,0,2,0
S01007780,Owned: Owned with a mortgage or loan or shared ownership,214,208,183,10,173,23,2,6,6,0,0,0,0
S01007780,Rented or living rent free: Total,35,30,27,7,20,2,1,5,3,0,0,1,1
S01007780,Rented or living rent free: Social rented,7,4,4,1,3,0,0,3,2,0,0,1,0
S01007780,Rented or living rent free: Private rented or living rent free,28,26,23,6,17,2,1,2,1,0,0,0,1
S01007781,All HRPs aged 16 and over,381,307,274,30,244,23,10,74,59,0,7,6,2
S01007781,Owned: Total,289,244,227,18,209,14,3,45,43,0,1,0,1
S01007781,Owned: Owned outright,66,26,25,4,21,0,1,40,39,0,0,0,1
S01007781,Owned: Owned with a mortgage or loan or shared ownership,223,218,202,14,188,14,2,5,4,0,1,0,0
S01007781,Rented or living rent free: Total,92,63,47,12,35,9,7,29,16,0,6,6,1
S01007781,Rented or living rent free: Social rented,62,37,29,11,18,4,4,25,13,0,5,6,1
S01007781,Rented or living rent free: Private rented or living rent free,30,26,18,1,17,5,3,4,3,0,1,0,0
S01007782,All HRPs aged 16 and over,239,153,109,24,85,16,28,86,32,6,14,25,9
S01007782,Owned: Total,99,76,64,9,55,9,3,23,18,2,1,2,0
S01007782,Owned: Owned outright,39,24,19,6,13,3,2,15,14,0,1,0,0
S01007782,Owned: Owned with a mortgage or loan or shared ownership,60,52,45,3,42,6,1,8,4,2,0,2,0
S01007782,Rented or living rent free: Total,140,77,45,15,30,7,25,63,14,4,13,23,9
S01007782,Rented or living rent free: Social rented,69,31,18,7,11,2,11,38,13,0,6,14,5
S01007782,Rented or living rent free: Private rented or living rent free,71,46,27,8,19,5,14,25,1,4,7,9,4
S01007783,All HRPs aged 16 and over,405,188,138,52,86,10,40,217,139,4,24,44,6
S01007783,Owned: Total,115,60,54,17,37,4,2,55,55,0,0,0,0
S01007783,Owned: Owned outright,74,25,23,10,13,1,1,49,49,0,0,0,0
S01007783,Owned: Owned with a mortgage or loan or shared ownership,41,35,31,7,24,3,1,6,6,0,0,0,0
S01007783,Rented or living rent free: Total,290,128,84,35,49,6,38,162,84,4,24,44,6
S01007783,Rented or living rent free: Social rented,276,120,79,32,47,4,37,156,80,4,22,44,6
S01007783,Rented or living rent free: Private rented or living rent free,14,8,5,3,2,2,1,6,4,0,2,0,0
S01007784,All HRPs aged 16 and over,276,233,195,37,158,16,22,43,21,3,12,2,5
S01007784,Owned: Total,178,161,143,16,127,14,4,17,14,0,2,0,1
S01007784,Owned: Owned outright,29,18,14,2,12,2,2,11,11,0,0,0,0
S01007784,Owned: Owned with a mortgage or loan or shared ownership,149,143,129,14,115,12,2,6,3,0,2,0,1
S01007784,Rented or living rent free: Total,98,72,52,21,31,2,18,26,7,3,10,2,4
S01007784,Rented or living rent free: Social rented,65,48,34,14,20,1,13,17,4,2,9,0,2
S01007784,Rented or living rent free: Private rented or living rent free,33,24,18,7,11,1,5,9,3,1,1,2,2
S01007785,All HRPs aged 16 and over,276,150,116,37,79,6,28,126,69,6,22,20,9
S01007785,Owned: Total,52,36,33,4,29,3,0,16,15,0,0,1,0
S01007785,Owned: Owned outright,18,7,7,1,6,0,0,11,11,0,0,0,0
S01007785,Owned: Owned with a mortgage or loan or shared ownership,34,29,26,3,23,3,0,5,4,0,0,1,0
S01007785,Rented or living rent free: Total,224,114,83,33,50,3,28,110,54,6,22,19,9
S01007785,Rented or living rent free: Social rented,213,104,79,32,47,3,22,109,54,6,21,19,9
S01007785,Rented or living rent free: Private rented or living rent free,11,10,4,1,3,0,6,1,0,0,1,0,0
S01007786,All HRPs aged 16 and over,333,198,171,53,118,18,9,135,105,0,12,13,5
S01007786,Owned: Total,209,130,115,22,93,12,3,79,70,0,1,6,2
S01007786,Owned: Owned outright,123,52,44,10,34,6,2,71,63,0,0,6,2
S01007786,Owned: Owned with a mortgage or loan or shared ownership,86,78,71,12,59,6,1,8,7,0,1,0,0
S01007786,Rented or living rent free: Total,124,68,56,31,25,6,6,56,35,0,11,7,3
S01007786,Rented or living rent free: Social rented,86,39,32,17,15,5,2,47,31,0,7,6,3
S01007786,Rented or living rent free: Private rented or living rent free,38,29,24,14,10,1,4,9,4,0,4,1,0
S01007787,All HRPs aged 16 and over,277,178,143,41,102,17,18,99,70,2,7,14,6
S01007787,Owned: Total,160,106,91,16,75,12,3,54,47,0,0,6,1
S01007787,Owned: Owned outright,72,25,22,7,15,3,0,47,41,0,0,5,1
S01007787,Owned: Owned with a mortgage or loan or shared ownership,88,81,69,9,60,9,3,7,6,0,0,1,0
S01007787,Rented or living rent free: Total,117,72,52,25,27,5,15,45,23,2,7,8,5
S01007787,Rented or living rent free: Social rented,87,54,37,19,18,4,13,33,21,1,2,6,3
S01007787,Rented or living rent free: Private rented or living rent free,30,18,15,6,9,1,2,12,2,1,5,2,2
S01007788,All HRPs aged 16 and over,268,162,111,43,68,11,40,106,33,2,24,39,8
S01007788,Owned: Total,9,6,3,0,3,3,0,3,2,0,0,1,0
S01007788,Owned: Owned outright,3,1,0,0,0,1,0,2,2,0,0,0,0
S01007788,Owned: Owned with a mortgage or loan or shared ownership,6,5,3,0,3,2,0,1,0,0,0,1,0
S01007788,Rented or living rent free: Total,259,156,108,43,65,8,40,103,31,2,24,38,8
S01007788,Rented or living rent free: Social rented,256,154,106,43,63,8,40,102,31,2,24,38,7
S01007788,Rented or living rent free: Private rented or living rent free,3,2,2,0,2,0,0,1,0,0,0,0,1
S01007789,All HRPs aged 16 and over,231,147,120,45,75,12,15,84,16,2,15,47,4
S01007789,Owned: Total,28,24,19,0,19,4,1,4,1,0,0,2,1
S01007789,Owned: Owned outright,2,1,0,0,0,1,0,1,1,0,0,0,0
S01007789,Owned: Owned with a mortgage or loan or shared ownership,26,23,19,0,19,3,1,3,0,0,0,2,1
S01007789,Rented or living rent free: Total,203,123,101,45,56,8,14,80,15,2,15,45,3
S01007789,Rented or living rent free: Social rented,196,116,99,45,54,5,12,80,15,2,15,45,3
S01007789,Rented or living rent free: Private rented or living rent free,7,7,2,0,2,3,2,0,0,0,0,0,0
S01007790,All HRPs aged 16 and over,330,215,176,61,115,5,34,115,22,2,35,43,13
S01007790,Owned: Total,35,27,26,1,25,0,1,8,5,0,0,2,1
S01007790,Owned: Owned outright,11,5,5,0,5,0,0,6,4,0,0,1,1
S01007790,Owned: Owned with a mortgage or loan or shared ownership,24,22,21,1,20,0,1,2,1,0,0,1,0
S01007790,Rented or living rent free: Total,295,188,150,60,90,5,33,107,17,2,35,41,12
S01007790,Rented or living rent free: Social rented,284,184,146,59,87,5,33,100,16,1,32,39,12
S01007790,Rented or living rent free: Private rented or living rent free,11,4,4,1,3,0,0,7,1,1,3,2,0
S01007791,All HRPs aged 16 and over,174,150,127,14,113,22,1,24,18,1,1,2,2
S01007791,Owned: Total,155,138,118,10,108,20,0,17,14,0,1,2,0
S01007791,Owned: Owned outright,30,14,13,2,11,1,0,16,13,0,1,2,0
S01007791,Owned: Owned with a mortgage or loan or shared ownership,125,124,105,8,97,19,0,1,1,0,0,0,0
S01007791,Rented or living rent free: Total,19,12,9,4,5,2,1,7,4,1,0,0,2
S01007791,Rented or living rent free: Social rented,6,4,2,1,1,2,0,2,2,0,0,0,0
S01007791,Rented or living rent free: Private rented or living rent free,13,8,7,3,4,0,1,5,2,1,0,0,2
S01007792,All HRPs aged 16 and over,384,227,194,41,153,15,18,157,108,2,10,30,7
S01007792,Owned: Total,254,158,142,23,119,13,3,96,83,1,2,7,3
S01007792,Owned: Owned outright,118,38,36,7,29,1,1,80,73,1,1,5,0
S01007792,Owned: Owned with a mortgage or loan or shared ownership,136,120,106,16,90,12,2,16,10,0,1,2,3
S01007792,Rented or living rent free: Total,130,69,52,18,34,2,15,61,25,1,8,23,4
S01007792,Rented or living rent free: Social rented,107,53,39,13,26,2,12,54,23,1,5,21,4
S01007792,Rented or living rent free: Private rented or living rent free,23,16,13,5,8,0,3,7,2,0,3,2,0
S01007793,All HRPs aged 16 and over,457,228,174,58,116,16,38,229,151,3,22,43,10
S01007793,Owned: Total,136,86,72,11,61,11,3,50,41,2,0,6,1
S01007793,Owned: Owned outright,58,20,17,4,13,3,0,38,36,1,0,1,0
S01007793,Owned: Owned with a mortgage or loan or shared ownership,78,66,55,7,48,8,3,12,5,1,0,5,1
S01007793,Rented or living rent free: Total,321,142,102,47,55,5,35,179,110,1,22,37,9
S01007793,Rented or living rent free: Social rented,289,116,82,39,43,2,32,173,107,0,22,35,9
S01007793,Rented or living rent free: Private rented or living rent free,32,26,20,8,12,3,3,6,3,1,0,2,0
S01007794,All HRPs aged 16 and over,234,146,126,30,96,10,10,88,66,1,10,8,3
S01007794,Owned: Total,166,111,97,15,82,9,5,55,47,1,3,4,0
S01007794,Owned: Owned outright,73,27,22,9,13,4,1,46,41,0,2,3,0
S01007794,Owned: Owned with a mortgage or loan or shared ownership,93,84,75,6,69,5,4,9,6,1,1,1,0
S01007794,Rented or living rent free: Total,68,35,29,15,14,1,5,33,19,0,7,4,3
S01007794,Rented or living rent free: Social rented,51,25,21,11,10,1,3,26,17,0,5,3,1
S01007794,Rented or living rent free: Private rented or living rent free,17,10,8,4,4,0,2,7,2,0,2,1,2
S01007795,All HRPs aged 16 and over,243,162,150,51,99,8,4,81,57,2,12,10,0
S01007795,Owned: Total,159,110,105,32,73,4,1,49,46,0,0,3,0
S01007795,Owned: Owned outright,77,38,35,13,22,3,0,39,37,0,0,2,0
S01007795,Owned: Owned with a mortgage or loan or shared ownership,82,72,70,19,51,1,1,10,9,0,0,1,0
S01007795,Rented or living rent free: Total,84,52,45,19,26,4,3,32,11,2,12,7,0
S01007795,Rented or living rent free: Social rented,56,35,31,14,17,1,3,21,10,0,6,5,0
S01007795,Rented or living rent free: Private rented or living rent free,28,17,14,5,9,3,0,11,1,2,6,2,0
S01007796,All HRPs aged 16 and over,311,188,157,48,109,11,20,123,68,11,16,26,2
S01007796,Owned: Total,150,112,104,18,86,8,0,38,34,1,0,2,1
S01007796,Owned: Owned outright,49,16,14,4,10,2,0,33,30,1,0,1,1
S01007796,Owned: Owned with a mortgage or loan or shared ownership,101,96,90,14,76,6,0,5,4,0,0,1,0
S01007796,Rented or living rent free: Total,161,76,53,30,23,3,20,85,34,10,16,24,1
S01007796,Rented or living rent free: Social rented,129,59,42,23,19,3,14,70,31,9,9,20,1
S01007796,Rented or living rent free: Private rented or living rent free,32,17,11,7,4,0,6,15,3,1,7,4,0
S01007797,All HRPs aged 16 and over,258,138,109,39,70,9,20,120,68,1,12,30,9
S01007797,Owned: Total,96,60,55,12,43,5,0,36,32,1,1,1,1
S01007797,Owned: Owned outright,42,15,13,5,8,2,0,27,26,1,0,0,0
S01007797,Owned: Owned with a mortgage or loan or shared ownership,54,45,42,7,35,3,0,9,6,0,1,1,1
S01007797,Rented or living rent free: Total,162,78,54,27,27,4,20,84,36,0,11,29,8
S01007797,Rented or living rent free: Social rented,145,69,46,24,22,4,19,76,36,0,10,22,8
S01007797,Rented or living rent free: Private rented or living rent free,17,9,8,3,5,0,1,8,0,0,1,7,0
S01007798,All HRPs aged 16 and over,226,186,155,22,133,26,5,40,21,1,5,6,7
S01007798,Owned: Total,184,156,129,14,115,23,4,28,19,0,3,2,4
S01007798,Owned: Owned outright,42,24,19,4,15,4,1,18,16,0,1,0,1
S01007798,Owned: Owned with a mortgage or loan or shared ownership,142,132,110,10,100,19,3,10,3,0,2,2,3
S01007798,Rented or living rent free: Total,42,30,26,8,18,3,1,12,2,1,2,4,3
S01007798,Rented or living rent free: Social rented,7,4,3,0,3,1,0,3,1,0,1,1,0
S01007798,Rented or living rent free: Private rented or living rent free,35,26,23,8,15,2,1,9,1,1,1,3,3
S01007799,All HRPs aged 16 and over,193,183,150,15,135,29,4,10,7,0,1,2,0
S01007799,Owned: Total,175,168,138,12,126,28,2,7,7,0,0,0,0
S01007799,Owned: Owned outright,23,17,14,5,9,3,0,6,6,0,0,0,0
S01007799,Owned: Owned with a mortgage or loan or shared ownership,152,151,124,7,117,25,2,1,1,0,0,0,0
S01007799,Rented or living rent free: Total,18,15,12,3,9,1,2,3,0,0,1,2,0
S01007799,Rented or living rent free: Social rented,7,5,4,1,3,0,1,2,0,0,1,1,0
S01007799,Rented or living rent free: Private rented or living rent free,11,10,8,2,6,1,1,1,0,0,0,1,0
S01007800,All HRPs aged 16 and over,365,217,178,66,112,14,25,148,76,2,23,40,7
S01007800,Owned: Total,146,103,94,18,76,8,1,43,35,0,1,6,1
S01007800,Owned: Owned outright,60,25,22,6,16,3,0,35,28,0,1,5,1
S01007800,Owned: Owned with a mortgage or loan or shared ownership,86,78,72,12,60,5,1,8,7,0,0,1,0
S01007800,Rented or living rent free: Total,219,114,84,48,36,6,24,105,41,2,22,34,6
S01007800,Rented or living rent free: Social rented,188,93,67,37,30,5,21,95,41,1,17,31,5
S01007800,Rented or living rent free: Private rented or living rent free,31,21,17,11,6,1,3,10,0,1,5,3,1
S01007801,All HRPs aged 16 and over,388,192,149,41,108,7,36,196,97,5,17,70,7
S01007801,Owned: Total,95,65,59,12,47,6,0,30,23,0,2,4,1
S01007801,Owned: Owned outright,45,20,18,6,12,2,0,25,21,0,2,1,1
S01007801,Owned: Owned with a mortgage or loan or shared ownership,50,45,41,6,35,4,0,5,2,0,0,3,0
S01007801,Rented or living rent free: Total,293,127,90,29,61,1,36,166,74,5,15,66,6
S01007801,Rented or living rent free: Social rented,266,113,79,25,54,1,33,153,69,5,12,61,6
S01007801,Rented or living rent free: Private rented or living rent free,27,14,11,4,7,0,3,13,5,0,3,5,0
S01007802,All HRPs aged 16 and over,199,184,160,17,143,18,6,15,7,0,0,5,3
S01007802,Owned: Total,173,166,149,15,134,15,2,7,5,0,0,0,2
S01007802,Owned: Owned outright,21,17,15,5,10,2,0,4,3,0,0,0,1
S01007802,Owned: Owned with a mortgage or loan or shared ownership,152,149,134,10,124,13,2,3,2,0,0,0,1
S01007802,Rented or living rent free: Total,26,18,11,2,9,3,4,8,2,0,0,5,1
S01007802,Rented or living rent free: Social rented,10,5,2,1,1,0,3,5,1,0,0,3,1
S01007802,Rented or living rent free: Private rented or living rent free,16,13,9,1,8,3,1,3,1,0,0,2,0
S01007803,All HRPs aged 16 and over,524,251,186,60,126,13,52,273,139,15,39,69,11
S01007803,Owned: Total,114,72,60,9,51,7,5,42,38,0,1,3,0
S01007803,Owned: Owned outright,53,20,16,5,11,2,2,33,32,0,0,1,0
S01007803,Owned: Owned with a mortgage or loan or shared ownership,61,52,44,4,40,5,3,9,6,0,1,2,0
S01007803,Rented or living rent free: Total,410,179,126,51,75,6,47,231,101,15,38,66,11
S01007803,Rented or living rent free: Social rented,384,167,118,50,68,6,43,217,99,10,32,65,11
S01007803,Rented or living rent free: Private rented or living rent free,26,12,8,1,7,0,4,14,2,5,6,1,0
S01007804,All HRPs aged 16 and over,259,145,122,45,77,10,13,114,44,4,20,37,9
S01007804,Owned: Total,47,41,38,6,32,3,0,6,4,0,0,1,1
S01007804,Owned: Owned outright,12,8,8,4,4,0,0,4,3,0,0,0,1
S01007804,Owned: Owned with a mortgage or loan or shared ownership,35,33,30,2,28,3,0,2,1,0,0,1,0
S01007804,Rented or living rent free: Total,212,104,84,39,45,7,13,108,40,4,20,36,8
S01007804,Rented or living rent free: Social rented,192,91,71,33,38,7,13,101,36,4,19,34,8
S01007804,Rented or living rent free: Private rented or living rent free,20,13,13,6,7,0,0,7,4,0,1,2,0
S01007805,All HRPs aged 16 and over,207,138,114,38,76,8,16,69,22,1,18,23,5
S01007805,Owned: Total,82,72,63,10,53,5,4,10,7,0,0,3,0
S01007805,Owned: Owned outright,22,16,15,5,10,0,1,6,5,0,0,1,0
S01007805,Owned: Owned with a mortgage or loan or shared ownership,60,56,48,5,43,5,3,4,2,0,0,2,0
S01007805,Rented or living rent free: Total,125,66,51,28,23,3,12,59,15,1,18,20,5
S01007805,Rented or living rent free: Social rented,105,49,38,23,15,3,8,56,15,0,17,19,5
S01007805,Rented or living rent free: Private rented or living rent free,20,17,13,5,8,0,4,3,0,1,1,1,0
S01007806,All HRPs aged 16 and over,296,172,148,35,113,13,11,124,90,1,7,22,4
S01007806,Owned: Total,163,105,96,16,80,9,0,58,54,0,0,4,0
S01007806,Owned: Owned outright,71,19,18,4,14,1,0,52,50,0,0,2,0
S01007806,Owned: Owned with a mortgage or loan or shared ownership,92,86,78,12,66,8,0,6,4,0,0,2,0
S01007806,Rented or living rent free: Total,133,67,52,19,33,4,11,66,36,1,7,18,4
S01007806,Rented or living rent free: Social rented,115,57,43,15,28,3,11,58,33,1,4,17,3
S01007806,Rented or living rent free: Private rented or living rent free,18,10,9,4,5,1,0,8,3,0,3,1,1
S01007807,All HRPs aged 16 and over,258,199,172,21,151,22,5,59,50,0,2,7,0
S01007807,Owned: Total,224,178,156,16,140,21,1,46,41,0,1,4,0
S01007807,Owned: Owned outright,65,29,26,4,22,3,0,36,34,0,1,1,0
S01007807,Owned: Owned with a mortgage or loan or shared ownership,159,149,130,12,118,18,1,10,7,0,0,3,0
S01007807,Rented or living rent free: Total,34,21,16,5,11,1,4,13,9,0,1,3,0
S01007807,Rented or living rent free: Social rented,20,9,5,0,5,1,3,11,7,0,1,3,0
S01007807,Rented or living rent free: Private rented or living rent free,14,12,11,5,6,0,1,2,2,0,0,0,0
S01007808,All HRPs aged 16 and over,304,217,193,44,149,20,4,87,42,3,13,26,3
S01007808,Owned: Total,191,158,141,19,122,15,2,33,28,1,0,3,1
S01007808,Owned: Owned outright,42,20,13,1,12,6,1,22,19,0,0,2,1
S01007808,Owned: Owned with a mortgage or loan or shared ownership,149,138,128,18,110,9,1,11,9,1,0,1,0
S01007808,Rented or living rent free: Total,113,59,52,25,27,5,2,54,14,2,13,23,2
S01007808,Rented or living rent free: Social rented,88,39,35,19,16,3,1,49,13,2,10,22,2
S01007808,Rented or living rent free: Private rented or living rent free,25,20,17,6,11,2,1,5,1,0,3,1,0
S01007809,All HRPs aged 16 and over,398,240,210,31,179,30,0,158,148,0,4,3,3
S01007809,Owned: Total,370,228,199,25,174,29,0,142,137,0,0,2,3
S01007809,Owned: Owned outright,201,67,60,14,46,7,0,134,131,0,0,1,2
S01007809,Owned: Owned with a mortgage or loan or shared ownership,169,161,139,11,128,22,0,8,6,0,0,1,1
S01007809,Rented or living rent free: Total,28,12,11,6,5,1,0,16,11,0,4,1,0
S01007809,Rented or living rent free: Social rented,12,2,1,1,0,1,0,10,9,0,1,0,0
S01007809,Rented or living rent free: Private rented or living rent free,16,10,10,5,5,0,0,6,2,0,3,1,0
S01007810,All HRPs aged 16 and over,369,190,162,36,126,15,13,179,114,1,19,40,5
S01007810,Owned: Total,168,119,104,13,91,13,2,49,43,0,2,3,1
S01007810,Owned: Owned outright,62,22,18,5,13,3,1,40,37,0,0,2,1
S01007810,Owned: Owned with a mortgage or loan or shared ownership,106,97,86,8,78,10,1,9,6,0,2,1,0
S01007810,Rented or living rent free: Total,201,71,58,23,35,2,11,130,71,1,17,37,4
S01007810,Rented or living rent free: Social rented,180,61,50,20,30,2,9,119,68,0,12,36,3
S01007810,Rented or living rent free: Private rented or living rent free,21,10,8,3,5,0,2,11,3,1,5,1,1
S01007811,All HRPs aged 16 and over,325,210,187,47,140,9,14,115,65,3,22,21,4
S01007811,Owned: Total,186,140,131,24,107,6,3,46,40,0,1,5,0
S01007811,Owned: Owned outright,68,33,29,9,20,2,2,35,32,0,0,3,0
S01007811,Owned: Owned with a mortgage or loan or shared ownership,118,107,102,15,87,4,1,11,8,0,1,2,0
S01007811,Rented or living rent free: Total,139,70,56,23,33,3,11,69,25,3,21,16,4
S01007811,Rented or living rent free: Social rented,130,63,51,22,29,2,10,67,25,3,19,16,4
S01007811,Rented or living rent free: Private rented or living rent free,9,7,5,1,4,1,1,2,0,0,2,0,0
S01007812,All HRPs aged 16 and over,328,209,151,45,106,20,38,119,33,3,25,45,13
S01007812,Owned: Total,80,65,55,13,42,9,1,15,11,0,0,4,0
S01007812,Owned: Owned outright,22,12,9,4,5,3,0,10,9,0,0,1,0
S01007812,Owned: Owned with a mortgage or loan or shared ownership,58,53,46,9,37,6,1,5,2,0,0,3,0
S01007812,Rented or living rent free: Total,248,144,96,32,64,11,37,104,22,3,25,41,13
S01007812,Rented or living rent free: Social rented,230,134,89,29,60,10,35,96,21,3,22,40,10
S01007812,Rented or living rent free: Private rented or living rent free,18,10,7,3,4,1,2,8,1,0,3,1,3
S01007813,All HRPs aged 16 and over,306,188,158,47,111,9,21,118,75,2,21,12,8
S01007813,Owned: Total,128,98,89,15,74,7,2,30,28,0,1,1,0
S01007813,Owned: Owned outright,55,28,25,2,23,3,0,27,25,0,1,1,0
S01007813,Owned: Owned with a mortgage or loan or shared ownership,73,70,64,13,51,4,2,3,3,0,0,0,0
S01007813,Rented or living rent free: Total,178,90,69,32,37,2,19,88,47,2,20,11,8
S01007813,Rented or living rent free: Social rented,154,76,61,29,32,1,14,78,45,0,16,11,6
S01007813,Rented or living rent free: Private rented or living rent free,24,14,8,3,5,1,5,10,2,2,4,0,2
S01007814,All HRPs aged 16 and over,229,129,112,19,93,16,1,100,75,2,9,13,1
S01007814,Owned: Total,168,100,89,10,79,11,0,68,61,1,0,6,0
S01007814,Owned: Owned outright,73,21,19,4,15,2,0,52,48,0,0,4,0
S01007814,Owned: Owned with a mortgage or loan or shared ownership,95,79,70,6,64,9,0,16,13,1,0,2,0
S01007814,Rented or living rent free: Total,61,29,23,9,14,5,1,32,14,1,9,7,1
S01007814,Rented or living rent free: Social rented,43,19,15,7,8,3,1,24,12,1,6,4,1
S01007814,Rented or living rent free: Private rented or living rent free,18,10,8,2,6,2,0,8,2,0,3,3,0
S01007815,All HRPs aged 16 and over,343,232,204,22,182,26,2,111,103,1,1,2,4
S01007815,Owned: Total,319,217,194,20,174,23,0,102,96,1,0,1,4
S01007815,Owned: Owned outright,156,61,49,16,33,12,0,95,92,1,0,0,2
S01007815,Owned: Owned with a mortgage or loan or shared ownership,163,156,145,4,141,11,0,7,4,0,0,1,2
S01007815,Rented or living rent free: Total,24,15,10,2,8,3,2,9,7,0,1,1,0
S01007815,Rented or living rent free: Social rented,9,6,3,0,3,2,1,3,1,0,1,1,0
S01007815,Rented or living rent free: Private rented or living rent free,15,9,7,2,5,1,1,6,6,0,0,0,0
S01007816,All HRPs aged 16 and over,273,183,160,25,135,23,0,90,77,2,5,5,1
S01007816,Owned: Total,244,168,147,19,128,21,0,76,74,0,1,0,1
S01007816,Owned: Owned outright,115,46,40,8,32,6,0,69,67,0,1,0,1
S01007816,Owned: Owned with a mortgage or loan or shared ownership,129,122,107,11,96,15,0,7,7,0,0,0,0
S01007816,Rented or living rent free: Total,29,15,13,6,7,2,0,14,3,2,4,5,0
S01007816,Rented or living rent free: Social rented,9,4,2,0,2,2,0,5,2,0,2,1,0
S01007816,Rented or living rent free: Private rented or living rent free,20,11,11,6,5,0,0,9,1,2,2,4,0
S01007817,All HRPs aged 16 and over,207,103,90,19,71,11,2,104,92,1,2,7,2
S01007817,Owned: Total,160,81,71,14,57,10,0,79,73,1,1,3,1
S01007817,Owned: Owned outright,100,32,29,7,22,3,0,68,65,0,0,3,0
S01007817,Owned: Owned with a mortgage or loan or shared ownership,60,49,42,7,35,7,0,11,8,1,1,0,1
S01007817,Rented or living rent free: Total,47,22,19,5,14,1,2,25,19,0,1,4,1
S01007817,Rented or living rent free: Social rented,32,11,9,1,8,1,1,21,16,0,1,3,1
S01007817,Rented or living rent free: Private rented or living rent free,15,11,10,4,6,0,1,4,3,0,0,1,0
S01007818,All HRPs aged 16 and over,314,221,185,19,166,30,6,93,70,1,12,9,1
S01007818,Owned: Total,255,192,165,12,153,26,1,63,60,0,0,2,1
S01007818,Owned: Owned outright,93,39,34,6,28,5,0,54,52,0,0,1,1
S01007818,Owned: Owned with a mortgage or loan or shared ownership,162,153,131,6,125,21,1,9,8,0,0,1,0
S01007818,Rented or living rent free: Total,59,29,20,7,13,4,5,30,10,1,12,7,0
S01007818,Rented or living rent free: Social rented,29,12,8,4,4,2,2,17,5,0,7,5,0
S01007818,Rented or living rent free: Private rented or living rent free,30,17,12,3,9,2,3,13,5,1,5,2,0
S01007819,All HRPs aged 16 and over,353,210,178,29,149,27,5,143,126,0,7,9,1
S01007819,Owned: Total,298,177,151,21,130,23,3,121,116,0,3,2,0
S01007819,Owned: Owned outright,148,40,35,16,19,5,0,108,107,0,1,0,0
S01007819,Owned: Owned with a mortgage or loan or shared ownership,150,137,116,5,111,18,3,13,9,0,2,2,0
S01007819,Rented or living rent free: Total,55,33,27,8,19,4,2,22,10,0,4,7,1
S01007819,Rented or living rent free: Social rented,29,10,8,3,5,1,1,19,9,0,3,7,0
S01007819,Rented or living rent free: Private rented or living rent free,26,23,19,5,14,3,1,3,1,0,1,0,1
S01007820,All HRPs aged 16 and over,408,230,191,35,156,25,14,178,150,1,8,10,9
S01007820,Owned: Total,289,182,153,21,132,23,6,107,102,0,1,2,2
S01007820,Owned: Owned outright,141,52,43,11,32,8,1,89,86,0,1,1,1
S01007820,Owned: Owned with a mortgage or loan or shared ownership,148,130,110,10,100,15,5,18,16,0,0,1,1
S01007820,Rented or living rent free: Total,119,48,38,14,24,2,8,71,48,1,7,8,7
S01007820,Rented or living rent free: Social rented,92,25,18,9,9,1,6,67,45,0,7,8,7
S01007820,Rented or living rent free: Private rented or living rent free,27,23,20,5,15,1,2,4,3,1,0,0,0
S01007821,All HRPs aged 16 and over,244,158,142,28,114,16,0,86,72,1,3,8,2
S01007821,Owned: Total,186,123,111,16,95,12,0,63,61,0,0,2,0
S01007821,Owned: Owned outright,94,39,35,9,26,4,0,55,53,0,0,2,0
S01007821,Owned: Owned with a mortgage or loan or shared ownership,92,84,76,7,69,8,0,8,8,0,0,0,0
S01007821,Rented or living rent free: Total,58,35,31,12,19,4,0,23,11,1,3,6,2
S01007821,Rented or living rent free: Social rented,33,16,15,6,9,1,0,17,7,1,2,6,1
S01007821,Rented or living rent free: Private rented or living rent free,25,19,16,6,10,3,0,6,4,0,1,0,1
S01007822,All HRPs aged 16 and over,349,190,165,19,146,20,5,159,145,1,1,10,2
S01007822,Owned: Total,253,164,146,16,130,16,2,89,86,0,0,2,1
S01007822,Owned: Owned outright,123,47,41,10,31,5,1,76,73,0,0,2,1
S01007822,Owned: Owned with a mortgage or loan or shared ownership,130,117,105,6,99,11,1,13,13,0,0,0,0
S01007822,Rented or living rent free: Total,96,26,19,3,16,4,3,70,59,1,1,8,1
S01007822,Rented or living rent free: Social rented,77,10,6,2,4,2,2,67,57,0,1,8,1
S01007822,Rented or living rent free: Private rented or living rent free,19,16,13,1,12,2,1,3,2,1,0,0,0
S01007823,All HRPs aged 16 and over,306,196,165,18,147,26,5,110,103,0,1,2,4
S01007823,Owned: Total,270,172,148,15,133,22,2,98,95,0,1,1,1
S01007823,Owned: Owned outright,140,51,39,7,32,12,0,89,87,0,1,0,1
S01007823,Owned: Owned with a mortgage or loan or shared ownership,130,121,109,8,101,10,2,9,8,0,0,1,0
S01007823,Rented or living rent free: Total,36,24,17,3,14,4,3,12,8,0,0,1,3
S01007823,Rented or living rent free: Social rented,10,4,2,0,2,0,2,6,3,0,0,1,2
S01007823,Rented or living rent free: Private rented or living rent free,26,20,15,3,12,4,1,6,5,0,0,0,1
S01007824,All HRPs aged 16 and over,342,190,166,28,138,23,1,152,136,1,0,15,0
S01007824,Owned: Total,278,153,131,20,111,22,0,125,124,0,0,1,0
S01007824,Owned: Owned outright,156,46,39,12,27,7,0,110,109,0,0,1,0
S01007824,Owned: Owned with a mortgage or loan or shared ownership,122,107,92,8,84,15,0,15,15,0,0,0,0
S01007824,Rented or living rent free: Total,64,37,35,8,27,1,1,27,12,1,0,14,0
S01007824,Rented or living rent free: Social rented,14,2,2,0,2,0,0,12,1,0,0,11,0
S01007824,Rented or living rent free: Private rented or living rent free,50,35,33,8,25,1,1,15,11,1,0,3,0
S01007825,All HRPs aged 16 and over,482,270,222,32,190,41,7,212,189,3,1,11,8
S01007825,Owned: Total,376,225,184,22,162,37,4,151,149,0,0,1,1
S01007825,Owned: Owned outright,197,59,44,9,35,13,2,138,137,0,0,0,1
S01007825,Owned: Owned with a mortgage or loan or shared ownership,179,166,140,13,127,24,2,13,12,0,0,1,0
S01007825,Rented or living rent free: Total,106,45,38,10,28,4,3,61,40,3,1,10,7
S01007825,Rented or living rent free: Social rented,63,15,13,5,8,2,0,48,34,0,0,9,5
S01007825,Rented or living rent free: Private rented or living rent free,43,30,25,5,20,2,3,13,6,3,1,1,2
S01007826,All HRPs aged 16 and over,260,128,109,30,79,10,9,132,83,2,14,29,4
S01007826,Owned: Total,74,47,38,5,33,8,1,27,21,0,1,5,0
S01007826,Owned: Owned outright,33,14,11,4,7,3,0,19,17,0,0,2,0
S01007826,Owned: Owned with a mortgage or loan or shared ownership,41,33,27,1,26,5,1,8,4,0,1,3,0
S01007826,Rented or living rent free: Total,186,81,71,25,46,2,8,105,62,2,13,24,4
S01007826,Rented or living rent free: Social rented,173,73,63,23,40,2,8,100,61,2,12,21,4
S01007826,Rented or living rent free: Private rented or living rent free,13,8,8,2,6,0,0,5,1,0,1,3,0
S01007827,All HRPs aged 16 and over,291,225,192,24,168,15,18,66,31,5,4,15,11
S01007827,Owned: Total,174,145,129,9,120,12,4,29,22,2,1,3,1
S01007827,Owned: Owned outright,41,27,19,2,17,5,3,14,13,0,0,0,1
S01007827,Owned: Owned with a mortgage or loan or shared ownership,133,118,110,7,103,7,1,15,9,2,1,3,0
S01007827,Rented or living rent free: Total,117,80,63,15,48,3,14,37,9,3,3,12,10
S01007827,Rented or living rent free: Social rented,47,24,15,7,8,0,9,23,8,1,2,7,5
S01007827,Rented or living rent free: Private rented or living rent free,70,56,48,8,40,3,5,14,1,2,1,5,5
S01007828,All HRPs aged 16 and over,592,325,269,51,218,26,30,267,186,7,8,52,14
S01007828,Owned: Total,244,163,145,13,132,15,3,81,74,1,1,1,4
S01007828,Owned: Owned outright,94,26,22,4,18,2,2,68,63,1,0,1,3
S01007828,Owned: Owned with a mortgage or loan or shared ownership,150,137,123,9,114,13,1,13,11,0,1,0,1
S01007828,Rented or living rent free: Total,348,162,124,38,86,11,27,186,112,6,7,51,10
S01007828,Rented or living rent free: Social rented,235,72,52,24,28,3,17,163,107,0,4,44,8
S01007828,Rented or living rent free: Private rented or living rent free,113,90,72,14,58,8,10,23,5,6,3,7,2
S01007829,All HRPs aged 16 and over,348,137,118,27,91,13,6,211,183,4,0,20,4
S01007829,Owned: Total,173,88,78,14,64,10,0,85,79,0,0,5,1
S01007829,Owned: Owned outright,94,26,22,7,15,4,0,68,63,0,0,4,1
S01007829,Owned: Owned with a mortgage or loan or shared ownership,79,62,56,7,49,6,0,17,16,0,0,1,0
S01007829,Rented or living rent free: Total,175,49,40,13,27,3,6,126,104,4,0,15,3
S01007829,Rented or living rent free: Social rented,141,33,27,8,19,1,5,108,92,0,0,13,3
S01007829,Rented or living rent free: Private rented or living rent free,34,16,13,5,8,2,1,18,12,4,0,2,0
S01007830,All HRPs aged 16 and over,545,256,218,46,172,18,20,289,210,15,12,41,11
S01007830,Owned: Total,235,132,117,20,97,12,3,103,98,2,1,1,1
S01007830,Owned: Owned outright,123,32,29,8,21,3,0,91,87,2,1,0,1
S01007830,Owned: Owned with a mortgage or loan or shared ownership,112,100,88,12,76,9,3,12,11,0,0,1,0
S01007830,Rented or living rent free: Total,310,124,101,26,75,6,17,186,112,13,11,40,10
S01007830,Rented or living rent free: Social rented,229,70,55,20,35,4,11,159,108,1,8,32,10
S01007830,Rented or living rent free: Private rented or living rent free,81,54,46,6,40,2,6,27,4,12,3,8,0
S01007831,All HRPs aged 16 and over,501,237,191,48,143,19,27,264,158,19,11,65,11
S01007831,Owned: Total,158,95,86,8,78,5,4,63,54,3,0,4,2
S01007831,Owned: Owned outright,71,18,13,1,12,2,3,53,50,0,0,2,1
S01007831,Owned: Owned with a mortgage or loan or shared ownership,87,77,73,7,66,3,1,10,4,3,0,2,1
S01007831,Rented or living rent free: Total,343,142,105,40,65,14,23,201,104,16,11,61,9
S01007831,Rented or living rent free: Social rented,247,80,60,26,34,8,12,167,97,1,11,49,9
S01007831,Rented or living rent free: Private rented or living rent free,96,62,45,14,31,6,11,34,7,15,0,12,0
S01007832,All HRPs aged 16 and over,362,197,161,33,128,13,23,165,113,10,11,27,4
S01007832,Owned: Total,167,100,89,18,71,8,3,67,58,1,2,5,1
S01007832,Owned: Owned outright,97,34,31,11,20,1,2,63,55,1,1,5,1
S01007832,Owned: Owned with a mortgage or loan or shared ownership,70,66,58,7,51,7,1,4,3,0,1,0,0
S01007832,Rented or living rent free: Total,195,97,72,15,57,5,20,98,55,9,9,22,3
S01007832,Rented or living rent free: Social rented,136,50,34,6,28,3,13,86,53,4,7,19,3
S01007832,Rented or living rent free: Private rented or living rent free,59,47,38,9,29,2,7,12,2,5,2,3,0
S01007833,All HRPs aged 16 and over,479,150,123,24,99,17,10,329,292,11,3,16,7
S01007833,Owned: Total,239,108,89,14,75,15,4,131,127,1,1,1,1
S01007833,Owned: Owned outright,171,55,44,10,34,8,3,116,114,1,1,0,0
S01007833,Owned: Owned with a mortgage or loan or shared ownership,68,53,45,4,41,7,1,15,13,0,0,1,1
S01007833,Rented or living rent free: Total,240,42,34,10,24,2,6,198,165,10,2,15,6
S01007833,Rented or living rent free: Social rented,192,23,19,5,14,1,3,169,155,1,0,9,4
S01007833,Rented or living rent free: Private rented or living rent free,48,19,15,5,10,1,3,29,10,9,2,6,2
S01007834,All HRPs aged 16 and over,416,242,193,40,153,15,34,174,98,16,11,41,8
S01007834,Owned: Total,173,108,96,12,84,8,4,65,56,5,0,3,1
S01007834,Owned: Owned outright,70,21,16,3,13,2,3,49,46,0,0,2,1
S01007834,Owned: Owned with a mortgage or loan or shared ownership,103,87,80,9,71,6,1,16,10,5,0,1,0
S01007834,Rented or living rent free: Total,243,134,97,28,69,7,30,109,42,11,11,38,7
S01007834,Rented or living rent free: Social rented,153,67,45,18,27,5,17,86,39,1,5,36,5
S01007834,Rented or living rent free: Private rented or living rent free,90,67,52,10,42,2,13,23,3,10,6,2,2
S01007835,All HRPs aged 16 and over,325,185,164,33,131,15,6,140,126,1,4,8,1
S01007835,Owned: Total,203,146,132,21,111,13,1,57,56,1,0,0,0
S01007835,Owned: Owned outright,85,35,30,13,17,5,0,50,49,1,0,0,0
S01007835,Owned: Owned with a mortgage or loan or shared ownership,118,111,102,8,94,8,1,7,7,0,0,0,0
S01007835,Rented or living rent free: Total,122,39,32,12,20,2,5,83,70,0,4,8,1
S01007835,Rented or living rent free: Social rented,80,8,5,3,2,1,2,72,65,0,1,5,1
S01007835,Rented or living rent free: Private rented or living rent free,42,31,27,9,18,1,3,11,5,0,3,3,0
S01007836,All HRPs aged 16 and over,285,142,122,17,105,12,8,143,114,4,2,20,3
S01007836,Owned: Total,217,110,94,12,82,11,5,107,101,0,1,4,1
S01007836,Owned: Owned outright,105,32,26,6,20,3,3,73,68,0,1,3,1
S01007836,Owned: Owned with a mortgage or loan or shared ownership,112,78,68,6,62,8,2,34,33,0,0,1,0
S01007836,Rented or living rent free: Total,68,32,28,5,23,1,3,36,13,4,1,16,2
S01007836,Rented or living rent free: Social rented,38,11,10,3,7,0,1,27,9,2,1,14,1
S01007836,Rented or living rent free: Private rented or living rent free,30,21,18,2,16,1,2,9,4,2,0,2,1
S01007837,All HRPs aged 16 and over,357,200,170,27,143,29,1,157,151,3,0,3,0
S01007837,Owned: Total,340,191,161,25,136,29,1,149,146,2,0,1,0
S01007837,Owned: Owned outright,202,69,58,16,42,11,0,133,131,1,0,1,0
S01007837,Owned: Owned with a mortgage or loan or shared ownership,138,122,103,9,94,18,1,16,15,1,0,0,0
S01007837,Rented or living rent free: Total,17,9,9,2,7,0,0,8,5,1,0,2,0
S01007837,Rented or living rent free: Social rented,5,2,2,0,2,0,0,3,1,0,0,2,0
S01007837,Rented or living rent free: Private rented or living rent free,12,7,7,2,5,0,0,5,4,1,0,0,0
S01007838,All HRPs aged 16 and over,392,206,182,21,161,22,2,186,166,6,3,10,1
S01007838,Owned: Total,341,180,164,15,149,15,1,161,156,1,2,2,0
S01007838,Owned: Owned outright,191,46,42,7,35,4,0,145,143,0,1,1,0
S01007838,Owned: Owned with a mortgage or loan or shared ownership,150,134,122,8,114,11,1,16,13,1,1,1,0
S01007838,Rented or living rent free: Total,51,26,18,6,12,7,1,25,10,5,1,8,1
S01007838,Rented or living rent free: Social rented,19,8,6,2,4,2,0,11,4,0,0,6,1
S01007838,Rented or living rent free: Private rented or living rent free,32,18,12,4,8,5,1,14,6,5,1,2,0
S01007839,All HRPs aged 16 and over,281,116,96,13,83,14,6,165,148,6,1,4,6
S01007839,Owned: Total,139,73,60,5,55,12,1,66,62,2,0,0,2
S01007839,Owned: Owned outright,82,20,18,3,15,2,0,62,59,2,0,0,1
S01007839,Owned: Owned with a mortgage or loan or shared ownership,57,53,42,2,40,10,1,4,3,0,0,0,1
S01007839,Rented or living rent free: Total,142,43,36,8,28,2,5,99,86,4,1,4,4
S01007839,Rented or living rent free: Social rented,114,24,19,4,15,2,3,90,82,0,0,4,4
S01007839,Rented or living rent free: Private rented or living rent free,28,19,17,4,13,0,2,9,4,4,1,0,0
S01007840,All HRPs aged 16 and over,425,241,210,46,164,13,18,184,134,12,8,23,7
S01007840,Owned: Total,215,124,113,19,94,5,6,91,77,1,0,9,4
S01007840,Owned: Owned outright,97,19,17,5,12,0,2,78,69,0,0,6,3
S01007840,Owned: Owned with a mortgage or loan or shared ownership,118,105,96,14,82,5,4,13,8,1,0,3,1
S01007840,Rented or living rent free: Total,210,117,97,27,70,8,12,93,57,11,8,14,3
S01007840,Rented or living rent free: Social rented,139,69,55,18,37,6,8,70,50,2,3,13,2
S01007840,Rented or living rent free: Private rented or living rent free,71,48,42,9,33,2,4,23,7,9,5,1,1
S01007841,All HRPs aged 16 and over,341,217,177,41,136,15,25,124,85,5,5,23,6
S01007841,Owned: Total,157,101,90,13,77,9,2,56,54,1,0,0,1
S01007841,Owned: Owned outright,71,22,18,3,15,3,1,49,48,1,0,0,0
S01007841,Owned: Owned with a mortgage or loan or shared ownership,86,79,72,10,62,6,1,7,6,0,0,0,1
S01007841,Rented or living rent free: Total,184,116,87,28,59,6,23,68,31,4,5,23,5
S01007841,Rented or living rent free: Social rented,147,86,61,17,44,5,20,61,29,2,5,21,4
S01007841,Rented or living rent free: Private rented or living rent free,37,30,26,11,15,1,3,7,2,2,0,2,1
S01007842,All HRPs aged 16 and over,391,263,188,63,125,17,58,128,41,6,20,48,13
S01007842,Owned: Total,106,74,63,10,53,9,2,32,28,1,0,2,1
S01007842,Owned: Owned outright,43,16,10,5,5,6,0,27,25,0,0,1,1
S01007842,Owned: Owned with a mortgage or loan or shared ownership,63,58,53,5,48,3,2,5,3,1,0,1,0
S01007842,Rented or living rent free: Total,285,189,125,53,72,8,56,96,13,5,20,46,12
S01007842,Rented or living rent free: Social rented,242,158,100,47,53,8,50,84,12,3,15,45,9
S01007842,Rented or living rent free: Private rented or living rent free,43,31,25,6,19,0,6,12,1,2,5,1,3
S01007843,All HRPs aged 16 and over,354,212,172,35,137,11,29,142,89,7,10,27,9
S01007843,Owned: Total,137,85,76,11,65,5,4,52,46,1,0,2,3
S01007843,Owned: Owned outright,59,14,10,4,6,2,2,45,42,0,0,0,3
S01007843,Owned: Owned with a mortgage or loan or shared ownership,78,71,66,7,59,3,2,7,4,1,0,2,0
S01007843,Rented or living rent free: Total,217,127,96,24,72,6,25,90,43,6,10,25,6
S01007843,Rented or living rent free: Social rented,152,81,55,13,42,4,22,71,42,1,6,20,2
S01007843,Rented or living rent free: Private rented or living rent free,65,46,41,11,30,2,3,19,1,5,4,5,4
S01007844,All HRPs aged 16 and over,520,338,259,58,201,23,56,182,88,19,9,55,11
S01007844,Owned: Total,191,122,110,13,97,9,3,69,56,1,0,8,4
S01007844,Owned: Owned outright,78,21,19,7,12,1,1,57,49,1,0,6,1
S01007844,Owned: Owned with a mortgage or loan or shared ownership,113,101,91,6,85,8,2,12,7,0,0,2,3
S01007844,Rented or living rent free: Total,329,216,149,45,104,14,53,113,32,18,9,47,7
S01007844,Rented or living rent free: Social rented,244,160,100,34,66,11,49,84,27,2,5,43,7
S01007844,Rented or living rent free: Private rented or living rent free,85,56,49,11,38,3,4,29,5,16,4,4,0
S01007845,All HRPs aged 16 and over,427,248,202,65,137,15,31,179,99,0,26,38,16
S01007845,Owned: Total,161,112,101,21,80,10,1,49,45,0,2,1,1
S01007845,Owned: Owned outright,75,34,32,9,23,2,0,41,39,0,1,0,1
S01007845,Owned: Owned with a mortgage or loan or shared ownership,86,78,69,12,57,8,1,8,6,0,1,1,0
S01007845,Rented or living rent free: Total,266,136,101,44,57,5,30,130,54,0,24,37,15
S01007845,Rented or living rent free: Social rented,236,111,78,35,43,5,28,125,53,0,22,36,14
S01007845,Rented or living rent free: Private rented or living rent free,30,25,23,9,14,0,2,5,1,0,2,1,1
S01007846,All HRPs aged 16 and over,337,202,171,38,133,12,19,135,95,2,12,19,7
S01007846,Owned: Total,197,125,112,14,98,10,3,72,64,2,0,2,4
S01007846,Owned: Owned outright,81,23,20,5,15,2,1,58,53,1,0,1,3
S01007846,Owned: Owned with a mortgage or loan or shared ownership,116,102,92,9,83,8,2,14,11,1,0,1,1
S01007846,Rented or living rent free: Total,140,77,59,24,35,2,16,63,31,0,12,17,3
S01007846,Rented or living rent free: Social rented,107,52,38,16,22,1,13,55,27,0,9,16,3
S01007846,Rented or living rent free: Private rented or living rent free,33,25,21,8,13,1,3,8,4,0,3,1,0
S01007847,All HRPs aged 16 and over,437,259,212,61,151,19,28,178,123,4,12,31,8
S01007847,Owned: Total,179,115,101,16,85,12,2,64,62,0,0,1,1
S01007847,Owned: Owned outright,81,29,28,7,21,1,0,52,51,0,0,1,0
S01007847,Owned: Owned with a mortgage or loan or shared ownership,98,86,73,9,64,11,2,12,11,0,0,0,1
S01007847,Rented or living rent free: Total,258,144,111,45,66,7,26,114,61,4,12,30,7
S01007847,Rented or living rent free: Social rented,215,108,82,37,45,5,21,107,56,3,12,30,6
S01007847,Rented or living rent free: Private rented or living rent free,43,36,29,8,21,2,5,7,5,1,0,0,1
S01007848,All HRPs aged 16 and over,447,252,187,47,140,11,54,195,113,4,16,47,15
S01007848,Owned: Total,105,72,59,5,54,6,7,33,26,0,2,4,1
S01007848,Owned: Owned outright,40,15,11,3,8,1,3,25,20,0,2,2,1
S01007848,Owned: Owned with a mortgage or loan or shared ownership,65,57,48,2,46,5,4,8,6,0,0,2,0
S01007848,Rented or living rent free: Total,342,180,128,42,86,5,47,162,87,4,14,43,14
S01007848,Rented or living rent free: Social rented,299,148,98,36,62,4,46,151,83,1,14,41,12
S01007848,Rented or living rent free: Private rented or living rent free,43,32,30,6,24,1,1,11,4,3,0,2,2
S01007849,All HRPs aged 16 and over,413,254,211,54,157,16,27,159,80,11,21,39,8
S01007849,Owned: Total,206,137,124,18,106,11,2,69,56,7,1,4,1
S01007849,Owned: Owned outright,85,29,24,6,18,5,0,56,45,7,0,4,0
S01007849,Owned: Owned with a mortgage or loan or shared ownership,121,108,100,12,88,6,2,13,11,0,1,0,1
S01007849,Rented or living rent free: Total,207,117,87,36,51,5,25,90,24,4,20,35,7
S01007849,Rented or living rent free: Social rented,176,97,70,27,43,3,24,79,21,2,17,32,7
S01007849,Rented or living rent free: Private rented or living rent free,31,20,17,9,8,2,1,11,3,2,3,3,0
S01007850,All HRPs aged 16 and over,293,154,124,29,95,18,12,139,95,1,11,24,8
S01007850,Owned: Total,167,99,85,14,71,10,4,68,62,0,1,4,1
S01007850,Owned: Owned outright,120,55,46,9,37,5,4,65,59,0,1,4,1
S01007850,Owned: Owned with a mortgage or loan or shared ownership,47,44,39,5,34,5,0,3,3,0,0,0,0
S01007850,Rented or living rent free: Total,126,55,39,15,24,8,8,71,33,1,10,20,7
S01007850,Rented or living rent free: Social rented,107,44,31,11,20,7,6,63,30,1,8,18,6
S01007850,Rented or living rent free: Private rented or living rent free,19,11,8,4,4,1,2,8,3,0,2,2,1
S01007851,All HRPs aged 16 and over,479,201,173,28,145,23,5,278,256,1,3,12,6
S01007851,Owned: Total,297,163,142,17,125,18,3,134,128,0,0,4,2
S01007851,Owned: Owned outright,159,40,37,8,29,3,0,119,116,0,0,2,1
S01007851,Owned: Owned with a mortgage or loan or shared ownership,138,123,105,9,96,15,3,15,12,0,0,2,1
S01007851,Rented or living rent free: Total,182,38,31,11,20,5,2,144,128,1,3,8,4
S01007851,Rented or living rent free: Social rented,162,25,20,7,13,4,1,137,125,0,3,6,3
S01007851,Rented or living rent free: Private rented or living rent free,20,13,11,4,7,1,1,7,3,1,0,2,1
S01007852,All HRPs aged 16 and over,356,218,143,42,101,18,57,138,70,3,14,43,8
S01007852,Owned: Total,120,74,60,12,48,13,1,46,39,0,2,2,3
S01007852,Owned: Owned outright,48,14,10,6,4,4,0,34,31,0,0,0,3
S01007852,Owned: Owned with a mortgage or loan or shared ownership,72,60,50,6,44,9,1,12,8,0,2,2,0
S01007852,Rented or living rent free: Total,236,144,83,30,53,5,56,92,31,3,12,41,5
S01007852,Rented or living rent free: Social rented,209,123,65,20,45,4,54,86,30,3,9,39,5
S01007852,Rented or living rent free: Private rented or living rent free,27,21,18,10,8,1,2,6,1,0,3,2,0
S01007853,All HRPs aged 16 and over,413,176,127,33,94,7,42,237,155,8,16,48,10
S01007853,Owned: Total,79,48,42,7,35,6,0,31,30,0,0,0,1
S01007853,Owned: Owned outright,40,13,11,2,9,2,0,27,27,0,0,0,0
S01007853,Owned: Owned with a mortgage or loan or shared ownership,39,35,31,5,26,4,0,4,3,0,0,0,1
S01007853,Rented or living rent free: Total,334,128,85,26,59,1,42,206,125,8,16,48,9
S01007853,Rented or living rent free: Social rented,275,88,55,16,39,1,32,187,115,6,13,44,9
S01007853,Rented or living rent free: Private rented or living rent free,59,40,30,10,20,0,10,19,10,2,3,4,0
S01007854,All HRPs aged 16 and over,548,300,214,51,163,19,67,248,133,8,27,62,18
S01007854,Owned: Total,148,105,87,9,78,15,3,43,34,0,0,5,4
S01007854,Owned: Owned outright,62,27,18,5,13,7,2,35,27,0,0,4,4
S01007854,Owned: Owned with a mortgage or loan or shared ownership,86,78,69,4,65,8,1,8,7,0,0,1,0
S01007854,Rented or living rent free: Total,400,195,127,42,85,4,64,205,99,8,27,57,14
S01007854,Rented or living rent free: Social rented,351,161,104,37,67,3,54,190,94,5,25,56,10
S01007854,Rented or living rent free: Private rented or living rent free,49,34,23,5,18,1,10,15,5,3,2,1,4
S01007855,All HRPs aged 16 and over,310,192,140,43,97,16,36,118,63,5,8,35,7
S01007855,Owned: Total,90,69,59,11,48,8,2,21,20,0,0,0,1
S01007855,Owned: Owned outright,36,15,14,6,8,1,0,21,20,0,0,0,1
S01007855,Owned: Owned with a mortgage or loan or shared ownership,54,54,45,5,40,7,2,0,0,0,0,0,0
S01007855,Rented or living rent free: Total,220,123,81,32,49,8,34,97,43,5,8,35,6
S01007855,Rented or living rent free: Social rented,140,64,38,17,21,4,22,76,34,4,5,27,6
S01007855,Rented or living rent free: Private rented or living rent free,80,59,43,15,28,4,12,21,9,1,3,8,0
S01007856,All HRPs aged 16 and over,348,230,197,47,150,24,9,118,90,1,8,18,1
S01007856,Owned: Total,256,175,150,23,127,23,2,81,74,0,1,5,1
S01007856,Owned: Owned outright,115,48,38,9,29,8,2,67,62,0,1,3,1
S01007856,Owned: Owned with a mortgage or loan or shared ownership,141,127,112,14,98,15,0,14,12,0,0,2,0
S01007856,Rented or living rent free: Total,92,55,47,24,23,1,7,37,16,1,7,13,0
S01007856,Rented or living rent free: Social rented,61,28,24,14,10,0,4,33,15,1,7,10,0
S01007856,Rented or living rent free: Private rented or living rent free,31,27,23,10,13,1,3,4,1,0,0,3,0
S01007857,All HRPs aged 16 and over,233,124,103,36,67,11,10,109,62,5,15,23,4
S01007857,Owned: Total,54,29,25,9,16,4,0,25,25,0,0,0,0
S01007857,Owned: Owned outright,23,2,2,1,1,0,0,21,21,0,0,0,0
S01007857,Owned: Owned with a mortgage or loan or shared ownership,31,27,23,8,15,4,0,4,4,0,0,0,0
S01007857,Rented or living rent free: Total,179,95,78,27,51,7,10,84,37,5,15,23,4
S01007857,Rented or living rent free: Social rented,172,92,75,27,48,7,10,80,36,5,15,20,4
S01007857,Rented or living rent free: Private rented or living rent free,7,3,3,0,3,0,0,4,1,0,0,3,0
S01007858,All HRPs aged 16 and over,533,288,224,71,153,28,36,245,187,0,12,35,11
S01007858,Owned: Total,140,99,79,16,63,15,5,41,38,0,0,3,0
S01007858,Owned: Owned outright,40,15,8,4,4,5,2,25,23,0,0,2,0
S01007858,Owned: Owned with a mortgage or loan or shared ownership,100,84,71,12,59,10,3,16,15,0,0,1,0
S01007858,Rented or living rent free: Total,393,189,145,55,90,13,31,204,149,0,12,32,11
S01007858,Rented or living rent free: Social rented,369,174,131,49,82,12,31,195,141,0,12,31,11
S01007858,Rented or living rent free: Private rented or living rent free,24,15,14,6,8,1,0,9,8,0,0,1,0
S01007859,All HRPs aged 16 and over,246,132,98,30,68,13,21,114,66,1,11,28,8
S01007859,Owned: Total,38,30,24,2,22,6,0,8,6,0,0,2,0
S01007859,Owned: Owned outright,8,4,3,0,3,1,0,4,3,0,0,1,0
S01007859,Owned: Owned with a mortgage or loan or shared ownership,30,26,21,2,19,5,0,4,3,0,0,1,0
S01007859,Rented or living rent free: Total,208,102,74,28,46,7,21,106,60,1,11,26,8
S01007859,Rented or living rent free: Social rented,196,93,66,24,42,6,21,103,59,1,11,25,7
S01007859,Rented or living rent free: Private rented or living rent free,12,9,8,4,4,1,0,3,1,0,0,1,1
S01007860,All HRPs aged 16 and over,237,181,140,28,112,23,18,56,20,0,6,21,9
S01007860,Owned: Total,97,92,72,6,66,18,2,5,4,0,0,1,0
S01007860,Owned: Owned outright,8,7,6,1,5,0,1,1,1,0,0,0,0
S01007860,Owned: Owned with a mortgage or loan or shared ownership,89,85,66,5,61,18,1,4,3,0,0,1,0
S01007860,Rented or living rent free: Total,140,89,68,22,46,5,16,51,16,0,6,20,9
S01007860,Rented or living rent free: Social rented,129,85,64,21,43,5,16,44,12,0,6,18,8
S01007860,Rented or living rent free: Private rented or living rent free,11,4,4,1,3,0,0,7,4,0,0,2,1
S01007861,All HRPs aged 16 and over,254,148,127,32,95,10,11,106,75,3,10,16,2
S01007861,Owned: Total,168,111,102,22,80,7,2,57,51,2,1,2,1
S01007861,Owned: Owned outright,77,28,26,5,21,1,1,49,44,2,0,2,1
S01007861,Owned: Owned with a mortgage or loan or shared ownership,91,83,76,17,59,6,1,8,7,0,1,0,0
S01007861,Rented or living rent free: Total,86,37,25,10,15,3,9,49,24,1,9,14,1
S01007861,Rented or living rent free: Social rented,76,30,22,9,13,3,5,46,24,1,8,12,1
S01007861,Rented or living rent free: Private rented or living rent free,10,7,3,1,2,0,4,3,0,0,1,2,0
S01007862,All HRPs aged 16 and over,308,195,162,50,112,17,16,113,83,2,12,14,2
S01007862,Owned: Total,197,130,110,22,88,16,4,67,62,0,1,3,1
S01007862,Owned: Owned outright,88,29,24,7,17,5,0,59,56,0,0,3,0
S01007862,Owned: Owned with a mortgage or loan or shared ownership,109,101,86,15,71,11,4,8,6,0,1,0,1
S01007862,Rented or living rent free: Total,111,65,52,28,24,1,12,46,21,2,11,11,1
S01007862,Rented or living rent free: Social rented,85,48,38,21,17,1,9,37,19,1,7,10,0
S01007862,Rented or living rent free: Private rented or living rent free,26,17,14,7,7,0,3,9,2,1,4,1,1
S01007863,All HRPs aged 16 and over,441,239,178,45,133,15,46,202,81,8,40,48,25
S01007863,Owned: Total,146,90,79,13,66,7,4,56,52,1,0,2,1
S01007863,Owned: Owned outright,66,18,14,5,9,2,2,48,45,0,0,2,1
S01007863,Owned: Owned with a mortgage or loan or shared ownership,80,72,65,8,57,5,2,8,7,1,0,0,0
S01007863,Rented or living rent free: Total,295,149,99,32,67,8,42,146,29,7,40,46,24
S01007863,Rented or living rent free: Social rented,272,130,86,24,62,8,36,142,29,6,38,45,24
S01007863,Rented or living rent free: Private rented or living rent free,23,19,13,8,5,0,6,4,0,1,2,1,0
S01007864,All HRPs aged 16 and over,486,276,226,55,171,21,29,210,140,2,12,36,20
S01007864,Owned: Total,279,160,142,20,122,13,5,119,105,2,0,5,7
S01007864,Owned: Owned outright,143,45,38,13,25,3,4,98,90,0,0,3,5
S01007864,Owned: Owned with a mortgage or loan or shared ownership,136,115,104,7,97,10,1,21,15,2,0,2,2
S01007864,Rented or living rent free: Total,207,116,84,35,49,8,24,91,35,0,12,31,13
S01007864,Rented or living rent free: Social rented,172,95,67,30,37,6,22,77,31,0,9,29,8
S01007864,Rented or living rent free: Private rented or living rent free,35,21,17,5,12,2,2,14,4,0,3,2,5
S01007865,All HRPs aged 16 and over,229,214,189,17,172,21,4,15,10,0,1,2,2
S01007865,Owned: Total,213,203,183,14,169,18,2,10,10,0,0,0,0
S01007865,Owned: Owned outright,20,11,10,2,8,0,1,9,9,0,0,0,0
S01007865,Owned: Owned with a mortgage or loan or shared ownership,193,192,173,12,161,18,1,1,1,0,0,0,0
S01007865,Rented or living rent free: Total,16,11,6,3,3,3,2,5,0,0,1,2,2
S01007865,Rented or living rent free: Social rented,7,4,2,0,2,1,1,3,0,0,1,2,0
S01007865,Rented or living rent free: Private rented or living rent free,9,7,4,3,1,2,1,2,0,0,0,0,2
S01007866,All HRPs aged 16 and over,209,195,164,7,157,27,4,14,11,0,1,1,1
S01007866,Owned: Total,195,182,159,7,152,22,1,13,11,0,1,0,1
S01007866,Owned: Owned outright,29,18,15,3,12,3,0,11,10,0,1,0,0
S01007866,Owned: Owned with a mortgage or loan or shared ownership,166,164,144,4,140,19,1,2,1,0,0,0,1
S01007866,Rented or living rent free: Total,14,13,5,0,5,5,3,1,0,0,0,1,0
S01007866,Rented or living rent free: Social rented,2,1,0,0,0,0,1,1,0,0,0,1,0
S01007866,Rented or living rent free: Private rented or living rent free,12,12,5,0,5,5,2,0,0,0,0,0,0
S01007867,All HRPs aged 16 and over,195,149,124,14,110,23,2,46,33,3,6,3,1
S01007867,Owned: Total,136,109,91,6,85,18,0,27,26,0,0,0,1
S01007867,Owned: Owned outright,43,19,16,3,13,3,0,24,23,0,0,0,1
S01007867,Owned: Owned with a mortgage or loan or shared ownership,93,90,75,3,72,15,0,3,3,0,0,0,0
S01007867,Rented or living rent free: Total,59,40,33,8,25,5,2,19,7,3,6,3,0
S01007867,Rented or living rent free: Social rented,17,8,7,2,5,0,1,9,4,1,2,2,0
S01007867,Rented or living rent free: Private rented or living rent free,42,32,26,6,20,5,1,10,3,2,4,1,0
S01007868,All HRPs aged 16 and over,351,242,208,26,182,29,5,109,103,2,2,1,1
S01007868,Owned: Total,333,228,199,23,176,27,2,105,102,0,2,0,1
S01007868,Owned: Owned outright,188,88,75,21,54,11,2,100,98,0,1,0,1
S01007868,Owned: Owned with a mortgage or loan or shared ownership,145,140,124,2,122,16,0,5,4,0,1,0,0
S01007868,Rented or living rent free: Total,18,14,9,3,6,2,3,4,1,2,0,1,0
S01007868,Rented or living rent free: Social rented,8,6,2,2,0,2,2,2,0,1,0,1,0
S01007868,Rented or living rent free: Private rented or living rent free,10,8,7,1,6,0,1,2,1,1,0,0,0
S01007869,All HRPs aged 16 and over,362,278,236,25,211,37,5,84,64,9,3,5,3
S01007869,Owned: Total,306,234,201,16,185,31,2,72,64,1,2,2,3
S01007869,Owned: Owned outright,127,66,55,8,47,11,0,61,58,1,0,0,2
S01007869,Owned: Owned with a mortgage or loan or shared ownership,179,168,146,8,138,20,2,11,6,0,2,2,1
S01007869,Rented or living rent free: Total,56,44,35,9,26,6,3,12,0,8,1,3,0
S01007869,Rented or living rent free: Social rented,6,3,2,2,0,1,0,3,0,0,1,2,0
S01007869,Rented or living rent free: Private rented or living rent free,50,41,33,7,26,5,3,9,0,8,0,1,0
S01007870,All HRPs aged 16 and over,199,145,110,11,99,33,2,54,42,0,1,9,2
S01007870,Owned: Total,153,112,83,3,80,29,0,41,34,0,1,5,1
S01007870,Owned: Owned outright,74,42,26,0,26,16,0,32,27,0,1,4,0
S01007870,Owned: Owned with a mortgage or loan or shared ownership,79,70,57,3,54,13,0,9,7,0,0,1,1
S01007870,Rented or living rent free: Total,46,33,27,8,19,4,2,13,8,0,0,4,1
S01007870,Rented or living rent free: Social rented,9,5,4,1,3,0,1,4,1,0,0,2,1
S01007870,Rented or living rent free: Private rented or living rent free,37,28,23,7,16,4,1,9,7,0,0,2,0
S01007871,All HRPs aged 16 and over,285,137,99,27,72,18,20,148,87,0,12,36,13
S01007871,Owned: Total,68,38,28,2,26,10,0,30,25,0,0,3,2
S01007871,Owned: Owned outright,36,10,6,1,5,4,0,26,22,0,0,3,1
S01007871,Owned: Owned with a mortgage or loan or shared ownership,32,28,22,1,21,6,0,4,3,0,0,0,1
S01007871,Rented or living rent free: Total,217,99,71,25,46,8,20,118,62,0,12,33,11
S01007871,Rented or living rent free: Social rented,211,96,69,24,45,7,20,115,62,0,11,31,11
S01007871,Rented or living rent free: Private rented or living rent free,6,3,2,1,1,1,0,3,0,0,1,2,0
S01007872,All HRPs aged 16 and over,322,166,123,42,81,9,34,156,76,1,20,46,13
S01007872,Owned: Total,75,50,44,7,37,6,0,25,21,0,0,2,2
S01007872,Owned: Owned outright,36,18,16,4,12,2,0,18,17,0,0,0,1
S01007872,Owned: Owned with a mortgage or loan or shared ownership,39,32,28,3,25,4,0,7,4,0,0,2,1
S01007872,Rented or living rent free: Total,247,116,79,35,44,3,34,131,55,1,20,44,11
S01007872,Rented or living rent free: Social rented,241,111,76,34,42,3,32,130,54,1,20,44,11
S01007872,Rented or living rent free: Private rented or living rent free,6,5,3,1,2,0,2,1,1,0,0,0,0
S01007873,All HRPs aged 16 and over,295,171,139,29,110,24,8,124,98,1,5,12,8
S01007873,Owned: Total,190,122,100,15,85,20,2,68,61,1,0,3,3
S01007873,Owned: Owned outright,95,44,36,8,28,8,0,51,48,1,0,1,1
S01007873,Owned: Owned with a mortgage or loan or shared ownership,95,78,64,7,57,12,2,17,13,0,0,2,2
S01007873,Rented or living rent free: Total,105,49,39,14,25,4,6,56,37,0,5,9,5
S01007873,Rented or living rent free: Social rented,71,28,22,7,15,1,5,43,29,0,2,8,4
S01007873,Rented or living rent free: Private rented or living rent free,34,21,17,7,10,3,1,13,8,0,3,1,1
S01007874,All HRPs aged 16 and over,367,185,150,34,116,21,14,182,152,1,4,22,3
S01007874,Owned: Total,186,113,93,8,85,18,2,73,72,0,0,1,0
S01007874,Owned: Owned outright,84,28,18,3,15,8,2,56,56,0,0,0,0
S01007874,Owned: Owned with a mortgage or loan or shared ownership,102,85,75,5,70,10,0,17,16,0,0,1,0
S01007874,Rented or living rent free: Total,181,72,57,26,31,3,12,109,80,1,4,21,3
S01007874,Rented or living rent free: Social rented,150,48,37,17,20,2,9,102,74,1,4,20,3
S01007874,Rented or living rent free: Private rented or living rent free,31,24,20,9,11,1,3,7,6,0,0,1,0
S01007875,All HRPs aged 16 and over,242,159,141,38,103,14,4,83,62,1,5,12,3
S01007875,Owned: Total,168,123,111,21,90,11,1,45,41,1,0,2,1
S01007875,Owned: Owned outright,73,35,28,9,19,6,1,38,36,0,0,1,1
S01007875,Owned: Owned with a mortgage or loan or shared ownership,95,88,83,12,71,5,0,7,5,1,0,1,0
S01007875,Rented or living rent free: Total,74,36,30,17,13,3,3,38,21,0,5,10,2
S01007875,Rented or living rent free: Social rented,64,31,27,16,11,1,3,33,18,0,4,9,2
S01007875,Rented or living rent free: Private rented or living rent free,10,5,3,1,2,2,0,5,3,0,1,1,0
S01007876,All HRPs aged 16 and over,420,299,244,43,201,36,19,121,90,0,8,18,5
S01007876,Owned: Total,291,218,187,23,164,29,2,73,64,0,2,5,2
S01007876,Owned: Owned outright,90,33,26,7,19,6,1,57,52,0,2,1,2
S01007876,Owned: Owned with a mortgage or loan or shared ownership,201,185,161,16,145,23,1,16,12,0,0,4,0
S01007876,Rented or living rent free: Total,129,81,57,20,37,7,17,48,26,0,6,13,3
S01007876,Rented or living rent free: Social rented,102,60,43,15,28,3,14,42,23,0,4,13,2
S01007876,Rented or living rent free: Private rented or living rent free,27,21,14,5,9,4,3,6,3,0,2,0,1
S01007877,All HRPs aged 16 and over,336,189,153,33,120,24,12,147,113,2,5,18,9
S01007877,Owned: Total,194,129,109,17,92,20,0,65,58,1,1,4,1
S01007877,Owned: Owned outright,88,37,31,9,22,6,0,51,47,1,0,2,1
S01007877,Owned: Owned with a mortgage or loan or shared ownership,106,92,78,8,70,14,0,14,11,0,1,2,0
S01007877,Rented or living rent free: Total,142,60,44,16,28,4,12,82,55,1,4,14,8
S01007877,Rented or living rent free: Social rented,127,54,40,14,26,3,11,73,50,1,3,14,5
S01007877,Rented or living rent free: Private rented or living rent free,15,6,4,2,2,1,1,9,5,0,1,0,3
S01007878,All HRPs aged 16 and over,281,156,136,35,101,10,10,125,80,2,11,29,3
S01007878,Owned: Total,121,85,75,10,65,10,0,36,33,0,0,3,0
S01007878,Owned: Owned outright,50,22,19,5,14,3,0,28,26,0,0,2,0
S01007878,Owned: Owned with a mortgage or loan or shared ownership,71,63,56,5,51,7,0,8,7,0,0,1,0
S01007878,Rented or living rent free: Total,160,71,61,25,36,0,10,89,47,2,11,26,3
S01007878,Rented or living rent free: Social rented,151,66,57,24,33,0,9,85,44,2,11,25,3
S01007878,Rented or living rent free: Private rented or living rent free,9,5,4,1,3,0,1,4,3,0,0,1,0
S01007879,All HRPs aged 16 and over,320,186,156,44,112,11,19,134,79,0,17,30,8
S01007879,Owned: Total,154,99,92,20,72,6,1,55,48,0,0,4,3
S01007879,Owned: Owned outright,65,25,22,9,13,3,0,40,35,0,0,3,2
S01007879,Owned: Owned with a mortgage or loan or shared ownership,89,74,70,11,59,3,1,15,13,0,0,1,1
S01007879,Rented or living rent free: Total,166,87,64,24,40,5,18,79,31,0,17,26,5
S01007879,Rented or living rent free: Social rented,147,78,58,23,35,3,17,69,28,0,13,24,4
S01007879,Rented or living rent free: Private rented or living rent free,19,9,6,1,5,2,1,10,3,0,4,2,1
S01007880,All HRPs aged 16 and over,178,116,80,14,66,30,6,62,52,0,1,8,1
S01007880,Owned: Total,143,94,65,7,58,29,0,49,44,0,0,4,1
S01007880,Owned: Owned outright,78,39,25,4,21,14,0,39,36,0,0,3,0
S01007880,Owned: Owned with a mortgage or loan or shared ownership,65,55,40,3,37,15,0,10,8,0,0,1,1
S01007880,Rented or living rent free: Total,35,22,15,7,8,1,6,13,8,0,1,4,0
S01007880,Rented or living rent free: Social rented,21,12,9,5,4,0,3,9,5,0,0,4,0
S01007880,Rented or living rent free: Private rented or living rent free,14,10,6,2,4,1,3,4,3,0,1,0,0
S01007881,All HRPs aged 16 and over,244,141,96,12,84,29,16,103,69,0,6,22,6
S01007881,Owned: Total,107,76,49,2,47,26,1,31,29,0,0,1,1
S01007881,Owned: Owned outright,49,24,8,0,8,15,1,25,25,0,0,0,0
S01007881,Owned: Owned with a mortgage or loan or shared ownership,58,52,41,2,39,11,0,6,4,0,0,1,1
S01007881,Rented or living rent free: Total,137,65,47,10,37,3,15,72,40,0,6,21,5
S01007881,Rented or living rent free: Social rented,119,53,37,7,30,3,13,66,37,0,4,21,4
S01007881,Rented or living rent free: Private rented or living rent free,18,12,10,3,7,0,2,6,3,0,2,0,1
S01007882,All HRPs aged 16 and over,268,223,152,16,136,67,4,45,38,2,0,5,0
S01007882,Owned: Total,225,191,126,14,112,63,2,34,33,0,0,1,0
S01007882,Owned: Owned outright,109,81,42,9,33,39,0,28,27,0,0,1,0
S01007882,Owned: Owned with a mortgage or loan or shared ownership,116,110,84,5,79,24,2,6,6,0,0,0,0
S01007882,Rented or living rent free: Total,43,32,26,2,24,4,2,11,5,2,0,4,0
S01007882,Rented or living rent free: Social rented,9,5,4,0,4,0,1,4,2,0,0,2,0
S01007882,Rented or living rent free: Private rented or living rent free,34,27,22,2,20,4,1,7,3,2,0,2,0
S01007883,All HRPs aged 16 and over,468,320,262,33,229,45,13,148,119,4,9,14,2
S01007883,Owned: Total,361,261,217,24,193,39,5,100,94,0,1,3,2
S01007883,Owned: Owned outright,150,71,52,13,39,16,3,79,77,0,0,1,1
S01007883,Owned: Owned with a mortgage or loan or shared ownership,211,190,165,11,154,23,2,21,17,0,1,2,1
S01007883,Rented or living rent free: Total,107,59,45,9,36,6,8,48,25,4,8,11,0
S01007883,Rented or living rent free: Social rented,69,29,21,5,16,2,6,40,24,2,3,11,0
S01007883,Rented or living rent free: Private rented or living rent free,38,30,24,4,20,4,2,8,1,2,5,0,0
S01007884,All HRPs aged 16 and over,269,175,144,24,120,21,10,94,66,1,9,14,4
S01007884,Owned: Total,176,125,108,9,99,16,1,51,45,0,1,4,1
S01007884,Owned: Owned outright,66,25,22,4,18,3,0,41,37,0,0,3,1
S01007884,Owned: Owned with a mortgage or loan or shared ownership,110,100,86,5,81,13,1,10,8,0,1,1,0
S01007884,Rented or living rent free: Total,93,50,36,15,21,5,9,43,21,1,8,10,3
S01007884,Rented or living rent free: Social rented,69,39,29,13,16,4,6,30,16,1,3,8,2
S01007884,Rented or living rent free: Private rented or living rent free,24,11,7,2,5,1,3,13,5,0,5,2,1
S01007885,All HRPs aged 16 and over,345,195,142,26,116,17,36,150,90,1,6,42,11
S01007885,Owned: Total,125,83,68,9,59,12,3,42,38,0,0,3,1
S01007885,Owned: Owned outright,56,20,17,5,12,2,1,36,35,0,0,1,0
S01007885,Owned: Owned with a mortgage or loan or shared ownership,69,63,51,4,47,10,2,6,3,0,0,2,1
S01007885,Rented or living rent free: Total,220,112,74,17,57,5,33,108,52,1,6,39,10
S01007885,Rented or living rent free: Social rented,201,101,67,17,50,4,30,100,51,1,4,34,10
S01007885,Rented or living rent free: Private rented or living rent free,19,11,7,0,7,1,3,8,1,0,2,5,0
S01007886,All HRPs aged 16 and over,433,242,184,21,163,38,20,191,128,3,4,49,7
S01007886,Owned: Total,260,175,137,11,126,34,4,85,80,0,0,5,0
S01007886,Owned: Owned outright,127,55,44,5,39,9,2,72,70,0,0,2,0
S01007886,Owned: Owned with a mortgage or loan or shared ownership,133,120,93,6,87,25,2,13,10,0,0,3,0
S01007886,Rented or living rent free: Total,173,67,47,10,37,4,16,106,48,3,4,44,7
S01007886,Rented or living rent free: Social rented,138,46,33,8,25,1,12,92,46,1,3,35,7
S01007886,Rented or living rent free: Private rented or living rent free,35,21,14,2,12,3,4,14,2,2,1,9,0
S01007887,All HRPs aged 16 and over,230,157,100,12,88,52,5,73,64,0,5,3,1
S01007887,Owned: Total,149,105,67,5,62,36,2,44,41,0,2,1,0
S01007887,Owned: Owned outright,81,42,24,3,21,16,2,39,36,0,2,1,0
S01007887,Owned: Owned with a mortgage or loan or shared ownership,68,63,43,2,41,20,0,5,5,0,0,0,0
S01007887,Rented or living rent free: Total,81,52,33,7,26,16,3,29,23,0,3,2,1
S01007887,Rented or living rent free: Social rented,8,2,1,0,1,1,0,6,1,0,2,2,1
S01007887,Rented or living rent free: Private rented or living rent free,73,50,32,7,25,15,3,23,22,0,1,0,0
S01007888,All HRPs aged 16 and over,451,306,253,73,180,13,40,145,91,6,14,28,6
S01007888,Owned: Total,200,135,122,21,101,11,2,65,59,0,2,4,0
S01007888,Owned: Owned outright,81,36,30,8,22,5,1,45,44,0,0,1,0
S01007888,Owned: Owned with a mortgage or loan or shared ownership,119,99,92,13,79,6,1,20,15,0,2,3,0
S01007888,Rented or living rent free: Total,251,171,131,52,79,2,38,80,32,6,12,24,6
S01007888,Rented or living rent free: Social rented,230,158,125,49,76,1,32,72,31,4,10,23,4
S01007888,Rented or living rent free: Private rented or living rent free,21,13,6,3,3,1,6,8,1,2,2,1,2
S01007889,All HRPs aged 16 and over,242,131,113,28,85,8,10,111,85,1,4,16,5
S01007889,Owned: Total,144,85,77,14,63,7,1,59,49,0,2,7,1
S01007889,Owned: Owned outright,66,17,14,5,9,3,0,49,43,0,0,5,1
S01007889,Owned: Owned with a mortgage or loan or shared ownership,78,68,63,9,54,4,1,10,6,0,2,2,0
S01007889,Rented or living rent free: Total,98,46,36,14,22,1,9,52,36,1,2,9,4
S01007889,Rented or living rent free: Social rented,88,38,29,11,18,1,8,50,34,1,2,9,4
S01007889,Rented or living rent free: Private rented or living rent free,10,8,7,3,4,0,1,2,2,0,0,0,0
S01007890,All HRPs aged 16 and over,300,198,155,34,121,33,10,102,72,1,4,23,2
S01007890,Owned: Total,199,145,112,13,99,30,3,54,50,0,0,3,1
S01007890,Owned: Owned outright,82,43,24,6,18,18,1,39,37,0,0,2,0
S01007890,Owned: Owned with a mortgage or loan or shared ownership,117,102,88,7,81,12,2,15,13,0,0,1,1
S01007890,Rented or living rent free: Total,101,53,43,21,22,3,7,48,22,1,4,20,1
S01007890,Rented or living rent free: Social rented,90,46,37,20,17,3,6,44,18,1,4,20,1
S01007890,Rented or living rent free: Private rented or living rent free,11,7,6,1,5,0,1,4,4,0,0,0,0
S01007891,All HRPs aged 16 and over,370,229,196,29,167,26,7,141,112,0,6,19,4
S01007891,Owned: Total,254,184,161,18,143,23,0,70,60,0,3,7,0
S01007891,Owned: Owned outright,84,32,28,11,17,4,0,52,47,0,2,3,0
S01007891,Owned: Owned with a mortgage or loan or shared ownership,170,152,133,7,126,19,0,18,13,0,1,4,0
S01007891,Rented or living rent free: Total,116,45,35,11,24,3,7,71,52,0,3,12,4
S01007891,Rented or living rent free: Social rented,95,32,25,9,16,1,6,63,49,0,3,8,3
S01007891,Rented or living rent free: Private rented or living rent free,21,13,10,2,8,2,1,8,3,0,0,4,1
S01007892,All HRPs aged 16 and over,341,215,175,31,144,30,10,126,105,0,4,11,6
S01007892,Owned: Total,254,167,142,19,123,24,1,87,84,0,0,3,0
S01007892,Owned: Owned outright,128,54,44,10,34,9,1,74,72,0,0,2,0
S01007892,Owned: Owned with a mortgage or loan or shared ownership,126,113,98,9,89,15,0,13,12,0,0,1,0
S01007892,Rented or living rent free: Total,87,48,33,12,21,6,9,39,21,0,4,8,6
S01007892,Rented or living rent free: Social rented,48,30,22,9,13,1,7,18,10,0,1,5,2
S01007892,Rented or living rent free: Private rented or living rent free,39,18,11,3,8,5,2,21,11,0,3,3,4
S01007893,All HRPs aged 16 and over,423,268,205,23,182,52,11,155,137,1,2,11,4
S01007893,Owned: Total,365,232,176,20,156,49,7,133,125,1,0,5,2
S01007893,Owned: Owned outright,181,61,38,7,31,21,2,120,114,1,0,4,1
S01007893,Owned: Owned with a mortgage or loan or shared ownership,184,171,138,13,125,28,5,13,11,0,0,1,1
S01007893,Rented or living rent free: Total,58,36,29,3,26,3,4,22,12,0,2,6,2
S01007893,Rented or living rent free: Social rented,23,10,8,1,7,0,2,13,6,0,0,5,2
S01007893,Rented or living rent free: Private rented or living rent free,35,26,21,2,19,3,2,9,6,0,2,1,0
S01007894,All HRPs aged 16 and over,386,242,208,29,179,27,7,144,108,3,6,17,10
S01007894,Owned: Total,261,181,158,19,139,21,2,80,67,0,2,6,5
S01007894,Owned: Owned outright,108,43,37,7,30,6,0,65,55,0,2,5,3
S01007894,Owned: Owned with a mortgage or loan or shared ownership,153,138,121,12,109,15,2,15,12,0,0,1,2
S01007894,Rented or living rent free: Total,125,61,50,10,40,6,5,64,41,3,4,11,5
S01007894,Rented or living rent free: Social rented,88,36,30,7,23,3,3,52,36,2,1,10,3
S01007894,Rented or living rent free: Private rented or living rent free,37,25,20,3,17,3,2,12,5,1,3,1,2
S01007895,All HRPs aged 16 and over,249,138,112,13,99,20,6,111,103,0,0,5,3
S01007895,Owned: Total,182,105,84,9,75,17,4,77,76,0,0,0,1
S01007895,Owned: Owned outright,95,30,21,7,14,6,3,65,65,0,0,0,0
S01007895,Owned: Owned with a mortgage or loan or shared ownership,87,75,63,2,61,11,1,12,11,0,0,0,1
S01007895,Rented or living rent free: Total,67,33,28,4,24,3,2,34,27,0,0,5,2
S01007895,Rented or living rent free: Social rented,34,10,9,1,8,1,0,24,21,0,0,3,0
S01007895,Rented or living rent free: Private rented or living rent free,33,23,19,3,16,2,2,10,6,0,0,2,2
S01007896,All HRPs aged 16 and over,387,220,176,35,141,21,23,167,118,1,6,31,11
S01007896,Owned: Total,186,129,112,17,95,13,4,57,50,0,1,4,2
S01007896,Owned: Owned outright,76,32,28,9,19,4,0,44,40,0,0,2,2
S01007896,Owned: Owned with a mortgage or loan or shared ownership,110,97,84,8,76,9,4,13,10,0,1,2,0
S01007896,Rented or living rent free: Total,201,91,64,18,46,8,19,110,68,1,5,27,9
S01007896,Rented or living rent free: Social rented,156,72,51,14,37,7,14,84,54,0,3,23,4
S01007896,Rented or living rent free: Private rented or living rent free,45,19,13,4,9,1,5,26,14,1,2,4,5
S01007897,All HRPs aged 16 and over,165,115,69,8,61,42,4,50,41,0,4,4,1
S01007897,Owned: Total,133,93,52,5,47,39,2,40,36,0,1,2,1
S01007897,Owned: Owned outright,71,37,15,1,14,22,0,34,32,0,0,2,0
S01007897,Owned: Owned with a mortgage or loan or shared ownership,62,56,37,4,33,17,2,6,4,0,1,0,1
S01007897,Rented or living rent free: Total,32,22,17,3,14,3,2,10,5,0,3,2,0
S01007897,Rented or living rent free: Social rented,4,2,2,0,2,0,0,2,0,0,1,1,0
S01007897,Rented or living rent free: Private rented or living rent free,28,20,15,3,12,3,2,8,5,0,2,1,0
S01007898,All HRPs aged 16 and over,166,116,74,9,65,39,3,50,41,2,0,4,3
S01007898,Owned: Total,134,91,58,7,51,32,1,43,37,1,0,2,3
S01007898,Owned: Owned outright,65,41,19,2,17,22,0,24,22,1,0,0,1
S01007898,Owned: Owned with a mortgage or loan or shared ownership,69,50,39,5,34,10,1,19,15,0,0,2,2
S01007898,Rented or living rent free: Total,32,25,16,2,14,7,2,7,4,1,0,2,0
S01007898,Rented or living rent free: Social rented,5,4,1,1,0,2,1,1,0,1,0,0,0
S01007898,Rented or living rent free: Private rented or living rent free,27,21,15,1,14,5,1,6,4,0,0,2,0
S01007899,All HRPs aged 16 and over,145,106,54,8,46,47,5,39,29,0,1,8,1
S01007899,Owned: Total,103,80,42,5,37,37,1,23,21,0,0,1,1
S01007899,Owned: Owned outright,61,43,14,4,10,29,0,18,16,0,0,1,1
S01007899,Owned: Owned with a mortgage or loan or shared ownership,42,37,28,1,27,8,1,5,5,0,0,0,0
S01007899,Rented or living rent free: Total,42,26,12,3,9,10,4,16,8,0,1,7,0
S01007899,Rented or living rent free: Social rented,6,4,4,2,2,0,0,2,2,0,0,0,0
S01007899,Rented or living rent free: Private rented or living rent free,36,22,8,1,7,10,4,14,6,0,1,7,0
S01007900,All HRPs aged 16 and over,232,129,108,25,83,7,14,103,77,1,6,13,6
S01007900,Owned: Total,105,61,57,8,49,3,1,44,41,0,0,1,2
S01007900,Owned: Owned outright,56,16,14,3,11,1,1,40,38,0,0,1,1
S01007900,Owned: Owned with a mortgage or loan or shared ownership,49,45,43,5,38,2,0,4,3,0,0,0,1
S01007900,Rented or living rent free: Total,127,68,51,17,34,4,13,59,36,1,6,12,4
S01007900,Rented or living rent free: Social rented,120,62,47,16,31,2,13,58,36,1,6,11,4
S01007900,Rented or living rent free: Private rented or living rent free,7,6,4,1,3,2,0,1,0,0,0,1,0
S01007901,All HRPs aged 16 and over,317,176,141,25,116,17,18,141,99,3,8,28,3
S01007901,Owned: Total,146,87,73,6,67,13,1,59,52,0,1,3,3
S01007901,Owned: Owned outright,65,24,20,4,16,4,0,41,38,0,0,1,2
S01007901,Owned: Owned with a mortgage or loan or shared ownership,81,63,53,2,51,9,1,18,14,0,1,2,1
S01007901,Rented or living rent free: Total,171,89,68,19,49,4,17,82,47,3,7,25,0
S01007901,Rented or living rent free: Social rented,143,68,51,13,38,2,15,75,45,3,7,20,0
S01007901,Rented or living rent free: Private rented or living rent free,28,21,17,6,11,2,2,7,2,0,0,5,0
S01007902,All HRPs aged 16 and over,394,201,163,29,134,16,22,193,115,2,18,47,11
S01007902,Owned: Total,148,92,81,13,68,9,2,56,51,0,1,4,0
S01007902,Owned: Owned outright,75,35,29,7,22,5,1,40,38,0,1,1,0
S01007902,Owned: Owned with a mortgage or loan or shared ownership,73,57,52,6,46,4,1,16,13,0,0,3,0
S01007902,Rented or living rent free: Total,246,109,82,16,66,7,20,137,64,2,17,43,11
S01007902,Rented or living rent free: Social rented,226,96,75,15,60,2,19,130,61,2,16,41,10
S01007902,Rented or living rent free: Private rented or living rent free,20,13,7,1,6,5,1,7,3,0,1,2,1
S01007903,All HRPs aged 16 and over,322,145,112,18,94,20,13,177,135,2,7,31,2
S01007903,Owned: Total,185,100,82,9,73,14,4,85,77,0,1,7,0
S01007903,Owned: Owned outright,116,46,35,7,28,7,4,70,65,0,0,5,0
S01007903,Owned: Owned with a mortgage or loan or shared ownership,69,54,47,2,45,7,0,15,12,0,1,2,0
S01007903,Rented or living rent free: Total,137,45,30,9,21,6,9,92,58,2,6,24,2
S01007903,Rented or living rent free: Social rented,110,33,24,9,15,2,7,77,50,1,4,20,2
S01007903,Rented or living rent free: Private rented or living rent free,27,12,6,0,6,4,2,15,8,1,2,4,0
S01007904,All HRPs aged 16 and over,312,223,148,17,131,75,0,89,72,0,3,12,2
S01007904,Owned: Total,220,162,108,9,99,54,0,58,50,0,0,7,1
S01007904,Owned: Owned outright,115,70,40,5,35,30,0,45,40,0,0,4,1
S01007904,Owned: Owned with a mortgage or loan or shared ownership,105,92,68,4,64,24,0,13,10,0,0,3,0
S01007904,Rented or living rent free: Total,92,61,40,8,32,21,0,31,22,0,3,5,1
S01007904,Rented or living rent free: Social rented,17,7,6,2,4,1,0,10,8,0,1,1,0
S01007904,Rented or living rent free: Private rented or living rent free,75,54,34,6,28,20,0,21,14,0,2,4,1
S01007905,All HRPs aged 16 and over,292,173,125,28,97,9,39,119,75,3,9,22,10
S01007905,Owned: Total,92,65,57,8,49,6,2,27,25,0,0,1,1
S01007905,Owned: Owned outright,28,11,9,2,7,0,2,17,16,0,0,0,1
S01007905,Owned: Owned with a mortgage or loan or shared ownership,64,54,48,6,42,6,0,10,9,0,0,1,0
S01007905,Rented or living rent free: Total,200,108,68,20,48,3,37,92,50,3,9,21,9
S01007905,Rented or living rent free: Social rented,189,101,64,17,47,2,35,88,48,3,8,21,8
S01007905,Rented or living rent free: Private rented or living rent free,11,7,4,3,1,1,2,4,2,0,1,0,1
S01007906,All HRPs aged 16 and over,382,179,143,30,113,19,17,203,157,0,10,29,7
S01007906,Owned: Total,164,90,75,6,69,13,2,74,71,0,0,2,1
S01007906,Owned: Owned outright,73,21,17,2,15,4,0,52,51,0,0,0,1
S01007906,Owned: Owned with a mortgage or loan or shared ownership,91,69,58,4,54,9,2,22,20,0,0,2,0
S01007906,Rented or living rent free: Total,218,89,68,24,44,6,15,129,86,0,10,27,6
S01007906,Rented or living rent free: Social rented,201,80,61,23,38,5,14,121,83,0,7,26,5
S01007906,Rented or living rent free: Private rented or living rent free,17,9,7,1,6,1,1,8,3,0,3,1,1
S01007907,All HRPs aged 16 and over,254,127,108,10,98,6,13,127,107,0,4,15,1
S01007907,Owned: Total,129,76,69,5,64,5,2,53,52,0,1,0,0
S01007907,Owned: Owned outright,74,28,25,4,21,3,0,46,45,0,1,0,0
S01007907,Owned: Owned with a mortgage or loan or shared ownership,55,48,44,1,43,2,2,7,7,0,0,0,0
S01007907,Rented or living rent free: Total,125,51,39,5,34,1,11,74,55,0,3,15,1
S01007907,Rented or living rent free: Social rented,112,41,31,3,28,0,10,71,53,0,3,14,1
S01007907,Rented or living rent free: Private rented or living rent free,13,10,8,2,6,1,1,3,2,0,0,1,0
S01007908,All HRPs aged 16 and over,419,222,182,31,151,28,12,197,164,0,7,23,3
S01007908,Owned: Total,311,182,153,21,132,25,4,129,123,0,0,5,1
S01007908,Owned: Owned outright,173,69,51,12,39,14,4,104,102,0,0,2,0
S01007908,Owned: Owned with a mortgage or loan or shared ownership,138,113,102,9,93,11,0,25,21,0,0,3,1
S01007908,Rented or living rent free: Total,108,40,29,10,19,3,8,68,41,0,7,18,2
S01007908,Rented or living rent free: Social rented,74,17,12,4,8,1,4,57,39,0,4,13,1
S01007908,Rented or living rent free: Private rented or living rent free,34,23,17,6,11,2,4,11,2,0,3,5,1
S01007909,All HRPs aged 16 and over,226,152,128,18,110,15,9,74,54,2,3,11,4
S01007909,Owned: Total,136,94,82,7,75,11,1,42,41,0,0,0,1
S01007909,Owned: Owned outright,54,21,20,3,17,1,0,33,32,0,0,0,1
S01007909,Owned: Owned with a mortgage or loan or shared ownership,82,73,62,4,58,10,1,9,9,0,0,0,0
S01007909,Rented or living rent free: Total,90,58,46,11,35,4,8,32,13,2,3,11,3
S01007909,Rented or living rent free: Social rented,74,46,39,11,28,2,5,28,12,2,2,10,2
S01007909,Rented or living rent free: Private rented or living rent free,16,12,7,0,7,2,3,4,1,0,1,1,1
S01007910,All HRPs aged 16 and over,369,231,183,51,132,16,32,138,68,6,20,40,4
S01007910,Owned: Total,172,121,107,19,88,11,3,51,44,0,0,7,0
S01007910,Owned: Owned outright,67,29,24,8,16,4,1,38,34,0,0,4,0
S01007910,Owned: Owned with a mortgage or loan or shared ownership,105,92,83,11,72,7,2,13,10,0,0,3,0
S01007910,Rented or living rent free: Total,197,110,76,32,44,5,29,87,24,6,20,33,4
S01007910,Rented or living rent free: Social rented,160,84,58,28,30,3,23,76,22,3,17,30,4
S01007910,Rented or living rent free: Private rented or living rent free,37,26,18,4,14,2,6,11,2,3,3,3,0
S01007911,All HRPs aged 16 and over,348,195,171,28,143,19,5,153,101,4,7,36,5
S01007911,Owned: Total,219,159,139,13,126,19,1,60,55,2,0,3,0
S01007911,Owned: Owned outright,73,29,21,4,17,8,0,44,40,2,0,2,0
S01007911,Owned: Owned with a mortgage or loan or shared ownership,146,130,118,9,109,11,1,16,15,0,0,1,0
S01007911,Rented or living rent free: Total,129,36,32,15,17,0,4,93,46,2,7,33,5
S01007911,Rented or living rent free: Social rented,106,26,25,13,12,0,1,80,42,2,4,27,5
S01007911,Rented or living rent free: Private rented or living rent free,23,10,7,2,5,0,3,13,4,0,3,6,0
S01007912,All HRPs aged 16 and over,346,214,179,34,145,20,15,132,104,0,1,21,6
S01007912,Owned: Total,222,142,128,20,108,14,0,80,74,0,0,5,1
S01007912,Owned: Owned outright,103,40,34,11,23,6,0,63,59,0,0,3,1
S01007912,Owned: Owned with a mortgage or loan or shared ownership,119,102,94,9,85,8,0,17,15,0,0,2,0
S01007912,Rented or living rent free: Total,124,72,51,14,37,6,15,52,30,0,1,16,5
S01007912,Rented or living rent free: Social rented,95,48,33,10,23,3,12,47,26,0,0,16,5
S01007912,Rented or living rent free: Private rented or living rent free,29,24,18,4,14,3,3,5,4,0,1,0,0
S01007913,All HRPs aged 16 and over,304,165,133,38,95,17,15,139,97,2,8,26,6
S01007913,Owned: Total,124,77,66,9,57,10,1,47,44,0,0,3,0
S01007913,Owned: Owned outright,60,19,15,2,13,3,1,41,39,0,0,2,0
S01007913,Owned: Owned with a mortgage or loan or shared ownership,64,58,51,7,44,7,0,6,5,0,0,1,0
S01007913,Rented or living rent free: Total,180,88,67,29,38,7,14,92,53,2,8,23,6
S01007913,Rented or living rent free: Social rented,132,55,44,19,25,4,7,77,48,0,4,22,3
S01007913,Rented or living rent free: Private rented or living rent free,48,33,23,10,13,3,7,15,5,2,4,1,3
S01007914,All HRPs aged 16 and over,279,171,124,25,99,17,30,108,77,3,8,18,2
S01007914,Owned: Total,135,90,72,9,63,14,4,45,41,1,0,3,0
S01007914,Owned: Owned outright,58,23,15,3,12,7,1,35,33,0,0,2,0
S01007914,Owned: Owned with a mortgage or loan or shared ownership,77,67,57,6,51,7,3,10,8,1,0,1,0
S01007914,Rented or living rent free: Total,144,81,52,16,36,3,26,63,36,2,8,15,2
S01007914,Rented or living rent free: Social rented,129,70,47,14,33,2,21,59,36,1,7,13,2
S01007914,Rented or living rent free: Private rented or living rent free,15,11,5,2,3,1,5,4,0,1,1,2,0
S01007915,All HRPs aged 16 and over,361,240,190,43,147,24,26,121,90,0,4,24,3
S01007915,Owned: Total,216,145,125,21,104,17,3,71,69,0,1,1,0
S01007915,Owned: Owned outright,93,34,30,6,24,4,0,59,58,0,1,0,0
S01007915,Owned: Owned with a mortgage or loan or shared ownership,123,111,95,15,80,13,3,12,11,0,0,1,0
S01007915,Rented or living rent free: Total,145,95,65,22,43,7,23,50,21,0,3,23,3
S01007915,Rented or living rent free: Social rented,134,87,62,22,40,5,20,47,21,0,2,21,3
S01007915,Rented or living rent free: Private rented or living rent free,11,8,3,0,3,2,3,3,0,0,1,2,0
S01007916,All HRPs aged 16 and over,399,188,149,31,118,26,13,211,169,2,5,31,4
S01007916,Owned: Total,242,132,110,17,93,19,3,110,104,1,1,3,1
S01007916,Owned: Owned outright,120,41,35,6,29,4,2,79,75,1,1,2,0
S01007916,Owned: Owned with a mortgage or loan or shared ownership,122,91,75,11,64,15,1,31,29,0,0,1,1
S01007916,Rented or living rent free: Total,157,56,39,14,25,7,10,101,65,1,4,28,3
S01007916,Rented or living rent free: Social rented,131,41,28,11,17,3,10,90,62,1,3,22,2
S01007916,Rented or living rent free: Private rented or living rent free,26,15,11,3,8,4,0,11,3,0,1,6,1
S01007917,All HRPs aged 16 and over,369,228,192,37,155,19,17,141,97,2,7,24,11
S01007917,Owned: Total,234,156,141,19,122,15,0,78,73,0,0,5,0
S01007917,Owned: Owned outright,96,35,30,11,19,5,0,61,57,0,0,4,0
S01007917,Owned: Owned with a mortgage or loan or shared ownership,138,121,111,8,103,10,0,17,16,0,0,1,0
S01007917,Rented or living rent free: Total,135,72,51,18,33,4,17,63,24,2,7,19,11
S01007917,Rented or living rent free: Social rented,112,56,39,15,24,2,15,56,23,1,3,19,10
S01007917,Rented or living rent free: Private rented or living rent free,23,16,12,3,9,2,2,7,1,1,4,0,1
S01007918,All HRPs aged 16 and over,446,253,195,31,164,27,31,193,140,4,5,32,12
S01007918,Owned: Total,237,164,137,13,124,23,4,73,69,1,1,2,0
S01007918,Owned: Owned outright,112,51,43,12,31,6,2,61,59,0,1,1,0
S01007918,Owned: Owned with a mortgage or loan or shared ownership,125,113,94,1,93,17,2,12,10,1,0,1,0
S01007918,Rented or living rent free: Total,209,89,58,18,40,4,27,120,71,3,4,30,12
S01007918,Rented or living rent free: Social rented,164,63,36,14,22,2,25,101,57,3,4,27,10
S01007918,Rented or living rent free: Private rented or living rent free,45,26,22,4,18,2,2,19,14,0,0,3,2
S01007919,All HRPs aged 16 and over,303,197,167,11,156,28,2,106,99,0,1,5,1
S01007919,Owned: Total,281,185,156,11,145,27,2,96,93,0,0,3,0
S01007919,Owned: Owned outright,131,48,36,6,30,10,2,83,81,0,0,2,0
S01007919,Owned: Owned with a mortgage or loan or shared ownership,150,137,120,5,115,17,0,13,12,0,0,1,0
S01007919,Rented or living rent free: Total,22,12,11,0,11,1,0,10,6,0,1,2,1
S01007919,Rented or living rent free: Social rented,10,3,3,0,3,0,0,7,4,0,0,2,1
S01007919,Rented or living rent free: Private rented or living rent free,12,9,8,0,8,1,0,3,2,0,1,0,0
S01007920,All HRPs aged 16 and over,245,177,155,17,138,20,2,68,61,0,2,3,2
S01007920,Owned: Total,221,161,142,15,127,18,1,60,57,0,1,1,1
S01007920,Owned: Owned outright,89,39,36,9,27,3,0,50,50,0,0,0,0
S01007920,Owned: Owned with a mortgage or loan or shared ownership,132,122,106,6,100,15,1,10,7,0,1,1,1
S01007920,Rented or living rent free: Total,24,16,13,2,11,2,1,8,4,0,1,2,1
S01007920,Rented or living rent free: Social rented,10,6,5,0,5,1,0,4,0,0,1,2,1
S01007920,Rented or living rent free: Private rented or living rent free,14,10,8,2,6,1,1,4,4,0,0,0,0
S01007921,All HRPs aged 16 and over,422,220,176,31,145,23,21,202,144,2,7,38,11
S01007921,Owned: Total,162,102,87,6,81,14,1,60,52,0,1,6,1
S01007921,Owned: Owned outright,66,22,19,1,18,3,0,44,39,0,1,4,0
S01007921,Owned: Owned with a mortgage or loan or shared ownership,96,80,68,5,63,11,1,16,13,0,0,2,1
S01007921,Rented or living rent free: Total,260,118,89,25,64,9,20,142,92,2,6,32,10
S01007921,Rented or living rent free: Social rented,246,112,86,25,61,7,19,134,89,2,6,28,9
S01007921,Rented or living rent free: Private rented or living rent free,14,6,3,0,3,2,1,8,3,0,0,4,1
S01007922,All HRPs aged 16 and over,386,212,162,51,111,26,24,174,107,1,12,46,8
S01007922,Owned: Total,161,105,87,23,64,18,0,56,48,0,1,6,1
S01007922,Owned: Owned outright,67,28,23,7,16,5,0,39,33,0,1,4,1
S01007922,Owned: Owned with a mortgage or loan or shared ownership,94,77,64,16,48,13,0,17,15,0,0,2,0
S01007922,Rented or living rent free: Total,225,107,75,28,47,8,24,118,59,1,11,40,7
S01007922,Rented or living rent free: Social rented,200,91,67,25,42,5,19,109,55,0,9,38,7
S01007922,Rented or living rent free: Private rented or living rent free,25,16,8,3,5,3,5,9,4,1,2,2,0
S01007923,All HRPs aged 16 and over,412,283,229,42,187,46,8,129,108,2,3,15,1
S01007923,Owned: Total,330,234,190,26,164,43,1,96,87,0,2,6,1
S01007923,Owned: Owned outright,148,73,55,13,42,17,1,75,73,0,0,2,0
S01007923,Owned: Owned with a mortgage or loan or shared ownership,182,161,135,13,122,26,0,21,14,0,2,4,1
S01007923,Rented or living rent free: Total,82,49,39,16,23,3,7,33,21,2,1,9,0
S01007923,Rented or living rent free: Social rented,49,25,19,7,12,1,5,24,18,2,0,4,0
S01007923,Rented or living rent free: Private rented or living rent free,33,24,20,9,11,2,2,9,3,0,1,5,0
S01007924,All HRPs aged 16 and over,430,248,194,57,137,23,31,182,118,7,9,37,11
S01007924,Owned: Total,209,129,107,20,87,21,1,80,71,3,1,3,2
S01007924,Owned: Owned outright,98,32,23,10,13,8,1,66,60,3,0,2,1
S01007924,Owned: Owned with a mortgage or loan or shared ownership,111,97,84,10,74,13,0,14,11,0,1,1,1
S01007924,Rented or living rent free: Total,221,119,87,37,50,2,30,102,47,4,8,34,9
S01007924,Rented or living rent free: Social rented,182,92,67,32,35,2,23,90,45,4,6,29,6
S01007924,Rented or living rent free: Private rented or living rent free,39,27,20,5,15,0,7,12,2,0,2,5,3
S01007925,All HRPs aged 16 and over,176,136,70,6,64,61,5,40,34,0,2,4,0
S01007925,Owned: Total,147,113,57,5,52,54,2,34,33,0,0,1,0
S01007925,Owned: Owned outright,81,52,19,4,15,32,1,29,29,0,0,0,0
S01007925,Owned: Owned with a mortgage or loan or shared ownership,66,61,38,1,37,22,1,5,4,0,0,1,0
S01007925,Rented or living rent free: Total,29,23,13,1,12,7,3,6,1,0,2,3,0
S01007925,Rented or living rent free: Social rented,4,1,0,0,0,0,1,3,1,0,1,1,0
S01007925,Rented or living rent free: Private rented or living rent free,25,22,13,1,12,7,2,3,0,0,1,2,0
S01007926,All HRPs aged 16 and over,175,147,95,9,86,49,3,28,26,0,0,2,0
S01007926,Owned: Total,147,125,78,8,70,45,2,22,22,0,0,0,0
S01007926,Owned: Owned outright,67,50,20,2,18,29,1,17,17,0,0,0,0
S01007926,Owned: Owned with a mortgage or loan or shared ownership,80,75,58,6,52,16,1,5,5,0,0,0,0
S01007926,Rented or living rent free: Total,28,22,17,1,16,4,1,6,4,0,0,2,0
S01007926,Rented or living rent free: Social rented,7,4,2,0,2,1,1,3,2,0,0,1,0
S01007926,Rented or living rent free: Private rented or living rent free,21,18,15,1,14,3,0,3,2,0,0,1,0
S01007927,All HRPs aged 16 and over,237,180,106,13,93,73,1,57,47,0,3,5,2
S01007927,Owned: Total,200,160,93,11,82,66,1,40,38,0,0,1,1
S01007927,Owned: Owned outright,91,57,19,7,12,38,0,34,32,0,0,1,1
S01007927,Owned: Owned with a mortgage or loan or shared ownership,109,103,74,4,70,28,1,6,6,0,0,0,0
S01007927,Rented or living rent free: Total,37,20,13,2,11,7,0,17,9,0,3,4,1
S01007927,Rented or living rent free: Social rented,16,4,3,0,3,1,0,12,5,0,3,3,1
S01007927,Rented or living rent free: Private rented or living rent free,21,16,10,2,8,6,0,5,4,0,0,1,0
S01007928,All HRPs aged 16 and over,418,268,204,27,177,57,7,150,136,0,5,8,1
S01007928,Owned: Total,346,224,168,19,149,55,1,122,118,0,2,2,0
S01007928,Owned: Owned outright,155,55,40,9,31,15,0,100,99,0,1,0,0
S01007928,Owned: Owned with a mortgage or loan or shared ownership,191,169,128,10,118,40,1,22,19,0,1,2,0
S01007928,Rented or living rent free: Total,72,44,36,8,28,2,6,28,18,0,3,6,1
S01007928,Rented or living rent free: Social rented,51,31,24,8,16,1,6,20,15,0,1,3,1
S01007928,Rented or living rent free: Private rented or living rent free,21,13,12,0,12,1,0,8,3,0,2,3,0
S01007929,All HRPs aged 16 and over,268,212,129,13,116,81,2,56,42,3,6,4,1
S01007929,Owned: Total,227,187,114,10,104,73,0,40,36,1,0,2,1
S01007929,Owned: Owned outright,99,67,36,5,31,31,0,32,31,0,0,0,1
S01007929,Owned: Owned with a mortgage or loan or shared ownership,128,120,78,5,73,42,0,8,5,1,0,2,0
S01007929,Rented or living rent free: Total,41,25,15,3,12,8,2,16,6,2,6,2,0
S01007929,Rented or living rent free: Social rented,11,4,0,0,0,3,1,7,2,0,3,2,0
S01007929,Rented or living rent free: Private rented or living rent free,30,21,15,3,12,5,1,9,4,2,3,0,0
S01007930,All HRPs aged 16 and over,216,175,101,11,90,74,0,41,36,0,1,3,1
S01007930,Owned: Total,191,159,89,7,82,70,0,32,29,0,0,2,1
S01007930,Owned: Owned outright,99,69,31,5,26,38,0,30,28,0,0,1,1
S01007930,Owned: Owned with a mortgage or loan or shared ownership,92,90,58,2,56,32,0,2,1,0,0,1,0
S01007930,Rented or living rent free: Total,25,16,12,4,8,4,0,9,7,0,1,1,0
S01007930,Rented or living rent free: Social rented,10,3,2,1,1,1,0,7,6,0,0,1,0
S01007930,Rented or living rent free: Private rented or living rent free,15,13,10,3,7,3,0,2,1,0,1,0,0
S01007931,All HRPs aged 16 and over,481,306,255,41,214,44,7,175,147,1,7,16,4
S01007931,Owned: Total,340,241,201,24,177,38,2,99,96,0,1,2,0
S01007931,Owned: Owned outright,155,70,57,14,43,13,0,85,85,0,0,0,0
S01007931,Owned: Owned with a mortgage or loan or shared ownership,185,171,144,10,134,25,2,14,11,0,1,2,0
S01007931,Rented or living rent free: Total,141,65,54,17,37,6,5,76,51,1,6,14,4
S01007931,Rented or living rent free: Social rented,117,46,40,14,26,4,2,71,48,1,5,14,3
S01007931,Rented or living rent free: Private rented or living rent free,24,19,14,3,11,2,3,5,3,0,1,0,1
S01007932,All HRPs aged 16 and over,364,220,176,20,156,38,6,144,136,3,2,3,0
S01007932,Owned: Total,336,203,163,16,147,38,2,133,130,1,1,1,0
S01007932,Owned: Owned outright,186,73,54,10,44,17,2,113,112,0,0,1,0
S01007932,Owned: Owned with a mortgage or loan or shared ownership,150,130,109,6,103,21,0,20,18,1,1,0,0
S01007932,Rented or living rent free: Total,28,17,13,4,9,0,4,11,6,2,1,2,0
S01007932,Rented or living rent free: Social rented,15,5,3,2,1,0,2,10,5,2,1,2,0
S01007932,Rented or living rent free: Private rented or living rent free,13,12,10,2,8,0,2,1,1,0,0,0,0
S01007933,All HRPs aged 16 and over,316,233,193,26,167,30,10,83,67,5,1,8,2
S01007933,Owned: Total,270,204,173,17,156,28,3,66,60,1,1,3,1
S01007933,Owned: Owned outright,100,45,35,3,32,9,1,55,54,0,0,1,0
S01007933,Owned: Owned with a mortgage or loan or shared ownership,170,159,138,14,124,19,2,11,6,1,1,2,1
S01007933,Rented or living rent free: Total,46,29,20,9,11,2,7,17,7,4,0,5,1
S01007933,Rented or living rent free: Social rented,14,9,7,4,3,1,1,5,5,0,0,0,0
S01007933,Rented or living rent free: Private rented or living rent free,32,20,13,5,8,1,6,12,2,4,0,5,1
S01007934,All HRPs aged 16 and over,300,191,148,20,128,27,16,109,84,2,6,11,6
S01007934,Owned: Total,186,139,113,9,104,23,3,47,43,0,0,2,2
S01007934,Owned: Owned outright,60,27,18,4,14,8,1,33,31,0,0,1,1
S01007934,Owned: Owned with a mortgage or loan or shared ownership,126,112,95,5,90,15,2,14,12,0,0,1,1
S01007934,Rented or living rent free: Total,114,52,35,11,24,4,13,62,41,2,6,9,4
S01007934,Rented or living rent free: Social rented,93,37,26,9,17,2,9,56,38,2,3,9,4
S01007934,Rented or living rent free: Private rented or living rent free,21,15,9,2,7,2,4,6,3,0,3,0,0
S01007935,All HRPs aged 16 and over,444,262,200,21,179,34,28,182,131,1,13,25,12
S01007935,Owned: Total,226,159,129,11,118,25,5,67,62,0,1,1,3
S01007935,Owned: Owned outright,89,32,22,6,16,9,1,57,54,0,1,0,2
S01007935,Owned: Owned with a mortgage or loan or shared ownership,137,127,107,5,102,16,4,10,8,0,0,1,1
S01007935,Rented or living rent free: Total,218,103,71,10,61,9,23,115,69,1,12,24,9
S01007935,Rented or living rent free: Social rented,115,29,18,3,15,2,9,86,63,1,5,13,4
S01007935,Rented or living rent free: Private rented or living rent free,103,74,53,7,46,7,14,29,6,0,7,11,5
S01007936,All HRPs aged 16 and over,389,299,256,22,234,37,6,90,81,1,2,3,3
S01007936,Owned: Total,328,252,217,15,202,35,0,76,71,1,2,0,2
S01007936,Owned: Owned outright,126,60,49,7,42,11,0,66,63,1,0,0,2
S01007936,Owned: Owned with a mortgage or loan or shared ownership,202,192,168,8,160,24,0,10,8,0,2,0,0
S01007936,Rented or living rent free: Total,61,47,39,7,32,2,6,14,10,0,0,3,1
S01007936,Rented or living rent free: Social rented,6,1,0,0,0,0,1,5,2,0,0,3,0
S01007936,Rented or living rent free: Private rented or living rent free,55,46,39,7,32,2,5,9,8,0,0,0,1
S01007937,All HRPs aged 16 and over,435,310,252,30,222,50,8,125,106,3,3,10,3
S01007937,Owned: Total,373,275,225,23,202,45,5,98,95,0,1,2,0
S01007937,Owned: Owned outright,150,63,48,7,41,12,3,87,87,0,0,0,0
S01007937,Owned: Owned with a mortgage or loan or shared ownership,223,212,177,16,161,33,2,11,8,0,1,2,0
S01007937,Rented or living rent free: Total,62,35,27,7,20,5,3,27,11,3,2,8,3
S01007937,Rented or living rent free: Social rented,14,6,5,2,3,0,1,8,2,0,1,3,2
S01007937,Rented or living rent free: Private rented or living rent free,48,29,22,5,17,5,2,19,9,3,1,5,1
S01007938,All HRPs aged 16 and over,372,218,176,34,142,25,17,154,126,3,5,18,2
S01007938,Owned: Total,235,146,125,18,107,19,2,89,84,0,2,3,0
S01007938,Owned: Owned outright,106,37,30,4,26,5,2,69,67,0,0,2,0
S01007938,Owned: Owned with a mortgage or loan or shared ownership,129,109,95,14,81,14,0,20,17,0,2,1,0
S01007938,Rented or living rent free: Total,137,72,51,16,35,6,15,65,42,3,3,15,2
S01007938,Rented or living rent free: Social rented,102,51,39,13,26,5,7,51,37,1,1,11,1
S01007938,Rented or living rent free: Private rented or living rent free,35,21,12,3,9,1,8,14,5,2,2,4,1
S01007939,All HRPs aged 16 and over,412,260,200,42,158,20,40,152,120,3,8,16,5
S01007939,Owned: Total,202,127,113,13,100,11,3,75,73,1,0,1,0
S01007939,Owned: Owned outright,92,29,26,5,21,3,0,63,63,0,0,0,0
S01007939,Owned: Owned with a mortgage or loan or shared ownership,110,98,87,8,79,8,3,12,10,1,0,1,0
S01007939,Rented or living rent free: Total,210,133,87,29,58,9,37,77,47,2,8,15,5
S01007939,Rented or living rent free: Social rented,182,116,76,25,51,7,33,66,43,2,4,14,3
S01007939,Rented or living rent free: Private rented or living rent free,28,17,11,4,7,2,4,11,4,0,4,1,2
S01007940,All HRPs aged 16 and over,497,295,238,29,209,33,24,202,155,2,10,28,7
S01007940,Owned: Total,326,212,181,19,162,29,2,114,103,1,1,7,2
S01007940,Owned: Owned outright,138,42,31,5,26,10,1,96,90,0,1,3,2
S01007940,Owned: Owned with a mortgage or loan or shared ownership,188,170,150,14,136,19,1,18,13,1,0,4,0
S01007940,Rented or living rent free: Total,171,83,57,10,47,4,22,88,52,1,9,21,5
S01007940,Rented or living rent free: Social rented,138,62,43,7,36,2,17,76,44,1,8,19,4
S01007940,Rented or living rent free: Private rented or living rent free,33,21,14,3,11,2,5,12,8,0,1,2,1
S01007941,All HRPs aged 16 and over,257,185,154,15,139,23,8,72,64,1,2,4,1
S01007941,Owned: Total,238,175,146,14,132,23,6,63,61,1,0,1,0
S01007941,Owned: Owned outright,118,61,50,8,42,9,2,57,57,0,0,0,0
S01007941,Owned: Owned with a mortgage or loan or shared ownership,120,114,96,6,90,14,4,6,4,1,0,1,0
S01007941,Rented or living rent free: Total,19,10,8,1,7,0,2,9,3,0,2,3,1
S01007941,Rented or living rent free: Social rented,7,3,1,0,1,0,2,4,1,0,0,3,0
S01007941,Rented or living rent free: Private rented or living rent free,12,7,7,1,6,0,0,5,2,0,2,0,1
S01007942,All HRPs aged 16 and over,207,152,127,22,105,14,11,55,32,2,7,11,3
S01007942,Owned: Total,121,104,91,10,81,12,1,17,16,0,0,0,1
S01007942,Owned: Owned outright,27,15,12,4,8,3,0,12,12,0,0,0,0
S01007942,Owned: Owned with a mortgage or loan or shared ownership,94,89,79,6,73,9,1,5,4,0,0,0,1
S01007942,Rented or living rent free: Total,86,48,36,12,24,2,10,38,16,2,7,11,2
S01007942,Rented or living rent free: Social rented,46,23,17,2,15,0,6,23,13,1,1,7,1
S01007942,Rented or living rent free: Private rented or living rent free,40,25,19,10,9,2,4,15,3,1,6,4,1
S01007943,All HRPs aged 16 and over,319,178,142,21,121,21,15,141,118,1,7,10,5
S01007943,Owned: Total,225,136,116,13,103,17,3,89,83,0,1,3,2
S01007943,Owned: Owned outright,114,42,34,9,25,8,0,72,68,0,0,2,2
S01007943,Owned: Owned with a mortgage or loan or shared ownership,111,94,82,4,78,9,3,17,15,0,1,1,0
S01007943,Rented or living rent free: Total,94,42,26,8,18,4,12,52,35,1,6,7,3
S01007943,Rented or living rent free: Social rented,51,21,13,4,9,2,6,30,22,1,1,4,2
S01007943,Rented or living rent free: Private rented or living rent free,43,21,13,4,9,2,6,22,13,0,5,3,1
S01007944,All HRPs aged 16 and over,442,273,209,27,182,36,28,169,137,1,8,14,9
S01007944,Owned: Total,271,179,148,11,137,25,6,92,88,1,1,1,1
S01007944,Owned: Owned outright,104,35,26,1,25,7,2,69,67,0,0,1,1
S01007944,Owned: Owned with a mortgage or loan or shared ownership,167,144,122,10,112,18,4,23,21,1,1,0,0
S01007944,Rented or living rent free: Total,171,94,61,16,45,11,22,77,49,0,7,13,8
S01007944,Rented or living rent free: Social rented,118,73,52,14,38,8,13,45,32,0,0,9,4
S01007944,Rented or living rent free: Private rented or living rent free,53,21,9,2,7,3,9,32,17,0,7,4,4
S01007945,All HRPs aged 16 and over,443,256,182,29,153,38,36,187,133,2,7,39,6
S01007945,Owned: Total,243,161,124,18,106,33,4,82,70,1,1,7,3
S01007945,Owned: Owned outright,116,45,30,7,23,14,1,71,63,1,0,4,3
S01007945,Owned: Owned with a mortgage or loan or shared ownership,127,116,94,11,83,19,3,11,7,0,1,3,0
S01007945,Rented or living rent free: Total,200,95,58,11,47,5,32,105,63,1,6,32,3
S01007945,Rented or living rent free: Social rented,145,61,36,7,29,3,22,84,56,1,3,23,1
S01007945,Rented or living rent free: Private rented or living rent free,55,34,22,4,18,2,10,21,7,0,3,9,2
S01007946,All HRPs aged 16 and over,396,250,186,37,149,31,33,146,95,1,9,29,12
S01007946,Owned: Total,232,154,130,20,110,18,6,78,65,1,1,7,4
S01007946,Owned: Owned outright,103,40,35,8,27,4,1,63,55,0,0,4,4
S01007946,Owned: Owned with a mortgage or loan or shared ownership,129,114,95,12,83,14,5,15,10,1,1,3,0
S01007946,Rented or living rent free: Total,164,96,56,17,39,13,27,68,30,0,8,22,8
S01007946,Rented or living rent free: Social rented,114,63,40,15,25,5,18,51,25,0,2,18,6
S01007946,Rented or living rent free: Private rented or living rent free,50,33,16,2,14,8,9,17,5,0,6,4,2
S01007947,All HRPs aged 16 and over,327,209,159,22,137,30,20,118,99,0,3,14,2
S01007947,Owned: Total,252,169,133,17,116,27,9,83,81,0,1,0,1
S01007947,Owned: Owned outright,119,45,31,9,22,11,3,74,74,0,0,0,0
S01007947,Owned: Owned with a mortgage or loan or shared ownership,133,124,102,8,94,16,6,9,7,0,1,0,1
S01007947,Rented or living rent free: Total,75,40,26,5,21,3,11,35,18,0,2,14,1
S01007947,Rented or living rent free: Social rented,48,28,19,5,14,0,9,20,14,0,0,6,0
S01007947,Rented or living rent free: Private rented or living rent free,27,12,7,0,7,3,2,15,4,0,2,8,1
S01007948,All HRPs aged 16 and over,304,164,111,17,94,21,32,140,80,2,15,34,9
S01007948,Owned: Total,125,84,65,7,58,17,2,41,38,0,1,2,0
S01007948,Owned: Owned outright,61,27,18,3,15,8,1,34,32,0,0,2,0
S01007948,Owned: Owned with a mortgage or loan or shared ownership,64,57,47,4,43,9,1,7,6,0,1,0,0
S01007948,Rented or living rent free: Total,179,80,46,10,36,4,30,99,42,2,14,32,9
S01007948,Rented or living rent free: Social rented,156,72,41,10,31,2,29,84,40,2,10,26,6
S01007948,Rented or living rent free: Private rented or living rent free,23,8,5,0,5,2,1,15,2,0,4,6,3
S01007949,All HRPs aged 16 and over,347,211,182,26,156,19,10,136,118,2,3,9,4
S01007949,Owned: Total,277,176,155,20,135,19,2,101,95,0,1,4,1
S01007949,Owned: Owned outright,135,52,45,11,34,7,0,83,78,0,1,3,1
S01007949,Owned: Owned with a mortgage or loan or shared ownership,142,124,110,9,101,12,2,18,17,0,0,1,0
S01007949,Rented or living rent free: Total,70,35,27,6,21,0,8,35,23,2,2,5,3
S01007949,Rented or living rent free: Social rented,42,16,10,2,8,0,6,26,18,1,1,4,2
S01007949,Rented or living rent free: Private rented or living rent free,28,19,17,4,13,0,2,9,5,1,1,1,1
S01007950,All HRPs aged 16 and over,376,252,206,19,187,39,7,124,105,2,7,7,3
S01007950,Owned: Total,324,221,182,11,171,36,3,103,93,1,6,2,1
S01007950,Owned: Owned outright,147,66,52,4,48,12,2,81,75,0,5,0,1
S01007950,Owned: Owned with a mortgage or loan or shared ownership,177,155,130,7,123,24,1,22,18,1,1,2,0
S01007950,Rented or living rent free: Total,52,31,24,8,16,3,4,21,12,1,1,5,2
S01007950,Rented or living rent free: Social rented,22,12,8,4,4,1,3,10,6,1,0,3,0
S01007950,Rented or living rent free: Private rented or living rent free,30,19,16,4,12,2,1,11,6,0,1,2,2
S01007951,All HRPs aged 16 and over,321,215,181,21,160,24,10,106,88,2,4,9,3
S01007951,Owned: Total,246,165,145,13,132,20,0,81,73,1,1,3,3
S01007951,Owned: Owned outright,96,29,26,6,20,3,0,67,63,0,1,1,2
S01007951,Owned: Owned with a mortgage or loan or shared ownership,150,136,119,7,112,17,0,14,10,1,0,2,1
S01007951,Rented or living rent free: Total,75,50,36,8,28,4,10,25,15,1,3,6,0
S01007951,Rented or living rent free: Social rented,52,34,25,8,17,2,7,18,12,0,1,5,0
S01007951,Rented or living rent free: Private rented or living rent free,23,16,11,0,11,2,3,7,3,1,2,1,0
S01007952,All HRPs aged 16 and over,357,189,132,25,107,29,28,168,131,2,3,20,12
S01007952,Owned: Total,142,108,80,12,68,25,3,34,31,1,0,1,1
S01007952,Owned: Owned outright,56,27,17,6,11,9,1,29,27,1,0,0,1
S01007952,Owned: Owned with a mortgage or loan or shared ownership,86,81,63,6,57,16,2,5,4,0,0,1,0
S01007952,Rented or living rent free: Total,215,81,52,13,39,4,25,134,100,1,3,19,11
S01007952,Rented or living rent free: Social rented,171,53,38,12,26,3,12,118,91,1,1,15,10
S01007952,Rented or living rent free: Private rented or living rent free,44,28,14,1,13,1,13,16,9,0,2,4,1
S01007953,All HRPs aged 16 and over,414,262,219,38,181,30,13,152,113,7,6,21,5
S01007953,Owned: Total,252,190,166,21,145,22,2,62,54,2,1,4,1
S01007953,Owned: Owned outright,78,34,26,9,17,7,1,44,40,2,0,2,0
S01007953,Owned: Owned with a mortgage or loan or shared ownership,174,156,140,12,128,15,1,18,14,0,1,2,1
S01007953,Rented or living rent free: Total,162,72,53,17,36,8,11,90,59,5,5,17,4
S01007953,Rented or living rent free: Social rented,124,55,44,15,29,5,6,69,52,1,1,12,3
S01007953,Rented or living rent free: Private rented or living rent free,38,17,9,2,7,3,5,21,7,4,4,5,1
S01007954,All HRPs aged 16 and over,324,195,154,34,120,9,32,129,61,5,7,41,15
S01007954,Owned: Total,127,93,85,14,71,7,1,34,29,2,0,3,0
S01007954,Owned: Owned outright,40,17,13,3,10,3,1,23,23,0,0,0,0
S01007954,Owned: Owned with a mortgage or loan or shared ownership,87,76,72,11,61,4,0,11,6,2,0,3,0
S01007954,Rented or living rent free: Total,197,102,69,20,49,2,31,95,32,3,7,38,15
S01007954,Rented or living rent free: Social rented,177,88,62,18,44,2,24,89,30,3,6,36,14
S01007954,Rented or living rent free: Private rented or living rent free,20,14,7,2,5,0,7,6,2,0,1,2,1
S01007955,All HRPs aged 16 and over,322,230,185,41,144,19,26,92,64,2,8,12,6
S01007955,Owned: Total,159,122,107,11,96,12,3,37,37,0,0,0,0
S01007955,Owned: Owned outright,56,25,18,2,16,6,1,31,31,0,0,0,0
S01007955,Owned: Owned with a mortgage or loan or shared ownership,103,97,89,9,80,6,2,6,6,0,0,0,0
S01007955,Rented or living rent free: Total,163,108,78,30,48,7,23,55,27,2,8,12,6
S01007955,Rented or living rent free: Social rented,142,95,71,27,44,5,19,47,24,2,6,10,5
S01007955,Rented or living rent free: Private rented or living rent free,21,13,7,3,4,2,4,8,3,0,2,2,1
S01007956,All HRPs aged 16 and over,297,194,153,38,115,19,22,103,80,3,8,9,3
S01007956,Owned: Total,152,110,90,12,78,16,4,42,40,0,0,1,1
S01007956,Owned: Owned outright,45,20,15,3,12,2,3,25,25,0,0,0,0
S01007956,Owned: Owned with a mortgage or loan or shared ownership,107,90,75,9,66,14,1,17,15,0,0,1,1
S01007956,Rented or living rent free: Total,145,84,63,26,37,3,18,61,40,3,8,8,2
S01007956,Rented or living rent free: Social rented,123,66,51,20,31,2,13,57,36,3,8,8,2
S01007956,Rented or living rent free: Private rented or living rent free,22,18,12,6,6,1,5,4,4,0,0,0,0
S01007957,All HRPs aged 16 and over,455,241,204,39,165,19,18,214,159,4,3,40,8
S01007957,Owned: Total,239,157,139,23,116,17,1,82,77,0,1,3,1
S01007957,Owned: Owned outright,97,34,29,8,21,4,1,63,60,0,0,2,1
S01007957,Owned: Owned with a mortgage or loan or shared ownership,142,123,110,15,95,13,0,19,17,0,1,1,0
S01007957,Rented or living rent free: Total,216,84,65,16,49,2,17,132,82,4,2,37,7
S01007957,Rented or living rent free: Social rented,185,62,45,10,35,1,16,123,77,2,2,36,6
S01007957,Rented or living rent free: Private rented or living rent free,31,22,20,6,14,1,1,9,5,2,0,1,1
S01007958,All HRPs aged 16 and over,388,253,190,32,158,16,47,135,82,0,12,34,7
S01007958,Owned: Total,173,125,110,9,101,12,3,48,43,0,1,3,1
S01007958,Owned: Owned outright,55,20,14,1,13,4,2,35,31,0,1,2,1
S01007958,Owned: Owned with a mortgage or loan or shared ownership,118,105,96,8,88,8,1,13,12,0,0,1,0
S01007958,Rented or living rent free: Total,215,128,80,23,57,4,44,87,39,0,11,31,6
S01007958,Rented or living rent free: Social rented,194,118,71,21,50,4,43,76,36,0,10,27,3
S01007958,Rented or living rent free: Private rented or living rent free,21,10,9,2,7,0,1,11,3,0,1,4,3
S01007959,All HRPs aged 16 and over,380,226,195,31,164,21,10,154,143,0,0,8,3
S01007959,Owned: Total,320,198,174,27,147,19,5,122,116,0,0,4,2
S01007959,Owned: Owned outright,156,62,50,13,37,9,3,94,91,0,0,2,1
S01007959,Owned: Owned with a mortgage or loan or shared ownership,164,136,124,14,110,10,2,28,25,0,0,2,1
S01007959,Rented or living rent free: Total,60,28,21,4,17,2,5,32,27,0,0,4,1
S01007959,Rented or living rent free: Social rented,40,15,13,4,9,0,2,25,21,0,0,3,1
S01007959,Rented or living rent free: Private rented or living rent free,20,13,8,0,8,2,3,7,6,0,0,1,0
S01007960,All HRPs aged 16 and over,291,193,166,33,133,13,14,98,70,0,10,17,1
S01007960,Owned: Total,171,126,116,18,98,9,1,45,38,0,2,5,0
S01007960,Owned: Owned outright,57,25,23,4,19,1,1,32,30,0,1,1,0
S01007960,Owned: Owned with a mortgage or loan or shared ownership,114,101,93,14,79,8,0,13,8,0,1,4,0
S01007960,Rented or living rent free: Total,120,67,50,15,35,4,13,53,32,0,8,12,1
S01007960,Rented or living rent free: Social rented,108,60,45,13,32,2,13,48,31,0,5,11,1
S01007960,Rented or living rent free: Private rented or living rent free,12,7,5,2,3,2,0,5,1,0,3,1,0
S01007961,All HRPs aged 16 and over,278,213,110,15,95,101,2,65,55,0,4,4,2
S01007961,Owned: Total,206,162,75,10,65,87,0,44,42,0,2,0,0
S01007961,Owned: Owned outright,117,81,31,7,24,50,0,36,35,0,1,0,0
S01007961,Owned: Owned with a mortgage or loan or shared ownership,89,81,44,3,41,37,0,8,7,0,1,0,0
S01007961,Rented or living rent free: Total,72,51,35,5,30,14,2,21,13,0,2,4,2
S01007961,Rented or living rent free: Social rented,16,8,6,3,3,1,1,8,3,0,0,3,2
S01007961,Rented or living rent free: Private rented or living rent free,56,43,29,2,27,13,1,13,10,0,2,1,0
S01007962,All HRPs aged 16 and over,246,169,130,27,103,20,19,77,40,1,11,15,10
S01007962,Owned: Total,146,116,92,14,78,19,5,30,26,0,1,2,1
S01007962,Owned: Owned outright,35,16,9,4,5,6,1,19,18,0,0,1,0
S01007962,Owned: Owned with a mortgage or loan or shared ownership,111,100,83,10,73,13,4,11,8,0,1,1,1
S01007962,Rented or living rent free: Total,100,53,38,13,25,1,14,47,14,1,10,13,9
S01007962,Rented or living rent free: Social rented,73,38,25,9,16,1,12,35,13,0,5,12,5
S01007962,Rented or living rent free: Private rented or living rent free,27,15,13,4,9,0,2,12,1,1,5,1,4
S01007963,All HRPs aged 16 and over,408,217,136,48,88,13,68,191,83,7,36,57,8
S01007963,Owned: Total,66,41,32,5,27,7,2,25,22,0,2,1,0
S01007963,Owned: Owned outright,32,13,11,2,9,2,0,19,17,0,2,0,0
S01007963,Owned: Owned with a mortgage or loan or shared ownership,34,28,21,3,18,5,2,6,5,0,0,1,0
S01007963,Rented or living rent free: Total,342,176,104,43,61,6,66,166,61,7,34,56,8
S01007963,Rented or living rent free: Social rented,323,168,98,43,55,6,64,155,60,6,29,52,8
S01007963,Rented or living rent free: Private rented or living rent free,19,8,6,0,6,0,2,11,1,1,5,4,0
S01007964,All HRPs aged 16 and over,353,197,153,42,111,16,28,156,110,2,18,18,8
S01007964,Owned: Total,166,100,87,18,69,9,4,66,61,0,0,4,1
S01007964,Owned: Owned outright,72,25,23,8,15,1,1,47,43,0,0,3,1
S01007964,Owned: Owned with a mortgage or loan or shared ownership,94,75,64,10,54,8,3,19,18,0,0,1,0
S01007964,Rented or living rent free: Total,187,97,66,24,42,7,24,90,49,2,18,14,7
S01007964,Rented or living rent free: Social rented,162,88,60,21,39,6,22,74,42,1,10,14,7
S01007964,Rented or living rent free: Private rented or living rent free,25,9,6,3,3,1,2,16,7,1,8,0,0
S01007965,All HRPs aged 16 and over,256,142,119,24,95,8,15,114,73,2,11,23,5
S01007965,Owned: Total,123,84,75,8,67,6,3,39,36,1,0,1,1
S01007965,Owned: Owned outright,45,19,18,4,14,0,1,26,25,0,0,0,1
S01007965,Owned: Owned with a mortgage or loan or shared ownership,78,65,57,4,53,6,2,13,11,1,0,1,0
S01007965,Rented or living rent free: Total,133,58,44,16,28,2,12,75,37,1,11,22,4
S01007965,Rented or living rent free: Social rented,119,49,37,16,21,2,10,70,36,1,8,21,4
S01007965,Rented or living rent free: Private rented or living rent free,14,9,7,0,7,0,2,5,1,0,3,1,0
S01007966,All HRPs aged 16 and over,418,227,184,56,128,12,31,191,116,2,22,37,14
S01007966,Owned: Total,154,92,82,9,73,8,2,62,58,0,0,2,2
S01007966,Owned: Owned outright,63,17,14,3,11,3,0,46,42,0,0,2,2
S01007966,Owned: Owned with a mortgage or loan or shared ownership,91,75,68,6,62,5,2,16,16,0,0,0,0
S01007966,Rented or living rent free: Total,264,135,102,47,55,4,29,129,58,2,22,35,12
S01007966,Rented or living rent free: Social rented,242,121,93,43,50,4,24,121,57,1,19,32,12
S01007966,Rented or living rent free: Private rented or living rent free,22,14,9,4,5,0,5,8,1,1,3,3,0
S01007967,All HRPs aged 16 and over,245,161,123,47,76,11,27,84,43,5,12,17,7
S01007967,Owned: Total,70,55,44,8,36,9,2,15,12,1,0,2,0
S01007967,Owned: Owned outright,18,8,6,0,6,1,1,10,10,0,0,0,0
S01007967,Owned: Owned with a mortgage or loan or shared ownership,52,47,38,8,30,8,1,5,2,1,0,2,0
S01007967,Rented or living rent free: Total,175,106,79,39,40,2,25,69,31,4,12,15,7
S01007967,Rented or living rent free: Social rented,159,97,72,37,35,1,24,62,28,3,11,13,7
S01007967,Rented or living rent free: Private rented or living rent free,16,9,7,2,5,1,1,7,3,1,1,2,0
S01007968,All HRPs aged 16 and over,397,224,194,40,154,17,13,173,141,1,5,23,3
S01007968,Owned: Total,270,171,152,23,129,16,3,99,96,0,1,2,0
S01007968,Owned: Owned outright,106,33,29,8,21,4,0,73,71,0,1,1,0
S01007968,Owned: Owned with a mortgage or loan or shared ownership,164,138,123,15,108,12,3,26,25,0,0,1,0
S01007968,Rented or living rent free: Total,127,53,42,17,25,1,10,74,45,1,4,21,3
S01007968,Rented or living rent free: Social rented,101,40,33,12,21,1,6,61,41,1,1,16,2
S01007968,Rented or living rent free: Private rented or living rent free,26,13,9,5,4,0,4,13,4,0,3,5,1
S01007969,All HRPs aged 16 and over,390,210,176,34,142,18,16,180,135,5,10,21,9
S01007969,Owned: Total,223,141,123,17,106,14,4,82,75,1,2,1,3
S01007969,Owned: Owned outright,98,30,25,8,17,3,2,68,63,1,1,1,2
S01007969,Owned: Owned with a mortgage or loan or shared ownership,125,111,98,9,89,11,2,14,12,0,1,0,1
S01007969,Rented or living rent free: Total,167,69,53,17,36,4,12,98,60,4,8,20,6
S01007969,Rented or living rent free: Social rented,150,62,49,16,33,3,10,88,58,3,4,18,5
S01007969,Rented or living rent free: Private rented or living rent free,17,7,4,1,3,1,2,10,2,1,4,2,1
S01007970,All HRPs aged 16 and over,408,260,223,37,186,17,20,148,117,1,5,17,8
S01007970,Owned: Total,232,164,149,20,129,12,3,68,63,0,2,1,2
S01007970,Owned: Owned outright,78,28,25,6,19,2,1,50,48,0,0,1,1
S01007970,Owned: Owned with a mortgage or loan or shared ownership,154,136,124,14,110,10,2,18,15,0,2,0,1
S01007970,Rented or living rent free: Total,176,96,74,17,57,5,17,80,54,1,3,16,6
S01007970,Rented or living rent free: Social rented,137,70,57,15,42,3,10,67,47,1,2,13,4
S01007970,Rented or living rent free: Private rented or living rent free,39,26,17,2,15,2,7,13,7,0,1,3,2
S01007971,All HRPs aged 16 and over,469,254,204,34,170,16,34,215,168,3,9,29,6
S01007971,Owned: Total,221,139,127,14,113,9,3,82,80,0,0,2,0
S01007971,Owned: Owned outright,81,26,24,3,21,2,0,55,54,0,0,1,0
S01007971,Owned: Owned with a mortgage or loan or shared ownership,140,113,103,11,92,7,3,27,26,0,0,1,0
S01007971,Rented or living rent free: Total,248,115,77,20,57,7,31,133,88,3,9,27,6
S01007971,Rented or living rent free: Social rented,214,96,64,16,48,4,28,118,83,3,2,25,5
S01007971,Rented or living rent free: Private rented or living rent free,34,19,13,4,9,3,3,15,5,0,7,2,1
S01007972,All HRPs aged 16 and over,377,232,199,38,161,19,14,145,127,1,4,10,3
S01007972,Owned: Total,236,157,143,14,129,11,3,79,75,1,0,1,2
S01007972,Owned: Owned outright,74,19,16,2,14,2,1,55,51,1,0,1,2
S01007972,Owned: Owned with a mortgage or loan or shared ownership,162,138,127,12,115,9,2,24,24,0,0,0,0
S01007972,Rented or living rent free: Total,141,75,56,24,32,8,11,66,52,0,4,9,1
S01007972,Rented or living rent free: Social rented,110,57,42,18,24,5,10,53,42,0,3,7,1
S01007972,Rented or living rent free: Private rented or living rent free,31,18,14,6,8,3,1,13,10,0,1,2,0
S01007973,All HRPs aged 16 and over,355,246,223,22,201,21,2,109,102,0,2,5,0
S01007973,Owned: Total,342,238,218,21,197,20,0,104,100,0,1,3,0
S01007973,Owned: Owned outright,167,76,70,15,55,6,0,91,87,0,1,3,0
S01007973,Owned: Owned with a mortgage or loan or shared ownership,175,162,148,6,142,14,0,13,13,0,0,0,0
S01007973,Rented or living rent free: Total,13,8,5,1,4,1,2,5,2,0,1,2,0
S01007973,Rented or living rent free: Social rented,5,4,3,0,3,1,0,1,0,0,0,1,0
S01007973,Rented or living rent free: Private rented or living rent free,8,4,2,1,1,0,2,4,2,0,1,1,0
S01007974,All HRPs aged 16 and over,426,228,190,47,143,15,23,198,135,3,4,47,9
S01007974,Owned: Total,179,113,102,16,86,9,2,66,58,0,1,6,1
S01007974,Owned: Owned outright,70,23,20,6,14,3,0,47,42,0,0,4,1
S01007974,Owned: Owned with a mortgage or loan or shared ownership,109,90,82,10,72,6,2,19,16,0,1,2,0
S01007974,Rented or living rent free: Total,247,115,88,31,57,6,21,132,77,3,3,41,8
S01007974,Rented or living rent free: Social rented,215,96,74,28,46,3,19,119,73,3,3,36,4
S01007974,Rented or living rent free: Private rented or living rent free,32,19,14,3,11,3,2,13,4,0,0,5,4
S01007975,All HRPs aged 16 and over,324,184,152,33,119,13,19,140,112,3,5,18,2
S01007975,Owned: Total,179,113,101,17,84,8,4,66,65,1,0,0,0
S01007975,Owned: Owned outright,69,20,20,5,15,0,0,49,48,1,0,0,0
S01007975,Owned: Owned with a mortgage or loan or shared ownership,110,93,81,12,69,8,4,17,17,0,0,0,0
S01007975,Rented or living rent free: Total,145,71,51,16,35,5,15,74,47,2,5,18,2
S01007975,Rented or living rent free: Social rented,98,38,27,10,17,4,7,60,42,0,2,15,1
S01007975,Rented or living rent free: Private rented or living rent free,47,33,24,6,18,1,8,14,5,2,3,3,1
S01007976,All HRPs aged 16 and over,456,243,188,25,163,19,36,213,165,2,4,33,9
S01007976,Owned: Total,212,122,103,11,92,12,7,90,82,0,1,3,4
S01007976,Owned: Owned outright,105,35,28,6,22,5,2,70,67,0,0,1,2
S01007976,Owned: Owned with a mortgage or loan or shared ownership,107,87,75,5,70,7,5,20,15,0,1,2,2
S01007976,Rented or living rent free: Total,244,121,85,14,71,7,29,123,83,2,3,30,5
S01007976,Rented or living rent free: Social rented,175,70,45,9,36,2,23,105,76,0,2,24,3
S01007976,Rented or living rent free: Private rented or living rent free,69,51,40,5,35,5,6,18,7,2,1,6,2
S01007977,All HRPs aged 16 and over,304,218,191,33,158,22,5,86,72,1,0,11,2
S01007977,Owned: Total,222,160,140,25,115,19,1,62,60,1,0,1,0
S01007977,Owned: Owned outright,80,33,26,9,17,6,1,47,47,0,0,0,0
S01007977,Owned: Owned with a mortgage or loan or shared ownership,142,127,114,16,98,13,0,15,13,1,0,1,0
S01007977,Rented or living rent free: Total,82,58,51,8,43,3,4,24,12,0,0,10,2
S01007977,Rented or living rent free: Social rented,42,21,17,5,12,1,3,21,9,0,0,10,2
S01007977,Rented or living rent free: Private rented or living rent free,40,37,34,3,31,2,1,3,3,0,0,0,0
S01007978,All HRPs aged 16 and over,353,243,202,26,176,14,27,110,80,0,2,21,7
S01007978,Owned: Total,180,141,127,10,117,10,4,39,32,0,1,4,2
S01007978,Owned: Owned outright,49,21,20,6,14,0,1,28,24,0,0,2,2
S01007978,Owned: Owned with a mortgage or loan or shared ownership,131,120,107,4,103,10,3,11,8,0,1,2,0
S01007978,Rented or living rent free: Total,173,102,75,16,59,4,23,71,48,0,1,17,5
S01007978,Rented or living rent free: Social rented,71,16,9,1,8,1,6,55,41,0,0,12,2
S01007978,Rented or living rent free: Private rented or living rent free,102,86,66,15,51,3,17,16,7,0,1,5,3
S01007979,All HRPs aged 16 and over,363,241,196,17,179,37,8,122,109,2,3,7,1
S01007979,Owned: Total,294,198,163,12,151,33,2,96,93,0,1,1,1
S01007979,Owned: Owned outright,121,40,32,7,25,7,1,81,78,0,1,1,1
S01007979,Owned: Owned with a mortgage or loan or shared ownership,173,158,131,5,126,26,1,15,15,0,0,0,0
S01007979,Rented or living rent free: Total,69,43,33,5,28,4,6,26,16,2,2,6,0
S01007979,Rented or living rent free: Social rented,31,17,14,3,11,0,3,14,12,0,0,2,0
S01007979,Rented or living rent free: Private rented or living rent free,38,26,19,2,17,4,3,12,4,2,2,4,0
S01007980,All HRPs aged 16 and over,340,200,164,21,143,28,8,140,126,0,1,8,5
S01007980,Owned: Total,257,161,136,17,119,23,2,96,93,0,0,2,1
S01007980,Owned: Owned outright,118,47,33,7,26,14,0,71,70,0,0,1,0
S01007980,Owned: Owned with a mortgage or loan or shared ownership,139,114,103,10,93,9,2,25,23,0,0,1,1
S01007980,Rented or living rent free: Total,83,39,28,4,24,5,6,44,33,0,1,6,4
S01007980,Rented or living rent free: Social rented,57,23,17,3,14,1,5,34,27,0,0,6,1
S01007980,Rented or living rent free: Private rented or living rent free,26,16,11,1,10,4,1,10,6,0,1,0,3
S01007981,All HRPs aged 16 and over,252,142,115,17,98,23,4,110,105,1,0,1,3
S01007981,Owned: Total,239,134,108,12,96,23,3,105,101,1,0,0,3
S01007981,Owned: Owned outright,151,55,43,9,34,10,2,96,94,0,0,0,2
S01007981,Owned: Owned with a mortgage or loan or shared ownership,88,79,65,3,62,13,1,9,7,1,0,0,1
S01007981,Rented or living rent free: Total,13,8,7,5,2,0,1,5,4,0,0,1,0
S01007981,Rented or living rent free: Social rented,5,3,3,2,1,0,0,2,2,0,0,0,0
S01007981,Rented or living rent free: Private rented or living rent free,8,5,4,3,1,0,1,3,2,0,0,1,0
S01007982,All HRPs aged 16 and over,210,127,108,13,95,16,3,83,75,0,2,5,1
S01007982,Owned: Total,183,111,94,10,84,15,2,72,70,0,1,0,1
S01007982,Owned: Owned outright,103,38,32,4,28,5,1,65,64,0,1,0,0
S01007982,Owned: Owned with a mortgage or loan or shared ownership,80,73,62,6,56,10,1,7,6,0,0,0,1
S01007982,Rented or living rent free: Total,27,16,14,3,11,1,1,11,5,0,1,5,0
S01007982,Rented or living rent free: Social rented,24,13,11,3,8,1,1,11,5,0,1,5,0
S01007982,Rented or living rent free: Private rented or living rent free,3,3,3,0,3,0,0,0,0,0,0,0,0
S01007983,All HRPs aged 16 and over,387,196,154,48,106,17,25,191,161,3,8,13,6
S01007983,Owned: Total,171,86,75,11,64,10,1,85,80,0,0,3,2
S01007983,Owned: Owned outright,88,24,18,6,12,5,1,64,62,0,0,2,0
S01007983,Owned: Owned with a mortgage or loan or shared ownership,83,62,57,5,52,5,0,21,18,0,0,1,2
S01007983,Rented or living rent free: Total,216,110,79,37,42,7,24,106,81,3,8,10,4
S01007983,Rented or living rent free: Social rented,197,96,69,34,35,6,21,101,77,3,7,10,4
S01007983,Rented or living rent free: Private rented or living rent free,19,14,10,3,7,1,3,5,4,0,1,0,0
S01007984,All HRPs aged 16 and over,374,216,186,32,154,20,10,158,137,2,8,9,2
S01007984,Owned: Total,277,171,150,20,130,18,3,106,100,0,2,3,1
S01007984,Owned: Owned outright,126,41,37,11,26,3,1,85,81,0,1,3,0
S01007984,Owned: Owned with a mortgage or loan or shared ownership,151,130,113,9,104,15,2,21,19,0,1,0,1
S01007984,Rented or living rent free: Total,97,45,36,12,24,2,7,52,37,2,6,6,1
S01007984,Rented or living rent free: Social rented,77,36,29,8,21,1,6,41,33,0,3,4,1
S01007984,Rented or living rent free: Private rented or living rent free,20,9,7,4,3,1,1,11,4,2,3,2,0
S01007985,All HRPs aged 16 and over,412,234,187,38,149,18,29,178,123,4,14,30,7
S01007985,Owned: Total,197,110,96,7,89,14,0,87,82,1,1,2,1
S01007985,Owned: Owned outright,80,24,19,4,15,5,0,56,53,1,0,1,1
S01007985,Owned: Owned with a mortgage or loan or shared ownership,117,86,77,3,74,9,0,31,29,0,1,1,0
S01007985,Rented or living rent free: Total,215,124,91,31,60,4,29,91,41,3,13,28,6
S01007985,Rented or living rent free: Social rented,188,110,81,29,52,3,26,78,40,2,6,25,5
S01007985,Rented or living rent free: Private rented or living rent free,27,14,10,2,8,1,3,13,1,1,7,3,1
S01007986,All HRPs aged 16 and over,238,142,128,23,105,12,2,96,87,2,5,1,1
S01007986,Owned: Total,172,105,95,15,80,9,1,67,67,0,0,0,0
S01007986,Owned: Owned outright,64,15,13,3,10,2,0,49,49,0,0,0,0
S01007986,Owned: Owned with a mortgage or loan or shared ownership,108,90,82,12,70,7,1,18,18,0,0,0,0
S01007986,Rented or living rent free: Total,66,37,33,8,25,3,1,29,20,2,5,1,1
S01007986,Rented or living rent free: Social rented,47,25,22,5,17,2,1,22,17,2,2,0,1
S01007986,Rented or living rent free: Private rented or living rent free,19,12,11,3,8,1,0,7,3,0,3,1,0
S01007987,All HRPs aged 16 and over,313,224,196,36,160,18,10,89,77,3,0,7,2
S01007987,Owned: Total,252,187,169,25,144,16,2,65,61,0,0,3,1
S01007987,Owned: Owned outright,99,47,40,8,32,6,1,52,51,0,0,1,0
S01007987,Owned: Owned with a mortgage or loan or shared ownership,153,140,129,17,112,10,1,13,10,0,0,2,1
S01007987,Rented or living rent free: Total,61,37,27,11,16,2,8,24,16,3,0,4,1
S01007987,Rented or living rent free: Social rented,40,22,14,5,9,2,6,18,14,0,0,4,0
S01007987,Rented or living rent free: Private rented or living rent free,21,15,13,6,7,0,2,6,2,3,0,0,1
S01007988,All HRPs aged 16 and over,336,204,174,40,134,15,15,132,105,0,12,11,4
S01007988,Owned: Total,228,154,140,29,111,12,2,74,70,0,0,3,1
S01007988,Owned: Owned outright,78,30,26,7,19,4,0,48,45,0,0,2,1
S01007988,Owned: Owned with a mortgage or loan or shared ownership,150,124,114,22,92,8,2,26,25,0,0,1,0
S01007988,Rented or living rent free: Total,108,50,34,11,23,3,13,58,35,0,12,8,3
S01007988,Rented or living rent free: Social rented,87,39,30,10,20,3,6,48,33,0,6,6,3
S01007988,Rented or living rent free: Private rented or living rent free,21,11,4,1,3,0,7,10,2,0,6,2,0
S01007989,All HRPs aged 16 and over,289,208,176,42,134,17,15,81,48,1,14,15,3
S01007989,Owned: Total,163,128,113,15,98,15,0,35,32,0,0,3,0
S01007989,Owned: Owned outright,50,27,23,6,17,4,0,23,22,0,0,1,0
S01007989,Owned: Owned with a mortgage or loan or shared ownership,113,101,90,9,81,11,0,12,10,0,0,2,0
S01007989,Rented or living rent free: Total,126,80,63,27,36,2,15,46,16,1,14,12,3
S01007989,Rented or living rent free: Social rented,79,51,43,17,26,1,7,28,14,1,6,6,1
S01007989,Rented or living rent free: Private rented or living rent free,47,29,20,10,10,1,8,18,2,0,8,6,2
S01007990,All HRPs aged 16 and over,339,262,226,38,188,17,19,77,42,3,11,15,6
S01007990,Owned: Total,241,209,190,22,168,14,5,32,31,0,0,1,0
S01007990,Owned: Owned outright,52,24,20,1,19,2,2,28,28,0,0,0,0
S01007990,Owned: Owned with a mortgage or loan or shared ownership,189,185,170,21,149,12,3,4,3,0,0,1,0
S01007990,Rented or living rent free: Total,98,53,36,16,20,3,14,45,11,3,11,14,6
S01007990,Rented or living rent free: Social rented,60,31,25,14,11,2,4,29,10,3,5,6,5
S01007990,Rented or living rent free: Private rented or living rent free,38,22,11,2,9,1,10,16,1,0,6,8,1
S01007991,All HRPs aged 16 and over,334,304,262,18,244,35,7,30,27,1,1,1,0
S01007991,Owned: Total,305,280,240,16,224,34,6,25,24,0,1,0,0
S01007991,Owned: Owned outright,73,52,39,6,33,9,4,21,21,0,0,0,0
S01007991,Owned: Owned with a mortgage or loan or shared ownership,232,228,201,10,191,25,2,4,3,0,1,0,0
S01007991,Rented or living rent free: Total,29,24,22,2,20,1,1,5,3,1,0,1,0
S01007991,Rented or living rent free: Social rented,7,4,3,1,2,0,1,3,2,0,0,1,0
S01007991,Rented or living rent free: Private rented or living rent free,22,20,19,1,18,1,0,2,1,1,0,0,0
S01007992,All HRPs aged 16 and over,224,205,177,9,168,27,1,19,14,1,2,1,1
S01007992,Owned: Total,208,191,166,8,158,24,1,17,14,1,1,0,1
S01007992,Owned: Owned outright,41,27,20,3,17,7,0,14,12,1,1,0,0
S01007992,Owned: Owned with a mortgage or loan or shared ownership,167,164,146,5,141,17,1,3,2,0,0,0,1
S01007992,Rented or living rent free: Total,16,14,11,1,10,3,0,2,0,0,1,1,0
S01007992,Rented or living rent free: Social rented,2,1,1,0,1,0,0,1,0,0,1,0,0
S01007992,Rented or living rent free: Private rented or living rent free,14,13,10,1,9,3,0,1,0,0,0,1,0
S01007993,All HRPs aged 16 and over,329,249,220,27,193,26,3,80,73,0,3,1,3
S01007993,Owned: Total,305,235,210,21,189,23,2,70,67,0,1,0,2
S01007993,Owned: Owned outright,133,70,61,12,49,8,1,63,60,0,1,0,2
S01007993,Owned: Owned with a mortgage or loan or shared ownership,172,165,149,9,140,15,1,7,7,0,0,0,0
S01007993,Rented or living rent free: Total,24,14,10,6,4,3,1,10,6,0,2,1,1
S01007993,Rented or living rent free: Social rented,11,4,2,1,1,1,1,7,5,0,1,1,0
S01007993,Rented or living rent free: Private rented or living rent free,13,10,8,5,3,2,0,3,1,0,1,0,1
S01007994,All HRPs aged 16 and over,293,268,236,17,219,29,3,25,18,1,2,3,1
S01007994,Owned: Total,266,247,219,15,204,26,2,19,16,0,0,3,0
S01007994,Owned: Owned outright,42,27,20,6,14,6,1,15,13,0,0,2,0
S01007994,Owned: Owned with a mortgage or loan or shared ownership,224,220,199,9,190,20,1,4,3,0,0,1,0
S01007994,Rented or living rent free: Total,27,21,17,2,15,3,1,6,2,1,2,0,1
S01007994,Rented or living rent free: Social rented,11,7,5,2,3,1,1,4,2,0,1,0,1
S01007994,Rented or living rent free: Private rented or living rent free,16,14,12,0,12,2,0,2,0,1,1,0,0
S01007995,All HRPs aged 16 and over,309,262,240,20,220,19,3,47,38,1,2,5,1
S01007995,Owned: Total,294,253,234,17,217,18,1,41,37,1,0,2,1
S01007995,Owned: Owned outright,71,37,34,9,25,3,0,34,32,0,0,1,1
S01007995,Owned: Owned with a mortgage or loan or shared ownership,223,216,200,8,192,15,1,7,5,1,0,1,0
S01007995,Rented or living rent free: Total,15,9,6,3,3,1,2,6,1,0,2,3,0
S01007995,Rented or living rent free: Social rented,5,3,3,1,2,0,0,2,0,0,1,1,0
S01007995,Rented or living rent free: Private rented or living rent free,10,6,3,2,1,1,2,4,1,0,1,2,0
S01007996,All HRPs aged 16 and over,187,130,99,15,84,28,3,57,49,0,3,4,1
S01007996,Owned: Total,164,116,89,12,77,26,1,48,46,0,0,1,1
S01007996,Owned: Owned outright,82,38,27,7,20,10,1,44,42,0,0,1,1
S01007996,Owned: Owned with a mortgage or loan or shared ownership,82,78,62,5,57,16,0,4,4,0,0,0,0
S01007996,Rented or living rent free: Total,23,14,10,3,7,2,2,9,3,0,3,3,0
S01007996,Rented or living rent free: Social rented,9,4,2,1,1,1,1,5,1,0,1,3,0
S01007996,Rented or living rent free: Private rented or living rent free,14,10,8,2,6,1,1,4,2,0,2,0,0
S01007997,All HRPs aged 16 and over,296,177,135,15,120,37,5,119,115,0,1,3,0
S01007997,Owned: Total,274,156,119,12,107,33,4,118,115,0,1,2,0
S01007997,Owned: Owned outright,162,58,39,9,30,15,4,104,101,0,1,2,0
S01007997,Owned: Owned with a mortgage or loan or shared ownership,112,98,80,3,77,18,0,14,14,0,0,0,0
S01007997,Rented or living rent free: Total,22,21,16,3,13,4,1,1,0,0,0,1,0
S01007997,Rented or living rent free: Social rented,4,4,3,1,2,1,0,0,0,0,0,0,0
S01007997,Rented or living rent free: Private rented or living rent free,18,17,13,2,11,3,1,1,0,0,0,1,0
S01007998,All HRPs aged 16 and over,225,157,121,11,110,29,7,68,62,0,2,2,2
S01007998,Owned: Total,194,133,104,9,95,28,1,61,59,0,0,0,2
S01007998,Owned: Owned outright,98,43,29,4,25,14,0,55,54,0,0,0,1
S01007998,Owned: Owned with a mortgage or loan or shared ownership,96,90,75,5,70,14,1,6,5,0,0,0,1
S01007998,Rented or living rent free: Total,31,24,17,2,15,1,6,7,3,0,2,2,0
S01007998,Rented or living rent free: Social rented,13,7,5,1,4,0,2,6,3,0,1,2,0
S01007998,Rented or living rent free: Private rented or living rent free,18,17,12,1,11,1,4,1,0,0,1,0,0
S01007999,All HRPs aged 16 and over,301,187,149,33,116,22,16,114,70,2,9,23,10
S01007999,Owned: Total,133,96,77,13,64,16,3,37,34,0,1,1,1
S01007999,Owned: Owned outright,39,14,11,3,8,3,0,25,23,0,1,0,1
S01007999,Owned: Owned with a mortgage or loan or shared ownership,94,82,66,10,56,13,3,12,11,0,0,1,0
S01007999,Rented or living rent free: Total,168,91,72,20,52,6,13,77,36,2,8,22,9
S01007999,Rented or living rent free: Social rented,145,76,62,18,44,4,10,69,32,1,8,20,8
S01007999,Rented or living rent free: Private rented or living rent free,23,15,10,2,8,2,3,8,4,1,0,2,1
S01008000,All HRPs aged 16 and over,390,230,190,46,144,11,29,160,101,5,10,36,8
S01008000,Owned: Total,133,98,88,16,72,8,2,35,32,0,0,2,1
S01008000,Owned: Owned outright,50,25,19,3,16,6,0,25,22,0,0,2,1
S01008000,Owned: Owned with a mortgage or loan or shared ownership,83,73,69,13,56,2,2,10,10,0,0,0,0
S01008000,Rented or living rent free: Total,257,132,102,30,72,3,27,125,69,5,10,34,7
S01008000,Rented or living rent free: Social rented,241,126,98,28,70,3,25,115,68,2,9,30,6
S01008000,Rented or living rent free: Private rented or living rent free,16,6,4,2,2,0,2,10,1,3,1,4,1
S01008001,All HRPs aged 16 and over,372,207,152,39,113,9,46,165,82,8,21,36,18
S01008001,Owned: Total,95,59,56,6,50,3,0,36,32,0,1,2,1
S01008001,Owned: Owned outright,34,9,9,2,7,0,0,25,23,0,1,0,1
S01008001,Owned: Owned with a mortgage or loan or shared ownership,61,50,47,4,43,3,0,11,9,0,0,2,0
S01008001,Rented or living rent free: Total,277,148,96,33,63,6,46,129,50,8,20,34,17
S01008001,Rented or living rent free: Social rented,261,140,90,32,58,6,44,121,48,7,18,34,14
S01008001,Rented or living rent free: Private rented or living rent free,16,8,6,1,5,0,2,8,2,1,2,0,3
S01008002,All HRPs aged 16 and over,330,215,145,39,106,17,53,115,53,6,10,37,9
S01008002,Owned: Total,87,72,58,9,49,10,4,15,12,1,0,2,0
S01008002,Owned: Owned outright,31,23,16,6,10,5,2,8,7,0,0,1,0
S01008002,Owned: Owned with a mortgage or loan or shared ownership,56,49,42,3,39,5,2,7,5,1,0,1,0
S01008002,Rented or living rent free: Total,243,143,87,30,57,7,49,100,41,5,10,35,9
S01008002,Rented or living rent free: Social rented,232,138,83,28,55,7,48,94,36,5,10,34,9
S01008002,Rented or living rent free: Private rented or living rent free,11,5,4,2,2,0,1,6,5,0,0,1,0
S01008003,All HRPs aged 16 and over,241,172,139,15,124,22,11,69,42,3,7,16,1
S01008003,Owned: Total,138,112,94,5,89,16,2,26,25,0,0,0,1
S01008003,Owned: Owned outright,28,7,5,1,4,1,1,21,21,0,0,0,0
S01008003,Owned: Owned with a mortgage or loan or shared ownership,110,105,89,4,85,15,1,5,4,0,0,0,1
S01008003,Rented or living rent free: Total,103,60,45,10,35,6,9,43,17,3,7,16,0
S01008003,Rented or living rent free: Social rented,74,39,30,8,22,3,6,35,16,0,5,14,0
S01008003,Rented or living rent free: Private rented or living rent free,29,21,15,2,13,3,3,8,1,3,2,2,0
S01008004,All HRPs aged 16 and over,230,192,168,20,148,16,8,38,23,1,4,8,2
S01008004,Owned: Total,158,145,130,9,121,15,0,13,13,0,0,0,0
S01008004,Owned: Owned outright,22,13,12,4,8,1,0,9,9,0,0,0,0
S01008004,Owned: Owned with a mortgage or loan or shared ownership,136,132,118,5,113,14,0,4,4,0,0,0,0
S01008004,Rented or living rent free: Total,72,47,38,11,27,1,8,25,10,1,4,8,2
S01008004,Rented or living rent free: Social rented,32,12,12,5,7,0,0,20,10,1,0,7,2
S01008004,Rented or living rent free: Private rented or living rent free,40,35,26,6,20,1,8,5,0,0,4,1,0
S01008005,All HRPs aged 16 and over,220,191,161,27,134,21,9,29,5,3,10,8,3
S01008005,Owned: Total,124,119,102,4,98,15,2,5,3,0,0,1,1
S01008005,Owned: Owned outright,9,7,5,1,4,2,0,2,2,0,0,0,0
S01008005,Owned: Owned with a mortgage or loan or shared ownership,115,112,97,3,94,13,2,3,1,0,0,1,1
S01008005,Rented or living rent free: Total,96,72,59,23,36,6,7,24,2,3,10,7,2
S01008005,Rented or living rent free: Social rented,77,55,44,19,25,5,6,22,2,3,8,7,2
S01008005,Rented or living rent free: Private rented or living rent free,19,17,15,4,11,1,1,2,0,0,2,0,0
S01008006,All HRPs aged 16 and over,248,118,84,18,66,13,21,130,62,2,13,39,14
S01008006,Owned: Total,51,30,26,2,24,3,1,21,19,0,0,2,0
S01008006,Owned: Owned outright,17,5,3,1,2,1,1,12,12,0,0,0,0
S01008006,Owned: Owned with a mortgage or loan or shared ownership,34,25,23,1,22,2,0,9,7,0,0,2,0
S01008006,Rented or living rent free: Total,197,88,58,16,42,10,20,109,43,2,13,37,14
S01008006,Rented or living rent free: Social rented,185,81,53,14,39,9,19,104,43,2,9,37,13
S01008006,Rented or living rent free: Private rented or living rent free,12,7,5,2,3,1,1,5,0,0,4,0,1
S01008007,All HRPs aged 16 and over,208,134,99,21,78,7,28,74,19,3,12,36,4
S01008007,Owned: Total,79,66,62,10,52,4,0,13,8,1,1,3,0
S01008007,Owned: Owned outright,27,17,14,4,10,3,0,10,8,0,0,2,0
S01008007,Owned: Owned with a mortgage or loan or shared ownership,52,49,48,6,42,1,0,3,0,1,1,1,0
S01008007,Rented or living rent free: Total,129,68,37,11,26,3,28,61,11,2,11,33,4
S01008007,Rented or living rent free: Social rented,70,35,21,4,17,3,11,35,6,1,5,19,4
S01008007,Rented or living rent free: Private rented or living rent free,59,33,16,7,9,0,17,26,5,1,6,14,0
S01008008,All HRPs aged 16 and over,267,166,128,22,106,16,22,101,36,4,15,31,15
S01008008,Owned: Total,68,58,51,3,48,6,1,10,10,0,0,0,0
S01008008,Owned: Owned outright,12,9,8,0,8,1,0,3,3,0,0,0,0
S01008008,Owned: Owned with a mortgage or loan or shared ownership,56,49,43,3,40,5,1,7,7,0,0,0,0
S01008008,Rented or living rent free: Total,199,108,77,19,58,10,21,91,26,4,15,31,15
S01008008,Rented or living rent free: Social rented,184,99,72,18,54,8,19,85,25,4,14,31,11
S01008008,Rented or living rent free: Private rented or living rent free,15,9,5,1,4,2,2,6,1,0,1,0,4
S01008009,All HRPs aged 16 and over,373,234,179,47,132,21,34,139,52,7,18,48,14
S01008009,Owned: Total,102,80,73,11,62,7,0,22,17,0,1,3,1
S01008009,Owned: Owned outright,33,15,14,6,8,1,0,18,16,0,0,1,1
S01008009,Owned: Owned with a mortgage or loan or shared ownership,69,65,59,5,54,6,0,4,1,0,1,2,0
S01008009,Rented or living rent free: Total,271,154,106,36,70,14,34,117,35,7,17,45,13
S01008009,Rented or living rent free: Social rented,231,128,88,35,53,12,28,103,29,7,17,39,11
S01008009,Rented or living rent free: Private rented or living rent free,40,26,18,1,17,2,6,14,6,0,0,6,2
S01008010,All HRPs aged 16 and over,476,313,222,38,184,31,60,163,74,4,11,56,18
S01008010,Owned: Total,204,164,140,13,127,22,2,40,38,0,0,1,1
S01008010,Owned: Owned outright,63,28,25,5,20,2,1,35,33,0,0,1,1
S01008010,Owned: Owned with a mortgage or loan or shared ownership,141,136,115,8,107,20,1,5,5,0,0,0,0
S01008010,Rented or living rent free: Total,272,149,82,25,57,9,58,123,36,4,11,55,17
S01008010,Rented or living rent free: Social rented,220,115,59,19,40,3,53,105,29,3,7,49,17
S01008010,Rented or living rent free: Private rented or living rent free,52,34,23,6,17,6,5,18,7,1,4,6,0
S01008011,All HRPs aged 16 and over,455,222,164,27,137,13,45,233,177,3,2,47,4
S01008011,Owned: Total,116,58,49,8,41,5,4,58,55,1,0,2,0
S01008011,Owned: Owned outright,59,13,11,4,7,1,1,46,44,0,0,2,0
S01008011,Owned: Owned with a mortgage or loan or shared ownership,57,45,38,4,34,4,3,12,11,1,0,0,0
S01008011,Rented or living rent free: Total,339,164,115,19,96,8,41,175,122,2,2,45,4
S01008011,Rented or living rent free: Social rented,261,91,53,15,38,5,33,170,121,2,2,42,3
S01008011,Rented or living rent free: Private rented or living rent free,78,73,62,4,58,3,8,5,1,0,0,3,1
S01008012,All HRPs aged 16 and over,471,314,246,36,210,38,30,157,98,9,1,37,12
S01008012,Owned: Total,223,155,128,8,120,21,6,68,59,2,0,5,2
S01008012,Owned: Owned outright,86,32,22,2,20,6,4,54,50,1,0,3,0
S01008012,Owned: Owned with a mortgage or loan or shared ownership,137,123,106,6,100,15,2,14,9,1,0,2,2
S01008012,Rented or living rent free: Total,248,159,118,28,90,17,24,89,39,7,1,32,10
S01008012,Rented or living rent free: Social rented,76,29,23,7,16,1,5,47,25,2,0,16,4
S01008012,Rented or living rent free: Private rented or living rent free,172,130,95,21,74,16,19,42,14,5,1,16,6
S01008013,All HRPs aged 16 and over,363,224,185,24,161,26,13,139,105,2,3,24,5
S01008013,Owned: Total,173,134,116,12,104,15,3,39,39,0,0,0,0
S01008013,Owned: Owned outright,50,18,13,3,10,4,1,32,32,0,0,0,0
S01008013,Owned: Owned with a mortgage or loan or shared ownership,123,116,103,9,94,11,2,7,7,0,0,0,0
S01008013,Rented or living rent free: Total,190,90,69,12,57,11,10,100,66,2,3,24,5
S01008013,Rented or living rent free: Social rented,93,18,16,3,13,0,2,75,59,0,0,13,3
S01008013,Rented or living rent free: Private rented or living rent free,97,72,53,9,44,11,8,25,7,2,3,11,2
S01008014,All HRPs aged 16 and over,312,204,170,20,150,19,15,108,91,1,1,11,4
S01008014,Owned: Total,220,152,134,13,121,15,3,68,65,0,0,2,1
S01008014,Owned: Owned outright,92,32,28,5,23,3,1,60,58,0,0,1,1
S01008014,Owned: Owned with a mortgage or loan or shared ownership,128,120,106,8,98,12,2,8,7,0,0,1,0
S01008014,Rented or living rent free: Total,92,52,36,7,29,4,12,40,26,1,1,9,3
S01008014,Rented or living rent free: Social rented,40,13,8,2,6,1,4,27,17,1,1,6,2
S01008014,Rented or living rent free: Private rented or living rent free,52,39,28,5,23,3,8,13,9,0,0,3,1
S01008015,All HRPs aged 16 and over,437,253,214,28,186,12,27,184,119,2,12,43,8
S01008015,Owned: Total,206,142,130,12,118,6,6,64,57,0,1,3,3
S01008015,Owned: Owned outright,71,26,20,5,15,4,2,45,42,0,0,2,1
S01008015,Owned: Owned with a mortgage or loan or shared ownership,135,116,110,7,103,2,4,19,15,0,1,1,2
S01008015,Rented or living rent free: Total,231,111,84,16,68,6,21,120,62,2,11,40,5
S01008015,Rented or living rent free: Social rented,135,45,31,11,20,1,13,90,54,2,4,26,4
S01008015,Rented or living rent free: Private rented or living rent free,96,66,53,5,48,5,8,30,8,0,7,14,1
S01008016,All HRPs aged 16 and over,433,239,194,38,156,26,19,194,155,4,5,26,4
S01008016,Owned: Total,256,150,131,23,108,16,3,106,97,0,2,6,1
S01008016,Owned: Owned outright,117,34,29,10,19,3,2,83,77,0,1,4,1
S01008016,Owned: Owned with a mortgage or loan or shared ownership,139,116,102,13,89,13,1,23,20,0,1,2,0
S01008016,Rented or living rent free: Total,177,89,63,15,48,10,16,88,58,4,3,20,3
S01008016,Rented or living rent free: Social rented,117,43,34,9,25,4,5,74,55,2,0,14,3
S01008016,Rented or living rent free: Private rented or living rent free,60,46,29,6,23,6,11,14,3,2,3,6,0
S01008017,All HRPs aged 16 and over,375,206,172,18,154,32,2,169,160,1,3,1,4
S01008017,Owned: Total,351,194,162,15,147,32,0,157,152,1,1,1,2
S01008017,Owned: Owned outright,209,62,52,8,44,10,0,147,144,1,0,0,2
S01008017,Owned: Owned with a mortgage or loan or shared ownership,142,132,110,7,103,22,0,10,8,0,1,1,0
S01008017,Rented or living rent free: Total,24,12,10,3,7,0,2,12,8,0,2,0,2
S01008017,Rented or living rent free: Social rented,6,3,2,1,1,0,1,3,1,0,1,0,1
S01008017,Rented or living rent free: Private rented or living rent free,18,9,8,2,6,0,1,9,7,0,1,0,1
S01008018,All HRPs aged 16 and over,308,177,146,24,122,26,5,131,126,2,0,2,1
S01008018,Owned: Total,271,150,125,19,106,22,3,121,120,0,0,1,0
S01008018,Owned: Owned outright,169,59,42,13,29,14,3,110,109,0,0,1,0
S01008018,Owned: Owned with a mortgage or loan or shared ownership,102,91,83,6,77,8,0,11,11,0,0,0,0
S01008018,Rented or living rent free: Total,37,27,21,5,16,4,2,10,6,2,0,1,1
S01008018,Rented or living rent free: Social rented,3,1,0,0,0,0,1,2,2,0,0,0,0
S01008018,Rented or living rent free: Private rented or living rent free,34,26,21,5,16,4,1,8,4,2,0,1,1
S01008019,All HRPs aged 16 and over,271,185,141,16,125,43,1,86,74,0,1,8,3
S01008019,Owned: Total,236,163,120,9,111,42,1,73,66,0,0,5,2
S01008019,Owned: Owned outright,102,35,27,3,24,8,0,67,60,0,0,5,2
S01008019,Owned: Owned with a mortgage or loan or shared ownership,134,128,93,6,87,34,1,6,6,0,0,0,0
S01008019,Rented or living rent free: Total,35,22,21,7,14,1,0,13,8,0,1,3,1
S01008019,Rented or living rent free: Social rented,10,2,2,1,1,0,0,8,6,0,0,1,1
S01008019,Rented or living rent free: Private rented or living rent free,25,20,19,6,13,1,0,5,2,0,1,2,0
S01008020,All HRPs aged 16 and over,313,227,190,23,167,29,8,86,70,0,1,12,3
S01008020,Owned: Total,233,167,139,16,123,26,2,66,62,0,0,4,0
S01008020,Owned: Owned outright,81,29,27,5,22,2,0,52,50,0,0,2,0
S01008020,Owned: Owned with a mortgage or loan or shared ownership,152,138,112,11,101,24,2,14,12,0,0,2,0
S01008020,Rented or living rent free: Total,80,60,51,7,44,3,6,20,8,0,1,8,3
S01008020,Rented or living rent free: Social rented,10,4,4,0,4,0,0,6,2,0,1,2,1
S01008020,Rented or living rent free: Private rented or living rent free,70,56,47,7,40,3,6,14,6,0,0,6,2
S01008021,All HRPs aged 16 and over,244,152,118,17,101,31,3,92,86,0,3,1,2
S01008021,Owned: Total,221,138,105,13,92,31,2,83,80,0,1,1,1
S01008021,Owned: Owned outright,121,42,32,9,23,9,1,79,77,0,1,0,1
S01008021,Owned: Owned with a mortgage or loan or shared ownership,100,96,73,4,69,22,1,4,3,0,0,1,0
S01008021,Rented or living rent free: Total,23,14,13,4,9,0,1,9,6,0,2,0,1
S01008021,Rented or living rent free: Social rented,4,3,3,1,2,0,0,1,1,0,0,0,0
S01008021,Rented or living rent free: Private rented or living rent free,19,11,10,3,7,0,1,8,5,0,2,0,1
S01008022,All HRPs aged 16 and over,286,197,168,17,151,28,1,89,83,0,2,1,3
S01008022,Owned: Total,272,186,157,15,142,28,1,86,82,0,1,0,3
S01008022,Owned: Owned outright,142,63,50,11,39,13,0,79,76,0,1,0,2
S01008022,Owned: Owned with a mortgage or loan or shared ownership,130,123,107,4,103,15,1,7,6,0,0,0,1
S01008022,Rented or living rent free: Total,14,11,11,2,9,0,0,3,1,0,1,1,0
S01008022,Rented or living rent free: Social rented,1,0,0,0,0,0,0,1,1,0,0,0,0
S01008022,Rented or living rent free: Private rented or living rent free,13,11,11,2,9,0,0,2,0,0,1,1,0
S01008023,All HRPs aged 16 and over,246,205,166,15,151,35,4,41,41,0,0,0,0
S01008023,Owned: Total,237,199,161,13,148,35,3,38,38,0,0,0,0
S01008023,Owned: Owned outright,66,33,28,6,22,3,2,33,33,0,0,0,0
S01008023,Owned: Owned with a mortgage or loan or shared ownership,171,166,133,7,126,32,1,5,5,0,0,0,0
S01008023,Rented or living rent free: Total,9,6,5,2,3,0,1,3,3,0,0,0,0
S01008023,Rented or living rent free: Social rented,2,0,0,0,0,0,0,2,2,0,0,0,0
S01008023,Rented or living rent free: Private rented or living rent free,7,6,5,2,3,0,1,1,1,0,0,0,0
S01008024,All HRPs aged 16 and over,224,212,182,11,171,27,3,12,9,1,0,2,0
S01008024,Owned: Total,202,193,167,9,158,24,2,9,8,1,0,0,0
S01008024,Owned: Owned outright,22,17,13,1,12,3,1,5,4,1,0,0,0
S01008024,Owned: Owned with a mortgage or loan or shared ownership,180,176,154,8,146,21,1,4,4,0,0,0,0
S01008024,Rented or living rent free: Total,22,19,15,2,13,3,1,3,1,0,0,2,0
S01008024,Rented or living rent free: Social rented,9,7,5,1,4,1,1,2,0,0,0,2,0
S01008024,Rented or living rent free: Private rented or living rent free,13,12,10,1,9,2,0,1,1,0,0,0,0
S01008025,All HRPs aged 16 and over,283,213,183,24,159,27,3,70,66,0,2,2,0
S01008025,Owned: Total,266,202,173,20,153,26,3,64,63,0,0,1,0
S01008025,Owned: Owned outright,107,51,44,9,35,6,1,56,55,0,0,1,0
S01008025,Owned: Owned with a mortgage or loan or shared ownership,159,151,129,11,118,20,2,8,8,0,0,0,0
S01008025,Rented or living rent free: Total,17,11,10,4,6,1,0,6,3,0,2,1,0
S01008025,Rented or living rent free: Social rented,6,1,1,0,1,0,0,5,3,0,1,1,0
S01008025,Rented or living rent free: Private rented or living rent free,11,10,9,4,5,1,0,1,0,0,1,0,0
S01008026,All HRPs aged 16 and over,466,289,241,42,199,30,18,177,143,0,9,22,3
S01008026,Owned: Total,274,197,168,23,145,25,4,77,72,0,2,3,0
S01008026,Owned: Owned outright,102,37,29,5,24,8,0,65,63,0,0,2,0
S01008026,Owned: Owned with a mortgage or loan or shared ownership,172,160,139,18,121,17,4,12,9,0,2,1,0
S01008026,Rented or living rent free: Total,192,92,73,19,54,5,14,100,71,0,7,19,3
S01008026,Rented or living rent free: Social rented,142,62,52,13,39,1,9,80,60,0,4,14,2
S01008026,Rented or living rent free: Private rented or living rent free,50,30,21,6,15,4,5,20,11,0,3,5,1
S01008027,All HRPs aged 16 and over,259,156,137,21,116,8,11,103,85,1,8,7,2
S01008027,Owned: Total,154,96,90,10,80,5,1,58,56,1,0,0,1
S01008027,Owned: Owned outright,72,22,21,1,20,1,0,50,49,0,0,0,1
S01008027,Owned: Owned with a mortgage or loan or shared ownership,82,74,69,9,60,4,1,8,7,1,0,0,0
S01008027,Rented or living rent free: Total,105,60,47,11,36,3,10,45,29,0,8,7,1
S01008027,Rented or living rent free: Social rented,79,42,34,7,27,0,8,37,28,0,5,3,1
S01008027,Rented or living rent free: Private rented or living rent free,26,18,13,4,9,3,2,8,1,0,3,4,0
S01008028,All HRPs aged 16 and over,239,170,140,11,129,24,6,69,56,2,5,4,2
S01008028,Owned: Total,180,147,121,7,114,23,3,33,30,0,2,0,1
S01008028,Owned: Owned outright,49,20,16,2,14,4,0,29,28,0,1,0,0
S01008028,Owned: Owned with a mortgage or loan or shared ownership,131,127,105,5,100,19,3,4,2,0,1,0,1
S01008028,Rented or living rent free: Total,59,23,19,4,15,1,3,36,26,2,3,4,1
S01008028,Rented or living rent free: Social rented,42,11,9,2,7,1,1,31,24,2,1,3,1
S01008028,Rented or living rent free: Private rented or living rent free,17,12,10,2,8,0,2,5,2,0,2,1,0
S01008029,All HRPs aged 16 and over,345,248,184,25,159,59,5,97,77,0,1,19,0
S01008029,Owned: Total,240,183,131,12,119,51,1,57,53,0,1,3,0
S01008029,Owned: Owned outright,123,75,44,8,36,30,1,48,45,0,1,2,0
S01008029,Owned: Owned with a mortgage or loan or shared ownership,117,108,87,4,83,21,0,9,8,0,0,1,0
S01008029,Rented or living rent free: Total,105,65,53,13,40,8,4,40,24,0,0,16,0
S01008029,Rented or living rent free: Social rented,45,26,21,8,13,3,2,19,13,0,0,6,0
S01008029,Rented or living rent free: Private rented or living rent free,60,39,32,5,27,5,2,21,11,0,0,10,0
S01008030,All HRPs aged 16 and over,476,293,230,28,202,52,11,183,160,0,4,14,5
S01008030,Owned: Total,369,242,192,21,171,46,4,127,122,0,0,4,1
S01008030,Owned: Owned outright,174,68,47,11,36,18,3,106,103,0,0,3,0
S01008030,Owned: Owned with a mortgage or loan or shared ownership,195,174,145,10,135,28,1,21,19,0,0,1,1
S01008030,Rented or living rent free: Total,107,51,38,7,31,6,7,56,38,0,4,10,4
S01008030,Rented or living rent free: Social rented,74,30,24,5,19,3,3,44,29,0,4,8,3
S01008030,Rented or living rent free: Private rented or living rent free,33,21,14,2,12,3,4,12,9,0,0,2,1
S01008031,All HRPs aged 16 and over,403,241,198,38,160,27,16,162,123,2,9,22,6
S01008031,Owned: Total,226,159,134,16,118,19,6,67,62,0,0,4,1
S01008031,Owned: Owned outright,96,43,35,10,25,6,2,53,51,0,0,2,0
S01008031,Owned: Owned with a mortgage or loan or shared ownership,130,116,99,6,93,13,4,14,11,0,0,2,1
S01008031,Rented or living rent free: Total,177,82,64,22,42,8,10,95,61,2,9,18,5
S01008031,Rented or living rent free: Social rented,148,64,50,16,34,6,8,84,56,2,8,15,3
S01008031,Rented or living rent free: Private rented or living rent free,29,18,14,6,8,2,2,11,5,0,1,3,2
S01008032,All HRPs aged 16 and over,377,254,223,36,187,23,8,123,95,0,5,17,6
S01008032,Owned: Total,258,190,172,22,150,16,2,68,61,0,0,6,1
S01008032,Owned: Owned outright,107,53,47,12,35,5,1,54,50,0,0,3,1
S01008032,Owned: Owned with a mortgage or loan or shared ownership,151,137,125,10,115,11,1,14,11,0,0,3,0
S01008032,Rented or living rent free: Total,119,64,51,14,37,7,6,55,34,0,5,11,5
S01008032,Rented or living rent free: Social rented,97,49,39,11,28,4,6,48,32,0,3,8,5
S01008032,Rented or living rent free: Private rented or living rent free,22,15,12,3,9,3,0,7,2,0,2,3,0
S01008033,All HRPs aged 16 and over,269,229,163,16,147,63,3,40,38,0,1,0,1
S01008033,Owned: Total,246,209,146,13,133,61,2,37,35,0,1,0,1
S01008033,Owned: Owned outright,90,57,42,7,35,15,0,33,31,0,1,0,1
S01008033,Owned: Owned with a mortgage or loan or shared ownership,156,152,104,6,98,46,2,4,4,0,0,0,0
S01008033,Rented or living rent free: Total,23,20,17,3,14,2,1,3,3,0,0,0,0
S01008033,Rented or living rent free: Social rented,8,7,7,2,5,0,0,1,1,0,0,0,0
S01008033,Rented or living rent free: Private rented or living rent free,15,13,10,1,9,2,1,2,2,0,0,0,0
S01008034,All HRPs aged 16 and over,271,225,176,14,162,46,3,46,38,0,6,0,2
S01008034,Owned: Total,259,216,169,13,156,46,1,43,38,0,4,0,1
S01008034,Owned: Owned outright,78,41,30,5,25,11,0,37,35,0,2,0,0
S01008034,Owned: Owned with a mortgage or loan or shared ownership,181,175,139,8,131,35,1,6,3,0,2,0,1
S01008034,Rented or living rent free: Total,12,9,7,1,6,0,2,3,0,0,2,0,1
S01008034,Rented or living rent free: Social rented,2,0,0,0,0,0,0,2,0,0,1,0,1
S01008034,Rented or living rent free: Private rented or living rent free,10,9,7,1,6,0,2,1,0,0,1,0,0
S01008035,All HRPs aged 16 and over,281,187,153,22,131,26,8,94,80,1,4,7,2
S01008035,Owned: Total,245,167,137,17,120,25,5,78,74,1,0,3,0
S01008035,Owned: Owned outright,109,41,36,6,30,4,1,68,64,1,0,3,0
S01008035,Owned: Owned with a mortgage or loan or shared ownership,136,126,101,11,90,21,4,10,10,0,0,0,0
S01008035,Rented or living rent free: Total,36,20,16,5,11,1,3,16,6,0,4,4,2
S01008035,Rented or living rent free: Social rented,23,12,8,2,6,1,3,11,4,0,3,2,2
S01008035,Rented or living rent free: Private rented or living rent free,13,8,8,3,5,0,0,5,2,0,1,2,0
S01008036,All HRPs aged 16 and over,246,163,135,22,113,26,2,83,80,0,2,0,1
S01008036,Owned: Total,239,158,132,21,111,24,2,81,78,0,2,0,1
S01008036,Owned: Owned outright,132,58,45,16,29,12,1,74,72,0,2,0,0
S01008036,Owned: Owned with a mortgage or loan or shared ownership,107,100,87,5,82,12,1,7,6,0,0,0,1
S01008036,Rented or living rent free: Total,7,5,3,1,2,2,0,2,2,0,0,0,0
S01008036,Rented or living rent free: Social rented,3,2,0,0,0,2,0,1,1,0,0,0,0
S01008036,Rented or living rent free: Private rented or living rent free,4,3,3,1,2,0,0,1,1,0,0,0,0
S01008037,All HRPs aged 16 and over,421,256,212,43,169,39,5,165,118,1,14,27,5
S01008037,Owned: Total,236,162,132,17,115,28,2,74,61,0,5,6,2
S01008037,Owned: Owned outright,86,40,27,4,23,11,2,46,42,0,1,2,1
S01008037,Owned: Owned with a mortgage or loan or shared ownership,150,122,105,13,92,17,0,28,19,0,4,4,1
S01008037,Rented or living rent free: Total,185,94,80,26,54,11,3,91,57,1,9,21,3
S01008037,Rented or living rent free: Social rented,159,77,68,22,46,7,2,82,51,1,7,20,3
S01008037,Rented or living rent free: Private rented or living rent free,26,17,12,4,8,4,1,9,6,0,2,1,0
S01008038,All HRPs aged 16 and over,303,200,161,35,126,30,9,103,73,1,11,17,1
S01008038,Owned: Total,177,129,108,18,90,18,3,48,43,0,3,2,0
S01008038,Owned: Owned outright,51,19,15,5,10,3,1,32,30,0,1,1,0
S01008038,Owned: Owned with a mortgage or loan or shared ownership,126,110,93,13,80,15,2,16,13,0,2,1,0
S01008038,Rented or living rent free: Total,126,71,53,17,36,12,6,55,30,1,8,15,1
S01008038,Rented or living rent free: Social rented,108,58,44,15,29,8,6,50,28,1,6,14,1
S01008038,Rented or living rent free: Private rented or living rent free,18,13,9,2,7,4,0,5,2,0,2,1,0
S01008039,All HRPs aged 16 and over,363,245,206,40,166,27,12,118,83,2,8,23,2
S01008039,Owned: Total,245,182,150,25,125,25,7,63,58,1,1,3,0
S01008039,Owned: Owned outright,86,40,30,10,20,6,4,46,43,0,1,2,0
S01008039,Owned: Owned with a mortgage or loan or shared ownership,159,142,120,15,105,19,3,17,15,1,0,1,0
S01008039,Rented or living rent free: Total,118,63,56,15,41,2,5,55,25,1,7,20,2
S01008039,Rented or living rent free: Social rented,97,50,43,14,29,2,5,47,22,1,5,18,1
S01008039,Rented or living rent free: Private rented or living rent free,21,13,13,1,12,0,0,8,3,0,2,2,1
S01008040,All HRPs aged 16 and over,332,195,153,24,129,38,4,137,120,0,6,8,3
S01008040,Owned: Total,282,163,130,19,111,32,1,119,113,0,3,1,2
S01008040,Owned: Owned outright,162,53,46,12,34,7,0,109,107,0,0,1,1
S01008040,Owned: Owned with a mortgage or loan or shared ownership,120,110,84,7,77,25,1,10,6,0,3,0,1
S01008040,Rented or living rent free: Total,50,32,23,5,18,6,3,18,7,0,3,7,1
S01008040,Rented or living rent free: Social rented,36,19,12,5,7,4,3,17,7,0,2,7,1
S01008040,Rented or living rent free: Private rented or living rent free,14,13,11,0,11,2,0,1,0,0,1,0,0
S01008041,All HRPs aged 16 and over,354,186,155,36,119,29,2,168,147,1,5,11,4
S01008041,Owned: Total,260,134,112,21,91,22,0,126,121,1,0,1,3
S01008041,Owned: Owned outright,151,43,37,9,28,6,0,108,106,0,0,1,1
S01008041,Owned: Owned with a mortgage or loan or shared ownership,109,91,75,12,63,16,0,18,15,1,0,0,2
S01008041,Rented or living rent free: Total,94,52,43,15,28,7,2,42,26,0,5,10,1
S01008041,Rented or living rent free: Social rented,42,14,11,6,5,3,0,28,19,0,3,5,1
S01008041,Rented or living rent free: Private rented or living rent free,52,38,32,9,23,4,2,14,7,0,2,5,0
S01008042,All HRPs aged 16 and over,280,167,119,20,99,46,2,113,98,1,4,5,5
S01008042,Owned: Total,243,145,101,14,87,44,0,98,88,1,4,1,4
S01008042,Owned: Owned outright,143,56,35,9,26,21,0,87,80,1,2,1,3
S01008042,Owned: Owned with a mortgage or loan or shared ownership,100,89,66,5,61,23,0,11,8,0,2,0,1
S01008042,Rented or living rent free: Total,37,22,18,6,12,2,2,15,10,0,0,4,1
S01008042,Rented or living rent free: Social rented,12,4,3,3,0,0,1,8,5,0,0,3,0
S01008042,Rented or living rent free: Private rented or living rent free,25,18,15,3,12,2,1,7,5,0,0,1,1
S01008043,All HRPs aged 16 and over,398,237,169,26,143,65,3,161,152,1,4,2,2
S01008043,Owned: Total,378,223,155,18,137,65,3,155,149,1,2,1,2
S01008043,Owned: Owned outright,219,73,38,11,27,34,1,146,144,1,0,0,1
S01008043,Owned: Owned with a mortgage or loan or shared ownership,159,150,117,7,110,31,2,9,5,0,2,1,1
S01008043,Rented or living rent free: Total,20,14,14,8,6,0,0,6,3,0,2,1,0
S01008043,Rented or living rent free: Social rented,15,12,12,8,4,0,0,3,1,0,1,1,0
S01008043,Rented or living rent free: Private rented or living rent free,5,2,2,0,2,0,0,3,2,0,1,0,0
S01008044,All HRPs aged 16 and over,431,262,205,31,174,54,3,169,157,0,5,3,4
S01008044,Owned: Total,392,235,182,25,157,51,2,157,150,0,3,0,4
S01008044,Owned: Owned outright,235,90,71,16,55,17,2,145,139,0,3,0,3
S01008044,Owned: Owned with a mortgage or loan or shared ownership,157,145,111,9,102,34,0,12,11,0,0,0,1
S01008044,Rented or living rent free: Total,39,27,23,6,17,3,1,12,7,0,2,3,0
S01008044,Rented or living rent free: Social rented,5,1,1,1,0,0,0,4,1,0,1,2,0
S01008044,Rented or living rent free: Private rented or living rent free,34,26,22,5,17,3,1,8,6,0,1,1,0
S01008045,All HRPs aged 16 and over,449,237,163,22,141,63,11,212,190,4,8,8,2
S01008045,Owned: Total,372,195,131,19,112,60,4,177,168,1,2,4,2
S01008045,Owned: Owned outright,247,93,57,17,40,33,3,154,151,0,1,1,1
S01008045,Owned: Owned with a mortgage or loan or shared ownership,125,102,74,2,72,27,1,23,17,1,1,3,1
S01008045,Rented or living rent free: Total,77,42,32,3,29,3,7,35,22,3,6,4,0
S01008045,Rented or living rent free: Social rented,40,19,13,2,11,1,5,21,11,3,3,4,0
S01008045,Rented or living rent free: Private rented or living rent free,37,23,19,1,18,2,2,14,11,0,3,0,0
S01008046,All HRPs aged 16 and over,527,219,170,36,134,29,20,308,236,5,8,46,13
S01008046,Owned: Total,280,127,101,15,86,22,4,153,138,0,1,8,6
S01008046,Owned: Owned outright,160,30,22,8,14,8,0,130,117,0,0,7,6
S01008046,Owned: Owned with a mortgage or loan or shared ownership,120,97,79,7,72,14,4,23,21,0,1,1,0
S01008046,Rented or living rent free: Total,247,92,69,21,48,7,16,155,98,5,7,38,7
S01008046,Rented or living rent free: Social rented,178,51,37,13,24,3,11,127,79,4,3,36,5
S01008046,Rented or living rent free: Private rented or living rent free,69,41,32,8,24,4,5,28,19,1,4,2,2
S01008047,All HRPs aged 16 and over,292,164,123,18,105,37,4,128,123,0,1,2,2
S01008047,Owned: Total,275,155,121,18,103,33,1,120,117,0,0,2,1
S01008047,Owned: Owned outright,173,62,43,12,31,18,1,111,109,0,0,1,1
S01008047,Owned: Owned with a mortgage or loan or shared ownership,102,93,78,6,72,15,0,9,8,0,0,1,0
S01008047,Rented or living rent free: Total,17,9,2,0,2,4,3,8,6,0,1,0,1
S01008047,Rented or living rent free: Social rented,2,0,0,0,0,0,0,2,1,0,0,0,1
S01008047,Rented or living rent free: Private rented or living rent free,15,9,2,0,2,4,3,6,5,0,1,0,0
S01008048,All HRPs aged 16 and over,238,125,110,12,98,13,2,113,107,1,1,1,3
S01008048,Owned: Total,229,119,105,12,93,12,2,110,105,1,1,0,3
S01008048,Owned: Owned outright,150,49,42,11,31,5,2,101,97,1,1,0,2
S01008048,Owned: Owned with a mortgage or loan or shared ownership,79,70,63,1,62,7,0,9,8,0,0,0,1
S01008048,Rented or living rent free: Total,9,6,5,0,5,1,0,3,2,0,0,1,0
S01008048,Rented or living rent free: Social rented,2,1,1,0,1,0,0,1,0,0,0,1,0
S01008048,Rented or living rent free: Private rented or living rent free,7,5,4,0,4,1,0,2,2,0,0,0,0
S01008049,All HRPs aged 16 and over,357,196,157,11,146,38,1,161,155,0,2,3,1
S01008049,Owned: Total,346,188,149,10,139,38,1,158,152,0,2,3,1
S01008049,Owned: Owned outright,211,66,53,7,46,13,0,145,139,0,2,3,1
S01008049,Owned: Owned with a mortgage or loan or shared ownership,135,122,96,3,93,25,1,13,13,0,0,0,0
S01008049,Rented or living rent free: Total,11,8,8,1,7,0,0,3,3,0,0,0,0
S01008049,Rented or living rent free: Social rented,2,0,0,0,0,0,0,2,2,0,0,0,0
S01008049,Rented or living rent free: Private rented or living rent free,9,8,8,1,7,0,0,1,1,0,0,0,0
S01008050,All HRPs aged 16 and over,245,145,112,14,98,29,4,100,95,0,4,1,0
S01008050,Owned: Total,228,132,101,10,91,28,3,96,91,0,4,1,0
S01008050,Owned: Owned outright,138,49,33,8,25,14,2,89,85,0,3,1,0
S01008050,Owned: Owned with a mortgage or loan or shared ownership,90,83,68,2,66,14,1,7,6,0,1,0,0
S01008050,Rented or living rent free: Total,17,13,11,4,7,1,1,4,4,0,0,0,0
S01008050,Rented or living rent free: Social rented,8,4,3,1,2,0,1,4,4,0,0,0,0
S01008050,Rented or living rent free: Private rented or living rent free,9,9,8,3,5,1,0,0,0,0,0,0,0
S01008051,All HRPs aged 16 and over,328,219,186,16,170,33,0,109,100,2,1,3,3
S01008051,Owned: Total,312,210,177,13,164,33,0,102,96,2,0,1,3
S01008051,Owned: Owned outright,148,56,43,6,37,13,0,92,90,0,0,0,2
S01008051,Owned: Owned with a mortgage or loan or shared ownership,164,154,134,7,127,20,0,10,6,2,0,1,1
S01008051,Rented or living rent free: Total,16,9,9,3,6,0,0,7,4,0,1,2,0
S01008051,Rented or living rent free: Social rented,3,0,0,0,0,0,0,3,1,0,0,2,0
S01008051,Rented or living rent free: Private rented or living rent free,13,9,9,3,6,0,0,4,3,0,1,0,0
S01008052,All HRPs aged 16 and over,337,242,197,10,187,42,3,95,92,0,0,1,2
S01008052,Owned: Total,327,234,191,9,182,41,2,93,90,0,0,1,2
S01008052,Owned: Owned outright,153,74,59,7,52,14,1,79,76,0,0,1,2
S01008052,Owned: Owned with a mortgage or loan or shared ownership,174,160,132,2,130,27,1,14,14,0,0,0,0
S01008052,Rented or living rent free: Total,10,8,6,1,5,1,1,2,2,0,0,0,0
S01008052,Rented or living rent free: Social rented,2,2,1,0,1,0,1,0,0,0,0,0,0
S01008052,Rented or living rent free: Private rented or living rent free,8,6,5,1,4,1,0,2,2,0,0,0,0
S01008053,All HRPs aged 16 and over,263,139,111,20,91,26,2,124,119,0,3,1,1
S01008053,Owned: Total,246,127,101,15,86,25,1,119,114,0,3,1,1
S01008053,Owned: Owned outright,144,31,26,9,17,5,0,113,109,0,2,1,1
S01008053,Owned: Owned with a mortgage or loan or shared ownership,102,96,75,6,69,20,1,6,5,0,1,0,0
S01008053,Rented or living rent free: Total,17,12,10,5,5,1,1,5,5,0,0,0,0
S01008053,Rented or living rent free: Social rented,1,1,1,1,0,0,0,0,0,0,0,0,0
S01008053,Rented or living rent free: Private rented or living rent free,16,11,9,4,5,1,1,5,5,0,0,0,0
S01008054,All HRPs aged 16 and over,361,200,141,25,116,55,4,161,140,0,1,16,4
S01008054,Owned: Total,269,169,120,22,98,47,2,100,95,0,1,3,1
S01008054,Owned: Owned outright,149,60,44,15,29,14,2,89,85,0,1,2,1
S01008054,Owned: Owned with a mortgage or loan or shared ownership,120,109,76,7,69,33,0,11,10,0,0,1,0
S01008054,Rented or living rent free: Total,92,31,21,3,18,8,2,61,45,0,0,13,3
S01008054,Rented or living rent free: Social rented,55,9,6,2,4,3,0,46,37,0,0,6,3
S01008054,Rented or living rent free: Private rented or living rent free,37,22,15,1,14,5,2,15,8,0,0,7,0
S01008055,All HRPs aged 16 and over,384,264,211,28,183,53,0,120,119,0,1,0,0
S01008055,Owned: Total,374,254,204,26,178,50,0,120,119,0,1,0,0
S01008055,Owned: Owned outright,207,95,75,20,55,20,0,112,111,0,1,0,0
S01008055,Owned: Owned with a mortgage or loan or shared ownership,167,159,129,6,123,30,0,8,8,0,0,0,0
S01008055,Rented or living rent free: Total,10,10,7,2,5,3,0,0,0,0,0,0,0
S01008055,Rented or living rent free: Social rented,1,1,1,1,0,0,0,0,0,0,0,0,0
S01008055,Rented or living rent free: Private rented or living rent free,9,9,6,1,5,3,0,0,0,0,0,0,0
S01008056,All HRPs aged 16 and over,332,161,130,14,116,31,0,171,164,2,1,2,2
S01008056,Owned: Total,294,157,127,14,113,30,0,137,133,2,0,0,2
S01008056,Owned: Owned outright,177,46,39,10,29,7,0,131,129,0,0,0,2
S01008056,Owned: Owned with a mortgage or loan or shared ownership,117,111,88,4,84,23,0,6,4,2,0,0,0
S01008056,Rented or living rent free: Total,38,4,3,0,3,1,0,34,31,0,1,2,0
S01008056,Rented or living rent free: Social rented,30,0,0,0,0,0,0,30,28,0,1,1,0
S01008056,Rented or living rent free: Private rented or living rent free,8,4,3,0,3,1,0,4,3,0,0,1,0
S01008057,All HRPs aged 16 and over,400,233,182,18,164,50,1,167,157,3,1,4,2
S01008057,Owned: Total,348,213,166,15,151,46,1,135,134,1,0,0,0
S01008057,Owned: Owned outright,183,62,44,13,31,17,1,121,121,0,0,0,0
S01008057,Owned: Owned with a mortgage or loan or shared ownership,165,151,122,2,120,29,0,14,13,1,0,0,0
S01008057,Rented or living rent free: Total,52,20,16,3,13,4,0,32,23,2,1,4,2
S01008057,Rented or living rent free: Social rented,32,4,4,2,2,0,0,28,22,0,0,4,2
S01008057,Rented or living rent free: Private rented or living rent free,20,16,12,1,11,4,0,4,1,2,1,0,0
S01008058,All HRPs aged 16 and over,304,238,163,19,144,73,2,66,61,1,2,1,1
S01008058,Owned: Total,288,226,154,17,137,70,2,62,60,0,1,1,0
S01008058,Owned: Owned outright,132,76,48,9,39,28,0,56,54,0,1,1,0
S01008058,Owned: Owned with a mortgage or loan or shared ownership,156,150,106,8,98,42,2,6,6,0,0,0,0
S01008058,Rented or living rent free: Total,16,12,9,2,7,3,0,4,1,1,1,0,1
S01008058,Rented or living rent free: Social rented,1,0,0,0,0,0,0,1,1,0,0,0,0
S01008058,Rented or living rent free: Private rented or living rent free,15,12,9,2,7,3,0,3,0,1,1,0,1
S01008059,All HRPs aged 16 and over,260,177,146,23,123,30,1,83,78,0,3,1,1
S01008059,Owned: Total,250,169,139,22,117,29,1,81,77,0,3,0,1
S01008059,Owned: Owned outright,135,59,48,15,33,10,1,76,74,0,1,0,1
S01008059,Owned: Owned with a mortgage or loan or shared ownership,115,110,91,7,84,19,0,5,3,0,2,0,0
S01008059,Rented or living rent free: Total,10,8,7,1,6,1,0,2,1,0,0,1,0
S01008059,Rented or living rent free: Social rented,1,1,0,0,0,1,0,0,0,0,0,0,0
S01008059,Rented or living rent free: Private rented or living rent free,9,7,7,1,6,0,0,2,1,0,0,1,0
S01008060,All HRPs aged 16 and over,326,235,194,25,169,39,2,91,88,0,1,2,0
S01008060,Owned: Total,310,222,189,25,164,32,1,88,87,0,0,1,0
S01008060,Owned: Owned outright,136,57,48,15,33,9,0,79,79,0,0,0,0
S01008060,Owned: Owned with a mortgage or loan or shared ownership,174,165,141,10,131,23,1,9,8,0,0,1,0
S01008060,Rented or living rent free: Total,16,13,5,0,5,7,1,3,1,0,1,1,0
S01008060,Rented or living rent free: Social rented,5,3,0,0,0,2,1,2,1,0,0,1,0
S01008060,Rented or living rent free: Private rented or living rent free,11,10,5,0,5,5,0,1,0,0,1,0,0
S01008061,All HRPs aged 16 and over,283,215,179,24,155,31,5,68,59,2,1,4,2
S01008061,Owned: Total,269,204,171,24,147,28,5,65,57,1,1,4,2
S01008061,Owned: Owned outright,93,42,35,9,26,5,2,51,47,1,0,1,2
S01008061,Owned: Owned with a mortgage or loan or shared ownership,176,162,136,15,121,23,3,14,10,0,1,3,0
S01008061,Rented or living rent free: Total,14,11,8,0,8,3,0,3,2,1,0,0,0
S01008061,Rented or living rent free: Social rented,0,0,0,0,0,0,0,0,0,0,0,0,0
S01008061,Rented or living rent free: Private rented or living rent free,14,11,8,0,8,3,0,3,2,1,0,0,0
S01008062,All HRPs aged 16 and over,371,246,209,34,175,34,3,125,109,2,3,8,3
S01008062,Owned: Total,350,235,203,34,169,32,0,115,106,0,3,3,3
S01008062,Owned: Owned outright,172,73,59,18,41,14,0,99,94,0,1,3,1
S01008062,Owned: Owned with a mortgage or loan or shared ownership,178,162,144,16,128,18,0,16,12,0,2,0,2
S01008062,Rented or living rent free: Total,21,11,6,0,6,2,3,10,3,2,0,5,0
S01008062,Rented or living rent free: Social rented,5,1,0,0,0,0,1,4,1,0,0,3,0
S01008062,Rented or living rent free: Private rented or living rent free,16,10,6,0,6,2,2,6,2,2,0,2,0
S01008063,All HRPs aged 16 and over,381,243,200,26,174,42,1,138,123,2,5,5,3
S01008063,Owned: Total,357,229,189,25,164,40,0,128,121,0,3,1,3
S01008063,Owned: Owned outright,174,61,52,9,43,9,0,113,109,0,1,0,3
S01008063,Owned: Owned with a mortgage or loan or shared ownership,183,168,137,16,121,31,0,15,12,0,2,1,0
S01008063,Rented or living rent free: Total,24,14,11,1,10,2,1,10,2,2,2,4,0
S01008063,Rented or living rent free: Social rented,4,1,1,0,1,0,0,3,0,0,0,3,0
S01008063,Rented or living rent free: Private rented or living rent free,20,13,10,1,9,2,1,7,2,2,2,1,0
S01008064,All HRPs aged 16 and over,296,187,146,43,103,24,17,109,73,2,6,24,4
S01008064,Owned: Total,150,102,85,14,71,15,2,48,42,1,0,4,1
S01008064,Owned: Owned outright,72,29,21,6,15,7,1,43,38,1,0,3,1
S01008064,Owned: Owned with a mortgage or loan or shared ownership,78,73,64,8,56,8,1,5,4,0,0,1,0
S01008064,Rented or living rent free: Total,146,85,61,29,32,9,15,61,31,1,6,20,3
S01008064,Rented or living rent free: Social rented,120,68,51,27,24,8,9,52,26,1,6,17,2
S01008064,Rented or living rent free: Private rented or living rent free,26,17,10,2,8,1,6,9,5,0,0,3,1
S01008065,All HRPs aged 16 and over,348,252,199,19,180,49,4,96,92,1,0,2,1
S01008065,Owned: Total,338,244,191,17,174,49,4,94,92,0,0,1,1
S01008065,Owned: Owned outright,162,77,60,11,49,13,4,85,85,0,0,0,0
S01008065,Owned: Owned with a mortgage or loan or shared ownership,176,167,131,6,125,36,0,9,7,0,0,1,1
S01008065,Rented or living rent free: Total,10,8,8,2,6,0,0,2,0,1,0,1,0
S01008065,Rented or living rent free: Social rented,1,0,0,0,0,0,0,1,0,0,0,1,0
S01008065,Rented or living rent free: Private rented or living rent free,9,8,8,2,6,0,0,1,0,1,0,0,0
S01008066,All HRPs aged 16 and over,326,227,153,14,139,72,2,99,98,1,0,0,0
S01008066,Owned: Total,316,220,146,14,132,72,2,96,96,0,0,0,0
S01008066,Owned: Owned outright,170,81,51,8,43,28,2,89,89,0,0,0,0
S01008066,Owned: Owned with a mortgage or loan or shared ownership,146,139,95,6,89,44,0,7,7,0,0,0,0
S01008066,Rented or living rent free: Total,10,7,7,0,7,0,0,3,2,1,0,0,0
S01008066,Rented or living rent free: Social rented,0,0,0,0,0,0,0,0,0,0,0,0,0
S01008066,Rented or living rent free: Private rented or living rent free,10,7,7,0,7,0,0,3,2,1,0,0,0
S01008067,All HRPs aged 16 and over,257,166,125,9,116,39,2,91,86,2,1,2,0
S01008067,Owned: Total,245,159,119,8,111,38,2,86,83,0,1,2,0
S01008067,Owned: Owned outright,140,63,45,6,39,17,1,77,75,0,0,2,0
S01008067,Owned: Owned with a mortgage or loan or shared ownership,105,96,74,2,72,21,1,9,8,0,1,0,0
S01008067,Rented or living rent free: Total,12,7,6,1,5,1,0,5,3,2,0,0,0
S01008067,Rented or living rent free: Social rented,2,0,0,0,0,0,0,2,2,0,0,0,0
S01008067,Rented or living rent free: Private rented or living rent free,10,7,6,1,5,1,0,3,1,2,0,0,0
S01008068,All HRPs aged 16 and over,384,249,199,30,169,48,2,135,123,3,1,5,3
S01008068,Owned: Total,346,231,181,29,152,48,2,115,108,1,1,2,3
S01008068,Owned: Owned outright,179,72,56,22,34,16,0,107,101,1,1,1,3
S01008068,Owned: Owned with a mortgage or loan or shared ownership,167,159,125,7,118,32,2,8,7,0,0,1,0
S01008068,Rented or living rent free: Total,38,18,18,1,17,0,0,20,15,2,0,3,0
S01008068,Rented or living rent free: Social rented,16,3,3,0,3,0,0,13,11,0,0,2,0
S01008068,Rented or living rent free: Private rented or living rent free,22,15,15,1,14,0,0,7,4,2,0,1,0
S01008069,All HRPs aged 16 and over,385,264,225,31,194,32,7,121,110,0,2,6,3
S01008069,Owned: Total,357,247,213,24,189,31,3,110,106,0,1,1,2
S01008069,Owned: Owned outright,159,67,55,12,43,12,0,92,92,0,0,0,0
S01008069,Owned: Owned with a mortgage or loan or shared ownership,198,180,158,12,146,19,3,18,14,0,1,1,2
S01008069,Rented or living rent free: Total,28,17,12,7,5,1,4,11,4,0,1,5,1
S01008069,Rented or living rent free: Social rented,7,1,0,0,0,0,1,6,1,0,0,4,1
S01008069,Rented or living rent free: Private rented or living rent free,21,16,12,7,5,1,3,5,3,0,1,1,0
S01008070,All HRPs aged 16 and over,356,244,210,29,181,28,6,112,96,1,9,5,1
S01008070,Owned: Total,346,241,208,28,180,28,5,105,94,0,5,5,1
S01008070,Owned: Owned outright,160,65,54,12,42,10,1,95,86,0,3,5,1
S01008070,Owned: Owned with a mortgage or loan or shared ownership,186,176,154,16,138,18,4,10,8,0,2,0,0
S01008070,Rented or living rent free: Total,10,3,2,1,1,0,1,7,2,1,4,0,0
S01008070,Rented or living rent free: Social rented,1,0,0,0,0,0,0,1,1,0,0,0,0
S01008070,Rented or living rent free: Private rented or living rent free,9,3,2,1,1,0,1,6,1,1,4,0,0
S01008071,All HRPs aged 16 and over,287,203,174,19,155,28,1,84,71,1,5,6,1
S01008071,Owned: Total,264,194,167,18,149,26,1,70,64,0,2,3,1
S01008071,Owned: Owned outright,108,42,37,9,28,4,1,66,61,0,2,2,1
S01008071,Owned: Owned with a mortgage or loan or shared ownership,156,152,130,9,121,22,0,4,3,0,0,1,0
S01008071,Rented or living rent free: Total,23,9,7,1,6,2,0,14,7,1,3,3,0
S01008071,Rented or living rent free: Social rented,14,3,2,0,2,1,0,11,6,0,2,3,0
S01008071,Rented or living rent free: Private rented or living rent free,9,6,5,1,4,1,0,3,1,1,1,0,0
S01008072,All HRPs aged 16 and over,350,254,199,19,180,47,8,96,66,10,10,7,3
S01008072,Owned: Total,288,216,172,15,157,41,3,72,61,0,4,4,3
S01008072,Owned: Owned outright,124,64,49,12,37,12,3,60,53,0,2,3,2
S01008072,Owned: Owned with a mortgage or loan or shared ownership,164,152,123,3,120,29,0,12,8,0,2,1,1
S01008072,Rented or living rent free: Total,62,38,27,4,23,6,5,24,5,10,6,3,0
S01008072,Rented or living rent free: Social rented,2,1,1,0,1,0,0,1,0,0,0,1,0
S01008072,Rented or living rent free: Private rented or living rent free,60,37,26,4,22,6,5,23,5,10,6,2,0
S01008073,All HRPs aged 16 and over,178,111,73,5,68,35,3,67,66,0,0,1,0
S01008073,Owned: Total,173,106,70,4,66,35,1,67,66,0,0,1,0
S01008073,Owned: Owned outright,97,35,22,3,19,12,1,62,61,0,0,1,0
S01008073,Owned: Owned with a mortgage or loan or shared ownership,76,71,48,1,47,23,0,5,5,0,0,0,0
S01008073,Rented or living rent free: Total,5,5,3,1,2,0,2,0,0,0,0,0,0
S01008073,Rented or living rent free: Social rented,1,1,1,1,0,0,0,0,0,0,0,0,0
S01008073,Rented or living rent free: Private rented or living rent free,4,4,2,0,2,0,2,0,0,0,0,0,0
S01008074,All HRPs aged 16 and over,378,249,191,19,172,58,0,129,124,0,2,1,2
S01008074,Owned: Total,369,243,187,17,170,56,0,126,123,0,1,0,2
S01008074,Owned: Owned outright,197,83,55,7,48,28,0,114,113,0,0,0,1
S01008074,Owned: Owned with a mortgage or loan or shared ownership,172,160,132,10,122,28,0,12,10,0,1,0,1
S01008074,Rented or living rent free: Total,9,6,4,2,2,2,0,3,1,0,1,1,0
S01008074,Rented or living rent free: Social rented,4,3,2,1,1,1,0,1,0,0,0,1,0
S01008074,Rented or living rent free: Private rented or living rent free,5,3,2,1,1,1,0,2,1,0,1,0,0
S01008075,All HRPs aged 16 and over,246,125,78,8,70,46,1,121,114,2,2,2,1
S01008075,Owned: Total,233,120,74,7,67,45,1,113,111,0,1,0,1
S01008075,Owned: Owned outright,152,42,22,6,16,20,0,110,108,0,1,0,1
S01008075,Owned: Owned with a mortgage or loan or shared ownership,81,78,52,1,51,25,1,3,3,0,0,0,0
S01008075,Rented or living rent free: Total,13,5,4,1,3,1,0,8,3,2,1,2,0
S01008075,Rented or living rent free: Social rented,1,0,0,0,0,0,0,1,0,1,0,0,0
S01008075,Rented or living rent free: Private rented or living rent free,12,5,4,1,3,1,0,7,3,1,1,2,0
S01008076,All HRPs aged 16 and over,301,136,89,11,78,46,1,165,156,3,2,2,2
S01008076,Owned: Total,279,125,81,10,71,43,1,154,150,0,2,0,2
S01008076,Owned: Owned outright,198,57,37,7,30,20,0,141,137,0,2,0,2
S01008076,Owned: Owned with a mortgage or loan or shared ownership,81,68,44,3,41,23,1,13,13,0,0,0,0
S01008076,Rented or living rent free: Total,22,11,8,1,7,3,0,11,6,3,0,2,0
S01008076,Rented or living rent free: Social rented,5,1,1,0,1,0,0,4,2,0,0,2,0
S01008076,Rented or living rent free: Private rented or living rent free,17,10,7,1,6,3,0,7,4,3,0,0,0
S01008077,All HRPs aged 16 and over,349,205,136,14,122,63,6,144,134,0,3,5,2
S01008077,Owned: Total,332,194,132,14,118,57,5,138,130,0,3,3,2
S01008077,Owned: Owned outright,189,70,43,8,35,25,2,119,116,0,1,1,1
S01008077,Owned: Owned with a mortgage or loan or shared ownership,143,124,89,6,83,32,3,19,14,0,2,2,1
S01008077,Rented or living rent free: Total,17,11,4,0,4,6,1,6,4,0,0,2,0
S01008077,Rented or living rent free: Social rented,3,1,0,0,0,1,0,2,2,0,0,0,0
S01008077,Rented or living rent free: Private rented or living rent free,14,10,4,0,4,5,1,4,2,0,0,2,0
S01008078,All HRPs aged 16 and over,350,204,150,26,124,50,4,146,128,3,5,8,2
S01008078,Owned: Total,315,184,133,19,114,48,3,131,119,2,3,5,2
S01008078,Owned: Owned outright,185,66,47,14,33,17,2,119,112,1,3,1,2
S01008078,Owned: Owned with a mortgage or loan or shared ownership,130,118,86,5,81,31,1,12,7,1,0,4,0
S01008078,Rented or living rent free: Total,35,20,17,7,10,2,1,15,9,1,2,3,0
S01008078,Rented or living rent free: Social rented,10,4,4,1,3,0,0,6,4,0,0,2,0
S01008078,Rented or living rent free: Private rented or living rent free,25,16,13,6,7,2,1,9,5,1,2,1,0
S01008079,All HRPs aged 16 and over,341,201,144,21,123,52,5,140,135,0,4,1,0
S01008079,Owned: Total,331,192,138,21,117,49,5,139,135,0,4,0,0
S01008079,Owned: Owned outright,193,70,46,11,35,21,3,123,123,0,0,0,0
S01008079,Owned: Owned with a mortgage or loan or shared ownership,138,122,92,10,82,28,2,16,12,0,4,0,0
S01008079,Rented or living rent free: Total,10,9,6,0,6,3,0,1,0,0,0,1,0
S01008079,Rented or living rent free: Social rented,3,2,1,0,1,1,0,1,0,0,0,1,0
S01008079,Rented or living rent free: Private rented or living rent free,7,7,5,0,5,2,0,0,0,0,0,0,0
S01008080,All HRPs aged 16 and over,279,182,127,15,112,53,2,97,83,3,7,3,1
S01008080,Owned: Total,262,168,116,14,102,50,2,94,83,2,5,3,1
S01008080,Owned: Owned outright,135,50,38,10,28,12,0,85,79,2,2,1,1
S01008080,Owned: Owned with a mortgage or loan or shared ownership,127,118,78,4,74,38,2,9,4,0,3,2,0
S01008080,Rented or living rent free: Total,17,14,11,1,10,3,0,3,0,1,2,0,0
S01008080,Rented or living rent free: Social rented,1,1,0,0,0,1,0,0,0,0,0,0,0
S01008080,Rented or living rent free: Private rented or living rent free,16,13,11,1,10,2,0,3,0,1,2,0,0
S01008081,All HRPs aged 16 and over,235,143,109,6,103,33,1,92,80,2,6,1,3
S01008081,Owned: Total,227,137,103,6,97,33,1,90,80,2,6,0,2
S01008081,Owned: Owned outright,128,48,38,3,35,10,0,80,74,0,5,0,1
S01008081,Owned: Owned with a mortgage or loan or shared ownership,99,89,65,3,62,23,1,10,6,2,1,0,1
S01008081,Rented or living rent free: Total,8,6,6,0,6,0,0,2,0,0,0,1,1
S01008081,Rented or living rent free: Social rented,1,0,0,0,0,0,0,1,0,0,0,1,0
S01008081,Rented or living rent free: Private rented or living rent free,7,6,6,0,6,0,0,1,0,0,0,0,1
S01008082,All HRPs aged 16 and over,328,205,167,23,144,37,1,123,113,3,1,3,3
S01008082,Owned: Total,306,192,158,20,138,33,1,114,111,1,0,0,2
S01008082,Owned: Owned outright,178,79,63,16,47,16,0,99,99,0,0,0,0
S01008082,Owned: Owned with a mortgage or loan or shared ownership,128,113,95,4,91,17,1,15,12,1,0,0,2
S01008082,Rented or living rent free: Total,22,13,9,3,6,4,0,9,2,2,1,3,1
S01008082,Rented or living rent free: Social rented,8,4,3,1,2,1,0,4,1,0,0,2,1
S01008082,Rented or living rent free: Private rented or living rent free,14,9,6,2,4,3,0,5,1,2,1,1,0
S01008083,All HRPs aged 16 and over,270,166,136,20,116,27,3,104,98,1,2,2,1
S01008083,Owned: Total,261,159,132,20,112,25,2,102,98,1,1,2,0
S01008083,Owned: Owned outright,136,44,33,9,24,11,0,92,90,1,1,0,0
S01008083,Owned: Owned with a mortgage or loan or shared ownership,125,115,99,11,88,14,2,10,8,0,0,2,0
S01008083,Rented or living rent free: Total,9,7,4,0,4,2,1,2,0,0,1,0,1
S01008083,Rented or living rent free: Social rented,2,1,0,0,0,1,0,1,0,0,1,0,0
S01008083,Rented or living rent free: Private rented or living rent free,7,6,4,0,4,1,1,1,0,0,0,0,1
S01008084,All HRPs aged 16 and over,353,236,184,33,151,47,5,117,103,1,5,7,1
S01008084,Owned: Total,297,203,159,26,133,43,1,94,88,0,1,5,0
S01008084,Owned: Owned outright,158,75,55,15,40,20,0,83,78,0,1,4,0
S01008084,Owned: Owned with a mortgage or loan or shared ownership,139,128,104,11,93,23,1,11,10,0,0,1,0
S01008084,Rented or living rent free: Total,56,33,25,7,18,4,4,23,15,1,4,2,1
S01008084,Rented or living rent free: Social rented,32,19,16,6,10,1,2,13,10,0,1,2,0
S01008084,Rented or living rent free: Private rented or living rent free,24,14,9,1,8,3,2,10,5,1,3,0,1
S01008085,All HRPs aged 16 and over,339,258,194,19,175,62,2,81,74,2,2,2,1
S01008085,Owned: Total,320,247,187,18,169,59,1,73,69,1,1,2,0
S01008085,Owned: Owned outright,142,80,54,10,44,25,1,62,59,0,1,2,0
S01008085,Owned: Owned with a mortgage or loan or shared ownership,178,167,133,8,125,34,0,11,10,1,0,0,0
S01008085,Rented or living rent free: Total,19,11,7,1,6,3,1,8,5,1,1,0,1
S01008085,Rented or living rent free: Social rented,6,2,2,1,1,0,0,4,2,1,0,0,1
S01008085,Rented or living rent free: Private rented or living rent free,13,9,5,0,5,3,1,4,3,0,1,0,0
S01008086,All HRPs aged 16 and over,418,306,246,28,218,57,3,112,96,2,5,4,5
S01008086,Owned: Total,339,260,208,17,191,52,0,79,76,0,1,0,2
S01008086,Owned: Owned outright,144,76,63,8,55,13,0,68,66,0,1,0,1
S01008086,Owned: Owned with a mortgage or loan or shared ownership,195,184,145,9,136,39,0,11,10,0,0,0,1
S01008086,Rented or living rent free: Total,79,46,38,11,27,5,3,33,20,2,4,4,3
S01008086,Rented or living rent free: Social rented,43,23,19,7,12,2,2,20,14,1,1,3,1
S01008086,Rented or living rent free: Private rented or living rent free,36,23,19,4,15,3,1,13,6,1,3,1,2
S01008087,All HRPs aged 16 and over,330,175,149,15,134,23,3,155,146,2,2,3,2
S01008087,Owned: Total,317,170,146,15,131,23,1,147,144,0,0,2,1
S01008087,Owned: Owned outright,176,48,41,8,33,6,1,128,127,0,0,1,0
S01008087,Owned: Owned with a mortgage or loan or shared ownership,141,122,105,7,98,17,0,19,17,0,0,1,1
S01008087,Rented or living rent free: Total,13,5,3,0,3,0,2,8,2,2,2,1,1
S01008087,Rented or living rent free: Social rented,3,1,1,0,1,0,0,2,0,0,0,1,1
S01008087,Rented or living rent free: Private rented or living rent free,10,4,2,0,2,0,2,6,2,2,2,0,0
S01008088,All HRPs aged 16 and over,398,229,200,34,166,23,6,169,153,1,2,10,3
S01008088,Owned: Total,353,202,178,28,150,19,5,151,141,1,1,7,1
S01008088,Owned: Owned outright,205,70,63,19,44,7,0,135,130,0,0,4,1
S01008088,Owned: Owned with a mortgage or loan or shared ownership,148,132,115,9,106,12,5,16,11,1,1,3,0
S01008088,Rented or living rent free: Total,45,27,22,6,16,4,1,18,12,0,1,3,2
S01008088,Rented or living rent free: Social rented,4,2,2,0,2,0,0,2,1,0,0,1,0
S01008088,Rented or living rent free: Private rented or living rent free,41,25,20,6,14,4,1,16,11,0,1,2,2
S01008089,All HRPs aged 16 and over,243,151,130,11,119,19,2,92,87,0,2,2,1
S01008089,Owned: Total,236,147,126,10,116,19,2,89,87,0,1,1,0
S01008089,Owned: Owned outright,125,41,35,7,28,4,2,84,82,0,1,1,0
S01008089,Owned: Owned with a mortgage or loan or shared ownership,111,106,91,3,88,15,0,5,5,0,0,0,0
S01008089,Rented or living rent free: Total,7,4,4,1,3,0,0,3,0,0,1,1,1
S01008089,Rented or living rent free: Social rented,1,1,1,0,1,0,0,0,0,0,0,0,0
S01008089,Rented or living rent free: Private rented or living rent free,6,3,3,1,2,0,0,3,0,0,1,1,1
S01008090,All HRPs aged 16 and over,305,196,168,31,137,27,1,109,101,1,1,5,1
S01008090,Owned: Total,276,182,156,24,132,25,1,94,92,0,0,1,1
S01008090,Owned: Owned outright,147,58,50,14,36,8,0,89,88,0,0,1,0
S01008090,Owned: Owned with a mortgage or loan or shared ownership,129,124,106,10,96,17,1,5,4,0,0,0,1
S01008090,Rented or living rent free: Total,29,14,12,7,5,2,0,15,9,1,1,4,0
S01008090,Rented or living rent free: Social rented,16,6,5,4,1,1,0,10,6,0,0,4,0
S01008090,Rented or living rent free: Private rented or living rent free,13,8,7,3,4,1,0,5,3,1,1,0,0
S01008091,All HRPs aged 16 and over,146,90,71,9,62,18,1,56,50,0,0,5,1
S01008091,Owned: Total,141,87,69,9,60,17,1,54,48,0,0,5,1
S01008091,Owned: Owned outright,78,28,25,5,20,2,1,50,47,0,0,2,1
S01008091,Owned: Owned with a mortgage or loan or shared ownership,63,59,44,4,40,15,0,4,1,0,0,3,0
S01008091,Rented or living rent free: Total,5,3,2,0,2,1,0,2,2,0,0,0,0
S01008091,Rented or living rent free: Social rented,1,0,0,0,0,0,0,1,1,0,0,0,0
S01008091,Rented or living rent free: Private rented or living rent free,4,3,2,0,2,1,0,1,1,0,0,0,0
S01008092,All HRPs aged 16 and over,368,196,158,19,139,33,5,172,168,1,0,3,0
S01008092,Owned: Total,342,192,156,19,137,31,5,150,149,0,0,1,0
S01008092,Owned: Owned outright,210,74,58,13,45,15,1,136,136,0,0,0,0
S01008092,Owned: Owned with a mortgage or loan or shared ownership,132,118,98,6,92,16,4,14,13,0,0,1,0
S01008092,Rented or living rent free: Total,26,4,2,0,2,2,0,22,19,1,0,2,0
S01008092,Rented or living rent free: Social rented,21,1,0,0,0,1,0,20,18,0,0,2,0
S01008092,Rented or living rent free: Private rented or living rent free,5,3,2,0,2,1,0,2,1,1,0,0,0
S01008093,All HRPs aged 16 and over,331,176,142,17,125,29,5,155,149,0,3,3,0
S01008093,Owned: Total,307,159,126,13,113,28,5,148,145,0,2,1,0
S01008093,Owned: Owned outright,186,49,42,8,34,6,1,137,136,0,0,1,0
S01008093,Owned: Owned with a mortgage or loan or shared ownership,121,110,84,5,79,22,4,11,9,0,2,0,0
S01008093,Rented or living rent free: Total,24,17,16,4,12,1,0,7,4,0,1,2,0
S01008093,Rented or living rent free: Social rented,1,0,0,0,0,0,0,1,0,0,0,1,0
S01008093,Rented or living rent free: Private rented or living rent free,23,17,16,4,12,1,0,6,4,0,1,1,0
S01008094,All HRPs aged 16 and over,257,159,120,17,103,36,3,98,90,0,2,6,0
S01008094,Owned: Total,245,152,115,14,101,35,2,93,88,0,1,4,0
S01008094,Owned: Owned outright,141,57,41,9,32,14,2,84,81,0,0,3,0
S01008094,Owned: Owned with a mortgage or loan or shared ownership,104,95,74,5,69,21,0,9,7,0,1,1,0
S01008094,Rented or living rent free: Total,12,7,5,3,2,1,1,5,2,0,1,2,0
S01008094,Rented or living rent free: Social rented,3,1,1,1,0,0,0,2,2,0,0,0,0
S01008094,Rented or living rent free: Private rented or living rent free,9,6,4,2,2,1,1,3,0,0,1,2,0
S01008095,All HRPs aged 16 and over,345,200,164,23,141,31,5,145,128,0,2,9,6
S01008095,Owned: Total,301,168,141,17,124,25,2,133,123,0,1,6,3
S01008095,Owned: Owned outright,166,50,47,12,35,3,0,116,111,0,1,3,1
S01008095,Owned: Owned with a mortgage or loan or shared ownership,135,118,94,5,89,22,2,17,12,0,0,3,2
S01008095,Rented or living rent free: Total,44,32,23,6,17,6,3,12,5,0,1,3,3
S01008095,Rented or living rent free: Social rented,2,1,1,1,0,0,0,1,0,0,0,0,1
S01008095,Rented or living rent free: Private rented or living rent free,42,31,22,5,17,6,3,11,5,0,1,3,2
S01008096,All HRPs aged 16 and over,334,166,139,17,122,26,1,168,159,2,0,5,2
S01008096,Owned: Total,319,158,133,15,118,24,1,161,153,2,0,4,2
S01008096,Owned: Owned outright,187,47,38,8,30,9,0,140,134,0,0,4,2
S01008096,Owned: Owned with a mortgage or loan or shared ownership,132,111,95,7,88,15,1,21,19,2,0,0,0
S01008096,Rented or living rent free: Total,15,8,6,2,4,2,0,7,6,0,0,1,0
S01008096,Rented or living rent free: Social rented,1,0,0,0,0,0,0,1,0,0,0,1,0
S01008096,Rented or living rent free: Private rented or living rent free,14,8,6,2,4,2,0,6,6,0,0,0,0
S01008097,All HRPs aged 16 and over,281,142,108,18,90,30,4,139,133,1,2,1,2
S01008097,Owned: Total,269,137,103,16,87,30,4,132,128,0,2,1,1
S01008097,Owned: Owned outright,177,51,38,7,31,12,1,126,124,0,0,1,1
S01008097,Owned: Owned with a mortgage or loan or shared ownership,92,86,65,9,56,18,3,6,4,0,2,0,0
S01008097,Rented or living rent free: Total,12,5,5,2,3,0,0,7,5,1,0,0,1
S01008097,Rented or living rent free: Social rented,0,0,0,0,0,0,0,0,0,0,0,0,0
S01008097,Rented or living rent free: Private rented or living rent free,12,5,5,2,3,0,0,7,5,1,0,0,1
S01008098,All HRPs aged 16 and over,293,182,154,16,138,25,3,111,101,1,3,5,1
S01008098,Owned: Total,282,177,151,16,135,24,2,105,101,0,1,2,1
S01008098,Owned: Owned outright,147,51,40,8,32,9,2,96,95,0,0,0,1
S01008098,Owned: Owned with a mortgage or loan or shared ownership,135,126,111,8,103,15,0,9,6,0,1,2,0
S01008098,Rented or living rent free: Total,11,5,3,0,3,1,1,6,0,1,2,3,0
S01008098,Rented or living rent free: Social rented,2,0,0,0,0,0,0,2,0,0,1,1,0
S01008098,Rented or living rent free: Private rented or living rent free,9,5,3,0,3,1,1,4,0,1,1,2,0
S01008099,All HRPs aged 16 and over,209,146,115,16,99,24,7,63,54,2,3,2,2
S01008099,Owned: Total,190,136,109,13,96,23,4,54,52,0,1,0,1
S01008099,Owned: Owned outright,86,39,30,8,22,7,2,47,46,0,0,0,1
S01008099,Owned: Owned with a mortgage or loan or shared ownership,104,97,79,5,74,16,2,7,6,0,1,0,0
S01008099,Rented or living rent free: Total,19,10,6,3,3,1,3,9,2,2,2,2,1
S01008099,Rented or living rent free: Social rented,5,2,0,0,0,0,2,3,0,0,1,2,0
S01008099,Rented or living rent free: Private rented or living rent free,14,8,6,3,3,1,1,6,2,2,1,0,1
S01008100,All HRPs aged 16 and over,401,202,144,14,130,49,9,199,187,1,2,7,2
S01008100,Owned: Total,344,190,133,10,123,49,8,154,144,1,2,7,0
S01008100,Owned: Owned outright,182,55,40,4,36,11,4,127,122,1,1,3,0
S01008100,Owned: Owned with a mortgage or loan or shared ownership,162,135,93,6,87,38,4,27,22,0,1,4,0
S01008100,Rented or living rent free: Total,57,12,11,4,7,0,1,45,43,0,0,0,2
S01008100,Rented or living rent free: Social rented,35,0,0,0,0,0,0,35,34,0,0,0,1
S01008100,Rented or living rent free: Private rented or living rent free,22,12,11,4,7,0,1,10,9,0,0,0,1
S01008101,All HRPs aged 16 and over,351,269,223,25,198,31,15,82,55,2,14,9,2
S01008101,Owned: Total,276,219,189,19,170,27,3,57,51,0,4,2,0
S01008101,Owned: Owned outright,91,44,39,9,30,5,0,47,44,0,2,1,0
S01008101,Owned: Owned with a mortgage or loan or shared ownership,185,175,150,10,140,22,3,10,7,0,2,1,0
S01008101,Rented or living rent free: Total,75,50,34,6,28,4,12,25,4,2,10,7,2
S01008101,Rented or living rent free: Social rented,17,12,6,1,5,1,5,5,1,0,0,4,0
S01008101,Rented or living rent free: Private rented or living rent free,58,38,28,5,23,3,7,20,3,2,10,3,2
S01008102,All HRPs aged 16 and over,310,202,167,26,141,29,6,108,80,4,3,16,5
S01008102,Owned: Total,263,173,142,18,124,28,3,90,74,2,3,8,3
S01008102,Owned: Owned outright,113,34,29,6,23,4,1,79,67,2,1,6,3
S01008102,Owned: Owned with a mortgage or loan or shared ownership,150,139,113,12,101,24,2,11,7,0,2,2,0
S01008102,Rented or living rent free: Total,47,29,25,8,17,1,3,18,6,2,0,8,2
S01008102,Rented or living rent free: Social rented,20,12,10,3,7,0,2,8,3,0,0,3,2
S01008102,Rented or living rent free: Private rented or living rent free,27,17,15,5,10,1,1,10,3,2,0,5,0
S01008103,All HRPs aged 16 and over,338,194,155,30,125,28,11,144,104,0,2,32,6
S01008103,Owned: Total,196,131,113,13,100,18,0,65,60,0,0,3,2
S01008103,Owned: Owned outright,78,26,22,4,18,4,0,52,49,0,0,2,1
S01008103,Owned: Owned with a mortgage or loan or shared ownership,118,105,91,9,82,14,0,13,11,0,0,1,1
S01008103,Rented or living rent free: Total,142,63,42,17,25,10,11,79,44,0,2,29,4
S01008103,Rented or living rent free: Social rented,92,26,21,10,11,0,5,66,37,0,0,26,3
S01008103,Rented or living rent free: Private rented or living rent free,50,37,21,7,14,10,6,13,7,0,2,3,1
S01008104,All HRPs aged 16 and over,390,244,203,52,151,27,14,146,103,4,10,25,4
S01008104,Owned: Total,253,169,139,24,115,25,5,84,77,1,1,3,2
S01008104,Owned: Owned outright,88,30,21,6,15,8,1,58,55,0,1,2,0
S01008104,Owned: Owned with a mortgage or loan or shared ownership,165,139,118,18,100,17,4,26,22,1,0,1,2
S01008104,Rented or living rent free: Total,137,75,64,28,36,2,9,62,26,3,9,22,2
S01008104,Rented or living rent free: Social rented,97,52,46,19,27,0,6,45,21,2,5,15,2
S01008104,Rented or living rent free: Private rented or living rent free,40,23,18,9,9,2,3,17,5,1,4,7,0
S01008105,All HRPs aged 16 and over,518,304,236,46,190,34,34,214,137,4,12,48,13
S01008105,Owned: Total,273,200,167,20,147,25,8,73,59,1,4,8,1
S01008105,Owned: Owned outright,77,33,29,5,24,4,0,44,41,0,1,1,1
S01008105,Owned: Owned with a mortgage or loan or shared ownership,196,167,138,15,123,21,8,29,18,1,3,7,0
S01008105,Rented or living rent free: Total,245,104,69,26,43,9,26,141,78,3,8,40,12
S01008105,Rented or living rent free: Social rented,195,71,51,19,32,3,17,124,74,2,6,32,10
S01008105,Rented or living rent free: Private rented or living rent free,50,33,18,7,11,6,9,17,4,1,2,8,2
S01008106,All HRPs aged 16 and over,371,196,156,29,127,21,19,175,116,0,15,38,6
S01008106,Owned: Total,224,137,119,15,104,15,3,87,75,0,2,10,0
S01008106,Owned: Owned outright,88,27,20,8,12,7,0,61,56,0,0,5,0
S01008106,Owned: Owned with a mortgage or loan or shared ownership,136,110,99,7,92,8,3,26,19,0,2,5,0
S01008106,Rented or living rent free: Total,147,59,37,14,23,6,16,88,41,0,13,28,6
S01008106,Rented or living rent free: Social rented,109,35,23,6,17,3,9,74,38,0,11,20,5
S01008106,Rented or living rent free: Private rented or living rent free,38,24,14,8,6,3,7,14,3,0,2,8,1
S01008107,All HRPs aged 16 and over,281,251,187,15,172,61,3,30,21,1,1,5,2
S01008107,Owned: Total,248,224,166,11,155,56,2,24,19,1,0,3,1
S01008107,Owned: Owned outright,56,38,25,4,21,12,1,18,15,0,0,3,0
S01008107,Owned: Owned with a mortgage or loan or shared ownership,192,186,141,7,134,44,1,6,4,1,0,0,1
S01008107,Rented or living rent free: Total,33,27,21,4,17,5,1,6,2,0,1,2,1
S01008107,Rented or living rent free: Social rented,1,1,1,1,0,0,0,0,0,0,0,0,0
S01008107,Rented or living rent free: Private rented or living rent free,32,26,20,3,17,5,1,6,2,0,1,2,1
S01008108,All HRPs aged 16 and over,244,201,159,22,137,40,2,43,37,0,0,4,2
S01008108,Owned: Total,228,190,148,19,129,40,2,38,36,0,0,1,1
S01008108,Owned: Owned outright,103,69,54,14,40,15,0,34,34,0,0,0,0
S01008108,Owned: Owned with a mortgage or loan or shared ownership,125,121,94,5,89,25,2,4,2,0,0,1,1
S01008108,Rented or living rent free: Total,16,11,11,3,8,0,0,5,1,0,0,3,1
S01008108,Rented or living rent free: Social rented,3,1,1,0,1,0,0,2,1,0,0,1,0
S01008108,Rented or living rent free: Private rented or living rent free,13,10,10,3,7,0,0,3,0,0,0,2,1
S01008109,All HRPs aged 16 and over,332,232,192,20,172,36,4,100,82,1,10,5,2
S01008109,Owned: Total,305,221,182,15,167,36,3,84,80,1,0,1,2
S01008109,Owned: Owned outright,149,73,59,8,51,12,2,76,74,0,0,0,2
S01008109,Owned: Owned with a mortgage or loan or shared ownership,156,148,123,7,116,24,1,8,6,1,0,1,0
S01008109,Rented or living rent free: Total,27,11,10,5,5,0,1,16,2,0,10,4,0
S01008109,Rented or living rent free: Social rented,10,4,3,2,1,0,1,6,2,0,1,3,0
S01008109,Rented or living rent free: Private rented or living rent free,17,7,7,3,4,0,0,10,0,0,9,1,0
S01008110,All HRPs aged 16 and over,316,237,201,18,183,30,6,79,70,2,2,4,1
S01008110,Owned: Total,296,222,188,15,173,29,5,74,68,1,2,3,0
S01008110,Owned: Owned outright,104,40,33,7,26,6,1,64,60,1,1,2,0
S01008110,Owned: Owned with a mortgage or loan or shared ownership,192,182,155,8,147,23,4,10,8,0,1,1,0
S01008110,Rented or living rent free: Total,20,15,13,3,10,1,1,5,2,1,0,1,1
S01008110,Rented or living rent free: Social rented,2,2,1,0,1,0,1,0,0,0,0,0,0
S01008110,Rented or living rent free: Private rented or living rent free,18,13,12,3,9,1,0,5,2,1,0,1,1
S01008111,All HRPs aged 16 and over,349,193,166,15,151,27,0,156,147,0,2,4,3
S01008111,Owned: Total,326,183,157,14,143,26,0,143,141,0,0,2,0
S01008111,Owned: Owned outright,209,74,63,9,54,11,0,135,134,0,0,1,0
S01008111,Owned: Owned with a mortgage or loan or shared ownership,117,109,94,5,89,15,0,8,7,0,0,1,0
S01008111,Rented or living rent free: Total,23,10,9,1,8,1,0,13,6,0,2,2,3
S01008111,Rented or living rent free: Social rented,6,3,3,1,2,0,0,3,2,0,0,0,1
S01008111,Rented or living rent free: Private rented or living rent free,17,7,6,0,6,1,0,10,4,0,2,2,2
S01008112,All HRPs aged 16 and over,322,178,154,26,128,23,1,144,137,1,2,3,1
S01008112,Owned: Total,314,176,153,26,127,22,1,138,132,0,2,3,1
S01008112,Owned: Owned outright,184,58,50,11,39,8,0,126,121,0,2,2,1
S01008112,Owned: Owned with a mortgage or loan or shared ownership,130,118,103,15,88,14,1,12,11,0,0,1,0
S01008112,Rented or living rent free: Total,8,2,1,0,1,1,0,6,5,1,0,0,0
S01008112,Rented or living rent free: Social rented,2,1,1,0,1,0,0,1,1,0,0,0,0
S01008112,Rented or living rent free: Private rented or living rent free,6,1,0,0,0,1,0,5,4,1,0,0,0
S01008113,All HRPs aged 16 and over,359,211,175,28,147,33,3,148,141,0,3,2,2
S01008113,Owned: Total,333,195,163,25,138,30,2,138,134,0,3,0,1
S01008113,Owned: Owned outright,187,59,49,15,34,9,1,128,127,0,1,0,0
S01008113,Owned: Owned with a mortgage or loan or shared ownership,146,136,114,10,104,21,1,10,7,0,2,0,1
S01008113,Rented or living rent free: Total,26,16,12,3,9,3,1,10,7,0,0,2,1
S01008113,Rented or living rent free: Social rented,4,2,2,1,1,0,0,2,1,0,0,0,1
S01008113,Rented or living rent free: Private rented or living rent free,22,14,10,2,8,3,1,8,6,0,0,2,0
S01008114,All HRPs aged 16 and over,262,169,140,27,113,24,5,93,89,0,1,1,2
S01008114,Owned: Total,254,164,138,27,111,22,4,90,87,0,0,1,2
S01008114,Owned: Owned outright,144,62,53,22,31,8,1,82,80,0,0,1,1
S01008114,Owned: Owned with a mortgage or loan or shared ownership,110,102,85,5,80,14,3,8,7,0,0,0,1
S01008114,Rented or living rent free: Total,8,5,2,0,2,2,1,3,2,0,1,0,0
S01008114,Rented or living rent free: Social rented,2,1,1,0,1,0,0,1,1,0,0,0,0
S01008114,Rented or living rent free: Private rented or living rent free,6,4,1,0,1,2,1,2,1,0,1,0,0
S01008115,All HRPs aged 16 and over,368,279,230,28,202,40,9,89,69,1,4,10,5
S01008115,Owned: Total,320,251,210,24,186,36,5,69,63,0,1,2,3
S01008115,Owned: Owned outright,110,57,44,11,33,13,0,53,50,0,1,1,1
S01008115,Owned: Owned with a mortgage or loan or shared ownership,210,194,166,13,153,23,5,16,13,0,0,1,2
S01008115,Rented or living rent free: Total,48,28,20,4,16,4,4,20,6,1,3,8,2
S01008115,Rented or living rent free: Social rented,7,4,3,1,2,1,0,3,0,0,0,3,0
S01008115,Rented or living rent free: Private rented or living rent free,41,24,17,3,14,3,4,17,6,1,3,5,2
S01008116,All HRPs aged 16 and over,350,241,206,20,186,28,7,109,101,2,4,0,2
S01008116,Owned: Total,332,229,194,19,175,28,7,103,99,1,2,0,1
S01008116,Owned: Owned outright,162,66,54,10,44,10,2,96,93,1,1,0,1
S01008116,Owned: Owned with a mortgage or loan or shared ownership,170,163,140,9,131,18,5,7,6,0,1,0,0
S01008116,Rented or living rent free: Total,18,12,12,1,11,0,0,6,2,1,2,0,1
S01008116,Rented or living rent free: Social rented,6,5,5,0,5,0,0,1,0,1,0,0,0
S01008116,Rented or living rent free: Private rented or living rent free,12,7,7,1,6,0,0,5,2,0,2,0,1
S01008117,All HRPs aged 16 and over,329,196,158,22,136,34,4,133,119,0,8,6,0
S01008117,Owned: Total,289,177,144,18,126,32,1,112,106,0,5,1,0
S01008117,Owned: Owned outright,161,63,53,16,37,10,0,98,95,0,2,1,0
S01008117,Owned: Owned with a mortgage or loan or shared ownership,128,114,91,2,89,22,1,14,11,0,3,0,0
S01008117,Rented or living rent free: Total,40,19,14,4,10,2,3,21,13,0,3,5,0
S01008117,Rented or living rent free: Social rented,29,11,7,3,4,1,3,18,12,0,1,5,0
S01008117,Rented or living rent free: Private rented or living rent free,11,8,7,1,6,1,0,3,1,0,2,0,0
S01008118,All HRPs aged 16 and over,361,215,181,22,159,26,8,146,125,3,4,11,3
S01008118,Owned: Total,295,179,152,16,136,22,5,116,108,0,3,3,2
S01008118,Owned: Owned outright,126,36,28,7,21,6,2,90,88,0,0,0,2
S01008118,Owned: Owned with a mortgage or loan or shared ownership,169,143,124,9,115,16,3,26,20,0,3,3,0
S01008118,Rented or living rent free: Total,66,36,29,6,23,4,3,30,17,3,1,8,1
S01008118,Rented or living rent free: Social rented,42,23,19,5,14,1,3,19,11,0,0,7,1
S01008118,Rented or living rent free: Private rented or living rent free,24,13,10,1,9,3,0,11,6,3,1,1,0
S01008119,All HRPs aged 16 and over,260,147,126,16,110,12,9,113,84,1,12,13,3
S01008119,Owned: Total,139,87,76,4,72,9,2,52,46,1,1,3,1
S01008119,Owned: Owned outright,52,11,9,1,8,2,0,41,37,0,0,3,1
S01008119,Owned: Owned with a mortgage or loan or shared ownership,87,76,67,3,64,7,2,11,9,1,1,0,0
S01008119,Rented or living rent free: Total,121,60,50,12,38,3,7,61,38,0,11,10,2
S01008119,Rented or living rent free: Social rented,104,51,43,11,32,2,6,53,38,0,5,9,1
S01008119,Rented or living rent free: Private rented or living rent free,17,9,7,1,6,1,1,8,0,0,6,1,1
S01008120,All HRPs aged 16 and over,288,164,130,20,110,30,4,124,107,3,1,7,6
S01008120,Owned: Total,224,131,103,13,90,27,1,93,87,1,0,2,3
S01008120,Owned: Owned outright,123,40,28,5,23,12,0,83,79,1,0,2,1
S01008120,Owned: Owned with a mortgage or loan or shared ownership,101,91,75,8,67,15,1,10,8,0,0,0,2
S01008120,Rented or living rent free: Total,64,33,27,7,20,3,3,31,20,2,1,5,3
S01008120,Rented or living rent free: Social rented,41,15,12,5,7,1,2,26,17,2,0,4,3
S01008120,Rented or living rent free: Private rented or living rent free,23,18,15,2,13,2,1,5,3,0,1,1,0
S01008121,All HRPs aged 16 and over,269,154,119,21,98,33,2,115,110,2,1,1,1
S01008121,Owned: Total,266,152,117,21,96,33,2,114,110,2,1,0,1
S01008121,Owned: Owned outright,163,57,40,15,25,16,1,106,103,1,1,0,1
S01008121,Owned: Owned with a mortgage or loan or shared ownership,103,95,77,6,71,17,1,8,7,1,0,0,0
S01008121,Rented or living rent free: Total,3,2,2,0,2,0,0,1,0,0,0,1,0
S01008121,Rented or living rent free: Social rented,1,1,1,0,1,0,0,0,0,0,0,0,0
S01008121,Rented or living rent free: Private rented or living rent free,2,1,1,0,1,0,0,1,0,0,0,1,0
S01008122,All HRPs aged 16 and over,266,184,130,10,120,48,6,82,73,3,3,2,1
S01008122,Owned: Total,246,170,119,8,111,45,6,76,73,2,0,1,0
S01008122,Owned: Owned outright,123,50,30,5,25,16,4,73,71,2,0,0,0
S01008122,Owned: Owned with a mortgage or loan or shared ownership,123,120,89,3,86,29,2,3,2,0,0,1,0
S01008122,Rented or living rent free: Total,20,14,11,2,9,3,0,6,0,1,3,1,1
S01008122,Rented or living rent free: Social rented,2,1,1,1,0,0,0,1,0,0,0,1,0
S01008122,Rented or living rent free: Private rented or living rent free,18,13,10,1,9,3,0,5,0,1,3,0,1
S01008123,All HRPs aged 16 and over,366,223,160,25,135,62,1,143,133,0,4,5,1
S01008123,Owned: Total,337,205,143,21,122,61,1,132,130,0,0,1,1
S01008123,Owned: Owned outright,200,78,51,18,33,26,1,122,120,0,0,1,1
S01008123,Owned: Owned with a mortgage or loan or shared ownership,137,127,92,3,89,35,0,10,10,0,0,0,0
S01008123,Rented or living rent free: Total,29,18,17,4,13,1,0,11,3,0,4,4,0
S01008123,Rented or living rent free: Social rented,2,1,1,0,1,0,0,1,0,0,1,0,0
S01008123,Rented or living rent free: Private rented or living rent free,27,17,16,4,12,1,0,10,3,0,3,4,0
S01008124,All HRPs aged 16 and over,306,214,185,22,163,27,2,92,86,1,3,0,2
S01008124,Owned: Total,296,207,180,22,158,25,2,89,85,0,2,0,2
S01008124,Owned: Owned outright,141,58,49,13,36,7,2,83,80,0,2,0,1
S01008124,Owned: Owned with a mortgage or loan or shared ownership,155,149,131,9,122,18,0,6,5,0,0,0,1
S01008124,Rented or living rent free: Total,10,7,5,0,5,2,0,3,1,1,1,0,0
S01008124,Rented or living rent free: Social rented,1,1,0,0,0,1,0,0,0,0,0,0,0
S01008124,Rented or living rent free: Private rented or living rent free,9,6,5,0,5,1,0,3,1,1,1,0,0
S01008125,All HRPs aged 16 and over,378,246,205,34,171,39,2,132,119,0,6,7,0
S01008125,Owned: Total,336,219,182,26,156,35,2,117,114,0,3,0,0
S01008125,Owned: Owned outright,186,82,67,18,49,13,2,104,101,0,3,0,0
S01008125,Owned: Owned with a mortgage or loan or shared ownership,150,137,115,8,107,22,0,13,13,0,0,0,0
S01008125,Rented or living rent free: Total,42,27,23,8,15,4,0,15,5,0,3,7,0
S01008125,Rented or living rent free: Social rented,3,1,1,1,0,0,0,2,0,0,1,1,0
S01008125,Rented or living rent free: Private rented or living rent free,39,26,22,7,15,4,0,13,5,0,2,6,0
S01008126,All HRPs aged 16 and over,308,246,196,22,174,43,7,62,58,0,1,3,0
S01008126,Owned: Total,299,240,193,22,171,40,7,59,57,0,1,1,0
S01008126,Owned: Owned outright,142,87,71,18,53,13,3,55,53,0,1,1,0
S01008126,Owned: Owned with a mortgage or loan or shared ownership,157,153,122,4,118,27,4,4,4,0,0,0,0
S01008126,Rented or living rent free: Total,9,6,3,0,3,3,0,3,1,0,0,2,0
S01008126,Rented or living rent free: Social rented,1,0,0,0,0,0,0,1,0,0,0,1,0
S01008126,Rented or living rent free: Private rented or living rent free,8,6,3,0,3,3,0,2,1,0,0,1,0
S01008127,All HRPs aged 16 and over,194,127,109,17,92,16,2,67,59,1,1,3,3
S01008127,Owned: Total,181,119,101,16,85,16,2,62,58,0,0,2,2
S01008127,Owned: Owned outright,89,30,26,11,15,3,1,59,57,0,0,0,2
S01008127,Owned: Owned with a mortgage or loan or shared ownership,92,89,75,5,70,13,1,3,1,0,0,2,0
S01008127,Rented or living rent free: Total,13,8,8,1,7,0,0,5,1,1,1,1,1
S01008127,Rented or living rent free: Social rented,4,2,2,0,2,0,0,2,0,0,0,1,1
S01008127,Rented or living rent free: Private rented or living rent free,9,6,6,1,5,0,0,3,1,1,1,0,0
S01008128,All HRPs aged 16 and over,350,223,184,26,158,32,7,127,117,1,6,3,0
S01008128,Owned: Total,318,202,170,21,149,31,1,116,111,0,3,2,0
S01008128,Owned: Owned outright,165,65,54,12,42,10,1,100,100,0,0,0,0
S01008128,Owned: Owned with a mortgage or loan or shared ownership,153,137,116,9,107,21,0,16,11,0,3,2,0
S01008128,Rented or living rent free: Total,32,21,14,5,9,1,6,11,6,1,3,1,0
S01008128,Rented or living rent free: Social rented,20,15,10,5,5,0,5,5,4,0,0,1,0
S01008128,Rented or living rent free: Private rented or living rent free,12,6,4,0,4,1,1,6,2,1,3,0,0
S01008129,All HRPs aged 16 and over,426,262,212,29,183,33,17,164,103,0,10,42,9
S01008129,Owned: Total,251,177,145,13,132,24,8,74,66,0,0,5,3
S01008129,Owned: Owned outright,91,39,29,4,25,8,2,52,48,0,0,1,3
S01008129,Owned: Owned with a mortgage or loan or shared ownership,160,138,116,9,107,16,6,22,18,0,0,4,0
S01008129,Rented or living rent free: Total,175,85,67,16,51,9,9,90,37,0,10,37,6
S01008129,Rented or living rent free: Social rented,132,61,49,13,36,4,8,71,31,0,7,29,4
S01008129,Rented or living rent free: Private rented or living rent free,43,24,18,3,15,5,1,19,6,0,3,8,2
S01008130,All HRPs aged 16 and over,462,316,252,44,208,33,31,146,114,4,6,18,4
S01008130,Owned: Total,262,188,166,20,146,18,4,74,71,1,0,1,1
S01008130,Owned: Owned outright,95,39,36,6,30,2,1,56,54,0,0,1,1
S01008130,Owned: Owned with a mortgage or loan or shared ownership,167,149,130,14,116,16,3,18,17,1,0,0,0
S01008130,Rented or living rent free: Total,200,128,86,24,62,15,27,72,43,3,6,17,3
S01008130,Rented or living rent free: Social rented,105,47,37,10,27,5,5,58,40,1,3,12,2
S01008130,Rented or living rent free: Private rented or living rent free,95,81,49,14,35,10,22,14,3,2,3,5,1
S01008131,All HRPs aged 16 and over,398,250,207,34,173,22,21,148,93,2,9,37,7
S01008131,Owned: Total,214,151,127,12,115,15,9,63,56,0,0,6,1
S01008131,Owned: Owned outright,82,29,22,4,18,3,4,53,48,0,0,4,1
S01008131,Owned: Owned with a mortgage or loan or shared ownership,132,122,105,8,97,12,5,10,8,0,0,2,0
S01008131,Rented or living rent free: Total,184,99,80,22,58,7,12,85,37,2,9,31,6
S01008131,Rented or living rent free: Social rented,112,55,41,13,28,3,11,57,29,1,8,16,3
S01008131,Rented or living rent free: Private rented or living rent free,72,44,39,9,30,4,1,28,8,1,1,15,3
S01008132,All HRPs aged 16 and over,423,236,185,23,162,47,4,187,177,0,3,3,4
S01008132,Owned: Total,398,216,171,20,151,42,3,182,172,0,3,3,4
S01008132,Owned: Owned outright,240,69,52,12,40,16,1,171,162,0,3,2,4
S01008132,Owned: Owned with a mortgage or loan or shared ownership,158,147,119,8,111,26,2,11,10,0,0,1,0
S01008132,Rented or living rent free: Total,25,20,14,3,11,5,1,5,5,0,0,0,0
S01008132,Rented or living rent free: Social rented,6,5,5,0,5,0,0,1,1,0,0,0,0
S01008132,Rented or living rent free: Private rented or living rent free,19,15,9,3,6,5,1,4,4,0,0,0,0
S01008133,All HRPs aged 16 and over,338,161,124,19,105,27,10,177,132,3,5,29,8
S01008133,Owned: Total,191,104,81,7,74,22,1,87,79,1,0,6,1
S01008133,Owned: Owned outright,110,35,26,2,24,9,0,75,72,0,0,2,1
S01008133,Owned: Owned with a mortgage or loan or shared ownership,81,69,55,5,50,13,1,12,7,1,0,4,0
S01008133,Rented or living rent free: Total,147,57,43,12,31,5,9,90,53,2,5,23,7
S01008133,Rented or living rent free: Social rented,92,27,19,6,13,2,6,65,41,0,2,18,4
S01008133,Rented or living rent free: Private rented or living rent free,55,30,24,6,18,3,3,25,12,2,3,5,3
S01008134,All HRPs aged 16 and over,325,219,181,19,162,24,14,106,79,2,1,23,1
S01008134,Owned: Total,229,157,137,14,123,15,5,72,68,1,0,3,0
S01008134,Owned: Owned outright,93,30,24,5,19,4,2,63,60,1,0,2,0
S01008134,Owned: Owned with a mortgage or loan or shared ownership,136,127,113,9,104,11,3,9,8,0,0,1,0
S01008134,Rented or living rent free: Total,96,62,44,5,39,9,9,34,11,1,1,20,1
S01008134,Rented or living rent free: Social rented,24,5,2,0,2,1,2,19,7,0,1,10,1
S01008134,Rented or living rent free: Private rented or living rent free,72,57,42,5,37,8,7,15,4,1,0,10,0
S01008135,All HRPs aged 16 and over,478,371,308,38,270,43,20,107,60,7,12,24,4
S01008135,Owned: Total,320,267,229,21,208,34,4,53,47,1,1,4,0
S01008135,Owned: Owned outright,90,48,40,8,32,8,0,42,39,0,0,3,0
S01008135,Owned: Owned with a mortgage or loan or shared ownership,230,219,189,13,176,26,4,11,8,1,1,1,0
S01008135,Rented or living rent free: Total,158,104,79,17,62,9,16,54,13,6,11,20,4
S01008135,Rented or living rent free: Social rented,57,31,20,7,13,3,8,26,9,0,1,12,4
S01008135,Rented or living rent free: Private rented or living rent free,101,73,59,10,49,6,8,28,4,6,10,8,0
S01008136,All HRPs aged 16 and over,448,271,227,42,185,30,14,177,132,1,6,30,8
S01008136,Owned: Total,310,205,175,26,149,24,6,105,94,0,1,6,4
S01008136,Owned: Owned outright,118,37,32,11,21,4,1,81,76,0,0,3,2
S01008136,Owned: Owned with a mortgage or loan or shared ownership,192,168,143,15,128,20,5,24,18,0,1,3,2
S01008136,Rented or living rent free: Total,138,66,52,16,36,6,8,72,38,1,5,24,4
S01008136,Rented or living rent free: Social rented,91,39,31,11,20,3,5,52,27,0,2,21,2
S01008136,Rented or living rent free: Private rented or living rent free,47,27,21,5,16,3,3,20,11,1,3,3,2
S01008137,All HRPs aged 16 and over,414,244,191,64,127,20,33,170,66,5,27,55,17
S01008137,Owned: Total,87,61,49,12,37,11,1,26,19,0,2,3,2
S01008137,Owned: Owned outright,24,13,7,1,6,5,1,11,8,0,1,0,2
S01008137,Owned: Owned with a mortgage or loan or shared ownership,63,48,42,11,31,6,0,15,11,0,1,3,0
S01008137,Rented or living rent free: Total,327,183,142,52,90,9,32,144,47,5,25,52,15
S01008137,Rented or living rent free: Social rented,305,170,134,49,85,6,30,135,46,2,23,49,15
S01008137,Rented or living rent free: Private rented or living rent free,22,13,8,3,5,3,2,9,1,3,2,3,0
S01008138,All HRPs aged 16 and over,374,224,178,47,131,18,28,150,69,2,20,48,11
S01008138,Owned: Total,112,88,76,12,64,7,5,24,17,0,2,3,2
S01008138,Owned: Owned outright,33,14,13,3,10,1,0,19,13,0,1,3,2
S01008138,Owned: Owned with a mortgage or loan or shared ownership,79,74,63,9,54,6,5,5,4,0,1,0,0
S01008138,Rented or living rent free: Total,262,136,102,35,67,11,23,126,52,2,18,45,9
S01008138,Rented or living rent free: Social rented,235,120,90,32,58,10,20,115,49,2,14,43,7
S01008138,Rented or living rent free: Private rented or living rent free,27,16,12,3,9,1,3,11,3,0,4,2,2
S01008139,All HRPs aged 16 and over,393,229,181,49,132,23,25,164,109,1,15,36,3
S01008139,Owned: Total,229,143,121,18,103,19,3,86,83,0,0,3,0
S01008139,Owned: Owned outright,109,37,31,7,24,5,1,72,70,0,0,2,0
S01008139,Owned: Owned with a mortgage or loan or shared ownership,120,106,90,11,79,14,2,14,13,0,0,1,0
S01008139,Rented or living rent free: Total,164,86,60,31,29,4,22,78,26,1,15,33,3
S01008139,Rented or living rent free: Social rented,126,66,49,27,22,3,14,60,20,1,4,32,3
S01008139,Rented or living rent free: Private rented or living rent free,38,20,11,4,7,1,8,18,6,0,11,1,0
S01008140,All HRPs aged 16 and over,239,127,104,24,80,10,13,112,69,0,16,25,2
S01008140,Owned: Total,95,68,59,7,52,9,0,27,22,0,1,3,1
S01008140,Owned: Owned outright,38,15,15,3,12,0,0,23,20,0,0,2,1
S01008140,Owned: Owned with a mortgage or loan or shared ownership,57,53,44,4,40,9,0,4,2,0,1,1,0
S01008140,Rented or living rent free: Total,144,59,45,17,28,1,13,85,47,0,15,22,1
S01008140,Rented or living rent free: Social rented,124,46,37,13,24,1,8,78,44,0,14,19,1
S01008140,Rented or living rent free: Private rented or living rent free,20,13,8,4,4,0,5,7,3,0,1,3,0
S01008141,All HRPs aged 16 and over,318,197,159,16,143,34,4,121,111,3,1,4,2
S01008141,Owned: Total,303,188,152,14,138,33,3,115,107,3,1,3,1
S01008141,Owned: Owned outright,155,54,41,9,32,11,2,101,97,1,0,2,1
S01008141,Owned: Owned with a mortgage or loan or shared ownership,148,134,111,5,106,22,1,14,10,2,1,1,0
S01008141,Rented or living rent free: Total,15,9,7,2,5,1,1,6,4,0,0,1,1
S01008141,Rented or living rent free: Social rented,9,5,3,1,2,1,1,4,2,0,0,1,1
S01008141,Rented or living rent free: Private rented or living rent free,6,4,4,1,3,0,0,2,2,0,0,0,0
S01008142,All HRPs aged 16 and over,293,216,190,18,172,23,3,77,66,4,3,4,0
S01008142,Owned: Total,283,212,189,17,172,21,2,71,66,4,0,1,0
S01008142,Owned: Owned outright,111,50,43,11,32,6,1,61,59,1,0,1,0
S01008142,Owned: Owned with a mortgage or loan or shared ownership,172,162,146,6,140,15,1,10,7,3,0,0,0
S01008142,Rented or living rent free: Total,10,4,1,1,0,2,1,6,0,0,3,3,0
S01008142,Rented or living rent free: Social rented,5,1,0,0,0,1,0,4,0,0,1,3,0
S01008142,Rented or living rent free: Private rented or living rent free,5,3,1,1,0,1,1,2,0,0,2,0,0
S01008143,All HRPs aged 16 and over,428,248,206,33,173,20,22,180,130,1,7,38,4
S01008143,Owned: Total,262,169,144,17,127,17,8,93,84,0,1,8,0
S01008143,Owned: Owned outright,114,38,33,9,24,4,1,76,69,0,1,6,0
S01008143,Owned: Owned with a mortgage or loan or shared ownership,148,131,111,8,103,13,7,17,15,0,0,2,0
S01008143,Rented or living rent free: Total,166,79,62,16,46,3,14,87,46,1,6,30,4
S01008143,Rented or living rent free: Social rented,121,61,50,15,35,2,9,60,32,1,1,23,3
S01008143,Rented or living rent free: Private rented or living rent free,45,18,12,1,11,1,5,27,14,0,5,7,1
S01008144,All HRPs aged 16 and over,229,156,119,19,100,35,2,73,63,1,4,4,1
S01008144,Owned: Total,215,151,115,17,98,34,2,64,61,1,1,0,1
S01008144,Owned: Owned outright,97,40,26,8,18,12,2,57,55,0,1,0,1
S01008144,Owned: Owned with a mortgage or loan or shared ownership,118,111,89,9,80,22,0,7,6,1,0,0,0
S01008144,Rented or living rent free: Total,14,5,4,2,2,1,0,9,2,0,3,4,0
S01008144,Rented or living rent free: Social rented,2,1,1,1,0,0,0,1,0,0,0,1,0
S01008144,Rented or living rent free: Private rented or living rent free,12,4,3,1,2,1,0,8,2,0,3,3,0
S01008145,All HRPs aged 16 and over,328,214,176,30,146,21,17,114,81,3,8,20,2
S01008145,Owned: Total,155,119,100,14,86,18,1,36,32,0,2,2,0
S01008145,Owned: Owned outright,50,19,15,5,10,3,1,31,28,0,2,1,0
S01008145,Owned: Owned with a mortgage or loan or shared ownership,105,100,85,9,76,15,0,5,4,0,0,1,0
S01008145,Rented or living rent free: Total,173,95,76,16,60,3,16,78,49,3,6,18,2
S01008145,Rented or living rent free: Social rented,159,84,67,15,52,2,15,75,48,2,5,18,2
S01008145,Rented or living rent free: Private rented or living rent free,14,11,9,1,8,1,1,3,1,1,1,0,0
S01008146,All HRPs aged 16 and over,218,114,90,20,70,15,9,104,77,0,13,11,3
S01008146,Owned: Total,97,61,49,4,45,12,0,36,33,0,0,3,0
S01008146,Owned: Owned outright,52,22,16,2,14,6,0,30,27,0,0,3,0
S01008146,Owned: Owned with a mortgage or loan or shared ownership,45,39,33,2,31,6,0,6,6,0,0,0,0
S01008146,Rented or living rent free: Total,121,53,41,16,25,3,9,68,44,0,13,8,3
S01008146,Rented or living rent free: Social rented,107,45,35,13,22,2,8,62,41,0,11,7,3
S01008146,Rented or living rent free: Private rented or living rent free,14,8,6,3,3,1,1,6,3,0,2,1,0
S01008147,All HRPs aged 16 and over,339,226,191,36,155,27,8,113,80,4,6,20,3
S01008147,Owned: Total,233,177,148,21,127,26,3,56,53,1,0,2,0
S01008147,Owned: Owned outright,87,44,37,7,30,6,1,43,41,0,0,2,0
S01008147,Owned: Owned with a mortgage or loan or shared ownership,146,133,111,14,97,20,2,13,12,1,0,0,0
S01008147,Rented or living rent free: Total,106,49,43,15,28,1,5,57,27,3,6,18,3
S01008147,Rented or living rent free: Social rented,98,45,40,13,27,1,4,53,25,2,6,17,3
S01008147,Rented or living rent free: Private rented or living rent free,8,4,3,2,1,0,1,4,2,1,0,1,0
S01008148,All HRPs aged 16 and over,328,220,184,26,158,25,11,108,74,3,4,25,2
S01008148,Owned: Total,245,186,159,21,138,22,5,59,55,1,0,2,1
S01008148,Owned: Owned outright,97,53,45,13,32,8,0,44,43,0,0,1,0
S01008148,Owned: Owned with a mortgage or loan or shared ownership,148,133,114,8,106,14,5,15,12,1,0,1,1
S01008148,Rented or living rent free: Total,83,34,25,5,20,3,6,49,19,2,4,23,1
S01008148,Rented or living rent free: Social rented,56,19,12,4,8,2,5,37,16,1,3,16,1
S01008148,Rented or living rent free: Private rented or living rent free,27,15,13,1,12,1,1,12,3,1,1,7,0
S01008149,All HRPs aged 16 and over,313,205,165,27,138,16,24,108,72,2,8,17,9
S01008149,Owned: Total,211,146,127,12,115,15,4,65,56,0,2,6,1
S01008149,Owned: Owned outright,71,20,18,3,15,1,1,51,46,0,2,2,1
S01008149,Owned: Owned with a mortgage or loan or shared ownership,140,126,109,9,100,14,3,14,10,0,0,4,0
S01008149,Rented or living rent free: Total,102,59,38,15,23,1,20,43,16,2,6,11,8
S01008149,Rented or living rent free: Social rented,80,44,30,14,16,1,13,36,13,2,5,11,5
S01008149,Rented or living rent free: Private rented or living rent free,22,15,8,1,7,0,7,7,3,0,1,0,3
S01008150,All HRPs aged 16 and over,428,241,207,35,172,21,13,187,138,1,15,28,5
S01008150,Owned: Total,266,167,148,19,129,18,1,99,90,0,0,8,1
S01008150,Owned: Owned outright,107,22,19,6,13,3,0,85,77,0,0,7,1
S01008150,Owned: Owned with a mortgage or loan or shared ownership,159,145,129,13,116,15,1,14,13,0,0,1,0
S01008150,Rented or living rent free: Total,162,74,59,16,43,3,12,88,48,1,15,20,4
S01008150,Rented or living rent free: Social rented,131,55,43,12,31,2,10,76,40,1,12,19,4
S01008150,Rented or living rent free: Private rented or living rent free,31,19,16,4,12,1,2,12,8,0,3,1,0
S01008151,All HRPs aged 16 and over,321,188,164,23,141,16,8,133,105,0,6,21,1
S01008151,Owned: Total,206,137,123,12,111,14,0,69,62,0,0,6,1
S01008151,Owned: Owned outright,67,21,20,4,16,1,0,46,43,0,0,2,1
S01008151,Owned: Owned with a mortgage or loan or shared ownership,139,116,103,8,95,13,0,23,19,0,0,4,0
S01008151,Rented or living rent free: Total,115,51,41,11,30,2,8,64,43,0,6,15,0
S01008151,Rented or living rent free: Social rented,92,37,28,9,19,2,7,55,38,0,3,14,0
S01008151,Rented or living rent free: Private rented or living rent free,23,14,13,2,11,0,1,9,5,0,3,1,0
S01008152,All HRPs aged 16 and over,511,270,224,43,181,23,23,241,182,7,12,34,6
S01008152,Owned: Total,285,170,147,15,132,17,6,115,103,0,5,5,2
S01008152,Owned: Owned outright,126,43,37,8,29,3,3,83,78,0,1,2,2
S01008152,Owned: Owned with a mortgage or loan or shared ownership,159,127,110,7,103,14,3,32,25,0,4,3,0
S01008152,Rented or living rent free: Total,226,100,77,28,49,6,17,126,79,7,7,29,4
S01008152,Rented or living rent free: Social rented,186,78,62,20,42,2,14,108,69,2,6,28,3
S01008152,Rented or living rent free: Private rented or living rent free,40,22,15,8,7,4,3,18,10,5,1,1,1
S01008153,All HRPs aged 16 and over,295,229,186,23,163,37,6,66,55,3,4,2,2
S01008153,Owned: Total,277,215,177,21,156,34,4,62,54,3,3,0,2
S01008153,Owned: Owned outright,112,65,53,7,46,9,3,47,44,1,0,0,2
S01008153,Owned: Owned with a mortgage or loan or shared ownership,165,150,124,14,110,25,1,15,10,2,3,0,0
S01008153,Rented or living rent free: Total,18,14,9,2,7,3,2,4,1,0,1,2,0
S01008153,Rented or living rent free: Social rented,6,3,2,1,1,0,1,3,0,0,1,2,0
S01008153,Rented or living rent free: Private rented or living rent free,12,11,7,1,6,3,1,1,1,0,0,0,0
S01008154,All HRPs aged 16 and over,355,201,166,27,139,30,5,154,140,1,0,9,4
S01008154,Owned: Total,310,180,148,18,130,29,3,130,124,1,0,3,2
S01008154,Owned: Owned outright,175,61,51,12,39,9,1,114,110,1,0,2,1
S01008154,Owned: Owned with a mortgage or loan or shared ownership,135,119,97,6,91,20,2,16,14,0,0,1,1
S01008154,Rented or living rent free: Total,45,21,18,9,9,1,2,24,16,0,0,6,2
S01008154,Rented or living rent free: Social rented,34,14,14,8,6,0,0,20,14,0,0,5,1
S01008154,Rented or living rent free: Private rented or living rent free,11,7,4,1,3,1,2,4,2,0,0,1,1
S01008155,All HRPs aged 16 and over,275,187,153,16,137,27,7,88,77,0,4,5,2
S01008155,Owned: Total,245,168,137,9,128,25,6,77,73,0,1,1,2
S01008155,Owned: Owned outright,97,32,24,2,22,6,2,65,61,0,1,1,2
S01008155,Owned: Owned with a mortgage or loan or shared ownership,148,136,113,7,106,19,4,12,12,0,0,0,0
S01008155,Rented or living rent free: Total,30,19,16,7,9,2,1,11,4,0,3,4,0
S01008155,Rented or living rent free: Social rented,19,10,9,4,5,0,1,9,3,0,3,3,0
S01008155,Rented or living rent free: Private rented or living rent free,11,9,7,3,4,2,0,2,1,0,0,1,0
S01008156,All HRPs aged 16 and over,391,246,173,27,146,56,17,145,114,2,7,18,4
S01008156,Owned: Total,277,177,126,11,115,45,6,100,91,1,1,6,1
S01008156,Owned: Owned outright,130,53,34,6,28,18,1,77,73,1,0,3,0
S01008156,Owned: Owned with a mortgage or loan or shared ownership,147,124,92,5,87,27,5,23,18,0,1,3,1
S01008156,Rented or living rent free: Total,114,69,47,16,31,11,11,45,23,1,6,12,3
S01008156,Rented or living rent free: Social rented,89,50,36,13,23,8,6,39,20,1,6,11,1
S01008156,Rented or living rent free: Private rented or living rent free,25,19,11,3,8,3,5,6,3,0,0,1,2
S01008157,All HRPs aged 16 and over,293,210,178,26,152,27,5,83,62,6,7,7,1
S01008157,Owned: Total,248,187,161,23,138,25,1,61,50,4,2,4,1
S01008157,Owned: Owned outright,96,55,45,7,38,9,1,41,37,3,0,1,0
S01008157,Owned: Owned with a mortgage or loan or shared ownership,152,132,116,16,100,16,0,20,13,1,2,3,1
S01008157,Rented or living rent free: Total,45,23,17,3,14,2,4,22,12,2,5,3,0
S01008157,Rented or living rent free: Social rented,31,14,12,1,11,1,1,17,10,1,4,2,0
S01008157,Rented or living rent free: Private rented or living rent free,14,9,5,2,3,1,3,5,2,1,1,1,0
S01008158,All HRPs aged 16 and over,287,240,205,18,187,31,4,47,39,1,3,2,2
S01008158,Owned: Total,274,231,198,17,181,30,3,43,38,1,0,2,2
S01008158,Owned: Owned outright,96,61,50,7,43,10,1,35,32,0,0,2,1
S01008158,Owned: Owned with a mortgage or loan or shared ownership,178,170,148,10,138,20,2,8,6,1,0,0,1
S01008158,Rented or living rent free: Total,13,9,7,1,6,1,1,4,1,0,3,0,0
S01008158,Rented or living rent free: Social rented,5,1,0,0,0,0,1,4,1,0,3,0,0
S01008158,Rented or living rent free: Private rented or living rent free,8,8,7,1,6,1,0,0,0,0,0,0,0
S01008159,All HRPs aged 16 and over,461,269,208,48,160,31,30,192,115,1,17,53,6
S01008159,Owned: Total,180,121,89,12,77,23,9,59,52,0,2,4,1
S01008159,Owned: Owned outright,70,23,12,3,9,7,4,47,42,0,2,3,0
S01008159,Owned: Owned with a mortgage or loan or shared ownership,110,98,77,9,68,16,5,12,10,0,0,1,1
S01008159,Rented or living rent free: Total,281,148,119,36,83,8,21,133,63,1,15,49,5
S01008159,Rented or living rent free: Social rented,227,103,84,27,57,3,16,124,58,0,15,46,5
S01008159,Rented or living rent free: Private rented or living rent free,54,45,35,9,26,5,5,9,5,1,0,3,0
S01008160,All HRPs aged 16 and over,397,244,195,25,170,26,23,153,89,3,14,38,9
S01008160,Owned: Total,218,160,137,12,125,19,4,58,53,0,1,3,1
S01008160,Owned: Owned outright,73,30,23,4,19,6,1,43,41,0,0,1,1
S01008160,Owned: Owned with a mortgage or loan or shared ownership,145,130,114,8,106,13,3,15,12,0,1,2,0
S01008160,Rented or living rent free: Total,179,84,58,13,45,7,19,95,36,3,13,35,8
S01008160,Rented or living rent free: Social rented,162,77,56,13,43,5,16,85,32,3,13,32,5
S01008160,Rented or living rent free: Private rented or living rent free,17,7,2,0,2,2,3,10,4,0,0,3,3
S01008161,All HRPs aged 16 and over,399,336,280,17,263,53,3,63,56,0,2,5,0
S01008161,Owned: Total,354,296,247,12,235,48,1,58,53,0,2,3,0
S01008161,Owned: Owned outright,104,54,38,5,33,15,1,50,49,0,1,0,0
S01008161,Owned: Owned with a mortgage or loan or shared ownership,250,242,209,7,202,33,0,8,4,0,1,3,0
S01008161,Rented or living rent free: Total,45,40,33,5,28,5,2,5,3,0,0,2,0
S01008161,Rented or living rent free: Social rented,20,15,13,1,12,1,1,5,3,0,0,2,0
S01008161,Rented or living rent free: Private rented or living rent free,25,25,20,4,16,4,1,0,0,0,0,0,0
S01008162,All HRPs aged 16 and over,430,279,239,28,211,38,2,151,126,2,4,18,1
S01008162,Owned: Total,313,222,188,16,172,34,0,91,82,1,4,3,1
S01008162,Owned: Owned outright,121,50,40,9,31,10,0,71,66,0,4,1,0
S01008162,Owned: Owned with a mortgage or loan or shared ownership,192,172,148,7,141,24,0,20,16,1,0,2,1
S01008162,Rented or living rent free: Total,117,57,51,12,39,4,2,60,44,1,0,15,0
S01008162,Rented or living rent free: Social rented,88,40,38,12,26,1,1,48,36,1,0,11,0
S01008162,Rented or living rent free: Private rented or living rent free,29,17,13,0,13,3,1,12,8,0,0,4,0
S01008163,All HRPs aged 16 and over,327,208,166,40,126,30,12,119,77,2,12,16,12
S01008163,Owned: Total,163,115,92,11,81,21,2,48,42,0,1,3,2
S01008163,Owned: Owned outright,63,29,24,7,17,4,1,34,31,0,1,1,1
S01008163,Owned: Owned with a mortgage or loan or shared ownership,100,86,68,4,64,17,1,14,11,0,0,2,1
S01008163,Rented or living rent free: Total,164,93,74,29,45,9,10,71,35,2,11,13,10
S01008163,Rented or living rent free: Social rented,115,57,47,19,28,3,7,58,29,2,10,9,8
S01008163,Rented or living rent free: Private rented or living rent free,49,36,27,10,17,6,3,13,6,0,1,4,2
S01008164,All HRPs aged 16 and over,289,203,164,33,131,23,16,86,58,3,4,13,8
S01008164,Owned: Total,158,123,102,8,94,20,1,35,29,0,1,1,4
S01008164,Owned: Owned outright,46,19,14,4,10,4,1,27,22,0,0,1,4
S01008164,Owned: Owned with a mortgage or loan or shared ownership,112,104,88,4,84,16,0,8,7,0,1,0,0
S01008164,Rented or living rent free: Total,131,80,62,25,37,3,15,51,29,3,3,12,4
S01008164,Rented or living rent free: Social rented,100,56,46,19,27,3,7,44,28,1,2,12,1
S01008164,Rented or living rent free: Private rented or living rent free,31,24,16,6,10,0,8,7,1,2,1,0,3
S01008165,All HRPs aged 16 and over,266,240,192,14,178,47,1,26,18,0,2,2,4
S01008165,Owned: Total,234,211,168,11,157,42,1,23,17,0,2,2,2
S01008165,Owned: Owned outright,39,21,13,5,8,8,0,18,16,0,1,1,0
S01008165,Owned: Owned with a mortgage or loan or shared ownership,195,190,155,6,149,34,1,5,1,0,1,1,2
S01008165,Rented or living rent free: Total,32,29,24,3,21,5,0,3,1,0,0,0,2
S01008165,Rented or living rent free: Social rented,7,5,5,2,3,0,0,2,0,0,0,0,2
S01008165,Rented or living rent free: Private rented or living rent free,25,24,19,1,18,5,0,1,1,0,0,0,0
S01008166,All HRPs aged 16 and over,226,149,125,26,99,18,6,77,57,0,8,10,2
S01008166,Owned: Total,137,97,82,12,70,14,1,40,39,0,0,1,0
S01008166,Owned: Owned outright,58,26,19,7,12,6,1,32,32,0,0,0,0
S01008166,Owned: Owned with a mortgage or loan or shared ownership,79,71,63,5,58,8,0,8,7,0,0,1,0
S01008166,Rented or living rent free: Total,89,52,43,14,29,4,5,37,18,0,8,9,2
S01008166,Rented or living rent free: Social rented,77,46,37,13,24,4,5,31,15,0,6,9,1
S01008166,Rented or living rent free: Private rented or living rent free,12,6,6,1,5,0,0,6,3,0,2,0,1
S01008167,All HRPs aged 16 and over,294,191,159,40,119,18,14,103,70,2,5,18,8
S01008167,Owned: Total,136,96,82,14,68,9,5,40,37,0,0,1,2
S01008167,Owned: Owned outright,67,35,30,7,23,3,2,32,30,0,0,0,2
S01008167,Owned: Owned with a mortgage or loan or shared ownership,69,61,52,7,45,6,3,8,7,0,0,1,0
S01008167,Rented or living rent free: Total,158,95,77,26,51,9,9,63,33,2,5,17,6
S01008167,Rented or living rent free: Social rented,136,78,64,21,43,7,7,58,32,1,4,15,6
S01008167,Rented or living rent free: Private rented or living rent free,22,17,13,5,8,2,2,5,1,1,1,2,0
S01008168,All HRPs aged 16 and over,349,229,201,42,159,13,15,120,71,2,16,26,5
S01008168,Owned: Total,162,130,117,16,101,12,1,32,28,0,0,3,1
S01008168,Owned: Owned outright,44,21,20,7,13,1,0,23,21,0,0,1,1
S01008168,Owned: Owned with a mortgage or loan or shared ownership,118,109,97,9,88,11,1,9,7,0,0,2,0
S01008168,Rented or living rent free: Total,187,99,84,26,58,1,14,88,43,2,16,23,4
S01008168,Rented or living rent free: Social rented,173,91,77,25,52,1,13,82,41,0,15,22,4
S01008168,Rented or living rent free: Private rented or living rent free,14,8,7,1,6,0,1,6,2,2,1,1,0
S01008169,All HRPs aged 16 and over,320,226,204,47,157,19,3,94,65,1,10,10,8
S01008169,Owned: Total,179,147,128,21,107,18,1,32,28,0,2,0,2
S01008169,Owned: Owned outright,53,30,28,9,19,2,0,23,21,0,1,0,1
S01008169,Owned: Owned with a mortgage or loan or shared ownership,126,117,100,12,88,16,1,9,7,0,1,0,1
S01008169,Rented or living rent free: Total,141,79,76,26,50,1,2,62,37,1,8,10,6
S01008169,Rented or living rent free: Social rented,117,62,59,20,39,1,2,55,35,0,6,8,6
S01008169,Rented or living rent free: Private rented or living rent free,24,17,17,6,11,0,0,7,2,1,2,2,0
S01008170,All HRPs aged 16 and over,231,169,133,7,126,31,5,62,49,2,2,5,4
S01008170,Owned: Total,198,153,121,6,115,28,4,45,39,1,1,1,3
S01008170,Owned: Owned outright,76,40,28,1,27,10,2,36,33,1,0,1,1
S01008170,Owned: Owned with a mortgage or loan or shared ownership,122,113,93,5,88,18,2,9,6,0,1,0,2
S01008170,Rented or living rent free: Total,33,16,12,1,11,3,1,17,10,1,1,4,1
S01008170,Rented or living rent free: Social rented,20,7,6,1,5,0,1,13,8,0,1,4,0
S01008170,Rented or living rent free: Private rented or living rent free,13,9,6,0,6,3,0,4,2,1,0,0,1
S01008171,All HRPs aged 16 and over,373,215,190,32,158,18,7,158,115,7,5,26,5
S01008171,Owned: Total,206,131,120,13,107,11,0,75,69,1,0,3,2
S01008171,Owned: Owned outright,97,32,29,6,23,3,0,65,62,1,0,2,0
S01008171,Owned: Owned with a mortgage or loan or shared ownership,109,99,91,7,84,8,0,10,7,0,0,1,2
S01008171,Rented or living rent free: Total,167,84,70,19,51,7,7,83,46,6,5,23,3
S01008171,Rented or living rent free: Social rented,117,50,41,12,29,4,5,67,41,0,2,21,3
S01008171,Rented or living rent free: Private rented or living rent free,50,34,29,7,22,3,2,16,5,6,3,2,0
S01008172,All HRPs aged 16 and over,250,159,132,25,107,25,2,91,79,1,2,6,3
S01008172,Owned: Total,194,130,109,16,93,20,1,64,61,0,0,0,3
S01008172,Owned: Owned outright,80,28,21,8,13,6,1,52,51,0,0,0,1
S01008172,Owned: Owned with a mortgage or loan or shared ownership,114,102,88,8,80,14,0,12,10,0,0,0,2
S01008172,Rented or living rent free: Total,56,29,23,9,14,5,1,27,18,1,2,6,0
S01008172,Rented or living rent free: Social rented,41,19,15,7,8,3,1,22,15,1,2,4,0
S01008172,Rented or living rent free: Private rented or living rent free,15,10,8,2,6,2,0,5,3,0,0,2,0
S01008173,All HRPs aged 16 and over,260,188,161,26,135,23,4,72,65,0,3,1,3
S01008173,Owned: Total,213,166,142,23,119,22,2,47,46,0,0,0,1
S01008173,Owned: Owned outright,80,41,37,11,26,4,0,39,38,0,0,0,1
S01008173,Owned: Owned with a mortgage or loan or shared ownership,133,125,105,12,93,18,2,8,8,0,0,0,0
S01008173,Rented or living rent free: Total,47,22,19,3,16,1,2,25,19,0,3,1,2
S01008173,Rented or living rent free: Social rented,37,13,11,3,8,0,2,24,18,0,3,1,2
S01008173,Rented or living rent free: Private rented or living rent free,10,9,8,0,8,1,0,1,1,0,0,0,0
S01008174,All HRPs aged 16 and over,226,161,133,15,118,27,1,65,56,2,0,4,3
S01008174,Owned: Total,191,141,116,6,110,24,1,50,45,2,0,0,3
S01008174,Owned: Owned outright,88,43,38,5,33,4,1,45,41,2,0,0,2
S01008174,Owned: Owned with a mortgage or loan or shared ownership,103,98,78,1,77,20,0,5,4,0,0,0,1
S01008174,Rented or living rent free: Total,35,20,17,9,8,3,0,15,11,0,0,4,0
S01008174,Rented or living rent free: Social rented,27,13,12,6,6,1,0,14,11,0,0,3,0
S01008174,Rented or living rent free: Private rented or living rent free,8,7,5,3,2,2,0,1,0,0,0,1,0
S01008175,All HRPs aged 16 and over,378,276,234,41,193,28,14,102,71,3,9,13,6
S01008175,Owned: Total,247,201,178,18,160,21,2,46,42,0,3,0,1
S01008175,Owned: Owned outright,75,40,34,9,25,5,1,35,35,0,0,0,0
S01008175,Owned: Owned with a mortgage or loan or shared ownership,172,161,144,9,135,16,1,11,7,0,3,0,1
S01008175,Rented or living rent free: Total,131,75,56,23,33,7,12,56,29,3,6,13,5
S01008175,Rented or living rent free: Social rented,78,38,30,20,10,3,5,40,21,0,3,12,4
S01008175,Rented or living rent free: Private rented or living rent free,53,37,26,3,23,4,7,16,8,3,3,1,1
S01008176,All HRPs aged 16 and over,327,230,181,21,160,46,3,97,83,6,1,7,0
S01008176,Owned: Total,259,185,144,15,129,39,2,74,72,0,0,2,0
S01008176,Owned: Owned outright,122,54,42,7,35,11,1,68,67,0,0,1,0
S01008176,Owned: Owned with a mortgage or loan or shared ownership,137,131,102,8,94,28,1,6,5,0,0,1,0
S01008176,Rented or living rent free: Total,68,45,37,6,31,7,1,23,11,6,1,5,0
S01008176,Rented or living rent free: Social rented,17,7,6,3,3,1,0,10,6,0,0,4,0
S01008176,Rented or living rent free: Private rented or living rent free,51,38,31,3,28,6,1,13,5,6,1,1,0
S01008177,All HRPs aged 16 and over,371,218,183,42,141,24,11,153,133,1,4,13,2
S01008177,Owned: Total,230,150,128,27,101,18,4,80,78,0,0,2,0
S01008177,Owned: Owned outright,106,39,35,14,21,2,2,67,65,0,0,2,0
S01008177,Owned: Owned with a mortgage or loan or shared ownership,124,111,93,13,80,16,2,13,13,0,0,0,0
S01008177,Rented or living rent free: Total,141,68,55,15,40,6,7,73,55,1,4,11,2
S01008177,Rented or living rent free: Social rented,113,46,37,12,25,5,4,67,51,0,4,10,2
S01008177,Rented or living rent free: Private rented or living rent free,28,22,18,3,15,1,3,6,4,1,0,1,0
S01008178,All HRPs aged 16 and over,278,166,142,22,120,20,4,112,100,2,3,5,2
S01008178,Owned: Total,223,134,119,18,101,15,0,89,84,2,0,2,1
S01008178,Owned: Owned outright,133,52,48,12,36,4,0,81,78,2,0,1,0
S01008178,Owned: Owned with a mortgage or loan or shared ownership,90,82,71,6,65,11,0,8,6,0,0,1,1
S01008178,Rented or living rent free: Total,55,32,23,4,19,5,4,23,16,0,3,3,1
S01008178,Rented or living rent free: Social rented,36,19,13,4,9,3,3,17,12,0,3,1,1
S01008178,Rented or living rent free: Private rented or living rent free,19,13,10,0,10,2,1,6,4,0,0,2,0
S01008179,All HRPs aged 16 and over,170,150,120,7,113,29,1,20,17,0,1,0,2
S01008179,Owned: Total,161,141,114,7,107,27,0,20,17,0,1,0,2
S01008179,Owned: Owned outright,38,21,19,3,16,2,0,17,16,0,0,0,1
S01008179,Owned: Owned with a mortgage or loan or shared ownership,123,120,95,4,91,25,0,3,1,0,1,0,1
S01008179,Rented or living rent free: Total,9,9,6,0,6,2,1,0,0,0,0,0,0
S01008179,Rented or living rent free: Social rented,2,2,2,0,2,0,0,0,0,0,0,0,0
S01008179,Rented or living rent free: Private rented or living rent free,7,7,4,0,4,2,1,0,0,0,0,0,0
S01008180,All HRPs aged 16 and over,167,144,120,12,108,24,0,23,21,0,2,0,0
S01008180,Owned: Total,157,135,112,10,102,23,0,22,20,0,2,0,0
S01008180,Owned: Owned outright,59,39,35,3,32,4,0,20,18,0,2,0,0
S01008180,Owned: Owned with a mortgage or loan or shared ownership,98,96,77,7,70,19,0,2,2,0,0,0,0
S01008180,Rented or living rent free: Total,10,9,8,2,6,1,0,1,1,0,0,0,0
S01008180,Rented or living rent free: Social rented,0,0,0,0,0,0,0,0,0,0,0,0,0
S01008180,Rented or living rent free: Private rented or living rent free,10,9,8,2,6,1,0,1,1,0,0,0,0
S01008181,All HRPs aged 16 and over,284,177,144,26,118,32,1,107,102,0,4,0,1
S01008181,Owned: Total,257,157,124,17,107,32,1,100,100,0,0,0,0
S01008181,Owned: Owned outright,149,55,43,14,29,11,1,94,94,0,0,0,0
S01008181,Owned: Owned with a mortgage or loan or shared ownership,108,102,81,3,78,21,0,6,6,0,0,0,0
S01008181,Rented or living rent free: Total,27,20,20,9,11,0,0,7,2,0,4,0,1
S01008181,Rented or living rent free: Social rented,12,9,9,3,6,0,0,3,0,0,3,0,0
S01008181,Rented or living rent free: Private rented or living rent free,15,11,11,6,5,0,0,4,2,0,1,0,1
S01008182,All HRPs aged 16 and over,563,387,328,51,277,32,27,176,118,19,4,27,8
S01008182,Owned: Total,313,230,206,24,182,21,3,83,69,4,0,6,4
S01008182,Owned: Owned outright,121,53,43,10,33,10,0,68,63,0,0,3,2
S01008182,Owned: Owned with a mortgage or loan or shared ownership,192,177,163,14,149,11,3,15,6,4,0,3,2
S01008182,Rented or living rent free: Total,250,157,122,27,95,11,24,93,49,15,4,21,4
S01008182,Rented or living rent free: Social rented,115,47,31,10,21,5,11,68,43,4,3,15,3
S01008182,Rented or living rent free: Private rented or living rent free,135,110,91,17,74,6,13,25,6,11,1,6,1
S01008183,All HRPs aged 16 and over,282,205,173,26,147,23,9,77,64,1,4,7,1
S01008183,Owned: Total,224,158,136,15,121,18,4,66,61,1,1,2,1
S01008183,Owned: Owned outright,88,35,30,5,25,4,1,53,52,0,1,0,0
S01008183,Owned: Owned with a mortgage or loan or shared ownership,136,123,106,10,96,14,3,13,9,1,0,2,1
S01008183,Rented or living rent free: Total,58,47,37,11,26,5,5,11,3,0,3,5,0
S01008183,Rented or living rent free: Social rented,20,14,13,3,10,0,1,6,2,0,2,2,0
S01008183,Rented or living rent free: Private rented or living rent free,38,33,24,8,16,5,4,5,1,0,1,3,0
S01008184,All HRPs aged 16 and over,481,283,227,40,187,35,21,198,173,8,1,10,6
S01008184,Owned: Total,267,190,160,24,136,26,4,77,73,1,0,2,1
S01008184,Owned: Owned outright,121,49,33,8,25,13,3,72,68,1,0,2,1
S01008184,Owned: Owned with a mortgage or loan or shared ownership,146,141,127,16,111,13,1,5,5,0,0,0,0
S01008184,Rented or living rent free: Total,214,93,67,16,51,9,17,121,100,7,1,8,5
S01008184,Rented or living rent free: Social rented,120,21,13,5,8,2,6,99,88,2,0,6,3
S01008184,Rented or living rent free: Private rented or living rent free,94,72,54,11,43,7,11,22,12,5,1,2,2
S01008185,All HRPs aged 16 and over,573,362,294,52,242,37,31,211,167,5,6,30,3
S01008185,Owned: Total,331,218,180,19,161,28,10,113,105,1,0,5,2
S01008185,Owned: Owned outright,134,41,30,8,22,7,4,93,90,0,0,2,1
S01008185,Owned: Owned with a mortgage or loan or shared ownership,197,177,150,11,139,21,6,20,15,1,0,3,1
S01008185,Rented or living rent free: Total,242,144,114,33,81,9,21,98,62,4,6,25,1
S01008185,Rented or living rent free: Social rented,148,73,55,24,31,3,15,75,52,0,4,19,0
S01008185,Rented or living rent free: Private rented or living rent free,94,71,59,9,50,6,6,23,10,4,2,6,1
S01008186,All HRPs aged 16 and over,366,231,183,18,165,27,21,135,103,6,3,18,5
S01008186,Owned: Total,227,136,112,11,101,19,5,91,84,0,0,5,2
S01008186,Owned: Owned outright,110,31,24,3,21,6,1,79,77,0,0,1,1
S01008186,Owned: Owned with a mortgage or loan or shared ownership,117,105,88,8,80,13,4,12,7,0,0,4,1
S01008186,Rented or living rent free: Total,139,95,71,7,64,8,16,44,19,6,3,13,3
S01008186,Rented or living rent free: Social rented,41,23,12,3,9,4,7,18,9,0,0,8,1
S01008186,Rented or living rent free: Private rented or living rent free,98,72,59,4,55,4,9,26,10,6,3,5,2
S01008187,All HRPs aged 16 and over,284,183,155,42,113,17,11,101,65,4,7,15,10
S01008187,Owned: Total,148,96,81,12,69,14,1,52,46,1,0,2,3
S01008187,Owned: Owned outright,58,16,12,4,8,4,0,42,39,1,0,0,2
S01008187,Owned: Owned with a mortgage or loan or shared ownership,90,80,69,8,61,10,1,10,7,0,0,2,1
S01008187,Rented or living rent free: Total,136,87,74,30,44,3,10,49,19,3,7,13,7
S01008187,Rented or living rent free: Social rented,108,68,57,28,29,2,9,40,15,2,6,10,7
S01008187,Rented or living rent free: Private rented or living rent free,28,19,17,2,15,1,1,9,4,1,1,3,0
S01008188,All HRPs aged 16 and over,485,263,218,52,166,26,19,222,161,15,9,30,7
S01008188,Owned: Total,196,143,122,20,102,19,2,53,50,0,0,1,2
S01008188,Owned: Owned outright,78,32,23,8,15,7,2,46,44,0,0,1,1
S01008188,Owned: Owned with a mortgage or loan or shared ownership,118,111,99,12,87,12,0,7,6,0,0,0,1
S01008188,Rented or living rent free: Total,289,120,96,32,64,7,17,169,111,15,9,29,5
S01008188,Rented or living rent free: Social rented,188,58,48,18,30,2,8,130,101,0,5,20,4
S01008188,Rented or living rent free: Private rented or living rent free,101,62,48,14,34,5,9,39,10,15,4,9,1
S01008189,All HRPs aged 16 and over,271,164,132,25,107,28,4,107,85,9,1,7,5
S01008189,Owned: Total,196,124,104,18,86,19,1,72,66,1,1,2,2
S01008189,Owned: Owned outright,105,41,33,9,24,7,1,64,60,1,1,2,0
S01008189,Owned: Owned with a mortgage or loan or shared ownership,91,83,71,9,62,12,0,8,6,0,0,0,2
S01008189,Rented or living rent free: Total,75,40,28,7,21,9,3,35,19,8,0,5,3
S01008189,Rented or living rent free: Social rented,48,25,18,5,13,5,2,23,16,0,0,4,3
S01008189,Rented or living rent free: Private rented or living rent free,27,15,10,2,8,4,1,12,3,8,0,1,0
S01008190,All HRPs aged 16 and over,365,230,191,43,148,26,13,135,107,1,8,13,6
S01008190,Owned: Total,183,118,99,16,83,18,1,65,62,0,1,0,2
S01008190,Owned: Owned outright,80,27,23,6,17,4,0,53,50,0,1,0,2
S01008190,Owned: Owned with a mortgage or loan or shared ownership,103,91,76,10,66,14,1,12,12,0,0,0,0
S01008190,Rented or living rent free: Total,182,112,92,27,65,8,12,70,45,1,7,13,4
S01008190,Rented or living rent free: Social rented,164,98,80,22,58,6,12,66,45,0,7,12,2
S01008190,Rented or living rent free: Private rented or living rent free,18,14,12,5,7,2,0,4,0,1,0,1,2
S01008191,All HRPs aged 16 and over,187,119,97,23,74,17,5,68,54,2,5,6,1
S01008191,Owned: Total,109,75,61,9,52,13,1,34,33,0,0,1,0
S01008191,Owned: Owned outright,57,27,23,6,17,3,1,30,29,0,0,1,0
S01008191,Owned: Owned with a mortgage or loan or shared ownership,52,48,38,3,35,10,0,4,4,0,0,0,0
S01008191,Rented or living rent free: Total,78,44,36,14,22,4,4,34,21,2,5,5,1
S01008191,Rented or living rent free: Social rented,68,37,31,12,19,3,3,31,20,0,5,5,1
S01008191,Rented or living rent free: Private rented or living rent free,10,7,5,2,3,1,1,3,1,2,0,0,0
S01008192,All HRPs aged 16 and over,360,248,213,37,176,26,9,112,77,5,8,21,1
S01008192,Owned: Total,201,150,127,16,111,22,1,51,43,0,2,6,0
S01008192,Owned: Owned outright,68,31,28,5,23,3,0,37,33,0,2,2,0
S01008192,Owned: Owned with a mortgage or loan or shared ownership,133,119,99,11,88,19,1,14,10,0,0,4,0
S01008192,Rented or living rent free: Total,159,98,86,21,65,4,8,61,34,5,6,15,1
S01008192,Rented or living rent free: Social rented,82,40,36,11,25,2,2,42,27,0,4,11,0
S01008192,Rented or living rent free: Private rented or living rent free,77,58,50,10,40,2,6,19,7,5,2,4,1
S01008193,All HRPs aged 16 and over,327,213,175,34,141,32,6,114,103,2,1,6,2
S01008193,Owned: Total,248,159,128,19,109,29,2,89,84,0,0,3,2
S01008193,Owned: Owned outright,117,43,30,8,22,11,2,74,72,0,0,0,2
S01008193,Owned: Owned with a mortgage or loan or shared ownership,131,116,98,11,87,18,0,15,12,0,0,3,0
S01008193,Rented or living rent free: Total,79,54,47,15,32,3,4,25,19,2,1,3,0
S01008193,Rented or living rent free: Social rented,54,37,33,14,19,2,2,17,13,1,0,3,0
S01008193,Rented or living rent free: Private rented or living rent free,25,17,14,1,13,1,2,8,6,1,1,0,0
S01008194,All HRPs aged 16 and over,244,174,143,24,119,23,8,70,50,1,4,10,5
S01008194,Owned: Total,154,116,96,15,81,19,1,38,35,0,0,3,0
S01008194,Owned: Owned outright,70,39,29,10,19,9,1,31,28,0,0,3,0
S01008194,Owned: Owned with a mortgage or loan or shared ownership,84,77,67,5,62,10,0,7,7,0,0,0,0
S01008194,Rented or living rent free: Total,90,58,47,9,38,4,7,32,15,1,4,7,5
S01008194,Rented or living rent free: Social rented,66,42,36,7,29,3,3,24,12,0,3,5,4
S01008194,Rented or living rent free: Private rented or living rent free,24,16,11,2,9,1,4,8,3,1,1,2,1
S01008195,All HRPs aged 16 and over,331,237,199,51,148,25,13,94,40,5,8,34,7
S01008195,Owned: Total,149,125,108,17,91,17,0,24,21,0,0,2,1
S01008195,Owned: Owned outright,35,16,12,5,7,4,0,19,18,0,0,0,1
S01008195,Owned: Owned with a mortgage or loan or shared ownership,114,109,96,12,84,13,0,5,3,0,0,2,0
S01008195,Rented or living rent free: Total,182,112,91,34,57,8,13,70,19,5,8,32,6
S01008195,Rented or living rent free: Social rented,153,94,78,31,47,5,11,59,18,2,7,27,5
S01008195,Rented or living rent free: Private rented or living rent free,29,18,13,3,10,3,2,11,1,3,1,5,1
S01008196,All HRPs aged 16 and over,333,240,192,53,139,27,21,93,49,0,10,22,12
S01008196,Owned: Total,157,120,97,18,79,21,2,37,32,0,1,2,2
S01008196,Owned: Owned outright,43,18,16,7,9,2,0,25,25,0,0,0,0
S01008196,Owned: Owned with a mortgage or loan or shared ownership,114,102,81,11,70,19,2,12,7,0,1,2,2
S01008196,Rented or living rent free: Total,176,120,95,35,60,6,19,56,17,0,9,20,10
S01008196,Rented or living rent free: Social rented,150,100,80,31,49,5,15,50,15,0,8,19,8
S01008196,Rented or living rent free: Private rented or living rent free,26,20,15,4,11,1,4,6,2,0,1,1,2
S01008197,All HRPs aged 16 and over,390,362,316,21,295,31,15,28,8,3,5,8,4
S01008197,Owned: Total,290,283,258,10,248,25,0,7,6,0,0,1,0
S01008197,Owned: Owned outright,32,27,20,3,17,7,0,5,4,0,0,1,0
S01008197,Owned: Owned with a mortgage or loan or shared ownership,258,256,238,7,231,18,0,2,2,0,0,0,0
S01008197,Rented or living rent free: Total,100,79,58,11,47,6,15,21,2,3,5,7,4
S01008197,Rented or living rent free: Social rented,60,44,32,8,24,1,11,16,2,1,4,7,2
S01008197,Rented or living rent free: Private rented or living rent free,40,35,26,3,23,5,4,5,0,2,1,0,2
S01008198,All HRPs aged 16 and over,300,178,152,33,119,17,9,122,99,0,8,12,3
S01008198,Owned: Total,187,117,103,20,83,12,2,70,67,0,0,2,1
S01008198,Owned: Owned outright,98,36,29,12,17,6,1,62,59,0,0,2,1
S01008198,Owned: Owned with a mortgage or loan or shared ownership,89,81,74,8,66,6,1,8,8,0,0,0,0
S01008198,Rented or living rent free: Total,113,61,49,13,36,5,7,52,32,0,8,10,2
S01008198,Rented or living rent free: Social rented,101,54,44,12,32,4,6,47,28,0,7,10,2
S01008198,Rented or living rent free: Private rented or living rent free,12,7,5,1,4,1,1,5,4,0,1,0,0
S01008199,All HRPs aged 16 and over,298,193,163,31,132,15,15,105,49,0,11,36,9
S01008199,Owned: Total,99,79,66,3,63,13,0,20,19,0,0,1,0
S01008199,Owned: Owned outright,30,12,10,3,7,2,0,18,17,0,0,1,0
S01008199,Owned: Owned with a mortgage or loan or shared ownership,69,67,56,0,56,11,0,2,2,0,0,0,0
S01008199,Rented or living rent free: Total,199,114,97,28,69,2,15,85,30,0,11,35,9
S01008199,Rented or living rent free: Social rented,184,104,88,27,61,1,15,80,28,0,10,35,7
S01008199,Rented or living rent free: Private rented or living rent free,15,10,9,1,8,1,0,5,2,0,1,0,2
S01008200,All HRPs aged 16 and over,300,153,124,32,92,18,11,147,112,3,5,19,8
S01008200,Owned: Total,126,70,53,8,45,14,3,56,55,0,0,0,1
S01008200,Owned: Owned outright,59,16,12,3,9,3,1,43,43,0,0,0,0
S01008200,Owned: Owned with a mortgage or loan or shared ownership,67,54,41,5,36,11,2,13,12,0,0,0,1
S01008200,Rented or living rent free: Total,174,83,71,24,47,4,8,91,57,3,5,19,7
S01008200,Rented or living rent free: Social rented,166,77,66,22,44,4,7,89,55,3,5,19,7
S01008200,Rented or living rent free: Private rented or living rent free,8,6,5,2,3,0,1,2,2,0,0,0,0
S01008201,All HRPs aged 16 and over,354,207,180,33,147,10,17,147,92,5,10,32,8
S01008201,Owned: Total,156,107,100,10,90,6,1,49,44,0,1,3,1
S01008201,Owned: Owned outright,62,21,18,2,16,2,1,41,36,0,1,3,1
S01008201,Owned: Owned with a mortgage or loan or shared ownership,94,86,82,8,74,4,0,8,8,0,0,0,0
S01008201,Rented or living rent free: Total,198,100,80,23,57,4,16,98,48,5,9,29,7
S01008201,Rented or living rent free: Social rented,179,86,68,19,49,4,14,93,46,4,9,28,6
S01008201,Rented or living rent free: Private rented or living rent free,19,14,12,4,8,0,2,5,2,1,0,1,1
S01008202,All HRPs aged 16 and over,261,147,127,16,111,15,5,114,103,2,1,6,2
S01008202,Owned: Total,161,118,105,11,94,13,0,43,39,2,0,1,1
S01008202,Owned: Owned outright,50,20,16,4,12,4,0,30,29,0,0,0,1
S01008202,Owned: Owned with a mortgage or loan or shared ownership,111,98,89,7,82,9,0,13,10,2,0,1,0
S01008202,Rented or living rent free: Total,100,29,22,5,17,2,5,71,64,0,1,5,1
S01008202,Rented or living rent free: Social rented,86,23,18,4,14,1,4,63,57,0,1,4,1
S01008202,Rented or living rent free: Private rented or living rent free,14,6,4,1,3,1,1,8,7,0,0,1,0
S01008203,All HRPs aged 16 and over,283,189,146,30,116,18,25,94,68,0,4,17,5
S01008203,Owned: Total,115,86,75,9,66,7,4,29,28,0,0,1,0
S01008203,Owned: Owned outright,36,17,13,3,10,2,2,19,19,0,0,0,0
S01008203,Owned: Owned with a mortgage or loan or shared ownership,79,69,62,6,56,5,2,10,9,0,0,1,0
S01008203,Rented or living rent free: Total,168,103,71,21,50,11,21,65,40,0,4,16,5
S01008203,Rented or living rent free: Social rented,118,64,47,18,29,5,12,54,38,0,3,12,1
S01008203,Rented or living rent free: Private rented or living rent free,50,39,24,3,21,6,9,11,2,0,1,4,4
S01008204,All HRPs aged 16 and over,480,218,177,29,148,28,13,262,212,0,4,39,7
S01008204,Owned: Total,260,158,127,14,113,25,6,102,95,0,1,5,1
S01008204,Owned: Owned outright,131,42,29,9,20,12,1,89,85,0,0,4,0
S01008204,Owned: Owned with a mortgage or loan or shared ownership,129,116,98,5,93,13,5,13,10,0,1,1,1
S01008204,Rented or living rent free: Total,220,60,50,15,35,3,7,160,117,0,3,34,6
S01008204,Rented or living rent free: Social rented,188,38,31,11,20,2,5,150,112,0,2,31,5
S01008204,Rented or living rent free: Private rented or living rent free,32,22,19,4,15,1,2,10,5,0,1,3,1
S01008205,All HRPs aged 16 and over,276,179,142,34,108,28,9,97,75,0,5,10,7
S01008205,Owned: Total,162,110,89,15,74,19,2,52,50,0,0,2,0
S01008205,Owned: Owned outright,66,24,20,6,14,3,1,42,41,0,0,1,0
S01008205,Owned: Owned with a mortgage or loan or shared ownership,96,86,69,9,60,16,1,10,9,0,0,1,0
S01008205,Rented or living rent free: Total,114,69,53,19,34,9,7,45,25,0,5,8,7
S01008205,Rented or living rent free: Social rented,99,60,48,18,30,7,5,39,23,0,3,7,6
S01008205,Rented or living rent free: Private rented or living rent free,15,9,5,1,4,2,2,6,2,0,2,1,1
S01008206,All HRPs aged 16 and over,295,175,152,32,120,17,6,120,94,2,2,16,6
S01008206,Owned: Total,155,97,90,14,76,7,0,58,56,0,0,1,1
S01008206,Owned: Owned outright,66,24,22,7,15,2,0,42,41,0,0,1,0
S01008206,Owned: Owned with a mortgage or loan or shared ownership,89,73,68,7,61,5,0,16,15,0,0,0,1
S01008206,Rented or living rent free: Total,140,78,62,18,44,10,6,62,38,2,2,15,5
S01008206,Rented or living rent free: Social rented,125,68,54,17,37,9,5,57,34,1,2,15,5
S01008206,Rented or living rent free: Private rented or living rent free,15,10,8,1,7,1,1,5,4,1,0,0,0
S01008207,All HRPs aged 16 and over,246,173,138,32,106,24,11,73,47,1,6,18,1
S01008207,Owned: Total,89,69,54,3,51,14,1,20,15,1,0,3,1
S01008207,Owned: Owned outright,23,8,5,1,4,3,0,15,12,0,0,3,0
S01008207,Owned: Owned with a mortgage or loan or shared ownership,66,61,49,2,47,11,1,5,3,1,0,0,1
S01008207,Rented or living rent free: Total,157,104,84,29,55,10,10,53,32,0,6,15,0
S01008207,Rented or living rent free: Social rented,148,97,78,27,51,9,10,51,31,0,5,15,0
S01008207,Rented or living rent free: Private rented or living rent free,9,7,6,2,4,1,0,2,1,0,1,0,0
S01008208,All HRPs aged 16 and over,344,304,256,26,230,32,16,40,26,3,2,6,3
S01008208,Owned: Total,253,231,198,16,182,27,6,22,20,0,0,1,1
S01008208,Owned: Owned outright,46,29,24,7,17,4,1,17,16,0,0,1,0
S01008208,Owned: Owned with a mortgage or loan or shared ownership,207,202,174,9,165,23,5,5,4,0,0,0,1
S01008208,Rented or living rent free: Total,91,73,58,10,48,5,10,18,6,3,2,5,2
S01008208,Rented or living rent free: Social rented,56,43,32,8,24,4,7,13,5,1,2,4,1
S01008208,Rented or living rent free: Private rented or living rent free,35,30,26,2,24,1,3,5,1,2,0,1,1
S01008209,All HRPs aged 16 and over,200,180,141,15,126,39,0,20,18,0,1,1,0
S01008209,Owned: Total,176,159,123,8,115,36,0,17,16,0,0,1,0
S01008209,Owned: Owned outright,17,10,7,2,5,3,0,7,7,0,0,0,0
S01008209,Owned: Owned with a mortgage or loan or shared ownership,159,149,116,6,110,33,0,10,9,0,0,1,0
S01008209,Rented or living rent free: Total,24,21,18,7,11,3,0,3,2,0,1,0,0
S01008209,Rented or living rent free: Social rented,5,5,5,2,3,0,0,0,0,0,0,0,0
S01008209,Rented or living rent free: Private rented or living rent free,19,16,13,5,8,3,0,3,2,0,1,0,0
S01008210,All HRPs aged 16 and over,417,286,222,33,189,42,22,131,109,0,4,17,1
S01008210,Owned: Total,267,191,153,19,134,33,5,76,70,0,0,6,0
S01008210,Owned: Owned outright,128,63,46,12,34,13,4,65,63,0,0,2,0
S01008210,Owned: Owned with a mortgage or loan or shared ownership,139,128,107,7,100,20,1,11,7,0,0,4,0
S01008210,Rented or living rent free: Total,150,95,69,14,55,9,17,55,39,0,4,11,1
S01008210,Rented or living rent free: Social rented,118,73,51,10,41,8,14,45,35,0,1,9,0
S01008210,Rented or living rent free: Private rented or living rent free,32,22,18,4,14,1,3,10,4,0,3,2,1
S01008211,All HRPs aged 16 and over,420,274,213,31,182,44,17,146,117,1,9,15,4
S01008211,Owned: Total,275,201,165,20,145,31,5,74,66,0,1,4,3
S01008211,Owned: Owned outright,118,54,39,7,32,13,2,64,59,0,0,3,2
S01008211,Owned: Owned with a mortgage or loan or shared ownership,157,147,126,13,113,18,3,10,7,0,1,1,1
S01008211,Rented or living rent free: Total,145,73,48,11,37,13,12,72,51,1,8,11,1
S01008211,Rented or living rent free: Social rented,100,47,34,7,27,5,8,53,37,1,7,8,0
S01008211,Rented or living rent free: Private rented or living rent free,45,26,14,4,10,8,4,19,14,0,1,3,1
S01008212,All HRPs aged 16 and over,212,179,154,19,135,23,2,33,26,1,3,3,0
S01008212,Owned: Total,190,163,140,15,125,23,0,27,26,0,1,0,0
S01008212,Owned: Owned outright,58,34,30,8,22,4,0,24,24,0,0,0,0
S01008212,Owned: Owned with a mortgage or loan or shared ownership,132,129,110,7,103,19,0,3,2,0,1,0,0
S01008212,Rented or living rent free: Total,22,16,14,4,10,0,2,6,0,1,2,3,0
S01008212,Rented or living rent free: Social rented,10,9,8,3,5,0,1,1,0,0,0,1,0
S01008212,Rented or living rent free: Private rented or living rent free,12,7,6,1,5,0,1,5,0,1,2,2,0
S01008213,All HRPs aged 16 and over,370,285,238,24,214,40,7,85,76,2,3,3,1
S01008213,Owned: Total,319,250,213,20,193,34,3,69,63,2,2,2,0
S01008213,Owned: Owned outright,110,52,41,9,32,10,1,58,56,1,0,1,0
S01008213,Owned: Owned with a mortgage or loan or shared ownership,209,198,172,11,161,24,2,11,7,1,2,1,0
S01008213,Rented or living rent free: Total,51,35,25,4,21,6,4,16,13,0,1,1,1
S01008213,Rented or living rent free: Social rented,33,20,15,4,11,3,2,13,11,0,1,1,0
S01008213,Rented or living rent free: Private rented or living rent free,18,15,10,0,10,3,2,3,2,0,0,0,1
S01008214,All HRPs aged 16 and over,354,195,163,27,136,19,13,159,134,0,2,22,1
S01008214,Owned: Total,220,127,112,11,101,12,3,93,87,0,0,6,0
S01008214,Owned: Owned outright,115,35,32,6,26,1,2,80,75,0,0,5,0
S01008214,Owned: Owned with a mortgage or loan or shared ownership,105,92,80,5,75,11,1,13,12,0,0,1,0
S01008214,Rented or living rent free: Total,134,68,51,16,35,7,10,66,47,0,2,16,1
S01008214,Rented or living rent free: Social rented,100,49,37,12,25,4,8,51,36,0,1,13,1
S01008214,Rented or living rent free: Private rented or living rent free,34,19,14,4,10,3,2,15,11,0,1,3,0
S01008215,All HRPs aged 16 and over,324,220,193,28,165,19,8,104,85,0,2,14,3
S01008215,Owned: Total,250,173,155,15,140,17,1,77,73,0,1,3,0
S01008215,Owned: Owned outright,98,36,32,5,27,4,0,62,59,0,0,3,0
S01008215,Owned: Owned with a mortgage or loan or shared ownership,152,137,123,10,113,13,1,15,14,0,1,0,0
S01008215,Rented or living rent free: Total,74,47,38,13,25,2,7,27,12,0,1,11,3
S01008215,Rented or living rent free: Social rented,48,27,24,11,13,1,2,21,12,0,0,7,2
S01008215,Rented or living rent free: Private rented or living rent free,26,20,14,2,12,1,5,6,0,0,1,4,1
S01008216,All HRPs aged 16 and over,205,159,130,17,113,26,3,46,39,4,2,1,0
S01008216,Owned: Total,188,152,124,15,109,26,2,36,35,0,1,0,0
S01008216,Owned: Owned outright,70,43,34,6,28,8,1,27,26,0,1,0,0
S01008216,Owned: Owned with a mortgage or loan or shared ownership,118,109,90,9,81,18,1,9,9,0,0,0,0
S01008216,Rented or living rent free: Total,17,7,6,2,4,0,1,10,4,4,1,1,0
S01008216,Rented or living rent free: Social rented,4,2,1,0,1,0,1,2,1,0,0,1,0
S01008216,Rented or living rent free: Private rented or living rent free,13,5,5,2,3,0,0,8,3,4,1,0,0
S01008217,All HRPs aged 16 and over,226,162,128,13,115,33,1,64,61,0,1,2,0
S01008217,Owned: Total,209,150,120,11,109,29,1,59,56,0,1,2,0
S01008217,Owned: Owned outright,100,50,39,9,30,10,1,50,48,0,1,1,0
S01008217,Owned: Owned with a mortgage or loan or shared ownership,109,100,81,2,79,19,0,9,8,0,0,1,0
S01008217,Rented or living rent free: Total,17,12,8,2,6,4,0,5,5,0,0,0,0
S01008217,Rented or living rent free: Social rented,4,2,2,1,1,0,0,2,2,0,0,0,0
S01008217,Rented or living rent free: Private rented or living rent free,13,10,6,1,5,4,0,3,3,0,0,0,0
S01008218,All HRPs aged 16 and over,376,336,263,27,236,68,5,40,38,0,1,1,0
S01008218,Owned: Total,351,313,242,21,221,68,3,38,36,0,1,1,0
S01008218,Owned: Owned outright,89,59,44,14,30,15,0,30,30,0,0,0,0
S01008218,Owned: Owned with a mortgage or loan or shared ownership,262,254,198,7,191,53,3,8,6,0,1,1,0
S01008218,Rented or living rent free: Total,25,23,21,6,15,0,2,2,2,0,0,0,0
S01008218,Rented or living rent free: Social rented,11,10,9,2,7,0,1,1,1,0,0,0,0
S01008218,Rented or living rent free: Private rented or living rent free,14,13,12,4,8,0,1,1,1,0,0,0,0
S01008219,All HRPs aged 16 and over,424,315,248,39,209,48,19,109,76,1,6,21,5
S01008219,Owned: Total,258,200,167,22,145,30,3,58,55,0,0,2,1
S01008219,Owned: Owned outright,91,44,37,14,23,7,0,47,46,0,0,0,1
S01008219,Owned: Owned with a mortgage or loan or shared ownership,167,156,130,8,122,23,3,11,9,0,0,2,0
S01008219,Rented or living rent free: Total,166,115,81,17,64,18,16,51,21,1,6,19,4
S01008219,Rented or living rent free: Social rented,98,62,45,12,33,6,11,36,13,1,4,16,2
S01008219,Rented or living rent free: Private rented or living rent free,68,53,36,5,31,12,5,15,8,0,2,3,2
S01008220,All HRPs aged 16 and over,223,144,118,24,94,17,9,79,43,1,14,9,12
S01008220,Owned: Total,99,68,56,5,51,10,2,31,26,0,0,1,4
S01008220,Owned: Owned outright,37,14,11,2,9,3,0,23,20,0,0,1,2
S01008220,Owned: Owned with a mortgage or loan or shared ownership,62,54,45,3,42,7,2,8,6,0,0,0,2
S01008220,Rented or living rent free: Total,124,76,62,19,43,7,7,48,17,1,14,8,8
S01008220,Rented or living rent free: Social rented,117,72,59,19,40,6,7,45,17,0,13,8,7
S01008220,Rented or living rent free: Private rented or living rent free,7,4,3,0,3,1,0,3,0,1,1,0,1
S01008221,All HRPs aged 16 and over,309,209,157,36,121,19,33,100,61,1,14,16,8
S01008221,Owned: Total,105,68,57,11,46,10,1,37,35,0,1,0,1
S01008221,Owned: Owned outright,49,16,12,6,6,3,1,33,31,0,1,0,1
S01008221,Owned: Owned with a mortgage or loan or shared ownership,56,52,45,5,40,7,0,4,4,0,0,0,0
S01008221,Rented or living rent free: Total,204,141,100,25,75,9,32,63,26,1,13,16,7
S01008221,Rented or living rent free: Social rented,176,119,88,23,65,8,23,57,22,1,13,14,7
S01008221,Rented or living rent free: Private rented or living rent free,28,22,12,2,10,1,9,6,4,0,0,2,0
S01008222,All HRPs aged 16 and over,287,148,122,26,96,14,12,139,118,1,5,9,6
S01008222,Owned: Total,129,74,63,8,55,8,3,55,53,0,0,1,1
S01008222,Owned: Owned outright,53,10,8,2,6,1,1,43,42,0,0,1,0
S01008222,Owned: Owned with a mortgage or loan or shared ownership,76,64,55,6,49,7,2,12,11,0,0,0,1
S01008222,Rented or living rent free: Total,158,74,59,18,41,6,9,84,65,1,5,8,5
S01008222,Rented or living rent free: Social rented,139,64,50,15,35,5,9,75,61,0,4,7,3
S01008222,Rented or living rent free: Private rented or living rent free,19,10,9,3,6,1,0,9,4,1,1,1,2
S01008223,All HRPs aged 16 and over,280,142,125,24,101,10,7,138,110,2,2,18,6
S01008223,Owned: Total,135,87,79,12,67,6,2,48,47,0,0,0,1
S01008223,Owned: Owned outright,59,19,18,5,13,1,0,40,39,0,0,0,1
S01008223,Owned: Owned with a mortgage or loan or shared ownership,76,68,61,7,54,5,2,8,8,0,0,0,0
S01008223,Rented or living rent free: Total,145,55,46,12,34,4,5,90,63,2,2,18,5
S01008223,Rented or living rent free: Social rented,131,47,38,12,26,4,5,84,59,2,1,18,4
S01008223,Rented or living rent free: Private rented or living rent free,14,8,8,0,8,0,0,6,4,0,1,0,1
S01008224,All HRPs aged 16 and over,406,302,266,30,236,31,5,104,93,0,2,6,3
S01008224,Owned: Total,356,263,238,23,215,23,2,93,88,0,1,3,1
S01008224,Owned: Owned outright,143,65,61,13,48,4,0,78,75,0,0,2,1
S01008224,Owned: Owned with a mortgage or loan or shared ownership,213,198,177,10,167,19,2,15,13,0,1,1,0
S01008224,Rented or living rent free: Total,50,39,28,7,21,8,3,11,5,0,1,3,2
S01008224,Rented or living rent free: Social rented,15,6,4,2,2,2,0,9,5,0,1,2,1
S01008224,Rented or living rent free: Private rented or living rent free,35,33,24,5,19,6,3,2,0,0,0,1,1
S01008225,All HRPs aged 16 and over,290,194,168,24,144,23,3,96,82,2,4,8,0
S01008225,Owned: Total,201,140,118,9,109,21,1,61,60,0,1,0,0
S01008225,Owned: Owned outright,94,41,35,7,28,6,0,53,52,0,1,0,0
S01008225,Owned: Owned with a mortgage or loan or shared ownership,107,99,83,2,81,15,1,8,8,0,0,0,0
S01008225,Rented or living rent free: Total,89,54,50,15,35,2,2,35,22,2,3,8,0
S01008225,Rented or living rent free: Social rented,77,43,40,12,28,2,1,34,21,2,3,8,0
S01008225,Rented or living rent free: Private rented or living rent free,12,11,10,3,7,0,1,1,1,0,0,0,0
S01008226,All HRPs aged 16 and over,379,204,167,39,128,21,16,175,138,1,3,28,5
S01008226,Owned: Total,151,109,95,11,84,11,3,42,42,0,0,0,0
S01008226,Owned: Owned outright,53,20,15,5,10,5,0,33,33,0,0,0,0
S01008226,Owned: Owned with a mortgage or loan or shared ownership,98,89,80,6,74,6,3,9,9,0,0,0,0
S01008226,Rented or living rent free: Total,228,95,72,28,44,10,13,133,96,1,3,28,5
S01008226,Rented or living rent free: Social rented,204,78,60,24,36,9,9,126,93,0,3,27,3
S01008226,Rented or living rent free: Private rented or living rent free,24,17,12,4,8,1,4,7,3,1,0,1,2
S01008227,All HRPs aged 16 and over,389,232,203,38,165,18,11,157,113,3,6,26,9
S01008227,Owned: Total,171,115,104,12,92,10,1,56,54,1,0,1,0
S01008227,Owned: Owned outright,69,22,19,4,15,2,1,47,46,0,0,1,0
S01008227,Owned: Owned with a mortgage or loan or shared ownership,102,93,85,8,77,8,0,9,8,1,0,0,0
S01008227,Rented or living rent free: Total,218,117,99,26,73,8,10,101,59,2,6,25,9
S01008227,Rented or living rent free: Social rented,192,105,89,25,64,6,10,87,55,2,5,17,8
S01008227,Rented or living rent free: Private rented or living rent free,26,12,10,1,9,2,0,14,4,0,1,8,1
S01008228,All HRPs aged 16 and over,279,192,144,19,125,38,10,87,75,0,1,7,4
S01008228,Owned: Total,216,148,112,11,101,35,1,68,64,0,0,3,1
S01008228,Owned: Owned outright,102,40,30,6,24,9,1,62,59,0,0,2,1
S01008228,Owned: Owned with a mortgage or loan or shared ownership,114,108,82,5,77,26,0,6,5,0,0,1,0
S01008228,Rented or living rent free: Total,63,44,32,8,24,3,9,19,11,0,1,4,3
S01008228,Rented or living rent free: Social rented,46,30,22,6,16,2,6,16,10,0,0,3,3
S01008228,Rented or living rent free: Private rented or living rent free,17,14,10,2,8,1,3,3,1,0,1,1,0
S01008229,All HRPs aged 16 and over,300,192,171,39,132,16,5,108,84,2,0,18,4
S01008229,Owned: Total,155,103,94,12,82,8,1,52,50,1,0,1,0
S01008229,Owned: Owned outright,63,26,24,8,16,1,1,37,36,1,0,0,0
S01008229,Owned: Owned with a mortgage or loan or shared ownership,92,77,70,4,66,7,0,15,14,0,0,1,0
S01008229,Rented or living rent free: Total,145,89,77,27,50,8,4,56,34,1,0,17,4
S01008229,Rented or living rent free: Social rented,137,85,75,26,49,7,3,52,31,1,0,17,3
S01008229,Rented or living rent free: Private rented or living rent free,8,4,2,1,1,1,1,4,3,0,0,0,1
S01008230,All HRPs aged 16 and over,305,276,236,19,217,36,4,29,22,0,0,5,2
S01008230,Owned: Total,255,236,203,13,190,33,0,19,18,0,0,1,0
S01008230,Owned: Owned outright,38,21,19,2,17,2,0,17,17,0,0,0,0
S01008230,Owned: Owned with a mortgage or loan or shared ownership,217,215,184,11,173,31,0,2,1,0,0,1,0
S01008230,Rented or living rent free: Total,50,40,33,6,27,3,4,10,4,0,0,4,2
S01008230,Rented or living rent free: Social rented,22,15,12,3,9,0,3,7,3,0,0,2,2
S01008230,Rented or living rent free: Private rented or living rent free,28,25,21,3,18,3,1,3,1,0,0,2,0
S01008231,All HRPs aged 16 and over,243,228,184,6,178,40,4,15,9,2,2,2,0
S01008231,Owned: Total,226,216,174,4,170,39,3,10,8,1,1,0,0
S01008231,Owned: Owned outright,21,14,10,0,10,4,0,7,5,1,1,0,0
S01008231,Owned: Owned with a mortgage or loan or shared ownership,205,202,164,4,160,35,3,3,3,0,0,0,0
S01008231,Rented or living rent free: Total,17,12,10,2,8,1,1,5,1,1,1,2,0
S01008231,Rented or living rent free: Social rented,6,4,3,0,3,1,0,2,0,0,0,2,0
S01008231,Rented or living rent free: Private rented or living rent free,11,8,7,2,5,0,1,3,1,1,1,0,0
S01008232,All HRPs aged 16 and over,259,238,194,23,171,30,14,21,6,0,4,8,3
S01008232,Owned: Total,178,172,144,8,136,26,2,6,6,0,0,0,0
S01008232,Owned: Owned outright,19,14,13,2,11,1,0,5,5,0,0,0,0
S01008232,Owned: Owned with a mortgage or loan or shared ownership,159,158,131,6,125,25,2,1,1,0,0,0,0
S01008232,Rented or living rent free: Total,81,66,50,15,35,4,12,15,0,0,4,8,3
S01008232,Rented or living rent free: Social rented,56,43,30,11,19,2,11,13,0,0,4,7,2
S01008232,Rented or living rent free: Private rented or living rent free,25,23,20,4,16,2,1,2,0,0,0,1,1
S01008233,All HRPs aged 16 and over,178,154,124,10,114,26,4,24,16,1,2,4,1
S01008233,Owned: Total,119,106,86,3,83,20,0,13,11,1,1,0,0
S01008233,Owned: Owned outright,25,17,10,2,8,7,0,8,8,0,0,0,0
S01008233,Owned: Owned with a mortgage or loan or shared ownership,94,89,76,1,75,13,0,5,3,1,1,0,0
S01008233,Rented or living rent free: Total,59,48,38,7,31,6,4,11,5,0,1,4,1
S01008233,Rented or living rent free: Social rented,41,30,25,3,22,2,3,11,5,0,1,4,1
S01008233,Rented or living rent free: Private rented or living rent free,18,18,13,4,9,4,1,0,0,0,0,0,0
S01008234,All HRPs aged 16 and over,187,99,84,14,70,15,0,88,72,1,3,11,1
S01008234,Owned: Total,107,63,50,4,46,13,0,44,42,0,1,1,0
S01008234,Owned: Owned outright,57,18,13,4,9,5,0,39,38,0,1,0,0
S01008234,Owned: Owned with a mortgage or loan or shared ownership,50,45,37,0,37,8,0,5,4,0,0,1,0
S01008234,Rented or living rent free: Total,80,36,34,10,24,2,0,44,30,1,2,10,1
S01008234,Rented or living rent free: Social rented,75,34,32,10,22,2,0,41,29,1,2,8,1
S01008234,Rented or living rent free: Private rented or living rent free,5,2,2,0,2,0,0,3,1,0,0,2,0
S01008235,All HRPs aged 16 and over,368,220,175,26,149,39,6,148,121,1,5,17,4
S01008235,Owned: Total,216,148,112,12,100,35,1,68,64,0,1,2,1
S01008235,Owned: Owned outright,107,49,30,5,25,18,1,58,55,0,0,2,1
S01008235,Owned: Owned with a mortgage or loan or shared ownership,109,99,82,7,75,17,0,10,9,0,1,0,0
S01008235,Rented or living rent free: Total,152,72,63,14,49,4,5,80,57,1,4,15,3
S01008235,Rented or living rent free: Social rented,134,63,56,14,42,4,3,71,49,1,3,15,3
S01008235,Rented or living rent free: Private rented or living rent free,18,9,7,0,7,0,2,9,8,0,1,0,0
S01008236,All HRPs aged 16 and over,386,256,197,33,164,45,14,130,107,0,5,14,4
S01008236,Owned: Total,250,177,139,14,125,36,2,73,71,0,1,1,0
S01008236,Owned: Owned outright,122,56,43,8,35,11,2,66,64,0,1,1,0
S01008236,Owned: Owned with a mortgage or loan or shared ownership,128,121,96,6,90,25,0,7,7,0,0,0,0
S01008236,Rented or living rent free: Total,136,79,58,19,39,9,12,57,36,0,4,13,4
S01008236,Rented or living rent free: Social rented,101,56,43,18,25,3,10,45,29,0,4,8,4
S01008236,Rented or living rent free: Private rented or living rent free,35,23,15,1,14,6,2,12,7,0,0,5,0
S01008237,All HRPs aged 16 and over,376,261,192,39,153,54,15,115,85,0,4,21,5
S01008237,Owned: Total,210,161,123,18,105,37,1,49,49,0,0,0,0
S01008237,Owned: Owned outright,92,48,29,9,20,19,0,44,44,0,0,0,0
S01008237,Owned: Owned with a mortgage or loan or shared ownership,118,113,94,9,85,18,1,5,5,0,0,0,0
S01008237,Rented or living rent free: Total,166,100,69,21,48,17,14,66,36,0,4,21,5
S01008237,Rented or living rent free: Social rented,127,70,51,17,34,7,12,57,29,0,3,20,5
S01008237,Rented or living rent free: Private rented or living rent free,39,30,18,4,14,10,2,9,7,0,1,1,0
S01008238,All HRPs aged 16 and over,341,196,155,27,128,25,16,145,121,2,5,15,2
S01008238,Owned: Total,188,117,99,13,86,18,0,71,68,0,0,3,0
S01008238,Owned: Owned outright,95,33,25,8,17,8,0,62,60,0,0,2,0
S01008238,Owned: Owned with a mortgage or loan or shared ownership,93,84,74,5,69,10,0,9,8,0,0,1,0
S01008238,Rented or living rent free: Total,153,79,56,14,42,7,16,74,53,2,5,12,2
S01008238,Rented or living rent free: Social rented,139,71,50,14,36,6,15,68,50,1,5,10,2
S01008238,Rented or living rent free: Private rented or living rent free,14,8,6,0,6,1,1,6,3,1,0,2,0
S01008239,All HRPs aged 16 and over,331,221,175,28,147,44,2,110,97,0,6,7,0
S01008239,Owned: Total,219,156,120,16,104,36,0,63,63,0,0,0,0
S01008239,Owned: Owned outright,84,30,18,10,8,12,0,54,54,0,0,0,0
S01008239,Owned: Owned with a mortgage or loan or shared ownership,135,126,102,6,96,24,0,9,9,0,0,0,0
S01008239,Rented or living rent free: Total,112,65,55,12,43,8,2,47,34,0,6,7,0
S01008239,Rented or living rent free: Social rented,81,41,38,8,30,1,2,40,29,0,6,5,0
S01008239,Rented or living rent free: Private rented or living rent free,31,24,17,4,13,7,0,7,5,0,0,2,0
S01008240,All HRPs aged 16 and over,358,222,178,28,150,44,0,136,133,1,1,1,0
S01008240,Owned: Total,322,195,161,23,138,34,0,127,125,0,1,1,0
S01008240,Owned: Owned outright,190,75,62,16,46,13,0,115,114,0,1,0,0
S01008240,Owned: Owned with a mortgage or loan or shared ownership,132,120,99,7,92,21,0,12,11,0,0,1,0
S01008240,Rented or living rent free: Total,36,27,17,5,12,10,0,9,8,1,0,0,0
S01008240,Rented or living rent free: Social rented,7,5,5,2,3,0,0,2,1,1,0,0,0
S01008240,Rented or living rent free: Private rented or living rent free,29,22,12,3,9,10,0,7,7,0,0,0,0
S01008241,All HRPs aged 16 and over,271,165,123,17,106,38,4,106,101,2,2,0,1
S01008241,Owned: Total,258,159,120,16,104,36,3,99,97,0,1,0,1
S01008241,Owned: Owned outright,163,74,55,11,44,17,2,89,88,0,0,0,1
S01008241,Owned: Owned with a mortgage or loan or shared ownership,95,85,65,5,60,19,1,10,9,0,1,0,0
S01008241,Rented or living rent free: Total,13,6,3,1,2,2,1,7,4,2,1,0,0
S01008241,Rented or living rent free: Social rented,4,1,0,0,0,1,0,3,2,0,1,0,0
S01008241,Rented or living rent free: Private rented or living rent free,9,5,3,1,2,1,1,4,2,2,0,0,0
S01008242,All HRPs aged 16 and over,430,230,178,37,141,46,6,200,179,1,1,16,3
S01008242,Owned: Total,254,141,109,17,92,30,2,113,109,0,0,3,1
S01008242,Owned: Owned outright,146,50,38,13,25,10,2,96,93,0,0,2,1
S01008242,Owned: Owned with a mortgage or loan or shared ownership,108,91,71,4,67,20,0,17,16,0,0,1,0
S01008242,Rented or living rent free: Total,176,89,69,20,49,16,4,87,70,1,1,13,2
S01008242,Rented or living rent free: Social rented,110,45,37,14,23,7,1,65,53,0,1,9,2
S01008242,Rented or living rent free: Private rented or living rent free,66,44,32,6,26,9,3,22,17,1,0,4,0
S01008243,All HRPs aged 16 and over,361,262,193,18,175,67,2,99,91,0,2,4,2
S01008243,Owned: Total,240,187,139,10,129,48,0,53,50,0,2,0,1
S01008243,Owned: Owned outright,89,40,26,4,22,14,0,49,47,0,1,0,1
S01008243,Owned: Owned with a mortgage or loan or shared ownership,151,147,113,6,107,34,0,4,3,0,1,0,0
S01008243,Rented or living rent free: Total,121,75,54,8,46,19,2,46,41,0,0,4,1
S01008243,Rented or living rent free: Social rented,63,31,24,3,21,6,1,32,30,0,0,2,0
S01008243,Rented or living rent free: Private rented or living rent free,58,44,30,5,25,13,1,14,11,0,0,2,1
S01008244,All HRPs aged 16 and over,255,149,105,15,90,38,6,106,95,0,0,8,3
S01008244,Owned: Total,179,103,71,9,62,29,3,76,74,0,0,1,1
S01008244,Owned: Owned outright,100,31,19,5,14,9,3,69,68,0,0,0,1
S01008244,Owned: Owned with a mortgage or loan or shared ownership,79,72,52,4,48,20,0,7,6,0,0,1,0
S01008244,Rented or living rent free: Total,76,46,34,6,28,9,3,30,21,0,0,7,2
S01008244,Rented or living rent free: Social rented,37,18,15,4,11,2,1,19,12,0,0,6,1
S01008244,Rented or living rent free: Private rented or living rent free,39,28,19,2,17,7,2,11,9,0,0,1,1
S01008245,All HRPs aged 16 and over,410,281,218,32,186,57,6,129,118,0,2,8,1
S01008245,Owned: Total,319,232,183,27,156,47,2,87,84,0,0,2,1
S01008245,Owned: Owned outright,144,69,53,17,36,14,2,75,73,0,0,2,0
S01008245,Owned: Owned with a mortgage or loan or shared ownership,175,163,130,10,120,33,0,12,11,0,0,0,1
S01008245,Rented or living rent free: Total,91,49,35,5,30,10,4,42,34,0,2,6,0
S01008245,Rented or living rent free: Social rented,64,28,21,5,16,3,4,36,28,0,2,6,0
S01008245,Rented or living rent free: Private rented or living rent free,27,21,14,0,14,7,0,6,6,0,0,0,0
S01008246,All HRPs aged 16 and over,353,277,208,22,186,64,5,76,65,1,2,4,4
S01008246,Owned: Total,273,219,166,18,148,50,3,54,50,0,0,1,3
S01008246,Owned: Owned outright,124,76,57,11,46,18,1,48,46,0,0,0,2
S01008246,Owned: Owned with a mortgage or loan or shared ownership,149,143,109,7,102,32,2,6,4,0,0,1,1
S01008246,Rented or living rent free: Total,80,58,42,4,38,14,2,22,15,1,2,3,1
S01008246,Rented or living rent free: Social rented,33,16,14,1,13,1,1,17,10,1,2,3,1
S01008246,Rented or living rent free: Private rented or living rent free,47,42,28,3,25,13,1,5,5,0,0,0,0
S01008247,All HRPs aged 16 and over,319,248,174,22,152,71,3,71,60,1,3,5,2
S01008247,Owned: Total,224,178,122,11,111,55,1,46,44,0,1,0,1
S01008247,Owned: Owned outright,112,69,40,7,33,29,0,43,41,0,1,0,1
S01008247,Owned: Owned with a mortgage or loan or shared ownership,112,109,82,4,78,26,1,3,3,0,0,0,0
S01008247,Rented or living rent free: Total,95,70,52,11,41,16,2,25,16,1,2,5,1
S01008247,Rented or living rent free: Social rented,48,29,21,6,15,7,1,19,12,1,1,4,1
S01008247,Rented or living rent free: Private rented or living rent free,47,41,31,5,26,9,1,6,4,0,1,1,0
S01008248,All HRPs aged 16 and over,397,269,194,34,160,70,5,128,114,2,3,7,2
S01008248,Owned: Total,227,149,100,15,85,49,0,78,76,0,1,0,1
S01008248,Owned: Owned outright,134,67,38,8,30,29,0,67,66,0,0,0,1
S01008248,Owned: Owned with a mortgage or loan or shared ownership,93,82,62,7,55,20,0,11,10,0,1,0,0
S01008248,Rented or living rent free: Total,170,120,94,19,75,21,5,50,38,2,2,7,1
S01008248,Rented or living rent free: Social rented,109,65,51,16,35,10,4,44,32,2,2,7,1
S01008248,Rented or living rent free: Private rented or living rent free,61,55,43,3,40,11,1,6,6,0,0,0,0
S01008249,All HRPs aged 16 and over,401,277,194,29,165,79,4,124,107,0,6,8,3
S01008249,Owned: Total,277,187,127,18,109,58,2,90,84,0,2,3,1
S01008249,Owned: Owned outright,157,79,50,12,38,29,0,78,74,0,1,2,1
S01008249,Owned: Owned with a mortgage or loan or shared ownership,120,108,77,6,71,29,2,12,10,0,1,1,0
S01008249,Rented or living rent free: Total,124,90,67,11,56,21,2,34,23,0,4,5,2
S01008249,Rented or living rent free: Social rented,40,19,15,4,11,4,0,21,14,0,1,4,2
S01008249,Rented or living rent free: Private rented or living rent free,84,71,52,7,45,17,2,13,9,0,3,1,0
S01008250,All HRPs aged 16 and over,447,321,228,28,200,87,6,126,109,4,3,7,3
S01008250,Owned: Total,308,211,147,19,128,63,1,97,91,1,2,3,0
S01008250,Owned: Owned outright,180,93,54,14,40,39,0,87,83,1,0,3,0
S01008250,Owned: Owned with a mortgage or loan or shared ownership,128,118,93,5,88,24,1,10,8,0,2,0,0
S01008250,Rented or living rent free: Total,139,110,81,9,72,24,5,29,18,3,1,4,3
S01008250,Rented or living rent free: Social rented,16,9,9,4,5,0,0,7,2,1,0,3,1
S01008250,Rented or living rent free: Private rented or living rent free,123,101,72,5,67,24,5,22,16,2,1,1,2
S01008251,All HRPs aged 16 and over,255,208,163,19,144,45,0,47,45,0,0,2,0
S01008251,Owned: Total,236,193,152,15,137,41,0,43,42,0,0,1,0
S01008251,Owned: Owned outright,91,49,35,8,27,14,0,42,41,0,0,1,0
S01008251,Owned: Owned with a mortgage or loan or shared ownership,145,144,117,7,110,27,0,1,1,0,0,0,0
S01008251,Rented or living rent free: Total,19,15,11,4,7,4,0,4,3,0,0,1,0
S01008251,Rented or living rent free: Social rented,6,4,4,2,2,0,0,2,1,0,0,1,0
S01008251,Rented or living rent free: Private rented or living rent free,13,11,7,2,5,4,0,2,2,0,0,0,0
S01008252,All HRPs aged 16 and over,338,217,167,18,149,42,8,121,116,2,0,2,1
S01008252,Owned: Total,292,186,148,14,134,35,3,106,106,0,0,0,0
S01008252,Owned: Owned outright,168,72,56,11,45,15,1,96,96,0,0,0,0
S01008252,Owned: Owned with a mortgage or loan or shared ownership,124,114,92,3,89,20,2,10,10,0,0,0,0
S01008252,Rented or living rent free: Total,46,31,19,4,15,7,5,15,10,2,0,2,1
S01008252,Rented or living rent free: Social rented,17,10,8,2,6,0,2,7,3,2,0,1,1
S01008252,Rented or living rent free: Private rented or living rent free,29,21,11,2,9,7,3,8,7,0,0,1,0
S01008253,All HRPs aged 16 and over,370,209,175,32,143,22,12,161,135,2,2,22,0
S01008253,Owned: Total,212,125,106,14,92,18,1,87,85,1,0,1,0
S01008253,Owned: Owned outright,101,30,27,7,20,3,0,71,70,0,0,1,0
S01008253,Owned: Owned with a mortgage or loan or shared ownership,111,95,79,7,72,15,1,16,15,1,0,0,0
S01008253,Rented or living rent free: Total,158,84,69,18,51,4,11,74,50,1,2,21,0
S01008253,Rented or living rent free: Social rented,133,71,59,17,42,3,9,62,40,1,2,19,0
S01008253,Rented or living rent free: Private rented or living rent free,25,13,10,1,9,1,2,12,10,0,0,2,0
S01008254,All HRPs aged 16 and over,428,251,212,32,180,28,11,177,144,0,3,25,5
S01008254,Owned: Total,257,166,147,16,131,19,0,91,86,0,0,3,2
S01008254,Owned: Owned outright,126,47,43,8,35,4,0,79,75,0,0,2,2
S01008254,Owned: Owned with a mortgage or loan or shared ownership,131,119,104,8,96,15,0,12,11,0,0,1,0
S01008254,Rented or living rent free: Total,171,85,65,16,49,9,11,86,58,0,3,22,3
S01008254,Rented or living rent free: Social rented,130,57,41,11,30,5,11,73,49,0,2,19,3
S01008254,Rented or living rent free: Private rented or living rent free,41,28,24,5,19,4,0,13,9,0,1,3,0
S01008255,All HRPs aged 16 and over,292,204,162,31,131,38,4,88,74,2,1,7,4
S01008255,Owned: Total,217,150,116,13,103,32,2,67,61,2,0,3,1
S01008255,Owned: Owned outright,85,28,23,9,14,5,0,57,52,1,0,3,1
S01008255,Owned: Owned with a mortgage or loan or shared ownership,132,122,93,4,89,27,2,10,9,1,0,0,0
S01008255,Rented or living rent free: Total,75,54,46,18,28,6,2,21,13,0,1,4,3
S01008255,Rented or living rent free: Social rented,58,41,36,16,20,3,2,17,11,0,1,3,2
S01008255,Rented or living rent free: Private rented or living rent free,17,13,10,2,8,3,0,4,2,0,0,1,1
S01008256,All HRPs aged 16 and over,361,236,189,40,149,41,6,125,80,6,8,20,11
S01008256,Owned: Total,169,121,96,19,77,24,1,48,46,1,0,1,0
S01008256,Owned: Owned outright,73,32,26,9,17,5,1,41,41,0,0,0,0
S01008256,Owned: Owned with a mortgage or loan or shared ownership,96,89,70,10,60,19,0,7,5,1,0,1,0
S01008256,Rented or living rent free: Total,192,115,93,21,72,17,5,77,34,5,8,19,11
S01008256,Rented or living rent free: Social rented,147,84,67,19,48,12,5,63,26,4,8,16,9
S01008256,Rented or living rent free: Private rented or living rent free,45,31,26,2,24,5,0,14,8,1,0,3,2
S01008257,All HRPs aged 16 and over,357,164,121,23,98,36,7,193,179,2,2,7,3
S01008257,Owned: Total,197,96,69,7,62,26,1,101,100,0,0,0,1
S01008257,Owned: Owned outright,119,29,17,5,12,11,1,90,89,0,0,0,1
S01008257,Owned: Owned with a mortgage or loan or shared ownership,78,67,52,2,50,15,0,11,11,0,0,0,0
S01008257,Rented or living rent free: Total,160,68,52,16,36,10,6,92,79,2,2,7,2
S01008257,Rented or living rent free: Social rented,110,32,27,9,18,2,3,78,66,2,2,7,1
S01008257,Rented or living rent free: Private rented or living rent free,50,36,25,7,18,8,3,14,13,0,0,0,1
S01008258,All HRPs aged 16 and over,401,289,244,21,223,35,10,112,95,1,1,13,2
S01008258,Owned: Total,318,232,197,16,181,31,4,86,84,0,0,2,0
S01008258,Owned: Owned outright,129,65,56,13,43,8,1,64,64,0,0,0,0
S01008258,Owned: Owned with a mortgage or loan or shared ownership,189,167,141,3,138,23,3,22,20,0,0,2,0
S01008258,Rented or living rent free: Total,83,57,47,5,42,4,6,26,11,1,1,11,2
S01008258,Rented or living rent free: Social rented,10,3,2,1,1,1,0,7,3,1,0,3,0
S01008258,Rented or living rent free: Private rented or living rent free,73,54,45,4,41,3,6,19,8,0,1,8,2
S01008259,All HRPs aged 16 and over,376,238,183,26,157,46,9,138,122,4,4,5,3
S01008259,Owned: Total,219,151,117,8,109,33,1,68,65,1,1,1,0
S01008259,Owned: Owned outright,102,44,28,5,23,15,1,58,56,0,1,1,0
S01008259,Owned: Owned with a mortgage or loan or shared ownership,117,107,89,3,86,18,0,10,9,1,0,0,0
S01008259,Rented or living rent free: Total,157,87,66,18,48,13,8,70,57,3,3,4,3
S01008259,Rented or living rent free: Social rented,70,25,21,8,13,2,2,45,42,1,1,1,0
S01008259,Rented or living rent free: Private rented or living rent free,87,62,45,10,35,11,6,25,15,2,2,3,3
S01008260,All HRPs aged 16 and over,355,239,199,39,160,27,13,116,77,2,9,21,7
S01008260,Owned: Total,167,123,99,11,88,21,3,44,40,0,2,1,1
S01008260,Owned: Owned outright,68,33,23,7,16,9,1,35,32,0,2,1,0
S01008260,Owned: Owned with a mortgage or loan or shared ownership,99,90,76,4,72,12,2,9,8,0,0,0,1
S01008260,Rented or living rent free: Total,188,116,100,28,72,6,10,72,37,2,7,20,6
S01008260,Rented or living rent free: Social rented,144,80,67,20,47,3,10,64,32,2,7,18,5
S01008260,Rented or living rent free: Private rented or living rent free,44,36,33,8,25,3,0,8,5,0,0,2,1
S01008261,All HRPs aged 16 and over,368,263,213,40,173,36,14,105,76,0,7,20,2
S01008261,Owned: Total,195,146,127,12,115,16,3,49,42,0,0,6,1
S01008261,Owned: Owned outright,74,35,30,3,27,4,1,39,36,0,0,2,1
S01008261,Owned: Owned with a mortgage or loan or shared ownership,121,111,97,9,88,12,2,10,6,0,0,4,0
S01008261,Rented or living rent free: Total,173,117,86,28,58,20,11,56,34,0,7,14,1
S01008261,Rented or living rent free: Social rented,152,103,78,26,52,16,9,49,31,0,4,13,1
S01008261,Rented or living rent free: Private rented or living rent free,21,14,8,2,6,4,2,7,3,0,3,1,0
S01008262,All HRPs aged 16 and over,252,191,132,18,114,57,2,61,52,0,3,6,0
S01008262,Owned: Total,157,119,73,8,65,46,0,38,35,0,1,2,0
S01008262,Owned: Owned outright,84,52,30,6,24,22,0,32,32,0,0,0,0
S01008262,Owned: Owned with a mortgage or loan or shared ownership,73,67,43,2,41,24,0,6,3,0,1,2,0
S01008262,Rented or living rent free: Total,95,72,59,10,49,11,2,23,17,0,2,4,0
S01008262,Rented or living rent free: Social rented,43,28,24,6,18,2,2,15,11,0,1,3,0
S01008262,Rented or living rent free: Private rented or living rent free,52,44,35,4,31,9,0,8,6,0,1,1,0
S01008263,All HRPs aged 16 and over,284,182,136,19,117,45,1,102,88,0,3,9,2
S01008263,Owned: Total,189,124,91,13,78,33,0,65,61,0,1,1,2
S01008263,Owned: Owned outright,96,37,24,8,16,13,0,59,56,0,0,1,2
S01008263,Owned: Owned with a mortgage or loan or shared ownership,93,87,67,5,62,20,0,6,5,0,1,0,0
S01008263,Rented or living rent free: Total,95,58,45,6,39,12,1,37,27,0,2,8,0
S01008263,Rented or living rent free: Social rented,36,9,5,2,3,3,1,27,19,0,1,7,0
S01008263,Rented or living rent free: Private rented or living rent free,59,49,40,4,36,9,0,10,8,0,1,1,0
S01008264,All HRPs aged 16 and over,330,213,178,32,146,29,6,117,103,0,6,6,2
S01008264,Owned: Total,185,128,102,11,91,26,0,57,54,0,2,0,1
S01008264,Owned: Owned outright,80,34,27,6,21,7,0,46,45,0,1,0,0
S01008264,Owned: Owned with a mortgage or loan or shared ownership,105,94,75,5,70,19,0,11,9,0,1,0,1
S01008264,Rented or living rent free: Total,145,85,76,21,55,3,6,60,49,0,4,6,1
S01008264,Rented or living rent free: Social rented,125,69,62,19,43,2,5,56,45,0,4,6,1
S01008264,Rented or living rent free: Private rented or living rent free,20,16,14,2,12,1,1,4,4,0,0,0,0
S01008265,All HRPs aged 16 and over,332,176,128,15,113,45,3,156,148,0,3,2,3
S01008265,Owned: Total,295,147,106,13,93,39,2,148,141,0,2,2,3
S01008265,Owned: Owned outright,192,52,32,9,23,19,1,140,133,0,2,2,3
S01008265,Owned: Owned with a mortgage or loan or shared ownership,103,95,74,4,70,20,1,8,8,0,0,0,0
S01008265,Rented or living rent free: Total,37,29,22,2,20,6,1,8,7,0,1,0,0
S01008265,Rented or living rent free: Social rented,7,3,3,1,2,0,0,4,4,0,0,0,0
S01008265,Rented or living rent free: Private rented or living rent free,30,26,19,1,18,6,1,4,3,0,1,0,0
S01008266,All HRPs aged 16 and over,319,161,113,15,98,47,1,158,152,0,1,3,2
S01008266,Owned: Total,278,134,90,11,79,43,1,144,141,0,1,1,1
S01008266,Owned: Owned outright,191,57,32,7,25,24,1,134,132,0,0,1,1
S01008266,Owned: Owned with a mortgage or loan or shared ownership,87,77,58,4,54,19,0,10,9,0,1,0,0
S01008266,Rented or living rent free: Total,41,27,23,4,19,4,0,14,11,0,0,2,1
S01008266,Rented or living rent free: Social rented,19,11,10,3,7,1,0,8,7,0,0,1,0
S01008266,Rented or living rent free: Private rented or living rent free,22,16,13,1,12,3,0,6,4,0,0,1,1
S01008267,All HRPs aged 16 and over,350,237,159,25,134,72,6,113,97,1,2,7,6
S01008267,Owned: Total,215,148,95,12,83,52,1,67,63,0,0,1,3
S01008267,Owned: Owned outright,110,58,36,9,27,22,0,52,50,0,0,1,1
S01008267,Owned: Owned with a mortgage or loan or shared ownership,105,90,59,3,56,30,1,15,13,0,0,0,2
S01008267,Rented or living rent free: Total,135,89,64,13,51,20,5,46,34,1,2,6,3
S01008267,Rented or living rent free: Social rented,69,36,28,7,21,5,3,33,25,1,1,6,0
S01008267,Rented or living rent free: Private rented or living rent free,66,53,36,6,30,15,2,13,9,0,1,0,3
S01008268,All HRPs aged 16 and over,355,208,135,15,120,71,2,147,140,0,2,1,4
S01008268,Owned: Total,315,174,110,13,97,64,0,141,137,0,1,0,3
S01008268,Owned: Owned outright,195,67,44,7,37,23,0,128,125,0,1,0,2
S01008268,Owned: Owned with a mortgage or loan or shared ownership,120,107,66,6,60,41,0,13,12,0,0,0,1
S01008268,Rented or living rent free: Total,40,34,25,2,23,7,2,6,3,0,1,1,1
S01008268,Rented or living rent free: Social rented,5,2,1,0,1,0,1,3,1,0,1,1,0
S01008268,Rented or living rent free: Private rented or living rent free,35,32,24,2,22,7,1,3,2,0,0,0,1
S01008269,All HRPs aged 16 and over,400,167,130,24,106,36,1,233,227,0,1,2,3
S01008269,Owned: Total,332,155,122,22,100,33,0,177,174,0,1,0,2
S01008269,Owned: Owned outright,216,58,41,14,27,17,0,158,155,0,1,0,2
S01008269,Owned: Owned with a mortgage or loan or shared ownership,116,97,81,8,73,16,0,19,19,0,0,0,0
S01008269,Rented or living rent free: Total,68,12,8,2,6,3,1,56,53,0,0,2,1
S01008269,Rented or living rent free: Social rented,48,4,3,0,3,1,0,44,42,0,0,2,0
S01008269,Rented or living rent free: Private rented or living rent free,20,8,5,2,3,2,1,12,11,0,0,0,1
S01008270,All HRPs aged 16 and over,394,188,128,25,103,52,8,206,193,3,4,4,2
S01008270,Owned: Total,327,144,96,17,79,45,3,183,179,1,2,0,1
S01008270,Owned: Owned outright,222,54,35,12,23,18,1,168,164,1,2,0,1
S01008270,Owned: Owned with a mortgage or loan or shared ownership,105,90,61,5,56,27,2,15,15,0,0,0,0
S01008270,Rented or living rent free: Total,67,44,32,8,24,7,5,23,14,2,2,4,1
S01008270,Rented or living rent free: Social rented,19,13,7,0,7,2,4,6,1,2,0,3,0
S01008270,Rented or living rent free: Private rented or living rent free,48,31,25,8,17,5,1,17,13,0,2,1,1
S01008271,All HRPs aged 16 and over,386,232,161,22,139,50,21,154,116,6,4,22,6
S01008271,Owned: Total,203,117,85,10,75,30,2,86,81,0,1,2,2
S01008271,Owned: Owned outright,111,35,24,6,18,10,1,76,73,0,0,2,1
S01008271,Owned: Owned with a mortgage or loan or shared ownership,92,82,61,4,57,20,1,10,8,0,1,0,1
S01008271,Rented or living rent free: Total,183,115,76,12,64,20,19,68,35,6,3,20,4
S01008271,Rented or living rent free: Social rented,68,29,14,5,9,2,13,39,21,0,1,13,4
S01008271,Rented or living rent free: Private rented or living rent free,115,86,62,7,55,18,6,29,14,6,2,7,0
S01008272,All HRPs aged 16 and over,414,268,211,40,171,53,4,146,123,1,5,16,1
S01008272,Owned: Total,305,206,160,22,138,43,3,99,91,1,4,3,0
S01008272,Owned: Owned outright,162,76,48,10,38,27,1,86,81,1,2,2,0
S01008272,Owned: Owned with a mortgage or loan or shared ownership,143,130,112,12,100,16,2,13,10,0,2,1,0
S01008272,Rented or living rent free: Total,109,62,51,18,33,10,1,47,32,0,1,13,1
S01008272,Rented or living rent free: Social rented,51,13,12,8,4,1,0,38,25,0,1,11,1
S01008272,Rented or living rent free: Private rented or living rent free,58,49,39,10,29,9,1,9,7,0,0,2,0
S01008273,All HRPs aged 16 and over,346,214,168,31,137,41,5,132,120,0,2,7,3
S01008273,Owned: Total,291,181,143,23,120,34,4,110,106,0,1,0,3
S01008273,Owned: Owned outright,171,70,54,15,39,13,3,101,99,0,0,0,2
S01008273,Owned: Owned with a mortgage or loan or shared ownership,120,111,89,8,81,21,1,9,7,0,1,0,1
S01008273,Rented or living rent free: Total,55,33,25,8,17,7,1,22,14,0,1,7,0
S01008273,Rented or living rent free: Social rented,27,13,12,5,7,0,1,14,9,0,0,5,0
S01008273,Rented or living rent free: Private rented or living rent free,28,20,13,3,10,7,0,8,5,0,1,2,0
S01008274,All HRPs aged 16 and over,322,182,142,34,108,24,16,140,116,0,5,14,5
S01008274,Owned: Total,193,107,87,21,66,18,2,86,82,0,2,1,1
S01008274,Owned: Owned outright,111,41,30,12,18,11,0,70,69,0,1,0,0
S01008274,Owned: Owned with a mortgage or loan or shared ownership,82,66,57,9,48,7,2,16,13,0,1,1,1
S01008274,Rented or living rent free: Total,129,75,55,13,42,6,14,54,34,0,3,13,4
S01008274,Rented or living rent free: Social rented,107,59,42,12,30,4,13,48,32,0,2,12,2
S01008274,Rented or living rent free: Private rented or living rent free,22,16,13,1,12,2,1,6,2,0,1,1,2
S01008275,All HRPs aged 16 and over,258,155,108,19,89,42,5,103,94,0,3,5,1
S01008275,Owned: Total,188,115,78,12,66,35,2,73,72,0,0,0,1
S01008275,Owned: Owned outright,109,44,26,8,18,17,1,65,65,0,0,0,0
S01008275,Owned: Owned with a mortgage or loan or shared ownership,79,71,52,4,48,18,1,8,7,0,0,0,1
S01008275,Rented or living rent free: Total,70,40,30,7,23,7,3,30,22,0,3,5,0
S01008275,Rented or living rent free: Social rented,51,22,18,6,12,3,1,29,21,0,3,5,0
S01008275,Rented or living rent free: Private rented or living rent free,19,18,12,1,11,4,2,1,1,0,0,0,0
S01008276,All HRPs aged 16 and over,199,151,116,20,96,34,1,48,41,0,2,3,2
S01008276,Owned: Total,169,127,98,15,83,28,1,42,38,0,2,0,2
S01008276,Owned: Owned outright,73,38,29,9,20,9,0,35,34,0,0,0,1
S01008276,Owned: Owned with a mortgage or loan or shared ownership,96,89,69,6,63,19,1,7,4,0,2,0,1
S01008276,Rented or living rent free: Total,30,24,18,5,13,6,0,6,3,0,0,3,0
S01008276,Rented or living rent free: Social rented,17,11,9,2,7,2,0,6,3,0,0,3,0
S01008276,Rented or living rent free: Private rented or living rent free,13,13,9,3,6,4,0,0,0,0,0,0,0
S01008277,All HRPs aged 16 and over,213,162,91,12,79,63,8,51,47,0,1,1,2
S01008277,Owned: Total,138,103,58,8,50,43,2,35,33,0,1,0,1
S01008277,Owned: Owned outright,77,46,20,7,13,25,1,31,29,0,1,0,1
S01008277,Owned: Owned with a mortgage or loan or shared ownership,61,57,38,1,37,18,1,4,4,0,0,0,0
S01008277,Rented or living rent free: Total,75,59,33,4,29,20,6,16,14,0,0,1,1
S01008277,Rented or living rent free: Social rented,7,4,3,0,3,0,1,3,1,0,0,1,1
S01008277,Rented or living rent free: Private rented or living rent free,68,55,30,4,26,20,5,13,13,0,0,0,0
S01008278,All HRPs aged 16 and over,334,223,160,21,139,58,5,111,107,0,2,2,0
S01008278,Owned: Total,265,168,120,13,107,46,2,97,96,0,0,1,0
S01008278,Owned: Owned outright,149,59,39,11,28,18,2,90,89,0,0,1,0
S01008278,Owned: Owned with a mortgage or loan or shared ownership,116,109,81,2,79,28,0,7,7,0,0,0,0
S01008278,Rented or living rent free: Total,69,55,40,8,32,12,3,14,11,0,2,1,0
S01008278,Rented or living rent free: Social rented,6,4,2,1,1,2,0,2,0,0,2,0,0
S01008278,Rented or living rent free: Private rented or living rent free,63,51,38,7,31,10,3,12,11,0,0,1,0
S01008279,All HRPs aged 16 and over,331,200,154,17,137,34,12,131,119,0,2,7,3
S01008279,Owned: Total,228,135,110,11,99,25,0,93,90,0,1,2,0
S01008279,Owned: Owned outright,119,40,27,6,21,13,0,79,78,0,0,1,0
S01008279,Owned: Owned with a mortgage or loan or shared ownership,109,95,83,5,78,12,0,14,12,0,1,1,0
S01008279,Rented or living rent free: Total,103,65,44,6,38,9,12,38,29,0,1,5,3
S01008279,Rented or living rent free: Social rented,88,54,36,6,30,7,11,34,27,0,0,5,2
S01008279,Rented or living rent free: Private rented or living rent free,15,11,8,0,8,2,1,4,2,0,1,0,1
S01008280,All HRPs aged 16 and over,425,292,189,26,163,91,12,133,118,1,1,12,1
S01008280,Owned: Total,260,196,123,13,110,72,1,64,64,0,0,0,0
S01008280,Owned: Owned outright,125,68,30,5,25,37,1,57,57,0,0,0,0
S01008280,Owned: Owned with a mortgage or loan or shared ownership,135,128,93,8,85,35,0,7,7,0,0,0,0
S01008280,Rented or living rent free: Total,165,96,66,13,53,19,11,69,54,1,1,12,1
S01008280,Rented or living rent free: Social rented,85,29,23,8,15,2,4,56,44,0,0,11,1
S01008280,Rented or living rent free: Private rented or living rent free,80,67,43,5,38,17,7,13,10,1,1,1,0
S01008281,All HRPs aged 16 and over,316,241,171,19,152,64,6,75,59,1,2,9,4
S01008281,Owned: Total,180,141,97,8,89,44,0,39,34,1,2,0,2
S01008281,Owned: Owned outright,91,58,33,6,27,25,0,33,29,1,1,0,2
S01008281,Owned: Owned with a mortgage or loan or shared ownership,89,83,64,2,62,19,0,6,5,0,1,0,0
S01008281,Rented or living rent free: Total,136,100,74,11,63,20,6,36,25,0,0,9,2
S01008281,Rented or living rent free: Social rented,35,19,16,4,12,2,1,16,10,0,0,4,2
S01008281,Rented or living rent free: Private rented or living rent free,101,81,58,7,51,18,5,20,15,0,0,5,0
S01008282,All HRPs aged 16 and over,299,218,139,22,117,74,5,81,72,0,3,5,1
S01008282,Owned: Total,224,175,109,16,93,64,2,49,47,0,1,1,0
S01008282,Owned: Owned outright,115,73,36,10,26,36,1,42,41,0,0,1,0
S01008282,Owned: Owned with a mortgage or loan or shared ownership,109,102,73,6,67,28,1,7,6,0,1,0,0
S01008282,Rented or living rent free: Total,75,43,30,6,24,10,3,32,25,0,2,4,1
S01008282,Rented or living rent free: Social rented,35,15,14,5,9,1,0,20,15,0,1,4,0
S01008282,Rented or living rent free: Private rented or living rent free,40,28,16,1,15,9,3,12,10,0,1,0,1
S01008283,All HRPs aged 16 and over,184,152,108,10,98,36,8,32,27,1,0,1,3
S01008283,Owned: Total,151,124,88,4,84,32,4,27,22,1,0,1,3
S01008283,Owned: Owned outright,60,36,22,2,20,13,1,24,21,1,0,0,2
S01008283,Owned: Owned with a mortgage or loan or shared ownership,91,88,66,2,64,19,3,3,1,0,0,1,1
S01008283,Rented or living rent free: Total,33,28,20,6,14,4,4,5,5,0,0,0,0
S01008283,Rented or living rent free: Social rented,11,10,10,5,5,0,0,1,1,0,0,0,0
S01008283,Rented or living rent free: Private rented or living rent free,22,18,10,1,9,4,4,4,4,0,0,0,0
S01008284,All HRPs aged 16 and over,348,246,194,27,167,44,8,102,89,0,5,7,1
S01008284,Owned: Total,239,190,154,21,133,35,1,49,48,0,0,1,0
S01008284,Owned: Owned outright,84,43,32,15,17,10,1,41,40,0,0,1,0
S01008284,Owned: Owned with a mortgage or loan or shared ownership,155,147,122,6,116,25,0,8,8,0,0,0,0
S01008284,Rented or living rent free: Total,109,56,40,6,34,9,7,53,41,0,5,6,1
S01008284,Rented or living rent free: Social rented,75,36,28,6,22,3,5,39,30,0,3,5,1
S01008284,Rented or living rent free: Private rented or living rent free,34,20,12,0,12,6,2,14,11,0,2,1,0
S01008285,All HRPs aged 16 and over,355,201,159,38,121,31,11,154,118,1,6,23,6
S01008285,Owned: Total,159,96,75,10,65,21,0,63,59,1,0,3,0
S01008285,Owned: Owned outright,80,25,19,4,15,6,0,55,52,1,0,2,0
S01008285,Owned: Owned with a mortgage or loan or shared ownership,79,71,56,6,50,15,0,8,7,0,0,1,0
S01008285,Rented or living rent free: Total,196,105,84,28,56,10,11,91,59,0,6,20,6
S01008285,Rented or living rent free: Social rented,164,84,65,23,42,8,11,80,51,0,5,19,5
S01008285,Rented or living rent free: Private rented or living rent free,32,21,19,5,14,2,0,11,8,0,1,1,1
S01008286,All HRPs aged 16 and over,303,188,153,26,127,30,5,115,94,2,5,13,1
S01008286,Owned: Total,169,119,96,12,84,23,0,50,44,0,1,5,0
S01008286,Owned: Owned outright,69,22,18,5,13,4,0,47,44,0,0,3,0
S01008286,Owned: Owned with a mortgage or loan or shared ownership,100,97,78,7,71,19,0,3,0,0,1,2,0
S01008286,Rented or living rent free: Total,134,69,57,14,43,7,5,65,50,2,4,8,1
S01008286,Rented or living rent free: Social rented,115,58,49,14,35,5,4,57,46,1,4,6,0
S01008286,Rented or living rent free: Private rented or living rent free,19,11,8,0,8,2,1,8,4,1,0,2,1
S01008287,All HRPs aged 16 and over,311,209,172,29,143,25,12,102,82,3,3,13,1
S01008287,Owned: Total,189,132,110,13,97,22,0,57,51,2,0,4,0
S01008287,Owned: Owned outright,82,31,24,7,17,7,0,51,48,0,0,3,0
S01008287,Owned: Owned with a mortgage or loan or shared ownership,107,101,86,6,80,15,0,6,3,2,0,1,0
S01008287,Rented or living rent free: Total,122,77,62,16,46,3,12,45,31,1,3,9,1
S01008287,Rented or living rent free: Social rented,98,55,41,14,27,3,11,43,30,0,3,9,1
S01008287,Rented or living rent free: Private rented or living rent free,24,22,21,2,19,0,1,2,1,1,0,0,0
S01008288,All HRPs aged 16 and over,413,234,178,27,151,47,9,179,160,0,1,15,3
S01008288,Owned: Total,274,167,129,13,116,36,2,107,103,0,0,2,2
S01008288,Owned: Owned outright,150,50,32,8,24,18,0,100,97,0,0,1,2
S01008288,Owned: Owned with a mortgage or loan or shared ownership,124,117,97,5,92,18,2,7,6,0,0,1,0
S01008288,Rented or living rent free: Total,139,67,49,14,35,11,7,72,57,0,1,13,1
S01008288,Rented or living rent free: Social rented,90,33,24,9,15,4,5,57,47,0,1,8,1
S01008288,Rented or living rent free: Private rented or living rent free,49,34,25,5,20,7,2,15,10,0,0,5,0
S01008289,All HRPs aged 16 and over,319,223,172,31,141,40,11,96,68,1,8,14,5
S01008289,Owned: Total,169,121,88,10,78,31,2,48,44,0,3,1,0
S01008289,Owned: Owned outright,80,38,20,3,17,17,1,42,40,0,1,1,0
S01008289,Owned: Owned with a mortgage or loan or shared ownership,89,83,68,7,61,14,1,6,4,0,2,0,0
S01008289,Rented or living rent free: Total,150,102,84,21,63,9,9,48,24,1,5,13,5
S01008289,Rented or living rent free: Social rented,88,49,42,15,27,3,4,39,18,1,5,12,3
S01008289,Rented or living rent free: Private rented or living rent free,62,53,42,6,36,6,5,9,6,0,0,1,2
S01008290,All HRPs aged 16 and over,397,266,194,27,167,52,20,131,89,3,9,23,7
S01008290,Owned: Total,249,181,136,11,125,42,3,68,61,1,1,3,2
S01008290,Owned: Owned outright,115,50,34,6,28,14,2,65,58,1,1,3,2
S01008290,Owned: Owned with a mortgage or loan or shared ownership,134,131,102,5,97,28,1,3,3,0,0,0,0
S01008290,Rented or living rent free: Total,148,85,58,16,42,10,17,63,28,2,8,20,5
S01008290,Rented or living rent free: Social rented,79,31,20,8,12,3,8,48,20,0,6,18,4
S01008290,Rented or living rent free: Private rented or living rent free,69,54,38,8,30,7,9,15,8,2,2,2,1
S01008291,All HRPs aged 16 and over,369,187,160,20,140,20,7,182,175,1,0,3,3
S01008291,Owned: Total,315,151,132,12,120,16,3,164,160,1,0,1,2
S01008291,Owned: Owned outright,210,57,46,6,40,8,3,153,151,0,0,0,2
S01008291,Owned: Owned with a mortgage or loan or shared ownership,105,94,86,6,80,8,0,11,9,1,0,1,0
S01008291,Rented or living rent free: Total,54,36,28,8,20,4,4,18,15,0,0,2,1
S01008291,Rented or living rent free: Social rented,14,8,6,2,4,2,0,6,3,0,0,2,1
S01008291,Rented or living rent free: Private rented or living rent free,40,28,22,6,16,2,4,12,12,0,0,0,0
S01008292,All HRPs aged 16 and over,310,237,199,48,151,24,14,73,45,1,5,14,8
S01008292,Owned: Total,165,137,116,17,99,20,1,28,25,1,0,1,1
S01008292,Owned: Owned outright,54,32,26,6,20,6,0,22,21,0,0,1,0
S01008292,Owned: Owned with a mortgage or loan or shared ownership,111,105,90,11,79,14,1,6,4,1,0,0,1
S01008292,Rented or living rent free: Total,145,100,83,31,52,4,13,45,20,0,5,13,7
S01008292,Rented or living rent free: Social rented,131,90,75,31,44,4,11,41,18,0,5,13,5
S01008292,Rented or living rent free: Private rented or living rent free,14,10,8,0,8,0,2,4,2,0,0,0,2
S01008293,All HRPs aged 16 and over,199,160,131,6,125,27,2,39,35,0,3,0,1
S01008293,Owned: Total,186,151,123,6,117,26,2,35,33,0,2,0,0
S01008293,Owned: Owned outright,55,24,17,2,15,6,1,31,30,0,1,0,0
S01008293,Owned: Owned with a mortgage or loan or shared ownership,131,127,106,4,102,20,1,4,3,0,1,0,0
S01008293,Rented or living rent free: Total,13,9,8,0,8,1,0,4,2,0,1,0,1
S01008293,Rented or living rent free: Social rented,3,1,1,0,1,0,0,2,0,0,1,0,1
S01008293,Rented or living rent free: Private rented or living rent free,10,8,7,0,7,1,0,2,2,0,0,0,0
S01008294,All HRPs aged 16 and over,326,250,202,16,186,42,6,76,63,0,4,8,1
S01008294,Owned: Total,262,219,179,12,167,38,2,43,40,0,0,2,1
S01008294,Owned: Owned outright,78,37,28,5,23,8,1,41,38,0,0,2,1
S01008294,Owned: Owned with a mortgage or loan or shared ownership,184,182,151,7,144,30,1,2,2,0,0,0,0
S01008294,Rented or living rent free: Total,64,31,23,4,19,4,4,33,23,0,4,6,0
S01008294,Rented or living rent free: Social rented,40,13,9,2,7,1,3,27,18,0,3,6,0
S01008294,Rented or living rent free: Private rented or living rent free,24,18,14,2,12,3,1,6,5,0,1,0,0
S01008295,All HRPs aged 16 and over,380,291,263,34,229,21,7,89,73,2,5,6,3
S01008295,Owned: Total,335,267,244,30,214,19,4,68,61,0,4,1,2
S01008295,Owned: Owned outright,130,70,66,11,55,2,2,60,54,0,4,0,2
S01008295,Owned: Owned with a mortgage or loan or shared ownership,205,197,178,19,159,17,2,8,7,0,0,1,0
S01008295,Rented or living rent free: Total,45,24,19,4,15,2,3,21,12,2,1,5,1
S01008295,Rented or living rent free: Social rented,20,9,9,2,7,0,0,11,8,0,0,3,0
S01008295,Rented or living rent free: Private rented or living rent free,25,15,10,2,8,2,3,10,4,2,1,2,1
S01008296,All HRPs aged 16 and over,320,173,133,22,111,24,16,147,108,5,9,18,7
S01008296,Owned: Total,186,125,100,12,88,23,2,61,54,2,0,2,3
S01008296,Owned: Owned outright,78,34,26,4,22,8,0,44,39,2,0,1,2
S01008296,Owned: Owned with a mortgage or loan or shared ownership,108,91,74,8,66,15,2,17,15,0,0,1,1
S01008296,Rented or living rent free: Total,134,48,33,10,23,1,14,86,54,3,9,16,4
S01008296,Rented or living rent free: Social rented,117,41,28,9,19,0,13,76,53,3,5,12,3
S01008296,Rented or living rent free: Private rented or living rent free,17,7,5,1,4,1,1,10,1,0,4,4,1
S01008297,All HRPs aged 16 and over,295,202,167,17,150,28,7,93,61,3,6,19,4
S01008297,Owned: Total,244,182,153,12,141,27,2,62,54,3,0,5,0
S01008297,Owned: Owned outright,88,40,32,6,26,8,0,48,42,3,0,3,0
S01008297,Owned: Owned with a mortgage or loan or shared ownership,156,142,121,6,115,19,2,14,12,0,0,2,0
S01008297,Rented or living rent free: Total,51,20,14,5,9,1,5,31,7,0,6,14,4
S01008297,Rented or living rent free: Social rented,39,17,12,5,7,0,5,22,7,0,5,6,4
S01008297,Rented or living rent free: Private rented or living rent free,12,3,2,0,2,1,0,9,0,0,1,8,0
S01008298,All HRPs aged 16 and over,303,215,177,14,163,34,4,88,72,0,6,10,0
S01008298,Owned: Total,270,200,165,12,153,31,4,70,62,0,4,4,0
S01008298,Owned: Owned outright,111,51,34,5,29,15,2,60,56,0,1,3,0
S01008298,Owned: Owned with a mortgage or loan or shared ownership,159,149,131,7,124,16,2,10,6,0,3,1,0
S01008298,Rented or living rent free: Total,33,15,12,2,10,3,0,18,10,0,2,6,0
S01008298,Rented or living rent free: Social rented,6,0,0,0,0,0,0,6,1,0,2,3,0
S01008298,Rented or living rent free: Private rented or living rent free,27,15,12,2,10,3,0,12,9,0,0,3,0
S01008299,All HRPs aged 16 and over,370,199,138,35,103,32,29,171,97,1,15,51,7
S01008299,Owned: Total,157,102,80,13,67,19,3,55,49,0,2,3,1
S01008299,Owned: Owned outright,79,36,21,7,14,12,3,43,40,0,0,2,1
S01008299,Owned: Owned with a mortgage or loan or shared ownership,78,66,59,6,53,7,0,12,9,0,2,1,0
S01008299,Rented or living rent free: Total,213,97,58,22,36,13,26,116,48,1,13,48,6
S01008299,Rented or living rent free: Social rented,182,80,49,20,29,10,21,102,47,0,12,40,3
S01008299,Rented or living rent free: Private rented or living rent free,31,17,9,2,7,3,5,14,1,1,1,8,3
S01008300,All HRPs aged 16 and over,377,205,163,28,135,30,12,172,110,3,9,44,6
S01008300,Owned: Total,226,142,113,15,98,25,4,84,77,1,0,6,0
S01008300,Owned: Owned outright,109,44,29,9,20,12,3,65,63,0,0,2,0
S01008300,Owned: Owned with a mortgage or loan or shared ownership,117,98,84,6,78,13,1,19,14,1,0,4,0
S01008300,Rented or living rent free: Total,151,63,50,13,37,5,8,88,33,2,9,38,6
S01008300,Rented or living rent free: Social rented,127,51,41,11,30,4,6,76,32,2,6,33,3
S01008300,Rented or living rent free: Private rented or living rent free,24,12,9,2,7,1,2,12,1,0,3,5,3
S01008301,All HRPs aged 16 and over,316,244,210,25,185,32,2,72,60,1,0,11,0
S01008301,Owned: Total,301,235,201,23,178,32,2,66,55,1,0,10,0
S01008301,Owned: Owned outright,115,64,55,13,42,9,0,51,45,0,0,6,0
S01008301,Owned: Owned with a mortgage or loan or shared ownership,186,171,146,10,136,23,2,15,10,1,0,4,0
S01008301,Rented or living rent free: Total,15,9,9,2,7,0,0,6,5,0,0,1,0
S01008301,Rented or living rent free: Social rented,3,2,2,0,2,0,0,1,1,0,0,0,0
S01008301,Rented or living rent free: Private rented or living rent free,12,7,7,2,5,0,0,5,4,0,0,1,0
S01008302,All HRPs aged 16 and over,300,197,150,15,135,43,4,103,89,0,1,11,2
S01008302,Owned: Total,265,178,132,15,117,43,3,87,79,0,1,6,1
S01008302,Owned: Owned outright,150,71,51,10,41,17,3,79,74,0,0,4,1
S01008302,Owned: Owned with a mortgage or loan or shared ownership,115,107,81,5,76,26,0,8,5,0,1,2,0
S01008302,Rented or living rent free: Total,35,19,18,0,18,0,1,16,10,0,0,5,1
S01008302,Rented or living rent free: Social rented,14,3,2,0,2,0,1,11,9,0,0,1,1
S01008302,Rented or living rent free: Private rented or living rent free,21,16,16,0,16,0,0,5,1,0,0,4,0
S01008303,All HRPs aged 16 and over,272,166,133,16,117,21,12,106,82,1,2,16,5
S01008303,Owned: Total,183,131,106,9,97,20,5,52,47,0,0,5,0
S01008303,Owned: Owned outright,68,26,21,3,18,4,1,42,39,0,0,3,0
S01008303,Owned: Owned with a mortgage or loan or shared ownership,115,105,85,6,79,16,4,10,8,0,0,2,0
S01008303,Rented or living rent free: Total,89,35,27,7,20,1,7,54,35,1,2,11,5
S01008303,Rented or living rent free: Social rented,50,14,10,5,5,0,4,36,28,0,2,5,1
S01008303,Rented or living rent free: Private rented or living rent free,39,21,17,2,15,1,3,18,7,1,0,6,4
S01008304,All HRPs aged 16 and over,212,119,98,15,83,16,5,93,77,1,3,12,0
S01008304,Owned: Total,157,100,84,11,73,15,1,57,52,1,1,3,0
S01008304,Owned: Owned outright,85,37,30,6,24,7,0,48,47,0,1,0,0
S01008304,Owned: Owned with a mortgage or loan or shared ownership,72,63,54,5,49,8,1,9,5,1,0,3,0
S01008304,Rented or living rent free: Total,55,19,14,4,10,1,4,36,25,0,2,9,0
S01008304,Rented or living rent free: Social rented,37,6,4,1,3,0,2,31,22,0,2,7,0
S01008304,Rented or living rent free: Private rented or living rent free,18,13,10,3,7,1,2,5,3,0,0,2,0
S01008305,All HRPs aged 16 and over,315,206,185,17,168,18,3,109,100,2,3,3,1
S01008305,Owned: Total,299,191,171,13,158,18,2,108,99,2,3,3,1
S01008305,Owned: Owned outright,160,70,60,11,49,8,2,90,86,2,0,1,1
S01008305,Owned: Owned with a mortgage or loan or shared ownership,139,121,111,2,109,10,0,18,13,0,3,2,0
S01008305,Rented or living rent free: Total,16,15,14,4,10,0,1,1,1,0,0,0,0
S01008305,Rented or living rent free: Social rented,3,3,3,2,1,0,0,0,0,0,0,0,0
S01008305,Rented or living rent free: Private rented or living rent free,13,12,11,2,9,0,1,1,1,0,0,0,0
S01008306,All HRPs aged 16 and over,239,169,141,16,125,25,3,70,64,0,2,3,1
S01008306,Owned: Total,227,164,136,16,120,25,3,63,59,0,1,2,1
S01008306,Owned: Owned outright,96,43,35,10,25,7,1,53,50,0,1,1,1
S01008306,Owned: Owned with a mortgage or loan or shared ownership,131,121,101,6,95,18,2,10,9,0,0,1,0
S01008306,Rented or living rent free: Total,12,5,5,0,5,0,0,7,5,0,1,1,0
S01008306,Rented or living rent free: Social rented,5,2,2,0,2,0,0,3,3,0,0,0,0
S01008306,Rented or living rent free: Private rented or living rent free,7,3,3,0,3,0,0,4,2,0,1,1,0
S01008307,All HRPs aged 16 and over,216,168,145,9,136,20,3,48,42,1,1,4,0
S01008307,Owned: Total,195,155,135,9,126,19,1,40,37,1,1,1,0
S01008307,Owned: Owned outright,64,32,25,3,22,6,1,32,31,0,1,0,0
S01008307,Owned: Owned with a mortgage or loan or shared ownership,131,123,110,6,104,13,0,8,6,1,0,1,0
S01008307,Rented or living rent free: Total,21,13,10,0,10,1,2,8,5,0,0,3,0
S01008307,Rented or living rent free: Social rented,13,7,5,0,5,0,2,6,4,0,0,2,0
S01008307,Rented or living rent free: Private rented or living rent free,8,6,5,0,5,1,0,2,1,0,0,1,0
S01008308,All HRPs aged 16 and over,238,143,120,11,109,21,2,95,87,3,2,0,3
S01008308,Owned: Total,227,133,112,7,105,20,1,94,87,3,1,0,3
S01008308,Owned: Owned outright,130,45,38,3,35,6,1,85,82,2,0,0,1
S01008308,Owned: Owned with a mortgage or loan or shared ownership,97,88,74,4,70,14,0,9,5,1,1,0,2
S01008308,Rented or living rent free: Total,11,10,8,4,4,1,1,1,0,0,1,0,0
S01008308,Rented or living rent free: Social rented,3,3,3,1,2,0,0,0,0,0,0,0,0
S01008308,Rented or living rent free: Private rented or living rent free,8,7,5,3,2,1,1,1,0,0,1,0,0
S01008309,All HRPs aged 16 and over,372,207,167,38,129,16,24,165,103,3,11,45,3
S01008309,Owned: Total,162,104,90,13,77,12,2,58,51,1,1,5,0
S01008309,Owned: Owned outright,70,23,18,4,14,4,1,47,44,0,0,3,0
S01008309,Owned: Owned with a mortgage or loan or shared ownership,92,81,72,9,63,8,1,11,7,1,1,2,0
S01008309,Rented or living rent free: Total,210,103,77,25,52,4,22,107,52,2,10,40,3
S01008309,Rented or living rent free: Social rented,161,79,61,20,41,4,14,82,47,1,5,27,2
S01008309,Rented or living rent free: Private rented or living rent free,49,24,16,5,11,0,8,25,5,1,5,13,1
S01008310,All HRPs aged 16 and over,467,259,214,28,186,26,19,208,166,1,4,35,2
S01008310,Owned: Total,301,200,172,17,155,24,4,101,92,0,0,9,0
S01008310,Owned: Owned outright,132,50,45,8,37,4,1,82,76,0,0,6,0
S01008310,Owned: Owned with a mortgage or loan or shared ownership,169,150,127,9,118,20,3,19,16,0,0,3,0
S01008310,Rented or living rent free: Total,166,59,42,11,31,2,15,107,74,1,4,26,2
S01008310,Rented or living rent free: Social rented,124,32,25,7,18,1,6,92,66,0,2,23,1
S01008310,Rented or living rent free: Private rented or living rent free,42,27,17,4,13,1,9,15,8,1,2,3,1
S01008311,All HRPs aged 16 and over,172,111,91,10,81,7,13,61,38,1,5,13,4
S01008311,Owned: Total,108,81,74,4,70,6,1,27,22,0,3,2,0
S01008311,Owned: Owned outright,28,11,8,2,6,3,0,17,17,0,0,0,0
S01008311,Owned: Owned with a mortgage or loan or shared ownership,80,70,66,2,64,3,1,10,5,0,3,2,0
S01008311,Rented or living rent free: Total,64,30,17,6,11,1,12,34,16,1,2,11,4
S01008311,Rented or living rent free: Social rented,54,23,16,5,11,1,6,31,14,1,1,11,4
S01008311,Rented or living rent free: Private rented or living rent free,10,7,1,1,0,0,6,3,2,0,1,0,0
S01008312,All HRPs aged 16 and over,171,118,97,13,84,14,7,53,41,1,3,7,1
S01008312,Owned: Total,118,88,77,4,73,10,1,30,26,0,2,2,0
S01008312,Owned: Owned outright,33,10,8,1,7,2,0,23,21,0,0,2,0
S01008312,Owned: Owned with a mortgage or loan or shared ownership,85,78,69,3,66,8,1,7,5,0,2,0,0
S01008312,Rented or living rent free: Total,53,30,20,9,11,4,6,23,15,1,1,5,1
S01008312,Rented or living rent free: Social rented,41,21,15,9,6,2,4,20,13,1,0,5,1
S01008312,Rented or living rent free: Private rented or living rent free,12,9,5,0,5,2,2,3,2,0,1,0,0
S01008313,All HRPs aged 16 and over,403,228,183,44,139,24,21,175,118,0,17,34,6
S01008313,Owned: Total,209,129,104,19,85,20,5,80,68,0,5,5,2
S01008313,Owned: Owned outright,90,30,24,7,17,4,2,60,56,0,2,2,0
S01008313,Owned: Owned with a mortgage or loan or shared ownership,119,99,80,12,68,16,3,20,12,0,3,3,2
S01008313,Rented or living rent free: Total,194,99,79,25,54,4,16,95,50,0,12,29,4
S01008313,Rented or living rent free: Social rented,166,78,60,21,39,2,16,88,50,0,8,26,4
S01008313,Rented or living rent free: Private rented or living rent free,28,21,19,4,15,2,0,7,0,0,4,3,0
S01008314,All HRPs aged 16 and over,311,201,164,42,122,18,19,110,35,5,18,43,9
S01008314,Owned: Total,90,70,59,3,56,7,4,20,15,0,2,3,0
S01008314,Owned: Owned outright,27,14,11,1,10,2,1,13,11,0,0,2,0
S01008314,Owned: Owned with a mortgage or loan or shared ownership,63,56,48,2,46,5,3,7,4,0,2,1,0
S01008314,Rented or living rent free: Total,221,131,105,39,66,11,15,90,20,5,16,40,9
S01008314,Rented or living rent free: Social rented,192,113,89,34,55,9,15,79,17,5,14,36,7
S01008314,Rented or living rent free: Private rented or living rent free,29,18,16,5,11,2,0,11,3,0,2,4,2
S01008315,All HRPs aged 16 and over,450,259,204,33,171,21,34,191,86,9,13,67,16
S01008315,Owned: Total,137,101,90,8,82,9,2,36,31,0,0,5,0
S01008315,Owned: Owned outright,51,18,16,3,13,2,0,33,29,0,0,4,0
S01008315,Owned: Owned with a mortgage or loan or shared ownership,86,83,74,5,69,7,2,3,2,0,0,1,0
S01008315,Rented or living rent free: Total,313,158,114,25,89,12,32,155,55,9,13,62,16
S01008315,Rented or living rent free: Social rented,246,120,88,22,66,10,22,126,47,5,12,51,11
S01008315,Rented or living rent free: Private rented or living rent free,67,38,26,3,23,2,10,29,8,4,1,11,5
S01008316,All HRPs aged 16 and over,265,146,107,21,86,11,28,119,25,2,19,62,11
S01008316,Owned: Total,62,51,40,7,33,9,2,11,7,0,0,3,1
S01008316,Owned: Owned outright,13,7,6,3,3,1,0,6,4,0,0,1,1
S01008316,Owned: Owned with a mortgage or loan or shared ownership,49,44,34,4,30,8,2,5,3,0,0,2,0
S01008316,Rented or living rent free: Total,203,95,67,14,53,2,26,108,18,2,19,59,10
S01008316,Rented or living rent free: Social rented,187,88,63,14,49,2,23,99,16,2,17,54,10
S01008316,Rented or living rent free: Private rented or living rent free,16,7,4,0,4,0,3,9,2,0,2,5,0
S01008317,All HRPs aged 16 and over,316,222,176,21,155,31,15,94,34,3,12,35,10
S01008317,Owned: Total,180,152,127,6,121,24,1,28,16,0,3,7,2
S01008317,Owned: Owned outright,44,26,17,2,15,8,1,18,12,0,1,4,1
S01008317,Owned: Owned with a mortgage or loan or shared ownership,136,126,110,4,106,16,0,10,4,0,2,3,1
S01008317,Rented or living rent free: Total,136,70,49,15,34,7,14,66,18,3,9,28,8
S01008317,Rented or living rent free: Social rented,109,53,39,14,25,4,10,56,16,1,7,24,8
S01008317,Rented or living rent free: Private rented or living rent free,27,17,10,1,9,3,4,10,2,2,2,4,0
S01008318,All HRPs aged 16 and over,368,257,213,25,188,41,3,111,95,2,3,9,2
S01008318,Owned: Total,325,234,193,20,173,40,1,91,87,0,1,2,1
S01008318,Owned: Owned outright,129,55,43,12,31,11,1,74,72,0,0,1,1
S01008318,Owned: Owned with a mortgage or loan or shared ownership,196,179,150,8,142,29,0,17,15,0,1,1,0
S01008318,Rented or living rent free: Total,43,23,20,5,15,1,2,20,8,2,2,7,1
S01008318,Rented or living rent free: Social rented,17,9,7,1,6,0,2,8,4,0,2,2,0
S01008318,Rented or living rent free: Private rented or living rent free,26,14,13,4,9,1,0,12,4,2,0,5,1
S01008319,All HRPs aged 16 and over,373,194,162,30,132,20,12,179,133,1,5,36,4
S01008319,Owned: Total,252,145,125,17,108,19,1,107,97,0,2,8,0
S01008319,Owned: Owned outright,123,39,33,9,24,5,1,84,78,0,2,4,0
S01008319,Owned: Owned with a mortgage or loan or shared ownership,129,106,92,8,84,14,0,23,19,0,0,4,0
S01008319,Rented or living rent free: Total,121,49,37,13,24,1,11,72,36,1,3,28,4
S01008319,Rented or living rent free: Social rented,96,37,27,12,15,1,9,59,31,1,2,22,3
S01008319,Rented or living rent free: Private rented or living rent free,25,12,10,1,9,0,2,13,5,0,1,6,1
S01008320,All HRPs aged 16 and over,308,150,127,21,106,18,5,158,130,0,3,20,5
S01008320,Owned: Total,239,117,100,10,90,16,1,122,118,0,0,2,2
S01008320,Owned: Owned outright,153,40,33,6,27,7,0,113,110,0,0,2,1
S01008320,Owned: Owned with a mortgage or loan or shared ownership,86,77,67,4,63,9,1,9,8,0,0,0,1
S01008320,Rented or living rent free: Total,69,33,27,11,16,2,4,36,12,0,3,18,3
S01008320,Rented or living rent free: Social rented,58,24,20,9,11,0,4,34,12,0,2,17,3
S01008320,Rented or living rent free: Private rented or living rent free,11,9,7,2,5,2,0,2,0,0,1,1,0
S01008321,All HRPs aged 16 and over,195,150,129,11,118,19,2,45,35,0,0,8,2
S01008321,Owned: Total,187,143,125,11,114,18,0,44,34,0,0,8,2
S01008321,Owned: Owned outright,66,30,28,6,22,2,0,36,29,0,0,6,1
S01008321,Owned: Owned with a mortgage or loan or shared ownership,121,113,97,5,92,16,0,8,5,0,0,2,1
S01008321,Rented or living rent free: Total,8,7,4,0,4,1,2,1,1,0,0,0,0
S01008321,Rented or living rent free: Social rented,4,3,1,0,1,0,2,1,1,0,0,0,0
S01008321,Rented or living rent free: Private rented or living rent free,4,4,3,0,3,1,0,0,0,0,0,0,0
S01008322,All HRPs aged 16 and over,501,308,259,48,211,29,20,193,122,4,18,37,12
S01008322,Owned: Total,311,218,189,23,166,27,2,93,88,0,2,3,0
S01008322,Owned: Owned outright,133,61,51,14,37,9,1,72,71,0,0,1,0
S01008322,Owned: Owned with a mortgage or loan or shared ownership,178,157,138,9,129,18,1,21,17,0,2,2,0
S01008322,Rented or living rent free: Total,190,90,70,25,45,2,18,100,34,4,16,34,12
S01008322,Rented or living rent free: Social rented,143,65,50,19,31,2,13,78,31,2,6,28,11
S01008322,Rented or living rent free: Private rented or living rent free,47,25,20,6,14,0,5,22,3,2,10,6,1
S01008323,All HRPs aged 16 and over,324,191,147,38,109,24,20,133,71,1,14,42,5
S01008323,Owned: Total,153,113,92,12,80,19,2,40,37,0,1,2,0
S01008323,Owned: Owned outright,43,18,10,2,8,8,0,25,25,0,0,0,0
S01008323,Owned: Owned with a mortgage or loan or shared ownership,110,95,82,10,72,11,2,15,12,0,1,2,0
S01008323,Rented or living rent free: Total,171,78,55,26,29,5,18,93,34,1,13,40,5
S01008323,Rented or living rent free: Social rented,141,57,40,17,23,4,13,84,31,0,10,40,3
S01008323,Rented or living rent free: Private rented or living rent free,30,21,15,9,6,1,5,9,3,1,3,0,2
S01008324,All HRPs aged 16 and over,254,162,139,27,112,17,6,92,56,6,11,15,4
S01008324,Owned: Total,163,111,97,10,87,13,1,52,44,3,1,3,1
S01008324,Owned: Owned outright,57,20,16,1,15,3,1,37,35,2,0,0,0
S01008324,Owned: Owned with a mortgage or loan or shared ownership,106,91,81,9,72,10,0,15,9,1,1,3,1
S01008324,Rented or living rent free: Total,91,51,42,17,25,4,5,40,12,3,10,12,3
S01008324,Rented or living rent free: Social rented,65,42,36,14,22,2,4,23,7,1,4,10,1
S01008324,Rented or living rent free: Private rented or living rent free,26,9,6,3,3,2,1,17,5,2,6,2,2
S01008325,All HRPs aged 16 and over,291,189,166,37,129,4,19,102,46,1,21,31,3
S01008325,Owned: Total,164,124,116,17,99,2,6,40,35,1,0,4,0
S01008325,Owned: Owned outright,48,18,18,6,12,0,0,30,28,0,0,2,0
S01008325,Owned: Owned with a mortgage or loan or shared ownership,116,106,98,11,87,2,6,10,7,1,0,2,0
S01008325,Rented or living rent free: Total,127,65,50,20,30,2,13,62,11,0,21,27,3
S01008325,Rented or living rent free: Social rented,106,56,42,17,25,2,12,50,10,0,18,21,1
S01008325,Rented or living rent free: Private rented or living rent free,21,9,8,3,5,0,1,12,1,0,3,6,2
S01008326,All HRPs aged 16 and over,455,275,227,57,170,20,28,180,88,10,17,45,20
S01008326,Owned: Total,223,150,137,22,115,10,3,73,54,5,1,9,4
S01008326,Owned: Owned outright,73,27,22,8,14,3,2,46,39,1,0,3,3
S01008326,Owned: Owned with a mortgage or loan or shared ownership,150,123,115,14,101,7,1,27,15,4,1,6,1
S01008326,Rented or living rent free: Total,232,125,90,35,55,10,25,107,34,5,16,36,16
S01008326,Rented or living rent free: Social rented,192,109,83,32,51,6,20,83,32,5,7,28,11
S01008326,Rented or living rent free: Private rented or living rent free,40,16,7,3,4,4,5,24,2,0,9,8,5
S01008327,All HRPs aged 16 and over,386,219,185,32,153,21,13,167,128,0,15,19,5
S01008327,Owned: Total,262,170,144,20,124,20,6,92,84,0,4,2,2
S01008327,Owned: Owned outright,110,39,30,7,23,6,3,71,67,0,2,2,0
S01008327,Owned: Owned with a mortgage or loan or shared ownership,152,131,114,13,101,14,3,21,17,0,2,0,2
S01008327,Rented or living rent free: Total,124,49,41,12,29,1,7,75,44,0,11,17,3
S01008327,Rented or living rent free: Social rented,101,39,32,9,23,1,6,62,40,0,2,17,3
S01008327,Rented or living rent free: Private rented or living rent free,23,10,9,3,6,0,1,13,4,0,9,0,0
S01008328,All HRPs aged 16 and over,242,206,167,29,138,37,2,36,30,0,2,3,1
S01008328,Owned: Total,223,189,152,25,127,36,1,34,28,0,2,3,1
S01008328,Owned: Owned outright,60,37,31,9,22,6,0,23,22,0,0,1,0
S01008328,Owned: Owned with a mortgage or loan or shared ownership,163,152,121,16,105,30,1,11,6,0,2,2,1
S01008328,Rented or living rent free: Total,19,17,15,4,11,1,1,2,2,0,0,0,0
S01008328,Rented or living rent free: Social rented,2,2,2,1,1,0,0,0,0,0,0,0,0
S01008328,Rented or living rent free: Private rented or living rent free,17,15,13,3,10,1,1,2,2,0,0,0,0
S01008329,All HRPs aged 16 and over,291,231,183,20,163,43,5,60,52,0,4,2,2
S01008329,Owned: Total,275,220,175,18,157,41,4,55,50,0,1,2,2
S01008329,Owned: Owned outright,103,55,47,9,38,7,1,48,47,0,0,0,1
S01008329,Owned: Owned with a mortgage or loan or shared ownership,172,165,128,9,119,34,3,7,3,0,1,2,1
S01008329,Rented or living rent free: Total,16,11,8,2,6,2,1,5,2,0,3,0,0
S01008329,Rented or living rent free: Social rented,3,1,1,1,0,0,0,2,1,0,1,0,0
S01008329,Rented or living rent free: Private rented or living rent free,13,10,7,1,6,2,1,3,1,0,2,0,0
S01008330,All HRPs aged 16 and over,290,225,175,25,150,45,5,65,50,0,3,8,4
S01008330,Owned: Total,274,213,167,23,144,43,3,61,47,0,3,7,4
S01008330,Owned: Owned outright,114,63,51,9,42,10,2,51,46,0,2,1,2
S01008330,Owned: Owned with a mortgage or loan or shared ownership,160,150,116,14,102,33,1,10,1,0,1,6,2
S01008330,Rented or living rent free: Total,16,12,8,2,6,2,2,4,3,0,0,1,0
S01008330,Rented or living rent free: Social rented,3,2,2,1,1,0,0,1,0,0,0,1,0
S01008330,Rented or living rent free: Private rented or living rent free,13,10,6,1,5,2,2,3,3,0,0,0,0
S01008331,All HRPs aged 16 and over,246,198,155,25,130,39,4,48,37,0,2,8,1
S01008331,Owned: Total,210,172,138,18,120,32,2,38,34,0,0,3,1
S01008331,Owned: Owned outright,65,36,29,7,22,6,1,29,25,0,0,3,1
S01008331,Owned: Owned with a mortgage or loan or shared ownership,145,136,109,11,98,26,1,9,9,0,0,0,0
S01008331,Rented or living rent free: Total,36,26,17,7,10,7,2,10,3,0,2,5,0
S01008331,Rented or living rent free: Social rented,3,1,0,0,0,1,0,2,1,0,0,1,0
S01008331,Rented or living rent free: Private rented or living rent free,33,25,17,7,10,6,2,8,2,0,2,4,0
S01008332,All HRPs aged 16 and over,378,229,168,35,133,56,5,149,132,1,8,7,1
S01008332,Owned: Total,331,205,148,27,121,53,4,126,116,0,5,4,1
S01008332,Owned: Owned outright,188,79,62,20,42,16,1,109,105,0,1,2,1
S01008332,Owned: Owned with a mortgage or loan or shared ownership,143,126,86,7,79,37,3,17,11,0,4,2,0
S01008332,Rented or living rent free: Total,47,24,20,8,12,3,1,23,16,1,3,3,0
S01008332,Rented or living rent free: Social rented,6,4,4,2,2,0,0,2,0,1,0,1,0
S01008332,Rented or living rent free: Private rented or living rent free,41,20,16,6,10,3,1,21,16,0,3,2,0
S01008333,All HRPs aged 16 and over,454,220,153,23,130,62,5,234,221,0,2,10,1
S01008333,Owned: Total,349,203,144,21,123,57,2,146,137,0,2,6,1
S01008333,Owned: Owned outright,202,72,49,13,36,21,2,130,127,0,0,3,0
S01008333,Owned: Owned with a mortgage or loan or shared ownership,147,131,95,8,87,36,0,16,10,0,2,3,1
S01008333,Rented or living rent free: Total,105,17,9,2,7,5,3,88,84,0,0,4,0
S01008333,Rented or living rent free: Social rented,34,0,0,0,0,0,0,34,33,0,0,1,0
S01008333,Rented or living rent free: Private rented or living rent free,71,17,9,2,7,5,3,54,51,0,0,3,0
S01008334,All HRPs aged 16 and over,321,196,157,22,135,32,7,125,111,1,2,8,3
S01008334,Owned: Total,296,179,146,19,127,30,3,117,106,1,2,5,3
S01008334,Owned: Owned outright,156,58,47,12,35,9,2,98,95,0,2,0,1
S01008334,Owned: Owned with a mortgage or loan or shared ownership,140,121,99,7,92,21,1,19,11,1,0,5,2
S01008334,Rented or living rent free: Total,25,17,11,3,8,2,4,8,5,0,0,3,0
S01008334,Rented or living rent free: Social rented,3,1,1,1,0,0,0,2,1,0,0,1,0
S01008334,Rented or living rent free: Private rented or living rent free,22,16,10,2,8,2,4,6,4,0,0,2,0
S01008335,All HRPs aged 16 and over,330,181,148,34,114,25,8,149,113,3,11,20,2
S01008335,Owned: Total,230,139,113,19,94,24,2,91,81,0,4,4,2
S01008335,Owned: Owned outright,100,28,23,9,14,5,0,72,69,0,2,1,0
S01008335,Owned: Owned with a mortgage or loan or shared ownership,130,111,90,10,80,19,2,19,12,0,2,3,2
S01008335,Rented or living rent free: Total,100,42,35,15,20,1,6,58,32,3,7,16,0
S01008335,Rented or living rent free: Social rented,80,27,23,10,13,0,4,53,31,1,5,16,0
S01008335,Rented or living rent free: Private rented or living rent free,20,15,12,5,7,1,2,5,1,2,2,0,0
S01008336,All HRPs aged 16 and over,268,166,121,20,101,38,7,102,80,0,3,18,1
S01008336,Owned: Total,180,139,100,11,89,35,4,41,32,0,0,9,0
S01008336,Owned: Owned outright,62,31,19,5,14,11,1,31,24,0,0,7,0
S01008336,Owned: Owned with a mortgage or loan or shared ownership,118,108,81,6,75,24,3,10,8,0,0,2,0
S01008336,Rented or living rent free: Total,88,27,21,9,12,3,3,61,48,0,3,9,1
S01008336,Rented or living rent free: Social rented,75,16,11,6,5,2,3,59,48,0,2,8,1
S01008336,Rented or living rent free: Private rented or living rent free,13,11,10,3,7,1,0,2,0,0,1,1,0
S01008337,All HRPs aged 16 and over,365,275,244,31,213,24,7,90,70,2,5,11,2
S01008337,Owned: Total,286,238,215,18,197,21,2,48,35,1,5,6,1
S01008337,Owned: Owned outright,77,39,35,9,26,3,1,38,28,1,2,6,1
S01008337,Owned: Owned with a mortgage or loan or shared ownership,209,199,180,9,171,18,1,10,7,0,3,0,0
S01008337,Rented or living rent free: Total,79,37,29,13,16,3,5,42,35,1,0,5,1
S01008337,Rented or living rent free: Social rented,61,22,17,6,11,2,3,39,34,0,0,4,1
S01008337,Rented or living rent free: Private rented or living rent free,18,15,12,7,5,1,2,3,1,1,0,1,0
S01008338,All HRPs aged 16 and over,262,242,203,22,181,38,1,20,18,0,0,1,1
S01008338,Owned: Total,249,229,191,17,174,37,1,20,18,0,0,1,1
S01008338,Owned: Owned outright,42,28,19,6,13,9,0,14,14,0,0,0,0
S01008338,Owned: Owned with a mortgage or loan or shared ownership,207,201,172,11,161,28,1,6,4,0,0,1,1
S01008338,Rented or living rent free: Total,13,13,12,5,7,1,0,0,0,0,0,0,0
S01008338,Rented or living rent free: Social rented,2,2,2,1,1,0,0,0,0,0,0,0,0
S01008338,Rented or living rent free: Private rented or living rent free,11,11,10,4,6,1,0,0,0,0,0,0,0
S01008339,All HRPs aged 16 and over,227,197,167,31,136,26,4,30,23,0,2,5,0
S01008339,Owned: Total,211,187,157,31,126,26,4,24,22,0,0,2,0
S01008339,Owned: Owned outright,70,51,45,18,27,5,1,19,19,0,0,0,0
S01008339,Owned: Owned with a mortgage or loan or shared ownership,141,136,112,13,99,21,3,5,3,0,0,2,0
S01008339,Rented or living rent free: Total,16,10,10,0,10,0,0,6,1,0,2,3,0
S01008339,Rented or living rent free: Social rented,2,0,0,0,0,0,0,2,1,0,0,1,0
S01008339,Rented or living rent free: Private rented or living rent free,14,10,10,0,10,0,0,4,0,0,2,2,0
S01008340,All HRPs aged 16 and over,313,262,211,29,182,45,6,51,40,1,6,2,2
S01008340,Owned: Total,285,241,193,25,168,42,6,44,38,1,4,1,0
S01008340,Owned: Owned outright,95,57,37,13,24,14,6,38,34,0,4,0,0
S01008340,Owned: Owned with a mortgage or loan or shared ownership,190,184,156,12,144,28,0,6,4,1,0,1,0
S01008340,Rented or living rent free: Total,28,21,18,4,14,3,0,7,2,0,2,1,2
S01008340,Rented or living rent free: Social rented,2,0,0,0,0,0,0,2,1,0,1,0,0
S01008340,Rented or living rent free: Private rented or living rent free,26,21,18,4,14,3,0,5,1,0,1,1,2
S01008341,All HRPs aged 16 and over,204,181,137,12,125,44,0,23,19,0,3,1,0
S01008341,Owned: Total,200,178,134,11,123,44,0,22,19,0,2,1,0
S01008341,Owned: Owned outright,62,41,36,4,32,5,0,21,19,0,2,0,0
S01008341,Owned: Owned with a mortgage or loan or shared ownership,138,137,98,7,91,39,0,1,0,0,0,1,0
S01008341,Rented or living rent free: Total,4,3,3,1,2,0,0,1,0,0,1,0,0
S01008341,Rented or living rent free: Social rented,1,0,0,0,0,0,0,1,0,0,1,0,0
S01008341,Rented or living rent free: Private rented or living rent free,3,3,3,1,2,0,0,0,0,0,0,0,0
S01008342,All HRPs aged 16 and over,327,212,163,25,138,37,12,115,83,2,9,17,4
S01008342,Owned: Total,238,169,136,15,121,33,0,69,60,0,8,1,0
S01008342,Owned: Owned outright,104,52,43,9,34,9,0,52,50,0,1,1,0
S01008342,Owned: Owned with a mortgage or loan or shared ownership,134,117,93,6,87,24,0,17,10,0,7,0,0
S01008342,Rented or living rent free: Total,89,43,27,10,17,4,12,46,23,2,1,16,4
S01008342,Rented or living rent free: Social rented,81,36,21,9,12,3,12,45,22,2,1,16,4
S01008342,Rented or living rent free: Private rented or living rent free,8,7,6,1,5,1,0,1,1,0,0,0,0
S01008343,All HRPs aged 16 and over,328,203,140,14,126,56,7,125,121,0,3,1,0
S01008343,Owned: Total,323,200,139,14,125,54,7,123,119,0,3,1,0
S01008343,Owned: Owned outright,183,65,43,9,34,19,3,118,117,0,1,0,0
S01008343,Owned: Owned with a mortgage or loan or shared ownership,140,135,96,5,91,35,4,5,2,0,2,1,0
S01008343,Rented or living rent free: Total,5,3,1,0,1,2,0,2,2,0,0,0,0
S01008343,Rented or living rent free: Social rented,0,0,0,0,0,0,0,0,0,0,0,0,0
S01008343,Rented or living rent free: Private rented or living rent free,5,3,1,0,1,2,0,2,2,0,0,0,0
S01008344,All HRPs aged 16 and over,355,234,131,23,108,98,5,121,105,0,13,2,1
S01008344,Owned: Total,331,216,120,21,99,93,3,115,101,0,13,0,1
S01008344,Owned: Owned outright,188,92,48,12,36,43,1,96,91,0,4,0,1
S01008344,Owned: Owned with a mortgage or loan or shared ownership,143,124,72,9,63,50,2,19,10,0,9,0,0
S01008344,Rented or living rent free: Total,24,18,11,2,9,5,2,6,4,0,0,2,0
S01008344,Rented or living rent free: Social rented,5,4,2,1,1,1,1,1,1,0,0,0,0
S01008344,Rented or living rent free: Private rented or living rent free,19,14,9,1,8,4,1,5,3,0,0,2,0
S01008345,All HRPs aged 16 and over,350,211,139,19,120,71,1,139,128,1,8,1,1
S01008345,Owned: Total,332,201,131,15,116,69,1,131,122,0,7,1,1
S01008345,Owned: Owned outright,210,94,57,8,49,36,1,116,109,0,5,1,1
S01008345,Owned: Owned with a mortgage or loan or shared ownership,122,107,74,7,67,33,0,15,13,0,2,0,0
S01008345,Rented or living rent free: Total,18,10,8,4,4,2,0,8,6,1,1,0,0
S01008345,Rented or living rent free: Social rented,1,1,1,0,1,0,0,0,0,0,0,0,0
S01008345,Rented or living rent free: Private rented or living rent free,17,9,7,4,3,2,0,8,6,1,1,0,0
S01008346,All HRPs aged 16 and over,359,233,163,19,144,67,3,126,112,2,4,6,2
S01008346,Owned: Total,346,226,159,19,140,64,3,120,110,0,3,5,2
S01008346,Owned: Owned outright,168,65,47,10,37,16,2,103,100,0,1,2,0
S01008346,Owned: Owned with a mortgage or loan or shared ownership,178,161,112,9,103,48,1,17,10,0,2,3,2
S01008346,Rented or living rent free: Total,13,7,4,0,4,3,0,6,2,2,1,1,0
S01008346,Rented or living rent free: Social rented,1,0,0,0,0,0,0,1,0,0,1,0,0
S01008346,Rented or living rent free: Private rented or living rent free,12,7,4,0,4,3,0,5,2,2,0,1,0
S01008347,All HRPs aged 16 and over,489,242,178,26,152,54,10,247,226,1,11,6,3
S01008347,Owned: Total,431,205,151,24,127,49,5,226,211,1,6,6,2
S01008347,Owned: Owned outright,267,67,49,12,37,17,1,200,193,0,4,2,1
S01008347,Owned: Owned with a mortgage or loan or shared ownership,164,138,102,12,90,32,4,26,18,1,2,4,1
S01008347,Rented or living rent free: Total,58,37,27,2,25,5,5,21,15,0,5,0,1
S01008347,Rented or living rent free: Social rented,6,3,3,0,3,0,0,3,1,0,2,0,0
S01008347,Rented or living rent free: Private rented or living rent free,52,34,24,2,22,5,5,18,14,0,3,0,1
S01008348,All HRPs aged 16 and over,326,193,140,25,115,44,9,133,119,0,6,4,4
S01008348,Owned: Total,301,180,134,23,111,42,4,121,114,0,4,0,3
S01008348,Owned: Owned outright,179,65,47,15,32,17,1,114,109,0,3,0,2
S01008348,Owned: Owned with a mortgage or loan or shared ownership,122,115,87,8,79,25,3,7,5,0,1,0,1
S01008348,Rented or living rent free: Total,25,13,6,2,4,2,5,12,5,0,2,4,1
S01008348,Rented or living rent free: Social rented,3,2,1,1,0,1,0,1,0,0,1,0,0
S01008348,Rented or living rent free: Private rented or living rent free,22,11,5,1,4,1,5,11,5,0,1,4,1
S01008349,All HRPs aged 16 and over,313,222,152,21,131,68,2,91,82,0,6,2,1
S01008349,Owned: Total,300,215,147,18,129,66,2,85,80,0,2,2,1
S01008349,Owned: Owned outright,144,68,45,11,34,22,1,76,75,0,0,0,1
S01008349,Owned: Owned with a mortgage or loan or shared ownership,156,147,102,7,95,44,1,9,5,0,2,2,0
S01008349,Rented or living rent free: Total,13,7,5,3,2,2,0,6,2,0,4,0,0
S01008349,Rented or living rent free: Social rented,1,1,1,1,0,0,0,0,0,0,0,0,0
S01008349,Rented or living rent free: Private rented or living rent free,12,6,4,2,2,2,0,6,2,0,4,0,0
S01008350,All HRPs aged 16 and over,257,133,91,8,83,38,4,124,115,0,0,3,6
S01008350,Owned: Total,244,123,85,8,77,35,3,121,113,0,0,2,6
S01008350,Owned: Owned outright,147,46,28,7,21,15,3,101,95,0,0,2,4
S01008350,Owned: Owned with a mortgage or loan or shared ownership,97,77,57,1,56,20,0,20,18,0,0,0,2
S01008350,Rented or living rent free: Total,13,10,6,0,6,3,1,3,2,0,0,1,0
S01008350,Rented or living rent free: Social rented,5,4,2,0,2,1,1,1,0,0,0,1,0
S01008350,Rented or living rent free: Private rented or living rent free,8,6,4,0,4,2,0,2,2,0,0,0,0
S01008351,All HRPs aged 16 and over,347,224,176,24,152,45,3,123,115,1,6,0,1
S01008351,Owned: Total,331,214,167,18,149,45,2,117,112,0,4,0,1
S01008351,Owned: Owned outright,174,69,56,11,45,13,0,105,100,0,4,0,1
S01008351,Owned: Owned with a mortgage or loan or shared ownership,157,145,111,7,104,32,2,12,12,0,0,0,0
S01008351,Rented or living rent free: Total,16,10,9,6,3,0,1,6,3,1,2,0,0
S01008351,Rented or living rent free: Social rented,2,0,0,0,0,0,0,2,1,1,0,0,0
S01008351,Rented or living rent free: Private rented or living rent free,14,10,9,6,3,0,1,4,2,0,2,0,0
S01008352,All HRPs aged 16 and over,248,151,116,13,103,35,0,97,89,3,3,1,1
S01008352,Owned: Total,236,143,109,13,96,34,0,93,86,2,3,1,1
S01008352,Owned: Owned outright,138,57,42,11,31,15,0,81,78,2,1,0,0
S01008352,Owned: Owned with a mortgage or loan or shared ownership,98,86,67,2,65,19,0,12,8,0,2,1,1
S01008352,Rented or living rent free: Total,12,8,7,0,7,1,0,4,3,1,0,0,0
S01008352,Rented or living rent free: Social rented,0,0,0,0,0,0,0,0,0,0,0,0,0
S01008352,Rented or living rent free: Private rented or living rent free,12,8,7,0,7,1,0,4,3,1,0,0,0
S01008353,All HRPs aged 16 and over,198,132,82,10,72,46,4,66,61,0,3,2,0
S01008353,Owned: Total,189,126,79,8,71,45,2,63,59,0,3,1,0
S01008353,Owned: Owned outright,91,35,21,3,18,12,2,56,54,0,1,1,0
S01008353,Owned: Owned with a mortgage or loan or shared ownership,98,91,58,5,53,33,0,7,5,0,2,0,0
S01008353,Rented or living rent free: Total,9,6,3,2,1,1,2,3,2,0,0,1,0
S01008353,Rented or living rent free: Social rented,1,0,0,0,0,0,0,1,1,0,0,0,0
S01008353,Rented or living rent free: Private rented or living rent free,8,6,3,2,1,1,2,2,1,0,0,1,0
S01008354,All HRPs aged 16 and over,286,193,126,15,111,65,2,93,81,0,4,8,0
S01008354,Owned: Total,236,171,109,9,100,61,1,65,56,0,3,6,0
S01008354,Owned: Owned outright,111,61,32,7,25,29,0,50,46,0,0,4,0
S01008354,Owned: Owned with a mortgage or loan or shared ownership,125,110,77,2,75,32,1,15,10,0,3,2,0
S01008354,Rented or living rent free: Total,50,22,17,6,11,4,1,28,25,0,1,2,0
S01008354,Rented or living rent free: Social rented,25,4,3,2,1,0,1,21,18,0,1,2,0
S01008354,Rented or living rent free: Private rented or living rent free,25,18,14,4,10,4,0,7,7,0,0,0,0
S01008355,All HRPs aged 16 and over,299,158,121,18,103,31,6,141,113,3,5,16,4
S01008355,Owned: Total,204,118,92,13,79,25,1,86,68,2,4,9,3
S01008355,Owned: Owned outright,96,28,21,7,14,7,0,68,59,2,1,4,2
S01008355,Owned: Owned with a mortgage or loan or shared ownership,108,90,71,6,65,18,1,18,9,0,3,5,1
S01008355,Rented or living rent free: Total,95,40,29,5,24,6,5,55,45,1,1,7,1
S01008355,Rented or living rent free: Social rented,65,18,11,1,10,3,4,47,39,0,1,6,1
S01008355,Rented or living rent free: Private rented or living rent free,30,22,18,4,14,3,1,8,6,1,0,1,0
S01008356,All HRPs aged 16 and over,259,205,164,25,139,38,3,54,42,4,2,6,0
S01008356,Owned: Total,238,190,151,18,133,37,2,48,38,4,1,5,0
S01008356,Owned: Owned outright,81,44,27,8,19,16,1,37,31,2,0,4,0
S01008356,Owned: Owned with a mortgage or loan or shared ownership,157,146,124,10,114,21,1,11,7,2,1,1,0
S01008356,Rented or living rent free: Total,21,15,13,7,6,1,1,6,4,0,1,1,0
S01008356,Rented or living rent free: Social rented,3,2,2,1,1,0,0,1,1,0,0,0,0
S01008356,Rented or living rent free: Private rented or living rent free,18,13,11,6,5,1,1,5,3,0,1,1,0
S01008357,All HRPs aged 16 and over,296,184,150,18,132,34,0,112,98,2,3,8,1
S01008357,Owned: Total,268,167,138,16,122,29,0,101,95,1,3,2,0
S01008357,Owned: Owned outright,131,41,34,9,25,7,0,90,88,1,1,0,0
S01008357,Owned: Owned with a mortgage or loan or shared ownership,137,126,104,7,97,22,0,11,7,0,2,2,0
S01008357,Rented or living rent free: Total,28,17,12,2,10,5,0,11,3,1,0,6,1
S01008357,Rented or living rent free: Social rented,4,1,1,0,1,0,0,3,1,0,0,1,1
S01008357,Rented or living rent free: Private rented or living rent free,24,16,11,2,9,5,0,8,2,1,0,5,0
S01008358,All HRPs aged 16 and over,346,184,144,23,121,31,9,162,135,1,12,12,2
S01008358,Owned: Total,234,142,114,12,102,25,3,92,85,0,3,3,1
S01008358,Owned: Owned outright,109,41,30,8,22,9,2,68,65,0,1,1,1
S01008358,Owned: Owned with a mortgage or loan or shared ownership,125,101,84,4,80,16,1,24,20,0,2,2,0
S01008358,Rented or living rent free: Total,112,42,30,11,19,6,6,70,50,1,9,9,1
S01008358,Rented or living rent free: Social rented,70,20,16,5,11,3,1,50,39,0,3,8,0
S01008358,Rented or living rent free: Private rented or living rent free,42,22,14,6,8,3,5,20,11,1,6,1,1
S01008359,All HRPs aged 16 and over,250,167,122,10,112,42,3,83,73,1,2,6,1
S01008359,Owned: Total,227,152,114,8,106,36,2,75,70,1,1,3,0
S01008359,Owned: Owned outright,105,44,27,3,24,15,2,61,61,0,0,0,0
S01008359,Owned: Owned with a mortgage or loan or shared ownership,122,108,87,5,82,21,0,14,9,1,1,3,0
S01008359,Rented or living rent free: Total,23,15,8,2,6,6,1,8,3,0,1,3,1
S01008359,Rented or living rent free: Social rented,7,2,0,0,0,1,1,5,1,0,1,2,1
S01008359,Rented or living rent free: Private rented or living rent free,16,13,8,2,6,5,0,3,2,0,0,1,0
S01008360,All HRPs aged 16 and over,319,212,145,15,130,64,3,107,96,0,7,3,1
S01008360,Owned: Total,302,200,136,12,124,61,3,102,94,0,5,2,1
S01008360,Owned: Owned outright,148,61,33,7,26,26,2,87,85,0,0,1,1
S01008360,Owned: Owned with a mortgage or loan or shared ownership,154,139,103,5,98,35,1,15,9,0,5,1,0
S01008360,Rented or living rent free: Total,17,12,9,3,6,3,0,5,2,0,2,1,0
S01008360,Rented or living rent free: Social rented,4,2,1,0,1,1,0,2,1,0,1,0,0
S01008360,Rented or living rent free: Private rented or living rent free,13,10,8,3,5,2,0,3,1,0,1,1,0
S01008361,All HRPs aged 16 and over,201,144,121,17,104,21,2,57,51,1,1,3,1
S01008361,Owned: Total,188,134,113,14,99,19,2,54,49,1,0,3,1
S01008361,Owned: Owned outright,83,39,32,8,24,7,0,44,42,0,0,1,1
S01008361,Owned: Owned with a mortgage or loan or shared ownership,105,95,81,6,75,12,2,10,7,1,0,2,0
S01008361,Rented or living rent free: Total,13,10,8,3,5,2,0,3,2,0,1,0,0
S01008361,Rented or living rent free: Social rented,4,3,3,2,1,0,0,1,1,0,0,0,0
S01008361,Rented or living rent free: Private rented or living rent free,9,7,5,1,4,2,0,2,1,0,1,0,0
S01008362,All HRPs aged 16 and over,409,300,242,26,216,50,8,109,84,2,7,11,5
S01008362,Owned: Total,367,271,225,22,203,44,2,96,81,1,4,7,3
S01008362,Owned: Owned outright,124,58,45,13,32,12,1,66,60,0,0,4,2
S01008362,Owned: Owned with a mortgage or loan or shared ownership,243,213,180,9,171,32,1,30,21,1,4,3,1
S01008362,Rented or living rent free: Total,42,29,17,4,13,6,6,13,3,1,3,4,2
S01008362,Rented or living rent free: Social rented,1,0,0,0,0,0,0,1,0,0,0,1,0
S01008362,Rented or living rent free: Private rented or living rent free,41,29,17,4,13,6,6,12,3,1,3,3,2
S01008363,All HRPs aged 16 and over,320,219,182,34,148,30,7,101,86,2,1,9,3
S01008363,Owned: Total,279,187,156,25,131,28,3,92,80,2,1,7,2
S01008363,Owned: Owned outright,142,62,46,12,34,13,3,80,73,2,1,4,0
S01008363,Owned: Owned with a mortgage or loan or shared ownership,137,125,110,13,97,15,0,12,7,0,0,3,2
S01008363,Rented or living rent free: Total,41,32,26,9,17,2,4,9,6,0,0,2,1
S01008363,Rented or living rent free: Social rented,2,1,1,0,1,0,0,1,0,0,0,1,0
S01008363,Rented or living rent free: Private rented or living rent free,39,31,25,9,16,2,4,8,6,0,0,1,1
S01008364,All HRPs aged 16 and over,322,217,162,30,132,44,11,105,92,1,4,4,4
S01008364,Owned: Total,290,194,151,26,125,41,2,96,88,1,3,1,3
S01008364,Owned: Owned outright,135,58,39,13,26,19,0,77,73,0,3,0,1
S01008364,Owned: Owned with a mortgage or loan or shared ownership,155,136,112,13,99,22,2,19,15,1,0,1,2
S01008364,Rented or living rent free: Total,32,23,11,4,7,3,9,9,4,0,1,3,1
S01008364,Rented or living rent free: Social rented,10,8,2,0,2,1,5,2,0,0,0,2,0
S01008364,Rented or living rent free: Private rented or living rent free,22,15,9,4,5,2,4,7,4,0,1,1,1
S01008365,All HRPs aged 16 and over,288,170,111,20,91,52,7,118,107,1,3,7,0
S01008365,Owned: Total,274,162,106,19,87,51,5,112,104,0,3,5,0
S01008365,Owned: Owned outright,160,67,44,13,31,22,1,93,90,0,2,1,0
S01008365,Owned: Owned with a mortgage or loan or shared ownership,114,95,62,6,56,29,4,19,14,0,1,4,0
S01008365,Rented or living rent free: Total,14,8,5,1,4,1,2,6,3,1,0,2,0
S01008365,Rented or living rent free: Social rented,1,0,0,0,0,0,0,1,1,0,0,0,0
S01008365,Rented or living rent free: Private rented or living rent free,13,8,5,1,4,1,2,5,2,1,0,2,0
S01008366,All HRPs aged 16 and over,424,215,181,34,147,29,5,209,172,15,7,12,3
S01008366,Owned: Total,305,175,148,21,127,25,2,130,113,10,2,4,1
S01008366,Owned: Owned outright,154,39,31,6,25,7,1,115,104,7,0,3,1
S01008366,Owned: Owned with a mortgage or loan or shared ownership,151,136,117,15,102,18,1,15,9,3,2,1,0
S01008366,Rented or living rent free: Total,119,40,33,13,20,4,3,79,59,5,5,8,2
S01008366,Rented or living rent free: Social rented,105,32,26,11,15,3,3,73,58,4,4,6,1
S01008366,Rented or living rent free: Private rented or living rent free,14,8,7,2,5,1,0,6,1,1,1,2,1
S01008367,All HRPs aged 16 and over,368,208,169,27,142,24,15,160,111,20,1,21,7
S01008367,Owned: Total,201,139,118,9,109,19,2,62,55,5,0,2,0
S01008367,Owned: Owned outright,70,28,24,3,21,4,0,42,40,2,0,0,0
S01008367,Owned: Owned with a mortgage or loan or shared ownership,131,111,94,6,88,15,2,20,15,3,0,2,0
S01008367,Rented or living rent free: Total,167,69,51,18,33,5,13,98,56,15,1,19,7
S01008367,Rented or living rent free: Social rented,123,45,34,12,22,3,8,78,53,9,0,12,4
S01008367,Rented or living rent free: Private rented or living rent free,44,24,17,6,11,2,5,20,3,6,1,7,3
S01008368,All HRPs aged 16 and over,311,205,172,20,152,29,4,106,88,4,4,10,0
S01008368,Owned: Total,272,186,157,15,142,26,3,86,78,4,0,4,0
S01008368,Owned: Owned outright,113,43,39,8,31,3,1,70,66,2,0,2,0
S01008368,Owned: Owned with a mortgage or loan or shared ownership,159,143,118,7,111,23,2,16,12,2,0,2,0
S01008368,Rented or living rent free: Total,39,19,15,5,10,3,1,20,10,0,4,6,0
S01008368,Rented or living rent free: Social rented,12,3,3,2,1,0,0,9,4,0,3,2,0
S01008368,Rented or living rent free: Private rented or living rent free,27,16,12,3,9,3,1,11,6,0,1,4,0
S01008369,All HRPs aged 16 and over,235,147,127,21,106,15,5,88,67,7,1,12,1
S01008369,Owned: Total,196,127,113,14,99,13,1,69,60,6,0,3,0
S01008369,Owned: Owned outright,89,29,26,4,22,3,0,60,52,6,0,2,0
S01008369,Owned: Owned with a mortgage or loan or shared ownership,107,98,87,10,77,10,1,9,8,0,0,1,0
S01008369,Rented or living rent free: Total,39,20,14,7,7,2,4,19,7,1,1,9,1
S01008369,Rented or living rent free: Social rented,28,11,8,3,5,1,2,17,7,0,0,9,1
S01008369,Rented or living rent free: Private rented or living rent free,11,9,6,4,2,1,2,2,0,1,1,0,0
S01008370,All HRPs aged 16 and over,300,198,149,19,130,44,5,102,82,7,4,8,1
S01008370,Owned: Total,263,177,134,18,116,40,3,86,79,3,0,3,1
S01008370,Owned: Owned outright,118,43,31,6,25,12,0,75,71,3,0,0,1
S01008370,Owned: Owned with a mortgage or loan or shared ownership,145,134,103,12,91,28,3,11,8,0,0,3,0
S01008370,Rented or living rent free: Total,37,21,15,1,14,4,2,16,3,4,4,5,0
S01008370,Rented or living rent free: Social rented,17,7,6,1,5,1,0,10,2,4,0,4,0
S01008370,Rented or living rent free: Private rented or living rent free,20,14,9,0,9,3,2,6,1,0,4,1,0
S01008371,All HRPs aged 16 and over,302,207,169,22,147,35,3,95,85,2,1,2,5
S01008371,Owned: Total,292,200,165,21,144,33,2,92,83,1,1,2,5
S01008371,Owned: Owned outright,144,63,53,12,41,10,0,81,77,0,0,0,4
S01008371,Owned: Owned with a mortgage or loan or shared ownership,148,137,112,9,103,23,2,11,6,1,1,2,1
S01008371,Rented or living rent free: Total,10,7,4,1,3,2,1,3,2,1,0,0,0
S01008371,Rented or living rent free: Social rented,2,2,1,0,1,1,0,0,0,0,0,0,0
S01008371,Rented or living rent free: Private rented or living rent free,8,5,3,1,2,1,1,3,2,1,0,0,0
S01008372,All HRPs aged 16 and over,288,208,173,22,151,29,6,80,73,2,1,1,3
S01008372,Owned: Total,279,202,169,22,147,28,5,77,72,1,1,1,2
S01008372,Owned: Owned outright,124,59,45,12,33,11,3,65,63,0,1,0,1
S01008372,Owned: Owned with a mortgage or loan or shared ownership,155,143,124,10,114,17,2,12,9,1,0,1,1
S01008372,Rented or living rent free: Total,9,6,4,0,4,1,1,3,1,1,0,0,1
S01008372,Rented or living rent free: Social rented,1,1,1,0,1,0,0,0,0,0,0,0,0
S01008372,Rented or living rent free: Private rented or living rent free,8,5,3,0,3,1,1,3,1,1,0,0,1
S01008373,All HRPs aged 16 and over,269,198,172,12,160,24,2,71,65,0,2,3,1
S01008373,Owned: Total,267,196,171,12,159,23,2,71,65,0,2,3,1
S01008373,Owned: Owned outright,113,51,46,6,40,4,1,62,60,0,1,1,0
S01008373,Owned: Owned with a mortgage or loan or shared ownership,154,145,125,6,119,19,1,9,5,0,1,2,1
S01008373,Rented or living rent free: Total,2,2,1,0,1,1,0,0,0,0,0,0,0
S01008373,Rented or living rent free: Social rented,0,0,0,0,0,0,0,0,0,0,0,0,0
S01008373,Rented or living rent free: Private rented or living rent free,2,2,1,0,1,1,0,0,0,0,0,0,0
S01008374,All HRPs aged 16 and over,264,178,155,21,134,23,0,86,80,1,4,1,0
S01008374,Owned: Total,247,166,145,17,128,21,0,81,78,1,2,0,0
S01008374,Owned: Owned outright,119,45,36,6,30,9,0,74,73,0,1,0,0
S01008374,Owned: Owned with a mortgage or loan or shared ownership,128,121,109,11,98,12,0,7,5,1,1,0,0
S01008374,Rented or living rent free: Total,17,12,10,4,6,2,0,5,2,0,2,1,0
S01008374,Rented or living rent free: Social rented,2,1,1,1,0,0,0,1,0,0,0,1,0
S01008374,Rented or living rent free: Private rented or living rent free,15,11,9,3,6,2,0,4,2,0,2,0,0
S01008375,All HRPs aged 16 and over,285,190,155,18,137,31,4,95,88,2,2,2,1
S01008375,Owned: Total,279,186,152,17,135,30,4,93,87,2,2,1,1
S01008375,Owned: Owned outright,135,49,34,8,26,13,2,86,82,2,1,0,1
S01008375,Owned: Owned with a mortgage or loan or shared ownership,144,137,118,9,109,17,2,7,5,0,1,1,0
S01008375,Rented or living rent free: Total,6,4,3,1,2,1,0,2,1,0,0,1,0
S01008375,Rented or living rent free: Social rented,1,1,1,0,1,0,0,0,0,0,0,0,0
S01008375,Rented or living rent free: Private rented or living rent free,5,3,2,1,1,1,0,2,1,0,0,1,0
S01008376,All HRPs aged 16 and over,212,151,111,12,99,31,9,61,49,1,4,6,1
S01008376,Owned: Total,194,143,106,11,95,30,7,51,48,0,1,1,1
S01008376,Owned: Owned outright,80,36,21,6,15,10,5,44,42,0,0,1,1
S01008376,Owned: Owned with a mortgage or loan or shared ownership,114,107,85,5,80,20,2,7,6,0,1,0,0
S01008376,Rented or living rent free: Total,18,8,5,1,4,1,2,10,1,1,3,5,0
S01008376,Rented or living rent free: Social rented,5,1,1,1,0,0,0,4,0,0,1,3,0
S01008376,Rented or living rent free: Private rented or living rent free,13,7,4,0,4,1,2,6,1,1,2,2,0
S01008377,All HRPs aged 16 and over,291,208,175,19,156,32,1,83,72,2,1,3,5
S01008377,Owned: Total,268,193,163,16,147,29,1,75,69,0,1,1,4
S01008377,Owned: Owned outright,117,49,40,11,29,9,0,68,65,0,0,1,2
S01008377,Owned: Owned with a mortgage or loan or shared ownership,151,144,123,5,118,20,1,7,4,0,1,0,2
S01008377,Rented or living rent free: Total,23,15,12,3,9,3,0,8,3,2,0,2,1
S01008377,Rented or living rent free: Social rented,0,0,0,0,0,0,0,0,0,0,0,0,0
S01008377,Rented or living rent free: Private rented or living rent free,23,15,12,3,9,3,0,8,3,2,0,2,1
S01008378,All HRPs aged 16 and over,421,241,191,16,175,49,1,180,163,1,5,8,3
S01008378,Owned: Total,378,216,175,13,162,41,0,162,156,1,2,3,0
S01008378,Owned: Owned outright,199,53,40,6,34,13,0,146,143,1,0,2,0
S01008378,Owned: Owned with a mortgage or loan or shared ownership,179,163,135,7,128,28,0,16,13,0,2,1,0
S01008378,Rented or living rent free: Total,43,25,16,3,13,8,1,18,7,0,3,5,3
S01008378,Rented or living rent free: Social rented,14,3,3,2,1,0,0,11,3,0,3,4,1
S01008378,Rented or living rent free: Private rented or living rent free,29,22,13,1,12,8,1,7,4,0,0,1,2
S01008379,All HRPs aged 16 and over,206,110,87,10,77,22,1,96,83,3,5,4,1
S01008379,Owned: Total,200,108,86,10,76,21,1,92,83,0,5,3,1
S01008379,Owned: Owned outright,114,28,24,5,19,3,1,86,81,0,2,2,1
S01008379,Owned: Owned with a mortgage or loan or shared ownership,86,80,62,5,57,18,0,6,2,0,3,1,0
S01008379,Rented or living rent free: Total,6,2,1,0,1,1,0,4,0,3,0,1,0
S01008379,Rented or living rent free: Social rented,1,0,0,0,0,0,0,1,0,0,0,1,0
S01008379,Rented or living rent free: Private rented or living rent free,5,2,1,0,1,1,0,3,0,3,0,0,0
S01008380,All HRPs aged 16 and over,238,169,141,15,126,26,2,69,57,0,6,5,1
S01008380,Owned: Total,234,166,138,15,123,26,2,68,56,0,6,5,1
S01008380,Owned: Owned outright,95,40,32,9,23,7,1,55,47,0,3,4,1
S01008380,Owned: Owned with a mortgage or loan or shared ownership,139,126,106,6,100,19,1,13,9,0,3,1,0
S01008380,Rented or living rent free: Total,4,3,3,0,3,0,0,1,1,0,0,0,0
S01008380,Rented or living rent free: Social rented,1,0,0,0,0,0,0,1,1,0,0,0,0
S01008380,Rented or living rent free: Private rented or living rent free,3,3,3,0,3,0,0,0,0,0,0,0,0
S01008381,All HRPs aged 16 and over,229,191,151,12,139,36,4,38,36,0,1,1,0
S01008381,Owned: Total,229,191,151,12,139,36,4,38,36,0,1,1,0
S01008381,Owned: Owned outright,77,44,29,8,21,12,3,33,33,0,0,0,0
S01008381,Owned: Owned with a mortgage or loan or shared ownership,152,147,122,4,118,24,1,5,3,0,1,1,0
S01008381,Rented or living rent free: Total,0,0,0,0,0,0,0,0,0,0,0,0,0
S01008381,Rented or living rent free: Social rented,0,0,0,0,0,0,0,0,0,0,0,0,0
S01008381,Rented or living rent free: Private rented or living rent free,0,0,0,0,0,0,0,0,0,0,0,0,0
S01008382,All HRPs aged 16 and over,248,156,132,13,119,22,2,92,78,5,4,5,0
S01008382,Owned: Total,241,152,130,12,118,20,2,89,76,4,4,5,0
S01008382,Owned: Owned outright,114,35,27,7,20,7,1,79,71,3,2,3,0
S01008382,Owned: Owned with a mortgage or loan or shared ownership,127,117,103,5,98,13,1,10,5,1,2,2,0
S01008382,Rented or living rent free: Total,7,4,2,1,1,2,0,3,2,1,0,0,0
S01008382,Rented or living rent free: Social rented,1,0,0,0,0,0,0,1,0,1,0,0,0
S01008382,Rented or living rent free: Private rented or living rent free,6,4,2,1,1,2,0,2,2,0,0,0,0
S01008383,All HRPs aged 16 and over,181,121,95,4,91,24,2,60,53,0,3,2,2
S01008383,Owned: Total,173,114,89,4,85,24,1,59,53,0,3,1,2
S01008383,Owned: Owned outright,77,23,21,2,19,2,0,54,51,0,0,1,2
S01008383,Owned: Owned with a mortgage or loan or shared ownership,96,91,68,2,66,22,1,5,2,0,3,0,0
S01008383,Rented or living rent free: Total,8,7,6,0,6,0,1,1,0,0,0,1,0
S01008383,Rented or living rent free: Social rented,2,1,1,0,1,0,0,1,0,0,0,1,0
S01008383,Rented or living rent free: Private rented or living rent free,6,6,5,0,5,0,1,0,0,0,0,0,0
S01008384,All HRPs aged 16 and over,387,270,240,38,202,28,2,117,101,1,3,11,1
S01008384,Owned: Total,377,264,234,36,198,28,2,113,101,0,1,10,1
S01008384,Owned: Owned outright,167,68,61,14,47,6,1,99,96,0,0,2,1
S01008384,Owned: Owned with a mortgage or loan or shared ownership,210,196,173,22,151,22,1,14,5,0,1,8,0
S01008384,Rented or living rent free: Total,10,6,6,2,4,0,0,4,0,1,2,1,0
S01008384,Rented or living rent free: Social rented,3,1,1,0,1,0,0,2,0,0,1,1,0
S01008384,Rented or living rent free: Private rented or living rent free,7,5,5,2,3,0,0,2,0,1,1,0,0
S01008385,All HRPs aged 16 and over,252,159,118,7,111,36,5,93,87,0,1,4,1
S01008385,Owned: Total,242,155,117,7,110,35,3,87,85,0,1,1,0
S01008385,Owned: Owned outright,124,45,35,3,32,8,2,79,77,0,1,1,0
S01008385,Owned: Owned with a mortgage or loan or shared ownership,118,110,82,4,78,27,1,8,8,0,0,0,0
S01008385,Rented or living rent free: Total,10,4,1,0,1,1,2,6,2,0,0,3,1
S01008385,Rented or living rent free: Social rented,6,2,0,0,0,0,2,4,0,0,0,3,1
S01008385,Rented or living rent free: Private rented or living rent free,4,2,1,0,1,1,0,2,2,0,0,0,0
S01008386,All HRPs aged 16 and over,337,231,196,28,168,32,3,106,92,2,3,7,2
S01008386,Owned: Total,319,221,188,21,167,31,2,98,88,2,3,4,1
S01008386,Owned: Owned outright,131,45,37,6,31,8,0,86,82,0,2,1,1
S01008386,Owned: Owned with a mortgage or loan or shared ownership,188,176,151,15,136,23,2,12,6,2,1,3,0
S01008386,Rented or living rent free: Total,18,10,8,7,1,1,1,8,4,0,0,3,1
S01008386,Rented or living rent free: Social rented,6,3,2,1,1,0,1,3,0,0,0,3,0
S01008386,Rented or living rent free: Private rented or living rent free,12,7,6,6,0,1,0,5,4,0,0,0,1
S01008387,All HRPs aged 16 and over,241,184,158,18,140,23,3,57,49,0,2,5,1
S01008387,Owned: Total,225,173,149,16,133,22,2,52,46,0,1,4,1
S01008387,Owned: Owned outright,76,33,25,6,19,7,1,43,41,0,0,1,1
S01008387,Owned: Owned with a mortgage or loan or shared ownership,149,140,124,10,114,15,1,9,5,0,1,3,0
S01008387,Rented or living rent free: Total,16,11,9,2,7,1,1,5,3,0,1,1,0
S01008387,Rented or living rent free: Social rented,4,2,2,1,1,0,0,2,1,0,1,0,0
S01008387,Rented or living rent free: Private rented or living rent free,12,9,7,1,6,1,1,3,2,0,0,1,0
S01008388,All HRPs aged 16 and over,243,207,182,23,159,25,0,36,26,0,2,7,1
S01008388,Owned: Total,228,197,173,18,155,24,0,31,25,0,1,5,0
S01008388,Owned: Owned outright,60,35,29,3,26,6,0,25,23,0,0,2,0
S01008388,Owned: Owned with a mortgage or loan or shared ownership,168,162,144,15,129,18,0,6,2,0,1,3,0
S01008388,Rented or living rent free: Total,15,10,9,5,4,1,0,5,1,0,1,2,1
S01008388,Rented or living rent free: Social rented,2,1,1,0,1,0,0,1,1,0,0,0,0
S01008388,Rented or living rent free: Private rented or living rent free,13,9,8,5,3,1,0,4,0,0,1,2,1
S01008389,All HRPs aged 16 and over,312,119,89,11,78,28,2,193,185,0,3,3,2
S01008389,Owned: Total,272,114,84,10,74,28,2,158,156,0,1,0,1
S01008389,Owned: Owned outright,200,45,31,5,26,14,0,155,153,0,1,0,1
S01008389,Owned: Owned with a mortgage or loan or shared ownership,72,69,53,5,48,14,2,3,3,0,0,0,0
S01008389,Rented or living rent free: Total,40,5,5,1,4,0,0,35,29,0,2,3,1
S01008389,Rented or living rent free: Social rented,28,1,1,0,1,0,0,27,24,0,1,1,1
S01008389,Rented or living rent free: Private rented or living rent free,12,4,4,1,3,0,0,8,5,0,1,2,0
S01008390,All HRPs aged 16 and over,255,160,125,13,112,34,1,95,85,0,3,4,3
S01008390,Owned: Total,250,158,123,13,110,34,1,92,83,0,2,4,3
S01008390,Owned: Owned outright,153,69,51,9,42,17,1,84,75,0,2,4,3
S01008390,Owned: Owned with a mortgage or loan or shared ownership,97,89,72,4,68,17,0,8,8,0,0,0,0
S01008390,Rented or living rent free: Total,5,2,2,0,2,0,0,3,2,0,1,0,0
S01008390,Rented or living rent free: Social rented,3,1,1,0,1,0,0,2,2,0,0,0,0
S01008390,Rented or living rent free: Private rented or living rent free,2,1,1,0,1,0,0,1,0,0,1,0,0
S01008391,All HRPs aged 16 and over,349,173,142,20,122,28,3,176,166,1,8,0,1
S01008391,Owned: Total,285,160,129,17,112,28,3,125,121,1,2,0,1
S01008391,Owned: Owned outright,168,52,39,10,29,10,3,116,114,1,0,0,1
S01008391,Owned: Owned with a mortgage or loan or shared ownership,117,108,90,7,83,18,0,9,7,0,2,0,0
S01008391,Rented or living rent free: Total,64,13,13,3,10,0,0,51,45,0,6,0,0
S01008391,Rented or living rent free: Social rented,35,0,0,0,0,0,0,35,35,0,0,0,0
S01008391,Rented or living rent free: Private rented or living rent free,29,13,13,3,10,0,0,16,10,0,6,0,0
S01008392,All HRPs aged 16 and over,330,241,202,15,187,35,4,89,73,0,5,11,0
S01008392,Owned: Total,315,235,196,14,182,35,4,80,72,0,3,5,0
S01008392,Owned: Owned outright,127,58,45,5,40,10,3,69,65,0,2,2,0
S01008392,Owned: Owned with a mortgage or loan or shared ownership,188,177,151,9,142,25,1,11,7,0,1,3,0
S01008392,Rented or living rent free: Total,15,6,6,1,5,0,0,9,1,0,2,6,0
S01008392,Rented or living rent free: Social rented,7,1,1,0,1,0,0,6,0,0,2,4,0
S01008392,Rented or living rent free: Private rented or living rent free,8,5,5,1,4,0,0,3,1,0,0,2,0
S01008393,All HRPs aged 16 and over,369,200,161,17,144,35,4,169,157,2,0,5,5
S01008393,Owned: Total,344,184,149,15,134,33,2,160,150,1,0,4,5
S01008393,Owned: Owned outright,225,75,60,11,49,14,1,150,144,1,0,2,3
S01008393,Owned: Owned with a mortgage or loan or shared ownership,119,109,89,4,85,19,1,10,6,0,0,2,2
S01008393,Rented or living rent free: Total,25,16,12,2,10,2,2,9,7,1,0,1,0
S01008393,Rented or living rent free: Social rented,3,0,0,0,0,0,0,3,2,0,0,1,0
S01008393,Rented or living rent free: Private rented or living rent free,22,16,12,2,10,2,2,6,5,1,0,0,0
S01008394,All HRPs aged 16 and over,276,209,166,9,157,42,1,67,62,1,2,2,0
S01008394,Owned: Total,268,204,162,8,154,41,1,64,61,1,0,2,0
S01008394,Owned: Owned outright,116,58,47,7,40,10,1,58,57,0,0,1,0
S01008394,Owned: Owned with a mortgage or loan or shared ownership,152,146,115,1,114,31,0,6,4,1,0,1,0
S01008394,Rented or living rent free: Total,8,5,4,1,3,1,0,3,1,0,2,0,0
S01008394,Rented or living rent free: Social rented,1,0,0,0,0,0,0,1,1,0,0,0,0
S01008394,Rented or living rent free: Private rented or living rent free,7,5,4,1,3,1,0,2,0,0,2,0,0
S01008395,All HRPs aged 16 and over,189,152,131,16,115,20,1,37,32,1,2,1,1
S01008395,Owned: Total,184,147,127,15,112,19,1,37,32,1,2,1,1
S01008395,Owned: Owned outright,78,43,37,9,28,5,1,35,31,1,2,1,0
S01008395,Owned: Owned with a mortgage or loan or shared ownership,106,104,90,6,84,14,0,2,1,0,0,0,1
S01008395,Rented or living rent free: Total,5,5,4,1,3,1,0,0,0,0,0,0,0
S01008395,Rented or living rent free: Social rented,0,0,0,0,0,0,0,0,0,0,0,0,0
S01008395,Rented or living rent free: Private rented or living rent free,5,5,4,1,3,1,0,0,0,0,0,0,0
S01008396,All HRPs aged 16 and over,303,146,107,12,95,34,5,157,151,0,1,3,2
S01008396,Owned: Total,299,142,104,12,92,34,4,157,151,0,1,3,2
S01008396,Owned: Owned outright,196,61,39,7,32,20,2,135,132,0,0,1,2
S01008396,Owned: Owned with a mortgage or loan or shared ownership,103,81,65,5,60,14,2,22,19,0,1,2,0
S01008396,Rented or living rent free: Total,4,4,3,0,3,0,1,0,0,0,0,0,0
S01008396,Rented or living rent free: Social rented,1,1,1,0,1,0,0,0,0,0,0,0,0
S01008396,Rented or living rent free: Private rented or living rent free,3,3,2,0,2,0,1,0,0,0,0,0,0
S01008397,All HRPs aged 16 and over,346,238,193,24,169,40,5,108,106,0,1,1,0
S01008397,Owned: Total,334,229,187,24,163,38,4,105,104,0,1,0,0
S01008397,Owned: Owned outright,168,73,54,13,41,16,3,95,95,0,0,0,0
S01008397,Owned: Owned with a mortgage or loan or shared ownership,166,156,133,11,122,22,1,10,9,0,1,0,0
S01008397,Rented or living rent free: Total,12,9,6,0,6,2,1,3,2,0,0,1,0
S01008397,Rented or living rent free: Social rented,0,0,0,0,0,0,0,0,0,0,0,0,0
S01008397,Rented or living rent free: Private rented or living rent free,12,9,6,0,6,2,1,3,2,0,0,1,0
S01008398,All HRPs aged 16 and over,238,138,105,10,95,29,4,100,93,0,3,2,2
S01008398,Owned: Total,203,131,98,10,88,29,4,72,67,0,2,2,1
S01008398,Owned: Owned outright,114,48,39,6,33,8,1,66,64,0,1,1,0
S01008398,Owned: Owned with a mortgage or loan or shared ownership,89,83,59,4,55,21,3,6,3,0,1,1,1
S01008398,Rented or living rent free: Total,35,7,7,0,7,0,0,28,26,0,1,0,1
S01008398,Rented or living rent free: Social rented,21,1,1,0,1,0,0,20,20,0,0,0,0
S01008398,Rented or living rent free: Private rented or living rent free,14,6,6,0,6,0,0,8,6,0,1,0,1
S01008399,All HRPs aged 16 and over,257,128,101,12,89,25,2,129,123,1,0,3,2
S01008399,Owned: Total,240,120,98,10,88,21,1,120,117,1,0,1,1
S01008399,Owned: Owned outright,162,47,37,8,29,9,1,115,112,1,0,1,1
S01008399,Owned: Owned with a mortgage or loan or shared ownership,78,73,61,2,59,12,0,5,5,0,0,0,0
S01008399,Rented or living rent free: Total,17,8,3,2,1,4,1,9,6,0,0,2,1
S01008399,Rented or living rent free: Social rented,1,0,0,0,0,0,0,1,0,0,0,1,0
S01008399,Rented or living rent free: Private rented or living rent free,16,8,3,2,1,4,1,8,6,0,0,1,1
S01008400,All HRPs aged 16 and over,261,165,133,22,111,25,7,96,82,1,5,6,2
S01008400,Owned: Total,247,156,127,19,108,24,5,91,79,1,3,6,2
S01008400,Owned: Owned outright,135,55,41,11,30,12,2,80,72,1,0,6,1
S01008400,Owned: Owned with a mortgage or loan or shared ownership,112,101,86,8,78,12,3,11,7,0,3,0,1
S01008400,Rented or living rent free: Total,14,9,6,3,3,1,2,5,3,0,2,0,0
S01008400,Rented or living rent free: Social rented,0,0,0,0,0,0,0,0,0,0,0,0,0
S01008400,Rented or living rent free: Private rented or living rent free,14,9,6,3,3,1,2,5,3,0,2,0,0
S01008401,All HRPs aged 16 and over,404,231,184,24,160,41,6,173,158,7,1,6,1
S01008401,Owned: Total,390,222,176,23,153,40,6,168,156,6,1,4,1
S01008401,Owned: Owned outright,228,76,63,15,48,11,2,152,145,4,0,2,1
S01008401,Owned: Owned with a mortgage or loan or shared ownership,162,146,113,8,105,29,4,16,11,2,1,2,0
S01008401,Rented or living rent free: Total,14,9,8,1,7,1,0,5,2,1,0,2,0
S01008401,Rented or living rent free: Social rented,1,0,0,0,0,0,0,1,0,1,0,0,0
S01008401,Rented or living rent free: Private rented or living rent free,13,9,8,1,7,1,0,4,2,0,0,2,0
S01008402,All HRPs aged 16 and over,415,262,155,17,138,104,3,153,147,0,1,5,0
S01008402,Owned: Total,396,251,149,17,132,101,1,145,142,0,1,2,0
S01008402,Owned: Owned outright,251,122,66,11,55,55,1,129,129,0,0,0,0
S01008402,Owned: Owned with a mortgage or loan or shared ownership,145,129,83,6,77,46,0,16,13,0,1,2,0
S01008402,Rented or living rent free: Total,19,11,6,0,6,3,2,8,5,0,0,3,0
S01008402,Rented or living rent free: Social rented,5,2,1,0,1,1,0,3,1,0,0,2,0
S01008402,Rented or living rent free: Private rented or living rent free,14,9,5,0,5,2,2,5,4,0,0,1,0
S01008403,All HRPs aged 16 and over,218,138,95,7,88,42,1,80,77,1,0,2,0
S01008403,Owned: Total,214,134,91,7,84,42,1,80,77,1,0,2,0
S01008403,Owned: Owned outright,116,44,29,6,23,14,1,72,70,1,0,1,0
S01008403,Owned: Owned with a mortgage or loan or shared ownership,98,90,62,1,61,28,0,8,7,0,0,1,0
S01008403,Rented or living rent free: Total,4,4,4,0,4,0,0,0,0,0,0,0,0
S01008403,Rented or living rent free: Social rented,1,1,1,0,1,0,0,0,0,0,0,0,0
S01008403,Rented or living rent free: Private rented or living rent free,3,3,3,0,3,0,0,0,0,0,0,0,0
S01008404,All HRPs aged 16 and over,349,213,157,19,138,54,2,136,127,0,4,4,1
S01008404,Owned: Total,326,199,150,17,133,47,2,127,123,0,1,2,1
S01008404,Owned: Owned outright,177,60,45,11,34,14,1,117,115,0,1,0,1
S01008404,Owned: Owned with a mortgage or loan or shared ownership,149,139,105,6,99,33,1,10,8,0,0,2,0
S01008404,Rented or living rent free: Total,23,14,7,2,5,7,0,9,4,0,3,2,0
S01008404,Rented or living rent free: Social rented,4,0,0,0,0,0,0,4,1,0,1,2,0
S01008404,Rented or living rent free: Private rented or living rent free,19,14,7,2,5,7,0,5,3,0,2,0,0
S01008405,All HRPs aged 16 and over,266,204,139,23,116,62,3,62,55,0,2,4,1
S01008405,Owned: Total,256,196,134,21,113,61,1,60,55,0,1,3,1
S01008405,Owned: Owned outright,128,76,52,13,39,23,1,52,50,0,1,1,0
S01008405,Owned: Owned with a mortgage or loan or shared ownership,128,120,82,8,74,38,0,8,5,0,0,2,1
S01008405,Rented or living rent free: Total,10,8,5,2,3,1,2,2,0,0,1,1,0
S01008405,Rented or living rent free: Social rented,3,2,1,1,0,0,1,1,0,0,1,0,0
S01008405,Rented or living rent free: Private rented or living rent free,7,6,4,1,3,1,1,1,0,0,0,1,0
S01008406,All HRPs aged 16 and over,451,205,161,11,150,42,2,246,210,2,9,19,6
S01008406,Owned: Total,292,174,139,10,129,33,2,118,103,0,2,9,4
S01008406,Owned: Owned outright,144,52,38,2,36,13,1,92,87,0,0,2,3
S01008406,Owned: Owned with a mortgage or loan or shared ownership,148,122,101,8,93,20,1,26,16,0,2,7,1
S01008406,Rented or living rent free: Total,159,31,22,1,21,9,0,128,107,2,7,10,2
S01008406,Rented or living rent free: Social rented,101,11,7,1,6,4,0,90,73,2,5,10,0
S01008406,Rented or living rent free: Private rented or living rent free,58,20,15,0,15,5,0,38,34,0,2,0,2
S01008407,All HRPs aged 16 and over,284,133,108,19,89,23,2,151,120,0,3,27,1
S01008407,Owned: Total,209,111,90,18,72,19,2,98,89,0,3,6,0
S01008407,Owned: Owned outright,129,37,30,10,20,6,1,92,85,0,3,4,0
S01008407,Owned: Owned with a mortgage or loan or shared ownership,80,74,60,8,52,13,1,6,4,0,0,2,0
S01008407,Rented or living rent free: Total,75,22,18,1,17,4,0,53,31,0,0,21,1
S01008407,Rented or living rent free: Social rented,29,1,1,0,1,0,0,28,21,0,0,7,0
S01008407,Rented or living rent free: Private rented or living rent free,46,21,17,1,16,4,0,25,10,0,0,14,1
S01008408,All HRPs aged 16 and over,265,194,156,19,137,31,7,71,54,1,4,9,3
S01008408,Owned: Total,238,177,146,17,129,27,4,61,52,0,1,5,3
S01008408,Owned: Owned outright,102,46,39,9,30,6,1,56,51,0,1,2,2
S01008408,Owned: Owned with a mortgage or loan or shared ownership,136,131,107,8,99,21,3,5,1,0,0,3,1
S01008408,Rented or living rent free: Total,27,17,10,2,8,4,3,10,2,1,3,4,0
S01008408,Rented or living rent free: Social rented,9,4,2,1,1,1,1,5,1,0,0,4,0
S01008408,Rented or living rent free: Private rented or living rent free,18,13,8,1,7,3,2,5,1,1,3,0,0
S01008409,All HRPs aged 16 and over,390,217,188,33,155,17,12,173,118,1,9,35,10
S01008409,Owned: Total,274,174,152,19,133,16,6,100,83,1,1,8,7
S01008409,Owned: Owned outright,127,45,40,8,32,2,3,82,74,0,0,5,3
S01008409,Owned: Owned with a mortgage or loan or shared ownership,147,129,112,11,101,14,3,18,9,1,1,3,4
S01008409,Rented or living rent free: Total,116,43,36,14,22,1,6,73,35,0,8,27,3
S01008409,Rented or living rent free: Social rented,73,19,16,4,12,0,3,54,30,0,0,23,1
S01008409,Rented or living rent free: Private rented or living rent free,43,24,20,10,10,1,3,19,5,0,8,4,2
S01008410,All HRPs aged 16 and over,269,133,99,15,84,29,5,136,119,0,4,8,5
S01008410,Owned: Total,244,125,94,15,79,27,4,119,109,0,1,6,3
S01008410,Owned: Owned outright,146,40,28,10,18,10,2,106,99,0,0,5,2
S01008410,Owned: Owned with a mortgage or loan or shared ownership,98,85,66,5,61,17,2,13,10,0,1,1,1
S01008410,Rented or living rent free: Total,25,8,5,0,5,2,1,17,10,0,3,2,2
S01008410,Rented or living rent free: Social rented,3,1,1,0,1,0,0,2,1,0,0,1,0
S01008410,Rented or living rent free: Private rented or living rent free,22,7,4,0,4,2,1,15,9,0,3,1,2
S01008411,All HRPs aged 16 and over,247,166,133,17,116,28,5,81,65,0,0,16,0
S01008411,Owned: Total,217,152,121,14,107,28,3,65,58,0,0,7,0
S01008411,Owned: Owned outright,107,52,42,8,34,10,0,55,50,0,0,5,0
S01008411,Owned: Owned with a mortgage or loan or shared ownership,110,100,79,6,73,18,3,10,8,0,0,2,0
S01008411,Rented or living rent free: Total,30,14,12,3,9,0,2,16,7,0,0,9,0
S01008411,Rented or living rent free: Social rented,12,5,4,1,3,0,1,7,2,0,0,5,0
S01008411,Rented or living rent free: Private rented or living rent free,18,9,8,2,6,0,1,9,5,0,0,4,0
S01008412,All HRPs aged 16 and over,274,171,138,20,118,29,4,103,78,3,4,17,1
S01008412,Owned: Total,226,156,126,14,112,28,2,70,65,2,2,0,1
S01008412,Owned: Owned outright,112,47,36,9,27,9,2,65,62,2,0,0,1
S01008412,Owned: Owned with a mortgage or loan or shared ownership,114,109,90,5,85,19,0,5,3,0,2,0,0
S01008412,Rented or living rent free: Total,48,15,12,6,6,1,2,33,13,1,2,17,0
S01008412,Rented or living rent free: Social rented,31,8,6,3,3,0,2,23,9,1,2,11,0
S01008412,Rented or living rent free: Private rented or living rent free,17,7,6,3,3,1,0,10,4,0,0,6,0
S01008413,All HRPs aged 16 and over,222,139,104,22,82,29,6,83,58,1,2,20,2
S01008413,Owned: Total,161,112,83,18,65,27,2,49,45,0,2,2,0
S01008413,Owned: Owned outright,79,40,22,7,15,16,2,39,37,0,1,1,0
S01008413,Owned: Owned with a mortgage or loan or shared ownership,82,72,61,11,50,11,0,10,8,0,1,1,0
S01008413,Rented or living rent free: Total,61,27,21,4,17,2,4,34,13,1,0,18,2
S01008413,Rented or living rent free: Social rented,49,17,14,3,11,1,2,32,13,1,0,17,1
S01008413,Rented or living rent free: Private rented or living rent free,12,10,7,1,6,1,2,2,0,0,0,1,1
S01008414,All HRPs aged 16 and over,152,107,80,10,70,26,1,45,40,1,3,1,0
S01008414,Owned: Total,147,103,76,8,68,26,1,44,40,1,2,1,0
S01008414,Owned: Owned outright,78,36,25,4,21,11,0,42,40,1,0,1,0
S01008414,Owned: Owned with a mortgage or loan or shared ownership,69,67,51,4,47,15,1,2,0,0,2,0,0
S01008414,Rented or living rent free: Total,5,4,4,2,2,0,0,1,0,0,1,0,0
S01008414,Rented or living rent free: Social rented,1,0,0,0,0,0,0,1,0,0,1,0,0
S01008414,Rented or living rent free: Private rented or living rent free,4,4,4,2,2,0,0,0,0,0,0,0,0
S01008415,All HRPs aged 16 and over,347,243,195,35,160,37,11,104,81,1,8,12,2
S01008415,Owned: Total,292,205,164,22,142,32,9,87,72,1,4,9,1
S01008415,Owned: Owned outright,132,60,47,13,34,9,4,72,63,0,4,5,0
S01008415,Owned: Owned with a mortgage or loan or shared ownership,160,145,117,9,108,23,5,15,9,1,0,4,1
S01008415,Rented or living rent free: Total,55,38,31,13,18,5,2,17,9,0,4,3,1
S01008415,Rented or living rent free: Social rented,27,19,14,7,7,4,1,8,4,0,1,3,0
S01008415,Rented or living rent free: Private rented or living rent free,28,19,17,6,11,1,1,9,5,0,3,0,1
S01008416,All HRPs aged 16 and over,437,277,213,43,170,33,31,160,93,4,12,44,7
S01008416,Owned: Total,266,192,158,18,140,28,6,74,58,2,3,8,3
S01008416,Owned: Owned outright,100,46,32,8,24,11,3,54,47,2,0,3,2
S01008416,Owned: Owned with a mortgage or loan or shared ownership,166,146,126,10,116,17,3,20,11,0,3,5,1
S01008416,Rented or living rent free: Total,171,85,55,25,30,5,25,86,35,2,9,36,4
S01008416,Rented or living rent free: Social rented,134,63,40,17,23,3,20,71,31,0,4,34,2
S01008416,Rented or living rent free: Private rented or living rent free,37,22,15,8,7,2,5,15,4,2,5,2,2
S01008417,All HRPs aged 16 and over,299,205,157,28,129,44,4,94,86,1,0,4,3
S01008417,Owned: Total,262,179,144,25,119,33,2,83,81,0,0,1,1
S01008417,Owned: Owned outright,140,63,45,18,27,17,1,77,76,0,0,0,1
S01008417,Owned: Owned with a mortgage or loan or shared ownership,122,116,99,7,92,16,1,6,5,0,0,1,0
S01008417,Rented or living rent free: Total,37,26,13,3,10,11,2,11,5,1,0,3,2
S01008417,Rented or living rent free: Social rented,6,3,1,0,1,2,0,3,0,0,0,3,0
S01008417,Rented or living rent free: Private rented or living rent free,31,23,12,3,9,9,2,8,5,1,0,0,2
S01008418,All HRPs aged 16 and over,312,205,166,26,140,38,1,107,102,2,1,2,0
S01008418,Owned: Total,273,175,147,22,125,28,0,98,98,0,0,0,0
S01008418,Owned: Owned outright,155,64,54,12,42,10,0,91,91,0,0,0,0
S01008418,Owned: Owned with a mortgage or loan or shared ownership,118,111,93,10,83,18,0,7,7,0,0,0,0
S01008418,Rented or living rent free: Total,39,30,19,4,15,10,1,9,4,2,1,2,0
S01008418,Rented or living rent free: Social rented,4,2,2,1,1,0,0,2,0,1,0,1,0
S01008418,Rented or living rent free: Private rented or living rent free,35,28,17,3,14,10,1,7,4,1,1,1,0
S01008419,All HRPs aged 16 and over,193,137,103,12,91,32,2,56,46,0,4,5,1
S01008419,Owned: Total,141,119,88,9,79,30,1,22,21,0,0,0,1
S01008419,Owned: Owned outright,49,29,22,5,17,7,0,20,19,0,0,0,1
S01008419,Owned: Owned with a mortgage or loan or shared ownership,92,90,66,4,62,23,1,2,2,0,0,0,0
S01008419,Rented or living rent free: Total,52,18,15,3,12,2,1,34,25,0,4,5,0
S01008419,Rented or living rent free: Social rented,35,7,5,1,4,1,1,28,24,0,0,4,0
S01008419,Rented or living rent free: Private rented or living rent free,17,11,10,2,8,1,0,6,1,0,4,1,0
S01008420,All HRPs aged 16 and over,190,127,110,16,94,16,1,63,58,1,0,2,2
S01008420,Owned: Total,179,123,107,15,92,16,0,56,55,0,0,1,0
S01008420,Owned: Owned outright,97,47,40,10,30,7,0,50,50,0,0,0,0
S01008420,Owned: Owned with a mortgage or loan or shared ownership,82,76,67,5,62,9,0,6,5,0,0,1,0
S01008420,Rented or living rent free: Total,11,4,3,1,2,0,1,7,3,1,0,1,2
S01008420,Rented or living rent free: Social rented,4,0,0,0,0,0,0,4,3,0,0,1,0
S01008420,Rented or living rent free: Private rented or living rent free,7,4,3,1,2,0,1,3,0,1,0,0,2
S01008421,All HRPs aged 16 and over,394,265,228,36,192,29,8,129,99,3,4,16,7
S01008421,Owned: Total,291,212,185,21,164,25,2,79,73,0,0,4,2
S01008421,Owned: Owned outright,102,48,38,8,30,9,1,54,50,0,0,2,2
S01008421,Owned: Owned with a mortgage or loan or shared ownership,189,164,147,13,134,16,1,25,23,0,0,2,0
S01008421,Rented or living rent free: Total,103,53,43,15,28,4,6,50,26,3,4,12,5
S01008421,Rented or living rent free: Social rented,67,28,23,7,16,0,5,39,22,0,2,10,5
S01008421,Rented or living rent free: Private rented or living rent free,36,25,20,8,12,4,1,11,4,3,2,2,0
S01008422,All HRPs aged 16 and over,241,146,111,11,100,35,0,95,93,0,0,1,1
S01008422,Owned: Total,228,137,103,10,93,34,0,91,90,0,0,0,1
S01008422,Owned: Owned outright,135,52,37,5,32,15,0,83,82,0,0,0,1
S01008422,Owned: Owned with a mortgage or loan or shared ownership,93,85,66,5,61,19,0,8,8,0,0,0,0
S01008422,Rented or living rent free: Total,13,9,8,1,7,1,0,4,3,0,0,1,0
S01008422,Rented or living rent free: Social rented,2,1,1,1,0,0,0,1,0,0,0,1,0
S01008422,Rented or living rent free: Private rented or living rent free,11,8,7,0,7,1,0,3,3,0,0,0,0
S01008423,All HRPs aged 16 and over,398,276,205,13,192,64,7,122,108,1,4,8,1
S01008423,Owned: Total,341,235,176,11,165,55,4,106,100,1,3,1,1
S01008423,Owned: Owned outright,177,77,58,9,49,16,3,100,97,0,2,1,0
S01008423,Owned: Owned with a mortgage or loan or shared ownership,164,158,118,2,116,39,1,6,3,1,1,0,1
S01008423,Rented or living rent free: Total,57,41,29,2,27,9,3,16,8,0,1,7,0
S01008423,Rented or living rent free: Social rented,6,2,1,0,1,1,0,4,0,0,0,4,0
S01008423,Rented or living rent free: Private rented or living rent free,51,39,28,2,26,8,3,12,8,0,1,3,0
S01008424,All HRPs aged 16 and over,338,180,139,16,123,39,2,158,155,0,1,1,1
S01008424,Owned: Total,330,174,135,16,119,38,1,156,154,0,1,0,1
S01008424,Owned: Owned outright,216,71,49,15,34,21,1,145,144,0,0,0,1
S01008424,Owned: Owned with a mortgage or loan or shared ownership,114,103,86,1,85,17,0,11,10,0,1,0,0
S01008424,Rented or living rent free: Total,8,6,4,0,4,1,1,2,1,0,0,1,0
S01008424,Rented or living rent free: Social rented,2,1,0,0,0,1,0,1,0,0,0,1,0
S01008424,Rented or living rent free: Private rented or living rent free,6,5,4,0,4,0,1,1,1,0,0,0,0
S01008425,All HRPs aged 16 and over,409,254,200,23,177,47,7,155,147,1,0,6,1
S01008425,Owned: Total,367,223,178,21,157,43,2,144,141,0,0,2,1
S01008425,Owned: Owned outright,206,72,52,16,36,19,1,134,132,0,0,1,1
S01008425,Owned: Owned with a mortgage or loan or shared ownership,161,151,126,5,121,24,1,10,9,0,0,1,0
S01008425,Rented or living rent free: Total,42,31,22,2,20,4,5,11,6,1,0,4,0
S01008425,Rented or living rent free: Social rented,19,11,7,2,5,2,2,8,4,0,0,4,0
S01008425,Rented or living rent free: Private rented or living rent free,23,20,15,0,15,2,3,3,2,1,0,0,0
S01008426,All HRPs aged 16 and over,264,146,130,28,102,13,3,118,105,1,3,8,1
S01008426,Owned: Total,187,107,94,15,79,11,2,80,79,0,0,1,0
S01008426,Owned: Owned outright,106,34,30,8,22,3,1,72,72,0,0,0,0
S01008426,Owned: Owned with a mortgage or loan or shared ownership,81,73,64,7,57,8,1,8,7,0,0,1,0
S01008426,Rented or living rent free: Total,77,39,36,13,23,2,1,38,26,1,3,7,1
S01008426,Rented or living rent free: Social rented,52,21,19,5,14,2,0,31,23,0,1,6,1
S01008426,Rented or living rent free: Private rented or living rent free,25,18,17,8,9,0,1,7,3,1,2,1,0
S01008427,All HRPs aged 16 and over,397,335,282,26,256,51,2,62,56,3,1,0,2
S01008427,Owned: Total,375,317,266,22,244,49,2,58,53,2,1,0,2
S01008427,Owned: Owned outright,138,92,73,12,61,18,1,46,45,0,0,0,1
S01008427,Owned: Owned with a mortgage or loan or shared ownership,237,225,193,10,183,31,1,12,8,2,1,0,1
S01008427,Rented or living rent free: Total,22,18,16,4,12,2,0,4,3,1,0,0,0
S01008427,Rented or living rent free: Social rented,2,2,2,2,0,0,0,0,0,0,0,0,0
S01008427,Rented or living rent free: Private rented or living rent free,20,16,14,2,12,2,0,4,3,1,0,0,0
S01008428,All HRPs aged 16 and over,316,160,134,23,111,23,3,156,132,6,3,10,5
S01008428,Owned: Total,226,132,111,18,93,21,0,94,88,0,0,3,3
S01008428,Owned: Owned outright,111,30,22,5,17,8,0,81,77,0,0,2,2
S01008428,Owned: Owned with a mortgage or loan or shared ownership,115,102,89,13,76,13,0,13,11,0,0,1,1
S01008428,Rented or living rent free: Total,90,28,23,5,18,2,3,62,44,6,3,7,2
S01008428,Rented or living rent free: Social rented,73,21,17,4,13,1,3,52,40,1,2,7,2
S01008428,Rented or living rent free: Private rented or living rent free,17,7,6,1,5,1,0,10,4,5,1,0,0
S01008429,All HRPs aged 16 and over,352,203,169,25,144,33,1,149,137,2,6,4,0
S01008429,Owned: Total,331,192,158,21,137,33,1,139,134,0,4,1,0
S01008429,Owned: Owned outright,192,57,47,13,34,10,0,135,131,0,3,1,0
S01008429,Owned: Owned with a mortgage or loan or shared ownership,139,135,111,8,103,23,1,4,3,0,1,0,0
S01008429,Rented or living rent free: Total,21,11,11,4,7,0,0,10,3,2,2,3,0
S01008429,Rented or living rent free: Social rented,11,5,5,3,2,0,0,6,2,0,2,2,0
S01008429,Rented or living rent free: Private rented or living rent free,10,6,6,1,5,0,0,4,1,2,0,1,0
S01008430,All HRPs aged 16 and over,276,164,142,22,120,20,2,112,107,1,0,2,2
S01008430,Owned: Total,233,135,114,15,99,19,2,98,94,1,0,1,2
S01008430,Owned: Owned outright,129,38,30,9,21,7,1,91,88,0,0,1,2
S01008430,Owned: Owned with a mortgage or loan or shared ownership,104,97,84,6,78,12,1,7,6,1,0,0,0
S01008430,Rented or living rent free: Total,43,29,28,7,21,1,0,14,13,0,0,1,0
S01008430,Rented or living rent free: Social rented,17,8,8,3,5,0,0,9,8,0,0,1,0
S01008430,Rented or living rent free: Private rented or living rent free,26,21,20,4,16,1,0,5,5,0,0,0,0
S01008431,All HRPs aged 16 and over,352,198,169,20,149,27,2,154,127,2,4,16,5
S01008431,Owned: Total,304,175,150,18,132,23,2,129,121,1,3,2,2
S01008431,Owned: Owned outright,180,57,45,12,33,11,1,123,119,0,3,1,0
S01008431,Owned: Owned with a mortgage or loan or shared ownership,124,118,105,6,99,12,1,6,2,1,0,1,2
S01008431,Rented or living rent free: Total,48,23,19,2,17,4,0,25,6,1,1,14,3
S01008431,Rented or living rent free: Social rented,42,19,17,2,15,2,0,23,5,1,0,14,3
S01008431,Rented or living rent free: Private rented or living rent free,6,4,2,0,2,2,0,2,1,0,1,0,0
S01008432,All HRPs aged 16 and over,293,165,130,19,111,31,4,128,122,0,3,3,0
S01008432,Owned: Total,274,153,122,18,104,27,4,121,118,0,1,2,0
S01008432,Owned: Owned outright,167,53,42,10,32,8,3,114,112,0,0,2,0
S01008432,Owned: Owned with a mortgage or loan or shared ownership,107,100,80,8,72,19,1,7,6,0,1,0,0
S01008432,Rented or living rent free: Total,19,12,8,1,7,4,0,7,4,0,2,1,0
S01008432,Rented or living rent free: Social rented,9,5,4,1,3,1,0,4,3,0,0,1,0
S01008432,Rented or living rent free: Private rented or living rent free,10,7,4,0,4,3,0,3,1,0,2,0,0
S01008433,All HRPs aged 16 and over,348,249,206,32,174,42,1,99,95,1,0,3,0
S01008433,Owned: Total,328,235,193,26,167,41,1,93,93,0,0,0,0
S01008433,Owned: Owned outright,171,85,68,15,53,16,1,86,86,0,0,0,0
S01008433,Owned: Owned with a mortgage or loan or shared ownership,157,150,125,11,114,25,0,7,7,0,0,0,0
S01008433,Rented or living rent free: Total,20,14,13,6,7,1,0,6,2,1,0,3,0
S01008433,Rented or living rent free: Social rented,6,4,4,1,3,0,0,2,1,0,0,1,0
S01008433,Rented or living rent free: Private rented or living rent free,14,10,9,5,4,1,0,4,1,1,0,2,0
S01008434,All HRPs aged 16 and over,322,231,196,27,169,31,4,91,83,1,2,3,2
S01008434,Owned: Total,302,218,186,23,163,29,3,84,82,0,0,1,1
S01008434,Owned: Owned outright,154,81,69,15,54,10,2,73,71,0,0,1,1
S01008434,Owned: Owned with a mortgage or loan or shared ownership,148,137,117,8,109,19,1,11,11,0,0,0,0
S01008434,Rented or living rent free: Total,20,13,10,4,6,2,1,7,1,1,2,2,1
S01008434,Rented or living rent free: Social rented,10,5,4,1,3,1,0,5,1,0,2,2,0
S01008434,Rented or living rent free: Private rented or living rent free,10,8,6,3,3,1,1,2,0,1,0,0,1
S01008435,All HRPs aged 16 and over,301,187,157,24,133,29,1,114,108,4,0,1,1
S01008435,Owned: Total,286,175,148,20,128,26,1,111,107,2,0,1,1
S01008435,Owned: Owned outright,162,57,48,13,35,9,0,105,103,0,0,1,1
S01008435,Owned: Owned with a mortgage or loan or shared ownership,124,118,100,7,93,17,1,6,4,2,0,0,0
S01008435,Rented or living rent free: Total,15,12,9,4,5,3,0,3,1,2,0,0,0
S01008435,Rented or living rent free: Social rented,4,4,3,1,2,1,0,0,0,0,0,0,0
S01008435,Rented or living rent free: Private rented or living rent free,11,8,6,3,3,2,0,3,1,2,0,0,0
S01008436,All HRPs aged 16 and over,356,233,184,26,158,45,4,123,114,0,4,3,2
S01008436,Owned: Total,320,207,161,22,139,42,4,113,108,0,2,1,2
S01008436,Owned: Owned outright,168,66,49,15,34,15,2,102,99,0,1,1,1
S01008436,Owned: Owned with a mortgage or loan or shared ownership,152,141,112,7,105,27,2,11,9,0,1,0,1
S01008436,Rented or living rent free: Total,36,26,23,4,19,3,0,10,6,0,2,2,0
S01008436,Rented or living rent free: Social rented,9,3,3,1,2,0,0,6,4,0,1,1,0
S01008436,Rented or living rent free: Private rented or living rent free,27,23,20,3,17,3,0,4,2,0,1,1,0
S01008437,All HRPs aged 16 and over,367,225,184,28,156,36,5,142,129,3,2,8,0
S01008437,Owned: Total,247,165,137,19,118,27,1,82,79,1,1,1,0
S01008437,Owned: Owned outright,138,60,49,13,36,11,0,78,76,0,1,1,0
S01008437,Owned: Owned with a mortgage or loan or shared ownership,109,105,88,6,82,16,1,4,3,1,0,0,0
S01008437,Rented or living rent free: Total,120,60,47,9,38,9,4,60,50,2,1,7,0
S01008437,Rented or living rent free: Social rented,58,9,8,4,4,0,1,49,44,0,0,5,0
S01008437,Rented or living rent free: Private rented or living rent free,62,51,39,5,34,9,3,11,6,2,1,2,0
S01008438,All HRPs aged 16 and over,189,149,119,18,101,29,1,40,33,2,0,2,3
S01008438,Owned: Total,139,110,89,11,78,21,0,29,27,0,0,0,2
S01008438,Owned: Owned outright,57,32,22,5,17,10,0,25,23,0,0,0,2
S01008438,Owned: Owned with a mortgage or loan or shared ownership,82,78,67,6,61,11,0,4,4,0,0,0,0
S01008438,Rented or living rent free: Total,50,39,30,7,23,8,1,11,6,2,0,2,1
S01008438,Rented or living rent free: Social rented,5,2,1,0,1,1,0,3,2,0,0,1,0
S01008438,Rented or living rent free: Private rented or living rent free,45,37,29,7,22,7,1,8,4,2,0,1,1
S01008439,All HRPs aged 16 and over,434,316,260,32,228,55,1,118,109,0,4,2,3
S01008439,Owned: Total,407,298,243,29,214,54,1,109,104,0,2,1,2
S01008439,Owned: Owned outright,220,121,95,18,77,26,0,99,96,0,2,0,1
S01008439,Owned: Owned with a mortgage or loan or shared ownership,187,177,148,11,137,28,1,10,8,0,0,1,1
S01008439,Rented or living rent free: Total,27,18,17,3,14,1,0,9,5,0,2,1,1
S01008439,Rented or living rent free: Social rented,2,1,1,0,1,0,0,1,0,0,0,1,0
S01008439,Rented or living rent free: Private rented or living rent free,25,17,16,3,13,1,0,8,5,0,2,0,1
S01008440,All HRPs aged 16 and over,403,261,200,23,177,58,3,142,141,0,0,0,1
S01008440,Owned: Total,370,243,186,22,164,56,1,127,126,0,0,0,1
S01008440,Owned: Owned outright,229,110,79,18,61,30,1,119,118,0,0,0,1
S01008440,Owned: Owned with a mortgage or loan or shared ownership,141,133,107,4,103,26,0,8,8,0,0,0,0
S01008440,Rented or living rent free: Total,33,18,14,1,13,2,2,15,15,0,0,0,0
S01008440,Rented or living rent free: Social rented,17,3,2,0,2,1,0,14,14,0,0,0,0
S01008440,Rented or living rent free: Private rented or living rent free,16,15,12,1,11,1,2,1,1,0,0,0,0
S01008441,All HRPs aged 16 and over,186,124,94,11,83,29,1,62,60,0,2,0,0
S01008441,Owned: Total,181,121,92,11,81,28,1,60,58,0,2,0,0
S01008441,Owned: Owned outright,96,40,26,4,22,14,0,56,54,0,2,0,0
S01008441,Owned: Owned with a mortgage or loan or shared ownership,85,81,66,7,59,14,1,4,4,0,0,0,0
S01008441,Rented or living rent free: Total,5,3,2,0,2,1,0,2,2,0,0,0,0
S01008441,Rented or living rent free: Social rented,1,0,0,0,0,0,0,1,1,0,0,0,0
S01008441,Rented or living rent free: Private rented or living rent free,4,3,2,0,2,1,0,1,1,0,0,0,0
S01008442,All HRPs aged 16 and over,303,235,190,22,168,42,3,68,59,0,4,3,2
S01008442,Owned: Total,258,201,165,17,148,36,0,57,53,0,2,1,1
S01008442,Owned: Owned outright,99,51,43,13,30,8,0,48,45,0,2,1,0
S01008442,Owned: Owned with a mortgage or loan or shared ownership,159,150,122,4,118,28,0,9,8,0,0,0,1
S01008442,Rented or living rent free: Total,45,34,25,5,20,6,3,11,6,0,2,2,1
S01008442,Rented or living rent free: Social rented,3,1,0,0,0,1,0,2,0,0,0,2,0
S01008442,Rented or living rent free: Private rented or living rent free,42,33,25,5,20,5,3,9,6,0,2,0,1
S01008443,All HRPs aged 16 and over,252,158,117,11,106,34,7,94,86,0,3,4,1
S01008443,Owned: Total,227,142,107,6,101,31,4,85,82,0,1,2,0
S01008443,Owned: Owned outright,141,63,43,5,38,18,2,78,76,0,1,1,0
S01008443,Owned: Owned with a mortgage or loan or shared ownership,86,79,64,1,63,13,2,7,6,0,0,1,0
S01008443,Rented or living rent free: Total,25,16,10,5,5,3,3,9,4,0,2,2,1
S01008443,Rented or living rent free: Social rented,13,8,6,4,2,0,2,5,2,0,0,2,1
S01008443,Rented or living rent free: Private rented or living rent free,12,8,4,1,3,3,1,4,2,0,2,0,0
S01008444,All HRPs aged 16 and over,260,194,157,13,144,34,3,66,55,4,3,3,1
S01008444,Owned: Total,187,133,104,6,98,27,2,54,52,1,0,1,0
S01008444,Owned: Owned outright,90,38,31,6,25,6,1,52,51,0,0,1,0
S01008444,Owned: Owned with a mortgage or loan or shared ownership,97,95,73,0,73,21,1,2,1,1,0,0,0
S01008444,Rented or living rent free: Total,73,61,53,7,46,7,1,12,3,3,3,2,1
S01008444,Rented or living rent free: Social rented,8,4,1,0,1,2,1,4,1,0,0,2,1
S01008444,Rented or living rent free: Private rented or living rent free,65,57,52,7,45,5,0,8,2,3,3,0,0
S01008445,All HRPs aged 16 and over,403,179,155,14,141,23,1,224,200,2,3,13,6
S01008445,Owned: Total,132,77,57,4,53,20,0,55,54,0,0,1,0
S01008445,Owned: Owned outright,70,27,19,2,17,8,0,43,42,0,0,1,0
S01008445,Owned: Owned with a mortgage or loan or shared ownership,62,50,38,2,36,12,0,12,12,0,0,0,0
S01008445,Rented or living rent free: Total,271,102,98,10,88,3,1,169,146,2,3,12,6
S01008445,Rented or living rent free: Social rented,171,22,20,8,12,1,1,149,136,0,0,9,4
S01008445,Rented or living rent free: Private rented or living rent free,100,80,78,2,76,2,0,20,10,2,3,3,2
S01008446,All HRPs aged 16 and over,323,203,151,13,138,50,2,120,118,0,1,1,0
S01008446,Owned: Total,304,189,144,12,132,45,0,115,114,0,1,0,0
S01008446,Owned: Owned outright,167,58,44,11,33,14,0,109,108,0,1,0,0
S01008446,Owned: Owned with a mortgage or loan or shared ownership,137,131,100,1,99,31,0,6,6,0,0,0,0
S01008446,Rented or living rent free: Total,19,14,7,1,6,5,2,5,4,0,0,1,0
S01008446,Rented or living rent free: Social rented,2,1,1,0,1,0,0,1,1,0,0,0,0
S01008446,Rented or living rent free: Private rented or living rent free,17,13,6,1,5,5,2,4,3,0,0,1,0
S01008447,All HRPs aged 16 and over,286,189,138,15,123,47,4,97,91,1,5,0,0
S01008447,Owned: Total,261,172,125,13,112,44,3,89,86,1,2,0,0
S01008447,Owned: Owned outright,135,54,33,7,26,19,2,81,79,1,1,0,0
S01008447,Owned: Owned with a mortgage or loan or shared ownership,126,118,92,6,86,25,1,8,7,0,1,0,0
S01008447,Rented or living rent free: Total,25,17,13,2,11,3,1,8,5,0,3,0,0
S01008447,Rented or living rent free: Social rented,3,2,1,1,0,1,0,1,1,0,0,0,0
S01008447,Rented or living rent free: Private rented or living rent free,22,15,12,1,11,2,1,7,4,0,3,0,0
S01008448,All HRPs aged 16 and over,315,200,146,21,125,50,4,115,105,4,2,4,0
S01008448,Owned: Total,281,178,130,15,115,46,2,103,101,0,1,1,0
S01008448,Owned: Owned outright,156,59,38,11,27,20,1,97,95,0,1,1,0
S01008448,Owned: Owned with a mortgage or loan or shared ownership,125,119,92,4,88,26,1,6,6,0,0,0,0
S01008448,Rented or living rent free: Total,34,22,16,6,10,4,2,12,4,4,1,3,0
S01008448,Rented or living rent free: Social rented,14,6,3,1,2,2,1,8,3,3,0,2,0
S01008448,Rented or living rent free: Private rented or living rent free,20,16,13,5,8,2,1,4,1,1,1,1,0
S01008449,All HRPs aged 16 and over,351,232,166,40,126,22,44,119,45,8,20,38,8
S01008449,Owned: Total,80,59,41,4,37,13,5,21,17,1,2,1,0
S01008449,Owned: Owned outright,22,7,5,2,3,1,1,15,14,0,1,0,0
S01008449,Owned: Owned with a mortgage or loan or shared ownership,58,52,36,2,34,12,4,6,3,1,1,1,0
S01008449,Rented or living rent free: Total,271,173,125,36,89,9,39,98,28,7,18,37,8
S01008449,Rented or living rent free: Social rented,242,155,108,33,75,8,39,87,25,6,15,35,6
S01008449,Rented or living rent free: Private rented or living rent free,29,18,17,3,14,1,0,11,3,1,3,2,2
S01008450,All HRPs aged 16 and over,256,167,140,51,89,13,14,89,31,3,26,19,10
S01008450,Owned: Total,57,48,40,7,33,8,0,9,7,0,0,1,1
S01008450,Owned: Owned outright,11,7,7,2,5,0,0,4,4,0,0,0,0
S01008450,Owned: Owned with a mortgage or loan or shared ownership,46,41,33,5,28,8,0,5,3,0,0,1,1
S01008450,Rented or living rent free: Total,199,119,100,44,56,5,14,80,24,3,26,18,9
S01008450,Rented or living rent free: Social rented,167,97,82,38,44,1,14,70,22,2,23,17,6
S01008450,Rented or living rent free: Private rented or living rent free,32,22,18,6,12,4,0,10,2,1,3,1,3
S01008451,All HRPs aged 16 and over,325,196,133,48,85,11,52,129,29,13,20,49,18
S01008451,Owned: Total,32,30,26,5,21,4,0,2,1,1,0,0,0
S01008451,Owned: Owned outright,6,4,3,0,3,1,0,2,1,1,0,0,0
S01008451,Owned: Owned with a mortgage or loan or shared ownership,26,26,23,5,18,3,0,0,0,0,0,0,0
S01008451,Rented or living rent free: Total,293,166,107,43,64,7,52,127,28,12,20,49,18
S01008451,Rented or living rent free: Social rented,279,156,99,41,58,7,50,123,28,10,18,49,18
S01008451,Rented or living rent free: Private rented or living rent free,14,10,8,2,6,0,2,4,0,2,2,0,0
S01008452,All HRPs aged 16 and over,271,182,140,40,100,19,23,89,24,8,14,21,22
S01008452,Owned: Total,29,26,20,2,18,4,2,3,2,0,0,0,1
S01008452,Owned: Owned outright,7,6,5,0,5,1,0,1,1,0,0,0,0
S01008452,Owned: Owned with a mortgage or loan or shared ownership,22,20,15,2,13,3,2,2,1,0,0,0,1
S01008452,Rented or living rent free: Total,242,156,120,38,82,15,21,86,22,8,14,21,21
S01008452,Rented or living rent free: Social rented,217,137,107,34,73,9,21,80,20,8,14,19,19
S01008452,Rented or living rent free: Private rented or living rent free,25,19,13,4,9,6,0,6,2,0,0,2,2
S01008453,All HRPs aged 16 and over,215,175,143,21,122,20,12,40,7,5,11,11,6
S01008453,Owned: Total,59,55,50,1,49,5,0,4,2,1,0,0,1
S01008453,Owned: Owned outright,9,9,8,1,7,1,0,0,0,0,0,0,0
S01008453,Owned: Owned with a mortgage or loan or shared ownership,50,46,42,0,42,4,0,4,2,1,0,0,1
S01008453,Rented or living rent free: Total,156,120,93,20,73,15,12,36,5,4,11,11,5
S01008453,Rented or living rent free: Social rented,128,93,71,11,60,10,12,35,5,3,11,11,5
S01008453,Rented or living rent free: Private rented or living rent free,28,27,22,9,13,5,0,1,0,1,0,0,0
S01008454,All HRPs aged 16 and over,393,259,206,67,139,16,37,134,33,4,37,50,10
S01008454,Owned: Total,77,68,61,7,54,6,1,9,7,0,0,2,0
S01008454,Owned: Owned outright,19,13,10,2,8,3,0,6,6,0,0,0,0
S01008454,Owned: Owned with a mortgage or loan or shared ownership,58,55,51,5,46,3,1,3,1,0,0,2,0
S01008454,Rented or living rent free: Total,316,191,145,60,85,10,36,125,26,4,37,48,10
S01008454,Rented or living rent free: Social rented,293,176,135,56,79,7,34,117,25,3,32,47,10
S01008454,Rented or living rent free: Private rented or living rent free,23,15,10,4,6,3,2,8,1,1,5,1,0
S01008455,All HRPs aged 16 and over,501,296,229,61,168,23,44,205,87,21,30,50,17
S01008455,Owned: Total,147,100,88,20,68,8,4,47,42,0,2,3,0
S01008455,Owned: Owned outright,59,19,17,6,11,0,2,40,37,0,0,3,0
S01008455,Owned: Owned with a mortgage or loan or shared ownership,88,81,71,14,57,8,2,7,5,0,2,0,0
S01008455,Rented or living rent free: Total,354,196,141,41,100,15,40,158,45,21,28,47,17
S01008455,Rented or living rent free: Social rented,275,147,101,32,69,12,34,128,44,10,21,39,14
S01008455,Rented or living rent free: Private rented or living rent free,79,49,40,9,31,3,6,30,1,11,7,8,3
S01008456,All HRPs aged 16 and over,528,330,235,81,154,26,69,198,70,14,27,53,34
S01008456,Owned: Total,137,99,83,15,68,15,1,38,29,0,0,6,3
S01008456,Owned: Owned outright,59,28,22,6,16,6,0,31,27,0,0,1,3
S01008456,Owned: Owned with a mortgage or loan or shared ownership,78,71,61,9,52,9,1,7,2,0,0,5,0
S01008456,Rented or living rent free: Total,391,231,152,66,86,11,68,160,41,14,27,47,31
S01008456,Rented or living rent free: Social rented,337,202,129,56,73,9,64,135,38,6,22,42,27
S01008456,Rented or living rent free: Private rented or living rent free,54,29,23,10,13,2,4,25,3,8,5,5,4
S01008457,All HRPs aged 16 and over,353,174,146,31,115,7,21,179,113,6,17,39,4
S01008457,Owned: Total,142,93,82,11,71,4,7,49,46,0,3,0,0
S01008457,Owned: Owned outright,69,26,25,7,18,0,1,43,42,0,1,0,0
S01008457,Owned: Owned with a mortgage or loan or shared ownership,73,67,57,4,53,4,6,6,4,0,2,0,0
S01008457,Rented or living rent free: Total,211,81,64,20,44,3,14,130,67,6,14,39,4
S01008457,Rented or living rent free: Social rented,168,57,43,15,28,1,13,111,64,0,7,37,3
S01008457,Rented or living rent free: Private rented or living rent free,43,24,21,5,16,2,1,19,3,6,7,2,1
S01008458,All HRPs aged 16 and over,428,290,238,36,202,26,26,138,76,8,27,21,6
S01008458,Owned: Total,243,189,167,22,145,16,6,54,46,0,3,3,2
S01008458,Owned: Owned outright,100,57,47,11,36,7,3,43,40,0,1,1,1
S01008458,Owned: Owned with a mortgage or loan or shared ownership,143,132,120,11,109,9,3,11,6,0,2,2,1
S01008458,Rented or living rent free: Total,185,101,71,14,57,10,20,84,30,8,24,18,4
S01008458,Rented or living rent free: Social rented,120,62,42,9,33,5,15,58,22,3,13,17,3
S01008458,Rented or living rent free: Private rented or living rent free,65,39,29,5,24,5,5,26,8,5,11,1,1
S01008459,All HRPs aged 16 and over,393,250,173,39,134,17,60,143,52,8,23,55,5
S01008459,Owned: Total,105,79,71,7,64,7,1,26,20,2,2,2,0
S01008459,Owned: Owned outright,40,22,19,3,16,3,0,18,17,0,0,1,0
S01008459,Owned: Owned with a mortgage or loan or shared ownership,65,57,52,4,48,4,1,8,3,2,2,1,0
S01008459,Rented or living rent free: Total,288,171,102,32,70,10,59,117,32,6,21,53,5
S01008459,Rented or living rent free: Social rented,250,147,88,28,60,8,51,103,32,1,18,49,3
S01008459,Rented or living rent free: Private rented or living rent free,38,24,14,4,10,2,8,14,0,5,3,4,2
S01008460,All HRPs aged 16 and over,368,221,160,48,112,7,54,147,37,9,46,40,15
S01008460,Owned: Total,65,46,43,8,35,2,1,19,11,0,2,4,2
S01008460,Owned: Owned outright,26,12,10,2,8,1,1,14,10,0,0,2,2
S01008460,Owned: Owned with a mortgage or loan or shared ownership,39,34,33,6,27,1,0,5,1,0,2,2,0
S01008460,Rented or living rent free: Total,303,175,117,40,77,5,53,128,26,9,44,36,13
S01008460,Rented or living rent free: Social rented,272,154,100,34,66,4,50,118,25,8,36,36,13
S01008460,Rented or living rent free: Private rented or living rent free,31,21,17,6,11,1,3,10,1,1,8,0,0
S01008461,All HRPs aged 16 and over,449,289,220,53,167,15,54,160,49,11,38,42,20
S01008461,Owned: Total,118,85,75,6,69,8,2,33,25,1,1,4,2
S01008461,Owned: Owned outright,54,26,22,5,17,3,1,28,23,0,1,2,2
S01008461,Owned: Owned with a mortgage or loan or shared ownership,64,59,53,1,52,5,1,5,2,1,0,2,0
S01008461,Rented or living rent free: Total,331,204,145,47,98,7,52,127,24,10,37,38,18
S01008461,Rented or living rent free: Social rented,302,187,131,44,87,6,50,115,23,6,34,36,16
S01008461,Rented or living rent free: Private rented or living rent free,29,17,14,3,11,1,2,12,1,4,3,2,2
S01008462,All HRPs aged 16 and over,349,170,125,29,96,11,34,179,85,5,14,60,15
S01008462,Owned: Total,34,18,15,4,11,2,1,16,14,0,0,2,0
S01008462,Owned: Owned outright,28,14,11,4,7,2,1,14,13,0,0,1,0
S01008462,Owned: Owned with a mortgage or loan or shared ownership,6,4,4,0,4,0,0,2,1,0,0,1,0
S01008462,Rented or living rent free: Total,315,152,110,25,85,9,33,163,71,5,14,58,15
S01008462,Rented or living rent free: Social rented,308,151,109,25,84,9,33,157,71,1,12,58,15
S01008462,Rented or living rent free: Private rented or living rent free,7,1,1,0,1,0,0,6,0,4,2,0,0
S01008463,All HRPs aged 16 and over,355,220,163,39,124,17,40,135,46,9,26,42,12
S01008463,Owned: Total,100,72,65,13,52,5,2,28,21,1,1,5,0
S01008463,Owned: Owned outright,38,16,15,5,10,1,0,22,20,0,1,1,0
S01008463,Owned: Owned with a mortgage or loan or shared ownership,62,56,50,8,42,4,2,6,1,1,0,4,0
S01008463,Rented or living rent free: Total,255,148,98,26,72,12,38,107,25,8,25,37,12
S01008463,Rented or living rent free: Social rented,223,128,80,24,56,12,36,95,22,6,19,37,11
S01008463,Rented or living rent free: Private rented or living rent free,32,20,18,2,16,0,2,12,3,2,6,0,1
S01008464,All HRPs aged 16 and over,413,271,239,40,199,20,12,142,100,6,27,3,6
S01008464,Owned: Total,321,231,206,32,174,18,7,90,85,0,1,0,4
S01008464,Owned: Owned outright,128,50,40,13,27,5,5,78,73,0,1,0,4
S01008464,Owned: Owned with a mortgage or loan or shared ownership,193,181,166,19,147,13,2,12,12,0,0,0,0
S01008464,Rented or living rent free: Total,92,40,33,8,25,2,5,52,15,6,26,3,2
S01008464,Rented or living rent free: Social rented,11,8,5,2,3,1,2,3,0,0,1,1,1
S01008464,Rented or living rent free: Private rented or living rent free,81,32,28,6,22,1,3,49,15,6,25,2,1
S01008465,All HRPs aged 16 and over,346,238,204,37,167,24,10,108,79,12,7,4,6
S01008465,Owned: Total,238,173,151,16,135,20,2,65,62,0,0,1,2
S01008465,Owned: Owned outright,101,39,30,6,24,7,2,62,60,0,0,0,2
S01008465,Owned: Owned with a mortgage or loan or shared ownership,137,134,121,10,111,13,0,3,2,0,0,1,0
S01008465,Rented or living rent free: Total,108,65,53,21,32,4,8,43,17,12,7,3,4
S01008465,Rented or living rent free: Social rented,16,8,4,1,3,2,2,8,4,0,1,0,3
S01008465,Rented or living rent free: Private rented or living rent free,92,57,49,20,29,2,6,35,13,12,6,3,1
S01008466,All HRPs aged 16 and over,318,220,191,43,148,15,14,98,59,17,10,5,7
S01008466,Owned: Total,217,167,151,28,123,11,5,50,46,1,0,1,2
S01008466,Owned: Owned outright,83,40,35,11,24,3,2,43,41,0,0,1,1
S01008466,Owned: Owned with a mortgage or loan or shared ownership,134,127,116,17,99,8,3,7,5,1,0,0,1
S01008466,Rented or living rent free: Total,101,53,40,15,25,4,9,48,13,16,10,4,5
S01008466,Rented or living rent free: Social rented,12,7,3,2,1,0,4,5,1,1,0,3,0
S01008466,Rented or living rent free: Private rented or living rent free,89,46,37,13,24,4,5,43,12,15,10,1,5
S01008467,All HRPs aged 16 and over,330,209,169,31,138,26,14,121,85,6,15,10,5
S01008467,Owned: Total,255,171,143,16,127,25,3,84,79,0,1,1,3
S01008467,Owned: Owned outright,114,40,37,11,26,3,0,74,70,0,0,1,3
S01008467,Owned: Owned with a mortgage or loan or shared ownership,141,131,106,5,101,22,3,10,9,0,1,0,0
S01008467,Rented or living rent free: Total,75,38,26,15,11,1,11,37,6,6,14,9,2
S01008467,Rented or living rent free: Social rented,9,5,2,1,1,1,2,4,1,0,0,3,0
S01008467,Rented or living rent free: Private rented or living rent free,66,33,24,14,10,0,9,33,5,6,14,6,2
S01008468,All HRPs aged 16 and over,232,135,112,25,87,15,8,97,48,9,23,12,5
S01008468,Owned: Total,138,94,78,11,67,13,3,44,39,1,0,1,3
S01008468,Owned: Owned outright,55,18,14,6,8,3,1,37,33,1,0,1,2
S01008468,Owned: Owned with a mortgage or loan or shared ownership,83,76,64,5,59,10,2,7,6,0,0,0,1
S01008468,Rented or living rent free: Total,94,41,34,14,20,2,5,53,9,8,23,11,2
S01008468,Rented or living rent free: Social rented,62,27,24,12,12,1,2,35,6,1,15,11,2
S01008468,Rented or living rent free: Private rented or living rent free,32,14,10,2,8,1,3,18,3,7,8,0,0
S01008469,All HRPs aged 16 and over,229,155,135,27,108,17,3,74,50,17,5,2,0
S01008469,Owned: Total,152,116,99,14,85,15,2,36,36,0,0,0,0
S01008469,Owned: Owned outright,46,16,13,5,8,3,0,30,30,0,0,0,0
S01008469,Owned: Owned with a mortgage or loan or shared ownership,106,100,86,9,77,12,2,6,6,0,0,0,0
S01008469,Rented or living rent free: Total,77,39,36,13,23,2,1,38,14,17,5,2,0
S01008469,Rented or living rent free: Social rented,32,13,12,7,5,0,1,19,14,0,4,1,0
S01008469,Rented or living rent free: Private rented or living rent free,45,26,24,6,18,2,0,19,0,17,1,1,0
S01008470,All HRPs aged 16 and over,298,172,138,32,106,13,21,126,75,3,17,20,11
S01008470,Owned: Total,113,83,72,14,58,7,4,30,25,0,3,1,1
S01008470,Owned: Owned outright,47,23,21,6,15,2,0,24,23,0,0,1,0
S01008470,Owned: Owned with a mortgage or loan or shared ownership,66,60,51,8,43,5,4,6,2,0,3,0,1
S01008470,Rented or living rent free: Total,185,89,66,18,48,6,17,96,50,3,14,19,10
S01008470,Rented or living rent free: Social rented,147,67,48,15,33,5,14,80,46,1,8,17,8
S01008470,Rented or living rent free: Private rented or living rent free,38,22,18,3,15,1,3,16,4,2,6,2,2
S01008471,All HRPs aged 16 and over,347,219,182,54,128,15,22,128,46,4,38,33,7
S01008471,Owned: Total,75,62,60,8,52,2,0,13,10,0,1,1,1
S01008471,Owned: Owned outright,24,13,13,4,9,0,0,11,8,0,1,1,1
S01008471,Owned: Owned with a mortgage or loan or shared ownership,51,49,47,4,43,2,0,2,2,0,0,0,0
S01008471,Rented or living rent free: Total,272,157,122,46,76,13,22,115,36,4,37,32,6
S01008471,Rented or living rent free: Social rented,235,131,102,42,60,11,18,104,36,2,29,31,6
S01008471,Rented or living rent free: Private rented or living rent free,37,26,20,4,16,2,4,11,0,2,8,1,0
S01008472,All HRPs aged 16 and over,277,175,142,24,118,20,13,102,52,14,14,17,5
S01008472,Owned: Total,146,109,93,11,82,15,1,37,32,1,0,2,2
S01008472,Owned: Owned outright,56,25,24,5,19,1,0,31,27,0,0,2,2
S01008472,Owned: Owned with a mortgage or loan or shared ownership,90,84,69,6,63,14,1,6,5,1,0,0,0
S01008472,Rented or living rent free: Total,131,66,49,13,36,5,12,65,20,13,14,15,3
S01008472,Rented or living rent free: Social rented,80,39,33,9,24,1,5,41,17,0,9,14,1
S01008472,Rented or living rent free: Private rented or living rent free,51,27,16,4,12,4,7,24,3,13,5,1,2
S01008473,All HRPs aged 16 and over,307,190,165,41,124,15,10,117,64,13,12,19,9
S01008473,Owned: Total,130,93,88,15,73,5,0,37,33,0,1,0,3
S01008473,Owned: Owned outright,47,19,17,6,11,2,0,28,25,0,1,0,2
S01008473,Owned: Owned with a mortgage or loan or shared ownership,83,74,71,9,62,3,0,9,8,0,0,0,1
S01008473,Rented or living rent free: Total,177,97,77,26,51,10,10,80,31,13,11,19,6
S01008473,Rented or living rent free: Social rented,127,64,48,20,28,7,9,63,31,4,7,17,4
S01008473,Rented or living rent free: Private rented or living rent free,50,33,29,6,23,3,1,17,0,9,4,2,2
S01008474,All HRPs aged 16 and over,440,233,195,36,159,12,26,207,125,7,17,44,14
S01008474,Owned: Total,147,98,93,12,81,4,1,49,46,0,0,2,1
S01008474,Owned: Owned outright,56,13,12,5,7,1,0,43,43,0,0,0,0
S01008474,Owned: Owned with a mortgage or loan or shared ownership,91,85,81,7,74,3,1,6,3,0,0,2,1
S01008474,Rented or living rent free: Total,293,135,102,24,78,8,25,158,79,7,17,42,13
S01008474,Rented or living rent free: Social rented,214,81,63,17,46,5,13,133,72,1,13,37,10
S01008474,Rented or living rent free: Private rented or living rent free,79,54,39,7,32,3,12,25,7,6,4,5,3
S01008475,All HRPs aged 16 and over,327,173,149,32,117,11,13,154,106,6,13,27,2
S01008475,Owned: Total,163,90,82,9,73,6,2,73,67,1,0,5,0
S01008475,Owned: Owned outright,81,16,14,2,12,1,1,65,60,1,0,4,0
S01008475,Owned: Owned with a mortgage or loan or shared ownership,82,74,68,7,61,5,1,8,7,0,0,1,0
S01008475,Rented or living rent free: Total,164,83,67,23,44,5,11,81,39,5,13,22,2
S01008475,Rented or living rent free: Social rented,86,33,29,11,18,1,3,53,27,1,5,18,2
S01008475,Rented or living rent free: Private rented or living rent free,78,50,38,12,26,4,8,28,12,4,8,4,0
S01008476,All HRPs aged 16 and over,406,221,187,36,151,19,15,185,128,5,4,37,11
S01008476,Owned: Total,210,119,104,19,85,13,2,91,84,0,1,3,3
S01008476,Owned: Owned outright,99,26,21,9,12,4,1,73,68,0,1,2,2
S01008476,Owned: Owned with a mortgage or loan or shared ownership,111,93,83,10,73,9,1,18,16,0,0,1,1
S01008476,Rented or living rent free: Total,196,102,83,17,66,6,13,94,44,5,3,34,8
S01008476,Rented or living rent free: Social rented,125,49,44,10,34,0,5,76,39,3,0,29,5
S01008476,Rented or living rent free: Private rented or living rent free,71,53,39,7,32,6,8,18,5,2,3,5,3
S01008477,All HRPs aged 16 and over,465,259,227,42,185,18,14,206,136,2,11,44,13
S01008477,Owned: Total,249,156,142,19,123,9,5,93,81,2,1,6,3
S01008477,Owned: Owned outright,114,41,39,13,26,1,1,73,69,0,1,1,2
S01008477,Owned: Owned with a mortgage or loan or shared ownership,135,115,103,6,97,8,4,20,12,2,0,5,1
S01008477,Rented or living rent free: Total,216,103,85,23,62,9,9,113,55,0,10,38,10
S01008477,Rented or living rent free: Social rented,146,55,46,11,35,4,5,91,50,0,7,27,7
S01008477,Rented or living rent free: Private rented or living rent free,70,48,39,12,27,5,4,22,5,0,3,11,3
S01008478,All HRPs aged 16 and over,439,221,182,39,143,24,15,218,148,8,9,47,6
S01008478,Owned: Total,188,115,95,14,81,16,4,73,69,1,0,2,1
S01008478,Owned: Owned outright,92,28,24,8,16,3,1,64,63,0,0,1,0
S01008478,Owned: Owned with a mortgage or loan or shared ownership,96,87,71,6,65,13,3,9,6,1,0,1,1
S01008478,Rented or living rent free: Total,251,106,87,25,62,8,11,145,79,7,9,45,5
S01008478,Rented or living rent free: Social rented,166,47,41,16,25,1,5,119,66,0,7,44,2
S01008478,Rented or living rent free: Private rented or living rent free,85,59,46,9,37,7,6,26,13,7,2,1,3
S01008479,All HRPs aged 16 and over,407,222,178,40,138,17,27,185,129,4,13,31,8
S01008479,Owned: Total,234,139,124,22,102,11,4,95,91,1,0,3,0
S01008479,Owned: Owned outright,112,35,32,9,23,1,2,77,76,0,0,1,0
S01008479,Owned: Owned with a mortgage or loan or shared ownership,122,104,92,13,79,10,2,18,15,1,0,2,0
S01008479,Rented or living rent free: Total,173,83,54,18,36,6,23,90,38,3,13,28,8
S01008479,Rented or living rent free: Social rented,89,36,19,8,11,3,14,53,26,0,3,23,1
S01008479,Rented or living rent free: Private rented or living rent free,84,47,35,10,25,3,9,37,12,3,10,5,7
S01008480,All HRPs aged 16 and over,279,187,164,34,130,6,17,92,35,18,14,21,4
S01008480,Owned: Total,108,89,83,6,77,5,1,19,15,0,0,2,2
S01008480,Owned: Owned outright,30,15,15,4,11,0,0,15,12,0,0,1,2
S01008480,Owned: Owned with a mortgage or loan or shared ownership,78,74,68,2,66,5,1,4,3,0,0,1,0
S01008480,Rented or living rent free: Total,171,98,81,28,53,1,16,73,20,18,14,19,2
S01008480,Rented or living rent free: Social rented,97,50,44,19,25,0,6,47,19,4,8,15,1
S01008480,Rented or living rent free: Private rented or living rent free,74,48,37,9,28,1,10,26,1,14,6,4,1
S01008481,All HRPs aged 16 and over,373,218,185,45,140,27,6,155,103,3,24,21,4
S01008481,Owned: Total,233,152,131,21,110,19,2,81,75,0,1,3,2
S01008481,Owned: Owned outright,109,43,37,12,25,5,1,66,63,0,0,2,1
S01008481,Owned: Owned with a mortgage or loan or shared ownership,124,109,94,9,85,14,1,15,12,0,1,1,1
S01008481,Rented or living rent free: Total,140,66,54,24,30,8,4,74,28,3,23,18,2
S01008481,Rented or living rent free: Social rented,111,51,41,19,22,7,3,60,26,0,16,16,2
S01008481,Rented or living rent free: Private rented or living rent free,29,15,13,5,8,1,1,14,2,3,7,2,0
S01008482,All HRPs aged 16 and over,316,167,142,33,109,13,12,149,113,7,9,15,5
S01008482,Owned: Total,177,109,96,14,82,11,2,68,59,1,3,2,3
S01008482,Owned: Owned outright,84,27,22,3,19,5,0,57,52,0,2,2,1
S01008482,Owned: Owned with a mortgage or loan or shared ownership,93,82,74,11,63,6,2,11,7,1,1,0,2
S01008482,Rented or living rent free: Total,139,58,46,19,27,2,10,81,54,6,6,13,2
S01008482,Rented or living rent free: Social rented,94,26,19,10,9,2,5,68,52,1,2,12,1
S01008482,Rented or living rent free: Private rented or living rent free,45,32,27,9,18,0,5,13,2,5,4,1,1
S01008483,All HRPs aged 16 and over,327,170,139,22,117,24,7,157,108,15,7,23,4
S01008483,Owned: Total,156,105,84,7,77,19,2,51,49,0,0,2,0
S01008483,Owned: Owned outright,64,17,14,3,11,3,0,47,45,0,0,2,0
S01008483,Owned: Owned with a mortgage or loan or shared ownership,92,88,70,4,66,16,2,4,4,0,0,0,0
S01008483,Rented or living rent free: Total,171,65,55,15,40,5,5,106,59,15,7,21,4
S01008483,Rented or living rent free: Social rented,116,36,32,8,24,1,3,80,55,1,3,18,3
S01008483,Rented or living rent free: Private rented or living rent free,55,29,23,7,16,4,2,26,4,14,4,3,1
S01008484,All HRPs aged 16 and over,342,217,174,31,143,31,12,125,109,4,4,4,4
S01008484,Owned: Total,267,175,147,22,125,24,4,92,88,0,2,1,1
S01008484,Owned: Owned outright,125,47,40,10,30,6,1,78,76,0,1,1,0
S01008484,Owned: Owned with a mortgage or loan or shared ownership,142,128,107,12,95,18,3,14,12,0,1,0,1
S01008484,Rented or living rent free: Total,75,42,27,9,18,7,8,33,21,4,2,3,3
S01008484,Rented or living rent free: Social rented,44,24,15,5,10,2,7,20,15,2,0,2,1
S01008484,Rented or living rent free: Private rented or living rent free,31,18,12,4,8,5,1,13,6,2,2,1,2
S01008485,All HRPs aged 16 and over,408,303,261,59,202,36,6,105,86,7,6,6,0
S01008485,Owned: Total,269,190,155,27,128,32,3,79,76,0,1,2,0
S01008485,Owned: Owned outright,123,49,41,14,27,7,1,74,71,0,1,2,0
S01008485,Owned: Owned with a mortgage or loan or shared ownership,146,141,114,13,101,25,2,5,5,0,0,0,0
S01008485,Rented or living rent free: Total,139,113,106,32,74,4,3,26,10,7,5,4,0
S01008485,Rented or living rent free: Social rented,21,12,11,4,7,0,1,9,6,0,1,2,0
S01008485,Rented or living rent free: Private rented or living rent free,118,101,95,28,67,4,2,17,4,7,4,2,0
S01008486,All HRPs aged 16 and over,459,228,184,33,151,35,9,231,192,11,5,17,6
S01008486,Owned: Total,294,181,149,21,128,32,0,113,102,0,1,6,4
S01008486,Owned: Owned outright,149,55,46,11,35,9,0,94,88,0,1,4,1
S01008486,Owned: Owned with a mortgage or loan or shared ownership,145,126,103,10,93,23,0,19,14,0,0,2,3
S01008486,Rented or living rent free: Total,165,47,35,12,23,3,9,118,90,11,4,11,2
S01008486,Rented or living rent free: Social rented,114,13,11,5,6,0,2,101,82,5,3,9,2
S01008486,Rented or living rent free: Private rented or living rent free,51,34,24,7,17,3,7,17,8,6,1,2,0
S01008487,All HRPs aged 16 and over,417,330,294,28,266,30,6,87,59,16,2,5,5
S01008487,Owned: Total,260,207,187,9,178,18,2,53,43,5,1,1,3
S01008487,Owned: Owned outright,65,26,23,2,21,3,0,39,36,2,0,0,1
S01008487,Owned: Owned with a mortgage or loan or shared ownership,195,181,164,7,157,15,2,14,7,3,1,1,2
S01008487,Rented or living rent free: Total,157,123,107,19,88,12,4,34,16,11,1,4,2
S01008487,Rented or living rent free: Social rented,61,45,37,6,31,5,3,16,13,0,1,1,1
S01008487,Rented or living rent free: Private rented or living rent free,96,78,70,13,57,7,1,18,3,11,0,3,1
S01008488,All HRPs aged 16 and over,416,254,218,31,187,26,10,162,113,19,2,25,3
S01008488,Owned: Total,256,164,142,10,132,19,3,92,84,0,2,4,2
S01008488,Owned: Owned outright,111,33,27,5,22,4,2,78,73,0,2,2,1
S01008488,Owned: Owned with a mortgage or loan or shared ownership,145,131,115,5,110,15,1,14,11,0,0,2,1
S01008488,Rented or living rent free: Total,160,90,76,21,55,7,7,70,29,19,0,21,1
S01008488,Rented or living rent free: Social rented,72,31,25,7,18,2,4,41,21,3,0,16,1
S01008488,Rented or living rent free: Private rented or living rent free,88,59,51,14,37,5,3,29,8,16,0,5,0
S01008489,All HRPs aged 16 and over,305,202,169,38,131,17,16,103,79,8,1,14,1
S01008489,Owned: Total,195,129,112,16,96,15,2,66,59,2,0,5,0
S01008489,Owned: Owned outright,96,39,32,11,21,7,0,57,52,1,0,4,0
S01008489,Owned: Owned with a mortgage or loan or shared ownership,99,90,80,5,75,8,2,9,7,1,0,1,0
S01008489,Rented or living rent free: Total,110,73,57,22,35,2,14,37,20,6,1,9,1
S01008489,Rented or living rent free: Social rented,60,36,25,7,18,2,9,24,13,0,1,9,1
S01008489,Rented or living rent free: Private rented or living rent free,50,37,32,15,17,0,5,13,7,6,0,0,0
S01008490,All HRPs aged 16 and over,528,400,343,40,303,37,20,128,96,12,2,13,5
S01008490,Owned: Total,340,260,231,17,214,25,4,80,71,1,1,4,3
S01008490,Owned: Owned outright,135,67,54,8,46,11,2,68,61,1,0,3,3
S01008490,Owned: Owned with a mortgage or loan or shared ownership,205,193,177,9,168,14,2,12,10,0,1,1,0
S01008490,Rented or living rent free: Total,188,140,112,23,89,12,16,48,25,11,1,9,2
S01008490,Rented or living rent free: Social rented,56,27,22,7,15,1,4,29,20,1,1,7,0
S01008490,Rented or living rent free: Private rented or living rent free,132,113,90,16,74,11,12,19,5,10,0,2,2
S01008491,All HRPs aged 16 and over,487,334,291,57,234,27,16,153,81,44,5,12,11
S01008491,Owned: Total,255,188,166,24,142,16,6,67,58,3,0,0,6
S01008491,Owned: Owned outright,109,49,44,14,30,3,2,60,53,2,0,0,5
S01008491,Owned: Owned with a mortgage or loan or shared ownership,146,139,122,10,112,13,4,7,5,1,0,0,1
S01008491,Rented or living rent free: Total,232,146,125,33,92,11,10,86,23,41,5,12,5
S01008491,Rented or living rent free: Social rented,66,33,30,7,23,1,2,33,16,1,2,9,5
S01008491,Rented or living rent free: Private rented or living rent free,166,113,95,26,69,10,8,53,7,40,3,3,0
S01008492,All HRPs aged 16 and over,515,405,361,51,310,26,18,110,25,23,11,42,9
S01008492,Owned: Total,243,221,200,14,186,15,6,22,9,10,0,1,2
S01008492,Owned: Owned outright,31,18,10,1,9,5,3,13,4,8,0,0,1
S01008492,Owned: Owned with a mortgage or loan or shared ownership,212,203,190,13,177,10,3,9,5,2,0,1,1
S01008492,Rented or living rent free: Total,272,184,161,37,124,11,12,88,16,13,11,41,7
S01008492,Rented or living rent free: Social rented,154,85,72,23,49,4,9,69,14,2,10,37,6
S01008492,Rented or living rent free: Private rented or living rent free,118,99,89,14,75,7,3,19,2,11,1,4,1
S01008493,All HRPs aged 16 and over,420,266,228,42,186,20,18,154,112,10,7,24,1
S01008493,Owned: Total,229,143,127,15,112,12,4,86,82,1,0,2,1
S01008493,Owned: Owned outright,113,36,33,8,25,1,2,77,74,0,0,2,1
S01008493,Owned: Owned with a mortgage or loan or shared ownership,116,107,94,7,87,11,2,9,8,1,0,0,0
S01008493,Rented or living rent free: Total,191,123,101,27,74,8,14,68,30,9,7,22,0
S01008493,Rented or living rent free: Social rented,103,54,41,11,30,4,9,49,21,2,5,21,0
S01008493,Rented or living rent free: Private rented or living rent free,88,69,60,16,44,4,5,19,9,7,2,1,0
S01008494,All HRPs aged 16 and over,409,291,246,31,215,23,22,118,57,22,13,21,5
S01008494,Owned: Total,193,145,130,9,121,12,3,48,39,2,1,4,2
S01008494,Owned: Owned outright,55,15,12,0,12,1,2,40,35,0,1,2,2
S01008494,Owned: Owned with a mortgage or loan or shared ownership,138,130,118,9,109,11,1,8,4,2,0,2,0
S01008494,Rented or living rent free: Total,216,146,116,22,94,11,19,70,18,20,12,17,3
S01008494,Rented or living rent free: Social rented,52,21,11,3,8,4,6,31,12,2,6,10,1
S01008494,Rented or living rent free: Private rented or living rent free,164,125,105,19,86,7,13,39,6,18,6,7,2
S01008495,All HRPs aged 16 and over,589,475,403,55,348,28,44,114,33,40,7,20,14
S01008495,Owned: Total,226,192,178,18,160,10,4,34,21,1,4,6,2
S01008495,Owned: Owned outright,58,30,28,4,24,1,1,28,21,0,3,4,0
S01008495,Owned: Owned with a mortgage or loan or shared ownership,168,162,150,14,136,9,3,6,0,1,1,2,2
S01008495,Rented or living rent free: Total,363,283,225,37,188,18,40,80,12,39,3,14,12
S01008495,Rented or living rent free: Social rented,57,32,20,3,17,4,8,25,3,3,2,7,10
S01008495,Rented or living rent free: Private rented or living rent free,306,251,205,34,171,14,32,55,9,36,1,7,2
S01008496,All HRPs aged 16 and over,676,540,463,56,407,36,41,136,32,71,1,16,16
S01008496,Owned: Total,266,234,211,12,199,18,5,32,19,6,0,3,4
S01008496,Owned: Owned outright,55,32,26,5,21,5,1,23,19,2,0,1,1
S01008496,Owned: Owned with a mortgage or loan or shared ownership,211,202,185,7,178,13,4,9,0,4,0,2,3
S01008496,Rented or living rent free: Total,410,306,252,44,208,18,36,104,13,65,1,13,12
S01008496,Rented or living rent free: Social rented,37,24,15,4,11,1,8,13,6,0,0,5,2
S01008496,Rented or living rent free: Private rented or living rent free,373,282,237,40,197,17,28,91,7,65,1,8,10
S01008497,All HRPs aged 16 and over,572,476,424,68,356,23,29,96,39,28,4,21,4
S01008497,Owned: Total,235,209,200,18,182,7,2,26,23,1,0,1,1
S01008497,Owned: Owned outright,62,39,36,8,28,1,2,23,22,0,0,0,1
S01008497,Owned: Owned with a mortgage or loan or shared ownership,173,170,164,10,154,6,0,3,1,1,0,1,0
S01008497,Rented or living rent free: Total,337,267,224,50,174,16,27,70,16,27,4,20,3
S01008497,Rented or living rent free: Social rented,48,25,21,7,14,1,3,23,7,0,4,11,1
S01008497,Rented or living rent free: Private rented or living rent free,289,242,203,43,160,15,24,47,9,27,0,9,2
S01008498,All HRPs aged 16 and over,525,411,345,67,278,31,35,114,39,21,1,45,8
S01008498,Owned: Total,203,179,158,15,143,17,4,24,17,0,0,5,2
S01008498,Owned: Owned outright,51,35,27,3,24,6,2,16,12,0,0,3,1
S01008498,Owned: Owned with a mortgage or loan or shared ownership,152,144,131,12,119,11,2,8,5,0,0,2,1
S01008498,Rented or living rent free: Total,322,232,187,52,135,14,31,90,22,21,1,40,6
S01008498,Rented or living rent free: Social rented,111,61,40,15,25,5,16,50,15,0,0,29,6
S01008498,Rented or living rent free: Private rented or living rent free,211,171,147,37,110,9,15,40,7,21,1,11,0
S01008499,All HRPs aged 16 and over,591,456,396,60,336,32,28,135,36,51,6,34,8
S01008499,Owned: Total,196,168,152,15,137,14,2,28,16,3,2,4,3
S01008499,Owned: Owned outright,47,28,22,7,15,5,1,19,15,1,0,2,1
S01008499,Owned: Owned with a mortgage or loan or shared ownership,149,140,130,8,122,9,1,9,1,2,2,2,2
S01008499,Rented or living rent free: Total,395,288,244,45,199,18,26,107,20,48,4,30,5
S01008499,Rented or living rent free: Social rented,96,55,39,9,30,2,14,41,11,4,0,24,2
S01008499,Rented or living rent free: Private rented or living rent free,299,233,205,36,169,16,12,66,9,44,4,6,3
S01008500,All HRPs aged 16 and over,209,147,122,23,99,12,13,62,4,8,3,39,8
S01008500,Owned: Total,31,30,26,1,25,2,2,1,1,0,0,0,0
S01008500,Owned: Owned outright,4,3,2,0,2,0,1,1,1,0,0,0,0
S01008500,Owned: Owned with a mortgage or loan or shared ownership,27,27,24,1,23,2,1,0,0,0,0,0,0
S01008500,Rented or living rent free: Total,178,117,96,22,74,10,11,61,3,8,3,39,8
S01008500,Rented or living rent free: Social rented,125,70,55,17,38,5,10,55,3,2,3,39,8
S01008500,Rented or living rent free: Private rented or living rent free,53,47,41,5,36,5,1,6,0,6,0,0,0
S01008501,All HRPs aged 16 and over,316,279,248,36,212,19,12,37,8,17,4,5,3
S01008501,Owned: Total,106,100,84,7,77,11,5,6,4,1,0,0,1
S01008501,Owned: Owned outright,25,21,17,2,15,3,1,4,3,0,0,0,1
S01008501,Owned: Owned with a mortgage or loan or shared ownership,81,79,67,5,62,8,4,2,1,1,0,0,0
S01008501,Rented or living rent free: Total,210,179,164,29,135,8,7,31,4,16,4,5,2
S01008501,Rented or living rent free: Social rented,28,15,15,5,10,0,0,13,4,0,4,4,1
S01008501,Rented or living rent free: Private rented or living rent free,182,164,149,24,125,8,7,18,0,16,0,1,1
S01008502,All HRPs aged 16 and over,373,313,288,34,254,12,13,60,11,43,1,4,1
S01008502,Owned: Total,171,158,150,13,137,4,4,13,9,4,0,0,0
S01008502,Owned: Owned outright,35,27,26,3,23,1,0,8,6,2,0,0,0
S01008502,Owned: Owned with a mortgage or loan or shared ownership,136,131,124,10,114,3,4,5,3,2,0,0,0
S01008502,Rented or living rent free: Total,202,155,138,21,117,8,9,47,2,39,1,4,1
S01008502,Rented or living rent free: Social rented,4,0,0,0,0,0,0,4,1,1,0,2,0
S01008502,Rented or living rent free: Private rented or living rent free,198,155,138,21,117,8,9,43,1,38,1,2,1
S01008503,All HRPs aged 16 and over,443,380,343,40,303,28,9,63,32,22,2,5,2
S01008503,Owned: Total,260,224,198,19,179,23,3,36,29,6,1,0,0
S01008503,Owned: Owned outright,67,41,39,10,29,2,0,26,22,4,0,0,0
S01008503,Owned: Owned with a mortgage or loan or shared ownership,193,183,159,9,150,21,3,10,7,2,1,0,0
S01008503,Rented or living rent free: Total,183,156,145,21,124,5,6,27,3,16,1,5,2
S01008503,Rented or living rent free: Social rented,14,9,9,0,9,0,0,5,1,0,0,3,1
S01008503,Rented or living rent free: Private rented or living rent free,169,147,136,21,115,5,6,22,2,16,1,2,1
S01008504,All HRPs aged 16 and over,543,445,383,47,336,46,16,98,62,21,4,3,8
S01008504,Owned: Total,398,331,281,28,253,41,9,67,59,2,0,0,6
S01008504,Owned: Owned outright,130,74,51,13,38,16,7,56,54,1,0,0,1
S01008504,Owned: Owned with a mortgage or loan or shared ownership,268,257,230,15,215,25,2,11,5,1,0,0,5
S01008504,Rented or living rent free: Total,145,114,102,19,83,5,7,31,3,19,4,3,2
S01008504,Rented or living rent free: Social rented,5,2,2,0,2,0,0,3,0,1,0,2,0
S01008504,Rented or living rent free: Private rented or living rent free,140,112,100,19,81,5,7,28,3,18,4,1,2
S01008505,All HRPs aged 16 and over,330,272,234,38,196,30,8,58,47,7,0,1,3
S01008505,Owned: Total,271,220,190,32,158,25,5,51,45,2,0,1,3
S01008505,Owned: Owned outright,116,70,59,17,42,9,2,46,41,2,0,1,2
S01008505,Owned: Owned with a mortgage or loan or shared ownership,155,150,131,15,116,16,3,5,4,0,0,0,1
S01008505,Rented or living rent free: Total,59,52,44,6,38,5,3,7,2,5,0,0,0
S01008505,Rented or living rent free: Social rented,2,2,1,0,1,1,0,0,0,0,0,0,0
S01008505,Rented or living rent free: Private rented or living rent free,57,50,43,6,37,4,3,7,2,5,0,0,0
S01008506,All HRPs aged 16 and over,442,282,236,40,196,38,8,160,139,6,7,6,2
S01008506,Owned: Total,322,194,158,25,133,33,3,128,121,1,5,1,0
S01008506,Owned: Owned outright,181,61,49,20,29,10,2,120,115,0,5,0,0
S01008506,Owned: Owned with a mortgage or loan or shared ownership,141,133,109,5,104,23,1,8,6,1,0,1,0
S01008506,Rented or living rent free: Total,120,88,78,15,63,5,5,32,18,5,2,5,2
S01008506,Rented or living rent free: Social rented,22,6,5,1,4,0,1,16,11,0,0,5,0
S01008506,Rented or living rent free: Private rented or living rent free,98,82,73,14,59,5,4,16,7,5,2,0,2
S01008507,All HRPs aged 16 and over,386,321,283,36,247,33,5,65,37,11,3,7,7
S01008507,Owned: Total,251,212,188,17,171,21,3,39,31,1,2,3,2
S01008507,Owned: Owned outright,80,47,42,9,33,5,0,33,29,0,1,2,1
S01008507,Owned: Owned with a mortgage or loan or shared ownership,171,165,146,8,138,16,3,6,2,1,1,1,1
S01008507,Rented or living rent free: Total,135,109,95,19,76,12,2,26,6,10,1,4,5
S01008507,Rented or living rent free: Social rented,21,12,8,3,5,2,2,9,3,0,1,3,2
S01008507,Rented or living rent free: Private rented or living rent free,114,97,87,16,71,10,0,17,3,10,0,1,3
S01008508,All HRPs aged 16 and over,358,247,201,22,179,42,4,111,105,3,1,2,0
S01008508,Owned: Total,316,211,173,18,155,36,2,105,102,1,0,2,0
S01008508,Owned: Owned outright,170,73,63,11,52,10,0,97,95,1,0,1,0
S01008508,Owned: Owned with a mortgage or loan or shared ownership,146,138,110,7,103,26,2,8,7,0,0,1,0
S01008508,Rented or living rent free: Total,42,36,28,4,24,6,2,6,3,2,1,0,0
S01008508,Rented or living rent free: Social rented,1,0,0,0,0,0,0,1,0,0,1,0,0
S01008508,Rented or living rent free: Private rented or living rent free,41,36,28,4,24,6,2,5,3,2,0,0,0
S01008509,All HRPs aged 16 and over,509,320,261,30,231,52,7,189,163,14,3,6,3
S01008509,Owned: Total,435,269,220,20,200,42,7,166,155,4,2,2,3
S01008509,Owned: Owned outright,232,75,53,13,40,18,4,157,150,2,2,2,1
S01008509,Owned: Owned with a mortgage or loan or shared ownership,203,194,167,7,160,24,3,9,5,2,0,0,2
S01008509,Rented or living rent free: Total,74,51,41,10,31,10,0,23,8,10,1,4,0
S01008509,Rented or living rent free: Social rented,11,4,2,2,0,2,0,7,2,1,0,4,0
S01008509,Rented or living rent free: Private rented or living rent free,63,47,39,8,31,8,0,16,6,9,1,0,0
S01008510,All HRPs aged 16 and over,390,257,211,22,189,45,1,133,114,13,3,1,2
S01008510,Owned: Total,349,234,193,17,176,41,0,115,112,1,0,0,2
S01008510,Owned: Owned outright,179,74,60,12,48,14,0,105,104,0,0,0,1
S01008510,Owned: Owned with a mortgage or loan or shared ownership,170,160,133,5,128,27,0,10,8,1,0,0,1
S01008510,Rented or living rent free: Total,41,23,18,5,13,4,1,18,2,12,3,1,0
S01008510,Rented or living rent free: Social rented,3,2,2,0,2,0,0,1,1,0,0,0,0
S01008510,Rented or living rent free: Private rented or living rent free,38,21,16,5,11,4,1,17,1,12,3,1,0
S01008511,All HRPs aged 16 and over,358,238,179,27,152,56,3,120,113,1,3,0,3
S01008511,Owned: Total,328,217,163,24,139,54,0,111,107,0,2,0,2
S01008511,Owned: Owned outright,178,75,57,16,41,18,0,103,100,0,1,0,2
S01008511,Owned: Owned with a mortgage or loan or shared ownership,150,142,106,8,98,36,0,8,7,0,1,0,0
S01008511,Rented or living rent free: Total,30,21,16,3,13,2,3,9,6,1,1,0,1
S01008511,Rented or living rent free: Social rented,4,4,3,2,1,1,0,0,0,0,0,0,0
S01008511,Rented or living rent free: Private rented or living rent free,26,17,13,1,12,1,3,9,6,1,1,0,1
S01008512,All HRPs aged 16 and over,201,127,97,7,90,29,1,74,71,0,1,0,2
S01008512,Owned: Total,197,124,94,7,87,29,1,73,70,0,1,0,2
S01008512,Owned: Owned outright,117,50,37,5,32,13,0,67,65,0,1,0,1
S01008512,Owned: Owned with a mortgage or loan or shared ownership,80,74,57,2,55,16,1,6,5,0,0,0,1
S01008512,Rented or living rent free: Total,4,3,3,0,3,0,0,1,1,0,0,0,0
S01008512,Rented or living rent free: Social rented,0,0,0,0,0,0,0,0,0,0,0,0,0
S01008512,Rented or living rent free: Private rented or living rent free,4,3,3,0,3,0,0,1,1,0,0,0,0
S01008513,All HRPs aged 16 and over,258,160,123,16,107,37,0,98,93,0,1,3,1
S01008513,Owned: Total,252,156,120,14,106,36,0,96,93,0,0,2,1
S01008513,Owned: Owned outright,142,49,36,10,26,13,0,93,90,0,0,2,1
S01008513,Owned: Owned with a mortgage or loan or shared ownership,110,107,84,4,80,23,0,3,3,0,0,0,0
S01008513,Rented or living rent free: Total,6,4,3,2,1,1,0,2,0,0,1,1,0
S01008513,Rented or living rent free: Social rented,3,2,1,1,0,1,0,1,0,0,0,1,0
S01008513,Rented or living rent free: Private rented or living rent free,3,2,2,1,1,0,0,1,0,0,1,0,0
S01008514,All HRPs aged 16 and over,397,232,184,26,158,45,3,165,151,4,3,6,1
S01008514,Owned: Total,339,202,162,23,139,39,1,137,132,0,2,2,1
S01008514,Owned: Owned outright,204,80,65,14,51,15,0,124,121,0,0,2,1
S01008514,Owned: Owned with a mortgage or loan or shared ownership,135,122,97,9,88,24,1,13,11,0,2,0,0
S01008514,Rented or living rent free: Total,58,30,22,3,19,6,2,28,19,4,1,4,0
S01008514,Rented or living rent free: Social rented,14,2,1,0,1,1,0,12,11,0,0,1,0
S01008514,Rented or living rent free: Private rented or living rent free,44,28,21,3,18,5,2,16,8,4,1,3,0
S01008515,All HRPs aged 16 and over,297,234,197,21,176,36,1,63,56,2,1,3,1
S01008515,Owned: Total,268,210,176,18,158,34,0,58,56,0,1,1,0
S01008515,Owned: Owned outright,116,63,48,7,41,15,0,53,52,0,0,1,0
S01008515,Owned: Owned with a mortgage or loan or shared ownership,152,147,128,11,117,19,0,5,4,0,1,0,0
S01008515,Rented or living rent free: Total,29,24,21,3,18,2,1,5,0,2,0,2,1
S01008515,Rented or living rent free: Social rented,1,0,0,0,0,0,0,1,0,0,0,1,0
S01008515,Rented or living rent free: Private rented or living rent free,28,24,21,3,18,2,1,4,0,2,0,1,1
S01008516,All HRPs aged 16 and over,592,436,378,43,335,39,19,156,84,44,5,11,12
S01008516,Owned: Total,317,231,199,11,188,26,6,86,72,4,0,3,7
S01008516,Owned: Owned outright,133,58,45,3,42,8,5,75,67,1,0,3,4
S01008516,Owned: Owned with a mortgage or loan or shared ownership,184,173,154,8,146,18,1,11,5,3,0,0,3
S01008516,Rented or living rent free: Total,275,205,179,32,147,13,13,70,12,40,5,8,5
S01008516,Rented or living rent free: Social rented,29,16,12,2,10,1,3,13,4,0,4,2,3
S01008516,Rented or living rent free: Private rented or living rent free,246,189,167,30,137,12,10,57,8,40,1,6,2
S01008517,All HRPs aged 16 and over,463,305,264,40,224,34,7,158,115,29,5,3,6
S01008517,Owned: Total,283,163,136,13,123,23,4,120,108,2,4,0,6
S01008517,Owned: Owned outright,164,53,41,7,34,10,2,111,101,1,3,0,6
S01008517,Owned: Owned with a mortgage or loan or shared ownership,119,110,95,6,89,13,2,9,7,1,1,0,0
S01008517,Rented or living rent free: Total,180,142,128,27,101,11,3,38,7,27,1,3,0
S01008517,Rented or living rent free: Social rented,7,7,6,3,3,1,0,0,0,0,0,0,0
S01008517,Rented or living rent free: Private rented or living rent free,173,135,122,24,98,10,3,38,7,27,1,3,0
S01008518,All HRPs aged 16 and over,378,268,221,24,197,45,2,110,85,17,4,2,2
S01008518,Owned: Total,299,216,176,16,160,40,0,83,80,1,1,0,1
S01008518,Owned: Owned outright,150,78,66,9,57,12,0,72,71,0,0,0,1
S01008518,Owned: Owned with a mortgage or loan or shared ownership,149,138,110,7,103,28,0,11,9,1,1,0,0
S01008518,Rented or living rent free: Total,79,52,45,8,37,5,2,27,5,16,3,2,1
S01008518,Rented or living rent free: Social rented,5,3,2,1,1,1,0,2,0,1,0,1,0
S01008518,Rented or living rent free: Private rented or living rent free,74,49,43,7,36,4,2,25,5,15,3,1,1
S01008519,All HRPs aged 16 and over,324,226,165,18,147,58,3,98,88,1,5,3,1
S01008519,Owned: Total,291,198,141,12,129,55,2,93,85,1,5,1,1
S01008519,Owned: Owned outright,153,65,42,7,35,22,1,88,83,0,3,1,1
S01008519,Owned: Owned with a mortgage or loan or shared ownership,138,133,99,5,94,33,1,5,2,1,2,0,0
S01008519,Rented or living rent free: Total,33,28,24,6,18,3,1,5,3,0,0,2,0
S01008519,Rented or living rent free: Social rented,3,3,3,2,1,0,0,0,0,0,0,0,0
S01008519,Rented or living rent free: Private rented or living rent free,30,25,21,4,17,3,1,5,3,0,0,2,0
S01008520,All HRPs aged 16 and over,433,268,192,19,173,74,2,165,158,2,1,1,3
S01008520,Owned: Total,410,252,181,17,164,70,1,158,155,2,0,0,1
S01008520,Owned: Owned outright,250,106,76,12,64,30,0,144,143,1,0,0,0
S01008520,Owned: Owned with a mortgage or loan or shared ownership,160,146,105,5,100,40,1,14,12,1,0,0,1
S01008520,Rented or living rent free: Total,23,16,11,2,9,4,1,7,3,0,1,1,2
S01008520,Rented or living rent free: Social rented,4,2,0,0,0,1,1,2,1,0,0,1,0
S01008520,Rented or living rent free: Private rented or living rent free,19,14,11,2,9,3,0,5,2,0,1,0,2
S01008521,All HRPs aged 16 and over,338,227,167,14,153,59,1,111,110,0,0,0,1
S01008521,Owned: Total,327,218,161,13,148,57,0,109,108,0,0,0,1
S01008521,Owned: Owned outright,190,83,60,10,50,23,0,107,106,0,0,0,1
S01008521,Owned: Owned with a mortgage or loan or shared ownership,137,135,101,3,98,34,0,2,2,0,0,0,0
S01008521,Rented or living rent free: Total,11,9,6,1,5,2,1,2,2,0,0,0,0
S01008521,Rented or living rent free: Social rented,2,1,1,0,1,0,0,1,1,0,0,0,0
S01008521,Rented or living rent free: Private rented or living rent free,9,8,5,1,4,2,1,1,1,0,0,0,0
S01008522,All HRPs aged 16 and over,228,150,112,11,101,34,4,78,71,4,2,0,1
S01008522,Owned: Total,200,129,96,9,87,31,2,71,69,1,1,0,0
S01008522,Owned: Owned outright,111,45,33,5,28,11,1,66,64,1,1,0,0
S01008522,Owned: Owned with a mortgage or loan or shared ownership,89,84,63,4,59,20,1,5,5,0,0,0,0
S01008522,Rented or living rent free: Total,28,21,16,2,14,3,2,7,2,3,1,0,1
S01008522,Rented or living rent free: Social rented,0,0,0,0,0,0,0,0,0,0,0,0,0
S01008522,Rented or living rent free: Private rented or living rent free,28,21,16,2,14,3,2,7,2,3,1,0,1
S01008523,All HRPs aged 16 and over,434,305,250,21,229,51,4,129,110,4,11,2,2
S01008523,Owned: Total,376,268,219,18,201,46,3,108,103,1,3,0,1
S01008523,Owned: Owned outright,172,74,55,11,44,16,3,98,95,0,3,0,0
S01008523,Owned: Owned with a mortgage or loan or shared ownership,204,194,164,7,157,30,0,10,8,1,0,0,1
S01008523,Rented or living rent free: Total,58,37,31,3,28,5,1,21,7,3,8,2,1
S01008523,Rented or living rent free: Social rented,3,0,0,0,0,0,0,3,1,0,0,2,0
S01008523,Rented or living rent free: Private rented or living rent free,55,37,31,3,28,5,1,18,6,3,8,0,1
S01008524,All HRPs aged 16 and over,442,268,204,47,157,29,35,174,80,13,19,47,15
S01008524,Owned: Total,182,128,101,18,83,19,8,54,47,1,0,3,3
S01008524,Owned: Owned outright,70,25,20,7,13,2,3,45,42,0,0,1,2
S01008524,Owned: Owned with a mortgage or loan or shared ownership,112,103,81,11,70,17,5,9,5,1,0,2,1
S01008524,Rented or living rent free: Total,260,140,103,29,74,10,27,120,33,12,19,44,12
S01008524,Rented or living rent free: Social rented,206,111,81,24,57,6,24,95,27,3,13,42,10
S01008524,Rented or living rent free: Private rented or living rent free,54,29,22,5,17,4,3,25,6,9,6,2,2
S01008525,All HRPs aged 16 and over,380,193,160,40,120,15,18,187,138,0,15,28,6
S01008525,Owned: Total,125,78,71,10,61,6,1,47,45,0,0,2,0
S01008525,Owned: Owned outright,61,20,16,4,12,4,0,41,40,0,0,1,0
S01008525,Owned: Owned with a mortgage or loan or shared ownership,64,58,55,6,49,2,1,6,5,0,0,1,0
S01008525,Rented or living rent free: Total,255,115,89,30,59,9,17,140,93,0,15,26,6
S01008525,Rented or living rent free: Social rented,210,84,66,20,46,7,11,126,86,0,9,25,6
S01008525,Rented or living rent free: Private rented or living rent free,45,31,23,10,13,2,6,14,7,0,6,1,0
S01008526,All HRPs aged 16 and over,448,262,222,37,185,28,12,186,153,3,7,21,2
S01008526,Owned: Total,307,190,165,24,141,23,2,117,111,0,1,3,2
S01008526,Owned: Owned outright,145,42,35,14,21,6,1,103,99,0,1,2,1
S01008526,Owned: Owned with a mortgage or loan or shared ownership,162,148,130,10,120,17,1,14,12,0,0,1,1
S01008526,Rented or living rent free: Total,141,72,57,13,44,5,10,69,42,3,6,18,0
S01008526,Rented or living rent free: Social rented,77,27,21,6,15,1,5,50,34,0,3,13,0
S01008526,Rented or living rent free: Private rented or living rent free,64,45,36,7,29,4,5,19,8,3,3,5,0
S01008527,All HRPs aged 16 and over,333,240,214,39,175,21,5,93,66,7,12,4,4
S01008527,Owned: Total,244,189,167,20,147,19,3,55,53,0,1,0,1
S01008527,Owned: Owned outright,91,44,38,4,34,5,1,47,46,0,0,0,1
S01008527,Owned: Owned with a mortgage or loan or shared ownership,153,145,129,16,113,14,2,8,7,0,1,0,0
S01008527,Rented or living rent free: Total,89,51,47,19,28,2,2,38,13,7,11,4,3
S01008527,Rented or living rent free: Social rented,15,5,3,1,2,0,2,10,5,0,1,4,0
S01008527,Rented or living rent free: Private rented or living rent free,74,46,44,18,26,2,0,28,8,7,10,0,3
S01008528,All HRPs aged 16 and over,304,223,184,45,139,27,12,81,60,0,12,6,3
S01008528,Owned: Total,225,172,148,27,121,21,3,53,50,0,2,1,0
S01008528,Owned: Owned outright,84,39,35,11,24,2,2,45,44,0,1,0,0
S01008528,Owned: Owned with a mortgage or loan or shared ownership,141,133,113,16,97,19,1,8,6,0,1,1,0
S01008528,Rented or living rent free: Total,79,51,36,18,18,6,9,28,10,0,10,5,3
S01008528,Rented or living rent free: Social rented,8,2,2,2,0,0,0,6,1,0,3,1,1
S01008528,Rented or living rent free: Private rented or living rent free,71,49,34,16,18,6,9,22,9,0,7,4,2
S01008529,All HRPs aged 16 and over,349,199,167,29,138,24,8,150,114,3,12,16,5
S01008529,Owned: Total,253,158,137,16,121,21,0,95,92,1,0,1,1
S01008529,Owned: Owned outright,118,35,28,7,21,7,0,83,82,1,0,0,0
S01008529,Owned: Owned with a mortgage or loan or shared ownership,135,123,109,9,100,14,0,12,10,0,0,1,1
S01008529,Rented or living rent free: Total,96,41,30,13,17,3,8,55,22,2,12,15,4
S01008529,Rented or living rent free: Social rented,62,21,16,8,8,1,4,41,20,1,6,14,0
S01008529,Rented or living rent free: Private rented or living rent free,34,20,14,5,9,2,4,14,2,1,6,1,4
S01008530,All HRPs aged 16 and over,369,224,186,51,135,21,17,145,83,3,21,29,9
S01008530,Owned: Total,175,118,99,13,86,12,7,57,51,0,0,3,3
S01008530,Owned: Owned outright,74,24,18,6,12,5,1,50,47,0,0,1,2
S01008530,Owned: Owned with a mortgage or loan or shared ownership,101,94,81,7,74,7,6,7,4,0,0,2,1
S01008530,Rented or living rent free: Total,194,106,87,38,49,9,10,88,32,3,21,26,6
S01008530,Rented or living rent free: Social rented,153,76,62,34,28,7,7,77,31,2,14,24,6
S01008530,Rented or living rent free: Private rented or living rent free,41,30,25,4,21,2,3,11,1,1,7,2,0
S01008531,All HRPs aged 16 and over,394,231,193,64,129,22,16,163,110,0,15,33,5
S01008531,Owned: Total,204,125,105,21,84,15,5,79,75,0,0,4,0
S01008531,Owned: Owned outright,97,32,21,8,13,8,3,65,63,0,0,2,0
S01008531,Owned: Owned with a mortgage or loan or shared ownership,107,93,84,13,71,7,2,14,12,0,0,2,0
S01008531,Rented or living rent free: Total,190,106,88,43,45,7,11,84,35,0,15,29,5
S01008531,Rented or living rent free: Social rented,142,71,60,31,29,1,10,71,33,0,8,26,4
S01008531,Rented or living rent free: Private rented or living rent free,48,35,28,12,16,6,1,13,2,0,7,3,1
S01008532,All HRPs aged 16 and over,213,118,96,22,74,13,9,95,79,2,1,12,1
S01008532,Owned: Total,127,78,66,11,55,11,1,49,48,0,0,0,1
S01008532,Owned: Owned outright,59,22,18,2,16,3,1,37,36,0,0,0,1
S01008532,Owned: Owned with a mortgage or loan or shared ownership,68,56,48,9,39,8,0,12,12,0,0,0,0
S01008532,Rented or living rent free: Total,86,40,30,11,19,2,8,46,31,2,1,12,0
S01008532,Rented or living rent free: Social rented,71,28,20,8,12,1,7,43,30,1,1,11,0
S01008532,Rented or living rent free: Private rented or living rent free,15,12,10,3,7,1,1,3,1,1,0,1,0
S01008533,All HRPs aged 16 and over,179,158,148,9,139,9,1,21,17,0,2,2,0
S01008533,Owned: Total,42,30,26,2,24,4,0,12,12,0,0,0,0
S01008533,Owned: Owned outright,16,5,4,0,4,1,0,11,11,0,0,0,0
S01008533,Owned: Owned with a mortgage or loan or shared ownership,26,25,22,2,20,3,0,1,1,0,0,0,0
S01008533,Rented or living rent free: Total,137,128,122,7,115,5,1,9,5,0,2,2,0
S01008533,Rented or living rent free: Social rented,32,25,23,3,20,2,0,7,5,0,0,2,0
S01008533,Rented or living rent free: Private rented or living rent free,105,103,99,4,95,3,1,2,0,0,2,0,0
S01008534,All HRPs aged 16 and over,274,213,179,13,166,29,5,61,48,3,1,8,1
S01008534,Owned: Total,201,152,122,10,112,29,1,49,46,0,1,1,1
S01008534,Owned: Owned outright,90,46,36,4,32,9,1,44,41,0,1,1,1
S01008534,Owned: Owned with a mortgage or loan or shared ownership,111,106,86,6,80,20,0,5,5,0,0,0,0
S01008534,Rented or living rent free: Total,73,61,57,3,54,0,4,12,2,3,0,7,0
S01008534,Rented or living rent free: Social rented,10,5,4,0,4,0,1,5,0,0,0,5,0
S01008534,Rented or living rent free: Private rented or living rent free,63,56,53,3,50,0,3,7,2,3,0,2,0
S01008535,All HRPs aged 16 and over,284,193,152,20,132,36,5,91,86,0,1,2,2
S01008535,Owned: Total,274,184,145,17,128,34,5,90,86,0,1,1,2
S01008535,Owned: Owned outright,147,68,49,13,36,14,5,79,76,0,1,1,1
S01008535,Owned: Owned with a mortgage or loan or shared ownership,127,116,96,4,92,20,0,11,10,0,0,0,1
S01008535,Rented or living rent free: Total,10,9,7,3,4,2,0,1,0,0,0,1,0
S01008535,Rented or living rent free: Social rented,2,2,2,1,1,0,0,0,0,0,0,0,0
S01008535,Rented or living rent free: Private rented or living rent free,8,7,5,2,3,2,0,1,0,0,0,1,0
S01008536,All HRPs aged 16 and over,263,148,121,17,104,24,3,115,112,0,2,0,1
S01008536,Owned: Total,242,131,108,14,94,23,0,111,108,0,2,0,1
S01008536,Owned: Owned outright,154,47,38,11,27,9,0,107,105,0,2,0,0
S01008536,Owned: Owned with a mortgage or loan or shared ownership,88,84,70,3,67,14,0,4,3,0,0,0,1
S01008536,Rented or living rent free: Total,21,17,13,3,10,1,3,4,4,0,0,0,0
S01008536,Rented or living rent free: Social rented,7,4,4,3,1,0,0,3,3,0,0,0,0
S01008536,Rented or living rent free: Private rented or living rent free,14,13,9,0,9,1,3,1,1,0,0,0,0
S01008537,All HRPs aged 16 and over,280,165,134,18,116,28,3,115,111,0,3,0,1
S01008537,Owned: Total,270,158,128,17,111,28,2,112,110,0,1,0,1
S01008537,Owned: Owned outright,173,67,52,11,41,15,0,106,105,0,0,0,1
S01008537,Owned: Owned with a mortgage or loan or shared ownership,97,91,76,6,70,13,2,6,5,0,1,0,0
S01008537,Rented or living rent free: Total,10,7,6,1,5,0,1,3,1,0,2,0,0
S01008537,Rented or living rent free: Social rented,0,0,0,0,0,0,0,0,0,0,0,0,0
S01008537,Rented or living rent free: Private rented or living rent free,10,7,6,1,5,0,1,3,1,0,2,0,0
S01008538,All HRPs aged 16 and over,242,123,95,12,83,27,1,119,116,1,1,1,0
S01008538,Owned: Total,239,121,94,12,82,26,1,118,115,1,1,1,0
S01008538,Owned: Owned outright,165,51,38,10,28,13,0,114,111,1,1,1,0
S01008538,Owned: Owned with a mortgage or loan or shared ownership,74,70,56,2,54,13,1,4,4,0,0,0,0
S01008538,Rented or living rent free: Total,3,2,1,0,1,1,0,1,1,0,0,0,0
S01008538,Rented or living rent free: Social rented,0,0,0,0,0,0,0,0,0,0,0,0,0
S01008538,Rented or living rent free: Private rented or living rent free,3,2,1,0,1,1,0,1,1,0,0,0,0
S01008539,All HRPs aged 16 and over,346,234,194,22,172,35,5,112,106,2,2,1,1
S01008539,Owned: Total,323,215,179,21,158,33,3,108,103,1,2,1,1
S01008539,Owned: Owned outright,192,94,78,17,61,14,2,98,94,1,2,1,0
S01008539,Owned: Owned with a mortgage or loan or shared ownership,131,121,101,4,97,19,1,10,9,0,0,0,1
S01008539,Rented or living rent free: Total,23,19,15,1,14,2,2,4,3,1,0,0,0
S01008539,Rented or living rent free: Social rented,0,0,0,0,0,0,0,0,0,0,0,0,0
S01008539,Rented or living rent free: Private rented or living rent free,23,19,15,1,14,2,2,4,3,1,0,0,0
S01008540,All HRPs aged 16 and over,373,225,168,25,143,55,2,148,147,0,0,1,0
S01008540,Owned: Total,352,209,153,23,130,54,2,143,143,0,0,0,0
S01008540,Owned: Owned outright,226,90,68,20,48,22,0,136,136,0,0,0,0
S01008540,Owned: Owned with a mortgage or loan or shared ownership,126,119,85,3,82,32,2,7,7,0,0,0,0
S01008540,Rented or living rent free: Total,21,16,15,2,13,1,0,5,4,0,0,1,0
S01008540,Rented or living rent free: Social rented,2,0,0,0,0,0,0,2,1,0,0,1,0
S01008540,Rented or living rent free: Private rented or living rent free,19,16,15,2,13,1,0,3,3,0,0,0,0
S01008541,All HRPs aged 16 and over,323,230,193,20,173,33,4,93,90,1,1,0,1
S01008541,Owned: Total,306,213,180,18,162,31,2,93,90,1,1,0,1
S01008541,Owned: Owned outright,154,65,50,11,39,14,1,89,86,1,1,0,1
S01008541,Owned: Owned with a mortgage or loan or shared ownership,152,148,130,7,123,17,1,4,4,0,0,0,0
S01008541,Rented or living rent free: Total,17,17,13,2,11,2,2,0,0,0,0,0,0
S01008541,Rented or living rent free: Social rented,1,1,1,0,1,0,0,0,0,0,0,0,0
S01008541,Rented or living rent free: Private rented or living rent free,16,16,12,2,10,2,2,0,0,0,0,0,0
S01008542,All HRPs aged 16 and over,337,247,206,31,175,40,1,90,87,0,2,0,1
S01008542,Owned: Total,323,236,197,30,167,39,0,87,86,0,0,0,1
S01008542,Owned: Owned outright,144,67,53,16,37,14,0,77,76,0,0,0,1
S01008542,Owned: Owned with a mortgage or loan or shared ownership,179,169,144,14,130,25,0,10,10,0,0,0,0
S01008542,Rented or living rent free: Total,14,11,9,1,8,1,1,3,1,0,2,0,0
S01008542,Rented or living rent free: Social rented,1,1,0,0,0,1,0,0,0,0,0,0,0
S01008542,Rented or living rent free: Private rented or living rent free,13,10,9,1,8,0,1,3,1,0,2,0,0
S01008543,All HRPs aged 16 and over,259,205,171,19,152,34,0,54,51,0,2,1,0
S01008543,Owned: Total,243,193,159,16,143,34,0,50,49,0,0,1,0
S01008543,Owned: Owned outright,92,47,40,12,28,7,0,45,45,0,0,0,0
S01008543,Owned: Owned with a mortgage or loan or shared ownership,151,146,119,4,115,27,0,5,4,0,0,1,0
S01008543,Rented or living rent free: Total,16,12,12,3,9,0,0,4,2,0,2,0,0
S01008543,Rented or living rent free: Social rented,1,1,1,1,0,0,0,0,0,0,0,0,0
S01008543,Rented or living rent free: Private rented or living rent free,15,11,11,2,9,0,0,4,2,0,2,0,0
S01008544,All HRPs aged 16 and over,216,187,153,13,140,32,2,29,23,2,1,3,0
S01008544,Owned: Total,201,176,144,10,134,31,1,25,22,0,1,2,0
S01008544,Owned: Owned outright,68,48,38,1,37,9,1,20,18,0,1,1,0
S01008544,Owned: Owned with a mortgage or loan or shared ownership,133,128,106,9,97,22,0,5,4,0,0,1,0
S01008544,Rented or living rent free: Total,15,11,9,3,6,1,1,4,1,2,0,1,0
S01008544,Rented or living rent free: Social rented,2,2,1,1,0,0,1,0,0,0,0,0,0
S01008544,Rented or living rent free: Private rented or living rent free,13,9,8,2,6,1,0,4,1,2,0,1,0
S01008545,All HRPs aged 16 and over,334,231,171,13,158,57,3,103,100,1,1,1,0
S01008545,Owned: Total,305,207,155,8,147,49,3,98,97,0,1,0,0
S01008545,Owned: Owned outright,158,69,49,3,46,19,1,89,88,0,1,0,0
S01008545,Owned: Owned with a mortgage or loan or shared ownership,147,138,106,5,101,30,2,9,9,0,0,0,0
S01008545,Rented or living rent free: Total,29,24,16,5,11,8,0,5,3,1,0,1,0
S01008545,Rented or living rent free: Social rented,3,1,1,1,0,0,0,2,1,0,0,1,0
S01008545,Rented or living rent free: Private rented or living rent free,26,23,15,4,11,8,0,3,2,1,0,0,0
S01008546,All HRPs aged 16 and over,337,212,166,22,144,45,1,125,123,0,0,2,0
S01008546,Owned: Total,331,208,163,22,141,45,0,123,122,0,0,1,0
S01008546,Owned: Owned outright,198,86,63,12,51,23,0,112,112,0,0,0,0
S01008546,Owned: Owned with a mortgage or loan or shared ownership,133,122,100,10,90,22,0,11,10,0,0,1,0
S01008546,Rented or living rent free: Total,6,4,3,0,3,0,1,2,1,0,0,1,0
S01008546,Rented or living rent free: Social rented,0,0,0,0,0,0,0,0,0,0,0,0,0
S01008546,Rented or living rent free: Private rented or living rent free,6,4,3,0,3,0,1,2,1,0,0,1,0
S01008547,All HRPs aged 16 and over,424,348,287,42,245,53,8,76,57,4,8,4,3
S01008547,Owned: Total,372,314,262,33,229,49,3,58,52,0,3,2,1
S01008547,Owned: Owned outright,109,65,54,16,38,11,0,44,43,0,1,0,0
S01008547,Owned: Owned with a mortgage or loan or shared ownership,263,249,208,17,191,38,3,14,9,0,2,2,1
S01008547,Rented or living rent free: Total,52,34,25,9,16,4,5,18,5,4,5,2,2
S01008547,Rented or living rent free: Social rented,16,6,4,2,2,1,1,10,5,2,2,0,1
S01008547,Rented or living rent free: Private rented or living rent free,36,28,21,7,14,3,4,8,0,2,3,2,1
S01008548,All HRPs aged 16 and over,347,292,244,32,212,37,11,55,33,6,6,10,0
S01008548,Owned: Total,269,238,207,21,186,29,2,31,27,0,3,1,0
S01008548,Owned: Owned outright,50,27,21,7,14,5,1,23,23,0,0,0,0
S01008548,Owned: Owned with a mortgage or loan or shared ownership,219,211,186,14,172,24,1,8,4,0,3,1,0
S01008548,Rented or living rent free: Total,78,54,37,11,26,8,9,24,6,6,3,9,0
S01008548,Rented or living rent free: Social rented,32,23,14,6,8,2,7,9,4,0,0,5,0
S01008548,Rented or living rent free: Private rented or living rent free,46,31,23,5,18,6,2,15,2,6,3,4,0
S01008549,All HRPs aged 16 and over,439,306,242,38,204,51,13,133,106,3,6,15,3
S01008549,Owned: Total,330,248,199,23,176,47,2,82,76,1,0,4,1
S01008549,Owned: Owned outright,111,49,39,11,28,9,1,62,59,0,0,2,1
S01008549,Owned: Owned with a mortgage or loan or shared ownership,219,199,160,12,148,38,1,20,17,1,0,2,0
S01008549,Rented or living rent free: Total,109,58,43,15,28,4,11,51,30,2,6,11,2
S01008549,Rented or living rent free: Social rented,45,12,12,5,7,0,0,33,23,0,2,8,0
S01008549,Rented or living rent free: Private rented or living rent free,64,46,31,10,21,4,11,18,7,2,4,3,2
S01008550,All HRPs aged 16 and over,346,255,215,32,183,36,4,91,78,2,6,2,3
S01008550,Owned: Total,300,223,186,27,159,34,3,77,74,1,1,0,1
S01008550,Owned: Owned outright,127,58,52,11,41,5,1,69,66,1,1,0,1
S01008550,Owned: Owned with a mortgage or loan or shared ownership,173,165,134,16,118,29,2,8,8,0,0,0,0
S01008550,Rented or living rent free: Total,46,32,29,5,24,2,1,14,4,1,5,2,2
S01008550,Rented or living rent free: Social rented,6,3,3,0,3,0,0,3,1,0,0,1,1
S01008550,Rented or living rent free: Private rented or living rent free,40,29,26,5,21,2,1,11,3,1,5,1,1
S01008551,All HRPs aged 16 and over,496,312,251,39,212,58,3,184,161,4,4,7,8
S01008551,Owned: Total,440,283,227,36,191,55,1,157,146,3,3,0,5
S01008551,Owned: Owned outright,227,88,78,20,58,9,1,139,135,1,1,0,2
S01008551,Owned: Owned with a mortgage or loan or shared ownership,213,195,149,16,133,46,0,18,11,2,2,0,3
S01008551,Rented or living rent free: Total,56,29,24,3,21,3,2,27,15,1,1,7,3
S01008551,Rented or living rent free: Social rented,27,7,6,1,5,0,1,20,11,0,1,6,2
S01008551,Rented or living rent free: Private rented or living rent free,29,22,18,2,16,3,1,7,4,1,0,1,1
S01008552,All HRPs aged 16 and over,383,257,209,33,176,41,7,126,110,1,7,5,3
S01008552,Owned: Total,331,220,181,25,156,34,5,111,105,0,2,3,1
S01008552,Owned: Owned outright,154,58,49,15,34,7,2,96,94,0,1,0,1
S01008552,Owned: Owned with a mortgage or loan or shared ownership,177,162,132,10,122,27,3,15,11,0,1,3,0
S01008552,Rented or living rent free: Total,52,37,28,8,20,7,2,15,5,1,5,2,2
S01008552,Rented or living rent free: Social rented,16,12,10,2,8,1,1,4,2,0,1,1,0
S01008552,Rented or living rent free: Private rented or living rent free,36,25,18,6,12,6,1,11,3,1,4,1,2
S01008553,All HRPs aged 16 and over,244,149,117,18,99,27,5,95,75,1,2,11,6
S01008553,Owned: Total,175,114,88,14,74,25,1,61,57,0,1,2,1
S01008553,Owned: Owned outright,86,34,23,7,16,10,1,52,51,0,0,1,0
S01008553,Owned: Owned with a mortgage or loan or shared ownership,89,80,65,7,58,15,0,9,6,0,1,1,1
S01008553,Rented or living rent free: Total,69,35,29,4,25,2,4,34,18,1,1,9,5
S01008553,Rented or living rent free: Social rented,52,25,20,4,16,2,3,27,14,0,1,8,4
S01008553,Rented or living rent free: Private rented or living rent free,17,10,9,0,9,0,1,7,4,1,0,1,1
S01008554,All HRPs aged 16 and over,368,223,170,41,129,27,26,145,56,5,32,40,12
S01008554,Owned: Total,126,86,66,7,59,16,4,40,31,0,1,6,2
S01008554,Owned: Owned outright,50,21,14,5,9,7,0,29,24,0,0,4,1
S01008554,Owned: Owned with a mortgage or loan or shared ownership,76,65,52,2,50,9,4,11,7,0,1,2,1
S01008554,Rented or living rent free: Total,242,137,104,34,70,11,22,105,25,5,31,34,10
S01008554,Rented or living rent free: Social rented,203,109,84,30,54,7,18,94,23,2,27,32,10
S01008554,Rented or living rent free: Private rented or living rent free,39,28,20,4,16,4,4,11,2,3,4,2,0
S01008555,All HRPs aged 16 and over,528,306,240,69,171,24,42,222,107,6,35,57,17
S01008555,Owned: Total,146,116,98,13,85,15,3,30,22,2,2,3,1
S01008555,Owned: Owned outright,44,23,21,6,15,2,0,21,17,1,2,1,0
S01008555,Owned: Owned with a mortgage or loan or shared ownership,102,93,77,7,70,13,3,9,5,1,0,2,1
S01008555,Rented or living rent free: Total,382,190,142,56,86,9,39,192,85,4,33,54,16
S01008555,Rented or living rent free: Social rented,336,157,114,46,68,9,34,179,83,2,28,51,15
S01008555,Rented or living rent free: Private rented or living rent free,46,33,28,10,18,0,5,13,2,2,5,3,1
S01008556,All HRPs aged 16 and over,346,183,148,38,110,14,21,163,90,7,28,26,12
S01008556,Owned: Total,170,110,97,12,85,10,3,60,49,0,1,6,4
S01008556,Owned: Owned outright,59,18,16,5,11,2,0,41,36,0,1,1,3
S01008556,Owned: Owned with a mortgage or loan or shared ownership,111,92,81,7,74,8,3,19,13,0,0,5,1
S01008556,Rented or living rent free: Total,176,73,51,26,25,4,18,103,41,7,27,20,8
S01008556,Rented or living rent free: Social rented,136,60,41,20,21,3,16,76,38,4,14,16,4
S01008556,Rented or living rent free: Private rented or living rent free,40,13,10,6,4,1,2,27,3,3,13,4,4
S01008557,All HRPs aged 16 and over,429,205,167,45,122,17,21,224,130,4,44,42,4
S01008557,Owned: Total,161,97,86,15,71,9,2,64,55,0,4,4,1
S01008557,Owned: Owned outright,62,14,10,6,4,3,1,48,45,0,0,2,1
S01008557,Owned: Owned with a mortgage or loan or shared ownership,99,83,76,9,67,6,1,16,10,0,4,2,0
S01008557,Rented or living rent free: Total,268,108,81,30,51,8,19,160,75,4,40,38,3
S01008557,Rented or living rent free: Social rented,204,83,63,19,44,4,16,121,52,2,27,37,3
S01008557,Rented or living rent free: Private rented or living rent free,64,25,18,11,7,4,3,39,23,2,13,1,0
S01008558,All HRPs aged 16 and over,433,233,191,41,150,28,14,200,131,6,19,36,8
S01008558,Owned: Total,231,144,126,20,106,16,2,87,82,1,0,3,1
S01008558,Owned: Owned outright,104,35,28,7,21,6,1,69,66,0,0,2,1
S01008558,Owned: Owned with a mortgage or loan or shared ownership,127,109,98,13,85,10,1,18,16,1,0,1,0
S01008558,Rented or living rent free: Total,202,89,65,21,44,12,12,113,49,5,19,33,7
S01008558,Rented or living rent free: Social rented,144,57,43,15,28,6,8,87,44,0,10,30,3
S01008558,Rented or living rent free: Private rented or living rent free,58,32,22,6,16,6,4,26,5,5,9,3,4
S01008559,All HRPs aged 16 and over,295,177,148,26,122,21,8,118,74,7,10,17,10
S01008559,Owned: Total,189,129,109,13,96,17,3,60,48,5,1,5,1
S01008559,Owned: Owned outright,71,30,25,6,19,5,0,41,37,1,0,2,1
S01008559,Owned: Owned with a mortgage or loan or shared ownership,118,99,84,7,77,12,3,19,11,4,1,3,0
S01008559,Rented or living rent free: Total,106,48,39,13,26,4,5,58,26,2,9,12,9
S01008559,Rented or living rent free: Social rented,73,28,23,8,15,3,2,45,20,0,7,11,7
S01008559,Rented or living rent free: Private rented or living rent free,33,20,16,5,11,1,3,13,6,2,2,1,2
S01008560,All HRPs aged 16 and over,295,177,150,37,113,19,8,118,85,1,16,11,5
S01008560,Owned: Total,176,116,98,18,80,16,2,60,56,0,0,2,2
S01008560,Owned: Owned outright,62,19,16,5,11,3,0,43,42,0,0,0,1
S01008560,Owned: Owned with a mortgage or loan or shared ownership,114,97,82,13,69,13,2,17,14,0,0,2,1
S01008560,Rented or living rent free: Total,119,61,52,19,33,3,6,58,29,1,16,9,3
S01008560,Rented or living rent free: Social rented,81,38,31,11,20,1,6,43,20,1,12,9,1
S01008560,Rented or living rent free: Private rented or living rent free,38,23,21,8,13,2,0,15,9,0,4,0,2
S01008561,All HRPs aged 16 and over,277,172,145,26,119,17,10,105,76,3,12,9,5
S01008561,Owned: Total,169,116,96,10,86,15,5,53,50,0,0,2,1
S01008561,Owned: Owned outright,61,17,9,2,7,5,3,44,43,0,0,0,1
S01008561,Owned: Owned with a mortgage or loan or shared ownership,108,99,87,8,79,10,2,9,7,0,0,2,0
S01008561,Rented or living rent free: Total,108,56,49,16,33,2,5,52,26,3,12,7,4
S01008561,Rented or living rent free: Social rented,75,39,34,10,24,2,3,36,23,0,5,5,3
S01008561,Rented or living rent free: Private rented or living rent free,33,17,15,6,9,0,2,16,3,3,7,2,1
S01008562,All HRPs aged 16 and over,344,151,115,35,80,15,21,193,116,7,17,46,7
S01008562,Owned: Total,65,55,42,8,34,12,1,10,9,0,0,1,0
S01008562,Owned: Owned outright,8,3,2,2,0,1,0,5,4,0,0,1,0
S01008562,Owned: Owned with a mortgage or loan or shared ownership,57,52,40,6,34,11,1,5,5,0,0,0,0
S01008562,Rented or living rent free: Total,279,96,73,27,46,3,20,183,107,7,17,45,7
S01008562,Rented or living rent free: Social rented,266,87,64,24,40,3,20,179,105,7,17,43,7
S01008562,Rented or living rent free: Private rented or living rent free,13,9,9,3,6,0,0,4,2,0,0,2,0
S01008563,All HRPs aged 16 and over,369,228,193,27,166,20,15,141,78,3,23,23,14
S01008563,Owned: Total,203,151,135,13,122,15,1,52,47,2,1,0,2
S01008563,Owned: Owned outright,64,24,19,5,14,5,0,40,38,0,0,0,2
S01008563,Owned: Owned with a mortgage or loan or shared ownership,139,127,116,8,108,10,1,12,9,2,1,0,0
S01008563,Rented or living rent free: Total,166,77,58,14,44,5,14,89,31,1,22,23,12
S01008563,Rented or living rent free: Social rented,114,47,32,7,25,4,11,67,28,1,16,15,7
S01008563,Rented or living rent free: Private rented or living rent free,52,30,26,7,19,1,3,22,3,0,6,8,5
S01008564,All HRPs aged 16 and over,315,166,138,12,126,21,7,149,116,2,6,21,4
S01008564,Owned: Total,209,127,108,5,103,18,1,82,75,0,0,4,3
S01008564,Owned: Owned outright,91,28,22,1,21,6,0,63,60,0,0,1,2
S01008564,Owned: Owned with a mortgage or loan or shared ownership,118,99,86,4,82,12,1,19,15,0,0,3,1
S01008564,Rented or living rent free: Total,106,39,30,7,23,3,6,67,41,2,6,17,1
S01008564,Rented or living rent free: Social rented,68,12,8,3,5,0,4,56,37,0,5,14,0
S01008564,Rented or living rent free: Private rented or living rent free,38,27,22,4,18,3,2,11,4,2,1,3,1
S01008565,All HRPs aged 16 and over,414,224,179,53,126,23,22,190,113,9,22,36,10
S01008565,Owned: Total,200,114,97,15,82,17,0,86,78,0,3,4,1
S01008565,Owned: Owned outright,96,25,21,4,17,4,0,71,68,0,1,2,0
S01008565,Owned: Owned with a mortgage or loan or shared ownership,104,89,76,11,65,13,0,15,10,0,2,2,1
S01008565,Rented or living rent free: Total,214,110,82,38,44,6,22,104,35,9,19,32,9
S01008565,Rented or living rent free: Social rented,185,91,71,34,37,4,16,94,34,6,18,30,6
S01008565,Rented or living rent free: Private rented or living rent free,29,19,11,4,7,2,6,10,1,3,1,2,3
S01008566,All HRPs aged 16 and over,433,268,219,43,176,36,13,165,105,5,27,22,6
S01008566,Owned: Total,251,191,156,20,136,27,8,60,51,3,1,3,2
S01008566,Owned: Owned outright,78,37,28,9,19,6,3,41,39,1,0,1,0
S01008566,Owned: Owned with a mortgage or loan or shared ownership,173,154,128,11,117,21,5,19,12,2,1,2,2
S01008566,Rented or living rent free: Total,182,77,63,23,40,9,5,105,54,2,26,19,4
S01008566,Rented or living rent free: Social rented,140,57,48,18,30,4,5,83,47,2,14,17,3
S01008566,Rented or living rent free: Private rented or living rent free,42,20,15,5,10,5,0,22,7,0,12,2,1
S01008567,All HRPs aged 16 and over,289,177,150,19,131,19,8,112,67,7,9,20,9
S01008567,Owned: Total,158,119,103,11,92,15,1,39,32,2,1,4,0
S01008567,Owned: Owned outright,58,26,22,5,17,4,0,32,27,1,1,3,0
S01008567,Owned: Owned with a mortgage or loan or shared ownership,100,93,81,6,75,11,1,7,5,1,0,1,0
S01008567,Rented or living rent free: Total,131,58,47,8,39,4,7,73,35,5,8,16,9
S01008567,Rented or living rent free: Social rented,106,41,36,7,29,2,3,65,35,1,4,16,9
S01008567,Rented or living rent free: Private rented or living rent free,25,17,11,1,10,2,4,8,0,4,4,0,0
S01008568,All HRPs aged 16 and over,350,258,215,43,172,35,8,92,66,4,10,8,4
S01008568,Owned: Total,268,200,166,24,142,32,2,68,63,1,1,1,2
S01008568,Owned: Owned outright,90,31,25,9,16,5,1,59,57,1,0,0,1
S01008568,Owned: Owned with a mortgage or loan or shared ownership,178,169,141,15,126,27,1,9,6,0,1,1,1
S01008568,Rented or living rent free: Total,82,58,49,19,30,3,6,24,3,3,9,7,2
S01008568,Rented or living rent free: Social rented,15,9,6,3,3,1,2,6,1,0,1,4,0
S01008568,Rented or living rent free: Private rented or living rent free,67,49,43,16,27,2,4,18,2,3,8,3,2
S01008569,All HRPs aged 16 and over,400,249,160,49,111,26,63,151,33,18,25,52,23
S01008569,Owned: Total,48,34,23,3,20,8,3,14,13,0,1,0,0
S01008569,Owned: Owned outright,30,17,10,2,8,5,2,13,13,0,0,0,0
S01008569,Owned: Owned with a mortgage or loan or shared ownership,18,17,13,1,12,3,1,1,0,0,1,0,0
S01008569,Rented or living rent free: Total,352,215,137,46,91,18,60,137,20,18,24,52,23
S01008569,Rented or living rent free: Social rented,316,187,114,41,73,15,58,129,19,12,23,52,23
S01008569,Rented or living rent free: Private rented or living rent free,36,28,23,5,18,3,2,8,1,6,1,0,0
S01008570,All HRPs aged 16 and over,426,240,172,49,123,33,35,186,86,8,41,32,19
S01008570,Owned: Total,133,85,71,9,62,14,0,48,46,0,0,1,1
S01008570,Owned: Owned outright,57,18,14,3,11,4,0,39,38,0,0,1,0
S01008570,Owned: Owned with a mortgage or loan or shared ownership,76,67,57,6,51,10,0,9,8,0,0,0,1
S01008570,Rented or living rent free: Total,293,155,101,40,61,19,35,138,40,8,41,31,18
S01008570,Rented or living rent free: Social rented,261,131,81,36,45,16,34,130,40,7,37,30,16
S01008570,Rented or living rent free: Private rented or living rent free,32,24,20,4,16,3,1,8,0,1,4,1,2
S01008571,All HRPs aged 16 and over,323,167,131,40,91,29,7,156,125,3,9,17,2
S01008571,Owned: Total,207,121,95,18,77,26,0,86,83,2,0,1,0
S01008571,Owned: Owned outright,110,35,25,11,14,10,0,75,74,0,0,1,0
S01008571,Owned: Owned with a mortgage or loan or shared ownership,97,86,70,7,63,16,0,11,9,2,0,0,0
S01008571,Rented or living rent free: Total,116,46,36,22,14,3,7,70,42,1,9,16,2
S01008571,Rented or living rent free: Social rented,87,27,22,14,8,0,5,60,40,1,3,15,1
S01008571,Rented or living rent free: Private rented or living rent free,29,19,14,8,6,3,2,10,2,0,6,1,1
S01008572,All HRPs aged 16 and over,346,206,166,30,136,31,9,140,102,8,13,12,5
S01008572,Owned: Total,251,162,133,24,109,27,2,89,85,0,1,3,0
S01008572,Owned: Owned outright,107,30,26,11,15,3,1,77,74,0,0,3,0
S01008572,Owned: Owned with a mortgage or loan or shared ownership,144,132,107,13,94,24,1,12,11,0,1,0,0
S01008572,Rented or living rent free: Total,95,44,33,6,27,4,7,51,17,8,12,9,5
S01008572,Rented or living rent free: Social rented,44,18,12,3,9,2,4,26,9,0,6,8,3
S01008572,Rented or living rent free: Private rented or living rent free,51,26,21,3,18,2,3,25,8,8,6,1,2
S01008573,All HRPs aged 16 and over,321,240,184,21,163,51,5,81,61,3,9,5,3
S01008573,Owned: Total,275,217,168,17,151,48,1,58,50,1,3,2,2
S01008573,Owned: Owned outright,98,50,42,9,33,8,0,48,45,1,0,1,1
S01008573,Owned: Owned with a mortgage or loan or shared ownership,177,167,126,8,118,40,1,10,5,0,3,1,1
S01008573,Rented or living rent free: Total,46,23,16,4,12,3,4,23,11,2,6,3,1
S01008573,Rented or living rent free: Social rented,20,11,6,2,4,1,4,9,7,0,0,1,1
S01008573,Rented or living rent free: Private rented or living rent free,26,12,10,2,8,2,0,14,4,2,6,2,0
S01008574,All HRPs aged 16 and over,293,243,199,23,176,38,6,50,38,3,4,3,2
S01008574,Owned: Total,263,223,186,20,166,33,4,40,34,0,2,2,2
S01008574,Owned: Owned outright,93,61,51,11,40,9,1,32,29,0,1,1,1
S01008574,Owned: Owned with a mortgage or loan or shared ownership,170,162,135,9,126,24,3,8,5,0,1,1,1
S01008574,Rented or living rent free: Total,30,20,13,3,10,5,2,10,4,3,2,1,0
S01008574,Rented or living rent free: Social rented,7,3,1,1,0,0,2,4,2,0,1,1,0
S01008574,Rented or living rent free: Private rented or living rent free,23,17,12,2,10,5,0,6,2,3,1,0,0
S01008575,All HRPs aged 16 and over,335,232,185,23,162,42,5,103,89,4,6,2,2
S01008575,Owned: Total,298,209,170,19,151,38,1,89,83,1,2,1,2
S01008575,Owned: Owned outright,136,55,42,12,30,12,1,81,79,1,1,0,0
S01008575,Owned: Owned with a mortgage or loan or shared ownership,162,154,128,7,121,26,0,8,4,0,1,1,2
S01008575,Rented or living rent free: Total,37,23,15,4,11,4,4,14,6,3,4,1,0
S01008575,Rented or living rent free: Social rented,5,2,2,1,1,0,0,3,0,0,2,1,0
S01008575,Rented or living rent free: Private rented or living rent free,32,21,13,3,10,4,4,11,6,3,2,0,0
S01008576,All HRPs aged 16 and over,386,252,210,48,162,40,2,134,114,14,2,4,0
S01008576,Owned: Total,328,210,171,34,137,37,2,118,113,2,0,3,0
S01008576,Owned: Owned outright,175,73,58,23,35,15,0,102,99,1,0,2,0
S01008576,Owned: Owned with a mortgage or loan or shared ownership,153,137,113,11,102,22,2,16,14,1,0,1,0
S01008576,Rented or living rent free: Total,58,42,39,14,25,3,0,16,1,12,2,1,0
S01008576,Rented or living rent free: Social rented,7,4,3,3,0,1,0,3,0,0,2,1,0
S01008576,Rented or living rent free: Private rented or living rent free,51,38,36,11,25,2,0,13,1,12,0,0,0
S01008577,All HRPs aged 16 and over,363,208,156,16,140,50,2,155,143,3,3,5,1
S01008577,Owned: Total,328,189,140,14,126,49,0,139,135,0,1,2,1
S01008577,Owned: Owned outright,206,78,64,10,54,14,0,128,126,0,0,1,1
S01008577,Owned: Owned with a mortgage or loan or shared ownership,122,111,76,4,72,35,0,11,9,0,1,1,0
S01008577,Rented or living rent free: Total,35,19,16,2,14,1,2,16,8,3,2,3,0
S01008577,Rented or living rent free: Social rented,6,2,1,0,1,0,1,4,1,0,1,2,0
S01008577,Rented or living rent free: Private rented or living rent free,29,17,15,2,13,1,1,12,7,3,1,1,0
S01008578,All HRPs aged 16 and over,291,192,147,17,130,42,3,99,90,3,4,0,2
S01008578,Owned: Total,277,182,142,16,126,38,2,95,89,0,4,0,2
S01008578,Owned: Owned outright,164,76,59,12,47,15,2,88,86,0,0,0,2
S01008578,Owned: Owned with a mortgage or loan or shared ownership,113,106,83,4,79,23,0,7,3,0,4,0,0
S01008578,Rented or living rent free: Total,14,10,5,1,4,4,1,4,1,3,0,0,0
S01008578,Rented or living rent free: Social rented,3,3,1,1,0,1,1,0,0,0,0,0,0
S01008578,Rented or living rent free: Private rented or living rent free,11,7,4,0,4,3,0,4,1,3,0,0,0
S01008579,All HRPs aged 16 and over,301,162,128,18,110,32,2,139,129,1,2,6,1
S01008579,Owned: Total,268,142,110,13,97,30,2,126,122,0,0,4,0
S01008579,Owned: Owned outright,171,55,43,9,34,12,0,116,113,0,0,3,0
S01008579,Owned: Owned with a mortgage or loan or shared ownership,97,87,67,4,63,18,2,10,9,0,0,1,0
S01008579,Rented or living rent free: Total,33,20,18,5,13,2,0,13,7,1,2,2,1
S01008579,Rented or living rent free: Social rented,5,2,2,0,2,0,0,3,1,0,0,1,1
S01008579,Rented or living rent free: Private rented or living rent free,28,18,16,5,11,2,0,10,6,1,2,1,0
S01008580,All HRPs aged 16 and over,261,169,139,19,120,18,12,92,74,10,2,4,2
S01008580,Owned: Total,175,129,111,15,96,16,2,46,41,1,1,1,2
S01008580,Owned: Owned outright,77,38,33,6,27,4,1,39,35,1,0,1,2
S01008580,Owned: Owned with a mortgage or loan or shared ownership,98,91,78,9,69,12,1,7,6,0,1,0,0
S01008580,Rented or living rent free: Total,86,40,28,4,24,2,10,46,33,9,1,3,0
S01008580,Rented or living rent free: Social rented,40,5,3,0,3,0,2,35,32,0,0,3,0
S01008580,Rented or living rent free: Private rented or living rent free,46,35,25,4,21,2,8,11,1,9,1,0,0
S01008581,All HRPs aged 16 and over,464,256,213,42,171,27,16,208,149,9,13,27,10
S01008581,Owned: Total,248,156,135,23,112,20,1,92,77,1,3,5,6
S01008581,Owned: Owned outright,108,36,29,8,21,7,0,72,63,1,0,3,5
S01008581,Owned: Owned with a mortgage or loan or shared ownership,140,120,106,15,91,13,1,20,14,0,3,2,1
S01008581,Rented or living rent free: Total,216,100,78,19,59,7,15,116,72,8,10,22,4
S01008581,Rented or living rent free: Social rented,150,57,44,11,33,4,9,93,64,1,8,19,1
S01008581,Rented or living rent free: Private rented or living rent free,66,43,34,8,26,3,6,23,8,7,2,3,3
S01008582,All HRPs aged 16 and over,486,287,226,49,177,40,21,199,124,4,21,39,11
S01008582,Owned: Total,289,200,164,26,138,28,8,89,81,0,2,5,1
S01008582,Owned: Owned outright,120,52,37,12,25,10,5,68,66,0,0,1,1
S01008582,Owned: Owned with a mortgage or loan or shared ownership,169,148,127,14,113,18,3,21,15,0,2,4,0
S01008582,Rented or living rent free: Total,197,87,62,23,39,12,13,110,43,4,19,34,10
S01008582,Rented or living rent free: Social rented,136,53,37,16,21,7,9,83,34,0,11,30,8
S01008582,Rented or living rent free: Private rented or living rent free,61,34,25,7,18,5,4,27,9,4,8,4,2
S01008583,All HRPs aged 16 and over,352,189,160,31,129,23,6,163,112,18,7,18,8
S01008583,Owned: Total,196,121,103,13,90,18,0,75,63,5,0,2,5
S01008583,Owned: Owned outright,83,24,19,5,14,5,0,59,54,2,0,2,1
S01008583,Owned: Owned with a mortgage or loan or shared ownership,113,97,84,8,76,13,0,16,9,3,0,0,4
S01008583,Rented or living rent free: Total,156,68,57,18,39,5,6,88,49,13,7,16,3
S01008583,Rented or living rent free: Social rented,86,25,21,9,12,1,3,61,41,0,5,14,1
S01008583,Rented or living rent free: Private rented or living rent free,70,43,36,9,27,4,3,27,8,13,2,2,2
S01008584,All HRPs aged 16 and over,394,225,184,33,151,26,15,169,103,25,19,17,5
S01008584,Owned: Total,212,128,106,12,94,17,5,84,77,5,1,0,1
S01008584,Owned: Owned outright,104,42,32,5,27,7,3,62,57,3,1,0,1
S01008584,Owned: Owned with a mortgage or loan or shared ownership,108,86,74,7,67,10,2,22,20,2,0,0,0
S01008584,Rented or living rent free: Total,182,97,78,21,57,9,10,85,26,20,18,17,4
S01008584,Rented or living rent free: Social rented,86,36,29,10,19,1,6,50,17,2,12,15,4
S01008584,Rented or living rent free: Private rented or living rent free,96,61,49,11,38,8,4,35,9,18,6,2,0
S01008585,All HRPs aged 16 and over,249,149,136,31,105,8,5,100,69,3,12,15,1
S01008585,Owned: Total,155,101,94,18,76,5,2,54,48,1,1,3,1
S01008585,Owned: Owned outright,62,19,18,5,13,1,0,43,41,1,0,1,0
S01008585,Owned: Owned with a mortgage or loan or shared ownership,93,82,76,13,63,4,2,11,7,0,1,2,1
S01008585,Rented or living rent free: Total,94,48,42,13,29,3,3,46,21,2,11,12,0
S01008585,Rented or living rent free: Social rented,57,23,17,7,10,3,3,34,21,0,4,9,0
S01008585,Rented or living rent free: Private rented or living rent free,37,25,25,6,19,0,0,12,0,2,7,3,0
S01008586,All HRPs aged 16 and over,360,183,150,25,125,19,14,177,119,5,10,35,8
S01008586,Owned: Total,212,129,110,12,98,16,3,83,72,0,2,6,3
S01008586,Owned: Owned outright,97,35,27,7,20,8,0,62,56,0,0,4,2
S01008586,Owned: Owned with a mortgage or loan or shared ownership,115,94,83,5,78,8,3,21,16,0,2,2,1
S01008586,Rented or living rent free: Total,148,54,40,13,27,3,11,94,47,5,8,29,5
S01008586,Rented or living rent free: Social rented,105,29,21,5,16,1,7,76,45,1,5,21,4
S01008586,Rented or living rent free: Private rented or living rent free,43,25,19,8,11,2,4,18,2,4,3,8,1
S01008587,All HRPs aged 16 and over,316,202,163,30,133,31,8,114,96,8,1,1,8
S01008587,Owned: Total,262,164,128,25,103,31,5,98,91,1,1,1,4
S01008587,Owned: Owned outright,150,64,50,17,33,13,1,86,83,0,0,1,2
S01008587,Owned: Owned with a mortgage or loan or shared ownership,112,100,78,8,70,18,4,12,8,1,1,0,2
S01008587,Rented or living rent free: Total,54,38,35,5,30,0,3,16,5,7,0,0,4
S01008587,Rented or living rent free: Social rented,7,4,3,3,0,0,1,3,1,0,0,0,2
S01008587,Rented or living rent free: Private rented or living rent free,47,34,32,2,30,0,2,13,4,7,0,0,2
S01008588,All HRPs aged 16 and over,344,209,177,22,155,30,2,135,112,17,1,4,1
S01008588,Owned: Total,286,176,150,14,136,26,0,110,106,2,1,1,0
S01008588,Owned: Owned outright,158,55,45,8,37,10,0,103,100,1,1,1,0
S01008588,Owned: Owned with a mortgage or loan or shared ownership,128,121,105,6,99,16,0,7,6,1,0,0,0
S01008588,Rented or living rent free: Total,58,33,27,8,19,4,2,25,6,15,0,3,1
S01008588,Rented or living rent free: Social rented,4,1,1,1,0,0,0,3,1,0,0,1,1
S01008588,Rented or living rent free: Private rented or living rent free,54,32,26,7,19,4,2,22,5,15,0,2,0
S01008589,All HRPs aged 16 and over,172,96,77,9,68,16,3,76,73,1,1,1,0
S01008589,Owned: Total,123,85,68,4,64,16,1,38,38,0,0,0,0
S01008589,Owned: Owned outright,60,24,20,3,17,4,0,36,36,0,0,0,0
S01008589,Owned: Owned with a mortgage or loan or shared ownership,63,61,48,1,47,12,1,2,2,0,0,0,0
S01008589,Rented or living rent free: Total,49,11,9,5,4,0,2,38,35,1,1,1,0
S01008589,Rented or living rent free: Social rented,43,7,5,3,2,0,2,36,35,0,0,1,0
S01008589,Rented or living rent free: Private rented or living rent free,6,4,4,2,2,0,0,2,0,1,1,0,0
S01008590,All HRPs aged 16 and over,413,199,177,22,155,19,3,214,173,28,2,5,6
S01008590,Owned: Total,315,135,117,9,108,17,1,180,165,7,1,1,6
S01008590,Owned: Owned outright,201,36,30,6,24,5,1,165,151,7,1,0,6
S01008590,Owned: Owned with a mortgage or loan or shared ownership,114,99,87,3,84,12,0,15,14,0,0,1,0
S01008590,Rented or living rent free: Total,98,64,60,13,47,2,2,34,8,21,1,4,0
S01008590,Rented or living rent free: Social rented,11,2,1,0,1,0,1,9,5,0,0,4,0
S01008590,Rented or living rent free: Private rented or living rent free,87,62,59,13,46,2,1,25,3,21,1,0,0
S01008591,All HRPs aged 16 and over,327,232,194,36,158,32,6,95,65,18,2,8,2
S01008591,Owned: Total,238,171,142,23,119,26,3,67,61,2,0,3,1
S01008591,Owned: Owned outright,109,46,37,13,24,8,1,63,59,2,0,1,1
S01008591,Owned: Owned with a mortgage or loan or shared ownership,129,125,105,10,95,18,2,4,2,0,0,2,0
S01008591,Rented or living rent free: Total,89,61,52,13,39,6,3,28,4,16,2,5,1
S01008591,Rented or living rent free: Social rented,15,7,6,2,4,1,0,8,4,2,0,2,0
S01008591,Rented or living rent free: Private rented or living rent free,74,54,46,11,35,5,3,20,0,14,2,3,1
S01008592,All HRPs aged 16 and over,356,196,163,32,131,28,5,160,102,23,14,15,6
S01008592,Owned: Total,228,136,115,14,101,21,0,92,78,5,2,3,4
S01008592,Owned: Owned outright,119,40,38,7,31,2,0,79,69,4,2,2,2
S01008592,Owned: Owned with a mortgage or loan or shared ownership,109,96,77,7,70,19,0,13,9,1,0,1,2
S01008592,Rented or living rent free: Total,128,60,48,18,30,7,5,68,24,18,12,12,2
S01008592,Rented or living rent free: Social rented,49,9,6,3,3,2,1,40,18,0,9,11,2
S01008592,Rented or living rent free: Private rented or living rent free,79,51,42,15,27,5,4,28,6,18,3,1,0
S01008593,All HRPs aged 16 and over,309,207,154,17,137,52,1,102,94,3,2,1,2
S01008593,Owned: Total,285,190,140,14,126,50,0,95,92,0,2,0,1
S01008593,Owned: Owned outright,164,75,50,11,39,25,0,89,88,0,1,0,0
S01008593,Owned: Owned with a mortgage or loan or shared ownership,121,115,90,3,87,25,0,6,4,0,1,0,1
S01008593,Rented or living rent free: Total,24,17,14,3,11,2,1,7,2,3,0,1,1
S01008593,Rented or living rent free: Social rented,5,3,2,1,1,1,0,2,0,0,0,1,1
S01008593,Rented or living rent free: Private rented or living rent free,19,14,12,2,10,1,1,5,2,3,0,0,0
S01008594,All HRPs aged 16 and over,428,290,226,22,204,56,8,138,114,17,4,2,1
S01008594,Owned: Total,335,221,168,13,155,48,5,114,106,6,1,0,1
S01008594,Owned: Owned outright,185,89,63,8,55,24,2,96,89,5,1,0,1
S01008594,Owned: Owned with a mortgage or loan or shared ownership,150,132,105,5,100,24,3,18,17,1,0,0,0
S01008594,Rented or living rent free: Total,93,69,58,9,49,8,3,24,8,11,3,2,0
S01008594,Rented or living rent free: Social rented,11,6,3,1,2,1,2,5,2,0,1,2,0
S01008594,Rented or living rent free: Private rented or living rent free,82,63,55,8,47,7,1,19,6,11,2,0,0
S01008595,All HRPs aged 16 and over,508,243,212,40,172,16,15,265,175,22,12,44,12
S01008595,Owned: Total,207,133,117,15,102,13,3,74,67,4,0,3,0
S01008595,Owned: Owned outright,104,43,37,8,29,4,2,61,56,4,0,1,0
S01008595,Owned: Owned with a mortgage or loan or shared ownership,103,90,80,7,73,9,1,13,11,0,0,2,0
S01008595,Rented or living rent free: Total,301,110,95,25,70,3,12,191,108,18,12,41,12
S01008595,Rented or living rent free: Social rented,212,52,41,15,26,2,9,160,103,4,8,37,8
S01008595,Rented or living rent free: Private rented or living rent free,89,58,54,10,44,1,3,31,5,14,4,4,4
S01008596,All HRPs aged 16 and over,455,248,198,38,160,24,26,207,123,22,17,33,12
S01008596,Owned: Total,204,120,102,13,89,15,3,84,72,3,0,3,6
S01008596,Owned: Owned outright,99,33,25,8,17,7,1,66,61,0,0,3,2
S01008596,Owned: Owned with a mortgage or loan or shared ownership,105,87,77,5,72,8,2,18,11,3,0,0,4
S01008596,Rented or living rent free: Total,251,128,96,25,71,9,23,123,51,19,17,30,6
S01008596,Rented or living rent free: Social rented,122,43,31,5,26,4,8,79,42,0,7,28,2
S01008596,Rented or living rent free: Private rented or living rent free,129,85,65,20,45,5,15,44,9,19,10,2,4
S01008597,All HRPs aged 16 and over,388,238,190,23,167,46,2,150,136,3,8,2,1
S01008597,Owned: Total,337,209,168,18,150,40,1,128,123,2,1,1,1
S01008597,Owned: Owned outright,195,75,58,11,47,16,1,120,118,1,0,1,0
S01008597,Owned: Owned with a mortgage or loan or shared ownership,142,134,110,7,103,24,0,8,5,1,1,0,1
S01008597,Rented or living rent free: Total,51,29,22,5,17,6,1,22,13,1,7,1,0
S01008597,Rented or living rent free: Social rented,8,1,1,0,1,0,0,7,6,0,0,1,0
S01008597,Rented or living rent free: Private rented or living rent free,43,28,21,5,16,6,1,15,7,1,7,0,0
S01008598,All HRPs aged 16 and over,329,203,170,54,116,20,13,126,65,47,5,8,1
S01008598,Owned: Total,157,102,82,11,71,17,3,55,47,5,2,0,1
S01008598,Owned: Owned outright,70,27,22,3,19,5,0,43,42,1,0,0,0
S01008598,Owned: Owned with a mortgage or loan or shared ownership,87,75,60,8,52,12,3,12,5,4,2,0,1
S01008598,Rented or living rent free: Total,172,101,88,43,45,3,10,71,18,42,3,8,0
S01008598,Rented or living rent free: Social rented,34,11,11,4,7,0,0,23,15,1,1,6,0
S01008598,Rented or living rent free: Private rented or living rent free,138,90,77,39,38,3,10,48,3,41,2,2,0
S01008599,All HRPs aged 16 and over,366,261,207,40,167,46,8,105,64,29,5,2,5
S01008599,Owned: Total,246,180,137,18,119,41,2,66,56,4,3,1,2
S01008599,Owned: Owned outright,117,56,37,7,30,17,2,61,55,2,2,0,2
S01008599,Owned: Owned with a mortgage or loan or shared ownership,129,124,100,11,89,24,0,5,1,2,1,1,0
S01008599,Rented or living rent free: Total,120,81,70,22,48,5,6,39,8,25,2,1,3
S01008599,Rented or living rent free: Social rented,8,4,2,2,0,1,1,4,1,0,0,1,2
S01008599,Rented or living rent free: Private rented or living rent free,112,77,68,20,48,4,5,35,7,25,2,0,1
S01008600,All HRPs aged 16 and over,306,196,139,22,117,49,8,110,60,38,3,6,3
S01008600,Owned: Total,192,134,93,9,84,39,2,58,54,3,0,0,1
S01008600,Owned: Owned outright,101,47,23,5,18,22,2,54,51,3,0,0,0
S01008600,Owned: Owned with a mortgage or loan or shared ownership,91,87,70,4,66,17,0,4,3,0,0,0,1
S01008600,Rented or living rent free: Total,114,62,46,13,33,10,6,52,6,35,3,6,2
S01008600,Rented or living rent free: Social rented,16,9,4,0,4,2,3,7,0,3,0,4,0
S01008600,Rented or living rent free: Private rented or living rent free,98,53,42,13,29,8,3,45,6,32,3,2,2
S01008601,All HRPs aged 16 and over,314,200,170,59,111,19,11,114,45,54,0,9,6
S01008601,Owned: Total,117,82,66,9,57,13,3,35,25,7,0,1,2
S01008601,Owned: Owned outright,67,38,29,6,23,7,2,29,21,6,0,1,1
S01008601,Owned: Owned with a mortgage or loan or shared ownership,50,44,37,3,34,6,1,6,4,1,0,0,1
S01008601,Rented or living rent free: Total,197,118,104,50,54,6,8,79,20,47,0,8,4
S01008601,Rented or living rent free: Social rented,28,3,1,1,0,2,0,25,16,0,0,8,1
S01008601,Rented or living rent free: Private rented or living rent free,169,115,103,49,54,4,8,54,4,47,0,0,3
S01008602,All HRPs aged 16 and over,323,211,172,40,132,28,11,112,43,52,2,10,5
S01008602,Owned: Total,150,100,73,13,60,22,5,50,35,12,0,2,1
S01008602,Owned: Owned outright,70,31,21,5,16,8,2,39,32,5,0,1,1
S01008602,Owned: Owned with a mortgage or loan or shared ownership,80,69,52,8,44,14,3,11,3,7,0,1,0
S01008602,Rented or living rent free: Total,173,111,99,27,72,6,6,62,8,40,2,8,4
S01008602,Rented or living rent free: Social rented,24,11,10,2,8,0,1,13,4,0,1,8,0
S01008602,Rented or living rent free: Private rented or living rent free,149,100,89,25,64,6,5,49,4,40,1,0,4
S01008603,All HRPs aged 16 and over,544,356,292,76,216,37,27,188,47,110,4,18,9
S01008603,Owned: Total,196,145,124,17,107,21,0,51,24,22,1,3,1
S01008603,Owned: Owned outright,74,46,39,9,30,7,0,28,20,6,1,1,0
S01008603,Owned: Owned with a mortgage or loan or shared ownership,122,99,85,8,77,14,0,23,4,16,0,2,1
S01008603,Rented or living rent free: Total,348,211,168,59,109,16,27,137,23,88,3,15,8
S01008603,Rented or living rent free: Social rented,59,19,10,0,10,0,9,40,16,3,1,14,6
S01008603,Rented or living rent free: Private rented or living rent free,289,192,158,59,99,16,18,97,7,85,2,1,2
S01008604,All HRPs aged 16 and over,418,287,223,41,182,51,13,131,61,58,2,7,3
S01008604,Owned: Total,212,147,105,15,90,40,2,65,53,6,1,4,1
S01008604,Owned: Owned outright,102,50,34,6,28,15,1,52,47,0,1,3,1
S01008604,Owned: Owned with a mortgage or loan or shared ownership,110,97,71,9,62,25,1,13,6,6,0,1,0
S01008604,Rented or living rent free: Total,206,140,118,26,92,11,11,66,8,52,1,3,2
S01008604,Rented or living rent free: Social rented,9,3,2,0,2,1,0,6,3,2,0,1,0
S01008604,Rented or living rent free: Private rented or living rent free,197,137,116,26,90,10,11,60,5,50,1,2,2
S01008605,All HRPs aged 16 and over,337,243,201,33,168,34,8,94,42,44,4,2,2
S01008605,Owned: Total,177,128,102,10,92,25,1,49,40,7,0,0,2
S01008605,Owned: Owned outright,83,42,33,5,28,9,0,41,37,3,0,0,1
S01008605,Owned: Owned with a mortgage or loan or shared ownership,94,86,69,5,64,16,1,8,3,4,0,0,1
S01008605,Rented or living rent free: Total,160,115,99,23,76,9,7,45,2,37,4,2,0
S01008605,Rented or living rent free: Social rented,9,2,0,0,0,0,2,7,0,6,0,1,0
S01008605,Rented or living rent free: Private rented or living rent free,151,113,99,23,76,9,5,38,2,31,4,1,0
S01008606,All HRPs aged 16 and over,287,207,158,22,136,47,2,80,66,11,2,1,0
S01008606,Owned: Total,222,161,120,16,104,41,0,61,60,1,0,0,0
S01008606,Owned: Owned outright,118,62,40,9,31,22,0,56,56,0,0,0,0
S01008606,Owned: Owned with a mortgage or loan or shared ownership,104,99,80,7,73,19,0,5,4,1,0,0,0
S01008606,Rented or living rent free: Total,65,46,38,6,32,6,2,19,6,10,2,1,0
S01008606,Rented or living rent free: Social rented,8,2,1,1,0,1,0,6,5,0,1,0,0
S01008606,Rented or living rent free: Private rented or living rent free,57,44,37,5,32,5,2,13,1,10,1,1,0
S01008607,All HRPs aged 16 and over,283,164,112,13,99,48,4,119,111,3,2,2,1
S01008607,Owned: Total,225,145,97,11,86,47,1,80,79,0,1,0,0
S01008607,Owned: Owned outright,147,73,40,8,32,32,1,74,73,0,1,0,0
S01008607,Owned: Owned with a mortgage or loan or shared ownership,78,72,57,3,54,15,0,6,6,0,0,0,0
S01008607,Rented or living rent free: Total,58,19,15,2,13,1,3,39,32,3,1,2,1
S01008607,Rented or living rent free: Social rented,37,7,5,0,5,0,2,30,28,0,1,1,0
S01008607,Rented or living rent free: Private rented or living rent free,21,12,10,2,8,1,1,9,4,3,0,1,1
S01008608,All HRPs aged 16 and over,326,187,147,18,129,38,2,139,124,10,1,1,3
S01008608,Owned: Total,285,157,120,11,109,35,2,128,120,3,1,1,3
S01008608,Owned: Owned outright,191,71,50,9,41,19,2,120,114,3,1,0,2
S01008608,Owned: Owned with a mortgage or loan or shared ownership,94,86,70,2,68,16,0,8,6,0,0,1,1
S01008608,Rented or living rent free: Total,41,30,27,7,20,3,0,11,4,7,0,0,0
S01008608,Rented or living rent free: Social rented,0,0,0,0,0,0,0,0,0,0,0,0,0
S01008608,Rented or living rent free: Private rented or living rent free,41,30,27,7,20,3,0,11,4,7,0,0,0
S01008609,All HRPs aged 16 and over,410,241,176,21,155,62,3,169,146,13,1,3,6
S01008609,Owned: Total,337,206,149,18,131,55,2,131,124,2,0,1,4
S01008609,Owned: Owned outright,195,88,60,11,49,28,0,107,103,1,0,1,2
S01008609,Owned: Owned with a mortgage or loan or shared ownership,142,118,89,7,82,27,2,24,21,1,0,0,2
S01008609,Rented or living rent free: Total,73,35,27,3,24,7,1,38,22,11,1,2,2
S01008609,Rented or living rent free: Social rented,31,9,5,2,3,4,0,22,18,0,0,2,2
S01008609,Rented or living rent free: Private rented or living rent free,42,26,22,1,21,3,1,16,4,11,1,0,0
S01008610,All HRPs aged 16 and over,416,203,152,27,125,49,2,213,188,20,1,1,3
S01008610,Owned: Total,316,145,101,9,92,42,2,171,162,5,1,0,3
S01008610,Owned: Owned outright,220,63,36,6,30,26,1,157,153,1,1,0,2
S01008610,Owned: Owned with a mortgage or loan or shared ownership,96,82,65,3,62,16,1,14,9,4,0,0,1
S01008610,Rented or living rent free: Total,100,58,51,18,33,7,0,42,26,15,0,1,0
S01008610,Rented or living rent free: Social rented,13,2,1,1,0,1,0,11,11,0,0,0,0
S01008610,Rented or living rent free: Private rented or living rent free,87,56,50,17,33,6,0,31,15,15,0,1,0
S01008611,All HRPs aged 16 and over,592,400,326,73,253,47,27,192,66,101,4,10,11
S01008611,Owned: Total,247,170,133,18,115,31,6,77,58,10,4,1,4
S01008611,Owned: Owned outright,126,62,41,10,31,18,3,64,54,4,1,1,4
S01008611,Owned: Owned with a mortgage or loan or shared ownership,121,108,92,8,84,13,3,13,4,6,3,0,0
S01008611,Rented or living rent free: Total,345,230,193,55,138,16,21,115,8,91,0,9,7
S01008611,Rented or living rent free: Social rented,12,5,5,2,3,0,0,7,1,0,0,6,0
S01008611,Rented or living rent free: Private rented or living rent free,333,225,188,53,135,16,21,108,7,91,0,3,7
S01008612,All HRPs aged 16 and over,376,256,218,54,164,23,15,120,36,68,2,12,2
S01008612,Owned: Total,106,79,69,14,55,8,2,27,20,5,1,0,1
S01008612,Owned: Owned outright,47,25,20,5,15,4,1,22,18,2,1,0,1
S01008612,Owned: Owned with a mortgage or loan or shared ownership,59,54,49,9,40,4,1,5,2,3,0,0,0
S01008612,Rented or living rent free: Total,270,177,149,40,109,15,13,93,16,63,1,12,1
S01008612,Rented or living rent free: Social rented,44,20,18,2,16,0,2,24,14,2,0,7,1
S01008612,Rented or living rent free: Private rented or living rent free,226,157,131,38,93,15,11,69,2,61,1,5,0
S01008613,All HRPs aged 16 and over,371,232,185,50,135,39,8,139,71,54,0,9,5
S01008613,Owned: Total,214,137,104,21,83,31,2,77,67,5,0,2,3
S01008613,Owned: Owned outright,138,66,48,13,35,18,0,72,64,4,0,1,3
S01008613,Owned: Owned with a mortgage or loan or shared ownership,76,71,56,8,48,13,2,5,3,1,0,1,0
S01008613,Rented or living rent free: Total,157,95,81,29,52,8,6,62,4,49,0,7,2
S01008613,Rented or living rent free: Social rented,12,4,2,0,2,0,2,8,3,0,0,4,1
S01008613,Rented or living rent free: Private rented or living rent free,145,91,79,29,50,8,4,54,1,49,0,3,1
S01008614,All HRPs aged 16 and over,307,191,161,50,111,19,11,116,45,58,0,11,2
S01008614,Owned: Total,92,64,51,6,45,12,1,28,22,3,0,3,0
S01008614,Owned: Owned outright,47,24,16,4,12,7,1,23,21,0,0,2,0
S01008614,Owned: Owned with a mortgage or loan or shared ownership,45,40,35,2,33,5,0,5,1,3,0,1,0
S01008614,Rented or living rent free: Total,215,127,110,44,66,7,10,88,23,55,0,8,2
S01008614,Rented or living rent free: Social rented,33,7,4,1,3,0,3,26,21,0,0,3,2
S01008614,Rented or living rent free: Private rented or living rent free,182,120,106,43,63,7,7,62,2,55,0,5,0
S01008615,All HRPs aged 16 and over,331,233,191,58,133,34,8,98,36,49,2,6,5
S01008615,Owned: Total,156,115,88,8,80,25,2,41,31,6,2,1,1
S01008615,Owned: Owned outright,75,41,33,4,29,7,1,34,30,2,2,0,0
S01008615,Owned: Owned with a mortgage or loan or shared ownership,81,74,55,4,51,18,1,7,1,4,0,1,1
S01008615,Rented or living rent free: Total,175,118,103,50,53,9,6,57,5,43,0,5,4
S01008615,Rented or living rent free: Social rented,14,5,3,2,1,2,0,9,4,0,0,4,1
S01008615,Rented or living rent free: Private rented or living rent free,161,113,100,48,52,7,6,48,1,43,0,1,3
S01008616,All HRPs aged 16 and over,259,190,158,59,99,28,4,69,15,51,1,1,1
S01008616,Owned: Total,103,81,63,10,53,17,1,22,15,5,1,0,1
S01008616,Owned: Owned outright,47,27,15,3,12,11,1,20,15,3,1,0,1
S01008616,Owned: Owned with a mortgage or loan or shared ownership,56,54,48,7,41,6,0,2,0,2,0,0,0
S01008616,Rented or living rent free: Total,156,109,95,49,46,11,3,47,0,46,0,1,0
S01008616,Rented or living rent free: Social rented,0,0,0,0,0,0,0,0,0,0,0,0,0
S01008616,Rented or living rent free: Private rented or living rent free,156,109,95,49,46,11,3,47,0,46,0,1,0
S01008617,All HRPs aged 16 and over,281,185,141,50,91,31,13,96,31,59,2,3,1
S01008617,Owned: Total,127,88,72,10,62,15,1,39,28,7,2,1,1
S01008617,Owned: Owned outright,61,32,26,6,20,5,1,29,26,1,1,0,1
S01008617,Owned: Owned with a mortgage or loan or shared ownership,66,56,46,4,42,10,0,10,2,6,1,1,0
S01008617,Rented or living rent free: Total,154,97,69,40,29,16,12,57,3,52,0,2,0
S01008617,Rented or living rent free: Social rented,3,1,1,0,1,0,0,2,1,0,0,1,0
S01008617,Rented or living rent free: Private rented or living rent free,151,96,68,40,28,16,12,55,2,52,0,1,0
S01008618,All HRPs aged 16 and over,267,183,154,62,92,18,11,84,23,56,1,0,4
S01008618,Owned: Total,107,73,61,7,54,12,0,34,22,8,0,0,4
S01008618,Owned: Owned outright,46,22,16,2,14,6,0,24,21,1,0,0,2
S01008618,Owned: Owned with a mortgage or loan or shared ownership,61,51,45,5,40,6,0,10,1,7,0,0,2
S01008618,Rented or living rent free: Total,160,110,93,55,38,6,11,50,1,48,1,0,0
S01008618,Rented or living rent free: Social rented,0,0,0,0,0,0,0,0,0,0,0,0,0
S01008618,Rented or living rent free: Private rented or living rent free,160,110,93,55,38,6,11,50,1,48,1,0,0
S01008619,All HRPs aged 16 and over,203,157,126,33,93,23,8,46,24,17,2,1,2
S01008619,Owned: Total,105,78,59,7,52,16,3,27,22,2,1,1,1
S01008619,Owned: Owned outright,62,37,27,4,23,9,1,25,21,1,1,1,1
S01008619,Owned: Owned with a mortgage or loan or shared ownership,43,41,32,3,29,7,2,2,1,1,0,0,0
S01008619,Rented or living rent free: Total,98,79,67,26,41,7,5,19,2,15,1,0,1
S01008619,Rented or living rent free: Social rented,1,0,0,0,0,0,0,1,0,0,0,0,1
S01008619,Rented or living rent free: Private rented or living rent free,97,79,67,26,41,7,5,18,2,15,1,0,0
S01008620,All HRPs aged 16 and over,290,209,167,54,113,29,13,81,15,56,3,5,2
S01008620,Owned: Total,119,95,72,9,63,19,4,24,14,4,2,2,2
S01008620,Owned: Owned outright,49,32,22,6,16,7,3,17,13,0,1,2,1
S01008620,Owned: Owned with a mortgage or loan or shared ownership,70,63,50,3,47,12,1,7,1,4,1,0,1
S01008620,Rented or living rent free: Total,171,114,95,45,50,10,9,57,1,52,1,3,0
S01008620,Rented or living rent free: Social rented,9,1,1,0,1,0,0,8,0,4,1,3,0
S01008620,Rented or living rent free: Private rented or living rent free,162,113,94,45,49,10,9,49,1,48,0,0,0
S01008621,All HRPs aged 16 and over,272,200,149,62,87,39,12,72,18,48,3,0,3
S01008621,Owned: Total,120,90,66,16,50,19,5,30,16,9,2,0,3
S01008621,Owned: Owned outright,54,33,21,6,15,9,3,21,13,5,0,0,3
S01008621,Owned: Owned with a mortgage or loan or shared ownership,66,57,45,10,35,10,2,9,3,4,2,0,0
S01008621,Rented or living rent free: Total,152,110,83,46,37,20,7,42,2,39,1,0,0
S01008621,Rented or living rent free: Social rented,3,2,2,2,0,0,0,1,1,0,0,0,0
S01008621,Rented or living rent free: Private rented or living rent free,149,108,81,44,37,20,7,41,1,39,1,0,0
S01008622,All HRPs aged 16 and over,200,146,113,26,87,24,9,54,28,23,2,0,1
S01008622,Owned: Total,116,84,64,10,54,17,3,32,28,2,2,0,0
S01008622,Owned: Owned outright,72,43,29,7,22,12,2,29,26,1,2,0,0
S01008622,Owned: Owned with a mortgage or loan or shared ownership,44,41,35,3,32,5,1,3,2,1,0,0,0
S01008622,Rented or living rent free: Total,84,62,49,16,33,7,6,22,0,21,0,0,1
S01008622,Rented or living rent free: Social rented,0,0,0,0,0,0,0,0,0,0,0,0,0
S01008622,Rented or living rent free: Private rented or living rent free,84,62,49,16,33,7,6,22,0,21,0,0,1
S01008623,All HRPs aged 16 and over,343,231,168,55,113,52,11,112,86,20,2,2,2
S01008623,Owned: Total,221,138,98,20,78,36,4,83,74,5,2,0,2
S01008623,Owned: Owned outright,130,60,38,12,26,19,3,70,65,3,0,0,2
S01008623,Owned: Owned with a mortgage or loan or shared ownership,91,78,60,8,52,17,1,13,9,2,2,0,0
S01008623,Rented or living rent free: Total,122,93,70,35,35,16,7,29,12,15,0,2,0
S01008623,Rented or living rent free: Social rented,3,0,0,0,0,0,0,3,2,0,0,1,0
S01008623,Rented or living rent free: Private rented or living rent free,119,93,70,35,35,16,7,26,10,15,0,1,0
S01008624,All HRPs aged 16 and over,346,171,125,14,111,44,2,175,164,6,1,2,2
S01008624,Owned: Total,262,147,107,9,98,39,1,115,110,2,1,1,1
S01008624,Owned: Owned outright,180,71,49,8,41,21,1,109,104,2,1,1,1
S01008624,Owned: Owned with a mortgage or loan or shared ownership,82,76,58,1,57,18,0,6,6,0,0,0,0
S01008624,Rented or living rent free: Total,84,24,18,5,13,5,1,60,54,4,0,1,1
S01008624,Rented or living rent free: Social rented,49,4,2,1,1,1,1,45,44,0,0,1,0
S01008624,Rented or living rent free: Private rented or living rent free,35,20,16,4,12,4,0,15,10,4,0,0,1
S01008625,All HRPs aged 16 and over,239,155,110,14,96,42,3,84,74,4,4,2,0
S01008625,Owned: Total,206,138,95,11,84,40,3,68,65,0,2,1,0
S01008625,Owned: Owned outright,131,65,40,5,35,22,3,66,63,0,2,1,0
S01008625,Owned: Owned with a mortgage or loan or shared ownership,75,73,55,6,49,18,0,2,2,0,0,0,0
S01008625,Rented or living rent free: Total,33,17,15,3,12,2,0,16,9,4,2,1,0
S01008625,Rented or living rent free: Social rented,15,5,4,1,3,1,0,10,9,0,0,1,0
S01008625,Rented or living rent free: Private rented or living rent free,18,12,11,2,9,1,0,6,0,4,2,0,0
S01008626,All HRPs aged 16 and over,388,286,230,27,203,56,0,102,78,13,2,4,5
S01008626,Owned: Total,296,219,172,19,153,47,0,77,71,2,1,0,3
S01008626,Owned: Owned outright,152,84,60,11,49,24,0,68,65,0,1,0,2
S01008626,Owned: Owned with a mortgage or loan or shared ownership,144,135,112,8,104,23,0,9,6,2,0,0,1
S01008626,Rented or living rent free: Total,92,67,58,8,50,9,0,25,7,11,1,4,2
S01008626,Rented or living rent free: Social rented,4,1,0,0,0,1,0,3,0,0,0,3,0
S01008626,Rented or living rent free: Private rented or living rent free,88,66,58,8,50,8,0,22,7,11,1,1,2
S01008627,All HRPs aged 16 and over,256,184,134,17,117,48,2,72,55,8,4,1,4
S01008627,Owned: Total,224,166,120,14,106,44,2,58,52,1,2,0,3
S01008627,Owned: Owned outright,113,60,39,11,28,20,1,53,49,1,2,0,1
S01008627,Owned: Owned with a mortgage or loan or shared ownership,111,106,81,3,78,24,1,5,3,0,0,0,2
S01008627,Rented or living rent free: Total,32,18,14,3,11,4,0,14,3,7,2,1,1
S01008627,Rented or living rent free: Social rented,2,1,0,0,0,1,0,1,1,0,0,0,0
S01008627,Rented or living rent free: Private rented or living rent free,30,17,14,3,11,3,0,13,2,7,2,1,1
S01008628,All HRPs aged 16 and over,262,199,164,27,137,33,2,63,44,11,3,5,0
S01008628,Owned: Total,166,121,100,15,85,20,1,45,40,4,0,1,0
S01008628,Owned: Owned outright,87,42,36,10,26,5,1,45,40,4,0,1,0
S01008628,Owned: Owned with a mortgage or loan or shared ownership,79,79,64,5,59,15,0,0,0,0,0,0,0
S01008628,Rented or living rent free: Total,96,78,64,12,52,13,1,18,4,7,3,4,0
S01008628,Rented or living rent free: Social rented,7,3,3,1,2,0,0,4,0,0,1,3,0
S01008628,Rented or living rent free: Private rented or living rent free,89,75,61,11,50,13,1,14,4,7,2,1,0
S01008629,All HRPs aged 16 and over,301,206,172,27,145,28,6,95,65,15,2,10,3
S01008629,Owned: Total,182,119,100,8,92,17,2,63,56,1,1,3,2
S01008629,Owned: Owned outright,115,57,46,5,41,9,2,58,52,1,0,3,2
S01008629,Owned: Owned with a mortgage or loan or shared ownership,67,62,54,3,51,8,0,5,4,0,1,0,0
S01008629,Rented or living rent free: Total,119,87,72,19,53,11,4,32,9,14,1,7,1
S01008629,Rented or living rent free: Social rented,33,17,12,7,5,2,3,16,7,1,0,7,1
S01008629,Rented or living rent free: Private rented or living rent free,86,70,60,12,48,9,1,16,2,13,1,0,0
S01008630,All HRPs aged 16 and over,277,195,164,28,136,21,10,82,54,18,4,4,2
S01008630,Owned: Total,153,93,79,8,71,13,1,60,52,4,2,1,1
S01008630,Owned: Owned outright,77,23,22,4,18,1,0,54,49,1,2,1,1
S01008630,Owned: Owned with a mortgage or loan or shared ownership,76,70,57,4,53,12,1,6,3,3,0,0,0
S01008630,Rented or living rent free: Total,124,102,85,20,65,8,9,22,2,14,2,3,1
S01008630,Rented or living rent free: Social rented,1,1,0,0,0,0,1,0,0,0,0,0,0
S01008630,Rented or living rent free: Private rented or living rent free,123,101,85,20,65,8,8,22,2,14,2,3,1
S01008631,All HRPs aged 16 and over,453,350,300,39,261,39,11,103,54,25,6,14,4
S01008631,Owned: Total,247,187,163,16,147,20,4,60,47,10,0,2,1
S01008631,Owned: Owned outright,109,58,45,11,34,10,3,51,42,7,0,1,1
S01008631,Owned: Owned with a mortgage or loan or shared ownership,138,129,118,5,113,10,1,9,5,3,0,1,0
S01008631,Rented or living rent free: Total,206,163,137,23,114,19,7,43,7,15,6,12,3
S01008631,Rented or living rent free: Social rented,11,3,2,0,2,1,0,8,2,0,1,5,0
S01008631,Rented or living rent free: Private rented or living rent free,195,160,135,23,112,18,7,35,5,15,5,7,3
S01008632,All HRPs aged 16 and over,420,328,265,33,232,44,19,92,73,11,2,6,0
S01008632,Owned: Total,233,168,136,18,118,31,1,65,62,0,0,3,0
S01008632,Owned: Owned outright,99,41,30,10,20,11,0,58,56,0,0,2,0
S01008632,Owned: Owned with a mortgage or loan or shared ownership,134,127,106,8,98,20,1,7,6,0,0,1,0
S01008632,Rented or living rent free: Total,187,160,129,15,114,13,18,27,11,11,2,3,0
S01008632,Rented or living rent free: Social rented,10,7,3,0,3,0,4,3,0,1,0,2,0
S01008632,Rented or living rent free: Private rented or living rent free,177,153,126,15,111,13,14,24,11,10,2,1,0
S01008633,All HRPs aged 16 and over,452,234,171,27,144,56,7,218,192,17,4,3,2
S01008633,Owned: Total,358,178,123,14,109,52,3,180,172,4,2,1,1
S01008633,Owned: Owned outright,244,77,51,9,42,23,3,167,161,3,1,1,1
S01008633,Owned: Owned with a mortgage or loan or shared ownership,114,101,72,5,67,29,0,13,11,1,1,0,0
S01008633,Rented or living rent free: Total,94,56,48,13,35,4,4,38,20,13,2,2,1
S01008633,Rented or living rent free: Social rented,20,4,2,1,1,0,2,16,13,1,1,1,0
S01008633,Rented or living rent free: Private rented or living rent free,74,52,46,12,34,4,2,22,7,12,1,1,1
S01008634,All HRPs aged 16 and over,276,190,138,25,113,46,6,86,68,8,3,2,5
S01008634,Owned: Total,210,137,97,12,85,37,3,73,63,1,3,1,5
S01008634,Owned: Owned outright,121,55,38,9,29,15,2,66,60,0,2,1,3
S01008634,Owned: Owned with a mortgage or loan or shared ownership,89,82,59,3,56,22,1,7,3,1,1,0,2
S01008634,Rented or living rent free: Total,66,53,41,13,28,9,3,13,5,7,0,1,0
S01008634,Rented or living rent free: Social rented,4,2,2,0,2,0,0,2,1,0,0,1,0
S01008634,Rented or living rent free: Private rented or living rent free,62,51,39,13,26,9,3,11,4,7,0,0,0
S01008635,All HRPs aged 16 and over,362,273,214,29,185,52,7,89,68,16,5,0,0
S01008635,Owned: Total,263,194,148,15,133,43,3,69,65,2,2,0,0
S01008635,Owned: Owned outright,137,72,55,12,43,15,2,65,64,0,1,0,0
S01008635,Owned: Owned with a mortgage or loan or shared ownership,126,122,93,3,90,28,1,4,1,2,1,0,0
S01008635,Rented or living rent free: Total,99,79,66,14,52,9,4,20,3,14,3,0,0
S01008635,Rented or living rent free: Social rented,3,2,1,0,1,0,1,1,0,0,1,0,0
S01008635,Rented or living rent free: Private rented or living rent free,96,77,65,14,51,9,3,19,3,14,2,0,0
S01008636,All HRPs aged 16 and over,367,254,192,38,154,51,11,113,91,13,1,4,4
S01008636,Owned: Total,254,163,111,15,96,48,4,91,88,1,0,1,1
S01008636,Owned: Owned outright,152,67,37,9,28,27,3,85,83,1,0,1,0
S01008636,Owned: Owned with a mortgage or loan or shared ownership,102,96,74,6,68,21,1,6,5,0,0,0,1
S01008636,Rented or living rent free: Total,113,91,81,23,58,3,7,22,3,12,1,3,3
S01008636,Rented or living rent free: Social rented,2,1,1,0,1,0,0,1,0,0,0,1,0
S01008636,Rented or living rent free: Private rented or living rent free,111,90,80,23,57,3,7,21,3,12,1,2,3
S01008637,All HRPs aged 16 and over,309,207,162,17,145,44,1,102,75,17,7,3,0
S01008637,Owned: Total,199,122,93,7,86,29,0,77,72,3,1,1,0
S01008637,Owned: Owned outright,113,38,24,3,21,14,0,75,71,2,1,1,0
S01008637,Owned: Owned with a mortgage or loan or shared ownership,86,84,69,4,65,15,0,2,1,1,0,0,0
S01008637,Rented or living rent free: Total,110,85,69,10,59,15,1,25,3,14,6,2,0
S01008637,Rented or living rent free: Social rented,12,8,4,1,3,4,0,4,1,0,1,2,0
S01008637,Rented or living rent free: Private rented or living rent free,98,77,65,9,56,11,1,21,2,14,5,0,0
S01008638,All HRPs aged 16 and over,344,191,155,30,125,33,3,153,115,28,1,4,5
S01008638,Owned: Total,119,96,75,7,68,21,0,23,17,2,0,1,3
S01008638,Owned: Owned outright,55,37,26,3,23,11,0,18,14,1,0,0,3
S01008638,Owned: Owned with a mortgage or loan or shared ownership,64,59,49,4,45,10,0,5,3,1,0,1,0
S01008638,Rented or living rent free: Total,225,95,80,23,57,12,3,130,98,26,1,3,2
S01008638,Rented or living rent free: Social rented,104,5,5,1,4,0,0,99,95,0,0,3,1
S01008638,Rented or living rent free: Private rented or living rent free,121,90,75,22,53,12,3,31,3,26,1,0,1
S01008639,All HRPs aged 16 and over,430,353,297,44,253,45,11,77,38,24,5,5,5
S01008639,Owned: Total,240,196,161,21,140,32,3,44,33,4,1,2,4
S01008639,Owned: Owned outright,91,51,38,6,32,13,0,40,33,2,0,1,4
S01008639,Owned: Owned with a mortgage or loan or shared ownership,149,145,123,15,108,19,3,4,0,2,1,1,0
S01008639,Rented or living rent free: Total,190,157,136,23,113,13,8,33,5,20,4,3,1
S01008639,Rented or living rent free: Social rented,5,1,1,0,1,0,0,4,2,1,0,1,0
S01008639,Rented or living rent free: Private rented or living rent free,185,156,135,23,112,13,8,29,3,19,4,2,1
S01008640,All HRPs aged 16 and over,351,289,244,36,208,36,9,62,21,34,3,2,2
S01008640,Owned: Total,187,164,140,11,129,21,3,23,19,2,0,1,1
S01008640,Owned: Owned outright,75,57,50,7,43,6,1,18,17,0,0,0,1
S01008640,Owned: Owned with a mortgage or loan or shared ownership,112,107,90,4,86,15,2,5,2,2,0,1,0
S01008640,Rented or living rent free: Total,164,125,104,25,79,15,6,39,2,32,3,1,1
S01008640,Rented or living rent free: Social rented,1,0,0,0,0,0,0,1,1,0,0,0,0
S01008640,Rented or living rent free: Private rented or living rent free,163,125,104,25,79,15,6,38,1,32,3,1,1
S01008641,All HRPs aged 16 and over,351,268,233,52,181,29,6,83,29,44,4,3,3
S01008641,Owned: Total,176,138,114,13,101,21,3,38,25,9,2,1,1
S01008641,Owned: Owned outright,83,50,42,6,36,6,2,33,24,6,2,1,0
S01008641,Owned: Owned with a mortgage or loan or shared ownership,93,88,72,7,65,15,1,5,1,3,0,0,1
S01008641,Rented or living rent free: Total,175,130,119,39,80,8,3,45,4,35,2,2,2
S01008641,Rented or living rent free: Social rented,2,1,1,0,1,0,0,1,1,0,0,0,0
S01008641,Rented or living rent free: Private rented or living rent free,173,129,118,39,79,8,3,44,3,35,2,2,2
S01008642,All HRPs aged 16 and over,433,349,296,61,235,45,8,84,46,28,3,0,7
S01008642,Owned: Total,256,199,162,20,142,33,4,57,46,5,1,0,5
S01008642,Owned: Owned outright,102,54,41,7,34,11,2,48,39,3,1,0,5
S01008642,Owned: Owned with a mortgage or loan or shared ownership,154,145,121,13,108,22,2,9,7,2,0,0,0
S01008642,Rented or living rent free: Total,177,150,134,41,93,12,4,27,0,23,2,0,2
S01008642,Rented or living rent free: Social rented,2,1,1,0,1,0,0,1,0,0,0,0,1
S01008642,Rented or living rent free: Private rented or living rent free,175,149,133,41,92,12,4,26,0,23,2,0,1
S01008643,All HRPs aged 16 and over,323,270,224,30,194,42,4,53,30,13,6,2,2
S01008643,Owned: Total,204,171,136,12,124,33,2,33,26,3,2,2,0
S01008643,Owned: Owned outright,80,52,43,10,33,8,1,28,24,0,2,2,0
S01008643,Owned: Owned with a mortgage or loan or shared ownership,124,119,93,2,91,25,1,5,2,3,0,0,0
S01008643,Rented or living rent free: Total,119,99,88,18,70,9,2,20,4,10,4,0,2
S01008643,Rented or living rent free: Social rented,5,3,2,1,1,0,1,2,0,1,1,0,0
S01008643,Rented or living rent free: Private rented or living rent free,114,96,86,17,69,9,1,18,4,9,3,0,2
S01008644,All HRPs aged 16 and over,386,274,238,32,206,26,10,112,67,30,3,9,3
S01008644,Owned: Total,178,144,124,8,116,16,4,34,27,2,3,0,2
S01008644,Owned: Owned outright,72,44,36,7,29,7,1,28,24,1,1,0,2
S01008644,Owned: Owned with a mortgage or loan or shared ownership,106,100,88,1,87,9,3,6,3,1,2,0,0
S01008644,Rented or living rent free: Total,208,130,114,24,90,10,6,78,40,28,0,9,1
S01008644,Rented or living rent free: Social rented,66,20,15,6,9,4,1,46,36,0,0,9,1
S01008644,Rented or living rent free: Private rented or living rent free,142,110,99,18,81,6,5,32,4,28,0,0,0
S01008645,All HRPs aged 16 and over,360,280,250,41,209,23,7,80,53,24,0,0,3
S01008645,Owned: Total,211,157,140,7,133,15,2,54,51,1,0,0,2
S01008645,Owned: Owned outright,91,43,36,5,31,6,1,48,48,0,0,0,0
S01008645,Owned: Owned with a mortgage or loan or shared ownership,120,114,104,2,102,9,1,6,3,1,0,0,2
S01008645,Rented or living rent free: Total,149,123,110,34,76,8,5,26,2,23,0,0,1
S01008645,Rented or living rent free: Social rented,10,4,3,1,2,1,0,6,1,5,0,0,0
S01008645,Rented or living rent free: Private rented or living rent free,139,119,107,33,74,7,5,20,1,18,0,0,1
S01008646,All HRPs aged 16 and over,453,358,315,57,258,27,16,95,56,17,6,11,5
S01008646,Owned: Total,235,183,162,19,143,19,2,52,46,2,0,1,3
S01008646,Owned: Owned outright,93,46,37,9,28,9,0,47,44,1,0,0,2
S01008646,Owned: Owned with a mortgage or loan or shared ownership,142,137,125,10,115,10,2,5,2,1,0,1,1
S01008646,Rented or living rent free: Total,218,175,153,38,115,8,14,43,10,15,6,10,2
S01008646,Rented or living rent free: Social rented,29,12,12,4,8,0,0,17,7,0,4,6,0
S01008646,Rented or living rent free: Private rented or living rent free,189,163,141,34,107,8,14,26,3,15,2,4,2
S01008647,All HRPs aged 16 and over,330,287,256,36,220,22,9,43,21,16,0,4,2
S01008647,Owned: Total,183,162,142,9,133,16,4,21,17,2,0,1,1
S01008647,Owned: Owned outright,51,33,25,4,21,6,2,18,16,1,0,1,0
S01008647,Owned: Owned with a mortgage or loan or shared ownership,132,129,117,5,112,10,2,3,1,1,0,0,1
S01008647,Rented or living rent free: Total,147,125,114,27,87,6,5,22,4,14,0,3,1
S01008647,Rented or living rent free: Social rented,4,1,1,0,1,0,0,3,1,1,0,0,1
S01008647,Rented or living rent free: Private rented or living rent free,143,124,113,27,86,6,5,19,3,13,0,3,0
S01008648,All HRPs aged 16 and over,339,262,235,36,199,14,13,77,43,19,1,7,7
S01008648,Owned: Total,118,100,94,7,87,6,0,18,14,3,0,0,1
S01008648,Owned: Owned outright,30,15,14,3,11,1,0,15,12,2,0,0,1
S01008648,Owned: Owned with a mortgage or loan or shared ownership,88,85,80,4,76,5,0,3,2,1,0,0,0
S01008648,Rented or living rent free: Total,221,162,141,29,112,8,13,59,29,16,1,7,6
S01008648,Rented or living rent free: Social rented,44,12,7,3,4,3,2,32,25,0,0,4,3
S01008648,Rented or living rent free: Private rented or living rent free,177,150,134,26,108,5,11,27,4,16,1,3,3
S01008649,All HRPs aged 16 and over,560,447,403,41,362,22,22,113,39,36,1,30,7
S01008649,Owned: Total,246,208,197,11,186,8,3,38,27,4,1,4,2
S01008649,Owned: Owned outright,63,33,30,5,25,2,1,30,24,1,1,3,1
S01008649,Owned: Owned with a mortgage or loan or shared ownership,183,175,167,6,161,6,2,8,3,3,0,1,1
S01008649,Rented or living rent free: Total,314,239,206,30,176,14,19,75,12,32,0,26,5
S01008649,Rented or living rent free: Social rented,41,20,17,4,13,2,1,21,3,0,0,16,2
S01008649,Rented or living rent free: Private rented or living rent free,273,219,189,26,163,12,18,54,9,32,0,10,3
S01008650,All HRPs aged 16 and over,470,385,352,56,296,22,11,85,29,22,0,22,12
S01008650,Owned: Total,205,172,157,15,142,11,4,33,22,1,0,3,7
S01008650,Owned: Owned outright,62,35,31,4,27,2,2,27,21,0,0,1,5
S01008650,Owned: Owned with a mortgage or loan or shared ownership,143,137,126,11,115,9,2,6,1,1,0,2,2
S01008650,Rented or living rent free: Total,265,213,195,41,154,11,7,52,7,21,0,19,5
S01008650,Rented or living rent free: Social rented,39,21,18,10,8,0,3,18,4,2,0,11,1
S01008650,Rented or living rent free: Private rented or living rent free,226,192,177,31,146,11,4,34,3,19,0,8,4
S01008651,All HRPs aged 16 and over,497,374,307,58,249,38,29,123,28,42,1,41,11
S01008651,Owned: Total,170,143,118,10,108,20,5,27,16,5,0,5,1
S01008651,Owned: Owned outright,51,30,24,3,21,5,1,21,14,2,0,4,1
S01008651,Owned: Owned with a mortgage or loan or shared ownership,119,113,94,7,87,15,4,6,2,3,0,1,0
S01008651,Rented or living rent free: Total,327,231,189,48,141,18,24,96,12,37,1,36,10
S01008651,Rented or living rent free: Social rented,105,52,32,9,23,2,18,53,10,2,1,32,8
S01008651,Rented or living rent free: Private rented or living rent free,222,179,157,39,118,16,6,43,2,35,0,4,2
S01008652,All HRPs aged 16 and over,387,307,257,46,211,22,28,80,25,17,4,25,9
S01008652,Owned: Total,104,93,83,13,70,8,2,11,8,2,0,1,0
S01008652,Owned: Owned outright,25,19,16,4,12,2,1,6,6,0,0,0,0
S01008652,Owned: Owned with a mortgage or loan or shared ownership,79,74,67,9,58,6,1,5,2,2,0,1,0
S01008652,Rented or living rent free: Total,283,214,174,33,141,14,26,69,17,15,4,24,9
S01008652,Rented or living rent free: Social rented,137,86,64,16,48,4,18,51,17,0,4,21,9
S01008652,Rented or living rent free: Private rented or living rent free,146,128,110,17,93,10,8,18,0,15,0,3,0
S01008653,All HRPs aged 16 and over,402,301,259,45,214,17,25,101,33,29,6,30,3
S01008653,Owned: Total,94,83,74,5,69,7,2,11,8,0,0,3,0
S01008653,Owned: Owned outright,24,15,9,1,8,5,1,9,7,0,0,2,0
S01008653,Owned: Owned with a mortgage or loan or shared ownership,70,68,65,4,61,2,1,2,1,0,0,1,0
S01008653,Rented or living rent free: Total,308,218,185,40,145,10,23,90,25,29,6,27,3
S01008653,Rented or living rent free: Social rented,122,67,58,19,39,2,7,55,23,3,5,23,1
S01008653,Rented or living rent free: Private rented or living rent free,186,151,127,21,106,8,16,35,2,26,1,4,2
S01008654,All HRPs aged 16 and over,585,448,385,74,311,35,28,137,32,46,5,36,18
S01008654,Owned: Total,192,170,151,12,139,16,3,22,12,4,1,4,1
S01008654,Owned: Owned outright,51,36,29,3,26,4,3,15,9,2,0,3,1
S01008654,Owned: Owned with a mortgage or loan or shared ownership,141,134,122,9,113,12,0,7,3,2,1,1,0
S01008654,Rented or living rent free: Total,393,278,234,62,172,19,25,115,20,42,4,32,17
S01008654,Rented or living rent free: Social rented,126,69,52,20,32,5,12,57,14,0,1,26,16
S01008654,Rented or living rent free: Private rented or living rent free,267,209,182,42,140,14,13,58,6,42,3,6,1
S01008655,All HRPs aged 16 and over,442,346,312,49,263,25,9,96,35,24,2,23,12
S01008655,Owned: Total,147,125,112,11,101,11,2,22,14,1,1,3,3
S01008655,Owned: Owned outright,46,28,24,6,18,2,2,18,13,0,1,2,2
S01008655,Owned: Owned with a mortgage or loan or shared ownership,101,97,88,5,83,9,0,4,1,1,0,1,1
S01008655,Rented or living rent free: Total,295,221,200,38,162,14,7,74,21,23,1,20,9
S01008655,Rented or living rent free: Social rented,59,19,17,3,14,1,1,40,14,1,0,20,5
S01008655,Rented or living rent free: Private rented or living rent free,236,202,183,35,148,13,6,34,7,22,1,0,4
S01008656,All HRPs aged 16 and over,426,312,258,49,209,29,25,114,28,36,7,36,7
S01008656,Owned: Total,106,91,76,10,66,13,2,15,9,2,1,2,1
S01008656,Owned: Owned outright,37,26,18,2,16,6,2,11,8,0,1,2,0
S01008656,Owned: Owned with a mortgage or loan or shared ownership,69,65,58,8,50,7,0,4,1,2,0,0,1
S01008656,Rented or living rent free: Total,320,221,182,39,143,16,23,99,19,34,6,34,6
S01008656,Rented or living rent free: Social rented,135,75,59,10,49,3,13,60,17,3,5,31,4
S01008656,Rented or living rent free: Private rented or living rent free,185,146,123,29,94,13,10,39,2,31,1,3,2
S01008657,All HRPs aged 16 and over,361,266,228,47,181,26,12,95,39,16,11,25,4
S01008657,Owned: Total,130,100,82,14,68,16,2,30,27,2,0,1,0
S01008657,Owned: Owned outright,55,28,23,4,19,5,0,27,26,0,0,1,0
S01008657,Owned: Owned with a mortgage or loan or shared ownership,75,72,59,10,49,11,2,3,1,2,0,0,0
S01008657,Rented or living rent free: Total,231,166,146,33,113,10,10,65,12,14,11,24,4
S01008657,Rented or living rent free: Social rented,103,55,50,13,37,1,4,48,10,3,8,24,3
S01008657,Rented or living rent free: Private rented or living rent free,128,111,96,20,76,9,6,17,2,11,3,0,1
S01008658,All HRPs aged 16 and over,555,396,321,64,257,26,49,159,78,41,2,32,6
S01008658,Owned: Total,158,123,106,6,100,9,8,35,30,4,0,1,0
S01008658,Owned: Owned outright,56,29,22,4,18,3,4,27,27,0,0,0,0
S01008658,Owned: Owned with a mortgage or loan or shared ownership,102,94,84,2,82,6,4,8,3,4,0,1,0
S01008658,Rented or living rent free: Total,397,273,215,58,157,17,41,124,48,37,2,31,6
S01008658,Rented or living rent free: Social rented,157,74,44,15,29,4,26,83,39,6,2,30,6
S01008658,Rented or living rent free: Private rented or living rent free,240,199,171,43,128,13,15,41,9,31,0,1,0
S01008659,All HRPs aged 16 and over,446,331,277,82,195,30,24,115,38,47,6,21,3
S01008659,Owned: Total,117,98,80,13,67,14,4,19,15,1,0,1,2
S01008659,Owned: Owned outright,38,22,20,2,18,1,1,16,12,1,0,1,2
S01008659,Owned: Owned with a mortgage or loan or shared ownership,79,76,60,11,49,13,3,3,3,0,0,0,0
S01008659,Rented or living rent free: Total,329,233,197,69,128,16,20,96,23,46,6,20,1
S01008659,Rented or living rent free: Social rented,82,45,32,11,21,1,12,37,18,0,1,17,1
S01008659,Rented or living rent free: Private rented or living rent free,247,188,165,58,107,15,8,59,5,46,5,3,0
S01008660,All HRPs aged 16 and over,444,343,264,69,195,46,33,101,25,43,14,15,4
S01008660,Owned: Total,127,100,77,12,65,19,4,27,19,4,0,3,1
S01008660,Owned: Owned outright,59,41,29,9,20,9,3,18,16,0,0,1,1
S01008660,Owned: Owned with a mortgage or loan or shared ownership,68,59,48,3,45,10,1,9,3,4,0,2,0
S01008660,Rented or living rent free: Total,317,243,187,57,130,27,29,74,6,39,14,12,3
S01008660,Rented or living rent free: Social rented,53,27,16,7,9,0,11,26,2,3,11,8,2
S01008660,Rented or living rent free: Private rented or living rent free,264,216,171,50,121,27,18,48,4,36,3,4,1
S01008661,All HRPs aged 16 and over,437,311,257,64,193,30,24,126,54,33,7,24,8
S01008661,Owned: Total,92,67,53,5,48,10,4,25,12,4,1,3,5
S01008661,Owned: Owned outright,42,21,15,3,12,3,3,21,12,2,1,2,4
S01008661,Owned: Owned with a mortgage or loan or shared ownership,50,46,38,2,36,7,1,4,0,2,0,1,1
S01008661,Rented or living rent free: Total,345,244,204,59,145,20,20,101,42,29,6,21,3
S01008661,Rented or living rent free: Social rented,161,97,71,17,54,15,11,64,39,0,6,17,2
S01008661,Rented or living rent free: Private rented or living rent free,184,147,133,42,91,5,9,37,3,29,0,4,1
S01008662,All HRPs aged 16 and over,276,198,165,46,119,15,18,78,13,38,3,23,1
S01008662,Owned: Total,48,41,33,7,26,7,1,7,4,1,0,1,1
S01008662,Owned: Owned outright,16,12,7,2,5,4,1,4,4,0,0,0,0
S01008662,Owned: Owned with a mortgage or loan or shared ownership,32,29,26,5,21,3,0,3,0,1,0,1,1
S01008662,Rented or living rent free: Total,228,157,132,39,93,8,17,71,9,37,3,22,0
S01008662,Rented or living rent free: Social rented,70,36,22,5,17,3,11,34,9,6,0,19,0
S01008662,Rented or living rent free: Private rented or living rent free,158,121,110,34,76,5,6,37,0,31,3,3,0
S01008663,All HRPs aged 16 and over,434,289,230,53,177,36,23,145,55,57,4,24,5
S01008663,Owned: Total,130,101,77,7,70,21,3,29,15,10,1,1,2
S01008663,Owned: Owned outright,40,20,12,1,11,7,1,20,11,7,0,0,2
S01008663,Owned: Owned with a mortgage or loan or shared ownership,90,81,65,6,59,14,2,9,4,3,1,1,0
S01008663,Rented or living rent free: Total,304,188,153,46,107,15,20,116,40,47,3,23,3
S01008663,Rented or living rent free: Social rented,92,32,26,8,18,2,4,60,36,4,2,16,2
S01008663,Rented or living rent free: Private rented or living rent free,212,156,127,38,89,13,16,56,4,43,1,7,1
S01008664,All HRPs aged 16 and over,396,301,254,60,194,33,14,95,29,40,0,22,4
S01008664,Owned: Total,159,129,112,19,93,15,2,30,22,3,0,4,1
S01008664,Owned: Owned outright,55,30,25,7,18,5,0,25,19,3,0,2,1
S01008664,Owned: Owned with a mortgage or loan or shared ownership,104,99,87,12,75,10,2,5,3,0,0,2,0
S01008664,Rented or living rent free: Total,237,172,142,41,101,18,12,65,7,37,0,18,3
S01008664,Rented or living rent free: Social rented,46,25,16,6,10,3,6,21,5,1,0,12,3
S01008664,Rented or living rent free: Private rented or living rent free,191,147,126,35,91,15,6,44,2,36,0,6,0
S01008665,All HRPs aged 16 and over,524,397,318,57,261,47,32,127,37,42,15,24,9
S01008665,Owned: Total,186,152,131,14,117,16,5,34,25,7,0,0,2
S01008665,Owned: Owned outright,78,48,41,10,31,6,1,30,25,3,0,0,2
S01008665,Owned: Owned with a mortgage or loan or shared ownership,108,104,90,4,86,10,4,4,0,4,0,0,0
S01008665,Rented or living rent free: Total,338,245,187,43,144,31,27,93,12,35,15,24,7
S01008665,Rented or living rent free: Social rented,92,46,27,5,22,6,13,46,8,6,10,17,5
S01008665,Rented or living rent free: Private rented or living rent free,246,199,160,38,122,25,14,47,4,29,5,7,2
S01008666,All HRPs aged 16 and over,311,242,196,52,144,28,18,69,33,29,2,5,0
S01008666,Owned: Total,118,87,71,10,61,14,2,31,26,3,1,1,0
S01008666,Owned: Owned outright,50,24,19,4,15,4,1,26,24,1,0,1,0
S01008666,Owned: Owned with a mortgage or loan or shared ownership,68,63,52,6,46,10,1,5,2,2,1,0,0
S01008666,Rented or living rent free: Total,193,155,125,42,83,14,16,38,7,26,1,4,0
S01008666,Rented or living rent free: Social rented,12,4,0,0,0,0,4,8,4,1,0,3,0
S01008666,Rented or living rent free: Private rented or living rent free,181,151,125,42,83,14,12,30,3,25,1,1,0
S01008667,All HRPs aged 16 and over,308,213,171,49,122,28,14,95,41,45,1,7,1
S01008667,Owned: Total,145,96,76,7,69,17,3,49,31,18,0,0,0
S01008667,Owned: Owned outright,72,38,25,5,20,11,2,34,30,4,0,0,0
S01008667,Owned: Owned with a mortgage or loan or shared ownership,73,58,51,2,49,6,1,15,1,14,0,0,0
S01008667,Rented or living rent free: Total,163,117,95,42,53,11,11,46,10,27,1,7,1
S01008667,Rented or living rent free: Social rented,50,31,23,13,10,4,4,19,5,6,1,6,1
S01008667,Rented or living rent free: Private rented or living rent free,113,86,72,29,43,7,7,27,5,21,0,1,0
S01008668,All HRPs aged 16 and over,280,196,160,36,124,28,8,84,23,54,4,1,2
S01008668,Owned: Total,122,97,85,14,71,11,1,25,19,6,0,0,0
S01008668,Owned: Owned outright,51,32,26,6,20,5,1,19,16,3,0,0,0
S01008668,Owned: Owned with a mortgage or loan or shared ownership,71,65,59,8,51,6,0,6,3,3,0,0,0
S01008668,Rented or living rent free: Total,158,99,75,22,53,17,7,59,4,48,4,1,2
S01008668,Rented or living rent free: Social rented,11,4,3,2,1,1,0,7,0,2,4,1,0
S01008668,Rented or living rent free: Private rented or living rent free,147,95,72,20,52,16,7,52,4,46,0,0,2
S01008669,All HRPs aged 16 and over,173,112,93,42,51,8,11,61,8,46,4,2,1
S01008669,Owned: Total,36,24,22,3,19,2,0,12,7,4,0,1,0
S01008669,Owned: Owned outright,18,9,9,3,6,0,0,9,7,2,0,0,0
S01008669,Owned: Owned with a mortgage or loan or shared ownership,18,15,13,0,13,2,0,3,0,2,0,1,0
S01008669,Rented or living rent free: Total,137,88,71,39,32,6,11,49,1,42,4,1,1
S01008669,Rented or living rent free: Social rented,6,4,3,1,2,1,0,2,0,0,0,1,1
S01008669,Rented or living rent free: Private rented or living rent free,131,84,68,38,30,5,11,47,1,42,4,0,0
S01008670,All HRPs aged 16 and over,260,176,149,67,82,14,13,84,27,52,2,1,2
S01008670,Owned: Total,79,53,43,10,33,9,1,26,16,9,0,0,1
S01008670,Owned: Owned outright,38,21,17,5,12,4,0,17,15,1,0,0,1
S01008670,Owned: Owned with a mortgage or loan or shared ownership,41,32,26,5,21,5,1,9,1,8,0,0,0
S01008670,Rented or living rent free: Total,181,123,106,57,49,5,12,58,11,43,2,1,1
S01008670,Rented or living rent free: Social rented,10,3,2,1,1,0,1,7,6,1,0,0,0
S01008670,Rented or living rent free: Private rented or living rent free,171,120,104,56,48,5,11,51,5,42,2,1,1
S01008671,All HRPs aged 16 and over,331,198,163,61,102,20,15,133,29,90,1,9,4
S01008671,Owned: Total,101,67,59,9,50,6,2,34,22,8,1,1,2
S01008671,Owned: Owned outright,44,19,17,6,11,2,0,25,21,3,0,1,0
S01008671,Owned: Owned with a mortgage or loan or shared ownership,57,48,42,3,39,4,2,9,1,5,1,0,2
S01008671,Rented or living rent free: Total,230,131,104,52,52,14,13,99,7,82,0,8,2
S01008671,Rented or living rent free: Social rented,22,7,3,1,2,4,0,15,4,2,0,7,2
S01008671,Rented or living rent free: Private rented or living rent free,208,124,101,51,50,10,13,84,3,80,0,1,0
S01008672,All HRPs aged 16 and over,341,196,175,49,126,16,5,145,53,80,0,7,5
S01008672,Owned: Total,126,73,63,12,51,10,0,53,42,8,0,2,1
S01008672,Owned: Owned outright,74,27,23,5,18,4,0,47,38,6,0,2,1
S01008672,Owned: Owned with a mortgage or loan or shared ownership,52,46,40,7,33,6,0,6,4,2,0,0,0
S01008672,Rented or living rent free: Total,215,123,112,37,75,6,5,92,11,72,0,5,4
S01008672,Rented or living rent free: Social rented,16,9,9,2,7,0,0,7,4,0,0,3,0
S01008672,Rented or living rent free: Private rented or living rent free,199,114,103,35,68,6,5,85,7,72,0,2,4
S01008673,All HRPs aged 16 and over,649,338,262,70,192,52,24,311,45,219,9,29,9
S01008673,Owned: Total,194,101,79,10,69,22,0,93,28,62,0,2,1
S01008673,Owned: Owned outright,114,37,28,5,23,9,0,77,23,52,0,2,0
S01008673,Owned: Owned with a mortgage or loan or shared ownership,80,64,51,5,46,13,0,16,5,10,0,0,1
S01008673,Rented or living rent free: Total,455,237,183,60,123,30,24,218,17,157,9,27,8
S01008673,Rented or living rent free: Social rented,109,60,41,16,25,8,11,49,11,6,7,21,4
S01008673,Rented or living rent free: Private rented or living rent free,346,177,142,44,98,22,13,169,6,151,2,6,4
S01008674,All HRPs aged 16 and over,413,265,195,61,134,42,28,148,26,83,7,23,9
S01008674,Owned: Total,95,70,49,8,41,19,2,25,16,7,0,2,0
S01008674,Owned: Owned outright,49,27,16,4,12,10,1,22,15,6,0,1,0
S01008674,Owned: Owned with a mortgage or loan or shared ownership,46,43,33,4,29,9,1,3,1,1,0,1,0
S01008674,Rented or living rent free: Total,318,195,146,53,93,23,26,123,10,76,7,21,9
S01008674,Rented or living rent free: Social rented,73,35,22,7,15,5,8,38,4,6,5,18,5
S01008674,Rented or living rent free: Private rented or living rent free,245,160,124,46,78,18,18,85,6,70,2,3,4
S01008675,All HRPs aged 16 and over,476,293,230,38,192,39,24,183,59,77,8,33,6
S01008675,Owned: Total,105,76,62,8,54,13,1,29,21,5,0,0,3
S01008675,Owned: Owned outright,47,22,16,4,12,5,1,25,19,4,0,0,2
S01008675,Owned: Owned with a mortgage or loan or shared ownership,58,54,46,4,42,8,0,4,2,1,0,0,1
S01008675,Rented or living rent free: Total,371,217,168,30,138,26,23,154,38,72,8,33,3
S01008675,Rented or living rent free: Social rented,112,35,20,4,16,6,9,77,33,6,7,29,2
S01008675,Rented or living rent free: Private rented or living rent free,259,182,148,26,122,20,14,77,5,66,1,4,1
S01008676,All HRPs aged 16 and over,338,263,207,32,175,46,10,75,23,32,6,8,6
S01008676,Owned: Total,128,99,68,9,59,31,0,29,19,5,0,3,2
S01008676,Owned: Owned outright,58,34,21,5,16,13,0,24,16,5,0,2,1
S01008676,Owned: Owned with a mortgage or loan or shared ownership,70,65,47,4,43,18,0,5,3,0,0,1,1
S01008676,Rented or living rent free: Total,210,164,139,23,116,15,10,46,4,27,6,5,4
S01008676,Rented or living rent free: Social rented,44,26,19,5,14,1,6,18,3,1,6,4,4
S01008676,Rented or living rent free: Private rented or living rent free,166,138,120,18,102,14,4,28,1,26,0,1,0
S01008677,All HRPs aged 16 and over,420,276,209,50,159,52,15,144,32,86,1,19,6
S01008677,Owned: Total,121,89,57,10,47,29,3,32,23,6,0,3,0
S01008677,Owned: Owned outright,60,31,19,6,13,11,1,29,20,6,0,3,0
S01008677,Owned: Owned with a mortgage or loan or shared ownership,61,58,38,4,34,18,2,3,3,0,0,0,0
S01008677,Rented or living rent free: Total,299,187,152,40,112,23,12,112,9,80,1,16,6
S01008677,Rented or living rent free: Social rented,46,18,13,4,9,2,3,28,5,5,1,14,3
S01008677,Rented or living rent free: Private rented or living rent free,253,169,139,36,103,21,9,84,4,75,0,2,3
S01008678,All HRPs aged 16 and over,393,236,179,55,124,34,23,157,16,115,4,15,7
S01008678,Owned: Total,79,66,46,11,35,15,5,13,8,3,0,2,0
S01008678,Owned: Owned outright,30,21,15,6,9,4,2,9,6,1,0,2,0
S01008678,Owned: Owned with a mortgage or loan or shared ownership,49,45,31,5,26,11,3,4,2,2,0,0,0
S01008678,Rented or living rent free: Total,314,170,133,44,89,19,18,144,8,112,4,13,7
S01008678,Rented or living rent free: Social rented,65,30,21,7,14,4,5,35,5,12,3,11,4
S01008678,Rented or living rent free: Private rented or living rent free,249,140,112,37,75,15,13,109,3,100,1,2,3
S01008679,All HRPs aged 16 and over,546,298,223,73,150,41,34,248,87,95,11,51,4
S01008679,Owned: Total,72,52,35,1,34,16,1,20,8,8,0,4,0
S01008679,Owned: Owned outright,31,17,9,0,9,7,1,14,7,6,0,1,0
S01008679,Owned: Owned with a mortgage or loan or shared ownership,41,35,26,1,25,9,0,6,1,2,0,3,0
S01008679,Rented or living rent free: Total,474,246,188,72,116,25,33,228,79,87,11,47,4
S01008679,Rented or living rent free: Social rented,236,96,70,22,48,11,15,140,75,6,11,45,3
S01008679,Rented or living rent free: Private rented or living rent free,238,150,118,50,68,14,18,88,4,81,0,2,1
S01008680,All HRPs aged 16 and over,326,202,170,48,122,10,22,124,21,67,4,23,9
S01008680,Owned: Total,60,44,37,8,29,3,4,16,9,4,0,1,2
S01008680,Owned: Owned outright,19,10,9,5,4,0,1,9,8,1,0,0,0
S01008680,Owned: Owned with a mortgage or loan or shared ownership,41,34,28,3,25,3,3,7,1,3,0,1,2
S01008680,Rented or living rent free: Total,266,158,133,40,93,7,18,108,12,63,4,22,7
S01008680,Rented or living rent free: Social rented,84,37,27,13,14,4,6,47,8,9,4,20,6
S01008680,Rented or living rent free: Private rented or living rent free,182,121,106,27,79,3,12,61,4,54,0,2,1
S01008681,All HRPs aged 16 and over,540,273,216,54,162,23,34,267,87,108,9,50,13
S01008681,Owned: Total,139,89,76,8,68,5,8,50,28,10,0,8,4
S01008681,Owned: Owned outright,59,27,22,1,21,2,3,32,23,1,0,5,3
S01008681,Owned: Owned with a mortgage or loan or shared ownership,80,62,54,7,47,3,5,18,5,9,0,3,1
S01008681,Rented or living rent free: Total,401,184,140,46,94,18,26,217,59,98,9,42,9
S01008681,Rented or living rent free: Social rented,155,41,26,4,22,5,10,114,57,2,8,39,8
S01008681,Rented or living rent free: Private rented or living rent free,246,143,114,42,72,13,16,103,2,96,1,3,1
S01008682,All HRPs aged 16 and over,431,279,224,55,169,33,22,152,44,65,3,32,8
S01008682,Owned: Total,135,100,80,7,73,17,3,35,20,10,0,3,2
S01008682,Owned: Owned outright,58,34,27,5,22,7,0,24,19,3,0,0,2
S01008682,Owned: Owned with a mortgage or loan or shared ownership,77,66,53,2,51,10,3,11,1,7,0,3,0
S01008682,Rented or living rent free: Total,296,179,144,48,96,16,19,117,24,55,3,29,6
S01008682,Rented or living rent free: Social rented,93,35,26,11,15,4,5,58,21,2,3,28,4
S01008682,Rented or living rent free: Private rented or living rent free,203,144,118,37,81,12,14,59,3,53,0,1,2
S01008683,All HRPs aged 16 and over,576,312,230,74,156,28,54,264,88,65,29,69,13
S01008683,Owned: Total,116,76,61,14,47,12,3,40,28,7,0,4,1
S01008683,Owned: Owned outright,45,16,12,4,8,4,0,29,22,6,0,1,0
S01008683,Owned: Owned with a mortgage or loan or shared ownership,71,60,49,10,39,8,3,11,6,1,0,3,1
S01008683,Rented or living rent free: Total,460,236,169,60,109,16,51,224,60,58,29,65,12
S01008683,Rented or living rent free: Social rented,320,156,105,40,65,8,43,164,58,8,23,63,12
S01008683,Rented or living rent free: Private rented or living rent free,140,80,64,20,44,8,8,60,2,50,6,2,0
S01008684,All HRPs aged 16 and over,532,323,235,67,168,36,52,209,68,49,21,59,12
S01008684,Owned: Total,119,77,63,10,53,12,2,42,27,5,3,4,3
S01008684,Owned: Owned outright,56,26,19,5,14,6,1,30,25,3,0,0,2
S01008684,Owned: Owned with a mortgage or loan or shared ownership,63,51,44,5,39,6,1,12,2,2,3,4,1
S01008684,Rented or living rent free: Total,413,246,172,57,115,24,50,167,41,44,18,55,9
S01008684,Rented or living rent free: Social rented,268,154,102,39,63,12,40,114,38,4,12,51,9
S01008684,Rented or living rent free: Private rented or living rent free,145,92,70,18,52,12,10,53,3,40,6,4,0
S01008685,All HRPs aged 16 and over,489,321,248,60,188,40,33,168,66,46,1,45,10
S01008685,Owned: Total,150,94,74,15,59,15,5,56,41,8,0,4,3
S01008685,Owned: Owned outright,84,36,24,4,20,9,3,48,37,7,0,2,2
S01008685,Owned: Owned with a mortgage or loan or shared ownership,66,58,50,11,39,6,2,8,4,1,0,2,1
S01008685,Rented or living rent free: Total,339,227,174,45,129,25,28,112,25,38,1,41,7
S01008685,Rented or living rent free: Social rented,147,73,52,18,34,5,16,74,20,8,0,41,5
S01008685,Rented or living rent free: Private rented or living rent free,192,154,122,27,95,20,12,38,5,30,1,0,2
S01008686,All HRPs aged 16 and over,585,325,246,54,192,47,32,260,166,24,11,47,12
S01008686,Owned: Total,144,113,86,9,77,21,6,31,25,1,0,2,3
S01008686,Owned: Owned outright,25,12,8,3,5,4,0,13,12,0,0,0,1
S01008686,Owned: Owned with a mortgage or loan or shared ownership,119,101,78,6,72,17,6,18,13,1,0,2,2
S01008686,Rented or living rent free: Total,441,212,160,45,115,26,26,229,141,23,11,45,9
S01008686,Rented or living rent free: Social rented,281,90,67,26,41,11,12,191,136,2,7,40,6
S01008686,Rented or living rent free: Private rented or living rent free,160,122,93,19,74,15,14,38,5,21,4,5,3
S01008687,All HRPs aged 16 and over,419,330,287,41,246,25,18,89,28,36,4,14,7
S01008687,Owned: Total,196,168,149,18,131,14,5,28,19,3,0,3,3
S01008687,Owned: Owned outright,51,27,25,7,18,2,0,24,18,2,0,3,1
S01008687,Owned: Owned with a mortgage or loan or shared ownership,145,141,124,11,113,12,5,4,1,1,0,0,2
S01008687,Rented or living rent free: Total,223,162,138,23,115,11,13,61,9,33,4,11,4
S01008687,Rented or living rent free: Social rented,22,8,8,2,6,0,0,14,4,1,2,7,0
S01008687,Rented or living rent free: Private rented or living rent free,201,154,130,21,109,11,13,47,5,32,2,4,4
S01008688,All HRPs aged 16 and over,457,380,325,42,283,37,18,77,27,23,6,14,7
S01008688,Owned: Total,237,211,180,10,170,26,5,26,21,2,0,2,1
S01008688,Owned: Owned outright,66,42,35,5,30,6,1,24,20,2,0,2,0
S01008688,Owned: Owned with a mortgage or loan or shared ownership,171,169,145,5,140,20,4,2,1,0,0,0,1
S01008688,Rented or living rent free: Total,220,169,145,32,113,11,13,51,6,21,6,12,6
S01008688,Rented or living rent free: Social rented,47,28,19,7,12,2,7,19,4,0,1,9,5
S01008688,Rented or living rent free: Private rented or living rent free,173,141,126,25,101,9,6,32,2,21,5,3,1
S01008689,All HRPs aged 16 and over,548,416,344,46,298,39,33,132,92,16,7,9,8
S01008689,Owned: Total,240,194,169,19,150,21,4,46,36,3,2,1,4
S01008689,Owned: Owned outright,65,27,24,7,17,1,2,38,33,0,2,1,2
S01008689,Owned: Owned with a mortgage or loan or shared ownership,175,167,145,12,133,20,2,8,3,3,0,0,2
S01008689,Rented or living rent free: Total,308,222,175,27,148,18,29,86,56,13,5,8,4
S01008689,Rented or living rent free: Social rented,68,17,7,2,5,3,7,51,43,0,1,4,3
S01008689,Rented or living rent free: Private rented or living rent free,240,205,168,25,143,15,22,35,13,13,4,4,1
S01008690,All HRPs aged 16 and over,598,482,410,57,353,58,14,116,70,19,3,15,9
S01008690,Owned: Total,328,263,227,21,206,31,5,65,58,0,1,2,4
S01008690,Owned: Owned outright,121,66,54,9,45,11,1,55,52,0,0,1,2
S01008690,Owned: Owned with a mortgage or loan or shared ownership,207,197,173,12,161,20,4,10,6,0,1,1,2
S01008690,Rented or living rent free: Total,270,219,183,36,147,27,9,51,12,19,2,13,5
S01008690,Rented or living rent free: Social rented,20,13,11,4,7,1,1,7,3,0,0,4,0
S01008690,Rented or living rent free: Private rented or living rent free,250,206,172,32,140,26,8,44,9,19,2,9,5
S01008691,All HRPs aged 16 and over,678,549,469,55,414,51,29,129,59,18,4,37,11
S01008691,Owned: Total,335,284,255,23,232,25,4,51,39,6,0,5,1
S01008691,Owned: Owned outright,92,55,43,7,36,10,2,37,33,2,0,2,0
S01008691,Owned: Owned with a mortgage or loan or shared ownership,243,229,212,16,196,15,2,14,6,4,0,3,1
S01008691,Rented or living rent free: Total,343,265,214,32,182,26,25,78,20,12,4,32,10
S01008691,Rented or living rent free: Social rented,65,28,20,6,14,0,8,37,10,2,2,21,2
S01008691,Rented or living rent free: Private rented or living rent free,278,237,194,26,168,26,17,41,10,10,2,11,8
S01008692,All HRPs aged 16 and over,391,320,273,42,231,22,25,71,30,12,3,17,9
S01008692,Owned: Total,187,159,141,10,131,14,4,28,21,3,0,1,3
S01008692,Owned: Owned outright,49,24,23,7,16,1,0,25,20,2,0,1,2
S01008692,Owned: Owned with a mortgage or loan or shared ownership,138,135,118,3,115,13,4,3,1,1,0,0,1
S01008692,Rented or living rent free: Total,204,161,132,32,100,8,21,43,9,9,3,16,6
S01008692,Rented or living rent free: Social rented,93,65,48,11,37,4,13,28,8,1,3,12,4
S01008692,Rented or living rent free: Private rented or living rent free,111,96,84,21,63,4,8,15,1,8,0,4,2
S01008693,All HRPs aged 16 and over,224,136,100,18,82,33,3,88,80,1,3,3,1
S01008693,Owned: Total,199,118,88,17,71,30,0,81,78,0,0,2,1
S01008693,Owned: Owned outright,104,31,22,14,8,9,0,73,71,0,0,1,1
S01008693,Owned: Owned with a mortgage or loan or shared ownership,95,87,66,3,63,21,0,8,7,0,0,1,0
S01008693,Rented or living rent free: Total,25,18,12,1,11,3,3,7,2,1,3,1,0
S01008693,Rented or living rent free: Social rented,6,5,3,1,2,0,2,1,0,0,0,1,0
S01008693,Rented or living rent free: Private rented or living rent free,19,13,9,0,9,3,1,6,2,1,3,0,0
S01008694,All HRPs aged 16 and over,537,452,389,50,339,42,21,85,60,8,1,13,3
S01008694,Owned: Total,334,276,240,22,218,29,7,58,53,0,0,4,1
S01008694,Owned: Owned outright,118,64,52,14,38,10,2,54,49,0,0,4,1
S01008694,Owned: Owned with a mortgage or loan or shared ownership,216,212,188,8,180,19,5,4,4,0,0,0,0
S01008694,Rented or living rent free: Total,203,176,149,28,121,13,14,27,7,8,1,9,2
S01008694,Rented or living rent free: Social rented,25,16,10,1,9,0,6,9,2,0,1,6,0
S01008694,Rented or living rent free: Private rented or living rent free,178,160,139,27,112,13,8,18,5,8,0,3,2
S01008695,All HRPs aged 16 and over,338,260,223,30,193,24,13,78,56,4,10,7,1
S01008695,Owned: Total,249,188,164,17,147,21,3,61,52,3,3,2,1
S01008695,Owned: Owned outright,96,47,39,8,31,6,2,49,48,0,0,1,0
S01008695,Owned: Owned with a mortgage or loan or shared ownership,153,141,125,9,116,15,1,12,4,3,3,1,1
S01008695,Rented or living rent free: Total,89,72,59,13,46,3,10,17,4,1,7,5,0
S01008695,Rented or living rent free: Social rented,11,6,2,0,2,2,2,5,0,0,3,2,0
S01008695,Rented or living rent free: Private rented or living rent free,78,66,57,13,44,1,8,12,4,1,4,3,0
S01008696,All HRPs aged 16 and over,285,212,174,20,154,32,6,73,62,0,4,3,4
S01008696,Owned: Total,254,184,153,13,140,28,3,70,61,0,4,2,3
S01008696,Owned: Owned outright,110,47,36,4,32,9,2,63,58,0,2,0,3
S01008696,Owned: Owned with a mortgage or loan or shared ownership,144,137,117,9,108,19,1,7,3,0,2,2,0
S01008696,Rented or living rent free: Total,31,28,21,7,14,4,3,3,1,0,0,1,1
S01008696,Rented or living rent free: Social rented,2,1,1,1,0,0,0,1,0,0,0,1,0
S01008696,Rented or living rent free: Private rented or living rent free,29,27,20,6,14,4,3,2,1,0,0,0,1
S01008697,All HRPs aged 16 and over,453,292,243,31,212,47,2,161,149,3,5,3,1
S01008697,Owned: Total,399,249,203,25,178,44,2,150,146,0,1,2,1
S01008697,Owned: Owned outright,214,72,59,16,43,12,1,142,141,0,0,1,0
S01008697,Owned: Owned with a mortgage or loan or shared ownership,185,177,144,9,135,32,1,8,5,0,1,1,1
S01008697,Rented or living rent free: Total,54,43,40,6,34,3,0,11,3,3,4,1,0
S01008697,Rented or living rent free: Social rented,4,1,1,0,1,0,0,3,2,0,0,1,0
S01008697,Rented or living rent free: Private rented or living rent free,50,42,39,6,33,3,0,8,1,3,4,0,0
S01008698,All HRPs aged 16 and over,209,132,104,28,76,26,2,77,73,0,2,1,1
S01008698,Owned: Total,187,112,90,22,68,20,2,75,73,0,1,0,1
S01008698,Owned: Owned outright,116,45,36,16,20,7,2,71,69,0,1,0,1
S01008698,Owned: Owned with a mortgage or loan or shared ownership,71,67,54,6,48,13,0,4,4,0,0,0,0
S01008698,Rented or living rent free: Total,22,20,14,6,8,6,0,2,0,0,1,1,0
S01008698,Rented or living rent free: Social rented,5,4,3,0,3,1,0,1,0,0,1,0,0
S01008698,Rented or living rent free: Private rented or living rent free,17,16,11,6,5,5,0,1,0,0,0,1,0
S01008699,All HRPs aged 16 and over,470,249,204,34,170,28,17,221,167,2,10,30,12
S01008699,Owned: Total,281,172,145,20,125,23,4,109,102,0,1,3,3
S01008699,Owned: Owned outright,143,42,33,9,24,8,1,101,97,0,1,2,1
S01008699,Owned: Owned with a mortgage or loan or shared ownership,138,130,112,11,101,15,3,8,5,0,0,1,2
S01008699,Rented or living rent free: Total,189,77,59,14,45,5,13,112,65,2,9,27,9
S01008699,Rented or living rent free: Social rented,121,33,27,9,18,2,4,88,57,0,2,22,7
S01008699,Rented or living rent free: Private rented or living rent free,68,44,32,5,27,3,9,24,8,2,7,5,2
S01008700,All HRPs aged 16 and over,248,144,106,12,94,36,2,104,84,3,9,5,3
S01008700,Owned: Total,201,118,84,8,76,33,1,83,80,0,2,0,1
S01008700,Owned: Owned outright,111,35,23,3,20,12,0,76,75,0,1,0,0
S01008700,Owned: Owned with a mortgage or loan or shared ownership,90,83,61,5,56,21,1,7,5,0,1,0,1
S01008700,Rented or living rent free: Total,47,26,22,4,18,3,1,21,4,3,7,5,2
S01008700,Rented or living rent free: Social rented,6,1,1,0,1,0,0,5,1,0,2,0,2
S01008700,Rented or living rent free: Private rented or living rent free,41,25,21,4,17,3,1,16,3,3,5,5,0
S01008701,All HRPs aged 16 and over,200,126,97,33,64,8,21,74,23,6,6,31,8
S01008701,Owned: Total,40,36,32,5,27,4,0,4,3,0,0,1,0
S01008701,Owned: Owned outright,5,2,0,0,0,2,0,3,2,0,0,1,0
S01008701,Owned: Owned with a mortgage or loan or shared ownership,35,34,32,5,27,2,0,1,1,0,0,0,0
S01008701,Rented or living rent free: Total,160,90,65,28,37,4,21,70,20,6,6,30,8
S01008701,Rented or living rent free: Social rented,154,86,61,27,34,4,21,68,20,5,6,30,7
S01008701,Rented or living rent free: Private rented or living rent free,6,4,4,1,3,0,0,2,0,1,0,0,1
S01008702,All HRPs aged 16 and over,312,236,197,34,163,18,21,76,17,28,9,16,6
S01008702,Owned: Total,108,85,70,8,62,10,5,23,12,3,1,6,1
S01008702,Owned: Owned outright,42,24,17,6,11,4,3,18,10,2,1,4,1
S01008702,Owned: Owned with a mortgage or loan or shared ownership,66,61,53,2,51,6,2,5,2,1,0,2,0
S01008702,Rented or living rent free: Total,204,151,127,26,101,8,16,53,5,25,8,10,5
S01008702,Rented or living rent free: Social rented,38,22,12,4,8,2,8,16,2,0,3,9,2
S01008702,Rented or living rent free: Private rented or living rent free,166,129,115,22,93,6,8,37,3,25,5,1,3
S01008703,All HRPs aged 16 and over,456,262,195,55,140,29,38,194,67,13,40,50,24
S01008703,Owned: Total,87,70,55,13,42,13,2,17,12,1,0,3,1
S01008703,Owned: Owned outright,18,7,5,2,3,0,2,11,9,1,0,0,1
S01008703,Owned: Owned with a mortgage or loan or shared ownership,69,63,50,11,39,13,0,6,3,0,0,3,0
S01008703,Rented or living rent free: Total,369,192,140,42,98,16,36,177,55,12,40,47,23
S01008703,Rented or living rent free: Social rented,328,167,120,37,83,13,34,161,55,1,38,44,23
S01008703,Rented or living rent free: Private rented or living rent free,41,25,20,5,15,3,2,16,0,11,2,3,0
S01008704,All HRPs aged 16 and over,307,177,145,34,111,18,14,130,56,3,19,42,10
S01008704,Owned: Total,94,82,70,9,61,12,0,12,10,0,0,1,1
S01008704,Owned: Owned outright,19,10,8,3,5,2,0,9,9,0,0,0,0
S01008704,Owned: Owned with a mortgage or loan or shared ownership,75,72,62,6,56,10,0,3,1,0,0,1,1
S01008704,Rented or living rent free: Total,213,95,75,25,50,6,14,118,46,3,19,41,9
S01008704,Rented or living rent free: Social rented,183,75,59,21,38,4,12,108,44,0,18,39,7
S01008704,Rented or living rent free: Private rented or living rent free,30,20,16,4,12,2,2,10,2,3,1,2,2
S01008705,All HRPs aged 16 and over,236,131,107,28,79,16,8,105,54,5,13,22,11
S01008705,Owned: Total,71,65,52,9,43,11,2,6,6,0,0,0,0
S01008705,Owned: Owned outright,14,8,7,2,5,1,0,6,6,0,0,0,0
S01008705,Owned: Owned with a mortgage or loan or shared ownership,57,57,45,7,38,10,2,0,0,0,0,0,0
S01008705,Rented or living rent free: Total,165,66,55,19,36,5,6,99,48,5,13,22,11
S01008705,Rented or living rent free: Social rented,127,45,37,11,26,3,5,82,47,0,5,21,9
S01008705,Rented or living rent free: Private rented or living rent free,38,21,18,8,10,2,1,17,1,5,8,1,2
S01008706,All HRPs aged 16 and over,243,153,121,31,90,12,20,90,34,3,21,28,4
S01008706,Owned: Total,38,36,32,4,28,3,1,2,1,0,1,0,0
S01008706,Owned: Owned outright,4,3,2,1,1,0,1,1,1,0,0,0,0
S01008706,Owned: Owned with a mortgage or loan or shared ownership,34,33,30,3,27,3,0,1,0,0,1,0,0
S01008706,Rented or living rent free: Total,205,117,89,27,62,9,19,88,33,3,20,28,4
S01008706,Rented or living rent free: Social rented,189,108,81,24,57,8,19,81,33,1,16,27,4
S01008706,Rented or living rent free: Private rented or living rent free,16,9,8,3,5,1,0,7,0,2,4,1,0
S01008707,All HRPs aged 16 and over,387,206,155,55,100,23,28,181,42,5,62,48,24
S01008707,Owned: Total,84,71,59,12,47,10,2,13,5,2,1,1,4
S01008707,Owned: Owned outright,21,10,7,4,3,2,1,11,5,2,0,0,4
S01008707,Owned: Owned with a mortgage or loan or shared ownership,63,61,52,8,44,8,1,2,0,0,1,1,0
S01008707,Rented or living rent free: Total,303,135,96,43,53,13,26,168,37,3,61,47,20
S01008707,Rented or living rent free: Social rented,271,121,86,39,47,10,25,150,37,2,48,45,18
S01008707,Rented or living rent free: Private rented or living rent free,32,14,10,4,6,3,1,18,0,1,13,2,2
S01008708,All HRPs aged 16 and over,452,250,180,68,112,17,53,202,57,12,31,83,19
S01008708,Owned: Total,35,34,30,4,26,3,1,1,1,0,0,0,0
S01008708,Owned: Owned outright,4,3,2,0,2,0,1,1,1,0,0,0,0
S01008708,Owned: Owned with a mortgage or loan or shared ownership,31,31,28,4,24,3,0,0,0,0,0,0,0
S01008708,Rented or living rent free: Total,417,216,150,64,86,14,52,201,56,12,31,83,19
S01008708,Rented or living rent free: Social rented,390,206,141,61,80,13,52,184,52,11,26,76,19
S01008708,Rented or living rent free: Private rented or living rent free,27,10,9,3,6,1,0,17,4,1,5,7,0
S01008709,All HRPs aged 16 and over,299,179,147,43,104,19,13,120,51,3,28,30,8
S01008709,Owned: Total,119,91,77,14,63,13,1,28,21,0,2,3,2
S01008709,Owned: Owned outright,39,19,17,5,12,2,0,20,16,0,0,2,2
S01008709,Owned: Owned with a mortgage or loan or shared ownership,80,72,60,9,51,11,1,8,5,0,2,1,0
S01008709,Rented or living rent free: Total,180,88,70,29,41,6,12,92,30,3,26,27,6
S01008709,Rented or living rent free: Social rented,138,74,61,26,35,4,9,64,26,1,10,24,3
S01008709,Rented or living rent free: Private rented or living rent free,42,14,9,3,6,2,3,28,4,2,16,3,3
S01008710,All HRPs aged 16 and over,208,130,99,24,75,13,18,78,26,9,13,20,10
S01008710,Owned: Total,66,58,48,4,44,8,2,8,3,3,0,1,1
S01008710,Owned: Owned outright,9,4,3,1,2,1,0,5,2,1,0,1,1
S01008710,Owned: Owned with a mortgage or loan or shared ownership,57,54,45,3,42,7,2,3,1,2,0,0,0
S01008710,Rented or living rent free: Total,142,72,51,20,31,5,16,70,23,6,13,19,9
S01008710,Rented or living rent free: Social rented,116,57,41,15,26,3,13,59,21,4,9,18,7
S01008710,Rented or living rent free: Private rented or living rent free,26,15,10,5,5,2,3,11,2,2,4,1,2
S01008711,All HRPs aged 16 and over,353,176,148,46,102,11,17,177,107,3,20,35,12
S01008711,Owned: Total,122,75,65,15,50,9,1,47,46,0,0,0,1
S01008711,Owned: Owned outright,58,20,16,3,13,4,0,38,37,0,0,0,1
S01008711,Owned: Owned with a mortgage or loan or shared ownership,64,55,49,12,37,5,1,9,9,0,0,0,0
S01008711,Rented or living rent free: Total,231,101,83,31,52,2,16,130,61,3,20,35,11
S01008711,Rented or living rent free: Social rented,189,80,64,21,43,1,15,109,56,1,15,29,8
S01008711,Rented or living rent free: Private rented or living rent free,42,21,19,10,9,1,1,21,5,2,5,6,3
S01008712,All HRPs aged 16 and over,499,211,161,55,106,22,28,288,173,7,22,62,24
S01008712,Owned: Total,115,73,60,11,49,13,0,42,37,0,0,2,3
S01008712,Owned: Owned outright,54,21,17,3,14,4,0,33,29,0,0,2,2
S01008712,Owned: Owned with a mortgage or loan or shared ownership,61,52,43,8,35,9,0,9,8,0,0,0,1
S01008712,Rented or living rent free: Total,384,138,101,44,57,9,28,246,136,7,22,60,21
S01008712,Rented or living rent free: Social rented,345,118,86,37,49,6,26,227,133,5,16,55,18
S01008712,Rented or living rent free: Private rented or living rent free,39,20,15,7,8,3,2,19,3,2,6,5,3
S01008713,All HRPs aged 16 and over,292,180,135,42,93,17,28,112,48,3,22,30,9
S01008713,Owned: Total,75,56,45,11,34,11,0,19,15,0,2,2,0
S01008713,Owned: Owned outright,20,8,8,2,6,0,0,12,11,0,0,1,0
S01008713,Owned: Owned with a mortgage or loan or shared ownership,55,48,37,9,28,11,0,7,4,0,2,1,0
S01008713,Rented or living rent free: Total,217,124,90,31,59,6,28,93,33,3,20,28,9
S01008713,Rented or living rent free: Social rented,190,107,77,29,48,4,26,83,31,3,14,28,7
S01008713,Rented or living rent free: Private rented or living rent free,27,17,13,2,11,2,2,10,2,0,6,0,2
S01008714,All HRPs aged 16 and over,297,164,127,34,93,16,21,133,84,3,20,18,8
S01008714,Owned: Total,172,108,91,18,73,14,3,64,57,1,2,1,3
S01008714,Owned: Owned outright,82,25,21,6,15,3,1,57,51,0,2,1,3
S01008714,Owned: Owned with a mortgage or loan or shared ownership,90,83,70,12,58,11,2,7,6,1,0,0,0
S01008714,Rented or living rent free: Total,125,56,36,16,20,2,18,69,27,2,18,17,5
S01008714,Rented or living rent free: Social rented,81,33,21,10,11,0,12,48,24,1,8,12,3
S01008714,Rented or living rent free: Private rented or living rent free,44,23,15,6,9,2,6,21,3,1,10,5,2
S01008715,All HRPs aged 16 and over,367,180,156,34,122,15,9,187,144,0,13,21,9
S01008715,Owned: Total,219,111,99,14,85,11,1,108,101,0,2,4,1
S01008715,Owned: Owned outright,109,27,25,8,17,1,1,82,78,0,1,2,1
S01008715,Owned: Owned with a mortgage or loan or shared ownership,110,84,74,6,68,10,0,26,23,0,1,2,0
S01008715,Rented or living rent free: Total,148,69,57,20,37,4,8,79,43,0,11,17,8
S01008715,Rented or living rent free: Social rented,123,55,45,17,28,4,6,68,42,0,8,12,6
S01008715,Rented or living rent free: Private rented or living rent free,25,14,12,3,9,0,2,11,1,0,3,5,2
S01008716,All HRPs aged 16 and over,295,134,107,15,92,21,6,161,126,5,11,15,4
S01008716,Owned: Total,156,92,75,7,68,16,1,64,62,0,0,2,0
S01008716,Owned: Owned outright,67,15,13,3,10,2,0,52,52,0,0,0,0
S01008716,Owned: Owned with a mortgage or loan or shared ownership,89,77,62,4,58,14,1,12,10,0,0,2,0
S01008716,Rented or living rent free: Total,139,42,32,8,24,5,5,97,64,5,11,13,4
S01008716,Rented or living rent free: Social rented,106,24,18,4,14,4,2,82,56,5,7,11,3
S01008716,Rented or living rent free: Private rented or living rent free,33,18,14,4,10,1,3,15,8,0,4,2,1
S01008717,All HRPs aged 16 and over,181,140,116,18,98,19,5,41,23,5,6,3,4
S01008717,Owned: Total,148,121,101,14,87,18,2,27,21,2,2,0,2
S01008717,Owned: Owned outright,42,22,19,5,14,3,0,20,16,2,1,0,1
S01008717,Owned: Owned with a mortgage or loan or shared ownership,106,99,82,9,73,15,2,7,5,0,1,0,1
S01008717,Rented or living rent free: Total,33,19,15,4,11,1,3,14,2,3,4,3,2
S01008717,Rented or living rent free: Social rented,5,4,3,0,3,0,1,1,0,0,0,0,1
S01008717,Rented or living rent free: Private rented or living rent free,28,15,12,4,8,1,2,13,2,3,4,3,1
S01008718,All HRPs aged 16 and over,222,152,128,15,113,23,1,70,54,2,4,9,1
S01008718,Owned: Total,193,135,115,12,103,20,0,58,49,0,2,7,0
S01008718,Owned: Owned outright,71,24,20,3,17,4,0,47,43,0,1,3,0
S01008718,Owned: Owned with a mortgage or loan or shared ownership,122,111,95,9,86,16,0,11,6,0,1,4,0
S01008718,Rented or living rent free: Total,29,17,13,3,10,3,1,12,5,2,2,2,1
S01008718,Rented or living rent free: Social rented,9,6,4,2,2,2,0,3,3,0,0,0,0
S01008718,Rented or living rent free: Private rented or living rent free,20,11,9,1,8,1,1,9,2,2,2,2,1
S01008719,All HRPs aged 16 and over,420,307,235,47,188,62,10,113,60,7,23,12,11
S01008719,Owned: Total,313,249,195,29,166,51,3,64,55,0,3,1,5
S01008719,Owned: Owned outright,93,41,29,8,21,11,1,52,49,0,1,1,1
S01008719,Owned: Owned with a mortgage or loan or shared ownership,220,208,166,21,145,40,2,12,6,0,2,0,4
S01008719,Rented or living rent free: Total,107,58,40,18,22,11,7,49,5,7,20,11,6
S01008719,Rented or living rent free: Social rented,17,5,2,1,1,1,2,12,1,1,3,7,0
S01008719,Rented or living rent free: Private rented or living rent free,90,53,38,17,21,10,5,37,4,6,17,4,6
S01008720,All HRPs aged 16 and over,243,148,115,21,94,24,9,95,59,5,12,12,7
S01008720,Owned: Total,162,112,86,14,72,24,2,50,44,0,1,3,2
S01008720,Owned: Owned outright,77,33,24,7,17,9,0,44,40,0,1,1,2
S01008720,Owned: Owned with a mortgage or loan or shared ownership,85,79,62,7,55,15,2,6,4,0,0,2,0
S01008720,Rented or living rent free: Total,81,36,29,7,22,0,7,45,15,5,11,9,5
S01008720,Rented or living rent free: Social rented,29,11,9,1,8,0,2,18,11,0,0,3,4
S01008720,Rented or living rent free: Private rented or living rent free,52,25,20,6,14,0,5,27,4,5,11,6,1
S01008721,All HRPs aged 16 and over,310,264,217,22,195,44,3,46,34,2,3,5,2
S01008721,Owned: Total,285,246,202,16,186,44,0,39,32,1,2,2,2
S01008721,Owned: Owned outright,86,51,42,6,36,9,0,35,31,0,1,1,2
S01008721,Owned: Owned with a mortgage or loan or shared ownership,199,195,160,10,150,35,0,4,1,1,1,1,0
S01008721,Rented or living rent free: Total,25,18,15,6,9,0,3,7,2,1,1,3,0
S01008721,Rented or living rent free: Social rented,4,1,0,0,0,0,1,3,1,0,0,2,0
S01008721,Rented or living rent free: Private rented or living rent free,21,17,15,6,9,0,2,4,1,1,1,1,0
S01008722,All HRPs aged 16 and over,480,248,183,22,161,61,4,232,213,3,4,10,2
S01008722,Owned: Total,378,230,171,20,151,57,2,148,141,0,2,4,1
S01008722,Owned: Owned outright,205,78,49,13,36,29,0,127,123,0,1,2,1
S01008722,Owned: Owned with a mortgage or loan or shared ownership,173,152,122,7,115,28,2,21,18,0,1,2,0
S01008722,Rented or living rent free: Total,102,18,12,2,10,4,2,84,72,3,2,6,1
S01008722,Rented or living rent free: Social rented,80,4,3,1,2,0,1,76,69,1,0,5,1
S01008722,Rented or living rent free: Private rented or living rent free,22,14,9,1,8,4,1,8,3,2,2,1,0
S01008723,All HRPs aged 16 and over,257,182,147,18,129,35,0,75,67,1,4,2,1
S01008723,Owned: Total,228,158,124,15,109,34,0,70,64,1,3,1,1
S01008723,Owned: Owned outright,100,41,30,9,21,11,0,59,56,1,0,1,1
S01008723,Owned: Owned with a mortgage or loan or shared ownership,128,117,94,6,88,23,0,11,8,0,3,0,0
S01008723,Rented or living rent free: Total,29,24,23,3,20,1,0,5,3,0,1,1,0
S01008723,Rented or living rent free: Social rented,16,13,13,1,12,0,0,3,2,0,0,1,0
S01008723,Rented or living rent free: Private rented or living rent free,13,11,10,2,8,1,0,2,1,0,1,0,0
S01008724,All HRPs aged 16 and over,400,243,184,29,155,55,4,157,143,1,3,5,5
S01008724,Owned: Total,315,208,154,21,133,52,2,107,105,0,1,0,1
S01008724,Owned: Owned outright,153,60,44,11,33,14,2,93,92,0,0,0,1
S01008724,Owned: Owned with a mortgage or loan or shared ownership,162,148,110,10,100,38,0,14,13,0,1,0,0
S01008724,Rented or living rent free: Total,85,35,30,8,22,3,2,50,38,1,2,5,4
S01008724,Rented or living rent free: Social rented,51,17,16,4,12,0,1,34,28,0,1,3,2
S01008724,Rented or living rent free: Private rented or living rent free,34,18,14,4,10,3,1,16,10,1,1,2,2
S01008725,All HRPs aged 16 and over,343,239,187,23,164,44,8,104,86,1,1,8,8
S01008725,Owned: Total,276,191,151,17,134,37,3,85,77,0,1,3,4
S01008725,Owned: Owned outright,138,62,47,11,36,12,3,76,69,0,1,3,3
S01008725,Owned: Owned with a mortgage or loan or shared ownership,138,129,104,6,98,25,0,9,8,0,0,0,1
S01008725,Rented or living rent free: Total,67,48,36,6,30,7,5,19,9,1,0,5,4
S01008725,Rented or living rent free: Social rented,36,23,17,4,13,2,4,13,6,0,0,5,2
S01008725,Rented or living rent free: Private rented or living rent free,31,25,19,2,17,5,1,6,3,1,0,0,2
S01008726,All HRPs aged 16 and over,241,180,137,11,126,42,1,61,58,0,2,1,0
S01008726,Owned: Total,222,165,126,10,116,38,1,57,57,0,0,0,0
S01008726,Owned: Owned outright,97,46,30,7,23,16,0,51,51,0,0,0,0
S01008726,Owned: Owned with a mortgage or loan or shared ownership,125,119,96,3,93,22,1,6,6,0,0,0,0
S01008726,Rented or living rent free: Total,19,15,11,1,10,4,0,4,1,0,2,1,0
S01008726,Rented or living rent free: Social rented,3,2,1,0,1,1,0,1,0,0,0,1,0
S01008726,Rented or living rent free: Private rented or living rent free,16,13,10,1,9,3,0,3,1,0,2,0,0
S01008727,All HRPs aged 16 and over,454,295,231,27,204,56,8,159,125,8,7,12,7
S01008727,Owned: Total,356,237,185,21,164,50,2,119,109,4,1,3,2
S01008727,Owned: Owned outright,184,80,58,10,48,21,1,104,97,2,1,3,1
S01008727,Owned: Owned with a mortgage or loan or shared ownership,172,157,127,11,116,29,1,15,12,2,0,0,1
S01008727,Rented or living rent free: Total,98,58,46,6,40,6,6,40,16,4,6,9,5
S01008727,Rented or living rent free: Social rented,39,17,16,1,15,0,1,22,11,1,4,3,3
S01008727,Rented or living rent free: Private rented or living rent free,59,41,30,5,25,6,5,18,5,3,2,6,2
S01008728,All HRPs aged 16 and over,229,142,105,25,80,28,9,87,54,3,16,12,2
S01008728,Owned: Total,147,94,74,13,61,18,2,53,47,1,0,4,1
S01008728,Owned: Owned outright,66,20,15,5,10,4,1,46,44,1,0,0,1
S01008728,Owned: Owned with a mortgage or loan or shared ownership,81,74,59,8,51,14,1,7,3,0,0,4,0
S01008728,Rented or living rent free: Total,82,48,31,12,19,10,7,34,7,2,16,8,1
S01008728,Rented or living rent free: Social rented,48,23,17,9,8,2,4,25,7,2,8,7,1
S01008728,Rented or living rent free: Private rented or living rent free,34,25,14,3,11,8,3,9,0,0,8,1,0
S01008729,All HRPs aged 16 and over,277,205,152,22,130,52,1,72,57,0,9,5,1
S01008729,Owned: Total,228,178,131,12,119,47,0,50,48,0,0,1,1
S01008729,Owned: Owned outright,86,43,24,4,20,19,0,43,41,0,0,1,1
S01008729,Owned: Owned with a mortgage or loan or shared ownership,142,135,107,8,99,28,0,7,7,0,0,0,0
S01008729,Rented or living rent free: Total,49,27,21,10,11,5,1,22,9,0,9,4,0
S01008729,Rented or living rent free: Social rented,14,5,4,3,1,1,0,9,7,0,1,1,0
S01008729,Rented or living rent free: Private rented or living rent free,35,22,17,7,10,4,1,13,2,0,8,3,0
S01008730,All HRPs aged 16 and over,411,335,266,33,233,41,28,76,45,7,4,12,8
S01008730,Owned: Total,239,207,170,16,154,30,7,32,27,2,0,2,1
S01008730,Owned: Owned outright,65,41,28,4,24,10,3,24,23,0,0,1,0
S01008730,Owned: Owned with a mortgage or loan or shared ownership,174,166,142,12,130,20,4,8,4,2,0,1,1
S01008730,Rented or living rent free: Total,172,128,96,17,79,11,21,44,18,5,4,10,7
S01008730,Rented or living rent free: Social rented,42,26,18,3,15,1,7,16,8,0,1,5,2
S01008730,Rented or living rent free: Private rented or living rent free,130,102,78,14,64,10,14,28,10,5,3,5,5
S01008731,All HRPs aged 16 and over,226,115,92,18,74,13,10,111,91,2,2,14,2
S01008731,Owned: Total,154,85,71,11,60,12,2,69,63,1,0,4,1
S01008731,Owned: Owned outright,80,21,14,8,6,7,0,59,54,0,0,4,1
S01008731,Owned: Owned with a mortgage or loan or shared ownership,74,64,57,3,54,5,2,10,9,1,0,0,0
S01008731,Rented or living rent free: Total,72,30,21,7,14,1,8,42,28,1,2,10,1
S01008731,Rented or living rent free: Social rented,39,10,6,2,4,0,4,29,19,1,2,6,1
S01008731,Rented or living rent free: Private rented or living rent free,33,20,15,5,10,1,4,13,9,0,0,4,0
S01008732,All HRPs aged 16 and over,340,215,159,23,136,36,20,125,72,5,14,31,3
S01008732,Owned: Total,178,128,101,11,90,24,3,50,44,0,3,3,0
S01008732,Owned: Owned outright,68,28,23,5,18,3,2,40,39,0,0,1,0
S01008732,Owned: Owned with a mortgage or loan or shared ownership,110,100,78,6,72,21,1,10,5,0,3,2,0
S01008732,Rented or living rent free: Total,162,87,58,12,46,12,17,75,28,5,11,28,3
S01008732,Rented or living rent free: Social rented,72,25,18,4,14,4,3,47,19,2,8,16,2
S01008732,Rented or living rent free: Private rented or living rent free,90,62,40,8,32,8,14,28,9,3,3,12,1
S01008733,All HRPs aged 16 and over,473,349,307,34,273,27,15,124,89,5,8,15,7
S01008733,Owned: Total,326,245,223,23,200,21,1,81,67,3,0,7,4
S01008733,Owned: Owned outright,104,38,34,12,22,4,0,66,59,1,0,3,3
S01008733,Owned: Owned with a mortgage or loan or shared ownership,222,207,189,11,178,17,1,15,8,2,0,4,1
S01008733,Rented or living rent free: Total,147,104,84,11,73,6,14,43,22,2,8,8,3
S01008733,Rented or living rent free: Social rented,27,16,13,2,11,0,3,11,8,0,0,2,1
S01008733,Rented or living rent free: Private rented or living rent free,120,88,71,9,62,6,11,32,14,2,8,6,2
S01008734,All HRPs aged 16 and over,266,167,135,18,117,27,5,99,72,7,4,13,3
S01008734,Owned: Total,208,134,107,11,96,25,2,74,65,4,0,2,3
S01008734,Owned: Owned outright,96,31,24,1,23,6,1,65,57,4,0,2,2
S01008734,Owned: Owned with a mortgage or loan or shared ownership,112,103,83,10,73,19,1,9,8,0,0,0,1
S01008734,Rented or living rent free: Total,58,33,28,7,21,2,3,25,7,3,4,11,0
S01008734,Rented or living rent free: Social rented,28,11,11,2,9,0,0,17,5,0,2,10,0
S01008734,Rented or living rent free: Private rented or living rent free,30,22,17,5,12,2,3,8,2,3,2,1,0
S01008735,All HRPs aged 16 and over,385,231,165,20,145,60,6,154,147,0,4,2,1
S01008735,Owned: Total,361,215,152,18,134,58,5,146,145,0,0,0,1
S01008735,Owned: Owned outright,201,64,48,12,36,13,3,137,136,0,0,0,1
S01008735,Owned: Owned with a mortgage or loan or shared ownership,160,151,104,6,98,45,2,9,9,0,0,0,0
S01008735,Rented or living rent free: Total,24,16,13,2,11,2,1,8,2,0,4,2,0
S01008735,Rented or living rent free: Social rented,2,2,2,1,1,0,0,0,0,0,0,0,0
S01008735,Rented or living rent free: Private rented or living rent free,22,14,11,1,10,2,1,8,2,0,4,2,0
S01008736,All HRPs aged 16 and over,290,164,130,17,113,28,6,126,110,0,3,6,7
S01008736,Owned: Total,250,142,115,12,103,25,2,108,102,0,2,1,3
S01008736,Owned: Owned outright,148,47,39,9,30,7,1,101,97,0,0,1,3
S01008736,Owned: Owned with a mortgage or loan or shared ownership,102,95,76,3,73,18,1,7,5,0,2,0,0
S01008736,Rented or living rent free: Total,40,22,15,5,10,3,4,18,8,0,1,5,4
S01008736,Rented or living rent free: Social rented,30,14,8,5,3,2,4,16,6,0,1,5,4
S01008736,Rented or living rent free: Private rented or living rent free,10,8,7,0,7,1,0,2,2,0,0,0,0
S01008737,All HRPs aged 16 and over,339,195,163,30,133,30,2,144,131,1,5,2,5
S01008737,Owned: Total,314,179,149,26,123,30,0,135,127,1,3,2,2
S01008737,Owned: Owned outright,193,65,54,15,39,11,0,128,120,1,3,2,2
S01008737,Owned: Owned with a mortgage or loan or shared ownership,121,114,95,11,84,19,0,7,7,0,0,0,0
S01008737,Rented or living rent free: Total,25,16,14,4,10,0,2,9,4,0,2,0,3
S01008737,Rented or living rent free: Social rented,6,3,2,0,2,0,1,3,1,0,1,0,1
S01008737,Rented or living rent free: Private rented or living rent free,19,13,12,4,8,0,1,6,3,0,1,0,2
S01008738,All HRPs aged 16 and over,299,172,132,25,107,39,1,127,121,0,3,2,1
S01008738,Owned: Total,291,169,131,25,106,38,0,122,121,0,1,0,0
S01008738,Owned: Owned outright,174,57,47,16,31,10,0,117,117,0,0,0,0
S01008738,Owned: Owned with a mortgage or loan or shared ownership,117,112,84,9,75,28,0,5,4,0,1,0,0
S01008738,Rented or living rent free: Total,8,3,1,0,1,1,1,5,0,0,2,2,1
S01008738,Rented or living rent free: Social rented,3,1,1,0,1,0,0,2,0,0,0,2,0
S01008738,Rented or living rent free: Private rented or living rent free,5,2,0,0,0,1,1,3,0,0,2,0,1
S01008739,All HRPs aged 16 and over,240,155,125,20,105,28,2,85,75,1,4,4,1
S01008739,Owned: Total,214,142,116,19,97,26,0,72,67,0,4,1,0
S01008739,Owned: Owned outright,113,48,36,6,30,12,0,65,61,0,3,1,0
S01008739,Owned: Owned with a mortgage or loan or shared ownership,101,94,80,13,67,14,0,7,6,0,1,0,0
S01008739,Rented or living rent free: Total,26,13,9,1,8,2,2,13,8,1,0,3,1
S01008739,Rented or living rent free: Social rented,12,3,2,0,2,0,1,9,7,0,0,2,0
S01008739,Rented or living rent free: Private rented or living rent free,14,10,7,1,6,2,1,4,1,1,0,1,1
S01008740,All HRPs aged 16 and over,227,134,113,19,94,20,1,93,82,1,4,4,2
S01008740,Owned: Total,215,127,108,18,90,19,0,88,81,1,3,2,1
S01008740,Owned: Owned outright,121,42,37,15,22,5,0,79,75,0,3,0,1
S01008740,Owned: Owned with a mortgage or loan or shared ownership,94,85,71,3,68,14,0,9,6,1,0,2,0
S01008740,Rented or living rent free: Total,12,7,5,1,4,1,1,5,1,0,1,2,1
S01008740,Rented or living rent free: Social rented,5,2,2,0,2,0,0,3,1,0,1,1,0
S01008740,Rented or living rent free: Private rented or living rent free,7,5,3,1,2,1,1,2,0,0,0,1,1
S01008741,All HRPs aged 16 and over,395,226,180,17,163,41,5,169,159,2,3,2,3
S01008741,Owned: Total,373,213,170,13,157,41,2,160,156,1,0,2,1
S01008741,Owned: Owned outright,220,70,53,9,44,15,2,150,148,1,0,1,0
S01008741,Owned: Owned with a mortgage or loan or shared ownership,153,143,117,4,113,26,0,10,8,0,0,1,1
S01008741,Rented or living rent free: Total,22,13,10,4,6,0,3,9,3,1,3,0,2
S01008741,Rented or living rent free: Social rented,10,4,2,1,1,0,2,6,2,1,1,0,2
S01008741,Rented or living rent free: Private rented or living rent free,12,9,8,3,5,0,1,3,1,0,2,0,0
S01008742,All HRPs aged 16 and over,280,129,106,18,88,21,2,151,135,2,2,7,5
S01008742,Owned: Total,190,93,72,11,61,20,1,97,93,1,2,1,0
S01008742,Owned: Owned outright,118,28,23,6,17,4,1,90,88,1,1,0,0
S01008742,Owned: Owned with a mortgage or loan or shared ownership,72,65,49,5,44,16,0,7,5,0,1,1,0
S01008742,Rented or living rent free: Total,90,36,34,7,27,1,1,54,42,1,0,6,5
S01008742,Rented or living rent free: Social rented,50,3,3,3,0,0,0,47,36,0,0,6,5
S01008742,Rented or living rent free: Private rented or living rent free,40,33,31,4,27,1,1,7,6,1,0,0,0
S01008743,All HRPs aged 16 and over,485,288,235,44,191,31,22,197,127,11,17,34,8
S01008743,Owned: Total,261,184,152,20,132,23,9,77,72,2,1,2,0
S01008743,Owned: Owned outright,101,39,32,8,24,6,1,62,59,1,0,2,0
S01008743,Owned: Owned with a mortgage or loan or shared ownership,160,145,120,12,108,17,8,15,13,1,1,0,0
S01008743,Rented or living rent free: Total,224,104,83,24,59,8,13,120,55,9,16,32,8
S01008743,Rented or living rent free: Social rented,124,40,30,9,21,3,7,84,48,0,4,26,6
S01008743,Rented or living rent free: Private rented or living rent free,100,64,53,15,38,5,6,36,7,9,12,6,2
S01008744,All HRPs aged 16 and over,519,300,260,41,219,28,12,219,176,4,13,17,9
S01008744,Owned: Total,361,220,196,25,171,23,1,141,132,0,4,4,1
S01008744,Owned: Owned outright,164,44,40,8,32,4,0,120,116,0,1,2,1
S01008744,Owned: Owned with a mortgage or loan or shared ownership,197,176,156,17,139,19,1,21,16,0,3,2,0
S01008744,Rented or living rent free: Total,158,80,64,16,48,5,11,78,44,4,9,13,8
S01008744,Rented or living rent free: Social rented,79,30,25,4,21,1,4,49,33,0,2,9,5
S01008744,Rented or living rent free: Private rented or living rent free,79,50,39,12,27,4,7,29,11,4,7,4,3
S01008745,All HRPs aged 16 and over,241,152,131,19,112,19,2,89,74,4,7,3,1
S01008745,Owned: Total,195,120,101,13,88,18,1,75,70,2,1,1,1
S01008745,Owned: Owned outright,109,36,31,7,24,5,0,73,69,2,0,1,1
S01008745,Owned: Owned with a mortgage or loan or shared ownership,86,84,70,6,64,13,1,2,1,0,1,0,0
S01008745,Rented or living rent free: Total,46,32,30,6,24,1,1,14,4,2,6,2,0
S01008745,Rented or living rent free: Social rented,4,1,1,0,1,0,0,3,1,0,2,0,0
S01008745,Rented or living rent free: Private rented or living rent free,42,31,29,6,23,1,1,11,3,2,4,2,0
S01008746,All HRPs aged 16 and over,572,347,284,55,229,29,34,225,131,12,24,52,6
S01008746,Owned: Total,225,153,132,11,121,17,4,72,68,2,0,1,1
S01008746,Owned: Owned outright,83,17,13,3,10,4,0,66,63,2,0,0,1
S01008746,Owned: Owned with a mortgage or loan or shared ownership,142,136,119,8,111,13,4,6,5,0,0,1,0
S01008746,Rented or living rent free: Total,347,194,152,44,108,12,30,153,63,10,24,51,5
S01008746,Rented or living rent free: Social rented,214,96,69,22,47,7,20,118,55,3,18,38,4
S01008746,Rented or living rent free: Private rented or living rent free,133,98,83,22,61,5,10,35,8,7,6,13,1
S01008747,All HRPs aged 16 and over,234,132,99,16,83,33,0,102,90,4,4,2,2
S01008747,Owned: Total,208,118,90,13,77,28,0,90,86,1,1,1,1
S01008747,Owned: Owned outright,113,33,22,10,12,11,0,80,79,0,1,0,0
S01008747,Owned: Owned with a mortgage or loan or shared ownership,95,85,68,3,65,17,0,10,7,1,0,1,1
S01008747,Rented or living rent free: Total,26,14,9,3,6,5,0,12,4,3,3,1,1
S01008747,Rented or living rent free: Social rented,4,2,2,1,1,0,0,2,0,0,1,1,0
S01008747,Rented or living rent free: Private rented or living rent free,22,12,7,2,5,5,0,10,4,3,2,0,1
S01008748,All HRPs aged 16 and over,283,160,133,22,111,25,2,123,118,0,0,1,4
S01008748,Owned: Total,261,147,121,19,102,25,1,114,113,0,0,0,1
S01008748,Owned: Owned outright,168,58,45,14,31,12,1,110,109,0,0,0,1
S01008748,Owned: Owned with a mortgage or loan or shared ownership,93,89,76,5,71,13,0,4,4,0,0,0,0
S01008748,Rented or living rent free: Total,22,13,12,3,9,0,1,9,5,0,0,1,3
S01008748,Rented or living rent free: Social rented,7,4,3,2,1,0,1,3,1,0,0,1,1
S01008748,Rented or living rent free: Private rented or living rent free,15,9,9,1,8,0,0,6,4,0,0,0,2
S01008749,All HRPs aged 16 and over,402,240,182,28,154,53,5,162,149,0,6,4,3
S01008749,Owned: Total,369,222,171,24,147,49,2,147,139,0,3,3,2
S01008749,Owned: Owned outright,208,75,55,17,38,19,1,133,128,0,2,1,2
S01008749,Owned: Owned with a mortgage or loan or shared ownership,161,147,116,7,109,30,1,14,11,0,1,2,0
S01008749,Rented or living rent free: Total,33,18,11,4,7,4,3,15,10,0,3,1,1
S01008749,Rented or living rent free: Social rented,13,5,4,3,1,1,0,8,5,0,2,1,0
S01008749,Rented or living rent free: Private rented or living rent free,20,13,7,1,6,3,3,7,5,0,1,0,1
S01008750,All HRPs aged 16 and over,313,177,138,25,113,35,4,136,129,1,3,2,1
S01008750,Owned: Total,290,163,130,20,110,32,1,127,123,1,1,1,1
S01008750,Owned: Owned outright,184,65,49,15,34,16,0,119,117,1,0,0,1
S01008750,Owned: Owned with a mortgage or loan or shared ownership,106,98,81,5,76,16,1,8,6,0,1,1,0
S01008750,Rented or living rent free: Total,23,14,8,5,3,3,3,9,6,0,2,1,0
S01008750,Rented or living rent free: Social rented,8,7,5,4,1,0,2,1,1,0,0,0,0
S01008750,Rented or living rent free: Private rented or living rent free,15,7,3,1,2,3,1,8,5,0,2,1,0
S01008751,All HRPs aged 16 and over,304,157,118,17,101,26,13,147,114,2,8,21,2
S01008751,Owned: Total,188,117,96,9,87,20,1,71,69,0,0,2,0
S01008751,Owned: Owned outright,92,31,25,5,20,5,1,61,59,0,0,2,0
S01008751,Owned: Owned with a mortgage or loan or shared ownership,96,86,71,4,67,15,0,10,10,0,0,0,0
S01008751,Rented or living rent free: Total,116,40,22,8,14,6,12,76,45,2,8,19,2
S01008751,Rented or living rent free: Social rented,84,25,15,6,9,3,7,59,42,0,1,15,1
S01008751,Rented or living rent free: Private rented or living rent free,32,15,7,2,5,3,5,17,3,2,7,4,1
S01008752,All HRPs aged 16 and over,459,239,194,53,141,14,31,220,113,5,39,45,18
S01008752,Owned: Total,180,103,93,17,76,7,3,77,69,3,0,3,2
S01008752,Owned: Owned outright,81,17,14,5,9,1,2,64,58,3,0,2,1
S01008752,Owned: Owned with a mortgage or loan or shared ownership,99,86,79,12,67,6,1,13,11,0,0,1,1
S01008752,Rented or living rent free: Total,279,136,101,36,65,7,28,143,44,2,39,42,16
S01008752,Rented or living rent free: Social rented,194,88,62,25,37,2,24,106,34,2,26,33,11
S01008752,Rented or living rent free: Private rented or living rent free,85,48,39,11,28,5,4,37,10,0,13,9,5
S01008753,All HRPs aged 16 and over,314,167,130,30,100,14,23,147,84,2,3,48,10
S01008753,Owned: Total,147,89,77,9,68,9,3,58,48,0,0,9,1
S01008753,Owned: Owned outright,64,13,9,1,8,3,1,51,43,0,0,7,1
S01008753,Owned: Owned with a mortgage or loan or shared ownership,83,76,68,8,60,6,2,7,5,0,0,2,0
S01008753,Rented or living rent free: Total,167,78,53,21,32,5,20,89,36,2,3,39,9
S01008753,Rented or living rent free: Social rented,109,33,21,8,13,1,11,76,33,0,2,34,7
S01008753,Rented or living rent free: Private rented or living rent free,58,45,32,13,19,4,9,13,3,2,1,5,2
S01008754,All HRPs aged 16 and over,362,250,223,30,193,18,9,112,67,7,2,27,9
S01008754,Owned: Total,163,127,112,8,104,12,3,36,33,1,1,1,0
S01008754,Owned: Owned outright,53,20,17,3,14,1,2,33,32,0,0,1,0
S01008754,Owned: Owned with a mortgage or loan or shared ownership,110,107,95,5,90,11,1,3,1,1,1,0,0
S01008754,Rented or living rent free: Total,199,123,111,22,89,6,6,76,34,6,1,26,9
S01008754,Rented or living rent free: Social rented,140,70,63,14,49,2,5,70,34,5,0,24,7
S01008754,Rented or living rent free: Private rented or living rent free,59,53,48,8,40,4,1,6,0,1,1,2,2
S01008755,All HRPs aged 16 and over,541,363,305,47,258,28,30,178,95,9,30,30,14
S01008755,Owned: Total,231,176,159,17,142,15,2,55,45,0,2,5,3
S01008755,Owned: Owned outright,57,18,16,5,11,2,0,39,36,0,0,2,1
S01008755,Owned: Owned with a mortgage or loan or shared ownership,174,158,143,12,131,13,2,16,9,0,2,3,2
S01008755,Rented or living rent free: Total,310,187,146,30,116,13,28,123,50,9,28,25,11
S01008755,Rented or living rent free: Social rented,180,89,65,20,45,8,16,91,44,0,16,22,9
S01008755,Rented or living rent free: Private rented or living rent free,130,98,81,10,71,5,12,32,6,9,12,3,2
S01008756,All HRPs aged 16 and over,418,251,206,36,170,18,27,167,96,3,8,45,15
S01008756,Owned: Total,195,136,119,15,104,16,1,59,53,2,0,2,2
S01008756,Owned: Owned outright,79,28,23,6,17,5,0,51,47,2,0,1,1
S01008756,Owned: Owned with a mortgage or loan or shared ownership,116,108,96,9,87,11,1,8,6,0,0,1,1
S01008756,Rented or living rent free: Total,223,115,87,21,66,2,26,108,43,1,8,43,13
S01008756,Rented or living rent free: Social rented,172,81,56,15,41,2,23,91,43,0,1,37,10
S01008756,Rented or living rent free: Private rented or living rent free,51,34,31,6,25,0,3,17,0,1,7,6,3
S01008757,All HRPs aged 16 and over,397,190,139,35,104,15,36,207,111,0,24,62,10
S01008757,Owned: Total,116,72,59,10,49,10,3,44,36,0,1,5,2
S01008757,Owned: Owned outright,42,10,7,1,6,2,1,32,27,0,1,2,2
S01008757,Owned: Owned with a mortgage or loan or shared ownership,74,62,52,9,43,8,2,12,9,0,0,3,0
S01008757,Rented or living rent free: Total,281,118,80,25,55,5,33,163,75,0,23,57,8
S01008757,Rented or living rent free: Social rented,236,94,62,21,41,4,28,142,72,0,11,52,7
S01008757,Rented or living rent free: Private rented or living rent free,45,24,18,4,14,1,5,21,3,0,12,5,1
S01008758,All HRPs aged 16 and over,444,243,190,43,147,34,19,201,124,4,12,48,13
S01008758,Owned: Total,222,134,110,19,91,20,4,88,74,1,0,6,7
S01008758,Owned: Owned outright,89,20,16,8,8,2,2,69,61,1,0,2,5
S01008758,Owned: Owned with a mortgage or loan or shared ownership,133,114,94,11,83,18,2,19,13,0,0,4,2
S01008758,Rented or living rent free: Total,222,109,80,24,56,14,15,113,50,3,12,42,6
S01008758,Rented or living rent free: Social rented,173,79,56,19,37,10,13,94,45,3,6,37,3
S01008758,Rented or living rent free: Private rented or living rent free,49,30,24,5,19,4,2,19,5,0,6,5,3
S01008759,All HRPs aged 16 and over,322,171,130,33,97,17,24,151,91,2,11,36,11
S01008759,Owned: Total,136,79,68,8,60,10,1,57,54,0,0,2,1
S01008759,Owned: Owned outright,60,13,12,3,9,1,0,47,44,0,0,2,1
S01008759,Owned: Owned with a mortgage or loan or shared ownership,76,66,56,5,51,9,1,10,10,0,0,0,0
S01008759,Rented or living rent free: Total,186,92,62,25,37,7,23,94,37,2,11,34,10
S01008759,Rented or living rent free: Social rented,147,72,47,20,27,7,18,75,34,2,5,25,9
S01008759,Rented or living rent free: Private rented or living rent free,39,20,15,5,10,0,5,19,3,0,6,9,1
S01008760,All HRPs aged 16 and over,500,292,236,84,152,19,37,208,88,4,29,73,14
S01008760,Owned: Total,152,109,98,21,77,8,3,43,37,0,2,2,2
S01008760,Owned: Owned outright,52,26,21,10,11,3,2,26,23,0,0,1,2
S01008760,Owned: Owned with a mortgage or loan or shared ownership,100,83,77,11,66,5,1,17,14,0,2,1,0
S01008760,Rented or living rent free: Total,348,183,138,63,75,11,34,165,51,4,27,71,12
S01008760,Rented or living rent free: Social rented,300,158,121,56,65,7,30,142,49,4,19,62,8
S01008760,Rented or living rent free: Private rented or living rent free,48,25,17,7,10,4,4,23,2,0,8,9,4
S01008761,All HRPs aged 16 and over,295,245,199,35,164,39,7,50,19,3,9,18,1
S01008761,Owned: Total,120,110,90,7,83,20,0,10,8,0,1,1,0
S01008761,Owned: Owned outright,25,17,13,2,11,4,0,8,8,0,0,0,0
S01008761,Owned: Owned with a mortgage or loan or shared ownership,95,93,77,5,72,16,0,2,0,0,1,1,0
S01008761,Rented or living rent free: Total,175,135,109,28,81,19,7,40,11,3,8,17,1
S01008761,Rented or living rent free: Social rented,35,17,10,3,7,4,3,18,8,0,1,8,1
S01008761,Rented or living rent free: Private rented or living rent free,140,118,99,25,74,15,4,22,3,3,7,9,0
S01008762,All HRPs aged 16 and over,301,195,169,26,143,23,3,106,94,2,3,5,2
S01008762,Owned: Total,256,166,142,20,122,22,2,90,87,0,0,2,1
S01008762,Owned: Owned outright,120,40,32,8,24,7,1,80,78,0,0,2,0
S01008762,Owned: Owned with a mortgage or loan or shared ownership,136,126,110,12,98,15,1,10,9,0,0,0,1
S01008762,Rented or living rent free: Total,45,29,27,6,21,1,1,16,7,2,3,3,1
S01008762,Rented or living rent free: Social rented,12,8,6,1,5,1,1,4,2,0,0,2,0
S01008762,Rented or living rent free: Private rented or living rent free,33,21,21,5,16,0,0,12,5,2,3,1,1
S01008763,All HRPs aged 16 and over,433,342,289,36,253,45,8,91,77,1,2,11,0
S01008763,Owned: Total,355,281,236,30,206,40,5,74,71,0,1,2,0
S01008763,Owned: Owned outright,135,68,53,16,37,11,4,67,65,0,1,1,0
S01008763,Owned: Owned with a mortgage or loan or shared ownership,220,213,183,14,169,29,1,7,6,0,0,1,0
S01008763,Rented or living rent free: Total,78,61,53,6,47,5,3,17,6,1,1,9,0
S01008763,Rented or living rent free: Social rented,15,8,4,1,3,1,3,7,2,0,0,5,0
S01008763,Rented or living rent free: Private rented or living rent free,63,53,49,5,44,4,0,10,4,1,1,4,0
S01008764,All HRPs aged 16 and over,306,225,189,16,173,28,8,81,55,3,7,11,5
S01008764,Owned: Total,230,185,157,11,146,25,3,45,43,0,1,1,0
S01008764,Owned: Owned outright,91,51,41,7,34,9,1,40,38,0,1,1,0
S01008764,Owned: Owned with a mortgage or loan or shared ownership,139,134,116,4,112,16,2,5,5,0,0,0,0
S01008764,Rented or living rent free: Total,76,40,32,5,27,3,5,36,12,3,6,10,5
S01008764,Rented or living rent free: Social rented,41,15,9,2,7,1,5,26,8,1,3,10,4
S01008764,Rented or living rent free: Private rented or living rent free,35,25,23,3,20,2,0,10,4,2,3,0,1
S01008765,All HRPs aged 16 and over,393,306,246,31,215,52,8,87,68,3,8,8,0
S01008765,Owned: Total,304,238,191,19,172,45,2,66,58,1,3,4,0
S01008765,Owned: Owned outright,100,43,36,7,29,6,1,57,55,0,1,1,0
S01008765,Owned: Owned with a mortgage or loan or shared ownership,204,195,155,12,143,39,1,9,3,1,2,3,0
S01008765,Rented or living rent free: Total,89,68,55,12,43,7,6,21,10,2,5,4,0
S01008765,Rented or living rent free: Social rented,10,3,1,0,1,1,1,7,3,0,1,3,0
S01008765,Rented or living rent free: Private rented or living rent free,79,65,54,12,42,6,5,14,7,2,4,1,0
S01008766,All HRPs aged 16 and over,413,282,214,37,177,67,1,131,110,2,12,4,3
S01008766,Owned: Total,359,253,190,27,163,62,1,106,102,1,2,1,0
S01008766,Owned: Owned outright,180,82,59,18,41,23,0,98,95,0,2,1,0
S01008766,Owned: Owned with a mortgage or loan or shared ownership,179,171,131,9,122,39,1,8,7,1,0,0,0
S01008766,Rented or living rent free: Total,54,29,24,10,14,5,0,25,8,1,10,3,3
S01008766,Rented or living rent free: Social rented,19,6,5,3,2,1,0,13,4,0,4,3,2
S01008766,Rented or living rent free: Private rented or living rent free,35,23,19,7,12,4,0,12,4,1,6,0,1
S01008767,All HRPs aged 16 and over,266,181,147,30,117,24,10,85,67,3,7,7,1
S01008767,Owned: Total,198,141,118,18,100,20,3,57,53,0,2,1,1
S01008767,Owned: Owned outright,82,34,31,9,22,2,1,48,46,0,1,0,1
S01008767,Owned: Owned with a mortgage or loan or shared ownership,116,107,87,9,78,18,2,9,7,0,1,1,0
S01008767,Rented or living rent free: Total,68,40,29,12,17,4,7,28,14,3,5,6,0
S01008767,Rented or living rent free: Social rented,39,25,19,9,10,2,4,14,9,0,0,5,0
S01008767,Rented or living rent free: Private rented or living rent free,29,15,10,3,7,2,3,14,5,3,5,1,0
S01008768,All HRPs aged 16 and over,256,182,150,20,130,24,8,74,42,2,11,13,6
S01008768,Owned: Total,150,113,92,8,84,19,2,37,33,0,2,1,1
S01008768,Owned: Owned outright,48,17,16,3,13,1,0,31,31,0,0,0,0
S01008768,Owned: Owned with a mortgage or loan or shared ownership,102,96,76,5,71,18,2,6,2,0,2,1,1
S01008768,Rented or living rent free: Total,106,69,58,12,46,5,6,37,9,2,9,12,5
S01008768,Rented or living rent free: Social rented,56,30,25,5,20,1,4,26,6,0,8,7,5
S01008768,Rented or living rent free: Private rented or living rent free,50,39,33,7,26,4,2,11,3,2,1,5,0
S01008769,All HRPs aged 16 and over,380,347,287,26,261,44,16,33,18,8,1,3,3
S01008769,Owned: Total,214,197,162,19,143,31,4,17,15,1,0,0,1
S01008769,Owned: Owned outright,61,47,40,12,28,7,0,14,13,0,0,0,1
S01008769,Owned: Owned with a mortgage or loan or shared ownership,153,150,122,7,115,24,4,3,2,1,0,0,0
S01008769,Rented or living rent free: Total,166,150,125,7,118,13,12,16,3,7,1,3,2
S01008769,Rented or living rent free: Social rented,7,4,3,1,2,0,1,3,0,0,1,2,0
S01008769,Rented or living rent free: Private rented or living rent free,159,146,122,6,116,13,11,13,3,7,0,1,2
S01008770,All HRPs aged 16 and over,431,366,298,33,265,55,13,65,17,26,11,4,7
S01008770,Owned: Total,188,165,132,8,124,28,5,23,15,6,0,0,2
S01008770,Owned: Owned outright,44,32,22,3,19,6,4,12,9,1,0,0,2
S01008770,Owned: Owned with a mortgage or loan or shared ownership,144,133,110,5,105,22,1,11,6,5,0,0,0
S01008770,Rented or living rent free: Total,243,201,166,25,141,27,8,42,2,20,11,4,5
S01008770,Rented or living rent free: Social rented,13,8,6,2,4,1,1,5,0,1,2,1,1
S01008770,Rented or living rent free: Private rented or living rent free,230,193,160,23,137,26,7,37,2,19,9,3,4
S01008771,All HRPs aged 16 and over,411,306,237,32,205,55,14,105,46,18,19,17,5
S01008771,Owned: Total,185,155,118,5,113,34,3,30,26,3,0,0,1
S01008771,Owned: Owned outright,50,26,17,0,17,7,2,24,22,1,0,0,1
S01008771,Owned: Owned with a mortgage or loan or shared ownership,135,129,101,5,96,27,1,6,4,2,0,0,0
S01008771,Rented or living rent free: Total,226,151,119,27,92,21,11,75,20,15,19,17,4
S01008771,Rented or living rent free: Social rented,106,50,37,18,19,4,9,56,18,4,15,16,3
S01008771,Rented or living rent free: Private rented or living rent free,120,101,82,9,73,17,2,19,2,11,4,1,1
S01008772,All HRPs aged 16 and over,395,259,212,22,190,41,6,136,108,11,4,11,2
S01008772,Owned: Total,284,199,163,12,151,32,4,85,80,0,0,4,1
S01008772,Owned: Owned outright,127,49,37,5,32,11,1,78,74,0,0,3,1
S01008772,Owned: Owned with a mortgage or loan or shared ownership,157,150,126,7,119,21,3,7,6,0,0,1,0
S01008772,Rented or living rent free: Total,111,60,49,10,39,9,2,51,28,11,4,7,1
S01008772,Rented or living rent free: Social rented,51,13,8,1,7,4,1,38,23,4,3,7,1
S01008772,Rented or living rent free: Private rented or living rent free,60,47,41,9,32,5,1,13,5,7,1,0,0
S01008773,All HRPs aged 16 and over,596,436,372,52,320,37,27,160,102,7,8,33,10
S01008773,Owned: Total,305,236,204,23,181,28,4,69,63,0,1,4,1
S01008773,Owned: Owned outright,97,43,33,11,22,9,1,54,53,0,0,1,0
S01008773,Owned: Owned with a mortgage or loan or shared ownership,208,193,171,12,159,19,3,15,10,0,1,3,1
S01008773,Rented or living rent free: Total,291,200,168,29,139,9,23,91,39,7,7,29,9
S01008773,Rented or living rent free: Social rented,130,59,43,12,31,2,14,71,32,6,3,25,5
S01008773,Rented or living rent free: Private rented or living rent free,161,141,125,17,108,7,9,20,7,1,4,4,4
S01008774,All HRPs aged 16 and over,495,361,299,39,260,38,24,134,70,9,8,36,11
S01008774,Owned: Total,215,176,146,10,136,26,4,39,35,2,0,1,1
S01008774,Owned: Owned outright,68,32,25,2,23,4,3,36,32,2,0,1,1
S01008774,Owned: Owned with a mortgage or loan or shared ownership,147,144,121,8,113,22,1,3,3,0,0,0,0
S01008774,Rented or living rent free: Total,280,185,153,29,124,12,20,95,35,7,8,35,10
S01008774,Rented or living rent free: Social rented,130,46,31,14,17,3,12,84,31,3,8,32,10
S01008774,Rented or living rent free: Private rented or living rent free,150,139,122,15,107,9,8,11,4,4,0,3,0
S01008775,All HRPs aged 16 and over,218,171,138,18,120,25,8,47,36,2,4,5,0
S01008775,Owned: Total,157,124,96,13,83,22,6,33,29,0,2,2,0
S01008775,Owned: Owned outright,57,29,20,6,14,6,3,28,26,0,1,1,0
S01008775,Owned: Owned with a mortgage or loan or shared ownership,100,95,76,7,69,16,3,5,3,0,1,1,0
S01008775,Rented or living rent free: Total,61,47,42,5,37,3,2,14,7,2,2,3,0
S01008775,Rented or living rent free: Social rented,9,4,4,1,3,0,0,5,2,0,1,2,0
S01008775,Rented or living rent free: Private rented or living rent free,52,43,38,4,34,3,2,9,5,2,1,1,0
S01008776,All HRPs aged 16 and over,467,319,251,48,203,30,38,148,54,14,25,40,15
S01008776,Owned: Total,171,143,126,14,112,15,2,28,28,0,0,0,0
S01008776,Owned: Owned outright,56,33,29,7,22,3,1,23,23,0,0,0,0
S01008776,Owned: Owned with a mortgage or loan or shared ownership,115,110,97,7,90,12,1,5,5,0,0,0,0
S01008776,Rented or living rent free: Total,296,176,125,34,91,15,36,120,26,14,25,40,15
S01008776,Rented or living rent free: Social rented,165,81,55,19,36,4,22,84,23,6,14,32,9
S01008776,Rented or living rent free: Private rented or living rent free,131,95,70,15,55,11,14,36,3,8,11,8,6
S01008777,All HRPs aged 16 and over,637,363,295,56,239,35,33,274,145,3,21,87,18
S01008777,Owned: Total,187,151,131,15,116,17,3,36,29,0,1,5,1
S01008777,Owned: Owned outright,59,30,25,4,21,3,2,29,27,0,1,1,0
S01008777,Owned: Owned with a mortgage or loan or shared ownership,128,121,106,11,95,14,1,7,2,0,0,4,1
S01008777,Rented or living rent free: Total,450,212,164,41,123,18,30,238,116,3,20,82,17
S01008777,Rented or living rent free: Social rented,336,122,91,30,61,6,25,214,109,1,15,73,16
S01008777,Rented or living rent free: Private rented or living rent free,114,90,73,11,62,12,5,24,7,2,5,9,1
S01008778,All HRPs aged 16 and over,664,563,462,47,415,76,25,101,38,7,14,41,1
S01008778,Owned: Total,265,242,200,14,186,37,5,23,20,1,0,2,0
S01008778,Owned: Owned outright,68,52,45,6,39,5,2,16,15,0,0,1,0
S01008778,Owned: Owned with a mortgage or loan or shared ownership,197,190,155,8,147,32,3,7,5,1,0,1,0
S01008778,Rented or living rent free: Total,399,321,262,33,229,39,20,78,18,6,14,39,1
S01008778,Rented or living rent free: Social rented,113,59,46,8,38,6,7,54,12,3,5,34,0
S01008778,Rented or living rent free: Private rented or living rent free,286,262,216,25,191,33,13,24,6,3,9,5,1
S01008779,All HRPs aged 16 and over,402,364,294,25,269,59,11,38,24,12,1,1,0
S01008779,Owned: Total,212,193,154,9,145,36,3,19,19,0,0,0,0
S01008779,Owned: Owned outright,48,32,23,7,16,8,1,16,16,0,0,0,0
S01008779,Owned: Owned with a mortgage or loan or shared ownership,164,161,131,2,129,28,2,3,3,0,0,0,0
S01008779,Rented or living rent free: Total,190,171,140,16,124,23,8,19,5,12,1,1,0
S01008779,Rented or living rent free: Social rented,9,5,3,2,1,1,1,4,3,0,0,1,0
S01008779,Rented or living rent free: Private rented or living rent free,181,166,137,14,123,22,7,15,2,12,1,0,0
S01008780,All HRPs aged 16 and over,329,267,222,19,203,37,8,62,17,11,10,16,8
S01008780,Owned: Total,145,131,112,5,107,18,1,14,7,4,0,2,1
S01008780,Owned: Owned outright,24,16,12,2,10,4,0,8,6,2,0,0,0
S01008780,Owned: Owned with a mortgage or loan or shared ownership,121,115,100,3,97,14,1,6,1,2,0,2,1
S01008780,Rented or living rent free: Total,184,136,110,14,96,19,7,48,10,7,10,14,7
S01008780,Rented or living rent free: Social rented,48,21,17,2,15,1,3,27,4,0,6,12,5
S01008780,Rented or living rent free: Private rented or living rent free,136,115,93,12,81,18,4,21,6,7,4,2,2
S01008781,All HRPs aged 16 and over,530,444,377,54,323,36,31,86,17,5,17,34,13
S01008781,Owned: Total,168,159,144,10,134,14,1,9,4,2,0,1,2
S01008781,Owned: Owned outright,21,15,12,5,7,3,0,6,4,1,0,1,0
S01008781,Owned: Owned with a mortgage or loan or shared ownership,147,144,132,5,127,11,1,3,0,1,0,0,2
S01008781,Rented or living rent free: Total,362,285,233,44,189,22,30,77,13,3,17,33,11
S01008781,Rented or living rent free: Social rented,196,128,99,25,74,7,22,68,12,1,16,30,9
S01008781,Rented or living rent free: Private rented or living rent free,166,157,134,19,115,15,8,9,1,2,1,3,2
S01008782,All HRPs aged 16 and over,400,334,277,23,254,40,17,66,16,13,15,16,6
S01008782,Owned: Total,181,170,142,7,135,25,3,11,6,1,0,1,3
S01008782,Owned: Owned outright,35,27,19,2,17,7,1,8,6,1,0,0,1
S01008782,Owned: Owned with a mortgage or loan or shared ownership,146,143,123,5,118,18,2,3,0,0,0,1,2
S01008782,Rented or living rent free: Total,219,164,135,16,119,15,14,55,10,12,15,15,3
S01008782,Rented or living rent free: Social rented,57,25,15,7,8,5,5,32,8,1,7,13,3
S01008782,Rented or living rent free: Private rented or living rent free,162,139,120,9,111,10,9,23,2,11,8,2,0
S01008783,All HRPs aged 16 and over,236,200,160,14,146,34,6,36,13,3,11,7,2
S01008783,Owned: Total,92,80,65,3,62,15,0,12,9,1,0,2,0
S01008783,Owned: Owned outright,15,7,4,0,4,3,0,8,7,1,0,0,0
S01008783,Owned: Owned with a mortgage or loan or shared ownership,77,73,61,3,58,12,0,4,2,0,0,2,0
S01008783,Rented or living rent free: Total,144,120,95,11,84,19,6,24,4,2,11,5,2
S01008783,Rented or living rent free: Social rented,45,30,24,6,18,3,3,15,3,0,10,2,0
S01008783,Rented or living rent free: Private rented or living rent free,99,90,71,5,66,16,3,9,1,2,1,3,2
S01008784,All HRPs aged 16 and over,268,234,197,30,167,26,11,34,10,7,9,5,3
S01008784,Owned: Total,92,87,74,4,70,12,1,5,4,0,0,0,1
S01008784,Owned: Owned outright,12,9,8,0,8,1,0,3,2,0,0,0,1
S01008784,Owned: Owned with a mortgage or loan or shared ownership,80,78,66,4,62,11,1,2,2,0,0,0,0
S01008784,Rented or living rent free: Total,176,147,123,26,97,14,10,29,6,7,9,5,2
S01008784,Rented or living rent free: Social rented,53,34,32,14,18,2,0,19,5,2,5,5,2
S01008784,Rented or living rent free: Private rented or living rent free,123,113,91,12,79,12,10,10,1,5,4,0,0
S01008785,All HRPs aged 16 and over,485,289,220,47,173,31,38,196,103,7,24,41,21
S01008785,Owned: Total,125,83,69,10,59,12,2,42,37,1,0,2,2
S01008785,Owned: Owned outright,52,21,18,8,10,3,0,31,30,0,0,1,0
S01008785,Owned: Owned with a mortgage or loan or shared ownership,73,62,51,2,49,9,2,11,7,1,0,1,2
S01008785,Rented or living rent free: Total,360,206,151,37,114,19,36,154,66,6,24,39,19
S01008785,Rented or living rent free: Social rented,235,101,71,25,46,4,26,134,60,3,20,35,16
S01008785,Rented or living rent free: Private rented or living rent free,125,105,80,12,68,15,10,20,6,3,4,4,3
S01008786,All HRPs aged 16 and over,540,442,369,37,332,47,26,98,52,14,12,9,11
S01008786,Owned: Total,257,218,177,14,163,34,7,39,38,0,0,1,0
S01008786,Owned: Owned outright,69,33,25,6,19,7,1,36,35,0,0,1,0
S01008786,Owned: Owned with a mortgage or loan or shared ownership,188,185,152,8,144,27,6,3,3,0,0,0,0
S01008786,Rented or living rent free: Total,283,224,192,23,169,13,19,59,14,14,12,8,11
S01008786,Rented or living rent free: Social rented,49,22,12,3,9,3,7,27,6,1,9,6,5
S01008786,Rented or living rent free: Private rented or living rent free,234,202,180,20,160,10,12,32,8,13,3,2,6
S01008787,All HRPs aged 16 and over,200,108,77,32,45,9,22,92,30,8,24,19,11
S01008787,Owned: Total,6,5,5,0,5,0,0,1,1,0,0,0,0
S01008787,Owned: Owned outright,4,4,4,0,4,0,0,0,0,0,0,0,0
S01008787,Owned: Owned with a mortgage or loan or shared ownership,2,1,1,0,1,0,0,1,1,0,0,0,0
S01008787,Rented or living rent free: Total,194,103,72,32,40,9,22,91,29,8,24,19,11
S01008787,Rented or living rent free: Social rented,173,89,62,28,34,6,21,84,28,4,23,18,11
S01008787,Rented or living rent free: Private rented or living rent free,21,14,10,4,6,3,1,7,1,4,1,1,0
S01008788,All HRPs aged 16 and over,376,309,266,20,246,32,11,67,25,9,13,15,5
S01008788,Owned: Total,168,147,118,8,110,24,5,21,13,5,0,2,1
S01008788,Owned: Owned outright,36,22,16,4,12,4,2,14,12,1,0,0,1
S01008788,Owned: Owned with a mortgage or loan or shared ownership,132,125,102,4,98,20,3,7,1,4,0,2,0
S01008788,Rented or living rent free: Total,208,162,148,12,136,8,6,46,12,4,13,13,4
S01008788,Rented or living rent free: Social rented,64,32,29,4,25,1,2,32,10,0,9,9,4
S01008788,Rented or living rent free: Private rented or living rent free,144,130,119,8,111,7,4,14,2,4,4,4,0
S01008789,All HRPs aged 16 and over,375,184,157,23,134,22,5,191,140,1,9,33,8
S01008789,Owned: Total,149,102,87,7,80,12,3,47,42,1,1,3,0
S01008789,Owned: Owned outright,56,19,16,3,13,3,0,37,35,0,0,2,0
S01008789,Owned: Owned with a mortgage or loan or shared ownership,93,83,71,4,67,9,3,10,7,1,1,1,0
S01008789,Rented or living rent free: Total,226,82,70,16,54,10,2,144,98,0,8,30,8
S01008789,Rented or living rent free: Social rented,159,29,25,9,16,3,1,130,92,0,8,24,6
S01008789,Rented or living rent free: Private rented or living rent free,67,53,45,7,38,7,1,14,6,0,0,6,2
S01008790,All HRPs aged 16 and over,353,256,194,42,152,30,32,97,45,6,9,30,7
S01008790,Owned: Total,122,104,88,10,78,12,4,18,16,0,1,1,0
S01008790,Owned: Owned outright,28,14,11,1,10,2,1,14,14,0,0,0,0
S01008790,Owned: Owned with a mortgage or loan or shared ownership,94,90,77,9,68,10,3,4,2,0,1,1,0
S01008790,Rented or living rent free: Total,231,152,106,32,74,18,28,79,29,6,8,29,7
S01008790,Rented or living rent free: Social rented,118,51,33,13,20,5,13,67,24,5,7,25,6
S01008790,Rented or living rent free: Private rented or living rent free,113,101,73,19,54,13,15,12,5,1,1,4,1
S01008791,All HRPs aged 16 and over,421,343,292,38,254,35,16,78,30,14,15,10,9
S01008791,Owned: Total,173,147,128,12,116,16,3,26,20,3,1,2,0
S01008791,Owned: Owned outright,50,28,24,4,20,2,2,22,17,3,0,2,0
S01008791,Owned: Owned with a mortgage or loan or shared ownership,123,119,104,8,96,14,1,4,3,0,1,0,0
S01008791,Rented or living rent free: Total,248,196,164,26,138,19,13,52,10,11,14,8,9
S01008791,Rented or living rent free: Social rented,33,14,9,5,4,2,3,19,6,0,11,2,0
S01008791,Rented or living rent free: Private rented or living rent free,215,182,155,21,134,17,10,33,4,11,3,6,9
S01008792,All HRPs aged 16 and over,415,316,258,41,217,37,21,99,56,4,7,18,14
S01008792,Owned: Total,226,183,158,17,141,22,3,43,37,1,2,1,2
S01008792,Owned: Owned outright,91,56,46,11,35,8,2,35,35,0,0,0,0
S01008792,Owned: Owned with a mortgage or loan or shared ownership,135,127,112,6,106,14,1,8,2,1,2,1,2
S01008792,Rented or living rent free: Total,189,133,100,24,76,15,18,56,19,3,5,17,12
S01008792,Rented or living rent free: Social rented,74,30,16,3,13,4,10,44,15,0,2,15,12
S01008792,Rented or living rent free: Private rented or living rent free,115,103,84,21,63,11,8,12,4,3,3,2,0
S01008793,All HRPs aged 16 and over,266,168,126,26,100,17,25,98,62,9,6,18,3
S01008793,Owned: Total,80,69,53,10,43,12,4,11,8,1,1,0,1
S01008793,Owned: Owned outright,19,10,8,2,6,2,0,9,7,1,0,0,1
S01008793,Owned: Owned with a mortgage or loan or shared ownership,61,59,45,8,37,10,4,2,1,0,1,0,0
S01008793,Rented or living rent free: Total,186,99,73,16,57,5,21,87,54,8,5,18,2
S01008793,Rented or living rent free: Social rented,101,40,20,5,15,3,17,61,44,0,3,13,1
S01008793,Rented or living rent free: Private rented or living rent free,85,59,53,11,42,2,4,26,10,8,2,5,1
S01008794,All HRPs aged 16 and over,492,281,239,39,200,25,17,211,161,5,8,31,6
S01008794,Owned: Total,203,149,133,15,118,14,2,54,45,1,0,6,2
S01008794,Owned: Owned outright,67,21,17,3,14,2,2,46,41,0,0,3,2
S01008794,Owned: Owned with a mortgage or loan or shared ownership,136,128,116,12,104,12,0,8,4,1,0,3,0
S01008794,Rented or living rent free: Total,289,132,106,24,82,11,15,157,116,4,8,25,4
S01008794,Rented or living rent free: Social rented,199,55,39,14,25,4,12,144,113,1,6,21,3
S01008794,Rented or living rent free: Private rented or living rent free,90,77,67,10,57,7,3,13,3,3,2,4,1
S01008795,All HRPs aged 16 and over,618,505,423,62,361,57,25,113,58,22,6,20,7
S01008795,Owned: Total,314,269,231,23,208,34,4,45,39,2,1,2,1
S01008795,Owned: Owned outright,83,47,42,11,31,5,0,36,33,0,1,1,1
S01008795,Owned: Owned with a mortgage or loan or shared ownership,231,222,189,12,177,29,4,9,6,2,0,1,0
S01008795,Rented or living rent free: Total,304,236,192,39,153,23,21,68,19,20,5,18,6
S01008795,Rented or living rent free: Social rented,34,13,8,6,2,0,5,21,12,0,0,9,0
S01008795,Rented or living rent free: Private rented or living rent free,270,223,184,33,151,23,16,47,7,20,5,9,6
S01008796,All HRPs aged 16 and over,622,448,370,60,310,42,36,174,88,13,18,43,12
S01008796,Owned: Total,198,159,136,8,128,18,5,39,29,2,3,3,2
S01008796,Owned: Owned outright,50,27,19,1,18,5,3,23,22,0,0,1,0
S01008796,Owned: Owned with a mortgage or loan or shared ownership,148,132,117,7,110,13,2,16,7,2,3,2,2
S01008796,Rented or living rent free: Total,424,289,234,52,182,24,31,135,59,11,15,40,10
S01008796,Rented or living rent free: Social rented,158,84,62,14,48,7,15,74,38,2,2,26,6
S01008796,Rented or living rent free: Private rented or living rent free,266,205,172,38,134,17,16,61,21,9,13,14,4
S01008797,All HRPs aged 16 and over,579,425,374,58,316,30,21,154,96,20,5,29,4
S01008797,Owned: Total,281,221,191,22,169,20,10,60,48,4,2,5,1
S01008797,Owned: Owned outright,86,36,26,7,19,4,6,50,44,2,1,3,0
S01008797,Owned: Owned with a mortgage or loan or shared ownership,195,185,165,15,150,16,4,10,4,2,1,2,1
S01008797,Rented or living rent free: Total,298,204,183,36,147,10,11,94,48,16,3,24,3
S01008797,Rented or living rent free: Social rented,66,15,9,1,8,2,4,51,31,2,0,16,2
S01008797,Rented or living rent free: Private rented or living rent free,232,189,174,35,139,8,7,43,17,14,3,8,1
S01008798,All HRPs aged 16 and over,502,364,309,52,257,28,27,138,87,11,14,19,7
S01008798,Owned: Total,238,176,159,22,137,10,7,62,58,1,1,1,1
S01008798,Owned: Owned outright,85,34,30,9,21,2,2,51,50,0,1,0,0
S01008798,Owned: Owned with a mortgage or loan or shared ownership,153,142,129,13,116,8,5,11,8,1,0,1,1
S01008798,Rented or living rent free: Total,264,188,150,30,120,18,20,76,29,10,13,18,6
S01008798,Rented or living rent free: Social rented,91,36,25,9,16,3,8,55,26,0,8,16,5
S01008798,Rented or living rent free: Private rented or living rent free,173,152,125,21,104,15,12,21,3,10,5,2,1
S01008799,All HRPs aged 16 and over,322,242,202,30,172,28,12,80,25,14,11,28,2
S01008799,Owned: Total,107,87,72,5,67,13,2,20,12,5,0,3,0
S01008799,Owned: Owned outright,25,12,10,2,8,1,1,13,10,1,0,2,0
S01008799,Owned: Owned with a mortgage or loan or shared ownership,82,75,62,3,59,12,1,7,2,4,0,1,0
S01008799,Rented or living rent free: Total,215,155,130,25,105,15,10,60,13,9,11,25,2
S01008799,Rented or living rent free: Social rented,52,15,11,1,10,3,1,37,11,0,5,20,1
S01008799,Rented or living rent free: Private rented or living rent free,163,140,119,24,95,12,9,23,2,9,6,5,1
S01008800,All HRPs aged 16 and over,651,562,477,58,419,51,34,89,37,16,2,20,14
S01008800,Owned: Total,321,288,250,17,233,28,10,33,26,1,1,3,2
S01008800,Owned: Owned outright,74,44,36,5,31,4,4,30,24,1,1,3,1
S01008800,Owned: Owned with a mortgage or loan or shared ownership,247,244,214,12,202,24,6,3,2,0,0,0,1
S01008800,Rented or living rent free: Total,330,274,227,41,186,23,24,56,11,15,1,17,12
S01008800,Rented or living rent free: Social rented,33,20,13,4,9,2,5,13,3,0,0,6,4
S01008800,Rented or living rent free: Private rented or living rent free,297,254,214,37,177,21,19,43,8,15,1,11,8
S01008801,All HRPs aged 16 and over,582,491,418,41,377,39,34,91,35,23,5,23,5
S01008801,Owned: Total,263,229,201,11,190,22,6,34,27,2,2,3,0
S01008801,Owned: Owned outright,61,33,27,3,24,2,4,28,25,1,2,0,0
S01008801,Owned: Owned with a mortgage or loan or shared ownership,202,196,174,8,166,20,2,6,2,1,0,3,0
S01008801,Rented or living rent free: Total,319,262,217,30,187,17,28,57,8,21,3,20,5
S01008801,Rented or living rent free: Social rented,52,29,21,2,19,2,6,23,7,0,0,14,2
S01008801,Rented or living rent free: Private rented or living rent free,267,233,196,28,168,15,22,34,1,21,3,6,3
S01008802,All HRPs aged 16 and over,614,463,383,59,324,46,34,151,61,34,7,33,16
S01008802,Owned: Total,263,215,187,18,169,22,6,48,37,3,0,2,6
S01008802,Owned: Owned outright,80,40,34,7,27,4,2,40,32,2,0,1,5
S01008802,Owned: Owned with a mortgage or loan or shared ownership,183,175,153,11,142,18,4,8,5,1,0,1,1
S01008802,Rented or living rent free: Total,351,248,196,41,155,24,28,103,24,31,7,31,10
S01008802,Rented or living rent free: Social rented,86,40,30,8,22,4,6,46,17,0,7,20,2
S01008802,Rented or living rent free: Private rented or living rent free,265,208,166,33,133,20,22,57,7,31,0,11,8
S01008803,All HRPs aged 16 and over,575,437,358,61,297,43,36,138,60,16,14,37,11
S01008803,Owned: Total,185,160,136,10,126,22,2,25,19,1,0,3,2
S01008803,Owned: Owned outright,50,28,23,4,19,5,0,22,18,0,0,2,2
S01008803,Owned: Owned with a mortgage or loan or shared ownership,135,132,113,6,107,17,2,3,1,1,0,1,0
S01008803,Rented or living rent free: Total,390,277,222,51,171,21,34,113,41,15,14,34,9
S01008803,Rented or living rent free: Social rented,163,85,58,14,44,7,20,78,32,3,8,28,7
S01008803,Rented or living rent free: Private rented or living rent free,227,192,164,37,127,14,14,35,9,12,6,6,2
S01008804,All HRPs aged 16 and over,332,254,221,33,188,14,19,78,28,20,6,18,6
S01008804,Owned: Total,110,92,86,2,84,5,1,18,12,1,0,2,3
S01008804,Owned: Owned outright,24,13,12,1,11,1,0,11,8,1,0,1,1
S01008804,Owned: Owned with a mortgage or loan or shared ownership,86,79,74,1,73,4,1,7,4,0,0,1,2
S01008804,Rented or living rent free: Total,222,162,135,31,104,9,18,60,16,19,6,16,3
S01008804,Rented or living rent free: Social rented,86,49,31,9,22,3,15,37,14,1,6,13,3
S01008804,Rented or living rent free: Private rented or living rent free,136,113,104,22,82,6,3,23,2,18,0,3,0
S01008805,All HRPs aged 16 and over,334,261,234,39,195,20,7,73,33,29,1,9,1
S01008805,Owned: Total,128,100,90,8,82,9,1,28,26,1,0,1,0
S01008805,Owned: Owned outright,46,22,18,5,13,4,0,24,24,0,0,0,0
S01008805,Owned: Owned with a mortgage or loan or shared ownership,82,78,72,3,69,5,1,4,2,1,0,1,0
S01008805,Rented or living rent free: Total,206,161,144,31,113,11,6,45,7,28,1,8,1
S01008805,Rented or living rent free: Social rented,12,7,5,1,4,0,2,5,2,0,0,2,1
S01008805,Rented or living rent free: Private rented or living rent free,194,154,139,30,109,11,4,40,5,28,1,6,0
S01008806,All HRPs aged 16 and over,558,489,429,52,377,43,17,69,31,14,6,13,5
S01008806,Owned: Total,225,194,174,16,158,19,1,31,27,1,0,2,1
S01008806,Owned: Owned outright,61,35,31,6,25,4,0,26,24,0,0,1,1
S01008806,Owned: Owned with a mortgage or loan or shared ownership,164,159,143,10,133,15,1,5,3,1,0,1,0
S01008806,Rented or living rent free: Total,333,295,255,36,219,24,16,38,4,13,6,11,4
S01008806,Rented or living rent free: Social rented,69,50,41,4,37,3,6,19,2,1,3,9,4
S01008806,Rented or living rent free: Private rented or living rent free,264,245,214,32,182,21,10,19,2,12,3,2,0
S01008807,All HRPs aged 16 and over,490,379,325,42,283,37,17,111,55,20,3,27,6
S01008807,Owned: Total,246,191,168,12,156,19,4,55,34,9,1,6,5
S01008807,Owned: Owned outright,68,36,31,7,24,5,0,32,26,0,0,2,4
S01008807,Owned: Owned with a mortgage or loan or shared ownership,178,155,137,5,132,14,4,23,8,9,1,4,1
S01008807,Rented or living rent free: Total,244,188,157,30,127,18,13,56,21,11,2,21,1
S01008807,Rented or living rent free: Social rented,39,11,11,4,7,0,0,28,18,1,2,7,0
S01008807,Rented or living rent free: Private rented or living rent free,205,177,146,26,120,18,13,28,3,10,0,14,1
S01008808,All HRPs aged 16 and over,391,283,225,31,194,48,10,108,76,7,1,23,1
S01008808,Owned: Total,196,155,121,14,107,30,4,41,37,1,0,2,1
S01008808,Owned: Owned outright,72,37,24,5,19,10,3,35,32,1,0,2,0
S01008808,Owned: Owned with a mortgage or loan or shared ownership,124,118,97,9,88,20,1,6,5,0,0,0,1
S01008808,Rented or living rent free: Total,195,128,104,17,87,18,6,67,39,6,1,21,0
S01008808,Rented or living rent free: Social rented,74,21,16,6,10,2,3,53,34,0,0,19,0
S01008808,Rented or living rent free: Private rented or living rent free,121,107,88,11,77,16,3,14,5,6,1,2,0
S01008809,All HRPs aged 16 and over,324,248,173,32,141,64,11,76,45,20,5,3,3
S01008809,Owned: Total,145,108,67,9,58,38,3,37,32,1,1,1,2
S01008809,Owned: Owned outright,79,45,24,5,19,19,2,34,32,1,1,0,0
S01008809,Owned: Owned with a mortgage or loan or shared ownership,66,63,43,4,39,19,1,3,0,0,0,1,2
S01008809,Rented or living rent free: Total,179,140,106,23,83,26,8,39,13,19,4,2,1
S01008809,Rented or living rent free: Social rented,18,7,4,3,1,1,2,11,8,1,0,2,0
S01008809,Rented or living rent free: Private rented or living rent free,161,133,102,20,82,25,6,28,5,18,4,0,1
S01008810,All HRPs aged 16 and over,383,317,260,38,222,42,15,66,38,18,3,3,4
S01008810,Owned: Total,213,173,144,16,128,26,3,40,33,1,3,1,2
S01008810,Owned: Owned outright,70,31,26,6,20,5,0,39,33,0,3,1,2
S01008810,Owned: Owned with a mortgage or loan or shared ownership,143,142,118,10,108,21,3,1,0,1,0,0,0
S01008810,Rented or living rent free: Total,170,144,116,22,94,16,12,26,5,17,0,2,2
S01008810,Rented or living rent free: Social rented,3,1,1,1,0,0,0,2,1,0,0,0,1
S01008810,Rented or living rent free: Private rented or living rent free,167,143,115,21,94,16,12,24,4,17,0,2,1
S01008811,All HRPs aged 16 and over,389,313,246,37,209,52,15,76,34,28,0,9,5
S01008811,Owned: Total,195,156,118,9,109,34,4,39,29,5,0,4,1
S01008811,Owned: Owned outright,70,39,30,5,25,8,1,31,26,2,0,2,1
S01008811,Owned: Owned with a mortgage or loan or shared ownership,125,117,88,4,84,26,3,8,3,3,0,2,0
S01008811,Rented or living rent free: Total,194,157,128,28,100,18,11,37,5,23,0,5,4
S01008811,Rented or living rent free: Social rented,9,8,6,2,4,0,2,1,0,0,0,0,1
S01008811,Rented or living rent free: Private rented or living rent free,185,149,122,26,96,18,9,36,5,23,0,5,3
S01008812,All HRPs aged 16 and over,260,215,181,31,150,24,10,45,26,11,2,4,2
S01008812,Owned: Total,141,107,87,9,78,18,2,34,25,4,1,2,2
S01008812,Owned: Owned outright,58,29,25,3,22,4,0,29,23,2,1,1,2
S01008812,Owned: Owned with a mortgage or loan or shared ownership,83,78,62,6,56,14,2,5,2,2,0,1,0
S01008812,Rented or living rent free: Total,119,108,94,22,72,6,8,11,1,7,1,2,0
S01008812,Rented or living rent free: Social rented,2,1,1,1,0,0,0,1,1,0,0,0,0
S01008812,Rented or living rent free: Private rented or living rent free,117,107,93,21,72,6,8,10,0,7,1,2,0
S01008813,All HRPs aged 16 and over,508,365,283,59,224,50,32,143,61,9,15,48,10
S01008813,Owned: Total,185,148,118,19,99,29,1,37,30,1,2,2,2
S01008813,Owned: Owned outright,76,45,37,10,27,8,0,31,29,0,0,2,0
S01008813,Owned: Owned with a mortgage or loan or shared ownership,109,103,81,9,72,21,1,6,1,1,2,0,2
S01008813,Rented or living rent free: Total,323,217,165,40,125,21,31,106,31,8,13,46,8
S01008813,Rented or living rent free: Social rented,182,105,78,21,57,6,21,77,27,0,8,38,4
S01008813,Rented or living rent free: Private rented or living rent free,141,112,87,19,68,15,10,29,4,8,5,8,4
S01008814,All HRPs aged 16 and over,403,326,263,56,207,41,22,77,47,4,10,10,6
S01008814,Owned: Total,228,189,151,20,131,28,10,39,36,0,0,2,1
S01008814,Owned: Owned outright,92,60,41,11,30,12,7,32,31,0,0,1,0
S01008814,Owned: Owned with a mortgage or loan or shared ownership,136,129,110,9,101,16,3,7,5,0,0,1,1
S01008814,Rented or living rent free: Total,175,137,112,36,76,13,12,38,11,4,10,8,5
S01008814,Rented or living rent free: Social rented,35,16,13,4,9,1,2,19,6,0,6,5,2
S01008814,Rented or living rent free: Private rented or living rent free,140,121,99,32,67,12,10,19,5,4,4,3,3
S01008815,All HRPs aged 16 and over,557,425,372,58,314,31,22,132,50,22,15,38,7
S01008815,Owned: Total,247,214,197,23,174,13,4,33,24,0,2,5,2
S01008815,Owned: Owned outright,59,37,32,8,24,3,2,22,19,0,0,3,0
S01008815,Owned: Owned with a mortgage or loan or shared ownership,188,177,165,15,150,10,2,11,5,0,2,2,2
S01008815,Rented or living rent free: Total,310,211,175,35,140,18,18,99,26,22,13,33,5
S01008815,Rented or living rent free: Social rented,119,62,43,11,32,6,13,57,22,2,6,26,1
S01008815,Rented or living rent free: Private rented or living rent free,191,149,132,24,108,12,5,42,4,20,7,7,4
S01008816,All HRPs aged 16 and over,321,218,182,19,163,19,17,103,62,5,8,21,7
S01008816,Owned: Total,184,120,105,5,100,13,2,64,55,1,0,8,0
S01008816,Owned: Owned outright,63,14,12,2,10,2,0,49,44,0,0,5,0
S01008816,Owned: Owned with a mortgage or loan or shared ownership,121,106,93,3,90,11,2,15,11,1,0,3,0
S01008816,Rented or living rent free: Total,137,98,77,14,63,6,15,39,7,4,8,13,7
S01008816,Rented or living rent free: Social rented,51,25,16,3,13,0,9,26,5,1,4,11,5
S01008816,Rented or living rent free: Private rented or living rent free,86,73,61,11,50,6,6,13,2,3,4,2,2
S01008817,All HRPs aged 16 and over,425,315,272,38,234,27,16,110,39,6,16,39,10
S01008817,Owned: Total,183,158,145,11,134,11,2,25,22,1,0,1,1
S01008817,Owned: Owned outright,41,21,19,2,17,1,1,20,20,0,0,0,0
S01008817,Owned: Owned with a mortgage or loan or shared ownership,142,137,126,9,117,10,1,5,2,1,0,1,1
S01008817,Rented or living rent free: Total,242,157,127,27,100,16,14,85,17,5,16,38,9
S01008817,Rented or living rent free: Social rented,130,61,49,15,34,2,10,69,14,3,12,33,7
S01008817,Rented or living rent free: Private rented or living rent free,112,96,78,12,66,14,4,16,3,2,4,5,2
S01008818,All HRPs aged 16 and over,371,303,267,29,238,32,4,68,41,3,18,5,1
S01008818,Owned: Total,247,206,182,11,171,22,2,41,36,2,1,2,0
S01008818,Owned: Owned outright,67,34,29,5,24,3,2,33,30,1,0,2,0
S01008818,Owned: Owned with a mortgage or loan or shared ownership,180,172,153,6,147,19,0,8,6,1,1,0,0
S01008818,Rented or living rent free: Total,124,97,85,18,67,10,2,27,5,1,17,3,1
S01008818,Rented or living rent free: Social rented,32,15,15,5,10,0,0,17,0,0,17,0,0
S01008818,Rented or living rent free: Private rented or living rent free,92,82,70,13,57,10,2,10,5,1,0,3,1
S01008819,All HRPs aged 16 and over,368,297,240,18,222,49,8,71,55,7,2,5,2
S01008819,Owned: Total,254,209,166,11,155,40,3,45,42,1,0,1,1
S01008819,Owned: Owned outright,90,48,35,4,31,12,1,42,40,1,0,1,0
S01008819,Owned: Owned with a mortgage or loan or shared ownership,164,161,131,7,124,28,2,3,2,0,0,0,1
S01008819,Rented or living rent free: Total,114,88,74,7,67,9,5,26,13,6,2,4,1
S01008819,Rented or living rent free: Social rented,23,7,6,1,5,0,1,16,6,5,1,3,1
S01008819,Rented or living rent free: Private rented or living rent free,91,81,68,6,62,9,4,10,7,1,1,1,0
S01008820,All HRPs aged 16 and over,616,447,357,43,314,49,41,169,95,14,12,38,10
S01008820,Owned: Total,242,201,175,12,163,23,3,41,35,0,1,4,1
S01008820,Owned: Owned outright,76,41,34,3,31,7,0,35,30,0,1,3,1
S01008820,Owned: Owned with a mortgage or loan or shared ownership,166,160,141,9,132,16,3,6,5,0,0,1,0
S01008820,Rented or living rent free: Total,374,246,182,31,151,26,38,128,60,14,11,34,9
S01008820,Rented or living rent free: Social rented,223,131,89,17,72,11,31,92,50,7,4,24,7
S01008820,Rented or living rent free: Private rented or living rent free,151,115,93,14,79,15,7,36,10,7,7,10,2
S01008821,All HRPs aged 16 and over,271,217,181,20,161,32,4,54,46,0,6,2,0
S01008821,Owned: Total,224,180,151,13,138,29,0,44,44,0,0,0,0
S01008821,Owned: Owned outright,78,38,29,7,22,9,0,40,40,0,0,0,0
S01008821,Owned: Owned with a mortgage or loan or shared ownership,146,142,122,6,116,20,0,4,4,0,0,0,0
S01008821,Rented or living rent free: Total,47,37,30,7,23,3,4,10,2,0,6,2,0
S01008821,Rented or living rent free: Social rented,12,8,7,1,6,1,0,4,0,0,3,1,0
S01008821,Rented or living rent free: Private rented or living rent free,35,29,23,6,17,2,4,6,2,0,3,1,0
S01008822,All HRPs aged 16 and over,286,214,164,15,149,46,4,72,67,3,0,2,0
S01008822,Owned: Total,258,188,144,15,129,42,2,70,67,3,0,0,0
S01008822,Owned: Owned outright,116,57,40,10,30,16,1,59,59,0,0,0,0
S01008822,Owned: Owned with a mortgage or loan or shared ownership,142,131,104,5,99,26,1,11,8,3,0,0,0
S01008822,Rented or living rent free: Total,28,26,20,0,20,4,2,2,0,0,0,2,0
S01008822,Rented or living rent free: Social rented,6,4,2,0,2,0,2,2,0,0,0,2,0
S01008822,Rented or living rent free: Private rented or living rent free,22,22,18,0,18,4,0,0,0,0,0,0,0
S01008823,All HRPs aged 16 and over,269,184,145,16,129,37,2,85,78,2,2,2,1
S01008823,Owned: Total,227,147,114,8,106,33,0,80,74,2,2,1,1
S01008823,Owned: Owned outright,114,44,36,3,33,8,0,70,66,1,2,0,1
S01008823,Owned: Owned with a mortgage or loan or shared ownership,113,103,78,5,73,25,0,10,8,1,0,1,0
S01008823,Rented or living rent free: Total,42,37,31,8,23,4,2,5,4,0,0,1,0
S01008823,Rented or living rent free: Social rented,3,3,2,0,2,0,1,0,0,0,0,0,0
S01008823,Rented or living rent free: Private rented or living rent free,39,34,29,8,21,4,1,5,4,0,0,1,0
S01008824,All HRPs aged 16 and over,510,364,305,37,268,45,14,146,129,2,1,10,4
S01008824,Owned: Total,394,277,229,24,205,40,8,117,115,1,0,1,0
S01008824,Owned: Owned outright,187,83,64,10,54,17,2,104,104,0,0,0,0
S01008824,Owned: Owned with a mortgage or loan or shared ownership,207,194,165,14,151,23,6,13,11,1,0,1,0
S01008824,Rented or living rent free: Total,116,87,76,13,63,5,6,29,14,1,1,9,4
S01008824,Rented or living rent free: Social rented,23,7,6,0,6,0,1,16,6,0,0,9,1
S01008824,Rented or living rent free: Private rented or living rent free,93,80,70,13,57,5,5,13,8,1,1,0,3
S01008825,All HRPs aged 16 and over,296,223,177,20,157,43,3,73,71,1,0,1,0
S01008825,Owned: Total,245,178,138,15,123,38,2,67,66,1,0,0,0
S01008825,Owned: Owned outright,122,58,39,7,32,18,1,64,63,1,0,0,0
S01008825,Owned: Owned with a mortgage or loan or shared ownership,123,120,99,8,91,20,1,3,3,0,0,0,0
S01008825,Rented or living rent free: Total,51,45,39,5,34,5,1,6,5,0,0,1,0
S01008825,Rented or living rent free: Social rented,8,3,2,0,2,0,1,5,4,0,0,1,0
S01008825,Rented or living rent free: Private rented or living rent free,43,42,37,5,32,5,0,1,1,0,0,0,0
S01008826,All HRPs aged 16 and over,378,292,224,30,194,48,20,86,57,0,0,22,7
S01008826,Owned: Total,224,167,130,11,119,35,2,57,54,0,0,2,1
S01008826,Owned: Owned outright,101,47,35,8,27,10,2,54,51,0,0,2,1
S01008826,Owned: Owned with a mortgage or loan or shared ownership,123,120,95,3,92,25,0,3,3,0,0,0,0
S01008826,Rented or living rent free: Total,154,125,94,19,75,13,18,29,3,0,0,20,6
S01008826,Rented or living rent free: Social rented,73,50,36,9,27,3,11,23,2,0,0,16,5
S01008826,Rented or living rent free: Private rented or living rent free,81,75,58,10,48,10,7,6,1,0,0,4,1
S01008827,All HRPs aged 16 and over,273,189,138,18,120,50,1,84,77,1,1,5,0
S01008827,Owned: Total,258,176,129,18,111,47,0,82,77,1,1,3,0
S01008827,Owned: Owned outright,142,66,49,13,36,17,0,76,73,1,0,2,0
S01008827,Owned: Owned with a mortgage or loan or shared ownership,116,110,80,5,75,30,0,6,4,0,1,1,0
S01008827,Rented or living rent free: Total,15,13,9,0,9,3,1,2,0,0,0,2,0
S01008827,Rented or living rent free: Social rented,1,1,1,0,1,0,0,0,0,0,0,0,0
S01008827,Rented or living rent free: Private rented or living rent free,14,12,8,0,8,3,1,2,0,0,0,2,0
S01008828,All HRPs aged 16 and over,439,304,242,23,219,50,12,135,113,2,7,9,4
S01008828,Owned: Total,330,221,174,14,160,43,4,109,103,0,2,3,1
S01008828,Owned: Owned outright,177,78,56,9,47,20,2,99,96,0,0,2,1
S01008828,Owned: Owned with a mortgage or loan or shared ownership,153,143,118,5,113,23,2,10,7,0,2,1,0
S01008828,Rented or living rent free: Total,109,83,68,9,59,7,8,26,10,2,5,6,3
S01008828,Rented or living rent free: Social rented,27,17,7,2,5,3,7,10,3,1,0,3,3
S01008828,Rented or living rent free: Private rented or living rent free,82,66,61,7,54,4,1,16,7,1,5,3,0
S01008829,All HRPs aged 16 and over,297,185,151,25,126,28,6,112,88,10,6,4,4
S01008829,Owned: Total,234,159,129,20,109,26,4,75,70,2,0,1,2
S01008829,Owned: Owned outright,119,52,42,11,31,8,2,67,63,2,0,1,1
S01008829,Owned: Owned with a mortgage or loan or shared ownership,115,107,87,9,78,18,2,8,7,0,0,0,1
S01008829,Rented or living rent free: Total,63,26,22,5,17,2,2,37,18,8,6,3,2
S01008829,Rented or living rent free: Social rented,31,8,7,3,4,0,1,23,13,0,5,3,2
S01008829,Rented or living rent free: Private rented or living rent free,32,18,15,2,13,2,1,14,5,8,1,0,0
S01008830,All HRPs aged 16 and over,334,212,164,17,147,43,5,122,111,4,0,6,1
S01008830,Owned: Total,281,174,135,13,122,39,0,107,105,0,0,2,0
S01008830,Owned: Owned outright,158,59,44,7,37,15,0,99,98,0,0,1,0
S01008830,Owned: Owned with a mortgage or loan or shared ownership,123,115,91,6,85,24,0,8,7,0,0,1,0
S01008830,Rented or living rent free: Total,53,38,29,4,25,4,5,15,6,4,0,4,1
S01008830,Rented or living rent free: Social rented,10,5,2,0,2,0,3,5,3,0,0,1,1
S01008830,Rented or living rent free: Private rented or living rent free,43,33,27,4,23,4,2,10,3,4,0,3,0
S01008831,All HRPs aged 16 and over,359,205,144,23,121,56,5,154,145,2,3,2,2
S01008831,Owned: Total,310,178,126,19,107,49,3,132,129,0,1,1,1
S01008831,Owned: Owned outright,199,78,58,14,44,19,1,121,120,0,1,0,0
S01008831,Owned: Owned with a mortgage or loan or shared ownership,111,100,68,5,63,30,2,11,9,0,0,1,1
S01008831,Rented or living rent free: Total,49,27,18,4,14,7,2,22,16,2,2,1,1
S01008831,Rented or living rent free: Social rented,22,8,5,2,3,2,1,14,12,0,0,1,1
S01008831,Rented or living rent free: Private rented or living rent free,27,19,13,2,11,5,1,8,4,2,2,0,0
S01008832,All HRPs aged 16 and over,350,213,160,15,145,47,6,137,118,7,9,2,1
S01008832,Owned: Total,287,168,122,15,107,44,2,119,115,1,3,0,0
S01008832,Owned: Owned outright,167,64,43,14,29,19,2,103,102,1,0,0,0
S01008832,Owned: Owned with a mortgage or loan or shared ownership,120,104,79,1,78,25,0,16,13,0,3,0,0
S01008832,Rented or living rent free: Total,63,45,38,0,38,3,4,18,3,6,6,2,1
S01008832,Rented or living rent free: Social rented,2,0,0,0,0,0,0,2,0,0,0,1,1
S01008832,Rented or living rent free: Private rented or living rent free,61,45,38,0,38,3,4,16,3,6,6,1,0
S01008833,All HRPs aged 16 and over,526,320,263,27,236,51,6,206,184,7,5,8,2
S01008833,Owned: Total,374,237,194,14,180,40,3,137,131,2,2,1,1
S01008833,Owned: Owned outright,195,70,56,6,50,13,1,125,122,1,2,0,0
S01008833,Owned: Owned with a mortgage or loan or shared ownership,179,167,138,8,130,27,2,12,9,1,0,1,1
S01008833,Rented or living rent free: Total,152,83,69,13,56,11,3,69,53,5,3,7,1
S01008833,Rented or living rent free: Social rented,55,7,4,2,2,0,3,48,45,0,1,1,1
S01008833,Rented or living rent free: Private rented or living rent free,97,76,65,11,54,11,0,21,8,5,2,6,0
S01008834,All HRPs aged 16 and over,519,359,274,36,238,81,4,160,141,6,5,6,2
S01008834,Owned: Total,405,265,203,30,173,61,1,140,136,0,2,2,0
S01008834,Owned: Owned outright,224,100,72,21,51,28,0,124,122,0,0,2,0
S01008834,Owned: Owned with a mortgage or loan or shared ownership,181,165,131,9,122,33,1,16,14,0,2,0,0
S01008834,Rented or living rent free: Total,114,94,71,6,65,20,3,20,5,6,3,4,2
S01008834,Rented or living rent free: Social rented,5,0,0,0,0,0,0,5,1,0,1,3,0
S01008834,Rented or living rent free: Private rented or living rent free,109,94,71,6,65,20,3,15,4,6,2,1,2
S01008835,All HRPs aged 16 and over,407,258,226,33,193,27,5,149,133,4,5,7,0
S01008835,Owned: Total,342,219,195,25,170,22,2,123,117,3,3,0,0
S01008835,Owned: Owned outright,181,73,65,15,50,6,2,108,103,2,3,0,0
S01008835,Owned: Owned with a mortgage or loan or shared ownership,161,146,130,10,120,16,0,15,14,1,0,0,0
S01008835,Rented or living rent free: Total,65,39,31,8,23,5,3,26,16,1,2,7,0
S01008835,Rented or living rent free: Social rented,22,10,7,3,4,1,2,12,9,0,0,3,0
S01008835,Rented or living rent free: Private rented or living rent free,43,29,24,5,19,4,1,14,7,1,2,4,0
S01008836,All HRPs aged 16 and over,413,288,241,33,208,38,9,125,75,10,3,28,9
S01008836,Owned: Total,224,167,136,12,124,28,3,57,44,3,1,4,5
S01008836,Owned: Owned outright,80,37,28,6,22,8,1,43,36,2,1,2,2
S01008836,Owned: Owned with a mortgage or loan or shared ownership,144,130,108,6,102,20,2,14,8,1,0,2,3
S01008836,Rented or living rent free: Total,189,121,105,21,84,10,6,68,31,7,2,24,4
S01008836,Rented or living rent free: Social rented,90,34,28,6,22,4,2,56,27,2,2,21,4
S01008836,Rented or living rent free: Private rented or living rent free,99,87,77,15,62,6,4,12,4,5,0,3,0
S01008837,All HRPs aged 16 and over,630,526,439,50,389,60,27,104,57,14,10,18,5
S01008837,Owned: Total,323,275,228,21,207,37,10,48,43,1,2,1,1
S01008837,Owned: Owned outright,82,43,34,4,30,6,3,39,37,0,2,0,0
S01008837,Owned: Owned with a mortgage or loan or shared ownership,241,232,194,17,177,31,7,9,6,1,0,1,1
S01008837,Rented or living rent free: Total,307,251,211,29,182,23,17,56,14,13,8,17,4
S01008837,Rented or living rent free: Social rented,52,24,13,5,8,1,10,28,5,4,3,14,2
S01008837,Rented or living rent free: Private rented or living rent free,255,227,198,24,174,22,7,28,9,9,5,3,2
S01008838,All HRPs aged 16 and over,606,481,407,47,360,61,13,125,89,14,2,16,4
S01008838,Owned: Total,341,263,226,29,197,36,1,78,74,2,0,2,0
S01008838,Owned: Owned outright,154,84,64,14,50,19,1,70,67,2,0,1,0
S01008838,Owned: Owned with a mortgage or loan or shared ownership,187,179,162,15,147,17,0,8,7,0,0,1,0
S01008838,Rented or living rent free: Total,265,218,181,18,163,25,12,47,15,12,2,14,4
S01008838,Rented or living rent free: Social rented,20,8,4,1,3,1,3,12,3,0,0,9,0
S01008838,Rented or living rent free: Private rented or living rent free,245,210,177,17,160,24,9,35,12,12,2,5,4
S01008839,All HRPs aged 16 and over,549,417,361,39,322,50,6,132,86,18,4,21,3
S01008839,Owned: Total,313,236,198,21,177,36,2,77,73,1,0,1,2
S01008839,Owned: Owned outright,134,64,55,9,46,8,1,70,68,0,0,1,1
S01008839,Owned: Owned with a mortgage or loan or shared ownership,179,172,143,12,131,28,1,7,5,1,0,0,1
S01008839,Rented or living rent free: Total,236,181,163,18,145,14,4,55,13,17,4,20,1
S01008839,Rented or living rent free: Social rented,47,20,19,5,14,0,1,27,7,1,1,17,1
S01008839,Rented or living rent free: Private rented or living rent free,189,161,144,13,131,14,3,28,6,16,3,3,0
S01008840,All HRPs aged 16 and over,510,400,333,45,288,54,13,110,81,10,9,4,6
S01008840,Owned: Total,348,258,214,23,191,42,2,90,78,0,7,1,4
S01008840,Owned: Owned outright,151,74,57,13,44,16,1,77,73,0,0,1,3
S01008840,Owned: Owned with a mortgage or loan or shared ownership,197,184,157,10,147,26,1,13,5,0,7,0,1
S01008840,Rented or living rent free: Total,162,142,119,22,97,12,11,20,3,10,2,3,2
S01008840,Rented or living rent free: Social rented,8,4,1,0,1,1,2,4,2,0,0,2,0
S01008840,Rented or living rent free: Private rented or living rent free,154,138,118,22,96,11,9,16,1,10,2,1,2
S01008841,All HRPs aged 16 and over,291,239,201,24,177,34,4,52,32,4,8,5,3
S01008841,Owned: Total,185,148,123,10,113,24,1,37,31,2,0,3,1
S01008841,Owned: Owned outright,71,42,37,8,29,5,0,29,29,0,0,0,0
S01008841,Owned: Owned with a mortgage or loan or shared ownership,114,106,86,2,84,19,1,8,2,2,0,3,1
S01008841,Rented or living rent free: Total,106,91,78,14,64,10,3,15,1,2,8,2,2
S01008841,Rented or living rent free: Social rented,14,5,2,1,1,1,2,9,1,0,5,2,1
S01008841,Rented or living rent free: Private rented or living rent free,92,86,76,13,63,9,1,6,0,2,3,0,1
S01008842,All HRPs aged 16 and over,433,367,307,34,273,43,17,66,27,20,12,3,4
S01008842,Owned: Total,197,173,144,5,139,25,4,24,24,0,0,0,0
S01008842,Owned: Owned outright,40,20,14,0,14,5,1,20,20,0,0,0,0
S01008842,Owned: Owned with a mortgage or loan or shared ownership,157,153,130,5,125,20,3,4,4,0,0,0,0
S01008842,Rented or living rent free: Total,236,194,163,29,134,18,13,42,3,20,12,3,4
S01008842,Rented or living rent free: Social rented,20,10,2,0,2,1,7,10,2,1,4,3,0
S01008842,Rented or living rent free: Private rented or living rent free,216,184,161,29,132,17,6,32,1,19,8,0,4
S01008843,All HRPs aged 16 and over,464,381,322,41,281,48,11,83,47,13,5,12,6
S01008843,Owned: Total,241,187,156,16,140,27,4,54,38,3,4,3,6
S01008843,Owned: Owned outright,87,48,41,7,34,6,1,39,33,0,1,1,4
S01008843,Owned: Owned with a mortgage or loan or shared ownership,154,139,115,9,106,21,3,15,5,3,3,2,2
S01008843,Rented or living rent free: Total,223,194,166,25,141,21,7,29,9,10,1,9,0
S01008843,Rented or living rent free: Social rented,15,8,7,4,3,1,0,7,5,0,0,2,0
S01008843,Rented or living rent free: Private rented or living rent free,208,186,159,21,138,20,7,22,4,10,1,7,0
S01008844,All HRPs aged 16 and over,355,288,249,27,222,32,7,67,29,19,7,9,3
S01008844,Owned: Total,169,133,112,5,107,20,1,36,22,10,0,3,1
S01008844,Owned: Owned outright,50,30,26,3,23,3,1,20,17,2,0,0,1
S01008844,Owned: Owned with a mortgage or loan or shared ownership,119,103,86,2,84,17,0,16,5,8,0,3,0
S01008844,Rented or living rent free: Total,186,155,137,22,115,12,6,31,7,9,7,6,2
S01008844,Rented or living rent free: Social rented,30,17,15,6,9,0,2,13,5,0,3,4,1
S01008844,Rented or living rent free: Private rented or living rent free,156,138,122,16,106,12,4,18,2,9,4,2,1
S01008845,All HRPs aged 16 and over,420,314,254,45,209,53,7,106,37,55,3,3,8
S01008845,Owned: Total,190,142,106,10,96,35,1,48,35,8,1,0,4
S01008845,Owned: Owned outright,95,55,41,7,34,13,1,40,34,4,1,0,1
S01008845,Owned: Owned with a mortgage or loan or shared ownership,95,87,65,3,62,22,0,8,1,4,0,0,3
S01008845,Rented or living rent free: Total,230,172,148,35,113,18,6,58,2,47,2,3,4
S01008845,Rented or living rent free: Social rented,8,0,0,0,0,0,0,8,0,5,2,0,1
S01008845,Rented or living rent free: Private rented or living rent free,222,172,148,35,113,18,6,50,2,42,0,3,3
S01008846,All HRPs aged 16 and over,386,298,221,34,187,69,8,88,49,23,2,10,4
S01008846,Owned: Total,193,157,106,8,98,49,2,36,33,2,0,0,1
S01008846,Owned: Owned outright,96,64,46,4,42,17,1,32,30,1,0,0,1
S01008846,Owned: Owned with a mortgage or loan or shared ownership,97,93,60,4,56,32,1,4,3,1,0,0,0
S01008846,Rented or living rent free: Total,193,141,115,26,89,20,6,52,16,21,2,10,3
S01008846,Rented or living rent free: Social rented,34,10,6,2,4,1,3,24,14,0,0,9,1
S01008846,Rented or living rent free: Private rented or living rent free,159,131,109,24,85,19,3,28,2,21,2,1,2
S01008847,All HRPs aged 16 and over,263,197,146,14,132,46,5,66,31,29,3,1,2
S01008847,Owned: Total,134,103,72,3,69,28,3,31,25,3,3,0,0
S01008847,Owned: Owned outright,61,35,24,1,23,9,2,26,24,1,1,0,0
S01008847,Owned: Owned with a mortgage or loan or shared ownership,73,68,48,2,46,19,1,5,1,2,2,0,0
S01008847,Rented or living rent free: Total,129,94,74,11,63,18,2,35,6,26,0,1,2
S01008847,Rented or living rent free: Social rented,3,0,0,0,0,0,0,3,2,0,0,1,0
S01008847,Rented or living rent free: Private rented or living rent free,126,94,74,11,63,18,2,32,4,26,0,0,2
S01008848,All HRPs aged 16 and over,384,310,227,27,200,70,13,74,37,27,0,8,2
S01008848,Owned: Total,209,173,125,8,117,47,1,36,32,3,0,0,1
S01008848,Owned: Owned outright,107,75,57,4,53,18,0,32,29,2,0,0,1
S01008848,Owned: Owned with a mortgage or loan or shared ownership,102,98,68,4,64,29,1,4,3,1,0,0,0
S01008848,Rented or living rent free: Total,175,137,102,19,83,23,12,38,5,24,0,8,1
S01008848,Rented or living rent free: Social rented,29,15,12,9,3,3,0,14,3,3,0,7,1
S01008848,Rented or living rent free: Private rented or living rent free,146,122,90,10,80,20,12,24,2,21,0,1,0
S01008849,All HRPs aged 16 and over,396,314,234,26,208,73,7,82,48,23,5,1,5
S01008849,Owned: Total,184,134,93,10,83,39,2,50,46,2,0,0,2
S01008849,Owned: Owned outright,98,55,36,7,29,17,2,43,40,2,0,0,1
S01008849,Owned: Owned with a mortgage or loan or shared ownership,86,79,57,3,54,22,0,7,6,0,0,0,1
S01008849,Rented or living rent free: Total,212,180,141,16,125,34,5,32,2,21,5,1,3
S01008849,Rented or living rent free: Social rented,3,1,1,1,0,0,0,2,0,0,0,1,1
S01008849,Rented or living rent free: Private rented or living rent free,209,179,140,15,125,34,5,30,2,21,5,0,2
S01008850,All HRPs aged 16 and over,401,283,208,29,179,69,6,118,67,35,5,4,7
S01008850,Owned: Total,222,146,89,14,75,54,3,76,63,3,2,2,6
S01008850,Owned: Owned outright,127,62,39,12,27,21,2,65,55,2,1,1,6
S01008850,Owned: Owned with a mortgage or loan or shared ownership,95,84,50,2,48,33,1,11,8,1,1,1,0
S01008850,Rented or living rent free: Total,179,137,119,15,104,15,3,42,4,32,3,2,1
S01008850,Rented or living rent free: Social rented,5,1,1,0,1,0,0,4,2,0,1,1,0
S01008850,Rented or living rent free: Private rented or living rent free,174,136,118,15,103,15,3,38,2,32,2,1,1
S01008851,All HRPs aged 16 and over,634,413,299,31,268,92,22,221,146,28,7,32,8
S01008851,Owned: Total,260,178,117,8,109,56,5,82,69,4,4,2,3
S01008851,Owned: Owned outright,142,78,48,4,44,27,3,64,59,2,1,0,2
S01008851,Owned: Owned with a mortgage or loan or shared ownership,118,100,69,4,65,29,2,18,10,2,3,2,1
S01008851,Rented or living rent free: Total,374,235,182,23,159,36,17,139,77,24,3,30,5
S01008851,Rented or living rent free: Social rented,135,42,31,8,23,4,7,93,66,1,1,22,3
S01008851,Rented or living rent free: Private rented or living rent free,239,193,151,15,136,32,10,46,11,23,2,8,2
S01008852,All HRPs aged 16 and over,503,368,254,34,220,108,6,135,91,30,3,4,7
S01008852,Owned: Total,312,214,124,17,107,88,2,98,85,2,3,3,5
S01008852,Owned: Owned outright,207,119,62,12,50,56,1,88,78,2,2,2,4
S01008852,Owned: Owned with a mortgage or loan or shared ownership,105,95,62,5,57,32,1,10,7,0,1,1,1
S01008852,Rented or living rent free: Total,191,154,130,17,113,20,4,37,6,28,0,1,2
S01008852,Rented or living rent free: Social rented,0,0,0,0,0,0,0,0,0,0,0,0,0
S01008852,Rented or living rent free: Private rented or living rent free,191,154,130,17,113,20,4,37,6,28,0,1,2
S01008853,All HRPs aged 16 and over,352,306,246,30,216,48,12,46,22,17,0,4,3
S01008853,Owned: Total,180,155,123,9,114,31,1,25,20,0,0,2,3
S01008853,Owned: Owned outright,75,55,47,5,42,7,1,20,18,0,0,1,1
S01008853,Owned: Owned with a mortgage or loan or shared ownership,105,100,76,4,72,24,0,5,2,0,0,1,2
S01008853,Rented or living rent free: Total,172,151,123,21,102,17,11,21,2,17,0,2,0
S01008853,Rented or living rent free: Social rented,4,2,1,0,1,0,1,2,1,0,0,1,0
S01008853,Rented or living rent free: Private rented or living rent free,168,149,122,21,101,17,10,19,1,17,0,1,0
S01008854,All HRPs aged 16 and over,483,364,250,28,222,97,17,119,63,44,5,4,3
S01008854,Owned: Total,249,182,115,7,108,60,7,67,58,4,3,2,0
S01008854,Owned: Owned outright,132,74,41,6,35,32,1,58,54,0,2,2,0
S01008854,Owned: Owned with a mortgage or loan or shared ownership,117,108,74,1,73,28,6,9,4,4,1,0,0
S01008854,Rented or living rent free: Total,234,182,135,21,114,37,10,52,5,40,2,2,3
S01008854,Rented or living rent free: Social rented,4,1,1,1,0,0,0,3,0,1,1,1,0
S01008854,Rented or living rent free: Private rented or living rent free,230,181,134,20,114,37,10,49,5,39,1,1,3
S01008855,All HRPs aged 16 and over,620,494,395,29,366,88,11,126,64,33,9,16,4
S01008855,Owned: Total,318,240,186,13,173,49,5,78,56,5,6,7,4
S01008855,Owned: Owned outright,138,77,57,5,52,16,4,61,53,1,2,2,3
S01008855,Owned: Owned with a mortgage or loan or shared ownership,180,163,129,8,121,33,1,17,3,4,4,5,1
S01008855,Rented or living rent free: Total,302,254,209,16,193,39,6,48,8,28,3,9,0
S01008855,Rented or living rent free: Social rented,10,7,3,1,2,1,3,3,0,0,0,3,0
S01008855,Rented or living rent free: Private rented or living rent free,292,247,206,15,191,38,3,45,8,28,3,6,0
S01008856,All HRPs aged 16 and over,296,255,218,27,191,30,7,41,23,5,2,9,2
S01008856,Owned: Total,148,122,102,7,95,20,0,26,20,0,2,3,1
S01008856,Owned: Owned outright,61,40,28,2,26,12,0,21,18,0,1,1,1
S01008856,Owned: Owned with a mortgage or loan or shared ownership,87,82,74,5,69,8,0,5,2,0,1,2,0
S01008856,Rented or living rent free: Total,148,133,116,20,96,10,7,15,3,5,0,6,1
S01008856,Rented or living rent free: Social rented,7,3,2,0,2,0,1,4,0,0,0,3,1
S01008856,Rented or living rent free: Private rented or living rent free,141,130,114,20,94,10,6,11,3,5,0,3,0
S01008857,All HRPs aged 16 and over,434,357,289,48,241,60,8,77,66,4,1,6,0
S01008857,Owned: Total,274,209,166,28,138,40,3,65,62,0,1,2,0
S01008857,Owned: Owned outright,142,82,64,21,43,16,2,60,57,0,1,2,0
S01008857,Owned: Owned with a mortgage or loan or shared ownership,132,127,102,7,95,24,1,5,5,0,0,0,0
S01008857,Rented or living rent free: Total,160,148,123,20,103,20,5,12,4,4,0,4,0
S01008857,Rented or living rent free: Social rented,3,2,1,1,0,1,0,1,0,0,0,1,0
S01008857,Rented or living rent free: Private rented or living rent free,157,146,122,19,103,19,5,11,4,4,0,3,0
S01008858,All HRPs aged 16 and over,328,246,186,18,168,55,5,82,72,4,4,2,0
S01008858,Owned: Total,218,151,110,12,98,38,3,67,65,0,2,0,0
S01008858,Owned: Owned outright,131,69,45,7,38,21,3,62,60,0,2,0,0
S01008858,Owned: Owned with a mortgage or loan or shared ownership,87,82,65,5,60,17,0,5,5,0,0,0,0
S01008858,Rented or living rent free: Total,110,95,76,6,70,17,2,15,7,4,2,2,0
S01008858,Rented or living rent free: Social rented,2,1,1,0,1,0,0,1,0,0,0,1,0
S01008858,Rented or living rent free: Private rented or living rent free,108,94,75,6,69,17,2,14,7,4,2,1,0
S01008859,All HRPs aged 16 and over,712,513,397,28,369,97,19,199,165,11,3,9,11
S01008859,Owned: Total,261,183,133,7,126,47,3,78,71,1,1,0,5
S01008859,Owned: Owned outright,122,50,34,5,29,14,2,72,69,1,0,0,2
S01008859,Owned: Owned with a mortgage or loan or shared ownership,139,133,99,2,97,33,1,6,2,0,1,0,3
S01008859,Rented or living rent free: Total,451,330,264,21,243,50,16,121,94,10,2,9,6
S01008859,Rented or living rent free: Social rented,97,13,9,3,6,3,1,84,78,0,0,3,3
S01008859,Rented or living rent free: Private rented or living rent free,354,317,255,18,237,47,15,37,16,10,2,6,3
S01008860,All HRPs aged 16 and over,500,374,308,41,267,51,15,126,84,18,4,15,5
S01008860,Owned: Total,279,200,158,27,131,37,5,79,67,4,3,1,4
S01008860,Owned: Owned outright,124,63,52,18,34,11,0,61,56,1,3,0,1
S01008860,Owned: Owned with a mortgage or loan or shared ownership,155,137,106,9,97,26,5,18,11,3,0,1,3
S01008860,Rented or living rent free: Total,221,174,150,14,136,14,10,47,17,14,1,14,1
S01008860,Rented or living rent free: Social rented,31,12,10,4,6,0,2,19,8,0,1,10,0
S01008860,Rented or living rent free: Private rented or living rent free,190,162,140,10,130,14,8,28,9,14,0,4,1
S01008861,All HRPs aged 16 and over,349,260,165,15,150,89,6,89,76,5,3,3,2
S01008861,Owned: Total,269,190,114,7,107,74,2,79,72,1,3,2,1
S01008861,Owned: Owned outright,164,94,53,6,47,39,2,70,64,1,2,2,1
S01008861,Owned: Owned with a mortgage or loan or shared ownership,105,96,61,1,60,35,0,9,8,0,1,0,0
S01008861,Rented or living rent free: Total,80,70,51,8,43,15,4,10,4,4,0,1,1
S01008861,Rented or living rent free: Social rented,3,0,0,0,0,0,0,3,2,0,0,0,1
S01008861,Rented or living rent free: Private rented or living rent free,77,70,51,8,43,15,4,7,2,4,0,1,0
S01008862,All HRPs aged 16 and over,561,453,360,34,326,75,18,108,66,18,3,15,6
S01008862,Owned: Total,243,190,146,15,131,39,5,53,42,0,3,3,5
S01008862,Owned: Owned outright,102,57,41,3,38,14,2,45,39,0,1,1,4
S01008862,Owned: Owned with a mortgage or loan or shared ownership,141,133,105,12,93,25,3,8,3,0,2,2,1
S01008862,Rented or living rent free: Total,318,263,214,19,195,36,13,55,24,18,0,12,1
S01008862,Rented or living rent free: Social rented,40,16,12,4,8,1,3,24,17,1,0,6,0
S01008862,Rented or living rent free: Private rented or living rent free,278,247,202,15,187,35,10,31,7,17,0,6,1
S01008863,All HRPs aged 16 and over,392,307,253,25,228,50,4,85,71,3,0,4,7
S01008863,Owned: Total,235,177,139,15,124,37,1,58,53,2,0,1,2
S01008863,Owned: Owned outright,118,67,52,8,44,14,1,51,50,0,0,0,1
S01008863,Owned: Owned with a mortgage or loan or shared ownership,117,110,87,7,80,23,0,7,3,2,0,1,1
S01008863,Rented or living rent free: Total,157,130,114,10,104,13,3,27,18,1,0,3,5
S01008863,Rented or living rent free: Social rented,16,2,2,2,0,0,0,14,11,0,0,2,1
S01008863,Rented or living rent free: Private rented or living rent free,141,128,112,8,104,13,3,13,7,1,0,1,4
S01008864,All HRPs aged 16 and over,410,277,244,13,231,32,1,133,120,3,3,4,3
S01008864,Owned: Total,259,140,118,5,113,22,0,119,113,1,3,2,0
S01008864,Owned: Owned outright,152,46,41,5,36,5,0,106,105,0,0,1,0
S01008864,Owned: Owned with a mortgage or loan or shared ownership,107,94,77,0,77,17,0,13,8,1,3,1,0
S01008864,Rented or living rent free: Total,151,137,126,8,118,10,1,14,7,2,0,2,3
S01008864,Rented or living rent free: Social rented,4,0,0,0,0,0,0,4,1,0,0,1,2
S01008864,Rented or living rent free: Private rented or living rent free,147,137,126,8,118,10,1,10,6,2,0,1,1
S01008865,All HRPs aged 16 and over,455,315,273,30,243,37,5,140,115,14,3,6,2
S01008865,Owned: Total,292,183,157,13,144,23,3,109,105,2,0,2,0
S01008865,Owned: Owned outright,167,64,49,6,43,13,2,103,100,1,0,2,0
S01008865,Owned: Owned with a mortgage or loan or shared ownership,125,119,108,7,101,10,1,6,5,1,0,0,0
S01008865,Rented or living rent free: Total,163,132,116,17,99,14,2,31,10,12,3,4,2
S01008865,Rented or living rent free: Social rented,5,2,2,1,1,0,0,3,2,0,1,0,0
S01008865,Rented or living rent free: Private rented or living rent free,158,130,114,16,98,14,2,28,8,12,2,4,2
S01008866,All HRPs aged 16 and over,467,389,322,20,302,58,9,78,65,4,3,5,1
S01008866,Owned: Total,278,214,176,11,165,34,4,64,59,2,0,2,1
S01008866,Owned: Owned outright,129,73,57,6,51,14,2,56,54,1,0,0,1
S01008866,Owned: Owned with a mortgage or loan or shared ownership,149,141,119,5,114,20,2,8,5,1,0,2,0
S01008866,Rented or living rent free: Total,189,175,146,9,137,24,5,14,6,2,3,3,0
S01008866,Rented or living rent free: Social rented,2,0,0,0,0,0,0,2,1,0,0,1,0
S01008866,Rented or living rent free: Private rented or living rent free,187,175,146,9,137,24,5,12,5,2,3,2,0
S01008867,All HRPs aged 16 and over,421,312,245,15,230,65,2,109,95,2,6,4,2
S01008867,Owned: Total,315,216,163,14,149,51,2,99,88,1,6,2,2
S01008867,Owned: Owned outright,169,86,60,11,49,26,0,83,78,0,2,2,1
S01008867,Owned: Owned with a mortgage or loan or shared ownership,146,130,103,3,100,25,2,16,10,1,4,0,1
S01008867,Rented or living rent free: Total,106,96,82,1,81,14,0,10,7,1,0,2,0
S01008867,Rented or living rent free: Social rented,3,1,1,0,1,0,0,2,1,0,0,1,0
S01008867,Rented or living rent free: Private rented or living rent free,103,95,81,1,80,14,0,8,6,1,0,1,0
S01008868,All HRPs aged 16 and over,391,331,249,31,218,71,11,60,28,26,2,1,3
S01008868,Owned: Total,157,127,85,7,78,41,1,30,25,1,2,0,2
S01008868,Owned: Owned outright,64,42,27,3,24,15,0,22,21,0,0,0,1
S01008868,Owned: Owned with a mortgage or loan or shared ownership,93,85,58,4,54,26,1,8,4,1,2,0,1
S01008868,Rented or living rent free: Total,234,204,164,24,140,30,10,30,3,25,0,1,1
S01008868,Rented or living rent free: Social rented,5,3,2,0,2,0,1,2,1,0,0,1,0
S01008868,Rented or living rent free: Private rented or living rent free,229,201,162,24,138,30,9,28,2,25,0,0,1
S01008869,All HRPs aged 16 and over,615,446,330,46,284,103,13,169,118,26,7,11,7
S01008869,Owned: Total,316,219,149,23,126,64,6,97,84,3,2,1,7
S01008869,Owned: Owned outright,187,99,68,15,53,28,3,88,75,3,2,1,7
S01008869,Owned: Owned with a mortgage or loan or shared ownership,129,120,81,8,73,36,3,9,9,0,0,0,0
S01008869,Rented or living rent free: Total,299,227,181,23,158,39,7,72,34,23,5,10,0
S01008869,Rented or living rent free: Social rented,66,20,14,6,8,5,1,46,32,5,1,8,0
S01008869,Rented or living rent free: Private rented or living rent free,233,207,167,17,150,34,6,26,2,18,4,2,0
S01008870,All HRPs aged 16 and over,426,324,250,24,226,70,4,102,85,8,1,5,3
S01008870,Owned: Total,258,179,137,15,122,42,0,79,75,1,0,2,1
S01008870,Owned: Owned outright,146,73,57,12,45,16,0,73,70,0,0,2,1
S01008870,Owned: Owned with a mortgage or loan or shared ownership,112,106,80,3,77,26,0,6,5,1,0,0,0
S01008870,Rented or living rent free: Total,168,145,113,9,104,28,4,23,10,7,1,3,2
S01008870,Rented or living rent free: Social rented,5,2,1,0,1,1,0,3,0,0,0,3,0
S01008870,Rented or living rent free: Private rented or living rent free,163,143,112,9,103,27,4,20,10,7,1,0,2
S01008871,All HRPs aged 16 and over,503,394,308,40,268,71,15,109,70,28,2,6,3
S01008871,Owned: Total,315,239,181,13,168,56,2,76,68,3,1,2,2
S01008871,Owned: Owned outright,165,100,71,9,62,28,1,65,59,2,1,2,1
S01008871,Owned: Owned with a mortgage or loan or shared ownership,150,139,110,4,106,28,1,11,9,1,0,0,1
S01008871,Rented or living rent free: Total,188,155,127,27,100,15,13,33,2,25,1,4,1
S01008871,Rented or living rent free: Social rented,0,0,0,0,0,0,0,0,0,0,0,0,0
S01008871,Rented or living rent free: Private rented or living rent free,188,155,127,27,100,15,13,33,2,25,1,4,1
S01008872,All HRPs aged 16 and over,401,314,242,40,202,61,11,87,57,20,5,2,3
S01008872,Owned: Total,221,162,111,10,101,46,5,59,51,3,3,1,1
S01008872,Owned: Owned outright,102,49,31,7,24,14,4,53,49,1,1,1,1
S01008872,Owned: Owned with a mortgage or loan or shared ownership,119,113,80,3,77,32,1,6,2,2,2,0,0
S01008872,Rented or living rent free: Total,180,152,131,30,101,15,6,28,6,17,2,1,2
S01008872,Rented or living rent free: Social rented,8,4,3,2,1,0,1,4,2,0,2,0,0
S01008872,Rented or living rent free: Private rented or living rent free,172,148,128,28,100,15,5,24,4,17,0,1,2
S01008873,All HRPs aged 16 and over,334,260,186,17,169,71,3,74,61,6,2,2,3
S01008873,Owned: Total,251,188,128,13,115,58,2,63,57,1,0,2,3
S01008873,Owned: Owned outright,128,70,46,7,39,22,2,58,53,0,0,2,3
S01008873,Owned: Owned with a mortgage or loan or shared ownership,123,118,82,6,76,36,0,5,4,1,0,0,0
S01008873,Rented or living rent free: Total,83,72,58,4,54,13,1,11,4,5,2,0,0
S01008873,Rented or living rent free: Social rented,1,1,1,1,0,0,0,0,0,0,0,0,0
S01008873,Rented or living rent free: Private rented or living rent free,82,71,57,3,54,13,1,11,4,5,2,0,0
S01008874,All HRPs aged 16 and over,514,355,295,21,274,55,5,159,127,16,4,9,3
S01008874,Owned: Total,307,207,166,11,155,38,3,100,93,2,1,1,3
S01008874,Owned: Owned outright,155,67,52,5,47,13,2,88,83,0,1,1,3
S01008874,Owned: Owned with a mortgage or loan or shared ownership,152,140,114,6,108,25,1,12,10,2,0,0,0
S01008874,Rented or living rent free: Total,207,148,129,10,119,17,2,59,34,14,3,8,0
S01008874,Rented or living rent free: Social rented,55,13,11,2,9,1,1,42,31,0,3,8,0
S01008874,Rented or living rent free: Private rented or living rent free,152,135,118,8,110,16,1,17,3,14,0,0,0
S01008875,All HRPs aged 16 and over,502,349,301,41,260,37,11,153,116,12,4,13,8
S01008875,Owned: Total,283,170,147,18,129,18,5,113,105,2,1,0,5
S01008875,Owned: Owned outright,120,37,24,4,20,8,5,83,80,0,0,0,3
S01008875,Owned: Owned with a mortgage or loan or shared ownership,163,133,123,14,109,10,0,30,25,2,1,0,2
S01008875,Rented or living rent free: Total,219,179,154,23,131,19,6,40,11,10,3,13,3
S01008875,Rented or living rent free: Social rented,32,19,15,5,10,1,3,13,4,0,0,9,0
S01008875,Rented or living rent free: Private rented or living rent free,187,160,139,18,121,18,3,27,7,10,3,4,3
S01008876,All HRPs aged 16 and over,291,158,126,21,105,26,6,133,131,1,0,0,1
S01008876,Owned: Total,260,144,118,20,98,22,4,116,115,0,0,0,1
S01008876,Owned: Owned outright,159,44,36,6,30,6,2,115,114,0,0,0,1
S01008876,Owned: Owned with a mortgage or loan or shared ownership,101,100,82,14,68,16,2,1,1,0,0,0,0
S01008876,Rented or living rent free: Total,31,14,8,1,7,4,2,17,16,1,0,0,0
S01008876,Rented or living rent free: Social rented,3,1,0,0,0,0,1,2,2,0,0,0,0
S01008876,Rented or living rent free: Private rented or living rent free,28,13,8,1,7,4,1,15,14,1,0,0,0
S01008877,All HRPs aged 16 and over,243,167,131,17,114,35,1,76,72,1,1,0,2
S01008877,Owned: Total,199,133,104,13,91,29,0,66,64,1,0,0,1
S01008877,Owned: Owned outright,95,32,27,8,19,5,0,63,61,1,0,0,1
S01008877,Owned: Owned with a mortgage or loan or shared ownership,104,101,77,5,72,24,0,3,3,0,0,0,0
S01008877,Rented or living rent free: Total,44,34,27,4,23,6,1,10,8,0,1,0,1
S01008877,Rented or living rent free: Social rented,10,4,4,2,2,0,0,6,5,0,1,0,0
S01008877,Rented or living rent free: Private rented or living rent free,34,30,23,2,21,6,1,4,3,0,0,0,1
S01008878,All HRPs aged 16 and over,459,254,202,37,165,45,7,205,171,3,9,17,5
S01008878,Owned: Total,332,194,155,25,130,36,3,138,132,1,2,2,1
S01008878,Owned: Owned outright,181,59,46,18,28,11,2,122,119,1,1,0,1
S01008878,Owned: Owned with a mortgage or loan or shared ownership,151,135,109,7,102,25,1,16,13,0,1,2,0
S01008878,Rented or living rent free: Total,127,60,47,12,35,9,4,67,39,2,7,15,4
S01008878,Rented or living rent free: Social rented,72,19,16,7,9,1,2,53,34,1,6,8,4
S01008878,Rented or living rent free: Private rented or living rent free,55,41,31,5,26,8,2,14,5,1,1,7,0
S01008879,All HRPs aged 16 and over,411,254,208,35,173,34,12,157,133,2,8,9,5
S01008879,Owned: Total,310,190,164,20,144,23,3,120,115,0,2,0,3
S01008879,Owned: Owned outright,165,57,49,13,36,6,2,108,107,0,0,0,1
S01008879,Owned: Owned with a mortgage or loan or shared ownership,145,133,115,7,108,17,1,12,8,0,2,0,2
S01008879,Rented or living rent free: Total,101,64,44,15,29,11,9,37,18,2,6,9,2
S01008879,Rented or living rent free: Social rented,36,17,11,4,7,3,3,19,10,1,1,6,1
S01008879,Rented or living rent free: Private rented or living rent free,65,47,33,11,22,8,6,18,8,1,5,3,1
S01008880,All HRPs aged 16 and over,291,202,170,24,146,28,4,89,76,2,3,6,2
S01008880,Owned: Total,238,164,135,17,118,27,2,74,67,2,1,4,0
S01008880,Owned: Owned outright,114,52,40,12,28,11,1,62,57,2,0,3,0
S01008880,Owned: Owned with a mortgage or loan or shared ownership,124,112,95,5,90,16,1,12,10,0,1,1,0
S01008880,Rented or living rent free: Total,53,38,35,7,28,1,2,15,9,0,2,2,2
S01008880,Rented or living rent free: Social rented,16,6,6,1,5,0,0,10,8,0,2,0,0
S01008880,Rented or living rent free: Private rented or living rent free,37,32,29,6,23,1,2,5,1,0,0,2,2
S01008881,All HRPs aged 16 and over,264,163,115,17,98,39,9,101,97,0,0,2,2
S01008881,Owned: Total,214,120,85,13,72,32,3,94,92,0,0,0,2
S01008881,Owned: Owned outright,134,44,28,10,18,15,1,90,89,0,0,0,1
S01008881,Owned: Owned with a mortgage or loan or shared ownership,80,76,57,3,54,17,2,4,3,0,0,0,1
S01008881,Rented or living rent free: Total,50,43,30,4,26,7,6,7,5,0,0,2,0
S01008881,Rented or living rent free: Social rented,4,0,0,0,0,0,0,4,3,0,0,1,0
S01008881,Rented or living rent free: Private rented or living rent free,46,43,30,4,26,7,6,3,2,0,0,1,0
S01008882,All HRPs aged 16 and over,401,303,223,15,208,78,2,98,89,0,4,2,3
S01008882,Owned: Total,360,266,190,15,175,74,2,94,86,0,3,2,3
S01008882,Owned: Owned outright,177,94,67,12,55,26,1,83,78,0,2,1,2
S01008882,Owned: Owned with a mortgage or loan or shared ownership,183,172,123,3,120,48,1,11,8,0,1,1,1
S01008882,Rented or living rent free: Total,41,37,33,0,33,4,0,4,3,0,1,0,0
S01008882,Rented or living rent free: Social rented,0,0,0,0,0,0,0,0,0,0,0,0,0
S01008882,Rented or living rent free: Private rented or living rent free,41,37,33,0,33,4,0,4,3,0,1,0,0
S01008883,All HRPs aged 16 and over,362,222,148,17,131,72,2,140,131,1,3,3,2
S01008883,Owned: Total,329,198,128,17,111,70,0,131,126,0,2,1,2
S01008883,Owned: Owned outright,230,103,68,15,53,35,0,127,123,0,2,1,1
S01008883,Owned: Owned with a mortgage or loan or shared ownership,99,95,60,2,58,35,0,4,3,0,0,0,1
S01008883,Rented or living rent free: Total,33,24,20,0,20,2,2,9,5,1,1,2,0
S01008883,Rented or living rent free: Social rented,3,1,0,0,0,0,1,2,0,0,0,2,0
S01008883,Rented or living rent free: Private rented or living rent free,30,23,20,0,20,2,1,7,5,1,1,0,0
S01008884,All HRPs aged 16 and over,316,159,110,14,96,47,2,157,146,5,3,1,2
S01008884,Owned: Total,295,146,99,13,86,46,1,149,143,2,3,0,1
S01008884,Owned: Owned outright,203,67,42,10,32,25,0,136,133,2,0,0,1
S01008884,Owned: Owned with a mortgage or loan or shared ownership,92,79,57,3,54,21,1,13,10,0,3,0,0
S01008884,Rented or living rent free: Total,21,13,11,1,10,1,1,8,3,3,0,1,1
S01008884,Rented or living rent free: Social rented,1,0,0,0,0,0,0,1,0,0,0,1,0
S01008884,Rented or living rent free: Private rented or living rent free,20,13,11,1,10,1,1,7,3,3,0,0,1
S01008885,All HRPs aged 16 and over,345,233,164,19,145,65,4,112,105,1,3,0,3
S01008885,Owned: Total,317,213,150,18,132,60,3,104,102,0,1,0,1
S01008885,Owned: Owned outright,176,75,56,13,43,18,1,101,99,0,1,0,1
S01008885,Owned: Owned with a mortgage or loan or shared ownership,141,138,94,5,89,42,2,3,3,0,0,0,0
S01008885,Rented or living rent free: Total,28,20,14,1,13,5,1,8,3,1,2,0,2
S01008885,Rented or living rent free: Social rented,4,2,1,0,1,0,1,2,1,0,0,0,1
S01008885,Rented or living rent free: Private rented or living rent free,24,18,13,1,12,5,0,6,2,1,2,0,1
S01008886,All HRPs aged 16 and over,425,273,220,26,194,42,11,152,127,8,5,7,5
S01008886,Owned: Total,323,193,154,17,137,35,4,130,122,0,5,1,2
S01008886,Owned: Owned outright,188,69,49,8,41,17,3,119,113,0,4,0,2
S01008886,Owned: Owned with a mortgage or loan or shared ownership,135,124,105,9,96,18,1,11,9,0,1,1,0
S01008886,Rented or living rent free: Total,102,80,66,9,57,7,7,22,5,8,0,6,3
S01008886,Rented or living rent free: Social rented,6,1,0,0,0,0,1,5,1,0,0,4,0
S01008886,Rented or living rent free: Private rented or living rent free,96,79,66,9,57,7,6,17,4,8,0,2,3
S01008887,All HRPs aged 16 and over,358,234,188,29,159,44,2,124,111,3,3,3,4
S01008887,Owned: Total,308,199,162,26,136,37,0,109,104,0,1,1,3
S01008887,Owned: Owned outright,171,66,54,13,41,12,0,105,102,0,0,0,3
S01008887,Owned: Owned with a mortgage or loan or shared ownership,137,133,108,13,95,25,0,4,2,0,1,1,0
S01008887,Rented or living rent free: Total,50,35,26,3,23,7,2,15,7,3,2,2,1
S01008887,Rented or living rent free: Social rented,8,5,3,2,1,1,1,3,1,0,1,1,0
S01008887,Rented or living rent free: Private rented or living rent free,42,30,23,1,22,6,1,12,6,3,1,1,1
S01008888,All HRPs aged 16 and over,373,292,242,20,222,36,14,81,62,11,2,3,3
S01008888,Owned: Total,238,175,142,14,128,23,10,63,60,0,0,0,3
S01008888,Owned: Owned outright,105,48,38,8,30,9,1,57,56,0,0,0,1
S01008888,Owned: Owned with a mortgage or loan or shared ownership,133,127,104,6,98,14,9,6,4,0,0,0,2
S01008888,Rented or living rent free: Total,135,117,100,6,94,13,4,18,2,11,2,3,0
S01008888,Rented or living rent free: Social rented,4,2,2,1,1,0,0,2,0,0,0,2,0
S01008888,Rented or living rent free: Private rented or living rent free,131,115,98,5,93,13,4,16,2,11,2,1,0
S01008889,All HRPs aged 16 and over,267,196,152,20,132,40,4,71,62,0,6,1,2
S01008889,Owned: Total,232,171,134,15,119,34,3,61,60,0,1,0,0
S01008889,Owned: Owned outright,95,42,36,11,25,6,0,53,52,0,1,0,0
S01008889,Owned: Owned with a mortgage or loan or shared ownership,137,129,98,4,94,28,3,8,8,0,0,0,0
S01008889,Rented or living rent free: Total,35,25,18,5,13,6,1,10,2,0,5,1,2
S01008889,Rented or living rent free: Social rented,4,3,3,2,1,0,0,1,1,0,0,0,0
S01008889,Rented or living rent free: Private rented or living rent free,31,22,15,3,12,6,1,9,1,0,5,1,2
S01008890,All HRPs aged 16 and over,308,191,150,19,131,37,4,117,111,1,0,4,1
S01008890,Owned: Total,279,170,135,17,118,35,0,109,107,1,0,0,1
S01008890,Owned: Owned outright,157,55,43,13,30,12,0,102,101,1,0,0,0
S01008890,Owned: Owned with a mortgage or loan or shared ownership,122,115,92,4,88,23,0,7,6,0,0,0,1
S01008890,Rented or living rent free: Total,29,21,15,2,13,2,4,8,4,0,0,4,0
S01008890,Rented or living rent free: Social rented,16,11,7,2,5,1,3,5,2,0,0,3,0
S01008890,Rented or living rent free: Private rented or living rent free,13,10,8,0,8,1,1,3,2,0,0,1,0
S01008891,All HRPs aged 16 and over,329,208,165,23,142,42,1,121,118,2,1,0,0
S01008891,Owned: Total,318,201,160,22,138,40,1,117,116,0,1,0,0
S01008891,Owned: Owned outright,194,84,61,16,45,22,1,110,109,0,1,0,0
S01008891,Owned: Owned with a mortgage or loan or shared ownership,124,117,99,6,93,18,0,7,7,0,0,0,0
S01008891,Rented or living rent free: Total,11,7,5,1,4,2,0,4,2,2,0,0,0
S01008891,Rented or living rent free: Social rented,0,0,0,0,0,0,0,0,0,0,0,0,0
S01008891,Rented or living rent free: Private rented or living rent free,11,7,5,1,4,2,0,4,2,2,0,0,0
S01008892,All HRPs aged 16 and over,533,307,249,32,217,46,12,226,204,3,4,10,5
S01008892,Owned: Total,374,214,177,20,157,37,0,160,154,1,2,0,3
S01008892,Owned: Owned outright,220,75,54,12,42,21,0,145,141,0,1,0,3
S01008892,Owned: Owned with a mortgage or loan or shared ownership,154,139,123,8,115,16,0,15,13,1,1,0,0
S01008892,Rented or living rent free: Total,159,93,72,12,60,9,12,66,50,2,2,10,2
S01008892,Rented or living rent free: Social rented,66,21,12,4,8,1,8,45,35,0,1,7,2
S01008892,Rented or living rent free: Private rented or living rent free,93,72,60,8,52,8,4,21,15,2,1,3,0
S01008893,All HRPs aged 16 and over,353,239,183,18,165,52,4,114,106,3,0,4,1
S01008893,Owned: Total,335,225,172,16,156,52,1,110,106,1,0,2,1
S01008893,Owned: Owned outright,171,70,50,14,36,19,1,101,98,1,0,1,1
S01008893,Owned: Owned with a mortgage or loan or shared ownership,164,155,122,2,120,33,0,9,8,0,0,1,0
S01008893,Rented or living rent free: Total,18,14,11,2,9,0,3,4,0,2,0,2,0
S01008893,Rented or living rent free: Social rented,4,2,0,0,0,0,2,2,0,0,0,2,0
S01008893,Rented or living rent free: Private rented or living rent free,14,12,11,2,9,0,1,2,0,2,0,0,0
S01008894,All HRPs aged 16 and over,337,223,160,14,146,59,4,114,107,0,3,1,3
S01008894,Owned: Total,317,206,150,13,137,55,1,111,107,0,1,0,3
S01008894,Owned: Owned outright,180,76,51,9,42,24,1,104,102,0,0,0,2
S01008894,Owned: Owned with a mortgage or loan or shared ownership,137,130,99,4,95,31,0,7,5,0,1,0,1
S01008894,Rented or living rent free: Total,20,17,10,1,9,4,3,3,0,0,2,1,0
S01008894,Rented or living rent free: Social rented,6,4,2,0,2,0,2,2,0,0,1,1,0
S01008894,Rented or living rent free: Private rented or living rent free,14,13,8,1,7,4,1,1,0,0,1,0,0
S01008895,All HRPs aged 16 and over,301,182,137,17,120,45,0,119,113,0,3,3,0
S01008895,Owned: Total,282,164,122,15,107,42,0,118,112,0,3,3,0
S01008895,Owned: Owned outright,162,54,38,9,29,16,0,108,104,0,2,2,0
S01008895,Owned: Owned with a mortgage or loan or shared ownership,120,110,84,6,78,26,0,10,8,0,1,1,0
S01008895,Rented or living rent free: Total,19,18,15,2,13,3,0,1,1,0,0,0,0
S01008895,Rented or living rent free: Social rented,2,2,2,0,2,0,0,0,0,0,0,0,0
S01008895,Rented or living rent free: Private rented or living rent free,17,16,13,2,11,3,0,1,1,0,0,0,0
S01008896,All HRPs aged 16 and over,208,149,127,9,118,22,0,59,52,1,4,1,1
S01008896,Owned: Total,181,130,109,7,102,21,0,51,50,0,1,0,0
S01008896,Owned: Owned outright,82,34,28,3,25,6,0,48,48,0,0,0,0
S01008896,Owned: Owned with a mortgage or loan or shared ownership,99,96,81,4,77,15,0,3,2,0,1,0,0
S01008896,Rented or living rent free: Total,27,19,18,2,16,1,0,8,2,1,3,1,1
S01008896,Rented or living rent free: Social rented,0,0,0,0,0,0,0,0,0,0,0,0,0
S01008896,Rented or living rent free: Private rented or living rent free,27,19,18,2,16,1,0,8,2,1,3,1,1
S01008897,All HRPs aged 16 and over,304,187,146,19,127,36,5,117,108,0,5,0,4
S01008897,Owned: Total,277,165,128,18,110,33,4,112,105,0,4,0,3
S01008897,Owned: Owned outright,155,58,41,11,30,14,3,97,95,0,0,0,2
S01008897,Owned: Owned with a mortgage or loan or shared ownership,122,107,87,7,80,19,1,15,10,0,4,0,1
S01008897,Rented or living rent free: Total,27,22,18,1,17,3,1,5,3,0,1,0,1
S01008897,Rented or living rent free: Social rented,4,3,1,0,1,1,1,1,1,0,0,0,0
S01008897,Rented or living rent free: Private rented or living rent free,23,19,17,1,16,2,0,4,2,0,1,0,1
S01008898,All HRPs aged 16 and over,331,210,158,18,140,50,2,121,118,0,2,0,1
S01008898,Owned: Total,314,198,148,17,131,50,0,116,114,0,1,0,1
S01008898,Owned: Owned outright,176,68,46,8,38,22,0,108,106,0,1,0,1
S01008898,Owned: Owned with a mortgage or loan or shared ownership,138,130,102,9,93,28,0,8,8,0,0,0,0
S01008898,Rented or living rent free: Total,17,12,10,1,9,0,2,5,4,0,1,0,0
S01008898,Rented or living rent free: Social rented,1,1,1,0,1,0,0,0,0,0,0,0,0
S01008898,Rented or living rent free: Private rented or living rent free,16,11,9,1,8,0,2,5,4,0,1,0,0
S01008899,All HRPs aged 16 and over,389,208,161,46,115,24,23,181,112,8,32,24,5
S01008899,Owned: Total,187,116,96,23,73,15,5,71,67,0,3,1,0
S01008899,Owned: Owned outright,89,31,22,11,11,5,4,58,57,0,1,0,0
S01008899,Owned: Owned with a mortgage or loan or shared ownership,98,85,74,12,62,10,1,13,10,0,2,1,0
S01008899,Rented or living rent free: Total,202,92,65,23,42,9,18,110,45,8,29,23,5
S01008899,Rented or living rent free: Social rented,169,76,52,15,37,9,15,93,42,6,21,19,5
S01008899,Rented or living rent free: Private rented or living rent free,33,16,13,8,5,0,3,17,3,2,8,4,0
S01008900,All HRPs aged 16 and over,415,259,224,40,184,24,11,156,113,0,19,19,5
S01008900,Owned: Total,252,172,153,22,131,19,0,80,72,0,1,3,4
S01008900,Owned: Owned outright,113,44,35,7,28,9,0,69,65,0,0,3,1
S01008900,Owned: Owned with a mortgage or loan or shared ownership,139,128,118,15,103,10,0,11,7,0,1,0,3
S01008900,Rented or living rent free: Total,163,87,71,18,53,5,11,76,41,0,18,16,1
S01008900,Rented or living rent free: Social rented,102,48,39,12,27,0,9,54,35,0,6,13,0
S01008900,Rented or living rent free: Private rented or living rent free,61,39,32,6,26,5,2,22,6,0,12,3,1
S01008901,All HRPs aged 16 and over,374,224,185,36,149,29,10,150,106,7,17,15,5
S01008901,Owned: Total,226,152,130,20,110,21,1,74,66,0,2,4,2
S01008901,Owned: Owned outright,93,34,30,9,21,4,0,59,53,0,2,2,2
S01008901,Owned: Owned with a mortgage or loan or shared ownership,133,118,100,11,89,17,1,15,13,0,0,2,0
S01008901,Rented or living rent free: Total,148,72,55,16,39,8,9,76,40,7,15,11,3
S01008901,Rented or living rent free: Social rented,102,41,35,11,24,2,4,61,37,2,12,9,1
S01008901,Rented or living rent free: Private rented or living rent free,46,31,20,5,15,6,5,15,3,5,3,2,2
S01008902,All HRPs aged 16 and over,485,289,244,58,186,30,15,196,116,10,24,35,11
S01008902,Owned: Total,243,160,140,19,121,19,1,83,75,3,0,4,1
S01008902,Owned: Owned outright,92,24,21,5,16,2,1,68,63,1,0,3,1
S01008902,Owned: Owned with a mortgage or loan or shared ownership,151,136,119,14,105,17,0,15,12,2,0,1,0
S01008902,Rented or living rent free: Total,242,129,104,39,65,11,14,113,41,7,24,31,10
S01008902,Rented or living rent free: Social rented,164,80,65,26,39,7,8,84,33,5,12,27,7
S01008902,Rented or living rent free: Private rented or living rent free,78,49,39,13,26,4,6,29,8,2,12,4,3
S01008903,All HRPs aged 16 and over,463,255,226,59,167,23,6,208,169,2,18,16,3
S01008903,Owned: Total,300,193,171,38,133,19,3,107,97,2,2,4,2
S01008903,Owned: Owned outright,143,55,46,18,28,7,2,88,84,2,1,1,0
S01008903,Owned: Owned with a mortgage or loan or shared ownership,157,138,125,20,105,12,1,19,13,0,1,3,2
S01008903,Rented or living rent free: Total,163,62,55,21,34,4,3,101,72,0,16,12,1
S01008903,Rented or living rent free: Social rented,132,39,36,16,20,0,3,93,67,0,13,12,1
S01008903,Rented or living rent free: Private rented or living rent free,31,23,19,5,14,4,0,8,5,0,3,0,0
S01008904,All HRPs aged 16 and over,431,281,241,55,186,19,21,150,67,15,34,25,9
S01008904,Owned: Total,193,144,126,22,104,13,5,49,42,1,3,2,1
S01008904,Owned: Owned outright,75,37,31,8,23,2,4,38,35,1,1,1,0
S01008904,Owned: Owned with a mortgage or loan or shared ownership,118,107,95,14,81,11,1,11,7,0,2,1,1
S01008904,Rented or living rent free: Total,238,137,115,33,82,6,16,101,25,14,31,23,8
S01008904,Rented or living rent free: Social rented,125,67,52,22,30,2,13,58,24,0,13,18,3
S01008904,Rented or living rent free: Private rented or living rent free,113,70,63,11,52,4,3,43,1,14,18,5,5
S01008905,All HRPs aged 16 and over,510,303,247,68,179,17,39,207,81,18,48,42,18
S01008905,Owned: Total,170,127,113,20,93,12,2,43,36,1,1,4,1
S01008905,Owned: Owned outright,52,21,19,9,10,2,0,31,28,0,0,2,1
S01008905,Owned: Owned with a mortgage or loan or shared ownership,118,106,94,11,83,10,2,12,8,1,1,2,0
S01008905,Rented or living rent free: Total,340,176,134,48,86,5,37,164,45,17,47,38,17
S01008905,Rented or living rent free: Social rented,244,111,84,32,52,3,24,133,45,5,33,36,14
S01008905,Rented or living rent free: Private rented or living rent free,96,65,50,16,34,2,13,31,0,12,14,2,3
S01008906,All HRPs aged 16 and over,386,259,197,41,156,21,41,127,30,9,34,38,16
S01008906,Owned: Total,104,83,75,5,70,8,0,21,12,4,2,2,1
S01008906,Owned: Owned outright,20,10,8,0,8,2,0,10,9,0,0,0,1
S01008906,Owned: Owned with a mortgage or loan or shared ownership,84,73,67,5,62,6,0,11,3,4,2,2,0
S01008906,Rented or living rent free: Total,282,176,122,36,86,13,41,106,18,5,32,36,15
S01008906,Rented or living rent free: Social rented,213,129,86,23,63,8,35,84,18,3,19,31,13
S01008906,Rented or living rent free: Private rented or living rent free,69,47,36,13,23,5,6,22,0,2,13,5,2
S01008907,All HRPs aged 16 and over,249,129,98,32,66,15,16,120,41,7,41,25,6
S01008907,Owned: Total,30,18,14,2,12,4,0,12,10,0,1,0,1
S01008907,Owned: Owned outright,13,6,4,1,3,2,0,7,7,0,0,0,0
S01008907,Owned: Owned with a mortgage or loan or shared ownership,17,12,10,1,9,2,0,5,3,0,1,0,1
S01008907,Rented or living rent free: Total,219,111,84,30,54,11,16,108,31,7,40,25,5
S01008907,Rented or living rent free: Social rented,201,101,77,28,49,11,13,100,31,7,35,23,4
S01008907,Rented or living rent free: Private rented or living rent free,18,10,7,2,5,0,3,8,0,0,5,2,1
S01008908,All HRPs aged 16 and over,421,251,204,44,160,27,20,170,79,17,36,32,6
S01008908,Owned: Total,184,124,111,19,92,13,0,60,52,2,2,4,0
S01008908,Owned: Owned outright,74,27,25,6,19,2,0,47,43,0,1,3,0
S01008908,Owned: Owned with a mortgage or loan or shared ownership,110,97,86,13,73,11,0,13,9,2,1,1,0
S01008908,Rented or living rent free: Total,237,127,93,25,68,14,20,110,27,15,34,28,6
S01008908,Rented or living rent free: Social rented,148,74,48,16,32,9,17,74,19,10,17,22,6
S01008908,Rented or living rent free: Private rented or living rent free,89,53,45,9,36,5,3,36,8,5,17,6,0
S01008909,All HRPs aged 16 and over,347,245,206,44,162,24,15,102,73,1,15,8,5
S01008909,Owned: Total,241,182,161,23,138,18,3,59,56,0,0,1,2
S01008909,Owned: Owned outright,84,33,31,10,21,2,0,51,50,0,0,0,1
S01008909,Owned: Owned with a mortgage or loan or shared ownership,157,149,130,13,117,16,3,8,6,0,0,1,1
S01008909,Rented or living rent free: Total,106,63,45,21,24,6,12,43,17,1,15,7,3
S01008909,Rented or living rent free: Social rented,15,9,4,1,3,1,4,6,2,1,2,1,0
S01008909,Rented or living rent free: Private rented or living rent free,91,54,41,20,21,5,8,37,15,0,13,6,3
S01008910,All HRPs aged 16 and over,211,152,134,21,113,15,3,59,42,3,5,5,4
S01008910,Owned: Total,144,108,96,10,86,11,1,36,32,1,0,2,1
S01008910,Owned: Owned outright,51,21,17,3,14,3,1,30,29,1,0,0,0
S01008910,Owned: Owned with a mortgage or loan or shared ownership,93,87,79,7,72,8,0,6,3,0,0,2,1
S01008910,Rented or living rent free: Total,67,44,38,11,27,4,2,23,10,2,5,3,3
S01008910,Rented or living rent free: Social rented,5,2,1,1,0,1,0,3,2,0,0,1,0
S01008910,Rented or living rent free: Private rented or living rent free,62,42,37,10,27,3,2,20,8,2,5,2,3
S01008911,All HRPs aged 16 and over,432,378,310,33,277,55,13,54,24,17,10,3,0
S01008911,Owned: Total,216,192,162,8,154,25,5,24,19,4,1,0,0
S01008911,Owned: Owned outright,54,33,26,3,23,3,4,21,16,4,1,0,0
S01008911,Owned: Owned with a mortgage or loan or shared ownership,162,159,136,5,131,22,1,3,3,0,0,0,0
S01008911,Rented or living rent free: Total,216,186,148,25,123,30,8,30,5,13,9,3,0
S01008911,Rented or living rent free: Social rented,7,4,3,0,3,1,0,3,2,0,1,0,0
S01008911,Rented or living rent free: Private rented or living rent free,209,182,145,25,120,29,8,27,3,13,8,3,0
S01008912,All HRPs aged 16 and over,333,235,187,22,165,42,6,98,89,1,3,3,2
S01008912,Owned: Total,278,199,162,21,141,35,2,79,78,0,0,1,0
S01008912,Owned: Owned outright,123,54,41,8,33,11,2,69,69,0,0,0,0
S01008912,Owned: Owned with a mortgage or loan or shared ownership,155,145,121,13,108,24,0,10,9,0,0,1,0
S01008912,Rented or living rent free: Total,55,36,25,1,24,7,4,19,11,1,3,2,2
S01008912,Rented or living rent free: Social rented,14,4,4,0,4,0,0,10,9,0,0,0,1
S01008912,Rented or living rent free: Private rented or living rent free,41,32,21,1,20,7,4,9,2,1,3,2,1
S01008913,All HRPs aged 16 and over,272,215,184,20,164,22,9,57,34,1,13,5,4
S01008913,Owned: Total,192,165,143,8,135,19,3,27,23,1,0,2,1
S01008913,Owned: Owned outright,47,25,20,0,20,3,2,22,20,1,0,1,0
S01008913,Owned: Owned with a mortgage or loan or shared ownership,145,140,123,8,115,16,1,5,3,0,0,1,1
S01008913,Rented or living rent free: Total,80,50,41,12,29,3,6,30,11,0,13,3,3
S01008913,Rented or living rent free: Social rented,3,2,2,2,0,0,0,1,0,0,1,0,0
S01008913,Rented or living rent free: Private rented or living rent free,77,48,39,10,29,3,6,29,11,0,12,3,3
S01008914,All HRPs aged 16 and over,398,236,198,35,163,34,4,162,132,4,3,19,4
S01008914,Owned: Total,298,194,164,27,137,27,3,104,98,1,0,4,1
S01008914,Owned: Owned outright,142,55,49,14,35,4,2,87,86,0,0,0,1
S01008914,Owned: Owned with a mortgage or loan or shared ownership,156,139,115,13,102,23,1,17,12,1,0,4,0
S01008914,Rented or living rent free: Total,100,42,34,8,26,7,1,58,34,3,3,15,3
S01008914,Rented or living rent free: Social rented,63,17,14,4,10,2,1,46,29,3,1,11,2
S01008914,Rented or living rent free: Private rented or living rent free,37,25,20,4,16,5,0,12,5,0,2,4,1
S01008915,All HRPs aged 16 and over,236,154,113,15,98,36,5,82,71,3,1,5,2
S01008915,Owned: Total,195,126,93,11,82,32,1,69,64,1,1,1,2
S01008915,Owned: Owned outright,103,40,26,6,20,13,1,63,61,0,0,0,2
S01008915,Owned: Owned with a mortgage or loan or shared ownership,92,86,67,5,62,19,0,6,3,1,1,1,0
S01008915,Rented or living rent free: Total,41,28,20,4,16,4,4,13,7,2,0,4,0
S01008915,Rented or living rent free: Social rented,18,10,7,1,6,1,2,8,6,0,0,2,0
S01008915,Rented or living rent free: Private rented or living rent free,23,18,13,3,10,3,2,5,1,2,0,2,0
S01008916,All HRPs aged 16 and over,593,285,224,58,166,28,33,308,211,1,26,58,12
S01008916,Owned: Total,217,112,100,19,81,11,1,105,94,1,2,2,6
S01008916,Owned: Owned outright,116,28,24,9,15,3,1,88,82,0,2,1,3
S01008916,Owned: Owned with a mortgage or loan or shared ownership,101,84,76,10,66,8,0,17,12,1,0,1,3
S01008916,Rented or living rent free: Total,376,173,124,39,85,17,32,203,117,0,24,56,6
S01008916,Rented or living rent free: Social rented,306,129,89,31,58,17,23,177,105,0,14,53,5
S01008916,Rented or living rent free: Private rented or living rent free,70,44,35,8,27,0,9,26,12,0,10,3,1
S01008917,All HRPs aged 16 and over,379,228,173,58,115,24,31,151,57,2,24,57,11
S01008917,Owned: Total,91,70,61,7,54,8,1,21,17,0,0,2,2
S01008917,Owned: Owned outright,29,11,10,3,7,1,0,18,16,0,0,1,1
S01008917,Owned: Owned with a mortgage or loan or shared ownership,62,59,51,4,47,7,1,3,1,0,0,1,1
S01008917,Rented or living rent free: Total,288,158,112,51,61,16,30,130,40,2,24,55,9
S01008917,Rented or living rent free: Social rented,254,137,96,43,53,12,29,117,39,2,18,50,8
S01008917,Rented or living rent free: Private rented or living rent free,34,21,16,8,8,4,1,13,1,0,6,5,1
S01008918,All HRPs aged 16 and over,293,186,131,48,83,16,39,107,29,6,29,29,14
S01008918,Owned: Total,24,16,13,1,12,0,3,8,6,0,0,1,1
S01008918,Owned: Owned outright,9,3,3,0,3,0,0,6,5,0,0,0,1
S01008918,Owned: Owned with a mortgage or loan or shared ownership,15,13,10,1,9,0,3,2,1,0,0,1,0
S01008918,Rented or living rent free: Total,269,170,118,47,71,16,36,99,23,6,29,28,13
S01008918,Rented or living rent free: Social rented,248,152,101,43,58,16,35,96,22,5,29,28,12
S01008918,Rented or living rent free: Private rented or living rent free,21,18,17,4,13,0,1,3,1,1,0,0,1
S01008919,All HRPs aged 16 and over,264,156,117,45,72,10,29,108,29,3,20,44,12
S01008919,Owned: Total,32,21,19,3,16,1,1,11,7,0,1,2,1
S01008919,Owned: Owned outright,11,5,5,1,4,0,0,6,5,0,0,1,0
S01008919,Owned: Owned with a mortgage or loan or shared ownership,21,16,14,2,12,1,1,5,2,0,1,1,1
S01008919,Rented or living rent free: Total,232,135,98,42,56,9,28,97,22,3,19,42,11
S01008919,Rented or living rent free: Social rented,213,118,84,36,48,8,26,95,22,3,18,41,11
S01008919,Rented or living rent free: Private rented or living rent free,19,17,14,6,8,1,2,2,0,0,1,1,0
S01008920,All HRPs aged 16 and over,586,505,422,45,377,60,23,81,29,17,6,20,9
S01008920,Owned: Total,264,239,201,15,186,35,3,25,23,1,0,0,1
S01008920,Owned: Owned outright,48,28,19,6,13,9,0,20,20,0,0,0,0
S01008920,Owned: Owned with a mortgage or loan or shared ownership,216,211,182,9,173,26,3,5,3,1,0,0,1
S01008920,Rented or living rent free: Total,322,266,221,30,191,25,20,56,6,16,6,20,8
S01008920,Rented or living rent free: Social rented,100,72,54,9,45,5,13,28,3,2,2,14,7
S01008920,Rented or living rent free: Private rented or living rent free,222,194,167,21,146,20,7,28,3,14,4,6,1
S01008921,All HRPs aged 16 and over,375,210,157,31,126,15,38,165,82,1,20,47,15
S01008921,Owned: Total,82,52,39,6,33,9,4,30,28,0,0,0,2
S01008921,Owned: Owned outright,39,14,10,2,8,2,2,25,24,0,0,0,1
S01008921,Owned: Owned with a mortgage or loan or shared ownership,43,38,29,4,25,7,2,5,4,0,0,0,1
S01008921,Rented or living rent free: Total,293,158,118,25,93,6,34,135,54,1,20,47,13
S01008921,Rented or living rent free: Social rented,263,135,103,23,80,4,28,128,54,1,14,46,13
S01008921,Rented or living rent free: Private rented or living rent free,30,23,15,2,13,2,6,7,0,0,6,1,0
S01008922,All HRPs aged 16 and over,400,215,176,34,142,20,19,185,111,6,16,34,18
S01008922,Owned: Total,178,130,117,13,104,12,1,48,42,0,1,2,3
S01008922,Owned: Owned outright,68,27,25,3,22,2,0,41,38,0,0,0,3
S01008922,Owned: Owned with a mortgage or loan or shared ownership,110,103,92,10,82,10,1,7,4,0,1,2,0
S01008922,Rented or living rent free: Total,222,85,59,21,38,8,18,137,69,6,15,32,15
S01008922,Rented or living rent free: Social rented,140,39,24,15,9,1,14,101,57,4,7,21,12
S01008922,Rented or living rent free: Private rented or living rent free,82,46,35,6,29,7,4,36,12,2,8,11,3
S01008923,All HRPs aged 16 and over,394,226,180,54,126,24,22,168,111,2,17,25,13
S01008923,Owned: Total,147,99,88,23,65,11,0,48,44,0,1,2,1
S01008923,Owned: Owned outright,64,20,17,6,11,3,0,44,41,0,0,2,1
S01008923,Owned: Owned with a mortgage or loan or shared ownership,83,79,71,17,54,8,0,4,3,0,1,0,0
S01008923,Rented or living rent free: Total,247,127,92,31,61,13,22,120,67,2,16,23,12
S01008923,Rented or living rent free: Social rented,183,78,53,12,41,4,21,105,57,1,13,22,12
S01008923,Rented or living rent free: Private rented or living rent free,64,49,39,19,20,9,1,15,10,1,3,1,0
S01008924,All HRPs aged 16 and over,372,234,200,67,133,12,22,138,60,2,41,30,5
S01008924,Owned: Total,65,56,45,3,42,8,3,9,5,1,2,0,1
S01008924,Owned: Owned outright,15,9,8,1,7,0,1,6,5,1,0,0,0
S01008924,Owned: Owned with a mortgage or loan or shared ownership,50,47,37,2,35,8,2,3,0,0,2,0,1
S01008924,Rented or living rent free: Total,307,178,155,64,91,4,19,129,55,1,39,30,4
S01008924,Rented or living rent free: Social rented,266,153,133,55,78,3,17,113,55,0,26,28,4
S01008924,Rented or living rent free: Private rented or living rent free,41,25,22,9,13,1,2,16,0,1,13,2,0
S01008925,All HRPs aged 16 and over,266,211,180,33,147,18,13,55,17,2,26,9,1
S01008925,Owned: Total,158,142,130,16,114,12,0,16,14,0,1,1,0
S01008925,Owned: Owned outright,40,28,24,6,18,4,0,12,12,0,0,0,0
S01008925,Owned: Owned with a mortgage or loan or shared ownership,118,114,106,10,96,8,0,4,2,0,1,1,0
S01008925,Rented or living rent free: Total,108,69,50,17,33,6,13,39,3,2,25,8,1
S01008925,Rented or living rent free: Social rented,24,10,8,3,5,1,1,14,3,1,7,3,0
S01008925,Rented or living rent free: Private rented or living rent free,84,59,42,14,28,5,12,25,0,1,18,5,1
S01008926,All HRPs aged 16 and over,242,191,163,19,144,24,4,51,30,0,8,10,3
S01008926,Owned: Total,155,131,110,6,104,20,1,24,21,0,0,2,1
S01008926,Owned: Owned outright,46,27,23,3,20,4,0,19,18,0,0,1,0
S01008926,Owned: Owned with a mortgage or loan or shared ownership,109,104,87,3,84,16,1,5,3,0,0,1,1
S01008926,Rented or living rent free: Total,87,60,53,13,40,4,3,27,9,0,8,8,2
S01008926,Rented or living rent free: Social rented,51,27,25,9,16,0,2,24,8,0,7,8,1
S01008926,Rented or living rent free: Private rented or living rent free,36,33,28,4,24,4,1,3,1,0,1,0,1
S01008927,All HRPs aged 16 and over,416,342,299,49,250,26,17,74,23,7,20,17,7
S01008927,Owned: Total,199,186,170,12,158,15,1,13,9,1,2,0,1
S01008927,Owned: Owned outright,14,10,9,1,8,1,0,4,3,1,0,0,0
S01008927,Owned: Owned with a mortgage or loan or shared ownership,185,176,161,11,150,14,1,9,6,0,2,0,1
S01008927,Rented or living rent free: Total,217,156,129,37,92,11,16,61,14,6,18,17,6
S01008927,Rented or living rent free: Social rented,97,66,56,20,36,3,7,31,13,1,1,14,2
S01008927,Rented or living rent free: Private rented or living rent free,120,90,73,17,56,8,9,30,1,5,17,3,4
S01008928,All HRPs aged 16 and over,298,186,150,23,127,24,12,112,86,3,8,11,4
S01008928,Owned: Total,117,95,77,3,74,15,3,22,21,0,0,1,0
S01008928,Owned: Owned outright,35,15,10,1,9,3,2,20,19,0,0,1,0
S01008928,Owned: Owned with a mortgage or loan or shared ownership,82,80,67,2,65,12,1,2,2,0,0,0,0
S01008928,Rented or living rent free: Total,181,91,73,20,53,9,9,90,65,3,8,10,4
S01008928,Rented or living rent free: Social rented,124,52,38,13,25,7,7,72,51,3,6,8,4
S01008928,Rented or living rent free: Private rented or living rent free,57,39,35,7,28,2,2,18,14,0,2,2,0
S01008929,All HRPs aged 16 and over,475,261,171,54,117,5,85,214,47,6,41,82,38
S01008929,Owned: Total,31,21,18,3,15,2,1,10,8,1,0,1,0
S01008929,Owned: Owned outright,14,6,5,1,4,0,1,8,7,1,0,0,0
S01008929,Owned: Owned with a mortgage or loan or shared ownership,17,15,13,2,11,2,0,2,1,0,0,1,0
S01008929,Rented or living rent free: Total,444,240,153,51,102,3,84,204,39,5,41,81,38
S01008929,Rented or living rent free: Social rented,424,231,144,47,97,3,84,193,39,1,36,79,38
S01008929,Rented or living rent free: Private rented or living rent free,20,9,9,4,5,0,0,11,0,4,5,2,0
S01008930,All HRPs aged 16 and over,427,241,175,63,112,18,48,186,88,3,33,45,17
S01008930,Owned: Total,55,36,29,5,24,6,1,19,15,0,0,4,0
S01008930,Owned: Owned outright,23,8,7,2,5,1,0,15,11,0,0,4,0
S01008930,Owned: Owned with a mortgage or loan or shared ownership,32,28,22,3,19,5,1,4,4,0,0,0,0
S01008930,Rented or living rent free: Total,372,205,146,58,88,12,47,167,73,3,33,41,17
S01008930,Rented or living rent free: Social rented,355,198,142,56,86,9,47,157,71,3,27,39,17
S01008930,Rented or living rent free: Private rented or living rent free,17,7,4,2,2,3,0,10,2,0,6,2,0
S01008931,All HRPs aged 16 and over,339,203,178,51,127,7,18,136,76,1,16,29,14
S01008931,Owned: Total,86,51,49,6,43,1,1,35,31,0,1,2,1
S01008931,Owned: Owned outright,44,14,13,1,12,1,0,30,29,0,0,1,0
S01008931,Owned: Owned with a mortgage or loan or shared ownership,42,37,36,5,31,0,1,5,2,0,1,1,1
S01008931,Rented or living rent free: Total,253,152,129,45,84,6,17,101,45,1,15,27,13
S01008931,Rented or living rent free: Social rented,235,140,118,38,80,5,17,95,43,1,12,26,13
S01008931,Rented or living rent free: Private rented or living rent free,18,12,11,7,4,1,0,6,2,0,3,1,0
S01008932,All HRPs aged 16 and over,404,310,259,53,206,35,16,94,52,6,14,12,10
S01008932,Owned: Total,187,156,138,6,132,18,0,31,30,0,0,1,0
S01008932,Owned: Owned outright,41,15,13,4,9,2,0,26,25,0,0,1,0
S01008932,Owned: Owned with a mortgage or loan or shared ownership,146,141,125,2,123,16,0,5,5,0,0,0,0
S01008932,Rented or living rent free: Total,217,154,121,47,74,17,16,63,22,6,14,11,10
S01008932,Rented or living rent free: Social rented,81,48,33,14,19,8,7,33,17,1,5,7,3
S01008932,Rented or living rent free: Private rented or living rent free,136,106,88,33,55,9,9,30,5,5,9,4,7
S01008933,All HRPs aged 16 and over,289,202,155,44,111,12,35,87,29,4,20,24,10
S01008933,Owned: Total,69,65,58,8,50,4,3,4,4,0,0,0,0
S01008933,Owned: Owned outright,12,8,4,1,3,1,3,4,4,0,0,0,0
S01008933,Owned: Owned with a mortgage or loan or shared ownership,57,57,54,7,47,3,0,0,0,0,0,0,0
S01008933,Rented or living rent free: Total,220,137,97,36,61,8,32,83,25,4,20,24,10
S01008933,Rented or living rent free: Social rented,201,122,85,33,52,7,30,79,25,3,19,22,10
S01008933,Rented or living rent free: Private rented or living rent free,19,15,12,3,9,1,2,4,0,1,1,2,0
S01008934,All HRPs aged 16 and over,354,234,186,39,147,28,20,120,67,3,24,21,5
S01008934,Owned: Total,175,132,114,13,101,13,5,43,38,1,1,3,0
S01008934,Owned: Owned outright,61,25,16,3,13,4,5,36,33,1,0,2,0
S01008934,Owned: Owned with a mortgage or loan or shared ownership,114,107,98,10,88,9,0,7,5,0,1,1,0
S01008934,Rented or living rent free: Total,179,102,72,26,46,15,15,77,29,2,23,18,5
S01008934,Rented or living rent free: Social rented,115,63,45,18,27,6,12,52,24,1,10,15,2
S01008934,Rented or living rent free: Private rented or living rent free,64,39,27,8,19,9,3,25,5,1,13,3,3
S01008935,All HRPs aged 16 and over,377,224,185,27,158,32,7,153,138,4,4,4,3
S01008935,Owned: Total,340,202,168,24,144,30,4,138,136,0,0,2,0
S01008935,Owned: Owned outright,204,74,54,13,41,17,3,130,130,0,0,0,0
S01008935,Owned: Owned with a mortgage or loan or shared ownership,136,128,114,11,103,13,1,8,6,0,0,2,0
S01008935,Rented or living rent free: Total,37,22,17,3,14,2,3,15,2,4,4,2,3
S01008935,Rented or living rent free: Social rented,10,5,3,1,2,2,0,5,1,1,3,0,0
S01008935,Rented or living rent free: Private rented or living rent free,27,17,14,2,12,0,3,10,1,3,1,2,3
S01008936,All HRPs aged 16 and over,157,104,82,6,76,22,0,53,50,0,1,1,1
S01008936,Owned: Total,150,99,78,6,72,21,0,51,49,0,0,1,1
S01008936,Owned: Owned outright,71,25,20,3,17,5,0,46,45,0,0,0,1
S01008936,Owned: Owned with a mortgage or loan or shared ownership,79,74,58,3,55,16,0,5,4,0,0,1,0
S01008936,Rented or living rent free: Total,7,5,4,0,4,1,0,2,1,0,1,0,0
S01008936,Rented or living rent free: Social rented,1,1,1,0,1,0,0,0,0,0,0,0,0
S01008936,Rented or living rent free: Private rented or living rent free,6,4,3,0,3,1,0,2,1,0,1,0,0
S01008937,All HRPs aged 16 and over,424,253,204,39,165,42,7,171,148,2,5,12,4
S01008937,Owned: Total,343,197,155,30,125,37,5,146,136,2,1,5,2
S01008937,Owned: Owned outright,186,52,38,14,24,10,4,134,125,2,1,5,1
S01008937,Owned: Owned with a mortgage or loan or shared ownership,157,145,117,16,101,27,1,12,11,0,0,0,1
S01008937,Rented or living rent free: Total,81,56,49,9,40,5,2,25,12,0,4,7,2
S01008937,Rented or living rent free: Social rented,13,6,6,3,3,0,0,7,6,0,0,1,0
S01008937,Rented or living rent free: Private rented or living rent free,68,50,43,6,37,5,2,18,6,0,4,6,2
S01008938,All HRPs aged 16 and over,285,174,131,18,113,39,4,111,106,0,2,2,1
S01008938,Owned: Total,265,157,115,12,103,38,4,108,106,0,0,1,1
S01008938,Owned: Owned outright,138,38,28,8,20,9,1,100,99,0,0,0,1
S01008938,Owned: Owned with a mortgage or loan or shared ownership,127,119,87,4,83,29,3,8,7,0,0,1,0
S01008938,Rented or living rent free: Total,20,17,16,6,10,1,0,3,0,0,2,1,0
S01008938,Rented or living rent free: Social rented,3,3,2,1,1,1,0,0,0,0,0,0,0
S01008938,Rented or living rent free: Private rented or living rent free,17,14,14,5,9,0,0,3,0,0,2,1,0
S01008939,All HRPs aged 16 and over,323,187,147,24,123,33,7,136,126,0,3,5,2
S01008939,Owned: Total,295,171,136,21,115,31,4,124,119,0,0,3,2
S01008939,Owned: Owned outright,171,52,42,12,30,8,2,119,116,0,0,1,2
S01008939,Owned: Owned with a mortgage or loan or shared ownership,124,119,94,9,85,23,2,5,3,0,0,2,0
S01008939,Rented or living rent free: Total,28,16,11,3,8,2,3,12,7,0,3,2,0
S01008939,Rented or living rent free: Social rented,3,2,2,0,2,0,0,1,0,0,0,1,0
S01008939,Rented or living rent free: Private rented or living rent free,25,14,9,3,6,2,3,11,7,0,3,1,0
S01008940,All HRPs aged 16 and over,255,151,102,9,93,47,2,104,98,0,5,1,0
S01008940,Owned: Total,235,135,88,7,81,45,2,100,97,0,2,1,0
S01008940,Owned: Owned outright,158,61,36,2,34,23,2,97,95,0,2,0,0
S01008940,Owned: Owned with a mortgage or loan or shared ownership,77,74,52,5,47,22,0,3,2,0,0,1,0
S01008940,Rented or living rent free: Total,20,16,14,2,12,2,0,4,1,0,3,0,0
S01008940,Rented or living rent free: Social rented,0,0,0,0,0,0,0,0,0,0,0,0,0
S01008940,Rented or living rent free: Private rented or living rent free,20,16,14,2,12,2,0,4,1,0,3,0,0
S01008941,All HRPs aged 16 and over,350,224,167,22,145,54,3,126,118,1,3,1,3
S01008941,Owned: Total,297,188,139,18,121,49,0,109,105,1,1,0,2
S01008941,Owned: Owned outright,156,56,40,8,32,16,0,100,97,0,1,0,2
S01008941,Owned: Owned with a mortgage or loan or shared ownership,141,132,99,10,89,33,0,9,8,1,0,0,0
S01008941,Rented or living rent free: Total,53,36,28,4,24,5,3,17,13,0,2,1,1
S01008941,Rented or living rent free: Social rented,14,4,3,2,1,1,0,10,8,0,0,1,1
S01008941,Rented or living rent free: Private rented or living rent free,39,32,25,2,23,4,3,7,5,0,2,0,0
S01008942,All HRPs aged 16 and over,333,233,187,19,168,42,4,100,90,1,3,5,1
S01008942,Owned: Total,286,197,156,12,144,39,2,89,87,1,1,0,0
S01008942,Owned: Owned outright,136,54,42,5,37,11,1,82,80,1,1,0,0
S01008942,Owned: Owned with a mortgage or loan or shared ownership,150,143,114,7,107,28,1,7,7,0,0,0,0
S01008942,Rented or living rent free: Total,47,36,31,7,24,3,2,11,3,0,2,5,1
S01008942,Rented or living rent free: Social rented,2,0,0,0,0,0,0,2,0,0,0,2,0
S01008942,Rented or living rent free: Private rented or living rent free,45,36,31,7,24,3,2,9,3,0,2,3,1
S01008943,All HRPs aged 16 and over,340,192,127,15,112,59,6,148,142,1,3,2,0
S01008943,Owned: Total,329,186,124,15,109,58,4,143,138,0,3,2,0
S01008943,Owned: Owned outright,206,73,47,10,37,24,2,133,131,0,0,2,0
S01008943,Owned: Owned with a mortgage or loan or shared ownership,123,113,77,5,72,34,2,10,7,0,3,0,0
S01008943,Rented or living rent free: Total,11,6,3,0,3,1,2,5,4,1,0,0,0
S01008943,Rented or living rent free: Social rented,2,0,0,0,0,0,0,2,2,0,0,0,0
S01008943,Rented or living rent free: Private rented or living rent free,9,6,3,0,3,1,2,3,2,1,0,0,0
S01008944,All HRPs aged 16 and over,429,246,178,22,156,65,3,183,175,1,3,2,2
S01008944,Owned: Total,395,219,156,17,139,60,3,176,169,1,2,2,2
S01008944,Owned: Owned outright,244,85,57,12,45,26,2,159,156,0,0,1,2
S01008944,Owned: Owned with a mortgage or loan or shared ownership,151,134,99,5,94,34,1,17,13,1,2,1,0
S01008944,Rented or living rent free: Total,34,27,22,5,17,5,0,7,6,0,1,0,0
S01008944,Rented or living rent free: Social rented,2,2,1,0,1,1,0,0,0,0,0,0,0
S01008944,Rented or living rent free: Private rented or living rent free,32,25,21,5,16,4,0,7,6,0,1,0,0
S01008945,All HRPs aged 16 and over,299,207,149,17,132,57,1,92,85,2,2,2,1
S01008945,Owned: Total,284,198,145,17,128,52,1,86,82,1,1,2,0
S01008945,Owned: Owned outright,154,75,49,11,38,25,1,79,77,0,1,1,0
S01008945,Owned: Owned with a mortgage or loan or shared ownership,130,123,96,6,90,27,0,7,5,1,0,1,0
S01008945,Rented or living rent free: Total,15,9,4,0,4,5,0,6,3,1,1,0,1
S01008945,Rented or living rent free: Social rented,1,0,0,0,0,0,0,1,0,0,1,0,0
S01008945,Rented or living rent free: Private rented or living rent free,14,9,4,0,4,5,0,5,3,1,0,0,1
S01008946,All HRPs aged 16 and over,397,212,155,20,135,52,5,185,173,1,2,6,3
S01008946,Owned: Total,362,190,140,16,124,47,3,172,168,1,1,1,1
S01008946,Owned: Owned outright,227,75,57,12,45,17,1,152,150,1,0,1,0
S01008946,Owned: Owned with a mortgage or loan or shared ownership,135,115,83,4,79,30,2,20,18,0,1,0,1
S01008946,Rented or living rent free: Total,35,22,15,4,11,5,2,13,5,0,1,5,2
S01008946,Rented or living rent free: Social rented,5,2,0,0,0,1,1,3,1,0,0,2,0
S01008946,Rented or living rent free: Private rented or living rent free,30,20,15,4,11,4,1,10,4,0,1,3,2
S01008947,All HRPs aged 16 and over,449,248,193,23,170,51,4,201,199,0,0,2,0
S01008947,Owned: Total,429,235,184,22,162,49,2,194,193,0,0,1,0
S01008947,Owned: Owned outright,266,85,64,20,44,19,2,181,181,0,0,0,0
S01008947,Owned: Owned with a mortgage or loan or shared ownership,163,150,120,2,118,30,0,13,12,0,0,1,0
S01008947,Rented or living rent free: Total,20,13,9,1,8,2,2,7,6,0,0,1,0
S01008947,Rented or living rent free: Social rented,3,1,1,1,0,0,0,2,1,0,0,1,0
S01008947,Rented or living rent free: Private rented or living rent free,17,12,8,0,8,2,2,5,5,0,0,0,0
S01008948,All HRPs aged 16 and over,285,200,161,13,148,34,5,85,75,2,3,4,1
S01008948,Owned: Total,254,186,148,11,137,34,4,68,64,0,2,1,1
S01008948,Owned: Owned outright,108,49,35,5,30,12,2,59,56,0,1,1,1
S01008948,Owned: Owned with a mortgage or loan or shared ownership,146,137,113,6,107,22,2,9,8,0,1,0,0
S01008948,Rented or living rent free: Total,31,14,13,2,11,0,1,17,11,2,1,3,0
S01008948,Rented or living rent free: Social rented,13,1,1,0,1,0,0,12,10,0,0,2,0
S01008948,Rented or living rent free: Private rented or living rent free,18,13,12,2,10,0,1,5,1,2,1,1,0
S01008949,All HRPs aged 16 and over,393,231,191,38,153,31,9,162,137,2,4,16,3
S01008949,Owned: Total,278,176,152,20,132,23,1,102,100,0,1,1,0
S01008949,Owned: Owned outright,119,39,33,9,24,6,0,80,80,0,0,0,0
S01008949,Owned: Owned with a mortgage or loan or shared ownership,159,137,119,11,108,17,1,22,20,0,1,1,0
S01008949,Rented or living rent free: Total,115,55,39,18,21,8,8,60,37,2,3,15,3
S01008949,Rented or living rent free: Social rented,74,32,25,12,13,3,4,42,27,0,1,11,3
S01008949,Rented or living rent free: Private rented or living rent free,41,23,14,6,8,5,4,18,10,2,2,4,0
S01008950,All HRPs aged 16 and over,420,242,199,37,162,34,9,178,154,4,9,8,3
S01008950,Owned: Total,321,192,162,21,141,29,1,129,122,2,3,1,1
S01008950,Owned: Owned outright,135,39,36,11,25,2,1,96,92,2,2,0,0
S01008950,Owned: Owned with a mortgage or loan or shared ownership,186,153,126,10,116,27,0,33,30,0,1,1,1
S01008950,Rented or living rent free: Total,99,50,37,16,21,5,8,49,32,2,6,7,2
S01008950,Rented or living rent free: Social rented,66,27,17,7,10,3,7,39,26,1,4,7,1
S01008950,Rented or living rent free: Private rented or living rent free,33,23,20,9,11,2,1,10,6,1,2,0,1
S01008951,All HRPs aged 16 and over,435,252,220,41,179,20,12,183,120,2,16,36,9
S01008951,Owned: Total,234,145,129,17,112,15,1,89,80,1,1,6,1
S01008951,Owned: Owned outright,99,27,23,9,14,4,0,72,70,1,0,1,0
S01008951,Owned: Owned with a mortgage or loan or shared ownership,135,118,106,8,98,11,1,17,10,0,1,5,1
S01008951,Rented or living rent free: Total,201,107,91,24,67,5,11,94,40,1,15,30,8
S01008951,Rented or living rent free: Social rented,138,67,54,16,38,5,8,71,34,0,8,24,5
S01008951,Rented or living rent free: Private rented or living rent free,63,40,37,8,29,0,3,23,6,1,7,6,3
S01008952,All HRPs aged 16 and over,421,259,206,46,160,25,28,162,91,4,31,32,4
S01008952,Owned: Total,210,149,134,18,116,11,4,61,54,0,1,6,0
S01008952,Owned: Owned outright,77,27,22,5,17,4,1,50,48,0,0,2,0
S01008952,Owned: Owned with a mortgage or loan or shared ownership,133,122,112,13,99,7,3,11,6,0,1,4,0
S01008952,Rented or living rent free: Total,211,110,72,28,44,14,24,101,37,4,30,26,4
S01008952,Rented or living rent free: Social rented,140,59,37,16,21,5,17,81,35,2,15,25,4
S01008952,Rented or living rent free: Private rented or living rent free,71,51,35,12,23,9,7,20,2,2,15,1,0
S01008953,All HRPs aged 16 and over,424,235,189,41,148,32,14,189,138,4,12,27,8
S01008953,Owned: Total,265,167,138,18,120,25,4,98,93,1,1,1,2
S01008953,Owned: Owned outright,116,33,28,6,22,5,0,83,82,1,0,0,0
S01008953,Owned: Owned with a mortgage or loan or shared ownership,149,134,110,12,98,20,4,15,11,0,1,1,2
S01008953,Rented or living rent free: Total,159,68,51,23,28,7,10,91,45,3,11,26,6
S01008953,Rented or living rent free: Social rented,119,39,28,11,17,5,6,80,43,2,6,24,5
S01008953,Rented or living rent free: Private rented or living rent free,40,29,23,12,11,2,4,11,2,1,5,2,1
S01008954,All HRPs aged 16 and over,434,223,180,41,139,28,15,211,173,4,1,19,14
S01008954,Owned: Total,249,144,111,17,94,25,8,105,98,0,0,2,5
S01008954,Owned: Owned outright,115,26,20,6,14,1,5,89,86,0,0,2,1
S01008954,Owned: Owned with a mortgage or loan or shared ownership,134,118,91,11,80,24,3,16,12,0,0,0,4
S01008954,Rented or living rent free: Total,185,79,69,24,45,3,7,106,75,4,1,17,9
S01008954,Rented or living rent free: Social rented,132,42,34,13,21,2,6,90,68,2,0,16,4
S01008954,Rented or living rent free: Private rented or living rent free,53,37,35,11,24,1,1,16,7,2,1,1,5
S01008955,All HRPs aged 16 and over,282,193,155,16,139,35,3,89,78,0,7,1,3
S01008955,Owned: Total,238,159,127,9,118,30,2,79,75,0,1,0,3
S01008955,Owned: Owned outright,113,42,28,4,24,14,0,71,67,0,1,0,3
S01008955,Owned: Owned with a mortgage or loan or shared ownership,125,117,99,5,94,16,2,8,8,0,0,0,0
S01008955,Rented or living rent free: Total,44,34,28,7,21,5,1,10,3,0,6,1,0
S01008955,Rented or living rent free: Social rented,20,17,16,6,10,1,0,3,1,0,1,1,0
S01008955,Rented or living rent free: Private rented or living rent free,24,17,12,1,11,4,1,7,2,0,5,0,0
S01008956,All HRPs aged 16 and over,406,324,288,44,244,27,9,82,62,2,9,6,3
S01008956,Owned: Total,327,266,240,31,209,21,5,61,53,2,1,2,3
S01008956,Owned: Owned outright,110,64,56,19,37,7,1,46,41,2,0,1,2
S01008956,Owned: Owned with a mortgage or loan or shared ownership,217,202,184,12,172,14,4,15,12,0,1,1,1
S01008956,Rented or living rent free: Total,79,58,48,13,35,6,4,21,9,0,8,4,0
S01008956,Rented or living rent free: Social rented,30,17,15,3,12,0,2,13,6,0,5,2,0
S01008956,Rented or living rent free: Private rented or living rent free,49,41,33,10,23,6,2,8,3,0,3,2,0
S01008957,All HRPs aged 16 and over,429,274,232,44,188,30,12,155,109,3,13,26,4
S01008957,Owned: Total,277,184,157,24,133,26,1,93,90,0,1,1,1
S01008957,Owned: Owned outright,131,51,45,12,33,5,1,80,79,0,0,0,1
S01008957,Owned: Owned with a mortgage or loan or shared ownership,146,133,112,12,100,21,0,13,11,0,1,1,0
S01008957,Rented or living rent free: Total,152,90,75,20,55,4,11,62,19,3,12,25,3
S01008957,Rented or living rent free: Social rented,101,49,41,12,29,1,7,52,16,3,9,22,2
S01008957,Rented or living rent free: Private rented or living rent free,51,41,34,8,26,3,4,10,3,0,3,3,1
S01008958,All HRPs aged 16 and over,404,212,180,28,152,23,9,192,143,0,5,39,5
S01008958,Owned: Total,183,149,130,11,119,17,2,34,33,0,0,1,0
S01008958,Owned: Owned outright,62,33,29,6,23,2,2,29,28,0,0,1,0
S01008958,Owned: Owned with a mortgage or loan or shared ownership,121,116,101,5,96,15,0,5,5,0,0,0,0
S01008958,Rented or living rent free: Total,221,63,50,17,33,6,7,158,110,0,5,38,5
S01008958,Rented or living rent free: Social rented,184,40,31,12,19,4,5,144,107,0,1,31,5
S01008958,Rented or living rent free: Private rented or living rent free,37,23,19,5,14,2,2,14,3,0,4,7,0
S01008959,All HRPs aged 16 and over,380,259,224,34,190,31,4,121,99,1,9,9,3
S01008959,Owned: Total,280,207,180,24,156,26,1,73,71,1,0,1,0
S01008959,Owned: Owned outright,114,55,47,11,36,8,0,59,57,1,0,1,0
S01008959,Owned: Owned with a mortgage or loan or shared ownership,166,152,133,13,120,18,1,14,14,0,0,0,0
S01008959,Rented or living rent free: Total,100,52,44,10,34,5,3,48,28,0,9,8,3
S01008959,Rented or living rent free: Social rented,60,22,19,5,14,1,2,38,24,0,4,7,3
S01008959,Rented or living rent free: Private rented or living rent free,40,30,25,5,20,4,1,10,4,0,5,1,0
S01008960,All HRPs aged 16 and over,328,299,246,20,226,51,2,29,18,2,6,3,0
S01008960,Owned: Total,289,267,217,15,202,48,2,22,17,1,3,1,0
S01008960,Owned: Owned outright,86,68,52,6,46,16,0,18,15,1,2,0,0
S01008960,Owned: Owned with a mortgage or loan or shared ownership,203,199,165,9,156,32,2,4,2,0,1,1,0
S01008960,Rented or living rent free: Total,39,32,29,5,24,3,0,7,1,1,3,2,0
S01008960,Rented or living rent free: Social rented,7,4,3,1,2,1,0,3,1,1,1,0,0
S01008960,Rented or living rent free: Private rented or living rent free,32,28,26,4,22,2,0,4,0,0,2,2,0
S01008961,All HRPs aged 16 and over,319,225,195,25,170,25,5,94,73,4,5,9,3
S01008961,Owned: Total,274,197,171,19,152,24,2,77,69,0,3,3,2
S01008961,Owned: Owned outright,107,42,37,7,30,4,1,65,62,0,0,1,2
S01008961,Owned: Owned with a mortgage or loan or shared ownership,167,155,134,12,122,20,1,12,7,0,3,2,0
S01008961,Rented or living rent free: Total,45,28,24,6,18,1,3,17,4,4,2,6,1
S01008961,Rented or living rent free: Social rented,5,2,1,1,0,1,0,3,0,0,0,3,0
S01008961,Rented or living rent free: Private rented or living rent free,40,26,23,5,18,0,3,14,4,4,2,3,1
S01008962,All HRPs aged 16 and over,275,184,156,19,137,24,4,91,81,0,4,3,3
S01008962,Owned: Total,252,169,146,18,128,22,1,83,80,0,1,1,1
S01008962,Owned: Owned outright,127,55,47,12,35,8,0,72,70,0,1,0,1
S01008962,Owned: Owned with a mortgage or loan or shared ownership,125,114,99,6,93,14,1,11,10,0,0,1,0
S01008962,Rented or living rent free: Total,23,15,10,1,9,2,3,8,1,0,3,2,2
S01008962,Rented or living rent free: Social rented,5,0,0,0,0,0,0,5,0,0,2,1,2
S01008962,Rented or living rent free: Private rented or living rent free,18,15,10,1,9,2,3,3,1,0,1,1,0
S01008963,All HRPs aged 16 and over,349,210,172,18,154,33,5,139,133,1,1,2,2
S01008963,Owned: Total,318,186,151,14,137,32,3,132,131,0,0,1,0
S01008963,Owned: Owned outright,184,60,48,9,39,11,1,124,124,0,0,0,0
S01008963,Owned: Owned with a mortgage or loan or shared ownership,134,126,103,5,98,21,2,8,7,0,0,1,0
S01008963,Rented or living rent free: Total,31,24,21,4,17,1,2,7,2,1,1,1,2
S01008963,Rented or living rent free: Social rented,7,4,4,2,2,0,0,3,0,0,0,1,2
S01008963,Rented or living rent free: Private rented or living rent free,24,20,17,2,15,1,2,4,2,1,1,0,0
S01008964,All HRPs aged 16 and over,211,120,97,10,87,22,1,91,89,0,1,0,1
S01008964,Owned: Total,200,111,89,9,80,21,1,89,88,0,0,0,1
S01008964,Owned: Owned outright,110,28,24,6,18,4,0,82,81,0,0,0,1
S01008964,Owned: Owned with a mortgage or loan or shared ownership,90,83,65,3,62,17,1,7,7,0,0,0,0
S01008964,Rented or living rent free: Total,11,9,8,1,7,1,0,2,1,0,1,0,0
S01008964,Rented or living rent free: Social rented,0,0,0,0,0,0,0,0,0,0,0,0,0
S01008964,Rented or living rent free: Private rented or living rent free,11,9,8,1,7,1,0,2,1,0,1,0,0
S01008965,All HRPs aged 16 and over,321,169,131,21,110,38,0,152,149,0,1,1,1
S01008965,Owned: Total,295,162,126,20,106,36,0,133,131,0,1,0,1
S01008965,Owned: Owned outright,178,54,43,15,28,11,0,124,122,0,1,0,1
S01008965,Owned: Owned with a mortgage or loan or shared ownership,117,108,83,5,78,25,0,9,9,0,0,0,0
S01008965,Rented or living rent free: Total,26,7,5,1,4,2,0,19,18,0,0,1,0
S01008965,Rented or living rent free: Social rented,17,2,2,1,1,0,0,15,14,0,0,1,0
S01008965,Rented or living rent free: Private rented or living rent free,9,5,3,0,3,2,0,4,4,0,0,0,0
S01008966,All HRPs aged 16 and over,252,160,133,24,109,26,1,92,86,1,0,2,3
S01008966,Owned: Total,241,153,128,21,107,24,1,88,86,0,0,1,1
S01008966,Owned: Owned outright,144,61,56,15,41,4,1,83,82,0,0,0,1
S01008966,Owned: Owned with a mortgage or loan or shared ownership,97,92,72,6,66,20,0,5,4,0,0,1,0
S01008966,Rented or living rent free: Total,11,7,5,3,2,2,0,4,0,1,0,1,2
S01008966,Rented or living rent free: Social rented,1,0,0,0,0,0,0,1,0,0,0,0,1
S01008966,Rented or living rent free: Private rented or living rent free,10,7,5,3,2,2,0,3,0,1,0,1,1
S01008967,All HRPs aged 16 and over,430,251,205,25,180,42,4,179,170,1,3,3,2
S01008967,Owned: Total,417,241,196,23,173,41,4,176,169,1,2,2,2
S01008967,Owned: Owned outright,236,68,51,18,33,15,2,168,162,1,2,1,2
S01008967,Owned: Owned with a mortgage or loan or shared ownership,181,173,145,5,140,26,2,8,7,0,0,1,0
S01008967,Rented or living rent free: Total,13,10,9,2,7,1,0,3,1,0,1,1,0
S01008967,Rented or living rent free: Social rented,3,1,1,1,0,0,0,2,0,0,1,1,0
S01008967,Rented or living rent free: Private rented or living rent free,10,9,8,1,7,1,0,1,1,0,0,0,0
S01008968,All HRPs aged 16 and over,398,253,212,32,180,39,2,145,142,1,1,1,0
S01008968,Owned: Total,372,234,197,27,170,37,0,138,137,1,0,0,0
S01008968,Owned: Owned outright,195,66,50,12,38,16,0,129,128,1,0,0,0
S01008968,Owned: Owned with a mortgage or loan or shared ownership,177,168,147,15,132,21,0,9,9,0,0,0,0
S01008968,Rented or living rent free: Total,26,19,15,5,10,2,2,7,5,0,1,1,0
S01008968,Rented or living rent free: Social rented,17,13,10,4,6,1,2,4,2,0,1,1,0
S01008968,Rented or living rent free: Private rented or living rent free,9,6,5,1,4,1,0,3,3,0,0,0,0
S01008969,All HRPs aged 16 and over,460,281,240,35,205,37,4,179,163,2,5,6,3
S01008969,Owned: Total,396,239,205,29,176,31,3,157,149,1,2,2,3
S01008969,Owned: Owned outright,214,70,60,12,48,7,3,144,141,0,1,0,2
S01008969,Owned: Owned with a mortgage or loan or shared ownership,182,169,145,17,128,24,0,13,8,1,1,2,1
S01008969,Rented or living rent free: Total,64,42,35,6,29,6,1,22,14,1,3,4,0
S01008969,Rented or living rent free: Social rented,20,8,4,1,3,3,1,12,8,0,3,1,0
S01008969,Rented or living rent free: Private rented or living rent free,44,34,31,5,26,3,0,10,6,1,0,3,0
S01008970,All HRPs aged 16 and over,438,301,252,23,229,46,3,137,135,0,0,1,1
S01008970,Owned: Total,391,263,219,19,200,43,1,128,128,0,0,0,0
S01008970,Owned: Owned outright,196,72,54,13,41,18,0,124,124,0,0,0,0
S01008970,Owned: Owned with a mortgage or loan or shared ownership,195,191,165,6,159,25,1,4,4,0,0,0,0
S01008970,Rented or living rent free: Total,47,38,33,4,29,3,2,9,7,0,0,1,1
S01008970,Rented or living rent free: Social rented,11,4,2,1,1,0,2,7,5,0,0,1,1
S01008970,Rented or living rent free: Private rented or living rent free,36,34,31,3,28,3,0,2,2,0,0,0,0
S01008971,All HRPs aged 16 and over,273,200,165,17,148,33,2,73,68,0,0,1,4
S01008971,Owned: Total,259,188,156,16,140,30,2,71,66,0,0,1,4
S01008971,Owned: Owned outright,116,48,43,12,31,5,0,68,64,0,0,0,4
S01008971,Owned: Owned with a mortgage or loan or shared ownership,143,140,113,4,109,25,2,3,2,0,0,1,0
S01008971,Rented or living rent free: Total,14,12,9,1,8,3,0,2,2,0,0,0,0
S01008971,Rented or living rent free: Social rented,1,1,1,1,0,0,0,0,0,0,0,0,0
S01008971,Rented or living rent free: Private rented or living rent free,13,11,8,0,8,3,0,2,2,0,0,0,0
S01008972,All HRPs aged 16 and over,304,208,164,14,150,43,1,96,92,0,2,0,2
S01008972,Owned: Total,276,182,142,13,129,40,0,94,92,0,0,0,2
S01008972,Owned: Owned outright,145,60,49,10,39,11,0,85,83,0,0,0,2
S01008972,Owned: Owned with a mortgage or loan or shared ownership,131,122,93,3,90,29,0,9,9,0,0,0,0
S01008972,Rented or living rent free: Total,28,26,22,1,21,3,1,2,0,0,2,0,0
S01008972,Rented or living rent free: Social rented,2,2,2,0,2,0,0,0,0,0,0,0,0
S01008972,Rented or living rent free: Private rented or living rent free,26,24,20,1,19,3,1,2,0,0,2,0,0
S01008973,All HRPs aged 16 and over,361,229,192,16,176,35,2,132,123,0,1,4,4
S01008973,Owned: Total,290,183,154,14,140,29,0,107,104,0,0,2,1
S01008973,Owned: Owned outright,154,55,47,10,37,8,0,99,98,0,0,0,1
S01008973,Owned: Owned with a mortgage or loan or shared ownership,136,128,107,4,103,21,0,8,6,0,0,2,0
S01008973,Rented or living rent free: Total,71,46,38,2,36,6,2,25,19,0,1,2,3
S01008973,Rented or living rent free: Social rented,28,9,7,1,6,1,1,19,14,0,1,2,2
S01008973,Rented or living rent free: Private rented or living rent free,43,37,31,1,30,5,1,6,5,0,0,0,1
S01008974,All HRPs aged 16 and over,374,212,182,24,158,25,5,162,136,4,15,5,2
S01008974,Owned: Total,288,161,138,19,119,21,2,127,127,0,0,0,0
S01008974,Owned: Owned outright,164,47,42,9,33,4,1,117,117,0,0,0,0
S01008974,Owned: Owned with a mortgage or loan or shared ownership,124,114,96,10,86,17,1,10,10,0,0,0,0
S01008974,Rented or living rent free: Total,86,51,44,5,39,4,3,35,9,4,15,5,2
S01008974,Rented or living rent free: Social rented,15,5,4,0,4,0,1,10,5,0,0,4,1
S01008974,Rented or living rent free: Private rented or living rent free,71,46,40,5,35,4,2,25,4,4,15,1,1
S01008975,All HRPs aged 16 and over,449,191,162,23,139,24,5,258,229,10,4,11,4
S01008975,Owned: Total,245,117,98,7,91,18,1,128,120,3,1,2,2
S01008975,Owned: Owned outright,146,28,23,3,20,5,0,118,111,2,1,2,2
S01008975,Owned: Owned with a mortgage or loan or shared ownership,99,89,75,4,71,13,1,10,9,1,0,0,0
S01008975,Rented or living rent free: Total,204,74,64,16,48,6,4,130,109,7,3,9,2
S01008975,Rented or living rent free: Social rented,135,29,26,11,15,1,2,106,96,3,0,5,2
S01008975,Rented or living rent free: Private rented or living rent free,69,45,38,5,33,5,2,24,13,4,3,4,0
S01008976,All HRPs aged 16 and over,212,132,99,6,93,32,1,80,76,1,1,0,2
S01008976,Owned: Total,203,127,96,6,90,30,1,76,73,0,1,0,2
S01008976,Owned: Owned outright,113,43,31,2,29,11,1,70,68,0,0,0,2
S01008976,Owned: Owned with a mortgage or loan or shared ownership,90,84,65,4,61,19,0,6,5,0,1,0,0
S01008976,Rented or living rent free: Total,9,5,3,0,3,2,0,4,3,1,0,0,0
S01008976,Rented or living rent free: Social rented,2,2,1,0,1,1,0,0,0,0,0,0,0
S01008976,Rented or living rent free: Private rented or living rent free,7,3,2,0,2,1,0,4,3,1,0,0,0
S01008977,All HRPs aged 16 and over,256,159,132,13,119,25,2,97,91,2,2,2,0
S01008977,Owned: Total,237,145,120,13,107,24,1,92,89,1,1,1,0
S01008977,Owned: Owned outright,142,54,44,9,35,9,1,88,86,1,0,1,0
S01008977,Owned: Owned with a mortgage or loan or shared ownership,95,91,76,4,72,15,0,4,3,0,1,0,0
S01008977,Rented or living rent free: Total,19,14,12,0,12,1,1,5,2,1,1,1,0
S01008977,Rented or living rent free: Social rented,3,1,1,0,1,0,0,2,1,0,0,1,0
S01008977,Rented or living rent free: Private rented or living rent free,16,13,11,0,11,1,1,3,1,1,1,0,0
S01008978,All HRPs aged 16 and over,252,182,151,31,120,26,5,70,59,4,5,0,2
S01008978,Owned: Total,191,140,114,17,97,24,2,51,48,2,1,0,0
S01008978,Owned: Owned outright,81,35,32,10,22,3,0,46,43,2,1,0,0
S01008978,Owned: Owned with a mortgage or loan or shared ownership,110,105,82,7,75,21,2,5,5,0,0,0,0
S01008978,Rented or living rent free: Total,61,42,37,14,23,2,3,19,11,2,4,0,2
S01008978,Rented or living rent free: Social rented,7,4,3,0,3,0,1,3,2,1,0,0,0
S01008978,Rented or living rent free: Private rented or living rent free,54,38,34,14,20,2,2,16,9,1,4,0,2
S01008979,All HRPs aged 16 and over,308,249,210,32,178,32,7,59,33,5,12,3,6
S01008979,Owned: Total,213,183,157,16,141,23,3,30,24,1,2,1,2
S01008979,Owned: Owned outright,49,26,22,4,18,3,1,23,22,0,0,0,1
S01008979,Owned: Owned with a mortgage or loan or shared ownership,164,157,135,12,123,20,2,7,2,1,2,1,1
S01008979,Rented or living rent free: Total,95,66,53,16,37,9,4,29,9,4,10,2,4
S01008979,Rented or living rent free: Social rented,9,2,2,1,1,0,0,7,1,0,5,1,0
S01008979,Rented or living rent free: Private rented or living rent free,86,64,51,15,36,9,4,22,8,4,5,1,4
S01008980,All HRPs aged 16 and over,334,247,209,33,176,27,11,87,51,4,14,12,6
S01008980,Owned: Total,224,174,157,19,138,16,1,50,48,0,0,2,0
S01008980,Owned: Owned outright,70,25,22,2,20,3,0,45,43,0,0,2,0
S01008980,Owned: Owned with a mortgage or loan or shared ownership,154,149,135,17,118,13,1,5,5,0,0,0,0
S01008980,Rented or living rent free: Total,110,73,52,14,38,11,10,37,3,4,14,10,6
S01008980,Rented or living rent free: Social rented,15,4,3,1,2,0,1,11,0,2,4,2,3
S01008980,Rented or living rent free: Private rented or living rent free,95,69,49,13,36,11,9,26,3,2,10,8,3
S01008981,All HRPs aged 16 and over,316,170,135,24,111,31,4,146,142,1,2,1,0
S01008981,Owned: Total,292,154,122,21,101,30,2,138,137,0,1,0,0
S01008981,Owned: Owned outright,178,47,36,12,24,9,2,131,131,0,0,0,0
S01008981,Owned: Owned with a mortgage or loan or shared ownership,114,107,86,9,77,21,0,7,6,0,1,0,0
S01008981,Rented or living rent free: Total,24,16,13,3,10,1,2,8,5,1,1,1,0
S01008981,Rented or living rent free: Social rented,9,6,5,1,4,0,1,3,2,1,0,0,0
S01008981,Rented or living rent free: Private rented or living rent free,15,10,8,2,6,1,1,5,3,0,1,1,0
S01008982,All HRPs aged 16 and over,352,249,211,33,178,28,10,103,73,8,12,4,6
S01008982,Owned: Total,245,182,158,16,142,22,2,63,59,0,1,2,1
S01008982,Owned: Owned outright,96,41,37,8,29,3,1,55,53,0,0,2,0
S01008982,Owned: Owned with a mortgage or loan or shared ownership,149,141,121,8,113,19,1,8,6,0,1,0,1
S01008982,Rented or living rent free: Total,107,67,53,17,36,6,8,40,14,8,11,2,5
S01008982,Rented or living rent free: Social rented,9,5,4,2,2,1,0,4,1,0,0,1,2
S01008982,Rented or living rent free: Private rented or living rent free,98,62,49,15,34,5,8,36,13,8,11,1,3
S01008983,All HRPs aged 16 and over,314,262,231,25,206,21,10,52,23,4,15,8,2
S01008983,Owned: Total,224,197,182,15,167,12,3,27,21,0,3,1,2
S01008983,Owned: Owned outright,49,31,26,4,22,3,2,18,18,0,0,0,0
S01008983,Owned: Owned with a mortgage or loan or shared ownership,175,166,156,11,145,9,1,9,3,0,3,1,2
S01008983,Rented or living rent free: Total,90,65,49,10,39,9,7,25,2,4,12,7,0
S01008983,Rented or living rent free: Social rented,14,7,6,1,5,0,1,7,2,0,3,2,0
S01008983,Rented or living rent free: Private rented or living rent free,76,58,43,9,34,9,6,18,0,4,9,5,0
S01008984,All HRPs aged 16 and over,227,158,141,26,115,10,7,69,43,1,13,9,3
S01008984,Owned: Total,150,114,103,9,94,8,3,36,34,0,0,2,0
S01008984,Owned: Owned outright,56,25,19,3,16,4,2,31,30,0,0,1,0
S01008984,Owned: Owned with a mortgage or loan or shared ownership,94,89,84,6,78,4,1,5,4,0,0,1,0
S01008984,Rented or living rent free: Total,77,44,38,17,21,2,4,33,9,1,13,7,3
S01008984,Rented or living rent free: Social rented,5,1,1,1,0,0,0,4,0,0,1,2,1
S01008984,Rented or living rent free: Private rented or living rent free,72,43,37,16,21,2,4,29,9,1,12,5,2
S01008985,All HRPs aged 16 and over,326,227,195,19,176,24,8,99,81,2,3,8,5
S01008985,Owned: Total,270,186,160,12,148,23,3,84,79,0,0,2,3
S01008985,Owned: Owned outright,125,47,38,7,31,8,1,78,76,0,0,0,2
S01008985,Owned: Owned with a mortgage or loan or shared ownership,145,139,122,5,117,15,2,6,3,0,0,2,1
S01008985,Rented or living rent free: Total,56,41,35,7,28,1,5,15,2,2,3,6,2
S01008985,Rented or living rent free: Social rented,4,2,1,1,0,1,0,2,0,0,0,1,1
S01008985,Rented or living rent free: Private rented or living rent free,52,39,34,6,28,0,5,13,2,2,3,5,1
S01008986,All HRPs aged 16 and over,343,209,171,26,145,34,4,134,128,1,2,3,0
S01008986,Owned: Total,319,191,158,23,135,30,3,128,126,0,0,2,0
S01008986,Owned: Owned outright,180,57,45,9,36,12,0,123,122,0,0,1,0
S01008986,Owned: Owned with a mortgage or loan or shared ownership,139,134,113,14,99,18,3,5,4,0,0,1,0
S01008986,Rented or living rent free: Total,24,18,13,3,10,4,1,6,2,1,2,1,0
S01008986,Rented or living rent free: Social rented,1,0,0,0,0,0,0,1,0,0,0,1,0
S01008986,Rented or living rent free: Private rented or living rent free,23,18,13,3,10,4,1,5,2,1,2,0,0
S01008987,All HRPs aged 16 and over,330,200,163,16,147,35,2,130,127,0,1,0,2
S01008987,Owned: Total,318,191,155,14,141,35,1,127,124,0,1,0,2
S01008987,Owned: Owned outright,186,65,60,8,52,4,1,121,119,0,1,0,1
S01008987,Owned: Owned with a mortgage or loan or shared ownership,132,126,95,6,89,31,0,6,5,0,0,0,1
S01008987,Rented or living rent free: Total,12,9,8,2,6,0,1,3,3,0,0,0,0
S01008987,Rented or living rent free: Social rented,1,0,0,0,0,0,0,1,1,0,0,0,0
S01008987,Rented or living rent free: Private rented or living rent free,11,9,8,2,6,0,1,2,2,0,0,0,0
S01008988,All HRPs aged 16 and over,481,294,246,34,212,42,6,187,158,5,15,5,4
S01008988,Owned: Total,326,182,147,16,131,33,2,144,139,3,0,1,1
S01008988,Owned: Owned outright,186,50,37,10,27,12,1,136,132,2,0,1,1
S01008988,Owned: Owned with a mortgage or loan or shared ownership,140,132,110,6,104,21,1,8,7,1,0,0,0
S01008988,Rented or living rent free: Total,155,112,99,18,81,9,4,43,19,2,15,4,3
S01008988,Rented or living rent free: Social rented,39,12,11,5,6,1,0,27,14,1,9,2,1
S01008988,Rented or living rent free: Private rented or living rent free,116,100,88,13,75,8,4,16,5,1,6,2,2
S01008989,All HRPs aged 16 and over,323,274,242,25,217,26,6,49,32,3,7,5,2
S01008989,Owned: Total,240,204,182,12,170,18,4,36,30,1,1,2,2
S01008989,Owned: Owned outright,56,31,25,5,20,6,0,25,21,1,0,1,2
S01008989,Owned: Owned with a mortgage or loan or shared ownership,184,173,157,7,150,12,4,11,9,0,1,1,0
S01008989,Rented or living rent free: Total,83,70,60,13,47,8,2,13,2,2,6,3,0
S01008989,Rented or living rent free: Social rented,5,4,3,2,1,1,0,1,1,0,0,0,0
S01008989,Rented or living rent free: Private rented or living rent free,78,66,57,11,46,7,2,12,1,2,6,3,0
S01008990,All HRPs aged 16 and over,383,331,291,24,267,35,5,52,44,0,2,4,2
S01008990,Owned: Total,288,246,215,17,198,31,0,42,39,0,0,2,1
S01008990,Owned: Owned outright,90,53,45,9,36,8,0,37,35,0,0,1,1
S01008990,Owned: Owned with a mortgage or loan or shared ownership,198,193,170,8,162,23,0,5,4,0,0,1,0
S01008990,Rented or living rent free: Total,95,85,76,7,69,4,5,10,5,0,2,2,1
S01008990,Rented or living rent free: Social rented,2,1,1,0,1,0,0,1,1,0,0,0,0
S01008990,Rented or living rent free: Private rented or living rent free,93,84,75,7,68,4,5,9,4,0,2,2,1
S01008991,All HRPs aged 16 and over,381,325,279,25,254,43,3,56,44,5,3,4,0
S01008991,Owned: Total,326,282,243,19,224,36,3,44,40,0,1,3,0
S01008991,Owned: Owned outright,99,64,56,11,45,7,1,35,34,0,0,1,0
S01008991,Owned: Owned with a mortgage or loan or shared ownership,227,218,187,8,179,29,2,9,6,0,1,2,0
S01008991,Rented or living rent free: Total,55,43,36,6,30,7,0,12,4,5,2,1,0
S01008991,Rented or living rent free: Social rented,5,3,1,0,1,2,0,2,0,0,1,1,0
S01008991,Rented or living rent free: Private rented or living rent free,50,40,35,6,29,5,0,10,4,5,1,0,0
S01008992,All HRPs aged 16 and over,270,176,153,20,133,19,4,94,76,2,4,12,0
S01008992,Owned: Total,204,137,121,11,110,16,0,67,63,0,2,2,0
S01008992,Owned: Owned outright,96,38,33,6,27,5,0,58,57,0,0,1,0
S01008992,Owned: Owned with a mortgage or loan or shared ownership,108,99,88,5,83,11,0,9,6,0,2,1,0
S01008992,Rented or living rent free: Total,66,39,32,9,23,3,4,27,13,2,2,10,0
S01008992,Rented or living rent free: Social rented,31,15,10,5,5,2,3,16,9,0,0,7,0
S01008992,Rented or living rent free: Private rented or living rent free,35,24,22,4,18,1,1,11,4,2,2,3,0
S01008993,All HRPs aged 16 and over,476,330,257,30,227,67,6,146,134,2,5,4,1
S01008993,Owned: Total,355,228,175,20,155,52,1,127,123,0,1,3,0
S01008993,Owned: Owned outright,182,65,49,9,40,16,0,117,114,0,1,2,0
S01008993,Owned: Owned with a mortgage or loan or shared ownership,173,163,126,11,115,36,1,10,9,0,0,1,0
S01008993,Rented or living rent free: Total,121,102,82,10,72,15,5,19,11,2,4,1,1
S01008993,Rented or living rent free: Social rented,7,4,4,2,2,0,0,3,2,0,0,1,0
S01008993,Rented or living rent free: Private rented or living rent free,114,98,78,8,70,15,5,16,9,2,4,0,1
S01008994,All HRPs aged 16 and over,337,223,179,34,145,36,8,114,80,0,14,15,5
S01008994,Owned: Total,206,150,118,16,102,30,2,56,50,0,0,4,2
S01008994,Owned: Owned outright,89,42,33,7,26,8,1,47,43,0,0,3,1
S01008994,Owned: Owned with a mortgage or loan or shared ownership,117,108,85,9,76,22,1,9,7,0,0,1,1
S01008994,Rented or living rent free: Total,131,73,61,18,43,6,6,58,30,0,14,11,3
S01008994,Rented or living rent free: Social rented,100,52,45,13,32,3,4,48,24,0,11,11,2
S01008994,Rented or living rent free: Private rented or living rent free,31,21,16,5,11,3,2,10,6,0,3,0,1
S01008995,All HRPs aged 16 and over,352,268,217,21,196,41,10,84,75,1,2,4,2
S01008995,Owned: Total,302,230,190,14,176,37,3,72,69,0,1,1,1
S01008995,Owned: Owned outright,134,68,53,8,45,13,2,66,63,0,1,1,1
S01008995,Owned: Owned with a mortgage or loan or shared ownership,168,162,137,6,131,24,1,6,6,0,0,0,0
S01008995,Rented or living rent free: Total,50,38,27,7,20,4,7,12,6,1,1,3,1
S01008995,Rented or living rent free: Social rented,16,9,7,4,3,0,2,7,4,0,0,2,1
S01008995,Rented or living rent free: Private rented or living rent free,34,29,20,3,17,4,5,5,2,1,1,1,0
S01008996,All HRPs aged 16 and over,251,151,128,25,103,18,5,100,79,0,5,12,4
S01008996,Owned: Total,169,112,94,17,77,16,2,57,54,0,0,1,2
S01008996,Owned: Owned outright,87,38,31,12,19,7,0,49,47,0,0,1,1
S01008996,Owned: Owned with a mortgage or loan or shared ownership,82,74,63,5,58,9,2,8,7,0,0,0,1
S01008996,Rented or living rent free: Total,82,39,34,8,26,2,3,43,25,0,5,11,2
S01008996,Rented or living rent free: Social rented,57,27,22,7,15,2,3,30,18,0,2,8,2
S01008996,Rented or living rent free: Private rented or living rent free,25,12,12,1,11,0,0,13,7,0,3,3,0
S01008997,All HRPs aged 16 and over,411,318,252,38,214,56,10,93,72,2,4,13,2
S01008997,Owned: Total,290,237,192,24,168,42,3,53,52,0,0,1,0
S01008997,Owned: Owned outright,95,50,39,8,31,11,0,45,45,0,0,0,0
S01008997,Owned: Owned with a mortgage or loan or shared ownership,195,187,153,16,137,31,3,8,7,0,0,1,0
S01008997,Rented or living rent free: Total,121,81,60,14,46,14,7,40,20,2,4,12,2
S01008997,Rented or living rent free: Social rented,52,35,32,11,21,1,2,17,7,0,1,8,1
S01008997,Rented or living rent free: Private rented or living rent free,69,46,28,3,25,13,5,23,13,2,3,4,1
S01008998,All HRPs aged 16 and over,236,155,129,24,105,11,15,81,33,3,12,21,12
S01008998,Owned: Total,102,79,70,7,63,8,1,23,22,0,0,0,1
S01008998,Owned: Owned outright,34,14,14,3,11,0,0,20,19,0,0,0,1
S01008998,Owned: Owned with a mortgage or loan or shared ownership,68,65,56,4,52,8,1,3,3,0,0,0,0
S01008998,Rented or living rent free: Total,134,76,59,17,42,3,14,58,11,3,12,21,11
S01008998,Rented or living rent free: Social rented,111,63,48,15,33,3,12,48,11,3,8,15,11
S01008998,Rented or living rent free: Private rented or living rent free,23,13,11,2,9,0,2,10,0,0,4,6,0
S01008999,All HRPs aged 16 and over,411,226,188,27,161,21,17,185,159,0,9,14,3
S01008999,Owned: Total,283,183,160,19,141,19,4,100,96,0,0,2,2
S01008999,Owned: Owned outright,142,51,45,12,33,4,2,91,87,0,0,2,2
S01008999,Owned: Owned with a mortgage or loan or shared ownership,141,132,115,7,108,15,2,9,9,0,0,0,0
S01008999,Rented or living rent free: Total,128,43,28,8,20,2,13,85,63,0,9,12,1
S01008999,Rented or living rent free: Social rented,82,24,15,3,12,1,8,58,47,0,4,7,0
S01008999,Rented or living rent free: Private rented or living rent free,46,19,13,5,8,1,5,27,16,0,5,5,1
S01009000,All HRPs aged 16 and over,393,258,208,24,184,46,4,135,122,0,4,5,4
S01009000,Owned: Total,343,225,187,20,167,37,1,118,110,0,3,2,3
S01009000,Owned: Owned outright,172,70,56,16,40,13,1,102,99,0,1,0,2
S01009000,Owned: Owned with a mortgage or loan or shared ownership,171,155,131,4,127,24,0,16,11,0,2,2,1
S01009000,Rented or living rent free: Total,50,33,21,4,17,9,3,17,12,0,1,3,1
S01009000,Rented or living rent free: Social rented,8,1,0,0,0,0,1,7,4,0,1,2,0
S01009000,Rented or living rent free: Private rented or living rent free,42,32,21,4,17,9,2,10,8,0,0,1,1
S01009001,All HRPs aged 16 and over,323,227,190,20,170,37,0,96,93,1,1,1,0
S01009001,Owned: Total,278,207,173,16,157,34,0,71,70,1,0,0,0
S01009001,Owned: Owned outright,117,54,39,10,29,15,0,63,63,0,0,0,0
S01009001,Owned: Owned with a mortgage or loan or shared ownership,161,153,134,6,128,19,0,8,7,1,0,0,0
S01009001,Rented or living rent free: Total,45,20,17,4,13,3,0,25,23,0,1,1,0
S01009001,Rented or living rent free: Social rented,29,7,5,0,5,2,0,22,22,0,0,0,0
S01009001,Rented or living rent free: Private rented or living rent free,16,13,12,4,8,1,0,3,1,0,1,1,0
S01009002,All HRPs aged 16 and over,348,243,203,27,176,35,5,105,87,2,7,6,3
S01009002,Owned: Total,173,122,96,13,83,25,1,51,47,2,0,2,0
S01009002,Owned: Owned outright,81,35,24,6,18,10,1,46,43,2,0,1,0
S01009002,Owned: Owned with a mortgage or loan or shared ownership,92,87,72,7,65,15,0,5,4,0,0,1,0
S01009002,Rented or living rent free: Total,175,121,107,14,93,10,4,54,40,0,7,4,3
S01009002,Rented or living rent free: Social rented,35,16,15,7,8,0,1,19,11,0,5,1,2
S01009002,Rented or living rent free: Private rented or living rent free,140,105,92,7,85,10,3,35,29,0,2,3,1
S01009003,All HRPs aged 16 and over,394,297,235,18,217,56,6,97,86,1,4,5,1
S01009003,Owned: Total,326,255,204,12,192,48,3,71,67,0,1,2,1
S01009003,Owned: Owned outright,140,80,68,9,59,12,0,60,58,0,1,1,0
S01009003,Owned: Owned with a mortgage or loan or shared ownership,186,175,136,3,133,36,3,11,9,0,0,1,1
S01009003,Rented or living rent free: Total,68,42,31,6,25,8,3,26,19,1,3,3,0
S01009003,Rented or living rent free: Social rented,24,9,7,1,6,0,2,15,12,1,0,2,0
S01009003,Rented or living rent free: Private rented or living rent free,44,33,24,5,19,8,1,11,7,0,3,1,0
S01009004,All HRPs aged 16 and over,270,198,166,21,145,30,2,72,65,0,4,3,0
S01009004,Owned: Total,232,171,144,10,134,25,2,61,58,0,1,2,0
S01009004,Owned: Owned outright,90,36,26,5,21,8,2,54,52,0,1,1,0
S01009004,Owned: Owned with a mortgage or loan or shared ownership,142,135,118,5,113,17,0,7,6,0,0,1,0
S01009004,Rented or living rent free: Total,38,27,22,11,11,5,0,11,7,0,3,1,0
S01009004,Rented or living rent free: Social rented,15,9,7,4,3,2,0,6,5,0,0,1,0
S01009004,Rented or living rent free: Private rented or living rent free,23,18,15,7,8,3,0,5,2,0,3,0,0
S01009005,All HRPs aged 16 and over,327,239,207,30,177,24,8,88,79,0,1,8,0
S01009005,Owned: Total,281,204,182,18,164,18,4,77,76,0,0,1,0
S01009005,Owned: Owned outright,108,41,32,4,28,7,2,67,66,0,0,1,0
S01009005,Owned: Owned with a mortgage or loan or shared ownership,173,163,150,14,136,11,2,10,10,0,0,0,0
S01009005,Rented or living rent free: Total,46,35,25,12,13,6,4,11,3,0,1,7,0
S01009005,Rented or living rent free: Social rented,9,5,3,2,1,1,1,4,1,0,1,2,0
S01009005,Rented or living rent free: Private rented or living rent free,37,30,22,10,12,5,3,7,2,0,0,5,0
S01009006,All HRPs aged 16 and over,318,186,160,24,136,20,6,132,105,1,16,8,2
S01009006,Owned: Total,241,147,131,14,117,15,1,94,90,0,1,1,2
S01009006,Owned: Owned outright,113,33,28,4,24,4,1,80,79,0,0,1,0
S01009006,Owned: Owned with a mortgage or loan or shared ownership,128,114,103,10,93,11,0,14,11,0,1,0,2
S01009006,Rented or living rent free: Total,77,39,29,10,19,5,5,38,15,1,15,7,0
S01009006,Rented or living rent free: Social rented,44,18,14,6,8,3,1,26,11,0,9,6,0
S01009006,Rented or living rent free: Private rented or living rent free,33,21,15,4,11,2,4,12,4,1,6,1,0
S01009007,All HRPs aged 16 and over,290,184,160,25,135,19,5,106,78,1,12,11,4
S01009007,Owned: Total,219,146,131,16,115,15,0,73,66,1,1,2,3
S01009007,Owned: Owned outright,99,35,32,2,30,3,0,64,60,0,1,1,2
S01009007,Owned: Owned with a mortgage or loan or shared ownership,120,111,99,14,85,12,0,9,6,1,0,1,1
S01009007,Rented or living rent free: Total,71,38,29,9,20,4,5,33,12,0,11,9,1
S01009007,Rented or living rent free: Social rented,42,23,17,6,11,3,3,19,7,0,4,7,1
S01009007,Rented or living rent free: Private rented or living rent free,29,15,12,3,9,1,2,14,5,0,7,2,0
S01009008,All HRPs aged 16 and over,445,276,228,29,199,40,8,169,155,0,3,10,1
S01009008,Owned: Total,331,196,161,17,144,34,1,135,130,0,3,1,1
S01009008,Owned: Owned outright,188,62,47,7,40,15,0,126,121,0,3,1,1
S01009008,Owned: Owned with a mortgage or loan or shared ownership,143,134,114,10,104,19,1,9,9,0,0,0,0
S01009008,Rented or living rent free: Total,114,80,67,12,55,6,7,34,25,0,0,9,0
S01009008,Rented or living rent free: Social rented,51,32,27,8,19,2,3,19,13,0,0,6,0
S01009008,Rented or living rent free: Private rented or living rent free,63,48,40,4,36,4,4,15,12,0,0,3,0
S01009009,All HRPs aged 16 and over,252,144,123,27,96,13,8,108,78,3,9,15,3
S01009009,Owned: Total,122,92,81,10,71,10,1,30,23,1,2,3,1
S01009009,Owned: Owned outright,48,23,22,5,17,1,0,25,20,0,2,3,0
S01009009,Owned: Owned with a mortgage or loan or shared ownership,74,69,59,5,54,9,1,5,3,1,0,0,1
S01009009,Rented or living rent free: Total,130,52,42,17,25,3,7,78,55,2,7,12,2
S01009009,Rented or living rent free: Social rented,99,33,27,12,15,2,4,66,49,2,4,9,2
S01009009,Rented or living rent free: Private rented or living rent free,31,19,15,5,10,1,3,12,6,0,3,3,0
S01009010,All HRPs aged 16 and over,404,335,298,42,256,32,5,69,58,2,5,3,1
S01009010,Owned: Total,321,265,237,25,212,27,1,56,54,0,1,0,1
S01009010,Owned: Owned outright,115,61,52,12,40,9,0,54,52,0,1,0,1
S01009010,Owned: Owned with a mortgage or loan or shared ownership,206,204,185,13,172,18,1,2,2,0,0,0,0
S01009010,Rented or living rent free: Total,83,70,61,17,44,5,4,13,4,2,4,3,0
S01009010,Rented or living rent free: Social rented,35,27,22,4,18,3,2,8,4,0,2,2,0
S01009010,Rented or living rent free: Private rented or living rent free,48,43,39,13,26,2,2,5,0,2,2,1,0
S01009011,All HRPs aged 16 and over,319,282,249,19,230,28,5,37,33,0,0,3,1
S01009011,Owned: Total,291,258,235,16,219,22,1,33,31,0,0,1,1
S01009011,Owned: Owned outright,83,59,53,12,41,6,0,24,24,0,0,0,0
S01009011,Owned: Owned with a mortgage or loan or shared ownership,208,199,182,4,178,16,1,9,7,0,0,1,1
S01009011,Rented or living rent free: Total,28,24,14,3,11,6,4,4,2,0,0,2,0
S01009011,Rented or living rent free: Social rented,5,3,3,0,3,0,0,2,1,0,0,1,0
S01009011,Rented or living rent free: Private rented or living rent free,23,21,11,3,8,6,4,2,1,0,0,1,0
S01009012,All HRPs aged 16 and over,296,238,204,20,184,34,0,58,53,1,2,1,1
S01009012,Owned: Total,274,222,191,17,174,31,0,52,51,0,0,1,0
S01009012,Owned: Owned outright,110,60,48,8,40,12,0,50,49,0,0,1,0
S01009012,Owned: Owned with a mortgage or loan or shared ownership,164,162,143,9,134,19,0,2,2,0,0,0,0
S01009012,Rented or living rent free: Total,22,16,13,3,10,3,0,6,2,1,2,0,1
S01009012,Rented or living rent free: Social rented,3,1,1,0,1,0,0,2,0,1,0,0,1
S01009012,Rented or living rent free: Private rented or living rent free,19,15,12,3,9,3,0,4,2,0,2,0,0
S01009013,All HRPs aged 16 and over,363,287,248,26,222,33,6,76,68,1,4,2,1
S01009013,Owned: Total,320,256,225,21,204,29,2,64,62,0,2,0,0
S01009013,Owned: Owned outright,113,63,51,7,44,11,1,50,48,0,2,0,0
S01009013,Owned: Owned with a mortgage or loan or shared ownership,207,193,174,14,160,18,1,14,14,0,0,0,0
S01009013,Rented or living rent free: Total,43,31,23,5,18,4,4,12,6,1,2,2,1
S01009013,Rented or living rent free: Social rented,15,7,3,1,2,2,2,8,4,0,2,2,0
S01009013,Rented or living rent free: Private rented or living rent free,28,24,20,4,16,2,2,4,2,1,0,0,1
S01009014,All HRPs aged 16 and over,284,192,134,32,102,45,13,92,75,0,1,13,3
S01009014,Owned: Total,184,117,82,17,65,33,2,67,62,0,0,4,1
S01009014,Owned: Owned outright,109,56,38,11,27,18,0,53,49,0,0,4,0
S01009014,Owned: Owned with a mortgage or loan or shared ownership,75,61,44,6,38,15,2,14,13,0,0,0,1
S01009014,Rented or living rent free: Total,100,75,52,15,37,12,11,25,13,0,1,9,2
S01009014,Rented or living rent free: Social rented,69,49,33,12,21,5,11,20,10,0,1,8,1
S01009014,Rented or living rent free: Private rented or living rent free,31,26,19,3,16,7,0,5,3,0,0,1,1
S01009015,All HRPs aged 16 and over,303,187,142,41,101,36,9,116,105,0,2,3,6
S01009015,Owned: Total,224,125,95,19,76,30,0,99,94,0,0,1,4
S01009015,Owned: Owned outright,161,73,54,16,38,19,0,88,84,0,0,1,3
S01009015,Owned: Owned with a mortgage or loan or shared ownership,63,52,41,3,38,11,0,11,10,0,0,0,1
S01009015,Rented or living rent free: Total,79,62,47,22,25,6,9,17,11,0,2,2,2
S01009015,Rented or living rent free: Social rented,48,38,29,17,12,3,6,10,6,0,2,2,0
S01009015,Rented or living rent free: Private rented or living rent free,31,24,18,5,13,3,3,7,5,0,0,0,2
S01009016,All HRPs aged 16 and over,250,142,108,15,93,29,5,108,98,0,1,5,4
S01009016,Owned: Total,201,109,83,10,73,22,4,92,85,0,0,3,4
S01009016,Owned: Owned outright,147,65,49,7,42,12,4,82,76,0,0,3,3
S01009016,Owned: Owned with a mortgage or loan or shared ownership,54,44,34,3,31,10,0,10,9,0,0,0,1
S01009016,Rented or living rent free: Total,49,33,25,5,20,7,1,16,13,0,1,2,0
S01009016,Rented or living rent free: Social rented,28,20,17,4,13,2,1,8,5,0,1,2,0
S01009016,Rented or living rent free: Private rented or living rent free,21,13,8,1,7,5,0,8,8,0,0,0,0
S01009017,All HRPs aged 16 and over,278,176,128,18,110,29,19,102,73,0,6,16,7
S01009017,Owned: Total,165,101,76,8,68,20,5,64,58,0,0,4,2
S01009017,Owned: Owned outright,93,41,32,6,26,5,4,52,49,0,0,2,1
S01009017,Owned: Owned with a mortgage or loan or shared ownership,72,60,44,2,42,15,1,12,9,0,0,2,1
S01009017,Rented or living rent free: Total,113,75,52,10,42,9,14,38,15,0,6,12,5
S01009017,Rented or living rent free: Social rented,83,50,35,7,28,6,9,33,10,0,6,12,5
S01009017,Rented or living rent free: Private rented or living rent free,30,25,17,3,14,3,5,5,5,0,0,0,0
S01009018,All HRPs aged 16 and over,326,231,178,28,150,45,8,95,71,4,1,12,7
S01009018,Owned: Total,231,161,123,14,109,37,1,70,59,1,0,6,4
S01009018,Owned: Owned outright,153,92,65,8,57,26,1,61,52,0,0,5,4
S01009018,Owned: Owned with a mortgage or loan or shared ownership,78,69,58,6,52,11,0,9,7,1,0,1,0
S01009018,Rented or living rent free: Total,95,70,55,14,41,8,7,25,12,3,1,6,3
S01009018,Rented or living rent free: Social rented,60,45,34,12,22,5,6,15,8,0,1,4,2
S01009018,Rented or living rent free: Private rented or living rent free,35,25,21,2,19,3,1,10,4,3,0,2,1
S01009019,All HRPs aged 16 and over,221,162,130,27,103,26,6,59,51,3,0,4,1
S01009019,Owned: Total,165,118,91,18,73,24,3,47,44,0,0,2,1
S01009019,Owned: Owned outright,105,65,43,14,29,19,3,40,37,0,0,2,1
S01009019,Owned: Owned with a mortgage or loan or shared ownership,60,53,48,4,44,5,0,7,7,0,0,0,0
S01009019,Rented or living rent free: Total,56,44,39,9,30,2,3,12,7,3,0,2,0
S01009019,Rented or living rent free: Social rented,40,31,26,9,17,2,3,9,6,1,0,2,0
S01009019,Rented or living rent free: Private rented or living rent free,16,13,13,0,13,0,0,3,1,2,0,0,0
S01009020,All HRPs aged 16 and over,366,284,233,42,191,34,17,82,65,1,6,8,2
S01009020,Owned: Total,229,174,142,21,121,27,5,55,53,1,0,1,0
S01009020,Owned: Owned outright,126,75,57,15,42,14,4,51,50,1,0,0,0
S01009020,Owned: Owned with a mortgage or loan or shared ownership,103,99,85,6,79,13,1,4,3,0,0,1,0
S01009020,Rented or living rent free: Total,137,110,91,21,70,7,12,27,12,0,6,7,2
S01009020,Rented or living rent free: Social rented,75,57,45,15,30,2,10,18,8,0,6,4,0
S01009020,Rented or living rent free: Private rented or living rent free,62,53,46,6,40,5,2,9,4,0,0,3,2
S01009021,All HRPs aged 16 and over,344,214,152,38,114,56,6,130,118,0,2,5,5
S01009021,Owned: Total,274,164,111,26,85,50,3,110,106,0,1,1,2
S01009021,Owned: Owned outright,186,88,57,22,35,31,0,98,94,0,1,1,2
S01009021,Owned: Owned with a mortgage or loan or shared ownership,88,76,54,4,50,19,3,12,12,0,0,0,0
S01009021,Rented or living rent free: Total,70,50,41,12,29,6,3,20,12,0,1,4,3
S01009021,Rented or living rent free: Social rented,37,25,21,10,11,2,2,12,6,0,1,2,3
S01009021,Rented or living rent free: Private rented or living rent free,33,25,20,2,18,4,1,8,6,0,0,2,0
S01009022,All HRPs aged 16 and over,447,275,198,35,163,59,18,172,154,1,4,5,8
S01009022,Owned: Total,328,204,147,25,122,50,7,124,117,0,2,3,2
S01009022,Owned: Owned outright,229,113,75,17,58,34,4,116,110,0,2,2,2
S01009022,Owned: Owned with a mortgage or loan or shared ownership,99,91,72,8,64,16,3,8,7,0,0,1,0
S01009022,Rented or living rent free: Total,119,71,51,10,41,9,11,48,37,1,2,2,6
S01009022,Rented or living rent free: Social rented,80,45,34,8,26,3,8,35,27,0,2,1,5
S01009022,Rented or living rent free: Private rented or living rent free,39,26,17,2,15,6,3,13,10,1,0,1,1
S01009023,All HRPs aged 16 and over,435,247,148,35,113,87,12,188,166,0,5,10,7
S01009023,Owned: Total,354,192,118,27,91,67,7,162,147,0,3,7,5
S01009023,Owned: Owned outright,287,137,85,22,63,45,7,150,137,0,2,6,5
S01009023,Owned: Owned with a mortgage or loan or shared ownership,67,55,33,5,28,22,0,12,10,0,1,1,0
S01009023,Rented or living rent free: Total,81,55,30,8,22,20,5,26,19,0,2,3,2
S01009023,Rented or living rent free: Social rented,49,30,18,6,12,9,3,19,12,0,2,3,2
S01009023,Rented or living rent free: Private rented or living rent free,32,25,12,2,10,11,2,7,7,0,0,0,0
S01009024,All HRPs aged 16 and over,476,264,198,35,163,54,12,212,191,1,3,11,6
S01009024,Owned: Total,329,167,119,14,105,46,2,162,152,1,1,5,3
S01009024,Owned: Owned outright,245,95,68,11,57,25,2,150,143,0,1,3,3
S01009024,Owned: Owned with a mortgage or loan or shared ownership,84,72,51,3,48,21,0,12,9,1,0,2,0
S01009024,Rented or living rent free: Total,147,97,79,21,58,8,10,50,39,0,2,6,3
S01009024,Rented or living rent free: Social rented,102,58,46,10,36,5,7,44,34,0,2,5,3
S01009024,Rented or living rent free: Private rented or living rent free,45,39,33,11,22,3,3,6,5,0,0,1,0
S01009025,All HRPs aged 16 and over,433,278,190,45,145,70,18,155,128,2,8,11,6
S01009025,Owned: Total,359,227,151,34,117,65,11,132,117,1,4,6,4
S01009025,Owned: Owned outright,253,135,90,29,61,37,8,118,107,0,2,6,3
S01009025,Owned: Owned with a mortgage or loan or shared ownership,106,92,61,5,56,28,3,14,10,1,2,0,1
S01009025,Rented or living rent free: Total,74,51,39,11,28,5,7,23,11,1,4,5,2
S01009025,Rented or living rent free: Social rented,42,24,16,8,8,1,7,18,7,1,4,4,2
S01009025,Rented or living rent free: Private rented or living rent free,32,27,23,3,20,4,0,5,4,0,0,1,0
S01009026,All HRPs aged 16 and over,411,249,183,35,148,48,18,162,134,5,4,14,5
S01009026,Owned: Total,338,204,155,29,126,40,9,134,123,1,2,6,2
S01009026,Owned: Owned outright,222,104,72,20,52,26,6,118,111,0,2,4,1
S01009026,Owned: Owned with a mortgage or loan or shared ownership,116,100,83,9,74,14,3,16,12,1,0,2,1
S01009026,Rented or living rent free: Total,73,45,28,6,22,8,9,28,11,4,2,8,3
S01009026,Rented or living rent free: Social rented,36,21,9,2,7,5,7,15,6,0,2,4,3
S01009026,Rented or living rent free: Private rented or living rent free,37,24,19,4,15,3,2,13,5,4,0,4,0
S01009027,All HRPs aged 16 and over,373,221,151,32,119,59,11,152,143,0,3,4,2
S01009027,Owned: Total,308,174,118,23,95,49,7,134,130,0,2,1,1
S01009027,Owned: Owned outright,232,103,60,16,44,37,6,129,127,0,0,1,1
S01009027,Owned: Owned with a mortgage or loan or shared ownership,76,71,58,7,51,12,1,5,3,0,2,0,0
S01009027,Rented or living rent free: Total,65,47,33,9,24,10,4,18,13,0,1,3,1
S01009027,Rented or living rent free: Social rented,36,27,20,7,13,4,3,9,7,0,0,1,1
S01009027,Rented or living rent free: Private rented or living rent free,29,20,13,2,11,6,1,9,6,0,1,2,0
S01009028,All HRPs aged 16 and over,232,133,91,15,76,33,9,99,90,0,0,8,1
S01009028,Owned: Total,192,107,71,11,60,31,5,85,82,0,0,2,1
S01009028,Owned: Owned outright,132,60,33,3,30,24,3,72,71,0,0,0,1
S01009028,Owned: Owned with a mortgage or loan or shared ownership,60,47,38,8,30,7,2,13,11,0,0,2,0
S01009028,Rented or living rent free: Total,40,26,20,4,16,2,4,14,8,0,0,6,0
S01009028,Rented or living rent free: Social rented,28,17,12,3,9,1,4,11,6,0,0,5,0
S01009028,Rented or living rent free: Private rented or living rent free,12,9,8,1,7,1,0,3,2,0,0,1,0
S01009029,All HRPs aged 16 and over,286,174,121,21,100,38,15,112,96,0,6,8,2
S01009029,Owned: Total,221,135,94,17,77,36,5,86,81,0,1,3,1
S01009029,Owned: Owned outright,149,75,50,10,40,21,4,74,70,0,1,2,1
S01009029,Owned: Owned with a mortgage or loan or shared ownership,72,60,44,7,37,15,1,12,11,0,0,1,0
S01009029,Rented or living rent free: Total,65,39,27,4,23,2,10,26,15,0,5,5,1
S01009029,Rented or living rent free: Social rented,41,22,14,2,12,1,7,19,9,0,5,4,1
S01009029,Rented or living rent free: Private rented or living rent free,24,17,13,2,11,1,3,7,6,0,0,1,0
S01009030,All HRPs aged 16 and over,321,203,149,27,122,43,11,118,98,1,1,13,5
S01009030,Owned: Total,251,151,116,17,99,31,4,100,92,0,0,6,2
S01009030,Owned: Owned outright,177,91,66,14,52,21,4,86,79,0,0,6,1
S01009030,Owned: Owned with a mortgage or loan or shared ownership,74,60,50,3,47,10,0,14,13,0,0,0,1
S01009030,Rented or living rent free: Total,70,52,33,10,23,12,7,18,6,1,1,7,3
S01009030,Rented or living rent free: Social rented,52,36,20,7,13,9,7,16,4,1,1,7,3
S01009030,Rented or living rent free: Private rented or living rent free,18,16,13,3,10,3,0,2,2,0,0,0,0
S01009031,All HRPs aged 16 and over,356,216,176,31,145,32,8,140,131,1,1,4,3
S01009031,Owned: Total,269,162,131,20,111,28,3,107,102,1,0,3,1
S01009031,Owned: Owned outright,189,92,70,14,56,19,3,97,93,1,0,2,1
S01009031,Owned: Owned with a mortgage or loan or shared ownership,80,70,61,6,55,9,0,10,9,0,0,1,0
S01009031,Rented or living rent free: Total,87,54,45,11,34,4,5,33,29,0,1,1,2
S01009031,Rented or living rent free: Social rented,45,24,21,7,14,1,2,21,19,0,0,1,1
S01009031,Rented or living rent free: Private rented or living rent free,42,30,24,4,20,3,3,12,10,0,1,0,1
S01009032,All HRPs aged 16 and over,299,157,125,23,102,29,3,142,126,2,4,7,3
S01009032,Owned: Total,252,127,103,19,84,23,1,125,113,0,2,7,3
S01009032,Owned: Owned outright,179,70,55,10,45,14,1,109,100,0,2,5,2
S01009032,Owned: Owned with a mortgage or loan or shared ownership,73,57,48,9,39,9,0,16,13,0,0,2,1
S01009032,Rented or living rent free: Total,47,30,22,4,18,6,2,17,13,2,2,0,0
S01009032,Rented or living rent free: Social rented,19,11,7,2,5,2,2,8,5,2,1,0,0
S01009032,Rented or living rent free: Private rented or living rent free,28,19,15,2,13,4,0,9,8,0,1,0,0
S01009033,All HRPs aged 16 and over,359,204,148,32,116,47,9,155,136,1,3,9,6
S01009033,Owned: Total,318,173,122,27,95,45,6,145,129,1,2,7,6
S01009033,Owned: Owned outright,230,101,68,19,49,28,5,129,114,1,1,7,6
S01009033,Owned: Owned with a mortgage or loan or shared ownership,88,72,54,8,46,17,1,16,15,0,1,0,0
S01009033,Rented or living rent free: Total,41,31,26,5,21,2,3,10,7,0,1,2,0
S01009033,Rented or living rent free: Social rented,12,9,7,2,5,0,2,3,1,0,1,1,0
S01009033,Rented or living rent free: Private rented or living rent free,29,22,19,3,16,2,1,7,6,0,0,1,0
S01009034,All HRPs aged 16 and over,283,160,132,22,110,24,4,123,110,1,1,8,3
S01009034,Owned: Total,243,130,107,17,90,20,3,113,106,0,0,4,3
S01009034,Owned: Owned outright,162,57,43,12,31,12,2,105,98,0,0,4,3
S01009034,Owned: Owned with a mortgage or loan or shared ownership,81,73,64,5,59,8,1,8,8,0,0,0,0
S01009034,Rented or living rent free: Total,40,30,25,5,20,4,1,10,4,1,1,4,0
S01009034,Rented or living rent free: Social rented,18,10,10,3,7,0,0,8,3,1,0,4,0
S01009034,Rented or living rent free: Private rented or living rent free,22,20,15,2,13,4,1,2,1,0,1,0,0
S01009035,All HRPs aged 16 and over,381,239,189,21,168,44,6,142,127,0,5,8,2
S01009035,Owned: Total,319,196,156,16,140,38,2,123,113,0,3,5,2
S01009035,Owned: Owned outright,184,73,58,13,45,14,1,111,106,0,1,3,1
S01009035,Owned: Owned with a mortgage or loan or shared ownership,135,123,98,3,95,24,1,12,7,0,2,2,1
S01009035,Rented or living rent free: Total,62,43,33,5,28,6,4,19,14,0,2,3,0
S01009035,Rented or living rent free: Social rented,41,23,15,5,10,4,4,18,13,0,2,3,0
S01009035,Rented or living rent free: Private rented or living rent free,21,20,18,0,18,2,0,1,1,0,0,0,0
S01009036,All HRPs aged 16 and over,437,305,245,27,218,48,12,132,101,2,6,18,5
S01009036,Owned: Total,308,219,177,14,163,38,4,89,80,0,2,3,4
S01009036,Owned: Owned outright,157,79,60,7,53,18,1,78,73,0,1,2,2
S01009036,Owned: Owned with a mortgage or loan or shared ownership,151,140,117,7,110,20,3,11,7,0,1,1,2
S01009036,Rented or living rent free: Total,129,86,68,13,55,10,8,43,21,2,4,15,1
S01009036,Rented or living rent free: Social rented,87,51,38,10,28,7,6,36,16,2,3,14,1
S01009036,Rented or living rent free: Private rented or living rent free,42,35,30,3,27,3,2,7,5,0,1,1,0
S01009037,All HRPs aged 16 and over,367,262,212,31,181,38,12,105,86,2,5,11,1
S01009037,Owned: Total,266,182,148,17,131,31,3,84,78,0,3,3,0
S01009037,Owned: Owned outright,142,64,51,12,39,11,2,78,74,0,2,2,0
S01009037,Owned: Owned with a mortgage or loan or shared ownership,124,118,97,5,92,20,1,6,4,0,1,1,0
S01009037,Rented or living rent free: Total,101,80,64,14,50,7,9,21,8,2,2,8,1
S01009037,Rented or living rent free: Social rented,81,61,49,13,36,5,7,20,7,2,2,8,1
S01009037,Rented or living rent free: Private rented or living rent free,20,19,15,1,14,2,2,1,1,0,0,0,0
S01009038,All HRPs aged 16 and over,440,317,258,49,209,49,10,123,98,0,6,11,8
S01009038,Owned: Total,319,232,186,28,158,46,0,87,84,0,1,2,0
S01009038,Owned: Owned outright,172,92,67,19,48,25,0,80,77,0,1,2,0
S01009038,Owned: Owned with a mortgage or loan or shared ownership,147,140,119,9,110,21,0,7,7,0,0,0,0
S01009038,Rented or living rent free: Total,121,85,72,21,51,3,10,36,14,0,5,9,8
S01009038,Rented or living rent free: Social rented,80,52,42,15,27,1,9,28,12,0,5,8,3
S01009038,Rented or living rent free: Private rented or living rent free,41,33,30,6,24,2,1,8,2,0,0,1,5
S01009039,All HRPs aged 16 and over,313,223,177,49,128,25,21,90,58,3,8,13,8
S01009039,Owned: Total,138,94,83,19,64,9,2,44,40,1,0,2,1
S01009039,Owned: Owned outright,85,43,38,13,25,5,0,42,40,0,0,1,1
S01009039,Owned: Owned with a mortgage or loan or shared ownership,53,51,45,6,39,4,2,2,0,1,0,1,0
S01009039,Rented or living rent free: Total,175,129,94,30,64,16,19,46,18,2,8,11,7
S01009039,Rented or living rent free: Social rented,155,110,80,28,52,13,17,45,17,2,8,11,7
S01009039,Rented or living rent free: Private rented or living rent free,20,19,14,2,12,3,2,1,1,0,0,0,0
S01009040,All HRPs aged 16 and over,338,197,160,28,132,28,9,141,121,3,3,10,4
S01009040,Owned: Total,187,115,92,13,79,21,2,72,70,0,0,0,2
S01009040,Owned: Owned outright,103,39,28,8,20,9,2,64,62,0,0,0,2
S01009040,Owned: Owned with a mortgage or loan or shared ownership,84,76,64,5,59,12,0,8,8,0,0,0,0
S01009040,Rented or living rent free: Total,151,82,68,15,53,7,7,69,51,3,3,10,2
S01009040,Rented or living rent free: Social rented,105,48,39,11,28,3,6,57,46,2,1,8,0
S01009040,Rented or living rent free: Private rented or living rent free,46,34,29,4,25,4,1,12,5,1,2,2,2
S01009041,All HRPs aged 16 and over,503,299,236,34,202,47,16,204,173,3,2,18,8
S01009041,Owned: Total,248,161,123,12,111,33,5,87,85,0,1,1,0
S01009041,Owned: Owned outright,139,60,40,6,34,18,2,79,79,0,0,0,0
S01009041,Owned: Owned with a mortgage or loan or shared ownership,109,101,83,6,77,15,3,8,6,0,1,1,0
S01009041,Rented or living rent free: Total,255,138,113,22,91,14,11,117,88,3,1,17,8
S01009041,Rented or living rent free: Social rented,154,54,42,14,28,6,6,100,74,3,0,15,8
S01009041,Rented or living rent free: Private rented or living rent free,101,84,71,8,63,8,5,17,14,0,1,2,0
S01009042,All HRPs aged 16 and over,401,282,234,42,192,29,19,119,101,2,4,9,3
S01009042,Owned: Total,255,180,154,23,131,23,3,75,72,0,0,1,2
S01009042,Owned: Owned outright,132,64,50,14,36,11,3,68,66,0,0,1,1
S01009042,Owned: Owned with a mortgage or loan or shared ownership,123,116,104,9,95,12,0,7,6,0,0,0,1
S01009042,Rented or living rent free: Total,146,102,80,19,61,6,16,44,29,2,4,8,1
S01009042,Rented or living rent free: Social rented,108,71,54,16,38,5,12,37,22,2,4,8,1
S01009042,Rented or living rent free: Private rented or living rent free,38,31,26,3,23,1,4,7,7,0,0,0,0
S01009043,All HRPs aged 16 and over,293,206,172,42,130,24,10,87,70,0,1,15,1
S01009043,Owned: Total,166,121,103,24,79,17,1,45,45,0,0,0,0
S01009043,Owned: Owned outright,99,60,49,15,34,11,0,39,39,0,0,0,0
S01009043,Owned: Owned with a mortgage or loan or shared ownership,67,61,54,9,45,6,1,6,6,0,0,0,0
S01009043,Rented or living rent free: Total,127,85,69,18,51,7,9,42,25,0,1,15,1
S01009043,Rented or living rent free: Social rented,104,66,52,17,35,6,8,38,21,0,1,15,1
S01009043,Rented or living rent free: Private rented or living rent free,23,19,17,1,16,1,1,4,4,0,0,0,0
S01009044,All HRPs aged 16 and over,412,217,180,35,145,28,9,195,171,0,5,13,6
S01009044,Owned: Total,259,139,118,16,102,19,2,120,118,0,0,0,2
S01009044,Owned: Owned outright,167,56,44,9,35,11,1,111,109,0,0,0,2
S01009044,Owned: Owned with a mortgage or loan or shared ownership,92,83,74,7,67,8,1,9,9,0,0,0,0
S01009044,Rented or living rent free: Total,153,78,62,19,43,9,7,75,53,0,5,13,4
S01009044,Rented or living rent free: Social rented,117,48,37,16,21,7,4,69,48,0,5,12,4
S01009044,Rented or living rent free: Private rented or living rent free,36,30,25,3,22,2,3,6,5,0,0,1,0
S01009045,All HRPs aged 16 and over,287,181,143,27,116,31,7,106,85,2,3,13,3
S01009045,Owned: Total,184,122,93,15,78,27,2,62,58,0,1,2,1
S01009045,Owned: Owned outright,110,55,37,10,27,16,2,55,53,0,1,1,0
S01009045,Owned: Owned with a mortgage or loan or shared ownership,74,67,56,5,51,11,0,7,5,0,0,1,1
S01009045,Rented or living rent free: Total,103,59,50,12,38,4,5,44,27,2,2,11,2
S01009045,Rented or living rent free: Social rented,66,29,22,9,13,2,5,37,21,1,2,11,2
S01009045,Rented or living rent free: Private rented or living rent free,37,30,28,3,25,2,0,7,6,1,0,0,0
S01009046,All HRPs aged 16 and over,363,250,201,24,177,40,9,113,99,0,3,11,0
S01009046,Owned: Total,292,200,162,18,144,35,3,92,88,0,0,4,0
S01009046,Owned: Owned outright,160,74,56,14,42,18,0,86,83,0,0,3,0
S01009046,Owned: Owned with a mortgage or loan or shared ownership,132,126,106,4,102,17,3,6,5,0,0,1,0
S01009046,Rented or living rent free: Total,71,50,39,6,33,5,6,21,11,0,3,7,0
S01009046,Rented or living rent free: Social rented,33,19,17,4,13,0,2,14,7,0,1,6,0
S01009046,Rented or living rent free: Private rented or living rent free,38,31,22,2,20,5,4,7,4,0,2,1,0
S01009047,All HRPs aged 16 and over,336,229,191,30,161,30,8,107,98,0,2,6,1
S01009047,Owned: Total,279,186,153,20,133,29,4,93,89,0,0,3,1
S01009047,Owned: Owned outright,152,70,56,12,44,12,2,82,80,0,0,1,1
S01009047,Owned: Owned with a mortgage or loan or shared ownership,127,116,97,8,89,17,2,11,9,0,0,2,0
S01009047,Rented or living rent free: Total,57,43,38,10,28,1,4,14,9,0,2,3,0
S01009047,Rented or living rent free: Social rented,30,21,17,9,8,0,4,9,6,0,0,3,0
S01009047,Rented or living rent free: Private rented or living rent free,27,22,21,1,20,1,0,5,3,0,2,0,0
S01009048,All HRPs aged 16 and over,348,230,202,29,173,23,5,118,101,8,1,4,4
S01009048,Owned: Total,308,197,177,23,154,19,1,111,98,6,1,3,3
S01009048,Owned: Owned outright,190,85,73,14,59,11,1,105,94,6,0,2,3
S01009048,Owned: Owned with a mortgage or loan or shared ownership,118,112,104,9,95,8,0,6,4,0,1,1,0
S01009048,Rented or living rent free: Total,40,33,25,6,19,4,4,7,3,2,0,1,1
S01009048,Rented or living rent free: Social rented,25,20,16,5,11,3,1,5,2,2,0,1,0
S01009048,Rented or living rent free: Private rented or living rent free,15,13,9,1,8,1,3,2,1,0,0,0,1
S01009049,All HRPs aged 16 and over,274,165,137,14,123,27,1,109,98,1,1,8,1
S01009049,Owned: Total,228,137,112,11,101,24,1,91,89,0,0,2,0
S01009049,Owned: Owned outright,136,57,44,8,36,13,0,79,77,0,0,2,0
S01009049,Owned: Owned with a mortgage or loan or shared ownership,92,80,68,3,65,11,1,12,12,0,0,0,0
S01009049,Rented or living rent free: Total,46,28,25,3,22,3,0,18,9,1,1,6,1
S01009049,Rented or living rent free: Social rented,26,16,14,2,12,2,0,10,6,0,1,2,1
S01009049,Rented or living rent free: Private rented or living rent free,20,12,11,1,10,1,0,8,3,1,0,4,0
S01009050,All HRPs aged 16 and over,370,238,204,26,178,25,9,132,112,0,3,11,6
S01009050,Owned: Total,272,201,176,21,155,22,3,71,67,0,0,3,1
S01009050,Owned: Owned outright,115,52,44,14,30,6,2,63,62,0,0,1,0
S01009050,Owned: Owned with a mortgage or loan or shared ownership,157,149,132,7,125,16,1,8,5,0,0,2,1
S01009050,Rented or living rent free: Total,98,37,28,5,23,3,6,61,45,0,3,8,5
S01009050,Rented or living rent free: Social rented,73,19,13,5,8,3,3,54,42,0,2,6,4
S01009050,Rented or living rent free: Private rented or living rent free,25,18,15,0,15,0,3,7,3,0,1,2,1
S01009051,All HRPs aged 16 and over,292,208,167,21,146,32,9,84,63,1,11,6,3
S01009051,Owned: Total,201,159,130,10,120,28,1,42,41,0,1,0,0
S01009051,Owned: Owned outright,54,23,21,5,16,2,0,31,30,0,1,0,0
S01009051,Owned: Owned with a mortgage or loan or shared ownership,147,136,109,5,104,26,1,11,11,0,0,0,0
S01009051,Rented or living rent free: Total,91,49,37,11,26,4,8,42,22,1,10,6,3
S01009051,Rented or living rent free: Social rented,74,40,30,8,22,2,8,34,19,1,6,5,3
S01009051,Rented or living rent free: Private rented or living rent free,17,9,7,3,4,2,0,8,3,0,4,1,0
S01009052,All HRPs aged 16 and over,305,185,146,23,123,31,8,120,106,0,1,11,2
S01009052,Owned: Total,221,145,118,17,101,25,2,76,72,0,1,2,1
S01009052,Owned: Owned outright,99,37,31,9,22,6,0,62,60,0,0,2,0
S01009052,Owned: Owned with a mortgage or loan or shared ownership,122,108,87,8,79,19,2,14,12,0,1,0,1
S01009052,Rented or living rent free: Total,84,40,28,6,22,6,6,44,34,0,0,9,1
S01009052,Rented or living rent free: Social rented,54,23,14,3,11,3,6,31,24,0,0,6,1
S01009052,Rented or living rent free: Private rented or living rent free,30,17,14,3,11,3,0,13,10,0,0,3,0
S01009053,All HRPs aged 16 and over,259,156,112,29,83,8,36,103,41,0,12,36,14
S01009053,Owned: Total,65,50,45,7,38,4,1,15,12,0,0,2,1
S01009053,Owned: Owned outright,20,6,5,1,4,1,0,14,11,0,0,2,1
S01009053,Owned: Owned with a mortgage or loan or shared ownership,45,44,40,6,34,3,1,1,1,0,0,0,0
S01009053,Rented or living rent free: Total,194,106,67,22,45,4,35,88,29,0,12,34,13
S01009053,Rented or living rent free: Social rented,187,101,63,21,42,4,34,86,27,0,12,34,13
S01009053,Rented or living rent free: Private rented or living rent free,7,5,4,1,3,0,1,2,2,0,0,0,0
S01009054,All HRPs aged 16 and over,249,160,143,25,118,12,5,89,70,0,3,12,4
S01009054,Owned: Total,158,112,102,15,87,9,1,46,43,0,0,1,2
S01009054,Owned: Owned outright,58,25,23,7,16,1,1,33,32,0,0,0,1
S01009054,Owned: Owned with a mortgage or loan or shared ownership,100,87,79,8,71,8,0,13,11,0,0,1,1
S01009054,Rented or living rent free: Total,91,48,41,10,31,3,4,43,27,0,3,11,2
S01009054,Rented or living rent free: Social rented,81,41,36,8,28,2,3,40,25,0,3,10,2
S01009054,Rented or living rent free: Private rented or living rent free,10,7,5,2,3,1,1,3,2,0,0,1,0
S01009055,All HRPs aged 16 and over,361,270,205,26,179,57,8,91,83,2,0,4,2
S01009055,Owned: Total,284,217,164,15,149,52,1,67,64,1,0,1,1
S01009055,Owned: Owned outright,119,62,35,8,27,27,0,57,56,0,0,1,0
S01009055,Owned: Owned with a mortgage or loan or shared ownership,165,155,129,7,122,25,1,10,8,1,0,0,1
S01009055,Rented or living rent free: Total,77,53,41,11,30,5,7,24,19,1,0,3,1
S01009055,Rented or living rent free: Social rented,57,36,25,10,15,4,7,21,17,0,0,3,1
S01009055,Rented or living rent free: Private rented or living rent free,20,17,16,1,15,1,0,3,2,1,0,0,0
S01009056,All HRPs aged 16 and over,217,127,95,17,78,21,11,90,55,4,10,16,5
S01009056,Owned: Total,105,76,59,4,55,16,1,29,28,0,0,0,1
S01009056,Owned: Owned outright,29,12,6,0,6,6,0,17,17,0,0,0,0
S01009056,Owned: Owned with a mortgage or loan or shared ownership,76,64,53,4,49,10,1,12,11,0,0,0,1
S01009056,Rented or living rent free: Total,112,51,36,13,23,5,10,61,27,4,10,16,4
S01009056,Rented or living rent free: Social rented,101,45,30,12,18,5,10,56,26,4,7,15,4
S01009056,Rented or living rent free: Private rented or living rent free,11,6,6,1,5,0,0,5,1,0,3,1,0
S01009057,All HRPs aged 16 and over,282,175,135,28,107,19,21,107,77,1,13,10,6
S01009057,Owned: Total,117,82,69,8,61,11,2,35,30,0,1,2,2
S01009057,Owned: Owned outright,40,16,14,5,9,2,0,24,24,0,0,0,0
S01009057,Owned: Owned with a mortgage or loan or shared ownership,77,66,55,3,52,9,2,11,6,0,1,2,2
S01009057,Rented or living rent free: Total,165,93,66,20,46,8,19,72,47,1,12,8,4
S01009057,Rented or living rent free: Social rented,137,75,57,19,38,2,16,62,41,0,11,8,2
S01009057,Rented or living rent free: Private rented or living rent free,28,18,9,1,8,6,3,10,6,1,1,0,2
S01009058,All HRPs aged 16 and over,385,222,194,28,166,17,11,163,125,2,4,32,0
S01009058,Owned: Total,210,154,140,11,129,12,2,56,53,0,1,2,0
S01009058,Owned: Owned outright,62,26,24,8,16,2,0,36,34,0,1,1,0
S01009058,Owned: Owned with a mortgage or loan or shared ownership,148,128,116,3,113,10,2,20,19,0,0,1,0
S01009058,Rented or living rent free: Total,175,68,54,17,37,5,9,107,72,2,3,30,0
S01009058,Rented or living rent free: Social rented,151,54,43,15,28,3,8,97,66,1,3,27,0
S01009058,Rented or living rent free: Private rented or living rent free,24,14,11,2,9,2,1,10,6,1,0,3,0
S01009059,All HRPs aged 16 and over,347,258,207,20,187,41,10,89,63,1,11,11,3
S01009059,Owned: Total,254,213,172,10,162,40,1,41,39,0,1,0,1
S01009059,Owned: Owned outright,62,31,24,2,22,7,0,31,29,0,1,0,1
S01009059,Owned: Owned with a mortgage or loan or shared ownership,192,182,148,8,140,33,1,10,10,0,0,0,0
S01009059,Rented or living rent free: Total,93,45,35,10,25,1,9,48,24,1,10,11,2
S01009059,Rented or living rent free: Social rented,69,30,21,9,12,0,9,39,22,0,5,10,2
S01009059,Rented or living rent free: Private rented or living rent free,24,15,14,1,13,1,0,9,2,1,5,1,0
S01009060,All HRPs aged 16 and over,188,167,132,6,126,34,1,21,19,0,0,2,0
S01009060,Owned: Total,171,154,124,5,119,29,1,17,16,0,0,1,0
S01009060,Owned: Owned outright,40,25,19,3,16,6,0,15,14,0,0,1,0
S01009060,Owned: Owned with a mortgage or loan or shared ownership,131,129,105,2,103,23,1,2,2,0,0,0,0
S01009060,Rented or living rent free: Total,17,13,8,1,7,5,0,4,3,0,0,1,0
S01009060,Rented or living rent free: Social rented,2,1,0,0,0,1,0,1,1,0,0,0,0
S01009060,Rented or living rent free: Private rented or living rent free,15,12,8,1,7,4,0,3,2,0,0,1,0
S01009061,All HRPs aged 16 and over,326,244,217,44,173,19,8,82,65,1,5,7,4
S01009061,Owned: Total,233,187,169,23,146,16,2,46,45,0,0,1,0
S01009061,Owned: Owned outright,71,35,32,8,24,3,0,36,36,0,0,0,0
S01009061,Owned: Owned with a mortgage or loan or shared ownership,162,152,137,15,122,13,2,10,9,0,0,1,0
S01009061,Rented or living rent free: Total,93,57,48,21,27,3,6,36,20,1,5,6,4
S01009061,Rented or living rent free: Social rented,84,50,43,19,24,1,6,34,20,1,3,6,4
S01009061,Rented or living rent free: Private rented or living rent free,9,7,5,2,3,2,0,2,0,0,2,0,0
S01009062,All HRPs aged 16 and over,297,177,147,35,112,11,19,120,89,1,8,15,7
S01009062,Owned: Total,166,101,92,15,77,7,2,65,55,1,4,3,2
S01009062,Owned: Owned outright,73,28,25,9,16,3,0,45,42,0,1,0,2
S01009062,Owned: Owned with a mortgage or loan or shared ownership,93,73,67,6,61,4,2,20,13,1,3,3,0
S01009062,Rented or living rent free: Total,131,76,55,20,35,4,17,55,34,0,4,12,5
S01009062,Rented or living rent free: Social rented,128,74,54,20,34,4,16,54,33,0,4,12,5
S01009062,Rented or living rent free: Private rented or living rent free,3,2,1,0,1,0,1,1,1,0,0,0,0
S01009063,All HRPs aged 16 and over,291,200,176,26,150,23,1,91,84,0,1,3,3
S01009063,Owned: Total,252,177,158,17,141,19,0,75,72,0,0,1,2
S01009063,Owned: Owned outright,121,49,43,6,37,6,0,72,69,0,0,1,2
S01009063,Owned: Owned with a mortgage or loan or shared ownership,131,128,115,11,104,13,0,3,3,0,0,0,0
S01009063,Rented or living rent free: Total,39,23,18,9,9,4,1,16,12,0,1,2,1
S01009063,Rented or living rent free: Social rented,28,15,11,5,6,3,1,13,9,0,1,2,1
S01009063,Rented or living rent free: Private rented or living rent free,11,8,7,4,3,1,0,3,3,0,0,0,0
S01009064,All HRPs aged 16 and over,264,167,144,13,131,11,12,97,78,0,6,10,3
S01009064,Owned: Total,177,119,111,6,105,7,1,58,58,0,0,0,0
S01009064,Owned: Owned outright,64,17,15,0,15,1,1,47,47,0,0,0,0
S01009064,Owned: Owned with a mortgage or loan or shared ownership,113,102,96,6,90,6,0,11,11,0,0,0,0
S01009064,Rented or living rent free: Total,87,48,33,7,26,4,11,39,20,0,6,10,3
S01009064,Rented or living rent free: Social rented,76,40,28,7,21,2,10,36,20,0,5,10,1
S01009064,Rented or living rent free: Private rented or living rent free,11,8,5,0,5,2,1,3,0,0,1,0,2
S01009065,All HRPs aged 16 and over,328,190,150,33,117,16,24,138,92,2,15,24,5
S01009065,Owned: Total,153,98,78,9,69,16,4,55,54,0,1,0,0
S01009065,Owned: Owned outright,68,19,15,4,11,3,1,49,49,0,0,0,0
S01009065,Owned: Owned with a mortgage or loan or shared ownership,85,79,63,5,58,13,3,6,5,0,1,0,0
S01009065,Rented or living rent free: Total,175,92,72,24,48,0,20,83,38,2,14,24,5
S01009065,Rented or living rent free: Social rented,140,70,54,22,32,0,16,70,35,2,13,16,4
S01009065,Rented or living rent free: Private rented or living rent free,35,22,18,2,16,0,4,13,3,0,1,8,1
S01009066,All HRPs aged 16 and over,319,193,162,31,131,15,16,126,100,1,3,15,7
S01009066,Owned: Total,189,123,109,14,95,11,3,66,60,0,0,1,5
S01009066,Owned: Owned outright,77,23,22,6,16,0,1,54,54,0,0,0,0
S01009066,Owned: Owned with a mortgage or loan or shared ownership,112,100,87,8,79,11,2,12,6,0,0,1,5
S01009066,Rented or living rent free: Total,130,70,53,17,36,4,13,60,40,1,3,14,2
S01009066,Rented or living rent free: Social rented,107,53,43,16,27,2,8,54,37,1,3,11,2
S01009066,Rented or living rent free: Private rented or living rent free,23,17,10,1,9,2,5,6,3,0,0,3,0
S01009067,All HRPs aged 16 and over,302,261,213,15,198,42,6,41,33,1,0,3,4
S01009067,Owned: Total,271,241,200,12,188,38,3,30,26,1,0,2,1
S01009067,Owned: Owned outright,50,27,21,4,17,4,2,23,22,1,0,0,0
S01009067,Owned: Owned with a mortgage or loan or shared ownership,221,214,179,8,171,34,1,7,4,0,0,2,1
S01009067,Rented or living rent free: Total,31,20,13,3,10,4,3,11,7,0,0,1,3
S01009067,Rented or living rent free: Social rented,16,7,4,1,3,2,1,9,7,0,0,1,1
S01009067,Rented or living rent free: Private rented or living rent free,15,13,9,2,7,2,2,2,0,0,0,0,2
S01009068,All HRPs aged 16 and over,386,266,227,42,185,26,13,120,96,3,6,12,3
S01009068,Owned: Total,260,195,172,27,145,21,2,65,61,1,0,2,1
S01009068,Owned: Owned outright,107,51,43,8,35,6,2,56,53,1,0,2,0
S01009068,Owned: Owned with a mortgage or loan or shared ownership,153,144,129,19,110,15,0,9,8,0,0,0,1
S01009068,Rented or living rent free: Total,126,71,55,15,40,5,11,55,35,2,6,10,2
S01009068,Rented or living rent free: Social rented,94,50,37,11,26,4,9,44,30,1,4,9,0
S01009068,Rented or living rent free: Private rented or living rent free,32,21,18,4,14,1,2,11,5,1,2,1,2
S01009069,All HRPs aged 16 and over,249,198,165,12,153,32,1,51,48,1,2,0,0
S01009069,Owned: Total,241,193,163,12,151,30,0,48,46,1,1,0,0
S01009069,Owned: Owned outright,91,49,41,8,33,8,0,42,40,1,1,0,0
S01009069,Owned: Owned with a mortgage or loan or shared ownership,150,144,122,4,118,22,0,6,6,0,0,0,0
S01009069,Rented or living rent free: Total,8,5,2,0,2,2,1,3,2,0,1,0,0
S01009069,Rented or living rent free: Social rented,4,2,0,0,0,1,1,2,1,0,1,0,0
S01009069,Rented or living rent free: Private rented or living rent free,4,3,2,0,2,1,0,1,1,0,0,0,0
S01009070,All HRPs aged 16 and over,269,206,172,20,152,30,4,63,53,1,4,3,2
S01009070,Owned: Total,232,183,154,16,138,29,0,49,46,1,0,1,1
S01009070,Owned: Owned outright,94,51,43,14,29,8,0,43,40,1,0,1,1
S01009070,Owned: Owned with a mortgage or loan or shared ownership,138,132,111,2,109,21,0,6,6,0,0,0,0
S01009070,Rented or living rent free: Total,37,23,18,4,14,1,4,14,7,0,4,2,1
S01009070,Rented or living rent free: Social rented,16,7,4,0,4,1,2,9,5,0,2,2,0
S01009070,Rented or living rent free: Private rented or living rent free,21,16,14,4,10,0,2,5,2,0,2,0,1
S01009071,All HRPs aged 16 and over,228,158,116,19,97,34,8,70,53,1,2,11,3
S01009071,Owned: Total,148,116,86,11,75,29,1,32,31,0,1,0,0
S01009071,Owned: Owned outright,63,40,26,6,20,14,0,23,22,0,1,0,0
S01009071,Owned: Owned with a mortgage or loan or shared ownership,85,76,60,5,55,15,1,9,9,0,0,0,0
S01009071,Rented or living rent free: Total,80,42,30,8,22,5,7,38,22,1,1,11,3
S01009071,Rented or living rent free: Social rented,73,37,26,7,19,4,7,36,20,1,1,11,3
S01009071,Rented or living rent free: Private rented or living rent free,7,5,4,1,3,1,0,2,2,0,0,0,0
S01009072,All HRPs aged 16 and over,199,149,121,17,104,26,2,50,37,2,4,4,3
S01009072,Owned: Total,154,121,100,9,91,20,1,33,28,1,1,1,2
S01009072,Owned: Owned outright,57,33,23,4,19,9,1,24,21,1,0,1,1
S01009072,Owned: Owned with a mortgage or loan or shared ownership,97,88,77,5,72,11,0,9,7,0,1,0,1
S01009072,Rented or living rent free: Total,45,28,21,8,13,6,1,17,9,1,3,3,1
S01009072,Rented or living rent free: Social rented,33,18,12,5,7,5,1,15,8,0,3,3,1
S01009072,Rented or living rent free: Private rented or living rent free,12,10,9,3,6,1,0,2,1,1,0,0,0
S01009073,All HRPs aged 16 and over,251,147,117,27,90,20,10,104,73,3,4,22,2
S01009073,Owned: Total,124,78,67,9,58,10,1,46,41,0,0,4,1
S01009073,Owned: Owned outright,47,15,14,5,9,1,0,32,31,0,0,0,1
S01009073,Owned: Owned with a mortgage or loan or shared ownership,77,63,53,4,49,9,1,14,10,0,0,4,0
S01009073,Rented or living rent free: Total,127,69,50,18,32,10,9,58,32,3,4,18,1
S01009073,Rented or living rent free: Social rented,119,64,48,17,31,9,7,55,30,3,4,17,1
S01009073,Rented or living rent free: Private rented or living rent free,8,5,2,1,1,1,2,3,2,0,0,1,0
S01009074,All HRPs aged 16 and over,290,190,156,35,121,18,16,100,69,5,4,17,5
S01009074,Owned: Total,125,93,78,9,69,14,1,32,27,0,2,3,0
S01009074,Owned: Owned outright,54,28,18,3,15,9,1,26,24,0,0,2,0
S01009074,Owned: Owned with a mortgage or loan or shared ownership,71,65,60,6,54,5,0,6,3,0,2,1,0
S01009074,Rented or living rent free: Total,165,97,78,26,52,4,15,68,42,5,2,14,5
S01009074,Rented or living rent free: Social rented,150,89,70,24,46,4,15,61,39,3,2,13,4
S01009074,Rented or living rent free: Private rented or living rent free,15,8,8,2,6,0,0,7,3,2,0,1,1
S01009075,All HRPs aged 16 and over,233,131,104,19,85,17,10,102,83,1,6,8,4
S01009075,Owned: Total,141,91,76,10,66,15,0,50,46,0,0,1,3
S01009075,Owned: Owned outright,67,29,23,3,20,6,0,38,36,0,0,1,1
S01009075,Owned: Owned with a mortgage or loan or shared ownership,74,62,53,7,46,9,0,12,10,0,0,0,2
S01009075,Rented or living rent free: Total,92,40,28,9,19,2,10,52,37,1,6,7,1
S01009075,Rented or living rent free: Social rented,79,34,23,8,15,2,9,45,30,1,6,7,1
S01009075,Rented or living rent free: Private rented or living rent free,13,6,5,1,4,0,1,7,7,0,0,0,0
S01009076,All HRPs aged 16 and over,381,313,263,34,229,41,9,68,56,2,1,9,0
S01009076,Owned: Total,341,283,238,28,210,38,7,58,51,1,1,5,0
S01009076,Owned: Owned outright,107,59,48,13,35,8,3,48,44,1,0,3,0
S01009076,Owned: Owned with a mortgage or loan or shared ownership,234,224,190,15,175,30,4,10,7,0,1,2,0
S01009076,Rented or living rent free: Total,40,30,25,6,19,3,2,10,5,1,0,4,0
S01009076,Rented or living rent free: Social rented,9,5,5,3,2,0,0,4,2,0,0,2,0
S01009076,Rented or living rent free: Private rented or living rent free,31,25,20,3,17,3,2,6,3,1,0,2,0
S01009077,All HRPs aged 16 and over,259,181,153,17,136,20,8,78,59,1,4,9,5
S01009077,Owned: Total,195,139,121,11,110,17,1,56,49,1,0,4,2
S01009077,Owned: Owned outright,94,47,38,7,31,9,0,47,42,1,0,2,2
S01009077,Owned: Owned with a mortgage or loan or shared ownership,101,92,83,4,79,8,1,9,7,0,0,2,0
S01009077,Rented or living rent free: Total,64,42,32,6,26,3,7,22,10,0,4,5,3
S01009077,Rented or living rent free: Social rented,51,30,23,3,20,2,5,21,9,0,4,5,3
S01009077,Rented or living rent free: Private rented or living rent free,13,12,9,3,6,1,2,1,1,0,0,0,0
S01009078,All HRPs aged 16 and over,271,248,225,17,208,21,2,23,14,1,5,3,0
S01009078,Owned: Total,251,235,214,15,199,20,1,16,14,1,1,0,0
S01009078,Owned: Owned outright,33,22,20,8,12,1,1,11,11,0,0,0,0
S01009078,Owned: Owned with a mortgage or loan or shared ownership,218,213,194,7,187,19,0,5,3,1,1,0,0
S01009078,Rented or living rent free: Total,20,13,11,2,9,1,1,7,0,0,4,3,0
S01009078,Rented or living rent free: Social rented,10,4,2,1,1,1,1,6,0,0,4,2,0
S01009078,Rented or living rent free: Private rented or living rent free,10,9,9,1,8,0,0,1,0,0,0,1,0
S01009079,All HRPs aged 16 and over,388,229,192,42,150,20,17,159,120,0,8,23,8
S01009079,Owned: Total,180,129,115,13,102,12,2,51,45,0,0,4,2
S01009079,Owned: Owned outright,71,30,24,7,17,5,1,41,37,0,0,2,2
S01009079,Owned: Owned with a mortgage or loan or shared ownership,109,99,91,6,85,7,1,10,8,0,0,2,0
S01009079,Rented or living rent free: Total,208,100,77,29,48,8,15,108,75,0,8,19,6
S01009079,Rented or living rent free: Social rented,185,82,63,25,38,6,13,103,71,0,7,19,6
S01009079,Rented or living rent free: Private rented or living rent free,23,18,14,4,10,2,2,5,4,0,1,0,0
S01009080,All HRPs aged 16 and over,430,249,206,51,155,31,12,181,134,2,12,20,13
S01009080,Owned: Total,243,159,141,30,111,16,2,84,80,0,0,2,2
S01009080,Owned: Owned outright,118,45,40,11,29,4,1,73,71,0,0,0,2
S01009080,Owned: Owned with a mortgage or loan or shared ownership,125,114,101,19,82,12,1,11,9,0,0,2,0
S01009080,Rented or living rent free: Total,187,90,65,21,44,15,10,97,54,2,12,18,11
S01009080,Rented or living rent free: Social rented,168,80,56,18,38,14,10,88,50,2,11,17,8
S01009080,Rented or living rent free: Private rented or living rent free,19,10,9,3,6,1,0,9,4,0,1,1,3
S01009081,All HRPs aged 16 and over,311,188,157,13,144,27,4,123,99,0,2,16,6
S01009081,Owned: Total,231,159,133,9,124,26,0,72,66,0,0,5,1
S01009081,Owned: Owned outright,93,37,28,3,25,9,0,56,51,0,0,4,1
S01009081,Owned: Owned with a mortgage or loan or shared ownership,138,122,105,6,99,17,0,16,15,0,0,1,0
S01009081,Rented or living rent free: Total,80,29,24,4,20,1,4,51,33,0,2,11,5
S01009081,Rented or living rent free: Social rented,74,25,20,4,16,1,4,49,32,0,2,11,4
S01009081,Rented or living rent free: Private rented or living rent free,6,4,4,0,4,0,0,2,1,0,0,0,1
S01009082,All HRPs aged 16 and over,426,277,219,35,184,41,17,149,110,2,7,23,7
S01009082,Owned: Total,237,180,154,20,134,24,2,57,52,1,0,3,1
S01009082,Owned: Owned outright,79,31,24,4,20,7,0,48,45,0,0,2,1
S01009082,Owned: Owned with a mortgage or loan or shared ownership,158,149,130,16,114,17,2,9,7,1,0,1,0
S01009082,Rented or living rent free: Total,189,97,65,15,50,17,15,92,58,1,7,20,6
S01009082,Rented or living rent free: Social rented,169,83,54,14,40,14,15,86,56,0,6,19,5
S01009082,Rented or living rent free: Private rented or living rent free,20,14,11,1,10,3,0,6,2,1,1,1,1
S01009083,All HRPs aged 16 and over,349,236,206,29,177,18,12,113,79,2,10,20,2
S01009083,Owned: Total,207,154,142,14,128,10,2,53,48,1,1,2,1
S01009083,Owned: Owned outright,72,33,29,5,24,4,0,39,37,0,0,1,1
S01009083,Owned: Owned with a mortgage or loan or shared ownership,135,121,113,9,104,6,2,14,11,1,1,1,0
S01009083,Rented or living rent free: Total,142,82,64,15,49,8,10,60,31,1,9,18,1
S01009083,Rented or living rent free: Social rented,106,56,50,13,37,1,5,50,24,1,7,17,1
S01009083,Rented or living rent free: Private rented or living rent free,36,26,14,2,12,7,5,10,7,0,2,1,0
S01009084,All HRPs aged 16 and over,177,147,114,11,103,31,2,30,18,2,3,5,2
S01009084,Owned: Total,120,109,82,5,77,27,0,11,11,0,0,0,0
S01009084,Owned: Owned outright,39,29,23,3,20,6,0,10,10,0,0,0,0
S01009084,Owned: Owned with a mortgage or loan or shared ownership,81,80,59,2,57,21,0,1,1,0,0,0,0
S01009084,Rented or living rent free: Total,57,38,32,6,26,4,2,19,7,2,3,5,2
S01009084,Rented or living rent free: Social rented,37,22,19,3,16,1,2,15,5,0,3,5,2
S01009084,Rented or living rent free: Private rented or living rent free,20,16,13,3,10,3,0,4,2,2,0,0,0
S01009085,All HRPs aged 16 and over,280,268,236,16,220,27,5,12,8,0,1,3,0
S01009085,Owned: Total,251,241,216,13,203,23,2,10,8,0,0,2,0
S01009085,Owned: Owned outright,31,21,19,5,14,2,0,10,8,0,0,2,0
S01009085,Owned: Owned with a mortgage or loan or shared ownership,220,220,197,8,189,21,2,0,0,0,0,0,0
S01009085,Rented or living rent free: Total,29,27,20,3,17,4,3,2,0,0,1,1,0
S01009085,Rented or living rent free: Social rented,9,7,4,0,4,1,2,2,0,0,1,1,0
S01009085,Rented or living rent free: Private rented or living rent free,20,20,16,3,13,3,1,0,0,0,0,0,0
S01009086,All HRPs aged 16 and over,305,207,172,29,143,22,13,98,69,2,4,22,1
S01009086,Owned: Total,193,151,134,19,115,15,2,42,40,0,0,2,0
S01009086,Owned: Owned outright,54,26,21,8,13,5,0,28,28,0,0,0,0
S01009086,Owned: Owned with a mortgage or loan or shared ownership,139,125,113,11,102,10,2,14,12,0,0,2,0
S01009086,Rented or living rent free: Total,112,56,38,10,28,7,11,56,29,2,4,20,1
S01009086,Rented or living rent free: Social rented,97,48,35,9,26,5,8,49,24,2,4,18,1
S01009086,Rented or living rent free: Private rented or living rent free,15,8,3,1,2,2,3,7,5,0,0,2,0
S01009087,All HRPs aged 16 and over,247,159,139,24,115,11,9,88,59,0,9,16,4
S01009087,Owned: Total,122,89,80,6,74,8,1,33,31,0,2,0,0
S01009087,Owned: Owned outright,49,20,16,2,14,4,0,29,28,0,1,0,0
S01009087,Owned: Owned with a mortgage or loan or shared ownership,73,69,64,4,60,4,1,4,3,0,1,0,0
S01009087,Rented or living rent free: Total,125,70,59,18,41,3,8,55,28,0,7,16,4
S01009087,Rented or living rent free: Social rented,109,58,47,13,34,3,8,51,25,0,7,16,3
S01009087,Rented or living rent free: Private rented or living rent free,16,12,12,5,7,0,0,4,3,0,0,0,1
S01009088,All HRPs aged 16 and over,385,268,215,29,186,48,5,117,107,0,3,5,2
S01009088,Owned: Total,324,227,180,22,158,44,3,97,96,0,0,0,1
S01009088,Owned: Owned outright,144,59,41,12,29,16,2,85,84,0,0,0,1
S01009088,Owned: Owned with a mortgage or loan or shared ownership,180,168,139,10,129,28,1,12,12,0,0,0,0
S01009088,Rented or living rent free: Total,61,41,35,7,28,4,2,20,11,0,3,5,1
S01009088,Rented or living rent free: Social rented,34,18,15,4,11,2,1,16,9,0,2,4,1
S01009088,Rented or living rent free: Private rented or living rent free,27,23,20,3,17,2,1,4,2,0,1,1,0
S01009089,All HRPs aged 16 and over,325,283,230,13,217,51,2,42,34,0,1,5,2
S01009089,Owned: Total,300,264,218,10,208,46,0,36,33,0,0,2,1
S01009089,Owned: Owned outright,71,40,27,3,24,13,0,31,31,0,0,0,0
S01009089,Owned: Owned with a mortgage or loan or shared ownership,229,224,191,7,184,33,0,5,2,0,0,2,1
S01009089,Rented or living rent free: Total,25,19,12,3,9,5,2,6,1,0,1,3,1
S01009089,Rented or living rent free: Social rented,4,1,0,0,0,0,1,3,1,0,1,1,0
S01009089,Rented or living rent free: Private rented or living rent free,21,18,12,3,9,5,1,3,0,0,0,2,1
S01009090,All HRPs aged 16 and over,333,313,274,16,258,37,2,20,19,0,0,1,0
S01009090,Owned: Total,267,256,228,11,217,28,0,11,11,0,0,0,0
S01009090,Owned: Owned outright,38,28,22,7,15,6,0,10,10,0,0,0,0
S01009090,Owned: Owned with a mortgage or loan or shared ownership,229,228,206,4,202,22,0,1,1,0,0,0,0
S01009090,Rented or living rent free: Total,66,57,46,5,41,9,2,9,8,0,0,1,0
S01009090,Rented or living rent free: Social rented,6,4,3,0,3,0,1,2,1,0,0,1,0
S01009090,Rented or living rent free: Private rented or living rent free,60,53,43,5,38,9,1,7,7,0,0,0,0
S01009091,All HRPs aged 16 and over,223,204,176,10,166,25,3,19,14,1,2,2,0
S01009091,Owned: Total,209,195,171,10,161,23,1,14,12,0,2,0,0
S01009091,Owned: Owned outright,33,23,20,5,15,2,1,10,9,0,1,0,0
S01009091,Owned: Owned with a mortgage or loan or shared ownership,176,172,151,5,146,21,0,4,3,0,1,0,0
S01009091,Rented or living rent free: Total,14,9,5,0,5,2,2,5,2,1,0,2,0
S01009091,Rented or living rent free: Social rented,3,0,0,0,0,0,0,3,1,1,0,1,0
S01009091,Rented or living rent free: Private rented or living rent free,11,9,5,0,5,2,2,2,1,0,0,1,0
S01009092,All HRPs aged 16 and over,482,293,252,40,212,26,15,189,156,0,4,24,5
S01009092,Owned: Total,336,211,186,22,164,22,3,125,117,0,1,5,2
S01009092,Owned: Owned outright,154,53,44,15,29,7,2,101,98,0,0,2,1
S01009092,Owned: Owned with a mortgage or loan or shared ownership,182,158,142,7,135,15,1,24,19,0,1,3,1
S01009092,Rented or living rent free: Total,146,82,66,18,48,4,12,64,39,0,3,19,3
S01009092,Rented or living rent free: Social rented,105,47,38,15,23,1,8,58,37,0,3,15,3
S01009092,Rented or living rent free: Private rented or living rent free,41,35,28,3,25,3,4,6,2,0,0,4,0
S01009093,All HRPs aged 16 and over,343,245,211,49,162,20,14,98,75,1,3,14,5
S01009093,Owned: Total,175,126,115,19,96,11,0,49,45,0,0,2,2
S01009093,Owned: Owned outright,56,21,20,9,11,1,0,35,32,0,0,2,1
S01009093,Owned: Owned with a mortgage or loan or shared ownership,119,105,95,10,85,10,0,14,13,0,0,0,1
S01009093,Rented or living rent free: Total,168,119,96,30,66,9,14,49,30,1,3,12,3
S01009093,Rented or living rent free: Social rented,116,74,57,21,36,6,11,42,25,0,3,12,2
S01009093,Rented or living rent free: Private rented or living rent free,52,45,39,9,30,3,3,7,5,1,0,0,1
S01009094,All HRPs aged 16 and over,290,149,134,17,117,13,2,141,138,0,1,1,1
S01009094,Owned: Total,271,136,122,14,108,13,1,135,134,0,0,0,1
S01009094,Owned: Owned outright,174,43,38,8,30,5,0,131,130,0,0,0,1
S01009094,Owned: Owned with a mortgage or loan or shared ownership,97,93,84,6,78,8,1,4,4,0,0,0,0
S01009094,Rented or living rent free: Total,19,13,12,3,9,0,1,6,4,0,1,1,0
S01009094,Rented or living rent free: Social rented,11,6,5,1,4,0,1,5,3,0,1,1,0
S01009094,Rented or living rent free: Private rented or living rent free,8,7,7,2,5,0,0,1,1,0,0,0,0
S01009095,All HRPs aged 16 and over,360,241,194,27,167,44,3,119,105,0,2,9,3
S01009095,Owned: Total,231,169,129,16,113,40,0,62,60,0,0,0,2
S01009095,Owned: Owned outright,100,44,32,8,24,12,0,56,55,0,0,0,1
S01009095,Owned: Owned with a mortgage or loan or shared ownership,131,125,97,8,89,28,0,6,5,0,0,0,1
S01009095,Rented or living rent free: Total,129,72,65,11,54,4,3,57,45,0,2,9,1
S01009095,Rented or living rent free: Social rented,80,30,27,6,21,2,1,50,39,0,2,8,1
S01009095,Rented or living rent free: Private rented or living rent free,49,42,38,5,33,2,2,7,6,0,0,1,0
S01009096,All HRPs aged 16 and over,384,299,250,25,225,43,6,85,62,0,5,17,1
S01009096,Owned: Total,272,226,191,13,178,33,2,46,42,0,2,2,0
S01009096,Owned: Owned outright,68,26,21,8,13,4,1,42,39,0,1,2,0
S01009096,Owned: Owned with a mortgage or loan or shared ownership,204,200,170,5,165,29,1,4,3,0,1,0,0
S01009096,Rented or living rent free: Total,112,73,59,12,47,10,4,39,20,0,3,15,1
S01009096,Rented or living rent free: Social rented,64,31,25,10,15,2,4,33,20,0,2,10,1
S01009096,Rented or living rent free: Private rented or living rent free,48,42,34,2,32,8,0,6,0,0,1,5,0
S01009097,All HRPs aged 16 and over,347,280,256,27,229,22,2,67,61,0,0,4,2
S01009097,Owned: Total,311,254,230,23,207,22,2,57,54,0,0,1,2
S01009097,Owned: Owned outright,96,45,37,11,26,6,2,51,48,0,0,1,2
S01009097,Owned: Owned with a mortgage or loan or shared ownership,215,209,193,12,181,16,0,6,6,0,0,0,0
S01009097,Rented or living rent free: Total,36,26,26,4,22,0,0,10,7,0,0,3,0
S01009097,Rented or living rent free: Social rented,9,3,3,3,0,0,0,6,4,0,0,2,0
S01009097,Rented or living rent free: Private rented or living rent free,27,23,23,1,22,0,0,4,3,0,0,1,0
S01009098,All HRPs aged 16 and over,190,134,108,8,100,22,4,56,51,0,3,2,0
S01009098,Owned: Total,177,125,103,7,96,21,1,52,50,0,1,1,0
S01009098,Owned: Owned outright,89,38,31,3,28,6,1,51,49,0,1,1,0
S01009098,Owned: Owned with a mortgage or loan or shared ownership,88,87,72,4,68,15,0,1,1,0,0,0,0
S01009098,Rented or living rent free: Total,13,9,5,1,4,1,3,4,1,0,2,1,0
S01009098,Rented or living rent free: Social rented,6,2,0,0,0,1,1,4,1,0,2,1,0
S01009098,Rented or living rent free: Private rented or living rent free,7,7,5,1,4,0,2,0,0,0,0,0,0
S01009099,All HRPs aged 16 and over,384,212,188,25,163,17,7,172,134,0,4,26,8
S01009099,Owned: Total,240,157,138,10,128,15,4,83,76,0,2,3,2
S01009099,Owned: Owned outright,105,35,27,6,21,5,3,70,66,0,2,1,1
S01009099,Owned: Owned with a mortgage or loan or shared ownership,135,122,111,4,107,10,1,13,10,0,0,2,1
S01009099,Rented or living rent free: Total,144,55,50,15,35,2,3,89,58,0,2,23,6
S01009099,Rented or living rent free: Social rented,100,29,26,10,16,1,2,71,45,0,2,18,6
S01009099,Rented or living rent free: Private rented or living rent free,44,26,24,5,19,1,1,18,13,0,0,5,0
S01009100,All HRPs aged 16 and over,397,210,174,32,142,24,12,187,158,2,6,17,4
S01009100,Owned: Total,159,106,90,8,82,14,2,53,49,1,2,0,1
S01009100,Owned: Owned outright,62,19,14,2,12,4,1,43,42,0,1,0,0
S01009100,Owned: Owned with a mortgage or loan or shared ownership,97,87,76,6,70,10,1,10,7,1,1,0,1
S01009100,Rented or living rent free: Total,238,104,84,24,60,10,10,134,109,1,4,17,3
S01009100,Rented or living rent free: Social rented,194,77,62,21,41,8,7,117,98,0,4,13,2
S01009100,Rented or living rent free: Private rented or living rent free,44,27,22,3,19,2,3,17,11,1,0,4,1
S01009101,All HRPs aged 16 and over,369,230,196,30,166,21,13,139,96,1,10,24,8
S01009101,Owned: Total,180,132,116,5,111,13,3,48,42,0,0,5,1
S01009101,Owned: Owned outright,69,32,25,3,22,6,1,37,32,0,0,4,1
S01009101,Owned: Owned with a mortgage or loan or shared ownership,111,100,91,2,89,7,2,11,10,0,0,1,0
S01009101,Rented or living rent free: Total,189,98,80,25,55,8,10,91,54,1,10,19,7
S01009101,Rented or living rent free: Social rented,180,91,74,24,50,7,10,89,53,1,9,19,7
S01009101,Rented or living rent free: Private rented or living rent free,9,7,6,1,5,1,0,2,1,0,1,0,0
S01009102,All HRPs aged 16 and over,317,225,184,42,142,15,26,92,47,2,14,25,4
S01009102,Owned: Total,106,88,78,8,70,9,1,18,16,0,0,2,0
S01009102,Owned: Owned outright,35,21,18,4,14,3,0,14,13,0,0,1,0
S01009102,Owned: Owned with a mortgage or loan or shared ownership,71,67,60,4,56,6,1,4,3,0,0,1,0
S01009102,Rented or living rent free: Total,211,137,106,34,72,6,25,74,31,2,14,23,4
S01009102,Rented or living rent free: Social rented,205,132,103,32,71,4,25,73,31,2,14,22,4
S01009102,Rented or living rent free: Private rented or living rent free,6,5,3,2,1,2,0,1,0,0,0,1,0
S01009103,All HRPs aged 16 and over,246,155,137,14,123,12,6,91,79,0,4,6,2
S01009103,Owned: Total,220,145,130,13,117,12,3,75,72,0,0,2,1
S01009103,Owned: Owned outright,116,45,39,9,30,4,2,71,68,0,0,2,1
S01009103,Owned: Owned with a mortgage or loan or shared ownership,104,100,91,4,87,8,1,4,4,0,0,0,0
S01009103,Rented or living rent free: Total,26,10,7,1,6,0,3,16,7,0,4,4,1
S01009103,Rented or living rent free: Social rented,21,6,4,1,3,0,2,15,6,0,4,4,1
S01009103,Rented or living rent free: Private rented or living rent free,5,4,3,0,3,0,1,1,1,0,0,0,0
S01009104,All HRPs aged 16 and over,352,222,194,40,154,20,8,130,98,1,5,19,7
S01009104,Owned: Total,206,142,123,18,105,17,2,64,54,1,0,6,3
S01009104,Owned: Owned outright,95,43,35,8,27,6,2,52,45,0,0,5,2
S01009104,Owned: Owned with a mortgage or loan or shared ownership,111,99,88,10,78,11,0,12,9,1,0,1,1
S01009104,Rented or living rent free: Total,146,80,71,22,49,3,6,66,44,0,5,13,4
S01009104,Rented or living rent free: Social rented,118,58,50,16,34,2,6,60,41,0,5,10,4
S01009104,Rented or living rent free: Private rented or living rent free,28,22,21,6,15,1,0,6,3,0,0,3,0
S01009105,All HRPs aged 16 and over,337,232,200,26,174,29,3,105,83,2,0,18,2
S01009105,Owned: Total,236,178,153,18,135,25,0,58,53,1,0,3,1
S01009105,Owned: Owned outright,88,40,33,8,25,7,0,48,46,0,0,2,0
S01009105,Owned: Owned with a mortgage or loan or shared ownership,148,138,120,10,110,18,0,10,7,1,0,1,1
S01009105,Rented or living rent free: Total,101,54,47,8,39,4,3,47,30,1,0,15,1
S01009105,Rented or living rent free: Social rented,74,32,27,6,21,3,2,42,28,0,0,13,1
S01009105,Rented or living rent free: Private rented or living rent free,27,22,20,2,18,1,1,5,2,1,0,2,0
S01009106,All HRPs aged 16 and over,264,170,147,18,129,15,8,94,82,1,1,6,4
S01009106,Owned: Total,177,116,105,6,99,11,0,61,57,0,1,2,1
S01009106,Owned: Owned outright,66,18,14,2,12,4,0,48,46,0,0,2,0
S01009106,Owned: Owned with a mortgage or loan or shared ownership,111,98,91,4,87,7,0,13,11,0,1,0,1
S01009106,Rented or living rent free: Total,87,54,42,12,30,4,8,33,25,1,0,4,3
S01009106,Rented or living rent free: Social rented,56,30,22,5,17,1,7,26,19,1,0,4,2
S01009106,Rented or living rent free: Private rented or living rent free,31,24,20,7,13,3,1,7,6,0,0,0,1
S01009107,All HRPs aged 16 and over,333,250,232,28,204,15,3,83,72,0,1,9,1
S01009107,Owned: Total,274,207,194,16,178,13,0,67,65,0,0,2,0
S01009107,Owned: Owned outright,100,43,42,9,33,1,0,57,56,0,0,1,0
S01009107,Owned: Owned with a mortgage or loan or shared ownership,174,164,152,7,145,12,0,10,9,0,0,1,0
S01009107,Rented or living rent free: Total,59,43,38,12,26,2,3,16,7,0,1,7,1
S01009107,Rented or living rent free: Social rented,36,25,22,8,14,1,2,11,4,0,1,6,0
S01009107,Rented or living rent free: Private rented or living rent free,23,18,16,4,12,1,1,5,3,0,0,1,1
S01009108,All HRPs aged 16 and over,313,210,186,33,153,24,0,103,101,0,0,2,0
S01009108,Owned: Total,288,191,167,27,140,24,0,97,96,0,0,1,0
S01009108,Owned: Owned outright,151,62,55,19,36,7,0,89,88,0,0,1,0
S01009108,Owned: Owned with a mortgage or loan or shared ownership,137,129,112,8,104,17,0,8,8,0,0,0,0
S01009108,Rented or living rent free: Total,25,19,19,6,13,0,0,6,5,0,0,1,0
S01009108,Rented or living rent free: Social rented,7,4,4,1,3,0,0,3,3,0,0,0,0
S01009108,Rented or living rent free: Private rented or living rent free,18,15,15,5,10,0,0,3,2,0,0,1,0
S01009109,All HRPs aged 16 and over,263,191,166,19,147,23,2,72,67,1,1,3,0
S01009109,Owned: Total,249,184,161,17,144,21,2,65,62,0,1,2,0
S01009109,Owned: Owned outright,112,57,45,8,37,10,2,55,52,0,1,2,0
S01009109,Owned: Owned with a mortgage or loan or shared ownership,137,127,116,9,107,11,0,10,10,0,0,0,0
S01009109,Rented or living rent free: Total,14,7,5,2,3,2,0,7,5,1,0,1,0
S01009109,Rented or living rent free: Social rented,3,2,1,1,0,1,0,1,0,0,0,1,0
S01009109,Rented or living rent free: Private rented or living rent free,11,5,4,1,3,1,0,6,5,1,0,0,0
S01009110,All HRPs aged 16 and over,263,157,138,19,119,15,4,106,93,0,3,9,1
S01009110,Owned: Total,195,130,114,11,103,14,2,65,64,0,0,1,0
S01009110,Owned: Owned outright,76,25,24,4,20,1,0,51,51,0,0,0,0
S01009110,Owned: Owned with a mortgage or loan or shared ownership,119,105,90,7,83,13,2,14,13,0,0,1,0
S01009110,Rented or living rent free: Total,68,27,24,8,16,1,2,41,29,0,3,8,1
S01009110,Rented or living rent free: Social rented,62,22,19,7,12,1,2,40,29,0,2,8,1
S01009110,Rented or living rent free: Private rented or living rent free,6,5,5,1,4,0,0,1,0,0,1,0,0
S01009111,All HRPs aged 16 and over,372,289,249,33,216,33,7,83,59,1,6,14,3
S01009111,Owned: Total,298,246,210,22,188,31,5,52,42,0,4,3,3
S01009111,Owned: Owned outright,104,60,46,15,31,12,2,44,38,0,4,2,0
S01009111,Owned: Owned with a mortgage or loan or shared ownership,194,186,164,7,157,19,3,8,4,0,0,1,3
S01009111,Rented or living rent free: Total,74,43,39,11,28,2,2,31,17,1,2,11,0
S01009111,Rented or living rent free: Social rented,32,6,5,2,3,1,0,26,17,0,1,8,0
S01009111,Rented or living rent free: Private rented or living rent free,42,37,34,9,25,1,2,5,0,1,1,3,0
S01009112,All HRPs aged 16 and over,238,149,126,16,110,21,2,89,85,0,1,1,2
S01009112,Owned: Total,226,139,117,14,103,20,2,87,83,0,1,1,2
S01009112,Owned: Owned outright,126,43,35,13,22,7,1,83,79,0,1,1,2
S01009112,Owned: Owned with a mortgage or loan or shared ownership,100,96,82,1,81,13,1,4,4,0,0,0,0
S01009112,Rented or living rent free: Total,12,10,9,2,7,1,0,2,2,0,0,0,0
S01009112,Rented or living rent free: Social rented,3,2,2,1,1,0,0,1,1,0,0,0,0
S01009112,Rented or living rent free: Private rented or living rent free,9,8,7,1,6,1,0,1,1,0,0,0,0
S01009113,All HRPs aged 16 and over,381,268,230,20,210,35,3,113,109,0,1,2,1
S01009113,Owned: Total,350,241,207,18,189,31,3,109,107,0,0,1,1
S01009113,Owned: Owned outright,142,47,37,12,25,9,1,95,93,0,0,1,1
S01009113,Owned: Owned with a mortgage or loan or shared ownership,208,194,170,6,164,22,2,14,14,0,0,0,0
S01009113,Rented or living rent free: Total,31,27,23,2,21,4,0,4,2,0,1,1,0
S01009113,Rented or living rent free: Social rented,5,2,2,1,1,0,0,3,1,0,1,1,0
S01009113,Rented or living rent free: Private rented or living rent free,26,25,21,1,20,4,0,1,1,0,0,0,0
S01009114,All HRPs aged 16 and over,303,243,210,21,189,24,9,60,41,0,2,12,5
S01009114,Owned: Total,229,200,174,12,162,23,3,29,25,0,0,3,1
S01009114,Owned: Owned outright,55,30,26,4,22,4,0,25,23,0,0,1,1
S01009114,Owned: Owned with a mortgage or loan or shared ownership,174,170,148,8,140,19,3,4,2,0,0,2,0
S01009114,Rented or living rent free: Total,74,43,36,9,27,1,6,31,16,0,2,9,4
S01009114,Rented or living rent free: Social rented,61,32,25,8,17,1,6,29,15,0,2,8,4
S01009114,Rented or living rent free: Private rented or living rent free,13,11,11,1,10,0,0,2,1,0,0,1,0
S01009115,All HRPs aged 16 and over,259,193,171,24,147,18,4,66,46,2,3,13,2
S01009115,Owned: Total,178,142,127,13,114,13,2,36,33,0,1,1,1
S01009115,Owned: Owned outright,55,27,22,2,20,4,1,28,27,0,0,0,1
S01009115,Owned: Owned with a mortgage or loan or shared ownership,123,115,105,11,94,9,1,8,6,0,1,1,0
S01009115,Rented or living rent free: Total,81,51,44,11,33,5,2,30,13,2,2,12,1
S01009115,Rented or living rent free: Social rented,52,28,26,10,16,2,0,24,10,1,2,10,1
S01009115,Rented or living rent free: Private rented or living rent free,29,23,18,1,17,3,2,6,3,1,0,2,0
S01009116,All HRPs aged 16 and over,191,139,124,18,106,11,4,52,49,0,1,1,1
S01009116,Owned: Total,180,133,120,18,102,11,2,47,45,0,1,0,1
S01009116,Owned: Owned outright,90,45,40,13,27,5,0,45,44,0,0,0,1
S01009116,Owned: Owned with a mortgage or loan or shared ownership,90,88,80,5,75,6,2,2,1,0,1,0,0
S01009116,Rented or living rent free: Total,11,6,4,0,4,0,2,5,4,0,0,1,0
S01009116,Rented or living rent free: Social rented,3,2,2,0,2,0,0,1,0,0,0,1,0
S01009116,Rented or living rent free: Private rented or living rent free,8,4,2,0,2,0,2,4,4,0,0,0,0
S01009117,All HRPs aged 16 and over,391,292,252,38,214,24,16,99,71,0,5,19,4
S01009117,Owned: Total,256,220,198,23,175,18,4,36,34,0,2,0,0
S01009117,Owned: Owned outright,59,31,27,7,20,3,1,28,27,0,1,0,0
S01009117,Owned: Owned with a mortgage or loan or shared ownership,197,189,171,16,155,15,3,8,7,0,1,0,0
S01009117,Rented or living rent free: Total,135,72,54,15,39,6,12,63,37,0,3,19,4
S01009117,Rented or living rent free: Social rented,97,39,29,13,16,3,7,58,34,0,3,17,4
S01009117,Rented or living rent free: Private rented or living rent free,38,33,25,2,23,3,5,5,3,0,0,2,0
S01009118,All HRPs aged 16 and over,215,183,162,12,150,19,2,32,23,1,1,6,1
S01009118,Owned: Total,197,176,157,12,145,18,1,21,18,0,0,2,1
S01009118,Owned: Owned outright,43,27,26,3,23,1,0,16,15,0,0,0,1
S01009118,Owned: Owned with a mortgage or loan or shared ownership,154,149,131,9,122,17,1,5,3,0,0,2,0
S01009118,Rented or living rent free: Total,18,7,5,0,5,1,1,11,5,1,1,4,0
S01009118,Rented or living rent free: Social rented,13,3,2,0,2,0,1,10,5,1,1,3,0
S01009118,Rented or living rent free: Private rented or living rent free,5,4,3,0,3,1,0,1,0,0,0,1,0
S01009119,All HRPs aged 16 and over,297,189,156,33,123,18,15,108,67,1,10,24,6
S01009119,Owned: Total,153,113,100,16,84,10,3,40,34,0,0,3,3
S01009119,Owned: Owned outright,65,33,27,5,22,5,1,32,28,0,0,2,2
S01009119,Owned: Owned with a mortgage or loan or shared ownership,88,80,73,11,62,5,2,8,6,0,0,1,1
S01009119,Rented or living rent free: Total,144,76,56,17,39,8,12,68,33,1,10,21,3
S01009119,Rented or living rent free: Social rented,126,63,49,14,35,6,8,63,29,1,9,21,3
S01009119,Rented or living rent free: Private rented or living rent free,18,13,7,3,4,2,4,5,4,0,1,0,0
S01009120,All HRPs aged 16 and over,233,148,129,22,107,13,6,85,64,1,6,12,2
S01009120,Owned: Total,150,105,92,10,82,12,1,45,44,0,0,1,0
S01009120,Owned: Owned outright,59,23,18,6,12,4,1,36,35,0,0,1,0
S01009120,Owned: Owned with a mortgage or loan or shared ownership,91,82,74,4,70,8,0,9,9,0,0,0,0
S01009120,Rented or living rent free: Total,83,43,37,12,25,1,5,40,20,1,6,11,2
S01009120,Rented or living rent free: Social rented,70,34,30,9,21,1,3,36,20,1,4,10,1
S01009120,Rented or living rent free: Private rented or living rent free,13,9,7,3,4,0,2,4,0,0,2,1,1
S01009121,All HRPs aged 16 and over,380,261,224,33,191,24,13,119,95,1,3,14,6
S01009121,Owned: Total,261,194,172,25,147,19,3,67,62,1,1,1,2
S01009121,Owned: Owned outright,107,53,49,15,34,3,1,54,53,0,0,0,1
S01009121,Owned: Owned with a mortgage or loan or shared ownership,154,141,123,10,113,16,2,13,9,1,1,1,1
S01009121,Rented or living rent free: Total,119,67,52,8,44,5,10,52,33,0,2,13,4
S01009121,Rented or living rent free: Social rented,89,41,34,7,27,2,5,48,31,0,1,12,4
S01009121,Rented or living rent free: Private rented or living rent free,30,26,18,1,17,3,5,4,2,0,1,1,0
S01009122,All HRPs aged 16 and over,417,278,200,30,170,56,22,139,102,2,8,23,4
S01009122,Owned: Total,269,194,139,11,128,47,8,75,65,0,3,6,1
S01009122,Owned: Owned outright,116,61,34,6,28,25,2,55,49,0,2,4,0
S01009122,Owned: Owned with a mortgage or loan or shared ownership,153,133,105,5,100,22,6,20,16,0,1,2,1
S01009122,Rented or living rent free: Total,148,84,61,19,42,9,14,64,37,2,5,17,3
S01009122,Rented or living rent free: Social rented,97,51,37,11,26,2,12,46,27,2,4,11,2
S01009122,Rented or living rent free: Private rented or living rent free,51,33,24,8,16,7,2,18,10,0,1,6,1
S01009123,All HRPs aged 16 and over,215,176,154,20,134,17,5,39,34,0,0,5,0
S01009123,Owned: Total,178,150,135,15,120,15,0,28,26,0,0,2,0
S01009123,Owned: Owned outright,45,25,23,6,17,2,0,20,19,0,0,1,0
S01009123,Owned: Owned with a mortgage or loan or shared ownership,133,125,112,9,103,13,0,8,7,0,0,1,0
S01009123,Rented or living rent free: Total,37,26,19,5,14,2,5,11,8,0,0,3,0
S01009123,Rented or living rent free: Social rented,25,16,12,2,10,1,3,9,6,0,0,3,0
S01009123,Rented or living rent free: Private rented or living rent free,12,10,7,3,4,1,2,2,2,0,0,0,0
S01009124,All HRPs aged 16 and over,217,170,145,19,126,24,1,47,37,0,3,4,3
S01009124,Owned: Total,150,132,111,5,106,21,0,18,17,0,0,1,0
S01009124,Owned: Owned outright,26,13,12,2,10,1,0,13,12,0,0,1,0
S01009124,Owned: Owned with a mortgage or loan or shared ownership,124,119,99,3,96,20,0,5,5,0,0,0,0
S01009124,Rented or living rent free: Total,67,38,34,14,20,3,1,29,20,0,3,3,3
S01009124,Rented or living rent free: Social rented,49,28,25,10,15,3,0,21,14,0,2,3,2
S01009124,Rented or living rent free: Private rented or living rent free,18,10,9,4,5,0,1,8,6,0,1,0,1
S01009125,All HRPs aged 16 and over,301,185,161,25,136,16,8,116,95,0,4,14,3
S01009125,Owned: Total,205,134,119,11,108,11,4,71,65,0,1,5,0
S01009125,Owned: Owned outright,89,30,25,4,21,3,2,59,54,0,1,4,0
S01009125,Owned: Owned with a mortgage or loan or shared ownership,116,104,94,7,87,8,2,12,11,0,0,1,0
S01009125,Rented or living rent free: Total,96,51,42,14,28,5,4,45,30,0,3,9,3
S01009125,Rented or living rent free: Social rented,83,40,35,10,25,3,2,43,28,0,3,9,3
S01009125,Rented or living rent free: Private rented or living rent free,13,11,7,4,3,2,2,2,2,0,0,0,0
S01009126,All HRPs aged 16 and over,281,178,130,29,101,12,36,103,50,2,10,33,8
S01009126,Owned: Total,69,51,39,6,33,9,3,18,15,0,1,2,0
S01009126,Owned: Owned outright,25,11,9,2,7,2,0,14,13,0,1,0,0
S01009126,Owned: Owned with a mortgage or loan or shared ownership,44,40,30,4,26,7,3,4,2,0,0,2,0
S01009126,Rented or living rent free: Total,212,127,91,23,68,3,33,85,35,2,9,31,8
S01009126,Rented or living rent free: Social rented,195,113,79,20,59,3,31,82,35,2,8,29,8
S01009126,Rented or living rent free: Private rented or living rent free,17,14,12,3,9,0,2,3,0,0,1,2,0
S01009127,All HRPs aged 16 and over,269,179,133,30,103,14,32,90,33,4,10,32,11
S01009127,Owned: Total,75,55,50,7,43,5,0,20,16,1,0,0,3
S01009127,Owned: Owned outright,26,10,9,2,7,1,0,16,13,1,0,0,2
S01009127,Owned: Owned with a mortgage or loan or shared ownership,49,45,41,5,36,4,0,4,3,0,0,0,1
S01009127,Rented or living rent free: Total,194,124,83,23,60,9,32,70,17,3,10,32,8
S01009127,Rented or living rent free: Social rented,190,122,81,21,60,9,32,68,17,3,10,30,8
S01009127,Rented or living rent free: Private rented or living rent free,4,2,2,2,0,0,0,2,0,0,0,2,0
S01009128,All HRPs aged 16 and over,467,239,185,39,146,16,38,228,147,3,19,48,11
S01009128,Owned: Total,132,96,86,10,76,6,4,36,30,0,1,2,3
S01009128,Owned: Owned outright,51,20,16,4,12,3,1,31,28,0,0,1,2
S01009128,Owned: Owned with a mortgage or loan or shared ownership,81,76,70,6,64,3,3,5,2,0,1,1,1
S01009128,Rented or living rent free: Total,335,143,99,29,70,10,34,192,117,3,18,46,8
S01009128,Rented or living rent free: Social rented,289,112,72,25,47,8,32,177,109,2,15,43,8
S01009128,Rented or living rent free: Private rented or living rent free,46,31,27,4,23,2,2,15,8,1,3,3,0
S01009129,All HRPs aged 16 and over,205,126,105,16,89,4,17,79,47,0,7,23,2
S01009129,Owned: Total,83,62,60,7,53,2,0,21,20,0,0,0,1
S01009129,Owned: Owned outright,33,15,15,3,12,0,0,18,17,0,0,0,1
S01009129,Owned: Owned with a mortgage or loan or shared ownership,50,47,45,4,41,2,0,3,3,0,0,0,0
S01009129,Rented or living rent free: Total,122,64,45,9,36,2,17,58,27,0,7,23,1
S01009129,Rented or living rent free: Social rented,111,57,40,9,31,1,16,54,23,0,7,23,1
S01009129,Rented or living rent free: Private rented or living rent free,11,7,5,0,5,1,1,4,4,0,0,0,0
S01009130,All HRPs aged 16 and over,271,197,163,17,146,22,12,74,43,2,8,16,5
S01009130,Owned: Total,163,141,122,9,113,18,1,22,21,0,0,0,1
S01009130,Owned: Owned outright,38,19,15,2,13,4,0,19,18,0,0,0,1
S01009130,Owned: Owned with a mortgage or loan or shared ownership,125,122,107,7,100,14,1,3,3,0,0,0,0
S01009130,Rented or living rent free: Total,108,56,41,8,33,4,11,52,22,2,8,16,4
S01009130,Rented or living rent free: Social rented,97,48,35,5,30,2,11,49,20,2,7,16,4
S01009130,Rented or living rent free: Private rented or living rent free,11,8,6,3,3,2,0,3,2,0,1,0,0
S01009131,All HRPs aged 16 and over,260,160,132,16,116,12,16,100,72,0,6,15,7
S01009131,Owned: Total,143,93,85,10,75,6,2,50,45,0,1,3,1
S01009131,Owned: Owned outright,71,29,26,6,20,3,0,42,38,0,1,2,1
S01009131,Owned: Owned with a mortgage or loan or shared ownership,72,64,59,4,55,3,2,8,7,0,0,1,0
S01009131,Rented or living rent free: Total,117,67,47,6,41,6,14,50,27,0,5,12,6
S01009131,Rented or living rent free: Social rented,82,40,31,4,27,1,8,42,26,0,4,10,2
S01009131,Rented or living rent free: Private rented or living rent free,35,27,16,2,14,5,6,8,1,0,1,2,4
S01009132,All HRPs aged 16 and over,329,271,239,26,213,22,10,58,38,1,8,6,5
S01009132,Owned: Total,267,227,203,13,190,20,4,40,33,1,0,3,3
S01009132,Owned: Owned outright,74,44,37,8,29,5,2,30,27,0,0,1,2
S01009132,Owned: Owned with a mortgage or loan or shared ownership,193,183,166,5,161,15,2,10,6,1,0,2,1
S01009132,Rented or living rent free: Total,62,44,36,13,23,2,6,18,5,0,8,3,2
S01009132,Rented or living rent free: Social rented,21,12,8,4,4,0,4,9,4,0,1,3,1
S01009132,Rented or living rent free: Private rented or living rent free,41,32,28,9,19,2,2,9,1,0,7,0,1
S01009133,All HRPs aged 16 and over,301,195,161,25,136,15,19,106,59,1,3,34,9
S01009133,Owned: Total,144,108,97,15,82,10,1,36,30,0,0,6,0
S01009133,Owned: Owned outright,51,24,19,3,16,4,1,27,22,0,0,5,0
S01009133,Owned: Owned with a mortgage or loan or shared ownership,93,84,78,12,66,6,0,9,8,0,0,1,0
S01009133,Rented or living rent free: Total,157,87,64,10,54,5,18,70,29,1,3,28,9
S01009133,Rented or living rent free: Social rented,118,54,42,8,34,3,9,64,27,1,3,26,7
S01009133,Rented or living rent free: Private rented or living rent free,39,33,22,2,20,2,9,6,2,0,0,2,2
S01009134,All HRPs aged 16 and over,409,274,239,28,211,25,10,135,112,2,2,13,6
S01009134,Owned: Total,305,213,192,16,176,19,2,92,87,0,0,3,2
S01009134,Owned: Owned outright,143,55,49,9,40,5,1,88,84,0,0,3,1
S01009134,Owned: Owned with a mortgage or loan or shared ownership,162,158,143,7,136,14,1,4,3,0,0,0,1
S01009134,Rented or living rent free: Total,104,61,47,12,35,6,8,43,25,2,2,10,4
S01009134,Rented or living rent free: Social rented,74,39,31,10,21,3,5,35,19,2,2,10,2
S01009134,Rented or living rent free: Private rented or living rent free,30,22,16,2,14,3,3,8,6,0,0,0,2
S01009135,All HRPs aged 16 and over,264,224,194,11,183,21,9,40,22,0,1,8,9
S01009135,Owned: Total,184,164,147,8,139,15,2,20,17,0,0,1,2
S01009135,Owned: Owned outright,39,25,20,3,17,3,2,14,14,0,0,0,0
S01009135,Owned: Owned with a mortgage or loan or shared ownership,145,139,127,5,122,12,0,6,3,0,0,1,2
S01009135,Rented or living rent free: Total,80,60,47,3,44,6,7,20,5,0,1,7,7
S01009135,Rented or living rent free: Social rented,10,4,2,0,2,2,0,6,2,0,0,2,2
S01009135,Rented or living rent free: Private rented or living rent free,70,56,45,3,42,4,7,14,3,0,1,5,5
S01009136,All HRPs aged 16 and over,275,220,192,16,176,22,6,55,48,3,1,3,0
S01009136,Owned: Total,198,178,156,8,148,19,3,20,20,0,0,0,0
S01009136,Owned: Owned outright,31,13,11,4,7,2,0,18,18,0,0,0,0
S01009136,Owned: Owned with a mortgage or loan or shared ownership,167,165,145,4,141,17,3,2,2,0,0,0,0
S01009136,Rented or living rent free: Total,77,42,36,8,28,3,3,35,28,3,1,3,0
S01009136,Rented or living rent free: Social rented,13,3,2,1,1,0,1,10,6,0,1,3,0
S01009136,Rented or living rent free: Private rented or living rent free,64,39,34,7,27,3,2,25,22,3,0,0,0
S01009137,All HRPs aged 16 and over,203,195,163,8,155,32,0,8,8,0,0,0,0
S01009137,Owned: Total,191,183,153,6,147,30,0,8,8,0,0,0,0
S01009137,Owned: Owned outright,24,17,14,4,10,3,0,7,7,0,0,0,0
S01009137,Owned: Owned with a mortgage or loan or shared ownership,167,166,139,2,137,27,0,1,1,0,0,0,0
S01009137,Rented or living rent free: Total,12,12,10,2,8,2,0,0,0,0,0,0,0
S01009137,Rented or living rent free: Social rented,4,4,4,1,3,0,0,0,0,0,0,0,0
S01009137,Rented or living rent free: Private rented or living rent free,8,8,6,1,5,2,0,0,0,0,0,0,0
S01009138,All HRPs aged 16 and over,395,308,253,24,229,45,10,87,68,3,0,12,4
S01009138,Owned: Total,323,252,211,20,191,37,4,71,66,0,0,3,2
S01009138,Owned: Owned outright,125,63,52,16,36,9,2,62,60,0,0,1,1
S01009138,Owned: Owned with a mortgage or loan or shared ownership,198,189,159,4,155,28,2,9,6,0,0,2,1
S01009138,Rented or living rent free: Total,72,56,42,4,38,8,6,16,2,3,0,9,2
S01009138,Rented or living rent free: Social rented,11,1,1,1,0,0,0,10,2,0,0,6,2
S01009138,Rented or living rent free: Private rented or living rent free,61,55,41,3,38,8,6,6,0,3,0,3,0
S01009139,All HRPs aged 16 and over,239,180,137,24,113,13,30,59,24,4,3,24,4
S01009139,Owned: Total,77,61,51,4,47,8,2,16,14,0,0,2,0
S01009139,Owned: Owned outright,28,12,10,2,8,1,1,16,14,0,0,2,0
S01009139,Owned: Owned with a mortgage or loan or shared ownership,49,49,41,2,39,7,1,0,0,0,0,0,0
S01009139,Rented or living rent free: Total,162,119,86,20,66,5,28,43,10,4,3,22,4
S01009139,Rented or living rent free: Social rented,115,82,60,14,46,2,20,33,9,0,3,20,1
S01009139,Rented or living rent free: Private rented or living rent free,47,37,26,6,20,3,8,10,1,4,0,2,3
S01009140,All HRPs aged 16 and over,381,252,218,41,177,21,13,129,84,3,5,36,1
S01009140,Owned: Total,173,124,110,15,95,12,2,49,43,0,0,6,0
S01009140,Owned: Owned outright,65,26,23,5,18,2,1,39,35,0,0,4,0
S01009140,Owned: Owned with a mortgage or loan or shared ownership,108,98,87,10,77,10,1,10,8,0,0,2,0
S01009140,Rented or living rent free: Total,208,128,108,26,82,9,11,80,41,3,5,30,1
S01009140,Rented or living rent free: Social rented,155,92,78,22,56,5,9,63,32,0,3,28,0
S01009140,Rented or living rent free: Private rented or living rent free,53,36,30,4,26,4,2,17,9,3,2,2,1
S01009141,All HRPs aged 16 and over,473,299,244,39,205,24,31,174,112,2,7,49,4
S01009141,Owned: Total,152,125,112,8,104,11,2,27,26,0,1,0,0
S01009141,Owned: Owned outright,40,20,16,3,13,2,2,20,20,0,0,0,0
S01009141,Owned: Owned with a mortgage or loan or shared ownership,112,105,96,5,91,9,0,7,6,0,1,0,0
S01009141,Rented or living rent free: Total,321,174,132,31,101,13,29,147,86,2,6,49,4
S01009141,Rented or living rent free: Social rented,250,120,94,23,71,8,18,130,79,1,6,40,4
S01009141,Rented or living rent free: Private rented or living rent free,71,54,38,8,30,5,11,17,7,1,0,9,0
S01009142,All HRPs aged 16 and over,393,243,197,25,172,20,26,150,106,2,3,32,7
S01009142,Owned: Total,204,115,103,7,96,11,1,89,83,1,0,4,1
S01009142,Owned: Owned outright,105,28,24,5,19,4,0,77,74,0,0,2,1
S01009142,Owned: Owned with a mortgage or loan or shared ownership,99,87,79,2,77,7,1,12,9,1,0,2,0
S01009142,Rented or living rent free: Total,189,128,94,18,76,9,25,61,23,1,3,28,6
S01009142,Rented or living rent free: Social rented,72,41,29,8,21,1,11,31,12,1,1,14,3
S01009142,Rented or living rent free: Private rented or living rent free,117,87,65,10,55,8,14,30,11,0,2,14,3
S01009143,All HRPs aged 16 and over,312,162,130,27,103,17,15,150,105,1,8,31,5
S01009143,Owned: Total,108,84,70,10,60,12,2,24,20,0,0,3,1
S01009143,Owned: Owned outright,36,16,11,5,6,4,1,20,16,0,0,3,1
S01009143,Owned: Owned with a mortgage or loan or shared ownership,72,68,59,5,54,8,1,4,4,0,0,0,0
S01009143,Rented or living rent free: Total,204,78,60,17,43,5,13,126,85,1,8,28,4
S01009143,Rented or living rent free: Social rented,175,65,51,12,39,3,11,110,76,0,4,26,4
S01009143,Rented or living rent free: Private rented or living rent free,29,13,9,5,4,2,2,16,9,1,4,2,0
S01009144,All HRPs aged 16 and over,306,279,250,18,232,28,1,27,17,4,3,1,2
S01009144,Owned: Total,224,209,189,12,177,20,0,15,15,0,0,0,0
S01009144,Owned: Owned outright,37,24,20,6,14,4,0,13,13,0,0,0,0
S01009144,Owned: Owned with a mortgage or loan or shared ownership,187,185,169,6,163,16,0,2,2,0,0,0,0
S01009144,Rented or living rent free: Total,82,70,61,6,55,8,1,12,2,4,3,1,2
S01009144,Rented or living rent free: Social rented,5,5,4,3,1,1,0,0,0,0,0,0,0
S01009144,Rented or living rent free: Private rented or living rent free,77,65,57,3,54,7,1,12,2,4,3,1,2
S01009145,All HRPs aged 16 and over,497,290,251,41,210,21,18,207,164,2,4,30,7
S01009145,Owned: Total,321,203,180,20,160,16,7,118,108,0,1,8,1
S01009145,Owned: Owned outright,146,52,46,11,35,3,3,94,89,0,1,4,0
S01009145,Owned: Owned with a mortgage or loan or shared ownership,175,151,134,9,125,13,4,24,19,0,0,4,1
S01009145,Rented or living rent free: Total,176,87,71,21,50,5,11,89,56,2,3,22,6
S01009145,Rented or living rent free: Social rented,145,66,52,17,35,4,10,79,47,1,3,22,6
S01009145,Rented or living rent free: Private rented or living rent free,31,21,19,4,15,1,1,10,9,1,0,0,0
S01009146,All HRPs aged 16 and over,417,287,240,40,200,22,25,130,91,5,5,21,8
S01009146,Owned: Total,203,144,129,13,116,9,6,59,55,0,0,3,1
S01009146,Owned: Owned outright,80,33,28,6,22,3,2,47,46,0,0,1,0
S01009146,Owned: Owned with a mortgage or loan or shared ownership,123,111,101,7,94,6,4,12,9,0,0,2,1
S01009146,Rented or living rent free: Total,214,143,111,27,84,13,19,71,36,5,5,18,7
S01009146,Rented or living rent free: Social rented,116,61,41,13,28,5,15,55,32,0,4,16,3
S01009146,Rented or living rent free: Private rented or living rent free,98,82,70,14,56,8,4,16,4,5,1,2,4
S01009147,All HRPs aged 16 and over,353,212,179,42,137,15,18,141,91,3,14,24,9
S01009147,Owned: Total,163,107,93,15,78,11,3,56,52,1,1,2,0
S01009147,Owned: Owned outright,79,29,24,8,16,3,2,50,48,1,0,1,0
S01009147,Owned: Owned with a mortgage or loan or shared ownership,84,78,69,7,62,8,1,6,4,0,1,1,0
S01009147,Rented or living rent free: Total,190,105,86,27,59,4,15,85,39,2,13,22,9
S01009147,Rented or living rent free: Social rented,161,85,69,20,49,1,15,76,32,2,12,22,8
S01009147,Rented or living rent free: Private rented or living rent free,29,20,17,7,10,3,0,9,7,0,1,0,1
S01009148,All HRPs aged 16 and over,260,180,158,34,124,11,11,80,57,2,7,10,4
S01009148,Owned: Total,153,114,104,18,86,9,1,39,35,0,2,1,1
S01009148,Owned: Owned outright,69,39,37,10,27,2,0,30,28,0,0,1,1
S01009148,Owned: Owned with a mortgage or loan or shared ownership,84,75,67,8,59,7,1,9,7,0,2,0,0
S01009148,Rented or living rent free: Total,107,66,54,16,38,2,10,41,22,2,5,9,3
S01009148,Rented or living rent free: Social rented,98,60,48,13,35,2,10,38,20,2,5,9,2
S01009148,Rented or living rent free: Private rented or living rent free,9,6,6,3,3,0,0,3,2,0,0,0,1
S01009149,All HRPs aged 16 and over,384,256,216,29,187,32,8,128,109,0,1,14,4
S01009149,Owned: Total,271,177,150,11,139,24,3,94,89,0,0,3,2
S01009149,Owned: Owned outright,128,40,31,5,26,9,0,88,86,0,0,1,1
S01009149,Owned: Owned with a mortgage or loan or shared ownership,143,137,119,6,113,15,3,6,3,0,0,2,1
S01009149,Rented or living rent free: Total,113,79,66,18,48,8,5,34,20,0,1,11,2
S01009149,Rented or living rent free: Social rented,39,17,13,8,5,2,2,22,13,0,1,7,1
S01009149,Rented or living rent free: Private rented or living rent free,74,62,53,10,43,6,3,12,7,0,0,4,1
S01009150,All HRPs aged 16 and over,574,75,57,17,40,11,7,499,460,0,1,25,13
S01009150,Owned: Total,99,25,20,3,17,3,2,74,69,0,0,1,4
S01009150,Owned: Owned outright,91,18,14,3,11,2,2,73,68,0,0,1,4
S01009150,Owned: Owned with a mortgage or loan or shared ownership,8,7,6,0,6,1,0,1,1,0,0,0,0
S01009150,Rented or living rent free: Total,475,50,37,14,23,8,5,425,391,0,1,24,9
S01009150,Rented or living rent free: Social rented,464,48,36,14,22,7,5,416,385,0,1,22,8
S01009150,Rented or living rent free: Private rented or living rent free,11,2,1,0,1,1,0,9,6,0,0,2,1
S01009151,All HRPs aged 16 and over,474,218,179,20,159,33,6,256,235,2,3,12,4
S01009151,Owned: Total,234,137,110,10,100,27,0,97,94,0,1,2,0
S01009151,Owned: Owned outright,119,33,25,6,19,8,0,86,84,0,0,2,0
S01009151,Owned: Owned with a mortgage or loan or shared ownership,115,104,85,4,81,19,0,11,10,0,1,0,0
S01009151,Rented or living rent free: Total,240,81,69,10,59,6,6,159,141,2,2,10,4
S01009151,Rented or living rent free: Social rented,164,18,14,3,11,2,2,146,133,0,1,9,3
S01009151,Rented or living rent free: Private rented or living rent free,76,63,55,7,48,4,4,13,8,2,1,1,1
S01009152,All HRPs aged 16 and over,462,245,204,21,183,22,19,217,182,1,4,18,12
S01009152,Owned: Total,145,95,78,10,68,15,2,50,46,0,0,0,4
S01009152,Owned: Owned outright,66,20,14,5,9,5,1,46,42,0,0,0,4
S01009152,Owned: Owned with a mortgage or loan or shared ownership,79,75,64,5,59,10,1,4,4,0,0,0,0
S01009152,Rented or living rent free: Total,317,150,126,11,115,7,17,167,136,1,4,18,8
S01009152,Rented or living rent free: Social rented,161,21,18,6,12,3,0,140,127,0,0,9,4
S01009152,Rented or living rent free: Private rented or living rent free,156,129,108,5,103,4,17,27,9,1,4,9,4
S01009153,All HRPs aged 16 and over,266,203,158,16,142,35,10,63,50,0,3,9,1
S01009153,Owned: Total,163,116,99,9,90,15,2,47,43,0,0,3,1
S01009153,Owned: Owned outright,67,22,17,3,14,5,0,45,42,0,0,2,1
S01009153,Owned: Owned with a mortgage or loan or shared ownership,96,94,82,6,76,10,2,2,1,0,0,1,0
S01009153,Rented or living rent free: Total,103,87,59,7,52,20,8,16,7,0,3,6,0
S01009153,Rented or living rent free: Social rented,8,6,5,2,3,1,0,2,1,0,1,0,0
S01009153,Rented or living rent free: Private rented or living rent free,95,81,54,5,49,19,8,14,6,0,2,6,0
S01009154,All HRPs aged 16 and over,438,268,207,22,185,55,6,170,153,1,0,6,10
S01009154,Owned: Total,334,189,145,15,130,42,2,145,139,0,0,2,4
S01009154,Owned: Owned outright,189,52,37,13,24,13,2,137,131,0,0,2,4
S01009154,Owned: Owned with a mortgage or loan or shared ownership,145,137,108,2,106,29,0,8,8,0,0,0,0
S01009154,Rented or living rent free: Total,104,79,62,7,55,13,4,25,14,1,0,4,6
S01009154,Rented or living rent free: Social rented,12,4,3,0,3,1,0,8,4,0,0,2,2
S01009154,Rented or living rent free: Private rented or living rent free,92,75,59,7,52,12,4,17,10,1,0,2,4
S01009155,All HRPs aged 16 and over,234,154,131,15,116,19,4,80,69,0,3,6,2
S01009155,Owned: Total,191,122,102,12,90,18,2,69,65,0,1,1,2
S01009155,Owned: Owned outright,98,35,27,10,17,8,0,63,59,0,1,1,2
S01009155,Owned: Owned with a mortgage or loan or shared ownership,93,87,75,2,73,10,2,6,6,0,0,0,0
S01009155,Rented or living rent free: Total,43,32,29,3,26,1,2,11,4,0,2,5,0
S01009155,Rented or living rent free: Social rented,10,7,7,3,4,0,0,3,0,0,0,3,0
S01009155,Rented or living rent free: Private rented or living rent free,33,25,22,0,22,1,2,8,4,0,2,2,0
S01009156,All HRPs aged 16 and over,247,150,117,15,102,26,7,97,94,0,2,1,0
S01009156,Owned: Total,214,129,102,13,89,26,1,85,84,0,1,0,0
S01009156,Owned: Owned outright,119,41,29,11,18,11,1,78,77,0,1,0,0
S01009156,Owned: Owned with a mortgage or loan or shared ownership,95,88,73,2,71,15,0,7,7,0,0,0,0
S01009156,Rented or living rent free: Total,33,21,15,2,13,0,6,12,10,0,1,1,0
S01009156,Rented or living rent free: Social rented,12,6,3,2,1,0,3,6,5,0,0,1,0
S01009156,Rented or living rent free: Private rented or living rent free,21,15,12,0,12,0,3,6,5,0,1,0,0
S01009157,All HRPs aged 16 and over,366,237,202,34,168,28,7,129,112,2,1,14,0
S01009157,Owned: Total,292,194,168,23,145,23,3,98,94,0,0,4,0
S01009157,Owned: Owned outright,140,59,51,14,37,6,2,81,78,0,0,3,0
S01009157,Owned: Owned with a mortgage or loan or shared ownership,152,135,117,9,108,17,1,17,16,0,0,1,0
S01009157,Rented or living rent free: Total,74,43,34,11,23,5,4,31,18,2,1,10,0
S01009157,Rented or living rent free: Social rented,48,23,17,6,11,2,4,25,16,2,0,7,0
S01009157,Rented or living rent free: Private rented or living rent free,26,20,17,5,12,3,0,6,2,0,1,3,0
S01009158,All HRPs aged 16 and over,277,164,146,19,127,10,8,113,97,0,3,8,5
S01009158,Owned: Total,187,111,104,6,98,6,1,76,73,0,0,1,2
S01009158,Owned: Owned outright,78,19,17,2,15,2,0,59,59,0,0,0,0
S01009158,Owned: Owned with a mortgage or loan or shared ownership,109,92,87,4,83,4,1,17,14,0,0,1,2
S01009158,Rented or living rent free: Total,90,53,42,13,29,4,7,37,24,0,3,7,3
S01009158,Rented or living rent free: Social rented,65,31,23,9,14,2,6,34,22,0,3,7,2
S01009158,Rented or living rent free: Private rented or living rent free,25,22,19,4,15,2,1,3,2,0,0,0,1
S01009159,All HRPs aged 16 and over,250,140,112,34,78,15,13,110,59,3,7,34,7
S01009159,Owned: Total,76,54,45,8,37,8,1,22,21,1,0,0,0
S01009159,Owned: Owned outright,28,13,10,3,7,3,0,15,15,0,0,0,0
S01009159,Owned: Owned with a mortgage or loan or shared ownership,48,41,35,5,30,5,1,7,6,1,0,0,0
S01009159,Rented or living rent free: Total,174,86,67,26,41,7,12,88,38,2,7,34,7
S01009159,Rented or living rent free: Social rented,161,78,60,24,36,6,12,83,36,2,6,32,7
S01009159,Rented or living rent free: Private rented or living rent free,13,8,7,2,5,1,0,5,2,0,1,2,0
S01009160,All HRPs aged 16 and over,327,221,175,32,143,20,26,106,74,1,5,23,3
S01009160,Owned: Total,143,99,84,10,74,12,3,44,43,0,0,1,0
S01009160,Owned: Owned outright,56,23,15,4,11,6,2,33,33,0,0,0,0
S01009160,Owned: Owned with a mortgage or loan or shared ownership,87,76,69,6,63,6,1,11,10,0,0,1,0
S01009160,Rented or living rent free: Total,184,122,91,22,69,8,23,62,31,1,5,22,3
S01009160,Rented or living rent free: Social rented,147,94,70,17,53,6,18,53,27,1,2,20,3
S01009160,Rented or living rent free: Private rented or living rent free,37,28,21,5,16,2,5,9,4,0,3,2,0
S01009161,All HRPs aged 16 and over,349,186,145,38,107,9,32,163,114,2,5,35,7
S01009161,Owned: Total,114,72,63,10,53,6,3,42,39,0,0,3,0
S01009161,Owned: Owned outright,48,14,12,5,7,0,2,34,32,0,0,2,0
S01009161,Owned: Owned with a mortgage or loan or shared ownership,66,58,51,5,46,6,1,8,7,0,0,1,0
S01009161,Rented or living rent free: Total,235,114,82,28,54,3,29,121,75,2,5,32,7
S01009161,Rented or living rent free: Social rented,181,80,57,20,37,1,22,101,65,1,3,28,4
S01009161,Rented or living rent free: Private rented or living rent free,54,34,25,8,17,2,7,20,10,1,2,4,3
S01009162,All HRPs aged 16 and over,436,257,217,34,183,12,28,179,120,1,2,40,16
S01009162,Owned: Total,185,133,124,13,111,7,2,52,47,0,0,5,0
S01009162,Owned: Owned outright,69,23,20,3,17,2,1,46,42,0,0,4,0
S01009162,Owned: Owned with a mortgage or loan or shared ownership,116,110,104,10,94,5,1,6,5,0,0,1,0
S01009162,Rented or living rent free: Total,251,124,93,21,72,5,26,127,73,1,2,35,16
S01009162,Rented or living rent free: Social rented,159,56,42,17,25,1,13,103,55,0,2,34,12
S01009162,Rented or living rent free: Private rented or living rent free,92,68,51,4,47,4,13,24,18,1,0,1,4
S01009163,All HRPs aged 16 and over,233,140,116,17,99,12,12,93,80,1,3,7,2
S01009163,Owned: Total,166,104,89,13,76,8,7,62,59,0,1,0,2
S01009163,Owned: Owned outright,95,38,33,7,26,3,2,57,55,0,0,0,2
S01009163,Owned: Owned with a mortgage or loan or shared ownership,71,66,56,6,50,5,5,5,4,0,1,0,0
S01009163,Rented or living rent free: Total,67,36,27,4,23,4,5,31,21,1,2,7,0
S01009163,Rented or living rent free: Social rented,31,12,8,3,5,3,1,19,12,0,2,5,0
S01009163,Rented or living rent free: Private rented or living rent free,36,24,19,1,18,1,4,12,9,1,0,2,0
S01009164,All HRPs aged 16 and over,307,196,170,28,142,14,12,111,80,0,13,16,2
S01009164,Owned: Total,196,134,118,15,103,13,3,62,56,0,3,2,1
S01009164,Owned: Owned outright,83,31,25,9,16,4,2,52,51,0,1,0,0
S01009164,Owned: Owned with a mortgage or loan or shared ownership,113,103,93,6,87,9,1,10,5,0,2,2,1
S01009164,Rented or living rent free: Total,111,62,52,13,39,1,9,49,24,0,10,14,1
S01009164,Rented or living rent free: Social rented,96,53,44,11,33,1,8,43,21,0,8,13,1
S01009164,Rented or living rent free: Private rented or living rent free,15,9,8,2,6,0,1,6,3,0,2,1,0
S01009165,All HRPs aged 16 and over,324,199,162,28,134,9,28,125,70,2,14,34,5
S01009165,Owned: Total,134,90,84,11,73,3,3,44,34,1,1,7,1
S01009165,Owned: Owned outright,63,25,22,6,16,1,2,38,31,0,1,5,1
S01009165,Owned: Owned with a mortgage or loan or shared ownership,71,65,62,5,57,2,1,6,3,1,0,2,0
S01009165,Rented or living rent free: Total,190,109,78,17,61,6,25,81,36,1,13,27,4
S01009165,Rented or living rent free: Social rented,148,76,52,12,40,4,20,72,31,1,12,24,4
S01009165,Rented or living rent free: Private rented or living rent free,42,33,26,5,21,2,5,9,5,0,1,3,0
S01009166,All HRPs aged 16 and over,399,231,191,51,140,12,28,168,101,2,12,44,9
S01009166,Owned: Total,151,102,92,9,83,9,1,49,47,0,0,1,1
S01009166,Owned: Owned outright,53,16,14,0,14,2,0,37,36,0,0,0,1
S01009166,Owned: Owned with a mortgage or loan or shared ownership,98,86,78,9,69,7,1,12,11,0,0,1,0
S01009166,Rented or living rent free: Total,248,129,99,42,57,3,27,119,54,2,12,43,8
S01009166,Rented or living rent free: Social rented,227,114,89,40,49,2,23,113,51,1,11,42,8
S01009166,Rented or living rent free: Private rented or living rent free,21,15,10,2,8,1,4,6,3,1,1,1,0
S01009167,All HRPs aged 16 and over,198,130,103,20,83,17,10,68,42,2,6,17,1
S01009167,Owned: Total,100,74,63,8,55,10,1,26,22,0,1,2,1
S01009167,Owned: Owned outright,30,11,10,2,8,1,0,19,16,0,1,1,1
S01009167,Owned: Owned with a mortgage or loan or shared ownership,70,63,53,6,47,9,1,7,6,0,0,1,0
S01009167,Rented or living rent free: Total,98,56,40,12,28,7,9,42,20,2,5,15,0
S01009167,Rented or living rent free: Social rented,94,52,39,12,27,6,7,42,20,2,5,15,0
S01009167,Rented or living rent free: Private rented or living rent free,4,4,1,0,1,1,2,0,0,0,0,0,0
S01009168,All HRPs aged 16 and over,297,186,160,29,131,21,5,111,105,0,3,1,2
S01009168,Owned: Total,268,163,141,27,114,18,4,105,100,0,3,0,2
S01009168,Owned: Owned outright,162,66,51,20,31,13,2,96,91,0,3,0,2
S01009168,Owned: Owned with a mortgage or loan or shared ownership,106,97,90,7,83,5,2,9,9,0,0,0,0
S01009168,Rented or living rent free: Total,29,23,19,2,17,3,1,6,5,0,0,1,0
S01009168,Rented or living rent free: Social rented,2,0,0,0,0,0,0,2,1,0,0,1,0
S01009168,Rented or living rent free: Private rented or living rent free,27,23,19,2,17,3,1,4,4,0,0,0,0
S01009169,All HRPs aged 16 and over,420,150,129,26,103,16,5,270,232,3,6,22,7
S01009169,Owned: Total,176,101,89,10,79,12,0,75,67,1,2,2,3
S01009169,Owned: Owned outright,93,28,22,7,15,6,0,65,59,0,1,2,3
S01009169,Owned: Owned with a mortgage or loan or shared ownership,83,73,67,3,64,6,0,10,8,1,1,0,0
S01009169,Rented or living rent free: Total,244,49,40,16,24,4,5,195,165,2,4,20,4
S01009169,Rented or living rent free: Social rented,231,39,31,14,17,3,5,192,163,2,4,19,4
S01009169,Rented or living rent free: Private rented or living rent free,13,10,9,2,7,1,0,3,2,0,0,1,0
S01009170,All HRPs aged 16 and over,282,199,165,42,123,19,15,83,58,0,8,13,4
S01009170,Owned: Total,165,124,104,19,85,15,5,41,38,0,0,2,1
S01009170,Owned: Owned outright,56,27,20,7,13,3,4,29,28,0,0,1,0
S01009170,Owned: Owned with a mortgage or loan or shared ownership,109,97,84,12,72,12,1,12,10,0,0,1,1
S01009170,Rented or living rent free: Total,117,75,61,23,38,4,10,42,20,0,8,11,3
S01009170,Rented or living rent free: Social rented,88,53,43,18,25,2,8,35,17,0,4,11,3
S01009170,Rented or living rent free: Private rented or living rent free,29,22,18,5,13,2,2,7,3,0,4,0,0
S01009171,All HRPs aged 16 and over,297,223,171,16,155,20,32,74,42,3,4,19,6
S01009171,Owned: Total,179,148,128,8,120,17,3,31,30,0,0,1,0
S01009171,Owned: Owned outright,51,25,19,4,15,5,1,26,26,0,0,0,0
S01009171,Owned: Owned with a mortgage or loan or shared ownership,128,123,109,4,105,12,2,5,4,0,0,1,0
S01009171,Rented or living rent free: Total,118,75,43,8,35,3,29,43,12,3,4,18,6
S01009171,Rented or living rent free: Social rented,99,61,35,7,28,2,24,38,12,1,4,16,5
S01009171,Rented or living rent free: Private rented or living rent free,19,14,8,1,7,1,5,5,0,2,0,2,1
S01009172,All HRPs aged 16 and over,288,197,163,10,153,30,4,91,86,1,0,2,2
S01009172,Owned: Total,254,171,142,10,132,26,3,83,79,1,0,2,1
S01009172,Owned: Owned outright,123,46,32,5,27,12,2,77,75,1,0,0,1
S01009172,Owned: Owned with a mortgage or loan or shared ownership,131,125,110,5,105,14,1,6,4,0,0,2,0
S01009172,Rented or living rent free: Total,34,26,21,0,21,4,1,8,7,0,0,0,1
S01009172,Rented or living rent free: Social rented,3,0,0,0,0,0,0,3,3,0,0,0,0
S01009172,Rented or living rent free: Private rented or living rent free,31,26,21,0,21,4,1,5,4,0,0,0,1
S01009173,All HRPs aged 16 and over,309,228,194,20,174,31,3,81,78,1,0,0,2
S01009173,Owned: Total,278,209,179,15,164,28,2,69,67,1,0,0,1
S01009173,Owned: Owned outright,128,60,49,10,39,9,2,68,66,1,0,0,1
S01009173,Owned: Owned with a mortgage or loan or shared ownership,150,149,130,5,125,19,0,1,1,0,0,0,0
S01009173,Rented or living rent free: Total,31,19,15,5,10,3,1,12,11,0,0,0,1
S01009173,Rented or living rent free: Social rented,13,8,7,2,5,0,1,5,4,0,0,0,1
S01009173,Rented or living rent free: Private rented or living rent free,18,11,8,3,5,3,0,7,7,0,0,0,0
S01009174,All HRPs aged 16 and over,162,156,132,10,122,23,1,6,5,0,0,1,0
S01009174,Owned: Total,151,146,124,7,117,22,0,5,5,0,0,0,0
S01009174,Owned: Owned outright,21,17,14,2,12,3,0,4,4,0,0,0,0
S01009174,Owned: Owned with a mortgage or loan or shared ownership,130,129,110,5,105,19,0,1,1,0,0,0,0
S01009174,Rented or living rent free: Total,11,10,8,3,5,1,1,1,0,0,0,1,0
S01009174,Rented or living rent free: Social rented,4,3,3,1,2,0,0,1,0,0,0,1,0
S01009174,Rented or living rent free: Private rented or living rent free,7,7,5,2,3,1,1,0,0,0,0,0,0
S01009175,All HRPs aged 16 and over,300,272,238,16,222,32,2,28,26,0,0,1,1
S01009175,Owned: Total,285,262,230,15,215,30,2,23,22,0,0,0,1
S01009175,Owned: Owned outright,67,49,39,5,34,9,1,18,18,0,0,0,0
S01009175,Owned: Owned with a mortgage or loan or shared ownership,218,213,191,10,181,21,1,5,4,0,0,0,1
S01009175,Rented or living rent free: Total,15,10,8,1,7,2,0,5,4,0,0,1,0
S01009175,Rented or living rent free: Social rented,6,1,1,1,0,0,0,5,4,0,0,1,0
S01009175,Rented or living rent free: Private rented or living rent free,9,9,7,0,7,2,0,0,0,0,0,0,0
S01009176,All HRPs aged 16 and over,400,251,199,21,178,48,4,149,146,0,1,2,0
S01009176,Owned: Total,375,234,191,20,171,40,3,141,139,0,1,1,0
S01009176,Owned: Owned outright,207,76,63,14,49,11,2,131,131,0,0,0,0
S01009176,Owned: Owned with a mortgage or loan or shared ownership,168,158,128,6,122,29,1,10,8,0,1,1,0
S01009176,Rented or living rent free: Total,25,17,8,1,7,8,1,8,7,0,0,1,0
S01009176,Rented or living rent free: Social rented,5,1,1,0,1,0,0,4,3,0,0,1,0
S01009176,Rented or living rent free: Private rented or living rent free,20,16,7,1,6,8,1,4,4,0,0,0,0
S01009177,All HRPs aged 16 and over,367,261,199,38,161,36,26,106,51,4,18,25,8
S01009177,Owned: Total,198,158,119,11,108,31,8,40,34,1,2,2,1
S01009177,Owned: Owned outright,72,42,34,7,27,6,2,30,30,0,0,0,0
S01009177,Owned: Owned with a mortgage or loan or shared ownership,126,116,85,4,81,25,6,10,4,1,2,2,1
S01009177,Rented or living rent free: Total,169,103,80,27,53,5,18,66,17,3,16,23,7
S01009177,Rented or living rent free: Social rented,145,89,68,26,42,5,16,56,12,2,13,23,6
S01009177,Rented or living rent free: Private rented or living rent free,24,14,12,1,11,0,2,10,5,1,3,0,1
S01009178,All HRPs aged 16 and over,320,234,179,35,144,23,32,86,41,4,19,19,3
S01009178,Owned: Total,150,123,106,12,94,14,3,27,24,1,1,1,0
S01009178,Owned: Owned outright,43,26,20,4,16,5,1,17,17,0,0,0,0
S01009178,Owned: Owned with a mortgage or loan or shared ownership,107,97,86,8,78,9,2,10,7,1,1,1,0
S01009178,Rented or living rent free: Total,170,111,73,23,50,9,29,59,17,3,18,18,3
S01009178,Rented or living rent free: Social rented,156,103,66,20,46,8,29,53,16,3,15,16,3
S01009178,Rented or living rent free: Private rented or living rent free,14,8,7,3,4,1,0,6,1,0,3,2,0
S01009179,All HRPs aged 16 and over,273,199,172,34,138,15,12,74,44,1,9,20,0
S01009179,Owned: Total,183,147,133,15,118,12,2,36,31,0,1,4,0
S01009179,Owned: Owned outright,56,29,25,8,17,3,1,27,25,0,0,2,0
S01009179,Owned: Owned with a mortgage or loan or shared ownership,127,118,108,7,101,9,1,9,6,0,1,2,0
S01009179,Rented or living rent free: Total,90,52,39,19,20,3,10,38,13,1,8,16,0
S01009179,Rented or living rent free: Social rented,72,40,30,16,14,1,9,32,11,1,5,15,0
S01009179,Rented or living rent free: Private rented or living rent free,18,12,9,3,6,2,1,6,2,0,3,1,0
S01009180,All HRPs aged 16 and over,437,290,246,55,191,25,19,147,103,0,11,27,6
S01009180,Owned: Total,263,190,170,26,144,18,2,73,67,0,0,4,2
S01009180,Owned: Owned outright,111,55,48,16,32,7,0,56,54,0,0,1,1
S01009180,Owned: Owned with a mortgage or loan or shared ownership,152,135,122,10,112,11,2,17,13,0,0,3,1
S01009180,Rented or living rent free: Total,174,100,76,29,47,7,17,74,36,0,11,23,4
S01009180,Rented or living rent free: Social rented,148,82,63,26,37,6,13,66,33,0,7,23,3
S01009180,Rented or living rent free: Private rented or living rent free,26,18,13,3,10,1,4,8,3,0,4,0,1
S01009181,All HRPs aged 16 and over,361,230,182,33,149,32,16,131,104,4,5,16,2
S01009181,Owned: Total,201,142,109,9,100,29,4,59,59,0,0,0,0
S01009181,Owned: Owned outright,96,45,29,3,26,13,3,51,51,0,0,0,0
S01009181,Owned: Owned with a mortgage or loan or shared ownership,105,97,80,6,74,16,1,8,8,0,0,0,0
S01009181,Rented or living rent free: Total,160,88,73,24,49,3,12,72,45,4,5,16,2
S01009181,Rented or living rent free: Social rented,142,75,64,24,40,1,10,67,41,4,5,15,2
S01009181,Rented or living rent free: Private rented or living rent free,18,13,9,0,9,2,2,5,4,0,0,1,0
S01009182,All HRPs aged 16 and over,419,313,255,19,236,44,14,106,90,1,3,12,0
S01009182,Owned: Total,346,272,225,12,213,40,7,74,70,0,1,3,0
S01009182,Owned: Owned outright,122,58,44,3,41,12,2,64,62,0,0,2,0
S01009182,Owned: Owned with a mortgage or loan or shared ownership,224,214,181,9,172,28,5,10,8,0,1,1,0
S01009182,Rented or living rent free: Total,73,41,30,7,23,4,7,32,20,1,2,9,0
S01009182,Rented or living rent free: Social rented,52,30,22,6,16,3,5,22,12,1,1,8,0
S01009182,Rented or living rent free: Private rented or living rent free,21,11,8,1,7,1,2,10,8,0,1,1,0
S01009183,All HRPs aged 16 and over,267,228,201,21,180,24,3,39,37,0,0,2,0
S01009183,Owned: Total,257,220,195,18,177,22,3,37,37,0,0,0,0
S01009183,Owned: Owned outright,71,42,37,8,29,4,1,29,29,0,0,0,0
S01009183,Owned: Owned with a mortgage or loan or shared ownership,186,178,158,10,148,18,2,8,8,0,0,0,0
S01009183,Rented or living rent free: Total,10,8,6,3,3,2,0,2,0,0,0,2,0
S01009183,Rented or living rent free: Social rented,2,0,0,0,0,0,0,2,0,0,0,2,0
S01009183,Rented or living rent free: Private rented or living rent free,8,8,6,3,3,2,0,0,0,0,0,0,0
S01009184,All HRPs aged 16 and over,376,234,156,24,132,49,29,142,97,2,9,30,4
S01009184,Owned: Total,180,126,90,10,80,34,2,54,47,1,0,5,1
S01009184,Owned: Owned outright,76,35,19,3,16,15,1,41,38,0,0,2,1
S01009184,Owned: Owned with a mortgage or loan or shared ownership,104,91,71,7,64,19,1,13,9,1,0,3,0
S01009184,Rented or living rent free: Total,196,108,66,14,52,15,27,88,50,1,9,25,3
S01009184,Rented or living rent free: Social rented,176,91,59,12,47,8,24,85,48,1,8,25,3
S01009184,Rented or living rent free: Private rented or living rent free,20,17,7,2,5,7,3,3,2,0,1,0,0
S01009185,All HRPs aged 16 and over,354,234,179,32,147,39,16,120,78,0,10,28,4
S01009185,Owned: Total,182,131,99,15,84,29,3,51,45,0,0,5,1
S01009185,Owned: Owned outright,74,31,16,5,11,14,1,43,38,0,0,4,1
S01009185,Owned: Owned with a mortgage or loan or shared ownership,108,100,83,10,73,15,2,8,7,0,0,1,0
S01009185,Rented or living rent free: Total,172,103,80,17,63,10,13,69,33,0,10,23,3
S01009185,Rented or living rent free: Social rented,151,90,74,15,59,5,11,61,28,0,10,21,2
S01009185,Rented or living rent free: Private rented or living rent free,21,13,6,2,4,5,2,8,5,0,0,2,1
S01009186,All HRPs aged 16 and over,312,218,172,22,150,32,14,94,78,0,6,9,1
S01009186,Owned: Total,198,152,124,11,113,25,3,46,45,0,1,0,0
S01009186,Owned: Owned outright,74,34,24,4,20,8,2,40,39,0,1,0,0
S01009186,Owned: Owned with a mortgage or loan or shared ownership,124,118,100,7,93,17,1,6,6,0,0,0,0
S01009186,Rented or living rent free: Total,114,66,48,11,37,7,11,48,33,0,5,9,1
S01009186,Rented or living rent free: Social rented,99,57,44,10,34,5,8,42,29,0,4,8,1
S01009186,Rented or living rent free: Private rented or living rent free,15,9,4,1,3,2,3,6,4,0,1,1,0
S01009187,All HRPs aged 16 and over,215,150,107,16,91,42,1,65,57,0,1,6,1
S01009187,Owned: Total,174,126,87,11,76,39,0,48,46,0,0,1,1
S01009187,Owned: Owned outright,84,44,25,8,17,19,0,40,38,0,0,1,1
S01009187,Owned: Owned with a mortgage or loan or shared ownership,90,82,62,3,59,20,0,8,8,0,0,0,0
S01009187,Rented or living rent free: Total,41,24,20,5,15,3,1,17,11,0,1,5,0
S01009187,Rented or living rent free: Social rented,20,10,8,3,5,1,1,10,6,0,1,3,0
S01009187,Rented or living rent free: Private rented or living rent free,21,14,12,2,10,2,0,7,5,0,0,2,0
S01009188,All HRPs aged 16 and over,383,247,190,28,162,44,13,136,93,2,10,24,7
S01009188,Owned: Total,217,167,126,12,114,37,4,50,46,1,1,0,2
S01009188,Owned: Owned outright,86,43,23,1,22,17,3,43,40,0,1,0,2
S01009188,Owned: Owned with a mortgage or loan or shared ownership,131,124,103,11,92,20,1,7,6,1,0,0,0
S01009188,Rented or living rent free: Total,166,80,64,16,48,7,9,86,47,1,9,24,5
S01009188,Rented or living rent free: Social rented,151,68,58,16,42,2,8,83,45,1,8,24,5
S01009188,Rented or living rent free: Private rented or living rent free,15,12,6,0,6,5,1,3,2,0,1,0,0
S01009189,All HRPs aged 16 and over,336,214,177,29,148,17,20,122,83,0,11,20,8
S01009189,Owned: Total,159,114,98,10,88,13,3,45,40,0,1,1,3
S01009189,Owned: Owned outright,71,35,29,4,25,4,2,36,33,0,1,0,2
S01009189,Owned: Owned with a mortgage or loan or shared ownership,88,79,69,6,63,9,1,9,7,0,0,1,1
S01009189,Rented or living rent free: Total,177,100,79,19,60,4,17,77,43,0,10,19,5
S01009189,Rented or living rent free: Social rented,169,97,77,19,58,4,16,72,39,0,10,18,5
S01009189,Rented or living rent free: Private rented or living rent free,8,3,2,0,2,0,1,5,4,0,0,1,0
S01009190,All HRPs aged 16 and over,309,259,207,27,180,50,2,50,43,0,1,6,0
S01009190,Owned: Total,269,229,185,24,161,42,2,40,37,0,0,3,0
S01009190,Owned: Owned outright,75,41,31,9,22,10,0,34,31,0,0,3,0
S01009190,Owned: Owned with a mortgage or loan or shared ownership,194,188,154,15,139,32,2,6,6,0,0,0,0
S01009190,Rented or living rent free: Total,40,30,22,3,19,8,0,10,6,0,1,3,0
S01009190,Rented or living rent free: Social rented,23,14,10,2,8,4,0,9,5,0,1,3,0
S01009190,Rented or living rent free: Private rented or living rent free,17,16,12,1,11,4,0,1,1,0,0,0,0
S01009191,All HRPs aged 16 and over,229,216,188,8,180,25,3,13,9,1,2,0,1
S01009191,Owned: Total,216,206,178,7,171,25,3,10,8,0,1,0,1
S01009191,Owned: Owned outright,31,24,19,0,19,5,0,7,7,0,0,0,0
S01009191,Owned: Owned with a mortgage or loan or shared ownership,185,182,159,7,152,20,3,3,1,0,1,0,1
S01009191,Rented or living rent free: Total,13,10,10,1,9,0,0,3,1,1,1,0,0
S01009191,Rented or living rent free: Social rented,7,6,6,0,6,0,0,1,1,0,0,0,0
S01009191,Rented or living rent free: Private rented or living rent free,6,4,4,1,3,0,0,2,0,1,1,0,0
S01009192,All HRPs aged 16 and over,258,187,157,24,133,22,8,71,69,0,0,2,0
S01009192,Owned: Total,223,158,138,21,117,18,2,65,65,0,0,0,0
S01009192,Owned: Owned outright,91,33,30,13,17,2,1,58,58,0,0,0,0
S01009192,Owned: Owned with a mortgage or loan or shared ownership,132,125,108,8,100,16,1,7,7,0,0,0,0
S01009192,Rented or living rent free: Total,35,29,19,3,16,4,6,6,4,0,0,2,0
S01009192,Rented or living rent free: Social rented,17,14,7,3,4,3,4,3,1,0,0,2,0
S01009192,Rented or living rent free: Private rented or living rent free,18,15,12,0,12,1,2,3,3,0,0,0,0
S01009193,All HRPs aged 16 and over,127,116,108,6,102,6,2,11,7,0,0,2,2
S01009193,Owned: Total,118,111,104,5,99,6,1,7,7,0,0,0,0
S01009193,Owned: Owned outright,20,13,11,1,10,2,0,7,7,0,0,0,0
S01009193,Owned: Owned with a mortgage or loan or shared ownership,98,98,93,4,89,4,1,0,0,0,0,0,0
S01009193,Rented or living rent free: Total,9,5,4,1,3,0,1,4,0,0,0,2,2
S01009193,Rented or living rent free: Social rented,6,3,3,0,3,0,0,3,0,0,0,2,1
S01009193,Rented or living rent free: Private rented or living rent free,3,2,1,1,0,0,1,1,0,0,0,0,1
S01009194,All HRPs aged 16 and over,323,230,190,21,169,37,3,93,89,0,2,2,0
S01009194,Owned: Total,303,215,178,20,158,35,2,88,86,0,1,1,0
S01009194,Owned: Owned outright,162,80,63,14,49,15,2,82,82,0,0,0,0
S01009194,Owned: Owned with a mortgage or loan or shared ownership,141,135,115,6,109,20,0,6,4,0,1,1,0
S01009194,Rented or living rent free: Total,20,15,12,1,11,2,1,5,3,0,1,1,0
S01009194,Rented or living rent free: Social rented,5,3,2,0,2,0,1,2,0,0,1,1,0
S01009194,Rented or living rent free: Private rented or living rent free,15,12,10,1,9,2,0,3,3,0,0,0,0
S01009195,All HRPs aged 16 and over,353,286,248,15,233,29,9,67,65,0,1,1,0
S01009195,Owned: Total,307,255,226,13,213,25,4,52,52,0,0,0,0
S01009195,Owned: Owned outright,80,45,32,5,27,12,1,35,35,0,0,0,0
S01009195,Owned: Owned with a mortgage or loan or shared ownership,227,210,194,8,186,13,3,17,17,0,0,0,0
S01009195,Rented or living rent free: Total,46,31,22,2,20,4,5,15,13,0,1,1,0
S01009195,Rented or living rent free: Social rented,13,5,2,0,2,0,3,8,7,0,1,0,0
S01009195,Rented or living rent free: Private rented or living rent free,33,26,20,2,18,4,2,7,6,0,0,1,0
S01009196,All HRPs aged 16 and over,298,183,150,21,129,25,8,115,103,2,4,3,3
S01009196,Owned: Total,215,135,112,11,101,20,3,80,75,1,0,2,2
S01009196,Owned: Owned outright,107,37,29,6,23,6,2,70,67,1,0,0,2
S01009196,Owned: Owned with a mortgage or loan or shared ownership,108,98,83,5,78,14,1,10,8,0,0,2,0
S01009196,Rented or living rent free: Total,83,48,38,10,28,5,5,35,28,1,4,1,1
S01009196,Rented or living rent free: Social rented,63,33,26,7,19,3,4,30,25,0,3,1,1
S01009196,Rented or living rent free: Private rented or living rent free,20,15,12,3,9,2,1,5,3,1,1,0,0
S01009197,All HRPs aged 16 and over,401,305,261,26,235,40,4,96,79,2,5,7,3
S01009197,Owned: Total,347,275,232,15,217,40,3,72,69,0,2,1,0
S01009197,Owned: Owned outright,117,49,40,5,35,8,1,68,65,0,2,1,0
S01009197,Owned: Owned with a mortgage or loan or shared ownership,230,226,192,10,182,32,2,4,4,0,0,0,0
S01009197,Rented or living rent free: Total,54,30,29,11,18,0,1,24,10,2,3,6,3
S01009197,Rented or living rent free: Social rented,25,12,11,7,4,0,1,13,7,0,1,5,0
S01009197,Rented or living rent free: Private rented or living rent free,29,18,18,4,14,0,0,11,3,2,2,1,3
S01009198,All HRPs aged 16 and over,306,212,169,20,149,35,8,94,87,2,0,3,2
S01009198,Owned: Total,255,190,154,16,138,34,2,65,64,0,0,0,1
S01009198,Owned: Owned outright,111,52,34,7,27,17,1,59,59,0,0,0,0
S01009198,Owned: Owned with a mortgage or loan or shared ownership,144,138,120,9,111,17,1,6,5,0,0,0,1
S01009198,Rented or living rent free: Total,51,22,15,4,11,1,6,29,23,2,0,3,1
S01009198,Rented or living rent free: Social rented,39,16,11,4,7,0,5,23,19,0,0,3,1
S01009198,Rented or living rent free: Private rented or living rent free,12,6,4,0,4,1,1,6,4,2,0,0,0
S01009199,All HRPs aged 16 and over,248,179,151,15,136,22,6,69,59,0,1,5,4
S01009199,Owned: Total,196,159,139,12,127,18,2,37,33,0,1,0,3
S01009199,Owned: Owned outright,59,27,22,5,17,4,1,32,28,0,1,0,3
S01009199,Owned: Owned with a mortgage or loan or shared ownership,137,132,117,7,110,14,1,5,5,0,0,0,0
S01009199,Rented or living rent free: Total,52,20,12,3,9,4,4,32,26,0,0,5,1
S01009199,Rented or living rent free: Social rented,40,13,6,3,3,3,4,27,23,0,0,3,1
S01009199,Rented or living rent free: Private rented or living rent free,12,7,6,0,6,1,0,5,3,0,0,2,0
S01009200,All HRPs aged 16 and over,439,314,275,31,244,29,10,125,106,2,5,8,4
S01009200,Owned: Total,379,277,251,25,226,24,2,102,99,0,2,1,0
S01009200,Owned: Owned outright,162,67,61,19,42,5,1,95,95,0,0,0,0
S01009200,Owned: Owned with a mortgage or loan or shared ownership,217,210,190,6,184,19,1,7,4,0,2,1,0
S01009200,Rented or living rent free: Total,60,37,24,6,18,5,8,23,7,2,3,7,4
S01009200,Rented or living rent free: Social rented,47,26,17,5,12,2,7,21,6,2,3,6,4
S01009200,Rented or living rent free: Private rented or living rent free,13,11,7,1,6,3,1,2,1,0,0,1,0
S01009201,All HRPs aged 16 and over,268,196,164,24,140,15,17,72,44,3,5,14,6
S01009201,Owned: Total,168,131,118,12,106,11,2,37,31,0,0,3,3
S01009201,Owned: Owned outright,54,25,20,2,18,3,2,29,25,0,0,1,3
S01009201,Owned: Owned with a mortgage or loan or shared ownership,114,106,98,10,88,8,0,8,6,0,0,2,0
S01009201,Rented or living rent free: Total,100,65,46,12,34,4,15,35,13,3,5,11,3
S01009201,Rented or living rent free: Social rented,76,47,33,11,22,3,11,29,10,2,4,10,3
S01009201,Rented or living rent free: Private rented or living rent free,24,18,13,1,12,1,4,6,3,1,1,1,0
S01009202,All HRPs aged 16 and over,190,150,129,7,122,19,2,40,37,0,0,3,0
S01009202,Owned: Total,173,140,121,5,116,18,1,33,32,0,0,1,0
S01009202,Owned: Owned outright,50,22,17,2,15,4,1,28,28,0,0,0,0
S01009202,Owned: Owned with a mortgage or loan or shared ownership,123,118,104,3,101,14,0,5,4,0,0,1,0
S01009202,Rented or living rent free: Total,17,10,8,2,6,1,1,7,5,0,0,2,0
S01009202,Rented or living rent free: Social rented,11,5,5,2,3,0,0,6,4,0,0,2,0
S01009202,Rented or living rent free: Private rented or living rent free,6,5,3,0,3,1,1,1,1,0,0,0,0
S01009203,All HRPs aged 16 and over,269,145,107,29,78,21,17,124,86,1,8,25,4
S01009203,Owned: Total,117,74,57,12,45,17,0,43,38,0,1,4,0
S01009203,Owned: Owned outright,53,21,18,5,13,3,0,32,29,0,1,2,0
S01009203,Owned: Owned with a mortgage or loan or shared ownership,64,53,39,7,32,14,0,11,9,0,0,2,0
S01009203,Rented or living rent free: Total,152,71,50,17,33,4,17,81,48,1,7,21,4
S01009203,Rented or living rent free: Social rented,141,64,45,17,28,4,15,77,46,1,7,20,3
S01009203,Rented or living rent free: Private rented or living rent free,11,7,5,0,5,0,2,4,2,0,0,1,1
S01009204,All HRPs aged 16 and over,343,262,226,48,178,28,8,81,49,2,8,13,9
S01009204,Owned: Total,208,181,160,19,141,18,3,27,22,0,2,0,3
S01009204,Owned: Owned outright,66,45,37,7,30,8,0,21,18,0,0,0,3
S01009204,Owned: Owned with a mortgage or loan or shared ownership,142,136,123,12,111,10,3,6,4,0,2,0,0
S01009204,Rented or living rent free: Total,135,81,66,29,37,10,5,54,27,2,6,13,6
S01009204,Rented or living rent free: Social rented,118,70,56,26,30,9,5,48,24,1,6,11,6
S01009204,Rented or living rent free: Private rented or living rent free,17,11,10,3,7,1,0,6,3,1,0,2,0
S01009205,All HRPs aged 16 and over,307,253,225,23,202,25,3,54,45,1,0,5,3
S01009205,Owned: Total,280,231,203,22,181,25,3,49,42,0,0,4,3
S01009205,Owned: Owned outright,97,59,50,16,34,8,1,38,36,0,0,2,0
S01009205,Owned: Owned with a mortgage or loan or shared ownership,183,172,153,6,147,17,2,11,6,0,0,2,3
S01009205,Rented or living rent free: Total,27,22,22,1,21,0,0,5,3,1,0,1,0
S01009205,Rented or living rent free: Social rented,2,1,1,0,1,0,0,1,1,0,0,0,0
S01009205,Rented or living rent free: Private rented or living rent free,25,21,21,1,20,0,0,4,2,1,0,1,0
S01009206,All HRPs aged 16 and over,362,289,258,19,239,23,8,73,63,1,1,3,5
S01009206,Owned: Total,324,260,237,16,221,20,3,64,59,0,0,0,5
S01009206,Owned: Owned outright,124,67,58,13,45,6,3,57,53,0,0,0,4
S01009206,Owned: Owned with a mortgage or loan or shared ownership,200,193,179,3,176,14,0,7,6,0,0,0,1
S01009206,Rented or living rent free: Total,38,29,21,3,18,3,5,9,4,1,1,3,0
S01009206,Rented or living rent free: Social rented,10,4,3,1,2,1,0,6,1,1,1,3,0
S01009206,Rented or living rent free: Private rented or living rent free,28,25,18,2,16,2,5,3,3,0,0,0,0
S01009207,All HRPs aged 16 and over,375,238,212,19,193,19,7,137,133,2,0,2,0
S01009207,Owned: Total,345,216,194,18,176,17,5,129,128,0,0,1,0
S01009207,Owned: Owned outright,178,64,50,13,37,13,1,114,114,0,0,0,0
S01009207,Owned: Owned with a mortgage or loan or shared ownership,167,152,144,5,139,4,4,15,14,0,0,1,0
S01009207,Rented or living rent free: Total,30,22,18,1,17,2,2,8,5,2,0,1,0
S01009207,Rented or living rent free: Social rented,3,0,0,0,0,0,0,3,1,1,0,1,0
S01009207,Rented or living rent free: Private rented or living rent free,27,22,18,1,17,2,2,5,4,1,0,0,0
S01009208,All HRPs aged 16 and over,294,162,141,20,121,16,5,132,114,0,1,9,8
S01009208,Owned: Total,227,128,114,17,97,13,1,99,94,0,0,0,5
S01009208,Owned: Owned outright,131,45,40,11,29,5,0,86,83,0,0,0,3
S01009208,Owned: Owned with a mortgage or loan or shared ownership,96,83,74,6,68,8,1,13,11,0,0,0,2
S01009208,Rented or living rent free: Total,67,34,27,3,24,3,4,33,20,0,1,9,3
S01009208,Rented or living rent free: Social rented,45,19,14,2,12,3,2,26,14,0,1,9,2
S01009208,Rented or living rent free: Private rented or living rent free,22,15,13,1,12,0,2,7,6,0,0,0,1
S01009209,All HRPs aged 16 and over,304,183,159,28,131,20,4,121,113,1,0,6,1
S01009209,Owned: Total,259,151,130,22,108,19,2,108,105,1,0,1,1
S01009209,Owned: Owned outright,145,42,37,13,24,5,0,103,101,0,0,1,1
S01009209,Owned: Owned with a mortgage or loan or shared ownership,114,109,93,9,84,14,2,5,4,1,0,0,0
S01009209,Rented or living rent free: Total,45,32,29,6,23,1,2,13,8,0,0,5,0
S01009209,Rented or living rent free: Social rented,13,6,5,2,3,0,1,7,4,0,0,3,0
S01009209,Rented or living rent free: Private rented or living rent free,32,26,24,4,20,1,1,6,4,0,0,2,0
S01009210,All HRPs aged 16 and over,234,164,132,24,108,28,4,70,64,0,2,4,0
S01009210,Owned: Total,191,139,111,19,92,25,3,52,52,0,0,0,0
S01009210,Owned: Owned outright,86,41,30,9,21,9,2,45,45,0,0,0,0
S01009210,Owned: Owned with a mortgage or loan or shared ownership,105,98,81,10,71,16,1,7,7,0,0,0,0
S01009210,Rented or living rent free: Total,43,25,21,5,16,3,1,18,12,0,2,4,0
S01009210,Rented or living rent free: Social rented,19,6,5,1,4,0,1,13,9,0,1,3,0
S01009210,Rented or living rent free: Private rented or living rent free,24,19,16,4,12,3,0,5,3,0,1,1,0
S01009211,All HRPs aged 16 and over,259,184,152,19,133,23,9,75,57,2,10,5,1
S01009211,Owned: Total,178,127,104,9,95,19,4,51,47,1,2,0,1
S01009211,Owned: Owned outright,70,28,25,6,19,2,1,42,41,1,0,0,0
S01009211,Owned: Owned with a mortgage or loan or shared ownership,108,99,79,3,76,17,3,9,6,0,2,0,1
S01009211,Rented or living rent free: Total,81,57,48,10,38,4,5,24,10,1,8,5,0
S01009211,Rented or living rent free: Social rented,50,29,24,6,18,3,2,21,9,1,8,3,0
S01009211,Rented or living rent free: Private rented or living rent free,31,28,24,4,20,1,3,3,1,0,0,2,0
S01009212,All HRPs aged 16 and over,363,210,180,43,137,20,10,153,124,0,7,18,4
S01009212,Owned: Total,214,139,124,22,102,14,1,75,67,0,2,4,2
S01009212,Owned: Owned outright,105,44,40,12,28,3,1,61,57,0,0,3,1
S01009212,Owned: Owned with a mortgage or loan or shared ownership,109,95,84,10,74,11,0,14,10,0,2,1,1
S01009212,Rented or living rent free: Total,149,71,56,21,35,6,9,78,57,0,5,14,2
S01009212,Rented or living rent free: Social rented,133,61,48,20,28,6,7,72,51,0,5,14,2
S01009212,Rented or living rent free: Private rented or living rent free,16,10,8,1,7,0,2,6,6,0,0,0,0
S01009213,All HRPs aged 16 and over,355,221,185,34,151,21,15,134,92,0,9,28,5
S01009213,Owned: Total,202,137,117,12,105,16,4,65,53,0,1,9,2
S01009213,Owned: Owned outright,69,18,13,3,10,4,1,51,45,0,1,5,0
S01009213,Owned: Owned with a mortgage or loan or shared ownership,133,119,104,9,95,12,3,14,8,0,0,4,2
S01009213,Rented or living rent free: Total,153,84,68,22,46,5,11,69,39,0,8,19,3
S01009213,Rented or living rent free: Social rented,139,77,62,21,41,4,11,62,37,0,6,16,3
S01009213,Rented or living rent free: Private rented or living rent free,14,7,6,1,5,1,0,7,2,0,2,3,0
S01009214,All HRPs aged 16 and over,397,276,241,24,217,27,8,121,105,2,4,7,3
S01009214,Owned: Total,328,243,213,21,192,26,4,85,82,2,0,0,1
S01009214,Owned: Owned outright,130,56,47,13,34,7,2,74,74,0,0,0,0
S01009214,Owned: Owned with a mortgage or loan or shared ownership,198,187,166,8,158,19,2,11,8,2,0,0,1
S01009214,Rented or living rent free: Total,69,33,28,3,25,1,4,36,23,0,4,7,2
S01009214,Rented or living rent free: Social rented,57,25,22,3,19,0,3,32,19,0,4,7,2
S01009214,Rented or living rent free: Private rented or living rent free,12,8,6,0,6,1,1,4,4,0,0,0,0
S01009215,All HRPs aged 16 and over,439,288,232,41,191,31,25,151,125,0,2,18,6
S01009215,Owned: Total,248,181,154,18,136,24,3,67,65,0,0,2,0
S01009215,Owned: Owned outright,117,58,48,10,38,7,3,59,59,0,0,0,0
S01009215,Owned: Owned with a mortgage or loan or shared ownership,131,123,106,8,98,17,0,8,6,0,0,2,0
S01009215,Rented or living rent free: Total,191,107,78,23,55,7,22,84,60,0,2,16,6
S01009215,Rented or living rent free: Social rented,173,94,71,22,49,4,19,79,56,0,2,16,5
S01009215,Rented or living rent free: Private rented or living rent free,18,13,7,1,6,3,3,5,4,0,0,0,1
S01009216,All HRPs aged 16 and over,397,257,221,41,180,24,12,140,108,3,4,21,4
S01009216,Owned: Total,249,183,162,20,142,21,0,66,61,0,0,4,1
S01009216,Owned: Owned outright,100,50,44,9,35,6,0,50,48,0,0,1,1
S01009216,Owned: Owned with a mortgage or loan or shared ownership,149,133,118,11,107,15,0,16,13,0,0,3,0
S01009216,Rented or living rent free: Total,148,74,59,21,38,3,12,74,47,3,4,17,3
S01009216,Rented or living rent free: Social rented,123,58,46,19,27,2,10,65,43,1,4,15,2
S01009216,Rented or living rent free: Private rented or living rent free,25,16,13,2,11,1,2,9,4,2,0,2,1
S01009217,All HRPs aged 16 and over,279,169,131,26,105,18,20,110,58,4,8,31,9
S01009217,Owned: Total,103,74,60,12,48,13,1,29,25,1,0,2,1
S01009217,Owned: Owned outright,31,11,8,3,5,3,0,20,17,1,0,1,1
S01009217,Owned: Owned with a mortgage or loan or shared ownership,72,63,52,9,43,10,1,9,8,0,0,1,0
S01009217,Rented or living rent free: Total,176,95,71,14,57,5,19,81,33,3,8,29,8
S01009217,Rented or living rent free: Social rented,165,85,62,12,50,4,19,80,33,3,7,29,8
S01009217,Rented or living rent free: Private rented or living rent free,11,10,9,2,7,1,0,1,0,0,1,0,0
S01009218,All HRPs aged 16 and over,395,218,188,30,158,24,6,177,164,1,1,9,2
S01009218,Owned: Total,281,169,145,19,126,22,2,112,109,0,0,2,1
S01009218,Owned: Owned outright,149,45,39,13,26,5,1,104,103,0,0,1,0
S01009218,Owned: Owned with a mortgage or loan or shared ownership,132,124,106,6,100,17,1,8,6,0,0,1,1
S01009218,Rented or living rent free: Total,114,49,43,11,32,2,4,65,55,1,1,7,1
S01009218,Rented or living rent free: Social rented,85,33,27,8,19,2,4,52,43,1,1,6,1
S01009218,Rented or living rent free: Private rented or living rent free,29,16,16,3,13,0,0,13,12,0,0,1,0
S01009219,All HRPs aged 16 and over,313,184,149,26,123,15,20,129,103,2,2,17,5
S01009219,Owned: Total,192,117,106,18,88,8,3,75,71,0,0,4,0
S01009219,Owned: Owned outright,97,33,29,11,18,2,2,64,63,0,0,1,0
S01009219,Owned: Owned with a mortgage or loan or shared ownership,95,84,77,7,70,6,1,11,8,0,0,3,0
S01009219,Rented or living rent free: Total,121,67,43,8,35,7,17,54,32,2,2,13,5
S01009219,Rented or living rent free: Social rented,99,56,39,8,31,5,12,43,24,2,2,11,4
S01009219,Rented or living rent free: Private rented or living rent free,22,11,4,0,4,2,5,11,8,0,0,2,1
S01009220,All HRPs aged 16 and over,264,149,126,34,92,9,14,115,88,2,7,14,4
S01009220,Owned: Total,154,85,77,18,59,8,0,69,66,0,0,2,1
S01009220,Owned: Owned outright,90,25,23,8,15,2,0,65,64,0,0,0,1
S01009220,Owned: Owned with a mortgage or loan or shared ownership,64,60,54,10,44,6,0,4,2,0,0,2,0
S01009220,Rented or living rent free: Total,110,64,49,16,33,1,14,46,22,2,7,12,3
S01009220,Rented or living rent free: Social rented,89,45,33,13,20,0,12,44,21,2,6,12,3
S01009220,Rented or living rent free: Private rented or living rent free,21,19,16,3,13,1,2,2,1,0,1,0,0
S01009221,All HRPs aged 16 and over,239,145,125,17,108,9,11,94,78,1,2,10,3
S01009221,Owned: Total,164,101,93,7,86,8,0,63,62,0,0,1,0
S01009221,Owned: Owned outright,81,20,18,3,15,2,0,61,60,0,0,1,0
S01009221,Owned: Owned with a mortgage or loan or shared ownership,83,81,75,4,71,6,0,2,2,0,0,0,0
S01009221,Rented or living rent free: Total,75,44,32,10,22,1,11,31,16,1,2,9,3
S01009221,Rented or living rent free: Social rented,65,38,28,10,18,0,10,27,13,1,2,8,3
S01009221,Rented or living rent free: Private rented or living rent free,10,6,4,0,4,1,1,4,3,0,0,1,0
S01009222,All HRPs aged 16 and over,238,155,128,39,89,12,15,83,50,2,7,16,8
S01009222,Owned: Total,116,84,75,12,63,7,2,32,27,1,1,0,3
S01009222,Owned: Owned outright,44,19,16,3,13,2,1,25,23,0,0,0,2
S01009222,Owned: Owned with a mortgage or loan or shared ownership,72,65,59,9,50,5,1,7,4,1,1,0,1
S01009222,Rented or living rent free: Total,122,71,53,27,26,5,13,51,23,1,6,16,5
S01009222,Rented or living rent free: Social rented,102,59,45,24,21,4,10,43,19,1,5,15,3
S01009222,Rented or living rent free: Private rented or living rent free,20,12,8,3,5,1,3,8,4,0,1,1,2
S01009223,All HRPs aged 16 and over,244,143,131,16,115,9,3,101,85,0,6,10,0
S01009223,Owned: Total,158,99,91,9,82,8,0,59,57,0,1,1,0
S01009223,Owned: Owned outright,72,22,21,6,15,1,0,50,48,0,1,1,0
S01009223,Owned: Owned with a mortgage or loan or shared ownership,86,77,70,3,67,7,0,9,9,0,0,0,0
S01009223,Rented or living rent free: Total,86,44,40,7,33,1,3,42,28,0,5,9,0
S01009223,Rented or living rent free: Social rented,67,29,26,2,24,1,2,38,24,0,5,9,0
S01009223,Rented or living rent free: Private rented or living rent free,19,15,14,5,9,0,1,4,4,0,0,0,0
S01009224,All HRPs aged 16 and over,277,167,141,29,112,12,14,110,84,2,7,16,1
S01009224,Owned: Total,149,104,89,11,78,11,4,45,41,1,2,1,0
S01009224,Owned: Owned outright,53,19,16,6,10,0,3,34,33,0,0,1,0
S01009224,Owned: Owned with a mortgage or loan or shared ownership,96,85,73,5,68,11,1,11,8,1,2,0,0
S01009224,Rented or living rent free: Total,128,63,52,18,34,1,10,65,43,1,5,15,1
S01009224,Rented or living rent free: Social rented,110,54,44,17,27,1,9,56,36,1,4,14,1
S01009224,Rented or living rent free: Private rented or living rent free,18,9,8,1,7,0,1,9,7,0,1,1,0
S01009225,All HRPs aged 16 and over,268,157,140,23,117,11,6,111,95,0,4,11,1
S01009225,Owned: Total,170,125,113,17,96,10,2,45,42,0,1,2,0
S01009225,Owned: Owned outright,73,31,27,9,18,4,0,42,39,0,1,2,0
S01009225,Owned: Owned with a mortgage or loan or shared ownership,97,94,86,8,78,6,2,3,3,0,0,0,0
S01009225,Rented or living rent free: Total,98,32,27,6,21,1,4,66,53,0,3,9,1
S01009225,Rented or living rent free: Social rented,87,28,24,6,18,0,4,59,47,0,2,9,1
S01009225,Rented or living rent free: Private rented or living rent free,11,4,3,0,3,1,0,7,6,0,1,0,0
S01009226,All HRPs aged 16 and over,507,277,237,36,201,18,22,230,168,1,9,42,10
S01009226,Owned: Total,259,173,154,22,132,13,6,86,81,0,0,3,2
S01009226,Owned: Owned outright,118,45,38,11,27,3,4,73,69,0,0,3,1
S01009226,Owned: Owned with a mortgage or loan or shared ownership,141,128,116,11,105,10,2,13,12,0,0,0,1
S01009226,Rented or living rent free: Total,248,104,83,14,69,5,16,144,87,1,9,39,8
S01009226,Rented or living rent free: Social rented,210,85,65,12,53,5,15,125,77,0,6,36,6
S01009226,Rented or living rent free: Private rented or living rent free,38,19,18,2,16,0,1,19,10,1,3,3,2
S01009227,All HRPs aged 16 and over,355,177,153,17,136,13,11,178,153,2,3,15,5
S01009227,Owned: Total,190,120,110,9,101,8,2,70,65,0,0,3,2
S01009227,Owned: Owned outright,85,28,27,7,20,1,0,57,56,0,0,1,0
S01009227,Owned: Owned with a mortgage or loan or shared ownership,105,92,83,2,81,7,2,13,9,0,0,2,2
S01009227,Rented or living rent free: Total,165,57,43,8,35,5,9,108,88,2,3,12,3
S01009227,Rented or living rent free: Social rented,125,33,24,7,17,2,7,92,78,0,1,11,2
S01009227,Rented or living rent free: Private rented or living rent free,40,24,19,1,18,3,2,16,10,2,2,1,1
S01009228,All HRPs aged 16 and over,313,180,136,22,114,17,27,133,108,2,1,17,5
S01009228,Owned: Total,145,88,71,6,65,14,3,57,56,0,0,0,1
S01009228,Owned: Owned outright,70,19,18,2,16,1,0,51,51,0,0,0,0
S01009228,Owned: Owned with a mortgage or loan or shared ownership,75,69,53,4,49,13,3,6,5,0,0,0,1
S01009228,Rented or living rent free: Total,168,92,65,16,49,3,24,76,52,2,1,17,4
S01009228,Rented or living rent free: Social rented,137,72,52,14,38,2,18,65,45,2,1,15,2
S01009228,Rented or living rent free: Private rented or living rent free,31,20,13,2,11,1,6,11,7,0,0,2,2
S01009229,All HRPs aged 16 and over,293,186,154,17,137,21,11,107,84,2,1,14,6
S01009229,Owned: Total,177,121,103,10,93,17,1,56,52,0,0,4,0
S01009229,Owned: Owned outright,97,45,31,6,25,13,1,52,50,0,0,2,0
S01009229,Owned: Owned with a mortgage or loan or shared ownership,80,76,72,4,68,4,0,4,2,0,0,2,0
S01009229,Rented or living rent free: Total,116,65,51,7,44,4,10,51,32,2,1,10,6
S01009229,Rented or living rent free: Social rented,84,45,35,7,28,3,7,39,24,2,1,9,3
S01009229,Rented or living rent free: Private rented or living rent free,32,20,16,0,16,1,3,12,8,0,0,1,3
S01009230,All HRPs aged 16 and over,319,246,218,17,201,22,6,73,55,0,2,15,1
S01009230,Owned: Total,228,185,168,14,154,16,1,43,38,0,1,3,1
S01009230,Owned: Owned outright,72,37,31,6,25,6,0,35,32,0,0,2,1
S01009230,Owned: Owned with a mortgage or loan or shared ownership,156,148,137,8,129,10,1,8,6,0,1,1,0
S01009230,Rented or living rent free: Total,91,61,50,3,47,6,5,30,17,0,1,12,0
S01009230,Rented or living rent free: Social rented,31,10,5,1,4,2,3,21,12,0,1,8,0
S01009230,Rented or living rent free: Private rented or living rent free,60,51,45,2,43,4,2,9,5,0,0,4,0
S01009231,All HRPs aged 16 and over,437,296,244,18,226,32,20,141,117,1,3,16,4
S01009231,Owned: Total,356,246,213,14,199,26,7,110,103,0,2,3,2
S01009231,Owned: Owned outright,164,67,54,6,48,10,3,97,92,0,2,2,1
S01009231,Owned: Owned with a mortgage or loan or shared ownership,192,179,159,8,151,16,4,13,11,0,0,1,1
S01009231,Rented or living rent free: Total,81,50,31,4,27,6,13,31,14,1,1,13,2
S01009231,Rented or living rent free: Social rented,44,22,13,2,11,3,6,22,9,1,1,10,1
S01009231,Rented or living rent free: Private rented or living rent free,37,28,18,2,16,3,7,9,5,0,0,3,1
S01009232,All HRPs aged 16 and over,309,197,146,30,116,2,49,112,46,4,16,34,12
S01009232,Owned: Total,91,59,56,7,49,1,2,32,30,0,1,1,0
S01009232,Owned: Owned outright,46,19,16,4,12,1,2,27,26,0,1,0,0
S01009232,Owned: Owned with a mortgage or loan or shared ownership,45,40,40,3,37,0,0,5,4,0,0,1,0
S01009232,Rented or living rent free: Total,218,138,90,23,67,1,47,80,16,4,15,33,12
S01009232,Rented or living rent free: Social rented,206,133,86,22,64,1,46,73,12,2,14,33,12
S01009232,Rented or living rent free: Private rented or living rent free,12,5,4,1,3,0,1,7,4,2,1,0,0
S01009233,All HRPs aged 16 and over,267,135,115,17,98,13,7,132,112,0,2,15,3
S01009233,Owned: Total,180,99,86,10,76,12,1,81,78,0,0,3,0
S01009233,Owned: Owned outright,91,22,18,6,12,3,1,69,67,0,0,2,0
S01009233,Owned: Owned with a mortgage or loan or shared ownership,89,77,68,4,64,9,0,12,11,0,0,1,0
S01009233,Rented or living rent free: Total,87,36,29,7,22,1,6,51,34,0,2,12,3
S01009233,Rented or living rent free: Social rented,71,28,24,7,17,1,3,43,28,0,2,11,2
S01009233,Rented or living rent free: Private rented or living rent free,16,8,5,0,5,0,3,8,6,0,0,1,1
S01009234,All HRPs aged 16 and over,476,320,247,51,196,13,60,156,72,5,16,49,14
S01009234,Owned: Total,149,103,91,13,78,9,3,46,42,0,1,1,2
S01009234,Owned: Owned outright,63,24,18,6,12,5,1,39,36,0,0,1,2
S01009234,Owned: Owned with a mortgage or loan or shared ownership,86,79,73,7,66,4,2,7,6,0,1,0,0
S01009234,Rented or living rent free: Total,327,217,156,38,118,4,57,110,30,5,15,48,12
S01009234,Rented or living rent free: Social rented,287,187,134,34,100,3,50,100,27,5,15,41,12
S01009234,Rented or living rent free: Private rented or living rent free,40,30,22,4,18,1,7,10,3,0,0,7,0
S01009235,All HRPs aged 16 and over,457,312,244,31,213,16,52,145,101,5,5,29,5
S01009235,Owned: Total,228,148,136,15,121,9,3,80,77,0,0,3,0
S01009235,Owned: Owned outright,106,33,28,9,19,3,2,73,72,0,0,1,0
S01009235,Owned: Owned with a mortgage or loan or shared ownership,122,115,108,6,102,6,1,7,5,0,0,2,0
S01009235,Rented or living rent free: Total,229,164,108,16,92,7,49,65,24,5,5,26,5
S01009235,Rented or living rent free: Social rented,205,142,91,16,75,7,44,63,22,5,5,26,5
S01009235,Rented or living rent free: Private rented or living rent free,24,22,17,0,17,0,5,2,2,0,0,0,0
S01009236,All HRPs aged 16 and over,224,121,102,11,91,15,4,103,96,0,2,5,0
S01009236,Owned: Total,184,95,81,5,76,13,1,89,86,0,0,3,0
S01009236,Owned: Owned outright,117,34,31,5,26,3,0,83,81,0,0,2,0
S01009236,Owned: Owned with a mortgage or loan or shared ownership,67,61,50,0,50,10,1,6,5,0,0,1,0
S01009236,Rented or living rent free: Total,40,26,21,6,15,2,3,14,10,0,2,2,0
S01009236,Rented or living rent free: Social rented,33,22,18,4,14,2,2,11,7,0,2,2,0
S01009236,Rented or living rent free: Private rented or living rent free,7,4,3,2,1,0,1,3,3,0,0,0,0
S01009237,All HRPs aged 16 and over,378,235,201,15,186,32,2,143,137,1,0,2,3
S01009237,Owned: Total,335,205,175,12,163,28,2,130,129,0,0,0,1
S01009237,Owned: Owned outright,171,50,38,9,29,10,2,121,120,0,0,0,1
S01009237,Owned: Owned with a mortgage or loan or shared ownership,164,155,137,3,134,18,0,9,9,0,0,0,0
S01009237,Rented or living rent free: Total,43,30,26,3,23,4,0,13,8,1,0,2,2
S01009237,Rented or living rent free: Social rented,10,6,5,1,4,1,0,4,1,0,0,2,1
S01009237,Rented or living rent free: Private rented or living rent free,33,24,21,2,19,3,0,9,7,1,0,0,1
S01009238,All HRPs aged 16 and over,335,194,170,38,132,7,17,141,120,2,6,10,3
S01009238,Owned: Total,242,138,128,23,105,7,3,104,101,0,0,1,2
S01009238,Owned: Owned outright,118,30,26,10,16,3,1,88,85,0,0,1,2
S01009238,Owned: Owned with a mortgage or loan or shared ownership,124,108,102,13,89,4,2,16,16,0,0,0,0
S01009238,Rented or living rent free: Total,93,56,42,15,27,0,14,37,19,2,6,9,1
S01009238,Rented or living rent free: Social rented,76,46,34,12,22,0,12,30,14,1,6,8,1
S01009238,Rented or living rent free: Private rented or living rent free,17,10,8,3,5,0,2,7,5,1,0,1,0
S01009239,All HRPs aged 16 and over,420,273,247,35,212,14,12,147,110,2,3,22,10
S01009239,Owned: Total,202,147,136,13,123,10,1,55,52,0,0,2,1
S01009239,Owned: Owned outright,75,31,27,7,20,4,0,44,41,0,0,2,1
S01009239,Owned: Owned with a mortgage or loan or shared ownership,127,116,109,6,103,6,1,11,11,0,0,0,0
S01009239,Rented or living rent free: Total,218,126,111,22,89,4,11,92,58,2,3,20,9
S01009239,Rented or living rent free: Social rented,193,108,93,20,73,4,11,85,53,1,2,20,9
S01009239,Rented or living rent free: Private rented or living rent free,25,18,18,2,16,0,0,7,5,1,1,0,0
S01009240,All HRPs aged 16 and over,387,254,177,55,122,9,68,133,79,4,12,24,14
S01009240,Owned: Total,93,56,49,6,43,5,2,37,35,0,0,1,1
S01009240,Owned: Owned outright,38,9,7,2,5,2,0,29,27,0,0,1,1
S01009240,Owned: Owned with a mortgage or loan or shared ownership,55,47,42,4,38,3,2,8,8,0,0,0,0
S01009240,Rented or living rent free: Total,294,198,128,49,79,4,66,96,44,4,12,23,13
S01009240,Rented or living rent free: Social rented,278,188,122,47,75,3,63,90,42,4,12,21,11
S01009240,Rented or living rent free: Private rented or living rent free,16,10,6,2,4,1,3,6,2,0,0,2,2
S01009241,All HRPs aged 16 and over,453,275,208,49,159,15,52,178,115,4,14,41,4
S01009241,Owned: Total,179,114,100,16,84,12,2,65,60,0,0,4,1
S01009241,Owned: Owned outright,84,27,23,5,18,4,0,57,54,0,0,2,1
S01009241,Owned: Owned with a mortgage or loan or shared ownership,95,87,77,11,66,8,2,8,6,0,0,2,0
S01009241,Rented or living rent free: Total,274,161,108,33,75,3,50,113,55,4,14,37,3
S01009241,Rented or living rent free: Social rented,263,151,101,31,70,3,47,112,54,4,14,37,3
S01009241,Rented or living rent free: Private rented or living rent free,11,10,7,2,5,0,3,1,1,0,0,0,0
S01009242,All HRPs aged 16 and over,321,207,174,26,148,19,14,114,102,1,0,6,5
S01009242,Owned: Total,257,159,144,21,123,12,3,98,95,1,0,1,1
S01009242,Owned: Owned outright,141,48,45,14,31,0,3,93,90,1,0,1,1
S01009242,Owned: Owned with a mortgage or loan or shared ownership,116,111,99,7,92,12,0,5,5,0,0,0,0
S01009242,Rented or living rent free: Total,64,48,30,5,25,7,11,16,7,0,0,5,4
S01009242,Rented or living rent free: Social rented,56,41,26,5,21,5,10,15,6,0,0,5,4
S01009242,Rented or living rent free: Private rented or living rent free,8,7,4,0,4,2,1,1,1,0,0,0,0
S01009243,All HRPs aged 16 and over,398,298,257,34,223,30,11,100,71,1,4,21,3
S01009243,Owned: Total,281,221,194,20,174,25,2,60,55,0,1,4,0
S01009243,Owned: Owned outright,93,39,37,6,31,1,1,54,51,0,0,3,0
S01009243,Owned: Owned with a mortgage or loan or shared ownership,188,182,157,14,143,24,1,6,4,0,1,1,0
S01009243,Rented or living rent free: Total,117,77,63,14,49,5,9,40,16,1,3,17,3
S01009243,Rented or living rent free: Social rented,80,45,37,10,27,2,6,35,15,1,1,15,3
S01009243,Rented or living rent free: Private rented or living rent free,37,32,26,4,22,3,3,5,1,0,2,2,0
S01009244,All HRPs aged 16 and over,337,224,194,26,168,28,2,113,110,1,0,2,0
S01009244,Owned: Total,309,204,178,21,157,24,2,105,104,0,0,1,0
S01009244,Owned: Owned outright,173,76,61,14,47,15,0,97,96,0,0,1,0
S01009244,Owned: Owned with a mortgage or loan or shared ownership,136,128,117,7,110,9,2,8,8,0,0,0,0
S01009244,Rented or living rent free: Total,28,20,16,5,11,4,0,8,6,1,0,1,0
S01009244,Rented or living rent free: Social rented,5,3,2,1,1,1,0,2,1,1,0,0,0
S01009244,Rented or living rent free: Private rented or living rent free,23,17,14,4,10,3,0,6,5,0,0,1,0
S01009245,All HRPs aged 16 and over,361,243,207,17,190,27,9,118,108,0,1,9,0
S01009245,Owned: Total,298,202,175,13,162,23,4,96,92,0,0,4,0
S01009245,Owned: Owned outright,135,53,45,6,39,7,1,82,80,0,0,2,0
S01009245,Owned: Owned with a mortgage or loan or shared ownership,163,149,130,7,123,16,3,14,12,0,0,2,0
S01009245,Rented or living rent free: Total,63,41,32,4,28,4,5,22,16,0,1,5,0
S01009245,Rented or living rent free: Social rented,41,26,20,4,16,1,5,15,11,0,0,4,0
S01009245,Rented or living rent free: Private rented or living rent free,22,15,12,0,12,3,0,7,5,0,1,1,0
S01009246,All HRPs aged 16 and over,383,238,198,32,166,24,16,145,124,0,3,13,5
S01009246,Owned: Total,228,156,140,19,121,16,0,72,68,0,1,2,1
S01009246,Owned: Owned outright,101,39,33,10,23,6,0,62,59,0,1,1,1
S01009246,Owned: Owned with a mortgage or loan or shared ownership,127,117,107,9,98,10,0,10,9,0,0,1,0
S01009246,Rented or living rent free: Total,155,82,58,13,45,8,16,73,56,0,2,11,4
S01009246,Rented or living rent free: Social rented,127,64,47,13,34,3,14,63,47,0,2,10,4
S01009246,Rented or living rent free: Private rented or living rent free,28,18,11,0,11,5,2,10,9,0,0,1,0
S01009247,All HRPs aged 16 and over,429,290,259,38,221,15,16,139,110,0,13,12,4
S01009247,Owned: Total,264,198,187,16,171,8,3,66,63,0,0,1,2
S01009247,Owned: Owned outright,91,35,31,7,24,2,2,56,55,0,0,0,1
S01009247,Owned: Owned with a mortgage or loan or shared ownership,173,163,156,9,147,6,1,10,8,0,0,1,1
S01009247,Rented or living rent free: Total,165,92,72,22,50,7,13,73,47,0,13,11,2
S01009247,Rented or living rent free: Social rented,135,71,55,21,34,4,12,64,42,0,10,10,2
S01009247,Rented or living rent free: Private rented or living rent free,30,21,17,1,16,3,1,9,5,0,3,1,0
S01009248,All HRPs aged 16 and over,300,184,152,28,124,27,5,116,104,1,3,4,4
S01009248,Owned: Total,239,152,128,21,107,23,1,87,83,0,2,2,0
S01009248,Owned: Owned outright,125,48,40,12,28,8,0,77,74,0,2,1,0
S01009248,Owned: Owned with a mortgage or loan or shared ownership,114,104,88,9,79,15,1,10,9,0,0,1,0
S01009248,Rented or living rent free: Total,61,32,24,7,17,4,4,29,21,1,1,2,4
S01009248,Rented or living rent free: Social rented,51,24,20,6,14,1,3,27,20,1,1,1,4
S01009248,Rented or living rent free: Private rented or living rent free,10,8,4,1,3,3,1,2,1,0,0,1,0
S01009249,All HRPs aged 16 and over,375,239,193,38,155,29,17,136,95,0,8,25,8
S01009249,Owned: Total,184,133,112,11,101,20,1,51,44,0,1,5,1
S01009249,Owned: Owned outright,68,27,22,6,16,4,1,41,37,0,1,2,1
S01009249,Owned: Owned with a mortgage or loan or shared ownership,116,106,90,5,85,16,0,10,7,0,0,3,0
S01009249,Rented or living rent free: Total,191,106,81,27,54,9,16,85,51,0,7,20,7
S01009249,Rented or living rent free: Social rented,158,81,65,26,39,5,11,77,46,0,6,19,6
S01009249,Rented or living rent free: Private rented or living rent free,33,25,16,1,15,4,5,8,5,0,1,1,1
S01009250,All HRPs aged 16 and over,278,176,150,27,123,22,4,102,83,0,5,14,0
S01009250,Owned: Total,184,132,113,13,100,17,2,52,47,0,1,4,0
S01009250,Owned: Owned outright,80,38,34,10,24,4,0,42,39,0,0,3,0
S01009250,Owned: Owned with a mortgage or loan or shared ownership,104,94,79,3,76,13,2,10,8,0,1,1,0
S01009250,Rented or living rent free: Total,94,44,37,14,23,5,2,50,36,0,4,10,0
S01009250,Rented or living rent free: Social rented,82,33,28,12,16,3,2,49,36,0,3,10,0
S01009250,Rented or living rent free: Private rented or living rent free,12,11,9,2,7,2,0,1,0,0,1,0,0
S01009251,All HRPs aged 16 and over,221,144,118,9,109,17,9,77,62,1,2,9,3
S01009251,Owned: Total,162,113,94,4,90,15,4,49,47,0,0,1,1
S01009251,Owned: Owned outright,78,32,26,1,25,5,1,46,44,0,0,1,1
S01009251,Owned: Owned with a mortgage or loan or shared ownership,84,81,68,3,65,10,3,3,3,0,0,0,0
S01009251,Rented or living rent free: Total,59,31,24,5,19,2,5,28,15,1,2,8,2
S01009251,Rented or living rent free: Social rented,52,26,19,4,15,2,5,26,14,1,2,7,2
S01009251,Rented or living rent free: Private rented or living rent free,7,5,5,1,4,0,0,2,1,0,0,1,0
S01009252,All HRPs aged 16 and over,163,144,127,10,117,16,1,19,19,0,0,0,0
S01009252,Owned: Total,157,138,123,9,114,14,1,19,19,0,0,0,0
S01009252,Owned: Owned outright,41,24,22,5,17,2,0,17,17,0,0,0,0
S01009252,Owned: Owned with a mortgage or loan or shared ownership,116,114,101,4,97,12,1,2,2,0,0,0,0
S01009252,Rented or living rent free: Total,6,6,4,1,3,2,0,0,0,0,0,0,0
S01009252,Rented or living rent free: Social rented,3,3,2,1,1,1,0,0,0,0,0,0,0
S01009252,Rented or living rent free: Private rented or living rent free,3,3,2,0,2,1,0,0,0,0,0,0,0
S01009253,All HRPs aged 16 and over,239,111,92,27,65,14,5,128,108,0,3,15,2
S01009253,Owned: Total,128,67,53,12,41,13,1,61,58,0,1,2,0
S01009253,Owned: Owned outright,77,24,21,8,13,3,0,53,51,0,0,2,0
S01009253,Owned: Owned with a mortgage or loan or shared ownership,51,43,32,4,28,10,1,8,7,0,1,0,0
S01009253,Rented or living rent free: Total,111,44,39,15,24,1,4,67,50,0,2,13,2
S01009253,Rented or living rent free: Social rented,99,37,33,13,20,1,3,62,45,0,2,13,2
S01009253,Rented or living rent free: Private rented or living rent free,12,7,6,2,4,0,1,5,5,0,0,0,0
S01009254,All HRPs aged 16 and over,371,213,173,31,142,16,24,158,102,2,13,35,6
S01009254,Owned: Total,143,97,86,11,75,9,2,46,43,0,0,3,0
S01009254,Owned: Owned outright,56,23,21,7,14,1,1,33,32,0,0,1,0
S01009254,Owned: Owned with a mortgage or loan or shared ownership,87,74,65,4,61,8,1,13,11,0,0,2,0
S01009254,Rented or living rent free: Total,228,116,87,20,67,7,22,112,59,2,13,32,6
S01009254,Rented or living rent free: Social rented,211,106,80,19,61,5,21,105,55,1,13,31,5
S01009254,Rented or living rent free: Private rented or living rent free,17,10,7,1,6,2,1,7,4,1,0,1,1
S01009255,All HRPs aged 16 and over,376,272,225,32,193,17,30,104,72,1,4,21,6
S01009255,Owned: Total,137,108,97,15,82,7,4,29,25,0,0,4,0
S01009255,Owned: Owned outright,45,23,19,8,11,3,1,22,20,0,0,2,0
S01009255,Owned: Owned with a mortgage or loan or shared ownership,92,85,78,7,71,4,3,7,5,0,0,2,0
S01009255,Rented or living rent free: Total,239,164,128,17,111,10,26,75,47,1,4,17,6
S01009255,Rented or living rent free: Social rented,133,67,48,10,38,4,15,66,43,0,4,15,4
S01009255,Rented or living rent free: Private rented or living rent free,106,97,80,7,73,6,11,9,4,1,0,2,2
S01009256,All HRPs aged 16 and over,222,131,119,12,107,8,4,91,80,1,0,10,0
S01009256,Owned: Total,172,103,95,6,89,7,1,69,66,0,0,3,0
S01009256,Owned: Owned outright,98,34,31,3,28,2,1,64,61,0,0,3,0
S01009256,Owned: Owned with a mortgage or loan or shared ownership,74,69,64,3,61,5,0,5,5,0,0,0,0
S01009256,Rented or living rent free: Total,50,28,24,6,18,1,3,22,14,1,0,7,0
S01009256,Rented or living rent free: Social rented,37,19,17,6,11,0,2,18,13,0,0,5,0
S01009256,Rented or living rent free: Private rented or living rent free,13,9,7,0,7,1,1,4,1,1,0,2,0
S01009257,All HRPs aged 16 and over,330,228,182,28,154,33,13,102,80,1,2,12,7
S01009257,Owned: Total,189,127,97,13,84,28,2,62,57,0,0,3,2
S01009257,Owned: Owned outright,94,34,24,5,19,8,2,60,55,0,0,3,2
S01009257,Owned: Owned with a mortgage or loan or shared ownership,95,93,73,8,65,20,0,2,2,0,0,0,0
S01009257,Rented or living rent free: Total,141,101,85,15,70,5,11,40,23,1,2,9,5
S01009257,Rented or living rent free: Social rented,74,46,32,7,25,3,11,28,16,0,2,8,2
S01009257,Rented or living rent free: Private rented or living rent free,67,55,53,8,45,2,0,12,7,1,0,1,3
S01009258,All HRPs aged 16 and over,282,189,142,16,126,42,5,93,84,0,2,7,0
S01009258,Owned: Total,231,159,117,15,102,38,4,72,68,0,1,3,0
S01009258,Owned: Owned outright,130,68,47,12,35,20,1,62,59,0,1,2,0
S01009258,Owned: Owned with a mortgage or loan or shared ownership,101,91,70,3,67,18,3,10,9,0,0,1,0
S01009258,Rented or living rent free: Total,51,30,25,1,24,4,1,21,16,0,1,4,0
S01009258,Rented or living rent free: Social rented,26,12,9,0,9,2,1,14,10,0,1,3,0
S01009258,Rented or living rent free: Private rented or living rent free,25,18,16,1,15,2,0,7,6,0,0,1,0
S01009259,All HRPs aged 16 and over,380,262,221,23,198,38,3,118,112,0,2,4,0
S01009259,Owned: Total,326,233,199,17,182,33,1,93,93,0,0,0,0
S01009259,Owned: Owned outright,147,60,52,12,40,8,0,87,87,0,0,0,0
S01009259,Owned: Owned with a mortgage or loan or shared ownership,179,173,147,5,142,25,1,6,6,0,0,0,0
S01009259,Rented or living rent free: Total,54,29,22,6,16,5,2,25,19,0,2,4,0
S01009259,Rented or living rent free: Social rented,36,15,12,3,9,2,1,21,16,0,1,4,0
S01009259,Rented or living rent free: Private rented or living rent free,18,14,10,3,7,3,1,4,3,0,1,0,0
S01009260,All HRPs aged 16 and over,526,399,341,48,293,39,19,127,101,2,6,17,1
S01009260,Owned: Total,343,274,243,32,211,29,2,69,64,0,1,4,0
S01009260,Owned: Owned outright,120,61,52,14,38,9,0,59,57,0,0,2,0
S01009260,Owned: Owned with a mortgage or loan or shared ownership,223,213,191,18,173,20,2,10,7,0,1,2,0
S01009260,Rented or living rent free: Total,183,125,98,16,82,10,17,58,37,2,5,13,1
S01009260,Rented or living rent free: Social rented,117,68,52,14,38,5,11,49,31,2,3,12,1
S01009260,Rented or living rent free: Private rented or living rent free,66,57,46,2,44,5,6,9,6,0,2,1,0
S01009261,All HRPs aged 16 and over,386,214,175,29,146,21,18,172,121,0,12,30,9
S01009261,Owned: Total,127,85,71,5,66,13,1,42,40,0,0,2,0
S01009261,Owned: Owned outright,57,19,15,3,12,3,1,38,37,0,0,1,0
S01009261,Owned: Owned with a mortgage or loan or shared ownership,70,66,56,2,54,10,0,4,3,0,0,1,0
S01009261,Rented or living rent free: Total,259,129,104,24,80,8,17,130,81,0,12,28,9
S01009261,Rented or living rent free: Social rented,230,108,86,23,63,7,15,122,75,0,11,28,8
S01009261,Rented or living rent free: Private rented or living rent free,29,21,18,1,17,1,2,8,6,0,1,0,1
S01009262,All HRPs aged 16 and over,293,162,132,29,103,10,20,131,83,4,10,27,7
S01009262,Owned: Total,92,53,44,5,39,8,1,39,37,0,0,1,1
S01009262,Owned: Owned outright,45,12,10,2,8,1,1,33,31,0,0,1,1
S01009262,Owned: Owned with a mortgage or loan or shared ownership,47,41,34,3,31,7,0,6,6,0,0,0,0
S01009262,Rented or living rent free: Total,201,109,88,24,64,2,19,92,46,4,10,26,6
S01009262,Rented or living rent free: Social rented,183,97,78,24,54,2,17,86,45,0,10,26,5
S01009262,Rented or living rent free: Private rented or living rent free,18,12,10,0,10,0,2,6,1,4,0,0,1
S01009263,All HRPs aged 16 and over,365,313,268,25,243,36,9,52,40,2,3,6,1
S01009263,Owned: Total,299,260,229,18,211,29,2,39,34,2,1,2,0
S01009263,Owned: Owned outright,60,31,23,7,16,6,2,29,25,2,0,2,0
S01009263,Owned: Owned with a mortgage or loan or shared ownership,239,229,206,11,195,23,0,10,9,0,1,0,0
S01009263,Rented or living rent free: Total,66,53,39,7,32,7,7,13,6,0,2,4,1
S01009263,Rented or living rent free: Social rented,15,5,3,1,2,1,1,10,3,0,2,4,1
S01009263,Rented or living rent free: Private rented or living rent free,51,48,36,6,30,6,6,3,3,0,0,0,0
S01009264,All HRPs aged 16 and over,231,151,127,16,111,24,0,80,76,1,0,2,1
S01009264,Owned: Total,202,134,111,11,100,23,0,68,67,0,0,1,0
S01009264,Owned: Owned outright,114,52,39,5,34,13,0,62,61,0,0,1,0
S01009264,Owned: Owned with a mortgage or loan or shared ownership,88,82,72,6,66,10,0,6,6,0,0,0,0
S01009264,Rented or living rent free: Total,29,17,16,5,11,1,0,12,9,1,0,1,1
S01009264,Rented or living rent free: Social rented,2,1,1,1,0,0,0,1,1,0,0,0,0
S01009264,Rented or living rent free: Private rented or living rent free,27,16,15,4,11,1,0,11,8,1,0,1,1
S01009265,All HRPs aged 16 and over,376,240,211,40,171,10,19,136,118,3,4,8,3
S01009265,Owned: Total,243,160,149,17,132,9,2,83,78,1,3,0,1
S01009265,Owned: Owned outright,115,46,42,11,31,3,1,69,64,1,3,0,1
S01009265,Owned: Owned with a mortgage or loan or shared ownership,128,114,107,6,101,6,1,14,14,0,0,0,0
S01009265,Rented or living rent free: Total,133,80,62,23,39,1,17,53,40,2,1,8,2
S01009265,Rented or living rent free: Social rented,103,57,42,18,24,0,15,46,35,2,1,6,2
S01009265,Rented or living rent free: Private rented or living rent free,30,23,20,5,15,1,2,7,5,0,0,2,0
S01009266,All HRPs aged 16 and over,374,221,186,37,149,23,12,153,130,0,7,13,3
S01009266,Owned: Total,274,168,150,24,126,16,2,106,103,0,0,2,1
S01009266,Owned: Owned outright,149,57,51,13,38,6,0,92,92,0,0,0,0
S01009266,Owned: Owned with a mortgage or loan or shared ownership,125,111,99,11,88,10,2,14,11,0,0,2,1
S01009266,Rented or living rent free: Total,100,53,36,13,23,7,10,47,27,0,7,11,2
S01009266,Rented or living rent free: Social rented,71,29,23,9,14,1,5,42,25,0,6,9,2
S01009266,Rented or living rent free: Private rented or living rent free,29,24,13,4,9,6,5,5,2,0,1,2,0
S01009267,All HRPs aged 16 and over,377,256,215,28,187,28,13,121,103,3,3,7,5
S01009267,Owned: Total,279,190,165,18,147,21,4,89,83,3,1,1,1
S01009267,Owned: Owned outright,133,53,44,10,34,7,2,80,77,1,0,1,1
S01009267,Owned: Owned with a mortgage or loan or shared ownership,146,137,121,8,113,14,2,9,6,2,1,0,0
S01009267,Rented or living rent free: Total,98,66,50,10,40,7,9,32,20,0,2,6,4
S01009267,Rented or living rent free: Social rented,35,18,13,2,11,1,4,17,9,0,2,5,1
S01009267,Rented or living rent free: Private rented or living rent free,63,48,37,8,29,6,5,15,11,0,0,1,3
S01009268,All HRPs aged 16 and over,431,290,245,35,210,28,17,141,100,5,11,16,9
S01009268,Owned: Total,285,201,177,20,157,23,1,84,70,2,2,5,5
S01009268,Owned: Owned outright,113,45,32,9,23,12,1,68,59,2,1,3,3
S01009268,Owned: Owned with a mortgage or loan or shared ownership,172,156,145,11,134,11,0,16,11,0,1,2,2
S01009268,Rented or living rent free: Total,146,89,68,15,53,5,16,57,30,3,9,11,4
S01009268,Rented or living rent free: Social rented,104,61,42,11,31,4,15,43,23,2,7,8,3
S01009268,Rented or living rent free: Private rented or living rent free,42,28,26,4,22,1,1,14,7,1,2,3,1
S01009269,All HRPs aged 16 and over,351,232,198,45,153,9,25,119,81,0,9,23,6
S01009269,Owned: Total,146,99,92,10,82,5,2,47,45,0,0,2,0
S01009269,Owned: Owned outright,56,15,13,4,9,1,1,41,39,0,0,2,0
S01009269,Owned: Owned with a mortgage or loan or shared ownership,90,84,79,6,73,4,1,6,6,0,0,0,0
S01009269,Rented or living rent free: Total,205,133,106,35,71,4,23,72,36,0,9,21,6
S01009269,Rented or living rent free: Social rented,192,123,98,33,65,3,22,69,35,0,8,20,6
S01009269,Rented or living rent free: Private rented or living rent free,13,10,8,2,6,1,1,3,1,0,1,1,0
S01009270,All HRPs aged 16 and over,306,174,137,25,112,17,20,132,97,2,8,18,7
S01009270,Owned: Total,152,91,76,6,70,12,3,61,57,0,1,1,2
S01009270,Owned: Owned outright,75,25,16,1,15,7,2,50,49,0,0,1,0
S01009270,Owned: Owned with a mortgage or loan or shared ownership,77,66,60,5,55,5,1,11,8,0,1,0,2
S01009270,Rented or living rent free: Total,154,83,61,19,42,5,17,71,40,2,7,17,5
S01009270,Rented or living rent free: Social rented,128,66,50,13,37,2,14,62,35,2,7,17,1
S01009270,Rented or living rent free: Private rented or living rent free,26,17,11,6,5,3,3,9,5,0,0,0,4
S01009271,All HRPs aged 16 and over,349,265,227,15,212,30,8,84,79,0,3,1,1
S01009271,Owned: Total,332,252,217,13,204,28,7,80,76,0,3,0,1
S01009271,Owned: Owned outright,126,61,46,7,39,10,5,65,63,0,2,0,0
S01009271,Owned: Owned with a mortgage or loan or shared ownership,206,191,171,6,165,18,2,15,13,0,1,0,1
S01009271,Rented or living rent free: Total,17,13,10,2,8,2,1,4,3,0,0,1,0
S01009271,Rented or living rent free: Social rented,4,1,0,0,0,0,1,3,2,0,0,1,0
S01009271,Rented or living rent free: Private rented or living rent free,13,12,10,2,8,2,0,1,1,0,0,0,0
S01009272,All HRPs aged 16 and over,264,195,162,40,122,15,18,69,46,1,10,10,2
S01009272,Owned: Total,147,112,98,14,84,12,2,35,32,0,1,1,1
S01009272,Owned: Owned outright,62,32,29,10,19,3,0,30,28,0,0,1,1
S01009272,Owned: Owned with a mortgage or loan or shared ownership,85,80,69,4,65,9,2,5,4,0,1,0,0
S01009272,Rented or living rent free: Total,117,83,64,26,38,3,16,34,14,1,9,9,1
S01009272,Rented or living rent free: Social rented,105,75,56,23,33,3,16,30,12,1,7,9,1
S01009272,Rented or living rent free: Private rented or living rent free,12,8,8,3,5,0,0,4,2,0,2,0,0
S01009273,All HRPs aged 16 and over,211,135,116,12,104,17,2,76,73,0,0,3,0
S01009273,Owned: Total,195,125,108,11,97,16,1,70,68,0,0,2,0
S01009273,Owned: Owned outright,115,49,42,7,35,7,0,66,66,0,0,0,0
S01009273,Owned: Owned with a mortgage or loan or shared ownership,80,76,66,4,62,9,1,4,2,0,0,2,0
S01009273,Rented or living rent free: Total,16,10,8,1,7,1,1,6,5,0,0,1,0
S01009273,Rented or living rent free: Social rented,8,4,3,0,3,0,1,4,3,0,0,1,0
S01009273,Rented or living rent free: Private rented or living rent free,8,6,5,1,4,1,0,2,2,0,0,0,0
S01009274,All HRPs aged 16 and over,255,158,128,19,109,22,8,97,90,1,2,1,3
S01009274,Owned: Total,219,131,111,12,99,19,1,88,82,1,2,1,2
S01009274,Owned: Owned outright,113,38,32,5,27,6,0,75,71,1,1,0,2
S01009274,Owned: Owned with a mortgage or loan or shared ownership,106,93,79,7,72,13,1,13,11,0,1,1,0
S01009274,Rented or living rent free: Total,36,27,17,7,10,3,7,9,8,0,0,0,1
S01009274,Rented or living rent free: Social rented,25,17,10,5,5,2,5,8,7,0,0,0,1
S01009274,Rented or living rent free: Private rented or living rent free,11,10,7,2,5,1,2,1,1,0,0,0,0
S01009275,All HRPs aged 16 and over,244,178,124,12,112,45,9,66,54,1,5,6,0
S01009275,Owned: Total,191,143,100,9,91,38,5,48,43,1,0,4,0
S01009275,Owned: Owned outright,78,39,22,3,19,15,2,39,36,1,0,2,0
S01009275,Owned: Owned with a mortgage or loan or shared ownership,113,104,78,6,72,23,3,9,7,0,0,2,0
S01009275,Rented or living rent free: Total,53,35,24,3,21,7,4,18,11,0,5,2,0
S01009275,Rented or living rent free: Social rented,2,2,2,0,2,0,0,0,0,0,0,0,0
S01009275,Rented or living rent free: Private rented or living rent free,51,33,22,3,19,7,4,18,11,0,5,2,0
S01009276,All HRPs aged 16 and over,373,224,182,25,157,35,7,149,122,1,7,16,3
S01009276,Owned: Total,310,198,164,20,144,34,0,112,108,0,2,1,1
S01009276,Owned: Owned outright,159,53,45,9,36,8,0,106,103,0,2,1,0
S01009276,Owned: Owned with a mortgage or loan or shared ownership,151,145,119,11,108,26,0,6,5,0,0,0,1
S01009276,Rented or living rent free: Total,63,26,18,5,13,1,7,37,14,1,5,15,2
S01009276,Rented or living rent free: Social rented,48,17,13,3,10,1,3,31,12,0,5,12,2
S01009276,Rented or living rent free: Private rented or living rent free,15,9,5,2,3,0,4,6,2,1,0,3,0
S01009277,All HRPs aged 16 and over,218,162,108,13,95,50,4,56,51,0,1,3,1
S01009277,Owned: Total,198,144,95,12,83,46,3,54,50,0,1,2,1
S01009277,Owned: Owned outright,111,62,36,7,29,25,1,49,46,0,0,2,1
S01009277,Owned: Owned with a mortgage or loan or shared ownership,87,82,59,5,54,21,2,5,4,0,1,0,0
S01009277,Rented or living rent free: Total,20,18,13,1,12,4,1,2,1,0,0,1,0
S01009277,Rented or living rent free: Social rented,2,2,1,0,1,1,0,0,0,0,0,0,0
S01009277,Rented or living rent free: Private rented or living rent free,18,16,12,1,11,3,1,2,1,0,0,1,0
S01009278,All HRPs aged 16 and over,235,177,157,20,137,18,2,58,53,0,0,5,0
S01009278,Owned: Total,204,153,136,14,122,16,1,51,48,0,0,3,0
S01009278,Owned: Owned outright,73,32,26,7,19,6,0,41,39,0,0,2,0
S01009278,Owned: Owned with a mortgage or loan or shared ownership,131,121,110,7,103,10,1,10,9,0,0,1,0
S01009278,Rented or living rent free: Total,31,24,21,6,15,2,1,7,5,0,0,2,0
S01009278,Rented or living rent free: Social rented,14,7,7,1,6,0,0,7,5,0,0,2,0
S01009278,Rented or living rent free: Private rented or living rent free,17,17,14,5,9,2,1,0,0,0,0,0,0
S01009279,All HRPs aged 16 and over,283,192,150,30,120,37,5,91,71,2,6,11,1
S01009279,Owned: Total,206,154,122,22,100,30,2,52,49,0,1,2,0
S01009279,Owned: Owned outright,89,46,32,14,18,14,0,43,40,0,1,2,0
S01009279,Owned: Owned with a mortgage or loan or shared ownership,117,108,90,8,82,16,2,9,9,0,0,0,0
S01009279,Rented or living rent free: Total,77,38,28,8,20,7,3,39,22,2,5,9,1
S01009279,Rented or living rent free: Social rented,39,14,11,6,5,1,2,25,17,0,3,4,1
S01009279,Rented or living rent free: Private rented or living rent free,38,24,17,2,15,6,1,14,5,2,2,5,0
S01009280,All HRPs aged 16 and over,406,201,162,42,120,11,28,205,118,3,27,44,13
S01009280,Owned: Total,147,83,75,11,64,6,2,64,56,0,1,5,2
S01009280,Owned: Owned outright,74,26,23,6,17,3,0,48,43,0,0,3,2
S01009280,Owned: Owned with a mortgage or loan or shared ownership,73,57,52,5,47,3,2,16,13,0,1,2,0
S01009280,Rented or living rent free: Total,259,118,87,31,56,5,26,141,62,3,26,39,11
S01009280,Rented or living rent free: Social rented,238,106,78,27,51,4,24,132,60,3,24,36,9
S01009280,Rented or living rent free: Private rented or living rent free,21,12,9,4,5,1,2,9,2,0,2,3,2
S01009281,All HRPs aged 16 and over,375,188,158,37,121,8,22,187,116,2,14,39,16
S01009281,Owned: Total,169,99,92,11,81,4,3,70,61,0,0,6,3
S01009281,Owned: Owned outright,81,23,21,3,18,1,1,58,53,0,0,3,2
S01009281,Owned: Owned with a mortgage or loan or shared ownership,88,76,71,8,63,3,2,12,8,0,0,3,1
S01009281,Rented or living rent free: Total,206,89,66,26,40,4,19,117,55,2,14,33,13
S01009281,Rented or living rent free: Social rented,182,77,56,23,33,4,17,105,49,2,12,30,12
S01009281,Rented or living rent free: Private rented or living rent free,24,12,10,3,7,0,2,12,6,0,2,3,1
S01009282,All HRPs aged 16 and over,346,219,163,17,146,43,13,127,92,0,15,15,5
S01009282,Owned: Total,239,164,127,15,112,34,3,75,65,0,5,3,2
S01009282,Owned: Owned outright,119,55,40,8,32,14,1,64,56,0,3,3,2
S01009282,Owned: Owned with a mortgage or loan or shared ownership,120,109,87,7,80,20,2,11,9,0,2,0,0
S01009282,Rented or living rent free: Total,107,55,36,2,34,9,10,52,27,0,10,12,3
S01009282,Rented or living rent free: Social rented,52,24,14,2,12,2,8,28,14,0,7,5,2
S01009282,Rented or living rent free: Private rented or living rent free,55,31,22,0,22,7,2,24,13,0,3,7,1
S01009283,All HRPs aged 16 and over,180,152,124,12,112,24,4,28,25,0,0,3,0
S01009283,Owned: Total,143,126,104,8,96,22,0,17,16,0,0,1,0
S01009283,Owned: Owned outright,42,30,21,4,17,9,0,12,12,0,0,0,0
S01009283,Owned: Owned with a mortgage or loan or shared ownership,101,96,83,4,79,13,0,5,4,0,0,1,0
S01009283,Rented or living rent free: Total,37,26,20,4,16,2,4,11,9,0,0,2,0
S01009283,Rented or living rent free: Social rented,21,12,10,0,10,0,2,9,7,0,0,2,0
S01009283,Rented or living rent free: Private rented or living rent free,16,14,10,4,6,2,2,2,2,0,0,0,0
S01009284,All HRPs aged 16 and over,311,245,209,28,181,33,3,66,56,0,0,9,1
S01009284,Owned: Total,285,232,196,26,170,33,3,53,48,0,0,4,1
S01009284,Owned: Owned outright,111,64,51,15,36,13,0,47,45,0,0,2,0
S01009284,Owned: Owned with a mortgage or loan or shared ownership,174,168,145,11,134,20,3,6,3,0,0,2,1
S01009284,Rented or living rent free: Total,26,13,13,2,11,0,0,13,8,0,0,5,0
S01009284,Rented or living rent free: Social rented,12,2,2,1,1,0,0,10,6,0,0,4,0
S01009284,Rented or living rent free: Private rented or living rent free,14,11,11,1,10,0,0,3,2,0,0,1,0
S01009285,All HRPs aged 16 and over,350,262,227,39,188,25,10,88,71,1,4,8,4
S01009285,Owned: Total,313,238,212,30,182,22,4,75,67,1,1,4,2
S01009285,Owned: Owned outright,110,44,37,13,24,4,3,66,61,0,1,2,2
S01009285,Owned: Owned with a mortgage or loan or shared ownership,203,194,175,17,158,18,1,9,6,1,0,2,0
S01009285,Rented or living rent free: Total,37,24,15,9,6,3,6,13,4,0,3,4,2
S01009285,Rented or living rent free: Social rented,14,5,2,0,2,1,2,9,3,0,0,4,2
S01009285,Rented or living rent free: Private rented or living rent free,23,19,13,9,4,2,4,4,1,0,3,0,0
S01009286,All HRPs aged 16 and over,351,232,194,25,169,33,5,119,113,0,2,4,0
S01009286,Owned: Total,311,201,170,17,153,28,3,110,107,0,1,2,0
S01009286,Owned: Owned outright,162,63,48,10,38,13,2,99,98,0,1,0,0
S01009286,Owned: Owned with a mortgage or loan or shared ownership,149,138,122,7,115,15,1,11,9,0,0,2,0
S01009286,Rented or living rent free: Total,40,31,24,8,16,5,2,9,6,0,1,2,0
S01009286,Rented or living rent free: Social rented,6,5,5,3,2,0,0,1,0,0,1,0,0
S01009286,Rented or living rent free: Private rented or living rent free,34,26,19,5,14,5,2,8,6,0,0,2,0
S01009287,All HRPs aged 16 and over,339,193,149,22,127,43,1,146,139,1,1,4,1
S01009287,Owned: Total,301,171,133,19,114,38,0,130,127,1,1,1,0
S01009287,Owned: Owned outright,192,73,53,13,40,20,0,119,118,0,0,1,0
S01009287,Owned: Owned with a mortgage or loan or shared ownership,109,98,80,6,74,18,0,11,9,1,1,0,0
S01009287,Rented or living rent free: Total,38,22,16,3,13,5,1,16,12,0,0,3,1
S01009287,Rented or living rent free: Social rented,12,4,4,2,2,0,0,8,6,0,0,2,0
S01009287,Rented or living rent free: Private rented or living rent free,26,18,12,1,11,5,1,8,6,0,0,1,1
S01009288,All HRPs aged 16 and over,392,225,176,26,150,42,7,167,154,2,2,9,0
S01009288,Owned: Total,291,164,133,19,114,31,0,127,121,0,2,4,0
S01009288,Owned: Owned outright,160,51,39,11,28,12,0,109,109,0,0,0,0
S01009288,Owned: Owned with a mortgage or loan or shared ownership,131,113,94,8,86,19,0,18,12,0,2,4,0
S01009288,Rented or living rent free: Total,101,61,43,7,36,11,7,40,33,2,0,5,0
S01009288,Rented or living rent free: Social rented,10,6,2,1,1,0,4,4,2,1,0,1,0
S01009288,Rented or living rent free: Private rented or living rent free,91,55,41,6,35,11,3,36,31,1,0,4,0
S01009289,All HRPs aged 16 and over,409,254,201,24,177,47,6,155,142,1,2,7,3
S01009289,Owned: Total,363,229,186,19,167,41,2,134,127,0,1,4,2
S01009289,Owned: Owned outright,190,73,57,12,45,15,1,117,114,0,0,3,0
S01009289,Owned: Owned with a mortgage or loan or shared ownership,173,156,129,7,122,26,1,17,13,0,1,1,2
S01009289,Rented or living rent free: Total,46,25,15,5,10,6,4,21,15,1,1,3,1
S01009289,Rented or living rent free: Social rented,19,6,4,0,4,0,2,13,8,1,1,3,0
S01009289,Rented or living rent free: Private rented or living rent free,27,19,11,5,6,6,2,8,7,0,0,0,1
S01009290,All HRPs aged 16 and over,288,163,133,24,109,30,0,125,122,1,0,2,0
S01009290,Owned: Total,282,160,130,23,107,30,0,122,119,1,0,2,0
S01009290,Owned: Owned outright,180,62,49,13,36,13,0,118,115,1,0,2,0
S01009290,Owned: Owned with a mortgage or loan or shared ownership,102,98,81,10,71,17,0,4,4,0,0,0,0
S01009290,Rented or living rent free: Total,6,3,3,1,2,0,0,3,3,0,0,0,0
S01009290,Rented or living rent free: Social rented,1,1,1,1,0,0,0,0,0,0,0,0,0
S01009290,Rented or living rent free: Private rented or living rent free,5,2,2,0,2,0,0,3,3,0,0,0,0
S01009291,All HRPs aged 16 and over,394,277,235,26,209,41,1,117,107,0,3,7,0
S01009291,Owned: Total,361,256,218,20,198,37,1,105,100,0,1,4,0
S01009291,Owned: Owned outright,183,86,71,15,56,14,1,97,92,0,1,4,0
S01009291,Owned: Owned with a mortgage or loan or shared ownership,178,170,147,5,142,23,0,8,8,0,0,0,0
S01009291,Rented or living rent free: Total,33,21,17,6,11,4,0,12,7,0,2,3,0
S01009291,Rented or living rent free: Social rented,9,2,2,0,2,0,0,7,4,0,1,2,0
S01009291,Rented or living rent free: Private rented or living rent free,24,19,15,6,9,4,0,5,3,0,1,1,0
S01009292,All HRPs aged 16 and over,227,143,123,25,98,12,8,84,59,4,5,12,4
S01009292,Owned: Total,142,95,82,11,71,10,3,47,35,3,0,7,2
S01009292,Owned: Owned outright,52,21,19,4,15,2,0,31,26,0,0,3,2
S01009292,Owned: Owned with a mortgage or loan or shared ownership,90,74,63,7,56,8,3,16,9,3,0,4,0
S01009292,Rented or living rent free: Total,85,48,41,14,27,2,5,37,24,1,5,5,2
S01009292,Rented or living rent free: Social rented,68,35,30,12,18,1,4,33,23,0,3,5,2
S01009292,Rented or living rent free: Private rented or living rent free,17,13,11,2,9,1,1,4,1,1,2,0,0
S01009293,All HRPs aged 16 and over,297,211,176,19,157,30,5,86,75,1,5,2,3
S01009293,Owned: Total,229,179,152,11,141,27,0,50,48,0,1,0,1
S01009293,Owned: Owned outright,85,40,32,6,26,8,0,45,44,0,0,0,1
S01009293,Owned: Owned with a mortgage or loan or shared ownership,144,139,120,5,115,19,0,5,4,0,1,0,0
S01009293,Rented or living rent free: Total,68,32,24,8,16,3,5,36,27,1,4,2,2
S01009293,Rented or living rent free: Social rented,47,16,15,8,7,0,1,31,27,0,1,2,1
S01009293,Rented or living rent free: Private rented or living rent free,21,16,9,0,9,3,4,5,0,1,3,0,1
S01009294,All HRPs aged 16 and over,192,143,115,12,103,25,3,49,46,0,2,1,0
S01009294,Owned: Total,180,135,112,11,101,23,0,45,45,0,0,0,0
S01009294,Owned: Owned outright,81,39,30,5,25,9,0,42,42,0,0,0,0
S01009294,Owned: Owned with a mortgage or loan or shared ownership,99,96,82,6,76,14,0,3,3,0,0,0,0
S01009294,Rented or living rent free: Total,12,8,3,1,2,2,3,4,1,0,2,1,0
S01009294,Rented or living rent free: Social rented,1,0,0,0,0,0,0,1,0,0,1,0,0
S01009294,Rented or living rent free: Private rented or living rent free,11,8,3,1,2,2,3,3,1,0,1,1,0
S01009295,All HRPs aged 16 and over,264,202,174,20,154,25,3,62,58,0,3,1,0
S01009295,Owned: Total,250,191,168,20,148,21,2,59,57,0,1,1,0
S01009295,Owned: Owned outright,112,61,54,12,42,6,1,51,49,0,1,1,0
S01009295,Owned: Owned with a mortgage or loan or shared ownership,138,130,114,8,106,15,1,8,8,0,0,0,0
S01009295,Rented or living rent free: Total,14,11,6,0,6,4,1,3,1,0,2,0,0
S01009295,Rented or living rent free: Social rented,3,2,1,0,1,1,0,1,0,0,1,0,0
S01009295,Rented or living rent free: Private rented or living rent free,11,9,5,0,5,3,1,2,1,0,1,0,0
S01009296,All HRPs aged 16 and over,187,150,123,6,117,25,2,37,33,0,1,2,1
S01009296,Owned: Total,167,140,115,6,109,24,1,27,27,0,0,0,0
S01009296,Owned: Owned outright,45,24,16,3,13,8,0,21,21,0,0,0,0
S01009296,Owned: Owned with a mortgage or loan or shared ownership,122,116,99,3,96,16,1,6,6,0,0,0,0
S01009296,Rented or living rent free: Total,20,10,8,0,8,1,1,10,6,0,1,2,1
S01009296,Rented or living rent free: Social rented,14,6,5,0,5,0,1,8,5,0,1,2,0
S01009296,Rented or living rent free: Private rented or living rent free,6,4,3,0,3,1,0,2,1,0,0,0,1
S01009297,All HRPs aged 16 and over,328,265,228,24,204,33,4,63,57,2,2,2,0
S01009297,Owned: Total,297,240,208,20,188,32,0,57,55,2,0,0,0
S01009297,Owned: Owned outright,115,65,49,11,38,16,0,50,50,0,0,0,0
S01009297,Owned: Owned with a mortgage or loan or shared ownership,182,175,159,9,150,16,0,7,5,2,0,0,0
S01009297,Rented or living rent free: Total,31,25,20,4,16,1,4,6,2,0,2,2,0
S01009297,Rented or living rent free: Social rented,5,3,2,0,2,0,1,2,0,0,2,0,0
S01009297,Rented or living rent free: Private rented or living rent free,26,22,18,4,14,1,3,4,2,0,0,2,0
S01009298,All HRPs aged 16 and over,553,310,258,60,198,29,23,243,193,2,6,37,5
S01009298,Owned: Total,242,160,141,25,116,17,2,82,75,1,0,5,1
S01009298,Owned: Owned outright,99,34,29,15,14,5,0,65,62,0,0,2,1
S01009298,Owned: Owned with a mortgage or loan or shared ownership,143,126,112,10,102,12,2,17,13,1,0,3,0
S01009298,Rented or living rent free: Total,311,150,117,35,82,12,21,161,118,1,6,32,4
S01009298,Rented or living rent free: Social rented,235,90,66,27,39,7,17,145,111,1,3,28,2
S01009298,Rented or living rent free: Private rented or living rent free,76,60,51,8,43,5,4,16,7,0,3,4,2
S01009299,All HRPs aged 16 and over,484,324,268,28,240,43,13,160,126,0,4,23,7
S01009299,Owned: Total,297,220,186,14,172,31,3,77,73,0,1,1,2
S01009299,Owned: Owned outright,117,52,43,8,35,8,1,65,64,0,0,0,1
S01009299,Owned: Owned with a mortgage or loan or shared ownership,180,168,143,6,137,23,2,12,9,0,1,1,1
S01009299,Rented or living rent free: Total,187,104,82,14,68,12,10,83,53,0,3,22,5
S01009299,Rented or living rent free: Social rented,98,31,24,7,17,5,2,67,44,0,2,17,4
S01009299,Rented or living rent free: Private rented or living rent free,89,73,58,7,51,7,8,16,9,0,1,5,1
S01009300,All HRPs aged 16 and over,287,203,169,15,154,16,18,84,52,3,3,19,7
S01009300,Owned: Total,161,125,115,9,106,9,1,36,32,0,1,2,1
S01009300,Owned: Owned outright,54,21,19,3,16,2,0,33,31,0,0,1,1
S01009300,Owned: Owned with a mortgage or loan or shared ownership,107,104,96,6,90,7,1,3,1,0,1,1,0
S01009300,Rented or living rent free: Total,126,78,54,6,48,7,17,48,20,3,2,17,6
S01009300,Rented or living rent free: Social rented,80,41,26,4,22,3,12,39,19,1,2,14,3
S01009300,Rented or living rent free: Private rented or living rent free,46,37,28,2,26,4,5,9,1,2,0,3,3
S01009301,All HRPs aged 16 and over,551,375,272,45,227,34,69,176,103,3,21,41,8
S01009301,Owned: Total,217,162,140,7,133,19,3,55,53,0,0,2,0
S01009301,Owned: Owned outright,69,26,19,2,17,5,2,43,43,0,0,0,0
S01009301,Owned: Owned with a mortgage or loan or shared ownership,148,136,121,5,116,14,1,12,10,0,0,2,0
S01009301,Rented or living rent free: Total,334,213,132,38,94,15,66,121,50,3,21,39,8
S01009301,Rented or living rent free: Social rented,256,151,80,30,50,9,62,105,41,3,17,37,7
S01009301,Rented or living rent free: Private rented or living rent free,78,62,52,8,44,6,4,16,9,0,4,2,1
S01009302,All HRPs aged 16 and over,450,301,241,57,184,12,48,149,73,5,14,44,13
S01009302,Owned: Total,160,119,106,15,91,5,8,41,32,0,1,7,1
S01009302,Owned: Owned outright,43,12,8,2,6,2,2,31,29,0,0,2,0
S01009302,Owned: Owned with a mortgage or loan or shared ownership,117,107,98,13,85,3,6,10,3,0,1,5,1
S01009302,Rented or living rent free: Total,290,182,135,42,93,7,40,108,41,5,13,37,12
S01009302,Rented or living rent free: Social rented,216,124,84,35,49,7,33,92,37,3,8,34,10
S01009302,Rented or living rent free: Private rented or living rent free,74,58,51,7,44,0,7,16,4,2,5,3,2
S01009303,All HRPs aged 16 and over,322,203,177,27,150,18,8,119,110,0,1,7,1
S01009303,Owned: Total,268,170,154,21,133,15,1,98,96,0,0,2,0
S01009303,Owned: Owned outright,136,44,38,14,24,5,1,92,91,0,0,1,0
S01009303,Owned: Owned with a mortgage or loan or shared ownership,132,126,116,7,109,10,0,6,5,0,0,1,0
S01009303,Rented or living rent free: Total,54,33,23,6,17,3,7,21,14,0,1,5,1
S01009303,Rented or living rent free: Social rented,24,10,6,4,2,0,4,14,9,0,0,4,1
S01009303,Rented or living rent free: Private rented or living rent free,30,23,17,2,15,3,3,7,5,0,1,1,0
S01009304,All HRPs aged 16 and over,395,265,218,35,183,34,13,130,115,2,4,5,4
S01009304,Owned: Total,297,215,181,28,153,29,5,82,80,0,1,1,0
S01009304,Owned: Owned outright,125,50,38,11,27,8,4,75,74,0,0,1,0
S01009304,Owned: Owned with a mortgage or loan or shared ownership,172,165,143,17,126,21,1,7,6,0,1,0,0
S01009304,Rented or living rent free: Total,98,50,37,7,30,5,8,48,35,2,3,4,4
S01009304,Rented or living rent free: Social rented,80,36,25,6,19,4,7,44,34,2,2,4,2
S01009304,Rented or living rent free: Private rented or living rent free,18,14,12,1,11,1,1,4,1,0,1,0,2
S01009305,All HRPs aged 16 and over,412,265,229,42,187,17,19,147,120,1,3,18,5
S01009305,Owned: Total,269,179,163,19,144,11,5,90,86,0,0,3,1
S01009305,Owned: Owned outright,106,28,24,7,17,2,2,78,75,0,0,2,1
S01009305,Owned: Owned with a mortgage or loan or shared ownership,163,151,139,12,127,9,3,12,11,0,0,1,0
S01009305,Rented or living rent free: Total,143,86,66,23,43,6,14,57,34,1,3,15,4
S01009305,Rented or living rent free: Social rented,95,49,33,13,20,4,12,46,26,1,3,13,3
S01009305,Rented or living rent free: Private rented or living rent free,48,37,33,10,23,2,2,11,8,0,0,2,1
S01009306,All HRPs aged 16 and over,565,418,344,58,286,35,39,147,87,4,11,36,9
S01009306,Owned: Total,313,240,207,21,186,26,7,73,63,2,1,5,2
S01009306,Owned: Owned outright,99,42,30,7,23,8,4,57,53,0,0,2,2
S01009306,Owned: Owned with a mortgage or loan or shared ownership,214,198,177,14,163,18,3,16,10,2,1,3,0
S01009306,Rented or living rent free: Total,252,178,137,37,100,9,32,74,24,2,10,31,7
S01009306,Rented or living rent free: Social rented,114,56,42,21,21,1,13,58,21,2,5,24,6
S01009306,Rented or living rent free: Private rented or living rent free,138,122,95,16,79,8,19,16,3,0,5,7,1
S01009307,All HRPs aged 16 and over,544,395,326,33,293,41,28,149,92,10,5,34,8
S01009307,Owned: Total,311,223,192,15,177,28,3,88,78,2,1,3,4
S01009307,Owned: Owned outright,123,47,36,10,26,10,1,76,71,1,1,3,0
S01009307,Owned: Owned with a mortgage or loan or shared ownership,188,176,156,5,151,18,2,12,7,1,0,0,4
S01009307,Rented or living rent free: Total,233,172,134,18,116,13,25,61,14,8,4,31,4
S01009307,Rented or living rent free: Social rented,60,24,15,3,12,1,8,36,10,3,2,21,0
S01009307,Rented or living rent free: Private rented or living rent free,173,148,119,15,104,12,17,25,4,5,2,10,4
S01009308,All HRPs aged 16 and over,304,222,173,22,151,30,19,82,58,4,5,11,4
S01009308,Owned: Total,160,102,77,6,71,23,2,58,53,1,0,1,3
S01009308,Owned: Owned outright,80,28,16,3,13,11,1,52,47,1,0,1,3
S01009308,Owned: Owned with a mortgage or loan or shared ownership,80,74,61,3,58,12,1,6,6,0,0,0,0
S01009308,Rented or living rent free: Total,144,120,96,16,80,7,17,24,5,3,5,10,1
S01009308,Rented or living rent free: Social rented,52,36,17,6,11,4,15,16,2,3,4,7,0
S01009308,Rented or living rent free: Private rented or living rent free,92,84,79,10,69,3,2,8,3,0,1,3,1
S01009309,All HRPs aged 16 and over,400,315,255,23,232,39,21,85,66,1,4,7,7
S01009309,Owned: Total,225,174,141,14,127,29,4,51,46,0,1,2,2
S01009309,Owned: Owned outright,93,47,35,4,31,11,1,46,43,0,1,0,2
S01009309,Owned: Owned with a mortgage or loan or shared ownership,132,127,106,10,96,18,3,5,3,0,0,2,0
S01009309,Rented or living rent free: Total,175,141,114,9,105,10,17,34,20,1,3,5,5
S01009309,Rented or living rent free: Social rented,42,18,11,5,6,2,5,24,18,0,0,4,2
S01009309,Rented or living rent free: Private rented or living rent free,133,123,103,4,99,8,12,10,2,1,3,1,3
S01009310,All HRPs aged 16 and over,399,281,237,20,217,35,9,118,110,0,0,7,1
S01009310,Owned: Total,343,236,199,14,185,32,5,107,106,0,0,1,0
S01009310,Owned: Owned outright,175,84,70,8,62,13,1,91,91,0,0,0,0
S01009310,Owned: Owned with a mortgage or loan or shared ownership,168,152,129,6,123,19,4,16,15,0,0,1,0
S01009310,Rented or living rent free: Total,56,45,38,6,32,3,4,11,4,0,0,6,1
S01009310,Rented or living rent free: Social rented,11,5,4,1,3,0,1,6,1,0,0,4,1
S01009310,Rented or living rent free: Private rented or living rent free,45,40,34,5,29,3,3,5,3,0,0,2,0
S01009311,All HRPs aged 16 and over,274,172,143,30,113,13,16,102,71,0,10,14,7
S01009311,Owned: Total,149,104,92,9,83,10,2,45,44,0,0,1,0
S01009311,Owned: Owned outright,59,19,18,3,15,1,0,40,40,0,0,0,0
S01009311,Owned: Owned with a mortgage or loan or shared ownership,90,85,74,6,68,9,2,5,4,0,0,1,0
S01009311,Rented or living rent free: Total,125,68,51,21,30,3,14,57,27,0,10,13,7
S01009311,Rented or living rent free: Social rented,107,57,44,18,26,1,12,50,24,0,9,10,7
S01009311,Rented or living rent free: Private rented or living rent free,18,11,7,3,4,2,2,7,3,0,1,3,0
S01009312,All HRPs aged 16 and over,366,278,243,22,221,20,15,88,68,2,1,14,3
S01009312,Owned: Total,224,173,156,14,142,15,2,51,45,1,0,3,2
S01009312,Owned: Owned outright,77,31,27,4,23,4,0,46,43,0,0,1,2
S01009312,Owned: Owned with a mortgage or loan or shared ownership,147,142,129,10,119,11,2,5,2,1,0,2,0
S01009312,Rented or living rent free: Total,142,105,87,8,79,5,13,37,23,1,1,11,1
S01009312,Rented or living rent free: Social rented,35,14,6,1,5,1,7,21,15,0,1,5,0
S01009312,Rented or living rent free: Private rented or living rent free,107,91,81,7,74,4,6,16,8,1,0,6,1
S01009313,All HRPs aged 16 and over,285,162,138,29,109,15,9,123,69,4,9,35,6
S01009313,Owned: Total,135,88,77,10,67,11,0,47,42,2,1,2,0
S01009313,Owned: Owned outright,58,21,18,3,15,3,0,37,34,1,1,1,0
S01009313,Owned: Owned with a mortgage or loan or shared ownership,77,67,59,7,52,8,0,10,8,1,0,1,0
S01009313,Rented or living rent free: Total,150,74,61,19,42,4,9,76,27,2,8,33,6
S01009313,Rented or living rent free: Social rented,114,46,42,16,26,2,2,68,24,1,5,32,6
S01009313,Rented or living rent free: Private rented or living rent free,36,28,19,3,16,2,7,8,3,1,3,1,0
S01009314,All HRPs aged 16 and over,258,179,161,23,138,17,1,79,75,0,1,2,1
S01009314,Owned: Total,229,159,142,19,123,17,0,70,69,0,0,1,0
S01009314,Owned: Owned outright,105,39,38,8,30,1,0,66,65,0,0,1,0
S01009314,Owned: Owned with a mortgage or loan or shared ownership,124,120,104,11,93,16,0,4,4,0,0,0,0
S01009314,Rented or living rent free: Total,29,20,19,4,15,0,1,9,6,0,1,1,1
S01009314,Rented or living rent free: Social rented,13,7,6,1,5,0,1,6,3,0,1,1,1
S01009314,Rented or living rent free: Private rented or living rent free,16,13,13,3,10,0,0,3,3,0,0,0,0
S01009315,All HRPs aged 16 and over,270,177,143,23,120,22,12,93,64,1,6,19,3
S01009315,Owned: Total,166,123,102,15,87,16,5,43,40,0,0,2,1
S01009315,Owned: Owned outright,65,34,28,7,21,4,2,31,31,0,0,0,0
S01009315,Owned: Owned with a mortgage or loan or shared ownership,101,89,74,8,66,12,3,12,9,0,0,2,1
S01009315,Rented or living rent free: Total,104,54,41,8,33,6,7,50,24,1,6,17,2
S01009315,Rented or living rent free: Social rented,85,41,29,6,23,5,7,44,22,0,4,16,2
S01009315,Rented or living rent free: Private rented or living rent free,19,13,12,2,10,1,0,6,2,1,2,1,0
S01009316,All HRPs aged 16 and over,326,239,193,17,176,37,9,87,79,0,1,5,2
S01009316,Owned: Total,265,200,165,12,153,33,2,65,64,0,0,0,1
S01009316,Owned: Owned outright,114,58,46,6,40,11,1,56,56,0,0,0,0
S01009316,Owned: Owned with a mortgage or loan or shared ownership,151,142,119,6,113,22,1,9,8,0,0,0,1
S01009316,Rented or living rent free: Total,61,39,28,5,23,4,7,22,15,0,1,5,1
S01009316,Rented or living rent free: Social rented,17,9,4,1,3,0,5,8,4,0,0,3,1
S01009316,Rented or living rent free: Private rented or living rent free,44,30,24,4,20,4,2,14,11,0,1,2,0
S01009317,All HRPs aged 16 and over,358,245,209,22,187,33,3,113,110,0,2,1,0
S01009317,Owned: Total,341,233,201,21,180,30,2,108,107,0,1,0,0
S01009317,Owned: Owned outright,164,66,52,13,39,13,1,98,97,0,1,0,0
S01009317,Owned: Owned with a mortgage or loan or shared ownership,177,167,149,8,141,17,1,10,10,0,0,0,0
S01009317,Rented or living rent free: Total,17,12,8,1,7,3,1,5,3,0,1,1,0
S01009317,Rented or living rent free: Social rented,3,1,1,1,0,0,0,2,2,0,0,0,0
S01009317,Rented or living rent free: Private rented or living rent free,14,11,7,0,7,3,1,3,1,0,1,1,0
S01009318,All HRPs aged 16 and over,236,167,147,12,135,19,1,69,66,0,0,3,0
S01009318,Owned: Total,223,156,139,10,129,16,1,67,66,0,0,1,0
S01009318,Owned: Owned outright,108,45,36,4,32,8,1,63,62,0,0,1,0
S01009318,Owned: Owned with a mortgage or loan or shared ownership,115,111,103,6,97,8,0,4,4,0,0,0,0
S01009318,Rented or living rent free: Total,13,11,8,2,6,3,0,2,0,0,0,2,0
S01009318,Rented or living rent free: Social rented,3,1,1,1,0,0,0,2,0,0,0,2,0
S01009318,Rented or living rent free: Private rented or living rent free,10,10,7,1,6,3,0,0,0,0,0,0,0
S01009319,All HRPs aged 16 and over,416,210,181,23,158,27,2,206,202,0,0,2,2
S01009319,Owned: Total,385,200,174,21,153,25,1,185,184,0,0,0,1
S01009319,Owned: Owned outright,218,57,46,8,38,10,1,161,160,0,0,0,1
S01009319,Owned: Owned with a mortgage or loan or shared ownership,167,143,128,13,115,15,0,24,24,0,0,0,0
S01009319,Rented or living rent free: Total,31,10,7,2,5,2,1,21,18,0,0,2,1
S01009319,Rented or living rent free: Social rented,14,3,1,0,1,1,1,11,10,0,0,0,1
S01009319,Rented or living rent free: Private rented or living rent free,17,7,6,2,4,1,0,10,8,0,0,2,0
S01009320,All HRPs aged 16 and over,352,182,159,19,140,21,2,170,148,2,1,15,4
S01009320,Owned: Total,226,156,138,14,124,17,1,70,66,1,0,3,0
S01009320,Owned: Owned outright,83,31,26,8,18,5,0,52,51,0,0,1,0
S01009320,Owned: Owned with a mortgage or loan or shared ownership,143,125,112,6,106,12,1,18,15,1,0,2,0
S01009320,Rented or living rent free: Total,126,26,21,5,16,4,1,100,82,1,1,12,4
S01009320,Rented or living rent free: Social rented,110,19,16,4,12,3,0,91,76,0,1,11,3
S01009320,Rented or living rent free: Private rented or living rent free,16,7,5,1,4,1,1,9,6,1,0,1,1
S01009321,All HRPs aged 16 and over,295,177,160,19,141,14,3,118,115,1,1,1,0
S01009321,Owned: Total,278,168,153,16,137,13,2,110,110,0,0,0,0
S01009321,Owned: Owned outright,150,50,43,10,33,6,1,100,100,0,0,0,0
S01009321,Owned: Owned with a mortgage or loan or shared ownership,128,118,110,6,104,7,1,10,10,0,0,0,0
S01009321,Rented or living rent free: Total,17,9,7,3,4,1,1,8,5,1,1,1,0
S01009321,Rented or living rent free: Social rented,3,3,2,1,1,0,1,0,0,0,0,0,0
S01009321,Rented or living rent free: Private rented or living rent free,14,6,5,2,3,1,0,8,5,1,1,1,0
S01009322,All HRPs aged 16 and over,355,227,193,17,176,27,7,128,111,4,2,11,0
S01009322,Owned: Total,287,187,162,12,150,24,1,100,98,1,0,1,0
S01009322,Owned: Owned outright,130,45,37,7,30,8,0,85,85,0,0,0,0
S01009322,Owned: Owned with a mortgage or loan or shared ownership,157,142,125,5,120,16,1,15,13,1,0,1,0
S01009322,Rented or living rent free: Total,68,40,31,5,26,3,6,28,13,3,2,10,0
S01009322,Rented or living rent free: Social rented,42,21,17,3,14,0,4,21,12,1,1,7,0
S01009322,Rented or living rent free: Private rented or living rent free,26,19,14,2,12,3,2,7,1,2,1,3,0
S01009323,All HRPs aged 16 and over,327,192,153,24,129,28,11,135,109,4,1,16,5
S01009323,Owned: Total,237,149,122,16,106,25,2,88,81,0,1,3,3
S01009323,Owned: Owned outright,117,39,30,8,22,9,0,78,72,0,1,3,2
S01009323,Owned: Owned with a mortgage or loan or shared ownership,120,110,92,8,84,16,2,10,9,0,0,0,1
S01009323,Rented or living rent free: Total,90,43,31,8,23,3,9,47,28,4,0,13,2
S01009323,Rented or living rent free: Social rented,63,21,15,5,10,2,4,42,26,4,0,10,2
S01009323,Rented or living rent free: Private rented or living rent free,27,22,16,3,13,1,5,5,2,0,0,3,0
S01009324,All HRPs aged 16 and over,256,172,143,24,119,17,12,84,67,0,7,8,2
S01009324,Owned: Total,179,127,110,12,98,12,5,52,50,0,0,2,0
S01009324,Owned: Owned outright,66,25,21,5,16,1,3,41,40,0,0,1,0
S01009324,Owned: Owned with a mortgage or loan or shared ownership,113,102,89,7,82,11,2,11,10,0,0,1,0
S01009324,Rented or living rent free: Total,77,45,33,12,21,5,7,32,17,0,7,6,2
S01009324,Rented or living rent free: Social rented,48,27,17,5,12,4,6,21,10,0,4,5,2
S01009324,Rented or living rent free: Private rented or living rent free,29,18,16,7,9,1,1,11,7,0,3,1,0
S01009325,All HRPs aged 16 and over,308,254,225,25,200,25,4,54,43,0,2,8,1
S01009325,Owned: Total,267,224,198,16,182,24,2,43,39,0,0,4,0
S01009325,Owned: Owned outright,80,41,32,5,27,8,1,39,36,0,0,3,0
S01009325,Owned: Owned with a mortgage or loan or shared ownership,187,183,166,11,155,16,1,4,3,0,0,1,0
S01009325,Rented or living rent free: Total,41,30,27,9,18,1,2,11,4,0,2,4,1
S01009325,Rented or living rent free: Social rented,10,7,6,3,3,0,1,3,2,0,0,0,1
S01009325,Rented or living rent free: Private rented or living rent free,31,23,21,6,15,1,1,8,2,0,2,4,0
S01009326,All HRPs aged 16 and over,210,180,163,29,134,9,8,30,16,0,3,9,2
S01009326,Owned: Total,158,147,135,15,120,9,3,11,10,0,0,1,0
S01009326,Owned: Owned outright,27,18,15,4,11,2,1,9,8,0,0,1,0
S01009326,Owned: Owned with a mortgage or loan or shared ownership,131,129,120,11,109,7,2,2,2,0,0,0,0
S01009326,Rented or living rent free: Total,52,33,28,14,14,0,5,19,6,0,3,8,2
S01009326,Rented or living rent free: Social rented,46,28,23,11,12,0,5,18,6,0,3,7,2
S01009326,Rented or living rent free: Private rented or living rent free,6,5,5,3,2,0,0,1,0,0,0,1,0
S01009327,All HRPs aged 16 and over,258,144,122,17,105,18,4,114,107,0,4,1,2
S01009327,Owned: Total,221,120,101,9,92,17,2,101,100,0,0,0,1
S01009327,Owned: Owned outright,127,33,27,6,21,5,1,94,93,0,0,0,1
S01009327,Owned: Owned with a mortgage or loan or shared ownership,94,87,74,3,71,12,1,7,7,0,0,0,0
S01009327,Rented or living rent free: Total,37,24,21,8,13,1,2,13,7,0,4,1,1
S01009327,Rented or living rent free: Social rented,28,16,14,4,10,0,2,12,6,0,4,1,1
S01009327,Rented or living rent free: Private rented or living rent free,9,8,7,4,3,1,0,1,1,0,0,0,0
S01009328,All HRPs aged 16 and over,237,230,213,8,205,17,0,7,5,2,0,0,0
S01009328,Owned: Total,197,192,177,7,170,15,0,5,5,0,0,0,0
S01009328,Owned: Owned outright,17,13,11,1,10,2,0,4,4,0,0,0,0
S01009328,Owned: Owned with a mortgage or loan or shared ownership,180,179,166,6,160,13,0,1,1,0,0,0,0
S01009328,Rented or living rent free: Total,40,38,36,1,35,2,0,2,0,2,0,0,0
S01009328,Rented or living rent free: Social rented,0,0,0,0,0,0,0,0,0,0,0,0,0
S01009328,Rented or living rent free: Private rented or living rent free,40,38,36,1,35,2,0,2,0,2,0,0,0
S01009329,All HRPs aged 16 and over,203,185,169,17,152,12,4,18,8,1,4,3,2
S01009329,Owned: Total,160,149,139,10,129,9,1,11,8,0,1,1,1
S01009329,Owned: Owned outright,18,10,8,1,7,2,0,8,7,0,0,1,0
S01009329,Owned: Owned with a mortgage or loan or shared ownership,142,139,131,9,122,7,1,3,1,0,1,0,1
S01009329,Rented or living rent free: Total,43,36,30,7,23,3,3,7,0,1,3,2,1
S01009329,Rented or living rent free: Social rented,17,10,6,3,3,1,3,7,0,1,3,2,1
S01009329,Rented or living rent free: Private rented or living rent free,26,26,24,4,20,2,0,0,0,0,0,0,0
S01009330,All HRPs aged 16 and over,183,148,130,17,113,12,6,35,13,0,10,11,1
S01009330,Owned: Total,100,87,80,5,75,7,0,13,10,0,1,2,0
S01009330,Owned: Owned outright,19,10,8,0,8,2,0,9,8,0,0,1,0
S01009330,Owned: Owned with a mortgage or loan or shared ownership,81,77,72,5,67,5,0,4,2,0,1,1,0
S01009330,Rented or living rent free: Total,83,61,50,12,38,5,6,22,3,0,9,9,1
S01009330,Rented or living rent free: Social rented,64,45,36,9,27,4,5,19,3,0,8,7,1
S01009330,Rented or living rent free: Private rented or living rent free,19,16,14,3,11,1,1,3,0,0,1,2,0
S01009331,All HRPs aged 16 and over,180,170,148,7,141,22,0,10,9,1,0,0,0
S01009331,Owned: Total,172,162,141,7,134,21,0,10,9,1,0,0,0
S01009331,Owned: Owned outright,27,17,15,2,13,2,0,10,9,1,0,0,0
S01009331,Owned: Owned with a mortgage or loan or shared ownership,145,145,126,5,121,19,0,0,0,0,0,0,0
S01009331,Rented or living rent free: Total,8,8,7,0,7,1,0,0,0,0,0,0,0
S01009331,Rented or living rent free: Social rented,0,0,0,0,0,0,0,0,0,0,0,0,0
S01009331,Rented or living rent free: Private rented or living rent free,8,8,7,0,7,1,0,0,0,0,0,0,0
S01009332,All HRPs aged 16 and over,333,246,221,17,204,23,2,87,82,1,3,0,1
S01009332,Owned: Total,315,232,209,14,195,22,1,83,81,0,2,0,0
S01009332,Owned: Owned outright,122,52,45,5,40,7,0,70,70,0,0,0,0
S01009332,Owned: Owned with a mortgage or loan or shared ownership,193,180,164,9,155,15,1,13,11,0,2,0,0
S01009332,Rented or living rent free: Total,18,14,12,3,9,1,1,4,1,1,1,0,1
S01009332,Rented or living rent free: Social rented,7,4,3,1,2,0,1,3,1,0,1,0,1
S01009332,Rented or living rent free: Private rented or living rent free,11,10,9,2,7,1,0,1,0,1,0,0,0
S01009333,All HRPs aged 16 and over,355,238,207,30,177,22,9,117,89,5,5,9,9
S01009333,Owned: Total,223,172,149,18,131,18,5,51,47,1,0,2,1
S01009333,Owned: Owned outright,74,28,25,2,23,2,1,46,43,1,0,2,0
S01009333,Owned: Owned with a mortgage or loan or shared ownership,149,144,124,16,108,16,4,5,4,0,0,0,1
S01009333,Rented or living rent free: Total,132,66,58,12,46,4,4,66,42,4,5,7,8
S01009333,Rented or living rent free: Social rented,72,21,20,6,14,0,1,51,38,1,3,6,3
S01009333,Rented or living rent free: Private rented or living rent free,60,45,38,6,32,4,3,15,4,3,2,1,5
S01009334,All HRPs aged 16 and over,310,189,144,35,109,7,38,121,82,2,6,24,7
S01009334,Owned: Total,138,88,75,11,64,7,6,50,44,1,1,2,2
S01009334,Owned: Owned outright,58,24,17,4,13,3,4,34,32,0,1,1,0
S01009334,Owned: Owned with a mortgage or loan or shared ownership,80,64,58,7,51,4,2,16,12,1,0,1,2
S01009334,Rented or living rent free: Total,172,101,69,24,45,0,32,71,38,1,5,22,5
S01009334,Rented or living rent free: Social rented,146,84,54,23,31,0,30,62,34,0,3,21,4
S01009334,Rented or living rent free: Private rented or living rent free,26,17,15,1,14,0,2,9,4,1,2,1,1
S01009335,All HRPs aged 16 and over,337,221,183,40,143,16,22,116,81,2,10,18,5
S01009335,Owned: Total,198,141,129,21,108,9,3,57,55,0,1,0,1
S01009335,Owned: Owned outright,84,38,35,11,24,1,2,46,44,0,1,0,1
S01009335,Owned: Owned with a mortgage or loan or shared ownership,114,103,94,10,84,8,1,11,11,0,0,0,0
S01009335,Rented or living rent free: Total,139,80,54,19,35,7,19,59,26,2,9,18,4
S01009335,Rented or living rent free: Social rented,113,65,44,19,25,3,18,48,24,1,7,12,4
S01009335,Rented or living rent free: Private rented or living rent free,26,15,10,0,10,4,1,11,2,1,2,6,0
S01009336,All HRPs aged 16 and over,318,186,132,39,93,10,44,132,65,6,16,39,6
S01009336,Owned: Total,108,63,52,9,43,8,3,45,43,0,0,1,1
S01009336,Owned: Owned outright,51,13,12,4,8,0,1,38,37,0,0,1,0
S01009336,Owned: Owned with a mortgage or loan or shared ownership,57,50,40,5,35,8,2,7,6,0,0,0,1
S01009336,Rented or living rent free: Total,210,123,80,30,50,2,41,87,22,6,16,38,5
S01009336,Rented or living rent free: Social rented,179,99,64,26,38,0,35,80,20,6,12,37,5
S01009336,Rented or living rent free: Private rented or living rent free,31,24,16,4,12,2,6,7,2,0,4,1,0
S01009337,All HRPs aged 16 and over,318,208,170,43,127,14,24,110,69,2,9,20,10
S01009337,Owned: Total,160,111,95,13,82,12,4,49,43,0,0,5,1
S01009337,Owned: Owned outright,50,15,13,4,9,2,0,35,32,0,0,2,1
S01009337,Owned: Owned with a mortgage or loan or shared ownership,110,96,82,9,73,10,4,14,11,0,0,3,0
S01009337,Rented or living rent free: Total,158,97,75,30,45,2,20,61,26,2,9,15,9
S01009337,Rented or living rent free: Social rented,138,83,61,27,34,2,20,55,20,2,9,15,9
S01009337,Rented or living rent free: Private rented or living rent free,20,14,14,3,11,0,0,6,6,0,0,0,0
S01009338,All HRPs aged 16 and over,401,216,167,35,132,10,39,185,115,0,8,48,14
S01009338,Owned: Total,158,95,85,9,76,5,5,63,57,0,1,4,1
S01009338,Owned: Owned outright,60,17,12,3,9,1,4,43,41,0,1,1,0
S01009338,Owned: Owned with a mortgage or loan or shared ownership,98,78,73,6,67,4,1,20,16,0,0,3,1
S01009338,Rented or living rent free: Total,243,121,82,26,56,5,34,122,58,0,7,44,13
S01009338,Rented or living rent free: Social rented,222,110,74,26,48,2,34,112,53,0,5,42,12
S01009338,Rented or living rent free: Private rented or living rent free,21,11,8,0,8,3,0,10,5,0,2,2,1
S01009339,All HRPs aged 16 and over,391,250,191,41,150,14,45,141,75,1,17,37,11
S01009339,Owned: Total,146,111,101,13,88,8,2,35,32,0,0,3,0
S01009339,Owned: Owned outright,51,20,17,3,14,1,2,31,28,0,0,3,0
S01009339,Owned: Owned with a mortgage or loan or shared ownership,95,91,84,10,74,7,0,4,4,0,0,0,0
S01009339,Rented or living rent free: Total,245,139,90,28,62,6,43,106,43,1,17,34,11
S01009339,Rented or living rent free: Social rented,216,118,77,25,52,3,38,98,43,0,15,29,11
S01009339,Rented or living rent free: Private rented or living rent free,29,21,13,3,10,3,5,8,0,1,2,5,0
S01009340,All HRPs aged 16 and over,283,169,146,46,100,12,11,114,80,1,8,20,5
S01009340,Owned: Total,154,93,87,18,69,6,0,61,52,0,1,8,0
S01009340,Owned: Owned outright,66,16,16,4,12,0,0,50,45,0,1,4,0
S01009340,Owned: Owned with a mortgage or loan or shared ownership,88,77,71,14,57,6,0,11,7,0,0,4,0
S01009340,Rented or living rent free: Total,129,76,59,28,31,6,11,53,28,1,7,12,5
S01009340,Rented or living rent free: Social rented,107,58,43,22,21,5,10,49,26,1,6,12,4
S01009340,Rented or living rent free: Private rented or living rent free,22,18,16,6,10,1,1,4,2,0,1,0,1
S01009341,All HRPs aged 16 and over,270,166,126,22,104,18,22,104,80,0,4,16,4
S01009341,Owned: Total,169,111,96,16,80,12,3,58,57,0,0,1,0
S01009341,Owned: Owned outright,70,22,20,4,16,1,1,48,47,0,0,1,0
S01009341,Owned: Owned with a mortgage or loan or shared ownership,99,89,76,12,64,11,2,10,10,0,0,0,0
S01009341,Rented or living rent free: Total,101,55,30,6,24,6,19,46,23,0,4,15,4
S01009341,Rented or living rent free: Social rented,78,40,20,5,15,4,16,38,20,0,1,13,4
S01009341,Rented or living rent free: Private rented or living rent free,23,15,10,1,9,2,3,8,3,0,3,2,0
S01009342,All HRPs aged 16 and over,333,226,202,39,163,12,12,107,86,1,6,10,4
S01009342,Owned: Total,223,151,139,19,120,10,2,72,67,1,1,2,1
S01009342,Owned: Owned outright,84,24,21,6,15,1,2,60,60,0,0,0,0
S01009342,Owned: Owned with a mortgage or loan or shared ownership,139,127,118,13,105,9,0,12,7,1,1,2,1
S01009342,Rented or living rent free: Total,110,75,63,20,43,2,10,35,19,0,5,8,3
S01009342,Rented or living rent free: Social rented,82,52,42,17,25,1,9,30,18,0,5,4,3
S01009342,Rented or living rent free: Private rented or living rent free,28,23,21,3,18,1,1,5,1,0,0,4,0
S01009343,All HRPs aged 16 and over,242,175,161,25,136,9,5,67,54,1,4,4,4
S01009343,Owned: Total,193,141,135,16,119,6,0,52,48,1,2,0,1
S01009343,Owned: Owned outright,65,21,19,4,15,2,0,44,42,0,1,0,1
S01009343,Owned: Owned with a mortgage or loan or shared ownership,128,120,116,12,104,4,0,8,6,1,1,0,0
S01009343,Rented or living rent free: Total,49,34,26,9,17,3,5,15,6,0,2,4,3
S01009343,Rented or living rent free: Social rented,27,13,9,3,6,1,3,14,6,0,1,4,3
S01009343,Rented or living rent free: Private rented or living rent free,22,21,17,6,11,2,2,1,0,0,1,0,0
S01009344,All HRPs aged 16 and over,288,168,143,30,113,11,14,120,94,1,5,15,5
S01009344,Owned: Total,162,88,77,7,70,9,2,74,68,1,0,4,1
S01009344,Owned: Owned outright,78,14,13,2,11,0,1,64,61,0,0,2,1
S01009344,Owned: Owned with a mortgage or loan or shared ownership,84,74,64,5,59,9,1,10,7,1,0,2,0
S01009344,Rented or living rent free: Total,126,80,66,23,43,2,12,46,26,0,5,11,4
S01009344,Rented or living rent free: Social rented,109,67,53,21,32,2,12,42,25,0,4,9,4
S01009344,Rented or living rent free: Private rented or living rent free,17,13,13,2,11,0,0,4,1,0,1,2,0
S01009345,All HRPs aged 16 and over,379,274,241,46,195,21,12,105,81,1,9,9,5
S01009345,Owned: Total,281,212,192,26,166,15,5,69,65,0,0,3,1
S01009345,Owned: Owned outright,96,38,31,9,22,6,1,58,55,0,0,2,1
S01009345,Owned: Owned with a mortgage or loan or shared ownership,185,174,161,17,144,9,4,11,10,0,0,1,0
S01009345,Rented or living rent free: Total,98,62,49,20,29,6,7,36,16,1,9,6,4
S01009345,Rented or living rent free: Social rented,47,30,25,14,11,1,4,17,10,1,1,4,1
S01009345,Rented or living rent free: Private rented or living rent free,51,32,24,6,18,5,3,19,6,0,8,2,3
S01009346,All HRPs aged 16 and over,228,216,180,10,170,34,2,12,12,0,0,0,0
S01009346,Owned: Total,218,206,171,9,162,33,2,12,12,0,0,0,0
S01009346,Owned: Owned outright,26,19,17,3,14,2,0,7,7,0,0,0,0
S01009346,Owned: Owned with a mortgage or loan or shared ownership,192,187,154,6,148,31,2,5,5,0,0,0,0
S01009346,Rented or living rent free: Total,10,10,9,1,8,1,0,0,0,0,0,0,0
S01009346,Rented or living rent free: Social rented,2,2,2,0,2,0,0,0,0,0,0,0,0
S01009346,Rented or living rent free: Private rented or living rent free,8,8,7,1,6,1,0,0,0,0,0,0,0
S01009347,All HRPs aged 16 and over,216,199,162,8,154,33,4,17,15,1,0,0,1
S01009347,Owned: Total,211,195,159,8,151,33,3,16,14,1,0,0,1
S01009347,Owned: Owned outright,47,34,30,5,25,3,1,13,13,0,0,0,0
S01009347,Owned: Owned with a mortgage or loan or shared ownership,164,161,129,3,126,30,2,3,1,1,0,0,1
S01009347,Rented or living rent free: Total,5,4,3,0,3,0,1,1,1,0,0,0,0
S01009347,Rented or living rent free: Social rented,0,0,0,0,0,0,0,0,0,0,0,0,0
S01009347,Rented or living rent free: Private rented or living rent free,5,4,3,0,3,0,1,1,1,0,0,0,0
S01009348,All HRPs aged 16 and over,161,153,134,5,129,17,2,8,6,0,0,2,0
S01009348,Owned: Total,152,147,129,4,125,16,2,5,5,0,0,0,0
S01009348,Owned: Owned outright,15,11,9,1,8,2,0,4,4,0,0,0,0
S01009348,Owned: Owned with a mortgage or loan or shared ownership,137,136,120,3,117,14,2,1,1,0,0,0,0
S01009348,Rented or living rent free: Total,9,6,5,1,4,1,0,3,1,0,0,2,0
S01009348,Rented or living rent free: Social rented,0,0,0,0,0,0,0,0,0,0,0,0,0
S01009348,Rented or living rent free: Private rented or living rent free,9,6,5,1,4,1,0,3,1,0,0,2,0
S01009349,All HRPs aged 16 and over,288,264,231,13,218,28,5,24,18,3,1,1,1
S01009349,Owned: Total,254,232,205,10,195,24,3,22,18,2,1,0,1
S01009349,Owned: Owned outright,35,21,20,5,15,0,1,14,12,1,1,0,0
S01009349,Owned: Owned with a mortgage or loan or shared ownership,219,211,185,5,180,24,2,8,6,1,0,0,1
S01009349,Rented or living rent free: Total,34,32,26,3,23,4,2,2,0,1,0,1,0
S01009349,Rented or living rent free: Social rented,3,2,0,0,0,0,2,1,0,0,0,1,0
S01009349,Rented or living rent free: Private rented or living rent free,31,30,26,3,23,4,0,1,0,1,0,0,0
S01009350,All HRPs aged 16 and over,240,216,193,23,170,18,5,24,17,0,4,2,1
S01009350,Owned: Total,161,149,135,10,125,14,0,12,12,0,0,0,0
S01009350,Owned: Owned outright,21,11,8,1,7,3,0,10,10,0,0,0,0
S01009350,Owned: Owned with a mortgage or loan or shared ownership,140,138,127,9,118,11,0,2,2,0,0,0,0
S01009350,Rented or living rent free: Total,79,67,58,13,45,4,5,12,5,0,4,2,1
S01009350,Rented or living rent free: Social rented,44,35,31,10,21,0,4,9,3,0,3,2,1
S01009350,Rented or living rent free: Private rented or living rent free,35,32,27,3,24,4,1,3,2,0,1,0,0
S01009351,All HRPs aged 16 and over,213,198,182,9,173,11,5,15,12,1,0,0,2
S01009351,Owned: Total,152,138,129,5,124,9,0,14,11,1,0,0,2
S01009351,Owned: Owned outright,26,16,15,2,13,1,0,10,9,1,0,0,0
S01009351,Owned: Owned with a mortgage or loan or shared ownership,126,122,114,3,111,8,0,4,2,0,0,0,2
S01009351,Rented or living rent free: Total,61,60,53,4,49,2,5,1,1,0,0,0,0
S01009351,Rented or living rent free: Social rented,2,2,1,1,0,0,1,0,0,0,0,0,0
S01009351,Rented or living rent free: Private rented or living rent free,59,58,52,3,49,2,4,1,1,0,0,0,0
S01009352,All HRPs aged 16 and over,290,275,253,13,240,16,6,15,13,1,1,0,0
S01009352,Owned: Total,261,250,233,10,223,14,3,11,10,0,1,0,0
S01009352,Owned: Owned outright,31,23,18,1,17,4,1,8,8,0,0,0,0
S01009352,Owned: Owned with a mortgage or loan or shared ownership,230,227,215,9,206,10,2,3,2,0,1,0,0
S01009352,Rented or living rent free: Total,29,25,20,3,17,2,3,4,3,1,0,0,0
S01009352,Rented or living rent free: Social rented,1,1,0,0,0,0,1,0,0,0,0,0,0
S01009352,Rented or living rent free: Private rented or living rent free,28,24,20,3,17,2,2,4,3,1,0,0,0
S01009353,All HRPs aged 16 and over,147,130,110,4,106,16,4,17,12,2,1,1,1
S01009353,Owned: Total,134,119,101,4,97,16,2,15,12,0,1,1,1
S01009353,Owned: Owned outright,27,15,10,1,9,4,1,12,11,0,0,0,1
S01009353,Owned: Owned with a mortgage or loan or shared ownership,107,104,91,3,88,12,1,3,1,0,1,1,0
S01009353,Rented or living rent free: Total,13,11,9,0,9,0,2,2,0,2,0,0,0
S01009353,Rented or living rent free: Social rented,1,1,1,0,1,0,0,0,0,0,0,0,0
S01009353,Rented or living rent free: Private rented or living rent free,12,10,8,0,8,0,2,2,0,2,0,0,0
S01009354,All HRPs aged 16 and over,297,277,243,15,228,31,3,20,16,0,2,1,1
S01009354,Owned: Total,273,257,230,11,219,26,1,16,14,0,0,1,1
S01009354,Owned: Owned outright,31,18,15,2,13,2,1,13,12,0,0,1,0
S01009354,Owned: Owned with a mortgage or loan or shared ownership,242,239,215,9,206,24,0,3,2,0,0,0,1
S01009354,Rented or living rent free: Total,24,20,13,4,9,5,2,4,2,0,2,0,0
S01009354,Rented or living rent free: Social rented,1,1,1,0,1,0,0,0,0,0,0,0,0
S01009354,Rented or living rent free: Private rented or living rent free,23,19,12,4,8,5,2,4,2,0,2,0,0
S01009355,All HRPs aged 16 and over,367,244,221,33,188,23,0,123,111,0,5,5,2
S01009355,Owned: Total,331,220,199,29,170,21,0,111,106,0,2,2,1
S01009355,Owned: Owned outright,163,67,62,20,42,5,0,96,94,0,2,0,0
S01009355,Owned: Owned with a mortgage or loan or shared ownership,168,153,137,9,128,16,0,15,12,0,0,2,1
S01009355,Rented or living rent free: Total,36,24,22,4,18,2,0,12,5,0,3,3,1
S01009355,Rented or living rent free: Social rented,8,2,2,0,2,0,0,6,2,0,1,3,0
S01009355,Rented or living rent free: Private rented or living rent free,28,22,20,4,16,2,0,6,3,0,2,0,1
S01009356,All HRPs aged 16 and over,411,277,245,31,214,28,4,134,130,0,2,2,0
S01009356,Owned: Total,390,261,231,27,204,27,3,129,129,0,0,0,0
S01009356,Owned: Owned outright,185,69,61,11,50,8,0,116,116,0,0,0,0
S01009356,Owned: Owned with a mortgage or loan or shared ownership,205,192,170,16,154,19,3,13,13,0,0,0,0
S01009356,Rented or living rent free: Total,21,16,14,4,10,1,1,5,1,0,2,2,0
S01009356,Rented or living rent free: Social rented,3,2,2,2,0,0,0,1,0,0,1,0,0
S01009356,Rented or living rent free: Private rented or living rent free,18,14,12,2,10,1,1,4,1,0,1,2,0
S01009357,All HRPs aged 16 and over,179,157,137,14,123,18,2,22,18,0,0,1,3
S01009357,Owned: Total,131,115,101,7,94,13,1,16,15,0,0,0,1
S01009357,Owned: Owned outright,31,15,12,3,9,3,0,16,15,0,0,0,1
S01009357,Owned: Owned with a mortgage or loan or shared ownership,100,100,89,4,85,10,1,0,0,0,0,0,0
S01009357,Rented or living rent free: Total,48,42,36,7,29,5,1,6,3,0,0,1,2
S01009357,Rented or living rent free: Social rented,2,1,0,0,0,0,1,1,1,0,0,0,0
S01009357,Rented or living rent free: Private rented or living rent free,46,41,36,7,29,5,0,5,2,0,0,1,2
S01009358,All HRPs aged 16 and over,256,206,173,7,166,30,3,50,50,0,0,0,0
S01009358,Owned: Total,252,202,169,6,163,30,3,50,50,0,0,0,0
S01009358,Owned: Owned outright,84,42,31,3,28,9,2,42,42,0,0,0,0
S01009358,Owned: Owned with a mortgage or loan or shared ownership,168,160,138,3,135,21,1,8,8,0,0,0,0
S01009358,Rented or living rent free: Total,4,4,4,1,3,0,0,0,0,0,0,0,0
S01009358,Rented or living rent free: Social rented,0,0,0,0,0,0,0,0,0,0,0,0,0
S01009358,Rented or living rent free: Private rented or living rent free,4,4,4,1,3,0,0,0,0,0,0,0,0
S01009359,All HRPs aged 16 and over,277,245,208,15,193,33,4,32,26,3,3,0,0
S01009359,Owned: Total,247,221,188,12,176,30,3,26,23,1,2,0,0
S01009359,Owned: Owned outright,41,23,19,4,15,3,1,18,17,0,1,0,0
S01009359,Owned: Owned with a mortgage or loan or shared ownership,206,198,169,8,161,27,2,8,6,1,1,0,0
S01009359,Rented or living rent free: Total,30,24,20,3,17,3,1,6,3,2,1,0,0
S01009359,Rented or living rent free: Social rented,7,4,3,2,1,0,1,3,1,2,0,0,0
S01009359,Rented or living rent free: Private rented or living rent free,23,20,17,1,16,3,0,3,2,0,1,0,0
S01009360,All HRPs aged 16 and over,376,258,225,33,192,29,4,118,106,0,1,7,4
S01009360,Owned: Total,309,211,183,17,166,25,3,98,91,0,1,4,2
S01009360,Owned: Owned outright,154,60,54,8,46,4,2,94,90,0,0,3,1
S01009360,Owned: Owned with a mortgage or loan or shared ownership,155,151,129,9,120,21,1,4,1,0,1,1,1
S01009360,Rented or living rent free: Total,67,47,42,16,26,4,1,20,15,0,0,3,2
S01009360,Rented or living rent free: Social rented,21,9,7,5,2,1,1,12,8,0,0,3,1
S01009360,Rented or living rent free: Private rented or living rent free,46,38,35,11,24,3,0,8,7,0,0,0,1
S01009361,All HRPs aged 16 and over,342,220,195,24,171,23,2,122,105,1,3,11,2
S01009361,Owned: Total,282,185,168,15,153,16,1,97,95,0,0,0,2
S01009361,Owned: Owned outright,131,43,38,8,30,5,0,88,87,0,0,0,1
S01009361,Owned: Owned with a mortgage or loan or shared ownership,151,142,130,7,123,11,1,9,8,0,0,0,1
S01009361,Rented or living rent free: Total,60,35,27,9,18,7,1,25,10,1,3,11,0
S01009361,Rented or living rent free: Social rented,30,9,8,2,6,1,0,21,7,1,3,10,0
S01009361,Rented or living rent free: Private rented or living rent free,30,26,19,7,12,6,1,4,3,0,0,1,0
S01009362,All HRPs aged 16 and over,417,285,256,31,225,26,3,132,125,0,2,1,4
S01009362,Owned: Total,389,261,234,25,209,25,2,128,124,0,0,0,4
S01009362,Owned: Owned outright,190,71,66,16,50,4,1,119,115,0,0,0,4
S01009362,Owned: Owned with a mortgage or loan or shared ownership,199,190,168,9,159,21,1,9,9,0,0,0,0
S01009362,Rented or living rent free: Total,28,24,22,6,16,1,1,4,1,0,2,1,0
S01009362,Rented or living rent free: Social rented,4,3,2,1,1,0,1,1,0,0,0,1,0
S01009362,Rented or living rent free: Private rented or living rent free,24,21,20,5,15,1,0,3,1,0,2,0,0
S01009363,All HRPs aged 16 and over,373,242,213,34,179,15,14,131,104,0,3,17,7
S01009363,Owned: Total,261,180,164,19,145,14,2,81,76,0,0,3,2
S01009363,Owned: Owned outright,117,52,47,11,36,3,2,65,65,0,0,0,0
S01009363,Owned: Owned with a mortgage or loan or shared ownership,144,128,117,8,109,11,0,16,11,0,0,3,2
S01009363,Rented or living rent free: Total,112,62,49,15,34,1,12,50,28,0,3,14,5
S01009363,Rented or living rent free: Social rented,79,39,27,9,18,0,12,40,22,0,3,13,2
S01009363,Rented or living rent free: Private rented or living rent free,33,23,22,6,16,1,0,10,6,0,0,1,3
S01009364,All HRPs aged 16 and over,325,263,232,36,196,23,8,62,49,3,3,4,3
S01009364,Owned: Total,260,212,189,22,167,19,4,48,38,2,3,2,3
S01009364,Owned: Owned outright,69,37,32,6,26,3,2,32,29,0,1,0,2
S01009364,Owned: Owned with a mortgage or loan or shared ownership,191,175,157,16,141,16,2,16,9,2,2,2,1
S01009364,Rented or living rent free: Total,65,51,43,14,29,4,4,14,11,1,0,2,0
S01009364,Rented or living rent free: Social rented,34,21,18,10,8,1,2,13,10,1,0,2,0
S01009364,Rented or living rent free: Private rented or living rent free,31,30,25,4,21,3,2,1,1,0,0,0,0
S01009365,All HRPs aged 16 and over,277,187,169,27,142,12,6,90,75,1,2,7,5
S01009365,Owned: Total,209,149,139,18,121,8,2,60,58,1,0,0,1
S01009365,Owned: Owned outright,93,41,38,6,32,2,1,52,51,1,0,0,0
S01009365,Owned: Owned with a mortgage or loan or shared ownership,116,108,101,12,89,6,1,8,7,0,0,0,1
S01009365,Rented or living rent free: Total,68,38,30,9,21,4,4,30,17,0,2,7,4
S01009365,Rented or living rent free: Social rented,36,16,10,5,5,2,4,20,11,0,0,5,4
S01009365,Rented or living rent free: Private rented or living rent free,32,22,20,4,16,2,0,10,6,0,2,2,0
S01009366,All HRPs aged 16 and over,351,208,168,22,146,24,16,143,114,3,9,14,3
S01009366,Owned: Total,244,155,132,10,122,19,4,89,84,0,1,4,0
S01009366,Owned: Owned outright,112,35,29,7,22,3,3,77,74,0,0,3,0
S01009366,Owned: Owned with a mortgage or loan or shared ownership,132,120,103,3,100,16,1,12,10,0,1,1,0
S01009366,Rented or living rent free: Total,107,53,36,12,24,5,12,54,30,3,8,10,3
S01009366,Rented or living rent free: Social rented,72,30,18,6,12,3,9,42,25,0,7,7,3
S01009366,Rented or living rent free: Private rented or living rent free,35,23,18,6,12,2,3,12,5,3,1,3,0
S01009367,All HRPs aged 16 and over,296,195,169,25,144,16,10,101,84,4,2,8,3
S01009367,Owned: Total,180,129,114,8,106,12,3,51,46,0,0,4,1
S01009367,Owned: Owned outright,69,27,23,6,17,3,1,42,39,0,0,2,1
S01009367,Owned: Owned with a mortgage or loan or shared ownership,111,102,91,2,89,9,2,9,7,0,0,2,0
S01009367,Rented or living rent free: Total,116,66,55,17,38,4,7,50,38,4,2,4,2
S01009367,Rented or living rent free: Social rented,80,41,36,11,25,3,2,39,33,1,0,3,2
S01009367,Rented or living rent free: Private rented or living rent free,36,25,19,6,13,1,5,11,5,3,2,1,0
S01009368,All HRPs aged 16 and over,211,159,138,24,114,13,8,52,38,1,3,7,3
S01009368,Owned: Total,119,96,88,12,76,7,1,23,21,0,0,2,0
S01009368,Owned: Owned outright,42,24,20,6,14,4,0,18,17,0,0,1,0
S01009368,Owned: Owned with a mortgage or loan or shared ownership,77,72,68,6,62,3,1,5,4,0,0,1,0
S01009368,Rented or living rent free: Total,92,63,50,12,38,6,7,29,17,1,3,5,3
S01009368,Rented or living rent free: Social rented,80,54,43,7,36,6,5,26,16,1,2,5,2
S01009368,Rented or living rent free: Private rented or living rent free,12,9,7,5,2,0,2,3,1,0,1,0,1
S01009369,All HRPs aged 16 and over,255,171,147,20,127,16,8,84,68,1,5,5,5
S01009369,Owned: Total,180,120,104,12,92,14,2,60,57,0,0,2,1
S01009369,Owned: Owned outright,74,24,21,5,16,2,1,50,48,0,0,1,1
S01009369,Owned: Owned with a mortgage or loan or shared ownership,106,96,83,7,76,12,1,10,9,0,0,1,0
S01009369,Rented or living rent free: Total,75,51,43,8,35,2,6,24,11,1,5,3,4
S01009369,Rented or living rent free: Social rented,47,29,26,6,20,1,2,18,9,1,3,2,3
S01009369,Rented or living rent free: Private rented or living rent free,28,22,17,2,15,1,4,6,2,0,2,1,1
S01009370,All HRPs aged 16 and over,381,232,213,39,174,14,5,149,123,2,5,17,2
S01009370,Owned: Total,286,179,168,25,143,11,0,107,101,0,1,4,1
S01009370,Owned: Owned outright,135,48,44,9,35,4,0,87,86,0,0,1,0
S01009370,Owned: Owned with a mortgage or loan or shared ownership,151,131,124,16,108,7,0,20,15,0,1,3,1
S01009370,Rented or living rent free: Total,95,53,45,14,31,3,5,42,22,2,4,13,1
S01009370,Rented or living rent free: Social rented,68,35,29,12,17,2,4,33,19,2,2,9,1
S01009370,Rented or living rent free: Private rented or living rent free,27,18,16,2,14,1,1,9,3,0,2,4,0
S01009371,All HRPs aged 16 and over,242,158,147,24,123,6,5,84,65,2,3,10,4
S01009371,Owned: Total,171,119,114,13,101,3,2,52,47,1,1,2,1
S01009371,Owned: Owned outright,67,29,27,8,19,1,1,38,35,0,1,1,1
S01009371,Owned: Owned with a mortgage or loan or shared ownership,104,90,87,5,82,2,1,14,12,1,0,1,0
S01009371,Rented or living rent free: Total,71,39,33,11,22,3,3,32,18,1,2,8,3
S01009371,Rented or living rent free: Social rented,43,17,15,7,8,1,1,26,16,0,1,7,2
S01009371,Rented or living rent free: Private rented or living rent free,28,22,18,4,14,2,2,6,2,1,1,1,1
S01009372,All HRPs aged 16 and over,219,152,127,19,108,20,5,67,53,0,4,9,1
S01009372,Owned: Total,149,112,93,10,83,18,1,37,37,0,0,0,0
S01009372,Owned: Owned outright,55,23,21,4,17,2,0,32,32,0,0,0,0
S01009372,Owned: Owned with a mortgage or loan or shared ownership,94,89,72,6,66,16,1,5,5,0,0,0,0
S01009372,Rented or living rent free: Total,70,40,34,9,25,2,4,30,16,0,4,9,1
S01009372,Rented or living rent free: Social rented,51,28,25,7,18,0,3,23,13,0,3,6,1
S01009372,Rented or living rent free: Private rented or living rent free,19,12,9,2,7,2,1,7,3,0,1,3,0
S01009373,All HRPs aged 16 and over,398,260,225,41,184,13,22,138,84,2,11,31,10
S01009373,Owned: Total,208,156,144,15,129,9,3,52,47,0,2,2,1
S01009373,Owned: Owned outright,72,35,29,7,22,4,2,37,37,0,0,0,0
S01009373,Owned: Owned with a mortgage or loan or shared ownership,136,121,115,8,107,5,1,15,10,0,2,2,1
S01009373,Rented or living rent free: Total,190,104,81,26,55,4,19,86,37,2,9,29,9
S01009373,Rented or living rent free: Social rented,145,67,46,12,34,3,18,78,31,2,8,28,9
S01009373,Rented or living rent free: Private rented or living rent free,45,37,35,14,21,1,1,8,6,0,1,1,0
S01009374,All HRPs aged 16 and over,432,239,204,39,165,16,19,193,156,5,2,19,11
S01009374,Owned: Total,236,165,148,22,126,13,4,71,61,2,0,4,4
S01009374,Owned: Owned outright,107,54,45,15,30,7,2,53,49,0,0,2,2
S01009374,Owned: Owned with a mortgage or loan or shared ownership,129,111,103,7,96,6,2,18,12,2,0,2,2
S01009374,Rented or living rent free: Total,196,74,56,17,39,3,15,122,95,3,2,15,7
S01009374,Rented or living rent free: Social rented,168,56,42,17,25,0,14,112,89,2,1,14,6
S01009374,Rented or living rent free: Private rented or living rent free,28,18,14,0,14,3,1,10,6,1,1,1,1
S01009375,All HRPs aged 16 and over,337,230,195,28,167,13,22,107,80,1,10,13,3
S01009375,Owned: Total,203,151,137,18,119,9,5,52,49,0,1,0,2
S01009375,Owned: Owned outright,83,39,33,9,24,4,2,44,42,0,1,0,1
S01009375,Owned: Owned with a mortgage or loan or shared ownership,120,112,104,9,95,5,3,8,7,0,0,0,1
S01009375,Rented or living rent free: Total,134,79,58,10,48,4,17,55,31,1,9,13,1
S01009375,Rented or living rent free: Social rented,107,60,45,7,38,3,12,47,27,1,5,13,1
S01009375,Rented or living rent free: Private rented or living rent free,27,19,13,3,10,1,5,8,4,0,4,0,0
S01009376,All HRPs aged 16 and over,271,159,144,23,121,9,6,112,87,1,6,18,0
S01009376,Owned: Total,152,105,95,11,84,9,1,47,45,0,0,2,0
S01009376,Owned: Owned outright,58,20,16,6,10,3,1,38,37,0,0,1,0
S01009376,Owned: Owned with a mortgage or loan or shared ownership,94,85,79,5,74,6,0,9,8,0,0,1,0
S01009376,Rented or living rent free: Total,119,54,49,12,37,0,5,65,42,1,6,16,0
S01009376,Rented or living rent free: Social rented,102,43,39,10,29,0,4,59,40,1,2,16,0
S01009376,Rented or living rent free: Private rented or living rent free,17,11,10,2,8,0,1,6,2,0,4,0,0
S01009377,All HRPs aged 16 and over,373,343,298,36,262,26,19,30,14,1,4,7,4
S01009377,Owned: Total,244,227,201,15,186,21,5,17,12,0,1,2,2
S01009377,Owned: Owned outright,38,25,22,4,18,3,0,13,11,0,0,1,1
S01009377,Owned: Owned with a mortgage or loan or shared ownership,206,202,179,11,168,18,5,4,1,0,1,1,1
S01009377,Rented or living rent free: Total,129,116,97,21,76,5,14,13,2,1,3,5,2
S01009377,Rented or living rent free: Social rented,34,25,21,12,9,1,3,9,2,0,2,3,2
S01009377,Rented or living rent free: Private rented or living rent free,95,91,76,9,67,4,11,4,0,1,1,2,0
S01009378,All HRPs aged 16 and over,388,311,266,47,219,30,15,77,41,6,12,13,5
S01009378,Owned: Total,205,173,149,12,137,22,2,32,32,0,0,0,0
S01009378,Owned: Owned outright,50,21,18,3,15,2,1,29,29,0,0,0,0
S01009378,Owned: Owned with a mortgage or loan or shared ownership,155,152,131,9,122,20,1,3,3,0,0,0,0
S01009378,Rented or living rent free: Total,183,138,117,35,82,8,13,45,9,6,12,13,5
S01009378,Rented or living rent free: Social rented,146,109,93,29,64,5,11,37,9,3,10,11,4
S01009378,Rented or living rent free: Private rented or living rent free,37,29,24,6,18,3,2,8,0,3,2,2,1
S01009379,All HRPs aged 16 and over,337,290,246,17,229,32,12,47,23,3,5,9,7
S01009379,Owned: Total,245,225,194,7,187,27,4,20,18,0,0,1,1
S01009379,Owned: Owned outright,31,18,12,2,10,5,1,13,12,0,0,1,0
S01009379,Owned: Owned with a mortgage or loan or shared ownership,214,207,182,5,177,22,3,7,6,0,0,0,1
S01009379,Rented or living rent free: Total,92,65,52,10,42,5,8,27,5,3,5,8,6
S01009379,Rented or living rent free: Social rented,66,44,36,7,29,2,6,22,5,3,2,8,4
S01009379,Rented or living rent free: Private rented or living rent free,26,21,16,3,13,3,2,5,0,0,3,0,2
S01009380,All HRPs aged 16 and over,200,173,158,12,146,10,5,27,14,1,5,5,2
S01009380,Owned: Total,146,130,119,8,111,9,2,16,11,0,2,2,1
S01009380,Owned: Owned outright,30,22,19,3,16,3,0,8,6,0,2,0,0
S01009380,Owned: Owned with a mortgage or loan or shared ownership,116,108,100,5,95,6,2,8,5,0,0,2,1
S01009380,Rented or living rent free: Total,54,43,39,4,35,1,3,11,3,1,3,3,1
S01009380,Rented or living rent free: Social rented,9,4,3,1,2,0,1,5,0,0,2,2,1
S01009380,Rented or living rent free: Private rented or living rent free,45,39,36,3,33,1,2,6,3,1,1,1,0
S01009381,All HRPs aged 16 and over,284,221,189,26,163,24,8,63,51,3,1,6,2
S01009381,Owned: Total,209,161,142,17,125,18,1,48,43,1,0,3,1
S01009381,Owned: Owned outright,73,34,27,8,19,7,0,39,38,0,0,1,0
S01009381,Owned: Owned with a mortgage or loan or shared ownership,136,127,115,9,106,11,1,9,5,1,0,2,1
S01009381,Rented or living rent free: Total,75,60,47,9,38,6,7,15,8,2,1,3,1
S01009381,Rented or living rent free: Social rented,22,15,10,3,7,3,2,7,3,1,0,2,1
S01009381,Rented or living rent free: Private rented or living rent free,53,45,37,6,31,3,5,8,5,1,1,1,0
S01009382,All HRPs aged 16 and over,377,221,188,28,160,19,14,156,131,2,4,14,5
S01009382,Owned: Total,206,138,124,11,113,14,0,68,63,0,0,5,0
S01009382,Owned: Owned outright,84,29,23,3,20,6,0,55,51,0,0,4,0
S01009382,Owned: Owned with a mortgage or loan or shared ownership,122,109,101,8,93,8,0,13,12,0,0,1,0
S01009382,Rented or living rent free: Total,171,83,64,17,47,5,14,88,68,2,4,9,5
S01009382,Rented or living rent free: Social rented,131,57,45,13,32,5,7,74,59,0,3,7,5
S01009382,Rented or living rent free: Private rented or living rent free,40,26,19,4,15,0,7,14,9,2,1,2,0
S01009383,All HRPs aged 16 and over,439,312,253,39,214,31,28,127,89,2,5,17,14
S01009383,Owned: Total,234,169,143,10,133,21,5,65,57,1,0,4,3
S01009383,Owned: Owned outright,83,29,25,2,23,3,1,54,50,0,0,2,2
S01009383,Owned: Owned with a mortgage or loan or shared ownership,151,140,118,8,110,18,4,11,7,1,0,2,1
S01009383,Rented or living rent free: Total,205,143,110,29,81,10,23,62,32,1,5,13,11
S01009383,Rented or living rent free: Social rented,105,61,49,16,33,4,8,44,20,1,4,12,7
S01009383,Rented or living rent free: Private rented or living rent free,100,82,61,13,48,6,15,18,12,0,1,1,4
S01009384,All HRPs aged 16 and over,248,177,133,18,115,40,4,71,65,0,2,3,1
S01009384,Owned: Total,206,144,107,13,94,33,4,62,60,0,1,1,0
S01009384,Owned: Owned outright,106,49,33,8,25,15,1,57,56,0,1,0,0
S01009384,Owned: Owned with a mortgage or loan or shared ownership,100,95,74,5,69,18,3,5,4,0,0,1,0
S01009384,Rented or living rent free: Total,42,33,26,5,21,7,0,9,5,0,1,2,1
S01009384,Rented or living rent free: Social rented,15,7,7,4,3,0,0,8,4,0,1,2,1
S01009384,Rented or living rent free: Private rented or living rent free,27,26,19,1,18,7,0,1,1,0,0,0,0
S01009385,All HRPs aged 16 and over,220,158,126,22,104,26,6,62,56,0,3,2,1
S01009385,Owned: Total,174,127,103,17,86,22,2,47,47,0,0,0,0
S01009385,Owned: Owned outright,79,38,27,10,17,10,1,41,41,0,0,0,0
S01009385,Owned: Owned with a mortgage or loan or shared ownership,95,89,76,7,69,12,1,6,6,0,0,0,0
S01009385,Rented or living rent free: Total,46,31,23,5,18,4,4,15,9,0,3,2,1
S01009385,Rented or living rent free: Social rented,25,16,12,5,7,3,1,9,6,0,2,1,0
S01009385,Rented or living rent free: Private rented or living rent free,21,15,11,0,11,1,3,6,3,0,1,1,1
S01009386,All HRPs aged 16 and over,279,181,158,30,128,14,9,98,81,2,5,5,5
S01009386,Owned: Total,205,135,125,20,105,9,1,70,65,1,0,1,3
S01009386,Owned: Owned outright,95,32,30,13,17,2,0,63,60,0,0,1,2
S01009386,Owned: Owned with a mortgage or loan or shared ownership,110,103,95,7,88,7,1,7,5,1,0,0,1
S01009386,Rented or living rent free: Total,74,46,33,10,23,5,8,28,16,1,5,4,2
S01009386,Rented or living rent free: Social rented,61,38,26,8,18,4,8,23,14,0,3,4,2
S01009386,Rented or living rent free: Private rented or living rent free,13,8,7,2,5,1,0,5,2,1,2,0,0
S01009387,All HRPs aged 16 and over,260,167,137,26,111,13,17,93,68,3,9,11,2
S01009387,Owned: Total,143,95,86,10,76,6,3,48,46,0,2,0,0
S01009387,Owned: Owned outright,57,19,17,4,13,2,0,38,37,0,1,0,0
S01009387,Owned: Owned with a mortgage or loan or shared ownership,86,76,69,6,63,4,3,10,9,0,1,0,0
S01009387,Rented or living rent free: Total,117,72,51,16,35,7,14,45,22,3,7,11,2
S01009387,Rented or living rent free: Social rented,94,57,41,13,28,7,9,37,18,3,4,11,1
S01009387,Rented or living rent free: Private rented or living rent free,23,15,10,3,7,0,5,8,4,0,3,0,1
S01009388,All HRPs aged 16 and over,423,282,205,43,162,19,58,141,66,3,26,41,5
S01009388,Owned: Total,125,89,77,9,68,10,2,36,33,0,0,2,1
S01009388,Owned: Owned outright,45,17,14,6,8,2,1,28,26,0,0,2,0
S01009388,Owned: Owned with a mortgage or loan or shared ownership,80,72,63,3,60,8,1,8,7,0,0,0,1
S01009388,Rented or living rent free: Total,298,193,128,34,94,9,56,105,33,3,26,39,4
S01009388,Rented or living rent free: Social rented,243,146,87,27,60,7,52,97,30,2,25,36,4
S01009388,Rented or living rent free: Private rented or living rent free,55,47,41,7,34,2,4,8,3,1,1,3,0
S01009389,All HRPs aged 16 and over,460,295,241,29,212,43,11,165,140,3,4,15,3
S01009389,Owned: Total,296,196,161,20,141,33,2,100,94,1,2,2,1
S01009389,Owned: Owned outright,153,62,44,12,32,17,1,91,88,0,1,2,0
S01009389,Owned: Owned with a mortgage or loan or shared ownership,143,134,117,8,109,16,1,9,6,1,1,0,1
S01009389,Rented or living rent free: Total,164,99,80,9,71,10,9,65,46,2,2,13,2
S01009389,Rented or living rent free: Social rented,70,17,14,2,12,1,2,53,42,0,2,8,1
S01009389,Rented or living rent free: Private rented or living rent free,94,82,66,7,59,9,7,12,4,2,0,5,1
S01009390,All HRPs aged 16 and over,270,238,210,16,194,24,4,32,31,0,0,1,0
S01009390,Owned: Total,250,220,194,13,181,22,4,30,30,0,0,0,0
S01009390,Owned: Owned outright,59,33,28,6,22,4,1,26,26,0,0,0,0
S01009390,Owned: Owned with a mortgage or loan or shared ownership,191,187,166,7,159,18,3,4,4,0,0,0,0
S01009390,Rented or living rent free: Total,20,18,16,3,13,2,0,2,1,0,0,1,0
S01009390,Rented or living rent free: Social rented,1,0,0,0,0,0,0,1,0,0,0,1,0
S01009390,Rented or living rent free: Private rented or living rent free,19,18,16,3,13,2,0,1,1,0,0,0,0
S01009391,All HRPs aged 16 and over,259,235,209,14,195,24,2,24,16,0,1,3,4
S01009391,Owned: Total,234,214,188,12,176,24,2,20,16,0,0,2,2
S01009391,Owned: Owned outright,41,26,21,5,16,5,0,15,14,0,0,0,1
S01009391,Owned: Owned with a mortgage or loan or shared ownership,193,188,167,7,160,19,2,5,2,0,0,2,1
S01009391,Rented or living rent free: Total,25,21,21,2,19,0,0,4,0,0,1,1,2
S01009391,Rented or living rent free: Social rented,0,0,0,0,0,0,0,0,0,0,0,0,0
S01009391,Rented or living rent free: Private rented or living rent free,25,21,21,2,19,0,0,4,0,0,1,1,2
S01009392,All HRPs aged 16 and over,193,175,153,10,143,22,0,18,15,0,1,2,0
S01009392,Owned: Total,179,163,143,10,133,20,0,16,14,0,1,1,0
S01009392,Owned: Owned outright,34,20,16,3,13,4,0,14,12,0,1,1,0
S01009392,Owned: Owned with a mortgage or loan or shared ownership,145,143,127,7,120,16,0,2,2,0,0,0,0
S01009392,Rented or living rent free: Total,14,12,10,0,10,2,0,2,1,0,0,1,0
S01009392,Rented or living rent free: Social rented,0,0,0,0,0,0,0,0,0,0,0,0,0
S01009392,Rented or living rent free: Private rented or living rent free,14,12,10,0,10,2,0,2,1,0,0,1,0
S01009393,All HRPs aged 16 and over,265,202,162,18,144,36,4,63,60,0,0,2,1
S01009393,Owned: Total,245,188,151,16,135,34,3,57,56,0,0,1,0
S01009393,Owned: Owned outright,106,53,42,9,33,11,0,53,52,0,0,1,0
S01009393,Owned: Owned with a mortgage or loan or shared ownership,139,135,109,7,102,23,3,4,4,0,0,0,0
S01009393,Rented or living rent free: Total,20,14,11,2,9,2,1,6,4,0,0,1,1
S01009393,Rented or living rent free: Social rented,4,1,0,0,0,0,1,3,2,0,0,1,0
S01009393,Rented or living rent free: Private rented or living rent free,16,13,11,2,9,2,0,3,2,0,0,0,1
S01009394,All HRPs aged 16 and over,451,320,272,25,247,36,12,131,118,4,5,3,1
S01009394,Owned: Total,316,211,175,13,162,27,9,105,103,1,0,1,0
S01009394,Owned: Owned outright,140,52,40,8,32,10,2,88,87,1,0,0,0
S01009394,Owned: Owned with a mortgage or loan or shared ownership,176,159,135,5,130,17,7,17,16,0,0,1,0
S01009394,Rented or living rent free: Total,135,109,97,12,85,9,3,26,15,3,5,2,1
S01009394,Rented or living rent free: Social rented,5,3,3,1,2,0,0,2,1,0,0,1,0
S01009394,Rented or living rent free: Private rented or living rent free,130,106,94,11,83,9,3,24,14,3,5,1,1
S01009395,All HRPs aged 16 and over,305,162,132,14,118,27,3,143,142,0,1,0,0
S01009395,Owned: Total,293,154,125,12,113,26,3,139,139,0,0,0,0
S01009395,Owned: Owned outright,175,48,34,5,29,12,2,127,127,0,0,0,0
S01009395,Owned: Owned with a mortgage or loan or shared ownership,118,106,91,7,84,14,1,12,12,0,0,0,0
S01009395,Rented or living rent free: Total,12,8,7,2,5,1,0,4,3,0,1,0,0
S01009395,Rented or living rent free: Social rented,1,1,1,1,0,0,0,0,0,0,0,0,0
S01009395,Rented or living rent free: Private rented or living rent free,11,7,6,1,5,1,0,4,3,0,1,0,0
S01009396,All HRPs aged 16 and over,301,191,145,12,133,43,3,110,106,0,3,1,0
S01009396,Owned: Total,281,173,134,10,124,37,2,108,105,0,3,0,0
S01009396,Owned: Owned outright,170,67,50,5,45,17,0,103,101,0,2,0,0
S01009396,Owned: Owned with a mortgage or loan or shared ownership,111,106,84,5,79,20,2,5,4,0,1,0,0
S01009396,Rented or living rent free: Total,20,18,11,2,9,6,1,2,1,0,0,1,0
S01009396,Rented or living rent free: Social rented,3,3,2,1,1,1,0,0,0,0,0,0,0
S01009396,Rented or living rent free: Private rented or living rent free,17,15,9,1,8,5,1,2,1,0,0,1,0
S01009397,All HRPs aged 16 and over,330,230,188,32,156,29,13,100,93,0,1,3,3
S01009397,Owned: Total,284,194,163,29,134,25,6,90,85,0,1,2,2
S01009397,Owned: Owned outright,126,56,48,18,30,7,1,70,68,0,1,1,0
S01009397,Owned: Owned with a mortgage or loan or shared ownership,158,138,115,11,104,18,5,20,17,0,0,1,2
S01009397,Rented or living rent free: Total,46,36,25,3,22,4,7,10,8,0,0,1,1
S01009397,Rented or living rent free: Social rented,2,1,0,0,0,0,1,1,1,0,0,0,0
S01009397,Rented or living rent free: Private rented or living rent free,44,35,25,3,22,4,6,9,7,0,0,1,1
S01009398,All HRPs aged 16 and over,308,240,208,30,178,25,7,68,58,0,2,7,1
S01009398,Owned: Total,251,201,173,20,153,23,5,50,47,0,0,2,1
S01009398,Owned: Owned outright,84,45,37,10,27,5,3,39,38,0,0,1,0
S01009398,Owned: Owned with a mortgage or loan or shared ownership,167,156,136,10,126,18,2,11,9,0,0,1,1
S01009398,Rented or living rent free: Total,57,39,35,10,25,2,2,18,11,0,2,5,0
S01009398,Rented or living rent free: Social rented,4,1,1,0,1,0,0,3,3,0,0,0,0
S01009398,Rented or living rent free: Private rented or living rent free,53,38,34,10,24,2,2,15,8,0,2,5,0
S01009399,All HRPs aged 16 and over,311,210,176,18,158,27,7,101,96,2,2,0,1
S01009399,Owned: Total,270,183,154,11,143,24,5,87,86,1,0,0,0
S01009399,Owned: Owned outright,133,58,48,4,44,9,1,75,74,1,0,0,0
S01009399,Owned: Owned with a mortgage or loan or shared ownership,137,125,106,7,99,15,4,12,12,0,0,0,0
S01009399,Rented or living rent free: Total,41,27,22,7,15,3,2,14,10,1,2,0,1
S01009399,Rented or living rent free: Social rented,11,6,5,0,5,0,1,5,2,0,2,0,1
S01009399,Rented or living rent free: Private rented or living rent free,30,21,17,7,10,3,1,9,8,1,0,0,0
S01009400,All HRPs aged 16 and over,221,142,124,24,100,15,3,79,70,0,2,5,2
S01009400,Owned: Total,184,122,106,17,89,14,2,62,57,0,2,2,1
S01009400,Owned: Owned outright,79,29,22,6,16,5,2,50,49,0,0,1,0
S01009400,Owned: Owned with a mortgage or loan or shared ownership,105,93,84,11,73,9,0,12,8,0,2,1,1
S01009400,Rented or living rent free: Total,37,20,18,7,11,1,1,17,13,0,0,3,1
S01009400,Rented or living rent free: Social rented,22,10,9,4,5,1,0,12,9,0,0,2,1
S01009400,Rented or living rent free: Private rented or living rent free,15,10,9,3,6,0,1,5,4,0,0,1,0
S01009401,All HRPs aged 16 and over,284,161,141,22,119,18,2,123,120,1,0,2,0
S01009401,Owned: Total,263,148,131,19,112,17,0,115,113,1,0,1,0
S01009401,Owned: Owned outright,158,52,40,9,31,12,0,106,106,0,0,0,0
S01009401,Owned: Owned with a mortgage or loan or shared ownership,105,96,91,10,81,5,0,9,7,1,0,1,0
S01009401,Rented or living rent free: Total,21,13,10,3,7,1,2,8,7,0,0,1,0
S01009401,Rented or living rent free: Social rented,8,3,2,0,2,0,1,5,5,0,0,0,0
S01009401,Rented or living rent free: Private rented or living rent free,13,10,8,3,5,1,1,3,2,0,0,1,0
S01009402,All HRPs aged 16 and over,397,241,190,20,170,44,7,156,150,0,2,1,3
S01009402,Owned: Total,376,227,181,17,164,42,4,149,146,0,0,1,2
S01009402,Owned: Owned outright,194,65,46,7,39,17,2,129,128,0,0,1,0
S01009402,Owned: Owned with a mortgage or loan or shared ownership,182,162,135,10,125,25,2,20,18,0,0,0,2
S01009402,Rented or living rent free: Total,21,14,9,3,6,2,3,7,4,0,2,0,1
S01009402,Rented or living rent free: Social rented,2,1,1,1,0,0,0,1,1,0,0,0,0
S01009402,Rented or living rent free: Private rented or living rent free,19,13,8,2,6,2,3,6,3,0,2,0,1
S01009403,All HRPs aged 16 and over,206,159,142,19,123,14,3,47,43,0,0,2,2
S01009403,Owned: Total,176,140,126,10,116,12,2,36,34,0,0,0,2
S01009403,Owned: Owned outright,57,26,23,3,20,2,1,31,29,0,0,0,2
S01009403,Owned: Owned with a mortgage or loan or shared ownership,119,114,103,7,96,10,1,5,5,0,0,0,0
S01009403,Rented or living rent free: Total,30,19,16,9,7,2,1,11,9,0,0,2,0
S01009403,Rented or living rent free: Social rented,18,10,8,4,4,1,1,8,7,0,0,1,0
S01009403,Rented or living rent free: Private rented or living rent free,12,9,8,5,3,1,0,3,2,0,0,1,0
S01009404,All HRPs aged 16 and over,232,147,112,16,96,21,14,85,46,4,13,20,2
S01009404,Owned: Total,124,85,68,7,61,15,2,39,33,0,0,6,0
S01009404,Owned: Owned outright,47,21,12,2,10,7,2,26,25,0,0,1,0
S01009404,Owned: Owned with a mortgage or loan or shared ownership,77,64,56,5,51,8,0,13,8,0,0,5,0
S01009404,Rented or living rent free: Total,108,62,44,9,35,6,12,46,13,4,13,14,2
S01009404,Rented or living rent free: Social rented,78,39,27,7,20,5,7,39,11,2,11,13,2
S01009404,Rented or living rent free: Private rented or living rent free,30,23,17,2,15,1,5,7,2,2,2,1,0
S01009405,All HRPs aged 16 and over,157,112,82,6,76,28,2,45,43,0,1,1,0
S01009405,Owned: Total,138,102,74,6,68,26,2,36,36,0,0,0,0
S01009405,Owned: Owned outright,79,45,27,4,23,16,2,34,34,0,0,0,0
S01009405,Owned: Owned with a mortgage or loan or shared ownership,59,57,47,2,45,10,0,2,2,0,0,0,0
S01009405,Rented or living rent free: Total,19,10,8,0,8,2,0,9,7,0,1,1,0
S01009405,Rented or living rent free: Social rented,6,3,2,0,2,1,0,3,1,0,1,1,0
S01009405,Rented or living rent free: Private rented or living rent free,13,7,6,0,6,1,0,6,6,0,0,0,0
S01009406,All HRPs aged 16 and over,429,282,241,33,208,27,14,147,117,3,11,10,6
S01009406,Owned: Total,296,205,182,16,166,23,0,91,82,1,2,2,4
S01009406,Owned: Owned outright,127,52,45,5,40,7,0,75,73,0,0,1,1
S01009406,Owned: Owned with a mortgage or loan or shared ownership,169,153,137,11,126,16,0,16,9,1,2,1,3
S01009406,Rented or living rent free: Total,133,77,59,17,42,4,14,56,35,2,9,8,2
S01009406,Rented or living rent free: Social rented,80,36,27,10,17,1,8,44,29,2,5,6,2
S01009406,Rented or living rent free: Private rented or living rent free,53,41,32,7,25,3,6,12,6,0,4,2,0
S01009407,All HRPs aged 16 and over,227,152,117,11,106,27,8,75,63,0,2,8,2
S01009407,Owned: Total,175,123,99,7,92,23,1,52,50,0,0,2,0
S01009407,Owned: Owned outright,73,27,19,1,18,7,1,46,45,0,0,1,0
S01009407,Owned: Owned with a mortgage or loan or shared ownership,102,96,80,6,74,16,0,6,5,0,0,1,0
S01009407,Rented or living rent free: Total,52,29,18,4,14,4,7,23,13,0,2,6,2
S01009407,Rented or living rent free: Social rented,36,21,14,3,11,2,5,15,9,0,1,3,2
S01009407,Rented or living rent free: Private rented or living rent free,16,8,4,1,3,2,2,8,4,0,1,3,0
S01009408,All HRPs aged 16 and over,307,240,208,19,189,24,8,67,54,1,4,5,3
S01009408,Owned: Total,242,195,170,11,159,22,3,47,44,0,2,1,0
S01009408,Owned: Owned outright,81,43,33,9,24,10,0,38,38,0,0,0,0
S01009408,Owned: Owned with a mortgage or loan or shared ownership,161,152,137,2,135,12,3,9,6,0,2,1,0
S01009408,Rented or living rent free: Total,65,45,38,8,30,2,5,20,10,1,2,4,3
S01009408,Rented or living rent free: Social rented,27,12,10,2,8,1,1,15,9,1,2,2,1
S01009408,Rented or living rent free: Private rented or living rent free,38,33,28,6,22,1,4,5,1,0,0,2,2
S01009409,All HRPs aged 16 and over,308,182,151,35,116,15,16,126,106,1,5,8,6
S01009409,Owned: Total,206,131,113,19,94,13,5,75,70,0,0,4,1
S01009409,Owned: Owned outright,96,39,33,10,23,3,3,57,54,0,0,2,1
S01009409,Owned: Owned with a mortgage or loan or shared ownership,110,92,80,9,71,10,2,18,16,0,0,2,0
S01009409,Rented or living rent free: Total,102,51,38,16,22,2,11,51,36,1,5,4,5
S01009409,Rented or living rent free: Social rented,78,37,27,11,16,1,9,41,27,1,5,4,4
S01009409,Rented or living rent free: Private rented or living rent free,24,14,11,5,6,1,2,10,9,0,0,0,1
S01009410,All HRPs aged 16 and over,351,251,215,51,164,23,13,100,56,1,14,17,12
S01009410,Owned: Total,159,125,109,12,97,14,2,34,28,0,0,2,4
S01009410,Owned: Owned outright,60,32,27,7,20,4,1,28,25,0,0,0,3
S01009410,Owned: Owned with a mortgage or loan or shared ownership,99,93,82,5,77,10,1,6,3,0,0,2,1
S01009410,Rented or living rent free: Total,192,126,106,39,67,9,11,66,28,1,14,15,8
S01009410,Rented or living rent free: Social rented,165,109,91,35,56,7,11,56,24,1,10,13,8
S01009410,Rented or living rent free: Private rented or living rent free,27,17,15,4,11,2,0,10,4,0,4,2,0
S01009411,All HRPs aged 16 and over,364,225,181,29,152,27,17,139,97,0,12,23,7
S01009411,Owned: Total,201,144,125,11,114,17,2,57,51,0,2,3,1
S01009411,Owned: Owned outright,82,34,32,2,30,2,0,48,44,0,2,1,1
S01009411,Owned: Owned with a mortgage or loan or shared ownership,119,110,93,9,84,15,2,9,7,0,0,2,0
S01009411,Rented or living rent free: Total,163,81,56,18,38,10,15,82,46,0,10,20,6
S01009411,Rented or living rent free: Social rented,136,65,43,14,29,9,13,71,45,0,3,18,5
S01009411,Rented or living rent free: Private rented or living rent free,27,16,13,4,9,1,2,11,1,0,7,2,1
S01009412,All HRPs aged 16 and over,407,252,214,47,167,16,22,155,115,0,6,26,8
S01009412,Owned: Total,203,137,124,17,107,12,1,66,64,0,0,2,0
S01009412,Owned: Owned outright,87,34,32,9,23,1,1,53,52,0,0,1,0
S01009412,Owned: Owned with a mortgage or loan or shared ownership,116,103,92,8,84,11,0,13,12,0,0,1,0
S01009412,Rented or living rent free: Total,204,115,90,30,60,4,21,89,51,0,6,24,8
S01009412,Rented or living rent free: Social rented,186,103,78,28,50,4,21,83,47,0,6,23,7
S01009412,Rented or living rent free: Private rented or living rent free,18,12,12,2,10,0,0,6,4,0,0,1,1
S01009413,All HRPs aged 16 and over,456,293,240,32,208,37,16,163,131,1,3,22,6
S01009413,Owned: Total,311,216,182,17,165,33,1,95,89,0,1,2,3
S01009413,Owned: Owned outright,130,56,49,9,40,6,1,74,70,0,0,2,2
S01009413,Owned: Owned with a mortgage or loan or shared ownership,181,160,133,8,125,27,0,21,19,0,1,0,1
S01009413,Rented or living rent free: Total,145,77,58,15,43,4,15,68,42,1,2,20,3
S01009413,Rented or living rent free: Social rented,108,49,38,12,26,3,8,59,38,1,2,16,2
S01009413,Rented or living rent free: Private rented or living rent free,37,28,20,3,17,1,7,9,4,0,0,4,1
S01009414,All HRPs aged 16 and over,292,174,152,31,121,16,6,118,100,1,2,12,3
S01009414,Owned: Total,217,141,126,20,106,15,0,76,74,0,0,2,0
S01009414,Owned: Owned outright,86,29,26,7,19,3,0,57,57,0,0,0,0
S01009414,Owned: Owned with a mortgage or loan or shared ownership,131,112,100,13,87,12,0,19,17,0,0,2,0
S01009414,Rented or living rent free: Total,75,33,26,11,15,1,6,42,26,1,2,10,3
S01009414,Rented or living rent free: Social rented,63,22,18,7,11,0,4,41,26,1,1,10,3
S01009414,Rented or living rent free: Private rented or living rent free,12,11,8,4,4,1,2,1,0,0,1,0,0
S01009415,All HRPs aged 16 and over,386,234,172,24,148,29,33,152,105,1,8,31,7
S01009415,Owned: Total,216,149,118,13,105,24,7,67,63,0,1,2,1
S01009415,Owned: Owned outright,86,31,22,6,16,5,4,55,52,0,1,1,1
S01009415,Owned: Owned with a mortgage or loan or shared ownership,130,118,96,7,89,19,3,12,11,0,0,1,0
S01009415,Rented or living rent free: Total,170,85,54,11,43,5,26,85,42,1,7,29,6
S01009415,Rented or living rent free: Social rented,95,34,24,6,18,0,10,61,35,1,2,21,2
S01009415,Rented or living rent free: Private rented or living rent free,75,51,30,5,25,5,16,24,7,0,5,8,4
S01009416,All HRPs aged 16 and over,201,152,130,23,107,19,3,49,45,0,1,2,1
S01009416,Owned: Total,180,136,116,19,97,19,1,44,41,0,0,2,1
S01009416,Owned: Owned outright,80,40,37,15,22,2,1,40,38,0,0,2,0
S01009416,Owned: Owned with a mortgage or loan or shared ownership,100,96,79,4,75,17,0,4,3,0,0,0,1
S01009416,Rented or living rent free: Total,21,16,14,4,10,0,2,5,4,0,1,0,0
S01009416,Rented or living rent free: Social rented,15,12,10,4,6,0,2,3,3,0,0,0,0
S01009416,Rented or living rent free: Private rented or living rent free,6,4,4,0,4,0,0,2,1,0,1,0,0
S01009417,All HRPs aged 16 and over,114,99,71,4,67,26,2,15,11,0,1,3,0
S01009417,Owned: Total,86,78,56,2,54,22,0,8,7,0,0,1,0
S01009417,Owned: Owned outright,21,14,7,1,6,7,0,7,6,0,0,1,0
S01009417,Owned: Owned with a mortgage or loan or shared ownership,65,64,49,1,48,15,0,1,1,0,0,0,0
S01009417,Rented or living rent free: Total,28,21,15,2,13,4,2,7,4,0,1,2,0
S01009417,Rented or living rent free: Social rented,13,6,5,0,5,0,1,7,4,0,1,2,0
S01009417,Rented or living rent free: Private rented or living rent free,15,15,10,2,8,4,1,0,0,0,0,0,0
S01009418,All HRPs aged 16 and over,517,297,250,37,213,21,26,220,163,1,9,36,11
S01009418,Owned: Total,284,180,157,20,137,18,5,104,91,0,1,5,7
S01009418,Owned: Owned outright,120,34,29,7,22,2,3,86,79,0,0,3,4
S01009418,Owned: Owned with a mortgage or loan or shared ownership,164,146,128,13,115,16,2,18,12,0,1,2,3
S01009418,Rented or living rent free: Total,233,117,93,17,76,3,21,116,72,1,8,31,4
S01009418,Rented or living rent free: Social rented,161,67,53,13,40,1,13,94,62,0,2,26,4
S01009418,Rented or living rent free: Private rented or living rent free,72,50,40,4,36,2,8,22,10,1,6,5,0
S01009419,All HRPs aged 16 and over,245,148,126,23,103,12,10,97,68,3,6,15,5
S01009419,Owned: Total,138,91,79,6,73,10,2,47,41,1,1,4,0
S01009419,Owned: Owned outright,49,11,9,1,8,1,1,38,32,1,1,4,0
S01009419,Owned: Owned with a mortgage or loan or shared ownership,89,80,70,5,65,9,1,9,9,0,0,0,0
S01009419,Rented or living rent free: Total,107,57,47,17,30,2,8,50,27,2,5,11,5
S01009419,Rented or living rent free: Social rented,94,50,41,16,25,2,7,44,24,2,5,8,5
S01009419,Rented or living rent free: Private rented or living rent free,13,7,6,1,5,0,1,6,3,0,0,3,0
S01009420,All HRPs aged 16 and over,253,155,129,32,97,13,13,98,43,4,13,33,5
S01009420,Owned: Total,88,61,53,7,46,8,0,27,21,0,1,4,1
S01009420,Owned: Owned outright,37,19,14,3,11,5,0,18,16,0,0,1,1
S01009420,Owned: Owned with a mortgage or loan or shared ownership,51,42,39,4,35,3,0,9,5,0,1,3,0
S01009420,Rented or living rent free: Total,165,94,76,25,51,5,13,71,22,4,12,29,4
S01009420,Rented or living rent free: Social rented,153,89,72,25,47,5,12,64,21,0,10,29,4
S01009420,Rented or living rent free: Private rented or living rent free,12,5,4,0,4,0,1,7,1,4,2,0,0
S01009421,All HRPs aged 16 and over,295,189,151,33,118,12,26,106,66,3,15,12,10
S01009421,Owned: Total,142,93,80,10,70,8,5,49,44,2,1,1,1
S01009421,Owned: Owned outright,69,29,24,6,18,4,1,40,38,0,1,0,1
S01009421,Owned: Owned with a mortgage or loan or shared ownership,73,64,56,4,52,4,4,9,6,2,0,1,0
S01009421,Rented or living rent free: Total,153,96,71,23,48,4,21,57,22,1,14,11,9
S01009421,Rented or living rent free: Social rented,143,89,65,23,42,4,20,54,22,1,13,11,7
S01009421,Rented or living rent free: Private rented or living rent free,10,7,6,0,6,0,1,3,0,0,1,0,2
S01009422,All HRPs aged 16 and over,369,225,191,34,157,18,16,144,119,0,6,15,4
S01009422,Owned: Total,251,163,143,20,123,16,4,88,84,0,2,1,1
S01009422,Owned: Owned outright,115,39,31,6,25,6,2,76,74,0,0,1,1
S01009422,Owned: Owned with a mortgage or loan or shared ownership,136,124,112,14,98,10,2,12,10,0,2,0,0
S01009422,Rented or living rent free: Total,118,62,48,14,34,2,12,56,35,0,4,14,3
S01009422,Rented or living rent free: Social rented,92,43,33,12,21,1,9,49,28,0,4,14,3
S01009422,Rented or living rent free: Private rented or living rent free,26,19,15,2,13,1,3,7,7,0,0,0,0
S01009423,All HRPs aged 16 and over,336,294,262,13,249,29,3,42,34,1,1,5,1
S01009423,Owned: Total,302,270,241,8,233,27,2,32,30,0,1,0,1
S01009423,Owned: Owned outright,56,29,25,4,21,3,1,27,27,0,0,0,0
S01009423,Owned: Owned with a mortgage or loan or shared ownership,246,241,216,4,212,24,1,5,3,0,1,0,1
S01009423,Rented or living rent free: Total,34,24,21,5,16,2,1,10,4,1,0,5,0
S01009423,Rented or living rent free: Social rented,10,6,4,0,4,1,1,4,1,0,0,3,0
S01009423,Rented or living rent free: Private rented or living rent free,24,18,17,5,12,1,0,6,3,1,0,2,0
S01009424,All HRPs aged 16 and over,250,165,139,21,118,19,7,85,73,2,3,6,1
S01009424,Owned: Total,180,122,106,15,91,15,1,58,55,0,0,2,1
S01009424,Owned: Owned outright,70,25,23,7,16,1,1,45,43,0,0,1,1
S01009424,Owned: Owned with a mortgage or loan or shared ownership,110,97,83,8,75,14,0,13,12,0,0,1,0
S01009424,Rented or living rent free: Total,70,43,33,6,27,4,6,27,18,2,3,4,0
S01009424,Rented or living rent free: Social rented,50,27,22,6,16,1,4,23,17,1,1,4,0
S01009424,Rented or living rent free: Private rented or living rent free,20,16,11,0,11,3,2,4,1,1,2,0,0
S01009425,All HRPs aged 16 and over,372,218,177,17,160,16,25,154,123,1,7,19,4
S01009425,Owned: Total,250,141,125,4,121,14,2,109,101,0,0,7,1
S01009425,Owned: Owned outright,134,39,34,3,31,5,0,95,92,0,0,3,0
S01009425,Owned: Owned with a mortgage or loan or shared ownership,116,102,91,1,90,9,2,14,9,0,0,4,1
S01009425,Rented or living rent free: Total,122,77,52,13,39,2,23,45,22,1,7,12,3
S01009425,Rented or living rent free: Social rented,84,49,29,9,20,2,18,35,17,0,6,10,2
S01009425,Rented or living rent free: Private rented or living rent free,38,28,23,4,19,0,5,10,5,1,1,2,1
S01009426,All HRPs aged 16 and over,415,231,187,46,141,19,25,184,127,1,9,36,11
S01009426,Owned: Total,172,108,94,18,76,12,2,64,59,0,1,2,2
S01009426,Owned: Owned outright,72,21,20,5,15,1,0,51,48,0,0,1,2
S01009426,Owned: Owned with a mortgage or loan or shared ownership,100,87,74,13,61,11,2,13,11,0,1,1,0
S01009426,Rented or living rent free: Total,243,123,93,28,65,7,23,120,68,1,8,34,9
S01009426,Rented or living rent free: Social rented,199,92,71,27,44,3,18,107,63,0,7,30,7
S01009426,Rented or living rent free: Private rented or living rent free,44,31,22,1,21,4,5,13,5,1,1,4,2
S01009427,All HRPs aged 16 and over,326,175,137,38,99,15,23,151,109,2,7,27,6
S01009427,Owned: Total,150,93,81,17,64,10,2,57,51,1,2,3,0
S01009427,Owned: Owned outright,65,16,14,7,7,2,0,49,45,1,2,1,0
S01009427,Owned: Owned with a mortgage or loan or shared ownership,85,77,67,10,57,8,2,8,6,0,0,2,0
S01009427,Rented or living rent free: Total,176,82,56,21,35,5,21,94,58,1,5,24,6
S01009427,Rented or living rent free: Social rented,148,65,45,19,26,2,18,83,50,1,4,22,6
S01009427,Rented or living rent free: Private rented or living rent free,28,17,11,2,9,3,3,11,8,0,1,2,0
S01009428,All HRPs aged 16 and over,235,151,121,25,96,18,12,84,45,3,9,20,7
S01009428,Owned: Total,143,107,92,14,78,12,3,36,31,0,1,2,2
S01009428,Owned: Owned outright,56,28,22,4,18,3,3,28,27,0,0,0,1
S01009428,Owned: Owned with a mortgage or loan or shared ownership,87,79,70,10,60,9,0,8,4,0,1,2,1
S01009428,Rented or living rent free: Total,92,44,29,11,18,6,9,48,14,3,8,18,5
S01009428,Rented or living rent free: Social rented,79,36,23,10,13,5,8,43,13,3,6,17,4
S01009428,Rented or living rent free: Private rented or living rent free,13,8,6,1,5,1,1,5,1,0,2,1,1
S01009429,All HRPs aged 16 and over,341,173,150,28,122,6,17,168,116,3,15,27,7
S01009429,Owned: Total,142,92,87,11,76,3,2,50,49,0,0,0,1
S01009429,Owned: Owned outright,74,31,29,4,25,1,1,43,43,0,0,0,0
S01009429,Owned: Owned with a mortgage or loan or shared ownership,68,61,58,7,51,2,1,7,6,0,0,0,1
S01009429,Rented or living rent free: Total,199,81,63,17,46,3,15,118,67,3,15,27,6
S01009429,Rented or living rent free: Social rented,174,66,53,16,37,2,11,108,61,3,13,26,5
S01009429,Rented or living rent free: Private rented or living rent free,25,15,10,1,9,1,4,10,6,0,2,1,1
S01009430,All HRPs aged 16 and over,338,197,160,37,123,18,19,141,99,4,11,19,8
S01009430,Owned: Total,168,111,96,16,80,14,1,57,54,0,1,2,0
S01009430,Owned: Owned outright,82,36,28,4,24,7,1,46,43,0,1,2,0
S01009430,Owned: Owned with a mortgage or loan or shared ownership,86,75,68,12,56,7,0,11,11,0,0,0,0
S01009430,Rented or living rent free: Total,170,86,64,21,43,4,18,84,45,4,10,17,8
S01009430,Rented or living rent free: Social rented,133,64,46,18,28,2,16,69,37,4,7,14,7
S01009430,Rented or living rent free: Private rented or living rent free,37,22,18,3,15,2,2,15,8,0,3,3,1
S01009431,All HRPs aged 16 and over,330,189,147,20,127,23,19,141,90,1,11,35,4
S01009431,Owned: Total,179,116,99,9,90,15,2,63,56,0,2,5,0
S01009431,Owned: Owned outright,100,43,33,4,29,9,1,57,51,0,2,4,0
S01009431,Owned: Owned with a mortgage or loan or shared ownership,79,73,66,5,61,6,1,6,5,0,0,1,0
S01009431,Rented or living rent free: Total,151,73,48,11,37,8,17,78,34,1,9,30,4
S01009431,Rented or living rent free: Social rented,106,46,27,6,21,5,14,60,26,1,6,23,4
S01009431,Rented or living rent free: Private rented or living rent free,45,27,21,5,16,3,3,18,8,0,3,7,0
S01009432,All HRPs aged 16 and over,321,195,161,48,113,12,22,126,68,5,12,32,9
S01009432,Owned: Total,125,85,76,12,64,7,2,40,35,0,1,4,0
S01009432,Owned: Owned outright,49,17,13,4,9,2,2,32,29,0,1,2,0
S01009432,Owned: Owned with a mortgage or loan or shared ownership,76,68,63,8,55,5,0,8,6,0,0,2,0
S01009432,Rented or living rent free: Total,196,110,85,36,49,5,20,86,33,5,11,28,9
S01009432,Rented or living rent free: Social rented,179,97,77,32,45,4,16,82,33,5,9,26,9
S01009432,Rented or living rent free: Private rented or living rent free,17,13,8,4,4,1,4,4,0,0,2,2,0
S01009433,All HRPs aged 16 and over,330,186,153,39,114,12,21,144,82,1,13,39,9
S01009433,Owned: Total,143,98,86,14,72,10,2,45,36,0,0,7,2
S01009433,Owned: Owned outright,44,16,14,5,9,2,0,28,24,0,0,4,0
S01009433,Owned: Owned with a mortgage or loan or shared ownership,99,82,72,9,63,8,2,17,12,0,0,3,2
S01009433,Rented or living rent free: Total,187,88,67,25,42,2,19,99,46,1,13,32,7
S01009433,Rented or living rent free: Social rented,168,75,57,22,35,2,16,93,43,1,10,32,7
S01009433,Rented or living rent free: Private rented or living rent free,19,13,10,3,7,0,3,6,3,0,3,0,0
S01009434,All HRPs aged 16 and over,248,133,105,22,83,12,16,115,78,1,7,20,9
S01009434,Owned: Total,122,74,63,8,55,9,2,48,45,0,0,2,1
S01009434,Owned: Owned outright,61,17,15,1,14,1,1,44,41,0,0,2,1
S01009434,Owned: Owned with a mortgage or loan or shared ownership,61,57,48,7,41,8,1,4,4,0,0,0,0
S01009434,Rented or living rent free: Total,126,59,42,14,28,3,14,67,33,1,7,18,8
S01009434,Rented or living rent free: Social rented,112,56,40,13,27,3,13,56,26,1,4,17,8
S01009434,Rented or living rent free: Private rented or living rent free,14,3,2,1,1,0,1,11,7,0,3,1,0
S01009435,All HRPs aged 16 and over,347,198,142,37,105,17,39,149,73,5,19,37,15
S01009435,Owned: Total,97,62,56,10,46,4,2,35,32,0,0,1,2
S01009435,Owned: Owned outright,42,15,15,1,14,0,0,27,26,0,0,0,1
S01009435,Owned: Owned with a mortgage or loan or shared ownership,55,47,41,9,32,4,2,8,6,0,0,1,1
S01009435,Rented or living rent free: Total,250,136,86,27,59,13,37,114,41,5,19,36,13
S01009435,Rented or living rent free: Social rented,236,125,82,26,56,9,34,111,39,5,19,35,13
S01009435,Rented or living rent free: Private rented or living rent free,14,11,4,1,3,4,3,3,2,0,0,1,0
S01009436,All HRPs aged 16 and over,298,202,171,30,141,15,16,96,66,2,8,14,6
S01009436,Owned: Total,160,116,107,14,93,6,3,44,41,0,0,2,1
S01009436,Owned: Owned outright,63,29,25,5,20,4,0,34,32,0,0,1,1
S01009436,Owned: Owned with a mortgage or loan or shared ownership,97,87,82,9,73,2,3,10,9,0,0,1,0
S01009436,Rented or living rent free: Total,138,86,64,16,48,9,13,52,25,2,8,12,5
S01009436,Rented or living rent free: Social rented,116,69,52,14,38,7,10,47,24,2,5,12,4
S01009436,Rented or living rent free: Private rented or living rent free,22,17,12,2,10,2,3,5,1,0,3,0,1
S01009437,All HRPs aged 16 and over,318,186,146,16,130,25,15,132,109,1,1,16,5
S01009437,Owned: Total,186,124,104,9,95,19,1,62,57,0,0,4,1
S01009437,Owned: Owned outright,64,22,18,3,15,4,0,42,42,0,0,0,0
S01009437,Owned: Owned with a mortgage or loan or shared ownership,122,102,86,6,80,15,1,20,15,0,0,4,1
S01009437,Rented or living rent free: Total,132,62,42,7,35,6,14,70,52,1,1,12,4
S01009437,Rented or living rent free: Social rented,108,46,32,7,25,4,10,62,45,1,1,11,4
S01009437,Rented or living rent free: Private rented or living rent free,24,16,10,0,10,2,4,8,7,0,0,1,0
S01009438,All HRPs aged 16 and over,410,209,170,24,146,26,13,201,139,2,11,38,11
S01009438,Owned: Total,187,120,98,10,88,20,2,67,62,0,1,3,1
S01009438,Owned: Owned outright,86,30,25,5,20,4,1,56,53,0,0,2,1
S01009438,Owned: Owned with a mortgage or loan or shared ownership,101,90,73,5,68,16,1,11,9,0,1,1,0
S01009438,Rented or living rent free: Total,223,89,72,14,58,6,11,134,77,2,10,35,10
S01009438,Rented or living rent free: Social rented,206,76,62,14,48,5,9,130,75,2,9,34,10
S01009438,Rented or living rent free: Private rented or living rent free,17,13,10,0,10,1,2,4,2,0,1,1,0
S01009439,All HRPs aged 16 and over,386,224,185,32,153,15,24,162,107,4,14,30,7
S01009439,Owned: Total,168,118,108,15,93,8,2,50,46,0,1,2,1
S01009439,Owned: Owned outright,66,27,26,7,19,0,1,39,39,0,0,0,0
S01009439,Owned: Owned with a mortgage or loan or shared ownership,102,91,82,8,74,8,1,11,7,0,1,2,1
S01009439,Rented or living rent free: Total,218,106,77,17,60,7,22,112,61,4,13,28,6
S01009439,Rented or living rent free: Social rented,203,97,72,14,58,5,20,106,60,4,11,27,4
S01009439,Rented or living rent free: Private rented or living rent free,15,9,5,3,2,2,2,6,1,0,2,1,2
S01009440,All HRPs aged 16 and over,328,180,143,38,105,17,20,148,106,1,8,26,7
S01009440,Owned: Total,145,86,73,13,60,11,2,59,56,0,1,2,0
S01009440,Owned: Owned outright,67,19,15,6,9,3,1,48,46,0,1,1,0
S01009440,Owned: Owned with a mortgage or loan or shared ownership,78,67,58,7,51,8,1,11,10,0,0,1,0
S01009440,Rented or living rent free: Total,183,94,70,25,45,6,18,89,50,1,7,24,7
S01009440,Rented or living rent free: Social rented,158,76,57,17,40,3,16,82,47,1,7,20,7
S01009440,Rented or living rent free: Private rented or living rent free,25,18,13,8,5,3,2,7,3,0,0,4,0
S01009441,All HRPs aged 16 and over,370,240,202,57,145,17,21,130,79,3,17,24,7
S01009441,Owned: Total,109,71,65,6,59,4,2,38,37,0,0,1,0
S01009441,Owned: Owned outright,49,14,12,2,10,1,1,35,34,0,0,1,0
S01009441,Owned: Owned with a mortgage or loan or shared ownership,60,57,53,4,49,3,1,3,3,0,0,0,0
S01009441,Rented or living rent free: Total,261,169,137,51,86,13,19,92,42,3,17,23,7
S01009441,Rented or living rent free: Social rented,237,160,131,49,82,11,18,77,37,1,13,20,6
S01009441,Rented or living rent free: Private rented or living rent free,24,9,6,2,4,2,1,15,5,2,4,3,1
S01009442,All HRPs aged 16 and over,216,172,128,13,115,39,5,44,27,3,4,8,2
S01009442,Owned: Total,162,132,103,8,95,27,2,30,24,0,2,2,2
S01009442,Owned: Owned outright,61,36,23,3,20,12,1,25,21,0,1,2,1
S01009442,Owned: Owned with a mortgage or loan or shared ownership,101,96,80,5,75,15,1,5,3,0,1,0,1
S01009442,Rented or living rent free: Total,54,40,25,5,20,12,3,14,3,3,2,6,0
S01009442,Rented or living rent free: Social rented,10,5,5,2,3,0,0,5,0,1,0,4,0
S01009442,Rented or living rent free: Private rented or living rent free,44,35,20,3,17,12,3,9,3,2,2,2,0
S01009443,All HRPs aged 16 and over,288,198,151,24,127,35,12,90,71,0,4,13,2
S01009443,Owned: Total,203,151,117,11,106,30,4,52,49,0,0,2,1
S01009443,Owned: Owned outright,86,42,25,4,21,15,2,44,41,0,0,2,1
S01009443,Owned: Owned with a mortgage or loan or shared ownership,117,109,92,7,85,15,2,8,8,0,0,0,0
S01009443,Rented or living rent free: Total,85,47,34,13,21,5,8,38,22,0,4,11,1
S01009443,Rented or living rent free: Social rented,49,23,17,9,8,1,5,26,16,0,0,10,0
S01009443,Rented or living rent free: Private rented or living rent free,36,24,17,4,13,4,3,12,6,0,4,1,1
S01009444,All HRPs aged 16 and over,305,237,207,22,185,28,2,68,58,0,6,3,1
S01009444,Owned: Total,271,220,190,17,173,28,2,51,48,0,1,1,1
S01009444,Owned: Owned outright,105,61,51,12,39,9,1,44,42,0,0,1,1
S01009444,Owned: Owned with a mortgage or loan or shared ownership,166,159,139,5,134,19,1,7,6,0,1,0,0
S01009444,Rented or living rent free: Total,34,17,17,5,12,0,0,17,10,0,5,2,0
S01009444,Rented or living rent free: Social rented,18,8,8,3,5,0,0,10,7,0,1,2,0
S01009444,Rented or living rent free: Private rented or living rent free,16,9,9,2,7,0,0,7,3,0,4,0,0
S01009445,All HRPs aged 16 and over,320,197,173,31,142,20,4,123,91,0,8,19,5
S01009445,Owned: Total,212,137,123,15,108,13,1,75,63,0,3,8,1
S01009445,Owned: Owned outright,90,29,26,7,19,3,0,61,53,0,2,6,0
S01009445,Owned: Owned with a mortgage or loan or shared ownership,122,108,97,8,89,10,1,14,10,0,1,2,1
S01009445,Rented or living rent free: Total,108,60,50,16,34,7,3,48,28,0,5,11,4
S01009445,Rented or living rent free: Social rented,94,50,41,14,27,6,3,44,26,0,4,11,3
S01009445,Rented or living rent free: Private rented or living rent free,14,10,9,2,7,1,0,4,2,0,1,0,1
S01009446,All HRPs aged 16 and over,471,259,197,37,160,18,44,212,140,4,7,49,12
S01009446,Owned: Total,179,115,101,12,89,12,2,64,58,1,0,3,2
S01009446,Owned: Owned outright,79,23,17,5,12,6,0,56,52,0,0,2,2
S01009446,Owned: Owned with a mortgage or loan or shared ownership,100,92,84,7,77,6,2,8,6,1,0,1,0
S01009446,Rented or living rent free: Total,292,144,96,25,71,6,42,148,82,3,7,46,10
S01009446,Rented or living rent free: Social rented,239,110,72,18,54,2,36,129,76,2,4,37,10
S01009446,Rented or living rent free: Private rented or living rent free,53,34,24,7,17,4,6,19,6,1,3,9,0
S01009447,All HRPs aged 16 and over,238,151,117,23,94,16,18,87,61,1,6,14,5
S01009447,Owned: Total,135,97,83,13,70,13,1,38,35,0,1,1,1
S01009447,Owned: Owned outright,62,27,17,4,13,9,1,35,32,0,1,1,1
S01009447,Owned: Owned with a mortgage or loan or shared ownership,73,70,66,9,57,4,0,3,3,0,0,0,0
S01009447,Rented or living rent free: Total,103,54,34,10,24,3,17,49,26,1,5,13,4
S01009447,Rented or living rent free: Social rented,78,37,25,7,18,2,10,41,21,1,4,13,2
S01009447,Rented or living rent free: Private rented or living rent free,25,17,9,3,6,1,7,8,5,0,1,0,2
S01009448,All HRPs aged 16 and over,343,240,206,26,180,23,11,103,75,2,4,20,2
S01009448,Owned: Total,247,189,166,12,154,21,2,58,53,0,0,5,0
S01009448,Owned: Owned outright,92,40,39,7,32,1,0,52,47,0,0,5,0
S01009448,Owned: Owned with a mortgage or loan or shared ownership,155,149,127,5,122,20,2,6,6,0,0,0,0
S01009448,Rented or living rent free: Total,96,51,40,14,26,2,9,45,22,2,4,15,2
S01009448,Rented or living rent free: Social rented,71,36,27,10,17,2,7,35,17,2,3,11,2
S01009448,Rented or living rent free: Private rented or living rent free,25,15,13,4,9,0,2,10,5,0,1,4,0
S01009449,All HRPs aged 16 and over,231,124,105,21,84,15,4,107,76,3,5,17,6
S01009449,Owned: Total,150,86,71,14,57,15,0,64,56,1,0,3,4
S01009449,Owned: Owned outright,80,23,21,9,12,2,0,57,49,1,0,3,4
S01009449,Owned: Owned with a mortgage or loan or shared ownership,70,63,50,5,45,13,0,7,7,0,0,0,0
S01009449,Rented or living rent free: Total,81,38,34,7,27,0,4,43,20,2,5,14,2
S01009449,Rented or living rent free: Social rented,60,23,21,5,16,0,2,37,16,2,4,13,2
S01009449,Rented or living rent free: Private rented or living rent free,21,15,13,2,11,0,2,6,4,0,1,1,0
S01009450,All HRPs aged 16 and over,307,184,143,42,101,14,27,123,72,1,12,24,14
S01009450,Owned: Total,103,67,58,4,54,8,1,36,34,0,0,2,0
S01009450,Owned: Owned outright,43,14,11,1,10,3,0,29,28,0,0,1,0
S01009450,Owned: Owned with a mortgage or loan or shared ownership,60,53,47,3,44,5,1,7,6,0,0,1,0
S01009450,Rented or living rent free: Total,204,117,85,38,47,6,26,87,38,1,12,22,14
S01009450,Rented or living rent free: Social rented,169,95,73,35,38,2,20,74,35,1,8,19,11
S01009450,Rented or living rent free: Private rented or living rent free,35,22,12,3,9,4,6,13,3,0,4,3,3
S01009451,All HRPs aged 16 and over,427,255,195,39,156,29,31,172,105,3,19,32,13
S01009451,Owned: Total,202,130,108,11,97,22,0,72,65,2,2,2,1
S01009451,Owned: Owned outright,99,37,31,8,23,6,0,62,58,1,2,1,0
S01009451,Owned: Owned with a mortgage or loan or shared ownership,103,93,77,3,74,16,0,10,7,1,0,1,1
S01009451,Rented or living rent free: Total,225,125,87,28,59,7,31,100,40,1,17,30,12
S01009451,Rented or living rent free: Social rented,190,100,70,23,47,5,25,90,38,1,17,25,9
S01009451,Rented or living rent free: Private rented or living rent free,35,25,17,5,12,2,6,10,2,0,0,5,3
S01009452,All HRPs aged 16 and over,269,146,117,15,102,9,20,123,84,1,8,23,7
S01009452,Owned: Total,122,78,70,7,63,6,2,44,39,0,0,5,0
S01009452,Owned: Owned outright,56,24,22,4,18,1,1,32,30,0,0,2,0
S01009452,Owned: Owned with a mortgage or loan or shared ownership,66,54,48,3,45,5,1,12,9,0,0,3,0
S01009452,Rented or living rent free: Total,147,68,47,8,39,3,18,79,45,1,8,18,7
S01009452,Rented or living rent free: Social rented,114,46,31,7,24,2,13,68,42,1,3,15,7
S01009452,Rented or living rent free: Private rented or living rent free,33,22,16,1,15,1,5,11,3,0,5,3,0
S01009453,All HRPs aged 16 and over,493,296,247,52,195,19,30,197,133,2,10,41,11
S01009453,Owned: Total,269,183,165,21,144,13,5,86,74,0,2,6,4
S01009453,Owned: Owned outright,111,46,40,10,30,3,3,65,61,0,0,2,2
S01009453,Owned: Owned with a mortgage or loan or shared ownership,158,137,125,11,114,10,2,21,13,0,2,4,2
S01009453,Rented or living rent free: Total,224,113,82,31,51,6,25,111,59,2,8,35,7
S01009453,Rented or living rent free: Social rented,175,82,62,22,40,4,16,93,50,2,7,29,5
S01009453,Rented or living rent free: Private rented or living rent free,49,31,20,9,11,2,9,18,9,0,1,6,2
S01009454,All HRPs aged 16 and over,397,258,209,27,182,42,7,139,126,0,4,8,1
S01009454,Owned: Total,310,201,165,16,149,34,2,109,107,0,0,1,1
S01009454,Owned: Owned outright,156,58,44,9,35,13,1,98,97,0,0,1,0
S01009454,Owned: Owned with a mortgage or loan or shared ownership,154,143,121,7,114,21,1,11,10,0,0,0,1
S01009454,Rented or living rent free: Total,87,57,44,11,33,8,5,30,19,0,4,7,0
S01009454,Rented or living rent free: Social rented,24,11,9,3,6,0,2,13,9,0,1,3,0
S01009454,Rented or living rent free: Private rented or living rent free,63,46,35,8,27,8,3,17,10,0,3,4,0
S01009455,All HRPs aged 16 and over,386,240,179,24,155,59,2,146,133,1,1,7,4
S01009455,Owned: Total,319,194,144,14,130,50,0,125,122,1,0,2,0
S01009455,Owned: Owned outright,207,88,62,11,51,26,0,119,116,1,0,2,0
S01009455,Owned: Owned with a mortgage or loan or shared ownership,112,106,82,3,79,24,0,6,6,0,0,0,0
S01009455,Rented or living rent free: Total,67,46,35,10,25,9,2,21,11,0,1,5,4
S01009455,Rented or living rent free: Social rented,12,4,4,1,3,0,0,8,6,0,0,1,1
S01009455,Rented or living rent free: Private rented or living rent free,55,42,31,9,22,9,2,13,5,0,1,4,3
S01009456,All HRPs aged 16 and over,358,210,162,24,138,31,17,148,106,4,1,26,11
S01009456,Owned: Total,204,140,110,11,99,28,2,64,61,0,0,1,2
S01009456,Owned: Owned outright,87,37,25,3,22,11,1,50,49,0,0,0,1
S01009456,Owned: Owned with a mortgage or loan or shared ownership,117,103,85,8,77,17,1,14,12,0,0,1,1
S01009456,Rented or living rent free: Total,154,70,52,13,39,3,15,84,45,4,1,25,9
S01009456,Rented or living rent free: Social rented,109,41,30,10,20,1,10,68,40,4,0,18,6
S01009456,Rented or living rent free: Private rented or living rent free,45,29,22,3,19,2,5,16,5,0,1,7,3
S01009457,All HRPs aged 16 and over,254,184,127,26,101,55,2,70,67,0,1,2,0
S01009457,Owned: Total,186,132,97,20,77,35,0,54,52,0,0,2,0
S01009457,Owned: Owned outright,100,52,31,11,20,21,0,48,47,0,0,1,0
S01009457,Owned: Owned with a mortgage or loan or shared ownership,86,80,66,9,57,14,0,6,5,0,0,1,0
S01009457,Rented or living rent free: Total,68,52,30,6,24,20,2,16,15,0,1,0,0
S01009457,Rented or living rent free: Social rented,17,10,7,3,4,1,2,7,6,0,1,0,0
S01009457,Rented or living rent free: Private rented or living rent free,51,42,23,3,20,19,0,9,9,0,0,0,0
S01009458,All HRPs aged 16 and over,332,195,159,21,138,23,13,137,113,3,7,12,2
S01009458,Owned: Total,222,133,108,14,94,21,4,89,82,0,2,4,1
S01009458,Owned: Owned outright,110,29,23,9,14,5,1,81,76,0,2,2,1
S01009458,Owned: Owned with a mortgage or loan or shared ownership,112,104,85,5,80,16,3,8,6,0,0,2,0
S01009458,Rented or living rent free: Total,110,62,51,7,44,2,9,48,31,3,5,8,1
S01009458,Rented or living rent free: Social rented,65,27,17,3,14,1,9,38,28,1,3,5,1
S01009458,Rented or living rent free: Private rented or living rent free,45,35,34,4,30,1,0,10,3,2,2,3,0
S01009459,All HRPs aged 16 and over,457,281,197,32,165,40,44,176,135,6,2,22,11
S01009459,Owned: Total,248,170,129,15,114,32,9,78,73,1,0,4,0
S01009459,Owned: Owned outright,112,51,30,5,25,15,6,61,59,0,0,2,0
S01009459,Owned: Owned with a mortgage or loan or shared ownership,136,119,99,10,89,17,3,17,14,1,0,2,0
S01009459,Rented or living rent free: Total,209,111,68,17,51,8,35,98,62,5,2,18,11
S01009459,Rented or living rent free: Social rented,132,52,27,9,18,3,22,80,55,3,1,13,8
S01009459,Rented or living rent free: Private rented or living rent free,77,59,41,8,33,5,13,18,7,2,1,5,3
S01009460,All HRPs aged 16 and over,398,265,197,53,144,11,57,133,80,2,13,30,8
S01009460,Owned: Total,118,82,71,11,60,10,1,36,33,0,0,3,0
S01009460,Owned: Owned outright,40,9,7,3,4,2,0,31,28,0,0,3,0
S01009460,Owned: Owned with a mortgage or loan or shared ownership,78,73,64,8,56,8,1,5,5,0,0,0,0
S01009460,Rented or living rent free: Total,280,183,126,42,84,1,56,97,47,2,13,27,8
S01009460,Rented or living rent free: Social rented,236,149,104,39,65,1,44,87,44,2,9,24,8
S01009460,Rented or living rent free: Private rented or living rent free,44,34,22,3,19,0,12,10,3,0,4,3,0
S01009461,All HRPs aged 16 and over,201,166,145,11,134,20,1,35,28,1,1,4,1
S01009461,Owned: Total,189,157,138,9,129,18,1,32,27,1,0,3,1
S01009461,Owned: Owned outright,46,18,14,3,11,3,1,28,25,0,0,3,0
S01009461,Owned: Owned with a mortgage or loan or shared ownership,143,139,124,6,118,15,0,4,2,1,0,0,1
S01009461,Rented or living rent free: Total,12,9,7,2,5,2,0,3,1,0,1,1,0
S01009461,Rented or living rent free: Social rented,6,4,4,2,2,0,0,2,0,0,1,1,0
S01009461,Rented or living rent free: Private rented or living rent free,6,5,3,0,3,2,0,1,1,0,0,0,0
S01009462,All HRPs aged 16 and over,292,177,149,24,125,22,6,115,100,0,5,8,2
S01009462,Owned: Total,211,135,118,16,102,16,1,76,75,0,0,1,0
S01009462,Owned: Owned outright,110,40,36,10,26,4,0,70,69,0,0,1,0
S01009462,Owned: Owned with a mortgage or loan or shared ownership,101,95,82,6,76,12,1,6,6,0,0,0,0
S01009462,Rented or living rent free: Total,81,42,31,8,23,6,5,39,25,0,5,7,2
S01009462,Rented or living rent free: Social rented,63,30,22,6,16,5,3,33,20,0,5,7,1
S01009462,Rented or living rent free: Private rented or living rent free,18,12,9,2,7,1,2,6,5,0,0,0,1
S01009463,All HRPs aged 16 and over,306,177,145,24,121,24,8,129,112,1,8,4,4
S01009463,Owned: Total,227,136,113,15,98,22,1,91,85,0,3,1,2
S01009463,Owned: Owned outright,118,38,29,7,22,9,0,80,77,0,1,1,1
S01009463,Owned: Owned with a mortgage or loan or shared ownership,109,98,84,8,76,13,1,11,8,0,2,0,1
S01009463,Rented or living rent free: Total,79,41,32,9,23,2,7,38,27,1,5,3,2
S01009463,Rented or living rent free: Social rented,63,33,26,8,18,1,6,30,19,1,5,3,2
S01009463,Rented or living rent free: Private rented or living rent free,16,8,6,1,5,1,1,8,8,0,0,0,0
S01009464,All HRPs aged 16 and over,378,261,228,36,192,26,7,117,100,1,2,10,4
S01009464,Owned: Total,317,227,197,33,164,26,4,90,84,0,1,4,1
S01009464,Owned: Owned outright,150,64,55,13,42,5,4,86,82,0,1,3,0
S01009464,Owned: Owned with a mortgage or loan or shared ownership,167,163,142,20,122,21,0,4,2,0,0,1,1
S01009464,Rented or living rent free: Total,61,34,31,3,28,0,3,27,16,1,1,6,3
S01009464,Rented or living rent free: Social rented,29,14,13,2,11,0,1,15,10,0,1,3,1
S01009464,Rented or living rent free: Private rented or living rent free,32,20,18,1,17,0,2,12,6,1,0,3,2
S01009465,All HRPs aged 16 and over,269,164,140,24,116,16,8,105,93,0,5,6,1
S01009465,Owned: Total,196,125,108,13,95,14,3,71,68,0,1,2,0
S01009465,Owned: Owned outright,94,31,24,7,17,6,1,63,60,0,1,2,0
S01009465,Owned: Owned with a mortgage or loan or shared ownership,102,94,84,6,78,8,2,8,8,0,0,0,0
S01009465,Rented or living rent free: Total,73,39,32,11,21,2,5,34,25,0,4,4,1
S01009465,Rented or living rent free: Social rented,58,28,24,8,16,1,3,30,24,0,2,3,1
S01009465,Rented or living rent free: Private rented or living rent free,15,11,8,3,5,1,2,4,1,0,2,1,0
S01009466,All HRPs aged 16 and over,256,151,124,8,116,26,1,105,101,0,0,1,3
S01009466,Owned: Total,241,143,116,8,108,26,1,98,96,0,0,1,1
S01009466,Owned: Owned outright,136,49,39,3,36,9,1,87,86,0,0,1,0
S01009466,Owned: Owned with a mortgage or loan or shared ownership,105,94,77,5,72,17,0,11,10,0,0,0,1
S01009466,Rented or living rent free: Total,15,8,8,0,8,0,0,7,5,0,0,0,2
S01009466,Rented or living rent free: Social rented,3,2,2,0,2,0,0,1,1,0,0,0,0
S01009466,Rented or living rent free: Private rented or living rent free,12,6,6,0,6,0,0,6,4,0,0,0,2
S01009467,All HRPs aged 16 and over,330,209,170,26,144,33,6,121,113,2,2,3,1
S01009467,Owned: Total,284,178,145,24,121,32,1,106,100,1,1,3,1
S01009467,Owned: Owned outright,151,55,45,13,32,9,1,96,92,0,1,2,1
S01009467,Owned: Owned with a mortgage or loan or shared ownership,133,123,100,11,89,23,0,10,8,1,0,1,0
S01009467,Rented or living rent free: Total,46,31,25,2,23,1,5,15,13,1,1,0,0
S01009467,Rented or living rent free: Social rented,18,12,8,1,7,1,3,6,5,0,1,0,0
S01009467,Rented or living rent free: Private rented or living rent free,28,19,17,1,16,0,2,9,8,1,0,0,0
S01009468,All HRPs aged 16 and over,385,220,184,33,151,20,16,165,132,1,7,20,5
S01009468,Owned: Total,215,138,121,15,106,16,1,77,70,1,2,3,1
S01009468,Owned: Owned outright,97,31,24,8,16,6,1,66,59,1,2,3,1
S01009468,Owned: Owned with a mortgage or loan or shared ownership,118,107,97,7,90,10,0,11,11,0,0,0,0
S01009468,Rented or living rent free: Total,170,82,63,18,45,4,15,88,62,0,5,17,4
S01009468,Rented or living rent free: Social rented,129,52,40,11,29,1,11,77,54,0,5,16,2
S01009468,Rented or living rent free: Private rented or living rent free,41,30,23,7,16,3,4,11,8,0,0,1,2
S01009469,All HRPs aged 16 and over,393,245,196,31,165,28,21,148,133,3,2,5,5
S01009469,Owned: Total,313,193,164,23,141,23,6,120,113,3,1,2,1
S01009469,Owned: Owned outright,167,60,48,13,35,7,5,107,105,0,1,0,1
S01009469,Owned: Owned with a mortgage or loan or shared ownership,146,133,116,10,106,16,1,13,8,3,0,2,0
S01009469,Rented or living rent free: Total,80,52,32,8,24,5,15,28,20,0,1,3,4
S01009469,Rented or living rent free: Social rented,44,25,14,6,8,3,8,19,15,0,1,3,0
S01009469,Rented or living rent free: Private rented or living rent free,36,27,18,2,16,2,7,9,5,0,0,0,4
S01009470,All HRPs aged 16 and over,232,138,114,20,94,19,5,94,80,0,3,5,6
S01009470,Owned: Total,180,110,93,12,81,15,2,70,66,0,1,0,3
S01009470,Owned: Owned outright,98,36,30,8,22,4,2,62,58,0,1,0,3
S01009470,Owned: Owned with a mortgage or loan or shared ownership,82,74,63,4,59,11,0,8,8,0,0,0,0
S01009470,Rented or living rent free: Total,52,28,21,8,13,4,3,24,14,0,2,5,3
S01009470,Rented or living rent free: Social rented,34,14,9,6,3,4,1,20,10,0,2,5,3
S01009470,Rented or living rent free: Private rented or living rent free,18,14,12,2,10,0,2,4,4,0,0,0,0
S01009471,All HRPs aged 16 and over,414,169,131,20,111,12,26,245,180,4,8,43,10
S01009471,Owned: Total,113,68,58,4,54,8,2,45,43,0,0,1,1
S01009471,Owned: Owned outright,61,20,17,3,14,2,1,41,40,0,0,0,1
S01009471,Owned: Owned with a mortgage or loan or shared ownership,52,48,41,1,40,6,1,4,3,0,0,1,0
S01009471,Rented or living rent free: Total,301,101,73,16,57,4,24,200,137,4,8,42,9
S01009471,Rented or living rent free: Social rented,261,74,52,11,41,3,19,187,132,0,6,40,9
S01009471,Rented or living rent free: Private rented or living rent free,40,27,21,5,16,1,5,13,5,4,2,2,0
S01009472,All HRPs aged 16 and over,435,283,197,38,159,31,55,152,91,0,17,30,14
S01009472,Owned: Total,191,131,103,9,94,23,5,60,58,0,0,2,0
S01009472,Owned: Owned outright,104,48,38,6,32,10,0,56,54,0,0,2,0
S01009472,Owned: Owned with a mortgage or loan or shared ownership,87,83,65,3,62,13,5,4,4,0,0,0,0
S01009472,Rented or living rent free: Total,244,152,94,29,65,8,50,92,33,0,17,28,14
S01009472,Rented or living rent free: Social rented,193,114,68,23,45,5,41,79,28,0,16,25,10
S01009472,Rented or living rent free: Private rented or living rent free,51,38,26,6,20,3,9,13,5,0,1,3,4
S01009473,All HRPs aged 16 and over,464,301,227,58,169,24,50,163,90,9,18,37,9
S01009473,Owned: Total,152,94,82,13,69,11,1,58,53,0,0,4,1
S01009473,Owned: Owned outright,70,20,15,6,9,4,1,50,47,0,0,2,1
S01009473,Owned: Owned with a mortgage or loan or shared ownership,82,74,67,7,60,7,0,8,6,0,0,2,0
S01009473,Rented or living rent free: Total,312,207,145,45,100,13,49,105,37,9,18,33,8
S01009473,Rented or living rent free: Social rented,143,71,40,13,27,5,26,72,32,1,8,25,6
S01009473,Rented or living rent free: Private rented or living rent free,169,136,105,32,73,8,23,33,5,8,10,8,2
S01009474,All HRPs aged 16 and over,403,298,209,42,167,31,58,105,65,4,13,15,8
S01009474,Owned: Total,178,141,114,16,98,22,5,37,35,1,1,0,0
S01009474,Owned: Owned outright,65,33,26,5,21,6,1,32,32,0,0,0,0
S01009474,Owned: Owned with a mortgage or loan or shared ownership,113,108,88,11,77,16,4,5,3,1,1,0,0
S01009474,Rented or living rent free: Total,225,157,95,26,69,9,53,68,30,3,12,15,8
S01009474,Rented or living rent free: Social rented,185,122,74,20,54,6,42,63,27,2,12,14,8
S01009474,Rented or living rent free: Private rented or living rent free,40,35,21,6,15,3,11,5,3,1,0,1,0
S01009475,All HRPs aged 16 and over,222,171,139,18,121,31,1,51,41,0,5,4,1
S01009475,Owned: Total,195,149,124,15,109,25,0,46,41,0,3,2,0
S01009475,Owned: Owned outright,67,29,22,10,12,7,0,38,35,0,1,2,0
S01009475,Owned: Owned with a mortgage or loan or shared ownership,128,120,102,5,97,18,0,8,6,0,2,0,0
S01009475,Rented or living rent free: Total,27,22,15,3,12,6,1,5,0,0,2,2,1
S01009475,Rented or living rent free: Social rented,3,2,1,1,0,1,0,1,0,0,1,0,0
S01009475,Rented or living rent free: Private rented or living rent free,24,20,14,2,12,5,1,4,0,0,1,2,1
S01009476,All HRPs aged 16 and over,169,147,116,13,103,29,2,22,18,0,0,2,2
S01009476,Owned: Total,133,119,91,5,86,27,1,14,14,0,0,0,0
S01009476,Owned: Owned outright,40,29,16,1,15,13,0,11,11,0,0,0,0
S01009476,Owned: Owned with a mortgage or loan or shared ownership,93,90,75,4,71,14,1,3,3,0,0,0,0
S01009476,Rented or living rent free: Total,36,28,25,8,17,2,1,8,4,0,0,2,2
S01009476,Rented or living rent free: Social rented,2,1,1,1,0,0,0,1,0,0,0,1,0
S01009476,Rented or living rent free: Private rented or living rent free,34,27,24,7,17,2,1,7,4,0,0,1,2
S01009477,All HRPs aged 16 and over,358,224,174,18,156,43,7,134,114,1,6,11,2
S01009477,Owned: Total,262,168,127,9,118,38,3,94,91,0,2,1,0
S01009477,Owned: Owned outright,131,47,33,5,28,14,0,84,82,0,2,0,0
S01009477,Owned: Owned with a mortgage or loan or shared ownership,131,121,94,4,90,24,3,10,9,0,0,1,0
S01009477,Rented or living rent free: Total,96,56,47,9,38,5,4,40,23,1,4,10,2
S01009477,Rented or living rent free: Social rented,45,18,13,2,11,3,2,27,16,0,2,7,2
S01009477,Rented or living rent free: Private rented or living rent free,51,38,34,7,27,2,2,13,7,1,2,3,0
S01009478,All HRPs aged 16 and over,480,355,290,43,247,35,30,125,80,8,11,20,6
S01009478,Owned: Total,246,191,164,24,140,23,4,55,52,0,1,1,1
S01009478,Owned: Owned outright,93,44,36,9,27,7,1,49,47,0,0,1,1
S01009478,Owned: Owned with a mortgage or loan or shared ownership,153,147,128,15,113,16,3,6,5,0,1,0,0
S01009478,Rented or living rent free: Total,234,164,126,19,107,12,26,70,28,8,10,19,5
S01009478,Rented or living rent free: Social rented,102,50,33,5,28,3,14,52,23,5,5,16,3
S01009478,Rented or living rent free: Private rented or living rent free,132,114,93,14,79,9,12,18,5,3,5,3,2
S01009479,All HRPs aged 16 and over,420,271,208,33,175,35,28,149,116,5,1,21,6
S01009479,Owned: Total,230,142,112,14,98,24,6,88,86,0,0,2,0
S01009479,Owned: Owned outright,114,41,30,6,24,10,1,73,72,0,0,1,0
S01009479,Owned: Owned with a mortgage or loan or shared ownership,116,101,82,8,74,14,5,15,14,0,0,1,0
S01009479,Rented or living rent free: Total,190,129,96,19,77,11,22,61,30,5,1,19,6
S01009479,Rented or living rent free: Social rented,85,37,23,6,17,3,11,48,22,3,1,17,5
S01009479,Rented or living rent free: Private rented or living rent free,105,92,73,13,60,8,11,13,8,2,0,2,1
S01009480,All HRPs aged 16 and over,420,236,190,16,174,39,7,184,174,1,0,6,3
S01009480,Owned: Total,328,195,158,14,144,35,2,133,133,0,0,0,0
S01009480,Owned: Owned outright,180,62,48,8,40,13,1,118,118,0,0,0,0
S01009480,Owned: Owned with a mortgage or loan or shared ownership,148,133,110,6,104,22,1,15,15,0,0,0,0
S01009480,Rented or living rent free: Total,92,41,32,2,30,4,5,51,41,1,0,6,3
S01009480,Rented or living rent free: Social rented,50,15,11,2,9,1,3,35,29,0,0,4,2
S01009480,Rented or living rent free: Private rented or living rent free,42,26,21,0,21,3,2,16,12,1,0,2,1
S01009481,All HRPs aged 16 and over,489,349,305,30,275,30,14,140,123,5,2,6,4
S01009481,Owned: Total,317,223,199,11,188,21,3,94,89,1,0,1,3
S01009481,Owned: Owned outright,129,48,39,7,32,6,3,81,78,0,0,1,2
S01009481,Owned: Owned with a mortgage or loan or shared ownership,188,175,160,4,156,15,0,13,11,1,0,0,1
S01009481,Rented or living rent free: Total,172,126,106,19,87,9,11,46,34,4,2,5,1
S01009481,Rented or living rent free: Social rented,36,9,8,2,6,0,1,27,23,1,1,2,0
S01009481,Rented or living rent free: Private rented or living rent free,136,117,98,17,81,9,10,19,11,3,1,3,1
S01009482,All HRPs aged 16 and over,332,249,217,35,182,19,13,83,57,8,10,7,1
S01009482,Owned: Total,196,140,125,18,107,13,2,56,52,1,1,2,0
S01009482,Owned: Owned outright,77,28,22,9,13,5,1,49,47,0,1,1,0
S01009482,Owned: Owned with a mortgage or loan or shared ownership,119,112,103,9,94,8,1,7,5,1,0,1,0
S01009482,Rented or living rent free: Total,136,109,92,17,75,6,11,27,5,7,9,5,1
S01009482,Rented or living rent free: Social rented,17,8,6,3,3,1,1,9,2,0,3,3,1
S01009482,Rented or living rent free: Private rented or living rent free,119,101,86,14,72,5,10,18,3,7,6,2,0
S01009483,All HRPs aged 16 and over,403,323,269,29,240,35,19,80,54,5,5,15,1
S01009483,Owned: Total,280,224,199,20,179,23,2,56,51,3,1,1,0
S01009483,Owned: Owned outright,108,60,50,12,38,9,1,48,47,1,0,0,0
S01009483,Owned: Owned with a mortgage or loan or shared ownership,172,164,149,8,141,14,1,8,4,2,1,1,0
S01009483,Rented or living rent free: Total,123,99,70,9,61,12,17,24,3,2,4,14,1
S01009483,Rented or living rent free: Social rented,6,5,3,0,3,1,1,1,0,0,1,0,0
S01009483,Rented or living rent free: Private rented or living rent free,117,94,67,9,58,11,16,23,3,2,3,14,1
S01009484,All HRPs aged 16 and over,427,223,179,25,154,19,25,204,159,7,3,30,5
S01009484,Owned: Total,261,130,111,10,101,16,3,131,123,4,0,4,0
S01009484,Owned: Owned outright,159,40,31,6,25,7,2,119,113,3,0,3,0
S01009484,Owned: Owned with a mortgage or loan or shared ownership,102,90,80,4,76,9,1,12,10,1,0,1,0
S01009484,Rented or living rent free: Total,166,93,68,15,53,3,22,73,36,3,3,26,5
S01009484,Rented or living rent free: Social rented,97,38,23,7,16,1,14,59,24,3,3,25,4
S01009484,Rented or living rent free: Private rented or living rent free,69,55,45,8,37,2,8,14,12,0,0,1,1
S01009485,All HRPs aged 16 and over,362,195,146,26,120,29,20,167,133,3,4,19,8
S01009485,Owned: Total,204,112,86,17,69,24,2,92,90,0,0,2,0
S01009485,Owned: Owned outright,114,36,26,9,17,9,1,78,77,0,0,1,0
S01009485,Owned: Owned with a mortgage or loan or shared ownership,90,76,60,8,52,15,1,14,13,0,0,1,0
S01009485,Rented or living rent free: Total,158,83,60,9,51,5,18,75,43,3,4,17,8
S01009485,Rented or living rent free: Social rented,116,56,40,8,32,4,12,60,38,1,3,12,6
S01009485,Rented or living rent free: Private rented or living rent free,42,27,20,1,19,1,6,15,5,2,1,5,2
S01009486,All HRPs aged 16 and over,313,170,146,26,120,20,4,143,134,0,2,4,3
S01009486,Owned: Total,233,130,111,13,98,19,0,103,101,0,1,1,0
S01009486,Owned: Owned outright,137,42,33,8,25,9,0,95,93,0,1,1,0
S01009486,Owned: Owned with a mortgage or loan or shared ownership,96,88,78,5,73,10,0,8,8,0,0,0,0
S01009486,Rented or living rent free: Total,80,40,35,13,22,1,4,40,33,0,1,3,3
S01009486,Rented or living rent free: Social rented,51,24,21,9,12,0,3,27,22,0,1,2,2
S01009486,Rented or living rent free: Private rented or living rent free,29,16,14,4,10,1,1,13,11,0,0,1,1
S01009487,All HRPs aged 16 and over,385,221,192,40,152,17,12,164,129,2,7,14,12
S01009487,Owned: Total,228,142,129,23,106,13,0,86,81,0,4,1,0
S01009487,Owned: Owned outright,109,33,31,12,19,2,0,76,74,0,1,1,0
S01009487,Owned: Owned with a mortgage or loan or shared ownership,119,109,98,11,87,11,0,10,7,0,3,0,0
S01009487,Rented or living rent free: Total,157,79,63,17,46,4,12,78,48,2,3,13,12
S01009487,Rented or living rent free: Social rented,120,53,40,15,25,2,11,67,42,2,2,12,9
S01009487,Rented or living rent free: Private rented or living rent free,37,26,23,2,21,2,1,11,6,0,1,1,3
S01009488,All HRPs aged 16 and over,267,182,153,30,123,20,9,85,70,0,8,4,3
S01009488,Owned: Total,197,137,117,15,102,20,0,60,59,0,0,1,0
S01009488,Owned: Owned outright,88,35,25,7,18,10,0,53,52,0,0,1,0
S01009488,Owned: Owned with a mortgage or loan or shared ownership,109,102,92,8,84,10,0,7,7,0,0,0,0
S01009488,Rented or living rent free: Total,70,45,36,15,21,0,9,25,11,0,8,3,3
S01009488,Rented or living rent free: Social rented,58,36,31,14,17,0,5,22,9,0,7,3,3
S01009488,Rented or living rent free: Private rented or living rent free,12,9,5,1,4,0,4,3,2,0,1,0,0
S01009489,All HRPs aged 16 and over,388,223,179,36,143,21,23,165,110,5,10,30,10
S01009489,Owned: Total,195,125,108,15,93,15,2,70,63,0,1,5,1
S01009489,Owned: Owned outright,88,29,24,6,18,4,1,59,56,0,0,3,0
S01009489,Owned: Owned with a mortgage or loan or shared ownership,107,96,84,9,75,11,1,11,7,0,1,2,1
S01009489,Rented or living rent free: Total,193,98,71,21,50,6,21,95,47,5,9,25,9
S01009489,Rented or living rent free: Social rented,146,67,44,15,29,3,20,79,42,4,9,18,6
S01009489,Rented or living rent free: Private rented or living rent free,47,31,27,6,21,3,1,16,5,1,0,7,3
S01009490,All HRPs aged 16 and over,394,253,195,54,141,15,43,141,82,3,17,29,10
S01009490,Owned: Total,148,111,96,18,78,10,5,37,30,0,1,3,3
S01009490,Owned: Owned outright,59,35,27,5,22,4,4,24,20,0,1,1,2
S01009490,Owned: Owned with a mortgage or loan or shared ownership,89,76,69,13,56,6,1,13,10,0,0,2,1
S01009490,Rented or living rent free: Total,246,142,99,36,63,5,38,104,52,3,16,26,7
S01009490,Rented or living rent free: Social rented,222,123,88,34,54,2,33,99,51,2,16,23,7
S01009490,Rented or living rent free: Private rented or living rent free,24,19,11,2,9,3,5,5,1,1,0,3,0
S01009491,All HRPs aged 16 and over,332,161,125,24,101,18,18,171,132,3,8,24,4
S01009491,Owned: Total,196,107,88,10,78,15,4,89,82,1,0,6,0
S01009491,Owned: Owned outright,101,31,23,3,20,6,2,70,66,0,0,4,0
S01009491,Owned: Owned with a mortgage or loan or shared ownership,95,76,65,7,58,9,2,19,16,1,0,2,0
S01009491,Rented or living rent free: Total,136,54,37,14,23,3,14,82,50,2,8,18,4
S01009491,Rented or living rent free: Social rented,119,46,31,13,18,2,13,73,45,2,5,17,4
S01009491,Rented or living rent free: Private rented or living rent free,17,8,6,1,5,1,1,9,5,0,3,1,0
S01009492,All HRPs aged 16 and over,310,198,163,22,141,26,9,112,83,4,8,11,6
S01009492,Owned: Total,185,130,109,8,101,21,0,55,51,0,1,2,1
S01009492,Owned: Owned outright,74,29,25,5,20,4,0,45,43,0,0,1,1
S01009492,Owned: Owned with a mortgage or loan or shared ownership,111,101,84,3,81,17,0,10,8,0,1,1,0
S01009492,Rented or living rent free: Total,125,68,54,14,40,5,9,57,32,4,7,9,5
S01009492,Rented or living rent free: Social rented,103,57,47,14,33,2,8,46,25,3,5,8,5
S01009492,Rented or living rent free: Private rented or living rent free,22,11,7,0,7,3,1,11,7,1,2,1,0
S01009493,All HRPs aged 16 and over,366,198,142,25,117,54,2,168,161,0,1,4,2
S01009493,Owned: Total,347,190,136,24,112,52,2,157,155,0,1,1,0
S01009493,Owned: Owned outright,238,88,57,17,40,30,1,150,148,0,1,1,0
S01009493,Owned: Owned with a mortgage or loan or shared ownership,109,102,79,7,72,22,1,7,7,0,0,0,0
S01009493,Rented or living rent free: Total,19,8,6,1,5,2,0,11,6,0,0,3,2
S01009493,Rented or living rent free: Social rented,8,1,1,0,1,0,0,7,2,0,0,3,2
S01009493,Rented or living rent free: Private rented or living rent free,11,7,5,1,4,2,0,4,4,0,0,0,0
S01009494,All HRPs aged 16 and over,387,317,258,24,234,47,12,70,62,1,3,3,1
S01009494,Owned: Total,318,261,219,19,200,40,2,57,54,1,0,1,1
S01009494,Owned: Owned outright,118,67,48,5,43,18,1,51,49,0,0,1,1
S01009494,Owned: Owned with a mortgage or loan or shared ownership,200,194,171,14,157,22,1,6,5,1,0,0,0
S01009494,Rented or living rent free: Total,69,56,39,5,34,7,10,13,8,0,3,2,0
S01009494,Rented or living rent free: Social rented,6,4,3,1,2,1,0,2,0,0,1,1,0
S01009494,Rented or living rent free: Private rented or living rent free,63,52,36,4,32,6,10,11,8,0,2,1,0
S01009495,All HRPs aged 16 and over,375,296,248,32,216,40,8,79,73,0,3,2,1
S01009495,Owned: Total,338,266,224,26,198,39,3,72,69,0,1,1,1
S01009495,Owned: Owned outright,119,62,49,13,36,13,0,57,56,0,1,0,0
S01009495,Owned: Owned with a mortgage or loan or shared ownership,219,204,175,13,162,26,3,15,13,0,0,1,1
S01009495,Rented or living rent free: Total,37,30,24,6,18,1,5,7,4,0,2,1,0
S01009495,Rented or living rent free: Social rented,5,4,2,2,0,0,2,1,1,0,0,0,0
S01009495,Rented or living rent free: Private rented or living rent free,32,26,22,4,18,1,3,6,3,0,2,1,0
S01009496,All HRPs aged 16 and over,371,221,191,30,161,21,9,150,122,0,3,18,7
S01009496,Owned: Total,224,148,129,16,113,17,2,76,71,0,0,2,3
S01009496,Owned: Owned outright,101,38,33,9,24,5,0,63,60,0,0,2,1
S01009496,Owned: Owned with a mortgage or loan or shared ownership,123,110,96,7,89,12,2,13,11,0,0,0,2
S01009496,Rented or living rent free: Total,147,73,62,14,48,4,7,74,51,0,3,16,4
S01009496,Rented or living rent free: Social rented,112,46,37,9,28,3,6,66,47,0,2,15,2
S01009496,Rented or living rent free: Private rented or living rent free,35,27,25,5,20,1,1,8,4,0,1,1,2
S01009497,All HRPs aged 16 and over,426,280,254,42,212,20,6,146,130,0,5,9,2
S01009497,Owned: Total,316,228,209,29,180,16,3,88,86,0,0,1,1
S01009497,Owned: Owned outright,121,49,45,14,31,3,1,72,70,0,0,1,1
S01009497,Owned: Owned with a mortgage or loan or shared ownership,195,179,164,15,149,13,2,16,16,0,0,0,0
S01009497,Rented or living rent free: Total,110,52,45,13,32,4,3,58,44,0,5,8,1
S01009497,Rented or living rent free: Social rented,74,24,20,9,11,2,2,50,39,0,5,5,1
S01009497,Rented or living rent free: Private rented or living rent free,36,28,25,4,21,2,1,8,5,0,0,3,0
S01009498,All HRPs aged 16 and over,276,163,137,17,120,24,2,113,108,0,2,2,1
S01009498,Owned: Total,262,154,131,15,116,22,1,108,105,0,1,1,1
S01009498,Owned: Owned outright,157,60,53,10,43,7,0,97,95,0,0,1,1
S01009498,Owned: Owned with a mortgage or loan or shared ownership,105,94,78,5,73,15,1,11,10,0,1,0,0
S01009498,Rented or living rent free: Total,14,9,6,2,4,2,1,5,3,0,1,1,0
S01009498,Rented or living rent free: Social rented,6,4,3,2,1,1,0,2,1,0,0,1,0
S01009498,Rented or living rent free: Private rented or living rent free,8,5,3,0,3,1,1,3,2,0,1,0,0
S01009499,All HRPs aged 16 and over,357,207,176,35,141,17,14,150,122,1,4,18,5
S01009499,Owned: Total,262,149,134,19,115,14,1,113,111,0,0,2,0
S01009499,Owned: Owned outright,146,44,41,9,32,3,0,102,102,0,0,0,0
S01009499,Owned: Owned with a mortgage or loan or shared ownership,116,105,93,10,83,11,1,11,9,0,0,2,0
S01009499,Rented or living rent free: Total,95,58,42,16,26,3,13,37,11,1,4,16,5
S01009499,Rented or living rent free: Social rented,79,47,33,11,22,2,12,32,10,1,1,15,5
S01009499,Rented or living rent free: Private rented or living rent free,16,11,9,5,4,1,1,5,1,0,3,1,0
S01009500,All HRPs aged 16 and over,382,215,176,36,140,17,22,167,124,6,12,18,7
S01009500,Owned: Total,169,121,111,19,92,9,1,48,46,2,0,0,0
S01009500,Owned: Owned outright,70,30,26,10,16,4,0,40,38,2,0,0,0
S01009500,Owned: Owned with a mortgage or loan or shared ownership,99,91,85,9,76,5,1,8,8,0,0,0,0
S01009500,Rented or living rent free: Total,213,94,65,17,48,8,21,119,78,4,12,18,7
S01009500,Rented or living rent free: Social rented,192,82,55,16,39,8,19,110,77,2,10,17,4
S01009500,Rented or living rent free: Private rented or living rent free,21,12,10,1,9,0,2,9,1,2,2,1,3
S01009501,All HRPs aged 16 and over,315,174,132,22,110,15,27,141,108,2,7,15,9
S01009501,Owned: Total,159,94,81,9,72,11,2,65,58,0,0,2,5
S01009501,Owned: Owned outright,70,16,13,2,11,3,0,54,49,0,0,1,4
S01009501,Owned: Owned with a mortgage or loan or shared ownership,89,78,68,7,61,8,2,11,9,0,0,1,1
S01009501,Rented or living rent free: Total,156,80,51,13,38,4,25,76,50,2,7,13,4
S01009501,Rented or living rent free: Social rented,137,66,40,11,29,3,23,71,49,2,5,12,3
S01009501,Rented or living rent free: Private rented or living rent free,19,14,11,2,9,1,2,5,1,0,2,1,1
S01009502,All HRPs aged 16 and over,373,250,209,50,159,22,19,123,84,2,12,16,9
S01009502,Owned: Total,177,123,107,22,85,11,5,54,47,2,1,2,2
S01009502,Owned: Owned outright,78,33,24,6,18,6,3,45,41,0,0,2,2
S01009502,Owned: Owned with a mortgage or loan or shared ownership,99,90,83,16,67,5,2,9,6,2,1,0,0
S01009502,Rented or living rent free: Total,196,127,102,28,74,11,14,69,37,0,11,14,7
S01009502,Rented or living rent free: Social rented,175,115,91,27,64,10,14,60,34,0,6,14,6
S01009502,Rented or living rent free: Private rented or living rent free,21,12,11,1,10,1,0,9,3,0,5,0,1
S01009503,All HRPs aged 16 and over,338,223,188,42,146,25,10,115,91,0,8,10,6
S01009503,Owned: Total,202,154,133,18,115,20,1,48,46,0,1,0,1
S01009503,Owned: Owned outright,69,31,24,7,17,7,0,38,37,0,0,0,1
S01009503,Owned: Owned with a mortgage or loan or shared ownership,133,123,109,11,98,13,1,10,9,0,1,0,0
S01009503,Rented or living rent free: Total,136,69,55,24,31,5,9,67,45,0,7,10,5
S01009503,Rented or living rent free: Social rented,113,53,41,19,22,4,8,60,43,0,5,10,2
S01009503,Rented or living rent free: Private rented or living rent free,23,16,14,5,9,1,1,7,2,0,2,0,3
S01009504,All HRPs aged 16 and over,314,196,154,41,113,15,27,118,65,7,10,24,12
S01009504,Owned: Total,125,83,74,11,63,7,2,42,38,0,1,2,1
S01009504,Owned: Owned outright,50,13,11,1,10,2,0,37,34,0,1,1,1
S01009504,Owned: Owned with a mortgage or loan or shared ownership,75,70,63,10,53,5,2,5,4,0,0,1,0
S01009504,Rented or living rent free: Total,189,113,80,30,50,8,25,76,27,7,9,22,11
S01009504,Rented or living rent free: Social rented,171,101,72,28,44,6,23,70,26,6,9,22,7
S01009504,Rented or living rent free: Private rented or living rent free,18,12,8,2,6,2,2,6,1,1,0,0,4
S01009505,All HRPs aged 16 and over,355,225,165,51,114,9,51,130,63,2,18,30,17
S01009505,Owned: Total,113,72,64,11,53,5,3,41,36,0,0,2,3
S01009505,Owned: Owned outright,53,16,12,2,10,1,3,37,33,0,0,2,2
S01009505,Owned: Owned with a mortgage or loan or shared ownership,60,56,52,9,43,4,0,4,3,0,0,0,1
S01009505,Rented or living rent free: Total,242,153,101,40,61,4,48,89,27,2,18,28,14
S01009505,Rented or living rent free: Social rented,219,141,92,36,56,4,45,78,25,2,15,24,12
S01009505,Rented or living rent free: Private rented or living rent free,23,12,9,4,5,0,3,11,2,0,3,4,2
S01009506,All HRPs aged 16 and over,346,210,168,47,121,17,25,136,79,2,16,29,10
S01009506,Owned: Total,140,101,85,16,69,14,2,39,30,0,0,6,3
S01009506,Owned: Owned outright,46,19,16,6,10,3,0,27,23,0,0,3,1
S01009506,Owned: Owned with a mortgage or loan or shared ownership,94,82,69,10,59,11,2,12,7,0,0,3,2
S01009506,Rented or living rent free: Total,206,109,83,31,52,3,23,97,49,2,16,23,7
S01009506,Rented or living rent free: Social rented,186,92,70,29,41,2,20,94,49,1,15,22,7
S01009506,Rented or living rent free: Private rented or living rent free,20,17,13,2,11,1,3,3,0,1,1,1,0
S01009507,All HRPs aged 16 and over,346,245,212,29,183,18,15,101,72,2,10,13,4
S01009507,Owned: Total,227,168,154,13,141,13,1,59,54,0,3,0,2
S01009507,Owned: Owned outright,79,33,31,6,25,2,0,46,45,0,1,0,0
S01009507,Owned: Owned with a mortgage or loan or shared ownership,148,135,123,7,116,11,1,13,9,0,2,0,2
S01009507,Rented or living rent free: Total,119,77,58,16,42,5,14,42,18,2,7,13,2
S01009507,Rented or living rent free: Social rented,103,63,46,16,30,3,14,40,17,2,6,13,2
S01009507,Rented or living rent free: Private rented or living rent free,16,14,12,0,12,2,0,2,1,0,1,0,0
S01009508,All HRPs aged 16 and over,397,244,181,65,116,19,44,153,86,3,21,37,6
S01009508,Owned: Total,144,98,81,15,66,13,4,46,41,0,0,5,0
S01009508,Owned: Owned outright,60,23,20,9,11,2,1,37,36,0,0,1,0
S01009508,Owned: Owned with a mortgage or loan or shared ownership,84,75,61,6,55,11,3,9,5,0,0,4,0
S01009508,Rented or living rent free: Total,253,146,100,50,50,6,40,107,45,3,21,32,6
S01009508,Rented or living rent free: Social rented,224,126,86,45,41,6,34,98,41,3,17,31,6
S01009508,Rented or living rent free: Private rented or living rent free,29,20,14,5,9,0,6,9,4,0,4,1,0
S01009509,All HRPs aged 16 and over,421,262,213,44,169,25,24,159,113,3,18,18,7
S01009509,Owned: Total,209,139,120,19,101,16,3,70,68,1,0,0,1
S01009509,Owned: Owned outright,82,27,22,4,18,5,0,55,55,0,0,0,0
S01009509,Owned: Owned with a mortgage or loan or shared ownership,127,112,98,15,83,11,3,15,13,1,0,0,1
S01009509,Rented or living rent free: Total,212,123,93,25,68,9,21,89,45,2,18,18,6
S01009509,Rented or living rent free: Social rented,176,96,70,20,50,6,20,80,42,2,16,16,4
S01009509,Rented or living rent free: Private rented or living rent free,36,27,23,5,18,3,1,9,3,0,2,2,2
S01009510,All HRPs aged 16 and over,301,182,157,23,134,23,2,119,116,0,3,0,0
S01009510,Owned: Total,289,174,150,20,130,23,1,115,114,0,1,0,0
S01009510,Owned: Owned outright,162,57,53,13,40,4,0,105,104,0,1,0,0
S01009510,Owned: Owned with a mortgage or loan or shared ownership,127,117,97,7,90,19,1,10,10,0,0,0,0
S01009510,Rented or living rent free: Total,12,8,7,3,4,0,1,4,2,0,2,0,0
S01009510,Rented or living rent free: Social rented,6,3,2,2,0,0,1,3,1,0,2,0,0
S01009510,Rented or living rent free: Private rented or living rent free,6,5,5,1,4,0,0,1,1,0,0,0,0
S01009511,All HRPs aged 16 and over,257,143,119,16,103,21,3,114,113,0,0,1,0
S01009511,Owned: Total,237,130,113,12,101,16,1,107,107,0,0,0,0
S01009511,Owned: Owned outright,141,39,36,8,28,2,1,102,102,0,0,0,0
S01009511,Owned: Owned with a mortgage or loan or shared ownership,96,91,77,4,73,14,0,5,5,0,0,0,0
S01009511,Rented or living rent free: Total,20,13,6,4,2,5,2,7,6,0,0,1,0
S01009511,Rented or living rent free: Social rented,6,4,1,1,0,1,2,2,1,0,0,1,0
S01009511,Rented or living rent free: Private rented or living rent free,14,9,5,3,2,4,0,5,5,0,0,0,0
S01009512,All HRPs aged 16 and over,313,212,185,26,159,22,5,101,98,2,1,0,0
S01009512,Owned: Total,291,196,175,24,151,19,2,95,94,1,0,0,0
S01009512,Owned: Owned outright,143,54,47,12,35,6,1,89,89,0,0,0,0
S01009512,Owned: Owned with a mortgage or loan or shared ownership,148,142,128,12,116,13,1,6,5,1,0,0,0
S01009512,Rented or living rent free: Total,22,16,10,2,8,3,3,6,4,1,1,0,0
S01009512,Rented or living rent free: Social rented,5,4,2,1,1,1,1,1,0,1,0,0,0
S01009512,Rented or living rent free: Private rented or living rent free,17,12,8,1,7,2,2,5,4,0,1,0,0
S01009513,All HRPs aged 16 and over,245,156,139,21,118,15,2,89,83,1,0,5,0
S01009513,Owned: Total,231,148,132,19,113,14,2,83,81,0,0,2,0
S01009513,Owned: Owned outright,121,47,43,11,32,2,2,74,74,0,0,0,0
S01009513,Owned: Owned with a mortgage or loan or shared ownership,110,101,89,8,81,12,0,9,7,0,0,2,0
S01009513,Rented or living rent free: Total,14,8,7,2,5,1,0,6,2,1,0,3,0
S01009513,Rented or living rent free: Social rented,4,0,0,0,0,0,0,4,1,0,0,3,0
S01009513,Rented or living rent free: Private rented or living rent free,10,8,7,2,5,1,0,2,1,1,0,0,0
S01009514,All HRPs aged 16 and over,282,210,192,23,169,17,1,72,68,0,0,1,3
S01009514,Owned: Total,266,196,180,19,161,16,0,70,66,0,0,1,3
S01009514,Owned: Owned outright,125,63,56,12,44,7,0,62,59,0,0,1,2
S01009514,Owned: Owned with a mortgage or loan or shared ownership,141,133,124,7,117,9,0,8,7,0,0,0,1
S01009514,Rented or living rent free: Total,16,14,12,4,8,1,1,2,2,0,0,0,0
S01009514,Rented or living rent free: Social rented,4,3,3,1,2,0,0,1,1,0,0,0,0
S01009514,Rented or living rent free: Private rented or living rent free,12,11,9,3,6,1,1,1,1,0,0,0,0
S01009515,All HRPs aged 16 and over,362,186,159,36,123,17,10,176,138,2,10,18,8
S01009515,Owned: Total,203,122,106,17,89,14,2,81,75,0,1,1,4
S01009515,Owned: Owned outright,102,31,26,12,14,5,0,71,67,0,0,1,3
S01009515,Owned: Owned with a mortgage or loan or shared ownership,101,91,80,5,75,9,2,10,8,0,1,0,1
S01009515,Rented or living rent free: Total,159,64,53,19,34,3,8,95,63,2,9,17,4
S01009515,Rented or living rent free: Social rented,143,57,49,18,31,1,7,86,57,2,7,16,4
S01009515,Rented or living rent free: Private rented or living rent free,16,7,4,1,3,2,1,9,6,0,2,1,0
S01009516,All HRPs aged 16 and over,399,216,185,38,147,24,7,183,161,3,3,11,5
S01009516,Owned: Total,256,161,139,19,120,21,1,95,94,0,0,1,0
S01009516,Owned: Owned outright,123,45,36,14,22,8,1,78,77,0,0,1,0
S01009516,Owned: Owned with a mortgage or loan or shared ownership,133,116,103,5,98,13,0,17,17,0,0,0,0
S01009516,Rented or living rent free: Total,143,55,46,19,27,3,6,88,67,3,3,10,5
S01009516,Rented or living rent free: Social rented,112,36,30,13,17,1,5,76,61,3,1,7,4
S01009516,Rented or living rent free: Private rented or living rent free,31,19,16,6,10,2,1,12,6,0,2,3,1
S01009517,All HRPs aged 16 and over,347,318,279,26,253,33,6,29,17,0,3,3,6
S01009517,Owned: Total,288,269,238,17,221,30,1,19,17,0,1,0,1
S01009517,Owned: Owned outright,51,38,33,6,27,4,1,13,13,0,0,0,0
S01009517,Owned: Owned with a mortgage or loan or shared ownership,237,231,205,11,194,26,0,6,4,0,1,0,1
S01009517,Rented or living rent free: Total,59,49,41,9,32,3,5,10,0,0,2,3,5
S01009517,Rented or living rent free: Social rented,14,9,6,2,4,1,2,5,0,0,1,2,2
S01009517,Rented or living rent free: Private rented or living rent free,45,40,35,7,28,2,3,5,0,0,1,1,3
S01009518,All HRPs aged 16 and over,319,301,256,14,242,40,5,18,9,0,4,2,3
S01009518,Owned: Total,276,270,232,10,222,35,3,6,6,0,0,0,0
S01009518,Owned: Owned outright,32,27,20,5,15,6,1,5,5,0,0,0,0
S01009518,Owned: Owned with a mortgage or loan or shared ownership,244,243,212,5,207,29,2,1,1,0,0,0,0
S01009518,Rented or living rent free: Total,43,31,24,4,20,5,2,12,3,0,4,2,3
S01009518,Rented or living rent free: Social rented,12,5,3,1,2,1,1,7,2,0,2,2,1
S01009518,Rented or living rent free: Private rented or living rent free,31,26,21,3,18,4,1,5,1,0,2,0,2
S01009519,All HRPs aged 16 and over,195,149,126,18,108,16,7,46,35,0,4,5,2
S01009519,Owned: Total,144,114,101,12,89,13,0,30,30,0,0,0,0
S01009519,Owned: Owned outright,66,38,36,5,31,2,0,28,28,0,0,0,0
S01009519,Owned: Owned with a mortgage or loan or shared ownership,78,76,65,7,58,11,0,2,2,0,0,0,0
S01009519,Rented or living rent free: Total,51,35,25,6,19,3,7,16,5,0,4,5,2
S01009519,Rented or living rent free: Social rented,42,29,21,5,16,2,6,13,4,0,4,3,2
S01009519,Rented or living rent free: Private rented or living rent free,9,6,4,1,3,1,1,3,1,0,0,2,0
S01009520,All HRPs aged 16 and over,328,246,202,25,177,34,10,82,59,3,5,12,3
S01009520,Owned: Total,255,206,175,18,157,29,2,49,43,1,1,3,1
S01009520,Owned: Owned outright,80,42,34,6,28,8,0,38,35,0,1,1,1
S01009520,Owned: Owned with a mortgage or loan or shared ownership,175,164,141,12,129,21,2,11,8,1,0,2,0
S01009520,Rented or living rent free: Total,73,40,27,7,20,5,8,33,16,2,4,9,2
S01009520,Rented or living rent free: Social rented,46,23,16,3,13,2,5,23,13,0,2,8,0
S01009520,Rented or living rent free: Private rented or living rent free,27,17,11,4,7,3,3,10,3,2,2,1,2
S01009521,All HRPs aged 16 and over,363,184,145,43,102,22,17,179,134,1,23,18,3
S01009521,Owned: Total,198,90,76,15,61,12,2,108,103,0,0,4,1
S01009521,Owned: Owned outright,130,31,29,10,19,2,0,99,96,0,0,3,0
S01009521,Owned: Owned with a mortgage or loan or shared ownership,68,59,47,5,42,10,2,9,7,0,0,1,1
S01009521,Rented or living rent free: Total,165,94,69,28,41,10,15,71,31,1,23,14,2
S01009521,Rented or living rent free: Social rented,144,82,61,27,34,9,12,62,29,0,17,14,2
S01009521,Rented or living rent free: Private rented or living rent free,21,12,8,1,7,1,3,9,2,1,6,0,0
S01009522,All HRPs aged 16 and over,376,268,217,49,168,30,21,108,57,2,18,24,7
S01009522,Owned: Total,194,147,123,17,106,21,3,47,40,1,2,2,2
S01009522,Owned: Owned outright,59,23,23,8,15,0,0,36,34,1,0,1,0
S01009522,Owned: Owned with a mortgage or loan or shared ownership,135,124,100,9,91,21,3,11,6,0,2,1,2
S01009522,Rented or living rent free: Total,182,121,94,32,62,9,18,61,17,1,16,22,5
S01009522,Rented or living rent free: Social rented,119,77,59,24,35,4,14,42,14,1,7,16,4
S01009522,Rented or living rent free: Private rented or living rent free,63,44,35,8,27,5,4,19,3,0,9,6,1
S01009523,All HRPs aged 16 and over,263,150,124,31,93,9,17,113,81,1,9,20,2
S01009523,Owned: Total,119,71,62,14,48,7,2,48,43,0,3,2,0
S01009523,Owned: Owned outright,55,15,12,5,7,2,1,40,38,0,1,1,0
S01009523,Owned: Owned with a mortgage or loan or shared ownership,64,56,50,9,41,5,1,8,5,0,2,1,0
S01009523,Rented or living rent free: Total,144,79,62,17,45,2,15,65,38,1,6,18,2
S01009523,Rented or living rent free: Social rented,123,65,51,17,34,2,12,58,33,1,6,17,1
S01009523,Rented or living rent free: Private rented or living rent free,21,14,11,0,11,0,3,7,5,0,0,1,1
S01009524,All HRPs aged 16 and over,340,202,163,30,133,15,24,138,78,5,8,40,7
S01009524,Owned: Total,138,103,93,9,84,7,3,35,33,0,0,2,0
S01009524,Owned: Owned outright,54,28,23,5,18,3,2,26,25,0,0,1,0
S01009524,Owned: Owned with a mortgage or loan or shared ownership,84,75,70,4,66,4,1,9,8,0,0,1,0
S01009524,Rented or living rent free: Total,202,99,70,21,49,8,21,103,45,5,8,38,7
S01009524,Rented or living rent free: Social rented,143,54,36,17,19,6,12,89,37,4,7,36,5
S01009524,Rented or living rent free: Private rented or living rent free,59,45,34,4,30,2,9,14,8,1,1,2,2
S01009525,All HRPs aged 16 and over,254,150,123,27,96,12,15,104,74,3,11,11,5
S01009525,Owned: Total,132,88,77,11,66,7,4,44,41,0,1,1,1
S01009525,Owned: Owned outright,60,25,22,5,17,3,0,35,34,0,0,1,0
S01009525,Owned: Owned with a mortgage or loan or shared ownership,72,63,55,6,49,4,4,9,7,0,1,0,1
S01009525,Rented or living rent free: Total,122,62,46,16,30,5,11,60,33,3,10,10,4
S01009525,Rented or living rent free: Social rented,71,32,22,8,14,2,8,39,26,2,3,7,1
S01009525,Rented or living rent free: Private rented or living rent free,51,30,24,8,16,3,3,21,7,1,7,3,3
S01009526,All HRPs aged 16 and over,365,286,244,21,223,28,14,79,59,3,2,12,3
S01009526,Owned: Total,183,130,114,7,107,14,2,53,48,0,1,1,3
S01009526,Owned: Owned outright,77,31,23,5,18,6,2,46,43,0,0,0,3
S01009526,Owned: Owned with a mortgage or loan or shared ownership,106,99,91,2,89,8,0,7,5,0,1,1,0
S01009526,Rented or living rent free: Total,182,156,130,14,116,14,12,26,11,3,1,11,0
S01009526,Rented or living rent free: Social rented,18,9,8,4,4,1,0,9,2,0,0,7,0
S01009526,Rented or living rent free: Private rented or living rent free,164,147,122,10,112,13,12,17,9,3,1,4,0
S01009527,All HRPs aged 16 and over,384,242,200,33,167,17,25,142,109,3,2,20,8
S01009527,Owned: Total,169,107,97,9,88,10,0,62,58,0,0,1,3
S01009527,Owned: Owned outright,80,26,25,6,19,1,0,54,51,0,0,1,2
S01009527,Owned: Owned with a mortgage or loan or shared ownership,89,81,72,3,69,9,0,8,7,0,0,0,1
S01009527,Rented or living rent free: Total,215,135,103,24,79,7,25,80,51,3,2,19,5
S01009527,Rented or living rent free: Social rented,95,33,21,9,12,1,11,62,42,0,0,18,2
S01009527,Rented or living rent free: Private rented or living rent free,120,102,82,15,67,6,14,18,9,3,2,1,3
S01009528,All HRPs aged 16 and over,355,141,124,26,98,10,7,214,191,1,3,13,6
S01009528,Owned: Total,175,81,73,12,61,4,4,94,94,0,0,0,0
S01009528,Owned: Owned outright,107,23,19,7,12,2,2,84,84,0,0,0,0
S01009528,Owned: Owned with a mortgage or loan or shared ownership,68,58,54,5,49,2,2,10,10,0,0,0,0
S01009528,Rented or living rent free: Total,180,60,51,14,37,6,3,120,97,1,3,13,6
S01009528,Rented or living rent free: Social rented,133,22,17,7,10,3,2,111,91,1,1,13,5
S01009528,Rented or living rent free: Private rented or living rent free,47,38,34,7,27,3,1,9,6,0,2,0,1
S01009529,All HRPs aged 16 and over,247,164,128,20,108,28,8,83,73,1,1,6,2
S01009529,Owned: Total,195,133,103,13,90,27,3,62,60,1,0,1,0
S01009529,Owned: Owned outright,104,46,34,9,25,11,1,58,57,0,0,1,0
S01009529,Owned: Owned with a mortgage or loan or shared ownership,91,87,69,4,65,16,2,4,3,1,0,0,0
S01009529,Rented or living rent free: Total,52,31,25,7,18,1,5,21,13,0,1,5,2
S01009529,Rented or living rent free: Social rented,30,17,11,3,8,1,5,13,8,0,0,4,1
S01009529,Rented or living rent free: Private rented or living rent free,22,14,14,4,10,0,0,8,5,0,1,1,1
S01009530,All HRPs aged 16 and over,255,162,135,19,116,27,0,93,90,0,3,0,0
S01009530,Owned: Total,241,153,128,17,111,25,0,88,86,0,2,0,0
S01009530,Owned: Owned outright,130,49,43,10,33,6,0,81,81,0,0,0,0
S01009530,Owned: Owned with a mortgage or loan or shared ownership,111,104,85,7,78,19,0,7,5,0,2,0,0
S01009530,Rented or living rent free: Total,14,9,7,2,5,2,0,5,4,0,1,0,0
S01009530,Rented or living rent free: Social rented,5,2,2,1,1,0,0,3,2,0,1,0,0
S01009530,Rented or living rent free: Private rented or living rent free,9,7,5,1,4,2,0,2,2,0,0,0,0
S01009531,All HRPs aged 16 and over,432,223,185,39,146,11,27,209,156,2,11,31,9
S01009531,Owned: Total,193,122,113,18,95,7,2,71,65,1,0,4,1
S01009531,Owned: Owned outright,87,27,23,8,15,2,2,60,55,0,0,4,1
S01009531,Owned: Owned with a mortgage or loan or shared ownership,106,95,90,10,80,5,0,11,10,1,0,0,0
S01009531,Rented or living rent free: Total,239,101,72,21,51,4,25,138,91,1,11,27,8
S01009531,Rented or living rent free: Social rented,187,63,38,16,22,3,22,124,82,1,9,24,8
S01009531,Rented or living rent free: Private rented or living rent free,52,38,34,5,29,1,3,14,9,0,2,3,0
S01009532,All HRPs aged 16 and over,437,186,155,30,125,13,18,251,205,1,8,34,3
S01009532,Owned: Total,192,89,81,11,70,6,2,103,102,1,0,0,0
S01009532,Owned: Owned outright,101,19,16,4,12,2,1,82,82,0,0,0,0
S01009532,Owned: Owned with a mortgage or loan or shared ownership,91,70,65,7,58,4,1,21,20,1,0,0,0
S01009532,Rented or living rent free: Total,245,97,74,19,55,7,16,148,103,0,8,34,3
S01009532,Rented or living rent free: Social rented,206,69,53,18,35,5,11,137,96,0,6,33,2
S01009532,Rented or living rent free: Private rented or living rent free,39,28,21,1,20,2,5,11,7,0,2,1,1
S01009533,All HRPs aged 16 and over,440,270,221,45,176,21,28,170,127,4,11,23,5
S01009533,Owned: Total,192,136,119,12,107,12,5,56,52,0,0,3,1
S01009533,Owned: Owned outright,66,21,14,3,11,6,1,45,42,0,0,2,1
S01009533,Owned: Owned with a mortgage or loan or shared ownership,126,115,105,9,96,6,4,11,10,0,0,1,0
S01009533,Rented or living rent free: Total,248,134,102,33,69,9,23,114,75,4,11,20,4
S01009533,Rented or living rent free: Social rented,162,72,49,17,32,5,18,90,62,1,7,19,1
S01009533,Rented or living rent free: Private rented or living rent free,86,62,53,16,37,4,5,24,13,3,4,1,3
S01009534,All HRPs aged 16 and over,427,241,167,37,130,21,53,186,104,6,31,29,16
S01009534,Owned: Total,110,63,53,6,47,9,1,47,40,1,1,4,1
S01009534,Owned: Owned outright,46,13,10,0,10,3,0,33,29,0,1,2,1
S01009534,Owned: Owned with a mortgage or loan or shared ownership,64,50,43,6,37,6,1,14,11,1,0,2,0
S01009534,Rented or living rent free: Total,317,178,114,31,83,12,52,139,64,5,30,25,15
S01009534,Rented or living rent free: Social rented,267,138,82,26,56,6,50,129,60,4,27,24,14
S01009534,Rented or living rent free: Private rented or living rent free,50,40,32,5,27,6,2,10,4,1,3,1,1
S01009535,All HRPs aged 16 and over,297,191,139,38,101,15,37,106,44,3,18,32,9
S01009535,Owned: Total,78,56,48,9,39,7,1,22,19,1,0,2,0
S01009535,Owned: Owned outright,25,9,7,2,5,1,1,16,15,0,0,1,0
S01009535,Owned: Owned with a mortgage or loan or shared ownership,53,47,41,7,34,6,0,6,4,1,0,1,0
S01009535,Rented or living rent free: Total,219,135,91,29,62,8,36,84,25,2,18,30,9
S01009535,Rented or living rent free: Social rented,199,119,80,27,53,6,33,80,24,2,18,27,9
S01009535,Rented or living rent free: Private rented or living rent free,20,16,11,2,9,2,3,4,1,0,0,3,0
S01009536,All HRPs aged 16 and over,228,151,120,29,91,17,14,77,52,1,5,17,2
S01009536,Owned: Total,114,88,71,9,62,15,2,26,26,0,0,0,0
S01009536,Owned: Owned outright,37,15,8,0,8,6,1,22,22,0,0,0,0
S01009536,Owned: Owned with a mortgage or loan or shared ownership,77,73,63,9,54,9,1,4,4,0,0,0,0
S01009536,Rented or living rent free: Total,114,63,49,20,29,2,12,51,26,1,5,17,2
S01009536,Rented or living rent free: Social rented,91,47,33,17,16,2,12,44,20,1,5,17,1
S01009536,Rented or living rent free: Private rented or living rent free,23,16,16,3,13,0,0,7,6,0,0,0,1
S01009537,All HRPs aged 16 and over,280,164,132,25,107,15,17,116,90,1,3,14,8
S01009537,Owned: Total,162,103,88,13,75,13,2,59,56,0,0,1,2
S01009537,Owned: Owned outright,78,22,16,4,12,6,0,56,53,0,0,1,2
S01009537,Owned: Owned with a mortgage or loan or shared ownership,84,81,72,9,63,7,2,3,3,0,0,0,0
S01009537,Rented or living rent free: Total,118,61,44,12,32,2,15,57,34,1,3,13,6
S01009537,Rented or living rent free: Social rented,87,42,34,12,22,1,7,45,27,1,1,11,5
S01009537,Rented or living rent free: Private rented or living rent free,31,19,10,0,10,1,8,12,7,0,2,2,1
S01009538,All HRPs aged 16 and over,401,260,204,38,166,24,32,141,84,6,9,28,14
S01009538,Owned: Total,151,108,95,10,85,11,2,43,39,0,1,1,2
S01009538,Owned: Owned outright,59,25,23,5,18,1,1,34,30,0,1,1,2
S01009538,Owned: Owned with a mortgage or loan or shared ownership,92,83,72,5,67,10,1,9,9,0,0,0,0
S01009538,Rented or living rent free: Total,250,152,109,28,81,13,30,98,45,6,8,27,12
S01009538,Rented or living rent free: Social rented,179,95,69,19,50,7,19,84,35,6,6,26,11
S01009538,Rented or living rent free: Private rented or living rent free,71,57,40,9,31,6,11,14,10,0,2,1,1
S01009539,All HRPs aged 16 and over,389,234,203,34,169,23,8,155,130,4,7,14,0
S01009539,Owned: Total,270,178,157,17,140,19,2,92,87,0,2,3,0
S01009539,Owned: Owned outright,118,44,35,11,24,8,1,74,70,0,2,2,0
S01009539,Owned: Owned with a mortgage or loan or shared ownership,152,134,122,6,116,11,1,18,17,0,0,1,0
S01009539,Rented or living rent free: Total,119,56,46,17,29,4,6,63,43,4,5,11,0
S01009539,Rented or living rent free: Social rented,97,38,31,15,16,1,6,59,40,4,5,10,0
S01009539,Rented or living rent free: Private rented or living rent free,22,18,15,2,13,3,0,4,3,0,0,1,0
S01009540,All HRPs aged 16 and over,459,281,229,50,179,18,34,178,115,1,8,44,10
S01009540,Owned: Total,206,138,125,18,107,11,2,68,64,0,1,3,0
S01009540,Owned: Owned outright,85,23,21,7,14,2,0,62,59,0,1,2,0
S01009540,Owned: Owned with a mortgage or loan or shared ownership,121,115,104,11,93,9,2,6,5,0,0,1,0
S01009540,Rented or living rent free: Total,253,143,104,32,72,7,32,110,51,1,7,41,10
S01009540,Rented or living rent free: Social rented,213,108,78,24,54,5,25,105,48,1,6,41,9
S01009540,Rented or living rent free: Private rented or living rent free,40,35,26,8,18,2,7,5,3,0,1,0,1
S01009541,All HRPs aged 16 and over,321,231,187,17,170,36,8,90,71,1,5,10,3
S01009541,Owned: Total,224,175,146,14,132,26,3,49,41,1,3,3,1
S01009541,Owned: Owned outright,86,46,36,7,29,8,2,40,34,1,1,3,1
S01009541,Owned: Owned with a mortgage or loan or shared ownership,138,129,110,7,103,18,1,9,7,0,2,0,0
S01009541,Rented or living rent free: Total,97,56,41,3,38,10,5,41,30,0,2,7,2
S01009541,Rented or living rent free: Social rented,25,8,6,0,6,0,2,17,13,0,1,2,1
S01009541,Rented or living rent free: Private rented or living rent free,72,48,35,3,32,10,3,24,17,0,1,5,1
S01009542,All HRPs aged 16 and over,380,252,172,44,128,24,56,128,72,3,15,27,11
S01009542,Owned: Total,124,88,73,11,62,11,4,36,32,0,0,2,2
S01009542,Owned: Owned outright,50,20,14,5,9,3,3,30,29,0,0,1,0
S01009542,Owned: Owned with a mortgage or loan or shared ownership,74,68,59,6,53,8,1,6,3,0,0,1,2
S01009542,Rented or living rent free: Total,256,164,99,33,66,13,52,92,40,3,15,25,9
S01009542,Rented or living rent free: Social rented,226,142,87,30,57,11,44,84,35,3,14,23,9
S01009542,Rented or living rent free: Private rented or living rent free,30,22,12,3,9,2,8,8,5,0,1,2,0
S01009543,All HRPs aged 16 and over,279,148,120,21,99,23,5,131,112,2,2,11,4
S01009543,Owned: Total,170,96,77,10,67,18,1,74,73,0,0,1,0
S01009543,Owned: Owned outright,96,33,27,5,22,6,0,63,63,0,0,0,0
S01009543,Owned: Owned with a mortgage or loan or shared ownership,74,63,50,5,45,12,1,11,10,0,0,1,0
S01009543,Rented or living rent free: Total,109,52,43,11,32,5,4,57,39,2,2,10,4
S01009543,Rented or living rent free: Social rented,78,31,26,8,18,2,3,47,35,1,0,7,4
S01009543,Rented or living rent free: Private rented or living rent free,31,21,17,3,14,3,1,10,4,1,2,3,0
S01009544,All HRPs aged 16 and over,432,267,218,34,184,33,16,165,128,3,4,23,7
S01009544,Owned: Total,197,146,121,15,106,20,5,51,46,0,0,1,4
S01009544,Owned: Owned outright,78,37,27,7,20,9,1,41,40,0,0,0,1
S01009544,Owned: Owned with a mortgage or loan or shared ownership,119,109,94,8,86,11,4,10,6,0,0,1,3
S01009544,Rented or living rent free: Total,235,121,97,19,78,13,11,114,82,3,4,22,3
S01009544,Rented or living rent free: Social rented,135,60,51,14,37,6,3,75,51,2,0,21,1
S01009544,Rented or living rent free: Private rented or living rent free,100,61,46,5,41,7,8,39,31,1,4,1,2
S01009545,All HRPs aged 16 and over,344,213,168,23,145,33,12,131,97,1,10,19,4
S01009545,Owned: Total,208,140,113,12,101,24,3,68,61,0,0,6,1
S01009545,Owned: Owned outright,109,50,33,4,29,15,2,59,54,0,0,5,0
S01009545,Owned: Owned with a mortgage or loan or shared ownership,99,90,80,8,72,9,1,9,7,0,0,1,1
S01009545,Rented or living rent free: Total,136,73,55,11,44,9,9,63,36,1,10,13,3
S01009545,Rented or living rent free: Social rented,96,43,30,6,24,6,7,53,32,0,6,12,3
S01009545,Rented or living rent free: Private rented or living rent free,40,30,25,5,20,3,2,10,4,1,4,1,0
S01009546,All HRPs aged 16 and over,414,313,263,33,230,28,22,101,71,0,4,19,7
S01009546,Owned: Total,278,231,206,15,191,23,2,47,41,0,0,4,2
S01009546,Owned: Owned outright,77,37,32,3,29,5,0,40,35,0,0,3,2
S01009546,Owned: Owned with a mortgage or loan or shared ownership,201,194,174,12,162,18,2,7,6,0,0,1,0
S01009546,Rented or living rent free: Total,136,82,57,18,39,5,20,54,30,0,4,15,5
S01009546,Rented or living rent free: Social rented,121,72,48,16,32,4,20,49,26,0,3,15,5
S01009546,Rented or living rent free: Private rented or living rent free,15,10,9,2,7,1,0,5,4,0,1,0,0
S01009547,All HRPs aged 16 and over,337,227,176,45,131,28,23,110,73,6,12,14,5
S01009547,Owned: Total,174,115,88,12,76,25,2,59,51,0,2,5,1
S01009547,Owned: Owned outright,93,41,30,6,24,11,0,52,46,0,2,4,0
S01009547,Owned: Owned with a mortgage or loan or shared ownership,81,74,58,6,52,14,2,7,5,0,0,1,1
S01009547,Rented or living rent free: Total,163,112,88,33,55,3,21,51,22,6,10,9,4
S01009547,Rented or living rent free: Social rented,114,71,50,26,24,3,18,43,19,6,8,8,2
S01009547,Rented or living rent free: Private rented or living rent free,49,41,38,7,31,0,3,8,3,0,2,1,2
S01009548,All HRPs aged 16 and over,317,194,160,30,130,20,14,123,97,1,5,13,7
S01009548,Owned: Total,197,129,112,17,95,16,1,68,61,0,1,4,2
S01009548,Owned: Owned outright,92,34,27,5,22,6,1,58,55,0,0,1,2
S01009548,Owned: Owned with a mortgage or loan or shared ownership,105,95,85,12,73,10,0,10,6,0,1,3,0
S01009548,Rented or living rent free: Total,120,65,48,13,35,4,13,55,36,1,4,9,5
S01009548,Rented or living rent free: Social rented,80,46,34,9,25,1,11,34,24,0,2,7,1
S01009548,Rented or living rent free: Private rented or living rent free,40,19,14,4,10,3,2,21,12,1,2,2,4
S01009549,All HRPs aged 16 and over,348,231,191,26,165,27,13,117,94,2,8,12,1
S01009549,Owned: Total,256,175,149,15,134,22,4,81,73,1,3,3,1
S01009549,Owned: Owned outright,118,49,42,13,29,6,1,69,64,1,1,2,1
S01009549,Owned: Owned with a mortgage or loan or shared ownership,138,126,107,2,105,16,3,12,9,0,2,1,0
S01009549,Rented or living rent free: Total,92,56,42,11,31,5,9,36,21,1,5,9,0
S01009549,Rented or living rent free: Social rented,52,24,18,5,13,1,5,28,17,1,2,8,0
S01009549,Rented or living rent free: Private rented or living rent free,40,32,24,6,18,4,4,8,4,0,3,1,0
S01009550,All HRPs aged 16 and over,208,136,119,16,103,14,3,72,63,0,3,5,1
S01009550,Owned: Total,173,120,106,13,93,13,1,53,51,0,1,1,0
S01009550,Owned: Owned outright,76,27,23,3,20,3,1,49,49,0,0,0,0
S01009550,Owned: Owned with a mortgage or loan or shared ownership,97,93,83,10,73,10,0,4,2,0,1,1,0
S01009550,Rented or living rent free: Total,35,16,13,3,10,1,2,19,12,0,2,4,1
S01009550,Rented or living rent free: Social rented,22,8,6,1,5,1,1,14,8,0,2,3,1
S01009550,Rented or living rent free: Private rented or living rent free,13,8,7,2,5,0,1,5,4,0,0,1,0
S01009551,All HRPs aged 16 and over,229,157,133,27,106,13,11,72,62,1,3,5,1
S01009551,Owned: Total,159,113,102,20,82,10,1,46,44,1,0,1,0
S01009551,Owned: Owned outright,61,25,23,6,17,2,0,36,36,0,0,0,0
S01009551,Owned: Owned with a mortgage or loan or shared ownership,98,88,79,14,65,8,1,10,8,1,0,1,0
S01009551,Rented or living rent free: Total,70,44,31,7,24,3,10,26,18,0,3,4,1
S01009551,Rented or living rent free: Social rented,29,9,5,1,4,0,4,20,17,0,0,3,0
S01009551,Rented or living rent free: Private rented or living rent free,41,35,26,6,20,3,6,6,1,0,3,1,1
S01009552,All HRPs aged 16 and over,398,252,202,27,175,36,14,146,128,1,6,9,2
S01009552,Owned: Total,268,177,143,15,128,32,2,91,90,0,0,0,1
S01009552,Owned: Owned outright,127,52,38,10,28,13,1,75,75,0,0,0,0
S01009552,Owned: Owned with a mortgage or loan or shared ownership,141,125,105,5,100,19,1,16,15,0,0,0,1
S01009552,Rented or living rent free: Total,130,75,59,12,47,4,12,55,38,1,6,9,1
S01009552,Rented or living rent free: Social rented,99,57,46,10,36,1,10,42,28,1,5,7,1
S01009552,Rented or living rent free: Private rented or living rent free,31,18,13,2,11,3,2,13,10,0,1,2,0
S01009553,All HRPs aged 16 and over,421,247,189,40,149,24,34,174,112,5,16,30,11
S01009553,Owned: Total,183,130,104,12,92,19,7,53,50,0,1,1,1
S01009553,Owned: Owned outright,75,29,22,6,16,3,4,46,44,0,1,1,0
S01009553,Owned: Owned with a mortgage or loan or shared ownership,108,101,82,6,76,16,3,7,6,0,0,0,1
S01009553,Rented or living rent free: Total,238,117,85,28,57,5,27,121,62,5,15,29,10
S01009553,Rented or living rent free: Social rented,201,93,63,19,44,3,27,108,56,3,13,26,10
S01009553,Rented or living rent free: Private rented or living rent free,37,24,22,9,13,2,0,13,6,2,2,3,0
S01009554,All HRPs aged 16 and over,311,204,148,40,108,28,28,107,73,3,9,13,9
S01009554,Owned: Total,163,112,86,15,71,21,5,51,46,2,0,1,2
S01009554,Owned: Owned outright,83,38,28,9,19,10,0,45,41,2,0,1,1
S01009554,Owned: Owned with a mortgage or loan or shared ownership,80,74,58,6,52,11,5,6,5,0,0,0,1
S01009554,Rented or living rent free: Total,148,92,62,25,37,7,23,56,27,1,9,12,7
S01009554,Rented or living rent free: Social rented,109,67,43,19,24,4,20,42,20,1,7,8,6
S01009554,Rented or living rent free: Private rented or living rent free,39,25,19,6,13,3,3,14,7,0,2,4,1
S01009555,All HRPs aged 16 and over,364,241,176,28,148,44,21,123,99,0,7,10,7
S01009555,Owned: Total,245,170,128,14,114,37,5,75,70,0,0,2,3
S01009555,Owned: Owned outright,115,49,25,4,21,23,1,66,62,0,0,1,3
S01009555,Owned: Owned with a mortgage or loan or shared ownership,130,121,103,10,93,14,4,9,8,0,0,1,0
S01009555,Rented or living rent free: Total,119,71,48,14,34,7,16,48,29,0,7,8,4
S01009555,Rented or living rent free: Social rented,59,27,17,6,11,0,10,32,18,0,4,7,3
S01009555,Rented or living rent free: Private rented or living rent free,60,44,31,8,23,7,6,16,11,0,3,1,1
S01009556,All HRPs aged 16 and over,338,236,199,35,164,14,23,102,67,3,6,22,4
S01009556,Owned: Total,173,132,119,11,108,11,2,41,40,0,0,0,1
S01009556,Owned: Owned outright,62,25,20,6,14,4,1,37,36,0,0,0,1
S01009556,Owned: Owned with a mortgage or loan or shared ownership,111,107,99,5,94,7,1,4,4,0,0,0,0
S01009556,Rented or living rent free: Total,165,104,80,24,56,3,21,61,27,3,6,22,3
S01009556,Rented or living rent free: Social rented,134,79,59,22,37,1,19,55,26,2,4,21,2
S01009556,Rented or living rent free: Private rented or living rent free,31,25,21,2,19,2,2,6,1,1,2,1,1
S01009557,All HRPs aged 16 and over,300,189,145,34,111,14,30,111,66,0,13,26,6
S01009557,Owned: Total,145,93,83,17,66,9,1,52,46,0,2,3,1
S01009557,Owned: Owned outright,62,18,16,5,11,2,0,44,41,0,0,2,1
S01009557,Owned: Owned with a mortgage or loan or shared ownership,83,75,67,12,55,7,1,8,5,0,2,1,0
S01009557,Rented or living rent free: Total,155,96,62,17,45,5,29,59,20,0,11,23,5
S01009557,Rented or living rent free: Social rented,112,63,39,14,25,3,21,49,17,0,6,22,4
S01009557,Rented or living rent free: Private rented or living rent free,43,33,23,3,20,2,8,10,3,0,5,1,1
S01009558,All HRPs aged 16 and over,291,192,151,31,120,10,31,99,58,3,10,23,5
S01009558,Owned: Total,142,99,94,11,83,4,1,43,40,0,0,3,0
S01009558,Owned: Owned outright,59,25,22,6,16,3,0,34,33,0,0,1,0
S01009558,Owned: Owned with a mortgage or loan or shared ownership,83,74,72,5,67,1,1,9,7,0,0,2,0
S01009558,Rented or living rent free: Total,149,93,57,20,37,6,30,56,18,3,10,20,5
S01009558,Rented or living rent free: Social rented,108,59,40,17,23,3,16,49,17,2,9,18,3
S01009558,Rented or living rent free: Private rented or living rent free,41,34,17,3,14,3,14,7,1,1,1,2,2
S01009559,All HRPs aged 16 and over,374,236,189,35,154,19,28,138,78,0,17,37,6
S01009559,Owned: Total,198,147,130,13,117,11,6,51,47,0,2,1,1
S01009559,Owned: Owned outright,82,40,35,8,27,4,1,42,40,0,1,0,1
S01009559,Owned: Owned with a mortgage or loan or shared ownership,116,107,95,5,90,7,5,9,7,0,1,1,0
S01009559,Rented or living rent free: Total,176,89,59,22,37,8,22,87,31,0,15,36,5
S01009559,Rented or living rent free: Social rented,131,60,38,14,24,5,17,71,30,0,8,28,5
S01009559,Rented or living rent free: Private rented or living rent free,45,29,21,8,13,3,5,16,1,0,7,8,0
S01009560,All HRPs aged 16 and over,351,211,170,34,136,13,28,140,78,5,19,30,8
S01009560,Owned: Total,178,121,107,14,93,10,4,57,52,0,1,3,1
S01009560,Owned: Owned outright,79,31,24,7,17,6,1,48,46,0,0,1,1
S01009560,Owned: Owned with a mortgage or loan or shared ownership,99,90,83,7,76,4,3,9,6,0,1,2,0
S01009560,Rented or living rent free: Total,173,90,63,20,43,3,24,83,26,5,18,27,7
S01009560,Rented or living rent free: Social rented,100,49,32,12,20,1,16,51,21,0,11,16,3
S01009560,Rented or living rent free: Private rented or living rent free,73,41,31,8,23,2,8,32,5,5,7,11,4
S01009561,All HRPs aged 16 and over,258,148,113,30,83,14,21,110,71,3,7,19,10
S01009561,Owned: Total,127,79,65,10,55,8,6,48,44,1,1,1,1
S01009561,Owned: Owned outright,53,14,11,5,6,0,3,39,37,0,0,1,1
S01009561,Owned: Owned with a mortgage or loan or shared ownership,74,65,54,5,49,8,3,9,7,1,1,0,0
S01009561,Rented or living rent free: Total,131,69,48,20,28,6,15,62,27,2,6,18,9
S01009561,Rented or living rent free: Social rented,84,38,26,12,14,4,8,46,26,0,1,12,7
S01009561,Rented or living rent free: Private rented or living rent free,47,31,22,8,14,2,7,16,1,2,5,6,2
S01009562,All HRPs aged 16 and over,316,197,175,21,154,12,10,119,97,3,7,9,3
S01009562,Owned: Total,228,150,136,15,121,11,3,78,76,0,0,2,0
S01009562,Owned: Owned outright,111,39,35,7,28,1,3,72,72,0,0,0,0
S01009562,Owned: Owned with a mortgage or loan or shared ownership,117,111,101,8,93,10,0,6,4,0,0,2,0
S01009562,Rented or living rent free: Total,88,47,39,6,33,1,7,41,21,3,7,7,3
S01009562,Rented or living rent free: Social rented,52,22,18,5,13,0,4,30,17,3,3,5,2
S01009562,Rented or living rent free: Private rented or living rent free,36,25,21,1,20,1,3,11,4,0,4,2,1
S01009563,All HRPs aged 16 and over,373,200,174,26,148,16,10,173,147,0,10,12,4
S01009563,Owned: Total,250,132,117,15,102,13,2,118,115,0,0,2,1
S01009563,Owned: Owned outright,136,30,27,9,18,1,2,106,103,0,0,2,1
S01009563,Owned: Owned with a mortgage or loan or shared ownership,114,102,90,6,84,12,0,12,12,0,0,0,0
S01009563,Rented or living rent free: Total,123,68,57,11,46,3,8,55,32,0,10,10,3
S01009563,Rented or living rent free: Social rented,62,26,18,3,15,3,5,36,22,0,5,6,3
S01009563,Rented or living rent free: Private rented or living rent free,61,42,39,8,31,0,3,19,10,0,5,4,0
S01009564,All HRPs aged 16 and over,315,157,139,17,122,13,5,158,143,1,5,6,3
S01009564,Owned: Total,220,128,115,12,103,12,1,92,90,0,0,1,1
S01009564,Owned: Owned outright,120,33,30,4,26,3,0,87,85,0,0,1,1
S01009564,Owned: Owned with a mortgage or loan or shared ownership,100,95,85,8,77,9,1,5,5,0,0,0,0
S01009564,Rented or living rent free: Total,95,29,24,5,19,1,4,66,53,1,5,5,2
S01009564,Rented or living rent free: Social rented,71,13,11,4,7,0,2,58,51,1,0,4,2
S01009564,Rented or living rent free: Private rented or living rent free,24,16,13,1,12,1,2,8,2,0,5,1,0
S01009565,All HRPs aged 16 and over,246,150,126,23,103,10,14,96,58,1,8,24,5
S01009565,Owned: Total,154,102,92,11,81,7,3,52,47,0,1,3,1
S01009565,Owned: Owned outright,74,24,20,3,17,2,2,50,46,0,1,3,0
S01009565,Owned: Owned with a mortgage or loan or shared ownership,80,78,72,8,64,5,1,2,1,0,0,0,1
S01009565,Rented or living rent free: Total,92,48,34,12,22,3,11,44,11,1,7,21,4
S01009565,Rented or living rent free: Social rented,61,27,19,5,14,2,6,34,10,1,3,18,2
S01009565,Rented or living rent free: Private rented or living rent free,31,21,15,7,8,1,5,10,1,0,4,3,2
S01009566,All HRPs aged 16 and over,431,309,273,30,243,24,12,122,98,5,9,6,4
S01009566,Owned: Total,320,249,225,16,209,20,4,71,69,0,0,1,1
S01009566,Owned: Owned outright,113,47,41,6,35,4,2,66,64,0,0,1,1
S01009566,Owned: Owned with a mortgage or loan or shared ownership,207,202,184,10,174,16,2,5,5,0,0,0,0
S01009566,Rented or living rent free: Total,111,60,48,14,34,4,8,51,29,5,9,5,3
S01009566,Rented or living rent free: Social rented,64,28,22,4,18,3,3,36,24,1,6,3,2
S01009566,Rented or living rent free: Private rented or living rent free,47,32,26,10,16,1,5,15,5,4,3,2,1
S01009567,All HRPs aged 16 and over,414,262,217,33,184,19,26,152,119,4,6,19,4
S01009567,Owned: Total,267,192,172,21,151,15,5,75,73,0,0,2,0
S01009567,Owned: Owned outright,117,52,44,11,33,6,2,65,64,0,0,1,0
S01009567,Owned: Owned with a mortgage or loan or shared ownership,150,140,128,10,118,9,3,10,9,0,0,1,0
S01009567,Rented or living rent free: Total,147,70,45,12,33,4,21,77,46,4,6,17,4
S01009567,Rented or living rent free: Social rented,77,23,12,5,7,2,9,54,42,1,2,7,2
S01009567,Rented or living rent free: Private rented or living rent free,70,47,33,7,26,2,12,23,4,3,4,10,2
S01009568,All HRPs aged 16 and over,333,191,160,24,136,21,10,142,104,5,6,24,3
S01009568,Owned: Total,218,148,126,15,111,18,4,70,62,2,0,6,0
S01009568,Owned: Owned outright,85,26,19,5,14,5,2,59,55,0,0,4,0
S01009568,Owned: Owned with a mortgage or loan or shared ownership,133,122,107,10,97,13,2,11,7,2,0,2,0
S01009568,Rented or living rent free: Total,115,43,34,9,25,3,6,72,42,3,6,18,3
S01009568,Rented or living rent free: Social rented,85,24,20,4,16,2,2,61,40,0,3,17,1
S01009568,Rented or living rent free: Private rented or living rent free,30,19,14,5,9,1,4,11,2,3,3,1,2
S01009569,All HRPs aged 16 and over,363,210,193,32,161,7,10,153,123,1,2,21,6
S01009569,Owned: Total,253,159,151,25,126,5,3,94,87,0,1,4,2
S01009569,Owned: Owned outright,125,45,41,14,27,1,3,80,78,0,0,2,0
S01009569,Owned: Owned with a mortgage or loan or shared ownership,128,114,110,11,99,4,0,14,9,0,1,2,2
S01009569,Rented or living rent free: Total,110,51,42,7,35,2,7,59,36,1,1,17,4
S01009569,Rented or living rent free: Social rented,68,19,14,2,12,1,4,49,30,0,1,17,1
S01009569,Rented or living rent free: Private rented or living rent free,42,32,28,5,23,1,3,10,6,1,0,0,3
S01009570,All HRPs aged 16 and over,240,142,122,13,109,13,7,98,77,4,8,8,1
S01009570,Owned: Total,148,103,93,8,85,9,1,45,45,0,0,0,0
S01009570,Owned: Owned outright,62,22,19,2,17,3,0,40,40,0,0,0,0
S01009570,Owned: Owned with a mortgage or loan or shared ownership,86,81,74,6,68,6,1,5,5,0,0,0,0
S01009570,Rented or living rent free: Total,92,39,29,5,24,4,6,53,32,4,8,8,1
S01009570,Rented or living rent free: Social rented,65,22,16,3,13,2,4,43,31,2,3,6,1
S01009570,Rented or living rent free: Private rented or living rent free,27,17,13,2,11,2,2,10,1,2,5,2,0
S01009571,All HRPs aged 16 and over,297,183,138,29,109,11,34,114,57,5,19,24,9
S01009571,Owned: Total,121,88,74,8,66,9,5,33,27,1,1,2,2
S01009571,Owned: Owned outright,48,20,18,2,16,0,2,28,23,1,1,2,1
S01009571,Owned: Owned with a mortgage or loan or shared ownership,73,68,56,6,50,9,3,5,4,0,0,0,1
S01009571,Rented or living rent free: Total,176,95,64,21,43,2,29,81,30,4,18,22,7
S01009571,Rented or living rent free: Social rented,116,51,35,11,24,0,16,65,29,4,8,17,7
S01009571,Rented or living rent free: Private rented or living rent free,60,44,29,10,19,2,13,16,1,0,10,5,0
S01009572,All HRPs aged 16 and over,499,293,234,45,189,21,38,206,124,3,10,50,19
S01009572,Owned: Total,225,146,131,17,114,13,2,79,73,0,1,4,1
S01009572,Owned: Owned outright,92,29,25,6,19,3,1,63,60,0,0,2,1
S01009572,Owned: Owned with a mortgage or loan or shared ownership,133,117,106,11,95,10,1,16,13,0,1,2,0
S01009572,Rented or living rent free: Total,274,147,103,28,75,8,36,127,51,3,9,46,18
S01009572,Rented or living rent free: Social rented,206,92,59,20,39,6,27,114,47,3,5,46,13
S01009572,Rented or living rent free: Private rented or living rent free,68,55,44,8,36,2,9,13,4,0,4,0,5
S01009573,All HRPs aged 16 and over,329,196,157,32,125,7,32,133,86,3,13,28,3
S01009573,Owned: Total,158,99,92,11,81,4,3,59,52,2,0,4,1
S01009573,Owned: Owned outright,74,23,20,5,15,1,2,51,48,0,0,2,1
S01009573,Owned: Owned with a mortgage or loan or shared ownership,84,76,72,6,66,3,1,8,4,2,0,2,0
S01009573,Rented or living rent free: Total,171,97,65,21,44,3,29,74,34,1,13,24,2
S01009573,Rented or living rent free: Social rented,125,62,38,13,25,1,23,63,30,1,9,21,2
S01009573,Rented or living rent free: Private rented or living rent free,46,35,27,8,19,2,6,11,4,0,4,3,0
S01009574,All HRPs aged 16 and over,447,271,226,41,185,26,19,176,138,3,8,23,4
S01009574,Owned: Total,273,183,154,21,133,23,6,90,84,0,1,4,1
S01009574,Owned: Owned outright,134,50,43,10,33,6,1,84,79,0,1,3,1
S01009574,Owned: Owned with a mortgage or loan or shared ownership,139,133,111,11,100,17,5,6,5,0,0,1,0
S01009574,Rented or living rent free: Total,174,88,72,20,52,3,13,86,54,3,7,19,3
S01009574,Rented or living rent free: Social rented,117,45,38,17,21,1,6,72,47,2,2,18,3
S01009574,Rented or living rent free: Private rented or living rent free,57,43,34,3,31,2,7,14,7,1,5,1,0
S01009575,All HRPs aged 16 and over,232,145,126,17,109,10,9,87,77,0,2,6,2
S01009575,Owned: Total,146,115,110,12,98,3,2,31,30,0,0,0,1
S01009575,Owned: Owned outright,53,27,25,7,18,0,2,26,26,0,0,0,0
S01009575,Owned: Owned with a mortgage or loan or shared ownership,93,88,85,5,80,3,0,5,4,0,0,0,1
S01009575,Rented or living rent free: Total,86,30,16,5,11,7,7,56,47,0,2,6,1
S01009575,Rented or living rent free: Social rented,68,17,11,5,6,4,2,51,45,0,1,4,1
S01009575,Rented or living rent free: Private rented or living rent free,18,13,5,0,5,3,5,5,2,0,1,2,0
S01009576,All HRPs aged 16 and over,223,154,134,12,122,20,0,69,58,1,5,4,1
S01009576,Owned: Total,202,142,122,12,110,20,0,60,55,1,1,3,0
S01009576,Owned: Owned outright,104,57,48,7,41,9,0,47,44,0,1,2,0
S01009576,Owned: Owned with a mortgage or loan or shared ownership,98,85,74,5,69,11,0,13,11,1,0,1,0
S01009576,Rented or living rent free: Total,21,12,12,0,12,0,0,9,3,0,4,1,1
S01009576,Rented or living rent free: Social rented,3,0,0,0,0,0,0,3,1,0,0,1,1
S01009576,Rented or living rent free: Private rented or living rent free,18,12,12,0,12,0,0,6,2,0,4,0,0
S01009577,All HRPs aged 16 and over,253,187,159,23,136,25,3,66,52,0,3,11,0
S01009577,Owned: Total,218,167,142,19,123,22,3,51,47,0,1,3,0
S01009577,Owned: Owned outright,91,47,37,10,27,9,1,44,41,0,0,3,0
S01009577,Owned: Owned with a mortgage or loan or shared ownership,127,120,105,9,96,13,2,7,6,0,1,0,0
S01009577,Rented or living rent free: Total,35,20,17,4,13,3,0,15,5,0,2,8,0
S01009577,Rented or living rent free: Social rented,23,13,12,4,8,1,0,10,2,0,1,7,0
S01009577,Rented or living rent free: Private rented or living rent free,12,7,5,0,5,2,0,5,3,0,1,1,0
S01009578,All HRPs aged 16 and over,312,230,198,28,170,20,12,82,59,1,13,6,3
S01009578,Owned: Total,220,179,158,17,141,19,2,41,36,1,1,2,1
S01009578,Owned: Owned outright,73,40,35,7,28,4,1,33,30,1,0,1,1
S01009578,Owned: Owned with a mortgage or loan or shared ownership,147,139,123,10,113,15,1,8,6,0,1,1,0
S01009578,Rented or living rent free: Total,92,51,40,11,29,1,10,41,23,0,12,4,2
S01009578,Rented or living rent free: Social rented,50,22,17,6,11,0,5,28,20,0,5,2,1
S01009578,Rented or living rent free: Private rented or living rent free,42,29,23,5,18,1,5,13,3,0,7,2,1
S01009579,All HRPs aged 16 and over,443,311,257,22,235,31,23,132,83,1,9,36,3
S01009579,Owned: Total,222,175,151,10,141,24,0,47,40,0,2,4,1
S01009579,Owned: Owned outright,72,35,28,7,21,7,0,37,33,0,1,3,0
S01009579,Owned: Owned with a mortgage or loan or shared ownership,150,140,123,3,120,17,0,10,7,0,1,1,1
S01009579,Rented or living rent free: Total,221,136,106,12,94,7,23,85,43,1,7,32,2
S01009579,Rented or living rent free: Social rented,197,120,93,11,82,6,21,77,41,1,4,29,2
S01009579,Rented or living rent free: Private rented or living rent free,24,16,13,1,12,1,2,8,2,0,3,3,0
S01009580,All HRPs aged 16 and over,355,292,255,24,231,34,3,63,57,1,0,3,2
S01009580,Owned: Total,325,267,234,20,214,31,2,58,56,0,0,0,2
S01009580,Owned: Owned outright,101,49,40,6,34,8,1,52,50,0,0,0,2
S01009580,Owned: Owned with a mortgage or loan or shared ownership,224,218,194,14,180,23,1,6,6,0,0,0,0
S01009580,Rented or living rent free: Total,30,25,21,4,17,3,1,5,1,1,0,3,0
S01009580,Rented or living rent free: Social rented,10,6,4,1,3,2,0,4,0,1,0,3,0
S01009580,Rented or living rent free: Private rented or living rent free,20,19,17,3,14,1,1,1,1,0,0,0,0
S01009581,All HRPs aged 16 and over,258,165,135,17,118,17,13,93,71,1,4,15,2
S01009581,Owned: Total,183,118,104,11,93,12,2,65,62,0,1,2,0
S01009581,Owned: Owned outright,86,35,28,9,19,7,0,51,50,0,0,1,0
S01009581,Owned: Owned with a mortgage or loan or shared ownership,97,83,76,2,74,5,2,14,12,0,1,1,0
S01009581,Rented or living rent free: Total,75,47,31,6,25,5,11,28,9,1,3,13,2
S01009581,Rented or living rent free: Social rented,44,18,9,2,7,2,7,26,8,1,3,13,1
S01009581,Rented or living rent free: Private rented or living rent free,31,29,22,4,18,3,4,2,1,0,0,0,1
S01009582,All HRPs aged 16 and over,240,161,130,24,106,17,14,79,71,0,2,3,3
S01009582,Owned: Total,160,115,97,12,85,14,4,45,45,0,0,0,0
S01009582,Owned: Owned outright,65,25,19,4,15,5,1,40,40,0,0,0,0
S01009582,Owned: Owned with a mortgage or loan or shared ownership,95,90,78,8,70,9,3,5,5,0,0,0,0
S01009582,Rented or living rent free: Total,80,46,33,12,21,3,10,34,26,0,2,3,3
S01009582,Rented or living rent free: Social rented,48,17,14,7,7,2,1,31,25,0,0,3,3
S01009582,Rented or living rent free: Private rented or living rent free,32,29,19,5,14,1,9,3,1,0,2,0,0
S01009583,All HRPs aged 16 and over,336,230,194,38,156,20,16,106,80,4,6,13,3
S01009583,Owned: Total,204,154,138,16,122,15,1,50,48,0,0,2,0
S01009583,Owned: Owned outright,68,31,28,7,21,3,0,37,35,0,0,2,0
S01009583,Owned: Owned with a mortgage or loan or shared ownership,136,123,110,9,101,12,1,13,13,0,0,0,0
S01009583,Rented or living rent free: Total,132,76,56,22,34,5,15,56,32,4,6,11,3
S01009583,Rented or living rent free: Social rented,91,49,36,12,24,3,10,42,29,1,1,9,2
S01009583,Rented or living rent free: Private rented or living rent free,41,27,20,10,10,2,5,14,3,3,5,2,1
S01009584,All HRPs aged 16 and over,219,130,99,10,89,28,3,89,83,2,0,4,0
S01009584,Owned: Total,182,101,80,8,72,20,1,81,81,0,0,0,0
S01009584,Owned: Owned outright,93,22,15,3,12,6,1,71,71,0,0,0,0
S01009584,Owned: Owned with a mortgage or loan or shared ownership,89,79,65,5,60,14,0,10,10,0,0,0,0
S01009584,Rented or living rent free: Total,37,29,19,2,17,8,2,8,2,2,0,4,0
S01009584,Rented or living rent free: Social rented,9,5,2,0,2,2,1,4,1,1,0,2,0
S01009584,Rented or living rent free: Private rented or living rent free,28,24,17,2,15,6,1,4,1,1,0,2,0
S01009585,All HRPs aged 16 and over,408,279,241,32,209,22,16,129,81,5,15,19,9
S01009585,Owned: Total,272,209,188,19,169,15,6,63,52,1,1,3,6
S01009585,Owned: Owned outright,102,49,40,12,28,7,2,53,47,0,1,1,4
S01009585,Owned: Owned with a mortgage or loan or shared ownership,170,160,148,7,141,8,4,10,5,1,0,2,2
S01009585,Rented or living rent free: Total,136,70,53,13,40,7,10,66,29,4,14,16,3
S01009585,Rented or living rent free: Social rented,91,43,33,5,28,3,7,48,27,1,6,12,2
S01009585,Rented or living rent free: Private rented or living rent free,45,27,20,8,12,4,3,18,2,3,8,4,1
S01009586,All HRPs aged 16 and over,313,150,132,21,111,14,4,163,131,1,5,23,3
S01009586,Owned: Total,204,123,108,16,92,13,2,81,72,0,0,7,2
S01009586,Owned: Owned outright,106,38,32,9,23,5,1,68,62,0,0,5,1
S01009586,Owned: Owned with a mortgage or loan or shared ownership,98,85,76,7,69,8,1,13,10,0,0,2,1
S01009586,Rented or living rent free: Total,109,27,24,5,19,1,2,82,59,1,5,16,1
S01009586,Rented or living rent free: Social rented,85,14,13,4,9,0,1,71,54,1,3,13,0
S01009586,Rented or living rent free: Private rented or living rent free,24,13,11,1,10,1,1,11,5,0,2,3,1
S01009587,All HRPs aged 16 and over,370,189,154,27,127,17,18,181,151,3,6,16,5
S01009587,Owned: Total,255,145,125,17,108,16,4,110,108,0,0,1,1
S01009587,Owned: Owned outright,136,39,31,9,22,6,2,97,96,0,0,0,1
S01009587,Owned: Owned with a mortgage or loan or shared ownership,119,106,94,8,86,10,2,13,12,0,0,1,0
S01009587,Rented or living rent free: Total,115,44,29,10,19,1,14,71,43,3,6,15,4
S01009587,Rented or living rent free: Social rented,79,23,13,7,6,1,9,56,35,1,3,14,3
S01009587,Rented or living rent free: Private rented or living rent free,36,21,16,3,13,0,5,15,8,2,3,1,1
S01009588,All HRPs aged 16 and over,436,269,236,51,185,20,13,167,146,2,3,13,3
S01009588,Owned: Total,306,201,181,24,157,19,1,105,102,0,1,1,1
S01009588,Owned: Owned outright,141,53,47,9,38,5,1,88,88,0,0,0,0
S01009588,Owned: Owned with a mortgage or loan or shared ownership,165,148,134,15,119,14,0,17,14,0,1,1,1
S01009588,Rented or living rent free: Total,130,68,55,27,28,1,12,62,44,2,2,12,2
S01009588,Rented or living rent free: Social rented,97,45,36,19,17,0,9,52,36,1,2,12,1
S01009588,Rented or living rent free: Private rented or living rent free,33,23,19,8,11,1,3,10,8,1,0,0,1
S01009589,All HRPs aged 16 and over,356,237,211,37,174,17,9,119,96,3,8,9,3
S01009589,Owned: Total,255,175,159,19,140,15,1,80,73,2,1,3,1
S01009589,Owned: Owned outright,96,29,27,8,19,1,1,67,64,0,0,2,1
S01009589,Owned: Owned with a mortgage or loan or shared ownership,159,146,132,11,121,14,0,13,9,2,1,1,0
S01009589,Rented or living rent free: Total,101,62,52,18,34,2,8,39,23,1,7,6,2
S01009589,Rented or living rent free: Social rented,79,46,36,13,23,2,8,33,22,0,4,6,1
S01009589,Rented or living rent free: Private rented or living rent free,22,16,16,5,11,0,0,6,1,1,3,0,1
S01009590,All HRPs aged 16 and over,267,196,172,18,154,22,2,71,70,0,0,1,0
S01009590,Owned: Total,257,188,164,17,147,22,2,69,69,0,0,0,0
S01009590,Owned: Owned outright,102,40,36,11,25,3,1,62,62,0,0,0,0
S01009590,Owned: Owned with a mortgage or loan or shared ownership,155,148,128,6,122,19,1,7,7,0,0,0,0
S01009590,Rented or living rent free: Total,10,8,8,1,7,0,0,2,1,0,0,1,0
S01009590,Rented or living rent free: Social rented,4,2,2,0,2,0,0,2,1,0,0,1,0
S01009590,Rented or living rent free: Private rented or living rent free,6,6,6,1,5,0,0,0,0,0,0,0,0
S01009591,All HRPs aged 16 and over,307,227,200,26,174,22,5,80,72,2,1,5,0
S01009591,Owned: Total,268,196,173,24,149,21,2,72,69,1,0,2,0
S01009591,Owned: Owned outright,123,58,49,15,34,7,2,65,63,1,0,1,0
S01009591,Owned: Owned with a mortgage or loan or shared ownership,145,138,124,9,115,14,0,7,6,0,0,1,0
S01009591,Rented or living rent free: Total,39,31,27,2,25,1,3,8,3,1,1,3,0
S01009591,Rented or living rent free: Social rented,5,2,2,0,2,0,0,3,1,0,0,2,0
S01009591,Rented or living rent free: Private rented or living rent free,34,29,25,2,23,1,3,5,2,1,1,1,0
S01009592,All HRPs aged 16 and over,246,144,119,10,109,24,1,102,100,0,0,1,1
S01009592,Owned: Total,225,134,110,7,103,23,1,91,90,0,0,0,1
S01009592,Owned: Owned outright,131,42,34,4,30,7,1,89,88,0,0,0,1
S01009592,Owned: Owned with a mortgage or loan or shared ownership,94,92,76,3,73,16,0,2,2,0,0,0,0
S01009592,Rented or living rent free: Total,21,10,9,3,6,1,0,11,10,0,0,1,0
S01009592,Rented or living rent free: Social rented,8,1,1,1,0,0,0,7,6,0,0,1,0
S01009592,Rented or living rent free: Private rented or living rent free,13,9,8,2,6,1,0,4,4,0,0,0,0
S01009593,All HRPs aged 16 and over,223,163,136,12,124,25,2,60,56,0,2,1,1
S01009593,Owned: Total,204,152,128,10,118,22,2,52,50,0,1,1,0
S01009593,Owned: Owned outright,81,35,30,5,25,5,0,46,45,0,0,1,0
S01009593,Owned: Owned with a mortgage or loan or shared ownership,123,117,98,5,93,17,2,6,5,0,1,0,0
S01009593,Rented or living rent free: Total,19,11,8,2,6,3,0,8,6,0,1,0,1
S01009593,Rented or living rent free: Social rented,5,2,2,0,2,0,0,3,1,0,1,0,1
S01009593,Rented or living rent free: Private rented or living rent free,14,9,6,2,4,3,0,5,5,0,0,0,0
S01009594,All HRPs aged 16 and over,263,209,185,20,165,23,1,54,48,0,2,4,0
S01009594,Owned: Total,250,197,175,20,155,21,1,53,48,0,2,3,0
S01009594,Owned: Owned outright,87,45,41,13,28,3,1,42,41,0,0,1,0
S01009594,Owned: Owned with a mortgage or loan or shared ownership,163,152,134,7,127,18,0,11,7,0,2,2,0
S01009594,Rented or living rent free: Total,13,12,10,0,10,2,0,1,0,0,0,1,0
S01009594,Rented or living rent free: Social rented,2,1,1,0,1,0,0,1,0,0,0,1,0
S01009594,Rented or living rent free: Private rented or living rent free,11,11,9,0,9,2,0,0,0,0,0,0,0
S01009595,All HRPs aged 16 and over,174,149,121,9,112,23,5,25,22,0,0,2,1
S01009595,Owned: Total,154,134,112,8,104,21,1,20,19,0,0,1,0
S01009595,Owned: Owned outright,40,23,19,2,17,3,1,17,16,0,0,1,0
S01009595,Owned: Owned with a mortgage or loan or shared ownership,114,111,93,6,87,18,0,3,3,0,0,0,0
S01009595,Rented or living rent free: Total,20,15,9,1,8,2,4,5,3,0,0,1,1
S01009595,Rented or living rent free: Social rented,11,7,2,1,1,1,4,4,2,0,0,1,1
S01009595,Rented or living rent free: Private rented or living rent free,9,8,7,0,7,1,0,1,1,0,0,0,0
S01009596,All HRPs aged 16 and over,355,241,206,36,170,22,13,114,63,2,12,30,7
S01009596,Owned: Total,188,147,130,17,113,16,1,41,37,0,0,3,1
S01009596,Owned: Owned outright,58,30,26,6,20,3,1,28,26,0,0,1,1
S01009596,Owned: Owned with a mortgage or loan or shared ownership,130,117,104,11,93,13,0,13,11,0,0,2,0
S01009596,Rented or living rent free: Total,167,94,76,19,57,6,12,73,26,2,12,27,6
S01009596,Rented or living rent free: Social rented,131,67,54,13,41,4,9,64,24,1,9,26,4
S01009596,Rented or living rent free: Private rented or living rent free,36,27,22,6,16,2,3,9,2,1,3,1,2
S01009597,All HRPs aged 16 and over,361,257,191,50,141,24,42,104,44,8,14,30,8
S01009597,Owned: Total,129,105,92,17,75,11,2,24,19,0,1,3,1
S01009597,Owned: Owned outright,29,14,12,2,10,2,0,15,12,0,1,1,1
S01009597,Owned: Owned with a mortgage or loan or shared ownership,100,91,80,15,65,9,2,9,7,0,0,2,0
S01009597,Rented or living rent free: Total,232,152,99,33,66,13,40,80,25,8,13,27,7
S01009597,Rented or living rent free: Social rented,192,119,77,27,50,11,31,73,24,7,9,26,7
S01009597,Rented or living rent free: Private rented or living rent free,40,33,22,6,16,2,9,7,1,1,4,1,0
S01009598,All HRPs aged 16 and over,303,192,138,37,101,19,35,111,50,0,15,36,10
S01009598,Owned: Total,56,46,32,5,27,13,1,10,5,0,1,2,2
S01009598,Owned: Owned outright,20,12,9,4,5,2,1,8,5,0,0,1,2
S01009598,Owned: Owned with a mortgage or loan or shared ownership,36,34,23,1,22,11,0,2,0,0,1,1,0
S01009598,Rented or living rent free: Total,247,146,106,32,74,6,34,101,45,0,14,34,8
S01009598,Rented or living rent free: Social rented,237,138,99,31,68,6,33,99,45,0,13,33,8
S01009598,Rented or living rent free: Private rented or living rent free,10,8,7,1,6,0,1,2,0,0,1,1,0
S01009599,All HRPs aged 16 and over,403,261,225,36,189,20,16,142,90,5,4,30,13
S01009599,Owned: Total,236,185,169,16,153,11,5,51,39,0,1,4,7
S01009599,Owned: Owned outright,73,37,35,6,29,2,0,36,29,0,0,1,6
S01009599,Owned: Owned with a mortgage or loan or shared ownership,163,148,134,10,124,9,5,15,10,0,1,3,1
S01009599,Rented or living rent free: Total,167,76,56,20,36,9,11,91,51,5,3,26,6
S01009599,Rented or living rent free: Social rented,126,50,37,14,23,4,9,76,46,2,1,21,6
S01009599,Rented or living rent free: Private rented or living rent free,41,26,19,6,13,5,2,15,5,3,2,5,0
S01009600,All HRPs aged 16 and over,330,173,138,29,109,12,23,157,101,5,9,37,5
S01009600,Owned: Total,95,76,67,8,59,8,1,19,15,0,0,3,1
S01009600,Owned: Owned outright,20,8,8,0,8,0,0,12,11,0,0,0,1
S01009600,Owned: Owned with a mortgage or loan or shared ownership,75,68,59,8,51,8,1,7,4,0,0,3,0
S01009600,Rented or living rent free: Total,235,97,71,21,50,4,22,138,86,5,9,34,4
S01009600,Rented or living rent free: Social rented,199,77,57,19,38,2,18,122,77,5,4,32,4
S01009600,Rented or living rent free: Private rented or living rent free,36,20,14,2,12,2,4,16,9,0,5,2,0
S01009601,All HRPs aged 16 and over,296,210,175,25,150,15,20,86,50,0,6,21,9
S01009601,Owned: Total,163,127,117,12,105,9,1,36,32,0,1,2,1
S01009601,Owned: Owned outright,49,21,18,3,15,3,0,28,27,0,0,1,0
S01009601,Owned: Owned with a mortgage or loan or shared ownership,114,106,99,9,90,6,1,8,5,0,1,1,1
S01009601,Rented or living rent free: Total,133,83,58,13,45,6,19,50,18,0,5,19,8
S01009601,Rented or living rent free: Social rented,87,47,30,9,21,1,16,40,15,0,2,16,7
S01009601,Rented or living rent free: Private rented or living rent free,46,36,28,4,24,5,3,10,3,0,3,3,1
S01009602,All HRPs aged 16 and over,291,244,220,18,202,21,3,47,43,0,2,1,1
S01009602,Owned: Total,271,230,209,17,192,20,1,41,41,0,0,0,0
S01009602,Owned: Owned outright,71,35,29,8,21,5,1,36,36,0,0,0,0
S01009602,Owned: Owned with a mortgage or loan or shared ownership,200,195,180,9,171,15,0,5,5,0,0,0,0
S01009602,Rented or living rent free: Total,20,14,11,1,10,1,2,6,2,0,2,1,1
S01009602,Rented or living rent free: Social rented,8,6,5,1,4,0,1,2,0,0,2,0,0
S01009602,Rented or living rent free: Private rented or living rent free,12,8,6,0,6,1,1,4,2,0,0,1,1
S01009603,All HRPs aged 16 and over,234,167,135,15,120,27,5,67,46,2,5,12,2
S01009603,Owned: Total,178,139,116,12,104,23,0,39,37,0,0,2,0
S01009603,Owned: Owned outright,70,37,31,4,27,6,0,33,32,0,0,1,0
S01009603,Owned: Owned with a mortgage or loan or shared ownership,108,102,85,8,77,17,0,6,5,0,0,1,0
S01009603,Rented or living rent free: Total,56,28,19,3,16,4,5,28,9,2,5,10,2
S01009603,Rented or living rent free: Social rented,44,21,14,3,11,2,5,23,7,2,5,7,2
S01009603,Rented or living rent free: Private rented or living rent free,12,7,5,0,5,2,0,5,2,0,0,3,0
S01009604,All HRPs aged 16 and over,377,252,220,28,192,22,10,125,97,4,4,13,7
S01009604,Owned: Total,239,201,182,22,160,17,2,38,35,0,0,0,3
S01009604,Owned: Owned outright,62,35,31,6,25,4,0,27,26,0,0,0,1
S01009604,Owned: Owned with a mortgage or loan or shared ownership,177,166,151,16,135,13,2,11,9,0,0,0,2
S01009604,Rented or living rent free: Total,138,51,38,6,32,5,8,87,62,4,4,13,4
S01009604,Rented or living rent free: Social rented,107,30,22,3,19,0,8,77,62,1,2,8,4
S01009604,Rented or living rent free: Private rented or living rent free,31,21,16,3,13,5,0,10,0,3,2,5,0
S01009605,All HRPs aged 16 and over,348,193,153,30,123,22,18,155,103,4,6,38,4
S01009605,Owned: Total,131,99,83,10,73,14,2,32,30,0,0,1,1
S01009605,Owned: Owned outright,47,24,20,3,17,4,0,23,21,0,0,1,1
S01009605,Owned: Owned with a mortgage or loan or shared ownership,84,75,63,7,56,10,2,9,9,0,0,0,0
S01009605,Rented or living rent free: Total,217,94,70,20,50,8,16,123,73,4,6,37,3
S01009605,Rented or living rent free: Social rented,201,82,61,18,43,6,15,119,72,3,6,37,1
S01009605,Rented or living rent free: Private rented or living rent free,16,12,9,2,7,2,1,4,1,1,0,0,2
S01009606,All HRPs aged 16 and over,218,180,162,10,152,14,4,38,32,0,1,5,0
S01009606,Owned: Total,194,164,149,5,144,14,1,30,30,0,0,0,0
S01009606,Owned: Owned outright,49,25,20,3,17,5,0,24,24,0,0,0,0
S01009606,Owned: Owned with a mortgage or loan or shared ownership,145,139,129,2,127,9,1,6,6,0,0,0,0
S01009606,Rented or living rent free: Total,24,16,13,5,8,0,3,8,2,0,1,5,0
S01009606,Rented or living rent free: Social rented,11,6,4,2,2,0,2,5,1,0,0,4,0
S01009606,Rented or living rent free: Private rented or living rent free,13,10,9,3,6,0,1,3,1,0,1,1,0
S01009607,All HRPs aged 16 and over,208,137,116,13,103,19,2,71,65,1,2,0,3
S01009607,Owned: Total,189,125,107,9,98,17,1,64,60,0,1,0,3
S01009607,Owned: Owned outright,94,36,33,4,29,3,0,58,55,0,1,0,2
S01009607,Owned: Owned with a mortgage or loan or shared ownership,95,89,74,5,69,14,1,6,5,0,0,0,1
S01009607,Rented or living rent free: Total,19,12,9,4,5,2,1,7,5,1,1,0,0
S01009607,Rented or living rent free: Social rented,9,6,6,4,2,0,0,3,2,0,1,0,0
S01009607,Rented or living rent free: Private rented or living rent free,10,6,3,0,3,2,1,4,3,1,0,0,0
S01009608,All HRPs aged 16 and over,287,180,149,18,131,17,14,107,90,2,4,10,1
S01009608,Owned: Total,184,128,115,10,105,12,1,56,52,1,0,3,0
S01009608,Owned: Owned outright,76,30,26,5,21,3,1,46,43,0,0,3,0
S01009608,Owned: Owned with a mortgage or loan or shared ownership,108,98,89,5,84,9,0,10,9,1,0,0,0
S01009608,Rented or living rent free: Total,103,52,34,8,26,5,13,51,38,1,4,7,1
S01009608,Rented or living rent free: Social rented,75,31,20,5,15,2,9,44,33,1,3,6,1
S01009608,Rented or living rent free: Private rented or living rent free,28,21,14,3,11,3,4,7,5,0,1,1,0
S01009609,All HRPs aged 16 and over,358,249,201,17,184,34,14,109,96,3,1,3,6
S01009609,Owned: Total,284,197,164,14,150,31,2,87,85,0,0,0,2
S01009609,Owned: Owned outright,121,46,34,7,27,12,0,75,74,0,0,0,1
S01009609,Owned: Owned with a mortgage or loan or shared ownership,163,151,130,7,123,19,2,12,11,0,0,0,1
S01009609,Rented or living rent free: Total,74,52,37,3,34,3,12,22,11,3,1,3,4
S01009609,Rented or living rent free: Social rented,30,19,9,0,9,1,9,11,7,1,0,2,1
S01009609,Rented or living rent free: Private rented or living rent free,44,33,28,3,25,2,3,11,4,2,1,1,3
S01009610,All HRPs aged 16 and over,500,307,264,41,223,26,17,193,164,1,4,21,3
S01009610,Owned: Total,352,215,194,22,172,17,4,137,132,0,0,3,2
S01009610,Owned: Owned outright,177,56,48,7,41,7,1,121,119,0,0,0,2
S01009610,Owned: Owned with a mortgage or loan or shared ownership,175,159,146,15,131,10,3,16,13,0,0,3,0
S01009610,Rented or living rent free: Total,148,92,70,19,51,9,13,56,32,1,4,18,1
S01009610,Rented or living rent free: Social rented,88,45,36,11,25,2,7,43,24,1,2,15,1
S01009610,Rented or living rent free: Private rented or living rent free,60,47,34,8,26,7,6,13,8,0,2,3,0
S01009611,All HRPs aged 16 and over,218,152,115,24,91,36,1,66,58,0,1,7,0
S01009611,Owned: Total,171,118,89,16,73,29,0,53,51,0,1,1,0
S01009611,Owned: Owned outright,98,51,37,9,28,14,0,47,46,0,0,1,0
S01009611,Owned: Owned with a mortgage or loan or shared ownership,73,67,52,7,45,15,0,6,5,0,1,0,0
S01009611,Rented or living rent free: Total,47,34,26,8,18,7,1,13,7,0,0,6,0
S01009611,Rented or living rent free: Social rented,7,2,2,0,2,0,0,5,1,0,0,4,0
S01009611,Rented or living rent free: Private rented or living rent free,40,32,24,8,16,7,1,8,6,0,0,2,0
S01009612,All HRPs aged 16 and over,272,176,149,21,128,23,4,96,74,3,5,10,4
S01009612,Owned: Total,183,126,106,10,96,18,2,57,55,0,0,2,0
S01009612,Owned: Owned outright,81,30,28,3,25,1,1,51,50,0,0,1,0
S01009612,Owned: Owned with a mortgage or loan or shared ownership,102,96,78,7,71,17,1,6,5,0,0,1,0
S01009612,Rented or living rent free: Total,89,50,43,11,32,5,2,39,19,3,5,8,4
S01009612,Rented or living rent free: Social rented,71,35,32,9,23,2,1,36,16,3,5,8,4
S01009612,Rented or living rent free: Private rented or living rent free,18,15,11,2,9,3,1,3,3,0,0,0,0
S01009613,All HRPs aged 16 and over,181,135,95,13,82,37,3,46,42,0,0,3,1
S01009613,Owned: Total,162,119,87,12,75,31,1,43,40,0,0,2,1
S01009613,Owned: Owned outright,76,41,25,5,20,15,1,35,33,0,0,1,1
S01009613,Owned: Owned with a mortgage or loan or shared ownership,86,78,62,7,55,16,0,8,7,0,0,1,0
S01009613,Rented or living rent free: Total,19,16,8,1,7,6,2,3,2,0,0,1,0
S01009613,Rented or living rent free: Social rented,2,2,1,0,1,1,0,0,0,0,0,0,0
S01009613,Rented or living rent free: Private rented or living rent free,17,14,7,1,6,5,2,3,2,0,0,1,0
S01009614,All HRPs aged 16 and over,223,144,112,16,96,27,5,79,75,0,0,4,0
S01009614,Owned: Total,167,107,83,13,70,21,3,60,60,0,0,0,0
S01009614,Owned: Owned outright,93,38,27,9,18,8,3,55,55,0,0,0,0
S01009614,Owned: Owned with a mortgage or loan or shared ownership,74,69,56,4,52,13,0,5,5,0,0,0,0
S01009614,Rented or living rent free: Total,56,37,29,3,26,6,2,19,15,0,0,4,0
S01009614,Rented or living rent free: Social rented,11,7,6,0,6,1,0,4,2,0,0,2,0
S01009614,Rented or living rent free: Private rented or living rent free,45,30,23,3,20,5,2,15,13,0,0,2,0
S01009615,All HRPs aged 16 and over,174,95,83,14,69,11,1,79,72,1,0,5,1
S01009615,Owned: Total,146,84,74,11,63,9,1,62,61,0,0,1,0
S01009615,Owned: Owned outright,84,28,24,6,18,3,1,56,55,0,0,1,0
S01009615,Owned: Owned with a mortgage or loan or shared ownership,62,56,50,5,45,6,0,6,6,0,0,0,0
S01009615,Rented or living rent free: Total,28,11,9,3,6,2,0,17,11,1,0,4,1
S01009615,Rented or living rent free: Social rented,22,8,7,2,5,1,0,14,9,1,0,3,1
S01009615,Rented or living rent free: Private rented or living rent free,6,3,2,1,1,1,0,3,2,0,0,1,0
S01009616,All HRPs aged 16 and over,324,222,181,30,151,29,12,102,80,1,7,12,2
S01009616,Owned: Total,226,161,134,16,118,25,2,65,59,0,1,4,1
S01009616,Owned: Owned outright,98,39,29,8,21,10,0,59,57,0,1,1,0
S01009616,Owned: Owned with a mortgage or loan or shared ownership,128,122,105,8,97,15,2,6,2,0,0,3,1
S01009616,Rented or living rent free: Total,98,61,47,14,33,4,10,37,21,1,6,8,1
S01009616,Rented or living rent free: Social rented,62,36,31,11,20,0,5,26,18,0,1,6,1
S01009616,Rented or living rent free: Private rented or living rent free,36,25,16,3,13,4,5,11,3,1,5,2,0
S01009617,All HRPs aged 16 and over,297,217,185,22,163,27,5,80,65,3,1,9,2
S01009617,Owned: Total,265,201,171,20,151,26,4,64,62,0,1,1,0
S01009617,Owned: Owned outright,103,51,41,10,31,7,3,52,52,0,0,0,0
S01009617,Owned: Owned with a mortgage or loan or shared ownership,162,150,130,10,120,19,1,12,10,0,1,1,0
S01009617,Rented or living rent free: Total,32,16,14,2,12,1,1,16,3,3,0,8,2
S01009617,Rented or living rent free: Social rented,6,2,2,0,2,0,0,4,0,0,0,3,1
S01009617,Rented or living rent free: Private rented or living rent free,26,14,12,2,10,1,1,12,3,3,0,5,1
S01009618,All HRPs aged 16 and over,333,210,172,28,144,24,14,123,84,2,6,26,5
S01009618,Owned: Total,199,139,121,13,108,17,1,60,56,0,1,3,0
S01009618,Owned: Owned outright,82,34,29,6,23,5,0,48,46,0,1,1,0
S01009618,Owned: Owned with a mortgage or loan or shared ownership,117,105,92,7,85,12,1,12,10,0,0,2,0
S01009618,Rented or living rent free: Total,134,71,51,15,36,7,13,63,28,2,5,23,5
S01009618,Rented or living rent free: Social rented,76,35,24,8,16,5,6,41,17,1,3,17,3
S01009618,Rented or living rent free: Private rented or living rent free,58,36,27,7,20,2,7,22,11,1,2,6,2
S01009619,All HRPs aged 16 and over,302,167,131,24,107,16,20,135,92,6,5,26,6
S01009619,Owned: Total,159,113,97,10,87,15,1,46,44,0,0,1,1
S01009619,Owned: Owned outright,79,35,31,7,24,3,1,44,43,0,0,1,0
S01009619,Owned: Owned with a mortgage or loan or shared ownership,80,78,66,3,63,12,0,2,1,0,0,0,1
S01009619,Rented or living rent free: Total,143,54,34,14,20,1,19,89,48,6,5,25,5
S01009619,Rented or living rent free: Social rented,113,42,27,10,17,1,14,71,42,4,1,19,5
S01009619,Rented or living rent free: Private rented or living rent free,30,12,7,4,3,0,5,18,6,2,4,6,0
S01009620,All HRPs aged 16 and over,391,199,160,36,124,15,24,192,146,5,12,23,6
S01009620,Owned: Total,180,109,97,10,87,9,3,71,62,2,2,3,2
S01009620,Owned: Owned outright,92,30,25,6,19,2,3,62,56,0,2,2,2
S01009620,Owned: Owned with a mortgage or loan or shared ownership,88,79,72,4,68,7,0,9,6,2,0,1,0
S01009620,Rented or living rent free: Total,211,90,63,26,37,6,21,121,84,3,10,20,4
S01009620,Rented or living rent free: Social rented,175,64,43,18,25,4,17,111,76,2,10,20,3
S01009620,Rented or living rent free: Private rented or living rent free,36,26,20,8,12,2,4,10,8,1,0,0,1
S01009621,All HRPs aged 16 and over,394,217,170,29,141,23,24,177,120,0,11,36,10
S01009621,Owned: Total,221,150,129,17,112,19,2,71,65,0,0,5,1
S01009621,Owned: Owned outright,110,50,41,8,33,9,0,60,57,0,0,3,0
S01009621,Owned: Owned with a mortgage or loan or shared ownership,111,100,88,9,79,10,2,11,8,0,0,2,1
S01009621,Rented or living rent free: Total,173,67,41,12,29,4,22,106,55,0,11,31,9
S01009621,Rented or living rent free: Social rented,105,33,23,9,14,2,8,72,42,0,9,13,8
S01009621,Rented or living rent free: Private rented or living rent free,68,34,18,3,15,2,14,34,13,0,2,18,1
S01009622,All HRPs aged 16 and over,394,234,172,41,131,15,47,160,85,3,13,47,12
S01009622,Owned: Total,130,85,75,8,67,8,2,45,42,0,0,3,0
S01009622,Owned: Owned outright,66,29,26,5,21,2,1,37,36,0,0,1,0
S01009622,Owned: Owned with a mortgage or loan or shared ownership,64,56,49,3,46,6,1,8,6,0,0,2,0
S01009622,Rented or living rent free: Total,264,149,97,33,64,7,45,115,43,3,13,44,12
S01009622,Rented or living rent free: Social rented,218,120,75,28,47,6,39,98,34,2,12,41,9
S01009622,Rented or living rent free: Private rented or living rent free,46,29,22,5,17,1,6,17,9,1,1,3,3
S01009623,All HRPs aged 16 and over,243,131,112,21,91,12,7,112,75,3,9,20,5
S01009623,Owned: Total,133,82,73,10,63,8,1,51,47,0,1,2,1
S01009623,Owned: Owned outright,71,24,18,2,16,5,1,47,45,0,0,1,1
S01009623,Owned: Owned with a mortgage or loan or shared ownership,62,58,55,8,47,3,0,4,2,0,1,1,0
S01009623,Rented or living rent free: Total,110,49,39,11,28,4,6,61,28,3,8,18,4
S01009623,Rented or living rent free: Social rented,89,40,31,9,22,4,5,49,23,2,4,16,4
S01009623,Rented or living rent free: Private rented or living rent free,21,9,8,2,6,0,1,12,5,1,4,2,0
S01009624,All HRPs aged 16 and over,408,232,201,49,152,17,14,176,136,1,9,24,6
S01009624,Owned: Total,243,151,137,26,111,13,1,92,85,0,2,3,2
S01009624,Owned: Owned outright,122,45,39,11,28,5,1,77,74,0,2,0,1
S01009624,Owned: Owned with a mortgage or loan or shared ownership,121,106,98,15,83,8,0,15,11,0,0,3,1
S01009624,Rented or living rent free: Total,165,81,64,23,41,4,13,84,51,1,7,21,4
S01009624,Rented or living rent free: Social rented,142,67,55,20,35,3,9,75,45,1,7,18,4
S01009624,Rented or living rent free: Private rented or living rent free,23,14,9,3,6,1,4,9,6,0,0,3,0
S01009625,All HRPs aged 16 and over,378,230,199,52,147,13,18,148,104,2,17,18,7
S01009625,Owned: Total,210,134,123,22,101,10,1,76,68,0,0,4,4
S01009625,Owned: Owned outright,85,24,22,6,16,1,1,61,56,0,0,2,3
S01009625,Owned: Owned with a mortgage or loan or shared ownership,125,110,101,16,85,9,0,15,12,0,0,2,1
S01009625,Rented or living rent free: Total,168,96,76,30,46,3,17,72,36,2,17,14,3
S01009625,Rented or living rent free: Social rented,134,75,60,26,34,3,12,59,30,1,14,11,3
S01009625,Rented or living rent free: Private rented or living rent free,34,21,16,4,12,0,5,13,6,1,3,3,0
S01009626,All HRPs aged 16 and over,231,122,95,29,66,12,15,109,64,2,15,24,4
S01009626,Owned: Total,100,53,43,10,33,9,1,47,41,0,2,4,0
S01009626,Owned: Owned outright,63,21,17,5,12,3,1,42,38,0,1,3,0
S01009626,Owned: Owned with a mortgage or loan or shared ownership,37,32,26,5,21,6,0,5,3,0,1,1,0
S01009626,Rented or living rent free: Total,131,69,52,19,33,3,14,62,23,2,13,20,4
S01009626,Rented or living rent free: Social rented,123,64,48,17,31,3,13,59,21,2,12,20,4
S01009626,Rented or living rent free: Private rented or living rent free,8,5,4,2,2,0,1,3,2,0,1,0,0
S01009627,All HRPs aged 16 and over,342,191,154,32,122,19,18,151,109,1,10,26,5
S01009627,Owned: Total,195,125,104,11,93,17,4,70,65,0,1,4,0
S01009627,Owned: Owned outright,94,38,27,4,23,10,1,56,54,0,0,2,0
S01009627,Owned: Owned with a mortgage or loan or shared ownership,101,87,77,7,70,7,3,14,11,0,1,2,0
S01009627,Rented or living rent free: Total,147,66,50,21,29,2,14,81,44,1,9,22,5
S01009627,Rented or living rent free: Social rented,124,57,43,18,25,2,12,67,37,0,7,18,5
S01009627,Rented or living rent free: Private rented or living rent free,23,9,7,3,4,0,2,14,7,1,2,4,0
S01009628,All HRPs aged 16 and over,265,88,75,18,57,5,8,177,151,0,1,18,7
S01009628,Owned: Total,121,60,57,8,49,3,0,61,56,0,0,2,3
S01009628,Owned: Owned outright,69,14,14,1,13,0,0,55,50,0,0,2,3
S01009628,Owned: Owned with a mortgage or loan or shared ownership,52,46,43,7,36,3,0,6,6,0,0,0,0
S01009628,Rented or living rent free: Total,144,28,18,10,8,2,8,116,95,0,1,16,4
S01009628,Rented or living rent free: Social rented,133,22,16,8,8,1,5,111,91,0,1,16,3
S01009628,Rented or living rent free: Private rented or living rent free,11,6,2,2,0,1,3,5,4,0,0,0,1
S01009629,All HRPs aged 16 and over,435,274,226,48,178,25,23,161,98,3,21,32,7
S01009629,Owned: Total,264,183,157,18,139,23,3,81,73,1,0,6,1
S01009629,Owned: Owned outright,112,44,40,8,32,1,3,68,65,0,0,2,1
S01009629,Owned: Owned with a mortgage or loan or shared ownership,152,139,117,10,107,22,0,13,8,1,0,4,0
S01009629,Rented or living rent free: Total,171,91,69,30,39,2,20,80,25,2,21,26,6
S01009629,Rented or living rent free: Social rented,124,62,49,25,24,0,13,62,19,2,12,23,6
S01009629,Rented or living rent free: Private rented or living rent free,47,29,20,5,15,2,7,18,6,0,9,3,0
S01009630,All HRPs aged 16 and over,343,207,158,33,125,13,36,136,80,5,21,25,5
S01009630,Owned: Total,145,101,92,13,79,8,1,44,41,1,1,1,0
S01009630,Owned: Owned outright,63,27,24,6,18,2,1,36,35,0,1,0,0
S01009630,Owned: Owned with a mortgage or loan or shared ownership,82,74,68,7,61,6,0,8,6,1,0,1,0
S01009630,Rented or living rent free: Total,198,106,66,20,46,5,35,92,39,4,20,24,5
S01009630,Rented or living rent free: Social rented,173,92,60,17,43,5,27,81,37,2,16,21,5
S01009630,Rented or living rent free: Private rented or living rent free,25,14,6,3,3,0,8,11,2,2,4,3,0
S01009631,All HRPs aged 16 and over,406,215,161,37,124,16,38,191,103,3,18,51,16
S01009631,Owned: Total,103,67,58,8,50,9,0,36,34,0,0,1,1
S01009631,Owned: Owned outright,54,22,19,4,15,3,0,32,30,0,0,1,1
S01009631,Owned: Owned with a mortgage or loan or shared ownership,49,45,39,4,35,6,0,4,4,0,0,0,0
S01009631,Rented or living rent free: Total,303,148,103,29,74,7,38,155,69,3,18,50,15
S01009631,Rented or living rent free: Social rented,224,105,78,22,56,5,22,119,60,1,10,41,7
S01009631,Rented or living rent free: Private rented or living rent free,79,43,25,7,18,2,16,36,9,2,8,9,8
S01009632,All HRPs aged 16 and over,306,152,108,30,78,11,33,154,82,2,18,34,18
S01009632,Owned: Total,96,58,46,9,37,9,3,38,32,1,0,5,0
S01009632,Owned: Owned outright,47,16,12,1,11,3,1,31,27,1,0,3,0
S01009632,Owned: Owned with a mortgage or loan or shared ownership,49,42,34,8,26,6,2,7,5,0,0,2,0
S01009632,Rented or living rent free: Total,210,94,62,21,41,2,30,116,50,1,18,29,18
S01009632,Rented or living rent free: Social rented,159,63,45,17,28,2,16,96,47,1,10,26,12
S01009632,Rented or living rent free: Private rented or living rent free,51,31,17,4,13,0,14,20,3,0,8,3,6
S01009633,All HRPs aged 16 and over,297,189,137,48,89,15,37,108,63,6,12,17,10
S01009633,Owned: Total,110,76,65,13,52,10,1,34,32,0,1,1,0
S01009633,Owned: Owned outright,51,22,20,7,13,2,0,29,27,0,1,1,0
S01009633,Owned: Owned with a mortgage or loan or shared ownership,59,54,45,6,39,8,1,5,5,0,0,0,0
S01009633,Rented or living rent free: Total,187,113,72,35,37,5,36,74,31,6,11,16,10
S01009633,Rented or living rent free: Social rented,159,95,59,32,27,5,31,64,27,3,9,16,9
S01009633,Rented or living rent free: Private rented or living rent free,28,18,13,3,10,0,5,10,4,3,2,0,1
S01009634,All HRPs aged 16 and over,253,119,99,25,74,3,17,134,106,1,8,12,7
S01009634,Owned: Total,126,61,60,11,49,1,0,65,57,1,2,4,1
S01009634,Owned: Owned outright,75,20,20,6,14,0,0,55,49,0,2,3,1
S01009634,Owned: Owned with a mortgage or loan or shared ownership,51,41,40,5,35,1,0,10,8,1,0,1,0
S01009634,Rented or living rent free: Total,127,58,39,14,25,2,17,69,49,0,6,8,6
S01009634,Rented or living rent free: Social rented,112,51,35,12,23,2,14,61,44,0,5,7,5
S01009634,Rented or living rent free: Private rented or living rent free,15,7,4,2,2,0,3,8,5,0,1,1,1
S01009635,All HRPs aged 16 and over,414,261,213,38,175,22,26,153,105,1,9,26,12
S01009635,Owned: Total,250,169,148,16,132,18,3,81,74,0,1,4,2
S01009635,Owned: Owned outright,117,45,34,8,26,10,1,72,68,0,0,3,1
S01009635,Owned: Owned with a mortgage or loan or shared ownership,133,124,114,8,106,8,2,9,6,0,1,1,1
S01009635,Rented or living rent free: Total,164,92,65,22,43,4,23,72,31,1,8,22,10
S01009635,Rented or living rent free: Social rented,119,60,41,17,24,1,18,59,25,1,8,18,7
S01009635,Rented or living rent free: Private rented or living rent free,45,32,24,5,19,3,5,13,6,0,0,4,3
S01009636,All HRPs aged 16 and over,521,310,209,47,162,26,75,211,115,5,26,46,19
S01009636,Owned: Total,217,149,121,17,104,20,8,68,62,0,0,4,2
S01009636,Owned: Owned outright,98,39,29,6,23,7,3,59,54,0,0,4,1
S01009636,Owned: Owned with a mortgage or loan or shared ownership,119,110,92,11,81,13,5,9,8,0,0,0,1
S01009636,Rented or living rent free: Total,304,161,88,30,58,6,67,143,53,5,26,42,17
S01009636,Rented or living rent free: Social rented,173,78,43,13,30,3,32,95,44,4,15,21,11
S01009636,Rented or living rent free: Private rented or living rent free,131,83,45,17,28,3,35,48,9,1,11,21,6
S01009637,All HRPs aged 16 and over,340,219,185,32,153,16,18,121,78,4,13,22,4
S01009637,Owned: Total,203,144,126,12,114,14,4,59,56,0,0,2,1
S01009637,Owned: Owned outright,82,30,23,4,19,4,3,52,49,0,0,2,1
S01009637,Owned: Owned with a mortgage or loan or shared ownership,121,114,103,8,95,10,1,7,7,0,0,0,0
S01009637,Rented or living rent free: Total,137,75,59,20,39,2,14,62,22,4,13,20,3
S01009637,Rented or living rent free: Social rented,98,54,43,16,27,1,10,44,15,1,9,16,3
S01009637,Rented or living rent free: Private rented or living rent free,39,21,16,4,12,1,4,18,7,3,4,4,0
S01009638,All HRPs aged 16 and over,292,161,119,30,89,15,27,131,76,1,19,22,13
S01009638,Owned: Total,121,75,57,7,50,13,5,46,41,0,2,2,1
S01009638,Owned: Owned outright,55,16,12,2,10,3,1,39,36,0,2,1,0
S01009638,Owned: Owned with a mortgage or loan or shared ownership,66,59,45,5,40,10,4,7,5,0,0,1,1
S01009638,Rented or living rent free: Total,171,86,62,23,39,2,22,85,35,1,17,20,12
S01009638,Rented or living rent free: Social rented,148,72,52,21,31,1,19,76,31,1,14,18,12
S01009638,Rented or living rent free: Private rented or living rent free,23,14,10,2,8,1,3,9,4,0,3,2,0
S01009639,All HRPs aged 16 and over,325,193,152,11,141,31,10,132,123,2,0,4,3
S01009639,Owned: Total,298,176,139,11,128,31,6,122,119,2,0,1,0
S01009639,Owned: Owned outright,180,65,44,4,40,17,4,115,113,2,0,0,0
S01009639,Owned: Owned with a mortgage or loan or shared ownership,118,111,95,7,88,14,2,7,6,0,0,1,0
S01009639,Rented or living rent free: Total,27,17,13,0,13,0,4,10,4,0,0,3,3
S01009639,Rented or living rent free: Social rented,9,5,4,0,4,0,1,4,3,0,0,0,1
S01009639,Rented or living rent free: Private rented or living rent free,18,12,9,0,9,0,3,6,1,0,0,3,2
S01009640,All HRPs aged 16 and over,363,168,142,30,112,13,13,195,125,5,4,55,6
S01009640,Owned: Total,148,88,77,13,64,9,2,60,57,0,0,3,0
S01009640,Owned: Owned outright,82,25,20,5,15,3,2,57,55,0,0,2,0
S01009640,Owned: Owned with a mortgage or loan or shared ownership,66,63,57,8,49,6,0,3,2,0,0,1,0
S01009640,Rented or living rent free: Total,215,80,65,17,48,4,11,135,68,5,4,52,6
S01009640,Rented or living rent free: Social rented,165,50,40,10,30,2,8,115,59,5,3,44,4
S01009640,Rented or living rent free: Private rented or living rent free,50,30,25,7,18,2,3,20,9,0,1,8,2
S01009641,All HRPs aged 16 and over,479,244,190,39,151,27,27,235,181,0,7,34,13
S01009641,Owned: Total,233,146,123,15,108,21,2,87,78,0,1,7,1
S01009641,Owned: Owned outright,128,50,41,9,32,9,0,78,72,0,0,5,1
S01009641,Owned: Owned with a mortgage or loan or shared ownership,105,96,82,6,76,12,2,9,6,0,1,2,0
S01009641,Rented or living rent free: Total,246,98,67,24,43,6,25,148,103,0,6,27,12
S01009641,Rented or living rent free: Social rented,155,47,31,14,17,4,12,108,83,0,4,17,4
S01009641,Rented or living rent free: Private rented or living rent free,91,51,36,10,26,2,13,40,20,0,2,10,8
S01009642,All HRPs aged 16 and over,482,302,251,37,214,33,18,180,127,2,8,32,11
S01009642,Owned: Total,289,189,163,15,148,20,6,100,88,0,1,10,1
S01009642,Owned: Owned outright,132,44,36,8,28,3,5,88,80,0,0,8,0
S01009642,Owned: Owned with a mortgage or loan or shared ownership,157,145,127,7,120,17,1,12,8,0,1,2,1
S01009642,Rented or living rent free: Total,193,113,88,22,66,13,12,80,39,2,7,22,10
S01009642,Rented or living rent free: Social rented,96,44,31,7,24,6,7,52,25,0,5,15,7
S01009642,Rented or living rent free: Private rented or living rent free,97,69,57,15,42,7,5,28,14,2,2,7,3
S01009643,All HRPs aged 16 and over,218,190,172,13,159,15,3,28,19,3,1,2,3
S01009643,Owned: Total,185,164,151,8,143,12,1,21,18,1,0,1,1
S01009643,Owned: Owned outright,35,18,14,5,9,3,1,17,17,0,0,0,0
S01009643,Owned: Owned with a mortgage or loan or shared ownership,150,146,137,3,134,9,0,4,1,1,0,1,1
S01009643,Rented or living rent free: Total,33,26,21,5,16,3,2,7,1,2,1,1,2
S01009643,Rented or living rent free: Social rented,25,19,15,4,11,2,2,6,1,1,1,1,2
S01009643,Rented or living rent free: Private rented or living rent free,8,7,6,1,5,1,0,1,0,1,0,0,0
S01009644,All HRPs aged 16 and over,339,205,171,37,134,21,13,134,104,2,4,19,5
S01009644,Owned: Total,229,145,124,14,110,18,3,84,76,1,2,2,3
S01009644,Owned: Owned outright,97,30,23,5,18,7,0,67,62,0,1,1,3
S01009644,Owned: Owned with a mortgage or loan or shared ownership,132,115,101,9,92,11,3,17,14,1,1,1,0
S01009644,Rented or living rent free: Total,110,60,47,23,24,3,10,50,28,1,2,17,2
S01009644,Rented or living rent free: Social rented,93,48,39,19,20,1,8,45,26,1,1,16,1
S01009644,Rented or living rent free: Private rented or living rent free,17,12,8,4,4,2,2,5,2,0,1,1,1
S01009645,All HRPs aged 16 and over,301,166,137,25,112,20,9,135,105,5,7,16,2
S01009645,Owned: Total,180,118,99,12,87,15,4,62,57,1,0,3,1
S01009645,Owned: Owned outright,85,31,23,4,19,6,2,54,50,1,0,2,1
S01009645,Owned: Owned with a mortgage or loan or shared ownership,95,87,76,8,68,9,2,8,7,0,0,1,0
S01009645,Rented or living rent free: Total,121,48,38,13,25,5,5,73,48,4,7,13,1
S01009645,Rented or living rent free: Social rented,91,33,29,11,18,2,2,58,40,4,4,9,1
S01009645,Rented or living rent free: Private rented or living rent free,30,15,9,2,7,3,3,15,8,0,3,4,0
S01009646,All HRPs aged 16 and over,244,153,125,16,109,16,12,91,72,2,6,7,4
S01009646,Owned: Total,159,106,90,9,81,13,3,53,50,0,0,1,2
S01009646,Owned: Owned outright,73,26,20,3,17,4,2,47,45,0,0,0,2
S01009646,Owned: Owned with a mortgage or loan or shared ownership,86,80,70,6,64,9,1,6,5,0,0,1,0
S01009646,Rented or living rent free: Total,85,47,35,7,28,3,9,38,22,2,6,6,2
S01009646,Rented or living rent free: Social rented,74,42,31,7,24,2,9,32,20,0,5,5,2
S01009646,Rented or living rent free: Private rented or living rent free,11,5,4,0,4,1,0,6,2,2,1,1,0
S01009647,All HRPs aged 16 and over,318,178,124,32,92,23,31,140,96,7,7,20,10
S01009647,Owned: Total,153,88,69,7,62,17,2,65,62,2,0,0,1
S01009647,Owned: Owned outright,93,31,22,2,20,7,2,62,60,1,0,0,1
S01009647,Owned: Owned with a mortgage or loan or shared ownership,60,57,47,5,42,10,0,3,2,1,0,0,0
S01009647,Rented or living rent free: Total,165,90,55,25,30,6,29,75,34,5,7,20,9
S01009647,Rented or living rent free: Social rented,134,65,40,20,20,4,21,69,32,5,6,19,7
S01009647,Rented or living rent free: Private rented or living rent free,31,25,15,5,10,2,8,6,2,0,1,1,2
S01009648,All HRPs aged 16 and over,394,230,194,33,161,16,20,164,137,3,6,14,4
S01009648,Owned: Total,256,155,139,14,125,14,2,101,97,0,1,2,1
S01009648,Owned: Owned outright,121,34,32,6,26,2,0,87,84,0,0,2,1
S01009648,Owned: Owned with a mortgage or loan or shared ownership,135,121,107,8,99,12,2,14,13,0,1,0,0
S01009648,Rented or living rent free: Total,138,75,55,19,36,2,18,63,40,3,5,12,3
S01009648,Rented or living rent free: Social rented,114,59,43,16,27,1,15,55,38,3,3,10,1
S01009648,Rented or living rent free: Private rented or living rent free,24,16,12,3,9,1,3,8,2,0,2,2,2
S01009649,All HRPs aged 16 and over,451,276,226,39,187,26,24,175,126,3,13,26,7
S01009649,Owned: Total,292,196,170,12,158,23,3,96,89,0,3,2,2
S01009649,Owned: Owned outright,120,40,30,6,24,9,1,80,76,0,2,1,1
S01009649,Owned: Owned with a mortgage or loan or shared ownership,172,156,140,6,134,14,2,16,13,0,1,1,1
S01009649,Rented or living rent free: Total,159,80,56,27,29,3,21,79,37,3,10,24,5
S01009649,Rented or living rent free: Social rented,142,71,51,26,25,2,18,71,36,2,8,21,4
S01009649,Rented or living rent free: Private rented or living rent free,17,9,5,1,4,1,3,8,1,1,2,3,1
S01009650,All HRPs aged 16 and over,343,173,142,16,126,27,4,170,168,0,0,1,1
S01009650,Owned: Total,325,162,135,15,120,25,2,163,162,0,0,0,1
S01009650,Owned: Owned outright,213,65,52,10,42,12,1,148,147,0,0,0,1
S01009650,Owned: Owned with a mortgage or loan or shared ownership,112,97,83,5,78,13,1,15,15,0,0,0,0
S01009650,Rented or living rent free: Total,18,11,7,1,6,2,2,7,6,0,0,1,0
S01009650,Rented or living rent free: Social rented,8,6,4,1,3,0,2,2,2,0,0,0,0
S01009650,Rented or living rent free: Private rented or living rent free,10,5,3,0,3,2,0,5,4,0,0,1,0
S01009651,All HRPs aged 16 and over,427,259,177,27,150,74,8,168,142,1,7,16,2
S01009651,Owned: Total,294,195,126,21,105,63,6,99,96,0,1,2,0
S01009651,Owned: Owned outright,184,94,46,16,30,43,5,90,87,0,1,2,0
S01009651,Owned: Owned with a mortgage or loan or shared ownership,110,101,80,5,75,20,1,9,9,0,0,0,0
S01009651,Rented or living rent free: Total,133,64,51,6,45,11,2,69,46,1,6,14,2
S01009651,Rented or living rent free: Social rented,57,15,13,2,11,1,1,42,30,0,4,7,1
S01009651,Rented or living rent free: Private rented or living rent free,76,49,38,4,34,10,1,27,16,1,2,7,1
S01009652,All HRPs aged 16 and over,399,195,147,28,119,46,2,204,192,2,2,6,2
S01009652,Owned: Total,346,163,119,22,97,42,2,183,177,0,2,3,1
S01009652,Owned: Owned outright,239,67,43,15,28,23,1,172,168,0,1,2,1
S01009652,Owned: Owned with a mortgage or loan or shared ownership,107,96,76,7,69,19,1,11,9,0,1,1,0
S01009652,Rented or living rent free: Total,53,32,28,6,22,4,0,21,15,2,0,3,1
S01009652,Rented or living rent free: Social rented,9,2,2,1,1,0,0,7,4,0,0,3,0
S01009652,Rented or living rent free: Private rented or living rent free,44,30,26,5,21,4,0,14,11,2,0,0,1
S01009653,All HRPs aged 16 and over,229,153,127,14,113,23,3,76,73,0,0,1,2
S01009653,Owned: Total,212,139,118,11,107,20,1,73,72,0,0,0,1
S01009653,Owned: Owned outright,114,47,40,9,31,7,0,67,67,0,0,0,0
S01009653,Owned: Owned with a mortgage or loan or shared ownership,98,92,78,2,76,13,1,6,5,0,0,0,1
S01009653,Rented or living rent free: Total,17,14,9,3,6,3,2,3,1,0,0,1,1
S01009653,Rented or living rent free: Social rented,5,4,2,1,1,1,1,1,0,0,0,0,1
S01009653,Rented or living rent free: Private rented or living rent free,12,10,7,2,5,2,1,2,1,0,0,1,0
S01009654,All HRPs aged 16 and over,274,148,107,18,89,36,5,126,110,4,2,6,4
S01009654,Owned: Total,208,107,78,9,69,28,1,101,93,3,1,1,3
S01009654,Owned: Owned outright,132,41,23,5,18,18,0,91,87,1,0,1,2
S01009654,Owned: Owned with a mortgage or loan or shared ownership,76,66,55,4,51,10,1,10,6,2,1,0,1
S01009654,Rented or living rent free: Total,66,41,29,9,20,8,4,25,17,1,1,5,1
S01009654,Rented or living rent free: Social rented,37,21,17,5,12,2,2,16,10,1,0,4,1
S01009654,Rented or living rent free: Private rented or living rent free,29,20,12,4,8,6,2,9,7,0,1,1,0
S01009655,All HRPs aged 16 and over,351,204,178,41,137,11,15,147,107,1,10,21,8
S01009655,Owned: Total,194,124,115,14,101,9,0,70,62,0,1,7,0
S01009655,Owned: Owned outright,87,35,33,9,24,2,0,52,49,0,1,2,0
S01009655,Owned: Owned with a mortgage or loan or shared ownership,107,89,82,5,77,7,0,18,13,0,0,5,0
S01009655,Rented or living rent free: Total,157,80,63,27,36,2,15,77,45,1,9,14,8
S01009655,Rented or living rent free: Social rented,139,71,56,23,33,2,13,68,39,1,8,12,8
S01009655,Rented or living rent free: Private rented or living rent free,18,9,7,4,3,0,2,9,6,0,1,2,0
S01009656,All HRPs aged 16 and over,387,172,126,29,97,14,32,215,155,2,13,37,8
S01009656,Owned: Total,168,93,81,12,69,10,2,75,70,0,1,2,2
S01009656,Owned: Owned outright,93,33,30,6,24,3,0,60,57,0,0,2,1
S01009656,Owned: Owned with a mortgage or loan or shared ownership,75,60,51,6,45,7,2,15,13,0,1,0,1
S01009656,Rented or living rent free: Total,219,79,45,17,28,4,30,140,85,2,12,35,6
S01009656,Rented or living rent free: Social rented,191,66,35,16,19,3,28,125,78,2,6,33,6
S01009656,Rented or living rent free: Private rented or living rent free,28,13,10,1,9,1,2,15,7,0,6,2,0
S01009657,All HRPs aged 16 and over,332,225,174,27,147,31,20,107,81,3,5,11,7
S01009657,Owned: Total,236,171,137,15,122,27,7,65,59,1,1,2,2
S01009657,Owned: Owned outright,110,57,47,10,37,9,1,53,50,0,0,1,2
S01009657,Owned: Owned with a mortgage or loan or shared ownership,126,114,90,5,85,18,6,12,9,1,1,1,0
S01009657,Rented or living rent free: Total,96,54,37,12,25,4,13,42,22,2,4,9,5
S01009657,Rented or living rent free: Social rented,79,48,33,10,23,3,12,31,15,1,4,7,4
S01009657,Rented or living rent free: Private rented or living rent free,17,6,4,2,2,1,1,11,7,1,0,2,1
S01009658,All HRPs aged 16 and over,286,199,175,37,138,15,9,87,52,0,10,21,4
S01009658,Owned: Total,173,135,121,20,101,12,2,38,32,0,0,6,0
S01009658,Owned: Owned outright,67,40,34,13,21,4,2,27,27,0,0,0,0
S01009658,Owned: Owned with a mortgage or loan or shared ownership,106,95,87,7,80,8,0,11,5,0,0,6,0
S01009658,Rented or living rent free: Total,113,64,54,17,37,3,7,49,20,0,10,15,4
S01009658,Rented or living rent free: Social rented,98,55,48,15,33,2,5,43,18,0,7,14,4
S01009658,Rented or living rent free: Private rented or living rent free,15,9,6,2,4,1,2,6,2,0,3,1,0
S01009659,All HRPs aged 16 and over,230,154,118,17,101,15,21,76,54,3,3,15,1
S01009659,Owned: Total,139,94,81,6,75,11,2,45,44,0,0,1,0
S01009659,Owned: Owned outright,60,23,21,3,18,2,0,37,37,0,0,0,0
S01009659,Owned: Owned with a mortgage or loan or shared ownership,79,71,60,3,57,9,2,8,7,0,0,1,0
S01009659,Rented or living rent free: Total,91,60,37,11,26,4,19,31,10,3,3,14,1
S01009659,Rented or living rent free: Social rented,79,51,29,8,21,3,19,28,9,3,2,13,1
S01009659,Rented or living rent free: Private rented or living rent free,12,9,8,3,5,1,0,3,1,0,1,1,0
S01009660,All HRPs aged 16 and over,430,268,227,35,192,25,16,162,99,6,23,29,5
S01009660,Owned: Total,263,191,164,14,150,23,4,72,66,0,1,4,1
S01009660,Owned: Owned outright,99,40,32,5,27,7,1,59,55,0,0,3,1
S01009660,Owned: Owned with a mortgage or loan or shared ownership,164,151,132,9,123,16,3,13,11,0,1,1,0
S01009660,Rented or living rent free: Total,167,77,63,21,42,2,12,90,33,6,22,25,4
S01009660,Rented or living rent free: Social rented,152,70,59,21,38,0,11,82,32,6,19,21,4
S01009660,Rented or living rent free: Private rented or living rent free,15,7,4,0,4,2,1,8,1,0,3,4,0
S01009661,All HRPs aged 16 and over,331,240,156,27,129,81,3,91,76,6,3,5,1
S01009661,Owned: Total,275,196,121,17,104,74,1,79,71,3,1,3,1
S01009661,Owned: Owned outright,157,86,50,11,39,35,1,71,66,2,1,1,1
S01009661,Owned: Owned with a mortgage or loan or shared ownership,118,110,71,6,65,39,0,8,5,1,0,2,0
S01009661,Rented or living rent free: Total,56,44,35,10,25,7,2,12,5,3,2,2,0
S01009661,Rented or living rent free: Social rented,2,1,1,1,0,0,0,1,0,0,1,0,0
S01009661,Rented or living rent free: Private rented or living rent free,54,43,34,9,25,7,2,11,5,3,1,2,0
S01009662,All HRPs aged 16 and over,292,206,157,19,138,45,4,86,76,0,4,6,0
S01009662,Owned: Total,232,168,128,15,113,39,1,64,64,0,0,0,0
S01009662,Owned: Owned outright,111,52,35,6,29,16,1,59,59,0,0,0,0
S01009662,Owned: Owned with a mortgage or loan or shared ownership,121,116,93,9,84,23,0,5,5,0,0,0,0
S01009662,Rented or living rent free: Total,60,38,29,4,25,6,3,22,12,0,4,6,0
S01009662,Rented or living rent free: Social rented,36,20,17,4,13,0,3,16,8,0,3,5,0
S01009662,Rented or living rent free: Private rented or living rent free,24,18,12,0,12,6,0,6,4,0,1,1,0
S01009663,All HRPs aged 16 and over,281,188,151,22,129,28,9,93,81,2,1,7,2
S01009663,Owned: Total,202,142,117,17,100,23,2,60,57,0,0,2,1
S01009663,Owned: Owned outright,103,48,38,9,29,9,1,55,52,0,0,2,1
S01009663,Owned: Owned with a mortgage or loan or shared ownership,99,94,79,8,71,14,1,5,5,0,0,0,0
S01009663,Rented or living rent free: Total,79,46,34,5,29,5,7,33,24,2,1,5,1
S01009663,Rented or living rent free: Social rented,45,21,14,2,12,2,5,24,19,0,1,3,1
S01009663,Rented or living rent free: Private rented or living rent free,34,25,20,3,17,3,2,9,5,2,0,2,0
S01009664,All HRPs aged 16 and over,377,278,212,31,181,60,6,99,89,0,2,7,1
S01009664,Owned: Total,281,210,163,25,138,45,2,71,66,0,1,3,1
S01009664,Owned: Owned outright,144,85,59,20,39,24,2,59,56,0,0,2,1
S01009664,Owned: Owned with a mortgage or loan or shared ownership,137,125,104,5,99,21,0,12,10,0,1,1,0
S01009664,Rented or living rent free: Total,96,68,49,6,43,15,4,28,23,0,1,4,0
S01009664,Rented or living rent free: Social rented,25,12,9,1,8,1,2,13,10,0,1,2,0
S01009664,Rented or living rent free: Private rented or living rent free,71,56,40,5,35,14,2,15,13,0,0,2,0
S01009665,All HRPs aged 16 and over,293,178,146,21,125,20,12,115,91,3,5,13,3
S01009665,Owned: Total,206,133,113,14,99,18,2,73,71,0,1,1,0
S01009665,Owned: Owned outright,109,40,32,7,25,6,2,69,67,0,1,1,0
S01009665,Owned: Owned with a mortgage or loan or shared ownership,97,93,81,7,74,12,0,4,4,0,0,0,0
S01009665,Rented or living rent free: Total,87,45,33,7,26,2,10,42,20,3,4,12,3
S01009665,Rented or living rent free: Social rented,62,30,21,4,17,1,8,32,15,1,3,10,3
S01009665,Rented or living rent free: Private rented or living rent free,25,15,12,3,9,1,2,10,5,2,1,2,0
S01009666,All HRPs aged 16 and over,342,204,158,15,143,39,7,138,115,2,4,12,5
S01009666,Owned: Total,229,162,127,7,120,32,3,67,63,0,1,1,2
S01009666,Owned: Owned outright,111,53,37,3,34,13,3,58,56,0,1,1,0
S01009666,Owned: Owned with a mortgage or loan or shared ownership,118,109,90,4,86,19,0,9,7,0,0,0,2
S01009666,Rented or living rent free: Total,113,42,31,8,23,7,4,71,52,2,3,11,3
S01009666,Rented or living rent free: Social rented,58,16,13,7,6,1,2,42,36,1,0,3,2
S01009666,Rented or living rent free: Private rented or living rent free,55,26,18,1,17,6,2,29,16,1,3,8,1
S01009667,All HRPs aged 16 and over,223,144,116,9,107,27,1,79,73,0,1,2,3
S01009667,Owned: Total,192,121,96,7,89,24,1,71,69,0,1,0,1
S01009667,Owned: Owned outright,107,39,27,5,22,12,0,68,66,0,1,0,1
S01009667,Owned: Owned with a mortgage or loan or shared ownership,85,82,69,2,67,12,1,3,3,0,0,0,0
S01009667,Rented or living rent free: Total,31,23,20,2,18,3,0,8,4,0,0,2,2
S01009667,Rented or living rent free: Social rented,15,10,8,2,6,2,0,5,3,0,0,0,2
S01009667,Rented or living rent free: Private rented or living rent free,16,13,12,0,12,1,0,3,1,0,0,2,0
S01009668,All HRPs aged 16 and over,243,183,154,17,137,24,5,60,53,0,3,2,2
S01009668,Owned: Total,211,157,134,12,122,22,1,54,50,0,1,1,2
S01009668,Owned: Owned outright,89,40,28,6,22,11,1,49,45,0,1,1,2
S01009668,Owned: Owned with a mortgage or loan or shared ownership,122,117,106,6,100,11,0,5,5,0,0,0,0
S01009668,Rented or living rent free: Total,32,26,20,5,15,2,4,6,3,0,2,1,0
S01009668,Rented or living rent free: Social rented,7,3,2,1,1,0,1,4,1,0,2,1,0
S01009668,Rented or living rent free: Private rented or living rent free,25,23,18,4,14,2,3,2,2,0,0,0,0
S01009669,All HRPs aged 16 and over,240,132,103,10,93,27,2,108,100,0,3,3,2
S01009669,Owned: Total,195,106,85,5,80,20,1,89,83,0,2,2,2
S01009669,Owned: Owned outright,121,38,26,3,23,11,1,83,78,0,1,2,2
S01009669,Owned: Owned with a mortgage or loan or shared ownership,74,68,59,2,57,9,0,6,5,0,1,0,0
S01009669,Rented or living rent free: Total,45,26,18,5,13,7,1,19,17,0,1,1,0
S01009669,Rented or living rent free: Social rented,19,8,4,2,2,3,1,11,11,0,0,0,0
S01009669,Rented or living rent free: Private rented or living rent free,26,18,14,3,11,4,0,8,6,0,1,1,0
S01009670,All HRPs aged 16 and over,340,222,180,21,159,36,6,118,98,6,2,9,3
S01009670,Owned: Total,241,174,139,12,127,34,1,67,65,1,0,1,0
S01009670,Owned: Owned outright,116,54,43,6,37,11,0,62,60,1,0,1,0
S01009670,Owned: Owned with a mortgage or loan or shared ownership,125,120,96,6,90,23,1,5,5,0,0,0,0
S01009670,Rented or living rent free: Total,99,48,41,9,32,2,5,51,33,5,2,8,3
S01009670,Rented or living rent free: Social rented,66,28,21,4,17,2,5,38,26,2,1,8,1
S01009670,Rented or living rent free: Private rented or living rent free,33,20,20,5,15,0,0,13,7,3,1,0,2
S01009671,All HRPs aged 16 and over,262,191,147,20,127,40,4,71,61,1,4,3,2
S01009671,Owned: Total,182,130,103,11,92,27,0,52,47,1,1,2,1
S01009671,Owned: Owned outright,77,32,20,8,12,12,0,45,42,1,0,1,1
S01009671,Owned: Owned with a mortgage or loan or shared ownership,105,98,83,3,80,15,0,7,5,0,1,1,0
S01009671,Rented or living rent free: Total,80,61,44,9,35,13,4,19,14,0,3,1,1
S01009671,Rented or living rent free: Social rented,18,11,6,0,6,1,4,7,4,0,2,0,1
S01009671,Rented or living rent free: Private rented or living rent free,62,50,38,9,29,12,0,12,10,0,1,1,0
S01009672,All HRPs aged 16 and over,355,228,200,37,163,20,8,127,88,1,6,25,7
S01009672,Owned: Total,200,148,135,18,117,13,0,52,46,1,0,3,2
S01009672,Owned: Owned outright,83,39,31,9,22,8,0,44,39,1,0,2,2
S01009672,Owned: Owned with a mortgage or loan or shared ownership,117,109,104,9,95,5,0,8,7,0,0,1,0
S01009672,Rented or living rent free: Total,155,80,65,19,46,7,8,75,42,0,6,22,5
S01009672,Rented or living rent free: Social rented,126,57,47,15,32,4,6,69,39,0,6,19,5
S01009672,Rented or living rent free: Private rented or living rent free,29,23,18,4,14,3,2,6,3,0,0,3,0
S01009673,All HRPs aged 16 and over,351,232,188,25,163,40,4,119,101,2,5,8,3
S01009673,Owned: Total,264,179,146,18,128,32,1,85,80,1,1,1,2
S01009673,Owned: Owned outright,120,46,35,10,25,10,1,74,71,1,0,0,2
S01009673,Owned: Owned with a mortgage or loan or shared ownership,144,133,111,8,103,22,0,11,9,0,1,1,0
S01009673,Rented or living rent free: Total,87,53,42,7,35,8,3,34,21,1,4,7,1
S01009673,Rented or living rent free: Social rented,48,24,19,3,16,3,2,24,13,1,4,5,1
S01009673,Rented or living rent free: Private rented or living rent free,39,29,23,4,19,5,1,10,8,0,0,2,0
S01009674,All HRPs aged 16 and over,392,260,189,25,164,64,7,132,123,3,2,3,1
S01009674,Owned: Total,295,201,145,16,129,52,4,94,94,0,0,0,0
S01009674,Owned: Owned outright,161,77,48,10,38,27,2,84,84,0,0,0,0
S01009674,Owned: Owned with a mortgage or loan or shared ownership,134,124,97,6,91,25,2,10,10,0,0,0,0
S01009674,Rented or living rent free: Total,97,59,44,9,35,12,3,38,29,3,2,3,1
S01009674,Rented or living rent free: Social rented,37,14,10,6,4,1,3,23,16,1,2,3,1
S01009674,Rented or living rent free: Private rented or living rent free,60,45,34,3,31,11,0,15,13,2,0,0,0
S01009675,All HRPs aged 16 and over,379,250,188,25,163,54,8,129,115,0,2,9,3
S01009675,Owned: Total,300,207,155,18,137,47,5,93,88,0,2,2,1
S01009675,Owned: Owned outright,151,73,49,10,39,24,0,78,74,0,1,2,1
S01009675,Owned: Owned with a mortgage or loan or shared ownership,149,134,106,8,98,23,5,15,14,0,1,0,0
S01009675,Rented or living rent free: Total,79,43,33,7,26,7,3,36,27,0,0,7,2
S01009675,Rented or living rent free: Social rented,35,16,12,3,9,1,3,19,15,0,0,3,1
S01009675,Rented or living rent free: Private rented or living rent free,44,27,21,4,17,6,0,17,12,0,0,4,1
S01009676,All HRPs aged 16 and over,356,236,185,28,157,48,3,120,102,0,3,8,7
S01009676,Owned: Total,242,181,138,15,123,41,2,61,55,0,0,3,3
S01009676,Owned: Owned outright,118,66,45,9,36,20,1,52,48,0,0,1,3
S01009676,Owned: Owned with a mortgage or loan or shared ownership,124,115,93,6,87,21,1,9,7,0,0,2,0
S01009676,Rented or living rent free: Total,114,55,47,13,34,7,1,59,47,0,3,5,4
S01009676,Rented or living rent free: Social rented,55,15,15,6,9,0,0,40,33,0,2,3,2
S01009676,Rented or living rent free: Private rented or living rent free,59,40,32,7,25,7,1,19,14,0,1,2,2
S01009677,All HRPs aged 16 and over,268,192,130,17,113,60,2,76,64,0,1,9,2
S01009677,Owned: Total,195,143,89,9,80,52,2,52,49,0,1,1,1
S01009677,Owned: Owned outright,107,59,30,6,24,28,1,48,45,0,1,1,1
S01009677,Owned: Owned with a mortgage or loan or shared ownership,88,84,59,3,56,24,1,4,4,0,0,0,0
S01009677,Rented or living rent free: Total,73,49,41,8,33,8,0,24,15,0,0,8,1
S01009677,Rented or living rent free: Social rented,19,7,7,3,4,0,0,12,8,0,0,4,0
S01009677,Rented or living rent free: Private rented or living rent free,54,42,34,5,29,8,0,12,7,0,0,4,1
S01009678,All HRPs aged 16 and over,273,167,133,22,111,34,0,106,97,1,3,4,1
S01009678,Owned: Total,197,121,93,14,79,28,0,76,71,1,0,3,1
S01009678,Owned: Owned outright,114,45,28,7,21,17,0,69,67,0,0,1,1
S01009678,Owned: Owned with a mortgage or loan or shared ownership,83,76,65,7,58,11,0,7,4,1,0,2,0
S01009678,Rented or living rent free: Total,76,46,40,8,32,6,0,30,26,0,3,1,0
S01009678,Rented or living rent free: Social rented,46,25,24,6,18,1,0,21,20,0,0,1,0
S01009678,Rented or living rent free: Private rented or living rent free,30,21,16,2,14,5,0,9,6,0,3,0,0
S01009679,All HRPs aged 16 and over,434,286,231,35,196,43,12,148,110,5,2,20,11
S01009679,Owned: Total,245,178,145,15,130,33,0,67,64,1,0,1,1
S01009679,Owned: Owned outright,121,58,45,8,37,13,0,63,60,1,0,1,1
S01009679,Owned: Owned with a mortgage or loan or shared ownership,124,120,100,7,93,20,0,4,4,0,0,0,0
S01009679,Rented or living rent free: Total,189,108,86,20,66,10,12,81,46,4,2,19,10
S01009679,Rented or living rent free: Social rented,120,54,43,11,32,3,8,66,35,3,0,19,9
S01009679,Rented or living rent free: Private rented or living rent free,69,54,43,9,34,7,4,15,11,1,2,0,1
S01009680,All HRPs aged 16 and over,356,240,183,31,152,44,13,116,100,2,5,5,4
S01009680,Owned: Total,229,161,124,13,111,37,0,68,62,2,2,2,0
S01009680,Owned: Owned outright,104,50,27,6,21,23,0,54,51,2,0,1,0
S01009680,Owned: Owned with a mortgage or loan or shared ownership,125,111,97,7,90,14,0,14,11,0,2,1,0
S01009680,Rented or living rent free: Total,127,79,59,18,41,7,13,48,38,0,3,3,4
S01009680,Rented or living rent free: Social rented,78,47,35,10,25,3,9,31,22,0,2,3,4
S01009680,Rented or living rent free: Private rented or living rent free,49,32,24,8,16,4,4,17,16,0,1,0,0
S01009681,All HRPs aged 16 and over,245,181,155,19,136,23,3,64,47,2,5,6,4
S01009681,Owned: Total,177,140,119,11,108,20,1,37,34,0,2,1,0
S01009681,Owned: Owned outright,60,29,23,6,17,6,0,31,29,0,1,1,0
S01009681,Owned: Owned with a mortgage or loan or shared ownership,117,111,96,5,91,14,1,6,5,0,1,0,0
S01009681,Rented or living rent free: Total,68,41,36,8,28,3,2,27,13,2,3,5,4
S01009681,Rented or living rent free: Social rented,45,23,21,7,14,0,2,22,11,0,3,4,4
S01009681,Rented or living rent free: Private rented or living rent free,23,18,15,1,14,3,0,5,2,2,0,1,0
S01009682,All HRPs aged 16 and over,278,185,163,27,136,18,4,93,87,2,0,2,2
S01009682,Owned: Total,220,142,126,18,108,15,1,78,77,0,0,0,1
S01009682,Owned: Owned outright,108,35,28,9,19,6,1,73,72,0,0,0,1
S01009682,Owned: Owned with a mortgage or loan or shared ownership,112,107,98,9,89,9,0,5,5,0,0,0,0
S01009682,Rented or living rent free: Total,58,43,37,9,28,3,3,15,10,2,0,2,1
S01009682,Rented or living rent free: Social rented,17,7,6,4,2,0,1,10,9,0,0,1,0
S01009682,Rented or living rent free: Private rented or living rent free,41,36,31,5,26,3,2,5,1,2,0,1,1
S01009683,All HRPs aged 16 and over,364,204,162,25,137,36,6,160,149,2,1,7,1
S01009683,Owned: Total,284,164,131,19,112,32,1,120,117,0,1,1,1
S01009683,Owned: Owned outright,162,50,37,9,28,12,1,112,110,0,0,1,1
S01009683,Owned: Owned with a mortgage or loan or shared ownership,122,114,94,10,84,20,0,8,7,0,1,0,0
S01009683,Rented or living rent free: Total,80,40,31,6,25,4,5,40,32,2,0,6,0
S01009683,Rented or living rent free: Social rented,40,12,11,4,7,0,1,28,23,0,0,5,0
S01009683,Rented or living rent free: Private rented or living rent free,40,28,20,2,18,4,4,12,9,2,0,1,0
S01009684,All HRPs aged 16 and over,395,302,235,17,218,63,4,93,81,2,1,6,3
S01009684,Owned: Total,304,228,174,10,164,54,0,76,71,1,0,2,2
S01009684,Owned: Owned outright,135,63,39,5,34,24,0,72,68,0,0,2,2
S01009684,Owned: Owned with a mortgage or loan or shared ownership,169,165,135,5,130,30,0,4,3,1,0,0,0
S01009684,Rented or living rent free: Total,91,74,61,7,54,9,4,17,10,1,1,4,1
S01009684,Rented or living rent free: Social rented,20,11,9,2,7,0,2,9,4,0,1,3,1
S01009684,Rented or living rent free: Private rented or living rent free,71,63,52,5,47,9,2,8,6,1,0,1,0
S01009685,All HRPs aged 16 and over,264,174,150,17,133,20,4,90,71,1,8,9,1
S01009685,Owned: Total,149,109,94,6,88,14,1,40,39,0,1,0,0
S01009685,Owned: Owned outright,63,28,25,2,23,2,1,35,35,0,0,0,0
S01009685,Owned: Owned with a mortgage or loan or shared ownership,86,81,69,4,65,12,0,5,4,0,1,0,0
S01009685,Rented or living rent free: Total,115,65,56,11,45,6,3,50,32,1,7,9,1
S01009685,Rented or living rent free: Social rented,79,41,38,11,27,1,2,38,23,1,4,9,1
S01009685,Rented or living rent free: Private rented or living rent free,36,24,18,0,18,5,1,12,9,0,3,0,0
S01009686,All HRPs aged 16 and over,544,345,290,49,241,36,19,199,145,10,12,26,6
S01009686,Owned: Total,255,183,152,14,138,29,2,72,66,2,1,1,2
S01009686,Owned: Owned outright,96,34,23,3,20,10,1,62,58,1,1,0,2
S01009686,Owned: Owned with a mortgage or loan or shared ownership,159,149,129,11,118,19,1,10,8,1,0,1,0
S01009686,Rented or living rent free: Total,289,162,138,35,103,7,17,127,79,8,11,25,4
S01009686,Rented or living rent free: Social rented,160,62,49,22,27,2,11,98,70,0,5,21,2
S01009686,Rented or living rent free: Private rented or living rent free,129,100,89,13,76,5,6,29,9,8,6,4,2
S01009687,All HRPs aged 16 and over,299,208,175,23,152,27,6,91,77,1,2,8,3
S01009687,Owned: Total,202,134,110,16,94,23,1,68,62,0,1,3,2
S01009687,Owned: Owned outright,84,23,19,6,13,4,0,61,57,0,0,3,1
S01009687,Owned: Owned with a mortgage or loan or shared ownership,118,111,91,10,81,19,1,7,5,0,1,0,1
S01009687,Rented or living rent free: Total,97,74,65,7,58,4,5,23,15,1,1,5,1
S01009687,Rented or living rent free: Social rented,44,25,20,4,16,1,4,19,13,0,1,5,0
S01009687,Rented or living rent free: Private rented or living rent free,53,49,45,3,42,3,1,4,2,1,0,0,1
S01009688,All HRPs aged 16 and over,456,266,207,39,168,19,40,190,109,11,20,35,15
S01009688,Owned: Total,136,91,74,10,64,13,4,45,41,0,1,1,2
S01009688,Owned: Owned outright,60,22,16,5,11,6,0,38,35,0,1,0,2
S01009688,Owned: Owned with a mortgage or loan or shared ownership,76,69,58,5,53,7,4,7,6,0,0,1,0
S01009688,Rented or living rent free: Total,320,175,133,29,104,6,36,145,68,11,19,34,13
S01009688,Rented or living rent free: Social rented,275,143,105,24,81,4,34,132,64,6,18,32,12
S01009688,Rented or living rent free: Private rented or living rent free,45,32,28,5,23,2,2,13,4,5,1,2,1
S01009689,All HRPs aged 16 and over,333,214,172,30,142,26,16,119,89,7,0,16,7
S01009689,Owned: Total,158,108,88,9,79,18,2,50,48,1,0,0,1
S01009689,Owned: Owned outright,73,29,22,4,18,6,1,44,42,1,0,0,1
S01009689,Owned: Owned with a mortgage or loan or shared ownership,85,79,66,5,61,12,1,6,6,0,0,0,0
S01009689,Rented or living rent free: Total,175,106,84,21,63,8,14,69,41,6,0,16,6
S01009689,Rented or living rent free: Social rented,80,28,22,7,15,0,6,52,36,0,0,12,4
S01009689,Rented or living rent free: Private rented or living rent free,95,78,62,14,48,8,8,17,5,6,0,4,2
S01009690,All HRPs aged 16 and over,347,242,197,26,171,28,17,105,84,2,3,13,3
S01009690,Owned: Total,213,154,131,11,120,21,2,59,57,0,0,1,1
S01009690,Owned: Owned outright,83,29,21,5,16,6,2,54,54,0,0,0,0
S01009690,Owned: Owned with a mortgage or loan or shared ownership,130,125,110,6,104,15,0,5,3,0,0,1,1
S01009690,Rented or living rent free: Total,134,88,66,15,51,7,15,46,27,2,3,12,2
S01009690,Rented or living rent free: Social rented,72,40,27,12,15,1,12,32,19,1,1,10,1
S01009690,Rented or living rent free: Private rented or living rent free,62,48,39,3,36,6,3,14,8,1,2,2,1
S01009691,All HRPs aged 16 and over,260,153,129,18,111,21,3,107,102,1,1,0,3
S01009691,Owned: Total,235,134,113,15,98,20,1,101,100,0,0,0,1
S01009691,Owned: Owned outright,139,45,36,8,28,9,0,94,93,0,0,0,1
S01009691,Owned: Owned with a mortgage or loan or shared ownership,96,89,77,7,70,11,1,7,7,0,0,0,0
S01009691,Rented or living rent free: Total,25,19,16,3,13,1,2,6,2,1,1,0,2
S01009691,Rented or living rent free: Social rented,4,3,3,1,2,0,0,1,0,0,1,0,0
S01009691,Rented or living rent free: Private rented or living rent free,21,16,13,2,11,1,2,5,2,1,0,0,2
S01009692,All HRPs aged 16 and over,484,266,218,28,190,40,8,218,208,0,3,4,3
S01009692,Owned: Total,411,211,174,22,152,33,4,200,197,0,1,2,0
S01009692,Owned: Owned outright,264,83,66,17,49,14,3,181,180,0,0,1,0
S01009692,Owned: Owned with a mortgage or loan or shared ownership,147,128,108,5,103,19,1,19,17,0,1,1,0
S01009692,Rented or living rent free: Total,73,55,44,6,38,7,4,18,11,0,2,2,3
S01009692,Rented or living rent free: Social rented,21,16,12,3,9,1,3,5,3,0,0,2,0
S01009692,Rented or living rent free: Private rented or living rent free,52,39,32,3,29,6,1,13,8,0,2,0,3
S01009693,All HRPs aged 16 and over,252,156,131,19,112,20,5,96,91,0,2,2,1
S01009693,Owned: Total,221,136,117,17,100,16,3,85,84,0,0,0,1
S01009693,Owned: Owned outright,129,46,38,11,27,6,2,83,82,0,0,0,1
S01009693,Owned: Owned with a mortgage or loan or shared ownership,92,90,79,6,73,10,1,2,2,0,0,0,0
S01009693,Rented or living rent free: Total,31,20,14,2,12,4,2,11,7,0,2,2,0
S01009693,Rented or living rent free: Social rented,9,5,3,0,3,0,2,4,1,0,1,2,0
S01009693,Rented or living rent free: Private rented or living rent free,22,15,11,2,9,4,0,7,6,0,1,0,0
S01009694,All HRPs aged 16 and over,453,238,212,35,177,25,1,215,203,1,1,3,7
S01009694,Owned: Total,394,210,186,29,157,23,1,184,180,0,1,1,2
S01009694,Owned: Owned outright,243,75,64,20,44,10,1,168,164,0,1,1,2
S01009694,Owned: Owned with a mortgage or loan or shared ownership,151,135,122,9,113,13,0,16,16,0,0,0,0
S01009694,Rented or living rent free: Total,59,28,26,6,20,2,0,31,23,1,0,2,5
S01009694,Rented or living rent free: Social rented,18,2,1,1,0,1,0,16,11,0,0,2,3
S01009694,Rented or living rent free: Private rented or living rent free,41,26,25,5,20,1,0,15,12,1,0,0,2
S01009695,All HRPs aged 16 and over,278,179,134,21,113,40,5,99,88,1,1,5,4
S01009695,Owned: Total,218,144,108,14,94,35,1,74,72,0,0,1,1
S01009695,Owned: Owned outright,128,64,42,10,32,22,0,64,63,0,0,0,1
S01009695,Owned: Owned with a mortgage or loan or shared ownership,90,80,66,4,62,13,1,10,9,0,0,1,0
S01009695,Rented or living rent free: Total,60,35,26,7,19,5,4,25,16,1,1,4,3
S01009695,Rented or living rent free: Social rented,20,8,5,3,2,0,3,12,7,0,0,3,2
S01009695,Rented or living rent free: Private rented or living rent free,40,27,21,4,17,5,1,13,9,1,1,1,1
S01009696,All HRPs aged 16 and over,443,280,211,29,182,62,7,163,143,2,2,12,4
S01009696,Owned: Total,336,218,166,20,146,48,4,118,113,0,0,3,2
S01009696,Owned: Owned outright,185,77,53,14,39,22,2,108,104,0,0,2,2
S01009696,Owned: Owned with a mortgage or loan or shared ownership,151,141,113,6,107,26,2,10,9,0,0,1,0
S01009696,Rented or living rent free: Total,107,62,45,9,36,14,3,45,30,2,2,9,2
S01009696,Rented or living rent free: Social rented,42,16,12,5,7,3,1,26,16,1,1,7,1
S01009696,Rented or living rent free: Private rented or living rent free,65,46,33,4,29,11,2,19,14,1,1,2,1
S01009697,All HRPs aged 16 and over,314,204,159,21,138,43,2,110,97,1,1,9,2
S01009697,Owned: Total,239,163,127,12,115,35,1,76,76,0,0,0,0
S01009697,Owned: Owned outright,126,58,40,8,32,18,0,68,68,0,0,0,0
S01009697,Owned: Owned with a mortgage or loan or shared ownership,113,105,87,4,83,17,1,8,8,0,0,0,0
S01009697,Rented or living rent free: Total,75,41,32,9,23,8,1,34,21,1,1,9,2
S01009697,Rented or living rent free: Social rented,33,11,9,3,6,1,1,22,13,0,1,8,0
S01009697,Rented or living rent free: Private rented or living rent free,42,30,23,6,17,7,0,12,8,1,0,1,2
S01009698,All HRPs aged 16 and over,232,167,111,13,98,55,1,65,47,9,1,7,1
S01009698,Owned: Total,159,115,73,8,65,42,0,44,42,0,0,1,1
S01009698,Owned: Owned outright,95,53,32,5,27,21,0,42,40,0,0,1,1
S01009698,Owned: Owned with a mortgage or loan or shared ownership,64,62,41,3,38,21,0,2,2,0,0,0,0
S01009698,Rented or living rent free: Total,73,52,38,5,33,13,1,21,5,9,1,6,0
S01009698,Rented or living rent free: Social rented,3,1,1,0,1,0,0,2,0,0,0,2,0
S01009698,Rented or living rent free: Private rented or living rent free,70,51,37,5,32,13,1,19,5,9,1,4,0
S01009699,All HRPs aged 16 and over,236,107,77,17,60,26,4,129,117,0,1,8,3
S01009699,Owned: Total,175,74,52,10,42,21,1,101,95,0,1,2,3
S01009699,Owned: Owned outright,133,39,24,4,20,14,1,94,89,0,1,2,2
S01009699,Owned: Owned with a mortgage or loan or shared ownership,42,35,28,6,22,7,0,7,6,0,0,0,1
S01009699,Rented or living rent free: Total,61,33,25,7,18,5,3,28,22,0,0,6,0
S01009699,Rented or living rent free: Social rented,26,8,8,1,7,0,0,18,13,0,0,5,0
S01009699,Rented or living rent free: Private rented or living rent free,35,25,17,6,11,5,3,10,9,0,0,1,0
S01009700,All HRPs aged 16 and over,297,184,132,21,111,47,5,113,94,5,5,7,2
S01009700,Owned: Total,184,116,85,11,74,29,2,68,64,1,0,2,1
S01009700,Owned: Owned outright,102,43,27,7,20,15,1,59,58,1,0,0,0
S01009700,Owned: Owned with a mortgage or loan or shared ownership,82,73,58,4,54,14,1,9,6,0,0,2,1
S01009700,Rented or living rent free: Total,113,68,47,10,37,18,3,45,30,4,5,5,1
S01009700,Rented or living rent free: Social rented,42,22,18,7,11,3,1,20,13,1,3,2,1
S01009700,Rented or living rent free: Private rented or living rent free,71,46,29,3,26,15,2,25,17,3,2,3,0
S01009701,All HRPs aged 16 and over,229,98,62,11,51,34,2,131,123,3,1,4,0
S01009701,Owned: Total,166,69,41,6,35,28,0,97,92,3,1,1,0
S01009701,Owned: Owned outright,127,38,23,4,19,15,0,89,86,2,0,1,0
S01009701,Owned: Owned with a mortgage or loan or shared ownership,39,31,18,2,16,13,0,8,6,1,1,0,0
S01009701,Rented or living rent free: Total,63,29,21,5,16,6,2,34,31,0,0,3,0
S01009701,Rented or living rent free: Social rented,45,19,15,3,12,2,2,26,23,0,0,3,0
S01009701,Rented or living rent free: Private rented or living rent free,18,10,6,2,4,4,0,8,8,0,0,0,0
S01009702,All HRPs aged 16 and over,265,194,125,24,101,62,7,71,61,1,1,8,0
S01009702,Owned: Total,173,125,74,11,63,50,1,48,44,0,1,3,0
S01009702,Owned: Owned outright,100,60,33,7,26,26,1,40,38,0,0,2,0
S01009702,Owned: Owned with a mortgage or loan or shared ownership,73,65,41,4,37,24,0,8,6,0,1,1,0
S01009702,Rented or living rent free: Total,92,69,51,13,38,12,6,23,17,1,0,5,0
S01009702,Rented or living rent free: Social rented,31,22,19,7,12,0,3,9,5,1,0,3,0
S01009702,Rented or living rent free: Private rented or living rent free,61,47,32,6,26,12,3,14,12,0,0,2,0
S01009703,All HRPs aged 16 and over,285,156,118,25,93,36,2,129,107,2,4,14,2
S01009703,Owned: Total,182,107,83,13,70,23,1,75,68,1,2,3,1
S01009703,Owned: Owned outright,107,44,31,7,24,12,1,63,60,1,1,1,0
S01009703,Owned: Owned with a mortgage or loan or shared ownership,75,63,52,6,46,11,0,12,8,0,1,2,1
S01009703,Rented or living rent free: Total,103,49,35,12,23,13,1,54,39,1,2,11,1
S01009703,Rented or living rent free: Social rented,83,37,28,10,18,8,1,46,34,0,1,10,1
S01009703,Rented or living rent free: Private rented or living rent free,20,12,7,2,5,5,0,8,5,1,1,1,0
S01009704,All HRPs aged 16 and over,440,275,180,37,143,89,6,165,148,3,1,9,4
S01009704,Owned: Total,330,206,129,17,112,76,1,124,120,1,0,1,2
S01009704,Owned: Owned outright,216,100,53,11,42,47,0,116,113,1,0,1,1
S01009704,Owned: Owned with a mortgage or loan or shared ownership,114,106,76,6,70,29,1,8,7,0,0,0,1
S01009704,Rented or living rent free: Total,110,69,51,20,31,13,5,41,28,2,1,8,2
S01009704,Rented or living rent free: Social rented,56,28,23,10,13,2,3,28,17,2,1,6,2
S01009704,Rented or living rent free: Private rented or living rent free,54,41,28,10,18,11,2,13,11,0,0,2,0
S01009705,All HRPs aged 16 and over,363,235,169,33,136,52,14,128,109,1,4,13,1
S01009705,Owned: Total,217,139,101,15,86,35,3,78,77,0,0,1,0
S01009705,Owned: Owned outright,125,55,33,9,24,21,1,70,69,0,0,1,0
S01009705,Owned: Owned with a mortgage or loan or shared ownership,92,84,68,6,62,14,2,8,8,0,0,0,0
S01009705,Rented or living rent free: Total,146,96,68,18,50,17,11,50,32,1,4,12,1
S01009705,Rented or living rent free: Social rented,113,72,52,16,36,9,11,41,27,0,3,10,1
S01009705,Rented or living rent free: Private rented or living rent free,33,24,16,2,14,8,0,9,5,1,1,2,0
S01009706,All HRPs aged 16 and over,295,172,110,19,91,50,12,123,101,1,6,10,5
S01009706,Owned: Total,187,105,73,5,68,29,3,82,76,0,0,2,4
S01009706,Owned: Owned outright,108,32,16,3,13,16,0,76,73,0,0,1,2
S01009706,Owned: Owned with a mortgage or loan or shared ownership,79,73,57,2,55,13,3,6,3,0,0,1,2
S01009706,Rented or living rent free: Total,108,67,37,14,23,21,9,41,25,1,6,8,1
S01009706,Rented or living rent free: Social rented,55,31,18,9,9,6,7,24,14,1,3,6,0
S01009706,Rented or living rent free: Private rented or living rent free,53,36,19,5,14,15,2,17,11,0,3,2,1
S01009707,All HRPs aged 16 and over,218,150,120,18,102,30,0,68,58,4,1,4,1
S01009707,Owned: Total,164,114,90,12,78,24,0,50,48,1,0,1,0
S01009707,Owned: Owned outright,83,37,30,7,23,7,0,46,44,1,0,1,0
S01009707,Owned: Owned with a mortgage or loan or shared ownership,81,77,60,5,55,17,0,4,4,0,0,0,0
S01009707,Rented or living rent free: Total,54,36,30,6,24,6,0,18,10,3,1,3,1
S01009707,Rented or living rent free: Social rented,1,1,1,0,1,0,0,0,0,0,0,0,0
S01009707,Rented or living rent free: Private rented or living rent free,53,35,29,6,23,6,0,18,10,3,1,3,1
S01009708,All HRPs aged 16 and over,258,157,112,23,89,41,4,101,86,2,3,5,5
S01009708,Owned: Total,192,120,81,10,71,38,1,72,68,1,0,2,1
S01009708,Owned: Owned outright,106,43,27,8,19,15,1,63,60,0,0,2,1
S01009708,Owned: Owned with a mortgage or loan or shared ownership,86,77,54,2,52,23,0,9,8,1,0,0,0
S01009708,Rented or living rent free: Total,66,37,31,13,18,3,3,29,18,1,3,3,4
S01009708,Rented or living rent free: Social rented,42,21,20,9,11,1,0,21,13,0,3,3,2
S01009708,Rented or living rent free: Private rented or living rent free,24,16,11,4,7,2,3,8,5,1,0,0,2
S01009709,All HRPs aged 16 and over,394,226,168,28,140,48,10,168,149,2,0,10,7
S01009709,Owned: Total,280,170,133,15,118,36,1,110,105,0,0,1,4
S01009709,Owned: Owned outright,160,62,40,10,30,21,1,98,94,0,0,1,3
S01009709,Owned: Owned with a mortgage or loan or shared ownership,120,108,93,5,88,15,0,12,11,0,0,0,1
S01009709,Rented or living rent free: Total,114,56,35,13,22,12,9,58,44,2,0,9,3
S01009709,Rented or living rent free: Social rented,59,23,14,7,7,1,8,36,27,1,0,5,3
S01009709,Rented or living rent free: Private rented or living rent free,55,33,21,6,15,11,1,22,17,1,0,4,0
S01009710,All HRPs aged 16 and over,246,174,121,19,102,42,11,72,60,1,1,7,3
S01009710,Owned: Total,169,120,88,10,78,31,1,49,49,0,0,0,0
S01009710,Owned: Owned outright,72,30,18,3,15,12,0,42,42,0,0,0,0
S01009710,Owned: Owned with a mortgage or loan or shared ownership,97,90,70,7,63,19,1,7,7,0,0,0,0
S01009710,Rented or living rent free: Total,77,54,33,9,24,11,10,23,11,1,1,7,3
S01009710,Rented or living rent free: Social rented,45,29,16,8,8,5,8,16,6,1,0,6,3
S01009710,Rented or living rent free: Private rented or living rent free,32,25,17,1,16,6,2,7,5,0,1,1,0
S01009711,All HRPs aged 16 and over,341,210,142,28,114,59,9,131,108,2,7,10,4
S01009711,Owned: Total,191,133,81,13,68,51,1,58,52,0,2,2,2
S01009711,Owned: Owned outright,97,46,27,5,22,19,0,51,48,0,1,1,1
S01009711,Owned: Owned with a mortgage or loan or shared ownership,94,87,54,8,46,32,1,7,4,0,1,1,1
S01009711,Rented or living rent free: Total,150,77,61,15,46,8,8,73,56,2,5,8,2
S01009711,Rented or living rent free: Social rented,109,49,39,11,28,3,7,60,49,1,4,5,1
S01009711,Rented or living rent free: Private rented or living rent free,41,28,22,4,18,5,1,13,7,1,1,3,1
S01009712,All HRPs aged 16 and over,277,173,129,28,101,38,6,104,86,3,5,8,2
S01009712,Owned: Total,195,126,88,19,69,36,2,69,66,1,1,0,1
S01009712,Owned: Owned outright,118,57,36,15,21,21,0,61,58,1,1,0,1
S01009712,Owned: Owned with a mortgage or loan or shared ownership,77,69,52,4,48,15,2,8,8,0,0,0,0
S01009712,Rented or living rent free: Total,82,47,41,9,32,2,4,35,20,2,4,8,1
S01009712,Rented or living rent free: Social rented,29,14,13,4,9,0,1,15,7,0,1,6,1
S01009712,Rented or living rent free: Private rented or living rent free,53,33,28,5,23,2,3,20,13,2,3,2,0
S01009713,All HRPs aged 16 and over,444,235,160,42,118,64,11,209,190,3,3,7,6
S01009713,Owned: Total,295,154,95,18,77,56,3,141,137,2,0,1,1
S01009713,Owned: Owned outright,195,66,36,10,26,28,2,129,126,2,0,0,1
S01009713,Owned: Owned with a mortgage or loan or shared ownership,100,88,59,8,51,28,1,12,11,0,0,1,0
S01009713,Rented or living rent free: Total,149,81,65,24,41,8,8,68,53,1,3,6,5
S01009713,Rented or living rent free: Social rented,70,29,22,10,12,3,4,41,33,0,1,4,3
S01009713,Rented or living rent free: Private rented or living rent free,79,52,43,14,29,5,4,27,20,1,2,2,2
S01009714,All HRPs aged 16 and over,453,241,175,24,151,55,11,212,201,1,4,5,1
S01009714,Owned: Total,348,166,119,13,106,45,2,182,178,1,2,1,0
S01009714,Owned: Owned outright,235,74,44,10,34,28,2,161,159,1,1,0,0
S01009714,Owned: Owned with a mortgage or loan or shared ownership,113,92,75,3,72,17,0,21,19,0,1,1,0
S01009714,Rented or living rent free: Total,105,75,56,11,45,10,9,30,23,0,2,4,1
S01009714,Rented or living rent free: Social rented,47,32,24,6,18,3,5,15,13,0,2,0,0
S01009714,Rented or living rent free: Private rented or living rent free,58,43,32,5,27,7,4,15,10,0,0,4,1
S01009715,All HRPs aged 16 and over,334,224,154,23,131,63,7,110,100,1,2,4,3
S01009715,Owned: Total,192,116,81,5,76,35,0,76,72,1,0,1,2
S01009715,Owned: Owned outright,131,62,38,4,34,24,0,69,67,0,0,0,2
S01009715,Owned: Owned with a mortgage or loan or shared ownership,61,54,43,1,42,11,0,7,5,1,0,1,0
S01009715,Rented or living rent free: Total,142,108,73,18,55,28,7,34,28,0,2,3,1
S01009715,Rented or living rent free: Social rented,33,23,15,5,10,7,1,10,6,0,2,2,0
S01009715,Rented or living rent free: Private rented or living rent free,109,85,58,13,45,21,6,24,22,0,0,1,1
S01009716,All HRPs aged 16 and over,329,170,136,23,113,28,6,159,135,15,3,5,1
S01009716,Owned: Total,244,126,97,17,80,26,3,118,116,0,1,1,0
S01009716,Owned: Owned outright,164,53,39,7,32,11,3,111,111,0,0,0,0
S01009716,Owned: Owned with a mortgage or loan or shared ownership,80,73,58,10,48,15,0,7,5,0,1,1,0
S01009716,Rented or living rent free: Total,85,44,39,6,33,2,3,41,19,15,2,4,1
S01009716,Rented or living rent free: Social rented,25,10,8,3,5,2,0,15,10,0,1,4,0
S01009716,Rented or living rent free: Private rented or living rent free,60,34,31,3,28,0,3,26,9,15,1,0,1
S01009717,All HRPs aged 16 and over,327,181,147,54,93,17,17,146,82,43,1,17,3
S01009717,Owned: Total,123,66,49,8,41,13,4,57,52,3,0,0,2
S01009717,Owned: Owned outright,69,20,13,3,10,6,1,49,46,2,0,0,1
S01009717,Owned: Owned with a mortgage or loan or shared ownership,54,46,36,5,31,7,3,8,6,1,0,0,1
S01009717,Rented or living rent free: Total,204,115,98,46,52,4,13,89,30,40,1,17,1
S01009717,Rented or living rent free: Social rented,115,66,53,21,32,4,9,49,27,3,1,17,1
S01009717,Rented or living rent free: Private rented or living rent free,89,49,45,25,20,0,4,40,3,37,0,0,0
S01009718,All HRPs aged 16 and over,327,188,163,48,115,14,11,139,87,34,4,11,3
S01009718,Owned: Total,164,89,84,16,68,4,1,75,70,2,2,0,1
S01009718,Owned: Owned outright,99,32,29,10,19,2,1,67,65,0,1,0,1
S01009718,Owned: Owned with a mortgage or loan or shared ownership,65,57,55,6,49,2,0,8,5,2,1,0,0
S01009718,Rented or living rent free: Total,163,99,79,32,47,10,10,64,17,32,2,11,2
S01009718,Rented or living rent free: Social rented,106,71,54,20,34,8,9,35,16,5,2,10,2
S01009718,Rented or living rent free: Private rented or living rent free,57,28,25,12,13,2,1,29,1,27,0,1,0
S01009719,All HRPs aged 16 and over,342,199,169,39,130,24,6,143,109,10,10,12,2
S01009719,Owned: Total,185,106,93,15,78,13,0,79,74,1,0,4,0
S01009719,Owned: Owned outright,107,40,31,9,22,9,0,67,66,0,0,1,0
S01009719,Owned: Owned with a mortgage or loan or shared ownership,78,66,62,6,56,4,0,12,8,1,0,3,0
S01009719,Rented or living rent free: Total,157,93,76,24,52,11,6,64,35,9,10,8,2
S01009719,Rented or living rent free: Social rented,113,60,46,16,30,9,5,53,34,0,9,8,2
S01009719,Rented or living rent free: Private rented or living rent free,44,33,30,8,22,2,1,11,1,9,1,0,0
S01009720,All HRPs aged 16 and over,379,198,178,51,127,14,6,181,152,16,1,9,3
S01009720,Owned: Total,179,97,85,19,66,12,0,82,77,1,0,2,2
S01009720,Owned: Owned outright,101,33,29,12,17,4,0,68,64,1,0,2,1
S01009720,Owned: Owned with a mortgage or loan or shared ownership,78,64,56,7,49,8,0,14,13,0,0,0,1
S01009720,Rented or living rent free: Total,200,101,93,32,61,2,6,99,75,15,1,7,1
S01009720,Rented or living rent free: Social rented,118,41,37,13,24,1,3,77,69,0,0,7,1
S01009720,Rented or living rent free: Private rented or living rent free,82,60,56,19,37,1,3,22,6,15,1,0,0
S01009721,All HRPs aged 16 and over,221,120,92,52,40,14,14,101,12,87,2,0,0
S01009721,Owned: Total,46,29,19,4,15,7,3,17,11,5,1,0,0
S01009721,Owned: Owned outright,25,12,8,3,5,3,1,13,10,2,1,0,0
S01009721,Owned: Owned with a mortgage or loan or shared ownership,21,17,11,1,10,4,2,4,1,3,0,0,0
S01009721,Rented or living rent free: Total,175,91,73,48,25,7,11,84,1,82,1,0,0
S01009721,Rented or living rent free: Social rented,1,1,1,0,1,0,0,0,0,0,0,0,0
S01009721,Rented or living rent free: Private rented or living rent free,174,90,72,48,24,7,11,84,1,82,1,0,0
S01009722,All HRPs aged 16 and over,387,171,146,75,71,16,9,216,89,109,0,13,5
S01009722,Owned: Total,128,50,38,9,29,12,0,78,73,2,0,3,0
S01009722,Owned: Owned outright,98,27,18,5,13,9,0,71,69,1,0,1,0
S01009722,Owned: Owned with a mortgage or loan or shared ownership,30,23,20,4,16,3,0,7,4,1,0,2,0
S01009722,Rented or living rent free: Total,259,121,108,66,42,4,9,138,16,107,0,10,5
S01009722,Rented or living rent free: Social rented,39,15,11,2,9,2,2,24,10,2,0,9,3
S01009722,Rented or living rent free: Private rented or living rent free,220,106,97,64,33,2,7,114,6,105,0,1,2
S01009723,All HRPs aged 16 and over,302,138,115,60,55,14,9,164,72,88,0,2,2
S01009723,Owned: Total,67,37,26,4,22,8,3,30,27,3,0,0,0
S01009723,Owned: Owned outright,44,20,14,3,11,4,2,24,23,1,0,0,0
S01009723,Owned: Owned with a mortgage or loan or shared ownership,23,17,12,1,11,4,1,6,4,2,0,0,0
S01009723,Rented or living rent free: Total,235,101,89,56,33,6,6,134,45,85,0,2,2
S01009723,Rented or living rent free: Social rented,55,13,11,5,6,0,2,42,37,3,0,1,1
S01009723,Rented or living rent free: Private rented or living rent free,180,88,78,51,27,6,4,92,8,82,0,1,1
S01009724,All HRPs aged 16 and over,495,257,210,81,129,25,22,238,125,81,5,19,8
S01009724,Owned: Total,121,63,55,8,47,7,1,58,48,7,1,1,1
S01009724,Owned: Owned outright,65,23,19,4,15,4,0,42,36,4,1,0,1
S01009724,Owned: Owned with a mortgage or loan or shared ownership,56,40,36,4,32,3,1,16,12,3,0,1,0
S01009724,Rented or living rent free: Total,374,194,155,73,82,18,21,180,77,74,4,18,7
S01009724,Rented or living rent free: Social rented,184,82,60,26,34,11,11,102,72,4,3,17,6
S01009724,Rented or living rent free: Private rented or living rent free,190,112,95,47,48,7,10,78,5,70,1,1,1
S01009725,All HRPs aged 16 and over,251,142,120,70,50,11,11,109,43,63,0,2,1
S01009725,Owned: Total,83,38,27,9,18,9,2,45,38,7,0,0,0
S01009725,Owned: Owned outright,60,23,15,7,8,6,2,37,34,3,0,0,0
S01009725,Owned: Owned with a mortgage or loan or shared ownership,23,15,12,2,10,3,0,8,4,4,0,0,0
S01009725,Rented or living rent free: Total,168,104,93,61,32,2,9,64,5,56,0,2,1
S01009725,Rented or living rent free: Social rented,14,10,8,5,3,0,2,4,2,1,0,1,0
S01009725,Rented or living rent free: Private rented or living rent free,154,94,85,56,29,2,7,60,3,55,0,1,1
S01009726,All HRPs aged 16 and over,209,106,76,43,33,21,9,103,28,73,0,2,0
S01009726,Owned: Total,66,34,17,4,13,14,3,32,25,6,0,1,0
S01009726,Owned: Owned outright,42,12,6,1,5,5,1,30,24,5,0,1,0
S01009726,Owned: Owned with a mortgage or loan or shared ownership,24,22,11,3,8,9,2,2,1,1,0,0,0
S01009726,Rented or living rent free: Total,143,72,59,39,20,7,6,71,3,67,0,1,0
S01009726,Rented or living rent free: Social rented,10,6,3,0,3,1,2,4,0,3,0,1,0
S01009726,Rented or living rent free: Private rented or living rent free,133,66,56,39,17,6,4,67,3,64,0,0,0
S01009727,All HRPs aged 16 and over,331,226,167,27,140,50,9,105,76,20,3,3,3
S01009727,Owned: Total,207,136,94,10,84,42,0,71,68,2,0,0,1
S01009727,Owned: Owned outright,120,58,32,6,26,26,0,62,61,0,0,0,1
S01009727,Owned: Owned with a mortgage or loan or shared ownership,87,78,62,4,58,16,0,9,7,2,0,0,0
S01009727,Rented or living rent free: Total,124,90,73,17,56,8,9,34,8,18,3,3,2
S01009727,Rented or living rent free: Social rented,47,36,28,10,18,2,6,11,4,1,2,3,1
S01009727,Rented or living rent free: Private rented or living rent free,77,54,45,7,38,6,3,23,4,17,1,0,1
S01009728,All HRPs aged 16 and over,333,197,162,22,140,32,3,136,123,5,3,2,3
S01009728,Owned: Total,294,168,138,17,121,29,1,126,122,0,1,1,2
S01009728,Owned: Owned outright,179,61,49,10,39,12,0,118,116,0,1,0,1
S01009728,Owned: Owned with a mortgage or loan or shared ownership,115,107,89,7,82,17,1,8,6,0,0,1,1
S01009728,Rented or living rent free: Total,39,29,24,5,19,3,2,10,1,5,2,1,1
S01009728,Rented or living rent free: Social rented,7,3,2,1,1,1,0,4,0,0,2,1,1
S01009728,Rented or living rent free: Private rented or living rent free,32,26,22,4,18,2,2,6,1,5,0,0,0
S01009729,All HRPs aged 16 and over,282,141,121,17,104,20,0,141,133,8,0,0,0
S01009729,Owned: Total,252,124,106,13,93,18,0,128,127,1,0,0,0
S01009729,Owned: Owned outright,179,58,48,10,38,10,0,121,121,0,0,0,0
S01009729,Owned: Owned with a mortgage or loan or shared ownership,73,66,58,3,55,8,0,7,6,1,0,0,0
S01009729,Rented or living rent free: Total,30,17,15,4,11,2,0,13,6,7,0,0,0
S01009729,Rented or living rent free: Social rented,3,2,1,0,1,1,0,1,1,0,0,0,0
S01009729,Rented or living rent free: Private rented or living rent free,27,15,14,4,10,1,0,12,5,7,0,0,0
S01009730,All HRPs aged 16 and over,241,161,131,33,98,23,7,80,54,16,1,6,3
S01009730,Owned: Total,161,104,80,17,63,22,2,57,51,4,0,2,0
S01009730,Owned: Owned outright,89,37,28,11,17,8,1,52,49,2,0,1,0
S01009730,Owned: Owned with a mortgage or loan or shared ownership,72,67,52,6,46,14,1,5,2,2,0,1,0
S01009730,Rented or living rent free: Total,80,57,51,16,35,1,5,23,3,12,1,4,3
S01009730,Rented or living rent free: Social rented,33,23,20,6,14,0,3,10,2,0,1,4,3
S01009730,Rented or living rent free: Private rented or living rent free,47,34,31,10,21,1,2,13,1,12,0,0,0
S01009731,All HRPs aged 16 and over,274,113,84,19,65,23,6,161,149,11,0,0,1
S01009731,Owned: Total,233,85,65,13,52,20,0,148,144,3,0,0,1
S01009731,Owned: Owned outright,180,43,32,11,21,11,0,137,136,0,0,0,1
S01009731,Owned: Owned with a mortgage or loan or shared ownership,53,42,33,2,31,9,0,11,8,3,0,0,0
S01009731,Rented or living rent free: Total,41,28,19,6,13,3,6,13,5,8,0,0,0
S01009731,Rented or living rent free: Social rented,2,2,1,0,1,0,1,0,0,0,0,0,0
S01009731,Rented or living rent free: Private rented or living rent free,39,26,18,6,12,3,5,13,5,8,0,0,0
S01009732,All HRPs aged 16 and over,344,176,129,46,83,31,16,168,96,67,1,3,1
S01009732,Owned: Total,180,83,58,9,49,22,3,97,92,4,0,1,0
S01009732,Owned: Owned outright,140,54,36,8,28,17,1,86,84,2,0,0,0
S01009732,Owned: Owned with a mortgage or loan or shared ownership,40,29,22,1,21,5,2,11,8,2,0,1,0
S01009732,Rented or living rent free: Total,164,93,71,37,34,9,13,71,4,63,1,2,1
S01009732,Rented or living rent free: Social rented,24,16,8,1,7,3,5,8,4,1,1,1,1
S01009732,Rented or living rent free: Private rented or living rent free,140,77,63,36,27,6,8,63,0,62,0,1,0
S01009733,All HRPs aged 16 and over,227,153,119,22,97,32,2,74,71,1,0,2,0
S01009733,Owned: Total,191,123,92,15,77,30,1,68,67,0,0,1,0
S01009733,Owned: Owned outright,127,64,43,12,31,21,0,63,62,0,0,1,0
S01009733,Owned: Owned with a mortgage or loan or shared ownership,64,59,49,3,46,9,1,5,5,0,0,0,0
S01009733,Rented or living rent free: Total,36,30,27,7,20,2,1,6,4,1,0,1,0
S01009733,Rented or living rent free: Social rented,6,5,3,1,2,1,1,1,1,0,0,0,0
S01009733,Rented or living rent free: Private rented or living rent free,30,25,24,6,18,1,0,5,3,1,0,1,0
S01009734,All HRPs aged 16 and over,385,258,200,27,173,52,6,127,110,7,1,3,6
S01009734,Owned: Total,275,180,139,16,123,39,2,95,92,1,0,1,1
S01009734,Owned: Owned outright,157,73,50,12,38,21,2,84,81,1,0,1,1
S01009734,Owned: Owned with a mortgage or loan or shared ownership,118,107,89,4,85,18,0,11,11,0,0,0,0
S01009734,Rented or living rent free: Total,110,78,61,11,50,13,4,32,18,6,1,2,5
S01009734,Rented or living rent free: Social rented,20,8,6,3,3,1,1,12,7,1,0,2,2
S01009734,Rented or living rent free: Private rented or living rent free,90,70,55,8,47,12,3,20,11,5,1,0,3
S01009735,All HRPs aged 16 and over,327,153,106,15,91,44,3,174,156,13,2,1,2
S01009735,Owned: Total,288,130,90,14,76,39,1,158,153,2,2,0,1
S01009735,Owned: Owned outright,205,58,41,11,30,17,0,147,142,2,2,0,1
S01009735,Owned: Owned with a mortgage or loan or shared ownership,83,72,49,3,46,22,1,11,11,0,0,0,0
S01009735,Rented or living rent free: Total,39,23,16,1,15,5,2,16,3,11,0,1,1
S01009735,Rented or living rent free: Social rented,3,0,0,0,0,0,0,3,1,0,0,1,1
S01009735,Rented or living rent free: Private rented or living rent free,36,23,16,1,15,5,2,13,2,11,0,0,0
S01009736,All HRPs aged 16 and over,332,116,81,38,43,21,14,216,125,85,1,1,4
S01009736,Owned: Total,124,33,19,3,16,12,2,91,84,4,1,0,2
S01009736,Owned: Owned outright,106,22,11,3,8,9,2,84,80,2,1,0,1
S01009736,Owned: Owned with a mortgage or loan or shared ownership,18,11,8,0,8,3,0,7,4,2,0,0,1
S01009736,Rented or living rent free: Total,208,83,62,35,27,9,12,125,41,81,0,1,2
S01009736,Rented or living rent free: Social rented,31,6,3,3,0,2,1,25,24,0,0,0,1
S01009736,Rented or living rent free: Private rented or living rent free,177,77,59,32,27,7,11,100,17,81,0,1,1
S01009737,All HRPs aged 16 and over,323,243,219,20,199,20,4,80,65,1,3,9,2
S01009737,Owned: Total,123,83,65,13,52,17,1,40,39,0,0,1,0
S01009737,Owned: Owned outright,69,32,21,6,15,11,0,37,37,0,0,0,0
S01009737,Owned: Owned with a mortgage or loan or shared ownership,54,51,44,7,37,6,1,3,2,0,0,1,0
S01009737,Rented or living rent free: Total,200,160,154,7,147,3,3,40,26,1,3,8,2
S01009737,Rented or living rent free: Social rented,72,38,33,4,29,2,3,34,22,0,3,7,2
S01009737,Rented or living rent free: Private rented or living rent free,128,122,121,3,118,1,0,6,4,1,0,1,0
S01009738,All HRPs aged 16 and over,214,151,123,17,106,25,3,63,48,5,2,5,3
S01009738,Owned: Total,123,99,81,8,73,18,0,24,21,1,0,2,0
S01009738,Owned: Owned outright,36,16,12,1,11,4,0,20,19,0,0,1,0
S01009738,Owned: Owned with a mortgage or loan or shared ownership,87,83,69,7,62,14,0,4,2,1,0,1,0
S01009738,Rented or living rent free: Total,91,52,42,9,33,7,3,39,27,4,2,3,3
S01009738,Rented or living rent free: Social rented,25,13,9,4,5,2,2,12,8,0,0,2,2
S01009738,Rented or living rent free: Private rented or living rent free,66,39,33,5,28,5,1,27,19,4,2,1,1
S01009739,All HRPs aged 16 and over,275,246,228,11,217,15,3,29,19,3,2,4,1
S01009739,Owned: Total,115,98,85,4,81,12,1,17,13,1,0,3,0
S01009739,Owned: Owned outright,30,16,9,0,9,6,1,14,12,1,0,1,0
S01009739,Owned: Owned with a mortgage or loan or shared ownership,85,82,76,4,72,6,0,3,1,0,0,2,0
S01009739,Rented or living rent free: Total,160,148,143,7,136,3,2,12,6,2,2,1,1
S01009739,Rented or living rent free: Social rented,40,32,30,4,26,2,0,8,5,0,2,1,0
S01009739,Rented or living rent free: Private rented or living rent free,120,116,113,3,110,1,2,4,1,2,0,0,1
S01009740,All HRPs aged 16 and over,243,151,126,20,106,19,6,92,68,4,9,6,5
S01009740,Owned: Total,136,87,71,9,62,15,1,49,48,0,0,1,0
S01009740,Owned: Owned outright,68,28,18,5,13,10,0,40,39,0,0,1,0
S01009740,Owned: Owned with a mortgage or loan or shared ownership,68,59,53,4,49,5,1,9,9,0,0,0,0
S01009740,Rented or living rent free: Total,107,64,55,11,44,4,5,43,20,4,9,5,5
S01009740,Rented or living rent free: Social rented,69,34,31,9,22,1,2,35,17,3,8,2,5
S01009740,Rented or living rent free: Private rented or living rent free,38,30,24,2,22,3,3,8,3,1,1,3,0
S01009741,All HRPs aged 16 and over,164,148,142,5,137,4,2,16,10,1,2,2,1
S01009741,Owned: Total,25,20,15,1,14,4,1,5,3,0,0,2,0
S01009741,Owned: Owned outright,12,7,5,1,4,2,0,5,3,0,0,2,0
S01009741,Owned: Owned with a mortgage or loan or shared ownership,13,13,10,0,10,2,1,0,0,0,0,0,0
S01009741,Rented or living rent free: Total,139,128,127,4,123,0,1,11,7,1,2,0,1
S01009741,Rented or living rent free: Social rented,23,16,15,2,13,0,1,7,7,0,0,0,0
S01009741,Rented or living rent free: Private rented or living rent free,116,112,112,2,110,0,0,4,0,1,2,0,1
S01009742,All HRPs aged 16 and over,206,145,110,13,97,33,2,61,55,1,0,5,0
S01009742,Owned: Total,137,94,66,5,61,27,1,43,42,1,0,0,0
S01009742,Owned: Owned outright,85,48,30,5,25,17,1,37,37,0,0,0,0
S01009742,Owned: Owned with a mortgage or loan or shared ownership,52,46,36,0,36,10,0,6,5,1,0,0,0
S01009742,Rented or living rent free: Total,69,51,44,8,36,6,1,18,13,0,0,5,0
S01009742,Rented or living rent free: Social rented,6,1,0,0,0,1,0,5,3,0,0,2,0
S01009742,Rented or living rent free: Private rented or living rent free,63,50,44,8,36,5,1,13,10,0,0,3,0
S01009743,All HRPs aged 16 and over,425,261,200,23,177,55,6,164,151,5,0,4,4
S01009743,Owned: Total,345,211,162,15,147,47,2,134,125,5,0,1,3
S01009743,Owned: Owned outright,187,83,59,10,49,22,2,104,97,4,0,0,3
S01009743,Owned: Owned with a mortgage or loan or shared ownership,158,128,103,5,98,25,0,30,28,1,0,1,0
S01009743,Rented or living rent free: Total,80,50,38,8,30,8,4,30,26,0,0,3,1
S01009743,Rented or living rent free: Social rented,26,6,4,1,3,1,1,20,16,0,0,3,1
S01009743,Rented or living rent free: Private rented or living rent free,54,44,34,7,27,7,3,10,10,0,0,0,0
S01009744,All HRPs aged 16 and over,306,200,158,21,137,39,3,106,96,1,3,4,2
S01009744,Owned: Total,259,165,129,16,113,34,2,94,88,0,2,3,1
S01009744,Owned: Owned outright,133,58,46,11,35,12,0,75,72,0,1,1,1
S01009744,Owned: Owned with a mortgage or loan or shared ownership,126,107,83,5,78,22,2,19,16,0,1,2,0
S01009744,Rented or living rent free: Total,47,35,29,5,24,5,1,12,8,1,1,1,1
S01009744,Rented or living rent free: Social rented,6,3,3,1,2,0,0,3,3,0,0,0,0
S01009744,Rented or living rent free: Private rented or living rent free,41,32,26,4,22,5,1,9,5,1,1,1,1
S01009745,All HRPs aged 16 and over,455,305,267,32,235,34,4,150,136,2,4,7,1
S01009745,Owned: Total,376,258,225,23,202,30,3,118,114,0,1,2,1
S01009745,Owned: Owned outright,185,77,63,14,49,12,2,108,104,0,1,2,1
S01009745,Owned: Owned with a mortgage or loan or shared ownership,191,181,162,9,153,18,1,10,10,0,0,0,0
S01009745,Rented or living rent free: Total,79,47,42,9,33,4,1,32,22,2,3,5,0
S01009745,Rented or living rent free: Social rented,29,9,9,2,7,0,0,20,15,0,2,3,0
S01009745,Rented or living rent free: Private rented or living rent free,50,38,33,7,26,4,1,12,7,2,1,2,0
S01009746,All HRPs aged 16 and over,237,182,122,23,99,58,2,55,49,1,1,2,2
S01009746,Owned: Total,156,118,81,14,67,37,0,38,36,1,0,1,0
S01009746,Owned: Owned outright,84,53,31,8,23,22,0,31,30,1,0,0,0
S01009746,Owned: Owned with a mortgage or loan or shared ownership,72,65,50,6,44,15,0,7,6,0,0,1,0
S01009746,Rented or living rent free: Total,81,64,41,9,32,21,2,17,13,0,1,1,2
S01009746,Rented or living rent free: Social rented,4,4,4,1,3,0,0,0,0,0,0,0,0
S01009746,Rented or living rent free: Private rented or living rent free,77,60,37,8,29,21,2,17,13,0,1,1,2
S01009747,All HRPs aged 16 and over,344,231,194,32,162,25,12,113,89,5,2,14,3
S01009747,Owned: Total,213,133,117,11,106,14,2,80,74,1,1,4,0
S01009747,Owned: Owned outright,93,35,29,6,23,4,2,58,54,1,0,3,0
S01009747,Owned: Owned with a mortgage or loan or shared ownership,120,98,88,5,83,10,0,22,20,0,1,1,0
S01009747,Rented or living rent free: Total,131,98,77,21,56,11,10,33,15,4,1,10,3
S01009747,Rented or living rent free: Social rented,63,39,26,10,16,6,7,24,11,1,1,9,2
S01009747,Rented or living rent free: Private rented or living rent free,68,59,51,11,40,5,3,9,4,3,0,1,1
S01009748,All HRPs aged 16 and over,299,199,174,21,153,23,2,100,90,3,0,6,1
S01009748,Owned: Total,244,167,146,16,130,20,1,77,72,2,0,2,1
S01009748,Owned: Owned outright,112,47,40,8,32,7,0,65,64,0,0,0,1
S01009748,Owned: Owned with a mortgage or loan or shared ownership,132,120,106,8,98,13,1,12,8,2,0,2,0
S01009748,Rented or living rent free: Total,55,32,28,5,23,3,1,23,18,1,0,4,0
S01009748,Rented or living rent free: Social rented,28,12,10,3,7,1,1,16,13,0,0,3,0
S01009748,Rented or living rent free: Private rented or living rent free,27,20,18,2,16,2,0,7,5,1,0,1,0
S01009749,All HRPs aged 16 and over,425,275,238,28,210,33,4,150,131,2,2,10,5
S01009749,Owned: Total,335,227,198,16,182,27,2,108,101,0,0,4,3
S01009749,Owned: Owned outright,176,73,54,10,44,18,1,103,97,0,0,4,2
S01009749,Owned: Owned with a mortgage or loan or shared ownership,159,154,144,6,138,9,1,5,4,0,0,0,1
S01009749,Rented or living rent free: Total,90,48,40,12,28,6,2,42,30,2,2,6,2
S01009749,Rented or living rent free: Social rented,54,22,18,7,11,3,1,32,25,0,2,4,1
S01009749,Rented or living rent free: Private rented or living rent free,36,26,22,5,17,3,1,10,5,2,0,2,1
S01009750,All HRPs aged 16 and over,311,198,171,24,147,20,7,113,99,0,3,9,2
S01009750,Owned: Total,195,130,114,10,104,16,0,65,63,0,0,1,1
S01009750,Owned: Owned outright,85,27,22,5,17,5,0,58,57,0,0,0,1
S01009750,Owned: Owned with a mortgage or loan or shared ownership,110,103,92,5,87,11,0,7,6,0,0,1,0
S01009750,Rented or living rent free: Total,116,68,57,14,43,4,7,48,36,0,3,8,1
S01009750,Rented or living rent free: Social rented,70,31,25,9,16,1,5,39,28,0,2,8,1
S01009750,Rented or living rent free: Private rented or living rent free,46,37,32,5,27,3,2,9,8,0,1,0,0
S01009751,All HRPs aged 16 and over,355,247,213,35,178,22,12,108,89,1,5,10,3
S01009751,Owned: Total,215,156,139,15,124,15,2,59,57,1,0,0,1
S01009751,Owned: Owned outright,88,41,36,5,31,4,1,47,47,0,0,0,0
S01009751,Owned: Owned with a mortgage or loan or shared ownership,127,115,103,10,93,11,1,12,10,1,0,0,1
S01009751,Rented or living rent free: Total,140,91,74,20,54,7,10,49,32,0,5,10,2
S01009751,Rented or living rent free: Social rented,97,61,50,15,35,6,5,36,23,0,1,10,2
S01009751,Rented or living rent free: Private rented or living rent free,43,30,24,5,19,1,5,13,9,0,4,0,0
S01009752,All HRPs aged 16 and over,260,175,142,14,128,30,3,85,81,1,1,2,0
S01009752,Owned: Total,231,153,123,12,111,28,2,78,78,0,0,0,0
S01009752,Owned: Owned outright,134,58,43,8,35,13,2,76,76,0,0,0,0
S01009752,Owned: Owned with a mortgage or loan or shared ownership,97,95,80,4,76,15,0,2,2,0,0,0,0
S01009752,Rented or living rent free: Total,29,22,19,2,17,2,1,7,3,1,1,2,0
S01009752,Rented or living rent free: Social rented,5,2,2,0,2,0,0,3,1,0,1,1,0
S01009752,Rented or living rent free: Private rented or living rent free,24,20,17,2,15,2,1,4,2,1,0,1,0
S01009753,All HRPs aged 16 and over,333,171,135,11,124,34,2,162,152,1,3,2,4
S01009753,Owned: Total,241,144,114,7,107,30,0,97,91,0,2,1,3
S01009753,Owned: Owned outright,129,42,32,3,29,10,0,87,84,0,0,1,2
S01009753,Owned: Owned with a mortgage or loan or shared ownership,112,102,82,4,78,20,0,10,7,0,2,0,1
S01009753,Rented or living rent free: Total,92,27,21,4,17,4,2,65,61,1,1,1,1
S01009753,Rented or living rent free: Social rented,61,6,5,3,2,0,1,55,54,0,0,0,1
S01009753,Rented or living rent free: Private rented or living rent free,31,21,16,1,15,4,1,10,7,1,1,1,0
S01009754,All HRPs aged 16 and over,383,244,202,22,180,32,10,139,110,5,6,14,4
S01009754,Owned: Total,285,190,157,17,140,28,5,95,85,2,3,3,2
S01009754,Owned: Owned outright,147,61,49,7,42,11,1,86,78,2,2,2,2
S01009754,Owned: Owned with a mortgage or loan or shared ownership,138,129,108,10,98,17,4,9,7,0,1,1,0
S01009754,Rented or living rent free: Total,98,54,45,5,40,4,5,44,25,3,3,11,2
S01009754,Rented or living rent free: Social rented,59,26,20,3,17,2,4,33,21,0,2,9,1
S01009754,Rented or living rent free: Private rented or living rent free,39,28,25,2,23,2,1,11,4,3,1,2,1
S01009755,All HRPs aged 16 and over,281,199,157,16,141,38,4,82,71,1,3,7,0
S01009755,Owned: Total,235,167,130,13,117,35,2,68,65,1,1,1,0
S01009755,Owned: Owned outright,115,52,34,6,28,16,2,63,62,0,0,1,0
S01009755,Owned: Owned with a mortgage or loan or shared ownership,120,115,96,7,89,19,0,5,3,1,1,0,0
S01009755,Rented or living rent free: Total,46,32,27,3,24,3,2,14,6,0,2,6,0
S01009755,Rented or living rent free: Social rented,14,6,5,3,2,1,0,8,2,0,2,4,0
S01009755,Rented or living rent free: Private rented or living rent free,32,26,22,0,22,2,2,6,4,0,0,2,0
S01009756,All HRPs aged 16 and over,320,206,173,17,156,30,3,114,105,1,4,3,1
S01009756,Owned: Total,265,170,142,10,132,26,2,95,94,0,0,1,0
S01009756,Owned: Owned outright,134,46,37,4,33,8,1,88,88,0,0,0,0
S01009756,Owned: Owned with a mortgage or loan or shared ownership,131,124,105,6,99,18,1,7,6,0,0,1,0
S01009756,Rented or living rent free: Total,55,36,31,7,24,4,1,19,11,1,4,2,1
S01009756,Rented or living rent free: Social rented,28,14,14,5,9,0,0,14,10,0,2,1,1
S01009756,Rented or living rent free: Private rented or living rent free,27,22,17,2,15,4,1,5,1,1,2,1,0
S01009757,All HRPs aged 16 and over,271,187,145,16,129,39,3,84,78,0,0,5,1
S01009757,Owned: Total,237,162,126,9,117,35,1,75,74,0,0,0,1
S01009757,Owned: Owned outright,131,64,47,8,39,17,0,67,67,0,0,0,0
S01009757,Owned: Owned with a mortgage or loan or shared ownership,106,98,79,1,78,18,1,8,7,0,0,0,1
S01009757,Rented or living rent free: Total,34,25,19,7,12,4,2,9,4,0,0,5,0
S01009757,Rented or living rent free: Social rented,19,12,9,6,3,1,2,7,2,0,0,5,0
S01009757,Rented or living rent free: Private rented or living rent free,15,13,10,1,9,3,0,2,2,0,0,0,0
S01009758,All HRPs aged 16 and over,242,197,172,18,154,21,4,45,37,2,1,4,1
S01009758,Owned: Total,204,166,147,13,134,18,1,38,35,1,1,1,0
S01009758,Owned: Owned outright,54,26,21,3,18,5,0,28,27,0,0,1,0
S01009758,Owned: Owned with a mortgage or loan or shared ownership,150,140,126,10,116,13,1,10,8,1,1,0,0
S01009758,Rented or living rent free: Total,38,31,25,5,20,3,3,7,2,1,0,3,1
S01009758,Rented or living rent free: Social rented,9,3,2,0,2,1,0,6,2,1,0,3,0
S01009758,Rented or living rent free: Private rented or living rent free,29,28,23,5,18,2,3,1,0,0,0,0,1
S01009759,All HRPs aged 16 and over,417,256,197,69,128,16,43,161,44,8,39,40,30
S01009759,Owned: Total,39,28,24,9,15,4,0,11,10,0,0,1,0
S01009759,Owned: Owned outright,14,5,5,1,4,0,0,9,8,0,0,1,0
S01009759,Owned: Owned with a mortgage or loan or shared ownership,25,23,19,8,11,4,0,2,2,0,0,0,0
S01009759,Rented or living rent free: Total,378,228,173,60,113,12,43,150,34,8,39,39,30
S01009759,Rented or living rent free: Social rented,369,223,171,58,113,12,40,146,33,8,38,37,30
S01009759,Rented or living rent free: Private rented or living rent free,9,5,2,2,0,0,3,4,1,0,1,2,0
S01009760,All HRPs aged 16 and over,407,226,182,58,124,21,23,181,97,3,21,48,12
S01009760,Owned: Total,143,86,71,10,61,13,2,57,50,1,0,3,3
S01009760,Owned: Owned outright,68,24,18,4,14,5,1,44,41,0,0,1,2
S01009760,Owned: Owned with a mortgage or loan or shared ownership,75,62,53,6,47,8,1,13,9,1,0,2,1
S01009760,Rented or living rent free: Total,264,140,111,48,63,8,21,124,47,2,21,45,9
S01009760,Rented or living rent free: Social rented,232,117,94,34,60,7,16,115,45,0,18,44,8
S01009760,Rented or living rent free: Private rented or living rent free,32,23,17,14,3,1,5,9,2,2,3,1,1
S01009761,All HRPs aged 16 and over,377,270,235,39,196,29,6,107,77,2,7,19,2
S01009761,Owned: Total,316,237,212,34,178,24,1,79,66,1,2,10,0
S01009761,Owned: Owned outright,109,51,46,15,31,4,1,58,53,0,1,4,0
S01009761,Owned: Owned with a mortgage or loan or shared ownership,207,186,166,19,147,20,0,21,13,1,1,6,0
S01009761,Rented or living rent free: Total,61,33,23,5,18,5,5,28,11,1,5,9,2
S01009761,Rented or living rent free: Social rented,22,8,6,1,5,2,0,14,5,0,4,4,1
S01009761,Rented or living rent free: Private rented or living rent free,39,25,17,4,13,3,5,14,6,1,1,5,1
S01009762,All HRPs aged 16 and over,416,234,189,53,136,11,34,182,69,8,22,68,15
S01009762,Owned: Total,45,35,32,7,25,2,1,10,8,0,0,1,1
S01009762,Owned: Owned outright,11,5,5,1,4,0,0,6,6,0,0,0,0
S01009762,Owned: Owned with a mortgage or loan or shared ownership,34,30,27,6,21,2,1,4,2,0,0,1,1
S01009762,Rented or living rent free: Total,371,199,157,46,111,9,33,172,61,8,22,67,14
S01009762,Rented or living rent free: Social rented,359,195,156,46,110,8,31,164,59,7,20,64,14
S01009762,Rented or living rent free: Private rented or living rent free,12,4,1,0,1,1,2,8,2,1,2,3,0
S01009763,All HRPs aged 16 and over,264,218,158,18,140,57,3,46,33,4,6,3,0
S01009763,Owned: Total,237,204,147,15,132,55,2,33,28,1,3,1,0
S01009763,Owned: Owned outright,68,42,25,3,22,17,0,26,25,0,1,0,0
S01009763,Owned: Owned with a mortgage or loan or shared ownership,169,162,122,12,110,38,2,7,3,1,2,1,0
S01009763,Rented or living rent free: Total,27,14,11,3,8,2,1,13,5,3,3,2,0
S01009763,Rented or living rent free: Social rented,9,2,2,0,2,0,0,7,3,1,1,2,0
S01009763,Rented or living rent free: Private rented or living rent free,18,12,9,3,6,2,1,6,2,2,2,0,0
S01009764,All HRPs aged 16 and over,291,191,156,42,114,10,25,100,41,3,10,36,10
S01009764,Owned: Total,108,96,81,12,69,8,7,12,8,0,0,0,4
S01009764,Owned: Owned outright,11,7,7,1,6,0,0,4,3,0,0,0,1
S01009764,Owned: Owned with a mortgage or loan or shared ownership,97,89,74,11,63,8,7,8,5,0,0,0,3
S01009764,Rented or living rent free: Total,183,95,75,30,45,2,18,88,33,3,10,36,6
S01009764,Rented or living rent free: Social rented,166,84,64,25,39,2,18,82,33,1,8,36,4
S01009764,Rented or living rent free: Private rented or living rent free,17,11,11,5,6,0,0,6,0,2,2,0,2
S01009765,All HRPs aged 16 and over,382,257,204,40,164,34,19,125,84,2,6,28,5
S01009765,Owned: Total,213,183,145,20,125,32,6,30,21,0,1,7,1
S01009765,Owned: Owned outright,31,17,11,4,7,5,1,14,12,0,0,2,0
S01009765,Owned: Owned with a mortgage or loan or shared ownership,182,166,134,16,118,27,5,16,9,0,1,5,1
S01009765,Rented or living rent free: Total,169,74,59,20,39,2,13,95,63,2,5,21,4
S01009765,Rented or living rent free: Social rented,129,55,42,13,29,2,11,74,54,1,1,16,2
S01009765,Rented or living rent free: Private rented or living rent free,40,19,17,7,10,0,2,21,9,1,4,5,2
S01009766,All HRPs aged 16 and over,231,185,170,21,149,12,3,46,30,3,5,5,3
S01009766,Owned: Total,201,168,159,16,143,7,2,33,27,1,2,2,1
S01009766,Owned: Owned outright,41,20,20,3,17,0,0,21,21,0,0,0,0
S01009766,Owned: Owned with a mortgage or loan or shared ownership,160,148,139,13,126,7,2,12,6,1,2,2,1
S01009766,Rented or living rent free: Total,30,17,11,5,6,5,1,13,3,2,3,3,2
S01009766,Rented or living rent free: Social rented,7,4,1,0,1,2,1,3,1,0,0,1,1
S01009766,Rented or living rent free: Private rented or living rent free,23,13,10,5,5,3,0,10,2,2,3,2,1
S01009767,All HRPs aged 16 and over,227,124,97,19,78,10,17,103,53,2,7,33,8
S01009767,Owned: Total,83,61,52,6,46,6,3,22,20,0,1,0,1
S01009767,Owned: Owned outright,21,9,8,3,5,1,0,12,11,0,0,0,1
S01009767,Owned: Owned with a mortgage or loan or shared ownership,62,52,44,3,41,5,3,10,9,0,1,0,0
S01009767,Rented or living rent free: Total,144,63,45,13,32,4,14,81,33,2,6,33,7
S01009767,Rented or living rent free: Social rented,136,58,43,12,31,3,12,78,33,0,6,32,7
S01009767,Rented or living rent free: Private rented or living rent free,8,5,2,1,1,1,2,3,0,2,0,1,0
S01009768,All HRPs aged 16 and over,279,199,144,37,107,29,26,80,24,3,12,33,8
S01009768,Owned: Total,95,90,71,8,63,19,0,5,2,0,1,1,1
S01009768,Owned: Owned outright,7,6,4,1,3,2,0,1,1,0,0,0,0
S01009768,Owned: Owned with a mortgage or loan or shared ownership,88,84,67,7,60,17,0,4,1,0,1,1,1
S01009768,Rented or living rent free: Total,184,109,73,29,44,10,26,75,22,3,11,32,7
S01009768,Rented or living rent free: Social rented,158,87,59,25,34,5,23,71,21,3,8,32,7
S01009768,Rented or living rent free: Private rented or living rent free,26,22,14,4,10,5,3,4,1,0,3,0,0
S01009769,All HRPs aged 16 and over,249,223,190,26,164,27,6,26,8,2,3,7,6
S01009769,Owned: Total,193,181,153,13,140,24,4,12,5,2,0,3,2
S01009769,Owned: Owned outright,21,14,12,2,10,2,0,7,4,1,0,2,0
S01009769,Owned: Owned with a mortgage or loan or shared ownership,172,167,141,11,130,22,4,5,1,1,0,1,2
S01009769,Rented or living rent free: Total,56,42,37,13,24,3,2,14,3,0,3,4,4
S01009769,Rented or living rent free: Social rented,14,6,5,0,5,0,1,8,2,0,2,2,2
S01009769,Rented or living rent free: Private rented or living rent free,42,36,32,13,19,3,1,6,1,0,1,2,2
S01009770,All HRPs aged 16 and over,257,201,164,37,127,32,5,56,39,1,3,10,3
S01009770,Owned: Total,222,177,143,24,119,30,4,45,37,1,2,3,2
S01009770,Owned: Owned outright,52,30,26,7,19,3,1,22,21,0,0,1,0
S01009770,Owned: Owned with a mortgage or loan or shared ownership,170,147,117,17,100,27,3,23,16,1,2,2,2
S01009770,Rented or living rent free: Total,35,24,21,13,8,2,1,11,2,0,1,7,1
S01009770,Rented or living rent free: Social rented,6,3,2,0,2,0,1,3,1,0,0,1,1
S01009770,Rented or living rent free: Private rented or living rent free,29,21,19,13,6,2,0,8,1,0,1,6,0
S01009771,All HRPs aged 16 and over,294,246,194,25,169,43,9,48,35,2,3,8,0
S01009771,Owned: Total,265,230,184,21,163,42,4,35,28,0,2,5,0
S01009771,Owned: Owned outright,59,38,32,6,26,6,0,21,18,0,1,2,0
S01009771,Owned: Owned with a mortgage or loan or shared ownership,206,192,152,15,137,36,4,14,10,0,1,3,0
S01009771,Rented or living rent free: Total,29,16,10,4,6,1,5,13,7,2,1,3,0
S01009771,Rented or living rent free: Social rented,5,1,0,0,0,1,0,4,3,0,1,0,0
S01009771,Rented or living rent free: Private rented or living rent free,24,15,10,4,6,0,5,9,4,2,0,3,0
S01009772,All HRPs aged 16 and over,271,214,186,23,163,22,6,57,39,3,5,4,6
S01009772,Owned: Total,242,194,170,20,150,21,3,48,38,2,3,2,3
S01009772,Owned: Owned outright,59,25,21,5,16,3,1,34,30,0,2,1,1
S01009772,Owned: Owned with a mortgage or loan or shared ownership,183,169,149,15,134,18,2,14,8,2,1,1,2
S01009772,Rented or living rent free: Total,29,20,16,3,13,1,3,9,1,1,2,2,3
S01009772,Rented or living rent free: Social rented,2,2,0,0,0,1,1,0,0,0,0,0,0
S01009772,Rented or living rent free: Private rented or living rent free,27,18,16,3,13,0,2,9,1,1,2,2,3
S01009773,All HRPs aged 16 and over,179,151,110,22,88,39,2,28,6,14,4,2,2
S01009773,Owned: Total,152,139,102,18,84,37,0,13,6,1,3,1,2
S01009773,Owned: Owned outright,16,9,3,1,2,6,0,7,5,1,1,0,0
S01009773,Owned: Owned with a mortgage or loan or shared ownership,136,130,99,17,82,31,0,6,1,0,2,1,2
S01009773,Rented or living rent free: Total,27,12,8,4,4,2,2,15,0,13,1,1,0
S01009773,Rented or living rent free: Social rented,4,4,2,1,1,1,1,0,0,0,0,0,0
S01009773,Rented or living rent free: Private rented or living rent free,23,8,6,3,3,1,1,15,0,13,1,1,0
S01009774,All HRPs aged 16 and over,151,139,108,14,94,29,2,12,3,1,6,1,1
S01009774,Owned: Total,142,135,106,14,92,28,1,7,2,1,2,1,1
S01009774,Owned: Owned outright,14,11,9,1,8,2,0,3,1,0,1,0,1
S01009774,Owned: Owned with a mortgage or loan or shared ownership,128,124,97,13,84,26,1,4,1,1,1,1,0
S01009774,Rented or living rent free: Total,9,4,2,0,2,1,1,5,1,0,4,0,0
S01009774,Rented or living rent free: Social rented,4,0,0,0,0,0,0,4,1,0,3,0,0
S01009774,Rented or living rent free: Private rented or living rent free,5,4,2,0,2,1,1,1,0,0,1,0,0
S01009775,All HRPs aged 16 and over,359,159,137,50,87,8,14,200,106,19,13,52,10
S01009775,Owned: Total,124,73,63,18,45,7,3,51,46,1,0,3,1
S01009775,Owned: Owned outright,47,12,6,2,4,4,2,35,34,0,0,0,1
S01009775,Owned: Owned with a mortgage or loan or shared ownership,77,61,57,16,41,3,1,16,12,1,0,3,0
S01009775,Rented or living rent free: Total,235,86,74,32,42,1,11,149,60,18,13,49,9
S01009775,Rented or living rent free: Social rented,201,72,61,28,33,1,10,129,60,0,13,49,7
S01009775,Rented or living rent free: Private rented or living rent free,34,14,13,4,9,0,1,20,0,18,0,0,2
S01009776,All HRPs aged 16 and over,307,166,121,54,67,6,39,141,40,4,28,54,15
S01009776,Owned: Total,39,25,23,4,19,2,0,14,10,0,1,1,2
S01009776,Owned: Owned outright,20,10,9,2,7,1,0,10,8,0,0,1,1
S01009776,Owned: Owned with a mortgage or loan or shared ownership,19,15,14,2,12,1,0,4,2,0,1,0,1
S01009776,Rented or living rent free: Total,268,141,98,50,48,4,39,127,30,4,27,53,13
S01009776,Rented or living rent free: Social rented,259,137,94,49,45,4,39,122,29,2,27,51,13
S01009776,Rented or living rent free: Private rented or living rent free,9,4,4,1,3,0,0,5,1,2,0,2,0
S01009777,All HRPs aged 16 and over,266,168,145,30,115,11,12,98,41,10,7,33,7
S01009777,Owned: Total,105,87,78,12,66,7,2,18,12,2,0,4,0
S01009777,Owned: Owned outright,16,6,6,0,6,0,0,10,7,0,0,3,0
S01009777,Owned: Owned with a mortgage or loan or shared ownership,89,81,72,12,60,7,2,8,5,2,0,1,0
S01009777,Rented or living rent free: Total,161,81,67,18,49,4,10,80,29,8,7,29,7
S01009777,Rented or living rent free: Social rented,64,16,12,5,7,0,4,48,27,2,3,10,6
S01009777,Rented or living rent free: Private rented or living rent free,97,65,55,13,42,4,6,32,2,6,4,19,1
S01009778,All HRPs aged 16 and over,415,147,124,28,96,11,12,268,179,5,10,62,12
S01009778,Owned: Total,115,56,50,6,44,6,0,59,54,2,0,2,1
S01009778,Owned: Owned outright,54,13,10,1,9,3,0,41,41,0,0,0,0
S01009778,Owned: Owned with a mortgage or loan or shared ownership,61,43,40,5,35,3,0,18,13,2,0,2,1
S01009778,Rented or living rent free: Total,300,91,74,22,52,5,12,209,125,3,10,60,11
S01009778,Rented or living rent free: Social rented,276,75,62,18,44,4,9,201,124,0,10,56,11
S01009778,Rented or living rent free: Private rented or living rent free,24,16,12,4,8,1,3,8,1,3,0,4,0
S01009779,All HRPs aged 16 and over,290,122,93,35,58,6,23,168,108,10,15,25,10
S01009779,Owned: Total,54,34,25,6,19,6,3,20,17,1,0,1,1
S01009779,Owned: Owned outright,21,7,6,4,2,0,1,14,13,0,0,0,1
S01009779,Owned: Owned with a mortgage or loan or shared ownership,33,27,19,2,17,6,2,6,4,1,0,1,0
S01009779,Rented or living rent free: Total,236,88,68,29,39,0,20,148,91,9,15,24,9
S01009779,Rented or living rent free: Social rented,216,81,62,27,35,0,19,135,87,2,14,24,8
S01009779,Rented or living rent free: Private rented or living rent free,20,7,6,2,4,0,1,13,4,7,1,0,1
S01009780,All HRPs aged 16 and over,219,145,103,46,57,7,35,74,28,4,11,23,8
S01009780,Owned: Total,15,11,10,2,8,1,0,4,3,0,0,1,0
S01009780,Owned: Owned outright,6,3,3,1,2,0,0,3,2,0,0,1,0
S01009780,Owned: Owned with a mortgage or loan or shared ownership,9,8,7,1,6,1,0,1,1,0,0,0,0
S01009780,Rented or living rent free: Total,204,134,93,44,49,6,35,70,25,4,11,22,8
S01009780,Rented or living rent free: Social rented,195,127,88,41,47,4,35,68,24,3,11,22,8
S01009780,Rented or living rent free: Private rented or living rent free,9,7,5,3,2,2,0,2,1,1,0,0,0
S01009781,All HRPs aged 16 and over,224,116,102,41,61,4,10,108,67,2,13,19,7
S01009781,Owned: Total,68,42,40,12,28,2,0,26,21,0,1,1,3
S01009781,Owned: Owned outright,28,11,10,2,8,1,0,17,15,0,0,1,1
S01009781,Owned: Owned with a mortgage or loan or shared ownership,40,31,30,10,20,1,0,9,6,0,1,0,2
S01009781,Rented or living rent free: Total,156,74,62,29,33,2,10,82,46,2,12,18,4
S01009781,Rented or living rent free: Social rented,150,70,58,27,31,2,10,80,45,2,12,18,3
S01009781,Rented or living rent free: Private rented or living rent free,6,4,4,2,2,0,0,2,1,0,0,0,1
S01009782,All HRPs aged 16 and over,200,156,113,21,92,27,16,44,12,3,11,15,3
S01009782,Owned: Total,113,108,85,10,75,21,2,5,4,1,0,0,0
S01009782,Owned: Owned outright,9,6,5,1,4,0,1,3,3,0,0,0,0
S01009782,Owned: Owned with a mortgage or loan or shared ownership,104,102,80,9,71,21,1,2,1,1,0,0,0
S01009782,Rented or living rent free: Total,87,48,28,11,17,6,14,39,8,2,11,15,3
S01009782,Rented or living rent free: Social rented,65,35,19,6,13,3,13,30,8,0,7,13,2
S01009782,Rented or living rent free: Private rented or living rent free,22,13,9,5,4,3,1,9,0,2,4,2,1
S01009783,All HRPs aged 16 and over,310,183,159,46,113,11,13,127,51,4,11,44,17
S01009783,Owned: Total,103,93,86,15,71,6,1,10,10,0,0,0,0
S01009783,Owned: Owned outright,12,8,7,0,7,1,0,4,4,0,0,0,0
S01009783,Owned: Owned with a mortgage or loan or shared ownership,91,85,79,15,64,5,1,6,6,0,0,0,0
S01009783,Rented or living rent free: Total,207,90,73,31,42,5,12,117,41,4,11,44,17
S01009783,Rented or living rent free: Social rented,193,83,70,29,41,3,10,110,40,3,8,43,16
S01009783,Rented or living rent free: Private rented or living rent free,14,7,3,2,1,2,2,7,1,1,3,1,1
S01009784,All HRPs aged 16 and over,309,162,136,50,86,4,22,147,70,8,13,52,4
S01009784,Owned: Total,40,29,29,2,27,0,0,11,8,2,0,1,0
S01009784,Owned: Owned outright,15,7,7,2,5,0,0,8,7,0,0,1,0
S01009784,Owned: Owned with a mortgage or loan or shared ownership,25,22,22,0,22,0,0,3,1,2,0,0,0
S01009784,Rented or living rent free: Total,269,133,107,48,59,4,22,136,62,6,13,51,4
S01009784,Rented or living rent free: Social rented,254,125,99,43,56,4,22,129,60,4,13,48,4
S01009784,Rented or living rent free: Private rented or living rent free,15,8,8,5,3,0,0,7,2,2,0,3,0
S01009785,All HRPs aged 16 and over,339,172,140,42,98,13,19,167,98,0,14,49,6
S01009785,Owned: Total,108,70,62,14,48,8,0,38,35,0,0,3,0
S01009785,Owned: Owned outright,49,19,18,7,11,1,0,30,29,0,0,1,0
S01009785,Owned: Owned with a mortgage or loan or shared ownership,59,51,44,7,37,7,0,8,6,0,0,2,0
S01009785,Rented or living rent free: Total,231,102,78,28,50,5,19,129,63,0,14,46,6
S01009785,Rented or living rent free: Social rented,221,98,74,28,46,5,19,123,61,0,14,42,6
S01009785,Rented or living rent free: Private rented or living rent free,10,4,4,0,4,0,0,6,2,0,0,4,0
S01009786,All HRPs aged 16 and over,425,231,175,57,118,14,42,194,98,5,20,53,18
S01009786,Owned: Total,133,84,71,14,57,8,5,49,47,1,0,0,1
S01009786,Owned: Owned outright,58,20,16,4,12,2,2,38,36,1,0,0,1
S01009786,Owned: Owned with a mortgage or loan or shared ownership,75,64,55,10,45,6,3,11,11,0,0,0,0
S01009786,Rented or living rent free: Total,292,147,104,43,61,6,37,145,51,4,20,53,17
S01009786,Rented or living rent free: Social rented,271,129,95,40,55,5,29,142,51,3,19,52,17
S01009786,Rented or living rent free: Private rented or living rent free,21,18,9,3,6,1,8,3,0,1,1,1,0
S01009787,All HRPs aged 16 and over,366,189,152,53,99,11,26,177,112,2,18,40,5
S01009787,Owned: Total,147,91,80,15,65,7,4,56,48,0,0,7,1
S01009787,Owned: Owned outright,65,25,22,8,14,2,1,40,37,0,0,2,1
S01009787,Owned: Owned with a mortgage or loan or shared ownership,82,66,58,7,51,5,3,16,11,0,0,5,0
S01009787,Rented or living rent free: Total,219,98,72,38,34,4,22,121,64,2,18,33,4
S01009787,Rented or living rent free: Social rented,197,82,62,33,29,2,18,115,62,0,18,31,4
S01009787,Rented or living rent free: Private rented or living rent free,22,16,10,5,5,2,4,6,2,2,0,2,0
S01009788,All HRPs aged 16 and over,404,190,156,34,122,22,12,214,170,3,13,27,1
S01009788,Owned: Total,268,139,117,19,98,16,6,129,119,0,4,6,0
S01009788,Owned: Owned outright,130,28,25,6,19,3,0,102,99,0,2,1,0
S01009788,Owned: Owned with a mortgage or loan or shared ownership,138,111,92,13,79,13,6,27,20,0,2,5,0
S01009788,Rented or living rent free: Total,136,51,39,15,24,6,6,85,51,3,9,21,1
S01009788,Rented or living rent free: Social rented,104,32,23,10,13,3,6,72,47,2,7,15,1
S01009788,Rented or living rent free: Private rented or living rent free,32,19,16,5,11,3,0,13,4,1,2,6,0
S01009789,All HRPs aged 16 and over,399,191,162,43,119,16,13,208,149,7,9,32,11
S01009789,Owned: Total,231,118,102,25,77,14,2,113,103,1,0,5,4
S01009789,Owned: Owned outright,109,29,25,12,13,3,1,80,74,0,0,3,3
S01009789,Owned: Owned with a mortgage or loan or shared ownership,122,89,77,13,64,11,1,33,29,1,0,2,1
S01009789,Rented or living rent free: Total,168,73,60,18,42,2,11,95,46,6,9,27,7
S01009789,Rented or living rent free: Social rented,135,53,42,13,29,0,11,82,41,0,8,27,6
S01009789,Rented or living rent free: Private rented or living rent free,33,20,18,5,13,2,0,13,5,6,1,0,1
S01009790,All HRPs aged 16 and over,259,148,132,28,104,5,11,111,84,1,6,17,3
S01009790,Owned: Total,168,106,97,15,82,5,4,62,55,1,2,4,0
S01009790,Owned: Owned outright,65,14,13,3,10,0,1,51,46,0,2,3,0
S01009790,Owned: Owned with a mortgage or loan or shared ownership,103,92,84,12,72,5,3,11,9,1,0,1,0
S01009790,Rented or living rent free: Total,91,42,35,13,22,0,7,49,29,0,4,13,3
S01009790,Rented or living rent free: Social rented,73,29,25,9,16,0,4,44,27,0,3,11,3
S01009790,Rented or living rent free: Private rented or living rent free,18,13,10,4,6,0,3,5,2,0,1,2,0
S01009791,All HRPs aged 16 and over,281,135,94,21,73,21,20,146,89,5,14,35,3
S01009791,Owned: Total,122,59,46,5,41,12,1,63,55,2,1,4,1
S01009791,Owned: Owned outright,55,8,8,0,8,0,0,47,44,0,1,2,0
S01009791,Owned: Owned with a mortgage or loan or shared ownership,67,51,38,5,33,12,1,16,11,2,0,2,1
S01009791,Rented or living rent free: Total,159,76,48,16,32,9,19,83,34,3,13,31,2
S01009791,Rented or living rent free: Social rented,125,54,35,13,22,4,15,71,31,1,11,26,2
S01009791,Rented or living rent free: Private rented or living rent free,34,22,13,3,10,5,4,12,3,2,2,5,0
S01009792,All HRPs aged 16 and over,323,288,241,27,214,42,5,35,17,5,6,7,0
S01009792,Owned: Total,277,256,216,25,191,36,4,21,13,0,4,4,0
S01009792,Owned: Owned outright,37,28,23,10,13,3,2,9,8,0,0,1,0
S01009792,Owned: Owned with a mortgage or loan or shared ownership,240,228,193,15,178,33,2,12,5,0,4,3,0
S01009792,Rented or living rent free: Total,46,32,25,2,23,6,1,14,4,5,2,3,0
S01009792,Rented or living rent free: Social rented,9,4,3,0,3,1,0,5,2,0,1,2,0
S01009792,Rented or living rent free: Private rented or living rent free,37,28,22,2,20,5,1,9,2,5,1,1,0
S01009793,All HRPs aged 16 and over,416,258,220,37,183,30,8,158,128,5,5,16,4
S01009793,Owned: Total,337,221,191,29,162,28,2,116,109,1,1,2,3
S01009793,Owned: Owned outright,158,70,59,14,45,10,1,88,87,0,0,0,1
S01009793,Owned: Owned with a mortgage or loan or shared ownership,179,151,132,15,117,18,1,28,22,1,1,2,2
S01009793,Rented or living rent free: Total,79,37,29,8,21,2,6,42,19,4,4,14,1
S01009793,Rented or living rent free: Social rented,33,6,4,1,3,1,1,27,14,0,2,10,1
S01009793,Rented or living rent free: Private rented or living rent free,46,31,25,7,18,1,5,15,5,4,2,4,0
S01009794,All HRPs aged 16 and over,199,176,163,15,148,12,1,23,19,1,1,2,0
S01009794,Owned: Total,185,168,156,13,143,11,1,17,15,0,1,1,0
S01009794,Owned: Owned outright,34,19,18,6,12,1,0,15,14,0,0,1,0
S01009794,Owned: Owned with a mortgage or loan or shared ownership,151,149,138,7,131,10,1,2,1,0,1,0,0
S01009794,Rented or living rent free: Total,14,8,7,2,5,1,0,6,4,1,0,1,0
S01009794,Rented or living rent free: Social rented,3,0,0,0,0,0,0,3,3,0,0,0,0
S01009794,Rented or living rent free: Private rented or living rent free,11,8,7,2,5,1,0,3,1,1,0,1,0
S01009795,All HRPs aged 16 and over,287,250,209,26,183,35,6,37,30,4,0,3,0
S01009795,Owned: Total,262,233,198,23,175,31,4,29,28,0,0,1,0
S01009795,Owned: Owned outright,59,39,34,5,29,4,1,20,20,0,0,0,0
S01009795,Owned: Owned with a mortgage or loan or shared ownership,203,194,164,18,146,27,3,9,8,0,0,1,0
S01009795,Rented or living rent free: Total,25,17,11,3,8,4,2,8,2,4,0,2,0
S01009795,Rented or living rent free: Social rented,5,4,3,0,3,1,0,1,0,0,0,1,0
S01009795,Rented or living rent free: Private rented or living rent free,20,13,8,3,5,3,2,7,2,4,0,1,0
S01009796,All HRPs aged 16 and over,310,203,164,21,143,37,2,107,98,1,0,6,2
S01009796,Owned: Total,284,190,155,20,135,34,1,94,88,1,0,3,2
S01009796,Owned: Owned outright,116,35,30,7,23,5,0,81,79,1,0,1,0
S01009796,Owned: Owned with a mortgage or loan or shared ownership,168,155,125,13,112,29,1,13,9,0,0,2,2
S01009796,Rented or living rent free: Total,26,13,9,1,8,3,1,13,10,0,0,3,0
S01009796,Rented or living rent free: Social rented,7,2,1,0,1,0,1,5,3,0,0,2,0
S01009796,Rented or living rent free: Private rented or living rent free,19,11,8,1,7,3,0,8,7,0,0,1,0
S01009797,All HRPs aged 16 and over,306,232,199,27,172,27,6,74,65,1,2,5,1
S01009797,Owned: Total,280,214,186,22,164,23,5,66,62,1,1,2,0
S01009797,Owned: Owned outright,91,35,29,6,23,5,1,56,55,0,0,1,0
S01009797,Owned: Owned with a mortgage or loan or shared ownership,189,179,157,16,141,18,4,10,7,1,1,1,0
S01009797,Rented or living rent free: Total,26,18,13,5,8,4,1,8,3,0,1,3,1
S01009797,Rented or living rent free: Social rented,6,3,3,0,3,0,0,3,1,0,0,1,1
S01009797,Rented or living rent free: Private rented or living rent free,20,15,10,5,5,4,1,5,2,0,1,2,0
S01009798,All HRPs aged 16 and over,255,217,176,21,155,37,4,38,33,2,1,1,1
S01009798,Owned: Total,241,206,168,18,150,35,3,35,32,1,1,0,1
S01009798,Owned: Owned outright,59,32,26,7,19,5,1,27,26,0,1,0,0
S01009798,Owned: Owned with a mortgage or loan or shared ownership,182,174,142,11,131,30,2,8,6,1,0,0,1
S01009798,Rented or living rent free: Total,14,11,8,3,5,2,1,3,1,1,0,1,0
S01009798,Rented or living rent free: Social rented,3,2,2,1,1,0,0,1,1,0,0,0,0
S01009798,Rented or living rent free: Private rented or living rent free,11,9,6,2,4,2,1,2,0,1,0,1,0
S01009799,All HRPs aged 16 and over,363,179,146,52,94,9,24,184,100,1,24,41,18
S01009799,Owned: Total,91,55,48,10,38,5,2,36,30,0,0,3,3
S01009799,Owned: Owned outright,42,18,15,7,8,1,2,24,21,0,0,2,1
S01009799,Owned: Owned with a mortgage or loan or shared ownership,49,37,33,3,30,4,0,12,9,0,0,1,2
S01009799,Rented or living rent free: Total,272,124,98,42,56,4,22,148,70,1,24,38,15
S01009799,Rented or living rent free: Social rented,258,116,91,38,53,4,21,142,68,1,24,34,15
S01009799,Rented or living rent free: Private rented or living rent free,14,8,7,4,3,0,1,6,2,0,0,4,0
S01009800,All HRPs aged 16 and over,424,279,234,67,167,25,20,145,78,3,20,33,11
S01009800,Owned: Total,237,176,154,27,127,15,7,61,46,0,2,11,2
S01009800,Owned: Owned outright,69,30,24,5,19,6,0,39,35,0,0,4,0
S01009800,Owned: Owned with a mortgage or loan or shared ownership,168,146,130,22,108,9,7,22,11,0,2,7,2
S01009800,Rented or living rent free: Total,187,103,80,40,40,10,13,84,32,3,18,22,9
S01009800,Rented or living rent free: Social rented,142,71,52,21,31,8,11,71,32,3,12,18,6
S01009800,Rented or living rent free: Private rented or living rent free,45,32,28,19,9,2,2,13,0,0,6,4,3
S01009801,All HRPs aged 16 and over,344,191,160,50,110,11,20,153,97,7,17,26,6
S01009801,Owned: Total,169,100,91,19,72,5,4,69,59,0,2,6,2
S01009801,Owned: Owned outright,67,18,13,4,9,2,3,49,43,0,0,4,2
S01009801,Owned: Owned with a mortgage or loan or shared ownership,102,82,78,15,63,3,1,20,16,0,2,2,0
S01009801,Rented or living rent free: Total,175,91,69,31,38,6,16,84,38,7,15,20,4
S01009801,Rented or living rent free: Social rented,150,79,62,28,34,3,14,71,33,1,14,19,4
S01009801,Rented or living rent free: Private rented or living rent free,25,12,7,3,4,3,2,13,5,6,1,1,0
S01009802,All HRPs aged 16 and over,431,283,242,45,197,19,22,148,73,2,24,42,7
S01009802,Owned: Total,213,177,162,9,153,12,3,36,29,1,1,3,2
S01009802,Owned: Owned outright,45,20,17,2,15,3,0,25,20,1,0,3,1
S01009802,Owned: Owned with a mortgage or loan or shared ownership,168,157,145,7,138,9,3,11,9,0,1,0,1
S01009802,Rented or living rent free: Total,218,106,80,36,44,7,19,112,44,1,23,39,5
S01009802,Rented or living rent free: Social rented,200,94,71,32,39,5,18,106,42,1,22,36,5
S01009802,Rented or living rent free: Private rented or living rent free,18,12,9,4,5,2,1,6,2,0,1,3,0
S01009803,All HRPs aged 16 and over,371,181,143,33,110,15,23,190,117,15,18,34,6
S01009803,Owned: Total,144,101,90,10,80,8,3,43,36,1,3,2,1
S01009803,Owned: Owned outright,52,18,15,2,13,1,2,34,31,1,0,1,1
S01009803,Owned: Owned with a mortgage or loan or shared ownership,92,83,75,8,67,7,1,9,5,0,3,1,0
S01009803,Rented or living rent free: Total,227,80,53,23,30,7,20,147,81,14,15,32,5
S01009803,Rented or living rent free: Social rented,197,67,46,21,25,4,17,130,80,1,13,31,5
S01009803,Rented or living rent free: Private rented or living rent free,30,13,7,2,5,3,3,17,1,13,2,1,0
S01009804,All HRPs aged 16 and over,208,177,158,16,142,14,5,31,19,1,1,10,0
S01009804,Owned: Total,142,131,118,5,113,11,2,11,9,1,0,1,0
S01009804,Owned: Owned outright,27,20,14,1,13,4,2,7,6,0,0,1,0
S01009804,Owned: Owned with a mortgage or loan or shared ownership,115,111,104,4,100,7,0,4,3,1,0,0,0
S01009804,Rented or living rent free: Total,66,46,40,11,29,3,3,20,10,0,1,9,0
S01009804,Rented or living rent free: Social rented,30,13,10,4,6,1,2,17,10,0,0,7,0
S01009804,Rented or living rent free: Private rented or living rent free,36,33,30,7,23,2,1,3,0,0,1,2,0
S01009805,All HRPs aged 16 and over,373,208,176,46,130,12,20,165,89,13,14,33,16
S01009805,Owned: Total,183,120,107,20,87,8,5,63,51,1,1,6,4
S01009805,Owned: Owned outright,59,18,15,4,11,2,1,41,37,0,0,2,2
S01009805,Owned: Owned with a mortgage or loan or shared ownership,124,102,92,16,76,6,4,22,14,1,1,4,2
S01009805,Rented or living rent free: Total,190,88,69,26,43,4,15,102,38,12,13,27,12
S01009805,Rented or living rent free: Social rented,144,67,51,20,31,2,14,77,34,2,9,26,6
S01009805,Rented or living rent free: Private rented or living rent free,46,21,18,6,12,2,1,25,4,10,4,1,6
S01009806,All HRPs aged 16 and over,446,224,189,39,150,21,14,222,156,4,8,47,7
S01009806,Owned: Total,255,155,137,23,114,15,3,100,79,2,2,11,6
S01009806,Owned: Owned outright,115,38,34,9,25,3,1,77,66,1,1,7,2
S01009806,Owned: Owned with a mortgage or loan or shared ownership,140,117,103,14,89,12,2,23,13,1,1,4,4
S01009806,Rented or living rent free: Total,191,69,52,16,36,6,11,122,77,2,6,36,1
S01009806,Rented or living rent free: Social rented,125,29,24,8,16,1,4,96,64,0,4,28,0
S01009806,Rented or living rent free: Private rented or living rent free,66,40,28,8,20,5,7,26,13,2,2,8,1
S01009807,All HRPs aged 16 and over,461,265,221,45,176,19,25,196,105,10,21,51,9
S01009807,Owned: Total,248,185,170,25,145,13,2,63,52,3,0,4,4
S01009807,Owned: Owned outright,96,45,40,9,31,4,1,51,45,1,0,2,3
S01009807,Owned: Owned with a mortgage or loan or shared ownership,152,140,130,16,114,9,1,12,7,2,0,2,1
S01009807,Rented or living rent free: Total,213,80,51,20,31,6,23,133,53,7,21,47,5
S01009807,Rented or living rent free: Social rented,158,49,30,15,15,5,14,109,51,5,14,35,4
S01009807,Rented or living rent free: Private rented or living rent free,55,31,21,5,16,1,9,24,2,2,7,12,1
S01009808,All HRPs aged 16 and over,428,264,182,55,127,25,57,164,51,24,24,37,28
S01009808,Owned: Total,140,99,81,14,67,18,0,41,32,7,1,1,0
S01009808,Owned: Owned outright,42,19,14,3,11,5,0,23,20,3,0,0,0
S01009808,Owned: Owned with a mortgage or loan or shared ownership,98,80,67,11,56,13,0,18,12,4,1,1,0
S01009808,Rented or living rent free: Total,288,165,101,41,60,7,57,123,19,17,23,36,28
S01009808,Rented or living rent free: Social rented,249,139,79,34,45,5,55,110,17,15,17,35,26
S01009808,Rented or living rent free: Private rented or living rent free,39,26,22,7,15,2,2,13,2,2,6,1,2
S01009809,All HRPs aged 16 and over,338,204,180,35,145,15,9,134,87,5,13,24,5
S01009809,Owned: Total,206,149,133,22,111,14,2,57,53,1,1,2,0
S01009809,Owned: Owned outright,85,39,31,6,25,7,1,46,44,0,0,2,0
S01009809,Owned: Owned with a mortgage or loan or shared ownership,121,110,102,16,86,7,1,11,9,1,1,0,0
S01009809,Rented or living rent free: Total,132,55,47,13,34,1,7,77,34,4,12,22,5
S01009809,Rented or living rent free: Social rented,77,24,20,7,13,0,4,53,25,3,0,20,5
S01009809,Rented or living rent free: Private rented or living rent free,55,31,27,6,21,1,3,24,9,1,12,2,0
S01009810,All HRPs aged 16 and over,453,241,178,48,130,17,46,212,125,3,12,61,11
S01009810,Owned: Total,154,97,82,15,67,11,4,57,53,0,0,2,2
S01009810,Owned: Owned outright,63,24,21,7,14,2,1,39,36,0,0,1,2
S01009810,Owned: Owned with a mortgage or loan or shared ownership,91,73,61,8,53,9,3,18,17,0,0,1,0
S01009810,Rented or living rent free: Total,299,144,96,33,63,6,42,155,72,3,12,59,9
S01009810,Rented or living rent free: Social rented,266,123,83,29,54,3,37,143,70,3,11,50,9
S01009810,Rented or living rent free: Private rented or living rent free,33,21,13,4,9,3,5,12,2,0,1,9,0
S01009811,All HRPs aged 16 and over,520,245,206,44,162,18,21,275,167,5,15,75,13
S01009811,Owned: Total,251,150,133,20,113,12,5,101,84,2,3,9,3
S01009811,Owned: Owned outright,98,27,23,6,17,3,1,71,64,2,2,2,1
S01009811,Owned: Owned with a mortgage or loan or shared ownership,153,123,110,14,96,9,4,30,20,0,1,7,2
S01009811,Rented or living rent free: Total,269,95,73,24,49,6,16,174,83,3,12,66,10
S01009811,Rented or living rent free: Social rented,222,71,57,18,39,5,9,151,72,2,8,63,6
S01009811,Rented or living rent free: Private rented or living rent free,47,24,16,6,10,1,7,23,11,1,4,3,4
S01009812,All HRPs aged 16 and over,376,188,146,19,127,20,22,188,135,1,11,30,11
S01009812,Owned: Total,219,134,114,11,103,14,6,85,78,0,0,4,3
S01009812,Owned: Owned outright,82,26,20,7,13,3,3,56,52,0,0,2,2
S01009812,Owned: Owned with a mortgage or loan or shared ownership,137,108,94,4,90,11,3,29,26,0,0,2,1
S01009812,Rented or living rent free: Total,157,54,32,8,24,6,16,103,57,1,11,26,8
S01009812,Rented or living rent free: Social rented,117,34,20,5,15,6,8,83,47,1,8,24,3
S01009812,Rented or living rent free: Private rented or living rent free,40,20,12,3,9,0,8,20,10,0,3,2,5
S01009813,All HRPs aged 16 and over,335,158,115,48,67,14,29,177,101,5,20,47,4
S01009813,Owned: Total,31,24,18,5,13,6,0,7,6,0,1,0,0
S01009813,Owned: Owned outright,10,3,3,1,2,0,0,7,6,0,1,0,0
S01009813,Owned: Owned with a mortgage or loan or shared ownership,21,21,15,4,11,6,0,0,0,0,0,0,0
S01009813,Rented or living rent free: Total,304,134,97,43,54,8,29,170,95,5,19,47,4
S01009813,Rented or living rent free: Social rented,288,122,90,42,48,7,25,166,95,3,19,45,4
S01009813,Rented or living rent free: Private rented or living rent free,16,12,7,1,6,1,4,4,0,2,0,2,0
S01009814,All HRPs aged 16 and over,362,199,163,30,133,25,11,163,128,4,7,18,6
S01009814,Owned: Total,268,166,135,19,116,24,7,102,87,3,1,10,1
S01009814,Owned: Owned outright,112,31,22,7,15,8,1,81,74,0,0,7,0
S01009814,Owned: Owned with a mortgage or loan or shared ownership,156,135,113,12,101,16,6,21,13,3,1,3,1
S01009814,Rented or living rent free: Total,94,33,28,11,17,1,4,61,41,1,6,8,5
S01009814,Rented or living rent free: Social rented,71,18,17,7,10,0,1,53,37,0,5,6,5
S01009814,Rented or living rent free: Private rented or living rent free,23,15,11,4,7,1,3,8,4,1,1,2,0
S01009815,All HRPs aged 16 and over,346,213,190,33,157,12,11,133,79,4,6,37,7
S01009815,Owned: Total,235,170,156,19,137,9,5,65,57,4,0,2,2
S01009815,Owned: Owned outright,97,39,34,6,28,3,2,58,54,3,0,0,1
S01009815,Owned: Owned with a mortgage or loan or shared ownership,138,131,122,13,109,6,3,7,3,1,0,2,1
S01009815,Rented or living rent free: Total,111,43,34,14,20,3,6,68,22,0,6,35,5
S01009815,Rented or living rent free: Social rented,63,16,11,2,9,1,4,47,17,0,1,27,2
S01009815,Rented or living rent free: Private rented or living rent free,48,27,23,12,11,2,2,21,5,0,5,8,3
S01009816,All HRPs aged 16 and over,326,238,211,42,169,24,3,88,68,3,3,11,3
S01009816,Owned: Total,266,204,181,29,152,21,2,62,55,2,0,4,1
S01009816,Owned: Owned outright,81,36,35,12,23,1,0,45,44,0,0,1,0
S01009816,Owned: Owned with a mortgage or loan or shared ownership,185,168,146,17,129,20,2,17,11,2,0,3,1
S01009816,Rented or living rent free: Total,60,34,30,13,17,3,1,26,13,1,3,7,2
S01009816,Rented or living rent free: Social rented,16,5,5,3,2,0,0,11,6,0,1,3,1
S01009816,Rented or living rent free: Private rented or living rent free,44,29,25,10,15,3,1,15,7,1,2,4,1
S01009817,All HRPs aged 16 and over,343,165,143,26,117,14,8,178,137,4,2,28,7
S01009817,Owned: Total,204,122,105,15,90,13,4,82,73,3,0,5,1
S01009817,Owned: Owned outright,84,26,23,8,15,1,2,58,54,1,0,3,0
S01009817,Owned: Owned with a mortgage or loan or shared ownership,120,96,82,7,75,12,2,24,19,2,0,2,1
S01009817,Rented or living rent free: Total,139,43,38,11,27,1,4,96,64,1,2,23,6
S01009817,Rented or living rent free: Social rented,122,33,29,6,23,1,3,89,62,0,0,21,6
S01009817,Rented or living rent free: Private rented or living rent free,17,10,9,5,4,0,1,7,2,1,2,2,0
S01009818,All HRPs aged 16 and over,421,205,166,26,140,36,3,216,201,0,2,8,5
S01009818,Owned: Total,397,191,156,25,131,33,2,206,197,0,0,5,4
S01009818,Owned: Owned outright,253,77,61,18,43,15,1,176,171,0,0,2,3
S01009818,Owned: Owned with a mortgage or loan or shared ownership,144,114,95,7,88,18,1,30,26,0,0,3,1
S01009818,Rented or living rent free: Total,24,14,10,1,9,3,1,10,4,0,2,3,1
S01009818,Rented or living rent free: Social rented,8,3,3,1,2,0,0,5,2,0,1,2,0
S01009818,Rented or living rent free: Private rented or living rent free,16,11,7,0,7,3,1,5,2,0,1,1,1
S01009819,All HRPs aged 16 and over,306,147,110,20,90,28,9,159,128,1,5,22,3
S01009819,Owned: Total,213,114,85,10,75,27,2,99,93,0,1,3,2
S01009819,Owned: Owned outright,115,31,22,1,21,8,1,84,82,0,0,2,0
S01009819,Owned: Owned with a mortgage or loan or shared ownership,98,83,63,9,54,19,1,15,11,0,1,1,2
S01009819,Rented or living rent free: Total,93,33,25,10,15,1,7,60,35,1,4,19,1
S01009819,Rented or living rent free: Social rented,71,20,16,6,10,1,3,51,34,0,1,15,1
S01009819,Rented or living rent free: Private rented or living rent free,22,13,9,4,5,0,4,9,1,1,3,4,0
S01009820,All HRPs aged 16 and over,445,229,200,28,172,22,7,216,168,4,8,29,7
S01009820,Owned: Total,314,183,161,17,144,18,4,131,117,1,1,9,3
S01009820,Owned: Owned outright,144,40,32,7,25,6,2,104,98,0,0,5,1
S01009820,Owned: Owned with a mortgage or loan or shared ownership,170,143,129,10,119,12,2,27,19,1,1,4,2
S01009820,Rented or living rent free: Total,131,46,39,11,28,4,3,85,51,3,7,20,4
S01009820,Rented or living rent free: Social rented,106,37,33,9,24,2,2,69,44,2,3,19,1
S01009820,Rented or living rent free: Private rented or living rent free,25,9,6,2,4,2,1,16,7,1,4,1,3
S01009821,All HRPs aged 16 and over,255,164,133,19,114,21,10,91,78,1,2,6,4
S01009821,Owned: Total,221,143,120,12,108,19,4,78,71,0,1,2,4
S01009821,Owned: Owned outright,93,27,25,3,22,1,1,66,63,0,1,0,2
S01009821,Owned: Owned with a mortgage or loan or shared ownership,128,116,95,9,86,18,3,12,8,0,0,2,2
S01009821,Rented or living rent free: Total,34,21,13,7,6,2,6,13,7,1,1,4,0
S01009821,Rented or living rent free: Social rented,14,8,4,3,1,2,2,6,4,0,1,1,0
S01009821,Rented or living rent free: Private rented or living rent free,20,13,9,4,5,0,4,7,3,1,0,3,0
S01009822,All HRPs aged 16 and over,191,128,109,15,94,5,14,63,42,3,7,10,1
S01009822,Owned: Total,136,106,96,11,85,4,6,30,24,1,1,3,1
S01009822,Owned: Owned outright,38,15,9,4,5,1,5,23,18,1,0,3,1
S01009822,Owned: Owned with a mortgage or loan or shared ownership,98,91,87,7,80,3,1,7,6,0,1,0,0
S01009822,Rented or living rent free: Total,55,22,13,4,9,1,8,33,18,2,6,7,0
S01009822,Rented or living rent free: Social rented,38,15,6,3,3,1,8,23,16,1,1,5,0
S01009822,Rented or living rent free: Private rented or living rent free,17,7,7,1,6,0,0,10,2,1,5,2,0
S01009823,All HRPs aged 16 and over,306,157,133,36,97,9,15,149,91,14,11,29,4
S01009823,Owned: Total,172,109,96,16,80,8,5,63,54,0,1,7,1
S01009823,Owned: Owned outright,64,27,25,4,21,1,1,37,32,0,1,3,1
S01009823,Owned: Owned with a mortgage or loan or shared ownership,108,82,71,12,59,7,4,26,22,0,0,4,0
S01009823,Rented or living rent free: Total,134,48,37,20,17,1,10,86,37,14,10,22,3
S01009823,Rented or living rent free: Social rented,92,30,25,13,12,0,5,62,34,3,3,21,1
S01009823,Rented or living rent free: Private rented or living rent free,42,18,12,7,5,1,5,24,3,11,7,1,2
S01009824,All HRPs aged 16 and over,365,218,192,39,153,16,10,147,98,1,16,25,7
S01009824,Owned: Total,238,166,145,19,126,14,7,72,64,0,2,4,2
S01009824,Owned: Owned outright,65,14,11,3,8,2,1,51,47,0,1,3,0
S01009824,Owned: Owned with a mortgage or loan or shared ownership,173,152,134,16,118,12,6,21,17,0,1,1,2
S01009824,Rented or living rent free: Total,127,52,47,20,27,2,3,75,34,1,14,21,5
S01009824,Rented or living rent free: Social rented,100,41,39,17,22,0,2,59,29,1,10,16,3
S01009824,Rented or living rent free: Private rented or living rent free,27,11,8,3,5,2,1,16,5,0,4,5,2
S01009825,All HRPs aged 16 and over,449,258,207,40,167,15,36,191,111,7,14,51,8
S01009825,Owned: Total,216,151,133,13,120,12,6,65,53,2,1,6,3
S01009825,Owned: Owned outright,72,30,25,1,24,2,3,42,40,1,1,0,0
S01009825,Owned: Owned with a mortgage or loan or shared ownership,144,121,108,12,96,10,3,23,13,1,0,6,3
S01009825,Rented or living rent free: Total,233,107,74,27,47,3,30,126,58,5,13,45,5
S01009825,Rented or living rent free: Social rented,209,94,62,24,38,3,29,115,56,3,8,44,4
S01009825,Rented or living rent free: Private rented or living rent free,24,13,12,3,9,0,1,11,2,2,5,1,1
S01009826,All HRPs aged 16 and over,228,122,103,20,83,7,12,106,64,0,10,26,6
S01009826,Owned: Total,127,76,71,9,62,4,1,51,42,0,1,6,2
S01009826,Owned: Owned outright,52,14,13,2,11,1,0,38,33,0,0,3,2
S01009826,Owned: Owned with a mortgage or loan or shared ownership,75,62,58,7,51,3,1,13,9,0,1,3,0
S01009826,Rented or living rent free: Total,101,46,32,11,21,3,11,55,22,0,9,20,4
S01009826,Rented or living rent free: Social rented,88,39,26,9,17,3,10,49,21,0,8,18,2
S01009826,Rented or living rent free: Private rented or living rent free,13,7,6,2,4,0,1,6,1,0,1,2,2
S01009827,All HRPs aged 16 and over,367,198,173,48,125,14,11,169,115,6,17,22,9
S01009827,Owned: Total,205,116,105,19,86,9,2,89,79,1,2,7,0
S01009827,Owned: Owned outright,87,25,23,8,15,1,1,62,57,1,0,4,0
S01009827,Owned: Owned with a mortgage or loan or shared ownership,118,91,82,11,71,8,1,27,22,0,2,3,0
S01009827,Rented or living rent free: Total,162,82,68,29,39,5,9,80,36,5,15,15,9
S01009827,Rented or living rent free: Social rented,134,67,55,24,31,4,8,67,34,3,7,14,9
S01009827,Rented or living rent free: Private rented or living rent free,28,15,13,5,8,1,1,13,2,2,8,1,0
S01009828,All HRPs aged 16 and over,394,152,123,35,88,11,18,242,153,0,11,60,18
S01009828,Owned: Total,108,61,54,8,46,7,0,47,39,0,0,6,2
S01009828,Owned: Owned outright,46,12,11,1,10,1,0,34,31,0,0,2,1
S01009828,Owned: Owned with a mortgage or loan or shared ownership,62,49,43,7,36,6,0,13,8,0,0,4,1
S01009828,Rented or living rent free: Total,286,91,69,27,42,4,18,195,114,0,11,54,16
S01009828,Rented or living rent free: Social rented,264,80,63,25,38,3,14,184,111,0,9,50,14
S01009828,Rented or living rent free: Private rented or living rent free,22,11,6,2,4,1,4,11,3,0,2,4,2
S01009829,All HRPs aged 16 and over,512,326,261,41,220,23,42,186,117,5,18,42,4
S01009829,Owned: Total,274,203,185,28,157,12,6,71,65,0,1,5,0
S01009829,Owned: Owned outright,94,35,30,6,24,4,1,59,55,0,0,4,0
S01009829,Owned: Owned with a mortgage or loan or shared ownership,180,168,155,22,133,8,5,12,10,0,1,1,0
S01009829,Rented or living rent free: Total,238,123,76,13,63,11,36,115,52,5,17,37,4
S01009829,Rented or living rent free: Social rented,160,69,37,5,32,7,25,91,50,4,3,31,3
S01009829,Rented or living rent free: Private rented or living rent free,78,54,39,8,31,4,11,24,2,1,14,6,1
S01009830,All HRPs aged 16 and over,329,220,199,38,161,12,9,109,70,3,15,17,4
S01009830,Owned: Total,214,167,155,23,132,10,2,47,43,1,0,1,2
S01009830,Owned: Owned outright,69,33,31,8,23,2,0,36,36,0,0,0,0
S01009830,Owned: Owned with a mortgage or loan or shared ownership,145,134,124,15,109,8,2,11,7,1,0,1,2
S01009830,Rented or living rent free: Total,115,53,44,15,29,2,7,62,27,2,15,16,2
S01009830,Rented or living rent free: Social rented,45,15,14,4,10,0,1,30,16,0,3,10,1
S01009830,Rented or living rent free: Private rented or living rent free,70,38,30,11,19,2,6,32,11,2,12,6,1
S01009831,All HRPs aged 16 and over,313,231,207,37,170,13,11,82,58,3,9,9,3
S01009831,Owned: Total,230,179,166,21,145,11,2,51,47,1,1,2,0
S01009831,Owned: Owned outright,84,38,35,7,28,3,0,46,42,1,1,2,0
S01009831,Owned: Owned with a mortgage or loan or shared ownership,146,141,131,14,117,8,2,5,5,0,0,0,0
S01009831,Rented or living rent free: Total,83,52,41,16,25,2,9,31,11,2,8,7,3
S01009831,Rented or living rent free: Social rented,8,1,0,0,0,0,1,7,2,1,1,3,0
S01009831,Rented or living rent free: Private rented or living rent free,75,51,41,16,25,2,8,24,9,1,7,4,3
S01009832,All HRPs aged 16 and over,474,279,240,45,195,20,19,195,162,5,5,18,5
S01009832,Owned: Total,338,208,181,25,156,19,8,130,119,0,2,7,2
S01009832,Owned: Owned outright,162,51,43,11,32,6,2,111,106,0,1,4,0
S01009832,Owned: Owned with a mortgage or loan or shared ownership,176,157,138,14,124,13,6,19,13,0,1,3,2
S01009832,Rented or living rent free: Total,136,71,59,20,39,1,11,65,43,5,3,11,3
S01009832,Rented or living rent free: Social rented,61,15,12,6,6,0,3,46,34,2,0,8,2
S01009832,Rented or living rent free: Private rented or living rent free,75,56,47,14,33,1,8,19,9,3,3,3,1
S01009833,All HRPs aged 16 and over,238,184,158,22,136,15,11,54,38,2,1,13,0
S01009833,Owned: Total,167,135,118,12,106,15,2,32,26,0,0,6,0
S01009833,Owned: Owned outright,39,18,14,3,11,3,1,21,19,0,0,2,0
S01009833,Owned: Owned with a mortgage or loan or shared ownership,128,117,104,9,95,12,1,11,7,0,0,4,0
S01009833,Rented or living rent free: Total,71,49,40,10,30,0,9,22,12,2,1,7,0
S01009833,Rented or living rent free: Social rented,32,13,9,5,4,0,4,19,12,0,1,6,0
S01009833,Rented or living rent free: Private rented or living rent free,39,36,31,5,26,0,5,3,0,2,0,1,0
S01009834,All HRPs aged 16 and over,372,268,226,54,172,14,28,104,38,9,9,43,5
S01009834,Owned: Total,157,148,136,17,119,11,1,9,5,0,0,2,2
S01009834,Owned: Owned outright,13,11,9,1,8,2,0,2,2,0,0,0,0
S01009834,Owned: Owned with a mortgage or loan or shared ownership,144,137,127,16,111,9,1,7,3,0,0,2,2
S01009834,Rented or living rent free: Total,215,120,90,37,53,3,27,95,33,9,9,41,3
S01009834,Rented or living rent free: Social rented,191,103,75,31,44,3,25,88,31,7,9,38,3
S01009834,Rented or living rent free: Private rented or living rent free,24,17,15,6,9,0,2,7,2,2,0,3,0
S01009835,All HRPs aged 16 and over,258,142,121,40,81,7,14,116,67,1,7,34,7
S01009835,Owned: Total,86,49,43,10,33,5,1,37,31,1,1,3,1
S01009835,Owned: Owned outright,33,14,13,4,9,0,1,19,19,0,0,0,0
S01009835,Owned: Owned with a mortgage or loan or shared ownership,53,35,30,6,24,5,0,18,12,1,1,3,1
S01009835,Rented or living rent free: Total,172,93,78,30,48,2,13,79,36,0,6,31,6
S01009835,Rented or living rent free: Social rented,161,84,70,27,43,1,13,77,36,0,5,30,6
S01009835,Rented or living rent free: Private rented or living rent free,11,9,8,3,5,1,0,2,0,0,1,1,0
S01009836,All HRPs aged 16 and over,414,258,226,34,192,19,13,156,122,2,2,22,8
S01009836,Owned: Total,310,214,191,24,167,19,4,96,89,1,0,3,3
S01009836,Owned: Owned outright,114,46,41,8,33,3,2,68,65,0,0,1,2
S01009836,Owned: Owned with a mortgage or loan or shared ownership,196,168,150,16,134,16,2,28,24,1,0,2,1
S01009836,Rented or living rent free: Total,104,44,35,10,25,0,9,60,33,1,2,19,5
S01009836,Rented or living rent free: Social rented,68,27,21,6,15,0,6,41,27,0,0,12,2
S01009836,Rented or living rent free: Private rented or living rent free,36,17,14,4,10,0,3,19,6,1,2,7,3
S01009837,All HRPs aged 16 and over,368,169,150,28,122,8,11,199,143,2,5,44,5
S01009837,Owned: Total,154,82,73,7,66,7,2,72,62,1,0,9,0
S01009837,Owned: Owned outright,65,17,13,2,11,2,2,48,44,1,0,3,0
S01009837,Owned: Owned with a mortgage or loan or shared ownership,89,65,60,5,55,5,0,24,18,0,0,6,0
S01009837,Rented or living rent free: Total,214,87,77,21,56,1,9,127,81,1,5,35,5
S01009837,Rented or living rent free: Social rented,194,73,65,15,50,1,7,121,77,0,4,35,5
S01009837,Rented or living rent free: Private rented or living rent free,20,14,12,6,6,0,2,6,4,1,1,0,0
S01009838,All HRPs aged 16 and over,433,259,203,41,162,14,42,174,115,4,8,37,10
S01009838,Owned: Total,194,124,113,18,95,8,3,70,65,1,0,4,0
S01009838,Owned: Owned outright,89,28,25,3,22,2,1,61,57,1,0,3,0
S01009838,Owned: Owned with a mortgage or loan or shared ownership,105,96,88,15,73,6,2,9,8,0,0,1,0
S01009838,Rented or living rent free: Total,239,135,90,23,67,6,39,104,50,3,8,33,10
S01009838,Rented or living rent free: Social rented,177,91,56,20,36,2,33,86,43,2,5,28,8
S01009838,Rented or living rent free: Private rented or living rent free,62,44,34,3,31,4,6,18,7,1,3,5,2
S01009839,All HRPs aged 16 and over,614,388,313,79,234,15,60,226,79,10,23,85,29
S01009839,Owned: Total,105,74,66,7,59,4,4,31,23,2,0,4,2
S01009839,Owned: Owned outright,35,16,13,1,12,0,3,19,15,2,0,1,1
S01009839,Owned: Owned with a mortgage or loan or shared ownership,70,58,53,6,47,4,1,12,8,0,0,3,1
S01009839,Rented or living rent free: Total,509,314,247,72,175,11,56,195,56,8,23,81,27
S01009839,Rented or living rent free: Social rented,452,272,212,62,150,10,50,180,54,4,21,76,25
S01009839,Rented or living rent free: Private rented or living rent free,57,42,35,10,25,1,6,15,2,4,2,5,2
S01009840,All HRPs aged 16 and over,475,232,193,49,144,16,23,243,184,2,5,40,12
S01009840,Owned: Total,279,166,145,27,118,13,8,113,101,1,2,7,2
S01009840,Owned: Owned outright,113,36,30,10,20,2,4,77,71,1,0,3,2
S01009840,Owned: Owned with a mortgage or loan or shared ownership,166,130,115,17,98,11,4,36,30,0,2,4,0
S01009840,Rented or living rent free: Total,196,66,48,22,26,3,15,130,83,1,3,33,10
S01009840,Rented or living rent free: Social rented,169,49,37,17,20,2,10,120,78,1,2,30,9
S01009840,Rented or living rent free: Private rented or living rent free,27,17,11,5,6,1,5,10,5,0,1,3,1
S01009841,All HRPs aged 16 and over,461,292,234,54,180,16,42,169,64,24,10,49,22
S01009841,Owned: Total,59,37,35,5,30,2,0,22,13,1,0,5,3
S01009841,Owned: Owned outright,27,10,10,3,7,0,0,17,12,1,0,4,0
S01009841,Owned: Owned with a mortgage or loan or shared ownership,32,27,25,2,23,2,0,5,1,0,0,1,3
S01009841,Rented or living rent free: Total,402,255,199,49,150,14,42,147,51,23,10,44,19
S01009841,Rented or living rent free: Social rented,371,230,183,47,136,12,35,141,51,21,9,43,17
S01009841,Rented or living rent free: Private rented or living rent free,31,25,16,2,14,2,7,6,0,2,1,1,2
S01009842,All HRPs aged 16 and over,332,209,155,41,114,16,38,123,25,25,21,35,17
S01009842,Owned: Total,61,43,38,2,36,5,0,18,12,1,1,2,2
S01009842,Owned: Owned outright,21,9,7,1,6,2,0,12,10,1,0,1,0
S01009842,Owned: Owned with a mortgage or loan or shared ownership,40,34,31,1,30,3,0,6,2,0,1,1,2
S01009842,Rented or living rent free: Total,271,166,117,39,78,11,38,105,13,24,20,33,15
S01009842,Rented or living rent free: Social rented,240,148,108,36,72,8,32,92,13,16,19,30,14
S01009842,Rented or living rent free: Private rented or living rent free,31,18,9,3,6,3,6,13,0,8,1,3,1
S01009843,All HRPs aged 16 and over,310,142,108,25,83,4,30,168,73,2,11,67,15
S01009843,Owned: Total,67,42,39,5,34,3,0,25,22,1,0,2,0
S01009843,Owned: Owned outright,19,2,1,1,0,1,0,17,16,1,0,0,0
S01009843,Owned: Owned with a mortgage or loan or shared ownership,48,40,38,4,34,2,0,8,6,0,0,2,0
S01009843,Rented or living rent free: Total,243,100,69,20,49,1,30,143,51,1,11,65,15
S01009843,Rented or living rent free: Social rented,230,94,63,19,44,1,30,136,48,1,10,62,15
S01009843,Rented or living rent free: Private rented or living rent free,13,6,6,1,5,0,0,7,3,0,1,3,0
S01009844,All HRPs aged 16 and over,361,177,119,27,92,16,42,184,77,8,11,59,29
S01009844,Owned: Total,15,8,7,2,5,1,0,7,3,1,0,3,0
S01009844,Owned: Owned outright,7,2,2,1,1,0,0,5,3,0,0,2,0
S01009844,Owned: Owned with a mortgage or loan or shared ownership,8,6,5,1,4,1,0,2,0,1,0,1,0
S01009844,Rented or living rent free: Total,346,169,112,25,87,15,42,177,74,7,11,56,29
S01009844,Rented or living rent free: Social rented,325,162,107,24,83,14,41,163,66,3,11,56,27
S01009844,Rented or living rent free: Private rented or living rent free,21,7,5,1,4,1,1,14,8,4,0,0,2
S01009845,All HRPs aged 16 and over,440,315,222,57,165,20,73,125,28,10,18,52,17
S01009845,Owned: Total,25,23,20,4,16,3,0,2,0,0,0,1,1
S01009845,Owned: Owned outright,5,4,4,1,3,0,0,1,0,0,0,1,0
S01009845,Owned: Owned with a mortgage or loan or shared ownership,20,19,16,3,13,3,0,1,0,0,0,0,1
S01009845,Rented or living rent free: Total,415,292,202,53,149,17,73,123,28,10,18,51,16
S01009845,Rented or living rent free: Social rented,362,247,166,47,119,11,70,115,28,6,17,48,16
S01009845,Rented or living rent free: Private rented or living rent free,53,45,36,6,30,6,3,8,0,4,1,3,0
S01009846,All HRPs aged 16 and over,461,289,229,67,162,16,44,172,79,10,15,50,18
S01009846,Owned: Total,141,101,88,18,70,10,3,40,32,0,1,4,3
S01009846,Owned: Owned outright,48,22,20,1,19,2,0,26,22,0,1,2,1
S01009846,Owned: Owned with a mortgage or loan or shared ownership,93,79,68,17,51,8,3,14,10,0,0,2,2
S01009846,Rented or living rent free: Total,320,188,141,49,92,6,41,132,47,10,14,46,15
S01009846,Rented or living rent free: Social rented,278,163,126,44,82,5,32,115,44,7,9,41,14
S01009846,Rented or living rent free: Private rented or living rent free,42,25,15,5,10,1,9,17,3,3,5,5,1
S01009847,All HRPs aged 16 and over,322,228,195,50,145,9,24,94,39,8,15,21,11
S01009847,Owned: Total,60,54,48,7,41,5,1,6,5,0,1,0,0
S01009847,Owned: Owned outright,15,10,9,3,6,1,0,5,4,0,1,0,0
S01009847,Owned: Owned with a mortgage or loan or shared ownership,45,44,39,4,35,4,1,1,1,0,0,0,0
S01009847,Rented or living rent free: Total,262,174,147,43,104,4,23,88,34,8,14,21,11
S01009847,Rented or living rent free: Social rented,233,157,131,37,94,4,22,76,34,2,12,19,9
S01009847,Rented or living rent free: Private rented or living rent free,29,17,16,6,10,0,1,12,0,6,2,2,2
S01009848,All HRPs aged 16 and over,383,200,176,45,131,12,12,183,103,3,15,57,5
S01009848,Owned: Total,208,130,116,24,92,10,4,78,63,0,2,12,1
S01009848,Owned: Owned outright,93,40,35,10,25,2,3,53,47,0,1,4,1
S01009848,Owned: Owned with a mortgage or loan or shared ownership,115,90,81,14,67,8,1,25,16,0,1,8,0
S01009848,Rented or living rent free: Total,175,70,60,21,39,2,8,105,40,3,13,45,4
S01009848,Rented or living rent free: Social rented,147,55,45,16,29,2,8,92,40,1,7,41,3
S01009848,Rented or living rent free: Private rented or living rent free,28,15,15,5,10,0,0,13,0,2,6,4,1
S01009849,All HRPs aged 16 and over,445,207,184,29,155,12,11,238,188,3,7,33,7
S01009849,Owned: Total,251,124,116,10,106,5,3,127,120,3,0,2,2
S01009849,Owned: Owned outright,123,21,18,4,14,1,2,102,96,3,0,2,1
S01009849,Owned: Owned with a mortgage or loan or shared ownership,128,103,98,6,92,4,1,25,24,0,0,0,1
S01009849,Rented or living rent free: Total,194,83,68,19,49,7,8,111,68,0,7,31,5
S01009849,Rented or living rent free: Social rented,136,41,35,13,22,0,6,95,62,0,4,24,5
S01009849,Rented or living rent free: Private rented or living rent free,58,42,33,6,27,7,2,16,6,0,3,7,0
S01009850,All HRPs aged 16 and over,472,254,224,32,192,15,15,218,164,5,8,35,6
S01009850,Owned: Total,299,186,170,18,152,13,3,113,99,2,3,9,0
S01009850,Owned: Owned outright,118,35,33,9,24,2,0,83,75,0,2,6,0
S01009850,Owned: Owned with a mortgage or loan or shared ownership,181,151,137,9,128,11,3,30,24,2,1,3,0
S01009850,Rented or living rent free: Total,173,68,54,14,40,2,12,105,65,3,5,26,6
S01009850,Rented or living rent free: Social rented,105,26,21,8,13,1,4,79,53,0,4,19,3
S01009850,Rented or living rent free: Private rented or living rent free,68,42,33,6,27,1,8,26,12,3,1,7,3
S01009851,All HRPs aged 16 and over,470,214,171,35,136,24,19,256,199,1,7,40,9
S01009851,Owned: Total,226,132,111,12,99,17,4,94,88,0,1,5,0
S01009851,Owned: Owned outright,108,38,30,8,22,7,1,70,65,0,1,4,0
S01009851,Owned: Owned with a mortgage or loan or shared ownership,118,94,81,4,77,10,3,24,23,0,0,1,0
S01009851,Rented or living rent free: Total,244,82,60,23,37,7,15,162,111,1,6,35,9
S01009851,Rented or living rent free: Social rented,213,58,43,17,26,4,11,155,109,1,3,34,8
S01009851,Rented or living rent free: Private rented or living rent free,31,24,17,6,11,3,4,7,2,0,3,1,1
S01009852,All HRPs aged 16 and over,257,121,107,11,96,9,5,136,111,1,8,13,3
S01009852,Owned: Total,181,92,82,7,75,8,2,89,81,1,2,3,2
S01009852,Owned: Owned outright,78,17,17,3,14,0,0,61,60,0,1,0,0
S01009852,Owned: Owned with a mortgage or loan or shared ownership,103,75,65,4,61,8,2,28,21,1,1,3,2
S01009852,Rented or living rent free: Total,76,29,25,4,21,1,3,47,30,0,6,10,1
S01009852,Rented or living rent free: Social rented,52,14,13,2,11,0,1,38,23,0,4,10,1
S01009852,Rented or living rent free: Private rented or living rent free,24,15,12,2,10,1,2,9,7,0,2,0,0
S01009853,All HRPs aged 16 and over,413,212,174,34,140,17,21,201,147,7,11,27,9
S01009853,Owned: Total,265,159,136,18,118,15,8,106,94,3,1,6,2
S01009853,Owned: Owned outright,113,40,28,11,17,6,6,73,66,1,1,4,1
S01009853,Owned: Owned with a mortgage or loan or shared ownership,152,119,108,7,101,9,2,33,28,2,0,2,1
S01009853,Rented or living rent free: Total,148,53,38,16,22,2,13,95,53,4,10,21,7
S01009853,Rented or living rent free: Social rented,107,32,25,10,15,0,7,75,46,0,7,19,3
S01009853,Rented or living rent free: Private rented or living rent free,41,21,13,6,7,2,6,20,7,4,3,2,4
S01009854,All HRPs aged 16 and over,398,242,198,57,141,19,25,156,89,2,7,44,14
S01009854,Owned: Total,163,131,118,19,99,10,3,32,27,0,2,2,1
S01009854,Owned: Owned outright,34,15,12,3,9,2,1,19,18,0,0,1,0
S01009854,Owned: Owned with a mortgage or loan or shared ownership,129,116,106,16,90,8,2,13,9,0,2,1,1
S01009854,Rented or living rent free: Total,235,111,80,38,42,9,22,124,62,2,5,42,13
S01009854,Rented or living rent free: Social rented,187,77,53,28,25,8,16,110,58,2,3,35,12
S01009854,Rented or living rent free: Private rented or living rent free,48,34,27,10,17,1,6,14,4,0,2,7,1
S01009855,All HRPs aged 16 and over,250,147,130,23,107,14,3,103,80,5,0,13,5
S01009855,Owned: Total,183,119,105,16,89,13,1,64,61,1,0,1,1
S01009855,Owned: Owned outright,62,24,18,5,13,5,1,38,36,1,0,1,0
S01009855,Owned: Owned with a mortgage or loan or shared ownership,121,95,87,11,76,8,0,26,25,0,0,0,1
S01009855,Rented or living rent free: Total,67,28,25,7,18,1,2,39,19,4,0,12,4
S01009855,Rented or living rent free: Social rented,53,19,16,3,13,1,2,34,18,0,0,12,4
S01009855,Rented or living rent free: Private rented or living rent free,14,9,9,4,5,0,0,5,1,4,0,0,0
S01009856,All HRPs aged 16 and over,308,142,112,22,90,20,10,166,117,11,8,22,8
S01009856,Owned: Total,221,116,91,15,76,19,6,105,94,0,4,7,0
S01009856,Owned: Owned outright,119,43,29,7,22,10,4,76,71,0,2,3,0
S01009856,Owned: Owned with a mortgage or loan or shared ownership,102,73,62,8,54,9,2,29,23,0,2,4,0
S01009856,Rented or living rent free: Total,87,26,21,7,14,1,4,61,23,11,4,15,8
S01009856,Rented or living rent free: Social rented,57,16,13,5,8,1,2,41,22,0,2,14,3
S01009856,Rented or living rent free: Private rented or living rent free,30,10,8,2,6,0,2,20,1,11,2,1,5
S01009857,All HRPs aged 16 and over,374,198,172,32,140,20,6,176,140,1,12,17,6
S01009857,Owned: Total,255,147,126,15,111,17,4,108,100,0,4,2,2
S01009857,Owned: Owned outright,100,31,26,3,23,4,1,69,67,0,0,1,1
S01009857,Owned: Owned with a mortgage or loan or shared ownership,155,116,100,12,88,13,3,39,33,0,4,1,1
S01009857,Rented or living rent free: Total,119,51,46,17,29,3,2,68,40,1,8,15,4
S01009857,Rented or living rent free: Social rented,95,34,30,10,20,3,1,61,37,0,7,13,4
S01009857,Rented or living rent free: Private rented or living rent free,24,17,16,7,9,0,1,7,3,1,1,2,0
S01009858,All HRPs aged 16 and over,337,191,164,32,132,17,10,146,113,6,5,17,5
S01009858,Owned: Total,232,152,136,18,118,13,3,80,74,1,2,1,2
S01009858,Owned: Owned outright,93,33,29,8,21,4,0,60,57,0,0,1,2
S01009858,Owned: Owned with a mortgage or loan or shared ownership,139,119,107,10,97,9,3,20,17,1,2,0,0
S01009858,Rented or living rent free: Total,105,39,28,14,14,4,7,66,39,5,3,16,3
S01009858,Rented or living rent free: Social rented,81,24,18,8,10,2,4,57,37,1,2,15,2
S01009858,Rented or living rent free: Private rented or living rent free,24,15,10,6,4,2,3,9,2,4,1,1,1
S01009859,All HRPs aged 16 and over,580,273,216,60,156,10,47,307,152,6,27,95,27
S01009859,Owned: Total,154,90,80,9,71,7,3,64,50,1,0,8,5
S01009859,Owned: Owned outright,61,19,17,2,15,1,1,42,32,1,0,7,2
S01009859,Owned: Owned with a mortgage or loan or shared ownership,93,71,63,7,56,6,2,22,18,0,0,1,3
S01009859,Rented or living rent free: Total,426,183,136,51,85,3,44,243,102,5,27,87,22
S01009859,Rented or living rent free: Social rented,351,131,94,39,55,1,36,220,98,2,22,80,18
S01009859,Rented or living rent free: Private rented or living rent free,75,52,42,12,30,2,8,23,4,3,5,7,4
S01009860,All HRPs aged 16 and over,503,225,180,56,124,6,39,278,163,6,22,76,11
S01009860,Owned: Total,86,52,48,8,40,2,2,34,30,1,0,3,0
S01009860,Owned: Owned outright,35,12,11,3,8,1,0,23,21,1,0,1,0
S01009860,Owned: Owned with a mortgage or loan or shared ownership,51,40,37,5,32,1,2,11,9,0,0,2,0
S01009860,Rented or living rent free: Total,417,173,132,48,84,4,37,244,133,5,22,73,11
S01009860,Rented or living rent free: Social rented,355,135,103,37,66,3,29,220,126,2,17,65,10
S01009860,Rented or living rent free: Private rented or living rent free,62,38,29,11,18,1,8,24,7,3,5,8,1
S01009861,All HRPs aged 16 and over,524,297,227,40,187,21,49,227,83,16,34,67,27
S01009861,Owned: Total,104,80,69,7,62,9,2,24,16,0,1,4,3
S01009861,Owned: Owned outright,28,13,12,0,12,1,0,15,11,0,0,3,1
S01009861,Owned: Owned with a mortgage or loan or shared ownership,76,67,57,7,50,8,2,9,5,0,1,1,2
S01009861,Rented or living rent free: Total,420,217,158,33,125,12,47,203,67,16,33,63,24
S01009861,Rented or living rent free: Social rented,315,147,101,20,81,4,42,168,65,10,26,55,12
S01009861,Rented or living rent free: Private rented or living rent free,105,70,57,13,44,8,5,35,2,6,7,8,12
S01009862,All HRPs aged 16 and over,607,380,296,65,231,28,56,227,75,26,14,89,23
S01009862,Owned: Total,131,103,87,13,74,13,3,28,20,2,2,3,1
S01009862,Owned: Owned outright,45,28,24,4,20,3,1,17,14,0,0,3,0
S01009862,Owned: Owned with a mortgage or loan or shared ownership,86,75,63,9,54,10,2,11,6,2,2,0,1
S01009862,Rented or living rent free: Total,476,277,209,52,157,15,53,199,55,24,12,86,22
S01009862,Rented or living rent free: Social rented,252,114,75,26,49,3,36,138,45,4,8,68,13
S01009862,Rented or living rent free: Private rented or living rent free,224,163,134,26,108,12,17,61,10,20,4,18,9
S01009863,All HRPs aged 16 and over,461,305,240,49,191,26,39,156,57,12,17,51,19
S01009863,Owned: Total,142,100,84,13,71,10,6,42,26,3,1,11,1
S01009863,Owned: Owned outright,56,26,19,6,13,6,1,30,24,0,0,6,0
S01009863,Owned: Owned with a mortgage or loan or shared ownership,86,74,65,7,58,4,5,12,2,3,1,5,1
S01009863,Rented or living rent free: Total,319,205,156,36,120,16,33,114,31,9,16,40,18
S01009863,Rented or living rent free: Social rented,128,52,38,11,27,4,10,76,26,2,9,30,9
S01009863,Rented or living rent free: Private rented or living rent free,191,153,118,25,93,12,23,38,5,7,7,10,9
S01009864,All HRPs aged 16 and over,317,208,155,32,123,26,27,109,39,13,9,30,18
S01009864,Owned: Total,125,94,70,7,63,17,7,31,24,2,1,3,1
S01009864,Owned: Owned outright,41,16,10,2,8,3,3,25,22,1,1,0,1
S01009864,Owned: Owned with a mortgage or loan or shared ownership,84,78,60,5,55,14,4,6,2,1,0,3,0
S01009864,Rented or living rent free: Total,192,114,85,25,60,9,20,78,15,11,8,27,17
S01009864,Rented or living rent free: Social rented,88,28,21,9,12,1,6,60,12,2,5,26,15
S01009864,Rented or living rent free: Private rented or living rent free,104,86,64,16,48,8,14,18,3,9,3,1,2
S01009865,All HRPs aged 16 and over,245,163,124,19,105,20,19,82,34,8,2,31,7
S01009865,Owned: Total,119,88,66,7,59,18,4,31,22,2,0,5,2
S01009865,Owned: Owned outright,39,19,16,1,15,1,2,20,19,0,0,1,0
S01009865,Owned: Owned with a mortgage or loan or shared ownership,80,69,50,6,44,17,2,11,3,2,0,4,2
S01009865,Rented or living rent free: Total,126,75,58,12,46,2,15,51,12,6,2,26,5
S01009865,Rented or living rent free: Social rented,52,17,11,5,6,0,6,35,10,0,2,19,4
S01009865,Rented or living rent free: Private rented or living rent free,74,58,47,7,40,2,9,16,2,6,0,7,1
S01009866,All HRPs aged 16 and over,455,298,253,31,222,26,19,157,108,13,2,26,8
S01009866,Owned: Total,258,182,159,16,143,17,6,76,61,3,1,9,2
S01009866,Owned: Owned outright,93,42,36,6,30,5,1,51,46,2,0,3,0
S01009866,Owned: Owned with a mortgage or loan or shared ownership,165,140,123,10,113,12,5,25,15,1,1,6,2
S01009866,Rented or living rent free: Total,197,116,94,15,79,9,13,81,47,10,1,17,6
S01009866,Rented or living rent free: Social rented,94,33,23,5,18,6,4,61,40,4,1,13,3
S01009866,Rented or living rent free: Private rented or living rent free,103,83,71,10,61,3,9,20,7,6,0,4,3
S01009867,All HRPs aged 16 and over,595,453,383,46,337,51,19,142,89,14,1,24,14
S01009867,Owned: Total,271,227,190,17,173,30,7,44,35,1,0,4,4
S01009867,Owned: Owned outright,63,34,31,8,23,2,1,29,26,0,0,1,2
S01009867,Owned: Owned with a mortgage or loan or shared ownership,208,193,159,9,150,28,6,15,9,1,0,3,2
S01009867,Rented or living rent free: Total,324,226,193,29,164,21,12,98,54,13,1,20,10
S01009867,Rented or living rent free: Social rented,95,26,25,12,13,0,1,69,44,2,1,17,5
S01009867,Rented or living rent free: Private rented or living rent free,229,200,168,17,151,21,11,29,10,11,0,3,5
S01009868,All HRPs aged 16 and over,308,243,207,21,186,23,13,65,25,19,6,13,2
S01009868,Owned: Total,157,135,115,8,107,15,5,22,16,1,1,3,1
S01009868,Owned: Owned outright,50,32,26,4,22,4,2,18,14,1,1,2,0
S01009868,Owned: Owned with a mortgage or loan or shared ownership,107,103,89,4,85,11,3,4,2,0,0,1,1
S01009868,Rented or living rent free: Total,151,108,92,13,79,8,8,43,9,18,5,10,1
S01009868,Rented or living rent free: Social rented,18,9,6,1,5,1,2,9,3,0,1,5,0
S01009868,Rented or living rent free: Private rented or living rent free,133,99,86,12,74,7,6,34,6,18,4,5,1
S01009869,All HRPs aged 16 and over,269,212,166,28,138,22,24,57,22,16,4,11,4
S01009869,Owned: Total,126,106,89,7,82,16,1,20,14,1,0,4,1
S01009869,Owned: Owned outright,27,16,14,2,12,2,0,11,10,0,0,1,0
S01009869,Owned: Owned with a mortgage or loan or shared ownership,99,90,75,5,70,14,1,9,4,1,0,3,1
S01009869,Rented or living rent free: Total,143,106,77,21,56,6,23,37,8,15,4,7,3
S01009869,Rented or living rent free: Social rented,7,3,2,0,2,0,1,4,0,2,0,1,1
S01009869,Rented or living rent free: Private rented or living rent free,136,103,75,21,54,6,22,33,8,13,4,6,2
S01009870,All HRPs aged 16 and over,274,197,149,27,122,27,21,77,39,7,8,19,4
S01009870,Owned: Total,110,95,74,9,65,18,3,15,6,3,1,3,2
S01009870,Owned: Owned outright,27,21,17,1,16,3,1,6,5,0,0,1,0
S01009870,Owned: Owned with a mortgage or loan or shared ownership,83,74,57,8,49,15,2,9,1,3,1,2,2
S01009870,Rented or living rent free: Total,164,102,75,18,57,9,18,62,33,4,7,16,2
S01009870,Rented or living rent free: Social rented,73,27,18,3,15,1,8,46,29,1,2,12,2
S01009870,Rented or living rent free: Private rented or living rent free,91,75,57,15,42,8,10,16,4,3,5,4,0
S01009871,All HRPs aged 16 and over,587,291,211,47,164,51,29,296,189,16,11,60,20
S01009871,Owned: Total,210,121,89,13,76,29,3,89,77,1,0,3,8
S01009871,Owned: Owned outright,103,32,22,5,17,9,1,71,66,0,0,1,4
S01009871,Owned: Owned with a mortgage or loan or shared ownership,107,89,67,8,59,20,2,18,11,1,0,2,4
S01009871,Rented or living rent free: Total,377,170,122,34,88,22,26,207,112,15,11,57,12
S01009871,Rented or living rent free: Social rented,283,105,73,23,50,11,21,178,100,6,8,54,10
S01009871,Rented or living rent free: Private rented or living rent free,94,65,49,11,38,11,5,29,12,9,3,3,2
S01009872,All HRPs aged 16 and over,365,284,226,38,188,35,23,81,36,16,3,17,9
S01009872,Owned: Total,185,148,123,16,107,21,4,37,27,2,2,4,2
S01009872,Owned: Owned outright,62,30,23,7,16,5,2,32,26,0,2,4,0
S01009872,Owned: Owned with a mortgage or loan or shared ownership,123,118,100,9,91,16,2,5,1,2,0,0,2
S01009872,Rented or living rent free: Total,180,136,103,22,81,14,19,44,9,14,1,13,7
S01009872,Rented or living rent free: Social rented,8,4,4,1,3,0,0,4,2,0,0,2,0
S01009872,Rented or living rent free: Private rented or living rent free,172,132,99,21,78,14,19,40,7,14,1,11,7
S01009873,All HRPs aged 16 and over,445,242,171,25,146,51,20,203,150,5,7,36,5
S01009873,Owned: Total,258,177,128,17,111,44,5,81,69,0,5,4,3
S01009873,Owned: Owned outright,114,50,34,5,29,16,0,64,58,0,4,0,2
S01009873,Owned: Owned with a mortgage or loan or shared ownership,144,127,94,12,82,28,5,17,11,0,1,4,1
S01009873,Rented or living rent free: Total,187,65,43,8,35,7,15,122,81,5,2,32,2
S01009873,Rented or living rent free: Social rented,126,19,12,5,7,1,6,107,74,2,0,29,2
S01009873,Rented or living rent free: Private rented or living rent free,61,46,31,3,28,6,9,15,7,3,2,3,0
S01009874,All HRPs aged 16 and over,497,277,200,42,158,50,27,220,139,8,12,48,13
S01009874,Owned: Total,242,152,107,12,95,42,3,90,84,0,3,1,2
S01009874,Owned: Owned outright,132,60,37,8,29,20,3,72,70,0,1,0,1
S01009874,Owned: Owned with a mortgage or loan or shared ownership,110,92,70,4,66,22,0,18,14,0,2,1,1
S01009874,Rented or living rent free: Total,255,125,93,30,63,8,24,130,55,8,9,47,11
S01009874,Rented or living rent free: Social rented,216,101,75,25,50,4,22,115,46,6,9,47,7
S01009874,Rented or living rent free: Private rented or living rent free,39,24,18,5,13,4,2,15,9,2,0,0,4
S01009875,All HRPs aged 16 and over,307,189,141,34,107,21,27,118,32,26,14,33,13
S01009875,Owned: Total,61,53,44,3,41,8,1,8,5,2,0,1,0
S01009875,Owned: Owned outright,14,9,9,1,8,0,0,5,3,2,0,0,0
S01009875,Owned: Owned with a mortgage or loan or shared ownership,47,44,35,2,33,8,1,3,2,0,0,1,0
S01009875,Rented or living rent free: Total,246,136,97,31,66,13,26,110,27,24,14,32,13
S01009875,Rented or living rent free: Social rented,126,54,36,21,15,3,15,72,23,2,10,26,11
S01009875,Rented or living rent free: Private rented or living rent free,120,82,61,10,51,10,11,38,4,22,4,6,2
S01009876,All HRPs aged 16 and over,322,187,139,61,78,13,35,135,34,21,21,45,14
S01009876,Owned: Total,58,38,33,6,27,2,3,20,14,3,0,2,1
S01009876,Owned: Owned outright,23,11,9,1,8,0,2,12,8,2,0,2,0
S01009876,Owned: Owned with a mortgage or loan or shared ownership,35,27,24,5,19,2,1,8,6,1,0,0,1
S01009876,Rented or living rent free: Total,264,149,106,55,51,11,32,115,20,18,21,43,13
S01009876,Rented or living rent free: Social rented,217,112,79,42,37,4,29,105,19,14,21,40,11
S01009876,Rented or living rent free: Private rented or living rent free,47,37,27,13,14,7,3,10,1,4,0,3,2
S01009877,All HRPs aged 16 and over,360,248,168,22,146,67,13,112,97,6,4,4,1
S01009877,Owned: Total,281,188,126,15,111,55,7,93,89,3,0,0,1
S01009877,Owned: Owned outright,153,70,44,8,36,23,3,83,79,3,0,0,1
S01009877,Owned: Owned with a mortgage or loan or shared ownership,128,118,82,7,75,32,4,10,10,0,0,0,0
S01009877,Rented or living rent free: Total,79,60,42,7,35,12,6,19,8,3,4,4,0
S01009877,Rented or living rent free: Social rented,18,13,9,4,5,2,2,5,1,0,3,1,0
S01009877,Rented or living rent free: Private rented or living rent free,61,47,33,3,30,10,4,14,7,3,1,3,0
S01009878,All HRPs aged 16 and over,252,177,124,39,85,33,20,75,38,7,5,22,3
S01009878,Owned: Total,119,85,63,17,46,19,3,34,22,1,3,5,3
S01009878,Owned: Owned outright,44,24,18,4,14,5,1,20,17,0,0,1,2
S01009878,Owned: Owned with a mortgage or loan or shared ownership,75,61,45,13,32,14,2,14,5,1,3,4,1
S01009878,Rented or living rent free: Total,133,92,61,22,39,14,17,41,16,6,2,17,0
S01009878,Rented or living rent free: Social rented,67,37,22,8,14,5,10,30,13,2,0,15,0
S01009878,Rented or living rent free: Private rented or living rent free,66,55,39,14,25,9,7,11,3,4,2,2,0
S01009879,All HRPs aged 16 and over,332,260,170,19,151,84,6,72,60,5,4,1,2
S01009879,Owned: Total,298,236,152,16,136,80,4,62,56,4,0,1,1
S01009879,Owned: Owned outright,139,88,50,9,41,38,0,51,48,1,0,1,1
S01009879,Owned: Owned with a mortgage or loan or shared ownership,159,148,102,7,95,42,4,11,8,3,0,0,0
S01009879,Rented or living rent free: Total,34,24,18,3,15,4,2,10,4,1,4,0,1
S01009879,Rented or living rent free: Social rented,7,5,3,0,3,0,2,2,1,0,0,0,1
S01009879,Rented or living rent free: Private rented or living rent free,27,19,15,3,12,4,0,8,3,1,4,0,0
S01009880,All HRPs aged 16 and over,258,179,129,28,101,43,7,79,50,6,9,9,5
S01009880,Owned: Total,198,141,97,19,78,39,5,57,45,1,4,6,1
S01009880,Owned: Owned outright,86,41,25,6,19,14,2,45,36,1,4,4,0
S01009880,Owned: Owned with a mortgage or loan or shared ownership,112,100,72,13,59,25,3,12,9,0,0,2,1
S01009880,Rented or living rent free: Total,60,38,32,9,23,4,2,22,5,5,5,3,4
S01009880,Rented or living rent free: Social rented,8,3,2,1,1,0,1,5,1,0,1,3,0
S01009880,Rented or living rent free: Private rented or living rent free,52,35,30,8,22,4,1,17,4,5,4,0,4
S01009881,All HRPs aged 16 and over,179,141,101,31,70,27,13,38,14,2,4,7,11
S01009881,Owned: Total,93,80,59,18,41,17,4,13,8,1,1,1,2
S01009881,Owned: Owned outright,33,22,13,8,5,8,1,11,8,0,0,1,2
S01009881,Owned: Owned with a mortgage or loan or shared ownership,60,58,46,10,36,9,3,2,0,1,1,0,0
S01009881,Rented or living rent free: Total,86,61,42,13,29,10,9,25,6,1,3,6,9
S01009881,Rented or living rent free: Social rented,15,9,4,1,3,1,4,6,1,0,0,4,1
S01009881,Rented or living rent free: Private rented or living rent free,71,52,38,12,26,9,5,19,5,1,3,2,8
S01009882,All HRPs aged 16 and over,612,520,419,90,329,69,32,92,25,20,9,25,13
S01009882,Owned: Total,247,229,193,22,171,34,2,18,8,2,2,4,2
S01009882,Owned: Owned outright,39,24,19,7,12,5,0,15,7,2,0,4,2
S01009882,Owned: Owned with a mortgage or loan or shared ownership,208,205,174,15,159,29,2,3,1,0,2,0,0
S01009882,Rented or living rent free: Total,365,291,226,68,158,35,30,74,17,18,7,21,11
S01009882,Rented or living rent free: Social rented,61,33,23,14,9,4,6,28,8,3,1,11,5
S01009882,Rented or living rent free: Private rented or living rent free,304,258,203,54,149,31,24,46,9,15,6,10,6
S01009883,All HRPs aged 16 and over,280,216,151,46,105,39,26,64,21,10,15,10,8
S01009883,Owned: Total,154,127,94,19,75,25,8,27,15,3,1,5,3
S01009883,Owned: Owned outright,46,25,14,4,10,9,2,21,15,0,1,3,2
S01009883,Owned: Owned with a mortgage or loan or shared ownership,108,102,80,15,65,16,6,6,0,3,0,2,1
S01009883,Rented or living rent free: Total,126,89,57,27,30,14,18,37,6,7,14,5,5
S01009883,Rented or living rent free: Social rented,6,4,4,1,3,0,0,2,0,0,2,0,0
S01009883,Rented or living rent free: Private rented or living rent free,120,85,53,26,27,14,18,35,6,7,12,5,5
S01009884,All HRPs aged 16 and over,316,249,185,36,149,49,15,67,23,8,4,21,11
S01009884,Owned: Total,201,164,123,21,102,35,6,37,16,2,2,9,8
S01009884,Owned: Owned outright,54,32,18,7,11,12,2,22,13,0,1,4,4
S01009884,Owned: Owned with a mortgage or loan or shared ownership,147,132,105,14,91,23,4,15,3,2,1,5,4
S01009884,Rented or living rent free: Total,115,85,62,15,47,14,9,30,7,6,2,12,3
S01009884,Rented or living rent free: Social rented,27,13,10,4,6,1,2,14,4,2,0,6,2
S01009884,Rented or living rent free: Private rented or living rent free,88,72,52,11,41,13,7,16,3,4,2,6,1
S01009885,All HRPs aged 16 and over,251,196,135,38,97,53,8,55,24,5,9,10,7
S01009885,Owned: Total,181,156,104,28,76,46,6,25,15,1,0,7,2
S01009885,Owned: Owned outright,57,42,27,12,15,12,3,15,10,0,0,3,2
S01009885,Owned: Owned with a mortgage or loan or shared ownership,124,114,77,16,61,34,3,10,5,1,0,4,0
S01009885,Rented or living rent free: Total,70,40,31,10,21,7,2,30,9,4,9,3,5
S01009885,Rented or living rent free: Social rented,7,2,0,0,0,2,0,5,2,0,2,1,0
S01009885,Rented or living rent free: Private rented or living rent free,63,38,31,10,21,5,2,25,7,4,7,2,5
S01009886,All HRPs aged 16 and over,277,166,121,42,79,34,11,111,74,7,7,20,3
S01009886,Owned: Total,147,109,79,25,54,29,1,38,32,0,2,4,0
S01009886,Owned: Owned outright,61,36,27,12,15,9,0,25,24,0,0,1,0
S01009886,Owned: Owned with a mortgage or loan or shared ownership,86,73,52,13,39,20,1,13,8,0,2,3,0
S01009886,Rented or living rent free: Total,130,57,42,17,25,5,10,73,42,7,5,16,3
S01009886,Rented or living rent free: Social rented,57,11,9,6,3,0,2,46,30,0,4,12,0
S01009886,Rented or living rent free: Private rented or living rent free,73,46,33,11,22,5,8,27,12,7,1,4,3
S01009887,All HRPs aged 16 and over,490,324,235,58,177,36,53,166,54,35,11,47,19
S01009887,Owned: Total,122,100,86,15,71,10,4,22,15,2,0,4,1
S01009887,Owned: Owned outright,37,20,15,7,8,3,2,17,13,1,0,2,1
S01009887,Owned: Owned with a mortgage or loan or shared ownership,85,80,71,8,63,7,2,5,2,1,0,2,0
S01009887,Rented or living rent free: Total,368,224,149,43,106,26,49,144,39,33,11,43,18
S01009887,Rented or living rent free: Social rented,154,73,53,11,42,9,11,81,27,9,8,29,8
S01009887,Rented or living rent free: Private rented or living rent free,214,151,96,32,64,17,38,63,12,24,3,14,10
S01009888,All HRPs aged 16 and over,280,208,156,45,111,36,16,72,31,9,7,18,7
S01009888,Owned: Total,118,91,72,18,54,15,4,27,15,4,1,6,1
S01009888,Owned: Owned outright,35,16,14,6,8,2,0,19,15,1,0,3,0
S01009888,Owned: Owned with a mortgage or loan or shared ownership,83,75,58,12,46,13,4,8,0,3,1,3,1
S01009888,Rented or living rent free: Total,162,117,84,27,57,21,12,45,16,5,6,12,6
S01009888,Rented or living rent free: Social rented,30,19,10,1,9,1,8,11,5,0,0,4,2
S01009888,Rented or living rent free: Private rented or living rent free,132,98,74,26,48,20,4,34,11,5,6,8,4
S01009889,All HRPs aged 16 and over,370,219,172,33,139,33,14,151,66,15,16,42,12
S01009889,Owned: Total,157,107,86,10,76,20,1,50,40,0,1,4,5
S01009889,Owned: Owned outright,52,17,13,2,11,4,0,35,31,0,1,2,1
S01009889,Owned: Owned with a mortgage or loan or shared ownership,105,90,73,8,65,16,1,15,9,0,0,2,4
S01009889,Rented or living rent free: Total,213,112,86,23,63,13,13,101,26,15,15,38,7
S01009889,Rented or living rent free: Social rented,96,33,25,7,18,3,5,63,15,12,11,20,5
S01009889,Rented or living rent free: Private rented or living rent free,117,79,61,16,45,10,8,38,11,3,4,18,2
S01009890,All HRPs aged 16 and over,278,181,140,43,97,15,26,97,32,3,6,50,6
S01009890,Owned: Total,53,41,37,2,35,3,1,12,8,1,0,3,0
S01009890,Owned: Owned outright,15,7,7,1,6,0,0,8,8,0,0,0,0
S01009890,Owned: Owned with a mortgage or loan or shared ownership,38,34,30,1,29,3,1,4,0,1,0,3,0
S01009890,Rented or living rent free: Total,225,140,103,41,62,12,25,85,24,2,6,47,6
S01009890,Rented or living rent free: Social rented,167,100,70,34,36,11,19,67,18,2,6,39,2
S01009890,Rented or living rent free: Private rented or living rent free,58,40,33,7,26,1,6,18,6,0,0,8,4
S01009891,All HRPs aged 16 and over,430,265,202,33,169,31,32,165,92,11,6,45,11
S01009891,Owned: Total,163,107,89,10,79,13,5,56,41,0,1,12,2
S01009891,Owned: Owned outright,68,28,24,5,19,3,1,40,32,0,0,6,2
S01009891,Owned: Owned with a mortgage or loan or shared ownership,95,79,65,5,60,10,4,16,9,0,1,6,0
S01009891,Rented or living rent free: Total,267,158,113,23,90,18,27,109,51,11,5,33,9
S01009891,Rented or living rent free: Social rented,105,41,20,5,15,5,16,64,42,1,3,14,4
S01009891,Rented or living rent free: Private rented or living rent free,162,117,93,18,75,13,11,45,9,10,2,19,5
S01009892,All HRPs aged 16 and over,468,257,214,38,176,14,29,211,76,21,6,88,20
S01009892,Owned: Total,86,67,61,7,54,4,2,19,7,1,1,2,8
S01009892,Owned: Owned outright,27,12,11,3,8,1,0,15,6,1,0,0,8
S01009892,Owned: Owned with a mortgage or loan or shared ownership,59,55,50,4,46,3,2,4,1,0,1,2,0
S01009892,Rented or living rent free: Total,382,190,153,31,122,10,27,192,69,20,5,86,12
S01009892,Rented or living rent free: Social rented,295,134,107,23,84,7,20,161,65,5,5,77,9
S01009892,Rented or living rent free: Private rented or living rent free,87,56,46,8,38,3,7,31,4,15,0,9,3
S01009893,All HRPs aged 16 and over,420,314,253,38,215,32,29,106,45,17,10,26,8
S01009893,Owned: Total,195,154,134,13,121,14,6,41,28,0,1,6,6
S01009893,Owned: Owned outright,56,27,22,5,17,4,1,29,22,0,1,3,3
S01009893,Owned: Owned with a mortgage or loan or shared ownership,139,127,112,8,104,10,5,12,6,0,0,3,3
S01009893,Rented or living rent free: Total,225,160,119,25,94,18,23,65,17,17,9,20,2
S01009893,Rented or living rent free: Social rented,28,13,9,4,5,1,3,15,6,0,2,7,0
S01009893,Rented or living rent free: Private rented or living rent free,197,147,110,21,89,17,20,50,11,17,7,13,2
S01009894,All HRPs aged 16 and over,476,240,193,53,140,22,25,236,114,17,17,70,18
S01009894,Owned: Total,105,59,50,6,44,5,4,46,42,0,0,4,0
S01009894,Owned: Owned outright,52,16,13,0,13,0,3,36,34,0,0,2,0
S01009894,Owned: Owned with a mortgage or loan or shared ownership,53,43,37,6,31,5,1,10,8,0,0,2,0
S01009894,Rented or living rent free: Total,371,181,143,47,96,17,21,190,72,17,17,66,18
S01009894,Rented or living rent free: Social rented,296,135,109,34,75,9,17,161,67,10,12,60,12
S01009894,Rented or living rent free: Private rented or living rent free,75,46,34,13,21,8,4,29,5,7,5,6,6
S01009895,All HRPs aged 16 and over,408,229,177,48,129,17,35,179,64,17,9,77,12
S01009895,Owned: Total,73,59,52,6,46,7,0,14,8,2,2,2,0
S01009895,Owned: Owned outright,17,10,8,1,7,2,0,7,6,0,0,1,0
S01009895,Owned: Owned with a mortgage or loan or shared ownership,56,49,44,5,39,5,0,7,2,2,2,1,0
S01009895,Rented or living rent free: Total,335,170,125,42,83,10,35,165,56,15,7,75,12
S01009895,Rented or living rent free: Social rented,249,110,82,32,50,3,25,139,53,4,6,65,11
S01009895,Rented or living rent free: Private rented or living rent free,86,60,43,10,33,7,10,26,3,11,1,10,1
S01009896,All HRPs aged 16 and over,470,249,175,46,129,35,39,221,84,19,18,88,12
S01009896,Owned: Total,130,103,79,16,63,20,4,27,17,0,3,5,2
S01009896,Owned: Owned outright,33,17,14,5,9,3,0,16,10,0,2,3,1
S01009896,Owned: Owned with a mortgage or loan or shared ownership,97,86,65,11,54,17,4,11,7,0,1,2,1
S01009896,Rented or living rent free: Total,340,146,96,30,66,15,35,194,67,19,15,83,10
S01009896,Rented or living rent free: Social rented,287,114,76,27,49,8,30,173,63,7,14,81,8
S01009896,Rented or living rent free: Private rented or living rent free,53,32,20,3,17,7,5,21,4,12,1,2,2
S01009897,All HRPs aged 16 and over,497,279,214,40,174,37,28,218,143,10,8,43,14
S01009897,Owned: Total,286,167,141,21,120,21,5,119,99,2,3,6,9
S01009897,Owned: Owned outright,134,37,33,6,27,2,2,97,90,2,1,1,3
S01009897,Owned: Owned with a mortgage or loan or shared ownership,152,130,108,15,93,19,3,22,9,0,2,5,6
S01009897,Rented or living rent free: Total,211,112,73,19,54,16,23,99,44,8,5,37,5
S01009897,Rented or living rent free: Social rented,117,43,22,8,14,8,13,74,35,0,2,33,4
S01009897,Rented or living rent free: Private rented or living rent free,94,69,51,11,40,8,10,25,9,8,3,4,1
S01009898,All HRPs aged 16 and over,259,125,87,25,62,21,17,134,78,4,14,29,9
S01009898,Owned: Total,108,66,49,11,38,10,7,42,35,0,1,5,1
S01009898,Owned: Owned outright,56,27,20,6,14,3,4,29,25,0,1,2,1
S01009898,Owned: Owned with a mortgage or loan or shared ownership,52,39,29,5,24,7,3,13,10,0,0,3,0
S01009898,Rented or living rent free: Total,151,59,38,14,24,11,10,92,43,4,13,24,8
S01009898,Rented or living rent free: Social rented,118,38,25,11,14,6,7,80,39,2,11,21,7
S01009898,Rented or living rent free: Private rented or living rent free,33,21,13,3,10,5,3,12,4,2,2,3,1
S01009899,All HRPs aged 16 and over,464,336,288,38,250,27,21,128,75,8,5,33,7
S01009899,Owned: Total,284,215,190,15,175,18,7,69,55,1,1,9,3
S01009899,Owned: Owned outright,77,30,26,6,20,2,2,47,42,0,0,2,3
S01009899,Owned: Owned with a mortgage or loan or shared ownership,207,185,164,9,155,16,5,22,13,1,1,7,0
S01009899,Rented or living rent free: Total,180,121,98,23,75,9,14,59,20,7,4,24,4
S01009899,Rented or living rent free: Social rented,39,15,11,2,9,2,2,24,14,0,0,9,1
S01009899,Rented or living rent free: Private rented or living rent free,141,106,87,21,66,7,12,35,6,7,4,15,3
S01009900,All HRPs aged 16 and over,499,432,380,44,336,35,17,67,39,4,7,12,5
S01009900,Owned: Total,344,303,268,21,247,27,8,41,31,0,2,4,4
S01009900,Owned: Owned outright,82,50,41,7,34,5,4,32,26,0,1,3,2
S01009900,Owned: Owned with a mortgage or loan or shared ownership,262,253,227,14,213,22,4,9,5,0,1,1,2
S01009900,Rented or living rent free: Total,155,129,112,23,89,8,9,26,8,4,5,8,1
S01009900,Rented or living rent free: Social rented,10,5,4,2,2,0,1,5,5,0,0,0,0
S01009900,Rented or living rent free: Private rented or living rent free,145,124,108,21,87,8,8,21,3,4,5,8,1
S01009901,All HRPs aged 16 and over,456,388,335,32,303,38,15,68,48,2,9,6,3
S01009901,Owned: Total,280,243,216,18,198,25,2,37,35,0,1,0,1
S01009901,Owned: Owned outright,68,40,38,11,27,1,1,28,27,0,0,0,1
S01009901,Owned: Owned with a mortgage or loan or shared ownership,212,203,178,7,171,24,1,9,8,0,1,0,0
S01009901,Rented or living rent free: Total,176,145,119,14,105,13,13,31,13,2,8,6,2
S01009901,Rented or living rent free: Social rented,11,7,4,1,3,0,3,4,1,0,2,0,1
S01009901,Rented or living rent free: Private rented or living rent free,165,138,115,13,102,13,10,27,12,2,6,6,1
S01009902,All HRPs aged 16 and over,495,227,174,39,135,29,24,268,213,5,3,36,11
S01009902,Owned: Total,270,146,118,23,95,24,4,124,114,0,0,6,4
S01009902,Owned: Owned outright,140,40,32,9,23,5,3,100,92,0,0,5,3
S01009902,Owned: Owned with a mortgage or loan or shared ownership,130,106,86,14,72,19,1,24,22,0,0,1,1
S01009902,Rented or living rent free: Total,225,81,56,16,40,5,20,144,99,5,3,30,7
S01009902,Rented or living rent free: Social rented,153,34,24,8,16,0,10,119,88,0,1,24,6
S01009902,Rented or living rent free: Private rented or living rent free,72,47,32,8,24,5,10,25,11,5,2,6,1
S01009903,All HRPs aged 16 and over,272,227,172,27,145,48,7,45,24,1,9,9,2
S01009903,Owned: Total,193,164,124,19,105,39,1,29,17,0,4,7,1
S01009903,Owned: Owned outright,56,34,25,8,17,9,0,22,15,0,3,4,0
S01009903,Owned: Owned with a mortgage or loan or shared ownership,137,130,99,11,88,30,1,7,2,0,1,3,1
S01009903,Rented or living rent free: Total,79,63,48,8,40,9,6,16,7,1,5,2,1
S01009903,Rented or living rent free: Social rented,6,3,1,0,1,1,1,3,0,0,1,2,0
S01009903,Rented or living rent free: Private rented or living rent free,73,60,47,8,39,8,5,13,7,1,4,0,1
S01009904,All HRPs aged 16 and over,456,325,279,34,245,38,8,131,100,7,3,13,8
S01009904,Owned: Total,232,206,176,16,160,26,4,26,22,1,1,1,1
S01009904,Owned: Owned outright,59,42,35,9,26,4,3,17,17,0,0,0,0
S01009904,Owned: Owned with a mortgage or loan or shared ownership,173,164,141,7,134,22,1,9,5,1,1,1,1
S01009904,Rented or living rent free: Total,224,119,103,18,85,12,4,105,78,6,2,12,7
S01009904,Rented or living rent free: Social rented,86,11,10,5,5,1,0,75,67,0,0,3,5
S01009904,Rented or living rent free: Private rented or living rent free,138,108,93,13,80,11,4,30,11,6,2,9,2
S01009905,All HRPs aged 16 and over,372,284,217,41,176,34,33,88,37,19,8,18,6
S01009905,Owned: Total,183,150,119,17,102,22,9,33,26,2,0,5,0
S01009905,Owned: Owned outright,44,22,14,6,8,6,2,22,20,1,0,1,0
S01009905,Owned: Owned with a mortgage or loan or shared ownership,139,128,105,11,94,16,7,11,6,1,0,4,0
S01009905,Rented or living rent free: Total,189,134,98,24,74,12,24,55,11,17,8,13,6
S01009905,Rented or living rent free: Social rented,21,6,6,2,4,0,0,15,4,2,2,5,2
S01009905,Rented or living rent free: Private rented or living rent free,168,128,92,22,70,12,24,40,7,15,6,8,4
S01009906,All HRPs aged 16 and over,331,268,225,37,188,29,14,63,31,6,4,12,10
S01009906,Owned: Total,175,148,128,15,113,18,2,27,21,0,1,3,2
S01009906,Owned: Owned outright,50,30,24,7,17,5,1,20,17,0,0,1,2
S01009906,Owned: Owned with a mortgage or loan or shared ownership,125,118,104,8,96,13,1,7,4,0,1,2,0
S01009906,Rented or living rent free: Total,156,120,97,22,75,11,12,36,10,6,3,9,8
S01009906,Rented or living rent free: Social rented,25,13,11,4,7,0,2,12,1,1,2,5,3
S01009906,Rented or living rent free: Private rented or living rent free,131,107,86,18,68,11,10,24,9,5,1,4,5
S01009907,All HRPs aged 16 and over,592,404,306,50,256,36,62,188,43,70,4,52,19
S01009907,Owned: Total,192,165,144,10,134,14,7,27,17,0,1,7,2
S01009907,Owned: Owned outright,41,24,18,3,15,3,3,17,12,0,1,3,1
S01009907,Owned: Owned with a mortgage or loan or shared ownership,151,141,126,7,119,11,4,10,5,0,0,4,1
S01009907,Rented or living rent free: Total,400,239,162,40,122,22,55,161,26,70,3,45,17
S01009907,Rented or living rent free: Social rented,96,48,24,10,14,1,23,48,9,9,2,22,6
S01009907,Rented or living rent free: Private rented or living rent free,304,191,138,30,108,21,32,113,17,61,1,23,11
S01009908,All HRPs aged 16 and over,492,409,315,44,271,81,13,83,43,8,5,23,4
S01009908,Owned: Total,314,266,199,20,179,67,0,48,34,2,3,5,4
S01009908,Owned: Owned outright,99,59,43,5,38,16,0,40,29,2,2,3,4
S01009908,Owned: Owned with a mortgage or loan or shared ownership,215,207,156,15,141,51,0,8,5,0,1,2,0
S01009908,Rented or living rent free: Total,178,143,116,24,92,14,13,35,9,6,2,18,0
S01009908,Rented or living rent free: Social rented,31,9,7,4,3,0,2,22,3,5,1,13,0
S01009908,Rented or living rent free: Private rented or living rent free,147,134,109,20,89,14,11,13,6,1,1,5,0
S01009909,All HRPs aged 16 and over,471,372,287,34,253,62,23,99,48,21,5,21,4
S01009909,Owned: Total,243,206,166,9,157,32,8,37,29,0,1,6,1
S01009909,Owned: Owned outright,63,35,23,1,22,9,3,28,24,0,0,4,0
S01009909,Owned: Owned with a mortgage or loan or shared ownership,180,171,143,8,135,23,5,9,5,0,1,2,1
S01009909,Rented or living rent free: Total,228,166,121,25,96,30,15,62,19,21,4,15,3
S01009909,Rented or living rent free: Social rented,16,7,3,1,2,1,3,9,3,3,0,2,1
S01009909,Rented or living rent free: Private rented or living rent free,212,159,118,24,94,29,12,53,16,18,4,13,2
S01009910,All HRPs aged 16 and over,278,243,203,30,173,29,11,35,17,2,2,8,6
S01009910,Owned: Total,145,131,111,17,94,18,2,14,10,1,0,2,1
S01009910,Owned: Owned outright,31,23,19,6,13,2,2,8,8,0,0,0,0
S01009910,Owned: Owned with a mortgage or loan or shared ownership,114,108,92,11,81,16,0,6,2,1,0,2,1
S01009910,Rented or living rent free: Total,133,112,92,13,79,11,9,21,7,1,2,6,5
S01009910,Rented or living rent free: Social rented,5,3,1,1,0,2,0,2,1,0,0,0,1
S01009910,Rented or living rent free: Private rented or living rent free,128,109,91,12,79,9,9,19,6,1,2,6,4
S01009911,All HRPs aged 16 and over,415,314,252,29,223,45,17,101,83,3,3,8,4
S01009911,Owned: Total,332,248,206,21,185,37,5,84,74,2,2,4,2
S01009911,Owned: Owned outright,143,66,50,12,38,13,3,77,71,1,2,2,1
S01009911,Owned: Owned with a mortgage or loan or shared ownership,189,182,156,9,147,24,2,7,3,1,0,2,1
S01009911,Rented or living rent free: Total,83,66,46,8,38,8,12,17,9,1,1,4,2
S01009911,Rented or living rent free: Social rented,8,4,2,2,0,1,1,4,2,0,1,1,0
S01009911,Rented or living rent free: Private rented or living rent free,75,62,44,6,38,7,11,13,7,1,0,3,2
S01009912,All HRPs aged 16 and over,365,239,167,21,146,70,2,126,112,0,7,4,3
S01009912,Owned: Total,292,203,138,14,124,63,2,89,80,0,5,3,1
S01009912,Owned: Owned outright,145,70,42,8,34,26,2,75,74,0,0,1,0
S01009912,Owned: Owned with a mortgage or loan or shared ownership,147,133,96,6,90,37,0,14,6,0,5,2,1
S01009912,Rented or living rent free: Total,73,36,29,7,22,7,0,37,32,0,2,1,2
S01009912,Rented or living rent free: Social rented,36,3,2,0,2,1,0,33,30,0,1,0,2
S01009912,Rented or living rent free: Private rented or living rent free,37,33,27,7,20,6,0,4,2,0,1,1,0
S01009913,All HRPs aged 16 and over,232,182,116,16,100,66,0,50,38,0,5,3,4
S01009913,Owned: Total,185,142,81,11,70,61,0,43,36,0,5,0,2
S01009913,Owned: Owned outright,88,54,30,5,25,24,0,34,32,0,2,0,0
S01009913,Owned: Owned with a mortgage or loan or shared ownership,97,88,51,6,45,37,0,9,4,0,3,0,2
S01009913,Rented or living rent free: Total,47,40,35,5,30,5,0,7,2,0,0,3,2
S01009913,Rented or living rent free: Social rented,7,5,5,1,4,0,0,2,0,0,0,2,0
S01009913,Rented or living rent free: Private rented or living rent free,40,35,30,4,26,5,0,5,2,0,0,1,2
S01009914,All HRPs aged 16 and over,408,266,165,18,147,99,2,142,121,3,3,5,10
S01009914,Owned: Total,358,228,138,14,124,89,1,130,116,1,3,3,7
S01009914,Owned: Owned outright,200,87,55,10,45,32,0,113,105,0,2,1,5
S01009914,Owned: Owned with a mortgage or loan or shared ownership,158,141,83,4,79,57,1,17,11,1,1,2,2
S01009914,Rented or living rent free: Total,50,38,27,4,23,10,1,12,5,2,0,2,3
S01009914,Rented or living rent free: Social rented,6,4,2,0,2,2,0,2,0,0,0,1,1
S01009914,Rented or living rent free: Private rented or living rent free,44,34,25,4,21,8,1,10,5,2,0,1,2
S01009915,All HRPs aged 16 and over,402,287,213,32,181,66,8,115,95,3,6,8,3
S01009915,Owned: Total,347,248,183,27,156,59,6,99,90,2,3,1,3
S01009915,Owned: Owned outright,164,77,52,8,44,23,2,87,80,2,2,1,2
S01009915,Owned: Owned with a mortgage or loan or shared ownership,183,171,131,19,112,36,4,12,10,0,1,0,1
S01009915,Rented or living rent free: Total,55,39,30,5,25,7,2,16,5,1,3,7,0
S01009915,Rented or living rent free: Social rented,6,2,2,2,0,0,0,4,1,0,2,1,0
S01009915,Rented or living rent free: Private rented or living rent free,49,37,28,3,25,7,2,12,4,1,1,6,0
S01009916,All HRPs aged 16 and over,315,216,140,27,113,72,4,99,85,1,5,3,5
S01009916,Owned: Total,279,192,121,23,98,68,3,87,81,1,3,0,2
S01009916,Owned: Owned outright,143,66,33,10,23,30,3,77,75,0,2,0,0
S01009916,Owned: Owned with a mortgage or loan or shared ownership,136,126,88,13,75,38,0,10,6,1,1,0,2
S01009916,Rented or living rent free: Total,36,24,19,4,15,4,1,12,4,0,2,3,3
S01009916,Rented or living rent free: Social rented,6,2,1,1,0,1,0,4,0,0,1,2,1
S01009916,Rented or living rent free: Private rented or living rent free,30,22,18,3,15,3,1,8,4,0,1,1,2
S01009917,All HRPs aged 16 and over,331,237,195,17,178,37,5,94,79,2,3,6,4
S01009917,Owned: Total,269,189,161,11,150,25,3,80,73,2,1,3,1
S01009917,Owned: Owned outright,137,60,52,9,43,6,2,77,71,2,1,2,1
S01009917,Owned: Owned with a mortgage or loan or shared ownership,132,129,109,2,107,19,1,3,2,0,0,1,0
S01009917,Rented or living rent free: Total,62,48,34,6,28,12,2,14,6,0,2,3,3
S01009917,Rented or living rent free: Social rented,3,1,0,0,0,1,0,2,0,0,1,1,0
S01009917,Rented or living rent free: Private rented or living rent free,59,47,34,6,28,11,2,12,6,0,1,2,3
S01009918,All HRPs aged 16 and over,277,194,158,21,137,33,3,83,71,2,3,6,1
S01009918,Owned: Total,241,169,136,19,117,31,2,72,65,1,2,3,1
S01009918,Owned: Owned outright,114,51,40,7,33,10,1,63,58,1,2,1,1
S01009918,Owned: Owned with a mortgage or loan or shared ownership,127,118,96,12,84,21,1,9,7,0,0,2,0
S01009918,Rented or living rent free: Total,36,25,22,2,20,2,1,11,6,1,1,3,0
S01009918,Rented or living rent free: Social rented,11,5,4,1,3,1,0,6,4,0,1,1,0
S01009918,Rented or living rent free: Private rented or living rent free,25,20,18,1,17,1,1,5,2,1,0,2,0
S01009919,All HRPs aged 16 and over,587,380,297,49,248,52,31,207,149,18,6,23,11
S01009919,Owned: Total,267,165,136,15,121,24,5,102,90,0,0,7,5
S01009919,Owned: Owned outright,126,38,30,6,24,8,0,88,81,0,0,4,3
S01009919,Owned: Owned with a mortgage or loan or shared ownership,141,127,106,9,97,16,5,14,9,0,0,3,2
S01009919,Rented or living rent free: Total,320,215,161,34,127,28,26,105,59,18,6,16,6
S01009919,Rented or living rent free: Social rented,91,31,24,8,16,3,4,60,43,1,3,9,4
S01009919,Rented or living rent free: Private rented or living rent free,229,184,137,26,111,25,22,45,16,17,3,7,2
S01009920,All HRPs aged 16 and over,519,414,367,31,336,36,11,105,67,7,11,13,7
S01009920,Owned: Total,311,252,226,18,208,23,3,59,47,2,4,2,4
S01009920,Owned: Owned outright,96,47,42,7,35,5,0,49,40,1,4,1,3
S01009920,Owned: Owned with a mortgage or loan or shared ownership,215,205,184,11,173,18,3,10,7,1,0,1,1
S01009920,Rented or living rent free: Total,208,162,141,13,128,13,8,46,20,5,7,11,3
S01009920,Rented or living rent free: Social rented,15,6,5,0,5,1,0,9,6,0,1,2,0
S01009920,Rented or living rent free: Private rented or living rent free,193,156,136,13,123,12,8,37,14,5,6,9,3
S01009921,All HRPs aged 16 and over,398,331,287,31,256,33,11,67,40,10,5,6,6
S01009921,Owned: Total,236,194,167,14,153,23,4,42,29,3,1,5,4
S01009921,Owned: Owned outright,54,23,19,6,13,2,2,31,25,1,1,2,2
S01009921,Owned: Owned with a mortgage or loan or shared ownership,182,171,148,8,140,21,2,11,4,2,0,3,2
S01009921,Rented or living rent free: Total,162,137,120,17,103,10,7,25,11,7,4,1,2
S01009921,Rented or living rent free: Social rented,11,7,5,2,3,1,1,4,0,1,0,1,2
S01009921,Rented or living rent free: Private rented or living rent free,151,130,115,15,100,9,6,21,11,6,4,0,0
S01009922,All HRPs aged 16 and over,619,501,439,46,393,45,17,118,81,11,3,12,11
S01009922,Owned: Total,363,282,242,20,222,32,8,81,68,4,1,3,5
S01009922,Owned: Owned outright,130,62,51,12,39,11,0,68,60,1,0,3,4
S01009922,Owned: Owned with a mortgage or loan or shared ownership,233,220,191,8,183,21,8,13,8,3,1,0,1
S01009922,Rented or living rent free: Total,256,219,197,26,171,13,9,37,13,7,2,9,6
S01009922,Rented or living rent free: Social rented,5,1,0,0,0,0,1,4,2,0,0,1,1
S01009922,Rented or living rent free: Private rented or living rent free,251,218,197,26,171,13,8,33,11,7,2,8,5
S01009923,All HRPs aged 16 and over,566,395,325,36,289,47,23,171,113,14,8,30,6
S01009923,Owned: Total,348,237,201,14,187,29,7,111,89,4,2,12,4
S01009923,Owned: Owned outright,117,41,32,7,25,6,3,76,68,2,1,2,3
S01009923,Owned: Owned with a mortgage or loan or shared ownership,231,196,169,7,162,23,4,35,21,2,1,10,1
S01009923,Rented or living rent free: Total,218,158,124,22,102,18,16,60,24,10,6,18,2
S01009923,Rented or living rent free: Social rented,22,10,8,3,5,2,0,12,8,0,1,3,0
S01009923,Rented or living rent free: Private rented or living rent free,196,148,116,19,97,16,16,48,16,10,5,15,2
S01009924,All HRPs aged 16 and over,581,411,361,45,316,40,10,170,88,24,9,38,11
S01009924,Owned: Total,279,222,192,19,173,26,4,57,45,2,0,8,2
S01009924,Owned: Owned outright,75,32,26,2,24,5,1,43,37,2,0,3,1
S01009924,Owned: Owned with a mortgage or loan or shared ownership,204,190,166,17,149,21,3,14,8,0,0,5,1
S01009924,Rented or living rent free: Total,302,189,169,26,143,14,6,113,43,22,9,30,9
S01009924,Rented or living rent free: Social rented,68,19,18,7,11,0,1,49,19,10,1,13,6
S01009924,Rented or living rent free: Private rented or living rent free,234,170,151,19,132,14,5,64,24,12,8,17,3
S01009925,All HRPs aged 16 and over,408,342,302,32,270,21,19,66,29,12,6,15,4
S01009925,Owned: Total,211,179,163,15,148,14,2,32,20,4,1,5,2
S01009925,Owned: Owned outright,53,28,23,6,17,4,1,25,17,3,1,3,1
S01009925,Owned: Owned with a mortgage or loan or shared ownership,158,151,140,9,131,10,1,7,3,1,0,2,1
S01009925,Rented or living rent free: Total,197,163,139,17,122,7,17,34,9,8,5,10,2
S01009925,Rented or living rent free: Social rented,4,2,1,1,0,0,1,2,1,0,0,1,0
S01009925,Rented or living rent free: Private rented or living rent free,193,161,138,16,122,7,16,32,8,8,5,9,2
S01009926,All HRPs aged 16 and over,375,260,215,15,200,39,6,115,68,6,10,17,14
S01009926,Owned: Total,229,164,132,6,126,30,2,65,48,2,2,5,8
S01009926,Owned: Owned outright,77,28,25,1,24,3,0,49,41,0,0,1,7
S01009926,Owned: Owned with a mortgage or loan or shared ownership,152,136,107,5,102,27,2,16,7,2,2,4,1
S01009926,Rented or living rent free: Total,146,96,83,9,74,9,4,50,20,4,8,12,6
S01009926,Rented or living rent free: Social rented,24,5,5,2,3,0,0,19,15,1,0,2,1
S01009926,Rented or living rent free: Private rented or living rent free,122,91,78,7,71,9,4,31,5,3,8,10,5
S01009927,All HRPs aged 16 and over,278,177,137,17,120,28,12,101,66,5,3,20,7
S01009927,Owned: Total,173,115,95,8,87,19,1,58,45,3,2,8,0
S01009927,Owned: Owned outright,66,22,18,4,14,3,1,44,39,0,1,4,0
S01009927,Owned: Owned with a mortgage or loan or shared ownership,107,93,77,4,73,16,0,14,6,3,1,4,0
S01009927,Rented or living rent free: Total,105,62,42,9,33,9,11,43,21,2,1,12,7
S01009927,Rented or living rent free: Social rented,40,13,7,3,4,1,5,27,17,1,0,6,3
S01009927,Rented or living rent free: Private rented or living rent free,65,49,35,6,29,8,6,16,4,1,1,6,4
S01009928,All HRPs aged 16 and over,429,345,277,22,255,60,8,84,70,2,2,9,1
S01009928,Owned: Total,343,277,221,11,210,53,3,66,62,0,1,3,0
S01009928,Owned: Owned outright,115,60,46,7,39,12,2,55,52,0,1,2,0
S01009928,Owned: Owned with a mortgage or loan or shared ownership,228,217,175,4,171,41,1,11,10,0,0,1,0
S01009928,Rented or living rent free: Total,86,68,56,11,45,7,5,18,8,2,1,6,1
S01009928,Rented or living rent free: Social rented,2,1,1,0,1,0,0,1,0,0,0,1,0
S01009928,Rented or living rent free: Private rented or living rent free,84,67,55,11,44,7,5,17,8,2,1,5,1
S01009929,All HRPs aged 16 and over,234,162,127,9,118,31,4,72,67,0,1,3,1
S01009929,Owned: Total,184,120,95,7,88,25,0,64,60,0,0,3,1
S01009929,Owned: Owned outright,86,30,21,5,16,9,0,56,53,0,0,2,1
S01009929,Owned: Owned with a mortgage or loan or shared ownership,98,90,74,2,72,16,0,8,7,0,0,1,0
S01009929,Rented or living rent free: Total,50,42,32,2,30,6,4,8,7,0,1,0,0
S01009929,Rented or living rent free: Social rented,7,4,2,0,2,0,2,3,2,0,1,0,0
S01009929,Rented or living rent free: Private rented or living rent free,43,38,30,2,28,6,2,5,5,0,0,0,0
S01009930,All HRPs aged 16 and over,460,370,304,23,281,48,18,90,58,7,3,15,7
S01009930,Owned: Total,259,222,185,11,174,30,7,37,34,0,0,1,2
S01009930,Owned: Owned outright,65,33,24,4,20,7,2,32,30,0,0,0,2
S01009930,Owned: Owned with a mortgage or loan or shared ownership,194,189,161,7,154,23,5,5,4,0,0,1,0
S01009930,Rented or living rent free: Total,201,148,119,12,107,18,11,53,24,7,3,14,5
S01009930,Rented or living rent free: Social rented,31,12,10,1,9,1,1,19,13,0,2,3,1
S01009930,Rented or living rent free: Private rented or living rent free,170,136,109,11,98,17,10,34,11,7,1,11,4
S01009931,All HRPs aged 16 and over,463,396,347,28,319,38,11,67,39,10,6,9,3
S01009931,Owned: Total,325,284,246,19,227,32,6,41,31,2,1,4,3
S01009931,Owned: Owned outright,84,51,41,10,31,7,3,33,26,1,1,3,2
S01009931,Owned: Owned with a mortgage or loan or shared ownership,241,233,205,9,196,25,3,8,5,1,0,1,1
S01009931,Rented or living rent free: Total,138,112,101,9,92,6,5,26,8,8,5,5,0
S01009931,Rented or living rent free: Social rented,6,3,1,0,1,1,1,3,1,0,1,1,0
S01009931,Rented or living rent free: Private rented or living rent free,132,109,100,9,91,5,4,23,7,8,4,4,0
S01009932,All HRPs aged 16 and over,374,295,244,26,218,41,10,79,53,6,0,15,5
S01009932,Owned: Total,229,187,158,15,143,25,4,42,37,2,0,1,2
S01009932,Owned: Owned outright,70,38,32,5,27,6,0,32,29,0,0,1,2
S01009932,Owned: Owned with a mortgage or loan or shared ownership,159,149,126,10,116,19,4,10,8,2,0,0,0
S01009932,Rented or living rent free: Total,145,108,86,11,75,16,6,37,16,4,0,14,3
S01009932,Rented or living rent free: Social rented,36,13,7,2,5,2,4,23,15,0,0,8,0
S01009932,Rented or living rent free: Private rented or living rent free,109,95,79,9,70,14,2,14,1,4,0,6,3
S01009933,All HRPs aged 16 and over,534,332,255,42,213,19,58,202,84,17,13,58,30
S01009933,Owned: Total,115,92,78,6,72,7,7,23,13,1,1,3,5
S01009933,Owned: Owned outright,20,9,5,0,5,2,2,11,8,0,0,1,2
S01009933,Owned: Owned with a mortgage or loan or shared ownership,95,83,73,6,67,5,5,12,5,1,1,2,3
S01009933,Rented or living rent free: Total,419,240,177,36,141,12,51,179,71,16,12,55,25
S01009933,Rented or living rent free: Social rented,315,161,111,32,79,8,42,154,63,13,10,47,21
S01009933,Rented or living rent free: Private rented or living rent free,104,79,66,4,62,4,9,25,8,3,2,8,4
S01009934,All HRPs aged 16 and over,436,319,275,41,234,30,14,117,87,7,5,8,10
S01009934,Owned: Total,287,211,185,16,169,20,6,76,71,0,0,1,4
S01009934,Owned: Owned outright,106,44,36,8,28,3,5,62,59,0,0,0,3
S01009934,Owned: Owned with a mortgage or loan or shared ownership,181,167,149,8,141,17,1,14,12,0,0,1,1
S01009934,Rented or living rent free: Total,149,108,90,25,65,10,8,41,16,7,5,7,6
S01009934,Rented or living rent free: Social rented,31,12,8,4,4,1,3,19,10,2,2,4,1
S01009934,Rented or living rent free: Private rented or living rent free,118,96,82,21,61,9,5,22,6,5,3,3,5
S01009935,All HRPs aged 16 and over,386,146,113,21,92,10,23,240,156,2,7,60,15
S01009935,Owned: Total,102,52,47,5,42,3,2,50,47,0,0,3,0
S01009935,Owned: Owned outright,54,19,16,2,14,2,1,35,34,0,0,1,0
S01009935,Owned: Owned with a mortgage or loan or shared ownership,48,33,31,3,28,1,1,15,13,0,0,2,0
S01009935,Rented or living rent free: Total,284,94,66,16,50,7,21,190,109,2,7,57,15
S01009935,Rented or living rent free: Social rented,264,80,55,14,41,6,19,184,107,1,7,55,14
S01009935,Rented or living rent free: Private rented or living rent free,20,14,11,2,9,1,2,6,2,1,0,2,1
S01009936,All HRPs aged 16 and over,397,231,196,26,170,19,16,166,90,8,4,58,6
S01009936,Owned: Total,110,81,70,3,67,11,0,29,20,4,0,4,1
S01009936,Owned: Owned outright,31,14,9,1,8,5,0,17,14,2,0,0,1
S01009936,Owned: Owned with a mortgage or loan or shared ownership,79,67,61,2,59,6,0,12,6,2,0,4,0
S01009936,Rented or living rent free: Total,287,150,126,23,103,8,16,137,70,4,4,54,5
S01009936,Rented or living rent free: Social rented,238,109,88,20,68,6,15,129,67,2,4,51,5
S01009936,Rented or living rent free: Private rented or living rent free,49,41,38,3,35,2,1,8,3,2,0,3,0
S01009937,All HRPs aged 16 and over,266,116,77,35,42,8,31,150,88,8,13,31,10
S01009937,Owned: Total,27,20,14,6,8,5,1,7,7,0,0,0,0
S01009937,Owned: Owned outright,12,8,6,4,2,2,0,4,4,0,0,0,0
S01009937,Owned: Owned with a mortgage or loan or shared ownership,15,12,8,2,6,3,1,3,3,0,0,0,0
S01009937,Rented or living rent free: Total,239,96,63,29,34,3,30,143,81,8,13,31,10
S01009937,Rented or living rent free: Social rented,213,80,50,26,24,3,27,133,76,5,13,30,9
S01009937,Rented or living rent free: Private rented or living rent free,26,16,13,3,10,0,3,10,5,3,0,1,1
S01009938,All HRPs aged 16 and over,570,227,171,36,135,32,24,343,235,6,14,73,15
S01009938,Owned: Total,227,146,120,18,102,19,7,81,70,3,1,6,1
S01009938,Owned: Owned outright,78,24,13,6,7,6,5,54,52,0,0,1,1
S01009938,Owned: Owned with a mortgage or loan or shared ownership,149,122,107,12,95,13,2,27,18,3,1,5,0
S01009938,Rented or living rent free: Total,343,81,51,18,33,13,17,262,165,3,13,67,14
S01009938,Rented or living rent free: Social rented,300,59,37,12,25,7,15,241,162,3,4,61,11
S01009938,Rented or living rent free: Private rented or living rent free,43,22,14,6,8,6,2,21,3,0,9,6,3
S01009939,All HRPs aged 16 and over,521,258,145,48,97,9,104,263,44,45,44,84,46
S01009939,Owned: Total,20,12,6,1,5,5,1,8,3,1,2,2,0
S01009939,Owned: Owned outright,9,4,3,1,2,0,1,5,3,1,0,1,0
S01009939,Owned: Owned with a mortgage or loan or shared ownership,11,8,3,0,3,5,0,3,0,0,2,1,0
S01009939,Rented or living rent free: Total,501,246,139,47,92,4,103,255,41,44,42,82,46
S01009939,Rented or living rent free: Social rented,480,235,133,45,88,2,100,245,40,43,40,80,42
S01009939,Rented or living rent free: Private rented or living rent free,21,11,6,2,4,2,3,10,1,1,2,2,4
S01009940,All HRPs aged 16 and over,438,199,157,53,104,13,29,239,123,4,25,68,19
S01009940,Owned: Total,133,71,65,11,54,6,0,62,49,0,1,7,5
S01009940,Owned: Owned outright,62,18,16,2,14,2,0,44,39,0,0,2,3
S01009940,Owned: Owned with a mortgage or loan or shared ownership,71,53,49,9,40,4,0,18,10,0,1,5,2
S01009940,Rented or living rent free: Total,305,128,92,42,50,7,29,177,74,4,24,61,14
S01009940,Rented or living rent free: Social rented,283,116,85,38,47,7,24,167,72,4,19,58,14
S01009940,Rented or living rent free: Private rented or living rent free,22,12,7,4,3,0,5,10,2,0,5,3,0
S01009941,All HRPs aged 16 and over,320,263,204,42,162,48,11,57,33,4,7,6,7
S01009941,Owned: Total,274,235,183,32,151,42,10,39,30,0,2,4,3
S01009941,Owned: Owned outright,57,35,23,7,16,11,1,22,21,0,0,0,1
S01009941,Owned: Owned with a mortgage or loan or shared ownership,217,200,160,25,135,31,9,17,9,0,2,4,2
S01009941,Rented or living rent free: Total,46,28,21,10,11,6,1,18,3,4,5,2,4
S01009941,Rented or living rent free: Social rented,13,8,7,1,6,1,0,5,1,1,3,0,0
S01009941,Rented or living rent free: Private rented or living rent free,33,20,14,9,5,5,1,13,2,3,2,2,4
S01009942,All HRPs aged 16 and over,486,251,203,55,148,17,31,235,122,5,19,69,20
S01009942,Owned: Total,177,111,98,12,86,8,5,66,51,2,2,10,1
S01009942,Owned: Owned outright,71,28,22,8,14,4,2,43,36,1,0,6,0
S01009942,Owned: Owned with a mortgage or loan or shared ownership,106,83,76,4,72,4,3,23,15,1,2,4,1
S01009942,Rented or living rent free: Total,309,140,105,43,62,9,26,169,71,3,17,59,19
S01009942,Rented or living rent free: Social rented,271,119,89,31,58,6,24,152,70,1,13,50,18
S01009942,Rented or living rent free: Private rented or living rent free,38,21,16,12,4,3,2,17,1,2,4,9,1
S01009943,All HRPs aged 16 and over,424,195,153,44,109,16,26,229,117,6,23,61,22
S01009943,Owned: Total,135,72,61,9,52,7,4,63,50,2,0,7,4
S01009943,Owned: Owned outright,59,16,14,4,10,0,2,43,40,0,0,2,1
S01009943,Owned: Owned with a mortgage or loan or shared ownership,76,56,47,5,42,7,2,20,10,2,0,5,3
S01009943,Rented or living rent free: Total,289,123,92,35,57,9,22,166,67,4,23,54,18
S01009943,Rented or living rent free: Social rented,275,117,88,33,55,8,21,158,66,1,21,53,17
S01009943,Rented or living rent free: Private rented or living rent free,14,6,4,2,2,1,1,8,1,3,2,1,1
S01009944,All HRPs aged 16 and over,344,192,160,37,123,24,8,152,107,7,14,14,10
S01009944,Owned: Total,206,132,112,22,90,17,3,74,66,0,2,3,3
S01009944,Owned: Owned outright,84,32,24,11,13,5,3,52,51,0,0,1,0
S01009944,Owned: Owned with a mortgage or loan or shared ownership,122,100,88,11,77,12,0,22,15,0,2,2,3
S01009944,Rented or living rent free: Total,138,60,48,15,33,7,5,78,41,7,12,11,7
S01009944,Rented or living rent free: Social rented,84,29,22,12,10,5,2,55,37,1,4,9,4
S01009944,Rented or living rent free: Private rented or living rent free,54,31,26,3,23,2,3,23,4,6,8,2,3
S01009945,All HRPs aged 16 and over,500,265,216,51,165,20,29,235,148,10,20,45,12
S01009945,Owned: Total,229,141,122,13,109,14,5,88,78,1,4,4,1
S01009945,Owned: Owned outright,84,21,17,2,15,4,0,63,59,0,1,2,1
S01009945,Owned: Owned with a mortgage or loan or shared ownership,145,120,105,11,94,10,5,25,19,1,3,2,0
S01009945,Rented or living rent free: Total,271,124,94,38,56,6,24,147,70,9,16,41,11
S01009945,Rented or living rent free: Social rented,202,77,59,25,34,3,15,125,67,3,12,35,8
S01009945,Rented or living rent free: Private rented or living rent free,69,47,35,13,22,3,9,22,3,6,4,6,3
S01009946,All HRPs aged 16 and over,348,199,166,37,129,20,13,149,97,4,9,28,11
S01009946,Owned: Total,230,149,133,26,107,13,3,81,69,1,2,8,1
S01009946,Owned: Owned outright,91,30,25,9,16,4,1,61,56,1,0,4,0
S01009946,Owned: Owned with a mortgage or loan or shared ownership,139,119,108,17,91,9,2,20,13,0,2,4,1
S01009946,Rented or living rent free: Total,118,50,33,11,22,7,10,68,28,3,7,20,10
S01009946,Rented or living rent free: Social rented,85,31,21,10,11,3,7,54,28,1,6,14,5
S01009946,Rented or living rent free: Private rented or living rent free,33,19,12,1,11,4,3,14,0,2,1,6,5
S01009947,All HRPs aged 16 and over,266,150,120,23,97,20,10,116,91,3,5,15,2
S01009947,Owned: Total,161,103,88,13,75,14,1,58,54,1,2,1,0
S01009947,Owned: Owned outright,76,30,27,9,18,3,0,46,44,0,2,0,0
S01009947,Owned: Owned with a mortgage or loan or shared ownership,85,73,61,4,57,11,1,12,10,1,0,1,0
S01009947,Rented or living rent free: Total,105,47,32,10,22,6,9,58,37,2,3,14,2
S01009947,Rented or living rent free: Social rented,71,21,11,6,5,3,7,50,34,0,2,13,1
S01009947,Rented or living rent free: Private rented or living rent free,34,26,21,4,17,3,2,8,3,2,1,1,1
S01009948,All HRPs aged 16 and over,431,193,154,42,112,16,23,238,137,12,17,61,11
S01009948,Owned: Total,135,84,77,13,64,7,0,51,39,0,3,7,2
S01009948,Owned: Owned outright,59,17,17,5,12,0,0,42,33,0,3,5,1
S01009948,Owned: Owned with a mortgage or loan or shared ownership,76,67,60,8,52,7,0,9,6,0,0,2,1
S01009948,Rented or living rent free: Total,296,109,77,29,48,9,23,187,98,12,14,54,9
S01009948,Rented or living rent free: Social rented,279,98,68,27,41,9,21,181,96,12,12,52,9
S01009948,Rented or living rent free: Private rented or living rent free,17,11,9,2,7,0,2,6,2,0,2,2,0
S01009949,All HRPs aged 16 and over,368,200,165,38,127,18,17,168,122,5,10,23,8
S01009949,Owned: Total,238,136,117,20,97,14,5,102,87,1,2,8,4
S01009949,Owned: Owned outright,107,23,19,9,10,4,0,84,72,1,1,7,3
S01009949,Owned: Owned with a mortgage or loan or shared ownership,131,113,98,11,87,10,5,18,15,0,1,1,1
S01009949,Rented or living rent free: Total,130,64,48,18,30,4,12,66,35,4,8,15,4
S01009949,Rented or living rent free: Social rented,84,31,21,11,10,2,8,53,31,3,4,12,3
S01009949,Rented or living rent free: Private rented or living rent free,46,33,27,7,20,2,4,13,4,1,4,3,1
S01009950,All HRPs aged 16 and over,256,182,126,18,108,52,4,74,66,2,1,3,2
S01009950,Owned: Total,239,167,114,14,100,51,2,72,66,1,1,2,2
S01009950,Owned: Owned outright,106,44,26,4,22,18,0,62,60,0,1,1,0
S01009950,Owned: Owned with a mortgage or loan or shared ownership,133,123,88,10,78,33,2,10,6,1,0,1,2
S01009950,Rented or living rent free: Total,17,15,12,4,8,1,2,2,0,1,0,1,0
S01009950,Rented or living rent free: Social rented,3,2,2,2,0,0,0,1,0,1,0,0,0
S01009950,Rented or living rent free: Private rented or living rent free,14,13,10,2,8,1,2,1,0,0,0,1,0
S01009951,All HRPs aged 16 and over,259,195,114,8,106,77,4,64,56,0,2,3,3
S01009951,Owned: Total,237,178,102,7,95,73,3,59,55,0,1,1,2
S01009951,Owned: Owned outright,122,71,31,5,26,38,2,51,48,0,1,0,2
S01009951,Owned: Owned with a mortgage or loan or shared ownership,115,107,71,2,69,35,1,8,7,0,0,1,0
S01009951,Rented or living rent free: Total,22,17,12,1,11,4,1,5,1,0,1,2,1
S01009951,Rented or living rent free: Social rented,7,3,2,0,2,0,1,4,1,0,0,2,1
S01009951,Rented or living rent free: Private rented or living rent free,15,14,10,1,9,4,0,1,0,0,1,0,0
S01009952,All HRPs aged 16 and over,311,194,161,16,145,29,4,117,105,1,3,5,3
S01009952,Owned: Total,279,176,145,10,135,28,3,103,97,0,2,2,2
S01009952,Owned: Owned outright,147,54,41,6,35,11,2,93,88,0,2,1,2
S01009952,Owned: Owned with a mortgage or loan or shared ownership,132,122,104,4,100,17,1,10,9,0,0,1,0
S01009952,Rented or living rent free: Total,32,18,16,6,10,1,1,14,8,1,1,3,1
S01009952,Rented or living rent free: Social rented,9,3,2,1,1,0,1,6,4,0,1,1,0
S01009952,Rented or living rent free: Private rented or living rent free,23,15,14,5,9,1,0,8,4,1,0,2,1
S01009953,All HRPs aged 16 and over,358,241,192,36,156,42,7,117,101,1,1,11,3
S01009953,Owned: Total,302,203,162,28,134,37,4,99,92,0,0,5,2
S01009953,Owned: Owned outright,144,63,47,15,32,14,2,81,79,0,0,1,1
S01009953,Owned: Owned with a mortgage or loan or shared ownership,158,140,115,13,102,23,2,18,13,0,0,4,1
S01009953,Rented or living rent free: Total,56,38,30,8,22,5,3,18,9,1,1,6,1
S01009953,Rented or living rent free: Social rented,26,13,11,2,9,0,2,13,5,0,1,6,1
S01009953,Rented or living rent free: Private rented or living rent free,30,25,19,6,13,5,1,5,4,1,0,0,0
S01009954,All HRPs aged 16 and over,214,152,106,12,94,42,4,62,46,4,1,8,3
S01009954,Owned: Total,177,133,93,10,83,39,1,44,40,0,1,1,2
S01009954,Owned: Owned outright,74,36,26,3,23,10,0,38,37,0,0,0,1
S01009954,Owned: Owned with a mortgage or loan or shared ownership,103,97,67,7,60,29,1,6,3,0,1,1,1
S01009954,Rented or living rent free: Total,37,19,13,2,11,3,3,18,6,4,0,7,1
S01009954,Rented or living rent free: Social rented,10,2,2,0,2,0,0,8,3,0,0,5,0
S01009954,Rented or living rent free: Private rented or living rent free,27,17,11,2,9,3,3,10,3,4,0,2,1
S01009955,All HRPs aged 16 and over,447,272,222,28,194,38,12,175,129,2,7,32,5
S01009955,Owned: Total,331,213,172,19,153,38,3,118,101,2,2,10,3
S01009955,Owned: Owned outright,156,60,43,10,33,15,2,96,82,2,2,7,3
S01009955,Owned: Owned with a mortgage or loan or shared ownership,175,153,129,9,120,23,1,22,19,0,0,3,0
S01009955,Rented or living rent free: Total,116,59,50,9,41,0,9,57,28,0,5,22,2
S01009955,Rented or living rent free: Social rented,47,15,9,1,8,0,6,32,18,0,2,10,2
S01009955,Rented or living rent free: Private rented or living rent free,69,44,41,8,33,0,3,25,10,0,3,12,0
S01009956,All HRPs aged 16 and over,324,193,151,37,114,28,14,131,97,4,8,20,2
S01009956,Owned: Total,222,138,108,18,90,27,3,84,74,3,2,3,2
S01009956,Owned: Owned outright,113,45,36,8,28,8,1,68,63,2,0,2,1
S01009956,Owned: Owned with a mortgage or loan or shared ownership,109,93,72,10,62,19,2,16,11,1,2,1,1
S01009956,Rented or living rent free: Total,102,55,43,19,24,1,11,47,23,1,6,17,0
S01009956,Rented or living rent free: Social rented,49,17,11,4,7,0,6,32,19,0,3,10,0
S01009956,Rented or living rent free: Private rented or living rent free,53,38,32,15,17,1,5,15,4,1,3,7,0
S01009957,All HRPs aged 16 and over,294,207,149,17,132,55,3,87,84,0,0,2,1
S01009957,Owned: Total,268,186,130,14,116,54,2,82,82,0,0,0,0
S01009957,Owned: Owned outright,136,62,40,7,33,21,1,74,74,0,0,0,0
S01009957,Owned: Owned with a mortgage or loan or shared ownership,132,124,90,7,83,33,1,8,8,0,0,0,0
S01009957,Rented or living rent free: Total,26,21,19,3,16,1,1,5,2,0,0,2,1
S01009957,Rented or living rent free: Social rented,4,1,1,0,1,0,0,3,1,0,0,1,1
S01009957,Rented or living rent free: Private rented or living rent free,22,20,18,3,15,1,1,2,1,0,0,1,0
S01009958,All HRPs aged 16 and over,371,277,224,20,204,50,3,94,88,0,0,4,2
S01009958,Owned: Total,350,258,211,19,192,47,0,92,86,0,0,4,2
S01009958,Owned: Owned outright,151,69,51,8,43,18,0,82,79,0,0,3,0
S01009958,Owned: Owned with a mortgage or loan or shared ownership,199,189,160,11,149,29,0,10,7,0,0,1,2
S01009958,Rented or living rent free: Total,21,19,13,1,12,3,3,2,2,0,0,0,0
S01009958,Rented or living rent free: Social rented,4,4,2,0,2,0,2,0,0,0,0,0,0
S01009958,Rented or living rent free: Private rented or living rent free,17,15,11,1,10,3,1,2,2,0,0,0,0
S01009959,All HRPs aged 16 and over,288,160,111,16,95,45,4,128,116,3,1,5,3
S01009959,Owned: Total,259,144,101,15,86,43,0,115,107,2,1,3,2
S01009959,Owned: Owned outright,148,41,32,10,22,9,0,107,101,2,1,2,1
S01009959,Owned: Owned with a mortgage or loan or shared ownership,111,103,69,5,64,34,0,8,6,0,0,1,1
S01009959,Rented or living rent free: Total,29,16,10,1,9,2,4,13,9,1,0,2,1
S01009959,Rented or living rent free: Social rented,5,2,0,0,0,0,2,3,2,0,0,1,0
S01009959,Rented or living rent free: Private rented or living rent free,24,14,10,1,9,2,2,10,7,1,0,1,1
S01009960,All HRPs aged 16 and over,395,201,156,19,137,42,3,194,180,1,6,4,3
S01009960,Owned: Total,327,180,140,14,126,38,2,147,144,0,0,1,2
S01009960,Owned: Owned outright,187,50,33,10,23,16,1,137,134,0,0,1,2
S01009960,Owned: Owned with a mortgage or loan or shared ownership,140,130,107,4,103,22,1,10,10,0,0,0,0
S01009960,Rented or living rent free: Total,68,21,16,5,11,4,1,47,36,1,6,3,1
S01009960,Rented or living rent free: Social rented,25,1,1,0,1,0,0,24,22,0,0,1,1
S01009960,Rented or living rent free: Private rented or living rent free,43,20,15,5,10,4,1,23,14,1,6,2,0
S01009961,All HRPs aged 16 and over,293,166,128,26,102,33,5,127,105,4,3,10,5
S01009961,Owned: Total,226,139,107,20,87,31,1,87,81,0,1,2,3
S01009961,Owned: Owned outright,125,53,44,11,33,8,1,72,70,0,0,1,1
S01009961,Owned: Owned with a mortgage or loan or shared ownership,101,86,63,9,54,23,0,15,11,0,1,1,2
S01009961,Rented or living rent free: Total,67,27,21,6,15,2,4,40,24,4,2,8,2
S01009961,Rented or living rent free: Social rented,48,14,11,3,8,1,2,34,22,1,1,8,2
S01009961,Rented or living rent free: Private rented or living rent free,19,13,10,3,7,1,2,6,2,3,1,0,0
S01009962,All HRPs aged 16 and over,599,414,358,48,310,36,20,185,130,4,9,30,12
S01009962,Owned: Total,342,235,208,16,192,23,4,107,97,1,3,3,3
S01009962,Owned: Owned outright,141,49,39,8,31,9,1,92,86,0,3,1,2
S01009962,Owned: Owned with a mortgage or loan or shared ownership,201,186,169,8,161,14,3,15,11,1,0,2,1
S01009962,Rented or living rent free: Total,257,179,150,32,118,13,16,78,33,3,6,27,9
S01009962,Rented or living rent free: Social rented,72,37,25,4,21,4,8,35,17,1,1,16,0
S01009962,Rented or living rent free: Private rented or living rent free,185,142,125,28,97,9,8,43,16,2,5,11,9
S01009963,All HRPs aged 16 and over,301,203,168,19,149,33,2,98,90,2,2,2,2
S01009963,Owned: Total,283,191,158,18,140,32,1,92,86,1,2,1,2
S01009963,Owned: Owned outright,145,65,52,12,40,13,0,80,76,0,2,0,2
S01009963,Owned: Owned with a mortgage or loan or shared ownership,138,126,106,6,100,19,1,12,10,1,0,1,0
S01009963,Rented or living rent free: Total,18,12,10,1,9,1,1,6,4,1,0,1,0
S01009963,Rented or living rent free: Social rented,0,0,0,0,0,0,0,0,0,0,0,0,0
S01009963,Rented or living rent free: Private rented or living rent free,18,12,10,1,9,1,1,6,4,1,0,1,0
S01009964,All HRPs aged 16 and over,344,257,207,26,181,43,7,87,72,0,4,9,2
S01009964,Owned: Total,285,213,174,18,156,36,3,72,67,0,1,3,1
S01009964,Owned: Owned outright,124,58,46,11,35,9,3,66,63,0,0,2,1
S01009964,Owned: Owned with a mortgage or loan or shared ownership,161,155,128,7,121,27,0,6,4,0,1,1,0
S01009964,Rented or living rent free: Total,59,44,33,8,25,7,4,15,5,0,3,6,1
S01009964,Rented or living rent free: Social rented,9,3,2,1,1,1,0,6,3,0,0,2,1
S01009964,Rented or living rent free: Private rented or living rent free,50,41,31,7,24,6,4,9,2,0,3,4,0
S01009965,All HRPs aged 16 and over,298,189,156,23,133,31,2,109,100,1,2,6,0
S01009965,Owned: Total,260,179,151,21,130,28,0,81,78,1,1,1,0
S01009965,Owned: Owned outright,132,61,49,12,37,12,0,71,70,0,0,1,0
S01009965,Owned: Owned with a mortgage or loan or shared ownership,128,118,102,9,93,16,0,10,8,1,1,0,0
S01009965,Rented or living rent free: Total,38,10,5,2,3,3,2,28,22,0,1,5,0
S01009965,Rented or living rent free: Social rented,30,4,2,2,0,0,2,26,22,0,0,4,0
S01009965,Rented or living rent free: Private rented or living rent free,8,6,3,0,3,3,0,2,0,0,1,1,0
S01009966,All HRPs aged 16 and over,292,201,172,25,147,23,6,91,77,2,2,9,1
S01009966,Owned: Total,277,195,169,25,144,22,4,82,74,1,1,5,1
S01009966,Owned: Owned outright,128,59,50,15,35,8,1,69,67,1,0,1,0
S01009966,Owned: Owned with a mortgage or loan or shared ownership,149,136,119,10,109,14,3,13,7,0,1,4,1
S01009966,Rented or living rent free: Total,15,6,3,0,3,1,2,9,3,1,1,4,0
S01009966,Rented or living rent free: Social rented,3,0,0,0,0,0,0,3,1,0,0,2,0
S01009966,Rented or living rent free: Private rented or living rent free,12,6,3,0,3,1,2,6,2,1,1,2,0
S01009967,All HRPs aged 16 and over,383,258,214,32,182,42,2,125,118,3,0,1,3
S01009967,Owned: Total,338,228,188,24,164,39,1,110,105,2,0,0,3
S01009967,Owned: Owned outright,173,81,62,18,44,18,1,92,90,0,0,0,2
S01009967,Owned: Owned with a mortgage or loan or shared ownership,165,147,126,6,120,21,0,18,15,2,0,0,1
S01009967,Rented or living rent free: Total,45,30,26,8,18,3,1,15,13,1,0,1,0
S01009967,Rented or living rent free: Social rented,10,0,0,0,0,0,0,10,9,0,0,1,0
S01009967,Rented or living rent free: Private rented or living rent free,35,30,26,8,18,3,1,5,4,1,0,0,0
S01009968,All HRPs aged 16 and over,232,146,121,17,104,24,1,86,70,2,3,6,5
S01009968,Owned: Total,219,138,114,15,99,23,1,81,69,1,1,5,5
S01009968,Owned: Owned outright,108,40,30,8,22,10,0,68,60,1,1,1,5
S01009968,Owned: Owned with a mortgage or loan or shared ownership,111,98,84,7,77,13,1,13,9,0,0,4,0
S01009968,Rented or living rent free: Total,13,8,7,2,5,1,0,5,1,1,2,1,0
S01009968,Rented or living rent free: Social rented,5,2,1,0,1,1,0,3,1,1,1,0,0
S01009968,Rented or living rent free: Private rented or living rent free,8,6,6,2,4,0,0,2,0,0,1,1,0
S01009969,All HRPs aged 16 and over,364,216,164,14,150,46,6,148,124,4,3,11,6
S01009969,Owned: Total,309,189,144,12,132,41,4,120,104,2,2,7,5
S01009969,Owned: Owned outright,150,56,39,9,30,16,1,94,86,1,1,3,3
S01009969,Owned: Owned with a mortgage or loan or shared ownership,159,133,105,3,102,25,3,26,18,1,1,4,2
S01009969,Rented or living rent free: Total,55,27,20,2,18,5,2,28,20,2,1,4,1
S01009969,Rented or living rent free: Social rented,36,14,11,1,10,1,2,22,17,0,0,4,1
S01009969,Rented or living rent free: Private rented or living rent free,19,13,9,1,8,4,0,6,3,2,1,0,0
S01009970,All HRPs aged 16 and over,476,231,177,59,118,11,43,245,136,9,32,51,17
S01009970,Owned: Total,98,62,57,8,49,4,1,36,27,4,1,2,2
S01009970,Owned: Owned outright,40,11,11,2,9,0,0,29,24,1,0,2,2
S01009970,Owned: Owned with a mortgage or loan or shared ownership,58,51,46,6,40,4,1,7,3,3,1,0,0
S01009970,Rented or living rent free: Total,378,169,120,51,69,7,42,209,109,5,31,49,15
S01009970,Rented or living rent free: Social rented,348,150,105,44,61,6,39,198,105,3,28,48,14
S01009970,Rented or living rent free: Private rented or living rent free,30,19,15,7,8,1,3,11,4,2,3,1,1
S01009971,All HRPs aged 16 and over,488,299,227,51,176,33,39,189,88,2,20,64,15
S01009971,Owned: Total,152,134,111,14,97,19,4,18,16,0,1,1,0
S01009971,Owned: Owned outright,42,27,17,6,11,6,4,15,15,0,0,0,0
S01009971,Owned: Owned with a mortgage or loan or shared ownership,110,107,94,8,86,13,0,3,1,0,1,1,0
S01009971,Rented or living rent free: Total,336,165,116,37,79,14,35,171,72,2,19,63,15
S01009971,Rented or living rent free: Social rented,312,149,106,34,72,12,31,163,70,1,18,59,15
S01009971,Rented or living rent free: Private rented or living rent free,24,16,10,3,7,2,4,8,2,1,1,4,0
S01009972,All HRPs aged 16 and over,364,206,168,22,146,29,9,158,110,1,12,26,9
S01009972,Owned: Total,226,158,134,12,122,23,1,68,67,0,0,1,0
S01009972,Owned: Owned outright,85,21,17,4,13,4,0,64,64,0,0,0,0
S01009972,Owned: Owned with a mortgage or loan or shared ownership,141,137,117,8,109,19,1,4,3,0,0,1,0
S01009972,Rented or living rent free: Total,138,48,34,10,24,6,8,90,43,1,12,25,9
S01009972,Rented or living rent free: Social rented,119,39,27,8,19,4,8,80,43,1,5,23,8
S01009972,Rented or living rent free: Private rented or living rent free,19,9,7,2,5,2,0,10,0,0,7,2,1
S01009973,All HRPs aged 16 and over,283,196,166,34,132,19,11,87,38,3,7,28,11
S01009973,Owned: Total,145,131,115,16,99,15,1,14,9,0,0,2,3
S01009973,Owned: Owned outright,22,13,11,5,6,2,0,9,8,0,0,0,1
S01009973,Owned: Owned with a mortgage or loan or shared ownership,123,118,104,11,93,13,1,5,1,0,0,2,2
S01009973,Rented or living rent free: Total,138,65,51,18,33,4,10,73,29,3,7,26,8
S01009973,Rented or living rent free: Social rented,124,60,48,17,31,2,10,64,27,1,6,24,6
S01009973,Rented or living rent free: Private rented or living rent free,14,5,3,1,2,2,0,9,2,2,1,2,2
S01009974,All HRPs aged 16 and over,294,142,111,44,67,8,23,152,70,3,17,51,11
S01009974,Owned: Total,21,17,14,2,12,3,0,4,2,0,1,1,0
S01009974,Owned: Owned outright,7,4,3,1,2,1,0,3,2,0,1,0,0
S01009974,Owned: Owned with a mortgage or loan or shared ownership,14,13,11,1,10,2,0,1,0,0,0,1,0
S01009974,Rented or living rent free: Total,273,125,97,42,55,5,23,148,68,3,16,50,11
S01009974,Rented or living rent free: Social rented,268,122,96,41,55,5,21,146,67,3,15,50,11
S01009974,Rented or living rent free: Private rented or living rent free,5,3,1,1,0,0,2,2,1,0,1,0,0
S01009975,All HRPs aged 16 and over,398,147,108,42,66,11,28,251,109,2,29,93,18
S01009975,Owned: Total,34,27,24,5,19,2,1,7,6,0,0,1,0
S01009975,Owned: Owned outright,14,9,8,3,5,1,0,5,4,0,0,1,0
S01009975,Owned: Owned with a mortgage or loan or shared ownership,20,18,16,2,14,1,1,2,2,0,0,0,0
S01009975,Rented or living rent free: Total,364,120,84,37,47,9,27,244,103,2,29,92,18
S01009975,Rented or living rent free: Social rented,347,113,83,37,46,6,24,234,97,2,26,92,17
S01009975,Rented or living rent free: Private rented or living rent free,17,7,1,0,1,3,3,10,6,0,3,0,1
S01009976,All HRPs aged 16 and over,255,131,103,32,71,7,21,124,48,5,11,48,12
S01009976,Owned: Total,73,46,43,7,36,3,0,27,19,1,2,3,2
S01009976,Owned: Owned outright,21,7,7,3,4,0,0,14,14,0,0,0,0
S01009976,Owned: Owned with a mortgage or loan or shared ownership,52,39,36,4,32,3,0,13,5,1,2,3,2
S01009976,Rented or living rent free: Total,182,85,60,25,35,4,21,97,29,4,9,45,10
S01009976,Rented or living rent free: Social rented,169,80,57,25,32,4,19,89,29,4,8,39,9
S01009976,Rented or living rent free: Private rented or living rent free,13,5,3,0,3,0,2,8,0,0,1,6,1
S01009977,All HRPs aged 16 and over,555,203,145,53,92,6,52,352,173,8,17,129,25
S01009977,Owned: Total,57,40,37,10,27,2,1,17,12,1,0,3,1
S01009977,Owned: Owned outright,20,9,7,2,5,1,1,11,11,0,0,0,0
S01009977,Owned: Owned with a mortgage or loan or shared ownership,37,31,30,8,22,1,0,6,1,1,0,3,1
S01009977,Rented or living rent free: Total,498,163,108,43,65,4,51,335,161,7,17,126,24
S01009977,Rented or living rent free: Social rented,489,158,105,43,62,4,49,331,160,6,17,124,24
S01009977,Rented or living rent free: Private rented or living rent free,9,5,3,0,3,0,2,4,1,1,0,2,0
S01009978,All HRPs aged 16 and over,444,245,194,61,133,13,38,199,54,4,33,89,19
S01009978,Owned: Total,92,79,71,10,61,8,0,13,8,1,1,3,0
S01009978,Owned: Owned outright,15,9,8,3,5,1,0,6,4,0,0,2,0
S01009978,Owned: Owned with a mortgage or loan or shared ownership,77,70,63,7,56,7,0,7,4,1,1,1,0
S01009978,Rented or living rent free: Total,352,166,123,51,72,5,38,186,46,3,32,86,19
S01009978,Rented or living rent free: Social rented,335,156,117,47,70,4,35,179,46,2,30,84,17
S01009978,Rented or living rent free: Private rented or living rent free,17,10,6,4,2,1,3,7,0,1,2,2,2
S01009979,All HRPs aged 16 and over,258,120,98,33,65,4,18,138,78,2,8,44,6
S01009979,Owned: Total,39,28,26,4,22,2,0,11,9,0,0,2,0
S01009979,Owned: Owned outright,15,9,8,2,6,1,0,6,6,0,0,0,0
S01009979,Owned: Owned with a mortgage or loan or shared ownership,24,19,18,2,16,1,0,5,3,0,0,2,0
S01009979,Rented or living rent free: Total,219,92,72,29,43,2,18,127,69,2,8,42,6
S01009979,Rented or living rent free: Social rented,215,90,70,28,42,2,18,125,69,1,8,41,6
S01009979,Rented or living rent free: Private rented or living rent free,4,2,2,1,1,0,0,2,0,1,0,1,0
S01009980,All HRPs aged 16 and over,250,106,84,30,54,3,19,144,66,4,12,50,12
S01009980,Owned: Total,39,21,20,2,18,1,0,18,16,1,0,1,0
S01009980,Owned: Owned outright,16,2,2,0,2,0,0,14,14,0,0,0,0
S01009980,Owned: Owned with a mortgage or loan or shared ownership,23,19,18,2,16,1,0,4,2,1,0,1,0
S01009980,Rented or living rent free: Total,211,85,64,28,36,2,19,126,50,3,12,49,12
S01009980,Rented or living rent free: Social rented,198,80,60,25,35,2,18,118,49,1,9,48,11
S01009980,Rented or living rent free: Private rented or living rent free,13,5,4,3,1,0,1,8,1,2,3,1,1
S01009981,All HRPs aged 16 and over,303,159,126,44,82,9,24,144,67,4,12,49,12
S01009981,Owned: Total,44,36,32,4,28,3,1,8,3,2,0,3,0
S01009981,Owned: Owned outright,7,2,1,0,1,1,0,5,2,1,0,2,0
S01009981,Owned: Owned with a mortgage or loan or shared ownership,37,34,31,4,27,2,1,3,1,1,0,1,0
S01009981,Rented or living rent free: Total,259,123,94,40,54,6,23,136,64,2,12,46,12
S01009981,Rented or living rent free: Social rented,247,116,87,36,51,6,23,131,64,1,10,45,11
S01009981,Rented or living rent free: Private rented or living rent free,12,7,7,4,3,0,0,5,0,1,2,1,1
S01009982,All HRPs aged 16 and over,428,277,227,75,152,27,23,151,49,8,17,57,20
S01009982,Owned: Total,174,157,134,27,107,20,3,17,12,1,2,1,1
S01009982,Owned: Owned outright,29,17,13,5,8,2,2,12,11,0,0,0,1
S01009982,Owned: Owned with a mortgage or loan or shared ownership,145,140,121,22,99,18,1,5,1,1,2,1,0
S01009982,Rented or living rent free: Total,254,120,93,48,45,7,20,134,37,7,15,56,19
S01009982,Rented or living rent free: Social rented,230,105,80,41,39,7,18,125,36,5,14,54,16
S01009982,Rented or living rent free: Private rented or living rent free,24,15,13,7,6,0,2,9,1,2,1,2,3
S01009983,All HRPs aged 16 and over,289,164,123,48,75,6,35,125,28,6,25,48,18
S01009983,Owned: Total,7,5,4,0,4,0,1,2,1,0,1,0,0
S01009983,Owned: Owned outright,2,1,0,0,0,0,1,1,1,0,0,0,0
S01009983,Owned: Owned with a mortgage or loan or shared ownership,5,4,4,0,4,0,0,1,0,0,1,0,0
S01009983,Rented or living rent free: Total,282,159,119,48,71,6,34,123,27,6,24,48,18
S01009983,Rented or living rent free: Social rented,272,153,115,47,68,4,34,119,27,4,23,47,18
S01009983,Rented or living rent free: Private rented or living rent free,10,6,4,1,3,2,0,4,0,2,1,1,0
S01009984,All HRPs aged 16 and over,350,233,180,30,150,24,29,117,52,5,11,34,15
S01009984,Owned: Total,157,131,113,10,103,14,4,26,20,0,1,2,3
S01009984,Owned: Owned outright,27,8,5,1,4,1,2,19,17,0,0,1,1
S01009984,Owned: Owned with a mortgage or loan or shared ownership,130,123,108,9,99,13,2,7,3,0,1,1,2
S01009984,Rented or living rent free: Total,193,102,67,20,47,10,25,91,32,5,10,32,12
S01009984,Rented or living rent free: Social rented,170,85,55,17,38,8,22,85,31,1,9,32,12
S01009984,Rented or living rent free: Private rented or living rent free,23,17,12,3,9,2,3,6,1,4,1,0,0
S01009985,All HRPs aged 16 and over,270,156,116,30,86,8,32,114,30,4,21,46,13
S01009985,Owned: Total,25,21,19,1,18,2,0,4,2,0,0,1,1
S01009985,Owned: Owned outright,4,2,2,0,2,0,0,2,1,0,0,1,0
S01009985,Owned: Owned with a mortgage or loan or shared ownership,21,19,17,1,16,2,0,2,1,0,0,0,1
S01009985,Rented or living rent free: Total,245,135,97,29,68,6,32,110,28,4,21,45,12
S01009985,Rented or living rent free: Social rented,239,129,93,28,65,6,30,110,28,4,21,45,12
S01009985,Rented or living rent free: Private rented or living rent free,6,6,4,1,3,0,2,0,0,0,0,0,0
S01009986,All HRPs aged 16 and over,280,122,81,22,59,4,37,158,77,0,19,49,13
S01009986,Owned: Total,40,26,23,4,19,1,2,14,12,0,0,1,1
S01009986,Owned: Owned outright,20,7,6,2,4,0,1,13,12,0,0,0,1
S01009986,Owned: Owned with a mortgage or loan or shared ownership,20,19,17,2,15,1,1,1,0,0,0,1,0
S01009986,Rented or living rent free: Total,240,96,58,18,40,3,35,144,65,0,19,48,12
S01009986,Rented or living rent free: Social rented,229,88,55,18,37,3,30,141,65,0,17,48,11
S01009986,Rented or living rent free: Private rented or living rent free,11,8,3,0,3,0,5,3,0,0,2,0,1
S01009987,All HRPs aged 16 and over,472,208,178,46,132,12,18,264,197,0,12,44,11
S01009987,Owned: Total,146,99,93,13,80,5,1,47,37,0,0,7,3
S01009987,Owned: Owned outright,39,11,9,5,4,1,1,28,27,0,0,1,0
S01009987,Owned: Owned with a mortgage or loan or shared ownership,107,88,84,8,76,4,0,19,10,0,0,6,3
S01009987,Rented or living rent free: Total,326,109,85,33,52,7,17,217,160,0,12,37,8
S01009987,Rented or living rent free: Social rented,312,100,78,29,49,6,16,212,157,0,12,35,8
S01009987,Rented or living rent free: Private rented or living rent free,14,9,7,4,3,1,1,5,3,0,0,2,0
S01009988,All HRPs aged 16 and over,270,112,87,32,55,5,20,158,100,2,7,38,11
S01009988,Owned: Total,58,34,32,5,27,2,0,24,23,0,0,1,0
S01009988,Owned: Owned outright,29,10,10,2,8,0,0,19,18,0,0,1,0
S01009988,Owned: Owned with a mortgage or loan or shared ownership,29,24,22,3,19,2,0,5,5,0,0,0,0
S01009988,Rented or living rent free: Total,212,78,55,27,28,3,20,134,77,2,7,37,11
S01009988,Rented or living rent free: Social rented,202,71,50,25,25,3,18,131,77,2,7,36,9
S01009988,Rented or living rent free: Private rented or living rent free,10,7,5,2,3,0,2,3,0,0,0,1,2
S01009989,All HRPs aged 16 and over,354,230,195,34,161,22,13,124,83,2,5,27,7
S01009989,Owned: Total,244,171,148,15,133,20,3,73,59,1,0,11,2
S01009989,Owned: Owned outright,85,33,24,5,19,6,3,52,49,0,0,3,0
S01009989,Owned: Owned with a mortgage or loan or shared ownership,159,138,124,10,114,14,0,21,10,1,0,8,2
S01009989,Rented or living rent free: Total,110,59,47,19,28,2,10,51,24,1,5,16,5
S01009989,Rented or living rent free: Social rented,54,25,21,9,12,0,4,29,15,0,0,12,2
S01009989,Rented or living rent free: Private rented or living rent free,56,34,26,10,16,2,6,22,9,1,5,4,3
S01009990,All HRPs aged 16 and over,302,226,202,46,156,11,13,76,50,5,8,9,4
S01009990,Owned: Total,234,183,170,27,143,9,4,51,44,3,2,1,1
S01009990,Owned: Owned outright,78,31,29,9,20,2,0,47,43,2,1,0,1
S01009990,Owned: Owned with a mortgage or loan or shared ownership,156,152,141,18,123,7,4,4,1,1,1,1,0
S01009990,Rented or living rent free: Total,68,43,32,19,13,2,9,25,6,2,6,8,3
S01009990,Rented or living rent free: Social rented,3,2,2,1,1,0,0,1,1,0,0,0,0
S01009990,Rented or living rent free: Private rented or living rent free,65,41,30,18,12,2,9,24,5,2,6,8,3
S01009991,All HRPs aged 16 and over,333,257,224,35,189,19,14,76,45,5,11,10,5
S01009991,Owned: Total,255,207,190,23,167,16,1,48,41,2,0,3,2
S01009991,Owned: Owned outright,64,27,25,6,19,1,1,37,35,0,0,1,1
S01009991,Owned: Owned with a mortgage or loan or shared ownership,191,180,165,17,148,15,0,11,6,2,0,2,1
S01009991,Rented or living rent free: Total,78,50,34,12,22,3,13,28,4,3,11,7,3
S01009991,Rented or living rent free: Social rented,3,1,1,0,1,0,0,2,2,0,0,0,0
S01009991,Rented or living rent free: Private rented or living rent free,75,49,33,12,21,3,13,26,2,3,11,7,3
S01009992,All HRPs aged 16 and over,330,152,117,34,83,11,24,178,114,3,10,39,12
S01009992,Owned: Total,87,52,45,9,36,5,2,35,27,1,0,4,3
S01009992,Owned: Owned outright,28,11,10,2,8,1,0,17,15,1,0,1,0
S01009992,Owned: Owned with a mortgage or loan or shared ownership,59,41,35,7,28,4,2,18,12,0,0,3,3
S01009992,Rented or living rent free: Total,243,100,72,25,47,6,22,143,87,2,10,35,9
S01009992,Rented or living rent free: Social rented,225,91,67,25,42,6,18,134,85,1,6,33,9
S01009992,Rented or living rent free: Private rented or living rent free,18,9,5,0,5,0,4,9,2,1,4,2,0
S01009993,All HRPs aged 16 and over,349,264,225,39,186,28,11,85,58,6,5,13,3
S01009993,Owned: Total,277,217,188,26,162,25,4,60,54,0,1,3,2
S01009993,Owned: Owned outright,85,36,33,11,22,2,1,49,47,0,1,1,0
S01009993,Owned: Owned with a mortgage or loan or shared ownership,192,181,155,15,140,23,3,11,7,0,0,2,2
S01009993,Rented or living rent free: Total,72,47,37,13,24,3,7,25,4,6,4,10,1
S01009993,Rented or living rent free: Social rented,2,1,0,0,0,0,1,1,0,0,0,0,1
S01009993,Rented or living rent free: Private rented or living rent free,70,46,37,13,24,3,6,24,4,6,4,10,0
S01009994,All HRPs aged 16 and over,302,225,193,32,161,24,8,77,42,3,14,13,5
S01009994,Owned: Total,232,189,165,19,146,20,4,43,38,0,1,2,2
S01009994,Owned: Owned outright,67,33,31,9,22,2,0,34,31,0,0,2,1
S01009994,Owned: Owned with a mortgage or loan or shared ownership,165,156,134,10,124,18,4,9,7,0,1,0,1
S01009994,Rented or living rent free: Total,70,36,28,13,15,4,4,34,4,3,13,11,3
S01009994,Rented or living rent free: Social rented,2,0,0,0,0,0,0,2,0,0,1,0,1
S01009994,Rented or living rent free: Private rented or living rent free,68,36,28,13,15,4,4,32,4,3,12,11,2
S01009995,All HRPs aged 16 and over,269,200,176,28,148,19,5,69,43,1,7,13,5
S01009995,Owned: Total,207,160,144,19,125,14,2,47,38,0,1,7,1
S01009995,Owned: Owned outright,64,28,22,5,17,5,1,36,31,0,1,3,1
S01009995,Owned: Owned with a mortgage or loan or shared ownership,143,132,122,14,108,9,1,11,7,0,0,4,0
S01009995,Rented or living rent free: Total,62,40,32,9,23,5,3,22,5,1,6,6,4
S01009995,Rented or living rent free: Social rented,1,1,1,0,1,0,0,0,0,0,0,0,0
S01009995,Rented or living rent free: Private rented or living rent free,61,39,31,9,22,5,3,22,5,1,6,6,4
S01009996,All HRPs aged 16 and over,310,212,182,39,143,18,12,98,57,3,13,17,8
S01009996,Owned: Total,202,166,146,20,126,15,5,36,30,1,1,4,0
S01009996,Owned: Owned outright,61,32,24,4,20,5,3,29,26,0,0,3,0
S01009996,Owned: Owned with a mortgage or loan or shared ownership,141,134,122,16,106,10,2,7,4,1,1,1,0
S01009996,Rented or living rent free: Total,108,46,36,19,17,3,7,62,27,2,12,13,8
S01009996,Rented or living rent free: Social rented,27,4,4,1,3,0,0,23,19,0,0,3,1
S01009996,Rented or living rent free: Private rented or living rent free,81,42,32,18,14,3,7,39,8,2,12,10,7
S01009997,All HRPs aged 16 and over,251,190,164,27,137,16,10,61,40,2,3,11,5
S01009997,Owned: Total,196,154,134,21,113,14,6,42,34,1,0,4,3
S01009997,Owned: Owned outright,67,33,27,7,20,3,3,34,29,0,0,2,3
S01009997,Owned: Owned with a mortgage or loan or shared ownership,129,121,107,14,93,11,3,8,5,1,0,2,0
S01009997,Rented or living rent free: Total,55,36,30,6,24,2,4,19,6,1,3,7,2
S01009997,Rented or living rent free: Social rented,3,1,1,0,1,0,0,2,1,0,0,1,0
S01009997,Rented or living rent free: Private rented or living rent free,52,35,29,6,23,2,4,17,5,1,3,6,2
S01009998,All HRPs aged 16 and over,246,149,114,14,100,34,1,97,84,2,2,5,4
S01009998,Owned: Total,214,129,94,11,83,34,1,85,80,1,0,2,2
S01009998,Owned: Owned outright,125,47,35,6,29,12,0,78,75,0,0,2,1
S01009998,Owned: Owned with a mortgage or loan or shared ownership,89,82,59,5,54,22,1,7,5,1,0,0,1
S01009998,Rented or living rent free: Total,32,20,20,3,17,0,0,12,4,1,2,3,2
S01009998,Rented or living rent free: Social rented,9,3,3,1,2,0,0,6,2,0,1,2,1
S01009998,Rented or living rent free: Private rented or living rent free,23,17,17,2,15,0,0,6,2,1,1,1,1
S01009999,All HRPs aged 16 and over,285,180,156,20,136,19,5,105,86,2,4,10,3
S01009999,Owned: Total,250,161,141,17,124,17,3,89,84,0,0,3,2
S01009999,Owned: Owned outright,124,46,39,8,31,6,1,78,76,0,0,1,1
S01009999,Owned: Owned with a mortgage or loan or shared ownership,126,115,102,9,93,11,2,11,8,0,0,2,1
S01009999,Rented or living rent free: Total,35,19,15,3,12,2,2,16,2,2,4,7,1
S01009999,Rented or living rent free: Social rented,3,3,3,2,1,0,0,0,0,0,0,0,0
S01009999,Rented or living rent free: Private rented or living rent free,32,16,12,1,11,2,2,16,2,2,4,7,1
S01010000,All HRPs aged 16 and over,269,212,182,29,153,19,11,57,38,3,6,8,2
S01010000,Owned: Total,202,164,144,15,129,16,4,38,31,2,1,3,1
S01010000,Owned: Owned outright,56,30,27,3,24,2,1,26,23,0,1,1,1
S01010000,Owned: Owned with a mortgage or loan or shared ownership,146,134,117,12,105,14,3,12,8,2,0,2,0
S01010000,Rented or living rent free: Total,67,48,38,14,24,3,7,19,7,1,5,5,1
S01010000,Rented or living rent free: Social rented,4,2,2,2,0,0,0,2,2,0,0,0,0
S01010000,Rented or living rent free: Private rented or living rent free,63,46,36,12,24,3,7,17,5,1,5,5,1
S01010001,All HRPs aged 16 and over,332,218,183,28,155,21,14,114,75,2,13,20,4
S01010001,Owned: Total,220,176,153,16,137,20,3,44,38,2,0,3,1
S01010001,Owned: Owned outright,64,26,24,1,23,1,1,38,37,0,0,1,0
S01010001,Owned: Owned with a mortgage or loan or shared ownership,156,150,129,15,114,19,2,6,1,2,0,2,1
S01010001,Rented or living rent free: Total,112,42,30,12,18,1,11,70,37,0,13,17,3
S01010001,Rented or living rent free: Social rented,31,3,3,2,1,0,0,28,26,0,0,1,1
S01010001,Rented or living rent free: Private rented or living rent free,81,39,27,10,17,1,11,42,11,0,13,16,2
S01010002,All HRPs aged 16 and over,336,240,207,51,156,22,11,96,66,3,9,13,5
S01010002,Owned: Total,259,196,173,31,142,19,4,63,52,2,2,6,1
S01010002,Owned: Owned outright,95,48,39,13,26,6,3,47,43,1,1,2,0
S01010002,Owned: Owned with a mortgage or loan or shared ownership,164,148,134,18,116,13,1,16,9,1,1,4,1
S01010002,Rented or living rent free: Total,77,44,34,20,14,3,7,33,14,1,7,7,4
S01010002,Rented or living rent free: Social rented,10,4,2,1,1,1,1,6,3,0,1,2,0
S01010002,Rented or living rent free: Private rented or living rent free,67,40,32,19,13,2,6,27,11,1,6,5,4
S01010003,All HRPs aged 16 and over,279,197,174,22,152,18,5,82,62,1,4,10,5
S01010003,Owned: Total,253,185,166,17,149,16,3,68,59,1,0,4,4
S01010003,Owned: Owned outright,115,57,48,8,40,6,3,58,51,0,0,3,4
S01010003,Owned: Owned with a mortgage or loan or shared ownership,138,128,118,9,109,10,0,10,8,1,0,1,0
S01010003,Rented or living rent free: Total,26,12,8,5,3,2,2,14,3,0,4,6,1
S01010003,Rented or living rent free: Social rented,8,2,2,1,1,0,0,6,2,0,1,2,1
S01010003,Rented or living rent free: Private rented or living rent free,18,10,6,4,2,2,2,8,1,0,3,4,0
S01010004,All HRPs aged 16 and over,273,174,141,18,123,24,9,99,89,3,1,4,2
S01010004,Owned: Total,255,162,133,16,117,23,6,93,87,3,0,1,2
S01010004,Owned: Owned outright,140,59,50,11,39,8,1,81,76,3,0,1,1
S01010004,Owned: Owned with a mortgage or loan or shared ownership,115,103,83,5,78,15,5,12,11,0,0,0,1
S01010004,Rented or living rent free: Total,18,12,8,2,6,1,3,6,2,0,1,3,0
S01010004,Rented or living rent free: Social rented,6,4,1,0,1,0,3,2,1,0,0,1,0
S01010004,Rented or living rent free: Private rented or living rent free,12,8,7,2,5,1,0,4,1,0,1,2,0
S01010005,All HRPs aged 16 and over,488,337,277,33,244,23,37,151,95,8,6,32,10
S01010005,Owned: Total,262,189,172,13,159,10,7,73,63,0,0,8,2
S01010005,Owned: Owned outright,91,33,30,7,23,2,1,58,50,0,0,7,1
S01010005,Owned: Owned with a mortgage or loan or shared ownership,171,156,142,6,136,8,6,15,13,0,0,1,1
S01010005,Rented or living rent free: Total,226,148,105,20,85,13,30,78,32,8,6,24,8
S01010005,Rented or living rent free: Social rented,85,47,34,11,23,6,7,38,18,1,2,13,4
S01010005,Rented or living rent free: Private rented or living rent free,141,101,71,9,62,7,23,40,14,7,4,11,4
S01010006,All HRPs aged 16 and over,586,410,362,34,328,19,29,176,122,6,8,30,10
S01010006,Owned: Total,350,257,239,15,224,11,7,93,79,1,0,9,4
S01010006,Owned: Owned outright,125,56,51,6,45,1,4,69,66,0,0,1,2
S01010006,Owned: Owned with a mortgage or loan or shared ownership,225,201,188,9,179,10,3,24,13,1,0,8,2
S01010006,Rented or living rent free: Total,236,153,123,19,104,8,22,83,43,5,8,21,6
S01010006,Rented or living rent free: Social rented,79,28,13,5,8,1,14,51,31,0,4,15,1
S01010006,Rented or living rent free: Private rented or living rent free,157,125,110,14,96,7,8,32,12,5,4,6,5
S01010007,All HRPs aged 16 and over,429,303,260,29,231,30,13,126,106,3,3,8,6
S01010007,Owned: Total,356,247,220,19,201,23,4,109,100,1,1,5,2
S01010007,Owned: Owned outright,155,60,54,8,46,3,3,95,90,0,1,4,0
S01010007,Owned: Owned with a mortgage or loan or shared ownership,201,187,166,11,155,20,1,14,10,1,0,1,2
S01010007,Rented or living rent free: Total,73,56,40,10,30,7,9,17,6,2,2,3,4
S01010007,Rented or living rent free: Social rented,7,5,3,0,3,1,1,2,1,0,0,0,1
S01010007,Rented or living rent free: Private rented or living rent free,66,51,37,10,27,6,8,15,5,2,2,3,3
S01010008,All HRPs aged 16 and over,410,301,260,25,235,27,14,109,71,5,5,23,5
S01010008,Owned: Total,203,163,149,3,146,14,0,40,37,1,0,2,0
S01010008,Owned: Owned outright,62,26,19,2,17,7,0,36,34,0,0,2,0
S01010008,Owned: Owned with a mortgage or loan or shared ownership,141,137,130,1,129,7,0,4,3,1,0,0,0
S01010008,Rented or living rent free: Total,207,138,111,22,89,13,14,69,34,4,5,21,5
S01010008,Rented or living rent free: Social rented,79,37,29,12,17,4,4,42,24,2,2,11,3
S01010008,Rented or living rent free: Private rented or living rent free,128,101,82,10,72,9,10,27,10,2,3,10,2
S01010009,All HRPs aged 16 and over,416,335,282,33,249,26,27,81,32,2,4,37,6
S01010009,Owned: Total,202,185,164,9,155,15,6,17,10,1,0,6,0
S01010009,Owned: Owned outright,32,19,15,0,15,3,1,13,9,1,0,3,0
S01010009,Owned: Owned with a mortgage or loan or shared ownership,170,166,149,9,140,12,5,4,1,0,0,3,0
S01010009,Rented or living rent free: Total,214,150,118,24,94,11,21,64,22,1,4,31,6
S01010009,Rented or living rent free: Social rented,55,23,18,10,8,2,3,32,17,0,1,12,2
S01010009,Rented or living rent free: Private rented or living rent free,159,127,100,14,86,9,18,32,5,1,3,19,4
S01010010,All HRPs aged 16 and over,451,318,256,29,227,53,9,133,111,3,3,13,3
S01010010,Owned: Total,381,266,217,25,192,43,6,115,106,0,1,7,1
S01010010,Owned: Owned outright,163,65,52,10,42,11,2,98,95,0,1,2,0
S01010010,Owned: Owned with a mortgage or loan or shared ownership,218,201,165,15,150,32,4,17,11,0,0,5,1
S01010010,Rented or living rent free: Total,70,52,39,4,35,10,3,18,5,3,2,6,2
S01010010,Rented or living rent free: Social rented,15,8,5,0,5,1,2,7,2,0,0,4,1
S01010010,Rented or living rent free: Private rented or living rent free,55,44,34,4,30,9,1,11,3,3,2,2,1
S01010011,All HRPs aged 16 and over,544,312,267,32,235,19,26,232,169,9,6,34,14
S01010011,Owned: Total,235,178,161,11,150,13,4,57,42,6,3,2,4
S01010011,Owned: Owned outright,76,28,21,5,16,4,3,48,39,4,2,1,2
S01010011,Owned: Owned with a mortgage or loan or shared ownership,159,150,140,6,134,9,1,9,3,2,1,1,2
S01010011,Rented or living rent free: Total,309,134,106,21,85,6,22,175,127,3,3,32,10
S01010011,Rented or living rent free: Social rented,194,34,22,9,13,2,10,160,124,3,1,26,6
S01010011,Rented or living rent free: Private rented or living rent free,115,100,84,12,72,4,12,15,3,0,2,6,4
S01010012,All HRPs aged 16 and over,348,217,182,33,149,29,6,131,105,2,5,15,4
S01010012,Owned: Total,305,195,167,27,140,26,2,110,100,1,0,9,0
S01010012,Owned: Owned outright,152,56,49,12,37,7,0,96,89,0,0,7,0
S01010012,Owned: Owned with a mortgage or loan or shared ownership,153,139,118,15,103,19,2,14,11,1,0,2,0
S01010012,Rented or living rent free: Total,43,22,15,6,9,3,4,21,5,1,5,6,4
S01010012,Rented or living rent free: Social rented,6,3,3,2,1,0,0,3,1,0,2,0,0
S01010012,Rented or living rent free: Private rented or living rent free,37,19,12,4,8,3,4,18,4,1,3,6,4
S01010013,All HRPs aged 16 and over,457,344,288,34,254,27,29,113,74,4,3,28,4
S01010013,Owned: Total,244,202,183,15,168,14,5,42,39,1,0,0,2
S01010013,Owned: Owned outright,74,41,36,4,32,3,2,33,33,0,0,0,0
S01010013,Owned: Owned with a mortgage or loan or shared ownership,170,161,147,11,136,11,3,9,6,1,0,0,2
S01010013,Rented or living rent free: Total,213,142,105,19,86,13,24,71,35,3,3,28,2
S01010013,Rented or living rent free: Social rented,34,13,8,0,8,2,3,21,7,2,0,10,2
S01010013,Rented or living rent free: Private rented or living rent free,179,129,97,19,78,11,21,50,28,1,3,18,0
S01010014,All HRPs aged 16 and over,523,365,284,29,255,61,20,158,96,11,4,41,6
S01010014,Owned: Total,366,284,228,21,207,52,4,82,70,2,1,7,2
S01010014,Owned: Owned outright,134,62,46,11,35,14,2,72,66,2,0,3,1
S01010014,Owned: Owned with a mortgage or loan or shared ownership,232,222,182,10,172,38,2,10,4,0,1,4,1
S01010014,Rented or living rent free: Total,157,81,56,8,48,9,16,76,26,9,3,34,4
S01010014,Rented or living rent free: Social rented,80,26,12,3,9,2,12,54,19,5,0,28,2
S01010014,Rented or living rent free: Private rented or living rent free,77,55,44,5,39,7,4,22,7,4,3,6,2
S01010015,All HRPs aged 16 and over,392,331,267,34,233,45,19,61,31,7,3,15,5
S01010015,Owned: Total,238,215,178,19,159,34,3,23,20,1,0,0,2
S01010015,Owned: Owned outright,60,41,33,9,24,7,1,19,18,0,0,0,1
S01010015,Owned: Owned with a mortgage or loan or shared ownership,178,174,145,10,135,27,2,4,2,1,0,0,1
S01010015,Rented or living rent free: Total,154,116,89,15,74,11,16,38,11,6,3,15,3
S01010015,Rented or living rent free: Social rented,33,10,5,2,3,1,4,23,8,0,1,12,2
S01010015,Rented or living rent free: Private rented or living rent free,121,106,84,13,71,10,12,15,3,6,2,3,1
S01010016,All HRPs aged 16 and over,325,164,139,26,113,14,11,161,130,1,7,17,6
S01010016,Owned: Total,207,126,108,16,92,12,6,81,73,1,1,5,1
S01010016,Owned: Owned outright,92,28,24,5,19,1,3,64,61,0,0,2,1
S01010016,Owned: Owned with a mortgage or loan or shared ownership,115,98,84,11,73,11,3,17,12,1,1,3,0
S01010016,Rented or living rent free: Total,118,38,31,10,21,2,5,80,57,0,6,12,5
S01010016,Rented or living rent free: Social rented,104,29,23,6,17,2,4,75,56,0,4,11,4
S01010016,Rented or living rent free: Private rented or living rent free,14,9,8,4,4,0,1,5,1,0,2,1,1
S01010017,All HRPs aged 16 and over,339,178,138,41,97,14,26,161,100,2,12,42,5
S01010017,Owned: Total,125,73,62,9,53,7,4,52,44,0,1,7,0
S01010017,Owned: Owned outright,51,14,12,2,10,0,2,37,34,0,1,2,0
S01010017,Owned: Owned with a mortgage or loan or shared ownership,74,59,50,7,43,7,2,15,10,0,0,5,0
S01010017,Rented or living rent free: Total,214,105,76,32,44,7,22,109,56,2,11,35,5
S01010017,Rented or living rent free: Social rented,187,85,60,25,35,6,19,102,56,2,8,33,3
S01010017,Rented or living rent free: Private rented or living rent free,27,20,16,7,9,1,3,7,0,0,3,2,2
S01010018,All HRPs aged 16 and over,525,263,234,56,178,17,12,262,179,2,12,54,15
S01010018,Owned: Total,211,143,136,21,115,7,0,68,56,1,1,7,3
S01010018,Owned: Owned outright,66,18,15,3,12,3,0,48,42,0,1,3,2
S01010018,Owned: Owned with a mortgage or loan or shared ownership,145,125,121,18,103,4,0,20,14,1,0,4,1
S01010018,Rented or living rent free: Total,314,120,98,35,63,10,12,194,123,1,11,47,12
S01010018,Rented or living rent free: Social rented,271,86,73,30,43,7,6,185,121,1,10,43,10
S01010018,Rented or living rent free: Private rented or living rent free,43,34,25,5,20,3,6,9,2,0,1,4,2
S01010019,All HRPs aged 16 and over,409,194,152,51,101,7,35,215,124,2,14,67,8
S01010019,Owned: Total,53,35,30,2,28,2,3,18,17,0,0,1,0
S01010019,Owned: Owned outright,27,12,9,2,7,1,2,15,14,0,0,1,0
S01010019,Owned: Owned with a mortgage or loan or shared ownership,26,23,21,0,21,1,1,3,3,0,0,0,0
S01010019,Rented or living rent free: Total,356,159,122,49,73,5,32,197,107,2,14,66,8
S01010019,Rented or living rent free: Social rented,336,147,114,46,68,3,30,189,102,2,12,66,7
S01010019,Rented or living rent free: Private rented or living rent free,20,12,8,3,5,2,2,8,5,0,2,0,1
S01010020,All HRPs aged 16 and over,346,182,159,44,115,12,11,164,122,1,5,30,6
S01010020,Owned: Total,192,110,96,19,77,10,4,82,69,0,0,11,2
S01010020,Owned: Owned outright,86,30,27,8,19,2,1,56,50,0,0,5,1
S01010020,Owned: Owned with a mortgage or loan or shared ownership,106,80,69,11,58,8,3,26,19,0,0,6,1
S01010020,Rented or living rent free: Total,154,72,63,25,38,2,7,82,53,1,5,19,4
S01010020,Rented or living rent free: Social rented,125,54,46,19,27,2,6,71,46,0,4,18,3
S01010020,Rented or living rent free: Private rented or living rent free,29,18,17,6,11,0,1,11,7,1,1,1,1
S01010021,All HRPs aged 16 and over,400,192,124,46,78,19,49,208,72,19,23,72,22
S01010021,Owned: Total,40,27,16,5,11,10,1,13,11,0,1,1,0
S01010021,Owned: Owned outright,18,9,6,2,4,2,1,9,9,0,0,0,0
S01010021,Owned: Owned with a mortgage or loan or shared ownership,22,18,10,3,7,8,0,4,2,0,1,1,0
S01010021,Rented or living rent free: Total,360,165,108,41,67,9,48,195,61,19,22,71,22
S01010021,Rented or living rent free: Social rented,319,137,94,38,56,7,36,182,60,17,21,64,20
S01010021,Rented or living rent free: Private rented or living rent free,41,28,14,3,11,2,12,13,1,2,1,7,2
S01010022,All HRPs aged 16 and over,468,245,192,34,158,20,33,223,105,10,26,64,18
S01010022,Owned: Total,132,104,83,9,74,10,11,28,22,0,1,3,2
S01010022,Owned: Owned outright,34,11,9,2,7,2,0,23,19,0,0,2,2
S01010022,Owned: Owned with a mortgage or loan or shared ownership,98,93,74,7,67,8,11,5,3,0,1,1,0
S01010022,Rented or living rent free: Total,336,141,109,25,84,10,22,195,83,10,25,61,16
S01010022,Rented or living rent free: Social rented,262,99,73,21,52,8,18,163,78,2,17,54,12
S01010022,Rented or living rent free: Private rented or living rent free,74,42,36,4,32,2,4,32,5,8,8,7,4
S01010023,All HRPs aged 16 and over,387,140,99,30,69,7,34,247,155,1,13,71,7
S01010023,Owned: Total,49,21,18,3,15,2,1,28,26,0,0,2,0
S01010023,Owned: Owned outright,34,9,8,2,6,1,0,25,23,0,0,2,0
S01010023,Owned: Owned with a mortgage or loan or shared ownership,15,12,10,1,9,1,1,3,3,0,0,0,0
S01010023,Rented or living rent free: Total,338,119,81,27,54,5,33,219,129,1,13,69,7
S01010023,Rented or living rent free: Social rented,327,116,81,27,54,5,30,211,128,1,10,66,6
S01010023,Rented or living rent free: Private rented or living rent free,11,3,0,0,0,0,3,8,1,0,3,3,1
S01010024,All HRPs aged 16 and over,402,230,199,52,147,11,20,172,85,7,14,57,9
S01010024,Owned: Total,86,77,72,13,59,4,1,9,7,0,0,0,2
S01010024,Owned: Owned outright,18,14,12,3,9,1,1,4,3,0,0,0,1
S01010024,Owned: Owned with a mortgage or loan or shared ownership,68,63,60,10,50,3,0,5,4,0,0,0,1
S01010024,Rented or living rent free: Total,316,153,127,39,88,7,19,163,78,7,14,57,7
S01010024,Rented or living rent free: Social rented,255,102,80,29,51,5,17,153,78,5,12,52,6
S01010024,Rented or living rent free: Private rented or living rent free,61,51,47,10,37,2,2,10,0,2,2,5,1
S01010025,All HRPs aged 16 and over,316,149,99,29,70,18,32,167,62,6,8,67,24
S01010025,Owned: Total,41,33,25,4,21,6,2,8,5,1,0,2,0
S01010025,Owned: Owned outright,14,7,6,2,4,0,1,7,5,0,0,2,0
S01010025,Owned: Owned with a mortgage or loan or shared ownership,27,26,19,2,17,6,1,1,0,1,0,0,0
S01010025,Rented or living rent free: Total,275,116,74,25,49,12,30,159,57,5,8,65,24
S01010025,Rented or living rent free: Social rented,255,101,65,22,43,8,28,154,57,3,8,62,24
S01010025,Rented or living rent free: Private rented or living rent free,20,15,9,3,6,4,2,5,0,2,0,3,0
S01010026,All HRPs aged 16 and over,492,302,242,48,194,25,35,190,63,18,15,84,10
S01010026,Owned: Total,129,116,100,5,95,15,1,13,6,4,1,1,1
S01010026,Owned: Owned outright,23,17,16,1,15,1,0,6,5,0,0,1,0
S01010026,Owned: Owned with a mortgage or loan or shared ownership,106,99,84,4,80,14,1,7,1,4,1,0,1
S01010026,Rented or living rent free: Total,363,186,142,43,99,10,34,177,57,14,14,83,9
S01010026,Rented or living rent free: Social rented,299,134,94,35,59,7,33,165,54,7,14,81,9
S01010026,Rented or living rent free: Private rented or living rent free,64,52,48,8,40,3,1,12,3,7,0,2,0
S01010027,All HRPs aged 16 and over,483,299,252,57,195,20,27,184,87,31,11,47,8
S01010027,Owned: Total,176,151,138,14,124,12,1,25,19,3,0,2,1
S01010027,Owned: Owned outright,46,23,22,7,15,1,0,23,18,3,0,1,1
S01010027,Owned: Owned with a mortgage or loan or shared ownership,130,128,116,7,109,11,1,2,1,0,0,1,0
S01010027,Rented or living rent free: Total,307,148,114,43,71,8,26,159,68,28,11,45,7
S01010027,Rented or living rent free: Social rented,210,78,58,28,30,2,18,132,68,4,9,44,7
S01010027,Rented or living rent free: Private rented or living rent free,97,70,56,15,41,6,8,27,0,24,2,1,0
S01010028,All HRPs aged 16 and over,381,185,143,34,109,16,26,196,113,12,8,57,6
S01010028,Owned: Total,81,62,55,5,50,7,0,19,13,2,0,3,1
S01010028,Owned: Owned outright,24,9,8,1,7,1,0,15,11,2,0,1,1
S01010028,Owned: Owned with a mortgage or loan or shared ownership,57,53,47,4,43,6,0,4,2,0,0,2,0
S01010028,Rented or living rent free: Total,300,123,88,29,59,9,26,177,100,10,8,54,5
S01010028,Rented or living rent free: Social rented,254,92,65,26,39,5,22,162,92,5,8,52,5
S01010028,Rented or living rent free: Private rented or living rent free,46,31,23,3,20,4,4,15,8,5,0,2,0
S01010029,All HRPs aged 16 and over,398,145,118,36,82,9,18,253,160,7,12,58,16
S01010029,Owned: Total,127,55,47,9,38,5,3,72,67,1,1,3,0
S01010029,Owned: Owned outright,76,19,16,5,11,1,2,57,55,1,0,1,0
S01010029,Owned: Owned with a mortgage or loan or shared ownership,51,36,31,4,27,4,1,15,12,0,1,2,0
S01010029,Rented or living rent free: Total,271,90,71,27,44,4,15,181,93,6,11,55,16
S01010029,Rented or living rent free: Social rented,258,83,65,24,41,3,15,175,93,6,11,52,13
S01010029,Rented or living rent free: Private rented or living rent free,13,7,6,3,3,1,0,6,0,0,0,3,3
S01010030,All HRPs aged 16 and over,429,310,273,38,235,21,16,119,63,17,6,30,3
S01010030,Owned: Total,225,186,163,11,152,20,3,39,33,0,0,5,1
S01010030,Owned: Owned outright,66,35,28,5,23,5,2,31,29,0,0,1,1
S01010030,Owned: Owned with a mortgage or loan or shared ownership,159,151,135,6,129,15,1,8,4,0,0,4,0
S01010030,Rented or living rent free: Total,204,124,110,27,83,1,13,80,30,17,6,25,2
S01010030,Rented or living rent free: Social rented,97,37,34,17,17,0,3,60,27,5,5,22,1
S01010030,Rented or living rent free: Private rented or living rent free,107,87,76,10,66,1,10,20,3,12,1,3,1
S01010031,All HRPs aged 16 and over,423,345,295,41,254,33,17,78,22,40,7,9,0
S01010031,Owned: Total,189,162,140,12,128,18,4,27,19,6,0,2,0
S01010031,Owned: Owned outright,47,31,24,5,19,4,3,16,13,2,0,1,0
S01010031,Owned: Owned with a mortgage or loan or shared ownership,142,131,116,7,109,14,1,11,6,4,0,1,0
S01010031,Rented or living rent free: Total,234,183,155,29,126,15,13,51,3,34,7,7,0
S01010031,Rented or living rent free: Social rented,13,5,2,0,2,1,2,8,0,1,3,4,0
S01010031,Rented or living rent free: Private rented or living rent free,221,178,153,29,124,14,11,43,3,33,4,3,0
S01010032,All HRPs aged 16 and over,298,253,221,40,181,16,16,45,5,28,4,4,4
S01010032,Owned: Total,101,91,76,8,68,13,2,10,4,4,0,0,2
S01010032,Owned: Owned outright,19,14,10,3,7,3,1,5,3,2,0,0,0
S01010032,Owned: Owned with a mortgage or loan or shared ownership,82,77,66,5,61,10,1,5,1,2,0,0,2
S01010032,Rented or living rent free: Total,197,162,145,32,113,3,14,35,1,24,4,4,2
S01010032,Rented or living rent free: Social rented,26,13,5,2,3,2,6,13,1,5,4,1,2
S01010032,Rented or living rent free: Private rented or living rent free,171,149,140,30,110,1,8,22,0,19,0,3,0
S01010033,All HRPs aged 16 and over,503,316,243,53,190,27,46,187,83,15,13,60,16
S01010033,Owned: Total,108,80,69,7,62,6,5,28,22,0,0,6,0
S01010033,Owned: Owned outright,32,10,8,2,6,1,1,22,20,0,0,2,0
S01010033,Owned: Owned with a mortgage or loan or shared ownership,76,70,61,5,56,5,4,6,2,0,0,4,0
S01010033,Rented or living rent free: Total,395,236,174,46,128,21,41,159,61,15,13,54,16
S01010033,Rented or living rent free: Social rented,278,151,108,27,81,17,26,127,56,2,10,48,11
S01010033,Rented or living rent free: Private rented or living rent free,117,85,66,19,47,4,15,32,5,13,3,6,5
S01010034,All HRPs aged 16 and over,498,222,181,40,141,12,29,276,169,17,11,67,12
S01010034,Owned: Total,150,93,87,15,72,4,2,57,52,1,0,3,1
S01010034,Owned: Owned outright,63,19,18,7,11,0,1,44,41,0,0,2,1
S01010034,Owned: Owned with a mortgage or loan or shared ownership,87,74,69,8,61,4,1,13,11,1,0,1,0
S01010034,Rented or living rent free: Total,348,129,94,25,69,8,27,219,117,16,11,64,11
S01010034,Rented or living rent free: Social rented,290,88,61,20,41,5,22,202,111,9,11,61,10
S01010034,Rented or living rent free: Private rented or living rent free,58,41,33,5,28,3,5,17,6,7,0,3,1
S01010035,All HRPs aged 16 and over,401,216,153,44,109,12,51,185,63,18,14,74,16
S01010035,Owned: Total,52,39,33,7,26,3,3,13,11,1,0,1,0
S01010035,Owned: Owned outright,19,7,5,1,4,0,2,12,10,1,0,1,0
S01010035,Owned: Owned with a mortgage or loan or shared ownership,33,32,28,6,22,3,1,1,1,0,0,0,0
S01010035,Rented or living rent free: Total,349,177,120,37,83,9,48,172,52,17,14,73,16
S01010035,Rented or living rent free: Social rented,303,143,92,30,62,5,46,160,52,5,14,73,16
S01010035,Rented or living rent free: Private rented or living rent free,46,34,28,7,21,4,2,12,0,12,0,0,0
S01010036,All HRPs aged 16 and over,423,345,271,89,182,33,41,78,0,64,4,4,6
S01010036,Owned: Total,83,77,64,9,55,8,5,6,0,5,0,0,1
S01010036,Owned: Owned outright,23,21,17,5,12,2,2,2,0,2,0,0,0
S01010036,Owned: Owned with a mortgage or loan or shared ownership,60,56,47,4,43,6,3,4,0,3,0,0,1
S01010036,Rented or living rent free: Total,340,268,207,80,127,25,36,72,0,59,4,4,5
S01010036,Rented or living rent free: Social rented,16,13,6,2,4,0,7,3,0,0,0,1,2
S01010036,Rented or living rent free: Private rented or living rent free,324,255,201,78,123,25,29,69,0,59,4,3,3
S01010037,All HRPs aged 16 and over,376,149,123,25,98,9,17,227,149,2,10,60,6
S01010037,Owned: Total,109,62,57,6,51,4,1,47,40,1,2,4,0
S01010037,Owned: Owned outright,42,15,15,2,13,0,0,27,24,0,0,3,0
S01010037,Owned: Owned with a mortgage or loan or shared ownership,67,47,42,4,38,4,1,20,16,1,2,1,0
S01010037,Rented or living rent free: Total,267,87,66,19,47,5,16,180,109,1,8,56,6
S01010037,Rented or living rent free: Social rented,246,72,54,16,38,4,14,174,106,1,6,55,6
S01010037,Rented or living rent free: Private rented or living rent free,21,15,12,3,9,1,2,6,3,0,2,1,0
S01010038,All HRPs aged 16 and over,568,274,221,49,172,27,26,294,122,25,21,108,18
S01010038,Owned: Total,158,96,80,7,73,13,3,62,41,2,3,11,5
S01010038,Owned: Owned outright,55,20,18,5,13,1,1,35,27,1,0,5,2
S01010038,Owned: Owned with a mortgage or loan or shared ownership,103,76,62,2,60,12,2,27,14,1,3,6,3
S01010038,Rented or living rent free: Total,410,178,141,42,99,14,23,232,81,23,18,97,13
S01010038,Rented or living rent free: Social rented,301,103,77,23,54,9,17,198,77,4,14,92,11
S01010038,Rented or living rent free: Private rented or living rent free,109,75,64,19,45,5,6,34,4,19,4,5,2
S01010039,All HRPs aged 16 and over,593,466,404,71,333,40,22,127,18,82,4,16,7
S01010039,Owned: Total,196,167,138,14,124,25,4,29,12,15,1,0,1
S01010039,Owned: Owned outright,35,18,15,4,11,2,1,17,7,9,1,0,0
S01010039,Owned: Owned with a mortgage or loan or shared ownership,161,149,123,10,113,23,3,12,5,6,0,0,1
S01010039,Rented or living rent free: Total,397,299,266,57,209,15,18,98,6,67,3,16,6
S01010039,Rented or living rent free: Social rented,40,21,14,4,10,4,3,19,3,0,2,12,2
S01010039,Rented or living rent free: Private rented or living rent free,357,278,252,53,199,11,15,79,3,67,1,4,4
S01010040,All HRPs aged 16 and over,415,308,259,44,215,33,16,107,42,16,8,37,4
S01010040,Owned: Total,207,174,150,16,134,21,3,33,27,1,1,3,1
S01010040,Owned: Owned outright,59,33,29,5,24,4,0,26,25,0,0,1,0
S01010040,Owned: Owned with a mortgage or loan or shared ownership,148,141,121,11,110,17,3,7,2,1,1,2,1
S01010040,Rented or living rent free: Total,208,134,109,28,81,12,13,74,15,15,7,34,3
S01010040,Rented or living rent free: Social rented,62,20,16,4,12,1,3,42,10,0,3,28,1
S01010040,Rented or living rent free: Private rented or living rent free,146,114,93,24,69,11,10,32,5,15,4,6,2
S01010041,All HRPs aged 16 and over,451,288,243,48,195,29,16,163,46,43,6,54,14
S01010041,Owned: Total,141,127,110,11,99,16,1,14,9,4,1,0,0
S01010041,Owned: Owned outright,42,33,30,7,23,3,0,9,6,2,1,0,0
S01010041,Owned: Owned with a mortgage or loan or shared ownership,99,94,80,4,76,13,1,5,3,2,0,0,0
S01010041,Rented or living rent free: Total,310,161,133,37,96,13,15,149,37,39,5,54,14
S01010041,Rented or living rent free: Social rented,172,61,43,11,32,5,13,111,36,5,4,52,14
S01010041,Rented or living rent free: Private rented or living rent free,138,100,90,26,64,8,2,38,1,34,1,2,0
S01010042,All HRPs aged 16 and over,621,472,392,75,317,32,48,149,41,43,9,44,12
S01010042,Owned: Total,178,160,141,11,130,16,3,18,12,1,0,3,2
S01010042,Owned: Owned outright,30,20,20,3,17,0,0,10,7,0,0,1,2
S01010042,Owned: Owned with a mortgage or loan or shared ownership,148,140,121,8,113,16,3,8,5,1,0,2,0
S01010042,Rented or living rent free: Total,443,312,251,64,187,16,45,131,29,42,9,41,10
S01010042,Rented or living rent free: Social rented,104,42,27,9,18,1,14,62,24,0,2,30,6
S01010042,Rented or living rent free: Private rented or living rent free,339,270,224,55,169,15,31,69,5,42,7,11,4
S01010043,All HRPs aged 16 and over,451,267,209,51,158,10,48,184,79,8,10,71,16
S01010043,Owned: Total,137,107,96,16,80,7,4,30,20,1,0,7,2
S01010043,Owned: Owned outright,41,18,17,6,11,0,1,23,19,0,0,4,0
S01010043,Owned: Owned with a mortgage or loan or shared ownership,96,89,79,10,69,7,3,7,1,1,0,3,2
S01010043,Rented or living rent free: Total,314,160,113,35,78,3,44,154,59,7,10,64,14
S01010043,Rented or living rent free: Social rented,212,91,56,25,31,0,35,121,47,1,9,51,13
S01010043,Rented or living rent free: Private rented or living rent free,102,69,57,10,47,3,9,33,12,6,1,13,1
S01010044,All HRPs aged 16 and over,649,396,333,65,268,30,33,253,150,13,15,58,17
S01010044,Owned: Total,233,183,161,19,142,18,4,50,44,0,1,5,0
S01010044,Owned: Owned outright,67,26,22,4,18,3,1,41,38,0,0,3,0
S01010044,Owned: Owned with a mortgage or loan or shared ownership,166,157,139,15,124,15,3,9,6,0,1,2,0
S01010044,Rented or living rent free: Total,416,213,172,46,126,12,29,203,106,13,14,53,17
S01010044,Rented or living rent free: Social rented,225,72,56,19,37,1,15,153,93,1,9,42,8
S01010044,Rented or living rent free: Private rented or living rent free,191,141,116,27,89,11,14,50,13,12,5,11,9
S01010045,All HRPs aged 16 and over,258,97,78,28,50,5,14,161,74,4,16,56,11
S01010045,Owned: Total,39,22,19,5,14,2,1,17,10,0,0,6,1
S01010045,Owned: Owned outright,19,6,6,3,3,0,0,13,9,0,0,4,0
S01010045,Owned: Owned with a mortgage or loan or shared ownership,20,16,13,2,11,2,1,4,1,0,0,2,1
S01010045,Rented or living rent free: Total,219,75,59,23,36,3,13,144,64,4,16,50,10
S01010045,Rented or living rent free: Social rented,207,69,54,20,34,2,13,138,60,3,15,50,10
S01010045,Rented or living rent free: Private rented or living rent free,12,6,5,3,2,1,0,6,4,1,1,0,0
S01010046,All HRPs aged 16 and over,431,234,181,36,145,25,28,197,106,7,13,55,16
S01010046,Owned: Total,133,92,76,12,64,12,4,41,30,3,0,7,1
S01010046,Owned: Owned outright,68,38,26,5,21,10,2,30,21,2,0,6,1
S01010046,Owned: Owned with a mortgage or loan or shared ownership,65,54,50,7,43,2,2,11,9,1,0,1,0
S01010046,Rented or living rent free: Total,298,142,105,24,81,13,24,156,76,4,13,48,15
S01010046,Rented or living rent free: Social rented,221,94,71,20,51,9,14,127,64,3,8,42,10
S01010046,Rented or living rent free: Private rented or living rent free,77,48,34,4,30,4,10,29,12,1,5,6,5
S01010047,All HRPs aged 16 and over,471,191,148,46,102,15,28,280,149,7,23,93,8
S01010047,Owned: Total,77,47,39,10,29,5,3,30,23,0,0,6,1
S01010047,Owned: Owned outright,19,6,6,2,4,0,0,13,10,0,0,3,0
S01010047,Owned: Owned with a mortgage or loan or shared ownership,58,41,33,8,25,5,3,17,13,0,0,3,1
S01010047,Rented or living rent free: Total,394,144,109,36,73,10,25,250,126,7,23,87,7
S01010047,Rented or living rent free: Social rented,383,136,104,35,69,9,23,247,126,7,20,87,7
S01010047,Rented or living rent free: Private rented or living rent free,11,8,5,1,4,1,2,3,0,0,3,0,0
S01010048,All HRPs aged 16 and over,551,255,208,43,165,10,37,296,158,12,17,84,25
S01010048,Owned: Total,110,45,39,4,35,2,4,65,48,0,1,13,3
S01010048,Owned: Owned outright,55,9,7,1,6,0,2,46,35,0,0,9,2
S01010048,Owned: Owned with a mortgage or loan or shared ownership,55,36,32,3,29,2,2,19,13,0,1,4,1
S01010048,Rented or living rent free: Total,441,210,169,39,130,8,33,231,110,12,16,71,22
S01010048,Rented or living rent free: Social rented,376,171,134,32,102,5,32,205,103,3,14,67,18
S01010048,Rented or living rent free: Private rented or living rent free,65,39,35,7,28,3,1,26,7,9,2,4,4
S01010049,All HRPs aged 16 and over,395,192,149,46,103,7,36,203,86,10,33,57,17
S01010049,Owned: Total,34,22,19,3,16,3,0,12,8,0,0,2,2
S01010049,Owned: Owned outright,11,2,1,1,0,1,0,9,5,0,0,2,2
S01010049,Owned: Owned with a mortgage or loan or shared ownership,23,20,18,2,16,2,0,3,3,0,0,0,0
S01010049,Rented or living rent free: Total,361,170,130,43,87,4,36,191,78,10,33,55,15
S01010049,Rented or living rent free: Social rented,312,149,113,39,74,3,33,163,74,2,26,48,13
S01010049,Rented or living rent free: Private rented or living rent free,49,21,17,4,13,1,3,28,4,8,7,7,2
S01010050,All HRPs aged 16 and over,540,238,187,61,126,11,40,302,126,12,27,115,22
S01010050,Owned: Total,57,42,42,7,35,0,0,15,12,0,0,1,2
S01010050,Owned: Owned outright,18,6,6,0,6,0,0,12,10,0,0,1,1
S01010050,Owned: Owned with a mortgage or loan or shared ownership,39,36,36,7,29,0,0,3,2,0,0,0,1
S01010050,Rented or living rent free: Total,483,196,145,54,91,11,40,287,114,12,27,114,20
S01010050,Rented or living rent free: Social rented,416,158,112,46,66,11,35,258,109,2,21,107,19
S01010050,Rented or living rent free: Private rented or living rent free,67,38,33,8,25,0,5,29,5,10,6,7,1
S01010051,All HRPs aged 16 and over,431,188,145,31,114,8,35,243,137,9,10,69,18
S01010051,Owned: Total,81,45,38,4,34,4,3,36,33,0,0,2,1
S01010051,Owned: Owned outright,33,11,8,2,6,1,2,22,22,0,0,0,0
S01010051,Owned: Owned with a mortgage or loan or shared ownership,48,34,30,2,28,3,1,14,11,0,0,2,1
S01010051,Rented or living rent free: Total,350,143,107,27,80,4,32,207,104,9,10,67,17
S01010051,Rented or living rent free: Social rented,297,111,81,19,62,4,26,186,100,0,8,62,16
S01010051,Rented or living rent free: Private rented or living rent free,53,32,26,8,18,0,6,21,4,9,2,5,1
S01010052,All HRPs aged 16 and over,372,203,160,38,122,9,34,169,54,9,15,79,12
S01010052,Owned: Total,92,66,60,8,52,3,3,26,15,0,0,9,2
S01010052,Owned: Owned outright,28,15,14,3,11,0,1,13,9,0,0,2,2
S01010052,Owned: Owned with a mortgage or loan or shared ownership,64,51,46,5,41,3,2,13,6,0,0,7,0
S01010052,Rented or living rent free: Total,280,137,100,30,70,6,31,143,39,9,15,70,10
S01010052,Rented or living rent free: Social rented,190,91,65,23,42,5,21,99,36,2,10,45,6
S01010052,Rented or living rent free: Private rented or living rent free,90,46,35,7,28,1,10,44,3,7,5,25,4
S01010053,All HRPs aged 16 and over,384,215,177,48,129,16,22,169,74,6,24,47,18
S01010053,Owned: Total,81,49,43,10,33,6,0,32,24,1,1,6,0
S01010053,Owned: Owned outright,31,15,15,7,8,0,0,16,12,0,1,3,0
S01010053,Owned: Owned with a mortgage or loan or shared ownership,50,34,28,3,25,6,0,16,12,1,0,3,0
S01010053,Rented or living rent free: Total,303,166,134,38,96,10,22,137,50,5,23,41,18
S01010053,Rented or living rent free: Social rented,182,67,45,17,28,5,17,115,48,1,18,40,8
S01010053,Rented or living rent free: Private rented or living rent free,121,99,89,21,68,5,5,22,2,4,5,1,10
S01010054,All HRPs aged 16 and over,247,115,89,30,59,4,22,132,39,1,25,54,13
S01010054,Owned: Total,17,12,10,1,9,2,0,5,2,0,1,2,0
S01010054,Owned: Owned outright,2,0,0,0,0,0,0,2,2,0,0,0,0
S01010054,Owned: Owned with a mortgage or loan or shared ownership,15,12,10,1,9,2,0,3,0,0,1,2,0
S01010054,Rented or living rent free: Total,230,103,79,29,50,2,22,127,37,1,24,52,13
S01010054,Rented or living rent free: Social rented,228,103,79,29,50,2,22,125,37,1,23,51,13
S01010054,Rented or living rent free: Private rented or living rent free,2,0,0,0,0,0,0,2,0,0,1,1,0
S01010055,All HRPs aged 16 and over,457,276,224,46,178,18,34,181,80,11,18,59,13
S01010055,Owned: Total,184,151,135,16,119,12,4,33,22,4,0,6,1
S01010055,Owned: Owned outright,47,32,25,7,18,7,0,15,8,3,0,3,1
S01010055,Owned: Owned with a mortgage or loan or shared ownership,137,119,110,9,101,5,4,18,14,1,0,3,0
S01010055,Rented or living rent free: Total,273,125,89,30,59,6,30,148,58,7,18,53,12
S01010055,Rented or living rent free: Social rented,190,71,46,19,27,2,23,119,47,1,17,43,11
S01010055,Rented or living rent free: Private rented or living rent free,83,54,43,11,32,4,7,29,11,6,1,10,1
S01010056,All HRPs aged 16 and over,214,118,90,21,69,12,16,96,36,2,15,36,7
S01010056,Owned: Total,25,19,14,1,13,5,0,6,5,0,1,0,0
S01010056,Owned: Owned outright,7,3,1,0,1,2,0,4,3,0,1,0,0
S01010056,Owned: Owned with a mortgage or loan or shared ownership,18,16,13,1,12,3,0,2,2,0,0,0,0
S01010056,Rented or living rent free: Total,189,99,76,20,56,7,16,90,31,2,14,36,7
S01010056,Rented or living rent free: Social rented,178,94,73,19,54,6,15,84,30,1,11,36,6
S01010056,Rented or living rent free: Private rented or living rent free,11,5,3,1,2,1,1,6,1,1,3,0,1
S01010057,All HRPs aged 16 and over,216,119,100,30,70,8,11,97,48,10,13,17,9
S01010057,Owned: Total,79,53,47,7,40,4,2,26,23,1,0,2,0
S01010057,Owned: Owned outright,24,4,3,2,1,0,1,20,18,0,0,2,0
S01010057,Owned: Owned with a mortgage or loan or shared ownership,55,49,44,5,39,4,1,6,5,1,0,0,0
S01010057,Rented or living rent free: Total,137,66,53,23,30,4,9,71,25,9,13,15,9
S01010057,Rented or living rent free: Social rented,82,31,24,15,9,1,6,51,25,1,7,13,5
S01010057,Rented or living rent free: Private rented or living rent free,55,35,29,8,21,3,3,20,0,8,6,2,4
S01010058,All HRPs aged 16 and over,355,200,163,42,121,13,24,155,51,9,30,55,10
S01010058,Owned: Total,120,101,91,15,76,8,2,19,13,0,3,3,0
S01010058,Owned: Owned outright,20,11,10,1,9,1,0,9,9,0,0,0,0
S01010058,Owned: Owned with a mortgage or loan or shared ownership,100,90,81,14,67,7,2,10,4,0,3,3,0
S01010058,Rented or living rent free: Total,235,99,72,27,45,5,22,136,38,9,27,52,10
S01010058,Rented or living rent free: Social rented,173,68,44,21,23,3,21,105,33,2,19,43,8
S01010058,Rented or living rent free: Private rented or living rent free,62,31,28,6,22,2,1,31,5,7,8,9,2
S01010059,All HRPs aged 16 and over,371,267,224,44,180,15,28,104,54,11,6,26,7
S01010059,Owned: Total,168,121,108,8,100,9,4,47,40,3,0,2,2
S01010059,Owned: Owned outright,61,24,19,5,14,5,0,37,34,1,0,1,1
S01010059,Owned: Owned with a mortgage or loan or shared ownership,107,97,89,3,86,4,4,10,6,2,0,1,1
S01010059,Rented or living rent free: Total,203,146,116,36,80,6,24,57,14,8,6,24,5
S01010059,Rented or living rent free: Social rented,92,59,43,20,23,3,13,33,11,0,3,14,5
S01010059,Rented or living rent free: Private rented or living rent free,111,87,73,16,57,3,11,24,3,8,3,10,0
S01010060,All HRPs aged 16 and over,493,281,224,44,180,23,34,212,94,11,11,76,20
S01010060,Owned: Total,135,94,78,11,67,14,2,41,38,0,1,2,0
S01010060,Owned: Owned outright,53,22,17,5,12,4,1,31,30,0,0,1,0
S01010060,Owned: Owned with a mortgage or loan or shared ownership,82,72,61,6,55,10,1,10,8,0,1,1,0
S01010060,Rented or living rent free: Total,358,187,146,33,113,9,32,171,56,11,10,74,20
S01010060,Rented or living rent free: Social rented,292,146,116,30,86,7,23,146,54,2,6,64,20
S01010060,Rented or living rent free: Private rented or living rent free,66,41,30,3,27,2,9,25,2,9,4,10,0
S01010061,All HRPs aged 16 and over,253,182,144,19,125,20,18,71,36,15,4,13,3
S01010061,Owned: Total,157,130,112,7,105,16,2,27,22,2,2,1,0
S01010061,Owned: Owned outright,37,16,13,2,11,2,1,21,18,2,0,1,0
S01010061,Owned: Owned with a mortgage or loan or shared ownership,120,114,99,5,94,14,1,6,4,0,2,0,0
S01010061,Rented or living rent free: Total,96,52,32,12,20,4,16,44,14,13,2,12,3
S01010061,Rented or living rent free: Social rented,37,17,11,5,6,0,6,20,10,2,1,7,0
S01010061,Rented or living rent free: Private rented or living rent free,59,35,21,7,14,4,10,24,4,11,1,5,3
S01010062,All HRPs aged 16 and over,344,180,140,44,96,17,23,164,99,2,16,37,10
S01010062,Owned: Total,135,70,55,12,43,13,2,65,54,0,1,9,1
S01010062,Owned: Owned outright,68,13,11,4,7,1,1,55,48,0,0,6,1
S01010062,Owned: Owned with a mortgage or loan or shared ownership,67,57,44,8,36,12,1,10,6,0,1,3,0
S01010062,Rented or living rent free: Total,209,110,85,32,53,4,21,99,45,2,15,28,9
S01010062,Rented or living rent free: Social rented,170,86,65,25,40,3,18,84,39,1,13,25,6
S01010062,Rented or living rent free: Private rented or living rent free,39,24,20,7,13,1,3,15,6,1,2,3,3
S01010063,All HRPs aged 16 and over,546,315,240,50,190,20,55,231,100,7,23,84,17
S01010063,Owned: Total,132,101,86,7,79,6,9,31,27,0,1,2,1
S01010063,Owned: Owned outright,37,15,12,1,11,1,2,22,20,0,1,1,0
S01010063,Owned: Owned with a mortgage or loan or shared ownership,95,86,74,6,68,5,7,9,7,0,0,1,1
S01010063,Rented or living rent free: Total,414,214,154,43,111,14,46,200,73,7,22,82,16
S01010063,Rented or living rent free: Social rented,327,151,112,33,79,5,34,176,70,2,19,72,13
S01010063,Rented or living rent free: Private rented or living rent free,87,63,42,10,32,9,12,24,3,5,3,10,3
S01010064,All HRPs aged 16 and over,264,154,119,23,96,14,21,110,63,3,10,22,12
S01010064,Owned: Total,114,78,69,9,60,9,0,36,34,0,1,0,1
S01010064,Owned: Owned outright,40,11,9,5,4,2,0,29,28,0,0,0,1
S01010064,Owned: Owned with a mortgage or loan or shared ownership,74,67,60,4,56,7,0,7,6,0,1,0,0
S01010064,Rented or living rent free: Total,150,76,50,14,36,5,21,74,29,3,9,22,11
S01010064,Rented or living rent free: Social rented,115,53,32,9,23,3,18,62,26,3,7,19,7
S01010064,Rented or living rent free: Private rented or living rent free,35,23,18,5,13,2,3,12,3,0,2,3,4
S01010065,All HRPs aged 16 and over,413,189,160,35,125,14,15,224,116,5,15,74,14
S01010065,Owned: Total,158,98,86,7,79,9,3,60,55,0,0,5,0
S01010065,Owned: Owned outright,63,19,18,2,16,1,0,44,42,0,0,2,0
S01010065,Owned: Owned with a mortgage or loan or shared ownership,95,79,68,5,63,8,3,16,13,0,0,3,0
S01010065,Rented or living rent free: Total,255,91,74,28,46,5,12,164,61,5,15,69,14
S01010065,Rented or living rent free: Social rented,223,75,61,24,37,4,10,148,59,3,11,65,10
S01010065,Rented or living rent free: Private rented or living rent free,32,16,13,4,9,1,2,16,2,2,4,4,4
S01010066,All HRPs aged 16 and over,342,152,128,42,86,12,12,190,87,7,21,61,14
S01010066,Owned: Total,112,66,59,17,42,7,0,46,36,0,0,9,1
S01010066,Owned: Owned outright,46,18,16,6,10,2,0,28,25,0,0,3,0
S01010066,Owned: Owned with a mortgage or loan or shared ownership,66,48,43,11,32,5,0,18,11,0,0,6,1
S01010066,Rented or living rent free: Total,230,86,69,25,44,5,12,144,51,7,21,52,13
S01010066,Rented or living rent free: Social rented,188,64,51,18,33,3,10,124,51,1,18,42,12
S01010066,Rented or living rent free: Private rented or living rent free,42,22,18,7,11,2,2,20,0,6,3,10,1
S01010067,All HRPs aged 16 and over,297,152,115,29,86,12,25,145,69,3,22,43,8
S01010067,Owned: Total,45,38,32,2,30,5,1,7,5,1,1,0,0
S01010067,Owned: Owned outright,10,5,4,0,4,1,0,5,5,0,0,0,0
S01010067,Owned: Owned with a mortgage or loan or shared ownership,35,33,28,2,26,4,1,2,0,1,1,0,0
S01010067,Rented or living rent free: Total,252,114,83,27,56,7,24,138,64,2,21,43,8
S01010067,Rented or living rent free: Social rented,235,105,74,25,49,7,24,130,63,0,17,43,7
S01010067,Rented or living rent free: Private rented or living rent free,17,9,9,2,7,0,0,8,1,2,4,0,1
S01010068,All HRPs aged 16 and over,338,196,169,34,135,17,10,142,76,15,13,36,2
S01010068,Owned: Total,100,85,77,5,72,7,1,15,10,2,0,3,0
S01010068,Owned: Owned outright,19,8,7,0,7,1,0,11,8,2,0,1,0
S01010068,Owned: Owned with a mortgage or loan or shared ownership,81,77,70,5,65,6,1,4,2,0,0,2,0
S01010068,Rented or living rent free: Total,238,111,92,29,63,10,9,127,66,13,13,33,2
S01010068,Rented or living rent free: Social rented,135,37,27,11,16,5,5,98,65,0,4,27,2
S01010068,Rented or living rent free: Private rented or living rent free,103,74,65,18,47,5,4,29,1,13,9,6,0
S01010069,All HRPs aged 16 and over,340,256,219,26,193,34,3,84,70,4,2,5,3
S01010069,Owned: Total,294,235,201,15,186,31,3,59,53,2,1,2,1
S01010069,Owned: Owned outright,88,44,35,5,30,7,2,44,40,1,0,2,1
S01010069,Owned: Owned with a mortgage or loan or shared ownership,206,191,166,10,156,24,1,15,13,1,1,0,0
S01010069,Rented or living rent free: Total,46,21,18,11,7,3,0,25,17,2,1,3,2
S01010069,Rented or living rent free: Social rented,23,8,7,6,1,1,0,15,13,0,0,2,0
S01010069,Rented or living rent free: Private rented or living rent free,23,13,11,5,6,2,0,10,4,2,1,1,2
S01010070,All HRPs aged 16 and over,238,189,151,27,124,37,1,49,25,8,4,11,1
S01010070,Owned: Total,217,182,146,25,121,36,0,35,24,0,3,7,1
S01010070,Owned: Owned outright,59,32,29,9,20,3,0,27,22,0,2,3,0
S01010070,Owned: Owned with a mortgage or loan or shared ownership,158,150,117,16,101,33,0,8,2,0,1,4,1
S01010070,Rented or living rent free: Total,21,7,5,2,3,1,1,14,1,8,1,4,0
S01010070,Rented or living rent free: Social rented,4,1,1,1,0,0,0,3,0,0,1,2,0
S01010070,Rented or living rent free: Private rented or living rent free,17,6,4,1,3,1,1,11,1,8,0,2,0
S01010071,All HRPs aged 16 and over,367,210,174,31,143,26,10,157,112,4,4,25,12
S01010071,Owned: Total,251,174,145,21,124,25,4,77,69,1,0,1,6
S01010071,Owned: Owned outright,94,41,35,7,28,5,1,53,50,0,0,1,2
S01010071,Owned: Owned with a mortgage or loan or shared ownership,157,133,110,14,96,20,3,24,19,1,0,0,4
S01010071,Rented or living rent free: Total,116,36,29,10,19,1,6,80,43,3,4,24,6
S01010071,Rented or living rent free: Social rented,89,19,15,7,8,1,3,70,43,0,2,20,5
S01010071,Rented or living rent free: Private rented or living rent free,27,17,14,3,11,0,3,10,0,3,2,4,1
S01010072,All HRPs aged 16 and over,370,221,188,26,162,21,12,149,119,0,5,21,4
S01010072,Owned: Total,268,180,156,15,141,20,4,88,79,0,1,6,2
S01010072,Owned: Owned outright,110,45,39,7,32,6,0,65,60,0,1,2,2
S01010072,Owned: Owned with a mortgage or loan or shared ownership,158,135,117,8,109,14,4,23,19,0,0,4,0
S01010072,Rented or living rent free: Total,102,41,32,11,21,1,8,61,40,0,4,15,2
S01010072,Rented or living rent free: Social rented,82,33,26,11,15,1,6,49,32,0,3,12,2
S01010072,Rented or living rent free: Private rented or living rent free,20,8,6,0,6,0,2,12,8,0,1,3,0
S01010073,All HRPs aged 16 and over,349,188,158,23,135,23,7,161,145,3,2,8,3
S01010073,Owned: Total,299,172,145,17,128,22,5,127,121,1,1,3,1
S01010073,Owned: Owned outright,167,54,44,7,37,7,3,113,110,0,1,1,1
S01010073,Owned: Owned with a mortgage or loan or shared ownership,132,118,101,10,91,15,2,14,11,1,0,2,0
S01010073,Rented or living rent free: Total,50,16,13,6,7,1,2,34,24,2,1,5,2
S01010073,Rented or living rent free: Social rented,38,8,7,4,3,1,0,30,22,2,0,4,2
S01010073,Rented or living rent free: Private rented or living rent free,12,8,6,2,4,0,2,4,2,0,1,1,0
S01010074,All HRPs aged 16 and over,306,191,158,31,127,25,8,115,99,1,5,6,4
S01010074,Owned: Total,282,175,144,23,121,24,7,107,95,0,4,4,4
S01010074,Owned: Owned outright,149,58,44,12,32,11,3,91,82,0,4,3,2
S01010074,Owned: Owned with a mortgage or loan or shared ownership,133,117,100,11,89,13,4,16,13,0,0,1,2
S01010074,Rented or living rent free: Total,24,16,14,8,6,1,1,8,4,1,1,2,0
S01010074,Rented or living rent free: Social rented,10,3,3,3,0,0,0,7,4,1,0,2,0
S01010074,Rented or living rent free: Private rented or living rent free,14,13,11,5,6,1,1,1,0,0,1,0,0
S01010075,All HRPs aged 16 and over,303,137,119,25,94,9,9,166,132,3,7,21,3
S01010075,Owned: Total,207,102,93,15,78,5,4,105,95,1,0,8,1
S01010075,Owned: Owned outright,89,20,18,7,11,0,2,69,66,1,0,2,0
S01010075,Owned: Owned with a mortgage or loan or shared ownership,118,82,75,8,67,5,2,36,29,0,0,6,1
S01010075,Rented or living rent free: Total,96,35,26,10,16,4,5,61,37,2,7,13,2
S01010075,Rented or living rent free: Social rented,80,26,19,7,12,2,5,54,34,2,4,12,2
S01010075,Rented or living rent free: Private rented or living rent free,16,9,7,3,4,2,0,7,3,0,3,1,0
S01010076,All HRPs aged 16 and over,276,174,146,30,116,19,9,102,70,1,4,23,4
S01010076,Owned: Total,188,133,112,17,95,18,3,55,48,0,0,6,1
S01010076,Owned: Owned outright,56,21,16,3,13,4,1,35,33,0,0,1,1
S01010076,Owned: Owned with a mortgage or loan or shared ownership,132,112,96,14,82,14,2,20,15,0,0,5,0
S01010076,Rented or living rent free: Total,88,41,34,13,21,1,6,47,22,1,4,17,3
S01010076,Rented or living rent free: Social rented,68,26,22,6,16,1,3,42,22,0,3,14,3
S01010076,Rented or living rent free: Private rented or living rent free,20,15,12,7,5,0,3,5,0,1,1,3,0
S01010077,All HRPs aged 16 and over,302,149,125,28,97,14,10,153,85,7,10,41,10
S01010077,Owned: Total,137,86,74,9,65,8,4,51,46,0,1,3,1
S01010077,Owned: Owned outright,46,14,12,1,11,2,0,32,30,0,0,1,1
S01010077,Owned: Owned with a mortgage or loan or shared ownership,91,72,62,8,54,6,4,19,16,0,1,2,0
S01010077,Rented or living rent free: Total,165,63,51,19,32,6,6,102,39,7,9,38,9
S01010077,Rented or living rent free: Social rented,143,51,42,15,27,3,6,92,37,3,7,36,9
S01010077,Rented or living rent free: Private rented or living rent free,22,12,9,4,5,3,0,10,2,4,2,2,0
S01010078,All HRPs aged 16 and over,229,177,146,20,126,26,5,52,44,0,1,5,2
S01010078,Owned: Total,208,163,135,17,118,25,3,45,42,0,0,2,1
S01010078,Owned: Owned outright,81,51,41,5,36,9,1,30,28,0,0,1,1
S01010078,Owned: Owned with a mortgage or loan or shared ownership,127,112,94,12,82,16,2,15,14,0,0,1,0
S01010078,Rented or living rent free: Total,21,14,11,3,8,1,2,7,2,0,1,3,1
S01010078,Rented or living rent free: Social rented,13,8,6,0,6,1,1,5,1,0,0,3,1
S01010078,Rented or living rent free: Private rented or living rent free,8,6,5,3,2,0,1,2,1,0,1,0,0
S01010079,All HRPs aged 16 and over,349,232,174,19,155,54,4,117,110,0,1,6,0
S01010079,Owned: Total,320,212,160,16,144,51,1,108,103,0,1,4,0
S01010079,Owned: Owned outright,152,58,44,7,37,13,1,94,92,0,1,1,0
S01010079,Owned: Owned with a mortgage or loan or shared ownership,168,154,116,9,107,38,0,14,11,0,0,3,0
S01010079,Rented or living rent free: Total,29,20,14,3,11,3,3,9,7,0,0,2,0
S01010079,Rented or living rent free: Social rented,9,6,5,1,4,1,0,3,1,0,0,2,0
S01010079,Rented or living rent free: Private rented or living rent free,20,14,9,2,7,2,3,6,6,0,0,0,0
S01010080,All HRPs aged 16 and over,284,160,129,16,113,29,2,124,118,2,2,2,0
S01010080,Owned: Total,269,149,120,16,104,27,2,120,115,1,2,2,0
S01010080,Owned: Owned outright,165,50,37,7,30,12,1,115,112,1,1,1,0
S01010080,Owned: Owned with a mortgage or loan or shared ownership,104,99,83,9,74,15,1,5,3,0,1,1,0
S01010080,Rented or living rent free: Total,15,11,9,0,9,2,0,4,3,1,0,0,0
S01010080,Rented or living rent free: Social rented,5,4,3,0,3,1,0,1,1,0,0,0,0
S01010080,Rented or living rent free: Private rented or living rent free,10,7,6,0,6,1,0,3,2,1,0,0,0
S01010081,All HRPs aged 16 and over,300,172,121,16,105,47,4,128,112,5,3,7,1
S01010081,Owned: Total,271,157,110,13,97,44,3,114,106,2,2,3,1
S01010081,Owned: Owned outright,151,48,31,7,24,16,1,103,100,1,0,1,1
S01010081,Owned: Owned with a mortgage or loan or shared ownership,120,109,79,6,73,28,2,11,6,1,2,2,0
S01010081,Rented or living rent free: Total,29,15,11,3,8,3,1,14,6,3,1,4,0
S01010081,Rented or living rent free: Social rented,12,6,4,1,3,2,0,6,1,2,0,3,0
S01010081,Rented or living rent free: Private rented or living rent free,17,9,7,2,5,1,1,8,5,1,1,1,0
S01010082,All HRPs aged 16 and over,407,255,192,23,169,48,15,152,117,8,8,14,5
S01010082,Owned: Total,314,206,160,16,144,44,2,108,100,1,1,4,2
S01010082,Owned: Owned outright,152,59,48,6,42,10,1,93,91,0,0,1,1
S01010082,Owned: Owned with a mortgage or loan or shared ownership,162,147,112,10,102,34,1,15,9,1,1,3,1
S01010082,Rented or living rent free: Total,93,49,32,7,25,4,13,44,17,7,7,10,3
S01010082,Rented or living rent free: Social rented,5,1,1,0,1,0,0,4,0,1,0,2,1
S01010082,Rented or living rent free: Private rented or living rent free,88,48,31,7,24,4,13,40,17,6,7,8,2
S01010083,All HRPs aged 16 and over,348,168,135,24,111,19,14,180,120,12,7,35,6
S01010083,Owned: Total,218,128,103,12,91,17,8,90,78,0,0,11,1
S01010083,Owned: Owned outright,84,25,19,4,15,5,1,59,56,0,0,2,1
S01010083,Owned: Owned with a mortgage or loan or shared ownership,134,103,84,8,76,12,7,31,22,0,0,9,0
S01010083,Rented or living rent free: Total,130,40,32,12,20,2,6,90,42,12,7,24,5
S01010083,Rented or living rent free: Social rented,99,26,22,10,12,1,3,73,40,3,5,22,3
S01010083,Rented or living rent free: Private rented or living rent free,31,14,10,2,8,1,3,17,2,9,2,2,2
S01010084,All HRPs aged 16 and over,442,221,194,43,151,11,16,221,144,0,13,54,10
S01010084,Owned: Total,250,147,135,27,108,9,3,103,90,0,1,10,2
S01010084,Owned: Owned outright,92,36,31,7,24,4,1,56,53,0,0,2,1
S01010084,Owned: Owned with a mortgage or loan or shared ownership,158,111,104,20,84,5,2,47,37,0,1,8,1
S01010084,Rented or living rent free: Total,192,74,59,16,43,2,13,118,54,0,12,44,8
S01010084,Rented or living rent free: Social rented,156,52,41,10,31,2,9,104,49,0,8,39,8
S01010084,Rented or living rent free: Private rented or living rent free,36,22,18,6,12,0,4,14,5,0,4,5,0
S01010085,All HRPs aged 16 and over,311,191,157,18,139,25,9,120,105,0,5,8,2
S01010085,Owned: Total,287,182,151,16,135,25,6,105,99,0,2,3,1
S01010085,Owned: Owned outright,139,43,28,9,19,11,4,96,95,0,0,1,0
S01010085,Owned: Owned with a mortgage or loan or shared ownership,148,139,123,7,116,14,2,9,4,0,2,2,1
S01010085,Rented or living rent free: Total,24,9,6,2,4,0,3,15,6,0,3,5,1
S01010085,Rented or living rent free: Social rented,11,2,2,0,2,0,0,9,3,0,1,5,0
S01010085,Rented or living rent free: Private rented or living rent free,13,7,4,2,2,0,3,6,3,0,2,0,1
S01010086,All HRPs aged 16 and over,414,190,160,34,126,17,13,224,142,4,16,48,14
S01010086,Owned: Total,224,130,113,21,92,14,3,94,82,0,2,8,2
S01010086,Owned: Owned outright,88,26,21,7,14,5,0,62,59,0,1,2,0
S01010086,Owned: Owned with a mortgage or loan or shared ownership,136,104,92,14,78,9,3,32,23,0,1,6,2
S01010086,Rented or living rent free: Total,190,60,47,13,34,3,10,130,60,4,14,40,12
S01010086,Rented or living rent free: Social rented,170,48,41,12,29,2,5,122,59,4,11,37,11
S01010086,Rented or living rent free: Private rented or living rent free,20,12,6,1,5,1,5,8,1,0,3,3,1
S01010087,All HRPs aged 16 and over,247,131,102,14,88,27,2,116,104,0,2,8,2
S01010087,Owned: Total,235,128,99,13,86,27,2,107,100,0,0,5,2
S01010087,Owned: Owned outright,146,49,37,8,29,10,2,97,94,0,0,1,2
S01010087,Owned: Owned with a mortgage or loan or shared ownership,89,79,62,5,57,17,0,10,6,0,0,4,0
S01010087,Rented or living rent free: Total,12,3,3,1,2,0,0,9,4,0,2,3,0
S01010087,Rented or living rent free: Social rented,5,0,0,0,0,0,0,5,2,0,2,1,0
S01010087,Rented or living rent free: Private rented or living rent free,7,3,3,1,2,0,0,4,2,0,0,2,0
S01010088,All HRPs aged 16 and over,295,274,212,16,196,56,6,21,9,3,3,4,2
S01010088,Owned: Total,246,239,182,13,169,52,5,7,5,0,1,1,0
S01010088,Owned: Owned outright,18,15,11,3,8,3,1,3,3,0,0,0,0
S01010088,Owned: Owned with a mortgage or loan or shared ownership,228,224,171,10,161,49,4,4,2,0,1,1,0
S01010088,Rented or living rent free: Total,49,35,30,3,27,4,1,14,4,3,2,3,2
S01010088,Rented or living rent free: Social rented,13,7,6,1,5,1,0,6,3,1,0,2,0
S01010088,Rented or living rent free: Private rented or living rent free,36,28,24,2,22,3,1,8,1,2,2,1,2
S01010089,All HRPs aged 16 and over,365,196,162,33,129,19,15,169,112,14,4,34,5
S01010089,Owned: Total,206,131,111,19,92,15,5,75,65,1,0,8,1
S01010089,Owned: Owned outright,85,28,23,7,16,3,2,57,52,0,0,5,0
S01010089,Owned: Owned with a mortgage or loan or shared ownership,121,103,88,12,76,12,3,18,13,1,0,3,1
S01010089,Rented or living rent free: Total,159,65,51,14,37,4,10,94,47,13,4,26,4
S01010089,Rented or living rent free: Social rented,87,25,19,10,9,3,3,62,40,1,2,17,2
S01010089,Rented or living rent free: Private rented or living rent free,72,40,32,4,28,1,7,32,7,12,2,9,2
S01010090,All HRPs aged 16 and over,435,314,270,40,230,35,9,121,79,12,7,17,6
S01010090,Owned: Total,313,257,222,23,199,30,5,56,49,1,0,4,2
S01010090,Owned: Owned outright,99,50,45,11,34,4,1,49,44,1,0,3,1
S01010090,Owned: Owned with a mortgage or loan or shared ownership,214,207,177,12,165,26,4,7,5,0,0,1,1
S01010090,Rented or living rent free: Total,122,57,48,17,31,5,4,65,30,11,7,13,4
S01010090,Rented or living rent free: Social rented,50,12,8,3,5,3,1,38,23,2,2,9,2
S01010090,Rented or living rent free: Private rented or living rent free,72,45,40,14,26,2,3,27,7,9,5,4,2
S01010091,All HRPs aged 16 and over,343,286,239,32,207,35,12,57,34,6,6,10,1
S01010091,Owned: Total,204,188,159,12,147,28,1,16,12,1,1,1,1
S01010091,Owned: Owned outright,35,23,17,6,11,6,0,12,11,0,0,0,1
S01010091,Owned: Owned with a mortgage or loan or shared ownership,169,165,142,6,136,22,1,4,1,1,1,1,0
S01010091,Rented or living rent free: Total,139,98,80,20,60,7,11,41,22,5,5,9,0
S01010091,Rented or living rent free: Social rented,90,58,48,13,35,4,6,32,21,0,4,7,0
S01010091,Rented or living rent free: Private rented or living rent free,49,40,32,7,25,3,5,9,1,5,1,2,0
S01010092,All HRPs aged 16 and over,446,189,159,35,124,16,14,257,161,14,18,47,17
S01010092,Owned: Total,215,118,104,20,84,13,1,97,83,2,1,8,3
S01010092,Owned: Owned outright,93,28,27,8,19,1,0,65,58,0,1,3,3
S01010092,Owned: Owned with a mortgage or loan or shared ownership,122,90,77,12,65,12,1,32,25,2,0,5,0
S01010092,Rented or living rent free: Total,231,71,55,15,40,3,13,160,78,12,17,39,14
S01010092,Rented or living rent free: Social rented,180,49,39,9,30,3,7,131,71,3,8,37,12
S01010092,Rented or living rent free: Private rented or living rent free,51,22,16,6,10,0,6,29,7,9,9,2,2
S01010093,All HRPs aged 16 and over,386,253,207,34,173,32,14,133,94,7,8,20,4
S01010093,Owned: Total,295,207,179,26,153,26,2,88,76,2,2,6,2
S01010093,Owned: Owned outright,107,34,28,13,15,4,2,73,67,1,1,2,2
S01010093,Owned: Owned with a mortgage or loan or shared ownership,188,173,151,13,138,22,0,15,9,1,1,4,0
S01010093,Rented or living rent free: Total,91,46,28,8,20,6,12,45,18,5,6,14,2
S01010093,Rented or living rent free: Social rented,35,12,8,4,4,1,3,23,12,1,3,7,0
S01010093,Rented or living rent free: Private rented or living rent free,56,34,20,4,16,5,9,22,6,4,3,7,2
S01010094,All HRPs aged 16 and over,291,174,149,25,124,21,4,117,107,1,0,6,3
S01010094,Owned: Total,239,160,139,21,118,21,0,79,76,0,0,3,0
S01010094,Owned: Owned outright,127,54,45,12,33,9,0,73,71,0,0,2,0
S01010094,Owned: Owned with a mortgage or loan or shared ownership,112,106,94,9,85,12,0,6,5,0,0,1,0
S01010094,Rented or living rent free: Total,52,14,10,4,6,0,4,38,31,1,0,3,3
S01010094,Rented or living rent free: Social rented,41,5,4,0,4,0,1,36,31,1,0,1,3
S01010094,Rented or living rent free: Private rented or living rent free,11,9,6,4,2,0,3,2,0,0,0,2,0
S01010095,All HRPs aged 16 and over,279,180,148,26,122,27,5,99,86,2,3,6,2
S01010095,Owned: Total,272,177,145,24,121,27,5,95,86,1,2,5,1
S01010095,Owned: Owned outright,128,46,36,13,23,7,3,82,76,0,1,4,1
S01010095,Owned: Owned with a mortgage or loan or shared ownership,144,131,109,11,98,20,2,13,10,1,1,1,0
S01010095,Rented or living rent free: Total,7,3,3,2,1,0,0,4,0,1,1,1,1
S01010095,Rented or living rent free: Social rented,0,0,0,0,0,0,0,0,0,0,0,0,0
S01010095,Rented or living rent free: Private rented or living rent free,7,3,3,2,1,0,0,4,0,1,1,1,1
S01010096,All HRPs aged 16 and over,292,204,175,28,147,25,4,88,71,1,3,12,1
S01010096,Owned: Total,277,193,167,24,143,24,2,84,70,0,3,10,1
S01010096,Owned: Owned outright,122,51,42,10,32,8,1,71,62,0,1,7,1
S01010096,Owned: Owned with a mortgage or loan or shared ownership,155,142,125,14,111,16,1,13,8,0,2,3,0
S01010096,Rented or living rent free: Total,15,11,8,4,4,1,2,4,1,1,0,2,0
S01010096,Rented or living rent free: Social rented,5,2,1,0,1,0,1,3,1,1,0,1,0
S01010096,Rented or living rent free: Private rented or living rent free,10,9,7,4,3,1,1,1,0,0,0,1,0
S01010097,All HRPs aged 16 and over,286,169,133,20,113,26,10,117,88,2,11,13,3
S01010097,Owned: Total,233,151,124,13,111,22,5,82,69,1,3,7,2
S01010097,Owned: Owned outright,108,42,31,6,25,7,4,66,58,1,2,4,1
S01010097,Owned: Owned with a mortgage or loan or shared ownership,125,109,93,7,86,15,1,16,11,0,1,3,1
S01010097,Rented or living rent free: Total,53,18,9,7,2,4,5,35,19,1,8,6,1
S01010097,Rented or living rent free: Social rented,28,7,4,3,1,2,1,21,17,0,2,2,0
S01010097,Rented or living rent free: Private rented or living rent free,25,11,5,4,1,2,4,14,2,1,6,4,1
S01010098,All HRPs aged 16 and over,277,180,153,16,137,23,4,97,87,0,1,6,3
S01010098,Owned: Total,269,176,149,16,133,23,4,93,86,0,0,5,2
S01010098,Owned: Owned outright,129,48,41,9,32,6,1,81,80,0,0,0,1
S01010098,Owned: Owned with a mortgage or loan or shared ownership,140,128,108,7,101,17,3,12,6,0,0,5,1
S01010098,Rented or living rent free: Total,8,4,4,0,4,0,0,4,1,0,1,1,1
S01010098,Rented or living rent free: Social rented,2,0,0,0,0,0,0,2,0,0,1,1,0
S01010098,Rented or living rent free: Private rented or living rent free,6,4,4,0,4,0,0,2,1,0,0,0,1
S01010099,All HRPs aged 16 and over,285,170,140,16,124,24,6,115,104,0,3,8,0
S01010099,Owned: Total,267,160,133,14,119,22,5,107,100,0,1,6,0
S01010099,Owned: Owned outright,142,47,40,8,32,4,3,95,90,0,1,4,0
S01010099,Owned: Owned with a mortgage or loan or shared ownership,125,113,93,6,87,18,2,12,10,0,0,2,0
S01010099,Rented or living rent free: Total,18,10,7,2,5,2,1,8,4,0,2,2,0
S01010099,Rented or living rent free: Social rented,4,1,0,0,0,1,0,3,3,0,0,0,0
S01010099,Rented or living rent free: Private rented or living rent free,14,9,7,2,5,1,1,5,1,0,2,2,0
S01010100,All HRPs aged 16 and over,382,223,192,27,165,30,1,159,137,1,2,16,3
S01010100,Owned: Total,341,204,174,21,153,30,0,137,125,0,0,9,3
S01010100,Owned: Owned outright,150,42,38,9,29,4,0,108,107,0,0,1,0
S01010100,Owned: Owned with a mortgage or loan or shared ownership,191,162,136,12,124,26,0,29,18,0,0,8,3
S01010100,Rented or living rent free: Total,41,19,18,6,12,0,1,22,12,1,2,7,0
S01010100,Rented or living rent free: Social rented,23,7,6,3,3,0,1,16,9,0,1,6,0
S01010100,Rented or living rent free: Private rented or living rent free,18,12,12,3,9,0,0,6,3,1,1,1,0
S01010101,All HRPs aged 16 and over,299,193,158,18,140,28,7,106,89,5,1,9,2
S01010101,Owned: Total,264,174,142,15,127,28,4,90,82,2,0,4,2
S01010101,Owned: Owned outright,120,52,43,5,38,7,2,68,66,0,0,1,1
S01010101,Owned: Owned with a mortgage or loan or shared ownership,144,122,99,10,89,21,2,22,16,2,0,3,1
S01010101,Rented or living rent free: Total,35,19,16,3,13,0,3,16,7,3,1,5,0
S01010101,Rented or living rent free: Social rented,10,7,7,1,6,0,0,3,1,2,0,0,0
S01010101,Rented or living rent free: Private rented or living rent free,25,12,9,2,7,0,3,13,6,1,1,5,0
S01010102,All HRPs aged 16 and over,324,280,241,24,217,32,7,44,30,3,3,6,2
S01010102,Owned: Total,298,263,231,18,213,29,3,35,29,0,1,4,1
S01010102,Owned: Owned outright,60,37,35,5,30,2,0,23,20,0,0,2,1
S01010102,Owned: Owned with a mortgage or loan or shared ownership,238,226,196,13,183,27,3,12,9,0,1,2,0
S01010102,Rented or living rent free: Total,26,17,10,6,4,3,4,9,1,3,2,2,1
S01010102,Rented or living rent free: Social rented,9,4,2,2,0,1,1,5,1,3,0,1,0
S01010102,Rented or living rent free: Private rented or living rent free,17,13,8,4,4,2,3,4,0,0,2,1,1
S01010103,All HRPs aged 16 and over,355,312,247,33,214,60,5,43,33,0,2,5,3
S01010103,Owned: Total,331,295,233,29,204,58,4,36,30,0,2,2,2
S01010103,Owned: Owned outright,67,41,29,8,21,11,1,26,25,0,0,0,1
S01010103,Owned: Owned with a mortgage or loan or shared ownership,264,254,204,21,183,47,3,10,5,0,2,2,1
S01010103,Rented or living rent free: Total,24,17,14,4,10,2,1,7,3,0,0,3,1
S01010103,Rented or living rent free: Social rented,3,2,1,1,0,1,0,1,1,0,0,0,0
S01010103,Rented or living rent free: Private rented or living rent free,21,15,13,3,10,1,1,6,2,0,0,3,1
S01010104,All HRPs aged 16 and over,267,236,199,21,178,33,4,31,16,3,3,7,2
S01010104,Owned: Total,244,221,186,18,168,32,3,23,13,1,2,5,2
S01010104,Owned: Owned outright,33,19,17,1,16,2,0,14,10,0,0,3,1
S01010104,Owned: Owned with a mortgage or loan or shared ownership,211,202,169,17,152,30,3,9,3,1,2,2,1
S01010104,Rented or living rent free: Total,23,15,13,3,10,1,1,8,3,2,1,2,0
S01010104,Rented or living rent free: Social rented,5,2,2,1,1,0,0,3,1,1,0,1,0
S01010104,Rented or living rent free: Private rented or living rent free,18,13,11,2,9,1,1,5,2,1,1,1,0
S01010105,All HRPs aged 16 and over,165,108,84,23,61,3,21,57,16,2,13,22,4
S01010105,Owned: Total,48,40,34,8,26,2,4,8,5,0,0,3,0
S01010105,Owned: Owned outright,12,8,7,2,5,0,1,4,3,0,0,1,0
S01010105,Owned: Owned with a mortgage or loan or shared ownership,36,32,27,6,21,2,3,4,2,0,0,2,0
S01010105,Rented or living rent free: Total,117,68,50,15,35,1,17,49,11,2,13,19,4
S01010105,Rented or living rent free: Social rented,85,48,36,15,21,1,11,37,9,0,11,15,2
S01010105,Rented or living rent free: Private rented or living rent free,32,20,14,0,14,0,6,12,2,2,2,4,2
S01010106,All HRPs aged 16 and over,219,107,83,19,64,6,18,112,59,2,8,34,9
S01010106,Owned: Total,81,40,33,5,28,6,1,41,35,0,0,5,1
S01010106,Owned: Owned outright,39,12,11,2,9,1,0,27,23,0,0,4,0
S01010106,Owned: Owned with a mortgage or loan or shared ownership,42,28,22,3,19,5,1,14,12,0,0,1,1
S01010106,Rented or living rent free: Total,138,67,50,14,36,0,17,71,24,2,8,29,8
S01010106,Rented or living rent free: Social rented,128,63,48,13,35,0,15,65,22,0,8,27,8
S01010106,Rented or living rent free: Private rented or living rent free,10,4,2,1,1,0,2,6,2,2,0,2,0
S01010107,All HRPs aged 16 and over,404,235,186,45,141,23,26,169,67,22,13,58,9
S01010107,Owned: Total,149,130,110,15,95,16,4,19,12,4,0,3,0
S01010107,Owned: Owned outright,25,18,13,2,11,4,1,7,6,1,0,0,0
S01010107,Owned: Owned with a mortgage or loan or shared ownership,124,112,97,13,84,12,3,12,6,3,0,3,0
S01010107,Rented or living rent free: Total,255,105,76,30,46,7,22,150,55,18,13,55,9
S01010107,Rented or living rent free: Social rented,159,45,33,11,22,2,10,114,53,3,9,42,7
S01010107,Rented or living rent free: Private rented or living rent free,96,60,43,19,24,5,12,36,2,15,4,13,2
S01010108,All HRPs aged 16 and over,374,206,172,32,140,22,12,168,105,5,5,46,7
S01010108,Owned: Total,199,157,134,19,115,22,1,42,33,2,2,5,0
S01010108,Owned: Owned outright,41,19,19,4,15,0,0,22,20,0,0,2,0
S01010108,Owned: Owned with a mortgage or loan or shared ownership,158,138,115,15,100,22,1,20,13,2,2,3,0
S01010108,Rented or living rent free: Total,175,49,38,13,25,0,11,126,72,3,3,41,7
S01010108,Rented or living rent free: Social rented,152,40,30,12,18,0,10,112,65,2,0,39,6
S01010108,Rented or living rent free: Private rented or living rent free,23,9,8,1,7,0,1,14,7,1,3,2,1
S01010109,All HRPs aged 16 and over,326,225,183,43,140,19,23,101,27,12,15,39,8
S01010109,Owned: Total,160,136,123,18,105,12,1,24,15,3,1,4,1
S01010109,Owned: Owned outright,37,22,20,3,17,1,1,15,11,3,0,1,0
S01010109,Owned: Owned with a mortgage or loan or shared ownership,123,114,103,15,88,11,0,9,4,0,1,3,1
S01010109,Rented or living rent free: Total,166,89,60,25,35,7,22,77,12,9,14,35,7
S01010109,Rented or living rent free: Social rented,84,47,33,11,22,2,12,37,8,0,4,24,1
S01010109,Rented or living rent free: Private rented or living rent free,82,42,27,14,13,5,10,40,4,9,10,11,6
S01010110,All HRPs aged 16 and over,431,199,164,66,98,6,29,232,137,6,15,58,16
S01010110,Owned: Total,97,54,53,11,42,0,1,43,42,0,0,0,1
S01010110,Owned: Owned outright,46,19,18,5,13,0,1,27,26,0,0,0,1
S01010110,Owned: Owned with a mortgage or loan or shared ownership,51,35,35,6,29,0,0,16,16,0,0,0,0
S01010110,Rented or living rent free: Total,334,145,111,55,56,6,28,189,95,6,15,58,15
S01010110,Rented or living rent free: Social rented,313,132,100,47,53,6,26,181,89,6,14,57,15
S01010110,Rented or living rent free: Private rented or living rent free,21,13,11,8,3,0,2,8,6,0,1,1,0
S01010111,All HRPs aged 16 and over,446,214,161,58,103,16,37,232,86,7,30,87,22
S01010111,Owned: Total,52,40,35,7,28,5,0,12,9,0,2,0,1
S01010111,Owned: Owned outright,15,9,9,2,7,0,0,6,5,0,0,0,1
S01010111,Owned: Owned with a mortgage or loan or shared ownership,37,31,26,5,21,5,0,6,4,0,2,0,0
S01010111,Rented or living rent free: Total,394,174,126,51,75,11,37,220,77,7,28,87,21
S01010111,Rented or living rent free: Social rented,378,163,122,50,72,5,36,215,77,5,27,86,20
S01010111,Rented or living rent free: Private rented or living rent free,16,11,4,1,3,6,1,5,0,2,1,1,1
S01010112,All HRPs aged 16 and over,419,228,165,66,99,13,50,191,54,9,23,85,20
S01010112,Owned: Total,33,23,20,4,16,2,1,10,4,1,1,4,0
S01010112,Owned: Owned outright,5,1,0,0,0,1,0,4,3,0,0,1,0
S01010112,Owned: Owned with a mortgage or loan or shared ownership,28,22,20,4,16,1,1,6,1,1,1,3,0
S01010112,Rented or living rent free: Total,386,205,145,62,83,11,49,181,50,8,22,81,20
S01010112,Rented or living rent free: Social rented,383,203,145,62,83,10,48,180,50,8,22,80,20
S01010112,Rented or living rent free: Private rented or living rent free,3,2,0,0,0,1,1,1,0,0,0,1,0
S01010113,All HRPs aged 16 and over,244,130,99,38,61,6,25,114,41,8,20,32,13
S01010113,Owned: Total,57,48,42,9,33,4,2,9,3,1,0,4,1
S01010113,Owned: Owned outright,12,9,8,3,5,1,0,3,2,0,0,1,0
S01010113,Owned: Owned with a mortgage or loan or shared ownership,45,39,34,6,28,3,2,6,1,1,0,3,1
S01010113,Rented or living rent free: Total,187,82,57,29,28,2,23,105,38,7,20,28,12
S01010113,Rented or living rent free: Social rented,153,63,42,22,20,2,19,90,36,3,14,25,12
S01010113,Rented or living rent free: Private rented or living rent free,34,19,15,7,8,0,4,15,2,4,6,3,0
S01010114,All HRPs aged 16 and over,366,159,125,44,81,4,30,207,80,4,29,73,21
S01010114,Owned: Total,31,22,19,2,17,1,2,9,5,1,0,3,0
S01010114,Owned: Owned outright,11,6,6,1,5,0,0,5,3,0,0,2,0
S01010114,Owned: Owned with a mortgage or loan or shared ownership,20,16,13,1,12,1,2,4,2,1,0,1,0
S01010114,Rented or living rent free: Total,335,137,106,42,64,3,28,198,75,3,29,70,21
S01010114,Rented or living rent free: Social rented,330,134,103,41,62,3,28,196,75,3,29,68,21
S01010114,Rented or living rent free: Private rented or living rent free,5,3,3,1,2,0,0,2,0,0,0,2,0
S01010115,All HRPs aged 16 and over,230,186,153,27,126,23,10,44,22,2,7,10,3
S01010115,Owned: Total,175,156,134,19,115,18,4,19,13,0,3,2,1
S01010115,Owned: Owned outright,37,25,20,6,14,5,0,12,9,0,1,2,0
S01010115,Owned: Owned with a mortgage or loan or shared ownership,138,131,114,13,101,13,4,7,4,0,2,0,1
S01010115,Rented or living rent free: Total,55,30,19,8,11,5,6,25,9,2,4,8,2
S01010115,Rented or living rent free: Social rented,29,15,10,4,6,1,4,14,7,1,1,4,1
S01010115,Rented or living rent free: Private rented or living rent free,26,15,9,4,5,4,2,11,2,1,3,4,1
S01010116,All HRPs aged 16 and over,397,327,280,45,235,31,16,70,23,17,13,10,7
S01010116,Owned: Total,283,258,228,25,203,26,4,25,16,1,3,4,1
S01010116,Owned: Owned outright,35,20,14,3,11,5,1,15,12,0,1,2,0
S01010116,Owned: Owned with a mortgage or loan or shared ownership,248,238,214,22,192,21,3,10,4,1,2,2,1
S01010116,Rented or living rent free: Total,114,69,52,20,32,5,12,45,7,16,10,6,6
S01010116,Rented or living rent free: Social rented,47,26,20,10,10,2,4,21,4,3,4,6,4
S01010116,Rented or living rent free: Private rented or living rent free,67,43,32,10,22,3,8,24,3,13,6,0,2
S01010117,All HRPs aged 16 and over,261,212,172,14,158,31,9,49,22,4,3,14,6
S01010117,Owned: Total,194,177,147,9,138,25,5,17,15,0,1,1,0
S01010117,Owned: Owned outright,20,10,10,1,9,0,0,10,10,0,0,0,0
S01010117,Owned: Owned with a mortgage or loan or shared ownership,174,167,137,8,129,25,5,7,5,0,1,1,0
S01010117,Rented or living rent free: Total,67,35,25,5,20,6,4,32,7,4,2,13,6
S01010117,Rented or living rent free: Social rented,44,17,13,2,11,4,0,27,7,2,0,12,6
S01010117,Rented or living rent free: Private rented or living rent free,23,18,12,3,9,2,4,5,0,2,2,1,0
S01010118,All HRPs aged 16 and over,277,121,94,41,53,5,22,156,49,2,21,63,21
S01010118,Owned: Total,20,11,7,5,2,3,1,9,9,0,0,0,0
S01010118,Owned: Owned outright,12,5,3,3,0,2,0,7,7,0,0,0,0
S01010118,Owned: Owned with a mortgage or loan or shared ownership,8,6,4,2,2,1,1,2,2,0,0,0,0
S01010118,Rented or living rent free: Total,257,110,87,36,51,2,21,147,40,2,21,63,21
S01010118,Rented or living rent free: Social rented,249,106,83,33,50,2,21,143,39,2,21,63,18
S01010118,Rented or living rent free: Private rented or living rent free,8,4,4,3,1,0,0,4,1,0,0,0,3
S01010119,All HRPs aged 16 and over,209,138,112,38,74,6,20,71,19,2,13,27,10
S01010119,Owned: Total,31,29,27,4,23,2,0,2,1,0,0,1,0
S01010119,Owned: Owned outright,1,0,0,0,0,0,0,1,1,0,0,0,0
S01010119,Owned: Owned with a mortgage or loan or shared ownership,30,29,27,4,23,2,0,1,0,0,0,1,0
S01010119,Rented or living rent free: Total,178,109,85,34,51,4,20,69,18,2,13,26,10
S01010119,Rented or living rent free: Social rented,170,103,80,29,51,4,19,67,18,2,12,26,9
S01010119,Rented or living rent free: Private rented or living rent free,8,6,5,5,0,0,1,2,0,0,1,0,1
S01010120,All HRPs aged 16 and over,444,223,167,51,116,8,48,221,68,10,37,80,26
S01010120,Owned: Total,53,41,35,6,29,5,1,12,9,0,1,2,0
S01010120,Owned: Owned outright,8,1,1,1,0,0,0,7,6,0,0,1,0
S01010120,Owned: Owned with a mortgage or loan or shared ownership,45,40,34,5,29,5,1,5,3,0,1,1,0
S01010120,Rented or living rent free: Total,391,182,132,45,87,3,47,209,59,10,36,78,26
S01010120,Rented or living rent free: Social rented,380,177,129,44,85,3,45,203,57,8,34,78,26
S01010120,Rented or living rent free: Private rented or living rent free,11,5,3,1,2,0,2,6,2,2,2,0,0
S01010121,All HRPs aged 16 and over,321,165,129,41,88,8,28,156,70,5,15,56,10
S01010121,Owned: Total,25,21,19,2,17,2,0,4,4,0,0,0,0
S01010121,Owned: Owned outright,6,2,1,0,1,1,0,4,4,0,0,0,0
S01010121,Owned: Owned with a mortgage or loan or shared ownership,19,19,18,2,16,1,0,0,0,0,0,0,0
S01010121,Rented or living rent free: Total,296,144,110,39,71,6,28,152,66,5,15,56,10
S01010121,Rented or living rent free: Social rented,289,140,108,38,70,6,26,149,65,5,15,54,10
S01010121,Rented or living rent free: Private rented or living rent free,7,4,2,1,1,0,2,3,1,0,0,2,0
S01010122,All HRPs aged 16 and over,198,80,57,15,42,4,19,118,45,4,11,49,9
S01010122,Owned: Total,21,11,11,2,9,0,0,10,8,0,0,2,0
S01010122,Owned: Owned outright,14,6,6,1,5,0,0,8,8,0,0,0,0
S01010122,Owned: Owned with a mortgage or loan or shared ownership,7,5,5,1,4,0,0,2,0,0,0,2,0
S01010122,Rented or living rent free: Total,177,69,46,13,33,4,19,108,37,4,11,47,9
S01010122,Rented or living rent free: Social rented,168,63,41,13,28,4,18,105,36,3,11,46,9
S01010122,Rented or living rent free: Private rented or living rent free,9,6,5,0,5,0,1,3,1,1,0,1,0
S01010123,All HRPs aged 16 and over,299,169,140,46,94,9,20,130,47,4,20,47,12
S01010123,Owned: Total,38,25,22,2,20,2,1,13,9,2,0,2,0
S01010123,Owned: Owned outright,12,3,2,1,1,0,1,9,8,0,0,1,0
S01010123,Owned: Owned with a mortgage or loan or shared ownership,26,22,20,1,19,2,0,4,1,2,0,1,0
S01010123,Rented or living rent free: Total,261,144,118,44,74,7,19,117,38,2,20,45,12
S01010123,Rented or living rent free: Social rented,250,136,112,40,72,6,18,114,37,2,19,45,11
S01010123,Rented or living rent free: Private rented or living rent free,11,8,6,4,2,1,1,3,1,0,1,0,1
S01010124,All HRPs aged 16 and over,293,213,177,32,145,18,18,80,31,9,14,20,6
S01010124,Owned: Total,204,168,148,21,127,14,6,36,21,0,3,8,4
S01010124,Owned: Owned outright,37,19,18,4,14,0,1,18,15,0,0,1,2
S01010124,Owned: Owned with a mortgage or loan or shared ownership,167,149,130,17,113,14,5,18,6,0,3,7,2
S01010124,Rented or living rent free: Total,89,45,29,11,18,4,12,44,10,9,11,12,2
S01010124,Rented or living rent free: Social rented,26,9,7,2,5,0,2,17,6,1,3,7,0
S01010124,Rented or living rent free: Private rented or living rent free,63,36,22,9,13,4,10,27,4,8,8,5,2
S01010125,All HRPs aged 16 and over,242,151,119,32,87,13,19,91,19,3,17,41,11
S01010125,Owned: Total,81,64,55,4,51,9,0,17,12,1,1,3,0
S01010125,Owned: Owned outright,19,10,9,1,8,1,0,9,7,0,0,2,0
S01010125,Owned: Owned with a mortgage or loan or shared ownership,62,54,46,3,43,8,0,8,5,1,1,1,0
S01010125,Rented or living rent free: Total,161,87,64,28,36,4,19,74,7,2,16,38,11
S01010125,Rented or living rent free: Social rented,150,80,59,27,32,3,18,70,7,2,14,37,10
S01010125,Rented or living rent free: Private rented or living rent free,11,7,5,1,4,1,1,4,0,0,2,1,1
S01010126,All HRPs aged 16 and over,312,205,169,28,141,25,11,107,56,0,8,35,8
S01010126,Owned: Total,194,152,126,12,114,23,3,42,34,0,1,7,0
S01010126,Owned: Owned outright,42,20,15,6,9,4,1,22,20,0,0,2,0
S01010126,Owned: Owned with a mortgage or loan or shared ownership,152,132,111,6,105,19,2,20,14,0,1,5,0
S01010126,Rented or living rent free: Total,118,53,43,16,27,2,8,65,22,0,7,28,8
S01010126,Rented or living rent free: Social rented,101,42,33,11,22,1,8,59,21,0,5,25,8
S01010126,Rented or living rent free: Private rented or living rent free,17,11,10,5,5,1,0,6,1,0,2,3,0
S01010127,All HRPs aged 16 and over,296,129,105,23,82,8,16,167,101,4,11,45,6
S01010127,Owned: Total,114,58,54,5,49,2,2,56,50,1,2,2,1
S01010127,Owned: Owned outright,47,12,12,3,9,0,0,35,33,0,0,1,1
S01010127,Owned: Owned with a mortgage or loan or shared ownership,67,46,42,2,40,2,2,21,17,1,2,1,0
S01010127,Rented or living rent free: Total,182,71,51,18,33,6,14,111,51,3,9,43,5
S01010127,Rented or living rent free: Social rented,171,65,47,15,32,6,12,106,48,3,8,42,5
S01010127,Rented or living rent free: Private rented or living rent free,11,6,4,3,1,0,2,5,3,0,1,1,0
S01010128,All HRPs aged 16 and over,214,108,80,31,49,4,24,106,29,3,24,43,7
S01010128,Owned: Total,22,16,14,3,11,1,1,6,3,0,1,1,1
S01010128,Owned: Owned outright,1,0,0,0,0,0,0,1,0,0,1,0,0
S01010128,Owned: Owned with a mortgage or loan or shared ownership,21,16,14,3,11,1,1,5,3,0,0,1,1
S01010128,Rented or living rent free: Total,192,92,66,28,38,3,23,100,26,3,23,42,6
S01010128,Rented or living rent free: Social rented,188,91,65,27,38,3,23,97,26,3,21,41,6
S01010128,Rented or living rent free: Private rented or living rent free,4,1,1,1,0,0,0,3,0,0,2,1,0
S01010129,All HRPs aged 16 and over,350,181,125,36,89,5,51,169,52,8,23,72,14
S01010129,Owned: Total,45,29,25,2,23,3,1,16,10,5,0,1,0
S01010129,Owned: Owned outright,12,2,0,0,0,2,0,10,9,1,0,0,0
S01010129,Owned: Owned with a mortgage or loan or shared ownership,33,27,25,2,23,1,1,6,1,4,0,1,0
S01010129,Rented or living rent free: Total,305,152,100,34,66,2,50,153,42,3,23,71,14
S01010129,Rented or living rent free: Social rented,289,144,95,32,63,2,47,145,41,2,21,67,14
S01010129,Rented or living rent free: Private rented or living rent free,16,8,5,2,3,0,3,8,1,1,2,4,0
S01010130,All HRPs aged 16 and over,206,88,69,17,52,7,12,118,78,2,14,21,3
S01010130,Owned: Total,46,29,24,3,21,5,0,17,14,1,1,1,0
S01010130,Owned: Owned outright,12,4,3,0,3,1,0,8,7,0,1,0,0
S01010130,Owned: Owned with a mortgage or loan or shared ownership,34,25,21,3,18,4,0,9,7,1,0,1,0
S01010130,Rented or living rent free: Total,160,59,45,14,31,2,12,101,64,1,13,20,3
S01010130,Rented or living rent free: Social rented,155,55,42,14,28,1,12,100,64,1,13,19,3
S01010130,Rented or living rent free: Private rented or living rent free,5,4,3,0,3,1,0,1,0,0,0,1,0
S01010131,All HRPs aged 16 and over,376,244,192,27,165,46,6,132,113,2,3,7,7
S01010131,Owned: Total,355,234,186,25,161,45,3,121,109,1,2,5,4
S01010131,Owned: Owned outright,165,67,57,14,43,9,1,98,90,1,1,4,2
S01010131,Owned: Owned with a mortgage or loan or shared ownership,190,167,129,11,118,36,2,23,19,0,1,1,2
S01010131,Rented or living rent free: Total,21,10,6,2,4,1,3,11,4,1,1,2,3
S01010131,Rented or living rent free: Social rented,5,3,2,1,1,0,1,2,0,0,1,0,1
S01010131,Rented or living rent free: Private rented or living rent free,16,7,4,1,3,1,2,9,4,1,0,2,2
S01010132,All HRPs aged 16 and over,497,215,171,52,119,10,34,282,174,10,16,69,13
S01010132,Owned: Total,172,85,73,19,54,6,6,87,73,2,2,6,4
S01010132,Owned: Owned outright,96,30,24,10,14,2,4,66,57,1,1,5,2
S01010132,Owned: Owned with a mortgage or loan or shared ownership,76,55,49,9,40,4,2,21,16,1,1,1,2
S01010132,Rented or living rent free: Total,325,130,98,33,65,4,28,195,101,8,14,63,9
S01010132,Rented or living rent free: Social rented,279,108,80,27,53,3,25,171,91,5,11,58,6
S01010132,Rented or living rent free: Private rented or living rent free,46,22,18,6,12,1,3,24,10,3,3,5,3
S01010133,All HRPs aged 16 and over,380,161,127,35,92,11,23,219,148,5,8,47,11
S01010133,Owned: Total,135,60,55,6,49,2,3,75,63,0,0,9,3
S01010133,Owned: Owned outright,58,14,13,1,12,1,0,44,41,0,0,2,1
S01010133,Owned: Owned with a mortgage or loan or shared ownership,77,46,42,5,37,1,3,31,22,0,0,7,2
S01010133,Rented or living rent free: Total,245,101,72,29,43,9,20,144,85,5,8,38,8
S01010133,Rented or living rent free: Social rented,225,88,63,25,38,5,20,137,84,5,6,37,5
S01010133,Rented or living rent free: Private rented or living rent free,20,13,9,4,5,4,0,7,1,0,2,1,3
S01010134,All HRPs aged 16 and over,551,265,212,49,163,26,27,286,182,4,20,66,14
S01010134,Owned: Total,269,159,131,21,110,20,8,110,91,3,0,11,5
S01010134,Owned: Owned outright,126,40,29,10,19,3,8,86,73,2,0,7,4
S01010134,Owned: Owned with a mortgage or loan or shared ownership,143,119,102,11,91,17,0,24,18,1,0,4,1
S01010134,Rented or living rent free: Total,282,106,81,28,53,6,19,176,91,1,20,55,9
S01010134,Rented or living rent free: Social rented,223,72,58,23,35,5,9,151,89,1,14,44,3
S01010134,Rented or living rent free: Private rented or living rent free,59,34,23,5,18,1,10,25,2,0,6,11,6
S01010135,All HRPs aged 16 and over,365,160,138,30,108,10,12,205,141,0,13,44,7
S01010135,Owned: Total,196,97,88,15,73,5,4,99,90,0,0,8,1
S01010135,Owned: Owned outright,102,30,29,8,21,0,1,72,66,0,0,5,1
S01010135,Owned: Owned with a mortgage or loan or shared ownership,94,67,59,7,52,5,3,27,24,0,0,3,0
S01010135,Rented or living rent free: Total,169,63,50,15,35,5,8,106,51,0,13,36,6
S01010135,Rented or living rent free: Social rented,146,47,38,10,28,3,6,99,50,0,11,33,5
S01010135,Rented or living rent free: Private rented or living rent free,23,16,12,5,7,2,2,7,1,0,2,3,1
S01010136,All HRPs aged 16 and over,367,215,178,36,142,22,15,152,108,1,3,31,9
S01010136,Owned: Total,259,172,144,26,118,21,7,87,74,0,0,9,4
S01010136,Owned: Owned outright,108,40,33,6,27,5,2,68,66,0,0,1,1
S01010136,Owned: Owned with a mortgage or loan or shared ownership,151,132,111,20,91,16,5,19,8,0,0,8,3
S01010136,Rented or living rent free: Total,108,43,34,10,24,1,8,65,34,1,3,22,5
S01010136,Rented or living rent free: Social rented,56,8,7,2,5,0,1,48,28,0,2,18,0
S01010136,Rented or living rent free: Private rented or living rent free,52,35,27,8,19,1,7,17,6,1,1,4,5
S01010137,All HRPs aged 16 and over,583,249,213,46,167,15,21,334,262,8,11,47,6
S01010137,Owned: Total,304,163,150,25,125,11,2,141,137,0,0,4,0
S01010137,Owned: Owned outright,141,34,31,13,18,2,1,107,105,0,0,2,0
S01010137,Owned: Owned with a mortgage or loan or shared ownership,163,129,119,12,107,9,1,34,32,0,0,2,0
S01010137,Rented or living rent free: Total,279,86,63,21,42,4,19,193,125,8,11,43,6
S01010137,Rented or living rent free: Social rented,192,44,32,5,27,1,11,148,109,5,2,29,3
S01010137,Rented or living rent free: Private rented or living rent free,87,42,31,16,15,3,8,45,16,3,9,14,3
S01010138,All HRPs aged 16 and over,660,253,158,48,110,18,77,407,184,6,26,164,27
S01010138,Owned: Total,106,59,52,10,42,7,0,47,39,1,1,3,3
S01010138,Owned: Owned outright,63,26,25,7,18,1,0,37,34,0,0,1,2
S01010138,Owned: Owned with a mortgage or loan or shared ownership,43,33,27,3,24,6,0,10,5,1,1,2,1
S01010138,Rented or living rent free: Total,554,194,106,38,68,11,77,360,145,5,25,161,24
S01010138,Rented or living rent free: Social rented,535,185,98,37,61,11,76,350,142,4,23,157,24
S01010138,Rented or living rent free: Private rented or living rent free,19,9,8,1,7,0,1,10,3,1,2,4,0
S01010139,All HRPs aged 16 and over,552,266,217,46,171,19,30,286,187,7,14,68,10
S01010139,Owned: Total,237,132,114,15,99,12,6,105,90,3,2,9,1
S01010139,Owned: Owned outright,111,34,30,5,25,2,2,77,67,2,1,6,1
S01010139,Owned: Owned with a mortgage or loan or shared ownership,126,98,84,10,74,10,4,28,23,1,1,3,0
S01010139,Rented or living rent free: Total,315,134,103,31,72,7,24,181,97,4,12,59,9
S01010139,Rented or living rent free: Social rented,249,91,69,24,45,6,16,158,91,2,11,46,8
S01010139,Rented or living rent free: Private rented or living rent free,66,43,34,7,27,1,8,23,6,2,1,13,1
S01010140,All HRPs aged 16 and over,384,303,254,33,221,20,29,81,27,4,13,23,14
S01010140,Owned: Total,227,206,189,13,176,12,5,21,16,1,1,1,2
S01010140,Owned: Owned outright,44,29,27,4,23,2,0,15,14,0,0,1,0
S01010140,Owned: Owned with a mortgage or loan or shared ownership,183,177,162,9,153,10,5,6,2,1,1,0,2
S01010140,Rented or living rent free: Total,157,97,65,20,45,8,24,60,11,3,12,22,12
S01010140,Rented or living rent free: Social rented,20,11,9,4,5,1,1,9,2,0,2,4,1
S01010140,Rented or living rent free: Private rented or living rent free,137,86,56,16,40,7,23,51,9,3,10,18,11
S01010141,All HRPs aged 16 and over,447,209,169,51,118,15,25,238,114,7,22,75,20
S01010141,Owned: Total,78,50,42,6,36,7,1,28,24,1,0,3,0
S01010141,Owned: Owned outright,24,9,8,1,7,1,0,15,14,0,0,1,0
S01010141,Owned: Owned with a mortgage or loan or shared ownership,54,41,34,5,29,6,1,13,10,1,0,2,0
S01010141,Rented or living rent free: Total,369,159,127,45,82,8,24,210,90,6,22,72,20
S01010141,Rented or living rent free: Social rented,323,126,102,39,63,4,20,197,87,5,16,70,19
S01010141,Rented or living rent free: Private rented or living rent free,46,33,25,6,19,4,4,13,3,1,6,2,1
S01010142,All HRPs aged 16 and over,288,178,129,27,102,21,28,110,52,6,11,33,8
S01010142,Owned: Total,127,91,71,12,59,17,3,36,29,1,0,5,1
S01010142,Owned: Owned outright,44,18,11,2,9,5,2,26,23,1,0,2,0
S01010142,Owned: Owned with a mortgage or loan or shared ownership,83,73,60,10,50,12,1,10,6,0,0,3,1
S01010142,Rented or living rent free: Total,161,87,58,15,43,4,25,74,23,5,11,28,7
S01010142,Rented or living rent free: Social rented,118,60,42,11,31,2,16,58,19,5,7,24,3
S01010142,Rented or living rent free: Private rented or living rent free,43,27,16,4,12,2,9,16,4,0,4,4,4
S01010143,All HRPs aged 16 and over,391,166,142,36,106,14,10,225,152,4,8,54,7
S01010143,Owned: Total,207,109,97,18,79,9,3,98,80,1,1,14,2
S01010143,Owned: Owned outright,88,17,15,2,13,2,0,71,62,1,0,8,0
S01010143,Owned: Owned with a mortgage or loan or shared ownership,119,92,82,16,66,7,3,27,18,0,1,6,2
S01010143,Rented or living rent free: Total,184,57,45,18,27,5,7,127,72,3,7,40,5
S01010143,Rented or living rent free: Social rented,158,47,39,16,23,4,4,111,65,3,4,35,4
S01010143,Rented or living rent free: Private rented or living rent free,26,10,6,2,4,1,3,16,7,0,3,5,1
S01010144,All HRPs aged 16 and over,372,248,200,39,161,15,33,124,44,5,14,45,16
S01010144,Owned: Total,128,99,86,9,77,9,4,29,21,3,1,2,2
S01010144,Owned: Owned outright,36,15,12,4,8,2,1,21,16,3,1,0,1
S01010144,Owned: Owned with a mortgage or loan or shared ownership,92,84,74,5,69,7,3,8,5,0,0,2,1
S01010144,Rented or living rent free: Total,244,149,114,30,84,6,29,95,23,2,13,43,14
S01010144,Rented or living rent free: Social rented,160,92,73,26,47,2,17,68,17,2,7,34,8
S01010144,Rented or living rent free: Private rented or living rent free,84,57,41,4,37,4,12,27,6,0,6,9,6
S01010145,All HRPs aged 16 and over,397,229,185,33,152,18,26,168,102,5,15,41,5
S01010145,Owned: Total,182,125,112,20,92,9,4,57,48,2,0,7,0
S01010145,Owned: Owned outright,79,29,26,8,18,3,0,50,45,2,0,3,0
S01010145,Owned: Owned with a mortgage or loan or shared ownership,103,96,86,12,74,6,4,7,3,0,0,4,0
S01010145,Rented or living rent free: Total,215,104,73,13,60,9,22,111,54,3,15,34,5
S01010145,Rented or living rent free: Social rented,108,37,28,6,22,2,7,71,47,1,2,19,2
S01010145,Rented or living rent free: Private rented or living rent free,107,67,45,7,38,7,15,40,7,2,13,15,3
S01010146,All HRPs aged 16 and over,406,247,179,40,139,20,48,159,56,6,15,71,11
S01010146,Owned: Total,97,75,63,13,50,10,2,22,13,1,1,6,1
S01010146,Owned: Owned outright,23,12,10,5,5,2,0,11,8,1,0,2,0
S01010146,Owned: Owned with a mortgage or loan or shared ownership,74,63,53,8,45,8,2,11,5,0,1,4,1
S01010146,Rented or living rent free: Total,309,172,116,27,89,10,46,137,43,5,14,65,10
S01010146,Rented or living rent free: Social rented,262,142,97,23,74,8,37,120,42,3,10,56,9
S01010146,Rented or living rent free: Private rented or living rent free,47,30,19,4,15,2,9,17,1,2,4,9,1
S01010147,All HRPs aged 16 and over,494,269,198,67,131,17,54,225,77,2,27,97,22
S01010147,Owned: Total,78,55,46,7,39,7,2,23,12,0,0,10,1
S01010147,Owned: Owned outright,14,8,6,2,4,1,1,6,5,0,0,1,0
S01010147,Owned: Owned with a mortgage or loan or shared ownership,64,47,40,5,35,6,1,17,7,0,0,9,1
S01010147,Rented or living rent free: Total,416,214,152,60,92,10,52,202,65,2,27,87,21
S01010147,Rented or living rent free: Social rented,351,176,125,52,73,4,47,175,57,1,22,79,16
S01010147,Rented or living rent free: Private rented or living rent free,65,38,27,8,19,6,5,27,8,1,5,8,5
S01010148,All HRPs aged 16 and over,356,184,142,46,96,11,31,172,71,12,22,49,18
S01010148,Owned: Total,104,66,55,16,39,6,5,38,25,2,2,6,3
S01010148,Owned: Owned outright,42,23,18,6,12,4,1,19,14,2,0,1,2
S01010148,Owned: Owned with a mortgage or loan or shared ownership,62,43,37,10,27,2,4,19,11,0,2,5,1
S01010148,Rented or living rent free: Total,252,118,87,30,57,5,26,134,46,10,20,43,15
S01010148,Rented or living rent free: Social rented,200,97,72,26,46,3,22,103,39,1,16,38,9
S01010148,Rented or living rent free: Private rented or living rent free,52,21,15,4,11,2,4,31,7,9,4,5,6
S01010149,All HRPs aged 16 and over,231,175,149,25,124,21,5,56,33,7,4,10,2
S01010149,Owned: Total,147,136,116,9,107,19,1,11,8,0,0,2,1
S01010149,Owned: Owned outright,23,16,11,3,8,4,1,7,5,0,0,2,0
S01010149,Owned: Owned with a mortgage or loan or shared ownership,124,120,105,6,99,15,0,4,3,0,0,0,1
S01010149,Rented or living rent free: Total,84,39,33,16,17,2,4,45,25,7,4,8,1
S01010149,Rented or living rent free: Social rented,32,11,8,3,5,1,2,21,16,1,1,2,1
S01010149,Rented or living rent free: Private rented or living rent free,52,28,25,13,12,1,2,24,9,6,3,6,0
S01010150,All HRPs aged 16 and over,325,134,111,36,75,12,11,191,136,3,9,30,13
S01010150,Owned: Total,125,68,59,16,43,7,2,57,53,1,0,2,1
S01010150,Owned: Owned outright,75,32,26,11,15,4,2,43,41,0,0,1,1
S01010150,Owned: Owned with a mortgage or loan or shared ownership,50,36,33,5,28,3,0,14,12,1,0,1,0
S01010150,Rented or living rent free: Total,200,66,52,20,32,5,9,134,83,2,9,28,12
S01010150,Rented or living rent free: Social rented,164,46,37,14,23,2,7,118,80,1,4,25,8
S01010150,Rented or living rent free: Private rented or living rent free,36,20,15,6,9,3,2,16,3,1,5,3,4
S01010151,All HRPs aged 16 and over,329,114,95,24,71,7,12,215,165,5,8,30,7
S01010151,Owned: Total,123,59,54,13,41,5,0,64,62,0,0,1,1
S01010151,Owned: Owned outright,69,19,18,7,11,1,0,50,48,0,0,1,1
S01010151,Owned: Owned with a mortgage or loan or shared ownership,54,40,36,6,30,4,0,14,14,0,0,0,0
S01010151,Rented or living rent free: Total,206,55,41,11,30,2,12,151,103,5,8,29,6
S01010151,Rented or living rent free: Social rented,194,50,37,11,26,2,11,144,102,4,4,29,5
S01010151,Rented or living rent free: Private rented or living rent free,12,5,4,0,4,0,1,7,1,1,4,0,1
S01010152,All HRPs aged 16 and over,425,212,179,30,149,14,19,213,161,6,11,27,8
S01010152,Owned: Total,259,138,125,8,117,10,3,121,104,2,2,9,4
S01010152,Owned: Owned outright,118,31,28,3,25,2,1,87,77,0,1,7,2
S01010152,Owned: Owned with a mortgage or loan or shared ownership,141,107,97,5,92,8,2,34,27,2,1,2,2
S01010152,Rented or living rent free: Total,166,74,54,22,32,4,16,92,57,4,9,18,4
S01010152,Rented or living rent free: Social rented,104,32,22,7,15,2,8,72,50,0,7,13,2
S01010152,Rented or living rent free: Private rented or living rent free,62,42,32,15,17,2,8,20,7,4,2,5,2
S01010153,All HRPs aged 16 and over,491,206,167,37,130,21,18,285,212,9,7,43,14
S01010153,Owned: Total,237,129,111,12,99,15,3,108,97,1,1,7,2
S01010153,Owned: Owned outright,100,25,21,5,16,4,0,75,70,1,0,4,0
S01010153,Owned: Owned with a mortgage or loan or shared ownership,137,104,90,7,83,11,3,33,27,0,1,3,2
S01010153,Rented or living rent free: Total,254,77,56,25,31,6,15,177,115,8,6,36,12
S01010153,Rented or living rent free: Social rented,205,55,42,19,23,2,11,150,108,3,4,26,9
S01010153,Rented or living rent free: Private rented or living rent free,49,22,14,6,8,4,4,27,7,5,2,10,3
S01010154,All HRPs aged 16 and over,432,155,137,31,106,9,9,277,210,8,11,44,4
S01010154,Owned: Total,251,104,93,15,78,8,3,147,129,2,3,10,3
S01010154,Owned: Owned outright,150,25,21,4,17,2,2,125,113,0,3,7,2
S01010154,Owned: Owned with a mortgage or loan or shared ownership,101,79,72,11,61,6,1,22,16,2,0,3,1
S01010154,Rented or living rent free: Total,181,51,44,16,28,1,6,130,81,6,8,34,1
S01010154,Rented or living rent free: Social rented,144,31,26,10,16,1,4,113,79,2,5,26,1
S01010154,Rented or living rent free: Private rented or living rent free,37,20,18,6,12,0,2,17,2,4,3,8,0
S01010155,All HRPs aged 16 and over,362,152,130,22,108,13,9,210,175,0,7,24,4
S01010155,Owned: Total,208,111,101,13,88,9,1,97,86,0,1,7,3
S01010155,Owned: Owned outright,112,34,29,7,22,4,1,78,74,0,0,2,2
S01010155,Owned: Owned with a mortgage or loan or shared ownership,96,77,72,6,66,5,0,19,12,0,1,5,1
S01010155,Rented or living rent free: Total,154,41,29,9,20,4,8,113,89,0,6,17,1
S01010155,Rented or living rent free: Social rented,132,26,22,8,14,2,2,106,85,0,5,15,1
S01010155,Rented or living rent free: Private rented or living rent free,22,15,7,1,6,2,6,7,4,0,1,2,0
S01010156,All HRPs aged 16 and over,281,104,75,14,61,16,13,177,128,2,9,32,6
S01010156,Owned: Total,111,52,39,2,37,10,3,59,53,1,1,4,0
S01010156,Owned: Owned outright,57,14,11,1,10,1,2,43,40,0,1,2,0
S01010156,Owned: Owned with a mortgage or loan or shared ownership,54,38,28,1,27,9,1,16,13,1,0,2,0
S01010156,Rented or living rent free: Total,170,52,36,12,24,6,10,118,75,1,8,28,6
S01010156,Rented or living rent free: Social rented,158,46,32,12,20,5,9,112,74,1,6,25,6
S01010156,Rented or living rent free: Private rented or living rent free,12,6,4,0,4,1,1,6,1,0,2,3,0
S01010157,All HRPs aged 16 and over,267,113,83,34,49,8,22,154,98,0,11,37,8
S01010157,Owned: Total,43,20,13,3,10,5,2,23,21,0,0,1,1
S01010157,Owned: Owned outright,27,12,9,2,7,2,1,15,15,0,0,0,0
S01010157,Owned: Owned with a mortgage or loan or shared ownership,16,8,4,1,3,3,1,8,6,0,0,1,1
S01010157,Rented or living rent free: Total,224,93,70,31,39,3,20,131,77,0,11,36,7
S01010157,Rented or living rent free: Social rented,219,89,67,29,38,3,19,130,77,0,11,35,7
S01010157,Rented or living rent free: Private rented or living rent free,5,4,3,2,1,0,1,1,0,0,0,1,0
S01010158,All HRPs aged 16 and over,461,215,183,28,155,17,15,246,176,5,14,44,7
S01010158,Owned: Total,271,154,134,17,117,12,8,117,101,1,2,10,3
S01010158,Owned: Owned outright,121,34,29,7,22,2,3,87,81,0,2,3,1
S01010158,Owned: Owned with a mortgage or loan or shared ownership,150,120,105,10,95,10,5,30,20,1,0,7,2
S01010158,Rented or living rent free: Total,190,61,49,11,38,5,7,129,75,4,12,34,4
S01010158,Rented or living rent free: Social rented,138,35,27,6,21,2,6,103,67,1,4,27,4
S01010158,Rented or living rent free: Private rented or living rent free,52,26,22,5,17,3,1,26,8,3,8,7,0
S01010159,All HRPs aged 16 and over,353,154,132,30,102,15,7,199,142,2,7,41,7
S01010159,Owned: Total,186,100,86,17,69,12,2,86,81,0,2,3,0
S01010159,Owned: Owned outright,98,32,29,12,17,3,0,66,64,0,0,2,0
S01010159,Owned: Owned with a mortgage or loan or shared ownership,88,68,57,5,52,9,2,20,17,0,2,1,0
S01010159,Rented or living rent free: Total,167,54,46,13,33,3,5,113,61,2,5,38,7
S01010159,Rented or living rent free: Social rented,143,45,39,12,27,2,4,98,56,1,4,33,4
S01010159,Rented or living rent free: Private rented or living rent free,24,9,7,1,6,1,1,15,5,1,1,5,3
S01010160,All HRPs aged 16 and over,308,168,111,24,87,19,38,140,28,18,12,66,16
S01010160,Owned: Total,18,15,14,3,11,1,0,3,1,0,1,0,1
S01010160,Owned: Owned outright,6,3,3,1,2,0,0,3,1,0,1,0,1
S01010160,Owned: Owned with a mortgage or loan or shared ownership,12,12,11,2,9,1,0,0,0,0,0,0,0
S01010160,Rented or living rent free: Total,290,153,97,21,76,18,38,137,27,18,11,66,15
S01010160,Rented or living rent free: Social rented,281,146,95,21,74,18,33,135,27,16,11,66,15
S01010160,Rented or living rent free: Private rented or living rent free,9,7,2,0,2,0,5,2,0,2,0,0,0
S01010161,All HRPs aged 16 and over,259,173,141,28,113,18,14,86,35,1,11,33,6
S01010161,Owned: Total,112,103,88,6,82,14,1,9,6,0,1,2,0
S01010161,Owned: Owned outright,12,5,4,0,4,1,0,7,6,0,0,1,0
S01010161,Owned: Owned with a mortgage or loan or shared ownership,100,98,84,6,78,13,1,2,0,0,1,1,0
S01010161,Rented or living rent free: Total,147,70,53,22,31,4,13,77,29,1,10,31,6
S01010161,Rented or living rent free: Social rented,143,67,51,21,30,3,13,76,29,1,10,30,6
S01010161,Rented or living rent free: Private rented or living rent free,4,3,2,1,1,1,0,1,0,0,0,1,0
S01010162,All HRPs aged 16 and over,360,185,123,54,69,12,50,175,57,6,24,73,15
S01010162,Owned: Total,35,21,21,5,16,0,0,14,9,0,0,5,0
S01010162,Owned: Owned outright,12,3,3,2,1,0,0,9,6,0,0,3,0
S01010162,Owned: Owned with a mortgage or loan or shared ownership,23,18,18,3,15,0,0,5,3,0,0,2,0
S01010162,Rented or living rent free: Total,325,164,102,49,53,12,50,161,48,6,24,68,15
S01010162,Rented or living rent free: Social rented,319,159,99,49,50,12,48,160,48,6,24,67,15
S01010162,Rented or living rent free: Private rented or living rent free,6,5,3,0,3,0,2,1,0,0,0,1,0
S01010163,All HRPs aged 16 and over,239,111,91,23,68,7,13,128,54,4,16,43,11
S01010163,Owned: Total,92,57,53,5,48,3,1,35,31,0,0,4,0
S01010163,Owned: Owned outright,41,12,9,2,7,2,1,29,27,0,0,2,0
S01010163,Owned: Owned with a mortgage or loan or shared ownership,51,45,44,3,41,1,0,6,4,0,0,2,0
S01010163,Rented or living rent free: Total,147,54,38,18,20,4,12,93,23,4,16,39,11
S01010163,Rented or living rent free: Social rented,139,51,36,16,20,4,11,88,22,4,13,38,11
S01010163,Rented or living rent free: Private rented or living rent free,8,3,2,2,0,0,1,5,1,0,3,1,0
S01010164,All HRPs aged 16 and over,282,154,124,31,93,16,14,128,71,2,13,32,10
S01010164,Owned: Total,138,91,80,14,66,10,1,47,33,1,2,7,4
S01010164,Owned: Owned outright,48,18,17,4,13,1,0,30,23,0,1,4,2
S01010164,Owned: Owned with a mortgage or loan or shared ownership,90,73,63,10,53,9,1,17,10,1,1,3,2
S01010164,Rented or living rent free: Total,144,63,44,17,27,6,13,81,38,1,11,25,6
S01010164,Rented or living rent free: Social rented,126,51,34,13,21,6,11,75,35,1,10,23,6
S01010164,Rented or living rent free: Private rented or living rent free,18,12,10,4,6,0,2,6,3,0,1,2,0
S01010165,All HRPs aged 16 and over,275,130,103,37,66,4,23,145,65,6,18,41,15
S01010165,Owned: Total,64,34,32,9,23,2,0,30,25,2,0,2,1
S01010165,Owned: Owned outright,43,21,19,6,13,2,0,22,20,0,0,2,0
S01010165,Owned: Owned with a mortgage or loan or shared ownership,21,13,13,3,10,0,0,8,5,2,0,0,1
S01010165,Rented or living rent free: Total,211,96,71,28,43,2,23,115,40,4,18,39,14
S01010165,Rented or living rent free: Social rented,204,94,70,28,42,2,22,110,40,2,18,38,12
S01010165,Rented or living rent free: Private rented or living rent free,7,2,1,0,1,0,1,5,0,2,0,1,2
S01010166,All HRPs aged 16 and over,347,168,142,43,99,14,12,179,104,1,11,50,13
S01010166,Owned: Total,168,115,103,23,80,10,2,53,47,0,1,4,1
S01010166,Owned: Owned outright,54,21,20,8,12,1,0,33,32,0,0,1,0
S01010166,Owned: Owned with a mortgage or loan or shared ownership,114,94,83,15,68,9,2,20,15,0,1,3,1
S01010166,Rented or living rent free: Total,179,53,39,20,19,4,10,126,57,1,10,46,12
S01010166,Rented or living rent free: Social rented,159,44,34,16,18,1,9,115,54,1,8,44,8
S01010166,Rented or living rent free: Private rented or living rent free,20,9,5,4,1,3,1,11,3,0,2,2,4
S01010167,All HRPs aged 16 and over,472,202,155,44,111,14,33,270,179,5,13,56,17
S01010167,Owned: Total,171,85,68,16,52,10,7,86,77,0,1,5,3
S01010167,Owned: Owned outright,81,20,16,4,12,3,1,61,58,0,0,1,2
S01010167,Owned: Owned with a mortgage or loan or shared ownership,90,65,52,12,40,7,6,25,19,0,1,4,1
S01010167,Rented or living rent free: Total,301,117,87,28,59,4,26,184,102,5,12,51,14
S01010167,Rented or living rent free: Social rented,260,100,73,25,48,3,24,160,101,2,4,42,11
S01010167,Rented or living rent free: Private rented or living rent free,41,17,14,3,11,1,2,24,1,3,8,9,3
S01010168,All HRPs aged 16 and over,236,150,117,30,87,13,20,86,51,0,12,18,5
S01010168,Owned: Total,112,83,72,9,63,8,3,29,26,0,1,1,1
S01010168,Owned: Owned outright,30,11,9,4,5,1,1,19,17,0,1,1,0
S01010168,Owned: Owned with a mortgage or loan or shared ownership,82,72,63,5,58,7,2,10,9,0,0,0,1
S01010168,Rented or living rent free: Total,124,67,45,21,24,5,17,57,25,0,11,17,4
S01010168,Rented or living rent free: Social rented,93,46,30,16,14,4,12,47,20,0,7,16,4
S01010168,Rented or living rent free: Private rented or living rent free,31,21,15,5,10,1,5,10,5,0,4,1,0
S01010169,All HRPs aged 16 and over,367,237,183,43,140,18,36,130,41,5,29,43,12
S01010169,Owned: Total,130,104,94,12,82,7,3,26,19,0,0,6,1
S01010169,Owned: Owned outright,38,16,14,1,13,2,0,22,18,0,0,4,0
S01010169,Owned: Owned with a mortgage or loan or shared ownership,92,88,80,11,69,5,3,4,1,0,0,2,1
S01010169,Rented or living rent free: Total,237,133,89,31,58,11,33,104,22,5,29,37,11
S01010169,Rented or living rent free: Social rented,187,102,69,26,43,7,26,85,22,1,25,35,2
S01010169,Rented or living rent free: Private rented or living rent free,50,31,20,5,15,4,7,19,0,4,4,2,9
S01010170,All HRPs aged 16 and over,271,156,126,31,95,11,19,115,49,2,22,33,9
S01010170,Owned: Total,104,81,69,15,54,9,3,23,20,0,0,2,1
S01010170,Owned: Owned outright,30,16,13,5,8,3,0,14,12,0,0,1,1
S01010170,Owned: Owned with a mortgage or loan or shared ownership,74,65,56,10,46,6,3,9,8,0,0,1,0
S01010170,Rented or living rent free: Total,167,75,57,16,41,2,16,92,29,2,22,31,8
S01010170,Rented or living rent free: Social rented,141,64,49,14,35,2,13,77,29,1,15,27,5
S01010170,Rented or living rent free: Private rented or living rent free,26,11,8,2,6,0,3,15,0,1,7,4,3
S01010171,All HRPs aged 16 and over,489,231,170,56,114,9,52,258,107,5,35,82,29
S01010171,Owned: Total,75,43,38,4,34,4,1,32,29,2,0,1,0
S01010171,Owned: Owned outright,26,6,5,1,4,1,0,20,19,0,0,1,0
S01010171,Owned: Owned with a mortgage or loan or shared ownership,49,37,33,3,30,3,1,12,10,2,0,0,0
S01010171,Rented or living rent free: Total,414,188,132,52,80,5,51,226,78,3,35,81,29
S01010171,Rented or living rent free: Social rented,390,176,124,50,74,5,47,214,71,3,32,79,29
S01010171,Rented or living rent free: Private rented or living rent free,24,12,8,2,6,0,4,12,7,0,3,2,0
S01010172,All HRPs aged 16 and over,481,206,169,31,138,17,20,275,200,1,6,58,10
S01010172,Owned: Total,202,102,86,11,75,13,3,100,91,0,0,9,0
S01010172,Owned: Owned outright,106,28,24,5,19,3,1,78,75,0,0,3,0
S01010172,Owned: Owned with a mortgage or loan or shared ownership,96,74,62,6,56,10,2,22,16,0,0,6,0
S01010172,Rented or living rent free: Total,279,104,83,20,63,4,17,175,109,1,6,49,10
S01010172,Rented or living rent free: Social rented,233,73,55,15,40,4,14,160,107,0,3,42,8
S01010172,Rented or living rent free: Private rented or living rent free,46,31,28,5,23,0,3,15,2,1,3,7,2
S01010173,All HRPs aged 16 and over,331,167,139,31,108,17,11,164,138,2,2,14,8
S01010173,Owned: Total,234,136,117,24,93,15,4,98,86,0,1,5,6
S01010173,Owned: Owned outright,101,34,32,10,22,0,2,67,63,0,0,3,1
S01010173,Owned: Owned with a mortgage or loan or shared ownership,133,102,85,14,71,15,2,31,23,0,1,2,5
S01010173,Rented or living rent free: Total,97,31,22,7,15,2,7,66,52,2,1,9,2
S01010173,Rented or living rent free: Social rented,86,26,18,5,13,1,7,60,48,2,1,8,1
S01010173,Rented or living rent free: Private rented or living rent free,11,5,4,2,2,1,0,6,4,0,0,1,1
S01010174,All HRPs aged 16 and over,250,136,116,12,104,15,5,114,88,1,5,17,3
S01010174,Owned: Total,182,119,103,10,93,13,3,63,56,0,1,5,1
S01010174,Owned: Owned outright,70,16,12,3,9,2,2,54,50,0,1,2,1
S01010174,Owned: Owned with a mortgage or loan or shared ownership,112,103,91,7,84,11,1,9,6,0,0,3,0
S01010174,Rented or living rent free: Total,68,17,13,2,11,2,2,51,32,1,4,12,2
S01010174,Rented or living rent free: Social rented,50,5,5,1,4,0,0,45,32,0,3,8,2
S01010174,Rented or living rent free: Private rented or living rent free,18,12,8,1,7,2,2,6,0,1,1,4,0
S01010175,All HRPs aged 16 and over,216,112,89,19,70,12,11,104,62,0,12,25,5
S01010175,Owned: Total,119,83,69,9,60,10,4,36,28,0,2,5,1
S01010175,Owned: Owned outright,43,19,14,5,9,4,1,24,21,0,0,2,1
S01010175,Owned: Owned with a mortgage or loan or shared ownership,76,64,55,4,51,6,3,12,7,0,2,3,0
S01010175,Rented or living rent free: Total,97,29,20,10,10,2,7,68,34,0,10,20,4
S01010175,Rented or living rent free: Social rented,72,16,9,5,4,2,5,56,32,0,5,17,2
S01010175,Rented or living rent free: Private rented or living rent free,25,13,11,5,6,0,2,12,2,0,5,3,2
S01010176,All HRPs aged 16 and over,369,164,138,27,111,14,12,205,145,9,9,31,11
S01010176,Owned: Total,214,116,104,16,88,9,3,98,88,0,1,5,4
S01010176,Owned: Owned outright,106,23,21,7,14,2,0,83,77,0,0,4,2
S01010176,Owned: Owned with a mortgage or loan or shared ownership,108,93,83,9,74,7,3,15,11,0,1,1,2
S01010176,Rented or living rent free: Total,155,48,34,11,23,5,9,107,57,9,8,26,7
S01010176,Rented or living rent free: Social rented,129,35,25,7,18,4,6,94,54,4,6,24,6
S01010176,Rented or living rent free: Private rented or living rent free,26,13,9,4,5,1,3,13,3,5,2,2,1
S01010177,All HRPs aged 16 and over,315,162,122,39,83,9,31,153,65,8,25,47,8
S01010177,Owned: Total,54,38,33,7,26,4,1,16,14,0,0,2,0
S01010177,Owned: Owned outright,16,3,2,1,1,1,0,13,13,0,0,0,0
S01010177,Owned: Owned with a mortgage or loan or shared ownership,38,35,31,6,25,3,1,3,1,0,0,2,0
S01010177,Rented or living rent free: Total,261,124,89,32,57,5,30,137,51,8,25,45,8
S01010177,Rented or living rent free: Social rented,248,118,85,29,56,4,29,130,49,6,23,44,8
S01010177,Rented or living rent free: Private rented or living rent free,13,6,4,3,1,1,1,7,2,2,2,1,0
S01010178,All HRPs aged 16 and over,391,206,163,61,102,11,32,185,74,0,35,59,17
S01010178,Owned: Total,45,34,33,5,28,1,0,11,8,0,0,3,0
S01010178,Owned: Owned outright,11,5,4,2,2,1,0,6,5,0,0,1,0
S01010178,Owned: Owned with a mortgage or loan or shared ownership,34,29,29,3,26,0,0,5,3,0,0,2,0
S01010178,Rented or living rent free: Total,346,172,130,56,74,10,32,174,66,0,35,56,17
S01010178,Rented or living rent free: Social rented,321,159,122,55,67,8,29,162,62,0,35,51,14
S01010178,Rented or living rent free: Private rented or living rent free,25,13,8,1,7,2,3,12,4,0,0,5,3
S01010179,All HRPs aged 16 and over,387,177,149,41,108,9,19,210,91,12,25,68,14
S01010179,Owned: Total,127,79,69,11,58,8,2,48,39,0,0,8,1
S01010179,Owned: Owned outright,52,17,15,7,8,2,0,35,29,0,0,5,1
S01010179,Owned: Owned with a mortgage or loan or shared ownership,75,62,54,4,50,6,2,13,10,0,0,3,0
S01010179,Rented or living rent free: Total,260,98,80,30,50,1,17,162,52,12,25,60,13
S01010179,Rented or living rent free: Social rented,230,88,74,29,45,0,14,142,48,2,25,56,11
S01010179,Rented or living rent free: Private rented or living rent free,30,10,6,1,5,1,3,20,4,10,0,4,2
S01010180,All HRPs aged 16 and over,215,168,144,36,108,16,8,47,14,4,11,16,2
S01010180,Owned: Total,118,108,93,12,81,14,1,10,5,0,3,1,1
S01010180,Owned: Owned outright,20,15,13,5,8,1,1,5,4,0,0,0,1
S01010180,Owned: Owned with a mortgage or loan or shared ownership,98,93,80,7,73,13,0,5,1,0,3,1,0
S01010180,Rented or living rent free: Total,97,60,51,24,27,2,7,37,9,4,8,15,1
S01010180,Rented or living rent free: Social rented,71,39,34,20,14,2,3,32,8,1,8,14,1
S01010180,Rented or living rent free: Private rented or living rent free,26,21,17,4,13,0,4,5,1,3,0,1,0
S01010181,All HRPs aged 16 and over,272,130,90,25,65,11,29,142,75,2,11,44,10
S01010181,Owned: Total,99,56,46,9,37,9,1,43,39,0,0,4,0
S01010181,Owned: Owned outright,45,12,8,2,6,3,1,33,33,0,0,0,0
S01010181,Owned: Owned with a mortgage or loan or shared ownership,54,44,38,7,31,6,0,10,6,0,0,4,0
S01010181,Rented or living rent free: Total,173,74,44,16,28,2,28,99,36,2,11,40,10
S01010181,Rented or living rent free: Social rented,159,68,38,14,24,2,28,91,34,2,9,37,9
S01010181,Rented or living rent free: Private rented or living rent free,14,6,6,2,4,0,0,8,2,0,2,3,1
S01010182,All HRPs aged 16 and over,307,231,192,27,165,32,7,76,58,2,0,13,3
S01010182,Owned: Total,262,207,174,23,151,30,3,55,46,0,0,6,3
S01010182,Owned: Owned outright,87,45,36,9,27,8,1,42,38,0,0,1,3
S01010182,Owned: Owned with a mortgage or loan or shared ownership,175,162,138,14,124,22,2,13,8,0,0,5,0
S01010182,Rented or living rent free: Total,45,24,18,4,14,2,4,21,12,2,0,7,0
S01010182,Rented or living rent free: Social rented,13,4,3,0,3,0,1,9,6,0,0,3,0
S01010182,Rented or living rent free: Private rented or living rent free,32,20,15,4,11,2,3,12,6,2,0,4,0
S01010183,All HRPs aged 16 and over,232,99,84,25,59,7,8,133,94,1,11,22,5
S01010183,Owned: Total,103,49,40,4,36,7,2,54,47,1,0,3,3
S01010183,Owned: Owned outright,54,12,9,1,8,3,0,42,38,0,0,1,3
S01010183,Owned: Owned with a mortgage or loan or shared ownership,49,37,31,3,28,4,2,12,9,1,0,2,0
S01010183,Rented or living rent free: Total,129,50,44,21,23,0,6,79,47,0,11,19,2
S01010183,Rented or living rent free: Social rented,116,43,37,17,20,0,6,73,43,0,9,19,2
S01010183,Rented or living rent free: Private rented or living rent free,13,7,7,4,3,0,0,6,4,0,2,0,0
S01010184,All HRPs aged 16 and over,286,152,125,45,80,7,20,134,81,0,12,32,9
S01010184,Owned: Total,116,67,60,12,48,3,4,49,40,0,1,6,2
S01010184,Owned: Owned outright,63,26,21,7,14,2,3,37,31,0,0,4,2
S01010184,Owned: Owned with a mortgage or loan or shared ownership,53,41,39,5,34,1,1,12,9,0,1,2,0
S01010184,Rented or living rent free: Total,170,85,65,33,32,4,16,85,41,0,11,26,7
S01010184,Rented or living rent free: Social rented,150,74,56,29,27,4,14,76,40,0,11,19,6
S01010184,Rented or living rent free: Private rented or living rent free,20,11,9,4,5,0,2,9,1,0,0,7,1
S01010185,All HRPs aged 16 and over,282,151,118,43,75,12,21,131,67,5,17,35,7
S01010185,Owned: Total,99,58,52,11,41,5,1,41,33,0,2,4,2
S01010185,Owned: Owned outright,43,16,14,7,7,2,0,27,24,0,1,2,0
S01010185,Owned: Owned with a mortgage or loan or shared ownership,56,42,38,4,34,3,1,14,9,0,1,2,2
S01010185,Rented or living rent free: Total,183,93,66,32,34,7,20,90,34,5,15,31,5
S01010185,Rented or living rent free: Social rented,174,86,63,31,32,4,19,88,34,5,13,31,5
S01010185,Rented or living rent free: Private rented or living rent free,9,7,3,1,2,3,1,2,0,0,2,0,0
S01010186,All HRPs aged 16 and over,246,188,157,26,131,24,7,58,41,2,4,6,5
S01010186,Owned: Total,221,176,148,21,127,23,5,45,37,0,3,3,2
S01010186,Owned: Owned outright,73,41,35,11,24,5,1,32,29,0,0,3,0
S01010186,Owned: Owned with a mortgage or loan or shared ownership,148,135,113,10,103,18,4,13,8,0,3,0,2
S01010186,Rented or living rent free: Total,25,12,9,5,4,1,2,13,4,2,1,3,3
S01010186,Rented or living rent free: Social rented,5,2,2,2,0,0,0,3,2,0,0,1,0
S01010186,Rented or living rent free: Private rented or living rent free,20,10,7,3,4,1,2,10,2,2,1,2,3
S01010187,All HRPs aged 16 and over,294,234,203,26,177,24,7,60,37,4,3,13,3
S01010187,Owned: Total,252,212,191,25,166,19,2,40,28,1,1,8,2
S01010187,Owned: Owned outright,74,42,37,8,29,5,0,32,26,1,1,3,1
S01010187,Owned: Owned with a mortgage or loan or shared ownership,178,170,154,17,137,14,2,8,2,0,0,5,1
S01010187,Rented or living rent free: Total,42,22,12,1,11,5,5,20,9,3,2,5,1
S01010187,Rented or living rent free: Social rented,9,2,1,0,1,1,0,7,4,0,2,0,1
S01010187,Rented or living rent free: Private rented or living rent free,33,20,11,1,10,4,5,13,5,3,0,5,0
S01010188,All HRPs aged 16 and over,304,233,187,23,164,38,8,71,50,1,6,10,4
S01010188,Owned: Total,262,211,177,18,159,31,3,51,45,0,1,3,2
S01010188,Owned: Owned outright,73,39,33,4,29,6,0,34,32,0,1,1,0
S01010188,Owned: Owned with a mortgage or loan or shared ownership,189,172,144,14,130,25,3,17,13,0,0,2,2
S01010188,Rented or living rent free: Total,42,22,10,5,5,7,5,20,5,1,5,7,2
S01010188,Rented or living rent free: Social rented,9,1,1,0,1,0,0,8,3,0,1,4,0
S01010188,Rented or living rent free: Private rented or living rent free,33,21,9,5,4,7,5,12,2,1,4,3,2
S01010189,All HRPs aged 16 and over,336,299,252,20,232,44,3,37,16,9,3,7,2
S01010189,Owned: Total,302,283,240,16,224,40,3,19,13,1,1,3,1
S01010189,Owned: Owned outright,40,30,25,6,19,4,1,10,7,0,1,2,0
S01010189,Owned: Owned with a mortgage or loan or shared ownership,262,253,215,10,205,36,2,9,6,1,0,1,1
S01010189,Rented or living rent free: Total,34,16,12,4,8,4,0,18,3,8,2,4,1
S01010189,Rented or living rent free: Social rented,4,2,1,0,1,1,0,2,1,0,0,1,0
S01010189,Rented or living rent free: Private rented or living rent free,30,14,11,4,7,3,0,16,2,8,2,3,1
S01010190,All HRPs aged 16 and over,253,233,177,13,164,51,5,20,12,1,1,4,2
S01010190,Owned: Total,233,219,168,12,156,48,3,14,11,0,0,1,2
S01010190,Owned: Owned outright,39,29,20,3,17,8,1,10,9,0,0,1,0
S01010190,Owned: Owned with a mortgage or loan or shared ownership,194,190,148,9,139,40,2,4,2,0,0,0,2
S01010190,Rented or living rent free: Total,20,14,9,1,8,3,2,6,1,1,1,3,0
S01010190,Rented or living rent free: Social rented,8,3,3,0,3,0,0,5,1,0,1,3,0
S01010190,Rented or living rent free: Private rented or living rent free,12,11,6,1,5,3,2,1,0,1,0,0,0
S01010191,All HRPs aged 16 and over,266,229,193,22,171,33,3,37,24,0,3,7,3
S01010191,Owned: Total,237,213,180,16,164,30,3,24,20,0,0,3,1
S01010191,Owned: Owned outright,35,20,15,4,11,4,1,15,13,0,0,2,0
S01010191,Owned: Owned with a mortgage or loan or shared ownership,202,193,165,12,153,26,2,9,7,0,0,1,1
S01010191,Rented or living rent free: Total,29,16,13,6,7,3,0,13,4,0,3,4,2
S01010191,Rented or living rent free: Social rented,7,3,3,2,1,0,0,4,3,0,0,1,0
S01010191,Rented or living rent free: Private rented or living rent free,22,13,10,4,6,3,0,9,1,0,3,3,2
S01010192,All HRPs aged 16 and over,294,258,225,26,199,27,6,36,16,6,4,8,2
S01010192,Owned: Total,266,245,216,24,192,24,5,21,15,1,0,4,1
S01010192,Owned: Owned outright,35,23,19,6,13,4,0,12,11,0,0,1,0
S01010192,Owned: Owned with a mortgage or loan or shared ownership,231,222,197,18,179,20,5,9,4,1,0,3,1
S01010192,Rented or living rent free: Total,28,13,9,2,7,3,1,15,1,5,4,4,1
S01010192,Rented or living rent free: Social rented,7,4,3,1,2,0,1,3,0,0,1,1,1
S01010192,Rented or living rent free: Private rented or living rent free,21,9,6,1,5,3,0,12,1,5,3,3,0
S01010193,All HRPs aged 16 and over,329,231,189,22,167,38,4,98,81,1,0,12,4
S01010193,Owned: Total,272,212,175,16,159,33,4,60,53,0,0,5,2
S01010193,Owned: Owned outright,78,36,31,4,27,5,0,42,40,0,0,1,1
S01010193,Owned: Owned with a mortgage or loan or shared ownership,194,176,144,12,132,28,4,18,13,0,0,4,1
S01010193,Rented or living rent free: Total,57,19,14,6,8,5,0,38,28,1,0,7,2
S01010193,Rented or living rent free: Social rented,11,2,1,0,1,1,0,9,6,0,0,2,1
S01010193,Rented or living rent free: Private rented or living rent free,46,17,13,6,7,4,0,29,22,1,0,5,1
S01010194,All HRPs aged 16 and over,268,118,103,20,83,10,5,150,122,0,4,20,4
S01010194,Owned: Total,198,95,84,14,70,8,3,103,92,0,1,7,3
S01010194,Owned: Owned outright,91,14,9,2,7,3,2,77,71,0,0,5,1
S01010194,Owned: Owned with a mortgage or loan or shared ownership,107,81,75,12,63,5,1,26,21,0,1,2,2
S01010194,Rented or living rent free: Total,70,23,19,6,13,2,2,47,30,0,3,13,1
S01010194,Rented or living rent free: Social rented,65,20,17,4,13,1,2,45,29,0,3,13,0
S01010194,Rented or living rent free: Private rented or living rent free,5,3,2,2,0,1,0,2,1,0,0,0,1
S01010195,All HRPs aged 16 and over,212,114,97,19,78,10,7,98,66,0,10,19,3
S01010195,Owned: Total,138,88,79,12,67,8,1,50,40,0,1,8,1
S01010195,Owned: Owned outright,47,11,10,2,8,1,0,36,33,0,0,3,0
S01010195,Owned: Owned with a mortgage or loan or shared ownership,91,77,69,10,59,7,1,14,7,0,1,5,1
S01010195,Rented or living rent free: Total,74,26,18,7,11,2,6,48,26,0,9,11,2
S01010195,Rented or living rent free: Social rented,56,18,13,5,8,1,4,38,24,0,3,9,2
S01010195,Rented or living rent free: Private rented or living rent free,18,8,5,2,3,1,2,10,2,0,6,2,0
S01010196,All HRPs aged 16 and over,274,143,128,29,99,5,10,131,85,1,11,30,4
S01010196,Owned: Total,111,76,71,12,59,4,1,35,31,0,0,3,1
S01010196,Owned: Owned outright,55,27,24,6,18,2,1,28,26,0,0,2,0
S01010196,Owned: Owned with a mortgage or loan or shared ownership,56,49,47,6,41,2,0,7,5,0,0,1,1
S01010196,Rented or living rent free: Total,163,67,57,17,40,1,9,96,54,1,11,27,3
S01010196,Rented or living rent free: Social rented,151,60,53,15,38,0,7,91,51,1,10,26,3
S01010196,Rented or living rent free: Private rented or living rent free,12,7,4,2,2,1,2,5,3,0,1,1,0
S01010197,All HRPs aged 16 and over,260,127,110,30,80,6,11,133,72,2,12,44,3
S01010197,Owned: Total,98,58,52,11,41,4,2,40,34,1,0,5,0
S01010197,Owned: Owned outright,52,21,18,4,14,3,0,31,27,1,0,3,0
S01010197,Owned: Owned with a mortgage or loan or shared ownership,46,37,34,7,27,1,2,9,7,0,0,2,0
S01010197,Rented or living rent free: Total,162,69,58,19,39,2,9,93,38,1,12,39,3
S01010197,Rented or living rent free: Social rented,149,64,54,17,37,2,8,85,36,1,10,36,2
S01010197,Rented or living rent free: Private rented or living rent free,13,5,4,2,2,0,1,8,2,0,2,3,1
S01010198,All HRPs aged 16 and over,394,192,159,46,113,21,12,202,138,0,17,37,10
S01010198,Owned: Total,217,122,107,23,84,13,2,95,78,0,5,8,4
S01010198,Owned: Owned outright,106,38,35,10,25,2,1,68,59,0,1,6,2
S01010198,Owned: Owned with a mortgage or loan or shared ownership,111,84,72,13,59,11,1,27,19,0,4,2,2
S01010198,Rented or living rent free: Total,177,70,52,23,29,8,10,107,60,0,12,29,6
S01010198,Rented or living rent free: Social rented,156,57,43,20,23,5,9,99,57,0,11,27,4
S01010198,Rented or living rent free: Private rented or living rent free,21,13,9,3,6,3,1,8,3,0,1,2,2
S01010199,All HRPs aged 16 and over,232,123,94,37,57,5,24,109,58,0,18,24,9
S01010199,Owned: Total,80,44,41,7,34,1,2,36,32,0,0,2,2
S01010199,Owned: Owned outright,38,9,9,2,7,0,0,29,28,0,0,1,0
S01010199,Owned: Owned with a mortgage or loan or shared ownership,42,35,32,5,27,1,2,7,4,0,0,1,2
S01010199,Rented or living rent free: Total,152,79,53,30,23,4,22,73,26,0,18,22,7
S01010199,Rented or living rent free: Social rented,144,73,47,26,21,4,22,71,25,0,18,22,6
S01010199,Rented or living rent free: Private rented or living rent free,8,6,6,4,2,0,0,2,1,0,0,0,1
S01010200,All HRPs aged 16 and over,305,130,113,19,94,12,5,175,137,1,5,29,3
S01010200,Owned: Total,180,95,85,9,76,9,1,85,74,0,2,7,2
S01010200,Owned: Owned outright,75,19,18,3,15,1,0,56,53,0,0,3,0
S01010200,Owned: Owned with a mortgage or loan or shared ownership,105,76,67,6,61,8,1,29,21,0,2,4,2
S01010200,Rented or living rent free: Total,125,35,28,10,18,3,4,90,63,1,3,22,1
S01010200,Rented or living rent free: Social rented,114,26,21,7,14,2,3,88,62,1,2,22,1
S01010200,Rented or living rent free: Private rented or living rent free,11,9,7,3,4,1,1,2,1,0,1,0,0
S01010201,All HRPs aged 16 and over,253,159,139,21,118,12,8,94,67,1,6,17,3
S01010201,Owned: Total,197,138,125,16,109,12,1,59,51,0,1,5,2
S01010201,Owned: Owned outright,76,33,30,4,26,2,1,43,39,0,0,2,2
S01010201,Owned: Owned with a mortgage or loan or shared ownership,121,105,95,12,83,10,0,16,12,0,1,3,0
S01010201,Rented or living rent free: Total,56,21,14,5,9,0,7,35,16,1,5,12,1
S01010201,Rented or living rent free: Social rented,40,11,6,1,5,0,5,29,15,0,4,9,1
S01010201,Rented or living rent free: Private rented or living rent free,16,10,8,4,4,0,2,6,1,1,1,3,0
S01010202,All HRPs aged 16 and over,365,195,133,53,80,7,55,170,38,10,44,67,11
S01010202,Owned: Total,26,14,9,3,6,0,5,12,10,0,0,2,0
S01010202,Owned: Owned outright,20,8,4,1,3,0,4,12,10,0,0,2,0
S01010202,Owned: Owned with a mortgage or loan or shared ownership,6,6,5,2,3,0,1,0,0,0,0,0,0
S01010202,Rented or living rent free: Total,339,181,124,50,74,7,50,158,28,10,44,65,11
S01010202,Rented or living rent free: Social rented,328,177,121,49,72,6,50,151,28,10,39,63,11
S01010202,Rented or living rent free: Private rented or living rent free,11,4,3,1,2,1,0,7,0,0,5,2,0
S01010203,All HRPs aged 16 and over,260,206,180,18,162,21,5,54,29,4,12,7,2
S01010203,Owned: Total,208,179,158,13,145,18,3,29,26,1,1,1,0
S01010203,Owned: Owned outright,28,9,8,0,8,1,0,19,18,0,0,1,0
S01010203,Owned: Owned with a mortgage or loan or shared ownership,180,170,150,13,137,17,3,10,8,1,1,0,0
S01010203,Rented or living rent free: Total,52,27,22,5,17,3,2,25,3,3,11,6,2
S01010203,Rented or living rent free: Social rented,9,3,2,1,1,1,0,6,0,2,1,2,1
S01010203,Rented or living rent free: Private rented or living rent free,43,24,20,4,16,2,2,19,3,1,10,4,1
S01010204,All HRPs aged 16 and over,381,181,151,62,89,7,23,200,81,3,28,70,18
S01010204,Owned: Total,93,52,46,14,32,3,3,41,33,0,1,4,3
S01010204,Owned: Owned outright,41,10,8,3,5,1,1,31,27,0,1,2,1
S01010204,Owned: Owned with a mortgage or loan or shared ownership,52,42,38,11,27,2,2,10,6,0,0,2,2
S01010204,Rented or living rent free: Total,288,129,105,48,57,4,20,159,48,3,27,66,15
S01010204,Rented or living rent free: Social rented,264,116,96,43,53,3,17,148,46,3,23,63,13
S01010204,Rented or living rent free: Private rented or living rent free,24,13,9,5,4,1,3,11,2,0,4,3,2
S01010205,All HRPs aged 16 and over,355,190,164,29,135,13,13,165,88,10,11,47,9
S01010205,Owned: Total,146,102,88,10,78,10,4,44,36,2,0,5,1
S01010205,Owned: Owned outright,60,26,21,3,18,4,1,34,30,1,0,2,1
S01010205,Owned: Owned with a mortgage or loan or shared ownership,86,76,67,7,60,6,3,10,6,1,0,3,0
S01010205,Rented or living rent free: Total,209,88,76,19,57,3,9,121,52,8,11,42,8
S01010205,Rented or living rent free: Social rented,174,70,58,13,45,3,9,104,52,3,7,35,7
S01010205,Rented or living rent free: Private rented or living rent free,35,18,18,6,12,0,0,17,0,5,4,7,1
S01010206,All HRPs aged 16 and over,255,51,27,4,23,2,22,204,5,67,56,10,66
S01010206,Owned: Total,9,6,5,0,5,0,1,3,3,0,0,0,0
S01010206,Owned: Owned outright,4,2,1,0,1,0,1,2,2,0,0,0,0
S01010206,Owned: Owned with a mortgage or loan or shared ownership,5,4,4,0,4,0,0,1,1,0,0,0,0
S01010206,Rented or living rent free: Total,246,45,22,4,18,2,21,201,2,67,56,10,66
S01010206,Rented or living rent free: Social rented,131,25,10,2,8,1,14,106,2,39,34,9,22
S01010206,Rented or living rent free: Private rented or living rent free,115,20,12,2,10,1,7,95,0,28,22,1,44
S01010207,All HRPs aged 16 and over,285,118,80,39,41,10,28,167,30,21,41,40,35
S01010207,Owned: Total,41,25,21,6,15,4,0,16,11,0,0,3,2
S01010207,Owned: Owned outright,27,14,12,4,8,2,0,13,9,0,0,3,1
S01010207,Owned: Owned with a mortgage or loan or shared ownership,14,11,9,2,7,2,0,3,2,0,0,0,1
S01010207,Rented or living rent free: Total,244,93,59,33,26,6,28,151,19,21,41,37,33
S01010207,Rented or living rent free: Social rented,155,55,34,23,11,3,18,100,17,16,24,28,15
S01010207,Rented or living rent free: Private rented or living rent free,89,38,25,10,15,3,10,51,2,5,17,9,18
S01010208,All HRPs aged 16 and over,565,377,317,50,267,26,34,188,105,11,8,45,19
S01010208,Owned: Total,272,227,203,21,182,15,9,45,36,0,0,6,3
S01010208,Owned: Owned outright,45,20,18,5,13,1,1,25,20,0,0,4,1
S01010208,Owned: Owned with a mortgage or loan or shared ownership,227,207,185,16,169,14,8,20,16,0,0,2,2
S01010208,Rented or living rent free: Total,293,150,114,29,85,11,25,143,69,11,8,39,16
S01010208,Rented or living rent free: Social rented,183,75,58,16,42,5,12,108,59,3,6,30,10
S01010208,Rented or living rent free: Private rented or living rent free,110,75,56,13,43,6,13,35,10,8,2,9,6
S01010209,All HRPs aged 16 and over,468,254,203,38,165,21,30,214,116,5,24,59,10
S01010209,Owned: Total,172,131,119,12,107,10,2,41,33,1,1,4,2
S01010209,Owned: Owned outright,55,22,20,1,19,2,0,33,28,1,0,2,2
S01010209,Owned: Owned with a mortgage or loan or shared ownership,117,109,99,11,88,8,2,8,5,0,1,2,0
S01010209,Rented or living rent free: Total,296,123,84,26,58,11,28,173,83,4,23,55,8
S01010209,Rented or living rent free: Social rented,253,94,65,22,43,5,24,159,80,2,20,51,6
S01010209,Rented or living rent free: Private rented or living rent free,43,29,19,4,15,6,4,14,3,2,3,4,2
S01010210,All HRPs aged 16 and over,416,206,180,38,142,14,12,210,159,2,9,30,10
S01010210,Owned: Total,273,158,141,20,121,12,5,115,103,0,3,6,3
S01010210,Owned: Owned outright,134,39,35,10,25,2,2,95,91,0,1,2,1
S01010210,Owned: Owned with a mortgage or loan or shared ownership,139,119,106,10,96,10,3,20,12,0,2,4,2
S01010210,Rented or living rent free: Total,143,48,39,18,21,2,7,95,56,2,6,24,7
S01010210,Rented or living rent free: Social rented,103,27,22,13,9,1,4,76,50,1,4,19,2
S01010210,Rented or living rent free: Private rented or living rent free,40,21,17,5,12,1,3,19,6,1,2,5,5
S01010211,All HRPs aged 16 and over,452,202,165,47,118,10,27,250,155,7,20,60,8
S01010211,Owned: Total,146,87,78,16,62,5,4,59,53,0,1,3,2
S01010211,Owned: Owned outright,69,25,22,9,13,1,2,44,42,0,0,1,1
S01010211,Owned: Owned with a mortgage or loan or shared ownership,77,62,56,7,49,4,2,15,11,0,1,2,1
S01010211,Rented or living rent free: Total,306,115,87,31,56,5,23,191,102,7,19,57,6
S01010211,Rented or living rent free: Social rented,268,93,68,27,41,3,22,175,97,3,17,54,4
S01010211,Rented or living rent free: Private rented or living rent free,38,22,19,4,15,2,1,16,5,4,2,3,2
S01010212,All HRPs aged 16 and over,559,279,217,59,158,13,49,280,109,16,26,110,19
S01010212,Owned: Total,97,67,63,9,54,2,2,30,26,0,0,4,0
S01010212,Owned: Owned outright,34,14,13,4,9,0,1,20,19,0,0,1,0
S01010212,Owned: Owned with a mortgage or loan or shared ownership,63,53,50,5,45,2,1,10,7,0,0,3,0
S01010212,Rented or living rent free: Total,462,212,154,50,104,11,47,250,83,16,26,106,19
S01010212,Rented or living rent free: Social rented,410,178,129,46,83,9,40,232,79,8,25,104,16
S01010212,Rented or living rent free: Private rented or living rent free,52,34,25,4,21,2,7,18,4,8,1,2,3
S01010213,All HRPs aged 16 and over,476,207,193,29,164,7,7,269,203,3,14,36,13
S01010213,Owned: Total,239,127,121,12,109,5,1,112,97,2,2,6,5
S01010213,Owned: Owned outright,104,29,29,3,26,0,0,75,70,1,1,2,1
S01010213,Owned: Owned with a mortgage or loan or shared ownership,135,98,92,9,83,5,1,37,27,1,1,4,4
S01010213,Rented or living rent free: Total,237,80,72,17,55,2,6,157,106,1,12,30,8
S01010213,Rented or living rent free: Social rented,187,50,45,10,35,1,4,137,102,0,6,23,6
S01010213,Rented or living rent free: Private rented or living rent free,50,30,27,7,20,1,2,20,4,1,6,7,2
S01010214,All HRPs aged 16 and over,396,237,203,45,158,21,13,159,129,1,9,13,7
S01010214,Owned: Total,316,196,171,31,140,19,6,120,105,0,1,8,6
S01010214,Owned: Owned outright,142,51,44,10,34,4,3,91,82,0,1,4,4
S01010214,Owned: Owned with a mortgage or loan or shared ownership,174,145,127,21,106,15,3,29,23,0,0,4,2
S01010214,Rented or living rent free: Total,80,41,32,14,18,2,7,39,24,1,8,5,1
S01010214,Rented or living rent free: Social rented,36,16,12,4,8,1,3,20,14,0,2,4,0
S01010214,Rented or living rent free: Private rented or living rent free,44,25,20,10,10,1,4,19,10,1,6,1,1
S01010215,All HRPs aged 16 and over,492,205,160,50,110,9,36,287,180,7,20,65,15
S01010215,Owned: Total,63,36,30,3,27,5,1,27,20,0,0,6,1
S01010215,Owned: Owned outright,28,10,8,2,6,1,1,18,14,0,0,3,1
S01010215,Owned: Owned with a mortgage or loan or shared ownership,35,26,22,1,21,4,0,9,6,0,0,3,0
S01010215,Rented or living rent free: Total,429,169,130,47,83,4,35,260,160,7,20,59,14
S01010215,Rented or living rent free: Social rented,415,158,122,45,77,3,33,257,160,6,19,58,14
S01010215,Rented or living rent free: Private rented or living rent free,14,11,8,2,6,1,2,3,0,1,1,1,0
S01010216,All HRPs aged 16 and over,361,170,130,39,91,13,27,191,100,6,12,58,15
S01010216,Owned: Total,43,37,34,6,28,3,0,6,2,0,0,3,1
S01010216,Owned: Owned outright,8,4,4,1,3,0,0,4,2,0,0,2,0
S01010216,Owned: Owned with a mortgage or loan or shared ownership,35,33,30,5,25,3,0,2,0,0,0,1,1
S01010216,Rented or living rent free: Total,318,133,96,33,63,10,27,185,98,6,12,55,14
S01010216,Rented or living rent free: Social rented,287,115,81,30,51,8,26,172,96,2,10,53,11
S01010216,Rented or living rent free: Private rented or living rent free,31,18,15,3,12,2,1,13,2,4,2,2,3
S01010217,All HRPs aged 16 and over,406,239,180,37,143,7,52,167,41,24,30,60,12
S01010217,Owned: Total,81,71,67,3,64,1,3,10,10,0,0,0,0
S01010217,Owned: Owned outright,19,11,9,1,8,0,2,8,8,0,0,0,0
S01010217,Owned: Owned with a mortgage or loan or shared ownership,62,60,58,2,56,1,1,2,2,0,0,0,0
S01010217,Rented or living rent free: Total,325,168,113,34,79,6,49,157,31,24,30,60,12
S01010217,Rented or living rent free: Social rented,245,120,73,27,46,4,43,125,28,5,30,52,10
S01010217,Rented or living rent free: Private rented or living rent free,80,48,40,7,33,2,6,32,3,19,0,8,2
S01010218,All HRPs aged 16 and over,587,380,293,46,247,29,58,207,94,11,19,59,24
S01010218,Owned: Total,196,175,151,11,140,18,6,21,18,0,0,2,1
S01010218,Owned: Owned outright,48,31,25,1,24,3,3,17,15,0,0,2,0
S01010218,Owned: Owned with a mortgage or loan or shared ownership,148,144,126,10,116,15,3,4,3,0,0,0,1
S01010218,Rented or living rent free: Total,391,205,142,35,107,11,52,186,76,11,19,57,23
S01010218,Rented or living rent free: Social rented,329,161,108,29,79,10,43,168,73,7,16,52,20
S01010218,Rented or living rent free: Private rented or living rent free,62,44,34,6,28,1,9,18,3,4,3,5,3
S01010219,All HRPs aged 16 and over,274,155,114,43,71,6,35,119,44,24,10,30,11
S01010219,Owned: Total,26,15,14,3,11,1,0,11,10,0,0,1,0
S01010219,Owned: Owned outright,16,5,4,2,2,1,0,11,10,0,0,1,0
S01010219,Owned: Owned with a mortgage or loan or shared ownership,10,10,10,1,9,0,0,0,0,0,0,0,0
S01010219,Rented or living rent free: Total,248,140,100,40,60,5,35,108,34,24,10,29,11
S01010219,Rented or living rent free: Social rented,231,129,93,39,54,5,31,102,33,20,10,28,11
S01010219,Rented or living rent free: Private rented or living rent free,17,11,7,1,6,0,4,6,1,4,0,1,0
S01010220,All HRPs aged 16 and over,279,238,191,26,165,42,5,41,3,30,1,4,3
S01010220,Owned: Total,161,143,110,5,105,30,3,18,3,15,0,0,0
S01010220,Owned: Owned outright,40,29,20,1,19,8,1,11,3,8,0,0,0
S01010220,Owned: Owned with a mortgage or loan or shared ownership,121,114,90,4,86,22,2,7,0,7,0,0,0
S01010220,Rented or living rent free: Total,118,95,81,21,60,12,2,23,0,15,1,4,3
S01010220,Rented or living rent free: Social rented,18,12,11,3,8,1,0,6,0,0,1,4,1
S01010220,Rented or living rent free: Private rented or living rent free,100,83,70,18,52,11,2,17,0,15,0,0,2
S01010221,All HRPs aged 16 and over,260,117,95,29,66,5,17,143,77,6,10,42,8
S01010221,Owned: Total,26,16,14,2,12,1,1,10,9,0,0,0,1
S01010221,Owned: Owned outright,14,6,4,1,3,1,1,8,8,0,0,0,0
S01010221,Owned: Owned with a mortgage or loan or shared ownership,12,10,10,1,9,0,0,2,1,0,0,0,1
S01010221,Rented or living rent free: Total,234,101,81,27,54,4,16,133,68,6,10,42,7
S01010221,Rented or living rent free: Social rented,218,88,68,20,48,4,16,130,68,6,9,40,7
S01010221,Rented or living rent free: Private rented or living rent free,16,13,13,7,6,0,0,3,0,0,1,2,0
S01010222,All HRPs aged 16 and over,285,179,146,25,121,11,22,106,56,11,8,26,5
S01010222,Owned: Total,89,69,58,7,51,8,3,20,14,0,0,6,0
S01010222,Owned: Owned outright,24,9,6,3,3,2,1,15,10,0,0,5,0
S01010222,Owned: Owned with a mortgage or loan or shared ownership,65,60,52,4,48,6,2,5,4,0,0,1,0
S01010222,Rented or living rent free: Total,196,110,88,18,70,3,19,86,42,11,8,20,5
S01010222,Rented or living rent free: Social rented,127,62,47,14,33,2,13,65,35,2,6,18,4
S01010222,Rented or living rent free: Private rented or living rent free,69,48,41,4,37,1,6,21,7,9,2,2,1
S01010223,All HRPs aged 16 and over,337,175,137,24,113,18,20,162,95,11,9,36,11
S01010223,Owned: Total,101,74,63,5,58,7,4,27,23,1,0,1,2
S01010223,Owned: Owned outright,27,13,10,2,8,1,2,14,14,0,0,0,0
S01010223,Owned: Owned with a mortgage or loan or shared ownership,74,61,53,3,50,6,2,13,9,1,0,1,2
S01010223,Rented or living rent free: Total,236,101,74,19,55,11,16,135,72,10,9,35,9
S01010223,Rented or living rent free: Social rented,193,73,53,12,41,7,13,120,72,8,5,29,6
S01010223,Rented or living rent free: Private rented or living rent free,43,28,21,7,14,4,3,15,0,2,4,6,3
S01010224,All HRPs aged 16 and over,469,241,174,66,108,16,51,228,83,8,28,87,22
S01010224,Owned: Total,43,36,32,3,29,4,0,7,2,1,0,4,0
S01010224,Owned: Owned outright,7,4,3,1,2,1,0,3,1,1,0,1,0
S01010224,Owned: Owned with a mortgage or loan or shared ownership,36,32,29,2,27,3,0,4,1,0,0,3,0
S01010224,Rented or living rent free: Total,426,205,142,63,79,12,51,221,81,7,28,83,22
S01010224,Rented or living rent free: Social rented,416,200,139,62,77,11,50,216,81,7,26,83,19
S01010224,Rented or living rent free: Private rented or living rent free,10,5,3,1,2,1,1,5,0,0,2,0,3
S01010225,All HRPs aged 16 and over,431,256,217,55,162,11,28,175,71,23,24,39,18
S01010225,Owned: Total,143,107,100,13,87,5,2,36,24,1,4,7,0
S01010225,Owned: Owned outright,35,17,15,4,11,1,1,18,13,1,0,4,0
S01010225,Owned: Owned with a mortgage or loan or shared ownership,108,90,85,9,76,4,1,18,11,0,4,3,0
S01010225,Rented or living rent free: Total,288,149,117,42,75,6,26,139,47,22,20,32,18
S01010225,Rented or living rent free: Social rented,241,112,84,33,51,5,23,129,45,19,19,30,16
S01010225,Rented or living rent free: Private rented or living rent free,47,37,33,9,24,1,3,10,2,3,1,2,2
S01010226,All HRPs aged 16 and over,394,214,139,53,86,27,48,180,45,34,19,56,26
S01010226,Owned: Total,22,18,12,3,9,6,0,4,0,2,0,1,1
S01010226,Owned: Owned outright,11,9,7,3,4,2,0,2,0,0,0,1,1
S01010226,Owned: Owned with a mortgage or loan or shared ownership,11,9,5,0,5,4,0,2,0,2,0,0,0
S01010226,Rented or living rent free: Total,372,196,127,50,77,21,48,176,45,32,19,55,25
S01010226,Rented or living rent free: Social rented,355,192,124,49,75,20,48,163,45,23,18,55,22
S01010226,Rented or living rent free: Private rented or living rent free,17,4,3,1,2,1,0,13,0,9,1,0,3
S01010227,All HRPs aged 16 and over,294,159,101,19,82,12,46,135,20,18,27,41,29
S01010227,Owned: Total,15,10,8,0,8,2,0,5,1,1,2,0,1
S01010227,Owned: Owned outright,7,4,3,0,3,1,0,3,1,0,1,0,1
S01010227,Owned: Owned with a mortgage or loan or shared ownership,8,6,5,0,5,1,0,2,0,1,1,0,0
S01010227,Rented or living rent free: Total,279,149,93,19,74,10,46,130,19,17,25,41,28
S01010227,Rented or living rent free: Social rented,260,136,86,18,68,8,42,124,19,15,25,40,25
S01010227,Rented or living rent free: Private rented or living rent free,19,13,7,1,6,2,4,6,0,2,0,1,3
S01010228,All HRPs aged 16 and over,384,168,139,37,102,8,21,216,125,1,13,64,13
S01010228,Owned: Total,117,50,44,4,40,4,2,67,62,0,0,5,0
S01010228,Owned: Owned outright,67,12,10,2,8,0,2,55,51,0,0,4,0
S01010228,Owned: Owned with a mortgage or loan or shared ownership,50,38,34,2,32,4,0,12,11,0,0,1,0
S01010228,Rented or living rent free: Total,267,118,95,33,62,4,19,149,63,1,13,59,13
S01010228,Rented or living rent free: Social rented,251,110,87,29,58,4,19,141,62,1,11,58,9
S01010228,Rented or living rent free: Private rented or living rent free,16,8,8,4,4,0,0,8,1,0,2,1,4
S01010229,All HRPs aged 16 and over,508,287,240,67,173,22,25,221,95,2,21,87,16
S01010229,Owned: Total,152,125,111,23,88,10,4,27,15,0,3,8,1
S01010229,Owned: Owned outright,29,16,13,5,8,3,0,13,10,0,2,1,0
S01010229,Owned: Owned with a mortgage or loan or shared ownership,123,109,98,18,80,7,4,14,5,0,1,7,1
S01010229,Rented or living rent free: Total,356,162,129,44,85,12,21,194,80,2,18,79,15
S01010229,Rented or living rent free: Social rented,326,146,120,40,80,8,18,180,78,1,16,71,14
S01010229,Rented or living rent free: Private rented or living rent free,30,16,9,4,5,4,3,14,2,1,2,8,1
S01010230,All HRPs aged 16 and over,577,299,220,78,142,9,70,278,106,46,22,73,31
S01010230,Owned: Total,34,19,17,5,12,2,0,15,11,0,0,4,0
S01010230,Owned: Owned outright,10,4,4,2,2,0,0,6,5,0,0,1,0
S01010230,Owned: Owned with a mortgage or loan or shared ownership,24,15,13,3,10,2,0,9,6,0,0,3,0
S01010230,Rented or living rent free: Total,543,280,203,73,130,7,70,263,95,46,22,69,31
S01010230,Rented or living rent free: Social rented,525,266,194,71,123,6,66,259,95,43,22,69,30
S01010230,Rented or living rent free: Private rented or living rent free,18,14,9,2,7,1,4,4,0,3,0,0,1
S01010231,All HRPs aged 16 and over,514,284,224,64,160,17,43,230,123,16,20,54,17
S01010231,Owned: Total,24,10,7,2,5,1,2,14,11,1,0,1,1
S01010231,Owned: Owned outright,11,3,2,0,2,1,0,8,8,0,0,0,0
S01010231,Owned: Owned with a mortgage or loan or shared ownership,13,7,5,2,3,0,2,6,3,1,0,1,1
S01010231,Rented or living rent free: Total,490,274,217,62,155,16,41,216,112,15,20,53,16
S01010231,Rented or living rent free: Social rented,473,266,210,60,150,16,40,207,112,10,17,52,16
S01010231,Rented or living rent free: Private rented or living rent free,17,8,7,2,5,0,1,9,0,5,3,1,0
S01010232,All HRPs aged 16 and over,485,302,224,72,152,17,61,183,57,15,25,55,31
S01010232,Owned: Total,77,68,58,11,47,9,1,9,5,0,0,2,2
S01010232,Owned: Owned outright,9,7,6,1,5,1,0,2,2,0,0,0,0
S01010232,Owned: Owned with a mortgage or loan or shared ownership,68,61,52,10,42,8,1,7,3,0,0,2,2
S01010232,Rented or living rent free: Total,408,234,166,61,105,8,60,174,52,15,25,53,29
S01010232,Rented or living rent free: Social rented,381,222,158,58,100,8,56,159,51,9,24,52,23
S01010232,Rented or living rent free: Private rented or living rent free,27,12,8,3,5,0,4,15,1,6,1,1,6
S01010233,All HRPs aged 16 and over,476,250,174,60,114,10,66,226,69,16,40,67,34
S01010233,Owned: Total,70,36,33,11,22,3,0,34,30,0,0,3,1
S01010233,Owned: Owned outright,39,14,14,4,10,0,0,25,21,0,0,3,1
S01010233,Owned: Owned with a mortgage or loan or shared ownership,31,22,19,7,12,3,0,9,9,0,0,0,0
S01010233,Rented or living rent free: Total,406,214,141,49,92,7,66,192,39,16,40,64,33
S01010233,Rented or living rent free: Social rented,388,202,134,46,88,5,63,186,39,16,38,62,31
S01010233,Rented or living rent free: Private rented or living rent free,18,12,7,3,4,2,3,6,0,0,2,2,2
S01010234,All HRPs aged 16 and over,562,366,300,51,249,43,23,196,119,21,13,36,7
S01010234,Owned: Total,270,182,146,11,135,32,4,88,78,1,0,8,1
S01010234,Owned: Owned outright,117,42,27,5,22,12,3,75,71,1,0,3,0
S01010234,Owned: Owned with a mortgage or loan or shared ownership,153,140,119,6,113,20,1,13,7,0,0,5,1
S01010234,Rented or living rent free: Total,292,184,154,40,114,11,19,108,41,20,13,28,6
S01010234,Rented or living rent free: Social rented,80,19,14,6,8,1,4,61,29,1,6,24,1
S01010234,Rented or living rent free: Private rented or living rent free,212,165,140,34,106,10,15,47,12,19,7,4,5
S01010235,All HRPs aged 16 and over,446,376,349,64,285,15,12,70,5,45,12,7,1
S01010235,Owned: Total,193,178,166,17,149,11,1,15,3,8,4,0,0
S01010235,Owned: Owned outright,30,20,18,8,10,1,1,10,3,4,3,0,0
S01010235,Owned: Owned with a mortgage or loan or shared ownership,163,158,148,9,139,10,0,5,0,4,1,0,0
S01010235,Rented or living rent free: Total,253,198,183,47,136,4,11,55,2,37,8,7,1
S01010235,Rented or living rent free: Social rented,5,3,3,1,2,0,0,2,0,1,0,1,0
S01010235,Rented or living rent free: Private rented or living rent free,248,195,180,46,134,4,11,53,2,36,8,6,1
S01010236,All HRPs aged 16 and over,378,272,229,43,186,27,16,106,62,15,4,9,16
S01010236,Owned: Total,212,165,143,16,127,20,2,47,39,0,1,5,2
S01010236,Owned: Owned outright,83,41,37,10,27,3,1,42,37,0,1,2,2
S01010236,Owned: Owned with a mortgage or loan or shared ownership,129,124,106,6,100,17,1,5,2,0,0,3,0
S01010236,Rented or living rent free: Total,166,107,86,27,59,7,14,59,23,15,3,4,14
S01010236,Rented or living rent free: Social rented,39,11,7,2,5,1,3,28,13,3,3,0,9
S01010236,Rented or living rent free: Private rented or living rent free,127,96,79,25,54,6,11,31,10,12,0,4,5
S01010237,All HRPs aged 16 and over,353,252,204,35,169,31,17,101,57,16,2,22,4
S01010237,Owned: Total,196,142,109,11,98,24,9,54,42,4,0,6,2
S01010237,Owned: Owned outright,72,34,25,5,20,5,4,38,34,0,0,3,1
S01010237,Owned: Owned with a mortgage or loan or shared ownership,124,108,84,6,78,19,5,16,8,4,0,3,1
S01010237,Rented or living rent free: Total,157,110,95,24,71,7,8,47,15,12,2,16,2
S01010237,Rented or living rent free: Social rented,54,24,16,5,11,2,6,30,14,0,1,13,2
S01010237,Rented or living rent free: Private rented or living rent free,103,86,79,19,60,5,2,17,1,12,1,3,0
S01010238,All HRPs aged 16 and over,455,321,268,59,209,34,19,134,70,31,9,21,3
S01010238,Owned: Total,229,168,141,17,124,21,6,61,44,8,2,6,1
S01010238,Owned: Owned outright,89,42,35,9,26,5,2,47,39,3,1,3,1
S01010238,Owned: Owned with a mortgage or loan or shared ownership,140,126,106,8,98,16,4,14,5,5,1,3,0
S01010238,Rented or living rent free: Total,226,153,127,42,85,13,13,73,26,23,7,15,2
S01010238,Rented or living rent free: Social rented,58,21,16,9,7,1,4,37,18,2,4,12,1
S01010238,Rented or living rent free: Private rented or living rent free,168,132,111,33,78,12,9,36,8,21,3,3,1
S01010239,All HRPs aged 16 and over,424,226,191,55,136,11,24,198,124,8,12,46,8
S01010239,Owned: Total,133,86,75,15,60,6,5,47,46,0,0,1,0
S01010239,Owned: Owned outright,55,20,16,7,9,2,2,35,35,0,0,0,0
S01010239,Owned: Owned with a mortgage or loan or shared ownership,78,66,59,8,51,4,3,12,11,0,0,1,0
S01010239,Rented or living rent free: Total,291,140,116,40,76,5,19,151,78,8,12,45,8
S01010239,Rented or living rent free: Social rented,226,92,74,33,41,3,15,134,76,3,5,42,8
S01010239,Rented or living rent free: Private rented or living rent free,65,48,42,7,35,2,4,17,2,5,7,3,0
S01010240,All HRPs aged 16 and over,398,264,236,47,189,13,15,134,70,14,7,28,15
S01010240,Owned: Total,157,123,114,9,105,5,4,34,27,3,1,1,2
S01010240,Owned: Owned outright,55,30,25,5,20,2,3,25,23,0,0,0,2
S01010240,Owned: Owned with a mortgage or loan or shared ownership,102,93,89,4,85,3,1,9,4,3,1,1,0
S01010240,Rented or living rent free: Total,241,141,122,38,84,8,11,100,43,11,6,27,13
S01010240,Rented or living rent free: Social rented,145,73,61,19,42,4,8,72,39,1,3,20,9
S01010240,Rented or living rent free: Private rented or living rent free,96,68,61,19,42,4,3,28,4,10,3,7,4
S01010241,All HRPs aged 16 and over,623,403,327,63,264,36,40,220,144,17,10,37,12
S01010241,Owned: Total,263,194,166,19,147,25,3,69,58,4,0,4,3
S01010241,Owned: Owned outright,103,45,37,6,31,6,2,58,50,2,0,4,2
S01010241,Owned: Owned with a mortgage or loan or shared ownership,160,149,129,13,116,19,1,11,8,2,0,0,1
S01010241,Rented or living rent free: Total,360,209,161,44,117,11,37,151,86,13,10,33,9
S01010241,Rented or living rent free: Social rented,183,79,55,19,36,4,20,104,77,1,2,18,6
S01010241,Rented or living rent free: Private rented or living rent free,177,130,106,25,81,7,17,47,9,12,8,15,3
S01010242,All HRPs aged 16 and over,455,309,248,65,183,19,42,146,53,10,14,56,13
S01010242,Owned: Total,110,87,78,8,70,7,2,23,15,3,1,4,0
S01010242,Owned: Owned outright,32,16,12,2,10,2,2,16,13,1,1,1,0
S01010242,Owned: Owned with a mortgage or loan or shared ownership,78,71,66,6,60,5,0,7,2,2,0,3,0
S01010242,Rented or living rent free: Total,345,222,170,57,113,12,40,123,38,7,13,52,13
S01010242,Rented or living rent free: Social rented,217,114,83,33,50,5,26,103,32,2,10,49,10
S01010242,Rented or living rent free: Private rented or living rent free,128,108,87,24,63,7,14,20,6,5,3,3,3
S01010243,All HRPs aged 16 and over,610,423,315,73,242,27,81,187,44,25,19,72,27
S01010243,Owned: Total,121,96,82,12,70,7,7,25,19,2,1,0,3
S01010243,Owned: Owned outright,38,17,12,5,7,1,4,21,19,1,0,0,1
S01010243,Owned: Owned with a mortgage or loan or shared ownership,83,79,70,7,63,6,3,4,0,1,1,0,2
S01010243,Rented or living rent free: Total,489,327,233,61,172,20,74,162,25,23,18,72,24
S01010243,Rented or living rent free: Social rented,279,168,119,42,77,12,37,111,21,3,15,52,20
S01010243,Rented or living rent free: Private rented or living rent free,210,159,114,19,95,8,37,51,4,20,3,20,4
S01010244,All HRPs aged 16 and over,440,224,150,43,107,18,56,216,82,25,12,74,23
S01010244,Owned: Total,72,42,36,4,32,6,0,30,20,4,0,1,5
S01010244,Owned: Owned outright,29,9,7,1,6,2,0,20,15,1,0,0,4
S01010244,Owned: Owned with a mortgage or loan or shared ownership,43,33,29,3,26,4,0,10,5,3,0,1,1
S01010244,Rented or living rent free: Total,368,182,114,39,75,12,56,186,62,21,12,73,18
S01010244,Rented or living rent free: Social rented,316,153,89,33,56,10,54,163,61,6,12,70,14
S01010244,Rented or living rent free: Private rented or living rent free,52,29,25,6,19,2,2,23,1,15,0,3,4
S01010245,All HRPs aged 16 and over,509,216,152,62,90,13,51,293,104,13,31,123,22
S01010245,Owned: Total,35,17,11,2,9,5,1,18,10,3,2,2,1
S01010245,Owned: Owned outright,13,2,1,0,1,0,1,11,8,1,0,1,1
S01010245,Owned: Owned with a mortgage or loan or shared ownership,22,15,10,2,8,5,0,7,2,2,2,1,0
S01010245,Rented or living rent free: Total,474,199,141,60,81,8,50,275,94,10,29,121,21
S01010245,Rented or living rent free: Social rented,446,185,131,55,76,7,47,261,93,3,27,117,21
S01010245,Rented or living rent free: Private rented or living rent free,28,14,10,5,5,1,3,14,1,7,2,4,0
S01010246,All HRPs aged 16 and over,433,224,177,45,132,16,31,209,81,17,34,60,17
S01010246,Owned: Total,65,48,41,3,38,6,1,17,12,3,0,2,0
S01010246,Owned: Owned outright,31,17,12,1,11,4,1,14,11,2,0,1,0
S01010246,Owned: Owned with a mortgage or loan or shared ownership,34,31,29,2,27,2,0,3,1,1,0,1,0
S01010246,Rented or living rent free: Total,368,176,136,42,94,10,30,192,69,14,34,58,17
S01010246,Rented or living rent free: Social rented,284,122,95,36,59,4,23,162,64,2,34,50,12
S01010246,Rented or living rent free: Private rented or living rent free,84,54,41,6,35,6,7,30,5,12,0,8,5
S01010247,All HRPs aged 16 and over,356,208,182,28,154,18,8,148,109,1,12,21,5
S01010247,Owned: Total,242,178,161,24,137,16,1,64,56,0,2,4,2
S01010247,Owned: Owned outright,80,39,35,11,24,4,0,41,41,0,0,0,0
S01010247,Owned: Owned with a mortgage or loan or shared ownership,162,139,126,13,113,12,1,23,15,0,2,4,2
S01010247,Rented or living rent free: Total,114,30,21,4,17,2,7,84,53,1,10,17,3
S01010247,Rented or living rent free: Social rented,97,21,16,2,14,1,4,76,52,0,8,15,1
S01010247,Rented or living rent free: Private rented or living rent free,17,9,5,2,3,1,3,8,1,1,2,2,2
S01010248,All HRPs aged 16 and over,456,334,279,43,236,36,19,122,77,22,1,19,3
S01010248,Owned: Total,277,208,173,17,156,28,7,69,53,7,0,9,0
S01010248,Owned: Owned outright,88,36,28,5,23,7,1,52,46,4,0,2,0
S01010248,Owned: Owned with a mortgage or loan or shared ownership,189,172,145,12,133,21,6,17,7,3,0,7,0
S01010248,Rented or living rent free: Total,179,126,106,26,80,8,12,53,24,15,1,10,3
S01010248,Rented or living rent free: Social rented,22,7,5,2,3,0,2,15,11,0,0,1,3
S01010248,Rented or living rent free: Private rented or living rent free,157,119,101,24,77,8,10,38,13,15,1,9,0
S01010249,All HRPs aged 16 and over,403,292,249,53,196,13,30,111,60,21,7,20,3
S01010249,Owned: Total,201,142,130,13,117,7,5,59,45,6,2,6,0
S01010249,Owned: Owned outright,76,32,27,5,22,3,2,44,39,4,1,0,0
S01010249,Owned: Owned with a mortgage or loan or shared ownership,125,110,103,8,95,4,3,15,6,2,1,6,0
S01010249,Rented or living rent free: Total,202,150,119,40,79,6,25,52,15,15,5,14,3
S01010249,Rented or living rent free: Social rented,16,10,4,0,4,0,6,6,3,0,1,1,1
S01010249,Rented or living rent free: Private rented or living rent free,186,140,115,40,75,6,19,46,12,15,4,13,2
S01010250,All HRPs aged 16 and over,390,312,266,49,217,29,17,78,38,23,5,6,6
S01010250,Owned: Total,185,150,127,10,117,18,5,35,26,5,1,2,1
S01010250,Owned: Owned outright,60,28,26,6,20,1,1,32,25,4,1,1,1
S01010250,Owned: Owned with a mortgage or loan or shared ownership,125,122,101,4,97,17,4,3,1,1,0,1,0
S01010250,Rented or living rent free: Total,205,162,139,39,100,11,12,43,12,18,4,4,5
S01010250,Rented or living rent free: Social rented,10,6,4,2,2,1,1,4,2,0,1,1,0
S01010250,Rented or living rent free: Private rented or living rent free,195,156,135,37,98,10,11,39,10,18,3,3,5
S01010251,All HRPs aged 16 and over,317,267,227,44,183,23,17,50,13,20,5,10,2
S01010251,Owned: Total,111,93,78,10,68,13,2,18,13,0,2,2,1
S01010251,Owned: Owned outright,27,15,12,2,10,3,0,12,11,0,0,1,0
S01010251,Owned: Owned with a mortgage or loan or shared ownership,84,78,66,8,58,10,2,6,2,0,2,1,1
S01010251,Rented or living rent free: Total,206,174,149,34,115,10,15,32,0,20,3,8,1
S01010251,Rented or living rent free: Social rented,7,4,4,1,3,0,0,3,0,2,0,1,0
S01010251,Rented or living rent free: Private rented or living rent free,199,170,145,33,112,10,15,29,0,18,3,7,1
S01010252,All HRPs aged 16 and over,297,218,187,18,169,17,14,79,40,12,9,10,8
S01010252,Owned: Total,154,121,103,6,97,13,5,33,24,0,3,5,1
S01010252,Owned: Owned outright,46,22,19,4,15,1,2,24,22,0,0,2,0
S01010252,Owned: Owned with a mortgage or loan or shared ownership,108,99,84,2,82,12,3,9,2,0,3,3,1
S01010252,Rented or living rent free: Total,143,97,84,12,72,4,9,46,16,12,6,5,7
S01010252,Rented or living rent free: Social rented,34,12,9,3,6,1,2,22,10,1,3,4,4
S01010252,Rented or living rent free: Private rented or living rent free,109,85,75,9,66,3,7,24,6,11,3,1,3
S01010253,All HRPs aged 16 and over,364,179,138,33,105,6,35,185,78,21,11,54,21
S01010253,Owned: Total,82,58,51,5,46,5,2,24,13,5,0,2,4
S01010253,Owned: Owned outright,25,13,11,3,8,2,0,12,7,1,0,2,2
S01010253,Owned: Owned with a mortgage or loan or shared ownership,57,45,40,2,38,3,2,12,6,4,0,0,2
S01010253,Rented or living rent free: Total,282,121,87,28,59,1,33,161,65,16,11,52,17
S01010253,Rented or living rent free: Social rented,235,99,72,25,47,0,27,136,62,1,11,48,14
S01010253,Rented or living rent free: Private rented or living rent free,47,22,15,3,12,1,6,25,3,15,0,4,3
S01010254,All HRPs aged 16 and over,581,309,273,61,212,15,21,272,166,7,17,71,11
S01010254,Owned: Total,173,131,119,15,104,8,4,42,32,3,1,6,0
S01010254,Owned: Owned outright,31,13,12,2,10,0,1,18,17,0,0,1,0
S01010254,Owned: Owned with a mortgage or loan or shared ownership,142,118,107,13,94,8,3,24,15,3,1,5,0
S01010254,Rented or living rent free: Total,408,178,154,46,108,7,17,230,134,4,16,65,11
S01010254,Rented or living rent free: Social rented,321,108,92,30,62,4,12,213,132,0,13,60,8
S01010254,Rented or living rent free: Private rented or living rent free,87,70,62,16,46,3,5,17,2,4,3,5,3
S01010255,All HRPs aged 16 and over,353,193,141,41,100,12,40,160,68,5,16,58,13
S01010255,Owned: Total,48,34,30,5,25,1,3,14,10,2,1,0,1
S01010255,Owned: Owned outright,17,7,6,2,4,1,0,10,7,2,1,0,0
S01010255,Owned: Owned with a mortgage or loan or shared ownership,31,27,24,3,21,0,3,4,3,0,0,0,1
S01010255,Rented or living rent free: Total,305,159,111,36,75,11,37,146,58,3,15,58,12
S01010255,Rented or living rent free: Social rented,254,123,85,26,59,7,31,131,57,0,13,51,10
S01010255,Rented or living rent free: Private rented or living rent free,51,36,26,10,16,4,6,15,1,3,2,7,2
S01010256,All HRPs aged 16 and over,516,304,221,69,152,26,57,212,91,9,24,76,12
S01010256,Owned: Total,61,39,33,8,25,6,0,22,16,3,0,3,0
S01010256,Owned: Owned outright,28,15,13,4,9,2,0,13,13,0,0,0,0
S01010256,Owned: Owned with a mortgage or loan or shared ownership,33,24,20,4,16,4,0,9,3,3,0,3,0
S01010256,Rented or living rent free: Total,455,265,188,61,127,20,57,190,75,6,24,73,12
S01010256,Rented or living rent free: Social rented,420,237,165,54,111,17,55,183,74,3,24,70,12
S01010256,Rented or living rent free: Private rented or living rent free,35,28,23,7,16,3,2,7,1,3,0,3,0
S01010257,All HRPs aged 16 and over,497,272,218,65,153,22,32,225,41,134,2,39,9
S01010257,Owned: Total,62,45,35,9,26,8,2,17,8,6,0,3,0
S01010257,Owned: Owned outright,25,13,9,2,7,2,2,12,8,3,0,1,0
S01010257,Owned: Owned with a mortgage or loan or shared ownership,37,32,26,7,19,6,0,5,0,3,0,2,0
S01010257,Rented or living rent free: Total,435,227,183,56,127,14,30,208,33,128,2,36,9
S01010257,Rented or living rent free: Social rented,135,53,36,14,22,5,12,82,31,9,2,33,7
S01010257,Rented or living rent free: Private rented or living rent free,300,174,147,42,105,9,18,126,2,119,0,3,2
S01010258,All HRPs aged 16 and over,424,280,244,71,173,15,21,144,6,133,0,2,3
S01010258,Owned: Total,121,109,95,13,82,9,5,12,4,7,0,0,1
S01010258,Owned: Owned outright,29,21,17,3,14,1,3,8,4,4,0,0,0
S01010258,Owned: Owned with a mortgage or loan or shared ownership,92,88,78,10,68,8,2,4,0,3,0,0,1
S01010258,Rented or living rent free: Total,303,171,149,58,91,6,16,132,2,126,0,2,2
S01010258,Rented or living rent free: Social rented,16,4,2,1,1,0,2,12,2,8,0,1,1
S01010258,Rented or living rent free: Private rented or living rent free,287,167,147,57,90,6,14,120,0,118,0,1,1
S01010259,All HRPs aged 16 and over,468,215,156,60,96,14,45,253,120,27,13,79,14
S01010259,Owned: Total,57,35,31,6,25,1,3,22,20,0,0,2,0
S01010259,Owned: Owned outright,33,15,12,2,10,0,3,18,17,0,0,1,0
S01010259,Owned: Owned with a mortgage or loan or shared ownership,24,20,19,4,15,1,0,4,3,0,0,1,0
S01010259,Rented or living rent free: Total,411,180,125,54,71,13,42,231,100,27,13,77,14
S01010259,Rented or living rent free: Social rented,364,156,107,45,62,11,38,208,99,9,11,76,13
S01010259,Rented or living rent free: Private rented or living rent free,47,24,18,9,9,2,4,23,1,18,2,1,1
S01010260,All HRPs aged 16 and over,685,438,351,82,269,55,32,247,77,108,5,44,13
S01010260,Owned: Total,225,169,141,18,123,24,4,56,34,13,2,6,1
S01010260,Owned: Owned outright,80,42,32,7,25,8,2,38,30,5,0,2,1
S01010260,Owned: Owned with a mortgage or loan or shared ownership,145,127,109,11,98,16,2,18,4,8,2,4,0
S01010260,Rented or living rent free: Total,460,269,210,64,146,31,28,191,43,95,3,38,12
S01010260,Rented or living rent free: Social rented,154,70,48,20,28,6,16,84,39,4,2,32,7
S01010260,Rented or living rent free: Private rented or living rent free,306,199,162,44,118,25,12,107,4,91,1,6,5
S01010261,All HRPs aged 16 and over,526,205,154,65,89,10,41,321,169,67,10,65,10
S01010261,Owned: Total,109,41,37,14,23,4,0,68,56,2,0,8,2
S01010261,Owned: Owned outright,71,20,19,9,10,1,0,51,44,2,0,3,2
S01010261,Owned: Owned with a mortgage or loan or shared ownership,38,21,18,5,13,3,0,17,12,0,0,5,0
S01010261,Rented or living rent free: Total,417,164,117,51,66,6,41,253,113,65,10,57,8
S01010261,Rented or living rent free: Social rented,280,93,57,23,34,4,32,187,111,5,9,54,8
S01010261,Rented or living rent free: Private rented or living rent free,137,71,60,28,32,2,9,66,2,60,1,3,0
S01010262,All HRPs aged 16 and over,535,195,154,58,96,12,29,340,228,26,4,70,12
S01010262,Owned: Total,107,45,36,9,27,4,5,62,52,1,0,9,0
S01010262,Owned: Owned outright,62,22,18,6,12,1,3,40,36,1,0,3,0
S01010262,Owned: Owned with a mortgage or loan or shared ownership,45,23,18,3,15,3,2,22,16,0,0,6,0
S01010262,Rented or living rent free: Total,428,150,118,49,69,8,24,278,176,25,4,61,12
S01010262,Rented or living rent free: Social rented,340,93,70,21,49,4,19,247,170,2,4,59,12
S01010262,Rented or living rent free: Private rented or living rent free,88,57,48,28,20,4,5,31,6,23,0,2,0
S01010263,All HRPs aged 16 and over,422,313,263,45,218,30,20,109,20,67,2,11,9
S01010263,Owned: Total,142,113,90,12,78,18,5,29,11,11,1,2,4
S01010263,Owned: Owned outright,51,29,20,5,15,6,3,22,8,9,1,2,2
S01010263,Owned: Owned with a mortgage or loan or shared ownership,91,84,70,7,63,12,2,7,3,2,0,0,2
S01010263,Rented or living rent free: Total,280,200,173,33,140,12,15,80,9,56,1,9,5
S01010263,Rented or living rent free: Social rented,32,15,8,1,7,3,4,17,5,1,1,8,2
S01010263,Rented or living rent free: Private rented or living rent free,248,185,165,32,133,9,11,63,4,55,0,1,3
S01010264,All HRPs aged 16 and over,557,396,328,66,262,35,33,161,49,51,4,45,12
S01010264,Owned: Total,152,119,101,13,88,13,5,33,22,3,1,4,3
S01010264,Owned: Owned outright,55,34,22,4,18,7,5,21,16,1,1,1,2
S01010264,Owned: Owned with a mortgage or loan or shared ownership,97,85,79,9,70,6,0,12,6,2,0,3,1
S01010264,Rented or living rent free: Total,405,277,227,53,174,22,28,128,27,48,3,41,9
S01010264,Rented or living rent free: Social rented,134,65,48,8,40,6,11,69,27,1,1,36,4
S01010264,Rented or living rent free: Private rented or living rent free,271,212,179,45,134,16,17,59,0,47,2,5,5
S01010265,All HRPs aged 16 and over,573,441,387,67,320,40,14,132,11,111,3,2,5
S01010265,Owned: Total,220,182,154,18,136,22,6,38,9,23,2,2,2
S01010265,Owned: Owned outright,59,35,27,3,24,7,1,24,8,14,0,1,1
S01010265,Owned: Owned with a mortgage or loan or shared ownership,161,147,127,15,112,15,5,14,1,9,2,1,1
S01010265,Rented or living rent free: Total,353,259,233,49,184,18,8,94,2,88,1,0,3
S01010265,Rented or living rent free: Social rented,2,1,1,0,1,0,0,1,1,0,0,0,0
S01010265,Rented or living rent free: Private rented or living rent free,351,258,232,49,183,18,8,93,1,88,1,0,3
S01010266,All HRPs aged 16 and over,237,173,138,48,90,21,14,64,21,31,2,4,6
S01010266,Owned: Total,93,77,61,13,48,12,4,16,14,0,0,0,2
S01010266,Owned: Owned outright,42,27,21,9,12,4,2,15,14,0,0,0,1
S01010266,Owned: Owned with a mortgage or loan or shared ownership,51,50,40,4,36,8,2,1,0,0,0,0,1
S01010266,Rented or living rent free: Total,144,96,77,35,42,9,10,48,7,31,2,4,4
S01010266,Rented or living rent free: Social rented,30,20,15,6,9,3,2,10,3,0,2,3,2
S01010266,Rented or living rent free: Private rented or living rent free,114,76,62,29,33,6,8,38,4,31,0,1,2
S01010267,All HRPs aged 16 and over,318,224,180,66,114,28,16,94,3,82,1,5,3
S01010267,Owned: Total,63,58,39,4,35,15,4,5,0,4,0,1,0
S01010267,Owned: Owned outright,15,12,9,3,6,2,1,3,0,3,0,0,0
S01010267,Owned: Owned with a mortgage or loan or shared ownership,48,46,30,1,29,13,3,2,0,1,0,1,0
S01010267,Rented or living rent free: Total,255,166,141,62,79,13,12,89,3,78,1,4,3
S01010267,Rented or living rent free: Social rented,16,8,4,3,1,2,2,8,3,2,1,0,2
S01010267,Rented or living rent free: Private rented or living rent free,239,158,137,59,78,11,10,81,0,76,0,4,1
S01010268,All HRPs aged 16 and over,417,291,230,61,169,34,27,126,41,43,3,34,5
S01010268,Owned: Total,161,136,109,20,89,18,9,25,18,2,1,3,1
S01010268,Owned: Owned outright,70,49,39,9,30,6,4,21,16,1,1,2,1
S01010268,Owned: Owned with a mortgage or loan or shared ownership,91,87,70,11,59,12,5,4,2,1,0,1,0
S01010268,Rented or living rent free: Total,256,155,121,41,80,16,18,101,23,41,2,31,4
S01010268,Rented or living rent free: Social rented,93,40,29,7,22,4,7,53,17,4,2,27,3
S01010268,Rented or living rent free: Private rented or living rent free,163,115,92,34,58,12,11,48,6,37,0,4,1
S01010269,All HRPs aged 16 and over,320,192,159,43,116,20,13,128,20,76,3,21,8
S01010269,Owned: Total,90,71,55,10,45,12,4,19,10,5,0,2,2
S01010269,Owned: Owned outright,32,19,16,5,11,3,0,13,9,2,0,0,2
S01010269,Owned: Owned with a mortgage or loan or shared ownership,58,52,39,5,34,9,4,6,1,3,0,2,0
S01010269,Rented or living rent free: Total,230,121,104,33,71,8,9,109,10,71,3,19,6
S01010269,Rented or living rent free: Social rented,56,17,14,5,9,0,3,39,9,5,2,19,4
S01010269,Rented or living rent free: Private rented or living rent free,174,104,90,28,62,8,6,70,1,66,1,0,2
S01010270,All HRPs aged 16 and over,817,325,256,65,191,28,41,492,250,81,4,131,26
S01010270,Owned: Total,140,103,83,13,70,16,4,37,32,3,0,2,0
S01010270,Owned: Owned outright,76,44,37,6,31,5,2,32,29,3,0,0,0
S01010270,Owned: Owned with a mortgage or loan or shared ownership,64,59,46,7,39,11,2,5,3,0,0,2,0
S01010270,Rented or living rent free: Total,677,222,173,52,121,12,37,455,218,78,4,129,26
S01010270,Rented or living rent free: Social rented,494,119,82,22,60,7,30,375,212,12,4,126,21
S01010270,Rented or living rent free: Private rented or living rent free,183,103,91,30,61,5,7,80,6,66,0,3,5
S01010271,All HRPs aged 16 and over,327,218,180,58,122,24,14,109,42,50,0,14,3
S01010271,Owned: Total,96,71,58,13,45,11,2,25,17,3,0,4,1
S01010271,Owned: Owned outright,35,22,19,2,17,2,1,13,9,1,0,3,0
S01010271,Owned: Owned with a mortgage or loan or shared ownership,61,49,39,11,28,9,1,12,8,2,0,1,1
S01010271,Rented or living rent free: Total,231,147,122,45,77,13,12,84,25,47,0,10,2
S01010271,Rented or living rent free: Social rented,52,22,17,3,14,5,0,30,20,1,0,7,2
S01010271,Rented or living rent free: Private rented or living rent free,179,125,105,42,63,8,12,54,5,46,0,3,0
S01010272,All HRPs aged 16 and over,703,403,299,58,241,38,66,300,90,57,8,124,21
S01010272,Owned: Total,126,112,94,12,82,13,5,14,6,6,0,2,0
S01010272,Owned: Owned outright,38,27,22,6,16,2,3,11,5,4,0,2,0
S01010272,Owned: Owned with a mortgage or loan or shared ownership,88,85,72,6,66,11,2,3,1,2,0,0,0
S01010272,Rented or living rent free: Total,577,291,205,46,159,25,61,286,84,51,8,122,21
S01010272,Rented or living rent free: Social rented,402,166,101,27,74,12,53,236,82,9,8,118,19
S01010272,Rented or living rent free: Private rented or living rent free,175,125,104,19,85,13,8,50,2,42,0,4,2
S01010273,All HRPs aged 16 and over,409,325,280,56,224,32,13,84,9,66,0,7,2
S01010273,Owned: Total,109,89,72,8,64,14,3,20,5,13,0,1,1
S01010273,Owned: Owned outright,36,20,14,5,9,5,1,16,3,11,0,1,1
S01010273,Owned: Owned with a mortgage or loan or shared ownership,73,69,58,3,55,9,2,4,2,2,0,0,0
S01010273,Rented or living rent free: Total,300,236,208,48,160,18,10,64,4,53,0,6,1
S01010273,Rented or living rent free: Social rented,13,3,2,0,2,1,0,10,3,0,0,6,1
S01010273,Rented or living rent free: Private rented or living rent free,287,233,206,48,158,17,10,54,1,53,0,0,0
S01010274,All HRPs aged 16 and over,342,252,214,42,172,29,9,90,17,64,0,4,5
S01010274,Owned: Total,119,97,82,8,74,14,1,22,10,8,0,1,3
S01010274,Owned: Owned outright,31,19,14,2,12,4,1,12,7,3,0,0,2
S01010274,Owned: Owned with a mortgage or loan or shared ownership,88,78,68,6,62,10,0,10,3,5,0,1,1
S01010274,Rented or living rent free: Total,223,155,132,34,98,15,8,68,7,56,0,3,2
S01010274,Rented or living rent free: Social rented,17,8,6,2,4,0,2,9,5,2,0,2,0
S01010274,Rented or living rent free: Private rented or living rent free,206,147,126,32,94,15,6,59,2,54,0,1,2
S01010275,All HRPs aged 16 and over,357,282,240,63,177,31,11,75,4,63,2,3,3
S01010275,Owned: Total,107,97,78,10,68,18,1,10,2,5,1,0,2
S01010275,Owned: Owned outright,31,23,17,4,13,6,0,8,2,5,0,0,1
S01010275,Owned: Owned with a mortgage or loan or shared ownership,76,74,61,6,55,12,1,2,0,0,1,0,1
S01010275,Rented or living rent free: Total,250,185,162,53,109,13,10,65,2,58,1,3,1
S01010275,Rented or living rent free: Social rented,10,6,2,1,1,4,0,4,1,2,0,1,0
S01010275,Rented or living rent free: Private rented or living rent free,240,179,160,52,108,9,10,61,1,56,1,2,1
S01010276,All HRPs aged 16 and over,625,508,402,35,367,84,22,117,18,81,5,9,4
S01010276,Owned: Total,242,214,161,10,151,50,3,28,15,9,2,1,1
S01010276,Owned: Owned outright,62,45,35,5,30,9,1,17,11,4,0,1,1
S01010276,Owned: Owned with a mortgage or loan or shared ownership,180,169,126,5,121,41,2,11,4,5,2,0,0
S01010276,Rented or living rent free: Total,383,294,241,25,216,34,19,89,3,72,3,8,3
S01010276,Rented or living rent free: Social rented,13,9,6,1,5,1,2,4,0,1,0,3,0
S01010276,Rented or living rent free: Private rented or living rent free,370,285,235,24,211,33,17,85,3,71,3,5,3
S01010277,All HRPs aged 16 and over,305,161,133,44,89,13,15,144,89,17,7,26,5
S01010277,Owned: Total,47,32,25,5,20,5,2,15,11,0,1,3,0
S01010277,Owned: Owned outright,19,11,8,3,5,1,2,8,5,0,0,3,0
S01010277,Owned: Owned with a mortgage or loan or shared ownership,28,21,17,2,15,4,0,7,6,0,1,0,0
S01010277,Rented or living rent free: Total,258,129,108,39,69,8,13,129,78,17,6,23,5
S01010277,Rented or living rent free: Social rented,194,85,74,31,43,3,8,109,75,3,5,21,5
S01010277,Rented or living rent free: Private rented or living rent free,64,44,34,8,26,5,5,20,3,14,1,2,0
S01010278,All HRPs aged 16 and over,330,224,182,66,116,22,20,106,56,5,6,32,7
S01010278,Owned: Total,62,51,42,5,37,7,2,11,7,2,0,2,0
S01010278,Owned: Owned outright,19,11,8,1,7,2,1,8,5,2,0,1,0
S01010278,Owned: Owned with a mortgage or loan or shared ownership,43,40,34,4,30,5,1,3,2,0,0,1,0
S01010278,Rented or living rent free: Total,268,173,140,61,79,15,18,95,49,3,6,30,7
S01010278,Rented or living rent free: Social rented,215,124,98,53,45,8,18,91,47,2,6,29,7
S01010278,Rented or living rent free: Private rented or living rent free,53,49,42,8,34,7,0,4,2,1,0,1,0
S01010279,All HRPs aged 16 and over,312,198,162,52,110,17,19,114,28,32,4,44,6
S01010279,Owned: Total,74,57,48,4,44,8,1,17,12,1,0,2,2
S01010279,Owned: Owned outright,25,14,12,2,10,2,0,11,10,0,0,0,1
S01010279,Owned: Owned with a mortgage or loan or shared ownership,49,43,36,2,34,6,1,6,2,1,0,2,1
S01010279,Rented or living rent free: Total,238,141,114,48,66,9,18,97,16,31,4,42,4
S01010279,Rented or living rent free: Social rented,126,62,50,22,28,4,8,64,13,4,3,41,3
S01010279,Rented or living rent free: Private rented or living rent free,112,79,64,26,38,5,10,33,3,27,1,1,1
S01010280,All HRPs aged 16 and over,426,341,285,54,231,35,21,85,27,29,4,17,8
S01010280,Owned: Total,125,99,76,4,72,21,2,26,14,6,0,2,4
S01010280,Owned: Owned outright,46,25,15,2,13,9,1,21,14,4,0,2,1
S01010280,Owned: Owned with a mortgage or loan or shared ownership,79,74,61,2,59,12,1,5,0,2,0,0,3
S01010280,Rented or living rent free: Total,301,242,209,50,159,14,19,59,13,23,4,15,4
S01010280,Rented or living rent free: Social rented,82,54,38,9,29,5,11,28,8,2,2,14,2
S01010280,Rented or living rent free: Private rented or living rent free,219,188,171,41,130,9,8,31,5,21,2,1,2
S01010281,All HRPs aged 16 and over,466,346,295,43,252,37,14,120,25,72,1,14,8
S01010281,Owned: Total,166,149,134,13,121,14,1,17,10,4,0,2,1
S01010281,Owned: Owned outright,43,33,27,6,21,6,0,10,9,1,0,0,0
S01010281,Owned: Owned with a mortgage or loan or shared ownership,123,116,107,7,100,8,1,7,1,3,0,2,1
S01010281,Rented or living rent free: Total,300,197,161,30,131,23,13,103,15,68,1,12,7
S01010281,Rented or living rent free: Social rented,62,26,17,4,13,5,4,36,11,10,1,11,3
S01010281,Rented or living rent free: Private rented or living rent free,238,171,144,26,118,18,9,67,4,58,0,1,4
S01010282,All HRPs aged 16 and over,645,413,347,65,282,30,36,232,91,49,9,73,10
S01010282,Owned: Total,172,125,113,15,98,9,3,47,28,8,1,9,1
S01010282,Owned: Owned outright,64,35,31,6,25,3,1,29,22,1,0,5,1
S01010282,Owned: Owned with a mortgage or loan or shared ownership,108,90,82,9,73,6,2,18,6,7,1,4,0
S01010282,Rented or living rent free: Total,473,288,234,50,184,21,33,185,63,41,8,64,9
S01010282,Rented or living rent free: Social rented,278,141,101,23,78,11,29,137,61,4,6,58,8
S01010282,Rented or living rent free: Private rented or living rent free,195,147,133,27,106,10,4,48,2,37,2,6,1
S01010283,All HRPs aged 16 and over,296,241,206,38,168,22,13,55,9,27,2,12,5
S01010283,Owned: Total,83,77,67,9,58,9,1,6,1,5,0,0,0
S01010283,Owned: Owned outright,23,21,17,3,14,3,1,2,1,1,0,0,0
S01010283,Owned: Owned with a mortgage or loan or shared ownership,60,56,50,6,44,6,0,4,0,4,0,0,0
S01010283,Rented or living rent free: Total,213,164,139,29,110,13,12,49,8,22,2,12,5
S01010283,Rented or living rent free: Social rented,59,34,25,11,14,1,8,25,8,2,1,11,3
S01010283,Rented or living rent free: Private rented or living rent free,154,130,114,18,96,12,4,24,0,20,1,1,2
S01010284,All HRPs aged 16 and over,638,485,406,76,330,51,28,153,37,79,0,31,6
S01010284,Owned: Total,234,200,166,16,150,29,5,34,16,13,0,3,2
S01010284,Owned: Owned outright,56,36,29,6,23,5,2,20,14,4,0,2,0
S01010284,Owned: Owned with a mortgage or loan or shared ownership,178,164,137,10,127,24,3,14,2,9,0,1,2
S01010284,Rented or living rent free: Total,404,285,240,60,180,22,23,119,21,66,0,28,4
S01010284,Rented or living rent free: Social rented,96,51,35,10,25,6,10,45,17,4,0,22,2
S01010284,Rented or living rent free: Private rented or living rent free,308,234,205,50,155,16,13,74,4,62,0,6,2
S01010285,All HRPs aged 16 and over,420,310,237,69,168,42,31,110,37,39,8,21,5
S01010285,Owned: Total,111,92,71,16,55,15,6,19,11,4,1,2,1
S01010285,Owned: Owned outright,30,17,13,3,10,3,1,13,11,1,1,0,0
S01010285,Owned: Owned with a mortgage or loan or shared ownership,81,75,58,13,45,12,5,6,0,3,0,2,1
S01010285,Rented or living rent free: Total,309,218,166,53,113,27,25,91,26,35,7,19,4
S01010285,Rented or living rent free: Social rented,135,86,61,22,39,7,18,49,22,3,5,17,2
S01010285,Rented or living rent free: Private rented or living rent free,174,132,105,31,74,20,7,42,4,32,2,2,2
S01010286,All HRPs aged 16 and over,365,281,233,53,180,32,16,84,15,53,5,9,2
S01010286,Owned: Total,129,105,87,11,76,17,1,24,7,14,0,2,1
S01010286,Owned: Owned outright,30,17,14,2,12,3,0,13,5,7,0,1,0
S01010286,Owned: Owned with a mortgage or loan or shared ownership,99,88,73,9,64,14,1,11,2,7,0,1,1
S01010286,Rented or living rent free: Total,236,176,146,42,104,15,15,60,8,39,5,7,1
S01010286,Rented or living rent free: Social rented,57,32,27,13,14,1,4,25,8,5,4,7,1
S01010286,Rented or living rent free: Private rented or living rent free,179,144,119,29,90,14,11,35,0,34,1,0,0
S01010287,All HRPs aged 16 and over,387,289,228,64,164,36,25,98,23,64,1,7,3
S01010287,Owned: Total,145,118,88,5,83,26,4,27,16,9,0,2,0
S01010287,Owned: Owned outright,49,34,20,1,19,12,2,15,12,3,0,0,0
S01010287,Owned: Owned with a mortgage or loan or shared ownership,96,84,68,4,64,14,2,12,4,6,0,2,0
S01010287,Rented or living rent free: Total,242,171,140,59,81,10,21,71,7,55,1,5,3
S01010287,Rented or living rent free: Social rented,26,14,13,8,5,0,1,12,4,2,1,4,1
S01010287,Rented or living rent free: Private rented or living rent free,216,157,127,51,76,10,20,59,3,53,0,1,2
S01010288,All HRPs aged 16 and over,349,279,215,40,175,47,17,70,17,41,1,6,5
S01010288,Owned: Total,136,119,90,11,79,27,2,17,14,0,1,2,0
S01010288,Owned: Owned outright,45,34,27,3,24,7,0,11,9,0,0,2,0
S01010288,Owned: Owned with a mortgage or loan or shared ownership,91,85,63,8,55,20,2,6,5,0,1,0,0
S01010288,Rented or living rent free: Total,213,160,125,29,96,20,15,53,3,41,0,4,5
S01010288,Rented or living rent free: Social rented,31,23,15,4,11,5,3,8,1,0,0,4,3
S01010288,Rented or living rent free: Private rented or living rent free,182,137,110,25,85,15,12,45,2,41,0,0,2
S01010289,All HRPs aged 16 and over,380,339,245,31,214,85,9,41,18,17,2,3,1
S01010289,Owned: Total,254,233,163,16,147,64,6,21,16,2,2,1,0
S01010289,Owned: Owned outright,66,54,35,7,28,18,1,12,11,1,0,0,0
S01010289,Owned: Owned with a mortgage or loan or shared ownership,188,179,128,9,119,46,5,9,5,1,2,1,0
S01010289,Rented or living rent free: Total,126,106,82,15,67,21,3,20,2,15,0,2,1
S01010289,Rented or living rent free: Social rented,11,6,3,2,1,3,0,5,1,1,0,2,1
S01010289,Rented or living rent free: Private rented or living rent free,115,100,79,13,66,18,3,15,1,14,0,0,0
S01010290,All HRPs aged 16 and over,278,197,165,39,126,24,8,81,15,37,3,18,8
S01010290,Owned: Total,87,66,53,6,47,12,1,21,10,6,0,1,4
S01010290,Owned: Owned outright,29,19,16,4,12,2,1,10,8,1,0,0,1
S01010290,Owned: Owned with a mortgage or loan or shared ownership,58,47,37,2,35,10,0,11,2,5,0,1,3
S01010290,Rented or living rent free: Total,191,131,112,33,79,12,7,60,5,31,3,17,4
S01010290,Rented or living rent free: Social rented,66,35,28,7,21,4,3,31,5,4,3,15,4
S01010290,Rented or living rent free: Private rented or living rent free,125,96,84,26,58,8,4,29,0,27,0,2,0
S01010291,All HRPs aged 16 and over,481,287,220,71,149,39,28,194,69,81,7,29,8
S01010291,Owned: Total,130,96,76,21,55,15,5,34,24,6,1,2,1
S01010291,Owned: Owned outright,53,30,23,7,16,5,2,23,19,2,0,1,1
S01010291,Owned: Owned with a mortgage or loan or shared ownership,77,66,53,14,39,10,3,11,5,4,1,1,0
S01010291,Rented or living rent free: Total,351,191,144,50,94,24,23,160,45,75,6,27,7
S01010291,Rented or living rent free: Social rented,126,45,30,7,23,9,6,81,44,0,6,25,6
S01010291,Rented or living rent free: Private rented or living rent free,225,146,114,43,71,15,17,79,1,75,0,2,1
S01010292,All HRPs aged 16 and over,409,300,246,62,184,39,15,109,34,62,2,6,5
S01010292,Owned: Total,198,159,125,25,100,26,8,39,29,4,0,1,5
S01010292,Owned: Owned outright,81,50,37,10,27,9,4,31,26,2,0,0,3
S01010292,Owned: Owned with a mortgage or loan or shared ownership,117,109,88,15,73,17,4,8,3,2,0,1,2
S01010292,Rented or living rent free: Total,211,141,121,37,84,13,7,70,5,58,2,5,0
S01010292,Rented or living rent free: Social rented,11,5,3,0,3,1,1,6,4,0,0,2,0
S01010292,Rented or living rent free: Private rented or living rent free,200,136,118,37,81,12,6,64,1,58,2,3,0
S01010293,All HRPs aged 16 and over,373,271,224,71,153,21,26,102,42,32,6,15,7
S01010293,Owned: Total,106,80,69,12,57,7,4,26,12,8,1,3,2
S01010293,Owned: Owned outright,30,14,10,3,7,2,2,16,10,4,0,1,1
S01010293,Owned: Owned with a mortgage or loan or shared ownership,76,66,59,9,50,5,2,10,2,4,1,2,1
S01010293,Rented or living rent free: Total,267,191,155,59,96,14,22,76,30,24,5,12,5
S01010293,Rented or living rent free: Social rented,89,35,21,10,11,7,7,54,30,3,4,12,5
S01010293,Rented or living rent free: Private rented or living rent free,178,156,134,49,85,7,15,22,0,21,1,0,0
S01010294,All HRPs aged 16 and over,275,186,162,71,91,15,9,89,26,49,5,6,3
S01010294,Owned: Total,114,69,58,16,42,8,3,45,24,11,5,2,3
S01010294,Owned: Owned outright,58,24,20,5,15,1,3,34,23,4,4,1,2
S01010294,Owned: Owned with a mortgage or loan or shared ownership,56,45,38,11,27,7,0,11,1,7,1,1,1
S01010294,Rented or living rent free: Total,161,117,104,55,49,7,6,44,2,38,0,4,0
S01010294,Rented or living rent free: Social rented,16,11,10,5,5,1,0,5,2,0,0,3,0
S01010294,Rented or living rent free: Private rented or living rent free,145,106,94,50,44,6,6,39,0,38,0,1,0
S01010295,All HRPs aged 16 and over,427,310,250,95,155,39,21,117,23,74,6,7,7
S01010295,Owned: Total,160,124,105,20,85,15,4,36,17,11,1,3,4
S01010295,Owned: Owned outright,62,37,31,9,22,6,0,25,13,4,1,3,4
S01010295,Owned: Owned with a mortgage or loan or shared ownership,98,87,74,11,63,9,4,11,4,7,0,0,0
S01010295,Rented or living rent free: Total,267,186,145,75,70,24,17,81,6,63,5,4,3
S01010295,Rented or living rent free: Social rented,23,15,9,3,6,4,2,8,3,0,3,2,0
S01010295,Rented or living rent free: Private rented or living rent free,244,171,136,72,64,20,15,73,3,63,2,2,3
S01010296,All HRPs aged 16 and over,291,196,158,60,98,21,17,95,32,34,11,17,1
S01010296,Owned: Total,90,69,59,15,44,8,2,21,16,4,1,0,0
S01010296,Owned: Owned outright,29,13,11,2,9,2,0,16,12,3,1,0,0
S01010296,Owned: Owned with a mortgage or loan or shared ownership,61,56,48,13,35,6,2,5,4,1,0,0,0
S01010296,Rented or living rent free: Total,201,127,99,45,54,13,15,74,16,30,10,17,1
S01010296,Rented or living rent free: Social rented,96,57,40,12,28,6,11,39,15,1,6,16,1
S01010296,Rented or living rent free: Private rented or living rent free,105,70,59,33,26,7,4,35,1,29,4,1,0
S01010297,All HRPs aged 16 and over,676,344,276,65,211,24,44,332,161,68,11,80,12
S01010297,Owned: Total,173,115,98,6,92,10,7,58,44,5,2,3,4
S01010297,Owned: Owned outright,82,38,30,3,27,3,5,44,37,3,0,0,4
S01010297,Owned: Owned with a mortgage or loan or shared ownership,91,77,68,3,65,7,2,14,7,2,2,3,0
S01010297,Rented or living rent free: Total,503,229,178,59,119,14,37,274,117,63,9,77,8
S01010297,Rented or living rent free: Social rented,332,117,81,25,56,7,29,215,115,14,8,73,5
S01010297,Rented or living rent free: Private rented or living rent free,171,112,97,34,63,7,8,59,2,49,1,4,3
S01010298,All HRPs aged 16 and over,515,273,219,64,155,31,23,242,170,19,5,36,12
S01010298,Owned: Total,132,91,71,10,61,16,4,41,30,6,0,3,2
S01010298,Owned: Owned outright,54,25,19,6,13,5,1,29,26,0,0,3,0
S01010298,Owned: Owned with a mortgage or loan or shared ownership,78,66,52,4,48,11,3,12,4,6,0,0,2
S01010298,Rented or living rent free: Total,383,182,148,54,94,15,19,201,140,13,5,33,10
S01010298,Rented or living rent free: Social rented,266,93,71,24,47,9,13,173,131,0,3,29,10
S01010298,Rented or living rent free: Private rented or living rent free,117,89,77,30,47,6,6,28,9,13,2,4,0
S01010299,All HRPs aged 16 and over,292,129,100,27,73,14,15,163,91,8,5,50,9
S01010299,Owned: Total,66,46,39,11,28,6,1,20,15,0,0,3,2
S01010299,Owned: Owned outright,31,15,13,4,9,1,1,16,11,0,0,3,2
S01010299,Owned: Owned with a mortgage or loan or shared ownership,35,31,26,7,19,5,0,4,4,0,0,0,0
S01010299,Rented or living rent free: Total,226,83,61,16,45,8,14,143,76,8,5,47,7
S01010299,Rented or living rent free: Social rented,189,54,37,11,26,5,12,135,76,1,5,46,7
S01010299,Rented or living rent free: Private rented or living rent free,37,29,24,5,19,3,2,8,0,7,0,1,0
S01010300,All HRPs aged 16 and over,478,274,227,66,161,24,23,204,80,43,15,54,12
S01010300,Owned: Total,115,86,73,8,65,10,3,29,17,2,2,4,4
S01010300,Owned: Owned outright,46,27,21,1,20,3,3,19,13,2,0,2,2
S01010300,Owned: Owned with a mortgage or loan or shared ownership,69,59,52,7,45,7,0,10,4,0,2,2,2
S01010300,Rented or living rent free: Total,363,188,154,58,96,14,20,175,63,41,13,50,8
S01010300,Rented or living rent free: Social rented,194,65,52,23,29,7,6,129,61,0,12,49,7
S01010300,Rented or living rent free: Private rented or living rent free,169,123,102,35,67,7,14,46,2,41,1,1,1
S01010301,All HRPs aged 16 and over,283,209,168,44,124,16,25,74,16,42,6,5,5
S01010301,Owned: Total,107,90,74,10,64,11,5,17,11,3,3,0,0
S01010301,Owned: Owned outright,27,21,18,4,14,1,2,6,4,1,1,0,0
S01010301,Owned: Owned with a mortgage or loan or shared ownership,80,69,56,6,50,10,3,11,7,2,2,0,0
S01010301,Rented or living rent free: Total,176,119,94,34,60,5,20,57,5,39,3,5,5
S01010301,Rented or living rent free: Social rented,23,13,8,5,3,2,3,10,2,0,2,5,1
S01010301,Rented or living rent free: Private rented or living rent free,153,106,86,29,57,3,17,47,3,39,1,0,4
S01010302,All HRPs aged 16 and over,388,179,115,34,81,12,52,209,98,16,21,57,17
S01010302,Owned: Total,59,40,33,5,28,4,3,19,17,2,0,0,0
S01010302,Owned: Owned outright,28,16,13,2,11,2,1,12,12,0,0,0,0
S01010302,Owned: Owned with a mortgage or loan or shared ownership,31,24,20,3,17,2,2,7,5,2,0,0,0
S01010302,Rented or living rent free: Total,329,139,82,29,53,8,49,190,81,14,21,57,17
S01010302,Rented or living rent free: Social rented,291,115,62,25,37,6,47,176,77,6,19,57,17
S01010302,Rented or living rent free: Private rented or living rent free,38,24,20,4,16,2,2,14,4,8,2,0,0
S01010303,All HRPs aged 16 and over,250,136,93,47,46,12,31,114,25,12,24,32,21
S01010303,Owned: Total,27,16,13,2,11,3,0,11,7,0,2,0,2
S01010303,Owned: Owned outright,13,7,7,1,6,0,0,6,4,0,2,0,0
S01010303,Owned: Owned with a mortgage or loan or shared ownership,14,9,6,1,5,3,0,5,3,0,0,0,2
S01010303,Rented or living rent free: Total,223,120,80,45,35,9,31,103,18,12,22,32,19
S01010303,Rented or living rent free: Social rented,205,112,75,43,32,8,29,93,17,10,19,29,18
S01010303,Rented or living rent free: Private rented or living rent free,18,8,5,2,3,1,2,10,1,2,3,3,1
S01010304,All HRPs aged 16 and over,332,183,146,29,117,9,28,149,53,18,5,60,13
S01010304,Owned: Total,78,67,60,11,49,4,3,11,8,2,0,1,0
S01010304,Owned: Owned outright,24,17,13,2,11,3,1,7,5,2,0,0,0
S01010304,Owned: Owned with a mortgage or loan or shared ownership,54,50,47,9,38,1,2,4,3,0,0,1,0
S01010304,Rented or living rent free: Total,254,116,86,18,68,5,25,138,45,16,5,59,13
S01010304,Rented or living rent free: Social rented,194,74,50,14,36,3,21,120,44,3,5,55,13
S01010304,Rented or living rent free: Private rented or living rent free,60,42,36,4,32,2,4,18,1,13,0,4,0
S01010305,All HRPs aged 16 and over,478,270,222,37,185,27,21,208,126,25,4,45,8
S01010305,Owned: Total,155,111,99,8,91,9,3,44,32,7,1,1,3
S01010305,Owned: Owned outright,49,27,23,5,18,4,0,22,17,2,0,1,2
S01010305,Owned: Owned with a mortgage or loan or shared ownership,106,84,76,3,73,5,3,22,15,5,1,0,1
S01010305,Rented or living rent free: Total,323,159,123,29,94,18,18,164,94,18,3,44,5
S01010305,Rented or living rent free: Social rented,219,77,63,16,47,6,8,142,91,3,2,42,4
S01010305,Rented or living rent free: Private rented or living rent free,104,82,60,13,47,12,10,22,3,15,1,2,1
S01010306,All HRPs aged 16 and over,449,336,271,53,218,33,32,113,38,51,3,16,5
S01010306,Owned: Total,175,139,107,10,97,21,11,36,17,16,1,1,1
S01010306,Owned: Owned outright,59,35,25,4,21,6,4,24,14,8,0,1,1
S01010306,Owned: Owned with a mortgage or loan or shared ownership,116,104,82,6,76,15,7,12,3,8,1,0,0
S01010306,Rented or living rent free: Total,274,197,164,43,121,12,21,77,21,35,2,15,4
S01010306,Rented or living rent free: Social rented,91,58,40,9,31,6,12,33,14,0,1,15,3
S01010306,Rented or living rent free: Private rented or living rent free,183,139,124,34,90,6,9,44,7,35,1,0,1
S01010307,All HRPs aged 16 and over,428,339,281,47,234,42,16,89,42,33,0,10,4
S01010307,Owned: Total,229,188,158,22,136,28,2,41,30,5,0,5,1
S01010307,Owned: Owned outright,76,46,40,9,31,6,0,30,24,2,0,3,1
S01010307,Owned: Owned with a mortgage or loan or shared ownership,153,142,118,13,105,22,2,11,6,3,0,2,0
S01010307,Rented or living rent free: Total,199,151,123,25,98,14,14,48,12,28,0,5,3
S01010307,Rented or living rent free: Social rented,31,19,14,5,9,2,3,12,7,0,0,4,1
S01010307,Rented or living rent free: Private rented or living rent free,168,132,109,20,89,12,11,36,5,28,0,1,2
S01010308,All HRPs aged 16 and over,480,362,292,49,243,54,16,118,48,53,2,12,3
S01010308,Owned: Total,232,189,153,18,135,36,0,43,34,6,0,1,2
S01010308,Owned: Owned outright,81,46,35,8,27,11,0,35,29,4,0,0,2
S01010308,Owned: Owned with a mortgage or loan or shared ownership,151,143,118,10,108,25,0,8,5,2,0,1,0
S01010308,Rented or living rent free: Total,248,173,139,31,108,18,16,75,14,47,2,11,1
S01010308,Rented or living rent free: Social rented,48,25,17,6,11,3,5,23,12,1,1,8,1
S01010308,Rented or living rent free: Private rented or living rent free,200,148,122,25,97,15,11,52,2,46,1,3,0
S01010309,All HRPs aged 16 and over,264,121,100,14,86,5,16,143,72,7,6,50,8
S01010309,Owned: Total,70,41,39,9,30,0,2,29,23,1,1,4,0
S01010309,Owned: Owned outright,36,15,15,6,9,0,0,21,19,0,0,2,0
S01010309,Owned: Owned with a mortgage or loan or shared ownership,34,26,24,3,21,0,2,8,4,1,1,2,0
S01010309,Rented or living rent free: Total,194,80,61,5,56,5,14,114,49,6,5,46,8
S01010309,Rented or living rent free: Social rented,173,68,50,5,45,5,13,105,49,1,3,44,8
S01010309,Rented or living rent free: Private rented or living rent free,21,12,11,0,11,0,1,9,0,5,2,2,0
S01010310,All HRPs aged 16 and over,381,219,162,39,123,17,40,162,41,27,16,61,17
S01010310,Owned: Total,67,53,42,8,34,8,3,14,9,0,0,5,0
S01010310,Owned: Owned outright,11,6,5,1,4,1,0,5,5,0,0,0,0
S01010310,Owned: Owned with a mortgage or loan or shared ownership,56,47,37,7,30,7,3,9,4,0,0,5,0
S01010310,Rented or living rent free: Total,314,166,120,31,89,9,37,148,32,27,16,56,17
S01010310,Rented or living rent free: Social rented,216,106,74,27,47,2,30,110,29,8,10,51,12
S01010310,Rented or living rent free: Private rented or living rent free,98,60,46,4,42,7,7,38,3,19,6,5,5
S01010311,All HRPs aged 16 and over,351,155,121,48,73,6,28,196,77,24,24,55,16
S01010311,Owned: Total,60,32,29,6,23,2,1,28,19,1,0,6,2
S01010311,Owned: Owned outright,27,8,8,3,5,0,0,19,13,0,0,5,1
S01010311,Owned: Owned with a mortgage or loan or shared ownership,33,24,21,3,18,2,1,9,6,1,0,1,1
S01010311,Rented or living rent free: Total,291,123,92,42,50,4,27,168,58,23,24,49,14
S01010311,Rented or living rent free: Social rented,262,110,83,39,44,3,24,152,56,16,22,45,13
S01010311,Rented or living rent free: Private rented or living rent free,29,13,9,3,6,1,3,16,2,7,2,4,1
S01010312,All HRPs aged 16 and over,425,193,147,53,94,9,37,232,80,11,35,90,16
S01010312,Owned: Total,4,2,1,0,1,1,0,2,2,0,0,0,0
S01010312,Owned: Owned outright,1,0,0,0,0,0,0,1,1,0,0,0,0
S01010312,Owned: Owned with a mortgage or loan or shared ownership,3,2,1,0,1,1,0,1,1,0,0,0,0
S01010312,Rented or living rent free: Total,421,191,146,53,93,8,37,230,78,11,35,90,16
S01010312,Rented or living rent free: Social rented,418,189,145,53,92,7,37,229,78,10,35,90,16
S01010312,Rented or living rent free: Private rented or living rent free,3,2,1,0,1,1,0,1,0,1,0,0,0
S01010313,All HRPs aged 16 and over,356,166,124,35,89,8,34,190,67,12,16,73,22
S01010313,Owned: Total,20,14,12,2,10,2,0,6,6,0,0,0,0
S01010313,Owned: Owned outright,11,5,3,0,3,2,0,6,6,0,0,0,0
S01010313,Owned: Owned with a mortgage or loan or shared ownership,9,9,9,2,7,0,0,0,0,0,0,0,0
S01010313,Rented or living rent free: Total,336,152,112,33,79,6,34,184,61,12,16,73,22
S01010313,Rented or living rent free: Social rented,316,140,102,30,72,5,33,176,61,5,16,72,22
S01010313,Rented or living rent free: Private rented or living rent free,20,12,10,3,7,1,1,8,0,7,0,1,0
S01010314,All HRPs aged 16 and over,550,298,223,54,169,21,54,252,106,54,13,62,17
S01010314,Owned: Total,109,85,74,6,68,6,5,24,16,3,0,3,2
S01010314,Owned: Owned outright,11,8,8,1,7,0,0,3,3,0,0,0,0
S01010314,Owned: Owned with a mortgage or loan or shared ownership,98,77,66,5,61,6,5,21,13,3,0,3,2
S01010314,Rented or living rent free: Total,441,213,149,48,101,15,49,228,90,51,13,59,15
S01010314,Rented or living rent free: Social rented,393,179,123,41,82,10,46,214,88,40,13,59,14
S01010314,Rented or living rent free: Private rented or living rent free,48,34,26,7,19,5,3,14,2,11,0,0,1
S01010315,All HRPs aged 16 and over,409,278,224,48,176,21,33,131,51,10,25,32,13
S01010315,Owned: Total,181,149,129,11,118,18,2,32,25,1,2,2,2
S01010315,Owned: Owned outright,46,22,19,3,16,3,0,24,19,0,1,2,2
S01010315,Owned: Owned with a mortgage or loan or shared ownership,135,127,110,8,102,15,2,8,6,1,1,0,0
S01010315,Rented or living rent free: Total,228,129,95,37,58,3,31,99,26,9,23,30,11
S01010315,Rented or living rent free: Social rented,137,68,47,25,22,0,21,69,19,2,17,25,6
S01010315,Rented or living rent free: Private rented or living rent free,91,61,48,12,36,3,10,30,7,7,6,5,5
S01010316,All HRPs aged 16 and over,304,178,149,39,110,11,18,126,20,13,28,55,10
S01010316,Owned: Total,34,28,24,3,21,4,0,6,4,1,0,1,0
S01010316,Owned: Owned outright,9,5,3,2,1,2,0,4,4,0,0,0,0
S01010316,Owned: Owned with a mortgage or loan or shared ownership,25,23,21,1,20,2,0,2,0,1,0,1,0
S01010316,Rented or living rent free: Total,270,150,125,36,89,7,18,120,16,12,28,54,10
S01010316,Rented or living rent free: Social rented,232,117,94,26,68,7,16,115,16,12,26,53,8
S01010316,Rented or living rent free: Private rented or living rent free,38,33,31,10,21,0,2,5,0,0,2,1,2
S01010317,All HRPs aged 16 and over,394,292,243,45,198,40,9,102,55,35,3,7,2
S01010317,Owned: Total,191,152,126,17,109,23,3,39,25,12,0,2,0
S01010317,Owned: Owned outright,58,34,26,5,21,7,1,24,19,5,0,0,0
S01010317,Owned: Owned with a mortgage or loan or shared ownership,133,118,100,12,88,16,2,15,6,7,0,2,0
S01010317,Rented or living rent free: Total,203,140,117,28,89,17,6,63,30,23,3,5,2
S01010317,Rented or living rent free: Social rented,44,11,8,2,6,3,0,33,26,0,1,5,1
S01010317,Rented or living rent free: Private rented or living rent free,159,129,109,26,83,14,6,30,4,23,2,0,1
S01010318,All HRPs aged 16 and over,304,201,145,44,101,20,36,103,45,16,7,32,3
S01010318,Owned: Total,39,29,26,4,22,2,1,10,7,2,0,1,0
S01010318,Owned: Owned outright,10,4,4,3,1,0,0,6,4,1,0,1,0
S01010318,Owned: Owned with a mortgage or loan or shared ownership,29,25,22,1,21,2,1,4,3,1,0,0,0
S01010318,Rented or living rent free: Total,265,172,119,40,79,18,35,93,38,14,7,31,3
S01010318,Rented or living rent free: Social rented,205,124,77,27,50,16,31,81,35,6,7,30,3
S01010318,Rented or living rent free: Private rented or living rent free,60,48,42,13,29,2,4,12,3,8,0,1,0
S01010319,All HRPs aged 16 and over,407,292,248,32,216,26,18,115,46,33,8,22,6
S01010319,Owned: Total,189,158,142,14,128,14,2,31,22,3,2,3,1
S01010319,Owned: Owned outright,45,25,19,1,18,4,2,20,17,2,0,1,0
S01010319,Owned: Owned with a mortgage or loan or shared ownership,144,133,123,13,110,10,0,11,5,1,2,2,1
S01010319,Rented or living rent free: Total,218,134,106,18,88,12,16,84,24,30,6,19,5
S01010319,Rented or living rent free: Social rented,96,48,34,9,25,4,10,48,22,4,3,15,4
S01010319,Rented or living rent free: Private rented or living rent free,122,86,72,9,63,8,6,36,2,26,3,4,1
S01010320,All HRPs aged 16 and over,437,256,198,44,154,23,35,181,65,43,12,55,6
S01010320,Owned: Total,107,83,63,2,61,13,7,24,8,11,0,5,0
S01010320,Owned: Owned outright,21,13,5,1,4,3,5,8,7,1,0,0,0
S01010320,Owned: Owned with a mortgage or loan or shared ownership,86,70,58,1,57,10,2,16,1,10,0,5,0
S01010320,Rented or living rent free: Total,330,173,135,42,93,10,28,157,57,32,12,50,6
S01010320,Rented or living rent free: Social rented,211,83,60,29,31,2,21,128,55,8,11,48,6
S01010320,Rented or living rent free: Private rented or living rent free,119,90,75,13,62,8,7,29,2,24,1,2,0
S01010321,All HRPs aged 16 and over,432,301,255,59,196,23,23,131,54,21,5,39,12
S01010321,Owned: Total,146,114,97,17,80,15,2,32,25,0,0,4,3
S01010321,Owned: Owned outright,43,20,15,4,11,4,1,23,18,0,0,4,1
S01010321,Owned: Owned with a mortgage or loan or shared ownership,103,94,82,13,69,11,1,9,7,0,0,0,2
S01010321,Rented or living rent free: Total,286,187,158,42,116,8,21,99,29,21,5,35,9
S01010321,Rented or living rent free: Social rented,158,91,71,22,49,3,17,67,25,3,4,28,7
S01010321,Rented or living rent free: Private rented or living rent free,128,96,87,20,67,5,4,32,4,18,1,7,2
S01010322,All HRPs aged 16 and over,549,428,344,52,292,72,12,121,71,38,2,6,4
S01010322,Owned: Total,307,242,189,22,167,49,4,65,58,5,0,2,0
S01010322,Owned: Owned outright,131,77,62,14,48,14,1,54,51,2,0,1,0
S01010322,Owned: Owned with a mortgage or loan or shared ownership,176,165,127,8,119,35,3,11,7,3,0,1,0
S01010322,Rented or living rent free: Total,242,186,155,30,125,23,8,56,13,33,2,4,4
S01010322,Rented or living rent free: Social rented,19,7,5,3,2,2,0,12,5,1,1,3,2
S01010322,Rented or living rent free: Private rented or living rent free,223,179,150,27,123,21,8,44,8,32,1,1,2
S01010323,All HRPs aged 16 and over,377,158,120,36,84,2,36,219,108,9,21,62,19
S01010323,Owned: Total,11,9,8,1,7,0,1,2,1,1,0,0,0
S01010323,Owned: Owned outright,6,5,4,0,4,0,1,1,1,0,0,0,0
S01010323,Owned: Owned with a mortgage or loan or shared ownership,5,4,4,1,3,0,0,1,0,1,0,0,0
S01010323,Rented or living rent free: Total,366,149,112,35,77,2,35,217,107,8,21,62,19
S01010323,Rented or living rent free: Social rented,358,143,106,34,72,2,35,215,107,6,21,62,19
S01010323,Rented or living rent free: Private rented or living rent free,8,6,6,1,5,0,0,2,0,2,0,0,0
S01010324,All HRPs aged 16 and over,403,152,125,39,86,13,14,251,163,10,14,53,11
S01010324,Owned: Total,138,74,63,20,43,8,3,64,54,1,2,6,1
S01010324,Owned: Owned outright,81,33,27,15,12,3,3,48,41,1,2,4,0
S01010324,Owned: Owned with a mortgage or loan or shared ownership,57,41,36,5,31,5,0,16,13,0,0,2,1
S01010324,Rented or living rent free: Total,265,78,62,19,43,5,11,187,109,9,12,47,10
S01010324,Rented or living rent free: Social rented,235,59,45,13,32,5,9,176,108,3,12,44,9
S01010324,Rented or living rent free: Private rented or living rent free,30,19,17,6,11,0,2,11,1,6,0,3,1
S01010325,All HRPs aged 16 and over,501,185,153,41,112,13,19,316,241,1,11,50,13
S01010325,Owned: Total,226,104,93,17,76,10,1,122,115,0,0,6,1
S01010325,Owned: Owned outright,150,45,41,7,34,4,0,105,99,0,0,5,1
S01010325,Owned: Owned with a mortgage or loan or shared ownership,76,59,52,10,42,6,1,17,16,0,0,1,0
S01010325,Rented or living rent free: Total,275,81,60,24,36,3,18,194,126,1,11,44,12
S01010325,Rented or living rent free: Social rented,242,58,43,13,30,2,13,184,122,1,8,41,12
S01010325,Rented or living rent free: Private rented or living rent free,33,23,17,11,6,1,5,10,4,0,3,3,0
S01010326,All HRPs aged 16 and over,494,224,157,63,94,12,55,270,85,10,41,119,15
S01010326,Owned: Total,60,45,38,5,33,6,1,15,11,1,0,3,0
S01010326,Owned: Owned outright,19,9,8,3,5,1,0,10,10,0,0,0,0
S01010326,Owned: Owned with a mortgage or loan or shared ownership,41,36,30,2,28,5,1,5,1,1,0,3,0
S01010326,Rented or living rent free: Total,434,179,119,58,61,6,54,255,74,9,41,116,15
S01010326,Rented or living rent free: Social rented,410,164,108,55,53,4,52,246,74,5,41,112,14
S01010326,Rented or living rent free: Private rented or living rent free,24,15,11,3,8,2,2,9,0,4,0,4,1
S01010327,All HRPs aged 16 and over,362,241,193,58,135,27,21,121,43,7,15,46,10
S01010327,Owned: Total,137,123,104,21,83,19,0,14,11,1,1,0,1
S01010327,Owned: Owned outright,22,14,12,4,8,2,0,8,7,1,0,0,0
S01010327,Owned: Owned with a mortgage or loan or shared ownership,115,109,92,17,75,17,0,6,4,0,1,0,1
S01010327,Rented or living rent free: Total,225,118,89,37,52,8,21,107,32,6,14,46,9
S01010327,Rented or living rent free: Social rented,186,97,74,29,45,6,17,89,27,1,12,42,7
S01010327,Rented or living rent free: Private rented or living rent free,39,21,15,8,7,2,4,18,5,5,2,4,2
S01010328,All HRPs aged 16 and over,445,248,196,38,158,33,19,197,133,13,11,30,10
S01010328,Owned: Total,263,175,145,24,121,25,5,88,73,1,2,7,5
S01010328,Owned: Owned outright,100,32,26,7,19,4,2,68,61,0,1,3,3
S01010328,Owned: Owned with a mortgage or loan or shared ownership,163,143,119,17,102,21,3,20,12,1,1,4,2
S01010328,Rented or living rent free: Total,182,73,51,14,37,8,14,109,60,12,9,23,5
S01010328,Rented or living rent free: Social rented,128,45,27,9,18,6,12,83,56,0,6,16,5
S01010328,Rented or living rent free: Private rented or living rent free,54,28,24,5,19,2,2,26,4,12,3,7,0
S01010329,All HRPs aged 16 and over,290,162,135,30,105,18,9,128,97,1,9,18,3
S01010329,Owned: Total,149,90,76,13,63,12,2,59,52,0,3,3,1
S01010329,Owned: Owned outright,75,28,25,5,20,2,1,47,43,0,1,2,1
S01010329,Owned: Owned with a mortgage or loan or shared ownership,74,62,51,8,43,10,1,12,9,0,2,1,0
S01010329,Rented or living rent free: Total,141,72,59,17,42,6,7,69,45,1,6,15,2
S01010329,Rented or living rent free: Social rented,108,50,46,15,31,2,2,58,42,1,2,11,2
S01010329,Rented or living rent free: Private rented or living rent free,33,22,13,2,11,4,5,11,3,0,4,4,0
S01010330,All HRPs aged 16 and over,299,158,117,37,80,12,29,141,72,3,15,39,12
S01010330,Owned: Total,73,43,37,2,35,4,2,30,25,0,1,2,2
S01010330,Owned: Owned outright,26,13,11,1,10,1,1,13,13,0,0,0,0
S01010330,Owned: Owned with a mortgage or loan or shared ownership,47,30,26,1,25,3,1,17,12,0,1,2,2
S01010330,Rented or living rent free: Total,226,115,80,35,45,8,27,111,47,3,14,37,10
S01010330,Rented or living rent free: Social rented,213,106,73,29,44,7,26,107,46,2,14,36,9
S01010330,Rented or living rent free: Private rented or living rent free,13,9,7,6,1,1,1,4,1,1,0,1,1
S01010331,All HRPs aged 16 and over,520,231,192,54,138,13,26,289,195,4,14,62,14
S01010331,Owned: Total,227,113,97,20,77,9,7,114,96,1,0,13,4
S01010331,Owned: Owned outright,112,31,26,10,16,1,4,81,71,1,0,8,1
S01010331,Owned: Owned with a mortgage or loan or shared ownership,115,82,71,10,61,8,3,33,25,0,0,5,3
S01010331,Rented or living rent free: Total,293,118,95,34,61,4,19,175,99,3,14,49,10
S01010331,Rented or living rent free: Social rented,247,92,72,28,44,4,16,155,90,3,9,46,7
S01010331,Rented or living rent free: Private rented or living rent free,46,26,23,6,17,0,3,20,9,0,5,3,3
S01010332,All HRPs aged 16 and over,279,130,109,30,79,8,13,149,83,5,22,35,4
S01010332,Owned: Total,126,77,69,12,57,6,2,49,39,1,4,5,0
S01010332,Owned: Owned outright,41,11,11,3,8,0,0,30,27,0,1,2,0
S01010332,Owned: Owned with a mortgage or loan or shared ownership,85,66,58,9,49,6,2,19,12,1,3,3,0
S01010332,Rented or living rent free: Total,153,53,40,18,22,2,11,100,44,4,18,30,4
S01010332,Rented or living rent free: Social rented,130,43,31,15,16,2,10,87,41,3,11,28,4
S01010332,Rented or living rent free: Private rented or living rent free,23,10,9,3,6,0,1,13,3,1,7,2,0
S01010333,All HRPs aged 16 and over,487,267,213,60,153,24,30,220,132,13,21,44,10
S01010333,Owned: Total,230,150,128,29,99,16,6,80,65,0,3,10,2
S01010333,Owned: Owned outright,104,42,37,9,28,3,2,62,56,0,1,4,1
S01010333,Owned: Owned with a mortgage or loan or shared ownership,126,108,91,20,71,13,4,18,9,0,2,6,1
S01010333,Rented or living rent free: Total,257,117,85,31,54,8,24,140,67,13,18,34,8
S01010333,Rented or living rent free: Social rented,193,78,59,19,40,4,15,115,63,5,14,26,7
S01010333,Rented or living rent free: Private rented or living rent free,64,39,26,12,14,4,9,25,4,8,4,8,1
S01010334,All HRPs aged 16 and over,433,259,225,51,174,22,12,174,108,0,13,41,12
S01010334,Owned: Total,259,180,163,25,138,13,4,79,69,0,3,5,2
S01010334,Owned: Owned outright,69,19,14,6,8,4,1,50,46,0,1,3,0
S01010334,Owned: Owned with a mortgage or loan or shared ownership,190,161,149,19,130,9,3,29,23,0,2,2,2
S01010334,Rented or living rent free: Total,174,79,62,26,36,9,8,95,39,0,10,36,10
S01010334,Rented or living rent free: Social rented,134,56,47,18,29,6,3,78,35,0,5,32,6
S01010334,Rented or living rent free: Private rented or living rent free,40,23,15,8,7,3,5,17,4,0,5,4,4
S01010335,All HRPs aged 16 and over,345,155,128,33,95,14,13,190,136,4,10,32,8
S01010335,Owned: Total,163,97,86,16,70,9,2,66,56,0,1,6,3
S01010335,Owned: Owned outright,76,28,27,7,20,1,0,48,42,0,0,4,2
S01010335,Owned: Owned with a mortgage or loan or shared ownership,87,69,59,9,50,8,2,18,14,0,1,2,1
S01010335,Rented or living rent free: Total,182,58,42,17,25,5,11,124,80,4,9,26,5
S01010335,Rented or living rent free: Social rented,159,43,31,13,18,3,9,116,75,3,7,26,5
S01010335,Rented or living rent free: Private rented or living rent free,23,15,11,4,7,2,2,8,5,1,2,0,0
S01010336,All HRPs aged 16 and over,379,186,127,52,75,11,48,193,62,17,25,77,12
S01010336,Owned: Total,34,23,16,7,9,5,2,11,10,0,1,0,0
S01010336,Owned: Owned outright,20,11,8,5,3,2,1,9,8,0,1,0,0
S01010336,Owned: Owned with a mortgage or loan or shared ownership,14,12,8,2,6,3,1,2,2,0,0,0,0
S01010336,Rented or living rent free: Total,345,163,111,45,66,6,46,182,52,17,24,77,12
S01010336,Rented or living rent free: Social rented,338,160,108,44,64,6,46,178,50,17,24,76,11
S01010336,Rented or living rent free: Private rented or living rent free,7,3,3,1,2,0,0,4,2,0,0,1,1
S01010337,All HRPs aged 16 and over,278,139,123,36,87,5,11,139,91,1,11,34,2
S01010337,Owned: Total,131,78,73,17,56,4,1,53,45,0,0,7,1
S01010337,Owned: Owned outright,53,17,17,6,11,0,0,36,31,0,0,5,0
S01010337,Owned: Owned with a mortgage or loan or shared ownership,78,61,56,11,45,4,1,17,14,0,0,2,1
S01010337,Rented or living rent free: Total,147,61,50,19,31,1,10,86,46,1,11,27,1
S01010337,Rented or living rent free: Social rented,133,53,45,18,27,1,7,80,46,0,7,26,1
S01010337,Rented or living rent free: Private rented or living rent free,14,8,5,1,4,0,3,6,0,1,4,1,0
S01010338,All HRPs aged 16 and over,356,166,120,36,84,11,35,190,74,4,26,73,13
S01010338,Owned: Total,93,53,43,3,40,7,3,40,33,1,1,3,2
S01010338,Owned: Owned outright,40,12,11,1,10,1,0,28,24,1,0,1,2
S01010338,Owned: Owned with a mortgage or loan or shared ownership,53,41,32,2,30,6,3,12,9,0,1,2,0
S01010338,Rented or living rent free: Total,263,113,77,33,44,4,32,150,41,3,25,70,11
S01010338,Rented or living rent free: Social rented,251,107,73,33,40,4,30,144,41,2,22,68,11
S01010338,Rented or living rent free: Private rented or living rent free,12,6,4,0,4,0,2,6,0,1,3,2,0
S01010339,All HRPs aged 16 and over,284,129,105,22,83,12,12,155,114,1,10,21,9
S01010339,Owned: Total,169,78,70,12,58,7,1,91,79,0,0,11,1
S01010339,Owned: Owned outright,86,17,13,3,10,3,1,69,66,0,0,2,1
S01010339,Owned: Owned with a mortgage or loan or shared ownership,83,61,57,9,48,4,0,22,13,0,0,9,0
S01010339,Rented or living rent free: Total,115,51,35,10,25,5,11,64,35,1,10,10,8
S01010339,Rented or living rent free: Social rented,99,42,28,9,19,5,9,57,32,1,9,9,6
S01010339,Rented or living rent free: Private rented or living rent free,16,9,7,1,6,0,2,7,3,0,1,1,2
S01010340,All HRPs aged 16 and over,349,203,159,45,114,16,28,146,80,7,20,34,5
S01010340,Owned: Total,123,84,77,10,67,6,1,39,34,0,0,4,1
S01010340,Owned: Owned outright,44,21,20,2,18,1,0,23,20,0,0,2,1
S01010340,Owned: Owned with a mortgage or loan or shared ownership,79,63,57,8,49,5,1,16,14,0,0,2,0
S01010340,Rented or living rent free: Total,226,119,82,35,47,10,27,107,46,7,20,30,4
S01010340,Rented or living rent free: Social rented,214,110,79,34,45,7,24,104,45,6,19,30,4
S01010340,Rented or living rent free: Private rented or living rent free,12,9,3,1,2,3,3,3,1,1,1,0,0
S01010341,All HRPs aged 16 and over,253,157,129,21,108,16,12,96,65,2,9,18,2
S01010341,Owned: Total,181,127,109,14,95,14,4,54,45,1,0,6,2
S01010341,Owned: Owned outright,68,27,22,4,18,4,1,41,37,1,0,2,1
S01010341,Owned: Owned with a mortgage or loan or shared ownership,113,100,87,10,77,10,3,13,8,0,0,4,1
S01010341,Rented or living rent free: Total,72,30,20,7,13,2,8,42,20,1,9,12,0
S01010341,Rented or living rent free: Social rented,57,22,16,4,12,2,4,35,19,0,6,10,0
S01010341,Rented or living rent free: Private rented or living rent free,15,8,4,3,1,0,4,7,1,1,3,2,0
S01010342,All HRPs aged 16 and over,302,229,201,22,179,24,4,73,57,2,4,7,3
S01010342,Owned: Total,264,205,181,18,163,22,2,59,51,2,1,3,2
S01010342,Owned: Owned outright,84,41,33,4,29,7,1,43,40,0,0,1,2
S01010342,Owned: Owned with a mortgage or loan or shared ownership,180,164,148,14,134,15,1,16,11,2,1,2,0
S01010342,Rented or living rent free: Total,38,24,20,4,16,2,2,14,6,0,3,4,1
S01010342,Rented or living rent free: Social rented,10,3,2,0,2,0,1,7,4,0,0,3,0
S01010342,Rented or living rent free: Private rented or living rent free,28,21,18,4,14,2,1,7,2,0,3,1,1
S01010343,All HRPs aged 16 and over,365,305,264,26,238,33,8,60,39,4,3,10,4
S01010343,Owned: Total,329,284,247,20,227,32,5,45,35,2,2,6,0
S01010343,Owned: Owned outright,77,50,43,4,39,5,2,27,22,1,1,3,0
S01010343,Owned: Owned with a mortgage or loan or shared ownership,252,234,204,16,188,27,3,18,13,1,1,3,0
S01010343,Rented or living rent free: Total,36,21,17,6,11,1,3,15,4,2,1,4,4
S01010343,Rented or living rent free: Social rented,9,4,4,2,2,0,0,5,3,0,1,1,0
S01010343,Rented or living rent free: Private rented or living rent free,27,17,13,4,9,1,3,10,1,2,0,3,4
S01010344,All HRPs aged 16 and over,419,212,152,45,107,11,49,207,100,4,19,69,15
S01010344,Owned: Total,65,28,24,5,19,4,0,37,29,0,0,8,0
S01010344,Owned: Owned outright,28,5,4,1,3,1,0,23,19,0,0,4,0
S01010344,Owned: Owned with a mortgage or loan or shared ownership,37,23,20,4,16,3,0,14,10,0,0,4,0
S01010344,Rented or living rent free: Total,354,184,128,40,88,7,49,170,71,4,19,61,15
S01010344,Rented or living rent free: Social rented,347,180,124,39,85,7,49,167,70,4,18,61,14
S01010344,Rented or living rent free: Private rented or living rent free,7,4,4,1,3,0,0,3,1,0,1,0,1
S01010345,All HRPs aged 16 and over,160,135,107,16,91,26,2,25,12,11,0,2,0
S01010345,Owned: Total,136,122,94,10,84,26,2,14,9,5,0,0,0
S01010345,Owned: Owned outright,27,17,12,5,7,4,1,10,7,3,0,0,0
S01010345,Owned: Owned with a mortgage or loan or shared ownership,109,105,82,5,77,22,1,4,2,2,0,0,0
S01010345,Rented or living rent free: Total,24,13,13,6,7,0,0,11,3,6,0,2,0
S01010345,Rented or living rent free: Social rented,4,3,3,3,0,0,0,1,0,0,0,1,0
S01010345,Rented or living rent free: Private rented or living rent free,20,10,10,3,7,0,0,10,3,6,0,1,0
S01010346,All HRPs aged 16 and over,410,309,264,30,234,38,7,101,80,2,3,9,7
S01010346,Owned: Total,338,268,231,21,210,32,5,70,58,1,3,5,3
S01010346,Owned: Owned outright,123,67,58,12,46,7,2,56,51,1,0,3,1
S01010346,Owned: Owned with a mortgage or loan or shared ownership,215,201,173,9,164,25,3,14,7,0,3,2,2
S01010346,Rented or living rent free: Total,72,41,33,9,24,6,2,31,22,1,0,4,4
S01010346,Rented or living rent free: Social rented,40,18,16,6,10,1,1,22,13,1,0,4,4
S01010346,Rented or living rent free: Private rented or living rent free,32,23,17,3,14,5,1,9,9,0,0,0,0
S01010347,All HRPs aged 16 and over,466,264,208,67,141,26,30,202,102,7,16,36,41
S01010347,Owned: Total,145,95,80,15,65,13,2,50,40,1,0,6,3
S01010347,Owned: Owned outright,61,27,22,8,14,4,1,34,32,0,0,2,0
S01010347,Owned: Owned with a mortgage or loan or shared ownership,84,68,58,7,51,9,1,16,8,1,0,4,3
S01010347,Rented or living rent free: Total,321,169,128,52,76,13,28,152,62,6,16,30,38
S01010347,Rented or living rent free: Social rented,270,124,96,46,50,6,22,146,60,5,16,29,36
S01010347,Rented or living rent free: Private rented or living rent free,51,45,32,6,26,7,6,6,2,1,0,1,2
S01010348,All HRPs aged 16 and over,483,261,232,50,182,15,14,222,156,5,18,36,7
S01010348,Owned: Total,272,179,168,28,140,10,1,93,85,0,4,4,0
S01010348,Owned: Owned outright,118,39,37,7,30,1,1,79,73,0,3,3,0
S01010348,Owned: Owned with a mortgage or loan or shared ownership,154,140,131,21,110,9,0,14,12,0,1,1,0
S01010348,Rented or living rent free: Total,211,82,64,22,42,5,13,129,71,5,14,32,7
S01010348,Rented or living rent free: Social rented,179,63,47,13,34,4,12,116,70,4,7,29,6
S01010348,Rented or living rent free: Private rented or living rent free,32,19,17,9,8,1,1,13,1,1,7,3,1
S01010349,All HRPs aged 16 and over,443,237,208,61,147,14,15,206,152,1,11,39,3
S01010349,Owned: Total,222,151,137,31,106,10,4,71,62,1,1,7,0
S01010349,Owned: Owned outright,81,30,26,13,13,2,2,51,47,0,1,3,0
S01010349,Owned: Owned with a mortgage or loan or shared ownership,141,121,111,18,93,8,2,20,15,1,0,4,0
S01010349,Rented or living rent free: Total,221,86,71,30,41,4,11,135,90,0,10,32,3
S01010349,Rented or living rent free: Social rented,201,75,62,26,36,3,10,126,86,0,7,31,2
S01010349,Rented or living rent free: Private rented or living rent free,20,11,9,4,5,1,1,9,4,0,3,1,1
S01010350,All HRPs aged 16 and over,475,248,196,68,128,6,46,227,141,3,17,53,13
S01010350,Owned: Total,131,73,67,10,57,2,4,58,51,0,0,5,2
S01010350,Owned: Owned outright,67,20,18,6,12,0,2,47,45,0,0,1,1
S01010350,Owned: Owned with a mortgage or loan or shared ownership,64,53,49,4,45,2,2,11,6,0,0,4,1
S01010350,Rented or living rent free: Total,344,175,129,58,71,4,42,169,90,3,17,48,11
S01010350,Rented or living rent free: Social rented,326,164,121,55,66,4,39,162,90,2,15,45,10
S01010350,Rented or living rent free: Private rented or living rent free,18,11,8,3,5,0,3,7,0,1,2,3,1
S01010351,All HRPs aged 16 and over,398,254,219,51,168,25,10,144,71,18,9,36,10
S01010351,Owned: Total,183,138,121,14,107,16,1,45,36,4,1,2,2
S01010351,Owned: Owned outright,46,21,19,2,17,1,1,25,23,1,0,1,0
S01010351,Owned: Owned with a mortgage or loan or shared ownership,137,117,102,12,90,15,0,20,13,3,1,1,2
S01010351,Rented or living rent free: Total,215,116,98,37,61,9,9,99,35,14,8,34,8
S01010351,Rented or living rent free: Social rented,147,73,65,28,37,4,4,74,32,1,6,29,6
S01010351,Rented or living rent free: Private rented or living rent free,68,43,33,9,24,5,5,25,3,13,2,5,2
S01010352,All HRPs aged 16 and over,276,133,109,29,80,6,18,143,89,7,8,25,14
S01010352,Owned: Total,126,71,63,11,52,4,4,55,47,1,0,7,0
S01010352,Owned: Owned outright,61,19,13,1,12,3,3,42,37,1,0,4,0
S01010352,Owned: Owned with a mortgage or loan or shared ownership,65,52,50,10,40,1,1,13,10,0,0,3,0
S01010352,Rented or living rent free: Total,150,62,46,18,28,2,14,88,42,6,8,18,14
S01010352,Rented or living rent free: Social rented,122,45,33,12,21,1,11,77,39,3,7,18,10
S01010352,Rented or living rent free: Private rented or living rent free,28,17,13,6,7,1,3,11,3,3,1,0,4
S01010353,All HRPs aged 16 and over,562,247,166,47,119,15,66,315,121,5,34,113,42
S01010353,Owned: Total,35,25,21,3,18,4,0,10,4,0,2,2,2
S01010353,Owned: Owned outright,6,4,2,1,1,2,0,2,2,0,0,0,0
S01010353,Owned: Owned with a mortgage or loan or shared ownership,29,21,19,2,17,2,0,8,2,0,2,2,2
S01010353,Rented or living rent free: Total,527,222,145,44,101,11,66,305,117,5,32,111,40
S01010353,Rented or living rent free: Social rented,516,216,141,43,98,11,64,300,116,5,32,109,38
S01010353,Rented or living rent free: Private rented or living rent free,11,6,4,1,3,0,2,5,1,0,0,2,2
S01010354,All HRPs aged 16 and over,375,196,159,39,120,14,23,179,87,8,16,55,13
S01010354,Owned: Total,128,77,66,4,62,6,5,51,42,0,1,7,1
S01010354,Owned: Owned outright,58,20,16,2,14,1,3,38,34,0,0,4,0
S01010354,Owned: Owned with a mortgage or loan or shared ownership,70,57,50,2,48,5,2,13,8,0,1,3,1
S01010354,Rented or living rent free: Total,247,119,93,35,58,8,18,128,45,8,15,48,12
S01010354,Rented or living rent free: Social rented,183,73,57,24,33,4,12,110,39,1,12,47,11
S01010354,Rented or living rent free: Private rented or living rent free,64,46,36,11,25,4,6,18,6,7,3,1,1
S01010355,All HRPs aged 16 and over,402,233,184,45,139,24,25,169,72,8,12,64,13
S01010355,Owned: Total,121,88,77,16,61,10,1,33,26,1,0,3,3
S01010355,Owned: Owned outright,51,26,23,5,18,3,0,25,22,0,0,1,2
S01010355,Owned: Owned with a mortgage or loan or shared ownership,70,62,54,11,43,7,1,8,4,1,0,2,1
S01010355,Rented or living rent free: Total,281,145,107,29,78,14,24,136,46,7,12,61,10
S01010355,Rented or living rent free: Social rented,234,111,79,21,58,11,21,123,44,3,11,58,7
S01010355,Rented or living rent free: Private rented or living rent free,47,34,28,8,20,3,3,13,2,4,1,3,3
S01010356,All HRPs aged 16 and over,308,245,202,30,172,20,23,63,22,7,11,18,5
S01010356,Owned: Total,182,158,140,14,126,13,5,24,16,1,1,4,2
S01010356,Owned: Owned outright,28,16,13,2,11,2,1,12,9,0,0,2,1
S01010356,Owned: Owned with a mortgage or loan or shared ownership,154,142,127,12,115,11,4,12,7,1,1,2,1
S01010356,Rented or living rent free: Total,126,87,62,16,46,7,18,39,6,6,10,14,3
S01010356,Rented or living rent free: Social rented,80,50,31,11,20,5,14,30,6,0,7,14,3
S01010356,Rented or living rent free: Private rented or living rent free,46,37,31,5,26,2,4,9,0,6,3,0,0
S01010357,All HRPs aged 16 and over,340,177,138,33,105,8,31,163,67,7,10,60,19
S01010357,Owned: Total,86,53,48,5,43,4,1,33,26,0,0,6,1
S01010357,Owned: Owned outright,39,16,14,4,10,2,0,23,20,0,0,2,1
S01010357,Owned: Owned with a mortgage or loan or shared ownership,47,37,34,1,33,2,1,10,6,0,0,4,0
S01010357,Rented or living rent free: Total,254,124,90,28,62,4,30,130,41,7,10,54,18
S01010357,Rented or living rent free: Social rented,236,115,81,23,58,4,30,121,40,3,10,50,18
S01010357,Rented or living rent free: Private rented or living rent free,18,9,9,5,4,0,0,9,1,4,0,4,0
S01010358,All HRPs aged 16 and over,507,229,171,55,116,9,49,278,146,10,10,91,21
S01010358,Owned: Total,137,85,78,18,60,3,4,52,45,1,0,3,3
S01010358,Owned: Owned outright,68,25,22,7,15,2,1,43,39,0,0,2,2
S01010358,Owned: Owned with a mortgage or loan or shared ownership,69,60,56,11,45,1,3,9,6,1,0,1,1
S01010358,Rented or living rent free: Total,370,144,93,37,56,6,45,226,101,9,10,88,18
S01010358,Rented or living rent free: Social rented,332,120,75,31,44,5,40,212,97,4,9,85,17
S01010358,Rented or living rent free: Private rented or living rent free,38,24,18,6,12,1,5,14,4,5,1,3,1
S01010359,All HRPs aged 16 and over,456,205,145,53,92,19,41,251,136,5,31,60,19
S01010359,Owned: Total,56,37,25,2,23,6,6,19,17,0,0,2,0
S01010359,Owned: Owned outright,32,18,10,1,9,3,5,14,13,0,0,1,0
S01010359,Owned: Owned with a mortgage or loan or shared ownership,24,19,15,1,14,3,1,5,4,0,0,1,0
S01010359,Rented or living rent free: Total,400,168,120,51,69,13,35,232,119,5,31,58,19
S01010359,Rented or living rent free: Social rented,379,155,111,49,62,11,33,224,116,4,29,57,18
S01010359,Rented or living rent free: Private rented or living rent free,21,13,9,2,7,2,2,8,3,1,2,1,1
S01010360,All HRPs aged 16 and over,285,169,126,36,90,10,33,116,41,3,13,46,13
S01010360,Owned: Total,72,58,55,10,45,3,0,14,10,1,0,2,1
S01010360,Owned: Owned outright,21,9,8,2,6,1,0,12,8,1,0,2,1
S01010360,Owned: Owned with a mortgage or loan or shared ownership,51,49,47,8,39,2,0,2,2,0,0,0,0
S01010360,Rented or living rent free: Total,213,111,71,26,45,7,33,102,31,2,13,44,12
S01010360,Rented or living rent free: Social rented,185,89,55,21,34,5,29,96,29,1,11,43,12
S01010360,Rented or living rent free: Private rented or living rent free,28,22,16,5,11,2,4,6,2,1,2,1,0
S01010361,All HRPs aged 16 and over,402,223,133,55,78,8,82,179,72,5,11,77,14
S01010361,Owned: Total,21,11,10,2,8,1,0,10,7,0,0,3,0
S01010361,Owned: Owned outright,12,5,5,1,4,0,0,7,6,0,0,1,0
S01010361,Owned: Owned with a mortgage or loan or shared ownership,9,6,5,1,4,1,0,3,1,0,0,2,0
S01010361,Rented or living rent free: Total,381,212,123,53,70,7,82,169,65,5,11,74,14
S01010361,Rented or living rent free: Social rented,356,200,117,51,66,7,76,156,62,5,10,72,7
S01010361,Rented or living rent free: Private rented or living rent free,25,12,6,2,4,0,6,13,3,0,1,2,7
S01010362,All HRPs aged 16 and over,611,323,203,54,149,8,112,288,127,38,5,98,20
S01010362,Owned: Total,87,44,38,6,32,3,3,43,41,0,0,2,0
S01010362,Owned: Owned outright,52,13,11,1,10,0,2,39,38,0,0,1,0
S01010362,Owned: Owned with a mortgage or loan or shared ownership,35,31,27,5,22,3,1,4,3,0,0,1,0
S01010362,Rented or living rent free: Total,524,279,165,48,117,5,109,245,86,38,5,96,20
S01010362,Rented or living rent free: Social rented,497,263,153,44,109,4,106,234,83,36,4,92,19
S01010362,Rented or living rent free: Private rented or living rent free,27,16,12,4,8,1,3,11,3,2,1,4,1
S01010363,All HRPs aged 16 and over,394,270,219,32,187,37,14,124,82,14,1,23,4
S01010363,Owned: Total,271,191,166,19,147,24,1,80,71,2,0,6,1
S01010363,Owned: Owned outright,114,49,42,3,39,7,0,65,61,0,0,3,1
S01010363,Owned: Owned with a mortgage or loan or shared ownership,157,142,124,16,108,17,1,15,10,2,0,3,0
S01010363,Rented or living rent free: Total,123,79,53,13,40,13,13,44,11,12,1,17,3
S01010363,Rented or living rent free: Social rented,35,14,6,1,5,3,5,21,8,0,0,12,1
S01010363,Rented or living rent free: Private rented or living rent free,88,65,47,12,35,10,8,23,3,12,1,5,2
S01010364,All HRPs aged 16 and over,337,236,196,31,165,39,1,101,93,0,1,5,2
S01010364,Owned: Total,314,222,189,26,163,33,0,92,87,0,1,3,1
S01010364,Owned: Owned outright,151,71,59,16,43,12,0,80,78,0,0,2,0
S01010364,Owned: Owned with a mortgage or loan or shared ownership,163,151,130,10,120,21,0,12,9,0,1,1,1
S01010364,Rented or living rent free: Total,23,14,7,5,2,6,1,9,6,0,0,2,1
S01010364,Rented or living rent free: Social rented,11,8,5,4,1,2,1,3,3,0,0,0,0
S01010364,Rented or living rent free: Private rented or living rent free,12,6,2,1,1,4,0,6,3,0,0,2,1
S01010365,All HRPs aged 16 and over,449,337,244,24,220,86,7,112,92,8,1,6,5
S01010365,Owned: Total,361,270,191,19,172,76,3,91,86,0,0,1,4
S01010365,Owned: Owned outright,177,92,58,9,49,33,1,85,80,0,0,1,4
S01010365,Owned: Owned with a mortgage or loan or shared ownership,184,178,133,10,123,43,2,6,6,0,0,0,0
S01010365,Rented or living rent free: Total,88,67,53,5,48,10,4,21,6,8,1,5,1
S01010365,Rented or living rent free: Social rented,4,2,0,0,0,0,2,2,0,0,0,2,0
S01010365,Rented or living rent free: Private rented or living rent free,84,65,53,5,48,10,2,19,6,8,1,3,1
S01010366,All HRPs aged 16 and over,502,373,302,31,271,57,14,129,91,32,2,4,0
S01010366,Owned: Total,391,294,243,19,224,45,6,97,87,6,0,4,0
S01010366,Owned: Owned outright,168,83,61,7,54,21,1,85,81,2,0,2,0
S01010366,Owned: Owned with a mortgage or loan or shared ownership,223,211,182,12,170,24,5,12,6,4,0,2,0
S01010366,Rented or living rent free: Total,111,79,59,12,47,12,8,32,4,26,2,0,0
S01010366,Rented or living rent free: Social rented,14,10,7,3,4,1,2,4,1,2,1,0,0
S01010366,Rented or living rent free: Private rented or living rent free,97,69,52,9,43,11,6,28,3,24,1,0,0
S01010367,All HRPs aged 16 and over,507,357,287,39,248,60,10,150,120,18,2,7,3
S01010367,Owned: Total,387,263,210,26,184,49,4,124,109,8,2,2,3
S01010367,Owned: Owned outright,195,90,66,15,51,22,2,105,98,2,2,1,2
S01010367,Owned: Owned with a mortgage or loan or shared ownership,192,173,144,11,133,27,2,19,11,6,0,1,1
S01010367,Rented or living rent free: Total,120,94,77,13,64,11,6,26,11,10,0,5,0
S01010367,Rented or living rent free: Social rented,15,6,6,1,5,0,0,9,4,1,0,4,0
S01010367,Rented or living rent free: Private rented or living rent free,105,88,71,12,59,11,6,17,7,9,0,1,0
S01010368,All HRPs aged 16 and over,355,268,194,25,169,66,8,87,73,9,2,1,2
S01010368,Owned: Total,282,207,138,13,125,62,7,75,69,4,0,0,2
S01010368,Owned: Owned outright,148,82,54,9,45,24,4,66,65,0,0,0,1
S01010368,Owned: Owned with a mortgage or loan or shared ownership,134,125,84,4,80,38,3,9,4,4,0,0,1
S01010368,Rented or living rent free: Total,73,61,56,12,44,4,1,12,4,5,2,1,0
S01010368,Rented or living rent free: Social rented,5,3,3,2,1,0,0,2,1,1,0,0,0
S01010368,Rented or living rent free: Private rented or living rent free,68,58,53,10,43,4,1,10,3,4,2,1,0
S01010369,All HRPs aged 16 and over,433,337,279,49,230,43,15,96,37,15,7,26,11
S01010369,Owned: Total,187,156,127,11,116,28,1,31,20,3,0,3,5
S01010369,Owned: Owned outright,74,50,31,6,25,19,0,24,19,0,0,1,4
S01010369,Owned: Owned with a mortgage or loan or shared ownership,113,106,96,5,91,9,1,7,1,3,0,2,1
S01010369,Rented or living rent free: Total,246,181,152,38,114,15,14,65,17,12,7,23,6
S01010369,Rented or living rent free: Social rented,112,64,48,21,27,5,11,48,10,8,5,20,5
S01010369,Rented or living rent free: Private rented or living rent free,134,117,104,17,87,10,3,17,7,4,2,3,1
S01010370,All HRPs aged 16 and over,335,279,212,28,184,58,9,56,30,18,2,3,3
S01010370,Owned: Total,201,165,119,15,104,43,3,36,27,7,0,1,1
S01010370,Owned: Owned outright,70,48,31,7,24,17,0,22,21,0,0,1,0
S01010370,Owned: Owned with a mortgage or loan or shared ownership,131,117,88,8,80,26,3,14,6,7,0,0,1
S01010370,Rented or living rent free: Total,134,114,93,13,80,15,6,20,3,11,2,2,2
S01010370,Rented or living rent free: Social rented,13,9,9,1,8,0,0,4,0,1,1,1,1
S01010370,Rented or living rent free: Private rented or living rent free,121,105,84,12,72,15,6,16,3,10,1,1,1
S01010371,All HRPs aged 16 and over,461,354,280,32,248,61,13,107,51,47,1,4,4
S01010371,Owned: Total,283,228,177,12,165,48,3,55,45,6,0,2,2
S01010371,Owned: Owned outright,107,60,40,8,32,19,1,47,43,3,0,1,0
S01010371,Owned: Owned with a mortgage or loan or shared ownership,176,168,137,4,133,29,2,8,2,3,0,1,2
S01010371,Rented or living rent free: Total,178,126,103,20,83,13,10,52,6,41,1,2,2
S01010371,Rented or living rent free: Social rented,6,3,3,1,2,0,0,3,0,2,0,1,0
S01010371,Rented or living rent free: Private rented or living rent free,172,123,100,19,81,13,10,49,6,39,1,1,2
S01010372,All HRPs aged 16 and over,226,181,151,21,130,29,1,45,32,6,2,5,0
S01010372,Owned: Total,161,133,107,11,96,26,0,28,25,1,0,2,0
S01010372,Owned: Owned outright,65,40,36,6,30,4,0,25,23,1,0,1,0
S01010372,Owned: Owned with a mortgage or loan or shared ownership,96,93,71,5,66,22,0,3,2,0,0,1,0
S01010372,Rented or living rent free: Total,65,48,44,10,34,3,1,17,7,5,2,3,0
S01010372,Rented or living rent free: Social rented,11,2,2,1,1,0,0,9,6,0,1,2,0
S01010372,Rented or living rent free: Private rented or living rent free,54,46,42,9,33,3,1,8,1,5,1,1,0
S01010373,All HRPs aged 16 and over,408,298,237,36,201,44,17,110,66,22,3,14,5
S01010373,Owned: Total,230,171,134,16,118,32,5,59,49,4,1,2,3
S01010373,Owned: Owned outright,95,50,37,7,30,10,3,45,40,2,1,0,2
S01010373,Owned: Owned with a mortgage or loan or shared ownership,135,121,97,9,88,22,2,14,9,2,0,2,1
S01010373,Rented or living rent free: Total,178,127,103,20,83,12,12,51,17,18,2,12,2
S01010373,Rented or living rent free: Social rented,37,10,9,1,8,0,1,27,12,1,2,10,2
S01010373,Rented or living rent free: Private rented or living rent free,141,117,94,19,75,12,11,24,5,17,0,2,0
S01010374,All HRPs aged 16 and over,469,356,272,56,216,74,10,113,61,42,2,4,4
S01010374,Owned: Total,282,217,150,26,124,62,5,65,51,9,2,2,1
S01010374,Owned: Owned outright,129,73,53,14,39,20,0,56,47,7,1,1,0
S01010374,Owned: Owned with a mortgage or loan or shared ownership,153,144,97,12,85,42,5,9,4,2,1,1,1
S01010374,Rented or living rent free: Total,187,139,122,30,92,12,5,48,10,33,0,2,3
S01010374,Rented or living rent free: Social rented,21,11,10,4,6,1,0,10,6,0,0,1,3
S01010374,Rented or living rent free: Private rented or living rent free,166,128,112,26,86,11,5,38,4,33,0,1,0
S01010375,All HRPs aged 16 and over,219,146,122,51,71,17,7,73,17,45,0,8,3
S01010375,Owned: Total,76,56,45,9,36,11,0,20,8,8,0,2,2
S01010375,Owned: Owned outright,29,20,16,3,13,4,0,9,7,0,0,2,0
S01010375,Owned: Owned with a mortgage or loan or shared ownership,47,36,29,6,23,7,0,11,1,8,0,0,2
S01010375,Rented or living rent free: Total,143,90,77,42,35,6,7,53,9,37,0,6,1
S01010375,Rented or living rent free: Social rented,5,2,2,1,1,0,0,3,1,0,0,2,0
S01010375,Rented or living rent free: Private rented or living rent free,138,88,75,41,34,6,7,50,8,37,0,4,1
S01010376,All HRPs aged 16 and over,367,247,203,53,150,30,14,120,24,88,2,5,1
S01010376,Owned: Total,129,106,85,8,77,18,3,23,13,10,0,0,0
S01010376,Owned: Owned outright,40,24,17,4,13,6,1,16,12,4,0,0,0
S01010376,Owned: Owned with a mortgage or loan or shared ownership,89,82,68,4,64,12,2,7,1,6,0,0,0
S01010376,Rented or living rent free: Total,238,141,118,45,73,12,11,97,11,78,2,5,1
S01010376,Rented or living rent free: Social rented,32,12,9,3,6,2,1,20,7,8,1,4,0
S01010376,Rented or living rent free: Private rented or living rent free,206,129,109,42,67,10,10,77,4,70,1,1,1
S01010377,All HRPs aged 16 and over,375,252,194,76,118,41,17,123,19,78,7,12,7
S01010377,Owned: Total,134,108,76,15,61,29,3,26,14,10,1,0,1
S01010377,Owned: Owned outright,53,38,26,8,18,12,0,15,12,1,1,0,1
S01010377,Owned: Owned with a mortgage or loan or shared ownership,81,70,50,7,43,17,3,11,2,9,0,0,0
S01010377,Rented or living rent free: Total,241,144,118,61,57,12,14,97,5,68,6,12,6
S01010377,Rented or living rent free: Social rented,36,17,12,4,8,2,3,19,4,6,1,7,1
S01010377,Rented or living rent free: Private rented or living rent free,205,127,106,57,49,10,11,78,1,62,5,5,5
S01010378,All HRPs aged 16 and over,272,190,156,57,99,15,19,82,15,56,1,6,4
S01010378,Owned: Total,108,83,69,14,55,9,5,25,9,12,0,1,3
S01010378,Owned: Owned outright,29,18,16,2,14,1,1,11,8,3,0,0,0
S01010378,Owned: Owned with a mortgage or loan or shared ownership,79,65,53,12,41,8,4,14,1,9,0,1,3
S01010378,Rented or living rent free: Total,164,107,87,43,44,6,14,57,6,44,1,5,1
S01010378,Rented or living rent free: Social rented,14,8,4,0,4,1,3,6,1,0,1,4,0
S01010378,Rented or living rent free: Private rented or living rent free,150,99,83,43,40,5,11,51,5,44,0,1,1
S01010379,All HRPs aged 16 and over,446,288,230,80,150,35,23,158,49,89,3,14,3
S01010379,Owned: Total,169,119,88,19,69,25,6,50,29,16,1,3,1
S01010379,Owned: Owned outright,65,29,20,5,15,6,3,36,27,7,1,0,1
S01010379,Owned: Owned with a mortgage or loan or shared ownership,104,90,68,14,54,19,3,14,2,9,0,3,0
S01010379,Rented or living rent free: Total,277,169,142,61,81,10,17,108,20,73,2,11,2
S01010379,Rented or living rent free: Social rented,75,43,36,9,27,3,4,32,15,4,2,10,1
S01010379,Rented or living rent free: Private rented or living rent free,202,126,106,52,54,7,13,76,5,69,0,1,1
S01010380,All HRPs aged 16 and over,521,357,292,57,235,46,19,164,96,42,2,18,6
S01010380,Owned: Total,274,186,152,22,130,30,4,88,71,11,0,4,2
S01010380,Owned: Owned outright,128,62,49,14,35,10,3,66,58,7,0,0,1
S01010380,Owned: Owned with a mortgage or loan or shared ownership,146,124,103,8,95,20,1,22,13,4,0,4,1
S01010380,Rented or living rent free: Total,247,171,140,35,105,16,15,76,25,31,2,14,4
S01010380,Rented or living rent free: Social rented,69,32,20,4,16,5,7,37,18,4,1,12,2
S01010380,Rented or living rent free: Private rented or living rent free,178,139,120,31,89,11,8,39,7,27,1,2,2
S01010381,All HRPs aged 16 and over,372,255,220,45,175,19,16,117,17,77,4,16,3
S01010381,Owned: Total,102,78,68,6,62,6,4,24,10,11,1,1,1
S01010381,Owned: Owned outright,35,18,15,1,14,2,1,17,8,7,1,0,1
S01010381,Owned: Owned with a mortgage or loan or shared ownership,67,60,53,5,48,4,3,7,2,4,0,1,0
S01010381,Rented or living rent free: Total,270,177,152,39,113,13,12,93,7,66,3,15,2
S01010381,Rented or living rent free: Social rented,31,18,12,3,9,3,3,13,2,1,1,8,1
S01010381,Rented or living rent free: Private rented or living rent free,239,159,140,36,104,10,9,80,5,65,2,7,1
S01010382,All HRPs aged 16 and over,483,365,293,62,231,41,31,118,52,39,4,21,2
S01010382,Owned: Total,198,158,124,18,106,22,12,40,30,7,0,2,1
S01010382,Owned: Owned outright,76,43,30,7,23,8,5,33,28,4,0,0,1
S01010382,Owned: Owned with a mortgage or loan or shared ownership,122,115,94,11,83,14,7,7,2,3,0,2,0
S01010382,Rented or living rent free: Total,285,207,169,44,125,19,19,78,22,32,4,19,1
S01010382,Rented or living rent free: Social rented,97,54,40,6,34,8,6,43,18,3,3,18,1
S01010382,Rented or living rent free: Private rented or living rent free,188,153,129,38,91,11,13,35,4,29,1,1,0
S01010383,All HRPs aged 16 and over,393,228,174,51,123,24,30,165,55,49,4,46,11
S01010383,Owned: Total,69,43,34,5,29,8,1,26,18,4,0,2,2
S01010383,Owned: Owned outright,19,8,7,2,5,1,0,11,9,1,0,0,1
S01010383,Owned: Owned with a mortgage or loan or shared ownership,50,35,27,3,24,7,1,15,9,3,0,2,1
S01010383,Rented or living rent free: Total,324,185,140,46,94,16,29,139,37,45,4,44,9
S01010383,Rented or living rent free: Social rented,193,97,67,21,46,11,19,96,35,7,4,42,8
S01010383,Rented or living rent free: Private rented or living rent free,131,88,73,25,48,5,10,43,2,38,0,2,1
S01010384,All HRPs aged 16 and over,454,342,289,44,245,43,10,112,51,43,1,11,6
S01010384,Owned: Total,198,152,122,11,111,25,5,46,34,7,0,1,4
S01010384,Owned: Owned outright,81,49,37,6,31,11,1,32,27,2,0,0,3
S01010384,Owned: Owned with a mortgage or loan or shared ownership,117,103,85,5,80,14,4,14,7,5,0,1,1
S01010384,Rented or living rent free: Total,256,190,167,33,134,18,5,66,17,36,1,10,2
S01010384,Rented or living rent free: Social rented,47,23,20,3,17,1,2,24,11,2,1,9,1
S01010384,Rented or living rent free: Private rented or living rent free,209,167,147,30,117,17,3,42,6,34,0,1,1
S01010385,All HRPs aged 16 and over,498,335,266,56,210,45,24,163,78,39,6,31,9
S01010385,Owned: Total,161,112,95,8,87,13,4,49,37,9,0,2,1
S01010385,Owned: Owned outright,60,28,23,3,20,4,1,32,28,3,0,1,0
S01010385,Owned: Owned with a mortgage or loan or shared ownership,101,84,72,5,67,9,3,17,9,6,0,1,1
S01010385,Rented or living rent free: Total,337,223,171,48,123,32,20,114,41,30,6,29,8
S01010385,Rented or living rent free: Social rented,163,83,62,24,38,13,8,80,37,4,6,27,6
S01010385,Rented or living rent free: Private rented or living rent free,174,140,109,24,85,19,12,34,4,26,0,2,2
S01010386,All HRPs aged 16 and over,528,311,250,56,194,31,30,217,95,48,8,56,10
S01010386,Owned: Total,132,100,88,12,76,11,1,32,21,6,0,4,1
S01010386,Owned: Owned outright,37,18,16,4,12,2,0,19,16,1,0,1,1
S01010386,Owned: Owned with a mortgage or loan or shared ownership,95,82,72,8,64,9,1,13,5,5,0,3,0
S01010386,Rented or living rent free: Total,396,211,162,44,118,20,29,185,74,42,8,52,9
S01010386,Rented or living rent free: Social rented,259,121,79,25,54,16,26,138,64,12,7,48,7
S01010386,Rented or living rent free: Private rented or living rent free,137,90,83,19,64,4,3,47,10,30,1,4,2
S01010387,All HRPs aged 16 and over,587,422,357,59,298,35,30,165,64,50,5,42,4
S01010387,Owned: Total,168,129,115,14,101,12,2,39,24,11,1,3,0
S01010387,Owned: Owned outright,49,25,23,3,20,1,1,24,21,2,0,1,0
S01010387,Owned: Owned with a mortgage or loan or shared ownership,119,104,92,11,81,11,1,15,3,9,1,2,0
S01010387,Rented or living rent free: Total,419,293,242,45,197,23,28,126,40,39,4,39,4
S01010387,Rented or living rent free: Social rented,154,80,58,7,51,8,14,74,33,0,3,35,3
S01010387,Rented or living rent free: Private rented or living rent free,265,213,184,38,146,15,14,52,7,39,1,4,1
S01010388,All HRPs aged 16 and over,584,354,291,65,226,32,31,230,114,31,10,65,10
S01010388,Owned: Total,185,133,115,16,99,12,6,52,46,1,2,3,0
S01010388,Owned: Owned outright,60,28,23,7,16,5,0,32,31,0,1,0,0
S01010388,Owned: Owned with a mortgage or loan or shared ownership,125,105,92,9,83,7,6,20,15,1,1,3,0
S01010388,Rented or living rent free: Total,399,221,176,49,127,20,25,178,68,30,8,62,10
S01010388,Rented or living rent free: Social rented,268,133,102,32,70,11,20,135,60,4,7,57,7
S01010388,Rented or living rent free: Private rented or living rent free,131,88,74,17,57,9,5,43,8,26,1,5,3
S01010389,All HRPs aged 16 and over,668,538,450,42,408,60,28,130,16,94,4,11,5
S01010389,Owned: Total,245,215,180,10,170,30,5,30,12,12,3,0,3
S01010389,Owned: Owned outright,49,29,22,4,18,6,1,20,10,8,2,0,0
S01010389,Owned: Owned with a mortgage or loan or shared ownership,196,186,158,6,152,24,4,10,2,4,1,0,3
S01010389,Rented or living rent free: Total,423,323,270,32,238,30,23,100,4,82,1,11,2
S01010389,Rented or living rent free: Social rented,45,27,20,7,13,4,3,18,3,4,1,9,1
S01010389,Rented or living rent free: Private rented or living rent free,378,296,250,25,225,26,20,82,1,78,0,2,1
S01010390,All HRPs aged 16 and over,716,573,481,67,414,46,46,143,53,30,3,46,11
S01010390,Owned: Total,307,264,228,19,209,23,13,43,30,4,0,7,2
S01010390,Owned: Owned outright,78,45,39,6,33,1,5,33,27,1,0,5,0
S01010390,Owned: Owned with a mortgage or loan or shared ownership,229,219,189,13,176,22,8,10,3,3,0,2,2
S01010390,Rented or living rent free: Total,409,309,253,48,205,23,33,100,23,26,3,39,9
S01010390,Rented or living rent free: Social rented,118,70,51,13,38,6,13,48,14,0,2,28,4
S01010390,Rented or living rent free: Private rented or living rent free,291,239,202,35,167,17,20,52,9,26,1,11,5
S01010391,All HRPs aged 16 and over,541,418,353,45,308,39,26,123,49,29,7,34,4
S01010391,Owned: Total,232,191,162,11,151,18,11,41,32,4,0,5,0
S01010391,Owned: Owned outright,56,26,15,2,13,5,6,30,28,0,0,2,0
S01010391,Owned: Owned with a mortgage or loan or shared ownership,176,165,147,9,138,13,5,11,4,4,0,3,0
S01010391,Rented or living rent free: Total,309,227,191,34,157,21,15,82,17,25,7,29,4
S01010391,Rented or living rent free: Social rented,86,43,33,12,21,7,3,43,10,6,6,19,2
S01010391,Rented or living rent free: Private rented or living rent free,223,184,158,22,136,14,12,39,7,19,1,10,2
S01010392,All HRPs aged 16 and over,416,352,284,27,257,60,8,64,10,44,2,4,4
S01010392,Owned: Total,130,116,86,6,80,28,2,14,4,6,1,1,2
S01010392,Owned: Owned outright,32,23,15,2,13,8,0,9,4,3,0,0,2
S01010392,Owned: Owned with a mortgage or loan or shared ownership,98,93,71,4,67,20,2,5,0,3,1,1,0
S01010392,Rented or living rent free: Total,286,236,198,21,177,32,6,50,6,38,1,3,2
S01010392,Rented or living rent free: Social rented,12,9,9,2,7,0,0,3,1,0,0,2,0
S01010392,Rented or living rent free: Private rented or living rent free,274,227,189,19,170,32,6,47,5,38,1,1,2
S01010393,All HRPs aged 16 and over,634,457,390,49,341,48,19,177,108,33,2,28,6
S01010393,Owned: Total,301,229,191,23,168,30,8,72,55,6,1,6,4
S01010393,Owned: Owned outright,126,66,50,9,41,12,4,60,50,4,1,3,2
S01010393,Owned: Owned with a mortgage or loan or shared ownership,175,163,141,14,127,18,4,12,5,2,0,3,2
S01010393,Rented or living rent free: Total,333,228,199,26,173,18,11,105,53,27,1,22,2
S01010393,Rented or living rent free: Social rented,69,16,10,1,9,4,2,53,36,1,0,14,2
S01010393,Rented or living rent free: Private rented or living rent free,264,212,189,25,164,14,9,52,17,26,1,8,0
S01010394,All HRPs aged 16 and over,516,247,175,37,138,28,44,269,141,13,11,93,11
S01010394,Owned: Total,105,66,55,2,53,10,1,39,31,4,0,3,1
S01010394,Owned: Owned outright,44,15,13,1,12,2,0,29,25,2,0,1,1
S01010394,Owned: Owned with a mortgage or loan or shared ownership,61,51,42,1,41,8,1,10,6,2,0,2,0
S01010394,Rented or living rent free: Total,411,181,120,35,85,18,43,230,110,9,11,90,10
S01010394,Rented or living rent free: Social rented,361,144,88,26,62,14,42,217,108,5,10,85,9
S01010394,Rented or living rent free: Private rented or living rent free,50,37,32,9,23,4,1,13,2,4,1,5,1
S01010395,All HRPs aged 16 and over,637,414,349,48,301,30,35,223,124,51,8,33,7
S01010395,Owned: Total,292,227,194,19,175,20,13,65,47,11,0,5,2
S01010395,Owned: Owned outright,94,47,39,10,29,4,4,47,38,6,0,1,2
S01010395,Owned: Owned with a mortgage or loan or shared ownership,198,180,155,9,146,16,9,18,9,5,0,4,0
S01010395,Rented or living rent free: Total,345,187,155,29,126,10,22,158,77,40,8,28,5
S01010395,Rented or living rent free: Social rented,159,49,33,11,22,5,11,110,73,5,5,26,1
S01010395,Rented or living rent free: Private rented or living rent free,186,138,122,18,104,5,11,48,4,35,3,2,4
S01010396,All HRPs aged 16 and over,585,376,306,63,243,39,31,209,137,25,4,37,6
S01010396,Owned: Total,190,146,116,13,103,21,9,44,39,2,0,3,0
S01010396,Owned: Owned outright,74,44,33,9,24,10,1,30,30,0,0,0,0
S01010396,Owned: Owned with a mortgage or loan or shared ownership,116,102,83,4,79,11,8,14,9,2,0,3,0
S01010396,Rented or living rent free: Total,395,230,190,50,140,18,22,165,98,23,4,34,6
S01010396,Rented or living rent free: Social rented,189,59,44,12,32,2,13,130,90,3,2,31,4
S01010396,Rented or living rent free: Private rented or living rent free,206,171,146,38,108,16,9,35,8,20,2,3,2
S01010397,All HRPs aged 16 and over,294,221,179,30,149,30,12,73,48,11,3,10,1
S01010397,Owned: Total,148,117,97,7,90,18,2,31,26,4,0,1,0
S01010397,Owned: Owned outright,56,35,30,2,28,5,0,21,20,0,0,1,0
S01010397,Owned: Owned with a mortgage or loan or shared ownership,92,82,67,5,62,13,2,10,6,4,0,0,0
S01010397,Rented or living rent free: Total,146,104,82,23,59,12,10,42,22,7,3,9,1
S01010397,Rented or living rent free: Social rented,50,19,11,4,7,3,5,31,18,1,3,9,0
S01010397,Rented or living rent free: Private rented or living rent free,96,85,71,19,52,9,5,11,4,6,0,0,1
S01010398,All HRPs aged 16 and over,583,444,369,45,324,57,18,139,100,27,2,5,5
S01010398,Owned: Total,352,251,210,24,186,37,4,101,85,11,1,1,3
S01010398,Owned: Owned outright,150,64,51,10,41,11,2,86,79,4,0,1,2
S01010398,Owned: Owned with a mortgage or loan or shared ownership,202,187,159,14,145,26,2,15,6,7,1,0,1
S01010398,Rented or living rent free: Total,231,193,159,21,138,20,14,38,15,16,1,4,2
S01010398,Rented or living rent free: Social rented,12,4,4,1,3,0,0,8,5,1,0,2,0
S01010398,Rented or living rent free: Private rented or living rent free,219,189,155,20,135,20,14,30,10,15,1,2,2
S01010399,All HRPs aged 16 and over,615,503,436,43,393,49,18,112,71,33,3,4,1
S01010399,Owned: Total,340,269,221,12,209,40,8,71,60,7,1,3,0
S01010399,Owned: Owned outright,132,71,53,8,45,14,4,61,57,1,1,2,0
S01010399,Owned: Owned with a mortgage or loan or shared ownership,208,198,168,4,164,26,4,10,3,6,0,1,0
S01010399,Rented or living rent free: Total,275,234,215,31,184,9,10,41,11,26,2,1,1
S01010399,Rented or living rent free: Social rented,4,4,2,0,2,0,2,0,0,0,0,0,0
S01010399,Rented or living rent free: Private rented or living rent free,271,230,213,31,182,9,8,41,11,26,2,1,1
S01010400,All HRPs aged 16 and over,530,397,320,45,275,70,7,133,102,20,2,6,3
S01010400,Owned: Total,390,298,236,29,207,57,5,92,79,9,0,2,2
S01010400,Owned: Owned outright,182,100,68,17,51,30,2,82,74,7,0,0,1
S01010400,Owned: Owned with a mortgage or loan or shared ownership,208,198,168,12,156,27,3,10,5,2,0,2,1
S01010400,Rented or living rent free: Total,140,99,84,16,68,13,2,41,23,11,2,4,1
S01010400,Rented or living rent free: Social rented,29,5,4,0,4,0,1,24,22,0,0,2,0
S01010400,Rented or living rent free: Private rented or living rent free,111,94,80,16,64,13,1,17,1,11,2,2,1
S01010401,All HRPs aged 16 and over,400,243,186,25,161,46,11,157,122,19,1,9,6
S01010401,Owned: Total,205,137,99,8,91,33,5,68,60,4,1,3,0
S01010401,Owned: Owned outright,105,47,32,5,27,13,2,58,53,4,1,0,0
S01010401,Owned: Owned with a mortgage or loan or shared ownership,100,90,67,3,64,20,3,10,7,0,0,3,0
S01010401,Rented or living rent free: Total,195,106,87,17,70,13,6,89,62,15,0,6,6
S01010401,Rented or living rent free: Social rented,76,11,5,2,3,2,4,65,56,0,0,5,4
S01010401,Rented or living rent free: Private rented or living rent free,119,95,82,15,67,11,2,24,6,15,0,1,2
S01010402,All HRPs aged 16 and over,513,390,313,30,283,67,10,123,96,18,1,5,3
S01010402,Owned: Total,351,265,203,12,191,58,4,86,71,9,0,4,2
S01010402,Owned: Owned outright,160,91,67,11,56,22,2,69,63,3,0,2,1
S01010402,Owned: Owned with a mortgage or loan or shared ownership,191,174,136,1,135,36,2,17,8,6,0,2,1
S01010402,Rented or living rent free: Total,162,125,110,18,92,9,6,37,25,9,1,1,1
S01010402,Rented or living rent free: Social rented,34,10,8,3,5,1,1,24,22,1,1,0,0
S01010402,Rented or living rent free: Private rented or living rent free,128,115,102,15,87,8,5,13,3,8,0,1,1
S01010403,All HRPs aged 16 and over,509,375,301,36,265,68,6,134,102,23,0,5,4
S01010403,Owned: Total,384,275,219,29,190,53,3,109,95,6,0,4,4
S01010403,Owned: Owned outright,183,86,65,15,50,21,0,97,87,5,0,1,4
S01010403,Owned: Owned with a mortgage or loan or shared ownership,201,189,154,14,140,32,3,12,8,1,0,3,0
S01010403,Rented or living rent free: Total,125,100,82,7,75,15,3,25,7,17,0,1,0
S01010403,Rented or living rent free: Social rented,4,1,1,0,1,0,0,3,1,2,0,0,0
S01010403,Rented or living rent free: Private rented or living rent free,121,99,81,7,74,15,3,22,6,15,0,1,0
S01010404,All HRPs aged 16 and over,406,300,210,32,178,82,8,106,90,8,1,5,2
S01010404,Owned: Total,279,215,147,19,128,66,2,64,59,2,0,2,1
S01010404,Owned: Owned outright,130,77,45,12,33,31,1,53,51,0,0,2,0
S01010404,Owned: Owned with a mortgage or loan or shared ownership,149,138,102,7,95,35,1,11,8,2,0,0,1
S01010404,Rented or living rent free: Total,127,85,63,13,50,16,6,42,31,6,1,3,1
S01010404,Rented or living rent free: Social rented,37,11,6,3,3,2,3,26,24,0,0,1,1
S01010404,Rented or living rent free: Private rented or living rent free,90,74,57,10,47,14,3,16,7,6,1,2,0
S01010405,All HRPs aged 16 and over,408,324,250,29,221,64,10,84,50,14,4,11,5
S01010405,Owned: Total,286,228,170,22,148,51,7,58,46,3,2,6,1
S01010405,Owned: Owned outright,130,85,61,16,45,21,3,45,38,3,1,2,1
S01010405,Owned: Owned with a mortgage or loan or shared ownership,156,143,109,6,103,30,4,13,8,0,1,4,0
S01010405,Rented or living rent free: Total,122,96,80,7,73,13,3,26,4,11,2,5,4
S01010405,Rented or living rent free: Social rented,7,5,5,0,5,0,0,2,1,0,0,1,0
S01010405,Rented or living rent free: Private rented or living rent free,115,91,75,7,68,13,3,24,3,11,2,4,4
S01010406,All HRPs aged 16 and over,435,352,265,47,218,71,16,83,39,35,1,6,2
S01010406,Owned: Total,239,194,145,17,128,49,0,45,37,5,1,1,1
S01010406,Owned: Owned outright,95,62,43,9,34,19,0,33,31,0,1,1,0
S01010406,Owned: Owned with a mortgage or loan or shared ownership,144,132,102,8,94,30,0,12,6,5,0,0,1
S01010406,Rented or living rent free: Total,196,158,120,30,90,22,16,38,2,30,0,5,1
S01010406,Rented or living rent free: Social rented,9,4,3,2,1,1,0,5,2,0,0,3,0
S01010406,Rented or living rent free: Private rented or living rent free,187,154,117,28,89,21,16,33,0,30,0,2,1
S01010407,All HRPs aged 16 and over,418,281,234,69,165,31,16,137,41,86,0,6,4
S01010407,Owned: Total,195,143,113,17,96,25,5,52,32,13,0,3,4
S01010407,Owned: Owned outright,98,56,40,10,30,12,4,42,29,8,0,1,4
S01010407,Owned: Owned with a mortgage or loan or shared ownership,97,87,73,7,66,13,1,10,3,5,0,2,0
S01010407,Rented or living rent free: Total,223,138,121,52,69,6,11,85,9,73,0,3,0
S01010407,Rented or living rent free: Social rented,4,3,2,1,1,0,1,1,1,0,0,0,0
S01010407,Rented or living rent free: Private rented or living rent free,219,135,119,51,68,6,10,84,8,73,0,3,0
S01010408,All HRPs aged 16 and over,272,140,114,14,100,18,8,132,94,5,2,27,4
S01010408,Owned: Total,155,100,84,7,77,16,0,55,51,0,0,3,1
S01010408,Owned: Owned outright,67,21,15,3,12,6,0,46,43,0,0,2,1
S01010408,Owned: Owned with a mortgage or loan or shared ownership,88,79,69,4,65,10,0,9,8,0,0,1,0
S01010408,Rented or living rent free: Total,117,40,30,7,23,2,8,77,43,5,2,24,3
S01010408,Rented or living rent free: Social rented,89,23,15,5,10,0,8,66,40,1,0,22,3
S01010408,Rented or living rent free: Private rented or living rent free,28,17,15,2,13,2,0,11,3,4,2,2,0
S01010409,All HRPs aged 16 and over,245,172,131,20,111,38,3,73,71,0,1,0,1
S01010409,Owned: Total,230,162,124,18,106,36,2,68,68,0,0,0,0
S01010409,Owned: Owned outright,105,48,37,9,28,10,1,57,57,0,0,0,0
S01010409,Owned: Owned with a mortgage or loan or shared ownership,125,114,87,9,78,26,1,11,11,0,0,0,0
S01010409,Rented or living rent free: Total,15,10,7,2,5,2,1,5,3,0,1,0,1
S01010409,Rented or living rent free: Social rented,8,4,2,1,1,1,1,4,2,0,1,0,1
S01010409,Rented or living rent free: Private rented or living rent free,7,6,5,1,4,1,0,1,1,0,0,0,0
S01010410,All HRPs aged 16 and over,248,175,141,13,128,28,6,73,56,7,3,3,4
S01010410,Owned: Total,216,153,124,12,112,26,3,63,53,3,2,2,3
S01010410,Owned: Owned outright,100,44,36,7,29,8,0,56,49,1,2,2,2
S01010410,Owned: Owned with a mortgage or loan or shared ownership,116,109,88,5,83,18,3,7,4,2,0,0,1
S01010410,Rented or living rent free: Total,32,22,17,1,16,2,3,10,3,4,1,1,1
S01010410,Rented or living rent free: Social rented,5,3,2,0,2,0,1,2,0,0,1,1,0
S01010410,Rented or living rent free: Private rented or living rent free,27,19,15,1,14,2,2,8,3,4,0,0,1
S01010411,All HRPs aged 16 and over,365,278,208,27,181,66,4,87,80,2,3,2,0
S01010411,Owned: Total,335,254,191,22,169,61,2,81,79,0,1,1,0
S01010411,Owned: Owned outright,171,96,69,13,56,26,1,75,73,0,1,1,0
S01010411,Owned: Owned with a mortgage or loan or shared ownership,164,158,122,9,113,35,1,6,6,0,0,0,0
S01010411,Rented or living rent free: Total,30,24,17,5,12,5,2,6,1,2,2,1,0
S01010411,Rented or living rent free: Social rented,8,5,3,2,1,1,1,3,0,2,1,0,0
S01010411,Rented or living rent free: Private rented or living rent free,22,19,14,3,11,4,1,3,1,0,1,1,0
S01010412,All HRPs aged 16 and over,424,330,276,27,249,49,5,94,62,19,2,8,3
S01010412,Owned: Total,243,181,140,16,124,39,2,62,55,4,0,1,2
S01010412,Owned: Owned outright,107,55,40,8,32,14,1,52,47,2,0,1,2
S01010412,Owned: Owned with a mortgage or loan or shared ownership,136,126,100,8,92,25,1,10,8,2,0,0,0
S01010412,Rented or living rent free: Total,181,149,136,11,125,10,3,32,7,15,2,7,1
S01010412,Rented or living rent free: Social rented,7,1,1,0,1,0,0,6,0,1,1,4,0
S01010412,Rented or living rent free: Private rented or living rent free,174,148,135,11,124,10,3,26,7,14,1,3,1
S01010413,All HRPs aged 16 and over,340,194,142,15,127,49,3,146,135,5,0,2,4
S01010413,Owned: Total,297,159,114,13,101,43,2,138,133,1,0,2,2
S01010413,Owned: Owned outright,187,58,36,6,30,21,1,129,125,1,0,2,1
S01010413,Owned: Owned with a mortgage or loan or shared ownership,110,101,78,7,71,22,1,9,8,0,0,0,1
S01010413,Rented or living rent free: Total,43,35,28,2,26,6,1,8,2,4,0,0,2
S01010413,Rented or living rent free: Social rented,6,5,3,1,2,1,1,1,0,0,0,0,1
S01010413,Rented or living rent free: Private rented or living rent free,37,30,25,1,24,5,0,7,2,4,0,0,1
S01010414,All HRPs aged 16 and over,497,310,257,36,221,45,8,187,158,8,2,14,5
S01010414,Owned: Total,355,243,201,25,176,37,5,112,103,1,2,4,2
S01010414,Owned: Owned outright,173,70,55,13,42,13,2,103,99,0,2,2,0
S01010414,Owned: Owned with a mortgage or loan or shared ownership,182,173,146,12,134,24,3,9,4,1,0,2,2
S01010414,Rented or living rent free: Total,142,67,56,11,45,8,3,75,55,7,0,10,3
S01010414,Rented or living rent free: Social rented,73,18,14,4,10,2,2,55,44,1,0,7,3
S01010414,Rented or living rent free: Private rented or living rent free,69,49,42,7,35,6,1,20,11,6,0,3,0
S01010415,All HRPs aged 16 and over,555,293,219,40,179,51,23,262,171,17,8,62,4
S01010415,Owned: Total,226,160,122,12,110,37,1,66,55,3,3,4,1
S01010415,Owned: Owned outright,104,52,42,8,34,10,0,52,50,0,0,2,0
S01010415,Owned: Owned with a mortgage or loan or shared ownership,122,108,80,4,76,27,1,14,5,3,3,2,1
S01010415,Rented or living rent free: Total,329,133,97,28,69,14,22,196,116,14,5,58,3
S01010415,Rented or living rent free: Social rented,275,96,66,20,46,11,19,179,113,4,4,55,3
S01010415,Rented or living rent free: Private rented or living rent free,54,37,31,8,23,3,3,17,3,10,1,3,0
S01010416,All HRPs aged 16 and over,322,219,170,18,152,41,8,103,93,6,2,0,2
S01010416,Owned: Total,252,163,125,13,112,33,5,89,87,0,0,0,2
S01010416,Owned: Owned outright,138,56,37,7,30,16,3,82,81,0,0,0,1
S01010416,Owned: Owned with a mortgage or loan or shared ownership,114,107,88,6,82,17,2,7,6,0,0,0,1
S01010416,Rented or living rent free: Total,70,56,45,5,40,8,3,14,6,6,2,0,0
S01010416,Rented or living rent free: Social rented,8,4,4,2,2,0,0,4,3,1,0,0,0
S01010416,Rented or living rent free: Private rented or living rent free,62,52,41,3,38,8,3,10,3,5,2,0,0
S01010417,All HRPs aged 16 and over,286,202,171,26,145,28,3,84,74,4,0,5,1
S01010417,Owned: Total,219,152,127,13,114,24,1,67,63,1,0,2,1
S01010417,Owned: Owned outright,96,37,29,5,24,8,0,59,57,0,0,2,0
S01010417,Owned: Owned with a mortgage or loan or shared ownership,123,115,98,8,90,16,1,8,6,1,0,0,1
S01010417,Rented or living rent free: Total,67,50,44,13,31,4,2,17,11,3,0,3,0
S01010417,Rented or living rent free: Social rented,10,3,2,2,0,0,1,7,2,3,0,2,0
S01010417,Rented or living rent free: Private rented or living rent free,57,47,42,11,31,4,1,10,9,0,0,1,0
S01010418,All HRPs aged 16 and over,561,443,345,28,317,83,15,118,87,8,4,16,3
S01010418,Owned: Total,388,303,231,13,218,66,6,85,77,2,1,3,2
S01010418,Owned: Owned outright,158,85,63,7,56,20,2,73,69,1,1,1,1
S01010418,Owned: Owned with a mortgage or loan or shared ownership,230,218,168,6,162,46,4,12,8,1,0,2,1
S01010418,Rented or living rent free: Total,173,140,114,15,99,17,9,33,10,6,3,13,1
S01010418,Rented or living rent free: Social rented,31,15,10,3,7,0,5,16,8,0,0,8,0
S01010418,Rented or living rent free: Private rented or living rent free,142,125,104,12,92,17,4,17,2,6,3,5,1
S01010419,All HRPs aged 16 and over,500,357,297,25,272,52,8,143,122,5,2,11,3
S01010419,Owned: Total,397,283,235,16,219,44,4,114,110,0,0,1,3
S01010419,Owned: Owned outright,196,90,77,12,65,11,2,106,104,0,0,1,1
S01010419,Owned: Owned with a mortgage or loan or shared ownership,201,193,158,4,154,33,2,8,6,0,0,0,2
S01010419,Rented or living rent free: Total,103,74,62,9,53,8,4,29,12,5,2,10,0
S01010419,Rented or living rent free: Social rented,21,7,6,3,3,0,1,14,8,0,0,6,0
S01010419,Rented or living rent free: Private rented or living rent free,82,67,56,6,50,8,3,15,4,5,2,4,0
S01010420,All HRPs aged 16 and over,290,151,114,9,105,32,5,139,131,1,3,3,1
S01010420,Owned: Total,258,136,103,6,97,30,3,122,119,0,1,2,0
S01010420,Owned: Owned outright,158,42,33,3,30,8,1,116,115,0,0,1,0
S01010420,Owned: Owned with a mortgage or loan or shared ownership,100,94,70,3,67,22,2,6,4,0,1,1,0
S01010420,Rented or living rent free: Total,32,15,11,3,8,2,2,17,12,1,2,1,1
S01010420,Rented or living rent free: Social rented,14,6,3,1,2,1,2,8,6,0,1,0,1
S01010420,Rented or living rent free: Private rented or living rent free,18,9,8,2,6,1,0,9,6,1,1,1,0
S01010421,All HRPs aged 16 and over,346,237,187,18,169,40,10,109,101,1,3,3,1
S01010421,Owned: Total,294,201,160,15,145,37,4,93,89,1,2,1,0
S01010421,Owned: Owned outright,142,61,49,10,39,10,2,81,78,1,2,0,0
S01010421,Owned: Owned with a mortgage or loan or shared ownership,152,140,111,5,106,27,2,12,11,0,0,1,0
S01010421,Rented or living rent free: Total,52,36,27,3,24,3,6,16,12,0,1,2,1
S01010421,Rented or living rent free: Social rented,23,8,3,1,2,1,4,15,12,0,1,1,1
S01010421,Rented or living rent free: Private rented or living rent free,29,28,24,2,22,2,2,1,0,0,0,1,0
S01010422,All HRPs aged 16 and over,483,286,238,26,212,39,9,197,168,3,1,21,4
S01010422,Owned: Total,356,235,198,16,182,35,2,121,113,1,0,5,2
S01010422,Owned: Owned outright,173,63,56,10,46,7,0,110,103,1,0,4,2
S01010422,Owned: Owned with a mortgage or loan or shared ownership,183,172,142,6,136,28,2,11,10,0,0,1,0
S01010422,Rented or living rent free: Total,127,51,40,10,30,4,7,76,55,2,1,16,2
S01010422,Rented or living rent free: Social rented,83,25,16,7,9,2,7,58,42,1,1,12,2
S01010422,Rented or living rent free: Private rented or living rent free,44,26,24,3,21,2,0,18,13,1,0,4,0
S01010423,All HRPs aged 16 and over,490,299,237,57,180,13,49,191,68,12,21,74,16
S01010423,Owned: Total,107,73,66,11,55,2,5,34,24,1,0,6,3
S01010423,Owned: Owned outright,30,9,9,4,5,0,0,21,20,1,0,0,0
S01010423,Owned: Owned with a mortgage or loan or shared ownership,77,64,57,7,50,2,5,13,4,0,0,6,3
S01010423,Rented or living rent free: Total,383,226,171,46,125,11,44,157,44,11,21,68,13
S01010423,Rented or living rent free: Social rented,304,161,114,36,78,7,40,143,42,5,18,66,12
S01010423,Rented or living rent free: Private rented or living rent free,79,65,57,10,47,4,4,14,2,6,3,2,1
S01010424,All HRPs aged 16 and over,471,263,215,55,160,13,35,208,120,10,11,58,9
S01010424,Owned: Total,170,113,104,16,88,4,5,57,44,2,3,7,1
S01010424,Owned: Owned outright,69,29,22,5,17,3,4,40,34,0,2,4,0
S01010424,Owned: Owned with a mortgage or loan or shared ownership,101,84,82,11,71,1,1,17,10,2,1,3,1
S01010424,Rented or living rent free: Total,301,150,111,39,72,9,30,151,76,8,8,51,8
S01010424,Rented or living rent free: Social rented,228,93,68,30,38,5,20,135,71,5,5,46,8
S01010424,Rented or living rent free: Private rented or living rent free,73,57,43,9,34,4,10,16,5,3,3,5,0
S01010425,All HRPs aged 16 and over,621,370,298,74,224,26,46,251,92,19,18,107,15
S01010425,Owned: Total,148,129,112,11,101,12,5,19,11,3,1,4,0
S01010425,Owned: Owned outright,31,22,16,6,10,3,3,9,7,1,0,1,0
S01010425,Owned: Owned with a mortgage or loan or shared ownership,117,107,96,5,91,9,2,10,4,2,1,3,0
S01010425,Rented or living rent free: Total,473,241,186,63,123,14,41,232,81,16,17,103,15
S01010425,Rented or living rent free: Social rented,374,176,132,48,84,12,32,198,78,5,14,86,15
S01010425,Rented or living rent free: Private rented or living rent free,99,65,54,15,39,2,9,34,3,11,3,17,0
S01010426,All HRPs aged 16 and over,406,274,225,47,178,15,34,132,54,9,11,43,15
S01010426,Owned: Total,160,121,109,10,99,8,4,39,28,1,1,7,2
S01010426,Owned: Owned outright,58,25,20,3,17,4,1,33,25,0,1,5,2
S01010426,Owned: Owned with a mortgage or loan or shared ownership,102,96,89,7,82,4,3,6,3,1,0,2,0
S01010426,Rented or living rent free: Total,246,153,116,37,79,7,30,93,26,8,10,36,13
S01010426,Rented or living rent free: Social rented,183,105,70,25,45,7,28,78,20,5,10,32,11
S01010426,Rented or living rent free: Private rented or living rent free,63,48,46,12,34,0,2,15,6,3,0,4,2
S01010427,All HRPs aged 16 and over,499,250,160,44,116,32,58,249,132,15,22,60,20
S01010427,Owned: Total,196,110,89,12,77,19,2,86,76,2,2,4,2
S01010427,Owned: Owned outright,83,23,16,5,11,6,1,60,56,0,1,1,2
S01010427,Owned: Owned with a mortgage or loan or shared ownership,113,87,73,7,66,13,1,26,20,2,1,3,0
S01010427,Rented or living rent free: Total,303,140,71,32,39,13,56,163,56,13,20,56,18
S01010427,Rented or living rent free: Social rented,283,129,65,31,34,11,53,154,55,12,19,51,17
S01010427,Rented or living rent free: Private rented or living rent free,20,11,6,1,5,2,3,9,1,1,1,5,1
S01010428,All HRPs aged 16 and over,319,199,168,22,146,25,6,120,94,6,6,11,3
S01010428,Owned: Total,234,172,147,13,134,24,1,62,57,0,1,2,2
S01010428,Owned: Owned outright,103,48,39,10,29,8,1,55,51,0,1,2,1
S01010428,Owned: Owned with a mortgage or loan or shared ownership,131,124,108,3,105,16,0,7,6,0,0,0,1
S01010428,Rented or living rent free: Total,85,27,21,9,12,1,5,58,37,6,5,9,1
S01010428,Rented or living rent free: Social rented,64,16,11,5,6,1,4,48,34,2,3,8,1
S01010428,Rented or living rent free: Private rented or living rent free,21,11,10,4,6,0,1,10,3,4,2,1,0
S01010429,All HRPs aged 16 and over,388,297,254,30,224,37,6,91,75,6,2,4,4
S01010429,Owned: Total,341,265,231,21,210,32,2,76,70,0,1,2,3
S01010429,Owned: Owned outright,139,69,56,10,46,12,1,70,65,0,1,1,3
S01010429,Owned: Owned with a mortgage or loan or shared ownership,202,196,175,11,164,20,1,6,5,0,0,1,0
S01010429,Rented or living rent free: Total,47,32,23,9,14,5,4,15,5,6,1,2,1
S01010429,Rented or living rent free: Social rented,19,10,8,4,4,2,0,9,5,1,1,1,1
S01010429,Rented or living rent free: Private rented or living rent free,28,22,15,5,10,3,4,6,0,5,0,1,0
S01010430,All HRPs aged 16 and over,451,256,200,69,131,20,36,195,81,24,13,63,14
S01010430,Owned: Total,131,85,77,19,58,7,1,46,38,1,0,6,1
S01010430,Owned: Owned outright,52,15,13,6,7,1,1,37,32,0,0,5,0
S01010430,Owned: Owned with a mortgage or loan or shared ownership,79,70,64,13,51,6,0,9,6,1,0,1,1
S01010430,Rented or living rent free: Total,320,171,123,50,73,13,35,149,43,23,13,57,13
S01010430,Rented or living rent free: Social rented,285,144,100,36,64,11,33,141,39,21,12,57,12
S01010430,Rented or living rent free: Private rented or living rent free,35,27,23,14,9,2,2,8,4,2,1,0,1
S01010431,All HRPs aged 16 and over,258,196,159,15,144,34,3,62,56,0,0,2,4
S01010431,Owned: Total,232,176,143,14,129,30,3,56,53,0,0,0,3
S01010431,Owned: Owned outright,94,46,35,6,29,10,1,48,47,0,0,0,1
S01010431,Owned: Owned with a mortgage or loan or shared ownership,138,130,108,8,100,20,2,8,6,0,0,0,2
S01010431,Rented or living rent free: Total,26,20,16,1,15,4,0,6,3,0,0,2,1
S01010431,Rented or living rent free: Social rented,12,6,4,1,3,2,0,6,3,0,0,2,1
S01010431,Rented or living rent free: Private rented or living rent free,14,14,12,0,12,2,0,0,0,0,0,0,0
S01010432,All HRPs aged 16 and over,464,285,236,41,195,16,33,179,66,22,17,61,13
S01010432,Owned: Total,140,109,100,7,93,5,4,31,23,1,0,7,0
S01010432,Owned: Owned outright,34,16,13,5,8,1,2,18,13,0,0,5,0
S01010432,Owned: Owned with a mortgage or loan or shared ownership,106,93,87,2,85,4,2,13,10,1,0,2,0
S01010432,Rented or living rent free: Total,324,176,136,34,102,11,29,148,43,21,17,54,13
S01010432,Rented or living rent free: Social rented,258,137,104,24,80,7,26,121,38,8,16,50,9
S01010432,Rented or living rent free: Private rented or living rent free,66,39,32,10,22,4,3,27,5,13,1,4,4
S01010433,All HRPs aged 16 and over,338,229,135,60,75,19,75,109,13,16,18,47,15
S01010433,Owned: Total,24,21,14,3,11,5,2,3,1,0,1,1,0
S01010433,Owned: Owned outright,7,5,1,0,1,3,1,2,0,0,1,1,0
S01010433,Owned: Owned with a mortgage or loan or shared ownership,17,16,13,3,10,2,1,1,1,0,0,0,0
S01010433,Rented or living rent free: Total,314,208,121,57,64,14,73,106,12,16,17,46,15
S01010433,Rented or living rent free: Social rented,304,204,117,57,60,14,73,100,12,14,16,44,14
S01010433,Rented or living rent free: Private rented or living rent free,10,4,4,0,4,0,0,6,0,2,1,2,1
S01010434,All HRPs aged 16 and over,331,201,154,51,103,12,35,130,53,13,15,43,6
S01010434,Owned: Total,63,39,31,4,27,6,2,24,18,0,2,3,1
S01010434,Owned: Owned outright,22,6,5,0,5,1,0,16,13,0,0,2,1
S01010434,Owned: Owned with a mortgage or loan or shared ownership,41,33,26,4,22,5,2,8,5,0,2,1,0
S01010434,Rented or living rent free: Total,268,162,123,47,76,6,33,106,35,13,13,40,5
S01010434,Rented or living rent free: Social rented,216,122,90,41,49,6,26,94,31,7,12,39,5
S01010434,Rented or living rent free: Private rented or living rent free,52,40,33,6,27,0,7,12,4,6,1,1,0
S01010435,All HRPs aged 16 and over,291,153,138,26,112,8,7,138,106,0,8,17,7
S01010435,Owned: Total,176,114,106,15,91,6,2,62,57,0,1,2,2
S01010435,Owned: Owned outright,72,26,23,7,16,3,0,46,42,0,1,2,1
S01010435,Owned: Owned with a mortgage or loan or shared ownership,104,88,83,8,75,3,2,16,15,0,0,0,1
S01010435,Rented or living rent free: Total,115,39,32,11,21,2,5,76,49,0,7,15,5
S01010435,Rented or living rent free: Social rented,97,29,24,11,13,2,3,68,45,0,5,14,4
S01010435,Rented or living rent free: Private rented or living rent free,18,10,8,0,8,0,2,8,4,0,2,1,1
S01010436,All HRPs aged 16 and over,433,252,199,45,154,19,34,181,58,8,18,80,17
S01010436,Owned: Total,98,82,74,14,60,6,2,16,11,1,1,2,1
S01010436,Owned: Owned outright,24,15,14,3,11,0,1,9,7,0,0,1,1
S01010436,Owned: Owned with a mortgage or loan or shared ownership,74,67,60,11,49,6,1,7,4,1,1,1,0
S01010436,Rented or living rent free: Total,335,170,125,31,94,13,32,165,47,7,17,78,16
S01010436,Rented or living rent free: Social rented,275,130,89,23,66,13,28,145,43,7,11,72,12
S01010436,Rented or living rent free: Private rented or living rent free,60,40,36,8,28,0,4,20,4,0,6,6,4
S01010437,All HRPs aged 16 and over,269,149,124,34,90,11,14,120,79,3,5,25,8
S01010437,Owned: Total,139,87,81,13,68,5,1,52,44,0,0,4,4
S01010437,Owned: Owned outright,53,16,15,4,11,1,0,37,33,0,0,2,2
S01010437,Owned: Owned with a mortgage or loan or shared ownership,86,71,66,9,57,4,1,15,11,0,0,2,2
S01010437,Rented or living rent free: Total,130,62,43,21,22,6,13,68,35,3,5,21,4
S01010437,Rented or living rent free: Social rented,115,50,33,16,17,5,12,65,35,3,4,19,4
S01010437,Rented or living rent free: Private rented or living rent free,15,12,10,5,5,1,1,3,0,0,1,2,0
S01010438,All HRPs aged 16 and over,370,242,194,43,151,15,33,128,34,6,29,50,9
S01010438,Owned: Total,115,108,96,5,91,10,2,7,7,0,0,0,0
S01010438,Owned: Owned outright,10,6,6,0,6,0,0,4,4,0,0,0,0
S01010438,Owned: Owned with a mortgage or loan or shared ownership,105,102,90,5,85,10,2,3,3,0,0,0,0
S01010438,Rented or living rent free: Total,255,134,98,38,60,5,31,121,27,6,29,50,9
S01010438,Rented or living rent free: Social rented,238,123,90,34,56,3,30,115,27,5,27,48,8
S01010438,Rented or living rent free: Private rented or living rent free,17,11,8,4,4,2,1,6,0,1,2,2,1
S01010439,All HRPs aged 16 and over,512,371,321,41,280,15,35,141,41,27,19,41,13
S01010439,Owned: Total,167,153,136,4,132,9,8,14,8,2,2,1,1
S01010439,Owned: Owned outright,34,23,18,0,18,1,4,11,6,2,1,1,1
S01010439,Owned: Owned with a mortgage or loan or shared ownership,133,130,118,4,114,8,4,3,2,0,1,0,0
S01010439,Rented or living rent free: Total,345,218,185,37,148,6,27,127,33,25,17,40,12
S01010439,Rented or living rent free: Social rented,242,145,122,31,91,4,19,97,31,4,14,37,11
S01010439,Rented or living rent free: Private rented or living rent free,103,73,63,6,57,2,8,30,2,21,3,3,1
S01010440,All HRPs aged 16 and over,322,170,131,24,107,12,27,152,72,3,16,46,15
S01010440,Owned: Total,126,84,74,9,65,10,0,42,39,0,0,3,0
S01010440,Owned: Owned outright,60,27,21,4,17,6,0,33,31,0,0,2,0
S01010440,Owned: Owned with a mortgage or loan or shared ownership,66,57,53,5,48,4,0,9,8,0,0,1,0
S01010440,Rented or living rent free: Total,196,86,57,15,42,2,27,110,33,3,16,43,15
S01010440,Rented or living rent free: Social rented,181,78,52,15,37,2,24,103,32,1,15,41,14
S01010440,Rented or living rent free: Private rented or living rent free,15,8,5,0,5,0,3,7,1,2,1,2,1
S01010441,All HRPs aged 16 and over,488,411,362,47,315,17,32,77,30,1,10,28,8
S01010441,Owned: Total,269,241,225,16,209,11,5,28,16,0,3,8,1
S01010441,Owned: Owned outright,39,26,22,6,16,3,1,13,10,0,1,2,0
S01010441,Owned: Owned with a mortgage or loan or shared ownership,230,215,203,10,193,8,4,15,6,0,2,6,1
S01010441,Rented or living rent free: Total,219,170,137,31,106,6,27,49,14,1,7,20,7
S01010441,Rented or living rent free: Social rented,103,68,46,15,31,2,20,35,12,0,2,15,6
S01010441,Rented or living rent free: Private rented or living rent free,116,102,91,16,75,4,7,14,2,1,5,5,1
S01010442,All HRPs aged 16 and over,383,300,256,64,192,19,25,83,23,2,10,36,12
S01010442,Owned: Total,127,115,106,10,96,7,2,12,9,0,0,2,1
S01010442,Owned: Owned outright,24,18,15,6,9,3,0,6,5,0,0,1,0
S01010442,Owned: Owned with a mortgage or loan or shared ownership,103,97,91,4,87,4,2,6,4,0,0,1,1
S01010442,Rented or living rent free: Total,256,185,150,54,96,12,23,71,14,2,10,34,11
S01010442,Rented or living rent free: Social rented,193,134,109,44,65,10,15,59,12,1,7,31,8
S01010442,Rented or living rent free: Private rented or living rent free,63,51,41,10,31,2,8,12,2,1,3,3,3
S01010443,All HRPs aged 16 and over,228,138,115,24,91,16,7,90,62,2,8,14,4
S01010443,Owned: Total,147,103,88,16,72,14,1,44,37,0,0,6,1
S01010443,Owned: Owned outright,57,30,27,9,18,3,0,27,24,0,0,3,0
S01010443,Owned: Owned with a mortgage or loan or shared ownership,90,73,61,7,54,11,1,17,13,0,0,3,1
S01010443,Rented or living rent free: Total,81,35,27,8,19,2,6,46,25,2,8,8,3
S01010443,Rented or living rent free: Social rented,49,16,13,5,8,1,2,33,22,0,2,6,3
S01010443,Rented or living rent free: Private rented or living rent free,32,19,14,3,11,1,4,13,3,2,6,2,0
S01010444,All HRPs aged 16 and over,289,154,128,38,90,15,11,135,97,2,4,24,8
S01010444,Owned: Total,178,110,97,25,72,12,1,68,61,1,0,6,0
S01010444,Owned: Owned outright,77,24,22,10,12,2,0,53,49,0,0,4,0
S01010444,Owned: Owned with a mortgage or loan or shared ownership,101,86,75,15,60,10,1,15,12,1,0,2,0
S01010444,Rented or living rent free: Total,111,44,31,13,18,3,10,67,36,1,4,18,8
S01010444,Rented or living rent free: Social rented,89,28,22,9,13,0,6,61,35,1,1,17,7
S01010444,Rented or living rent free: Private rented or living rent free,22,16,9,4,5,3,4,6,1,0,3,1,1
S01010445,All HRPs aged 16 and over,307,161,130,24,106,20,11,146,84,2,19,33,8
S01010445,Owned: Total,162,115,100,13,87,14,1,47,36,1,1,8,1
S01010445,Owned: Owned outright,44,17,14,3,11,3,0,27,25,0,0,1,1
S01010445,Owned: Owned with a mortgage or loan or shared ownership,118,98,86,10,76,11,1,20,11,1,1,7,0
S01010445,Rented or living rent free: Total,145,46,30,11,19,6,10,99,48,1,18,25,7
S01010445,Rented or living rent free: Social rented,129,36,23,9,14,5,8,93,47,1,14,24,7
S01010445,Rented or living rent free: Private rented or living rent free,16,10,7,2,5,1,2,6,1,0,4,1,0
S01010446,All HRPs aged 16 and over,329,202,155,27,128,39,8,127,100,2,6,18,1
S01010446,Owned: Total,248,174,133,17,116,39,2,74,67,0,1,5,1
S01010446,Owned: Owned outright,100,46,36,8,28,8,2,54,51,0,0,3,0
S01010446,Owned: Owned with a mortgage or loan or shared ownership,148,128,97,9,88,31,0,20,16,0,1,2,1
S01010446,Rented or living rent free: Total,81,28,22,10,12,0,6,53,33,2,5,13,0
S01010446,Rented or living rent free: Social rented,66,20,14,6,8,0,6,46,29,2,2,13,0
S01010446,Rented or living rent free: Private rented or living rent free,15,8,8,4,4,0,0,7,4,0,3,0,0
S01010447,All HRPs aged 16 and over,521,246,191,39,152,19,36,275,135,17,15,88,20
S01010447,Owned: Total,177,114,98,10,88,13,3,63,55,0,0,7,1
S01010447,Owned: Owned outright,53,16,14,1,13,1,1,37,33,0,0,3,1
S01010447,Owned: Owned with a mortgage or loan or shared ownership,124,98,84,9,75,12,2,26,22,0,0,4,0
S01010447,Rented or living rent free: Total,344,132,93,29,64,6,33,212,80,17,15,81,19
S01010447,Rented or living rent free: Social rented,310,117,82,23,59,5,30,193,78,16,10,74,15
S01010447,Rented or living rent free: Private rented or living rent free,34,15,11,6,5,1,3,19,2,1,5,7,4
S01010448,All HRPs aged 16 and over,360,219,189,27,162,23,7,141,107,1,6,22,5
S01010448,Owned: Total,270,187,161,20,141,22,4,83,72,1,0,6,4
S01010448,Owned: Owned outright,96,33,29,11,18,3,1,63,58,1,0,2,2
S01010448,Owned: Owned with a mortgage or loan or shared ownership,174,154,132,9,123,19,3,20,14,0,0,4,2
S01010448,Rented or living rent free: Total,90,32,28,7,21,1,3,58,35,0,6,16,1
S01010448,Rented or living rent free: Social rented,69,20,17,3,14,0,3,49,31,0,2,15,1
S01010448,Rented or living rent free: Private rented or living rent free,21,12,11,4,7,1,0,9,4,0,4,1,0
S01010449,All HRPs aged 16 and over,370,176,156,30,126,9,11,194,133,2,14,32,13
S01010449,Owned: Total,229,115,108,17,91,7,0,114,95,1,2,12,4
S01010449,Owned: Owned outright,106,28,24,4,20,4,0,78,67,1,1,6,3
S01010449,Owned: Owned with a mortgage or loan or shared ownership,123,87,84,13,71,3,0,36,28,0,1,6,1
S01010449,Rented or living rent free: Total,141,61,48,13,35,2,11,80,38,1,12,20,9
S01010449,Rented or living rent free: Social rented,102,37,27,5,22,2,8,65,35,0,3,19,8
S01010449,Rented or living rent free: Private rented or living rent free,39,24,21,8,13,0,3,15,3,1,9,1,1
S01010450,All HRPs aged 16 and over,407,205,172,33,139,15,18,202,136,4,8,41,13
S01010450,Owned: Total,234,145,129,18,111,12,4,89,75,1,1,7,5
S01010450,Owned: Owned outright,88,29,25,8,17,2,2,59,53,0,0,4,2
S01010450,Owned: Owned with a mortgage or loan or shared ownership,146,116,104,10,94,10,2,30,22,1,1,3,3
S01010450,Rented or living rent free: Total,173,60,43,15,28,3,14,113,61,3,7,34,8
S01010450,Rented or living rent free: Social rented,138,45,33,12,21,0,12,93,55,1,5,25,7
S01010450,Rented or living rent free: Private rented or living rent free,35,15,10,3,7,3,2,20,6,2,2,9,1
S01010451,All HRPs aged 16 and over,438,250,167,44,123,21,62,188,93,2,8,66,19
S01010451,Owned: Total,139,90,71,12,59,17,2,49,44,0,0,3,2
S01010451,Owned: Owned outright,61,22,19,4,15,3,0,39,36,0,0,1,2
S01010451,Owned: Owned with a mortgage or loan or shared ownership,78,68,52,8,44,14,2,10,8,0,0,2,0
S01010451,Rented or living rent free: Total,299,160,96,32,64,4,60,139,49,2,8,63,17
S01010451,Rented or living rent free: Social rented,284,152,89,31,58,3,60,132,47,2,6,62,15
S01010451,Rented or living rent free: Private rented or living rent free,15,8,7,1,6,1,0,7,2,0,2,1,2
S01010452,All HRPs aged 16 and over,408,180,160,27,133,12,8,228,186,1,6,30,5
S01010452,Owned: Total,252,120,109,10,99,7,4,132,122,0,0,7,3
S01010452,Owned: Owned outright,127,25,22,4,18,1,2,102,95,0,0,5,2
S01010452,Owned: Owned with a mortgage or loan or shared ownership,125,95,87,6,81,6,2,30,27,0,0,2,1
S01010452,Rented or living rent free: Total,156,60,51,17,34,5,4,96,64,1,6,23,2
S01010452,Rented or living rent free: Social rented,109,30,26,7,19,2,2,79,54,1,5,19,0
S01010452,Rented or living rent free: Private rented or living rent free,47,30,25,10,15,3,2,17,10,0,1,4,2
S01010453,All HRPs aged 16 and over,372,224,142,46,96,22,60,148,40,18,21,57,12
S01010453,Owned: Total,88,53,45,9,36,7,1,35,24,3,0,7,1
S01010453,Owned: Owned outright,29,8,6,2,4,1,1,21,16,1,0,4,0
S01010453,Owned: Owned with a mortgage or loan or shared ownership,59,45,39,7,32,6,0,14,8,2,0,3,1
S01010453,Rented or living rent free: Total,284,171,97,37,60,15,59,113,16,15,21,50,11
S01010453,Rented or living rent free: Social rented,264,154,84,35,49,12,58,110,15,14,21,49,11
S01010453,Rented or living rent free: Private rented or living rent free,20,17,13,2,11,3,1,3,1,1,0,1,0
S01010454,All HRPs aged 16 and over,383,191,162,38,124,19,10,192,145,2,10,27,8
S01010454,Owned: Total,260,157,137,26,111,18,2,103,94,0,2,4,3
S01010454,Owned: Owned outright,106,30,26,6,20,4,0,76,73,0,0,1,2
S01010454,Owned: Owned with a mortgage or loan or shared ownership,154,127,111,20,91,14,2,27,21,0,2,3,1
S01010454,Rented or living rent free: Total,123,34,25,12,13,1,8,89,51,2,8,23,5
S01010454,Rented or living rent free: Social rented,93,19,14,4,10,1,4,74,46,1,4,21,2
S01010454,Rented or living rent free: Private rented or living rent free,30,15,11,8,3,0,4,15,5,1,4,2,3
S01010455,All HRPs aged 16 and over,604,259,202,62,140,21,36,345,217,5,13,93,17
S01010455,Owned: Total,135,78,66,14,52,11,1,57,48,1,0,8,0
S01010455,Owned: Owned outright,63,19,14,3,11,4,1,44,39,0,0,5,0
S01010455,Owned: Owned with a mortgage or loan or shared ownership,72,59,52,11,41,7,0,13,9,1,0,3,0
S01010455,Rented or living rent free: Total,469,181,136,48,88,10,35,288,169,4,13,85,17
S01010455,Rented or living rent free: Social rented,442,162,123,42,81,10,29,280,168,4,11,81,16
S01010455,Rented or living rent free: Private rented or living rent free,27,19,13,6,7,0,6,8,1,0,2,4,1
S01010456,All HRPs aged 16 and over,313,145,125,25,100,14,6,168,141,1,4,19,3
S01010456,Owned: Total,186,101,85,7,78,13,3,85,79,0,2,2,2
S01010456,Owned: Owned outright,87,18,13,2,11,2,3,69,64,0,2,2,1
S01010456,Owned: Owned with a mortgage or loan or shared ownership,99,83,72,5,67,11,0,16,15,0,0,0,1
S01010456,Rented or living rent free: Total,127,44,40,18,22,1,3,83,62,1,2,17,1
S01010456,Rented or living rent free: Social rented,98,30,26,11,15,1,3,68,53,0,1,13,1
S01010456,Rented or living rent free: Private rented or living rent free,29,14,14,7,7,0,0,15,9,1,1,4,0
S01010457,All HRPs aged 16 and over,340,179,130,29,101,20,29,161,105,4,6,32,14
S01010457,Owned: Total,159,87,76,8,68,10,1,72,64,1,1,4,2
S01010457,Owned: Owned outright,68,16,15,5,10,1,0,52,47,0,1,4,0
S01010457,Owned: Owned with a mortgage or loan or shared ownership,91,71,61,3,58,9,1,20,17,1,0,0,2
S01010457,Rented or living rent free: Total,181,92,54,21,33,10,28,89,41,3,5,28,12
S01010457,Rented or living rent free: Social rented,171,83,48,17,31,7,28,88,40,3,5,28,12
S01010457,Rented or living rent free: Private rented or living rent free,10,9,6,4,2,3,0,1,1,0,0,0,0
S01010458,All HRPs aged 16 and over,411,190,152,38,114,11,27,221,142,6,15,49,9
S01010458,Owned: Total,208,101,92,14,78,7,2,107,98,0,2,5,2
S01010458,Owned: Owned outright,105,22,21,7,14,1,0,83,78,0,0,4,1
S01010458,Owned: Owned with a mortgage or loan or shared ownership,103,79,71,7,64,6,2,24,20,0,2,1,1
S01010458,Rented or living rent free: Total,203,89,60,24,36,4,25,114,44,6,13,44,7
S01010458,Rented or living rent free: Social rented,185,76,51,20,31,3,22,109,43,5,12,43,6
S01010458,Rented or living rent free: Private rented or living rent free,18,13,9,4,5,1,3,5,1,1,1,1,1
S01010459,All HRPs aged 16 and over,258,106,86,14,72,15,5,152,111,6,9,23,3
S01010459,Owned: Total,181,82,68,8,60,14,0,99,80,2,1,14,2
S01010459,Owned: Owned outright,75,17,16,3,13,1,0,58,52,0,1,5,0
S01010459,Owned: Owned with a mortgage or loan or shared ownership,106,65,52,5,47,13,0,41,28,2,0,9,2
S01010459,Rented or living rent free: Total,77,24,18,6,12,1,5,53,31,4,8,9,1
S01010459,Rented or living rent free: Social rented,50,10,7,1,6,0,3,40,27,0,6,7,0
S01010459,Rented or living rent free: Private rented or living rent free,27,14,11,5,6,1,2,13,4,4,2,2,1
S01010460,All HRPs aged 16 and over,346,244,193,12,181,46,5,102,82,5,5,6,4
S01010460,Owned: Total,271,198,159,8,151,38,1,73,68,2,2,1,0
S01010460,Owned: Owned outright,98,43,33,3,30,9,1,55,51,2,1,1,0
S01010460,Owned: Owned with a mortgage or loan or shared ownership,173,155,126,5,121,29,0,18,17,0,1,0,0
S01010460,Rented or living rent free: Total,75,46,34,4,30,8,4,29,14,3,3,5,4
S01010460,Rented or living rent free: Social rented,20,6,3,1,2,2,1,14,7,0,1,4,2
S01010460,Rented or living rent free: Private rented or living rent free,55,40,31,3,28,6,3,15,7,3,2,1,2
S01010461,All HRPs aged 16 and over,386,173,126,25,101,15,32,213,133,9,14,42,15
S01010461,Owned: Total,184,90,76,12,64,11,3,94,84,1,2,5,2
S01010461,Owned: Owned outright,82,20,17,6,11,0,3,62,59,0,1,2,0
S01010461,Owned: Owned with a mortgage or loan or shared ownership,102,70,59,6,53,11,0,32,25,1,1,3,2
S01010461,Rented or living rent free: Total,202,83,50,13,37,4,29,119,49,8,12,37,13
S01010461,Rented or living rent free: Social rented,167,67,38,11,27,1,28,100,43,4,6,34,13
S01010461,Rented or living rent free: Private rented or living rent free,35,16,12,2,10,3,1,19,6,4,6,3,0
S01010462,All HRPs aged 16 and over,437,240,120,53,67,14,106,197,27,37,34,63,36
S01010462,Owned: Total,14,9,4,3,1,5,0,5,1,0,0,3,1
S01010462,Owned: Owned outright,4,2,0,0,0,2,0,2,1,0,0,1,0
S01010462,Owned: Owned with a mortgage or loan or shared ownership,10,7,4,3,1,3,0,3,0,0,0,2,1
S01010462,Rented or living rent free: Total,423,231,116,50,66,9,106,192,26,37,34,60,35
S01010462,Rented or living rent free: Social rented,413,226,114,49,65,9,103,187,26,37,30,60,34
S01010462,Rented or living rent free: Private rented or living rent free,10,5,2,1,1,0,3,5,0,0,4,0,1
S01010463,All HRPs aged 16 and over,376,215,174,22,152,27,14,161,133,1,5,15,7
S01010463,Owned: Total,267,164,138,15,123,23,3,103,96,0,2,2,3
S01010463,Owned: Owned outright,120,35,31,9,22,3,1,85,78,0,2,2,3
S01010463,Owned: Owned with a mortgage or loan or shared ownership,147,129,107,6,101,20,2,18,18,0,0,0,0
S01010463,Rented or living rent free: Total,109,51,36,7,29,4,11,58,37,1,3,13,4
S01010463,Rented or living rent free: Social rented,84,32,22,5,17,2,8,52,35,0,1,12,4
S01010463,Rented or living rent free: Private rented or living rent free,25,19,14,2,12,2,3,6,2,1,2,1,0
S01010464,All HRPs aged 16 and over,248,135,108,14,94,18,9,113,89,3,5,14,2
S01010464,Owned: Total,179,105,87,8,79,15,3,74,66,2,0,4,2
S01010464,Owned: Owned outright,71,12,9,0,9,3,0,59,53,2,0,3,1
S01010464,Owned: Owned with a mortgage or loan or shared ownership,108,93,78,8,70,12,3,15,13,0,0,1,1
S01010464,Rented or living rent free: Total,69,30,21,6,15,3,6,39,23,1,5,10,0
S01010464,Rented or living rent free: Social rented,57,21,14,5,9,3,4,36,22,0,5,9,0
S01010464,Rented or living rent free: Private rented or living rent free,12,9,7,1,6,0,2,3,1,1,0,1,0
S01010465,All HRPs aged 16 and over,451,353,322,48,274,18,13,98,72,3,3,15,5
S01010465,Owned: Total,368,297,271,33,238,17,9,71,62,0,0,6,3
S01010465,Owned: Owned outright,104,56,50,10,40,3,3,48,44,0,0,2,2
S01010465,Owned: Owned with a mortgage or loan or shared ownership,264,241,221,23,198,14,6,23,18,0,0,4,1
S01010465,Rented or living rent free: Total,83,56,51,15,36,1,4,27,10,3,3,9,2
S01010465,Rented or living rent free: Social rented,23,8,8,3,5,0,0,15,6,0,1,6,2
S01010465,Rented or living rent free: Private rented or living rent free,60,48,43,12,31,1,4,12,4,3,2,3,0
S01010466,All HRPs aged 16 and over,458,348,296,31,265,38,14,110,53,36,5,11,5
S01010466,Owned: Total,321,257,218,15,203,31,8,64,51,2,2,4,5
S01010466,Owned: Owned outright,100,48,38,8,30,8,2,52,44,2,2,2,2
S01010466,Owned: Owned with a mortgage or loan or shared ownership,221,209,180,7,173,23,6,12,7,0,0,2,3
S01010466,Rented or living rent free: Total,137,91,78,16,62,7,6,46,2,34,3,7,0
S01010466,Rented or living rent free: Social rented,7,4,3,2,1,0,1,3,0,0,3,0,0
S01010466,Rented or living rent free: Private rented or living rent free,130,87,75,14,61,7,5,43,2,34,0,7,0
S01010467,All HRPs aged 16 and over,476,239,200,31,169,36,3,237,209,9,3,7,9
S01010467,Owned: Total,366,168,141,19,122,26,1,198,189,1,1,2,5
S01010467,Owned: Owned outright,228,49,41,10,31,7,1,179,172,1,1,2,3
S01010467,Owned: Owned with a mortgage or loan or shared ownership,138,119,100,9,91,19,0,19,17,0,0,0,2
S01010467,Rented or living rent free: Total,110,71,59,12,47,10,2,39,20,8,2,5,4
S01010467,Rented or living rent free: Social rented,10,3,3,1,2,0,0,7,5,0,0,2,0
S01010467,Rented or living rent free: Private rented or living rent free,100,68,56,11,45,10,2,32,15,8,2,3,4
S01010468,All HRPs aged 16 and over,417,288,240,42,198,44,4,129,103,9,6,6,5
S01010468,Owned: Total,317,209,173,22,151,34,2,108,100,1,2,2,3
S01010468,Owned: Owned outright,149,52,43,9,34,7,2,97,92,1,1,1,2
S01010468,Owned: Owned with a mortgage or loan or shared ownership,168,157,130,13,117,27,0,11,8,0,1,1,1
S01010468,Rented or living rent free: Total,100,79,67,20,47,10,2,21,3,8,4,4,2
S01010468,Rented or living rent free: Social rented,3,3,2,0,2,1,0,0,0,0,0,0,0
S01010468,Rented or living rent free: Private rented or living rent free,97,76,65,20,45,9,2,21,3,8,4,4,2
S01010469,All HRPs aged 16 and over,405,244,200,22,178,14,30,161,91,19,3,41,7
S01010469,Owned: Total,167,132,114,7,107,9,9,35,28,1,0,3,3
S01010469,Owned: Owned outright,57,28,20,5,15,4,4,29,25,0,0,2,2
S01010469,Owned: Owned with a mortgage or loan or shared ownership,110,104,94,2,92,5,5,6,3,1,0,1,1
S01010469,Rented or living rent free: Total,238,112,86,15,71,5,21,126,63,18,3,38,4
S01010469,Rented or living rent free: Social rented,119,32,20,6,14,1,11,87,55,2,3,25,2
S01010469,Rented or living rent free: Private rented or living rent free,119,80,66,9,57,4,10,39,8,16,0,13,2
S01010470,All HRPs aged 16 and over,364,212,172,30,142,27,13,152,127,2,2,13,8
S01010470,Owned: Total,235,150,123,13,110,23,4,85,81,0,0,1,3
S01010470,Owned: Owned outright,91,33,28,8,20,3,2,58,56,0,0,0,2
S01010470,Owned: Owned with a mortgage or loan or shared ownership,144,117,95,5,90,20,2,27,25,0,0,1,1
S01010470,Rented or living rent free: Total,129,62,49,17,32,4,9,67,46,2,2,12,5
S01010470,Rented or living rent free: Social rented,95,39,31,11,20,2,6,56,42,1,1,10,2
S01010470,Rented or living rent free: Private rented or living rent free,34,23,18,6,12,2,3,11,4,1,1,2,3
S01010471,All HRPs aged 16 and over,316,162,136,40,96,12,14,154,101,2,10,38,3
S01010471,Owned: Total,173,108,99,27,72,7,2,65,61,0,0,4,0
S01010471,Owned: Owned outright,71,26,24,13,11,2,0,45,42,0,0,3,0
S01010471,Owned: Owned with a mortgage or loan or shared ownership,102,82,75,14,61,5,2,20,19,0,0,1,0
S01010471,Rented or living rent free: Total,143,54,37,13,24,5,12,89,40,2,10,34,3
S01010471,Rented or living rent free: Social rented,106,33,23,10,13,2,8,73,35,0,6,31,1
S01010471,Rented or living rent free: Private rented or living rent free,37,21,14,3,11,3,4,16,5,2,4,3,2
S01010472,All HRPs aged 16 and over,290,221,192,18,174,16,13,69,34,16,3,13,3
S01010472,Owned: Total,174,146,132,8,124,9,5,28,22,4,0,2,0
S01010472,Owned: Owned outright,32,17,14,2,12,2,1,15,14,0,0,1,0
S01010472,Owned: Owned with a mortgage or loan or shared ownership,142,129,118,6,112,7,4,13,8,4,0,1,0
S01010472,Rented or living rent free: Total,116,75,60,10,50,7,8,41,12,12,3,11,3
S01010472,Rented or living rent free: Social rented,41,22,15,5,10,3,4,19,6,0,1,10,2
S01010472,Rented or living rent free: Private rented or living rent free,75,53,45,5,40,4,4,22,6,12,2,1,1
S01010473,All HRPs aged 16 and over,435,315,276,47,229,19,20,120,84,15,3,14,4
S01010473,Owned: Total,286,216,196,27,169,14,6,70,61,2,0,5,2
S01010473,Owned: Owned outright,95,43,39,9,30,3,1,52,48,0,0,4,0
S01010473,Owned: Owned with a mortgage or loan or shared ownership,191,173,157,18,139,11,5,18,13,2,0,1,2
S01010473,Rented or living rent free: Total,149,99,80,20,60,5,14,50,23,13,3,9,2
S01010473,Rented or living rent free: Social rented,39,18,12,6,6,2,4,21,12,2,0,6,1
S01010473,Rented or living rent free: Private rented or living rent free,110,81,68,14,54,3,10,29,11,11,3,3,1
S01010474,All HRPs aged 16 and over,431,309,252,48,204,32,25,122,74,21,10,10,7
S01010474,Owned: Total,212,160,140,14,126,17,3,52,43,2,0,4,3
S01010474,Owned: Owned outright,62,27,23,4,19,3,1,35,31,2,0,0,2
S01010474,Owned: Owned with a mortgage or loan or shared ownership,150,133,117,10,107,14,2,17,12,0,0,4,1
S01010474,Rented or living rent free: Total,219,149,112,34,78,15,22,70,31,19,10,6,4
S01010474,Rented or living rent free: Social rented,83,43,27,13,14,5,11,40,25,1,5,5,4
S01010474,Rented or living rent free: Private rented or living rent free,136,106,85,21,64,10,11,30,6,18,5,1,0
S01010475,All HRPs aged 16 and over,384,300,273,24,249,23,4,84,55,16,4,5,4
S01010475,Owned: Total,296,235,217,18,199,16,2,61,52,4,2,2,1
S01010475,Owned: Owned outright,85,40,36,6,30,3,1,45,41,2,1,0,1
S01010475,Owned: Owned with a mortgage or loan or shared ownership,211,195,181,12,169,13,1,16,11,2,1,2,0
S01010475,Rented or living rent free: Total,88,65,56,6,50,7,2,23,3,12,2,3,3
S01010475,Rented or living rent free: Social rented,7,5,5,0,5,0,0,2,0,0,0,1,1
S01010475,Rented or living rent free: Private rented or living rent free,81,60,51,6,45,7,2,21,3,12,2,2,2
S01010476,All HRPs aged 16 and over,523,270,231,33,198,30,9,253,200,17,10,19,7
S01010476,Owned: Total,347,197,171,19,152,24,2,150,136,6,0,5,3
S01010476,Owned: Owned outright,142,42,32,11,21,9,1,100,92,1,0,4,3
S01010476,Owned: Owned with a mortgage or loan or shared ownership,205,155,139,8,131,15,1,50,44,5,0,1,0
S01010476,Rented or living rent free: Total,176,73,60,14,46,6,7,103,64,11,10,14,4
S01010476,Rented or living rent free: Social rented,106,28,19,4,15,3,6,78,59,1,5,11,2
S01010476,Rented or living rent free: Private rented or living rent free,70,45,41,10,31,3,1,25,5,10,5,3,2
S01010477,All HRPs aged 16 and over,354,197,172,27,145,14,11,157,124,1,3,23,6
S01010477,Owned: Total,245,149,131,18,113,13,5,96,88,0,0,7,1
S01010477,Owned: Owned outright,109,37,34,5,29,2,1,72,67,0,0,4,1
S01010477,Owned: Owned with a mortgage or loan or shared ownership,136,112,97,13,84,11,4,24,21,0,0,3,0
S01010477,Rented or living rent free: Total,109,48,41,9,32,1,6,61,36,1,3,16,5
S01010477,Rented or living rent free: Social rented,74,23,17,3,14,1,5,51,33,1,0,13,4
S01010477,Rented or living rent free: Private rented or living rent free,35,25,24,6,18,0,1,10,3,0,3,3,1
S01010478,All HRPs aged 16 and over,628,340,260,53,207,30,50,288,155,6,17,88,22
S01010478,Owned: Total,236,154,131,18,113,19,4,82,68,0,6,5,3
S01010478,Owned: Owned outright,79,31,28,7,21,2,1,48,41,0,2,3,2
S01010478,Owned: Owned with a mortgage or loan or shared ownership,157,123,103,11,92,17,3,34,27,0,4,2,1
S01010478,Rented or living rent free: Total,392,186,129,35,94,11,46,206,87,6,11,83,19
S01010478,Rented or living rent free: Social rented,334,141,97,28,69,6,38,193,84,5,10,77,17
S01010478,Rented or living rent free: Private rented or living rent free,58,45,32,7,25,5,8,13,3,1,1,6,2
S01010479,All HRPs aged 16 and over,512,284,245,50,195,20,19,228,162,8,12,30,16
S01010479,Owned: Total,282,185,161,24,137,15,9,97,90,1,2,3,1
S01010479,Owned: Owned outright,101,27,21,3,18,3,3,74,70,1,1,2,0
S01010479,Owned: Owned with a mortgage or loan or shared ownership,181,158,140,21,119,12,6,23,20,0,1,1,1
S01010479,Rented or living rent free: Total,230,99,84,26,58,5,10,131,72,7,10,27,15
S01010479,Rented or living rent free: Social rented,188,72,61,19,42,4,7,116,70,3,7,24,12
S01010479,Rented or living rent free: Private rented or living rent free,42,27,23,7,16,1,3,15,2,4,3,3,3
S01010480,All HRPs aged 16 and over,285,140,117,22,95,15,8,145,113,1,10,21,0
S01010480,Owned: Total,204,109,95,14,81,11,3,95,86,1,0,8,0
S01010480,Owned: Owned outright,83,13,13,3,10,0,0,70,67,0,0,3,0
S01010480,Owned: Owned with a mortgage or loan or shared ownership,121,96,82,11,71,11,3,25,19,1,0,5,0
S01010480,Rented or living rent free: Total,81,31,22,8,14,4,5,50,27,0,10,13,0
S01010480,Rented or living rent free: Social rented,65,20,13,6,7,2,5,45,25,0,8,12,0
S01010480,Rented or living rent free: Private rented or living rent free,16,11,9,2,7,2,0,5,2,0,2,1,0
S01010481,All HRPs aged 16 and over,267,146,103,29,74,16,27,121,51,5,22,30,13
S01010481,Owned: Total,82,59,44,9,35,10,5,23,16,2,1,3,1
S01010481,Owned: Owned outright,30,15,9,1,8,4,2,15,11,0,0,3,1
S01010481,Owned: Owned with a mortgage or loan or shared ownership,52,44,35,8,27,6,3,8,5,2,1,0,0
S01010481,Rented or living rent free: Total,185,87,59,20,39,6,22,98,35,3,21,27,12
S01010481,Rented or living rent free: Social rented,162,76,50,19,31,6,20,86,32,1,19,25,9
S01010481,Rented or living rent free: Private rented or living rent free,23,11,9,1,8,0,2,12,3,2,2,2,3
S01010482,All HRPs aged 16 and over,354,183,159,28,131,16,8,171,136,2,6,23,4
S01010482,Owned: Total,237,141,126,19,107,13,2,96,85,2,0,8,1
S01010482,Owned: Owned outright,87,27,23,6,17,3,1,60,54,0,0,5,1
S01010482,Owned: Owned with a mortgage or loan or shared ownership,150,114,103,13,90,10,1,36,31,2,0,3,0
S01010482,Rented or living rent free: Total,117,42,33,9,24,3,6,75,51,0,6,15,3
S01010482,Rented or living rent free: Social rented,97,32,26,8,18,0,6,65,48,0,4,10,3
S01010482,Rented or living rent free: Private rented or living rent free,20,10,7,1,6,3,0,10,3,0,2,5,0
S01010483,All HRPs aged 16 and over,526,280,234,40,194,36,10,246,163,5,10,51,17
S01010483,Owned: Total,323,212,179,25,154,29,4,111,94,2,0,8,7
S01010483,Owned: Owned outright,114,39,32,8,24,7,0,75,64,1,0,5,5
S01010483,Owned: Owned with a mortgage or loan or shared ownership,209,173,147,17,130,22,4,36,30,1,0,3,2
S01010483,Rented or living rent free: Total,203,68,55,15,40,7,6,135,69,3,10,43,10
S01010483,Rented or living rent free: Social rented,163,46,39,14,25,5,2,117,64,2,8,35,8
S01010483,Rented or living rent free: Private rented or living rent free,40,22,16,1,15,2,4,18,5,1,2,8,2
S01010484,All HRPs aged 16 and over,246,140,120,30,90,14,6,106,63,4,8,24,7
S01010484,Owned: Total,132,91,79,14,65,12,0,41,35,1,0,5,0
S01010484,Owned: Owned outright,45,26,23,9,14,3,0,19,18,0,0,1,0
S01010484,Owned: Owned with a mortgage or loan or shared ownership,87,65,56,5,51,9,0,22,17,1,0,4,0
S01010484,Rented or living rent free: Total,114,49,41,16,25,2,6,65,28,3,8,19,7
S01010484,Rented or living rent free: Social rented,95,42,34,15,19,2,6,53,25,0,3,19,6
S01010484,Rented or living rent free: Private rented or living rent free,19,7,7,1,6,0,0,12,3,3,5,0,1
S01010485,All HRPs aged 16 and over,396,232,193,22,171,26,13,164,131,3,11,17,2
S01010485,Owned: Total,289,189,165,14,151,22,2,100,92,3,2,2,1
S01010485,Owned: Owned outright,119,43,37,5,32,6,0,76,73,0,0,2,1
S01010485,Owned: Owned with a mortgage or loan or shared ownership,170,146,128,9,119,16,2,24,19,3,2,0,0
S01010485,Rented or living rent free: Total,107,43,28,8,20,4,11,64,39,0,9,15,1
S01010485,Rented or living rent free: Social rented,88,26,17,4,13,0,9,62,37,0,9,15,1
S01010485,Rented or living rent free: Private rented or living rent free,19,17,11,4,7,4,2,2,2,0,0,0,0
S01010486,All HRPs aged 16 and over,371,240,190,26,164,45,5,131,113,1,4,9,4
S01010486,Owned: Total,348,231,185,22,163,43,3,117,106,0,2,5,4
S01010486,Owned: Owned outright,158,55,43,7,36,11,1,103,96,0,1,4,2
S01010486,Owned: Owned with a mortgage or loan or shared ownership,190,176,142,15,127,32,2,14,10,0,1,1,2
S01010486,Rented or living rent free: Total,23,9,5,4,1,2,2,14,7,1,2,4,0
S01010486,Rented or living rent free: Social rented,11,2,2,1,1,0,0,9,4,0,2,3,0
S01010486,Rented or living rent free: Private rented or living rent free,12,7,3,3,0,2,2,5,3,1,0,1,0
S01010487,All HRPs aged 16 and over,432,225,194,29,165,21,10,207,173,2,7,21,4
S01010487,Owned: Total,311,182,160,18,142,19,3,129,117,1,1,9,1
S01010487,Owned: Owned outright,122,31,30,11,19,1,0,91,84,0,0,7,0
S01010487,Owned: Owned with a mortgage or loan or shared ownership,189,151,130,7,123,18,3,38,33,1,1,2,1
S01010487,Rented or living rent free: Total,121,43,34,11,23,2,7,78,56,1,6,12,3
S01010487,Rented or living rent free: Social rented,92,31,24,6,18,2,5,61,49,0,3,7,2
S01010487,Rented or living rent free: Private rented or living rent free,29,12,10,5,5,0,2,17,7,1,3,5,1
S01010488,All HRPs aged 16 and over,338,200,154,43,111,13,33,138,42,2,25,55,14
S01010488,Owned: Total,92,74,64,14,50,7,3,18,10,0,0,6,2
S01010488,Owned: Owned outright,30,18,13,4,9,3,2,12,9,0,0,2,1
S01010488,Owned: Owned with a mortgage or loan or shared ownership,62,56,51,10,41,4,1,6,1,0,0,4,1
S01010488,Rented or living rent free: Total,246,126,90,29,61,6,30,120,32,2,25,49,12
S01010488,Rented or living rent free: Social rented,216,106,74,25,49,4,28,110,29,0,23,49,9
S01010488,Rented or living rent free: Private rented or living rent free,30,20,16,4,12,2,2,10,3,2,2,0,3
S01010489,All HRPs aged 16 and over,450,266,211,51,160,18,37,184,116,9,10,38,11
S01010489,Owned: Total,197,132,114,12,102,14,4,65,55,4,0,6,0
S01010489,Owned: Owned outright,69,25,19,3,16,6,0,44,40,0,0,4,0
S01010489,Owned: Owned with a mortgage or loan or shared ownership,128,107,95,9,86,8,4,21,15,4,0,2,0
S01010489,Rented or living rent free: Total,253,134,97,39,58,4,33,119,61,5,10,32,11
S01010489,Rented or living rent free: Social rented,240,124,92,39,53,1,31,116,60,5,10,31,10
S01010489,Rented or living rent free: Private rented or living rent free,13,10,5,0,5,3,2,3,1,0,0,1,1
S01010490,All HRPs aged 16 and over,308,165,125,39,86,10,30,143,46,7,31,42,17
S01010490,Owned: Total,68,45,41,7,34,3,1,23,20,1,1,0,1
S01010490,Owned: Owned outright,18,4,2,0,2,1,1,14,11,1,1,0,1
S01010490,Owned: Owned with a mortgage or loan or shared ownership,50,41,39,7,32,2,0,9,9,0,0,0,0
S01010490,Rented or living rent free: Total,240,120,84,32,52,7,29,120,26,6,30,42,16
S01010490,Rented or living rent free: Social rented,223,109,73,27,46,7,29,114,26,6,24,42,16
S01010490,Rented or living rent free: Private rented or living rent free,17,11,11,5,6,0,0,6,0,0,6,0,0
S01010491,All HRPs aged 16 and over,417,234,164,56,108,13,57,183,70,2,35,61,15
S01010491,Owned: Total,46,33,29,9,20,2,2,13,12,0,0,1,0
S01010491,Owned: Owned outright,17,8,6,3,3,1,1,9,9,0,0,0,0
S01010491,Owned: Owned with a mortgage or loan or shared ownership,29,25,23,6,17,1,1,4,3,0,0,1,0
S01010491,Rented or living rent free: Total,371,201,135,47,88,11,55,170,58,2,35,60,15
S01010491,Rented or living rent free: Social rented,360,195,130,47,83,11,54,165,58,1,31,60,15
S01010491,Rented or living rent free: Private rented or living rent free,11,6,5,0,5,0,1,5,0,1,4,0,0
S01010492,All HRPs aged 16 and over,255,105,87,38,49,2,16,150,69,4,21,48,8
S01010492,Owned: Total,11,8,7,1,6,1,0,3,3,0,0,0,0
S01010492,Owned: Owned outright,3,1,1,1,0,0,0,2,2,0,0,0,0
S01010492,Owned: Owned with a mortgage or loan or shared ownership,8,7,6,0,6,1,0,1,1,0,0,0,0
S01010492,Rented or living rent free: Total,244,97,80,37,43,1,16,147,66,4,21,48,8
S01010492,Rented or living rent free: Social rented,234,95,79,37,42,1,15,139,62,4,20,45,8
S01010492,Rented or living rent free: Private rented or living rent free,10,2,1,0,1,0,1,8,4,0,1,3,0
S01010493,All HRPs aged 16 and over,308,186,128,53,75,7,51,122,30,5,25,52,10
S01010493,Owned: Total,11,8,5,2,3,1,2,3,3,0,0,0,0
S01010493,Owned: Owned outright,3,1,0,0,0,0,1,2,2,0,0,0,0
S01010493,Owned: Owned with a mortgage or loan or shared ownership,8,7,5,2,3,1,1,1,1,0,0,0,0
S01010493,Rented or living rent free: Total,297,178,123,51,72,6,49,119,27,5,25,52,10
S01010493,Rented or living rent free: Social rented,293,174,120,50,70,6,48,119,27,5,25,52,10
S01010493,Rented or living rent free: Private rented or living rent free,4,4,3,1,2,0,1,0,0,0,0,0,0
S01010494,All HRPs aged 16 and over,252,169,135,33,102,15,19,83,23,3,14,34,9
S01010494,Owned: Total,122,109,94,16,78,13,2,13,4,1,1,6,1
S01010494,Owned: Owned outright,22,14,12,6,6,0,2,8,3,0,0,4,1
S01010494,Owned: Owned with a mortgage or loan or shared ownership,100,95,82,10,72,13,0,5,1,1,1,2,0
S01010494,Rented or living rent free: Total,130,60,41,17,24,2,17,70,19,2,13,28,8
S01010494,Rented or living rent free: Social rented,119,53,36,15,21,1,16,66,19,2,11,27,7
S01010494,Rented or living rent free: Private rented or living rent free,11,7,5,2,3,1,1,4,0,0,2,1,1
S01010495,All HRPs aged 16 and over,418,229,176,65,111,9,44,189,60,5,24,86,14
S01010495,Owned: Total,52,41,36,6,30,3,2,11,8,1,1,1,0
S01010495,Owned: Owned outright,14,6,6,2,4,0,0,8,7,1,0,0,0
S01010495,Owned: Owned with a mortgage or loan or shared ownership,38,35,30,4,26,3,2,3,1,0,1,1,0
S01010495,Rented or living rent free: Total,366,188,140,59,81,6,42,178,52,4,23,85,14
S01010495,Rented or living rent free: Social rented,353,181,135,58,77,5,41,172,50,4,23,81,14
S01010495,Rented or living rent free: Private rented or living rent free,13,7,5,1,4,1,1,6,2,0,0,4,0
S01010496,All HRPs aged 16 and over,388,201,153,48,105,9,39,187,75,4,27,66,15
S01010496,Owned: Total,54,39,37,6,31,1,1,15,12,0,0,2,1
S01010496,Owned: Owned outright,17,7,7,3,4,0,0,10,9,0,0,1,0
S01010496,Owned: Owned with a mortgage or loan or shared ownership,37,32,30,3,27,1,1,5,3,0,0,1,1
S01010496,Rented or living rent free: Total,334,162,116,42,74,8,38,172,63,4,27,64,14
S01010496,Rented or living rent free: Social rented,319,153,109,39,70,8,36,166,62,4,26,60,14
S01010496,Rented or living rent free: Private rented or living rent free,15,9,7,3,4,0,2,6,1,0,1,4,0
S01010497,All HRPs aged 16 and over,285,186,135,41,94,19,32,99,26,1,13,48,11
S01010497,Owned: Total,86,77,60,5,55,15,2,9,3,0,1,3,2
S01010497,Owned: Owned outright,8,4,4,1,3,0,0,4,2,0,0,2,0
S01010497,Owned: Owned with a mortgage or loan or shared ownership,78,73,56,4,52,15,2,5,1,0,1,1,2
S01010497,Rented or living rent free: Total,199,109,75,36,39,4,30,90,23,1,12,45,9
S01010497,Rented or living rent free: Social rented,193,105,72,33,39,4,29,88,23,1,12,43,9
S01010497,Rented or living rent free: Private rented or living rent free,6,4,3,3,0,0,1,2,0,0,0,2,0
S01010498,All HRPs aged 16 and over,357,192,159,51,108,6,27,165,65,4,23,59,14
S01010498,Owned: Total,43,34,30,4,26,4,0,9,9,0,0,0,0
S01010498,Owned: Owned outright,11,5,4,0,4,1,0,6,6,0,0,0,0
S01010498,Owned: Owned with a mortgage or loan or shared ownership,32,29,26,4,22,3,0,3,3,0,0,0,0
S01010498,Rented or living rent free: Total,314,158,129,47,82,2,27,156,56,4,23,59,14
S01010498,Rented or living rent free: Social rented,303,151,123,42,81,1,27,152,55,3,23,58,13
S01010498,Rented or living rent free: Private rented or living rent free,11,7,6,5,1,1,0,4,1,1,0,1,1
S01010499,All HRPs aged 16 and over,451,192,110,35,75,7,75,259,115,9,22,81,32
S01010499,Owned: Total,28,14,9,2,7,3,2,14,11,0,0,2,1
S01010499,Owned: Owned outright,15,3,1,0,1,1,1,12,9,0,0,2,1
S01010499,Owned: Owned with a mortgage or loan or shared ownership,13,11,8,2,6,2,1,2,2,0,0,0,0
S01010499,Rented or living rent free: Total,423,178,101,33,68,4,73,245,104,9,22,79,31
S01010499,Rented or living rent free: Social rented,410,171,94,33,61,4,73,239,99,9,21,79,31
S01010499,Rented or living rent free: Private rented or living rent free,13,7,7,0,7,0,0,6,5,0,1,0,0
S01010500,All HRPs aged 16 and over,398,226,180,63,117,12,34,172,48,8,27,74,15
S01010500,Owned: Total,76,58,46,3,43,11,1,18,11,1,1,5,0
S01010500,Owned: Owned outright,12,1,1,0,1,0,0,11,9,0,0,2,0
S01010500,Owned: Owned with a mortgage or loan or shared ownership,64,57,45,3,42,11,1,7,2,1,1,3,0
S01010500,Rented or living rent free: Total,322,168,134,60,74,1,33,154,37,7,26,69,15
S01010500,Rented or living rent free: Social rented,310,161,127,57,70,1,33,149,37,5,25,69,13
S01010500,Rented or living rent free: Private rented or living rent free,12,7,7,3,4,0,0,5,0,2,1,0,2
S01010501,All HRPs aged 16 and over,430,247,204,45,159,17,26,183,102,2,9,56,14
S01010501,Owned: Total,155,123,113,14,99,7,3,32,25,0,0,4,3
S01010501,Owned: Owned outright,31,16,13,2,11,2,1,15,14,0,0,1,0
S01010501,Owned: Owned with a mortgage or loan or shared ownership,124,107,100,12,88,5,2,17,11,0,0,3,3
S01010501,Rented or living rent free: Total,275,124,91,31,60,10,23,151,77,2,9,52,11
S01010501,Rented or living rent free: Social rented,258,118,88,31,57,10,20,140,73,1,8,49,9
S01010501,Rented or living rent free: Private rented or living rent free,17,6,3,0,3,0,3,11,4,1,1,3,2
S01010502,All HRPs aged 16 and over,331,238,202,49,153,22,14,93,39,3,14,31,6
S01010502,Owned: Total,148,136,116,20,96,15,5,12,9,0,1,1,1
S01010502,Owned: Owned outright,15,9,9,2,7,0,0,6,5,0,0,1,0
S01010502,Owned: Owned with a mortgage or loan or shared ownership,133,127,107,18,89,15,5,6,4,0,1,0,1
S01010502,Rented or living rent free: Total,183,102,86,29,57,7,9,81,30,3,13,30,5
S01010502,Rented or living rent free: Social rented,168,94,80,26,54,6,8,74,29,2,11,29,3
S01010502,Rented or living rent free: Private rented or living rent free,15,8,6,3,3,1,1,7,1,1,2,1,2
S01010503,All HRPs aged 16 and over,321,158,135,36,99,8,15,163,98,4,12,37,12
S01010503,Owned: Total,78,45,42,3,39,3,0,33,26,0,0,6,1
S01010503,Owned: Owned outright,31,10,8,0,8,2,0,21,19,0,0,1,1
S01010503,Owned: Owned with a mortgage or loan or shared ownership,47,35,34,3,31,1,0,12,7,0,0,5,0
S01010503,Rented or living rent free: Total,243,113,93,33,60,5,15,130,72,4,12,31,11
S01010503,Rented or living rent free: Social rented,227,104,89,33,56,5,10,123,71,1,10,30,11
S01010503,Rented or living rent free: Private rented or living rent free,16,9,4,0,4,0,5,7,1,3,2,1,0
S01010504,All HRPs aged 16 and over,247,162,75,27,48,85,2,85,78,0,1,6,0
S01010504,Owned: Total,163,93,38,14,24,55,0,70,69,0,0,1,0
S01010504,Owned: Owned outright,122,61,23,9,14,38,0,61,60,0,0,1,0
S01010504,Owned: Owned with a mortgage or loan or shared ownership,41,32,15,5,10,17,0,9,9,0,0,0,0
S01010504,Rented or living rent free: Total,84,69,37,13,24,30,2,15,9,0,1,5,0
S01010504,Rented or living rent free: Social rented,26,19,13,5,8,4,2,7,5,0,0,2,0
S01010504,Rented or living rent free: Private rented or living rent free,58,50,24,8,16,26,0,8,4,0,1,3,0
S01010505,All HRPs aged 16 and over,244,163,89,21,68,65,9,81,67,1,2,5,6
S01010505,Owned: Total,159,101,54,12,42,46,1,58,54,0,0,2,2
S01010505,Owned: Owned outright,110,59,29,8,21,29,1,51,47,0,0,2,2
S01010505,Owned: Owned with a mortgage or loan or shared ownership,49,42,25,4,21,17,0,7,7,0,0,0,0
S01010505,Rented or living rent free: Total,85,62,35,9,26,19,8,23,13,1,2,3,4
S01010505,Rented or living rent free: Social rented,34,24,10,3,7,7,7,10,6,1,1,2,0
S01010505,Rented or living rent free: Private rented or living rent free,51,38,25,6,19,12,1,13,7,0,1,1,4
S01010506,All HRPs aged 16 and over,380,266,164,34,130,95,7,114,95,2,2,10,5
S01010506,Owned: Total,266,184,107,20,87,76,1,82,73,1,0,5,3
S01010506,Owned: Owned outright,164,91,50,15,35,40,1,73,67,0,0,3,3
S01010506,Owned: Owned with a mortgage or loan or shared ownership,102,93,57,5,52,36,0,9,6,1,0,2,0
S01010506,Rented or living rent free: Total,114,82,57,14,43,19,6,32,22,1,2,5,2
S01010506,Rented or living rent free: Social rented,65,42,32,10,22,4,6,23,16,0,2,4,1
S01010506,Rented or living rent free: Private rented or living rent free,49,40,25,4,21,15,0,9,6,1,0,1,1
S01010507,All HRPs aged 16 and over,345,255,178,26,152,62,15,90,76,0,5,5,4
S01010507,Owned: Total,211,151,104,9,95,44,3,60,56,0,0,2,2
S01010507,Owned: Owned outright,114,63,35,4,31,26,2,51,49,0,0,1,1
S01010507,Owned: Owned with a mortgage or loan or shared ownership,97,88,69,5,64,18,1,9,7,0,0,1,1
S01010507,Rented or living rent free: Total,134,104,74,17,57,18,12,30,20,0,5,3,2
S01010507,Rented or living rent free: Social rented,80,58,44,11,33,9,5,22,15,0,3,2,2
S01010507,Rented or living rent free: Private rented or living rent free,54,46,30,6,24,9,7,8,5,0,2,1,0
S01010508,All HRPs aged 16 and over,449,302,219,46,173,74,9,147,128,0,0,12,7
S01010508,Owned: Total,280,179,120,22,98,55,4,101,93,0,0,4,4
S01010508,Owned: Owned outright,187,94,53,15,38,38,3,93,86,0,0,3,4
S01010508,Owned: Owned with a mortgage or loan or shared ownership,93,85,67,7,60,17,1,8,7,0,0,1,0
S01010508,Rented or living rent free: Total,169,123,99,24,75,19,5,46,35,0,0,8,3
S01010508,Rented or living rent free: Social rented,84,49,38,13,25,6,5,35,28,0,0,7,0
S01010508,Rented or living rent free: Private rented or living rent free,85,74,61,11,50,13,0,11,7,0,0,1,3
S01010509,All HRPs aged 16 and over,393,294,212,32,180,77,5,99,87,0,3,8,1
S01010509,Owned: Total,275,207,145,26,119,61,1,68,63,0,2,2,1
S01010509,Owned: Owned outright,161,97,63,17,46,33,1,64,60,0,2,2,0
S01010509,Owned: Owned with a mortgage or loan or shared ownership,114,110,82,9,73,28,0,4,3,0,0,0,1
S01010509,Rented or living rent free: Total,118,87,67,6,61,16,4,31,24,0,1,6,0
S01010509,Rented or living rent free: Social rented,32,18,13,4,9,5,0,14,9,0,0,5,0
S01010509,Rented or living rent free: Private rented or living rent free,86,69,54,2,52,11,4,17,15,0,1,1,0
S01010510,All HRPs aged 16 and over,340,204,167,40,127,31,6,136,129,0,0,6,1
S01010510,Owned: Total,251,170,137,30,107,29,4,81,80,0,0,0,1
S01010510,Owned: Owned outright,131,59,50,21,29,8,1,72,71,0,0,0,1
S01010510,Owned: Owned with a mortgage or loan or shared ownership,120,111,87,9,78,21,3,9,9,0,0,0,0
S01010510,Rented or living rent free: Total,89,34,30,10,20,2,2,55,49,0,0,6,0
S01010510,Rented or living rent free: Social rented,67,21,20,8,12,0,1,46,40,0,0,6,0
S01010510,Rented or living rent free: Private rented or living rent free,22,13,10,2,8,2,1,9,9,0,0,0,0
S01010511,All HRPs aged 16 and over,369,246,217,36,181,21,8,123,88,1,11,22,1
S01010511,Owned: Total,171,131,116,12,104,12,3,40,35,0,1,4,0
S01010511,Owned: Owned outright,57,28,24,4,20,4,0,29,27,0,0,2,0
S01010511,Owned: Owned with a mortgage or loan or shared ownership,114,103,92,8,84,8,3,11,8,0,1,2,0
S01010511,Rented or living rent free: Total,198,115,101,24,77,9,5,83,53,1,10,18,1
S01010511,Rented or living rent free: Social rented,181,100,90,23,67,5,5,81,52,1,10,17,1
S01010511,Rented or living rent free: Private rented or living rent free,17,15,11,1,10,4,0,2,1,0,0,1,0
S01010512,All HRPs aged 16 and over,281,153,119,28,91,28,6,128,105,0,4,14,5
S01010512,Owned: Total,170,108,84,17,67,21,3,62,60,0,0,0,2
S01010512,Owned: Owned outright,83,30,21,9,12,7,2,53,52,0,0,0,1
S01010512,Owned: Owned with a mortgage or loan or shared ownership,87,78,63,8,55,14,1,9,8,0,0,0,1
S01010512,Rented or living rent free: Total,111,45,35,11,24,7,3,66,45,0,4,14,3
S01010512,Rented or living rent free: Social rented,90,28,20,9,11,6,2,62,41,0,4,14,3
S01010512,Rented or living rent free: Private rented or living rent free,21,17,15,2,13,1,1,4,4,0,0,0,0
S01010513,All HRPs aged 16 and over,300,214,165,18,147,46,3,86,79,0,2,4,1
S01010513,Owned: Total,241,174,132,16,116,41,1,67,67,0,0,0,0
S01010513,Owned: Owned outright,125,67,49,12,37,17,1,58,58,0,0,0,0
S01010513,Owned: Owned with a mortgage or loan or shared ownership,116,107,83,4,79,24,0,9,9,0,0,0,0
S01010513,Rented or living rent free: Total,59,40,33,2,31,5,2,19,12,0,2,4,1
S01010513,Rented or living rent free: Social rented,23,11,8,1,7,2,1,12,7,0,1,4,0
S01010513,Rented or living rent free: Private rented or living rent free,36,29,25,1,24,3,1,7,5,0,1,0,1
S01010514,All HRPs aged 16 and over,287,190,166,34,132,19,5,97,72,1,8,9,7
S01010514,Owned: Total,188,134,117,21,96,16,1,54,49,0,1,3,1
S01010514,Owned: Owned outright,81,36,31,9,22,5,0,45,42,0,0,2,1
S01010514,Owned: Owned with a mortgage or loan or shared ownership,107,98,86,12,74,11,1,9,7,0,1,1,0
S01010514,Rented or living rent free: Total,99,56,49,13,36,3,4,43,23,1,7,6,6
S01010514,Rented or living rent free: Social rented,77,41,35,13,22,2,4,36,17,1,7,6,5
S01010514,Rented or living rent free: Private rented or living rent free,22,15,14,0,14,1,0,7,6,0,0,0,1
S01010515,All HRPs aged 16 and over,350,234,204,44,160,21,9,116,95,0,7,14,0
S01010515,Owned: Total,204,143,126,21,105,17,0,61,56,0,1,4,0
S01010515,Owned: Owned outright,93,47,36,11,25,11,0,46,44,0,0,2,0
S01010515,Owned: Owned with a mortgage or loan or shared ownership,111,96,90,10,80,6,0,15,12,0,1,2,0
S01010515,Rented or living rent free: Total,146,91,78,23,55,4,9,55,39,0,6,10,0
S01010515,Rented or living rent free: Social rented,116,71,60,20,40,2,9,45,30,0,5,10,0
S01010515,Rented or living rent free: Private rented or living rent free,30,20,18,3,15,2,0,10,9,0,1,0,0
S01010516,All HRPs aged 16 and over,270,176,121,20,101,46,9,94,75,2,7,7,3
S01010516,Owned: Total,172,116,72,14,58,42,2,56,56,0,0,0,0
S01010516,Owned: Owned outright,91,40,22,5,17,17,1,51,51,0,0,0,0
S01010516,Owned: Owned with a mortgage or loan or shared ownership,81,76,50,9,41,25,1,5,5,0,0,0,0
S01010516,Rented or living rent free: Total,98,60,49,6,43,4,7,38,19,2,7,7,3
S01010516,Rented or living rent free: Social rented,55,22,17,4,13,1,4,33,14,2,7,7,3
S01010516,Rented or living rent free: Private rented or living rent free,43,38,32,2,30,3,3,5,5,0,0,0,0
S01010517,All HRPs aged 16 and over,362,257,205,31,174,31,21,105,71,0,9,22,3
S01010517,Owned: Total,210,152,123,16,107,25,4,58,54,0,0,4,0
S01010517,Owned: Owned outright,96,50,39,9,30,10,1,46,45,0,0,1,0
S01010517,Owned: Owned with a mortgage or loan or shared ownership,114,102,84,7,77,15,3,12,9,0,0,3,0
S01010517,Rented or living rent free: Total,152,105,82,15,67,6,17,47,17,0,9,18,3
S01010517,Rented or living rent free: Social rented,113,70,54,11,43,2,14,43,15,0,9,16,3
S01010517,Rented or living rent free: Private rented or living rent free,39,35,28,4,24,4,3,4,2,0,0,2,0
S01010518,All HRPs aged 16 and over,293,217,175,30,145,33,9,76,61,0,4,9,2
S01010518,Owned: Total,187,134,107,15,92,26,1,53,50,0,0,2,1
S01010518,Owned: Owned outright,92,44,34,8,26,10,0,48,46,0,0,1,1
S01010518,Owned: Owned with a mortgage or loan or shared ownership,95,90,73,7,66,16,1,5,4,0,0,1,0
S01010518,Rented or living rent free: Total,106,83,68,15,53,7,8,23,11,0,4,7,1
S01010518,Rented or living rent free: Social rented,52,31,21,7,14,2,8,21,11,0,3,6,1
S01010518,Rented or living rent free: Private rented or living rent free,54,52,47,8,39,5,0,2,0,0,1,1,0
S01010519,All HRPs aged 16 and over,282,212,179,42,137,18,15,70,53,0,10,4,3
S01010519,Owned: Total,153,115,101,11,90,11,3,38,38,0,0,0,0
S01010519,Owned: Owned outright,70,38,32,4,28,4,2,32,32,0,0,0,0
S01010519,Owned: Owned with a mortgage or loan or shared ownership,83,77,69,7,62,7,1,6,6,0,0,0,0
S01010519,Rented or living rent free: Total,129,97,78,31,47,7,12,32,15,0,10,4,3
S01010519,Rented or living rent free: Social rented,103,74,57,26,31,5,12,29,14,0,9,4,2
S01010519,Rented or living rent free: Private rented or living rent free,26,23,21,5,16,2,0,3,1,0,1,0,1
S01010520,All HRPs aged 16 and over,410,260,231,36,195,27,2,150,133,1,3,10,3
S01010520,Owned: Total,306,207,184,29,155,23,0,99,97,0,0,0,2
S01010520,Owned: Owned outright,141,55,51,14,37,4,0,86,85,0,0,0,1
S01010520,Owned: Owned with a mortgage or loan or shared ownership,165,152,133,15,118,19,0,13,12,0,0,0,1
S01010520,Rented or living rent free: Total,104,53,47,7,40,4,2,51,36,1,3,10,1
S01010520,Rented or living rent free: Social rented,56,24,20,6,14,2,2,32,19,1,2,9,1
S01010520,Rented or living rent free: Private rented or living rent free,48,29,27,1,26,2,0,19,17,0,1,1,0
S01010521,All HRPs aged 16 and over,339,234,189,34,155,37,8,105,77,0,6,17,5
S01010521,Owned: Total,180,131,104,16,88,27,0,49,42,0,0,5,2
S01010521,Owned: Owned outright,95,49,34,10,24,15,0,46,40,0,0,4,2
S01010521,Owned: Owned with a mortgage or loan or shared ownership,85,82,70,6,64,12,0,3,2,0,0,1,0
S01010521,Rented or living rent free: Total,159,103,85,18,67,10,8,56,35,0,6,12,3
S01010521,Rented or living rent free: Social rented,116,65,54,13,41,4,7,51,31,0,6,12,2
S01010521,Rented or living rent free: Private rented or living rent free,43,38,31,5,26,6,1,5,4,0,0,0,1
S01010522,All HRPs aged 16 and over,283,184,151,25,126,21,12,99,66,0,6,25,2
S01010522,Owned: Total,114,92,75,4,71,13,4,22,20,0,0,2,0
S01010522,Owned: Owned outright,34,16,12,2,10,4,0,18,17,0,0,1,0
S01010522,Owned: Owned with a mortgage or loan or shared ownership,80,76,63,2,61,9,4,4,3,0,0,1,0
S01010522,Rented or living rent free: Total,169,92,76,21,55,8,8,77,46,0,6,23,2
S01010522,Rented or living rent free: Social rented,122,50,39,12,27,5,6,72,44,0,6,22,0
S01010522,Rented or living rent free: Private rented or living rent free,47,42,37,9,28,3,2,5,2,0,0,1,2
S01010523,All HRPs aged 16 and over,258,177,146,38,108,17,14,81,46,0,9,23,3
S01010523,Owned: Total,71,45,31,4,27,12,2,26,25,0,0,1,0
S01010523,Owned: Owned outright,39,15,9,3,6,4,2,24,24,0,0,0,0
S01010523,Owned: Owned with a mortgage or loan or shared ownership,32,30,22,1,21,8,0,2,1,0,0,1,0
S01010523,Rented or living rent free: Total,187,132,115,34,81,5,12,55,21,0,9,22,3
S01010523,Rented or living rent free: Social rented,170,119,103,32,71,4,12,51,20,0,8,20,3
S01010523,Rented or living rent free: Private rented or living rent free,17,13,12,2,10,1,0,4,1,0,1,2,0
S01010524,All HRPs aged 16 and over,234,154,107,14,93,45,2,80,73,0,2,5,0
S01010524,Owned: Total,181,116,74,9,65,41,1,65,64,0,0,1,0
S01010524,Owned: Owned outright,110,50,27,5,22,22,1,60,59,0,0,1,0
S01010524,Owned: Owned with a mortgage or loan or shared ownership,71,66,47,4,43,19,0,5,5,0,0,0,0
S01010524,Rented or living rent free: Total,53,38,33,5,28,4,1,15,9,0,2,4,0
S01010524,Rented or living rent free: Social rented,20,11,8,4,4,2,1,9,4,0,2,3,0
S01010524,Rented or living rent free: Private rented or living rent free,33,27,25,1,24,2,0,6,5,0,0,1,0
S01010525,All HRPs aged 16 and over,259,157,112,18,94,43,2,102,92,0,5,3,2
S01010525,Owned: Total,204,118,80,13,67,37,1,86,81,0,3,1,1
S01010525,Owned: Owned outright,124,48,32,9,23,15,1,76,72,0,3,0,1
S01010525,Owned: Owned with a mortgage or loan or shared ownership,80,70,48,4,44,22,0,10,9,0,0,1,0
S01010525,Rented or living rent free: Total,55,39,32,5,27,6,1,16,11,0,2,2,1
S01010525,Rented or living rent free: Social rented,16,9,8,1,7,0,1,7,6,0,0,1,0
S01010525,Rented or living rent free: Private rented or living rent free,39,30,24,4,20,6,0,9,5,0,2,1,1
S01010526,All HRPs aged 16 and over,364,251,177,35,142,67,7,113,100,0,0,10,3
S01010526,Owned: Total,226,173,117,19,98,55,1,53,49,0,0,3,1
S01010526,Owned: Owned outright,114,69,46,13,33,22,1,45,43,0,0,2,0
S01010526,Owned: Owned with a mortgage or loan or shared ownership,112,104,71,6,65,33,0,8,6,0,0,1,1
S01010526,Rented or living rent free: Total,138,78,60,16,44,12,6,60,51,0,0,7,2
S01010526,Rented or living rent free: Social rented,82,42,32,12,20,4,6,40,34,0,0,6,0
S01010526,Rented or living rent free: Private rented or living rent free,56,36,28,4,24,8,0,20,17,0,0,1,2
S01010527,All HRPs aged 16 and over,455,278,233,54,179,26,19,177,147,5,3,17,5
S01010527,Owned: Total,234,155,129,26,103,23,3,79,76,0,0,2,1
S01010527,Owned: Owned outright,131,62,50,20,30,9,3,69,68,0,0,1,0
S01010527,Owned: Owned with a mortgage or loan or shared ownership,103,93,79,6,73,14,0,10,8,0,0,1,1
S01010527,Rented or living rent free: Total,221,123,104,28,76,3,16,98,71,5,3,15,4
S01010527,Rented or living rent free: Social rented,176,98,81,27,54,2,15,78,53,5,2,14,4
S01010527,Rented or living rent free: Private rented or living rent free,45,25,23,1,22,1,1,20,18,0,1,1,0
S01010528,All HRPs aged 16 and over,265,187,130,20,110,56,1,78,64,0,4,9,1
S01010528,Owned: Total,168,118,77,13,64,40,1,50,46,0,0,3,1
S01010528,Owned: Owned outright,97,53,31,7,24,21,1,44,41,0,0,2,1
S01010528,Owned: Owned with a mortgage or loan or shared ownership,71,65,46,6,40,19,0,6,5,0,0,1,0
S01010528,Rented or living rent free: Total,97,69,53,7,46,16,0,28,18,0,4,6,0
S01010528,Rented or living rent free: Social rented,36,17,10,2,8,7,0,19,10,0,4,5,0
S01010528,Rented or living rent free: Private rented or living rent free,61,52,43,5,38,9,0,9,8,0,0,1,0
S01010529,All HRPs aged 16 and over,283,198,147,29,118,46,5,85,75,2,2,4,2
S01010529,Owned: Total,211,154,110,21,89,40,4,57,52,2,0,1,2
S01010529,Owned: Owned outright,110,65,46,12,34,17,2,45,42,1,0,1,1
S01010529,Owned: Owned with a mortgage or loan or shared ownership,101,89,64,9,55,23,2,12,10,1,0,0,1
S01010529,Rented or living rent free: Total,72,44,37,8,29,6,1,28,23,0,2,3,0
S01010529,Rented or living rent free: Social rented,47,22,20,3,17,2,0,25,20,0,2,3,0
S01010529,Rented or living rent free: Private rented or living rent free,25,22,17,5,12,4,1,3,3,0,0,0,0
S01010530,All HRPs aged 16 and over,278,201,132,19,113,64,5,77,76,0,0,1,0
S01010530,Owned: Total,210,148,89,13,76,54,5,62,62,0,0,0,0
S01010530,Owned: Owned outright,126,70,39,8,31,28,3,56,56,0,0,0,0
S01010530,Owned: Owned with a mortgage or loan or shared ownership,84,78,50,5,45,26,2,6,6,0,0,0,0
S01010530,Rented or living rent free: Total,68,53,43,6,37,10,0,15,14,0,0,1,0
S01010530,Rented or living rent free: Social rented,20,12,12,4,8,0,0,8,7,0,0,1,0
S01010530,Rented or living rent free: Private rented or living rent free,48,41,31,2,29,10,0,7,7,0,0,0,0
S01010531,All HRPs aged 16 and over,496,325,228,39,189,90,7,171,156,1,2,5,7
S01010531,Owned: Total,354,246,164,26,138,78,4,108,105,0,1,1,1
S01010531,Owned: Owned outright,214,112,76,16,60,35,1,102,99,0,1,1,1
S01010531,Owned: Owned with a mortgage or loan or shared ownership,140,134,88,10,78,43,3,6,6,0,0,0,0
S01010531,Rented or living rent free: Total,142,79,64,13,51,12,3,63,51,1,1,4,6
S01010531,Rented or living rent free: Social rented,74,29,24,8,16,2,3,45,34,1,1,4,5
S01010531,Rented or living rent free: Private rented or living rent free,68,50,40,5,35,10,0,18,17,0,0,0,1
S01010532,All HRPs aged 16 and over,245,172,113,16,97,54,5,73,67,1,0,0,5
S01010532,Owned: Total,147,98,56,11,45,38,4,49,49,0,0,0,0
S01010532,Owned: Owned outright,107,59,26,6,20,29,4,48,48,0,0,0,0
S01010532,Owned: Owned with a mortgage or loan or shared ownership,40,39,30,5,25,9,0,1,1,0,0,0,0
S01010532,Rented or living rent free: Total,98,74,57,5,52,16,1,24,18,1,0,0,5
S01010532,Rented or living rent free: Social rented,12,4,3,3,0,0,1,8,4,1,0,0,3
S01010532,Rented or living rent free: Private rented or living rent free,86,70,54,2,52,16,0,16,14,0,0,0,2
S01010533,All HRPs aged 16 and over,272,156,113,19,94,38,5,116,106,3,0,7,0
S01010533,Owned: Total,188,112,76,10,66,34,2,76,74,2,0,0,0
S01010533,Owned: Owned outright,124,53,36,8,28,17,0,71,69,2,0,0,0
S01010533,Owned: Owned with a mortgage or loan or shared ownership,64,59,40,2,38,17,2,5,5,0,0,0,0
S01010533,Rented or living rent free: Total,84,44,37,9,28,4,3,40,32,1,0,7,0
S01010533,Rented or living rent free: Social rented,49,16,14,5,9,1,1,33,25,1,0,7,0
S01010533,Rented or living rent free: Private rented or living rent free,35,28,23,4,19,3,2,7,7,0,0,0,0
S01010534,All HRPs aged 16 and over,374,262,203,41,162,51,8,112,95,0,7,8,2
S01010534,Owned: Total,249,172,129,21,108,43,0,77,73,0,2,1,1
S01010534,Owned: Owned outright,138,70,43,12,31,27,0,68,66,0,2,0,0
S01010534,Owned: Owned with a mortgage or loan or shared ownership,111,102,86,9,77,16,0,9,7,0,0,1,1
S01010534,Rented or living rent free: Total,125,90,74,20,54,8,8,35,22,0,5,7,1
S01010534,Rented or living rent free: Social rented,90,61,51,14,37,4,6,29,17,0,5,6,1
S01010534,Rented or living rent free: Private rented or living rent free,35,29,23,6,17,4,2,6,5,0,0,1,0
S01010535,All HRPs aged 16 and over,305,215,144,22,122,63,8,90,76,1,6,6,1
S01010535,Owned: Total,186,129,83,13,70,45,1,57,56,0,0,1,0
S01010535,Owned: Owned outright,112,62,37,8,29,24,1,50,50,0,0,0,0
S01010535,Owned: Owned with a mortgage or loan or shared ownership,74,67,46,5,41,21,0,7,6,0,0,1,0
S01010535,Rented or living rent free: Total,119,86,61,9,52,18,7,33,20,1,6,5,1
S01010535,Rented or living rent free: Social rented,28,8,6,3,3,0,2,20,10,1,4,5,0
S01010535,Rented or living rent free: Private rented or living rent free,91,78,55,6,49,18,5,13,10,0,2,0,1
S01010536,All HRPs aged 16 and over,397,254,207,33,174,35,12,143,121,0,1,17,4
S01010536,Owned: Total,213,149,121,13,108,27,1,64,59,0,0,5,0
S01010536,Owned: Owned outright,103,48,34,8,26,13,1,55,52,0,0,3,0
S01010536,Owned: Owned with a mortgage or loan or shared ownership,110,101,87,5,82,14,0,9,7,0,0,2,0
S01010536,Rented or living rent free: Total,184,105,86,20,66,8,11,79,62,0,1,12,4
S01010536,Rented or living rent free: Social rented,139,63,48,17,31,5,10,76,59,0,1,12,4
S01010536,Rented or living rent free: Private rented or living rent free,45,42,38,3,35,3,1,3,3,0,0,0,0
S01010537,All HRPs aged 16 and over,330,243,192,35,157,44,7,87,70,0,4,10,3
S01010537,Owned: Total,188,135,99,20,79,36,0,53,51,0,1,1,0
S01010537,Owned: Owned outright,92,45,31,11,20,14,0,47,46,0,0,1,0
S01010537,Owned: Owned with a mortgage or loan or shared ownership,96,90,68,9,59,22,0,6,5,0,1,0,0
S01010537,Rented or living rent free: Total,142,108,93,15,78,8,7,34,19,0,3,9,3
S01010537,Rented or living rent free: Social rented,73,46,41,12,29,0,5,27,13,0,3,8,3
S01010537,Rented or living rent free: Private rented or living rent free,69,62,52,3,49,8,2,7,6,0,0,1,0
S01010538,All HRPs aged 16 and over,337,282,223,30,193,47,12,55,34,1,6,11,3
S01010538,Owned: Total,163,138,105,10,95,32,1,25,24,0,0,1,0
S01010538,Owned: Owned outright,58,36,21,5,16,14,1,22,22,0,0,0,0
S01010538,Owned: Owned with a mortgage or loan or shared ownership,105,102,84,5,79,18,0,3,2,0,0,1,0
S01010538,Rented or living rent free: Total,174,144,118,20,98,15,11,30,10,1,6,10,3
S01010538,Rented or living rent free: Social rented,112,90,72,17,55,9,9,22,6,1,6,8,1
S01010538,Rented or living rent free: Private rented or living rent free,62,54,46,3,43,6,2,8,4,0,0,2,2
S01010539,All HRPs aged 16 and over,496,392,313,38,275,67,12,104,83,0,5,12,4
S01010539,Owned: Total,305,229,179,25,154,45,5,76,70,0,1,4,1
S01010539,Owned: Owned outright,153,87,61,16,45,22,4,66,62,0,0,4,0
S01010539,Owned: Owned with a mortgage or loan or shared ownership,152,142,118,9,109,23,1,10,8,0,1,0,1
S01010539,Rented or living rent free: Total,191,163,134,13,121,22,7,28,13,0,4,8,3
S01010539,Rented or living rent free: Social rented,59,40,32,7,25,2,6,19,9,0,3,6,1
S01010539,Rented or living rent free: Private rented or living rent free,132,123,102,6,96,20,1,9,4,0,1,2,2
S01010540,All HRPs aged 16 and over,298,192,138,22,116,51,3,106,97,2,1,3,3
S01010540,Owned: Total,212,130,91,16,75,37,2,82,80,0,0,2,0
S01010540,Owned: Owned outright,131,55,32,7,25,23,0,76,74,0,0,2,0
S01010540,Owned: Owned with a mortgage or loan or shared ownership,81,75,59,9,50,14,2,6,6,0,0,0,0
S01010540,Rented or living rent free: Total,86,62,47,6,41,14,1,24,17,2,1,1,3
S01010540,Rented or living rent free: Social rented,22,11,10,2,8,1,0,11,8,0,0,1,2
S01010540,Rented or living rent free: Private rented or living rent free,64,51,37,4,33,13,1,13,9,2,1,0,1
S01010541,All HRPs aged 16 and over,362,258,193,34,159,61,4,104,93,0,1,7,3
S01010541,Owned: Total,255,176,126,21,105,49,1,79,75,0,0,2,2
S01010541,Owned: Owned outright,146,74,45,13,32,28,1,72,68,0,0,2,2
S01010541,Owned: Owned with a mortgage or loan or shared ownership,109,102,81,8,73,21,0,7,7,0,0,0,0
S01010541,Rented or living rent free: Total,107,82,67,13,54,12,3,25,18,0,1,5,1
S01010541,Rented or living rent free: Social rented,37,24,20,8,12,1,3,13,8,0,1,3,1
S01010541,Rented or living rent free: Private rented or living rent free,70,58,47,5,42,11,0,12,10,0,0,2,0
S01010542,All HRPs aged 16 and over,388,253,181,29,152,64,8,135,117,0,3,11,4
S01010542,Owned: Total,269,180,127,20,107,49,4,89,85,0,1,1,2
S01010542,Owned: Owned outright,164,83,49,12,37,30,4,81,77,0,1,1,2
S01010542,Owned: Owned with a mortgage or loan or shared ownership,105,97,78,8,70,19,0,8,8,0,0,0,0
S01010542,Rented or living rent free: Total,119,73,54,9,45,15,4,46,32,0,2,10,2
S01010542,Rented or living rent free: Social rented,53,21,15,6,9,3,3,32,21,0,2,7,2
S01010542,Rented or living rent free: Private rented or living rent free,66,52,39,3,36,12,1,14,11,0,0,3,0
S01010543,All HRPs aged 16 and over,255,182,107,7,100,74,1,73,65,0,4,2,2
S01010543,Owned: Total,183,122,63,4,59,59,0,61,58,0,1,2,0
S01010543,Owned: Owned outright,104,57,25,2,23,32,0,47,46,0,0,1,0
S01010543,Owned: Owned with a mortgage or loan or shared ownership,79,65,38,2,36,27,0,14,12,0,1,1,0
S01010543,Rented or living rent free: Total,72,60,44,3,41,15,1,12,7,0,3,0,2
S01010543,Rented or living rent free: Social rented,12,8,8,1,7,0,0,4,3,0,0,0,1
S01010543,Rented or living rent free: Private rented or living rent free,60,52,36,2,34,15,1,8,4,0,3,0,1
S01010544,All HRPs aged 16 and over,370,248,187,42,145,50,11,122,111,0,4,6,1
S01010544,Owned: Total,250,173,133,28,105,39,1,77,76,0,0,1,0
S01010544,Owned: Owned outright,136,64,44,17,27,19,1,72,72,0,0,0,0
S01010544,Owned: Owned with a mortgage or loan or shared ownership,114,109,89,11,78,20,0,5,4,0,0,1,0
S01010544,Rented or living rent free: Total,120,75,54,14,40,11,10,45,35,0,4,5,1
S01010544,Rented or living rent free: Social rented,76,45,30,10,20,6,9,31,22,0,3,5,1
S01010544,Rented or living rent free: Private rented or living rent free,44,30,24,4,20,5,1,14,13,0,1,0,0
S01010545,All HRPs aged 16 and over,344,208,155,20,135,44,9,136,114,1,5,10,6
S01010545,Owned: Total,229,151,114,15,99,34,3,78,73,1,1,0,3
S01010545,Owned: Owned outright,126,56,37,8,29,18,1,70,68,0,0,0,2
S01010545,Owned: Owned with a mortgage or loan or shared ownership,103,95,77,7,70,16,2,8,5,1,1,0,1
S01010545,Rented or living rent free: Total,115,57,41,5,36,10,6,58,41,0,4,10,3
S01010545,Rented or living rent free: Social rented,68,15,13,3,10,0,2,53,38,0,4,9,2
S01010545,Rented or living rent free: Private rented or living rent free,47,42,28,2,26,10,4,5,3,0,0,1,1
S01010546,All HRPs aged 16 and over,369,227,178,32,146,37,12,142,129,0,4,5,4
S01010546,Owned: Total,231,137,103,20,83,30,4,94,91,0,1,1,1
S01010546,Owned: Owned outright,144,56,41,11,30,12,3,88,87,0,0,0,1
S01010546,Owned: Owned with a mortgage or loan or shared ownership,87,81,62,9,53,18,1,6,4,0,1,1,0
S01010546,Rented or living rent free: Total,138,90,75,12,63,7,8,48,38,0,3,4,3
S01010546,Rented or living rent free: Social rented,62,26,19,8,11,2,5,36,30,0,2,2,2
S01010546,Rented or living rent free: Private rented or living rent free,76,64,56,4,52,5,3,12,8,0,1,2,1
S01010547,All HRPs aged 16 and over,313,212,147,18,129,61,4,101,88,0,3,6,4
S01010547,Owned: Total,214,138,92,13,79,45,1,76,74,0,0,1,1
S01010547,Owned: Owned outright,143,71,38,9,29,32,1,72,70,0,0,1,1
S01010547,Owned: Owned with a mortgage or loan or shared ownership,71,67,54,4,50,13,0,4,4,0,0,0,0
S01010547,Rented or living rent free: Total,99,74,55,5,50,16,3,25,14,0,3,5,3
S01010547,Rented or living rent free: Social rented,21,6,4,2,2,1,1,15,7,0,3,3,2
S01010547,Rented or living rent free: Private rented or living rent free,78,68,51,3,48,15,2,10,7,0,0,2,1
S01010548,All HRPs aged 16 and over,299,167,119,22,97,44,4,132,128,0,1,2,1
S01010548,Owned: Total,228,115,88,14,74,25,2,113,112,0,0,0,1
S01010548,Owned: Owned outright,160,56,38,11,27,16,2,104,103,0,0,0,1
S01010548,Owned: Owned with a mortgage or loan or shared ownership,68,59,50,3,47,9,0,9,9,0,0,0,0
S01010548,Rented or living rent free: Total,71,52,31,8,23,19,2,19,16,0,1,2,0
S01010548,Rented or living rent free: Social rented,5,3,3,0,3,0,0,2,0,0,1,1,0
S01010548,Rented or living rent free: Private rented or living rent free,66,49,28,8,20,19,2,17,16,0,0,1,0
S01010549,All HRPs aged 16 and over,366,274,244,29,215,24,6,92,81,1,3,3,4
S01010549,Owned: Total,290,211,189,18,171,20,2,79,73,0,1,1,4
S01010549,Owned: Owned outright,118,50,44,9,35,5,1,68,65,0,1,0,2
S01010549,Owned: Owned with a mortgage or loan or shared ownership,172,161,145,9,136,15,1,11,8,0,0,1,2
S01010549,Rented or living rent free: Total,76,63,55,11,44,4,4,13,8,1,2,2,0
S01010549,Rented or living rent free: Social rented,19,11,9,8,1,1,1,8,3,1,2,2,0
S01010549,Rented or living rent free: Private rented or living rent free,57,52,46,3,43,3,3,5,5,0,0,0,0
S01010550,All HRPs aged 16 and over,236,162,131,27,104,28,3,74,66,0,2,3,3
S01010550,Owned: Total,163,113,92,14,78,21,0,50,45,0,2,1,2
S01010550,Owned: Owned outright,87,44,37,8,29,7,0,43,40,0,2,1,0
S01010550,Owned: Owned with a mortgage or loan or shared ownership,76,69,55,6,49,14,0,7,5,0,0,0,2
S01010550,Rented or living rent free: Total,73,49,39,13,26,7,3,24,21,0,0,2,1
S01010550,Rented or living rent free: Social rented,48,26,19,9,10,4,3,22,20,0,0,2,0
S01010550,Rented or living rent free: Private rented or living rent free,25,23,20,4,16,3,0,2,1,0,0,0,1
S01010551,All HRPs aged 16 and over,267,208,134,22,112,70,4,59,49,2,3,4,1
S01010551,Owned: Total,192,149,95,10,85,53,1,43,41,0,1,0,1
S01010551,Owned: Owned outright,87,51,27,6,21,24,0,36,34,0,1,0,1
S01010551,Owned: Owned with a mortgage or loan or shared ownership,105,98,68,4,64,29,1,7,7,0,0,0,0
S01010551,Rented or living rent free: Total,75,59,39,12,27,17,3,16,8,2,2,4,0
S01010551,Rented or living rent free: Social rented,27,17,12,6,6,2,3,10,3,1,2,4,0
S01010551,Rented or living rent free: Private rented or living rent free,48,42,27,6,21,15,0,6,5,1,0,0,0
S01010552,All HRPs aged 16 and over,334,233,168,25,143,60,5,101,85,2,5,7,2
S01010552,Owned: Total,218,154,109,19,90,43,2,64,58,0,3,1,2
S01010552,Owned: Owned outright,114,59,42,16,26,16,1,55,51,0,2,0,2
S01010552,Owned: Owned with a mortgage or loan or shared ownership,104,95,67,3,64,27,1,9,7,0,1,1,0
S01010552,Rented or living rent free: Total,116,79,59,6,53,17,3,37,27,2,2,6,0
S01010552,Rented or living rent free: Social rented,28,17,12,3,9,2,3,11,6,0,1,4,0
S01010552,Rented or living rent free: Private rented or living rent free,88,62,47,3,44,15,0,26,21,2,1,2,0
S01010553,All HRPs aged 16 and over,261,191,121,17,104,68,2,70,57,3,4,4,2
S01010553,Owned: Total,154,108,69,10,59,38,1,46,38,3,2,1,2
S01010553,Owned: Owned outright,88,49,25,3,22,23,1,39,35,3,0,0,1
S01010553,Owned: Owned with a mortgage or loan or shared ownership,66,59,44,7,37,15,0,7,3,0,2,1,1
S01010553,Rented or living rent free: Total,107,83,52,7,45,30,1,24,19,0,2,3,0
S01010553,Rented or living rent free: Social rented,5,2,2,2,0,0,0,3,2,0,1,0,0
S01010553,Rented or living rent free: Private rented or living rent free,102,81,50,5,45,30,1,21,17,0,1,3,0
S01010554,All HRPs aged 16 and over,396,250,191,32,159,45,14,146,115,1,11,15,4
S01010554,Owned: Total,268,161,121,18,103,37,3,107,96,0,3,7,1
S01010554,Owned: Owned outright,133,46,30,5,25,14,2,87,80,0,0,6,1
S01010554,Owned: Owned with a mortgage or loan or shared ownership,135,115,91,13,78,23,1,20,16,0,3,1,0
S01010554,Rented or living rent free: Total,128,89,70,14,56,8,11,39,19,1,8,8,3
S01010554,Rented or living rent free: Social rented,29,13,11,6,5,0,2,16,9,1,2,4,0
S01010554,Rented or living rent free: Private rented or living rent free,99,76,59,8,51,8,9,23,10,0,6,4,3
S01010555,All HRPs aged 16 and over,450,302,236,36,200,44,22,148,110,4,16,13,5
S01010555,Owned: Total,279,186,145,18,127,36,5,93,83,0,6,2,2
S01010555,Owned: Owned outright,124,51,34,10,24,13,4,73,70,0,2,0,1
S01010555,Owned: Owned with a mortgage or loan or shared ownership,155,135,111,8,103,23,1,20,13,0,4,2,1
S01010555,Rented or living rent free: Total,171,116,91,18,73,8,17,55,27,4,10,11,3
S01010555,Rented or living rent free: Social rented,55,27,17,11,6,1,9,28,13,1,6,6,2
S01010555,Rented or living rent free: Private rented or living rent free,116,89,74,7,67,7,8,27,14,3,4,5,1
S01010556,All HRPs aged 16 and over,410,231,188,43,145,24,19,179,138,2,9,23,7
S01010556,Owned: Total,182,123,104,9,95,16,3,59,51,1,1,3,3
S01010556,Owned: Owned outright,71,19,16,2,14,3,0,52,46,1,1,2,2
S01010556,Owned: Owned with a mortgage or loan or shared ownership,111,104,88,7,81,13,3,7,5,0,0,1,1
S01010556,Rented or living rent free: Total,228,108,84,34,50,8,16,120,87,1,8,20,4
S01010556,Rented or living rent free: Social rented,204,90,67,31,36,7,16,114,82,1,8,19,4
S01010556,Rented or living rent free: Private rented or living rent free,24,18,17,3,14,1,0,6,5,0,0,1,0
S01010557,All HRPs aged 16 and over,278,153,136,21,115,8,9,125,106,0,11,5,3
S01010557,Owned: Total,176,103,96,9,87,6,1,73,72,0,0,1,0
S01010557,Owned: Owned outright,93,30,26,4,22,3,1,63,62,0,0,1,0
S01010557,Owned: Owned with a mortgage or loan or shared ownership,83,73,70,5,65,3,0,10,10,0,0,0,0
S01010557,Rented or living rent free: Total,102,50,40,12,28,2,8,52,34,0,11,4,3
S01010557,Rented or living rent free: Social rented,85,39,30,9,21,1,8,46,29,0,10,4,3
S01010557,Rented or living rent free: Private rented or living rent free,17,11,10,3,7,1,0,6,5,0,1,0,0
S01010558,All HRPs aged 16 and over,385,210,162,23,139,27,21,175,150,0,6,15,4
S01010558,Owned: Total,273,152,124,16,108,23,5,121,117,0,0,3,1
S01010558,Owned: Owned outright,170,59,44,10,34,13,2,111,110,0,0,1,0
S01010558,Owned: Owned with a mortgage or loan or shared ownership,103,93,80,6,74,10,3,10,7,0,0,2,1
S01010558,Rented or living rent free: Total,112,58,38,7,31,4,16,54,33,0,6,12,3
S01010558,Rented or living rent free: Social rented,83,38,22,5,17,1,15,45,25,0,6,12,2
S01010558,Rented or living rent free: Private rented or living rent free,29,20,16,2,14,3,1,9,8,0,0,0,1
S01010559,All HRPs aged 16 and over,351,179,132,20,112,41,6,172,164,0,2,3,3
S01010559,Owned: Total,277,156,112,17,95,39,5,121,118,0,0,2,1
S01010559,Owned: Owned outright,188,71,54,14,40,13,4,117,114,0,0,2,1
S01010559,Owned: Owned with a mortgage or loan or shared ownership,89,85,58,3,55,26,1,4,4,0,0,0,0
S01010559,Rented or living rent free: Total,74,23,20,3,17,2,1,51,46,0,2,1,2
S01010559,Rented or living rent free: Social rented,43,2,1,1,0,1,0,41,37,0,2,1,1
S01010559,Rented or living rent free: Private rented or living rent free,31,21,19,2,17,1,1,10,9,0,0,0,1
S01010560,All HRPs aged 16 and over,291,180,150,19,131,28,2,111,108,0,2,0,1
S01010560,Owned: Total,255,154,127,15,112,26,1,101,100,0,0,0,1
S01010560,Owned: Owned outright,151,65,55,9,46,10,0,86,85,0,0,0,1
S01010560,Owned: Owned with a mortgage or loan or shared ownership,104,89,72,6,66,16,1,15,15,0,0,0,0
S01010560,Rented or living rent free: Total,36,26,23,4,19,2,1,10,8,0,2,0,0
S01010560,Rented or living rent free: Social rented,8,5,5,1,4,0,0,3,3,0,0,0,0
S01010560,Rented or living rent free: Private rented or living rent free,28,21,18,3,15,2,1,7,5,0,2,0,0
S01010561,All HRPs aged 16 and over,301,187,149,27,122,36,2,114,109,0,2,2,1
S01010561,Owned: Total,265,162,126,22,104,34,2,103,102,0,1,0,0
S01010561,Owned: Owned outright,173,77,56,15,41,20,1,96,96,0,0,0,0
S01010561,Owned: Owned with a mortgage or loan or shared ownership,92,85,70,7,63,14,1,7,6,0,1,0,0
S01010561,Rented or living rent free: Total,36,25,23,5,18,2,0,11,7,0,1,2,1
S01010561,Rented or living rent free: Social rented,7,3,3,1,2,0,0,4,2,0,1,0,1
S01010561,Rented or living rent free: Private rented or living rent free,29,22,20,4,16,2,0,7,5,0,0,2,0
S01010562,All HRPs aged 16 and over,314,211,180,35,145,28,3,103,94,0,4,5,0
S01010562,Owned: Total,274,180,154,28,126,23,3,94,87,0,3,4,0
S01010562,Owned: Owned outright,154,67,55,21,34,10,2,87,83,0,1,3,0
S01010562,Owned: Owned with a mortgage or loan or shared ownership,120,113,99,7,92,13,1,7,4,0,2,1,0
S01010562,Rented or living rent free: Total,40,31,26,7,19,5,0,9,7,0,1,1,0
S01010562,Rented or living rent free: Social rented,16,11,8,4,4,3,0,5,3,0,1,1,0
S01010562,Rented or living rent free: Private rented or living rent free,24,20,18,3,15,2,0,4,4,0,0,0,0
S01010563,All HRPs aged 16 and over,211,147,121,18,103,17,9,64,51,1,3,5,4
S01010563,Owned: Total,131,92,83,11,72,7,2,39,36,0,1,1,1
S01010563,Owned: Owned outright,58,25,24,6,18,1,0,33,31,0,0,1,1
S01010563,Owned: Owned with a mortgage or loan or shared ownership,73,67,59,5,54,6,2,6,5,0,1,0,0
S01010563,Rented or living rent free: Total,80,55,38,7,31,10,7,25,15,1,2,4,3
S01010563,Rented or living rent free: Social rented,63,41,30,6,24,6,5,22,15,0,1,3,3
S01010563,Rented or living rent free: Private rented or living rent free,17,14,8,1,7,4,2,3,0,1,1,1,0
S01010564,All HRPs aged 16 and over,269,135,102,21,81,18,15,134,90,1,5,35,3
S01010564,Owned: Total,95,57,42,6,36,14,1,38,37,0,0,1,0
S01010564,Owned: Owned outright,48,19,11,6,5,7,1,29,28,0,0,1,0
S01010564,Owned: Owned with a mortgage or loan or shared ownership,47,38,31,0,31,7,0,9,9,0,0,0,0
S01010564,Rented or living rent free: Total,174,78,60,15,45,4,14,96,53,1,5,34,3
S01010564,Rented or living rent free: Social rented,160,67,51,14,37,3,13,93,50,1,5,34,3
S01010564,Rented or living rent free: Private rented or living rent free,14,11,9,1,8,1,1,3,3,0,0,0,0
S01010565,All HRPs aged 16 and over,276,160,139,18,121,14,7,116,96,0,8,10,2
S01010565,Owned: Total,193,121,108,12,96,12,1,72,69,0,2,0,1
S01010565,Owned: Owned outright,99,39,36,12,24,2,1,60,57,0,2,0,1
S01010565,Owned: Owned with a mortgage or loan or shared ownership,94,82,72,0,72,10,0,12,12,0,0,0,0
S01010565,Rented or living rent free: Total,83,39,31,6,25,2,6,44,27,0,6,10,1
S01010565,Rented or living rent free: Social rented,65,28,20,4,16,2,6,37,22,0,5,9,1
S01010565,Rented or living rent free: Private rented or living rent free,18,11,11,2,9,0,0,7,5,0,1,1,0
S01010566,All HRPs aged 16 and over,453,332,249,33,216,77,6,121,106,3,2,6,4
S01010566,Owned: Total,294,203,142,19,123,61,0,91,83,1,1,2,4
S01010566,Owned: Owned outright,155,73,52,10,42,21,0,82,78,0,0,2,2
S01010566,Owned: Owned with a mortgage or loan or shared ownership,139,130,90,9,81,40,0,9,5,1,1,0,2
S01010566,Rented or living rent free: Total,159,129,107,14,93,16,6,30,23,2,1,4,0
S01010566,Rented or living rent free: Social rented,35,14,11,6,5,0,3,21,15,2,0,4,0
S01010566,Rented or living rent free: Private rented or living rent free,124,115,96,8,88,16,3,9,8,0,1,0,0
S01010567,All HRPs aged 16 and over,379,305,218,25,193,81,6,74,70,0,1,0,3
S01010567,Owned: Total,330,262,190,21,169,70,2,68,65,0,1,0,2
S01010567,Owned: Owned outright,154,94,65,13,52,29,0,60,58,0,1,0,1
S01010567,Owned: Owned with a mortgage or loan or shared ownership,176,168,125,8,117,41,2,8,7,0,0,0,1
S01010567,Rented or living rent free: Total,49,43,28,4,24,11,4,6,5,0,0,0,1
S01010567,Rented or living rent free: Social rented,2,2,2,1,1,0,0,0,0,0,0,0,0
S01010567,Rented or living rent free: Private rented or living rent free,47,41,26,3,23,11,4,6,5,0,0,0,1
S01010568,All HRPs aged 16 and over,391,298,234,28,206,59,5,93,70,1,6,15,1
S01010568,Owned: Total,288,229,174,16,158,53,2,59,56,0,1,2,0
S01010568,Owned: Owned outright,117,67,47,10,37,19,1,50,48,0,1,1,0
S01010568,Owned: Owned with a mortgage or loan or shared ownership,171,162,127,6,121,34,1,9,8,0,0,1,0
S01010568,Rented or living rent free: Total,103,69,60,12,48,6,3,34,14,1,5,13,1
S01010568,Rented or living rent free: Social rented,58,33,30,8,22,0,3,25,7,1,4,12,1
S01010568,Rented or living rent free: Private rented or living rent free,45,36,30,4,26,6,0,9,7,0,1,1,0
S01010569,All HRPs aged 16 and over,295,223,158,16,142,62,3,72,59,0,4,7,2
S01010569,Owned: Total,211,153,102,11,91,51,0,58,51,0,3,2,2
S01010569,Owned: Owned outright,113,62,39,8,31,23,0,51,49,0,0,1,1
S01010569,Owned: Owned with a mortgage or loan or shared ownership,98,91,63,3,60,28,0,7,2,0,3,1,1
S01010569,Rented or living rent free: Total,84,70,56,5,51,11,3,14,8,0,1,5,0
S01010569,Rented or living rent free: Social rented,7,3,3,0,3,0,0,4,0,0,1,3,0
S01010569,Rented or living rent free: Private rented or living rent free,77,67,53,5,48,11,3,10,8,0,0,2,0
S01010570,All HRPs aged 16 and over,467,302,256,42,214,34,12,165,115,1,13,28,8
S01010570,Owned: Total,261,188,155,17,138,30,3,73,66,0,0,4,3
S01010570,Owned: Owned outright,125,62,48,9,39,13,1,63,58,0,0,2,3
S01010570,Owned: Owned with a mortgage or loan or shared ownership,136,126,107,8,99,17,2,10,8,0,0,2,0
S01010570,Rented or living rent free: Total,206,114,101,25,76,4,9,92,49,1,13,24,5
S01010570,Rented or living rent free: Social rented,169,83,74,21,53,1,8,86,43,1,13,24,5
S01010570,Rented or living rent free: Private rented or living rent free,37,31,27,4,23,3,1,6,6,0,0,0,0
S01010571,All HRPs aged 16 and over,398,319,286,38,248,27,6,79,64,0,4,3,8
S01010571,Owned: Total,320,257,230,26,204,26,1,63,58,0,1,1,3
S01010571,Owned: Owned outright,113,59,52,11,41,6,1,54,50,0,1,1,2
S01010571,Owned: Owned with a mortgage or loan or shared ownership,207,198,178,15,163,20,0,9,8,0,0,0,1
S01010571,Rented or living rent free: Total,78,62,56,12,44,1,5,16,6,0,3,2,5
S01010571,Rented or living rent free: Social rented,8,5,5,2,3,0,0,3,0,0,1,0,2
S01010571,Rented or living rent free: Private rented or living rent free,70,57,51,10,41,1,5,13,6,0,2,2,3
S01010572,All HRPs aged 16 and over,336,257,227,41,186,18,12,79,52,3,8,13,3
S01010572,Owned: Total,183,153,139,26,113,11,3,30,28,0,0,2,0
S01010572,Owned: Owned outright,51,29,23,8,15,3,3,22,20,0,0,2,0
S01010572,Owned: Owned with a mortgage or loan or shared ownership,132,124,116,18,98,8,0,8,8,0,0,0,0
S01010572,Rented or living rent free: Total,153,104,88,15,73,7,9,49,24,3,8,11,3
S01010572,Rented or living rent free: Social rented,79,38,28,9,19,4,6,41,21,2,4,11,3
S01010572,Rented or living rent free: Private rented or living rent free,74,66,60,6,54,3,3,8,3,1,4,0,0
S01010573,All HRPs aged 16 and over,222,173,159,21,138,12,2,49,36,3,1,6,3
S01010573,Owned: Total,158,134,125,12,113,9,0,24,22,0,0,1,1
S01010573,Owned: Owned outright,49,27,25,5,20,2,0,22,20,0,0,1,1
S01010573,Owned: Owned with a mortgage or loan or shared ownership,109,107,100,7,93,7,0,2,2,0,0,0,0
S01010573,Rented or living rent free: Total,64,39,34,9,25,3,2,25,14,3,1,5,2
S01010573,Rented or living rent free: Social rented,50,28,24,8,16,3,1,22,13,1,1,5,2
S01010573,Rented or living rent free: Private rented or living rent free,14,11,10,1,9,0,1,3,1,2,0,0,0
S01010574,All HRPs aged 16 and over,236,179,151,12,139,25,3,57,56,0,0,0,1
S01010574,Owned: Total,216,165,140,11,129,23,2,51,51,0,0,0,0
S01010574,Owned: Owned outright,86,40,33,5,28,5,2,46,46,0,0,0,0
S01010574,Owned: Owned with a mortgage or loan or shared ownership,130,125,107,6,101,18,0,5,5,0,0,0,0
S01010574,Rented or living rent free: Total,20,14,11,1,10,2,1,6,5,0,0,0,1
S01010574,Rented or living rent free: Social rented,4,2,1,1,0,1,0,2,2,0,0,0,0
S01010574,Rented or living rent free: Private rented or living rent free,16,12,10,0,10,1,1,4,3,0,0,0,1
S01010575,All HRPs aged 16 and over,284,190,158,24,134,25,7,94,90,0,2,0,2
S01010575,Owned: Total,259,171,143,19,124,23,5,88,86,0,0,0,2
S01010575,Owned: Owned outright,152,69,58,13,45,8,3,83,81,0,0,0,2
S01010575,Owned: Owned with a mortgage or loan or shared ownership,107,102,85,6,79,15,2,5,5,0,0,0,0
S01010575,Rented or living rent free: Total,25,19,15,5,10,2,2,6,4,0,2,0,0
S01010575,Rented or living rent free: Social rented,8,6,5,3,2,0,1,2,1,0,1,0,0
S01010575,Rented or living rent free: Private rented or living rent free,17,13,10,2,8,2,1,4,3,0,1,0,0
S01010576,All HRPs aged 16 and over,326,222,184,29,155,36,2,104,101,1,0,2,0
S01010576,Owned: Total,300,201,165,23,142,34,2,99,96,1,0,2,0
S01010576,Owned: Owned outright,169,80,64,18,46,15,1,89,88,1,0,0,0
S01010576,Owned: Owned with a mortgage or loan or shared ownership,131,121,101,5,96,19,1,10,8,0,0,2,0
S01010576,Rented or living rent free: Total,26,21,19,6,13,2,0,5,5,0,0,0,0
S01010576,Rented or living rent free: Social rented,9,8,8,5,3,0,0,1,1,0,0,0,0
S01010576,Rented or living rent free: Private rented or living rent free,17,13,11,1,10,2,0,4,4,0,0,0,0
S01010577,All HRPs aged 16 and over,354,246,213,47,166,27,6,108,62,4,14,25,3
S01010577,Owned: Total,181,146,122,16,106,22,2,35,30,1,0,3,1
S01010577,Owned: Owned outright,66,37,31,10,21,6,0,29,26,0,0,2,1
S01010577,Owned: Owned with a mortgage or loan or shared ownership,115,109,91,6,85,16,2,6,4,1,0,1,0
S01010577,Rented or living rent free: Total,173,100,91,31,60,5,4,73,32,3,14,22,2
S01010577,Rented or living rent free: Social rented,157,85,77,28,49,4,4,72,31,3,14,22,2
S01010577,Rented or living rent free: Private rented or living rent free,16,15,14,3,11,1,0,1,1,0,0,0,0
S01010578,All HRPs aged 16 and over,203,159,139,26,113,18,2,44,28,1,2,11,2
S01010578,Owned: Total,140,123,106,13,93,17,0,17,12,0,1,3,1
S01010578,Owned: Owned outright,30,21,19,4,15,2,0,9,7,0,0,2,0
S01010578,Owned: Owned with a mortgage or loan or shared ownership,110,102,87,9,78,15,0,8,5,0,1,1,1
S01010578,Rented or living rent free: Total,63,36,33,13,20,1,2,27,16,1,1,8,1
S01010578,Rented or living rent free: Social rented,49,24,23,8,15,0,1,25,16,0,1,7,1
S01010578,Rented or living rent free: Private rented or living rent free,14,12,10,5,5,1,1,2,0,1,0,1,0
S01010579,All HRPs aged 16 and over,325,242,203,20,183,36,3,83,75,3,0,4,1
S01010579,Owned: Total,290,219,182,18,164,34,3,71,67,1,0,3,0
S01010579,Owned: Owned outright,129,69,58,9,49,10,1,60,59,1,0,0,0
S01010579,Owned: Owned with a mortgage or loan or shared ownership,161,150,124,9,115,24,2,11,8,0,0,3,0
S01010579,Rented or living rent free: Total,35,23,21,2,19,2,0,12,8,2,0,1,1
S01010579,Rented or living rent free: Social rented,7,2,2,0,2,0,0,5,4,0,0,1,0
S01010579,Rented or living rent free: Private rented or living rent free,28,21,19,2,17,2,0,7,4,2,0,0,1
S01010580,All HRPs aged 16 and over,305,229,210,19,191,17,2,76,39,7,4,20,6
S01010580,Owned: Total,143,111,104,9,95,7,0,32,30,0,0,2,0
S01010580,Owned: Owned outright,46,18,17,4,13,1,0,28,27,0,0,1,0
S01010580,Owned: Owned with a mortgage or loan or shared ownership,97,93,87,5,82,6,0,4,3,0,0,1,0
S01010580,Rented or living rent free: Total,162,118,106,10,96,10,2,44,9,7,4,18,6
S01010580,Rented or living rent free: Social rented,33,10,9,6,3,1,0,23,5,1,2,13,2
S01010580,Rented or living rent free: Private rented or living rent free,129,108,97,4,93,9,2,21,4,6,2,5,4
S01010581,All HRPs aged 16 and over,243,197,166,22,144,27,4,46,30,2,4,5,5
S01010581,Owned: Total,181,150,126,16,110,24,0,31,26,0,0,4,1
S01010581,Owned: Owned outright,43,23,18,4,14,5,0,20,19,0,0,1,0
S01010581,Owned: Owned with a mortgage or loan or shared ownership,138,127,108,12,96,19,0,11,7,0,0,3,1
S01010581,Rented or living rent free: Total,62,47,40,6,34,3,4,15,4,2,4,1,4
S01010581,Rented or living rent free: Social rented,11,5,2,1,1,1,2,6,1,0,3,0,2
S01010581,Rented or living rent free: Private rented or living rent free,51,42,38,5,33,2,2,9,3,2,1,1,2
S01010582,All HRPs aged 16 and over,185,148,122,16,106,25,1,37,34,0,0,2,1
S01010582,Owned: Total,146,117,91,10,81,25,1,29,28,0,0,0,1
S01010582,Owned: Owned outright,63,36,26,7,19,10,0,27,26,0,0,0,1
S01010582,Owned: Owned with a mortgage or loan or shared ownership,83,81,65,3,62,15,1,2,2,0,0,0,0
S01010582,Rented or living rent free: Total,39,31,31,6,25,0,0,8,6,0,0,2,0
S01010582,Rented or living rent free: Social rented,4,1,1,0,1,0,0,3,1,0,0,2,0
S01010582,Rented or living rent free: Private rented or living rent free,35,30,30,6,24,0,0,5,5,0,0,0,0
S01010583,All HRPs aged 16 and over,440,340,305,41,264,32,3,100,95,0,1,2,2
S01010583,Owned: Total,367,276,252,32,220,23,1,91,89,0,0,2,0
S01010583,Owned: Owned outright,149,75,70,19,51,5,0,74,74,0,0,0,0
S01010583,Owned: Owned with a mortgage or loan or shared ownership,218,201,182,13,169,18,1,17,15,0,0,2,0
S01010583,Rented or living rent free: Total,73,64,53,9,44,9,2,9,6,0,1,0,2
S01010583,Rented or living rent free: Social rented,4,3,1,1,0,1,1,1,1,0,0,0,0
S01010583,Rented or living rent free: Private rented or living rent free,69,61,52,8,44,8,1,8,5,0,1,0,2
S01010584,All HRPs aged 16 and over,312,262,216,32,184,38,8,50,27,3,3,16,1
S01010584,Owned: Total,229,205,175,19,156,29,1,24,21,1,0,1,1
S01010584,Owned: Owned outright,64,45,39,13,26,6,0,19,19,0,0,0,0
S01010584,Owned: Owned with a mortgage or loan or shared ownership,165,160,136,6,130,23,1,5,2,1,0,1,1
S01010584,Rented or living rent free: Total,83,57,41,13,28,9,7,26,6,2,3,15,0
S01010584,Rented or living rent free: Social rented,55,32,23,11,12,4,5,23,4,1,3,15,0
S01010584,Rented or living rent free: Private rented or living rent free,28,25,18,2,16,5,2,3,2,1,0,0,0
S01010585,All HRPs aged 16 and over,304,291,244,28,216,41,6,13,6,0,2,4,1
S01010585,Owned: Total,235,228,192,15,177,36,0,7,4,0,2,0,1
S01010585,Owned: Owned outright,27,22,16,5,11,6,0,5,4,0,1,0,0
S01010585,Owned: Owned with a mortgage or loan or shared ownership,208,206,176,10,166,30,0,2,0,0,1,0,1
S01010585,Rented or living rent free: Total,69,63,52,13,39,5,6,6,2,0,0,4,0
S01010585,Rented or living rent free: Social rented,19,16,11,6,5,1,4,3,0,0,0,3,0
S01010585,Rented or living rent free: Private rented or living rent free,50,47,41,7,34,4,2,3,2,0,0,1,0
S01010586,All HRPs aged 16 and over,305,232,197,25,172,33,2,73,72,0,0,1,0
S01010586,Owned: Total,279,210,177,24,153,32,1,69,68,0,0,1,0
S01010586,Owned: Owned outright,115,54,43,12,31,10,1,61,60,0,0,1,0
S01010586,Owned: Owned with a mortgage or loan or shared ownership,164,156,134,12,122,22,0,8,8,0,0,0,0
S01010586,Rented or living rent free: Total,26,22,20,1,19,1,1,4,4,0,0,0,0
S01010586,Rented or living rent free: Social rented,4,3,2,1,1,0,1,1,1,0,0,0,0
S01010586,Rented or living rent free: Private rented or living rent free,22,19,18,0,18,1,0,3,3,0,0,0,0
S01010587,All HRPs aged 16 and over,293,204,164,24,140,36,4,89,85,1,1,2,0
S01010587,Owned: Total,262,181,144,22,122,34,3,81,80,1,0,0,0
S01010587,Owned: Owned outright,134,64,46,14,32,16,2,70,70,0,0,0,0
S01010587,Owned: Owned with a mortgage or loan or shared ownership,128,117,98,8,90,18,1,11,10,1,0,0,0
S01010587,Rented or living rent free: Total,31,23,20,2,18,2,1,8,5,0,1,2,0
S01010587,Rented or living rent free: Social rented,7,4,3,0,3,0,1,3,0,0,1,2,0
S01010587,Rented or living rent free: Private rented or living rent free,24,19,17,2,15,2,0,5,5,0,0,0,0
S01010588,All HRPs aged 16 and over,268,188,164,21,143,21,3,80,63,0,5,10,2
S01010588,Owned: Total,222,153,136,16,120,17,0,69,61,0,4,3,1
S01010588,Owned: Owned outright,105,45,37,5,32,8,0,60,57,0,2,1,0
S01010588,Owned: Owned with a mortgage or loan or shared ownership,117,108,99,11,88,9,0,9,4,0,2,2,1
S01010588,Rented or living rent free: Total,46,35,28,5,23,4,3,11,2,0,1,7,1
S01010588,Rented or living rent free: Social rented,21,11,6,3,3,2,3,10,1,0,1,7,1
S01010588,Rented or living rent free: Private rented or living rent free,25,24,22,2,20,2,0,1,1,0,0,0,0
S01010589,All HRPs aged 16 and over,299,224,205,33,172,13,6,75,41,0,7,23,4
S01010589,Owned: Total,172,149,136,14,122,11,2,23,21,0,0,1,1
S01010589,Owned: Owned outright,39,27,23,4,19,3,1,12,12,0,0,0,0
S01010589,Owned: Owned with a mortgage or loan or shared ownership,133,122,113,10,103,8,1,11,9,0,0,1,1
S01010589,Rented or living rent free: Total,127,75,69,19,50,2,4,52,20,0,7,22,3
S01010589,Rented or living rent free: Social rented,80,38,34,12,22,1,3,42,16,0,4,20,2
S01010589,Rented or living rent free: Private rented or living rent free,47,37,35,7,28,1,1,10,4,0,3,2,1
S01010590,All HRPs aged 16 and over,293,249,207,18,189,41,1,44,40,0,3,0,1
S01010590,Owned: Total,267,229,195,18,177,33,1,38,35,0,3,0,0
S01010590,Owned: Owned outright,89,56,49,10,39,7,0,33,33,0,0,0,0
S01010590,Owned: Owned with a mortgage or loan or shared ownership,178,173,146,8,138,26,1,5,2,0,3,0,0
S01010590,Rented or living rent free: Total,26,20,12,0,12,8,0,6,5,0,0,0,1
S01010590,Rented or living rent free: Social rented,3,2,2,0,2,0,0,1,0,0,0,0,1
S01010590,Rented or living rent free: Private rented or living rent free,23,18,10,0,10,8,0,5,5,0,0,0,0
S01010591,All HRPs aged 16 and over,303,277,242,29,213,23,12,26,14,3,5,4,0
S01010591,Owned: Total,219,207,189,16,173,16,2,12,12,0,0,0,0
S01010591,Owned: Owned outright,27,16,13,2,11,2,1,11,11,0,0,0,0
S01010591,Owned: Owned with a mortgage or loan or shared ownership,192,191,176,14,162,14,1,1,1,0,0,0,0
S01010591,Rented or living rent free: Total,84,70,53,13,40,7,10,14,2,3,5,4,0
S01010591,Rented or living rent free: Social rented,39,28,18,11,7,1,9,11,1,2,4,4,0
S01010591,Rented or living rent free: Private rented or living rent free,45,42,35,2,33,6,1,3,1,1,1,0,0
S01010592,All HRPs aged 16 and over,273,212,191,29,162,16,5,61,44,2,0,11,4
S01010592,Owned: Total,183,137,126,16,110,10,1,46,40,2,0,4,0
S01010592,Owned: Owned outright,69,31,29,7,22,2,0,38,35,2,0,1,0
S01010592,Owned: Owned with a mortgage or loan or shared ownership,114,106,97,9,88,8,1,8,5,0,0,3,0
S01010592,Rented or living rent free: Total,90,75,65,13,52,6,4,15,4,0,0,7,4
S01010592,Rented or living rent free: Social rented,8,2,2,1,1,0,0,6,1,0,0,4,1
S01010592,Rented or living rent free: Private rented or living rent free,82,73,63,12,51,6,4,9,3,0,0,3,3
S01010593,All HRPs aged 16 and over,259,183,149,14,135,33,1,76,72,0,2,1,1
S01010593,Owned: Total,228,163,136,12,124,27,0,65,65,0,0,0,0
S01010593,Owned: Owned outright,99,42,30,5,25,12,0,57,57,0,0,0,0
S01010593,Owned: Owned with a mortgage or loan or shared ownership,129,121,106,7,99,15,0,8,8,0,0,0,0
S01010593,Rented or living rent free: Total,31,20,13,2,11,6,1,11,7,0,2,1,1
S01010593,Rented or living rent free: Social rented,5,2,1,1,0,1,0,3,1,0,0,1,1
S01010593,Rented or living rent free: Private rented or living rent free,26,18,12,1,11,5,1,8,6,0,2,0,0
S01010594,All HRPs aged 16 and over,281,233,202,27,175,28,3,48,37,0,7,3,1
S01010594,Owned: Total,182,147,119,14,105,25,3,35,30,0,2,2,1
S01010594,Owned: Owned outright,57,29,24,5,19,3,2,28,24,0,1,2,1
S01010594,Owned: Owned with a mortgage or loan or shared ownership,125,118,95,9,86,22,1,7,6,0,1,0,0
S01010594,Rented or living rent free: Total,99,86,83,13,70,3,0,13,7,0,5,1,0
S01010594,Rented or living rent free: Social rented,17,12,12,5,7,0,0,5,1,0,4,0,0
S01010594,Rented or living rent free: Private rented or living rent free,82,74,71,8,63,3,0,8,6,0,1,1,0
S01010595,All HRPs aged 16 and over,310,282,252,29,223,25,5,28,15,1,2,7,3
S01010595,Owned: Total,203,186,167,13,154,18,1,17,11,0,1,4,1
S01010595,Owned: Owned outright,31,20,17,3,14,3,0,11,9,0,0,2,0
S01010595,Owned: Owned with a mortgage or loan or shared ownership,172,166,150,10,140,15,1,6,2,0,1,2,1
S01010595,Rented or living rent free: Total,107,96,85,16,69,7,4,11,4,1,1,3,2
S01010595,Rented or living rent free: Social rented,29,22,16,5,11,3,3,7,1,1,1,2,2
S01010595,Rented or living rent free: Private rented or living rent free,78,74,69,11,58,4,1,4,3,0,0,1,0
S01010596,All HRPs aged 16 and over,310,259,205,19,186,53,1,51,38,1,6,1,5
S01010596,Owned: Total,231,198,159,14,145,38,1,33,31,0,0,0,2
S01010596,Owned: Owned outright,85,53,38,8,30,14,1,32,30,0,0,0,2
S01010596,Owned: Owned with a mortgage or loan or shared ownership,146,145,121,6,115,24,0,1,1,0,0,0,0
S01010596,Rented or living rent free: Total,79,61,46,5,41,15,0,18,7,1,6,1,3
S01010596,Rented or living rent free: Social rented,6,2,2,1,1,0,0,4,1,0,2,1,0
S01010596,Rented or living rent free: Private rented or living rent free,73,59,44,4,40,15,0,14,6,1,4,0,3
S01010597,All HRPs aged 16 and over,274,240,201,32,169,32,7,34,15,2,6,10,1
S01010597,Owned: Total,197,183,160,21,139,23,0,14,11,2,1,0,0
S01010597,Owned: Owned outright,27,16,13,4,9,3,0,11,10,0,1,0,0
S01010597,Owned: Owned with a mortgage or loan or shared ownership,170,167,147,17,130,20,0,3,1,2,0,0,0
S01010597,Rented or living rent free: Total,77,57,41,11,30,9,7,20,4,0,5,10,1
S01010597,Rented or living rent free: Social rented,37,22,14,9,5,1,7,15,2,0,3,9,1
S01010597,Rented or living rent free: Private rented or living rent free,40,35,27,2,25,8,0,5,2,0,2,1,0
S01010598,All HRPs aged 16 and over,404,363,313,27,286,45,5,41,20,3,13,2,3
S01010598,Owned: Total,270,254,219,10,209,35,0,16,15,0,1,0,0
S01010598,Owned: Owned outright,47,33,23,3,20,10,0,14,14,0,0,0,0
S01010598,Owned: Owned with a mortgage or loan or shared ownership,223,221,196,7,189,25,0,2,1,0,1,0,0
S01010598,Rented or living rent free: Total,134,109,94,17,77,10,5,25,5,3,12,2,3
S01010598,Rented or living rent free: Social rented,35,19,14,6,8,3,2,16,0,2,10,2,2
S01010598,Rented or living rent free: Private rented or living rent free,99,90,80,11,69,7,3,9,5,1,2,0,1
S01010599,All HRPs aged 16 and over,248,196,176,19,157,16,4,52,47,3,0,1,1
S01010599,Owned: Total,199,151,135,11,124,14,2,48,45,1,0,1,1
S01010599,Owned: Owned outright,81,40,33,7,26,5,2,41,40,1,0,0,0
S01010599,Owned: Owned with a mortgage or loan or shared ownership,118,111,102,4,98,9,0,7,5,0,0,1,1
S01010599,Rented or living rent free: Total,49,45,41,8,33,2,2,4,2,2,0,0,0
S01010599,Rented or living rent free: Social rented,2,2,1,1,0,1,0,0,0,0,0,0,0
S01010599,Rented or living rent free: Private rented or living rent free,47,43,40,7,33,1,2,4,2,2,0,0,0
S01010600,All HRPs aged 16 and over,427,263,215,25,190,43,5,164,149,1,2,7,5
S01010600,Owned: Total,351,214,173,20,153,40,1,137,133,0,1,2,1
S01010600,Owned: Owned outright,183,63,50,16,34,12,1,120,119,0,0,0,1
S01010600,Owned: Owned with a mortgage or loan or shared ownership,168,151,123,4,119,28,0,17,14,0,1,2,0
S01010600,Rented or living rent free: Total,76,49,42,5,37,3,4,27,16,1,1,5,4
S01010600,Rented or living rent free: Social rented,29,8,6,3,3,0,2,21,11,1,1,4,4
S01010600,Rented or living rent free: Private rented or living rent free,47,41,36,2,34,3,2,6,5,0,0,1,0
S01010601,All HRPs aged 16 and over,302,161,141,25,116,17,3,141,129,0,1,9,2
S01010601,Owned: Total,254,131,115,22,93,14,2,123,120,0,1,2,0
S01010601,Owned: Owned outright,171,58,48,17,31,8,2,113,110,0,1,2,0
S01010601,Owned: Owned with a mortgage or loan or shared ownership,83,73,67,5,62,6,0,10,10,0,0,0,0
S01010601,Rented or living rent free: Total,48,30,26,3,23,3,1,18,9,0,0,7,2
S01010601,Rented or living rent free: Social rented,19,9,8,1,7,0,1,10,3,0,0,5,2
S01010601,Rented or living rent free: Private rented or living rent free,29,21,18,2,16,3,0,8,6,0,0,2,0
S01010602,All HRPs aged 16 and over,260,200,171,23,148,22,7,60,53,1,0,6,0
S01010602,Owned: Total,214,159,139,20,119,17,3,55,51,1,0,3,0
S01010602,Owned: Owned outright,89,41,35,12,23,5,1,48,46,0,0,2,0
S01010602,Owned: Owned with a mortgage or loan or shared ownership,125,118,104,8,96,12,2,7,5,1,0,1,0
S01010602,Rented or living rent free: Total,46,41,32,3,29,5,4,5,2,0,0,3,0
S01010602,Rented or living rent free: Social rented,3,1,1,1,0,0,0,2,1,0,0,1,0
S01010602,Rented or living rent free: Private rented or living rent free,43,40,31,2,29,5,4,3,1,0,0,2,0
S01010603,All HRPs aged 16 and over,369,250,212,26,186,28,10,119,110,1,3,4,1
S01010603,Owned: Total,316,203,170,21,149,26,7,113,108,1,2,1,1
S01010603,Owned: Owned outright,190,83,67,17,50,12,4,107,104,1,1,0,1
S01010603,Owned: Owned with a mortgage or loan or shared ownership,126,120,103,4,99,14,3,6,4,0,1,1,0
S01010603,Rented or living rent free: Total,53,47,42,5,37,2,3,6,2,0,1,3,0
S01010603,Rented or living rent free: Social rented,9,6,4,2,2,0,2,3,0,0,1,2,0
S01010603,Rented or living rent free: Private rented or living rent free,44,41,38,3,35,2,1,3,2,0,0,1,0
S01010604,All HRPs aged 16 and over,193,137,115,14,101,19,3,56,51,1,1,2,1
S01010604,Owned: Total,181,129,107,14,93,19,3,52,50,1,1,0,0
S01010604,Owned: Owned outright,85,36,30,9,21,3,3,49,47,1,1,0,0
S01010604,Owned: Owned with a mortgage or loan or shared ownership,96,93,77,5,72,16,0,3,3,0,0,0,0
S01010604,Rented or living rent free: Total,12,8,8,0,8,0,0,4,1,0,0,2,1
S01010604,Rented or living rent free: Social rented,2,0,0,0,0,0,0,2,0,0,0,1,1
S01010604,Rented or living rent free: Private rented or living rent free,10,8,8,0,8,0,0,2,1,0,0,1,0
S01010605,All HRPs aged 16 and over,387,237,188,20,168,48,1,150,141,1,3,2,3
S01010605,Owned: Total,345,207,163,17,146,44,0,138,132,1,2,1,2
S01010605,Owned: Owned outright,212,81,57,10,47,24,0,131,126,0,2,1,2
S01010605,Owned: Owned with a mortgage or loan or shared ownership,133,126,106,7,99,20,0,7,6,1,0,0,0
S01010605,Rented or living rent free: Total,42,30,25,3,22,4,1,12,9,0,1,1,1
S01010605,Rented or living rent free: Social rented,7,2,1,0,1,1,0,5,3,0,1,1,0
S01010605,Rented or living rent free: Private rented or living rent free,35,28,24,3,21,3,1,7,6,0,0,0,1
S01010606,All HRPs aged 16 and over,371,233,194,36,158,32,7,138,111,4,8,14,1
S01010606,Owned: Total,227,146,123,18,105,23,0,81,78,0,2,1,0
S01010606,Owned: Owned outright,114,41,37,10,27,4,0,73,71,0,2,0,0
S01010606,Owned: Owned with a mortgage or loan or shared ownership,113,105,86,8,78,19,0,8,7,0,0,1,0
S01010606,Rented or living rent free: Total,144,87,71,18,53,9,7,57,33,4,6,13,1
S01010606,Rented or living rent free: Social rented,98,50,39,13,26,5,6,48,28,1,6,12,1
S01010606,Rented or living rent free: Private rented or living rent free,46,37,32,5,27,4,1,9,5,3,0,1,0
S01010607,All HRPs aged 16 and over,346,238,191,22,169,43,4,108,104,2,0,1,1
S01010607,Owned: Total,301,195,156,20,136,35,4,106,102,2,0,1,1
S01010607,Owned: Owned outright,155,60,41,12,29,16,3,95,92,2,0,1,0
S01010607,Owned: Owned with a mortgage or loan or shared ownership,146,135,115,8,107,19,1,11,10,0,0,0,1
S01010607,Rented or living rent free: Total,45,43,35,2,33,8,0,2,2,0,0,0,0
S01010607,Rented or living rent free: Social rented,4,4,1,0,1,3,0,0,0,0,0,0,0
S01010607,Rented or living rent free: Private rented or living rent free,41,39,34,2,32,5,0,2,2,0,0,0,0
S01010608,All HRPs aged 16 and over,306,196,166,44,122,9,21,110,58,5,15,25,7
S01010608,Owned: Total,118,78,69,10,59,7,2,40,37,0,0,1,2
S01010608,Owned: Owned outright,50,15,10,5,5,4,1,35,33,0,0,0,2
S01010608,Owned: Owned with a mortgage or loan or shared ownership,68,63,59,5,54,3,1,5,4,0,0,1,0
S01010608,Rented or living rent free: Total,188,118,97,34,63,2,19,70,21,5,15,24,5
S01010608,Rented or living rent free: Social rented,156,90,69,28,41,2,19,66,18,5,15,23,5
S01010608,Rented or living rent free: Private rented or living rent free,32,28,28,6,22,0,0,4,3,0,0,1,0
S01010609,All HRPs aged 16 and over,242,171,153,33,120,15,3,71,52,2,5,11,1
S01010609,Owned: Total,138,107,94,8,86,11,2,31,29,0,1,1,0
S01010609,Owned: Owned outright,53,27,19,2,17,7,1,26,26,0,0,0,0
S01010609,Owned: Owned with a mortgage or loan or shared ownership,85,80,75,6,69,4,1,5,3,0,1,1,0
S01010609,Rented or living rent free: Total,104,64,59,25,34,4,1,40,23,2,4,10,1
S01010609,Rented or living rent free: Social rented,83,48,45,22,23,2,1,35,20,2,3,9,1
S01010609,Rented or living rent free: Private rented or living rent free,21,16,14,3,11,2,0,5,3,0,1,1,0
S01010610,All HRPs aged 16 and over,318,182,148,17,131,28,6,136,123,1,1,6,5
S01010610,Owned: Total,261,143,116,16,100,25,2,118,110,1,1,3,3
S01010610,Owned: Owned outright,175,64,52,13,39,11,1,111,104,1,1,3,2
S01010610,Owned: Owned with a mortgage or loan or shared ownership,86,79,64,3,61,14,1,7,6,0,0,0,1
S01010610,Rented or living rent free: Total,57,39,32,1,31,3,4,18,13,0,0,3,2
S01010610,Rented or living rent free: Social rented,15,3,1,0,1,0,2,12,9,0,0,2,1
S01010610,Rented or living rent free: Private rented or living rent free,42,36,31,1,30,3,2,6,4,0,0,1,1
S01010611,All HRPs aged 16 and over,496,355,315,48,267,27,13,141,108,4,5,22,2
S01010611,Owned: Total,310,239,216,28,188,22,1,71,64,1,1,4,1
S01010611,Owned: Owned outright,109,54,45,16,29,8,1,55,53,0,0,2,0
S01010611,Owned: Owned with a mortgage or loan or shared ownership,201,185,171,12,159,14,0,16,11,1,1,2,1
S01010611,Rented or living rent free: Total,186,116,99,20,79,5,12,70,44,3,4,18,1
S01010611,Rented or living rent free: Social rented,107,46,41,12,29,1,4,61,39,3,4,14,1
S01010611,Rented or living rent free: Private rented or living rent free,79,70,58,8,50,4,8,9,5,0,0,4,0
S01010612,All HRPs aged 16 and over,316,227,198,36,162,22,7,89,76,0,6,7,0
S01010612,Owned: Total,240,179,158,23,135,21,0,61,59,0,0,2,0
S01010612,Owned: Owned outright,100,47,39,14,25,8,0,53,51,0,0,2,0
S01010612,Owned: Owned with a mortgage or loan or shared ownership,140,132,119,9,110,13,0,8,8,0,0,0,0
S01010612,Rented or living rent free: Total,76,48,40,13,27,1,7,28,17,0,6,5,0
S01010612,Rented or living rent free: Social rented,45,22,19,8,11,0,3,23,15,0,5,3,0
S01010612,Rented or living rent free: Private rented or living rent free,31,26,21,5,16,1,4,5,2,0,1,2,0
S01010613,All HRPs aged 16 and over,341,190,166,32,134,19,5,151,120,3,8,14,6
S01010613,Owned: Total,181,120,102,15,87,14,4,61,58,0,1,1,1
S01010613,Owned: Owned outright,106,49,41,11,30,4,4,57,56,0,1,0,0
S01010613,Owned: Owned with a mortgage or loan or shared ownership,75,71,61,4,57,10,0,4,2,0,0,1,1
S01010613,Rented or living rent free: Total,160,70,64,17,47,5,1,90,62,3,7,13,5
S01010613,Rented or living rent free: Social rented,120,39,35,15,20,4,0,81,56,1,7,13,4
S01010613,Rented or living rent free: Private rented or living rent free,40,31,29,2,27,1,1,9,6,2,0,0,1
S01010614,All HRPs aged 16 and over,264,168,145,32,113,11,12,96,67,1,5,19,4
S01010614,Owned: Total,122,93,82,11,71,7,4,29,27,0,0,2,0
S01010614,Owned: Owned outright,44,21,16,3,13,3,2,23,23,0,0,0,0
S01010614,Owned: Owned with a mortgage or loan or shared ownership,78,72,66,8,58,4,2,6,4,0,0,2,0
S01010614,Rented or living rent free: Total,142,75,63,21,42,4,8,67,40,1,5,17,4
S01010614,Rented or living rent free: Social rented,117,57,47,17,30,2,8,60,39,1,3,15,2
S01010614,Rented or living rent free: Private rented or living rent free,25,18,16,4,12,2,0,7,1,0,2,2,2
S01010615,All HRPs aged 16 and over,383,314,276,32,244,26,12,69,43,2,9,13,2
S01010615,Owned: Total,244,207,189,20,169,17,1,37,32,1,3,1,0
S01010615,Owned: Owned outright,70,43,40,11,29,2,1,27,26,0,1,0,0
S01010615,Owned: Owned with a mortgage or loan or shared ownership,174,164,149,9,140,15,0,10,6,1,2,1,0
S01010615,Rented or living rent free: Total,139,107,87,12,75,9,11,32,11,1,6,12,2
S01010615,Rented or living rent free: Social rented,36,19,12,6,6,1,6,17,7,0,0,10,0
S01010615,Rented or living rent free: Private rented or living rent free,103,88,75,6,69,8,5,15,4,1,6,2,2
S01010616,All HRPs aged 16 and over,359,236,211,34,177,25,0,123,117,1,0,3,2
S01010616,Owned: Total,316,202,181,26,155,21,0,114,110,1,0,1,2
S01010616,Owned: Owned outright,177,67,60,15,45,7,0,110,107,0,0,1,2
S01010616,Owned: Owned with a mortgage or loan or shared ownership,139,135,121,11,110,14,0,4,3,1,0,0,0
S01010616,Rented or living rent free: Total,43,34,30,8,22,4,0,9,7,0,0,2,0
S01010616,Rented or living rent free: Social rented,6,4,3,0,3,1,0,2,0,0,0,2,0
S01010616,Rented or living rent free: Private rented or living rent free,37,30,27,8,19,3,0,7,7,0,0,0,0
S01010617,All HRPs aged 16 and over,360,276,244,29,215,29,3,84,81,1,0,1,1
S01010617,Owned: Total,319,243,218,23,195,24,1,76,75,0,0,1,0
S01010617,Owned: Owned outright,160,86,76,15,61,10,0,74,74,0,0,0,0
S01010617,Owned: Owned with a mortgage or loan or shared ownership,159,157,142,8,134,14,1,2,1,0,0,1,0
S01010617,Rented or living rent free: Total,41,33,26,6,20,5,2,8,6,1,0,0,1
S01010617,Rented or living rent free: Social rented,6,4,4,2,2,0,0,2,1,0,0,0,1
S01010617,Rented or living rent free: Private rented or living rent free,35,29,22,4,18,5,2,6,5,1,0,0,0
S01010618,All HRPs aged 16 and over,307,252,215,33,182,34,3,55,48,0,1,4,2
S01010618,Owned: Total,276,228,195,28,167,30,3,48,44,0,0,3,1
S01010618,Owned: Owned outright,113,73,61,18,43,10,2,40,38,0,0,1,1
S01010618,Owned: Owned with a mortgage or loan or shared ownership,163,155,134,10,124,20,1,8,6,0,0,2,0
S01010618,Rented or living rent free: Total,31,24,20,5,15,4,0,7,4,0,1,1,1
S01010618,Rented or living rent free: Social rented,6,3,3,2,1,0,0,3,1,0,0,1,1
S01010618,Rented or living rent free: Private rented or living rent free,25,21,17,3,14,4,0,4,3,0,1,0,0
S01010619,All HRPs aged 16 and over,318,250,214,31,183,21,15,68,25,7,7,16,13
S01010619,Owned: Total,131,113,97,8,89,15,1,18,16,0,0,1,1
S01010619,Owned: Owned outright,43,31,30,4,26,1,0,12,11,0,0,1,0
S01010619,Owned: Owned with a mortgage or loan or shared ownership,88,82,67,4,63,14,1,6,5,0,0,0,1
S01010619,Rented or living rent free: Total,187,137,117,23,94,6,14,50,9,7,7,15,12
S01010619,Rented or living rent free: Social rented,81,50,37,13,24,2,11,31,2,1,5,13,10
S01010619,Rented or living rent free: Private rented or living rent free,106,87,80,10,70,4,3,19,7,6,2,2,2
S01010620,All HRPs aged 16 and over,369,288,210,35,175,20,58,81,21,9,7,29,15
S01010620,Owned: Total,82,62,46,5,41,15,1,20,13,1,0,2,4
S01010620,Owned: Owned outright,34,20,13,3,10,6,1,14,11,0,0,1,2
S01010620,Owned: Owned with a mortgage or loan or shared ownership,48,42,33,2,31,9,0,6,2,1,0,1,2
S01010620,Rented or living rent free: Total,287,226,164,30,134,5,57,61,8,8,7,27,11
S01010620,Rented or living rent free: Social rented,125,78,33,11,22,0,45,47,6,6,7,20,8
S01010620,Rented or living rent free: Private rented or living rent free,162,148,131,19,112,5,12,14,2,2,0,7,3
S01010621,All HRPs aged 16 and over,432,309,242,27,215,51,16,123,80,7,7,24,5
S01010621,Owned: Total,256,183,147,16,131,32,4,73,66,0,1,5,1
S01010621,Owned: Owned outright,121,56,45,5,40,10,1,65,59,0,1,5,0
S01010621,Owned: Owned with a mortgage or loan or shared ownership,135,127,102,11,91,22,3,8,7,0,0,0,1
S01010621,Rented or living rent free: Total,176,126,95,11,84,19,12,50,14,7,6,19,4
S01010621,Rented or living rent free: Social rented,51,23,14,4,10,2,7,28,8,1,4,13,2
S01010621,Rented or living rent free: Private rented or living rent free,125,103,81,7,74,17,5,22,6,6,2,6,2
S01010622,All HRPs aged 16 and over,333,219,178,50,128,19,22,114,70,4,13,20,7
S01010622,Owned: Total,145,100,86,16,70,11,3,45,42,0,0,1,2
S01010622,Owned: Owned outright,67,28,21,9,12,6,1,39,37,0,0,0,2
S01010622,Owned: Owned with a mortgage or loan or shared ownership,78,72,65,7,58,5,2,6,5,0,0,1,0
S01010622,Rented or living rent free: Total,188,119,92,34,58,8,19,69,28,4,13,19,5
S01010622,Rented or living rent free: Social rented,135,79,54,31,23,7,18,56,23,1,10,17,5
S01010622,Rented or living rent free: Private rented or living rent free,53,40,38,3,35,1,1,13,5,3,3,2,0
S01010623,All HRPs aged 16 and over,278,244,220,24,196,15,9,34,14,1,6,9,4
S01010623,Owned: Total,70,58,46,7,39,12,0,12,10,0,1,1,0
S01010623,Owned: Owned outright,36,24,19,2,17,5,0,12,10,0,1,1,0
S01010623,Owned: Owned with a mortgage or loan or shared ownership,34,34,27,5,22,7,0,0,0,0,0,0,0
S01010623,Rented or living rent free: Total,208,186,174,17,157,3,9,22,4,1,5,8,4
S01010623,Rented or living rent free: Social rented,54,44,35,6,29,1,8,10,2,1,1,4,2
S01010623,Rented or living rent free: Private rented or living rent free,154,142,139,11,128,2,1,12,2,0,4,4,2
S01010624,All HRPs aged 16 and over,244,162,142,23,119,12,8,82,54,2,3,20,3
S01010624,Owned: Total,149,99,89,14,75,10,0,50,43,0,0,7,0
S01010624,Owned: Owned outright,62,23,19,7,12,4,0,39,36,0,0,3,0
S01010624,Owned: Owned with a mortgage or loan or shared ownership,87,76,70,7,63,6,0,11,7,0,0,4,0
S01010624,Rented or living rent free: Total,95,63,53,9,44,2,8,32,11,2,3,13,3
S01010624,Rented or living rent free: Social rented,53,23,15,4,11,0,8,30,11,1,3,13,2
S01010624,Rented or living rent free: Private rented or living rent free,42,40,38,5,33,2,0,2,0,1,0,0,1
S01010625,All HRPs aged 16 and over,333,200,151,26,125,48,1,133,126,0,2,4,1
S01010625,Owned: Total,292,166,123,24,99,43,0,126,123,0,2,0,1
S01010625,Owned: Owned outright,194,71,55,13,42,16,0,123,120,0,2,0,1
S01010625,Owned: Owned with a mortgage or loan or shared ownership,98,95,68,11,57,27,0,3,3,0,0,0,0
S01010625,Rented or living rent free: Total,41,34,28,2,26,5,1,7,3,0,0,4,0
S01010625,Rented or living rent free: Social rented,6,4,2,1,1,2,0,2,1,0,0,1,0
S01010625,Rented or living rent free: Private rented or living rent free,35,30,26,1,25,3,1,5,2,0,0,3,0
S01010626,All HRPs aged 16 and over,368,211,156,29,127,49,6,157,149,0,0,7,1
S01010626,Owned: Total,318,178,130,20,110,45,3,140,137,0,0,2,1
S01010626,Owned: Owned outright,212,79,50,10,40,28,1,133,130,0,0,2,1
S01010626,Owned: Owned with a mortgage or loan or shared ownership,106,99,80,10,70,17,2,7,7,0,0,0,0
S01010626,Rented or living rent free: Total,50,33,26,9,17,4,3,17,12,0,0,5,0
S01010626,Rented or living rent free: Social rented,19,7,5,3,2,0,2,12,8,0,0,4,0
S01010626,Rented or living rent free: Private rented or living rent free,31,26,21,6,15,4,1,5,4,0,0,1,0
S01010627,All HRPs aged 16 and over,401,279,226,31,195,43,10,122,93,5,9,10,5
S01010627,Owned: Total,235,167,123,13,110,40,4,68,63,1,2,0,2
S01010627,Owned: Owned outright,128,65,48,10,38,14,3,63,59,1,2,0,1
S01010627,Owned: Owned with a mortgage or loan or shared ownership,107,102,75,3,72,26,1,5,4,0,0,0,1
S01010627,Rented or living rent free: Total,166,112,103,18,85,3,6,54,30,4,7,10,3
S01010627,Rented or living rent free: Social rented,40,10,9,3,6,0,1,30,23,0,3,3,1
S01010627,Rented or living rent free: Private rented or living rent free,126,102,94,15,79,3,5,24,7,4,4,7,2
S01010628,All HRPs aged 16 and over,472,322,274,29,245,40,8,150,135,4,2,5,4
S01010628,Owned: Total,317,197,163,14,149,31,3,120,120,0,0,0,0
S01010628,Owned: Owned outright,159,44,34,7,27,8,2,115,115,0,0,0,0
S01010628,Owned: Owned with a mortgage or loan or shared ownership,158,153,129,7,122,23,1,5,5,0,0,0,0
S01010628,Rented or living rent free: Total,155,125,111,15,96,9,5,30,15,4,2,5,4
S01010628,Rented or living rent free: Social rented,16,7,3,1,2,2,2,9,4,0,1,3,1
S01010628,Rented or living rent free: Private rented or living rent free,139,118,108,14,94,7,3,21,11,4,1,2,3
S01010629,All HRPs aged 16 and over,445,265,200,37,163,57,8,180,156,4,2,10,8
S01010629,Owned: Total,278,171,117,21,96,51,3,107,100,0,0,3,4
S01010629,Owned: Owned outright,155,56,40,10,30,15,1,99,95,0,0,1,3
S01010629,Owned: Owned with a mortgage or loan or shared ownership,123,115,77,11,66,36,2,8,5,0,0,2,1
S01010629,Rented or living rent free: Total,167,94,83,16,67,6,5,73,56,4,2,7,4
S01010629,Rented or living rent free: Social rented,80,20,16,7,9,3,1,60,51,0,0,6,3
S01010629,Rented or living rent free: Private rented or living rent free,87,74,67,9,58,3,4,13,5,4,2,1,1
S01010630,All HRPs aged 16 and over,252,178,145,26,119,24,9,74,40,2,8,16,8
S01010630,Owned: Total,129,103,83,8,75,19,1,26,24,0,0,1,1
S01010630,Owned: Owned outright,56,32,20,3,17,11,1,24,22,0,0,1,1
S01010630,Owned: Owned with a mortgage or loan or shared ownership,73,71,63,5,58,8,0,2,2,0,0,0,0
S01010630,Rented or living rent free: Total,123,75,62,18,44,5,8,48,16,2,8,15,7
S01010630,Rented or living rent free: Social rented,94,49,39,15,24,2,8,45,15,2,8,15,5
S01010630,Rented or living rent free: Private rented or living rent free,29,26,23,3,20,3,0,3,1,0,0,0,2
S01010631,All HRPs aged 16 and over,326,215,182,28,154,25,8,111,85,4,2,13,7
S01010631,Owned: Total,164,92,76,8,68,15,1,72,70,1,0,1,0
S01010631,Owned: Owned outright,90,21,16,2,14,5,0,69,67,1,0,1,0
S01010631,Owned: Owned with a mortgage or loan or shared ownership,74,71,60,6,54,10,1,3,3,0,0,0,0
S01010631,Rented or living rent free: Total,162,123,106,20,86,10,7,39,15,3,2,12,7
S01010631,Rented or living rent free: Social rented,56,24,21,11,10,1,2,32,11,1,2,11,7
S01010631,Rented or living rent free: Private rented or living rent free,106,99,85,9,76,9,5,7,4,2,0,1,0
S01010632,All HRPs aged 16 and over,486,261,215,43,172,34,12,225,182,5,4,27,7
S01010632,Owned: Total,279,158,127,19,108,28,3,121,107,0,3,7,4
S01010632,Owned: Owned outright,145,46,39,12,27,7,0,99,93,0,1,2,3
S01010632,Owned: Owned with a mortgage or loan or shared ownership,134,112,88,7,81,21,3,22,14,0,2,5,1
S01010632,Rented or living rent free: Total,207,103,88,24,64,6,9,104,75,5,1,20,3
S01010632,Rented or living rent free: Social rented,140,49,37,17,20,5,7,91,67,4,1,17,2
S01010632,Rented or living rent free: Private rented or living rent free,67,54,51,7,44,1,2,13,8,1,0,3,1
S01010633,All HRPs aged 16 and over,476,265,228,49,179,21,16,211,154,2,21,30,4
S01010633,Owned: Total,217,131,121,13,108,9,1,86,79,0,1,4,2
S01010633,Owned: Owned outright,106,32,29,6,23,3,0,74,71,0,0,3,0
S01010633,Owned: Owned with a mortgage or loan or shared ownership,111,99,92,7,85,6,1,12,8,0,1,1,2
S01010633,Rented or living rent free: Total,259,134,107,36,71,12,15,125,75,2,20,26,2
S01010633,Rented or living rent free: Social rented,221,107,85,32,53,8,14,114,65,2,19,26,2
S01010633,Rented or living rent free: Private rented or living rent free,38,27,22,4,18,4,1,11,10,0,1,0,0
S01010634,All HRPs aged 16 and over,264,161,135,34,101,22,4,103,82,1,3,14,3
S01010634,Owned: Total,160,97,84,17,67,12,1,63,59,1,0,2,1
S01010634,Owned: Owned outright,83,30,27,9,18,2,1,53,50,1,0,1,1
S01010634,Owned: Owned with a mortgage or loan or shared ownership,77,67,57,8,49,10,0,10,9,0,0,1,0
S01010634,Rented or living rent free: Total,104,64,51,17,34,10,3,40,23,0,3,12,2
S01010634,Rented or living rent free: Social rented,80,45,36,12,24,6,3,35,20,0,3,12,0
S01010634,Rented or living rent free: Private rented or living rent free,24,19,15,5,10,4,0,5,3,0,0,0,2
S01010635,All HRPs aged 16 and over,351,203,165,36,129,24,14,148,115,3,10,16,4
S01010635,Owned: Total,179,128,108,21,87,16,4,51,49,0,1,0,1
S01010635,Owned: Owned outright,88,41,31,13,18,7,3,47,46,0,0,0,1
S01010635,Owned: Owned with a mortgage or loan or shared ownership,91,87,77,8,69,9,1,4,3,0,1,0,0
S01010635,Rented or living rent free: Total,172,75,57,15,42,8,10,97,66,3,9,16,3
S01010635,Rented or living rent free: Social rented,140,50,35,14,21,6,9,90,61,3,8,15,3
S01010635,Rented or living rent free: Private rented or living rent free,32,25,22,1,21,2,1,7,5,0,1,1,0
S01010636,All HRPs aged 16 and over,386,260,215,33,182,42,3,126,110,1,4,8,3
S01010636,Owned: Total,292,195,155,26,129,40,0,97,90,0,1,4,2
S01010636,Owned: Owned outright,137,54,39,12,27,15,0,83,78,0,0,3,2
S01010636,Owned: Owned with a mortgage or loan or shared ownership,155,141,116,14,102,25,0,14,12,0,1,1,0
S01010636,Rented or living rent free: Total,94,65,60,7,53,2,3,29,20,1,3,4,1
S01010636,Rented or living rent free: Social rented,29,15,14,4,10,0,1,14,8,1,1,3,1
S01010636,Rented or living rent free: Private rented or living rent free,65,50,46,3,43,2,2,15,12,0,2,1,0
S01010637,All HRPs aged 16 and over,352,218,182,25,157,20,16,134,103,3,2,21,5
S01010637,Owned: Total,119,86,68,8,60,10,8,33,33,0,0,0,0
S01010637,Owned: Owned outright,53,24,17,2,15,0,7,29,29,0,0,0,0
S01010637,Owned: Owned with a mortgage or loan or shared ownership,66,62,51,6,45,10,1,4,4,0,0,0,0
S01010637,Rented or living rent free: Total,233,132,114,17,97,10,8,101,70,3,2,21,5
S01010637,Rented or living rent free: Social rented,127,38,32,10,22,0,6,89,64,1,2,17,5
S01010637,Rented or living rent free: Private rented or living rent free,106,94,82,7,75,10,2,12,6,2,0,4,0
S01010638,All HRPs aged 16 and over,417,211,170,28,142,35,6,206,172,2,6,21,5
S01010638,Owned: Total,240,135,106,16,90,28,1,105,99,0,0,3,3
S01010638,Owned: Owned outright,137,51,39,9,30,12,0,86,83,0,0,0,3
S01010638,Owned: Owned with a mortgage or loan or shared ownership,103,84,67,7,60,16,1,19,16,0,0,3,0
S01010638,Rented or living rent free: Total,177,76,64,12,52,7,5,101,73,2,6,18,2
S01010638,Rented or living rent free: Social rented,111,27,22,8,14,3,2,84,68,0,3,11,2
S01010638,Rented or living rent free: Private rented or living rent free,66,49,42,4,38,4,3,17,5,2,3,7,0
S01010639,All HRPs aged 16 and over,555,364,313,63,250,28,23,191,113,6,21,39,12
S01010639,Owned: Total,251,172,151,22,129,19,2,79,64,4,0,6,5
S01010639,Owned: Owned outright,111,44,37,7,30,6,1,67,56,4,0,5,2
S01010639,Owned: Owned with a mortgage or loan or shared ownership,140,128,114,15,99,13,1,12,8,0,0,1,3
S01010639,Rented or living rent free: Total,304,192,162,41,121,9,21,112,49,2,21,33,7
S01010639,Rented or living rent free: Social rented,194,93,67,24,43,6,20,101,44,2,20,28,7
S01010639,Rented or living rent free: Private rented or living rent free,110,99,95,17,78,3,1,11,5,0,1,5,0
S01010640,All HRPs aged 16 and over,411,325,261,45,216,50,14,86,58,5,3,17,3
S01010640,Owned: Total,192,149,114,20,94,33,2,43,37,2,2,2,0
S01010640,Owned: Owned outright,73,39,27,7,20,12,0,34,32,0,1,1,0
S01010640,Owned: Owned with a mortgage or loan or shared ownership,119,110,87,13,74,21,2,9,5,2,1,1,0
S01010640,Rented or living rent free: Total,219,176,147,25,122,17,12,43,21,3,1,15,3
S01010640,Rented or living rent free: Social rented,44,20,15,9,6,1,4,24,6,2,1,14,1
S01010640,Rented or living rent free: Private rented or living rent free,175,156,132,16,116,16,8,19,15,1,0,1,2
S01010641,All HRPs aged 16 and over,531,332,270,63,207,23,39,199,93,3,14,77,12
S01010641,Owned: Total,137,104,88,11,77,11,5,33,26,1,1,4,1
S01010641,Owned: Owned outright,45,22,19,4,15,2,1,23,20,0,1,1,1
S01010641,Owned: Owned with a mortgage or loan or shared ownership,92,82,69,7,62,9,4,10,6,1,0,3,0
S01010641,Rented or living rent free: Total,394,228,182,52,130,12,34,166,67,2,13,73,11
S01010641,Rented or living rent free: Social rented,323,168,131,44,87,6,31,155,63,2,13,69,8
S01010641,Rented or living rent free: Private rented or living rent free,71,60,51,8,43,6,3,11,4,0,0,4,3
S01010642,All HRPs aged 16 and over,451,288,231,68,163,17,40,163,84,3,24,36,16
S01010642,Owned: Total,156,109,94,13,81,12,3,47,43,0,1,2,1
S01010642,Owned: Owned outright,61,27,22,6,16,4,1,34,33,0,1,0,0
S01010642,Owned: Owned with a mortgage or loan or shared ownership,95,82,72,7,65,8,2,13,10,0,0,2,1
S01010642,Rented or living rent free: Total,295,179,137,55,82,5,37,116,41,3,23,34,15
S01010642,Rented or living rent free: Social rented,268,159,120,53,67,4,35,109,40,3,21,33,12
S01010642,Rented or living rent free: Private rented or living rent free,27,20,17,2,15,1,2,7,1,0,2,1,3
S01010643,All HRPs aged 16 and over,287,201,160,50,110,14,27,86,26,2,20,32,6
S01010643,Owned: Total,67,50,44,11,33,4,2,17,14,0,0,2,1
S01010643,Owned: Owned outright,26,15,11,4,7,2,2,11,10,0,0,1,0
S01010643,Owned: Owned with a mortgage or loan or shared ownership,41,35,33,7,26,2,0,6,4,0,0,1,1
S01010643,Rented or living rent free: Total,220,151,116,39,77,10,25,69,12,2,20,30,5
S01010643,Rented or living rent free: Social rented,214,145,110,38,72,10,25,69,12,2,20,30,5
S01010643,Rented or living rent free: Private rented or living rent free,6,6,6,1,5,0,0,0,0,0,0,0,0
S01010644,All HRPs aged 16 and over,346,198,151,57,94,10,37,148,58,4,13,60,13
S01010644,Owned: Total,62,45,37,7,30,6,2,17,13,0,1,3,0
S01010644,Owned: Owned outright,26,13,9,3,6,2,2,13,11,0,0,2,0
S01010644,Owned: Owned with a mortgage or loan or shared ownership,36,32,28,4,24,4,0,4,2,0,1,1,0
S01010644,Rented or living rent free: Total,284,153,114,50,64,4,35,131,45,4,12,57,13
S01010644,Rented or living rent free: Social rented,272,146,108,48,60,4,34,126,44,4,11,56,11
S01010644,Rented or living rent free: Private rented or living rent free,12,7,6,2,4,0,1,5,1,0,1,1,2
S01010645,All HRPs aged 16 and over,278,212,186,17,169,22,4,66,53,1,2,8,2
S01010645,Owned: Total,207,157,141,12,129,16,0,50,47,0,2,1,0
S01010645,Owned: Owned outright,83,43,38,8,30,5,0,40,38,0,2,0,0
S01010645,Owned: Owned with a mortgage or loan or shared ownership,124,114,103,4,99,11,0,10,9,0,0,1,0
S01010645,Rented or living rent free: Total,71,55,45,5,40,6,4,16,6,1,0,7,2
S01010645,Rented or living rent free: Social rented,5,2,1,0,1,0,1,3,0,0,0,3,0
S01010645,Rented or living rent free: Private rented or living rent free,66,53,44,5,39,6,3,13,6,1,0,4,2
S01010646,All HRPs aged 16 and over,287,206,179,26,153,22,5,81,70,3,2,4,2
S01010646,Owned: Total,245,174,153,25,128,18,3,71,68,2,0,0,1
S01010646,Owned: Owned outright,130,65,58,18,40,6,1,65,65,0,0,0,0
S01010646,Owned: Owned with a mortgage or loan or shared ownership,115,109,95,7,88,12,2,6,3,2,0,0,1
S01010646,Rented or living rent free: Total,42,32,26,1,25,4,2,10,2,1,2,4,1
S01010646,Rented or living rent free: Social rented,8,1,1,0,1,0,0,7,1,1,1,4,0
S01010646,Rented or living rent free: Private rented or living rent free,34,31,25,1,24,4,2,3,1,0,1,0,1
S01010647,All HRPs aged 16 and over,306,233,197,27,170,27,9,73,65,1,1,3,3
S01010647,Owned: Total,255,197,171,23,148,23,3,58,58,0,0,0,0
S01010647,Owned: Owned outright,120,67,55,16,39,10,2,53,53,0,0,0,0
S01010647,Owned: Owned with a mortgage or loan or shared ownership,135,130,116,7,109,13,1,5,5,0,0,0,0
S01010647,Rented or living rent free: Total,51,36,26,4,22,4,6,15,7,1,1,3,3
S01010647,Rented or living rent free: Social rented,9,3,3,2,1,0,0,6,3,1,1,1,0
S01010647,Rented or living rent free: Private rented or living rent free,42,33,23,2,21,4,6,9,4,0,0,2,3
S01010648,All HRPs aged 16 and over,306,205,173,25,148,24,8,101,66,1,3,22,9
S01010648,Owned: Total,216,158,138,17,121,19,1,58,50,1,0,4,3
S01010648,Owned: Owned outright,97,45,36,5,31,8,1,52,47,0,0,3,2
S01010648,Owned: Owned with a mortgage or loan or shared ownership,119,113,102,12,90,11,0,6,3,1,0,1,1
S01010648,Rented or living rent free: Total,90,47,35,8,27,5,7,43,16,0,3,18,6
S01010648,Rented or living rent free: Social rented,55,17,10,3,7,1,6,38,15,0,3,16,4
S01010648,Rented or living rent free: Private rented or living rent free,35,30,25,5,20,4,1,5,1,0,0,2,2
S01010649,All HRPs aged 16 and over,280,175,148,22,126,24,3,105,98,1,0,3,3
S01010649,Owned: Total,235,137,115,18,97,21,1,98,92,1,0,2,3
S01010649,Owned: Owned outright,142,55,47,8,39,7,1,87,83,0,0,1,3
S01010649,Owned: Owned with a mortgage or loan or shared ownership,93,82,68,10,58,14,0,11,9,1,0,1,0
S01010649,Rented or living rent free: Total,45,38,33,4,29,3,2,7,6,0,0,1,0
S01010649,Rented or living rent free: Social rented,8,4,3,2,1,0,1,4,3,0,0,1,0
S01010649,Rented or living rent free: Private rented or living rent free,37,34,30,2,28,3,1,3,3,0,0,0,0
S01010650,All HRPs aged 16 and over,196,139,109,15,94,25,5,57,35,0,2,16,4
S01010650,Owned: Total,109,86,76,10,66,10,0,23,21,0,0,1,1
S01010650,Owned: Owned outright,30,12,9,2,7,3,0,18,18,0,0,0,0
S01010650,Owned: Owned with a mortgage or loan or shared ownership,79,74,67,8,59,7,0,5,3,0,0,1,1
S01010650,Rented or living rent free: Total,87,53,33,5,28,15,5,34,14,0,2,15,3
S01010650,Rented or living rent free: Social rented,41,12,8,2,6,1,3,29,11,0,1,14,3
S01010650,Rented or living rent free: Private rented or living rent free,46,41,25,3,22,14,2,5,3,0,1,1,0
S01010651,All HRPs aged 16 and over,295,193,160,28,132,24,9,102,71,0,4,25,2
S01010651,Owned: Total,180,138,121,14,107,16,1,42,34,0,0,6,2
S01010651,Owned: Owned outright,65,32,26,4,22,5,1,33,28,0,0,4,1
S01010651,Owned: Owned with a mortgage or loan or shared ownership,115,106,95,10,85,11,0,9,6,0,0,2,1
S01010651,Rented or living rent free: Total,115,55,39,14,25,8,8,60,37,0,4,19,0
S01010651,Rented or living rent free: Social rented,89,33,23,11,12,4,6,56,33,0,4,19,0
S01010651,Rented or living rent free: Private rented or living rent free,26,22,16,3,13,4,2,4,4,0,0,0,0
S01010652,All HRPs aged 16 and over,309,239,199,24,175,25,15,70,53,1,2,11,3
S01010652,Owned: Total,230,178,152,16,136,23,3,52,46,0,1,3,2
S01010652,Owned: Owned outright,89,46,36,8,28,8,2,43,39,0,1,2,1
S01010652,Owned: Owned with a mortgage or loan or shared ownership,141,132,116,8,108,15,1,9,7,0,0,1,1
S01010652,Rented or living rent free: Total,79,61,47,8,39,2,12,18,7,1,1,8,1
S01010652,Rented or living rent free: Social rented,36,25,17,3,14,1,7,11,3,0,1,6,1
S01010652,Rented or living rent free: Private rented or living rent free,43,36,30,5,25,1,5,7,4,1,0,2,0
S01010653,All HRPs aged 16 and over,300,220,189,25,164,28,3,80,71,0,1,6,2
S01010653,Owned: Total,254,186,159,19,140,26,1,68,63,0,1,3,1
S01010653,Owned: Owned outright,120,58,49,12,37,8,1,62,59,0,1,2,0
S01010653,Owned: Owned with a mortgage or loan or shared ownership,134,128,110,7,103,18,0,6,4,0,0,1,1
S01010653,Rented or living rent free: Total,46,34,30,6,24,2,2,12,8,0,0,3,1
S01010653,Rented or living rent free: Social rented,10,7,5,3,2,1,1,3,1,0,0,2,0
S01010653,Rented or living rent free: Private rented or living rent free,36,27,25,3,22,1,1,9,7,0,0,1,1
S01010654,All HRPs aged 16 and over,348,248,207,41,166,27,14,100,69,0,6,22,3
S01010654,Owned: Total,229,185,155,27,128,20,10,44,38,0,0,5,1
S01010654,Owned: Owned outright,75,45,40,8,32,2,3,30,29,0,0,1,0
S01010654,Owned: Owned with a mortgage or loan or shared ownership,154,140,115,19,96,18,7,14,9,0,0,4,1
S01010654,Rented or living rent free: Total,119,63,52,14,38,7,4,56,31,0,6,17,2
S01010654,Rented or living rent free: Social rented,91,41,31,10,21,6,4,50,29,0,4,15,2
S01010654,Rented or living rent free: Private rented or living rent free,28,22,21,4,17,1,0,6,2,0,2,2,0
S01010655,All HRPs aged 16 and over,380,270,170,30,140,97,3,110,101,0,2,6,1
S01010655,Owned: Total,284,207,130,25,105,76,1,77,72,0,1,4,0
S01010655,Owned: Owned outright,154,86,44,13,31,41,1,68,65,0,1,2,0
S01010655,Owned: Owned with a mortgage or loan or shared ownership,130,121,86,12,74,35,0,9,7,0,0,2,0
S01010655,Rented or living rent free: Total,96,63,40,5,35,21,2,33,29,0,1,2,1
S01010655,Rented or living rent free: Social rented,17,10,5,0,5,3,2,7,4,0,1,2,0
S01010655,Rented or living rent free: Private rented or living rent free,79,53,35,5,30,18,0,26,25,0,0,0,1
S01010656,All HRPs aged 16 and over,182,118,85,10,75,28,5,64,51,1,2,9,1
S01010656,Owned: Total,135,91,67,8,59,23,1,44,36,0,1,6,1
S01010656,Owned: Owned outright,64,29,20,4,16,8,1,35,31,0,0,4,0
S01010656,Owned: Owned with a mortgage or loan or shared ownership,71,62,47,4,43,15,0,9,5,0,1,2,1
S01010656,Rented or living rent free: Total,47,27,18,2,16,5,4,20,15,1,1,3,0
S01010656,Rented or living rent free: Social rented,37,20,11,2,9,5,4,17,14,1,0,2,0
S01010656,Rented or living rent free: Private rented or living rent free,10,7,7,0,7,0,0,3,1,0,1,1,0
S01010657,All HRPs aged 16 and over,248,186,124,20,104,55,7,62,49,4,1,3,5
S01010657,Owned: Total,218,167,115,18,97,48,4,51,46,0,1,0,4
S01010657,Owned: Owned outright,127,82,51,14,37,28,3,45,44,0,0,0,1
S01010657,Owned: Owned with a mortgage or loan or shared ownership,91,85,64,4,60,20,1,6,2,0,1,0,3
S01010657,Rented or living rent free: Total,30,19,9,2,7,7,3,11,3,4,0,3,1
S01010657,Rented or living rent free: Social rented,6,4,0,0,0,2,2,2,1,0,0,1,0
S01010657,Rented or living rent free: Private rented or living rent free,24,15,9,2,7,5,1,9,2,4,0,2,1
S01010658,All HRPs aged 16 and over,296,209,156,17,139,48,5,87,71,0,3,7,6
S01010658,Owned: Total,248,174,131,14,117,40,3,74,65,0,1,5,3
S01010658,Owned: Owned outright,156,92,64,10,54,25,3,64,57,0,1,3,3
S01010658,Owned: Owned with a mortgage or loan or shared ownership,92,82,67,4,63,15,0,10,8,0,0,2,0
S01010658,Rented or living rent free: Total,48,35,25,3,22,8,2,13,6,0,2,2,3
S01010658,Rented or living rent free: Social rented,7,3,3,1,2,0,0,4,1,0,0,1,2
S01010658,Rented or living rent free: Private rented or living rent free,41,32,22,2,20,8,2,9,5,0,2,1,1
S01010659,All HRPs aged 16 and over,276,193,139,21,118,48,6,83,74,0,2,5,2
S01010659,Owned: Total,214,149,104,14,90,44,1,65,59,0,2,3,1
S01010659,Owned: Owned outright,131,70,39,6,33,31,0,61,56,0,2,2,1
S01010659,Owned: Owned with a mortgage or loan or shared ownership,83,79,65,8,57,13,1,4,3,0,0,1,0
S01010659,Rented or living rent free: Total,62,44,35,7,28,4,5,18,15,0,0,2,1
S01010659,Rented or living rent free: Social rented,3,1,1,0,1,0,0,2,0,0,0,1,1
S01010659,Rented or living rent free: Private rented or living rent free,59,43,34,7,27,4,5,16,15,0,0,1,0
S01010660,All HRPs aged 16 and over,285,175,132,20,112,40,3,110,95,0,3,8,4
S01010660,Owned: Total,200,124,93,12,81,29,2,76,73,0,0,1,2
S01010660,Owned: Owned outright,108,39,27,6,21,12,0,69,66,0,0,1,2
S01010660,Owned: Owned with a mortgage or loan or shared ownership,92,85,66,6,60,17,2,7,7,0,0,0,0
S01010660,Rented or living rent free: Total,85,51,39,8,31,11,1,34,22,0,3,7,2
S01010660,Rented or living rent free: Social rented,49,23,16,7,9,6,1,26,17,0,2,7,0
S01010660,Rented or living rent free: Private rented or living rent free,36,28,23,1,22,5,0,8,5,0,1,0,2
S01010661,All HRPs aged 16 and over,307,209,168,17,151,34,7,98,82,0,2,10,4
S01010661,Owned: Total,178,126,98,9,89,26,2,52,51,0,0,1,0
S01010661,Owned: Owned outright,99,50,38,8,30,12,0,49,48,0,0,1,0
S01010661,Owned: Owned with a mortgage or loan or shared ownership,79,76,60,1,59,14,2,3,3,0,0,0,0
S01010661,Rented or living rent free: Total,129,83,70,8,62,8,5,46,31,0,2,9,4
S01010661,Rented or living rent free: Social rented,79,41,35,6,29,3,3,38,25,0,2,8,3
S01010661,Rented or living rent free: Private rented or living rent free,50,42,35,2,33,5,2,8,6,0,0,1,1
S01010662,All HRPs aged 16 and over,310,214,165,24,141,48,1,96,81,2,4,5,4
S01010662,Owned: Total,259,182,142,19,123,40,0,77,68,1,2,4,2
S01010662,Owned: Owned outright,107,45,29,7,22,16,0,62,54,0,2,4,2
S01010662,Owned: Owned with a mortgage or loan or shared ownership,152,137,113,12,101,24,0,15,14,1,0,0,0
S01010662,Rented or living rent free: Total,51,32,23,5,18,8,1,19,13,1,2,1,2
S01010662,Rented or living rent free: Social rented,30,16,13,4,9,3,0,14,10,1,1,1,1
S01010662,Rented or living rent free: Private rented or living rent free,21,16,10,1,9,5,1,5,3,0,1,0,1
S01010663,All HRPs aged 16 and over,381,269,187,28,159,80,2,112,104,1,3,4,0
S01010663,Owned: Total,318,228,157,22,135,70,1,90,87,0,2,1,0
S01010663,Owned: Owned outright,177,95,59,12,47,36,0,82,81,0,0,1,0
S01010663,Owned: Owned with a mortgage or loan or shared ownership,141,133,98,10,88,34,1,8,6,0,2,0,0
S01010663,Rented or living rent free: Total,63,41,30,6,24,10,1,22,17,1,1,3,0
S01010663,Rented or living rent free: Social rented,13,9,8,2,6,0,1,4,3,0,0,1,0
S01010663,Rented or living rent free: Private rented or living rent free,50,32,22,4,18,10,0,18,14,1,1,2,0
S01010664,All HRPs aged 16 and over,337,248,165,35,130,79,4,89,79,1,0,9,0
S01010664,Owned: Total,294,217,146,34,112,68,3,77,73,0,0,4,0
S01010664,Owned: Owned outright,176,110,72,23,49,35,3,66,63,0,0,3,0
S01010664,Owned: Owned with a mortgage or loan or shared ownership,118,107,74,11,63,33,0,11,10,0,0,1,0
S01010664,Rented or living rent free: Total,43,31,19,1,18,11,1,12,6,1,0,5,0
S01010664,Rented or living rent free: Social rented,6,2,1,0,1,1,0,4,1,0,0,3,0
S01010664,Rented or living rent free: Private rented or living rent free,37,29,18,1,17,10,1,8,5,1,0,2,0
S01010665,All HRPs aged 16 and over,430,270,190,37,153,74,6,160,144,0,4,9,3
S01010665,Owned: Total,331,196,133,30,103,62,1,135,130,0,3,1,1
S01010665,Owned: Owned outright,201,80,48,14,34,31,1,121,118,0,1,1,1
S01010665,Owned: Owned with a mortgage or loan or shared ownership,130,116,85,16,69,31,0,14,12,0,2,0,0
S01010665,Rented or living rent free: Total,99,74,57,7,50,12,5,25,14,0,1,8,2
S01010665,Rented or living rent free: Social rented,25,15,12,5,7,2,1,10,4,0,0,5,1
S01010665,Rented or living rent free: Private rented or living rent free,74,59,45,2,43,10,4,15,10,0,1,3,1
S01010666,All HRPs aged 16 and over,416,260,200,40,160,52,8,156,141,3,3,6,3
S01010666,Owned: Total,276,175,128,20,108,43,4,101,95,1,2,1,2
S01010666,Owned: Owned outright,145,55,36,11,25,16,3,90,85,0,2,1,2
S01010666,Owned: Owned with a mortgage or loan or shared ownership,131,120,92,9,83,27,1,11,10,1,0,0,0
S01010666,Rented or living rent free: Total,140,85,72,20,52,9,4,55,46,2,1,5,1
S01010666,Rented or living rent free: Social rented,78,38,34,10,24,2,2,40,31,2,1,5,1
S01010666,Rented or living rent free: Private rented or living rent free,62,47,38,10,28,7,2,15,15,0,0,0,0
S01010667,All HRPs aged 16 and over,288,212,132,19,113,75,5,76,65,0,4,5,2
S01010667,Owned: Total,219,160,95,13,82,64,1,59,53,0,2,2,2
S01010667,Owned: Owned outright,129,75,46,12,34,29,0,54,51,0,1,1,1
S01010667,Owned: Owned with a mortgage or loan or shared ownership,90,85,49,1,48,35,1,5,2,0,1,1,1
S01010667,Rented or living rent free: Total,69,52,37,6,31,11,4,17,12,0,2,3,0
S01010667,Rented or living rent free: Social rented,16,8,5,2,3,2,1,8,6,0,1,1,0
S01010667,Rented or living rent free: Private rented or living rent free,53,44,32,4,28,9,3,9,6,0,1,2,0
S01010668,All HRPs aged 16 and over,503,318,212,31,181,95,11,185,168,1,5,7,4
S01010668,Owned: Total,355,216,130,14,116,82,4,139,133,1,0,3,2
S01010668,Owned: Owned outright,209,88,44,9,35,41,3,121,116,1,0,2,2
S01010668,Owned: Owned with a mortgage or loan or shared ownership,146,128,86,5,81,41,1,18,17,0,0,1,0
S01010668,Rented or living rent free: Total,148,102,82,17,65,13,7,46,35,0,5,4,2
S01010668,Rented or living rent free: Social rented,72,40,31,8,23,5,4,32,24,0,4,4,0
S01010668,Rented or living rent free: Private rented or living rent free,76,62,51,9,42,8,3,14,11,0,1,0,2
S01010669,All HRPs aged 16 and over,266,176,118,10,108,50,8,90,82,0,3,5,0
S01010669,Owned: Total,200,128,81,6,75,43,4,72,68,0,0,4,0
S01010669,Owned: Owned outright,128,63,36,5,31,25,2,65,64,0,0,1,0
S01010669,Owned: Owned with a mortgage or loan or shared ownership,72,65,45,1,44,18,2,7,4,0,0,3,0
S01010669,Rented or living rent free: Total,66,48,37,4,33,7,4,18,14,0,3,1,0
S01010669,Rented or living rent free: Social rented,24,16,10,3,7,3,3,8,4,0,3,1,0
S01010669,Rented or living rent free: Private rented or living rent free,42,32,27,1,26,4,1,10,10,0,0,0,0
S01010670,All HRPs aged 16 and over,296,213,152,26,126,54,7,83,72,3,2,4,2
S01010670,Owned: Total,226,159,113,18,95,42,4,67,60,3,0,2,2
S01010670,Owned: Owned outright,129,73,48,10,38,22,3,56,53,0,0,1,2
S01010670,Owned: Owned with a mortgage or loan or shared ownership,97,86,65,8,57,20,1,11,7,3,0,1,0
S01010670,Rented or living rent free: Total,70,54,39,8,31,12,3,16,12,0,2,2,0
S01010670,Rented or living rent free: Social rented,35,22,18,4,14,2,2,13,9,0,2,2,0
S01010670,Rented or living rent free: Private rented or living rent free,35,32,21,4,17,10,1,3,3,0,0,0,0
S01010671,All HRPs aged 16 and over,329,213,132,31,101,71,10,116,91,2,10,9,4
S01010671,Owned: Total,251,164,98,20,78,62,4,87,78,1,7,1,0
S01010671,Owned: Owned outright,159,87,43,10,33,42,2,72,68,1,2,1,0
S01010671,Owned: Owned with a mortgage or loan or shared ownership,92,77,55,10,45,20,2,15,10,0,5,0,0
S01010671,Rented or living rent free: Total,78,49,34,11,23,9,6,29,13,1,3,8,4
S01010671,Rented or living rent free: Social rented,43,25,16,5,11,5,4,18,3,1,3,7,4
S01010671,Rented or living rent free: Private rented or living rent free,35,24,18,6,12,4,2,11,10,0,0,1,0
S01010672,All HRPs aged 16 and over,321,213,153,38,115,37,23,108,82,1,6,15,4
S01010672,Owned: Total,161,106,77,13,64,25,4,55,52,0,0,2,1
S01010672,Owned: Owned outright,92,40,29,9,20,9,2,52,49,0,0,2,1
S01010672,Owned: Owned with a mortgage or loan or shared ownership,69,66,48,4,44,16,2,3,3,0,0,0,0
S01010672,Rented or living rent free: Total,160,107,76,25,51,12,19,53,30,1,6,13,3
S01010672,Rented or living rent free: Social rented,123,78,53,24,29,9,16,45,23,1,6,12,3
S01010672,Rented or living rent free: Private rented or living rent free,37,29,23,1,22,3,3,8,7,0,0,1,0
S01010673,All HRPs aged 16 and over,419,278,181,32,149,82,15,141,111,0,3,25,2
S01010673,Owned: Total,254,180,116,15,101,61,3,74,72,0,0,2,0
S01010673,Owned: Owned outright,154,88,50,9,41,36,2,66,65,0,0,1,0
S01010673,Owned: Owned with a mortgage or loan or shared ownership,100,92,66,6,60,25,1,8,7,0,0,1,0
S01010673,Rented or living rent free: Total,165,98,65,17,48,21,12,67,39,0,3,23,2
S01010673,Rented or living rent free: Social rented,110,54,31,11,20,13,10,56,33,0,2,20,1
S01010673,Rented or living rent free: Private rented or living rent free,55,44,34,6,28,8,2,11,6,0,1,3,1
S01010674,All HRPs aged 16 and over,419,310,191,33,158,110,9,109,90,1,3,11,4
S01010674,Owned: Total,298,218,132,20,112,84,2,80,77,0,1,1,1
S01010674,Owned: Owned outright,163,94,52,11,41,40,2,69,66,0,1,1,1
S01010674,Owned: Owned with a mortgage or loan or shared ownership,135,124,80,9,71,44,0,11,11,0,0,0,0
S01010674,Rented or living rent free: Total,121,92,59,13,46,26,7,29,13,1,2,10,3
S01010674,Rented or living rent free: Social rented,69,46,32,8,24,9,5,23,9,1,0,10,3
S01010674,Rented or living rent free: Private rented or living rent free,52,46,27,5,22,17,2,6,4,0,2,0,0
S01010675,All HRPs aged 16 and over,273,172,99,15,84,69,4,101,89,0,4,3,5
S01010675,Owned: Total,222,144,83,14,69,59,2,78,74,0,1,0,3
S01010675,Owned: Owned outright,143,74,33,12,21,39,2,69,66,0,0,0,3
S01010675,Owned: Owned with a mortgage or loan or shared ownership,79,70,50,2,48,20,0,9,8,0,1,0,0
S01010675,Rented or living rent free: Total,51,28,16,1,15,10,2,23,15,0,3,3,2
S01010675,Rented or living rent free: Social rented,25,10,3,1,2,5,2,15,8,0,3,2,2
S01010675,Rented or living rent free: Private rented or living rent free,26,18,13,0,13,5,0,8,7,0,0,1,0
S01010676,All HRPs aged 16 and over,392,249,159,35,124,84,6,143,121,6,4,9,3
S01010676,Owned: Total,279,167,101,22,79,64,2,112,103,3,1,4,1
S01010676,Owned: Owned outright,179,79,44,16,28,33,2,100,94,3,1,1,1
S01010676,Owned: Owned with a mortgage or loan or shared ownership,100,88,57,6,51,31,0,12,9,0,0,3,0
S01010676,Rented or living rent free: Total,113,82,58,13,45,20,4,31,18,3,3,5,2
S01010676,Rented or living rent free: Social rented,53,33,27,7,20,3,3,20,10,1,3,5,1
S01010676,Rented or living rent free: Private rented or living rent free,60,49,31,6,25,17,1,11,8,2,0,0,1
S01010677,All HRPs aged 16 and over,224,133,90,19,71,40,3,91,84,0,4,1,2
S01010677,Owned: Total,182,103,67,15,52,34,2,79,77,0,0,0,2
S01010677,Owned: Owned outright,129,53,36,7,29,16,1,76,74,0,0,0,2
S01010677,Owned: Owned with a mortgage or loan or shared ownership,53,50,31,8,23,18,1,3,3,0,0,0,0
S01010677,Rented or living rent free: Total,42,30,23,4,19,6,1,12,7,0,4,1,0
S01010677,Rented or living rent free: Social rented,14,9,4,1,3,4,1,5,2,0,2,1,0
S01010677,Rented or living rent free: Private rented or living rent free,28,21,19,3,16,2,0,7,5,0,2,0,0
S01010678,All HRPs aged 16 and over,273,176,112,23,89,56,8,97,81,0,0,9,7
S01010678,Owned: Total,217,145,87,19,68,53,5,72,63,0,0,3,6
S01010678,Owned: Owned outright,124,63,33,13,20,25,5,61,53,0,0,2,6
S01010678,Owned: Owned with a mortgage or loan or shared ownership,93,82,54,6,48,28,0,11,10,0,0,1,0
S01010678,Rented or living rent free: Total,56,31,25,4,21,3,3,25,18,0,0,6,1
S01010678,Rented or living rent free: Social rented,25,13,9,3,6,1,3,12,8,0,0,3,1
S01010678,Rented or living rent free: Private rented or living rent free,31,18,16,1,15,2,0,13,10,0,0,3,0
S01010679,All HRPs aged 16 and over,282,187,126,28,98,47,14,95,74,2,0,18,1
S01010679,Owned: Total,175,120,80,15,65,37,3,55,53,0,0,2,0
S01010679,Owned: Owned outright,109,57,35,8,27,19,3,52,51,0,0,1,0
S01010679,Owned: Owned with a mortgage or loan or shared ownership,66,63,45,7,38,18,0,3,2,0,0,1,0
S01010679,Rented or living rent free: Total,107,67,46,13,33,10,11,40,21,2,0,16,1
S01010679,Rented or living rent free: Social rented,77,41,25,10,15,7,9,36,18,2,0,15,1
S01010679,Rented or living rent free: Private rented or living rent free,30,26,21,3,18,3,2,4,3,0,0,1,0
S01010680,All HRPs aged 16 and over,315,188,129,29,100,43,16,127,96,3,6,18,4
S01010680,Owned: Total,151,101,69,11,58,32,0,50,43,1,1,5,0
S01010680,Owned: Owned outright,79,40,20,5,15,20,0,39,36,0,0,3,0
S01010680,Owned: Owned with a mortgage or loan or shared ownership,72,61,49,6,43,12,0,11,7,1,1,2,0
S01010680,Rented or living rent free: Total,164,87,60,18,42,11,16,77,53,2,5,13,4
S01010680,Rented or living rent free: Social rented,138,72,51,17,34,7,14,66,44,2,5,11,4
S01010680,Rented or living rent free: Private rented or living rent free,26,15,9,1,8,4,2,11,9,0,0,2,0
S01010681,All HRPs aged 16 and over,461,349,261,56,205,61,27,112,75,2,6,21,8
S01010681,Owned: Total,241,191,154,21,133,33,4,50,48,1,0,1,0
S01010681,Owned: Owned outright,93,51,35,7,28,12,4,42,41,1,0,0,0
S01010681,Owned: Owned with a mortgage or loan or shared ownership,148,140,119,14,105,21,0,8,7,0,0,1,0
S01010681,Rented or living rent free: Total,220,158,107,35,72,28,23,62,27,1,6,20,8
S01010681,Rented or living rent free: Social rented,188,135,87,31,56,26,22,53,18,1,6,20,8
S01010681,Rented or living rent free: Private rented or living rent free,32,23,20,4,16,2,1,9,9,0,0,0,0
S01010682,All HRPs aged 16 and over,398,289,189,34,155,94,6,109,94,3,4,6,2
S01010682,Owned: Total,319,228,150,27,123,76,2,91,85,3,1,2,0
S01010682,Owned: Owned outright,181,104,63,20,43,40,1,77,74,0,1,2,0
S01010682,Owned: Owned with a mortgage or loan or shared ownership,138,124,87,7,80,36,1,14,11,3,0,0,0
S01010682,Rented or living rent free: Total,79,61,39,7,32,18,4,18,9,0,3,4,2
S01010682,Rented or living rent free: Social rented,27,21,12,1,11,6,3,6,3,0,0,3,0
S01010682,Rented or living rent free: Private rented or living rent free,52,40,27,6,21,12,1,12,6,0,3,1,2
S01010683,All HRPs aged 16 and over,423,268,164,23,141,95,9,155,133,2,6,8,6
S01010683,Owned: Total,342,217,129,19,110,85,3,125,111,1,3,5,5
S01010683,Owned: Owned outright,225,113,54,15,39,56,3,112,101,1,3,3,4
S01010683,Owned: Owned with a mortgage or loan or shared ownership,117,104,75,4,71,29,0,13,10,0,0,2,1
S01010683,Rented or living rent free: Total,81,51,35,4,31,10,6,30,22,1,3,3,1
S01010683,Rented or living rent free: Social rented,48,25,17,0,17,2,6,23,15,1,3,3,1
S01010683,Rented or living rent free: Private rented or living rent free,33,26,18,4,14,8,0,7,7,0,0,0,0
S01010684,All HRPs aged 16 and over,361,230,137,20,117,85,8,131,115,0,3,7,6
S01010684,Owned: Total,290,182,104,13,91,73,5,108,99,0,1,2,6
S01010684,Owned: Owned outright,200,104,53,12,41,47,4,96,89,0,0,2,5
S01010684,Owned: Owned with a mortgage or loan or shared ownership,90,78,51,1,50,26,1,12,10,0,1,0,1
S01010684,Rented or living rent free: Total,71,48,33,7,26,12,3,23,16,0,2,5,0
S01010684,Rented or living rent free: Social rented,25,14,9,3,6,3,2,11,4,0,2,5,0
S01010684,Rented or living rent free: Private rented or living rent free,46,34,24,4,20,9,1,12,12,0,0,0,0
S01010685,All HRPs aged 16 and over,294,174,88,19,69,73,13,120,107,0,1,8,4
S01010685,Owned: Total,238,139,71,15,56,62,6,99,95,0,0,2,2
S01010685,Owned: Owned outright,171,78,32,9,23,43,3,93,90,0,0,1,2
S01010685,Owned: Owned with a mortgage or loan or shared ownership,67,61,39,6,33,19,3,6,5,0,0,1,0
S01010685,Rented or living rent free: Total,56,35,17,4,13,11,7,21,12,0,1,6,2
S01010685,Rented or living rent free: Social rented,28,17,9,4,5,3,5,11,8,0,1,0,2
S01010685,Rented or living rent free: Private rented or living rent free,28,18,8,0,8,8,2,10,4,0,0,6,0
S01010686,All HRPs aged 16 and over,309,195,116,15,101,73,6,114,99,1,2,10,2
S01010686,Owned: Total,229,135,75,10,65,57,3,94,86,0,1,6,1
S01010686,Owned: Owned outright,148,67,35,7,28,30,2,81,74,0,1,6,0
S01010686,Owned: Owned with a mortgage or loan or shared ownership,81,68,40,3,37,27,1,13,12,0,0,0,1
S01010686,Rented or living rent free: Total,80,60,41,5,36,16,3,20,13,1,1,4,1
S01010686,Rented or living rent free: Social rented,33,22,18,5,13,2,2,11,6,1,0,3,1
S01010686,Rented or living rent free: Private rented or living rent free,47,38,23,0,23,14,1,9,7,0,1,1,0
S01010687,All HRPs aged 16 and over,379,227,158,27,131,64,5,152,137,0,4,6,5
S01010687,Owned: Total,287,173,123,21,102,50,0,114,109,0,0,1,4
S01010687,Owned: Owned outright,185,81,53,14,39,28,0,104,100,0,0,1,3
S01010687,Owned: Owned with a mortgage or loan or shared ownership,102,92,70,7,63,22,0,10,9,0,0,0,1
S01010687,Rented or living rent free: Total,92,54,35,6,29,14,5,38,28,0,4,5,1
S01010687,Rented or living rent free: Social rented,58,28,19,5,14,6,3,30,23,0,1,5,1
S01010687,Rented or living rent free: Private rented or living rent free,34,26,16,1,15,8,2,8,5,0,3,0,0
S01010688,All HRPs aged 16 and over,335,210,122,26,96,85,3,125,114,1,1,1,8
S01010688,Owned: Total,246,143,73,19,54,67,3,103,96,0,0,1,6
S01010688,Owned: Owned outright,181,86,40,12,28,43,3,95,90,0,0,1,4
S01010688,Owned: Owned with a mortgage or loan or shared ownership,65,57,33,7,26,24,0,8,6,0,0,0,2
S01010688,Rented or living rent free: Total,89,67,49,7,42,18,0,22,18,1,1,0,2
S01010688,Rented or living rent free: Social rented,47,33,21,5,16,12,0,14,11,1,0,0,2
S01010688,Rented or living rent free: Private rented or living rent free,42,34,28,2,26,6,0,8,7,0,1,0,0
S01010689,All HRPs aged 16 and over,378,207,123,24,99,76,8,171,160,0,1,7,3
S01010689,Owned: Total,278,143,79,18,61,62,2,135,129,0,1,2,3
S01010689,Owned: Owned outright,215,88,48,12,36,39,1,127,121,0,1,2,3
S01010689,Owned: Owned with a mortgage or loan or shared ownership,63,55,31,6,25,23,1,8,8,0,0,0,0
S01010689,Rented or living rent free: Total,100,64,44,6,38,14,6,36,31,0,0,5,0
S01010689,Rented or living rent free: Social rented,41,13,9,3,6,2,2,28,25,0,0,3,0
S01010689,Rented or living rent free: Private rented or living rent free,59,51,35,3,32,12,4,8,6,0,0,2,0
S01010690,All HRPs aged 16 and over,330,197,126,19,107,62,9,133,115,0,5,11,2
S01010690,Owned: Total,200,126,72,11,61,52,2,74,67,0,1,4,2
S01010690,Owned: Owned outright,124,57,32,8,24,23,2,67,60,0,1,4,2
S01010690,Owned: Owned with a mortgage or loan or shared ownership,76,69,40,3,37,29,0,7,7,0,0,0,0
S01010690,Rented or living rent free: Total,130,71,54,8,46,10,7,59,48,0,4,7,0
S01010690,Rented or living rent free: Social rented,76,29,19,3,16,4,6,47,39,0,3,5,0
S01010690,Rented or living rent free: Private rented or living rent free,54,42,35,5,30,6,1,12,9,0,1,2,0
S01010691,All HRPs aged 16 and over,325,230,116,27,89,110,4,95,86,0,2,2,5
S01010691,Owned: Total,236,156,77,18,59,77,2,80,74,0,1,1,4
S01010691,Owned: Owned outright,165,91,40,12,28,50,1,74,69,0,0,1,4
S01010691,Owned: Owned with a mortgage or loan or shared ownership,71,65,37,6,31,27,1,6,5,0,1,0,0
S01010691,Rented or living rent free: Total,89,74,39,9,30,33,2,15,12,0,1,1,1
S01010691,Rented or living rent free: Social rented,6,4,2,1,1,2,0,2,0,0,1,1,0
S01010691,Rented or living rent free: Private rented or living rent free,83,70,37,8,29,31,2,13,12,0,0,0,1
S01010692,All HRPs aged 16 and over,307,228,166,34,132,59,3,79,61,0,7,8,3
S01010692,Owned: Total,196,149,106,18,88,42,1,47,43,0,1,1,2
S01010692,Owned: Owned outright,87,44,33,10,23,10,1,43,40,0,0,1,2
S01010692,Owned: Owned with a mortgage or loan or shared ownership,109,105,73,8,65,32,0,4,3,0,1,0,0
S01010692,Rented or living rent free: Total,111,79,60,16,44,17,2,32,18,0,6,7,1
S01010692,Rented or living rent free: Social rented,79,52,43,14,29,8,1,27,14,0,6,6,1
S01010692,Rented or living rent free: Private rented or living rent free,32,27,17,2,15,9,1,5,4,0,0,1,0
S01010693,All HRPs aged 16 and over,216,154,86,17,69,66,2,62,58,0,0,2,2
S01010693,Owned: Total,172,117,63,11,52,53,1,55,53,0,0,0,2
S01010693,Owned: Owned outright,121,70,33,10,23,36,1,51,49,0,0,0,2
S01010693,Owned: Owned with a mortgage or loan or shared ownership,51,47,30,1,29,17,0,4,4,0,0,0,0
S01010693,Rented or living rent free: Total,44,37,23,6,17,13,1,7,5,0,0,2,0
S01010693,Rented or living rent free: Social rented,18,14,7,4,3,6,1,4,2,0,0,2,0
S01010693,Rented or living rent free: Private rented or living rent free,26,23,16,2,14,7,0,3,3,0,0,0,0
S01010694,All HRPs aged 16 and over,270,149,97,21,76,48,4,121,108,0,6,7,0
S01010694,Owned: Total,209,111,71,11,60,39,1,98,93,0,2,3,0
S01010694,Owned: Owned outright,148,66,40,8,32,25,1,82,78,0,1,3,0
S01010694,Owned: Owned with a mortgage or loan or shared ownership,61,45,31,3,28,14,0,16,15,0,1,0,0
S01010694,Rented or living rent free: Total,61,38,26,10,16,9,3,23,15,0,4,4,0
S01010694,Rented or living rent free: Social rented,34,22,15,6,9,5,2,12,7,0,1,4,0
S01010694,Rented or living rent free: Private rented or living rent free,27,16,11,4,7,4,1,11,8,0,3,0,0
S01010695,All HRPs aged 16 and over,304,227,146,26,120,76,5,77,71,1,1,4,0
S01010695,Owned: Total,236,174,104,18,86,66,4,62,61,0,1,0,0
S01010695,Owned: Owned outright,150,90,45,11,34,42,3,60,59,0,1,0,0
S01010695,Owned: Owned with a mortgage or loan or shared ownership,86,84,59,7,52,24,1,2,2,0,0,0,0
S01010695,Rented or living rent free: Total,68,53,42,8,34,10,1,15,10,1,0,4,0
S01010695,Rented or living rent free: Social rented,5,2,2,1,1,0,0,3,1,1,0,1,0
S01010695,Rented or living rent free: Private rented or living rent free,63,51,40,7,33,10,1,12,9,0,0,3,0
S01010696,All HRPs aged 16 and over,402,274,206,20,186,60,8,128,105,4,3,10,6
S01010696,Owned: Total,293,210,160,16,144,50,0,83,76,2,1,1,3
S01010696,Owned: Owned outright,138,66,45,6,39,21,0,72,67,2,0,1,2
S01010696,Owned: Owned with a mortgage or loan or shared ownership,155,144,115,10,105,29,0,11,9,0,1,0,1
S01010696,Rented or living rent free: Total,109,64,46,4,42,10,8,45,29,2,2,9,3
S01010696,Rented or living rent free: Social rented,68,32,21,3,18,6,5,36,23,0,2,9,2
S01010696,Rented or living rent free: Private rented or living rent free,41,32,25,1,24,4,3,9,6,2,0,0,1
S01010697,All HRPs aged 16 and over,458,304,222,23,199,78,4,154,138,4,4,7,1
S01010697,Owned: Total,346,227,170,17,153,56,1,119,114,3,1,0,1
S01010697,Owned: Owned outright,200,93,64,12,52,29,0,107,105,0,1,0,1
S01010697,Owned: Owned with a mortgage or loan or shared ownership,146,134,106,5,101,27,1,12,9,3,0,0,0
S01010697,Rented or living rent free: Total,112,77,52,6,46,22,3,35,24,1,3,7,0
S01010697,Rented or living rent free: Social rented,33,20,13,2,11,4,3,13,5,1,2,5,0
S01010697,Rented or living rent free: Private rented or living rent free,79,57,39,4,35,18,0,22,19,0,1,2,0
S01010698,All HRPs aged 16 and over,338,215,147,32,115,65,3,123,97,1,13,9,3
S01010698,Owned: Total,211,135,81,13,68,53,1,76,68,0,2,4,2
S01010698,Owned: Owned outright,132,64,32,7,25,31,1,68,61,0,2,3,2
S01010698,Owned: Owned with a mortgage or loan or shared ownership,79,71,49,6,43,22,0,8,7,0,0,1,0
S01010698,Rented or living rent free: Total,127,80,66,19,47,12,2,47,29,1,11,5,1
S01010698,Rented or living rent free: Social rented,41,26,24,11,13,2,0,15,5,0,7,2,1
S01010698,Rented or living rent free: Private rented or living rent free,86,54,42,8,34,10,2,32,24,1,4,3,0
S01010699,All HRPs aged 16 and over,250,199,140,25,115,54,5,51,43,1,1,4,2
S01010699,Owned: Total,179,144,97,20,77,45,2,35,33,0,1,1,0
S01010699,Owned: Owned outright,92,59,35,15,20,23,1,33,31,0,1,1,0
S01010699,Owned: Owned with a mortgage or loan or shared ownership,87,85,62,5,57,22,1,2,2,0,0,0,0
S01010699,Rented or living rent free: Total,71,55,43,5,38,9,3,16,10,1,0,3,2
S01010699,Rented or living rent free: Social rented,12,6,4,0,4,1,1,6,4,0,0,2,0
S01010699,Rented or living rent free: Private rented or living rent free,59,49,39,5,34,8,2,10,6,1,0,1,2
S01010700,All HRPs aged 16 and over,258,188,130,20,110,48,10,70,60,0,2,8,0
S01010700,Owned: Total,197,150,102,17,85,45,3,47,43,0,1,3,0
S01010700,Owned: Owned outright,108,68,42,12,30,24,2,40,38,0,1,1,0
S01010700,Owned: Owned with a mortgage or loan or shared ownership,89,82,60,5,55,21,1,7,5,0,0,2,0
S01010700,Rented or living rent free: Total,61,38,28,3,25,3,7,23,17,0,1,5,0
S01010700,Rented or living rent free: Social rented,21,8,5,0,5,0,3,13,9,0,0,4,0
S01010700,Rented or living rent free: Private rented or living rent free,40,30,23,3,20,3,4,10,8,0,1,1,0
S01010701,All HRPs aged 16 and over,432,304,242,31,211,52,10,128,105,1,5,14,3
S01010701,Owned: Total,297,214,174,13,161,37,3,83,73,0,0,7,3
S01010701,Owned: Owned outright,136,68,53,6,47,13,2,68,62,0,0,5,1
S01010701,Owned: Owned with a mortgage or loan or shared ownership,161,146,121,7,114,24,1,15,11,0,0,2,2
S01010701,Rented or living rent free: Total,135,90,68,18,50,15,7,45,32,1,5,7,0
S01010701,Rented or living rent free: Social rented,88,50,39,13,26,7,4,38,27,1,4,6,0
S01010701,Rented or living rent free: Private rented or living rent free,47,40,29,5,24,8,3,7,5,0,1,1,0
S01010702,All HRPs aged 16 and over,417,288,204,20,184,78,6,129,118,0,2,6,3
S01010702,Owned: Total,352,241,170,20,150,68,3,111,108,0,1,0,2
S01010702,Owned: Owned outright,204,99,58,11,47,39,2,105,102,0,1,0,2
S01010702,Owned: Owned with a mortgage or loan or shared ownership,148,142,112,9,103,29,1,6,6,0,0,0,0
S01010702,Rented or living rent free: Total,65,47,34,0,34,10,3,18,10,0,1,6,1
S01010702,Rented or living rent free: Social rented,8,4,3,0,3,0,1,4,0,0,1,2,1
S01010702,Rented or living rent free: Private rented or living rent free,57,43,31,0,31,10,2,14,10,0,0,4,0
S01010703,All HRPs aged 16 and over,341,237,159,22,137,73,5,104,96,0,2,5,1
S01010703,Owned: Total,281,188,123,18,105,64,1,93,91,0,1,1,0
S01010703,Owned: Owned outright,177,88,50,13,37,38,0,89,88,0,1,0,0
S01010703,Owned: Owned with a mortgage or loan or shared ownership,104,100,73,5,68,26,1,4,3,0,0,1,0
S01010703,Rented or living rent free: Total,60,49,36,4,32,9,4,11,5,0,1,4,1
S01010703,Rented or living rent free: Social rented,5,3,2,1,1,1,0,2,0,0,1,1,0
S01010703,Rented or living rent free: Private rented or living rent free,55,46,34,3,31,8,4,9,5,0,0,3,1
S01010704,All HRPs aged 16 and over,300,180,151,20,131,22,7,120,102,0,3,11,4
S01010704,Owned: Total,192,133,111,10,101,20,2,59,56,0,0,1,2
S01010704,Owned: Owned outright,84,35,25,6,19,10,0,49,46,0,0,1,2
S01010704,Owned: Owned with a mortgage or loan or shared ownership,108,98,86,4,82,10,2,10,10,0,0,0,0
S01010704,Rented or living rent free: Total,108,47,40,10,30,2,5,61,46,0,3,10,2
S01010704,Rented or living rent free: Social rented,87,36,29,8,21,2,5,51,38,0,3,9,1
S01010704,Rented or living rent free: Private rented or living rent free,21,11,11,2,9,0,0,10,8,0,0,1,1
S01010705,All HRPs aged 16 and over,463,315,245,30,215,51,19,148,116,2,10,14,6
S01010705,Owned: Total,347,236,189,22,167,42,5,111,96,1,5,4,5
S01010705,Owned: Owned outright,152,58,40,11,29,16,2,94,84,0,4,2,4
S01010705,Owned: Owned with a mortgage or loan or shared ownership,195,178,149,11,138,26,3,17,12,1,1,2,1
S01010705,Rented or living rent free: Total,116,79,56,8,48,9,14,37,20,1,5,10,1
S01010705,Rented or living rent free: Social rented,81,49,33,7,26,2,14,32,15,1,5,10,1
S01010705,Rented or living rent free: Private rented or living rent free,35,30,23,1,22,7,0,5,5,0,0,0,0
S01010706,All HRPs aged 16 and over,293,202,161,24,137,28,13,91,57,3,8,17,6
S01010706,Owned: Total,168,125,101,10,91,20,4,43,37,0,0,4,2
S01010706,Owned: Owned outright,66,30,18,4,14,10,2,36,31,0,0,4,1
S01010706,Owned: Owned with a mortgage or loan or shared ownership,102,95,83,6,77,10,2,7,6,0,0,0,1
S01010706,Rented or living rent free: Total,125,77,60,14,46,8,9,48,20,3,8,13,4
S01010706,Rented or living rent free: Social rented,95,54,45,12,33,2,7,41,14,3,8,12,4
S01010706,Rented or living rent free: Private rented or living rent free,30,23,15,2,13,6,2,7,6,0,0,1,0
S01010707,All HRPs aged 16 and over,265,193,132,12,120,60,1,72,67,1,1,1,2
S01010707,Owned: Total,213,149,99,8,91,50,0,64,62,1,0,1,0
S01010707,Owned: Owned outright,141,82,48,6,42,34,0,59,58,0,0,1,0
S01010707,Owned: Owned with a mortgage or loan or shared ownership,72,67,51,2,49,16,0,5,4,1,0,0,0
S01010707,Rented or living rent free: Total,52,44,33,4,29,10,1,8,5,0,1,0,2
S01010707,Rented or living rent free: Social rented,2,2,2,0,2,0,0,0,0,0,0,0,0
S01010707,Rented or living rent free: Private rented or living rent free,50,42,31,4,27,10,1,8,5,0,1,0,2
S01010708,All HRPs aged 16 and over,252,166,132,25,107,30,4,86,76,0,3,5,2
S01010708,Owned: Total,191,129,103,20,83,25,1,62,61,0,0,0,1
S01010708,Owned: Owned outright,92,36,28,8,20,7,1,56,55,0,0,0,1
S01010708,Owned: Owned with a mortgage or loan or shared ownership,99,93,75,12,63,18,0,6,6,0,0,0,0
S01010708,Rented or living rent free: Total,61,37,29,5,24,5,3,24,15,0,3,5,1
S01010708,Rented or living rent free: Social rented,37,20,16,4,12,2,2,17,10,0,3,4,0
S01010708,Rented or living rent free: Private rented or living rent free,24,17,13,1,12,3,1,7,5,0,0,1,1
S01010709,All HRPs aged 16 and over,299,211,174,16,158,32,5,88,77,1,4,5,1
S01010709,Owned: Total,251,180,153,12,141,27,0,71,68,1,1,1,0
S01010709,Owned: Owned outright,112,48,44,6,38,4,0,64,63,0,1,0,0
S01010709,Owned: Owned with a mortgage or loan or shared ownership,139,132,109,6,103,23,0,7,5,1,0,1,0
S01010709,Rented or living rent free: Total,48,31,21,4,17,5,5,17,9,0,3,4,1
S01010709,Rented or living rent free: Social rented,28,15,9,1,8,1,5,13,7,0,2,3,1
S01010709,Rented or living rent free: Private rented or living rent free,20,16,12,3,9,4,0,4,2,0,1,1,0
S01010710,All HRPs aged 16 and over,316,210,172,43,129,20,18,106,77,2,7,17,3
S01010710,Owned: Total,158,107,95,18,77,12,0,51,48,0,0,2,1
S01010710,Owned: Owned outright,86,44,41,14,27,3,0,42,41,0,0,0,1
S01010710,Owned: Owned with a mortgage or loan or shared ownership,72,63,54,4,50,9,0,9,7,0,0,2,0
S01010710,Rented or living rent free: Total,158,103,77,25,52,8,18,55,29,2,7,15,2
S01010710,Rented or living rent free: Social rented,152,100,75,25,50,7,18,52,28,0,7,15,2
S01010710,Rented or living rent free: Private rented or living rent free,6,3,2,0,2,1,0,3,1,2,0,0,0
S01010711,All HRPs aged 16 and over,319,210,177,23,154,32,1,109,100,1,3,4,1
S01010711,Owned: Total,270,184,153,18,135,31,0,86,84,1,0,1,0
S01010711,Owned: Owned outright,150,68,56,13,43,12,0,82,81,0,0,1,0
S01010711,Owned: Owned with a mortgage or loan or shared ownership,120,116,97,5,92,19,0,4,3,1,0,0,0
S01010711,Rented or living rent free: Total,49,26,24,5,19,1,1,23,16,0,3,3,1
S01010711,Rented or living rent free: Social rented,32,13,12,4,8,0,1,19,12,0,3,3,1
S01010711,Rented or living rent free: Private rented or living rent free,17,13,12,1,11,1,0,4,4,0,0,0,0
S01010712,All HRPs aged 16 and over,269,192,165,38,127,20,7,77,51,4,5,13,4
S01010712,Owned: Total,143,114,97,8,89,16,1,29,27,1,1,0,0
S01010712,Owned: Owned outright,65,39,28,4,24,10,1,26,25,0,1,0,0
S01010712,Owned: Owned with a mortgage or loan or shared ownership,78,75,69,4,65,6,0,3,2,1,0,0,0
S01010712,Rented or living rent free: Total,126,78,68,30,38,4,6,48,24,3,4,13,4
S01010712,Rented or living rent free: Social rented,107,60,54,26,28,2,4,47,24,3,4,12,4
S01010712,Rented or living rent free: Private rented or living rent free,19,18,14,4,10,2,2,1,0,0,0,1,0
S01010713,All HRPs aged 16 and over,322,231,205,36,169,21,5,91,71,1,8,10,1
S01010713,Owned: Total,210,155,135,20,115,18,2,55,51,0,0,4,0
S01010713,Owned: Owned outright,88,40,31,7,24,8,1,48,46,0,0,2,0
S01010713,Owned: Owned with a mortgage or loan or shared ownership,122,115,104,13,91,10,1,7,5,0,0,2,0
S01010713,Rented or living rent free: Total,112,76,70,16,54,3,3,36,20,1,8,6,1
S01010713,Rented or living rent free: Social rented,81,48,42,12,30,3,3,33,18,1,7,6,1
S01010713,Rented or living rent free: Private rented or living rent free,31,28,28,4,24,0,0,3,2,0,1,0,0
S01010714,All HRPs aged 16 and over,380,214,186,42,144,14,14,166,115,2,9,27,13
S01010714,Owned: Total,164,106,92,16,76,12,2,58,55,0,0,2,1
S01010714,Owned: Owned outright,92,40,33,10,23,6,1,52,50,0,0,1,1
S01010714,Owned: Owned with a mortgage or loan or shared ownership,72,66,59,6,53,6,1,6,5,0,0,1,0
S01010714,Rented or living rent free: Total,216,108,94,26,68,2,12,108,60,2,9,25,12
S01010714,Rented or living rent free: Social rented,173,76,63,21,42,2,11,97,53,2,9,23,10
S01010714,Rented or living rent free: Private rented or living rent free,43,32,31,5,26,0,1,11,7,0,0,2,2
S01010715,All HRPs aged 16 and over,340,206,168,36,132,27,11,134,111,0,5,14,4
S01010715,Owned: Total,210,138,111,18,93,23,4,72,71,0,1,0,0
S01010715,Owned: Owned outright,99,41,34,9,25,5,2,58,58,0,0,0,0
S01010715,Owned: Owned with a mortgage or loan or shared ownership,111,97,77,9,68,18,2,14,13,0,1,0,0
S01010715,Rented or living rent free: Total,130,68,57,18,39,4,7,62,40,0,4,14,4
S01010715,Rented or living rent free: Social rented,93,45,40,16,24,1,4,48,29,0,4,13,2
S01010715,Rented or living rent free: Private rented or living rent free,37,23,17,2,15,3,3,14,11,0,0,1,2
S01010716,All HRPs aged 16 and over,444,294,245,36,209,30,19,150,110,3,5,24,8
S01010716,Owned: Total,247,168,142,22,120,23,3,79,74,1,1,2,1
S01010716,Owned: Owned outright,107,42,35,9,26,6,1,65,63,1,0,1,0
S01010716,Owned: Owned with a mortgage or loan or shared ownership,140,126,107,13,94,17,2,14,11,0,1,1,1
S01010716,Rented or living rent free: Total,197,126,103,14,89,7,16,71,36,2,4,22,7
S01010716,Rented or living rent free: Social rented,85,36,25,7,18,1,10,49,22,0,4,18,5
S01010716,Rented or living rent free: Private rented or living rent free,112,90,78,7,71,6,6,22,14,2,0,4,2
S01010717,All HRPs aged 16 and over,272,166,143,20,123,22,1,106,102,0,1,2,1
S01010717,Owned: Total,252,154,131,20,111,22,1,98,96,0,1,1,0
S01010717,Owned: Owned outright,151,61,52,15,37,9,0,90,89,0,0,1,0
S01010717,Owned: Owned with a mortgage or loan or shared ownership,101,93,79,5,74,13,1,8,7,0,1,0,0
S01010717,Rented or living rent free: Total,20,12,12,0,12,0,0,8,6,0,0,1,1
S01010717,Rented or living rent free: Social rented,3,1,1,0,1,0,0,2,1,0,0,1,0
S01010717,Rented or living rent free: Private rented or living rent free,17,11,11,0,11,0,0,6,5,0,0,0,1
S01010718,All HRPs aged 16 and over,393,285,228,37,191,48,9,108,79,1,8,16,4
S01010718,Owned: Total,292,214,170,16,154,42,2,78,70,0,4,3,1
S01010718,Owned: Owned outright,142,73,57,10,47,16,0,69,64,0,3,1,1
S01010718,Owned: Owned with a mortgage or loan or shared ownership,150,141,113,6,107,26,2,9,6,0,1,2,0
S01010718,Rented or living rent free: Total,101,71,58,21,37,6,7,30,9,1,4,13,3
S01010718,Rented or living rent free: Social rented,62,37,31,15,16,0,6,25,8,1,3,10,3
S01010718,Rented or living rent free: Private rented or living rent free,39,34,27,6,21,6,1,5,1,0,1,3,0
S01010719,All HRPs aged 16 and over,282,183,145,26,119,32,6,99,84,3,2,7,3
S01010719,Owned: Total,203,136,107,18,89,28,1,67,62,2,1,1,1
S01010719,Owned: Owned outright,111,52,38,14,24,13,1,59,58,1,0,0,0
S01010719,Owned: Owned with a mortgage or loan or shared ownership,92,84,69,4,65,15,0,8,4,1,1,1,1
S01010719,Rented or living rent free: Total,79,47,38,8,30,4,5,32,22,1,1,6,2
S01010719,Rented or living rent free: Social rented,44,21,17,3,14,2,2,23,17,1,1,3,1
S01010719,Rented or living rent free: Private rented or living rent free,35,26,21,5,16,2,3,9,5,0,0,3,1
S01010720,All HRPs aged 16 and over,336,178,133,25,108,45,0,158,144,0,2,9,3
S01010720,Owned: Total,264,149,106,16,90,43,0,115,113,0,0,2,0
S01010720,Owned: Owned outright,170,65,41,10,31,24,0,105,104,0,0,1,0
S01010720,Owned: Owned with a mortgage or loan or shared ownership,94,84,65,6,59,19,0,10,9,0,0,1,0
S01010720,Rented or living rent free: Total,72,29,27,9,18,2,0,43,31,0,2,7,3
S01010720,Rented or living rent free: Social rented,46,10,10,5,5,0,0,36,24,0,2,7,3
S01010720,Rented or living rent free: Private rented or living rent free,26,19,17,4,13,2,0,7,7,0,0,0,0
S01010721,All HRPs aged 16 and over,296,185,128,20,108,55,2,111,108,0,1,2,0
S01010721,Owned: Total,253,151,103,15,88,48,0,102,101,0,0,1,0
S01010721,Owned: Owned outright,160,63,43,11,32,20,0,97,96,0,0,1,0
S01010721,Owned: Owned with a mortgage or loan or shared ownership,93,88,60,4,56,28,0,5,5,0,0,0,0
S01010721,Rented or living rent free: Total,43,34,25,5,20,7,2,9,7,0,1,1,0
S01010721,Rented or living rent free: Social rented,4,3,2,1,1,0,1,1,0,0,1,0,0
S01010721,Rented or living rent free: Private rented or living rent free,39,31,23,4,19,7,1,8,7,0,0,1,0
S01010722,All HRPs aged 16 and over,394,251,198,38,160,47,6,143,127,3,2,6,5
S01010722,Owned: Total,278,181,145,21,124,34,2,97,91,2,0,2,2
S01010722,Owned: Owned outright,152,66,52,12,40,13,1,86,85,0,0,0,1
S01010722,Owned: Owned with a mortgage or loan or shared ownership,126,115,93,9,84,21,1,11,6,2,0,2,1
S01010722,Rented or living rent free: Total,116,70,53,17,36,13,4,46,36,1,2,4,3
S01010722,Rented or living rent free: Social rented,78,41,31,14,17,6,4,37,28,1,1,4,3
S01010722,Rented or living rent free: Private rented or living rent free,38,29,22,3,19,7,0,9,8,0,1,0,0
S01010723,All HRPs aged 16 and over,329,252,171,20,151,80,1,77,70,0,3,3,1
S01010723,Owned: Total,262,202,135,14,121,67,0,60,56,0,3,1,0
S01010723,Owned: Owned outright,143,91,53,7,46,38,0,52,50,0,1,1,0
S01010723,Owned: Owned with a mortgage or loan or shared ownership,119,111,82,7,75,29,0,8,6,0,2,0,0
S01010723,Rented or living rent free: Total,67,50,36,6,30,13,1,17,14,0,0,2,1
S01010723,Rented or living rent free: Social rented,10,3,2,1,1,1,0,7,5,0,0,2,0
S01010723,Rented or living rent free: Private rented or living rent free,57,47,34,5,29,12,1,10,9,0,0,0,1
S01010724,All HRPs aged 16 and over,354,260,186,29,157,69,5,94,86,0,2,5,1
S01010724,Owned: Total,253,180,127,13,114,51,2,73,71,0,1,1,0
S01010724,Owned: Owned outright,136,69,39,8,31,29,1,67,66,0,0,1,0
S01010724,Owned: Owned with a mortgage or loan or shared ownership,117,111,88,5,83,22,1,6,5,0,1,0,0
S01010724,Rented or living rent free: Total,101,80,59,16,43,18,3,21,15,0,1,4,1
S01010724,Rented or living rent free: Social rented,41,30,23,9,14,6,1,11,6,0,1,4,0
S01010724,Rented or living rent free: Private rented or living rent free,60,50,36,7,29,12,2,10,9,0,0,0,1
S01010725,All HRPs aged 16 and over,287,209,131,18,113,76,2,78,73,0,0,5,0
S01010725,Owned: Total,241,176,105,11,94,69,2,65,63,0,0,2,0
S01010725,Owned: Owned outright,147,86,44,8,36,41,1,61,59,0,0,2,0
S01010725,Owned: Owned with a mortgage or loan or shared ownership,94,90,61,3,58,28,1,4,4,0,0,0,0
S01010725,Rented or living rent free: Total,46,33,26,7,19,7,0,13,10,0,0,3,0
S01010725,Rented or living rent free: Social rented,1,1,1,1,0,0,0,0,0,0,0,0,0
S01010725,Rented or living rent free: Private rented or living rent free,45,32,25,6,19,7,0,13,10,0,0,3,0
S01010726,All HRPs aged 16 and over,415,249,188,34,154,51,10,166,151,0,2,10,3
S01010726,Owned: Total,323,189,139,19,120,45,5,134,130,0,1,1,2
S01010726,Owned: Owned outright,205,82,57,15,42,21,4,123,122,0,0,0,1
S01010726,Owned: Owned with a mortgage or loan or shared ownership,118,107,82,4,78,24,1,11,8,0,1,1,1
S01010726,Rented or living rent free: Total,92,60,49,15,34,6,5,32,21,0,1,9,1
S01010726,Rented or living rent free: Social rented,58,31,25,7,18,2,4,27,16,0,1,9,1
S01010726,Rented or living rent free: Private rented or living rent free,34,29,24,8,16,4,1,5,5,0,0,0,0
S01010727,All HRPs aged 16 and over,243,166,108,16,92,54,4,77,70,0,5,2,0
S01010727,Owned: Total,206,142,93,15,78,48,1,64,59,0,3,2,0
S01010727,Owned: Owned outright,122,67,41,11,30,26,0,55,51,0,3,1,0
S01010727,Owned: Owned with a mortgage or loan or shared ownership,84,75,52,4,48,22,1,9,8,0,0,1,0
S01010727,Rented or living rent free: Total,37,24,15,1,14,6,3,13,11,0,2,0,0
S01010727,Rented or living rent free: Social rented,8,5,2,0,2,2,1,3,2,0,1,0,0
S01010727,Rented or living rent free: Private rented or living rent free,29,19,13,1,12,4,2,10,9,0,1,0,0
S01010728,All HRPs aged 16 and over,204,139,113,14,99,25,1,65,64,0,0,0,1
S01010728,Owned: Total,177,118,98,12,86,20,0,59,58,0,0,0,1
S01010728,Owned: Owned outright,96,41,34,11,23,7,0,55,54,0,0,0,1
S01010728,Owned: Owned with a mortgage or loan or shared ownership,81,77,64,1,63,13,0,4,4,0,0,0,0
S01010728,Rented or living rent free: Total,27,21,15,2,13,5,1,6,6,0,0,0,0
S01010728,Rented or living rent free: Social rented,4,1,1,0,1,0,0,3,3,0,0,0,0
S01010728,Rented or living rent free: Private rented or living rent free,23,20,14,2,12,5,1,3,3,0,0,0,0
S01010729,All HRPs aged 16 and over,269,201,146,17,129,55,0,68,61,1,1,3,2
S01010729,Owned: Total,227,168,121,13,108,47,0,59,55,1,1,1,1
S01010729,Owned: Owned outright,134,80,49,10,39,31,0,54,52,0,1,1,0
S01010729,Owned: Owned with a mortgage or loan or shared ownership,93,88,72,3,69,16,0,5,3,1,0,0,1
S01010729,Rented or living rent free: Total,42,33,25,4,21,8,0,9,6,0,0,2,1
S01010729,Rented or living rent free: Social rented,8,4,2,1,1,2,0,4,1,0,0,2,1
S01010729,Rented or living rent free: Private rented or living rent free,34,29,23,3,20,6,0,5,5,0,0,0,0
S01010730,All HRPs aged 16 and over,343,255,171,21,150,79,5,88,84,0,1,1,2
S01010730,Owned: Total,296,220,144,20,124,73,3,76,74,0,0,0,2
S01010730,Owned: Owned outright,174,105,65,12,53,37,3,69,67,0,0,0,2
S01010730,Owned: Owned with a mortgage or loan or shared ownership,122,115,79,8,71,36,0,7,7,0,0,0,0
S01010730,Rented or living rent free: Total,47,35,27,1,26,6,2,12,10,0,1,1,0
S01010730,Rented or living rent free: Social rented,8,3,2,0,2,0,1,5,4,0,0,1,0
S01010730,Rented or living rent free: Private rented or living rent free,39,32,25,1,24,6,1,7,6,0,1,0,0
S01010731,All HRPs aged 16 and over,399,266,197,38,159,52,17,133,106,6,7,9,5
S01010731,Owned: Total,263,177,130,19,111,40,7,86,79,2,0,4,1
S01010731,Owned: Owned outright,151,74,49,12,37,18,7,77,73,2,0,1,1
S01010731,Owned: Owned with a mortgage or loan or shared ownership,112,103,81,7,74,22,0,9,6,0,0,3,0
S01010731,Rented or living rent free: Total,136,89,67,19,48,12,10,47,27,4,7,5,4
S01010731,Rented or living rent free: Social rented,79,46,34,13,21,5,7,33,18,2,5,5,3
S01010731,Rented or living rent free: Private rented or living rent free,57,43,33,6,27,7,3,14,9,2,2,0,1
S01010732,All HRPs aged 16 and over,334,207,176,42,134,18,13,127,77,2,17,26,5
S01010732,Owned: Total,164,117,100,17,83,15,2,47,43,0,2,1,1
S01010732,Owned: Owned outright,71,36,30,6,24,6,0,35,34,0,0,0,1
S01010732,Owned: Owned with a mortgage or loan or shared ownership,93,81,70,11,59,9,2,12,9,0,2,1,0
S01010732,Rented or living rent free: Total,170,90,76,25,51,3,11,80,34,2,15,25,4
S01010732,Rented or living rent free: Social rented,153,77,64,23,41,3,10,76,32,2,13,25,4
S01010732,Rented or living rent free: Private rented or living rent free,17,13,12,2,10,0,1,4,2,0,2,0,0
S01010733,All HRPs aged 16 and over,246,154,130,24,106,15,9,92,49,3,17,18,5
S01010733,Owned: Total,84,68,54,5,49,12,2,16,13,0,1,1,1
S01010733,Owned: Owned outright,32,18,14,3,11,3,1,14,11,0,1,1,1
S01010733,Owned: Owned with a mortgage or loan or shared ownership,52,50,40,2,38,9,1,2,2,0,0,0,0
S01010733,Rented or living rent free: Total,162,86,76,19,57,3,7,76,36,3,16,17,4
S01010733,Rented or living rent free: Social rented,149,78,68,19,49,3,7,71,32,3,15,17,4
S01010733,Rented or living rent free: Private rented or living rent free,13,8,8,0,8,0,0,5,4,0,1,0,0
S01010734,All HRPs aged 16 and over,362,241,195,42,153,24,22,121,61,1,21,33,5
S01010734,Owned: Total,139,115,94,8,86,19,2,24,19,0,1,4,0
S01010734,Owned: Owned outright,53,30,23,5,18,6,1,23,18,0,1,4,0
S01010734,Owned: Owned with a mortgage or loan or shared ownership,86,85,71,3,68,13,1,1,1,0,0,0,0
S01010734,Rented or living rent free: Total,223,126,101,34,67,5,20,97,42,1,20,29,5
S01010734,Rented or living rent free: Social rented,205,112,91,34,57,1,20,93,39,1,20,28,5
S01010734,Rented or living rent free: Private rented or living rent free,18,14,10,0,10,4,0,4,3,0,0,1,0
S01010735,All HRPs aged 16 and over,244,169,138,19,119,12,19,75,27,2,15,22,9
S01010735,Owned: Total,61,47,39,1,38,8,0,14,12,0,0,1,1
S01010735,Owned: Owned outright,21,11,10,0,10,1,0,10,10,0,0,0,0
S01010735,Owned: Owned with a mortgage or loan or shared ownership,40,36,29,1,28,7,0,4,2,0,0,1,1
S01010735,Rented or living rent free: Total,183,122,99,18,81,4,19,61,15,2,15,21,8
S01010735,Rented or living rent free: Social rented,177,118,97,18,79,3,18,59,13,2,15,21,8
S01010735,Rented or living rent free: Private rented or living rent free,6,4,2,0,2,1,1,2,2,0,0,0,0
S01010736,All HRPs aged 16 and over,218,138,115,10,105,19,4,80,75,0,1,1,3
S01010736,Owned: Total,196,122,106,10,96,16,0,74,71,0,1,1,1
S01010736,Owned: Owned outright,108,40,33,6,27,7,0,68,66,0,1,0,1
S01010736,Owned: Owned with a mortgage or loan or shared ownership,88,82,73,4,69,9,0,6,5,0,0,1,0
S01010736,Rented or living rent free: Total,22,16,9,0,9,3,4,6,4,0,0,0,2
S01010736,Rented or living rent free: Social rented,7,4,2,0,2,1,1,3,2,0,0,0,1
S01010736,Rented or living rent free: Private rented or living rent free,15,12,7,0,7,2,3,3,2,0,0,0,1
S01010737,All HRPs aged 16 and over,487,290,243,40,203,35,12,197,167,1,7,19,3
S01010737,Owned: Total,297,197,168,29,139,25,4,100,94,1,2,2,1
S01010737,Owned: Owned outright,154,70,56,13,43,10,4,84,82,0,1,1,0
S01010737,Owned: Owned with a mortgage or loan or shared ownership,143,127,112,16,96,15,0,16,12,1,1,1,1
S01010737,Rented or living rent free: Total,190,93,75,11,64,10,8,97,73,0,5,17,2
S01010737,Rented or living rent free: Social rented,130,46,33,7,26,5,8,84,61,0,5,16,2
S01010737,Rented or living rent free: Private rented or living rent free,60,47,42,4,38,5,0,13,12,0,0,1,0
S01010738,All HRPs aged 16 and over,235,148,134,36,98,13,1,87,74,0,6,6,1
S01010738,Owned: Total,149,95,83,20,63,11,1,54,50,0,1,3,0
S01010738,Owned: Owned outright,86,42,36,10,26,5,1,44,41,0,1,2,0
S01010738,Owned: Owned with a mortgage or loan or shared ownership,63,53,47,10,37,6,0,10,9,0,0,1,0
S01010738,Rented or living rent free: Total,86,53,51,16,35,2,0,33,24,0,5,3,1
S01010738,Rented or living rent free: Social rented,73,43,41,12,29,2,0,30,21,0,5,3,1
S01010738,Rented or living rent free: Private rented or living rent free,13,10,10,4,6,0,0,3,3,0,0,0,0
S01010739,All HRPs aged 16 and over,388,264,213,41,172,34,17,124,86,0,11,22,5
S01010739,Owned: Total,233,174,141,20,121,27,6,59,53,0,1,4,1
S01010739,Owned: Owned outright,91,44,33,9,24,9,2,47,42,0,0,4,1
S01010739,Owned: Owned with a mortgage or loan or shared ownership,142,130,108,11,97,18,4,12,11,0,1,0,0
S01010739,Rented or living rent free: Total,155,90,72,21,51,7,11,65,33,0,10,18,4
S01010739,Rented or living rent free: Social rented,114,56,45,18,27,3,8,58,27,0,9,18,4
S01010739,Rented or living rent free: Private rented or living rent free,41,34,27,3,24,4,3,7,6,0,1,0,0
S01010740,All HRPs aged 16 and over,260,145,118,33,85,7,20,115,61,0,14,27,13
S01010740,Owned: Total,55,40,36,6,30,4,0,15,10,0,1,1,3
S01010740,Owned: Owned outright,29,16,15,3,12,1,0,13,9,0,1,1,2
S01010740,Owned: Owned with a mortgage or loan or shared ownership,26,24,21,3,18,3,0,2,1,0,0,0,1
S01010740,Rented or living rent free: Total,205,105,82,27,55,3,20,100,51,0,13,26,10
S01010740,Rented or living rent free: Social rented,192,99,76,25,51,3,20,93,47,0,13,23,10
S01010740,Rented or living rent free: Private rented or living rent free,13,6,6,2,4,0,0,7,4,0,0,3,0
S01010741,All HRPs aged 16 and over,249,154,115,18,97,31,8,95,86,0,7,2,0
S01010741,Owned: Total,187,120,88,13,75,29,3,67,65,0,1,1,0
S01010741,Owned: Owned outright,114,54,38,10,28,13,3,60,59,0,1,0,0
S01010741,Owned: Owned with a mortgage or loan or shared ownership,73,66,50,3,47,16,0,7,6,0,0,1,0
S01010741,Rented or living rent free: Total,62,34,27,5,22,2,5,28,21,0,6,1,0
S01010741,Rented or living rent free: Social rented,45,24,18,4,14,1,5,21,14,0,6,1,0
S01010741,Rented or living rent free: Private rented or living rent free,17,10,9,1,8,1,0,7,7,0,0,0,0
S01010742,All HRPs aged 16 and over,308,207,186,29,157,8,13,101,80,1,6,10,4
S01010742,Owned: Total,194,140,131,15,116,6,3,54,49,0,0,3,2
S01010742,Owned: Owned outright,91,41,35,11,24,3,3,50,45,0,0,3,2
S01010742,Owned: Owned with a mortgage or loan or shared ownership,103,99,96,4,92,3,0,4,4,0,0,0,0
S01010742,Rented or living rent free: Total,114,67,55,14,41,2,10,47,31,1,6,7,2
S01010742,Rented or living rent free: Social rented,87,45,36,13,23,2,7,42,28,1,6,5,2
S01010742,Rented or living rent free: Private rented or living rent free,27,22,19,1,18,0,3,5,3,0,0,2,0
S01010743,All HRPs aged 16 and over,273,170,147,34,113,10,13,103,65,3,8,25,2
S01010743,Owned: Total,107,79,72,6,66,6,1,28,26,1,0,1,0
S01010743,Owned: Owned outright,45,19,17,1,16,1,1,26,24,1,0,1,0
S01010743,Owned: Owned with a mortgage or loan or shared ownership,62,60,55,5,50,5,0,2,2,0,0,0,0
S01010743,Rented or living rent free: Total,166,91,75,28,47,4,12,75,39,2,8,24,2
S01010743,Rented or living rent free: Social rented,156,83,68,27,41,4,11,73,39,2,8,22,2
S01010743,Rented or living rent free: Private rented or living rent free,10,8,7,1,6,0,1,2,0,0,0,2,0
S01010744,All HRPs aged 16 and over,459,315,262,42,220,43,10,144,118,0,10,12,4
S01010744,Owned: Total,335,232,196,22,174,35,1,103,95,0,1,4,3
S01010744,Owned: Owned outright,193,101,81,10,71,19,1,92,87,0,1,1,3
S01010744,Owned: Owned with a mortgage or loan or shared ownership,142,131,115,12,103,16,0,11,8,0,0,3,0
S01010744,Rented or living rent free: Total,124,83,66,20,46,8,9,41,23,0,9,8,1
S01010744,Rented or living rent free: Social rented,85,52,39,15,24,4,9,33,17,0,8,7,1
S01010744,Rented or living rent free: Private rented or living rent free,39,31,27,5,22,4,0,8,6,0,1,1,0
S01010745,All HRPs aged 16 and over,327,198,159,24,135,24,15,129,98,1,9,17,4
S01010745,Owned: Total,192,121,102,11,91,16,3,71,67,0,2,2,0
S01010745,Owned: Owned outright,105,40,32,5,27,7,1,65,61,0,2,2,0
S01010745,Owned: Owned with a mortgage or loan or shared ownership,87,81,70,6,64,9,2,6,6,0,0,0,0
S01010745,Rented or living rent free: Total,135,77,57,13,44,8,12,58,31,1,7,15,4
S01010745,Rented or living rent free: Social rented,80,32,22,8,14,2,8,48,26,1,5,13,3
S01010745,Rented or living rent free: Private rented or living rent free,55,45,35,5,30,6,4,10,5,0,2,2,1
S01010746,All HRPs aged 16 and over,441,301,219,30,189,73,9,140,116,0,8,13,3
S01010746,Owned: Total,300,201,141,15,126,60,0,99,93,0,3,3,0
S01010746,Owned: Owned outright,157,72,44,10,34,28,0,85,80,0,2,3,0
S01010746,Owned: Owned with a mortgage or loan or shared ownership,143,129,97,5,92,32,0,14,13,0,1,0,0
S01010746,Rented or living rent free: Total,141,100,78,15,63,13,9,41,23,0,5,10,3
S01010746,Rented or living rent free: Social rented,48,29,22,5,17,4,3,19,11,0,3,4,1
S01010746,Rented or living rent free: Private rented or living rent free,93,71,56,10,46,9,6,22,12,0,2,6,2
S01010747,All HRPs aged 16 and over,357,232,192,45,147,32,8,125,86,0,10,23,6
S01010747,Owned: Total,204,145,117,20,97,28,0,59,52,0,0,6,1
S01010747,Owned: Owned outright,103,54,40,9,31,14,0,49,46,0,0,3,0
S01010747,Owned: Owned with a mortgage or loan or shared ownership,101,91,77,11,66,14,0,10,6,0,0,3,1
S01010747,Rented or living rent free: Total,153,87,75,25,50,4,8,66,34,0,10,17,5
S01010747,Rented or living rent free: Social rented,120,66,56,19,37,2,8,54,27,0,10,12,5
S01010747,Rented or living rent free: Private rented or living rent free,33,21,19,6,13,2,0,12,7,0,0,5,0
S01010748,All HRPs aged 16 and over,280,175,117,16,101,53,5,105,89,1,7,8,0
S01010748,Owned: Total,214,133,86,12,74,45,2,81,75,1,1,4,0
S01010748,Owned: Owned outright,127,60,38,8,30,22,0,67,66,0,0,1,0
S01010748,Owned: Owned with a mortgage or loan or shared ownership,87,73,48,4,44,23,2,14,9,1,1,3,0
S01010748,Rented or living rent free: Total,66,42,31,4,27,8,3,24,14,0,6,4,0
S01010748,Rented or living rent free: Social rented,22,13,9,4,5,2,2,9,4,0,2,3,0
S01010748,Rented or living rent free: Private rented or living rent free,44,29,22,0,22,6,1,15,10,0,4,1,0
S01010749,All HRPs aged 16 and over,261,183,131,23,108,44,8,78,68,0,5,4,1
S01010749,Owned: Total,195,136,98,13,85,35,3,59,54,0,2,2,1
S01010749,Owned: Owned outright,120,68,44,5,39,22,2,52,50,0,1,0,1
S01010749,Owned: Owned with a mortgage or loan or shared ownership,75,68,54,8,46,13,1,7,4,0,1,2,0
S01010749,Rented or living rent free: Total,66,47,33,10,23,9,5,19,14,0,3,2,0
S01010749,Rented or living rent free: Social rented,13,8,6,3,3,0,2,5,3,0,1,1,0
S01010749,Rented or living rent free: Private rented or living rent free,53,39,27,7,20,9,3,14,11,0,2,1,0
S01010750,All HRPs aged 16 and over,287,178,121,20,101,53,4,109,102,0,2,2,3
S01010750,Owned: Total,230,138,91,17,74,45,2,92,90,0,0,1,1
S01010750,Owned: Owned outright,164,80,51,13,38,28,1,84,83,0,0,0,1
S01010750,Owned: Owned with a mortgage or loan or shared ownership,66,58,40,4,36,17,1,8,7,0,0,1,0
S01010750,Rented or living rent free: Total,57,40,30,3,27,8,2,17,12,0,2,1,2
S01010750,Rented or living rent free: Social rented,8,4,1,1,0,1,2,4,2,0,1,0,1
S01010750,Rented or living rent free: Private rented or living rent free,49,36,29,2,27,7,0,13,10,0,1,1,1
S01010751,All HRPs aged 16 and over,333,184,127,28,99,32,25,149,88,0,17,36,8
S01010751,Owned: Total,133,80,57,7,50,21,2,53,46,0,1,5,1
S01010751,Owned: Owned outright,82,37,28,7,21,8,1,45,41,0,1,3,0
S01010751,Owned: Owned with a mortgage or loan or shared ownership,51,43,29,0,29,13,1,8,5,0,0,2,1
S01010751,Rented or living rent free: Total,200,104,70,21,49,11,23,96,42,0,16,31,7
S01010751,Rented or living rent free: Social rented,166,83,56,18,38,5,22,83,36,0,13,27,7
S01010751,Rented or living rent free: Private rented or living rent free,34,21,14,3,11,6,1,13,6,0,3,4,0
S01010752,All HRPs aged 16 and over,332,221,185,37,148,25,11,111,71,1,10,26,3
S01010752,Owned: Total,168,122,100,8,92,18,4,46,42,0,2,2,0
S01010752,Owned: Owned outright,75,37,29,6,23,5,3,38,36,0,1,1,0
S01010752,Owned: Owned with a mortgage or loan or shared ownership,93,85,71,2,69,13,1,8,6,0,1,1,0
S01010752,Rented or living rent free: Total,164,99,85,29,56,7,7,65,29,1,8,24,3
S01010752,Rented or living rent free: Social rented,107,61,50,22,28,6,5,46,17,1,4,23,1
S01010752,Rented or living rent free: Private rented or living rent free,57,38,35,7,28,1,2,19,12,0,4,1,2
S01010753,All HRPs aged 16 and over,434,296,215,41,174,59,22,138,75,1,21,30,11
S01010753,Owned: Total,247,188,140,22,118,45,3,59,53,0,1,3,2
S01010753,Owned: Owned outright,121,66,45,7,38,20,1,55,50,0,1,3,1
S01010753,Owned: Owned with a mortgage or loan or shared ownership,126,122,95,15,80,25,2,4,3,0,0,0,1
S01010753,Rented or living rent free: Total,187,108,75,19,56,14,19,79,22,1,20,27,9
S01010753,Rented or living rent free: Social rented,167,90,61,18,43,11,18,77,20,1,20,27,9
S01010753,Rented or living rent free: Private rented or living rent free,20,18,14,1,13,3,1,2,2,0,0,0,0
S01010754,All HRPs aged 16 and over,357,186,150,30,120,33,3,171,125,1,9,32,4
S01010754,Owned: Total,206,115,91,7,84,23,1,91,77,0,4,7,3
S01010754,Owned: Owned outright,120,41,29,3,26,11,1,79,69,0,1,7,2
S01010754,Owned: Owned with a mortgage or loan or shared ownership,86,74,62,4,58,12,0,12,8,0,3,0,1
S01010754,Rented or living rent free: Total,151,71,59,23,36,10,2,80,48,1,5,25,1
S01010754,Rented or living rent free: Social rented,107,37,31,16,15,4,2,70,43,1,5,20,1
S01010754,Rented or living rent free: Private rented or living rent free,44,34,28,7,21,6,0,10,5,0,0,5,0
S01010755,All HRPs aged 16 and over,298,182,146,28,118,29,7,116,102,1,1,10,2
S01010755,Owned: Total,174,116,93,17,76,22,1,58,56,0,0,2,0
S01010755,Owned: Owned outright,90,39,32,10,22,7,0,51,50,0,0,1,0
S01010755,Owned: Owned with a mortgage or loan or shared ownership,84,77,61,7,54,15,1,7,6,0,0,1,0
S01010755,Rented or living rent free: Total,124,66,53,11,42,7,6,58,46,1,1,8,2
S01010755,Rented or living rent free: Social rented,82,33,26,11,15,2,5,49,38,1,1,7,2
S01010755,Rented or living rent free: Private rented or living rent free,42,33,27,0,27,5,1,9,8,0,0,1,0
S01010756,All HRPs aged 16 and over,286,179,126,14,112,47,6,107,101,0,3,3,0
S01010756,Owned: Total,240,152,106,12,94,43,3,88,87,0,0,1,0
S01010756,Owned: Owned outright,142,61,40,8,32,19,2,81,81,0,0,0,0
S01010756,Owned: Owned with a mortgage or loan or shared ownership,98,91,66,4,62,24,1,7,6,0,0,1,0
S01010756,Rented or living rent free: Total,46,27,20,2,18,4,3,19,14,0,3,2,0
S01010756,Rented or living rent free: Social rented,17,7,4,1,3,2,1,10,7,0,2,1,0
S01010756,Rented or living rent free: Private rented or living rent free,29,20,16,1,15,2,2,9,7,0,1,1,0
S01010757,All HRPs aged 16 and over,365,221,154,23,131,62,5,144,125,0,5,10,4
S01010757,Owned: Total,257,154,101,15,86,51,2,103,99,0,1,2,1
S01010757,Owned: Owned outright,179,86,52,12,40,32,2,93,92,0,0,0,1
S01010757,Owned: Owned with a mortgage or loan or shared ownership,78,68,49,3,46,19,0,10,7,0,1,2,0
S01010757,Rented or living rent free: Total,108,67,53,8,45,11,3,41,26,0,4,8,3
S01010757,Rented or living rent free: Social rented,41,16,14,4,10,2,0,25,16,0,3,5,1
S01010757,Rented or living rent free: Private rented or living rent free,67,51,39,4,35,9,3,16,10,0,1,3,2
S01010758,All HRPs aged 16 and over,305,165,118,24,94,44,3,140,125,3,4,7,1
S01010758,Owned: Total,229,113,78,13,65,34,1,116,108,0,3,4,1
S01010758,Owned: Owned outright,164,55,35,10,25,19,1,109,104,0,1,3,1
S01010758,Owned: Owned with a mortgage or loan or shared ownership,65,58,43,3,40,15,0,7,4,0,2,1,0
S01010758,Rented or living rent free: Total,76,52,40,11,29,10,2,24,17,3,1,3,0
S01010758,Rented or living rent free: Social rented,28,16,15,4,11,1,0,12,10,0,0,2,0
S01010758,Rented or living rent free: Private rented or living rent free,48,36,25,7,18,9,2,12,7,3,1,1,0
S01010759,All HRPs aged 16 and over,279,169,134,27,107,30,5,110,89,11,1,8,1
S01010759,Owned: Total,171,115,92,15,77,22,1,56,53,0,1,1,1
S01010759,Owned: Owned outright,83,31,20,3,17,11,0,52,49,0,1,1,1
S01010759,Owned: Owned with a mortgage or loan or shared ownership,88,84,72,12,60,11,1,4,4,0,0,0,0
S01010759,Rented or living rent free: Total,108,54,42,12,30,8,4,54,36,11,0,7,0
S01010759,Rented or living rent free: Social rented,76,38,30,8,22,4,4,38,30,1,0,7,0
S01010759,Rented or living rent free: Private rented or living rent free,32,16,12,4,8,4,0,16,6,10,0,0,0
S01010760,All HRPs aged 16 and over,306,149,108,19,89,32,9,157,141,2,3,10,1
S01010760,Owned: Total,216,107,79,13,66,25,3,109,106,0,1,2,0
S01010760,Owned: Owned outright,155,53,37,9,28,14,2,102,99,0,1,2,0
S01010760,Owned: Owned with a mortgage or loan or shared ownership,61,54,42,4,38,11,1,7,7,0,0,0,0
S01010760,Rented or living rent free: Total,90,42,29,6,23,7,6,48,35,2,2,8,1
S01010760,Rented or living rent free: Social rented,61,21,15,4,11,3,3,40,29,2,1,7,1
S01010760,Rented or living rent free: Private rented or living rent free,29,21,14,2,12,4,3,8,6,0,1,1,0
S01010761,All HRPs aged 16 and over,222,151,99,15,84,45,7,71,66,0,3,2,0
S01010761,Owned: Total,165,109,70,13,57,38,1,56,54,0,2,0,0
S01010761,Owned: Owned outright,105,59,37,11,26,21,1,46,45,0,1,0,0
S01010761,Owned: Owned with a mortgage or loan or shared ownership,60,50,33,2,31,17,0,10,9,0,1,0,0
S01010761,Rented or living rent free: Total,57,42,29,2,27,7,6,15,12,0,1,2,0
S01010761,Rented or living rent free: Social rented,2,1,1,0,1,0,0,1,0,0,1,0,0
S01010761,Rented or living rent free: Private rented or living rent free,55,41,28,2,26,7,6,14,12,0,0,2,0
S01010762,All HRPs aged 16 and over,263,163,106,13,93,50,7,100,91,0,1,6,2
S01010762,Owned: Total,194,123,80,10,70,42,1,71,68,0,0,2,1
S01010762,Owned: Owned outright,122,60,34,7,27,25,1,62,60,0,0,1,1
S01010762,Owned: Owned with a mortgage or loan or shared ownership,72,63,46,3,43,17,0,9,8,0,0,1,0
S01010762,Rented or living rent free: Total,69,40,26,3,23,8,6,29,23,0,1,4,1
S01010762,Rented or living rent free: Social rented,31,12,7,2,5,1,4,19,15,0,1,2,1
S01010762,Rented or living rent free: Private rented or living rent free,38,28,19,1,18,7,2,10,8,0,0,2,0
S01010763,All HRPs aged 16 and over,316,198,131,28,103,57,10,118,109,0,3,3,3
S01010763,Owned: Total,198,130,84,11,73,45,1,68,67,0,0,1,0
S01010763,Owned: Owned outright,135,74,43,6,37,31,0,61,60,0,0,1,0
S01010763,Owned: Owned with a mortgage or loan or shared ownership,63,56,41,5,36,14,1,7,7,0,0,0,0
S01010763,Rented or living rent free: Total,118,68,47,17,30,12,9,50,42,0,3,2,3
S01010763,Rented or living rent free: Social rented,85,43,33,15,18,4,6,42,35,0,3,2,2
S01010763,Rented or living rent free: Private rented or living rent free,33,25,14,2,12,8,3,8,7,0,0,0,1
S01010764,All HRPs aged 16 and over,289,173,102,15,87,65,6,116,108,2,1,3,2
S01010764,Owned: Total,212,124,73,10,63,49,2,88,85,0,0,2,1
S01010764,Owned: Owned outright,147,67,32,7,25,34,1,80,79,0,0,0,1
S01010764,Owned: Owned with a mortgage or loan or shared ownership,65,57,41,3,38,15,1,8,6,0,0,2,0
S01010764,Rented or living rent free: Total,77,49,29,5,24,16,4,28,23,2,1,1,1
S01010764,Rented or living rent free: Social rented,27,13,10,3,7,2,1,14,12,0,1,1,0
S01010764,Rented or living rent free: Private rented or living rent free,50,36,19,2,17,14,3,14,11,2,0,0,1
S01010765,All HRPs aged 16 and over,471,276,195,41,154,71,10,195,166,1,11,10,7
S01010765,Owned: Total,324,189,131,24,107,56,2,135,126,0,3,3,3
S01010765,Owned: Owned outright,225,104,64,17,47,38,2,121,117,0,0,2,2
S01010765,Owned: Owned with a mortgage or loan or shared ownership,99,85,67,7,60,18,0,14,9,0,3,1,1
S01010765,Rented or living rent free: Total,147,87,64,17,47,15,8,60,40,1,8,7,4
S01010765,Rented or living rent free: Social rented,85,42,32,9,23,5,5,43,30,1,4,6,2
S01010765,Rented or living rent free: Private rented or living rent free,62,45,32,8,24,10,3,17,10,0,4,1,2
S01010766,All HRPs aged 16 and over,359,190,136,32,104,44,10,169,149,1,5,12,2
S01010766,Owned: Total,238,125,93,21,72,30,2,113,111,0,1,1,0
S01010766,Owned: Owned outright,157,50,36,13,23,12,2,107,106,0,0,1,0
S01010766,Owned: Owned with a mortgage or loan or shared ownership,81,75,57,8,49,18,0,6,5,0,1,0,0
S01010766,Rented or living rent free: Total,121,65,43,11,32,14,8,56,38,1,4,11,2
S01010766,Rented or living rent free: Social rented,74,33,23,7,16,5,5,41,25,0,4,11,1
S01010766,Rented or living rent free: Private rented or living rent free,47,32,20,4,16,9,3,15,13,1,0,0,1
S01010767,All HRPs aged 16 and over,347,198,158,41,117,28,12,149,123,0,6,16,4
S01010767,Owned: Total,199,114,90,15,75,22,2,85,81,0,2,1,1
S01010767,Owned: Owned outright,131,52,39,11,28,12,1,79,75,0,2,1,1
S01010767,Owned: Owned with a mortgage or loan or shared ownership,68,62,51,4,47,10,1,6,6,0,0,0,0
S01010767,Rented or living rent free: Total,148,84,68,26,42,6,10,64,42,0,4,15,3
S01010767,Rented or living rent free: Social rented,122,66,53,24,29,4,9,56,36,0,4,13,3
S01010767,Rented or living rent free: Private rented or living rent free,26,18,15,2,13,2,1,8,6,0,0,2,0
S01010768,All HRPs aged 16 and over,284,149,118,24,94,24,7,135,110,0,4,10,11
S01010768,Owned: Total,182,96,75,13,62,19,2,86,75,0,4,3,4
S01010768,Owned: Owned outright,127,51,39,8,31,11,1,76,69,0,0,3,4
S01010768,Owned: Owned with a mortgage or loan or shared ownership,55,45,36,5,31,8,1,10,6,0,4,0,0
S01010768,Rented or living rent free: Total,102,53,43,11,32,5,5,49,35,0,0,7,7
S01010768,Rented or living rent free: Social rented,78,33,26,8,18,4,3,45,33,0,0,6,6
S01010768,Rented or living rent free: Private rented or living rent free,24,20,17,3,14,1,2,4,2,0,0,1,1
S01010769,All HRPs aged 16 and over,217,126,83,10,73,38,5,91,85,0,2,3,1
S01010769,Owned: Total,176,99,64,7,57,31,4,77,75,0,0,1,1
S01010769,Owned: Owned outright,131,60,38,6,32,20,2,71,69,0,0,1,1
S01010769,Owned: Owned with a mortgage or loan or shared ownership,45,39,26,1,25,11,2,6,6,0,0,0,0
S01010769,Rented or living rent free: Total,41,27,19,3,16,7,1,14,10,0,2,2,0
S01010769,Rented or living rent free: Social rented,4,1,1,1,0,0,0,3,2,0,0,1,0
S01010769,Rented or living rent free: Private rented or living rent free,37,26,18,2,16,7,1,11,8,0,2,1,0
S01010770,All HRPs aged 16 and over,385,259,195,31,164,57,7,126,94,2,3,23,4
S01010770,Owned: Total,231,182,142,24,118,39,1,49,47,0,0,1,1
S01010770,Owned: Owned outright,118,75,54,13,41,21,0,43,42,0,0,0,1
S01010770,Owned: Owned with a mortgage or loan or shared ownership,113,107,88,11,77,18,1,6,5,0,0,1,0
S01010770,Rented or living rent free: Total,154,77,53,7,46,18,6,77,47,2,3,22,3
S01010770,Rented or living rent free: Social rented,100,45,34,5,29,6,5,55,31,1,2,18,3
S01010770,Rented or living rent free: Private rented or living rent free,54,32,19,2,17,12,1,22,16,1,1,4,0
S01010771,All HRPs aged 16 and over,445,234,146,32,114,68,20,211,187,0,3,17,4
S01010771,Owned: Total,286,151,98,23,75,48,5,135,130,0,1,3,1
S01010771,Owned: Owned outright,214,90,56,18,38,31,3,124,120,0,1,2,1
S01010771,Owned: Owned with a mortgage or loan or shared ownership,72,61,42,5,37,17,2,11,10,0,0,1,0
S01010771,Rented or living rent free: Total,159,83,48,9,39,20,15,76,57,0,2,14,3
S01010771,Rented or living rent free: Social rented,101,46,25,6,19,7,14,55,39,0,2,12,2
S01010771,Rented or living rent free: Private rented or living rent free,58,37,23,3,20,13,1,21,18,0,0,2,1
S01010772,All HRPs aged 16 and over,376,223,136,24,112,67,20,153,126,2,3,18,4
S01010772,Owned: Total,262,153,83,19,64,59,11,109,101,0,0,5,3
S01010772,Owned: Owned outright,197,95,45,10,35,41,9,102,94,0,0,5,3
S01010772,Owned: Owned with a mortgage or loan or shared ownership,65,58,38,9,29,18,2,7,7,0,0,0,0
S01010772,Rented or living rent free: Total,114,70,53,5,48,8,9,44,25,2,3,13,1
S01010772,Rented or living rent free: Social rented,48,20,12,0,12,3,5,28,13,0,2,12,1
S01010772,Rented or living rent free: Private rented or living rent free,66,50,41,5,36,5,4,16,12,2,1,1,0
S01010773,All HRPs aged 16 and over,336,222,157,27,130,56,9,114,97,0,4,9,4
S01010773,Owned: Total,266,182,131,24,107,46,5,84,74,0,3,5,2
S01010773,Owned: Owned outright,166,89,53,18,35,33,3,77,70,0,3,3,1
S01010773,Owned: Owned with a mortgage or loan or shared ownership,100,93,78,6,72,13,2,7,4,0,0,2,1
S01010773,Rented or living rent free: Total,70,40,26,3,23,10,4,30,23,0,1,4,2
S01010773,Rented or living rent free: Social rented,35,17,12,1,11,2,3,18,13,0,0,3,2
S01010773,Rented or living rent free: Private rented or living rent free,35,23,14,2,12,8,1,12,10,0,1,1,0
S01010774,All HRPs aged 16 and over,325,191,123,20,103,54,14,134,105,3,8,12,6
S01010774,Owned: Total,217,139,91,10,81,43,5,78,71,1,2,3,1
S01010774,Owned: Owned outright,131,65,34,5,29,26,5,66,62,1,1,1,1
S01010774,Owned: Owned with a mortgage or loan or shared ownership,86,74,57,5,52,17,0,12,9,0,1,2,0
S01010774,Rented or living rent free: Total,108,52,32,10,22,11,9,56,34,2,6,9,5
S01010774,Rented or living rent free: Social rented,76,31,18,6,12,6,7,45,27,2,4,9,3
S01010774,Rented or living rent free: Private rented or living rent free,32,21,14,4,10,5,2,11,7,0,2,0,2
S01010775,All HRPs aged 16 and over,266,208,158,26,132,49,1,58,51,1,0,5,1
S01010775,Owned: Total,229,183,140,20,120,43,0,46,44,0,0,2,0
S01010775,Owned: Owned outright,126,83,59,14,45,24,0,43,42,0,0,1,0
S01010775,Owned: Owned with a mortgage or loan or shared ownership,103,100,81,6,75,19,0,3,2,0,0,1,0
S01010775,Rented or living rent free: Total,37,25,18,6,12,6,1,12,7,1,0,3,1
S01010775,Rented or living rent free: Social rented,15,8,6,3,3,2,0,7,4,0,0,2,1
S01010775,Rented or living rent free: Private rented or living rent free,22,17,12,3,9,4,1,5,3,1,0,1,0
S01010776,All HRPs aged 16 and over,266,168,131,26,105,27,10,98,83,0,0,12,3
S01010776,Owned: Total,170,112,89,11,78,22,1,58,56,0,0,1,1
S01010776,Owned: Owned outright,91,38,26,3,23,11,1,53,51,0,0,1,1
S01010776,Owned: Owned with a mortgage or loan or shared ownership,79,74,63,8,55,11,0,5,5,0,0,0,0
S01010776,Rented or living rent free: Total,96,56,42,15,27,5,9,40,27,0,0,11,2
S01010776,Rented or living rent free: Social rented,65,31,21,9,12,3,7,34,22,0,0,10,2
S01010776,Rented or living rent free: Private rented or living rent free,31,25,21,6,15,2,2,6,5,0,0,1,0
S01010777,All HRPs aged 16 and over,270,159,122,27,95,17,20,111,84,4,3,12,8
S01010777,Owned: Total,126,86,73,13,60,12,1,40,39,0,0,1,0
S01010777,Owned: Owned outright,71,36,27,8,19,9,0,35,34,0,0,1,0
S01010777,Owned: Owned with a mortgage or loan or shared ownership,55,50,46,5,41,3,1,5,5,0,0,0,0
S01010777,Rented or living rent free: Total,144,73,49,14,35,5,19,71,45,4,3,11,8
S01010777,Rented or living rent free: Social rented,122,58,37,13,24,3,18,64,39,4,3,10,8
S01010777,Rented or living rent free: Private rented or living rent free,22,15,12,1,11,2,1,7,6,0,0,1,0
S01010778,All HRPs aged 16 and over,239,146,110,30,80,12,24,93,38,3,14,30,8
S01010778,Owned: Total,71,54,47,9,38,7,0,17,15,0,0,1,1
S01010778,Owned: Owned outright,33,16,14,3,11,2,0,17,15,0,0,1,1
S01010778,Owned: Owned with a mortgage or loan or shared ownership,38,38,33,6,27,5,0,0,0,0,0,0,0
S01010778,Rented or living rent free: Total,168,92,63,21,42,5,24,76,23,3,14,29,7
S01010778,Rented or living rent free: Social rented,155,83,58,20,38,5,20,72,22,3,13,27,7
S01010778,Rented or living rent free: Private rented or living rent free,13,9,5,1,4,0,4,4,1,0,1,2,0
S01010779,All HRPs aged 16 and over,355,199,149,33,116,20,30,156,101,3,16,29,7
S01010779,Owned: Total,171,106,86,13,73,16,4,65,60,1,1,3,0
S01010779,Owned: Owned outright,96,38,29,7,22,7,2,58,56,0,0,2,0
S01010779,Owned: Owned with a mortgage or loan or shared ownership,75,68,57,6,51,9,2,7,4,1,1,1,0
S01010779,Rented or living rent free: Total,184,93,63,20,43,4,26,91,41,2,15,26,7
S01010779,Rented or living rent free: Social rented,154,73,46,16,30,3,24,81,35,1,13,25,7
S01010779,Rented or living rent free: Private rented or living rent free,30,20,17,4,13,1,2,10,6,1,2,1,0
S01010780,All HRPs aged 16 and over,261,150,132,28,104,12,6,111,93,0,5,9,4
S01010780,Owned: Total,190,118,111,20,91,7,0,72,69,0,2,1,0
S01010780,Owned: Owned outright,114,51,47,12,35,4,0,63,61,0,1,1,0
S01010780,Owned: Owned with a mortgage or loan or shared ownership,76,67,64,8,56,3,0,9,8,0,1,0,0
S01010780,Rented or living rent free: Total,71,32,21,8,13,5,6,39,24,0,3,8,4
S01010780,Rented or living rent free: Social rented,54,22,14,6,8,3,5,32,19,0,2,7,4
S01010780,Rented or living rent free: Private rented or living rent free,17,10,7,2,5,2,1,7,5,0,1,1,0
S01010781,All HRPs aged 16 and over,350,246,194,31,163,45,7,104,85,4,6,6,3
S01010781,Owned: Total,262,188,146,15,131,39,3,74,72,1,0,0,1
S01010781,Owned: Owned outright,136,65,50,12,38,13,2,71,69,1,0,0,1
S01010781,Owned: Owned with a mortgage or loan or shared ownership,126,123,96,3,93,26,1,3,3,0,0,0,0
S01010781,Rented or living rent free: Total,88,58,48,16,32,6,4,30,13,3,6,6,2
S01010781,Rented or living rent free: Social rented,49,30,23,12,11,4,3,19,6,2,5,5,1
S01010781,Rented or living rent free: Private rented or living rent free,39,28,25,4,21,2,1,11,7,1,1,1,1
S01010782,All HRPs aged 16 and over,293,176,125,21,104,31,20,117,89,0,3,19,6
S01010782,Owned: Total,180,115,84,12,72,29,2,65,62,0,0,1,2
S01010782,Owned: Owned outright,99,40,27,11,16,11,2,59,57,0,0,1,1
S01010782,Owned: Owned with a mortgage or loan or shared ownership,81,75,57,1,56,18,0,6,5,0,0,0,1
S01010782,Rented or living rent free: Total,113,61,41,9,32,2,18,52,27,0,3,18,4
S01010782,Rented or living rent free: Social rented,73,34,19,7,12,2,13,39,19,0,2,15,3
S01010782,Rented or living rent free: Private rented or living rent free,40,27,22,2,20,0,5,13,8,0,1,3,1
S01010783,All HRPs aged 16 and over,275,152,121,24,97,18,13,123,84,7,10,14,8
S01010783,Owned: Total,152,98,79,9,70,17,2,54,46,0,0,3,5
S01010783,Owned: Owned outright,82,33,26,4,22,7,0,49,42,0,0,3,4
S01010783,Owned: Owned with a mortgage or loan or shared ownership,70,65,53,5,48,10,2,5,4,0,0,0,1
S01010783,Rented or living rent free: Total,123,54,42,15,27,1,11,69,38,7,10,11,3
S01010783,Rented or living rent free: Social rented,89,36,26,11,15,1,9,53,31,0,8,11,3
S01010783,Rented or living rent free: Private rented or living rent free,34,18,16,4,12,0,2,16,7,7,2,0,0
S01010784,All HRPs aged 16 and over,345,212,170,45,125,16,26,133,84,2,14,24,9
S01010784,Owned: Total,168,120,103,18,85,12,5,48,42,1,0,3,2
S01010784,Owned: Owned outright,71,30,26,7,19,2,2,41,38,1,0,1,1
S01010784,Owned: Owned with a mortgage or loan or shared ownership,97,90,77,11,66,10,3,7,4,0,0,2,1
S01010784,Rented or living rent free: Total,177,92,67,27,40,4,21,85,42,1,14,21,7
S01010784,Rented or living rent free: Social rented,154,81,58,26,32,3,20,73,39,0,9,18,7
S01010784,Rented or living rent free: Private rented or living rent free,23,11,9,1,8,1,1,12,3,1,5,3,0
S01010785,All HRPs aged 16 and over,301,208,175,21,154,27,6,93,77,4,3,7,2
S01010785,Owned: Total,252,185,154,18,136,27,4,67,65,2,0,0,0
S01010785,Owned: Owned outright,147,83,65,13,52,17,1,64,62,2,0,0,0
S01010785,Owned: Owned with a mortgage or loan or shared ownership,105,102,89,5,84,10,3,3,3,0,0,0,0
S01010785,Rented or living rent free: Total,49,23,21,3,18,0,2,26,12,2,3,7,2
S01010785,Rented or living rent free: Social rented,33,11,9,2,7,0,2,22,9,2,3,7,1
S01010785,Rented or living rent free: Private rented or living rent free,16,12,12,1,11,0,0,4,3,0,0,0,1
S01010786,All HRPs aged 16 and over,255,192,165,28,137,24,3,63,48,4,0,7,4
S01010786,Owned: Total,211,169,147,22,125,21,1,42,37,1,0,2,2
S01010786,Owned: Owned outright,89,52,44,10,34,7,1,37,35,1,0,0,1
S01010786,Owned: Owned with a mortgage or loan or shared ownership,122,117,103,12,91,14,0,5,2,0,0,2,1
S01010786,Rented or living rent free: Total,44,23,18,6,12,3,2,21,11,3,0,5,2
S01010786,Rented or living rent free: Social rented,28,13,10,5,5,1,2,15,6,2,0,5,2
S01010786,Rented or living rent free: Private rented or living rent free,16,10,8,1,7,2,0,6,5,1,0,0,0
S01010787,All HRPs aged 16 and over,384,254,174,26,148,72,8,130,113,0,0,12,5
S01010787,Owned: Total,273,190,124,14,110,63,3,83,78,0,0,2,3
S01010787,Owned: Owned outright,167,90,45,10,35,44,1,77,73,0,0,2,2
S01010787,Owned: Owned with a mortgage or loan or shared ownership,106,100,79,4,75,19,2,6,5,0,0,0,1
S01010787,Rented or living rent free: Total,111,64,50,12,38,9,5,47,35,0,0,10,2
S01010787,Rented or living rent free: Social rented,64,31,26,9,17,2,3,33,21,0,0,10,2
S01010787,Rented or living rent free: Private rented or living rent free,47,33,24,3,21,7,2,14,14,0,0,0,0
S01010788,All HRPs aged 16 and over,274,197,147,22,125,47,3,77,69,0,4,3,1
S01010788,Owned: Total,208,149,113,10,103,36,0,59,56,0,1,2,0
S01010788,Owned: Owned outright,120,67,46,6,40,21,0,53,52,0,0,1,0
S01010788,Owned: Owned with a mortgage or loan or shared ownership,88,82,67,4,63,15,0,6,4,0,1,1,0
S01010788,Rented or living rent free: Total,66,48,34,12,22,11,3,18,13,0,3,1,1
S01010788,Rented or living rent free: Social rented,30,20,17,9,8,1,2,10,7,0,2,0,1
S01010788,Rented or living rent free: Private rented or living rent free,36,28,17,3,14,10,1,8,6,0,1,1,0
S01010789,All HRPs aged 16 and over,292,201,136,20,116,55,10,91,81,1,2,5,2
S01010789,Owned: Total,207,152,99,10,89,50,3,55,54,0,0,1,0
S01010789,Owned: Owned outright,118,64,29,7,22,33,2,54,54,0,0,0,0
S01010789,Owned: Owned with a mortgage or loan or shared ownership,89,88,70,3,67,17,1,1,0,0,0,1,0
S01010789,Rented or living rent free: Total,85,49,37,10,27,5,7,36,27,1,2,4,2
S01010789,Rented or living rent free: Social rented,62,35,26,8,18,3,6,27,20,0,2,4,1
S01010789,Rented or living rent free: Private rented or living rent free,23,14,11,2,9,2,1,9,7,1,0,0,1
S01010790,All HRPs aged 16 and over,282,177,123,19,104,51,3,105,92,0,2,7,4
S01010790,Owned: Total,234,153,104,12,92,47,2,81,76,0,0,2,3
S01010790,Owned: Owned outright,159,89,55,10,45,34,0,70,68,0,0,0,2
S01010790,Owned: Owned with a mortgage or loan or shared ownership,75,64,49,2,47,13,2,11,8,0,0,2,1
S01010790,Rented or living rent free: Total,48,24,19,7,12,4,1,24,16,0,2,5,1
S01010790,Rented or living rent free: Social rented,22,10,9,4,5,1,0,12,7,0,1,3,1
S01010790,Rented or living rent free: Private rented or living rent free,26,14,10,3,7,3,1,12,9,0,1,2,0
S01010791,All HRPs aged 16 and over,369,235,156,18,138,70,9,134,121,0,2,8,3
S01010791,Owned: Total,309,200,130,11,119,61,9,109,101,0,1,4,3
S01010791,Owned: Owned outright,204,104,58,9,49,40,6,100,95,0,1,1,3
S01010791,Owned: Owned with a mortgage or loan or shared ownership,105,96,72,2,70,21,3,9,6,0,0,3,0
S01010791,Rented or living rent free: Total,60,35,26,7,19,9,0,25,20,0,1,4,0
S01010791,Rented or living rent free: Social rented,26,9,7,2,5,2,0,17,12,0,1,4,0
S01010791,Rented or living rent free: Private rented or living rent free,34,26,19,5,14,7,0,8,8,0,0,0,0
S01010792,All HRPs aged 16 and over,287,201,171,34,137,14,16,86,63,1,7,10,5
S01010792,Owned: Total,153,116,107,11,96,9,0,37,36,0,0,0,1
S01010792,Owned: Owned outright,78,45,42,3,39,3,0,33,32,0,0,0,1
S01010792,Owned: Owned with a mortgage or loan or shared ownership,75,71,65,8,57,6,0,4,4,0,0,0,0
S01010792,Rented or living rent free: Total,134,85,64,23,41,5,16,49,27,1,7,10,4
S01010792,Rented or living rent free: Social rented,115,72,52,21,31,4,16,43,24,1,6,9,3
S01010792,Rented or living rent free: Private rented or living rent free,19,13,12,2,10,1,0,6,3,0,1,1,1
S01010793,All HRPs aged 16 and over,275,198,147,24,123,48,3,77,66,0,1,8,2
S01010793,Owned: Total,225,168,129,18,111,39,0,57,53,0,0,3,1
S01010793,Owned: Owned outright,129,76,48,9,39,28,0,53,49,0,0,3,1
S01010793,Owned: Owned with a mortgage or loan or shared ownership,96,92,81,9,72,11,0,4,4,0,0,0,0
S01010793,Rented or living rent free: Total,50,30,18,6,12,9,3,20,13,0,1,5,1
S01010793,Rented or living rent free: Social rented,20,7,5,3,2,0,2,13,11,0,1,1,0
S01010793,Rented or living rent free: Private rented or living rent free,30,23,13,3,10,9,1,7,2,0,0,4,1
S01010794,All HRPs aged 16 and over,234,174,133,18,115,34,7,60,46,0,2,10,2
S01010794,Owned: Total,172,132,99,8,91,30,3,40,38,0,0,2,0
S01010794,Owned: Owned outright,80,42,24,3,21,15,3,38,36,0,0,2,0
S01010794,Owned: Owned with a mortgage or loan or shared ownership,92,90,75,5,70,15,0,2,2,0,0,0,0
S01010794,Rented or living rent free: Total,62,42,34,10,24,4,4,20,8,0,2,8,2
S01010794,Rented or living rent free: Social rented,21,12,6,3,3,2,4,9,2,0,2,4,1
S01010794,Rented or living rent free: Private rented or living rent free,41,30,28,7,21,2,0,11,6,0,0,4,1
S01010795,All HRPs aged 16 and over,445,281,217,40,177,45,19,164,144,2,3,12,3
S01010795,Owned: Total,339,223,176,30,146,41,6,116,114,0,0,2,0
S01010795,Owned: Owned outright,202,93,71,23,48,19,3,109,109,0,0,0,0
S01010795,Owned: Owned with a mortgage or loan or shared ownership,137,130,105,7,98,22,3,7,5,0,0,2,0
S01010795,Rented or living rent free: Total,106,58,41,10,31,4,13,48,30,2,3,10,3
S01010795,Rented or living rent free: Social rented,59,27,21,8,13,2,4,32,22,0,0,7,3
S01010795,Rented or living rent free: Private rented or living rent free,47,31,20,2,18,2,9,16,8,2,3,3,0
S01010796,All HRPs aged 16 and over,341,256,176,17,159,75,5,85,79,0,2,4,0
S01010796,Owned: Total,280,210,144,15,129,64,2,70,67,0,1,2,0
S01010796,Owned: Owned outright,177,112,60,11,49,51,1,65,63,0,1,1,0
S01010796,Owned: Owned with a mortgage or loan or shared ownership,103,98,84,4,80,13,1,5,4,0,0,1,0
S01010796,Rented or living rent free: Total,61,46,32,2,30,11,3,15,12,0,1,2,0
S01010796,Rented or living rent free: Social rented,15,7,5,1,4,0,2,8,6,0,1,1,0
S01010796,Rented or living rent free: Private rented or living rent free,46,39,27,1,26,11,1,7,6,0,0,1,0
S01010797,All HRPs aged 16 and over,329,242,198,10,188,41,3,87,79,3,1,3,1
S01010797,Owned: Total,269,206,169,9,160,36,1,63,60,1,1,0,1
S01010797,Owned: Owned outright,146,90,66,7,59,23,1,56,55,0,0,0,1
S01010797,Owned: Owned with a mortgage or loan or shared ownership,123,116,103,2,101,13,0,7,5,1,1,0,0
S01010797,Rented or living rent free: Total,60,36,29,1,28,5,2,24,19,2,0,3,0
S01010797,Rented or living rent free: Social rented,22,14,13,1,12,0,1,8,6,2,0,0,0
S01010797,Rented or living rent free: Private rented or living rent free,38,22,16,0,16,5,1,16,13,0,0,3,0
S01010798,All HRPs aged 16 and over,293,210,154,23,131,47,9,83,72,0,0,8,3
S01010798,Owned: Total,234,172,125,18,107,44,3,62,59,0,0,1,2
S01010798,Owned: Owned outright,155,94,56,15,41,35,3,61,59,0,0,0,2
S01010798,Owned: Owned with a mortgage or loan or shared ownership,79,78,69,3,66,9,0,1,0,0,0,1,0
S01010798,Rented or living rent free: Total,59,38,29,5,24,3,6,21,13,0,0,7,1
S01010798,Rented or living rent free: Social rented,27,14,10,3,7,1,3,13,8,0,0,5,0
S01010798,Rented or living rent free: Private rented or living rent free,32,24,19,2,17,2,3,8,5,0,0,2,1
S01010799,All HRPs aged 16 and over,530,305,250,34,216,36,19,225,190,5,5,18,7
S01010799,Owned: Total,305,171,144,14,130,24,3,134,124,1,3,4,2
S01010799,Owned: Owned outright,186,61,44,10,34,16,1,125,118,0,3,3,1
S01010799,Owned: Owned with a mortgage or loan or shared ownership,119,110,100,4,96,8,2,9,6,1,0,1,1
S01010799,Rented or living rent free: Total,225,134,106,20,86,12,16,91,66,4,2,14,5
S01010799,Rented or living rent free: Social rented,135,59,44,13,31,6,9,76,55,0,2,14,5
S01010799,Rented or living rent free: Private rented or living rent free,90,75,62,7,55,6,7,15,11,4,0,0,0
S01010800,All HRPs aged 16 and over,360,233,206,40,166,16,11,127,103,0,7,12,5
S01010800,Owned: Total,208,130,123,16,107,7,0,78,74,0,0,2,2
S01010800,Owned: Owned outright,110,37,36,8,28,1,0,73,71,0,0,2,0
S01010800,Owned: Owned with a mortgage or loan or shared ownership,98,93,87,8,79,6,0,5,3,0,0,0,2
S01010800,Rented or living rent free: Total,152,103,83,24,59,9,11,49,29,0,7,10,3
S01010800,Rented or living rent free: Social rented,129,84,67,19,48,6,11,45,26,0,6,10,3
S01010800,Rented or living rent free: Private rented or living rent free,23,19,16,5,11,3,0,4,3,0,1,0,0
S01010801,All HRPs aged 16 and over,354,206,179,34,145,17,10,148,123,1,4,16,4
S01010801,Owned: Total,214,142,127,20,107,13,2,72,64,0,1,6,1
S01010801,Owned: Owned outright,119,53,48,14,34,4,1,66,60,0,1,4,1
S01010801,Owned: Owned with a mortgage or loan or shared ownership,95,89,79,6,73,9,1,6,4,0,0,2,0
S01010801,Rented or living rent free: Total,140,64,52,14,38,4,8,76,59,1,3,10,3
S01010801,Rented or living rent free: Social rented,120,46,35,11,24,3,8,74,58,1,3,9,3
S01010801,Rented or living rent free: Private rented or living rent free,20,18,17,3,14,1,0,2,1,0,0,1,0
S01010802,All HRPs aged 16 and over,263,187,150,14,136,22,15,76,66,1,3,5,1
S01010802,Owned: Total,174,124,103,7,96,19,2,50,48,0,0,2,0
S01010802,Owned: Owned outright,84,36,28,4,24,6,2,48,46,0,0,2,0
S01010802,Owned: Owned with a mortgage or loan or shared ownership,90,88,75,3,72,13,0,2,2,0,0,0,0
S01010802,Rented or living rent free: Total,89,63,47,7,40,3,13,26,18,1,3,3,1
S01010802,Rented or living rent free: Social rented,69,49,36,5,31,2,11,20,13,0,3,3,1
S01010802,Rented or living rent free: Private rented or living rent free,20,14,11,2,9,1,2,6,5,1,0,0,0
S01010803,All HRPs aged 16 and over,280,170,136,27,109,18,16,110,84,4,7,14,1
S01010803,Owned: Total,140,83,68,5,63,14,1,57,55,1,1,0,0
S01010803,Owned: Owned outright,79,27,19,4,15,7,1,52,51,0,1,0,0
S01010803,Owned: Owned with a mortgage or loan or shared ownership,61,56,49,1,48,7,0,5,4,1,0,0,0
S01010803,Rented or living rent free: Total,140,87,68,22,46,4,15,53,29,3,6,14,1
S01010803,Rented or living rent free: Social rented,107,64,49,20,29,2,13,43,25,3,6,8,1
S01010803,Rented or living rent free: Private rented or living rent free,33,23,19,2,17,2,2,10,4,0,0,6,0
S01010804,All HRPs aged 16 and over,283,180,151,18,133,25,4,103,90,0,2,9,2
S01010804,Owned: Total,192,117,95,10,85,22,0,75,73,0,1,0,1
S01010804,Owned: Owned outright,124,49,34,6,28,15,0,75,73,0,1,0,1
S01010804,Owned: Owned with a mortgage or loan or shared ownership,68,68,61,4,57,7,0,0,0,0,0,0,0
S01010804,Rented or living rent free: Total,91,63,56,8,48,3,4,28,17,0,1,9,1
S01010804,Rented or living rent free: Social rented,58,38,33,8,25,2,3,20,11,0,1,8,0
S01010804,Rented or living rent free: Private rented or living rent free,33,25,23,0,23,1,1,8,6,0,0,1,1
S01010805,All HRPs aged 16 and over,377,257,223,35,188,22,12,120,106,0,4,6,4
S01010805,Owned: Total,273,179,156,22,134,19,4,94,92,0,1,1,0
S01010805,Owned: Owned outright,159,70,61,12,49,7,2,89,88,0,0,1,0
S01010805,Owned: Owned with a mortgage or loan or shared ownership,114,109,95,10,85,12,2,5,4,0,1,0,0
S01010805,Rented or living rent free: Total,104,78,67,13,54,3,8,26,14,0,3,5,4
S01010805,Rented or living rent free: Social rented,74,52,44,11,33,1,7,22,13,0,3,4,2
S01010805,Rented or living rent free: Private rented or living rent free,30,26,23,2,21,2,1,4,1,0,0,1,2
S01010806,All HRPs aged 16 and over,458,267,223,59,164,20,24,191,111,8,12,51,9
S01010806,Owned: Total,217,149,132,23,109,15,2,68,64,1,0,3,0
S01010806,Owned: Owned outright,112,52,44,10,34,7,1,60,58,1,0,1,0
S01010806,Owned: Owned with a mortgage or loan or shared ownership,105,97,88,13,75,8,1,8,6,0,0,2,0
S01010806,Rented or living rent free: Total,241,118,91,36,55,5,22,123,47,7,12,48,9
S01010806,Rented or living rent free: Social rented,211,93,71,33,38,4,18,118,43,7,12,47,9
S01010806,Rented or living rent free: Private rented or living rent free,30,25,20,3,17,1,4,5,4,0,0,1,0
S01010807,All HRPs aged 16 and over,244,162,134,20,114,20,8,82,70,1,8,1,2
S01010807,Owned: Total,149,95,83,9,74,12,0,54,50,0,2,1,1
S01010807,Owned: Owned outright,85,39,30,5,25,9,0,46,46,0,0,0,0
S01010807,Owned: Owned with a mortgage or loan or shared ownership,64,56,53,4,49,3,0,8,4,0,2,1,1
S01010807,Rented or living rent free: Total,95,67,51,11,40,8,8,28,20,1,6,0,1
S01010807,Rented or living rent free: Social rented,77,51,37,7,30,7,7,26,18,1,6,0,1
S01010807,Rented or living rent free: Private rented or living rent free,18,16,14,4,10,1,1,2,2,0,0,0,0
S01010808,All HRPs aged 16 and over,230,161,146,13,133,11,4,69,56,0,7,3,3
S01010808,Owned: Total,156,104,97,3,94,7,0,52,47,0,3,1,1
S01010808,Owned: Owned outright,86,37,35,2,33,2,0,49,47,0,1,0,1
S01010808,Owned: Owned with a mortgage or loan or shared ownership,70,67,62,1,61,5,0,3,0,0,2,1,0
S01010808,Rented or living rent free: Total,74,57,49,10,39,4,4,17,9,0,4,2,2
S01010808,Rented or living rent free: Social rented,59,44,37,10,27,3,4,15,7,0,4,2,2
S01010808,Rented or living rent free: Private rented or living rent free,15,13,12,0,12,1,0,2,2,0,0,0,0
S01010809,All HRPs aged 16 and over,328,240,208,20,188,25,7,88,79,1,2,4,2
S01010809,Owned: Total,259,194,172,14,158,19,3,65,63,0,1,0,1
S01010809,Owned: Owned outright,141,82,71,11,60,9,2,59,58,0,0,0,1
S01010809,Owned: Owned with a mortgage or loan or shared ownership,118,112,101,3,98,10,1,6,5,0,1,0,0
S01010809,Rented or living rent free: Total,69,46,36,6,30,6,4,23,16,1,1,4,1
S01010809,Rented or living rent free: Social rented,36,16,11,3,8,2,3,20,13,1,1,4,1
S01010809,Rented or living rent free: Private rented or living rent free,33,30,25,3,22,4,1,3,3,0,0,0,0
S01010810,All HRPs aged 16 and over,249,130,91,10,81,29,10,119,106,1,0,8,4
S01010810,Owned: Total,173,94,67,6,61,22,5,79,76,0,0,0,3
S01010810,Owned: Owned outright,130,57,35,6,29,17,5,73,71,0,0,0,2
S01010810,Owned: Owned with a mortgage or loan or shared ownership,43,37,32,0,32,5,0,6,5,0,0,0,1
S01010810,Rented or living rent free: Total,76,36,24,4,20,7,5,40,30,1,0,8,1
S01010810,Rented or living rent free: Social rented,46,20,11,3,8,4,5,26,18,1,0,6,1
S01010810,Rented or living rent free: Private rented or living rent free,30,16,13,1,12,3,0,14,12,0,0,2,0
S01010811,All HRPs aged 16 and over,414,267,184,39,145,67,16,147,128,0,6,11,2
S01010811,Owned: Total,278,170,112,20,92,52,6,108,98,0,5,4,1
S01010811,Owned: Owned outright,197,98,57,10,47,37,4,99,94,0,3,1,1
S01010811,Owned: Owned with a mortgage or loan or shared ownership,81,72,55,10,45,15,2,9,4,0,2,3,0
S01010811,Rented or living rent free: Total,136,97,72,19,53,15,10,39,30,0,1,7,1
S01010811,Rented or living rent free: Social rented,50,31,21,11,10,4,6,19,12,0,1,5,1
S01010811,Rented or living rent free: Private rented or living rent free,86,66,51,8,43,11,4,20,18,0,0,2,0
S01010812,All HRPs aged 16 and over,238,153,92,18,74,51,10,85,71,0,0,8,6
S01010812,Owned: Total,176,115,64,12,52,47,4,61,58,0,0,2,1
S01010812,Owned: Owned outright,130,69,34,10,24,31,4,61,58,0,0,2,1
S01010812,Owned: Owned with a mortgage or loan or shared ownership,46,46,30,2,28,16,0,0,0,0,0,0,0
S01010812,Rented or living rent free: Total,62,38,28,6,22,4,6,24,13,0,0,6,5
S01010812,Rented or living rent free: Social rented,35,17,12,3,9,2,3,18,10,0,0,6,2
S01010812,Rented or living rent free: Private rented or living rent free,27,21,16,3,13,2,3,6,3,0,0,0,3
S01010813,All HRPs aged 16 and over,249,175,110,19,91,53,12,74,57,1,3,11,2
S01010813,Owned: Total,153,114,66,14,52,43,5,39,34,0,0,4,1
S01010813,Owned: Owned outright,93,58,29,11,18,25,4,35,32,0,0,3,0
S01010813,Owned: Owned with a mortgage or loan or shared ownership,60,56,37,3,34,18,1,4,2,0,0,1,1
S01010813,Rented or living rent free: Total,96,61,44,5,39,10,7,35,23,1,3,7,1
S01010813,Rented or living rent free: Social rented,63,34,26,5,21,4,4,29,19,1,3,5,1
S01010813,Rented or living rent free: Private rented or living rent free,33,27,18,0,18,6,3,6,4,0,0,2,0
S01010814,All HRPs aged 16 and over,307,208,120,19,101,81,7,99,93,0,2,2,2
S01010814,Owned: Total,235,155,87,16,71,66,2,80,77,0,1,0,2
S01010814,Owned: Owned outright,170,95,48,11,37,45,2,75,73,0,0,0,2
S01010814,Owned: Owned with a mortgage or loan or shared ownership,65,60,39,5,34,21,0,5,4,0,1,0,0
S01010814,Rented or living rent free: Total,72,53,33,3,30,15,5,19,16,0,1,2,0
S01010814,Rented or living rent free: Social rented,29,17,10,1,9,4,3,12,9,0,1,2,0
S01010814,Rented or living rent free: Private rented or living rent free,43,36,23,2,21,11,2,7,7,0,0,0,0
S01010815,All HRPs aged 16 and over,208,140,108,20,88,30,2,68,58,0,2,5,3
S01010815,Owned: Total,120,78,53,12,41,25,0,42,39,0,0,1,2
S01010815,Owned: Owned outright,90,50,30,11,19,20,0,40,37,0,0,1,2
S01010815,Owned: Owned with a mortgage or loan or shared ownership,30,28,23,1,22,5,0,2,2,0,0,0,0
S01010815,Rented or living rent free: Total,88,62,55,8,47,5,2,26,19,0,2,4,1
S01010815,Rented or living rent free: Social rented,42,27,24,6,18,2,1,15,10,0,2,3,0
S01010815,Rented or living rent free: Private rented or living rent free,46,35,31,2,29,3,1,11,9,0,0,1,1
S01010816,All HRPs aged 16 and over,293,149,104,13,91,43,2,144,125,3,4,8,4
S01010816,Owned: Total,237,131,88,10,78,42,1,106,96,2,3,2,3
S01010816,Owned: Owned outright,143,50,34,5,29,16,0,93,90,1,1,0,1
S01010816,Owned: Owned with a mortgage or loan or shared ownership,94,81,54,5,49,26,1,13,6,1,2,2,2
S01010816,Rented or living rent free: Total,56,18,16,3,13,1,1,38,29,1,1,6,1
S01010816,Rented or living rent free: Social rented,26,2,1,0,1,0,1,24,20,1,0,3,0
S01010816,Rented or living rent free: Private rented or living rent free,30,16,15,3,12,1,0,14,9,0,1,3,1
S01010817,All HRPs aged 16 and over,376,251,177,21,156,68,6,125,101,0,3,20,1
S01010817,Owned: Total,326,217,156,18,138,58,3,109,96,0,2,10,1
S01010817,Owned: Owned outright,168,74,46,6,40,28,0,94,89,0,0,4,1
S01010817,Owned: Owned with a mortgage or loan or shared ownership,158,143,110,12,98,30,3,15,7,0,2,6,0
S01010817,Rented or living rent free: Total,50,34,21,3,18,10,3,16,5,0,1,10,0
S01010817,Rented or living rent free: Social rented,6,6,4,0,4,1,1,0,0,0,0,0,0
S01010817,Rented or living rent free: Private rented or living rent free,44,28,17,3,14,9,2,16,5,0,1,10,0
S01010818,All HRPs aged 16 and over,507,321,242,35,207,65,14,186,165,5,3,9,4
S01010818,Owned: Total,410,252,194,22,172,51,7,158,151,1,0,3,3
S01010818,Owned: Owned outright,213,71,52,13,39,18,1,142,137,1,0,2,2
S01010818,Owned: Owned with a mortgage or loan or shared ownership,197,181,142,9,133,33,6,16,14,0,0,1,1
S01010818,Rented or living rent free: Total,97,69,48,13,35,14,7,28,14,4,3,6,1
S01010818,Rented or living rent free: Social rented,20,13,9,4,5,1,3,7,4,0,0,2,1
S01010818,Rented or living rent free: Private rented or living rent free,77,56,39,9,30,13,4,21,10,4,3,4,0
S01010819,All HRPs aged 16 and over,374,210,164,26,138,41,5,164,135,1,6,20,2
S01010819,Owned: Total,293,166,127,16,111,36,3,127,116,0,3,7,1
S01010819,Owned: Owned outright,145,51,37,9,28,11,3,94,90,0,1,2,1
S01010819,Owned: Owned with a mortgage or loan or shared ownership,148,115,90,7,83,25,0,33,26,0,2,5,0
S01010819,Rented or living rent free: Total,81,44,37,10,27,5,2,37,19,1,3,13,1
S01010819,Rented or living rent free: Social rented,44,16,13,4,9,3,0,28,16,1,0,11,0
S01010819,Rented or living rent free: Private rented or living rent free,37,28,24,6,18,2,2,9,3,0,3,2,1
S01010820,All HRPs aged 16 and over,217,150,114,15,99,35,1,67,56,0,8,2,1
S01010820,Owned: Total,191,130,96,14,82,33,1,61,55,0,4,1,1
S01010820,Owned: Owned outright,104,50,33,9,24,17,0,54,49,0,3,1,1
S01010820,Owned: Owned with a mortgage or loan or shared ownership,87,80,63,5,58,16,1,7,6,0,1,0,0
S01010820,Rented or living rent free: Total,26,20,18,1,17,2,0,6,1,0,4,1,0
S01010820,Rented or living rent free: Social rented,1,0,0,0,0,0,0,1,0,0,0,1,0
S01010820,Rented or living rent free: Private rented or living rent free,25,20,18,1,17,2,0,5,1,0,4,0,0
S01010821,All HRPs aged 16 and over,245,137,100,8,92,36,1,108,98,0,2,5,3
S01010821,Owned: Total,211,116,85,7,78,31,0,95,92,0,0,1,2
S01010821,Owned: Owned outright,128,39,26,5,21,13,0,89,86,0,0,1,2
S01010821,Owned: Owned with a mortgage or loan or shared ownership,83,77,59,2,57,18,0,6,6,0,0,0,0
S01010821,Rented or living rent free: Total,34,21,15,1,14,5,1,13,6,0,2,4,1
S01010821,Rented or living rent free: Social rented,10,2,1,0,1,0,1,8,1,0,2,4,1
S01010821,Rented or living rent free: Private rented or living rent free,24,19,14,1,13,5,0,5,5,0,0,0,0
S01010822,All HRPs aged 16 and over,280,213,141,18,123,63,9,67,43,3,5,9,7
S01010822,Owned: Total,220,171,112,13,99,55,4,49,36,3,4,2,4
S01010822,Owned: Owned outright,93,50,31,4,27,18,1,43,33,2,3,1,4
S01010822,Owned: Owned with a mortgage or loan or shared ownership,127,121,81,9,72,37,3,6,3,1,1,1,0
S01010822,Rented or living rent free: Total,60,42,29,5,24,8,5,18,7,0,1,7,3
S01010822,Rented or living rent free: Social rented,7,3,1,0,1,0,2,4,3,0,0,1,0
S01010822,Rented or living rent free: Private rented or living rent free,53,39,28,5,23,8,3,14,4,0,1,6,3
S01010823,All HRPs aged 16 and over,147,127,108,19,89,17,2,20,10,3,2,4,1
S01010823,Owned: Total,115,106,93,14,79,12,1,9,7,0,0,2,0
S01010823,Owned: Owned outright,19,13,10,1,9,3,0,6,5,0,0,1,0
S01010823,Owned: Owned with a mortgage or loan or shared ownership,96,93,83,13,70,9,1,3,2,0,0,1,0
S01010823,Rented or living rent free: Total,32,21,15,5,10,5,1,11,3,3,2,2,1
S01010823,Rented or living rent free: Social rented,17,10,8,4,4,1,1,7,1,3,2,1,0
S01010823,Rented or living rent free: Private rented or living rent free,15,11,7,1,6,4,0,4,2,0,0,1,1
S01010824,All HRPs aged 16 and over,250,209,174,11,163,30,5,41,29,0,4,8,0
S01010824,Owned: Total,228,198,168,8,160,27,3,30,28,0,0,2,0
S01010824,Owned: Owned outright,45,20,13,1,12,6,1,25,24,0,0,1,0
S01010824,Owned: Owned with a mortgage or loan or shared ownership,183,178,155,7,148,21,2,5,4,0,0,1,0
S01010824,Rented or living rent free: Total,22,11,6,3,3,3,2,11,1,0,4,6,0
S01010824,Rented or living rent free: Social rented,11,4,2,2,0,1,1,7,0,0,1,6,0
S01010824,Rented or living rent free: Private rented or living rent free,11,7,4,1,3,2,1,4,1,0,3,0,0
S01010825,All HRPs aged 16 and over,125,100,84,4,80,16,0,25,20,1,2,2,0
S01010825,Owned: Total,113,94,81,4,77,13,0,19,16,0,1,2,0
S01010825,Owned: Owned outright,27,12,7,3,4,5,0,15,13,0,1,1,0
S01010825,Owned: Owned with a mortgage or loan or shared ownership,86,82,74,1,73,8,0,4,3,0,0,1,0
S01010825,Rented or living rent free: Total,12,6,3,0,3,3,0,6,4,1,1,0,0
S01010825,Rented or living rent free: Social rented,1,0,0,0,0,0,0,1,1,0,0,0,0
S01010825,Rented or living rent free: Private rented or living rent free,11,6,3,0,3,3,0,5,3,1,1,0,0
S01010826,All HRPs aged 16 and over,315,201,158,23,135,41,2,114,91,3,13,5,2
S01010826,Owned: Total,260,168,133,13,120,34,1,92,84,1,3,3,1
S01010826,Owned: Owned outright,129,49,39,7,32,10,0,80,77,1,1,1,0
S01010826,Owned: Owned with a mortgage or loan or shared ownership,131,119,94,6,88,24,1,12,7,0,2,2,1
S01010826,Rented or living rent free: Total,55,33,25,10,15,7,1,22,7,2,10,2,1
S01010826,Rented or living rent free: Social rented,5,2,2,0,2,0,0,3,1,0,1,1,0
S01010826,Rented or living rent free: Private rented or living rent free,50,31,23,10,13,7,1,19,6,2,9,1,1
S01010827,All HRPs aged 16 and over,221,175,155,17,138,18,2,46,41,0,1,4,0
S01010827,Owned: Total,211,171,154,17,137,15,2,40,38,0,0,2,0
S01010827,Owned: Owned outright,78,47,44,12,32,3,0,31,30,0,0,1,0
S01010827,Owned: Owned with a mortgage or loan or shared ownership,133,124,110,5,105,12,2,9,8,0,0,1,0
S01010827,Rented or living rent free: Total,10,4,1,0,1,3,0,6,3,0,1,2,0
S01010827,Rented or living rent free: Social rented,3,1,0,0,0,1,0,2,0,0,0,2,0
S01010827,Rented or living rent free: Private rented or living rent free,7,3,1,0,1,2,0,4,3,0,1,0,0
S01010828,All HRPs aged 16 and over,441,363,307,33,274,50,6,78,61,1,2,12,2
S01010828,Owned: Total,405,345,294,29,265,48,3,60,55,0,0,3,2
S01010828,Owned: Owned outright,123,76,60,11,49,14,2,47,45,0,0,1,1
S01010828,Owned: Owned with a mortgage or loan or shared ownership,282,269,234,18,216,34,1,13,10,0,0,2,1
S01010828,Rented or living rent free: Total,36,18,13,4,9,2,3,18,6,1,2,9,0
S01010828,Rented or living rent free: Social rented,22,10,8,1,7,0,2,12,1,1,2,8,0
S01010828,Rented or living rent free: Private rented or living rent free,14,8,5,3,2,2,1,6,5,0,0,1,0
S01010829,All HRPs aged 16 and over,464,282,224,36,188,51,7,182,149,3,2,20,8
S01010829,Owned: Total,353,222,180,26,154,40,2,131,118,2,0,7,4
S01010829,Owned: Owned outright,168,66,54,17,37,11,1,102,96,0,0,2,4
S01010829,Owned: Owned with a mortgage or loan or shared ownership,185,156,126,9,117,29,1,29,22,2,0,5,0
S01010829,Rented or living rent free: Total,111,60,44,10,34,11,5,51,31,1,2,13,4
S01010829,Rented or living rent free: Social rented,31,7,5,1,4,2,0,24,18,0,2,3,1
S01010829,Rented or living rent free: Private rented or living rent free,80,53,39,9,30,9,5,27,13,1,0,10,3
S01010830,All HRPs aged 16 and over,231,160,133,21,112,23,4,71,56,0,4,10,1
S01010830,Owned: Total,186,131,110,11,99,20,1,55,47,0,2,5,1
S01010830,Owned: Owned outright,70,34,29,6,23,5,0,36,35,0,1,0,0
S01010830,Owned: Owned with a mortgage or loan or shared ownership,116,97,81,5,76,15,1,19,12,0,1,5,1
S01010830,Rented or living rent free: Total,45,29,23,10,13,3,3,16,9,0,2,5,0
S01010830,Rented or living rent free: Social rented,17,8,4,1,3,1,3,9,6,0,0,3,0
S01010830,Rented or living rent free: Private rented or living rent free,28,21,19,9,10,2,0,7,3,0,2,2,0
S01010831,All HRPs aged 16 and over,197,174,148,8,140,23,3,23,13,1,3,6,0
S01010831,Owned: Total,182,169,144,7,137,22,3,13,11,0,1,1,0
S01010831,Owned: Owned outright,25,16,15,1,14,1,0,9,8,0,1,0,0
S01010831,Owned: Owned with a mortgage or loan or shared ownership,157,153,129,6,123,21,3,4,3,0,0,1,0
S01010831,Rented or living rent free: Total,15,5,4,1,3,1,0,10,2,1,2,5,0
S01010831,Rented or living rent free: Social rented,8,3,2,1,1,1,0,5,2,1,0,2,0
S01010831,Rented or living rent free: Private rented or living rent free,7,2,2,0,2,0,0,5,0,0,2,3,0
S01010832,All HRPs aged 16 and over,284,229,204,29,175,20,5,55,38,2,6,8,1
S01010832,Owned: Total,240,201,181,25,156,17,3,39,31,0,1,6,1
S01010832,Owned: Owned outright,66,40,31,7,24,7,2,26,25,0,0,1,0
S01010832,Owned: Owned with a mortgage or loan or shared ownership,174,161,150,18,132,10,1,13,6,0,1,5,1
S01010832,Rented or living rent free: Total,44,28,23,4,19,3,2,16,7,2,5,2,0
S01010832,Rented or living rent free: Social rented,8,6,5,0,5,0,1,2,0,0,0,2,0
S01010832,Rented or living rent free: Private rented or living rent free,36,22,18,4,14,3,1,14,7,2,5,0,0
S01010833,All HRPs aged 16 and over,348,258,213,17,196,45,0,90,80,1,1,5,3
S01010833,Owned: Total,336,248,204,16,188,44,0,88,78,1,1,5,3
S01010833,Owned: Owned outright,137,60,49,13,36,11,0,77,69,1,0,4,3
S01010833,Owned: Owned with a mortgage or loan or shared ownership,199,188,155,3,152,33,0,11,9,0,1,1,0
S01010833,Rented or living rent free: Total,12,10,9,1,8,1,0,2,2,0,0,0,0
S01010833,Rented or living rent free: Social rented,1,1,1,0,1,0,0,0,0,0,0,0,0
S01010833,Rented or living rent free: Private rented or living rent free,11,9,8,1,7,1,0,2,2,0,0,0,0
S01010834,All HRPs aged 16 and over,422,251,211,20,191,33,7,171,156,1,1,9,4
S01010834,Owned: Total,382,225,191,18,173,30,4,157,151,1,1,4,0
S01010834,Owned: Owned outright,223,80,64,11,53,14,2,143,138,1,1,3,0
S01010834,Owned: Owned with a mortgage or loan or shared ownership,159,145,127,7,120,16,2,14,13,0,0,1,0
S01010834,Rented or living rent free: Total,40,26,20,2,18,3,3,14,5,0,0,5,4
S01010834,Rented or living rent free: Social rented,4,3,1,0,1,1,1,1,0,0,0,0,1
S01010834,Rented or living rent free: Private rented or living rent free,36,23,19,2,17,2,2,13,5,0,0,5,3
S01010835,All HRPs aged 16 and over,270,156,131,15,116,23,2,114,109,1,1,3,0
S01010835,Owned: Total,263,150,126,13,113,23,1,113,109,0,1,3,0
S01010835,Owned: Owned outright,162,58,45,6,39,12,1,104,101,0,0,3,0
S01010835,Owned: Owned with a mortgage or loan or shared ownership,101,92,81,7,74,11,0,9,8,0,1,0,0
S01010835,Rented or living rent free: Total,7,6,5,2,3,0,1,1,0,1,0,0,0
S01010835,Rented or living rent free: Social rented,0,0,0,0,0,0,0,0,0,0,0,0,0
S01010835,Rented or living rent free: Private rented or living rent free,7,6,5,2,3,0,1,1,0,1,0,0,0
S01010836,All HRPs aged 16 and over,384,246,195,21,174,41,10,138,112,2,9,14,1
S01010836,Owned: Total,323,206,166,17,149,35,5,117,105,1,4,7,0
S01010836,Owned: Owned outright,165,63,49,8,41,10,4,102,93,1,3,5,0
S01010836,Owned: Owned with a mortgage or loan or shared ownership,158,143,117,9,108,25,1,15,12,0,1,2,0
S01010836,Rented or living rent free: Total,61,40,29,4,25,6,5,21,7,1,5,7,1
S01010836,Rented or living rent free: Social rented,5,3,2,2,0,1,0,2,1,0,0,0,1
S01010836,Rented or living rent free: Private rented or living rent free,56,37,27,2,25,5,5,19,6,1,5,7,0
S01010837,All HRPs aged 16 and over,289,151,132,22,110,17,2,138,115,5,3,14,1
S01010837,Owned: Total,255,136,119,17,102,16,1,119,107,1,0,10,1
S01010837,Owned: Owned outright,133,46,38,8,30,8,0,87,82,0,0,4,1
S01010837,Owned: Owned with a mortgage or loan or shared ownership,122,90,81,9,72,8,1,32,25,1,0,6,0
S01010837,Rented or living rent free: Total,34,15,13,5,8,1,1,19,8,4,3,4,0
S01010837,Rented or living rent free: Social rented,22,7,6,3,3,0,1,15,7,2,3,3,0
S01010837,Rented or living rent free: Private rented or living rent free,12,8,7,2,5,1,0,4,1,2,0,1,0
S01010838,All HRPs aged 16 and over,330,220,194,21,173,17,9,110,86,0,6,16,2
S01010838,Owned: Total,267,183,167,14,153,14,2,84,75,0,1,8,0
S01010838,Owned: Owned outright,111,44,39,5,34,4,1,67,60,0,1,6,0
S01010838,Owned: Owned with a mortgage or loan or shared ownership,156,139,128,9,119,10,1,17,15,0,0,2,0
S01010838,Rented or living rent free: Total,63,37,27,7,20,3,7,26,11,0,5,8,2
S01010838,Rented or living rent free: Social rented,47,28,21,6,15,3,4,19,10,0,2,5,2
S01010838,Rented or living rent free: Private rented or living rent free,16,9,6,1,5,0,3,7,1,0,3,3,0
S01010839,All HRPs aged 16 and over,339,187,157,20,137,19,11,152,121,6,6,16,3
S01010839,Owned: Total,281,155,135,12,123,18,2,126,114,2,4,4,2
S01010839,Owned: Owned outright,144,37,31,5,26,5,1,107,101,0,3,3,0
S01010839,Owned: Owned with a mortgage or loan or shared ownership,137,118,104,7,97,13,1,19,13,2,1,1,2
S01010839,Rented or living rent free: Total,58,32,22,8,14,1,9,26,7,4,2,12,1
S01010839,Rented or living rent free: Social rented,36,16,12,6,6,0,4,20,6,1,2,11,0
S01010839,Rented or living rent free: Private rented or living rent free,22,16,10,2,8,1,5,6,1,3,0,1,1
S01010840,All HRPs aged 16 and over,300,148,126,13,113,16,6,152,111,3,6,27,5
S01010840,Owned: Total,222,117,101,8,93,15,1,105,97,1,0,5,2
S01010840,Owned: Owned outright,114,26,20,5,15,6,0,88,83,1,0,3,1
S01010840,Owned: Owned with a mortgage or loan or shared ownership,108,91,81,3,78,9,1,17,14,0,0,2,1
S01010840,Rented or living rent free: Total,78,31,25,5,20,1,5,47,14,2,6,22,3
S01010840,Rented or living rent free: Social rented,13,5,3,1,2,0,2,8,2,1,0,4,1
S01010840,Rented or living rent free: Private rented or living rent free,65,26,22,4,18,1,3,39,12,1,6,18,2
S01010841,All HRPs aged 16 and over,390,247,203,28,175,25,19,143,109,4,10,9,11
S01010841,Owned: Total,297,197,165,18,147,22,10,100,90,3,2,1,4
S01010841,Owned: Owned outright,135,51,36,8,28,10,5,84,78,2,0,0,4
S01010841,Owned: Owned with a mortgage or loan or shared ownership,162,146,129,10,119,12,5,16,12,1,2,1,0
S01010841,Rented or living rent free: Total,93,50,38,10,28,3,9,43,19,1,8,8,7
S01010841,Rented or living rent free: Social rented,13,2,0,0,0,0,2,11,6,1,0,1,3
S01010841,Rented or living rent free: Private rented or living rent free,80,48,38,10,28,3,7,32,13,0,8,7,4
S01010842,All HRPs aged 16 and over,613,260,214,32,182,22,24,353,247,15,11,63,17
S01010842,Owned: Total,270,144,126,12,114,14,4,126,113,2,2,7,2
S01010842,Owned: Owned outright,134,37,30,6,24,5,2,97,88,1,1,7,0
S01010842,Owned: Owned with a mortgage or loan or shared ownership,136,107,96,6,90,9,2,29,25,1,1,0,2
S01010842,Rented or living rent free: Total,343,116,88,20,68,8,20,227,134,13,9,56,15
S01010842,Rented or living rent free: Social rented,178,33,23,3,20,1,9,145,110,5,0,21,9
S01010842,Rented or living rent free: Private rented or living rent free,165,83,65,17,48,7,11,82,24,8,9,35,6
S01010843,All HRPs aged 16 and over,407,201,172,25,147,15,14,206,158,3,5,32,8
S01010843,Owned: Total,222,126,112,14,98,9,5,96,89,0,1,2,4
S01010843,Owned: Owned outright,101,29,24,4,20,4,1,72,70,0,0,0,2
S01010843,Owned: Owned with a mortgage or loan or shared ownership,121,97,88,10,78,5,4,24,19,0,1,2,2
S01010843,Rented or living rent free: Total,185,75,60,11,49,6,9,110,69,3,4,30,4
S01010843,Rented or living rent free: Social rented,90,17,16,2,14,0,1,73,54,1,4,13,1
S01010843,Rented or living rent free: Private rented or living rent free,95,58,44,9,35,6,8,37,15,2,0,17,3
S01010844,All HRPs aged 16 and over,289,175,156,23,133,14,5,114,100,5,1,6,2
S01010844,Owned: Total,268,167,151,23,128,14,2,101,94,2,1,3,1
S01010844,Owned: Owned outright,148,61,54,16,38,5,2,87,83,1,1,2,0
S01010844,Owned: Owned with a mortgage or loan or shared ownership,120,106,97,7,90,9,0,14,11,1,0,1,1
S01010844,Rented or living rent free: Total,21,8,5,0,5,0,3,13,6,3,0,3,1
S01010844,Rented or living rent free: Social rented,10,2,1,0,1,0,1,8,5,0,0,2,1
S01010844,Rented or living rent free: Private rented or living rent free,11,6,4,0,4,0,2,5,1,3,0,1,0
S01010845,All HRPs aged 16 and over,259,151,132,27,105,15,4,108,88,6,2,10,2
S01010845,Owned: Total,220,137,121,22,99,15,1,83,76,2,2,3,0
S01010845,Owned: Owned outright,114,47,39,8,31,8,0,67,64,0,1,2,0
S01010845,Owned: Owned with a mortgage or loan or shared ownership,106,90,82,14,68,7,1,16,12,2,1,1,0
S01010845,Rented or living rent free: Total,39,14,11,5,6,0,3,25,12,4,0,7,2
S01010845,Rented or living rent free: Social rented,24,5,3,1,2,0,2,19,12,1,0,5,1
S01010845,Rented or living rent free: Private rented or living rent free,15,9,8,4,4,0,1,6,0,3,0,2,1
S01010846,All HRPs aged 16 and over,296,211,183,51,132,15,13,85,48,3,3,28,3
S01010846,Owned: Total,217,162,142,34,108,14,6,55,41,2,1,11,0
S01010846,Owned: Owned outright,76,36,29,7,22,5,2,40,34,1,0,5,0
S01010846,Owned: Owned with a mortgage or loan or shared ownership,141,126,113,27,86,9,4,15,7,1,1,6,0
S01010846,Rented or living rent free: Total,79,49,41,17,24,1,7,30,7,1,2,17,3
S01010846,Rented or living rent free: Social rented,61,36,31,12,19,0,5,25,6,1,1,14,3
S01010846,Rented or living rent free: Private rented or living rent free,18,13,10,5,5,1,2,5,1,0,1,3,0
S01010847,All HRPs aged 16 and over,259,200,184,19,165,14,2,59,45,3,7,4,0
S01010847,Owned: Total,240,188,174,16,158,14,0,52,43,1,4,4,0
S01010847,Owned: Owned outright,70,30,27,8,19,3,0,40,35,1,2,2,0
S01010847,Owned: Owned with a mortgage or loan or shared ownership,170,158,147,8,139,11,0,12,8,0,2,2,0
S01010847,Rented or living rent free: Total,19,12,10,3,7,0,2,7,2,2,3,0,0
S01010847,Rented or living rent free: Social rented,6,3,2,1,1,0,1,3,1,1,1,0,0
S01010847,Rented or living rent free: Private rented or living rent free,13,9,8,2,6,0,1,4,1,1,2,0,0
S01010848,All HRPs aged 16 and over,260,155,125,31,94,13,17,105,51,5,16,30,3
S01010848,Owned: Total,130,87,74,16,58,9,4,43,34,2,3,2,2
S01010848,Owned: Owned outright,50,19,19,3,16,0,0,31,27,0,1,1,2
S01010848,Owned: Owned with a mortgage or loan or shared ownership,80,68,55,13,42,9,4,12,7,2,2,1,0
S01010848,Rented or living rent free: Total,130,68,51,15,36,4,13,62,17,3,13,28,1
S01010848,Rented or living rent free: Social rented,113,60,44,14,30,3,13,53,17,1,8,26,1
S01010848,Rented or living rent free: Private rented or living rent free,17,8,7,1,6,1,0,9,0,2,5,2,0
S01010849,All HRPs aged 16 and over,364,203,171,47,124,21,11,161,79,4,22,44,12
S01010849,Owned: Total,198,128,112,25,87,14,2,70,54,2,2,9,3
S01010849,Owned: Owned outright,77,35,34,8,26,1,0,42,39,0,1,2,0
S01010849,Owned: Owned with a mortgage or loan or shared ownership,121,93,78,17,61,13,2,28,15,2,1,7,3
S01010849,Rented or living rent free: Total,166,75,59,22,37,7,9,91,25,2,20,35,9
S01010849,Rented or living rent free: Social rented,148,68,54,19,35,6,8,80,23,1,15,35,6
S01010849,Rented or living rent free: Private rented or living rent free,18,7,5,3,2,1,1,11,2,1,5,0,3
S01010850,All HRPs aged 16 and over,373,191,154,49,105,10,27,182,75,8,21,63,15
S01010850,Owned: Total,176,112,102,21,81,8,2,64,48,3,0,10,3
S01010850,Owned: Owned outright,64,29,26,10,16,2,1,35,28,1,0,3,3
S01010850,Owned: Owned with a mortgage or loan or shared ownership,112,83,76,11,65,6,1,29,20,2,0,7,0
S01010850,Rented or living rent free: Total,197,79,52,28,24,2,25,118,27,5,21,53,12
S01010850,Rented or living rent free: Social rented,178,64,42,27,15,2,20,114,26,4,20,53,11
S01010850,Rented or living rent free: Private rented or living rent free,19,15,10,1,9,0,5,4,1,1,1,0,1
S01010851,All HRPs aged 16 and over,347,213,180,45,135,6,27,134,66,4,21,33,10
S01010851,Owned: Total,179,128,119,18,101,6,3,51,44,0,1,6,0
S01010851,Owned: Owned outright,59,21,19,6,13,2,0,38,35,0,1,2,0
S01010851,Owned: Owned with a mortgage or loan or shared ownership,120,107,100,12,88,4,3,13,9,0,0,4,0
S01010851,Rented or living rent free: Total,168,85,61,27,34,0,24,83,22,4,20,27,10
S01010851,Rented or living rent free: Social rented,136,70,50,26,24,0,20,66,21,3,12,21,9
S01010851,Rented or living rent free: Private rented or living rent free,32,15,11,1,10,0,4,17,1,1,8,6,1
S01010852,All HRPs aged 16 and over,306,185,153,32,121,22,10,121,93,1,9,17,1
S01010852,Owned: Total,233,151,125,23,102,21,5,82,70,0,4,7,1
S01010852,Owned: Owned outright,81,37,31,8,23,4,2,44,40,0,0,4,0
S01010852,Owned: Owned with a mortgage or loan or shared ownership,152,114,94,15,79,17,3,38,30,0,4,3,1
S01010852,Rented or living rent free: Total,73,34,28,9,19,1,5,39,23,1,5,10,0
S01010852,Rented or living rent free: Social rented,62,31,25,8,17,1,5,31,18,0,5,8,0
S01010852,Rented or living rent free: Private rented or living rent free,11,3,3,1,2,0,0,8,5,1,0,2,0
S01010853,All HRPs aged 16 and over,358,224,199,41,158,20,5,134,100,2,5,19,8
S01010853,Owned: Total,275,181,164,25,139,16,1,94,81,0,1,8,4
S01010853,Owned: Owned outright,102,45,40,9,31,4,1,57,49,0,1,6,1
S01010853,Owned: Owned with a mortgage or loan or shared ownership,173,136,124,16,108,12,0,37,32,0,0,2,3
S01010853,Rented or living rent free: Total,83,43,35,16,19,4,4,40,19,2,4,11,4
S01010853,Rented or living rent free: Social rented,66,32,28,15,13,3,1,34,18,1,2,11,2
S01010853,Rented or living rent free: Private rented or living rent free,17,11,7,1,6,1,3,6,1,1,2,0,2
S01010854,All HRPs aged 16 and over,384,242,201,59,142,16,25,142,72,0,16,44,10
S01010854,Owned: Total,184,121,105,17,88,11,5,63,48,0,2,9,4
S01010854,Owned: Owned outright,58,24,18,4,14,3,3,34,29,0,2,3,0
S01010854,Owned: Owned with a mortgage or loan or shared ownership,126,97,87,13,74,8,2,29,19,0,0,6,4
S01010854,Rented or living rent free: Total,200,121,96,42,54,5,20,79,24,0,14,35,6
S01010854,Rented or living rent free: Social rented,181,111,90,39,51,3,18,70,22,0,12,31,5
S01010854,Rented or living rent free: Private rented or living rent free,19,10,6,3,3,2,2,9,2,0,2,4,1
S01010855,All HRPs aged 16 and over,223,134,110,27,83,13,11,89,67,2,8,12,0
S01010855,Owned: Total,145,98,81,20,61,12,5,47,43,1,1,2,0
S01010855,Owned: Owned outright,56,22,18,6,12,3,1,34,34,0,0,0,0
S01010855,Owned: Owned with a mortgage or loan or shared ownership,89,76,63,14,49,9,4,13,9,1,1,2,0
S01010855,Rented or living rent free: Total,78,36,29,7,22,1,6,42,24,1,7,10,0
S01010855,Rented or living rent free: Social rented,57,22,18,4,14,0,4,35,20,0,5,10,0
S01010855,Rented or living rent free: Private rented or living rent free,21,14,11,3,8,1,2,7,4,1,2,0,0
S01010856,All HRPs aged 16 and over,455,217,172,33,139,23,22,238,141,5,12,72,8
S01010856,Owned: Total,262,143,119,11,108,21,3,119,99,0,2,15,3
S01010856,Owned: Owned outright,119,30,25,5,20,4,1,89,80,0,0,8,1
S01010856,Owned: Owned with a mortgage or loan or shared ownership,143,113,94,6,88,17,2,30,19,0,2,7,2
S01010856,Rented or living rent free: Total,193,74,53,22,31,2,19,119,42,5,10,57,5
S01010856,Rented or living rent free: Social rented,165,58,43,20,23,0,15,107,41,4,7,50,5
S01010856,Rented or living rent free: Private rented or living rent free,28,16,10,2,8,2,4,12,1,1,3,7,0
S01010857,All HRPs aged 16 and over,324,241,209,33,176,16,16,83,40,1,12,25,5
S01010857,Owned: Total,228,190,173,21,152,14,3,38,29,0,0,7,2
S01010857,Owned: Owned outright,53,28,28,5,23,0,0,25,23,0,0,2,0
S01010857,Owned: Owned with a mortgage or loan or shared ownership,175,162,145,16,129,14,3,13,6,0,0,5,2
S01010857,Rented or living rent free: Total,96,51,36,12,24,2,13,45,11,1,12,18,3
S01010857,Rented or living rent free: Social rented,77,39,29,9,20,2,8,38,9,1,12,13,3
S01010857,Rented or living rent free: Private rented or living rent free,19,12,7,3,4,0,5,7,2,0,0,5,0
S01010858,All HRPs aged 16 and over,330,186,154,29,125,15,17,144,95,4,11,29,5
S01010858,Owned: Total,211,127,110,13,97,10,7,84,71,1,3,8,1
S01010858,Owned: Owned outright,81,23,18,4,14,3,2,58,52,0,1,4,1
S01010858,Owned: Owned with a mortgage or loan or shared ownership,130,104,92,9,83,7,5,26,19,1,2,4,0
S01010858,Rented or living rent free: Total,119,59,44,16,28,5,10,60,24,3,8,21,4
S01010858,Rented or living rent free: Social rented,98,46,35,14,21,5,6,52,21,3,8,16,4
S01010858,Rented or living rent free: Private rented or living rent free,21,13,9,2,7,0,4,8,3,0,0,5,0
S01010859,All HRPs aged 16 and over,304,151,132,32,100,10,9,153,92,3,15,35,8
S01010859,Owned: Total,172,111,101,14,87,8,2,61,47,2,7,4,1
S01010859,Owned: Owned outright,47,12,10,2,8,2,0,35,31,1,1,2,0
S01010859,Owned: Owned with a mortgage or loan or shared ownership,125,99,91,12,79,6,2,26,16,1,6,2,1
S01010859,Rented or living rent free: Total,132,40,31,18,13,2,7,92,45,1,8,31,7
S01010859,Rented or living rent free: Social rented,117,36,28,16,12,2,6,81,41,1,6,27,6
S01010859,Rented or living rent free: Private rented or living rent free,15,4,3,2,1,0,1,11,4,0,2,4,1
S01010860,All HRPs aged 16 and over,279,168,152,38,114,7,9,111,77,0,13,17,4
S01010860,Owned: Total,194,129,121,23,98,5,3,65,57,0,3,3,2
S01010860,Owned: Owned outright,73,32,28,6,22,2,2,41,37,0,0,3,1
S01010860,Owned: Owned with a mortgage or loan or shared ownership,121,97,93,17,76,3,1,24,20,0,3,0,1
S01010860,Rented or living rent free: Total,85,39,31,15,16,2,6,46,20,0,10,14,2
S01010860,Rented or living rent free: Social rented,69,30,23,13,10,2,5,39,15,0,9,13,2
S01010860,Rented or living rent free: Private rented or living rent free,16,9,8,2,6,0,1,7,5,0,1,1,0
S01010861,All HRPs aged 16 and over,332,168,140,35,105,9,19,164,92,5,14,47,6
S01010861,Owned: Total,164,92,84,13,71,4,4,72,63,1,2,5,1
S01010861,Owned: Owned outright,68,19,17,3,14,0,2,49,45,0,2,2,0
S01010861,Owned: Owned with a mortgage or loan or shared ownership,96,73,67,10,57,4,2,23,18,1,0,3,1
S01010861,Rented or living rent free: Total,168,76,56,22,34,5,15,92,29,4,12,42,5
S01010861,Rented or living rent free: Social rented,125,51,36,16,20,5,10,74,23,2,7,39,3
S01010861,Rented or living rent free: Private rented or living rent free,43,25,20,6,14,0,5,18,6,2,5,3,2
S01010862,All HRPs aged 16 and over,266,129,103,41,62,4,22,137,51,6,19,54,7
S01010862,Owned: Total,49,26,22,7,15,3,1,23,20,0,3,0,0
S01010862,Owned: Owned outright,14,7,6,5,1,0,1,7,7,0,0,0,0
S01010862,Owned: Owned with a mortgage or loan or shared ownership,35,19,16,2,14,3,0,16,13,0,3,0,0
S01010862,Rented or living rent free: Total,217,103,81,34,47,1,21,114,31,6,16,54,7
S01010862,Rented or living rent free: Social rented,202,97,77,30,47,1,19,105,28,6,14,51,6
S01010862,Rented or living rent free: Private rented or living rent free,15,6,4,4,0,0,2,9,3,0,2,3,1
S01010863,All HRPs aged 16 and over,317,190,163,19,144,22,5,127,107,4,2,11,3
S01010863,Owned: Total,262,156,134,15,119,20,2,106,95,0,1,8,2
S01010863,Owned: Owned outright,134,40,34,7,27,5,1,94,88,0,1,3,2
S01010863,Owned: Owned with a mortgage or loan or shared ownership,128,116,100,8,92,15,1,12,7,0,0,5,0
S01010863,Rented or living rent free: Total,55,34,29,4,25,2,3,21,12,4,1,3,1
S01010863,Rented or living rent free: Social rented,21,8,5,0,5,1,2,13,6,2,1,3,1
S01010863,Rented or living rent free: Private rented or living rent free,34,26,24,4,20,1,1,8,6,2,0,0,0
S01010864,All HRPs aged 16 and over,250,167,147,20,127,16,4,83,77,1,2,2,1
S01010864,Owned: Total,229,150,130,17,113,16,4,79,74,0,2,2,1
S01010864,Owned: Owned outright,133,60,48,13,35,8,4,73,69,0,2,1,1
S01010864,Owned: Owned with a mortgage or loan or shared ownership,96,90,82,4,78,8,0,6,5,0,0,1,0
S01010864,Rented or living rent free: Total,21,17,17,3,14,0,0,4,3,1,0,0,0
S01010864,Rented or living rent free: Social rented,2,1,1,0,1,0,0,1,1,0,0,0,0
S01010864,Rented or living rent free: Private rented or living rent free,19,16,16,3,13,0,0,3,2,1,0,0,0
S01010865,All HRPs aged 16 and over,345,162,133,17,116,26,3,183,161,10,4,4,4
S01010865,Owned: Total,313,144,117,15,102,25,2,169,155,4,4,3,3
S01010865,Owned: Owned outright,207,55,43,9,34,10,2,152,143,3,1,2,3
S01010865,Owned: Owned with a mortgage or loan or shared ownership,106,89,74,6,68,15,0,17,12,1,3,1,0
S01010865,Rented or living rent free: Total,32,18,16,2,14,1,1,14,6,6,0,1,1
S01010865,Rented or living rent free: Social rented,10,0,0,0,0,0,0,10,2,6,0,1,1
S01010865,Rented or living rent free: Private rented or living rent free,22,18,16,2,14,1,1,4,4,0,0,0,0
S01010866,All HRPs aged 16 and over,312,144,119,17,102,22,3,168,152,5,2,8,1
S01010866,Owned: Total,246,136,113,15,98,20,3,110,107,1,0,2,0
S01010866,Owned: Owned outright,143,47,37,10,27,7,3,96,96,0,0,0,0
S01010866,Owned: Owned with a mortgage or loan or shared ownership,103,89,76,5,71,13,0,14,11,1,0,2,0
S01010866,Rented or living rent free: Total,66,8,6,2,4,2,0,58,45,4,2,6,1
S01010866,Rented or living rent free: Social rented,30,3,2,2,0,1,0,27,20,1,1,4,1
S01010866,Rented or living rent free: Private rented or living rent free,36,5,4,0,4,1,0,31,25,3,1,2,0
S01010867,All HRPs aged 16 and over,285,157,118,14,104,35,4,128,107,2,1,15,3
S01010867,Owned: Total,222,134,102,10,92,29,3,88,78,1,0,7,2
S01010867,Owned: Owned outright,122,43,29,7,22,12,2,79,74,1,0,2,2
S01010867,Owned: Owned with a mortgage or loan or shared ownership,100,91,73,3,70,17,1,9,4,0,0,5,0
S01010867,Rented or living rent free: Total,63,23,16,4,12,6,1,40,29,1,1,8,1
S01010867,Rented or living rent free: Social rented,35,6,3,1,2,2,1,29,23,0,1,4,1
S01010867,Rented or living rent free: Private rented or living rent free,28,17,13,3,10,4,0,11,6,1,0,4,0
S01010868,All HRPs aged 16 and over,306,173,148,21,127,23,2,133,111,3,1,15,3
S01010868,Owned: Total,250,159,136,18,118,21,2,91,86,1,1,1,2
S01010868,Owned: Owned outright,139,57,48,13,35,7,2,82,78,0,1,1,2
S01010868,Owned: Owned with a mortgage or loan or shared ownership,111,102,88,5,83,14,0,9,8,1,0,0,0
S01010868,Rented or living rent free: Total,56,14,12,3,9,2,0,42,25,2,0,14,1
S01010868,Rented or living rent free: Social rented,40,5,5,1,4,0,0,35,19,2,0,13,1
S01010868,Rented or living rent free: Private rented or living rent free,16,9,7,2,5,2,0,7,6,0,0,1,0
S01010869,All HRPs aged 16 and over,290,183,145,17,128,31,7,107,92,0,3,8,4
S01010869,Owned: Total,265,170,136,15,121,30,4,95,85,0,2,4,4
S01010869,Owned: Owned outright,154,67,52,10,42,14,1,87,79,0,2,3,3
S01010869,Owned: Owned with a mortgage or loan or shared ownership,111,103,84,5,79,16,3,8,6,0,0,1,1
S01010869,Rented or living rent free: Total,25,13,9,2,7,1,3,12,7,0,1,4,0
S01010869,Rented or living rent free: Social rented,6,4,1,0,1,0,3,2,2,0,0,0,0
S01010869,Rented or living rent free: Private rented or living rent free,19,9,8,2,6,1,0,10,5,0,1,4,0
S01010870,All HRPs aged 16 and over,407,248,204,32,172,34,10,159,135,5,4,13,2
S01010870,Owned: Total,286,179,150,19,131,26,3,107,103,3,0,1,0
S01010870,Owned: Owned outright,155,58,47,11,36,10,1,97,93,3,0,1,0
S01010870,Owned: Owned with a mortgage or loan or shared ownership,131,121,103,8,95,16,2,10,10,0,0,0,0
S01010870,Rented or living rent free: Total,121,69,54,13,41,8,7,52,32,2,4,12,2
S01010870,Rented or living rent free: Social rented,33,9,6,1,5,2,1,24,19,0,1,3,1
S01010870,Rented or living rent free: Private rented or living rent free,88,60,48,12,36,6,6,28,13,2,3,9,1
S01010871,All HRPs aged 16 and over,408,250,207,31,176,32,11,158,125,8,9,11,5
S01010871,Owned: Total,294,191,157,21,136,29,5,103,95,2,0,4,2
S01010871,Owned: Owned outright,130,44,30,11,19,12,2,86,82,0,0,2,2
S01010871,Owned: Owned with a mortgage or loan or shared ownership,164,147,127,10,117,17,3,17,13,2,0,2,0
S01010871,Rented or living rent free: Total,114,59,50,10,40,3,6,55,30,6,9,7,3
S01010871,Rented or living rent free: Social rented,15,6,6,2,4,0,0,9,5,2,0,2,0
S01010871,Rented or living rent free: Private rented or living rent free,99,53,44,8,36,3,6,46,25,4,9,5,3
S01010872,All HRPs aged 16 and over,403,233,199,28,171,22,12,170,117,9,10,27,7
S01010872,Owned: Total,256,172,151,18,133,17,4,84,67,6,1,8,2
S01010872,Owned: Owned outright,84,27,18,2,16,6,3,57,52,3,0,2,0
S01010872,Owned: Owned with a mortgage or loan or shared ownership,172,145,133,16,117,11,1,27,15,3,1,6,2
S01010872,Rented or living rent free: Total,147,61,48,10,38,5,8,86,50,3,9,19,5
S01010872,Rented or living rent free: Social rented,53,10,9,4,5,0,1,43,31,2,0,9,1
S01010872,Rented or living rent free: Private rented or living rent free,94,51,39,6,33,5,7,43,19,1,9,10,4
S01010873,All HRPs aged 16 and over,400,147,123,32,91,7,17,253,172,4,6,63,8
S01010873,Owned: Total,82,50,45,6,39,3,2,32,27,0,1,4,0
S01010873,Owned: Owned outright,38,10,7,2,5,1,2,28,24,0,1,3,0
S01010873,Owned: Owned with a mortgage or loan or shared ownership,44,40,38,4,34,2,0,4,3,0,0,1,0
S01010873,Rented or living rent free: Total,318,97,78,26,52,4,15,221,145,4,5,59,8
S01010873,Rented or living rent free: Social rented,247,66,56,18,38,2,8,181,128,0,3,44,6
S01010873,Rented or living rent free: Private rented or living rent free,71,31,22,8,14,2,7,40,17,4,2,15,2
S01010874,All HRPs aged 16 and over,306,220,181,29,152,34,5,86,66,3,7,8,2
S01010874,Owned: Total,253,182,154,20,134,28,0,71,61,0,3,6,1
S01010874,Owned: Owned outright,101,40,34,11,23,6,0,61,56,0,2,3,0
S01010874,Owned: Owned with a mortgage or loan or shared ownership,152,142,120,9,111,22,0,10,5,0,1,3,1
S01010874,Rented or living rent free: Total,53,38,27,9,18,6,5,15,5,3,4,2,1
S01010874,Rented or living rent free: Social rented,9,4,4,4,0,0,0,5,2,0,0,2,1
S01010874,Rented or living rent free: Private rented or living rent free,44,34,23,5,18,6,5,10,3,3,4,0,0
S01010875,All HRPs aged 16 and over,257,175,150,32,118,17,8,82,57,6,5,13,1
S01010875,Owned: Total,160,114,103,16,87,8,3,46,42,1,0,3,0
S01010875,Owned: Owned outright,61,23,19,7,12,2,2,38,35,1,0,2,0
S01010875,Owned: Owned with a mortgage or loan or shared ownership,99,91,84,9,75,6,1,8,7,0,0,1,0
S01010875,Rented or living rent free: Total,97,61,47,16,31,9,5,36,15,5,5,10,1
S01010875,Rented or living rent free: Social rented,32,12,10,2,8,1,1,20,8,2,1,8,1
S01010875,Rented or living rent free: Private rented or living rent free,65,49,37,14,23,8,4,16,7,3,4,2,0
S01010876,All HRPs aged 16 and over,391,231,198,49,149,8,25,160,91,10,8,46,5
S01010876,Owned: Total,146,101,94,10,84,4,3,45,40,2,0,2,1
S01010876,Owned: Owned outright,67,27,24,4,20,1,2,40,38,1,0,1,0
S01010876,Owned: Owned with a mortgage or loan or shared ownership,79,74,70,6,64,3,1,5,2,1,0,1,1
S01010876,Rented or living rent free: Total,245,130,104,39,65,4,22,115,51,8,8,44,4
S01010876,Rented or living rent free: Social rented,159,70,55,24,31,2,13,89,40,2,3,41,3
S01010876,Rented or living rent free: Private rented or living rent free,86,60,49,15,34,2,9,26,11,6,5,3,1
S01010877,All HRPs aged 16 and over,467,265,226,46,180,20,19,202,117,6,16,56,7
S01010877,Owned: Total,257,163,146,16,130,14,3,94,77,2,2,12,1
S01010877,Owned: Owned outright,114,38,31,9,22,6,1,76,66,0,2,7,1
S01010877,Owned: Owned with a mortgage or loan or shared ownership,143,125,115,7,108,8,2,18,11,2,0,5,0
S01010877,Rented or living rent free: Total,210,102,80,30,50,6,16,108,40,4,14,44,6
S01010877,Rented or living rent free: Social rented,132,55,43,20,23,4,8,77,33,1,7,31,5
S01010877,Rented or living rent free: Private rented or living rent free,78,47,37,10,27,2,8,31,7,3,7,13,1
S01010878,All HRPs aged 16 and over,512,255,225,35,190,17,13,257,202,3,12,32,8
S01010878,Owned: Total,332,178,162,25,137,12,4,154,147,2,1,4,0
S01010878,Owned: Owned outright,174,52,46,9,37,6,0,122,118,1,0,3,0
S01010878,Owned: Owned with a mortgage or loan or shared ownership,158,126,116,16,100,6,4,32,29,1,1,1,0
S01010878,Rented or living rent free: Total,180,77,63,10,53,5,9,103,55,1,11,28,8
S01010878,Rented or living rent free: Social rented,96,35,25,4,21,3,7,61,43,1,0,14,3
S01010878,Rented or living rent free: Private rented or living rent free,84,42,38,6,32,2,2,42,12,0,11,14,5
S01010879,All HRPs aged 16 and over,387,251,216,40,176,26,9,136,92,2,5,33,4
S01010879,Owned: Total,290,205,175,27,148,24,6,85,67,2,4,9,3
S01010879,Owned: Owned outright,113,51,42,9,33,7,2,62,57,2,0,2,1
S01010879,Owned: Owned with a mortgage or loan or shared ownership,177,154,133,18,115,17,4,23,10,0,4,7,2
S01010879,Rented or living rent free: Total,97,46,41,13,28,2,3,51,25,0,1,24,1
S01010879,Rented or living rent free: Social rented,69,27,23,8,15,1,3,42,21,0,0,20,1
S01010879,Rented or living rent free: Private rented or living rent free,28,19,18,5,13,1,0,9,4,0,1,4,0
S01010880,All HRPs aged 16 and over,268,141,118,26,92,5,18,127,71,3,8,37,8
S01010880,Owned: Total,141,74,69,9,60,2,3,67,59,0,2,5,1
S01010880,Owned: Owned outright,71,23,23,4,19,0,0,48,45,0,0,3,0
S01010880,Owned: Owned with a mortgage or loan or shared ownership,70,51,46,5,41,2,3,19,14,0,2,2,1
S01010880,Rented or living rent free: Total,127,67,49,17,32,3,15,60,12,3,6,32,7
S01010880,Rented or living rent free: Social rented,113,57,43,14,29,0,14,56,12,2,6,30,6
S01010880,Rented or living rent free: Private rented or living rent free,14,10,6,3,3,3,1,4,0,1,0,2,1
S01010881,All HRPs aged 16 and over,285,145,121,21,100,13,11,140,123,4,5,7,1
S01010881,Owned: Total,240,124,110,16,94,12,2,116,108,1,2,4,1
S01010881,Owned: Owned outright,117,36,30,9,21,5,1,81,76,1,1,2,1
S01010881,Owned: Owned with a mortgage or loan or shared ownership,123,88,80,7,73,7,1,35,32,0,1,2,0
S01010881,Rented or living rent free: Total,45,21,11,5,6,1,9,24,15,3,3,3,0
S01010881,Rented or living rent free: Social rented,33,15,9,4,5,0,6,18,13,3,0,2,0
S01010881,Rented or living rent free: Private rented or living rent free,12,6,2,1,1,1,3,6,2,0,3,1,0
S01010882,All HRPs aged 16 and over,203,144,132,22,110,6,6,59,39,1,2,12,5
S01010882,Owned: Total,157,123,119,14,105,4,0,34,28,1,0,4,1
S01010882,Owned: Owned outright,51,23,22,5,17,1,0,28,24,0,0,3,1
S01010882,Owned: Owned with a mortgage or loan or shared ownership,106,100,97,9,88,3,0,6,4,1,0,1,0
S01010882,Rented or living rent free: Total,46,21,13,8,5,2,6,25,11,0,2,8,4
S01010882,Rented or living rent free: Social rented,39,17,10,5,5,2,5,22,10,0,2,6,4
S01010882,Rented or living rent free: Private rented or living rent free,7,4,3,3,0,0,1,3,1,0,0,2,0
S01010883,All HRPs aged 16 and over,336,240,213,26,187,13,14,96,62,1,5,23,5
S01010883,Owned: Total,261,210,196,21,175,11,3,51,43,0,2,4,2
S01010883,Owned: Owned outright,88,48,43,10,33,3,2,40,34,0,1,4,1
S01010883,Owned: Owned with a mortgage or loan or shared ownership,173,162,153,11,142,8,1,11,9,0,1,0,1
S01010883,Rented or living rent free: Total,75,30,17,5,12,2,11,45,19,1,3,19,3
S01010883,Rented or living rent free: Social rented,66,27,16,5,11,1,10,39,17,1,3,16,2
S01010883,Rented or living rent free: Private rented or living rent free,9,3,1,0,1,1,1,6,2,0,0,3,1
S01010884,All HRPs aged 16 and over,408,189,142,33,109,11,36,219,106,3,24,72,14
S01010884,Owned: Total,142,81,70,12,58,8,3,61,50,0,3,8,0
S01010884,Owned: Owned outright,74,26,21,7,14,2,3,48,42,0,2,4,0
S01010884,Owned: Owned with a mortgage or loan or shared ownership,68,55,49,5,44,6,0,13,8,0,1,4,0
S01010884,Rented or living rent free: Total,266,108,72,21,51,3,33,158,56,3,21,64,14
S01010884,Rented or living rent free: Social rented,232,91,60,16,44,2,29,141,52,2,14,60,13
S01010884,Rented or living rent free: Private rented or living rent free,34,17,12,5,7,1,4,17,4,1,7,4,1
S01010885,All HRPs aged 16 and over,540,260,203,58,145,13,44,280,117,11,18,115,19
S01010885,Owned: Total,161,119,99,15,84,7,13,42,33,2,3,3,1
S01010885,Owned: Owned outright,56,26,16,5,11,3,7,30,25,0,1,3,1
S01010885,Owned: Owned with a mortgage or loan or shared ownership,105,93,83,10,73,4,6,12,8,2,2,0,0
S01010885,Rented or living rent free: Total,379,141,104,43,61,6,31,238,84,9,15,112,18
S01010885,Rented or living rent free: Social rented,302,107,79,36,43,5,23,195,77,5,14,85,14
S01010885,Rented or living rent free: Private rented or living rent free,77,34,25,7,18,1,8,43,7,4,1,27,4
S01010886,All HRPs aged 16 and over,250,146,114,20,94,12,20,104,47,12,1,31,13
S01010886,Owned: Total,117,84,74,11,63,6,4,33,28,0,0,4,1
S01010886,Owned: Owned outright,42,21,17,2,15,1,3,21,19,0,0,2,0
S01010886,Owned: Owned with a mortgage or loan or shared ownership,75,63,57,9,48,5,1,12,9,0,0,2,1
S01010886,Rented or living rent free: Total,133,62,40,9,31,6,16,71,19,12,1,27,12
S01010886,Rented or living rent free: Social rented,75,31,19,6,13,1,11,44,15,5,1,21,2
S01010886,Rented or living rent free: Private rented or living rent free,58,31,21,3,18,5,5,27,4,7,0,6,10
S01010887,All HRPs aged 16 and over,458,177,139,39,100,14,24,281,165,4,21,81,10
S01010887,Owned: Total,136,76,66,16,50,9,1,60,53,0,1,5,1
S01010887,Owned: Owned outright,63,23,20,9,11,2,1,40,39,0,0,1,0
S01010887,Owned: Owned with a mortgage or loan or shared ownership,73,53,46,7,39,7,0,20,14,0,1,4,1
S01010887,Rented or living rent free: Total,322,101,73,23,50,5,23,221,112,4,20,76,9
S01010887,Rented or living rent free: Social rented,291,85,60,18,42,5,20,206,110,3,12,74,7
S01010887,Rented or living rent free: Private rented or living rent free,31,16,13,5,8,0,3,15,2,1,8,2,2
S01010888,All HRPs aged 16 and over,437,239,200,39,161,14,25,198,97,11,14,63,13
S01010888,Owned: Total,221,137,129,20,109,6,2,84,62,2,4,12,4
S01010888,Owned: Owned outright,104,40,39,11,28,0,1,64,47,2,4,9,2
S01010888,Owned: Owned with a mortgage or loan or shared ownership,117,97,90,9,81,6,1,20,15,0,0,3,2
S01010888,Rented or living rent free: Total,216,102,71,19,52,8,23,114,35,9,10,51,9
S01010888,Rented or living rent free: Social rented,140,49,32,12,20,3,14,91,35,1,7,41,7
S01010888,Rented or living rent free: Private rented or living rent free,76,53,39,7,32,5,9,23,0,8,3,10,2
S01010889,All HRPs aged 16 and over,344,182,145,34,111,11,26,162,70,2,4,71,15
S01010889,Owned: Total,99,78,70,10,60,7,1,21,14,0,1,5,1
S01010889,Owned: Owned outright,27,15,11,3,8,4,0,12,8,0,1,3,0
S01010889,Owned: Owned with a mortgage or loan or shared ownership,72,63,59,7,52,3,1,9,6,0,0,2,1
S01010889,Rented or living rent free: Total,245,104,75,24,51,4,25,141,56,2,3,66,14
S01010889,Rented or living rent free: Social rented,184,66,47,19,28,1,18,118,49,1,2,56,10
S01010889,Rented or living rent free: Private rented or living rent free,61,38,28,5,23,3,7,23,7,1,1,10,4
S01010890,All HRPs aged 16 and over,507,167,141,36,105,10,16,340,254,1,10,61,14
S01010890,Owned: Total,209,89,79,16,63,7,3,120,104,1,1,12,2
S01010890,Owned: Owned outright,103,28,25,8,17,2,1,75,69,0,0,5,1
S01010890,Owned: Owned with a mortgage or loan or shared ownership,106,61,54,8,46,5,2,45,35,1,1,7,1
S01010890,Rented or living rent free: Total,298,78,62,20,42,3,13,220,150,0,9,49,12
S01010890,Rented or living rent free: Social rented,234,35,28,11,17,1,6,199,140,0,4,43,12
S01010890,Rented or living rent free: Private rented or living rent free,64,43,34,9,25,2,7,21,10,0,5,6,0
S01010891,All HRPs aged 16 and over,280,103,74,19,55,7,22,177,102,3,14,48,10
S01010891,Owned: Total,50,32,28,6,22,2,2,18,14,0,0,2,2
S01010891,Owned: Owned outright,19,11,10,4,6,0,1,8,6,0,0,1,1
S01010891,Owned: Owned with a mortgage or loan or shared ownership,31,21,18,2,16,2,1,10,8,0,0,1,1
S01010891,Rented or living rent free: Total,230,71,46,13,33,5,20,159,88,3,14,46,8
S01010891,Rented or living rent free: Social rented,152,27,15,5,10,1,11,125,76,0,3,39,7
S01010891,Rented or living rent free: Private rented or living rent free,78,44,31,8,23,4,9,34,12,3,11,7,1
S01010892,All HRPs aged 16 and over,531,239,203,49,154,13,23,292,199,2,7,73,11
S01010892,Owned: Total,198,120,108,15,93,10,2,78,66,1,1,8,2
S01010892,Owned: Owned outright,85,28,24,6,18,3,1,57,53,0,0,3,1
S01010892,Owned: Owned with a mortgage or loan or shared ownership,113,92,84,9,75,7,1,21,13,1,1,5,1
S01010892,Rented or living rent free: Total,333,119,95,34,61,3,21,214,133,1,6,65,9
S01010892,Rented or living rent free: Social rented,259,65,45,18,27,2,18,194,127,1,1,56,9
S01010892,Rented or living rent free: Private rented or living rent free,74,54,50,16,34,1,3,20,6,0,5,9,0
S01010893,All HRPs aged 16 and over,327,121,105,26,79,6,10,206,115,13,7,63,8
S01010893,Owned: Total,82,48,47,10,37,1,0,34,29,0,1,3,1
S01010893,Owned: Owned outright,34,13,13,4,9,0,0,21,17,0,1,2,1
S01010893,Owned: Owned with a mortgage or loan or shared ownership,48,35,34,6,28,1,0,13,12,0,0,1,0
S01010893,Rented or living rent free: Total,245,73,58,16,42,5,10,172,86,13,6,60,7
S01010893,Rented or living rent free: Social rented,202,52,42,13,29,2,8,150,81,2,6,54,7
S01010893,Rented or living rent free: Private rented or living rent free,43,21,16,3,13,3,2,22,5,11,0,6,0
S01010894,All HRPs aged 16 and over,312,214,177,37,140,14,23,98,54,3,11,25,5
S01010894,Owned: Total,148,124,114,16,98,9,1,24,21,0,0,2,1
S01010894,Owned: Owned outright,29,12,11,3,8,1,0,17,16,0,0,1,0
S01010894,Owned: Owned with a mortgage or loan or shared ownership,119,112,103,13,90,8,1,7,5,0,0,1,1
S01010894,Rented or living rent free: Total,164,90,63,21,42,5,22,74,33,3,11,23,4
S01010894,Rented or living rent free: Social rented,108,46,29,12,17,2,15,62,31,2,11,17,1
S01010894,Rented or living rent free: Private rented or living rent free,56,44,34,9,25,3,7,12,2,1,0,6,3
S01010895,All HRPs aged 16 and over,256,108,78,20,58,8,22,148,84,1,15,45,3
S01010895,Owned: Total,103,50,45,7,38,5,0,53,46,0,3,4,0
S01010895,Owned: Owned outright,56,16,14,5,9,2,0,40,37,0,2,1,0
S01010895,Owned: Owned with a mortgage or loan or shared ownership,47,34,31,2,29,3,0,13,9,0,1,3,0
S01010895,Rented or living rent free: Total,153,58,33,13,20,3,22,95,38,1,12,41,3
S01010895,Rented or living rent free: Social rented,136,45,24,7,17,2,19,91,37,1,12,38,3
S01010895,Rented or living rent free: Private rented or living rent free,17,13,9,6,3,1,3,4,1,0,0,3,0
S01010896,All HRPs aged 16 and over,339,161,128,26,102,9,24,178,89,4,19,57,9
S01010896,Owned: Total,156,86,78,14,64,6,2,70,58,2,1,7,2
S01010896,Owned: Owned outright,76,23,18,8,10,4,1,53,46,0,1,4,2
S01010896,Owned: Owned with a mortgage or loan or shared ownership,80,63,60,6,54,2,1,17,12,2,0,3,0
S01010896,Rented or living rent free: Total,183,75,50,12,38,3,22,108,31,2,18,50,7
S01010896,Rented or living rent free: Social rented,151,53,34,10,24,1,18,98,29,2,14,46,7
S01010896,Rented or living rent free: Private rented or living rent free,32,22,16,2,14,2,4,10,2,0,4,4,0
S01010897,All HRPs aged 16 and over,380,187,145,37,108,12,30,193,84,0,25,78,6
S01010897,Owned: Total,118,64,58,9,49,4,2,54,46,0,1,6,1
S01010897,Owned: Owned outright,54,14,14,2,12,0,0,40,36,0,1,3,0
S01010897,Owned: Owned with a mortgage or loan or shared ownership,64,50,44,7,37,4,2,14,10,0,0,3,1
S01010897,Rented or living rent free: Total,262,123,87,28,59,8,28,139,38,0,24,72,5
S01010897,Rented or living rent free: Social rented,253,117,84,26,58,6,27,136,37,0,24,70,5
S01010897,Rented or living rent free: Private rented or living rent free,9,6,3,2,1,2,1,3,1,0,0,2,0
S01010898,All HRPs aged 16 and over,253,126,98,21,77,14,14,127,57,1,7,58,4
S01010898,Owned: Total,110,77,64,10,54,10,3,33,21,0,1,8,3
S01010898,Owned: Owned outright,37,17,12,3,9,4,1,20,16,0,1,2,1
S01010898,Owned: Owned with a mortgage or loan or shared ownership,73,60,52,7,45,6,2,13,5,0,0,6,2
S01010898,Rented or living rent free: Total,143,49,34,11,23,4,11,94,36,1,6,50,1
S01010898,Rented or living rent free: Social rented,134,42,32,10,22,3,7,92,36,1,6,48,1
S01010898,Rented or living rent free: Private rented or living rent free,9,7,2,1,1,1,4,2,0,0,0,2,0
S01010899,All HRPs aged 16 and over,221,163,143,18,125,12,8,58,34,2,5,15,2
S01010899,Owned: Total,174,141,129,15,114,10,2,33,26,0,0,6,1
S01010899,Owned: Owned outright,48,25,23,3,20,1,1,23,17,0,0,5,1
S01010899,Owned: Owned with a mortgage or loan or shared ownership,126,116,106,12,94,9,1,10,9,0,0,1,0
S01010899,Rented or living rent free: Total,47,22,14,3,11,2,6,25,8,2,5,9,1
S01010899,Rented or living rent free: Social rented,30,9,6,0,6,1,2,21,8,0,4,8,1
S01010899,Rented or living rent free: Private rented or living rent free,17,13,8,3,5,1,4,4,0,2,1,1,0
S01010900,All HRPs aged 16 and over,298,180,149,46,103,10,21,118,43,2,31,32,10
S01010900,Owned: Total,154,114,102,24,78,8,4,40,26,1,2,8,3
S01010900,Owned: Owned outright,45,21,18,8,10,2,1,24,19,1,1,2,1
S01010900,Owned: Owned with a mortgage or loan or shared ownership,109,93,84,16,68,6,3,16,7,0,1,6,2
S01010900,Rented or living rent free: Total,144,66,47,22,25,2,17,78,17,1,29,24,7
S01010900,Rented or living rent free: Social rented,74,34,25,13,12,1,8,40,17,1,3,15,4
S01010900,Rented or living rent free: Private rented or living rent free,70,32,22,9,13,1,9,38,0,0,26,9,3
S01010901,All HRPs aged 16 and over,205,101,79,31,48,6,16,104,46,2,10,36,10
S01010901,Owned: Total,65,41,38,10,28,1,2,24,21,0,0,2,1
S01010901,Owned: Owned outright,33,15,14,4,10,1,0,18,16,0,0,2,0
S01010901,Owned: Owned with a mortgage or loan or shared ownership,32,26,24,6,18,0,2,6,5,0,0,0,1
S01010901,Rented or living rent free: Total,140,60,41,21,20,5,14,80,25,2,10,34,9
S01010901,Rented or living rent free: Social rented,132,57,40,20,20,5,12,75,24,2,9,33,7
S01010901,Rented or living rent free: Private rented or living rent free,8,3,1,1,0,0,2,5,1,0,1,1,2
S01010902,All HRPs aged 16 and over,453,239,201,36,165,14,24,214,138,4,8,58,6
S01010902,Owned: Total,279,170,156,22,134,9,5,109,95,1,2,9,2
S01010902,Owned: Owned outright,121,43,38,6,32,2,3,78,70,1,1,6,0
S01010902,Owned: Owned with a mortgage or loan or shared ownership,158,127,118,16,102,7,2,31,25,0,1,3,2
S01010902,Rented or living rent free: Total,174,69,45,14,31,5,19,105,43,3,6,49,4
S01010902,Rented or living rent free: Social rented,154,60,40,14,26,3,17,94,38,3,2,47,4
S01010902,Rented or living rent free: Private rented or living rent free,20,9,5,0,5,2,2,11,5,0,4,2,0
S01010903,All HRPs aged 16 and over,427,186,146,44,102,12,28,241,137,4,12,78,10
S01010903,Owned: Total,114,71,61,13,48,8,2,43,39,0,1,2,1
S01010903,Owned: Owned outright,41,16,12,3,9,4,0,25,24,0,0,0,1
S01010903,Owned: Owned with a mortgage or loan or shared ownership,73,55,49,10,39,4,2,18,15,0,1,2,0
S01010903,Rented or living rent free: Total,313,115,85,31,54,4,26,198,98,4,11,76,9
S01010903,Rented or living rent free: Social rented,292,106,81,29,52,3,22,186,94,4,8,71,9
S01010903,Rented or living rent free: Private rented or living rent free,21,9,4,2,2,1,4,12,4,0,3,5,0
S01010904,All HRPs aged 16 and over,271,146,115,22,93,7,24,125,42,5,12,63,3
S01010904,Owned: Total,94,83,76,11,65,4,3,11,9,2,0,0,0
S01010904,Owned: Owned outright,12,8,6,0,6,2,0,4,4,0,0,0,0
S01010904,Owned: Owned with a mortgage or loan or shared ownership,82,75,70,11,59,2,3,7,5,2,0,0,0
S01010904,Rented or living rent free: Total,177,63,39,11,28,3,21,114,33,3,12,63,3
S01010904,Rented or living rent free: Social rented,162,57,34,11,23,3,20,105,32,1,9,60,3
S01010904,Rented or living rent free: Private rented or living rent free,15,6,5,0,5,0,1,9,1,2,3,3,0
S01010905,All HRPs aged 16 and over,290,185,165,33,132,11,9,105,39,5,16,38,7
S01010905,Owned: Total,121,101,92,10,82,9,0,20,14,1,0,4,1
S01010905,Owned: Owned outright,27,13,12,2,10,1,0,14,12,0,0,2,0
S01010905,Owned: Owned with a mortgage or loan or shared ownership,94,88,80,8,72,8,0,6,2,1,0,2,1
S01010905,Rented or living rent free: Total,169,84,73,23,50,2,9,85,25,4,16,34,6
S01010905,Rented or living rent free: Social rented,117,44,36,17,19,2,6,73,23,2,14,28,6
S01010905,Rented or living rent free: Private rented or living rent free,52,40,37,6,31,0,3,12,2,2,2,6,0
S01010906,All HRPs aged 16 and over,383,257,223,50,173,15,19,126,48,4,24,37,13
S01010906,Owned: Total,189,160,145,19,126,14,1,29,23,0,1,4,1
S01010906,Owned: Owned outright,37,15,12,1,11,2,1,22,19,0,0,2,1
S01010906,Owned: Owned with a mortgage or loan or shared ownership,152,145,133,18,115,12,0,7,4,0,1,2,0
S01010906,Rented or living rent free: Total,194,97,78,31,47,1,18,97,25,4,23,33,12
S01010906,Rented or living rent free: Social rented,166,79,65,26,39,1,13,87,23,4,19,32,9
S01010906,Rented or living rent free: Private rented or living rent free,28,18,13,5,8,0,5,10,2,0,4,1,3
S01010907,All HRPs aged 16 and over,199,176,159,13,146,13,4,23,14,0,2,7,0
S01010907,Owned: Total,177,163,150,11,139,12,1,14,10,0,0,4,0
S01010907,Owned: Owned outright,23,15,14,1,13,0,1,8,7,0,0,1,0
S01010907,Owned: Owned with a mortgage or loan or shared ownership,154,148,136,10,126,12,0,6,3,0,0,3,0
S01010907,Rented or living rent free: Total,22,13,9,2,7,1,3,9,4,0,2,3,0
S01010907,Rented or living rent free: Social rented,6,1,0,0,0,0,1,5,2,0,2,1,0
S01010907,Rented or living rent free: Private rented or living rent free,16,12,9,2,7,1,2,4,2,0,0,2,0
S01010908,All HRPs aged 16 and over,274,152,132,25,107,11,9,122,78,5,10,24,5
S01010908,Owned: Total,150,108,96,12,84,10,2,42,34,0,1,6,1
S01010908,Owned: Owned outright,63,29,25,6,19,3,1,34,29,0,1,3,1
S01010908,Owned: Owned with a mortgage or loan or shared ownership,87,79,71,6,65,7,1,8,5,0,0,3,0
S01010908,Rented or living rent free: Total,124,44,36,13,23,1,7,80,44,5,9,18,4
S01010908,Rented or living rent free: Social rented,101,33,27,10,17,0,6,68,40,5,6,14,3
S01010908,Rented or living rent free: Private rented or living rent free,23,11,9,3,6,1,1,12,4,0,3,4,1
S01010909,All HRPs aged 16 and over,284,196,169,20,149,20,7,88,67,4,1,13,3
S01010909,Owned: Total,250,177,154,16,138,18,5,73,64,2,1,5,1
S01010909,Owned: Owned outright,114,54,45,9,36,6,3,60,57,0,1,2,0
S01010909,Owned: Owned with a mortgage or loan or shared ownership,136,123,109,7,102,12,2,13,7,2,0,3,1
S01010909,Rented or living rent free: Total,34,19,15,4,11,2,2,15,3,2,0,8,2
S01010909,Rented or living rent free: Social rented,14,6,3,0,3,2,1,8,2,1,0,5,0
S01010909,Rented or living rent free: Private rented or living rent free,20,13,12,4,8,0,1,7,1,1,0,3,2
S01010910,All HRPs aged 16 and over,273,149,113,32,81,8,28,124,52,3,13,51,5
S01010910,Owned: Total,94,68,58,7,51,7,3,26,22,1,0,2,1
S01010910,Owned: Owned outright,36,15,14,4,10,1,0,21,20,0,0,0,1
S01010910,Owned: Owned with a mortgage or loan or shared ownership,58,53,44,3,41,6,3,5,2,1,0,2,0
S01010910,Rented or living rent free: Total,179,81,55,25,30,1,25,98,30,2,13,49,4
S01010910,Rented or living rent free: Social rented,105,43,32,16,16,1,10,62,24,1,5,29,3
S01010910,Rented or living rent free: Private rented or living rent free,74,38,23,9,14,0,15,36,6,1,8,20,1
S01010911,All HRPs aged 16 and over,360,133,109,22,87,7,17,227,148,6,16,49,8
S01010911,Owned: Total,135,74,64,11,53,6,4,61,47,1,5,7,1
S01010911,Owned: Owned outright,61,23,19,5,14,2,2,38,31,0,1,5,1
S01010911,Owned: Owned with a mortgage or loan or shared ownership,74,51,45,6,39,4,2,23,16,1,4,2,0
S01010911,Rented or living rent free: Total,225,59,45,11,34,1,13,166,101,5,11,42,7
S01010911,Rented or living rent free: Social rented,163,30,24,8,16,0,6,133,93,2,2,29,7
S01010911,Rented or living rent free: Private rented or living rent free,62,29,21,3,18,1,7,33,8,3,9,13,0
S01010912,All HRPs aged 16 and over,392,140,111,26,85,12,17,252,156,13,10,57,16
S01010912,Owned: Total,106,55,45,6,39,8,2,51,38,4,0,7,2
S01010912,Owned: Owned outright,47,12,8,2,6,4,0,35,29,1,0,5,0
S01010912,Owned: Owned with a mortgage or loan or shared ownership,59,43,37,4,33,4,2,16,9,3,0,2,2
S01010912,Rented or living rent free: Total,286,85,66,20,46,4,15,201,118,9,10,50,14
S01010912,Rented or living rent free: Social rented,228,49,40,16,24,1,8,179,113,6,7,43,10
S01010912,Rented or living rent free: Private rented or living rent free,58,36,26,4,22,3,7,22,5,3,3,7,4
S01010913,All HRPs aged 16 and over,293,191,165,29,136,20,6,102,62,3,6,27,4
S01010913,Owned: Total,218,151,134,21,113,16,1,67,52,2,3,8,2
S01010913,Owned: Owned outright,91,41,34,11,23,6,1,50,41,0,1,6,2
S01010913,Owned: Owned with a mortgage or loan or shared ownership,127,110,100,10,90,10,0,17,11,2,2,2,0
S01010913,Rented or living rent free: Total,75,40,31,8,23,4,5,35,10,1,3,19,2
S01010913,Rented or living rent free: Social rented,19,8,4,2,2,2,2,11,5,0,1,5,0
S01010913,Rented or living rent free: Private rented or living rent free,56,32,27,6,21,2,3,24,5,1,2,14,2
S01010914,All HRPs aged 16 and over,255,194,169,32,137,18,7,61,40,5,4,11,1
S01010914,Owned: Total,223,180,161,29,132,16,3,43,34,1,4,3,1
S01010914,Owned: Owned outright,74,46,42,13,29,4,0,28,24,0,2,1,1
S01010914,Owned: Owned with a mortgage or loan or shared ownership,149,134,119,16,103,12,3,15,10,1,2,2,0
S01010914,Rented or living rent free: Total,32,14,8,3,5,2,4,18,6,4,0,8,0
S01010914,Rented or living rent free: Social rented,15,8,4,2,2,2,2,7,2,4,0,1,0
S01010914,Rented or living rent free: Private rented or living rent free,17,6,4,1,3,0,2,11,4,0,0,7,0
S01010915,All HRPs aged 16 and over,271,198,175,27,148,16,7,73,39,6,10,14,4
S01010915,Owned: Total,214,171,151,20,131,14,6,43,31,2,3,6,1
S01010915,Owned: Owned outright,72,46,40,8,32,3,3,26,24,0,1,1,0
S01010915,Owned: Owned with a mortgage or loan or shared ownership,142,125,111,12,99,11,3,17,7,2,2,5,1
S01010915,Rented or living rent free: Total,57,27,24,7,17,2,1,30,8,4,7,8,3
S01010915,Rented or living rent free: Social rented,26,6,5,0,5,1,0,20,7,3,3,6,1
S01010915,Rented or living rent free: Private rented or living rent free,31,21,19,7,12,1,1,10,1,1,4,2,2
S01010916,All HRPs aged 16 and over,333,145,102,19,83,10,33,188,73,9,23,69,14
S01010916,Owned: Total,118,66,59,9,50,5,2,52,40,4,3,3,2
S01010916,Owned: Owned outright,58,21,17,3,14,2,2,37,31,0,2,3,1
S01010916,Owned: Owned with a mortgage or loan or shared ownership,60,45,42,6,36,3,0,15,9,4,1,0,1
S01010916,Rented or living rent free: Total,215,79,43,10,33,5,31,136,33,5,20,66,12
S01010916,Rented or living rent free: Social rented,92,34,20,4,16,3,11,58,25,2,6,25,0
S01010916,Rented or living rent free: Private rented or living rent free,123,45,23,6,17,2,20,78,8,3,14,41,12
S01010917,All HRPs aged 16 and over,369,192,166,29,137,12,14,177,113,2,12,46,4
S01010917,Owned: Total,245,151,136,19,117,12,3,94,85,1,2,4,2
S01010917,Owned: Owned outright,110,42,36,9,27,4,2,68,61,0,1,4,2
S01010917,Owned: Owned with a mortgage or loan or shared ownership,135,109,100,10,90,8,1,26,24,1,1,0,0
S01010917,Rented or living rent free: Total,124,41,30,10,20,0,11,83,28,1,10,42,2
S01010917,Rented or living rent free: Social rented,68,21,15,3,12,0,6,47,21,1,10,14,1
S01010917,Rented or living rent free: Private rented or living rent free,56,20,15,7,8,0,5,36,7,0,0,28,1
S01010918,All HRPs aged 16 and over,334,153,129,24,105,11,13,181,137,4,11,24,5
S01010918,Owned: Total,212,117,105,14,91,9,3,95,86,2,1,6,0
S01010918,Owned: Owned outright,88,27,22,3,19,3,2,61,58,0,0,3,0
S01010918,Owned: Owned with a mortgage or loan or shared ownership,124,90,83,11,72,6,1,34,28,2,1,3,0
S01010918,Rented or living rent free: Total,122,36,24,10,14,2,10,86,51,2,10,18,5
S01010918,Rented or living rent free: Social rented,103,31,21,8,13,1,9,72,46,1,7,14,4
S01010918,Rented or living rent free: Private rented or living rent free,19,5,3,2,1,1,1,14,5,1,3,4,1
S01010919,All HRPs aged 16 and over,335,173,152,30,122,9,12,162,97,0,6,51,8
S01010919,Owned: Total,210,123,111,18,93,8,4,87,72,0,2,12,1
S01010919,Owned: Owned outright,88,29,25,6,19,3,1,59,53,0,0,5,1
S01010919,Owned: Owned with a mortgage or loan or shared ownership,122,94,86,12,74,5,3,28,19,0,2,7,0
S01010919,Rented or living rent free: Total,125,50,41,12,29,1,8,75,25,0,4,39,7
S01010919,Rented or living rent free: Social rented,107,44,35,10,25,1,8,63,23,0,2,33,5
S01010919,Rented or living rent free: Private rented or living rent free,18,6,6,2,4,0,0,12,2,0,2,6,2
S01010920,All HRPs aged 16 and over,254,134,96,31,65,13,25,120,41,6,17,51,5
S01010920,Owned: Total,56,43,34,5,29,8,1,13,10,0,0,2,1
S01010920,Owned: Owned outright,16,6,6,1,5,0,0,10,8,0,0,2,0
S01010920,Owned: Owned with a mortgage or loan or shared ownership,40,37,28,4,24,8,1,3,2,0,0,0,1
S01010920,Rented or living rent free: Total,198,91,62,26,36,5,24,107,31,6,17,49,4
S01010920,Rented or living rent free: Social rented,172,73,49,21,28,1,23,99,28,4,16,47,4
S01010920,Rented or living rent free: Private rented or living rent free,26,18,13,5,8,4,1,8,3,2,1,2,0
S01010921,All HRPs aged 16 and over,257,144,119,25,94,10,15,113,63,1,13,28,8
S01010921,Owned: Total,143,88,78,9,69,8,2,55,49,1,2,2,1
S01010921,Owned: Owned outright,47,12,11,2,9,0,1,35,31,0,2,1,1
S01010921,Owned: Owned with a mortgage or loan or shared ownership,96,76,67,7,60,8,1,20,18,1,0,1,0
S01010921,Rented or living rent free: Total,114,56,41,16,25,2,13,58,14,0,11,26,7
S01010921,Rented or living rent free: Social rented,94,43,34,13,21,2,7,51,14,0,7,23,7
S01010921,Rented or living rent free: Private rented or living rent free,20,13,7,3,4,0,6,7,0,0,4,3,0
S01010922,All HRPs aged 16 and over,346,183,151,40,111,13,19,163,99,1,16,44,3
S01010922,Owned: Total,167,105,95,18,77,8,2,62,48,0,3,11,0
S01010922,Owned: Owned outright,72,31,26,6,20,4,1,41,33,0,1,7,0
S01010922,Owned: Owned with a mortgage or loan or shared ownership,95,74,69,12,57,4,1,21,15,0,2,4,0
S01010922,Rented or living rent free: Total,179,78,56,22,34,5,17,101,51,1,13,33,3
S01010922,Rented or living rent free: Social rented,163,71,52,22,30,4,15,92,51,0,8,31,2
S01010922,Rented or living rent free: Private rented or living rent free,16,7,4,0,4,1,2,9,0,1,5,2,1
S01010923,All HRPs aged 16 and over,398,219,189,51,138,13,17,179,122,0,13,38,6
S01010923,Owned: Total,240,159,145,30,115,9,5,81,72,0,0,9,0
S01010923,Owned: Owned outright,86,38,36,13,23,1,1,48,45,0,0,3,0
S01010923,Owned: Owned with a mortgage or loan or shared ownership,154,121,109,17,92,8,4,33,27,0,0,6,0
S01010923,Rented or living rent free: Total,158,60,44,21,23,4,12,98,50,0,13,29,6
S01010923,Rented or living rent free: Social rented,136,48,35,16,19,2,11,88,50,0,7,27,4
S01010923,Rented or living rent free: Private rented or living rent free,22,12,9,5,4,2,1,10,0,0,6,2,2
S01010924,All HRPs aged 16 and over,260,132,113,18,95,11,8,128,87,1,9,25,6
S01010924,Owned: Total,168,100,91,13,78,8,1,68,55,1,2,7,3
S01010924,Owned: Owned outright,56,16,14,3,11,2,0,40,33,0,1,4,2
S01010924,Owned: Owned with a mortgage or loan or shared ownership,112,84,77,10,67,6,1,28,22,1,1,3,1
S01010924,Rented or living rent free: Total,92,32,22,5,17,3,7,60,32,0,7,18,3
S01010924,Rented or living rent free: Social rented,76,25,19,5,14,2,4,51,27,0,6,17,1
S01010924,Rented or living rent free: Private rented or living rent free,16,7,3,0,3,1,3,9,5,0,1,1,2
S01010925,All HRPs aged 16 and over,386,202,160,46,114,16,26,184,108,3,22,41,10
S01010925,Owned: Total,185,102,91,15,76,7,4,83,75,0,0,8,0
S01010925,Owned: Owned outright,81,26,23,3,20,1,2,55,51,0,0,4,0
S01010925,Owned: Owned with a mortgage or loan or shared ownership,104,76,68,12,56,6,2,28,24,0,0,4,0
S01010925,Rented or living rent free: Total,201,100,69,31,38,9,22,101,33,3,22,33,10
S01010925,Rented or living rent free: Social rented,180,87,60,29,31,7,20,93,31,3,18,32,9
S01010925,Rented or living rent free: Private rented or living rent free,21,13,9,2,7,2,2,8,2,0,4,1,1
S01010926,All HRPs aged 16 and over,352,184,153,35,118,15,16,168,105,9,15,36,3
S01010926,Owned: Total,182,113,95,16,79,14,4,69,60,0,3,6,0
S01010926,Owned: Owned outright,81,37,29,5,24,5,3,44,42,0,1,1,0
S01010926,Owned: Owned with a mortgage or loan or shared ownership,101,76,66,11,55,9,1,25,18,0,2,5,0
S01010926,Rented or living rent free: Total,170,71,58,19,39,1,12,99,45,9,12,30,3
S01010926,Rented or living rent free: Social rented,145,57,45,16,29,1,11,88,43,8,7,27,3
S01010926,Rented or living rent free: Private rented or living rent free,25,14,13,3,10,0,1,11,2,1,5,3,0
S01010927,All HRPs aged 16 and over,251,139,120,23,97,10,9,112,71,1,9,24,7
S01010927,Owned: Total,160,103,92,12,80,7,4,57,46,0,1,9,1
S01010927,Owned: Owned outright,64,25,24,4,20,0,1,39,35,0,1,2,1
S01010927,Owned: Owned with a mortgage or loan or shared ownership,96,78,68,8,60,7,3,18,11,0,0,7,0
S01010927,Rented or living rent free: Total,91,36,28,11,17,3,5,55,25,1,8,15,6
S01010927,Rented or living rent free: Social rented,72,24,20,8,12,1,3,48,24,1,8,13,2
S01010927,Rented or living rent free: Private rented or living rent free,19,12,8,3,5,2,2,7,1,0,0,2,4
S01010928,All HRPs aged 16 and over,311,162,131,34,97,20,11,149,71,1,30,42,5
S01010928,Owned: Total,157,99,84,15,69,15,0,58,49,0,0,8,1
S01010928,Owned: Owned outright,63,25,20,3,17,5,0,38,31,0,0,6,1
S01010928,Owned: Owned with a mortgage or loan or shared ownership,94,74,64,12,52,10,0,20,18,0,0,2,0
S01010928,Rented or living rent free: Total,154,63,47,19,28,5,11,91,22,1,30,34,4
S01010928,Rented or living rent free: Social rented,120,52,39,17,22,3,10,68,18,1,16,29,4
S01010928,Rented or living rent free: Private rented or living rent free,34,11,8,2,6,2,1,23,4,0,14,5,0
S01010929,All HRPs aged 16 and over,271,145,122,31,91,10,13,126,61,3,16,39,7
S01010929,Owned: Total,127,78,67,10,57,5,6,49,38,0,1,10,0
S01010929,Owned: Owned outright,53,21,15,3,12,3,3,32,27,0,0,5,0
S01010929,Owned: Owned with a mortgage or loan or shared ownership,74,57,52,7,45,2,3,17,11,0,1,5,0
S01010929,Rented or living rent free: Total,144,67,55,21,34,5,7,77,23,3,15,29,7
S01010929,Rented or living rent free: Social rented,125,57,47,18,29,5,5,68,21,3,10,27,7
S01010929,Rented or living rent free: Private rented or living rent free,19,10,8,3,5,0,2,9,2,0,5,2,0
S01010930,All HRPs aged 16 and over,357,297,214,27,187,76,7,60,51,3,1,5,0
S01010930,Owned: Total,268,227,165,23,142,58,4,41,40,0,1,0,0
S01010930,Owned: Owned outright,101,64,39,15,24,22,3,37,36,0,1,0,0
S01010930,Owned: Owned with a mortgage or loan or shared ownership,167,163,126,8,118,36,1,4,4,0,0,0,0
S01010930,Rented or living rent free: Total,89,70,49,4,45,18,3,19,11,3,0,5,0
S01010930,Rented or living rent free: Social rented,12,5,5,2,3,0,0,7,3,0,0,4,0
S01010930,Rented or living rent free: Private rented or living rent free,77,65,44,2,42,18,3,12,8,3,0,1,0
S01010931,All HRPs aged 16 and over,203,131,83,5,78,45,3,72,57,2,4,6,3
S01010931,Owned: Total,104,67,48,4,44,17,2,37,35,1,0,0,1
S01010931,Owned: Owned outright,60,27,16,4,12,11,0,33,32,0,0,0,1
S01010931,Owned: Owned with a mortgage or loan or shared ownership,44,40,32,0,32,6,2,4,3,1,0,0,0
S01010931,Rented or living rent free: Total,99,64,35,1,34,28,1,35,22,1,4,6,2
S01010931,Rented or living rent free: Social rented,21,10,6,0,6,4,0,11,7,0,1,3,0
S01010931,Rented or living rent free: Private rented or living rent free,78,54,29,1,28,24,1,24,15,1,3,3,2
S01010932,All HRPs aged 16 and over,277,162,135,22,113,23,4,115,70,4,6,26,9
S01010932,Owned: Total,126,88,75,7,68,12,1,38,36,0,0,1,1
S01010932,Owned: Owned outright,52,20,14,1,13,5,1,32,31,0,0,0,1
S01010932,Owned: Owned with a mortgage or loan or shared ownership,74,68,61,6,55,7,0,6,5,0,0,1,0
S01010932,Rented or living rent free: Total,151,74,60,15,45,11,3,77,34,4,6,25,8
S01010932,Rented or living rent free: Social rented,130,62,52,15,37,7,3,68,31,2,5,22,8
S01010932,Rented or living rent free: Private rented or living rent free,21,12,8,0,8,4,0,9,3,2,1,3,0
S01010933,All HRPs aged 16 and over,276,219,173,16,157,43,3,57,49,0,2,6,0
S01010933,Owned: Total,234,188,153,11,142,34,1,46,45,0,1,0,0
S01010933,Owned: Owned outright,89,46,32,7,25,13,1,43,42,0,1,0,0
S01010933,Owned: Owned with a mortgage or loan or shared ownership,145,142,121,4,117,21,0,3,3,0,0,0,0
S01010933,Rented or living rent free: Total,42,31,20,5,15,9,2,11,4,0,1,6,0
S01010933,Rented or living rent free: Social rented,21,11,9,4,5,1,1,10,3,0,1,6,0
S01010933,Rented or living rent free: Private rented or living rent free,21,20,11,1,10,8,1,1,1,0,0,0,0
S01010934,All HRPs aged 16 and over,424,301,248,25,223,45,8,123,109,3,2,6,3
S01010934,Owned: Total,358,256,208,19,189,44,4,102,98,1,1,1,1
S01010934,Owned: Owned outright,160,70,58,13,45,10,2,90,89,0,0,0,1
S01010934,Owned: Owned with a mortgage or loan or shared ownership,198,186,150,6,144,34,2,12,9,1,1,1,0
S01010934,Rented or living rent free: Total,66,45,40,6,34,1,4,21,11,2,1,5,2
S01010934,Rented or living rent free: Social rented,12,2,1,0,1,0,1,10,4,0,0,5,1
S01010934,Rented or living rent free: Private rented or living rent free,54,43,39,6,33,1,3,11,7,2,1,0,1
S01010935,All HRPs aged 16 and over,323,155,120,23,97,32,3,168,154,1,2,5,6
S01010935,Owned: Total,247,128,96,16,80,32,0,119,116,0,1,1,1
S01010935,Owned: Owned outright,159,50,35,11,24,15,0,109,107,0,1,0,1
S01010935,Owned: Owned with a mortgage or loan or shared ownership,88,78,61,5,56,17,0,10,9,0,0,1,0
S01010935,Rented or living rent free: Total,76,27,24,7,17,0,3,49,38,1,1,4,5
S01010935,Rented or living rent free: Social rented,53,14,13,4,9,0,1,39,34,0,1,2,2
S01010935,Rented or living rent free: Private rented or living rent free,23,13,11,3,8,0,2,10,4,1,0,2,3
S01010936,All HRPs aged 16 and over,404,229,187,23,164,31,11,175,146,2,5,17,5
S01010936,Owned: Total,220,153,128,13,115,25,0,67,63,0,1,2,1
S01010936,Owned: Owned outright,97,37,27,8,19,10,0,60,58,0,1,1,0
S01010936,Owned: Owned with a mortgage or loan or shared ownership,123,116,101,5,96,15,0,7,5,0,0,1,1
S01010936,Rented or living rent free: Total,184,76,59,10,49,6,11,108,83,2,4,15,4
S01010936,Rented or living rent free: Social rented,138,43,32,8,24,3,8,95,77,0,2,13,3
S01010936,Rented or living rent free: Private rented or living rent free,46,33,27,2,25,3,3,13,6,2,2,2,1
S01010937,All HRPs aged 16 and over,323,230,197,31,166,27,6,93,82,0,3,6,2
S01010937,Owned: Total,252,185,161,20,141,24,0,67,65,0,0,1,1
S01010937,Owned: Owned outright,112,57,51,12,39,6,0,55,53,0,0,1,1
S01010937,Owned: Owned with a mortgage or loan or shared ownership,140,128,110,8,102,18,0,12,12,0,0,0,0
S01010937,Rented or living rent free: Total,71,45,36,11,25,3,6,26,17,0,3,5,1
S01010937,Rented or living rent free: Social rented,53,29,24,5,19,2,3,24,15,0,3,5,1
S01010937,Rented or living rent free: Private rented or living rent free,18,16,12,6,6,1,3,2,2,0,0,0,0
S01010938,All HRPs aged 16 and over,369,227,183,49,134,16,28,142,101,1,13,18,9
S01010938,Owned: Total,149,98,85,13,72,11,2,51,47,0,0,2,2
S01010938,Owned: Owned outright,64,21,19,5,14,2,0,43,39,0,0,2,2
S01010938,Owned: Owned with a mortgage or loan or shared ownership,85,77,66,8,58,9,2,8,8,0,0,0,0
S01010938,Rented or living rent free: Total,220,129,98,36,62,5,26,91,54,1,13,16,7
S01010938,Rented or living rent free: Social rented,186,107,82,29,53,5,20,79,49,0,12,14,4
S01010938,Rented or living rent free: Private rented or living rent free,34,22,16,7,9,0,6,12,5,1,1,2,3
S01010939,All HRPs aged 16 and over,199,149,120,15,105,23,6,50,41,0,2,6,1
S01010939,Owned: Total,162,123,101,11,90,21,1,39,35,0,1,3,0
S01010939,Owned: Owned outright,70,36,26,6,20,9,1,34,32,0,1,1,0
S01010939,Owned: Owned with a mortgage or loan or shared ownership,92,87,75,5,70,12,0,5,3,0,0,2,0
S01010939,Rented or living rent free: Total,37,26,19,4,15,2,5,11,6,0,1,3,1
S01010939,Rented or living rent free: Social rented,27,19,14,4,10,1,4,8,4,0,0,3,1
S01010939,Rented or living rent free: Private rented or living rent free,10,7,5,0,5,1,1,3,2,0,1,0,0
S01010940,All HRPs aged 16 and over,268,177,155,18,137,22,0,91,89,1,0,0,1
S01010940,Owned: Total,261,173,152,17,135,21,0,88,86,1,0,0,1
S01010940,Owned: Owned outright,143,60,48,11,37,12,0,83,81,1,0,0,1
S01010940,Owned: Owned with a mortgage or loan or shared ownership,118,113,104,6,98,9,0,5,5,0,0,0,0
S01010940,Rented or living rent free: Total,7,4,3,1,2,1,0,3,3,0,0,0,0
S01010940,Rented or living rent free: Social rented,1,0,0,0,0,0,0,1,1,0,0,0,0
S01010940,Rented or living rent free: Private rented or living rent free,6,4,3,1,2,1,0,2,2,0,0,0,0
S01010941,All HRPs aged 16 and over,323,235,198,26,172,33,4,88,84,1,1,1,1
S01010941,Owned: Total,311,226,190,23,167,32,4,85,82,1,1,0,1
S01010941,Owned: Owned outright,152,72,59,19,40,10,3,80,77,1,1,0,1
S01010941,Owned: Owned with a mortgage or loan or shared ownership,159,154,131,4,127,22,1,5,5,0,0,0,0
S01010941,Rented or living rent free: Total,12,9,8,3,5,1,0,3,2,0,0,1,0
S01010941,Rented or living rent free: Social rented,4,2,2,1,1,0,0,2,1,0,0,1,0
S01010941,Rented or living rent free: Private rented or living rent free,8,7,6,2,4,1,0,1,1,0,0,0,0
S01010942,All HRPs aged 16 and over,268,166,146,17,129,20,0,102,102,0,0,0,0
S01010942,Owned: Total,261,162,142,17,125,20,0,99,99,0,0,0,0
S01010942,Owned: Owned outright,141,47,39,10,29,8,0,94,94,0,0,0,0
S01010942,Owned: Owned with a mortgage or loan or shared ownership,120,115,103,7,96,12,0,5,5,0,0,0,0
S01010942,Rented or living rent free: Total,7,4,4,0,4,0,0,3,3,0,0,0,0
S01010942,Rented or living rent free: Social rented,1,1,1,0,1,0,0,0,0,0,0,0,0
S01010942,Rented or living rent free: Private rented or living rent free,6,3,3,0,3,0,0,3,3,0,0,0,0
S01010943,All HRPs aged 16 and over,244,173,139,24,115,17,17,71,47,1,7,9,7
S01010943,Owned: Total,145,105,92,7,85,13,0,40,35,0,0,4,1
S01010943,Owned: Owned outright,51,18,16,3,13,2,0,33,30,0,0,2,1
S01010943,Owned: Owned with a mortgage or loan or shared ownership,94,87,76,4,72,11,0,7,5,0,0,2,0
S01010943,Rented or living rent free: Total,99,68,47,17,30,4,17,31,12,1,7,5,6
S01010943,Rented or living rent free: Social rented,85,61,40,17,23,4,17,24,12,1,5,3,3
S01010943,Rented or living rent free: Private rented or living rent free,14,7,7,0,7,0,0,7,0,0,2,2,3
S01010944,All HRPs aged 16 and over,295,178,151,28,123,9,18,117,85,1,8,18,5
S01010944,Owned: Total,127,85,77,10,67,7,1,42,37,0,1,1,3
S01010944,Owned: Owned outright,54,22,19,5,14,2,1,32,29,0,0,1,2
S01010944,Owned: Owned with a mortgage or loan or shared ownership,73,63,58,5,53,5,0,10,8,0,1,0,1
S01010944,Rented or living rent free: Total,168,93,74,18,56,2,17,75,48,1,7,17,2
S01010944,Rented or living rent free: Social rented,138,74,60,13,47,1,13,64,44,1,3,14,2
S01010944,Rented or living rent free: Private rented or living rent free,30,19,14,5,9,1,4,11,4,0,4,3,0
S01010945,All HRPs aged 16 and over,222,159,143,31,112,13,3,63,55,0,3,4,1
S01010945,Owned: Total,142,111,99,17,82,12,0,31,31,0,0,0,0
S01010945,Owned: Owned outright,57,32,29,7,22,3,0,25,25,0,0,0,0
S01010945,Owned: Owned with a mortgage or loan or shared ownership,85,79,70,10,60,9,0,6,6,0,0,0,0
S01010945,Rented or living rent free: Total,80,48,44,14,30,1,3,32,24,0,3,4,1
S01010945,Rented or living rent free: Social rented,69,41,38,13,25,1,2,28,23,0,2,3,0
S01010945,Rented or living rent free: Private rented or living rent free,11,7,6,1,5,0,1,4,1,0,1,1,1
S01010946,All HRPs aged 16 and over,344,214,176,30,146,27,11,130,108,1,10,9,2
S01010946,Owned: Total,195,136,116,14,102,20,0,59,56,0,1,1,1
S01010946,Owned: Owned outright,68,22,16,5,11,6,0,46,46,0,0,0,0
S01010946,Owned: Owned with a mortgage or loan or shared ownership,127,114,100,9,91,14,0,13,10,0,1,1,1
S01010946,Rented or living rent free: Total,149,78,60,16,44,7,11,71,52,1,9,8,1
S01010946,Rented or living rent free: Social rented,128,65,50,11,39,6,9,63,47,1,6,8,1
S01010946,Rented or living rent free: Private rented or living rent free,21,13,10,5,5,1,2,8,5,0,3,0,0
S01010947,All HRPs aged 16 and over,242,153,128,28,100,16,9,89,72,0,8,8,1
S01010947,Owned: Total,133,91,81,12,69,9,1,42,42,0,0,0,0
S01010947,Owned: Owned outright,58,20,14,8,6,5,1,38,38,0,0,0,0
S01010947,Owned: Owned with a mortgage or loan or shared ownership,75,71,67,4,63,4,0,4,4,0,0,0,0
S01010947,Rented or living rent free: Total,109,62,47,16,31,7,8,47,30,0,8,8,1
S01010947,Rented or living rent free: Social rented,88,48,38,12,26,4,6,40,28,0,3,8,1
S01010947,Rented or living rent free: Private rented or living rent free,21,14,9,4,5,3,2,7,2,0,5,0,0
S01010948,All HRPs aged 16 and over,288,189,160,28,132,19,10,99,76,2,7,13,1
S01010948,Owned: Total,172,123,105,10,95,15,3,49,48,0,0,0,1
S01010948,Owned: Owned outright,61,20,17,5,12,2,1,41,41,0,0,0,0
S01010948,Owned: Owned with a mortgage or loan or shared ownership,111,103,88,5,83,13,2,8,7,0,0,0,1
S01010948,Rented or living rent free: Total,116,66,55,18,37,4,7,50,28,2,7,13,0
S01010948,Rented or living rent free: Social rented,107,58,49,17,32,4,5,49,28,2,7,12,0
S01010948,Rented or living rent free: Private rented or living rent free,9,8,6,1,5,0,2,1,0,0,0,1,0
S01010949,All HRPs aged 16 and over,344,250,212,29,183,37,1,94,89,0,3,2,0
S01010949,Owned: Total,328,241,203,25,178,37,1,87,86,0,1,0,0
S01010949,Owned: Owned outright,155,70,57,15,42,12,1,85,84,0,1,0,0
S01010949,Owned: Owned with a mortgage or loan or shared ownership,173,171,146,10,136,25,0,2,2,0,0,0,0
S01010949,Rented or living rent free: Total,16,9,9,4,5,0,0,7,3,0,2,2,0
S01010949,Rented or living rent free: Social rented,7,2,2,1,1,0,0,5,2,0,2,1,0
S01010949,Rented or living rent free: Private rented or living rent free,9,7,7,3,4,0,0,2,1,0,0,1,0
S01010950,All HRPs aged 16 and over,380,224,190,36,154,28,6,156,130,0,15,7,4
S01010950,Owned: Total,271,166,139,18,121,27,0,105,101,0,0,2,2
S01010950,Owned: Owned outright,141,46,37,11,26,9,0,95,93,0,0,2,0
S01010950,Owned: Owned with a mortgage or loan or shared ownership,130,120,102,7,95,18,0,10,8,0,0,0,2
S01010950,Rented or living rent free: Total,109,58,51,18,33,1,6,51,29,0,15,5,2
S01010950,Rented or living rent free: Social rented,88,46,42,16,26,0,4,42,24,0,12,5,1
S01010950,Rented or living rent free: Private rented or living rent free,21,12,9,2,7,1,2,9,5,0,3,0,1
S01010951,All HRPs aged 16 and over,258,178,161,19,142,14,3,80,68,2,6,4,0
S01010951,Owned: Total,198,138,126,11,115,12,0,60,58,0,0,2,0
S01010951,Owned: Owned outright,77,28,25,2,23,3,0,49,49,0,0,0,0
S01010951,Owned: Owned with a mortgage or loan or shared ownership,121,110,101,9,92,9,0,11,9,0,0,2,0
S01010951,Rented or living rent free: Total,60,40,35,8,27,2,3,20,10,2,6,2,0
S01010951,Rented or living rent free: Social rented,44,30,27,6,21,0,3,14,9,2,3,0,0
S01010951,Rented or living rent free: Private rented or living rent free,16,10,8,2,6,2,0,6,1,0,3,2,0
S01010952,All HRPs aged 16 and over,199,158,138,17,121,17,3,41,29,1,4,6,1
S01010952,Owned: Total,153,129,114,10,104,15,0,24,22,0,0,2,0
S01010952,Owned: Owned outright,35,16,13,4,9,3,0,19,18,0,0,1,0
S01010952,Owned: Owned with a mortgage or loan or shared ownership,118,113,101,6,95,12,0,5,4,0,0,1,0
S01010952,Rented or living rent free: Total,46,29,24,7,17,2,3,17,7,1,4,4,1
S01010952,Rented or living rent free: Social rented,34,20,16,5,11,2,2,14,5,1,3,4,1
S01010952,Rented or living rent free: Private rented or living rent free,12,9,8,2,6,0,1,3,2,0,1,0,0
S01010953,All HRPs aged 16 and over,225,156,137,27,110,17,2,69,54,1,4,8,2
S01010953,Owned: Total,172,127,112,15,97,15,0,45,40,0,1,3,1
S01010953,Owned: Owned outright,70,30,25,7,18,5,0,40,37,0,0,2,1
S01010953,Owned: Owned with a mortgage or loan or shared ownership,102,97,87,8,79,10,0,5,3,0,1,1,0
S01010953,Rented or living rent free: Total,53,29,25,12,13,2,2,24,14,1,3,5,1
S01010953,Rented or living rent free: Social rented,42,21,18,11,7,1,2,21,12,1,3,4,1
S01010953,Rented or living rent free: Private rented or living rent free,11,8,7,1,6,1,0,3,2,0,0,1,0
S01010954,All HRPs aged 16 and over,206,167,140,22,118,23,4,39,37,0,1,1,0
S01010954,Owned: Total,183,147,124,18,106,21,2,36,35,0,0,1,0
S01010954,Owned: Owned outright,89,60,55,14,41,4,1,29,29,0,0,0,0
S01010954,Owned: Owned with a mortgage or loan or shared ownership,94,87,69,4,65,17,1,7,6,0,0,1,0
S01010954,Rented or living rent free: Total,23,20,16,4,12,2,2,3,2,0,1,0,0
S01010954,Rented or living rent free: Social rented,11,9,7,3,4,0,2,2,1,0,1,0,0
S01010954,Rented or living rent free: Private rented or living rent free,12,11,9,1,8,2,0,1,1,0,0,0,0
S01010955,All HRPs aged 16 and over,345,277,231,18,213,39,7,68,53,4,3,4,4
S01010955,Owned: Total,184,135,105,7,98,30,0,49,48,0,0,1,0
S01010955,Owned: Owned outright,88,46,33,4,29,13,0,42,41,0,0,1,0
S01010955,Owned: Owned with a mortgage or loan or shared ownership,96,89,72,3,69,17,0,7,7,0,0,0,0
S01010955,Rented or living rent free: Total,161,142,126,11,115,9,7,19,5,4,3,3,4
S01010955,Rented or living rent free: Social rented,44,34,27,3,24,4,3,10,2,3,0,2,3
S01010955,Rented or living rent free: Private rented or living rent free,117,108,99,8,91,5,4,9,3,1,3,1,1
S01010956,All HRPs aged 16 and over,304,228,153,18,135,69,6,76,57,6,0,10,3
S01010956,Owned: Total,202,155,94,12,82,60,1,47,45,0,0,2,0
S01010956,Owned: Owned outright,89,52,22,5,17,29,1,37,37,0,0,0,0
S01010956,Owned: Owned with a mortgage or loan or shared ownership,113,103,72,7,65,31,0,10,8,0,0,2,0
S01010956,Rented or living rent free: Total,102,73,59,6,53,9,5,29,12,6,0,8,3
S01010956,Rented or living rent free: Social rented,28,12,9,1,8,0,3,16,5,2,0,7,2
S01010956,Rented or living rent free: Private rented or living rent free,74,61,50,5,45,9,2,13,7,4,0,1,1
S01010957,All HRPs aged 16 and over,231,155,131,18,113,22,2,76,71,1,0,1,3
S01010957,Owned: Total,212,143,123,17,106,20,0,69,66,0,0,1,2
S01010957,Owned: Owned outright,116,50,49,12,37,1,0,66,64,0,0,0,2
S01010957,Owned: Owned with a mortgage or loan or shared ownership,96,93,74,5,69,19,0,3,2,0,0,1,0
S01010957,Rented or living rent free: Total,19,12,8,1,7,2,2,7,5,1,0,0,1
S01010957,Rented or living rent free: Social rented,10,5,5,1,4,0,0,5,5,0,0,0,0
S01010957,Rented or living rent free: Private rented or living rent free,9,7,3,0,3,2,2,2,0,1,0,0,1
S01010958,All HRPs aged 16 and over,224,120,97,9,88,19,4,104,90,1,5,6,2
S01010958,Owned: Total,164,95,77,4,73,17,1,69,66,0,1,1,1
S01010958,Owned: Owned outright,93,34,29,4,25,4,1,59,59,0,0,0,0
S01010958,Owned: Owned with a mortgage or loan or shared ownership,71,61,48,0,48,13,0,10,7,0,1,1,1
S01010958,Rented or living rent free: Total,60,25,20,5,15,2,3,35,24,1,4,5,1
S01010958,Rented or living rent free: Social rented,42,15,13,3,10,0,2,27,18,0,4,4,1
S01010958,Rented or living rent free: Private rented or living rent free,18,10,7,2,5,2,1,8,6,1,0,1,0
S01010959,All HRPs aged 16 and over,290,197,161,39,122,26,10,93,75,0,4,10,4
S01010959,Owned: Total,184,133,112,24,88,21,0,51,48,0,0,2,1
S01010959,Owned: Owned outright,84,37,34,9,25,3,0,47,45,0,0,2,0
S01010959,Owned: Owned with a mortgage or loan or shared ownership,100,96,78,15,63,18,0,4,3,0,0,0,1
S01010959,Rented or living rent free: Total,106,64,49,15,34,5,10,42,27,0,4,8,3
S01010959,Rented or living rent free: Social rented,66,34,28,9,19,2,4,32,20,0,4,6,2
S01010959,Rented or living rent free: Private rented or living rent free,40,30,21,6,15,3,6,10,7,0,0,2,1
S01010960,All HRPs aged 16 and over,441,316,251,39,212,47,18,125,91,5,5,20,4
S01010960,Owned: Total,267,193,156,22,134,36,1,74,68,1,0,4,1
S01010960,Owned: Owned outright,106,45,34,11,23,11,0,61,58,0,0,2,1
S01010960,Owned: Owned with a mortgage or loan or shared ownership,161,148,122,11,111,25,1,13,10,1,0,2,0
S01010960,Rented or living rent free: Total,174,123,95,17,78,11,17,51,23,4,5,16,3
S01010960,Rented or living rent free: Social rented,116,72,56,11,45,5,11,44,18,3,5,16,2
S01010960,Rented or living rent free: Private rented or living rent free,58,51,39,6,33,6,6,7,5,1,0,0,1
S01010961,All HRPs aged 16 and over,246,147,122,25,97,18,7,99,83,0,6,6,4
S01010961,Owned: Total,144,93,79,15,64,13,1,51,51,0,0,0,0
S01010961,Owned: Owned outright,66,25,18,4,14,7,0,41,41,0,0,0,0
S01010961,Owned: Owned with a mortgage or loan or shared ownership,78,68,61,11,50,6,1,10,10,0,0,0,0
S01010961,Rented or living rent free: Total,102,54,43,10,33,5,6,48,32,0,6,6,4
S01010961,Rented or living rent free: Social rented,86,43,34,9,25,5,4,43,28,0,6,6,3
S01010961,Rented or living rent free: Private rented or living rent free,16,11,9,1,8,0,2,5,4,0,0,0,1
S01010962,All HRPs aged 16 and over,314,180,151,23,128,24,5,134,118,0,1,12,3
S01010962,Owned: Total,298,170,143,22,121,23,4,128,114,0,0,11,3
S01010962,Owned: Owned outright,251,132,116,20,96,13,3,119,106,0,0,10,3
S01010962,Owned: Owned with a mortgage or loan or shared ownership,47,38,27,2,25,10,1,9,8,0,0,1,0
S01010962,Rented or living rent free: Total,16,10,8,1,7,1,1,6,4,0,1,1,0
S01010962,Rented or living rent free: Social rented,3,1,1,0,1,0,0,2,1,0,1,0,0
S01010962,Rented or living rent free: Private rented or living rent free,13,9,7,1,6,1,1,4,3,0,0,1,0
S01010963,All HRPs aged 16 and over,395,282,229,28,201,45,8,113,98,2,2,10,1
S01010963,Owned: Total,306,222,185,17,168,37,0,84,80,2,0,1,1
S01010963,Owned: Owned outright,118,46,37,9,28,9,0,72,68,2,0,1,1
S01010963,Owned: Owned with a mortgage or loan or shared ownership,188,176,148,8,140,28,0,12,12,0,0,0,0
S01010963,Rented or living rent free: Total,89,60,44,11,33,8,8,29,18,0,2,9,0
S01010963,Rented or living rent free: Social rented,56,30,23,7,16,2,5,26,17,0,2,7,0
S01010963,Rented or living rent free: Private rented or living rent free,33,30,21,4,17,6,3,3,1,0,0,2,0
S01010964,All HRPs aged 16 and over,216,140,110,22,88,24,6,76,74,0,0,2,0
S01010964,Owned: Total,177,117,93,15,78,21,3,60,59,0,0,1,0
S01010964,Owned: Owned outright,91,36,29,9,20,6,1,55,54,0,0,1,0
S01010964,Owned: Owned with a mortgage or loan or shared ownership,86,81,64,6,58,15,2,5,5,0,0,0,0
S01010964,Rented or living rent free: Total,39,23,17,7,10,3,3,16,15,0,0,1,0
S01010964,Rented or living rent free: Social rented,31,16,13,5,8,1,2,15,14,0,0,1,0
S01010964,Rented or living rent free: Private rented or living rent free,8,7,4,2,2,2,1,1,1,0,0,0,0
S01010965,All HRPs aged 16 and over,230,152,127,39,88,10,15,78,44,2,10,16,6
S01010965,Owned: Total,93,72,64,10,54,7,1,21,18,0,0,2,1
S01010965,Owned: Owned outright,41,24,22,8,14,2,0,17,15,0,0,2,0
S01010965,Owned: Owned with a mortgage or loan or shared ownership,52,48,42,2,40,5,1,4,3,0,0,0,1
S01010965,Rented or living rent free: Total,137,80,63,29,34,3,14,57,26,2,10,14,5
S01010965,Rented or living rent free: Social rented,116,66,51,24,27,2,13,50,23,2,9,11,5
S01010965,Rented or living rent free: Private rented or living rent free,21,14,12,5,7,1,1,7,3,0,1,3,0
S01010966,All HRPs aged 16 and over,309,199,159,25,134,24,16,110,95,0,5,8,2
S01010966,Owned: Total,202,138,118,12,106,17,3,64,62,0,0,2,0
S01010966,Owned: Owned outright,81,26,19,7,12,5,2,55,54,0,0,1,0
S01010966,Owned: Owned with a mortgage or loan or shared ownership,121,112,99,5,94,12,1,9,8,0,0,1,0
S01010966,Rented or living rent free: Total,107,61,41,13,28,7,13,46,33,0,5,6,2
S01010966,Rented or living rent free: Social rented,79,44,30,10,20,4,10,35,26,0,3,5,1
S01010966,Rented or living rent free: Private rented or living rent free,28,17,11,3,8,3,3,11,7,0,2,1,1
S01010967,All HRPs aged 16 and over,309,185,155,35,120,22,8,124,92,0,10,19,3
S01010967,Owned: Total,159,100,86,9,77,13,1,59,57,0,1,1,0
S01010967,Owned: Owned outright,71,20,16,4,12,3,1,51,49,0,1,1,0
S01010967,Owned: Owned with a mortgage or loan or shared ownership,88,80,70,5,65,10,0,8,8,0,0,0,0
S01010967,Rented or living rent free: Total,150,85,69,26,43,9,7,65,35,0,9,18,3
S01010967,Rented or living rent free: Social rented,125,67,53,21,32,8,6,58,32,0,7,17,2
S01010967,Rented or living rent free: Private rented or living rent free,25,18,16,5,11,1,1,7,3,0,2,1,1
S01010968,All HRPs aged 16 and over,316,191,164,23,141,21,6,125,109,1,3,10,2
S01010968,Owned: Total,249,154,132,14,118,19,3,95,93,0,1,0,1
S01010968,Owned: Owned outright,141,51,40,8,32,10,1,90,88,0,1,0,1
S01010968,Owned: Owned with a mortgage or loan or shared ownership,108,103,92,6,86,9,2,5,5,0,0,0,0
S01010968,Rented or living rent free: Total,67,37,32,9,23,2,3,30,16,1,2,10,1
S01010968,Rented or living rent free: Social rented,31,12,10,4,6,0,2,19,11,0,1,6,1
S01010968,Rented or living rent free: Private rented or living rent free,36,25,22,5,17,2,1,11,5,1,1,4,0
S01010969,All HRPs aged 16 and over,264,155,119,16,103,33,3,109,96,5,4,4,0
S01010969,Owned: Total,213,141,108,14,94,32,1,72,71,1,0,0,0
S01010969,Owned: Owned outright,120,57,44,12,32,12,1,63,63,0,0,0,0
S01010969,Owned: Owned with a mortgage or loan or shared ownership,93,84,64,2,62,20,0,9,8,1,0,0,0
S01010969,Rented or living rent free: Total,51,14,11,2,9,1,2,37,25,4,4,4,0
S01010969,Rented or living rent free: Social rented,37,6,4,2,2,1,1,31,25,0,2,4,0
S01010969,Rented or living rent free: Private rented or living rent free,14,8,7,0,7,0,1,6,0,4,2,0,0
S01010970,All HRPs aged 16 and over,428,273,222,45,177,42,9,155,125,4,7,14,5
S01010970,Owned: Total,297,205,168,28,140,35,2,92,86,1,0,1,4
S01010970,Owned: Owned outright,139,57,47,18,29,9,1,82,78,0,0,0,4
S01010970,Owned: Owned with a mortgage or loan or shared ownership,158,148,121,10,111,26,1,10,8,1,0,1,0
S01010970,Rented or living rent free: Total,131,68,54,17,37,7,7,63,39,3,7,13,1
S01010970,Rented or living rent free: Social rented,89,38,31,11,20,3,4,51,33,1,3,13,1
S01010970,Rented or living rent free: Private rented or living rent free,42,30,23,6,17,4,3,12,6,2,4,0,0
S01010971,All HRPs aged 16 and over,401,304,242,47,195,51,11,97,75,1,12,5,4
S01010971,Owned: Total,328,255,204,30,174,48,3,73,72,0,0,1,0
S01010971,Owned: Owned outright,132,68,53,18,35,13,2,64,63,0,0,1,0
S01010971,Owned: Owned with a mortgage or loan or shared ownership,196,187,151,12,139,35,1,9,9,0,0,0,0
S01010971,Rented or living rent free: Total,73,49,38,17,21,3,8,24,3,1,12,4,4
S01010971,Rented or living rent free: Social rented,38,29,25,11,14,0,4,9,1,1,4,2,1
S01010971,Rented or living rent free: Private rented or living rent free,35,20,13,6,7,3,4,15,2,0,8,2,3
S01010972,All HRPs aged 16 and over,333,226,192,49,143,23,11,107,74,3,7,19,4
S01010972,Owned: Total,147,97,84,12,72,12,1,50,44,1,0,5,0
S01010972,Owned: Owned outright,64,26,22,6,16,4,0,38,35,1,0,2,0
S01010972,Owned: Owned with a mortgage or loan or shared ownership,83,71,62,6,56,8,1,12,9,0,0,3,0
S01010972,Rented or living rent free: Total,186,129,108,37,71,11,10,57,30,2,7,14,4
S01010972,Rented or living rent free: Social rented,166,112,95,33,62,9,8,54,27,2,7,14,4
S01010972,Rented or living rent free: Private rented or living rent free,20,17,13,4,9,2,2,3,3,0,0,0,0
S01010973,All HRPs aged 16 and over,205,119,99,11,88,16,4,86,74,2,2,7,1
S01010973,Owned: Total,167,102,85,8,77,13,4,65,61,2,1,1,0
S01010973,Owned: Owned outright,92,39,31,7,24,5,3,53,52,0,0,1,0
S01010973,Owned: Owned with a mortgage or loan or shared ownership,75,63,54,1,53,8,1,12,9,2,1,0,0
S01010973,Rented or living rent free: Total,38,17,14,3,11,3,0,21,13,0,1,6,1
S01010973,Rented or living rent free: Social rented,27,11,9,2,7,2,0,16,8,0,1,6,1
S01010973,Rented or living rent free: Private rented or living rent free,11,6,5,1,4,1,0,5,5,0,0,0,0
S01010974,All HRPs aged 16 and over,298,182,158,24,134,16,8,116,94,3,5,14,0
S01010974,Owned: Total,159,99,86,7,79,12,1,60,56,1,1,2,0
S01010974,Owned: Owned outright,66,21,18,3,15,3,0,45,44,1,0,0,0
S01010974,Owned: Owned with a mortgage or loan or shared ownership,93,78,68,4,64,9,1,15,12,0,1,2,0
S01010974,Rented or living rent free: Total,139,83,72,17,55,4,7,56,38,2,4,12,0
S01010974,Rented or living rent free: Social rented,131,81,70,16,54,4,7,50,33,1,4,12,0
S01010974,Rented or living rent free: Private rented or living rent free,8,2,2,1,1,0,0,6,5,1,0,0,0
S01010975,All HRPs aged 16 and over,195,116,92,15,77,15,9,79,55,1,6,12,5
S01010975,Owned: Total,80,52,43,2,41,8,1,28,27,0,0,1,0
S01010975,Owned: Owned outright,29,8,5,2,3,3,0,21,20,0,0,1,0
S01010975,Owned: Owned with a mortgage or loan or shared ownership,51,44,38,0,38,5,1,7,7,0,0,0,0
S01010975,Rented or living rent free: Total,115,64,49,13,36,7,8,51,28,1,6,11,5
S01010975,Rented or living rent free: Social rented,101,54,43,12,31,6,5,47,27,1,5,10,4
S01010975,Rented or living rent free: Private rented or living rent free,14,10,6,1,5,1,3,4,1,0,1,1,1
S01010976,All HRPs aged 16 and over,211,139,122,17,105,13,4,72,54,2,5,10,1
S01010976,Owned: Total,129,97,86,6,80,10,1,32,28,2,1,1,0
S01010976,Owned: Owned outright,42,18,17,3,14,1,0,24,22,0,1,1,0
S01010976,Owned: Owned with a mortgage or loan or shared ownership,87,79,69,3,66,9,1,8,6,2,0,0,0
S01010976,Rented or living rent free: Total,82,42,36,11,25,3,3,40,26,0,4,9,1
S01010976,Rented or living rent free: Social rented,71,33,28,11,17,3,2,38,24,0,4,9,1
S01010976,Rented or living rent free: Private rented or living rent free,11,9,8,0,8,0,1,2,2,0,0,0,0
S01010977,All HRPs aged 16 and over,312,201,176,24,152,21,4,111,98,1,4,6,2
S01010977,Owned: Total,214,158,140,14,126,16,2,56,56,0,0,0,0
S01010977,Owned: Owned outright,72,29,26,8,18,2,1,43,43,0,0,0,0
S01010977,Owned: Owned with a mortgage or loan or shared ownership,142,129,114,6,108,14,1,13,13,0,0,0,0
S01010977,Rented or living rent free: Total,98,43,36,10,26,5,2,55,42,1,4,6,2
S01010977,Rented or living rent free: Social rented,75,30,24,7,17,4,2,45,37,1,1,5,1
S01010977,Rented or living rent free: Private rented or living rent free,23,13,12,3,9,1,0,10,5,0,3,1,1
S01010978,All HRPs aged 16 and over,354,200,156,27,129,25,19,154,113,0,13,17,11
S01010978,Owned: Total,166,114,95,11,84,16,3,52,50,0,0,0,2
S01010978,Owned: Owned outright,62,20,16,5,11,4,0,42,41,0,0,0,1
S01010978,Owned: Owned with a mortgage or loan or shared ownership,104,94,79,6,73,12,3,10,9,0,0,0,1
S01010978,Rented or living rent free: Total,188,86,61,16,45,9,16,102,63,0,13,17,9
S01010978,Rented or living rent free: Social rented,141,60,45,12,33,3,12,81,54,0,9,10,8
S01010978,Rented or living rent free: Private rented or living rent free,47,26,16,4,12,6,4,21,9,0,4,7,1
S01010979,All HRPs aged 16 and over,324,226,193,33,160,21,12,98,79,2,6,10,1
S01010979,Owned: Total,187,128,115,13,102,13,0,59,57,0,1,1,0
S01010979,Owned: Owned outright,70,23,22,6,16,1,0,47,47,0,0,0,0
S01010979,Owned: Owned with a mortgage or loan or shared ownership,117,105,93,7,86,12,0,12,10,0,1,1,0
S01010979,Rented or living rent free: Total,137,98,78,20,58,8,12,39,22,2,5,9,1
S01010979,Rented or living rent free: Social rented,117,82,66,18,48,5,11,35,20,2,4,8,1
S01010979,Rented or living rent free: Private rented or living rent free,20,16,12,2,10,3,1,4,2,0,1,1,0
S01010980,All HRPs aged 16 and over,348,208,177,40,137,25,6,140,104,2,2,24,8
S01010980,Owned: Total,197,136,114,20,94,21,1,61,58,0,0,2,1
S01010980,Owned: Owned outright,85,33,30,12,18,3,0,52,50,0,0,2,0
S01010980,Owned: Owned with a mortgage or loan or shared ownership,112,103,84,8,76,18,1,9,8,0,0,0,1
S01010980,Rented or living rent free: Total,151,72,63,20,43,4,5,79,46,2,2,22,7
S01010980,Rented or living rent free: Social rented,113,51,44,14,30,3,4,62,40,0,1,16,5
S01010980,Rented or living rent free: Private rented or living rent free,38,21,19,6,13,1,1,17,6,2,1,6,2
S01010981,All HRPs aged 16 and over,330,180,155,31,124,18,7,150,115,1,9,17,8
S01010981,Owned: Total,177,104,89,13,76,15,0,73,65,1,1,3,3
S01010981,Owned: Owned outright,86,26,23,8,15,3,0,60,56,1,1,1,1
S01010981,Owned: Owned with a mortgage or loan or shared ownership,91,78,66,5,61,12,0,13,9,0,0,2,2
S01010981,Rented or living rent free: Total,153,76,66,18,48,3,7,77,50,0,8,14,5
S01010981,Rented or living rent free: Social rented,120,56,48,12,36,2,6,64,44,0,5,12,3
S01010981,Rented or living rent free: Private rented or living rent free,33,20,18,6,12,1,1,13,6,0,3,2,2
S01010982,All HRPs aged 16 and over,447,316,227,24,203,77,12,131,115,1,6,5,4
S01010982,Owned: Total,368,261,183,12,171,72,6,107,104,1,1,0,1
S01010982,Owned: Owned outright,185,91,64,7,57,26,1,94,91,1,1,0,1
S01010982,Owned: Owned with a mortgage or loan or shared ownership,183,170,119,5,114,46,5,13,13,0,0,0,0
S01010982,Rented or living rent free: Total,79,55,44,12,32,5,6,24,11,0,5,5,3
S01010982,Rented or living rent free: Social rented,33,19,13,5,8,4,2,14,6,0,4,3,1
S01010982,Rented or living rent free: Private rented or living rent free,46,36,31,7,24,1,4,10,5,0,1,2,2
S01010983,All HRPs aged 16 and over,388,232,191,26,165,38,3,156,128,4,8,13,3
S01010983,Owned: Total,264,167,138,9,129,29,0,97,94,1,0,1,1
S01010983,Owned: Owned outright,133,43,37,7,30,6,0,90,89,0,0,0,1
S01010983,Owned: Owned with a mortgage or loan or shared ownership,131,124,101,2,99,23,0,7,5,1,0,1,0
S01010983,Rented or living rent free: Total,124,65,53,17,36,9,3,59,34,3,8,12,2
S01010983,Rented or living rent free: Social rented,79,39,30,8,22,6,3,40,24,0,3,11,2
S01010983,Rented or living rent free: Private rented or living rent free,45,26,23,9,14,3,0,19,10,3,5,1,0
S01010984,All HRPs aged 16 and over,300,150,125,21,104,22,3,150,138,0,6,4,2
S01010984,Owned: Total,258,130,108,15,93,21,1,128,127,0,0,0,1
S01010984,Owned: Owned outright,162,42,34,7,27,7,1,120,119,0,0,0,1
S01010984,Owned: Owned with a mortgage or loan or shared ownership,96,88,74,8,66,14,0,8,8,0,0,0,0
S01010984,Rented or living rent free: Total,42,20,17,6,11,1,2,22,11,0,6,4,1
S01010984,Rented or living rent free: Social rented,33,13,11,4,7,0,2,20,10,0,5,4,1
S01010984,Rented or living rent free: Private rented or living rent free,9,7,6,2,4,1,0,2,1,0,1,0,0
S01010985,All HRPs aged 16 and over,244,158,130,19,111,18,10,86,75,1,7,3,0
S01010985,Owned: Total,159,104,89,8,81,12,3,55,53,0,2,0,0
S01010985,Owned: Owned outright,65,17,13,1,12,2,2,48,48,0,0,0,0
S01010985,Owned: Owned with a mortgage or loan or shared ownership,94,87,76,7,69,10,1,7,5,0,2,0,0
S01010985,Rented or living rent free: Total,85,54,41,11,30,6,7,31,22,1,5,3,0
S01010985,Rented or living rent free: Social rented,60,35,27,7,20,5,3,25,20,1,1,3,0
S01010985,Rented or living rent free: Private rented or living rent free,25,19,14,4,10,1,4,6,2,0,4,0,0
S01010986,All HRPs aged 16 and over,179,150,123,9,114,27,0,29,28,0,0,1,0
S01010986,Owned: Total,171,146,120,9,111,26,0,25,24,0,0,1,0
S01010986,Owned: Owned outright,38,19,17,6,11,2,0,19,19,0,0,0,0
S01010986,Owned: Owned with a mortgage or loan or shared ownership,133,127,103,3,100,24,0,6,5,0,0,1,0
S01010986,Rented or living rent free: Total,8,4,3,0,3,1,0,4,4,0,0,0,0
S01010986,Rented or living rent free: Social rented,3,0,0,0,0,0,0,3,3,0,0,0,0
S01010986,Rented or living rent free: Private rented or living rent free,5,4,3,0,3,1,0,1,1,0,0,0,0
S01010987,All HRPs aged 16 and over,219,185,145,6,139,38,2,34,27,1,3,2,1
S01010987,Owned: Total,208,180,140,6,134,38,2,28,26,0,0,1,1
S01010987,Owned: Owned outright,56,35,28,3,25,7,0,21,20,0,0,0,1
S01010987,Owned: Owned with a mortgage or loan or shared ownership,152,145,112,3,109,31,2,7,6,0,0,1,0
S01010987,Rented or living rent free: Total,11,5,5,0,5,0,0,6,1,1,3,1,0
S01010987,Rented or living rent free: Social rented,3,0,0,0,0,0,0,3,0,0,2,1,0
S01010987,Rented or living rent free: Private rented or living rent free,8,5,5,0,5,0,0,3,1,1,1,0,0
S01010988,All HRPs aged 16 and over,205,176,153,10,143,22,1,29,22,0,2,3,2
S01010988,Owned: Total,197,173,150,9,141,22,1,24,20,0,2,1,1
S01010988,Owned: Owned outright,44,25,23,4,19,2,0,19,17,0,1,0,1
S01010988,Owned: Owned with a mortgage or loan or shared ownership,153,148,127,5,122,20,1,5,3,0,1,1,0
S01010988,Rented or living rent free: Total,8,3,3,1,2,0,0,5,2,0,0,2,1
S01010988,Rented or living rent free: Social rented,4,0,0,0,0,0,0,4,2,0,0,1,1
S01010988,Rented or living rent free: Private rented or living rent free,4,3,3,1,2,0,0,1,0,0,0,1,0
S01010989,All HRPs aged 16 and over,357,337,295,9,286,41,1,20,14,0,1,4,1
S01010989,Owned: Total,326,311,271,9,262,40,0,15,13,0,0,1,1
S01010989,Owned: Owned outright,31,18,16,2,14,2,0,13,12,0,0,0,1
S01010989,Owned: Owned with a mortgage or loan or shared ownership,295,293,255,7,248,38,0,2,1,0,0,1,0
S01010989,Rented or living rent free: Total,31,26,24,0,24,1,1,5,1,0,1,3,0
S01010989,Rented or living rent free: Social rented,5,2,2,0,2,0,0,3,0,0,0,3,0
S01010989,Rented or living rent free: Private rented or living rent free,26,24,22,0,22,1,1,2,1,0,1,0,0
S01010990,All HRPs aged 16 and over,319,198,165,28,137,29,4,121,103,0,4,11,3
S01010990,Owned: Total,215,150,121,17,104,27,2,65,64,0,0,1,0
S01010990,Owned: Owned outright,92,33,26,7,19,6,1,59,59,0,0,0,0
S01010990,Owned: Owned with a mortgage or loan or shared ownership,123,117,95,10,85,21,1,6,5,0,0,1,0
S01010990,Rented or living rent free: Total,104,48,44,11,33,2,2,56,39,0,4,10,3
S01010990,Rented or living rent free: Social rented,73,25,23,8,15,0,2,48,34,0,2,10,2
S01010990,Rented or living rent free: Private rented or living rent free,31,23,21,3,18,2,0,8,5,0,2,0,1
S01010991,All HRPs aged 16 and over,198,152,127,13,114,21,4,46,41,0,0,4,1
S01010991,Owned: Total,157,125,104,9,95,19,2,32,32,0,0,0,0
S01010991,Owned: Owned outright,63,35,26,7,19,7,2,28,28,0,0,0,0
S01010991,Owned: Owned with a mortgage or loan or shared ownership,94,90,78,2,76,12,0,4,4,0,0,0,0
S01010991,Rented or living rent free: Total,41,27,23,4,19,2,2,14,9,0,0,4,1
S01010991,Rented or living rent free: Social rented,23,15,13,2,11,0,2,8,5,0,0,3,0
S01010991,Rented or living rent free: Private rented or living rent free,18,12,10,2,8,2,0,6,4,0,0,1,1
S01010992,All HRPs aged 16 and over,184,172,143,10,133,27,2,12,8,1,0,0,3
S01010992,Owned: Total,166,160,133,6,127,26,1,6,5,0,0,0,1
S01010992,Owned: Owned outright,25,20,17,4,13,3,0,5,4,0,0,0,1
S01010992,Owned: Owned with a mortgage or loan or shared ownership,141,140,116,2,114,23,1,1,1,0,0,0,0
S01010992,Rented or living rent free: Total,18,12,10,4,6,1,1,6,3,1,0,0,2
S01010992,Rented or living rent free: Social rented,6,4,4,1,3,0,0,2,1,0,0,0,1
S01010992,Rented or living rent free: Private rented or living rent free,12,8,6,3,3,1,1,4,2,1,0,0,1
S01010993,All HRPs aged 16 and over,252,181,157,24,133,20,4,71,64,0,0,7,0
S01010993,Owned: Total,208,161,143,20,123,17,1,47,46,0,0,1,0
S01010993,Owned: Owned outright,70,32,28,4,24,3,1,38,38,0,0,0,0
S01010993,Owned: Owned with a mortgage or loan or shared ownership,138,129,115,16,99,14,0,9,8,0,0,1,0
S01010993,Rented or living rent free: Total,44,20,14,4,10,3,3,24,18,0,0,6,0
S01010993,Rented or living rent free: Social rented,34,14,9,3,6,2,3,20,14,0,0,6,0
S01010993,Rented or living rent free: Private rented or living rent free,10,6,5,1,4,1,0,4,4,0,0,0,0
S01010994,All HRPs aged 16 and over,390,289,236,22,214,50,3,101,91,2,4,1,3
S01010994,Owned: Total,350,256,213,15,198,42,1,94,90,0,2,1,1
S01010994,Owned: Owned outright,148,64,45,8,37,18,1,84,81,0,1,1,1
S01010994,Owned: Owned with a mortgage or loan or shared ownership,202,192,168,7,161,24,0,10,9,0,1,0,0
S01010994,Rented or living rent free: Total,40,33,23,7,16,8,2,7,1,2,2,0,2
S01010994,Rented or living rent free: Social rented,9,7,6,3,3,1,0,2,0,0,0,0,2
S01010994,Rented or living rent free: Private rented or living rent free,31,26,17,4,13,7,2,5,1,2,2,0,0
S01010995,All HRPs aged 16 and over,290,220,190,31,159,25,5,70,63,0,3,2,2
S01010995,Owned: Total,271,207,182,30,152,21,4,64,62,0,0,0,2
S01010995,Owned: Owned outright,136,77,69,18,51,6,2,59,58,0,0,0,1
S01010995,Owned: Owned with a mortgage or loan or shared ownership,135,130,113,12,101,15,2,5,4,0,0,0,1
S01010995,Rented or living rent free: Total,19,13,8,1,7,4,1,6,1,0,3,2,0
S01010995,Rented or living rent free: Social rented,7,4,2,1,1,2,0,3,0,0,1,2,0
S01010995,Rented or living rent free: Private rented or living rent free,12,9,6,0,6,2,1,3,1,0,2,0,0
S01010996,All HRPs aged 16 and over,235,174,140,10,130,31,3,61,59,1,0,1,0
S01010996,Owned: Total,212,157,128,10,118,29,0,55,54,0,0,1,0
S01010996,Owned: Owned outright,87,39,31,7,24,8,0,48,47,0,0,1,0
S01010996,Owned: Owned with a mortgage or loan or shared ownership,125,118,97,3,94,21,0,7,7,0,0,0,0
S01010996,Rented or living rent free: Total,23,17,12,0,12,2,3,6,5,1,0,0,0
S01010996,Rented or living rent free: Social rented,6,3,2,0,2,0,1,3,3,0,0,0,0
S01010996,Rented or living rent free: Private rented or living rent free,17,14,10,0,10,2,2,3,2,1,0,0,0
S01010997,All HRPs aged 16 and over,290,158,122,13,109,35,1,132,126,1,1,3,1
S01010997,Owned: Total,271,145,112,10,102,32,1,126,124,0,0,1,1
S01010997,Owned: Owned outright,174,55,45,7,38,10,0,119,117,0,0,1,1
S01010997,Owned: Owned with a mortgage or loan or shared ownership,97,90,67,3,64,22,1,7,7,0,0,0,0
S01010997,Rented or living rent free: Total,19,13,10,3,7,3,0,6,2,1,1,2,0
S01010997,Rented or living rent free: Social rented,7,3,1,0,1,2,0,4,2,0,1,1,0
S01010997,Rented or living rent free: Private rented or living rent free,12,10,9,3,6,1,0,2,0,1,0,1,0
S01010998,All HRPs aged 16 and over,216,155,104,7,97,49,2,61,55,0,3,2,1
S01010998,Owned: Total,201,142,93,6,87,48,1,59,53,0,3,2,1
S01010998,Owned: Owned outright,100,43,22,3,19,20,1,57,51,0,3,2,1
S01010998,Owned: Owned with a mortgage or loan or shared ownership,101,99,71,3,68,28,0,2,2,0,0,0,0
S01010998,Rented or living rent free: Total,15,13,11,1,10,1,1,2,2,0,0,0,0
S01010998,Rented or living rent free: Social rented,2,2,2,1,1,0,0,0,0,0,0,0,0
S01010998,Rented or living rent free: Private rented or living rent free,13,11,9,0,9,1,1,2,2,0,0,0,0
S01010999,All HRPs aged 16 and over,412,229,192,23,169,33,4,183,172,1,0,8,2
S01010999,Owned: Total,297,180,146,15,131,33,1,117,116,0,0,0,1
S01010999,Owned: Owned outright,168,55,43,11,32,11,1,113,112,0,0,0,1
S01010999,Owned: Owned with a mortgage or loan or shared ownership,129,125,103,4,99,22,0,4,4,0,0,0,0
S01010999,Rented or living rent free: Total,115,49,46,8,38,0,3,66,56,1,0,8,1
S01010999,Rented or living rent free: Social rented,72,15,13,4,9,0,2,57,51,0,0,6,0
S01010999,Rented or living rent free: Private rented or living rent free,43,34,33,4,29,0,1,9,5,1,0,2,1
S01011000,All HRPs aged 16 and over,345,256,187,29,158,62,7,89,74,2,5,4,4
S01011000,Owned: Total,247,186,133,18,115,51,2,61,60,0,1,0,0
S01011000,Owned: Owned outright,119,62,41,12,29,20,1,57,57,0,0,0,0
S01011000,Owned: Owned with a mortgage or loan or shared ownership,128,124,92,6,86,31,1,4,3,0,1,0,0
S01011000,Rented or living rent free: Total,98,70,54,11,43,11,5,28,14,2,4,4,4
S01011000,Rented or living rent free: Social rented,56,37,31,9,22,4,2,19,9,1,3,3,3
S01011000,Rented or living rent free: Private rented or living rent free,42,33,23,2,21,7,3,9,5,1,1,1,1
S01011001,All HRPs aged 16 and over,273,172,147,23,124,22,3,101,81,1,8,4,7
S01011001,Owned: Total,175,123,104,13,91,16,3,52,47,0,1,2,2
S01011001,Owned: Owned outright,70,32,29,8,21,3,0,38,34,0,0,2,2
S01011001,Owned: Owned with a mortgage or loan or shared ownership,105,91,75,5,70,13,3,14,13,0,1,0,0
S01011001,Rented or living rent free: Total,98,49,43,10,33,6,0,49,34,1,7,2,5
S01011001,Rented or living rent free: Social rented,81,41,39,9,30,2,0,40,29,0,4,2,5
S01011001,Rented or living rent free: Private rented or living rent free,17,8,4,1,3,4,0,9,5,1,3,0,0
S01011002,All HRPs aged 16 and over,314,191,169,38,131,17,5,123,100,1,4,12,6
S01011002,Owned: Total,178,123,108,19,89,15,0,55,52,1,0,1,1
S01011002,Owned: Owned outright,75,32,29,11,18,3,0,43,43,0,0,0,0
S01011002,Owned: Owned with a mortgage or loan or shared ownership,103,91,79,8,71,12,0,12,9,1,0,1,1
S01011002,Rented or living rent free: Total,136,68,61,19,42,2,5,68,48,0,4,11,5
S01011002,Rented or living rent free: Social rented,116,56,51,16,35,2,3,60,43,0,2,10,5
S01011002,Rented or living rent free: Private rented or living rent free,20,12,10,3,7,0,2,8,5,0,2,1,0
S01011003,All HRPs aged 16 and over,280,171,144,36,108,21,6,109,84,4,5,9,7
S01011003,Owned: Total,173,111,92,15,77,18,1,62,54,1,0,5,2
S01011003,Owned: Owned outright,73,23,17,1,16,6,0,50,44,1,0,3,2
S01011003,Owned: Owned with a mortgage or loan or shared ownership,100,88,75,14,61,12,1,12,10,0,0,2,0
S01011003,Rented or living rent free: Total,107,60,52,21,31,3,5,47,30,3,5,4,5
S01011003,Rented or living rent free: Social rented,90,53,46,19,27,3,4,37,26,1,2,4,4
S01011003,Rented or living rent free: Private rented or living rent free,17,7,6,2,4,0,1,10,4,2,3,0,1
S01011004,All HRPs aged 16 and over,249,194,160,20,140,26,8,55,48,2,2,3,0
S01011004,Owned: Total,201,165,137,14,123,23,5,36,32,1,2,1,0
S01011004,Owned: Owned outright,56,27,22,4,18,4,1,29,27,0,2,0,0
S01011004,Owned: Owned with a mortgage or loan or shared ownership,145,138,115,10,105,19,4,7,5,1,0,1,0
S01011004,Rented or living rent free: Total,48,29,23,6,17,3,3,19,16,1,0,2,0
S01011004,Rented or living rent free: Social rented,37,19,13,4,9,3,3,18,16,0,0,2,0
S01011004,Rented or living rent free: Private rented or living rent free,11,10,10,2,8,0,0,1,0,1,0,0,0
S01011005,All HRPs aged 16 and over,337,210,179,36,143,22,9,127,97,2,5,18,5
S01011005,Owned: Total,174,117,102,16,86,14,1,57,53,0,0,4,0
S01011005,Owned: Owned outright,76,27,22,9,13,4,1,49,48,0,0,1,0
S01011005,Owned: Owned with a mortgage or loan or shared ownership,98,90,80,7,73,10,0,8,5,0,0,3,0
S01011005,Rented or living rent free: Total,163,93,77,20,57,8,8,70,44,2,5,14,5
S01011005,Rented or living rent free: Social rented,125,63,55,17,38,3,5,62,40,2,2,13,5
S01011005,Rented or living rent free: Private rented or living rent free,38,30,22,3,19,5,3,8,4,0,3,1,0
S01011006,All HRPs aged 16 and over,422,302,262,24,238,33,7,120,92,3,6,10,9
S01011006,Owned: Total,280,219,193,14,179,26,0,61,53,0,1,2,5
S01011006,Owned: Owned outright,84,33,28,3,25,5,0,51,45,0,0,1,5
S01011006,Owned: Owned with a mortgage or loan or shared ownership,196,186,165,11,154,21,0,10,8,0,1,1,0
S01011006,Rented or living rent free: Total,142,83,69,10,59,7,7,59,39,3,5,8,4
S01011006,Rented or living rent free: Social rented,99,50,43,8,35,3,4,49,32,3,2,8,4
S01011006,Rented or living rent free: Private rented or living rent free,43,33,26,2,24,4,3,10,7,0,3,0,0
S01011007,All HRPs aged 16 and over,280,164,142,23,119,17,5,116,88,4,5,15,4
S01011007,Owned: Total,130,85,72,7,65,12,1,45,44,0,0,1,0
S01011007,Owned: Owned outright,51,17,13,3,10,4,0,34,33,0,0,1,0
S01011007,Owned: Owned with a mortgage or loan or shared ownership,79,68,59,4,55,8,1,11,11,0,0,0,0
S01011007,Rented or living rent free: Total,150,79,70,16,54,5,4,71,44,4,5,14,4
S01011007,Rented or living rent free: Social rented,130,71,64,16,48,4,3,59,40,3,3,10,3
S01011007,Rented or living rent free: Private rented or living rent free,20,8,6,0,6,1,1,12,4,1,2,4,1
S01011008,All HRPs aged 16 and over,332,208,178,32,146,19,11,124,99,1,6,15,3
S01011008,Owned: Total,199,135,118,18,100,15,2,64,62,0,0,2,0
S01011008,Owned: Owned outright,90,36,30,7,23,6,0,54,52,0,0,2,0
S01011008,Owned: Owned with a mortgage or loan or shared ownership,109,99,88,11,77,9,2,10,10,0,0,0,0
S01011008,Rented or living rent free: Total,133,73,60,14,46,4,9,60,37,1,6,13,3
S01011008,Rented or living rent free: Social rented,119,66,56,13,43,3,7,53,35,1,4,10,3
S01011008,Rented or living rent free: Private rented or living rent free,14,7,4,1,3,1,2,7,2,0,2,3,0
S01011009,All HRPs aged 16 and over,222,162,143,25,118,9,10,60,36,1,1,15,7
S01011009,Owned: Total,107,85,79,8,71,5,1,22,20,0,0,2,0
S01011009,Owned: Owned outright,28,19,17,4,13,1,1,9,8,0,0,1,0
S01011009,Owned: Owned with a mortgage or loan or shared ownership,79,66,62,4,58,4,0,13,12,0,0,1,0
S01011009,Rented or living rent free: Total,115,77,64,17,47,4,9,38,16,1,1,13,7
S01011009,Rented or living rent free: Social rented,107,69,58,16,42,3,8,38,16,1,1,13,7
S01011009,Rented or living rent free: Private rented or living rent free,8,8,6,1,5,1,1,0,0,0,0,0,0
S01011010,All HRPs aged 16 and over,335,205,168,32,136,10,27,130,85,2,8,24,11
S01011010,Owned: Total,151,90,80,13,67,7,3,61,58,0,0,1,2
S01011010,Owned: Owned outright,75,20,17,7,10,0,3,55,53,0,0,1,1
S01011010,Owned: Owned with a mortgage or loan or shared ownership,76,70,63,6,57,7,0,6,5,0,0,0,1
S01011010,Rented or living rent free: Total,184,115,88,19,69,3,24,69,27,2,8,23,9
S01011010,Rented or living rent free: Social rented,102,46,32,15,17,0,14,56,19,2,7,22,6
S01011010,Rented or living rent free: Private rented or living rent free,82,69,56,4,52,3,10,13,8,0,1,1,3
S01011011,All HRPs aged 16 and over,435,237,194,48,146,13,30,198,131,9,8,35,15
S01011011,Owned: Total,133,85,75,8,67,9,1,48,43,0,1,4,0
S01011011,Owned: Owned outright,53,17,15,3,12,2,0,36,35,0,0,1,0
S01011011,Owned: Owned with a mortgage or loan or shared ownership,80,68,60,5,55,7,1,12,8,0,1,3,0
S01011011,Rented or living rent free: Total,302,152,119,40,79,4,29,150,88,9,7,31,15
S01011011,Rented or living rent free: Social rented,244,114,86,35,51,4,24,130,77,7,5,29,12
S01011011,Rented or living rent free: Private rented or living rent free,58,38,33,5,28,0,5,20,11,2,2,2,3
S01011012,All HRPs aged 16 and over,313,195,154,43,111,12,29,118,62,3,19,25,9
S01011012,Owned: Total,80,53,43,6,37,8,2,27,22,1,1,2,1
S01011012,Owned: Owned outright,32,9,8,3,5,1,0,23,21,0,1,0,1
S01011012,Owned: Owned with a mortgage or loan or shared ownership,48,44,35,3,32,7,2,4,1,1,0,2,0
S01011012,Rented or living rent free: Total,233,142,111,37,74,4,27,91,40,2,18,23,8
S01011012,Rented or living rent free: Social rented,217,132,105,35,70,2,25,85,37,2,18,23,5
S01011012,Rented or living rent free: Private rented or living rent free,16,10,6,2,4,2,2,6,3,0,0,0,3
S01011013,All HRPs aged 16 and over,375,210,189,33,156,15,6,165,139,0,6,17,3
S01011013,Owned: Total,221,135,123,13,110,12,0,86,83,0,0,3,0
S01011013,Owned: Owned outright,103,33,31,9,22,2,0,70,68,0,0,2,0
S01011013,Owned: Owned with a mortgage or loan or shared ownership,118,102,92,4,88,10,0,16,15,0,0,1,0
S01011013,Rented or living rent free: Total,154,75,66,20,46,3,6,79,56,0,6,14,3
S01011013,Rented or living rent free: Social rented,135,64,58,18,40,2,4,71,53,0,2,13,3
S01011013,Rented or living rent free: Private rented or living rent free,19,11,8,2,6,1,2,8,3,0,4,1,0
S01011014,All HRPs aged 16 and over,364,263,223,36,187,25,15,101,71,2,7,11,10
S01011014,Owned: Total,242,189,167,20,147,21,1,53,51,0,1,1,0
S01011014,Owned: Owned outright,104,58,52,10,42,6,0,46,46,0,0,0,0
S01011014,Owned: Owned with a mortgage or loan or shared ownership,138,131,115,10,105,15,1,7,5,0,1,1,0
S01011014,Rented or living rent free: Total,122,74,56,16,40,4,14,48,20,2,6,10,10
S01011014,Rented or living rent free: Social rented,93,57,41,11,30,3,13,36,14,2,6,8,6
S01011014,Rented or living rent free: Private rented or living rent free,29,17,15,5,10,1,1,12,6,0,0,2,4
S01011015,All HRPs aged 16 and over,200,136,106,18,88,19,11,64,54,0,3,6,1
S01011015,Owned: Total,117,90,74,11,63,14,2,27,26,0,0,1,0
S01011015,Owned: Owned outright,54,32,27,10,17,5,0,22,21,0,0,1,0
S01011015,Owned: Owned with a mortgage or loan or shared ownership,63,58,47,1,46,9,2,5,5,0,0,0,0
S01011015,Rented or living rent free: Total,83,46,32,7,25,5,9,37,28,0,3,5,1
S01011015,Rented or living rent free: Social rented,76,43,30,7,23,4,9,33,26,0,1,5,1
S01011015,Rented or living rent free: Private rented or living rent free,7,3,2,0,2,1,0,4,2,0,2,0,0
S01011016,All HRPs aged 16 and over,311,282,221,12,209,49,12,29,12,0,2,11,4
S01011016,Owned: Total,239,226,182,6,176,41,3,13,10,0,1,2,0
S01011016,Owned: Owned outright,28,19,16,2,14,1,2,9,7,0,1,1,0
S01011016,Owned: Owned with a mortgage or loan or shared ownership,211,207,166,4,162,40,1,4,3,0,0,1,0
S01011016,Rented or living rent free: Total,72,56,39,6,33,8,9,16,2,0,1,9,4
S01011016,Rented or living rent free: Social rented,56,41,29,5,24,3,9,15,1,0,1,9,4
S01011016,Rented or living rent free: Private rented or living rent free,16,15,10,1,9,5,0,1,1,0,0,0,0
S01011017,All HRPs aged 16 and over,352,255,184,25,159,67,4,97,88,1,1,5,2
S01011017,Owned: Total,257,182,134,21,113,44,4,75,72,1,0,0,2
S01011017,Owned: Owned outright,147,79,60,16,44,17,2,68,66,1,0,0,1
S01011017,Owned: Owned with a mortgage or loan or shared ownership,110,103,74,5,69,27,2,7,6,0,0,0,1
S01011017,Rented or living rent free: Total,95,73,50,4,46,23,0,22,16,0,1,5,0
S01011017,Rented or living rent free: Social rented,23,16,9,1,8,7,0,7,4,0,0,3,0
S01011017,Rented or living rent free: Private rented or living rent free,72,57,41,3,38,16,0,15,12,0,1,2,0
S01011018,All HRPs aged 16 and over,366,233,185,29,156,41,7,133,110,2,3,13,5
S01011018,Owned: Total,201,146,114,16,98,32,0,55,50,1,0,3,1
S01011018,Owned: Owned outright,87,40,33,11,22,7,0,47,42,1,0,3,1
S01011018,Owned: Owned with a mortgage or loan or shared ownership,114,106,81,5,76,25,0,8,8,0,0,0,0
S01011018,Rented or living rent free: Total,165,87,71,13,58,9,7,78,60,1,3,10,4
S01011018,Rented or living rent free: Social rented,132,66,58,13,45,3,5,66,53,0,2,8,3
S01011018,Rented or living rent free: Private rented or living rent free,33,21,13,0,13,6,2,12,7,1,1,2,1
S01011019,All HRPs aged 16 and over,408,311,233,30,203,65,13,97,73,3,11,8,2
S01011019,Owned: Total,228,187,145,15,130,41,1,41,39,2,0,0,0
S01011019,Owned: Owned outright,108,72,49,11,38,22,1,36,34,2,0,0,0
S01011019,Owned: Owned with a mortgage or loan or shared ownership,120,115,96,4,92,19,0,5,5,0,0,0,0
S01011019,Rented or living rent free: Total,180,124,88,15,73,24,12,56,34,1,11,8,2
S01011019,Rented or living rent free: Social rented,93,54,39,10,29,7,8,39,22,0,9,7,1
S01011019,Rented or living rent free: Private rented or living rent free,87,70,49,5,44,17,4,17,12,1,2,1,1
S01011020,All HRPs aged 16 and over,202,147,116,11,105,28,3,55,46,0,1,7,1
S01011020,Owned: Total,166,129,102,10,92,26,1,37,35,0,0,2,0
S01011020,Owned: Owned outright,59,29,21,6,15,8,0,30,30,0,0,0,0
S01011020,Owned: Owned with a mortgage or loan or shared ownership,107,100,81,4,77,18,1,7,5,0,0,2,0
S01011020,Rented or living rent free: Total,36,18,14,1,13,2,2,18,11,0,1,5,1
S01011020,Rented or living rent free: Social rented,13,6,5,1,4,0,1,7,2,0,1,3,1
S01011020,Rented or living rent free: Private rented or living rent free,23,12,9,0,9,2,1,11,9,0,0,2,0
S01011021,All HRPs aged 16 and over,351,210,182,33,149,23,5,141,108,0,12,15,6
S01011021,Owned: Total,223,147,125,14,111,19,3,76,70,0,2,3,1
S01011021,Owned: Owned outright,95,37,33,8,25,3,1,58,56,0,1,1,0
S01011021,Owned: Owned with a mortgage or loan or shared ownership,128,110,92,6,86,16,2,18,14,0,1,2,1
S01011021,Rented or living rent free: Total,128,63,57,19,38,4,2,65,38,0,10,12,5
S01011021,Rented or living rent free: Social rented,108,50,47,17,30,1,2,58,36,0,9,10,3
S01011021,Rented or living rent free: Private rented or living rent free,20,13,10,2,8,3,0,7,2,0,1,2,2
S01011022,All HRPs aged 16 and over,233,153,124,26,98,19,10,80,55,0,7,17,1
S01011022,Owned: Total,118,84,70,8,62,13,1,34,30,0,1,3,0
S01011022,Owned: Owned outright,46,14,9,1,8,5,0,32,30,0,1,1,0
S01011022,Owned: Owned with a mortgage or loan or shared ownership,72,70,61,7,54,8,1,2,0,0,0,2,0
S01011022,Rented or living rent free: Total,115,69,54,18,36,6,9,46,25,0,6,14,1
S01011022,Rented or living rent free: Social rented,105,64,50,18,32,6,8,41,22,0,4,14,1
S01011022,Rented or living rent free: Private rented or living rent free,10,5,4,0,4,0,1,5,3,0,2,0,0
S01011023,All HRPs aged 16 and over,350,233,194,29,165,34,5,117,79,3,9,14,12
S01011023,Owned: Total,233,178,148,18,130,30,0,55,49,0,0,4,2
S01011023,Owned: Owned outright,83,39,32,7,25,7,0,44,43,0,0,1,0
S01011023,Owned: Owned with a mortgage or loan or shared ownership,150,139,116,11,105,23,0,11,6,0,0,3,2
S01011023,Rented or living rent free: Total,117,55,46,11,35,4,5,62,30,3,9,10,10
S01011023,Rented or living rent free: Social rented,93,42,34,7,27,4,4,51,27,1,4,10,9
S01011023,Rented or living rent free: Private rented or living rent free,24,13,12,4,8,0,1,11,3,2,5,0,1
S01011024,All HRPs aged 16 and over,302,193,163,36,127,17,13,109,53,1,24,20,11
S01011024,Owned: Total,129,92,85,16,69,6,1,37,32,0,1,2,2
S01011024,Owned: Owned outright,48,18,18,5,13,0,0,30,28,0,0,0,2
S01011024,Owned: Owned with a mortgage or loan or shared ownership,81,74,67,11,56,6,1,7,4,0,1,2,0
S01011024,Rented or living rent free: Total,173,101,78,20,58,11,12,72,21,1,23,18,9
S01011024,Rented or living rent free: Social rented,154,90,68,18,50,10,12,64,17,1,20,17,9
S01011024,Rented or living rent free: Private rented or living rent free,19,11,10,2,8,1,0,8,4,0,3,1,0
S01011025,All HRPs aged 16 and over,276,207,173,42,131,12,22,69,38,2,5,20,4
S01011025,Owned: Total,105,87,77,14,63,8,2,18,17,0,0,1,0
S01011025,Owned: Owned outright,27,14,13,5,8,1,0,13,13,0,0,0,0
S01011025,Owned: Owned with a mortgage or loan or shared ownership,78,73,64,9,55,7,2,5,4,0,0,1,0
S01011025,Rented or living rent free: Total,171,120,96,28,68,4,20,51,21,2,5,19,4
S01011025,Rented or living rent free: Social rented,155,113,94,28,66,3,16,42,19,1,3,16,3
S01011025,Rented or living rent free: Private rented or living rent free,16,7,2,0,2,1,4,9,2,1,2,3,1
S01011026,All HRPs aged 16 and over,235,165,134,24,110,16,15,70,37,2,3,22,6
S01011026,Owned: Total,91,75,66,8,58,9,0,16,13,0,1,1,1
S01011026,Owned: Owned outright,27,13,11,2,9,2,0,14,12,0,1,1,0
S01011026,Owned: Owned with a mortgage or loan or shared ownership,64,62,55,6,49,7,0,2,1,0,0,0,1
S01011026,Rented or living rent free: Total,144,90,68,16,52,7,15,54,24,2,2,21,5
S01011026,Rented or living rent free: Social rented,137,86,65,14,51,7,14,51,24,1,2,21,3
S01011026,Rented or living rent free: Private rented or living rent free,7,4,3,2,1,0,1,3,0,1,0,0,2
S01011027,All HRPs aged 16 and over,418,264,215,43,172,20,29,154,108,2,17,20,7
S01011027,Owned: Total,139,104,95,9,86,8,1,35,33,0,0,1,1
S01011027,Owned: Owned outright,45,17,15,4,11,2,0,28,27,0,0,0,1
S01011027,Owned: Owned with a mortgage or loan or shared ownership,94,87,80,5,75,6,1,7,6,0,0,1,0
S01011027,Rented or living rent free: Total,279,160,120,34,86,12,28,119,75,2,17,19,6
S01011027,Rented or living rent free: Social rented,259,148,112,30,82,11,25,111,73,2,13,19,4
S01011027,Rented or living rent free: Private rented or living rent free,20,12,8,4,4,1,3,8,2,0,4,0,2
S01011028,All HRPs aged 16 and over,425,249,202,47,155,20,27,176,109,3,27,27,10
S01011028,Owned: Total,177,101,89,12,77,9,3,76,75,0,0,1,0
S01011028,Owned: Owned outright,87,20,18,6,12,2,0,67,66,0,0,1,0
S01011028,Owned: Owned with a mortgage or loan or shared ownership,90,81,71,6,65,7,3,9,9,0,0,0,0
S01011028,Rented or living rent free: Total,248,148,113,35,78,11,24,100,34,3,27,26,10
S01011028,Rented or living rent free: Social rented,230,138,104,33,71,10,24,92,30,3,25,24,10
S01011028,Rented or living rent free: Private rented or living rent free,18,10,9,2,7,1,0,8,4,0,2,2,0
S01011029,All HRPs aged 16 and over,263,170,143,21,122,18,9,93,68,0,10,10,5
S01011029,Owned: Total,151,103,92,4,88,11,0,48,46,0,0,1,1
S01011029,Owned: Owned outright,56,14,10,1,9,4,0,42,41,0,0,1,0
S01011029,Owned: Owned with a mortgage or loan or shared ownership,95,89,82,3,79,7,0,6,5,0,0,0,1
S01011029,Rented or living rent free: Total,112,67,51,17,34,7,9,45,22,0,10,9,4
S01011029,Rented or living rent free: Social rented,97,56,43,16,27,5,8,41,19,0,10,9,3
S01011029,Rented or living rent free: Private rented or living rent free,15,11,8,1,7,2,1,4,3,0,0,0,1
S01011030,All HRPs aged 16 and over,369,283,252,22,230,29,2,86,71,0,5,6,4
S01011030,Owned: Total,306,239,215,14,201,24,0,67,62,0,1,3,1
S01011030,Owned: Owned outright,107,51,46,6,40,5,0,56,54,0,1,1,0
S01011030,Owned: Owned with a mortgage or loan or shared ownership,199,188,169,8,161,19,0,11,8,0,0,2,1
S01011030,Rented or living rent free: Total,63,44,37,8,29,5,2,19,9,0,4,3,3
S01011030,Rented or living rent free: Social rented,45,31,26,7,19,5,0,14,9,0,1,3,1
S01011030,Rented or living rent free: Private rented or living rent free,18,13,11,1,10,0,2,5,0,0,3,0,2
S01011031,All HRPs aged 16 and over,320,193,170,43,127,13,10,127,99,3,11,11,3
S01011031,Owned: Total,145,95,84,17,67,7,4,50,45,1,1,2,1
S01011031,Owned: Owned outright,69,26,23,8,15,2,1,43,38,1,1,2,1
S01011031,Owned: Owned with a mortgage or loan or shared ownership,76,69,61,9,52,5,3,7,7,0,0,0,0
S01011031,Rented or living rent free: Total,175,98,86,26,60,6,6,77,54,2,10,9,2
S01011031,Rented or living rent free: Social rented,157,92,82,24,58,4,6,65,46,1,10,6,2
S01011031,Rented or living rent free: Private rented or living rent free,18,6,4,2,2,2,0,12,8,1,0,3,0
S01011032,All HRPs aged 16 and over,353,215,168,36,132,32,15,138,98,1,13,21,5
S01011032,Owned: Total,198,126,99,13,86,23,4,72,67,0,1,3,1
S01011032,Owned: Owned outright,91,29,19,7,12,10,0,62,59,0,0,2,1
S01011032,Owned: Owned with a mortgage or loan or shared ownership,107,97,80,6,74,13,4,10,8,0,1,1,0
S01011032,Rented or living rent free: Total,155,89,69,23,46,9,11,66,31,1,12,18,4
S01011032,Rented or living rent free: Social rented,114,65,49,17,32,6,10,49,23,1,8,14,3
S01011032,Rented or living rent free: Private rented or living rent free,41,24,20,6,14,3,1,17,8,0,4,4,1
S01011033,All HRPs aged 16 and over,275,203,178,22,156,23,2,72,63,0,2,7,0
S01011033,Owned: Total,199,160,140,15,125,19,1,39,38,0,0,1,0
S01011033,Owned: Owned outright,69,37,34,9,25,2,1,32,31,0,0,1,0
S01011033,Owned: Owned with a mortgage or loan or shared ownership,130,123,106,6,100,17,0,7,7,0,0,0,0
S01011033,Rented or living rent free: Total,76,43,38,7,31,4,1,33,25,0,2,6,0
S01011033,Rented or living rent free: Social rented,57,27,26,5,21,1,0,30,24,0,2,4,0
S01011033,Rented or living rent free: Private rented or living rent free,19,16,12,2,10,3,1,3,1,0,0,2,0
S01011034,All HRPs aged 16 and over,331,170,143,26,117,20,7,161,123,0,5,28,5
S01011034,Owned: Total,166,116,96,12,84,19,1,50,41,0,3,5,1
S01011034,Owned: Owned outright,59,21,18,3,15,3,0,38,32,0,3,2,1
S01011034,Owned: Owned with a mortgage or loan or shared ownership,107,95,78,9,69,16,1,12,9,0,0,3,0
S01011034,Rented or living rent free: Total,165,54,47,14,33,1,6,111,82,0,2,23,4
S01011034,Rented or living rent free: Social rented,136,35,29,5,24,1,5,101,75,0,2,22,2
S01011034,Rented or living rent free: Private rented or living rent free,29,19,18,9,9,0,1,10,7,0,0,1,2
S01011035,All HRPs aged 16 and over,252,177,144,29,115,23,10,75,44,1,8,16,6
S01011035,Owned: Total,117,98,81,6,75,16,1,19,16,0,1,1,1
S01011035,Owned: Owned outright,24,12,11,1,10,1,0,12,12,0,0,0,0
S01011035,Owned: Owned with a mortgage or loan or shared ownership,93,86,70,5,65,15,1,7,4,0,1,1,1
S01011035,Rented or living rent free: Total,135,79,63,23,40,7,9,56,28,1,7,15,5
S01011035,Rented or living rent free: Social rented,121,72,58,23,35,6,8,49,26,1,5,15,2
S01011035,Rented or living rent free: Private rented or living rent free,14,7,5,0,5,1,1,7,2,0,2,0,3
S01011036,All HRPs aged 16 and over,285,197,162,19,143,26,9,88,69,2,3,13,1
S01011036,Owned: Total,190,145,122,13,109,21,2,45,44,1,0,0,0
S01011036,Owned: Owned outright,71,29,24,7,17,4,1,42,42,0,0,0,0
S01011036,Owned: Owned with a mortgage or loan or shared ownership,119,116,98,6,92,17,1,3,2,1,0,0,0
S01011036,Rented or living rent free: Total,95,52,40,6,34,5,7,43,25,1,3,13,1
S01011036,Rented or living rent free: Social rented,64,34,25,5,20,4,5,30,17,0,3,10,0
S01011036,Rented or living rent free: Private rented or living rent free,31,18,15,1,14,1,2,13,8,1,0,3,1
S01011037,All HRPs aged 16 and over,409,276,224,50,174,28,24,133,84,0,21,19,9
S01011037,Owned: Total,192,142,117,16,101,24,1,50,42,0,2,4,2
S01011037,Owned: Owned outright,61,34,28,8,20,5,1,27,26,0,1,0,0
S01011037,Owned: Owned with a mortgage or loan or shared ownership,131,108,89,8,81,19,0,23,16,0,1,4,2
S01011037,Rented or living rent free: Total,217,134,107,34,73,4,23,83,42,0,19,15,7
S01011037,Rented or living rent free: Social rented,173,108,89,30,59,4,15,65,32,0,17,11,5
S01011037,Rented or living rent free: Private rented or living rent free,44,26,18,4,14,0,8,18,10,0,2,4,2
S01011038,All HRPs aged 16 and over,337,208,172,28,144,19,17,129,74,2,27,22,4
S01011038,Owned: Total,105,79,68,6,62,8,3,26,22,0,2,0,2
S01011038,Owned: Owned outright,44,22,19,3,16,2,1,22,20,0,1,0,1
S01011038,Owned: Owned with a mortgage or loan or shared ownership,61,57,49,3,46,6,2,4,2,0,1,0,1
S01011038,Rented or living rent free: Total,232,129,104,22,82,11,14,103,52,2,25,22,2
S01011038,Rented or living rent free: Social rented,218,124,102,21,81,10,12,94,46,2,22,22,2
S01011038,Rented or living rent free: Private rented or living rent free,14,5,2,1,1,1,2,9,6,0,3,0,0
S01011039,All HRPs aged 16 and over,392,248,208,30,178,29,11,144,114,0,6,19,5
S01011039,Owned: Total,203,158,136,8,128,22,0,45,37,0,4,2,2
S01011039,Owned: Owned outright,54,26,25,6,19,1,0,28,25,0,1,1,1
S01011039,Owned: Owned with a mortgage or loan or shared ownership,149,132,111,2,109,21,0,17,12,0,3,1,1
S01011039,Rented or living rent free: Total,189,90,72,22,50,7,11,99,77,0,2,17,3
S01011039,Rented or living rent free: Social rented,142,53,45,17,28,3,5,89,71,0,1,16,1
S01011039,Rented or living rent free: Private rented or living rent free,47,37,27,5,22,4,6,10,6,0,1,1,2
S01011040,All HRPs aged 16 and over,285,189,158,28,130,17,14,96,62,0,15,12,7
S01011040,Owned: Total,153,108,100,9,91,8,0,45,43,0,1,1,0
S01011040,Owned: Owned outright,71,34,32,7,25,2,0,37,35,0,1,1,0
S01011040,Owned: Owned with a mortgage or loan or shared ownership,82,74,68,2,66,6,0,8,8,0,0,0,0
S01011040,Rented or living rent free: Total,132,81,58,19,39,9,14,51,19,0,14,11,7
S01011040,Rented or living rent free: Social rented,115,72,53,18,35,7,12,43,16,0,14,8,5
S01011040,Rented or living rent free: Private rented or living rent free,17,9,5,1,4,2,2,8,3,0,0,3,2
S01011041,All HRPs aged 16 and over,292,172,136,35,101,19,17,120,76,3,17,19,5
S01011041,Owned: Total,109,65,52,3,49,11,2,44,40,0,1,3,0
S01011041,Owned: Owned outright,47,12,10,2,8,1,1,35,33,0,0,2,0
S01011041,Owned: Owned with a mortgage or loan or shared ownership,62,53,42,1,41,10,1,9,7,0,1,1,0
S01011041,Rented or living rent free: Total,183,107,84,32,52,8,15,76,36,3,16,16,5
S01011041,Rented or living rent free: Social rented,175,103,82,31,51,8,13,72,36,2,14,16,4
S01011041,Rented or living rent free: Private rented or living rent free,8,4,2,1,1,0,2,4,0,1,2,0,1
S01011042,All HRPs aged 16 and over,333,246,205,22,183,32,9,87,57,6,10,11,3
S01011042,Owned: Total,252,205,174,16,158,29,2,47,42,2,0,2,1
S01011042,Owned: Owned outright,66,31,27,11,16,4,0,35,32,1,0,2,0
S01011042,Owned: Owned with a mortgage or loan or shared ownership,186,174,147,5,142,25,2,12,10,1,0,0,1
S01011042,Rented or living rent free: Total,81,41,31,6,25,3,7,40,15,4,10,9,2
S01011042,Rented or living rent free: Social rented,48,18,15,4,11,0,3,30,10,3,8,7,2
S01011042,Rented or living rent free: Private rented or living rent free,33,23,16,2,14,3,4,10,5,1,2,2,0
S01011043,All HRPs aged 16 and over,310,195,158,25,133,16,21,115,80,2,8,18,7
S01011043,Owned: Total,180,120,105,14,91,14,1,60,53,0,0,4,3
S01011043,Owned: Owned outright,77,29,23,8,15,5,1,48,47,0,0,1,0
S01011043,Owned: Owned with a mortgage or loan or shared ownership,103,91,82,6,76,9,0,12,6,0,0,3,3
S01011043,Rented or living rent free: Total,130,75,53,11,42,2,20,55,27,2,8,14,4
S01011043,Rented or living rent free: Social rented,117,67,46,10,36,2,19,50,23,2,7,14,4
S01011043,Rented or living rent free: Private rented or living rent free,13,8,7,1,6,0,1,5,4,0,1,0,0
S01011044,All HRPs aged 16 and over,307,205,162,39,123,24,19,102,62,1,17,15,7
S01011044,Owned: Total,149,112,91,11,80,20,1,37,33,0,0,3,1
S01011044,Owned: Owned outright,49,20,17,5,12,3,0,29,28,0,0,1,0
S01011044,Owned: Owned with a mortgage or loan or shared ownership,100,92,74,6,68,17,1,8,5,0,0,2,1
S01011044,Rented or living rent free: Total,158,93,71,28,43,4,18,65,29,1,17,12,6
S01011044,Rented or living rent free: Social rented,134,80,63,27,36,4,13,54,25,1,12,11,5
S01011044,Rented or living rent free: Private rented or living rent free,24,13,8,1,7,0,5,11,4,0,5,1,1
S01011045,All HRPs aged 16 and over,369,253,166,36,130,70,17,116,98,1,5,5,7
S01011045,Owned: Total,203,135,89,16,73,41,5,68,63,1,1,1,2
S01011045,Owned: Owned outright,128,64,40,12,28,19,5,64,60,1,1,1,1
S01011045,Owned: Owned with a mortgage or loan or shared ownership,75,71,49,4,45,22,0,4,3,0,0,0,1
S01011045,Rented or living rent free: Total,166,118,77,20,57,29,12,48,35,0,4,4,5
S01011045,Rented or living rent free: Social rented,58,33,25,9,16,3,5,25,21,0,2,0,2
S01011045,Rented or living rent free: Private rented or living rent free,108,85,52,11,41,26,7,23,14,0,2,4,3
S01011046,All HRPs aged 16 and over,362,262,174,17,157,82,6,100,81,1,4,8,6
S01011046,Owned: Total,246,176,109,9,100,64,3,70,57,0,3,4,6
S01011046,Owned: Owned outright,148,82,47,4,43,33,2,66,55,0,3,3,5
S01011046,Owned: Owned with a mortgage or loan or shared ownership,98,94,62,5,57,31,1,4,2,0,0,1,1
S01011046,Rented or living rent free: Total,116,86,65,8,57,18,3,30,24,1,1,4,0
S01011046,Rented or living rent free: Social rented,19,11,9,0,9,1,1,8,5,0,0,3,0
S01011046,Rented or living rent free: Private rented or living rent free,97,75,56,8,48,17,2,22,19,1,1,1,0
S01011047,All HRPs aged 16 and over,396,269,203,23,180,61,5,127,115,0,5,5,2
S01011047,Owned: Total,297,197,148,15,133,45,4,100,95,0,3,2,0
S01011047,Owned: Owned outright,187,93,64,11,53,27,2,94,92,0,1,1,0
S01011047,Owned: Owned with a mortgage or loan or shared ownership,110,104,84,4,80,18,2,6,3,0,2,1,0
S01011047,Rented or living rent free: Total,99,72,55,8,47,16,1,27,20,0,2,3,2
S01011047,Rented or living rent free: Social rented,25,14,13,4,9,0,1,11,7,0,1,3,0
S01011047,Rented or living rent free: Private rented or living rent free,74,58,42,4,38,16,0,16,13,0,1,0,2
S01011048,All HRPs aged 16 and over,440,266,211,34,177,45,10,174,152,0,5,12,5
S01011048,Owned: Total,290,188,152,17,135,35,1,102,96,0,2,1,3
S01011048,Owned: Owned outright,161,64,48,9,39,16,0,97,92,0,2,1,2
S01011048,Owned: Owned with a mortgage or loan or shared ownership,129,124,104,8,96,19,1,5,4,0,0,0,1
S01011048,Rented or living rent free: Total,150,78,59,17,42,10,9,72,56,0,3,11,2
S01011048,Rented or living rent free: Social rented,109,52,40,11,29,5,7,57,43,0,3,9,2
S01011048,Rented or living rent free: Private rented or living rent free,41,26,19,6,13,5,2,15,13,0,0,2,0
S01011049,All HRPs aged 16 and over,322,209,179,33,146,27,3,113,106,0,3,4,0
S01011049,Owned: Total,226,156,131,21,110,22,3,70,67,0,0,3,0
S01011049,Owned: Owned outright,119,54,44,11,33,7,3,65,64,0,0,1,0
S01011049,Owned: Owned with a mortgage or loan or shared ownership,107,102,87,10,77,15,0,5,3,0,0,2,0
S01011049,Rented or living rent free: Total,96,53,48,12,36,5,0,43,39,0,3,1,0
S01011049,Rented or living rent free: Social rented,62,34,31,9,22,3,0,28,26,0,2,0,0
S01011049,Rented or living rent free: Private rented or living rent free,34,19,17,3,14,2,0,15,13,0,1,1,0
S01011050,All HRPs aged 16 and over,323,233,182,20,162,46,5,90,79,0,1,9,1
S01011050,Owned: Total,235,167,129,17,112,35,3,68,65,0,0,3,0
S01011050,Owned: Owned outright,123,61,40,11,29,20,1,62,60,0,0,2,0
S01011050,Owned: Owned with a mortgage or loan or shared ownership,112,106,89,6,83,15,2,6,5,0,0,1,0
S01011050,Rented or living rent free: Total,88,66,53,3,50,11,2,22,14,0,1,6,1
S01011050,Rented or living rent free: Social rented,18,9,9,2,7,0,0,9,3,0,0,6,0
S01011050,Rented or living rent free: Private rented or living rent free,70,57,44,1,43,11,2,13,11,0,1,0,1
S01011051,All HRPs aged 16 and over,428,275,217,40,177,56,2,153,144,2,1,3,3
S01011051,Owned: Total,286,194,151,26,125,43,0,92,88,1,1,2,0
S01011051,Owned: Owned outright,169,82,62,18,44,20,0,87,85,1,1,0,0
S01011051,Owned: Owned with a mortgage or loan or shared ownership,117,112,89,8,81,23,0,5,3,0,0,2,0
S01011051,Rented or living rent free: Total,142,81,66,14,52,13,2,61,56,1,0,1,3
S01011051,Rented or living rent free: Social rented,81,32,27,9,18,3,2,49,44,1,0,1,3
S01011051,Rented or living rent free: Private rented or living rent free,61,49,39,5,34,10,0,12,12,0,0,0,0
S01011052,All HRPs aged 16 and over,366,207,167,28,139,36,4,159,148,1,3,6,1
S01011052,Owned: Total,256,143,111,17,94,31,1,113,111,0,0,1,1
S01011052,Owned: Owned outright,175,65,45,11,34,19,1,110,109,0,0,1,0
S01011052,Owned: Owned with a mortgage or loan or shared ownership,81,78,66,6,60,12,0,3,2,0,0,0,1
S01011052,Rented or living rent free: Total,110,64,56,11,45,5,3,46,37,1,3,5,0
S01011052,Rented or living rent free: Social rented,55,27,23,8,15,1,3,28,23,1,1,3,0
S01011052,Rented or living rent free: Private rented or living rent free,55,37,33,3,30,4,0,18,14,0,2,2,0
S01011053,All HRPs aged 16 and over,295,197,170,30,140,19,8,98,76,3,5,12,2
S01011053,Owned: Total,177,124,107,18,89,16,1,53,47,2,2,2,0
S01011053,Owned: Owned outright,90,47,36,14,22,10,1,43,42,1,0,0,0
S01011053,Owned: Owned with a mortgage or loan or shared ownership,87,77,71,4,67,6,0,10,5,1,2,2,0
S01011053,Rented or living rent free: Total,118,73,63,12,51,3,7,45,29,1,3,10,2
S01011053,Rented or living rent free: Social rented,91,51,43,7,36,2,6,40,25,1,2,10,2
S01011053,Rented or living rent free: Private rented or living rent free,27,22,20,5,15,1,1,5,4,0,1,0,0
S01011054,All HRPs aged 16 and over,244,165,135,19,116,27,3,79,73,1,1,2,2
S01011054,Owned: Total,168,121,96,11,85,23,2,47,45,1,0,0,1
S01011054,Owned: Owned outright,88,44,28,5,23,16,0,44,42,1,0,0,1
S01011054,Owned: Owned with a mortgage or loan or shared ownership,80,77,68,6,62,7,2,3,3,0,0,0,0
S01011054,Rented or living rent free: Total,76,44,39,8,31,4,1,32,28,0,1,2,1
S01011054,Rented or living rent free: Social rented,49,23,20,4,16,2,1,26,23,0,1,1,1
S01011054,Rented or living rent free: Private rented or living rent free,27,21,19,4,15,2,0,6,5,0,0,1,0
S01011055,All HRPs aged 16 and over,228,169,122,10,112,43,4,59,51,0,3,4,1
S01011055,Owned: Total,134,99,70,3,67,27,2,35,34,0,0,0,1
S01011055,Owned: Owned outright,78,43,24,2,22,17,2,35,34,0,0,0,1
S01011055,Owned: Owned with a mortgage or loan or shared ownership,56,56,46,1,45,10,0,0,0,0,0,0,0
S01011055,Rented or living rent free: Total,94,70,52,7,45,16,2,24,17,0,3,4,0
S01011055,Rented or living rent free: Social rented,19,9,9,1,8,0,0,10,6,0,2,2,0
S01011055,Rented or living rent free: Private rented or living rent free,75,61,43,6,37,16,2,14,11,0,1,2,0
S01011056,All HRPs aged 16 and over,271,210,121,16,105,87,2,61,54,0,1,5,1
S01011056,Owned: Total,228,182,98,12,86,84,0,46,44,0,1,1,0
S01011056,Owned: Owned outright,150,107,44,10,34,63,0,43,42,0,1,0,0
S01011056,Owned: Owned with a mortgage or loan or shared ownership,78,75,54,2,52,21,0,3,2,0,0,1,0
S01011056,Rented or living rent free: Total,43,28,23,4,19,3,2,15,10,0,0,4,1
S01011056,Rented or living rent free: Social rented,13,7,6,3,3,1,0,6,4,0,0,1,1
S01011056,Rented or living rent free: Private rented or living rent free,30,21,17,1,16,2,2,9,6,0,0,3,0
S01011057,All HRPs aged 16 and over,238,169,121,15,106,47,1,69,60,0,0,4,5
S01011057,Owned: Total,188,132,92,8,84,39,1,56,50,0,0,2,4
S01011057,Owned: Owned outright,121,69,42,7,35,27,0,52,48,0,0,1,3
S01011057,Owned: Owned with a mortgage or loan or shared ownership,67,63,50,1,49,12,1,4,2,0,0,1,1
S01011057,Rented or living rent free: Total,50,37,29,7,22,8,0,13,10,0,0,2,1
S01011057,Rented or living rent free: Social rented,23,16,14,5,9,2,0,7,5,0,0,1,1
S01011057,Rented or living rent free: Private rented or living rent free,27,21,15,2,13,6,0,6,5,0,0,1,0
S01011058,All HRPs aged 16 and over,251,193,127,16,111,65,1,58,53,0,2,3,0
S01011058,Owned: Total,215,164,106,10,96,58,0,51,47,0,2,2,0
S01011058,Owned: Owned outright,133,87,50,7,43,37,0,46,44,0,1,1,0
S01011058,Owned: Owned with a mortgage or loan or shared ownership,82,77,56,3,53,21,0,5,3,0,1,1,0
S01011058,Rented or living rent free: Total,36,29,21,6,15,7,1,7,6,0,0,1,0
S01011058,Rented or living rent free: Social rented,5,4,4,2,2,0,0,1,1,0,0,0,0
S01011058,Rented or living rent free: Private rented or living rent free,31,25,17,4,13,7,1,6,5,0,0,1,0
S01011059,All HRPs aged 16 and over,248,192,129,24,105,57,6,56,50,0,0,4,2
S01011059,Owned: Total,188,144,88,17,71,53,3,44,42,0,0,1,1
S01011059,Owned: Owned outright,118,76,40,10,30,34,2,42,40,0,0,1,1
S01011059,Owned: Owned with a mortgage or loan or shared ownership,70,68,48,7,41,19,1,2,2,0,0,0,0
S01011059,Rented or living rent free: Total,60,48,41,7,34,4,3,12,8,0,0,3,1
S01011059,Rented or living rent free: Social rented,16,10,7,2,5,0,3,6,4,0,0,2,0
S01011059,Rented or living rent free: Private rented or living rent free,44,38,34,5,29,4,0,6,4,0,0,1,1
S01011060,All HRPs aged 16 and over,402,225,180,32,148,44,1,177,162,0,2,10,3
S01011060,Owned: Total,293,186,145,22,123,41,0,107,100,0,0,5,2
S01011060,Owned: Owned outright,189,87,61,17,44,26,0,102,96,0,0,4,2
S01011060,Owned: Owned with a mortgage or loan or shared ownership,104,99,84,5,79,15,0,5,4,0,0,1,0
S01011060,Rented or living rent free: Total,109,39,35,10,25,3,1,70,62,0,2,5,1
S01011060,Rented or living rent free: Social rented,75,18,16,6,10,1,1,57,51,0,2,4,0
S01011060,Rented or living rent free: Private rented or living rent free,34,21,19,4,15,2,0,13,11,0,0,1,1
S01011061,All HRPs aged 16 and over,404,263,224,49,175,25,14,141,115,0,5,16,5
S01011061,Owned: Total,202,145,125,16,109,18,2,57,55,0,0,2,0
S01011061,Owned: Owned outright,106,54,45,8,37,8,1,52,50,0,0,2,0
S01011061,Owned: Owned with a mortgage or loan or shared ownership,96,91,80,8,72,10,1,5,5,0,0,0,0
S01011061,Rented or living rent free: Total,202,118,99,33,66,7,12,84,60,0,5,14,5
S01011061,Rented or living rent free: Social rented,155,86,72,29,43,5,9,69,50,0,4,10,5
S01011061,Rented or living rent free: Private rented or living rent free,47,32,27,4,23,2,3,15,10,0,1,4,0
S01011062,All HRPs aged 16 and over,423,275,224,32,192,45,6,148,129,0,1,13,5
S01011062,Owned: Total,283,193,153,15,138,39,1,90,85,0,1,2,2
S01011062,Owned: Owned outright,164,79,62,10,52,16,1,85,81,0,1,1,2
S01011062,Owned: Owned with a mortgage or loan or shared ownership,119,114,91,5,86,23,0,5,4,0,0,1,0
S01011062,Rented or living rent free: Total,140,82,71,17,54,6,5,58,44,0,0,11,3
S01011062,Rented or living rent free: Social rented,76,35,30,9,21,2,3,41,32,0,0,8,1
S01011062,Rented or living rent free: Private rented or living rent free,64,47,41,8,33,4,2,17,12,0,0,3,2
S01011063,All HRPs aged 16 and over,472,273,233,58,175,24,16,199,169,0,4,21,5
S01011063,Owned: Total,256,154,138,20,118,16,0,102,99,0,0,2,1
S01011063,Owned: Owned outright,157,59,53,13,40,6,0,98,95,0,0,2,1
S01011063,Owned: Owned with a mortgage or loan or shared ownership,99,95,85,7,78,10,0,4,4,0,0,0,0
S01011063,Rented or living rent free: Total,216,119,95,38,57,8,16,97,70,0,4,19,4
S01011063,Rented or living rent free: Social rented,191,109,88,34,54,6,15,82,57,0,4,17,4
S01011063,Rented or living rent free: Private rented or living rent free,25,10,7,4,3,2,1,15,13,0,0,2,0
S01011064,All HRPs aged 16 and over,480,293,243,34,209,43,7,187,159,2,7,10,9
S01011064,Owned: Total,343,224,187,23,164,35,2,119,111,0,2,2,4
S01011064,Owned: Owned outright,211,98,81,18,63,16,1,113,106,0,1,2,4
S01011064,Owned: Owned with a mortgage or loan or shared ownership,132,126,106,5,101,19,1,6,5,0,1,0,0
S01011064,Rented or living rent free: Total,137,69,56,11,45,8,5,68,48,2,5,8,5
S01011064,Rented or living rent free: Social rented,85,35,31,8,23,1,3,50,34,1,5,5,5
S01011064,Rented or living rent free: Private rented or living rent free,52,34,25,3,22,7,2,18,14,1,0,3,0
S01011065,All HRPs aged 16 and over,289,190,138,26,112,47,5,99,83,0,7,5,4
S01011065,Owned: Total,186,120,87,13,74,33,0,66,61,0,0,3,2
S01011065,Owned: Owned outright,102,44,28,8,20,16,0,58,53,0,0,3,2
S01011065,Owned: Owned with a mortgage or loan or shared ownership,84,76,59,5,54,17,0,8,8,0,0,0,0
S01011065,Rented or living rent free: Total,103,70,51,13,38,14,5,33,22,0,7,2,2
S01011065,Rented or living rent free: Social rented,53,32,25,11,14,2,5,21,15,0,3,2,1
S01011065,Rented or living rent free: Private rented or living rent free,50,38,26,2,24,12,0,12,7,0,4,0,1
S01011066,All HRPs aged 16 and over,231,137,100,27,73,34,3,94,87,1,3,3,0
S01011066,Owned: Total,164,97,66,11,55,30,1,67,64,1,1,1,0
S01011066,Owned: Owned outright,111,50,33,7,26,16,1,61,60,0,1,0,0
S01011066,Owned: Owned with a mortgage or loan or shared ownership,53,47,33,4,29,14,0,6,4,1,0,1,0
S01011066,Rented or living rent free: Total,67,40,34,16,18,4,2,27,23,0,2,2,0
S01011066,Rented or living rent free: Social rented,45,23,17,9,8,4,2,22,19,0,1,2,0
S01011066,Rented or living rent free: Private rented or living rent free,22,17,17,7,10,0,0,5,4,0,1,0,0
S01011067,All HRPs aged 16 and over,284,150,110,19,91,33,7,134,127,0,2,1,4
S01011067,Owned: Total,207,115,87,10,77,25,3,92,90,0,1,0,1
S01011067,Owned: Owned outright,128,39,27,4,23,10,2,89,88,0,1,0,0
S01011067,Owned: Owned with a mortgage or loan or shared ownership,79,76,60,6,54,15,1,3,2,0,0,0,1
S01011067,Rented or living rent free: Total,77,35,23,9,14,8,4,42,37,0,1,1,3
S01011067,Rented or living rent free: Social rented,50,14,8,3,5,2,4,36,32,0,1,1,2
S01011067,Rented or living rent free: Private rented or living rent free,27,21,15,6,9,6,0,6,5,0,0,0,1
S01011068,All HRPs aged 16 and over,238,151,117,20,97,29,5,87,77,0,2,2,6
S01011068,Owned: Total,165,106,79,8,71,24,3,59,56,0,1,0,2
S01011068,Owned: Owned outright,84,32,24,5,19,6,2,52,52,0,0,0,0
S01011068,Owned: Owned with a mortgage or loan or shared ownership,81,74,55,3,52,18,1,7,4,0,1,0,2
S01011068,Rented or living rent free: Total,73,45,38,12,26,5,2,28,21,0,1,2,4
S01011068,Rented or living rent free: Social rented,54,33,29,7,22,2,2,21,16,0,1,1,3
S01011068,Rented or living rent free: Private rented or living rent free,19,12,9,5,4,3,0,7,5,0,0,1,1
S01011069,All HRPs aged 16 and over,251,144,115,24,91,25,4,107,90,1,7,8,1
S01011069,Owned: Total,169,103,83,15,68,20,0,66,60,1,1,3,1
S01011069,Owned: Owned outright,102,43,33,9,24,10,0,59,55,1,0,3,0
S01011069,Owned: Owned with a mortgage or loan or shared ownership,67,60,50,6,44,10,0,7,5,0,1,0,1
S01011069,Rented or living rent free: Total,82,41,32,9,23,5,4,41,30,0,6,5,0
S01011069,Rented or living rent free: Social rented,60,29,23,9,14,2,4,31,20,0,6,5,0
S01011069,Rented or living rent free: Private rented or living rent free,22,12,9,0,9,3,0,10,10,0,0,0,0
S01011070,All HRPs aged 16 and over,274,179,147,16,131,27,5,95,90,0,2,1,2
S01011070,Owned: Total,208,138,116,9,107,20,2,70,68,0,1,0,1
S01011070,Owned: Owned outright,111,44,34,4,30,8,2,67,65,0,1,0,1
S01011070,Owned: Owned with a mortgage or loan or shared ownership,97,94,82,5,77,12,0,3,3,0,0,0,0
S01011070,Rented or living rent free: Total,66,41,31,7,24,7,3,25,22,0,1,1,1
S01011070,Rented or living rent free: Social rented,41,25,21,5,16,2,2,16,14,0,1,0,1
S01011070,Rented or living rent free: Private rented or living rent free,25,16,10,2,8,5,1,9,8,0,0,1,0
S01011071,All HRPs aged 16 and over,357,212,166,24,142,42,4,145,131,1,6,6,1
S01011071,Owned: Total,294,183,145,18,127,37,1,111,106,1,2,2,0
S01011071,Owned: Owned outright,181,79,61,15,46,18,0,102,97,1,2,2,0
S01011071,Owned: Owned with a mortgage or loan or shared ownership,113,104,84,3,81,19,1,9,9,0,0,0,0
S01011071,Rented or living rent free: Total,63,29,21,6,15,5,3,34,25,0,4,4,1
S01011071,Rented or living rent free: Social rented,37,12,9,5,4,0,3,25,18,0,3,3,1
S01011071,Rented or living rent free: Private rented or living rent free,26,17,12,1,11,5,0,9,7,0,1,1,0
S01011072,All HRPs aged 16 and over,407,295,223,26,197,60,12,112,89,4,6,9,4
S01011072,Owned: Total,315,233,181,16,165,52,0,82,76,0,1,1,4
S01011072,Owned: Owned outright,162,87,63,9,54,24,0,75,70,0,1,0,4
S01011072,Owned: Owned with a mortgage or loan or shared ownership,153,146,118,7,111,28,0,7,6,0,0,1,0
S01011072,Rented or living rent free: Total,92,62,42,10,32,8,12,30,13,4,5,8,0
S01011072,Rented or living rent free: Social rented,63,42,30,10,20,1,11,21,6,2,5,8,0
S01011072,Rented or living rent free: Private rented or living rent free,29,20,12,0,12,7,1,9,7,2,0,0,0
S01011073,All HRPs aged 16 and over,286,191,158,27,131,30,3,95,82,0,5,5,3
S01011073,Owned: Total,245,165,137,24,113,28,0,80,73,0,2,2,3
S01011073,Owned: Owned outright,136,61,50,14,36,11,0,75,69,0,1,2,3
S01011073,Owned: Owned with a mortgage or loan or shared ownership,109,104,87,10,77,17,0,5,4,0,1,0,0
S01011073,Rented or living rent free: Total,41,26,21,3,18,2,3,15,9,0,3,3,0
S01011073,Rented or living rent free: Social rented,14,6,3,0,3,0,3,8,3,0,2,3,0
S01011073,Rented or living rent free: Private rented or living rent free,27,20,18,3,15,2,0,7,6,0,1,0,0
S01011074,All HRPs aged 16 and over,280,185,154,16,138,28,3,95,83,1,2,6,3
S01011074,Owned: Total,221,143,119,12,107,24,0,78,73,0,2,2,1
S01011074,Owned: Owned outright,111,41,33,5,28,8,0,70,67,0,2,1,0
S01011074,Owned: Owned with a mortgage or loan or shared ownership,110,102,86,7,79,16,0,8,6,0,0,1,1
S01011074,Rented or living rent free: Total,59,42,35,4,31,4,3,17,10,1,0,4,2
S01011074,Rented or living rent free: Social rented,41,25,20,2,18,3,2,16,10,1,0,4,1
S01011074,Rented or living rent free: Private rented or living rent free,18,17,15,2,13,1,1,1,0,0,0,0,1
S01011075,All HRPs aged 16 and over,322,204,167,27,140,23,14,118,96,0,9,9,4
S01011075,Owned: Total,162,105,95,10,85,9,1,57,56,0,1,0,0
S01011075,Owned: Owned outright,84,31,26,8,18,5,0,53,53,0,0,0,0
S01011075,Owned: Owned with a mortgage or loan or shared ownership,78,74,69,2,67,4,1,4,3,0,1,0,0
S01011075,Rented or living rent free: Total,160,99,72,17,55,14,13,61,40,0,8,9,4
S01011075,Rented or living rent free: Social rented,140,85,64,16,48,10,11,55,35,0,8,8,4
S01011075,Rented or living rent free: Private rented or living rent free,20,14,8,1,7,4,2,6,5,0,0,1,0
S01011076,All HRPs aged 16 and over,348,193,162,22,140,20,11,155,131,2,4,14,4
S01011076,Owned: Total,202,128,111,8,103,16,1,74,70,1,0,1,2
S01011076,Owned: Owned outright,116,51,43,5,38,8,0,65,64,0,0,0,1
S01011076,Owned: Owned with a mortgage or loan or shared ownership,86,77,68,3,65,8,1,9,6,1,0,1,1
S01011076,Rented or living rent free: Total,146,65,51,14,37,4,10,81,61,1,4,13,2
S01011076,Rented or living rent free: Social rented,125,50,36,11,25,4,10,75,58,1,3,12,1
S01011076,Rented or living rent free: Private rented or living rent free,21,15,15,3,12,0,0,6,3,0,1,1,1
S01011077,All HRPs aged 16 and over,337,210,181,60,121,10,19,127,97,4,6,16,4
S01011077,Owned: Total,111,69,64,11,53,5,0,42,39,1,0,2,0
S01011077,Owned: Owned outright,63,24,22,6,16,2,0,39,36,1,0,2,0
S01011077,Owned: Owned with a mortgage or loan or shared ownership,48,45,42,5,37,3,0,3,3,0,0,0,0
S01011077,Rented or living rent free: Total,226,141,117,49,68,5,19,85,58,3,6,14,4
S01011077,Rented or living rent free: Social rented,220,137,113,47,66,5,19,83,58,3,6,12,4
S01011077,Rented or living rent free: Private rented or living rent free,6,4,4,2,2,0,0,2,0,0,0,2,0
S01011078,All HRPs aged 16 and over,466,306,243,39,204,55,8,160,146,1,3,6,4
S01011078,Owned: Total,379,236,189,27,162,46,1,143,138,0,3,0,2
S01011078,Owned: Owned outright,221,87,65,15,50,21,1,134,131,0,1,0,2
S01011078,Owned: Owned with a mortgage or loan or shared ownership,158,149,124,12,112,25,0,9,7,0,2,0,0
S01011078,Rented or living rent free: Total,87,70,54,12,42,9,7,17,8,1,0,6,2
S01011078,Rented or living rent free: Social rented,52,39,30,8,22,4,5,13,5,1,0,5,2
S01011078,Rented or living rent free: Private rented or living rent free,35,31,24,4,20,5,2,4,3,0,0,1,0
S01011079,All HRPs aged 16 and over,488,333,278,34,244,41,14,155,138,0,3,7,7
S01011079,Owned: Total,391,258,222,20,202,31,5,133,124,0,2,2,5
S01011079,Owned: Owned outright,200,75,60,15,45,14,1,125,118,0,1,1,5
S01011079,Owned: Owned with a mortgage or loan or shared ownership,191,183,162,5,157,17,4,8,6,0,1,1,0
S01011079,Rented or living rent free: Total,97,75,56,14,42,10,9,22,14,0,1,5,2
S01011079,Rented or living rent free: Social rented,24,16,11,1,10,2,3,8,4,0,0,3,1
S01011079,Rented or living rent free: Private rented or living rent free,73,59,45,13,32,8,6,14,10,0,1,2,1
S01011080,All HRPs aged 16 and over,461,285,244,34,210,25,16,176,146,1,9,13,7
S01011080,Owned: Total,325,215,188,22,166,23,4,110,106,1,1,1,1
S01011080,Owned: Owned outright,189,86,71,17,54,11,4,103,101,0,1,0,1
S01011080,Owned: Owned with a mortgage or loan or shared ownership,136,129,117,5,112,12,0,7,5,1,0,1,0
S01011080,Rented or living rent free: Total,136,70,56,12,44,2,12,66,40,0,8,12,6
S01011080,Rented or living rent free: Social rented,90,41,29,8,21,1,11,49,28,0,7,10,4
S01011080,Rented or living rent free: Private rented or living rent free,46,29,27,4,23,1,1,17,12,0,1,2,2
S01011081,All HRPs aged 16 and over,352,230,197,31,166,24,9,122,98,2,5,14,3
S01011081,Owned: Total,238,162,143,14,129,18,1,76,71,1,2,1,1
S01011081,Owned: Owned outright,131,57,44,8,36,12,1,74,70,0,2,1,1
S01011081,Owned: Owned with a mortgage or loan or shared ownership,107,105,99,6,93,6,0,2,1,1,0,0,0
S01011081,Rented or living rent free: Total,114,68,54,17,37,6,8,46,27,1,3,13,2
S01011081,Rented or living rent free: Social rented,101,58,45,15,30,6,7,43,25,1,2,13,2
S01011081,Rented or living rent free: Private rented or living rent free,13,10,9,2,7,0,1,3,2,0,1,0,0
S01011082,All HRPs aged 16 and over,269,118,106,18,88,8,4,151,131,0,2,16,2
S01011082,Owned: Total,114,74,67,9,58,5,2,40,39,0,0,1,0
S01011082,Owned: Owned outright,55,19,18,4,14,0,1,36,36,0,0,0,0
S01011082,Owned: Owned with a mortgage or loan or shared ownership,59,55,49,5,44,5,1,4,3,0,0,1,0
S01011082,Rented or living rent free: Total,155,44,39,9,30,3,2,111,92,0,2,15,2
S01011082,Rented or living rent free: Social rented,142,39,34,9,25,3,2,103,86,0,2,13,2
S01011082,Rented or living rent free: Private rented or living rent free,13,5,5,0,5,0,0,8,6,0,0,2,0
S01011083,All HRPs aged 16 and over,347,221,183,33,150,28,10,126,110,2,4,4,6
S01011083,Owned: Total,257,175,147,25,122,22,6,82,77,1,2,0,2
S01011083,Owned: Owned outright,128,57,47,11,36,7,3,71,69,0,0,0,2
S01011083,Owned: Owned with a mortgage or loan or shared ownership,129,118,100,14,86,15,3,11,8,1,2,0,0
S01011083,Rented or living rent free: Total,90,46,36,8,28,6,4,44,33,1,2,4,4
S01011083,Rented or living rent free: Social rented,64,24,21,6,15,2,1,40,30,1,2,4,3
S01011083,Rented or living rent free: Private rented or living rent free,26,22,15,2,13,4,3,4,3,0,0,0,1
S01011084,All HRPs aged 16 and over,330,207,155,21,134,49,3,123,117,0,0,1,5
S01011084,Owned: Total,269,166,130,16,114,35,1,103,101,0,0,0,2
S01011084,Owned: Owned outright,156,58,41,12,29,17,0,98,96,0,0,0,2
S01011084,Owned: Owned with a mortgage or loan or shared ownership,113,108,89,4,85,18,1,5,5,0,0,0,0
S01011084,Rented or living rent free: Total,61,41,25,5,20,14,2,20,16,0,0,1,3
S01011084,Rented or living rent free: Social rented,22,10,8,5,3,2,0,12,11,0,0,1,0
S01011084,Rented or living rent free: Private rented or living rent free,39,31,17,0,17,12,2,8,5,0,0,0,3
S01011085,All HRPs aged 16 and over,383,251,216,32,184,35,0,132,123,1,2,5,1
S01011085,Owned: Total,310,208,179,25,154,29,0,102,98,1,0,2,1
S01011085,Owned: Owned outright,186,89,76,19,57,13,0,97,94,0,0,2,1
S01011085,Owned: Owned with a mortgage or loan or shared ownership,124,119,103,6,97,16,0,5,4,1,0,0,0
S01011085,Rented or living rent free: Total,73,43,37,7,30,6,0,30,25,0,2,3,0
S01011085,Rented or living rent free: Social rented,35,14,13,4,9,1,0,21,16,0,2,3,0
S01011085,Rented or living rent free: Private rented or living rent free,38,29,24,3,21,5,0,9,9,0,0,0,0
S01011086,All HRPs aged 16 and over,273,166,134,13,121,29,3,107,98,1,1,6,1
S01011086,Owned: Total,212,128,109,11,98,18,1,84,84,0,0,0,0
S01011086,Owned: Owned outright,141,60,44,5,39,15,1,81,81,0,0,0,0
S01011086,Owned: Owned with a mortgage or loan or shared ownership,71,68,65,6,59,3,0,3,3,0,0,0,0
S01011086,Rented or living rent free: Total,61,38,25,2,23,11,2,23,14,1,1,6,1
S01011086,Rented or living rent free: Social rented,27,12,9,2,7,2,1,15,9,0,1,5,0
S01011086,Rented or living rent free: Private rented or living rent free,34,26,16,0,16,9,1,8,5,1,0,1,1
S01011087,All HRPs aged 16 and over,262,170,140,12,128,22,8,92,77,1,3,8,3
S01011087,Owned: Total,185,124,107,7,100,15,2,61,55,0,3,2,1
S01011087,Owned: Owned outright,87,30,20,5,15,10,0,57,51,0,3,2,1
S01011087,Owned: Owned with a mortgage or loan or shared ownership,98,94,87,2,85,5,2,4,4,0,0,0,0
S01011087,Rented or living rent free: Total,77,46,33,5,28,7,6,31,22,1,0,6,2
S01011087,Rented or living rent free: Social rented,61,32,23,5,18,5,4,29,21,1,0,5,2
S01011087,Rented or living rent free: Private rented or living rent free,16,14,10,0,10,2,2,2,1,0,0,1,0
S01011088,All HRPs aged 16 and over,453,277,237,34,203,35,5,176,152,5,1,14,4
S01011088,Owned: Total,323,216,188,25,163,26,2,107,97,2,1,5,2
S01011088,Owned: Owned outright,178,78,67,10,57,11,0,100,92,2,1,4,1
S01011088,Owned: Owned with a mortgage or loan or shared ownership,145,138,121,15,106,15,2,7,5,0,0,1,1
S01011088,Rented or living rent free: Total,130,61,49,9,40,9,3,69,55,3,0,9,2
S01011088,Rented or living rent free: Social rented,68,17,13,5,8,3,1,51,45,1,0,4,1
S01011088,Rented or living rent free: Private rented or living rent free,62,44,36,4,32,6,2,18,10,2,0,5,1
S01011089,All HRPs aged 16 and over,310,189,154,33,121,21,14,121,107,0,6,6,2
S01011089,Owned: Total,164,102,84,14,70,16,2,62,60,0,1,1,0
S01011089,Owned: Owned outright,96,38,28,10,18,10,0,58,56,0,1,1,0
S01011089,Owned: Owned with a mortgage or loan or shared ownership,68,64,56,4,52,6,2,4,4,0,0,0,0
S01011089,Rented or living rent free: Total,146,87,70,19,51,5,12,59,47,0,5,5,2
S01011089,Rented or living rent free: Social rented,126,73,56,18,38,5,12,53,42,0,5,4,2
S01011089,Rented or living rent free: Private rented or living rent free,20,14,14,1,13,0,0,6,5,0,0,1,0
S01011090,All HRPs aged 16 and over,304,210,147,18,129,58,5,94,84,0,5,2,3
S01011090,Owned: Total,242,156,112,14,98,40,4,86,76,0,5,2,3
S01011090,Owned: Owned outright,145,65,39,10,29,23,3,80,72,0,4,2,2
S01011090,Owned: Owned with a mortgage or loan or shared ownership,97,91,73,4,69,17,1,6,4,0,1,0,1
S01011090,Rented or living rent free: Total,62,54,35,4,31,18,1,8,8,0,0,0,0
S01011090,Rented or living rent free: Social rented,4,4,3,2,1,1,0,0,0,0,0,0,0
S01011090,Rented or living rent free: Private rented or living rent free,58,50,32,2,30,17,1,8,8,0,0,0,0
S01011091,All HRPs aged 16 and over,260,206,147,14,133,55,4,54,53,0,1,0,0
S01011091,Owned: Total,202,154,111,10,101,41,2,48,47,0,1,0,0
S01011091,Owned: Owned outright,108,63,42,7,35,19,2,45,44,0,1,0,0
S01011091,Owned: Owned with a mortgage or loan or shared ownership,94,91,69,3,66,22,0,3,3,0,0,0,0
S01011091,Rented or living rent free: Total,58,52,36,4,32,14,2,6,6,0,0,0,0
S01011091,Rented or living rent free: Social rented,4,3,2,1,1,1,0,1,1,0,0,0,0
S01011091,Rented or living rent free: Private rented or living rent free,54,49,34,3,31,13,2,5,5,0,0,0,0
S01011092,All HRPs aged 16 and over,181,131,105,26,79,13,13,50,15,4,8,20,3
S01011092,Owned: Total,57,47,41,5,36,6,0,10,9,0,0,1,0
S01011092,Owned: Owned outright,15,5,2,0,2,3,0,10,9,0,0,1,0
S01011092,Owned: Owned with a mortgage or loan or shared ownership,42,42,39,5,34,3,0,0,0,0,0,0,0
S01011092,Rented or living rent free: Total,124,84,64,21,43,7,13,40,6,4,8,19,3
S01011092,Rented or living rent free: Social rented,106,69,51,18,33,6,12,37,4,4,8,19,2
S01011092,Rented or living rent free: Private rented or living rent free,18,15,13,3,10,1,1,3,2,0,0,0,1
S01011093,All HRPs aged 16 and over,239,179,130,17,113,48,1,60,56,0,1,3,0
S01011093,Owned: Total,213,158,114,11,103,44,0,55,53,0,1,1,0
S01011093,Owned: Owned outright,92,46,26,3,23,20,0,46,45,0,1,0,0
S01011093,Owned: Owned with a mortgage or loan or shared ownership,121,112,88,8,80,24,0,9,8,0,0,1,0
S01011093,Rented or living rent free: Total,26,21,16,6,10,4,1,5,3,0,0,2,0
S01011093,Rented or living rent free: Social rented,5,2,1,0,1,1,0,3,1,0,0,2,0
S01011093,Rented or living rent free: Private rented or living rent free,21,19,15,6,9,3,1,2,2,0,0,0,0
S01011094,All HRPs aged 16 and over,196,159,114,16,98,45,0,37,33,1,0,2,1
S01011094,Owned: Total,150,127,89,13,76,38,0,23,22,0,0,1,0
S01011094,Owned: Owned outright,70,48,29,10,19,19,0,22,21,0,0,1,0
S01011094,Owned: Owned with a mortgage or loan or shared ownership,80,79,60,3,57,19,0,1,1,0,0,0,0
S01011094,Rented or living rent free: Total,46,32,25,3,22,7,0,14,11,1,0,1,1
S01011094,Rented or living rent free: Social rented,4,1,1,1,0,0,0,3,1,0,0,1,1
S01011094,Rented or living rent free: Private rented or living rent free,42,31,24,2,22,7,0,11,10,1,0,0,0
S01011095,All HRPs aged 16 and over,318,239,163,16,147,72,4,79,71,0,1,4,3
S01011095,Owned: Total,251,186,125,13,112,61,0,65,62,0,0,3,0
S01011095,Owned: Owned outright,147,88,49,7,42,39,0,59,57,0,0,2,0
S01011095,Owned: Owned with a mortgage or loan or shared ownership,104,98,76,6,70,22,0,6,5,0,0,1,0
S01011095,Rented or living rent free: Total,67,53,38,3,35,11,4,14,9,0,1,1,3
S01011095,Rented or living rent free: Social rented,8,3,2,0,2,0,1,5,2,0,1,1,1
S01011095,Rented or living rent free: Private rented or living rent free,59,50,36,3,33,11,3,9,7,0,0,0,2
S01011096,All HRPs aged 16 and over,223,181,147,16,131,30,4,42,35,1,1,2,3
S01011096,Owned: Total,149,119,98,9,89,21,0,30,27,1,0,1,1
S01011096,Owned: Owned outright,54,30,22,4,18,8,0,24,22,1,0,1,0
S01011096,Owned: Owned with a mortgage or loan or shared ownership,95,89,76,5,71,13,0,6,5,0,0,0,1
S01011096,Rented or living rent free: Total,74,62,49,7,42,9,4,12,8,0,1,1,2
S01011096,Rented or living rent free: Social rented,7,5,5,1,4,0,0,2,1,0,0,0,1
S01011096,Rented or living rent free: Private rented or living rent free,67,57,44,6,38,9,4,10,7,0,1,1,1
S01011097,All HRPs aged 16 and over,284,211,157,14,143,50,4,73,65,0,2,5,1
S01011097,Owned: Total,213,156,119,7,112,36,1,57,54,0,1,2,0
S01011097,Owned: Owned outright,108,55,35,4,31,19,1,53,50,0,1,2,0
S01011097,Owned: Owned with a mortgage or loan or shared ownership,105,101,84,3,81,17,0,4,4,0,0,0,0
S01011097,Rented or living rent free: Total,71,55,38,7,31,14,3,16,11,0,1,3,1
S01011097,Rented or living rent free: Social rented,10,4,4,1,3,0,0,6,5,0,1,0,0
S01011097,Rented or living rent free: Private rented or living rent free,61,51,34,6,28,14,3,10,6,0,0,3,1
S01011098,All HRPs aged 16 and over,346,235,202,24,178,27,6,111,96,0,1,13,1
S01011098,Owned: Total,253,174,150,11,139,21,3,79,75,0,0,4,0
S01011098,Owned: Owned outright,119,50,41,7,34,8,1,69,67,0,0,2,0
S01011098,Owned: Owned with a mortgage or loan or shared ownership,134,124,109,4,105,13,2,10,8,0,0,2,0
S01011098,Rented or living rent free: Total,93,61,52,13,39,6,3,32,21,0,1,9,1
S01011098,Rented or living rent free: Social rented,48,27,21,11,10,4,2,21,14,0,0,6,1
S01011098,Rented or living rent free: Private rented or living rent free,45,34,31,2,29,2,1,11,7,0,1,3,0
S01011099,All HRPs aged 16 and over,358,265,223,50,173,19,23,93,51,10,10,15,7
S01011099,Owned: Total,149,121,100,14,86,18,3,28,23,2,0,2,1
S01011099,Owned: Owned outright,61,40,35,9,26,4,1,21,19,0,0,1,1
S01011099,Owned: Owned with a mortgage or loan or shared ownership,88,81,65,5,60,14,2,7,4,2,0,1,0
S01011099,Rented or living rent free: Total,209,144,123,36,87,1,20,65,28,8,10,13,6
S01011099,Rented or living rent free: Social rented,186,126,107,31,76,0,19,60,27,7,10,12,4
S01011099,Rented or living rent free: Private rented or living rent free,23,18,16,5,11,1,1,5,1,1,0,1,2
S01011100,All HRPs aged 16 and over,210,121,102,12,90,15,4,89,81,0,0,7,1
S01011100,Owned: Total,153,93,79,9,70,13,1,60,57,0,0,2,1
S01011100,Owned: Owned outright,93,36,28,5,23,7,1,57,55,0,0,1,1
S01011100,Owned: Owned with a mortgage or loan or shared ownership,60,57,51,4,47,6,0,3,2,0,0,1,0
S01011100,Rented or living rent free: Total,57,28,23,3,20,2,3,29,24,0,0,5,0
S01011100,Rented or living rent free: Social rented,45,17,14,3,11,1,2,28,23,0,0,5,0
S01011100,Rented or living rent free: Private rented or living rent free,12,11,9,0,9,1,1,1,1,0,0,0,0
S01011101,All HRPs aged 16 and over,247,162,145,36,109,7,10,85,57,2,8,14,4
S01011101,Owned: Total,114,78,72,9,63,6,0,36,34,0,0,2,0
S01011101,Owned: Owned outright,51,20,19,6,13,1,0,31,30,0,0,1,0
S01011101,Owned: Owned with a mortgage or loan or shared ownership,63,58,53,3,50,5,0,5,4,0,0,1,0
S01011101,Rented or living rent free: Total,133,84,73,27,46,1,10,49,23,2,8,12,4
S01011101,Rented or living rent free: Social rented,120,73,64,27,37,0,9,47,21,2,8,12,4
S01011101,Rented or living rent free: Private rented or living rent free,13,11,9,0,9,1,1,2,2,0,0,0,0
S01011102,All HRPs aged 16 and over,330,208,180,38,142,12,16,122,72,2,11,28,9
S01011102,Owned: Total,121,76,68,10,58,7,1,45,40,0,0,5,0
S01011102,Owned: Owned outright,60,17,14,4,10,3,0,43,39,0,0,4,0
S01011102,Owned: Owned with a mortgage or loan or shared ownership,61,59,54,6,48,4,1,2,1,0,0,1,0
S01011102,Rented or living rent free: Total,209,132,112,28,84,5,15,77,32,2,11,23,9
S01011102,Rented or living rent free: Social rented,156,82,70,23,47,2,10,74,32,1,11,21,9
S01011102,Rented or living rent free: Private rented or living rent free,53,50,42,5,37,3,5,3,0,1,0,2,0
S01011103,All HRPs aged 16 and over,312,179,150,29,121,14,15,133,101,2,3,15,12
S01011103,Owned: Total,120,73,65,6,59,7,1,47,45,0,0,1,1
S01011103,Owned: Owned outright,60,16,14,2,12,2,0,44,42,0,0,1,1
S01011103,Owned: Owned with a mortgage or loan or shared ownership,60,57,51,4,47,5,1,3,3,0,0,0,0
S01011103,Rented or living rent free: Total,192,106,85,23,62,7,14,86,56,2,3,14,11
S01011103,Rented or living rent free: Social rented,112,40,29,14,15,3,8,72,49,1,2,13,7
S01011103,Rented or living rent free: Private rented or living rent free,80,66,56,9,47,4,6,14,7,1,1,1,4
S01011104,All HRPs aged 16 and over,294,165,133,17,116,25,7,129,105,1,2,18,3
S01011104,Owned: Total,186,113,89,11,78,23,1,73,70,0,0,2,1
S01011104,Owned: Owned outright,100,34,21,4,17,13,0,66,65,0,0,1,0
S01011104,Owned: Owned with a mortgage or loan or shared ownership,86,79,68,7,61,10,1,7,5,0,0,1,1
S01011104,Rented or living rent free: Total,108,52,44,6,38,2,6,56,35,1,2,16,2
S01011104,Rented or living rent free: Social rented,66,20,13,4,9,2,5,46,26,1,2,15,2
S01011104,Rented or living rent free: Private rented or living rent free,42,32,31,2,29,0,1,10,9,0,0,1,0
S01011105,All HRPs aged 16 and over,405,262,222,37,185,27,13,143,119,1,4,15,4
S01011105,Owned: Total,228,140,123,11,112,15,2,88,85,0,0,1,2
S01011105,Owned: Owned outright,126,42,33,7,26,8,1,84,83,0,0,1,0
S01011105,Owned: Owned with a mortgage or loan or shared ownership,102,98,90,4,86,7,1,4,2,0,0,0,2
S01011105,Rented or living rent free: Total,177,122,99,26,73,12,11,55,34,1,4,14,2
S01011105,Rented or living rent free: Social rented,98,49,36,13,23,6,7,49,31,1,4,12,1
S01011105,Rented or living rent free: Private rented or living rent free,79,73,63,13,50,6,4,6,3,0,0,2,1
S01011106,All HRPs aged 16 and over,352,300,272,33,239,13,15,52,27,2,10,4,9
S01011106,Owned: Total,95,73,67,6,61,6,0,22,20,0,1,1,0
S01011106,Owned: Owned outright,33,15,14,5,9,1,0,18,18,0,0,0,0
S01011106,Owned: Owned with a mortgage or loan or shared ownership,62,58,53,1,52,5,0,4,2,0,1,1,0
S01011106,Rented or living rent free: Total,257,227,205,27,178,7,15,30,7,2,9,3,9
S01011106,Rented or living rent free: Social rented,133,103,83,25,58,5,15,30,7,2,9,3,9
S01011106,Rented or living rent free: Private rented or living rent free,124,124,122,2,120,2,0,0,0,0,0,0,0
S01011107,All HRPs aged 16 and over,324,293,265,36,229,19,9,31,13,3,6,8,1
S01011107,Owned: Total,170,158,143,9,134,15,0,12,9,0,2,1,0
S01011107,Owned: Owned outright,23,14,13,6,7,1,0,9,9,0,0,0,0
S01011107,Owned: Owned with a mortgage or loan or shared ownership,147,144,130,3,127,14,0,3,0,0,2,1,0
S01011107,Rented or living rent free: Total,154,135,122,27,95,4,9,19,4,3,4,7,1
S01011107,Rented or living rent free: Social rented,82,65,57,16,41,1,7,17,2,3,4,7,1
S01011107,Rented or living rent free: Private rented or living rent free,72,70,65,11,54,3,2,2,2,0,0,0,0
S01011108,All HRPs aged 16 and over,216,161,141,21,120,18,2,55,44,2,1,6,2
S01011108,Owned: Total,132,110,101,8,93,9,0,22,19,1,1,1,0
S01011108,Owned: Owned outright,38,22,19,2,17,3,0,16,15,0,0,1,0
S01011108,Owned: Owned with a mortgage or loan or shared ownership,94,88,82,6,76,6,0,6,4,1,1,0,0
S01011108,Rented or living rent free: Total,84,51,40,13,27,9,2,33,25,1,0,5,2
S01011108,Rented or living rent free: Social rented,69,37,28,9,19,7,2,32,24,1,0,5,2
S01011108,Rented or living rent free: Private rented or living rent free,15,14,12,4,8,2,0,1,1,0,0,0,0
S01011109,All HRPs aged 16 and over,389,262,226,33,193,30,6,127,117,1,4,4,1
S01011109,Owned: Total,305,208,177,18,159,29,2,97,94,1,1,1,0
S01011109,Owned: Owned outright,147,61,49,11,38,11,1,86,85,1,0,0,0
S01011109,Owned: Owned with a mortgage or loan or shared ownership,158,147,128,7,121,18,1,11,9,0,1,1,0
S01011109,Rented or living rent free: Total,84,54,49,15,34,1,4,30,23,0,3,3,1
S01011109,Rented or living rent free: Social rented,41,21,17,10,7,1,3,20,16,0,0,3,1
S01011109,Rented or living rent free: Private rented or living rent free,43,33,32,5,27,0,1,10,7,0,3,0,0
S01011110,All HRPs aged 16 and over,314,234,209,42,167,9,16,80,55,2,6,9,8
S01011110,Owned: Total,184,147,135,20,115,8,4,37,35,0,0,0,2
S01011110,Owned: Owned outright,74,42,37,14,23,2,3,32,31,0,0,0,1
S01011110,Owned: Owned with a mortgage or loan or shared ownership,110,105,98,6,92,6,1,5,4,0,0,0,1
S01011110,Rented or living rent free: Total,130,87,74,22,52,1,12,43,20,2,6,9,6
S01011110,Rented or living rent free: Social rented,107,70,57,21,36,1,12,37,18,0,6,9,4
S01011110,Rented or living rent free: Private rented or living rent free,23,17,17,1,16,0,0,6,2,2,0,0,2
S01011111,All HRPs aged 16 and over,407,269,235,49,186,22,12,138,82,2,10,37,7
S01011111,Owned: Total,206,152,135,18,117,15,2,54,45,2,0,7,0
S01011111,Owned: Owned outright,88,41,36,5,31,5,0,47,40,2,0,5,0
S01011111,Owned: Owned with a mortgage or loan or shared ownership,118,111,99,13,86,10,2,7,5,0,0,2,0
S01011111,Rented or living rent free: Total,201,117,100,31,69,7,10,84,37,0,10,30,7
S01011111,Rented or living rent free: Social rented,172,94,79,31,48,5,10,78,33,0,10,29,6
S01011111,Rented or living rent free: Private rented or living rent free,29,23,21,0,21,2,0,6,4,0,0,1,1
S01011112,All HRPs aged 16 and over,328,283,252,28,224,25,6,45,34,0,4,5,2
S01011112,Owned: Total,261,229,207,23,184,19,3,32,29,0,2,0,1
S01011112,Owned: Owned outright,68,39,35,9,26,4,0,29,27,0,1,0,1
S01011112,Owned: Owned with a mortgage or loan or shared ownership,193,190,172,14,158,15,3,3,2,0,1,0,0
S01011112,Rented or living rent free: Total,67,54,45,5,40,6,3,13,5,0,2,5,1
S01011112,Rented or living rent free: Social rented,25,14,10,4,6,2,2,11,4,0,2,5,0
S01011112,Rented or living rent free: Private rented or living rent free,42,40,35,1,34,4,1,2,1,0,0,0,1
S01011113,All HRPs aged 16 and over,446,272,239,43,196,28,5,174,162,0,0,10,2
S01011113,Owned: Total,319,202,176,24,152,25,1,117,116,0,0,1,0
S01011113,Owned: Owned outright,180,71,64,15,49,6,1,109,109,0,0,0,0
S01011113,Owned: Owned with a mortgage or loan or shared ownership,139,131,112,9,103,19,0,8,7,0,0,1,0
S01011113,Rented or living rent free: Total,127,70,63,19,44,3,4,57,46,0,0,9,2
S01011113,Rented or living rent free: Social rented,93,45,40,12,28,2,3,48,37,0,0,9,2
S01011113,Rented or living rent free: Private rented or living rent free,34,25,23,7,16,1,1,9,9,0,0,0,0
S01011114,All HRPs aged 16 and over,296,214,182,20,162,28,4,82,73,0,1,8,0
S01011114,Owned: Total,254,184,158,11,147,26,0,70,65,0,0,5,0
S01011114,Owned: Owned outright,125,64,55,9,46,9,0,61,56,0,0,5,0
S01011114,Owned: Owned with a mortgage or loan or shared ownership,129,120,103,2,101,17,0,9,9,0,0,0,0
S01011114,Rented or living rent free: Total,42,30,24,9,15,2,4,12,8,0,1,3,0
S01011114,Rented or living rent free: Social rented,30,18,13,7,6,1,4,12,8,0,1,3,0
S01011114,Rented or living rent free: Private rented or living rent free,12,12,11,2,9,1,0,0,0,0,0,0,0
S01011115,All HRPs aged 16 and over,411,283,233,47,186,31,19,128,98,2,4,17,7
S01011115,Owned: Total,219,170,148,20,128,19,3,49,47,0,0,2,0
S01011115,Owned: Owned outright,94,50,42,11,31,7,1,44,43,0,0,1,0
S01011115,Owned: Owned with a mortgage or loan or shared ownership,125,120,106,9,97,12,2,5,4,0,0,1,0
S01011115,Rented or living rent free: Total,192,113,85,27,58,12,16,79,51,2,4,15,7
S01011115,Rented or living rent free: Social rented,166,89,65,24,41,11,13,77,49,2,4,15,7
S01011115,Rented or living rent free: Private rented or living rent free,26,24,20,3,17,1,3,2,2,0,0,0,0
S01011116,All HRPs aged 16 and over,269,190,173,22,151,12,5,79,64,3,4,6,2
S01011116,Owned: Total,204,150,137,19,118,11,2,54,51,0,2,0,1
S01011116,Owned: Owned outright,104,56,48,13,35,6,2,48,47,0,0,0,1
S01011116,Owned: Owned with a mortgage or loan or shared ownership,100,94,89,6,83,5,0,6,4,0,2,0,0
S01011116,Rented or living rent free: Total,65,40,36,3,33,1,3,25,13,3,2,6,1
S01011116,Rented or living rent free: Social rented,31,13,10,1,9,1,2,18,9,2,1,5,1
S01011116,Rented or living rent free: Private rented or living rent free,34,27,26,2,24,0,1,7,4,1,1,1,0
S01011117,All HRPs aged 16 and over,359,214,176,17,159,33,5,145,126,6,1,5,7
S01011117,Owned: Total,265,150,120,10,110,29,1,115,110,3,0,0,2
S01011117,Owned: Owned outright,157,58,44,8,36,14,0,99,96,1,0,0,2
S01011117,Owned: Owned with a mortgage or loan or shared ownership,108,92,76,2,74,15,1,16,14,2,0,0,0
S01011117,Rented or living rent free: Total,94,64,56,7,49,4,4,30,16,3,1,5,5
S01011117,Rented or living rent free: Social rented,11,4,1,0,1,1,2,7,4,0,0,3,0
S01011117,Rented or living rent free: Private rented or living rent free,83,60,55,7,48,3,2,23,12,3,1,2,5
S01011118,All HRPs aged 16 and over,399,250,206,29,177,40,4,149,145,1,0,2,1
S01011118,Owned: Total,293,192,155,19,136,35,2,101,100,0,0,1,0
S01011118,Owned: Owned outright,164,71,51,11,40,18,2,93,92,0,0,1,0
S01011118,Owned: Owned with a mortgage or loan or shared ownership,129,121,104,8,96,17,0,8,8,0,0,0,0
S01011118,Rented or living rent free: Total,106,58,51,10,41,5,2,48,45,1,0,1,1
S01011118,Rented or living rent free: Social rented,38,4,4,3,1,0,0,34,32,0,0,1,1
S01011118,Rented or living rent free: Private rented or living rent free,68,54,47,7,40,5,2,14,13,1,0,0,0
S01011119,All HRPs aged 16 and over,422,244,209,20,189,33,2,178,168,1,1,8,0
S01011119,Owned: Total,327,194,165,14,151,27,2,133,131,0,1,1,0
S01011119,Owned: Owned outright,188,63,48,8,40,13,2,125,123,0,1,1,0
S01011119,Owned: Owned with a mortgage or loan or shared ownership,139,131,117,6,111,14,0,8,8,0,0,0,0
S01011119,Rented or living rent free: Total,95,50,44,6,38,6,0,45,37,1,0,7,0
S01011119,Rented or living rent free: Social rented,38,5,5,1,4,0,0,33,27,0,0,6,0
S01011119,Rented or living rent free: Private rented or living rent free,57,45,39,5,34,6,0,12,10,1,0,1,0
S01011120,All HRPs aged 16 and over,293,160,132,12,120,26,2,133,129,0,1,3,0
S01011120,Owned: Total,280,150,125,12,113,24,1,130,126,0,1,3,0
S01011120,Owned: Owned outright,192,66,50,11,39,16,0,126,123,0,1,2,0
S01011120,Owned: Owned with a mortgage or loan or shared ownership,88,84,75,1,74,8,1,4,3,0,0,1,0
S01011120,Rented or living rent free: Total,13,10,7,0,7,2,1,3,3,0,0,0,0
S01011120,Rented or living rent free: Social rented,3,3,2,0,2,0,1,0,0,0,0,0,0
S01011120,Rented or living rent free: Private rented or living rent free,10,7,5,0,5,2,0,3,3,0,0,0,0
S01011121,All HRPs aged 16 and over,313,198,175,23,152,13,10,115,89,3,1,19,3
S01011121,Owned: Total,112,85,74,9,65,10,1,27,25,1,1,0,0
S01011121,Owned: Owned outright,46,23,20,3,17,3,0,23,22,0,1,0,0
S01011121,Owned: Owned with a mortgage or loan or shared ownership,66,62,54,6,48,7,1,4,3,1,0,0,0
S01011121,Rented or living rent free: Total,201,113,101,14,87,3,9,88,64,2,0,19,3
S01011121,Rented or living rent free: Social rented,102,23,19,4,15,0,4,79,61,0,0,16,2
S01011121,Rented or living rent free: Private rented or living rent free,99,90,82,10,72,3,5,9,3,2,0,3,1
S01011122,All HRPs aged 16 and over,302,203,177,29,148,23,3,99,83,0,3,10,3
S01011122,Owned: Total,203,136,118,15,103,17,1,67,63,0,1,3,0
S01011122,Owned: Owned outright,93,36,27,4,23,9,0,57,55,0,0,2,0
S01011122,Owned: Owned with a mortgage or loan or shared ownership,110,100,91,11,80,8,1,10,8,0,1,1,0
S01011122,Rented or living rent free: Total,99,67,59,14,45,6,2,32,20,0,2,7,3
S01011122,Rented or living rent free: Social rented,51,30,25,10,15,3,2,21,13,0,1,5,2
S01011122,Rented or living rent free: Private rented or living rent free,48,37,34,4,30,3,0,11,7,0,1,2,1
S01011123,All HRPs aged 16 and over,490,309,272,36,236,22,15,181,160,1,4,13,3
S01011123,Owned: Total,338,213,195,18,177,17,1,125,124,0,1,0,0
S01011123,Owned: Owned outright,164,50,41,6,35,8,1,114,113,0,1,0,0
S01011123,Owned: Owned with a mortgage or loan or shared ownership,174,163,154,12,142,9,0,11,11,0,0,0,0
S01011123,Rented or living rent free: Total,152,96,77,18,59,5,14,56,36,1,3,13,3
S01011123,Rented or living rent free: Social rented,118,74,56,16,40,4,14,44,31,1,2,9,1
S01011123,Rented or living rent free: Private rented or living rent free,34,22,21,2,19,1,0,12,5,0,1,4,2
S01011124,All HRPs aged 16 and over,277,197,174,24,150,21,2,80,63,3,5,8,1
S01011124,Owned: Total,182,140,122,14,108,17,1,42,40,1,1,0,0
S01011124,Owned: Owned outright,66,28,24,6,18,3,1,38,37,1,0,0,0
S01011124,Owned: Owned with a mortgage or loan or shared ownership,116,112,98,8,90,14,0,4,3,0,1,0,0
S01011124,Rented or living rent free: Total,95,57,52,10,42,4,1,38,23,2,4,8,1
S01011124,Rented or living rent free: Social rented,53,22,21,6,15,1,0,31,19,2,2,8,0
S01011124,Rented or living rent free: Private rented or living rent free,42,35,31,4,27,3,1,7,4,0,2,0,1
S01011125,All HRPs aged 16 and over,220,161,141,31,110,13,7,59,32,3,7,15,2
S01011125,Owned: Total,73,60,51,2,49,9,0,13,12,0,0,0,1
S01011125,Owned: Owned outright,21,15,12,2,10,3,0,6,6,0,0,0,0
S01011125,Owned: Owned with a mortgage or loan or shared ownership,52,45,39,0,39,6,0,7,6,0,0,0,1
S01011125,Rented or living rent free: Total,147,101,90,29,61,4,7,46,20,3,7,15,1
S01011125,Rented or living rent free: Social rented,125,83,74,28,46,2,7,42,19,3,7,13,0
S01011125,Rented or living rent free: Private rented or living rent free,22,18,16,1,15,2,0,4,1,0,0,2,1
S01011126,All HRPs aged 16 and over,184,130,116,9,107,11,3,54,47,1,1,3,2
S01011126,Owned: Total,78,58,48,4,44,10,0,20,18,0,0,1,1
S01011126,Owned: Owned outright,36,19,16,2,14,3,0,17,17,0,0,0,0
S01011126,Owned: Owned with a mortgage or loan or shared ownership,42,39,32,2,30,7,0,3,1,0,0,1,1
S01011126,Rented or living rent free: Total,106,72,68,5,63,1,3,34,29,1,1,2,1
S01011126,Rented or living rent free: Social rented,64,30,26,5,21,1,3,34,29,1,1,2,1
S01011126,Rented or living rent free: Private rented or living rent free,42,42,42,0,42,0,0,0,0,0,0,0,0
S01011127,All HRPs aged 16 and over,153,147,143,3,140,4,0,6,2,0,3,0,1
S01011127,Owned: Total,12,11,9,0,9,2,0,1,1,0,0,0,0
S01011127,Owned: Owned outright,1,0,0,0,0,0,0,1,1,0,0,0,0
S01011127,Owned: Owned with a mortgage or loan or shared ownership,11,11,9,0,9,2,0,0,0,0,0,0,0
S01011127,Rented or living rent free: Total,141,136,134,3,131,2,0,5,1,0,3,0,1
S01011127,Rented or living rent free: Social rented,17,16,15,1,14,1,0,1,0,0,1,0,0
S01011127,Rented or living rent free: Private rented or living rent free,124,120,119,2,117,1,0,4,1,0,2,0,1
S01011128,All HRPs aged 16 and over,341,234,200,34,166,22,12,107,79,2,3,18,5
S01011128,Owned: Total,208,150,130,16,114,17,3,58,53,1,0,4,0
S01011128,Owned: Owned outright,94,40,33,8,25,4,3,54,50,0,0,4,0
S01011128,Owned: Owned with a mortgage or loan or shared ownership,114,110,97,8,89,13,0,4,3,1,0,0,0
S01011128,Rented or living rent free: Total,133,84,70,18,52,5,9,49,26,1,3,14,5
S01011128,Rented or living rent free: Social rented,83,43,32,14,18,3,8,40,18,1,2,14,5
S01011128,Rented or living rent free: Private rented or living rent free,50,41,38,4,34,2,1,9,8,0,1,0,0
S01011129,All HRPs aged 16 and over,356,276,244,22,222,31,1,80,77,0,2,1,0
S01011129,Owned: Total,252,176,145,17,128,30,1,76,75,0,1,0,0
S01011129,Owned: Owned outright,123,51,38,10,28,12,1,72,71,0,1,0,0
S01011129,Owned: Owned with a mortgage or loan or shared ownership,129,125,107,7,100,18,0,4,4,0,0,0,0
S01011129,Rented or living rent free: Total,104,100,99,5,94,1,0,4,2,0,1,1,0
S01011129,Rented or living rent free: Social rented,14,10,10,1,9,0,0,4,2,0,1,1,0
S01011129,Rented or living rent free: Private rented or living rent free,90,90,89,4,85,1,0,0,0,0,0,0,0
S01011130,All HRPs aged 16 and over,296,173,148,18,130,14,11,123,98,2,2,15,6
S01011130,Owned: Total,172,103,92,10,82,11,0,69,67,1,0,1,0
S01011130,Owned: Owned outright,84,28,25,4,21,3,0,56,55,0,0,1,0
S01011130,Owned: Owned with a mortgage or loan or shared ownership,88,75,67,6,61,8,0,13,12,1,0,0,0
S01011130,Rented or living rent free: Total,124,70,56,8,48,3,11,54,31,1,2,14,6
S01011130,Rented or living rent free: Social rented,88,40,27,8,19,2,11,48,28,1,2,12,5
S01011130,Rented or living rent free: Private rented or living rent free,36,30,29,0,29,1,0,6,3,0,0,2,1
S01011131,All HRPs aged 16 and over,318,229,202,21,181,17,10,89,80,6,1,1,1
S01011131,Owned: Total,219,151,139,14,125,8,4,68,67,0,1,0,0
S01011131,Owned: Owned outright,103,41,37,9,28,2,2,62,61,0,1,0,0
S01011131,Owned: Owned with a mortgage or loan or shared ownership,116,110,102,5,97,6,2,6,6,0,0,0,0
S01011131,Rented or living rent free: Total,99,78,63,7,56,9,6,21,13,6,0,1,1
S01011131,Rented or living rent free: Social rented,13,7,7,1,6,0,0,6,5,0,0,1,0
S01011131,Rented or living rent free: Private rented or living rent free,86,71,56,6,50,9,6,15,8,6,0,0,1
S01011132,All HRPs aged 16 and over,374,257,218,20,198,35,4,117,107,0,5,4,1
S01011132,Owned: Total,311,211,179,15,164,30,2,100,92,0,4,3,1
S01011132,Owned: Owned outright,160,64,54,11,43,9,1,96,90,0,4,1,1
S01011132,Owned: Owned with a mortgage or loan or shared ownership,151,147,125,4,121,21,1,4,2,0,0,2,0
S01011132,Rented or living rent free: Total,63,46,39,5,34,5,2,17,15,0,1,1,0
S01011132,Rented or living rent free: Social rented,11,3,2,1,1,0,1,8,7,0,0,1,0
S01011132,Rented or living rent free: Private rented or living rent free,52,43,37,4,33,5,1,9,8,0,1,0,0
S01011133,All HRPs aged 16 and over,190,120,100,17,83,17,3,70,65,0,2,2,1
S01011133,Owned: Total,134,79,63,7,56,15,1,55,52,0,1,1,1
S01011133,Owned: Owned outright,65,16,11,2,9,4,1,49,46,0,1,1,1
S01011133,Owned: Owned with a mortgage or loan or shared ownership,69,63,52,5,47,11,0,6,6,0,0,0,0
S01011133,Rented or living rent free: Total,56,41,37,10,27,2,2,15,13,0,1,1,0
S01011133,Rented or living rent free: Social rented,39,27,25,9,16,1,1,12,10,0,1,1,0
S01011133,Rented or living rent free: Private rented or living rent free,17,14,12,1,11,1,1,3,3,0,0,0,0
S01011134,All HRPs aged 16 and over,401,248,209,32,177,32,7,153,138,1,2,6,6
S01011134,Owned: Total,253,162,137,16,121,23,2,91,89,0,0,0,2
S01011134,Owned: Owned outright,142,60,45,10,35,15,0,82,80,0,0,0,2
S01011134,Owned: Owned with a mortgage or loan or shared ownership,111,102,92,6,86,8,2,9,9,0,0,0,0
S01011134,Rented or living rent free: Total,148,86,72,16,56,9,5,62,49,1,2,6,4
S01011134,Rented or living rent free: Social rented,62,18,16,9,7,0,2,44,39,0,1,4,0
S01011134,Rented or living rent free: Private rented or living rent free,86,68,56,7,49,9,3,18,10,1,1,2,4
S01011135,All HRPs aged 16 and over,337,221,187,38,149,26,8,116,98,3,5,7,3
S01011135,Owned: Total,215,146,128,20,108,18,0,69,63,2,0,4,0
S01011135,Owned: Owned outright,112,50,43,12,31,7,0,62,57,1,0,4,0
S01011135,Owned: Owned with a mortgage or loan or shared ownership,103,96,85,8,77,11,0,7,6,1,0,0,0
S01011135,Rented or living rent free: Total,122,75,59,18,41,8,8,47,35,1,5,3,3
S01011135,Rented or living rent free: Social rented,89,49,39,14,25,4,6,40,29,1,4,3,3
S01011135,Rented or living rent free: Private rented or living rent free,33,26,20,4,16,4,2,7,6,0,1,0,0
S01011136,All HRPs aged 16 and over,284,186,162,25,137,17,7,98,84,1,3,6,4
S01011136,Owned: Total,200,128,111,14,97,15,2,72,70,0,0,1,1
S01011136,Owned: Owned outright,109,43,37,9,28,5,1,66,64,0,0,1,1
S01011136,Owned: Owned with a mortgage or loan or shared ownership,91,85,74,5,69,10,1,6,6,0,0,0,0
S01011136,Rented or living rent free: Total,84,58,51,11,40,2,5,26,14,1,3,5,3
S01011136,Rented or living rent free: Social rented,45,23,18,7,11,2,3,22,12,0,3,4,3
S01011136,Rented or living rent free: Private rented or living rent free,39,35,33,4,29,0,2,4,2,1,0,1,0
S01011137,All HRPs aged 16 and over,186,147,120,24,96,17,10,39,33,1,5,0,0
S01011137,Owned: Total,112,82,70,9,61,11,1,30,29,0,1,0,0
S01011137,Owned: Owned outright,53,27,20,5,15,6,1,26,26,0,0,0,0
S01011137,Owned: Owned with a mortgage or loan or shared ownership,59,55,50,4,46,5,0,4,3,0,1,0,0
S01011137,Rented or living rent free: Total,74,65,50,15,35,6,9,9,4,1,4,0,0
S01011137,Rented or living rent free: Social rented,52,45,32,14,18,5,8,7,2,1,4,0,0
S01011137,Rented or living rent free: Private rented or living rent free,22,20,18,1,17,1,1,2,2,0,0,0,0
S01011138,All HRPs aged 16 and over,254,199,173,26,147,18,8,55,44,1,5,5,0
S01011138,Owned: Total,98,74,63,9,54,9,2,24,24,0,0,0,0
S01011138,Owned: Owned outright,34,13,6,1,5,5,2,21,21,0,0,0,0
S01011138,Owned: Owned with a mortgage or loan or shared ownership,64,61,57,8,49,4,0,3,3,0,0,0,0
S01011138,Rented or living rent free: Total,156,125,110,17,93,9,6,31,20,1,5,5,0
S01011138,Rented or living rent free: Social rented,104,75,61,16,45,8,6,29,18,1,5,5,0
S01011138,Rented or living rent free: Private rented or living rent free,52,50,49,1,48,1,0,2,2,0,0,0,0
S01011139,All HRPs aged 16 and over,281,246,224,11,213,17,5,35,30,0,2,0,3
S01011139,Owned: Total,152,124,106,8,98,14,4,28,26,0,0,0,2
S01011139,Owned: Owned outright,56,33,29,7,22,2,2,23,22,0,0,0,1
S01011139,Owned: Owned with a mortgage or loan or shared ownership,96,91,77,1,76,12,2,5,4,0,0,0,1
S01011139,Rented or living rent free: Total,129,122,118,3,115,3,1,7,4,0,2,0,1
S01011139,Rented or living rent free: Social rented,9,7,7,0,7,0,0,2,1,0,1,0,0
S01011139,Rented or living rent free: Private rented or living rent free,120,115,111,3,108,3,1,5,3,0,1,0,1
S01011140,All HRPs aged 16 and over,232,167,143,23,120,17,7,65,49,1,2,11,2
S01011140,Owned: Total,119,99,86,3,83,13,0,20,20,0,0,0,0
S01011140,Owned: Owned outright,33,17,14,1,13,3,0,16,16,0,0,0,0
S01011140,Owned: Owned with a mortgage or loan or shared ownership,86,82,72,2,70,10,0,4,4,0,0,0,0
S01011140,Rented or living rent free: Total,113,68,57,20,37,4,7,45,29,1,2,11,2
S01011140,Rented or living rent free: Social rented,89,48,41,16,25,3,4,41,28,1,1,9,2
S01011140,Rented or living rent free: Private rented or living rent free,24,20,16,4,12,1,3,4,1,0,1,2,0
S01011141,All HRPs aged 16 and over,230,163,146,30,116,9,8,67,48,1,4,10,4
S01011141,Owned: Total,108,85,78,11,67,7,0,23,19,0,0,3,1
S01011141,Owned: Owned outright,38,22,21,3,18,1,0,16,14,0,0,1,1
S01011141,Owned: Owned with a mortgage or loan or shared ownership,70,63,57,8,49,6,0,7,5,0,0,2,0
S01011141,Rented or living rent free: Total,122,78,68,19,49,2,8,44,29,1,4,7,3
S01011141,Rented or living rent free: Social rented,110,66,56,18,38,2,8,44,29,1,4,7,3
S01011141,Rented or living rent free: Private rented or living rent free,12,12,12,1,11,0,0,0,0,0,0,0,0
S01011142,All HRPs aged 16 and over,334,256,209,18,191,39,8,78,71,0,2,2,3
S01011142,Owned: Total,237,172,131,11,120,37,4,65,62,0,1,0,2
S01011142,Owned: Owned outright,115,58,41,9,32,17,0,57,55,0,1,0,1
S01011142,Owned: Owned with a mortgage or loan or shared ownership,122,114,90,2,88,20,4,8,7,0,0,0,1
S01011142,Rented or living rent free: Total,97,84,78,7,71,2,4,13,9,0,1,2,1
S01011142,Rented or living rent free: Social rented,6,4,3,1,2,0,1,2,1,0,0,1,0
S01011142,Rented or living rent free: Private rented or living rent free,91,80,75,6,69,2,3,11,8,0,1,1,1
S01011143,All HRPs aged 16 and over,398,251,217,30,187,31,3,147,134,3,4,3,3
S01011143,Owned: Total,349,221,192,23,169,26,3,128,123,2,1,1,1
S01011143,Owned: Owned outright,183,65,55,17,38,9,1,118,114,2,0,1,1
S01011143,Owned: Owned with a mortgage or loan or shared ownership,166,156,137,6,131,17,2,10,9,0,1,0,0
S01011143,Rented or living rent free: Total,49,30,25,7,18,5,0,19,11,1,3,2,2
S01011143,Rented or living rent free: Social rented,10,5,5,1,4,0,0,5,2,0,2,1,0
S01011143,Rented or living rent free: Private rented or living rent free,39,25,20,6,14,5,0,14,9,1,1,1,2
S01011144,All HRPs aged 16 and over,303,205,181,31,150,22,2,98,84,2,5,6,1
S01011144,Owned: Total,226,162,142,24,118,20,0,64,61,0,2,0,1
S01011144,Owned: Owned outright,104,47,37,16,21,10,0,57,54,0,2,0,1
S01011144,Owned: Owned with a mortgage or loan or shared ownership,122,115,105,8,97,10,0,7,7,0,0,0,0
S01011144,Rented or living rent free: Total,77,43,39,7,32,2,2,34,23,2,3,6,0
S01011144,Rented or living rent free: Social rented,41,16,14,6,8,0,2,25,19,0,1,5,0
S01011144,Rented or living rent free: Private rented or living rent free,36,27,25,1,24,2,0,9,4,2,2,1,0
S01011145,All HRPs aged 16 and over,267,186,150,17,133,33,3,81,76,0,1,3,1
S01011145,Owned: Total,216,142,118,13,105,22,2,74,72,0,1,0,1
S01011145,Owned: Owned outright,130,60,47,8,39,13,0,70,68,0,1,0,1
S01011145,Owned: Owned with a mortgage or loan or shared ownership,86,82,71,5,66,9,2,4,4,0,0,0,0
S01011145,Rented or living rent free: Total,51,44,32,4,28,11,1,7,4,0,0,3,0
S01011145,Rented or living rent free: Social rented,7,4,3,1,2,1,0,3,1,0,0,2,0
S01011145,Rented or living rent free: Private rented or living rent free,44,40,29,3,26,10,1,4,3,0,0,1,0
S01011146,All HRPs aged 16 and over,306,203,169,27,142,22,12,103,83,1,3,14,2
S01011146,Owned: Total,200,132,118,12,106,14,0,68,64,0,1,3,0
S01011146,Owned: Owned outright,101,37,31,6,25,6,0,64,60,0,1,3,0
S01011146,Owned: Owned with a mortgage or loan or shared ownership,99,95,87,6,81,8,0,4,4,0,0,0,0
S01011146,Rented or living rent free: Total,106,71,51,15,36,8,12,35,19,1,2,11,2
S01011146,Rented or living rent free: Social rented,88,58,44,13,31,6,8,30,15,1,2,10,2
S01011146,Rented or living rent free: Private rented or living rent free,18,13,7,2,5,2,4,5,4,0,0,1,0
S01011147,All HRPs aged 16 and over,450,304,258,38,220,37,9,146,131,1,2,6,6
S01011147,Owned: Total,341,236,201,26,175,31,4,105,97,1,1,3,3
S01011147,Owned: Owned outright,174,77,63,16,47,12,2,97,89,1,1,3,3
S01011147,Owned: Owned with a mortgage or loan or shared ownership,167,159,138,10,128,19,2,8,8,0,0,0,0
S01011147,Rented or living rent free: Total,109,68,57,12,45,6,5,41,34,0,1,3,3
S01011147,Rented or living rent free: Social rented,50,23,18,8,10,1,4,27,23,0,1,2,1
S01011147,Rented or living rent free: Private rented or living rent free,59,45,39,4,35,5,1,14,11,0,0,1,2
S01011148,All HRPs aged 16 and over,329,233,161,18,143,67,5,96,79,1,1,10,5
S01011148,Owned: Total,212,148,106,11,95,41,1,64,60,0,1,2,1
S01011148,Owned: Owned outright,124,65,35,6,29,30,0,59,57,0,1,1,0
S01011148,Owned: Owned with a mortgage or loan or shared ownership,88,83,71,5,66,11,1,5,3,0,0,1,1
S01011148,Rented or living rent free: Total,117,85,55,7,48,26,4,32,19,1,0,8,4
S01011148,Rented or living rent free: Social rented,24,11,9,1,8,1,1,13,6,0,0,5,2
S01011148,Rented or living rent free: Private rented or living rent free,93,74,46,6,40,25,3,19,13,1,0,3,2
S01011149,All HRPs aged 16 and over,265,221,165,18,147,55,1,44,36,4,1,1,2
S01011149,Owned: Total,132,102,57,11,46,45,0,30,28,1,0,1,0
S01011149,Owned: Owned outright,80,52,21,8,13,31,0,28,26,1,0,1,0
S01011149,Owned: Owned with a mortgage or loan or shared ownership,52,50,36,3,33,14,0,2,2,0,0,0,0
S01011149,Rented or living rent free: Total,133,119,108,7,101,10,1,14,8,3,1,0,2
S01011149,Rented or living rent free: Social rented,9,5,5,0,5,0,0,4,3,1,0,0,0
S01011149,Rented or living rent free: Private rented or living rent free,124,114,103,7,96,10,1,10,5,2,1,0,2
S01011150,All HRPs aged 16 and over,175,163,154,12,142,5,4,12,3,0,2,5,2
S01011150,Owned: Total,120,116,111,9,102,4,1,4,2,0,0,1,1
S01011150,Owned: Owned outright,13,10,8,1,7,2,0,3,2,0,0,1,0
S01011150,Owned: Owned with a mortgage or loan or shared ownership,107,106,103,8,95,2,1,1,0,0,0,0,1
S01011150,Rented or living rent free: Total,55,47,43,3,40,1,3,8,1,0,2,4,1
S01011150,Rented or living rent free: Social rented,25,18,15,3,12,1,2,7,1,0,1,4,1
S01011150,Rented or living rent free: Private rented or living rent free,30,29,28,0,28,0,1,1,0,0,1,0,0
S01011151,All HRPs aged 16 and over,218,185,153,13,140,17,15,33,24,1,2,6,0
S01011151,Owned: Total,87,69,57,7,50,9,3,18,17,0,0,1,0
S01011151,Owned: Owned outright,33,16,12,5,7,4,0,17,16,0,0,1,0
S01011151,Owned: Owned with a mortgage or loan or shared ownership,54,53,45,2,43,5,3,1,1,0,0,0,0
S01011151,Rented or living rent free: Total,131,116,96,6,90,8,12,15,7,1,2,5,0
S01011151,Rented or living rent free: Social rented,23,16,14,2,12,1,1,7,5,0,0,2,0
S01011151,Rented or living rent free: Private rented or living rent free,108,100,82,4,78,7,11,8,2,1,2,3,0
S01011152,All HRPs aged 16 and over,341,200,131,17,114,61,8,141,124,4,5,5,3
S01011152,Owned: Total,227,119,72,9,63,43,4,108,104,3,1,0,0
S01011152,Owned: Owned outright,162,59,32,6,26,24,3,103,101,2,0,0,0
S01011152,Owned: Owned with a mortgage or loan or shared ownership,65,60,40,3,37,19,1,5,3,1,1,0,0
S01011152,Rented or living rent free: Total,114,81,59,8,51,18,4,33,20,1,4,5,3
S01011152,Rented or living rent free: Social rented,32,16,15,4,11,1,0,16,13,0,1,2,0
S01011152,Rented or living rent free: Private rented or living rent free,82,65,44,4,40,17,4,17,7,1,3,3,3
S01011153,All HRPs aged 16 and over,455,268,204,29,175,42,22,187,162,0,1,20,4
S01011153,Owned: Total,269,148,113,15,98,30,5,121,118,0,1,1,1
S01011153,Owned: Owned outright,166,56,37,8,29,18,1,110,107,0,1,1,1
S01011153,Owned: Owned with a mortgage or loan or shared ownership,103,92,76,7,69,12,4,11,11,0,0,0,0
S01011153,Rented or living rent free: Total,186,120,91,14,77,12,17,66,44,0,0,19,3
S01011153,Rented or living rent free: Social rented,86,39,23,2,21,2,14,47,30,0,0,16,1
S01011153,Rented or living rent free: Private rented or living rent free,100,81,68,12,56,10,3,19,14,0,0,3,2
S01011154,All HRPs aged 16 and over,348,198,145,41,104,28,25,150,114,2,4,22,8
S01011154,Owned: Total,165,104,78,14,64,20,6,61,56,0,2,2,1
S01011154,Owned: Owned outright,92,37,28,8,20,8,1,55,50,0,2,2,1
S01011154,Owned: Owned with a mortgage or loan or shared ownership,73,67,50,6,44,12,5,6,6,0,0,0,0
S01011154,Rented or living rent free: Total,183,94,67,27,40,8,19,89,58,2,2,20,7
S01011154,Rented or living rent free: Social rented,121,48,34,16,18,1,13,73,47,1,2,18,5
S01011154,Rented or living rent free: Private rented or living rent free,62,46,33,11,22,7,6,16,11,1,0,2,2
S01011155,All HRPs aged 16 and over,348,172,136,33,103,23,13,176,141,6,5,16,8
S01011155,Owned: Total,188,106,89,18,71,16,1,82,73,3,2,3,1
S01011155,Owned: Owned outright,107,31,21,9,12,9,1,76,71,3,2,0,0
S01011155,Owned: Owned with a mortgage or loan or shared ownership,81,75,68,9,59,7,0,6,2,0,0,3,1
S01011155,Rented or living rent free: Total,160,66,47,15,32,7,12,94,68,3,3,13,7
S01011155,Rented or living rent free: Social rented,112,35,25,11,14,3,7,77,58,0,1,12,6
S01011155,Rented or living rent free: Private rented or living rent free,48,31,22,4,18,4,5,17,10,3,2,1,1
S01011156,All HRPs aged 16 and over,249,174,148,16,132,22,4,75,72,0,1,1,1
S01011156,Owned: Total,224,157,135,14,121,19,3,67,67,0,0,0,0
S01011156,Owned: Owned outright,100,41,31,5,26,9,1,59,59,0,0,0,0
S01011156,Owned: Owned with a mortgage or loan or shared ownership,124,116,104,9,95,10,2,8,8,0,0,0,0
S01011156,Rented or living rent free: Total,25,17,13,2,11,3,1,8,5,0,1,1,1
S01011156,Rented or living rent free: Social rented,3,1,1,0,1,0,0,2,0,0,1,1,0
S01011156,Rented or living rent free: Private rented or living rent free,22,16,12,2,10,3,1,6,5,0,0,0,1
S01011157,All HRPs aged 16 and over,284,181,158,27,131,20,3,103,95,2,0,3,3
S01011157,Owned: Total,255,164,147,24,123,17,0,91,88,2,0,0,1
S01011157,Owned: Owned outright,149,64,53,17,36,11,0,85,84,0,0,0,1
S01011157,Owned: Owned with a mortgage or loan or shared ownership,106,100,94,7,87,6,0,6,4,2,0,0,0
S01011157,Rented or living rent free: Total,29,17,11,3,8,3,3,12,7,0,0,3,2
S01011157,Rented or living rent free: Social rented,13,6,3,1,2,1,2,7,4,0,0,3,0
S01011157,Rented or living rent free: Private rented or living rent free,16,11,8,2,6,2,1,5,3,0,0,0,2
S01011158,All HRPs aged 16 and over,233,131,98,15,83,31,2,102,100,0,1,0,1
S01011158,Owned: Total,214,120,93,15,78,27,0,94,94,0,0,0,0
S01011158,Owned: Owned outright,160,71,56,12,44,15,0,89,89,0,0,0,0
S01011158,Owned: Owned with a mortgage or loan or shared ownership,54,49,37,3,34,12,0,5,5,0,0,0,0
S01011158,Rented or living rent free: Total,19,11,5,0,5,4,2,8,6,0,1,0,1
S01011158,Rented or living rent free: Social rented,3,1,1,0,1,0,0,2,1,0,0,0,1
S01011158,Rented or living rent free: Private rented or living rent free,16,10,4,0,4,4,2,6,5,0,1,0,0
S01011159,All HRPs aged 16 and over,300,146,124,20,104,12,10,154,129,0,7,15,3
S01011159,Owned: Total,154,81,69,6,63,10,2,73,66,0,2,3,2
S01011159,Owned: Owned outright,94,28,18,2,16,8,2,66,62,0,1,1,2
S01011159,Owned: Owned with a mortgage or loan or shared ownership,60,53,51,4,47,2,0,7,4,0,1,2,0
S01011159,Rented or living rent free: Total,146,65,55,14,41,2,8,81,63,0,5,12,1
S01011159,Rented or living rent free: Social rented,114,48,41,11,30,2,5,66,51,0,3,11,1
S01011159,Rented or living rent free: Private rented or living rent free,32,17,14,3,11,0,3,15,12,0,2,1,0
S01011160,All HRPs aged 16 and over,393,280,235,47,188,35,10,113,92,0,3,11,7
S01011160,Owned: Total,237,170,142,21,121,26,2,67,65,0,1,1,0
S01011160,Owned: Owned outright,127,62,48,13,35,13,1,65,63,0,1,1,0
S01011160,Owned: Owned with a mortgage or loan or shared ownership,110,108,94,8,86,13,1,2,2,0,0,0,0
S01011160,Rented or living rent free: Total,156,110,93,26,67,9,8,46,27,0,2,10,7
S01011160,Rented or living rent free: Social rented,82,41,32,11,21,2,7,41,23,0,2,10,6
S01011160,Rented or living rent free: Private rented or living rent free,74,69,61,15,46,7,1,5,4,0,0,0,1
S01011161,All HRPs aged 16 and over,269,187,159,40,119,18,10,82,71,1,4,4,2
S01011161,Owned: Total,159,106,95,17,78,10,1,53,49,0,1,1,2
S01011161,Owned: Owned outright,71,24,22,8,14,2,0,47,46,0,0,0,1
S01011161,Owned: Owned with a mortgage or loan or shared ownership,88,82,73,9,64,8,1,6,3,0,1,1,1
S01011161,Rented or living rent free: Total,110,81,64,23,41,8,9,29,22,1,3,3,0
S01011161,Rented or living rent free: Social rented,67,46,37,14,23,5,4,21,17,1,1,2,0
S01011161,Rented or living rent free: Private rented or living rent free,43,35,27,9,18,3,5,8,5,0,2,1,0
S01011162,All HRPs aged 16 and over,187,118,99,20,79,11,8,69,44,2,8,9,6
S01011162,Owned: Total,104,66,57,9,48,8,1,38,35,0,2,0,1
S01011162,Owned: Owned outright,49,19,15,2,13,3,1,30,30,0,0,0,0
S01011162,Owned: Owned with a mortgage or loan or shared ownership,55,47,42,7,35,5,0,8,5,0,2,0,1
S01011162,Rented or living rent free: Total,83,52,42,11,31,3,7,31,9,2,6,9,5
S01011162,Rented or living rent free: Social rented,54,28,20,10,10,2,6,26,9,2,3,7,5
S01011162,Rented or living rent free: Private rented or living rent free,29,24,22,1,21,1,1,5,0,0,3,2,0
S01011163,All HRPs aged 16 and over,352,240,204,49,155,21,15,112,91,3,1,14,3
S01011163,Owned: Total,183,137,119,18,101,16,2,46,44,1,1,0,0
S01011163,Owned: Owned outright,75,38,31,12,19,7,0,37,36,0,1,0,0
S01011163,Owned: Owned with a mortgage or loan or shared ownership,108,99,88,6,82,9,2,9,8,1,0,0,0
S01011163,Rented or living rent free: Total,169,103,85,31,54,5,13,66,47,2,0,14,3
S01011163,Rented or living rent free: Social rented,140,80,64,28,36,4,12,60,42,2,0,13,3
S01011163,Rented or living rent free: Private rented or living rent free,29,23,21,3,18,1,1,6,5,0,0,1,0
S01011164,All HRPs aged 16 and over,282,205,178,33,145,18,9,77,61,0,8,6,2
S01011164,Owned: Total,196,144,132,19,113,12,0,52,50,0,1,0,1
S01011164,Owned: Owned outright,86,37,34,8,26,3,0,49,48,0,1,0,0
S01011164,Owned: Owned with a mortgage or loan or shared ownership,110,107,98,11,87,9,0,3,2,0,0,0,1
S01011164,Rented or living rent free: Total,86,61,46,14,32,6,9,25,11,0,7,6,1
S01011164,Rented or living rent free: Social rented,59,40,31,12,19,1,8,19,7,0,5,6,1
S01011164,Rented or living rent free: Private rented or living rent free,27,21,15,2,13,5,1,6,4,0,2,0,0
S01011165,All HRPs aged 16 and over,356,208,171,43,128,23,14,148,107,5,18,12,6
S01011165,Owned: Total,161,105,90,17,73,15,0,56,51,1,2,2,0
S01011165,Owned: Owned outright,71,23,21,7,14,2,0,48,44,0,2,2,0
S01011165,Owned: Owned with a mortgage or loan or shared ownership,90,82,69,10,59,13,0,8,7,1,0,0,0
S01011165,Rented or living rent free: Total,195,103,81,26,55,8,14,92,56,4,16,10,6
S01011165,Rented or living rent free: Social rented,166,87,67,22,45,7,13,79,50,3,16,7,3
S01011165,Rented or living rent free: Private rented or living rent free,29,16,14,4,10,1,1,13,6,1,0,3,3
S01011166,All HRPs aged 16 and over,229,128,109,21,88,18,1,101,100,1,0,0,0
S01011166,Owned: Total,196,104,88,15,73,16,0,92,91,1,0,0,0
S01011166,Owned: Owned outright,125,42,32,9,23,10,0,83,82,1,0,0,0
S01011166,Owned: Owned with a mortgage or loan or shared ownership,71,62,56,6,50,6,0,9,9,0,0,0,0
S01011166,Rented or living rent free: Total,33,24,21,6,15,2,1,9,9,0,0,0,0
S01011166,Rented or living rent free: Social rented,16,11,10,3,7,0,1,5,5,0,0,0,0
S01011166,Rented or living rent free: Private rented or living rent free,17,13,11,3,8,2,0,4,4,0,0,0,0
S01011167,All HRPs aged 16 and over,279,189,130,20,110,58,1,90,85,0,1,3,1
S01011167,Owned: Total,230,154,107,15,92,47,0,76,75,0,0,1,0
S01011167,Owned: Owned outright,146,75,47,11,36,28,0,71,70,0,0,1,0
S01011167,Owned: Owned with a mortgage or loan or shared ownership,84,79,60,4,56,19,0,5,5,0,0,0,0
S01011167,Rented or living rent free: Total,49,35,23,5,18,11,1,14,10,0,1,2,1
S01011167,Rented or living rent free: Social rented,8,4,3,1,2,1,0,4,1,0,0,2,1
S01011167,Rented or living rent free: Private rented or living rent free,41,31,20,4,16,10,1,10,9,0,1,0,0
S01011168,All HRPs aged 16 and over,355,256,152,24,128,96,8,99,87,4,1,5,2
S01011168,Owned: Total,194,135,85,13,72,44,6,59,57,0,0,0,2
S01011168,Owned: Owned outright,107,54,29,7,22,24,1,53,51,0,0,0,2
S01011168,Owned: Owned with a mortgage or loan or shared ownership,87,81,56,6,50,20,5,6,6,0,0,0,0
S01011168,Rented or living rent free: Total,161,121,67,11,56,52,2,40,30,4,1,5,0
S01011168,Rented or living rent free: Social rented,9,6,4,2,2,2,0,3,1,0,0,2,0
S01011168,Rented or living rent free: Private rented or living rent free,152,115,63,9,54,50,2,37,29,4,1,3,0
S01011169,All HRPs aged 16 and over,346,298,264,23,241,28,6,48,33,2,7,4,2
S01011169,Owned: Total,262,231,210,13,197,20,1,31,27,2,2,0,0
S01011169,Owned: Owned outright,71,46,37,8,29,8,1,25,25,0,0,0,0
S01011169,Owned: Owned with a mortgage or loan or shared ownership,191,185,173,5,168,12,0,6,2,2,2,0,0
S01011169,Rented or living rent free: Total,84,67,54,10,44,8,5,17,6,0,5,4,2
S01011169,Rented or living rent free: Social rented,26,20,14,7,7,1,5,6,1,0,2,3,0
S01011169,Rented or living rent free: Private rented or living rent free,58,47,40,3,37,7,0,11,5,0,3,1,2
S01011170,All HRPs aged 16 and over,400,274,203,33,170,56,15,126,109,1,0,9,7
S01011170,Owned: Total,275,186,138,21,117,39,9,89,82,1,0,2,4
S01011170,Owned: Owned outright,164,84,60,11,49,20,4,80,74,1,0,1,4
S01011170,Owned: Owned with a mortgage or loan or shared ownership,111,102,78,10,68,19,5,9,8,0,0,1,0
S01011170,Rented or living rent free: Total,125,88,65,12,53,17,6,37,27,0,0,7,3
S01011170,Rented or living rent free: Social rented,23,8,6,1,5,1,1,15,9,0,0,6,0
S01011170,Rented or living rent free: Private rented or living rent free,102,80,59,11,48,16,5,22,18,0,0,1,3
S01011171,All HRPs aged 16 and over,409,253,150,30,120,90,13,156,148,1,2,2,3
S01011171,Owned: Total,317,190,114,24,90,74,2,127,122,1,2,0,2
S01011171,Owned: Owned outright,231,115,66,21,45,48,1,116,112,1,1,0,2
S01011171,Owned: Owned with a mortgage or loan or shared ownership,86,75,48,3,45,26,1,11,10,0,1,0,0
S01011171,Rented or living rent free: Total,92,63,36,6,30,16,11,29,26,0,0,2,1
S01011171,Rented or living rent free: Social rented,40,21,12,4,8,3,6,19,16,0,0,2,1
S01011171,Rented or living rent free: Private rented or living rent free,52,42,24,2,22,13,5,10,10,0,0,0,0
S01011172,All HRPs aged 16 and over,339,201,119,22,97,75,7,138,127,0,3,7,1
S01011172,Owned: Total,257,150,85,20,65,63,2,107,102,0,2,3,0
S01011172,Owned: Owned outright,183,87,40,12,28,45,2,96,93,0,1,2,0
S01011172,Owned: Owned with a mortgage or loan or shared ownership,74,63,45,8,37,18,0,11,9,0,1,1,0
S01011172,Rented or living rent free: Total,82,51,34,2,32,12,5,31,25,0,1,4,1
S01011172,Rented or living rent free: Social rented,40,24,16,2,14,4,4,16,13,0,0,2,1
S01011172,Rented or living rent free: Private rented or living rent free,42,27,18,0,18,8,1,15,12,0,1,2,0
S01011173,All HRPs aged 16 and over,224,118,66,12,54,48,4,106,102,0,1,2,1
S01011173,Owned: Total,178,90,49,9,40,40,1,88,87,0,0,0,1
S01011173,Owned: Owned outright,119,39,17,6,11,21,1,80,79,0,0,0,1
S01011173,Owned: Owned with a mortgage or loan or shared ownership,59,51,32,3,29,19,0,8,8,0,0,0,0
S01011173,Rented or living rent free: Total,46,28,17,3,14,8,3,18,15,0,1,2,0
S01011173,Rented or living rent free: Social rented,18,8,4,1,3,2,2,10,8,0,1,1,0
S01011173,Rented or living rent free: Private rented or living rent free,28,20,13,2,11,6,1,8,7,0,0,1,0
S01011174,All HRPs aged 16 and over,219,118,71,17,54,42,5,101,96,0,1,3,1
S01011174,Owned: Total,154,76,43,11,32,32,1,78,78,0,0,0,0
S01011174,Owned: Owned outright,120,48,28,8,20,19,1,72,72,0,0,0,0
S01011174,Owned: Owned with a mortgage or loan or shared ownership,34,28,15,3,12,13,0,6,6,0,0,0,0
S01011174,Rented or living rent free: Total,65,42,28,6,22,10,4,23,18,0,1,3,1
S01011174,Rented or living rent free: Social rented,17,4,2,0,2,1,1,13,11,0,1,1,0
S01011174,Rented or living rent free: Private rented or living rent free,48,38,26,6,20,9,3,10,7,0,0,2,1
S01011175,All HRPs aged 16 and over,259,130,101,22,79,27,2,129,109,0,6,14,0
S01011175,Owned: Total,164,91,66,10,56,25,0,73,71,0,0,2,0
S01011175,Owned: Owned outright,96,31,20,5,15,11,0,65,63,0,0,2,0
S01011175,Owned: Owned with a mortgage or loan or shared ownership,68,60,46,5,41,14,0,8,8,0,0,0,0
S01011175,Rented or living rent free: Total,95,39,35,12,23,2,2,56,38,0,6,12,0
S01011175,Rented or living rent free: Social rented,72,26,22,9,13,2,2,46,33,0,3,10,0
S01011175,Rented or living rent free: Private rented or living rent free,23,13,13,3,10,0,0,10,5,0,3,2,0
S01011176,All HRPs aged 16 and over,274,132,83,15,68,46,3,142,133,0,1,5,3
S01011176,Owned: Total,228,97,57,11,46,39,1,131,125,0,0,3,3
S01011176,Owned: Owned outright,175,50,29,8,21,20,1,125,120,0,0,2,3
S01011176,Owned: Owned with a mortgage or loan or shared ownership,53,47,28,3,25,19,0,6,5,0,0,1,0
S01011176,Rented or living rent free: Total,46,35,26,4,22,7,2,11,8,0,1,2,0
S01011176,Rented or living rent free: Social rented,8,5,5,2,3,0,0,3,3,0,0,0,0
S01011176,Rented or living rent free: Private rented or living rent free,38,30,21,2,19,7,2,8,5,0,1,2,0
S01011177,All HRPs aged 16 and over,402,227,163,36,127,59,5,175,166,0,1,5,3
S01011177,Owned: Total,273,143,99,24,75,43,1,130,127,0,0,2,1
S01011177,Owned: Owned outright,190,76,49,21,28,27,0,114,113,0,0,1,0
S01011177,Owned: Owned with a mortgage or loan or shared ownership,83,67,50,3,47,16,1,16,14,0,0,1,1
S01011177,Rented or living rent free: Total,129,84,64,12,52,16,4,45,39,0,1,3,2
S01011177,Rented or living rent free: Social rented,68,34,26,9,17,8,0,34,29,0,1,3,1
S01011177,Rented or living rent free: Private rented or living rent free,61,50,38,3,35,8,4,11,10,0,0,0,1
S01011178,All HRPs aged 16 and over,206,139,109,14,95,24,6,67,50,1,4,10,2
S01011178,Owned: Total,141,95,73,10,63,21,1,46,42,0,0,4,0
S01011178,Owned: Owned outright,61,21,17,4,13,4,0,40,37,0,0,3,0
S01011178,Owned: Owned with a mortgage or loan or shared ownership,80,74,56,6,50,17,1,6,5,0,0,1,0
S01011178,Rented or living rent free: Total,65,44,36,4,32,3,5,21,8,1,4,6,2
S01011178,Rented or living rent free: Social rented,17,6,4,2,2,1,1,11,7,0,0,3,1
S01011178,Rented or living rent free: Private rented or living rent free,48,38,32,2,30,2,4,10,1,1,4,3,1
S01011179,All HRPs aged 16 and over,272,170,140,30,110,20,10,102,81,0,3,15,3
S01011179,Owned: Total,153,109,93,14,79,14,2,44,41,0,0,2,1
S01011179,Owned: Owned outright,66,31,25,4,21,5,1,35,33,0,0,1,1
S01011179,Owned: Owned with a mortgage or loan or shared ownership,87,78,68,10,58,9,1,9,8,0,0,1,0
S01011179,Rented or living rent free: Total,119,61,47,16,31,6,8,58,40,0,3,13,2
S01011179,Rented or living rent free: Social rented,98,47,37,11,26,4,6,51,36,0,2,12,1
S01011179,Rented or living rent free: Private rented or living rent free,21,14,10,5,5,2,2,7,4,0,1,1,1
S01011180,All HRPs aged 16 and over,301,154,117,35,82,13,24,147,98,3,8,37,1
S01011180,Owned: Total,122,79,64,13,51,13,2,43,40,0,1,2,0
S01011180,Owned: Owned outright,47,21,14,6,8,7,0,26,26,0,0,0,0
S01011180,Owned: Owned with a mortgage or loan or shared ownership,75,58,50,7,43,6,2,17,14,0,1,2,0
S01011180,Rented or living rent free: Total,179,75,53,22,31,0,22,104,58,3,7,35,1
S01011180,Rented or living rent free: Social rented,166,66,47,21,26,0,19,100,57,3,6,33,1
S01011180,Rented or living rent free: Private rented or living rent free,13,9,6,1,5,0,3,4,1,0,1,2,0
S01011181,All HRPs aged 16 and over,198,144,77,14,63,65,2,54,49,1,1,3,0
S01011181,Owned: Total,170,124,67,13,54,57,0,46,43,1,0,2,0
S01011181,Owned: Owned outright,100,55,24,9,15,31,0,45,42,1,0,2,0
S01011181,Owned: Owned with a mortgage or loan or shared ownership,70,69,43,4,39,26,0,1,1,0,0,0,0
S01011181,Rented or living rent free: Total,28,20,10,1,9,8,2,8,6,0,1,1,0
S01011181,Rented or living rent free: Social rented,6,3,2,1,1,0,1,3,3,0,0,0,0
S01011181,Rented or living rent free: Private rented or living rent free,22,17,8,0,8,8,1,5,3,0,1,1,0
S01011182,All HRPs aged 16 and over,166,127,86,10,76,38,3,39,36,0,1,2,0
S01011182,Owned: Total,151,117,80,9,71,34,3,34,33,0,1,0,0
S01011182,Owned: Owned outright,82,54,34,7,27,19,1,28,28,0,0,0,0
S01011182,Owned: Owned with a mortgage or loan or shared ownership,69,63,46,2,44,15,2,6,5,0,1,0,0
S01011182,Rented or living rent free: Total,15,10,6,1,5,4,0,5,3,0,0,2,0
S01011182,Rented or living rent free: Social rented,3,0,0,0,0,0,0,3,2,0,0,1,0
S01011182,Rented or living rent free: Private rented or living rent free,12,10,6,1,5,4,0,2,1,0,0,1,0
S01011183,All HRPs aged 16 and over,226,147,108,19,89,25,14,79,64,0,8,6,1
S01011183,Owned: Total,170,120,90,11,79,24,6,50,48,0,1,1,0
S01011183,Owned: Owned outright,74,32,21,2,19,7,4,42,42,0,0,0,0
S01011183,Owned: Owned with a mortgage or loan or shared ownership,96,88,69,9,60,17,2,8,6,0,1,1,0
S01011183,Rented or living rent free: Total,56,27,18,8,10,1,8,29,16,0,7,5,1
S01011183,Rented or living rent free: Social rented,44,22,14,8,6,1,7,22,12,0,4,5,1
S01011183,Rented or living rent free: Private rented or living rent free,12,5,4,0,4,0,1,7,4,0,3,0,0
S01011184,All HRPs aged 16 and over,307,223,188,14,174,33,2,84,81,0,1,2,0
S01011184,Owned: Total,300,219,184,13,171,33,2,81,79,0,1,1,0
S01011184,Owned: Owned outright,120,48,38,6,32,9,1,72,70,0,1,1,0
S01011184,Owned: Owned with a mortgage or loan or shared ownership,180,171,146,7,139,24,1,9,9,0,0,0,0
S01011184,Rented or living rent free: Total,7,4,4,1,3,0,0,3,2,0,0,1,0
S01011184,Rented or living rent free: Social rented,3,1,1,0,1,0,0,2,1,0,0,1,0
S01011184,Rented or living rent free: Private rented or living rent free,4,3,3,1,2,0,0,1,1,0,0,0,0
S01011185,All HRPs aged 16 and over,296,161,133,14,119,21,7,135,124,1,3,6,1
S01011185,Owned: Total,264,150,125,12,113,20,5,114,110,0,0,4,0
S01011185,Owned: Owned outright,137,41,32,8,24,5,4,96,93,0,0,3,0
S01011185,Owned: Owned with a mortgage or loan or shared ownership,127,109,93,4,89,15,1,18,17,0,0,1,0
S01011185,Rented or living rent free: Total,32,11,8,2,6,1,2,21,14,1,3,2,1
S01011185,Rented or living rent free: Social rented,17,4,2,1,1,1,1,13,9,0,2,1,1
S01011185,Rented or living rent free: Private rented or living rent free,15,7,6,1,5,0,1,8,5,1,1,1,0
S01011186,All HRPs aged 16 and over,456,233,193,41,152,28,12,223,178,2,10,31,2
S01011186,Owned: Total,286,172,146,19,127,22,4,114,109,0,2,2,1
S01011186,Owned: Owned outright,136,43,34,10,24,7,2,93,91,0,1,0,1
S01011186,Owned: Owned with a mortgage or loan or shared ownership,150,129,112,9,103,15,2,21,18,0,1,2,0
S01011186,Rented or living rent free: Total,170,61,47,22,25,6,8,109,69,2,8,29,1
S01011186,Rented or living rent free: Social rented,134,36,30,15,15,2,4,98,66,0,5,26,1
S01011186,Rented or living rent free: Private rented or living rent free,36,25,17,7,10,4,4,11,3,2,3,3,0
S01011187,All HRPs aged 16 and over,287,179,158,23,135,16,5,108,105,0,0,3,0
S01011187,Owned: Total,251,156,141,17,124,13,2,95,95,0,0,0,0
S01011187,Owned: Owned outright,135,54,50,14,36,2,2,81,81,0,0,0,0
S01011187,Owned: Owned with a mortgage or loan or shared ownership,116,102,91,3,88,11,0,14,14,0,0,0,0
S01011187,Rented or living rent free: Total,36,23,17,6,11,3,3,13,10,0,0,3,0
S01011187,Rented or living rent free: Social rented,22,15,10,4,6,2,3,7,5,0,0,2,0
S01011187,Rented or living rent free: Private rented or living rent free,14,8,7,2,5,1,0,6,5,0,0,1,0
S01011188,All HRPs aged 16 and over,442,270,221,46,175,22,27,172,139,1,6,18,8
S01011188,Owned: Total,285,192,167,30,137,18,7,93,90,0,0,2,1
S01011188,Owned: Owned outright,116,45,43,16,27,2,0,71,71,0,0,0,0
S01011188,Owned: Owned with a mortgage or loan or shared ownership,169,147,124,14,110,16,7,22,19,0,0,2,1
S01011188,Rented or living rent free: Total,157,78,54,16,38,4,20,79,49,1,6,16,7
S01011188,Rented or living rent free: Social rented,112,50,35,11,24,3,12,62,39,1,5,13,4
S01011188,Rented or living rent free: Private rented or living rent free,45,28,19,5,14,1,8,17,10,0,1,3,3
S01011189,All HRPs aged 16 and over,356,246,208,32,176,25,13,110,91,1,4,12,2
S01011189,Owned: Total,256,182,153,16,137,23,6,74,67,1,1,4,1
S01011189,Owned: Owned outright,96,35,24,8,16,8,3,61,58,0,0,3,0
S01011189,Owned: Owned with a mortgage or loan or shared ownership,160,147,129,8,121,15,3,13,9,1,1,1,1
S01011189,Rented or living rent free: Total,100,64,55,16,39,2,7,36,24,0,3,8,1
S01011189,Rented or living rent free: Social rented,48,21,19,7,12,1,1,27,18,0,1,7,1
S01011189,Rented or living rent free: Private rented or living rent free,52,43,36,9,27,1,6,9,6,0,2,1,0
S01011190,All HRPs aged 16 and over,288,153,121,23,98,26,6,135,98,0,10,21,6
S01011190,Owned: Total,152,102,81,8,73,20,1,50,43,0,3,3,1
S01011190,Owned: Owned outright,47,13,8,3,5,5,0,34,31,0,1,2,0
S01011190,Owned: Owned with a mortgage or loan or shared ownership,105,89,73,5,68,15,1,16,12,0,2,1,1
S01011190,Rented or living rent free: Total,136,51,40,15,25,6,5,85,55,0,7,18,5
S01011190,Rented or living rent free: Social rented,112,35,27,12,15,4,4,77,52,0,4,16,5
S01011190,Rented or living rent free: Private rented or living rent free,24,16,13,3,10,2,1,8,3,0,3,2,0
S01011191,All HRPs aged 16 and over,241,150,126,24,102,12,12,91,68,1,6,13,3
S01011191,Owned: Total,146,100,87,14,73,10,3,46,44,0,0,1,1
S01011191,Owned: Owned outright,53,17,12,7,5,3,2,36,34,0,0,1,1
S01011191,Owned: Owned with a mortgage or loan or shared ownership,93,83,75,7,68,7,1,10,10,0,0,0,0
S01011191,Rented or living rent free: Total,95,50,39,10,29,2,9,45,24,1,6,12,2
S01011191,Rented or living rent free: Social rented,77,40,32,8,24,2,6,37,24,1,3,8,1
S01011191,Rented or living rent free: Private rented or living rent free,18,10,7,2,5,0,3,8,0,0,3,4,1
S01011192,All HRPs aged 16 and over,290,216,182,26,156,14,20,74,47,3,6,13,5
S01011192,Owned: Total,174,143,131,10,121,9,3,31,29,0,0,1,1
S01011192,Owned: Owned outright,48,24,21,4,17,1,2,24,22,0,0,1,1
S01011192,Owned: Owned with a mortgage or loan or shared ownership,126,119,110,6,104,8,1,7,7,0,0,0,0
S01011192,Rented or living rent free: Total,116,73,51,16,35,5,17,43,18,3,6,12,4
S01011192,Rented or living rent free: Social rented,84,54,39,12,27,3,12,30,15,0,3,10,2
S01011192,Rented or living rent free: Private rented or living rent free,32,19,12,4,8,2,5,13,3,3,3,2,2
S01011193,All HRPs aged 16 and over,286,186,159,28,131,6,21,100,45,1,13,30,11
S01011193,Owned: Total,137,105,97,10,87,4,4,32,23,1,1,4,3
S01011193,Owned: Owned outright,33,15,14,3,11,1,0,18,15,0,0,1,2
S01011193,Owned: Owned with a mortgage or loan or shared ownership,104,90,83,7,76,3,4,14,8,1,1,3,1
S01011193,Rented or living rent free: Total,149,81,62,18,44,2,17,68,22,0,12,26,8
S01011193,Rented or living rent free: Social rented,110,60,45,13,32,1,14,50,20,0,7,19,4
S01011193,Rented or living rent free: Private rented or living rent free,39,21,17,5,12,1,3,18,2,0,5,7,4
S01011194,All HRPs aged 16 and over,302,209,157,40,117,15,37,93,46,6,15,21,5
S01011194,Owned: Total,132,108,90,13,77,11,7,24,18,0,1,5,0
S01011194,Owned: Owned outright,36,22,19,6,13,0,3,14,13,0,0,1,0
S01011194,Owned: Owned with a mortgage or loan or shared ownership,96,86,71,7,64,11,4,10,5,0,1,4,0
S01011194,Rented or living rent free: Total,170,101,67,27,40,4,30,69,28,6,14,16,5
S01011194,Rented or living rent free: Social rented,137,79,55,24,31,3,21,58,25,5,9,14,5
S01011194,Rented or living rent free: Private rented or living rent free,33,22,12,3,9,1,9,11,3,1,5,2,0
S01011195,All HRPs aged 16 and over,318,232,197,44,153,13,22,86,53,4,9,14,6
S01011195,Owned: Total,181,142,127,19,108,12,3,39,35,1,0,1,2
S01011195,Owned: Owned outright,46,19,16,3,13,1,2,27,26,0,0,0,1
S01011195,Owned: Owned with a mortgage or loan or shared ownership,135,123,111,16,95,11,1,12,9,1,0,1,1
S01011195,Rented or living rent free: Total,137,90,70,25,45,1,19,47,18,3,9,13,4
S01011195,Rented or living rent free: Social rented,102,64,50,17,33,1,13,38,17,2,4,12,3
S01011195,Rented or living rent free: Private rented or living rent free,35,26,20,8,12,0,6,9,1,1,5,1,1
S01011196,All HRPs aged 16 and over,409,240,196,36,160,19,25,169,109,6,16,28,10
S01011196,Owned: Total,178,135,119,18,101,12,4,43,35,1,2,3,2
S01011196,Owned: Owned outright,54,25,23,6,17,2,0,29,26,1,0,2,0
S01011196,Owned: Owned with a mortgage or loan or shared ownership,124,110,96,12,84,10,4,14,9,0,2,1,2
S01011196,Rented or living rent free: Total,231,105,77,18,59,7,21,126,74,5,14,25,8
S01011196,Rented or living rent free: Social rented,207,92,67,15,52,5,20,115,72,5,9,24,5
S01011196,Rented or living rent free: Private rented or living rent free,24,13,10,3,7,2,1,11,2,0,5,1,3
S01011197,All HRPs aged 16 and over,348,218,167,35,132,23,28,130,69,5,10,31,15
S01011197,Owned: Total,167,128,106,15,91,17,5,39,31,1,1,5,1
S01011197,Owned: Owned outright,55,27,20,2,18,5,2,28,26,0,0,2,0
S01011197,Owned: Owned with a mortgage or loan or shared ownership,112,101,86,13,73,12,3,11,5,1,1,3,1
S01011197,Rented or living rent free: Total,181,90,61,20,41,6,23,91,38,4,9,26,14
S01011197,Rented or living rent free: Social rented,138,67,45,14,31,6,16,71,36,4,6,21,4
S01011197,Rented or living rent free: Private rented or living rent free,43,23,16,6,10,0,7,20,2,0,3,5,10
S01011198,All HRPs aged 16 and over,241,163,129,29,100,18,16,78,47,0,9,16,6
S01011198,Owned: Total,125,94,82,12,70,12,0,31,25,0,0,4,2
S01011198,Owned: Owned outright,42,20,17,4,13,3,0,22,19,0,0,2,1
S01011198,Owned: Owned with a mortgage or loan or shared ownership,83,74,65,8,57,9,0,9,6,0,0,2,1
S01011198,Rented or living rent free: Total,116,69,47,17,30,6,16,47,22,0,9,12,4
S01011198,Rented or living rent free: Social rented,92,53,37,12,25,5,11,39,21,0,7,10,1
S01011198,Rented or living rent free: Private rented or living rent free,24,16,10,5,5,1,5,8,1,0,2,2,3
S01011199,All HRPs aged 16 and over,342,232,190,23,167,21,21,110,68,3,9,27,3
S01011199,Owned: Total,186,152,131,11,120,16,5,34,32,0,0,1,1
S01011199,Owned: Owned outright,50,28,25,3,22,1,2,22,21,0,0,0,1
S01011199,Owned: Owned with a mortgage or loan or shared ownership,136,124,106,8,98,15,3,12,11,0,0,1,0
S01011199,Rented or living rent free: Total,156,80,59,12,47,5,16,76,36,3,9,26,2
S01011199,Rented or living rent free: Social rented,121,59,44,9,35,2,13,62,35,2,4,19,2
S01011199,Rented or living rent free: Private rented or living rent free,35,21,15,3,12,3,3,14,1,1,5,7,0
S01011200,All HRPs aged 16 and over,356,241,203,29,174,22,16,115,79,1,5,26,4
S01011200,Owned: Total,253,186,162,21,141,20,4,67,60,0,1,5,1
S01011200,Owned: Owned outright,92,45,39,10,29,5,1,47,46,0,0,0,1
S01011200,Owned: Owned with a mortgage or loan or shared ownership,161,141,123,11,112,15,3,20,14,0,1,5,0
S01011200,Rented or living rent free: Total,103,55,41,8,33,2,12,48,19,1,4,21,3
S01011200,Rented or living rent free: Social rented,71,32,24,5,19,2,6,39,17,1,3,15,3
S01011200,Rented or living rent free: Private rented or living rent free,32,23,17,3,14,0,6,9,2,0,1,6,0
S01011201,All HRPs aged 16 and over,267,159,135,15,120,19,5,108,88,0,1,16,3
S01011201,Owned: Total,197,134,115,13,102,17,2,63,55,0,0,6,2
S01011201,Owned: Owned outright,77,31,27,6,21,2,2,46,41,0,0,3,2
S01011201,Owned: Owned with a mortgage or loan or shared ownership,120,103,88,7,81,15,0,17,14,0,0,3,0
S01011201,Rented or living rent free: Total,70,25,20,2,18,2,3,45,33,0,1,10,1
S01011201,Rented or living rent free: Social rented,63,19,14,2,12,2,3,44,32,0,1,10,1
S01011201,Rented or living rent free: Private rented or living rent free,7,6,6,0,6,0,0,1,1,0,0,0,0
S01011202,All HRPs aged 16 and over,390,248,214,44,170,17,17,142,103,2,5,26,6
S01011202,Owned: Total,230,177,162,22,140,13,2,53,53,0,0,0,0
S01011202,Owned: Owned outright,65,28,24,8,16,3,1,37,37,0,0,0,0
S01011202,Owned: Owned with a mortgage or loan or shared ownership,165,149,138,14,124,10,1,16,16,0,0,0,0
S01011202,Rented or living rent free: Total,160,71,52,22,30,4,15,89,50,2,5,26,6
S01011202,Rented or living rent free: Social rented,127,52,38,17,21,4,10,75,46,0,2,21,6
S01011202,Rented or living rent free: Private rented or living rent free,33,19,14,5,9,0,5,14,4,2,3,5,0
S01011203,All HRPs aged 16 and over,364,228,196,30,166,19,13,136,114,5,4,11,2
S01011203,Owned: Total,251,185,164,22,142,15,6,66,62,0,0,4,0
S01011203,Owned: Owned outright,86,43,40,13,27,2,1,43,40,0,0,3,0
S01011203,Owned: Owned with a mortgage or loan or shared ownership,165,142,124,9,115,13,5,23,22,0,0,1,0
S01011203,Rented or living rent free: Total,113,43,32,8,24,4,7,70,52,5,4,7,2
S01011203,Rented or living rent free: Social rented,89,29,26,4,22,1,2,60,51,0,2,5,2
S01011203,Rented or living rent free: Private rented or living rent free,24,14,6,4,2,3,5,10,1,5,2,2,0
S01011204,All HRPs aged 16 and over,235,157,132,18,114,24,1,78,74,0,1,2,1
S01011204,Owned: Total,203,137,116,14,102,21,0,66,66,0,0,0,0
S01011204,Owned: Owned outright,92,40,37,6,31,3,0,52,52,0,0,0,0
S01011204,Owned: Owned with a mortgage or loan or shared ownership,111,97,79,8,71,18,0,14,14,0,0,0,0
S01011204,Rented or living rent free: Total,32,20,16,4,12,3,1,12,8,0,1,2,1
S01011204,Rented or living rent free: Social rented,14,4,3,1,2,1,0,10,7,0,0,2,1
S01011204,Rented or living rent free: Private rented or living rent free,18,16,13,3,10,2,1,2,1,0,1,0,0
S01011205,All HRPs aged 16 and over,237,217,184,24,160,25,8,20,11,0,2,4,3
S01011205,Owned: Total,187,176,151,11,140,24,1,11,9,0,0,0,2
S01011205,Owned: Owned outright,28,19,11,1,10,7,1,9,7,0,0,0,2
S01011205,Owned: Owned with a mortgage or loan or shared ownership,159,157,140,10,130,17,0,2,2,0,0,0,0
S01011205,Rented or living rent free: Total,50,41,33,13,20,1,7,9,2,0,2,4,1
S01011205,Rented or living rent free: Social rented,39,31,24,12,12,0,7,8,2,0,2,3,1
S01011205,Rented or living rent free: Private rented or living rent free,11,10,9,1,8,1,0,1,0,0,0,1,0
S01011206,All HRPs aged 16 and over,264,223,192,22,170,27,4,41,33,0,2,6,0
S01011206,Owned: Total,222,191,173,14,159,17,1,31,26,0,1,4,0
S01011206,Owned: Owned outright,55,27,20,4,16,6,1,28,25,0,0,3,0
S01011206,Owned: Owned with a mortgage or loan or shared ownership,167,164,153,10,143,11,0,3,1,0,1,1,0
S01011206,Rented or living rent free: Total,42,32,19,8,11,10,3,10,7,0,1,2,0
S01011206,Rented or living rent free: Social rented,25,16,10,4,6,6,0,9,7,0,0,2,0
S01011206,Rented or living rent free: Private rented or living rent free,17,16,9,4,5,4,3,1,0,0,1,0,0
S01011207,All HRPs aged 16 and over,326,205,175,24,151,21,9,121,90,1,5,16,9
S01011207,Owned: Total,182,147,127,10,117,19,1,35,31,0,3,1,0
S01011207,Owned: Owned outright,51,28,23,6,17,4,1,23,22,0,1,0,0
S01011207,Owned: Owned with a mortgage or loan or shared ownership,131,119,104,4,100,15,0,12,9,0,2,1,0
S01011207,Rented or living rent free: Total,144,58,48,14,34,2,8,86,59,1,2,15,9
S01011207,Rented or living rent free: Social rented,133,50,40,13,27,2,8,83,58,1,1,14,9
S01011207,Rented or living rent free: Private rented or living rent free,11,8,8,1,7,0,0,3,1,0,1,1,0
S01011208,All HRPs aged 16 and over,345,277,241,23,218,28,8,68,61,2,1,3,1
S01011208,Owned: Total,312,265,233,22,211,28,4,47,43,1,0,2,1
S01011208,Owned: Owned outright,71,37,30,5,25,7,0,34,32,0,0,1,1
S01011208,Owned: Owned with a mortgage or loan or shared ownership,241,228,203,17,186,21,4,13,11,1,0,1,0
S01011208,Rented or living rent free: Total,33,12,8,1,7,0,4,21,18,1,1,1,0
S01011208,Rented or living rent free: Social rented,19,4,3,0,3,0,1,15,15,0,0,0,0
S01011208,Rented or living rent free: Private rented or living rent free,14,8,5,1,4,0,3,6,3,1,1,1,0
S01011209,All HRPs aged 16 and over,283,174,147,29,118,12,15,109,80,1,9,14,5
S01011209,Owned: Total,138,105,93,16,77,8,4,33,30,0,2,1,0
S01011209,Owned: Owned outright,48,21,17,6,11,3,1,27,26,0,1,0,0
S01011209,Owned: Owned with a mortgage or loan or shared ownership,90,84,76,10,66,5,3,6,4,0,1,1,0
S01011209,Rented or living rent free: Total,145,69,54,13,41,4,11,76,50,1,7,13,5
S01011209,Rented or living rent free: Social rented,131,60,48,12,36,3,9,71,50,1,4,12,4
S01011209,Rented or living rent free: Private rented or living rent free,14,9,6,1,5,1,2,5,0,0,3,1,1
S01011210,All HRPs aged 16 and over,272,196,148,16,132,42,6,76,61,1,2,10,2
S01011210,Owned: Total,204,161,120,9,111,40,1,43,41,1,0,1,0
S01011210,Owned: Owned outright,77,40,29,3,26,10,1,37,36,1,0,0,0
S01011210,Owned: Owned with a mortgage or loan or shared ownership,127,121,91,6,85,30,0,6,5,0,0,1,0
S01011210,Rented or living rent free: Total,68,35,28,7,21,2,5,33,20,0,2,9,2
S01011210,Rented or living rent free: Social rented,64,31,25,7,18,1,5,33,20,0,2,9,2
S01011210,Rented or living rent free: Private rented or living rent free,4,4,3,0,3,1,0,0,0,0,0,0,0
S01011211,All HRPs aged 16 and over,252,202,182,27,155,17,3,50,40,0,4,5,1
S01011211,Owned: Total,206,179,163,20,143,15,1,27,26,0,1,0,0
S01011211,Owned: Owned outright,38,29,25,6,19,4,0,9,8,0,1,0,0
S01011211,Owned: Owned with a mortgage or loan or shared ownership,168,150,138,14,124,11,1,18,18,0,0,0,0
S01011211,Rented or living rent free: Total,46,23,19,7,12,2,2,23,14,0,3,5,1
S01011211,Rented or living rent free: Social rented,33,18,15,7,8,1,2,15,10,0,3,2,0
S01011211,Rented or living rent free: Private rented or living rent free,13,5,4,0,4,1,0,8,4,0,0,3,1
S01011212,All HRPs aged 16 and over,213,130,105,22,83,18,7,83,55,1,15,12,0
S01011212,Owned: Total,118,81,69,8,61,11,1,37,33,0,1,3,0
S01011212,Owned: Owned outright,36,14,11,3,8,2,1,22,20,0,1,1,0
S01011212,Owned: Owned with a mortgage or loan or shared ownership,82,67,58,5,53,9,0,15,13,0,0,2,0
S01011212,Rented or living rent free: Total,95,49,36,14,22,7,6,46,22,1,14,9,0
S01011212,Rented or living rent free: Social rented,72,38,27,13,14,7,4,34,21,1,7,5,0
S01011212,Rented or living rent free: Private rented or living rent free,23,11,9,1,8,0,2,12,1,0,7,4,0
S01011213,All HRPs aged 16 and over,421,278,224,54,170,17,37,143,88,4,16,27,8
S01011213,Owned: Total,233,165,146,20,126,15,4,68,54,2,5,5,2
S01011213,Owned: Owned outright,87,37,32,5,27,4,1,50,43,0,2,3,2
S01011213,Owned: Owned with a mortgage or loan or shared ownership,146,128,114,15,99,11,3,18,11,2,3,2,0
S01011213,Rented or living rent free: Total,188,113,78,34,44,2,33,75,34,2,11,22,6
S01011213,Rented or living rent free: Social rented,130,74,52,25,27,1,21,56,31,2,4,16,3
S01011213,Rented or living rent free: Private rented or living rent free,58,39,26,9,17,1,12,19,3,0,7,6,3
S01011214,All HRPs aged 16 and over,349,206,167,45,122,15,24,143,89,3,23,24,4
S01011214,Owned: Total,195,117,107,17,90,10,0,78,73,0,1,4,0
S01011214,Owned: Owned outright,92,28,26,7,19,2,0,64,62,0,0,2,0
S01011214,Owned: Owned with a mortgage or loan or shared ownership,103,89,81,10,71,8,0,14,11,0,1,2,0
S01011214,Rented or living rent free: Total,154,89,60,28,32,5,24,65,16,3,22,20,4
S01011214,Rented or living rent free: Social rented,107,61,44,16,28,3,14,46,16,2,11,15,2
S01011214,Rented or living rent free: Private rented or living rent free,47,28,16,12,4,2,10,19,0,1,11,5,2
S01011215,All HRPs aged 16 and over,260,144,100,30,70,9,35,116,62,1,11,35,7
S01011215,Owned: Total,86,55,47,9,38,7,1,31,27,0,0,3,1
S01011215,Owned: Owned outright,35,10,10,5,5,0,0,25,23,0,0,2,0
S01011215,Owned: Owned with a mortgage or loan or shared ownership,51,45,37,4,33,7,1,6,4,0,0,1,1
S01011215,Rented or living rent free: Total,174,89,53,21,32,2,34,85,35,1,11,32,6
S01011215,Rented or living rent free: Social rented,154,76,49,20,29,2,25,78,34,1,8,29,6
S01011215,Rented or living rent free: Private rented or living rent free,20,13,4,1,3,0,9,7,1,0,3,3,0
S01011216,All HRPs aged 16 and over,240,149,108,25,83,13,28,91,58,6,3,17,7
S01011216,Owned: Total,111,65,59,9,50,5,1,46,42,2,0,2,0
S01011216,Owned: Owned outright,52,13,12,4,8,0,1,39,37,1,0,1,0
S01011216,Owned: Owned with a mortgage or loan or shared ownership,59,52,47,5,42,5,0,7,5,1,0,1,0
S01011216,Rented or living rent free: Total,129,84,49,16,33,8,27,45,16,4,3,15,7
S01011216,Rented or living rent free: Social rented,100,63,39,14,25,8,16,37,14,4,2,12,5
S01011216,Rented or living rent free: Private rented or living rent free,29,21,10,2,8,0,11,8,2,0,1,3,2
S01011217,All HRPs aged 16 and over,380,227,155,52,103,20,52,153,97,1,14,34,7
S01011217,Owned: Total,165,101,80,21,59,15,6,64,62,0,0,2,0
S01011217,Owned: Owned outright,79,25,20,10,10,1,4,54,53,0,0,1,0
S01011217,Owned: Owned with a mortgage or loan or shared ownership,86,76,60,11,49,14,2,10,9,0,0,1,0
S01011217,Rented or living rent free: Total,215,126,75,31,44,5,46,89,35,1,14,32,7
S01011217,Rented or living rent free: Social rented,170,94,59,25,34,2,33,76,30,1,9,30,6
S01011217,Rented or living rent free: Private rented or living rent free,45,32,16,6,10,3,13,13,5,0,5,2,1
S01011218,All HRPs aged 16 and over,282,168,121,32,89,14,33,114,60,6,16,22,10
S01011218,Owned: Total,80,62,50,5,45,9,3,18,17,0,0,1,0
S01011218,Owned: Owned outright,24,12,5,1,4,5,2,12,12,0,0,0,0
S01011218,Owned: Owned with a mortgage or loan or shared ownership,56,50,45,4,41,4,1,6,5,0,0,1,0
S01011218,Rented or living rent free: Total,202,106,71,27,44,5,30,96,43,6,16,21,10
S01011218,Rented or living rent free: Social rented,166,85,59,20,39,1,25,81,38,4,10,19,10
S01011218,Rented or living rent free: Private rented or living rent free,36,21,12,7,5,4,5,15,5,2,6,2,0
S01011219,All HRPs aged 16 and over,352,211,164,41,123,22,25,141,98,1,14,24,4
S01011219,Owned: Total,170,107,91,14,77,12,4,63,55,1,2,4,1
S01011219,Owned: Owned outright,64,24,21,9,12,3,0,40,36,1,0,3,0
S01011219,Owned: Owned with a mortgage or loan or shared ownership,106,83,70,5,65,9,4,23,19,0,2,1,1
S01011219,Rented or living rent free: Total,182,104,73,27,46,10,21,78,43,0,12,20,3
S01011219,Rented or living rent free: Social rented,154,83,59,22,37,9,15,71,43,0,10,16,2
S01011219,Rented or living rent free: Private rented or living rent free,28,21,14,5,9,1,6,7,0,0,2,4,1
S01011220,All HRPs aged 16 and over,425,236,185,46,139,22,29,189,125,2,9,45,8
S01011220,Owned: Total,237,151,129,19,110,18,4,86,82,0,0,3,1
S01011220,Owned: Owned outright,93,30,24,7,17,3,3,63,61,0,0,1,1
S01011220,Owned: Owned with a mortgage or loan or shared ownership,144,121,105,12,93,15,1,23,21,0,0,2,0
S01011220,Rented or living rent free: Total,188,85,56,27,29,4,25,103,43,2,9,42,7
S01011220,Rented or living rent free: Social rented,150,67,46,21,25,1,20,83,41,1,7,31,3
S01011220,Rented or living rent free: Private rented or living rent free,38,18,10,6,4,3,5,20,2,1,2,11,4
S01011221,All HRPs aged 16 and over,449,281,235,44,191,20,26,168,113,3,9,28,15
S01011221,Owned: Total,272,175,161,18,143,9,5,97,86,1,2,6,2
S01011221,Owned: Owned outright,110,38,34,7,27,2,2,72,68,0,0,3,1
S01011221,Owned: Owned with a mortgage or loan or shared ownership,162,137,127,11,116,7,3,25,18,1,2,3,1
S01011221,Rented or living rent free: Total,177,106,74,26,48,11,21,71,27,2,7,22,13
S01011221,Rented or living rent free: Social rented,128,77,52,18,34,10,15,51,23,2,0,17,9
S01011221,Rented or living rent free: Private rented or living rent free,49,29,22,8,14,1,6,20,4,0,7,5,4
S01011222,All HRPs aged 16 and over,312,178,143,25,118,18,17,134,104,2,10,17,1
S01011222,Owned: Total,178,107,92,13,79,13,2,71,65,0,0,6,0
S01011222,Owned: Owned outright,75,23,18,5,13,3,2,52,47,0,0,5,0
S01011222,Owned: Owned with a mortgage or loan or shared ownership,103,84,74,8,66,10,0,19,18,0,0,1,0
S01011222,Rented or living rent free: Total,134,71,51,12,39,5,15,63,39,2,10,11,1
S01011222,Rented or living rent free: Social rented,115,60,45,12,33,4,11,55,36,2,6,11,0
S01011222,Rented or living rent free: Private rented or living rent free,19,11,6,0,6,1,4,8,3,0,4,0,1
S01011223,All HRPs aged 16 and over,361,225,193,32,161,22,10,136,114,1,6,12,3
S01011223,Owned: Total,230,164,144,15,129,19,1,66,63,0,1,1,1
S01011223,Owned: Owned outright,84,30,24,7,17,5,1,54,53,0,0,1,0
S01011223,Owned: Owned with a mortgage or loan or shared ownership,146,134,120,8,112,14,0,12,10,0,1,0,1
S01011223,Rented or living rent free: Total,131,61,49,17,32,3,9,70,51,1,5,11,2
S01011223,Rented or living rent free: Social rented,99,41,32,13,19,3,6,58,43,1,3,11,0
S01011223,Rented or living rent free: Private rented or living rent free,32,20,17,4,13,0,3,12,8,0,2,0,2
S01011224,All HRPs aged 16 and over,350,166,131,26,105,20,15,184,131,2,5,36,10
S01011224,Owned: Total,176,104,90,12,78,11,3,72,65,1,1,5,0
S01011224,Owned: Owned outright,87,28,20,3,17,6,2,59,54,0,1,4,0
S01011224,Owned: Owned with a mortgage or loan or shared ownership,89,76,70,9,61,5,1,13,11,1,0,1,0
S01011224,Rented or living rent free: Total,174,62,41,14,27,9,12,112,66,1,4,31,10
S01011224,Rented or living rent free: Social rented,144,45,32,11,21,5,8,99,60,0,1,30,8
S01011224,Rented or living rent free: Private rented or living rent free,30,17,9,3,6,4,4,13,6,1,3,1,2
S01011225,All HRPs aged 16 and over,327,182,141,35,106,16,25,145,88,3,7,35,12
S01011225,Owned: Total,117,69,57,8,49,9,3,48,45,0,0,3,0
S01011225,Owned: Owned outright,57,17,13,5,8,3,1,40,39,0,0,1,0
S01011225,Owned: Owned with a mortgage or loan or shared ownership,60,52,44,3,41,6,2,8,6,0,0,2,0
S01011225,Rented or living rent free: Total,210,113,84,27,57,7,22,97,43,3,7,32,12
S01011225,Rented or living rent free: Social rented,163,77,54,22,32,7,16,86,39,3,5,29,10
S01011225,Rented or living rent free: Private rented or living rent free,47,36,30,5,25,0,6,11,4,0,2,3,2
S01011226,All HRPs aged 16 and over,455,232,194,26,168,29,9,223,202,0,3,13,5
S01011226,Owned: Total,361,200,172,20,152,25,3,161,153,0,0,6,2
S01011226,Owned: Owned outright,199,59,52,13,39,6,1,140,136,0,0,2,2
S01011226,Owned: Owned with a mortgage or loan or shared ownership,162,141,120,7,113,19,2,21,17,0,0,4,0
S01011226,Rented or living rent free: Total,94,32,22,6,16,4,6,62,49,0,3,7,3
S01011226,Rented or living rent free: Social rented,66,10,9,4,5,1,0,56,46,0,2,6,2
S01011226,Rented or living rent free: Private rented or living rent free,28,22,13,2,11,3,6,6,3,0,1,1,1
S01011227,All HRPs aged 16 and over,397,240,182,29,153,30,28,157,101,1,18,28,9
S01011227,Owned: Total,218,144,118,14,104,21,5,74,65,0,2,5,2
S01011227,Owned: Owned outright,91,33,25,6,19,5,3,58,51,0,2,3,2
S01011227,Owned: Owned with a mortgage or loan or shared ownership,127,111,93,8,85,16,2,16,14,0,0,2,0
S01011227,Rented or living rent free: Total,179,96,64,15,49,9,23,83,36,1,16,23,7
S01011227,Rented or living rent free: Social rented,99,48,30,7,23,2,16,51,26,1,5,13,6
S01011227,Rented or living rent free: Private rented or living rent free,80,48,34,8,26,7,7,32,10,0,11,10,1
S01011228,All HRPs aged 16 and over,450,233,187,32,155,14,32,217,166,5,7,28,11
S01011228,Owned: Total,209,120,106,13,93,10,4,89,84,1,1,2,1
S01011228,Owned: Owned outright,98,24,20,5,15,2,2,74,72,0,0,2,0
S01011228,Owned: Owned with a mortgage or loan or shared ownership,111,96,86,8,78,8,2,15,12,1,1,0,1
S01011228,Rented or living rent free: Total,241,113,81,19,62,4,28,128,82,4,6,26,10
S01011228,Rented or living rent free: Social rented,156,59,39,12,27,2,18,97,66,2,6,16,7
S01011228,Rented or living rent free: Private rented or living rent free,85,54,42,7,35,2,10,31,16,2,0,10,3
S01011229,All HRPs aged 16 and over,286,147,99,26,73,13,35,139,102,0,11,23,3
S01011229,Owned: Total,117,61,50,6,44,9,2,56,54,0,1,1,0
S01011229,Owned: Owned outright,58,12,7,2,5,3,2,46,44,0,1,1,0
S01011229,Owned: Owned with a mortgage or loan or shared ownership,59,49,43,4,39,6,0,10,10,0,0,0,0
S01011229,Rented or living rent free: Total,169,86,49,20,29,4,33,83,48,0,10,22,3
S01011229,Rented or living rent free: Social rented,129,64,38,17,21,2,24,65,37,0,6,19,3
S01011229,Rented or living rent free: Private rented or living rent free,40,22,11,3,8,2,9,18,11,0,4,3,0
S01011230,All HRPs aged 16 and over,500,243,158,49,109,21,64,257,128,2,28,77,22
S01011230,Owned: Total,81,45,40,10,30,5,0,36,26,0,3,4,3
S01011230,Owned: Owned outright,37,10,7,3,4,3,0,27,21,0,0,3,3
S01011230,Owned: Owned with a mortgage or loan or shared ownership,44,35,33,7,26,2,0,9,5,0,3,1,0
S01011230,Rented or living rent free: Total,419,198,118,39,79,16,64,221,102,2,25,73,19
S01011230,Rented or living rent free: Social rented,401,185,110,36,74,15,60,216,101,2,24,71,18
S01011230,Rented or living rent free: Private rented or living rent free,18,13,8,3,5,1,4,5,1,0,1,2,1
S01011231,All HRPs aged 16 and over,298,135,110,24,86,7,18,163,111,0,18,24,10
S01011231,Owned: Total,116,61,55,3,52,4,2,55,47,0,0,4,4
S01011231,Owned: Owned outright,58,15,12,0,12,1,2,43,39,0,0,2,2
S01011231,Owned: Owned with a mortgage or loan or shared ownership,58,46,43,3,40,3,0,12,8,0,0,2,2
S01011231,Rented or living rent free: Total,182,74,55,21,34,3,16,108,64,0,18,20,6
S01011231,Rented or living rent free: Social rented,159,65,47,21,26,3,15,94,60,0,14,17,3
S01011231,Rented or living rent free: Private rented or living rent free,23,9,8,0,8,0,1,14,4,0,4,3,3
S01011232,All HRPs aged 16 and over,513,335,261,44,217,39,35,178,105,3,6,56,8
S01011232,Owned: Total,165,127,102,12,90,22,3,38,35,0,0,2,1
S01011232,Owned: Owned outright,65,38,30,7,23,7,1,27,26,0,0,0,1
S01011232,Owned: Owned with a mortgage or loan or shared ownership,100,89,72,5,67,15,2,11,9,0,0,2,0
S01011232,Rented or living rent free: Total,348,208,159,32,127,17,32,140,70,3,6,54,7
S01011232,Rented or living rent free: Social rented,280,146,105,23,82,13,28,134,67,3,5,54,5
S01011232,Rented or living rent free: Private rented or living rent free,68,62,54,9,45,4,4,6,3,0,1,0,2
S01011233,All HRPs aged 16 and over,158,87,65,13,52,10,12,71,44,1,9,15,2
S01011233,Owned: Total,93,57,46,6,40,8,3,36,32,0,0,4,0
S01011233,Owned: Owned outright,47,19,12,3,9,5,2,28,27,0,0,1,0
S01011233,Owned: Owned with a mortgage or loan or shared ownership,46,38,34,3,31,3,1,8,5,0,0,3,0
S01011233,Rented or living rent free: Total,65,30,19,7,12,2,9,35,12,1,9,11,2
S01011233,Rented or living rent free: Social rented,43,12,8,4,4,2,2,31,10,1,8,10,2
S01011233,Rented or living rent free: Private rented or living rent free,22,18,11,3,8,0,7,4,2,0,1,1,0
S01011234,All HRPs aged 16 and over,456,265,200,48,152,21,44,191,97,12,17,56,9
S01011234,Owned: Total,195,141,121,12,109,15,5,54,48,1,0,2,3
S01011234,Owned: Owned outright,70,27,22,6,16,3,2,43,39,1,0,0,3
S01011234,Owned: Owned with a mortgage or loan or shared ownership,125,114,99,6,93,12,3,11,9,0,0,2,0
S01011234,Rented or living rent free: Total,261,124,79,36,43,6,39,137,49,11,17,54,6
S01011234,Rented or living rent free: Social rented,230,103,69,33,36,5,29,127,45,10,14,52,6
S01011234,Rented or living rent free: Private rented or living rent free,31,21,10,3,7,1,10,10,4,1,3,2,0
S01011235,All HRPs aged 16 and over,195,94,70,20,50,10,14,101,49,4,6,38,4
S01011235,Owned: Total,76,47,37,10,27,9,1,29,25,0,0,4,0
S01011235,Owned: Owned outright,32,11,8,1,7,3,0,21,20,0,0,1,0
S01011235,Owned: Owned with a mortgage or loan or shared ownership,44,36,29,9,20,6,1,8,5,0,0,3,0
S01011235,Rented or living rent free: Total,119,47,33,10,23,1,13,72,24,4,6,34,4
S01011235,Rented or living rent free: Social rented,95,35,25,6,19,0,10,60,21,3,5,29,2
S01011235,Rented or living rent free: Private rented or living rent free,24,12,8,4,4,1,3,12,3,1,1,5,2
S01011236,All HRPs aged 16 and over,284,152,126,30,96,12,14,132,90,0,18,22,2
S01011236,Owned: Total,161,103,90,15,75,11,2,58,56,0,0,2,0
S01011236,Owned: Owned outright,75,27,20,5,15,7,0,48,48,0,0,0,0
S01011236,Owned: Owned with a mortgage or loan or shared ownership,86,76,70,10,60,4,2,10,8,0,0,2,0
S01011236,Rented or living rent free: Total,123,49,36,15,21,1,12,74,34,0,18,20,2
S01011236,Rented or living rent free: Social rented,89,30,20,8,12,1,9,59,29,0,12,16,2
S01011236,Rented or living rent free: Private rented or living rent free,34,19,16,7,9,0,3,15,5,0,6,4,0
S01011237,All HRPs aged 16 and over,331,193,154,38,116,15,24,138,90,4,12,32,0
S01011237,Owned: Total,158,101,87,11,76,13,1,57,52,0,1,4,0
S01011237,Owned: Owned outright,60,23,18,6,12,4,1,37,37,0,0,0,0
S01011237,Owned: Owned with a mortgage or loan or shared ownership,98,78,69,5,64,9,0,20,15,0,1,4,0
S01011237,Rented or living rent free: Total,173,92,67,27,40,2,23,81,38,4,11,28,0
S01011237,Rented or living rent free: Social rented,148,78,58,24,34,0,20,70,35,3,8,24,0
S01011237,Rented or living rent free: Private rented or living rent free,25,14,9,3,6,2,3,11,3,1,3,4,0
S01011238,All HRPs aged 16 and over,334,192,135,41,94,13,44,142,76,0,9,48,9
S01011238,Owned: Total,108,70,52,14,38,12,6,38,34,0,0,3,1
S01011238,Owned: Owned outright,47,15,11,5,6,3,1,32,30,0,0,1,1
S01011238,Owned: Owned with a mortgage or loan or shared ownership,61,55,41,9,32,9,5,6,4,0,0,2,0
S01011238,Rented or living rent free: Total,226,122,83,27,56,1,38,104,42,0,9,45,8
S01011238,Rented or living rent free: Social rented,187,98,67,25,42,1,30,89,39,0,6,36,8
S01011238,Rented or living rent free: Private rented or living rent free,39,24,16,2,14,0,8,15,3,0,3,9,0
S01011239,All HRPs aged 16 and over,427,226,155,38,117,24,47,201,139,1,6,44,11
S01011239,Owned: Total,178,112,91,11,80,16,5,66,58,0,0,6,2
S01011239,Owned: Owned outright,96,43,34,7,27,6,3,53,50,0,0,3,0
S01011239,Owned: Owned with a mortgage or loan or shared ownership,82,69,57,4,53,10,2,13,8,0,0,3,2
S01011239,Rented or living rent free: Total,249,114,64,27,37,8,42,135,81,1,6,38,9
S01011239,Rented or living rent free: Social rented,165,59,37,18,19,7,15,106,72,0,3,27,4
S01011239,Rented or living rent free: Private rented or living rent free,84,55,27,9,18,1,27,29,9,1,3,11,5
S01011240,All HRPs aged 16 and over,481,260,176,38,138,23,61,221,128,1,4,65,23
S01011240,Owned: Total,166,104,87,12,75,13,4,62,51,0,0,9,2
S01011240,Owned: Owned outright,70,19,13,2,11,2,4,51,45,0,0,6,0
S01011240,Owned: Owned with a mortgage or loan or shared ownership,96,85,74,10,64,11,0,11,6,0,0,3,2
S01011240,Rented or living rent free: Total,315,156,89,26,63,10,57,159,77,1,4,56,21
S01011240,Rented or living rent free: Social rented,190,81,46,13,33,5,30,109,67,0,3,28,11
S01011240,Rented or living rent free: Private rented or living rent free,125,75,43,13,30,5,27,50,10,1,1,28,10
S01011241,All HRPs aged 16 and over,540,284,214,39,175,40,30,256,192,5,2,46,11
S01011241,Owned: Total,313,192,154,25,129,35,3,121,116,0,0,4,1
S01011241,Owned: Owned outright,151,53,40,12,28,11,2,98,93,0,0,4,1
S01011241,Owned: Owned with a mortgage or loan or shared ownership,162,139,114,13,101,24,1,23,23,0,0,0,0
S01011241,Rented or living rent free: Total,227,92,60,14,46,5,27,135,76,5,2,42,10
S01011241,Rented or living rent free: Social rented,107,24,16,3,13,2,6,83,51,1,2,24,5
S01011241,Rented or living rent free: Private rented or living rent free,120,68,44,11,33,3,21,52,25,4,0,18,5
S01011242,All HRPs aged 16 and over,383,202,165,40,125,22,15,181,126,1,5,36,13
S01011242,Owned: Total,224,134,113,23,90,18,3,90,81,0,0,5,4
S01011242,Owned: Owned outright,108,38,31,11,20,6,1,70,67,0,0,1,2
S01011242,Owned: Owned with a mortgage or loan or shared ownership,116,96,82,12,70,12,2,20,14,0,0,4,2
S01011242,Rented or living rent free: Total,159,68,52,17,35,4,12,91,45,1,5,31,9
S01011242,Rented or living rent free: Social rented,115,44,34,15,19,3,7,71,36,1,2,26,6
S01011242,Rented or living rent free: Private rented or living rent free,44,24,18,2,16,1,5,20,9,0,3,5,3
S01011243,All HRPs aged 16 and over,545,275,187,48,139,19,69,270,167,4,16,69,14
S01011243,Owned: Total,133,91,73,10,63,13,5,42,40,0,1,0,1
S01011243,Owned: Owned outright,50,22,14,1,13,6,2,28,28,0,0,0,0
S01011243,Owned: Owned with a mortgage or loan or shared ownership,83,69,59,9,50,7,3,14,12,0,1,0,1
S01011243,Rented or living rent free: Total,412,184,114,38,76,6,64,228,127,4,15,69,13
S01011243,Rented or living rent free: Social rented,305,115,71,29,42,2,42,190,119,2,7,53,9
S01011243,Rented or living rent free: Private rented or living rent free,107,69,43,9,34,4,22,38,8,2,8,16,4
S01011244,All HRPs aged 16 and over,409,242,170,48,122,8,64,167,81,5,9,67,5
S01011244,Owned: Total,119,87,75,13,62,5,7,32,25,0,2,5,0
S01011244,Owned: Owned outright,48,22,14,2,12,3,5,26,20,0,2,4,0
S01011244,Owned: Owned with a mortgage or loan or shared ownership,71,65,61,11,50,2,2,6,5,0,0,1,0
S01011244,Rented or living rent free: Total,290,155,95,35,60,3,57,135,56,5,7,62,5
S01011244,Rented or living rent free: Social rented,203,98,58,20,38,1,39,105,43,5,3,50,4
S01011244,Rented or living rent free: Private rented or living rent free,87,57,37,15,22,2,18,30,13,0,4,12,1
S01011245,All HRPs aged 16 and over,446,239,168,50,118,16,55,207,125,3,11,57,11
S01011245,Owned: Total,176,103,93,14,79,10,0,73,64,0,1,7,1
S01011245,Owned: Owned outright,84,25,23,5,18,2,0,59,53,0,1,4,1
S01011245,Owned: Owned with a mortgage or loan or shared ownership,92,78,70,9,61,8,0,14,11,0,0,3,0
S01011245,Rented or living rent free: Total,270,136,75,36,39,6,55,134,61,3,10,50,10
S01011245,Rented or living rent free: Social rented,243,124,70,34,36,6,48,119,56,3,6,45,9
S01011245,Rented or living rent free: Private rented or living rent free,27,12,5,2,3,0,7,15,5,0,4,5,1
S01011246,All HRPs aged 16 and over,439,287,210,41,169,48,29,152,125,0,4,20,3
S01011246,Owned: Total,310,207,158,24,134,41,8,103,99,0,0,4,0
S01011246,Owned: Owned outright,156,77,63,19,44,8,6,79,77,0,0,2,0
S01011246,Owned: Owned with a mortgage or loan or shared ownership,154,130,95,5,90,33,2,24,22,0,0,2,0
S01011246,Rented or living rent free: Total,129,80,52,17,35,7,21,49,26,0,4,16,3
S01011246,Rented or living rent free: Social rented,50,26,19,8,11,0,7,24,12,0,2,8,2
S01011246,Rented or living rent free: Private rented or living rent free,79,54,33,9,24,7,14,25,14,0,2,8,1
S01011247,All HRPs aged 16 and over,357,203,171,20,151,24,8,154,146,0,1,6,1
S01011247,Owned: Total,311,175,150,14,136,21,4,136,131,0,1,3,1
S01011247,Owned: Owned outright,169,52,40,8,32,10,2,117,113,0,1,2,1
S01011247,Owned: Owned with a mortgage or loan or shared ownership,142,123,110,6,104,11,2,19,18,0,0,1,0
S01011247,Rented or living rent free: Total,46,28,21,6,15,3,4,18,15,0,0,3,0
S01011247,Rented or living rent free: Social rented,20,13,10,4,6,2,1,7,5,0,0,2,0
S01011247,Rented or living rent free: Private rented or living rent free,26,15,11,2,9,1,3,11,10,0,0,1,0
S01011248,All HRPs aged 16 and over,317,215,190,32,158,19,6,102,86,0,3,10,3
S01011248,Owned: Total,250,179,158,22,136,18,3,71,63,0,1,5,2
S01011248,Owned: Owned outright,104,42,34,7,27,7,1,62,56,0,1,4,1
S01011248,Owned: Owned with a mortgage or loan or shared ownership,146,137,124,15,109,11,2,9,7,0,0,1,1
S01011248,Rented or living rent free: Total,67,36,32,10,22,1,3,31,23,0,2,5,1
S01011248,Rented or living rent free: Social rented,43,17,16,7,9,0,1,26,20,0,1,4,1
S01011248,Rented or living rent free: Private rented or living rent free,24,19,16,3,13,1,2,5,3,0,1,1,0
S01011249,All HRPs aged 16 and over,308,207,184,20,164,14,9,101,93,2,1,4,1
S01011249,Owned: Total,278,187,172,19,153,11,4,91,87,1,1,2,0
S01011249,Owned: Owned outright,118,44,41,9,32,2,1,74,73,0,0,1,0
S01011249,Owned: Owned with a mortgage or loan or shared ownership,160,143,131,10,121,9,3,17,14,1,1,1,0
S01011249,Rented or living rent free: Total,30,20,12,1,11,3,5,10,6,1,0,2,1
S01011249,Rented or living rent free: Social rented,12,7,3,0,3,1,3,5,4,0,0,1,0
S01011249,Rented or living rent free: Private rented or living rent free,18,13,9,1,8,2,2,5,2,1,0,1,1
S01011250,All HRPs aged 16 and over,446,302,234,69,165,25,43,144,66,2,22,42,12
S01011250,Owned: Total,213,159,136,17,119,18,5,54,41,0,1,10,2
S01011250,Owned: Owned outright,58,18,14,4,10,3,1,40,31,0,0,8,1
S01011250,Owned: Owned with a mortgage or loan or shared ownership,155,141,122,13,109,15,4,14,10,0,1,2,1
S01011250,Rented or living rent free: Total,233,143,98,52,46,7,38,90,25,2,21,32,10
S01011250,Rented or living rent free: Social rented,204,130,93,49,44,6,31,74,22,2,15,29,6
S01011250,Rented or living rent free: Private rented or living rent free,29,13,5,3,2,1,7,16,3,0,6,3,4
S01011251,All HRPs aged 16 and over,385,236,196,52,144,21,19,149,102,6,13,20,8
S01011251,Owned: Total,202,130,111,11,100,15,4,72,62,0,2,5,3
S01011251,Owned: Owned outright,81,32,29,4,25,3,0,49,44,0,0,3,2
S01011251,Owned: Owned with a mortgage or loan or shared ownership,121,98,82,7,75,12,4,23,18,0,2,2,1
S01011251,Rented or living rent free: Total,183,106,85,41,44,6,15,77,40,6,11,15,5
S01011251,Rented or living rent free: Social rented,143,85,71,33,38,5,9,58,36,3,4,13,2
S01011251,Rented or living rent free: Private rented or living rent free,40,21,14,8,6,1,6,19,4,3,7,2,3
S01011252,All HRPs aged 16 and over,344,213,176,54,122,8,29,131,68,1,20,33,9
S01011252,Owned: Total,129,87,77,10,67,6,4,42,35,0,2,4,1
S01011252,Owned: Owned outright,38,11,10,2,8,0,1,27,26,0,0,1,0
S01011252,Owned: Owned with a mortgage or loan or shared ownership,91,76,67,8,59,6,3,15,9,0,2,3,1
S01011252,Rented or living rent free: Total,215,126,99,44,55,2,25,89,33,1,18,29,8
S01011252,Rented or living rent free: Social rented,186,108,87,40,47,2,19,78,29,1,15,26,7
S01011252,Rented or living rent free: Private rented or living rent free,29,18,12,4,8,0,6,11,4,0,3,3,1
S01011253,All HRPs aged 16 and over,391,215,178,49,129,12,25,176,98,3,13,49,13
S01011253,Owned: Total,133,102,89,16,73,10,3,31,27,0,0,3,1
S01011253,Owned: Owned outright,44,19,14,4,10,3,2,25,23,0,0,1,1
S01011253,Owned: Owned with a mortgage or loan or shared ownership,89,83,75,12,63,7,1,6,4,0,0,2,0
S01011253,Rented or living rent free: Total,258,113,89,33,56,2,22,145,71,3,13,46,12
S01011253,Rented or living rent free: Social rented,233,99,78,28,50,2,19,134,70,1,11,43,9
S01011253,Rented or living rent free: Private rented or living rent free,25,14,11,5,6,0,3,11,1,2,2,3,3
S01011254,All HRPs aged 16 and over,359,271,243,26,217,23,5,88,83,1,1,3,0
S01011254,Owned: Total,339,259,234,23,211,21,4,80,77,0,1,2,0
S01011254,Owned: Owned outright,134,66,56,16,40,8,2,68,66,0,1,1,0
S01011254,Owned: Owned with a mortgage or loan or shared ownership,205,193,178,7,171,13,2,12,11,0,0,1,0
S01011254,Rented or living rent free: Total,20,12,9,3,6,2,1,8,6,1,0,1,0
S01011254,Rented or living rent free: Social rented,6,2,1,0,1,1,0,4,2,1,0,1,0
S01011254,Rented or living rent free: Private rented or living rent free,14,10,8,3,5,1,1,4,4,0,0,0,0
S01011255,All HRPs aged 16 and over,267,222,201,13,188,19,2,45,38,1,3,3,0
S01011255,Owned: Total,256,216,197,12,185,17,2,40,36,1,2,1,0
S01011255,Owned: Owned outright,56,26,25,3,22,1,0,30,29,0,1,0,0
S01011255,Owned: Owned with a mortgage or loan or shared ownership,200,190,172,9,163,16,2,10,7,1,1,1,0
S01011255,Rented or living rent free: Total,11,6,4,1,3,2,0,5,2,0,1,2,0
S01011255,Rented or living rent free: Social rented,6,3,1,1,0,2,0,3,1,0,1,1,0
S01011255,Rented or living rent free: Private rented or living rent free,5,3,3,0,3,0,0,2,1,0,0,1,0
S01011256,All HRPs aged 16 and over,169,144,123,11,112,19,2,25,18,0,5,2,0
S01011256,Owned: Total,150,129,111,9,102,16,2,21,17,0,4,0,0
S01011256,Owned: Owned outright,30,14,12,3,9,2,0,16,15,0,1,0,0
S01011256,Owned: Owned with a mortgage or loan or shared ownership,120,115,99,6,93,14,2,5,2,0,3,0,0
S01011256,Rented or living rent free: Total,19,15,12,2,10,3,0,4,1,0,1,2,0
S01011256,Rented or living rent free: Social rented,7,5,2,0,2,3,0,2,0,0,0,2,0
S01011256,Rented or living rent free: Private rented or living rent free,12,10,10,2,8,0,0,2,1,0,1,0,0
S01011257,All HRPs aged 16 and over,188,86,74,13,61,12,0,102,99,1,2,0,0
S01011257,Owned: Total,179,80,70,13,57,10,0,99,98,1,0,0,0
S01011257,Owned: Owned outright,130,37,29,9,20,8,0,93,92,1,0,0,0
S01011257,Owned: Owned with a mortgage or loan or shared ownership,49,43,41,4,37,2,0,6,6,0,0,0,0
S01011257,Rented or living rent free: Total,9,6,4,0,4,2,0,3,1,0,2,0,0
S01011257,Rented or living rent free: Social rented,5,2,1,0,1,1,0,3,1,0,2,0,0
S01011257,Rented or living rent free: Private rented or living rent free,4,4,3,0,3,1,0,0,0,0,0,0,0
S01011258,All HRPs aged 16 and over,229,141,115,11,104,22,4,88,80,0,3,5,0
S01011258,Owned: Total,191,121,100,8,92,20,1,70,65,0,2,3,0
S01011258,Owned: Owned outright,78,23,19,2,17,4,0,55,54,0,0,1,0
S01011258,Owned: Owned with a mortgage or loan or shared ownership,113,98,81,6,75,16,1,15,11,0,2,2,0
S01011258,Rented or living rent free: Total,38,20,15,3,12,2,3,18,15,0,1,2,0
S01011258,Rented or living rent free: Social rented,28,12,11,2,9,0,1,16,14,0,0,2,0
S01011258,Rented or living rent free: Private rented or living rent free,10,8,4,1,3,2,2,2,1,0,1,0,0
S01011259,All HRPs aged 16 and over,383,201,151,29,122,30,20,182,153,0,7,21,1
S01011259,Owned: Total,235,143,112,15,97,29,2,92,87,0,0,5,0
S01011259,Owned: Owned outright,125,42,30,5,25,11,1,83,79,0,0,4,0
S01011259,Owned: Owned with a mortgage or loan or shared ownership,110,101,82,10,72,18,1,9,8,0,0,1,0
S01011259,Rented or living rent free: Total,148,58,39,14,25,1,18,90,66,0,7,16,1
S01011259,Rented or living rent free: Social rented,106,31,25,10,15,0,6,75,59,0,4,11,1
S01011259,Rented or living rent free: Private rented or living rent free,42,27,14,4,10,1,12,15,7,0,3,5,0
S01011260,All HRPs aged 16 and over,336,181,142,15,127,24,15,155,133,2,1,14,5
S01011260,Owned: Total,279,152,127,12,115,20,5,127,119,2,1,2,3
S01011260,Owned: Owned outright,166,52,39,5,34,8,5,114,110,0,1,1,2
S01011260,Owned: Owned with a mortgage or loan or shared ownership,113,100,88,7,81,12,0,13,9,2,0,1,1
S01011260,Rented or living rent free: Total,57,29,15,3,12,4,10,28,14,0,0,12,2
S01011260,Rented or living rent free: Social rented,35,13,6,1,5,2,5,22,12,0,0,10,0
S01011260,Rented or living rent free: Private rented or living rent free,22,16,9,2,7,2,5,6,2,0,0,2,2
S01011261,All HRPs aged 16 and over,310,175,133,45,88,15,27,135,89,3,19,21,3
S01011261,Owned: Total,144,85,70,13,57,9,6,59,50,1,3,4,1
S01011261,Owned: Owned outright,55,16,14,2,12,1,1,39,36,1,1,1,0
S01011261,Owned: Owned with a mortgage or loan or shared ownership,89,69,56,11,45,8,5,20,14,0,2,3,1
S01011261,Rented or living rent free: Total,166,90,63,32,31,6,21,76,39,2,16,17,2
S01011261,Rented or living rent free: Social rented,148,78,57,26,31,5,16,70,39,2,12,15,2
S01011261,Rented or living rent free: Private rented or living rent free,18,12,6,6,0,1,5,6,0,0,4,2,0
S01011262,All HRPs aged 16 and over,223,125,101,27,74,15,9,98,72,1,2,16,7
S01011262,Owned: Total,139,85,74,15,59,8,3,54,50,0,0,3,1
S01011262,Owned: Owned outright,71,26,19,2,17,4,3,45,43,0,0,2,0
S01011262,Owned: Owned with a mortgage or loan or shared ownership,68,59,55,13,42,4,0,9,7,0,0,1,1
S01011262,Rented or living rent free: Total,84,40,27,12,15,7,6,44,22,1,2,13,6
S01011262,Rented or living rent free: Social rented,63,29,20,9,11,5,4,34,17,1,2,10,4
S01011262,Rented or living rent free: Private rented or living rent free,21,11,7,3,4,2,2,10,5,0,0,3,2
S01011263,All HRPs aged 16 and over,431,323,279,45,234,21,23,108,70,1,13,18,6
S01011263,Owned: Total,280,228,208,20,188,17,3,52,46,0,1,3,2
S01011263,Owned: Owned outright,70,27,23,5,18,3,1,43,40,0,0,2,1
S01011263,Owned: Owned with a mortgage or loan or shared ownership,210,201,185,15,170,14,2,9,6,0,1,1,1
S01011263,Rented or living rent free: Total,151,95,71,25,46,4,20,56,24,1,12,15,4
S01011263,Rented or living rent free: Social rented,104,64,49,17,32,3,12,40,19,1,6,10,4
S01011263,Rented or living rent free: Private rented or living rent free,47,31,22,8,14,1,8,16,5,0,6,5,0
S01011264,All HRPs aged 16 and over,259,171,140,36,104,10,21,88,49,1,16,19,3
S01011264,Owned: Total,124,91,83,12,71,6,2,33,28,0,2,3,0
S01011264,Owned: Owned outright,39,18,15,4,11,2,1,21,18,0,1,2,0
S01011264,Owned: Owned with a mortgage or loan or shared ownership,85,73,68,8,60,4,1,12,10,0,1,1,0
S01011264,Rented or living rent free: Total,135,80,57,24,33,4,19,55,21,1,14,16,3
S01011264,Rented or living rent free: Social rented,106,66,47,17,30,4,15,40,19,1,8,11,1
S01011264,Rented or living rent free: Private rented or living rent free,29,14,10,7,3,0,4,15,2,0,6,5,2
S01011265,All HRPs aged 16 and over,468,304,226,84,142,26,52,164,90,7,11,43,13
S01011265,Owned: Total,150,110,96,17,79,10,4,40,34,2,0,4,0
S01011265,Owned: Owned outright,45,16,14,4,10,1,1,29,29,0,0,0,0
S01011265,Owned: Owned with a mortgage or loan or shared ownership,105,94,82,13,69,9,3,11,5,2,0,4,0
S01011265,Rented or living rent free: Total,318,194,130,67,63,16,48,124,56,5,11,39,13
S01011265,Rented or living rent free: Social rented,277,170,112,59,53,16,42,107,50,4,9,33,11
S01011265,Rented or living rent free: Private rented or living rent free,41,24,18,8,10,0,6,17,6,1,2,6,2
S01011266,All HRPs aged 16 and over,383,215,186,38,148,17,12,168,132,1,13,16,6
S01011266,Owned: Total,265,161,142,19,123,16,3,104,96,0,1,3,4
S01011266,Owned: Owned outright,107,36,28,8,20,6,2,71,67,0,1,0,3
S01011266,Owned: Owned with a mortgage or loan or shared ownership,158,125,114,11,103,10,1,33,29,0,0,3,1
S01011266,Rented or living rent free: Total,118,54,44,19,25,1,9,64,36,1,12,13,2
S01011266,Rented or living rent free: Social rented,95,41,34,15,19,0,7,54,34,0,8,10,2
S01011266,Rented or living rent free: Private rented or living rent free,23,13,10,4,6,1,2,10,2,1,4,3,0
S01011267,All HRPs aged 16 and over,266,143,120,14,106,10,13,123,106,0,3,12,2
S01011267,Owned: Total,200,109,98,8,90,8,3,91,87,0,0,3,1
S01011267,Owned: Owned outright,121,37,34,6,28,3,0,84,82,0,0,1,1
S01011267,Owned: Owned with a mortgage or loan or shared ownership,79,72,64,2,62,5,3,7,5,0,0,2,0
S01011267,Rented or living rent free: Total,66,34,22,6,16,2,10,32,19,0,3,9,1
S01011267,Rented or living rent free: Social rented,48,21,14,5,9,2,5,27,15,0,3,8,1
S01011267,Rented or living rent free: Private rented or living rent free,18,13,8,1,7,0,5,5,4,0,0,1,0
S01011268,All HRPs aged 16 and over,186,99,75,13,62,14,10,87,74,1,1,10,1
S01011268,Owned: Total,121,72,58,8,50,12,2,49,47,0,0,2,0
S01011268,Owned: Owned outright,73,29,20,4,16,8,1,44,42,0,0,2,0
S01011268,Owned: Owned with a mortgage or loan or shared ownership,48,43,38,4,34,4,1,5,5,0,0,0,0
S01011268,Rented or living rent free: Total,65,27,17,5,12,2,8,38,27,1,1,8,1
S01011268,Rented or living rent free: Social rented,37,7,5,3,2,0,2,30,26,0,1,3,0
S01011268,Rented or living rent free: Private rented or living rent free,28,20,12,2,10,2,6,8,1,1,0,5,1
S01011269,All HRPs aged 16 and over,279,127,103,26,77,9,15,152,108,4,7,27,6
S01011269,Owned: Total,143,81,70,14,56,8,3,62,54,2,1,3,2
S01011269,Owned: Owned outright,70,19,14,4,10,3,2,51,47,1,0,1,2
S01011269,Owned: Owned with a mortgage or loan or shared ownership,73,62,56,10,46,5,1,11,7,1,1,2,0
S01011269,Rented or living rent free: Total,136,46,33,12,21,1,12,90,54,2,6,24,4
S01011269,Rented or living rent free: Social rented,112,30,20,8,12,1,9,82,52,2,5,23,0
S01011269,Rented or living rent free: Private rented or living rent free,24,16,13,4,9,0,3,8,2,0,1,1,4
S01011270,All HRPs aged 16 and over,349,208,153,33,120,22,33,141,89,6,5,36,5
S01011270,Owned: Total,147,97,76,6,70,16,5,50,46,0,1,3,0
S01011270,Owned: Owned outright,67,23,13,1,12,6,4,44,42,0,1,1,0
S01011270,Owned: Owned with a mortgage or loan or shared ownership,80,74,63,5,58,10,1,6,4,0,0,2,0
S01011270,Rented or living rent free: Total,202,111,77,27,50,6,28,91,43,6,4,33,5
S01011270,Rented or living rent free: Social rented,138,66,51,20,31,3,12,72,40,1,3,25,3
S01011270,Rented or living rent free: Private rented or living rent free,64,45,26,7,19,3,16,19,3,5,1,8,2
S01011271,All HRPs aged 16 and over,357,198,165,37,128,8,25,159,127,2,6,18,6
S01011271,Owned: Total,206,122,110,16,94,8,4,84,82,1,0,1,0
S01011271,Owned: Owned outright,108,36,31,4,27,2,3,72,71,0,0,1,0
S01011271,Owned: Owned with a mortgage or loan or shared ownership,98,86,79,12,67,6,1,12,11,1,0,0,0
S01011271,Rented or living rent free: Total,151,76,55,21,34,0,21,75,45,1,6,17,6
S01011271,Rented or living rent free: Social rented,113,49,39,15,24,0,10,64,43,1,5,12,3
S01011271,Rented or living rent free: Private rented or living rent free,38,27,16,6,10,0,11,11,2,0,1,5,3
S01011272,All HRPs aged 16 and over,380,216,161,35,126,14,41,164,104,1,7,45,7
S01011272,Owned: Total,173,105,91,13,78,9,5,68,60,1,2,5,0
S01011272,Owned: Owned outright,71,24,20,8,12,1,3,47,42,1,2,2,0
S01011272,Owned: Owned with a mortgage or loan or shared ownership,102,81,71,5,66,8,2,21,18,0,0,3,0
S01011272,Rented or living rent free: Total,207,111,70,22,48,5,36,96,44,0,5,40,7
S01011272,Rented or living rent free: Social rented,159,77,52,20,32,2,23,82,42,0,2,32,6
S01011272,Rented or living rent free: Private rented or living rent free,48,34,18,2,16,3,13,14,2,0,3,8,1
S01011273,All HRPs aged 16 and over,339,202,157,40,117,15,30,137,82,3,19,25,8
S01011273,Owned: Total,180,113,97,14,83,14,2,67,57,0,3,3,4
S01011273,Owned: Owned outright,63,16,14,4,10,1,1,47,43,0,2,1,1
S01011273,Owned: Owned with a mortgage or loan or shared ownership,117,97,83,10,73,13,1,20,14,0,1,2,3
S01011273,Rented or living rent free: Total,159,89,60,26,34,1,28,70,25,3,16,22,4
S01011273,Rented or living rent free: Social rented,140,75,51,20,31,1,23,65,24,3,15,20,3
S01011273,Rented or living rent free: Private rented or living rent free,19,14,9,6,3,0,5,5,1,0,1,2,1
S01011274,All HRPs aged 16 and over,395,253,204,44,160,18,31,142,75,4,18,36,9
S01011274,Owned: Total,187,146,129,15,114,16,1,41,36,0,1,3,1
S01011274,Owned: Owned outright,59,30,21,6,15,9,0,29,29,0,0,0,0
S01011274,Owned: Owned with a mortgage or loan or shared ownership,128,116,108,9,99,7,1,12,7,0,1,3,1
S01011274,Rented or living rent free: Total,208,107,75,29,46,2,30,101,39,4,17,33,8
S01011274,Rented or living rent free: Social rented,135,64,50,20,30,2,12,71,35,4,5,23,4
S01011274,Rented or living rent free: Private rented or living rent free,73,43,25,9,16,0,18,30,4,0,12,10,4
S01011275,All HRPs aged 16 and over,277,177,137,44,93,10,30,100,46,4,21,21,8
S01011275,Owned: Total,90,64,56,11,45,7,1,26,26,0,0,0,0
S01011275,Owned: Owned outright,34,17,16,4,12,1,0,17,17,0,0,0,0
S01011275,Owned: Owned with a mortgage or loan or shared ownership,56,47,40,7,33,6,1,9,9,0,0,0,0
S01011275,Rented or living rent free: Total,187,113,81,33,48,3,29,74,20,4,21,21,8
S01011275,Rented or living rent free: Social rented,172,103,75,31,44,3,25,69,20,4,17,20,8
S01011275,Rented or living rent free: Private rented or living rent free,15,10,6,2,4,0,4,5,0,0,4,1,0
S01011276,All HRPs aged 16 and over,405,250,199,49,150,21,30,155,104,2,19,25,5
S01011276,Owned: Total,237,149,130,16,114,16,3,88,82,0,1,5,0
S01011276,Owned: Owned outright,96,31,28,8,20,3,0,65,63,0,1,1,0
S01011276,Owned: Owned with a mortgage or loan or shared ownership,141,118,102,8,94,13,3,23,19,0,0,4,0
S01011276,Rented or living rent free: Total,168,101,69,33,36,5,27,67,22,2,18,20,5
S01011276,Rented or living rent free: Social rented,143,87,59,31,28,4,24,56,20,2,13,19,2
S01011276,Rented or living rent free: Private rented or living rent free,25,14,10,2,8,1,3,11,2,0,5,1,3
S01011277,All HRPs aged 16 and over,284,204,173,18,155,27,4,80,71,1,1,7,0
S01011277,Owned: Total,255,185,159,13,146,25,1,70,65,0,1,4,0
S01011277,Owned: Owned outright,101,37,31,7,24,5,1,64,60,0,1,3,0
S01011277,Owned: Owned with a mortgage or loan or shared ownership,154,148,128,6,122,20,0,6,5,0,0,1,0
S01011277,Rented or living rent free: Total,29,19,14,5,9,2,3,10,6,1,0,3,0
S01011277,Rented or living rent free: Social rented,7,3,2,0,2,1,0,4,2,0,0,2,0
S01011277,Rented or living rent free: Private rented or living rent free,22,16,12,5,7,1,3,6,4,1,0,1,0
S01011278,All HRPs aged 16 and over,230,182,162,15,147,14,6,48,40,3,1,3,1
S01011278,Owned: Total,194,156,143,10,133,12,1,38,37,1,0,0,0
S01011278,Owned: Owned outright,59,29,27,4,23,2,0,30,30,0,0,0,0
S01011278,Owned: Owned with a mortgage or loan or shared ownership,135,127,116,6,110,10,1,8,7,1,0,0,0
S01011278,Rented or living rent free: Total,36,26,19,5,14,2,5,10,3,2,1,3,1
S01011278,Rented or living rent free: Social rented,6,2,1,0,1,1,0,4,2,1,0,0,1
S01011278,Rented or living rent free: Private rented or living rent free,30,24,18,5,13,1,5,6,1,1,1,3,0
S01011279,All HRPs aged 16 and over,302,182,166,20,146,15,1,120,105,0,7,4,4
S01011279,Owned: Total,245,160,147,16,131,13,0,85,82,0,0,2,1
S01011279,Owned: Owned outright,106,34,31,5,26,3,0,72,70,0,0,1,1
S01011279,Owned: Owned with a mortgage or loan or shared ownership,139,126,116,11,105,10,0,13,12,0,0,1,0
S01011279,Rented or living rent free: Total,57,22,19,4,15,2,1,35,23,0,7,2,3
S01011279,Rented or living rent free: Social rented,24,1,0,0,0,0,1,23,21,0,0,2,0
S01011279,Rented or living rent free: Private rented or living rent free,33,21,19,4,15,2,0,12,2,0,7,0,3
S01011280,All HRPs aged 16 and over,231,145,124,16,108,20,1,86,76,0,2,5,3
S01011280,Owned: Total,215,137,118,14,104,19,0,78,73,0,1,3,1
S01011280,Owned: Owned outright,125,53,46,10,36,7,0,72,70,0,0,1,1
S01011280,Owned: Owned with a mortgage or loan or shared ownership,90,84,72,4,68,12,0,6,3,0,1,2,0
S01011280,Rented or living rent free: Total,16,8,6,2,4,1,1,8,3,0,1,2,2
S01011280,Rented or living rent free: Social rented,11,5,4,1,3,0,1,6,2,0,1,2,1
S01011280,Rented or living rent free: Private rented or living rent free,5,3,2,1,1,1,0,2,1,0,0,0,1
S01011281,All HRPs aged 16 and over,238,181,158,18,140,21,2,57,47,1,2,7,0
S01011281,Owned: Total,211,164,145,13,132,17,2,47,46,0,0,1,0
S01011281,Owned: Owned outright,62,23,21,5,16,2,0,39,39,0,0,0,0
S01011281,Owned: Owned with a mortgage or loan or shared ownership,149,141,124,8,116,15,2,8,7,0,0,1,0
S01011281,Rented or living rent free: Total,27,17,13,5,8,4,0,10,1,1,2,6,0
S01011281,Rented or living rent free: Social rented,8,5,4,2,2,1,0,3,0,1,0,2,0
S01011281,Rented or living rent free: Private rented or living rent free,19,12,9,3,6,3,0,7,1,0,2,4,0
S01011282,All HRPs aged 16 and over,341,273,240,20,220,24,9,68,60,1,0,5,2
S01011282,Owned: Total,268,234,212,15,197,19,3,34,31,1,0,1,1
S01011282,Owned: Owned outright,63,40,32,4,28,7,1,23,20,1,0,1,1
S01011282,Owned: Owned with a mortgage or loan or shared ownership,205,194,180,11,169,12,2,11,11,0,0,0,0
S01011282,Rented or living rent free: Total,73,39,28,5,23,5,6,34,29,0,0,4,1
S01011282,Rented or living rent free: Social rented,56,26,17,2,15,3,6,30,26,0,0,3,1
S01011282,Rented or living rent free: Private rented or living rent free,17,13,11,3,8,2,0,4,3,0,0,1,0
S01011283,All HRPs aged 16 and over,251,223,198,14,184,22,3,28,22,0,2,4,0
S01011283,Owned: Total,238,214,189,13,176,22,3,24,20,0,2,2,0
S01011283,Owned: Owned outright,37,24,22,4,18,1,1,13,13,0,0,0,0
S01011283,Owned: Owned with a mortgage or loan or shared ownership,201,190,167,9,158,21,2,11,7,0,2,2,0
S01011283,Rented or living rent free: Total,13,9,9,1,8,0,0,4,2,0,0,2,0
S01011283,Rented or living rent free: Social rented,4,1,1,0,1,0,0,3,1,0,0,2,0
S01011283,Rented or living rent free: Private rented or living rent free,9,8,8,1,7,0,0,1,1,0,0,0,0
S01011284,All HRPs aged 16 and over,192,180,158,9,149,21,1,12,9,1,0,2,0
S01011284,Owned: Total,179,170,150,8,142,19,1,9,8,0,0,1,0
S01011284,Owned: Owned outright,20,12,10,0,10,2,0,8,7,0,0,1,0
S01011284,Owned: Owned with a mortgage or loan or shared ownership,159,158,140,8,132,17,1,1,1,0,0,0,0
S01011284,Rented or living rent free: Total,13,10,8,1,7,2,0,3,1,1,0,1,0
S01011284,Rented or living rent free: Social rented,4,2,1,0,1,1,0,2,1,1,0,0,0
S01011284,Rented or living rent free: Private rented or living rent free,9,8,7,1,6,1,0,1,0,0,0,1,0
S01011285,All HRPs aged 16 and over,297,210,165,40,125,15,30,87,58,1,6,17,5
S01011285,Owned: Total,138,100,86,15,71,8,6,38,34,0,0,3,1
S01011285,Owned: Owned outright,50,24,19,5,14,2,3,26,25,0,0,1,0
S01011285,Owned: Owned with a mortgage or loan or shared ownership,88,76,67,10,57,6,3,12,9,0,0,2,1
S01011285,Rented or living rent free: Total,159,110,79,25,54,7,24,49,24,1,6,14,4
S01011285,Rented or living rent free: Social rented,136,92,70,20,50,5,17,44,23,1,4,12,4
S01011285,Rented or living rent free: Private rented or living rent free,23,18,9,5,4,2,7,5,1,0,2,2,0
S01011286,All HRPs aged 16 and over,298,192,153,37,116,20,19,106,64,8,10,19,5
S01011286,Owned: Total,139,100,86,9,77,12,2,39,37,0,0,2,0
S01011286,Owned: Owned outright,49,22,20,5,15,2,0,27,26,0,0,1,0
S01011286,Owned: Owned with a mortgage or loan or shared ownership,90,78,66,4,62,10,2,12,11,0,0,1,0
S01011286,Rented or living rent free: Total,159,92,67,28,39,8,17,67,27,8,10,17,5
S01011286,Rented or living rent free: Social rented,141,79,60,25,35,7,12,62,27,6,8,17,4
S01011286,Rented or living rent free: Private rented or living rent free,18,13,7,3,4,1,5,5,0,2,2,0,1
S01011287,All HRPs aged 16 and over,337,212,176,43,133,15,21,125,74,6,9,30,6
S01011287,Owned: Total,171,128,112,19,93,13,3,43,39,0,0,1,3
S01011287,Owned: Owned outright,69,33,30,10,20,3,0,36,34,0,0,1,1
S01011287,Owned: Owned with a mortgage or loan or shared ownership,102,95,82,9,73,10,3,7,5,0,0,0,2
S01011287,Rented or living rent free: Total,166,84,64,24,40,2,18,82,35,6,9,29,3
S01011287,Rented or living rent free: Social rented,145,73,58,24,34,2,13,72,35,4,5,25,3
S01011287,Rented or living rent free: Private rented or living rent free,21,11,6,0,6,0,5,10,0,2,4,4,0
S01011288,All HRPs aged 16 and over,318,203,172,43,129,13,18,115,89,1,6,12,7
S01011288,Owned: Total,184,134,126,16,110,7,1,50,45,0,0,4,1
S01011288,Owned: Owned outright,63,23,20,5,15,3,0,40,37,0,0,2,1
S01011288,Owned: Owned with a mortgage or loan or shared ownership,121,111,106,11,95,4,1,10,8,0,0,2,0
S01011288,Rented or living rent free: Total,134,69,46,27,19,6,17,65,44,1,6,8,6
S01011288,Rented or living rent free: Social rented,108,49,35,21,14,4,10,59,42,1,4,7,5
S01011288,Rented or living rent free: Private rented or living rent free,26,20,11,6,5,2,7,6,2,0,2,1,1
S01011289,All HRPs aged 16 and over,431,243,203,43,160,18,22,188,121,6,9,36,16
S01011289,Owned: Total,237,158,142,21,121,9,7,79,72,0,2,4,1
S01011289,Owned: Owned outright,105,43,36,9,27,4,3,62,58,0,0,3,1
S01011289,Owned: Owned with a mortgage or loan or shared ownership,132,115,106,12,94,5,4,17,14,0,2,1,0
S01011289,Rented or living rent free: Total,194,85,61,22,39,9,15,109,49,6,7,32,15
S01011289,Rented or living rent free: Social rented,166,68,49,15,34,7,12,98,44,5,3,32,14
S01011289,Rented or living rent free: Private rented or living rent free,28,17,12,7,5,2,3,11,5,1,4,0,1
S01011290,All HRPs aged 16 and over,503,288,214,43,171,42,32,215,138,2,19,48,8
S01011290,Owned: Total,258,165,130,15,115,31,4,93,83,1,3,5,1
S01011290,Owned: Owned outright,124,45,33,4,29,10,2,79,71,0,3,4,1
S01011290,Owned: Owned with a mortgage or loan or shared ownership,134,120,97,11,86,21,2,14,12,1,0,1,0
S01011290,Rented or living rent free: Total,245,123,84,28,56,11,28,122,55,1,16,43,7
S01011290,Rented or living rent free: Social rented,210,99,64,23,41,9,26,111,53,1,14,39,4
S01011290,Rented or living rent free: Private rented or living rent free,35,24,20,5,15,2,2,11,2,0,2,4,3
S01011291,All HRPs aged 16 and over,407,243,204,41,163,12,27,164,111,5,7,27,14
S01011291,Owned: Total,234,153,134,17,117,10,9,81,68,1,2,7,3
S01011291,Owned: Owned outright,110,41,29,3,26,6,6,69,58,1,1,6,3
S01011291,Owned: Owned with a mortgage or loan or shared ownership,124,112,105,14,91,4,3,12,10,0,1,1,0
S01011291,Rented or living rent free: Total,173,90,70,24,46,2,18,83,43,4,5,20,11
S01011291,Rented or living rent free: Social rented,147,73,59,20,39,2,12,74,42,3,3,17,9
S01011291,Rented or living rent free: Private rented or living rent free,26,17,11,4,7,0,6,9,1,1,2,3,2
S01011292,All HRPs aged 16 and over,332,188,133,33,100,13,42,144,88,1,7,41,7
S01011292,Owned: Total,111,79,65,11,54,12,2,32,25,1,0,2,4
S01011292,Owned: Owned outright,36,15,10,2,8,3,2,21,17,0,0,1,3
S01011292,Owned: Owned with a mortgage or loan or shared ownership,75,64,55,9,46,9,0,11,8,1,0,1,1
S01011292,Rented or living rent free: Total,221,109,68,22,46,1,40,112,63,0,7,39,3
S01011292,Rented or living rent free: Social rented,208,99,62,19,43,1,36,109,62,0,7,39,1
S01011292,Rented or living rent free: Private rented or living rent free,13,10,6,3,3,0,4,3,1,0,0,0,2
S01011293,All HRPs aged 16 and over,341,195,166,33,133,10,19,146,110,8,6,18,4
S01011293,Owned: Total,163,117,113,19,94,4,0,46,41,2,1,2,0
S01011293,Owned: Owned outright,64,30,28,10,18,2,0,34,30,1,1,2,0
S01011293,Owned: Owned with a mortgage or loan or shared ownership,99,87,85,9,76,2,0,12,11,1,0,0,0
S01011293,Rented or living rent free: Total,178,78,53,14,39,6,19,100,69,6,5,16,4
S01011293,Rented or living rent free: Social rented,161,66,45,11,34,6,15,95,66,6,5,15,3
S01011293,Rented or living rent free: Private rented or living rent free,17,12,8,3,5,0,4,5,3,0,0,1,1
S01011294,All HRPs aged 16 and over,487,225,160,33,127,22,43,262,196,3,11,47,5
S01011294,Owned: Total,194,107,88,13,75,13,6,87,80,0,0,6,1
S01011294,Owned: Owned outright,94,26,18,5,13,4,4,68,64,0,0,4,0
S01011294,Owned: Owned with a mortgage or loan or shared ownership,100,81,70,8,62,9,2,19,16,0,0,2,1
S01011294,Rented or living rent free: Total,293,118,72,20,52,9,37,175,116,3,11,41,4
S01011294,Rented or living rent free: Social rented,232,77,46,13,33,7,24,155,106,3,9,33,4
S01011294,Rented or living rent free: Private rented or living rent free,61,41,26,7,19,2,13,20,10,0,2,8,0
S01011295,All HRPs aged 16 and over,448,257,208,27,181,35,14,191,168,0,5,11,7
S01011295,Owned: Total,342,200,169,15,154,28,3,142,139,0,1,1,1
S01011295,Owned: Owned outright,178,52,40,7,33,11,1,126,125,0,1,0,0
S01011295,Owned: Owned with a mortgage or loan or shared ownership,164,148,129,8,121,17,2,16,14,0,0,1,1
S01011295,Rented or living rent free: Total,106,57,39,12,27,7,11,49,29,0,4,10,6
S01011295,Rented or living rent free: Social rented,70,33,19,8,11,5,9,37,25,0,1,9,2
S01011295,Rented or living rent free: Private rented or living rent free,36,24,20,4,16,2,2,12,4,0,3,1,4
S01011296,All HRPs aged 16 and over,280,150,109,26,83,26,15,130,104,2,3,17,4
S01011296,Owned: Total,172,104,76,11,65,23,5,68,62,0,0,4,2
S01011296,Owned: Owned outright,93,41,26,9,17,11,4,52,50,0,0,0,2
S01011296,Owned: Owned with a mortgage or loan or shared ownership,79,63,50,2,48,12,1,16,12,0,0,4,0
S01011296,Rented or living rent free: Total,108,46,33,15,18,3,10,62,42,2,3,13,2
S01011296,Rented or living rent free: Social rented,92,35,24,13,11,3,8,57,40,2,2,12,1
S01011296,Rented or living rent free: Private rented or living rent free,16,11,9,2,7,0,2,5,2,0,1,1,1
S01011297,All HRPs aged 16 and over,311,203,167,40,127,24,12,108,68,1,14,14,11
S01011297,Owned: Total,152,113,97,16,81,14,2,39,32,0,3,1,3
S01011297,Owned: Owned outright,56,24,17,2,15,6,1,32,28,0,1,1,2
S01011297,Owned: Owned with a mortgage or loan or shared ownership,96,89,80,14,66,8,1,7,4,0,2,0,1
S01011297,Rented or living rent free: Total,159,90,70,24,46,10,10,69,36,1,11,13,8
S01011297,Rented or living rent free: Social rented,143,78,59,20,39,9,10,65,36,1,9,12,7
S01011297,Rented or living rent free: Private rented or living rent free,16,12,11,4,7,1,0,4,0,0,2,1,1
S01011298,All HRPs aged 16 and over,230,149,114,25,89,13,22,81,44,2,15,16,4
S01011298,Owned: Total,98,73,59,10,49,9,5,25,23,0,1,0,1
S01011298,Owned: Owned outright,31,16,13,6,7,2,1,15,14,0,1,0,0
S01011298,Owned: Owned with a mortgage or loan or shared ownership,67,57,46,4,42,7,4,10,9,0,0,0,1
S01011298,Rented or living rent free: Total,132,76,55,15,40,4,17,56,21,2,14,16,3
S01011298,Rented or living rent free: Social rented,115,69,52,14,38,2,15,46,20,1,10,12,3
S01011298,Rented or living rent free: Private rented or living rent free,17,7,3,1,2,2,2,10,1,1,4,4,0
S01011299,All HRPs aged 16 and over,197,144,84,8,76,59,1,53,45,0,1,5,2
S01011299,Owned: Total,162,119,67,7,60,51,1,43,41,0,0,1,1
S01011299,Owned: Owned outright,96,60,28,6,22,31,1,36,35,0,0,0,1
S01011299,Owned: Owned with a mortgage or loan or shared ownership,66,59,39,1,38,20,0,7,6,0,0,1,0
S01011299,Rented or living rent free: Total,35,25,17,1,16,8,0,10,4,0,1,4,1
S01011299,Rented or living rent free: Social rented,3,0,0,0,0,0,0,3,0,0,1,1,1
S01011299,Rented or living rent free: Private rented or living rent free,32,25,17,1,16,8,0,7,4,0,0,3,0
S01011300,All HRPs aged 16 and over,423,242,186,35,151,18,38,181,117,0,16,31,17
S01011300,Owned: Total,193,130,116,12,104,13,1,63,58,0,0,4,1
S01011300,Owned: Owned outright,87,40,37,2,35,3,0,47,45,0,0,2,0
S01011300,Owned: Owned with a mortgage or loan or shared ownership,106,90,79,10,69,10,1,16,13,0,0,2,1
S01011300,Rented or living rent free: Total,230,112,70,23,47,5,37,118,59,0,16,27,16
S01011300,Rented or living rent free: Social rented,213,99,65,22,43,3,31,114,58,0,14,26,16
S01011300,Rented or living rent free: Private rented or living rent free,17,13,5,1,4,2,6,4,1,0,2,1,0
S01011301,All HRPs aged 16 and over,309,200,163,16,147,29,8,109,95,1,4,6,3
S01011301,Owned: Total,267,176,147,12,135,26,3,91,87,0,1,2,1
S01011301,Owned: Owned outright,130,50,39,7,32,9,2,80,78,0,0,2,0
S01011301,Owned: Owned with a mortgage or loan or shared ownership,137,126,108,5,103,17,1,11,9,0,1,0,1
S01011301,Rented or living rent free: Total,42,24,16,4,12,3,5,18,8,1,3,4,2
S01011301,Rented or living rent free: Social rented,8,3,3,1,2,0,0,5,2,1,0,2,0
S01011301,Rented or living rent free: Private rented or living rent free,34,21,13,3,10,3,5,13,6,0,3,2,2
S01011302,All HRPs aged 16 and over,522,240,188,37,151,14,38,282,209,3,8,55,7
S01011302,Owned: Total,242,145,128,16,112,9,8,97,89,1,1,6,0
S01011302,Owned: Owned outright,126,40,33,8,25,2,5,86,80,1,0,5,0
S01011302,Owned: Owned with a mortgage or loan or shared ownership,116,105,95,8,87,7,3,11,9,0,1,1,0
S01011302,Rented or living rent free: Total,280,95,60,21,39,5,30,185,120,2,7,49,7
S01011302,Rented or living rent free: Social rented,232,67,46,17,29,4,17,165,115,1,4,39,6
S01011302,Rented or living rent free: Private rented or living rent free,48,28,14,4,10,1,13,20,5,1,3,10,1
S01011303,All HRPs aged 16 and over,427,293,245,22,223,41,7,134,115,0,6,8,5
S01011303,Owned: Total,361,256,217,17,200,37,2,105,100,0,2,2,1
S01011303,Owned: Owned outright,157,67,54,8,46,11,2,90,86,0,2,1,1
S01011303,Owned: Owned with a mortgage or loan or shared ownership,204,189,163,9,154,26,0,15,14,0,0,1,0
S01011303,Rented or living rent free: Total,66,37,28,5,23,4,5,29,15,0,4,6,4
S01011303,Rented or living rent free: Social rented,11,3,2,0,2,0,1,8,6,0,1,0,1
S01011303,Rented or living rent free: Private rented or living rent free,55,34,26,5,21,4,4,21,9,0,3,6,3
S01011304,All HRPs aged 16 and over,282,175,144,34,110,14,17,107,61,2,16,19,9
S01011304,Owned: Total,137,97,86,15,71,9,2,40,34,1,0,4,1
S01011304,Owned: Owned outright,56,25,20,4,16,4,1,31,26,0,0,4,1
S01011304,Owned: Owned with a mortgage or loan or shared ownership,81,72,66,11,55,5,1,9,8,1,0,0,0
S01011304,Rented or living rent free: Total,145,78,58,19,39,5,15,67,27,1,16,15,8
S01011304,Rented or living rent free: Social rented,131,71,56,18,38,4,11,60,24,0,16,13,7
S01011304,Rented or living rent free: Private rented or living rent free,14,7,2,1,1,1,4,7,3,1,0,2,1
S01011305,All HRPs aged 16 and over,342,239,185,17,168,26,28,103,65,2,8,22,6
S01011305,Owned: Total,187,150,127,8,119,21,2,37,35,0,0,1,1
S01011305,Owned: Owned outright,50,19,16,3,13,2,1,31,30,0,0,0,1
S01011305,Owned: Owned with a mortgage or loan or shared ownership,137,131,111,5,106,19,1,6,5,0,0,1,0
S01011305,Rented or living rent free: Total,155,89,58,9,49,5,26,66,30,2,8,21,5
S01011305,Rented or living rent free: Social rented,135,79,51,8,43,4,24,56,26,1,6,19,4
S01011305,Rented or living rent free: Private rented or living rent free,20,10,7,1,6,1,2,10,4,1,2,2,1
S01011306,All HRPs aged 16 and over,282,145,111,20,91,8,26,137,88,5,17,17,10
S01011306,Owned: Total,161,86,77,10,67,7,2,75,68,1,0,4,2
S01011306,Owned: Owned outright,99,33,29,8,21,3,1,66,61,1,0,3,1
S01011306,Owned: Owned with a mortgage or loan or shared ownership,62,53,48,2,46,4,1,9,7,0,0,1,1
S01011306,Rented or living rent free: Total,121,59,34,10,24,1,24,62,20,4,17,13,8
S01011306,Rented or living rent free: Social rented,94,51,30,10,20,1,20,43,15,1,11,11,5
S01011306,Rented or living rent free: Private rented or living rent free,27,8,4,0,4,0,4,19,5,3,6,2,3
S01011307,All HRPs aged 16 and over,188,136,89,12,77,44,3,52,48,0,0,4,0
S01011307,Owned: Total,151,105,65,7,58,38,2,46,44,0,0,2,0
S01011307,Owned: Owned outright,95,50,25,6,19,24,1,45,43,0,0,2,0
S01011307,Owned: Owned with a mortgage or loan or shared ownership,56,55,40,1,39,14,1,1,1,0,0,0,0
S01011307,Rented or living rent free: Total,37,31,24,5,19,6,1,6,4,0,0,2,0
S01011307,Rented or living rent free: Social rented,4,3,3,1,2,0,0,1,0,0,0,1,0
S01011307,Rented or living rent free: Private rented or living rent free,33,28,21,4,17,6,1,5,4,0,0,1,0
S01011308,All HRPs aged 16 and over,186,129,71,6,65,54,4,57,50,0,0,4,3
S01011308,Owned: Total,146,99,51,4,47,47,1,47,44,0,0,0,3
S01011308,Owned: Owned outright,90,46,17,3,14,28,1,44,41,0,0,0,3
S01011308,Owned: Owned with a mortgage or loan or shared ownership,56,53,34,1,33,19,0,3,3,0,0,0,0
S01011308,Rented or living rent free: Total,40,30,20,2,18,7,3,10,6,0,0,4,0
S01011308,Rented or living rent free: Social rented,4,3,0,0,0,1,2,1,0,0,0,1,0
S01011308,Rented or living rent free: Private rented or living rent free,36,27,20,2,18,6,1,9,6,0,0,3,0
S01011309,All HRPs aged 16 and over,333,188,135,18,117,49,4,145,135,0,1,7,2
S01011309,Owned: Total,314,180,130,17,113,46,4,134,130,0,1,2,1
S01011309,Owned: Owned outright,184,69,50,10,40,18,1,115,113,0,0,2,0
S01011309,Owned: Owned with a mortgage or loan or shared ownership,130,111,80,7,73,28,3,19,17,0,1,0,1
S01011309,Rented or living rent free: Total,19,8,5,1,4,3,0,11,5,0,0,5,1
S01011309,Rented or living rent free: Social rented,4,1,1,0,1,0,0,3,1,0,0,2,0
S01011309,Rented or living rent free: Private rented or living rent free,15,7,4,1,3,3,0,8,4,0,0,3,1
S01011310,All HRPs aged 16 and over,341,198,144,29,115,41,13,143,122,0,4,12,5
S01011310,Owned: Total,247,141,107,14,93,32,2,106,99,0,2,2,3
S01011310,Owned: Owned outright,140,50,36,8,28,14,0,90,87,0,1,1,1
S01011310,Owned: Owned with a mortgage or loan or shared ownership,107,91,71,6,65,18,2,16,12,0,1,1,2
S01011310,Rented or living rent free: Total,94,57,37,15,22,9,11,37,23,0,2,10,2
S01011310,Rented or living rent free: Social rented,44,18,11,4,7,4,3,26,17,0,2,7,0
S01011310,Rented or living rent free: Private rented or living rent free,50,39,26,11,15,5,8,11,6,0,0,3,2
S01011311,All HRPs aged 16 and over,305,181,126,25,101,49,6,124,113,3,2,4,2
S01011311,Owned: Total,280,166,120,24,96,42,4,114,108,1,1,3,1
S01011311,Owned: Owned outright,178,73,51,17,34,20,2,105,100,1,1,2,1
S01011311,Owned: Owned with a mortgage or loan or shared ownership,102,93,69,7,62,22,2,9,8,0,0,1,0
S01011311,Rented or living rent free: Total,25,15,6,1,5,7,2,10,5,2,1,1,1
S01011311,Rented or living rent free: Social rented,6,2,1,0,1,0,1,4,1,0,1,1,1
S01011311,Rented or living rent free: Private rented or living rent free,19,13,5,1,4,7,1,6,4,2,0,0,0
S01011312,All HRPs aged 16 and over,493,284,194,23,171,76,14,209,203,1,0,1,4
S01011312,Owned: Total,457,261,182,22,160,73,6,196,193,0,0,1,2
S01011312,Owned: Owned outright,295,117,71,14,57,42,4,178,175,0,0,1,2
S01011312,Owned: Owned with a mortgage or loan or shared ownership,162,144,111,8,103,31,2,18,18,0,0,0,0
S01011312,Rented or living rent free: Total,36,23,12,1,11,3,8,13,10,1,0,0,2
S01011312,Rented or living rent free: Social rented,7,4,2,0,2,0,2,3,2,0,0,0,1
S01011312,Rented or living rent free: Private rented or living rent free,29,19,10,1,9,3,6,10,8,1,0,0,1
S01011313,All HRPs aged 16 and over,368,220,171,27,144,38,11,148,127,3,1,13,4
S01011313,Owned: Total,274,179,145,20,125,32,2,95,92,0,0,1,2
S01011313,Owned: Owned outright,132,47,31,8,23,14,2,85,83,0,0,1,1
S01011313,Owned: Owned with a mortgage or loan or shared ownership,142,132,114,12,102,18,0,10,9,0,0,0,1
S01011313,Rented or living rent free: Total,94,41,26,7,19,6,9,53,35,3,1,12,2
S01011313,Rented or living rent free: Social rented,45,5,4,3,1,1,0,40,28,1,0,9,2
S01011313,Rented or living rent free: Private rented or living rent free,49,36,22,4,18,5,9,13,7,2,1,3,0
S01011314,All HRPs aged 16 and over,487,324,253,34,219,51,20,163,140,1,4,15,3
S01011314,Owned: Total,371,256,214,21,193,37,5,115,113,1,0,1,0
S01011314,Owned: Owned outright,166,71,62,14,48,8,1,95,94,0,0,1,0
S01011314,Owned: Owned with a mortgage or loan or shared ownership,205,185,152,7,145,29,4,20,19,1,0,0,0
S01011314,Rented or living rent free: Total,116,68,39,13,26,14,15,48,27,0,4,14,3
S01011314,Rented or living rent free: Social rented,43,13,7,3,4,3,3,30,23,0,1,6,0
S01011314,Rented or living rent free: Private rented or living rent free,73,55,32,10,22,11,12,18,4,0,3,8,3
S01011315,All HRPs aged 16 and over,168,100,82,18,64,12,6,68,54,1,5,6,2
S01011315,Owned: Total,95,62,53,7,46,9,0,33,30,1,1,1,0
S01011315,Owned: Owned outright,34,7,7,1,6,0,0,27,25,1,0,1,0
S01011315,Owned: Owned with a mortgage or loan or shared ownership,61,55,46,6,40,9,0,6,5,0,1,0,0
S01011315,Rented or living rent free: Total,73,38,29,11,18,3,6,35,24,0,4,5,2
S01011315,Rented or living rent free: Social rented,55,27,21,11,10,1,5,28,21,0,2,5,0
S01011315,Rented or living rent free: Private rented or living rent free,18,11,8,0,8,2,1,7,3,0,2,0,2
S01011316,All HRPs aged 16 and over,311,185,136,34,102,31,18,126,92,2,8,17,7
S01011316,Owned: Total,177,115,93,14,79,20,2,62,53,0,3,3,3
S01011316,Owned: Owned outright,85,32,24,5,19,7,1,53,47,0,2,2,2
S01011316,Owned: Owned with a mortgage or loan or shared ownership,92,83,69,9,60,13,1,9,6,0,1,1,1
S01011316,Rented or living rent free: Total,134,70,43,20,23,11,16,64,39,2,5,14,4
S01011316,Rented or living rent free: Social rented,112,57,36,19,17,8,13,55,33,2,5,12,3
S01011316,Rented or living rent free: Private rented or living rent free,22,13,7,1,6,3,3,9,6,0,0,2,1
S01011317,All HRPs aged 16 and over,392,168,108,17,91,49,11,224,221,0,0,2,1
S01011317,Owned: Total,360,144,94,14,80,44,6,216,215,0,0,0,1
S01011317,Owned: Owned outright,237,47,30,10,20,15,2,190,189,0,0,0,1
S01011317,Owned: Owned with a mortgage or loan or shared ownership,123,97,64,4,60,29,4,26,26,0,0,0,0
S01011317,Rented or living rent free: Total,32,24,14,3,11,5,5,8,6,0,0,2,0
S01011317,Rented or living rent free: Social rented,1,1,0,0,0,1,0,0,0,0,0,0,0
S01011317,Rented or living rent free: Private rented or living rent free,31,23,14,3,11,4,5,8,6,0,0,2,0
S01011318,All HRPs aged 16 and over,520,234,176,26,150,49,9,286,256,3,7,15,5
S01011318,Owned: Total,424,182,137,22,115,40,5,242,232,2,1,3,4
S01011318,Owned: Owned outright,279,57,36,13,23,18,3,222,215,2,0,2,3
S01011318,Owned: Owned with a mortgage or loan or shared ownership,145,125,101,9,92,22,2,20,17,0,1,1,1
S01011318,Rented or living rent free: Total,96,52,39,4,35,9,4,44,24,1,6,12,1
S01011318,Rented or living rent free: Social rented,6,3,1,0,1,2,0,3,2,0,1,0,0
S01011318,Rented or living rent free: Private rented or living rent free,90,49,38,4,34,7,4,41,22,1,5,12,1
S01011319,All HRPs aged 16 and over,398,172,137,12,125,34,1,226,216,0,3,4,3
S01011319,Owned: Total,369,161,126,12,114,34,1,208,201,0,2,2,3
S01011319,Owned: Owned outright,248,60,47,8,39,12,1,188,184,0,1,2,1
S01011319,Owned: Owned with a mortgage or loan or shared ownership,121,101,79,4,75,22,0,20,17,0,1,0,2
S01011319,Rented or living rent free: Total,29,11,11,0,11,0,0,18,15,0,1,2,0
S01011319,Rented or living rent free: Social rented,2,1,1,0,1,0,0,1,1,0,0,0,0
S01011319,Rented or living rent free: Private rented or living rent free,27,10,10,0,10,0,0,17,14,0,1,2,0
S01011320,All HRPs aged 16 and over,303,142,118,20,98,17,7,161,137,3,1,8,12
S01011320,Owned: Total,216,110,93,15,78,14,3,106,97,1,1,1,6
S01011320,Owned: Owned outright,125,31,27,5,22,3,1,94,90,0,0,0,4
S01011320,Owned: Owned with a mortgage or loan or shared ownership,91,79,66,10,56,11,2,12,7,1,1,1,2
S01011320,Rented or living rent free: Total,87,32,25,5,20,3,4,55,40,2,0,7,6
S01011320,Rented or living rent free: Social rented,48,14,10,2,8,2,2,34,28,0,0,3,3
S01011320,Rented or living rent free: Private rented or living rent free,39,18,15,3,12,1,2,21,12,2,0,4,3
S01011321,All HRPs aged 16 and over,252,184,160,29,131,21,3,68,55,1,2,9,1
S01011321,Owned: Total,203,158,139,20,119,18,1,45,42,1,1,1,0
S01011321,Owned: Owned outright,73,37,32,7,25,5,0,36,35,0,0,1,0
S01011321,Owned: Owned with a mortgage or loan or shared ownership,130,121,107,13,94,13,1,9,7,1,1,0,0
S01011321,Rented or living rent free: Total,49,26,21,9,12,3,2,23,13,0,1,8,1
S01011321,Rented or living rent free: Social rented,27,10,6,3,3,2,2,17,7,0,1,8,1
S01011321,Rented or living rent free: Private rented or living rent free,22,16,15,6,9,1,0,6,6,0,0,0,0
S01011322,All HRPs aged 16 and over,251,169,148,27,121,15,6,82,67,1,4,9,1
S01011322,Owned: Total,197,138,125,16,109,10,3,59,57,1,1,0,0
S01011322,Owned: Owned outright,77,29,26,9,17,2,1,48,46,1,1,0,0
S01011322,Owned: Owned with a mortgage or loan or shared ownership,120,109,99,7,92,8,2,11,11,0,0,0,0
S01011322,Rented or living rent free: Total,54,31,23,11,12,5,3,23,10,0,3,9,1
S01011322,Rented or living rent free: Social rented,40,22,18,8,10,2,2,18,9,0,1,8,0
S01011322,Rented or living rent free: Private rented or living rent free,14,9,5,3,2,3,1,5,1,0,2,1,1
S01011323,All HRPs aged 16 and over,374,256,207,39,168,30,19,118,83,0,7,25,3
S01011323,Owned: Total,233,167,142,12,130,22,3,66,57,0,3,3,3
S01011323,Owned: Owned outright,82,30,20,4,16,8,2,52,48,0,1,2,1
S01011323,Owned: Owned with a mortgage or loan or shared ownership,151,137,122,8,114,14,1,14,9,0,2,1,2
S01011323,Rented or living rent free: Total,141,89,65,27,38,8,16,52,26,0,4,22,0
S01011323,Rented or living rent free: Social rented,102,60,45,21,24,7,8,42,21,0,2,19,0
S01011323,Rented or living rent free: Private rented or living rent free,39,29,20,6,14,1,8,10,5,0,2,3,0
S01011324,All HRPs aged 16 and over,202,121,96,24,72,18,7,81,65,0,2,13,1
S01011324,Owned: Total,154,98,80,16,64,16,2,56,50,0,1,4,1
S01011324,Owned: Owned outright,75,30,25,7,18,5,0,45,42,0,0,2,1
S01011324,Owned: Owned with a mortgage or loan or shared ownership,79,68,55,9,46,11,2,11,8,0,1,2,0
S01011324,Rented or living rent free: Total,48,23,16,8,8,2,5,25,15,0,1,9,0
S01011324,Rented or living rent free: Social rented,31,11,7,4,3,1,3,20,12,0,1,7,0
S01011324,Rented or living rent free: Private rented or living rent free,17,12,9,4,5,1,2,5,3,0,0,2,0
S01011325,All HRPs aged 16 and over,472,246,182,46,136,33,31,226,148,5,7,46,20
S01011325,Owned: Total,262,144,122,30,92,20,2,118,98,1,1,8,10
S01011325,Owned: Owned outright,131,40,33,20,13,5,2,91,79,0,0,4,8
S01011325,Owned: Owned with a mortgage or loan or shared ownership,131,104,89,10,79,15,0,27,19,1,1,4,2
S01011325,Rented or living rent free: Total,210,102,60,16,44,13,29,108,50,4,6,38,10
S01011325,Rented or living rent free: Social rented,77,18,13,5,8,1,4,59,35,0,4,18,2
S01011325,Rented or living rent free: Private rented or living rent free,133,84,47,11,36,12,25,49,15,4,2,20,8
S01011326,All HRPs aged 16 and over,521,245,183,54,129,36,26,276,216,1,9,41,9
S01011326,Owned: Total,286,128,98,19,79,28,2,158,141,0,1,11,5
S01011326,Owned: Owned outright,171,39,29,9,20,10,0,132,121,0,0,6,5
S01011326,Owned: Owned with a mortgage or loan or shared ownership,115,89,69,10,59,18,2,26,20,0,1,5,0
S01011326,Rented or living rent free: Total,235,117,85,35,50,8,24,118,75,1,8,30,4
S01011326,Rented or living rent free: Social rented,60,9,6,3,3,2,1,51,42,0,0,8,1
S01011326,Rented or living rent free: Private rented or living rent free,175,108,79,32,47,6,23,67,33,1,8,22,3
S01011327,All HRPs aged 16 and over,400,188,138,32,106,36,14,212,177,0,5,27,3
S01011327,Owned: Total,262,120,85,16,69,31,4,142,135,0,2,5,0
S01011327,Owned: Owned outright,184,61,39,9,30,19,3,123,121,0,0,2,0
S01011327,Owned: Owned with a mortgage or loan or shared ownership,78,59,46,7,39,12,1,19,14,0,2,3,0
S01011327,Rented or living rent free: Total,138,68,53,16,37,5,10,70,42,0,3,22,3
S01011327,Rented or living rent free: Social rented,60,25,18,5,13,2,5,35,20,0,1,12,2
S01011327,Rented or living rent free: Private rented or living rent free,78,43,35,11,24,3,5,35,22,0,2,10,1
S01011328,All HRPs aged 16 and over,355,172,120,22,98,46,6,183,158,0,2,19,4
S01011328,Owned: Total,262,124,90,16,74,34,0,138,133,0,0,3,2
S01011328,Owned: Owned outright,176,54,37,10,27,17,0,122,118,0,0,2,2
S01011328,Owned: Owned with a mortgage or loan or shared ownership,86,70,53,6,47,17,0,16,15,0,0,1,0
S01011328,Rented or living rent free: Total,93,48,30,6,24,12,6,45,25,0,2,16,2
S01011328,Rented or living rent free: Social rented,45,20,14,2,12,4,2,25,17,0,0,7,1
S01011328,Rented or living rent free: Private rented or living rent free,48,28,16,4,12,8,4,20,8,0,2,9,1
S01011329,All HRPs aged 16 and over,484,226,180,32,148,32,14,258,231,5,6,13,3
S01011329,Owned: Total,360,171,144,21,123,22,5,189,184,2,0,2,1
S01011329,Owned: Owned outright,212,45,37,10,27,5,3,167,165,0,0,1,1
S01011329,Owned: Owned with a mortgage or loan or shared ownership,148,126,107,11,96,17,2,22,19,2,0,1,0
S01011329,Rented or living rent free: Total,124,55,36,11,25,10,9,69,47,3,6,11,2
S01011329,Rented or living rent free: Social rented,45,8,5,4,1,3,0,37,30,1,0,6,0
S01011329,Rented or living rent free: Private rented or living rent free,79,47,31,7,24,7,9,32,17,2,6,5,2
S01011330,All HRPs aged 16 and over,324,181,154,24,130,24,3,143,135,0,0,4,4
S01011330,Owned: Total,294,167,144,20,124,22,1,127,124,0,0,1,2
S01011330,Owned: Owned outright,171,57,50,14,36,7,0,114,112,0,0,1,1
S01011330,Owned: Owned with a mortgage or loan or shared ownership,123,110,94,6,88,15,1,13,12,0,0,0,1
S01011330,Rented or living rent free: Total,30,14,10,4,6,2,2,16,11,0,0,3,2
S01011330,Rented or living rent free: Social rented,13,5,4,4,0,1,0,8,6,0,0,2,0
S01011330,Rented or living rent free: Private rented or living rent free,17,9,6,0,6,1,2,8,5,0,0,1,2
S01011331,All HRPs aged 16 and over,336,154,132,15,117,20,2,182,178,0,1,1,2
S01011331,Owned: Total,322,148,127,13,114,19,2,174,171,0,1,1,1
S01011331,Owned: Owned outright,195,48,41,11,30,6,1,147,145,0,1,0,1
S01011331,Owned: Owned with a mortgage or loan or shared ownership,127,100,86,2,84,13,1,27,26,0,0,1,0
S01011331,Rented or living rent free: Total,14,6,5,2,3,1,0,8,7,0,0,0,1
S01011331,Rented or living rent free: Social rented,3,0,0,0,0,0,0,3,2,0,0,0,1
S01011331,Rented or living rent free: Private rented or living rent free,11,6,5,2,3,1,0,5,5,0,0,0,0
S01011332,All HRPs aged 16 and over,385,215,175,29,146,39,1,170,166,1,1,2,0
S01011332,Owned: Total,361,196,157,23,134,38,1,165,163,0,1,1,0
S01011332,Owned: Owned outright,212,68,57,17,40,11,0,144,142,0,1,1,0
S01011332,Owned: Owned with a mortgage or loan or shared ownership,149,128,100,6,94,27,1,21,21,0,0,0,0
S01011332,Rented or living rent free: Total,24,19,18,6,12,1,0,5,3,1,0,1,0
S01011332,Rented or living rent free: Social rented,2,2,2,1,1,0,0,0,0,0,0,0,0
S01011332,Rented or living rent free: Private rented or living rent free,22,17,16,5,11,1,0,5,3,1,0,1,0
S01011333,All HRPs aged 16 and over,386,165,123,18,105,39,3,221,215,0,1,3,2
S01011333,Owned: Total,341,137,97,14,83,39,1,204,199,0,1,2,2
S01011333,Owned: Owned outright,251,66,42,5,37,23,1,185,182,0,0,1,2
S01011333,Owned: Owned with a mortgage or loan or shared ownership,90,71,55,9,46,16,0,19,17,0,1,1,0
S01011333,Rented or living rent free: Total,45,28,26,4,22,0,2,17,16,0,0,1,0
S01011333,Rented or living rent free: Social rented,3,2,1,1,0,0,1,1,0,0,0,1,0
S01011333,Rented or living rent free: Private rented or living rent free,42,26,25,3,22,0,1,16,16,0,0,0,0
S01011334,All HRPs aged 16 and over,297,208,122,16,106,77,9,89,81,0,4,2,2
S01011334,Owned: Total,225,168,100,13,87,65,3,57,54,0,1,0,2
S01011334,Owned: Owned outright,130,80,35,11,24,44,1,50,48,0,0,0,2
S01011334,Owned: Owned with a mortgage or loan or shared ownership,95,88,65,2,63,21,2,7,6,0,1,0,0
S01011334,Rented or living rent free: Total,72,40,22,3,19,12,6,32,27,0,3,2,0
S01011334,Rented or living rent free: Social rented,29,8,3,1,2,2,3,21,21,0,0,0,0
S01011334,Rented or living rent free: Private rented or living rent free,43,32,19,2,17,10,3,11,6,0,3,2,0
S01011335,All HRPs aged 16 and over,438,232,176,24,152,49,7,206,196,0,2,6,2
S01011335,Owned: Total,377,195,147,17,130,43,5,182,178,0,2,1,1
S01011335,Owned: Owned outright,236,73,54,8,46,19,0,163,160,0,1,1,1
S01011335,Owned: Owned with a mortgage or loan or shared ownership,141,122,93,9,84,24,5,19,18,0,1,0,0
S01011335,Rented or living rent free: Total,61,37,29,7,22,6,2,24,18,0,0,5,1
S01011335,Rented or living rent free: Social rented,5,3,3,0,3,0,0,2,2,0,0,0,0
S01011335,Rented or living rent free: Private rented or living rent free,56,34,26,7,19,6,2,22,16,0,0,5,1
S01011336,All HRPs aged 16 and over,266,163,130,21,109,16,17,103,77,0,10,15,1
S01011336,Owned: Total,182,119,98,12,86,15,6,63,59,0,0,4,0
S01011336,Owned: Owned outright,71,28,19,5,14,5,4,43,40,0,0,3,0
S01011336,Owned: Owned with a mortgage or loan or shared ownership,111,91,79,7,72,10,2,20,19,0,0,1,0
S01011336,Rented or living rent free: Total,84,44,32,9,23,1,11,40,18,0,10,11,1
S01011336,Rented or living rent free: Social rented,52,22,16,7,9,0,6,30,17,0,3,9,1
S01011336,Rented or living rent free: Private rented or living rent free,32,22,16,2,14,1,5,10,1,0,7,2,0
S01011337,All HRPs aged 16 and over,287,182,128,15,113,51,3,105,102,0,1,1,1
S01011337,Owned: Total,260,164,117,13,104,46,1,96,95,0,0,0,1
S01011337,Owned: Owned outright,142,60,44,7,37,16,0,82,82,0,0,0,0
S01011337,Owned: Owned with a mortgage or loan or shared ownership,118,104,73,6,67,30,1,14,13,0,0,0,1
S01011337,Rented or living rent free: Total,27,18,11,2,9,5,2,9,7,0,1,1,0
S01011337,Rented or living rent free: Social rented,6,4,2,0,2,1,1,2,0,0,1,1,0
S01011337,Rented or living rent free: Private rented or living rent free,21,14,9,2,7,4,1,7,7,0,0,0,0
S01011338,All HRPs aged 16 and over,270,194,152,24,128,16,26,76,52,3,2,16,3
S01011338,Owned: Total,174,135,119,12,107,13,3,39,37,1,1,0,0
S01011338,Owned: Owned outright,60,31,29,7,22,1,1,29,29,0,0,0,0
S01011338,Owned: Owned with a mortgage or loan or shared ownership,114,104,90,5,85,12,2,10,8,1,1,0,0
S01011338,Rented or living rent free: Total,96,59,33,12,21,3,23,37,15,2,1,16,3
S01011338,Rented or living rent free: Social rented,79,47,29,11,18,1,17,32,14,1,1,13,3
S01011338,Rented or living rent free: Private rented or living rent free,17,12,4,1,3,2,6,5,1,1,0,3,0
S01011339,All HRPs aged 16 and over,219,142,120,27,93,13,9,77,56,1,7,10,3
S01011339,Owned: Total,121,85,72,9,63,10,3,36,33,1,1,1,0
S01011339,Owned: Owned outright,52,18,15,5,10,2,1,34,32,1,0,1,0
S01011339,Owned: Owned with a mortgage or loan or shared ownership,69,67,57,4,53,8,2,2,1,0,1,0,0
S01011339,Rented or living rent free: Total,98,57,48,18,30,3,6,41,23,0,6,9,3
S01011339,Rented or living rent free: Social rented,91,55,46,16,30,3,6,36,21,0,5,7,3
S01011339,Rented or living rent free: Private rented or living rent free,7,2,2,2,0,0,0,5,2,0,1,2,0
S01011340,All HRPs aged 16 and over,290,160,128,28,100,19,13,130,97,3,7,18,5
S01011340,Owned: Total,128,83,66,8,58,12,5,45,42,0,1,2,0
S01011340,Owned: Owned outright,67,29,21,3,18,4,4,38,37,0,1,0,0
S01011340,Owned: Owned with a mortgage or loan or shared ownership,61,54,45,5,40,8,1,7,5,0,0,2,0
S01011340,Rented or living rent free: Total,162,77,62,20,42,7,8,85,55,3,6,16,5
S01011340,Rented or living rent free: Social rented,150,73,59,18,41,6,8,77,52,1,4,15,5
S01011340,Rented or living rent free: Private rented or living rent free,12,4,3,2,1,1,0,8,3,2,2,1,0
S01011341,All HRPs aged 16 and over,346,216,178,30,148,14,24,130,80,6,5,32,7
S01011341,Owned: Total,173,125,112,11,101,10,3,48,43,0,0,3,2
S01011341,Owned: Owned outright,73,30,25,6,19,3,2,43,38,0,0,3,2
S01011341,Owned: Owned with a mortgage or loan or shared ownership,100,95,87,5,82,7,1,5,5,0,0,0,0
S01011341,Rented or living rent free: Total,173,91,66,19,47,4,21,82,37,6,5,29,5
S01011341,Rented or living rent free: Social rented,129,66,51,16,35,2,13,63,34,1,3,21,4
S01011341,Rented or living rent free: Private rented or living rent free,44,25,15,3,12,2,8,19,3,5,2,8,1
S01011342,All HRPs aged 16 and over,325,208,172,14,158,23,13,117,94,3,4,12,4
S01011342,Owned: Total,239,170,145,9,136,22,3,69,66,0,0,2,1
S01011342,Owned: Owned outright,96,36,29,3,26,5,2,60,59,0,0,1,0
S01011342,Owned: Owned with a mortgage or loan or shared ownership,143,134,116,6,110,17,1,9,7,0,0,1,1
S01011342,Rented or living rent free: Total,86,38,27,5,22,1,10,48,28,3,4,10,3
S01011342,Rented or living rent free: Social rented,36,8,5,0,5,0,3,28,23,0,2,3,0
S01011342,Rented or living rent free: Private rented or living rent free,50,30,22,5,17,1,7,20,5,3,2,7,3
S01011343,All HRPs aged 16 and over,434,245,189,42,147,18,38,189,124,2,12,39,12
S01011343,Owned: Total,209,134,118,18,100,13,3,75,71,0,1,2,1
S01011343,Owned: Owned outright,82,28,26,5,21,2,0,54,51,0,1,2,0
S01011343,Owned: Owned with a mortgage or loan or shared ownership,127,106,92,13,79,11,3,21,20,0,0,0,1
S01011343,Rented or living rent free: Total,225,111,71,24,47,5,35,114,53,2,11,37,11
S01011343,Rented or living rent free: Social rented,191,91,60,22,38,4,27,100,52,2,10,29,7
S01011343,Rented or living rent free: Private rented or living rent free,34,20,11,2,9,1,8,14,1,0,1,8,4
S01011344,All HRPs aged 16 and over,401,236,174,39,135,16,46,165,101,3,16,36,9
S01011344,Owned: Total,166,102,88,14,74,12,2,64,57,1,2,4,0
S01011344,Owned: Owned outright,66,23,21,4,17,2,0,43,42,0,0,1,0
S01011344,Owned: Owned with a mortgage or loan or shared ownership,100,79,67,10,57,10,2,21,15,1,2,3,0
S01011344,Rented or living rent free: Total,235,134,86,25,61,4,44,101,44,2,14,32,9
S01011344,Rented or living rent free: Social rented,223,123,78,22,56,2,43,100,43,2,14,32,9
S01011344,Rented or living rent free: Private rented or living rent free,12,11,8,3,5,2,1,1,1,0,0,0,0
S01011345,All HRPs aged 16 and over,357,237,179,54,125,16,42,120,68,1,23,24,4
S01011345,Owned: Total,115,83,74,9,65,9,0,32,24,0,4,3,1
S01011345,Owned: Owned outright,39,18,18,3,15,0,0,21,17,0,1,2,1
S01011345,Owned: Owned with a mortgage or loan or shared ownership,76,65,56,6,50,9,0,11,7,0,3,1,0
S01011345,Rented or living rent free: Total,242,154,105,45,60,7,42,88,44,1,19,21,3
S01011345,Rented or living rent free: Social rented,228,145,98,42,56,7,40,83,43,1,16,20,3
S01011345,Rented or living rent free: Private rented or living rent free,14,9,7,3,4,0,2,5,1,0,3,1,0
S01011346,All HRPs aged 16 and over,325,187,150,24,126,20,17,138,105,6,4,21,2
S01011346,Owned: Total,200,134,118,13,105,15,1,66,58,2,0,4,2
S01011346,Owned: Owned outright,81,28,24,7,17,3,1,53,49,0,0,2,2
S01011346,Owned: Owned with a mortgage or loan or shared ownership,119,106,94,6,88,12,0,13,9,2,0,2,0
S01011346,Rented or living rent free: Total,125,53,32,11,21,5,16,72,47,4,4,17,0
S01011346,Rented or living rent free: Social rented,100,37,24,10,14,2,11,63,44,2,1,16,0
S01011346,Rented or living rent free: Private rented or living rent free,25,16,8,1,7,3,5,9,3,2,3,1,0
S01011347,All HRPs aged 16 and over,547,318,247,34,213,31,40,229,182,2,8,33,4
S01011347,Owned: Total,348,215,180,20,160,27,8,133,124,1,2,6,0
S01011347,Owned: Owned outright,183,64,52,15,37,10,2,119,113,0,1,5,0
S01011347,Owned: Owned with a mortgage or loan or shared ownership,165,151,128,5,123,17,6,14,11,1,1,1,0
S01011347,Rented or living rent free: Total,199,103,67,14,53,4,32,96,58,1,6,27,4
S01011347,Rented or living rent free: Social rented,149,69,42,11,31,1,26,80,48,1,6,21,4
S01011347,Rented or living rent free: Private rented or living rent free,50,34,25,3,22,3,6,16,10,0,0,6,0
S01011348,All HRPs aged 16 and over,424,264,205,31,174,20,39,160,116,0,9,29,6
S01011348,Owned: Total,200,140,128,14,114,11,1,60,57,0,0,1,2
S01011348,Owned: Owned outright,76,31,27,5,22,3,1,45,44,0,0,0,1
S01011348,Owned: Owned with a mortgage or loan or shared ownership,124,109,101,9,92,8,0,15,13,0,0,1,1
S01011348,Rented or living rent free: Total,224,124,77,17,60,9,38,100,59,0,9,28,4
S01011348,Rented or living rent free: Social rented,208,115,71,15,56,8,36,93,59,0,5,25,4
S01011348,Rented or living rent free: Private rented or living rent free,16,9,6,2,4,1,2,7,0,0,4,3,0
S01011349,All HRPs aged 16 and over,367,307,256,22,234,38,13,60,49,1,2,7,1
S01011349,Owned: Total,335,283,241,21,220,36,6,52,47,1,0,3,1
S01011349,Owned: Owned outright,104,59,48,10,38,9,2,45,43,0,0,2,0
S01011349,Owned: Owned with a mortgage or loan or shared ownership,231,224,193,11,182,27,4,7,4,1,0,1,1
S01011349,Rented or living rent free: Total,32,24,15,1,14,2,7,8,2,0,2,4,0
S01011349,Rented or living rent free: Social rented,10,6,3,1,2,0,3,4,2,0,1,1,0
S01011349,Rented or living rent free: Private rented or living rent free,22,18,12,0,12,2,4,4,0,0,1,3,0
S01011350,All HRPs aged 16 and over,275,176,134,18,116,39,3,99,91,0,3,5,0
S01011350,Owned: Total,251,166,126,18,108,39,1,85,81,0,1,3,0
S01011350,Owned: Owned outright,140,63,45,11,34,17,1,77,74,0,0,3,0
S01011350,Owned: Owned with a mortgage or loan or shared ownership,111,103,81,7,74,22,0,8,7,0,1,0,0
S01011350,Rented or living rent free: Total,24,10,8,0,8,0,2,14,10,0,2,2,0
S01011350,Rented or living rent free: Social rented,14,3,2,0,2,0,1,11,8,0,1,2,0
S01011350,Rented or living rent free: Private rented or living rent free,10,7,6,0,6,0,1,3,2,0,1,0,0
S01011351,All HRPs aged 16 and over,353,192,156,37,119,11,25,161,99,2,16,34,10
S01011351,Owned: Total,148,95,84,15,69,9,2,53,47,1,2,2,1
S01011351,Owned: Owned outright,57,15,14,6,8,1,0,42,39,1,0,1,1
S01011351,Owned: Owned with a mortgage or loan or shared ownership,91,80,70,9,61,8,2,11,8,0,2,1,0
S01011351,Rented or living rent free: Total,205,97,72,22,50,2,23,108,52,1,14,32,9
S01011351,Rented or living rent free: Social rented,178,81,61,19,42,2,18,97,44,1,13,32,7
S01011351,Rented or living rent free: Private rented or living rent free,27,16,11,3,8,0,5,11,8,0,1,0,2
S01011352,All HRPs aged 16 and over,328,203,157,25,132,25,21,125,99,3,0,15,8
S01011352,Owned: Total,193,136,113,10,103,19,4,57,53,0,0,3,1
S01011352,Owned: Owned outright,78,31,25,4,21,4,2,47,46,0,0,0,1
S01011352,Owned: Owned with a mortgage or loan or shared ownership,115,105,88,6,82,15,2,10,7,0,0,3,0
S01011352,Rented or living rent free: Total,135,67,44,15,29,6,17,68,46,3,0,12,7
S01011352,Rented or living rent free: Social rented,83,23,16,5,11,0,7,60,43,3,0,9,5
S01011352,Rented or living rent free: Private rented or living rent free,52,44,28,10,18,6,10,8,3,0,0,3,2
S01011353,All HRPs aged 16 and over,274,177,148,24,124,18,11,97,75,4,4,12,2
S01011353,Owned: Total,171,124,108,16,92,12,4,47,44,1,0,1,1
S01011353,Owned: Owned outright,74,32,24,7,17,6,2,42,41,0,0,0,1
S01011353,Owned: Owned with a mortgage or loan or shared ownership,97,92,84,9,75,6,2,5,3,1,0,1,0
S01011353,Rented or living rent free: Total,103,53,40,8,32,6,7,50,31,3,4,11,1
S01011353,Rented or living rent free: Social rented,89,47,37,8,29,5,5,42,29,1,3,9,0
S01011353,Rented or living rent free: Private rented or living rent free,14,6,3,0,3,1,2,8,2,2,1,2,1
S01011354,All HRPs aged 16 and over,313,192,156,22,134,28,8,121,103,1,2,11,4
S01011354,Owned: Total,255,161,131,14,117,25,5,94,92,0,0,2,0
S01011354,Owned: Owned outright,124,42,29,6,23,11,2,82,81,0,0,1,0
S01011354,Owned: Owned with a mortgage or loan or shared ownership,131,119,102,8,94,14,3,12,11,0,0,1,0
S01011354,Rented or living rent free: Total,58,31,25,8,17,3,3,27,11,1,2,9,4
S01011354,Rented or living rent free: Social rented,46,25,19,7,12,3,3,21,9,1,1,7,3
S01011354,Rented or living rent free: Private rented or living rent free,12,6,6,1,5,0,0,6,2,0,1,2,1
S01011355,All HRPs aged 16 and over,433,263,221,26,195,30,12,170,152,3,3,12,0
S01011355,Owned: Total,277,175,150,12,138,23,2,102,101,0,0,1,0
S01011355,Owned: Owned outright,129,44,34,8,26,9,1,85,85,0,0,0,0
S01011355,Owned: Owned with a mortgage or loan or shared ownership,148,131,116,4,112,14,1,17,16,0,0,1,0
S01011355,Rented or living rent free: Total,156,88,71,14,57,7,10,68,51,3,3,11,0
S01011355,Rented or living rent free: Social rented,134,74,57,12,45,7,10,60,45,2,2,11,0
S01011355,Rented or living rent free: Private rented or living rent free,22,14,14,2,12,0,0,8,6,1,1,0,0
S01011356,All HRPs aged 16 and over,392,285,186,17,169,92,7,107,89,1,4,9,4
S01011356,Owned: Total,339,256,168,12,156,87,1,83,78,0,1,3,1
S01011356,Owned: Owned outright,159,93,45,8,37,47,1,66,65,0,0,1,0
S01011356,Owned: Owned with a mortgage or loan or shared ownership,180,163,123,4,119,40,0,17,13,0,1,2,1
S01011356,Rented or living rent free: Total,53,29,18,5,13,5,6,24,11,1,3,6,3
S01011356,Rented or living rent free: Social rented,26,13,9,4,5,2,2,13,5,0,2,4,2
S01011356,Rented or living rent free: Private rented or living rent free,27,16,9,1,8,3,4,11,6,1,1,2,1
S01011357,All HRPs aged 16 and over,354,201,167,26,141,29,5,153,124,0,9,17,3
S01011357,Owned: Total,243,162,132,16,116,27,3,81,71,0,4,5,1
S01011357,Owned: Owned outright,120,50,38,9,29,10,2,70,63,0,3,4,0
S01011357,Owned: Owned with a mortgage or loan or shared ownership,123,112,94,7,87,17,1,11,8,0,1,1,1
S01011357,Rented or living rent free: Total,111,39,35,10,25,2,2,72,53,0,5,12,2
S01011357,Rented or living rent free: Social rented,95,26,24,6,18,1,1,69,50,0,5,12,2
S01011357,Rented or living rent free: Private rented or living rent free,16,13,11,4,7,1,1,3,3,0,0,0,0
S01011358,All HRPs aged 16 and over,186,162,150,13,137,12,0,24,16,2,1,4,1
S01011358,Owned: Total,168,149,137,10,127,12,0,19,13,2,0,3,1
S01011358,Owned: Owned outright,26,15,13,1,12,2,0,11,9,2,0,0,0
S01011358,Owned: Owned with a mortgage or loan or shared ownership,142,134,124,9,115,10,0,8,4,0,0,3,1
S01011358,Rented or living rent free: Total,18,13,13,3,10,0,0,5,3,0,1,1,0
S01011358,Rented or living rent free: Social rented,4,3,3,0,3,0,0,1,0,0,1,0,0
S01011358,Rented or living rent free: Private rented or living rent free,14,10,10,3,7,0,0,4,3,0,0,1,0
S01011359,All HRPs aged 16 and over,368,190,154,24,130,20,16,178,138,2,4,27,7
S01011359,Owned: Total,220,125,108,15,93,15,2,95,88,1,0,4,2
S01011359,Owned: Owned outright,106,41,35,9,26,5,1,65,61,1,0,2,1
S01011359,Owned: Owned with a mortgage or loan or shared ownership,114,84,73,6,67,10,1,30,27,0,0,2,1
S01011359,Rented or living rent free: Total,148,65,46,9,37,5,14,83,50,1,4,23,5
S01011359,Rented or living rent free: Social rented,120,44,31,8,23,2,11,76,44,1,3,23,5
S01011359,Rented or living rent free: Private rented or living rent free,28,21,15,1,14,3,3,7,6,0,1,0,0
S01011360,All HRPs aged 16 and over,354,256,198,47,151,11,47,98,40,2,13,32,11
S01011360,Owned: Total,72,55,48,7,41,5,2,17,16,0,1,0,0
S01011360,Owned: Owned outright,22,12,10,1,9,1,1,10,10,0,0,0,0
S01011360,Owned: Owned with a mortgage or loan or shared ownership,50,43,38,6,32,4,1,7,6,0,1,0,0
S01011360,Rented or living rent free: Total,282,201,150,40,110,6,45,81,24,2,12,32,11
S01011360,Rented or living rent free: Social rented,271,194,144,37,107,6,44,77,24,2,12,29,10
S01011360,Rented or living rent free: Private rented or living rent free,11,7,6,3,3,0,1,4,0,0,0,3,1
S01011361,All HRPs aged 16 and over,343,215,130,32,98,13,72,128,57,3,14,44,10
S01011361,Owned: Total,20,16,15,1,14,1,0,4,2,0,0,2,0
S01011361,Owned: Owned outright,5,2,1,0,1,1,0,3,1,0,0,2,0
S01011361,Owned: Owned with a mortgage or loan or shared ownership,15,14,14,1,13,0,0,1,1,0,0,0,0
S01011361,Rented or living rent free: Total,323,199,115,31,84,12,72,124,55,3,14,42,10
S01011361,Rented or living rent free: Social rented,322,198,115,31,84,11,72,124,55,3,14,42,10
S01011361,Rented or living rent free: Private rented or living rent free,1,1,0,0,0,1,0,0,0,0,0,0,0
S01011362,All HRPs aged 16 and over,199,169,130,11,119,36,3,30,25,1,1,3,0
S01011362,Owned: Total,182,161,125,9,116,34,2,21,17,1,1,2,0
S01011362,Owned: Owned outright,52,36,21,5,16,15,0,16,13,1,0,2,0
S01011362,Owned: Owned with a mortgage or loan or shared ownership,130,125,104,4,100,19,2,5,4,0,1,0,0
S01011362,Rented or living rent free: Total,17,8,5,2,3,2,1,9,8,0,0,1,0
S01011362,Rented or living rent free: Social rented,10,5,4,2,2,0,1,5,4,0,0,1,0
S01011362,Rented or living rent free: Private rented or living rent free,7,3,1,0,1,2,0,4,4,0,0,0,0
S01011363,All HRPs aged 16 and over,429,224,177,32,145,32,15,205,138,3,5,55,4
S01011363,Owned: Total,237,141,117,17,100,23,1,96,91,0,1,3,1
S01011363,Owned: Owned outright,117,41,37,11,26,3,1,76,73,0,0,2,1
S01011363,Owned: Owned with a mortgage or loan or shared ownership,120,100,80,6,74,20,0,20,18,0,1,1,0
S01011363,Rented or living rent free: Total,192,83,60,15,45,9,14,109,47,3,4,52,3
S01011363,Rented or living rent free: Social rented,156,59,40,6,34,5,14,97,44,3,3,45,2
S01011363,Rented or living rent free: Private rented or living rent free,36,24,20,9,11,4,0,12,3,0,1,7,1
S01011364,All HRPs aged 16 and over,272,193,167,18,149,18,8,79,68,0,1,8,2
S01011364,Owned: Total,216,158,142,16,126,13,3,58,51,0,0,6,1
S01011364,Owned: Owned outright,67,26,22,4,18,3,1,41,39,0,0,1,1
S01011364,Owned: Owned with a mortgage or loan or shared ownership,149,132,120,12,108,10,2,17,12,0,0,5,0
S01011364,Rented or living rent free: Total,56,35,25,2,23,5,5,21,17,0,1,2,1
S01011364,Rented or living rent free: Social rented,40,20,14,1,13,3,3,20,17,0,1,1,1
S01011364,Rented or living rent free: Private rented or living rent free,16,15,11,1,10,2,2,1,0,0,0,1,0
S01011365,All HRPs aged 16 and over,207,176,154,12,142,18,4,31,26,0,4,1,0
S01011365,Owned: Total,187,163,147,10,137,16,0,24,21,0,2,1,0
S01011365,Owned: Owned outright,32,16,13,5,8,3,0,16,15,0,1,0,0
S01011365,Owned: Owned with a mortgage or loan or shared ownership,155,147,134,5,129,13,0,8,6,0,1,1,0
S01011365,Rented or living rent free: Total,20,13,7,2,5,2,4,7,5,0,2,0,0
S01011365,Rented or living rent free: Social rented,12,5,4,1,3,1,0,7,5,0,2,0,0
S01011365,Rented or living rent free: Private rented or living rent free,8,8,3,1,2,1,4,0,0,0,0,0,0
S01011366,All HRPs aged 16 and over,238,128,116,16,100,7,5,110,81,2,3,23,1
S01011366,Owned: Total,154,94,86,10,76,6,2,60,51,2,2,5,0
S01011366,Owned: Owned outright,63,20,20,4,16,0,0,43,40,0,1,2,0
S01011366,Owned: Owned with a mortgage or loan or shared ownership,91,74,66,6,60,6,2,17,11,2,1,3,0
S01011366,Rented or living rent free: Total,84,34,30,6,24,1,3,50,30,0,1,18,1
S01011366,Rented or living rent free: Social rented,68,22,20,3,17,0,2,46,28,0,0,17,1
S01011366,Rented or living rent free: Private rented or living rent free,16,12,10,3,7,1,1,4,2,0,1,1,0
S01011367,All HRPs aged 16 and over,400,229,204,37,167,14,11,171,118,1,11,36,5
S01011367,Owned: Total,219,129,116,9,107,12,1,90,74,1,2,10,3
S01011367,Owned: Owned outright,90,26,24,4,20,2,0,64,53,1,2,6,2
S01011367,Owned: Owned with a mortgage or loan or shared ownership,129,103,92,5,87,10,1,26,21,0,0,4,1
S01011367,Rented or living rent free: Total,181,100,88,28,60,2,10,81,44,0,9,26,2
S01011367,Rented or living rent free: Social rented,162,88,79,26,53,2,7,74,42,0,6,24,2
S01011367,Rented or living rent free: Private rented or living rent free,19,12,9,2,7,0,3,7,2,0,3,2,0
S01011368,All HRPs aged 16 and over,291,269,234,16,218,31,4,22,12,2,1,2,5
S01011368,Owned: Total,235,223,197,10,187,25,1,12,9,0,0,0,3
S01011368,Owned: Owned outright,29,22,19,5,14,3,0,7,6,0,0,0,1
S01011368,Owned: Owned with a mortgage or loan or shared ownership,206,201,178,5,173,22,1,5,3,0,0,0,2
S01011368,Rented or living rent free: Total,56,46,37,6,31,6,3,10,3,2,1,2,2
S01011368,Rented or living rent free: Social rented,7,5,4,0,4,0,1,2,1,0,1,0,0
S01011368,Rented or living rent free: Private rented or living rent free,49,41,33,6,27,6,2,8,2,2,0,2,2
S01011369,All HRPs aged 16 and over,380,225,170,26,144,22,33,155,119,2,4,23,7
S01011369,Owned: Total,213,123,106,10,96,16,1,90,85,0,1,4,0
S01011369,Owned: Owned outright,98,22,18,1,17,3,1,76,75,0,0,1,0
S01011369,Owned: Owned with a mortgage or loan or shared ownership,115,101,88,9,79,13,0,14,10,0,1,3,0
S01011369,Rented or living rent free: Total,167,102,64,16,48,6,32,65,34,2,3,19,7
S01011369,Rented or living rent free: Social rented,157,94,57,15,42,5,32,63,32,2,3,19,7
S01011369,Rented or living rent free: Private rented or living rent free,10,8,7,1,6,1,0,2,2,0,0,0,0
S01011370,All HRPs aged 16 and over,307,244,220,19,201,17,7,63,52,1,3,5,2
S01011370,Owned: Total,230,193,177,9,168,14,2,37,33,1,0,3,0
S01011370,Owned: Owned outright,36,19,18,2,16,1,0,17,16,0,0,1,0
S01011370,Owned: Owned with a mortgage or loan or shared ownership,194,174,159,7,152,13,2,20,17,1,0,2,0
S01011370,Rented or living rent free: Total,77,51,43,10,33,3,5,26,19,0,3,2,2
S01011370,Rented or living rent free: Social rented,50,27,21,4,17,2,4,23,19,0,1,1,2
S01011370,Rented or living rent free: Private rented or living rent free,27,24,22,6,16,1,1,3,0,0,2,1,0
S01011371,All HRPs aged 16 and over,503,324,248,49,199,17,59,179,115,3,12,41,8
S01011371,Owned: Total,109,85,75,7,68,6,4,24,21,1,1,1,0
S01011371,Owned: Owned outright,31,17,14,2,12,1,2,14,13,0,0,1,0
S01011371,Owned: Owned with a mortgage or loan or shared ownership,78,68,61,5,56,5,2,10,8,1,1,0,0
S01011371,Rented or living rent free: Total,394,239,173,42,131,11,55,155,94,2,11,40,8
S01011371,Rented or living rent free: Social rented,382,231,166,39,127,11,54,151,93,2,10,39,7
S01011371,Rented or living rent free: Private rented or living rent free,12,8,7,3,4,0,1,4,1,0,1,1,1
S01011372,All HRPs aged 16 and over,411,235,175,38,137,8,52,176,106,12,10,39,9
S01011372,Owned: Total,33,22,21,4,17,0,1,11,10,1,0,0,0
S01011372,Owned: Owned outright,14,7,6,1,5,0,1,7,7,0,0,0,0
S01011372,Owned: Owned with a mortgage or loan or shared ownership,19,15,15,3,12,0,0,4,3,1,0,0,0
S01011372,Rented or living rent free: Total,378,213,154,34,120,8,51,165,96,11,10,39,9
S01011372,Rented or living rent free: Social rented,372,208,151,33,118,6,51,164,95,11,10,39,9
S01011372,Rented or living rent free: Private rented or living rent free,6,5,3,1,2,2,0,1,1,0,0,0,0
S01011373,All HRPs aged 16 and over,350,202,148,33,115,15,39,148,78,22,7,29,12
S01011373,Owned: Total,78,54,48,5,43,5,1,24,21,0,0,2,1
S01011373,Owned: Owned outright,25,11,10,2,8,1,0,14,13,0,0,0,1
S01011373,Owned: Owned with a mortgage or loan or shared ownership,53,43,38,3,35,4,1,10,8,0,0,2,0
S01011373,Rented or living rent free: Total,272,148,100,28,72,10,38,124,57,22,7,27,11
S01011373,Rented or living rent free: Social rented,258,135,89,26,63,9,37,123,56,22,7,27,11
S01011373,Rented or living rent free: Private rented or living rent free,14,13,11,2,9,1,1,1,1,0,0,0,0
S01011374,All HRPs aged 16 and over,276,227,205,16,189,14,8,49,27,0,7,12,3
S01011374,Owned: Total,200,177,161,7,154,13,3,23,16,0,1,5,1
S01011374,Owned: Owned outright,23,7,6,1,5,1,0,16,12,0,1,2,1
S01011374,Owned: Owned with a mortgage or loan or shared ownership,177,170,155,6,149,12,3,7,4,0,0,3,0
S01011374,Rented or living rent free: Total,76,50,44,9,35,1,5,26,11,0,6,7,2
S01011374,Rented or living rent free: Social rented,48,28,26,8,18,1,1,20,7,0,5,6,2
S01011374,Rented or living rent free: Private rented or living rent free,28,22,18,1,17,0,4,6,4,0,1,1,0
S01011375,All HRPs aged 16 and over,295,196,155,24,131,18,23,99,75,3,2,11,8
S01011375,Owned: Total,153,108,92,12,80,14,2,45,41,0,1,1,2
S01011375,Owned: Owned outright,68,29,24,5,19,3,2,39,38,0,0,0,1
S01011375,Owned: Owned with a mortgage or loan or shared ownership,85,79,68,7,61,11,0,6,3,0,1,1,1
S01011375,Rented or living rent free: Total,142,88,63,12,51,4,21,54,34,3,1,10,6
S01011375,Rented or living rent free: Social rented,136,84,60,11,49,4,20,52,34,2,1,9,6
S01011375,Rented or living rent free: Private rented or living rent free,6,4,3,1,2,0,1,2,0,1,0,1,0
S01011376,All HRPs aged 16 and over,326,167,142,27,115,9,16,159,126,2,5,25,1
S01011376,Owned: Total,24,18,16,1,15,2,0,6,4,0,0,1,1
S01011376,Owned: Owned outright,11,6,5,1,4,1,0,5,4,0,0,0,1
S01011376,Owned: Owned with a mortgage or loan or shared ownership,13,12,11,0,11,1,0,1,0,0,0,1,0
S01011376,Rented or living rent free: Total,302,149,126,26,100,7,16,153,122,2,5,24,0
S01011376,Rented or living rent free: Social rented,298,147,124,25,99,7,16,151,122,2,5,22,0
S01011376,Rented or living rent free: Private rented or living rent free,4,2,2,1,1,0,0,2,0,0,0,2,0
S01011377,All HRPs aged 16 and over,262,171,143,11,132,25,3,91,77,1,0,13,0
S01011377,Owned: Total,226,148,123,6,117,23,2,78,71,1,0,6,0
S01011377,Owned: Owned outright,115,46,34,1,33,10,2,69,64,1,0,4,0
S01011377,Owned: Owned with a mortgage or loan or shared ownership,111,102,89,5,84,13,0,9,7,0,0,2,0
S01011377,Rented or living rent free: Total,36,23,20,5,15,2,1,13,6,0,0,7,0
S01011377,Rented or living rent free: Social rented,26,14,13,4,9,1,0,12,5,0,0,7,0
S01011377,Rented or living rent free: Private rented or living rent free,10,9,7,1,6,1,1,1,1,0,0,0,0
S01011378,All HRPs aged 16 and over,362,191,159,25,134,23,9,171,160,0,2,4,5
S01011378,Owned: Total,274,151,128,15,113,20,3,123,117,0,0,2,4
S01011378,Owned: Owned outright,136,42,32,5,27,8,2,94,91,0,0,1,2
S01011378,Owned: Owned with a mortgage or loan or shared ownership,138,109,96,10,86,12,1,29,26,0,0,1,2
S01011378,Rented or living rent free: Total,88,40,31,10,21,3,6,48,43,0,2,2,1
S01011378,Rented or living rent free: Social rented,71,31,24,6,18,2,5,40,37,0,0,2,1
S01011378,Rented or living rent free: Private rented or living rent free,17,9,7,4,3,1,1,8,6,0,2,0,0
S01011379,All HRPs aged 16 and over,342,272,237,12,225,31,4,70,68,0,0,1,1
S01011379,Owned: Total,308,245,212,9,203,30,3,63,61,0,0,1,1
S01011379,Owned: Owned outright,108,55,44,2,42,10,1,53,53,0,0,0,0
S01011379,Owned: Owned with a mortgage or loan or shared ownership,200,190,168,7,161,20,2,10,8,0,0,1,1
S01011379,Rented or living rent free: Total,34,27,25,3,22,1,1,7,7,0,0,0,0
S01011379,Rented or living rent free: Social rented,15,9,8,3,5,0,1,6,6,0,0,0,0
S01011379,Rented or living rent free: Private rented or living rent free,19,18,17,0,17,1,0,1,1,0,0,0,0
S01011380,All HRPs aged 16 and over,357,223,192,31,161,16,15,134,107,2,3,17,5
S01011380,Owned: Total,195,131,113,17,96,13,5,64,62,0,1,1,0
S01011380,Owned: Owned outright,79,35,28,8,20,5,2,44,42,0,1,1,0
S01011380,Owned: Owned with a mortgage or loan or shared ownership,116,96,85,9,76,8,3,20,20,0,0,0,0
S01011380,Rented or living rent free: Total,162,92,79,14,65,3,10,70,45,2,2,16,5
S01011380,Rented or living rent free: Social rented,115,62,53,12,41,3,6,53,34,2,2,13,2
S01011380,Rented or living rent free: Private rented or living rent free,47,30,26,2,24,0,4,17,11,0,0,3,3
S01011381,All HRPs aged 16 and over,302,189,151,20,131,26,12,113,83,8,2,18,2
S01011381,Owned: Total,205,137,111,11,100,21,5,68,60,0,1,6,1
S01011381,Owned: Owned outright,84,30,22,4,18,8,0,54,49,0,1,3,1
S01011381,Owned: Owned with a mortgage or loan or shared ownership,121,107,89,7,82,13,5,14,11,0,0,3,0
S01011381,Rented or living rent free: Total,97,52,40,9,31,5,7,45,23,8,1,12,1
S01011381,Rented or living rent free: Social rented,58,29,22,5,17,1,6,29,17,0,0,11,1
S01011381,Rented or living rent free: Private rented or living rent free,39,23,18,4,14,4,1,16,6,8,1,1,0
S01011382,All HRPs aged 16 and over,286,195,158,26,132,19,18,91,44,0,7,35,5
S01011382,Owned: Total,88,74,61,7,54,12,1,14,14,0,0,0,0
S01011382,Owned: Owned outright,20,9,7,2,5,2,0,11,11,0,0,0,0
S01011382,Owned: Owned with a mortgage or loan or shared ownership,68,65,54,5,49,10,1,3,3,0,0,0,0
S01011382,Rented or living rent free: Total,198,121,97,19,78,7,17,77,30,0,7,35,5
S01011382,Rented or living rent free: Social rented,127,57,47,11,36,1,9,70,28,0,5,32,5
S01011382,Rented or living rent free: Private rented or living rent free,71,64,50,8,42,6,8,7,2,0,2,3,0
S01011383,All HRPs aged 16 and over,394,191,152,40,112,5,34,203,107,2,13,71,10
S01011383,Owned: Total,97,48,47,5,42,0,1,49,38,0,1,9,1
S01011383,Owned: Owned outright,40,7,6,0,6,0,1,33,31,0,0,2,0
S01011383,Owned: Owned with a mortgage or loan or shared ownership,57,41,41,5,36,0,0,16,7,0,1,7,1
S01011383,Rented or living rent free: Total,297,143,105,35,70,5,33,154,69,2,12,62,9
S01011383,Rented or living rent free: Social rented,277,132,96,33,63,4,32,145,68,1,6,61,9
S01011383,Rented or living rent free: Private rented or living rent free,20,11,9,2,7,1,1,9,1,1,6,1,0
S01011384,All HRPs aged 16 and over,328,190,131,48,83,12,47,138,51,2,25,49,11
S01011384,Owned: Total,63,53,48,10,38,4,1,10,10,0,0,0,0
S01011384,Owned: Owned outright,19,11,10,2,8,0,1,8,8,0,0,0,0
S01011384,Owned: Owned with a mortgage or loan or shared ownership,44,42,38,8,30,4,0,2,2,0,0,0,0
S01011384,Rented or living rent free: Total,265,137,83,38,45,8,46,128,41,2,25,49,11
S01011384,Rented or living rent free: Social rented,258,133,79,38,41,8,46,125,40,2,25,48,10
S01011384,Rented or living rent free: Private rented or living rent free,7,4,4,0,4,0,0,3,1,0,0,1,1
S01011385,All HRPs aged 16 and over,441,237,184,50,134,18,35,204,129,2,17,44,12
S01011385,Owned: Total,161,101,87,13,74,10,4,60,52,0,1,6,1
S01011385,Owned: Owned outright,71,21,19,3,16,0,2,50,44,0,0,5,1
S01011385,Owned: Owned with a mortgage or loan or shared ownership,90,80,68,10,58,10,2,10,8,0,1,1,0
S01011385,Rented or living rent free: Total,280,136,97,37,60,8,31,144,77,2,16,38,11
S01011385,Rented or living rent free: Social rented,255,123,87,36,51,7,29,132,75,2,11,36,8
S01011385,Rented or living rent free: Private rented or living rent free,25,13,10,1,9,1,2,12,2,0,5,2,3
S01011386,All HRPs aged 16 and over,208,137,100,33,67,10,27,71,24,1,20,20,6
S01011386,Owned: Total,56,43,32,4,28,8,3,13,10,0,1,1,1
S01011386,Owned: Owned outright,15,7,4,1,3,1,2,8,7,0,1,0,0
S01011386,Owned: Owned with a mortgage or loan or shared ownership,41,36,28,3,25,7,1,5,3,0,0,1,1
S01011386,Rented or living rent free: Total,152,94,68,29,39,2,24,58,14,1,19,19,5
S01011386,Rented or living rent free: Social rented,138,84,61,27,34,2,21,54,13,1,17,18,5
S01011386,Rented or living rent free: Private rented or living rent free,14,10,7,2,5,0,3,4,1,0,2,1,0
S01011387,All HRPs aged 16 and over,366,196,149,27,122,8,39,170,88,0,17,48,17
S01011387,Owned: Total,121,81,74,8,66,5,2,40,36,0,1,3,0
S01011387,Owned: Owned outright,28,10,9,1,8,1,0,18,16,0,1,1,0
S01011387,Owned: Owned with a mortgage or loan or shared ownership,93,71,65,7,58,4,2,22,20,0,0,2,0
S01011387,Rented or living rent free: Total,245,115,75,19,56,3,37,130,52,0,16,45,17
S01011387,Rented or living rent free: Social rented,196,90,63,18,45,2,25,106,51,0,12,28,15
S01011387,Rented or living rent free: Private rented or living rent free,49,25,12,1,11,1,12,24,1,0,4,17,2
S01011388,All HRPs aged 16 and over,435,349,304,19,285,33,12,86,48,5,7,22,4
S01011388,Owned: Total,306,272,244,8,236,26,2,34,26,1,2,4,1
S01011388,Owned: Owned outright,43,21,18,0,18,3,0,22,20,0,0,2,0
S01011388,Owned: Owned with a mortgage or loan or shared ownership,263,251,226,8,218,23,2,12,6,1,2,2,1
S01011388,Rented or living rent free: Total,129,77,60,11,49,7,10,52,22,4,5,18,3
S01011388,Rented or living rent free: Social rented,84,41,30,8,22,2,9,43,19,1,3,18,2
S01011388,Rented or living rent free: Private rented or living rent free,45,36,30,3,27,5,1,9,3,3,2,0,1
S01011389,All HRPs aged 16 and over,415,259,211,41,170,19,29,156,108,1,5,29,13
S01011389,Owned: Total,162,121,106,11,95,13,2,41,34,0,0,5,2
S01011389,Owned: Owned outright,41,14,13,2,11,1,0,27,22,0,0,3,2
S01011389,Owned: Owned with a mortgage or loan or shared ownership,121,107,93,9,84,12,2,14,12,0,0,2,0
S01011389,Rented or living rent free: Total,253,138,105,30,75,6,27,115,74,1,5,24,11
S01011389,Rented or living rent free: Social rented,175,76,64,20,44,2,10,99,69,0,3,21,6
S01011389,Rented or living rent free: Private rented or living rent free,78,62,41,10,31,4,17,16,5,1,2,3,5
S01011390,All HRPs aged 16 and over,342,190,166,32,134,11,13,152,108,3,10,22,9
S01011390,Owned: Total,164,105,94,16,78,9,2,59,53,1,1,2,2
S01011390,Owned: Owned outright,71,28,23,7,16,3,2,43,40,1,0,1,1
S01011390,Owned: Owned with a mortgage or loan or shared ownership,93,77,71,9,62,6,0,16,13,0,1,1,1
S01011390,Rented or living rent free: Total,178,85,72,16,56,2,11,93,55,2,9,20,7
S01011390,Rented or living rent free: Social rented,163,75,64,13,51,1,10,88,51,2,9,20,6
S01011390,Rented or living rent free: Private rented or living rent free,15,10,8,3,5,1,1,5,4,0,0,0,1
S01011391,All HRPs aged 16 and over,254,158,136,27,109,13,9,96,64,5,10,14,3
S01011391,Owned: Total,127,81,71,8,63,9,1,46,37,3,0,4,2
S01011391,Owned: Owned outright,44,15,13,3,10,2,0,29,27,0,0,0,2
S01011391,Owned: Owned with a mortgage or loan or shared ownership,83,66,58,5,53,7,1,17,10,3,0,4,0
S01011391,Rented or living rent free: Total,127,77,65,19,46,4,8,50,27,2,10,10,1
S01011391,Rented or living rent free: Social rented,118,71,60,18,42,4,7,47,26,2,9,9,1
S01011391,Rented or living rent free: Private rented or living rent free,9,6,5,1,4,0,1,3,1,0,1,1,0
S01011392,All HRPs aged 16 and over,287,193,149,37,112,15,29,94,61,1,4,22,6
S01011392,Owned: Total,116,86,70,12,58,11,5,30,27,0,1,2,0
S01011392,Owned: Owned outright,35,11,10,3,7,1,0,24,22,0,0,2,0
S01011392,Owned: Owned with a mortgage or loan or shared ownership,81,75,60,9,51,10,5,6,5,0,1,0,0
S01011392,Rented or living rent free: Total,171,107,79,25,54,4,24,64,34,1,3,20,6
S01011392,Rented or living rent free: Social rented,157,96,74,23,51,4,18,61,34,0,3,20,4
S01011392,Rented or living rent free: Private rented or living rent free,14,11,5,2,3,0,6,3,0,1,0,0,2
S01011393,All HRPs aged 16 and over,374,209,165,28,137,27,17,165,126,1,5,24,9
S01011393,Owned: Total,234,147,121,16,105,23,3,87,78,0,1,7,1
S01011393,Owned: Owned outright,107,35,26,8,18,7,2,72,66,0,0,5,1
S01011393,Owned: Owned with a mortgage or loan or shared ownership,127,112,95,8,87,16,1,15,12,0,1,2,0
S01011393,Rented or living rent free: Total,140,62,44,12,32,4,14,78,48,1,4,17,8
S01011393,Rented or living rent free: Social rented,114,47,37,8,29,1,9,67,39,1,4,15,8
S01011393,Rented or living rent free: Private rented or living rent free,26,15,7,4,3,3,5,11,9,0,0,2,0
S01011394,All HRPs aged 16 and over,212,171,152,7,145,14,5,41,34,0,2,5,0
S01011394,Owned: Total,165,159,145,4,141,11,3,6,4,0,1,1,0
S01011394,Owned: Owned outright,17,14,12,2,10,2,0,3,2,0,1,0,0
S01011394,Owned: Owned with a mortgage or loan or shared ownership,148,145,133,2,131,9,3,3,2,0,0,1,0
S01011394,Rented or living rent free: Total,47,12,7,3,4,3,2,35,30,0,1,4,0
S01011394,Rented or living rent free: Social rented,38,6,5,3,2,0,1,32,29,0,0,3,0
S01011394,Rented or living rent free: Private rented or living rent free,9,6,2,0,2,3,1,3,1,0,1,1,0
S01011395,All HRPs aged 16 and over,409,214,173,33,140,25,16,195,128,2,7,44,14
S01011395,Owned: Total,166,114,92,12,80,18,4,52,46,1,1,2,2
S01011395,Owned: Owned outright,70,27,21,5,16,5,1,43,40,0,0,1,2
S01011395,Owned: Owned with a mortgage or loan or shared ownership,96,87,71,7,64,13,3,9,6,1,1,1,0
S01011395,Rented or living rent free: Total,243,100,81,21,60,7,12,143,82,1,6,42,12
S01011395,Rented or living rent free: Social rented,190,65,55,14,41,5,5,125,77,0,3,37,8
S01011395,Rented or living rent free: Private rented or living rent free,53,35,26,7,19,2,7,18,5,1,3,5,4
S01011396,All HRPs aged 16 and over,402,196,160,22,138,18,18,206,140,3,9,46,8
S01011396,Owned: Total,184,117,99,9,90,15,3,67,59,0,2,3,3
S01011396,Owned: Owned outright,82,27,23,4,19,3,1,55,49,0,1,2,3
S01011396,Owned: Owned with a mortgage or loan or shared ownership,102,90,76,5,71,12,2,12,10,0,1,1,0
S01011396,Rented or living rent free: Total,218,79,61,13,48,3,15,139,81,3,7,43,5
S01011396,Rented or living rent free: Social rented,186,56,44,8,36,1,11,130,75,3,7,40,5
S01011396,Rented or living rent free: Private rented or living rent free,32,23,17,5,12,2,4,9,6,0,0,3,0
S01011397,All HRPs aged 16 and over,364,212,167,32,135,17,28,152,107,13,10,21,1
S01011397,Owned: Total,161,112,100,12,88,11,1,49,46,0,1,2,0
S01011397,Owned: Owned outright,57,20,15,8,7,4,1,37,35,0,0,2,0
S01011397,Owned: Owned with a mortgage or loan or shared ownership,104,92,85,4,81,7,0,12,11,0,1,0,0
S01011397,Rented or living rent free: Total,203,100,67,20,47,6,27,103,61,13,9,19,1
S01011397,Rented or living rent free: Social rented,180,88,59,19,40,5,24,92,55,12,7,17,1
S01011397,Rented or living rent free: Private rented or living rent free,23,12,8,1,7,1,3,11,6,1,2,2,0
S01011398,All HRPs aged 16 and over,322,192,147,31,116,15,30,130,81,0,15,31,3
S01011398,Owned: Total,144,101,86,10,76,9,6,43,38,0,3,2,0
S01011398,Owned: Owned outright,45,17,12,2,10,1,4,28,26,0,1,1,0
S01011398,Owned: Owned with a mortgage or loan or shared ownership,99,84,74,8,66,8,2,15,12,0,2,1,0
S01011398,Rented or living rent free: Total,178,91,61,21,40,6,24,87,43,0,12,29,3
S01011398,Rented or living rent free: Social rented,158,78,53,18,35,4,21,80,41,0,12,24,3
S01011398,Rented or living rent free: Private rented or living rent free,20,13,8,3,5,2,3,7,2,0,0,5,0
S01011399,All HRPs aged 16 and over,240,149,116,28,88,11,22,91,59,0,6,22,4
S01011399,Owned: Total,95,72,63,8,55,6,3,23,22,0,0,1,0
S01011399,Owned: Owned outright,32,14,11,5,6,2,1,18,18,0,0,0,0
S01011399,Owned: Owned with a mortgage or loan or shared ownership,63,58,52,3,49,4,2,5,4,0,0,1,0
S01011399,Rented or living rent free: Total,145,77,53,20,33,5,19,68,37,0,6,21,4
S01011399,Rented or living rent free: Social rented,131,67,46,18,28,4,17,64,36,0,5,19,4
S01011399,Rented or living rent free: Private rented or living rent free,14,10,7,2,5,1,2,4,1,0,1,2,0
S01011400,All HRPs aged 16 and over,357,243,210,24,186,19,14,114,82,0,5,22,5
S01011400,Owned: Total,207,157,141,9,132,15,1,50,45,0,0,4,1
S01011400,Owned: Owned outright,71,33,28,2,26,4,1,38,38,0,0,0,0
S01011400,Owned: Owned with a mortgage or loan or shared ownership,136,124,113,7,106,11,0,12,7,0,0,4,1
S01011400,Rented or living rent free: Total,150,86,69,15,54,4,13,64,37,0,5,18,4
S01011400,Rented or living rent free: Social rented,83,38,27,10,17,2,9,45,25,0,3,14,3
S01011400,Rented or living rent free: Private rented or living rent free,67,48,42,5,37,2,4,19,12,0,2,4,1
S01011401,All HRPs aged 16 and over,287,175,154,21,133,15,6,112,90,2,2,15,3
S01011401,Owned: Total,195,137,123,15,108,12,2,58,55,0,0,1,2
S01011401,Owned: Owned outright,67,26,19,7,12,5,2,41,39,0,0,1,1
S01011401,Owned: Owned with a mortgage or loan or shared ownership,128,111,104,8,96,7,0,17,16,0,0,0,1
S01011401,Rented or living rent free: Total,92,38,31,6,25,3,4,54,35,2,2,14,1
S01011401,Rented or living rent free: Social rented,73,28,22,5,17,2,4,45,30,0,2,13,0
S01011401,Rented or living rent free: Private rented or living rent free,19,10,9,1,8,1,0,9,5,2,0,1,1
S01011402,All HRPs aged 16 and over,492,214,177,26,151,22,15,278,252,1,3,13,9
S01011402,Owned: Total,359,167,145,19,126,16,6,192,184,0,1,4,3
S01011402,Owned: Owned outright,214,48,38,6,32,6,4,166,159,0,1,3,3
S01011402,Owned: Owned with a mortgage or loan or shared ownership,145,119,107,13,94,10,2,26,25,0,0,1,0
S01011402,Rented or living rent free: Total,133,47,32,7,25,6,9,86,68,1,2,9,6
S01011402,Rented or living rent free: Social rented,95,26,18,6,12,3,5,69,57,0,1,6,5
S01011402,Rented or living rent free: Private rented or living rent free,38,21,14,1,13,3,4,17,11,1,1,3,1
S01011403,All HRPs aged 16 and over,208,152,135,28,107,12,5,56,39,0,0,14,3
S01011403,Owned: Total,130,105,96,11,85,9,0,25,22,0,0,1,2
S01011403,Owned: Owned outright,44,23,18,2,16,5,0,21,19,0,0,1,1
S01011403,Owned: Owned with a mortgage or loan or shared ownership,86,82,78,9,69,4,0,4,3,0,0,0,1
S01011403,Rented or living rent free: Total,78,47,39,17,22,3,5,31,17,0,0,13,1
S01011403,Rented or living rent free: Social rented,63,35,28,14,14,2,5,28,14,0,0,13,1
S01011403,Rented or living rent free: Private rented or living rent free,15,12,11,3,8,1,0,3,3,0,0,0,0
S01011404,All HRPs aged 16 and over,468,246,202,30,172,19,25,222,153,3,5,48,13
S01011404,Owned: Total,237,158,137,22,115,14,7,79,74,0,0,5,0
S01011404,Owned: Owned outright,95,35,28,6,22,5,2,60,57,0,0,3,0
S01011404,Owned: Owned with a mortgage or loan or shared ownership,142,123,109,16,93,9,5,19,17,0,0,2,0
S01011404,Rented or living rent free: Total,231,88,65,8,57,5,18,143,79,3,5,43,13
S01011404,Rented or living rent free: Social rented,195,65,49,6,43,4,12,130,73,2,5,42,8
S01011404,Rented or living rent free: Private rented or living rent free,36,23,16,2,14,1,6,13,6,1,0,1,5
S01011405,All HRPs aged 16 and over,298,168,132,21,111,22,14,130,102,0,12,14,2
S01011405,Owned: Total,197,106,86,9,77,19,1,91,89,0,1,1,0
S01011405,Owned: Owned outright,109,32,24,3,21,7,1,77,76,0,0,1,0
S01011405,Owned: Owned with a mortgage or loan or shared ownership,88,74,62,6,56,12,0,14,13,0,1,0,0
S01011405,Rented or living rent free: Total,101,62,46,12,34,3,13,39,13,0,11,13,2
S01011405,Rented or living rent free: Social rented,84,52,38,11,27,2,12,32,10,0,9,11,2
S01011405,Rented or living rent free: Private rented or living rent free,17,10,8,1,7,1,1,7,3,0,2,2,0
S01011406,All HRPs aged 16 and over,287,168,145,21,124,16,7,119,106,1,4,8,0
S01011406,Owned: Total,183,110,97,7,90,13,0,73,70,0,1,2,0
S01011406,Owned: Owned outright,87,27,22,3,19,5,0,60,59,0,0,1,0
S01011406,Owned: Owned with a mortgage or loan or shared ownership,96,83,75,4,71,8,0,13,11,0,1,1,0
S01011406,Rented or living rent free: Total,104,58,48,14,34,3,7,46,36,1,3,6,0
S01011406,Rented or living rent free: Social rented,88,49,41,14,27,3,5,39,33,0,2,4,0
S01011406,Rented or living rent free: Private rented or living rent free,16,9,7,0,7,0,2,7,3,1,1,2,0
S01011407,All HRPs aged 16 and over,506,304,255,39,216,33,16,202,165,5,6,20,6
S01011407,Owned: Total,375,237,198,21,177,29,10,138,126,2,1,8,1
S01011407,Owned: Owned outright,175,62,48,7,41,8,6,113,107,2,0,3,1
S01011407,Owned: Owned with a mortgage or loan or shared ownership,200,175,150,14,136,21,4,25,19,0,1,5,0
S01011407,Rented or living rent free: Total,131,67,57,18,39,4,6,64,39,3,5,12,5
S01011407,Rented or living rent free: Social rented,94,45,41,14,27,1,3,49,34,1,4,10,0
S01011407,Rented or living rent free: Private rented or living rent free,37,22,16,4,12,3,3,15,5,2,1,2,5
S01011408,All HRPs aged 16 and over,369,215,180,30,150,15,20,154,110,1,10,23,10
S01011408,Owned: Total,225,137,118,13,105,11,8,88,76,0,3,7,2
S01011408,Owned: Owned outright,83,30,23,5,18,3,4,53,49,0,1,2,1
S01011408,Owned: Owned with a mortgage or loan or shared ownership,142,107,95,8,87,8,4,35,27,0,2,5,1
S01011408,Rented or living rent free: Total,144,78,62,17,45,4,12,66,34,1,7,16,8
S01011408,Rented or living rent free: Social rented,122,66,53,14,39,4,9,56,28,1,6,15,6
S01011408,Rented or living rent free: Private rented or living rent free,22,12,9,3,6,0,3,10,6,0,1,1,2
S01011409,All HRPs aged 16 and over,362,229,175,42,133,21,33,133,66,1,14,46,6
S01011409,Owned: Total,145,101,87,10,77,14,0,44,37,0,2,3,2
S01011409,Owned: Owned outright,36,15,14,1,13,1,0,21,19,0,1,1,0
S01011409,Owned: Owned with a mortgage or loan or shared ownership,109,86,73,9,64,13,0,23,18,0,1,2,2
S01011409,Rented or living rent free: Total,217,128,88,32,56,7,33,89,29,1,12,43,4
S01011409,Rented or living rent free: Social rented,207,118,85,30,55,5,28,89,29,1,12,43,4
S01011409,Rented or living rent free: Private rented or living rent free,10,10,3,2,1,2,5,0,0,0,0,0,0
S01011410,All HRPs aged 16 and over,316,185,160,33,127,12,13,131,108,1,2,18,2
S01011410,Owned: Total,202,122,104,10,94,12,6,80,75,1,1,3,0
S01011410,Owned: Owned outright,97,33,26,5,21,4,3,64,62,0,0,2,0
S01011410,Owned: Owned with a mortgage or loan or shared ownership,105,89,78,5,73,8,3,16,13,1,1,1,0
S01011410,Rented or living rent free: Total,114,63,56,23,33,0,7,51,33,0,1,15,2
S01011410,Rented or living rent free: Social rented,106,59,52,22,30,0,7,47,30,0,1,14,2
S01011410,Rented or living rent free: Private rented or living rent free,8,4,4,1,3,0,0,4,3,0,0,1,0
S01011411,All HRPs aged 16 and over,285,165,136,27,109,15,14,120,103,1,3,9,4
S01011411,Owned: Total,185,114,97,10,87,12,5,71,67,0,0,1,3
S01011411,Owned: Owned outright,77,23,16,3,13,4,3,54,51,0,0,1,2
S01011411,Owned: Owned with a mortgage or loan or shared ownership,108,91,81,7,74,8,2,17,16,0,0,0,1
S01011411,Rented or living rent free: Total,100,51,39,17,22,3,9,49,36,1,3,8,1
S01011411,Rented or living rent free: Social rented,90,44,35,16,19,2,7,46,34,1,2,8,1
S01011411,Rented or living rent free: Private rented or living rent free,10,7,4,1,3,1,2,3,2,0,1,0,0
S01011412,All HRPs aged 16 and over,357,211,171,13,158,37,3,146,136,0,2,5,3
S01011412,Owned: Total,339,203,166,12,154,35,2,136,132,0,0,2,2
S01011412,Owned: Owned outright,190,69,53,8,45,16,0,121,119,0,0,1,1
S01011412,Owned: Owned with a mortgage or loan or shared ownership,149,134,113,4,109,19,2,15,13,0,0,1,1
S01011412,Rented or living rent free: Total,18,8,5,1,4,2,1,10,4,0,2,3,1
S01011412,Rented or living rent free: Social rented,15,7,4,1,3,2,1,8,3,0,2,2,1
S01011412,Rented or living rent free: Private rented or living rent free,3,1,1,0,1,0,0,2,1,0,0,1,0
S01011413,All HRPs aged 16 and over,218,182,159,15,144,19,4,36,25,2,4,3,2
S01011413,Owned: Total,194,168,148,13,135,19,1,26,21,2,2,1,0
S01011413,Owned: Owned outright,41,22,19,2,17,3,0,19,17,1,1,0,0
S01011413,Owned: Owned with a mortgage or loan or shared ownership,153,146,129,11,118,16,1,7,4,1,1,1,0
S01011413,Rented or living rent free: Total,24,14,11,2,9,0,3,10,4,0,2,2,2
S01011413,Rented or living rent free: Social rented,7,3,1,0,1,0,2,4,2,0,0,1,1
S01011413,Rented or living rent free: Private rented or living rent free,17,11,10,2,8,0,1,6,2,0,2,1,1
S01011414,All HRPs aged 16 and over,377,228,179,41,138,22,27,149,109,2,12,16,10
S01011414,Owned: Total,204,139,120,17,103,16,3,65,63,1,0,0,1
S01011414,Owned: Owned outright,81,31,24,6,18,5,2,50,49,1,0,0,0
S01011414,Owned: Owned with a mortgage or loan or shared ownership,123,108,96,11,85,11,1,15,14,0,0,0,1
S01011414,Rented or living rent free: Total,173,89,59,24,35,6,24,84,46,1,12,16,9
S01011414,Rented or living rent free: Social rented,149,77,49,20,29,5,23,72,41,1,10,12,8
S01011414,Rented or living rent free: Private rented or living rent free,24,12,10,4,6,1,1,12,5,0,2,4,1
S01011415,All HRPs aged 16 and over,408,269,229,35,194,22,18,139,105,0,4,24,6
S01011415,Owned: Total,287,212,188,21,167,22,2,75,67,0,1,6,1
S01011415,Owned: Owned outright,90,33,28,7,21,5,0,57,52,0,0,4,1
S01011415,Owned: Owned with a mortgage or loan or shared ownership,197,179,160,14,146,17,2,18,15,0,1,2,0
S01011415,Rented or living rent free: Total,121,57,41,14,27,0,16,64,38,0,3,18,5
S01011415,Rented or living rent free: Social rented,101,46,32,12,20,0,14,55,33,0,2,16,4
S01011415,Rented or living rent free: Private rented or living rent free,20,11,9,2,7,0,2,9,5,0,1,2,1
S01011416,All HRPs aged 16 and over,240,180,156,14,142,22,2,60,51,0,2,5,2
S01011416,Owned: Total,226,171,150,14,136,20,1,55,50,0,2,1,2
S01011416,Owned: Owned outright,98,51,45,10,35,5,1,47,45,0,0,1,1
S01011416,Owned: Owned with a mortgage or loan or shared ownership,128,120,105,4,101,15,0,8,5,0,2,0,1
S01011416,Rented or living rent free: Total,14,9,6,0,6,2,1,5,1,0,0,4,0
S01011416,Rented or living rent free: Social rented,5,3,2,0,2,0,1,2,1,0,0,1,0
S01011416,Rented or living rent free: Private rented or living rent free,9,6,4,0,4,2,0,3,0,0,0,3,0
S01011417,All HRPs aged 16 and over,374,200,168,19,149,24,8,174,143,3,7,15,6
S01011417,Owned: Total,259,146,124,8,116,19,3,113,99,1,2,7,4
S01011417,Owned: Owned outright,128,37,27,2,25,9,1,91,80,1,2,5,3
S01011417,Owned: Owned with a mortgage or loan or shared ownership,131,109,97,6,91,10,2,22,19,0,0,2,1
S01011417,Rented or living rent free: Total,115,54,44,11,33,5,5,61,44,2,5,8,2
S01011417,Rented or living rent free: Social rented,76,26,21,8,13,1,4,50,38,0,4,7,1
S01011417,Rented or living rent free: Private rented or living rent free,39,28,23,3,20,4,1,11,6,2,1,1,1
S01011418,All HRPs aged 16 and over,264,137,121,26,95,8,8,127,91,2,8,21,5
S01011418,Owned: Total,125,82,75,13,62,5,2,43,39,1,1,2,0
S01011418,Owned: Owned outright,49,23,21,4,17,2,0,26,25,0,0,1,0
S01011418,Owned: Owned with a mortgage or loan or shared ownership,76,59,54,9,45,3,2,17,14,1,1,1,0
S01011418,Rented or living rent free: Total,139,55,46,13,33,3,6,84,52,1,7,19,5
S01011418,Rented or living rent free: Social rented,128,53,45,12,33,3,5,75,48,0,6,17,4
S01011418,Rented or living rent free: Private rented or living rent free,11,2,1,1,0,0,1,9,4,1,1,2,1
S01011419,All HRPs aged 16 and over,253,151,120,22,98,15,16,102,74,2,5,15,6
S01011419,Owned: Total,147,95,80,7,73,14,1,52,44,1,2,4,1
S01011419,Owned: Owned outright,56,18,12,4,8,5,1,38,34,1,1,2,0
S01011419,Owned: Owned with a mortgage or loan or shared ownership,91,77,68,3,65,9,0,14,10,0,1,2,1
S01011419,Rented or living rent free: Total,106,56,40,15,25,1,15,50,30,1,3,11,5
S01011419,Rented or living rent free: Social rented,92,48,36,13,23,1,11,44,28,1,1,10,4
S01011419,Rented or living rent free: Private rented or living rent free,14,8,4,2,2,0,4,6,2,0,2,1,1
S01011420,All HRPs aged 16 and over,250,131,98,25,73,13,20,119,62,10,9,28,10
S01011420,Owned: Total,71,46,36,4,32,8,2,25,23,0,0,2,0
S01011420,Owned: Owned outright,32,13,10,2,8,3,0,19,18,0,0,1,0
S01011420,Owned: Owned with a mortgage or loan or shared ownership,39,33,26,2,24,5,2,6,5,0,0,1,0
S01011420,Rented or living rent free: Total,179,85,62,21,41,5,18,94,39,10,9,26,10
S01011420,Rented or living rent free: Social rented,150,65,49,20,29,3,13,85,38,10,6,24,7
S01011420,Rented or living rent free: Private rented or living rent free,29,20,13,1,12,2,5,9,1,0,3,2,3
S01011421,All HRPs aged 16 and over,233,204,178,14,164,11,15,29,8,1,8,8,4
S01011421,Owned: Total,189,178,163,11,152,10,5,11,7,0,0,4,0
S01011421,Owned: Owned outright,21,18,15,2,13,1,2,3,3,0,0,0,0
S01011421,Owned: Owned with a mortgage or loan or shared ownership,168,160,148,9,139,9,3,8,4,0,0,4,0
S01011421,Rented or living rent free: Total,44,26,15,3,12,1,10,18,1,1,8,4,4
S01011421,Rented or living rent free: Social rented,11,4,3,1,2,0,1,7,1,0,1,3,2
S01011421,Rented or living rent free: Private rented or living rent free,33,22,12,2,10,1,9,11,0,1,7,1,2
S01011422,All HRPs aged 16 and over,264,155,129,24,105,14,12,109,78,0,7,20,4
S01011422,Owned: Total,149,98,83,12,71,12,3,51,47,0,2,1,1
S01011422,Owned: Owned outright,55,18,14,3,11,4,0,37,37,0,0,0,0
S01011422,Owned: Owned with a mortgage or loan or shared ownership,94,80,69,9,60,8,3,14,10,0,2,1,1
S01011422,Rented or living rent free: Total,115,57,46,12,34,2,9,58,31,0,5,19,3
S01011422,Rented or living rent free: Social rented,97,46,37,12,25,2,7,51,30,0,2,17,2
S01011422,Rented or living rent free: Private rented or living rent free,18,11,9,0,9,0,2,7,1,0,3,2,1
S01011423,All HRPs aged 16 and over,221,129,103,20,83,8,18,92,52,1,18,18,3
S01011423,Owned: Total,91,63,56,4,52,5,2,28,25,0,0,2,1
S01011423,Owned: Owned outright,32,12,9,2,7,2,1,20,19,0,0,1,0
S01011423,Owned: Owned with a mortgage or loan or shared ownership,59,51,47,2,45,3,1,8,6,0,0,1,1
S01011423,Rented or living rent free: Total,130,66,47,16,31,3,16,64,27,1,18,16,2
S01011423,Rented or living rent free: Social rented,113,54,40,15,25,1,13,59,27,1,13,16,2
S01011423,Rented or living rent free: Private rented or living rent free,17,12,7,1,6,2,3,5,0,0,5,0,0
S01011424,All HRPs aged 16 and over,237,145,132,23,109,10,3,92,71,1,5,13,2
S01011424,Owned: Total,161,110,99,11,88,10,1,51,47,1,1,1,1
S01011424,Owned: Owned outright,60,23,19,3,16,4,0,37,34,0,1,1,1
S01011424,Owned: Owned with a mortgage or loan or shared ownership,101,87,80,8,72,6,1,14,13,1,0,0,0
S01011424,Rented or living rent free: Total,76,35,33,12,21,0,2,41,24,0,4,12,1
S01011424,Rented or living rent free: Social rented,63,27,25,11,14,0,2,36,23,0,3,10,0
S01011424,Rented or living rent free: Private rented or living rent free,13,8,8,1,7,0,0,5,1,0,1,2,1
S01011425,All HRPs aged 16 and over,348,222,160,23,137,34,28,126,90,1,7,19,9
S01011425,Owned: Total,175,102,74,5,69,27,1,73,65,0,1,7,0
S01011425,Owned: Owned outright,86,29,20,2,18,9,0,57,53,0,1,3,0
S01011425,Owned: Owned with a mortgage or loan or shared ownership,89,73,54,3,51,18,1,16,12,0,0,4,0
S01011425,Rented or living rent free: Total,173,120,86,18,68,7,27,53,25,1,6,12,9
S01011425,Rented or living rent free: Social rented,153,109,80,18,62,5,24,44,23,1,3,11,6
S01011425,Rented or living rent free: Private rented or living rent free,20,11,6,0,6,2,3,9,2,0,3,1,3
S01011426,All HRPs aged 16 and over,356,290,228,11,217,56,6,66,57,0,1,7,1
S01011426,Owned: Total,315,259,208,9,199,48,3,56,52,0,1,2,1
S01011426,Owned: Owned outright,98,51,36,5,31,14,1,47,46,0,0,1,0
S01011426,Owned: Owned with a mortgage or loan or shared ownership,217,208,172,4,168,34,2,9,6,0,1,1,1
S01011426,Rented or living rent free: Total,41,31,20,2,18,8,3,10,5,0,0,5,0
S01011426,Rented or living rent free: Social rented,15,11,10,2,8,1,0,4,3,0,0,1,0
S01011426,Rented or living rent free: Private rented or living rent free,26,20,10,0,10,7,3,6,2,0,0,4,0
S01011427,All HRPs aged 16 and over,303,185,142,18,124,23,20,118,81,1,9,25,2
S01011427,Owned: Total,162,103,84,4,80,16,3,59,53,0,0,6,0
S01011427,Owned: Owned outright,66,24,19,0,19,4,1,42,39,0,0,3,0
S01011427,Owned: Owned with a mortgage or loan or shared ownership,96,79,65,4,61,12,2,17,14,0,0,3,0
S01011427,Rented or living rent free: Total,141,82,58,14,44,7,17,59,28,1,9,19,2
S01011427,Rented or living rent free: Social rented,123,69,48,9,39,6,15,54,28,1,7,16,2
S01011427,Rented or living rent free: Private rented or living rent free,18,13,10,5,5,1,2,5,0,0,2,3,0
S01011428,All HRPs aged 16 and over,243,141,117,10,107,16,8,102,85,0,5,7,5
S01011428,Owned: Total,146,93,83,4,79,10,0,53,50,0,0,2,1
S01011428,Owned: Owned outright,69,24,21,2,19,3,0,45,44,0,0,0,1
S01011428,Owned: Owned with a mortgage or loan or shared ownership,77,69,62,2,60,7,0,8,6,0,0,2,0
S01011428,Rented or living rent free: Total,97,48,34,6,28,6,8,49,35,0,5,5,4
S01011428,Rented or living rent free: Social rented,91,44,32,6,26,5,7,47,34,0,4,5,4
S01011428,Rented or living rent free: Private rented or living rent free,6,4,2,0,2,1,1,2,1,0,1,0,0
S01011429,All HRPs aged 16 and over,240,186,143,8,135,39,4,54,43,2,2,6,1
S01011429,Owned: Total,219,173,133,7,126,36,4,46,41,2,0,3,0
S01011429,Owned: Owned outright,74,35,18,1,17,15,2,39,36,2,0,1,0
S01011429,Owned: Owned with a mortgage or loan or shared ownership,145,138,115,6,109,21,2,7,5,0,0,2,0
S01011429,Rented or living rent free: Total,21,13,10,1,9,3,0,8,2,0,2,3,1
S01011429,Rented or living rent free: Social rented,9,4,2,0,2,2,0,5,2,0,0,3,0
S01011429,Rented or living rent free: Private rented or living rent free,12,9,8,1,7,1,0,3,0,0,2,0,1
S01011430,All HRPs aged 16 and over,368,275,233,28,205,34,8,93,73,1,3,14,2
S01011430,Owned: Total,286,227,196,21,175,30,1,59,54,0,0,5,0
S01011430,Owned: Owned outright,93,45,36,8,28,8,1,48,45,0,0,3,0
S01011430,Owned: Owned with a mortgage or loan or shared ownership,193,182,160,13,147,22,0,11,9,0,0,2,0
S01011430,Rented or living rent free: Total,82,48,37,7,30,4,7,34,19,1,3,9,2
S01011430,Rented or living rent free: Social rented,40,17,12,2,10,2,3,23,14,1,1,6,1
S01011430,Rented or living rent free: Private rented or living rent free,42,31,25,5,20,2,4,11,5,0,2,3,1
S01011431,All HRPs aged 16 and over,506,279,239,39,200,26,14,227,174,2,12,29,10
S01011431,Owned: Total,256,166,146,13,133,14,6,90,81,0,4,3,2
S01011431,Owned: Owned outright,104,40,32,6,26,4,4,64,59,0,3,1,1
S01011431,Owned: Owned with a mortgage or loan or shared ownership,152,126,114,7,107,10,2,26,22,0,1,2,1
S01011431,Rented or living rent free: Total,250,113,93,26,67,12,8,137,93,2,8,26,8
S01011431,Rented or living rent free: Social rented,216,89,76,23,53,5,8,127,89,1,7,22,8
S01011431,Rented or living rent free: Private rented or living rent free,34,24,17,3,14,7,0,10,4,1,1,4,0
S01011432,All HRPs aged 16 and over,467,296,248,35,213,23,25,171,148,1,9,11,2
S01011432,Owned: Total,284,189,164,16,148,18,7,95,93,0,1,1,0
S01011432,Owned: Owned outright,117,47,37,6,31,5,5,70,68,0,1,1,0
S01011432,Owned: Owned with a mortgage or loan or shared ownership,167,142,127,10,117,13,2,25,25,0,0,0,0
S01011432,Rented or living rent free: Total,183,107,84,19,65,5,18,76,55,1,8,10,2
S01011432,Rented or living rent free: Social rented,163,92,71,17,54,5,16,71,53,1,6,9,2
S01011432,Rented or living rent free: Private rented or living rent free,20,15,13,2,11,0,2,5,2,0,2,1,0
S01011433,All HRPs aged 16 and over,369,242,197,48,149,14,31,127,58,3,21,31,14
S01011433,Owned: Total,102,73,64,7,57,7,2,29,24,0,1,3,1
S01011433,Owned: Owned outright,40,18,15,1,14,3,0,22,21,0,0,0,1
S01011433,Owned: Owned with a mortgage or loan or shared ownership,62,55,49,6,43,4,2,7,3,0,1,3,0
S01011433,Rented or living rent free: Total,267,169,133,41,92,7,29,98,34,3,20,28,13
S01011433,Rented or living rent free: Social rented,251,159,129,41,88,5,25,92,33,3,18,26,12
S01011433,Rented or living rent free: Private rented or living rent free,16,10,4,0,4,2,4,6,1,0,2,2,1
S01011434,All HRPs aged 16 and over,250,152,127,20,107,16,9,98,86,0,2,8,2
S01011434,Owned: Total,171,107,92,11,81,12,3,64,62,0,0,1,1
S01011434,Owned: Owned outright,81,32,27,6,21,5,0,49,48,0,0,0,1
S01011434,Owned: Owned with a mortgage or loan or shared ownership,90,75,65,5,60,7,3,15,14,0,0,1,0
S01011434,Rented or living rent free: Total,79,45,35,9,26,4,6,34,24,0,2,7,1
S01011434,Rented or living rent free: Social rented,67,36,29,9,20,2,5,31,22,0,1,7,1
S01011434,Rented or living rent free: Private rented or living rent free,12,9,6,0,6,2,1,3,2,0,1,0,0
S01011435,All HRPs aged 16 and over,374,267,229,18,211,24,14,107,87,3,1,10,6
S01011435,Owned: Total,319,235,205,13,192,20,10,84,71,3,1,5,4
S01011435,Owned: Owned outright,109,47,41,1,40,3,3,62,57,0,1,3,1
S01011435,Owned: Owned with a mortgage or loan or shared ownership,210,188,164,12,152,17,7,22,14,3,0,2,3
S01011435,Rented or living rent free: Total,55,32,24,5,19,4,4,23,16,0,0,5,2
S01011435,Rented or living rent free: Social rented,17,4,4,1,3,0,0,13,8,0,0,4,1
S01011435,Rented or living rent free: Private rented or living rent free,38,28,20,4,16,4,4,10,8,0,0,1,1
S01011436,All HRPs aged 16 and over,370,232,176,33,143,20,36,138,89,4,6,27,12
S01011436,Owned: Total,139,92,74,4,70,16,2,47,45,0,0,0,2
S01011436,Owned: Owned outright,50,16,13,2,11,3,0,34,34,0,0,0,0
S01011436,Owned: Owned with a mortgage or loan or shared ownership,89,76,61,2,59,13,2,13,11,0,0,0,2
S01011436,Rented or living rent free: Total,231,140,102,29,73,4,34,91,44,4,6,27,10
S01011436,Rented or living rent free: Social rented,198,117,88,26,62,3,26,81,41,2,3,25,10
S01011436,Rented or living rent free: Private rented or living rent free,33,23,14,3,11,1,8,10,3,2,3,2,0
S01011437,All HRPs aged 16 and over,354,206,166,33,133,17,23,148,100,0,11,27,10
S01011437,Owned: Total,166,108,95,14,81,10,3,58,54,0,1,1,2
S01011437,Owned: Owned outright,54,22,20,3,17,1,1,32,31,0,0,1,0
S01011437,Owned: Owned with a mortgage or loan or shared ownership,112,86,75,11,64,9,2,26,23,0,1,0,2
S01011437,Rented or living rent free: Total,188,98,71,19,52,7,20,90,46,0,10,26,8
S01011437,Rented or living rent free: Social rented,162,83,63,15,48,4,16,79,44,0,8,19,8
S01011437,Rented or living rent free: Private rented or living rent free,26,15,8,4,4,3,4,11,2,0,2,7,0
S01011438,All HRPs aged 16 and over,241,149,118,25,93,4,27,92,46,3,15,25,3
S01011438,Owned: Total,56,45,40,5,35,3,2,11,10,0,0,1,0
S01011438,Owned: Owned outright,12,6,3,0,3,2,1,6,6,0,0,0,0
S01011438,Owned: Owned with a mortgage or loan or shared ownership,44,39,37,5,32,1,1,5,4,0,0,1,0
S01011438,Rented or living rent free: Total,185,104,78,20,58,1,25,81,36,3,15,24,3
S01011438,Rented or living rent free: Social rented,176,101,76,20,56,1,24,75,34,3,14,21,3
S01011438,Rented or living rent free: Private rented or living rent free,9,3,2,0,2,0,1,6,2,0,1,3,0
S01011439,All HRPs aged 16 and over,396,247,196,23,173,29,22,149,117,1,5,23,3
S01011439,Owned: Total,217,142,116,8,108,25,1,75,69,0,1,5,0
S01011439,Owned: Owned outright,96,41,28,4,24,13,0,55,54,0,0,1,0
S01011439,Owned: Owned with a mortgage or loan or shared ownership,121,101,88,4,84,12,1,20,15,0,1,4,0
S01011439,Rented or living rent free: Total,179,105,80,15,65,4,21,74,48,1,4,18,3
S01011439,Rented or living rent free: Social rented,152,86,69,13,56,3,14,66,46,1,3,14,2
S01011439,Rented or living rent free: Private rented or living rent free,27,19,11,2,9,1,7,8,2,0,1,4,1
S01011440,All HRPs aged 16 and over,276,159,136,15,121,10,13,117,81,2,7,23,4
S01011440,Owned: Total,145,91,82,7,75,7,2,54,47,1,0,4,2
S01011440,Owned: Owned outright,53,16,15,5,10,0,1,37,34,1,0,1,1
S01011440,Owned: Owned with a mortgage or loan or shared ownership,92,75,67,2,65,7,1,17,13,0,0,3,1
S01011440,Rented or living rent free: Total,131,68,54,8,46,3,11,63,34,1,7,19,2
S01011440,Rented or living rent free: Social rented,119,60,49,7,42,2,9,59,34,1,4,18,2
S01011440,Rented or living rent free: Private rented or living rent free,12,8,5,1,4,1,2,4,0,0,3,1,0
S01011441,All HRPs aged 16 and over,343,232,181,28,153,18,33,111,75,0,4,18,14
S01011441,Owned: Total,160,115,101,12,89,13,1,45,38,0,0,6,1
S01011441,Owned: Owned outright,71,38,33,6,27,5,0,33,31,0,0,2,0
S01011441,Owned: Owned with a mortgage or loan or shared ownership,89,77,68,6,62,8,1,12,7,0,0,4,1
S01011441,Rented or living rent free: Total,183,117,80,16,64,5,32,66,37,0,4,12,13
S01011441,Rented or living rent free: Social rented,161,101,71,16,55,2,28,60,34,0,3,10,13
S01011441,Rented or living rent free: Private rented or living rent free,22,16,9,0,9,3,4,6,3,0,1,2,0
S01011442,All HRPs aged 16 and over,327,177,145,26,119,19,13,150,106,2,7,29,6
S01011442,Owned: Total,167,96,79,10,69,13,4,71,63,1,2,5,0
S01011442,Owned: Owned outright,71,18,16,3,13,1,1,53,50,1,1,1,0
S01011442,Owned: Owned with a mortgage or loan or shared ownership,96,78,63,7,56,12,3,18,13,0,1,4,0
S01011442,Rented or living rent free: Total,160,81,66,16,50,6,9,79,43,1,5,24,6
S01011442,Rented or living rent free: Social rented,125,56,48,15,33,4,4,69,39,1,2,23,4
S01011442,Rented or living rent free: Private rented or living rent free,35,25,18,1,17,2,5,10,4,0,3,1,2
S01011443,All HRPs aged 16 and over,288,153,129,26,103,12,12,135,105,4,5,19,2
S01011443,Owned: Total,166,95,80,12,68,11,4,71,67,0,0,4,0
S01011443,Owned: Owned outright,78,29,23,7,16,4,2,49,46,0,0,3,0
S01011443,Owned: Owned with a mortgage or loan or shared ownership,88,66,57,5,52,7,2,22,21,0,0,1,0
S01011443,Rented or living rent free: Total,122,58,49,14,35,1,8,64,38,4,5,15,2
S01011443,Rented or living rent free: Social rented,114,52,43,13,30,1,8,62,38,4,4,14,2
S01011443,Rented or living rent free: Private rented or living rent free,8,6,6,1,5,0,0,2,0,0,1,1,0
S01011444,All HRPs aged 16 and over,334,187,151,29,122,17,19,147,100,0,13,26,8
S01011444,Owned: Total,152,97,85,12,73,10,2,55,50,0,1,3,1
S01011444,Owned: Owned outright,63,25,24,9,15,1,0,38,36,0,0,2,0
S01011444,Owned: Owned with a mortgage or loan or shared ownership,89,72,61,3,58,9,2,17,14,0,1,1,1
S01011444,Rented or living rent free: Total,182,90,66,17,49,7,17,92,50,0,12,23,7
S01011444,Rented or living rent free: Social rented,172,82,59,15,44,7,16,90,48,0,12,23,7
S01011444,Rented or living rent free: Private rented or living rent free,10,8,7,2,5,0,1,2,2,0,0,0,0
S01011445,All HRPs aged 16 and over,251,173,140,19,121,16,17,78,55,3,3,13,4
S01011445,Owned: Total,165,127,109,13,96,13,5,38,34,0,1,3,0
S01011445,Owned: Owned outright,56,24,17,5,12,4,3,32,29,0,0,3,0
S01011445,Owned: Owned with a mortgage or loan or shared ownership,109,103,92,8,84,9,2,6,5,0,1,0,0
S01011445,Rented or living rent free: Total,86,46,31,6,25,3,12,40,21,3,2,10,4
S01011445,Rented or living rent free: Social rented,70,32,25,5,20,2,5,38,20,3,2,9,4
S01011445,Rented or living rent free: Private rented or living rent free,16,14,6,1,5,1,7,2,1,0,0,1,0
S01011446,All HRPs aged 16 and over,231,148,101,15,86,39,8,83,64,2,1,14,2
S01011446,Owned: Total,161,120,80,9,71,38,2,41,38,1,0,2,0
S01011446,Owned: Owned outright,80,42,22,2,20,18,2,38,36,1,0,1,0
S01011446,Owned: Owned with a mortgage or loan or shared ownership,81,78,58,7,51,20,0,3,2,0,0,1,0
S01011446,Rented or living rent free: Total,70,28,21,6,15,1,6,42,26,1,1,12,2
S01011446,Rented or living rent free: Social rented,56,19,14,3,11,0,5,37,24,1,1,10,1
S01011446,Rented or living rent free: Private rented or living rent free,14,9,7,3,4,1,1,5,2,0,0,2,1
S01011447,All HRPs aged 16 and over,369,233,188,40,148,27,18,136,72,1,17,33,13
S01011447,Owned: Total,179,137,116,16,100,19,2,42,32,0,3,2,5
S01011447,Owned: Owned outright,53,26,21,6,15,4,1,27,23,0,0,1,3
S01011447,Owned: Owned with a mortgage or loan or shared ownership,126,111,95,10,85,15,1,15,9,0,3,1,2
S01011447,Rented or living rent free: Total,190,96,72,24,48,8,16,94,40,1,14,31,8
S01011447,Rented or living rent free: Social rented,170,84,65,23,42,7,12,86,39,1,13,27,6
S01011447,Rented or living rent free: Private rented or living rent free,20,12,7,1,6,1,4,8,1,0,1,4,2
S01011448,All HRPs aged 16 and over,377,264,215,33,182,39,10,113,84,2,7,15,5
S01011448,Owned: Total,280,206,168,16,152,35,3,74,67,2,0,2,3
S01011448,Owned: Owned outright,115,58,48,5,43,9,1,57,53,2,0,0,2
S01011448,Owned: Owned with a mortgage or loan or shared ownership,165,148,120,11,109,26,2,17,14,0,0,2,1
S01011448,Rented or living rent free: Total,97,58,47,17,30,4,7,39,17,0,7,13,2
S01011448,Rented or living rent free: Social rented,58,31,24,8,16,1,6,27,12,0,3,11,1
S01011448,Rented or living rent free: Private rented or living rent free,39,27,23,9,14,3,1,12,5,0,4,2,1
S01011449,All HRPs aged 16 and over,276,150,116,12,104,15,19,126,87,0,6,26,7
S01011449,Owned: Total,110,76,67,7,60,8,1,34,30,0,0,4,0
S01011449,Owned: Owned outright,50,21,17,3,14,3,1,29,25,0,0,4,0
S01011449,Owned: Owned with a mortgage or loan or shared ownership,60,55,50,4,46,5,0,5,5,0,0,0,0
S01011449,Rented or living rent free: Total,166,74,49,5,44,7,18,92,57,0,6,22,7
S01011449,Rented or living rent free: Social rented,134,49,35,3,32,4,10,85,57,0,3,19,6
S01011449,Rented or living rent free: Private rented or living rent free,32,25,14,2,12,3,8,7,0,0,3,3,1
S01011450,All HRPs aged 16 and over,239,168,134,13,121,29,5,71,53,2,8,6,2
S01011450,Owned: Total,193,151,124,10,114,26,1,42,35,2,1,2,2
S01011450,Owned: Owned outright,63,29,23,5,18,6,0,34,30,2,0,1,1
S01011450,Owned: Owned with a mortgage or loan or shared ownership,130,122,101,5,96,20,1,8,5,0,1,1,1
S01011450,Rented or living rent free: Total,46,17,10,3,7,3,4,29,18,0,7,4,0
S01011450,Rented or living rent free: Social rented,31,9,5,2,3,2,2,22,17,0,3,2,0
S01011450,Rented or living rent free: Private rented or living rent free,15,8,5,1,4,1,2,7,1,0,4,2,0
S01011451,All HRPs aged 16 and over,212,186,126,11,115,54,6,26,17,0,2,5,2
S01011451,Owned: Total,175,153,101,10,91,48,4,22,16,0,2,2,2
S01011451,Owned: Owned outright,50,36,22,5,17,12,2,14,11,0,1,0,2
S01011451,Owned: Owned with a mortgage or loan or shared ownership,125,117,79,5,74,36,2,8,5,0,1,2,0
S01011451,Rented or living rent free: Total,37,33,25,1,24,6,2,4,1,0,0,3,0
S01011451,Rented or living rent free: Social rented,22,18,14,1,13,3,1,4,1,0,0,3,0
S01011451,Rented or living rent free: Private rented or living rent free,15,15,11,0,11,3,1,0,0,0,0,0,0
S01011452,All HRPs aged 16 and over,412,308,253,26,227,41,14,104,71,2,11,17,3
S01011452,Owned: Total,317,249,209,18,191,37,3,68,57,1,2,7,1
S01011452,Owned: Owned outright,125,71,55,9,46,16,0,54,48,0,2,4,0
S01011452,Owned: Owned with a mortgage or loan or shared ownership,192,178,154,9,145,21,3,14,9,1,0,3,1
S01011452,Rented or living rent free: Total,95,59,44,8,36,4,11,36,14,1,9,10,2
S01011452,Rented or living rent free: Social rented,57,31,23,5,18,4,4,26,10,1,6,8,1
S01011452,Rented or living rent free: Private rented or living rent free,38,28,21,3,18,0,7,10,4,0,3,2,1
S01011453,All HRPs aged 16 and over,301,173,149,23,126,15,9,128,97,0,10,16,5
S01011453,Owned: Total,211,122,106,8,98,13,3,89,80,0,5,3,1
S01011453,Owned: Owned outright,101,33,26,7,19,5,2,68,62,0,3,2,1
S01011453,Owned: Owned with a mortgage or loan or shared ownership,110,89,80,1,79,8,1,21,18,0,2,1,0
S01011453,Rented or living rent free: Total,90,51,43,15,28,2,6,39,17,0,5,13,4
S01011453,Rented or living rent free: Social rented,68,35,32,10,22,2,1,33,17,0,4,10,2
S01011453,Rented or living rent free: Private rented or living rent free,22,16,11,5,6,0,5,6,0,0,1,3,2
S01011454,All HRPs aged 16 and over,351,198,177,46,131,12,9,153,116,1,8,17,11
S01011454,Owned: Total,177,120,111,20,91,8,1,57,49,0,2,3,3
S01011454,Owned: Owned outright,58,19,17,5,12,1,1,39,36,0,1,2,0
S01011454,Owned: Owned with a mortgage or loan or shared ownership,119,101,94,15,79,7,0,18,13,0,1,1,3
S01011454,Rented or living rent free: Total,174,78,66,26,40,4,8,96,67,1,6,14,8
S01011454,Rented or living rent free: Social rented,153,67,57,20,37,3,7,86,60,0,6,14,6
S01011454,Rented or living rent free: Private rented or living rent free,21,11,9,6,3,1,1,10,7,1,0,0,2
S01011455,All HRPs aged 16 and over,329,180,143,40,103,18,19,149,106,2,8,27,6
S01011455,Owned: Total,165,101,90,11,79,8,3,64,57,0,2,4,1
S01011455,Owned: Owned outright,69,25,24,5,19,1,0,44,41,0,2,1,0
S01011455,Owned: Owned with a mortgage or loan or shared ownership,96,76,66,6,60,7,3,20,16,0,0,3,1
S01011455,Rented or living rent free: Total,164,79,53,29,24,10,16,85,49,2,6,23,5
S01011455,Rented or living rent free: Social rented,147,69,46,25,21,8,15,78,48,0,3,22,5
S01011455,Rented or living rent free: Private rented or living rent free,17,10,7,4,3,2,1,7,1,2,3,1,0
S01011456,All HRPs aged 16 and over,356,198,159,36,123,23,16,158,112,0,10,31,5
S01011456,Owned: Total,185,122,99,16,83,20,3,63,56,0,3,4,0
S01011456,Owned: Owned outright,62,27,19,6,13,8,0,35,35,0,0,0,0
S01011456,Owned: Owned with a mortgage or loan or shared ownership,123,95,80,10,70,12,3,28,21,0,3,4,0
S01011456,Rented or living rent free: Total,171,76,60,20,40,3,13,95,56,0,7,27,5
S01011456,Rented or living rent free: Social rented,160,72,56,18,38,3,13,88,53,0,6,26,3
S01011456,Rented or living rent free: Private rented or living rent free,11,4,4,2,2,0,0,7,3,0,1,1,2
S01011457,All HRPs aged 16 and over,382,237,197,50,147,17,23,145,91,1,16,29,8
S01011457,Owned: Total,172,112,99,19,80,10,3,60,49,0,3,2,6
S01011457,Owned: Owned outright,63,31,25,8,17,5,1,32,28,0,1,0,3
S01011457,Owned: Owned with a mortgage or loan or shared ownership,109,81,74,11,63,5,2,28,21,0,2,2,3
S01011457,Rented or living rent free: Total,210,125,98,31,67,7,20,85,42,1,13,27,2
S01011457,Rented or living rent free: Social rented,193,111,86,28,58,5,20,82,42,0,12,26,2
S01011457,Rented or living rent free: Private rented or living rent free,17,14,12,3,9,2,0,3,0,1,1,1,0
S01011458,All HRPs aged 16 and over,374,306,267,23,244,35,4,68,46,3,6,7,6
S01011458,Owned: Total,312,277,242,16,226,33,2,35,24,1,6,2,2
S01011458,Owned: Owned outright,55,33,28,3,25,4,1,22,19,0,2,0,1
S01011458,Owned: Owned with a mortgage or loan or shared ownership,257,244,214,13,201,29,1,13,5,1,4,2,1
S01011458,Rented or living rent free: Total,62,29,25,7,18,2,2,33,22,2,0,5,4
S01011458,Rented or living rent free: Social rented,49,18,15,5,10,2,1,31,22,2,0,4,3
S01011458,Rented or living rent free: Private rented or living rent free,13,11,10,2,8,0,1,2,0,0,0,1,1
S01011459,All HRPs aged 16 and over,420,335,291,45,246,34,10,85,55,0,4,21,5
S01011459,Owned: Total,299,259,229,18,211,27,3,40,33,0,0,6,1
S01011459,Owned: Owned outright,52,23,21,4,17,2,0,29,24,0,0,4,1
S01011459,Owned: Owned with a mortgage or loan or shared ownership,247,236,208,14,194,25,3,11,9,0,0,2,0
S01011459,Rented or living rent free: Total,121,76,62,27,35,7,7,45,22,0,4,15,4
S01011459,Rented or living rent free: Social rented,79,44,34,18,16,5,5,35,19,0,1,13,2
S01011459,Rented or living rent free: Private rented or living rent free,42,32,28,9,19,2,2,10,3,0,3,2,2
S01011460,All HRPs aged 16 and over,292,206,174,31,143,15,17,86,57,0,5,15,9
S01011460,Owned: Total,150,130,118,12,106,10,2,20,18,0,1,1,0
S01011460,Owned: Owned outright,23,13,13,4,9,0,0,10,10,0,0,0,0
S01011460,Owned: Owned with a mortgage or loan or shared ownership,127,117,105,8,97,10,2,10,8,0,1,1,0
S01011460,Rented or living rent free: Total,142,76,56,19,37,5,15,66,39,0,4,14,9
S01011460,Rented or living rent free: Social rented,133,70,53,17,36,3,14,63,38,0,3,14,8
S01011460,Rented or living rent free: Private rented or living rent free,9,6,3,2,1,2,1,3,1,0,1,0,1
S01011461,All HRPs aged 16 and over,332,230,190,37,153,17,23,102,53,1,10,32,6
S01011461,Owned: Total,150,120,102,10,92,12,6,30,22,1,0,6,1
S01011461,Owned: Owned outright,31,16,12,4,8,3,1,15,12,1,0,2,0
S01011461,Owned: Owned with a mortgage or loan or shared ownership,119,104,90,6,84,9,5,15,10,0,0,4,1
S01011461,Rented or living rent free: Total,182,110,88,27,61,5,17,72,31,0,10,26,5
S01011461,Rented or living rent free: Social rented,130,68,57,22,35,5,6,62,29,0,6,23,4
S01011461,Rented or living rent free: Private rented or living rent free,52,42,31,5,26,0,11,10,2,0,4,3,1
S01011462,All HRPs aged 16 and over,404,259,218,29,189,28,13,145,115,1,6,16,7
S01011462,Owned: Total,274,198,169,16,153,27,2,76,69,0,1,5,1
S01011462,Owned: Owned outright,103,44,34,4,30,8,2,59,56,0,0,3,0
S01011462,Owned: Owned with a mortgage or loan or shared ownership,171,154,135,12,123,19,0,17,13,0,1,2,1
S01011462,Rented or living rent free: Total,130,61,49,13,36,1,11,69,46,1,5,11,6
S01011462,Rented or living rent free: Social rented,95,41,33,11,22,0,8,54,40,0,3,9,2
S01011462,Rented or living rent free: Private rented or living rent free,35,20,16,2,14,1,3,15,6,1,2,2,4
S01011463,All HRPs aged 16 and over,307,203,170,34,136,29,4,104,87,1,7,6,3
S01011463,Owned: Total,230,158,131,16,115,25,2,72,63,0,4,4,1
S01011463,Owned: Owned outright,80,36,29,6,23,6,1,44,43,0,1,0,0
S01011463,Owned: Owned with a mortgage or loan or shared ownership,150,122,102,10,92,19,1,28,20,0,3,4,1
S01011463,Rented or living rent free: Total,77,45,39,18,21,4,2,32,24,1,3,2,2
S01011463,Rented or living rent free: Social rented,54,29,25,12,13,2,2,25,21,0,1,1,2
S01011463,Rented or living rent free: Private rented or living rent free,23,16,14,6,8,2,0,7,3,1,2,1,0
S01011464,All HRPs aged 16 and over,223,198,172,7,165,21,5,25,9,0,4,10,2
S01011464,Owned: Total,177,169,148,4,144,20,1,8,6,0,0,2,0
S01011464,Owned: Owned outright,17,10,8,0,8,2,0,7,5,0,0,2,0
S01011464,Owned: Owned with a mortgage or loan or shared ownership,160,159,140,4,136,18,1,1,1,0,0,0,0
S01011464,Rented or living rent free: Total,46,29,24,3,21,1,4,17,3,0,4,8,2
S01011464,Rented or living rent free: Social rented,26,9,4,0,4,1,4,17,3,0,4,8,2
S01011464,Rented or living rent free: Private rented or living rent free,20,20,20,3,17,0,0,0,0,0,0,0,0
S01011465,All HRPs aged 16 and over,223,137,105,30,75,15,17,86,41,1,11,22,11
S01011465,Owned: Total,80,60,47,9,38,9,4,20,18,0,0,2,0
S01011465,Owned: Owned outright,30,15,10,5,5,4,1,15,14,0,0,1,0
S01011465,Owned: Owned with a mortgage or loan or shared ownership,50,45,37,4,33,5,3,5,4,0,0,1,0
S01011465,Rented or living rent free: Total,143,77,58,21,37,6,13,66,23,1,11,20,11
S01011465,Rented or living rent free: Social rented,135,73,56,20,36,6,11,62,22,1,11,18,10
S01011465,Rented or living rent free: Private rented or living rent free,8,4,2,1,1,0,2,4,1,0,0,2,1
S01011466,All HRPs aged 16 and over,316,168,133,27,106,14,21,148,88,5,8,37,10
S01011466,Owned: Total,127,77,65,10,55,7,5,50,43,0,3,3,1
S01011466,Owned: Owned outright,50,15,11,3,8,2,2,35,30,0,2,2,1
S01011466,Owned: Owned with a mortgage or loan or shared ownership,77,62,54,7,47,5,3,15,13,0,1,1,0
S01011466,Rented or living rent free: Total,189,91,68,17,51,7,16,98,45,5,5,34,9
S01011466,Rented or living rent free: Social rented,168,73,54,15,39,4,15,95,45,4,5,32,9
S01011466,Rented or living rent free: Private rented or living rent free,21,18,14,2,12,3,1,3,0,1,0,2,0
S01011467,All HRPs aged 16 and over,231,160,131,19,112,12,17,71,44,0,5,19,3
S01011467,Owned: Total,134,100,90,9,81,8,2,34,25,0,1,6,2
S01011467,Owned: Owned outright,37,14,12,3,9,2,0,23,19,0,0,3,1
S01011467,Owned: Owned with a mortgage or loan or shared ownership,97,86,78,6,72,6,2,11,6,0,1,3,1
S01011467,Rented or living rent free: Total,97,60,41,10,31,4,15,37,19,0,4,13,1
S01011467,Rented or living rent free: Social rented,77,42,30,10,20,3,9,35,19,0,2,13,1
S01011467,Rented or living rent free: Private rented or living rent free,20,18,11,0,11,1,6,2,0,0,2,0,0
S01011468,All HRPs aged 16 and over,310,285,253,16,237,28,4,25,9,2,5,7,2
S01011468,Owned: Total,263,250,225,11,214,25,0,13,8,1,0,3,1
S01011468,Owned: Owned outright,28,19,15,3,12,4,0,9,5,0,0,3,1
S01011468,Owned: Owned with a mortgage or loan or shared ownership,235,231,210,8,202,21,0,4,3,1,0,0,0
S01011468,Rented or living rent free: Total,47,35,28,5,23,3,4,12,1,1,5,4,1
S01011468,Rented or living rent free: Social rented,9,5,2,0,2,0,3,4,0,0,1,3,0
S01011468,Rented or living rent free: Private rented or living rent free,38,30,26,5,21,3,1,8,1,1,4,1,1
S01011469,All HRPs aged 16 and over,318,216,178,40,138,17,21,102,41,13,15,24,9
S01011469,Owned: Total,103,86,74,6,68,12,0,17,14,0,0,3,0
S01011469,Owned: Owned outright,16,6,5,3,2,1,0,10,9,0,0,1,0
S01011469,Owned: Owned with a mortgage or loan or shared ownership,87,80,69,3,66,11,0,7,5,0,0,2,0
S01011469,Rented or living rent free: Total,215,130,104,34,70,5,21,85,27,13,15,21,9
S01011469,Rented or living rent free: Social rented,173,111,89,31,58,3,19,62,21,11,9,18,3
S01011469,Rented or living rent free: Private rented or living rent free,42,19,15,3,12,2,2,23,6,2,6,3,6
S01011470,All HRPs aged 16 and over,491,282,236,38,198,32,14,209,153,10,9,30,7
S01011470,Owned: Total,272,173,147,17,130,24,2,99,91,0,1,6,1
S01011470,Owned: Owned outright,104,31,28,8,20,3,0,73,71,0,1,0,1
S01011470,Owned: Owned with a mortgage or loan or shared ownership,168,142,119,9,110,21,2,26,20,0,0,6,0
S01011470,Rented or living rent free: Total,219,109,89,21,68,8,12,110,62,10,8,24,6
S01011470,Rented or living rent free: Social rented,170,71,59,20,39,5,7,99,58,9,5,22,5
S01011470,Rented or living rent free: Private rented or living rent free,49,38,30,1,29,3,5,11,4,1,3,2,1
S01011471,All HRPs aged 16 and over,454,222,199,32,167,17,6,232,190,12,6,17,7
S01011471,Owned: Total,277,170,152,21,131,15,3,107,102,0,1,3,1
S01011471,Owned: Owned outright,128,43,36,11,25,5,2,85,81,0,1,2,1
S01011471,Owned: Owned with a mortgage or loan or shared ownership,149,127,116,10,106,10,1,22,21,0,0,1,0
S01011471,Rented or living rent free: Total,177,52,47,11,36,2,3,125,88,12,5,14,6
S01011471,Rented or living rent free: Social rented,141,37,34,10,24,1,2,104,72,9,4,13,6
S01011471,Rented or living rent free: Private rented or living rent free,36,15,13,1,12,1,1,21,16,3,1,1,0
S01011472,All HRPs aged 16 and over,535,291,214,28,186,20,57,244,142,21,11,59,11
S01011472,Owned: Total,136,80,73,1,72,6,1,56,54,0,1,0,1
S01011472,Owned: Owned outright,58,15,13,0,13,2,0,43,43,0,0,0,0
S01011472,Owned: Owned with a mortgage or loan or shared ownership,78,65,60,1,59,4,1,13,11,0,1,0,1
S01011472,Rented or living rent free: Total,399,211,141,27,114,14,56,188,88,21,10,59,10
S01011472,Rented or living rent free: Social rented,366,186,125,26,99,10,51,180,87,20,9,55,9
S01011472,Rented or living rent free: Private rented or living rent free,33,25,16,1,15,4,5,8,1,1,1,4,1
S01011473,All HRPs aged 16 and over,431,181,149,34,115,10,22,250,193,1,3,44,9
S01011473,Owned: Total,92,57,51,7,44,4,2,35,33,0,0,2,0
S01011473,Owned: Owned outright,39,13,13,4,9,0,0,26,25,0,0,1,0
S01011473,Owned: Owned with a mortgage or loan or shared ownership,53,44,38,3,35,4,2,9,8,0,0,1,0
S01011473,Rented or living rent free: Total,339,124,98,27,71,6,20,215,160,1,3,42,9
S01011473,Rented or living rent free: Social rented,311,104,82,25,57,5,17,207,157,1,3,38,8
S01011473,Rented or living rent free: Private rented or living rent free,28,20,16,2,14,1,3,8,3,0,0,4,1
S01011474,All HRPs aged 16 and over,481,235,183,31,152,12,40,246,179,0,10,48,9
S01011474,Owned: Total,109,71,66,2,64,3,2,38,32,0,1,4,1
S01011474,Owned: Owned outright,37,13,13,1,12,0,0,24,22,0,0,1,1
S01011474,Owned: Owned with a mortgage or loan or shared ownership,72,58,53,1,52,3,2,14,10,0,1,3,0
S01011474,Rented or living rent free: Total,372,164,117,29,88,9,38,208,147,0,9,44,8
S01011474,Rented or living rent free: Social rented,301,118,89,22,67,7,22,183,137,0,4,36,6
S01011474,Rented or living rent free: Private rented or living rent free,71,46,28,7,21,2,16,25,10,0,5,8,2
S01011475,All HRPs aged 16 and over,391,172,129,32,97,9,34,219,163,4,6,37,9
S01011475,Owned: Total,41,23,20,3,17,1,2,18,13,0,0,4,1
S01011475,Owned: Owned outright,17,5,4,1,3,0,1,12,11,0,0,1,0
S01011475,Owned: Owned with a mortgage or loan or shared ownership,24,18,16,2,14,1,1,6,2,0,0,3,1
S01011475,Rented or living rent free: Total,350,149,109,29,80,8,32,201,150,4,6,33,8
S01011475,Rented or living rent free: Social rented,336,140,102,27,75,8,30,196,149,1,6,32,8
S01011475,Rented or living rent free: Private rented or living rent free,14,9,7,2,5,0,2,5,1,3,0,1,0
S01011476,All HRPs aged 16 and over,198,139,129,14,115,9,1,59,58,0,0,1,0
S01011476,Owned: Total,183,126,118,11,107,7,1,57,56,0,0,1,0
S01011476,Owned: Owned outright,92,41,39,7,32,2,0,51,50,0,0,1,0
S01011476,Owned: Owned with a mortgage or loan or shared ownership,91,85,79,4,75,5,1,6,6,0,0,0,0
S01011476,Rented or living rent free: Total,15,13,11,3,8,2,0,2,2,0,0,0,0
S01011476,Rented or living rent free: Social rented,6,5,3,2,1,2,0,1,1,0,0,0,0
S01011476,Rented or living rent free: Private rented or living rent free,9,8,8,1,7,0,0,1,1,0,0,0,0
S01011477,All HRPs aged 16 and over,335,220,193,26,167,27,0,115,106,1,2,3,3
S01011477,Owned: Total,320,211,185,24,161,26,0,109,105,1,1,1,1
S01011477,Owned: Owned outright,171,74,62,12,50,12,0,97,94,0,1,1,1
S01011477,Owned: Owned with a mortgage or loan or shared ownership,149,137,123,12,111,14,0,12,11,1,0,0,0
S01011477,Rented or living rent free: Total,15,9,8,2,6,1,0,6,1,0,1,2,2
S01011477,Rented or living rent free: Social rented,8,3,3,1,2,0,0,5,1,0,1,2,1
S01011477,Rented or living rent free: Private rented or living rent free,7,6,5,1,4,1,0,1,0,0,0,0,1
S01011478,All HRPs aged 16 and over,442,313,260,16,244,48,5,129,119,1,1,6,2
S01011478,Owned: Total,372,266,218,11,207,46,2,106,103,1,1,0,1
S01011478,Owned: Owned outright,152,64,47,7,40,16,1,88,88,0,0,0,0
S01011478,Owned: Owned with a mortgage or loan or shared ownership,220,202,171,4,167,30,1,18,15,1,1,0,1
S01011478,Rented or living rent free: Total,70,47,42,5,37,2,3,23,16,0,0,6,1
S01011478,Rented or living rent free: Social rented,21,9,7,1,6,0,2,12,8,0,0,3,1
S01011478,Rented or living rent free: Private rented or living rent free,49,38,35,4,31,2,1,11,8,0,0,3,0
S01011479,All HRPs aged 16 and over,380,240,206,24,182,29,5,140,126,0,6,6,2
S01011479,Owned: Total,323,199,167,18,149,28,4,124,120,0,1,1,2
S01011479,Owned: Owned outright,169,57,48,9,39,8,1,112,109,0,0,1,2
S01011479,Owned: Owned with a mortgage or loan or shared ownership,154,142,119,9,110,20,3,12,11,0,1,0,0
S01011479,Rented or living rent free: Total,57,41,39,6,33,1,1,16,6,0,5,5,0
S01011479,Rented or living rent free: Social rented,13,6,5,3,2,1,0,7,2,0,2,3,0
S01011479,Rented or living rent free: Private rented or living rent free,44,35,34,3,31,0,1,9,4,0,3,2,0
S01011480,All HRPs aged 16 and over,467,306,255,20,235,48,3,161,144,1,8,4,4
S01011480,Owned: Total,394,253,211,14,197,41,1,141,136,0,1,3,1
S01011480,Owned: Owned outright,194,68,58,8,50,10,0,126,123,0,0,2,1
S01011480,Owned: Owned with a mortgage or loan or shared ownership,200,185,153,6,147,31,1,15,13,0,1,1,0
S01011480,Rented or living rent free: Total,73,53,44,6,38,7,2,20,8,1,7,1,3
S01011480,Rented or living rent free: Social rented,12,6,3,1,2,2,1,6,1,0,3,1,1
S01011480,Rented or living rent free: Private rented or living rent free,61,47,41,5,36,5,1,14,7,1,4,0,2
S01011481,All HRPs aged 16 and over,336,255,221,20,201,26,8,81,60,0,3,16,2
S01011481,Owned: Total,255,217,191,11,180,24,2,38,33,0,0,5,0
S01011481,Owned: Owned outright,59,30,24,3,21,6,0,29,26,0,0,3,0
S01011481,Owned: Owned with a mortgage or loan or shared ownership,196,187,167,8,159,18,2,9,7,0,0,2,0
S01011481,Rented or living rent free: Total,81,38,30,9,21,2,6,43,27,0,3,11,2
S01011481,Rented or living rent free: Social rented,60,21,17,5,12,1,3,39,25,0,3,9,2
S01011481,Rented or living rent free: Private rented or living rent free,21,17,13,4,9,1,3,4,2,0,0,2,0
S01011482,All HRPs aged 16 and over,424,225,189,26,163,17,19,199,156,5,7,26,5
S01011482,Owned: Total,205,126,108,10,98,13,5,79,71,0,1,5,2
S01011482,Owned: Owned outright,87,30,24,7,17,4,2,57,51,0,0,4,2
S01011482,Owned: Owned with a mortgage or loan or shared ownership,118,96,84,3,81,9,3,22,20,0,1,1,0
S01011482,Rented or living rent free: Total,219,99,81,16,65,4,14,120,85,5,6,21,3
S01011482,Rented or living rent free: Social rented,173,67,56,10,46,3,8,106,78,3,4,19,2
S01011482,Rented or living rent free: Private rented or living rent free,46,32,25,6,19,1,6,14,7,2,2,2,1
S01011483,All HRPs aged 16 and over,221,172,146,17,129,22,4,49,46,0,1,2,0
S01011483,Owned: Total,201,155,133,15,118,20,2,46,46,0,0,0,0
S01011483,Owned: Owned outright,83,45,35,8,27,10,0,38,38,0,0,0,0
S01011483,Owned: Owned with a mortgage or loan or shared ownership,118,110,98,7,91,10,2,8,8,0,0,0,0
S01011483,Rented or living rent free: Total,20,17,13,2,11,2,2,3,0,0,1,2,0
S01011483,Rented or living rent free: Social rented,4,2,2,1,1,0,0,2,0,0,1,1,0
S01011483,Rented or living rent free: Private rented or living rent free,16,15,11,1,10,2,2,1,0,0,0,1,0
S01011484,All HRPs aged 16 and over,381,216,180,34,146,14,22,165,116,3,11,30,5
S01011484,Owned: Total,165,115,102,16,86,10,3,50,40,0,3,5,2
S01011484,Owned: Owned outright,56,20,16,3,13,2,2,36,30,0,0,5,1
S01011484,Owned: Owned with a mortgage or loan or shared ownership,109,95,86,13,73,8,1,14,10,0,3,0,1
S01011484,Rented or living rent free: Total,216,101,78,18,60,4,19,115,76,3,8,25,3
S01011484,Rented or living rent free: Social rented,202,91,73,17,56,4,14,111,73,3,8,24,3
S01011484,Rented or living rent free: Private rented or living rent free,14,10,5,1,4,0,5,4,3,0,0,1,0
S01011485,All HRPs aged 16 and over,371,203,171,44,127,8,24,168,111,3,24,25,5
S01011485,Owned: Total,158,105,94,17,77,5,6,53,46,3,1,3,0
S01011485,Owned: Owned outright,52,21,19,5,14,1,1,31,30,0,0,1,0
S01011485,Owned: Owned with a mortgage or loan or shared ownership,106,84,75,12,63,4,5,22,16,3,1,2,0
S01011485,Rented or living rent free: Total,213,98,77,27,50,3,18,115,65,0,23,22,5
S01011485,Rented or living rent free: Social rented,185,81,68,23,45,2,11,104,62,0,17,20,5
S01011485,Rented or living rent free: Private rented or living rent free,28,17,9,4,5,1,7,11,3,0,6,2,0
S01011486,All HRPs aged 16 and over,235,117,101,23,78,4,12,118,78,1,12,23,4
S01011486,Owned: Total,70,43,39,5,34,2,2,27,21,1,1,4,0
S01011486,Owned: Owned outright,31,14,12,4,8,0,2,17,17,0,0,0,0
S01011486,Owned: Owned with a mortgage or loan or shared ownership,39,29,27,1,26,2,0,10,4,1,1,4,0
S01011486,Rented or living rent free: Total,165,74,62,18,44,2,10,91,57,0,11,19,4
S01011486,Rented or living rent free: Social rented,155,70,59,17,42,1,10,85,54,0,11,18,2
S01011486,Rented or living rent free: Private rented or living rent free,10,4,3,1,2,1,0,6,3,0,0,1,2
S01011487,All HRPs aged 16 and over,429,282,243,59,184,24,15,147,72,4,20,43,8
S01011487,Owned: Total,182,138,122,12,110,14,2,44,37,1,0,6,0
S01011487,Owned: Owned outright,49,22,20,3,17,1,1,27,24,1,0,2,0
S01011487,Owned: Owned with a mortgage or loan or shared ownership,133,116,102,9,93,13,1,17,13,0,0,4,0
S01011487,Rented or living rent free: Total,247,144,121,47,74,10,13,103,35,3,20,37,8
S01011487,Rented or living rent free: Social rented,223,128,109,43,66,8,11,95,34,3,19,32,7
S01011487,Rented or living rent free: Private rented or living rent free,24,16,12,4,8,2,2,8,1,0,1,5,1
S01011488,All HRPs aged 16 and over,284,160,129,42,87,8,23,124,80,3,16,18,7
S01011488,Owned: Total,118,74,69,15,54,4,1,44,42,0,0,2,0
S01011488,Owned: Owned outright,51,18,18,6,12,0,0,33,32,0,0,1,0
S01011488,Owned: Owned with a mortgage or loan or shared ownership,67,56,51,9,42,4,1,11,10,0,0,1,0
S01011488,Rented or living rent free: Total,166,86,60,27,33,4,22,80,38,3,16,16,7
S01011488,Rented or living rent free: Social rented,146,74,53,25,28,2,19,72,35,2,14,14,7
S01011488,Rented or living rent free: Private rented or living rent free,20,12,7,2,5,2,3,8,3,1,2,2,0
S01011489,All HRPs aged 16 and over,260,234,199,21,178,25,10,26,5,0,2,12,7
S01011489,Owned: Total,192,184,159,8,151,24,1,8,4,0,0,1,3
S01011489,Owned: Owned outright,18,13,11,2,9,2,0,5,4,0,0,1,0
S01011489,Owned: Owned with a mortgage or loan or shared ownership,174,171,148,6,142,22,1,3,0,0,0,0,3
S01011489,Rented or living rent free: Total,68,50,40,13,27,1,9,18,1,0,2,11,4
S01011489,Rented or living rent free: Social rented,58,41,33,10,23,1,7,17,1,0,2,10,4
S01011489,Rented or living rent free: Private rented or living rent free,10,9,7,3,4,0,2,1,0,0,0,1,0
S01011490,All HRPs aged 16 and over,473,311,267,34,233,24,20,162,101,5,12,33,11
S01011490,Owned: Total,253,205,181,14,167,20,4,48,43,0,2,1,2
S01011490,Owned: Owned outright,70,40,35,7,28,3,2,30,30,0,0,0,0
S01011490,Owned: Owned with a mortgage or loan or shared ownership,183,165,146,7,139,17,2,18,13,0,2,1,2
S01011490,Rented or living rent free: Total,220,106,86,20,66,4,16,114,58,5,10,32,9
S01011490,Rented or living rent free: Social rented,178,75,59,17,42,2,14,103,52,5,6,32,8
S01011490,Rented or living rent free: Private rented or living rent free,42,31,27,3,24,2,2,11,6,0,4,0,1
S01011491,All HRPs aged 16 and over,262,155,119,24,95,6,30,107,66,5,6,22,8
S01011491,Owned: Total,94,64,56,5,51,5,3,30,27,0,0,3,0
S01011491,Owned: Owned outright,30,11,8,2,6,1,2,19,18,0,0,1,0
S01011491,Owned: Owned with a mortgage or loan or shared ownership,64,53,48,3,45,4,1,11,9,0,0,2,0
S01011491,Rented or living rent free: Total,168,91,63,19,44,1,27,77,39,5,6,19,8
S01011491,Rented or living rent free: Social rented,151,83,55,18,37,1,27,68,36,5,5,16,6
S01011491,Rented or living rent free: Private rented or living rent free,17,8,8,1,7,0,0,9,3,0,1,3,2
S01011492,All HRPs aged 16 and over,395,248,199,37,162,16,33,147,63,20,18,40,6
S01011492,Owned: Total,109,91,83,7,76,8,0,18,14,1,0,2,1
S01011492,Owned: Owned outright,24,16,12,2,10,4,0,8,6,1,0,1,0
S01011492,Owned: Owned with a mortgage or loan or shared ownership,85,75,71,5,66,4,0,10,8,0,0,1,1
S01011492,Rented or living rent free: Total,286,157,116,30,86,8,33,129,49,19,18,38,5
S01011492,Rented or living rent free: Social rented,140,70,54,20,34,2,14,70,38,1,4,24,3
S01011492,Rented or living rent free: Private rented or living rent free,146,87,62,10,52,6,19,59,11,18,14,14,2
S01011493,All HRPs aged 16 and over,170,162,142,7,135,18,2,8,6,0,1,0,1
S01011493,Owned: Total,164,157,137,7,130,18,2,7,6,0,0,0,1
S01011493,Owned: Owned outright,24,20,16,1,15,4,0,4,3,0,0,0,1
S01011493,Owned: Owned with a mortgage or loan or shared ownership,140,137,121,6,115,14,2,3,3,0,0,0,0
S01011493,Rented or living rent free: Total,6,5,5,0,5,0,0,1,0,0,1,0,0
S01011493,Rented or living rent free: Social rented,3,2,2,0,2,0,0,1,0,0,1,0,0
S01011493,Rented or living rent free: Private rented or living rent free,3,3,3,0,3,0,0,0,0,0,0,0,0
S01011494,All HRPs aged 16 and over,332,194,172,26,146,15,7,138,115,1,3,16,3
S01011494,Owned: Total,188,129,116,15,101,11,2,59,51,0,1,7,0
S01011494,Owned: Owned outright,65,19,18,7,11,1,0,46,39,0,1,6,0
S01011494,Owned: Owned with a mortgage or loan or shared ownership,123,110,98,8,90,10,2,13,12,0,0,1,0
S01011494,Rented or living rent free: Total,144,65,56,11,45,4,5,79,64,1,2,9,3
S01011494,Rented or living rent free: Social rented,132,55,48,10,38,2,5,77,62,1,2,9,3
S01011494,Rented or living rent free: Private rented or living rent free,12,10,8,1,7,2,0,2,2,0,0,0,0
S01011495,All HRPs aged 16 and over,369,214,180,30,150,11,23,155,109,3,13,26,4
S01011495,Owned: Total,157,104,96,14,82,8,0,53,44,0,2,5,2
S01011495,Owned: Owned outright,64,31,29,9,20,2,0,33,30,0,1,2,0
S01011495,Owned: Owned with a mortgage or loan or shared ownership,93,73,67,5,62,6,0,20,14,0,1,3,2
S01011495,Rented or living rent free: Total,212,110,84,16,68,3,23,102,65,3,11,21,2
S01011495,Rented or living rent free: Social rented,190,100,76,16,60,3,21,90,61,2,4,21,2
S01011495,Rented or living rent free: Private rented or living rent free,22,10,8,0,8,0,2,12,4,1,7,0,0
S01011496,All HRPs aged 16 and over,308,185,154,41,113,9,22,123,47,0,16,52,8
S01011496,Owned: Total,51,37,34,3,31,1,2,14,11,0,1,2,0
S01011496,Owned: Owned outright,14,5,5,0,5,0,0,9,8,0,0,1,0
S01011496,Owned: Owned with a mortgage or loan or shared ownership,37,32,29,3,26,1,2,5,3,0,1,1,0
S01011496,Rented or living rent free: Total,257,148,120,38,82,8,20,109,36,0,15,50,8
S01011496,Rented or living rent free: Social rented,246,141,118,37,81,8,15,105,34,0,14,49,8
S01011496,Rented or living rent free: Private rented or living rent free,11,7,2,1,1,0,5,4,2,0,1,1,0
S01011497,All HRPs aged 16 and over,256,219,182,19,163,24,13,37,23,0,2,9,3
S01011497,Owned: Total,207,179,151,8,143,22,6,28,22,0,1,3,2
S01011497,Owned: Owned outright,56,36,29,4,25,6,1,20,18,0,1,1,0
S01011497,Owned: Owned with a mortgage or loan or shared ownership,151,143,122,4,118,16,5,8,4,0,0,2,2
S01011497,Rented or living rent free: Total,49,40,31,11,20,2,7,9,1,0,1,6,1
S01011497,Rented or living rent free: Social rented,14,12,7,4,3,2,3,2,0,0,0,2,0
S01011497,Rented or living rent free: Private rented or living rent free,35,28,24,7,17,0,4,7,1,0,1,4,1
S01011498,All HRPs aged 16 and over,230,210,185,23,162,23,2,20,16,1,0,2,1
S01011498,Owned: Total,209,195,171,18,153,23,1,14,14,0,0,0,0
S01011498,Owned: Owned outright,44,33,27,6,21,6,0,11,11,0,0,0,0
S01011498,Owned: Owned with a mortgage or loan or shared ownership,165,162,144,12,132,17,1,3,3,0,0,0,0
S01011498,Rented or living rent free: Total,21,15,14,5,9,0,1,6,2,1,0,2,1
S01011498,Rented or living rent free: Social rented,11,7,6,2,4,0,1,4,2,0,0,2,0
S01011498,Rented or living rent free: Private rented or living rent free,10,8,8,3,5,0,0,2,0,1,0,0,1
S01011499,All HRPs aged 16 and over,370,262,215,21,194,29,18,108,74,3,7,16,8
S01011499,Owned: Total,246,201,176,13,163,22,3,45,37,0,1,4,3
S01011499,Owned: Owned outright,76,42,31,2,29,9,2,34,31,0,1,2,0
S01011499,Owned: Owned with a mortgage or loan or shared ownership,170,159,145,11,134,13,1,11,6,0,0,2,3
S01011499,Rented or living rent free: Total,124,61,39,8,31,7,15,63,37,3,6,12,5
S01011499,Rented or living rent free: Social rented,88,38,24,7,17,4,10,50,30,0,5,12,3
S01011499,Rented or living rent free: Private rented or living rent free,36,23,15,1,14,3,5,13,7,3,1,0,2
S01011500,All HRPs aged 16 and over,219,147,118,18,100,14,15,72,56,1,4,5,6
S01011500,Owned: Total,148,101,88,6,82,13,0,47,45,0,0,1,1
S01011500,Owned: Owned outright,60,26,25,5,20,1,0,34,33,0,0,1,0
S01011500,Owned: Owned with a mortgage or loan or shared ownership,88,75,63,1,62,12,0,13,12,0,0,0,1
S01011500,Rented or living rent free: Total,71,46,30,12,18,1,15,25,11,1,4,4,5
S01011500,Rented or living rent free: Social rented,55,33,22,12,10,1,10,22,9,0,4,4,5
S01011500,Rented or living rent free: Private rented or living rent free,16,13,8,0,8,0,5,3,2,1,0,0,0
S01011501,All HRPs aged 16 and over,325,184,136,27,109,15,33,141,88,1,17,31,4
S01011501,Owned: Total,109,64,59,8,51,4,1,45,38,1,3,3,0
S01011501,Owned: Owned outright,37,11,9,3,6,1,1,26,23,1,1,1,0
S01011501,Owned: Owned with a mortgage or loan or shared ownership,72,53,50,5,45,3,0,19,15,0,2,2,0
S01011501,Rented or living rent free: Total,216,120,77,19,58,11,32,96,50,0,14,28,4
S01011501,Rented or living rent free: Social rented,196,108,72,18,54,10,26,88,46,0,13,25,4
S01011501,Rented or living rent free: Private rented or living rent free,20,12,5,1,4,1,6,8,4,0,1,3,0
S01011502,All HRPs aged 16 and over,305,197,172,32,140,17,8,108,79,2,4,18,5
S01011502,Owned: Total,185,125,111,16,95,14,0,60,47,1,2,7,3
S01011502,Owned: Owned outright,59,25,24,2,22,1,0,34,28,1,1,4,0
S01011502,Owned: Owned with a mortgage or loan or shared ownership,126,100,87,14,73,13,0,26,19,0,1,3,3
S01011502,Rented or living rent free: Total,120,72,61,16,45,3,8,48,32,1,2,11,2
S01011502,Rented or living rent free: Social rented,110,65,54,15,39,3,8,45,30,1,2,11,1
S01011502,Rented or living rent free: Private rented or living rent free,10,7,7,1,6,0,0,3,2,0,0,0,1
S01011503,All HRPs aged 16 and over,253,157,130,16,114,15,12,96,66,4,4,19,3
S01011503,Owned: Total,171,116,99,8,91,11,6,55,48,0,1,6,0
S01011503,Owned: Owned outright,63,24,20,2,18,2,2,39,37,0,0,2,0
S01011503,Owned: Owned with a mortgage or loan or shared ownership,108,92,79,6,73,9,4,16,11,0,1,4,0
S01011503,Rented or living rent free: Total,82,41,31,8,23,4,6,41,18,4,3,13,3
S01011503,Rented or living rent free: Social rented,72,36,27,7,20,3,6,36,17,3,2,11,3
S01011503,Rented or living rent free: Private rented or living rent free,10,5,4,1,3,1,0,5,1,1,1,2,0
S01011504,All HRPs aged 16 and over,237,145,120,24,96,16,9,92,83,2,0,4,3
S01011504,Owned: Total,173,110,95,16,79,12,3,63,58,2,0,3,0
S01011504,Owned: Owned outright,81,34,29,6,23,4,1,47,45,0,0,2,0
S01011504,Owned: Owned with a mortgage or loan or shared ownership,92,76,66,10,56,8,2,16,13,2,0,1,0
S01011504,Rented or living rent free: Total,64,35,25,8,17,4,6,29,25,0,0,1,3
S01011504,Rented or living rent free: Social rented,52,23,17,7,10,3,3,29,25,0,0,1,3
S01011504,Rented or living rent free: Private rented or living rent free,12,12,8,1,7,1,3,0,0,0,0,0,0
S01011505,All HRPs aged 16 and over,322,204,164,33,131,13,27,118,57,4,12,39,6
S01011505,Owned: Total,136,101,92,6,86,8,1,35,26,0,1,7,1
S01011505,Owned: Owned outright,37,12,11,2,9,1,0,25,18,0,1,5,1
S01011505,Owned: Owned with a mortgage or loan or shared ownership,99,89,81,4,77,7,1,10,8,0,0,2,0
S01011505,Rented or living rent free: Total,186,103,72,27,45,5,26,83,31,4,11,32,5
S01011505,Rented or living rent free: Social rented,145,73,55,22,33,2,16,72,27,3,8,30,4
S01011505,Rented or living rent free: Private rented or living rent free,41,30,17,5,12,3,10,11,4,1,3,2,1
S01011506,All HRPs aged 16 and over,237,127,110,16,94,13,4,110,92,1,2,11,4
S01011506,Owned: Total,171,102,89,9,80,12,1,69,62,0,2,4,1
S01011506,Owned: Owned outright,79,25,17,2,15,8,0,54,51,0,0,3,0
S01011506,Owned: Owned with a mortgage or loan or shared ownership,92,77,72,7,65,4,1,15,11,0,2,1,1
S01011506,Rented or living rent free: Total,66,25,21,7,14,1,3,41,30,1,0,7,3
S01011506,Rented or living rent free: Social rented,57,19,17,7,10,0,2,38,27,1,0,7,3
S01011506,Rented or living rent free: Private rented or living rent free,9,6,4,0,4,1,1,3,3,0,0,0,0
S01011507,All HRPs aged 16 and over,293,165,137,21,116,17,11,128,90,1,6,27,4
S01011507,Owned: Total,168,110,95,12,83,12,3,58,53,1,1,3,0
S01011507,Owned: Owned outright,72,29,24,7,17,4,1,43,41,0,1,1,0
S01011507,Owned: Owned with a mortgage or loan or shared ownership,96,81,71,5,66,8,2,15,12,1,0,2,0
S01011507,Rented or living rent free: Total,125,55,42,9,33,5,8,70,37,0,5,24,4
S01011507,Rented or living rent free: Social rented,110,48,40,8,32,2,6,62,32,0,4,22,4
S01011507,Rented or living rent free: Private rented or living rent free,15,7,2,1,1,3,2,8,5,0,1,2,0
S01011508,All HRPs aged 16 and over,468,363,302,34,268,22,39,105,52,0,4,34,15
S01011508,Owned: Total,254,216,201,19,182,11,4,38,29,0,1,6,2
S01011508,Owned: Owned outright,62,33,30,5,25,2,1,29,26,0,1,1,1
S01011508,Owned: Owned with a mortgage or loan or shared ownership,192,183,171,14,157,9,3,9,3,0,0,5,1
S01011508,Rented or living rent free: Total,214,147,101,15,86,11,35,67,23,0,3,28,13
S01011508,Rented or living rent free: Social rented,138,83,55,12,43,5,23,55,19,0,2,25,9
S01011508,Rented or living rent free: Private rented or living rent free,76,64,46,3,43,6,12,12,4,0,1,3,4
S01011509,All HRPs aged 16 and over,247,163,140,16,124,12,11,84,61,1,8,9,5
S01011509,Owned: Total,184,132,120,9,111,12,0,52,50,0,0,1,1
S01011509,Owned: Owned outright,73,37,34,5,29,3,0,36,36,0,0,0,0
S01011509,Owned: Owned with a mortgage or loan or shared ownership,111,95,86,4,82,9,0,16,14,0,0,1,1
S01011509,Rented or living rent free: Total,63,31,20,7,13,0,11,32,11,1,8,8,4
S01011509,Rented or living rent free: Social rented,50,26,17,7,10,0,9,24,11,0,4,8,1
S01011509,Rented or living rent free: Private rented or living rent free,13,5,3,0,3,0,2,8,0,1,4,0,3
S01011510,All HRPs aged 16 and over,435,268,216,40,176,14,38,167,104,4,27,21,11
S01011510,Owned: Total,218,152,140,14,126,8,4,66,55,3,2,4,2
S01011510,Owned: Owned outright,76,32,28,3,25,2,2,44,39,1,1,2,1
S01011510,Owned: Owned with a mortgage or loan or shared ownership,142,120,112,11,101,6,2,22,16,2,1,2,1
S01011510,Rented or living rent free: Total,217,116,76,26,50,6,34,101,49,1,25,17,9
S01011510,Rented or living rent free: Social rented,179,100,64,25,39,5,31,79,41,1,17,15,5
S01011510,Rented or living rent free: Private rented or living rent free,38,16,12,1,11,1,3,22,8,0,8,2,4
S01011511,All HRPs aged 16 and over,255,154,118,20,98,8,28,101,71,3,8,16,3
S01011511,Owned: Total,105,65,57,6,51,6,2,40,39,0,0,1,0
S01011511,Owned: Owned outright,41,11,10,1,9,1,0,30,30,0,0,0,0
S01011511,Owned: Owned with a mortgage or loan or shared ownership,64,54,47,5,42,5,2,10,9,0,0,1,0
S01011511,Rented or living rent free: Total,150,89,61,14,47,2,26,61,32,3,8,15,3
S01011511,Rented or living rent free: Social rented,143,84,57,13,44,1,26,59,30,3,8,15,3
S01011511,Rented or living rent free: Private rented or living rent free,7,5,4,1,3,1,0,2,2,0,0,0,0
S01011512,All HRPs aged 16 and over,482,275,201,46,155,17,57,207,83,6,36,55,27
S01011512,Owned: Total,107,84,75,8,67,8,1,23,19,0,0,3,1
S01011512,Owned: Owned outright,25,14,12,1,11,1,1,11,9,0,0,1,1
S01011512,Owned: Owned with a mortgage or loan or shared ownership,82,70,63,7,56,7,0,12,10,0,0,2,0
S01011512,Rented or living rent free: Total,375,191,126,38,88,9,56,184,64,6,36,52,26
S01011512,Rented or living rent free: Social rented,360,180,118,35,83,8,54,180,63,5,34,52,26
S01011512,Rented or living rent free: Private rented or living rent free,15,11,8,3,5,1,2,4,1,1,2,0,0
S01011513,All HRPs aged 16 and over,358,211,171,41,130,9,31,147,84,0,13,33,17
S01011513,Owned: Total,129,94,85,9,76,6,3,35,32,0,0,3,0
S01011513,Owned: Owned outright,51,23,18,2,16,4,1,28,25,0,0,3,0
S01011513,Owned: Owned with a mortgage or loan or shared ownership,78,71,67,7,60,2,2,7,7,0,0,0,0
S01011513,Rented or living rent free: Total,229,117,86,32,54,3,28,112,52,0,13,30,17
S01011513,Rented or living rent free: Social rented,215,106,76,29,47,3,27,109,51,0,13,29,16
S01011513,Rented or living rent free: Private rented or living rent free,14,11,10,3,7,0,1,3,1,0,0,1,1
S01011514,All HRPs aged 16 and over,337,214,183,55,128,17,14,123,81,3,8,27,4
S01011514,Owned: Total,148,106,94,21,73,11,1,42,35,2,1,2,2
S01011514,Owned: Owned outright,52,23,21,6,15,1,1,29,24,2,0,2,1
S01011514,Owned: Owned with a mortgage or loan or shared ownership,96,83,73,15,58,10,0,13,11,0,1,0,1
S01011514,Rented or living rent free: Total,189,108,89,34,55,6,13,81,46,1,7,25,2
S01011514,Rented or living rent free: Social rented,182,103,85,32,53,5,13,79,45,1,7,24,2
S01011514,Rented or living rent free: Private rented or living rent free,7,5,4,2,2,1,0,2,1,0,0,1,0
S01011515,All HRPs aged 16 and over,280,213,181,26,155,20,12,67,41,1,5,18,2
S01011515,Owned: Total,205,155,136,16,120,17,2,50,33,1,4,11,1
S01011515,Owned: Owned outright,63,27,24,8,16,2,1,36,29,0,1,5,1
S01011515,Owned: Owned with a mortgage or loan or shared ownership,142,128,112,8,104,15,1,14,4,1,3,6,0
S01011515,Rented or living rent free: Total,75,58,45,10,35,3,10,17,8,0,1,7,1
S01011515,Rented or living rent free: Social rented,15,7,5,3,2,0,2,8,5,0,0,3,0
S01011515,Rented or living rent free: Private rented or living rent free,60,51,40,7,33,3,8,9,3,0,1,4,1
S01011516,All HRPs aged 16 and over,358,312,264,14,250,36,12,46,38,1,1,5,1
S01011516,Owned: Total,316,278,242,11,231,30,6,38,35,0,0,2,1
S01011516,Owned: Owned outright,90,58,44,7,37,9,5,32,32,0,0,0,0
S01011516,Owned: Owned with a mortgage or loan or shared ownership,226,220,198,4,194,21,1,6,3,0,0,2,1
S01011516,Rented or living rent free: Total,42,34,22,3,19,6,6,8,3,1,1,3,0
S01011516,Rented or living rent free: Social rented,12,7,5,2,3,1,1,5,2,1,0,2,0
S01011516,Rented or living rent free: Private rented or living rent free,30,27,17,1,16,5,5,3,1,0,1,1,0
S01011517,All HRPs aged 16 and over,225,137,119,18,101,13,5,88,72,1,3,11,1
S01011517,Owned: Total,158,100,89,9,80,11,0,58,53,0,2,2,1
S01011517,Owned: Owned outright,67,20,17,2,15,3,0,47,42,0,2,2,1
S01011517,Owned: Owned with a mortgage or loan or shared ownership,91,80,72,7,65,8,0,11,11,0,0,0,0
S01011517,Rented or living rent free: Total,67,37,30,9,21,2,5,30,19,1,1,9,0
S01011517,Rented or living rent free: Social rented,56,30,24,7,17,1,5,26,16,0,1,9,0
S01011517,Rented or living rent free: Private rented or living rent free,11,7,6,2,4,1,0,4,3,1,0,0,0
S01011518,All HRPs aged 16 and over,302,140,115,17,98,14,11,162,124,0,9,23,6
S01011518,Owned: Total,138,87,74,9,65,12,1,51,49,0,0,1,1
S01011518,Owned: Owned outright,50,12,10,3,7,2,0,38,37,0,0,0,1
S01011518,Owned: Owned with a mortgage or loan or shared ownership,88,75,64,6,58,10,1,13,12,0,0,1,0
S01011518,Rented or living rent free: Total,164,53,41,8,33,2,10,111,75,0,9,22,5
S01011518,Rented or living rent free: Social rented,149,45,35,7,28,2,8,104,70,0,8,21,5
S01011518,Rented or living rent free: Private rented or living rent free,15,8,6,1,5,0,2,7,5,0,1,1,0
S01011519,All HRPs aged 16 and over,310,187,168,25,143,10,9,123,90,0,4,24,5
S01011519,Owned: Total,168,111,99,7,92,10,2,57,53,0,0,4,0
S01011519,Owned: Owned outright,70,28,26,4,22,2,0,42,39,0,0,3,0
S01011519,Owned: Owned with a mortgage or loan or shared ownership,98,83,73,3,70,8,2,15,14,0,0,1,0
S01011519,Rented or living rent free: Total,142,76,69,18,51,0,7,66,37,0,4,20,5
S01011519,Rented or living rent free: Social rented,129,66,60,18,42,0,6,63,37,0,3,18,5
S01011519,Rented or living rent free: Private rented or living rent free,13,10,9,0,9,0,1,3,0,0,1,2,0
S01011520,All HRPs aged 16 and over,273,137,112,29,83,7,18,136,84,3,13,25,11
S01011520,Owned: Total,85,59,50,9,41,5,4,26,22,0,0,1,3
S01011520,Owned: Owned outright,20,5,3,1,2,1,1,15,12,0,0,1,2
S01011520,Owned: Owned with a mortgage or loan or shared ownership,65,54,47,8,39,4,3,11,10,0,0,0,1
S01011520,Rented or living rent free: Total,188,78,62,20,42,2,14,110,62,3,13,24,8
S01011520,Rented or living rent free: Social rented,177,76,62,20,42,2,12,101,58,0,12,23,8
S01011520,Rented or living rent free: Private rented or living rent free,11,2,0,0,0,0,2,9,4,3,1,1,0
S01011521,All HRPs aged 16 and over,441,281,231,47,184,16,34,160,91,3,24,32,10
S01011521,Owned: Total,191,136,122,11,111,11,3,55,49,1,2,2,1
S01011521,Owned: Owned outright,69,27,21,1,20,5,1,42,38,0,2,2,0
S01011521,Owned: Owned with a mortgage or loan or shared ownership,122,109,101,10,91,6,2,13,11,1,0,0,1
S01011521,Rented or living rent free: Total,250,145,109,36,73,5,31,105,42,2,22,30,9
S01011521,Rented or living rent free: Social rented,196,105,80,33,47,2,23,91,38,0,18,28,7
S01011521,Rented or living rent free: Private rented or living rent free,54,40,29,3,26,3,8,14,4,2,4,2,2
S01011522,All HRPs aged 16 and over,463,263,226,49,177,20,17,200,137,0,11,45,7
S01011522,Owned: Total,192,140,127,22,105,11,2,52,49,0,0,2,1
S01011522,Owned: Owned outright,58,25,22,4,18,2,1,33,32,0,0,0,1
S01011522,Owned: Owned with a mortgage or loan or shared ownership,134,115,105,18,87,9,1,19,17,0,0,2,0
S01011522,Rented or living rent free: Total,271,123,99,27,72,9,15,148,88,0,11,43,6
S01011522,Rented or living rent free: Social rented,222,90,71,27,44,8,11,132,80,0,10,38,4
S01011522,Rented or living rent free: Private rented or living rent free,49,33,28,0,28,1,4,16,8,0,1,5,2
S01011523,All HRPs aged 16 and over,340,236,189,28,161,23,24,104,67,1,10,20,6
S01011523,Owned: Total,155,125,109,6,103,14,2,30,30,0,0,0,0
S01011523,Owned: Owned outright,42,20,17,2,15,2,1,22,22,0,0,0,0
S01011523,Owned: Owned with a mortgage or loan or shared ownership,113,105,92,4,88,12,1,8,8,0,0,0,0
S01011523,Rented or living rent free: Total,185,111,80,22,58,9,22,74,37,1,10,20,6
S01011523,Rented or living rent free: Social rented,109,59,45,15,30,4,10,50,29,0,3,15,3
S01011523,Rented or living rent free: Private rented or living rent free,76,52,35,7,28,5,12,24,8,1,7,5,3
S01011524,All HRPs aged 16 and over,396,293,251,28,223,28,14,103,82,1,5,13,2
S01011524,Owned: Total,307,244,213,23,190,26,5,63,58,0,0,3,2
S01011524,Owned: Owned outright,95,52,44,12,32,4,4,43,39,0,0,2,2
S01011524,Owned: Owned with a mortgage or loan or shared ownership,212,192,169,11,158,22,1,20,19,0,0,1,0
S01011524,Rented or living rent free: Total,89,49,38,5,33,2,9,40,24,1,5,10,0
S01011524,Rented or living rent free: Social rented,60,25,18,3,15,1,6,35,21,1,3,10,0
S01011524,Rented or living rent free: Private rented or living rent free,29,24,20,2,18,1,3,5,3,0,2,0,0
S01011525,All HRPs aged 16 and over,348,264,234,31,203,27,3,84,59,1,8,13,3
S01011525,Owned: Total,264,231,205,21,184,23,3,33,30,1,1,1,0
S01011525,Owned: Owned outright,58,36,31,3,28,5,0,22,22,0,0,0,0
S01011525,Owned: Owned with a mortgage or loan or shared ownership,206,195,174,18,156,18,3,11,8,1,1,1,0
S01011525,Rented or living rent free: Total,84,33,29,10,19,4,0,51,29,0,7,12,3
S01011525,Rented or living rent free: Social rented,66,24,21,6,15,3,0,42,25,0,3,11,3
S01011525,Rented or living rent free: Private rented or living rent free,18,9,8,4,4,1,0,9,4,0,4,1,0
S01011526,All HRPs aged 16 and over,422,279,238,27,211,22,19,143,103,2,12,23,3
S01011526,Owned: Total,274,199,176,15,161,21,2,75,67,0,2,5,1
S01011526,Owned: Owned outright,90,41,35,6,29,5,1,49,46,0,1,2,0
S01011526,Owned: Owned with a mortgage or loan or shared ownership,184,158,141,9,132,16,1,26,21,0,1,3,1
S01011526,Rented or living rent free: Total,148,80,62,12,50,1,17,68,36,2,10,18,2
S01011526,Rented or living rent free: Social rented,106,49,37,6,31,1,11,57,33,2,4,17,1
S01011526,Rented or living rent free: Private rented or living rent free,42,31,25,6,19,0,6,11,3,0,6,1,1
S01011527,All HRPs aged 16 and over,290,173,143,13,130,23,7,117,104,0,8,3,2
S01011527,Owned: Total,231,142,118,7,111,21,3,89,84,0,2,1,2
S01011527,Owned: Owned outright,111,35,30,5,25,4,1,76,72,0,2,1,1
S01011527,Owned: Owned with a mortgage or loan or shared ownership,120,107,88,2,86,17,2,13,12,0,0,0,1
S01011527,Rented or living rent free: Total,59,31,25,6,19,2,4,28,20,0,6,2,0
S01011527,Rented or living rent free: Social rented,40,19,14,6,8,1,4,21,16,0,4,1,0
S01011527,Rented or living rent free: Private rented or living rent free,19,12,11,0,11,1,0,7,4,0,2,1,0
S01011528,All HRPs aged 16 and over,495,288,242,45,197,20,26,207,155,0,11,36,5
S01011528,Owned: Total,243,141,121,20,101,14,6,102,96,0,1,5,0
S01011528,Owned: Owned outright,116,38,32,12,20,3,3,78,75,0,0,3,0
S01011528,Owned: Owned with a mortgage or loan or shared ownership,127,103,89,8,81,11,3,24,21,0,1,2,0
S01011528,Rented or living rent free: Total,252,147,121,25,96,6,20,105,59,0,10,31,5
S01011528,Rented or living rent free: Social rented,216,118,94,24,70,5,19,98,55,0,9,30,4
S01011528,Rented or living rent free: Private rented or living rent free,36,29,27,1,26,1,1,7,4,0,1,1,1
S01011529,All HRPs aged 16 and over,291,153,119,28,91,8,26,138,77,8,10,30,13
S01011529,Owned: Total,93,55,49,4,45,4,2,38,32,0,0,4,2
S01011529,Owned: Owned outright,36,8,7,2,5,1,0,28,25,0,0,1,2
S01011529,Owned: Owned with a mortgage or loan or shared ownership,57,47,42,2,40,3,2,10,7,0,0,3,0
S01011529,Rented or living rent free: Total,198,98,70,24,46,4,24,100,45,8,10,26,11
S01011529,Rented or living rent free: Social rented,184,92,65,23,42,4,23,92,45,7,8,24,8
S01011529,Rented or living rent free: Private rented or living rent free,14,6,5,1,4,0,1,8,0,1,2,2,3
S01011530,All HRPs aged 16 and over,468,281,237,31,206,19,25,187,138,2,5,32,10
S01011530,Owned: Total,227,149,130,10,120,14,5,78,72,1,0,5,0
S01011530,Owned: Owned outright,82,31,20,6,14,8,3,51,47,0,0,4,0
S01011530,Owned: Owned with a mortgage or loan or shared ownership,145,118,110,4,106,6,2,27,25,1,0,1,0
S01011530,Rented or living rent free: Total,241,132,107,21,86,5,20,109,66,1,5,27,10
S01011530,Rented or living rent free: Social rented,215,118,95,19,76,4,19,97,59,1,5,22,10
S01011530,Rented or living rent free: Private rented or living rent free,26,14,12,2,10,1,1,12,7,0,0,5,0
S01011531,All HRPs aged 16 and over,473,305,260,28,232,33,12,168,142,1,5,17,3
S01011531,Owned: Total,335,248,214,20,194,28,6,87,82,0,1,2,2
S01011531,Owned: Owned outright,109,47,39,12,27,8,0,62,60,0,1,1,0
S01011531,Owned: Owned with a mortgage or loan or shared ownership,226,201,175,8,167,20,6,25,22,0,0,1,2
S01011531,Rented or living rent free: Total,138,57,46,8,38,5,6,81,60,1,4,15,1
S01011531,Rented or living rent free: Social rented,92,18,13,3,10,2,3,74,56,1,3,13,1
S01011531,Rented or living rent free: Private rented or living rent free,46,39,33,5,28,3,3,7,4,0,1,2,0
S01011532,All HRPs aged 16 and over,237,196,153,13,140,35,8,41,24,2,9,6,0
S01011532,Owned: Total,201,175,135,7,128,35,5,26,20,0,4,2,0
S01011532,Owned: Owned outright,39,21,17,5,12,2,2,18,16,0,1,1,0
S01011532,Owned: Owned with a mortgage or loan or shared ownership,162,154,118,2,116,33,3,8,4,0,3,1,0
S01011532,Rented or living rent free: Total,36,21,18,6,12,0,3,15,4,2,5,4,0
S01011532,Rented or living rent free: Social rented,19,7,6,1,5,0,1,12,3,2,3,4,0
S01011532,Rented or living rent free: Private rented or living rent free,17,14,12,5,7,0,2,3,1,0,2,0,0
S01011533,All HRPs aged 16 and over,315,174,134,33,101,16,24,141,85,0,14,36,6
S01011533,Owned: Total,130,80,61,8,53,16,3,50,44,0,1,4,1
S01011533,Owned: Owned outright,53,24,18,4,14,4,2,29,29,0,0,0,0
S01011533,Owned: Owned with a mortgage or loan or shared ownership,77,56,43,4,39,12,1,21,15,0,1,4,1
S01011533,Rented or living rent free: Total,185,94,73,25,48,0,21,91,41,0,13,32,5
S01011533,Rented or living rent free: Social rented,172,86,65,24,41,0,21,86,39,0,10,32,5
S01011533,Rented or living rent free: Private rented or living rent free,13,8,8,1,7,0,0,5,2,0,3,0,0
S01011534,All HRPs aged 16 and over,341,204,168,31,137,21,15,137,90,2,8,31,6
S01011534,Owned: Total,182,127,109,12,97,14,4,55,44,1,1,7,2
S01011534,Owned: Owned outright,65,23,20,3,17,2,1,42,37,0,1,3,1
S01011534,Owned: Owned with a mortgage or loan or shared ownership,117,104,89,9,80,12,3,13,7,1,0,4,1
S01011534,Rented or living rent free: Total,159,77,59,19,40,7,11,82,46,1,7,24,4
S01011534,Rented or living rent free: Social rented,138,60,45,17,28,4,11,78,46,0,5,23,4
S01011534,Rented or living rent free: Private rented or living rent free,21,17,14,2,12,3,0,4,0,1,2,1,0
S01011535,All HRPs aged 16 and over,467,240,181,44,137,17,42,227,131,4,21,52,19
S01011535,Owned: Total,115,66,55,8,47,10,1,49,45,2,0,2,0
S01011535,Owned: Owned outright,54,15,13,3,10,2,0,39,36,1,0,2,0
S01011535,Owned: Owned with a mortgage or loan or shared ownership,61,51,42,5,37,8,1,10,9,1,0,0,0
S01011535,Rented or living rent free: Total,352,174,126,36,90,7,41,178,86,2,21,50,19
S01011535,Rented or living rent free: Social rented,338,166,119,35,84,6,41,172,85,2,18,49,18
S01011535,Rented or living rent free: Private rented or living rent free,14,8,7,1,6,1,0,6,1,0,3,1,1
S01011536,All HRPs aged 16 and over,269,207,171,21,150,30,6,62,53,1,4,2,2
S01011536,Owned: Total,247,193,159,19,140,30,4,54,50,0,1,2,1
S01011536,Owned: Owned outright,96,50,41,8,33,7,2,46,45,0,0,1,0
S01011536,Owned: Owned with a mortgage or loan or shared ownership,151,143,118,11,107,23,2,8,5,0,1,1,1
S01011536,Rented or living rent free: Total,22,14,12,2,10,0,2,8,3,1,3,0,1
S01011536,Rented or living rent free: Social rented,7,5,5,1,4,0,0,2,1,0,1,0,0
S01011536,Rented or living rent free: Private rented or living rent free,15,9,7,1,6,0,2,6,2,1,2,0,1
S01011537,All HRPs aged 16 and over,252,207,186,16,170,15,6,45,30,4,1,6,4
S01011537,Owned: Total,219,187,169,15,154,15,3,32,24,1,0,4,3
S01011537,Owned: Owned outright,51,31,30,8,22,1,0,20,20,0,0,0,0
S01011537,Owned: Owned with a mortgage or loan or shared ownership,168,156,139,7,132,14,3,12,4,1,0,4,3
S01011537,Rented or living rent free: Total,33,20,17,1,16,0,3,13,6,3,1,2,1
S01011537,Rented or living rent free: Social rented,4,2,2,0,2,0,0,2,1,0,0,0,1
S01011537,Rented or living rent free: Private rented or living rent free,29,18,15,1,14,0,3,11,5,3,1,2,0
S01011538,All HRPs aged 16 and over,259,192,166,17,149,22,4,67,65,1,1,0,0
S01011538,Owned: Total,237,175,154,14,140,20,1,62,60,1,1,0,0
S01011538,Owned: Owned outright,102,48,45,10,35,3,0,54,54,0,0,0,0
S01011538,Owned: Owned with a mortgage or loan or shared ownership,135,127,109,4,105,17,1,8,6,1,1,0,0
S01011538,Rented or living rent free: Total,22,17,12,3,9,2,3,5,5,0,0,0,0
S01011538,Rented or living rent free: Social rented,3,2,2,0,2,0,0,1,1,0,0,0,0
S01011538,Rented or living rent free: Private rented or living rent free,19,15,10,3,7,2,3,4,4,0,0,0,0
S01011539,All HRPs aged 16 and over,312,177,142,30,112,17,18,135,91,4,5,27,8
S01011539,Owned: Total,172,102,87,13,74,13,2,70,53,3,1,11,2
S01011539,Owned: Owned outright,68,25,20,4,16,4,1,43,38,2,0,2,1
S01011539,Owned: Owned with a mortgage or loan or shared ownership,104,77,67,9,58,9,1,27,15,1,1,9,1
S01011539,Rented or living rent free: Total,140,75,55,17,38,4,16,65,38,1,4,16,6
S01011539,Rented or living rent free: Social rented,127,66,50,17,33,4,12,61,36,1,3,15,6
S01011539,Rented or living rent free: Private rented or living rent free,13,9,5,0,5,0,4,4,2,0,1,1,0
S01011540,All HRPs aged 16 and over,431,280,235,41,194,35,10,151,118,1,3,22,7
S01011540,Owned: Total,280,207,176,18,158,29,2,73,67,1,0,4,1
S01011540,Owned: Owned outright,77,31,26,5,21,4,1,46,43,0,0,3,0
S01011540,Owned: Owned with a mortgage or loan or shared ownership,203,176,150,13,137,25,1,27,24,1,0,1,1
S01011540,Rented or living rent free: Total,151,73,59,23,36,6,8,78,51,0,3,18,6
S01011540,Rented or living rent free: Social rented,130,61,50,19,31,3,8,69,45,0,2,17,5
S01011540,Rented or living rent free: Private rented or living rent free,21,12,9,4,5,3,0,9,6,0,1,1,1
S01011541,All HRPs aged 16 and over,382,260,214,57,157,26,20,122,67,5,8,33,9
S01011541,Owned: Total,136,103,93,7,86,10,0,33,26,1,0,5,1
S01011541,Owned: Owned outright,45,24,19,2,17,5,0,21,20,0,0,1,0
S01011541,Owned: Owned with a mortgage or loan or shared ownership,91,79,74,5,69,5,0,12,6,1,0,4,1
S01011541,Rented or living rent free: Total,246,157,121,50,71,16,20,89,41,4,8,28,8
S01011541,Rented or living rent free: Social rented,227,145,110,46,64,15,20,82,40,0,8,26,8
S01011541,Rented or living rent free: Private rented or living rent free,19,12,11,4,7,1,0,7,1,4,0,2,0
S01011542,All HRPs aged 16 and over,374,234,200,35,165,20,14,140,90,0,13,25,12
S01011542,Owned: Total,205,139,126,16,110,13,0,66,60,0,2,2,2
S01011542,Owned: Owned outright,71,25,18,2,16,7,0,46,42,0,1,1,2
S01011542,Owned: Owned with a mortgage or loan or shared ownership,134,114,108,14,94,6,0,20,18,0,1,1,0
S01011542,Rented or living rent free: Total,169,95,74,19,55,7,14,74,30,0,11,23,10
S01011542,Rented or living rent free: Social rented,155,85,66,18,48,6,13,70,28,0,10,22,10
S01011542,Rented or living rent free: Private rented or living rent free,14,10,8,1,7,1,1,4,2,0,1,1,0
S01011543,All HRPs aged 16 and over,325,211,170,49,121,16,25,114,58,1,19,28,8
S01011543,Owned: Total,117,99,87,14,73,12,0,18,16,0,0,0,2
S01011543,Owned: Owned outright,25,13,13,6,7,0,0,12,10,0,0,0,2
S01011543,Owned: Owned with a mortgage or loan or shared ownership,92,86,74,8,66,12,0,6,6,0,0,0,0
S01011543,Rented or living rent free: Total,208,112,83,35,48,4,25,96,42,1,19,28,6
S01011543,Rented or living rent free: Social rented,201,108,79,34,45,4,25,93,41,1,17,28,6
S01011543,Rented or living rent free: Private rented or living rent free,7,4,4,1,3,0,0,3,1,0,2,0,0
S01011544,All HRPs aged 16 and over,295,166,135,21,114,14,17,129,79,3,9,29,9
S01011544,Owned: Total,138,101,90,9,81,9,2,37,24,1,2,7,3
S01011544,Owned: Owned outright,34,12,10,1,9,2,0,22,18,1,0,2,1
S01011544,Owned: Owned with a mortgage or loan or shared ownership,104,89,80,8,72,7,2,15,6,0,2,5,2
S01011544,Rented or living rent free: Total,157,65,45,12,33,5,15,92,55,2,7,22,6
S01011544,Rented or living rent free: Social rented,148,59,44,12,32,5,10,89,55,2,7,20,5
S01011544,Rented or living rent free: Private rented or living rent free,9,6,1,0,1,0,5,3,0,0,0,2,1
S01011545,All HRPs aged 16 and over,252,135,117,22,95,10,8,117,83,2,9,17,6
S01011545,Owned: Total,152,87,78,11,67,6,3,65,55,0,2,6,2
S01011545,Owned: Owned outright,56,16,15,7,8,0,1,40,35,0,0,4,1
S01011545,Owned: Owned with a mortgage or loan or shared ownership,96,71,63,4,59,6,2,25,20,0,2,2,1
S01011545,Rented or living rent free: Total,100,48,39,11,28,4,5,52,28,2,7,11,4
S01011545,Rented or living rent free: Social rented,90,40,35,9,26,2,3,50,26,2,7,11,4
S01011545,Rented or living rent free: Private rented or living rent free,10,8,4,2,2,2,2,2,2,0,0,0,0
S01011546,All HRPs aged 16 and over,236,218,179,21,158,37,2,18,12,0,4,1,1
S01011546,Owned: Total,227,210,173,17,156,36,1,17,12,0,3,1,1
S01011546,Owned: Owned outright,30,22,20,5,15,2,0,8,8,0,0,0,0
S01011546,Owned: Owned with a mortgage or loan or shared ownership,197,188,153,12,141,34,1,9,4,0,3,1,1
S01011546,Rented or living rent free: Total,9,8,6,4,2,1,1,1,0,0,1,0,0
S01011546,Rented or living rent free: Social rented,4,4,3,3,0,1,0,0,0,0,0,0,0
S01011546,Rented or living rent free: Private rented or living rent free,5,4,3,1,2,0,1,1,0,0,1,0,0
S01011547,All HRPs aged 16 and over,216,191,160,21,139,23,8,25,12,1,6,5,1
S01011547,Owned: Total,191,173,145,15,130,22,6,18,11,0,2,4,1
S01011547,Owned: Owned outright,28,21,15,4,11,6,0,7,6,0,1,0,0
S01011547,Owned: Owned with a mortgage or loan or shared ownership,163,152,130,11,119,16,6,11,5,0,1,4,1
S01011547,Rented or living rent free: Total,25,18,15,6,9,1,2,7,1,1,4,1,0
S01011547,Rented or living rent free: Social rented,6,3,2,1,1,0,1,3,1,0,1,1,0
S01011547,Rented or living rent free: Private rented or living rent free,19,15,13,5,8,1,1,4,0,1,3,0,0
S01011548,All HRPs aged 16 and over,331,190,160,20,140,23,7,141,118,4,5,11,3
S01011548,Owned: Total,244,152,131,12,119,16,5,92,85,0,1,4,2
S01011548,Owned: Owned outright,107,37,30,4,26,5,2,70,68,0,0,1,1
S01011548,Owned: Owned with a mortgage or loan or shared ownership,137,115,101,8,93,11,3,22,17,0,1,3,1
S01011548,Rented or living rent free: Total,87,38,29,8,21,7,2,49,33,4,4,7,1
S01011548,Rented or living rent free: Social rented,63,23,18,6,12,3,2,40,28,1,4,6,1
S01011548,Rented or living rent free: Private rented or living rent free,24,15,11,2,9,4,0,9,5,3,0,1,0
S01011549,All HRPs aged 16 and over,318,217,177,16,161,30,10,101,91,0,3,7,0
S01011549,Owned: Total,277,199,163,12,151,30,6,78,70,0,3,5,0
S01011549,Owned: Owned outright,136,69,61,9,52,6,2,67,62,0,1,4,0
S01011549,Owned: Owned with a mortgage or loan or shared ownership,141,130,102,3,99,24,4,11,8,0,2,1,0
S01011549,Rented or living rent free: Total,41,18,14,4,10,0,4,23,21,0,0,2,0
S01011549,Rented or living rent free: Social rented,31,13,9,2,7,0,4,18,17,0,0,1,0
S01011549,Rented or living rent free: Private rented or living rent free,10,5,5,2,3,0,0,5,4,0,0,1,0
S01011550,All HRPs aged 16 and over,277,190,161,21,140,25,4,87,79,0,2,6,0
S01011550,Owned: Total,264,186,158,21,137,25,3,78,74,0,1,3,0
S01011550,Owned: Owned outright,140,70,57,10,47,13,0,70,68,0,0,2,0
S01011550,Owned: Owned with a mortgage or loan or shared ownership,124,116,101,11,90,12,3,8,6,0,1,1,0
S01011550,Rented or living rent free: Total,13,4,3,0,3,0,1,9,5,0,1,3,0
S01011550,Rented or living rent free: Social rented,9,2,1,0,1,0,1,7,3,0,1,3,0
S01011550,Rented or living rent free: Private rented or living rent free,4,2,2,0,2,0,0,2,2,0,0,0,0
S01011551,All HRPs aged 16 and over,227,151,122,17,105,19,10,76,55,0,7,9,5
S01011551,Owned: Total,167,119,97,11,86,18,4,48,43,0,1,1,3
S01011551,Owned: Owned outright,69,36,29,9,20,6,1,33,32,0,1,0,0
S01011551,Owned: Owned with a mortgage or loan or shared ownership,98,83,68,2,66,12,3,15,11,0,0,1,3
S01011551,Rented or living rent free: Total,60,32,25,6,19,1,6,28,12,0,6,8,2
S01011551,Rented or living rent free: Social rented,46,27,20,5,15,1,6,19,9,0,2,6,2
S01011551,Rented or living rent free: Private rented or living rent free,14,5,5,1,4,0,0,9,3,0,4,2,0
S01011552,All HRPs aged 16 and over,269,200,173,30,143,23,4,69,58,0,2,5,4
S01011552,Owned: Total,241,184,163,29,134,19,2,57,53,0,0,2,2
S01011552,Owned: Owned outright,96,50,44,10,34,5,1,46,42,0,0,2,2
S01011552,Owned: Owned with a mortgage or loan or shared ownership,145,134,119,19,100,14,1,11,11,0,0,0,0
S01011552,Rented or living rent free: Total,28,16,10,1,9,4,2,12,5,0,2,3,2
S01011552,Rented or living rent free: Social rented,15,6,4,1,3,0,2,9,4,0,0,3,2
S01011552,Rented or living rent free: Private rented or living rent free,13,10,6,0,6,4,0,3,1,0,2,0,0
S01011553,All HRPs aged 16 and over,267,243,193,13,180,46,4,24,11,3,1,8,1
S01011553,Owned: Total,238,224,181,11,170,42,1,14,10,3,0,1,0
S01011553,Owned: Owned outright,32,23,21,0,21,2,0,9,9,0,0,0,0
S01011553,Owned: Owned with a mortgage or loan or shared ownership,206,201,160,11,149,40,1,5,1,3,0,1,0
S01011553,Rented or living rent free: Total,29,19,12,2,10,4,3,10,1,0,1,7,1
S01011553,Rented or living rent free: Social rented,9,6,5,1,4,0,1,3,0,0,0,3,0
S01011553,Rented or living rent free: Private rented or living rent free,20,13,7,1,6,4,2,7,1,0,1,4,1
S01011554,All HRPs aged 16 and over,372,208,179,39,140,24,5,164,128,0,10,19,7
S01011554,Owned: Total,266,168,144,26,118,23,1,98,89,0,2,7,0
S01011554,Owned: Owned outright,110,38,31,8,23,7,0,72,64,0,2,6,0
S01011554,Owned: Owned with a mortgage or loan or shared ownership,156,130,113,18,95,16,1,26,25,0,0,1,0
S01011554,Rented or living rent free: Total,106,40,35,13,22,1,4,66,39,0,8,12,7
S01011554,Rented or living rent free: Social rented,92,32,28,10,18,0,4,60,38,0,7,10,5
S01011554,Rented or living rent free: Private rented or living rent free,14,8,7,3,4,1,0,6,1,0,1,2,2
S01011555,All HRPs aged 16 and over,236,155,137,39,98,10,8,81,52,1,6,16,6
S01011555,Owned: Total,121,93,84,15,69,9,0,28,24,0,1,1,2
S01011555,Owned: Owned outright,31,14,14,4,10,0,0,17,16,0,0,0,1
S01011555,Owned: Owned with a mortgage or loan or shared ownership,90,79,70,11,59,9,0,11,8,0,1,1,1
S01011555,Rented or living rent free: Total,115,62,53,24,29,1,8,53,28,1,5,15,4
S01011555,Rented or living rent free: Social rented,98,51,42,20,22,1,8,47,27,1,3,13,3
S01011555,Rented or living rent free: Private rented or living rent free,17,11,11,4,7,0,0,6,1,0,2,2,1
S01011556,All HRPs aged 16 and over,251,149,112,24,88,20,17,102,56,2,11,30,3
S01011556,Owned: Total,125,88,71,11,60,15,2,37,32,1,2,2,0
S01011556,Owned: Owned outright,50,20,16,5,11,3,1,30,28,1,1,0,0
S01011556,Owned: Owned with a mortgage or loan or shared ownership,75,68,55,6,49,12,1,7,4,0,1,2,0
S01011556,Rented or living rent free: Total,126,61,41,13,28,5,15,65,24,1,9,28,3
S01011556,Rented or living rent free: Social rented,105,52,36,12,24,4,12,53,22,0,5,23,3
S01011556,Rented or living rent free: Private rented or living rent free,21,9,5,1,4,1,3,12,2,1,4,5,0
S01011557,All HRPs aged 16 and over,303,194,167,34,133,17,10,109,67,2,2,30,8
S01011557,Owned: Total,182,130,117,12,105,12,1,52,44,0,1,4,3
S01011557,Owned: Owned outright,56,21,19,2,17,2,0,35,29,0,0,3,3
S01011557,Owned: Owned with a mortgage or loan or shared ownership,126,109,98,10,88,10,1,17,15,0,1,1,0
S01011557,Rented or living rent free: Total,121,64,50,22,28,5,9,57,23,2,1,26,5
S01011557,Rented or living rent free: Social rented,102,47,38,15,23,4,5,55,21,2,1,26,5
S01011557,Rented or living rent free: Private rented or living rent free,19,17,12,7,5,1,4,2,2,0,0,0,0
S01011558,All HRPs aged 16 and over,242,164,134,29,105,17,13,78,46,1,9,19,3
S01011558,Owned: Total,107,81,69,9,60,11,1,26,22,0,1,3,0
S01011558,Owned: Owned outright,33,14,13,4,9,1,0,19,17,0,1,1,0
S01011558,Owned: Owned with a mortgage or loan or shared ownership,74,67,56,5,51,10,1,7,5,0,0,2,0
S01011558,Rented or living rent free: Total,135,83,65,20,45,6,12,52,24,1,8,16,3
S01011558,Rented or living rent free: Social rented,125,77,61,18,43,5,11,48,21,1,8,16,2
S01011558,Rented or living rent free: Private rented or living rent free,10,6,4,2,2,1,1,4,3,0,0,0,1
S01011559,All HRPs aged 16 and over,246,154,123,23,100,14,17,92,53,1,6,29,3
S01011559,Owned: Total,127,90,77,11,66,12,1,37,33,0,0,3,1
S01011559,Owned: Owned outright,39,14,11,2,9,3,0,25,24,0,0,1,0
S01011559,Owned: Owned with a mortgage or loan or shared ownership,88,76,66,9,57,9,1,12,9,0,0,2,1
S01011559,Rented or living rent free: Total,119,64,46,12,34,2,16,55,20,1,6,26,2
S01011559,Rented or living rent free: Social rented,101,47,32,11,21,2,13,54,20,1,5,26,2
S01011559,Rented or living rent free: Private rented or living rent free,18,17,14,1,13,0,3,1,0,0,1,0,0
S01011560,All HRPs aged 16 and over,318,185,162,23,139,12,11,133,87,0,13,27,6
S01011560,Owned: Total,179,122,110,7,103,10,2,57,50,0,0,4,3
S01011560,Owned: Owned outright,50,16,13,2,11,2,1,34,30,0,0,2,2
S01011560,Owned: Owned with a mortgage or loan or shared ownership,129,106,97,5,92,8,1,23,20,0,0,2,1
S01011560,Rented or living rent free: Total,139,63,52,16,36,2,9,76,37,0,13,23,3
S01011560,Rented or living rent free: Social rented,130,55,46,13,33,2,7,75,37,0,12,23,3
S01011560,Rented or living rent free: Private rented or living rent free,9,8,6,3,3,0,2,1,0,0,1,0,0
S01011561,All HRPs aged 16 and over,302,178,149,42,107,8,21,124,84,1,12,23,4
S01011561,Owned: Total,164,109,99,19,80,7,3,55,48,0,3,2,2
S01011561,Owned: Owned outright,53,18,16,8,8,1,1,35,31,0,2,1,1
S01011561,Owned: Owned with a mortgage or loan or shared ownership,111,91,83,11,72,6,2,20,17,0,1,1,1
S01011561,Rented or living rent free: Total,138,69,50,23,27,1,18,69,36,1,9,21,2
S01011561,Rented or living rent free: Social rented,126,61,44,21,23,1,16,65,35,1,7,20,2
S01011561,Rented or living rent free: Private rented or living rent free,12,8,6,2,4,0,2,4,1,0,2,1,0
S01011562,All HRPs aged 16 and over,270,166,138,45,93,10,18,104,40,5,13,35,11
S01011562,Owned: Total,72,57,49,5,44,6,2,15,13,0,0,2,0
S01011562,Owned: Owned outright,14,7,7,1,6,0,0,7,7,0,0,0,0
S01011562,Owned: Owned with a mortgage or loan or shared ownership,58,50,42,4,38,6,2,8,6,0,0,2,0
S01011562,Rented or living rent free: Total,198,109,89,40,49,4,16,89,27,5,13,33,11
S01011562,Rented or living rent free: Social rented,184,99,82,37,45,2,15,85,25,5,11,33,11
S01011562,Rented or living rent free: Private rented or living rent free,14,10,7,3,4,2,1,4,2,0,2,0,0
S01011563,All HRPs aged 16 and over,287,182,147,41,106,15,20,105,50,0,10,38,7
S01011563,Owned: Total,99,67,59,4,55,7,1,32,26,0,0,6,0
S01011563,Owned: Owned outright,36,12,9,2,7,2,1,24,20,0,0,4,0
S01011563,Owned: Owned with a mortgage or loan or shared ownership,63,55,50,2,48,5,0,8,6,0,0,2,0
S01011563,Rented or living rent free: Total,188,115,88,37,51,8,19,73,24,0,10,32,7
S01011563,Rented or living rent free: Social rented,174,104,81,33,48,7,16,70,24,0,10,30,6
S01011563,Rented or living rent free: Private rented or living rent free,14,11,7,4,3,1,3,3,0,0,0,2,1
S01011564,All HRPs aged 16 and over,410,289,246,42,204,26,17,121,93,0,7,17,4
S01011564,Owned: Total,285,215,186,17,169,25,4,70,64,0,1,5,0
S01011564,Owned: Owned outright,92,34,29,5,24,3,2,58,54,0,0,4,0
S01011564,Owned: Owned with a mortgage or loan or shared ownership,193,181,157,12,145,22,2,12,10,0,1,1,0
S01011564,Rented or living rent free: Total,125,74,60,25,35,1,13,51,29,0,6,12,4
S01011564,Rented or living rent free: Social rented,100,56,48,18,30,1,7,44,27,0,5,9,3
S01011564,Rented or living rent free: Private rented or living rent free,25,18,12,7,5,0,6,7,2,0,1,3,1
S01011565,All HRPs aged 16 and over,365,257,221,39,182,25,11,108,72,3,11,17,5
S01011565,Owned: Total,208,166,148,15,133,15,3,42,41,1,0,0,0
S01011565,Owned: Owned outright,40,19,17,3,14,1,1,21,21,0,0,0,0
S01011565,Owned: Owned with a mortgage or loan or shared ownership,168,147,131,12,119,14,2,21,20,1,0,0,0
S01011565,Rented or living rent free: Total,157,91,73,24,49,10,8,66,31,2,11,17,5
S01011565,Rented or living rent free: Social rented,129,74,58,17,41,8,8,55,29,1,9,12,4
S01011565,Rented or living rent free: Private rented or living rent free,28,17,15,7,8,2,0,11,2,1,2,5,1
S01011566,All HRPs aged 16 and over,374,244,189,42,147,17,38,130,59,6,11,45,9
S01011566,Owned: Total,154,118,101,12,89,13,4,36,32,0,0,2,2
S01011566,Owned: Owned outright,48,24,21,5,16,1,2,24,23,0,0,1,0
S01011566,Owned: Owned with a mortgage or loan or shared ownership,106,94,80,7,73,12,2,12,9,0,0,1,2
S01011566,Rented or living rent free: Total,220,126,88,30,58,4,34,94,27,6,11,43,7
S01011566,Rented or living rent free: Social rented,198,109,75,27,48,4,30,89,25,6,11,40,7
S01011566,Rented or living rent free: Private rented or living rent free,22,17,13,3,10,0,4,5,2,0,0,3,0
S01011567,All HRPs aged 16 and over,454,226,192,43,149,23,11,228,156,3,5,55,9
S01011567,Owned: Total,239,145,128,20,108,16,1,94,88,0,0,5,1
S01011567,Owned: Owned outright,106,36,32,9,23,3,1,70,66,0,0,3,1
S01011567,Owned: Owned with a mortgage or loan or shared ownership,133,109,96,11,85,13,0,24,22,0,0,2,0
S01011567,Rented or living rent free: Total,215,81,64,23,41,7,10,134,68,3,5,50,8
S01011567,Rented or living rent free: Social rented,196,71,55,20,35,6,10,125,67,0,5,45,8
S01011567,Rented or living rent free: Private rented or living rent free,19,10,9,3,6,1,0,9,1,3,0,5,0
S01011568,All HRPs aged 16 and over,320,221,188,29,159,20,13,99,76,1,3,18,1
S01011568,Owned: Total,241,181,157,22,135,18,6,60,55,0,1,4,0
S01011568,Owned: Owned outright,64,27,21,9,12,2,4,37,36,0,0,1,0
S01011568,Owned: Owned with a mortgage or loan or shared ownership,177,154,136,13,123,16,2,23,19,0,1,3,0
S01011568,Rented or living rent free: Total,79,40,31,7,24,2,7,39,21,1,2,14,1
S01011568,Rented or living rent free: Social rented,56,24,18,5,13,1,5,32,18,0,2,11,1
S01011568,Rented or living rent free: Private rented or living rent free,23,16,13,2,11,1,2,7,3,1,0,3,0
S01011569,All HRPs aged 16 and over,414,256,232,33,199,16,8,158,121,4,8,22,3
S01011569,Owned: Total,288,205,189,20,169,12,4,83,71,0,3,8,1
S01011569,Owned: Owned outright,111,46,40,4,36,4,2,65,56,0,2,7,0
S01011569,Owned: Owned with a mortgage or loan or shared ownership,177,159,149,16,133,8,2,18,15,0,1,1,1
S01011569,Rented or living rent free: Total,126,51,43,13,30,4,4,75,50,4,5,14,2
S01011569,Rented or living rent free: Social rented,102,35,30,10,20,2,3,67,48,4,2,12,1
S01011569,Rented or living rent free: Private rented or living rent free,24,16,13,3,10,2,1,8,2,0,3,2,1
S01011570,All HRPs aged 16 and over,329,191,164,37,127,17,10,138,96,3,8,23,8
S01011570,Owned: Total,186,116,102,16,86,13,1,70,60,2,2,6,0
S01011570,Owned: Owned outright,79,23,20,4,16,3,0,56,51,2,1,2,0
S01011570,Owned: Owned with a mortgage or loan or shared ownership,107,93,82,12,70,10,1,14,9,0,1,4,0
S01011570,Rented or living rent free: Total,143,75,62,21,41,4,9,68,36,1,6,17,8
S01011570,Rented or living rent free: Social rented,106,47,42,15,27,1,4,59,32,1,4,15,7
S01011570,Rented or living rent free: Private rented or living rent free,37,28,20,6,14,3,5,9,4,0,2,2,1
S01011571,All HRPs aged 16 and over,389,210,173,33,140,11,26,179,113,4,9,44,9
S01011571,Owned: Total,113,90,78,6,72,7,5,23,21,0,0,0,2
S01011571,Owned: Owned outright,27,14,13,3,10,1,0,13,13,0,0,0,0
S01011571,Owned: Owned with a mortgage or loan or shared ownership,86,76,65,3,62,6,5,10,8,0,0,0,2
S01011571,Rented or living rent free: Total,276,120,95,27,68,4,21,156,92,4,9,44,7
S01011571,Rented or living rent free: Social rented,236,90,71,18,53,3,16,146,91,4,9,37,5
S01011571,Rented or living rent free: Private rented or living rent free,40,30,24,9,15,1,5,10,1,0,0,7,2
S01011572,All HRPs aged 16 and over,294,190,164,25,139,14,12,104,65,0,12,19,8
S01011572,Owned: Total,139,96,82,10,72,12,2,43,35,0,0,6,2
S01011572,Owned: Owned outright,54,22,14,1,13,8,0,32,28,0,0,2,2
S01011572,Owned: Owned with a mortgage or loan or shared ownership,85,74,68,9,59,4,2,11,7,0,0,4,0
S01011572,Rented or living rent free: Total,155,94,82,15,67,2,10,61,30,0,12,13,6
S01011572,Rented or living rent free: Social rented,108,57,53,12,41,0,4,51,27,0,11,9,4
S01011572,Rented or living rent free: Private rented or living rent free,47,37,29,3,26,2,6,10,3,0,1,4,2
S01011573,All HRPs aged 16 and over,474,338,274,23,251,48,16,136,94,0,3,31,8
S01011573,Owned: Total,307,275,228,13,215,41,6,32,25,0,0,4,3
S01011573,Owned: Owned outright,48,27,22,4,18,4,1,21,19,0,0,2,0
S01011573,Owned: Owned with a mortgage or loan or shared ownership,259,248,206,9,197,37,5,11,6,0,0,2,3
S01011573,Rented or living rent free: Total,167,63,46,10,36,7,10,104,69,0,3,27,5
S01011573,Rented or living rent free: Social rented,128,32,19,5,14,5,8,96,67,0,3,22,4
S01011573,Rented or living rent free: Private rented or living rent free,39,31,27,5,22,2,2,8,2,0,0,5,1
S01011574,All HRPs aged 16 and over,296,212,180,20,160,24,8,84,57,3,3,15,6
S01011574,Owned: Total,221,178,151,15,136,23,4,43,39,0,1,2,1
S01011574,Owned: Owned outright,50,16,13,2,11,2,1,34,33,0,1,0,0
S01011574,Owned: Owned with a mortgage or loan or shared ownership,171,162,138,13,125,21,3,9,6,0,0,2,1
S01011574,Rented or living rent free: Total,75,34,29,5,24,1,4,41,18,3,2,13,5
S01011574,Rented or living rent free: Social rented,55,21,18,2,16,1,2,34,16,2,1,11,4
S01011574,Rented or living rent free: Private rented or living rent free,20,13,11,3,8,0,2,7,2,1,1,2,1
S01011575,All HRPs aged 16 and over,229,142,117,17,100,11,14,87,51,14,5,11,6
S01011575,Owned: Total,125,95,83,7,76,8,4,30,23,0,2,3,2
S01011575,Owned: Owned outright,29,10,8,2,6,2,0,19,18,0,0,1,0
S01011575,Owned: Owned with a mortgage or loan or shared ownership,96,85,75,5,70,6,4,11,5,0,2,2,2
S01011575,Rented or living rent free: Total,104,47,34,10,24,3,10,57,28,14,3,8,4
S01011575,Rented or living rent free: Social rented,67,28,25,6,19,1,2,39,26,0,3,7,3
S01011575,Rented or living rent free: Private rented or living rent free,37,19,9,4,5,2,8,18,2,14,0,1,1
S01011576,All HRPs aged 16 and over,374,184,141,46,95,11,32,190,118,3,15,47,7
S01011576,Owned: Total,79,51,44,11,33,6,1,28,24,0,0,3,1
S01011576,Owned: Owned outright,31,12,11,3,8,1,0,19,17,0,0,1,1
S01011576,Owned: Owned with a mortgage or loan or shared ownership,48,39,33,8,25,5,1,9,7,0,0,2,0
S01011576,Rented or living rent free: Total,295,133,97,35,62,5,31,162,94,3,15,44,6
S01011576,Rented or living rent free: Social rented,287,125,94,34,60,5,26,162,94,3,15,44,6
S01011576,Rented or living rent free: Private rented or living rent free,8,8,3,1,2,0,5,0,0,0,0,0,0
S01011577,All HRPs aged 16 and over,328,228,185,36,149,23,20,100,55,1,8,35,1
S01011577,Owned: Total,192,145,128,13,115,16,1,47,37,0,1,8,1
S01011577,Owned: Owned outright,55,24,21,1,20,2,1,31,28,0,0,2,1
S01011577,Owned: Owned with a mortgage or loan or shared ownership,137,121,107,12,95,14,0,16,9,0,1,6,0
S01011577,Rented or living rent free: Total,136,83,57,23,34,7,19,53,18,1,7,27,0
S01011577,Rented or living rent free: Social rented,89,45,29,17,12,2,14,44,17,1,3,23,0
S01011577,Rented or living rent free: Private rented or living rent free,47,38,28,6,22,5,5,9,1,0,4,4,0
S01011578,All HRPs aged 16 and over,355,240,201,47,154,14,25,115,56,1,14,39,5
S01011578,Owned: Total,150,118,108,12,96,10,0,32,27,0,1,4,0
S01011578,Owned: Owned outright,36,11,10,6,4,1,0,25,24,0,1,0,0
S01011578,Owned: Owned with a mortgage or loan or shared ownership,114,107,98,6,92,9,0,7,3,0,0,4,0
S01011578,Rented or living rent free: Total,205,122,93,35,58,4,25,83,29,1,13,35,5
S01011578,Rented or living rent free: Social rented,189,109,85,32,53,4,20,80,26,1,13,35,5
S01011578,Rented or living rent free: Private rented or living rent free,16,13,8,3,5,0,5,3,3,0,0,0,0
S01011579,All HRPs aged 16 and over,413,275,223,27,196,47,5,138,122,3,3,7,3
S01011579,Owned: Total,383,254,209,25,184,43,2,129,117,2,3,5,2
S01011579,Owned: Owned outright,184,77,64,16,48,13,0,107,100,1,2,2,2
S01011579,Owned: Owned with a mortgage or loan or shared ownership,199,177,145,9,136,30,2,22,17,1,1,3,0
S01011579,Rented or living rent free: Total,30,21,14,2,12,4,3,9,5,1,0,2,1
S01011579,Rented or living rent free: Social rented,8,5,3,1,2,0,2,3,1,1,0,0,1
S01011579,Rented or living rent free: Private rented or living rent free,22,16,11,1,10,4,1,6,4,0,0,2,0
S01011580,All HRPs aged 16 and over,311,205,165,33,132,24,16,106,50,2,12,33,9
S01011580,Owned: Total,157,126,108,13,95,17,1,31,21,0,0,7,3
S01011580,Owned: Owned outright,38,19,16,6,10,3,0,19,16,0,0,1,2
S01011580,Owned: Owned with a mortgage or loan or shared ownership,119,107,92,7,85,14,1,12,5,0,0,6,1
S01011580,Rented or living rent free: Total,154,79,57,20,37,7,15,75,29,2,12,26,6
S01011580,Rented or living rent free: Social rented,130,64,47,18,29,5,12,66,27,0,9,24,6
S01011580,Rented or living rent free: Private rented or living rent free,24,15,10,2,8,2,3,9,2,2,3,2,0
S01011581,All HRPs aged 16 and over,463,201,161,43,118,17,23,262,185,1,8,57,11
S01011581,Owned: Total,138,81,69,10,59,9,3,57,46,0,2,9,0
S01011581,Owned: Owned outright,55,20,18,5,13,0,2,35,29,0,1,5,0
S01011581,Owned: Owned with a mortgage or loan or shared ownership,83,61,51,5,46,9,1,22,17,0,1,4,0
S01011581,Rented or living rent free: Total,325,120,92,33,59,8,20,205,139,1,6,48,11
S01011581,Rented or living rent free: Social rented,296,97,73,27,46,8,16,199,138,0,5,45,11
S01011581,Rented or living rent free: Private rented or living rent free,29,23,19,6,13,0,4,6,1,1,1,3,0
S01011582,All HRPs aged 16 and over,477,334,286,42,244,45,3,143,132,3,2,6,0
S01011582,Owned: Total,414,288,246,37,209,39,3,126,122,0,1,3,0
S01011582,Owned: Owned outright,182,70,57,18,39,12,1,112,110,0,1,1,0
S01011582,Owned: Owned with a mortgage or loan or shared ownership,232,218,189,19,170,27,2,14,12,0,0,2,0
S01011582,Rented or living rent free: Total,63,46,40,5,35,6,0,17,10,3,1,3,0
S01011582,Rented or living rent free: Social rented,8,4,4,0,4,0,0,4,2,0,0,2,0
S01011582,Rented or living rent free: Private rented or living rent free,55,42,36,5,31,6,0,13,8,3,1,1,0
S01011583,All HRPs aged 16 and over,332,226,190,32,158,16,20,106,66,2,12,22,4
S01011583,Owned: Total,182,141,122,13,109,11,8,41,37,1,0,3,0
S01011583,Owned: Owned outright,59,27,22,8,14,2,3,32,29,0,0,3,0
S01011583,Owned: Owned with a mortgage or loan or shared ownership,123,114,100,5,95,9,5,9,8,1,0,0,0
S01011583,Rented or living rent free: Total,150,85,68,19,49,5,12,65,29,1,12,19,4
S01011583,Rented or living rent free: Social rented,100,48,36,12,24,3,9,52,26,1,9,15,1
S01011583,Rented or living rent free: Private rented or living rent free,50,37,32,7,25,2,3,13,3,0,3,4,3
S01011584,All HRPs aged 16 and over,325,193,169,28,141,10,14,132,91,1,8,28,4
S01011584,Owned: Total,188,133,125,16,109,6,2,55,50,0,1,4,0
S01011584,Owned: Owned outright,59,19,17,3,14,1,1,40,38,0,1,1,0
S01011584,Owned: Owned with a mortgage or loan or shared ownership,129,114,108,13,95,5,1,15,12,0,0,3,0
S01011584,Rented or living rent free: Total,137,60,44,12,32,4,12,77,41,1,7,24,4
S01011584,Rented or living rent free: Social rented,113,45,36,12,24,2,7,68,38,0,6,21,3
S01011584,Rented or living rent free: Private rented or living rent free,24,15,8,0,8,2,5,9,3,1,1,3,1
S01011585,All HRPs aged 16 and over,336,197,169,40,129,16,12,139,100,2,13,21,3
S01011585,Owned: Total,205,132,113,16,97,14,5,73,66,0,0,5,2
S01011585,Owned: Owned outright,82,27,22,4,18,4,1,55,52,0,0,3,0
S01011585,Owned: Owned with a mortgage or loan or shared ownership,123,105,91,12,79,10,4,18,14,0,0,2,2
S01011585,Rented or living rent free: Total,131,65,56,24,32,2,7,66,34,2,13,16,1
S01011585,Rented or living rent free: Social rented,91,42,36,18,18,0,6,49,29,1,7,12,0
S01011585,Rented or living rent free: Private rented or living rent free,40,23,20,6,14,2,1,17,5,1,6,4,1
S01011586,All HRPs aged 16 and over,239,150,128,22,106,3,19,89,57,5,5,19,3
S01011586,Owned: Total,122,82,78,12,66,2,2,40,34,0,0,5,1
S01011586,Owned: Owned outright,46,19,18,6,12,1,0,27,26,0,0,1,0
S01011586,Owned: Owned with a mortgage or loan or shared ownership,76,63,60,6,54,1,2,13,8,0,0,4,1
S01011586,Rented or living rent free: Total,117,68,50,10,40,1,17,49,23,5,5,14,2
S01011586,Rented or living rent free: Social rented,81,44,32,7,25,1,11,37,21,0,3,11,2
S01011586,Rented or living rent free: Private rented or living rent free,36,24,18,3,15,0,6,12,2,5,2,3,0
S01011587,All HRPs aged 16 and over,236,143,125,36,89,8,10,93,56,5,15,13,4
S01011587,Owned: Total,103,75,66,11,55,6,3,28,23,0,2,2,1
S01011587,Owned: Owned outright,33,12,11,4,7,1,0,21,19,0,0,1,1
S01011587,Owned: Owned with a mortgage or loan or shared ownership,70,63,55,7,48,5,3,7,4,0,2,1,0
S01011587,Rented or living rent free: Total,133,68,59,25,34,2,7,65,33,5,13,11,3
S01011587,Rented or living rent free: Social rented,111,55,49,22,27,2,4,56,30,2,11,11,2
S01011587,Rented or living rent free: Private rented or living rent free,22,13,10,3,7,0,3,9,3,3,2,0,1
S01011588,All HRPs aged 16 and over,302,179,143,22,121,21,15,123,81,1,19,17,5
S01011588,Owned: Total,166,115,100,11,89,15,0,51,45,0,1,3,2
S01011588,Owned: Owned outright,72,27,20,4,16,7,0,45,39,0,1,3,2
S01011588,Owned: Owned with a mortgage or loan or shared ownership,94,88,80,7,73,8,0,6,6,0,0,0,0
S01011588,Rented or living rent free: Total,136,64,43,11,32,6,15,72,36,1,18,14,3
S01011588,Rented or living rent free: Social rented,116,57,37,8,29,6,14,59,34,1,10,12,2
S01011588,Rented or living rent free: Private rented or living rent free,20,7,6,3,3,0,1,13,2,0,8,2,1
S01011589,All HRPs aged 16 and over,347,196,176,24,152,16,4,151,124,1,4,15,7
S01011589,Owned: Total,245,155,139,13,126,14,2,90,82,1,0,4,3
S01011589,Owned: Owned outright,104,30,26,7,19,2,2,74,71,1,0,1,1
S01011589,Owned: Owned with a mortgage or loan or shared ownership,141,125,113,6,107,12,0,16,11,0,0,3,2
S01011589,Rented or living rent free: Total,102,41,37,11,26,2,2,61,42,0,4,11,4
S01011589,Rented or living rent free: Social rented,91,32,28,8,20,2,2,59,41,0,4,11,3
S01011589,Rented or living rent free: Private rented or living rent free,11,9,9,3,6,0,0,2,1,0,0,0,1
S01011590,All HRPs aged 16 and over,287,170,137,21,116,14,19,117,85,4,6,19,3
S01011590,Owned: Total,150,98,86,11,75,9,3,52,46,1,1,4,0
S01011590,Owned: Owned outright,51,21,17,3,14,3,1,30,26,1,0,3,0
S01011590,Owned: Owned with a mortgage or loan or shared ownership,99,77,69,8,61,6,2,22,20,0,1,1,0
S01011590,Rented or living rent free: Total,137,72,51,10,41,5,16,65,39,3,5,15,3
S01011590,Rented or living rent free: Social rented,126,65,45,9,36,5,15,61,37,3,5,13,3
S01011590,Rented or living rent free: Private rented or living rent free,11,7,6,1,5,0,1,4,2,0,0,2,0
S01011591,All HRPs aged 16 and over,268,150,108,14,94,15,27,118,74,4,8,25,7
S01011591,Owned: Total,110,76,65,4,61,6,5,34,30,2,1,1,0
S01011591,Owned: Owned outright,29,9,6,0,6,1,2,20,17,2,0,1,0
S01011591,Owned: Owned with a mortgage or loan or shared ownership,81,67,59,4,55,5,3,14,13,0,1,0,0
S01011591,Rented or living rent free: Total,158,74,43,10,33,9,22,84,44,2,7,24,7
S01011591,Rented or living rent free: Social rented,145,66,38,9,29,7,21,79,43,2,7,23,4
S01011591,Rented or living rent free: Private rented or living rent free,13,8,5,1,4,2,1,5,1,0,0,1,3
S01011592,All HRPs aged 16 and over,353,209,164,44,120,15,30,144,80,1,11,42,10
S01011592,Owned: Total,100,77,68,10,58,9,0,23,19,0,1,1,2
S01011592,Owned: Owned outright,29,13,12,3,9,1,0,16,14,0,0,1,1
S01011592,Owned: Owned with a mortgage or loan or shared ownership,71,64,56,7,49,8,0,7,5,0,1,0,1
S01011592,Rented or living rent free: Total,253,132,96,34,62,6,30,121,61,1,10,41,8
S01011592,Rented or living rent free: Social rented,211,96,66,25,41,6,24,115,58,1,10,38,8
S01011592,Rented or living rent free: Private rented or living rent free,42,36,30,9,21,0,6,6,3,0,0,3,0
S01011593,All HRPs aged 16 and over,325,186,160,27,133,18,8,139,103,6,3,21,6
S01011593,Owned: Total,213,142,126,15,111,14,2,71,61,4,0,4,2
S01011593,Owned: Owned outright,79,27,25,9,16,2,0,52,46,3,0,2,1
S01011593,Owned: Owned with a mortgage or loan or shared ownership,134,115,101,6,95,12,2,19,15,1,0,2,1
S01011593,Rented or living rent free: Total,112,44,34,12,22,4,6,68,42,2,3,17,4
S01011593,Rented or living rent free: Social rented,95,36,27,8,19,3,6,59,39,0,1,16,3
S01011593,Rented or living rent free: Private rented or living rent free,17,8,7,4,3,1,0,9,3,2,2,1,1
S01011594,All HRPs aged 16 and over,221,131,112,17,95,13,6,90,77,0,3,10,0
S01011594,Owned: Total,130,89,76,9,67,10,3,41,37,0,1,3,0
S01011594,Owned: Owned outright,55,22,17,4,13,4,1,33,31,0,1,1,0
S01011594,Owned: Owned with a mortgage or loan or shared ownership,75,67,59,5,54,6,2,8,6,0,0,2,0
S01011594,Rented or living rent free: Total,91,42,36,8,28,3,3,49,40,0,2,7,0
S01011594,Rented or living rent free: Social rented,61,19,17,5,12,1,1,42,36,0,1,5,0
S01011594,Rented or living rent free: Private rented or living rent free,30,23,19,3,16,2,2,7,4,0,1,2,0
S01011595,All HRPs aged 16 and over,301,234,191,16,175,33,10,67,53,3,3,8,0
S01011595,Owned: Total,230,180,147,10,137,30,3,50,44,2,0,4,0
S01011595,Owned: Owned outright,79,39,27,5,22,9,3,40,39,0,0,1,0
S01011595,Owned: Owned with a mortgage or loan or shared ownership,151,141,120,5,115,21,0,10,5,2,0,3,0
S01011595,Rented or living rent free: Total,71,54,44,6,38,3,7,17,9,1,3,4,0
S01011595,Rented or living rent free: Social rented,6,3,2,1,1,0,1,3,3,0,0,0,0
S01011595,Rented or living rent free: Private rented or living rent free,65,51,42,5,37,3,6,14,6,1,3,4,0
S01011596,All HRPs aged 16 and over,489,318,276,42,234,24,18,171,127,7,11,20,6
S01011596,Owned: Total,309,210,189,24,165,17,4,99,86,2,2,6,3
S01011596,Owned: Owned outright,121,46,41,10,31,5,0,75,68,1,0,4,2
S01011596,Owned: Owned with a mortgage or loan or shared ownership,188,164,148,14,134,12,4,24,18,1,2,2,1
S01011596,Rented or living rent free: Total,180,108,87,18,69,7,14,72,41,5,9,14,3
S01011596,Rented or living rent free: Social rented,71,23,18,4,14,1,4,48,30,1,2,14,1
S01011596,Rented or living rent free: Private rented or living rent free,109,85,69,14,55,6,10,24,11,4,7,0,2
S01011597,All HRPs aged 16 and over,268,211,183,20,163,18,10,57,40,2,1,7,7
S01011597,Owned: Total,198,158,138,9,129,17,3,40,33,2,0,3,2
S01011597,Owned: Owned outright,52,21,17,2,15,4,0,31,28,0,0,1,2
S01011597,Owned: Owned with a mortgage or loan or shared ownership,146,137,121,7,114,13,3,9,5,2,0,2,0
S01011597,Rented or living rent free: Total,70,53,45,11,34,1,7,17,7,0,1,4,5
S01011597,Rented or living rent free: Social rented,13,6,4,2,2,0,2,7,5,0,0,2,0
S01011597,Rented or living rent free: Private rented or living rent free,57,47,41,9,32,1,5,10,2,0,1,2,5
S01011598,All HRPs aged 16 and over,544,317,192,46,146,17,108,227,80,15,10,80,42
S01011598,Owned: Total,31,26,17,0,17,6,3,5,2,0,0,2,1
S01011598,Owned: Owned outright,11,8,5,0,5,3,0,3,2,0,0,0,1
S01011598,Owned: Owned with a mortgage or loan or shared ownership,20,18,12,0,12,3,3,2,0,0,0,2,0
S01011598,Rented or living rent free: Total,513,291,175,46,129,11,105,222,78,15,10,78,41
S01011598,Rented or living rent free: Social rented,506,288,173,46,127,10,105,218,77,15,10,75,41
S01011598,Rented or living rent free: Private rented or living rent free,7,3,2,0,2,1,0,4,1,0,0,3,0
S01011599,All HRPs aged 16 and over,362,212,186,35,151,13,13,150,112,1,10,17,10
S01011599,Owned: Total,234,143,129,17,112,12,2,91,76,1,0,9,5
S01011599,Owned: Owned outright,97,30,29,7,22,0,1,67,60,0,0,3,4
S01011599,Owned: Owned with a mortgage or loan or shared ownership,137,113,100,10,90,12,1,24,16,1,0,6,1
S01011599,Rented or living rent free: Total,128,69,57,18,39,1,11,59,36,0,10,8,5
S01011599,Rented or living rent free: Social rented,91,47,39,15,24,0,8,44,30,0,6,5,3
S01011599,Rented or living rent free: Private rented or living rent free,37,22,18,3,15,1,3,15,6,0,4,3,2
S01011600,All HRPs aged 16 and over,392,218,186,27,159,19,13,174,129,1,8,28,8
S01011600,Owned: Total,218,136,115,12,103,15,6,82,73,1,2,5,1
S01011600,Owned: Owned outright,97,37,28,5,23,7,2,60,57,0,2,1,0
S01011600,Owned: Owned with a mortgage or loan or shared ownership,121,99,87,7,80,8,4,22,16,1,0,4,1
S01011600,Rented or living rent free: Total,174,82,71,15,56,4,7,92,56,0,6,23,7
S01011600,Rented or living rent free: Social rented,108,44,36,9,27,2,6,64,41,0,1,20,2
S01011600,Rented or living rent free: Private rented or living rent free,66,38,35,6,29,2,1,28,15,0,5,3,5
S01011601,All HRPs aged 16 and over,316,263,227,31,196,30,6,53,35,1,10,4,3
S01011601,Owned: Total,277,240,207,23,184,29,4,37,32,1,1,2,1
S01011601,Owned: Owned outright,59,32,28,8,20,4,0,27,25,0,0,1,1
S01011601,Owned: Owned with a mortgage or loan or shared ownership,218,208,179,15,164,25,4,10,7,1,1,1,0
S01011601,Rented or living rent free: Total,39,23,20,8,12,1,2,16,3,0,9,2,2
S01011601,Rented or living rent free: Social rented,8,3,3,2,1,0,0,5,1,0,3,1,0
S01011601,Rented or living rent free: Private rented or living rent free,31,20,17,6,11,1,2,11,2,0,6,1,2
S01011602,All HRPs aged 16 and over,266,163,129,21,108,15,19,103,64,2,6,23,8
S01011602,Owned: Total,123,80,69,4,65,9,2,43,40,0,0,2,1
S01011602,Owned: Owned outright,56,26,21,1,20,4,1,30,29,0,0,0,1
S01011602,Owned: Owned with a mortgage or loan or shared ownership,67,54,48,3,45,5,1,13,11,0,0,2,0
S01011602,Rented or living rent free: Total,143,83,60,17,43,6,17,60,24,2,6,21,7
S01011602,Rented or living rent free: Social rented,128,72,51,17,34,6,15,56,21,1,6,21,7
S01011602,Rented or living rent free: Private rented or living rent free,15,11,9,0,9,0,2,4,3,1,0,0,0
S01011603,All HRPs aged 16 and over,443,197,162,26,136,14,21,246,163,4,7,51,21
S01011603,Owned: Total,177,101,91,10,81,5,5,76,69,1,0,3,3
S01011603,Owned: Owned outright,77,24,20,5,15,4,0,53,51,0,0,1,1
S01011603,Owned: Owned with a mortgage or loan or shared ownership,100,77,71,5,66,1,5,23,18,1,0,2,2
S01011603,Rented or living rent free: Total,266,96,71,16,55,9,16,170,94,3,7,48,18
S01011603,Rented or living rent free: Social rented,232,80,60,13,47,8,12,152,87,3,2,43,17
S01011603,Rented or living rent free: Private rented or living rent free,34,16,11,3,8,1,4,18,7,0,5,5,1
S01011604,All HRPs aged 16 and over,293,174,134,30,104,14,26,119,81,2,9,21,6
S01011604,Owned: Total,146,88,78,10,68,9,1,58,51,0,2,4,1
S01011604,Owned: Owned outright,50,14,10,2,8,3,1,36,33,0,1,2,0
S01011604,Owned: Owned with a mortgage or loan or shared ownership,96,74,68,8,60,6,0,22,18,0,1,2,1
S01011604,Rented or living rent free: Total,147,86,56,20,36,5,25,61,30,2,7,17,5
S01011604,Rented or living rent free: Social rented,139,81,52,18,34,4,25,58,27,2,7,17,5
S01011604,Rented or living rent free: Private rented or living rent free,8,5,4,2,2,1,0,3,3,0,0,0,0
S01011605,All HRPs aged 16 and over,376,211,167,23,144,28,16,165,137,0,5,19,4
S01011605,Owned: Total,253,158,132,14,118,23,3,95,85,0,0,9,1
S01011605,Owned: Owned outright,104,36,27,5,22,8,1,68,62,0,0,5,1
S01011605,Owned: Owned with a mortgage or loan or shared ownership,149,122,105,9,96,15,2,27,23,0,0,4,0
S01011605,Rented or living rent free: Total,123,53,35,9,26,5,13,70,52,0,5,10,3
S01011605,Rented or living rent free: Social rented,96,36,22,5,17,4,10,60,46,0,4,9,1
S01011605,Rented or living rent free: Private rented or living rent free,27,17,13,4,9,1,3,10,6,0,1,1,2
S01011606,All HRPs aged 16 and over,342,314,282,22,260,27,5,28,16,2,2,6,2
S01011606,Owned: Total,314,293,266,17,249,24,3,21,15,2,1,2,1
S01011606,Owned: Owned outright,41,30,26,5,21,3,1,11,9,2,0,0,0
S01011606,Owned: Owned with a mortgage or loan or shared ownership,273,263,240,12,228,21,2,10,6,0,1,2,1
S01011606,Rented or living rent free: Total,28,21,16,5,11,3,2,7,1,0,1,4,1
S01011606,Rented or living rent free: Social rented,15,10,7,2,5,2,1,5,0,0,1,3,1
S01011606,Rented or living rent free: Private rented or living rent free,13,11,9,3,6,1,1,2,1,0,0,1,0
S01011607,All HRPs aged 16 and over,231,197,169,14,155,20,8,34,29,1,1,3,0
S01011607,Owned: Total,212,181,159,12,147,19,3,31,27,1,1,2,0
S01011607,Owned: Owned outright,73,48,43,4,39,4,1,25,24,1,0,0,0
S01011607,Owned: Owned with a mortgage or loan or shared ownership,139,133,116,8,108,15,2,6,3,0,1,2,0
S01011607,Rented or living rent free: Total,19,16,10,2,8,1,5,3,2,0,0,1,0
S01011607,Rented or living rent free: Social rented,3,2,1,0,1,0,1,1,1,0,0,0,0
S01011607,Rented or living rent free: Private rented or living rent free,16,14,9,2,7,1,4,2,1,0,0,1,0
S01011608,All HRPs aged 16 and over,360,308,256,31,225,44,8,52,36,0,3,9,4
S01011608,Owned: Total,305,269,224,17,207,41,4,36,30,0,1,3,2
S01011608,Owned: Owned outright,76,50,37,7,30,11,2,26,22,0,1,1,2
S01011608,Owned: Owned with a mortgage or loan or shared ownership,229,219,187,10,177,30,2,10,8,0,0,2,0
S01011608,Rented or living rent free: Total,55,39,32,14,18,3,4,16,6,0,2,6,2
S01011608,Rented or living rent free: Social rented,16,6,6,1,5,0,0,10,3,0,2,4,1
S01011608,Rented or living rent free: Private rented or living rent free,39,33,26,13,13,3,4,6,3,0,0,2,1
S01011609,All HRPs aged 16 and over,479,278,210,56,154,20,48,201,84,7,19,73,18
S01011609,Owned: Total,113,75,64,8,56,9,2,38,27,0,0,8,3
S01011609,Owned: Owned outright,45,22,18,6,12,3,1,23,18,0,0,2,3
S01011609,Owned: Owned with a mortgage or loan or shared ownership,68,53,46,2,44,6,1,15,9,0,0,6,0
S01011609,Rented or living rent free: Total,366,203,146,48,98,11,46,163,57,7,19,65,15
S01011609,Rented or living rent free: Social rented,330,174,121,40,81,10,43,156,54,7,18,62,15
S01011609,Rented or living rent free: Private rented or living rent free,36,29,25,8,17,1,3,7,3,0,1,3,0
S01011610,All HRPs aged 16 and over,362,214,174,45,129,10,30,148,84,2,19,35,8
S01011610,Owned: Total,124,91,82,10,72,7,2,33,31,0,0,2,0
S01011610,Owned: Owned outright,33,7,6,1,5,1,0,26,25,0,0,1,0
S01011610,Owned: Owned with a mortgage or loan or shared ownership,91,84,76,9,67,6,2,7,6,0,0,1,0
S01011610,Rented or living rent free: Total,238,123,92,35,57,3,28,115,53,2,19,33,8
S01011610,Rented or living rent free: Social rented,210,108,80,32,48,3,25,102,51,2,12,29,8
S01011610,Rented or living rent free: Private rented or living rent free,28,15,12,3,9,0,3,13,2,0,7,4,0
S01011611,All HRPs aged 16 and over,258,198,169,23,146,20,9,60,43,3,0,10,4
S01011611,Owned: Total,212,169,146,15,131,18,5,43,36,1,0,4,2
S01011611,Owned: Owned outright,73,42,33,8,25,7,2,31,26,0,0,3,2
S01011611,Owned: Owned with a mortgage or loan or shared ownership,139,127,113,7,106,11,3,12,10,1,0,1,0
S01011611,Rented or living rent free: Total,46,29,23,8,15,2,4,17,7,2,0,6,2
S01011611,Rented or living rent free: Social rented,27,15,10,4,6,2,3,12,5,1,0,6,0
S01011611,Rented or living rent free: Private rented or living rent free,19,14,13,4,9,0,1,5,2,1,0,0,2
S01011612,All HRPs aged 16 and over,211,203,176,11,165,25,2,8,5,0,1,2,0
S01011612,Owned: Total,192,191,165,10,155,25,1,1,1,0,0,0,0
S01011612,Owned: Owned outright,17,16,15,4,11,1,0,1,1,0,0,0,0
S01011612,Owned: Owned with a mortgage or loan or shared ownership,175,175,150,6,144,24,1,0,0,0,0,0,0
S01011612,Rented or living rent free: Total,19,12,11,1,10,0,1,7,4,0,1,2,0
S01011612,Rented or living rent free: Social rented,5,2,2,0,2,0,0,3,2,0,1,0,0
S01011612,Rented or living rent free: Private rented or living rent free,14,10,9,1,8,0,1,4,2,0,0,2,0
S01011613,All HRPs aged 16 and over,374,258,208,25,183,43,7,116,101,0,6,7,2
S01011613,Owned: Total,339,233,190,21,169,39,4,106,97,0,2,6,1
S01011613,Owned: Owned outright,166,74,59,11,48,14,1,92,87,0,1,3,1
S01011613,Owned: Owned with a mortgage or loan or shared ownership,173,159,131,10,121,25,3,14,10,0,1,3,0
S01011613,Rented or living rent free: Total,35,25,18,4,14,4,3,10,4,0,4,1,1
S01011613,Rented or living rent free: Social rented,12,7,4,2,2,1,2,5,4,0,1,0,0
S01011613,Rented or living rent free: Private rented or living rent free,23,18,14,2,12,3,1,5,0,0,3,1,1
S01011614,All HRPs aged 16 and over,183,121,99,9,90,16,6,62,54,1,0,6,1
S01011614,Owned: Total,134,102,85,7,78,14,3,32,30,0,0,1,1
S01011614,Owned: Owned outright,49,25,17,2,15,7,1,24,24,0,0,0,0
S01011614,Owned: Owned with a mortgage or loan or shared ownership,85,77,68,5,63,7,2,8,6,0,0,1,1
S01011614,Rented or living rent free: Total,49,19,14,2,12,2,3,30,24,1,0,5,0
S01011614,Rented or living rent free: Social rented,40,13,10,2,8,1,2,27,21,1,0,5,0
S01011614,Rented or living rent free: Private rented or living rent free,9,6,4,0,4,1,1,3,3,0,0,0,0
S01011615,All HRPs aged 16 and over,296,181,145,32,113,18,18,115,61,3,12,30,9
S01011615,Owned: Total,163,121,104,17,87,14,3,42,36,0,1,5,0
S01011615,Owned: Owned outright,60,30,27,6,21,3,0,30,26,0,1,3,0
S01011615,Owned: Owned with a mortgage or loan or shared ownership,103,91,77,11,66,11,3,12,10,0,0,2,0
S01011615,Rented or living rent free: Total,133,60,41,15,26,4,15,73,25,3,11,25,9
S01011615,Rented or living rent free: Social rented,112,47,34,13,21,2,11,65,24,2,9,23,7
S01011615,Rented or living rent free: Private rented or living rent free,21,13,7,2,5,2,4,8,1,1,2,2,2
S01011616,All HRPs aged 16 and over,211,113,86,10,76,9,18,98,62,2,9,22,3
S01011616,Owned: Total,95,55,45,4,41,8,2,40,34,0,2,3,1
S01011616,Owned: Owned outright,44,16,13,3,10,2,1,28,26,0,1,1,0
S01011616,Owned: Owned with a mortgage or loan or shared ownership,51,39,32,1,31,6,1,12,8,0,1,2,1
S01011616,Rented or living rent free: Total,116,58,41,6,35,1,16,58,28,2,7,19,2
S01011616,Rented or living rent free: Social rented,92,40,29,5,24,1,10,52,25,2,5,18,2
S01011616,Rented or living rent free: Private rented or living rent free,24,18,12,1,11,0,6,6,3,0,2,1,0
S01011617,All HRPs aged 16 and over,388,216,180,34,146,21,15,172,115,4,12,32,9
S01011617,Owned: Total,245,142,123,18,105,16,3,103,83,3,4,11,2
S01011617,Owned: Owned outright,94,32,30,8,22,2,0,62,50,2,2,6,2
S01011617,Owned: Owned with a mortgage or loan or shared ownership,151,110,93,10,83,14,3,41,33,1,2,5,0
S01011617,Rented or living rent free: Total,143,74,57,16,41,5,12,69,32,1,8,21,7
S01011617,Rented or living rent free: Social rented,121,63,49,13,36,5,9,58,29,0,5,20,4
S01011617,Rented or living rent free: Private rented or living rent free,22,11,8,3,5,0,3,11,3,1,3,1,3
S01011618,All HRPs aged 16 and over,277,155,131,29,102,12,12,122,80,0,11,16,15
S01011618,Owned: Total,169,105,91,11,80,11,3,64,54,0,3,5,2
S01011618,Owned: Owned outright,61,16,15,0,15,1,0,45,35,0,3,5,2
S01011618,Owned: Owned with a mortgage or loan or shared ownership,108,89,76,11,65,10,3,19,19,0,0,0,0
S01011618,Rented or living rent free: Total,108,50,40,18,22,1,9,58,26,0,8,11,13
S01011618,Rented or living rent free: Social rented,78,33,25,8,17,1,7,45,25,0,4,11,5
S01011618,Rented or living rent free: Private rented or living rent free,30,17,15,10,5,0,2,13,1,0,4,0,8
S01011619,All HRPs aged 16 and over,406,341,306,18,288,25,10,65,47,2,6,9,1
S01011619,Owned: Total,356,305,276,12,264,25,4,51,40,2,3,6,0
S01011619,Owned: Owned outright,72,37,31,1,30,4,2,35,29,2,1,3,0
S01011619,Owned: Owned with a mortgage or loan or shared ownership,284,268,245,11,234,21,2,16,11,0,2,3,0
S01011619,Rented or living rent free: Total,50,36,30,6,24,0,6,14,7,0,3,3,1
S01011619,Rented or living rent free: Social rented,20,13,8,2,6,0,5,7,4,0,0,3,0
S01011619,Rented or living rent free: Private rented or living rent free,30,23,22,4,18,0,1,7,3,0,3,0,1
S01011620,All HRPs aged 16 and over,394,360,320,17,303,37,3,34,23,3,2,5,1
S01011620,Owned: Total,361,337,299,12,287,35,3,24,19,0,2,2,1
S01011620,Owned: Owned outright,45,32,25,4,21,6,1,13,12,0,0,0,1
S01011620,Owned: Owned with a mortgage or loan or shared ownership,316,305,274,8,266,29,2,11,7,0,2,2,0
S01011620,Rented or living rent free: Total,33,23,21,5,16,2,0,10,4,3,0,3,0
S01011620,Rented or living rent free: Social rented,14,7,6,1,5,1,0,7,3,3,0,1,0
S01011620,Rented or living rent free: Private rented or living rent free,19,16,15,4,11,1,0,3,1,0,0,2,0
S01011621,All HRPs aged 16 and over,286,199,171,24,147,20,8,87,64,1,6,13,3
S01011621,Owned: Total,223,163,143,16,127,18,2,60,55,0,0,4,1
S01011621,Owned: Owned outright,78,33,30,6,24,2,1,45,44,0,0,1,0
S01011621,Owned: Owned with a mortgage or loan or shared ownership,145,130,113,10,103,16,1,15,11,0,0,3,1
S01011621,Rented or living rent free: Total,63,36,28,8,20,2,6,27,9,1,6,9,2
S01011621,Rented or living rent free: Social rented,40,24,21,6,15,1,2,16,8,0,3,4,1
S01011621,Rented or living rent free: Private rented or living rent free,23,12,7,2,5,1,4,11,1,1,3,5,1
S01011622,All HRPs aged 16 and over,230,193,152,10,142,38,3,37,28,2,0,5,2
S01011622,Owned: Total,204,172,136,8,128,33,3,32,27,1,0,4,0
S01011622,Owned: Owned outright,39,15,9,1,8,5,1,24,22,0,0,2,0
S01011622,Owned: Owned with a mortgage or loan or shared ownership,165,157,127,7,120,28,2,8,5,1,0,2,0
S01011622,Rented or living rent free: Total,26,21,16,2,14,5,0,5,1,1,0,1,2
S01011622,Rented or living rent free: Social rented,6,5,4,0,4,1,0,1,0,0,0,1,0
S01011622,Rented or living rent free: Private rented or living rent free,20,16,12,2,10,4,0,4,1,1,0,0,2
S01011623,All HRPs aged 16 and over,314,183,154,28,126,18,11,131,92,1,9,23,6
S01011623,Owned: Total,180,120,102,12,90,15,3,60,52,0,1,5,2
S01011623,Owned: Owned outright,70,26,19,3,16,5,2,44,42,0,1,1,0
S01011623,Owned: Owned with a mortgage or loan or shared ownership,110,94,83,9,74,10,1,16,10,0,0,4,2
S01011623,Rented or living rent free: Total,134,63,52,16,36,3,8,71,40,1,8,18,4
S01011623,Rented or living rent free: Social rented,108,45,37,9,28,2,6,63,39,0,5,15,4
S01011623,Rented or living rent free: Private rented or living rent free,26,18,15,7,8,1,2,8,1,1,3,3,0
S01011624,All HRPs aged 16 and over,294,229,186,22,164,28,15,65,44,1,4,13,3
S01011624,Owned: Total,225,187,157,10,147,24,6,38,34,1,0,2,1
S01011624,Owned: Owned outright,47,21,18,2,16,3,0,26,24,0,0,1,1
S01011624,Owned: Owned with a mortgage or loan or shared ownership,178,166,139,8,131,21,6,12,10,1,0,1,0
S01011624,Rented or living rent free: Total,69,42,29,12,17,4,9,27,10,0,4,11,2
S01011624,Rented or living rent free: Social rented,45,28,21,9,12,1,6,17,7,0,2,8,0
S01011624,Rented or living rent free: Private rented or living rent free,24,14,8,3,5,3,3,10,3,0,2,3,2
S01011625,All HRPs aged 16 and over,240,162,138,20,118,13,11,78,51,5,5,17,0
S01011625,Owned: Total,132,102,91,9,82,11,0,30,28,1,1,0,0
S01011625,Owned: Owned outright,41,21,20,3,17,1,0,20,19,1,0,0,0
S01011625,Owned: Owned with a mortgage or loan or shared ownership,91,81,71,6,65,10,0,10,9,0,1,0,0
S01011625,Rented or living rent free: Total,108,60,47,11,36,2,11,48,23,4,4,17,0
S01011625,Rented or living rent free: Social rented,98,53,42,10,32,1,10,45,21,4,3,17,0
S01011625,Rented or living rent free: Private rented or living rent free,10,7,5,1,4,1,1,3,2,0,1,0,0
S01011626,All HRPs aged 16 and over,289,255,213,19,194,31,11,34,29,0,2,0,3
S01011626,Owned: Total,259,230,199,13,186,30,1,29,27,0,0,0,2
S01011626,Owned: Owned outright,52,30,26,3,23,4,0,22,21,0,0,0,1
S01011626,Owned: Owned with a mortgage or loan or shared ownership,207,200,173,10,163,26,1,7,6,0,0,0,1
S01011626,Rented or living rent free: Total,30,25,14,6,8,1,10,5,2,0,2,0,1
S01011626,Rented or living rent free: Social rented,10,7,4,1,3,0,3,3,1,0,1,0,1
S01011626,Rented or living rent free: Private rented or living rent free,20,18,10,5,5,1,7,2,1,0,1,0,0
S01011627,All HRPs aged 16 and over,260,233,206,15,191,24,3,27,18,1,4,4,0
S01011627,Owned: Total,228,210,186,13,173,23,1,18,15,0,1,2,0
S01011627,Owned: Owned outright,42,28,26,4,22,2,0,14,12,0,1,1,0
S01011627,Owned: Owned with a mortgage or loan or shared ownership,186,182,160,9,151,21,1,4,3,0,0,1,0
S01011627,Rented or living rent free: Total,32,23,20,2,18,1,2,9,3,1,3,2,0
S01011627,Rented or living rent free: Social rented,10,4,4,1,3,0,0,6,2,1,1,2,0
S01011627,Rented or living rent free: Private rented or living rent free,22,19,16,1,15,1,2,3,1,0,2,0,0
S01011628,All HRPs aged 16 and over,410,289,247,27,220,35,7,121,109,1,2,3,6
S01011628,Owned: Total,365,263,229,22,207,30,4,102,98,0,0,1,3
S01011628,Owned: Owned outright,141,55,50,12,38,3,2,86,86,0,0,0,0
S01011628,Owned: Owned with a mortgage or loan or shared ownership,224,208,179,10,169,27,2,16,12,0,0,1,3
S01011628,Rented or living rent free: Total,45,26,18,5,13,5,3,19,11,1,2,2,3
S01011628,Rented or living rent free: Social rented,23,11,8,2,6,1,2,12,8,0,1,1,2
S01011628,Rented or living rent free: Private rented or living rent free,22,15,10,3,7,4,1,7,3,1,1,1,1
S01011629,All HRPs aged 16 and over,240,147,118,29,89,12,17,93,58,3,6,22,4
S01011629,Owned: Total,161,108,93,21,72,9,6,53,48,1,1,2,1
S01011629,Owned: Owned outright,69,30,27,11,16,0,3,39,36,1,0,1,1
S01011629,Owned: Owned with a mortgage or loan or shared ownership,92,78,66,10,56,9,3,14,12,0,1,1,0
S01011629,Rented or living rent free: Total,79,39,25,8,17,3,11,40,10,2,5,20,3
S01011629,Rented or living rent free: Social rented,64,34,23,8,15,2,9,30,9,2,2,15,2
S01011629,Rented or living rent free: Private rented or living rent free,15,5,2,0,2,1,2,10,1,0,3,5,1
S01011630,All HRPs aged 16 and over,255,159,123,18,105,20,16,96,79,0,8,7,2
S01011630,Owned: Total,166,113,91,7,84,18,4,53,51,0,2,0,0
S01011630,Owned: Owned outright,73,28,24,4,20,3,1,45,44,0,1,0,0
S01011630,Owned: Owned with a mortgage or loan or shared ownership,93,85,67,3,64,15,3,8,7,0,1,0,0
S01011630,Rented or living rent free: Total,89,46,32,11,21,2,12,43,28,0,6,7,2
S01011630,Rented or living rent free: Social rented,76,37,26,8,18,2,9,39,27,0,4,6,2
S01011630,Rented or living rent free: Private rented or living rent free,13,9,6,3,3,0,3,4,1,0,2,1,0
S01011631,All HRPs aged 16 and over,245,147,113,26,87,9,25,98,30,9,23,30,6
S01011631,Owned: Total,63,50,42,9,33,6,2,13,10,1,1,1,0
S01011631,Owned: Owned outright,13,7,6,0,6,1,0,6,5,0,0,1,0
S01011631,Owned: Owned with a mortgage or loan or shared ownership,50,43,36,9,27,5,2,7,5,1,1,0,0
S01011631,Rented or living rent free: Total,182,97,71,17,54,3,23,85,20,8,22,29,6
S01011631,Rented or living rent free: Social rented,173,93,67,16,51,3,23,80,19,8,20,27,6
S01011631,Rented or living rent free: Private rented or living rent free,9,4,4,1,3,0,0,5,1,0,2,2,0
S01011632,All HRPs aged 16 and over,314,202,164,35,129,19,19,112,60,2,14,27,9
S01011632,Owned: Total,150,105,90,12,78,13,2,45,35,0,2,6,2
S01011632,Owned: Owned outright,53,24,17,3,14,5,2,29,23,0,0,4,2
S01011632,Owned: Owned with a mortgage or loan or shared ownership,97,81,73,9,64,8,0,16,12,0,2,2,0
S01011632,Rented or living rent free: Total,164,97,74,23,51,6,17,67,25,2,12,21,7
S01011632,Rented or living rent free: Social rented,143,84,63,21,42,5,16,59,22,1,10,19,7
S01011632,Rented or living rent free: Private rented or living rent free,21,13,11,2,9,1,1,8,3,1,2,2,0
S01011633,All HRPs aged 16 and over,321,181,143,28,115,14,24,140,97,2,13,21,7
S01011633,Owned: Total,141,97,86,16,70,10,1,44,38,1,0,3,2
S01011633,Owned: Owned outright,55,23,20,8,12,3,0,32,30,1,0,0,1
S01011633,Owned: Owned with a mortgage or loan or shared ownership,86,74,66,8,58,7,1,12,8,0,0,3,1
S01011633,Rented or living rent free: Total,180,84,57,12,45,4,23,96,59,1,13,18,5
S01011633,Rented or living rent free: Social rented,161,76,52,12,40,3,21,85,53,1,9,17,5
S01011633,Rented or living rent free: Private rented or living rent free,19,8,5,0,5,1,2,11,6,0,4,1,0
S01011634,All HRPs aged 16 and over,235,130,114,20,94,5,11,105,49,8,12,28,8
S01011634,Owned: Total,91,67,60,5,55,4,3,24,16,3,0,4,1
S01011634,Owned: Owned outright,20,10,8,1,7,1,1,10,9,0,0,1,0
S01011634,Owned: Owned with a mortgage or loan or shared ownership,71,57,52,4,48,3,2,14,7,3,0,3,1
S01011634,Rented or living rent free: Total,144,63,54,15,39,1,8,81,33,5,12,24,7
S01011634,Rented or living rent free: Social rented,123,52,44,14,30,1,7,71,30,4,7,24,6
S01011634,Rented or living rent free: Private rented or living rent free,21,11,10,1,9,0,1,10,3,1,5,0,1
S01011635,All HRPs aged 16 and over,274,176,150,27,123,14,12,98,54,1,6,33,4
S01011635,Owned: Total,92,77,70,4,66,7,0,15,13,1,0,1,0
S01011635,Owned: Owned outright,18,11,7,0,7,4,0,7,6,0,0,1,0
S01011635,Owned: Owned with a mortgage or loan or shared ownership,74,66,63,4,59,3,0,8,7,1,0,0,0
S01011635,Rented or living rent free: Total,182,99,80,23,57,7,12,83,41,0,6,32,4
S01011635,Rented or living rent free: Social rented,153,80,65,17,48,7,8,73,37,0,5,28,3
S01011635,Rented or living rent free: Private rented or living rent free,29,19,15,6,9,0,4,10,4,0,1,4,1
S01011636,All HRPs aged 16 and over,283,165,136,33,103,13,16,118,70,3,17,20,8
S01011636,Owned: Total,142,97,86,12,74,9,2,45,39,0,1,3,2
S01011636,Owned: Owned outright,49,21,20,2,18,1,0,28,27,0,0,1,0
S01011636,Owned: Owned with a mortgage or loan or shared ownership,93,76,66,10,56,8,2,17,12,0,1,2,2
S01011636,Rented or living rent free: Total,141,68,50,21,29,4,14,73,31,3,16,17,6
S01011636,Rented or living rent free: Social rented,122,56,39,15,24,4,13,66,30,3,11,16,6
S01011636,Rented or living rent free: Private rented or living rent free,19,12,11,6,5,0,1,7,1,0,5,1,0
S01011637,All HRPs aged 16 and over,299,182,144,29,115,15,23,117,78,2,9,19,9
S01011637,Owned: Total,166,110,92,10,82,12,6,56,51,0,1,3,1
S01011637,Owned: Owned outright,68,30,24,2,22,4,2,38,37,0,0,0,1
S01011637,Owned: Owned with a mortgage or loan or shared ownership,98,80,68,8,60,8,4,18,14,0,1,3,0
S01011637,Rented or living rent free: Total,133,72,52,19,33,3,17,61,27,2,8,16,8
S01011637,Rented or living rent free: Social rented,108,54,37,13,24,1,16,54,27,2,6,13,6
S01011637,Rented or living rent free: Private rented or living rent free,25,18,15,6,9,2,1,7,0,0,2,3,2
S01011638,All HRPs aged 16 and over,260,138,115,18,97,12,11,122,97,1,2,20,2
S01011638,Owned: Total,149,89,77,9,68,11,1,60,54,0,1,3,2
S01011638,Owned: Owned outright,62,19,17,3,14,2,0,43,40,0,1,1,1
S01011638,Owned: Owned with a mortgage or loan or shared ownership,87,70,60,6,54,9,1,17,14,0,0,2,1
S01011638,Rented or living rent free: Total,111,49,38,9,29,1,10,62,43,1,1,17,0
S01011638,Rented or living rent free: Social rented,81,25,17,4,13,1,7,56,40,0,1,15,0
S01011638,Rented or living rent free: Private rented or living rent free,30,24,21,5,16,0,3,6,3,1,0,2,0
S01011639,All HRPs aged 16 and over,250,145,124,33,91,6,15,105,71,1,13,13,7
S01011639,Owned: Total,124,80,75,18,57,4,1,44,38,1,0,2,3
S01011639,Owned: Owned outright,55,21,20,6,14,1,0,34,31,0,0,1,2
S01011639,Owned: Owned with a mortgage or loan or shared ownership,69,59,55,12,43,3,1,10,7,1,0,1,1
S01011639,Rented or living rent free: Total,126,65,49,15,34,2,14,61,33,0,13,11,4
S01011639,Rented or living rent free: Social rented,98,44,29,9,20,2,13,54,29,0,12,9,4
S01011639,Rented or living rent free: Private rented or living rent free,28,21,20,6,14,0,1,7,4,0,1,2,0
S01011640,All HRPs aged 16 and over,259,179,151,26,125,11,17,80,59,1,5,12,3
S01011640,Owned: Total,143,105,94,8,86,8,3,38,34,0,0,2,2
S01011640,Owned: Owned outright,57,28,25,4,21,2,1,29,26,0,0,2,1
S01011640,Owned: Owned with a mortgage or loan or shared ownership,86,77,69,4,65,6,2,9,8,0,0,0,1
S01011640,Rented or living rent free: Total,116,74,57,18,39,3,14,42,25,1,5,10,1
S01011640,Rented or living rent free: Social rented,102,67,52,16,36,3,12,35,23,1,4,7,0
S01011640,Rented or living rent free: Private rented or living rent free,14,7,5,2,3,0,2,7,2,0,1,3,1
S01011641,All HRPs aged 16 and over,195,121,101,5,96,20,0,74,69,2,0,3,0
S01011641,Owned: Total,187,118,99,5,94,19,0,69,65,2,0,2,0
S01011641,Owned: Owned outright,82,21,19,4,15,2,0,61,58,2,0,1,0
S01011641,Owned: Owned with a mortgage or loan or shared ownership,105,97,80,1,79,17,0,8,7,0,0,1,0
S01011641,Rented or living rent free: Total,8,3,2,0,2,1,0,5,4,0,0,1,0
S01011641,Rented or living rent free: Social rented,3,2,1,0,1,1,0,1,1,0,0,0,0
S01011641,Rented or living rent free: Private rented or living rent free,5,1,1,0,1,0,0,4,3,0,0,1,0
S01011642,All HRPs aged 16 and over,352,245,193,26,167,28,24,107,81,1,4,17,4
S01011642,Owned: Total,243,162,138,13,125,22,2,81,77,0,0,3,1
S01011642,Owned: Owned outright,118,48,41,7,34,6,1,70,68,0,0,1,1
S01011642,Owned: Owned with a mortgage or loan or shared ownership,125,114,97,6,91,16,1,11,9,0,0,2,0
S01011642,Rented or living rent free: Total,109,83,55,13,42,6,22,26,4,1,4,14,3
S01011642,Rented or living rent free: Social rented,100,76,52,13,39,4,20,24,3,1,3,14,3
S01011642,Rented or living rent free: Private rented or living rent free,9,7,3,0,3,2,2,2,1,0,1,0,0
S01011643,All HRPs aged 16 and over,238,168,134,8,126,28,6,70,61,1,2,6,0
S01011643,Owned: Total,160,134,109,5,104,22,3,26,25,0,1,0,0
S01011643,Owned: Owned outright,40,17,12,2,10,5,0,23,22,0,1,0,0
S01011643,Owned: Owned with a mortgage or loan or shared ownership,120,117,97,3,94,17,3,3,3,0,0,0,0
S01011643,Rented or living rent free: Total,78,34,25,3,22,6,3,44,36,1,1,6,0
S01011643,Rented or living rent free: Social rented,40,7,5,0,5,2,0,33,29,0,0,4,0
S01011643,Rented or living rent free: Private rented or living rent free,38,27,20,3,17,4,3,11,7,1,1,2,0
S01011644,All HRPs aged 16 and over,339,176,152,22,130,20,4,163,149,2,1,4,7
S01011644,Owned: Total,231,149,127,14,113,19,3,82,78,0,1,2,1
S01011644,Owned: Owned outright,105,38,30,9,21,6,2,67,65,0,1,0,1
S01011644,Owned: Owned with a mortgage or loan or shared ownership,126,111,97,5,92,13,1,15,13,0,0,2,0
S01011644,Rented or living rent free: Total,108,27,25,8,17,1,1,81,71,2,0,2,6
S01011644,Rented or living rent free: Social rented,81,10,10,2,8,0,0,71,63,2,0,1,5
S01011644,Rented or living rent free: Private rented or living rent free,27,17,15,6,9,1,1,10,8,0,0,1,1
S01011645,All HRPs aged 16 and over,257,139,117,31,86,18,4,118,104,1,0,12,1
S01011645,Owned: Total,170,93,76,15,61,15,2,77,74,0,0,3,0
S01011645,Owned: Owned outright,89,27,24,10,14,2,1,62,59,0,0,3,0
S01011645,Owned: Owned with a mortgage or loan or shared ownership,81,66,52,5,47,13,1,15,15,0,0,0,0
S01011645,Rented or living rent free: Total,87,46,41,16,25,3,2,41,30,1,0,9,1
S01011645,Rented or living rent free: Social rented,67,31,26,12,14,3,2,36,27,0,0,8,1
S01011645,Rented or living rent free: Private rented or living rent free,20,15,15,4,11,0,0,5,3,1,0,1,0
S01011646,All HRPs aged 16 and over,262,184,160,21,139,22,2,78,73,0,2,1,2
S01011646,Owned: Total,252,178,156,20,136,21,1,74,72,0,0,1,1
S01011646,Owned: Owned outright,129,64,53,14,39,10,1,65,63,0,0,1,1
S01011646,Owned: Owned with a mortgage or loan or shared ownership,123,114,103,6,97,11,0,9,9,0,0,0,0
S01011646,Rented or living rent free: Total,10,6,4,1,3,1,1,4,1,0,2,0,1
S01011646,Rented or living rent free: Social rented,4,1,0,0,0,0,1,3,1,0,1,0,1
S01011646,Rented or living rent free: Private rented or living rent free,6,5,4,1,3,1,0,1,0,0,1,0,0
S01011647,All HRPs aged 16 and over,330,272,246,22,224,20,6,58,47,0,3,7,1
S01011647,Owned: Total,294,245,224,14,210,20,1,49,43,0,1,5,0
S01011647,Owned: Owned outright,74,33,29,4,25,4,0,41,39,0,0,2,0
S01011647,Owned: Owned with a mortgage or loan or shared ownership,220,212,195,10,185,16,1,8,4,0,1,3,0
S01011647,Rented or living rent free: Total,36,27,22,8,14,0,5,9,4,0,2,2,1
S01011647,Rented or living rent free: Social rented,10,5,4,1,3,0,1,5,3,0,0,2,0
S01011647,Rented or living rent free: Private rented or living rent free,26,22,18,7,11,0,4,4,1,0,2,0,1
S01011648,All HRPs aged 16 and over,276,215,179,14,165,24,12,61,32,1,4,19,5
S01011648,Owned: Total,173,150,131,7,124,18,1,23,17,0,0,5,1
S01011648,Owned: Owned outright,37,17,14,3,11,2,1,20,16,0,0,3,1
S01011648,Owned: Owned with a mortgage or loan or shared ownership,136,133,117,4,113,16,0,3,1,0,0,2,0
S01011648,Rented or living rent free: Total,103,65,48,7,41,6,11,38,15,1,4,14,4
S01011648,Rented or living rent free: Social rented,90,58,44,7,37,5,9,32,14,0,1,14,3
S01011648,Rented or living rent free: Private rented or living rent free,13,7,4,0,4,1,2,6,1,1,3,0,1
S01011649,All HRPs aged 16 and over,243,153,131,20,111,11,11,90,58,3,7,11,11
S01011649,Owned: Total,116,82,73,7,66,9,0,34,30,0,1,2,1
S01011649,Owned: Owned outright,35,13,12,4,8,1,0,22,20,0,1,1,0
S01011649,Owned: Owned with a mortgage or loan or shared ownership,81,69,61,3,58,8,0,12,10,0,0,1,1
S01011649,Rented or living rent free: Total,127,71,58,13,45,2,11,56,28,3,6,9,10
S01011649,Rented or living rent free: Social rented,103,52,43,11,32,1,8,51,28,3,4,8,8
S01011649,Rented or living rent free: Private rented or living rent free,24,19,15,2,13,1,3,5,0,0,2,1,2
S01011650,All HRPs aged 16 and over,308,199,159,20,139,31,9,109,89,0,6,12,2
S01011650,Owned: Total,222,145,117,12,105,25,3,77,74,0,0,3,0
S01011650,Owned: Owned outright,113,44,33,6,27,9,2,69,67,0,0,2,0
S01011650,Owned: Owned with a mortgage or loan or shared ownership,109,101,84,6,78,16,1,8,7,0,0,1,0
S01011650,Rented or living rent free: Total,86,54,42,8,34,6,6,32,15,0,6,9,2
S01011650,Rented or living rent free: Social rented,62,35,24,4,20,6,5,27,13,0,5,7,2
S01011650,Rented or living rent free: Private rented or living rent free,24,19,18,4,14,0,1,5,2,0,1,2,0
S01011651,All HRPs aged 16 and over,446,287,245,37,208,25,17,159,130,7,2,19,1
S01011651,Owned: Total,297,187,166,23,143,17,4,110,98,4,0,8,0
S01011651,Owned: Owned outright,125,42,34,9,25,5,3,83,79,0,0,4,0
S01011651,Owned: Owned with a mortgage or loan or shared ownership,172,145,132,14,118,12,1,27,19,4,0,4,0
S01011651,Rented or living rent free: Total,149,100,79,14,65,8,13,49,32,3,2,11,1
S01011651,Rented or living rent free: Social rented,74,38,32,4,28,1,5,36,25,2,1,7,1
S01011651,Rented or living rent free: Private rented or living rent free,75,62,47,10,37,7,8,13,7,1,1,4,0
S01011652,All HRPs aged 16 and over,311,235,201,31,170,22,12,76,58,3,1,9,5
S01011652,Owned: Total,260,195,171,21,150,20,4,65,54,3,0,7,1
S01011652,Owned: Owned outright,105,52,42,11,31,9,1,53,47,2,0,3,1
S01011652,Owned: Owned with a mortgage or loan or shared ownership,155,143,129,10,119,11,3,12,7,1,0,4,0
S01011652,Rented or living rent free: Total,51,40,30,10,20,2,8,11,4,0,1,2,4
S01011652,Rented or living rent free: Social rented,14,8,4,2,2,1,3,6,4,0,1,1,0
S01011652,Rented or living rent free: Private rented or living rent free,37,32,26,8,18,1,5,5,0,0,0,1,4
S01011653,All HRPs aged 16 and over,340,211,167,29,138,22,22,129,91,6,7,20,5
S01011653,Owned: Total,196,125,102,11,91,17,6,71,66,0,0,3,2
S01011653,Owned: Owned outright,73,23,16,3,13,6,1,50,47,0,0,2,1
S01011653,Owned: Owned with a mortgage or loan or shared ownership,123,102,86,8,78,11,5,21,19,0,0,1,1
S01011653,Rented or living rent free: Total,144,86,65,18,47,5,16,58,25,6,7,17,3
S01011653,Rented or living rent free: Social rented,113,62,48,16,32,4,10,51,23,5,5,15,3
S01011653,Rented or living rent free: Private rented or living rent free,31,24,17,2,15,1,6,7,2,1,2,2,0
S01011654,All HRPs aged 16 and over,521,294,215,30,185,40,39,227,165,6,20,31,5
S01011654,Owned: Total,223,145,114,11,103,29,2,78,71,1,2,3,1
S01011654,Owned: Owned outright,88,24,16,4,12,8,0,64,62,0,0,2,0
S01011654,Owned: Owned with a mortgage or loan or shared ownership,135,121,98,7,91,21,2,14,9,1,2,1,1
S01011654,Rented or living rent free: Total,298,149,101,19,82,11,37,149,94,5,18,28,4
S01011654,Rented or living rent free: Social rented,206,79,42,12,30,3,34,127,80,5,12,27,3
S01011654,Rented or living rent free: Private rented or living rent free,92,70,59,7,52,8,3,22,14,0,6,1,1
S01011655,All HRPs aged 16 and over,471,264,202,53,149,20,42,207,138,5,14,37,13
S01011655,Owned: Total,162,112,96,19,77,14,2,50,45,1,0,4,0
S01011655,Owned: Owned outright,66,28,22,6,16,5,1,38,35,1,0,2,0
S01011655,Owned: Owned with a mortgage or loan or shared ownership,96,84,74,13,61,9,1,12,10,0,0,2,0
S01011655,Rented or living rent free: Total,309,152,106,34,72,6,40,157,93,4,14,33,13
S01011655,Rented or living rent free: Social rented,236,102,65,20,45,4,33,134,85,4,6,28,11
S01011655,Rented or living rent free: Private rented or living rent free,73,50,41,14,27,2,7,23,8,0,8,5,2
S01011656,All HRPs aged 16 and over,287,174,127,26,101,7,40,113,52,7,18,28,8
S01011656,Owned: Total,83,59,54,5,49,1,4,24,17,2,0,4,1
S01011656,Owned: Owned outright,32,15,13,2,11,1,1,17,12,2,0,3,0
S01011656,Owned: Owned with a mortgage or loan or shared ownership,51,44,41,3,38,0,3,7,5,0,0,1,1
S01011656,Rented or living rent free: Total,204,115,73,21,52,6,36,89,35,5,18,24,7
S01011656,Rented or living rent free: Social rented,184,104,65,20,45,5,34,80,33,5,12,23,7
S01011656,Rented or living rent free: Private rented or living rent free,20,11,8,1,7,1,2,9,2,0,6,1,0
S01011657,All HRPs aged 16 and over,281,158,113,22,91,12,33,123,55,8,9,43,8
S01011657,Owned: Total,85,65,53,7,46,9,3,20,19,0,0,0,1
S01011657,Owned: Owned outright,25,11,8,3,5,1,2,14,13,0,0,0,1
S01011657,Owned: Owned with a mortgage or loan or shared ownership,60,54,45,4,41,8,1,6,6,0,0,0,0
S01011657,Rented or living rent free: Total,196,93,60,15,45,3,30,103,36,8,9,43,7
S01011657,Rented or living rent free: Social rented,160,68,39,11,28,3,26,92,34,6,7,40,5
S01011657,Rented or living rent free: Private rented or living rent free,36,25,21,4,17,0,4,11,2,2,2,3,2
S01011658,All HRPs aged 16 and over,304,190,138,17,121,27,25,114,75,3,3,28,5
S01011658,Owned: Total,174,116,89,5,84,21,6,58,46,2,1,9,0
S01011658,Owned: Owned outright,60,23,13,2,11,5,5,37,32,0,1,4,0
S01011658,Owned: Owned with a mortgage or loan or shared ownership,114,93,76,3,73,16,1,21,14,2,0,5,0
S01011658,Rented or living rent free: Total,130,74,49,12,37,6,19,56,29,1,2,19,5
S01011658,Rented or living rent free: Social rented,101,50,33,8,25,3,14,51,26,0,2,18,5
S01011658,Rented or living rent free: Private rented or living rent free,29,24,16,4,12,3,5,5,3,1,0,1,0
S01011659,All HRPs aged 16 and over,353,202,161,40,121,15,26,151,109,4,12,22,4
S01011659,Owned: Total,175,98,86,12,74,8,4,77,74,1,0,1,1
S01011659,Owned: Owned outright,83,23,17,4,13,4,2,60,58,1,0,0,1
S01011659,Owned: Owned with a mortgage or loan or shared ownership,92,75,69,8,61,4,2,17,16,0,0,1,0
S01011659,Rented or living rent free: Total,178,104,75,28,47,7,22,74,35,3,12,21,3
S01011659,Rented or living rent free: Social rented,156,89,67,27,40,3,19,67,31,3,11,20,2
S01011659,Rented or living rent free: Private rented or living rent free,22,15,8,1,7,4,3,7,4,0,1,1,1
S01011660,All HRPs aged 16 and over,379,260,220,28,192,30,10,119,106,2,3,8,0
S01011660,Owned: Total,302,208,181,22,159,22,5,94,89,0,3,2,0
S01011660,Owned: Owned outright,129,50,46,7,39,3,1,79,79,0,0,0,0
S01011660,Owned: Owned with a mortgage or loan or shared ownership,173,158,135,15,120,19,4,15,10,0,3,2,0
S01011660,Rented or living rent free: Total,77,52,39,6,33,8,5,25,17,2,0,6,0
S01011660,Rented or living rent free: Social rented,50,27,22,3,19,3,2,23,16,2,0,5,0
S01011660,Rented or living rent free: Private rented or living rent free,27,25,17,3,14,5,3,2,1,0,0,1,0
S01011661,All HRPs aged 16 and over,246,158,123,28,95,21,14,88,69,1,2,15,1
S01011661,Owned: Total,164,108,89,14,75,15,4,56,52,0,0,4,0
S01011661,Owned: Owned outright,68,26,22,5,17,4,0,42,39,0,0,3,0
S01011661,Owned: Owned with a mortgage or loan or shared ownership,96,82,67,9,58,11,4,14,13,0,0,1,0
S01011661,Rented or living rent free: Total,82,50,34,14,20,6,10,32,17,1,2,11,1
S01011661,Rented or living rent free: Social rented,64,37,27,11,16,2,8,27,15,1,1,10,0
S01011661,Rented or living rent free: Private rented or living rent free,18,13,7,3,4,4,2,5,2,0,1,1,1
S01011662,All HRPs aged 16 and over,237,198,168,15,153,29,1,39,30,0,1,5,3
S01011662,Owned: Total,218,182,153,9,144,29,0,36,29,0,0,4,3
S01011662,Owned: Owned outright,51,24,21,4,17,3,0,27,24,0,0,2,1
S01011662,Owned: Owned with a mortgage or loan or shared ownership,167,158,132,5,127,26,0,9,5,0,0,2,2
S01011662,Rented or living rent free: Total,19,16,15,6,9,0,1,3,1,0,1,1,0
S01011662,Rented or living rent free: Social rented,4,3,2,0,2,0,1,1,0,0,1,0,0
S01011662,Rented or living rent free: Private rented or living rent free,15,13,13,6,7,0,0,2,1,0,0,1,0
S01011663,All HRPs aged 16 and over,428,296,215,45,170,20,61,132,51,2,18,45,16
S01011663,Owned: Total,134,108,96,17,79,9,3,26,22,0,1,2,1
S01011663,Owned: Owned outright,23,11,10,2,8,1,0,12,10,0,1,1,0
S01011663,Owned: Owned with a mortgage or loan or shared ownership,111,97,86,15,71,8,3,14,12,0,0,1,1
S01011663,Rented or living rent free: Total,294,188,119,28,91,11,58,106,29,2,17,43,15
S01011663,Rented or living rent free: Social rented,256,160,103,25,78,7,50,96,27,2,13,41,13
S01011663,Rented or living rent free: Private rented or living rent free,38,28,16,3,13,4,8,10,2,0,4,2,2
S01011664,All HRPs aged 16 and over,408,214,178,37,141,21,15,194,124,1,12,43,14
S01011664,Owned: Total,212,135,115,17,98,17,3,77,67,1,1,6,2
S01011664,Owned: Owned outright,62,18,16,2,14,1,1,44,39,1,0,4,0
S01011664,Owned: Owned with a mortgage or loan or shared ownership,150,117,99,15,84,16,2,33,28,0,1,2,2
S01011664,Rented or living rent free: Total,196,79,63,20,43,4,12,117,57,0,11,37,12
S01011664,Rented or living rent free: Social rented,177,70,55,18,37,4,11,107,52,0,9,36,10
S01011664,Rented or living rent free: Private rented or living rent free,19,9,8,2,6,0,1,10,5,0,2,1,2
S01011665,All HRPs aged 16 and over,428,232,192,40,152,14,26,196,126,7,18,36,9
S01011665,Owned: Total,150,111,96,10,86,9,6,39,34,3,0,2,0
S01011665,Owned: Owned outright,43,13,10,4,6,1,2,30,28,0,0,2,0
S01011665,Owned: Owned with a mortgage or loan or shared ownership,107,98,86,6,80,8,4,9,6,3,0,0,0
S01011665,Rented or living rent free: Total,278,121,96,30,66,5,20,157,92,4,18,34,9
S01011665,Rented or living rent free: Social rented,229,95,76,27,49,5,14,134,83,4,13,27,7
S01011665,Rented or living rent free: Private rented or living rent free,49,26,20,3,17,0,6,23,9,0,5,7,2
S01011666,All HRPs aged 16 and over,454,219,167,37,130,12,40,235,145,12,11,49,18
S01011666,Owned: Total,173,94,82,15,67,8,4,79,62,3,0,10,4
S01011666,Owned: Owned outright,85,26,22,9,13,2,2,59,50,3,0,4,2
S01011666,Owned: Owned with a mortgage or loan or shared ownership,88,68,60,6,54,6,2,20,12,0,0,6,2
S01011666,Rented or living rent free: Total,281,125,85,22,63,4,36,156,83,9,11,39,14
S01011666,Rented or living rent free: Social rented,252,112,75,21,54,4,33,140,76,9,8,36,11
S01011666,Rented or living rent free: Private rented or living rent free,29,13,10,1,9,0,3,16,7,0,3,3,3
S01011667,All HRPs aged 16 and over,375,220,168,23,145,30,22,155,92,0,10,40,13
S01011667,Owned: Total,184,123,98,10,88,22,3,61,53,0,2,4,2
S01011667,Owned: Owned outright,70,24,15,4,11,8,1,46,40,0,1,3,2
S01011667,Owned: Owned with a mortgage or loan or shared ownership,114,99,83,6,77,14,2,15,13,0,1,1,0
S01011667,Rented or living rent free: Total,191,97,70,13,57,8,19,94,39,0,8,36,11
S01011667,Rented or living rent free: Social rented,150,71,50,10,40,5,16,79,33,0,7,29,10
S01011667,Rented or living rent free: Private rented or living rent free,41,26,20,3,17,3,3,15,6,0,1,7,1
S01011668,All HRPs aged 16 and over,429,266,216,56,160,12,38,163,74,5,21,46,17
S01011668,Owned: Total,166,118,104,13,91,10,4,48,35,1,2,7,3
S01011668,Owned: Owned outright,49,24,19,1,18,3,2,25,22,1,0,1,1
S01011668,Owned: Owned with a mortgage or loan or shared ownership,117,94,85,12,73,7,2,23,13,0,2,6,2
S01011668,Rented or living rent free: Total,263,148,112,43,69,2,34,115,39,4,19,39,14
S01011668,Rented or living rent free: Social rented,226,124,94,36,58,2,28,102,37,4,12,35,14
S01011668,Rented or living rent free: Private rented or living rent free,37,24,18,7,11,0,6,13,2,0,7,4,0
S01011669,All HRPs aged 16 and over,299,170,132,28,104,32,6,129,105,1,4,13,6
S01011669,Owned: Total,222,131,98,19,79,29,4,91,81,1,0,4,5
S01011669,Owned: Owned outright,114,41,30,10,20,10,1,73,65,0,0,4,4
S01011669,Owned: Owned with a mortgage or loan or shared ownership,108,90,68,9,59,19,3,18,16,1,0,0,1
S01011669,Rented or living rent free: Total,77,39,34,9,25,3,2,38,24,0,4,9,1
S01011669,Rented or living rent free: Social rented,40,14,13,5,8,1,0,26,17,0,3,5,1
S01011669,Rented or living rent free: Private rented or living rent free,37,25,21,4,17,2,2,12,7,0,1,4,0
S01011670,All HRPs aged 16 and over,234,162,128,31,97,14,20,72,45,1,7,15,4
S01011670,Owned: Total,108,77,62,9,53,10,5,31,26,0,1,4,0
S01011670,Owned: Owned outright,34,10,6,1,5,3,1,24,20,0,1,3,0
S01011670,Owned: Owned with a mortgage or loan or shared ownership,74,67,56,8,48,7,4,7,6,0,0,1,0
S01011670,Rented or living rent free: Total,126,85,66,22,44,4,15,41,19,1,6,11,4
S01011670,Rented or living rent free: Social rented,99,69,52,16,36,3,14,30,16,1,4,6,3
S01011670,Rented or living rent free: Private rented or living rent free,27,16,14,6,8,1,1,11,3,0,2,5,1
S01011671,All HRPs aged 16 and over,316,183,148,18,130,26,9,133,105,4,6,9,9
S01011671,Owned: Total,231,143,118,13,105,22,3,88,80,2,0,3,3
S01011671,Owned: Owned outright,113,42,34,5,29,7,1,71,65,2,0,1,3
S01011671,Owned: Owned with a mortgage or loan or shared ownership,118,101,84,8,76,15,2,17,15,0,0,2,0
S01011671,Rented or living rent free: Total,85,40,30,5,25,4,6,45,25,2,6,6,6
S01011671,Rented or living rent free: Social rented,50,15,11,4,7,1,3,35,22,0,5,5,3
S01011671,Rented or living rent free: Private rented or living rent free,35,25,19,1,18,3,3,10,3,2,1,1,3
S01011672,All HRPs aged 16 and over,275,153,120,17,103,15,18,122,96,2,5,15,4
S01011672,Owned: Total,149,88,76,4,72,12,0,61,58,2,0,1,0
S01011672,Owned: Owned outright,78,25,20,3,17,5,0,53,51,1,0,1,0
S01011672,Owned: Owned with a mortgage or loan or shared ownership,71,63,56,1,55,7,0,8,7,1,0,0,0
S01011672,Rented or living rent free: Total,126,65,44,13,31,3,18,61,38,0,5,14,4
S01011672,Rented or living rent free: Social rented,104,50,36,12,24,2,12,54,37,0,1,13,3
S01011672,Rented or living rent free: Private rented or living rent free,22,15,8,1,7,1,6,7,1,0,4,1,1
S01011673,All HRPs aged 16 and over,275,173,146,32,114,15,12,102,67,6,9,18,2
S01011673,Owned: Total,149,103,92,10,82,9,2,46,43,0,1,1,1
S01011673,Owned: Owned outright,60,26,22,6,16,3,1,34,32,0,1,0,1
S01011673,Owned: Owned with a mortgage or loan or shared ownership,89,77,70,4,66,6,1,12,11,0,0,1,0
S01011673,Rented or living rent free: Total,126,70,54,22,32,6,10,56,24,6,8,17,1
S01011673,Rented or living rent free: Social rented,108,58,46,16,30,2,10,50,22,4,8,15,1
S01011673,Rented or living rent free: Private rented or living rent free,18,12,8,6,2,4,0,6,2,2,0,2,0
S01011674,All HRPs aged 16 and over,434,291,254,38,216,18,19,143,103,2,6,24,8
S01011674,Owned: Total,310,226,209,20,189,16,1,84,69,2,1,8,4
S01011674,Owned: Owned outright,98,34,31,7,24,3,0,64,55,1,0,6,2
S01011674,Owned: Owned with a mortgage or loan or shared ownership,212,192,178,13,165,13,1,20,14,1,1,2,2
S01011674,Rented or living rent free: Total,124,65,45,18,27,2,18,59,34,0,5,16,4
S01011674,Rented or living rent free: Social rented,96,44,32,16,16,1,11,52,31,0,5,13,3
S01011674,Rented or living rent free: Private rented or living rent free,28,21,13,2,11,1,7,7,3,0,0,3,1
S01011675,All HRPs aged 16 and over,387,225,188,31,157,20,17,162,101,1,15,40,5
S01011675,Owned: Total,230,153,136,17,119,15,2,77,64,0,2,9,2
S01011675,Owned: Owned outright,78,32,26,5,21,5,1,46,43,0,1,1,1
S01011675,Owned: Owned with a mortgage or loan or shared ownership,152,121,110,12,98,10,1,31,21,0,1,8,1
S01011675,Rented or living rent free: Total,157,72,52,14,38,5,15,85,37,1,13,31,3
S01011675,Rented or living rent free: Social rented,133,61,44,12,32,4,13,72,34,1,7,27,3
S01011675,Rented or living rent free: Private rented or living rent free,24,11,8,2,6,1,2,13,3,0,6,4,0
S01011676,All HRPs aged 16 and over,311,179,150,30,120,9,20,132,86,1,15,27,3
S01011676,Owned: Total,142,95,89,10,79,5,1,47,41,0,2,4,0
S01011676,Owned: Owned outright,50,15,15,2,13,0,0,35,32,0,0,3,0
S01011676,Owned: Owned with a mortgage or loan or shared ownership,92,80,74,8,66,5,1,12,9,0,2,1,0
S01011676,Rented or living rent free: Total,169,84,61,20,41,4,19,85,45,1,13,23,3
S01011676,Rented or living rent free: Social rented,153,77,59,20,39,3,15,76,45,1,6,21,3
S01011676,Rented or living rent free: Private rented or living rent free,16,7,2,0,2,1,4,9,0,0,7,2,0
S01011677,All HRPs aged 16 and over,258,200,157,20,137,20,23,58,21,6,3,25,3
S01011677,Owned: Total,147,131,112,11,101,18,1,16,11,1,1,3,0
S01011677,Owned: Owned outright,22,15,12,2,10,2,1,7,6,0,1,0,0
S01011677,Owned: Owned with a mortgage or loan or shared ownership,125,116,100,9,91,16,0,9,5,1,0,3,0
S01011677,Rented or living rent free: Total,111,69,45,9,36,2,22,42,10,5,2,22,3
S01011677,Rented or living rent free: Social rented,37,15,13,3,10,0,2,22,8,0,0,12,2
S01011677,Rented or living rent free: Private rented or living rent free,74,54,32,6,26,2,20,20,2,5,2,10,1
S01011678,All HRPs aged 16 and over,222,119,91,31,60,12,16,103,63,3,3,22,12
S01011678,Owned: Total,92,57,46,9,37,11,0,35,30,0,0,4,1
S01011678,Owned: Owned outright,52,22,17,7,10,5,0,30,27,0,0,2,1
S01011678,Owned: Owned with a mortgage or loan or shared ownership,40,35,29,2,27,6,0,5,3,0,0,2,0
S01011678,Rented or living rent free: Total,130,62,45,22,23,1,16,68,33,3,3,18,11
S01011678,Rented or living rent free: Social rented,114,51,39,18,21,0,12,63,31,3,2,17,10
S01011678,Rented or living rent free: Private rented or living rent free,16,11,6,4,2,1,4,5,2,0,1,1,1
S01011679,All HRPs aged 16 and over,204,177,157,10,147,15,5,27,19,0,2,4,2
S01011679,Owned: Total,179,160,145,9,136,13,2,19,18,0,0,1,0
S01011679,Owned: Owned outright,33,16,12,5,7,3,1,17,17,0,0,0,0
S01011679,Owned: Owned with a mortgage or loan or shared ownership,146,144,133,4,129,10,1,2,1,0,0,1,0
S01011679,Rented or living rent free: Total,25,17,12,1,11,2,3,8,1,0,2,3,2
S01011679,Rented or living rent free: Social rented,8,4,2,0,2,1,1,4,1,0,1,1,1
S01011679,Rented or living rent free: Private rented or living rent free,17,13,10,1,9,1,2,4,0,0,1,2,1
S01011680,All HRPs aged 16 and over,454,251,204,33,171,25,22,203,147,3,12,35,6
S01011680,Owned: Total,181,121,98,10,88,19,4,60,57,0,0,2,1
S01011680,Owned: Owned outright,76,35,26,5,21,6,3,41,39,0,0,1,1
S01011680,Owned: Owned with a mortgage or loan or shared ownership,105,86,72,5,67,13,1,19,18,0,0,1,0
S01011680,Rented or living rent free: Total,273,130,106,23,83,6,18,143,90,3,12,33,5
S01011680,Rented or living rent free: Social rented,253,121,99,21,78,5,17,132,81,3,12,31,5
S01011680,Rented or living rent free: Private rented or living rent free,20,9,7,2,5,1,1,11,9,0,0,2,0
S01011681,All HRPs aged 16 and over,345,231,192,33,159,25,14,114,87,0,5,17,5
S01011681,Owned: Total,199,147,124,13,111,22,1,52,46,0,1,3,2
S01011681,Owned: Owned outright,66,30,24,6,18,5,1,36,34,0,0,0,2
S01011681,Owned: Owned with a mortgage or loan or shared ownership,133,117,100,7,93,17,0,16,12,0,1,3,0
S01011681,Rented or living rent free: Total,146,84,68,20,48,3,13,62,41,0,4,14,3
S01011681,Rented or living rent free: Social rented,130,71,56,17,39,3,12,59,39,0,4,13,3
S01011681,Rented or living rent free: Private rented or living rent free,16,13,12,3,9,0,1,3,2,0,0,1,0
S01011682,All HRPs aged 16 and over,182,130,82,7,75,40,8,52,43,1,2,4,2
S01011682,Owned: Total,159,113,71,6,65,38,4,46,41,1,1,2,1
S01011682,Owned: Owned outright,74,40,19,3,16,20,1,34,33,0,1,0,0
S01011682,Owned: Owned with a mortgage or loan or shared ownership,85,73,52,3,49,18,3,12,8,1,0,2,1
S01011682,Rented or living rent free: Total,23,17,11,1,10,2,4,6,2,0,1,2,1
S01011682,Rented or living rent free: Social rented,3,2,2,1,1,0,0,1,0,0,0,1,0
S01011682,Rented or living rent free: Private rented or living rent free,20,15,9,0,9,2,4,5,2,0,1,1,1
S01011683,All HRPs aged 16 and over,306,205,155,21,134,34,16,101,61,1,11,20,8
S01011683,Owned: Total,193,144,114,9,105,27,3,49,43,1,1,3,1
S01011683,Owned: Owned outright,74,38,27,5,22,10,1,36,34,0,0,2,0
S01011683,Owned: Owned with a mortgage or loan or shared ownership,119,106,87,4,83,17,2,13,9,1,1,1,1
S01011683,Rented or living rent free: Total,113,61,41,12,29,7,13,52,18,0,10,17,7
S01011683,Rented or living rent free: Social rented,84,42,31,11,20,4,7,42,15,0,5,15,7
S01011683,Rented or living rent free: Private rented or living rent free,29,19,10,1,9,3,6,10,3,0,5,2,0
S01011684,All HRPs aged 16 and over,234,142,119,23,96,18,5,92,80,0,3,6,3
S01011684,Owned: Total,171,110,91,11,80,16,3,61,59,0,0,1,1
S01011684,Owned: Owned outright,72,26,20,4,16,5,1,46,46,0,0,0,0
S01011684,Owned: Owned with a mortgage or loan or shared ownership,99,84,71,7,64,11,2,15,13,0,0,1,1
S01011684,Rented or living rent free: Total,63,32,28,12,16,2,2,31,21,0,3,5,2
S01011684,Rented or living rent free: Social rented,49,22,18,9,9,2,2,27,19,0,2,4,2
S01011684,Rented or living rent free: Private rented or living rent free,14,10,10,3,7,0,0,4,2,0,1,1,0
S01011685,All HRPs aged 16 and over,279,242,192,15,177,43,7,37,28,0,3,2,4
S01011685,Owned: Total,253,225,184,13,171,40,1,28,25,0,0,1,2
S01011685,Owned: Owned outright,56,32,19,4,15,13,0,24,23,0,0,1,0
S01011685,Owned: Owned with a mortgage or loan or shared ownership,197,193,165,9,156,27,1,4,2,0,0,0,2
S01011685,Rented or living rent free: Total,26,17,8,2,6,3,6,9,3,0,3,1,2
S01011685,Rented or living rent free: Social rented,9,5,3,1,2,0,2,4,0,0,3,1,0
S01011685,Rented or living rent free: Private rented or living rent free,17,12,5,1,4,3,4,5,3,0,0,0,2
S01011686,All HRPs aged 16 and over,344,263,225,21,204,36,2,81,74,1,2,3,1
S01011686,Owned: Total,309,240,205,21,184,33,2,69,64,1,1,2,1
S01011686,Owned: Owned outright,127,71,56,13,43,14,1,56,53,1,1,0,1
S01011686,Owned: Owned with a mortgage or loan or shared ownership,182,169,149,8,141,19,1,13,11,0,0,2,0
S01011686,Rented or living rent free: Total,35,23,20,0,20,3,0,12,10,0,1,1,0
S01011686,Rented or living rent free: Social rented,11,4,4,0,4,0,0,7,6,0,0,1,0
S01011686,Rented or living rent free: Private rented or living rent free,24,19,16,0,16,3,0,5,4,0,1,0,0
S01011687,All HRPs aged 16 and over,386,236,198,27,171,20,18,150,113,1,12,19,5
S01011687,Owned: Total,213,166,148,13,135,16,2,47,44,0,2,1,0
S01011687,Owned: Owned outright,66,28,24,2,22,4,0,38,36,0,1,1,0
S01011687,Owned: Owned with a mortgage or loan or shared ownership,147,138,124,11,113,12,2,9,8,0,1,0,0
S01011687,Rented or living rent free: Total,173,70,50,14,36,4,16,103,69,1,10,18,5
S01011687,Rented or living rent free: Social rented,149,53,40,9,31,2,11,96,64,1,9,17,5
S01011687,Rented or living rent free: Private rented or living rent free,24,17,10,5,5,2,5,7,5,0,1,1,0
S01011688,All HRPs aged 16 and over,307,242,190,20,170,44,8,65,46,4,3,10,2
S01011688,Owned: Total,227,192,152,11,141,40,0,35,31,0,1,2,1
S01011688,Owned: Owned outright,65,36,23,3,20,13,0,29,25,0,1,2,1
S01011688,Owned: Owned with a mortgage or loan or shared ownership,162,156,129,8,121,27,0,6,6,0,0,0,0
S01011688,Rented or living rent free: Total,80,50,38,9,29,4,8,30,15,4,2,8,1
S01011688,Rented or living rent free: Social rented,56,32,23,8,15,2,7,24,14,1,2,7,0
S01011688,Rented or living rent free: Private rented or living rent free,24,18,15,1,14,2,1,6,1,3,0,1,1
S01011689,All HRPs aged 16 and over,248,200,157,14,143,39,4,48,38,3,3,3,1
S01011689,Owned: Total,225,186,147,12,135,36,3,39,35,1,1,2,0
S01011689,Owned: Owned outright,77,47,30,7,23,15,2,30,27,1,1,1,0
S01011689,Owned: Owned with a mortgage or loan or shared ownership,148,139,117,5,112,21,1,9,8,0,0,1,0
S01011689,Rented or living rent free: Total,23,14,10,2,8,3,1,9,3,2,2,1,1
S01011689,Rented or living rent free: Social rented,11,6,4,2,2,1,1,5,1,1,2,0,1
S01011689,Rented or living rent free: Private rented or living rent free,12,8,6,0,6,2,0,4,2,1,0,1,0
S01011690,All HRPs aged 16 and over,396,305,234,20,214,54,17,91,51,3,9,21,7
S01011690,Owned: Total,294,253,195,10,185,51,7,41,33,1,3,3,1
S01011690,Owned: Owned outright,63,36,21,4,17,11,4,27,24,0,1,1,1
S01011690,Owned: Owned with a mortgage or loan or shared ownership,231,217,174,6,168,40,3,14,9,1,2,2,0
S01011690,Rented or living rent free: Total,102,52,39,10,29,3,10,50,18,2,6,18,6
S01011690,Rented or living rent free: Social rented,83,40,29,9,20,1,10,43,18,0,5,15,5
S01011690,Rented or living rent free: Private rented or living rent free,19,12,10,1,9,2,0,7,0,2,1,3,1
S01011691,All HRPs aged 16 and over,224,172,151,14,137,19,2,52,42,1,4,4,1
S01011691,Owned: Total,180,146,133,8,125,13,0,34,31,0,0,2,1
S01011691,Owned: Owned outright,42,14,11,0,11,3,0,28,26,0,0,1,1
S01011691,Owned: Owned with a mortgage or loan or shared ownership,138,132,122,8,114,10,0,6,5,0,0,1,0
S01011691,Rented or living rent free: Total,44,26,18,6,12,6,2,18,11,1,4,2,0
S01011691,Rented or living rent free: Social rented,23,10,4,1,3,5,1,13,10,0,2,1,0
S01011691,Rented or living rent free: Private rented or living rent free,21,16,14,5,9,1,1,5,1,1,2,1,0
S01011692,All HRPs aged 16 and over,455,256,228,44,184,15,13,199,140,5,14,33,7
S01011692,Owned: Total,220,144,135,15,120,9,0,76,66,5,0,4,1
S01011692,Owned: Owned outright,81,36,34,10,24,2,0,45,42,2,0,1,0
S01011692,Owned: Owned with a mortgage or loan or shared ownership,139,108,101,5,96,7,0,31,24,3,0,3,1
S01011692,Rented or living rent free: Total,235,112,93,29,64,6,13,123,74,0,14,29,6
S01011692,Rented or living rent free: Social rented,211,93,78,24,54,4,11,118,72,0,13,27,6
S01011692,Rented or living rent free: Private rented or living rent free,24,19,15,5,10,2,2,5,2,0,1,2,0
S01011693,All HRPs aged 16 and over,367,261,223,28,195,31,7,106,82,6,3,13,2
S01011693,Owned: Total,274,215,186,14,172,28,1,59,53,1,1,3,1
S01011693,Owned: Owned outright,86,41,36,4,32,4,1,45,43,1,0,1,0
S01011693,Owned: Owned with a mortgage or loan or shared ownership,188,174,150,10,140,24,0,14,10,0,1,2,1
S01011693,Rented or living rent free: Total,93,46,37,14,23,3,6,47,29,5,2,10,1
S01011693,Rented or living rent free: Social rented,49,14,9,5,4,1,4,35,21,4,0,10,0
S01011693,Rented or living rent free: Private rented or living rent free,44,32,28,9,19,2,2,12,8,1,2,0,1
S01011694,All HRPs aged 16 and over,200,172,144,11,133,19,9,28,17,1,3,5,2
S01011694,Owned: Total,163,146,129,6,123,15,2,17,11,1,2,1,2
S01011694,Owned: Owned outright,22,10,8,2,6,2,0,12,8,0,1,1,2
S01011694,Owned: Owned with a mortgage or loan or shared ownership,141,136,121,4,117,13,2,5,3,1,1,0,0
S01011694,Rented or living rent free: Total,37,26,15,5,10,4,7,11,6,0,1,4,0
S01011694,Rented or living rent free: Social rented,24,16,8,2,6,2,6,8,4,0,0,4,0
S01011694,Rented or living rent free: Private rented or living rent free,13,10,7,3,4,2,1,3,2,0,1,0,0
S01011695,All HRPs aged 16 and over,333,280,231,28,203,46,3,53,43,1,1,7,1
S01011695,Owned: Total,295,254,208,19,189,44,2,41,36,1,1,2,1
S01011695,Owned: Owned outright,66,36,27,6,21,9,0,30,26,1,0,2,1
S01011695,Owned: Owned with a mortgage or loan or shared ownership,229,218,181,13,168,35,2,11,10,0,1,0,0
S01011695,Rented or living rent free: Total,38,26,23,9,14,2,1,12,7,0,0,5,0
S01011695,Rented or living rent free: Social rented,17,7,6,0,6,0,1,10,7,0,0,3,0
S01011695,Rented or living rent free: Private rented or living rent free,21,19,17,9,8,2,0,2,0,0,0,2,0
S01011696,All HRPs aged 16 and over,351,329,274,14,260,49,6,22,15,2,0,2,3
S01011696,Owned: Total,332,312,260,12,248,46,6,20,15,2,0,2,1
S01011696,Owned: Owned outright,57,46,32,2,30,11,3,11,10,0,0,1,0
S01011696,Owned: Owned with a mortgage or loan or shared ownership,275,266,228,10,218,35,3,9,5,2,0,1,1
S01011696,Rented or living rent free: Total,19,17,14,2,12,3,0,2,0,0,0,0,2
S01011696,Rented or living rent free: Social rented,4,3,3,0,3,0,0,1,0,0,0,0,1
S01011696,Rented or living rent free: Private rented or living rent free,15,14,11,2,9,3,0,1,0,0,0,0,1
S01011697,All HRPs aged 16 and over,398,312,257,25,232,48,7,86,62,0,7,13,4
S01011697,Owned: Total,309,261,215,15,200,43,3,48,43,0,1,2,2
S01011697,Owned: Owned outright,74,29,22,4,18,6,1,45,41,0,1,2,1
S01011697,Owned: Owned with a mortgage or loan or shared ownership,235,232,193,11,182,37,2,3,2,0,0,0,1
S01011697,Rented or living rent free: Total,89,51,42,10,32,5,4,38,19,0,6,11,2
S01011697,Rented or living rent free: Social rented,63,29,25,7,18,2,2,34,18,0,4,10,2
S01011697,Rented or living rent free: Private rented or living rent free,26,22,17,3,14,3,2,4,1,0,2,1,0
S01011698,All HRPs aged 16 and over,271,165,128,26,102,24,13,106,80,3,4,17,2
S01011698,Owned: Total,189,128,102,14,88,20,6,61,52,2,0,5,2
S01011698,Owned: Owned outright,74,27,17,5,12,9,1,47,42,2,0,1,2
S01011698,Owned: Owned with a mortgage or loan or shared ownership,115,101,85,9,76,11,5,14,10,0,0,4,0
S01011698,Rented or living rent free: Total,82,37,26,12,14,4,7,45,28,1,4,12,0
S01011698,Rented or living rent free: Social rented,71,30,22,11,11,3,5,41,25,1,3,12,0
S01011698,Rented or living rent free: Private rented or living rent free,11,7,4,1,3,1,2,4,3,0,1,0,0
S01011699,All HRPs aged 16 and over,387,260,210,30,180,44,6,127,100,0,5,15,7
S01011699,Owned: Total,335,235,192,23,169,40,3,100,92,0,1,5,2
S01011699,Owned: Owned outright,143,61,49,13,36,12,0,82,79,0,0,1,2
S01011699,Owned: Owned with a mortgage or loan or shared ownership,192,174,143,10,133,28,3,18,13,0,1,4,0
S01011699,Rented or living rent free: Total,52,25,18,7,11,4,3,27,8,0,4,10,5
S01011699,Rented or living rent free: Social rented,20,8,5,2,3,2,1,12,4,0,2,3,3
S01011699,Rented or living rent free: Private rented or living rent free,32,17,13,5,8,2,2,15,4,0,2,7,2
S01011700,All HRPs aged 16 and over,354,200,166,24,142,24,10,154,128,0,5,16,5
S01011700,Owned: Total,257,154,129,12,117,24,1,103,98,0,1,1,3
S01011700,Owned: Owned outright,132,40,34,6,28,6,0,92,87,0,1,1,3
S01011700,Owned: Owned with a mortgage or loan or shared ownership,125,114,95,6,89,18,1,11,11,0,0,0,0
S01011700,Rented or living rent free: Total,97,46,37,12,25,0,9,51,30,0,4,15,2
S01011700,Rented or living rent free: Social rented,77,31,27,9,18,0,4,46,28,0,4,13,1
S01011700,Rented or living rent free: Private rented or living rent free,20,15,10,3,7,0,5,5,2,0,0,2,1
S01011701,All HRPs aged 16 and over,444,318,257,37,220,54,7,126,105,1,6,6,8
S01011701,Owned: Total,367,266,212,27,185,49,5,101,92,0,1,4,4
S01011701,Owned: Owned outright,162,73,59,15,44,11,3,89,84,0,0,3,2
S01011701,Owned: Owned with a mortgage or loan or shared ownership,205,193,153,12,141,38,2,12,8,0,1,1,2
S01011701,Rented or living rent free: Total,77,52,45,10,35,5,2,25,13,1,5,2,4
S01011701,Rented or living rent free: Social rented,29,16,15,4,11,1,0,13,6,1,3,1,2
S01011701,Rented or living rent free: Private rented or living rent free,48,36,30,6,24,4,2,12,7,0,2,1,2
S01011702,All HRPs aged 16 and over,335,192,160,21,139,26,6,143,124,0,2,17,0
S01011702,Owned: Total,249,153,129,14,115,22,2,96,91,0,0,5,0
S01011702,Owned: Owned outright,123,42,33,6,27,8,1,81,77,0,0,4,0
S01011702,Owned: Owned with a mortgage or loan or shared ownership,126,111,96,8,88,14,1,15,14,0,0,1,0
S01011702,Rented or living rent free: Total,86,39,31,7,24,4,4,47,33,0,2,12,0
S01011702,Rented or living rent free: Social rented,68,29,23,6,17,3,3,39,26,0,2,11,0
S01011702,Rented or living rent free: Private rented or living rent free,18,10,8,1,7,1,1,8,7,0,0,1,0
S01011703,All HRPs aged 16 and over,255,181,127,17,110,48,6,74,66,1,1,3,3
S01011703,Owned: Total,219,154,109,11,98,42,3,65,62,0,1,1,1
S01011703,Owned: Owned outright,114,54,38,10,28,14,2,60,59,0,0,1,0
S01011703,Owned: Owned with a mortgage or loan or shared ownership,105,100,71,1,70,28,1,5,3,0,1,0,1
S01011703,Rented or living rent free: Total,36,27,18,6,12,6,3,9,4,1,0,2,2
S01011703,Rented or living rent free: Social rented,12,9,4,2,2,5,0,3,1,0,0,1,1
S01011703,Rented or living rent free: Private rented or living rent free,24,18,14,4,10,1,3,6,3,1,0,1,1
S01011704,All HRPs aged 16 and over,274,208,174,12,162,30,4,66,49,0,1,15,1
S01011704,Owned: Total,245,191,160,11,149,30,1,54,45,0,1,8,0
S01011704,Owned: Owned outright,69,23,18,4,14,5,0,46,38,0,1,7,0
S01011704,Owned: Owned with a mortgage or loan or shared ownership,176,168,142,7,135,25,1,8,7,0,0,1,0
S01011704,Rented or living rent free: Total,29,17,14,1,13,0,3,12,4,0,0,7,1
S01011704,Rented or living rent free: Social rented,17,8,7,0,7,0,1,9,2,0,0,6,1
S01011704,Rented or living rent free: Private rented or living rent free,12,9,7,1,6,0,2,3,2,0,0,1,0
S01011705,All HRPs aged 16 and over,318,206,159,25,134,30,17,112,69,6,18,18,1
S01011705,Owned: Total,193,139,119,11,108,18,2,54,46,0,3,4,1
S01011705,Owned: Owned outright,49,11,8,1,7,2,1,38,33,0,1,3,1
S01011705,Owned: Owned with a mortgage or loan or shared ownership,144,128,111,10,101,16,1,16,13,0,2,1,0
S01011705,Rented or living rent free: Total,125,67,40,14,26,12,15,58,23,6,15,14,0
S01011705,Rented or living rent free: Social rented,104,54,30,8,22,12,12,50,20,5,13,12,0
S01011705,Rented or living rent free: Private rented or living rent free,21,13,10,6,4,0,3,8,3,1,2,2,0
S01011706,All HRPs aged 16 and over,450,264,220,31,189,29,15,186,155,2,4,22,3
S01011706,Owned: Total,330,208,178,22,156,24,6,122,114,1,0,5,2
S01011706,Owned: Owned outright,154,52,45,11,34,3,4,102,96,0,0,5,1
S01011706,Owned: Owned with a mortgage or loan or shared ownership,176,156,133,11,122,21,2,20,18,1,0,0,1
S01011706,Rented or living rent free: Total,120,56,42,9,33,5,9,64,41,1,4,17,1
S01011706,Rented or living rent free: Social rented,81,34,24,6,18,2,8,47,30,0,2,15,0
S01011706,Rented or living rent free: Private rented or living rent free,39,22,18,3,15,3,1,17,11,1,2,2,1
S01011707,All HRPs aged 16 and over,283,184,156,26,130,26,2,99,91,3,0,4,1
S01011707,Owned: Total,262,172,147,25,122,24,1,90,86,2,0,2,0
S01011707,Owned: Owned outright,133,56,51,17,34,5,0,77,75,2,0,0,0
S01011707,Owned: Owned with a mortgage or loan or shared ownership,129,116,96,8,88,19,1,13,11,0,0,2,0
S01011707,Rented or living rent free: Total,21,12,9,1,8,2,1,9,5,1,0,2,1
S01011707,Rented or living rent free: Social rented,14,6,5,1,4,0,1,8,4,1,0,2,1
S01011707,Rented or living rent free: Private rented or living rent free,7,6,4,0,4,2,0,1,1,0,0,0,0
S01011708,All HRPs aged 16 and over,448,250,215,45,170,25,10,198,144,3,6,37,8
S01011708,Owned: Total,280,171,148,25,123,21,2,109,99,0,0,9,1
S01011708,Owned: Owned outright,136,47,40,13,27,6,1,89,84,0,0,4,1
S01011708,Owned: Owned with a mortgage or loan or shared ownership,144,124,108,12,96,15,1,20,15,0,0,5,0
S01011708,Rented or living rent free: Total,168,79,67,20,47,4,8,89,45,3,6,28,7
S01011708,Rented or living rent free: Social rented,130,52,43,17,26,2,7,78,39,2,5,25,7
S01011708,Rented or living rent free: Private rented or living rent free,38,27,24,3,21,2,1,11,6,1,1,3,0
S01011709,All HRPs aged 16 and over,370,249,203,36,167,34,12,121,101,4,1,13,2
S01011709,Owned: Total,286,202,168,22,146,28,6,84,74,1,1,6,2
S01011709,Owned: Owned outright,106,44,35,9,26,7,2,62,57,0,1,4,0
S01011709,Owned: Owned with a mortgage or loan or shared ownership,180,158,133,13,120,21,4,22,17,1,0,2,2
S01011709,Rented or living rent free: Total,84,47,35,14,21,6,6,37,27,3,0,7,0
S01011709,Rented or living rent free: Social rented,71,38,27,12,15,5,6,33,24,2,0,7,0
S01011709,Rented or living rent free: Private rented or living rent free,13,9,8,2,6,1,0,4,3,1,0,0,0
S01011710,All HRPs aged 16 and over,257,174,138,43,95,11,25,83,52,1,7,18,5
S01011710,Owned: Total,95,65,58,13,45,4,3,30,26,0,0,1,3
S01011710,Owned: Owned outright,33,12,7,2,5,2,3,21,18,0,0,1,2
S01011710,Owned: Owned with a mortgage or loan or shared ownership,62,53,51,11,40,2,0,9,8,0,0,0,1
S01011710,Rented or living rent free: Total,162,109,80,30,50,7,22,53,26,1,7,17,2
S01011710,Rented or living rent free: Social rented,153,103,76,28,48,7,20,50,24,1,6,17,2
S01011710,Rented or living rent free: Private rented or living rent free,9,6,4,2,2,0,2,3,2,0,1,0,0
S01011711,All HRPs aged 16 and over,321,168,138,32,106,15,15,153,98,2,10,33,10
S01011711,Owned: Total,115,76,66,9,57,8,2,39,34,0,1,4,0
S01011711,Owned: Owned outright,41,14,11,1,10,2,1,27,25,0,1,1,0
S01011711,Owned: Owned with a mortgage or loan or shared ownership,74,62,55,8,47,6,1,12,9,0,0,3,0
S01011711,Rented or living rent free: Total,206,92,72,23,49,7,13,114,64,2,9,29,10
S01011711,Rented or living rent free: Social rented,184,81,64,21,43,5,12,103,62,1,7,27,6
S01011711,Rented or living rent free: Private rented or living rent free,22,11,8,2,6,2,1,11,2,1,2,2,4
S01011712,All HRPs aged 16 and over,294,203,173,31,142,14,16,91,65,0,4,21,1
S01011712,Owned: Total,171,127,114,13,101,8,5,44,42,0,0,2,0
S01011712,Owned: Owned outright,56,23,22,7,15,0,1,33,32,0,0,1,0
S01011712,Owned: Owned with a mortgage or loan or shared ownership,115,104,92,6,86,8,4,11,10,0,0,1,0
S01011712,Rented or living rent free: Total,123,76,59,18,41,6,11,47,23,0,4,19,1
S01011712,Rented or living rent free: Social rented,94,49,36,13,23,3,10,45,22,0,4,18,1
S01011712,Rented or living rent free: Private rented or living rent free,29,27,23,5,18,3,1,2,1,0,0,1,0
S01011713,All HRPs aged 16 and over,389,245,205,21,184,32,8,144,126,0,3,15,0
S01011713,Owned: Total,304,214,184,20,164,26,4,90,85,0,3,2,0
S01011713,Owned: Owned outright,130,61,48,11,37,12,1,69,68,0,1,0,0
S01011713,Owned: Owned with a mortgage or loan or shared ownership,174,153,136,9,127,14,3,21,17,0,2,2,0
S01011713,Rented or living rent free: Total,85,31,21,1,20,6,4,54,41,0,0,13,0
S01011713,Rented or living rent free: Social rented,67,17,9,1,8,5,3,50,38,0,0,12,0
S01011713,Rented or living rent free: Private rented or living rent free,18,14,12,0,12,1,1,4,3,0,0,1,0
S01011714,All HRPs aged 16 and over,194,181,156,10,146,25,0,13,10,1,0,2,0
S01011714,Owned: Total,188,177,152,7,145,25,0,11,10,1,0,0,0
S01011714,Owned: Owned outright,22,15,14,2,12,1,0,7,7,0,0,0,0
S01011714,Owned: Owned with a mortgage or loan or shared ownership,166,162,138,5,133,24,0,4,3,1,0,0,0
S01011714,Rented or living rent free: Total,6,4,4,3,1,0,0,2,0,0,0,2,0
S01011714,Rented or living rent free: Social rented,5,3,3,2,1,0,0,2,0,0,0,2,0
S01011714,Rented or living rent free: Private rented or living rent free,1,1,1,1,0,0,0,0,0,0,0,0,0
S01011715,All HRPs aged 16 and over,297,166,137,29,108,13,16,131,74,1,15,34,7
S01011715,Owned: Total,146,94,81,13,68,12,1,52,44,1,0,6,1
S01011715,Owned: Owned outright,49,15,12,2,10,3,0,34,32,0,0,2,0
S01011715,Owned: Owned with a mortgage or loan or shared ownership,97,79,69,11,58,9,1,18,12,1,0,4,1
S01011715,Rented or living rent free: Total,151,72,56,16,40,1,15,79,30,0,15,28,6
S01011715,Rented or living rent free: Social rented,122,61,46,14,32,1,14,61,28,0,6,24,3
S01011715,Rented or living rent free: Private rented or living rent free,29,11,10,2,8,0,1,18,2,0,9,4,3
S01011716,All HRPs aged 16 and over,351,294,240,19,221,43,11,57,45,0,3,9,0
S01011716,Owned: Total,306,263,218,16,202,40,5,43,37,0,1,5,0
S01011716,Owned: Owned outright,65,34,23,1,22,7,4,31,28,0,0,3,0
S01011716,Owned: Owned with a mortgage or loan or shared ownership,241,229,195,15,180,33,1,12,9,0,1,2,0
S01011716,Rented or living rent free: Total,45,31,22,3,19,3,6,14,8,0,2,4,0
S01011716,Rented or living rent free: Social rented,19,8,4,0,4,2,2,11,8,0,0,3,0
S01011716,Rented or living rent free: Private rented or living rent free,26,23,18,3,15,1,4,3,0,0,2,1,0
S01011717,All HRPs aged 16 and over,294,196,163,19,144,29,4,98,86,0,3,8,1
S01011717,Owned: Total,280,187,158,19,139,26,3,93,83,0,2,7,1
S01011717,Owned: Owned outright,144,64,55,11,44,7,2,80,75,0,2,3,0
S01011717,Owned: Owned with a mortgage or loan or shared ownership,136,123,103,8,95,19,1,13,8,0,0,4,1
S01011717,Rented or living rent free: Total,14,9,5,0,5,3,1,5,3,0,1,1,0
S01011717,Rented or living rent free: Social rented,5,4,1,0,1,3,0,1,0,0,1,0,0
S01011717,Rented or living rent free: Private rented or living rent free,9,5,4,0,4,0,1,4,3,0,0,1,0
S01011718,All HRPs aged 16 and over,289,263,222,17,205,39,2,26,18,0,0,7,1
S01011718,Owned: Total,255,241,205,12,193,36,0,14,12,0,0,2,0
S01011718,Owned: Owned outright,36,27,21,4,17,6,0,9,9,0,0,0,0
S01011718,Owned: Owned with a mortgage or loan or shared ownership,219,214,184,8,176,30,0,5,3,0,0,2,0
S01011718,Rented or living rent free: Total,34,22,17,5,12,3,2,12,6,0,0,5,1
S01011718,Rented or living rent free: Social rented,12,4,2,1,1,1,1,8,2,0,0,5,1
S01011718,Rented or living rent free: Private rented or living rent free,22,18,15,4,11,2,1,4,4,0,0,0,0
S01011719,All HRPs aged 16 and over,224,205,168,10,158,37,0,19,16,0,0,1,2
S01011719,Owned: Total,209,192,157,8,149,35,0,17,15,0,0,0,2
S01011719,Owned: Owned outright,43,27,21,2,19,6,0,16,14,0,0,0,2
S01011719,Owned: Owned with a mortgage or loan or shared ownership,166,165,136,6,130,29,0,1,1,0,0,0,0
S01011719,Rented or living rent free: Total,15,13,11,2,9,2,0,2,1,0,0,1,0
S01011719,Rented or living rent free: Social rented,3,1,1,0,1,0,0,2,1,0,0,1,0
S01011719,Rented or living rent free: Private rented or living rent free,12,12,10,2,8,2,0,0,0,0,0,0,0
S01011720,All HRPs aged 16 and over,213,152,130,11,119,21,1,61,56,1,1,3,0
S01011720,Owned: Total,192,137,116,9,107,20,1,55,52,1,1,1,0
S01011720,Owned: Owned outright,99,50,40,6,34,9,1,49,46,1,1,1,0
S01011720,Owned: Owned with a mortgage or loan or shared ownership,93,87,76,3,73,11,0,6,6,0,0,0,0
S01011720,Rented or living rent free: Total,21,15,14,2,12,1,0,6,4,0,0,2,0
S01011720,Rented or living rent free: Social rented,5,4,4,0,4,0,0,1,1,0,0,0,0
S01011720,Rented or living rent free: Private rented or living rent free,16,11,10,2,8,1,0,5,3,0,0,2,0
S01011721,All HRPs aged 16 and over,305,187,167,22,145,12,8,118,99,3,2,12,2
S01011721,Owned: Total,247,165,147,15,132,11,7,82,77,1,0,3,1
S01011721,Owned: Owned outright,90,34,27,4,23,4,3,56,55,0,0,1,0
S01011721,Owned: Owned with a mortgage or loan or shared ownership,157,131,120,11,109,7,4,26,22,1,0,2,1
S01011721,Rented or living rent free: Total,58,22,20,7,13,1,1,36,22,2,2,9,1
S01011721,Rented or living rent free: Social rented,49,16,15,4,11,0,1,33,22,2,1,8,0
S01011721,Rented or living rent free: Private rented or living rent free,9,6,5,3,2,1,0,3,0,0,1,1,1
S01011722,All HRPs aged 16 and over,317,176,148,28,120,15,13,141,121,1,7,6,6
S01011722,Owned: Total,231,137,118,12,106,15,4,94,87,1,1,1,4
S01011722,Owned: Owned outright,104,36,34,6,28,1,1,68,67,0,0,0,1
S01011722,Owned: Owned with a mortgage or loan or shared ownership,127,101,84,6,78,14,3,26,20,1,1,1,3
S01011722,Rented or living rent free: Total,86,39,30,16,14,0,9,47,34,0,6,5,2
S01011722,Rented or living rent free: Social rented,60,22,20,11,9,0,2,38,31,0,1,5,1
S01011722,Rented or living rent free: Private rented or living rent free,26,17,10,5,5,0,7,9,3,0,5,0,1
S01011723,All HRPs aged 16 and over,397,265,233,31,202,27,5,132,108,3,2,11,8
S01011723,Owned: Total,300,217,194,22,172,22,1,83,76,2,1,3,1
S01011723,Owned: Owned outright,98,44,40,7,33,3,1,54,48,2,1,3,0
S01011723,Owned: Owned with a mortgage or loan or shared ownership,202,173,154,15,139,19,0,29,28,0,0,0,1
S01011723,Rented or living rent free: Total,97,48,39,9,30,5,4,49,32,1,1,8,7
S01011723,Rented or living rent free: Social rented,65,26,19,5,14,4,3,39,27,0,1,5,6
S01011723,Rented or living rent free: Private rented or living rent free,32,22,20,4,16,1,1,10,5,1,0,3,1
S01011724,All HRPs aged 16 and over,261,228,198,18,180,23,7,33,9,5,3,11,5
S01011724,Owned: Total,178,171,148,4,144,20,3,7,5,1,0,0,1
S01011724,Owned: Owned outright,31,25,21,1,20,3,1,6,4,1,0,0,1
S01011724,Owned: Owned with a mortgage or loan or shared ownership,147,146,127,3,124,17,2,1,1,0,0,0,0
S01011724,Rented or living rent free: Total,83,57,50,14,36,3,4,26,4,4,3,11,4
S01011724,Rented or living rent free: Social rented,63,38,34,10,24,1,3,25,4,3,3,11,4
S01011724,Rented or living rent free: Private rented or living rent free,20,19,16,4,12,2,1,1,0,1,0,0,0
S01011725,All HRPs aged 16 and over,219,200,166,10,156,33,1,19,15,1,0,3,0
S01011725,Owned: Total,205,191,160,9,151,31,0,14,12,0,0,2,0
S01011725,Owned: Owned outright,20,12,9,2,7,3,0,8,7,0,0,1,0
S01011725,Owned: Owned with a mortgage or loan or shared ownership,185,179,151,7,144,28,0,6,5,0,0,1,0
S01011725,Rented or living rent free: Total,14,9,6,1,5,2,1,5,3,1,0,1,0
S01011725,Rented or living rent free: Social rented,3,0,0,0,0,0,0,3,2,0,0,1,0
S01011725,Rented or living rent free: Private rented or living rent free,11,9,6,1,5,2,1,2,1,1,0,0,0
S01011726,All HRPs aged 16 and over,208,180,160,7,153,19,1,28,20,2,0,4,2
S01011726,Owned: Total,199,174,155,7,148,19,0,25,18,2,0,4,1
S01011726,Owned: Owned outright,34,20,19,2,17,1,0,14,12,0,0,1,1
S01011726,Owned: Owned with a mortgage or loan or shared ownership,165,154,136,5,131,18,0,11,6,2,0,3,0
S01011726,Rented or living rent free: Total,9,6,5,0,5,0,1,3,2,0,0,0,1
S01011726,Rented or living rent free: Social rented,3,1,1,0,1,0,0,2,1,0,0,0,1
S01011726,Rented or living rent free: Private rented or living rent free,6,5,4,0,4,0,1,1,1,0,0,0,0
S01011727,All HRPs aged 16 and over,261,237,184,10,174,51,2,24,19,0,1,3,1
S01011727,Owned: Total,234,211,166,6,160,43,2,23,19,0,0,3,1
S01011727,Owned: Owned outright,39,20,13,1,12,6,1,19,17,0,0,2,0
S01011727,Owned: Owned with a mortgage or loan or shared ownership,195,191,153,5,148,37,1,4,2,0,0,1,1
S01011727,Rented or living rent free: Total,27,26,18,4,14,8,0,1,0,0,1,0,0
S01011727,Rented or living rent free: Social rented,4,3,2,0,2,1,0,1,0,0,1,0,0
S01011727,Rented or living rent free: Private rented or living rent free,23,23,16,4,12,7,0,0,0,0,0,0,0
S01011728,All HRPs aged 16 and over,393,258,215,33,182,36,7,135,97,3,5,19,11
S01011728,Owned: Total,278,201,168,17,151,30,3,77,71,1,0,3,2
S01011728,Owned: Owned outright,101,43,36,7,29,6,1,58,55,0,0,1,2
S01011728,Owned: Owned with a mortgage or loan or shared ownership,177,158,132,10,122,24,2,19,16,1,0,2,0
S01011728,Rented or living rent free: Total,115,57,47,16,31,6,4,58,26,2,5,16,9
S01011728,Rented or living rent free: Social rented,73,28,23,6,17,2,3,45,23,2,0,13,7
S01011728,Rented or living rent free: Private rented or living rent free,42,29,24,10,14,4,1,13,3,0,5,3,2
S01011729,All HRPs aged 16 and over,302,179,144,29,115,15,20,123,85,2,6,27,3
S01011729,Owned: Total,161,109,100,10,90,8,1,52,46,1,0,5,0
S01011729,Owned: Owned outright,54,23,17,5,12,6,0,31,30,0,0,1,0
S01011729,Owned: Owned with a mortgage or loan or shared ownership,107,86,83,5,78,2,1,21,16,1,0,4,0
S01011729,Rented or living rent free: Total,141,70,44,19,25,7,19,71,39,1,6,22,3
S01011729,Rented or living rent free: Social rented,118,56,37,15,22,6,13,62,36,1,3,20,2
S01011729,Rented or living rent free: Private rented or living rent free,23,14,7,4,3,1,6,9,3,0,3,2,1
S01011730,All HRPs aged 16 and over,431,278,238,31,207,33,7,153,141,4,0,6,2
S01011730,Owned: Total,368,251,214,29,185,32,5,117,106,3,0,6,2
S01011730,Owned: Owned outright,174,82,66,19,47,13,3,92,87,2,0,2,1
S01011730,Owned: Owned with a mortgage or loan or shared ownership,194,169,148,10,138,19,2,25,19,1,0,4,1
S01011730,Rented or living rent free: Total,63,27,24,2,22,1,2,36,35,1,0,0,0
S01011730,Rented or living rent free: Social rented,35,4,3,0,3,1,0,31,30,1,0,0,0
S01011730,Rented or living rent free: Private rented or living rent free,28,23,21,2,19,0,2,5,5,0,0,0,0
S01011731,All HRPs aged 16 and over,352,221,186,37,149,28,7,131,115,0,4,10,2
S01011731,Owned: Total,283,190,159,27,132,26,5,93,91,0,0,2,0
S01011731,Owned: Owned outright,132,60,46,10,36,10,4,72,72,0,0,0,0
S01011731,Owned: Owned with a mortgage or loan or shared ownership,151,130,113,17,96,16,1,21,19,0,0,2,0
S01011731,Rented or living rent free: Total,69,31,27,10,17,2,2,38,24,0,4,8,2
S01011731,Rented or living rent free: Social rented,49,20,17,7,10,2,1,29,20,0,1,6,2
S01011731,Rented or living rent free: Private rented or living rent free,20,11,10,3,7,0,1,9,4,0,3,2,0
S01011732,All HRPs aged 16 and over,299,223,181,17,164,38,4,76,69,0,0,7,0
S01011732,Owned: Total,289,215,175,17,158,37,3,74,68,0,0,6,0
S01011732,Owned: Owned outright,136,70,55,10,45,12,3,66,62,0,0,4,0
S01011732,Owned: Owned with a mortgage or loan or shared ownership,153,145,120,7,113,25,0,8,6,0,0,2,0
S01011732,Rented or living rent free: Total,10,8,6,0,6,1,1,2,1,0,0,1,0
S01011732,Rented or living rent free: Social rented,5,3,1,0,1,1,1,2,1,0,0,1,0
S01011732,Rented or living rent free: Private rented or living rent free,5,5,5,0,5,0,0,0,0,0,0,0,0
S01011733,All HRPs aged 16 and over,352,217,183,31,152,26,8,135,114,1,3,14,3
S01011733,Owned: Total,281,185,162,22,140,22,1,96,90,0,1,2,3
S01011733,Owned: Owned outright,116,43,35,9,26,8,0,73,71,0,1,0,1
S01011733,Owned: Owned with a mortgage or loan or shared ownership,165,142,127,13,114,14,1,23,19,0,0,2,2
S01011733,Rented or living rent free: Total,71,32,21,9,12,4,7,39,24,1,2,12,0
S01011733,Rented or living rent free: Social rented,44,15,12,7,5,2,1,29,18,0,0,11,0
S01011733,Rented or living rent free: Private rented or living rent free,27,17,9,2,7,2,6,10,6,1,2,1,0
S01011734,All HRPs aged 16 and over,335,207,173,24,149,24,10,128,105,2,1,18,2
S01011734,Owned: Total,256,175,151,18,133,22,2,81,74,0,0,6,1
S01011734,Owned: Owned outright,113,42,32,5,27,8,2,71,69,0,0,2,0
S01011734,Owned: Owned with a mortgage or loan or shared ownership,143,133,119,13,106,14,0,10,5,0,0,4,1
S01011734,Rented or living rent free: Total,79,32,22,6,16,2,8,47,31,2,1,12,1
S01011734,Rented or living rent free: Social rented,56,14,11,1,10,1,2,42,29,2,0,10,1
S01011734,Rented or living rent free: Private rented or living rent free,23,18,11,5,6,1,6,5,2,0,1,2,0
S01011735,All HRPs aged 16 and over,288,191,146,20,126,40,5,97,92,0,0,5,0
S01011735,Owned: Total,275,183,139,17,122,39,5,92,90,0,0,2,0
S01011735,Owned: Owned outright,137,57,41,8,33,14,2,80,78,0,0,2,0
S01011735,Owned: Owned with a mortgage or loan or shared ownership,138,126,98,9,89,25,3,12,12,0,0,0,0
S01011735,Rented or living rent free: Total,13,8,7,3,4,1,0,5,2,0,0,3,0
S01011735,Rented or living rent free: Social rented,6,4,4,3,1,0,0,2,2,0,0,0,0
S01011735,Rented or living rent free: Private rented or living rent free,7,4,3,0,3,1,0,3,0,0,0,3,0
S01011736,All HRPs aged 16 and over,317,221,187,34,153,18,16,96,73,3,7,9,4
S01011736,Owned: Total,230,166,148,22,126,15,3,64,56,1,3,3,1
S01011736,Owned: Owned outright,84,29,27,11,16,2,0,55,49,1,3,2,0
S01011736,Owned: Owned with a mortgage or loan or shared ownership,146,137,121,11,110,13,3,9,7,0,0,1,1
S01011736,Rented or living rent free: Total,87,55,39,12,27,3,13,32,17,2,4,6,3
S01011736,Rented or living rent free: Social rented,31,13,9,4,5,1,3,18,14,1,0,3,0
S01011736,Rented or living rent free: Private rented or living rent free,56,42,30,8,22,2,10,14,3,1,4,3,3
S01011737,All HRPs aged 16 and over,294,184,144,23,121,20,20,110,82,4,7,9,8
S01011737,Owned: Total,187,123,104,10,94,16,3,64,58,1,0,2,3
S01011737,Owned: Owned outright,71,21,16,4,12,5,0,50,46,1,0,1,2
S01011737,Owned: Owned with a mortgage or loan or shared ownership,116,102,88,6,82,11,3,14,12,0,0,1,1
S01011737,Rented or living rent free: Total,107,61,40,13,27,4,17,46,24,3,7,7,5
S01011737,Rented or living rent free: Social rented,44,17,13,6,7,2,2,27,20,0,1,3,3
S01011737,Rented or living rent free: Private rented or living rent free,63,44,27,7,20,2,15,19,4,3,6,4,2
S01011738,All HRPs aged 16 and over,466,319,243,42,201,40,36,147,84,11,10,29,13
S01011738,Owned: Total,255,189,151,24,127,31,7,66,60,0,0,5,1
S01011738,Owned: Owned outright,97,47,38,9,29,7,2,50,48,0,0,2,0
S01011738,Owned: Owned with a mortgage or loan or shared ownership,158,142,113,15,98,24,5,16,12,0,0,3,1
S01011738,Rented or living rent free: Total,211,130,92,18,74,9,29,81,24,11,10,24,12
S01011738,Rented or living rent free: Social rented,117,59,41,9,32,3,15,58,22,9,4,17,6
S01011738,Rented or living rent free: Private rented or living rent free,94,71,51,9,42,6,14,23,2,2,6,7,6
S01011739,All HRPs aged 16 and over,226,139,121,25,96,6,12,87,72,2,3,8,2
S01011739,Owned: Total,167,105,98,15,83,5,2,62,57,0,0,3,2
S01011739,Owned: Owned outright,72,25,25,9,16,0,0,47,45,0,0,1,1
S01011739,Owned: Owned with a mortgage or loan or shared ownership,95,80,73,6,67,5,2,15,12,0,0,2,1
S01011739,Rented or living rent free: Total,59,34,23,10,13,1,10,25,15,2,3,5,0
S01011739,Rented or living rent free: Social rented,45,27,21,9,12,1,5,18,15,0,0,3,0
S01011739,Rented or living rent free: Private rented or living rent free,14,7,2,1,1,0,5,7,0,2,3,2,0
S01011740,All HRPs aged 16 and over,356,188,152,35,117,10,26,168,76,24,11,45,12
S01011740,Owned: Total,153,96,86,12,74,8,2,57,48,2,1,6,0
S01011740,Owned: Owned outright,61,22,19,6,13,2,1,39,35,0,0,4,0
S01011740,Owned: Owned with a mortgage or loan or shared ownership,92,74,67,6,61,6,1,18,13,2,1,2,0
S01011740,Rented or living rent free: Total,203,92,66,23,43,2,24,111,28,22,10,39,12
S01011740,Rented or living rent free: Social rented,160,72,52,19,33,1,19,88,27,5,7,37,12
S01011740,Rented or living rent free: Private rented or living rent free,43,20,14,4,10,1,5,23,1,17,3,2,0
S01011741,All HRPs aged 16 and over,296,182,159,27,132,8,15,114,81,3,12,17,1
S01011741,Owned: Total,184,114,107,9,98,6,1,70,63,0,1,6,0
S01011741,Owned: Owned outright,81,23,21,3,18,2,0,58,54,0,1,3,0
S01011741,Owned: Owned with a mortgage or loan or shared ownership,103,91,86,6,80,4,1,12,9,0,0,3,0
S01011741,Rented or living rent free: Total,112,68,52,18,34,2,14,44,18,3,11,11,1
S01011741,Rented or living rent free: Social rented,78,44,38,14,24,1,5,34,15,2,8,9,0
S01011741,Rented or living rent free: Private rented or living rent free,34,24,14,4,10,1,9,10,3,1,3,2,1
S01011742,All HRPs aged 16 and over,333,210,175,33,142,21,14,123,94,3,6,15,5
S01011742,Owned: Total,219,154,132,19,113,19,3,65,59,0,3,1,2
S01011742,Owned: Owned outright,90,39,35,12,23,3,1,51,51,0,0,0,0
S01011742,Owned: Owned with a mortgage or loan or shared ownership,129,115,97,7,90,16,2,14,8,0,3,1,2
S01011742,Rented or living rent free: Total,114,56,43,14,29,2,11,58,35,3,3,14,3
S01011742,Rented or living rent free: Social rented,95,40,32,11,21,2,6,55,34,2,3,14,2
S01011742,Rented or living rent free: Private rented or living rent free,19,16,11,3,8,0,5,3,1,1,0,0,1
S01011743,All HRPs aged 16 and over,379,247,218,38,180,20,9,132,107,3,6,10,6
S01011743,Owned: Total,257,174,153,16,137,17,4,83,80,0,0,2,1
S01011743,Owned: Owned outright,107,39,32,8,24,6,1,68,66,0,0,1,1
S01011743,Owned: Owned with a mortgage or loan or shared ownership,150,135,121,8,113,11,3,15,14,0,0,1,0
S01011743,Rented or living rent free: Total,122,73,65,22,43,3,5,49,27,3,6,8,5
S01011743,Rented or living rent free: Social rented,70,33,30,11,19,0,3,37,23,0,3,7,4
S01011743,Rented or living rent free: Private rented or living rent free,52,40,35,11,24,3,2,12,4,3,3,1,1
S01011744,All HRPs aged 16 and over,462,258,205,40,165,28,25,204,158,3,11,23,9
S01011744,Owned: Total,242,155,131,18,113,21,3,87,80,0,1,4,2
S01011744,Owned: Owned outright,125,48,41,9,32,5,2,77,73,0,1,2,1
S01011744,Owned: Owned with a mortgage or loan or shared ownership,117,107,90,9,81,16,1,10,7,0,0,2,1
S01011744,Rented or living rent free: Total,220,103,74,22,52,7,22,117,78,3,10,19,7
S01011744,Rented or living rent free: Social rented,145,41,28,9,19,0,13,104,72,2,7,17,6
S01011744,Rented or living rent free: Private rented or living rent free,75,62,46,13,33,7,9,13,6,1,3,2,1
S01011745,All HRPs aged 16 and over,398,170,148,31,117,13,9,228,201,3,5,16,3
S01011745,Owned: Total,202,111,99,13,86,11,1,91,86,1,2,1,1
S01011745,Owned: Owned outright,98,23,19,7,12,4,0,75,73,0,1,1,0
S01011745,Owned: Owned with a mortgage or loan or shared ownership,104,88,80,6,74,7,1,16,13,1,1,0,1
S01011745,Rented or living rent free: Total,196,59,49,18,31,2,8,137,115,2,3,15,2
S01011745,Rented or living rent free: Social rented,162,43,37,15,22,1,5,119,104,2,0,13,0
S01011745,Rented or living rent free: Private rented or living rent free,34,16,12,3,9,1,3,18,11,0,3,2,2
S01011746,All HRPs aged 16 and over,215,140,123,37,86,9,8,75,48,3,8,11,5
S01011746,Owned: Total,122,87,80,17,63,6,1,35,31,0,0,2,2
S01011746,Owned: Owned outright,46,17,15,6,9,1,1,29,27,0,0,1,1
S01011746,Owned: Owned with a mortgage or loan or shared ownership,76,70,65,11,54,5,0,6,4,0,0,1,1
S01011746,Rented or living rent free: Total,93,53,43,20,23,3,7,40,17,3,8,9,3
S01011746,Rented or living rent free: Social rented,63,36,27,15,12,2,7,27,16,0,3,7,1
S01011746,Rented or living rent free: Private rented or living rent free,30,17,16,5,11,1,0,13,1,3,5,2,2
S01011747,All HRPs aged 16 and over,413,252,199,45,154,13,40,161,87,10,21,41,2
S01011747,Owned: Total,198,125,111,15,96,10,4,73,60,0,2,11,0
S01011747,Owned: Owned outright,73,22,19,4,15,1,2,51,46,0,2,3,0
S01011747,Owned: Owned with a mortgage or loan or shared ownership,125,103,92,11,81,9,2,22,14,0,0,8,0
S01011747,Rented or living rent free: Total,215,127,88,30,58,3,36,88,27,10,19,30,2
S01011747,Rented or living rent free: Social rented,155,86,60,21,39,2,24,69,25,5,12,25,2
S01011747,Rented or living rent free: Private rented or living rent free,60,41,28,9,19,1,12,19,2,5,7,5,0
S01011748,All HRPs aged 16 and over,375,238,202,38,164,14,22,137,74,7,22,20,14
S01011748,Owned: Total,203,139,126,19,107,10,3,64,52,4,0,5,3
S01011748,Owned: Owned outright,61,14,13,2,11,0,1,47,44,0,0,1,2
S01011748,Owned: Owned with a mortgage or loan or shared ownership,142,125,113,17,96,10,2,17,8,4,0,4,1
S01011748,Rented or living rent free: Total,172,99,76,19,57,4,19,73,22,3,22,15,11
S01011748,Rented or living rent free: Social rented,82,38,36,12,24,0,2,44,21,2,7,13,1
S01011748,Rented or living rent free: Private rented or living rent free,90,61,40,7,33,4,17,29,1,1,15,2,10
S01011749,All HRPs aged 16 and over,370,255,193,29,164,12,50,115,27,16,20,36,16
S01011749,Owned: Total,118,98,85,4,81,9,4,20,16,0,2,2,0
S01011749,Owned: Owned outright,27,18,15,1,14,2,1,9,8,0,1,0,0
S01011749,Owned: Owned with a mortgage or loan or shared ownership,91,80,70,3,67,7,3,11,8,0,1,2,0
S01011749,Rented or living rent free: Total,252,157,108,25,83,3,46,95,11,16,18,34,16
S01011749,Rented or living rent free: Social rented,128,72,46,18,28,1,25,56,9,10,7,22,8
S01011749,Rented or living rent free: Private rented or living rent free,124,85,62,7,55,2,21,39,2,6,11,12,8
S01011750,All HRPs aged 16 and over,398,236,199,37,162,20,17,162,126,1,13,19,3
S01011750,Owned: Total,252,170,152,23,129,15,3,82,81,0,0,1,0
S01011750,Owned: Owned outright,108,35,33,9,24,1,1,73,73,0,0,0,0
S01011750,Owned: Owned with a mortgage or loan or shared ownership,144,135,119,14,105,14,2,9,8,0,0,1,0
S01011750,Rented or living rent free: Total,146,66,47,14,33,5,14,80,45,1,13,18,3
S01011750,Rented or living rent free: Social rented,103,43,28,9,19,4,11,60,40,0,1,17,2
S01011750,Rented or living rent free: Private rented or living rent free,43,23,19,5,14,1,3,20,5,1,12,1,1
S01011751,All HRPs aged 16 and over,532,373,297,70,227,20,56,159,69,9,15,48,18
S01011751,Owned: Total,226,174,153,28,125,12,9,52,39,0,2,8,3
S01011751,Owned: Owned outright,63,24,21,5,16,3,0,39,34,0,1,2,2
S01011751,Owned: Owned with a mortgage or loan or shared ownership,163,150,132,23,109,9,9,13,5,0,1,6,1
S01011751,Rented or living rent free: Total,306,199,144,42,102,8,47,107,30,9,13,40,15
S01011751,Rented or living rent free: Social rented,179,106,76,33,43,4,26,73,27,7,9,23,7
S01011751,Rented or living rent free: Private rented or living rent free,127,93,68,9,59,4,21,34,3,2,4,17,8
S01011752,All HRPs aged 16 and over,460,327,285,48,237,23,19,133,103,1,5,22,2
S01011752,Owned: Total,313,234,214,31,183,16,4,79,73,1,2,3,0
S01011752,Owned: Owned outright,88,33,32,7,25,1,0,55,55,0,0,0,0
S01011752,Owned: Owned with a mortgage or loan or shared ownership,225,201,182,24,158,15,4,24,18,1,2,3,0
S01011752,Rented or living rent free: Total,147,93,71,17,54,7,15,54,30,0,3,19,2
S01011752,Rented or living rent free: Social rented,71,36,28,7,21,3,5,35,23,0,1,9,2
S01011752,Rented or living rent free: Private rented or living rent free,76,57,43,10,33,4,10,19,7,0,2,10,0
S01011753,All HRPs aged 16 and over,366,243,210,34,176,19,14,123,106,0,4,9,4
S01011753,Owned: Total,315,210,185,25,160,17,8,105,102,0,2,0,1
S01011753,Owned: Owned outright,135,46,39,12,27,3,4,89,87,0,1,0,1
S01011753,Owned: Owned with a mortgage or loan or shared ownership,180,164,146,13,133,14,4,16,15,0,1,0,0
S01011753,Rented or living rent free: Total,51,33,25,9,16,2,6,18,4,0,2,9,3
S01011753,Rented or living rent free: Social rented,12,2,2,1,1,0,0,10,1,0,1,6,2
S01011753,Rented or living rent free: Private rented or living rent free,39,31,23,8,15,2,6,8,3,0,1,3,1
S01011754,All HRPs aged 16 and over,339,200,167,34,133,19,14,139,116,1,6,12,4
S01011754,Owned: Total,251,154,136,24,112,16,2,97,91,1,0,4,1
S01011754,Owned: Owned outright,101,31,27,8,19,3,1,70,68,1,0,1,0
S01011754,Owned: Owned with a mortgage or loan or shared ownership,150,123,109,16,93,13,1,27,23,0,0,3,1
S01011754,Rented or living rent free: Total,88,46,31,10,21,3,12,42,25,0,6,8,3
S01011754,Rented or living rent free: Social rented,58,27,21,6,15,2,4,31,20,0,1,7,3
S01011754,Rented or living rent free: Private rented or living rent free,30,19,10,4,6,1,8,11,5,0,5,1,0
S01011755,All HRPs aged 16 and over,456,327,273,35,238,26,28,129,73,2,14,35,5
S01011755,Owned: Total,273,217,197,15,182,17,3,56,50,0,0,6,0
S01011755,Owned: Owned outright,86,41,38,8,30,2,1,45,41,0,0,4,0
S01011755,Owned: Owned with a mortgage or loan or shared ownership,187,176,159,7,152,15,2,11,9,0,0,2,0
S01011755,Rented or living rent free: Total,183,110,76,20,56,9,25,73,23,2,14,29,5
S01011755,Rented or living rent free: Social rented,106,59,41,11,30,4,14,47,19,0,2,21,5
S01011755,Rented or living rent free: Private rented or living rent free,77,51,35,9,26,5,11,26,4,2,12,8,0
S01011756,All HRPs aged 16 and over,430,297,256,46,210,20,21,133,89,7,12,15,10
S01011756,Owned: Total,292,210,193,22,171,14,3,82,70,0,3,8,1
S01011756,Owned: Owned outright,87,27,23,4,19,4,0,60,55,0,1,3,1
S01011756,Owned: Owned with a mortgage or loan or shared ownership,205,183,170,18,152,10,3,22,15,0,2,5,0
S01011756,Rented or living rent free: Total,138,87,63,24,39,6,18,51,19,7,9,7,9
S01011756,Rented or living rent free: Social rented,76,46,34,14,20,3,9,30,12,7,2,6,3
S01011756,Rented or living rent free: Private rented or living rent free,62,41,29,10,19,3,9,21,7,0,7,1,6
S01011757,All HRPs aged 16 and over,327,189,158,32,126,16,15,138,88,3,9,34,4
S01011757,Owned: Total,187,131,114,17,97,12,5,56,48,2,1,4,1
S01011757,Owned: Owned outright,67,30,25,9,16,3,2,37,34,1,0,1,1
S01011757,Owned: Owned with a mortgage or loan or shared ownership,120,101,89,8,81,9,3,19,14,1,1,3,0
S01011757,Rented or living rent free: Total,140,58,44,15,29,4,10,82,40,1,8,30,3
S01011757,Rented or living rent free: Social rented,102,30,22,8,14,3,5,72,38,1,6,25,2
S01011757,Rented or living rent free: Private rented or living rent free,38,28,22,7,15,1,5,10,2,0,2,5,1
S01011758,All HRPs aged 16 and over,252,174,153,27,126,15,6,78,55,1,7,12,3
S01011758,Owned: Total,188,145,129,19,110,15,1,43,38,0,1,4,0
S01011758,Owned: Owned outright,52,18,16,2,14,2,0,34,32,0,0,2,0
S01011758,Owned: Owned with a mortgage or loan or shared ownership,136,127,113,17,96,13,1,9,6,0,1,2,0
S01011758,Rented or living rent free: Total,64,29,24,8,16,0,5,35,17,1,6,8,3
S01011758,Rented or living rent free: Social rented,43,19,17,7,10,0,2,24,14,1,3,5,1
S01011758,Rented or living rent free: Private rented or living rent free,21,10,7,1,6,0,3,11,3,0,3,3,2
S01011759,All HRPs aged 16 and over,340,216,188,45,143,19,9,124,104,3,1,13,3
S01011759,Owned: Total,261,172,151,30,121,18,3,89,82,2,0,5,0
S01011759,Owned: Owned outright,114,42,39,14,25,3,0,72,71,0,0,1,0
S01011759,Owned: Owned with a mortgage or loan or shared ownership,147,130,112,16,96,15,3,17,11,2,0,4,0
S01011759,Rented or living rent free: Total,79,44,37,15,22,1,6,35,22,1,1,8,3
S01011759,Rented or living rent free: Social rented,55,25,21,7,14,1,3,30,19,0,0,8,3
S01011759,Rented or living rent free: Private rented or living rent free,24,19,16,8,8,0,3,5,3,1,1,0,0
S01011760,All HRPs aged 16 and over,411,270,234,39,195,21,15,141,104,3,6,25,3
S01011760,Owned: Total,287,202,180,25,155,18,4,85,79,0,0,5,1
S01011760,Owned: Owned outright,102,28,23,8,15,2,3,74,71,0,0,3,0
S01011760,Owned: Owned with a mortgage or loan or shared ownership,185,174,157,17,140,16,1,11,8,0,0,2,1
S01011760,Rented or living rent free: Total,124,68,54,14,40,3,11,56,25,3,6,20,2
S01011760,Rented or living rent free: Social rented,86,39,31,9,22,0,8,47,24,1,1,19,2
S01011760,Rented or living rent free: Private rented or living rent free,38,29,23,5,18,3,3,9,1,2,5,1,0
S01011761,All HRPs aged 16 and over,272,202,167,31,136,20,15,70,41,1,12,12,4
S01011761,Owned: Total,171,135,118,11,107,12,5,36,28,0,1,5,2
S01011761,Owned: Owned outright,37,12,8,1,7,3,1,25,24,0,0,0,1
S01011761,Owned: Owned with a mortgage or loan or shared ownership,134,123,110,10,100,9,4,11,4,0,1,5,1
S01011761,Rented or living rent free: Total,101,67,49,20,29,8,10,34,13,1,11,7,2
S01011761,Rented or living rent free: Social rented,66,39,30,16,14,2,7,27,11,0,9,6,1
S01011761,Rented or living rent free: Private rented or living rent free,35,28,19,4,15,6,3,7,2,1,2,1,1
S01011762,All HRPs aged 16 and over,322,205,173,37,136,15,17,117,60,14,12,28,3
S01011762,Owned: Total,178,121,108,15,93,10,3,57,48,0,1,8,0
S01011762,Owned: Owned outright,62,19,18,4,14,1,0,43,39,0,1,3,0
S01011762,Owned: Owned with a mortgage or loan or shared ownership,116,102,90,11,79,9,3,14,9,0,0,5,0
S01011762,Rented or living rent free: Total,144,84,65,22,43,5,14,60,12,14,11,20,3
S01011762,Rented or living rent free: Social rented,85,39,27,16,11,3,9,46,11,14,4,14,3
S01011762,Rented or living rent free: Private rented or living rent free,59,45,38,6,32,2,5,14,1,0,7,6,0
S01011763,All HRPs aged 16 and over,350,220,184,29,155,25,11,130,102,2,5,18,3
S01011763,Owned: Total,262,183,156,19,137,21,6,79,71,2,1,4,1
S01011763,Owned: Owned outright,82,28,23,7,16,2,3,54,50,2,1,1,0
S01011763,Owned: Owned with a mortgage or loan or shared ownership,180,155,133,12,121,19,3,25,21,0,0,3,1
S01011763,Rented or living rent free: Total,88,37,28,10,18,4,5,51,31,0,4,14,2
S01011763,Rented or living rent free: Social rented,71,27,21,8,13,2,4,44,28,0,2,12,2
S01011763,Rented or living rent free: Private rented or living rent free,17,10,7,2,5,2,1,7,3,0,2,2,0
S01011764,All HRPs aged 16 and over,136,96,85,13,72,6,5,40,37,0,0,3,0
S01011764,Owned: Total,119,86,77,11,66,6,3,33,32,0,0,1,0
S01011764,Owned: Owned outright,44,17,15,4,11,0,2,27,27,0,0,0,0
S01011764,Owned: Owned with a mortgage or loan or shared ownership,75,69,62,7,55,6,1,6,5,0,0,1,0
S01011764,Rented or living rent free: Total,17,10,8,2,6,0,2,7,5,0,0,2,0
S01011764,Rented or living rent free: Social rented,12,7,6,2,4,0,1,5,3,0,0,2,0
S01011764,Rented or living rent free: Private rented or living rent free,5,3,2,0,2,0,1,2,2,0,0,0,0
S01011765,All HRPs aged 16 and over,380,311,263,29,234,42,6,69,58,1,1,6,3
S01011765,Owned: Total,344,288,243,26,217,41,4,56,51,1,0,4,0
S01011765,Owned: Owned outright,93,48,41,6,35,6,1,45,44,0,0,1,0
S01011765,Owned: Owned with a mortgage or loan or shared ownership,251,240,202,20,182,35,3,11,7,1,0,3,0
S01011765,Rented or living rent free: Total,36,23,20,3,17,1,2,13,7,0,1,2,3
S01011765,Rented or living rent free: Social rented,10,3,2,0,2,0,1,7,4,0,0,1,2
S01011765,Rented or living rent free: Private rented or living rent free,26,20,18,3,15,1,1,6,3,0,1,1,1
S01011766,All HRPs aged 16 and over,209,154,127,13,114,24,3,55,44,1,2,6,2
S01011766,Owned: Total,184,140,116,11,105,21,3,44,40,0,2,2,0
S01011766,Owned: Owned outright,68,36,28,6,22,7,1,32,30,0,1,1,0
S01011766,Owned: Owned with a mortgage or loan or shared ownership,116,104,88,5,83,14,2,12,10,0,1,1,0
S01011766,Rented or living rent free: Total,25,14,11,2,9,3,0,11,4,1,0,4,2
S01011766,Rented or living rent free: Social rented,15,8,6,2,4,2,0,7,3,0,0,4,0
S01011766,Rented or living rent free: Private rented or living rent free,10,6,5,0,5,1,0,4,1,1,0,0,2
S01011767,All HRPs aged 16 and over,443,267,210,44,166,29,28,176,141,3,2,27,3
S01011767,Owned: Total,252,171,139,16,123,27,5,81,77,0,0,4,0
S01011767,Owned: Owned outright,110,42,29,3,26,12,1,68,66,0,0,2,0
S01011767,Owned: Owned with a mortgage or loan or shared ownership,142,129,110,13,97,15,4,13,11,0,0,2,0
S01011767,Rented or living rent free: Total,191,96,71,28,43,2,23,95,64,3,2,23,3
S01011767,Rented or living rent free: Social rented,138,53,36,15,21,1,16,85,61,2,1,21,0
S01011767,Rented or living rent free: Private rented or living rent free,53,43,35,13,22,1,7,10,3,1,1,2,3
S01011768,All HRPs aged 16 and over,342,237,201,40,161,13,23,105,62,4,8,24,7
S01011768,Owned: Total,161,123,111,14,97,10,2,38,33,1,0,2,2
S01011768,Owned: Owned outright,46,14,13,3,10,1,0,32,31,0,0,1,0
S01011768,Owned: Owned with a mortgage or loan or shared ownership,115,109,98,11,87,9,2,6,2,1,0,1,2
S01011768,Rented or living rent free: Total,181,114,90,26,64,3,21,67,29,3,8,22,5
S01011768,Rented or living rent free: Social rented,134,79,62,21,41,3,14,55,29,3,2,19,2
S01011768,Rented or living rent free: Private rented or living rent free,47,35,28,5,23,0,7,12,0,0,6,3,3
S01011769,All HRPs aged 16 and over,321,182,153,30,123,19,10,139,107,2,4,22,4
S01011769,Owned: Total,212,125,110,14,96,13,2,87,81,0,1,5,0
S01011769,Owned: Owned outright,107,34,30,8,22,3,1,73,71,0,1,1,0
S01011769,Owned: Owned with a mortgage or loan or shared ownership,105,91,80,6,74,10,1,14,10,0,0,4,0
S01011769,Rented or living rent free: Total,109,57,43,16,27,6,8,52,26,2,3,17,4
S01011769,Rented or living rent free: Social rented,63,27,19,7,12,4,4,36,20,2,2,10,2
S01011769,Rented or living rent free: Private rented or living rent free,46,30,24,9,15,2,4,16,6,0,1,7,2
S01011770,All HRPs aged 16 and over,409,244,205,38,167,18,21,165,125,4,6,24,6
S01011770,Owned: Total,252,165,149,21,128,13,3,87,80,1,1,3,2
S01011770,Owned: Owned outright,112,42,36,9,27,4,2,70,66,1,0,2,1
S01011770,Owned: Owned with a mortgage or loan or shared ownership,140,123,113,12,101,9,1,17,14,0,1,1,1
S01011770,Rented or living rent free: Total,157,79,56,17,39,5,18,78,45,3,5,21,4
S01011770,Rented or living rent free: Social rented,99,43,28,10,18,4,11,56,37,2,2,14,1
S01011770,Rented or living rent free: Private rented or living rent free,58,36,28,7,21,1,7,22,8,1,3,7,3
S01011771,All HRPs aged 16 and over,238,200,174,15,159,25,1,38,32,0,0,5,1
S01011771,Owned: Total,222,188,164,15,149,23,1,34,31,0,0,2,1
S01011771,Owned: Owned outright,51,24,21,4,17,3,0,27,26,0,0,1,0
S01011771,Owned: Owned with a mortgage or loan or shared ownership,171,164,143,11,132,20,1,7,5,0,0,1,1
S01011771,Rented or living rent free: Total,16,12,10,0,10,2,0,4,1,0,0,3,0
S01011771,Rented or living rent free: Social rented,7,5,4,0,4,1,0,2,0,0,0,2,0
S01011771,Rented or living rent free: Private rented or living rent free,9,7,6,0,6,1,0,2,1,0,0,1,0
S01011772,All HRPs aged 16 and over,390,299,223,18,205,68,8,91,86,1,0,3,1
S01011772,Owned: Total,369,285,214,15,199,67,4,84,82,1,0,0,1
S01011772,Owned: Owned outright,140,72,52,6,46,20,0,68,66,1,0,0,1
S01011772,Owned: Owned with a mortgage or loan or shared ownership,229,213,162,9,153,47,4,16,16,0,0,0,0
S01011772,Rented or living rent free: Total,21,14,9,3,6,1,4,7,4,0,0,3,0
S01011772,Rented or living rent free: Social rented,12,9,5,2,3,0,4,3,0,0,0,3,0
S01011772,Rented or living rent free: Private rented or living rent free,9,5,4,1,3,1,0,4,4,0,0,0,0
S01011773,All HRPs aged 16 and over,200,180,158,11,147,21,1,20,15,0,3,2,0
S01011773,Owned: Total,190,173,152,11,141,20,1,17,12,0,3,2,0
S01011773,Owned: Owned outright,26,16,13,5,8,3,0,10,9,0,0,1,0
S01011773,Owned: Owned with a mortgage or loan or shared ownership,164,157,139,6,133,17,1,7,3,0,3,1,0
S01011773,Rented or living rent free: Total,10,7,6,0,6,1,0,3,3,0,0,0,0
S01011773,Rented or living rent free: Social rented,3,2,1,0,1,1,0,1,1,0,0,0,0
S01011773,Rented or living rent free: Private rented or living rent free,7,5,5,0,5,0,0,2,2,0,0,0,0
S01011774,All HRPs aged 16 and over,354,279,237,34,203,34,8,75,31,6,9,24,5
S01011774,Owned: Total,216,201,168,13,155,30,3,15,14,0,1,0,0
S01011774,Owned: Owned outright,34,25,21,3,18,4,0,9,9,0,0,0,0
S01011774,Owned: Owned with a mortgage or loan or shared ownership,182,176,147,10,137,26,3,6,5,0,1,0,0
S01011774,Rented or living rent free: Total,138,78,69,21,48,4,5,60,17,6,8,24,5
S01011774,Rented or living rent free: Social rented,106,54,45,14,31,4,5,52,14,6,8,22,2
S01011774,Rented or living rent free: Private rented or living rent free,32,24,24,7,17,0,0,8,3,0,0,2,3
S01011775,All HRPs aged 16 and over,228,205,176,13,163,28,1,23,19,0,0,1,3
S01011775,Owned: Total,216,195,167,11,156,27,1,21,18,0,0,1,2
S01011775,Owned: Owned outright,40,23,19,7,12,4,0,17,15,0,0,1,1
S01011775,Owned: Owned with a mortgage or loan or shared ownership,176,172,148,4,144,23,1,4,3,0,0,0,1
S01011775,Rented or living rent free: Total,12,10,9,2,7,1,0,2,1,0,0,0,1
S01011775,Rented or living rent free: Social rented,2,2,2,0,2,0,0,0,0,0,0,0,0
S01011775,Rented or living rent free: Private rented or living rent free,10,8,7,2,5,1,0,2,1,0,0,0,1
S01011776,All HRPs aged 16 and over,319,297,236,17,219,57,4,22,18,0,0,2,2
S01011776,Owned: Total,298,279,222,13,209,53,4,19,16,0,0,1,2
S01011776,Owned: Owned outright,43,29,22,3,19,6,1,14,13,0,0,0,1
S01011776,Owned: Owned with a mortgage or loan or shared ownership,255,250,200,10,190,47,3,5,3,0,0,1,1
S01011776,Rented or living rent free: Total,21,18,14,4,10,4,0,3,2,0,0,1,0
S01011776,Rented or living rent free: Social rented,5,3,2,1,1,1,0,2,1,0,0,1,0
S01011776,Rented or living rent free: Private rented or living rent free,16,15,12,3,9,3,0,1,1,0,0,0,0
S01011777,All HRPs aged 16 and over,264,207,183,19,164,20,4,57,44,0,2,7,4
S01011777,Owned: Total,215,176,158,13,145,17,1,39,34,0,0,2,3
S01011777,Owned: Owned outright,48,18,17,4,13,1,0,30,29,0,0,0,1
S01011777,Owned: Owned with a mortgage or loan or shared ownership,167,158,141,9,132,16,1,9,5,0,0,2,2
S01011777,Rented or living rent free: Total,49,31,25,6,19,3,3,18,10,0,2,5,1
S01011777,Rented or living rent free: Social rented,27,15,12,5,7,0,3,12,7,0,1,4,0
S01011777,Rented or living rent free: Private rented or living rent free,22,16,13,1,12,3,0,6,3,0,1,1,1
S01011778,All HRPs aged 16 and over,261,202,167,9,158,27,8,59,53,0,1,3,2
S01011778,Owned: Total,168,150,124,4,120,22,4,18,14,0,0,2,2
S01011778,Owned: Owned outright,25,15,11,1,10,2,2,10,9,0,0,1,0
S01011778,Owned: Owned with a mortgage or loan or shared ownership,143,135,113,3,110,20,2,8,5,0,0,1,2
S01011778,Rented or living rent free: Total,93,52,43,5,38,5,4,41,39,0,1,1,0
S01011778,Rented or living rent free: Social rented,37,6,4,2,2,2,0,31,30,0,0,1,0
S01011778,Rented or living rent free: Private rented or living rent free,56,46,39,3,36,3,4,10,9,0,1,0,0
S01011779,All HRPs aged 16 and over,324,239,207,25,182,28,4,85,78,0,2,4,1
S01011779,Owned: Total,298,222,195,25,170,24,3,76,71,0,2,2,1
S01011779,Owned: Owned outright,112,51,48,13,35,3,0,61,58,0,0,2,1
S01011779,Owned: Owned with a mortgage or loan or shared ownership,186,171,147,12,135,21,3,15,13,0,2,0,0
S01011779,Rented or living rent free: Total,26,17,12,0,12,4,1,9,7,0,0,2,0
S01011779,Rented or living rent free: Social rented,3,1,1,0,1,0,0,2,2,0,0,0,0
S01011779,Rented or living rent free: Private rented or living rent free,23,16,11,0,11,4,1,7,5,0,0,2,0
S01011780,All HRPs aged 16 and over,315,261,203,19,184,54,4,54,47,0,1,6,0
S01011780,Owned: Total,304,252,199,18,181,50,3,52,46,0,1,5,0
S01011780,Owned: Owned outright,99,60,47,9,38,11,2,39,37,0,0,2,0
S01011780,Owned: Owned with a mortgage or loan or shared ownership,205,192,152,9,143,39,1,13,9,0,1,3,0
S01011780,Rented or living rent free: Total,11,9,4,1,3,4,1,2,1,0,0,1,0
S01011780,Rented or living rent free: Social rented,4,3,2,0,2,1,0,1,0,0,0,1,0
S01011780,Rented or living rent free: Private rented or living rent free,7,6,2,1,1,3,1,1,1,0,0,0,0
S01011781,All HRPs aged 16 and over,214,160,130,11,119,25,5,54,49,1,0,4,0
S01011781,Owned: Total,207,156,127,11,116,24,5,51,46,1,0,4,0
S01011781,Owned: Owned outright,69,27,20,4,16,6,1,42,38,1,0,3,0
S01011781,Owned: Owned with a mortgage or loan or shared ownership,138,129,107,7,100,18,4,9,8,0,0,1,0
S01011781,Rented or living rent free: Total,7,4,3,0,3,1,0,3,3,0,0,0,0
S01011781,Rented or living rent free: Social rented,4,2,1,0,1,1,0,2,2,0,0,0,0
S01011781,Rented or living rent free: Private rented or living rent free,3,2,2,0,2,0,0,1,1,0,0,0,0
S01011782,All HRPs aged 16 and over,271,199,165,20,145,28,6,72,67,1,2,1,1
S01011782,Owned: Total,262,192,161,18,143,26,5,70,66,1,2,1,0
S01011782,Owned: Owned outright,103,47,42,11,31,3,2,56,53,1,1,1,0
S01011782,Owned: Owned with a mortgage or loan or shared ownership,159,145,119,7,112,23,3,14,13,0,1,0,0
S01011782,Rented or living rent free: Total,9,7,4,2,2,2,1,2,1,0,0,0,1
S01011782,Rented or living rent free: Social rented,5,3,0,0,0,2,1,2,1,0,0,0,1
S01011782,Rented or living rent free: Private rented or living rent free,4,4,4,2,2,0,0,0,0,0,0,0,0
S01011783,All HRPs aged 16 and over,213,159,132,13,119,25,2,54,48,0,1,2,3
S01011783,Owned: Total,202,150,123,12,111,25,2,52,47,0,1,2,2
S01011783,Owned: Owned outright,79,35,26,4,22,8,1,44,39,0,1,2,2
S01011783,Owned: Owned with a mortgage or loan or shared ownership,123,115,97,8,89,17,1,8,8,0,0,0,0
S01011783,Rented or living rent free: Total,11,9,9,1,8,0,0,2,1,0,0,0,1
S01011783,Rented or living rent free: Social rented,4,3,3,1,2,0,0,1,1,0,0,0,0
S01011783,Rented or living rent free: Private rented or living rent free,7,6,6,0,6,0,0,1,0,0,0,0,1
S01011784,All HRPs aged 16 and over,349,221,187,33,154,23,11,128,86,8,5,23,6
S01011784,Owned: Total,188,129,112,9,103,15,2,59,52,1,0,4,2
S01011784,Owned: Owned outright,58,23,19,2,17,3,1,35,33,0,0,1,1
S01011784,Owned: Owned with a mortgage or loan or shared ownership,130,106,93,7,86,12,1,24,19,1,0,3,1
S01011784,Rented or living rent free: Total,161,92,75,24,51,8,9,69,34,7,5,19,4
S01011784,Rented or living rent free: Social rented,134,72,60,20,40,6,6,62,30,6,5,18,3
S01011784,Rented or living rent free: Private rented or living rent free,27,20,15,4,11,2,3,7,4,1,0,1,1
S01011785,All HRPs aged 16 and over,389,239,203,36,167,29,7,150,121,2,8,13,6
S01011785,Owned: Total,248,190,162,21,141,25,3,58,55,0,1,1,1
S01011785,Owned: Owned outright,82,39,31,7,24,7,1,43,41,0,0,1,1
S01011785,Owned: Owned with a mortgage or loan or shared ownership,166,151,131,14,117,18,2,15,14,0,1,0,0
S01011785,Rented or living rent free: Total,141,49,41,15,26,4,4,92,66,2,7,12,5
S01011785,Rented or living rent free: Social rented,106,29,25,9,16,2,2,77,60,0,4,8,5
S01011785,Rented or living rent free: Private rented or living rent free,35,20,16,6,10,2,2,15,6,2,3,4,0
S01011786,All HRPs aged 16 and over,124,120,100,8,92,18,2,4,1,0,1,2,0
S01011786,Owned: Total,113,110,93,6,87,16,1,3,1,0,0,2,0
S01011786,Owned: Owned outright,10,9,8,2,6,0,1,1,1,0,0,0,0
S01011786,Owned: Owned with a mortgage or loan or shared ownership,103,101,85,4,81,16,0,2,0,0,0,2,0
S01011786,Rented or living rent free: Total,11,10,7,2,5,2,1,1,0,0,1,0,0
S01011786,Rented or living rent free: Social rented,4,4,3,2,1,1,0,0,0,0,0,0,0
S01011786,Rented or living rent free: Private rented or living rent free,7,6,4,0,4,1,1,1,0,0,1,0,0
S01011787,All HRPs aged 16 and over,483,273,207,39,168,30,36,210,132,8,15,47,8
S01011787,Owned: Total,219,142,118,14,104,18,6,77,68,3,0,5,1
S01011787,Owned: Owned outright,90,39,31,6,25,4,4,51,48,0,0,2,1
S01011787,Owned: Owned with a mortgage or loan or shared ownership,129,103,87,8,79,14,2,26,20,3,0,3,0
S01011787,Rented or living rent free: Total,264,131,89,25,64,12,30,133,64,5,15,42,7
S01011787,Rented or living rent free: Social rented,243,115,75,21,54,12,28,128,62,5,15,40,6
S01011787,Rented or living rent free: Private rented or living rent free,21,16,14,4,10,0,2,5,2,0,0,2,1
S01011788,All HRPs aged 16 and over,225,195,130,4,126,63,2,30,25,0,0,4,1
S01011788,Owned: Total,213,187,123,2,121,62,2,26,24,0,0,1,1
S01011788,Owned: Owned outright,72,51,36,1,35,14,1,21,21,0,0,0,0
S01011788,Owned: Owned with a mortgage or loan or shared ownership,141,136,87,1,86,48,1,5,3,0,0,1,1
S01011788,Rented or living rent free: Total,12,8,7,2,5,1,0,4,1,0,0,3,0
S01011788,Rented or living rent free: Social rented,3,1,1,0,1,0,0,2,0,0,0,2,0
S01011788,Rented or living rent free: Private rented or living rent free,9,7,6,2,4,1,0,2,1,0,0,1,0
S01011789,All HRPs aged 16 and over,284,176,130,19,111,41,5,108,97,1,1,6,3
S01011789,Owned: Total,223,144,105,11,94,36,3,79,77,1,0,0,1
S01011789,Owned: Owned outright,114,51,37,4,33,14,0,63,63,0,0,0,0
S01011789,Owned: Owned with a mortgage or loan or shared ownership,109,93,68,7,61,22,3,16,14,1,0,0,1
S01011789,Rented or living rent free: Total,61,32,25,8,17,5,2,29,20,0,1,6,2
S01011789,Rented or living rent free: Social rented,42,20,17,8,9,2,1,22,14,0,1,5,2
S01011789,Rented or living rent free: Private rented or living rent free,19,12,8,0,8,3,1,7,6,0,0,1,0
S01011790,All HRPs aged 16 and over,404,267,201,46,155,48,18,137,79,5,12,32,9
S01011790,Owned: Total,246,178,135,21,114,40,3,68,56,3,1,5,3
S01011790,Owned: Owned outright,96,47,28,11,17,17,2,49,45,0,0,3,1
S01011790,Owned: Owned with a mortgage or loan or shared ownership,150,131,107,10,97,23,1,19,11,3,1,2,2
S01011790,Rented or living rent free: Total,158,89,66,25,41,8,15,69,23,2,11,27,6
S01011790,Rented or living rent free: Social rented,140,78,55,23,32,8,15,62,20,2,10,25,5
S01011790,Rented or living rent free: Private rented or living rent free,18,11,11,2,9,0,0,7,3,0,1,2,1
S01011791,All HRPs aged 16 and over,347,200,163,38,125,24,13,147,100,3,10,27,7
S01011791,Owned: Total,175,120,103,21,82,16,1,55,48,0,1,4,2
S01011791,Owned: Owned outright,69,26,24,12,12,2,0,43,39,0,0,3,1
S01011791,Owned: Owned with a mortgage or loan or shared ownership,106,94,79,9,70,14,1,12,9,0,1,1,1
S01011791,Rented or living rent free: Total,172,80,60,17,43,8,12,92,52,3,9,23,5
S01011791,Rented or living rent free: Social rented,128,50,40,13,27,2,8,78,45,0,8,21,4
S01011791,Rented or living rent free: Private rented or living rent free,44,30,20,4,16,6,4,14,7,3,1,2,1
S01011792,All HRPs aged 16 and over,515,236,189,19,170,32,15,279,221,3,2,48,5
S01011792,Owned: Total,250,157,128,13,115,26,3,93,81,2,0,10,0
S01011792,Owned: Owned outright,129,44,34,8,26,8,2,85,74,2,0,9,0
S01011792,Owned: Owned with a mortgage or loan or shared ownership,121,113,94,5,89,18,1,8,7,0,0,1,0
S01011792,Rented or living rent free: Total,265,79,61,6,55,6,12,186,140,1,2,38,5
S01011792,Rented or living rent free: Social rented,198,36,24,4,20,6,6,162,127,0,1,29,5
S01011792,Rented or living rent free: Private rented or living rent free,67,43,37,2,35,0,6,24,13,1,1,9,0
S01011793,All HRPs aged 16 and over,327,190,149,18,131,31,10,137,115,2,2,13,5
S01011793,Owned: Total,236,141,110,11,99,26,5,95,86,2,0,2,5
S01011793,Owned: Owned outright,121,38,30,8,22,7,1,83,76,2,0,1,4
S01011793,Owned: Owned with a mortgage or loan or shared ownership,115,103,80,3,77,19,4,12,10,0,0,1,1
S01011793,Rented or living rent free: Total,91,49,39,7,32,5,5,42,29,0,2,11,0
S01011793,Rented or living rent free: Social rented,47,14,9,3,6,1,4,33,21,0,2,10,0
S01011793,Rented or living rent free: Private rented or living rent free,44,35,30,4,26,4,1,9,8,0,0,1,0
S01011794,All HRPs aged 16 and over,414,247,193,43,150,33,21,167,118,3,8,31,7
S01011794,Owned: Total,230,152,121,17,104,26,5,78,66,1,2,8,1
S01011794,Owned: Owned outright,103,37,28,4,24,7,2,66,59,1,2,3,1
S01011794,Owned: Owned with a mortgage or loan or shared ownership,127,115,93,13,80,19,3,12,7,0,0,5,0
S01011794,Rented or living rent free: Total,184,95,72,26,46,7,16,89,52,2,6,23,6
S01011794,Rented or living rent free: Social rented,141,64,46,19,27,6,12,77,46,2,2,21,6
S01011794,Rented or living rent free: Private rented or living rent free,43,31,26,7,19,1,4,12,6,0,4,2,0
S01011795,All HRPs aged 16 and over,317,195,155,28,127,20,20,122,70,2,10,30,10
S01011795,Owned: Total,144,93,79,8,71,13,1,51,44,2,0,4,1
S01011795,Owned: Owned outright,65,29,22,5,17,7,0,36,34,1,0,1,0
S01011795,Owned: Owned with a mortgage or loan or shared ownership,79,64,57,3,54,6,1,15,10,1,0,3,1
S01011795,Rented or living rent free: Total,173,102,76,20,56,7,19,71,26,0,10,26,9
S01011795,Rented or living rent free: Social rented,125,66,47,14,33,3,16,59,22,0,6,23,8
S01011795,Rented or living rent free: Private rented or living rent free,48,36,29,6,23,4,3,12,4,0,4,3,1
S01011796,All HRPs aged 16 and over,354,219,176,44,132,19,24,135,85,7,13,19,11
S01011796,Owned: Total,143,103,91,14,77,10,2,40,37,1,1,0,1
S01011796,Owned: Owned outright,52,21,18,5,13,3,0,31,31,0,0,0,0
S01011796,Owned: Owned with a mortgage or loan or shared ownership,91,82,73,9,64,7,2,9,6,1,1,0,1
S01011796,Rented or living rent free: Total,211,116,85,30,55,9,22,95,48,6,12,19,10
S01011796,Rented or living rent free: Social rented,177,90,66,23,43,6,18,87,46,6,10,17,8
S01011796,Rented or living rent free: Private rented or living rent free,34,26,19,7,12,3,4,8,2,0,2,2,2
S01011797,All HRPs aged 16 and over,385,283,230,26,204,47,6,102,98,2,0,1,1
S01011797,Owned: Total,368,268,218,25,193,45,5,100,96,2,0,1,1
S01011797,Owned: Owned outright,164,81,66,15,51,14,1,83,81,0,0,1,1
S01011797,Owned: Owned with a mortgage or loan or shared ownership,204,187,152,10,142,31,4,17,15,2,0,0,0
S01011797,Rented or living rent free: Total,17,15,12,1,11,2,1,2,2,0,0,0,0
S01011797,Rented or living rent free: Social rented,5,4,3,0,3,0,1,1,1,0,0,0,0
S01011797,Rented or living rent free: Private rented or living rent free,12,11,9,1,8,2,0,1,1,0,0,0,0
S01011798,All HRPs aged 16 and over,242,146,114,20,94,22,10,96,67,1,2,19,7
S01011798,Owned: Total,138,101,82,7,75,15,4,37,33,1,0,1,2
S01011798,Owned: Owned outright,37,14,11,3,8,1,2,23,22,1,0,0,0
S01011798,Owned: Owned with a mortgage or loan or shared ownership,101,87,71,4,67,14,2,14,11,0,0,1,2
S01011798,Rented or living rent free: Total,104,45,32,13,19,7,6,59,34,0,2,18,5
S01011798,Rented or living rent free: Social rented,74,30,23,9,14,2,5,44,30,0,2,10,2
S01011798,Rented or living rent free: Private rented or living rent free,30,15,9,4,5,5,1,15,4,0,0,8,3
S01011799,All HRPs aged 16 and over,357,228,185,24,161,37,6,129,109,0,6,13,1
S01011799,Owned: Total,295,193,154,17,137,36,3,102,94,0,2,5,1
S01011799,Owned: Owned outright,140,57,41,9,32,15,1,83,80,0,1,1,1
S01011799,Owned: Owned with a mortgage or loan or shared ownership,155,136,113,8,105,21,2,19,14,0,1,4,0
S01011799,Rented or living rent free: Total,62,35,31,7,24,1,3,27,15,0,4,8,0
S01011799,Rented or living rent free: Social rented,51,25,22,7,15,0,3,26,14,0,4,8,0
S01011799,Rented or living rent free: Private rented or living rent free,11,10,9,0,9,1,0,1,1,0,0,0,0
S01011800,All HRPs aged 16 and over,219,132,110,19,91,19,3,87,72,1,4,8,2
S01011800,Owned: Total,150,99,83,13,70,16,0,51,43,1,1,6,0
S01011800,Owned: Owned outright,63,20,16,2,14,4,0,43,37,1,0,5,0
S01011800,Owned: Owned with a mortgage or loan or shared ownership,87,79,67,11,56,12,0,8,6,0,1,1,0
S01011800,Rented or living rent free: Total,69,33,27,6,21,3,3,36,29,0,3,2,2
S01011800,Rented or living rent free: Social rented,55,22,18,3,15,2,2,33,28,0,1,2,2
S01011800,Rented or living rent free: Private rented or living rent free,14,11,9,3,6,1,1,3,1,0,2,0,0
S01011801,All HRPs aged 16 and over,253,161,129,29,100,10,22,92,51,4,10,24,3
S01011801,Owned: Total,129,88,79,9,70,6,3,41,35,0,0,6,0
S01011801,Owned: Owned outright,45,14,11,2,9,2,1,31,29,0,0,2,0
S01011801,Owned: Owned with a mortgage or loan or shared ownership,84,74,68,7,61,4,2,10,6,0,0,4,0
S01011801,Rented or living rent free: Total,124,73,50,20,30,4,19,51,16,4,10,18,3
S01011801,Rented or living rent free: Social rented,110,64,43,17,26,3,18,46,16,4,7,16,3
S01011801,Rented or living rent free: Private rented or living rent free,14,9,7,3,4,1,1,5,0,0,3,2,0
S01011802,All HRPs aged 16 and over,361,202,160,28,132,20,22,159,127,1,10,18,3
S01011802,Owned: Total,210,131,112,10,102,16,3,79,76,0,0,1,2
S01011802,Owned: Owned outright,93,22,20,1,19,2,0,71,68,0,0,1,2
S01011802,Owned: Owned with a mortgage or loan or shared ownership,117,109,92,9,83,14,3,8,8,0,0,0,0
S01011802,Rented or living rent free: Total,151,71,48,18,30,4,19,80,51,1,10,17,1
S01011802,Rented or living rent free: Social rented,127,60,40,15,25,4,16,67,47,0,7,12,1
S01011802,Rented or living rent free: Private rented or living rent free,24,11,8,3,5,0,3,13,4,1,3,5,0
S01011803,All HRPs aged 16 and over,236,154,116,23,93,21,17,82,57,2,4,13,6
S01011803,Owned: Total,145,100,78,9,69,15,7,45,38,2,1,2,2
S01011803,Owned: Owned outright,51,18,12,3,9,5,1,33,28,1,0,2,2
S01011803,Owned: Owned with a mortgage or loan or shared ownership,94,82,66,6,60,10,6,12,10,1,1,0,0
S01011803,Rented or living rent free: Total,91,54,38,14,24,6,10,37,19,0,3,11,4
S01011803,Rented or living rent free: Social rented,74,42,29,8,21,4,9,32,16,0,3,10,3
S01011803,Rented or living rent free: Private rented or living rent free,17,12,9,6,3,2,1,5,3,0,0,1,1
S01011804,All HRPs aged 16 and over,379,251,198,37,161,44,9,128,103,4,3,14,4
S01011804,Owned: Total,215,151,115,23,92,33,3,64,60,0,0,2,2
S01011804,Owned: Owned outright,120,59,39,10,29,17,3,61,58,0,0,2,1
S01011804,Owned: Owned with a mortgage or loan or shared ownership,95,92,76,13,63,16,0,3,2,0,0,0,1
S01011804,Rented or living rent free: Total,164,100,83,14,69,11,6,64,43,4,3,12,2
S01011804,Rented or living rent free: Social rented,117,67,55,13,42,7,5,50,39,0,2,7,2
S01011804,Rented or living rent free: Private rented or living rent free,47,33,28,1,27,4,1,14,4,4,1,5,0
S01011805,All HRPs aged 16 and over,279,182,132,23,109,44,6,97,86,5,1,3,2
S01011805,Owned: Total,172,105,75,15,60,28,2,67,65,0,0,1,1
S01011805,Owned: Owned outright,120,57,37,11,26,18,2,63,61,0,0,1,1
S01011805,Owned: Owned with a mortgage or loan or shared ownership,52,48,38,4,34,10,0,4,4,0,0,0,0
S01011805,Rented or living rent free: Total,107,77,57,8,49,16,4,30,21,5,1,2,1
S01011805,Rented or living rent free: Social rented,36,24,21,4,17,2,1,12,11,0,0,0,1
S01011805,Rented or living rent free: Private rented or living rent free,71,53,36,4,32,14,3,18,10,5,1,2,0
S01011806,All HRPs aged 16 and over,362,232,171,31,140,55,6,130,116,0,2,9,3
S01011806,Owned: Total,253,165,116,17,99,48,1,88,86,0,0,0,2
S01011806,Owned: Owned outright,164,81,53,12,41,28,0,83,82,0,0,0,1
S01011806,Owned: Owned with a mortgage or loan or shared ownership,89,84,63,5,58,20,1,5,4,0,0,0,1
S01011806,Rented or living rent free: Total,109,67,55,14,41,7,5,42,30,0,2,9,1
S01011806,Rented or living rent free: Social rented,61,31,26,7,19,3,2,30,20,0,2,7,1
S01011806,Rented or living rent free: Private rented or living rent free,48,36,29,7,22,4,3,12,10,0,0,2,0
S01011807,All HRPs aged 16 and over,444,327,206,40,166,121,0,117,106,1,1,6,3
S01011807,Owned: Total,363,269,165,30,135,104,0,94,90,0,1,2,1
S01011807,Owned: Owned outright,241,154,80,23,57,74,0,87,85,0,0,1,1
S01011807,Owned: Owned with a mortgage or loan or shared ownership,122,115,85,7,78,30,0,7,5,0,1,1,0
S01011807,Rented or living rent free: Total,81,58,41,10,31,17,0,23,16,1,0,4,2
S01011807,Rented or living rent free: Social rented,17,11,10,5,5,1,0,6,3,0,0,3,0
S01011807,Rented or living rent free: Private rented or living rent free,64,47,31,5,26,16,0,17,13,1,0,1,2
S01011808,All HRPs aged 16 and over,287,191,146,29,117,36,9,96,90,0,0,3,3
S01011808,Owned: Total,200,133,99,17,82,32,2,67,67,0,0,0,0
S01011808,Owned: Owned outright,117,58,39,10,29,18,1,59,59,0,0,0,0
S01011808,Owned: Owned with a mortgage or loan or shared ownership,83,75,60,7,53,14,1,8,8,0,0,0,0
S01011808,Rented or living rent free: Total,87,58,47,12,35,4,7,29,23,0,0,3,3
S01011808,Rented or living rent free: Social rented,50,32,26,9,17,1,5,18,13,0,0,2,3
S01011808,Rented or living rent free: Private rented or living rent free,37,26,21,3,18,3,2,11,10,0,0,1,0
S01011809,All HRPs aged 16 and over,302,228,167,32,135,60,1,74,67,1,2,2,2
S01011809,Owned: Total,246,183,134,26,108,49,0,63,60,1,0,1,1
S01011809,Owned: Owned outright,163,103,68,15,53,35,0,60,57,1,0,1,1
S01011809,Owned: Owned with a mortgage or loan or shared ownership,83,80,66,11,55,14,0,3,3,0,0,0,0
S01011809,Rented or living rent free: Total,56,45,33,6,27,11,1,11,7,0,2,1,1
S01011809,Rented or living rent free: Social rented,13,7,6,2,4,1,0,6,3,0,2,1,0
S01011809,Rented or living rent free: Private rented or living rent free,43,38,27,4,23,10,1,5,4,0,0,0,1
S01011810,All HRPs aged 16 and over,413,286,208,25,183,76,2,127,118,0,0,8,1
S01011810,Owned: Total,336,236,163,19,144,71,2,100,97,0,0,3,0
S01011810,Owned: Owned outright,220,129,74,15,59,53,2,91,90,0,0,1,0
S01011810,Owned: Owned with a mortgage or loan or shared ownership,116,107,89,4,85,18,0,9,7,0,0,2,0
S01011810,Rented or living rent free: Total,77,50,45,6,39,5,0,27,21,0,0,5,1
S01011810,Rented or living rent free: Social rented,33,18,17,3,14,1,0,15,12,0,0,2,1
S01011810,Rented or living rent free: Private rented or living rent free,44,32,28,3,25,4,0,12,9,0,0,3,0
S01011811,All HRPs aged 16 and over,436,303,191,23,168,107,5,133,124,0,2,5,2
S01011811,Owned: Total,369,258,161,15,146,97,0,111,108,0,1,1,1
S01011811,Owned: Owned outright,246,139,73,9,64,66,0,107,105,0,0,1,1
S01011811,Owned: Owned with a mortgage or loan or shared ownership,123,119,88,6,82,31,0,4,3,0,1,0,0
S01011811,Rented or living rent free: Total,67,45,30,8,22,10,5,22,16,0,1,4,1
S01011811,Rented or living rent free: Social rented,9,7,4,3,1,3,0,2,1,0,0,1,0
S01011811,Rented or living rent free: Private rented or living rent free,58,38,26,5,21,7,5,20,15,0,1,3,1
S01011812,All HRPs aged 16 and over,275,199,127,25,102,70,2,76,71,0,0,5,0
S01011812,Owned: Total,232,173,107,19,88,64,2,59,56,0,0,3,0
S01011812,Owned: Owned outright,138,87,41,10,31,44,2,51,49,0,0,2,0
S01011812,Owned: Owned with a mortgage or loan or shared ownership,94,86,66,9,57,20,0,8,7,0,0,1,0
S01011812,Rented or living rent free: Total,43,26,20,6,14,6,0,17,15,0,0,2,0
S01011812,Rented or living rent free: Social rented,7,2,2,2,0,0,0,5,4,0,0,1,0
S01011812,Rented or living rent free: Private rented or living rent free,36,24,18,4,14,6,0,12,11,0,0,1,0
S01011813,All HRPs aged 16 and over,306,230,161,14,147,66,3,76,71,0,1,4,0
S01011813,Owned: Total,246,181,121,8,113,58,2,65,62,0,1,2,0
S01011813,Owned: Owned outright,146,89,48,4,44,39,2,57,56,0,0,1,0
S01011813,Owned: Owned with a mortgage or loan or shared ownership,100,92,73,4,69,19,0,8,6,0,1,1,0
S01011813,Rented or living rent free: Total,60,49,40,6,34,8,1,11,9,0,0,2,0
S01011813,Rented or living rent free: Social rented,25,22,15,3,12,6,1,3,2,0,0,1,0
S01011813,Rented or living rent free: Private rented or living rent free,35,27,25,3,22,2,0,8,7,0,0,1,0
S01011814,All HRPs aged 16 and over,297,224,150,23,127,72,2,73,72,0,0,0,1
S01011814,Owned: Total,253,197,131,20,111,65,1,56,56,0,0,0,0
S01011814,Owned: Owned outright,156,100,53,12,41,47,0,56,56,0,0,0,0
S01011814,Owned: Owned with a mortgage or loan or shared ownership,97,97,78,8,70,18,1,0,0,0,0,0,0
S01011814,Rented or living rent free: Total,44,27,19,3,16,7,1,17,16,0,0,0,1
S01011814,Rented or living rent free: Social rented,13,9,7,2,5,2,0,4,3,0,0,0,1
S01011814,Rented or living rent free: Private rented or living rent free,31,18,12,1,11,5,1,13,13,0,0,0,0
S01011815,All HRPs aged 16 and over,313,237,180,30,150,49,8,76,62,1,2,7,4
S01011815,Owned: Total,250,194,146,18,128,44,4,56,53,0,0,2,1
S01011815,Owned: Owned outright,124,71,39,11,28,30,2,53,51,0,0,1,1
S01011815,Owned: Owned with a mortgage or loan or shared ownership,126,123,107,7,100,14,2,3,2,0,0,1,0
S01011815,Rented or living rent free: Total,63,43,34,12,22,5,4,20,9,1,2,5,3
S01011815,Rented or living rent free: Social rented,30,18,15,6,9,0,3,12,4,1,2,5,0
S01011815,Rented or living rent free: Private rented or living rent free,33,25,19,6,13,5,1,8,5,0,0,0,3
S01011816,All HRPs aged 16 and over,257,182,136,16,120,44,2,75,69,0,3,2,1
S01011816,Owned: Total,219,156,117,14,103,38,1,63,62,0,1,0,0
S01011816,Owned: Owned outright,131,70,45,11,34,24,1,61,60,0,1,0,0
S01011816,Owned: Owned with a mortgage or loan or shared ownership,88,86,72,3,69,14,0,2,2,0,0,0,0
S01011816,Rented or living rent free: Total,38,26,19,2,17,6,1,12,7,0,2,2,1
S01011816,Rented or living rent free: Social rented,5,3,1,0,1,1,1,2,1,0,0,1,0
S01011816,Rented or living rent free: Private rented or living rent free,33,23,18,2,16,5,0,10,6,0,2,1,1
S01011817,All HRPs aged 16 and over,294,225,162,14,148,61,2,69,64,1,0,2,2
S01011817,Owned: Total,244,189,135,10,125,53,1,55,52,0,0,1,2
S01011817,Owned: Owned outright,149,96,61,8,53,34,1,53,50,0,0,1,2
S01011817,Owned: Owned with a mortgage or loan or shared ownership,95,93,74,2,72,19,0,2,2,0,0,0,0
S01011817,Rented or living rent free: Total,50,36,27,4,23,8,1,14,12,1,0,1,0
S01011817,Rented or living rent free: Social rented,5,3,3,1,2,0,0,2,1,0,0,1,0
S01011817,Rented or living rent free: Private rented or living rent free,45,33,24,3,21,8,1,12,11,1,0,0,0
S01011818,All HRPs aged 16 and over,486,338,291,53,238,42,5,148,127,1,4,13,3
S01011818,Owned: Total,360,253,217,29,188,35,1,107,103,0,0,3,1
S01011818,Owned: Owned outright,187,94,79,16,63,14,1,93,92,0,0,0,1
S01011818,Owned: Owned with a mortgage or loan or shared ownership,173,159,138,13,125,21,0,14,11,0,0,3,0
S01011818,Rented or living rent free: Total,126,85,74,24,50,7,4,41,24,1,4,10,2
S01011818,Rented or living rent free: Social rented,81,52,46,17,29,3,3,29,12,1,4,10,2
S01011818,Rented or living rent free: Private rented or living rent free,45,33,28,7,21,4,1,12,12,0,0,0,0
S01011819,All HRPs aged 16 and over,438,286,246,47,199,31,9,152,128,2,7,15,0
S01011819,Owned: Total,275,189,166,31,135,20,3,86,81,0,1,4,0
S01011819,Owned: Owned outright,131,50,45,16,29,4,1,81,77,0,1,3,0
S01011819,Owned: Owned with a mortgage or loan or shared ownership,144,139,121,15,106,16,2,5,4,0,0,1,0
S01011819,Rented or living rent free: Total,163,97,80,16,64,11,6,66,47,2,6,11,0
S01011819,Rented or living rent free: Social rented,90,45,36,8,28,4,5,45,32,2,3,8,0
S01011819,Rented or living rent free: Private rented or living rent free,73,52,44,8,36,7,1,21,15,0,3,3,0
S01011820,All HRPs aged 16 and over,319,205,170,32,138,32,3,114,101,0,3,9,1
S01011820,Owned: Total,214,156,127,20,107,29,0,58,58,0,0,0,0
S01011820,Owned: Owned outright,100,47,36,15,21,11,0,53,53,0,0,0,0
S01011820,Owned: Owned with a mortgage or loan or shared ownership,114,109,91,5,86,18,0,5,5,0,0,0,0
S01011820,Rented or living rent free: Total,105,49,43,12,31,3,3,56,43,0,3,9,1
S01011820,Rented or living rent free: Social rented,63,18,15,6,9,0,3,45,33,0,3,8,1
S01011820,Rented or living rent free: Private rented or living rent free,42,31,28,6,22,3,0,11,10,0,0,1,0
S01011821,All HRPs aged 16 and over,223,143,119,15,104,14,10,80,47,5,4,20,4
S01011821,Owned: Total,86,58,51,4,47,7,0,28,27,0,0,0,1
S01011821,Owned: Owned outright,31,14,13,1,12,1,0,17,17,0,0,0,0
S01011821,Owned: Owned with a mortgage or loan or shared ownership,55,44,38,3,35,6,0,11,10,0,0,0,1
S01011821,Rented or living rent free: Total,137,85,68,11,57,7,10,52,20,5,4,20,3
S01011821,Rented or living rent free: Social rented,93,52,39,10,29,5,8,41,17,0,4,19,1
S01011821,Rented or living rent free: Private rented or living rent free,44,33,29,1,28,2,2,11,3,5,0,1,2
S01011822,All HRPs aged 16 and over,410,277,225,55,170,33,19,133,100,2,5,18,8
S01011822,Owned: Total,164,102,81,15,66,21,0,62,57,0,1,2,2
S01011822,Owned: Owned outright,96,40,30,7,23,10,0,56,53,0,0,2,1
S01011822,Owned: Owned with a mortgage or loan or shared ownership,68,62,51,8,43,11,0,6,4,0,1,0,1
S01011822,Rented or living rent free: Total,246,175,144,40,104,12,19,71,43,2,4,16,6
S01011822,Rented or living rent free: Social rented,107,57,43,23,20,3,11,50,28,2,3,11,6
S01011822,Rented or living rent free: Private rented or living rent free,139,118,101,17,84,9,8,21,15,0,1,5,0
S01011823,All HRPs aged 16 and over,290,197,172,34,138,22,3,93,77,0,3,12,1
S01011823,Owned: Total,184,129,112,12,100,16,1,55,54,0,0,1,0
S01011823,Owned: Owned outright,99,46,39,9,30,6,1,53,52,0,0,1,0
S01011823,Owned: Owned with a mortgage or loan or shared ownership,85,83,73,3,70,10,0,2,2,0,0,0,0
S01011823,Rented or living rent free: Total,106,68,60,22,38,6,2,38,23,0,3,11,1
S01011823,Rented or living rent free: Social rented,70,42,37,17,20,4,1,28,14,0,3,10,1
S01011823,Rented or living rent free: Private rented or living rent free,36,26,23,5,18,2,1,10,9,0,0,1,0
S01011824,All HRPs aged 16 and over,316,226,193,37,156,23,10,90,73,0,5,10,2
S01011824,Owned: Total,167,129,113,18,95,13,3,38,35,0,0,2,1
S01011824,Owned: Owned outright,79,43,33,6,27,10,0,36,33,0,0,2,1
S01011824,Owned: Owned with a mortgage or loan or shared ownership,88,86,80,12,68,3,3,2,2,0,0,0,0
S01011824,Rented or living rent free: Total,149,97,80,19,61,10,7,52,38,0,5,8,1
S01011824,Rented or living rent free: Social rented,111,64,51,15,36,6,7,47,36,0,4,6,1
S01011824,Rented or living rent free: Private rented or living rent free,38,33,29,4,25,4,0,5,2,0,1,2,0
S01011825,All HRPs aged 16 and over,275,177,155,26,129,20,2,98,86,5,1,6,0
S01011825,Owned: Total,171,108,93,11,82,15,0,63,63,0,0,0,0
S01011825,Owned: Owned outright,93,31,26,8,18,5,0,62,62,0,0,0,0
S01011825,Owned: Owned with a mortgage or loan or shared ownership,78,77,67,3,64,10,0,1,1,0,0,0,0
S01011825,Rented or living rent free: Total,104,69,62,15,47,5,2,35,23,5,1,6,0
S01011825,Rented or living rent free: Social rented,41,19,17,5,12,0,2,22,10,5,1,6,0
S01011825,Rented or living rent free: Private rented or living rent free,63,50,45,10,35,5,0,13,13,0,0,0,0
S01011826,All HRPs aged 16 and over,320,228,193,29,164,28,7,92,78,1,1,9,3
S01011826,Owned: Total,190,131,110,14,96,20,1,59,58,0,0,1,0
S01011826,Owned: Owned outright,107,49,39,9,30,10,0,58,57,0,0,1,0
S01011826,Owned: Owned with a mortgage or loan or shared ownership,83,82,71,5,66,10,1,1,1,0,0,0,0
S01011826,Rented or living rent free: Total,130,97,83,15,68,8,6,33,20,1,1,8,3
S01011826,Rented or living rent free: Social rented,64,40,33,9,24,2,5,24,12,1,1,8,2
S01011826,Rented or living rent free: Private rented or living rent free,66,57,50,6,44,6,1,9,8,0,0,0,1
S01011827,All HRPs aged 16 and over,289,151,95,23,72,50,6,138,115,0,1,18,4
S01011827,Owned: Total,194,104,59,14,45,41,4,90,84,0,0,5,1
S01011827,Owned: Owned outright,165,80,45,13,32,31,4,85,80,0,0,4,1
S01011827,Owned: Owned with a mortgage or loan or shared ownership,29,24,14,1,13,10,0,5,4,0,0,1,0
S01011827,Rented or living rent free: Total,95,47,36,9,27,9,2,48,31,0,1,13,3
S01011827,Rented or living rent free: Social rented,54,25,21,5,16,2,2,29,18,0,1,9,1
S01011827,Rented or living rent free: Private rented or living rent free,41,22,15,4,11,7,0,19,13,0,0,4,2
S01011828,All HRPs aged 16 and over,411,272,169,32,137,100,3,139,120,2,2,13,2
S01011828,Owned: Total,334,225,131,22,109,92,2,109,103,2,0,4,0
S01011828,Owned: Owned outright,231,127,62,18,44,63,2,104,98,2,0,4,0
S01011828,Owned: Owned with a mortgage or loan or shared ownership,103,98,69,4,65,29,0,5,5,0,0,0,0
S01011828,Rented or living rent free: Total,77,47,38,10,28,8,1,30,17,0,2,9,2
S01011828,Rented or living rent free: Social rented,23,10,10,4,6,0,0,13,8,0,1,2,2
S01011828,Rented or living rent free: Private rented or living rent free,54,37,28,6,22,8,1,17,9,0,1,7,0
S01011829,All HRPs aged 16 and over,195,143,103,19,84,40,0,52,47,0,0,4,1
S01011829,Owned: Total,153,116,80,15,65,36,0,37,34,0,0,2,1
S01011829,Owned: Owned outright,89,52,34,11,23,18,0,37,34,0,0,2,1
S01011829,Owned: Owned with a mortgage or loan or shared ownership,64,64,46,4,42,18,0,0,0,0,0,0,0
S01011829,Rented or living rent free: Total,42,27,23,4,19,4,0,15,13,0,0,2,0
S01011829,Rented or living rent free: Social rented,16,8,8,2,6,0,0,8,6,0,0,2,0
S01011829,Rented or living rent free: Private rented or living rent free,26,19,15,2,13,4,0,7,7,0,0,0,0
S01011830,All HRPs aged 16 and over,279,188,99,24,75,82,7,91,83,1,0,6,1
S01011830,Owned: Total,211,143,69,14,55,70,4,68,64,1,0,2,1
S01011830,Owned: Owned outright,155,93,36,9,27,54,3,62,58,1,0,2,1
S01011830,Owned: Owned with a mortgage or loan or shared ownership,56,50,33,5,28,16,1,6,6,0,0,0,0
S01011830,Rented or living rent free: Total,68,45,30,10,20,12,3,23,19,0,0,4,0
S01011830,Rented or living rent free: Social rented,34,20,12,7,5,8,0,14,11,0,0,3,0
S01011830,Rented or living rent free: Private rented or living rent free,34,25,18,3,15,4,3,9,8,0,0,1,0
S01011831,All HRPs aged 16 and over,425,242,112,38,74,118,12,183,162,4,9,7,1
S01011831,Owned: Total,333,193,82,31,51,104,7,140,128,3,5,3,1
S01011831,Owned: Owned outright,272,141,51,25,26,85,5,131,123,3,2,2,1
S01011831,Owned: Owned with a mortgage or loan or shared ownership,61,52,31,6,25,19,2,9,5,0,3,1,0
S01011831,Rented or living rent free: Total,92,49,30,7,23,14,5,43,34,1,4,4,0
S01011831,Rented or living rent free: Social rented,25,11,8,3,5,0,3,14,9,0,2,3,0
S01011831,Rented or living rent free: Private rented or living rent free,67,38,22,4,18,14,2,29,25,1,2,1,0
S01011832,All HRPs aged 16 and over,405,267,143,37,106,119,5,138,118,1,1,17,1
S01011832,Owned: Total,279,189,90,21,69,99,0,90,80,0,0,9,1
S01011832,Owned: Owned outright,222,137,54,18,36,83,0,85,76,0,0,8,1
S01011832,Owned: Owned with a mortgage or loan or shared ownership,57,52,36,3,33,16,0,5,4,0,0,1,0
S01011832,Rented or living rent free: Total,126,78,53,16,37,20,5,48,38,1,1,8,0
S01011832,Rented or living rent free: Social rented,52,25,17,8,9,6,2,27,19,1,0,7,0
S01011832,Rented or living rent free: Private rented or living rent free,74,53,36,8,28,14,3,21,19,0,1,1,0
S01011833,All HRPs aged 16 and over,360,251,174,18,156,72,5,109,96,0,5,7,1
S01011833,Owned: Total,317,224,156,17,139,65,3,93,87,0,2,4,0
S01011833,Owned: Owned outright,155,77,50,10,40,25,2,78,74,0,1,3,0
S01011833,Owned: Owned with a mortgage or loan or shared ownership,162,147,106,7,99,40,1,15,13,0,1,1,0
S01011833,Rented or living rent free: Total,43,27,18,1,17,7,2,16,9,0,3,3,1
S01011833,Rented or living rent free: Social rented,13,7,4,0,4,1,2,6,1,0,2,3,0
S01011833,Rented or living rent free: Private rented or living rent free,30,20,14,1,13,6,0,10,8,0,1,0,1
S01011834,All HRPs aged 16 and over,180,141,110,11,99,28,3,39,36,0,0,3,0
S01011834,Owned: Total,157,124,95,8,87,28,1,33,32,0,0,1,0
S01011834,Owned: Owned outright,66,37,25,5,20,12,0,29,29,0,0,0,0
S01011834,Owned: Owned with a mortgage or loan or shared ownership,91,87,70,3,67,16,1,4,3,0,0,1,0
S01011834,Rented or living rent free: Total,23,17,15,3,12,0,2,6,4,0,0,2,0
S01011834,Rented or living rent free: Social rented,8,6,5,2,3,0,1,2,0,0,0,2,0
S01011834,Rented or living rent free: Private rented or living rent free,15,11,10,1,9,0,1,4,4,0,0,0,0
S01011835,All HRPs aged 16 and over,278,216,162,12,150,47,7,62,56,0,2,1,3
S01011835,Owned: Total,240,187,142,11,131,41,4,53,49,0,2,1,1
S01011835,Owned: Owned outright,116,68,46,8,38,19,3,48,45,0,1,1,1
S01011835,Owned: Owned with a mortgage or loan or shared ownership,124,119,96,3,93,22,1,5,4,0,1,0,0
S01011835,Rented or living rent free: Total,38,29,20,1,19,6,3,9,7,0,0,0,2
S01011835,Rented or living rent free: Social rented,6,2,2,0,2,0,0,4,4,0,0,0,0
S01011835,Rented or living rent free: Private rented or living rent free,32,27,18,1,17,6,3,5,3,0,0,0,2
S01011836,All HRPs aged 16 and over,332,225,163,19,144,58,4,107,101,0,1,2,3
S01011836,Owned: Total,302,204,146,18,128,57,1,98,93,0,0,2,3
S01011836,Owned: Owned outright,180,96,59,13,46,36,1,84,82,0,0,0,2
S01011836,Owned: Owned with a mortgage or loan or shared ownership,122,108,87,5,82,21,0,14,11,0,0,2,1
S01011836,Rented or living rent free: Total,30,21,17,1,16,1,3,9,8,0,1,0,0
S01011836,Rented or living rent free: Social rented,13,11,8,1,7,0,3,2,2,0,0,0,0
S01011836,Rented or living rent free: Private rented or living rent free,17,10,9,0,9,1,0,7,6,0,1,0,0
S01011837,All HRPs aged 16 and over,255,184,130,16,114,53,1,71,64,1,1,4,1
S01011837,Owned: Total,214,154,105,11,94,48,1,60,57,1,1,1,0
S01011837,Owned: Owned outright,107,55,31,8,23,24,0,52,52,0,0,0,0
S01011837,Owned: Owned with a mortgage or loan or shared ownership,107,99,74,3,71,24,1,8,5,1,1,1,0
S01011837,Rented or living rent free: Total,41,30,25,5,20,5,0,11,7,0,0,3,1
S01011837,Rented or living rent free: Social rented,7,2,2,1,1,0,0,5,2,0,0,3,0
S01011837,Rented or living rent free: Private rented or living rent free,34,28,23,4,19,5,0,6,5,0,0,0,1
S01011838,All HRPs aged 16 and over,327,217,171,13,158,40,6,110,106,0,0,2,2
S01011838,Owned: Total,301,197,158,12,146,36,3,104,102,0,0,1,1
S01011838,Owned: Owned outright,164,67,55,9,46,10,2,97,95,0,0,1,1
S01011838,Owned: Owned with a mortgage or loan or shared ownership,137,130,103,3,100,26,1,7,7,0,0,0,0
S01011838,Rented or living rent free: Total,26,20,13,1,12,4,3,6,4,0,0,1,1
S01011838,Rented or living rent free: Social rented,6,3,2,1,1,0,1,3,1,0,0,1,1
S01011838,Rented or living rent free: Private rented or living rent free,20,17,11,0,11,4,2,3,3,0,0,0,0
S01011839,All HRPs aged 16 and over,444,285,233,32,201,47,5,159,146,1,3,5,4
S01011839,Owned: Total,380,245,200,26,174,41,4,135,133,0,0,1,1
S01011839,Owned: Owned outright,202,79,58,16,42,18,3,123,121,0,0,1,1
S01011839,Owned: Owned with a mortgage or loan or shared ownership,178,166,142,10,132,23,1,12,12,0,0,0,0
S01011839,Rented or living rent free: Total,64,40,33,6,27,6,1,24,13,1,3,4,3
S01011839,Rented or living rent free: Social rented,8,3,3,2,1,0,0,5,1,0,0,2,2
S01011839,Rented or living rent free: Private rented or living rent free,56,37,30,4,26,6,1,19,12,1,3,2,1
S01011840,All HRPs aged 16 and over,406,294,242,26,216,45,7,112,97,1,7,3,4
S01011840,Owned: Total,319,237,197,18,179,39,1,82,77,1,0,1,3
S01011840,Owned: Owned outright,148,75,60,16,44,14,1,73,70,1,0,0,2
S01011840,Owned: Owned with a mortgage or loan or shared ownership,171,162,137,2,135,25,0,9,7,0,0,1,1
S01011840,Rented or living rent free: Total,87,57,45,8,37,6,6,30,20,0,7,2,1
S01011840,Rented or living rent free: Social rented,51,29,19,5,14,4,6,22,15,0,5,2,0
S01011840,Rented or living rent free: Private rented or living rent free,36,28,26,3,23,2,0,8,5,0,2,0,1
S01011841,All HRPs aged 16 and over,415,266,213,34,179,47,6,149,131,0,4,14,0
S01011841,Owned: Total,271,190,152,15,137,36,2,81,77,0,2,2,0
S01011841,Owned: Owned outright,119,49,39,8,31,9,1,70,67,0,2,1,0
S01011841,Owned: Owned with a mortgage or loan or shared ownership,152,141,113,7,106,27,1,11,10,0,0,1,0
S01011841,Rented or living rent free: Total,144,76,61,19,42,11,4,68,54,0,2,12,0
S01011841,Rented or living rent free: Social rented,95,40,36,15,21,2,2,55,45,0,0,10,0
S01011841,Rented or living rent free: Private rented or living rent free,49,36,25,4,21,9,2,13,9,0,2,2,0
S01011842,All HRPs aged 16 and over,462,286,238,51,187,34,14,176,148,2,5,17,4
S01011842,Owned: Total,283,195,161,24,137,27,7,88,81,0,0,5,2
S01011842,Owned: Owned outright,126,54,40,12,28,12,2,72,70,0,0,2,0
S01011842,Owned: Owned with a mortgage or loan or shared ownership,157,141,121,12,109,15,5,16,11,0,0,3,2
S01011842,Rented or living rent free: Total,179,91,77,27,50,7,7,88,67,2,5,12,2
S01011842,Rented or living rent free: Social rented,142,65,57,26,31,4,4,77,61,1,4,9,2
S01011842,Rented or living rent free: Private rented or living rent free,37,26,20,1,19,3,3,11,6,1,1,3,0
S01011843,All HRPs aged 16 and over,415,300,177,15,162,117,6,115,102,1,3,7,2
S01011843,Owned: Total,348,253,145,12,133,105,3,95,89,0,3,2,1
S01011843,Owned: Owned outright,216,129,66,10,56,63,0,87,83,0,1,2,1
S01011843,Owned: Owned with a mortgage or loan or shared ownership,132,124,79,2,77,42,3,8,6,0,2,0,0
S01011843,Rented or living rent free: Total,67,47,32,3,29,12,3,20,13,1,0,5,1
S01011843,Rented or living rent free: Social rented,21,12,10,0,10,0,2,9,5,1,0,2,1
S01011843,Rented or living rent free: Private rented or living rent free,46,35,22,3,19,12,1,11,8,0,0,3,0
S01011844,All HRPs aged 16 and over,295,195,146,18,128,45,4,100,93,1,3,1,2
S01011844,Owned: Total,248,167,123,13,110,42,2,81,79,0,2,0,0
S01011844,Owned: Owned outright,133,56,34,6,28,20,2,77,77,0,0,0,0
S01011844,Owned: Owned with a mortgage or loan or shared ownership,115,111,89,7,82,22,0,4,2,0,2,0,0
S01011844,Rented or living rent free: Total,47,28,23,5,18,3,2,19,14,1,1,1,2
S01011844,Rented or living rent free: Social rented,13,8,7,2,5,0,1,5,3,0,0,1,1
S01011844,Rented or living rent free: Private rented or living rent free,34,20,16,3,13,3,1,14,11,1,1,0,1
S01011845,All HRPs aged 16 and over,382,252,202,42,160,46,4,130,119,2,1,7,1
S01011845,Owned: Total,255,174,135,18,117,36,3,81,79,0,0,1,1
S01011845,Owned: Owned outright,118,46,34,11,23,12,0,72,72,0,0,0,0
S01011845,Owned: Owned with a mortgage or loan or shared ownership,137,128,101,7,94,24,3,9,7,0,0,1,1
S01011845,Rented or living rent free: Total,127,78,67,24,43,10,1,49,40,2,1,6,0
S01011845,Rented or living rent free: Social rented,80,44,41,19,22,2,1,36,29,1,1,5,0
S01011845,Rented or living rent free: Private rented or living rent free,47,34,26,5,21,8,0,13,11,1,0,1,0
S01011846,All HRPs aged 16 and over,385,266,198,25,173,64,4,119,107,3,3,5,1
S01011846,Owned: Total,285,199,141,16,125,57,1,86,82,1,0,2,1
S01011846,Owned: Owned outright,159,80,51,10,41,28,1,79,77,0,0,1,1
S01011846,Owned: Owned with a mortgage or loan or shared ownership,126,119,90,6,84,29,0,7,5,1,0,1,0
S01011846,Rented or living rent free: Total,100,67,57,9,48,7,3,33,25,2,3,3,0
S01011846,Rented or living rent free: Social rented,41,20,18,3,15,1,1,21,15,1,3,2,0
S01011846,Rented or living rent free: Private rented or living rent free,59,47,39,6,33,6,2,12,10,1,0,1,0
S01011847,All HRPs aged 16 and over,178,131,85,5,80,45,1,47,45,0,1,1,0
S01011847,Owned: Total,156,112,73,5,68,38,1,44,43,0,1,0,0
S01011847,Owned: Owned outright,77,39,17,1,16,21,1,38,38,0,0,0,0
S01011847,Owned: Owned with a mortgage or loan or shared ownership,79,73,56,4,52,17,0,6,5,0,1,0,0
S01011847,Rented or living rent free: Total,22,19,12,0,12,7,0,3,2,0,0,1,0
S01011847,Rented or living rent free: Social rented,2,1,0,0,0,1,0,1,0,0,0,1,0
S01011847,Rented or living rent free: Private rented or living rent free,20,18,12,0,12,6,0,2,2,0,0,0,0
S01011848,All HRPs aged 16 and over,305,217,149,26,123,64,4,88,82,1,2,2,1
S01011848,Owned: Total,225,154,108,20,88,46,0,71,68,0,2,0,1
S01011848,Owned: Owned outright,134,71,46,16,30,25,0,63,61,0,1,0,1
S01011848,Owned: Owned with a mortgage or loan or shared ownership,91,83,62,4,58,21,0,8,7,0,1,0,0
S01011848,Rented or living rent free: Total,80,63,41,6,35,18,4,17,14,1,0,2,0
S01011848,Rented or living rent free: Social rented,30,21,15,3,12,3,3,9,6,1,0,2,0
S01011848,Rented or living rent free: Private rented or living rent free,50,42,26,3,23,15,1,8,8,0,0,0,0
S01011849,All HRPs aged 16 and over,352,255,201,19,182,49,5,97,78,1,4,10,4
S01011849,Owned: Total,253,183,145,9,136,37,1,70,63,1,2,1,3
S01011849,Owned: Owned outright,106,50,35,3,32,15,0,56,53,0,1,0,2
S01011849,Owned: Owned with a mortgage or loan or shared ownership,147,133,110,6,104,22,1,14,10,1,1,1,1
S01011849,Rented or living rent free: Total,99,72,56,10,46,12,4,27,15,0,2,9,1
S01011849,Rented or living rent free: Social rented,45,27,25,7,18,1,1,18,9,0,0,8,1
S01011849,Rented or living rent free: Private rented or living rent free,54,45,31,3,28,11,3,9,6,0,2,1,0
S01011850,All HRPs aged 16 and over,314,210,143,20,123,63,4,104,92,1,3,6,2
S01011850,Owned: Total,223,143,93,15,78,46,4,80,75,0,2,2,1
S01011850,Owned: Owned outright,128,59,30,6,24,27,2,69,67,0,1,1,0
S01011850,Owned: Owned with a mortgage or loan or shared ownership,95,84,63,9,54,19,2,11,8,0,1,1,1
S01011850,Rented or living rent free: Total,91,67,50,5,45,17,0,24,17,1,1,4,1
S01011850,Rented or living rent free: Social rented,6,0,0,0,0,0,0,6,2,1,0,3,0
S01011850,Rented or living rent free: Private rented or living rent free,85,67,50,5,45,17,0,18,15,0,1,1,1
S01011851,All HRPs aged 16 and over,368,260,179,28,151,69,12,108,92,0,3,12,1
S01011851,Owned: Total,211,151,109,13,96,39,3,60,56,0,2,1,1
S01011851,Owned: Owned outright,107,52,34,7,27,16,2,55,53,0,0,1,1
S01011851,Owned: Owned with a mortgage or loan or shared ownership,104,99,75,6,69,23,1,5,3,0,2,0,0
S01011851,Rented or living rent free: Total,157,109,70,15,55,30,9,48,36,0,1,11,0
S01011851,Rented or living rent free: Social rented,68,40,28,9,19,7,5,28,19,0,0,9,0
S01011851,Rented or living rent free: Private rented or living rent free,89,69,42,6,36,23,4,20,17,0,1,2,0
S01011852,All HRPs aged 16 and over,460,281,213,29,184,50,18,179,154,5,9,10,1
S01011852,Owned: Total,259,177,137,18,119,37,3,82,77,0,2,2,1
S01011852,Owned: Owned outright,116,44,30,8,22,12,2,72,70,0,1,1,0
S01011852,Owned: Owned with a mortgage or loan or shared ownership,143,133,107,10,97,25,1,10,7,0,1,1,1
S01011852,Rented or living rent free: Total,201,104,76,11,65,13,15,97,77,5,7,8,0
S01011852,Rented or living rent free: Social rented,132,53,38,7,31,3,12,79,68,5,1,5,0
S01011852,Rented or living rent free: Private rented or living rent free,69,51,38,4,34,10,3,18,9,0,6,3,0
S01011853,All HRPs aged 16 and over,304,219,175,25,150,35,9,85,65,1,7,8,4
S01011853,Owned: Total,219,153,120,13,107,31,2,66,62,0,2,2,0
S01011853,Owned: Owned outright,103,46,32,7,25,14,0,57,54,0,2,1,0
S01011853,Owned: Owned with a mortgage or loan or shared ownership,116,107,88,6,82,17,2,9,8,0,0,1,0
S01011853,Rented or living rent free: Total,85,66,55,12,43,4,7,19,3,1,5,6,4
S01011853,Rented or living rent free: Social rented,23,15,10,2,8,1,4,8,2,1,0,3,2
S01011853,Rented or living rent free: Private rented or living rent free,62,51,45,10,35,3,3,11,1,0,5,3,2
S01011854,All HRPs aged 16 and over,356,205,164,33,131,37,4,151,148,2,0,1,0
S01011854,Owned: Total,263,130,98,20,78,29,3,133,133,0,0,0,0
S01011854,Owned: Owned outright,176,57,41,14,27,15,1,119,119,0,0,0,0
S01011854,Owned: Owned with a mortgage or loan or shared ownership,87,73,57,6,51,14,2,14,14,0,0,0,0
S01011854,Rented or living rent free: Total,93,75,66,13,53,8,1,18,15,2,0,1,0
S01011854,Rented or living rent free: Social rented,39,28,23,8,15,4,1,11,10,1,0,0,0
S01011854,Rented or living rent free: Private rented or living rent free,54,47,43,5,38,4,0,7,5,1,0,1,0
S01011855,All HRPs aged 16 and over,364,230,187,42,145,37,6,134,113,1,5,12,3
S01011855,Owned: Total,213,152,121,21,100,30,1,61,57,1,0,2,1
S01011855,Owned: Owned outright,92,43,32,14,18,11,0,49,47,0,0,1,1
S01011855,Owned: Owned with a mortgage or loan or shared ownership,121,109,89,7,82,19,1,12,10,1,0,1,0
S01011855,Rented or living rent free: Total,151,78,66,21,45,7,5,73,56,0,5,10,2
S01011855,Rented or living rent free: Social rented,125,58,50,21,29,5,3,67,51,0,4,10,2
S01011855,Rented or living rent free: Private rented or living rent free,26,20,16,0,16,2,2,6,5,0,1,0,0
S01011856,All HRPs aged 16 and over,309,162,110,23,87,48,4,147,142,0,4,0,1
S01011856,Owned: Total,290,151,101,21,80,47,3,139,137,0,1,0,1
S01011856,Owned: Owned outright,182,56,31,14,17,24,1,126,125,0,0,0,1
S01011856,Owned: Owned with a mortgage or loan or shared ownership,108,95,70,7,63,23,2,13,12,0,1,0,0
S01011856,Rented or living rent free: Total,19,11,9,2,7,1,1,8,5,0,3,0,0
S01011856,Rented or living rent free: Social rented,2,0,0,0,0,0,0,2,0,0,2,0,0
S01011856,Rented or living rent free: Private rented or living rent free,17,11,9,2,7,1,1,6,5,0,1,0,0
S01011857,All HRPs aged 16 and over,301,209,134,30,104,74,1,92,87,1,2,0,2
S01011857,Owned: Total,175,123,78,14,64,45,0,52,50,1,1,0,0
S01011857,Owned: Owned outright,107,59,40,13,27,19,0,48,47,0,1,0,0
S01011857,Owned: Owned with a mortgage or loan or shared ownership,68,64,38,1,37,26,0,4,3,1,0,0,0
S01011857,Rented or living rent free: Total,126,86,56,16,40,29,1,40,37,0,1,0,2
S01011857,Rented or living rent free: Social rented,36,16,14,5,9,2,0,20,17,0,1,0,2
S01011857,Rented or living rent free: Private rented or living rent free,90,70,42,11,31,27,1,20,20,0,0,0,0
S01011858,All HRPs aged 16 and over,403,200,128,34,94,71,1,203,189,0,4,8,2
S01011858,Owned: Total,329,150,86,20,66,64,0,179,175,0,1,3,0
S01011858,Owned: Owned outright,237,66,33,12,21,33,0,171,168,0,1,2,0
S01011858,Owned: Owned with a mortgage or loan or shared ownership,92,84,53,8,45,31,0,8,7,0,0,1,0
S01011858,Rented or living rent free: Total,74,50,42,14,28,7,1,24,14,0,3,5,2
S01011858,Rented or living rent free: Social rented,31,17,13,5,8,3,1,14,7,0,2,5,0
S01011858,Rented or living rent free: Private rented or living rent free,43,33,29,9,20,4,0,10,7,0,1,0,2
S01011859,All HRPs aged 16 and over,446,186,130,27,103,49,7,260,233,1,1,15,10
S01011859,Owned: Total,279,119,81,17,64,34,4,160,151,1,0,4,4
S01011859,Owned: Owned outright,193,45,27,11,16,16,2,148,140,0,0,4,4
S01011859,Owned: Owned with a mortgage or loan or shared ownership,86,74,54,6,48,18,2,12,11,1,0,0,0
S01011859,Rented or living rent free: Total,167,67,49,10,39,15,3,100,82,0,1,11,6
S01011859,Rented or living rent free: Social rented,129,43,32,7,25,8,3,86,70,0,1,10,5
S01011859,Rented or living rent free: Private rented or living rent free,38,24,17,3,14,7,0,14,12,0,0,1,1
S01011860,All HRPs aged 16 and over,206,165,108,14,94,48,9,41,38,0,1,1,1
S01011860,Owned: Total,100,75,43,7,36,30,2,25,25,0,0,0,0
S01011860,Owned: Owned outright,64,40,17,5,12,22,1,24,24,0,0,0,0
S01011860,Owned: Owned with a mortgage or loan or shared ownership,36,35,26,2,24,8,1,1,1,0,0,0,0
S01011860,Rented or living rent free: Total,106,90,65,7,58,18,7,16,13,0,1,1,1
S01011860,Rented or living rent free: Social rented,3,1,1,0,1,0,0,2,1,0,0,1,0
S01011860,Rented or living rent free: Private rented or living rent free,103,89,64,7,57,18,7,14,12,0,1,0,1
S01011861,All HRPs aged 16 and over,343,222,144,23,121,72,6,121,114,0,2,4,1
S01011861,Owned: Total,231,133,85,16,69,47,1,98,96,0,0,1,1
S01011861,Owned: Owned outright,155,65,42,13,29,22,1,90,89,0,0,0,1
S01011861,Owned: Owned with a mortgage or loan or shared ownership,76,68,43,3,40,25,0,8,7,0,0,1,0
S01011861,Rented or living rent free: Total,112,89,59,7,52,25,5,23,18,0,2,3,0
S01011861,Rented or living rent free: Social rented,8,5,4,3,1,0,1,3,2,0,1,0,0
S01011861,Rented or living rent free: Private rented or living rent free,104,84,55,4,51,25,4,20,16,0,1,3,0
S01011862,All HRPs aged 16 and over,425,224,168,12,156,48,8,201,191,0,2,5,3
S01011862,Owned: Total,370,193,145,10,135,44,4,177,172,0,0,3,2
S01011862,Owned: Owned outright,243,81,58,6,52,20,3,162,157,0,0,3,2
S01011862,Owned: Owned with a mortgage or loan or shared ownership,127,112,87,4,83,24,1,15,15,0,0,0,0
S01011862,Rented or living rent free: Total,55,31,23,2,21,4,4,24,19,0,2,2,1
S01011862,Rented or living rent free: Social rented,25,10,9,2,7,1,0,15,14,0,0,0,1
S01011862,Rented or living rent free: Private rented or living rent free,30,21,14,0,14,3,4,9,5,0,2,2,0
S01011863,All HRPs aged 16 and over,328,208,152,23,129,48,8,120,110,1,4,3,2
S01011863,Owned: Total,237,149,107,13,94,39,3,88,87,1,0,0,0
S01011863,Owned: Owned outright,139,58,37,9,28,20,1,81,80,1,0,0,0
S01011863,Owned: Owned with a mortgage or loan or shared ownership,98,91,70,4,66,19,2,7,7,0,0,0,0
S01011863,Rented or living rent free: Total,91,59,45,10,35,9,5,32,23,0,4,3,2
S01011863,Rented or living rent free: Social rented,44,17,14,4,10,1,2,27,19,0,4,3,1
S01011863,Rented or living rent free: Private rented or living rent free,47,42,31,6,25,8,3,5,4,0,0,0,1
S01011864,All HRPs aged 16 and over,315,189,144,25,119,43,2,126,123,0,0,3,0
S01011864,Owned: Total,295,175,133,23,110,41,1,120,119,0,0,1,0
S01011864,Owned: Owned outright,183,69,50,15,35,18,1,114,113,0,0,1,0
S01011864,Owned: Owned with a mortgage or loan or shared ownership,112,106,83,8,75,23,0,6,6,0,0,0,0
S01011864,Rented or living rent free: Total,20,14,11,2,9,2,1,6,4,0,0,2,0
S01011864,Rented or living rent free: Social rented,2,1,1,0,1,0,0,1,1,0,0,0,0
S01011864,Rented or living rent free: Private rented or living rent free,18,13,10,2,8,2,1,5,3,0,0,2,0
S01011865,All HRPs aged 16 and over,291,169,124,13,111,34,11,122,108,0,4,9,1
S01011865,Owned: Total,207,127,94,8,86,30,3,80,74,0,3,2,1
S01011865,Owned: Owned outright,123,52,36,4,32,15,1,71,65,0,3,2,1
S01011865,Owned: Owned with a mortgage or loan or shared ownership,84,75,58,4,54,15,2,9,9,0,0,0,0
S01011865,Rented or living rent free: Total,84,42,30,5,25,4,8,42,34,0,1,7,0
S01011865,Rented or living rent free: Social rented,48,19,12,2,10,1,6,29,23,0,0,6,0
S01011865,Rented or living rent free: Private rented or living rent free,36,23,18,3,15,3,2,13,11,0,1,1,0
S01011866,All HRPs aged 16 and over,341,225,174,32,142,47,4,116,106,1,3,3,3
S01011866,Owned: Total,249,164,125,19,106,39,0,85,82,0,0,1,2
S01011866,Owned: Owned outright,142,61,45,15,30,16,0,81,80,0,0,0,1
S01011866,Owned: Owned with a mortgage or loan or shared ownership,107,103,80,4,76,23,0,4,2,0,0,1,1
S01011866,Rented or living rent free: Total,92,61,49,13,36,8,4,31,24,1,3,2,1
S01011866,Rented or living rent free: Social rented,68,47,40,11,29,3,4,21,16,1,1,2,1
S01011866,Rented or living rent free: Private rented or living rent free,24,14,9,2,7,5,0,10,8,0,2,0,0
S01011867,All HRPs aged 16 and over,444,274,228,40,188,39,7,170,135,2,7,20,6
S01011867,Owned: Total,214,162,135,15,120,26,1,52,49,0,0,2,1
S01011867,Owned: Owned outright,74,33,24,6,18,8,1,41,38,0,0,2,1
S01011867,Owned: Owned with a mortgage or loan or shared ownership,140,129,111,9,102,18,0,11,11,0,0,0,0
S01011867,Rented or living rent free: Total,230,112,93,25,68,13,6,118,86,2,7,18,5
S01011867,Rented or living rent free: Social rented,195,89,73,23,50,10,6,106,78,2,5,16,5
S01011867,Rented or living rent free: Private rented or living rent free,35,23,20,2,18,3,0,12,8,0,2,2,0
S01011868,All HRPs aged 16 and over,416,266,204,39,165,48,14,150,124,0,8,17,1
S01011868,Owned: Total,276,170,127,23,104,41,2,106,104,0,0,2,0
S01011868,Owned: Owned outright,159,58,44,15,29,13,1,101,100,0,0,1,0
S01011868,Owned: Owned with a mortgage or loan or shared ownership,117,112,83,8,75,28,1,5,4,0,0,1,0
S01011868,Rented or living rent free: Total,140,96,77,16,61,7,12,44,20,0,8,15,1
S01011868,Rented or living rent free: Social rented,69,36,25,7,18,2,9,33,15,0,5,12,1
S01011868,Rented or living rent free: Private rented or living rent free,71,60,52,9,43,5,3,11,5,0,3,3,0
S01011869,All HRPs aged 16 and over,409,278,212,29,183,53,13,131,109,2,2,16,2
S01011869,Owned: Total,245,151,109,9,100,38,4,94,89,0,0,3,2
S01011869,Owned: Owned outright,130,50,27,5,22,23,0,80,78,0,0,2,0
S01011869,Owned: Owned with a mortgage or loan or shared ownership,115,101,82,4,78,15,4,14,11,0,0,1,2
S01011869,Rented or living rent free: Total,164,127,103,20,83,15,9,37,20,2,2,13,0
S01011869,Rented or living rent free: Social rented,30,20,15,4,11,3,2,10,3,1,1,5,0
S01011869,Rented or living rent free: Private rented or living rent free,134,107,88,16,72,12,7,27,17,1,1,8,0
S01011870,All HRPs aged 16 and over,315,198,155,33,122,33,10,117,85,0,12,18,2
S01011870,Owned: Total,183,116,90,14,76,24,2,67,63,0,2,1,1
S01011870,Owned: Owned outright,102,41,32,9,23,8,1,61,58,0,2,1,0
S01011870,Owned: Owned with a mortgage or loan or shared ownership,81,75,58,5,53,16,1,6,5,0,0,0,1
S01011870,Rented or living rent free: Total,132,82,65,19,46,9,8,50,22,0,10,17,1
S01011870,Rented or living rent free: Social rented,86,48,36,14,22,5,7,38,17,0,8,13,0
S01011870,Rented or living rent free: Private rented or living rent free,46,34,29,5,24,4,1,12,5,0,2,4,1
S01011871,All HRPs aged 16 and over,438,331,222,32,190,96,13,107,91,1,3,6,6
S01011871,Owned: Total,261,198,123,15,108,71,4,63,60,0,1,0,2
S01011871,Owned: Owned outright,131,74,31,4,27,42,1,57,54,0,1,0,2
S01011871,Owned: Owned with a mortgage or loan or shared ownership,130,124,92,11,81,29,3,6,6,0,0,0,0
S01011871,Rented or living rent free: Total,177,133,99,17,82,25,9,44,31,1,2,6,4
S01011871,Rented or living rent free: Social rented,55,34,29,7,22,2,3,21,12,1,1,4,3
S01011871,Rented or living rent free: Private rented or living rent free,122,99,70,10,60,23,6,23,19,0,1,2,1
S01011872,All HRPs aged 16 and over,365,283,187,25,162,91,5,82,72,2,1,4,3
S01011872,Owned: Total,277,207,131,18,113,74,2,70,66,2,1,0,1
S01011872,Owned: Owned outright,146,85,45,14,31,39,1,61,59,1,0,0,1
S01011872,Owned: Owned with a mortgage or loan or shared ownership,131,122,86,4,82,35,1,9,7,1,1,0,0
S01011872,Rented or living rent free: Total,88,76,56,7,49,17,3,12,6,0,0,4,2
S01011872,Rented or living rent free: Social rented,9,5,3,1,2,1,1,4,2,0,0,1,1
S01011872,Rented or living rent free: Private rented or living rent free,79,71,53,6,47,16,2,8,4,0,0,3,1
S01011873,All HRPs aged 16 and over,339,260,205,20,185,50,5,79,69,0,6,3,1
S01011873,Owned: Total,221,164,129,15,114,33,2,57,53,0,3,1,0
S01011873,Owned: Owned outright,103,55,41,11,30,13,1,48,46,0,2,0,0
S01011873,Owned: Owned with a mortgage or loan or shared ownership,118,109,88,4,84,20,1,9,7,0,1,1,0
S01011873,Rented or living rent free: Total,118,96,76,5,71,17,3,22,16,0,3,2,1
S01011873,Rented or living rent free: Social rented,4,2,1,1,0,1,0,2,1,0,0,1,0
S01011873,Rented or living rent free: Private rented or living rent free,114,94,75,4,71,16,3,20,15,0,3,1,1
S01011874,All HRPs aged 16 and over,285,206,168,23,145,35,3,79,68,1,1,5,4
S01011874,Owned: Total,229,175,146,14,132,28,1,54,53,0,0,1,0
S01011874,Owned: Owned outright,89,46,36,6,30,9,1,43,43,0,0,0,0
S01011874,Owned: Owned with a mortgage or loan or shared ownership,140,129,110,8,102,19,0,11,10,0,0,1,0
S01011874,Rented or living rent free: Total,56,31,22,9,13,7,2,25,15,1,1,4,4
S01011874,Rented or living rent free: Social rented,31,14,10,6,4,2,2,17,10,0,1,3,3
S01011874,Rented or living rent free: Private rented or living rent free,25,17,12,3,9,5,0,8,5,1,0,1,1
S01011875,All HRPs aged 16 and over,322,180,152,22,130,26,2,142,136,0,0,4,2
S01011875,Owned: Total,218,127,108,12,96,19,0,91,89,0,0,1,1
S01011875,Owned: Owned outright,113,36,29,7,22,7,0,77,75,0,0,1,1
S01011875,Owned: Owned with a mortgage or loan or shared ownership,105,91,79,5,74,12,0,14,14,0,0,0,0
S01011875,Rented or living rent free: Total,104,53,44,10,34,7,2,51,47,0,0,3,1
S01011875,Rented or living rent free: Social rented,63,22,18,3,15,3,1,41,38,0,0,2,1
S01011875,Rented or living rent free: Private rented or living rent free,41,31,26,7,19,4,1,10,9,0,0,1,0
S01011876,All HRPs aged 16 and over,398,289,212,28,184,72,5,109,94,0,5,8,2
S01011876,Owned: Total,248,181,133,13,120,46,2,67,63,0,2,1,1
S01011876,Owned: Owned outright,140,80,50,10,40,30,0,60,58,0,1,0,1
S01011876,Owned: Owned with a mortgage or loan or shared ownership,108,101,83,3,80,16,2,7,5,0,1,1,0
S01011876,Rented or living rent free: Total,150,108,79,15,64,26,3,42,31,0,3,7,1
S01011876,Rented or living rent free: Social rented,35,11,11,3,8,0,0,24,17,0,1,6,0
S01011876,Rented or living rent free: Private rented or living rent free,115,97,68,12,56,26,3,18,14,0,2,1,1
S01011877,All HRPs aged 16 and over,262,163,125,23,102,35,3,99,95,3,0,1,0
S01011877,Owned: Total,181,109,87,12,75,20,2,72,72,0,0,0,0
S01011877,Owned: Owned outright,105,44,32,8,24,10,2,61,61,0,0,0,0
S01011877,Owned: Owned with a mortgage or loan or shared ownership,76,65,55,4,51,10,0,11,11,0,0,0,0
S01011877,Rented or living rent free: Total,81,54,38,11,27,15,1,27,23,3,0,1,0
S01011877,Rented or living rent free: Social rented,25,10,8,4,4,2,0,15,13,2,0,0,0
S01011877,Rented or living rent free: Private rented or living rent free,56,44,30,7,23,13,1,12,10,1,0,1,0
S01011878,All HRPs aged 16 and over,379,273,203,29,174,63,7,106,96,0,5,2,3
S01011878,Owned: Total,244,165,116,14,102,46,3,79,76,0,1,0,2
S01011878,Owned: Owned outright,141,74,41,8,33,32,1,67,64,0,1,0,2
S01011878,Owned: Owned with a mortgage or loan or shared ownership,103,91,75,6,69,14,2,12,12,0,0,0,0
S01011878,Rented or living rent free: Total,135,108,87,15,72,17,4,27,20,0,4,2,1
S01011878,Rented or living rent free: Social rented,21,7,7,6,1,0,0,14,12,0,1,0,1
S01011878,Rented or living rent free: Private rented or living rent free,114,101,80,9,71,17,4,13,8,0,3,2,0
S01011879,All HRPs aged 16 and over,218,159,113,18,95,41,5,59,54,1,2,1,1
S01011879,Owned: Total,198,143,103,18,85,37,3,55,52,0,2,0,1
S01011879,Owned: Owned outright,102,51,31,9,22,19,1,51,51,0,0,0,0
S01011879,Owned: Owned with a mortgage or loan or shared ownership,96,92,72,9,63,18,2,4,1,0,2,0,1
S01011879,Rented or living rent free: Total,20,16,10,0,10,4,2,4,2,1,0,1,0
S01011879,Rented or living rent free: Social rented,3,1,1,0,1,0,0,2,2,0,0,0,0
S01011879,Rented or living rent free: Private rented or living rent free,17,15,9,0,9,4,2,2,0,1,0,1,0
S01011880,All HRPs aged 16 and over,241,173,124,13,111,45,4,68,61,2,1,4,0
S01011880,Owned: Total,187,138,98,10,88,40,0,49,45,2,0,2,0
S01011880,Owned: Owned outright,104,62,32,7,25,30,0,42,38,2,0,2,0
S01011880,Owned: Owned with a mortgage or loan or shared ownership,83,76,66,3,63,10,0,7,7,0,0,0,0
S01011880,Rented or living rent free: Total,54,35,26,3,23,5,4,19,16,0,1,2,0
S01011880,Rented or living rent free: Social rented,22,10,8,3,5,1,1,12,10,0,1,1,0
S01011880,Rented or living rent free: Private rented or living rent free,32,25,18,0,18,4,3,7,6,0,0,1,0
S01011881,All HRPs aged 16 and over,371,253,201,26,175,43,9,118,104,2,1,6,5
S01011881,Owned: Total,258,168,137,13,124,28,3,90,87,1,0,0,2
S01011881,Owned: Owned outright,120,36,27,4,23,8,1,84,82,1,0,0,1
S01011881,Owned: Owned with a mortgage or loan or shared ownership,138,132,110,9,101,20,2,6,5,0,0,0,1
S01011881,Rented or living rent free: Total,113,85,64,13,51,15,6,28,17,1,1,6,3
S01011881,Rented or living rent free: Social rented,52,35,30,8,22,4,1,17,7,1,1,5,3
S01011881,Rented or living rent free: Private rented or living rent free,61,50,34,5,29,11,5,11,10,0,0,1,0
S01011882,All HRPs aged 16 and over,450,243,205,36,169,32,6,207,186,1,1,13,6
S01011882,Owned: Total,300,183,157,20,137,23,3,117,114,0,0,0,3
S01011882,Owned: Owned outright,151,48,40,13,27,6,2,103,101,0,0,0,2
S01011882,Owned: Owned with a mortgage or loan or shared ownership,149,135,117,7,110,17,1,14,13,0,0,0,1
S01011882,Rented or living rent free: Total,150,60,48,16,32,9,3,90,72,1,1,13,3
S01011882,Rented or living rent free: Social rented,124,41,33,14,19,5,3,83,65,1,1,13,3
S01011882,Rented or living rent free: Private rented or living rent free,26,19,15,2,13,4,0,7,7,0,0,0,0
S01011883,All HRPs aged 16 and over,439,315,257,33,224,53,5,124,112,2,1,5,4
S01011883,Owned: Total,354,254,210,24,186,42,2,100,91,1,1,4,3
S01011883,Owned: Owned outright,168,79,57,14,43,20,2,89,83,1,0,3,2
S01011883,Owned: Owned with a mortgage or loan or shared ownership,186,175,153,10,143,22,0,11,8,0,1,1,1
S01011883,Rented or living rent free: Total,85,61,47,9,38,11,3,24,21,1,0,1,1
S01011883,Rented or living rent free: Social rented,32,18,13,7,6,3,2,14,11,1,0,1,1
S01011883,Rented or living rent free: Private rented or living rent free,53,43,34,2,32,8,1,10,10,0,0,0,0
S01011884,All HRPs aged 16 and over,169,128,88,8,80,37,3,41,38,0,1,1,1
S01011884,Owned: Total,133,100,68,7,61,31,1,33,31,0,0,1,1
S01011884,Owned: Owned outright,72,43,26,2,24,16,1,29,29,0,0,0,0
S01011884,Owned: Owned with a mortgage or loan or shared ownership,61,57,42,5,37,15,0,4,2,0,0,1,1
S01011884,Rented or living rent free: Total,36,28,20,1,19,6,2,8,7,0,1,0,0
S01011884,Rented or living rent free: Social rented,2,1,0,0,0,0,1,1,1,0,0,0,0
S01011884,Rented or living rent free: Private rented or living rent free,34,27,20,1,19,6,1,7,6,0,1,0,0
S01011885,All HRPs aged 16 and over,270,210,161,11,150,47,2,60,59,0,0,1,0
S01011885,Owned: Total,236,185,137,8,129,46,2,51,51,0,0,0,0
S01011885,Owned: Owned outright,91,46,26,3,23,19,1,45,45,0,0,0,0
S01011885,Owned: Owned with a mortgage or loan or shared ownership,145,139,111,5,106,27,1,6,6,0,0,0,0
S01011885,Rented or living rent free: Total,34,25,24,3,21,1,0,9,8,0,0,1,0
S01011885,Rented or living rent free: Social rented,10,2,2,0,2,0,0,8,7,0,0,1,0
S01011885,Rented or living rent free: Private rented or living rent free,24,23,22,3,19,1,0,1,1,0,0,0,0
S01011886,All HRPs aged 16 and over,368,242,191,24,167,45,6,126,108,2,6,8,2
S01011886,Owned: Total,290,195,150,13,137,42,3,95,90,1,3,0,1
S01011886,Owned: Owned outright,139,53,38,6,32,13,2,86,82,1,2,0,1
S01011886,Owned: Owned with a mortgage or loan or shared ownership,151,142,112,7,105,29,1,9,8,0,1,0,0
S01011886,Rented or living rent free: Total,78,47,41,11,30,3,3,31,18,1,3,8,1
S01011886,Rented or living rent free: Social rented,50,29,26,10,16,0,3,21,9,1,3,7,1
S01011886,Rented or living rent free: Private rented or living rent free,28,18,15,1,14,3,0,10,9,0,0,1,0
S01011887,All HRPs aged 16 and over,230,147,118,17,101,29,0,83,70,1,4,5,3
S01011887,Owned: Total,170,117,94,13,81,23,0,53,48,0,1,3,1
S01011887,Owned: Owned outright,81,34,22,6,16,12,0,47,44,0,1,1,1
S01011887,Owned: Owned with a mortgage or loan or shared ownership,89,83,72,7,65,11,0,6,4,0,0,2,0
S01011887,Rented or living rent free: Total,60,30,24,4,20,6,0,30,22,1,3,2,2
S01011887,Rented or living rent free: Social rented,44,21,17,2,15,4,0,23,19,0,1,2,1
S01011887,Rented or living rent free: Private rented or living rent free,16,9,7,2,5,2,0,7,3,1,2,0,1
S01011888,All HRPs aged 16 and over,369,257,220,68,152,23,14,112,84,4,2,18,4
S01011888,Owned: Total,213,158,139,32,107,16,3,55,48,0,1,6,0
S01011888,Owned: Owned outright,89,45,35,15,20,9,1,44,40,0,0,4,0
S01011888,Owned: Owned with a mortgage or loan or shared ownership,124,113,104,17,87,7,2,11,8,0,1,2,0
S01011888,Rented or living rent free: Total,156,99,81,36,45,7,11,57,36,4,1,12,4
S01011888,Rented or living rent free: Social rented,129,78,67,31,36,5,6,51,32,3,1,11,4
S01011888,Rented or living rent free: Private rented or living rent free,27,21,14,5,9,2,5,6,4,1,0,1,0
S01011889,All HRPs aged 16 and over,430,240,199,25,174,37,4,190,171,1,3,9,6
S01011889,Owned: Total,337,189,157,20,137,32,0,148,140,0,1,3,4
S01011889,Owned: Owned outright,194,58,43,8,35,15,0,136,128,0,1,3,4
S01011889,Owned: Owned with a mortgage or loan or shared ownership,143,131,114,12,102,17,0,12,12,0,0,0,0
S01011889,Rented or living rent free: Total,93,51,42,5,37,5,4,42,31,1,2,6,2
S01011889,Rented or living rent free: Social rented,50,20,15,2,13,3,2,30,22,0,1,5,2
S01011889,Rented or living rent free: Private rented or living rent free,43,31,27,3,24,2,2,12,9,1,1,1,0
S01011890,All HRPs aged 16 and over,300,216,178,25,153,32,6,84,74,0,1,8,1
S01011890,Owned: Total,228,172,142,19,123,29,1,56,56,0,0,0,0
S01011890,Owned: Owned outright,101,50,41,12,29,9,0,51,51,0,0,0,0
S01011890,Owned: Owned with a mortgage or loan or shared ownership,127,122,101,7,94,20,1,5,5,0,0,0,0
S01011890,Rented or living rent free: Total,72,44,36,6,30,3,5,28,18,0,1,8,1
S01011890,Rented or living rent free: Social rented,26,8,5,2,3,0,3,18,12,0,0,6,0
S01011890,Rented or living rent free: Private rented or living rent free,46,36,31,4,27,3,2,10,6,0,1,2,1
S01011891,All HRPs aged 16 and over,378,218,186,37,149,15,17,160,112,2,6,30,10
S01011891,Owned: Total,152,106,91,14,77,11,4,46,40,0,0,3,3
S01011891,Owned: Owned outright,61,24,17,5,12,5,2,37,35,0,0,1,1
S01011891,Owned: Owned with a mortgage or loan or shared ownership,91,82,74,9,65,6,2,9,5,0,0,2,2
S01011891,Rented or living rent free: Total,226,112,95,23,72,4,13,114,72,2,6,27,7
S01011891,Rented or living rent free: Social rented,156,60,46,14,32,2,12,96,59,0,5,25,7
S01011891,Rented or living rent free: Private rented or living rent free,70,52,49,9,40,2,1,18,13,2,1,2,0
S01011892,All HRPs aged 16 and over,503,415,356,43,313,47,12,88,71,1,3,10,3
S01011892,Owned: Total,343,275,234,28,206,37,4,68,65,0,1,2,0
S01011892,Owned: Owned outright,117,58,45,9,36,11,2,59,58,0,0,1,0
S01011892,Owned: Owned with a mortgage or loan or shared ownership,226,217,189,19,170,26,2,9,7,0,1,1,0
S01011892,Rented or living rent free: Total,160,140,122,15,107,10,8,20,6,1,2,8,3
S01011892,Rented or living rent free: Social rented,6,0,0,0,0,0,0,6,0,0,1,5,0
S01011892,Rented or living rent free: Private rented or living rent free,154,140,122,15,107,10,8,14,6,1,1,3,3
S01011893,All HRPs aged 16 and over,500,342,296,36,260,31,15,158,131,2,4,18,3
S01011893,Owned: Total,287,193,170,13,157,18,5,94,87,1,1,3,2
S01011893,Owned: Owned outright,141,56,46,6,40,8,2,85,80,1,0,2,2
S01011893,Owned: Owned with a mortgage or loan or shared ownership,146,137,124,7,117,10,3,9,7,0,1,1,0
S01011893,Rented or living rent free: Total,213,149,126,23,103,13,10,64,44,1,3,15,1
S01011893,Rented or living rent free: Social rented,87,44,33,4,29,5,6,43,29,1,0,12,1
S01011893,Rented or living rent free: Private rented or living rent free,126,105,93,19,74,8,4,21,15,0,3,3,0
S01011894,All HRPs aged 16 and over,291,206,177,32,145,24,5,85,67,3,2,10,3
S01011894,Owned: Total,188,130,109,15,94,21,0,58,54,1,0,1,2
S01011894,Owned: Owned outright,99,47,39,8,31,8,0,52,50,0,0,0,2
S01011894,Owned: Owned with a mortgage or loan or shared ownership,89,83,70,7,63,13,0,6,4,1,0,1,0
S01011894,Rented or living rent free: Total,103,76,68,17,51,3,5,27,13,2,2,9,1
S01011894,Rented or living rent free: Social rented,43,26,23,5,18,1,2,17,9,1,1,6,0
S01011894,Rented or living rent free: Private rented or living rent free,60,50,45,12,33,2,3,10,4,1,1,3,1
S01011895,All HRPs aged 16 and over,305,164,117,17,100,43,4,141,128,3,3,2,5
S01011895,Owned: Total,266,143,103,11,92,40,0,123,116,2,3,0,2
S01011895,Owned: Owned outright,169,56,39,8,31,17,0,113,109,0,2,0,2
S01011895,Owned: Owned with a mortgage or loan or shared ownership,97,87,64,3,61,23,0,10,7,2,1,0,0
S01011895,Rented or living rent free: Total,39,21,14,6,8,3,4,18,12,1,0,2,3
S01011895,Rented or living rent free: Social rented,3,0,0,0,0,0,0,3,2,0,0,0,1
S01011895,Rented or living rent free: Private rented or living rent free,36,21,14,6,8,3,4,15,10,1,0,2,2
S01011896,All HRPs aged 16 and over,421,261,222,31,191,33,6,160,149,0,1,7,3
S01011896,Owned: Total,329,198,169,19,150,27,2,131,125,0,0,4,2
S01011896,Owned: Owned outright,175,56,47,8,39,8,1,119,116,0,0,2,1
S01011896,Owned: Owned with a mortgage or loan or shared ownership,154,142,122,11,111,19,1,12,9,0,0,2,1
S01011896,Rented or living rent free: Total,92,63,53,12,41,6,4,29,24,0,1,3,1
S01011896,Rented or living rent free: Social rented,35,15,12,7,5,1,2,20,17,0,1,1,1
S01011896,Rented or living rent free: Private rented or living rent free,57,48,41,5,36,5,2,9,7,0,0,2,0
S01011897,All HRPs aged 16 and over,436,274,229,23,206,41,4,162,146,3,2,6,5
S01011897,Owned: Total,366,231,191,18,173,39,1,135,129,2,1,2,1
S01011897,Owned: Owned outright,201,76,63,7,56,13,0,125,121,1,1,1,1
S01011897,Owned: Owned with a mortgage or loan or shared ownership,165,155,128,11,117,26,1,10,8,1,0,1,0
S01011897,Rented or living rent free: Total,70,43,38,5,33,2,3,27,17,1,1,4,4
S01011897,Rented or living rent free: Social rented,38,14,11,3,8,1,2,24,15,1,0,4,4
S01011897,Rented or living rent free: Private rented or living rent free,32,29,27,2,25,1,1,3,2,0,1,0,0
S01011898,All HRPs aged 16 and over,246,193,152,21,131,40,1,53,53,0,0,0,0
S01011898,Owned: Total,221,170,132,16,116,37,1,51,51,0,0,0,0
S01011898,Owned: Owned outright,98,51,37,12,25,13,1,47,47,0,0,0,0
S01011898,Owned: Owned with a mortgage or loan or shared ownership,123,119,95,4,91,24,0,4,4,0,0,0,0
S01011898,Rented or living rent free: Total,25,23,20,5,15,3,0,2,2,0,0,0,0
S01011898,Rented or living rent free: Social rented,0,0,0,0,0,0,0,0,0,0,0,0,0
S01011898,Rented or living rent free: Private rented or living rent free,25,23,20,5,15,3,0,2,2,0,0,0,0
S01011899,All HRPs aged 16 and over,352,215,193,27,166,21,1,137,130,0,0,3,4
S01011899,Owned: Total,326,197,179,25,154,18,0,129,125,0,0,1,3
S01011899,Owned: Owned outright,197,77,67,20,47,10,0,120,117,0,0,0,3
S01011899,Owned: Owned with a mortgage or loan or shared ownership,129,120,112,5,107,8,0,9,8,0,0,1,0
S01011899,Rented or living rent free: Total,26,18,14,2,12,3,1,8,5,0,0,2,1
S01011899,Rented or living rent free: Social rented,2,0,0,0,0,0,0,2,0,0,0,2,0
S01011899,Rented or living rent free: Private rented or living rent free,24,18,14,2,12,3,1,6,5,0,0,0,1
S01011900,All HRPs aged 16 and over,293,203,176,23,153,27,0,90,86,1,1,1,1
S01011900,Owned: Total,282,197,170,21,149,27,0,85,83,0,0,1,1
S01011900,Owned: Owned outright,144,66,56,16,40,10,0,78,78,0,0,0,0
S01011900,Owned: Owned with a mortgage or loan or shared ownership,138,131,114,5,109,17,0,7,5,0,0,1,1
S01011900,Rented or living rent free: Total,11,6,6,2,4,0,0,5,3,1,1,0,0
S01011900,Rented or living rent free: Social rented,1,1,1,1,0,0,0,0,0,0,0,0,0
S01011900,Rented or living rent free: Private rented or living rent free,10,5,5,1,4,0,0,5,3,1,1,0,0
S01011901,All HRPs aged 16 and over,397,267,216,22,194,41,10,130,117,6,1,3,3
S01011901,Owned: Total,312,198,160,9,151,33,5,114,107,4,0,1,2
S01011901,Owned: Owned outright,167,63,48,6,42,11,4,104,99,2,0,1,2
S01011901,Owned: Owned with a mortgage or loan or shared ownership,145,135,112,3,109,22,1,10,8,2,0,0,0
S01011901,Rented or living rent free: Total,85,69,56,13,43,8,5,16,10,2,1,2,1
S01011901,Rented or living rent free: Social rented,15,13,10,4,6,0,3,2,1,0,0,1,0
S01011901,Rented or living rent free: Private rented or living rent free,70,56,46,9,37,8,2,14,9,2,1,1,1
S01011902,All HRPs aged 16 and over,465,269,223,28,195,44,2,196,192,1,0,3,0
S01011902,Owned: Total,423,246,205,25,180,40,1,177,177,0,0,0,0
S01011902,Owned: Owned outright,249,84,69,18,51,15,0,165,165,0,0,0,0
S01011902,Owned: Owned with a mortgage or loan or shared ownership,174,162,136,7,129,25,1,12,12,0,0,0,0
S01011902,Rented or living rent free: Total,42,23,18,3,15,4,1,19,15,1,0,3,0
S01011902,Rented or living rent free: Social rented,14,7,7,1,6,0,0,7,6,0,0,1,0
S01011902,Rented or living rent free: Private rented or living rent free,28,16,11,2,9,4,1,12,9,1,0,2,0
S01011903,All HRPs aged 16 and over,352,199,171,24,147,28,0,153,153,0,0,0,0
S01011903,Owned: Total,331,183,156,20,136,27,0,148,148,0,0,0,0
S01011903,Owned: Owned outright,207,68,58,14,44,10,0,139,139,0,0,0,0
S01011903,Owned: Owned with a mortgage or loan or shared ownership,124,115,98,6,92,17,0,9,9,0,0,0,0
S01011903,Rented or living rent free: Total,21,16,15,4,11,1,0,5,5,0,0,0,0
S01011903,Rented or living rent free: Social rented,2,0,0,0,0,0,0,2,2,0,0,0,0
S01011903,Rented or living rent free: Private rented or living rent free,19,16,15,4,11,1,0,3,3,0,0,0,0
S01011904,All HRPs aged 16 and over,324,209,179,26,153,28,2,115,109,0,1,3,2
S01011904,Owned: Total,304,196,171,24,147,24,1,108,104,0,1,1,2
S01011904,Owned: Owned outright,157,64,54,17,37,10,0,93,90,0,1,1,1
S01011904,Owned: Owned with a mortgage or loan or shared ownership,147,132,117,7,110,14,1,15,14,0,0,0,1
S01011904,Rented or living rent free: Total,20,13,8,2,6,4,1,7,5,0,0,2,0
S01011904,Rented or living rent free: Social rented,4,3,2,1,1,0,1,1,1,0,0,0,0
S01011904,Rented or living rent free: Private rented or living rent free,16,10,6,1,5,4,0,6,4,0,0,2,0
S01011905,All HRPs aged 16 and over,280,212,168,22,146,42,2,68,65,2,1,0,0
S01011905,Owned: Total,260,197,157,22,135,40,0,63,60,2,1,0,0
S01011905,Owned: Owned outright,118,61,48,14,34,13,0,57,56,0,1,0,0
S01011905,Owned: Owned with a mortgage or loan or shared ownership,142,136,109,8,101,27,0,6,4,2,0,0,0
S01011905,Rented or living rent free: Total,20,15,11,0,11,2,2,5,5,0,0,0,0
S01011905,Rented or living rent free: Social rented,5,2,2,0,2,0,0,3,3,0,0,0,0
S01011905,Rented or living rent free: Private rented or living rent free,15,13,9,0,9,2,2,2,2,0,0,0,0
S01011906,All HRPs aged 16 and over,201,135,118,19,99,13,4,66,62,0,1,1,2
S01011906,Owned: Total,185,122,108,17,91,10,4,63,60,0,0,1,2
S01011906,Owned: Owned outright,92,36,31,11,20,3,2,56,54,0,0,1,1
S01011906,Owned: Owned with a mortgage or loan or shared ownership,93,86,77,6,71,7,2,7,6,0,0,0,1
S01011906,Rented or living rent free: Total,16,13,10,2,8,3,0,3,2,0,1,0,0
S01011906,Rented or living rent free: Social rented,2,0,0,0,0,0,0,2,1,0,1,0,0
S01011906,Rented or living rent free: Private rented or living rent free,14,13,10,2,8,3,0,1,1,0,0,0,0
S01011907,All HRPs aged 16 and over,338,256,231,22,209,22,3,82,73,0,2,4,3
S01011907,Owned: Total,279,203,181,10,171,22,0,76,72,0,0,1,3
S01011907,Owned: Owned outright,116,46,38,6,32,8,0,70,67,0,0,1,2
S01011907,Owned: Owned with a mortgage or loan or shared ownership,163,157,143,4,139,14,0,6,5,0,0,0,1
S01011907,Rented or living rent free: Total,59,53,50,12,38,0,3,6,1,0,2,3,0
S01011907,Rented or living rent free: Social rented,17,11,10,6,4,0,1,6,1,0,2,3,0
S01011907,Rented or living rent free: Private rented or living rent free,42,42,40,6,34,0,2,0,0,0,0,0,0
S01011908,All HRPs aged 16 and over,147,121,112,8,104,7,2,26,23,1,0,2,0
S01011908,Owned: Total,122,101,93,8,85,7,1,21,19,1,0,1,0
S01011908,Owned: Owned outright,37,20,17,4,13,2,1,17,17,0,0,0,0
S01011908,Owned: Owned with a mortgage or loan or shared ownership,85,81,76,4,72,5,0,4,2,1,0,1,0
S01011908,Rented or living rent free: Total,25,20,19,0,19,0,1,5,4,0,0,1,0
S01011908,Rented or living rent free: Social rented,6,4,3,0,3,0,1,2,1,0,0,1,0
S01011908,Rented or living rent free: Private rented or living rent free,19,16,16,0,16,0,0,3,3,0,0,0,0
S01011909,All HRPs aged 16 and over,404,380,337,29,308,41,2,24,19,0,2,2,1
S01011909,Owned: Total,344,327,289,21,268,36,2,17,13,0,1,2,1
S01011909,Owned: Owned outright,38,26,23,7,16,3,0,12,11,0,0,0,1
S01011909,Owned: Owned with a mortgage or loan or shared ownership,306,301,266,14,252,33,2,5,2,0,1,2,0
S01011909,Rented or living rent free: Total,60,53,48,8,40,5,0,7,6,0,1,0,0
S01011909,Rented or living rent free: Social rented,13,7,7,3,4,0,0,6,6,0,0,0,0
S01011909,Rented or living rent free: Private rented or living rent free,47,46,41,5,36,5,0,1,0,0,1,0,0
S01011910,All HRPs aged 16 and over,464,300,248,70,178,21,31,164,101,5,12,29,17
S01011910,Owned: Total,159,115,103,22,81,10,2,44,41,0,0,1,2
S01011910,Owned: Owned outright,62,23,19,7,12,3,1,39,38,0,0,0,1
S01011910,Owned: Owned with a mortgage or loan or shared ownership,97,92,84,15,69,7,1,5,3,0,0,1,1
S01011910,Rented or living rent free: Total,305,185,145,48,97,11,29,120,60,5,12,28,15
S01011910,Rented or living rent free: Social rented,271,157,123,47,76,7,27,114,57,4,12,26,15
S01011910,Rented or living rent free: Private rented or living rent free,34,28,22,1,21,4,2,6,3,1,0,2,0
S01011911,All HRPs aged 16 and over,285,176,158,31,127,17,1,109,95,0,4,10,0
S01011911,Owned: Total,172,117,104,19,85,13,0,55,54,0,0,1,0
S01011911,Owned: Owned outright,72,23,23,10,13,0,0,49,49,0,0,0,0
S01011911,Owned: Owned with a mortgage or loan or shared ownership,100,94,81,9,72,13,0,6,5,0,0,1,0
S01011911,Rented or living rent free: Total,113,59,54,12,42,4,1,54,41,0,4,9,0
S01011911,Rented or living rent free: Social rented,97,47,44,12,32,2,1,50,39,0,3,8,0
S01011911,Rented or living rent free: Private rented or living rent free,16,12,10,0,10,2,0,4,2,0,1,1,0
S01011912,All HRPs aged 16 and over,327,215,189,39,150,16,10,112,91,2,3,14,2
S01011912,Owned: Total,169,123,114,12,102,9,0,46,44,1,1,0,0
S01011912,Owned: Owned outright,62,23,22,2,20,1,0,39,38,0,1,0,0
S01011912,Owned: Owned with a mortgage or loan or shared ownership,107,100,92,10,82,8,0,7,6,1,0,0,0
S01011912,Rented or living rent free: Total,158,92,75,27,48,7,10,66,47,1,2,14,2
S01011912,Rented or living rent free: Social rented,129,71,57,25,32,6,8,58,39,1,2,14,2
S01011912,Rented or living rent free: Private rented or living rent free,29,21,18,2,16,1,2,8,8,0,0,0,0
S01011913,All HRPs aged 16 and over,365,240,202,69,133,20,18,125,84,1,7,28,5
S01011913,Owned: Total,144,105,95,19,76,10,0,39,36,0,0,2,1
S01011913,Owned: Owned outright,44,20,17,5,12,3,0,24,23,0,0,1,0
S01011913,Owned: Owned with a mortgage or loan or shared ownership,100,85,78,14,64,7,0,15,13,0,0,1,1
S01011913,Rented or living rent free: Total,221,135,107,50,57,10,18,86,48,1,7,26,4
S01011913,Rented or living rent free: Social rented,200,121,95,46,49,9,17,79,41,1,7,26,4
S01011913,Rented or living rent free: Private rented or living rent free,21,14,12,4,8,1,1,7,7,0,0,0,0
S01011914,All HRPs aged 16 and over,360,258,203,51,152,32,23,102,63,4,17,11,7
S01011914,Owned: Total,132,110,90,13,77,18,2,22,22,0,0,0,0
S01011914,Owned: Owned outright,37,23,20,7,13,2,1,14,14,0,0,0,0
S01011914,Owned: Owned with a mortgage or loan or shared ownership,95,87,70,6,64,16,1,8,8,0,0,0,0
S01011914,Rented or living rent free: Total,228,148,113,38,75,14,21,80,41,4,17,11,7
S01011914,Rented or living rent free: Social rented,193,119,95,37,58,8,16,74,37,4,17,9,7
S01011914,Rented or living rent free: Private rented or living rent free,35,29,18,1,17,6,5,6,4,0,0,2,0
S01011915,All HRPs aged 16 and over,337,214,190,41,149,20,4,123,90,2,3,22,6
S01011915,Owned: Total,183,132,115,16,99,16,1,51,48,0,0,1,2
S01011915,Owned: Owned outright,72,33,29,8,21,4,0,39,38,0,0,0,1
S01011915,Owned: Owned with a mortgage or loan or shared ownership,111,99,86,8,78,12,1,12,10,0,0,1,1
S01011915,Rented or living rent free: Total,154,82,75,25,50,4,3,72,42,2,3,21,4
S01011915,Rented or living rent free: Social rented,134,65,59,20,39,3,3,69,40,2,3,21,3
S01011915,Rented or living rent free: Private rented or living rent free,20,17,16,5,11,1,0,3,2,0,0,0,1
S01011916,All HRPs aged 16 and over,232,150,131,22,109,11,8,82,57,0,6,16,3
S01011916,Owned: Total,107,77,71,7,64,6,0,30,29,0,0,1,0
S01011916,Owned: Owned outright,44,18,16,3,13,2,0,26,26,0,0,0,0
S01011916,Owned: Owned with a mortgage or loan or shared ownership,63,59,55,4,51,4,0,4,3,0,0,1,0
S01011916,Rented or living rent free: Total,125,73,60,15,45,5,8,52,28,0,6,15,3
S01011916,Rented or living rent free: Social rented,106,59,48,14,34,3,8,47,25,0,6,14,2
S01011916,Rented or living rent free: Private rented or living rent free,19,14,12,1,11,2,0,5,3,0,0,1,1
S01011917,All HRPs aged 16 and over,232,151,134,34,100,11,6,81,68,1,3,5,4
S01011917,Owned: Total,150,100,91,15,76,9,0,50,46,0,0,3,1
S01011917,Owned: Owned outright,67,27,23,9,14,4,0,40,38,0,0,1,1
S01011917,Owned: Owned with a mortgage or loan or shared ownership,83,73,68,6,62,5,0,10,8,0,0,2,0
S01011917,Rented or living rent free: Total,82,51,43,19,24,2,6,31,22,1,3,2,3
S01011917,Rented or living rent free: Social rented,61,37,29,14,15,2,6,24,18,1,0,2,3
S01011917,Rented or living rent free: Private rented or living rent free,21,14,14,5,9,0,0,7,4,0,3,0,0
S01011918,All HRPs aged 16 and over,368,244,188,56,132,17,39,124,64,2,12,29,17
S01011918,Owned: Total,72,58,48,5,43,8,2,14,13,0,0,1,0
S01011918,Owned: Owned outright,23,14,12,2,10,1,1,9,9,0,0,0,0
S01011918,Owned: Owned with a mortgage or loan or shared ownership,49,44,36,3,33,7,1,5,4,0,0,1,0
S01011918,Rented or living rent free: Total,296,186,140,51,89,9,37,110,51,2,12,28,17
S01011918,Rented or living rent free: Social rented,266,165,122,48,74,9,34,101,47,1,10,26,17
S01011918,Rented or living rent free: Private rented or living rent free,30,21,18,3,15,0,3,9,4,1,2,2,0
S01011919,All HRPs aged 16 and over,390,288,253,45,208,18,17,102,60,3,7,24,8
S01011919,Owned: Total,182,145,134,13,121,11,0,37,33,0,1,2,1
S01011919,Owned: Owned outright,63,29,25,5,20,4,0,34,31,0,1,1,1
S01011919,Owned: Owned with a mortgage or loan or shared ownership,119,116,109,8,101,7,0,3,2,0,0,1,0
S01011919,Rented or living rent free: Total,208,143,119,32,87,7,17,65,27,3,6,22,7
S01011919,Rented or living rent free: Social rented,149,89,72,28,44,4,13,60,26,1,6,21,6
S01011919,Rented or living rent free: Private rented or living rent free,59,54,47,4,43,3,4,5,1,2,0,1,1
S01011920,All HRPs aged 16 and over,291,200,175,40,135,17,8,91,71,2,3,13,2
S01011920,Owned: Total,161,119,107,16,91,12,0,42,42,0,0,0,0
S01011920,Owned: Owned outright,63,30,24,7,17,6,0,33,33,0,0,0,0
S01011920,Owned: Owned with a mortgage or loan or shared ownership,98,89,83,9,74,6,0,9,9,0,0,0,0
S01011920,Rented or living rent free: Total,130,81,68,24,44,5,8,49,29,2,3,13,2
S01011920,Rented or living rent free: Social rented,106,62,51,21,30,5,6,44,25,1,3,13,2
S01011920,Rented or living rent free: Private rented or living rent free,24,19,17,3,14,0,2,5,4,1,0,0,0
S01011921,All HRPs aged 16 and over,285,190,163,36,127,13,14,95,73,1,10,9,2
S01011921,Owned: Total,124,95,85,11,74,10,0,29,26,0,0,2,1
S01011921,Owned: Owned outright,44,23,20,5,15,3,0,21,21,0,0,0,0
S01011921,Owned: Owned with a mortgage or loan or shared ownership,80,72,65,6,59,7,0,8,5,0,0,2,1
S01011921,Rented or living rent free: Total,161,95,78,25,53,3,14,66,47,1,10,7,1
S01011921,Rented or living rent free: Social rented,141,80,66,23,43,2,12,61,44,1,8,7,1
S01011921,Rented or living rent free: Private rented or living rent free,20,15,12,2,10,1,2,5,3,0,2,0,0
S01011922,All HRPs aged 16 and over,356,236,200,38,162,13,23,120,77,4,2,30,7
S01011922,Owned: Total,159,121,110,14,96,8,3,38,36,0,0,1,1
S01011922,Owned: Owned outright,54,25,22,8,14,2,1,29,29,0,0,0,0
S01011922,Owned: Owned with a mortgage or loan or shared ownership,105,96,88,6,82,6,2,9,7,0,0,1,1
S01011922,Rented or living rent free: Total,197,115,90,24,66,5,20,82,41,4,2,29,6
S01011922,Rented or living rent free: Social rented,170,94,73,18,55,4,17,76,39,2,2,28,5
S01011922,Rented or living rent free: Private rented or living rent free,27,21,17,6,11,1,3,6,2,2,0,1,1
S01011923,All HRPs aged 16 and over,383,264,228,53,175,17,19,119,76,3,16,22,2
S01011923,Owned: Total,148,109,97,7,90,11,1,39,38,0,0,1,0
S01011923,Owned: Owned outright,44,15,12,1,11,3,0,29,29,0,0,0,0
S01011923,Owned: Owned with a mortgage or loan or shared ownership,104,94,85,6,79,8,1,10,9,0,0,1,0
S01011923,Rented or living rent free: Total,235,155,131,46,85,6,18,80,38,3,16,21,2
S01011923,Rented or living rent free: Social rented,208,136,113,45,68,6,17,72,34,3,14,19,2
S01011923,Rented or living rent free: Private rented or living rent free,27,19,18,1,17,0,1,8,4,0,2,2,0
S01011924,All HRPs aged 16 and over,206,132,111,23,88,11,10,74,51,3,2,14,4
S01011924,Owned: Total,106,78,71,7,64,7,0,28,27,0,0,0,1
S01011924,Owned: Owned outright,44,20,18,2,16,2,0,24,24,0,0,0,0
S01011924,Owned: Owned with a mortgage or loan or shared ownership,62,58,53,5,48,5,0,4,3,0,0,0,1
S01011924,Rented or living rent free: Total,100,54,40,16,24,4,10,46,24,3,2,14,3
S01011924,Rented or living rent free: Social rented,83,41,30,14,16,4,7,42,21,3,2,13,3
S01011924,Rented or living rent free: Private rented or living rent free,17,13,10,2,8,0,3,4,3,0,0,1,0
S01011925,All HRPs aged 16 and over,264,233,189,12,177,39,5,31,18,1,1,7,4
S01011925,Owned: Total,231,212,174,9,165,36,2,19,14,0,0,2,3
S01011925,Owned: Owned outright,32,19,16,2,14,3,0,13,11,0,0,1,1
S01011925,Owned: Owned with a mortgage or loan or shared ownership,199,193,158,7,151,33,2,6,3,0,0,1,2
S01011925,Rented or living rent free: Total,33,21,15,3,12,3,3,12,4,1,1,5,1
S01011925,Rented or living rent free: Social rented,20,10,6,2,4,1,3,10,3,0,1,5,1
S01011925,Rented or living rent free: Private rented or living rent free,13,11,9,1,8,2,0,2,1,1,0,0,0
S01011926,All HRPs aged 16 and over,298,201,176,38,138,17,8,97,68,1,12,15,1
S01011926,Owned: Total,173,135,117,18,99,16,2,38,34,0,3,1,0
S01011926,Owned: Owned outright,61,28,17,3,14,9,2,33,30,0,3,0,0
S01011926,Owned: Owned with a mortgage or loan or shared ownership,112,107,100,15,85,7,0,5,4,0,0,1,0
S01011926,Rented or living rent free: Total,125,66,59,20,39,1,6,59,34,1,9,14,1
S01011926,Rented or living rent free: Social rented,95,42,39,16,23,0,3,53,31,0,8,14,0
S01011926,Rented or living rent free: Private rented or living rent free,30,24,20,4,16,1,3,6,3,1,1,0,1
S01011927,All HRPs aged 16 and over,285,182,154,34,120,15,13,103,67,5,5,19,7
S01011927,Owned: Total,154,114,98,12,86,12,4,40,35,1,0,3,1
S01011927,Owned: Owned outright,55,24,21,5,16,1,2,31,29,0,0,1,1
S01011927,Owned: Owned with a mortgage or loan or shared ownership,99,90,77,7,70,11,2,9,6,1,0,2,0
S01011927,Rented or living rent free: Total,131,68,56,22,34,3,9,63,32,4,5,16,6
S01011927,Rented or living rent free: Social rented,114,55,45,19,26,3,7,59,31,4,4,16,4
S01011927,Rented or living rent free: Private rented or living rent free,17,13,11,3,8,0,2,4,1,0,1,0,2
S01011928,All HRPs aged 16 and over,338,209,174,31,143,27,8,129,106,2,4,16,1
S01011928,Owned: Total,187,129,110,10,100,18,1,58,57,0,0,1,0
S01011928,Owned: Owned outright,85,30,20,3,17,9,1,55,54,0,0,1,0
S01011928,Owned: Owned with a mortgage or loan or shared ownership,102,99,90,7,83,9,0,3,3,0,0,0,0
S01011928,Rented or living rent free: Total,151,80,64,21,43,9,7,71,49,2,4,15,1
S01011928,Rented or living rent free: Social rented,106,46,35,15,20,6,5,60,43,2,3,11,1
S01011928,Rented or living rent free: Private rented or living rent free,45,34,29,6,23,3,2,11,6,0,1,4,0
S01011929,All HRPs aged 16 and over,319,190,175,28,147,10,5,129,108,1,4,13,3
S01011929,Owned: Total,182,133,127,13,114,6,0,49,47,0,0,2,0
S01011929,Owned: Owned outright,70,30,29,7,22,1,0,40,39,0,0,1,0
S01011929,Owned: Owned with a mortgage or loan or shared ownership,112,103,98,6,92,5,0,9,8,0,0,1,0
S01011929,Rented or living rent free: Total,137,57,48,15,33,4,5,80,61,1,4,11,3
S01011929,Rented or living rent free: Social rented,118,42,33,11,22,4,5,76,59,1,4,10,2
S01011929,Rented or living rent free: Private rented or living rent free,19,15,15,4,11,0,0,4,2,0,0,1,1
S01011930,All HRPs aged 16 and over,294,195,172,39,133,15,8,99,67,1,8,16,7
S01011930,Owned: Total,150,117,107,20,87,9,1,33,32,0,0,1,0
S01011930,Owned: Owned outright,62,32,30,11,19,2,0,30,29,0,0,1,0
S01011930,Owned: Owned with a mortgage or loan or shared ownership,88,85,77,9,68,7,1,3,3,0,0,0,0
S01011930,Rented or living rent free: Total,144,78,65,19,46,6,7,66,35,1,8,15,7
S01011930,Rented or living rent free: Social rented,109,54,46,15,31,1,7,55,33,0,3,14,5
S01011930,Rented or living rent free: Private rented or living rent free,35,24,19,4,15,5,0,11,2,1,5,1,2
S01011931,All HRPs aged 16 and over,250,160,136,28,108,13,11,90,41,3,15,27,4
S01011931,Owned: Total,61,47,37,2,35,10,0,14,10,0,2,1,1
S01011931,Owned: Owned outright,16,6,6,1,5,0,0,10,8,0,0,1,1
S01011931,Owned: Owned with a mortgage or loan or shared ownership,45,41,31,1,30,10,0,4,2,0,2,0,0
S01011931,Rented or living rent free: Total,189,113,99,26,73,3,11,76,31,3,13,26,3
S01011931,Rented or living rent free: Social rented,161,92,82,22,60,1,9,69,30,3,12,21,3
S01011931,Rented or living rent free: Private rented or living rent free,28,21,17,4,13,2,2,7,1,0,1,5,0
S01011932,All HRPs aged 16 and over,300,239,218,27,191,15,6,61,32,4,7,11,7
S01011932,Owned: Total,161,140,132,8,124,8,0,21,16,1,1,1,2
S01011932,Owned: Owned outright,32,16,16,5,11,0,0,16,12,1,1,1,1
S01011932,Owned: Owned with a mortgage or loan or shared ownership,129,124,116,3,113,8,0,5,4,0,0,0,1
S01011932,Rented or living rent free: Total,139,99,86,19,67,7,6,40,16,3,6,10,5
S01011932,Rented or living rent free: Social rented,70,39,34,11,23,1,4,31,13,0,4,10,4
S01011932,Rented or living rent free: Private rented or living rent free,69,60,52,8,44,6,2,9,3,3,2,0,1
S01011933,All HRPs aged 16 and over,344,234,205,26,179,19,10,110,68,8,4,23,7
S01011933,Owned: Total,143,106,89,7,82,15,2,37,33,2,0,1,1
S01011933,Owned: Owned outright,58,26,21,4,17,3,2,32,29,2,0,0,1
S01011933,Owned: Owned with a mortgage or loan or shared ownership,85,80,68,3,65,12,0,5,4,0,0,1,0
S01011933,Rented or living rent free: Total,201,128,116,19,97,4,8,73,35,6,4,22,6
S01011933,Rented or living rent free: Social rented,101,41,35,9,26,1,5,60,27,4,3,21,5
S01011933,Rented or living rent free: Private rented or living rent free,100,87,81,10,71,3,3,13,8,2,1,1,1
S01011934,All HRPs aged 16 and over,520,351,283,54,229,41,27,169,129,23,4,9,4
S01011934,Owned: Total,314,214,181,32,149,27,6,100,99,0,0,1,0
S01011934,Owned: Owned outright,163,72,59,15,44,10,3,91,91,0,0,0,0
S01011934,Owned: Owned with a mortgage or loan or shared ownership,151,142,122,17,105,17,3,9,8,0,0,1,0
S01011934,Rented or living rent free: Total,206,137,102,22,80,14,21,69,30,23,4,8,4
S01011934,Rented or living rent free: Social rented,50,22,12,6,6,3,7,28,16,0,3,6,3
S01011934,Rented or living rent free: Private rented or living rent free,156,115,90,16,74,11,14,41,14,23,1,2,1
S01011935,All HRPs aged 16 and over,459,340,278,53,225,38,24,119,84,6,4,23,2
S01011935,Owned: Total,173,116,89,13,76,23,4,57,50,0,1,5,1
S01011935,Owned: Owned outright,89,37,25,6,19,10,2,52,46,0,0,5,1
S01011935,Owned: Owned with a mortgage or loan or shared ownership,84,79,64,7,57,13,2,5,4,0,1,0,0
S01011935,Rented or living rent free: Total,286,224,189,40,149,15,20,62,34,6,3,18,1
S01011935,Rented or living rent free: Social rented,86,43,37,11,26,2,4,43,28,2,2,11,0
S01011935,Rented or living rent free: Private rented or living rent free,200,181,152,29,123,13,16,19,6,4,1,7,1
S01011936,All HRPs aged 16 and over,380,288,231,38,193,39,18,92,65,7,5,12,3
S01011936,Owned: Total,187,137,110,17,93,24,3,50,47,0,1,1,1
S01011936,Owned: Owned outright,87,40,30,12,18,10,0,47,45,0,0,1,1
S01011936,Owned: Owned with a mortgage or loan or shared ownership,100,97,80,5,75,14,3,3,2,0,1,0,0
S01011936,Rented or living rent free: Total,193,151,121,21,100,15,15,42,18,7,4,11,2
S01011936,Rented or living rent free: Social rented,67,47,39,5,34,1,7,20,9,1,1,7,2
S01011936,Rented or living rent free: Private rented or living rent free,126,104,82,16,66,14,8,22,9,6,3,4,0
S01011937,All HRPs aged 16 and over,408,273,240,49,191,22,11,135,96,3,5,27,4
S01011937,Owned: Total,124,102,93,9,84,7,2,22,22,0,0,0,0
S01011937,Owned: Owned outright,35,18,17,3,14,0,1,17,17,0,0,0,0
S01011937,Owned: Owned with a mortgage or loan or shared ownership,89,84,76,6,70,7,1,5,5,0,0,0,0
S01011937,Rented or living rent free: Total,284,171,147,40,107,15,9,113,74,3,5,27,4
S01011937,Rented or living rent free: Social rented,140,47,40,18,22,4,3,93,61,1,5,23,3
S01011937,Rented or living rent free: Private rented or living rent free,144,124,107,22,85,11,6,20,13,2,0,4,1
S01011938,All HRPs aged 16 and over,400,264,211,31,180,40,13,136,109,2,1,18,6
S01011938,Owned: Total,192,116,91,15,76,22,3,76,71,0,0,4,1
S01011938,Owned: Owned outright,98,35,23,8,15,9,3,63,61,0,0,2,0
S01011938,Owned: Owned with a mortgage or loan or shared ownership,94,81,68,7,61,13,0,13,10,0,0,2,1
S01011938,Rented or living rent free: Total,208,148,120,16,104,18,10,60,38,2,1,14,5
S01011938,Rented or living rent free: Social rented,71,26,18,4,14,2,6,45,26,0,1,14,4
S01011938,Rented or living rent free: Private rented or living rent free,137,122,102,12,90,16,4,15,12,2,0,0,1
S01011939,All HRPs aged 16 and over,446,320,267,48,219,27,26,126,48,18,8,37,15
S01011939,Owned: Total,146,114,98,10,88,16,0,32,27,0,1,2,2
S01011939,Owned: Owned outright,55,28,24,5,19,4,0,27,23,0,0,2,2
S01011939,Owned: Owned with a mortgage or loan or shared ownership,91,86,74,5,69,12,0,5,4,0,1,0,0
S01011939,Rented or living rent free: Total,300,206,169,38,131,11,26,94,21,18,7,35,13
S01011939,Rented or living rent free: Social rented,145,78,53,14,39,3,22,67,15,7,6,30,9
S01011939,Rented or living rent free: Private rented or living rent free,155,128,116,24,92,8,4,27,6,11,1,5,4
S01011940,All HRPs aged 16 and over,266,182,155,20,135,14,13,84,49,12,5,17,1
S01011940,Owned: Total,59,47,38,1,37,7,2,12,12,0,0,0,0
S01011940,Owned: Owned outright,20,11,8,0,8,2,1,9,9,0,0,0,0
S01011940,Owned: Owned with a mortgage or loan or shared ownership,39,36,30,1,29,5,1,3,3,0,0,0,0
S01011940,Rented or living rent free: Total,207,135,117,19,98,7,11,72,37,12,5,17,1
S01011940,Rented or living rent free: Social rented,90,31,24,6,18,1,6,59,35,5,5,13,1
S01011940,Rented or living rent free: Private rented or living rent free,117,104,93,13,80,6,5,13,2,7,0,4,0
S01011941,All HRPs aged 16 and over,441,354,302,53,249,24,28,87,36,9,9,22,11
S01011941,Owned: Total,114,90,77,9,68,11,2,24,17,0,0,7,0
S01011941,Owned: Owned outright,40,23,19,5,14,4,0,17,13,0,0,4,0
S01011941,Owned: Owned with a mortgage or loan or shared ownership,74,67,58,4,54,7,2,7,4,0,0,3,0
S01011941,Rented or living rent free: Total,327,264,225,44,181,13,26,63,19,9,9,15,11
S01011941,Rented or living rent free: Social rented,50,25,14,4,10,3,8,25,7,0,7,9,2
S01011941,Rented or living rent free: Private rented or living rent free,277,239,211,40,171,10,18,38,12,9,2,6,9
S01011942,All HRPs aged 16 and over,573,360,313,74,239,27,20,213,140,25,8,29,11
S01011942,Owned: Total,183,96,86,9,77,10,0,87,81,1,0,1,4
S01011942,Owned: Owned outright,103,24,18,4,14,6,0,79,76,0,0,1,2
S01011942,Owned: Owned with a mortgage or loan or shared ownership,80,72,68,5,63,4,0,8,5,1,0,0,2
S01011942,Rented or living rent free: Total,390,264,227,65,162,17,20,126,59,24,8,28,7
S01011942,Rented or living rent free: Social rented,158,75,66,28,38,3,6,83,50,4,2,21,6
S01011942,Rented or living rent free: Private rented or living rent free,232,189,161,37,124,14,14,43,9,20,6,7,1
S01011943,All HRPs aged 16 and over,715,465,374,89,285,28,63,250,161,13,9,56,11
S01011943,Owned: Total,188,134,120,8,112,9,5,54,45,0,0,9,0
S01011943,Owned: Owned outright,71,25,23,2,21,0,2,46,42,0,0,4,0
S01011943,Owned: Owned with a mortgage or loan or shared ownership,117,109,97,6,91,9,3,8,3,0,0,5,0
S01011943,Rented or living rent free: Total,527,331,254,81,173,19,58,196,116,13,9,47,11
S01011943,Rented or living rent free: Social rented,265,117,79,34,45,3,35,148,84,9,8,39,8
S01011943,Rented or living rent free: Private rented or living rent free,262,214,175,47,128,16,23,48,32,4,1,8,3
S01011944,All HRPs aged 16 and over,188,122,85,10,75,36,1,66,63,0,2,0,1
S01011944,Owned: Total,157,102,69,7,62,32,1,55,54,0,1,0,0
S01011944,Owned: Owned outright,105,53,36,6,30,17,0,52,51,0,1,0,0
S01011944,Owned: Owned with a mortgage or loan or shared ownership,52,49,33,1,32,15,1,3,3,0,0,0,0
S01011944,Rented or living rent free: Total,31,20,16,3,13,4,0,11,9,0,1,0,1
S01011944,Rented or living rent free: Social rented,3,2,1,0,1,1,0,1,1,0,0,0,0
S01011944,Rented or living rent free: Private rented or living rent free,28,18,15,3,12,3,0,10,8,0,1,0,1
S01011945,All HRPs aged 16 and over,313,183,138,22,116,43,2,130,125,1,0,2,2
S01011945,Owned: Total,291,172,128,21,107,42,2,119,115,1,0,1,2
S01011945,Owned: Owned outright,198,84,60,19,41,23,1,114,110,1,0,1,2
S01011945,Owned: Owned with a mortgage or loan or shared ownership,93,88,68,2,66,19,1,5,5,0,0,0,0
S01011945,Rented or living rent free: Total,22,11,10,1,9,1,0,11,10,0,0,1,0
S01011945,Rented or living rent free: Social rented,5,1,1,0,1,0,0,4,3,0,0,1,0
S01011945,Rented or living rent free: Private rented or living rent free,17,10,9,1,8,1,0,7,7,0,0,0,0
S01011946,All HRPs aged 16 and over,377,206,159,34,125,27,20,171,152,1,10,6,2
S01011946,Owned: Total,215,129,99,15,84,24,6,86,81,0,4,1,0
S01011946,Owned: Owned outright,126,46,31,7,24,12,3,80,76,0,3,1,0
S01011946,Owned: Owned with a mortgage or loan or shared ownership,89,83,68,8,60,12,3,6,5,0,1,0,0
S01011946,Rented or living rent free: Total,162,77,60,19,41,3,14,85,71,1,6,5,2
S01011946,Rented or living rent free: Social rented,125,46,32,15,17,2,12,79,68,0,6,5,0
S01011946,Rented or living rent free: Private rented or living rent free,37,31,28,4,24,1,2,6,3,1,0,0,2
S01011947,All HRPs aged 16 and over,214,119,107,21,86,12,0,95,92,0,0,3,0
S01011947,Owned: Total,28,21,16,0,16,5,0,7,7,0,0,0,0
S01011947,Owned: Owned outright,12,6,5,0,5,1,0,6,6,0,0,0,0
S01011947,Owned: Owned with a mortgage or loan or shared ownership,16,15,11,0,11,4,0,1,1,0,0,0,0
S01011947,Rented or living rent free: Total,186,98,91,21,70,7,0,88,85,0,0,3,0
S01011947,Rented or living rent free: Social rented,41,21,21,2,19,0,0,20,18,0,0,2,0
S01011947,Rented or living rent free: Private rented or living rent free,145,77,70,19,51,7,0,68,67,0,0,1,0
S01011948,All HRPs aged 16 and over,527,299,218,38,180,66,15,228,207,0,0,18,3
S01011948,Owned: Total,327,214,153,24,129,58,3,113,109,0,0,4,0
S01011948,Owned: Owned outright,195,92,58,18,40,32,2,103,101,0,0,2,0
S01011948,Owned: Owned with a mortgage or loan or shared ownership,132,122,95,6,89,26,1,10,8,0,0,2,0
S01011948,Rented or living rent free: Total,200,85,65,14,51,8,12,115,98,0,0,14,3
S01011948,Rented or living rent free: Social rented,133,33,20,5,15,3,10,100,85,0,0,12,3
S01011948,Rented or living rent free: Private rented or living rent free,67,52,45,9,36,5,2,15,13,0,0,2,0
S01011949,All HRPs aged 16 and over,392,178,141,26,115,31,6,214,206,0,1,5,2
S01011949,Owned: Total,366,166,132,22,110,30,4,200,195,0,1,3,1
S01011949,Owned: Owned outright,276,80,58,15,43,19,3,196,192,0,1,3,0
S01011949,Owned: Owned with a mortgage or loan or shared ownership,90,86,74,7,67,11,1,4,3,0,0,0,1
S01011949,Rented or living rent free: Total,26,12,9,4,5,1,2,14,11,0,0,2,1
S01011949,Rented or living rent free: Social rented,7,4,3,0,3,1,0,3,1,0,0,1,1
S01011949,Rented or living rent free: Private rented or living rent free,19,8,6,4,2,0,2,11,10,0,0,1,0
S01011950,All HRPs aged 16 and over,348,172,147,27,120,24,1,176,169,0,1,5,1
S01011950,Owned: Total,239,131,112,18,94,18,1,108,108,0,0,0,0
S01011950,Owned: Owned outright,153,52,42,14,28,9,1,101,101,0,0,0,0
S01011950,Owned: Owned with a mortgage or loan or shared ownership,86,79,70,4,66,9,0,7,7,0,0,0,0
S01011950,Rented or living rent free: Total,109,41,35,9,26,6,0,68,61,0,1,5,1
S01011950,Rented or living rent free: Social rented,84,21,18,6,12,3,0,63,57,0,0,5,1
S01011950,Rented or living rent free: Private rented or living rent free,25,20,17,3,14,3,0,5,4,0,1,0,0
S01011951,All HRPs aged 16 and over,306,181,145,17,128,32,4,125,114,2,4,3,2
S01011951,Owned: Total,226,134,109,10,99,24,1,92,88,2,0,1,1
S01011951,Owned: Owned outright,124,43,33,6,27,9,1,81,78,1,0,1,1
S01011951,Owned: Owned with a mortgage or loan or shared ownership,102,91,76,4,72,15,0,11,10,1,0,0,0
S01011951,Rented or living rent free: Total,80,47,36,7,29,8,3,33,26,0,4,2,1
S01011951,Rented or living rent free: Social rented,34,15,12,1,11,2,1,19,17,0,1,0,1
S01011951,Rented or living rent free: Private rented or living rent free,46,32,24,6,18,6,2,14,9,0,3,2,0
S01011952,All HRPs aged 16 and over,200,127,105,9,96,22,0,73,71,0,0,1,1
S01011952,Owned: Total,185,118,97,9,88,21,0,67,66,0,0,0,1
S01011952,Owned: Owned outright,88,27,21,6,15,6,0,61,60,0,0,0,1
S01011952,Owned: Owned with a mortgage or loan or shared ownership,97,91,76,3,73,15,0,6,6,0,0,0,0
S01011952,Rented or living rent free: Total,15,9,8,0,8,1,0,6,5,0,0,1,0
S01011952,Rented or living rent free: Social rented,1,0,0,0,0,0,0,1,0,0,0,1,0
S01011952,Rented or living rent free: Private rented or living rent free,14,9,8,0,8,1,0,5,5,0,0,0,0
S01011953,All HRPs aged 16 and over,325,206,160,23,137,42,4,119,115,1,3,0,0
S01011953,Owned: Total,281,175,133,15,118,38,4,106,103,1,2,0,0
S01011953,Owned: Owned outright,156,54,40,9,31,11,3,102,99,1,2,0,0
S01011953,Owned: Owned with a mortgage or loan or shared ownership,125,121,93,6,87,27,1,4,4,0,0,0,0
S01011953,Rented or living rent free: Total,44,31,27,8,19,4,0,13,12,0,1,0,0
S01011953,Rented or living rent free: Social rented,6,3,3,1,2,0,0,3,3,0,0,0,0
S01011953,Rented or living rent free: Private rented or living rent free,38,28,24,7,17,4,0,10,9,0,1,0,0
S01011954,All HRPs aged 16 and over,230,136,121,20,101,9,6,94,83,1,5,4,1
S01011954,Owned: Total,133,95,87,12,75,8,0,38,38,0,0,0,0
S01011954,Owned: Owned outright,57,24,21,3,18,3,0,33,33,0,0,0,0
S01011954,Owned: Owned with a mortgage or loan or shared ownership,76,71,66,9,57,5,0,5,5,0,0,0,0
S01011954,Rented or living rent free: Total,97,41,34,8,26,1,6,56,45,1,5,4,1
S01011954,Rented or living rent free: Social rented,79,29,22,6,16,1,6,50,41,1,4,3,1
S01011954,Rented or living rent free: Private rented or living rent free,18,12,12,2,10,0,0,6,4,0,1,1,0
S01011955,All HRPs aged 16 and over,467,272,217,31,186,45,10,195,176,1,0,14,4
S01011955,Owned: Total,304,185,147,18,129,36,2,119,109,0,0,7,3
S01011955,Owned: Owned outright,161,57,41,11,30,15,1,104,96,0,0,5,3
S01011955,Owned: Owned with a mortgage or loan or shared ownership,143,128,106,7,99,21,1,15,13,0,0,2,0
S01011955,Rented or living rent free: Total,163,87,70,13,57,9,8,76,67,1,0,7,1
S01011955,Rented or living rent free: Social rented,94,39,29,10,19,5,5,55,48,1,0,5,1
S01011955,Rented or living rent free: Private rented or living rent free,69,48,41,3,38,4,3,21,19,0,0,2,0
S01011956,All HRPs aged 16 and over,392,288,240,27,213,44,4,104,97,1,0,5,1
S01011956,Owned: Total,335,251,212,23,189,39,0,84,81,1,0,2,0
S01011956,Owned: Owned outright,142,65,51,10,41,14,0,77,75,1,0,1,0
S01011956,Owned: Owned with a mortgage or loan or shared ownership,193,186,161,13,148,25,0,7,6,0,0,1,0
S01011956,Rented or living rent free: Total,57,37,28,4,24,5,4,20,16,0,0,3,1
S01011956,Rented or living rent free: Social rented,23,12,8,2,6,1,3,11,10,0,0,1,0
S01011956,Rented or living rent free: Private rented or living rent free,34,25,20,2,18,4,1,9,6,0,0,2,1
S01011957,All HRPs aged 16 and over,325,220,159,29,130,54,7,105,87,1,2,11,4
S01011957,Owned: Total,187,126,85,14,71,40,1,61,59,0,0,1,1
S01011957,Owned: Owned outright,101,50,31,12,19,19,0,51,50,0,0,0,1
S01011957,Owned: Owned with a mortgage or loan or shared ownership,86,76,54,2,52,21,1,10,9,0,0,1,0
S01011957,Rented or living rent free: Total,138,94,74,15,59,14,6,44,28,1,2,10,3
S01011957,Rented or living rent free: Social rented,28,7,7,2,5,0,0,21,12,1,2,5,1
S01011957,Rented or living rent free: Private rented or living rent free,110,87,67,13,54,14,6,23,16,0,0,5,2
S01011958,All HRPs aged 16 and over,481,308,210,26,184,93,5,173,150,3,3,13,4
S01011958,Owned: Total,299,191,122,14,108,69,0,108,106,0,0,1,1
S01011958,Owned: Owned outright,186,84,43,9,34,41,0,102,101,0,0,0,1
S01011958,Owned: Owned with a mortgage or loan or shared ownership,113,107,79,5,74,28,0,6,5,0,0,1,0
S01011958,Rented or living rent free: Total,182,117,88,12,76,24,5,65,44,3,3,12,3
S01011958,Rented or living rent free: Social rented,41,17,14,5,9,2,1,24,18,0,1,5,0
S01011958,Rented or living rent free: Private rented or living rent free,141,100,74,7,67,22,4,41,26,3,2,7,3
S01011959,All HRPs aged 16 and over,365,235,172,21,151,61,2,130,115,5,1,8,1
S01011959,Owned: Total,260,171,126,14,112,45,0,89,86,0,1,2,0
S01011959,Owned: Owned outright,144,65,40,9,31,25,0,79,77,0,1,1,0
S01011959,Owned: Owned with a mortgage or loan or shared ownership,116,106,86,5,81,20,0,10,9,0,0,1,0
S01011959,Rented or living rent free: Total,105,64,46,7,39,16,2,41,29,5,0,6,1
S01011959,Rented or living rent free: Social rented,27,10,8,0,8,1,1,17,14,0,0,3,0
S01011959,Rented or living rent free: Private rented or living rent free,78,54,38,7,31,15,1,24,15,5,0,3,1
S01011960,All HRPs aged 16 and over,325,257,211,18,193,45,1,68,58,1,1,5,3
S01011960,Owned: Total,254,203,168,16,152,35,0,51,43,1,1,4,2
S01011960,Owned: Owned outright,100,59,41,7,34,18,0,41,34,1,1,3,2
S01011960,Owned: Owned with a mortgage or loan or shared ownership,154,144,127,9,118,17,0,10,9,0,0,1,0
S01011960,Rented or living rent free: Total,71,54,43,2,41,10,1,17,15,0,0,1,1
S01011960,Rented or living rent free: Social rented,3,2,2,0,2,0,0,1,0,0,0,1,0
S01011960,Rented or living rent free: Private rented or living rent free,68,52,41,2,39,10,1,16,15,0,0,0,1
S01011961,All HRPs aged 16 and over,311,240,211,30,181,25,4,71,66,0,2,2,1
S01011961,Owned: Total,240,187,166,18,148,18,3,53,49,0,1,2,1
S01011961,Owned: Owned outright,87,45,37,7,30,6,2,42,39,0,0,2,1
S01011961,Owned: Owned with a mortgage or loan or shared ownership,153,142,129,11,118,12,1,11,10,0,1,0,0
S01011961,Rented or living rent free: Total,71,53,45,12,33,7,1,18,17,0,1,0,0
S01011961,Rented or living rent free: Social rented,39,22,20,8,12,2,0,17,16,0,1,0,0
S01011961,Rented or living rent free: Private rented or living rent free,32,31,25,4,21,5,1,1,1,0,0,0,0
S01011962,All HRPs aged 16 and over,264,202,152,10,142,47,3,62,60,0,0,2,0
S01011962,Owned: Total,226,172,128,8,120,43,1,54,54,0,0,0,0
S01011962,Owned: Owned outright,95,48,33,6,27,14,1,47,47,0,0,0,0
S01011962,Owned: Owned with a mortgage or loan or shared ownership,131,124,95,2,93,29,0,7,7,0,0,0,0
S01011962,Rented or living rent free: Total,38,30,24,2,22,4,2,8,6,0,0,2,0
S01011962,Rented or living rent free: Social rented,2,1,0,0,0,1,0,1,1,0,0,0,0
S01011962,Rented or living rent free: Private rented or living rent free,36,29,24,2,22,3,2,7,5,0,0,2,0
S01011963,All HRPs aged 16 and over,231,139,122,9,113,12,5,92,79,1,2,10,0
S01011963,Owned: Total,163,114,101,6,95,12,1,49,45,1,1,2,0
S01011963,Owned: Owned outright,52,15,12,0,12,2,1,37,36,0,0,1,0
S01011963,Owned: Owned with a mortgage or loan or shared ownership,111,99,89,6,83,10,0,12,9,1,1,1,0
S01011963,Rented or living rent free: Total,68,25,21,3,18,0,4,43,34,0,1,8,0
S01011963,Rented or living rent free: Social rented,61,21,18,1,17,0,3,40,31,0,1,8,0
S01011963,Rented or living rent free: Private rented or living rent free,7,4,3,2,1,0,1,3,3,0,0,0,0
S01011964,All HRPs aged 16 and over,453,320,271,33,238,40,9,133,118,1,3,10,1
S01011964,Owned: Total,326,229,198,19,179,29,2,97,92,1,1,3,0
S01011964,Owned: Owned outright,152,68,59,14,45,9,0,84,83,0,0,1,0
S01011964,Owned: Owned with a mortgage or loan or shared ownership,174,161,139,5,134,20,2,13,9,1,1,2,0
S01011964,Rented or living rent free: Total,127,91,73,14,59,11,7,36,26,0,2,7,1
S01011964,Rented or living rent free: Social rented,27,14,13,5,8,0,1,13,9,0,1,3,0
S01011964,Rented or living rent free: Private rented or living rent free,100,77,60,9,51,11,6,23,17,0,1,4,1
S01011965,All HRPs aged 16 and over,381,198,174,29,145,23,1,183,172,2,1,6,2
S01011965,Owned: Total,304,163,146,19,127,17,0,141,136,0,0,4,1
S01011965,Owned: Owned outright,181,51,46,14,32,5,0,130,125,0,0,4,1
S01011965,Owned: Owned with a mortgage or loan or shared ownership,123,112,100,5,95,12,0,11,11,0,0,0,0
S01011965,Rented or living rent free: Total,77,35,28,10,18,6,1,42,36,2,1,2,1
S01011965,Rented or living rent free: Social rented,54,18,14,8,6,3,1,36,32,0,1,2,1
S01011965,Rented or living rent free: Private rented or living rent free,23,17,14,2,12,3,0,6,4,2,0,0,0
S01011966,All HRPs aged 16 and over,351,219,172,27,145,42,5,132,119,2,4,5,2
S01011966,Owned: Total,292,189,144,20,124,40,5,103,98,1,2,0,2
S01011966,Owned: Owned outright,148,57,33,12,21,22,2,91,89,0,0,0,2
S01011966,Owned: Owned with a mortgage or loan or shared ownership,144,132,111,8,103,18,3,12,9,1,2,0,0
S01011966,Rented or living rent free: Total,59,30,28,7,21,2,0,29,21,1,2,5,0
S01011966,Rented or living rent free: Social rented,23,7,7,3,4,0,0,16,11,0,2,3,0
S01011966,Rented or living rent free: Private rented or living rent free,36,23,21,4,17,2,0,13,10,1,0,2,0
S01011967,All HRPs aged 16 and over,420,300,206,19,187,93,1,120,104,0,5,9,2
S01011967,Owned: Total,308,227,154,12,142,73,0,81,76,0,2,2,1
S01011967,Owned: Owned outright,165,91,45,6,39,46,0,74,73,0,0,0,1
S01011967,Owned: Owned with a mortgage or loan or shared ownership,143,136,109,6,103,27,0,7,3,0,2,2,0
S01011967,Rented or living rent free: Total,112,73,52,7,45,20,1,39,28,0,3,7,1
S01011967,Rented or living rent free: Social rented,31,6,3,1,2,2,1,25,20,0,1,4,0
S01011967,Rented or living rent free: Private rented or living rent free,81,67,49,6,43,18,0,14,8,0,2,3,1
S01011968,All HRPs aged 16 and over,478,333,280,39,241,45,8,145,127,4,3,9,2
S01011968,Owned: Total,334,234,195,20,175,36,3,100,98,0,1,1,0
S01011968,Owned: Owned outright,159,68,51,9,42,16,1,91,90,0,1,0,0
S01011968,Owned: Owned with a mortgage or loan or shared ownership,175,166,144,11,133,20,2,9,8,0,0,1,0
S01011968,Rented or living rent free: Total,144,99,85,19,66,9,5,45,29,4,2,8,2
S01011968,Rented or living rent free: Social rented,47,15,12,5,7,1,2,32,27,0,0,5,0
S01011968,Rented or living rent free: Private rented or living rent free,97,84,73,14,59,8,3,13,2,4,2,3,2
S01011969,All HRPs aged 16 and over,480,296,255,36,219,34,7,184,152,2,4,19,7
S01011969,Owned: Total,309,207,178,23,155,27,2,102,94,0,0,5,3
S01011969,Owned: Owned outright,158,70,58,14,44,11,1,88,84,0,0,2,2
S01011969,Owned: Owned with a mortgage or loan or shared ownership,151,137,120,9,111,16,1,14,10,0,0,3,1
S01011969,Rented or living rent free: Total,171,89,77,13,64,7,5,82,58,2,4,14,4
S01011969,Rented or living rent free: Social rented,114,48,41,10,31,3,4,66,48,2,4,11,1
S01011969,Rented or living rent free: Private rented or living rent free,57,41,36,3,33,4,1,16,10,0,0,3,3
S01011970,All HRPs aged 16 and over,432,306,249,38,211,42,15,126,89,0,10,19,8
S01011970,Owned: Total,209,162,135,14,121,25,2,47,47,0,0,0,0
S01011970,Owned: Owned outright,88,51,34,7,27,17,0,37,37,0,0,0,0
S01011970,Owned: Owned with a mortgage or loan or shared ownership,121,111,101,7,94,8,2,10,10,0,0,0,0
S01011970,Rented or living rent free: Total,223,144,114,24,90,17,13,79,42,0,10,19,8
S01011970,Rented or living rent free: Social rented,162,97,79,19,60,10,8,65,35,0,9,15,6
S01011970,Rented or living rent free: Private rented or living rent free,61,47,35,5,30,7,5,14,7,0,1,4,2
S01011971,All HRPs aged 16 and over,243,164,116,13,103,43,5,79,74,0,0,5,0
S01011971,Owned: Total,200,136,94,9,85,40,2,64,62,0,0,2,0
S01011971,Owned: Owned outright,107,47,27,6,21,19,1,60,59,0,0,1,0
S01011971,Owned: Owned with a mortgage or loan or shared ownership,93,89,67,3,64,21,1,4,3,0,0,1,0
S01011971,Rented or living rent free: Total,43,28,22,4,18,3,3,15,12,0,0,3,0
S01011971,Rented or living rent free: Social rented,14,8,4,0,4,2,2,6,5,0,0,1,0
S01011971,Rented or living rent free: Private rented or living rent free,29,20,18,4,14,1,1,9,7,0,0,2,0
S01011972,All HRPs aged 16 and over,512,342,237,31,206,103,2,170,153,1,0,14,2
S01011972,Owned: Total,320,207,133,16,117,74,0,113,108,0,0,4,1
S01011972,Owned: Owned outright,192,94,47,10,37,47,0,98,93,0,0,4,1
S01011972,Owned: Owned with a mortgage or loan or shared ownership,128,113,86,6,80,27,0,15,15,0,0,0,0
S01011972,Rented or living rent free: Total,192,135,104,15,89,29,2,57,45,1,0,10,1
S01011972,Rented or living rent free: Social rented,24,13,11,3,8,1,1,11,7,0,0,3,1
S01011972,Rented or living rent free: Private rented or living rent free,168,122,93,12,81,28,1,46,38,1,0,7,0
S01011973,All HRPs aged 16 and over,272,193,144,18,126,45,4,79,75,0,2,1,1
S01011973,Owned: Total,199,143,100,12,88,41,2,56,55,0,0,0,1
S01011973,Owned: Owned outright,103,50,32,10,22,17,1,53,53,0,0,0,0
S01011973,Owned: Owned with a mortgage or loan or shared ownership,96,93,68,2,66,24,1,3,2,0,0,0,1
S01011973,Rented or living rent free: Total,73,50,44,6,38,4,2,23,20,0,2,1,0
S01011973,Rented or living rent free: Social rented,34,20,16,5,11,2,2,14,12,0,1,1,0
S01011973,Rented or living rent free: Private rented or living rent free,39,30,28,1,27,2,0,9,8,0,1,0,0
S01011974,All HRPs aged 16 and over,320,216,163,18,145,51,2,104,97,0,2,3,2
S01011974,Owned: Total,263,178,132,15,117,46,0,85,84,0,1,0,0
S01011974,Owned: Owned outright,133,62,38,7,31,24,0,71,71,0,0,0,0
S01011974,Owned: Owned with a mortgage or loan or shared ownership,130,116,94,8,86,22,0,14,13,0,1,0,0
S01011974,Rented or living rent free: Total,57,38,31,3,28,5,2,19,13,0,1,3,2
S01011974,Rented or living rent free: Social rented,12,6,4,1,3,1,1,6,4,0,1,1,0
S01011974,Rented or living rent free: Private rented or living rent free,45,32,27,2,25,4,1,13,9,0,0,2,2
S01011975,All HRPs aged 16 and over,199,128,87,14,73,36,5,71,62,1,1,5,2
S01011975,Owned: Total,140,93,60,9,51,31,2,47,45,1,0,0,1
S01011975,Owned: Owned outright,78,38,22,7,15,14,2,40,38,1,0,0,1
S01011975,Owned: Owned with a mortgage or loan or shared ownership,62,55,38,2,36,17,0,7,7,0,0,0,0
S01011975,Rented or living rent free: Total,59,35,27,5,22,5,3,24,17,0,1,5,1
S01011975,Rented or living rent free: Social rented,19,10,5,2,3,3,2,9,4,0,1,3,1
S01011975,Rented or living rent free: Private rented or living rent free,40,25,22,3,19,2,1,15,13,0,0,2,0
S01011976,All HRPs aged 16 and over,353,218,157,19,138,53,8,135,118,1,4,9,3
S01011976,Owned: Total,256,155,116,12,104,39,0,101,97,1,1,1,1
S01011976,Owned: Owned outright,142,44,30,5,25,14,0,98,94,1,1,1,1
S01011976,Owned: Owned with a mortgage or loan or shared ownership,114,111,86,7,79,25,0,3,3,0,0,0,0
S01011976,Rented or living rent free: Total,97,63,41,7,34,14,8,34,21,0,3,8,2
S01011976,Rented or living rent free: Social rented,39,18,14,3,11,3,1,21,11,0,2,6,2
S01011976,Rented or living rent free: Private rented or living rent free,58,45,27,4,23,11,7,13,10,0,1,2,0
S01011977,All HRPs aged 16 and over,508,307,227,34,193,70,10,201,153,4,9,26,9
S01011977,Owned: Total,292,202,150,18,132,51,1,90,86,0,0,2,2
S01011977,Owned: Owned outright,159,85,52,13,39,33,0,74,73,0,0,1,0
S01011977,Owned: Owned with a mortgage or loan or shared ownership,133,117,98,5,93,18,1,16,13,0,0,1,2
S01011977,Rented or living rent free: Total,216,105,77,16,61,19,9,111,67,4,9,24,7
S01011977,Rented or living rent free: Social rented,130,48,40,9,31,4,4,82,49,2,6,20,5
S01011977,Rented or living rent free: Private rented or living rent free,86,57,37,7,30,15,5,29,18,2,3,4,2
S01011978,All HRPs aged 16 and over,351,171,136,26,110,26,9,180,155,5,6,11,3
S01011978,Owned: Total,217,113,87,14,73,20,6,104,99,1,0,2,2
S01011978,Owned: Owned outright,137,42,30,10,20,8,4,95,92,0,0,2,1
S01011978,Owned: Owned with a mortgage or loan or shared ownership,80,71,57,4,53,12,2,9,7,1,0,0,1
S01011978,Rented or living rent free: Total,134,58,49,12,37,6,3,76,56,4,6,9,1
S01011978,Rented or living rent free: Social rented,93,34,32,8,24,1,1,59,46,2,5,6,0
S01011978,Rented or living rent free: Private rented or living rent free,41,24,17,4,13,5,2,17,10,2,1,3,1
S01011979,All HRPs aged 16 and over,397,275,200,19,181,74,1,122,110,3,3,5,1
S01011979,Owned: Total,306,223,160,15,145,62,1,83,81,1,0,0,1
S01011979,Owned: Owned outright,152,76,42,6,36,34,0,76,74,1,0,0,1
S01011979,Owned: Owned with a mortgage or loan or shared ownership,154,147,118,9,109,28,1,7,7,0,0,0,0
S01011979,Rented or living rent free: Total,91,52,40,4,36,12,0,39,29,2,3,5,0
S01011979,Rented or living rent free: Social rented,26,5,5,1,4,0,0,21,17,0,0,4,0
S01011979,Rented or living rent free: Private rented or living rent free,65,47,35,3,32,12,0,18,12,2,3,1,0
S01011980,All HRPs aged 16 and over,182,129,80,6,74,45,4,53,47,0,0,4,2
S01011980,Owned: Total,127,90,49,4,45,39,2,37,35,0,0,1,1
S01011980,Owned: Owned outright,87,53,26,4,22,26,1,34,33,0,0,1,0
S01011980,Owned: Owned with a mortgage or loan or shared ownership,40,37,23,0,23,13,1,3,2,0,0,0,1
S01011980,Rented or living rent free: Total,55,39,31,2,29,6,2,16,12,0,0,3,1
S01011980,Rented or living rent free: Social rented,5,1,1,0,1,0,0,4,1,0,0,2,1
S01011980,Rented or living rent free: Private rented or living rent free,50,38,30,2,28,6,2,12,11,0,0,1,0
S01011981,All HRPs aged 16 and over,396,286,188,35,153,92,6,110,96,0,3,10,1
S01011981,Owned: Total,196,135,75,20,55,59,1,61,57,0,2,1,1
S01011981,Owned: Owned outright,122,70,32,10,22,37,1,52,48,0,2,1,1
S01011981,Owned: Owned with a mortgage or loan or shared ownership,74,65,43,10,33,22,0,9,9,0,0,0,0
S01011981,Rented or living rent free: Total,200,151,113,15,98,33,5,49,39,0,1,9,0
S01011981,Rented or living rent free: Social rented,32,17,12,2,10,5,0,15,8,0,1,6,0
S01011981,Rented or living rent free: Private rented or living rent free,168,134,101,13,88,28,5,34,31,0,0,3,0
S01011982,All HRPs aged 16 and over,414,306,203,26,177,98,5,108,95,1,1,7,4
S01011982,Owned: Total,219,154,85,6,79,69,0,65,65,0,0,0,0
S01011982,Owned: Owned outright,131,73,34,3,31,39,0,58,58,0,0,0,0
S01011982,Owned: Owned with a mortgage or loan or shared ownership,88,81,51,3,48,30,0,7,7,0,0,0,0
S01011982,Rented or living rent free: Total,195,152,118,20,98,29,5,43,30,1,1,7,4
S01011982,Rented or living rent free: Social rented,11,7,7,2,5,0,0,4,2,0,0,2,0
S01011982,Rented or living rent free: Private rented or living rent free,184,145,111,18,93,29,5,39,28,1,1,5,4
S01011983,All HRPs aged 16 and over,351,209,141,25,116,59,9,142,134,1,1,4,2
S01011983,Owned: Total,208,116,68,17,51,42,6,92,92,0,0,0,0
S01011983,Owned: Owned outright,150,63,35,12,23,23,5,87,87,0,0,0,0
S01011983,Owned: Owned with a mortgage or loan or shared ownership,58,53,33,5,28,19,1,5,5,0,0,0,0
S01011983,Rented or living rent free: Total,143,93,73,8,65,17,3,50,42,1,1,4,2
S01011983,Rented or living rent free: Social rented,46,28,25,4,21,1,2,18,11,0,1,4,2
S01011983,Rented or living rent free: Private rented or living rent free,97,65,48,4,44,16,1,32,31,1,0,0,0
S01011984,All HRPs aged 16 and over,315,175,146,28,118,24,5,140,100,3,6,24,7
S01011984,Owned: Total,120,78,61,5,56,17,0,42,39,0,1,1,1
S01011984,Owned: Owned outright,61,24,19,3,16,5,0,37,36,0,0,1,0
S01011984,Owned: Owned with a mortgage or loan or shared ownership,59,54,42,2,40,12,0,5,3,0,1,0,1
S01011984,Rented or living rent free: Total,195,97,85,23,62,7,5,98,61,3,5,23,6
S01011984,Rented or living rent free: Social rented,172,79,68,19,49,6,5,93,57,3,5,23,5
S01011984,Rented or living rent free: Private rented or living rent free,23,18,17,4,13,1,0,5,4,0,0,0,1
S01011985,All HRPs aged 16 and over,293,196,134,16,118,53,9,97,87,2,2,2,4
S01011985,Owned: Total,230,153,105,12,93,46,2,77,73,0,1,0,3
S01011985,Owned: Owned outright,124,52,33,4,29,17,2,72,68,0,1,0,3
S01011985,Owned: Owned with a mortgage or loan or shared ownership,106,101,72,8,64,29,0,5,5,0,0,0,0
S01011985,Rented or living rent free: Total,63,43,29,4,25,7,7,20,14,2,1,2,1
S01011985,Rented or living rent free: Social rented,13,6,4,1,3,1,1,7,4,0,1,2,0
S01011985,Rented or living rent free: Private rented or living rent free,50,37,25,3,22,6,6,13,10,2,0,0,1
S01011986,All HRPs aged 16 and over,320,193,149,36,113,26,18,127,80,0,7,29,11
S01011986,Owned: Total,114,69,54,6,48,14,1,45,42,0,1,1,1
S01011986,Owned: Owned outright,51,15,11,2,9,3,1,36,34,0,0,1,1
S01011986,Owned: Owned with a mortgage or loan or shared ownership,63,54,43,4,39,11,0,9,8,0,1,0,0
S01011986,Rented or living rent free: Total,206,124,95,30,65,12,17,82,38,0,6,28,10
S01011986,Rented or living rent free: Social rented,178,103,81,27,54,7,15,75,36,0,3,26,10
S01011986,Rented or living rent free: Private rented or living rent free,28,21,14,3,11,5,2,7,2,0,3,2,0
S01011987,All HRPs aged 16 and over,403,254,216,46,170,33,5,149,122,0,7,17,3
S01011987,Owned: Total,257,163,136,25,111,27,0,94,90,0,2,1,1
S01011987,Owned: Owned outright,128,45,35,9,26,10,0,83,80,0,1,1,1
S01011987,Owned: Owned with a mortgage or loan or shared ownership,129,118,101,16,85,17,0,11,10,0,1,0,0
S01011987,Rented or living rent free: Total,146,91,80,21,59,6,5,55,32,0,5,16,2
S01011987,Rented or living rent free: Social rented,108,64,59,19,40,1,4,44,26,0,5,11,2
S01011987,Rented or living rent free: Private rented or living rent free,38,27,21,2,19,5,1,11,6,0,0,5,0
S01011988,All HRPs aged 16 and over,297,162,123,15,108,38,1,135,127,2,1,4,1
S01011988,Owned: Total,268,149,111,15,96,37,1,119,115,1,0,3,0
S01011988,Owned: Owned outright,161,53,43,13,30,10,0,108,106,0,0,2,0
S01011988,Owned: Owned with a mortgage or loan or shared ownership,107,96,68,2,66,27,1,11,9,1,0,1,0
S01011988,Rented or living rent free: Total,29,13,12,0,12,1,0,16,12,1,1,1,1
S01011988,Rented or living rent free: Social rented,11,1,1,0,1,0,0,10,8,0,0,1,1
S01011988,Rented or living rent free: Private rented or living rent free,18,12,11,0,11,1,0,6,4,1,1,0,0
S01011989,All HRPs aged 16 and over,379,228,179,28,151,47,2,151,139,0,2,9,1
S01011989,Owned: Total,307,185,145,19,126,39,1,122,117,0,1,3,1
S01011989,Owned: Owned outright,157,50,37,9,28,12,1,107,103,0,1,2,1
S01011989,Owned: Owned with a mortgage or loan or shared ownership,150,135,108,10,98,27,0,15,14,0,0,1,0
S01011989,Rented or living rent free: Total,72,43,34,9,25,8,1,29,22,0,1,6,0
S01011989,Rented or living rent free: Social rented,36,19,14,6,8,5,0,17,14,0,1,2,0
S01011989,Rented or living rent free: Private rented or living rent free,36,24,20,3,17,3,1,12,8,0,0,4,0
S01011990,All HRPs aged 16 and over,364,184,140,18,122,37,7,180,172,0,2,3,3
S01011990,Owned: Total,313,153,117,14,103,35,1,160,155,0,1,2,2
S01011990,Owned: Owned outright,216,67,51,7,44,16,0,149,147,0,1,1,0
S01011990,Owned: Owned with a mortgage or loan or shared ownership,97,86,66,7,59,19,1,11,8,0,0,1,2
S01011990,Rented or living rent free: Total,51,31,23,4,19,2,6,20,17,0,1,1,1
S01011990,Rented or living rent free: Social rented,14,8,6,2,4,0,2,6,4,0,1,0,1
S01011990,Rented or living rent free: Private rented or living rent free,37,23,17,2,15,2,4,14,13,0,0,1,0
S01011991,All HRPs aged 16 and over,298,182,147,25,122,29,6,116,96,0,4,12,4
S01011991,Owned: Total,220,145,119,19,100,25,1,75,73,0,1,1,0
S01011991,Owned: Owned outright,117,55,44,12,32,10,1,62,60,0,1,1,0
S01011991,Owned: Owned with a mortgage or loan or shared ownership,103,90,75,7,68,15,0,13,13,0,0,0,0
S01011991,Rented or living rent free: Total,78,37,28,6,22,4,5,41,23,0,3,11,4
S01011991,Rented or living rent free: Social rented,55,23,19,6,13,1,3,32,18,0,2,8,4
S01011991,Rented or living rent free: Private rented or living rent free,23,14,9,0,9,3,2,9,5,0,1,3,0
S01011992,All HRPs aged 16 and over,472,271,192,32,160,69,10,201,189,1,3,6,2
S01011992,Owned: Total,377,200,135,22,113,57,8,177,172,0,2,1,2
S01011992,Owned: Owned outright,246,80,48,15,33,27,5,166,163,0,1,1,1
S01011992,Owned: Owned with a mortgage or loan or shared ownership,131,120,87,7,80,30,3,11,9,0,1,0,1
S01011992,Rented or living rent free: Total,95,71,57,10,47,12,2,24,17,1,1,5,0
S01011992,Rented or living rent free: Social rented,11,4,3,0,3,0,1,7,4,0,0,3,0
S01011992,Rented or living rent free: Private rented or living rent free,84,67,54,10,44,12,1,17,13,1,1,2,0
S01011993,All HRPs aged 16 and over,460,272,230,44,186,24,18,188,151,2,6,17,12
S01011993,Owned: Total,176,110,90,11,79,18,2,66,65,0,0,1,0
S01011993,Owned: Owned outright,85,27,20,7,13,6,1,58,57,0,0,1,0
S01011993,Owned: Owned with a mortgage or loan or shared ownership,91,83,70,4,66,12,1,8,8,0,0,0,0
S01011993,Rented or living rent free: Total,284,162,140,33,107,6,16,122,86,2,6,16,12
S01011993,Rented or living rent free: Social rented,150,51,44,13,31,0,7,99,76,2,3,11,7
S01011993,Rented or living rent free: Private rented or living rent free,134,111,96,20,76,6,9,23,10,0,3,5,5
S01011994,All HRPs aged 16 and over,305,143,94,21,73,48,1,162,159,0,1,1,1
S01011994,Owned: Total,286,133,86,19,67,46,1,153,151,0,0,1,1
S01011994,Owned: Owned outright,212,71,42,13,29,29,0,141,139,0,0,1,1
S01011994,Owned: Owned with a mortgage or loan or shared ownership,74,62,44,6,38,17,1,12,12,0,0,0,0
S01011994,Rented or living rent free: Total,19,10,8,2,6,2,0,9,8,0,1,0,0
S01011994,Rented or living rent free: Social rented,4,2,1,0,1,1,0,2,1,0,1,0,0
S01011994,Rented or living rent free: Private rented or living rent free,15,8,7,2,5,1,0,7,7,0,0,0,0
S01011995,All HRPs aged 16 and over,324,245,170,17,153,73,2,79,70,0,2,4,3
S01011995,Owned: Total,235,179,123,16,107,55,1,56,53,0,1,1,1
S01011995,Owned: Owned outright,120,68,43,10,33,24,1,52,50,0,1,0,1
S01011995,Owned: Owned with a mortgage or loan or shared ownership,115,111,80,6,74,31,0,4,3,0,0,1,0
S01011995,Rented or living rent free: Total,89,66,47,1,46,18,1,23,17,0,1,3,2
S01011995,Rented or living rent free: Social rented,8,2,1,0,1,0,1,6,4,0,1,1,0
S01011995,Rented or living rent free: Private rented or living rent free,81,64,46,1,45,18,0,17,13,0,0,2,2
S01011996,All HRPs aged 16 and over,254,155,130,22,108,21,4,99,85,1,2,9,2
S01011996,Owned: Total,153,97,78,8,70,19,0,56,54,0,0,2,0
S01011996,Owned: Owned outright,81,32,22,4,18,10,0,49,48,0,0,1,0
S01011996,Owned: Owned with a mortgage or loan or shared ownership,72,65,56,4,52,9,0,7,6,0,0,1,0
S01011996,Rented or living rent free: Total,101,58,52,14,38,2,4,43,31,1,2,7,2
S01011996,Rented or living rent free: Social rented,73,34,31,11,20,0,3,39,28,1,2,7,1
S01011996,Rented or living rent free: Private rented or living rent free,28,24,21,3,18,2,1,4,3,0,0,0,1
S01011997,All HRPs aged 16 and over,422,288,231,34,197,48,9,134,110,1,8,9,6
S01011997,Owned: Total,260,181,143,12,131,36,2,79,76,1,0,2,0
S01011997,Owned: Owned outright,121,52,34,7,27,16,2,69,66,1,0,2,0
S01011997,Owned: Owned with a mortgage or loan or shared ownership,139,129,109,5,104,20,0,10,10,0,0,0,0
S01011997,Rented or living rent free: Total,162,107,88,22,66,12,7,55,34,0,8,7,6
S01011997,Rented or living rent free: Social rented,102,59,49,15,34,4,6,43,28,0,7,4,4
S01011997,Rented or living rent free: Private rented or living rent free,60,48,39,7,32,8,1,12,6,0,1,3,2
S01011998,All HRPs aged 16 and over,220,142,99,15,84,41,2,78,74,0,2,1,1
S01011998,Owned: Total,190,123,85,15,70,37,1,67,65,0,2,0,0
S01011998,Owned: Owned outright,100,41,32,13,19,9,0,59,59,0,0,0,0
S01011998,Owned: Owned with a mortgage or loan or shared ownership,90,82,53,2,51,28,1,8,6,0,2,0,0
S01011998,Rented or living rent free: Total,30,19,14,0,14,4,1,11,9,0,0,1,1
S01011998,Rented or living rent free: Social rented,9,4,2,0,2,1,1,5,3,0,0,1,1
S01011998,Rented or living rent free: Private rented or living rent free,21,15,12,0,12,3,0,6,6,0,0,0,0
S01011999,All HRPs aged 16 and over,291,214,153,21,132,55,6,77,67,1,3,6,0
S01011999,Owned: Total,153,115,83,9,74,32,0,38,36,0,0,2,0
S01011999,Owned: Owned outright,74,41,21,5,16,20,0,33,31,0,0,2,0
S01011999,Owned: Owned with a mortgage or loan or shared ownership,79,74,62,4,58,12,0,5,5,0,0,0,0
S01011999,Rented or living rent free: Total,138,99,70,12,58,23,6,39,31,1,3,4,0
S01011999,Rented or living rent free: Social rented,22,11,5,3,2,3,3,11,7,0,1,3,0
S01011999,Rented or living rent free: Private rented or living rent free,116,88,65,9,56,20,3,28,24,1,2,1,0
S01012000,All HRPs aged 16 and over,198,144,118,11,107,25,1,54,52,0,1,0,1
S01012000,Owned: Total,163,117,91,7,84,25,1,46,45,0,1,0,0
S01012000,Owned: Owned outright,78,35,21,3,18,14,0,43,43,0,0,0,0
S01012000,Owned: Owned with a mortgage or loan or shared ownership,85,82,70,4,66,11,1,3,2,0,1,0,0
S01012000,Rented or living rent free: Total,35,27,27,4,23,0,0,8,7,0,0,0,1
S01012000,Rented or living rent free: Social rented,9,4,4,1,3,0,0,5,5,0,0,0,0
S01012000,Rented or living rent free: Private rented or living rent free,26,23,23,3,20,0,0,3,2,0,0,0,1
S01012001,All HRPs aged 16 and over,296,198,153,14,139,41,4,98,88,0,4,5,1
S01012001,Owned: Total,206,149,115,9,106,33,1,57,56,0,0,1,0
S01012001,Owned: Owned outright,90,44,26,4,22,17,1,46,45,0,0,1,0
S01012001,Owned: Owned with a mortgage or loan or shared ownership,116,105,89,5,84,16,0,11,11,0,0,0,0
S01012001,Rented or living rent free: Total,90,49,38,5,33,8,3,41,32,0,4,4,1
S01012001,Rented or living rent free: Social rented,61,28,21,3,18,4,3,33,27,0,3,3,0
S01012001,Rented or living rent free: Private rented or living rent free,29,21,17,2,15,4,0,8,5,0,1,1,1
S01012002,All HRPs aged 16 and over,243,134,104,16,88,28,2,109,102,0,1,5,1
S01012002,Owned: Total,177,111,88,12,76,22,1,66,65,0,0,0,1
S01012002,Owned: Owned outright,94,35,30,6,24,4,1,59,58,0,0,0,1
S01012002,Owned: Owned with a mortgage or loan or shared ownership,83,76,58,6,52,18,0,7,7,0,0,0,0
S01012002,Rented or living rent free: Total,66,23,16,4,12,6,1,43,37,0,1,5,0
S01012002,Rented or living rent free: Social rented,50,16,10,3,7,5,1,34,30,0,0,4,0
S01012002,Rented or living rent free: Private rented or living rent free,16,7,6,1,5,1,0,9,7,0,1,1,0
S01012003,All HRPs aged 16 and over,241,161,131,20,111,21,9,80,66,0,3,9,2
S01012003,Owned: Total,157,111,90,12,78,17,4,46,43,0,2,0,1
S01012003,Owned: Owned outright,83,42,35,8,27,7,0,41,39,0,1,0,1
S01012003,Owned: Owned with a mortgage or loan or shared ownership,74,69,55,4,51,10,4,5,4,0,1,0,0
S01012003,Rented or living rent free: Total,84,50,41,8,33,4,5,34,23,0,1,9,1
S01012003,Rented or living rent free: Social rented,35,15,13,2,11,0,2,20,16,0,1,2,1
S01012003,Rented or living rent free: Private rented or living rent free,49,35,28,6,22,4,3,14,7,0,0,7,0
S01012004,All HRPs aged 16 and over,398,245,192,20,172,46,7,153,137,0,2,11,3
S01012004,Owned: Total,303,197,156,13,143,40,1,106,105,0,0,1,0
S01012004,Owned: Owned outright,174,74,56,9,47,18,0,100,100,0,0,0,0
S01012004,Owned: Owned with a mortgage or loan or shared ownership,129,123,100,4,96,22,1,6,5,0,0,1,0
S01012004,Rented or living rent free: Total,95,48,36,7,29,6,6,47,32,0,2,10,3
S01012004,Rented or living rent free: Social rented,63,25,16,4,12,3,6,38,25,0,2,8,3
S01012004,Rented or living rent free: Private rented or living rent free,32,23,20,3,17,3,0,9,7,0,0,2,0
S01012005,All HRPs aged 16 and over,334,259,217,25,192,37,5,75,67,1,2,4,1
S01012005,Owned: Total,295,236,199,20,179,34,3,59,58,0,1,0,0
S01012005,Owned: Owned outright,120,68,58,13,45,8,2,52,52,0,0,0,0
S01012005,Owned: Owned with a mortgage or loan or shared ownership,175,168,141,7,134,26,1,7,6,0,1,0,0
S01012005,Rented or living rent free: Total,39,23,18,5,13,3,2,16,9,1,1,4,1
S01012005,Rented or living rent free: Social rented,26,16,13,5,8,1,2,10,7,0,1,2,0
S01012005,Rented or living rent free: Private rented or living rent free,13,7,5,0,5,2,0,6,2,1,0,2,1
S01012006,All HRPs aged 16 and over,280,221,156,17,139,59,6,59,47,0,2,7,3
S01012006,Owned: Total,150,113,75,11,64,34,4,37,34,0,0,1,2
S01012006,Owned: Owned outright,83,52,34,8,26,17,1,31,29,0,0,0,2
S01012006,Owned: Owned with a mortgage or loan or shared ownership,67,61,41,3,38,17,3,6,5,0,0,1,0
S01012006,Rented or living rent free: Total,130,108,81,6,75,25,2,22,13,0,2,6,1
S01012006,Rented or living rent free: Social rented,9,3,3,1,2,0,0,6,1,0,0,5,0
S01012006,Rented or living rent free: Private rented or living rent free,121,105,78,5,73,25,2,16,12,0,2,1,1
S01012007,All HRPs aged 16 and over,374,219,169,32,137,49,1,155,143,2,2,6,2
S01012007,Owned: Total,233,149,110,21,89,39,0,84,83,0,0,0,1
S01012007,Owned: Owned outright,142,64,44,15,29,20,0,78,77,0,0,0,1
S01012007,Owned: Owned with a mortgage or loan or shared ownership,91,85,66,6,60,19,0,6,6,0,0,0,0
S01012007,Rented or living rent free: Total,141,70,59,11,48,10,1,71,60,2,2,6,1
S01012007,Rented or living rent free: Social rented,71,19,17,6,11,1,1,52,43,2,1,5,1
S01012007,Rented or living rent free: Private rented or living rent free,70,51,42,5,37,9,0,19,17,0,1,1,0
S01012008,All HRPs aged 16 and over,421,302,214,41,173,79,9,119,104,4,0,8,3
S01012008,Owned: Total,248,173,117,22,95,55,1,75,73,2,0,0,0
S01012008,Owned: Owned outright,146,78,45,13,32,32,1,68,66,2,0,0,0
S01012008,Owned: Owned with a mortgage or loan or shared ownership,102,95,72,9,63,23,0,7,7,0,0,0,0
S01012008,Rented or living rent free: Total,173,129,97,19,78,24,8,44,31,2,0,8,3
S01012008,Rented or living rent free: Social rented,74,46,40,12,28,3,3,28,16,2,0,8,2
S01012008,Rented or living rent free: Private rented or living rent free,99,83,57,7,50,21,5,16,15,0,0,0,1
S01012009,All HRPs aged 16 and over,300,209,147,19,128,56,6,91,80,1,4,5,1
S01012009,Owned: Total,154,104,72,10,62,29,3,50,48,0,0,1,1
S01012009,Owned: Owned outright,91,44,27,5,22,17,0,47,45,0,0,1,1
S01012009,Owned: Owned with a mortgage or loan or shared ownership,63,60,45,5,40,12,3,3,3,0,0,0,0
S01012009,Rented or living rent free: Total,146,105,75,9,66,27,3,41,32,1,4,4,0
S01012009,Rented or living rent free: Social rented,56,37,27,6,21,7,3,19,12,1,3,3,0
S01012009,Rented or living rent free: Private rented or living rent free,90,68,48,3,45,20,0,22,20,0,1,1,0
S01012010,All HRPs aged 16 and over,524,303,232,31,201,68,3,221,202,0,2,12,5
S01012010,Owned: Total,391,203,146,21,125,55,2,188,181,0,1,5,1
S01012010,Owned: Owned outright,259,83,62,14,48,20,1,176,171,0,0,4,1
S01012010,Owned: Owned with a mortgage or loan or shared ownership,132,120,84,7,77,35,1,12,10,0,1,1,0
S01012010,Rented or living rent free: Total,133,100,86,10,76,13,1,33,21,0,1,7,4
S01012010,Rented or living rent free: Social rented,46,30,27,7,20,3,0,16,6,0,1,6,3
S01012010,Rented or living rent free: Private rented or living rent free,87,70,59,3,56,10,1,17,15,0,0,1,1
S01012011,All HRPs aged 16 and over,537,337,262,59,203,65,10,200,174,6,2,13,5
S01012011,Owned: Total,298,171,125,21,104,46,0,127,122,0,1,2,2
S01012011,Owned: Owned outright,195,79,53,14,39,26,0,116,112,0,0,2,2
S01012011,Owned: Owned with a mortgage or loan or shared ownership,103,92,72,7,65,20,0,11,10,0,1,0,0
S01012011,Rented or living rent free: Total,239,166,137,38,99,19,10,73,52,6,1,11,3
S01012011,Rented or living rent free: Social rented,158,104,85,31,54,10,9,54,42,0,1,8,3
S01012011,Rented or living rent free: Private rented or living rent free,81,62,52,7,45,9,1,19,10,6,0,3,0
S01012012,All HRPs aged 16 and over,320,157,101,15,86,49,7,163,153,0,0,7,3
S01012012,Owned: Total,206,104,70,10,60,33,1,102,100,0,0,1,1
S01012012,Owned: Owned outright,125,44,22,6,16,21,1,81,80,0,0,1,0
S01012012,Owned: Owned with a mortgage or loan or shared ownership,81,60,48,4,44,12,0,21,20,0,0,0,1
S01012012,Rented or living rent free: Total,114,53,31,5,26,16,6,61,53,0,0,6,2
S01012012,Rented or living rent free: Social rented,66,15,9,3,6,1,5,51,45,0,0,5,1
S01012012,Rented or living rent free: Private rented or living rent free,48,38,22,2,20,15,1,10,8,0,0,1,1
S01012013,All HRPs aged 16 and over,357,233,152,29,123,75,6,124,115,0,1,3,5
S01012013,Owned: Total,215,129,79,16,63,49,1,86,84,0,1,0,1
S01012013,Owned: Owned outright,140,63,33,10,23,29,1,77,76,0,0,0,1
S01012013,Owned: Owned with a mortgage or loan or shared ownership,75,66,46,6,40,20,0,9,8,0,1,0,0
S01012013,Rented or living rent free: Total,142,104,73,13,60,26,5,38,31,0,0,3,4
S01012013,Rented or living rent free: Social rented,38,26,20,6,14,3,3,12,7,0,0,2,3
S01012013,Rented or living rent free: Private rented or living rent free,104,78,53,7,46,23,2,26,24,0,0,1,1
S01012014,All HRPs aged 16 and over,402,275,203,42,161,59,13,127,110,2,3,10,2
S01012014,Owned: Total,211,142,94,18,76,45,3,69,69,0,0,0,0
S01012014,Owned: Owned outright,108,50,33,13,20,16,1,58,58,0,0,0,0
S01012014,Owned: Owned with a mortgage or loan or shared ownership,103,92,61,5,56,29,2,11,11,0,0,0,0
S01012014,Rented or living rent free: Total,191,133,109,24,85,14,10,58,41,2,3,10,2
S01012014,Rented or living rent free: Social rented,118,67,53,19,34,5,9,51,38,1,2,8,2
S01012014,Rented or living rent free: Private rented or living rent free,73,66,56,5,51,9,1,7,3,1,1,2,0
S01012015,All HRPs aged 16 and over,420,263,187,29,158,64,12,157,144,1,4,8,0
S01012015,Owned: Total,270,160,112,15,97,46,2,110,110,0,0,0,0
S01012015,Owned: Owned outright,162,57,37,9,28,20,0,105,105,0,0,0,0
S01012015,Owned: Owned with a mortgage or loan or shared ownership,108,103,75,6,69,26,2,5,5,0,0,0,0
S01012015,Rented or living rent free: Total,150,103,75,14,61,18,10,47,34,1,4,8,0
S01012015,Rented or living rent free: Social rented,90,56,43,10,33,7,6,34,22,1,3,8,0
S01012015,Rented or living rent free: Private rented or living rent free,60,47,32,4,28,11,4,13,12,0,1,0,0
S01012016,All HRPs aged 16 and over,360,250,165,28,137,78,7,110,101,0,2,6,1
S01012016,Owned: Total,216,140,85,16,69,53,2,76,72,0,1,2,1
S01012016,Owned: Owned outright,137,62,33,11,22,29,0,75,71,0,1,2,1
S01012016,Owned: Owned with a mortgage or loan or shared ownership,79,78,52,5,47,24,2,1,1,0,0,0,0
S01012016,Rented or living rent free: Total,144,110,80,12,68,25,5,34,29,0,1,4,0
S01012016,Rented or living rent free: Social rented,45,29,23,10,13,4,2,16,11,0,1,4,0
S01012016,Rented or living rent free: Private rented or living rent free,99,81,57,2,55,21,3,18,18,0,0,0,0
S01012017,All HRPs aged 16 and over,221,147,74,13,61,72,1,74,69,0,2,2,1
S01012017,Owned: Total,148,93,34,8,26,58,1,55,53,0,1,1,0
S01012017,Owned: Owned outright,100,53,13,5,8,39,1,47,45,0,1,1,0
S01012017,Owned: Owned with a mortgage or loan or shared ownership,48,40,21,3,18,19,0,8,8,0,0,0,0
S01012017,Rented or living rent free: Total,73,54,40,5,35,14,0,19,16,0,1,1,1
S01012017,Rented or living rent free: Social rented,10,4,2,0,2,2,0,6,3,0,1,1,1
S01012017,Rented or living rent free: Private rented or living rent free,63,50,38,5,33,12,0,13,13,0,0,0,0
S01012018,All HRPs aged 16 and over,374,255,165,26,139,83,7,119,107,0,1,9,2
S01012018,Owned: Total,238,144,86,12,74,55,3,94,91,0,0,1,2
S01012018,Owned: Owned outright,145,62,34,8,26,28,0,83,81,0,0,0,2
S01012018,Owned: Owned with a mortgage or loan or shared ownership,93,82,52,4,48,27,3,11,10,0,0,1,0
S01012018,Rented or living rent free: Total,136,111,79,14,65,28,4,25,16,0,1,8,0
S01012018,Rented or living rent free: Social rented,34,21,16,5,11,2,3,13,5,0,0,8,0
S01012018,Rented or living rent free: Private rented or living rent free,102,90,63,9,54,26,1,12,11,0,1,0,0
S01012019,All HRPs aged 16 and over,371,276,229,30,199,30,17,95,76,0,3,13,3
S01012019,Owned: Total,297,225,190,20,170,29,6,72,61,0,2,7,2
S01012019,Owned: Owned outright,109,53,38,10,28,13,2,56,53,0,0,2,1
S01012019,Owned: Owned with a mortgage or loan or shared ownership,188,172,152,10,142,16,4,16,8,0,2,5,1
S01012019,Rented or living rent free: Total,74,51,39,10,29,1,11,23,15,0,1,6,1
S01012019,Rented or living rent free: Social rented,25,12,6,3,3,0,6,13,8,0,1,3,1
S01012019,Rented or living rent free: Private rented or living rent free,49,39,33,7,26,1,5,10,7,0,0,3,0
S01012020,All HRPs aged 16 and over,361,188,158,23,135,21,9,173,137,6,2,21,7
S01012020,Owned: Total,206,139,120,11,109,16,3,67,61,0,1,2,3
S01012020,Owned: Owned outright,91,37,33,6,27,3,1,54,53,0,0,0,1
S01012020,Owned: Owned with a mortgage or loan or shared ownership,115,102,87,5,82,13,2,13,8,0,1,2,2
S01012020,Rented or living rent free: Total,155,49,38,12,26,5,6,106,76,6,1,19,4
S01012020,Rented or living rent free: Social rented,126,25,21,8,13,2,2,101,74,6,1,16,4
S01012020,Rented or living rent free: Private rented or living rent free,29,24,17,4,13,3,4,5,2,0,0,3,0
S01012021,All HRPs aged 16 and over,225,158,124,16,108,27,7,67,54,0,4,8,1
S01012021,Owned: Total,187,137,109,12,97,23,5,50,46,0,0,3,1
S01012021,Owned: Owned outright,87,44,32,8,24,12,0,43,42,0,0,0,1
S01012021,Owned: Owned with a mortgage or loan or shared ownership,100,93,77,4,73,11,5,7,4,0,0,3,0
S01012021,Rented or living rent free: Total,38,21,15,4,11,4,2,17,8,0,4,5,0
S01012021,Rented or living rent free: Social rented,33,18,13,4,9,3,2,15,7,0,4,4,0
S01012021,Rented or living rent free: Private rented or living rent free,5,3,2,0,2,1,0,2,1,0,0,1,0
S01012022,All HRPs aged 16 and over,289,204,169,33,136,30,5,85,63,0,4,15,3
S01012022,Owned: Total,221,163,134,18,116,28,1,58,53,0,0,4,1
S01012022,Owned: Owned outright,87,39,29,7,22,9,1,48,47,0,0,1,0
S01012022,Owned: Owned with a mortgage or loan or shared ownership,134,124,105,11,94,19,0,10,6,0,0,3,1
S01012022,Rented or living rent free: Total,68,41,35,15,20,2,4,27,10,0,4,11,2
S01012022,Rented or living rent free: Social rented,49,27,22,10,12,1,4,22,7,0,4,9,2
S01012022,Rented or living rent free: Private rented or living rent free,19,14,13,5,8,1,0,5,3,0,0,2,0
S01012023,All HRPs aged 16 and over,228,163,97,14,83,63,3,65,56,0,0,7,2
S01012023,Owned: Total,197,139,82,13,69,55,2,58,51,0,0,5,2
S01012023,Owned: Owned outright,99,50,25,8,17,25,0,49,46,0,0,3,0
S01012023,Owned: Owned with a mortgage or loan or shared ownership,98,89,57,5,52,30,2,9,5,0,0,2,2
S01012023,Rented or living rent free: Total,31,24,15,1,14,8,1,7,5,0,0,2,0
S01012023,Rented or living rent free: Social rented,5,4,2,0,2,1,1,1,0,0,0,1,0
S01012023,Rented or living rent free: Private rented or living rent free,26,20,13,1,12,7,0,6,5,0,0,1,0
S01012024,All HRPs aged 16 and over,363,282,229,28,201,43,10,81,67,3,2,6,3
S01012024,Owned: Total,310,248,205,23,182,39,4,62,54,2,1,3,2
S01012024,Owned: Owned outright,101,52,42,9,33,8,2,49,45,1,0,1,2
S01012024,Owned: Owned with a mortgage or loan or shared ownership,209,196,163,14,149,31,2,13,9,1,1,2,0
S01012024,Rented or living rent free: Total,53,34,24,5,19,4,6,19,13,1,1,3,1
S01012024,Rented or living rent free: Social rented,32,16,10,5,5,2,4,16,10,1,1,3,1
S01012024,Rented or living rent free: Private rented or living rent free,21,18,14,0,14,2,2,3,3,0,0,0,0
S01012025,All HRPs aged 16 and over,288,188,157,18,139,27,4,100,78,2,4,14,2
S01012025,Owned: Total,225,160,135,11,124,23,2,65,57,1,0,6,1
S01012025,Owned: Owned outright,68,25,19,3,16,6,0,43,42,1,0,0,0
S01012025,Owned: Owned with a mortgage or loan or shared ownership,157,135,116,8,108,17,2,22,15,0,0,6,1
S01012025,Rented or living rent free: Total,63,28,22,7,15,4,2,35,21,1,4,8,1
S01012025,Rented or living rent free: Social rented,52,20,18,6,12,1,1,32,21,0,3,7,1
S01012025,Rented or living rent free: Private rented or living rent free,11,8,4,1,3,3,1,3,0,1,1,1,0
S01012026,All HRPs aged 16 and over,211,183,154,12,142,29,0,28,16,0,7,4,1
S01012026,Owned: Total,193,171,145,9,136,26,0,22,15,0,4,2,1
S01012026,Owned: Owned outright,31,14,10,1,9,4,0,17,15,0,2,0,0
S01012026,Owned: Owned with a mortgage or loan or shared ownership,162,157,135,8,127,22,0,5,0,0,2,2,1
S01012026,Rented or living rent free: Total,18,12,9,3,6,3,0,6,1,0,3,2,0
S01012026,Rented or living rent free: Social rented,6,4,2,1,1,2,0,2,0,0,1,1,0
S01012026,Rented or living rent free: Private rented or living rent free,12,8,7,2,5,1,0,4,1,0,2,1,0
S01012027,All HRPs aged 16 and over,311,229,177,11,166,47,5,82,66,6,5,3,2
S01012027,Owned: Total,268,201,160,8,152,41,0,67,59,5,2,0,1
S01012027,Owned: Owned outright,96,43,31,3,28,12,0,53,52,1,0,0,0
S01012027,Owned: Owned with a mortgage or loan or shared ownership,172,158,129,5,124,29,0,14,7,4,2,0,1
S01012027,Rented or living rent free: Total,43,28,17,3,14,6,5,15,7,1,3,3,1
S01012027,Rented or living rent free: Social rented,19,7,7,1,6,0,0,12,5,1,2,3,1
S01012027,Rented or living rent free: Private rented or living rent free,24,21,10,2,8,6,5,3,2,0,1,0,0
S01012028,All HRPs aged 16 and over,375,248,196,16,180,46,6,127,118,2,1,5,1
S01012028,Owned: Total,352,229,184,15,169,40,5,123,117,2,1,2,1
S01012028,Owned: Owned outright,181,76,58,9,49,14,4,105,102,0,1,2,0
S01012028,Owned: Owned with a mortgage or loan or shared ownership,171,153,126,6,120,26,1,18,15,2,0,0,1
S01012028,Rented or living rent free: Total,23,19,12,1,11,6,1,4,1,0,0,3,0
S01012028,Rented or living rent free: Social rented,3,3,2,0,2,1,0,0,0,0,0,0,0
S01012028,Rented or living rent free: Private rented or living rent free,20,16,10,1,9,5,1,4,1,0,0,3,0
S01012029,All HRPs aged 16 and over,418,293,226,25,201,63,4,125,100,1,2,17,5
S01012029,Owned: Total,301,230,171,15,156,56,3,71,64,0,1,3,3
S01012029,Owned: Owned outright,116,61,40,8,32,20,1,55,52,0,0,2,1
S01012029,Owned: Owned with a mortgage or loan or shared ownership,185,169,131,7,124,36,2,16,12,0,1,1,2
S01012029,Rented or living rent free: Total,117,63,55,10,45,7,1,54,36,1,1,14,2
S01012029,Rented or living rent free: Social rented,22,7,7,2,5,0,0,15,6,1,1,6,1
S01012029,Rented or living rent free: Private rented or living rent free,95,56,48,8,40,7,1,39,30,0,0,8,1
S01012030,All HRPs aged 16 and over,249,198,128,18,110,67,3,51,43,0,2,4,2
S01012030,Owned: Total,177,145,95,10,85,48,2,32,28,0,1,3,0
S01012030,Owned: Owned outright,90,63,38,8,30,23,2,27,24,0,1,2,0
S01012030,Owned: Owned with a mortgage or loan or shared ownership,87,82,57,2,55,25,0,5,4,0,0,1,0
S01012030,Rented or living rent free: Total,72,53,33,8,25,19,1,19,15,0,1,1,2
S01012030,Rented or living rent free: Social rented,13,6,4,1,3,2,0,7,6,0,0,1,0
S01012030,Rented or living rent free: Private rented or living rent free,59,47,29,7,22,17,1,12,9,0,1,0,2
S01012031,All HRPs aged 16 and over,231,140,103,14,89,34,3,91,84,0,2,4,1
S01012031,Owned: Total,215,129,94,12,82,33,2,86,81,0,1,3,1
S01012031,Owned: Owned outright,125,46,34,9,25,10,2,79,76,0,1,2,0
S01012031,Owned: Owned with a mortgage or loan or shared ownership,90,83,60,3,57,23,0,7,5,0,0,1,1
S01012031,Rented or living rent free: Total,16,11,9,2,7,1,1,5,3,0,1,1,0
S01012031,Rented or living rent free: Social rented,6,3,2,1,1,1,0,3,1,0,1,1,0
S01012031,Rented or living rent free: Private rented or living rent free,10,8,7,1,6,0,1,2,2,0,0,0,0
S01012032,All HRPs aged 16 and over,142,101,62,8,54,38,1,41,36,0,1,4,0
S01012032,Owned: Total,120,87,54,7,47,33,0,33,33,0,0,0,0
S01012032,Owned: Owned outright,76,44,23,2,21,21,0,32,32,0,0,0,0
S01012032,Owned: Owned with a mortgage or loan or shared ownership,44,43,31,5,26,12,0,1,1,0,0,0,0
S01012032,Rented or living rent free: Total,22,14,8,1,7,5,1,8,3,0,1,4,0
S01012032,Rented or living rent free: Social rented,3,1,0,0,0,0,1,2,0,0,0,2,0
S01012032,Rented or living rent free: Private rented or living rent free,19,13,8,1,7,5,0,6,3,0,1,2,0
S01012033,All HRPs aged 16 and over,373,210,180,27,153,22,8,163,133,3,2,25,0
S01012033,Owned: Total,289,178,155,20,135,20,3,111,104,2,1,4,0
S01012033,Owned: Owned outright,140,54,46,11,35,7,1,86,82,1,1,2,0
S01012033,Owned: Owned with a mortgage or loan or shared ownership,149,124,109,9,100,13,2,25,22,1,0,2,0
S01012033,Rented or living rent free: Total,84,32,25,7,18,2,5,52,29,1,1,21,0
S01012033,Rented or living rent free: Social rented,60,17,14,6,8,0,3,43,23,0,0,20,0
S01012033,Rented or living rent free: Private rented or living rent free,24,15,11,1,10,2,2,9,6,1,1,1,0
S01012034,All HRPs aged 16 and over,386,243,197,36,161,36,10,143,110,7,5,18,3
S01012034,Owned: Total,265,179,147,22,125,30,2,86,73,4,1,6,2
S01012034,Owned: Owned outright,110,43,34,8,26,8,1,67,61,2,1,2,1
S01012034,Owned: Owned with a mortgage or loan or shared ownership,155,136,113,14,99,22,1,19,12,2,0,4,1
S01012034,Rented or living rent free: Total,121,64,50,14,36,6,8,57,37,3,4,12,1
S01012034,Rented or living rent free: Social rented,74,35,28,6,22,3,4,39,29,2,0,8,0
S01012034,Rented or living rent free: Private rented or living rent free,47,29,22,8,14,3,4,18,8,1,4,4,1
S01012035,All HRPs aged 16 and over,431,276,213,38,175,43,20,155,133,1,4,14,3
S01012035,Owned: Total,330,221,178,25,153,37,6,109,104,1,1,3,0
S01012035,Owned: Owned outright,156,63,43,11,32,15,5,93,91,1,0,1,0
S01012035,Owned: Owned with a mortgage or loan or shared ownership,174,158,135,14,121,22,1,16,13,0,1,2,0
S01012035,Rented or living rent free: Total,101,55,35,13,22,6,14,46,29,0,3,11,3
S01012035,Rented or living rent free: Social rented,67,31,14,6,8,6,11,36,22,0,2,9,3
S01012035,Rented or living rent free: Private rented or living rent free,34,24,21,7,14,0,3,10,7,0,1,2,0
S01012036,All HRPs aged 16 and over,385,237,198,24,174,28,11,148,127,2,2,11,6
S01012036,Owned: Total,354,220,186,20,166,28,6,134,123,2,0,4,5
S01012036,Owned: Owned outright,194,75,58,14,44,14,3,119,115,0,0,1,3
S01012036,Owned: Owned with a mortgage or loan or shared ownership,160,145,128,6,122,14,3,15,8,2,0,3,2
S01012036,Rented or living rent free: Total,31,17,12,4,8,0,5,14,4,0,2,7,1
S01012036,Rented or living rent free: Social rented,5,2,2,1,1,0,0,3,1,0,1,0,1
S01012036,Rented or living rent free: Private rented or living rent free,26,15,10,3,7,0,5,11,3,0,1,7,0
S01012037,All HRPs aged 16 and over,438,260,214,36,178,13,33,178,111,7,14,41,5
S01012037,Owned: Total,248,154,140,11,129,10,4,94,78,3,2,10,1
S01012037,Owned: Owned outright,82,23,17,6,11,6,0,59,51,1,1,6,0
S01012037,Owned: Owned with a mortgage or loan or shared ownership,166,131,123,5,118,4,4,35,27,2,1,4,1
S01012037,Rented or living rent free: Total,190,106,74,25,49,3,29,84,33,4,12,31,4
S01012037,Rented or living rent free: Social rented,152,80,60,22,38,2,18,72,30,3,9,26,4
S01012037,Rented or living rent free: Private rented or living rent free,38,26,14,3,11,1,11,12,3,1,3,5,0
S01012038,All HRPs aged 16 and over,366,199,157,53,104,14,28,167,55,6,44,47,15
S01012038,Owned: Total,88,60,48,9,39,9,3,28,23,1,2,1,1
S01012038,Owned: Owned outright,32,14,10,3,7,2,2,18,17,1,0,0,0
S01012038,Owned: Owned with a mortgage or loan or shared ownership,56,46,38,6,32,7,1,10,6,0,2,1,1
S01012038,Rented or living rent free: Total,278,139,109,44,65,5,25,139,32,5,42,46,14
S01012038,Rented or living rent free: Social rented,268,132,103,42,61,5,24,136,32,4,42,44,14
S01012038,Rented or living rent free: Private rented or living rent free,10,7,6,2,4,0,1,3,0,1,0,2,0
S01012039,All HRPs aged 16 and over,413,217,180,32,148,23,14,196,142,6,7,35,6
S01012039,Owned: Total,274,159,135,18,117,18,6,115,98,5,1,7,4
S01012039,Owned: Owned outright,114,39,32,6,26,4,3,75,68,5,1,1,0
S01012039,Owned: Owned with a mortgage or loan or shared ownership,160,120,103,12,91,14,3,40,30,0,0,6,4
S01012039,Rented or living rent free: Total,139,58,45,14,31,5,8,81,44,1,6,28,2
S01012039,Rented or living rent free: Social rented,123,52,42,13,29,5,5,71,40,1,6,23,1
S01012039,Rented or living rent free: Private rented or living rent free,16,6,3,1,2,0,3,10,4,0,0,5,1
S01012040,All HRPs aged 16 and over,255,183,155,20,135,22,6,72,49,3,5,13,2
S01012040,Owned: Total,198,153,130,13,117,21,2,45,36,2,4,2,1
S01012040,Owned: Owned outright,64,30,25,7,18,5,0,34,31,2,1,0,0
S01012040,Owned: Owned with a mortgage or loan or shared ownership,134,123,105,6,99,16,2,11,5,0,3,2,1
S01012040,Rented or living rent free: Total,57,30,25,7,18,1,4,27,13,1,1,11,1
S01012040,Rented or living rent free: Social rented,42,18,14,4,10,0,4,24,11,0,1,11,1
S01012040,Rented or living rent free: Private rented or living rent free,15,12,11,3,8,1,0,3,2,1,0,0,0
S01012041,All HRPs aged 16 and over,382,229,197,32,165,18,14,153,113,11,4,22,3
S01012041,Owned: Total,261,161,145,13,132,13,3,100,95,2,2,1,0
S01012041,Owned: Owned outright,107,30,26,4,22,3,1,77,75,1,1,0,0
S01012041,Owned: Owned with a mortgage or loan or shared ownership,154,131,119,9,110,10,2,23,20,1,1,1,0
S01012041,Rented or living rent free: Total,121,68,52,19,33,5,11,53,18,9,2,21,3
S01012041,Rented or living rent free: Social rented,82,47,36,14,22,2,9,35,16,2,2,14,1
S01012041,Rented or living rent free: Private rented or living rent free,39,21,16,5,11,3,2,18,2,7,0,7,2
S01012042,All HRPs aged 16 and over,408,227,188,29,159,28,11,181,139,5,11,19,7
S01012042,Owned: Total,274,164,145,15,130,18,1,110,104,1,1,1,3
S01012042,Owned: Owned outright,98,25,22,5,17,3,0,73,67,1,1,1,3
S01012042,Owned: Owned with a mortgage or loan or shared ownership,176,139,123,10,113,15,1,37,37,0,0,0,0
S01012042,Rented or living rent free: Total,134,63,43,14,29,10,10,71,35,4,10,18,4
S01012042,Rented or living rent free: Social rented,108,44,28,10,18,10,6,64,33,3,7,17,4
S01012042,Rented or living rent free: Private rented or living rent free,26,19,15,4,11,0,4,7,2,1,3,1,0
S01012043,All HRPs aged 16 and over,380,234,197,40,157,15,22,146,69,3,30,31,13
S01012043,Owned: Total,168,117,105,9,96,12,0,51,43,2,0,6,0
S01012043,Owned: Owned outright,61,24,21,3,18,3,0,37,31,1,0,5,0
S01012043,Owned: Owned with a mortgage or loan or shared ownership,107,93,84,6,78,9,0,14,12,1,0,1,0
S01012043,Rented or living rent free: Total,212,117,92,31,61,3,22,95,26,1,30,25,13
S01012043,Rented or living rent free: Social rented,175,101,81,29,52,3,17,74,25,1,13,24,11
S01012043,Rented or living rent free: Private rented or living rent free,37,16,11,2,9,0,5,21,1,0,17,1,2
S01012044,All HRPs aged 16 and over,474,207,167,35,132,15,25,267,183,5,15,55,9
S01012044,Owned: Total,201,107,93,12,81,11,3,94,85,2,1,5,1
S01012044,Owned: Owned outright,83,22,18,3,15,4,0,61,57,2,0,2,0
S01012044,Owned: Owned with a mortgage or loan or shared ownership,118,85,75,9,66,7,3,33,28,0,1,3,1
S01012044,Rented or living rent free: Total,273,100,74,23,51,4,22,173,98,3,14,50,8
S01012044,Rented or living rent free: Social rented,249,85,62,20,42,4,19,164,94,3,11,48,8
S01012044,Rented or living rent free: Private rented or living rent free,24,15,12,3,9,0,3,9,4,0,3,2,0
S01012045,All HRPs aged 16 and over,583,356,281,39,242,29,46,227,117,9,15,73,13
S01012045,Owned: Total,256,177,151,11,140,20,6,79,67,4,0,5,3
S01012045,Owned: Owned outright,92,32,30,5,25,0,2,60,52,3,0,3,2
S01012045,Owned: Owned with a mortgage or loan or shared ownership,164,145,121,6,115,20,4,19,15,1,0,2,1
S01012045,Rented or living rent free: Total,327,179,130,28,102,9,40,148,50,5,15,68,10
S01012045,Rented or living rent free: Social rented,202,82,56,14,42,5,21,120,39,3,13,57,8
S01012045,Rented or living rent free: Private rented or living rent free,125,97,74,14,60,4,19,28,11,2,2,11,2
S01012046,All HRPs aged 16 and over,375,176,142,39,103,9,25,199,116,6,14,49,14
S01012046,Owned: Total,147,88,76,15,61,6,6,59,48,2,3,4,2
S01012046,Owned: Owned outright,62,20,16,3,13,2,2,42,33,2,3,2,2
S01012046,Owned: Owned with a mortgage or loan or shared ownership,85,68,60,12,48,4,4,17,15,0,0,2,0
S01012046,Rented or living rent free: Total,228,88,66,24,42,3,19,140,68,4,11,45,12
S01012046,Rented or living rent free: Social rented,198,72,52,20,32,3,17,126,65,1,8,40,12
S01012046,Rented or living rent free: Private rented or living rent free,30,16,14,4,10,0,2,14,3,3,3,5,0
S01012047,All HRPs aged 16 and over,548,253,200,38,162,24,29,295,197,6,15,64,13
S01012047,Owned: Total,208,138,117,16,101,16,5,70,60,1,1,5,3
S01012047,Owned: Owned outright,83,35,28,7,21,4,3,48,43,1,1,2,1
S01012047,Owned: Owned with a mortgage or loan or shared ownership,125,103,89,9,80,12,2,22,17,0,0,3,2
S01012047,Rented or living rent free: Total,340,115,83,22,61,8,24,225,137,5,14,59,10
S01012047,Rented or living rent free: Social rented,289,83,56,17,39,7,20,206,129,5,14,50,8
S01012047,Rented or living rent free: Private rented or living rent free,51,32,27,5,22,1,4,19,8,0,0,9,2
S01012048,All HRPs aged 16 and over,402,199,168,30,138,11,20,203,130,4,12,46,11
S01012048,Owned: Total,148,91,82,5,77,6,3,57,45,0,3,6,3
S01012048,Owned: Owned outright,50,13,11,1,10,1,1,37,33,0,2,0,2
S01012048,Owned: Owned with a mortgage or loan or shared ownership,98,78,71,4,67,5,2,20,12,0,1,6,1
S01012048,Rented or living rent free: Total,254,108,86,25,61,5,17,146,85,4,9,40,8
S01012048,Rented or living rent free: Social rented,193,66,55,18,37,3,8,127,79,4,3,34,7
S01012048,Rented or living rent free: Private rented or living rent free,61,42,31,7,24,2,9,19,6,0,6,6,1
S01012049,All HRPs aged 16 and over,347,214,186,29,157,18,10,133,96,3,5,21,8
S01012049,Owned: Total,242,161,144,18,126,15,2,81,70,0,2,7,2
S01012049,Owned: Owned outright,90,29,24,4,20,3,2,61,56,0,0,3,2
S01012049,Owned: Owned with a mortgage or loan or shared ownership,152,132,120,14,106,12,0,20,14,0,2,4,0
S01012049,Rented or living rent free: Total,105,53,42,11,31,3,8,52,26,3,3,14,6
S01012049,Rented or living rent free: Social rented,70,25,23,6,17,1,1,45,22,2,3,13,5
S01012049,Rented or living rent free: Private rented or living rent free,35,28,19,5,14,2,7,7,4,1,0,1,1
S01012050,All HRPs aged 16 and over,423,316,270,41,229,30,16,107,59,1,3,39,5
S01012050,Owned: Total,307,260,228,24,204,26,6,47,38,0,0,8,1
S01012050,Owned: Owned outright,59,28,24,7,17,3,1,31,30,0,0,1,0
S01012050,Owned: Owned with a mortgage or loan or shared ownership,248,232,204,17,187,23,5,16,8,0,0,7,1
S01012050,Rented or living rent free: Total,116,56,42,17,25,4,10,60,21,1,3,31,4
S01012050,Rented or living rent free: Social rented,91,40,32,13,19,3,5,51,20,1,2,25,3
S01012050,Rented or living rent free: Private rented or living rent free,25,16,10,4,6,1,5,9,1,0,1,6,1
S01012051,All HRPs aged 16 and over,255,138,109,16,93,19,10,117,95,0,4,14,4
S01012051,Owned: Total,155,107,87,14,73,18,2,48,46,0,0,2,0
S01012051,Owned: Owned outright,64,29,21,7,14,6,2,35,35,0,0,0,0
S01012051,Owned: Owned with a mortgage or loan or shared ownership,91,78,66,7,59,12,0,13,11,0,0,2,0
S01012051,Rented or living rent free: Total,100,31,22,2,20,1,8,69,49,0,4,12,4
S01012051,Rented or living rent free: Social rented,75,11,6,1,5,1,4,64,47,0,4,9,4
S01012051,Rented or living rent free: Private rented or living rent free,25,20,16,1,15,0,4,5,2,0,0,3,0
S01012052,All HRPs aged 16 and over,469,264,232,34,198,21,11,205,161,1,10,24,9
S01012052,Owned: Total,303,193,174,24,150,16,3,110,106,0,0,3,1
S01012052,Owned: Owned outright,124,38,33,6,27,5,0,86,84,0,0,1,1
S01012052,Owned: Owned with a mortgage or loan or shared ownership,179,155,141,18,123,11,3,24,22,0,0,2,0
S01012052,Rented or living rent free: Total,166,71,58,10,48,5,8,95,55,1,10,21,8
S01012052,Rented or living rent free: Social rented,117,41,33,8,25,3,5,76,48,0,7,17,4
S01012052,Rented or living rent free: Private rented or living rent free,49,30,25,2,23,2,3,19,7,1,3,4,4
S01012053,All HRPs aged 16 and over,461,261,211,42,169,16,34,200,116,3,19,50,12
S01012053,Owned: Total,220,139,122,15,107,14,3,81,73,0,3,4,1
S01012053,Owned: Owned outright,84,31,24,7,17,6,1,53,51,0,1,1,0
S01012053,Owned: Owned with a mortgage or loan or shared ownership,136,108,98,8,90,8,2,28,22,0,2,3,1
S01012053,Rented or living rent free: Total,241,122,89,27,62,2,31,119,43,3,16,46,11
S01012053,Rented or living rent free: Social rented,218,107,78,26,52,2,27,111,42,3,14,42,10
S01012053,Rented or living rent free: Private rented or living rent free,23,15,11,1,10,0,4,8,1,0,2,4,1
S01012054,All HRPs aged 16 and over,443,284,204,53,151,15,65,159,62,7,14,57,19
S01012054,Owned: Total,125,85,73,8,65,8,4,40,37,0,0,2,1
S01012054,Owned: Owned outright,40,13,9,2,7,2,2,27,25,0,0,2,0
S01012054,Owned: Owned with a mortgage or loan or shared ownership,85,72,64,6,58,6,2,13,12,0,0,0,1
S01012054,Rented or living rent free: Total,318,199,131,45,86,7,61,119,25,7,14,55,18
S01012054,Rented or living rent free: Social rented,257,169,109,38,71,5,55,88,23,2,9,36,18
S01012054,Rented or living rent free: Private rented or living rent free,61,30,22,7,15,2,6,31,2,5,5,19,0
S01012055,All HRPs aged 16 and over,463,242,203,41,162,19,20,221,144,3,18,50,6
S01012055,Owned: Total,238,138,128,16,112,8,2,100,87,0,1,9,3
S01012055,Owned: Owned outright,93,27,24,6,18,2,1,66,61,0,1,3,1
S01012055,Owned: Owned with a mortgage or loan or shared ownership,145,111,104,10,94,6,1,34,26,0,0,6,2
S01012055,Rented or living rent free: Total,225,104,75,25,50,11,18,121,57,3,17,41,3
S01012055,Rented or living rent free: Social rented,178,79,59,17,42,9,11,99,50,3,7,37,2
S01012055,Rented or living rent free: Private rented or living rent free,47,25,16,8,8,2,7,22,7,0,10,4,1
S01012056,All HRPs aged 16 and over,354,199,166,21,145,27,6,155,131,5,6,11,2
S01012056,Owned: Total,256,176,148,15,133,26,2,80,72,5,0,3,0
S01012056,Owned: Owned outright,101,35,27,7,20,6,2,66,58,5,0,3,0
S01012056,Owned: Owned with a mortgage or loan or shared ownership,155,141,121,8,113,20,0,14,14,0,0,0,0
S01012056,Rented or living rent free: Total,98,23,18,6,12,1,4,75,59,0,6,8,2
S01012056,Rented or living rent free: Social rented,88,18,15,6,9,0,3,70,55,0,6,8,1
S01012056,Rented or living rent free: Private rented or living rent free,10,5,3,0,3,1,1,5,4,0,0,0,1
S01012057,All HRPs aged 16 and over,316,203,175,24,151,23,5,113,104,0,4,5,0
S01012057,Owned: Total,294,188,163,22,141,22,3,106,102,0,1,3,0
S01012057,Owned: Owned outright,159,58,51,15,36,5,2,101,98,0,1,2,0
S01012057,Owned: Owned with a mortgage or loan or shared ownership,135,130,112,7,105,17,1,5,4,0,0,1,0
S01012057,Rented or living rent free: Total,22,15,12,2,10,1,2,7,2,0,3,2,0
S01012057,Rented or living rent free: Social rented,4,3,2,1,1,0,1,1,0,0,1,0,0
S01012057,Rented or living rent free: Private rented or living rent free,18,12,10,1,9,1,1,6,2,0,2,2,0
S01012058,All HRPs aged 16 and over,328,199,157,25,132,33,9,129,117,0,4,8,0
S01012058,Owned: Total,265,156,123,22,101,29,4,109,108,0,1,0,0
S01012058,Owned: Owned outright,155,55,40,14,26,14,1,100,99,0,1,0,0
S01012058,Owned: Owned with a mortgage or loan or shared ownership,110,101,83,8,75,15,3,9,9,0,0,0,0
S01012058,Rented or living rent free: Total,63,43,34,3,31,4,5,20,9,0,3,8,0
S01012058,Rented or living rent free: Social rented,30,17,13,2,11,3,1,13,7,0,2,4,0
S01012058,Rented or living rent free: Private rented or living rent free,33,26,21,1,20,1,4,7,2,0,1,4,0
S01012059,All HRPs aged 16 and over,412,230,188,49,139,27,15,182,128,2,16,31,5
S01012059,Owned: Total,258,158,137,30,107,19,2,100,90,0,0,8,2
S01012059,Owned: Owned outright,96,35,30,9,21,5,0,61,58,0,0,3,0
S01012059,Owned: Owned with a mortgage or loan or shared ownership,162,123,107,21,86,14,2,39,32,0,0,5,2
S01012059,Rented or living rent free: Total,154,72,51,19,32,8,13,82,38,2,16,23,3
S01012059,Rented or living rent free: Social rented,125,55,37,13,24,8,10,70,36,2,9,21,2
S01012059,Rented or living rent free: Private rented or living rent free,29,17,14,6,8,0,3,12,2,0,7,2,1
S01012060,All HRPs aged 16 and over,408,221,185,28,157,21,15,187,136,1,10,34,6
S01012060,Owned: Total,222,147,129,16,113,17,1,75,68,1,0,4,2
S01012060,Owned: Owned outright,87,31,26,5,21,4,1,56,51,1,0,2,2
S01012060,Owned: Owned with a mortgage or loan or shared ownership,135,116,103,11,92,13,0,19,17,0,0,2,0
S01012060,Rented or living rent free: Total,186,74,56,12,44,4,14,112,68,0,10,30,4
S01012060,Rented or living rent free: Social rented,154,53,40,11,29,2,11,101,65,0,5,27,4
S01012060,Rented or living rent free: Private rented or living rent free,32,21,16,1,15,2,3,11,3,0,5,3,0
S01012061,All HRPs aged 16 and over,440,279,234,30,204,30,15,161,128,3,7,18,5
S01012061,Owned: Total,348,223,191,23,168,27,5,125,114,2,0,5,4
S01012061,Owned: Owned outright,154,52,38,8,30,12,2,102,97,2,0,2,1
S01012061,Owned: Owned with a mortgage or loan or shared ownership,194,171,153,15,138,15,3,23,17,0,0,3,3
S01012061,Rented or living rent free: Total,92,56,43,7,36,3,10,36,14,1,7,13,1
S01012061,Rented or living rent free: Social rented,34,18,15,4,11,2,1,16,10,0,1,5,0
S01012061,Rented or living rent free: Private rented or living rent free,58,38,28,3,25,1,9,20,4,1,6,8,1
S01012062,All HRPs aged 16 and over,335,258,215,28,187,41,2,77,63,3,2,6,3
S01012062,Owned: Total,300,232,194,21,173,37,1,68,58,3,1,3,3
S01012062,Owned: Owned outright,89,39,30,8,22,9,0,50,48,1,0,0,1
S01012062,Owned: Owned with a mortgage or loan or shared ownership,211,193,164,13,151,28,1,18,10,2,1,3,2
S01012062,Rented or living rent free: Total,35,26,21,7,14,4,1,9,5,0,1,3,0
S01012062,Rented or living rent free: Social rented,7,5,5,3,2,0,0,2,1,0,0,1,0
S01012062,Rented or living rent free: Private rented or living rent free,28,21,16,4,12,4,1,7,4,0,1,2,0
S01012063,All HRPs aged 16 and over,235,186,160,19,141,20,6,49,20,1,12,14,2
S01012063,Owned: Total,194,163,142,16,126,19,2,31,19,0,2,9,1
S01012063,Owned: Owned outright,37,16,13,2,11,3,0,21,15,0,2,4,0
S01012063,Owned: Owned with a mortgage or loan or shared ownership,157,147,129,14,115,16,2,10,4,0,0,5,1
S01012063,Rented or living rent free: Total,41,23,18,3,15,1,4,18,1,1,10,5,1
S01012063,Rented or living rent free: Social rented,9,6,5,0,5,1,0,3,0,0,1,2,0
S01012063,Rented or living rent free: Private rented or living rent free,32,17,13,3,10,0,4,15,1,1,9,3,1
S01012064,All HRPs aged 16 and over,276,157,115,35,80,6,36,119,29,5,33,50,2
S01012064,Owned: Total,64,59,56,8,48,3,0,5,4,0,0,1,0
S01012064,Owned: Owned outright,9,5,5,1,4,0,0,4,3,0,0,1,0
S01012064,Owned: Owned with a mortgage or loan or shared ownership,55,54,51,7,44,3,0,1,1,0,0,0,0
S01012064,Rented or living rent free: Total,212,98,59,27,32,3,36,114,25,5,33,49,2
S01012064,Rented or living rent free: Social rented,194,86,53,24,29,1,32,108,25,5,29,47,2
S01012064,Rented or living rent free: Private rented or living rent free,18,12,6,3,3,2,4,6,0,0,4,2,0
S01012065,All HRPs aged 16 and over,261,129,94,42,52,7,28,132,29,2,34,58,9
S01012065,Owned: Total,22,19,15,2,13,4,0,3,1,0,0,0,2
S01012065,Owned: Owned outright,5,5,4,0,4,1,0,0,0,0,0,0,0
S01012065,Owned: Owned with a mortgage or loan or shared ownership,17,14,11,2,9,3,0,3,1,0,0,0,2
S01012065,Rented or living rent free: Total,239,110,79,40,39,3,28,129,28,2,34,58,7
S01012065,Rented or living rent free: Social rented,237,110,79,40,39,3,28,127,28,2,32,58,7
S01012065,Rented or living rent free: Private rented or living rent free,2,0,0,0,0,0,0,2,0,0,2,0,0
S01012066,All HRPs aged 16 and over,382,258,213,56,157,18,27,124,32,6,23,52,11
S01012066,Owned: Total,180,155,138,20,118,13,4,25,13,2,1,8,1
S01012066,Owned: Owned outright,24,14,13,4,9,0,1,10,9,1,0,0,0
S01012066,Owned: Owned with a mortgage or loan or shared ownership,156,141,125,16,109,13,3,15,4,1,1,8,1
S01012066,Rented or living rent free: Total,202,103,75,36,39,5,23,99,19,4,22,44,10
S01012066,Rented or living rent free: Social rented,169,89,67,32,35,3,19,80,18,3,14,35,10
S01012066,Rented or living rent free: Private rented or living rent free,33,14,8,4,4,2,4,19,1,1,8,9,0
S01012067,All HRPs aged 16 and over,250,134,97,33,64,7,30,116,33,3,25,47,8
S01012067,Owned: Total,37,26,19,3,16,6,1,11,5,1,0,5,0
S01012067,Owned: Owned outright,9,5,3,0,3,2,0,4,4,0,0,0,0
S01012067,Owned: Owned with a mortgage or loan or shared ownership,28,21,16,3,13,4,1,7,1,1,0,5,0
S01012067,Rented or living rent free: Total,213,108,78,30,48,1,29,105,28,2,25,42,8
S01012067,Rented or living rent free: Social rented,205,107,77,30,47,1,29,98,27,2,24,37,8
S01012067,Rented or living rent free: Private rented or living rent free,8,1,1,0,1,0,0,7,1,0,1,5,0
S01012068,All HRPs aged 16 and over,268,99,68,27,41,5,26,169,55,2,40,60,12
S01012068,Owned: Total,20,11,6,2,4,3,2,9,3,0,0,4,2
S01012068,Owned: Owned outright,5,1,0,0,0,0,1,4,1,0,0,1,2
S01012068,Owned: Owned with a mortgage or loan or shared ownership,15,10,6,2,4,3,1,5,2,0,0,3,0
S01012068,Rented or living rent free: Total,248,88,62,25,37,2,24,160,52,2,40,56,10
S01012068,Rented or living rent free: Social rented,240,85,60,25,35,2,23,155,52,1,36,56,10
S01012068,Rented or living rent free: Private rented or living rent free,8,3,2,0,2,0,1,5,0,1,4,0,0
S01012069,All HRPs aged 16 and over,292,163,116,29,87,11,36,129,50,3,14,51,11
S01012069,Owned: Total,74,58,48,5,43,6,4,16,11,0,0,4,1
S01012069,Owned: Owned outright,18,11,7,2,5,2,2,7,6,0,0,0,1
S01012069,Owned: Owned with a mortgage or loan or shared ownership,56,47,41,3,38,4,2,9,5,0,0,4,0
S01012069,Rented or living rent free: Total,218,105,68,24,44,5,32,113,39,3,14,47,10
S01012069,Rented or living rent free: Social rented,197,89,57,22,35,4,28,108,39,0,13,46,10
S01012069,Rented or living rent free: Private rented or living rent free,21,16,11,2,9,1,4,5,0,3,1,1,0
S01012070,All HRPs aged 16 and over,449,228,166,41,125,11,51,221,117,17,20,50,17
S01012070,Owned: Total,99,56,53,5,48,3,0,43,31,0,3,6,3
S01012070,Owned: Owned outright,42,10,9,2,7,1,0,32,26,0,2,2,2
S01012070,Owned: Owned with a mortgage or loan or shared ownership,57,46,44,3,41,2,0,11,5,0,1,4,1
S01012070,Rented or living rent free: Total,350,172,113,36,77,8,51,178,86,17,17,44,14
S01012070,Rented or living rent free: Social rented,298,145,95,30,65,3,47,153,83,8,12,40,10
S01012070,Rented or living rent free: Private rented or living rent free,52,27,18,6,12,5,4,25,3,9,5,4,4
S01012071,All HRPs aged 16 and over,692,392,292,84,208,28,72,300,130,11,23,113,23
S01012071,Owned: Total,160,121,100,18,82,16,5,39,30,2,0,7,0
S01012071,Owned: Owned outright,52,25,20,9,11,4,1,27,25,0,0,2,0
S01012071,Owned: Owned with a mortgage or loan or shared ownership,108,96,80,9,71,12,4,12,5,2,0,5,0
S01012071,Rented or living rent free: Total,532,271,192,66,126,12,67,261,100,9,23,106,23
S01012071,Rented or living rent free: Social rented,272,108,63,23,40,7,38,164,78,1,18,56,11
S01012071,Rented or living rent free: Private rented or living rent free,260,163,129,43,86,5,29,97,22,8,5,50,12
S01012072,All HRPs aged 16 and over,722,384,278,62,216,27,79,338,159,33,20,110,16
S01012072,Owned: Total,199,145,122,17,105,16,7,54,46,0,0,7,1
S01012072,Owned: Owned outright,71,34,27,7,20,5,2,37,36,0,0,1,0
S01012072,Owned: Owned with a mortgage or loan or shared ownership,128,111,95,10,85,11,5,17,10,0,0,6,1
S01012072,Rented or living rent free: Total,523,239,156,45,111,11,72,284,113,33,20,103,15
S01012072,Rented or living rent free: Social rented,336,125,76,28,48,5,44,211,105,1,9,84,12
S01012072,Rented or living rent free: Private rented or living rent free,187,114,80,17,63,6,28,73,8,32,11,19,3
S01012073,All HRPs aged 16 and over,320,243,204,23,181,23,16,77,42,7,8,13,7
S01012073,Owned: Total,219,184,162,13,149,21,1,35,31,0,0,2,2
S01012073,Owned: Owned outright,48,25,22,4,18,2,1,23,22,0,0,1,0
S01012073,Owned: Owned with a mortgage or loan or shared ownership,171,159,140,9,131,19,0,12,9,0,0,1,2
S01012073,Rented or living rent free: Total,101,59,42,10,32,2,15,42,11,7,8,11,5
S01012073,Rented or living rent free: Social rented,47,23,11,5,6,0,12,24,8,2,2,9,3
S01012073,Rented or living rent free: Private rented or living rent free,54,36,31,5,26,2,3,18,3,5,6,2,2
S01012074,All HRPs aged 16 and over,343,267,227,24,203,29,11,76,61,4,1,8,2
S01012074,Owned: Total,261,204,175,13,162,25,4,57,54,0,1,1,1
S01012074,Owned: Owned outright,75,26,22,3,19,2,2,49,48,0,0,1,0
S01012074,Owned: Owned with a mortgage or loan or shared ownership,186,178,153,10,143,23,2,8,6,0,1,0,1
S01012074,Rented or living rent free: Total,82,63,52,11,41,4,7,19,7,4,0,7,1
S01012074,Rented or living rent free: Social rented,4,4,3,1,2,0,1,0,0,0,0,0,0
S01012074,Rented or living rent free: Private rented or living rent free,78,59,49,10,39,4,6,19,7,4,0,7,1
S01012075,All HRPs aged 16 and over,269,236,199,14,185,31,6,33,28,0,1,3,1
S01012075,Owned: Total,258,227,191,14,177,30,6,31,26,0,1,3,1
S01012075,Owned: Owned outright,49,26,22,4,18,2,2,23,21,0,1,1,0
S01012075,Owned: Owned with a mortgage or loan or shared ownership,209,201,169,10,159,28,4,8,5,0,0,2,1
S01012075,Rented or living rent free: Total,11,9,8,0,8,1,0,2,2,0,0,0,0
S01012075,Rented or living rent free: Social rented,7,5,5,0,5,0,0,2,2,0,0,0,0
S01012075,Rented or living rent free: Private rented or living rent free,4,4,3,0,3,1,0,0,0,0,0,0,0
S01012076,All HRPs aged 16 and over,382,227,190,26,164,27,10,155,111,1,11,25,7
S01012076,Owned: Total,252,172,150,14,136,20,2,80,71,0,0,7,2
S01012076,Owned: Owned outright,80,29,24,4,20,4,1,51,46,0,0,3,2
S01012076,Owned: Owned with a mortgage or loan or shared ownership,172,143,126,10,116,16,1,29,25,0,0,4,0
S01012076,Rented or living rent free: Total,130,55,40,12,28,7,8,75,40,1,11,18,5
S01012076,Rented or living rent free: Social rented,82,26,16,8,8,3,7,56,35,0,1,17,3
S01012076,Rented or living rent free: Private rented or living rent free,48,29,24,4,20,4,1,19,5,1,10,1,2
S01012077,All HRPs aged 16 and over,363,233,199,35,164,6,28,130,55,7,24,40,4
S01012077,Owned: Total,164,132,124,16,108,5,3,32,27,1,0,4,0
S01012077,Owned: Owned outright,39,17,15,4,11,1,1,22,19,0,0,3,0
S01012077,Owned: Owned with a mortgage or loan or shared ownership,125,115,109,12,97,4,2,10,8,1,0,1,0
S01012077,Rented or living rent free: Total,199,101,75,19,56,1,25,98,28,6,24,36,4
S01012077,Rented or living rent free: Social rented,148,66,47,15,32,0,19,82,26,5,15,33,3
S01012077,Rented or living rent free: Private rented or living rent free,51,35,28,4,24,1,6,16,2,1,9,3,1
S01012078,All HRPs aged 16 and over,367,290,245,32,213,27,18,77,40,3,8,21,5
S01012078,Owned: Total,265,227,203,17,186,21,3,38,30,1,0,6,1
S01012078,Owned: Owned outright,50,26,24,5,19,2,0,24,21,1,0,1,1
S01012078,Owned: Owned with a mortgage or loan or shared ownership,215,201,179,12,167,19,3,14,9,0,0,5,0
S01012078,Rented or living rent free: Total,102,63,42,15,27,6,15,39,10,2,8,15,4
S01012078,Rented or living rent free: Social rented,73,43,31,13,18,3,9,30,8,2,7,11,2
S01012078,Rented or living rent free: Private rented or living rent free,29,20,11,2,9,3,6,9,2,0,1,4,2
S01012079,All HRPs aged 16 and over,448,251,198,40,158,24,29,197,140,1,11,33,12
S01012079,Owned: Total,228,153,127,16,111,19,7,75,68,0,1,5,1
S01012079,Owned: Owned outright,92,36,28,6,22,4,4,56,53,0,0,3,0
S01012079,Owned: Owned with a mortgage or loan or shared ownership,136,117,99,10,89,15,3,19,15,0,1,2,1
S01012079,Rented or living rent free: Total,220,98,71,24,47,5,22,122,72,1,10,28,11
S01012079,Rented or living rent free: Social rented,190,81,62,24,38,2,17,109,68,1,5,25,10
S01012079,Rented or living rent free: Private rented or living rent free,30,17,9,0,9,3,5,13,4,0,5,3,1
S01012080,All HRPs aged 16 and over,352,226,185,55,130,13,28,126,39,3,33,39,12
S01012080,Owned: Total,94,76,66,8,58,9,1,18,12,1,2,2,1
S01012080,Owned: Owned outright,15,8,6,1,5,2,0,7,6,0,0,0,1
S01012080,Owned: Owned with a mortgage or loan or shared ownership,79,68,60,7,53,7,1,11,6,1,2,2,0
S01012080,Rented or living rent free: Total,258,150,119,47,72,4,27,108,27,2,31,37,11
S01012080,Rented or living rent free: Social rented,244,139,111,44,67,2,26,105,27,2,31,34,11
S01012080,Rented or living rent free: Private rented or living rent free,14,11,8,3,5,2,1,3,0,0,0,3,0
S01012081,All HRPs aged 16 and over,387,232,166,42,124,15,51,155,79,3,12,49,12
S01012081,Owned: Total,137,85,74,8,66,10,1,52,48,0,0,2,2
S01012081,Owned: Owned outright,40,6,4,1,3,2,0,34,32,0,0,1,1
S01012081,Owned: Owned with a mortgage or loan or shared ownership,97,79,70,7,63,8,1,18,16,0,0,1,1
S01012081,Rented or living rent free: Total,250,147,92,34,58,5,50,103,31,3,12,47,10
S01012081,Rented or living rent free: Social rented,226,132,80,30,50,3,49,94,30,3,12,41,8
S01012081,Rented or living rent free: Private rented or living rent free,24,15,12,4,8,2,1,9,1,0,0,6,2
S01012082,All HRPs aged 16 and over,323,175,132,30,102,13,30,148,84,0,18,42,4
S01012082,Owned: Total,142,90,81,11,70,9,0,52,47,0,0,3,2
S01012082,Owned: Owned outright,41,11,11,3,8,0,0,30,29,0,0,0,1
S01012082,Owned: Owned with a mortgage or loan or shared ownership,101,79,70,8,62,9,0,22,18,0,0,3,1
S01012082,Rented or living rent free: Total,181,85,51,19,32,4,30,96,37,0,18,39,2
S01012082,Rented or living rent free: Social rented,159,75,45,17,28,4,26,84,35,0,11,36,2
S01012082,Rented or living rent free: Private rented or living rent free,22,10,6,2,4,0,4,12,2,0,7,3,0
S01012083,All HRPs aged 16 and over,383,207,165,27,138,11,31,176,105,2,8,57,4
S01012083,Owned: Total,154,93,82,12,70,9,2,61,49,1,3,6,2
S01012083,Owned: Owned outright,57,21,18,4,14,3,0,36,32,0,1,2,1
S01012083,Owned: Owned with a mortgage or loan or shared ownership,97,72,64,8,56,6,2,25,17,1,2,4,1
S01012083,Rented or living rent free: Total,229,114,83,15,68,2,29,115,56,1,5,51,2
S01012083,Rented or living rent free: Social rented,218,107,79,14,65,2,26,111,55,1,4,49,2
S01012083,Rented or living rent free: Private rented or living rent free,11,7,4,1,3,0,3,4,1,0,1,2,0
S01012084,All HRPs aged 16 and over,238,156,135,16,119,17,4,82,72,1,2,6,1
S01012084,Owned: Total,213,144,129,14,115,13,2,69,65,0,0,3,1
S01012084,Owned: Owned outright,82,27,24,8,16,3,0,55,55,0,0,0,0
S01012084,Owned: Owned with a mortgage or loan or shared ownership,131,117,105,6,99,10,2,14,10,0,0,3,1
S01012084,Rented or living rent free: Total,25,12,6,2,4,4,2,13,7,1,2,3,0
S01012084,Rented or living rent free: Social rented,16,5,2,1,1,2,1,11,6,0,2,3,0
S01012084,Rented or living rent free: Private rented or living rent free,9,7,4,1,3,2,1,2,1,1,0,0,0
S01012085,All HRPs aged 16 and over,301,186,162,20,142,17,7,115,102,1,1,10,1
S01012085,Owned: Total,226,155,141,14,127,14,0,71,70,0,0,1,0
S01012085,Owned: Owned outright,103,43,37,9,28,6,0,60,60,0,0,0,0
S01012085,Owned: Owned with a mortgage or loan or shared ownership,123,112,104,5,99,8,0,11,10,0,0,1,0
S01012085,Rented or living rent free: Total,75,31,21,6,15,3,7,44,32,1,1,9,1
S01012085,Rented or living rent free: Social rented,55,21,15,4,11,2,4,34,27,1,1,5,0
S01012085,Rented or living rent free: Private rented or living rent free,20,10,6,2,4,1,3,10,5,0,0,4,1
S01012086,All HRPs aged 16 and over,448,253,208,46,162,10,35,195,128,3,11,47,6
S01012086,Owned: Total,239,142,132,17,115,7,3,97,87,1,1,7,1
S01012086,Owned: Owned outright,92,18,17,1,16,1,0,74,68,0,1,4,1
S01012086,Owned: Owned with a mortgage or loan or shared ownership,147,124,115,16,99,6,3,23,19,1,0,3,0
S01012086,Rented or living rent free: Total,209,111,76,29,47,3,32,98,41,2,10,40,5
S01012086,Rented or living rent free: Social rented,180,90,60,23,37,2,28,90,38,2,6,40,4
S01012086,Rented or living rent free: Private rented or living rent free,29,21,16,6,10,1,4,8,3,0,4,0,1
S01012087,All HRPs aged 16 and over,364,203,172,34,138,11,20,161,128,2,7,21,3
S01012087,Owned: Total,251,150,139,21,118,9,2,101,92,0,1,7,1
S01012087,Owned: Owned outright,102,24,21,4,17,2,1,78,72,0,0,5,1
S01012087,Owned: Owned with a mortgage or loan or shared ownership,149,126,118,17,101,7,1,23,20,0,1,2,0
S01012087,Rented or living rent free: Total,113,53,33,13,20,2,18,60,36,2,6,14,2
S01012087,Rented or living rent free: Social rented,88,39,23,9,14,1,15,49,34,2,1,11,1
S01012087,Rented or living rent free: Private rented or living rent free,25,14,10,4,6,1,3,11,2,0,5,3,1
S01012088,All HRPs aged 16 and over,286,224,189,23,166,23,12,62,41,3,1,13,4
S01012088,Owned: Total,207,175,153,14,139,20,2,32,31,1,0,0,0
S01012088,Owned: Owned outright,55,29,25,2,23,3,1,26,25,1,0,0,0
S01012088,Owned: Owned with a mortgage or loan or shared ownership,152,146,128,12,116,17,1,6,6,0,0,0,0
S01012088,Rented or living rent free: Total,79,49,36,9,27,3,10,30,10,2,1,13,4
S01012088,Rented or living rent free: Social rented,64,36,24,6,18,3,9,28,10,0,1,13,4
S01012088,Rented or living rent free: Private rented or living rent free,15,13,12,3,9,0,1,2,0,2,0,0,0
S01012089,All HRPs aged 16 and over,357,252,211,20,191,31,10,105,91,0,2,8,4
S01012089,Owned: Total,329,233,202,18,184,26,5,96,89,0,1,3,3
S01012089,Owned: Owned outright,127,40,33,4,29,6,1,87,85,0,1,0,1
S01012089,Owned: Owned with a mortgage or loan or shared ownership,202,193,169,14,155,20,4,9,4,0,0,3,2
S01012089,Rented or living rent free: Total,28,19,9,2,7,5,5,9,2,0,1,5,1
S01012089,Rented or living rent free: Social rented,3,1,0,0,0,0,1,2,0,0,1,1,0
S01012089,Rented or living rent free: Private rented or living rent free,25,18,9,2,7,5,4,7,2,0,0,4,1
S01012090,All HRPs aged 16 and over,356,226,176,17,159,43,7,130,120,0,4,4,2
S01012090,Owned: Total,340,220,172,16,156,43,5,120,118,0,1,0,1
S01012090,Owned: Owned outright,188,75,50,10,40,22,3,113,111,0,1,0,1
S01012090,Owned: Owned with a mortgage or loan or shared ownership,152,145,122,6,116,21,2,7,7,0,0,0,0
S01012090,Rented or living rent free: Total,16,6,4,1,3,0,2,10,2,0,3,4,1
S01012090,Rented or living rent free: Social rented,6,0,0,0,0,0,0,6,2,0,0,3,1
S01012090,Rented or living rent free: Private rented or living rent free,10,6,4,1,3,0,2,4,0,0,3,1,0
S01012091,All HRPs aged 16 and over,244,170,151,19,132,14,5,74,65,0,0,8,1
S01012091,Owned: Total,221,156,140,17,123,13,3,65,63,0,0,2,0
S01012091,Owned: Owned outright,100,47,43,8,35,3,1,53,53,0,0,0,0
S01012091,Owned: Owned with a mortgage or loan or shared ownership,121,109,97,9,88,10,2,12,10,0,0,2,0
S01012091,Rented or living rent free: Total,23,14,11,2,9,1,2,9,2,0,0,6,1
S01012091,Rented or living rent free: Social rented,7,2,1,1,0,1,0,5,1,0,0,3,1
S01012091,Rented or living rent free: Private rented or living rent free,16,12,10,1,9,0,2,4,1,0,0,3,0
S01012092,All HRPs aged 16 and over,214,148,129,12,117,19,0,66,54,0,0,10,2
S01012092,Owned: Total,198,140,121,11,110,19,0,58,52,0,0,6,0
S01012092,Owned: Owned outright,84,38,33,7,26,5,0,46,44,0,0,2,0
S01012092,Owned: Owned with a mortgage or loan or shared ownership,114,102,88,4,84,14,0,12,8,0,0,4,0
S01012092,Rented or living rent free: Total,16,8,8,1,7,0,0,8,2,0,0,4,2
S01012092,Rented or living rent free: Social rented,3,1,1,0,1,0,0,2,0,0,0,2,0
S01012092,Rented or living rent free: Private rented or living rent free,13,7,7,1,6,0,0,6,2,0,0,2,2
S01012093,All HRPs aged 16 and over,295,187,162,14,148,20,5,108,96,1,3,7,1
S01012093,Owned: Total,248,154,134,9,125,18,2,94,89,0,3,1,1
S01012093,Owned: Owned outright,121,39,34,7,27,4,1,82,81,0,0,1,0
S01012093,Owned: Owned with a mortgage or loan or shared ownership,127,115,100,2,98,14,1,12,8,0,3,0,1
S01012093,Rented or living rent free: Total,47,33,28,5,23,2,3,14,7,1,0,6,0
S01012093,Rented or living rent free: Social rented,6,4,3,1,2,1,0,2,2,0,0,0,0
S01012093,Rented or living rent free: Private rented or living rent free,41,29,25,4,21,1,3,12,5,1,0,6,0
S01012094,All HRPs aged 16 and over,317,217,167,20,147,45,5,100,98,0,0,2,0
S01012094,Owned: Total,302,204,155,16,139,44,5,98,97,0,0,1,0
S01012094,Owned: Owned outright,152,64,49,7,42,13,2,88,87,0,0,1,0
S01012094,Owned: Owned with a mortgage or loan or shared ownership,150,140,106,9,97,31,3,10,10,0,0,0,0
S01012094,Rented or living rent free: Total,15,13,12,4,8,1,0,2,1,0,0,1,0
S01012094,Rented or living rent free: Social rented,4,2,2,1,1,0,0,2,1,0,0,1,0
S01012094,Rented or living rent free: Private rented or living rent free,11,11,10,3,7,1,0,0,0,0,0,0,0
S01012095,All HRPs aged 16 and over,410,307,259,48,211,30,18,103,53,8,12,28,2
S01012095,Owned: Total,285,230,200,29,171,26,4,55,40,6,1,6,2
S01012095,Owned: Owned outright,80,42,38,7,31,3,1,38,35,1,0,1,1
S01012095,Owned: Owned with a mortgage or loan or shared ownership,205,188,162,22,140,23,3,17,5,5,1,5,1
S01012095,Rented or living rent free: Total,125,77,59,19,40,4,14,48,13,2,11,22,0
S01012095,Rented or living rent free: Social rented,109,63,48,14,34,2,13,46,13,2,11,20,0
S01012095,Rented or living rent free: Private rented or living rent free,16,14,11,5,6,2,1,2,0,0,0,2,0
S01012096,All HRPs aged 16 and over,388,214,181,47,134,21,12,174,132,3,12,24,3
S01012096,Owned: Total,263,157,133,29,104,19,5,106,95,3,5,2,1
S01012096,Owned: Owned outright,105,34,25,7,18,5,4,71,66,1,3,1,0
S01012096,Owned: Owned with a mortgage or loan or shared ownership,158,123,108,22,86,14,1,35,29,2,2,1,1
S01012096,Rented or living rent free: Total,125,57,48,18,30,2,7,68,37,0,7,22,2
S01012096,Rented or living rent free: Social rented,109,42,35,13,22,2,5,67,37,0,7,21,2
S01012096,Rented or living rent free: Private rented or living rent free,16,15,13,5,8,0,2,1,0,0,0,1,0
S01012097,All HRPs aged 16 and over,279,180,156,37,119,8,16,99,78,0,7,10,4
S01012097,Owned: Total,188,128,119,20,99,5,4,60,56,0,1,2,1
S01012097,Owned: Owned outright,62,18,16,3,13,1,1,44,41,0,1,1,1
S01012097,Owned: Owned with a mortgage or loan or shared ownership,126,110,103,17,86,4,3,16,15,0,0,1,0
S01012097,Rented or living rent free: Total,91,52,37,17,20,3,12,39,22,0,6,8,3
S01012097,Rented or living rent free: Social rented,80,46,32,14,18,3,11,34,20,0,5,6,3
S01012097,Rented or living rent free: Private rented or living rent free,11,6,5,3,2,0,1,5,2,0,1,2,0
S01012098,All HRPs aged 16 and over,277,171,153,31,122,8,10,106,73,3,10,20,0
S01012098,Owned: Total,190,124,113,17,96,7,4,66,54,0,3,9,0
S01012098,Owned: Owned outright,57,19,15,4,11,2,2,38,34,0,1,3,0
S01012098,Owned: Owned with a mortgage or loan or shared ownership,133,105,98,13,85,5,2,28,20,0,2,6,0
S01012098,Rented or living rent free: Total,87,47,40,14,26,1,6,40,19,3,7,11,0
S01012098,Rented or living rent free: Social rented,72,37,31,9,22,1,5,35,17,2,6,10,0
S01012098,Rented or living rent free: Private rented or living rent free,15,10,9,5,4,0,1,5,2,1,1,1,0
S01012099,All HRPs aged 16 and over,348,200,177,44,133,8,15,148,103,5,7,28,5
S01012099,Owned: Total,172,119,107,10,97,8,4,53,44,0,2,6,1
S01012099,Owned: Owned outright,50,19,17,3,14,2,0,31,28,0,1,2,0
S01012099,Owned: Owned with a mortgage or loan or shared ownership,122,100,90,7,83,6,4,22,16,0,1,4,1
S01012099,Rented or living rent free: Total,176,81,70,34,36,0,11,95,59,5,5,22,4
S01012099,Rented or living rent free: Social rented,150,67,58,29,29,0,9,83,52,5,3,20,3
S01012099,Rented or living rent free: Private rented or living rent free,26,14,12,5,7,0,2,12,7,0,2,2,1
S01012100,All HRPs aged 16 and over,493,263,223,53,170,29,11,230,171,3,16,31,9
S01012100,Owned: Total,288,192,164,24,140,25,3,96,87,0,2,5,2
S01012100,Owned: Owned outright,108,43,31,5,26,11,1,65,64,0,0,0,1
S01012100,Owned: Owned with a mortgage or loan or shared ownership,180,149,133,19,114,14,2,31,23,0,2,5,1
S01012100,Rented or living rent free: Total,205,71,59,29,30,4,8,134,84,3,14,26,7
S01012100,Rented or living rent free: Social rented,183,56,48,25,23,2,6,127,80,3,14,23,7
S01012100,Rented or living rent free: Private rented or living rent free,22,15,11,4,7,2,2,7,4,0,0,3,0
S01012101,All HRPs aged 16 and over,311,201,169,23,146,26,6,110,102,2,2,2,2
S01012101,Owned: Total,281,181,155,17,138,24,2,100,97,0,2,0,1
S01012101,Owned: Owned outright,144,53,42,9,33,9,2,91,90,0,1,0,0
S01012101,Owned: Owned with a mortgage or loan or shared ownership,137,128,113,8,105,15,0,9,7,0,1,0,1
S01012101,Rented or living rent free: Total,30,20,14,6,8,2,4,10,5,2,0,2,1
S01012101,Rented or living rent free: Social rented,19,11,7,5,2,0,4,8,4,1,0,2,1
S01012101,Rented or living rent free: Private rented or living rent free,11,9,7,1,6,2,0,2,1,1,0,0,0
S01012102,All HRPs aged 16 and over,319,206,172,51,121,8,26,113,50,6,15,35,7
S01012102,Owned: Total,130,100,92,11,81,7,1,30,26,0,0,3,1
S01012102,Owned: Owned outright,41,19,16,3,13,2,1,22,22,0,0,0,0
S01012102,Owned: Owned with a mortgage or loan or shared ownership,89,81,76,8,68,5,0,8,4,0,0,3,1
S01012102,Rented or living rent free: Total,189,106,80,40,40,1,25,83,24,6,15,32,6
S01012102,Rented or living rent free: Social rented,163,97,73,37,36,1,23,66,19,2,13,26,6
S01012102,Rented or living rent free: Private rented or living rent free,26,9,7,3,4,0,2,17,5,4,2,6,0
S01012103,All HRPs aged 16 and over,425,315,269,27,242,27,19,110,72,5,8,23,2
S01012103,Owned: Total,330,256,225,15,210,22,9,74,60,3,1,8,2
S01012103,Owned: Owned outright,89,35,27,1,26,4,4,54,47,2,0,4,1
S01012103,Owned: Owned with a mortgage or loan or shared ownership,241,221,198,14,184,18,5,20,13,1,1,4,1
S01012103,Rented or living rent free: Total,95,59,44,12,32,5,10,36,12,2,7,15,0
S01012103,Rented or living rent free: Social rented,54,31,25,8,17,2,4,23,12,0,1,10,0
S01012103,Rented or living rent free: Private rented or living rent free,41,28,19,4,15,3,6,13,0,2,6,5,0
S01012104,All HRPs aged 16 and over,345,278,241,16,225,33,4,67,53,3,5,5,1
S01012104,Owned: Total,269,217,182,9,173,33,2,52,45,1,3,2,1
S01012104,Owned: Owned outright,68,31,21,3,18,9,1,37,36,0,0,1,0
S01012104,Owned: Owned with a mortgage or loan or shared ownership,201,186,161,6,155,24,1,15,9,1,3,1,1
S01012104,Rented or living rent free: Total,76,61,59,7,52,0,2,15,8,2,2,3,0
S01012104,Rented or living rent free: Social rented,29,17,15,4,11,0,2,12,7,1,1,3,0
S01012104,Rented or living rent free: Private rented or living rent free,47,44,44,3,41,0,0,3,1,1,1,0,0
S01012105,All HRPs aged 16 and over,492,329,271,35,236,45,13,163,136,6,4,14,3
S01012105,Owned: Total,405,274,225,23,202,41,8,131,120,3,3,4,1
S01012105,Owned: Owned outright,164,60,50,8,42,10,0,104,99,2,0,2,1
S01012105,Owned: Owned with a mortgage or loan or shared ownership,241,214,175,15,160,31,8,27,21,1,3,2,0
S01012105,Rented or living rent free: Total,87,55,46,12,34,4,5,32,16,3,1,10,2
S01012105,Rented or living rent free: Social rented,44,22,18,9,9,1,3,22,11,1,1,9,0
S01012105,Rented or living rent free: Private rented or living rent free,43,33,28,3,25,3,2,10,5,2,0,1,2
S01012106,All HRPs aged 16 and over,497,376,310,25,285,53,13,121,99,2,14,3,3
S01012106,Owned: Total,391,303,252,13,239,48,3,88,79,0,7,0,2
S01012106,Owned: Owned outright,111,49,36,7,29,11,2,62,60,0,1,0,1
S01012106,Owned: Owned with a mortgage or loan or shared ownership,280,254,216,6,210,37,1,26,19,0,6,0,1
S01012106,Rented or living rent free: Total,106,73,58,12,46,5,10,33,20,2,7,3,1
S01012106,Rented or living rent free: Social rented,13,8,6,3,3,1,1,5,2,0,1,2,0
S01012106,Rented or living rent free: Private rented or living rent free,93,65,52,9,43,4,9,28,18,2,6,1,1
S01012107,All HRPs aged 16 and over,279,191,142,19,123,39,10,88,75,1,2,9,1
S01012107,Owned: Total,238,163,123,15,108,35,5,75,70,0,0,4,1
S01012107,Owned: Owned outright,123,57,40,10,30,14,3,66,64,0,0,1,1
S01012107,Owned: Owned with a mortgage or loan or shared ownership,115,106,83,5,78,21,2,9,6,0,0,3,0
S01012107,Rented or living rent free: Total,41,28,19,4,15,4,5,13,5,1,2,5,0
S01012107,Rented or living rent free: Social rented,23,12,7,3,4,1,4,11,3,1,2,5,0
S01012107,Rented or living rent free: Private rented or living rent free,18,16,12,1,11,3,1,2,2,0,0,0,0
S01012108,All HRPs aged 16 and over,631,248,200,38,162,18,30,383,327,1,5,45,5
S01012108,Owned: Total,248,152,138,18,120,10,4,96,86,0,1,8,1
S01012108,Owned: Owned outright,115,29,24,10,14,4,1,86,80,0,1,5,0
S01012108,Owned: Owned with a mortgage or loan or shared ownership,133,123,114,8,106,6,3,10,6,0,0,3,1
S01012108,Rented or living rent free: Total,383,96,62,20,42,8,26,287,241,1,4,37,4
S01012108,Rented or living rent free: Social rented,332,58,34,11,23,6,18,274,237,0,2,32,3
S01012108,Rented or living rent free: Private rented or living rent free,51,38,28,9,19,2,8,13,4,1,2,5,1
S01012109,All HRPs aged 16 and over,560,359,288,62,226,23,48,201,82,10,17,78,14
S01012109,Owned: Total,189,132,116,16,100,9,7,57,48,0,2,5,2
S01012109,Owned: Owned outright,76,33,27,9,18,1,5,43,39,0,1,2,1
S01012109,Owned: Owned with a mortgage or loan or shared ownership,113,99,89,7,82,8,2,14,9,0,1,3,1
S01012109,Rented or living rent free: Total,371,227,172,46,126,14,41,144,34,10,15,73,12
S01012109,Rented or living rent free: Social rented,205,125,90,29,61,5,30,80,24,3,7,38,8
S01012109,Rented or living rent free: Private rented or living rent free,166,102,82,17,65,9,11,64,10,7,8,35,4
S01012110,All HRPs aged 16 and over,458,254,213,43,170,14,27,204,161,0,4,31,8
S01012110,Owned: Total,256,144,132,16,116,10,2,112,109,0,0,3,0
S01012110,Owned: Owned outright,112,23,22,2,20,1,0,89,86,0,0,3,0
S01012110,Owned: Owned with a mortgage or loan or shared ownership,144,121,110,14,96,9,2,23,23,0,0,0,0
S01012110,Rented or living rent free: Total,202,110,81,27,54,4,25,92,52,0,4,28,8
S01012110,Rented or living rent free: Social rented,121,43,31,15,16,2,10,78,43,0,2,26,7
S01012110,Rented or living rent free: Private rented or living rent free,81,67,50,12,38,2,15,14,9,0,2,2,1
S01012111,All HRPs aged 16 and over,309,177,137,22,115,12,28,132,75,16,4,26,11
S01012111,Owned: Total,125,83,70,6,64,7,6,42,33,9,0,0,0
S01012111,Owned: Owned outright,48,15,10,2,8,2,3,33,24,9,0,0,0
S01012111,Owned: Owned with a mortgage or loan or shared ownership,77,68,60,4,56,5,3,9,9,0,0,0,0
S01012111,Rented or living rent free: Total,184,94,67,16,51,5,22,90,42,7,4,26,11
S01012111,Rented or living rent free: Social rented,154,68,45,11,34,4,19,86,41,6,3,26,10
S01012111,Rented or living rent free: Private rented or living rent free,30,26,22,5,17,1,3,4,1,1,1,0,1
S01012112,All HRPs aged 16 and over,423,201,168,26,142,21,12,222,203,0,2,14,3
S01012112,Owned: Total,289,146,126,13,113,18,2,143,138,0,2,2,1
S01012112,Owned: Owned outright,150,37,30,6,24,5,2,113,110,0,1,1,1
S01012112,Owned: Owned with a mortgage or loan or shared ownership,139,109,96,7,89,13,0,30,28,0,1,1,0
S01012112,Rented or living rent free: Total,134,55,42,13,29,3,10,79,65,0,0,12,2
S01012112,Rented or living rent free: Social rented,97,27,20,6,14,2,5,70,58,0,0,11,1
S01012112,Rented or living rent free: Private rented or living rent free,37,28,22,7,15,1,5,9,7,0,0,1,1
S01012113,All HRPs aged 16 and over,511,278,241,37,204,26,11,233,197,7,2,23,4
S01012113,Owned: Total,362,218,190,23,167,25,3,144,137,1,0,5,1
S01012113,Owned: Owned outright,148,39,33,6,27,4,2,109,104,1,0,3,1
S01012113,Owned: Owned with a mortgage or loan or shared ownership,214,179,157,17,140,21,1,35,33,0,0,2,0
S01012113,Rented or living rent free: Total,149,60,51,14,37,1,8,89,60,6,2,18,3
S01012113,Rented or living rent free: Social rented,115,37,29,10,19,1,7,78,53,5,2,15,3
S01012113,Rented or living rent free: Private rented or living rent free,34,23,22,4,18,0,1,11,7,1,0,3,0
S01012114,All HRPs aged 16 and over,357,218,179,14,165,37,2,139,117,5,9,4,4
S01012114,Owned: Total,302,186,151,9,142,35,0,116,105,4,6,1,0
S01012114,Owned: Owned outright,146,49,38,6,32,11,0,97,90,4,2,1,0
S01012114,Owned: Owned with a mortgage or loan or shared ownership,156,137,113,3,110,24,0,19,15,0,4,0,0
S01012114,Rented or living rent free: Total,55,32,28,5,23,2,2,23,12,1,3,3,4
S01012114,Rented or living rent free: Social rented,8,6,4,1,3,1,1,2,0,0,0,2,0
S01012114,Rented or living rent free: Private rented or living rent free,47,26,24,4,20,1,1,21,12,1,3,1,4
S01012115,All HRPs aged 16 and over,257,140,132,25,107,5,3,117,94,3,5,14,1
S01012115,Owned: Total,186,108,102,15,87,4,2,78,76,0,0,2,0
S01012115,Owned: Owned outright,79,19,18,2,16,0,1,60,59,0,0,1,0
S01012115,Owned: Owned with a mortgage or loan or shared ownership,107,89,84,13,71,4,1,18,17,0,0,1,0
S01012115,Rented or living rent free: Total,71,32,30,10,20,1,1,39,18,3,5,12,1
S01012115,Rented or living rent free: Social rented,46,20,18,7,11,1,1,26,13,1,4,7,1
S01012115,Rented or living rent free: Private rented or living rent free,25,12,12,3,9,0,0,13,5,2,1,5,0
S01012116,All HRPs aged 16 and over,283,164,146,23,123,11,7,119,98,4,2,13,2
S01012116,Owned: Total,217,132,122,17,105,10,0,85,79,1,0,5,0
S01012116,Owned: Owned outright,92,25,21,3,18,4,0,67,63,1,0,3,0
S01012116,Owned: Owned with a mortgage or loan or shared ownership,125,107,101,14,87,6,0,18,16,0,0,2,0
S01012116,Rented or living rent free: Total,66,32,24,6,18,1,7,34,19,3,2,8,2
S01012116,Rented or living rent free: Social rented,53,23,20,5,15,0,3,30,19,2,1,6,2
S01012116,Rented or living rent free: Private rented or living rent free,13,9,4,1,3,1,4,4,0,1,1,2,0
S01012117,All HRPs aged 16 and over,289,249,219,9,210,26,4,40,28,3,0,7,2
S01012117,Owned: Total,260,235,209,8,201,23,3,25,20,1,0,3,1
S01012117,Owned: Owned outright,31,16,12,2,10,4,0,15,14,1,0,0,0
S01012117,Owned: Owned with a mortgage or loan or shared ownership,229,219,197,6,191,19,3,10,6,0,0,3,1
S01012117,Rented or living rent free: Total,29,14,10,1,9,3,1,15,8,2,0,4,1
S01012117,Rented or living rent free: Social rented,13,4,1,0,1,3,0,9,6,0,0,3,0
S01012117,Rented or living rent free: Private rented or living rent free,16,10,9,1,8,0,1,6,2,2,0,1,1
S01012118,All HRPs aged 16 and over,226,191,168,13,155,20,3,35,25,1,0,8,1
S01012118,Owned: Total,210,181,161,12,149,18,2,29,24,0,0,5,0
S01012118,Owned: Owned outright,47,29,25,4,21,2,2,18,15,0,0,3,0
S01012118,Owned: Owned with a mortgage or loan or shared ownership,163,152,136,8,128,16,0,11,9,0,0,2,0
S01012118,Rented or living rent free: Total,16,10,7,1,6,2,1,6,1,1,0,3,1
S01012118,Rented or living rent free: Social rented,6,3,3,1,2,0,0,3,1,1,0,1,0
S01012118,Rented or living rent free: Private rented or living rent free,10,7,4,0,4,2,1,3,0,0,0,2,1
S01012119,All HRPs aged 16 and over,349,237,199,29,170,32,6,112,100,3,0,6,3
S01012119,Owned: Total,332,229,193,27,166,31,5,103,99,1,0,3,0
S01012119,Owned: Owned outright,172,77,56,13,43,17,4,95,92,1,0,2,0
S01012119,Owned: Owned with a mortgage or loan or shared ownership,160,152,137,14,123,14,1,8,7,0,0,1,0
S01012119,Rented or living rent free: Total,17,8,6,2,4,1,1,9,1,2,0,3,3
S01012119,Rented or living rent free: Social rented,7,3,3,1,2,0,0,4,1,1,0,2,0
S01012119,Rented or living rent free: Private rented or living rent free,10,5,3,1,2,1,1,5,0,1,0,1,3
S01012120,All HRPs aged 16 and over,256,157,132,33,99,9,16,99,65,2,10,20,2
S01012120,Owned: Total,147,92,85,16,69,7,0,55,49,2,0,4,0
S01012120,Owned: Owned outright,62,21,18,7,11,3,0,41,39,0,0,2,0
S01012120,Owned: Owned with a mortgage or loan or shared ownership,85,71,67,9,58,4,0,14,10,2,0,2,0
S01012120,Rented or living rent free: Total,109,65,47,17,30,2,16,44,16,0,10,16,2
S01012120,Rented or living rent free: Social rented,80,49,36,13,23,2,11,31,12,0,6,11,2
S01012120,Rented or living rent free: Private rented or living rent free,29,16,11,4,7,0,5,13,4,0,4,5,0
S01012121,All HRPs aged 16 and over,404,229,193,38,155,15,21,175,122,2,18,26,7
S01012121,Owned: Total,216,139,123,15,108,10,6,77,71,0,1,4,1
S01012121,Owned: Owned outright,84,27,25,4,21,1,1,57,55,0,1,1,0
S01012121,Owned: Owned with a mortgage or loan or shared ownership,132,112,98,11,87,9,5,20,16,0,0,3,1
S01012121,Rented or living rent free: Total,188,90,70,23,47,5,15,98,51,2,17,22,6
S01012121,Rented or living rent free: Social rented,160,77,59,18,41,3,15,83,45,2,13,18,5
S01012121,Rented or living rent free: Private rented or living rent free,28,13,11,5,6,2,0,15,6,0,4,4,1
S01012122,All HRPs aged 16 and over,318,189,162,35,127,16,11,129,105,0,7,16,1
S01012122,Owned: Total,235,146,126,20,106,15,5,89,85,0,0,3,1
S01012122,Owned: Owned outright,91,32,26,6,20,4,2,59,56,0,0,2,1
S01012122,Owned: Owned with a mortgage or loan or shared ownership,144,114,100,14,86,11,3,30,29,0,0,1,0
S01012122,Rented or living rent free: Total,83,43,36,15,21,1,6,40,20,0,7,13,0
S01012122,Rented or living rent free: Social rented,70,35,31,11,20,1,3,35,20,0,5,10,0
S01012122,Rented or living rent free: Private rented or living rent free,13,8,5,4,1,0,3,5,0,0,2,3,0
S01012123,All HRPs aged 16 and over,212,150,121,22,99,18,11,62,49,3,4,2,4
S01012123,Owned: Total,149,104,84,12,72,15,5,45,39,2,1,1,2
S01012123,Owned: Owned outright,55,21,17,5,12,3,1,34,31,1,0,0,2
S01012123,Owned: Owned with a mortgage or loan or shared ownership,94,83,67,7,60,12,4,11,8,1,1,1,0
S01012123,Rented or living rent free: Total,63,46,37,10,27,3,6,17,10,1,3,1,2
S01012123,Rented or living rent free: Social rented,23,11,7,4,3,1,3,12,6,1,2,1,2
S01012123,Rented or living rent free: Private rented or living rent free,40,35,30,6,24,2,3,5,4,0,1,0,0
S01012124,All HRPs aged 16 and over,262,205,187,29,158,12,6,57,38,1,4,12,2
S01012124,Owned: Total,199,158,149,19,130,8,1,41,36,0,0,4,1
S01012124,Owned: Owned outright,70,34,32,8,24,2,0,36,32,0,0,3,1
S01012124,Owned: Owned with a mortgage or loan or shared ownership,129,124,117,11,106,6,1,5,4,0,0,1,0
S01012124,Rented or living rent free: Total,63,47,38,10,28,4,5,16,2,1,4,8,1
S01012124,Rented or living rent free: Social rented,14,9,7,4,3,1,1,5,1,0,0,4,0
S01012124,Rented or living rent free: Private rented or living rent free,49,38,31,6,25,3,4,11,1,1,4,4,1
S01012125,All HRPs aged 16 and over,504,296,226,48,178,17,53,208,105,8,16,59,20
S01012125,Owned: Total,139,104,94,9,85,7,3,35,28,0,1,3,3
S01012125,Owned: Owned outright,41,19,16,2,14,3,0,22,20,0,0,0,2
S01012125,Owned: Owned with a mortgage or loan or shared ownership,98,85,78,7,71,4,3,13,8,0,1,3,1
S01012125,Rented or living rent free: Total,365,192,132,39,93,10,50,173,77,8,15,56,17
S01012125,Rented or living rent free: Social rented,279,133,91,28,63,5,37,146,69,7,11,46,13
S01012125,Rented or living rent free: Private rented or living rent free,86,59,41,11,30,5,13,27,8,1,4,10,4
S01012126,All HRPs aged 16 and over,389,318,265,26,239,36,17,71,30,8,7,19,7
S01012126,Owned: Total,274,235,205,16,189,26,4,39,24,5,2,5,3
S01012126,Owned: Owned outright,57,33,29,5,24,3,1,24,23,0,0,1,0
S01012126,Owned: Owned with a mortgage or loan or shared ownership,217,202,176,11,165,23,3,15,1,5,2,4,3
S01012126,Rented or living rent free: Total,115,83,60,10,50,10,13,32,6,3,5,14,4
S01012126,Rented or living rent free: Social rented,15,7,5,1,4,1,1,8,3,2,0,3,0
S01012126,Rented or living rent free: Private rented or living rent free,100,76,55,9,46,9,12,24,3,1,5,11,4
S01012127,All HRPs aged 16 and over,552,376,277,45,232,30,69,176,57,35,12,60,12
S01012127,Owned: Total,216,165,137,11,126,20,8,51,36,3,2,7,3
S01012127,Owned: Owned outright,70,32,25,3,22,3,4,38,29,3,0,5,1
S01012127,Owned: Owned with a mortgage or loan or shared ownership,146,133,112,8,104,17,4,13,7,0,2,2,2
S01012127,Rented or living rent free: Total,336,211,140,34,106,10,61,125,21,32,10,53,9
S01012127,Rented or living rent free: Social rented,95,48,38,17,21,1,9,47,13,1,9,22,2
S01012127,Rented or living rent free: Private rented or living rent free,241,163,102,17,85,9,52,78,8,31,1,31,7
S01012128,All HRPs aged 16 and over,278,204,173,30,143,12,19,74,28,4,17,19,6
S01012128,Owned: Total,104,88,79,5,74,8,1,16,7,0,2,7,0
S01012128,Owned: Owned outright,17,8,6,4,2,2,0,9,6,0,1,2,0
S01012128,Owned: Owned with a mortgage or loan or shared ownership,87,80,73,1,72,6,1,7,1,0,1,5,0
S01012128,Rented or living rent free: Total,174,116,94,25,69,4,18,58,21,4,15,12,6
S01012128,Rented or living rent free: Social rented,53,19,12,6,6,0,7,34,20,2,2,7,3
S01012128,Rented or living rent free: Private rented or living rent free,121,97,82,19,63,4,11,24,1,2,13,5,3
S01012129,All HRPs aged 16 and over,440,284,231,36,195,23,30,156,82,7,10,47,10
S01012129,Owned: Total,214,153,134,10,124,15,4,61,46,4,2,8,1
S01012129,Owned: Owned outright,80,36,31,4,27,3,2,44,35,1,0,7,1
S01012129,Owned: Owned with a mortgage or loan or shared ownership,134,117,103,6,97,12,2,17,11,3,2,1,0
S01012129,Rented or living rent free: Total,226,131,97,26,71,8,26,95,36,3,8,39,9
S01012129,Rented or living rent free: Social rented,120,55,41,15,26,2,12,65,32,2,0,28,3
S01012129,Rented or living rent free: Private rented or living rent free,106,76,56,11,45,6,14,30,4,1,8,11,6
S01012130,All HRPs aged 16 and over,687,341,285,34,251,21,35,346,240,12,8,72,14
S01012130,Owned: Total,282,189,168,13,155,12,9,93,84,0,2,5,2
S01012130,Owned: Owned outright,119,42,38,5,33,3,1,77,73,0,1,2,1
S01012130,Owned: Owned with a mortgage or loan or shared ownership,163,147,130,8,122,9,8,16,11,0,1,3,1
S01012130,Rented or living rent free: Total,405,152,117,21,96,9,26,253,156,12,6,67,12
S01012130,Rented or living rent free: Social rented,289,72,50,9,41,5,17,217,149,3,6,52,7
S01012130,Rented or living rent free: Private rented or living rent free,116,80,67,12,55,4,9,36,7,9,0,15,5
S01012131,All HRPs aged 16 and over,610,367,294,65,229,18,55,243,113,20,18,77,15
S01012131,Owned: Total,238,172,153,20,133,9,10,66,47,3,4,11,1
S01012131,Owned: Owned outright,84,38,31,7,24,3,4,46,39,0,1,5,1
S01012131,Owned: Owned with a mortgage or loan or shared ownership,154,134,122,13,109,6,6,20,8,3,3,6,0
S01012131,Rented or living rent free: Total,372,195,141,45,96,9,45,177,66,17,14,66,14
S01012131,Rented or living rent free: Social rented,203,79,48,18,30,2,29,124,59,5,8,43,9
S01012131,Rented or living rent free: Private rented or living rent free,169,116,93,27,66,7,16,53,7,12,6,23,5
S01012132,All HRPs aged 16 and over,426,275,204,49,155,20,51,151,61,22,14,41,13
S01012132,Owned: Total,150,102,86,16,70,10,6,48,43,0,1,3,1
S01012132,Owned: Owned outright,68,34,26,6,20,4,4,34,32,0,0,2,0
S01012132,Owned: Owned with a mortgage or loan or shared ownership,82,68,60,10,50,6,2,14,11,0,1,1,1
S01012132,Rented or living rent free: Total,276,173,118,33,85,10,45,103,18,22,13,38,12
S01012132,Rented or living rent free: Social rented,97,47,35,13,22,2,10,50,10,7,1,28,4
S01012132,Rented or living rent free: Private rented or living rent free,179,126,83,20,63,8,35,53,8,15,12,10,8
S01012133,All HRPs aged 16 and over,421,303,245,31,214,22,36,118,42,20,10,39,7
S01012133,Owned: Total,223,186,165,16,149,17,4,37,30,0,2,2,3
S01012133,Owned: Owned outright,56,34,30,8,22,2,2,22,21,0,0,1,0
S01012133,Owned: Owned with a mortgage or loan or shared ownership,167,152,135,8,127,15,2,15,9,0,2,1,3
S01012133,Rented or living rent free: Total,198,117,80,15,65,5,32,81,12,20,8,37,4
S01012133,Rented or living rent free: Social rented,88,47,26,9,17,1,20,41,11,3,2,25,0
S01012133,Rented or living rent free: Private rented or living rent free,110,70,54,6,48,4,12,40,1,17,6,12,4
S01012134,All HRPs aged 16 and over,606,350,291,36,255,40,19,256,221,11,6,16,2
S01012134,Owned: Total,433,270,228,21,207,35,7,163,152,6,2,1,2
S01012134,Owned: Owned outright,200,64,52,10,42,8,4,136,129,5,0,0,2
S01012134,Owned: Owned with a mortgage or loan or shared ownership,233,206,176,11,165,27,3,27,23,1,2,1,0
S01012134,Rented or living rent free: Total,173,80,63,15,48,5,12,93,69,5,4,15,0
S01012134,Rented or living rent free: Social rented,63,4,2,0,2,1,1,59,53,1,1,4,0
S01012134,Rented or living rent free: Private rented or living rent free,110,76,61,15,46,4,11,34,16,4,3,11,0
S01012135,All HRPs aged 16 and over,570,314,248,69,179,16,50,256,118,12,13,91,22
S01012135,Owned: Total,111,81,73,11,62,5,3,30,22,3,0,4,1
S01012135,Owned: Owned outright,39,16,12,0,12,2,2,23,18,2,0,3,0
S01012135,Owned: Owned with a mortgage or loan or shared ownership,72,65,61,11,50,3,1,7,4,1,0,1,1
S01012135,Rented or living rent free: Total,459,233,175,58,117,11,47,226,96,9,13,87,21
S01012135,Rented or living rent free: Social rented,383,183,139,48,91,8,36,200,88,6,7,79,20
S01012135,Rented or living rent free: Private rented or living rent free,76,50,36,10,26,3,11,26,8,3,6,8,1
S01012136,All HRPs aged 16 and over,516,339,269,57,212,16,54,177,47,26,8,75,21
S01012136,Owned: Total,119,105,87,4,83,10,8,14,9,0,0,3,2
S01012136,Owned: Owned outright,21,12,7,1,6,2,3,9,8,0,0,1,0
S01012136,Owned: Owned with a mortgage or loan or shared ownership,98,93,80,3,77,8,5,5,1,0,0,2,2
S01012136,Rented or living rent free: Total,397,234,182,53,129,6,46,163,38,26,8,72,19
S01012136,Rented or living rent free: Social rented,214,110,82,20,62,5,23,104,33,4,8,46,13
S01012136,Rented or living rent free: Private rented or living rent free,183,124,100,33,67,1,23,59,5,22,0,26,6
S01012137,All HRPs aged 16 and over,463,223,183,48,135,13,27,240,142,19,10,58,11
S01012137,Owned: Total,193,96,86,14,72,7,3,97,84,1,4,6,2
S01012137,Owned: Owned outright,110,23,20,5,15,1,2,87,80,0,2,4,1
S01012137,Owned: Owned with a mortgage or loan or shared ownership,83,73,66,9,57,6,1,10,4,1,2,2,1
S01012137,Rented or living rent free: Total,270,127,97,34,63,6,24,143,58,18,6,52,9
S01012137,Rented or living rent free: Social rented,186,77,55,25,30,4,18,109,49,2,4,46,8
S01012137,Rented or living rent free: Private rented or living rent free,84,50,42,9,33,2,6,34,9,16,2,6,1
S01012138,All HRPs aged 16 and over,460,295,254,32,222,29,12,165,130,9,6,16,4
S01012138,Owned: Total,350,238,205,16,189,24,9,112,93,8,2,6,3
S01012138,Owned: Owned outright,152,53,40,6,34,7,6,99,81,8,2,6,2
S01012138,Owned: Owned with a mortgage or loan or shared ownership,198,185,165,10,155,17,3,13,12,0,0,0,1
S01012138,Rented or living rent free: Total,110,57,49,16,33,5,3,53,37,1,4,10,1
S01012138,Rented or living rent free: Social rented,51,19,18,7,11,0,1,32,23,0,3,6,0
S01012138,Rented or living rent free: Private rented or living rent free,59,38,31,9,22,5,2,21,14,1,1,4,1
S01012139,All HRPs aged 16 and over,462,244,209,28,181,24,11,218,179,6,11,21,1
S01012139,Owned: Total,344,212,187,23,164,21,4,132,123,3,0,5,1
S01012139,Owned: Owned outright,152,48,41,10,31,5,2,104,99,2,0,2,1
S01012139,Owned: Owned with a mortgage or loan or shared ownership,192,164,146,13,133,16,2,28,24,1,0,3,0
S01012139,Rented or living rent free: Total,118,32,22,5,17,3,7,86,56,3,11,16,0
S01012139,Rented or living rent free: Social rented,80,16,8,3,5,2,6,64,45,2,4,13,0
S01012139,Rented or living rent free: Private rented or living rent free,38,16,14,2,12,1,1,22,11,1,7,3,0
S01012140,All HRPs aged 16 and over,205,134,109,10,99,21,4,71,69,1,0,1,0
S01012140,Owned: Total,194,127,104,9,95,20,3,67,66,1,0,0,0
S01012140,Owned: Owned outright,107,45,36,8,28,7,2,62,61,1,0,0,0
S01012140,Owned: Owned with a mortgage or loan or shared ownership,87,82,68,1,67,13,1,5,5,0,0,0,0
S01012140,Rented or living rent free: Total,11,7,5,1,4,1,1,4,3,0,0,1,0
S01012140,Rented or living rent free: Social rented,5,3,3,1,2,0,0,2,2,0,0,0,0
S01012140,Rented or living rent free: Private rented or living rent free,6,4,2,0,2,1,1,2,1,0,0,1,0
S01012141,All HRPs aged 16 and over,412,256,222,28,194,29,5,156,139,0,1,15,1
S01012141,Owned: Total,381,240,208,26,182,28,4,141,133,0,1,6,1
S01012141,Owned: Owned outright,193,73,63,13,50,8,2,120,119,0,0,1,0
S01012141,Owned: Owned with a mortgage or loan or shared ownership,188,167,145,13,132,20,2,21,14,0,1,5,1
S01012141,Rented or living rent free: Total,31,16,14,2,12,1,1,15,6,0,0,9,0
S01012141,Rented or living rent free: Social rented,17,5,4,1,3,0,1,12,6,0,0,6,0
S01012141,Rented or living rent free: Private rented or living rent free,14,11,10,1,9,1,0,3,0,0,0,3,0
S01012142,All HRPs aged 16 and over,395,225,183,17,166,39,3,170,156,2,4,5,3
S01012142,Owned: Total,379,215,175,14,161,37,3,164,155,1,3,3,2
S01012142,Owned: Owned outright,214,70,56,11,45,12,2,144,136,1,3,3,1
S01012142,Owned: Owned with a mortgage or loan or shared ownership,165,145,119,3,116,25,1,20,19,0,0,0,1
S01012142,Rented or living rent free: Total,16,10,8,3,5,2,0,6,1,1,1,2,1
S01012142,Rented or living rent free: Social rented,5,2,1,1,0,1,0,3,0,1,0,1,1
S01012142,Rented or living rent free: Private rented or living rent free,11,8,7,2,5,1,0,3,1,0,1,1,0
S01012143,All HRPs aged 16 and over,376,194,150,15,135,42,2,182,164,2,8,7,1
S01012143,Owned: Total,361,189,145,14,131,42,2,172,161,2,4,5,0
S01012143,Owned: Owned outright,225,67,47,10,37,18,2,158,153,0,3,2,0
S01012143,Owned: Owned with a mortgage or loan or shared ownership,136,122,98,4,94,24,0,14,8,2,1,3,0
S01012143,Rented or living rent free: Total,15,5,5,1,4,0,0,10,3,0,4,2,1
S01012143,Rented or living rent free: Social rented,8,1,1,1,0,0,0,7,1,0,4,1,1
S01012143,Rented or living rent free: Private rented or living rent free,7,4,4,0,4,0,0,3,2,0,0,1,0
S01012144,All HRPs aged 16 and over,449,251,211,20,191,35,5,198,176,6,3,9,4
S01012144,Owned: Total,392,230,193,16,177,35,2,162,152,3,1,2,4
S01012144,Owned: Owned outright,213,63,55,9,46,7,1,150,142,3,1,1,3
S01012144,Owned: Owned with a mortgage or loan or shared ownership,179,167,138,7,131,28,1,12,10,0,0,1,1
S01012144,Rented or living rent free: Total,57,21,18,4,14,0,3,36,24,3,2,7,0
S01012144,Rented or living rent free: Social rented,18,6,5,2,3,0,1,12,9,0,2,1,0
S01012144,Rented or living rent free: Private rented or living rent free,39,15,13,2,11,0,2,24,15,3,0,6,0
S01012145,All HRPs aged 16 and over,399,242,207,24,183,32,3,157,150,1,3,3,0
S01012145,Owned: Total,377,227,195,19,176,29,3,150,147,1,0,2,0
S01012145,Owned: Owned outright,191,54,43,9,34,8,3,137,134,1,0,2,0
S01012145,Owned: Owned with a mortgage or loan or shared ownership,186,173,152,10,142,21,0,13,13,0,0,0,0
S01012145,Rented or living rent free: Total,22,15,12,5,7,3,0,7,3,0,3,1,0
S01012145,Rented or living rent free: Social rented,7,4,4,1,3,0,0,3,1,0,1,1,0
S01012145,Rented or living rent free: Private rented or living rent free,15,11,8,4,4,3,0,4,2,0,2,0,0
S01012146,All HRPs aged 16 and over,572,297,255,52,203,21,21,275,160,20,25,58,12
S01012146,Owned: Total,213,127,115,13,102,9,3,86,71,2,0,8,5
S01012146,Owned: Owned outright,84,34,30,6,24,3,1,50,44,0,0,6,0
S01012146,Owned: Owned with a mortgage or loan or shared ownership,129,93,85,7,78,6,2,36,27,2,0,2,5
S01012146,Rented or living rent free: Total,359,170,140,39,101,12,18,189,89,18,25,50,7
S01012146,Rented or living rent free: Social rented,247,92,73,32,41,5,14,155,81,5,22,41,6
S01012146,Rented or living rent free: Private rented or living rent free,112,78,67,7,60,7,4,34,8,13,3,9,1
S01012147,All HRPs aged 16 and over,407,204,166,48,118,9,29,203,113,13,20,50,7
S01012147,Owned: Total,179,104,90,17,73,6,8,75,64,2,0,8,1
S01012147,Owned: Owned outright,71,23,15,7,8,4,4,48,47,0,0,1,0
S01012147,Owned: Owned with a mortgage or loan or shared ownership,108,81,75,10,65,2,4,27,17,2,0,7,1
S01012147,Rented or living rent free: Total,228,100,76,31,45,3,21,128,49,11,20,42,6
S01012147,Rented or living rent free: Social rented,184,82,59,24,35,2,21,102,45,6,7,39,5
S01012147,Rented or living rent free: Private rented or living rent free,44,18,17,7,10,1,0,26,4,5,13,3,1
S01012148,All HRPs aged 16 and over,364,197,166,51,115,8,23,167,73,3,27,49,15
S01012148,Owned: Total,153,101,95,19,76,4,2,52,45,0,1,6,0
S01012148,Owned: Owned outright,52,19,18,4,14,1,0,33,32,0,0,1,0
S01012148,Owned: Owned with a mortgage or loan or shared ownership,101,82,77,15,62,3,2,19,13,0,1,5,0
S01012148,Rented or living rent free: Total,211,96,71,32,39,4,21,115,28,3,26,43,15
S01012148,Rented or living rent free: Social rented,172,77,55,25,30,3,19,95,23,3,18,38,13
S01012148,Rented or living rent free: Private rented or living rent free,39,19,16,7,9,1,2,20,5,0,8,5,2
S01012149,All HRPs aged 16 and over,335,235,186,38,148,39,10,100,55,7,13,19,6
S01012149,Owned: Total,222,174,134,22,112,35,5,48,37,5,2,3,1
S01012149,Owned: Owned outright,67,36,25,7,18,9,2,31,29,0,0,2,0
S01012149,Owned: Owned with a mortgage or loan or shared ownership,155,138,109,15,94,26,3,17,8,5,2,1,1
S01012149,Rented or living rent free: Total,113,61,52,16,36,4,5,52,18,2,11,16,5
S01012149,Rented or living rent free: Social rented,68,32,26,11,15,2,4,36,13,2,5,13,3
S01012149,Rented or living rent free: Private rented or living rent free,45,29,26,5,21,2,1,16,5,0,6,3,2
S01012150,All HRPs aged 16 and over,359,188,150,32,118,15,23,171,124,0,13,26,8
S01012150,Owned: Total,189,116,101,12,89,13,2,73,68,0,3,2,0
S01012150,Owned: Owned outright,65,21,18,5,13,2,1,44,43,0,0,1,0
S01012150,Owned: Owned with a mortgage or loan or shared ownership,124,95,83,7,76,11,1,29,25,0,3,1,0
S01012150,Rented or living rent free: Total,170,72,49,20,29,2,21,98,56,0,10,24,8
S01012150,Rented or living rent free: Social rented,154,62,40,17,23,2,20,92,56,0,7,22,7
S01012150,Rented or living rent free: Private rented or living rent free,16,10,9,3,6,0,1,6,0,0,3,2,1
S01012151,All HRPs aged 16 and over,397,207,174,32,142,9,24,190,135,0,7,40,8
S01012151,Owned: Total,199,112,100,8,92,9,3,87,79,0,0,7,1
S01012151,Owned: Owned outright,78,23,21,3,18,1,1,55,49,0,0,6,0
S01012151,Owned: Owned with a mortgage or loan or shared ownership,121,89,79,5,74,8,2,32,30,0,0,1,1
S01012151,Rented or living rent free: Total,198,95,74,24,50,0,21,103,56,0,7,33,7
S01012151,Rented or living rent free: Social rented,181,85,65,21,44,0,20,96,56,0,4,29,7
S01012151,Rented or living rent free: Private rented or living rent free,17,10,9,3,6,0,1,7,0,0,3,4,0
S01012152,All HRPs aged 16 and over,362,194,150,41,109,14,30,168,67,1,16,67,17
S01012152,Owned: Total,105,74,67,9,58,5,2,31,29,0,0,1,1
S01012152,Owned: Owned outright,41,21,18,4,14,2,1,20,19,0,0,1,0
S01012152,Owned: Owned with a mortgage or loan or shared ownership,64,53,49,5,44,3,1,11,10,0,0,0,1
S01012152,Rented or living rent free: Total,257,120,83,32,51,9,28,137,38,1,16,66,16
S01012152,Rented or living rent free: Social rented,243,109,76,30,46,5,28,134,38,1,16,65,14
S01012152,Rented or living rent free: Private rented or living rent free,14,11,7,2,5,4,0,3,0,0,0,1,2
S01012153,All HRPs aged 16 and over,329,199,159,33,126,11,29,130,34,5,5,80,6
S01012153,Owned: Total,76,61,51,4,47,7,3,15,11,1,1,1,1
S01012153,Owned: Owned outright,27,18,13,1,12,3,2,9,6,0,1,1,1
S01012153,Owned: Owned with a mortgage or loan or shared ownership,49,43,38,3,35,4,1,6,5,1,0,0,0
S01012153,Rented or living rent free: Total,253,138,108,29,79,4,26,115,23,4,4,79,5
S01012153,Rented or living rent free: Social rented,185,89,66,19,47,3,20,96,19,2,4,66,5
S01012153,Rented or living rent free: Private rented or living rent free,68,49,42,10,32,1,6,19,4,2,0,13,0
S01012154,All HRPs aged 16 and over,513,291,235,45,190,15,41,222,89,15,12,95,11
S01012154,Owned: Total,149,108,95,9,86,8,5,41,34,0,0,6,1
S01012154,Owned: Owned outright,49,15,13,3,10,1,1,34,29,0,0,4,1
S01012154,Owned: Owned with a mortgage or loan or shared ownership,100,93,82,6,76,7,4,7,5,0,0,2,0
S01012154,Rented or living rent free: Total,364,183,140,36,104,7,36,181,55,15,12,89,10
S01012154,Rented or living rent free: Social rented,263,129,103,25,78,3,23,134,50,4,8,62,10
S01012154,Rented or living rent free: Private rented or living rent free,101,54,37,11,26,4,13,47,5,11,4,27,0
S01012155,All HRPs aged 16 and over,357,229,179,40,139,12,38,128,59,15,3,48,3
S01012155,Owned: Total,113,87,76,10,66,8,3,26,24,1,0,0,1
S01012155,Owned: Owned outright,42,22,16,6,10,4,2,20,19,0,0,0,1
S01012155,Owned: Owned with a mortgage or loan or shared ownership,71,65,60,4,56,4,1,6,5,1,0,0,0
S01012155,Rented or living rent free: Total,244,142,103,30,73,4,35,102,35,14,3,48,2
S01012155,Rented or living rent free: Social rented,165,95,67,19,48,3,25,70,24,5,2,37,2
S01012155,Rented or living rent free: Private rented or living rent free,79,47,36,11,25,1,10,32,11,9,1,11,0
S01012156,All HRPs aged 16 and over,372,190,149,29,120,15,26,182,103,4,12,59,4
S01012156,Owned: Total,133,93,82,14,68,9,2,40,30,1,2,7,0
S01012156,Owned: Owned outright,49,22,16,7,9,4,2,27,23,1,1,2,0
S01012156,Owned: Owned with a mortgage or loan or shared ownership,84,71,66,7,59,5,0,13,7,0,1,5,0
S01012156,Rented or living rent free: Total,239,97,67,15,52,6,24,142,73,3,10,52,4
S01012156,Rented or living rent free: Social rented,205,77,55,14,41,3,19,128,71,1,8,44,4
S01012156,Rented or living rent free: Private rented or living rent free,34,20,12,1,11,3,5,14,2,2,2,8,0
S01012157,All HRPs aged 16 and over,487,327,282,43,239,24,21,160,108,6,9,30,7
S01012157,Owned: Total,267,193,169,12,157,19,5,74,68,0,1,4,1
S01012157,Owned: Owned outright,79,21,17,5,12,3,1,58,55,0,0,3,0
S01012157,Owned: Owned with a mortgage or loan or shared ownership,188,172,152,7,145,16,4,16,13,0,1,1,1
S01012157,Rented or living rent free: Total,220,134,113,31,82,5,16,86,40,6,8,26,6
S01012157,Rented or living rent free: Social rented,137,70,57,18,39,0,13,67,33,0,6,23,5
S01012157,Rented or living rent free: Private rented or living rent free,83,64,56,13,43,5,3,19,7,6,2,3,1
S01012158,All HRPs aged 16 and over,487,382,325,41,284,44,13,105,69,4,16,12,4
S01012158,Owned: Total,366,306,268,23,245,36,2,60,52,2,1,4,1
S01012158,Owned: Owned outright,87,38,34,10,24,4,0,49,43,1,1,3,1
S01012158,Owned: Owned with a mortgage or loan or shared ownership,279,268,234,13,221,32,2,11,9,1,0,1,0
S01012158,Rented or living rent free: Total,121,76,57,18,39,8,11,45,17,2,15,8,3
S01012158,Rented or living rent free: Social rented,44,21,15,5,10,2,4,23,10,1,4,7,1
S01012158,Rented or living rent free: Private rented or living rent free,77,55,42,13,29,6,7,22,7,1,11,1,2
S01012159,All HRPs aged 16 and over,229,138,116,13,103,15,7,91,88,0,0,2,1
S01012159,Owned: Total,219,134,114,13,101,14,6,85,83,0,0,2,0
S01012159,Owned: Owned outright,125,47,39,10,29,4,4,78,76,0,0,2,0
S01012159,Owned: Owned with a mortgage or loan or shared ownership,94,87,75,3,72,10,2,7,7,0,0,0,0
S01012159,Rented or living rent free: Total,10,4,2,0,2,1,1,6,5,0,0,0,1
S01012159,Rented or living rent free: Social rented,4,1,0,0,0,0,1,3,3,0,0,0,0
S01012159,Rented or living rent free: Private rented or living rent free,6,3,2,0,2,1,0,3,2,0,0,0,1
S01012160,All HRPs aged 16 and over,293,199,174,23,151,22,3,94,87,2,0,4,1
S01012160,Owned: Total,277,188,165,23,142,21,2,89,84,0,0,4,1
S01012160,Owned: Owned outright,146,64,56,16,40,7,1,82,77,0,0,4,1
S01012160,Owned: Owned with a mortgage or loan or shared ownership,131,124,109,7,102,14,1,7,7,0,0,0,0
S01012160,Rented or living rent free: Total,16,11,9,0,9,1,1,5,3,2,0,0,0
S01012160,Rented or living rent free: Social rented,2,1,0,0,0,0,1,1,0,1,0,0,0
S01012160,Rented or living rent free: Private rented or living rent free,14,10,9,0,9,1,0,4,3,1,0,0,0
S01012161,All HRPs aged 16 and over,208,121,100,28,72,7,14,87,34,0,16,30,7
S01012161,Owned: Total,78,55,50,9,41,4,1,23,19,0,0,3,1
S01012161,Owned: Owned outright,21,7,7,1,6,0,0,14,13,0,0,0,1
S01012161,Owned: Owned with a mortgage or loan or shared ownership,57,48,43,8,35,4,1,9,6,0,0,3,0
S01012161,Rented or living rent free: Total,130,66,50,19,31,3,13,64,15,0,16,27,6
S01012161,Rented or living rent free: Social rented,99,51,38,17,21,2,11,48,14,0,10,22,2
S01012161,Rented or living rent free: Private rented or living rent free,31,15,12,2,10,1,2,16,1,0,6,5,4
S01012162,All HRPs aged 16 and over,386,280,233,46,187,18,29,106,38,2,17,38,11
S01012162,Owned: Total,177,149,135,12,123,13,1,28,22,0,0,2,4
S01012162,Owned: Owned outright,32,16,13,4,9,2,1,16,12,0,0,2,2
S01012162,Owned: Owned with a mortgage or loan or shared ownership,145,133,122,8,114,11,0,12,10,0,0,0,2
S01012162,Rented or living rent free: Total,209,131,98,34,64,5,28,78,16,2,17,36,7
S01012162,Rented or living rent free: Social rented,152,92,69,23,46,3,20,60,16,2,12,27,3
S01012162,Rented or living rent free: Private rented or living rent free,57,39,29,11,18,2,8,18,0,0,5,9,4
S01012163,All HRPs aged 16 and over,384,260,217,33,184,19,24,124,57,4,7,47,9
S01012163,Owned: Total,169,135,118,16,102,14,3,34,29,0,0,3,2
S01012163,Owned: Owned outright,43,17,13,2,11,3,1,26,24,0,0,1,1
S01012163,Owned: Owned with a mortgage or loan or shared ownership,126,118,105,14,91,11,2,8,5,0,0,2,1
S01012163,Rented or living rent free: Total,215,125,99,17,82,5,21,90,28,4,7,44,7
S01012163,Rented or living rent free: Social rented,133,53,35,11,24,4,14,80,25,3,6,40,6
S01012163,Rented or living rent free: Private rented or living rent free,82,72,64,6,58,1,7,10,3,1,1,4,1
S01012164,All HRPs aged 16 and over,413,366,330,29,301,32,4,47,27,0,11,7,2
S01012164,Owned: Total,370,338,303,22,281,32,3,32,24,0,4,3,1
S01012164,Owned: Owned outright,45,27,22,3,19,3,2,18,16,0,1,1,0
S01012164,Owned: Owned with a mortgage or loan or shared ownership,325,311,281,19,262,29,1,14,8,0,3,2,1
S01012164,Rented or living rent free: Total,43,28,27,7,20,0,1,15,3,0,7,4,1
S01012164,Rented or living rent free: Social rented,8,1,1,0,1,0,0,7,1,0,3,2,1
S01012164,Rented or living rent free: Private rented or living rent free,35,27,26,7,19,0,1,8,2,0,4,2,0
S01012165,All HRPs aged 16 and over,451,284,219,48,171,22,43,167,80,3,20,48,16
S01012165,Owned: Total,188,130,109,13,96,15,6,58,47,1,1,6,3
S01012165,Owned: Owned outright,70,30,23,3,20,4,3,40,35,1,0,3,1
S01012165,Owned: Owned with a mortgage or loan or shared ownership,118,100,86,10,76,11,3,18,12,0,1,3,2
S01012165,Rented or living rent free: Total,263,154,110,35,75,7,37,109,33,2,19,42,13
S01012165,Rented or living rent free: Social rented,222,125,89,30,59,7,29,97,30,1,18,37,11
S01012165,Rented or living rent free: Private rented or living rent free,41,29,21,5,16,0,8,12,3,1,1,5,2
S01012166,All HRPs aged 16 and over,292,193,165,46,119,15,13,99,42,4,20,25,8
S01012166,Owned: Total,147,116,108,23,85,8,0,31,26,0,1,3,1
S01012166,Owned: Owned outright,49,27,26,7,19,1,0,22,19,0,1,2,0
S01012166,Owned: Owned with a mortgage or loan or shared ownership,98,89,82,16,66,7,0,9,7,0,0,1,1
S01012166,Rented or living rent free: Total,145,77,57,23,34,7,13,68,16,4,19,22,7
S01012166,Rented or living rent free: Social rented,100,53,41,19,22,4,8,47,13,4,7,16,7
S01012166,Rented or living rent free: Private rented or living rent free,45,24,16,4,12,3,5,21,3,0,12,6,0
S01012167,All HRPs aged 16 and over,425,274,221,32,189,24,29,151,99,3,8,30,11
S01012167,Owned: Total,260,185,165,21,144,18,2,75,60,1,0,11,3
S01012167,Owned: Owned outright,85,30,27,9,18,1,2,55,50,0,0,2,3
S01012167,Owned: Owned with a mortgage or loan or shared ownership,175,155,138,12,126,17,0,20,10,1,0,9,0
S01012167,Rented or living rent free: Total,165,89,56,11,45,6,27,76,39,2,8,19,8
S01012167,Rented or living rent free: Social rented,115,56,36,10,26,5,15,59,32,1,6,13,7
S01012167,Rented or living rent free: Private rented or living rent free,50,33,20,1,19,1,12,17,7,1,2,6,1
S01012168,All HRPs aged 16 and over,379,215,185,23,162,19,11,164,141,3,3,13,4
S01012168,Owned: Total,341,202,176,20,156,17,9,139,127,3,2,6,1
S01012168,Owned: Owned outright,186,62,51,14,37,7,4,124,118,2,1,3,0
S01012168,Owned: Owned with a mortgage or loan or shared ownership,155,140,125,6,119,10,5,15,9,1,1,3,1
S01012168,Rented or living rent free: Total,38,13,9,3,6,2,2,25,14,0,1,7,3
S01012168,Rented or living rent free: Social rented,25,9,6,2,4,1,2,16,10,0,1,5,0
S01012168,Rented or living rent free: Private rented or living rent free,13,4,3,1,2,1,0,9,4,0,0,2,3
S01012169,All HRPs aged 16 and over,429,228,205,37,168,13,10,201,150,3,7,33,8
S01012169,Owned: Total,309,185,169,24,145,13,3,124,109,3,2,5,5
S01012169,Owned: Owned outright,140,39,34,8,26,4,1,101,90,3,2,4,2
S01012169,Owned: Owned with a mortgage or loan or shared ownership,169,146,135,16,119,9,2,23,19,0,0,1,3
S01012169,Rented or living rent free: Total,120,43,36,13,23,0,7,77,41,0,5,28,3
S01012169,Rented or living rent free: Social rented,88,25,20,9,11,0,5,63,37,0,3,20,3
S01012169,Rented or living rent free: Private rented or living rent free,32,18,16,4,12,0,2,14,4,0,2,8,0
S01012170,All HRPs aged 16 and over,543,277,255,52,203,18,4,266,211,2,6,41,6
S01012170,Owned: Total,362,217,203,36,167,14,0,145,132,1,1,8,3
S01012170,Owned: Owned outright,171,56,51,15,36,5,0,115,110,0,0,3,2
S01012170,Owned: Owned with a mortgage or loan or shared ownership,191,161,152,21,131,9,0,30,22,1,1,5,1
S01012170,Rented or living rent free: Total,181,60,52,16,36,4,4,121,79,1,5,33,3
S01012170,Rented or living rent free: Social rented,144,40,34,10,24,3,3,104,68,0,2,32,2
S01012170,Rented or living rent free: Private rented or living rent free,37,20,18,6,12,1,1,17,11,1,3,1,1
S01012171,All HRPs aged 16 and over,470,272,260,51,209,8,4,198,154,4,9,26,5
S01012171,Owned: Total,346,225,219,38,181,6,0,121,107,2,2,8,2
S01012171,Owned: Owned outright,131,43,42,11,31,1,0,88,82,0,0,5,1
S01012171,Owned: Owned with a mortgage or loan or shared ownership,215,182,177,27,150,5,0,33,25,2,2,3,1
S01012171,Rented or living rent free: Total,124,47,41,13,28,2,4,77,47,2,7,18,3
S01012171,Rented or living rent free: Social rented,87,28,27,6,21,1,0,59,43,1,3,9,3
S01012171,Rented or living rent free: Private rented or living rent free,37,19,14,7,7,1,4,18,4,1,4,9,0
S01012172,All HRPs aged 16 and over,360,198,180,38,142,13,5,162,116,2,12,25,7
S01012172,Owned: Total,237,152,139,26,113,11,2,85,76,1,1,7,0
S01012172,Owned: Owned outright,107,38,34,12,22,4,0,69,64,0,1,4,0
S01012172,Owned: Owned with a mortgage or loan or shared ownership,130,114,105,14,91,7,2,16,12,1,0,3,0
S01012172,Rented or living rent free: Total,123,46,41,12,29,2,3,77,40,1,11,18,7
S01012172,Rented or living rent free: Social rented,79,19,17,5,12,0,2,60,37,0,4,13,6
S01012172,Rented or living rent free: Private rented or living rent free,44,27,24,7,17,2,1,17,3,1,7,5,1
S01012173,All HRPs aged 16 and over,289,152,134,25,109,17,1,137,126,0,1,4,6
S01012173,Owned: Total,279,144,127,23,104,16,1,135,125,0,1,3,6
S01012173,Owned: Owned outright,169,48,43,16,27,4,1,121,113,0,0,3,5
S01012173,Owned: Owned with a mortgage or loan or shared ownership,110,96,84,7,77,12,0,14,12,0,1,0,1
S01012173,Rented or living rent free: Total,10,8,7,2,5,1,0,2,1,0,0,1,0
S01012173,Rented or living rent free: Social rented,3,2,2,0,2,0,0,1,0,0,0,1,0
S01012173,Rented or living rent free: Private rented or living rent free,7,6,5,2,3,1,0,1,1,0,0,0,0
S01012174,All HRPs aged 16 and over,301,267,234,23,211,31,2,34,23,1,4,4,2
S01012174,Owned: Total,279,253,222,20,202,29,2,26,21,1,2,1,1
S01012174,Owned: Owned outright,64,45,37,4,33,7,1,19,16,0,2,1,0
S01012174,Owned: Owned with a mortgage or loan or shared ownership,215,208,185,16,169,22,1,7,5,1,0,0,1
S01012174,Rented or living rent free: Total,22,14,12,3,9,2,0,8,2,0,2,3,1
S01012174,Rented or living rent free: Social rented,7,3,3,0,3,0,0,4,2,0,0,1,1
S01012174,Rented or living rent free: Private rented or living rent free,15,11,9,3,6,2,0,4,0,0,2,2,0
S01012175,All HRPs aged 16 and over,385,295,267,37,230,16,12,90,71,4,2,8,5
S01012175,Owned: Total,348,269,249,33,216,14,6,79,68,2,2,5,2
S01012175,Owned: Owned outright,130,67,59,16,43,5,3,63,58,1,0,3,1
S01012175,Owned: Owned with a mortgage or loan or shared ownership,218,202,190,17,173,9,3,16,10,1,2,2,1
S01012175,Rented or living rent free: Total,37,26,18,4,14,2,6,11,3,2,0,3,3
S01012175,Rented or living rent free: Social rented,5,1,0,0,0,1,0,4,1,0,0,2,1
S01012175,Rented or living rent free: Private rented or living rent free,32,25,18,4,14,1,6,7,2,2,0,1,2
S01012176,All HRPs aged 16 and over,367,261,226,26,200,26,9,106,87,0,5,11,3
S01012176,Owned: Total,337,241,210,22,188,25,6,96,85,0,1,7,3
S01012176,Owned: Owned outright,134,62,52,10,42,9,1,72,68,0,1,1,2
S01012176,Owned: Owned with a mortgage or loan or shared ownership,203,179,158,12,146,16,5,24,17,0,0,6,1
S01012176,Rented or living rent free: Total,30,20,16,4,12,1,3,10,2,0,4,4,0
S01012176,Rented or living rent free: Social rented,3,1,0,0,0,0,1,2,0,0,0,2,0
S01012176,Rented or living rent free: Private rented or living rent free,27,19,16,4,12,1,2,8,2,0,4,2,0
S01012177,All HRPs aged 16 and over,242,170,140,26,114,26,4,72,61,1,4,4,2
S01012177,Owned: Total,223,157,129,21,108,25,3,66,58,1,3,3,1
S01012177,Owned: Owned outright,115,58,46,12,34,10,2,57,54,0,1,1,1
S01012177,Owned: Owned with a mortgage or loan or shared ownership,108,99,83,9,74,15,1,9,4,1,2,2,0
S01012177,Rented or living rent free: Total,19,13,11,5,6,1,1,6,3,0,1,1,1
S01012177,Rented or living rent free: Social rented,3,1,1,0,1,0,0,2,1,0,0,0,1
S01012177,Rented or living rent free: Private rented or living rent free,16,12,10,5,5,1,1,4,2,0,1,1,0
S01012178,All HRPs aged 16 and over,212,149,133,22,111,15,1,63,61,0,1,1,0
S01012178,Owned: Total,200,145,130,20,110,14,1,55,53,0,1,1,0
S01012178,Owned: Owned outright,107,59,53,14,39,5,1,48,46,0,1,1,0
S01012178,Owned: Owned with a mortgage or loan or shared ownership,93,86,77,6,71,9,0,7,7,0,0,0,0
S01012178,Rented or living rent free: Total,12,4,3,2,1,1,0,8,8,0,0,0,0
S01012178,Rented or living rent free: Social rented,3,1,1,1,0,0,0,2,2,0,0,0,0
S01012178,Rented or living rent free: Private rented or living rent free,9,3,2,1,1,1,0,6,6,0,0,0,0
S01012179,All HRPs aged 16 and over,301,147,123,27,96,15,9,154,126,2,9,15,2
S01012179,Owned: Total,199,118,101,18,83,13,4,81,74,2,1,3,1
S01012179,Owned: Owned outright,101,35,28,7,21,7,0,66,64,0,0,1,1
S01012179,Owned: Owned with a mortgage or loan or shared ownership,98,83,73,11,62,6,4,15,10,2,1,2,0
S01012179,Rented or living rent free: Total,102,29,22,9,13,2,5,73,52,0,8,12,1
S01012179,Rented or living rent free: Social rented,68,12,10,5,5,1,1,56,45,0,1,10,0
S01012179,Rented or living rent free: Private rented or living rent free,34,17,12,4,8,1,4,17,7,0,7,2,1
S01012180,All HRPs aged 16 and over,273,122,101,17,84,16,5,151,122,2,8,14,5
S01012180,Owned: Total,207,95,81,7,74,13,1,112,100,1,2,7,2
S01012180,Owned: Owned outright,120,27,26,4,22,1,0,93,89,0,1,1,2
S01012180,Owned: Owned with a mortgage or loan or shared ownership,87,68,55,3,52,12,1,19,11,1,1,6,0
S01012180,Rented or living rent free: Total,66,27,20,10,10,3,4,39,22,1,6,7,3
S01012180,Rented or living rent free: Social rented,49,18,16,10,6,1,1,31,18,1,3,7,2
S01012180,Rented or living rent free: Private rented or living rent free,17,9,4,0,4,2,3,8,4,0,3,0,1
S01012181,All HRPs aged 16 and over,384,202,166,23,143,23,13,182,139,1,8,28,6
S01012181,Owned: Total,266,158,136,16,120,19,3,108,98,1,2,2,5
S01012181,Owned: Owned outright,123,35,26,5,21,7,2,88,81,1,0,2,4
S01012181,Owned: Owned with a mortgage or loan or shared ownership,143,123,110,11,99,12,1,20,17,0,2,0,1
S01012181,Rented or living rent free: Total,118,44,30,7,23,4,10,74,41,0,6,26,1
S01012181,Rented or living rent free: Social rented,77,19,11,4,7,1,7,58,38,0,4,16,0
S01012181,Rented or living rent free: Private rented or living rent free,41,25,19,3,16,3,3,16,3,0,2,10,1
S01012182,All HRPs aged 16 and over,431,364,324,36,288,36,4,67,43,4,4,13,3
S01012182,Owned: Total,347,305,271,23,248,32,2,42,33,1,1,6,1
S01012182,Owned: Owned outright,70,39,32,6,26,6,1,31,28,1,1,1,0
S01012182,Owned: Owned with a mortgage or loan or shared ownership,277,266,239,17,222,26,1,11,5,0,0,5,1
S01012182,Rented or living rent free: Total,84,59,53,13,40,4,2,25,10,3,3,7,2
S01012182,Rented or living rent free: Social rented,21,8,7,5,2,0,1,13,7,0,2,4,0
S01012182,Rented or living rent free: Private rented or living rent free,63,51,46,8,38,4,1,12,3,3,1,3,2
S01012183,All HRPs aged 16 and over,408,259,213,32,181,22,24,149,80,3,14,40,12
S01012183,Owned: Total,243,171,146,16,130,18,7,72,59,2,3,4,4
S01012183,Owned: Owned outright,74,23,16,6,10,6,1,51,46,1,2,1,1
S01012183,Owned: Owned with a mortgage or loan or shared ownership,169,148,130,10,120,12,6,21,13,1,1,3,3
S01012183,Rented or living rent free: Total,165,88,67,16,51,4,17,77,21,1,11,36,8
S01012183,Rented or living rent free: Social rented,107,47,34,7,27,3,10,60,17,1,6,30,6
S01012183,Rented or living rent free: Private rented or living rent free,58,41,33,9,24,1,7,17,4,0,5,6,2
S01012184,All HRPs aged 16 and over,280,242,213,22,191,16,13,38,24,1,1,10,2
S01012184,Owned: Total,167,145,131,10,121,12,2,22,17,0,0,4,1
S01012184,Owned: Owned outright,26,8,6,1,5,1,1,18,16,0,0,2,0
S01012184,Owned: Owned with a mortgage or loan or shared ownership,141,137,125,9,116,11,1,4,1,0,0,2,1
S01012184,Rented or living rent free: Total,113,97,82,12,70,4,11,16,7,1,1,6,1
S01012184,Rented or living rent free: Social rented,7,6,5,0,5,0,1,1,0,0,0,1,0
S01012184,Rented or living rent free: Private rented or living rent free,106,91,77,12,65,4,10,15,7,1,1,5,1
S01012185,All HRPs aged 16 and over,506,343,266,37,229,19,58,163,39,14,21,77,12
S01012185,Owned: Total,197,149,128,11,117,11,10,48,18,13,2,13,2
S01012185,Owned: Owned outright,54,37,32,5,27,2,3,17,15,1,0,0,1
S01012185,Owned: Owned with a mortgage or loan or shared ownership,143,112,96,6,90,9,7,31,3,12,2,13,1
S01012185,Rented or living rent free: Total,309,194,138,26,112,8,48,115,21,1,19,64,10
S01012185,Rented or living rent free: Social rented,146,62,34,10,24,3,25,84,17,1,1,58,7
S01012185,Rented or living rent free: Private rented or living rent free,163,132,104,16,88,5,23,31,4,0,18,6,3
S01012186,All HRPs aged 16 and over,344,179,146,27,119,16,17,165,129,4,8,19,5
S01012186,Owned: Total,230,134,113,17,96,14,7,96,85,0,4,6,1
S01012186,Owned: Owned outright,111,35,30,9,21,2,3,76,70,0,3,3,0
S01012186,Owned: Owned with a mortgage or loan or shared ownership,119,99,83,8,75,12,4,20,15,0,1,3,1
S01012186,Rented or living rent free: Total,114,45,33,10,23,2,10,69,44,4,4,13,4
S01012186,Rented or living rent free: Social rented,90,33,22,7,15,2,9,57,41,1,1,10,4
S01012186,Rented or living rent free: Private rented or living rent free,24,12,11,3,8,0,1,12,3,3,3,3,0
S01012187,All HRPs aged 16 and over,382,216,182,51,131,8,26,166,116,5,1,37,7
S01012187,Owned: Total,192,124,111,21,90,7,6,68,56,4,0,7,1
S01012187,Owned: Owned outright,81,32,30,8,22,1,1,49,42,1,0,5,1
S01012187,Owned: Owned with a mortgage or loan or shared ownership,111,92,81,13,68,6,5,19,14,3,0,2,0
S01012187,Rented or living rent free: Total,190,92,71,30,41,1,20,98,60,1,1,30,6
S01012187,Rented or living rent free: Social rented,135,51,42,16,26,0,9,84,54,0,1,25,4
S01012187,Rented or living rent free: Private rented or living rent free,55,41,29,14,15,1,11,14,6,1,0,5,2
S01012188,All HRPs aged 16 and over,252,155,136,24,112,15,4,97,84,4,0,6,3
S01012188,Owned: Total,208,135,121,22,99,13,1,73,69,1,0,2,1
S01012188,Owned: Owned outright,118,49,40,15,25,8,1,69,65,1,0,2,1
S01012188,Owned: Owned with a mortgage or loan or shared ownership,90,86,81,7,74,5,0,4,4,0,0,0,0
S01012188,Rented or living rent free: Total,44,20,15,2,13,2,3,24,15,3,0,4,2
S01012188,Rented or living rent free: Social rented,30,10,7,0,7,1,2,20,12,2,0,4,2
S01012188,Rented or living rent free: Private rented or living rent free,14,10,8,2,6,1,1,4,3,1,0,0,0
S01012189,All HRPs aged 16 and over,245,165,145,16,129,13,7,80,64,0,1,13,2
S01012189,Owned: Total,203,149,134,13,121,11,4,54,49,0,0,4,1
S01012189,Owned: Owned outright,70,28,24,4,20,3,1,42,37,0,0,4,1
S01012189,Owned: Owned with a mortgage or loan or shared ownership,133,121,110,9,101,8,3,12,12,0,0,0,0
S01012189,Rented or living rent free: Total,42,16,11,3,8,2,3,26,15,0,1,9,1
S01012189,Rented or living rent free: Social rented,28,7,4,1,3,1,2,21,13,0,1,6,1
S01012189,Rented or living rent free: Private rented or living rent free,14,9,7,2,5,1,1,5,2,0,0,3,0
S01012190,All HRPs aged 16 and over,210,180,161,14,147,18,1,30,25,2,0,2,1
S01012190,Owned: Total,193,167,150,11,139,17,0,26,24,2,0,0,0
S01012190,Owned: Owned outright,40,22,20,5,15,2,0,18,18,0,0,0,0
S01012190,Owned: Owned with a mortgage or loan or shared ownership,153,145,130,6,124,15,0,8,6,2,0,0,0
S01012190,Rented or living rent free: Total,17,13,11,3,8,1,1,4,1,0,0,2,1
S01012190,Rented or living rent free: Social rented,3,2,2,0,2,0,0,1,0,0,0,0,1
S01012190,Rented or living rent free: Private rented or living rent free,14,11,9,3,6,1,1,3,1,0,0,2,0
S01012191,All HRPs aged 16 and over,322,238,209,16,193,26,3,84,74,1,3,4,2
S01012191,Owned: Total,302,222,198,14,184,22,2,80,73,0,2,3,2
S01012191,Owned: Owned outright,112,47,40,7,33,5,2,65,62,0,1,0,2
S01012191,Owned: Owned with a mortgage or loan or shared ownership,190,175,158,7,151,17,0,15,11,0,1,3,0
S01012191,Rented or living rent free: Total,20,16,11,2,9,4,1,4,1,1,1,1,0
S01012191,Rented or living rent free: Social rented,7,3,2,0,2,0,1,4,1,1,1,1,0
S01012191,Rented or living rent free: Private rented or living rent free,13,13,9,2,7,4,0,0,0,0,0,0,0
S01012192,All HRPs aged 16 and over,187,129,102,9,93,23,4,58,57,0,1,0,0
S01012192,Owned: Total,176,122,96,7,89,22,4,54,54,0,0,0,0
S01012192,Owned: Owned outright,80,30,22,3,19,7,1,50,50,0,0,0,0
S01012192,Owned: Owned with a mortgage or loan or shared ownership,96,92,74,4,70,15,3,4,4,0,0,0,0
S01012192,Rented or living rent free: Total,11,7,6,2,4,1,0,4,3,0,1,0,0
S01012192,Rented or living rent free: Social rented,6,3,3,2,1,0,0,3,2,0,1,0,0
S01012192,Rented or living rent free: Private rented or living rent free,5,4,3,0,3,1,0,1,1,0,0,0,0
S01012193,All HRPs aged 16 and over,175,163,141,6,135,22,0,12,11,0,1,0,0
S01012193,Owned: Total,171,159,138,6,132,21,0,12,11,0,1,0,0
S01012193,Owned: Owned outright,31,22,20,3,17,2,0,9,8,0,1,0,0
S01012193,Owned: Owned with a mortgage or loan or shared ownership,140,137,118,3,115,19,0,3,3,0,0,0,0
S01012193,Rented or living rent free: Total,4,4,3,0,3,1,0,0,0,0,0,0,0
S01012193,Rented or living rent free: Social rented,3,3,2,0,2,1,0,0,0,0,0,0,0
S01012193,Rented or living rent free: Private rented or living rent free,1,1,1,0,1,0,0,0,0,0,0,0,0
S01012194,All HRPs aged 16 and over,179,163,147,13,134,11,5,16,13,0,1,2,0
S01012194,Owned: Total,175,161,145,12,133,11,5,14,13,0,1,0,0
S01012194,Owned: Owned outright,34,21,17,1,16,2,2,13,12,0,1,0,0
S01012194,Owned: Owned with a mortgage or loan or shared ownership,141,140,128,11,117,9,3,1,1,0,0,0,0
S01012194,Rented or living rent free: Total,4,2,2,1,1,0,0,2,0,0,0,2,0
S01012194,Rented or living rent free: Social rented,3,1,1,1,0,0,0,2,0,0,0,2,0
S01012194,Rented or living rent free: Private rented or living rent free,1,1,1,0,1,0,0,0,0,0,0,0,0
S01012195,All HRPs aged 16 and over,423,310,277,25,252,25,8,113,101,0,3,9,0
S01012195,Owned: Total,380,291,262,19,243,25,4,89,85,0,0,4,0
S01012195,Owned: Owned outright,112,42,38,3,35,3,1,70,67,0,0,3,0
S01012195,Owned: Owned with a mortgage or loan or shared ownership,268,249,224,16,208,22,3,19,18,0,0,1,0
S01012195,Rented or living rent free: Total,43,19,15,6,9,0,4,24,16,0,3,5,0
S01012195,Rented or living rent free: Social rented,33,13,9,5,4,0,4,20,14,0,2,4,0
S01012195,Rented or living rent free: Private rented or living rent free,10,6,6,1,5,0,0,4,2,0,1,1,0
S01012196,All HRPs aged 16 and over,211,177,154,16,138,21,2,34,22,0,3,7,2
S01012196,Owned: Total,187,161,140,13,127,21,0,26,19,0,1,4,2
S01012196,Owned: Owned outright,40,25,19,4,15,6,0,15,14,0,1,0,0
S01012196,Owned: Owned with a mortgage or loan or shared ownership,147,136,121,9,112,15,0,11,5,0,0,4,2
S01012196,Rented or living rent free: Total,24,16,14,3,11,0,2,8,3,0,2,3,0
S01012196,Rented or living rent free: Social rented,10,5,4,1,3,0,1,5,3,0,1,1,0
S01012196,Rented or living rent free: Private rented or living rent free,14,11,10,2,8,0,1,3,0,0,1,2,0
S01012197,All HRPs aged 16 and over,311,177,156,29,127,14,7,134,105,1,4,22,2
S01012197,Owned: Total,216,144,127,21,106,14,3,72,63,0,3,6,0
S01012197,Owned: Owned outright,65,21,19,6,13,2,0,44,41,0,1,2,0
S01012197,Owned: Owned with a mortgage or loan or shared ownership,151,123,108,15,93,12,3,28,22,0,2,4,0
S01012197,Rented or living rent free: Total,95,33,29,8,21,0,4,62,42,1,1,16,2
S01012197,Rented or living rent free: Social rented,85,26,24,6,18,0,2,59,41,1,1,14,2
S01012197,Rented or living rent free: Private rented or living rent free,10,7,5,2,3,0,2,3,1,0,0,2,0
S01012198,All HRPs aged 16 and over,403,253,229,33,196,21,3,150,101,10,0,37,2
S01012198,Owned: Total,263,202,185,19,166,16,1,61,56,3,0,2,0
S01012198,Owned: Owned outright,80,36,32,7,25,3,1,44,44,0,0,0,0
S01012198,Owned: Owned with a mortgage or loan or shared ownership,183,166,153,12,141,13,0,17,12,3,0,2,0
S01012198,Rented or living rent free: Total,140,51,44,14,30,5,2,89,45,7,0,35,2
S01012198,Rented or living rent free: Social rented,123,38,32,11,21,4,2,85,43,7,0,33,2
S01012198,Rented or living rent free: Private rented or living rent free,17,13,12,3,9,1,0,4,2,0,0,2,0
S01012199,All HRPs aged 16 and over,309,197,178,32,146,11,8,112,89,2,6,13,2
S01012199,Owned: Total,228,156,145,23,122,9,2,72,64,2,1,5,0
S01012199,Owned: Owned outright,85,33,29,10,19,3,1,52,46,2,0,4,0
S01012199,Owned: Owned with a mortgage or loan or shared ownership,143,123,116,13,103,6,1,20,18,0,1,1,0
S01012199,Rented or living rent free: Total,81,41,33,9,24,2,6,40,25,0,5,8,2
S01012199,Rented or living rent free: Social rented,54,23,18,3,15,2,3,31,20,0,1,8,2
S01012199,Rented or living rent free: Private rented or living rent free,27,18,15,6,9,0,3,9,5,0,4,0,0
S01012200,All HRPs aged 16 and over,278,168,144,33,111,16,8,110,81,1,7,19,2
S01012200,Owned: Total,206,142,126,21,105,12,4,64,56,0,1,5,2
S01012200,Owned: Owned outright,72,30,25,7,18,3,2,42,38,0,0,2,2
S01012200,Owned: Owned with a mortgage or loan or shared ownership,134,112,101,14,87,9,2,22,18,0,1,3,0
S01012200,Rented or living rent free: Total,72,26,18,12,6,4,4,46,25,1,6,14,0
S01012200,Rented or living rent free: Social rented,55,16,12,8,4,2,2,39,22,1,3,13,0
S01012200,Rented or living rent free: Private rented or living rent free,17,10,6,4,2,2,2,7,3,0,3,1,0
S01012201,All HRPs aged 16 and over,318,203,184,23,161,15,4,115,94,2,1,14,4
S01012201,Owned: Total,234,159,146,10,136,11,2,75,70,1,0,2,2
S01012201,Owned: Owned outright,79,22,19,1,18,3,0,57,54,1,0,0,2
S01012201,Owned: Owned with a mortgage or loan or shared ownership,155,137,127,9,118,8,2,18,16,0,0,2,0
S01012201,Rented or living rent free: Total,84,44,38,13,25,4,2,40,24,1,1,12,2
S01012201,Rented or living rent free: Social rented,67,31,26,8,18,3,2,36,21,1,1,12,1
S01012201,Rented or living rent free: Private rented or living rent free,17,13,12,5,7,1,0,4,3,0,0,0,1
S01012202,All HRPs aged 16 and over,239,156,144,21,123,11,1,83,65,6,4,7,1
S01012202,Owned: Total,198,138,130,18,112,8,0,60,55,0,0,5,0
S01012202,Owned: Owned outright,68,24,22,9,13,2,0,44,42,0,0,2,0
S01012202,Owned: Owned with a mortgage or loan or shared ownership,130,114,108,9,99,6,0,16,13,0,0,3,0
S01012202,Rented or living rent free: Total,41,18,14,3,11,3,1,23,10,6,4,2,1
S01012202,Rented or living rent free: Social rented,25,8,5,2,3,3,0,17,9,2,3,2,1
S01012202,Rented or living rent free: Private rented or living rent free,16,10,9,1,8,0,1,6,1,4,1,0,0
S01012203,All HRPs aged 16 and over,316,212,180,20,160,28,4,104,96,1,3,3,1
S01012203,Owned: Total,307,208,178,19,159,28,2,99,94,0,3,2,0
S01012203,Owned: Owned outright,124,50,44,10,34,6,0,74,71,0,2,1,0
S01012203,Owned: Owned with a mortgage or loan or shared ownership,183,158,134,9,125,22,2,25,23,0,1,1,0
S01012203,Rented or living rent free: Total,9,4,2,1,1,0,2,5,2,1,0,1,1
S01012203,Rented or living rent free: Social rented,4,0,0,0,0,0,0,4,2,1,0,1,0
S01012203,Rented or living rent free: Private rented or living rent free,5,4,2,1,1,0,2,1,0,0,0,0,1
S01012204,All HRPs aged 16 and over,270,228,204,11,193,20,4,42,37,2,0,3,0
S01012204,Owned: Total,262,221,197,10,187,20,4,41,37,1,0,3,0
S01012204,Owned: Owned outright,100,63,52,7,45,9,2,37,33,1,0,3,0
S01012204,Owned: Owned with a mortgage or loan or shared ownership,162,158,145,3,142,11,2,4,4,0,0,0,0
S01012204,Rented or living rent free: Total,8,7,7,1,6,0,0,1,0,1,0,0,0
S01012204,Rented or living rent free: Social rented,1,1,1,0,1,0,0,0,0,0,0,0,0
S01012204,Rented or living rent free: Private rented or living rent free,7,6,6,1,5,0,0,1,0,1,0,0,0
S01012205,All HRPs aged 16 and over,273,212,176,18,158,33,3,61,55,0,1,5,0
S01012205,Owned: Total,254,200,166,16,150,32,2,54,49,0,0,5,0
S01012205,Owned: Owned outright,92,54,46,5,41,8,0,38,37,0,0,1,0
S01012205,Owned: Owned with a mortgage or loan or shared ownership,162,146,120,11,109,24,2,16,12,0,0,4,0
S01012205,Rented or living rent free: Total,19,12,10,2,8,1,1,7,6,0,1,0,0
S01012205,Rented or living rent free: Social rented,4,1,1,1,0,0,0,3,3,0,0,0,0
S01012205,Rented or living rent free: Private rented or living rent free,15,11,9,1,8,1,1,4,3,0,1,0,0
S01012206,All HRPs aged 16 and over,317,248,218,33,185,28,2,69,59,1,2,6,1
S01012206,Owned: Total,280,221,194,22,172,25,2,59,54,0,1,3,1
S01012206,Owned: Owned outright,96,47,43,9,34,4,0,49,44,0,1,3,1
S01012206,Owned: Owned with a mortgage or loan or shared ownership,184,174,151,13,138,21,2,10,10,0,0,0,0
S01012206,Rented or living rent free: Total,37,27,24,11,13,3,0,10,5,1,1,3,0
S01012206,Rented or living rent free: Social rented,25,16,14,7,7,2,0,9,5,1,0,3,0
S01012206,Rented or living rent free: Private rented or living rent free,12,11,10,4,6,1,0,1,0,0,1,0,0
S01012207,All HRPs aged 16 and over,401,224,194,31,163,24,6,177,135,7,10,17,8
S01012207,Owned: Total,293,174,153,18,135,19,2,119,107,0,2,6,4
S01012207,Owned: Owned outright,116,31,28,4,24,3,0,85,80,0,1,1,3
S01012207,Owned: Owned with a mortgage or loan or shared ownership,177,143,125,14,111,16,2,34,27,0,1,5,1
S01012207,Rented or living rent free: Total,108,50,41,13,28,5,4,58,28,7,8,11,4
S01012207,Rented or living rent free: Social rented,77,32,26,9,17,2,4,45,26,4,4,9,2
S01012207,Rented or living rent free: Private rented or living rent free,31,18,15,4,11,3,0,13,2,3,4,2,2
S01012208,All HRPs aged 16 and over,457,270,228,38,190,27,15,187,143,5,8,21,10
S01012208,Owned: Total,330,200,173,20,153,22,5,130,114,3,1,9,3
S01012208,Owned: Owned outright,134,44,35,10,25,4,5,90,83,0,0,5,2
S01012208,Owned: Owned with a mortgage or loan or shared ownership,196,156,138,10,128,18,0,40,31,3,1,4,1
S01012208,Rented or living rent free: Total,127,70,55,18,37,5,10,57,29,2,7,12,7
S01012208,Rented or living rent free: Social rented,95,47,40,17,23,1,6,48,26,2,2,12,6
S01012208,Rented or living rent free: Private rented or living rent free,32,23,15,1,14,4,4,9,3,0,5,0,1
S01012209,All HRPs aged 16 and over,318,192,162,24,138,19,11,126,99,4,7,15,1
S01012209,Owned: Total,217,142,122,11,111,14,6,75,66,2,2,5,0
S01012209,Owned: Owned outright,78,26,21,4,17,2,3,52,49,1,0,2,0
S01012209,Owned: Owned with a mortgage or loan or shared ownership,139,116,101,7,94,12,3,23,17,1,2,3,0
S01012209,Rented or living rent free: Total,101,50,40,13,27,5,5,51,33,2,5,10,1
S01012209,Rented or living rent free: Social rented,73,28,21,8,13,4,3,45,30,2,4,8,1
S01012209,Rented or living rent free: Private rented or living rent free,28,22,19,5,14,1,2,6,3,0,1,2,0
S01012210,All HRPs aged 16 and over,385,184,161,33,128,13,10,201,162,5,2,26,6
S01012210,Owned: Total,232,133,117,18,99,11,5,99,90,2,0,6,1
S01012210,Owned: Owned outright,97,26,23,8,15,0,3,71,68,1,0,2,0
S01012210,Owned: Owned with a mortgage or loan or shared ownership,135,107,94,10,84,11,2,28,22,1,0,4,1
S01012210,Rented or living rent free: Total,153,51,44,15,29,2,5,102,72,3,2,20,5
S01012210,Rented or living rent free: Social rented,129,32,26,7,19,2,4,97,70,1,1,20,5
S01012210,Rented or living rent free: Private rented or living rent free,24,19,18,8,10,0,1,5,2,2,1,0,0
S01012211,All HRPs aged 16 and over,408,258,210,29,181,30,18,150,122,1,9,15,3
S01012211,Owned: Total,305,210,178,17,161,28,4,95,86,0,4,4,1
S01012211,Owned: Owned outright,124,43,36,7,29,5,2,81,74,0,3,3,1
S01012211,Owned: Owned with a mortgage or loan or shared ownership,181,167,142,10,132,23,2,14,12,0,1,1,0
S01012211,Rented or living rent free: Total,103,48,32,12,20,2,14,55,36,1,5,11,2
S01012211,Rented or living rent free: Social rented,75,27,19,9,10,1,7,48,32,1,5,9,1
S01012211,Rented or living rent free: Private rented or living rent free,28,21,13,3,10,1,7,7,4,0,0,2,1
S01012212,All HRPs aged 16 and over,304,190,174,21,153,12,4,114,103,0,2,7,2
S01012212,Owned: Total,291,183,169,19,150,11,3,108,102,0,2,3,1
S01012212,Owned: Owned outright,163,62,54,12,42,6,2,101,96,0,2,2,1
S01012212,Owned: Owned with a mortgage or loan or shared ownership,128,121,115,7,108,5,1,7,6,0,0,1,0
S01012212,Rented or living rent free: Total,13,7,5,2,3,1,1,6,1,0,0,4,1
S01012212,Rented or living rent free: Social rented,8,4,3,2,1,0,1,4,0,0,0,3,1
S01012212,Rented or living rent free: Private rented or living rent free,5,3,2,0,2,1,0,2,1,0,0,1,0
S01012213,All HRPs aged 16 and over,336,227,195,26,169,26,6,109,106,0,1,2,0
S01012213,Owned: Total,326,217,190,26,164,22,5,109,106,0,1,2,0
S01012213,Owned: Owned outright,177,81,67,15,52,10,4,96,94,0,1,1,0
S01012213,Owned: Owned with a mortgage or loan or shared ownership,149,136,123,11,112,12,1,13,12,0,0,1,0
S01012213,Rented or living rent free: Total,10,10,5,0,5,4,1,0,0,0,0,0,0
S01012213,Rented or living rent free: Social rented,2,2,0,0,0,2,0,0,0,0,0,0,0
S01012213,Rented or living rent free: Private rented or living rent free,8,8,5,0,5,2,1,0,0,0,0,0,0
S01012214,All HRPs aged 16 and over,282,168,127,17,110,38,3,114,105,2,2,5,0
S01012214,Owned: Total,271,162,125,17,108,36,1,109,102,2,0,5,0
S01012214,Owned: Owned outright,159,59,44,11,33,15,0,100,97,2,0,1,0
S01012214,Owned: Owned with a mortgage or loan or shared ownership,112,103,81,6,75,21,1,9,5,0,0,4,0
S01012214,Rented or living rent free: Total,11,6,2,0,2,2,2,5,3,0,2,0,0
S01012214,Rented or living rent free: Social rented,1,1,0,0,0,0,1,0,0,0,0,0,0
S01012214,Rented or living rent free: Private rented or living rent free,10,5,2,0,2,2,1,5,3,0,2,0,0
S01012215,All HRPs aged 16 and over,329,248,218,26,192,25,5,81,76,1,2,1,1
S01012215,Owned: Total,314,237,209,24,185,24,4,77,74,0,1,1,1
S01012215,Owned: Owned outright,143,70,63,15,48,6,1,73,71,0,1,0,1
S01012215,Owned: Owned with a mortgage or loan or shared ownership,171,167,146,9,137,18,3,4,3,0,0,1,0
S01012215,Rented or living rent free: Total,15,11,9,2,7,1,1,4,2,1,1,0,0
S01012215,Rented or living rent free: Social rented,6,4,3,1,2,1,0,2,0,1,1,0,0
S01012215,Rented or living rent free: Private rented or living rent free,9,7,6,1,5,0,1,2,2,0,0,0,0
S01012216,All HRPs aged 16 and over,282,197,164,20,144,29,4,85,78,1,0,5,1
S01012216,Owned: Total,258,181,153,18,135,25,3,77,74,0,0,3,0
S01012216,Owned: Owned outright,127,57,48,11,37,8,1,70,69,0,0,1,0
S01012216,Owned: Owned with a mortgage or loan or shared ownership,131,124,105,7,98,17,2,7,5,0,0,2,0
S01012216,Rented or living rent free: Total,24,16,11,2,9,4,1,8,4,1,0,2,1
S01012216,Rented or living rent free: Social rented,11,7,5,2,3,1,1,4,2,0,0,1,1
S01012216,Rented or living rent free: Private rented or living rent free,13,9,6,0,6,3,0,4,2,1,0,1,0
S01012217,All HRPs aged 16 and over,267,157,126,31,95,8,23,110,45,9,14,38,4
S01012217,Owned: Total,109,72,62,7,55,6,4,37,32,1,0,4,0
S01012217,Owned: Owned outright,36,13,10,3,7,1,2,23,23,0,0,0,0
S01012217,Owned: Owned with a mortgage or loan or shared ownership,73,59,52,4,48,5,2,14,9,1,0,4,0
S01012217,Rented or living rent free: Total,158,85,64,24,40,2,19,73,13,8,14,34,4
S01012217,Rented or living rent free: Social rented,131,73,52,17,35,2,19,58,12,5,10,28,3
S01012217,Rented or living rent free: Private rented or living rent free,27,12,12,7,5,0,0,15,1,3,4,6,1
S01012218,All HRPs aged 16 and over,228,150,105,31,74,6,39,78,35,5,7,28,3
S01012218,Owned: Total,74,52,47,12,35,1,4,22,21,1,0,0,0
S01012218,Owned: Owned outright,24,9,8,5,3,1,0,15,14,1,0,0,0
S01012218,Owned: Owned with a mortgage or loan or shared ownership,50,43,39,7,32,0,4,7,7,0,0,0,0
S01012218,Rented or living rent free: Total,154,98,58,19,39,5,35,56,14,4,7,28,3
S01012218,Rented or living rent free: Social rented,137,93,55,17,38,4,34,44,13,3,7,20,1
S01012218,Rented or living rent free: Private rented or living rent free,17,5,3,2,1,1,1,12,1,1,0,8,2
S01012219,All HRPs aged 16 and over,415,181,158,32,126,12,11,234,155,8,10,51,10
S01012219,Owned: Total,225,116,103,11,92,10,3,109,101,3,0,4,1
S01012219,Owned: Owned outright,97,21,19,3,16,0,2,76,72,1,0,2,1
S01012219,Owned: Owned with a mortgage or loan or shared ownership,128,95,84,8,76,10,1,33,29,2,0,2,0
S01012219,Rented or living rent free: Total,190,65,55,21,34,2,8,125,54,5,10,47,9
S01012219,Rented or living rent free: Social rented,160,52,44,18,26,1,7,108,46,2,8,45,7
S01012219,Rented or living rent free: Private rented or living rent free,30,13,11,3,8,1,1,17,8,3,2,2,2
S01012220,All HRPs aged 16 and over,367,173,135,26,109,14,24,194,113,3,17,53,8
S01012220,Owned: Total,111,68,58,9,49,6,4,43,38,0,0,3,2
S01012220,Owned: Owned outright,42,15,13,3,10,2,0,27,24,0,0,1,2
S01012220,Owned: Owned with a mortgage or loan or shared ownership,69,53,45,6,39,4,4,16,14,0,0,2,0
S01012220,Rented or living rent free: Total,256,105,77,17,60,8,20,151,75,3,17,50,6
S01012220,Rented or living rent free: Social rented,208,93,67,13,54,7,19,115,64,1,6,39,5
S01012220,Rented or living rent free: Private rented or living rent free,48,12,10,4,6,1,1,36,11,2,11,11,1
S01012221,All HRPs aged 16 and over,332,160,134,25,109,14,12,172,142,2,5,20,3
S01012221,Owned: Total,197,106,90,13,77,12,4,91,82,1,3,5,0
S01012221,Owned: Owned outright,75,16,13,3,10,3,0,59,56,0,1,2,0
S01012221,Owned: Owned with a mortgage or loan or shared ownership,122,90,77,10,67,9,4,32,26,1,2,3,0
S01012221,Rented or living rent free: Total,135,54,44,12,32,2,8,81,60,1,2,15,3
S01012221,Rented or living rent free: Social rented,104,34,28,10,18,1,5,70,53,0,1,14,2
S01012221,Rented or living rent free: Private rented or living rent free,31,20,16,2,14,1,3,11,7,1,1,1,1
S01012222,All HRPs aged 16 and over,402,217,196,33,163,12,9,185,137,2,7,33,6
S01012222,Owned: Total,250,153,144,20,124,8,1,97,94,0,0,3,0
S01012222,Owned: Owned outright,95,28,24,9,15,3,1,67,64,0,0,3,0
S01012222,Owned: Owned with a mortgage or loan or shared ownership,155,125,120,11,109,5,0,30,30,0,0,0,0
S01012222,Rented or living rent free: Total,152,64,52,13,39,4,8,88,43,2,7,30,6
S01012222,Rented or living rent free: Social rented,112,47,38,9,29,2,7,65,36,0,2,23,4
S01012222,Rented or living rent free: Private rented or living rent free,40,17,14,4,10,2,1,23,7,2,5,7,2
S01012223,All HRPs aged 16 and over,360,182,151,34,117,12,19,178,126,7,9,33,3
S01012223,Owned: Total,173,103,95,16,79,7,1,70,66,1,0,3,0
S01012223,Owned: Owned outright,63,11,11,4,7,0,0,52,51,0,0,1,0
S01012223,Owned: Owned with a mortgage or loan or shared ownership,110,92,84,12,72,7,1,18,15,1,0,2,0
S01012223,Rented or living rent free: Total,187,79,56,18,38,5,18,108,60,6,9,30,3
S01012223,Rented or living rent free: Social rented,169,70,52,16,36,5,13,99,57,6,5,29,2
S01012223,Rented or living rent free: Private rented or living rent free,18,9,4,2,2,0,5,9,3,0,4,1,1
S01012224,All HRPs aged 16 and over,333,213,189,29,160,16,8,120,76,4,16,20,4
S01012224,Owned: Total,230,162,142,14,128,15,5,68,58,3,1,4,2
S01012224,Owned: Owned outright,73,20,17,6,11,1,2,53,50,0,1,1,1
S01012224,Owned: Owned with a mortgage or loan or shared ownership,157,142,125,8,117,14,3,15,8,3,0,3,1
S01012224,Rented or living rent free: Total,103,51,47,15,32,1,3,52,18,1,15,16,2
S01012224,Rented or living rent free: Social rented,82,38,34,11,23,1,3,44,17,1,9,16,1
S01012224,Rented or living rent free: Private rented or living rent free,21,13,13,4,9,0,0,8,1,0,6,0,1
S01012225,All HRPs aged 16 and over,459,272,234,53,181,18,20,187,115,5,21,42,4
S01012225,Owned: Total,259,166,148,22,126,12,6,93,86,3,0,4,0
S01012225,Owned: Owned outright,95,27,26,7,19,1,0,68,63,2,0,3,0
S01012225,Owned: Owned with a mortgage or loan or shared ownership,164,139,122,15,107,11,6,25,23,1,0,1,0
S01012225,Rented or living rent free: Total,200,106,86,31,55,6,14,94,29,2,21,38,4
S01012225,Rented or living rent free: Social rented,157,81,67,22,45,5,9,76,24,2,13,34,3
S01012225,Rented or living rent free: Private rented or living rent free,43,25,19,9,10,1,5,18,5,0,8,4,1
S01012226,All HRPs aged 16 and over,287,192,167,26,141,18,7,95,85,0,1,7,2
S01012226,Owned: Total,246,163,146,23,123,13,4,83,77,0,0,4,2
S01012226,Owned: Owned outright,90,29,23,3,20,3,3,61,57,0,0,2,2
S01012226,Owned: Owned with a mortgage or loan or shared ownership,156,134,123,20,103,10,1,22,20,0,0,2,0
S01012226,Rented or living rent free: Total,41,29,21,3,18,5,3,12,8,0,1,3,0
S01012226,Rented or living rent free: Social rented,29,19,13,0,13,3,3,10,7,0,0,3,0
S01012226,Rented or living rent free: Private rented or living rent free,12,10,8,3,5,2,0,2,1,0,1,0,0
S01012227,All HRPs aged 16 and over,260,174,159,32,127,6,9,86,64,0,12,7,3
S01012227,Owned: Total,214,152,141,25,116,5,6,62,57,0,1,2,2
S01012227,Owned: Owned outright,73,30,27,10,17,0,3,43,41,0,1,0,1
S01012227,Owned: Owned with a mortgage or loan or shared ownership,141,122,114,15,99,5,3,19,16,0,0,2,1
S01012227,Rented or living rent free: Total,46,22,18,7,11,1,3,24,7,0,11,5,1
S01012227,Rented or living rent free: Social rented,29,14,10,5,5,1,3,15,7,0,4,4,0
S01012227,Rented or living rent free: Private rented or living rent free,17,8,8,2,6,0,0,9,0,0,7,1,1
S01012228,All HRPs aged 16 and over,252,169,156,23,133,10,3,83,65,3,3,9,3
S01012228,Owned: Total,208,143,133,12,121,9,1,65,56,1,1,6,1
S01012228,Owned: Owned outright,66,24,22,2,20,1,1,42,40,0,0,1,1
S01012228,Owned: Owned with a mortgage or loan or shared ownership,142,119,111,10,101,8,0,23,16,1,1,5,0
S01012228,Rented or living rent free: Total,44,26,23,11,12,1,2,18,9,2,2,3,2
S01012228,Rented or living rent free: Social rented,28,15,13,6,7,1,1,13,8,0,2,2,1
S01012228,Rented or living rent free: Private rented or living rent free,16,11,10,5,5,0,1,5,1,2,0,1,1
S01012229,All HRPs aged 16 and over,323,247,208,22,186,26,13,76,60,1,1,10,4
S01012229,Owned: Total,278,214,185,19,166,22,7,64,56,0,1,4,3
S01012229,Owned: Owned outright,92,44,38,9,29,4,2,48,45,0,0,2,1
S01012229,Owned: Owned with a mortgage or loan or shared ownership,186,170,147,10,137,18,5,16,11,0,1,2,2
S01012229,Rented or living rent free: Total,45,33,23,3,20,4,6,12,4,1,0,6,1
S01012229,Rented or living rent free: Social rented,4,1,0,0,0,0,1,3,1,0,0,2,0
S01012229,Rented or living rent free: Private rented or living rent free,41,32,23,3,20,4,5,9,3,1,0,4,1
S01012230,All HRPs aged 16 and over,392,292,258,29,229,31,3,100,90,3,1,2,4
S01012230,Owned: Total,366,274,245,27,218,27,2,92,87,1,0,2,2
S01012230,Owned: Owned outright,129,53,46,8,38,6,1,76,76,0,0,0,0
S01012230,Owned: Owned with a mortgage or loan or shared ownership,237,221,199,19,180,21,1,16,11,1,0,2,2
S01012230,Rented or living rent free: Total,26,18,13,2,11,4,1,8,3,2,1,0,2
S01012230,Rented or living rent free: Social rented,1,1,1,1,0,0,0,0,0,0,0,0,0
S01012230,Rented or living rent free: Private rented or living rent free,25,17,12,1,11,4,1,8,3,2,1,0,2
S01012231,All HRPs aged 16 and over,289,223,186,14,172,35,2,66,60,2,2,2,0
S01012231,Owned: Total,277,215,178,13,165,35,2,62,58,0,2,2,0
S01012231,Owned: Owned outright,123,67,55,10,45,11,1,56,53,0,1,2,0
S01012231,Owned: Owned with a mortgage or loan or shared ownership,154,148,123,3,120,24,1,6,5,0,1,0,0
S01012231,Rented or living rent free: Total,12,8,8,1,7,0,0,4,2,2,0,0,0
S01012231,Rented or living rent free: Social rented,3,1,1,0,1,0,0,2,1,1,0,0,0
S01012231,Rented or living rent free: Private rented or living rent free,9,7,7,1,6,0,0,2,1,1,0,0,0
S01012232,All HRPs aged 16 and over,318,244,213,22,191,27,4,74,67,0,0,4,3
S01012232,Owned: Total,308,235,204,19,185,27,4,73,66,0,0,4,3
S01012232,Owned: Owned outright,118,60,49,9,40,9,2,58,53,0,0,3,2
S01012232,Owned: Owned with a mortgage or loan or shared ownership,190,175,155,10,145,18,2,15,13,0,0,1,1
S01012232,Rented or living rent free: Total,10,9,9,3,6,0,0,1,1,0,0,0,0
S01012232,Rented or living rent free: Social rented,1,1,1,0,1,0,0,0,0,0,0,0,0
S01012232,Rented or living rent free: Private rented or living rent free,9,8,8,3,5,0,0,1,1,0,0,0,0
S01012233,All HRPs aged 16 and over,341,247,207,28,179,36,4,94,83,4,4,3,0
S01012233,Owned: Total,325,239,199,25,174,36,4,86,82,1,2,1,0
S01012233,Owned: Owned outright,144,65,58,11,47,5,2,79,77,0,2,0,0
S01012233,Owned: Owned with a mortgage or loan or shared ownership,181,174,141,14,127,31,2,7,5,1,0,1,0
S01012233,Rented or living rent free: Total,16,8,8,3,5,0,0,8,1,3,2,2,0
S01012233,Rented or living rent free: Social rented,2,0,0,0,0,0,0,2,1,0,1,0,0
S01012233,Rented or living rent free: Private rented or living rent free,14,8,8,3,5,0,0,6,0,3,1,2,0
S01012234,All HRPs aged 16 and over,393,307,247,27,220,55,5,86,67,2,5,11,1
S01012234,Owned: Total,351,291,232,26,206,54,5,60,55,2,1,2,0
S01012234,Owned: Owned outright,122,74,58,13,45,14,2,48,47,0,1,0,0
S01012234,Owned: Owned with a mortgage or loan or shared ownership,229,217,174,13,161,40,3,12,8,2,0,2,0
S01012234,Rented or living rent free: Total,42,16,15,1,14,1,0,26,12,0,4,9,1
S01012234,Rented or living rent free: Social rented,22,6,6,1,5,0,0,16,9,0,1,5,1
S01012234,Rented or living rent free: Private rented or living rent free,20,10,9,0,9,1,0,10,3,0,3,4,0
S01012235,All HRPs aged 16 and over,192,103,79,10,69,24,0,89,87,1,1,0,0
S01012235,Owned: Total,181,97,75,9,66,22,0,84,82,1,1,0,0
S01012235,Owned: Owned outright,114,37,29,6,23,8,0,77,76,0,1,0,0
S01012235,Owned: Owned with a mortgage or loan or shared ownership,67,60,46,3,43,14,0,7,6,1,0,0,0
S01012235,Rented or living rent free: Total,11,6,4,1,3,2,0,5,5,0,0,0,0
S01012235,Rented or living rent free: Social rented,2,1,1,1,0,0,0,1,1,0,0,0,0
S01012235,Rented or living rent free: Private rented or living rent free,9,5,3,0,3,2,0,4,4,0,0,0,0
S01012236,All HRPs aged 16 and over,278,173,142,26,116,26,5,105,84,2,4,10,5
S01012236,Owned: Total,204,135,113,17,96,22,0,69,63,2,1,1,2
S01012236,Owned: Owned outright,85,30,23,7,16,7,0,55,50,2,0,1,2
S01012236,Owned: Owned with a mortgage or loan or shared ownership,119,105,90,10,80,15,0,14,13,0,1,0,0
S01012236,Rented or living rent free: Total,74,38,29,9,20,4,5,36,21,0,3,9,3
S01012236,Rented or living rent free: Social rented,25,10,10,3,7,0,0,15,10,0,1,4,0
S01012236,Rented or living rent free: Private rented or living rent free,49,28,19,6,13,4,5,21,11,0,2,5,3
S01012237,All HRPs aged 16 and over,319,208,159,20,139,45,4,111,100,4,1,5,1
S01012237,Owned: Total,301,196,149,19,130,44,3,105,97,2,1,4,1
S01012237,Owned: Owned outright,158,68,45,12,33,22,1,90,87,0,0,2,1
S01012237,Owned: Owned with a mortgage or loan or shared ownership,143,128,104,7,97,22,2,15,10,2,1,2,0
S01012237,Rented or living rent free: Total,18,12,10,1,9,1,1,6,3,2,0,1,0
S01012237,Rented or living rent free: Social rented,5,3,2,0,2,0,1,2,1,0,0,1,0
S01012237,Rented or living rent free: Private rented or living rent free,13,9,8,1,7,1,0,4,2,2,0,0,0
S01012238,All HRPs aged 16 and over,309,188,151,20,131,26,11,121,91,1,2,22,5
S01012238,Owned: Total,191,127,101,7,94,21,5,64,58,0,1,3,2
S01012238,Owned: Owned outright,78,27,22,2,20,2,3,51,48,0,1,2,0
S01012238,Owned: Owned with a mortgage or loan or shared ownership,113,100,79,5,74,19,2,13,10,0,0,1,2
S01012238,Rented or living rent free: Total,118,61,50,13,37,5,6,57,33,1,1,19,3
S01012238,Rented or living rent free: Social rented,68,23,21,10,11,0,2,45,30,0,0,13,2
S01012238,Rented or living rent free: Private rented or living rent free,50,38,29,3,26,5,4,12,3,1,1,6,1
S01012239,All HRPs aged 16 and over,274,164,130,26,104,19,15,110,73,2,10,19,6
S01012239,Owned: Total,154,105,85,5,80,18,2,49,47,0,0,0,2
S01012239,Owned: Owned outright,67,32,23,2,21,7,2,35,34,0,0,0,1
S01012239,Owned: Owned with a mortgage or loan or shared ownership,87,73,62,3,59,11,0,14,13,0,0,0,1
S01012239,Rented or living rent free: Total,120,59,45,21,24,1,13,61,26,2,10,19,4
S01012239,Rented or living rent free: Social rented,85,40,30,17,13,1,9,45,20,1,10,11,3
S01012239,Rented or living rent free: Private rented or living rent free,35,19,15,4,11,0,4,16,6,1,0,8,1
S01012240,All HRPs aged 16 and over,391,214,180,24,156,25,9,177,141,3,9,18,6
S01012240,Owned: Total,281,166,142,19,123,21,3,115,105,1,3,4,2
S01012240,Owned: Owned outright,138,49,40,9,31,6,3,89,86,0,1,1,1
S01012240,Owned: Owned with a mortgage or loan or shared ownership,143,117,102,10,92,15,0,26,19,1,2,3,1
S01012240,Rented or living rent free: Total,110,48,38,5,33,4,6,62,36,2,6,14,4
S01012240,Rented or living rent free: Social rented,68,25,18,3,15,3,4,43,27,0,2,10,4
S01012240,Rented or living rent free: Private rented or living rent free,42,23,20,2,18,1,2,19,9,2,4,4,0
S01012241,All HRPs aged 16 and over,232,160,117,10,107,38,5,72,63,1,3,5,0
S01012241,Owned: Total,208,143,103,9,94,36,4,65,60,0,0,5,0
S01012241,Owned: Owned outright,107,55,39,8,31,13,3,52,52,0,0,0,0
S01012241,Owned: Owned with a mortgage or loan or shared ownership,101,88,64,1,63,23,1,13,8,0,0,5,0
S01012241,Rented or living rent free: Total,24,17,14,1,13,2,1,7,3,1,3,0,0
S01012241,Rented or living rent free: Social rented,8,6,5,0,5,0,1,2,1,0,1,0,0
S01012241,Rented or living rent free: Private rented or living rent free,16,11,9,1,8,2,0,5,2,1,2,0,0
S01012242,All HRPs aged 16 and over,307,217,172,14,158,41,4,90,85,1,1,2,1
S01012242,Owned: Total,293,205,161,12,149,41,3,88,83,1,1,2,1
S01012242,Owned: Owned outright,150,74,53,5,48,19,2,76,73,0,1,2,0
S01012242,Owned: Owned with a mortgage or loan or shared ownership,143,131,108,7,101,22,1,12,10,1,0,0,1
S01012242,Rented or living rent free: Total,14,12,11,2,9,0,1,2,2,0,0,0,0
S01012242,Rented or living rent free: Social rented,5,5,4,1,3,0,1,0,0,0,0,0,0
S01012242,Rented or living rent free: Private rented or living rent free,9,7,7,1,6,0,0,2,2,0,0,0,0
S01012243,All HRPs aged 16 and over,244,161,131,18,113,27,3,83,70,1,5,6,1
S01012243,Owned: Total,211,142,118,14,104,22,2,69,64,1,3,1,0
S01012243,Owned: Owned outright,95,39,32,6,26,6,1,56,53,0,2,1,0
S01012243,Owned: Owned with a mortgage or loan or shared ownership,116,103,86,8,78,16,1,13,11,1,1,0,0
S01012243,Rented or living rent free: Total,33,19,13,4,9,5,1,14,6,0,2,5,1
S01012243,Rented or living rent free: Social rented,9,5,4,1,3,0,1,4,3,0,0,1,0
S01012243,Rented or living rent free: Private rented or living rent free,24,14,9,3,6,5,0,10,3,0,2,4,1
S01012244,All HRPs aged 16 and over,347,279,183,15,168,93,3,68,62,0,0,1,5
S01012244,Owned: Total,275,221,139,12,127,80,2,54,51,0,0,1,2
S01012244,Owned: Owned outright,124,78,37,4,33,39,2,46,45,0,0,0,1
S01012244,Owned: Owned with a mortgage or loan or shared ownership,151,143,102,8,94,41,0,8,6,0,0,1,1
S01012244,Rented or living rent free: Total,72,58,44,3,41,13,1,14,11,0,0,0,3
S01012244,Rented or living rent free: Social rented,7,5,3,1,2,1,1,2,1,0,0,0,1
S01012244,Rented or living rent free: Private rented or living rent free,65,53,41,2,39,12,0,12,10,0,0,0,2
S01012245,All HRPs aged 16 and over,335,205,154,29,125,43,8,130,121,0,4,3,2
S01012245,Owned: Total,236,153,113,16,97,39,1,83,77,0,3,1,2
S01012245,Owned: Owned outright,137,60,42,11,31,17,1,77,74,0,1,1,1
S01012245,Owned: Owned with a mortgage or loan or shared ownership,99,93,71,5,66,22,0,6,3,0,2,0,1
S01012245,Rented or living rent free: Total,99,52,41,13,28,4,7,47,44,0,1,2,0
S01012245,Rented or living rent free: Social rented,68,26,19,10,9,1,6,42,39,0,1,2,0
S01012245,Rented or living rent free: Private rented or living rent free,31,26,22,3,19,3,1,5,5,0,0,0,0
S01012246,All HRPs aged 16 and over,301,229,174,30,144,51,4,72,67,0,1,4,0
S01012246,Owned: Total,260,196,149,22,127,46,1,64,62,0,0,2,0
S01012246,Owned: Owned outright,122,63,46,12,34,17,0,59,57,0,0,2,0
S01012246,Owned: Owned with a mortgage or loan or shared ownership,138,133,103,10,93,29,1,5,5,0,0,0,0
S01012246,Rented or living rent free: Total,41,33,25,8,17,5,3,8,5,0,1,2,0
S01012246,Rented or living rent free: Social rented,18,13,11,5,6,1,1,5,3,0,0,2,0
S01012246,Rented or living rent free: Private rented or living rent free,23,20,14,3,11,4,2,3,2,0,1,0,0
S01012247,All HRPs aged 16 and over,303,230,180,23,157,49,1,73,67,0,0,3,3
S01012247,Owned: Total,242,189,146,20,126,43,0,53,52,0,0,1,0
S01012247,Owned: Owned outright,123,76,51,9,42,25,0,47,46,0,0,1,0
S01012247,Owned: Owned with a mortgage or loan or shared ownership,119,113,95,11,84,18,0,6,6,0,0,0,0
S01012247,Rented or living rent free: Total,61,41,34,3,31,6,1,20,15,0,0,2,3
S01012247,Rented or living rent free: Social rented,16,5,4,0,4,0,1,11,9,0,0,1,1
S01012247,Rented or living rent free: Private rented or living rent free,45,36,30,3,27,6,0,9,6,0,0,1,2
S01012248,All HRPs aged 16 and over,332,253,162,26,136,85,6,79,73,0,2,3,1
S01012248,Owned: Total,220,170,106,12,94,62,2,50,49,0,0,0,1
S01012248,Owned: Owned outright,115,69,31,7,24,37,1,46,46,0,0,0,0
S01012248,Owned: Owned with a mortgage or loan or shared ownership,105,101,75,5,70,25,1,4,3,0,0,0,1
S01012248,Rented or living rent free: Total,112,83,56,14,42,23,4,29,24,0,2,3,0
S01012248,Rented or living rent free: Social rented,26,15,11,5,6,1,3,11,7,0,1,3,0
S01012248,Rented or living rent free: Private rented or living rent free,86,68,45,9,36,22,1,18,17,0,1,0,0
S01012249,All HRPs aged 16 and over,365,285,183,28,155,94,8,80,67,0,3,8,2
S01012249,Owned: Total,240,188,119,18,101,68,1,52,49,0,0,2,1
S01012249,Owned: Owned outright,121,74,37,8,29,37,0,47,44,0,0,2,1
S01012249,Owned: Owned with a mortgage or loan or shared ownership,119,114,82,10,72,31,1,5,5,0,0,0,0
S01012249,Rented or living rent free: Total,125,97,64,10,54,26,7,28,18,0,3,6,1
S01012249,Rented or living rent free: Social rented,41,29,21,7,14,4,4,12,8,0,0,3,1
S01012249,Rented or living rent free: Private rented or living rent free,84,68,43,3,40,22,3,16,10,0,3,3,0
S01012250,All HRPs aged 16 and over,301,231,159,29,130,68,4,70,67,1,1,0,1
S01012250,Owned: Total,206,152,106,22,84,45,1,54,54,0,0,0,0
S01012250,Owned: Owned outright,131,81,51,14,37,30,0,50,50,0,0,0,0
S01012250,Owned: Owned with a mortgage or loan or shared ownership,75,71,55,8,47,15,1,4,4,0,0,0,0
S01012250,Rented or living rent free: Total,95,79,53,7,46,23,3,16,13,1,1,0,1
S01012250,Rented or living rent free: Social rented,9,5,2,1,1,1,2,4,4,0,0,0,0
S01012250,Rented or living rent free: Private rented or living rent free,86,74,51,6,45,22,1,12,9,1,1,0,1
S01012251,All HRPs aged 16 and over,457,290,234,51,183,35,21,167,146,2,2,10,7
S01012251,Owned: Total,265,166,138,21,117,24,4,99,98,0,0,0,1
S01012251,Owned: Owned outright,130,48,37,9,28,7,4,82,82,0,0,0,0
S01012251,Owned: Owned with a mortgage or loan or shared ownership,135,118,101,12,89,17,0,17,16,0,0,0,1
S01012251,Rented or living rent free: Total,192,124,96,30,66,11,17,68,48,2,2,10,6
S01012251,Rented or living rent free: Social rented,137,83,60,27,33,7,16,54,38,0,2,9,5
S01012251,Rented or living rent free: Private rented or living rent free,55,41,36,3,33,4,1,14,10,2,0,1,1
S01012252,All HRPs aged 16 and over,333,220,169,40,129,35,16,113,87,1,2,19,4
S01012252,Owned: Total,189,134,103,19,84,26,5,55,50,0,1,2,2
S01012252,Owned: Owned outright,82,37,25,13,12,9,3,45,42,0,0,1,2
S01012252,Owned: Owned with a mortgage or loan or shared ownership,107,97,78,6,72,17,2,10,8,0,1,1,0
S01012252,Rented or living rent free: Total,144,86,66,21,45,9,11,58,37,1,1,17,2
S01012252,Rented or living rent free: Social rented,113,65,52,18,34,2,11,48,31,1,1,13,2
S01012252,Rented or living rent free: Private rented or living rent free,31,21,14,3,11,7,0,10,6,0,0,4,0
S01012253,All HRPs aged 16 and over,508,285,219,40,179,54,12,223,179,4,3,33,4
S01012253,Owned: Total,260,167,126,23,103,38,3,93,84,0,0,8,1
S01012253,Owned: Owned outright,155,69,53,18,35,16,0,86,79,0,0,6,1
S01012253,Owned: Owned with a mortgage or loan or shared ownership,105,98,73,5,68,22,3,7,5,0,0,2,0
S01012253,Rented or living rent free: Total,248,118,93,17,76,16,9,130,95,4,3,25,3
S01012253,Rented or living rent free: Social rented,151,49,38,10,28,4,7,102,76,0,2,21,3
S01012253,Rented or living rent free: Private rented or living rent free,97,69,55,7,48,12,2,28,19,4,1,4,0
S01012254,All HRPs aged 16 and over,399,262,207,32,175,48,7,137,122,2,1,7,5
S01012254,Owned: Total,277,187,147,21,126,38,2,90,85,2,0,1,2
S01012254,Owned: Owned outright,137,56,43,16,27,12,1,81,76,2,0,1,2
S01012254,Owned: Owned with a mortgage or loan or shared ownership,140,131,104,5,99,26,1,9,9,0,0,0,0
S01012254,Rented or living rent free: Total,122,75,60,11,49,10,5,47,37,0,1,6,3
S01012254,Rented or living rent free: Social rented,49,13,8,2,6,3,2,36,29,0,1,3,3
S01012254,Rented or living rent free: Private rented or living rent free,73,62,52,9,43,7,3,11,8,0,0,3,0
S01012255,All HRPs aged 16 and over,475,251,186,28,158,52,13,224,197,3,6,11,7
S01012255,Owned: Total,325,154,112,18,94,38,4,171,166,0,0,2,3
S01012255,Owned: Owned outright,212,50,33,14,19,15,2,162,158,0,0,2,2
S01012255,Owned: Owned with a mortgage or loan or shared ownership,113,104,79,4,75,23,2,9,8,0,0,0,1
S01012255,Rented or living rent free: Total,150,97,74,10,64,14,9,53,31,3,6,9,4
S01012255,Rented or living rent free: Social rented,55,24,16,4,12,3,5,31,17,1,1,9,3
S01012255,Rented or living rent free: Private rented or living rent free,95,73,58,6,52,11,4,22,14,2,5,0,1
S01012256,All HRPs aged 16 and over,327,242,196,29,167,39,7,85,74,1,6,2,2
S01012256,Owned: Total,268,196,158,23,135,34,4,72,68,1,1,1,1
S01012256,Owned: Owned outright,120,64,47,14,33,14,3,56,55,1,0,0,0
S01012256,Owned: Owned with a mortgage or loan or shared ownership,148,132,111,9,102,20,1,16,13,0,1,1,1
S01012256,Rented or living rent free: Total,59,46,38,6,32,5,3,13,6,0,5,1,1
S01012256,Rented or living rent free: Social rented,45,34,27,6,21,4,3,11,5,0,5,1,0
S01012256,Rented or living rent free: Private rented or living rent free,14,12,11,0,11,1,0,2,1,0,0,0,1
S01012257,All HRPs aged 16 and over,412,272,230,42,188,30,12,140,128,0,0,9,3
S01012257,Owned: Total,286,188,160,16,144,27,1,98,95,0,0,2,1
S01012257,Owned: Owned outright,158,66,55,10,45,11,0,92,90,0,0,1,1
S01012257,Owned: Owned with a mortgage or loan or shared ownership,128,122,105,6,99,16,1,6,5,0,0,1,0
S01012257,Rented or living rent free: Total,126,84,70,26,44,3,11,42,33,0,0,7,2
S01012257,Rented or living rent free: Social rented,99,66,54,26,28,2,10,33,24,0,0,7,2
S01012257,Rented or living rent free: Private rented or living rent free,27,18,16,0,16,1,1,9,9,0,0,0,0
S01012258,All HRPs aged 16 and over,297,181,145,21,124,34,2,116,113,0,0,3,0
S01012258,Owned: Total,275,164,131,19,112,31,2,111,109,0,0,2,0
S01012258,Owned: Owned outright,149,47,34,10,24,11,2,102,101,0,0,1,0
S01012258,Owned: Owned with a mortgage or loan or shared ownership,126,117,97,9,88,20,0,9,8,0,0,1,0
S01012258,Rented or living rent free: Total,22,17,14,2,12,3,0,5,4,0,0,1,0
S01012258,Rented or living rent free: Social rented,6,3,3,1,2,0,0,3,2,0,0,1,0
S01012258,Rented or living rent free: Private rented or living rent free,16,14,11,1,10,3,0,2,2,0,0,0,0
S01012259,All HRPs aged 16 and over,277,150,113,25,88,36,1,127,126,0,0,1,0
S01012259,Owned: Total,254,131,99,22,77,32,0,123,123,0,0,0,0
S01012259,Owned: Owned outright,175,61,42,16,26,19,0,114,114,0,0,0,0
S01012259,Owned: Owned with a mortgage or loan or shared ownership,79,70,57,6,51,13,0,9,9,0,0,0,0
S01012259,Rented or living rent free: Total,23,19,14,3,11,4,1,4,3,0,0,1,0
S01012259,Rented or living rent free: Social rented,4,4,3,2,1,1,0,0,0,0,0,0,0
S01012259,Rented or living rent free: Private rented or living rent free,19,15,11,1,10,3,1,4,3,0,0,1,0
S01012260,All HRPs aged 16 and over,368,211,158,31,127,47,6,157,140,0,5,6,6
S01012260,Owned: Total,254,161,120,17,103,40,1,93,90,0,0,1,2
S01012260,Owned: Owned outright,117,32,25,8,17,6,1,85,83,0,0,1,1
S01012260,Owned: Owned with a mortgage or loan or shared ownership,137,129,95,9,86,34,0,8,7,0,0,0,1
S01012260,Rented or living rent free: Total,114,50,38,14,24,7,5,64,50,0,5,5,4
S01012260,Rented or living rent free: Social rented,95,34,27,10,17,3,4,61,49,0,4,5,3
S01012260,Rented or living rent free: Private rented or living rent free,19,16,11,4,7,4,1,3,1,0,1,0,1
S01012261,All HRPs aged 16 and over,322,248,205,32,173,40,3,74,65,1,3,4,1
S01012261,Owned: Total,263,201,164,20,144,35,2,62,60,0,1,1,0
S01012261,Owned: Owned outright,90,36,27,7,20,7,2,54,54,0,0,0,0
S01012261,Owned: Owned with a mortgage or loan or shared ownership,173,165,137,13,124,28,0,8,6,0,1,1,0
S01012261,Rented or living rent free: Total,59,47,41,12,29,5,1,12,5,1,2,3,1
S01012261,Rented or living rent free: Social rented,37,28,23,7,16,4,1,9,2,1,2,3,1
S01012261,Rented or living rent free: Private rented or living rent free,22,19,18,5,13,1,0,3,3,0,0,0,0
S01012262,All HRPs aged 16 and over,343,263,166,22,144,88,9,80,70,1,3,3,3
S01012262,Owned: Total,197,146,99,11,88,45,2,51,46,1,3,0,1
S01012262,Owned: Owned outright,102,57,34,7,27,21,2,45,42,0,2,0,1
S01012262,Owned: Owned with a mortgage or loan or shared ownership,95,89,65,4,61,24,0,6,4,1,1,0,0
S01012262,Rented or living rent free: Total,146,117,67,11,56,43,7,29,24,0,0,3,2
S01012262,Rented or living rent free: Social rented,11,7,5,2,3,0,2,4,1,0,0,3,0
S01012262,Rented or living rent free: Private rented or living rent free,135,110,62,9,53,43,5,25,23,0,0,0,2
S01012263,All HRPs aged 16 and over,366,256,179,38,141,60,17,110,88,5,6,8,3
S01012263,Owned: Total,213,150,101,18,83,46,3,63,58,2,0,3,0
S01012263,Owned: Owned outright,108,51,35,5,30,16,0,57,53,2,0,2,0
S01012263,Owned: Owned with a mortgage or loan or shared ownership,105,99,66,13,53,30,3,6,5,0,0,1,0
S01012263,Rented or living rent free: Total,153,106,78,20,58,14,14,47,30,3,6,5,3
S01012263,Rented or living rent free: Social rented,97,64,49,18,31,4,11,33,19,3,3,5,3
S01012263,Rented or living rent free: Private rented or living rent free,56,42,29,2,27,10,3,14,11,0,3,0,0
S01012264,All HRPs aged 16 and over,222,130,101,18,83,24,5,92,75,0,4,8,5
S01012264,Owned: Total,149,94,74,10,64,18,2,55,52,0,1,2,0
S01012264,Owned: Owned outright,70,22,16,1,15,5,1,48,46,0,1,1,0
S01012264,Owned: Owned with a mortgage or loan or shared ownership,79,72,58,9,49,13,1,7,6,0,0,1,0
S01012264,Rented or living rent free: Total,73,36,27,8,19,6,3,37,23,0,3,6,5
S01012264,Rented or living rent free: Social rented,48,21,17,6,11,3,1,27,18,0,3,5,1
S01012264,Rented or living rent free: Private rented or living rent free,25,15,10,2,8,3,2,10,5,0,0,1,4
S01012265,All HRPs aged 16 and over,340,214,176,33,143,28,10,126,102,2,5,12,5
S01012265,Owned: Total,190,123,104,14,90,18,1,67,64,0,2,0,1
S01012265,Owned: Owned outright,91,29,23,3,20,6,0,62,59,0,2,0,1
S01012265,Owned: Owned with a mortgage or loan or shared ownership,99,94,81,11,70,12,1,5,5,0,0,0,0
S01012265,Rented or living rent free: Total,150,91,72,19,53,10,9,59,38,2,3,12,4
S01012265,Rented or living rent free: Social rented,132,78,65,17,48,6,7,54,35,1,3,12,3
S01012265,Rented or living rent free: Private rented or living rent free,18,13,7,2,5,4,2,5,3,1,0,0,1
S01012266,All HRPs aged 16 and over,536,305,246,46,200,49,10,231,208,4,3,7,9
S01012266,Owned: Total,356,229,190,28,162,38,1,127,120,4,0,0,3
S01012266,Owned: Owned outright,166,57,46,13,33,11,0,109,105,1,0,0,3
S01012266,Owned: Owned with a mortgage or loan or shared ownership,190,172,144,15,129,27,1,18,15,3,0,0,0
S01012266,Rented or living rent free: Total,180,76,56,18,38,11,9,104,88,0,3,7,6
S01012266,Rented or living rent free: Social rented,137,39,31,12,19,3,5,98,82,0,3,7,6
S01012266,Rented or living rent free: Private rented or living rent free,43,37,25,6,19,8,4,6,6,0,0,0,0
S01012267,All HRPs aged 16 and over,318,214,161,25,136,51,2,104,92,0,2,7,3
S01012267,Owned: Total,269,178,133,23,110,44,1,91,85,0,2,1,3
S01012267,Owned: Owned outright,139,58,41,13,28,17,0,81,77,0,1,1,2
S01012267,Owned: Owned with a mortgage or loan or shared ownership,130,120,92,10,82,27,1,10,8,0,1,0,1
S01012267,Rented or living rent free: Total,49,36,28,2,26,7,1,13,7,0,0,6,0
S01012267,Rented or living rent free: Social rented,10,5,4,0,4,1,0,5,2,0,0,3,0
S01012267,Rented or living rent free: Private rented or living rent free,39,31,24,2,22,6,1,8,5,0,0,3,0
S01012268,All HRPs aged 16 and over,265,202,122,10,112,74,6,63,56,2,0,4,1
S01012268,Owned: Total,128,95,54,5,49,38,3,33,31,0,0,1,1
S01012268,Owned: Owned outright,65,37,16,2,14,19,2,28,27,0,0,0,1
S01012268,Owned: Owned with a mortgage or loan or shared ownership,63,58,38,3,35,19,1,5,4,0,0,1,0
S01012268,Rented or living rent free: Total,137,107,68,5,63,36,3,30,25,2,0,3,0
S01012268,Rented or living rent free: Social rented,5,4,1,0,1,1,2,1,1,0,0,0,0
S01012268,Rented or living rent free: Private rented or living rent free,132,103,67,5,62,35,1,29,24,2,0,3,0
S01012269,All HRPs aged 16 and over,461,289,225,40,185,56,8,172,164,0,0,6,2
S01012269,Owned: Total,345,228,179,30,149,46,3,117,116,0,0,0,1
S01012269,Owned: Owned outright,178,74,49,15,34,24,1,104,103,0,0,0,1
S01012269,Owned: Owned with a mortgage or loan or shared ownership,167,154,130,15,115,22,2,13,13,0,0,0,0
S01012269,Rented or living rent free: Total,116,61,46,10,36,10,5,55,48,0,0,6,1
S01012269,Rented or living rent free: Social rented,74,28,23,8,15,4,1,46,40,0,0,5,1
S01012269,Rented or living rent free: Private rented or living rent free,42,33,23,2,21,6,4,9,8,0,0,1,0
S01012270,All HRPs aged 16 and over,348,229,178,31,147,42,9,119,99,3,2,13,2
S01012270,Owned: Total,218,158,118,14,104,36,4,60,58,0,0,1,1
S01012270,Owned: Owned outright,94,45,31,4,27,11,3,49,49,0,0,0,0
S01012270,Owned: Owned with a mortgage or loan or shared ownership,124,113,87,10,77,25,1,11,9,0,0,1,1
S01012270,Rented or living rent free: Total,130,71,60,17,43,6,5,59,41,3,2,12,1
S01012270,Rented or living rent free: Social rented,90,48,42,10,32,1,5,42,29,0,1,11,1
S01012270,Rented or living rent free: Private rented or living rent free,40,23,18,7,11,5,0,17,12,3,1,1,0
S01012271,All HRPs aged 16 and over,421,339,213,22,191,119,7,82,74,0,4,2,2
S01012271,Owned: Total,282,227,135,13,122,91,1,55,52,0,1,1,1
S01012271,Owned: Owned outright,146,94,37,9,28,57,0,52,49,0,1,1,1
S01012271,Owned: Owned with a mortgage or loan or shared ownership,136,133,98,4,94,34,1,3,3,0,0,0,0
S01012271,Rented or living rent free: Total,139,112,78,9,69,28,6,27,22,0,3,1,1
S01012271,Rented or living rent free: Social rented,25,14,10,1,9,2,2,11,8,0,3,0,0
S01012271,Rented or living rent free: Private rented or living rent free,114,98,68,8,60,26,4,16,14,0,0,1,1
S01012272,All HRPs aged 16 and over,305,214,166,29,137,42,6,91,84,2,0,3,2
S01012272,Owned: Total,226,163,124,17,107,38,1,63,61,1,0,0,1
S01012272,Owned: Owned outright,99,40,26,8,18,14,0,59,57,1,0,0,1
S01012272,Owned: Owned with a mortgage or loan or shared ownership,127,123,98,9,89,24,1,4,4,0,0,0,0
S01012272,Rented or living rent free: Total,79,51,42,12,30,4,5,28,23,1,0,3,1
S01012272,Rented or living rent free: Social rented,49,27,24,7,17,1,2,22,18,1,0,2,1
S01012272,Rented or living rent free: Private rented or living rent free,30,24,18,5,13,3,3,6,5,0,0,1,0
S01012273,All HRPs aged 16 and over,297,194,152,21,131,38,4,103,93,1,2,5,2
S01012273,Owned: Total,226,142,112,14,98,30,0,84,80,1,1,0,2
S01012273,Owned: Owned outright,125,49,33,8,25,16,0,76,74,1,0,0,1
S01012273,Owned: Owned with a mortgage or loan or shared ownership,101,93,79,6,73,14,0,8,6,0,1,0,1
S01012273,Rented or living rent free: Total,71,52,40,7,33,8,4,19,13,0,1,5,0
S01012273,Rented or living rent free: Social rented,21,9,6,1,5,1,2,12,7,0,1,4,0
S01012273,Rented or living rent free: Private rented or living rent free,50,43,34,6,28,7,2,7,6,0,0,1,0
S01012274,All HRPs aged 16 and over,432,321,265,54,211,44,12,111,83,3,5,17,3
S01012274,Owned: Total,294,226,188,24,164,37,1,68,65,0,1,2,0
S01012274,Owned: Owned outright,116,58,43,7,36,15,0,58,56,0,1,1,0
S01012274,Owned: Owned with a mortgage or loan or shared ownership,178,168,145,17,128,22,1,10,9,0,0,1,0
S01012274,Rented or living rent free: Total,138,95,77,30,47,7,11,43,18,3,4,15,3
S01012274,Rented or living rent free: Social rented,86,57,45,16,29,5,7,29,11,2,3,11,2
S01012274,Rented or living rent free: Private rented or living rent free,52,38,32,14,18,2,4,14,7,1,1,4,1
S01012275,All HRPs aged 16 and over,450,332,281,75,206,28,23,118,70,20,4,18,6
S01012275,Owned: Total,170,123,107,14,93,15,1,47,40,0,0,5,2
S01012275,Owned: Owned outright,69,27,22,6,16,5,0,42,37,0,0,4,1
S01012275,Owned: Owned with a mortgage or loan or shared ownership,101,96,85,8,77,10,1,5,3,0,0,1,1
S01012275,Rented or living rent free: Total,280,209,174,61,113,13,22,71,30,20,4,13,4
S01012275,Rented or living rent free: Social rented,110,72,58,25,33,4,10,38,18,8,2,7,3
S01012275,Rented or living rent free: Private rented or living rent free,170,137,116,36,80,9,12,33,12,12,2,6,1
S01012276,All HRPs aged 16 and over,463,311,246,39,207,44,21,152,109,8,2,24,9
S01012276,Owned: Total,271,205,167,16,151,37,1,66,63,1,0,2,0
S01012276,Owned: Owned outright,103,44,36,7,29,8,0,59,56,1,0,2,0
S01012276,Owned: Owned with a mortgage or loan or shared ownership,168,161,131,9,122,29,1,7,7,0,0,0,0
S01012276,Rented or living rent free: Total,192,106,79,23,56,7,20,86,46,7,2,22,9
S01012276,Rented or living rent free: Social rented,120,47,29,14,15,6,12,73,39,7,1,19,7
S01012276,Rented or living rent free: Private rented or living rent free,72,59,50,9,41,1,8,13,7,0,1,3,2
S01012277,All HRPs aged 16 and over,482,355,275,45,230,52,28,127,96,7,7,10,7
S01012277,Owned: Total,286,214,167,19,148,38,9,72,68,0,1,2,1
S01012277,Owned: Owned outright,113,54,36,9,27,14,4,59,57,0,0,2,0
S01012277,Owned: Owned with a mortgage or loan or shared ownership,173,160,131,10,121,24,5,13,11,0,1,0,1
S01012277,Rented or living rent free: Total,196,141,108,26,82,14,19,55,28,7,6,8,6
S01012277,Rented or living rent free: Social rented,110,74,57,19,38,7,10,36,24,2,2,5,3
S01012277,Rented or living rent free: Private rented or living rent free,86,67,51,7,44,7,9,19,4,5,4,3,3
S01012278,All HRPs aged 16 and over,401,247,196,35,161,27,24,154,108,7,1,30,8
S01012278,Owned: Total,169,103,88,12,76,13,2,66,55,0,0,10,1
S01012278,Owned: Owned outright,81,24,19,3,16,4,1,57,51,0,0,5,1
S01012278,Owned: Owned with a mortgage or loan or shared ownership,88,79,69,9,60,9,1,9,4,0,0,5,0
S01012278,Rented or living rent free: Total,232,144,108,23,85,14,22,88,53,7,1,20,7
S01012278,Rented or living rent free: Social rented,99,31,20,4,16,4,7,68,48,0,0,16,4
S01012278,Rented or living rent free: Private rented or living rent free,133,113,88,19,69,10,15,20,5,7,1,4,3
S01012279,All HRPs aged 16 and over,407,282,240,40,200,22,20,125,67,9,13,29,7
S01012279,Owned: Total,178,127,111,9,102,14,2,51,47,0,1,2,1
S01012279,Owned: Owned outright,81,34,29,6,23,5,0,47,43,0,1,2,1
S01012279,Owned: Owned with a mortgage or loan or shared ownership,97,93,82,3,79,9,2,4,4,0,0,0,0
S01012279,Rented or living rent free: Total,229,155,129,31,98,8,18,74,20,9,12,27,6
S01012279,Rented or living rent free: Social rented,127,72,58,22,36,4,10,55,18,0,8,24,5
S01012279,Rented or living rent free: Private rented or living rent free,102,83,71,9,62,4,8,19,2,9,4,3,1
S01012280,All HRPs aged 16 and over,409,285,230,53,177,30,25,124,96,5,3,18,2
S01012280,Owned: Total,244,186,156,19,137,22,8,58,55,1,1,0,1
S01012280,Owned: Owned outright,95,47,37,11,26,6,4,48,45,1,1,0,1
S01012280,Owned: Owned with a mortgage or loan or shared ownership,149,139,119,8,111,16,4,10,10,0,0,0,0
S01012280,Rented or living rent free: Total,165,99,74,34,40,8,17,66,41,4,2,18,1
S01012280,Rented or living rent free: Social rented,140,84,64,32,32,5,15,56,37,0,2,17,0
S01012280,Rented or living rent free: Private rented or living rent free,25,15,10,2,8,3,2,10,4,4,0,1,1
S01012281,All HRPs aged 16 and over,371,254,219,41,178,27,8,117,101,3,4,7,2
S01012281,Owned: Total,232,154,126,11,115,24,4,78,74,0,0,3,1
S01012281,Owned: Owned outright,110,39,31,8,23,6,2,71,68,0,0,2,1
S01012281,Owned: Owned with a mortgage or loan or shared ownership,122,115,95,3,92,18,2,7,6,0,0,1,0
S01012281,Rented or living rent free: Total,139,100,93,30,63,3,4,39,27,3,4,4,1
S01012281,Rented or living rent free: Social rented,40,18,17,9,8,0,1,22,19,0,1,2,0
S01012281,Rented or living rent free: Private rented or living rent free,99,82,76,21,55,3,3,17,8,3,3,2,1
S01012282,All HRPs aged 16 and over,466,236,185,22,163,45,6,230,211,8,4,6,1
S01012282,Owned: Total,293,169,132,12,120,34,3,124,121,1,0,1,1
S01012282,Owned: Owned outright,174,57,42,8,34,14,1,117,114,1,0,1,1
S01012282,Owned: Owned with a mortgage or loan or shared ownership,119,112,90,4,86,20,2,7,7,0,0,0,0
S01012282,Rented or living rent free: Total,173,67,53,10,43,11,3,106,90,7,4,5,0
S01012282,Rented or living rent free: Social rented,106,29,25,2,23,1,3,77,65,3,4,5,0
S01012282,Rented or living rent free: Private rented or living rent free,67,38,28,8,20,10,0,29,25,4,0,0,0
S01012283,All HRPs aged 16 and over,369,259,193,44,149,47,19,110,87,6,0,16,1
S01012283,Owned: Total,244,173,133,19,114,38,2,71,66,5,0,0,0
S01012283,Owned: Owned outright,132,65,53,12,41,11,1,67,62,5,0,0,0
S01012283,Owned: Owned with a mortgage or loan or shared ownership,112,108,80,7,73,27,1,4,4,0,0,0,0
S01012283,Rented or living rent free: Total,125,86,60,25,35,9,17,39,21,1,0,16,1
S01012283,Rented or living rent free: Social rented,90,56,37,17,20,4,15,34,18,0,0,15,1
S01012283,Rented or living rent free: Private rented or living rent free,35,30,23,8,15,5,2,5,3,1,0,1,0
S01012284,All HRPs aged 16 and over,436,260,199,42,157,26,35,176,140,10,3,16,7
S01012284,Owned: Total,192,120,102,17,85,15,3,72,68,2,1,1,0
S01012284,Owned: Owned outright,103,38,33,8,25,4,1,65,62,2,1,0,0
S01012284,Owned: Owned with a mortgage or loan or shared ownership,89,82,69,9,60,11,2,7,6,0,0,1,0
S01012284,Rented or living rent free: Total,244,140,97,25,72,11,32,104,72,8,2,15,7
S01012284,Rented or living rent free: Social rented,160,79,50,13,37,4,25,81,60,2,2,13,4
S01012284,Rented or living rent free: Private rented or living rent free,84,61,47,12,35,7,7,23,12,6,0,2,3
S01012285,All HRPs aged 16 and over,266,149,120,17,103,24,5,117,105,1,0,6,5
S01012285,Owned: Total,192,116,93,13,80,22,1,76,74,0,0,0,2
S01012285,Owned: Owned outright,118,45,36,9,27,8,1,73,73,0,0,0,0
S01012285,Owned: Owned with a mortgage or loan or shared ownership,74,71,57,4,53,14,0,3,1,0,0,0,2
S01012285,Rented or living rent free: Total,74,33,27,4,23,2,4,41,31,1,0,6,3
S01012285,Rented or living rent free: Social rented,57,20,16,2,14,1,3,37,29,0,0,5,3
S01012285,Rented or living rent free: Private rented or living rent free,17,13,11,2,9,1,1,4,2,1,0,1,0
S01012286,All HRPs aged 16 and over,493,300,237,58,179,32,31,193,119,28,8,28,10
S01012286,Owned: Total,252,168,142,20,122,23,3,84,77,2,1,1,3
S01012286,Owned: Owned outright,136,59,49,8,41,8,2,77,71,2,0,1,3
S01012286,Owned: Owned with a mortgage or loan or shared ownership,116,109,93,12,81,15,1,7,6,0,1,0,0
S01012286,Rented or living rent free: Total,241,132,95,38,57,9,28,109,42,26,7,27,7
S01012286,Rented or living rent free: Social rented,184,105,72,28,44,6,27,79,37,6,7,23,6
S01012286,Rented or living rent free: Private rented or living rent free,57,27,23,10,13,3,1,30,5,20,0,4,1
S01012287,All HRPs aged 16 and over,479,290,223,59,164,25,42,189,117,2,17,34,19
S01012287,Owned: Total,114,67,55,6,49,9,3,47,44,0,0,2,1
S01012287,Owned: Owned outright,59,17,13,3,10,3,1,42,40,0,0,1,1
S01012287,Owned: Owned with a mortgage or loan or shared ownership,55,50,42,3,39,6,2,5,4,0,0,1,0
S01012287,Rented or living rent free: Total,365,223,168,53,115,16,39,142,73,2,17,32,18
S01012287,Rented or living rent free: Social rented,344,213,158,51,107,16,39,131,65,2,16,30,18
S01012287,Rented or living rent free: Private rented or living rent free,21,10,10,2,8,0,0,11,8,0,1,2,0
S01012288,All HRPs aged 16 and over,377,244,170,45,125,21,53,133,92,4,8,24,5
S01012288,Owned: Total,126,64,51,11,40,11,2,62,56,2,0,3,1
S01012288,Owned: Owned outright,77,20,18,6,12,1,1,57,52,2,0,2,1
S01012288,Owned: Owned with a mortgage or loan or shared ownership,49,44,33,5,28,10,1,5,4,0,0,1,0
S01012288,Rented or living rent free: Total,251,180,119,34,85,10,51,71,36,2,8,21,4
S01012288,Rented or living rent free: Social rented,229,164,105,29,76,8,51,65,33,2,8,18,4
S01012288,Rented or living rent free: Private rented or living rent free,22,16,14,5,9,2,0,6,3,0,0,3,0
S01012289,All HRPs aged 16 and over,411,214,153,28,125,58,3,197,173,4,3,14,3
S01012289,Owned: Total,343,175,127,23,104,48,0,168,159,4,2,3,0
S01012289,Owned: Owned outright,245,85,58,13,45,27,0,160,153,3,1,3,0
S01012289,Owned: Owned with a mortgage or loan or shared ownership,98,90,69,10,59,21,0,8,6,1,1,0,0
S01012289,Rented or living rent free: Total,68,39,26,5,21,10,3,29,14,0,1,11,3
S01012289,Rented or living rent free: Social rented,27,10,5,1,4,2,3,17,5,0,0,10,2
S01012289,Rented or living rent free: Private rented or living rent free,41,29,21,4,17,8,0,12,9,0,1,1,1
S01012290,All HRPs aged 16 and over,292,160,127,26,101,26,7,132,114,1,1,13,3
S01012290,Owned: Total,169,100,82,15,67,18,0,69,65,1,0,1,2
S01012290,Owned: Owned outright,89,29,21,6,15,8,0,60,56,1,0,1,2
S01012290,Owned: Owned with a mortgage or loan or shared ownership,80,71,61,9,52,10,0,9,9,0,0,0,0
S01012290,Rented or living rent free: Total,123,60,45,11,34,8,7,63,49,0,1,12,1
S01012290,Rented or living rent free: Social rented,84,31,21,6,15,5,5,53,42,0,1,9,1
S01012290,Rented or living rent free: Private rented or living rent free,39,29,24,5,19,3,2,10,7,0,0,3,0
S01012291,All HRPs aged 16 and over,421,305,246,51,195,44,15,116,90,1,2,14,9
S01012291,Owned: Total,282,207,169,32,137,33,5,75,71,1,1,2,0
S01012291,Owned: Owned outright,121,54,37,11,26,15,2,67,67,0,0,0,0
S01012291,Owned: Owned with a mortgage or loan or shared ownership,161,153,132,21,111,18,3,8,4,1,1,2,0
S01012291,Rented or living rent free: Total,139,98,77,19,58,11,10,41,19,0,1,12,9
S01012291,Rented or living rent free: Social rented,66,42,33,11,22,1,8,24,11,0,1,10,2
S01012291,Rented or living rent free: Private rented or living rent free,73,56,44,8,36,10,2,17,8,0,0,2,7
S01012292,All HRPs aged 16 and over,341,180,123,27,96,55,2,161,155,2,2,2,0
S01012292,Owned: Total,255,128,85,17,68,41,2,127,126,0,1,0,0
S01012292,Owned: Owned outright,165,47,25,12,13,21,1,118,118,0,0,0,0
S01012292,Owned: Owned with a mortgage or loan or shared ownership,90,81,60,5,55,20,1,9,8,0,1,0,0
S01012292,Rented or living rent free: Total,86,52,38,10,28,14,0,34,29,2,1,2,0
S01012292,Rented or living rent free: Social rented,21,3,3,1,2,0,0,18,16,0,1,1,0
S01012292,Rented or living rent free: Private rented or living rent free,65,49,35,9,26,14,0,16,13,2,0,1,0
S01012293,All HRPs aged 16 and over,212,151,129,16,113,18,4,61,53,0,2,6,0
S01012293,Owned: Total,156,111,93,8,85,16,2,45,45,0,0,0,0
S01012293,Owned: Owned outright,85,45,38,4,34,5,2,40,40,0,0,0,0
S01012293,Owned: Owned with a mortgage or loan or shared ownership,71,66,55,4,51,11,0,5,5,0,0,0,0
S01012293,Rented or living rent free: Total,56,40,36,8,28,2,2,16,8,0,2,6,0
S01012293,Rented or living rent free: Social rented,39,26,23,6,17,1,2,13,5,0,2,6,0
S01012293,Rented or living rent free: Private rented or living rent free,17,14,13,2,11,1,0,3,3,0,0,0,0
S01012294,All HRPs aged 16 and over,371,271,236,39,197,28,7,100,82,1,3,11,3
S01012294,Owned: Total,260,195,170,20,150,22,3,65,62,1,0,2,0
S01012294,Owned: Owned outright,104,51,42,7,35,7,2,53,51,1,0,1,0
S01012294,Owned: Owned with a mortgage or loan or shared ownership,156,144,128,13,115,15,1,12,11,0,0,1,0
S01012294,Rented or living rent free: Total,111,76,66,19,47,6,4,35,20,0,3,9,3
S01012294,Rented or living rent free: Social rented,81,54,46,13,33,5,3,27,14,0,3,8,2
S01012294,Rented or living rent free: Private rented or living rent free,30,22,20,6,14,1,1,8,6,0,0,1,1
S01012295,All HRPs aged 16 and over,280,227,177,19,158,43,7,53,29,1,6,15,2
S01012295,Owned: Total,171,153,118,5,113,34,1,18,15,1,0,2,0
S01012295,Owned: Owned outright,34,24,16,3,13,7,1,10,9,1,0,0,0
S01012295,Owned: Owned with a mortgage or loan or shared ownership,137,129,102,2,100,27,0,8,6,0,0,2,0
S01012295,Rented or living rent free: Total,109,74,59,14,45,9,6,35,14,0,6,13,2
S01012295,Rented or living rent free: Social rented,69,41,33,9,24,2,6,28,10,0,5,12,1
S01012295,Rented or living rent free: Private rented or living rent free,40,33,26,5,21,7,0,7,4,0,1,1,1
S01012296,All HRPs aged 16 and over,330,271,223,28,195,45,3,59,45,1,6,5,2
S01012296,Owned: Total,237,205,171,14,157,34,0,32,28,1,2,0,1
S01012296,Owned: Owned outright,68,38,26,5,21,12,0,30,28,0,1,0,1
S01012296,Owned: Owned with a mortgage or loan or shared ownership,169,167,145,9,136,22,0,2,0,1,1,0,0
S01012296,Rented or living rent free: Total,93,66,52,14,38,11,3,27,17,0,4,5,1
S01012296,Rented or living rent free: Social rented,42,24,22,8,14,1,1,18,11,0,3,3,1
S01012296,Rented or living rent free: Private rented or living rent free,51,42,30,6,24,10,2,9,6,0,1,2,0
S01012297,All HRPs aged 16 and over,253,188,102,13,89,84,2,65,57,2,1,4,1
S01012297,Owned: Total,193,145,75,9,66,70,0,48,45,0,0,3,0
S01012297,Owned: Owned outright,111,68,25,8,17,43,0,43,41,0,0,2,0
S01012297,Owned: Owned with a mortgage or loan or shared ownership,82,77,50,1,49,27,0,5,4,0,0,1,0
S01012297,Rented or living rent free: Total,60,43,27,4,23,14,2,17,12,2,1,1,1
S01012297,Rented or living rent free: Social rented,3,2,2,1,1,0,0,1,1,0,0,0,0
S01012297,Rented or living rent free: Private rented or living rent free,57,41,25,3,22,14,2,16,11,2,1,1,1
S01012298,All HRPs aged 16 and over,374,243,180,18,162,57,6,131,127,0,1,3,0
S01012298,Owned: Total,274,190,142,13,129,45,3,84,83,0,0,1,0
S01012298,Owned: Owned outright,122,48,32,5,27,15,1,74,74,0,0,0,0
S01012298,Owned: Owned with a mortgage or loan or shared ownership,152,142,110,8,102,30,2,10,9,0,0,1,0
S01012298,Rented or living rent free: Total,100,53,38,5,33,12,3,47,44,0,1,2,0
S01012298,Rented or living rent free: Social rented,62,25,18,3,15,6,1,37,36,0,1,0,0
S01012298,Rented or living rent free: Private rented or living rent free,38,28,20,2,18,6,2,10,8,0,0,2,0
S01012299,All HRPs aged 16 and over,257,198,135,12,123,62,1,59,51,0,1,5,2
S01012299,Owned: Total,177,134,84,6,78,50,0,43,42,0,1,0,0
S01012299,Owned: Owned outright,84,47,22,4,18,25,0,37,37,0,0,0,0
S01012299,Owned: Owned with a mortgage or loan or shared ownership,93,87,62,2,60,25,0,6,5,0,1,0,0
S01012299,Rented or living rent free: Total,80,64,51,6,45,12,1,16,9,0,0,5,2
S01012299,Rented or living rent free: Social rented,6,2,1,0,1,1,0,4,1,0,0,3,0
S01012299,Rented or living rent free: Private rented or living rent free,74,62,50,6,44,11,1,12,8,0,0,2,2
S01012300,All HRPs aged 16 and over,294,179,129,29,100,45,5,115,95,6,1,11,2
S01012300,Owned: Total,179,122,81,15,66,38,3,57,53,2,0,2,0
S01012300,Owned: Owned outright,92,40,24,9,15,14,2,52,50,0,0,2,0
S01012300,Owned: Owned with a mortgage or loan or shared ownership,87,82,57,6,51,24,1,5,3,2,0,0,0
S01012300,Rented or living rent free: Total,115,57,48,14,34,7,2,58,42,4,1,9,2
S01012300,Rented or living rent free: Social rented,87,38,34,12,22,2,2,49,36,4,0,8,1
S01012300,Rented or living rent free: Private rented or living rent free,28,19,14,2,12,5,0,9,6,0,1,1,1
S01012301,All HRPs aged 16 and over,407,288,189,26,163,89,10,119,95,0,7,11,6
S01012301,Owned: Total,212,157,90,13,77,64,3,55,49,0,2,2,2
S01012301,Owned: Owned outright,129,78,33,9,24,43,2,51,47,0,1,2,1
S01012301,Owned: Owned with a mortgage or loan or shared ownership,83,79,57,4,53,21,1,4,2,0,1,0,1
S01012301,Rented or living rent free: Total,195,131,99,13,86,25,7,64,46,0,5,9,4
S01012301,Rented or living rent free: Social rented,48,25,19,2,17,4,2,23,17,0,2,3,1
S01012301,Rented or living rent free: Private rented or living rent free,147,106,80,11,69,21,5,41,29,0,3,6,3
S01012302,All HRPs aged 16 and over,240,178,107,10,97,66,5,62,49,0,2,8,3
S01012302,Owned: Total,122,88,41,5,36,44,3,34,28,0,2,3,1
S01012302,Owned: Owned outright,72,42,15,3,12,25,2,30,28,0,1,1,0
S01012302,Owned: Owned with a mortgage or loan or shared ownership,50,46,26,2,24,19,1,4,0,0,1,2,1
S01012302,Rented or living rent free: Total,118,90,66,5,61,22,2,28,21,0,0,5,2
S01012302,Rented or living rent free: Social rented,9,3,2,0,2,0,1,6,3,0,0,3,0
S01012302,Rented or living rent free: Private rented or living rent free,109,87,64,5,59,22,1,22,18,0,0,2,2
S01012303,All HRPs aged 16 and over,378,283,175,27,148,102,6,95,93,0,0,2,0
S01012303,Owned: Total,266,195,113,16,97,81,1,71,70,0,0,1,0
S01012303,Owned: Owned outright,161,96,46,11,35,49,1,65,64,0,0,1,0
S01012303,Owned: Owned with a mortgage or loan or shared ownership,105,99,67,5,62,32,0,6,6,0,0,0,0
S01012303,Rented or living rent free: Total,112,88,62,11,51,21,5,24,23,0,0,1,0
S01012303,Rented or living rent free: Social rented,19,10,9,3,6,1,0,9,8,0,0,1,0
S01012303,Rented or living rent free: Private rented or living rent free,93,78,53,8,45,20,5,15,15,0,0,0,0
S01012304,All HRPs aged 16 and over,424,303,208,32,176,86,9,121,108,1,4,3,5
S01012304,Owned: Total,301,214,141,20,121,70,3,87,84,0,0,1,2
S01012304,Owned: Owned outright,176,94,47,11,36,44,3,82,80,0,0,1,1
S01012304,Owned: Owned with a mortgage or loan or shared ownership,125,120,94,9,85,26,0,5,4,0,0,0,1
S01012304,Rented or living rent free: Total,123,89,67,12,55,16,6,34,24,1,4,2,3
S01012304,Rented or living rent free: Social rented,45,31,24,6,18,4,3,14,8,0,3,2,1
S01012304,Rented or living rent free: Private rented or living rent free,78,58,43,6,37,12,3,20,16,1,1,0,2
S01012305,All HRPs aged 16 and over,333,187,141,22,119,42,4,146,117,1,5,21,2
S01012305,Owned: Total,208,126,89,9,80,36,1,82,78,1,2,0,1
S01012305,Owned: Owned outright,133,61,38,5,33,23,0,72,72,0,0,0,0
S01012305,Owned: Owned with a mortgage or loan or shared ownership,75,65,51,4,47,13,1,10,6,1,2,0,1
S01012305,Rented or living rent free: Total,125,61,52,13,39,6,3,64,39,0,3,21,1
S01012305,Rented or living rent free: Social rented,86,29,25,9,16,1,3,57,33,0,3,20,1
S01012305,Rented or living rent free: Private rented or living rent free,39,32,27,4,23,5,0,7,6,0,0,1,0
S01012306,All HRPs aged 16 and over,308,163,134,36,98,22,7,145,130,0,0,12,3
S01012306,Owned: Total,119,75,59,11,48,15,1,44,41,0,0,2,1
S01012306,Owned: Owned outright,71,31,23,6,17,8,0,40,39,0,0,0,1
S01012306,Owned: Owned with a mortgage or loan or shared ownership,48,44,36,5,31,7,1,4,2,0,0,2,0
S01012306,Rented or living rent free: Total,189,88,75,25,50,7,6,101,89,0,0,10,2
S01012306,Rented or living rent free: Social rented,149,61,53,21,32,5,3,88,78,0,0,8,2
S01012306,Rented or living rent free: Private rented or living rent free,40,27,22,4,18,2,3,13,11,0,0,2,0
S01012307,All HRPs aged 16 and over,323,201,164,38,126,30,7,122,92,2,3,18,7
S01012307,Owned: Total,162,97,72,9,63,24,1,65,59,2,1,0,3
S01012307,Owned: Owned outright,98,39,24,6,18,14,1,59,57,1,0,0,1
S01012307,Owned: Owned with a mortgage or loan or shared ownership,64,58,48,3,45,10,0,6,2,1,1,0,2
S01012307,Rented or living rent free: Total,161,104,92,29,63,6,6,57,33,0,2,18,4
S01012307,Rented or living rent free: Social rented,127,79,69,22,47,4,6,48,29,0,1,15,3
S01012307,Rented or living rent free: Private rented or living rent free,34,25,23,7,16,2,0,9,4,0,1,3,1
S01012308,All HRPs aged 16 and over,334,235,198,25,173,34,3,99,88,1,3,5,2
S01012308,Owned: Total,236,168,141,16,125,25,2,68,67,0,1,0,0
S01012308,Owned: Owned outright,117,51,43,11,32,7,1,66,65,0,1,0,0
S01012308,Owned: Owned with a mortgage or loan or shared ownership,119,117,98,5,93,18,1,2,2,0,0,0,0
S01012308,Rented or living rent free: Total,98,67,57,9,48,9,1,31,21,1,2,5,2
S01012308,Rented or living rent free: Social rented,74,49,42,9,33,6,1,25,16,1,2,4,2
S01012308,Rented or living rent free: Private rented or living rent free,24,18,15,0,15,3,0,6,5,0,0,1,0
S01012309,All HRPs aged 16 and over,245,135,99,16,83,32,4,110,101,0,3,4,2
S01012309,Owned: Total,164,91,60,10,50,31,0,73,70,0,0,2,1
S01012309,Owned: Owned outright,96,29,18,8,10,11,0,67,64,0,0,2,1
S01012309,Owned: Owned with a mortgage or loan or shared ownership,68,62,42,2,40,20,0,6,6,0,0,0,0
S01012309,Rented or living rent free: Total,81,44,39,6,33,1,4,37,31,0,3,2,1
S01012309,Rented or living rent free: Social rented,57,25,21,5,16,0,4,32,26,0,3,2,1
S01012309,Rented or living rent free: Private rented or living rent free,24,19,18,1,17,1,0,5,5,0,0,0,0
S01012310,All HRPs aged 16 and over,427,282,165,29,136,111,6,145,125,1,4,11,4
S01012310,Owned: Total,285,181,104,19,85,76,1,104,97,0,1,3,3
S01012310,Owned: Owned outright,193,99,57,13,44,42,0,94,90,0,1,1,2
S01012310,Owned: Owned with a mortgage or loan or shared ownership,92,82,47,6,41,34,1,10,7,0,0,2,1
S01012310,Rented or living rent free: Total,142,101,61,10,51,35,5,41,28,1,3,8,1
S01012310,Rented or living rent free: Social rented,52,33,22,4,18,8,3,19,11,0,0,7,1
S01012310,Rented or living rent free: Private rented or living rent free,90,68,39,6,33,27,2,22,17,1,3,1,0
S01012311,All HRPs aged 16 and over,263,128,100,20,80,25,3,135,127,0,1,4,3
S01012311,Owned: Total,213,102,79,10,69,21,2,111,106,0,0,3,2
S01012311,Owned: Owned outright,138,34,26,8,18,8,0,104,100,0,0,3,1
S01012311,Owned: Owned with a mortgage or loan or shared ownership,75,68,53,2,51,13,2,7,6,0,0,0,1
S01012311,Rented or living rent free: Total,50,26,21,10,11,4,1,24,21,0,1,1,1
S01012311,Rented or living rent free: Social rented,34,17,14,9,5,2,1,17,15,0,1,1,0
S01012311,Rented or living rent free: Private rented or living rent free,16,9,7,1,6,2,0,7,6,0,0,0,1
S01012312,All HRPs aged 16 and over,439,299,182,21,161,113,4,140,112,2,7,16,3
S01012312,Owned: Total,300,219,121,16,105,95,3,81,72,0,5,3,1
S01012312,Owned: Owned outright,169,98,44,8,36,54,0,71,66,0,3,2,0
S01012312,Owned: Owned with a mortgage or loan or shared ownership,131,121,77,8,69,41,3,10,6,0,2,1,1
S01012312,Rented or living rent free: Total,139,80,61,5,56,18,1,59,40,2,2,13,2
S01012312,Rented or living rent free: Social rented,58,27,23,4,19,3,1,31,19,1,2,8,1
S01012312,Rented or living rent free: Private rented or living rent free,81,53,38,1,37,15,0,28,21,1,0,5,1
S01012313,All HRPs aged 16 and over,345,243,174,20,154,65,4,102,82,0,1,15,4
S01012313,Owned: Total,227,164,109,11,98,53,2,63,60,0,0,1,2
S01012313,Owned: Owned outright,125,69,34,6,28,33,2,56,53,0,0,1,2
S01012313,Owned: Owned with a mortgage or loan or shared ownership,102,95,75,5,70,20,0,7,7,0,0,0,0
S01012313,Rented or living rent free: Total,118,79,65,9,56,12,2,39,22,0,1,14,2
S01012313,Rented or living rent free: Social rented,56,29,27,7,20,1,1,27,15,0,1,10,1
S01012313,Rented or living rent free: Private rented or living rent free,62,50,38,2,36,11,1,12,7,0,0,4,1
S01012314,All HRPs aged 16 and over,365,217,170,55,115,37,10,148,122,0,7,15,4
S01012314,Owned: Total,199,125,98,20,78,25,2,74,73,0,0,1,0
S01012314,Owned: Owned outright,97,31,23,10,13,8,0,66,65,0,0,1,0
S01012314,Owned: Owned with a mortgage or loan or shared ownership,102,94,75,10,65,17,2,8,8,0,0,0,0
S01012314,Rented or living rent free: Total,166,92,72,35,37,12,8,74,49,0,7,14,4
S01012314,Rented or living rent free: Social rented,148,81,65,33,32,9,7,67,43,0,6,14,4
S01012314,Rented or living rent free: Private rented or living rent free,18,11,7,2,5,3,1,7,6,0,1,0,0
S01012315,All HRPs aged 16 and over,400,205,145,29,116,40,20,195,158,1,4,25,7
S01012315,Owned: Total,219,126,94,17,77,32,0,93,90,0,0,3,0
S01012315,Owned: Owned outright,144,57,41,12,29,16,0,87,84,0,0,3,0
S01012315,Owned: Owned with a mortgage or loan or shared ownership,75,69,53,5,48,16,0,6,6,0,0,0,0
S01012315,Rented or living rent free: Total,181,79,51,12,39,8,20,102,68,1,4,22,7
S01012315,Rented or living rent free: Social rented,132,47,25,9,16,4,18,85,55,1,2,20,7
S01012315,Rented or living rent free: Private rented or living rent free,49,32,26,3,23,4,2,17,13,0,2,2,0
S01012316,All HRPs aged 16 and over,315,171,130,26,104,23,18,144,109,0,9,21,5
S01012316,Owned: Total,149,95,76,13,63,17,2,54,49,0,1,1,3
S01012316,Owned: Owned outright,86,39,29,7,22,9,1,47,42,0,1,1,3
S01012316,Owned: Owned with a mortgage or loan or shared ownership,63,56,47,6,41,8,1,7,7,0,0,0,0
S01012316,Rented or living rent free: Total,166,76,54,13,41,6,16,90,60,0,8,20,2
S01012316,Rented or living rent free: Social rented,144,60,43,11,32,5,12,84,57,0,7,19,1
S01012316,Rented or living rent free: Private rented or living rent free,22,16,11,2,9,1,4,6,3,0,1,1,1
S01012317,All HRPs aged 16 and over,209,137,102,15,87,28,7,72,62,1,4,4,1
S01012317,Owned: Total,144,102,79,10,69,21,2,42,40,0,1,0,1
S01012317,Owned: Owned outright,64,29,20,9,11,8,1,35,35,0,0,0,0
S01012317,Owned: Owned with a mortgage or loan or shared ownership,80,73,59,1,58,13,1,7,5,0,1,0,1
S01012317,Rented or living rent free: Total,65,35,23,5,18,7,5,30,22,1,3,4,0
S01012317,Rented or living rent free: Social rented,44,20,12,4,8,4,4,24,19,1,2,2,0
S01012317,Rented or living rent free: Private rented or living rent free,21,15,11,1,10,3,1,6,3,0,1,2,0
S01012318,All HRPs aged 16 and over,329,224,183,34,149,31,10,105,81,0,5,16,3
S01012318,Owned: Total,181,136,107,14,93,25,4,45,45,0,0,0,0
S01012318,Owned: Owned outright,87,44,27,7,20,14,3,43,43,0,0,0,0
S01012318,Owned: Owned with a mortgage or loan or shared ownership,94,92,80,7,73,11,1,2,2,0,0,0,0
S01012318,Rented or living rent free: Total,148,88,76,20,56,6,6,60,36,0,5,16,3
S01012318,Rented or living rent free: Social rented,131,77,68,19,49,4,5,54,33,0,5,16,0
S01012318,Rented or living rent free: Private rented or living rent free,17,11,8,1,7,2,1,6,3,0,0,0,3
S01012319,All HRPs aged 16 and over,343,247,166,26,140,78,3,96,83,1,4,6,2
S01012319,Owned: Total,173,124,65,8,57,59,0,49,45,0,2,2,0
S01012319,Owned: Owned outright,113,70,27,3,24,43,0,43,40,0,1,2,0
S01012319,Owned: Owned with a mortgage or loan or shared ownership,60,54,38,5,33,16,0,6,5,0,1,0,0
S01012319,Rented or living rent free: Total,170,123,101,18,83,19,3,47,38,1,2,4,2
S01012319,Rented or living rent free: Social rented,13,8,8,2,6,0,0,5,2,0,1,1,1
S01012319,Rented or living rent free: Private rented or living rent free,157,115,93,16,77,19,3,42,36,1,1,3,1
S01012320,All HRPs aged 16 and over,276,178,139,26,113,31,8,98,80,0,3,11,4
S01012320,Owned: Total,148,106,82,9,73,24,0,42,38,0,0,3,1
S01012320,Owned: Owned outright,74,38,29,7,22,9,0,36,33,0,0,3,0
S01012320,Owned: Owned with a mortgage or loan or shared ownership,74,68,53,2,51,15,0,6,5,0,0,0,1
S01012320,Rented or living rent free: Total,128,72,57,17,40,7,8,56,42,0,3,8,3
S01012320,Rented or living rent free: Social rented,106,58,45,14,31,6,7,48,36,0,2,8,2
S01012320,Rented or living rent free: Private rented or living rent free,22,14,12,3,9,1,1,8,6,0,1,0,1
S01012321,All HRPs aged 16 and over,339,203,151,27,124,38,14,136,117,0,4,11,4
S01012321,Owned: Total,229,145,109,19,90,29,7,84,75,0,1,5,3
S01012321,Owned: Owned outright,120,48,28,12,16,15,5,72,69,0,1,1,1
S01012321,Owned: Owned with a mortgage or loan or shared ownership,109,97,81,7,74,14,2,12,6,0,0,4,2
S01012321,Rented or living rent free: Total,110,58,42,8,34,9,7,52,42,0,3,6,1
S01012321,Rented or living rent free: Social rented,73,29,23,8,15,1,5,44,39,0,2,3,0
S01012321,Rented or living rent free: Private rented or living rent free,37,29,19,0,19,8,2,8,3,0,1,3,1
S01012322,All HRPs aged 16 and over,453,299,182,33,149,110,7,154,142,0,4,5,3
S01012322,Owned: Total,292,183,102,19,83,80,1,109,109,0,0,0,0
S01012322,Owned: Owned outright,185,91,42,11,31,48,1,94,94,0,0,0,0
S01012322,Owned: Owned with a mortgage or loan or shared ownership,107,92,60,8,52,32,0,15,15,0,0,0,0
S01012322,Rented or living rent free: Total,161,116,80,14,66,30,6,45,33,0,4,5,3
S01012322,Rented or living rent free: Social rented,22,10,7,3,4,1,2,12,7,0,2,3,0
S01012322,Rented or living rent free: Private rented or living rent free,139,106,73,11,62,29,4,33,26,0,2,2,3
S01012323,All HRPs aged 16 and over,403,246,148,28,120,91,7,157,143,0,2,6,6
S01012323,Owned: Total,303,174,97,8,89,74,3,129,121,0,0,4,4
S01012323,Owned: Owned outright,196,86,40,5,35,44,2,110,105,0,0,2,3
S01012323,Owned: Owned with a mortgage or loan or shared ownership,107,88,57,3,54,30,1,19,16,0,0,2,1
S01012323,Rented or living rent free: Total,100,72,51,20,31,17,4,28,22,0,2,2,2
S01012323,Rented or living rent free: Social rented,16,9,9,6,3,0,0,7,5,0,1,0,1
S01012323,Rented or living rent free: Private rented or living rent free,84,63,42,14,28,17,4,21,17,0,1,2,1
S01012324,All HRPs aged 16 and over,365,235,145,22,123,84,6,130,115,0,2,10,3
S01012324,Owned: Total,183,110,52,8,44,57,1,73,67,0,0,3,3
S01012324,Owned: Owned outright,130,64,26,5,21,37,1,66,62,0,0,1,3
S01012324,Owned: Owned with a mortgage or loan or shared ownership,53,46,26,3,23,20,0,7,5,0,0,2,0
S01012324,Rented or living rent free: Total,182,125,93,14,79,27,5,57,48,0,2,7,0
S01012324,Rented or living rent free: Social rented,8,2,2,0,2,0,0,6,3,0,0,3,0
S01012324,Rented or living rent free: Private rented or living rent free,174,123,91,14,77,27,5,51,45,0,2,4,0
S01012325,All HRPs aged 16 and over,301,130,107,23,84,14,9,171,165,0,0,2,4
S01012325,Owned: Total,201,75,61,13,48,12,2,126,124,0,0,0,2
S01012325,Owned: Owned outright,147,30,25,10,15,4,1,117,115,0,0,0,2
S01012325,Owned: Owned with a mortgage or loan or shared ownership,54,45,36,3,33,8,1,9,9,0,0,0,0
S01012325,Rented or living rent free: Total,100,55,46,10,36,2,7,45,41,0,0,2,2
S01012325,Rented or living rent free: Social rented,72,39,32,7,25,0,7,33,29,0,0,2,2
S01012325,Rented or living rent free: Private rented or living rent free,28,16,14,3,11,2,0,12,12,0,0,0,0
S01012326,All HRPs aged 16 and over,310,170,115,23,92,33,22,140,114,0,3,14,9
S01012326,Owned: Total,143,86,59,8,51,26,1,57,55,0,0,0,2
S01012326,Owned: Owned outright,81,30,22,6,16,7,1,51,49,0,0,0,2
S01012326,Owned: Owned with a mortgage or loan or shared ownership,62,56,37,2,35,19,0,6,6,0,0,0,0
S01012326,Rented or living rent free: Total,167,84,56,15,41,7,21,83,59,0,3,14,7
S01012326,Rented or living rent free: Social rented,117,50,35,9,26,2,13,67,49,0,1,13,4
S01012326,Rented or living rent free: Private rented or living rent free,50,34,21,6,15,5,8,16,10,0,2,1,3
S01012327,All HRPs aged 16 and over,366,215,169,41,128,38,8,151,133,0,5,8,5
S01012327,Owned: Total,215,116,89,13,76,26,1,99,96,0,0,0,3
S01012327,Owned: Owned outright,127,44,32,8,24,11,1,83,82,0,0,0,1
S01012327,Owned: Owned with a mortgage or loan or shared ownership,88,72,57,5,52,15,0,16,14,0,0,0,2
S01012327,Rented or living rent free: Total,151,99,80,28,52,12,7,52,37,0,5,8,2
S01012327,Rented or living rent free: Social rented,113,71,55,21,34,9,7,42,29,0,4,7,2
S01012327,Rented or living rent free: Private rented or living rent free,38,28,25,7,18,3,0,10,8,0,1,1,0
S01012328,All HRPs aged 16 and over,293,134,91,19,72,35,8,159,146,0,4,5,4
S01012328,Owned: Total,194,89,61,13,48,26,2,105,104,0,0,0,1
S01012328,Owned: Owned outright,135,44,28,7,21,16,0,91,90,0,0,0,1
S01012328,Owned: Owned with a mortgage or loan or shared ownership,59,45,33,6,27,10,2,14,14,0,0,0,0
S01012328,Rented or living rent free: Total,99,45,30,6,24,9,6,54,42,0,4,5,3
S01012328,Rented or living rent free: Social rented,72,33,22,5,17,6,5,39,31,0,2,3,3
S01012328,Rented or living rent free: Private rented or living rent free,27,12,8,1,7,3,1,15,11,0,2,2,0
S01012329,All HRPs aged 16 and over,381,243,148,22,126,88,7,138,119,2,4,11,2
S01012329,Owned: Total,175,104,51,8,43,51,2,71,67,1,0,2,1
S01012329,Owned: Owned outright,114,52,24,4,20,27,1,62,58,1,0,2,1
S01012329,Owned: Owned with a mortgage or loan or shared ownership,61,52,27,4,23,24,1,9,9,0,0,0,0
S01012329,Rented or living rent free: Total,206,139,97,14,83,37,5,67,52,1,4,9,1
S01012329,Rented or living rent free: Social rented,27,15,12,5,7,1,2,12,7,0,0,4,1
S01012329,Rented or living rent free: Private rented or living rent free,179,124,85,9,76,36,3,55,45,1,4,5,0
S01012330,All HRPs aged 16 and over,280,162,125,19,106,34,3,118,105,1,4,2,6
S01012330,Owned: Total,204,113,90,11,79,23,0,91,89,0,0,0,2
S01012330,Owned: Owned outright,127,41,31,8,23,10,0,86,84,0,0,0,2
S01012330,Owned: Owned with a mortgage or loan or shared ownership,77,72,59,3,56,13,0,5,5,0,0,0,0
S01012330,Rented or living rent free: Total,76,49,35,8,27,11,3,27,16,1,4,2,4
S01012330,Rented or living rent free: Social rented,41,24,20,4,16,3,1,17,10,0,3,1,3
S01012330,Rented or living rent free: Private rented or living rent free,35,25,15,4,11,8,2,10,6,1,1,1,1
S01012331,All HRPs aged 16 and over,265,197,162,29,133,32,3,68,64,1,1,1,1
S01012331,Owned: Total,218,171,142,22,120,28,1,47,46,0,1,0,0
S01012331,Owned: Owned outright,80,39,32,13,19,6,1,41,41,0,0,0,0
S01012331,Owned: Owned with a mortgage or loan or shared ownership,138,132,110,9,101,22,0,6,5,0,1,0,0
S01012331,Rented or living rent free: Total,47,26,20,7,13,4,2,21,18,1,0,1,1
S01012331,Rented or living rent free: Social rented,20,7,7,6,1,0,0,13,12,0,0,0,1
S01012331,Rented or living rent free: Private rented or living rent free,27,19,13,1,12,4,2,8,6,1,0,1,0
S01012332,All HRPs aged 16 and over,435,323,208,37,171,105,10,112,105,0,2,3,2
S01012332,Owned: Total,243,172,104,25,79,64,4,71,67,0,0,2,2
S01012332,Owned: Owned outright,158,96,51,16,35,43,2,62,59,0,0,1,2
S01012332,Owned: Owned with a mortgage or loan or shared ownership,85,76,53,9,44,21,2,9,8,0,0,1,0
S01012332,Rented or living rent free: Total,192,151,104,12,92,41,6,41,38,0,2,1,0
S01012332,Rented or living rent free: Social rented,20,12,10,1,9,1,1,8,8,0,0,0,0
S01012332,Rented or living rent free: Private rented or living rent free,172,139,94,11,83,40,5,33,30,0,2,1,0
S01012333,All HRPs aged 16 and over,452,296,187,31,156,98,11,156,139,2,8,5,2
S01012333,Owned: Total,259,153,91,16,75,60,2,106,102,0,1,1,2
S01012333,Owned: Owned outright,168,67,37,12,25,30,0,101,97,0,1,1,2
S01012333,Owned: Owned with a mortgage or loan or shared ownership,91,86,54,4,50,30,2,5,5,0,0,0,0
S01012333,Rented or living rent free: Total,193,143,96,15,81,38,9,50,37,2,7,4,0
S01012333,Rented or living rent free: Social rented,10,5,2,1,1,1,2,5,2,0,2,1,0
S01012333,Rented or living rent free: Private rented or living rent free,183,138,94,14,80,37,7,45,35,2,5,3,0
S01012334,All HRPs aged 16 and over,365,229,181,37,144,38,10,136,117,1,6,9,3
S01012334,Owned: Total,226,136,104,7,97,30,2,90,88,0,0,0,2
S01012334,Owned: Owned outright,133,48,33,5,28,14,1,85,83,0,0,0,2
S01012334,Owned: Owned with a mortgage or loan or shared ownership,93,88,71,2,69,16,1,5,5,0,0,0,0
S01012334,Rented or living rent free: Total,139,93,77,30,47,8,8,46,29,1,6,9,1
S01012334,Rented or living rent free: Social rented,111,72,60,26,34,5,7,39,24,1,6,7,1
S01012334,Rented or living rent free: Private rented or living rent free,28,21,17,4,13,3,1,7,5,0,0,2,0
S01012335,All HRPs aged 16 and over,414,311,271,43,228,31,9,103,94,0,1,4,4
S01012335,Owned: Total,305,237,210,25,185,24,3,68,67,0,0,0,1
S01012335,Owned: Owned outright,120,57,48,9,39,7,2,63,62,0,0,0,1
S01012335,Owned: Owned with a mortgage or loan or shared ownership,185,180,162,16,146,17,1,5,5,0,0,0,0
S01012335,Rented or living rent free: Total,109,74,61,18,43,7,6,35,27,0,1,4,3
S01012335,Rented or living rent free: Social rented,72,43,36,11,25,2,5,29,21,0,1,4,3
S01012335,Rented or living rent free: Private rented or living rent free,37,31,25,7,18,5,1,6,6,0,0,0,0
S01012336,All HRPs aged 16 and over,275,159,137,25,112,21,1,116,109,0,2,4,1
S01012336,Owned: Total,191,117,102,13,89,15,0,74,74,0,0,0,0
S01012336,Owned: Owned outright,103,35,31,8,23,4,0,68,68,0,0,0,0
S01012336,Owned: Owned with a mortgage or loan or shared ownership,88,82,71,5,66,11,0,6,6,0,0,0,0
S01012336,Rented or living rent free: Total,84,42,35,12,23,6,1,42,35,0,2,4,1
S01012336,Rented or living rent free: Social rented,61,30,26,9,17,4,0,31,25,0,2,3,1
S01012336,Rented or living rent free: Private rented or living rent free,23,12,9,3,6,2,1,11,10,0,0,1,0
S01012337,All HRPs aged 16 and over,453,246,189,32,157,32,25,207,174,2,9,17,5
S01012337,Owned: Total,190,116,95,10,85,17,4,74,72,0,0,1,1
S01012337,Owned: Owned outright,116,44,32,7,25,9,3,72,70,0,0,1,1
S01012337,Owned: Owned with a mortgage or loan or shared ownership,74,72,63,3,60,8,1,2,2,0,0,0,0
S01012337,Rented or living rent free: Total,263,130,94,22,72,15,21,133,102,2,9,16,4
S01012337,Rented or living rent free: Social rented,210,99,71,17,54,8,20,111,81,2,8,16,4
S01012337,Rented or living rent free: Private rented or living rent free,53,31,23,5,18,7,1,22,21,0,1,0,0
S01012338,All HRPs aged 16 and over,384,232,184,35,149,40,8,152,133,1,2,12,4
S01012338,Owned: Total,211,116,93,13,80,23,0,95,90,0,0,1,4
S01012338,Owned: Owned outright,132,43,31,9,22,12,0,89,85,0,0,1,3
S01012338,Owned: Owned with a mortgage or loan or shared ownership,79,73,62,4,58,11,0,6,5,0,0,0,1
S01012338,Rented or living rent free: Total,173,116,91,22,69,17,8,57,43,1,2,11,0
S01012338,Rented or living rent free: Social rented,82,39,31,12,19,2,6,43,31,0,2,10,0
S01012338,Rented or living rent free: Private rented or living rent free,91,77,60,10,50,15,2,14,12,1,0,1,0
S01012339,All HRPs aged 16 and over,366,206,165,25,140,29,12,160,131,2,3,16,8
S01012339,Owned: Total,158,81,60,14,46,20,1,77,71,0,0,3,3
S01012339,Owned: Owned outright,93,29,19,4,15,9,1,64,59,0,0,2,3
S01012339,Owned: Owned with a mortgage or loan or shared ownership,65,52,41,10,31,11,0,13,12,0,0,1,0
S01012339,Rented or living rent free: Total,208,125,105,11,94,9,11,83,60,2,3,13,5
S01012339,Rented or living rent free: Social rented,102,37,29,6,23,1,7,65,50,1,1,11,2
S01012339,Rented or living rent free: Private rented or living rent free,106,88,76,5,71,8,4,18,10,1,2,2,3
S01012340,All HRPs aged 16 and over,477,273,214,42,172,53,6,204,177,1,7,12,7
S01012340,Owned: Total,291,168,123,15,108,44,1,123,122,1,0,0,0
S01012340,Owned: Owned outright,181,67,47,11,36,20,0,114,113,1,0,0,0
S01012340,Owned: Owned with a mortgage or loan or shared ownership,110,101,76,4,72,24,1,9,9,0,0,0,0
S01012340,Rented or living rent free: Total,186,105,91,27,64,9,5,81,55,0,7,12,7
S01012340,Rented or living rent free: Social rented,156,90,81,25,56,5,4,66,43,0,6,11,6
S01012340,Rented or living rent free: Private rented or living rent free,30,15,10,2,8,4,1,15,12,0,1,1,1
S01012341,All HRPs aged 16 and over,404,310,177,24,153,130,3,94,86,0,1,6,1
S01012341,Owned: Total,265,202,105,14,91,96,1,63,62,0,1,0,0
S01012341,Owned: Owned outright,148,93,42,13,29,51,0,55,54,0,1,0,0
S01012341,Owned: Owned with a mortgage or loan or shared ownership,117,109,63,1,62,45,1,8,8,0,0,0,0
S01012341,Rented or living rent free: Total,139,108,72,10,62,34,2,31,24,0,0,6,1
S01012341,Rented or living rent free: Social rented,14,9,8,0,8,0,1,5,2,0,0,2,1
S01012341,Rented or living rent free: Private rented or living rent free,125,99,64,10,54,34,1,26,22,0,0,4,0
S01012342,All HRPs aged 16 and over,403,249,170,25,145,78,1,154,139,1,1,8,5
S01012342,Owned: Total,233,146,96,9,87,50,0,87,84,0,1,0,2
S01012342,Owned: Owned outright,135,57,26,6,20,31,0,78,75,0,1,0,2
S01012342,Owned: Owned with a mortgage or loan or shared ownership,98,89,70,3,67,19,0,9,9,0,0,0,0
S01012342,Rented or living rent free: Total,170,103,74,16,58,28,1,67,55,1,0,8,3
S01012342,Rented or living rent free: Social rented,55,23,19,10,9,3,1,32,25,1,0,4,2
S01012342,Rented or living rent free: Private rented or living rent free,115,80,55,6,49,25,0,35,30,0,0,4,1
S01012343,All HRPs aged 16 and over,448,319,201,26,175,108,10,129,114,1,6,5,3
S01012343,Owned: Total,218,151,90,14,76,60,1,67,65,0,2,0,0
S01012343,Owned: Owned outright,134,75,43,12,31,32,0,59,57,0,2,0,0
S01012343,Owned: Owned with a mortgage or loan or shared ownership,84,76,47,2,45,28,1,8,8,0,0,0,0
S01012343,Rented or living rent free: Total,230,168,111,12,99,48,9,62,49,1,4,5,3
S01012343,Rented or living rent free: Social rented,33,25,20,3,17,1,4,8,3,0,1,4,0
S01012343,Rented or living rent free: Private rented or living rent free,197,143,91,9,82,47,5,54,46,1,3,1,3
S01012344,All HRPs aged 16 and over,296,199,160,34,126,25,14,97,74,2,3,14,4
S01012344,Owned: Total,155,113,93,14,79,19,1,42,39,0,1,1,1
S01012344,Owned: Owned outright,71,34,24,6,18,9,1,37,36,0,1,0,0
S01012344,Owned: Owned with a mortgage or loan or shared ownership,84,79,69,8,61,10,0,5,3,0,0,1,1
S01012344,Rented or living rent free: Total,141,86,67,20,47,6,13,55,35,2,2,13,3
S01012344,Rented or living rent free: Social rented,113,67,51,18,33,4,12,46,28,2,2,11,3
S01012344,Rented or living rent free: Private rented or living rent free,28,19,16,2,14,2,1,9,7,0,0,2,0
S01012345,All HRPs aged 16 and over,321,216,166,19,147,46,4,105,92,1,3,5,4
S01012345,Owned: Total,228,162,122,10,112,39,1,66,63,0,0,1,2
S01012345,Owned: Owned outright,105,47,34,6,28,13,0,58,56,0,0,0,2
S01012345,Owned: Owned with a mortgage or loan or shared ownership,123,115,88,4,84,26,1,8,7,0,0,1,0
S01012345,Rented or living rent free: Total,93,54,44,9,35,7,3,39,29,1,3,4,2
S01012345,Rented or living rent free: Social rented,70,36,31,7,24,2,3,34,25,1,2,4,2
S01012345,Rented or living rent free: Private rented or living rent free,23,18,13,2,11,5,0,5,4,0,1,0,0
S01012346,All HRPs aged 16 and over,361,243,157,20,137,81,5,118,96,5,1,11,5
S01012346,Owned: Total,179,113,62,5,57,50,1,66,61,1,0,2,2
S01012346,Owned: Owned outright,110,50,24,2,22,25,1,60,55,1,0,2,2
S01012346,Owned: Owned with a mortgage or loan or shared ownership,69,63,38,3,35,25,0,6,6,0,0,0,0
S01012346,Rented or living rent free: Total,182,130,95,15,80,31,4,52,35,4,1,9,3
S01012346,Rented or living rent free: Social rented,14,6,4,1,3,0,2,8,2,0,0,5,1
S01012346,Rented or living rent free: Private rented or living rent free,168,124,91,14,77,31,2,44,33,4,1,4,2
S01012347,All HRPs aged 16 and over,364,216,167,30,137,40,9,148,138,0,1,4,5
S01012347,Owned: Total,240,159,122,15,107,32,5,81,80,0,0,0,1
S01012347,Owned: Owned outright,121,46,33,9,24,9,4,75,74,0,0,0,1
S01012347,Owned: Owned with a mortgage or loan or shared ownership,119,113,89,6,83,23,1,6,6,0,0,0,0
S01012347,Rented or living rent free: Total,124,57,45,15,30,8,4,67,58,0,1,4,4
S01012347,Rented or living rent free: Social rented,96,34,28,10,18,3,3,62,55,0,1,4,2
S01012347,Rented or living rent free: Private rented or living rent free,28,23,17,5,12,5,1,5,3,0,0,0,2
S01012348,All HRPs aged 16 and over,325,197,154,27,127,40,3,128,116,0,2,7,3
S01012348,Owned: Total,239,155,122,21,101,31,2,84,84,0,0,0,0
S01012348,Owned: Owned outright,126,52,36,8,28,14,2,74,74,0,0,0,0
S01012348,Owned: Owned with a mortgage or loan or shared ownership,113,103,86,13,73,17,0,10,10,0,0,0,0
S01012348,Rented or living rent free: Total,86,42,32,6,26,9,1,44,32,0,2,7,3
S01012348,Rented or living rent free: Social rented,49,19,17,4,13,1,1,30,23,0,1,4,2
S01012348,Rented or living rent free: Private rented or living rent free,37,23,15,2,13,8,0,14,9,0,1,3,1
S01012349,All HRPs aged 16 and over,402,250,208,41,167,29,13,152,126,1,7,13,5
S01012349,Owned: Total,230,152,127,18,109,22,3,78,76,0,0,2,0
S01012349,Owned: Owned outright,105,41,31,3,28,8,2,64,63,0,0,1,0
S01012349,Owned: Owned with a mortgage or loan or shared ownership,125,111,96,15,81,14,1,14,13,0,0,1,0
S01012349,Rented or living rent free: Total,172,98,81,23,58,7,10,74,50,1,7,11,5
S01012349,Rented or living rent free: Social rented,136,81,66,18,48,5,10,55,37,0,5,9,4
S01012349,Rented or living rent free: Private rented or living rent free,36,17,15,5,10,2,0,19,13,1,2,2,1
S01012350,All HRPs aged 16 and over,337,187,139,30,109,42,6,150,116,2,4,14,14
S01012350,Owned: Total,212,116,85,10,75,29,2,96,92,0,0,0,4
S01012350,Owned: Owned outright,126,38,26,6,20,12,0,88,88,0,0,0,0
S01012350,Owned: Owned with a mortgage or loan or shared ownership,86,78,59,4,55,17,2,8,4,0,0,0,4
S01012350,Rented or living rent free: Total,125,71,54,20,34,13,4,54,24,2,4,14,10
S01012350,Rented or living rent free: Social rented,101,54,42,19,23,8,4,47,20,0,4,14,9
S01012350,Rented or living rent free: Private rented or living rent free,24,17,12,1,11,5,0,7,4,2,0,0,1
S01012351,All HRPs aged 16 and over,373,241,198,45,153,34,9,132,105,1,5,14,7
S01012351,Owned: Total,225,161,135,22,113,24,2,64,61,0,0,2,1
S01012351,Owned: Owned outright,85,29,26,9,17,3,0,56,53,0,0,2,1
S01012351,Owned: Owned with a mortgage or loan or shared ownership,140,132,109,13,96,21,2,8,8,0,0,0,0
S01012351,Rented or living rent free: Total,148,80,63,23,40,10,7,68,44,1,5,12,6
S01012351,Rented or living rent free: Social rented,116,63,49,20,29,8,6,53,35,0,2,10,6
S01012351,Rented or living rent free: Private rented or living rent free,32,17,14,3,11,2,1,15,9,1,3,2,0
S01012352,All HRPs aged 16 and over,350,210,158,30,128,43,9,140,117,4,5,9,5
S01012352,Owned: Total,223,144,106,17,89,37,1,79,74,0,0,3,2
S01012352,Owned: Owned outright,107,36,23,5,18,12,1,71,67,0,0,3,1
S01012352,Owned: Owned with a mortgage or loan or shared ownership,116,108,83,12,71,25,0,8,7,0,0,0,1
S01012352,Rented or living rent free: Total,127,66,52,13,39,6,8,61,43,4,5,6,3
S01012352,Rented or living rent free: Social rented,74,36,29,12,17,2,5,38,23,4,4,4,3
S01012352,Rented or living rent free: Private rented or living rent free,53,30,23,1,22,4,3,23,20,0,1,2,0
S01012353,All HRPs aged 16 and over,453,263,198,32,166,38,27,190,151,8,2,17,12
S01012353,Owned: Total,186,113,88,10,78,23,2,73,70,0,0,1,2
S01012353,Owned: Owned outright,98,34,21,6,15,12,1,64,61,0,0,1,2
S01012353,Owned: Owned with a mortgage or loan or shared ownership,88,79,67,4,63,11,1,9,9,0,0,0,0
S01012353,Rented or living rent free: Total,267,150,110,22,88,15,25,117,81,8,2,16,10
S01012353,Rented or living rent free: Social rented,170,78,59,16,43,2,17,92,61,8,1,13,9
S01012353,Rented or living rent free: Private rented or living rent free,97,72,51,6,45,13,8,25,20,0,1,3,1
S01012354,All HRPs aged 16 and over,385,202,144,27,117,50,8,183,170,1,2,9,1
S01012354,Owned: Total,253,132,90,16,74,42,0,121,117,0,0,3,1
S01012354,Owned: Owned outright,175,63,37,10,27,26,0,112,108,0,0,3,1
S01012354,Owned: Owned with a mortgage or loan or shared ownership,78,69,53,6,47,16,0,9,9,0,0,0,0
S01012354,Rented or living rent free: Total,132,70,54,11,43,8,8,62,53,1,2,6,0
S01012354,Rented or living rent free: Social rented,70,36,27,8,19,3,6,34,27,0,2,5,0
S01012354,Rented or living rent free: Private rented or living rent free,62,34,27,3,24,5,2,28,26,1,0,1,0
S01012355,All HRPs aged 16 and over,377,257,141,28,113,113,3,120,103,0,1,7,9
S01012355,Owned: Total,231,153,79,18,61,71,3,78,71,0,1,2,4
S01012355,Owned: Owned outright,150,84,39,13,26,44,1,66,60,0,1,1,4
S01012355,Owned: Owned with a mortgage or loan or shared ownership,81,69,40,5,35,27,2,12,11,0,0,1,0
S01012355,Rented or living rent free: Total,146,104,62,10,52,42,0,42,32,0,0,5,5
S01012355,Rented or living rent free: Social rented,10,4,3,0,3,1,0,6,3,0,0,2,1
S01012355,Rented or living rent free: Private rented or living rent free,136,100,59,10,49,41,0,36,29,0,0,3,4
S01012356,All HRPs aged 16 and over,320,182,132,23,109,45,5,138,129,0,4,4,1
S01012356,Owned: Total,246,142,101,17,84,40,1,104,101,0,1,1,1
S01012356,Owned: Owned outright,146,46,32,12,20,13,1,100,98,0,1,1,0
S01012356,Owned: Owned with a mortgage or loan or shared ownership,100,96,69,5,64,27,0,4,3,0,0,0,1
S01012356,Rented or living rent free: Total,74,40,31,6,25,5,4,34,28,0,3,3,0
S01012356,Rented or living rent free: Social rented,51,24,20,5,15,2,2,27,21,0,3,3,0
S01012356,Rented or living rent free: Private rented or living rent free,23,16,11,1,10,3,2,7,7,0,0,0,0
S01012357,All HRPs aged 16 and over,355,245,137,23,114,105,3,110,104,1,2,3,0
S01012357,Owned: Total,275,182,98,15,83,81,3,93,90,0,2,1,0
S01012357,Owned: Owned outright,177,91,44,9,35,45,2,86,83,0,2,1,0
S01012357,Owned: Owned with a mortgage or loan or shared ownership,98,91,54,6,48,36,1,7,7,0,0,0,0
S01012357,Rented or living rent free: Total,80,63,39,8,31,24,0,17,14,1,0,2,0
S01012357,Rented or living rent free: Social rented,3,0,0,0,0,0,0,3,1,1,0,1,0
S01012357,Rented or living rent free: Private rented or living rent free,77,63,39,8,31,24,0,14,13,0,0,1,0
S01012358,All HRPs aged 16 and over,343,228,118,24,94,105,5,115,104,0,2,6,3
S01012358,Owned: Total,246,158,75,15,60,83,0,88,83,0,1,1,3
S01012358,Owned: Owned outright,170,92,41,13,28,51,0,78,73,0,1,1,3
S01012358,Owned: Owned with a mortgage or loan or shared ownership,76,66,34,2,32,32,0,10,10,0,0,0,0
S01012358,Rented or living rent free: Total,97,70,43,9,34,22,5,27,21,0,1,5,0
S01012358,Rented or living rent free: Social rented,22,13,9,5,4,1,3,9,6,0,1,2,0
S01012358,Rented or living rent free: Private rented or living rent free,75,57,34,4,30,21,2,18,15,0,0,3,0
S01012359,All HRPs aged 16 and over,367,216,172,43,129,19,25,151,104,1,11,26,9
S01012359,Owned: Total,147,92,80,12,68,12,0,55,52,0,0,1,2
S01012359,Owned: Owned outright,79,36,34,8,26,2,0,43,42,0,0,1,0
S01012359,Owned: Owned with a mortgage or loan or shared ownership,68,56,46,4,42,10,0,12,10,0,0,0,2
S01012359,Rented or living rent free: Total,220,124,92,31,61,7,25,96,52,1,11,25,7
S01012359,Rented or living rent free: Social rented,190,101,77,29,48,4,20,89,48,1,11,23,6
S01012359,Rented or living rent free: Private rented or living rent free,30,23,15,2,13,3,5,7,4,0,0,2,1
S01012360,All HRPs aged 16 and over,324,215,175,45,130,18,22,109,67,0,14,26,2
S01012360,Owned: Total,111,78,68,7,61,8,2,33,27,0,3,2,1
S01012360,Owned: Owned outright,53,25,22,3,19,2,1,28,25,0,2,1,0
S01012360,Owned: Owned with a mortgage or loan or shared ownership,58,53,46,4,42,6,1,5,2,0,1,1,1
S01012360,Rented or living rent free: Total,213,137,107,38,69,10,20,76,40,0,11,24,1
S01012360,Rented or living rent free: Social rented,180,112,92,31,61,6,14,68,37,0,11,19,1
S01012360,Rented or living rent free: Private rented or living rent free,33,25,15,7,8,4,6,8,3,0,0,5,0
S01012361,All HRPs aged 16 and over,275,168,128,31,97,21,19,107,72,1,12,18,4
S01012361,Owned: Total,91,65,55,7,48,10,0,26,26,0,0,0,0
S01012361,Owned: Owned outright,37,14,12,4,8,2,0,23,23,0,0,0,0
S01012361,Owned: Owned with a mortgage or loan or shared ownership,54,51,43,3,40,8,0,3,3,0,0,0,0
S01012361,Rented or living rent free: Total,184,103,73,24,49,11,19,81,46,1,12,18,4
S01012361,Rented or living rent free: Social rented,174,100,71,23,48,10,19,74,42,0,12,16,4
S01012361,Rented or living rent free: Private rented or living rent free,10,3,2,1,1,1,0,7,4,1,0,2,0
S01012362,All HRPs aged 16 and over,306,200,156,43,113,23,21,106,49,2,22,28,5
S01012362,Owned: Total,58,41,33,5,28,7,1,17,15,0,0,2,0
S01012362,Owned: Owned outright,25,9,7,2,5,1,1,16,14,0,0,2,0
S01012362,Owned: Owned with a mortgage or loan or shared ownership,33,32,26,3,23,6,0,1,1,0,0,0,0
S01012362,Rented or living rent free: Total,248,159,123,38,85,16,20,89,34,2,22,26,5
S01012362,Rented or living rent free: Social rented,233,150,117,37,80,14,19,83,32,2,20,25,4
S01012362,Rented or living rent free: Private rented or living rent free,15,9,6,1,5,2,1,6,2,0,2,1,1
S01012363,All HRPs aged 16 and over,575,317,229,50,179,42,46,258,187,10,11,44,6
S01012363,Owned: Total,257,147,114,19,95,29,4,110,100,0,1,7,2
S01012363,Owned: Owned outright,144,42,32,9,23,7,3,102,96,0,1,5,0
S01012363,Owned: Owned with a mortgage or loan or shared ownership,113,105,82,10,72,22,1,8,4,0,0,2,2
S01012363,Rented or living rent free: Total,318,170,115,31,84,13,42,148,87,10,10,37,4
S01012363,Rented or living rent free: Social rented,186,86,60,15,45,5,21,100,61,2,6,29,2
S01012363,Rented or living rent free: Private rented or living rent free,132,84,55,16,39,8,21,48,26,8,4,8,2
S01012364,All HRPs aged 16 and over,375,215,165,28,137,28,22,160,131,5,3,14,7
S01012364,Owned: Total,223,145,116,18,98,24,5,78,75,0,0,3,0
S01012364,Owned: Owned outright,124,52,39,12,27,10,3,72,69,0,0,3,0
S01012364,Owned: Owned with a mortgage or loan or shared ownership,99,93,77,6,71,14,2,6,6,0,0,0,0
S01012364,Rented or living rent free: Total,152,70,49,10,39,4,17,82,56,5,3,11,7
S01012364,Rented or living rent free: Social rented,47,2,2,1,1,0,0,45,39,0,0,4,2
S01012364,Rented or living rent free: Private rented or living rent free,105,68,47,9,38,4,17,37,17,5,3,7,5
S01012365,All HRPs aged 16 and over,443,282,236,30,206,40,6,161,147,0,2,10,2
S01012365,Owned: Total,360,232,196,22,174,36,0,128,126,0,0,1,1
S01012365,Owned: Owned outright,200,75,67,15,52,8,0,125,123,0,0,1,1
S01012365,Owned: Owned with a mortgage or loan or shared ownership,160,157,129,7,122,28,0,3,3,0,0,0,0
S01012365,Rented or living rent free: Total,83,50,40,8,32,4,6,33,21,0,2,9,1
S01012365,Rented or living rent free: Social rented,32,12,8,5,3,1,3,20,10,0,1,8,1
S01012365,Rented or living rent free: Private rented or living rent free,51,38,32,3,29,3,3,13,11,0,1,1,0
S01012366,All HRPs aged 16 and over,513,303,245,40,205,38,20,210,175,3,3,25,4
S01012366,Owned: Total,328,210,174,24,150,31,5,118,110,0,0,6,2
S01012366,Owned: Owned outright,187,75,58,18,40,13,4,112,105,0,0,6,1
S01012366,Owned: Owned with a mortgage or loan or shared ownership,141,135,116,6,110,18,1,6,5,0,0,0,1
S01012366,Rented or living rent free: Total,185,93,71,16,55,7,15,92,65,3,3,19,2
S01012366,Rented or living rent free: Social rented,49,5,2,1,1,0,3,44,40,0,1,3,0
S01012366,Rented or living rent free: Private rented or living rent free,136,88,69,15,54,7,12,48,25,3,2,16,2
S01012367,All HRPs aged 16 and over,420,249,211,32,179,30,8,171,154,2,2,13,0
S01012367,Owned: Total,309,197,171,21,150,24,2,112,109,0,0,3,0
S01012367,Owned: Owned outright,179,79,67,12,55,10,2,100,98,0,0,2,0
S01012367,Owned: Owned with a mortgage or loan or shared ownership,130,118,104,9,95,14,0,12,11,0,0,1,0
S01012367,Rented or living rent free: Total,111,52,40,11,29,6,6,59,45,2,2,10,0
S01012367,Rented or living rent free: Social rented,72,31,25,8,17,2,4,41,34,0,2,5,0
S01012367,Rented or living rent free: Private rented or living rent free,39,21,15,3,12,4,2,18,11,2,0,5,0
S01012368,All HRPs aged 16 and over,261,156,117,28,89,35,4,105,97,0,1,6,1
S01012368,Owned: Total,221,136,102,23,79,33,1,85,83,0,0,1,1
S01012368,Owned: Owned outright,138,59,46,18,28,12,1,79,77,0,0,1,1
S01012368,Owned: Owned with a mortgage or loan or shared ownership,83,77,56,5,51,21,0,6,6,0,0,0,0
S01012368,Rented or living rent free: Total,40,20,15,5,10,2,3,20,14,0,1,5,0
S01012368,Rented or living rent free: Social rented,33,16,13,4,9,1,2,17,11,0,1,5,0
S01012368,Rented or living rent free: Private rented or living rent free,7,4,2,1,1,1,1,3,3,0,0,0,0
S01012369,All HRPs aged 16 and over,375,235,178,22,156,52,5,140,122,1,1,13,3
S01012369,Owned: Total,285,179,134,15,119,44,1,106,102,1,0,2,1
S01012369,Owned: Owned outright,154,56,39,8,31,16,1,98,97,0,0,1,0
S01012369,Owned: Owned with a mortgage or loan or shared ownership,131,123,95,7,88,28,0,8,5,1,0,1,1
S01012369,Rented or living rent free: Total,90,56,44,7,37,8,4,34,20,0,1,11,2
S01012369,Rented or living rent free: Social rented,49,28,22,5,17,2,4,21,9,0,0,10,2
S01012369,Rented or living rent free: Private rented or living rent free,41,28,22,2,20,6,0,13,11,0,1,1,0
S01012370,All HRPs aged 16 and over,516,282,221,42,179,46,15,234,193,3,2,26,10
S01012370,Owned: Total,255,172,134,15,119,37,1,83,77,0,0,1,5
S01012370,Owned: Owned outright,126,52,40,11,29,11,1,74,70,0,0,0,4
S01012370,Owned: Owned with a mortgage or loan or shared ownership,129,120,94,4,90,26,0,9,7,0,0,1,1
S01012370,Rented or living rent free: Total,261,110,87,27,60,9,14,151,116,3,2,25,5
S01012370,Rented or living rent free: Social rented,215,84,64,19,45,8,12,131,102,2,1,23,3
S01012370,Rented or living rent free: Private rented or living rent free,46,26,23,8,15,1,2,20,14,1,1,2,2
S01012371,All HRPs aged 16 and over,486,293,233,45,188,32,28,193,149,2,7,25,10
S01012371,Owned: Total,269,176,148,19,129,26,2,93,87,0,1,3,2
S01012371,Owned: Owned outright,136,51,41,9,32,9,1,85,79,0,1,3,2
S01012371,Owned: Owned with a mortgage or loan or shared ownership,133,125,107,10,97,17,1,8,8,0,0,0,0
S01012371,Rented or living rent free: Total,217,117,85,26,59,6,26,100,62,2,6,22,8
S01012371,Rented or living rent free: Social rented,142,63,40,13,27,2,21,79,48,2,4,19,6
S01012371,Rented or living rent free: Private rented or living rent free,75,54,45,13,32,4,5,21,14,0,2,3,2
S01012372,All HRPs aged 16 and over,450,247,189,32,157,35,23,203,149,5,5,38,6
S01012372,Owned: Total,213,132,104,12,92,22,6,81,76,0,0,4,1
S01012372,Owned: Owned outright,117,42,30,4,26,9,3,75,72,0,0,3,0
S01012372,Owned: Owned with a mortgage or loan or shared ownership,96,90,74,8,66,13,3,6,4,0,0,1,1
S01012372,Rented or living rent free: Total,237,115,85,20,65,13,17,122,73,5,5,34,5
S01012372,Rented or living rent free: Social rented,161,61,46,15,31,6,9,100,62,1,4,29,4
S01012372,Rented or living rent free: Private rented or living rent free,76,54,39,5,34,7,8,22,11,4,1,5,1
S01012373,All HRPs aged 16 and over,479,287,226,33,193,38,23,192,150,0,4,25,13
S01012373,Owned: Total,322,197,161,19,142,34,2,125,118,0,1,3,3
S01012373,Owned: Owned outright,183,65,49,9,40,16,0,118,112,0,1,3,2
S01012373,Owned: Owned with a mortgage or loan or shared ownership,139,132,112,10,102,18,2,7,6,0,0,0,1
S01012373,Rented or living rent free: Total,157,90,65,14,51,4,21,67,32,0,3,22,10
S01012373,Rented or living rent free: Social rented,113,59,42,11,31,0,17,54,20,0,3,21,10
S01012373,Rented or living rent free: Private rented or living rent free,44,31,23,3,20,4,4,13,12,0,0,1,0
S01012374,All HRPs aged 16 and over,402,266,215,43,172,45,6,136,115,1,5,10,5
S01012374,Owned: Total,286,204,168,26,142,35,1,82,78,0,0,3,1
S01012374,Owned: Owned outright,128,59,47,11,36,11,1,69,67,0,0,1,1
S01012374,Owned: Owned with a mortgage or loan or shared ownership,158,145,121,15,106,24,0,13,11,0,0,2,0
S01012374,Rented or living rent free: Total,116,62,47,17,30,10,5,54,37,1,5,7,4
S01012374,Rented or living rent free: Social rented,100,54,39,15,24,10,5,46,31,1,4,6,4
S01012374,Rented or living rent free: Private rented or living rent free,16,8,8,2,6,0,0,8,6,0,1,1,0
S01012375,All HRPs aged 16 and over,429,268,226,36,190,20,22,161,136,0,9,10,6
S01012375,Owned: Total,223,151,135,10,125,14,2,72,72,0,0,0,0
S01012375,Owned: Owned outright,101,36,31,6,25,3,2,65,65,0,0,0,0
S01012375,Owned: Owned with a mortgage or loan or shared ownership,122,115,104,4,100,11,0,7,7,0,0,0,0
S01012375,Rented or living rent free: Total,206,117,91,26,65,6,20,89,64,0,9,10,6
S01012375,Rented or living rent free: Social rented,180,97,74,21,53,4,19,83,59,0,9,9,6
S01012375,Rented or living rent free: Private rented or living rent free,26,20,17,5,12,2,1,6,5,0,0,1,0
S01012376,All HRPs aged 16 and over,407,293,184,28,156,95,14,114,99,6,2,4,3
S01012376,Owned: Total,301,211,136,19,117,70,5,90,80,6,1,2,1
S01012376,Owned: Owned outright,176,100,61,15,46,36,3,76,71,4,0,0,1
S01012376,Owned: Owned with a mortgage or loan or shared ownership,125,111,75,4,71,34,2,14,9,2,1,2,0
S01012376,Rented or living rent free: Total,106,82,48,9,39,25,9,24,19,0,1,2,2
S01012376,Rented or living rent free: Social rented,18,13,10,3,7,1,2,5,2,0,1,1,1
S01012376,Rented or living rent free: Private rented or living rent free,88,69,38,6,32,24,7,19,17,0,0,1,1
S01012377,All HRPs aged 16 and over,324,219,143,26,117,75,1,105,87,8,1,5,4
S01012377,Owned: Total,213,134,78,10,68,56,0,79,72,5,0,1,1
S01012377,Owned: Owned outright,142,67,36,6,30,31,0,75,68,5,0,1,1
S01012377,Owned: Owned with a mortgage or loan or shared ownership,71,67,42,4,38,25,0,4,4,0,0,0,0
S01012377,Rented or living rent free: Total,111,85,65,16,49,19,1,26,15,3,1,4,3
S01012377,Rented or living rent free: Social rented,40,25,25,7,18,0,0,15,9,0,1,4,1
S01012377,Rented or living rent free: Private rented or living rent free,71,60,40,9,31,19,1,11,6,3,0,0,2
S01012378,All HRPs aged 16 and over,250,172,105,16,89,65,2,78,71,0,1,5,1
S01012378,Owned: Total,132,79,38,4,34,41,0,53,52,0,0,1,0
S01012378,Owned: Owned outright,86,36,16,2,14,20,0,50,49,0,0,1,0
S01012378,Owned: Owned with a mortgage or loan or shared ownership,46,43,22,2,20,21,0,3,3,0,0,0,0
S01012378,Rented or living rent free: Total,118,93,67,12,55,24,2,25,19,0,1,4,1
S01012378,Rented or living rent free: Social rented,15,10,10,3,7,0,0,5,2,0,1,1,1
S01012378,Rented or living rent free: Private rented or living rent free,103,83,57,9,48,24,2,20,17,0,0,3,0
S01012379,All HRPs aged 16 and over,227,144,102,15,87,41,1,83,75,4,0,3,1
S01012379,Owned: Total,127,70,42,6,36,28,0,57,54,2,0,1,0
S01012379,Owned: Owned outright,84,32,17,4,13,15,0,52,49,2,0,1,0
S01012379,Owned: Owned with a mortgage or loan or shared ownership,43,38,25,2,23,13,0,5,5,0,0,0,0
S01012379,Rented or living rent free: Total,100,74,60,9,51,13,1,26,21,2,0,2,1
S01012379,Rented or living rent free: Social rented,19,16,14,3,11,1,1,3,1,0,0,1,1
S01012379,Rented or living rent free: Private rented or living rent free,81,58,46,6,40,12,0,23,20,2,0,1,0
S01012380,All HRPs aged 16 and over,423,293,240,44,196,43,10,130,108,1,3,17,1
S01012380,Owned: Total,247,177,142,22,120,35,0,70,67,1,1,1,0
S01012380,Owned: Owned outright,119,57,46,14,32,11,0,62,59,1,1,1,0
S01012380,Owned: Owned with a mortgage or loan or shared ownership,128,120,96,8,88,24,0,8,8,0,0,0,0
S01012380,Rented or living rent free: Total,176,116,98,22,76,8,10,60,41,0,2,16,1
S01012380,Rented or living rent free: Social rented,151,98,84,20,64,5,9,53,36,0,2,14,1
S01012380,Rented or living rent free: Private rented or living rent free,25,18,14,2,12,3,1,7,5,0,0,2,0
S01012381,All HRPs aged 16 and over,456,231,186,45,141,34,11,225,195,1,8,15,6
S01012381,Owned: Total,230,146,117,25,92,26,3,84,80,1,0,2,1
S01012381,Owned: Owned outright,126,55,43,14,29,10,2,71,70,0,0,1,0
S01012381,Owned: Owned with a mortgage or loan or shared ownership,104,91,74,11,63,16,1,13,10,1,0,1,1
S01012381,Rented or living rent free: Total,226,85,69,20,49,8,8,141,115,0,8,13,5
S01012381,Rented or living rent free: Social rented,173,48,36,16,20,4,8,125,103,0,6,12,4
S01012381,Rented or living rent free: Private rented or living rent free,53,37,33,4,29,4,0,16,12,0,2,1,1
S01012382,All HRPs aged 16 and over,437,281,218,31,187,60,3,156,142,0,1,9,4
S01012382,Owned: Total,359,248,188,24,164,58,2,111,107,0,0,2,2
S01012382,Owned: Owned outright,210,108,78,20,58,29,1,102,99,0,0,2,1
S01012382,Owned: Owned with a mortgage or loan or shared ownership,149,140,110,4,106,29,1,9,8,0,0,0,1
S01012382,Rented or living rent free: Total,78,33,30,7,23,2,1,45,35,0,1,7,2
S01012382,Rented or living rent free: Social rented,54,21,19,6,13,1,1,33,25,0,1,6,1
S01012382,Rented or living rent free: Private rented or living rent free,24,12,11,1,10,1,0,12,10,0,0,1,1
S01012383,All HRPs aged 16 and over,424,247,205,38,167,36,6,177,158,1,6,9,3
S01012383,Owned: Total,281,180,153,24,129,26,1,101,95,1,2,0,3
S01012383,Owned: Owned outright,165,72,62,18,44,9,1,93,89,0,1,0,3
S01012383,Owned: Owned with a mortgage or loan or shared ownership,116,108,91,6,85,17,0,8,6,1,1,0,0
S01012383,Rented or living rent free: Total,143,67,52,14,38,10,5,76,63,0,4,9,0
S01012383,Rented or living rent free: Social rented,89,28,21,10,11,3,4,61,49,0,4,8,0
S01012383,Rented or living rent free: Private rented or living rent free,54,39,31,4,27,7,1,15,14,0,0,1,0
S01012384,All HRPs aged 16 and over,267,168,135,15,120,24,9,99,82,2,6,7,2
S01012384,Owned: Total,171,113,90,7,83,20,3,58,52,1,2,3,0
S01012384,Owned: Owned outright,87,33,23,5,18,8,2,54,50,1,1,2,0
S01012384,Owned: Owned with a mortgage or loan or shared ownership,84,80,67,2,65,12,1,4,2,0,1,1,0
S01012384,Rented or living rent free: Total,96,55,45,8,37,4,6,41,30,1,4,4,2
S01012384,Rented or living rent free: Social rented,48,19,11,3,8,3,5,29,20,0,3,4,2
S01012384,Rented or living rent free: Private rented or living rent free,48,36,34,5,29,1,1,12,10,1,1,0,0
S01012385,All HRPs aged 16 and over,332,253,190,22,168,49,14,79,63,0,2,12,2
S01012385,Owned: Total,236,182,139,13,126,40,3,54,50,0,2,2,0
S01012385,Owned: Owned outright,116,67,48,6,42,16,3,49,46,0,1,2,0
S01012385,Owned: Owned with a mortgage or loan or shared ownership,120,115,91,7,84,24,0,5,4,0,1,0,0
S01012385,Rented or living rent free: Total,96,71,51,9,42,9,11,25,13,0,0,10,2
S01012385,Rented or living rent free: Social rented,41,25,16,2,14,3,6,16,5,0,0,9,2
S01012385,Rented or living rent free: Private rented or living rent free,55,46,35,7,28,6,5,9,8,0,0,1,0
S01012386,All HRPs aged 16 and over,440,291,230,54,176,32,29,149,104,2,16,17,10
S01012386,Owned: Total,156,110,91,17,74,18,1,46,44,1,0,1,0
S01012386,Owned: Owned outright,79,34,27,12,15,6,1,45,43,1,0,1,0
S01012386,Owned: Owned with a mortgage or loan or shared ownership,77,76,64,5,59,12,0,1,1,0,0,0,0
S01012386,Rented or living rent free: Total,284,181,139,37,102,14,28,103,60,1,16,16,10
S01012386,Rented or living rent free: Social rented,248,161,123,34,89,13,25,87,49,0,14,14,10
S01012386,Rented or living rent free: Private rented or living rent free,36,20,16,3,13,1,3,16,11,1,2,2,0
S01012387,All HRPs aged 16 and over,407,304,244,41,203,56,4,103,89,3,3,4,4
S01012387,Owned: Total,273,197,157,19,138,40,0,76,72,1,0,2,1
S01012387,Owned: Owned outright,166,94,71,16,55,23,0,72,69,1,0,1,1
S01012387,Owned: Owned with a mortgage or loan or shared ownership,107,103,86,3,83,17,0,4,3,0,0,1,0
S01012387,Rented or living rent free: Total,134,107,87,22,65,16,4,27,17,2,3,2,3
S01012387,Rented or living rent free: Social rented,75,59,52,15,37,3,4,16,9,0,3,2,2
S01012387,Rented or living rent free: Private rented or living rent free,59,48,35,7,28,13,0,11,8,2,0,0,1
S01012388,All HRPs aged 16 and over,306,238,201,22,179,37,0,68,62,1,0,2,3
S01012388,Owned: Total,273,216,182,21,161,34,0,57,54,0,0,1,2
S01012388,Owned: Owned outright,156,102,82,13,69,20,0,54,52,0,0,1,1
S01012388,Owned: Owned with a mortgage or loan or shared ownership,117,114,100,8,92,14,0,3,2,0,0,0,1
S01012388,Rented or living rent free: Total,33,22,19,1,18,3,0,11,8,1,0,1,1
S01012388,Rented or living rent free: Social rented,13,5,5,1,4,0,0,8,5,1,0,1,1
S01012388,Rented or living rent free: Private rented or living rent free,20,17,14,0,14,3,0,3,3,0,0,0,0
S01012389,All HRPs aged 16 and over,339,267,226,29,197,37,4,72,59,0,0,11,2
S01012389,Owned: Total,243,200,166,17,149,33,1,43,41,0,0,1,1
S01012389,Owned: Owned outright,114,74,55,8,47,19,0,40,38,0,0,1,1
S01012389,Owned: Owned with a mortgage or loan or shared ownership,129,126,111,9,102,14,1,3,3,0,0,0,0
S01012389,Rented or living rent free: Total,96,67,60,12,48,4,3,29,18,0,0,10,1
S01012389,Rented or living rent free: Social rented,67,41,35,10,25,3,3,26,15,0,0,10,1
S01012389,Rented or living rent free: Private rented or living rent free,29,26,25,2,23,1,0,3,3,0,0,0,0
S01012390,All HRPs aged 16 and over,307,225,196,27,169,28,1,82,71,0,2,6,3
S01012390,Owned: Total,232,173,146,18,128,26,1,59,52,0,1,3,3
S01012390,Owned: Owned outright,135,78,62,14,48,15,1,57,50,0,1,3,3
S01012390,Owned: Owned with a mortgage or loan or shared ownership,97,95,84,4,80,11,0,2,2,0,0,0,0
S01012390,Rented or living rent free: Total,75,52,50,9,41,2,0,23,19,0,1,3,0
S01012390,Rented or living rent free: Social rented,48,30,29,8,21,1,0,18,14,0,1,3,0
S01012390,Rented or living rent free: Private rented or living rent free,27,22,21,1,20,1,0,5,5,0,0,0,0
S01012391,All HRPs aged 16 and over,412,336,295,36,259,37,4,76,64,1,2,6,3
S01012391,Owned: Total,320,261,229,28,201,32,0,59,57,0,0,1,1
S01012391,Owned: Owned outright,148,94,81,23,58,13,0,54,53,0,0,0,1
S01012391,Owned: Owned with a mortgage or loan or shared ownership,172,167,148,5,143,19,0,5,4,0,0,1,0
S01012391,Rented or living rent free: Total,92,75,66,8,58,5,4,17,7,1,2,5,2
S01012391,Rented or living rent free: Social rented,50,37,33,5,28,2,2,13,4,0,2,5,2
S01012391,Rented or living rent free: Private rented or living rent free,42,38,33,3,30,3,2,4,3,1,0,0,0
S01012392,All HRPs aged 16 and over,327,252,222,42,180,21,9,75,53,0,1,17,4
S01012392,Owned: Total,185,148,130,11,119,18,0,37,36,0,0,0,1
S01012392,Owned: Owned outright,97,62,52,9,43,10,0,35,34,0,0,0,1
S01012392,Owned: Owned with a mortgage or loan or shared ownership,88,86,78,2,76,8,0,2,2,0,0,0,0
S01012392,Rented or living rent free: Total,142,104,92,31,61,3,9,38,17,0,1,17,3
S01012392,Rented or living rent free: Social rented,127,94,84,31,53,2,8,33,12,0,1,17,3
S01012392,Rented or living rent free: Private rented or living rent free,15,10,8,0,8,1,1,5,5,0,0,0,0
S01012393,All HRPs aged 16 and over,377,286,248,43,205,37,1,91,75,0,2,11,3
S01012393,Owned: Total,265,208,175,22,153,33,0,57,56,0,1,0,0
S01012393,Owned: Owned outright,146,89,70,15,55,19,0,57,56,0,1,0,0
S01012393,Owned: Owned with a mortgage or loan or shared ownership,119,119,105,7,98,14,0,0,0,0,0,0,0
S01012393,Rented or living rent free: Total,112,78,73,21,52,4,1,34,19,0,1,11,3
S01012393,Rented or living rent free: Social rented,81,48,46,20,26,2,0,33,18,0,1,11,3
S01012393,Rented or living rent free: Private rented or living rent free,31,30,27,1,26,2,1,1,1,0,0,0,0
S01012394,All HRPs aged 16 and over,276,204,178,41,137,15,11,72,44,2,6,14,6
S01012394,Owned: Total,109,83,70,9,61,12,1,26,24,0,0,0,2
S01012394,Owned: Owned outright,53,30,22,3,19,7,1,23,22,0,0,0,1
S01012394,Owned: Owned with a mortgage or loan or shared ownership,56,53,48,6,42,5,0,3,2,0,0,0,1
S01012394,Rented or living rent free: Total,167,121,108,32,76,3,10,46,20,2,6,14,4
S01012394,Rented or living rent free: Social rented,155,112,100,32,68,2,10,43,19,2,5,13,4
S01012394,Rented or living rent free: Private rented or living rent free,12,9,8,0,8,1,0,3,1,0,1,1,0
S01012395,All HRPs aged 16 and over,279,191,162,37,125,25,4,88,78,0,0,8,2
S01012395,Owned: Total,181,127,106,21,85,21,0,54,51,0,0,1,2
S01012395,Owned: Owned outright,103,51,38,12,26,13,0,52,50,0,0,1,1
S01012395,Owned: Owned with a mortgage or loan or shared ownership,78,76,68,9,59,8,0,2,1,0,0,0,1
S01012395,Rented or living rent free: Total,98,64,56,16,40,4,4,34,27,0,0,7,0
S01012395,Rented or living rent free: Social rented,74,41,35,15,20,3,3,33,26,0,0,7,0
S01012395,Rented or living rent free: Private rented or living rent free,24,23,21,1,20,1,1,1,1,0,0,0,0
S01012396,All HRPs aged 16 and over,312,201,173,22,151,21,7,111,88,0,3,17,3
S01012396,Owned: Total,181,110,88,15,73,19,3,71,68,0,0,1,2
S01012396,Owned: Owned outright,107,40,30,8,22,9,1,67,65,0,0,0,2
S01012396,Owned: Owned with a mortgage or loan or shared ownership,74,70,58,7,51,10,2,4,3,0,0,1,0
S01012396,Rented or living rent free: Total,131,91,85,7,78,2,4,40,20,0,3,16,1
S01012396,Rented or living rent free: Social rented,73,37,34,6,28,0,3,36,16,0,3,16,1
S01012396,Rented or living rent free: Private rented or living rent free,58,54,51,1,50,2,1,4,4,0,0,0,0
S01012397,All HRPs aged 16 and over,418,274,236,42,194,33,5,144,126,1,0,14,3
S01012397,Owned: Total,246,169,139,20,119,28,2,77,77,0,0,0,0
S01012397,Owned: Owned outright,152,80,59,14,45,20,1,72,72,0,0,0,0
S01012397,Owned: Owned with a mortgage or loan or shared ownership,94,89,80,6,74,8,1,5,5,0,0,0,0
S01012397,Rented or living rent free: Total,172,105,97,22,75,5,3,67,49,1,0,14,3
S01012397,Rented or living rent free: Social rented,126,65,60,17,43,2,3,61,43,1,0,14,3
S01012397,Rented or living rent free: Private rented or living rent free,46,40,37,5,32,3,0,6,6,0,0,0,0
S01012398,All HRPs aged 16 and over,432,309,277,35,242,29,3,123,98,1,4,13,7
S01012398,Owned: Total,213,156,136,14,122,20,0,57,50,0,2,1,4
S01012398,Owned: Owned outright,109,56,48,5,43,8,0,53,48,0,2,1,2
S01012398,Owned: Owned with a mortgage or loan or shared ownership,104,100,88,9,79,12,0,4,2,0,0,0,2
S01012398,Rented or living rent free: Total,219,153,141,21,120,9,3,66,48,1,2,12,3
S01012398,Rented or living rent free: Social rented,125,67,63,18,45,1,3,58,41,0,2,12,3
S01012398,Rented or living rent free: Private rented or living rent free,94,86,78,3,75,8,0,8,7,1,0,0,0
S01012399,All HRPs aged 16 and over,287,189,176,24,152,12,1,98,75,2,5,10,6
S01012399,Owned: Total,145,101,92,11,81,9,0,44,41,0,0,1,2
S01012399,Owned: Owned outright,82,41,37,8,29,4,0,41,38,0,0,1,2
S01012399,Owned: Owned with a mortgage or loan or shared ownership,63,60,55,3,52,5,0,3,3,0,0,0,0
S01012399,Rented or living rent free: Total,142,88,84,13,71,3,1,54,34,2,5,9,4
S01012399,Rented or living rent free: Social rented,118,66,62,12,50,3,1,52,32,2,5,9,4
S01012399,Rented or living rent free: Private rented or living rent free,24,22,22,1,21,0,0,2,2,0,0,0,0
S01012400,All HRPs aged 16 and over,274,214,177,32,145,26,11,60,46,0,3,8,3
S01012400,Owned: Total,117,87,70,15,55,16,1,30,30,0,0,0,0
S01012400,Owned: Owned outright,61,34,27,11,16,6,1,27,27,0,0,0,0
S01012400,Owned: Owned with a mortgage or loan or shared ownership,56,53,43,4,39,10,0,3,3,0,0,0,0
S01012400,Rented or living rent free: Total,157,127,107,17,90,10,10,30,16,0,3,8,3
S01012400,Rented or living rent free: Social rented,105,82,68,17,51,4,10,23,11,0,3,8,1
S01012400,Rented or living rent free: Private rented or living rent free,52,45,39,0,39,6,0,7,5,0,0,0,2
S01012401,All HRPs aged 16 and over,408,316,272,45,227,21,23,92,59,2,1,17,13
S01012401,Owned: Total,184,145,132,20,112,13,0,39,34,0,0,2,3
S01012401,Owned: Owned outright,102,66,58,14,44,8,0,36,32,0,0,2,2
S01012401,Owned: Owned with a mortgage or loan or shared ownership,82,79,74,6,68,5,0,3,2,0,0,0,1
S01012401,Rented or living rent free: Total,224,171,140,25,115,8,23,53,25,2,1,15,10
S01012401,Rented or living rent free: Social rented,203,152,121,25,96,8,23,51,25,1,1,14,10
S01012401,Rented or living rent free: Private rented or living rent free,21,19,19,0,19,0,0,2,0,1,0,1,0
S01012402,All HRPs aged 16 and over,184,160,125,15,110,31,4,24,22,0,0,1,1
S01012402,Owned: Total,153,135,107,9,98,27,1,18,17,0,0,0,1
S01012402,Owned: Owned outright,77,62,46,8,38,15,1,15,15,0,0,0,0
S01012402,Owned: Owned with a mortgage or loan or shared ownership,76,73,61,1,60,12,0,3,2,0,0,0,1
S01012402,Rented or living rent free: Total,31,25,18,6,12,4,3,6,5,0,0,1,0
S01012402,Rented or living rent free: Social rented,10,8,6,3,3,1,1,2,1,0,0,1,0
S01012402,Rented or living rent free: Private rented or living rent free,21,17,12,3,9,3,2,4,4,0,0,0,0
S01012403,All HRPs aged 16 and over,437,338,265,36,229,70,3,99,91,0,2,4,2
S01012403,Owned: Total,334,253,189,19,170,62,2,81,78,0,0,1,2
S01012403,Owned: Owned outright,195,116,77,13,64,38,1,79,76,0,0,1,2
S01012403,Owned: Owned with a mortgage or loan or shared ownership,139,137,112,6,106,24,1,2,2,0,0,0,0
S01012403,Rented or living rent free: Total,103,85,76,17,59,8,1,18,13,0,2,3,0
S01012403,Rented or living rent free: Social rented,49,38,35,13,22,2,1,11,7,0,2,2,0
S01012403,Rented or living rent free: Private rented or living rent free,54,47,41,4,37,6,0,7,6,0,0,1,0
S01012404,All HRPs aged 16 and over,448,324,273,32,241,40,11,124,103,3,3,10,5
S01012404,Owned: Total,258,179,143,14,129,32,4,79,73,0,3,3,0
S01012404,Owned: Owned outright,146,73,57,10,47,15,1,73,69,0,3,1,0
S01012404,Owned: Owned with a mortgage or loan or shared ownership,112,106,86,4,82,17,3,6,4,0,0,2,0
S01012404,Rented or living rent free: Total,190,145,130,18,112,8,7,45,30,3,0,7,5
S01012404,Rented or living rent free: Social rented,124,81,70,18,52,4,7,43,28,3,0,7,5
S01012404,Rented or living rent free: Private rented or living rent free,66,64,60,0,60,4,0,2,2,0,0,0,0
S01012405,All HRPs aged 16 and over,274,232,193,12,181,39,0,42,41,0,0,1,0
S01012405,Owned: Total,241,202,167,9,158,35,0,39,39,0,0,0,0
S01012405,Owned: Owned outright,115,78,60,7,53,18,0,37,37,0,0,0,0
S01012405,Owned: Owned with a mortgage or loan or shared ownership,126,124,107,2,105,17,0,2,2,0,0,0,0
S01012405,Rented or living rent free: Total,33,30,26,3,23,4,0,3,2,0,0,1,0
S01012405,Rented or living rent free: Social rented,7,6,6,1,5,0,0,1,1,0,0,0,0
S01012405,Rented or living rent free: Private rented or living rent free,26,24,20,2,18,4,0,2,1,0,0,1,0
S01012406,All HRPs aged 16 and over,260,183,144,16,128,35,4,77,64,0,2,7,4
S01012406,Owned: Total,201,142,114,11,103,26,2,59,52,0,2,4,1
S01012406,Owned: Owned outright,113,55,35,7,28,18,2,58,51,0,2,4,1
S01012406,Owned: Owned with a mortgage or loan or shared ownership,88,87,79,4,75,8,0,1,1,0,0,0,0
S01012406,Rented or living rent free: Total,59,41,30,5,25,9,2,18,12,0,0,3,3
S01012406,Rented or living rent free: Social rented,36,25,21,5,16,3,1,11,6,0,0,2,3
S01012406,Rented or living rent free: Private rented or living rent free,23,16,9,0,9,6,1,7,6,0,0,1,0
S01012407,All HRPs aged 16 and over,335,258,202,34,168,50,6,77,66,1,2,8,0
S01012407,Owned: Total,218,175,135,18,117,39,1,43,41,1,0,1,0
S01012407,Owned: Owned outright,117,78,52,11,41,25,1,39,37,1,0,1,0
S01012407,Owned: Owned with a mortgage or loan or shared ownership,101,97,83,7,76,14,0,4,4,0,0,0,0
S01012407,Rented or living rent free: Total,117,83,67,16,51,11,5,34,25,0,2,7,0
S01012407,Rented or living rent free: Social rented,90,63,50,14,36,8,5,27,20,0,1,6,0
S01012407,Rented or living rent free: Private rented or living rent free,27,20,17,2,15,3,0,7,5,0,1,1,0
S01012408,All HRPs aged 16 and over,250,191,140,20,120,49,2,59,54,0,0,2,3
S01012408,Owned: Total,194,155,111,14,97,43,1,39,38,0,0,0,1
S01012408,Owned: Owned outright,117,79,56,12,44,22,1,38,37,0,0,0,1
S01012408,Owned: Owned with a mortgage or loan or shared ownership,77,76,55,2,53,21,0,1,1,0,0,0,0
S01012408,Rented or living rent free: Total,56,36,29,6,23,6,1,20,16,0,0,2,2
S01012408,Rented or living rent free: Social rented,16,7,6,1,5,1,0,9,6,0,0,2,1
S01012408,Rented or living rent free: Private rented or living rent free,40,29,23,5,18,5,1,11,10,0,0,0,1
S01012409,All HRPs aged 16 and over,311,216,167,23,144,43,6,95,82,0,3,7,3
S01012409,Owned: Total,205,142,109,15,94,31,2,63,58,0,2,2,1
S01012409,Owned: Owned outright,133,72,52,11,41,18,2,61,56,0,2,2,1
S01012409,Owned: Owned with a mortgage or loan or shared ownership,72,70,57,4,53,13,0,2,2,0,0,0,0
S01012409,Rented or living rent free: Total,106,74,58,8,50,12,4,32,24,0,1,5,2
S01012409,Rented or living rent free: Social rented,60,39,31,2,29,5,3,21,14,0,1,4,2
S01012409,Rented or living rent free: Private rented or living rent free,46,35,27,6,21,7,1,11,10,0,0,1,0
S01012410,All HRPs aged 16 and over,420,336,289,32,257,42,5,84,67,1,5,11,0
S01012410,Owned: Total,268,221,186,12,174,35,0,47,43,0,2,2,0
S01012410,Owned: Owned outright,141,95,70,9,61,25,0,46,42,0,2,2,0
S01012410,Owned: Owned with a mortgage or loan or shared ownership,127,126,116,3,113,10,0,1,1,0,0,0,0
S01012410,Rented or living rent free: Total,152,115,103,20,83,7,5,37,24,1,3,9,0
S01012410,Rented or living rent free: Social rented,108,78,68,17,51,5,5,30,18,1,3,8,0
S01012410,Rented or living rent free: Private rented or living rent free,44,37,35,3,32,2,0,7,6,0,0,1,0
S01012411,All HRPs aged 16 and over,410,322,282,45,237,37,3,88,60,3,2,20,3
S01012411,Owned: Total,229,191,157,13,144,33,1,38,37,0,0,1,0
S01012411,Owned: Owned outright,122,86,60,6,54,25,1,36,36,0,0,0,0
S01012411,Owned: Owned with a mortgage or loan or shared ownership,107,105,97,7,90,8,0,2,1,0,0,1,0
S01012411,Rented or living rent free: Total,181,131,125,32,93,4,2,50,23,3,2,19,3
S01012411,Rented or living rent free: Social rented,151,112,109,31,78,1,2,39,14,3,2,17,3
S01012411,Rented or living rent free: Private rented or living rent free,30,19,16,1,15,3,0,11,9,0,0,2,0
S01012412,All HRPs aged 16 and over,281,202,155,34,121,43,4,79,68,0,2,7,2
S01012412,Owned: Total,177,136,103,21,82,33,0,41,37,0,1,2,1
S01012412,Owned: Owned outright,123,83,56,16,40,27,0,40,36,0,1,2,1
S01012412,Owned: Owned with a mortgage or loan or shared ownership,54,53,47,5,42,6,0,1,1,0,0,0,0
S01012412,Rented or living rent free: Total,104,66,52,13,39,10,4,38,31,0,1,5,1
S01012412,Rented or living rent free: Social rented,68,39,34,9,25,2,3,29,24,0,1,3,1
S01012412,Rented or living rent free: Private rented or living rent free,36,27,18,4,14,8,1,9,7,0,0,2,0
S01012413,All HRPs aged 16 and over,419,270,231,42,189,39,0,149,135,0,2,8,4
S01012413,Owned: Total,306,205,171,31,140,34,0,101,96,0,0,3,2
S01012413,Owned: Owned outright,203,108,86,23,63,22,0,95,91,0,0,2,2
S01012413,Owned: Owned with a mortgage or loan or shared ownership,103,97,85,8,77,12,0,6,5,0,0,1,0
S01012413,Rented or living rent free: Total,113,65,60,11,49,5,0,48,39,0,2,5,2
S01012413,Rented or living rent free: Social rented,50,29,29,5,24,0,0,21,15,0,1,3,2
S01012413,Rented or living rent free: Private rented or living rent free,63,36,31,6,25,5,0,27,24,0,1,2,0
S01012414,All HRPs aged 16 and over,341,219,166,39,127,44,9,122,106,3,2,8,3
S01012414,Owned: Total,218,145,107,25,82,37,1,73,70,0,0,2,1
S01012414,Owned: Owned outright,154,84,57,20,37,26,1,70,67,0,0,2,1
S01012414,Owned: Owned with a mortgage or loan or shared ownership,64,61,50,5,45,11,0,3,3,0,0,0,0
S01012414,Rented or living rent free: Total,123,74,59,14,45,7,8,49,36,3,2,6,2
S01012414,Rented or living rent free: Social rented,89,50,40,9,31,5,5,39,29,0,2,6,2
S01012414,Rented or living rent free: Private rented or living rent free,34,24,19,5,14,2,3,10,7,3,0,0,0
S01012415,All HRPs aged 16 and over,203,133,78,12,66,54,1,70,62,0,2,2,4
S01012415,Owned: Total,164,103,55,10,45,47,1,61,56,0,1,0,4
S01012415,Owned: Owned outright,120,64,33,6,27,30,1,56,54,0,0,0,2
S01012415,Owned: Owned with a mortgage or loan or shared ownership,44,39,22,4,18,17,0,5,2,0,1,0,2
S01012415,Rented or living rent free: Total,39,30,23,2,21,7,0,9,6,0,1,2,0
S01012415,Rented or living rent free: Social rented,30,21,16,1,15,5,0,9,6,0,1,2,0
S01012415,Rented or living rent free: Private rented or living rent free,9,9,7,1,6,2,0,0,0,0,0,0,0
S01012416,All HRPs aged 16 and over,216,137,95,19,76,41,1,79,73,1,1,2,2
S01012416,Owned: Total,173,105,68,13,55,37,0,68,65,0,1,1,1
S01012416,Owned: Owned outright,120,55,35,11,24,20,0,65,64,0,1,0,0
S01012416,Owned: Owned with a mortgage or loan or shared ownership,53,50,33,2,31,17,0,3,1,0,0,1,1
S01012416,Rented or living rent free: Total,43,32,27,6,21,4,1,11,8,1,0,1,1
S01012416,Rented or living rent free: Social rented,28,19,16,6,10,2,1,9,6,1,0,1,1
S01012416,Rented or living rent free: Private rented or living rent free,15,13,11,0,11,2,0,2,2,0,0,0,0
S01012417,All HRPs aged 16 and over,299,157,107,25,82,45,5,142,120,0,1,17,4
S01012417,Owned: Total,165,89,48,12,36,39,2,76,74,0,0,1,1
S01012417,Owned: Owned outright,113,45,21,7,14,23,1,68,67,0,0,1,0
S01012417,Owned: Owned with a mortgage or loan or shared ownership,52,44,27,5,22,16,1,8,7,0,0,0,1
S01012417,Rented or living rent free: Total,134,68,59,13,46,6,3,66,46,0,1,16,3
S01012417,Rented or living rent free: Social rented,68,33,27,8,19,4,2,35,19,0,1,14,1
S01012417,Rented or living rent free: Private rented or living rent free,66,35,32,5,27,2,1,31,27,0,0,2,2
S01012418,All HRPs aged 16 and over,343,223,124,17,107,93,6,120,99,2,4,12,3
S01012418,Owned: Total,232,156,75,10,65,79,2,76,66,1,2,5,2
S01012418,Owned: Owned outright,163,95,36,7,29,58,1,68,60,0,2,4,2
S01012418,Owned: Owned with a mortgage or loan or shared ownership,69,61,39,3,36,21,1,8,6,1,0,1,0
S01012418,Rented or living rent free: Total,111,67,49,7,42,14,4,44,33,1,2,7,1
S01012418,Rented or living rent free: Social rented,39,19,17,5,12,1,1,20,15,0,0,5,0
S01012418,Rented or living rent free: Private rented or living rent free,72,48,32,2,30,13,3,24,18,1,2,2,1
S01012419,All HRPs aged 16 and over,313,198,103,23,80,88,7,115,103,0,3,6,3
S01012419,Owned: Total,232,145,75,15,60,69,1,87,82,0,1,2,2
S01012419,Owned: Owned outright,167,87,41,12,29,45,1,80,76,0,1,1,2
S01012419,Owned: Owned with a mortgage or loan or shared ownership,65,58,34,3,31,24,0,7,6,0,0,1,0
S01012419,Rented or living rent free: Total,81,53,28,8,20,19,6,28,21,0,2,4,1
S01012419,Rented or living rent free: Social rented,31,14,10,6,4,2,2,17,11,0,1,4,1
S01012419,Rented or living rent free: Private rented or living rent free,50,39,18,2,16,17,4,11,10,0,1,0,0
S01012420,All HRPs aged 16 and over,362,216,174,39,135,33,9,146,104,1,14,21,6
S01012420,Owned: Total,195,126,102,17,85,22,2,69,62,0,2,5,0
S01012420,Owned: Owned outright,107,47,36,11,25,9,2,60,54,0,1,5,0
S01012420,Owned: Owned with a mortgage or loan or shared ownership,88,79,66,6,60,13,0,9,8,0,1,0,0
S01012420,Rented or living rent free: Total,167,90,72,22,50,11,7,77,42,1,12,16,6
S01012420,Rented or living rent free: Social rented,117,56,47,17,30,3,6,61,34,1,8,15,3
S01012420,Rented or living rent free: Private rented or living rent free,50,34,25,5,20,8,1,16,8,0,4,1,3
S01012421,All HRPs aged 16 and over,325,198,142,19,123,51,5,127,107,0,2,13,5
S01012421,Owned: Total,183,114,78,6,72,35,1,69,65,0,0,4,0
S01012421,Owned: Owned outright,103,47,28,4,24,19,0,56,53,0,0,3,0
S01012421,Owned: Owned with a mortgage or loan or shared ownership,80,67,50,2,48,16,1,13,12,0,0,1,0
S01012421,Rented or living rent free: Total,142,84,64,13,51,16,4,58,42,0,2,9,5
S01012421,Rented or living rent free: Social rented,73,40,33,11,22,3,4,33,23,0,1,4,5
S01012421,Rented or living rent free: Private rented or living rent free,69,44,31,2,29,13,0,25,19,0,1,5,0
S01012422,All HRPs aged 16 and over,402,259,172,31,141,72,15,143,119,4,6,10,4
S01012422,Owned: Total,256,160,111,15,96,48,1,96,91,2,0,1,2
S01012422,Owned: Owned outright,160,78,43,8,35,34,1,82,78,2,0,1,1
S01012422,Owned: Owned with a mortgage or loan or shared ownership,96,82,68,7,61,14,0,14,13,0,0,0,1
S01012422,Rented or living rent free: Total,146,99,61,16,45,24,14,47,28,2,6,9,2
S01012422,Rented or living rent free: Social rented,46,29,20,5,15,2,7,17,8,0,1,7,1
S01012422,Rented or living rent free: Private rented or living rent free,100,70,41,11,30,22,7,30,20,2,5,2,1
S01012423,All HRPs aged 16 and over,346,222,156,25,131,56,10,124,108,1,3,11,1
S01012423,Owned: Total,265,186,134,21,113,47,5,79,76,0,1,2,0
S01012423,Owned: Owned outright,140,74,47,14,33,25,2,66,66,0,0,0,0
S01012423,Owned: Owned with a mortgage or loan or shared ownership,125,112,87,7,80,22,3,13,10,0,1,2,0
S01012423,Rented or living rent free: Total,81,36,22,4,18,9,5,45,32,1,2,9,1
S01012423,Rented or living rent free: Social rented,38,11,5,2,3,2,4,27,18,1,2,5,1
S01012423,Rented or living rent free: Private rented or living rent free,43,25,17,2,15,7,1,18,14,0,0,4,0
S01012424,All HRPs aged 16 and over,414,257,216,55,161,26,15,157,124,2,8,21,2
S01012424,Owned: Total,260,173,152,28,124,19,2,87,81,1,1,3,1
S01012424,Owned: Owned outright,117,44,32,11,21,10,2,73,69,1,0,3,0
S01012424,Owned: Owned with a mortgage or loan or shared ownership,143,129,120,17,103,9,0,14,12,0,1,0,1
S01012424,Rented or living rent free: Total,154,84,64,27,37,7,13,70,43,1,7,18,1
S01012424,Rented or living rent free: Social rented,130,74,54,23,31,7,13,56,36,1,3,15,1
S01012424,Rented or living rent free: Private rented or living rent free,24,10,10,4,6,0,0,14,7,0,4,3,0
S01012425,All HRPs aged 16 and over,307,133,113,32,81,13,7,174,109,4,12,38,11
S01012425,Owned: Total,122,60,51,11,40,8,1,62,49,0,0,7,6
S01012425,Owned: Owned outright,67,16,13,7,6,2,1,51,40,0,0,6,5
S01012425,Owned: Owned with a mortgage or loan or shared ownership,55,44,38,4,34,6,0,11,9,0,0,1,1
S01012425,Rented or living rent free: Total,185,73,62,21,41,5,6,112,60,4,12,31,5
S01012425,Rented or living rent free: Social rented,163,61,52,18,34,4,5,102,57,2,9,30,4
S01012425,Rented or living rent free: Private rented or living rent free,22,12,10,3,7,1,1,10,3,2,3,1,1
S01012426,All HRPs aged 16 and over,237,126,89,30,59,12,25,111,67,3,13,24,4
S01012426,Owned: Total,102,59,51,13,38,8,0,43,41,0,0,2,0
S01012426,Owned: Owned outright,50,19,15,4,11,4,0,31,31,0,0,0,0
S01012426,Owned: Owned with a mortgage or loan or shared ownership,52,40,36,9,27,4,0,12,10,0,0,2,0
S01012426,Rented or living rent free: Total,135,67,38,17,21,4,25,68,26,3,13,22,4
S01012426,Rented or living rent free: Social rented,118,59,36,16,20,3,20,59,23,2,10,21,3
S01012426,Rented or living rent free: Private rented or living rent free,17,8,2,1,1,1,5,9,3,1,3,1,1
S01012427,All HRPs aged 16 and over,300,173,143,48,95,10,20,127,84,3,7,29,4
S01012427,Owned: Total,137,85,77,25,52,6,2,52,47,0,1,4,0
S01012427,Owned: Owned outright,61,20,17,7,10,2,1,41,38,0,0,3,0
S01012427,Owned: Owned with a mortgage or loan or shared ownership,76,65,60,18,42,4,1,11,9,0,1,1,0
S01012427,Rented or living rent free: Total,163,88,66,23,43,4,18,75,37,3,6,25,4
S01012427,Rented or living rent free: Social rented,145,76,56,18,38,4,16,69,34,3,4,24,4
S01012427,Rented or living rent free: Private rented or living rent free,18,12,10,5,5,0,2,6,3,0,2,1,0
S01012428,All HRPs aged 16 and over,286,169,145,36,109,20,4,117,95,1,8,9,4
S01012428,Owned: Total,206,122,104,21,83,15,3,84,75,1,2,4,2
S01012428,Owned: Owned outright,115,45,34,9,25,10,1,70,66,1,0,1,2
S01012428,Owned: Owned with a mortgage or loan or shared ownership,91,77,70,12,58,5,2,14,9,0,2,3,0
S01012428,Rented or living rent free: Total,80,47,41,15,26,5,1,33,20,0,6,5,2
S01012428,Rented or living rent free: Social rented,58,30,27,9,18,2,1,28,18,0,4,4,2
S01012428,Rented or living rent free: Private rented or living rent free,22,17,14,6,8,3,0,5,2,0,2,1,0
S01012429,All HRPs aged 16 and over,286,143,122,28,94,15,6,143,96,0,13,28,6
S01012429,Owned: Total,207,110,92,18,74,15,3,97,83,0,0,11,3
S01012429,Owned: Owned outright,122,44,38,14,24,4,2,78,69,0,0,7,2
S01012429,Owned: Owned with a mortgage or loan or shared ownership,85,66,54,4,50,11,1,19,14,0,0,4,1
S01012429,Rented or living rent free: Total,79,33,30,10,20,0,3,46,13,0,13,17,3
S01012429,Rented or living rent free: Social rented,36,15,15,5,10,0,0,21,5,0,4,10,2
S01012429,Rented or living rent free: Private rented or living rent free,43,18,15,5,10,0,3,25,8,0,9,7,1
S01012430,All HRPs aged 16 and over,277,149,128,25,103,19,2,128,99,1,9,14,5
S01012430,Owned: Total,219,121,103,17,86,18,0,98,88,0,3,3,4
S01012430,Owned: Owned outright,122,41,29,8,21,12,0,81,74,0,2,2,3
S01012430,Owned: Owned with a mortgage or loan or shared ownership,97,80,74,9,65,6,0,17,14,0,1,1,1
S01012430,Rented or living rent free: Total,58,28,25,8,17,1,2,30,11,1,6,11,1
S01012430,Rented or living rent free: Social rented,14,5,4,2,2,1,0,9,4,0,0,4,1
S01012430,Rented or living rent free: Private rented or living rent free,44,23,21,6,15,0,2,21,7,1,6,7,0
S01012431,All HRPs aged 16 and over,432,219,148,31,117,60,11,213,172,0,5,28,8
S01012431,Owned: Total,294,169,113,21,92,52,4,125,116,0,3,3,3
S01012431,Owned: Owned outright,182,73,44,13,31,26,3,109,104,0,0,2,3
S01012431,Owned: Owned with a mortgage or loan or shared ownership,112,96,69,8,61,26,1,16,12,0,3,1,0
S01012431,Rented or living rent free: Total,138,50,35,10,25,8,7,88,56,0,2,25,5
S01012431,Rented or living rent free: Social rented,73,10,9,2,7,1,0,63,42,0,1,16,4
S01012431,Rented or living rent free: Private rented or living rent free,65,40,26,8,18,7,7,25,14,0,1,9,1
S01012432,All HRPs aged 16 and over,352,156,121,28,93,23,12,196,166,1,5,22,2
S01012432,Owned: Total,235,114,91,16,75,22,1,121,115,0,2,2,2
S01012432,Owned: Owned outright,142,42,35,9,26,6,1,100,97,0,1,0,2
S01012432,Owned: Owned with a mortgage or loan or shared ownership,93,72,56,7,49,16,0,21,18,0,1,2,0
S01012432,Rented or living rent free: Total,117,42,30,12,18,1,11,75,51,1,3,20,0
S01012432,Rented or living rent free: Social rented,103,33,24,11,13,0,9,70,48,1,3,18,0
S01012432,Rented or living rent free: Private rented or living rent free,14,9,6,1,5,1,2,5,3,0,0,2,0
S01012433,All HRPs aged 16 and over,265,150,122,29,93,20,8,115,85,1,3,19,7
S01012433,Owned: Total,165,109,85,14,71,20,4,56,49,0,0,3,4
S01012433,Owned: Owned outright,88,39,28,7,21,9,2,49,46,0,0,1,2
S01012433,Owned: Owned with a mortgage or loan or shared ownership,77,70,57,7,50,11,2,7,3,0,0,2,2
S01012433,Rented or living rent free: Total,100,41,37,15,22,0,4,59,36,1,3,16,3
S01012433,Rented or living rent free: Social rented,63,17,16,9,7,0,1,46,29,0,1,13,3
S01012433,Rented or living rent free: Private rented or living rent free,37,24,21,6,15,0,3,13,7,1,2,3,0
S01012434,All HRPs aged 16 and over,334,197,161,35,126,17,19,137,99,1,3,28,6
S01012434,Owned: Total,179,117,105,18,87,9,3,62,56,0,0,5,1
S01012434,Owned: Owned outright,78,24,21,8,13,3,0,54,50,0,0,3,1
S01012434,Owned: Owned with a mortgage or loan or shared ownership,101,93,84,10,74,6,3,8,6,0,0,2,0
S01012434,Rented or living rent free: Total,155,80,56,17,39,8,16,75,43,1,3,23,5
S01012434,Rented or living rent free: Social rented,100,38,33,13,20,2,3,62,36,1,2,19,4
S01012434,Rented or living rent free: Private rented or living rent free,55,42,23,4,19,6,13,13,7,0,1,4,1
S01012435,All HRPs aged 16 and over,311,199,156,38,118,22,21,112,73,1,6,24,8
S01012435,Owned: Total,155,106,86,15,71,18,2,49,45,0,1,3,0
S01012435,Owned: Owned outright,69,27,18,9,9,7,2,42,39,0,0,3,0
S01012435,Owned: Owned with a mortgage or loan or shared ownership,86,79,68,6,62,11,0,7,6,0,1,0,0
S01012435,Rented or living rent free: Total,156,93,70,23,47,4,19,63,28,1,5,21,8
S01012435,Rented or living rent free: Social rented,121,66,53,21,32,4,9,55,24,1,4,19,7
S01012435,Rented or living rent free: Private rented or living rent free,35,27,17,2,15,0,10,8,4,0,1,2,1
S01012436,All HRPs aged 16 and over,345,210,158,45,113,22,30,135,88,1,14,29,3
S01012436,Owned: Total,167,99,84,21,63,14,1,68,62,0,3,3,0
S01012436,Owned: Owned outright,89,32,26,10,16,6,0,57,53,0,2,2,0
S01012436,Owned: Owned with a mortgage or loan or shared ownership,78,67,58,11,47,8,1,11,9,0,1,1,0
S01012436,Rented or living rent free: Total,178,111,74,24,50,8,29,67,26,1,11,26,3
S01012436,Rented or living rent free: Social rented,132,76,51,18,33,6,19,56,22,0,11,20,3
S01012436,Rented or living rent free: Private rented or living rent free,46,35,23,6,17,2,10,11,4,1,0,6,0
S01012437,All HRPs aged 16 and over,336,199,167,29,138,21,11,137,108,2,3,16,8
S01012437,Owned: Total,210,135,118,18,100,15,2,75,67,0,2,4,2
S01012437,Owned: Owned outright,109,42,37,10,27,4,1,67,63,0,1,3,0
S01012437,Owned: Owned with a mortgage or loan or shared ownership,101,93,81,8,73,11,1,8,4,0,1,1,2
S01012437,Rented or living rent free: Total,126,64,49,11,38,6,9,62,41,2,1,12,6
S01012437,Rented or living rent free: Social rented,106,50,38,7,31,5,7,56,37,2,0,12,5
S01012437,Rented or living rent free: Private rented or living rent free,20,14,11,4,7,1,2,6,4,0,1,0,1
S01012438,All HRPs aged 16 and over,260,182,143,22,121,25,14,78,55,0,6,14,3
S01012438,Owned: Total,177,132,104,11,93,23,5,45,43,0,0,2,0
S01012438,Owned: Owned outright,65,29,14,4,10,11,4,36,35,0,0,1,0
S01012438,Owned: Owned with a mortgage or loan or shared ownership,112,103,90,7,83,12,1,9,8,0,0,1,0
S01012438,Rented or living rent free: Total,83,50,39,11,28,2,9,33,12,0,6,12,3
S01012438,Rented or living rent free: Social rented,68,44,34,10,24,1,9,24,8,0,5,8,3
S01012438,Rented or living rent free: Private rented or living rent free,15,6,5,1,4,1,0,9,4,0,1,4,0
S01012439,All HRPs aged 16 and over,355,208,165,35,130,24,19,147,112,2,8,16,9
S01012439,Owned: Total,209,132,110,16,94,20,2,77,71,0,1,4,1
S01012439,Owned: Owned outright,106,38,31,10,21,5,2,68,66,0,0,1,1
S01012439,Owned: Owned with a mortgage or loan or shared ownership,103,94,79,6,73,15,0,9,5,0,1,3,0
S01012439,Rented or living rent free: Total,146,76,55,19,36,4,17,70,41,2,7,12,8
S01012439,Rented or living rent free: Social rented,97,45,34,13,21,2,9,52,33,2,3,10,4
S01012439,Rented or living rent free: Private rented or living rent free,49,31,21,6,15,2,8,18,8,0,4,2,4
S01012440,All HRPs aged 16 and over,221,145,109,13,96,31,5,76,66,0,3,4,3
S01012440,Owned: Total,196,133,101,13,88,31,1,63,60,0,1,1,1
S01012440,Owned: Owned outright,98,47,32,9,23,15,0,51,49,0,1,0,1
S01012440,Owned: Owned with a mortgage or loan or shared ownership,98,86,69,4,65,16,1,12,11,0,0,1,0
S01012440,Rented or living rent free: Total,25,12,8,0,8,0,4,13,6,0,2,3,2
S01012440,Rented or living rent free: Social rented,10,3,1,0,1,0,2,7,3,0,1,2,1
S01012440,Rented or living rent free: Private rented or living rent free,15,9,7,0,7,0,2,6,3,0,1,1,1
S01012441,All HRPs aged 16 and over,387,255,170,26,144,82,3,132,115,0,3,13,1
S01012441,Owned: Total,287,202,130,14,116,72,0,85,83,0,1,1,0
S01012441,Owned: Owned outright,164,91,50,10,40,41,0,73,73,0,0,0,0
S01012441,Owned: Owned with a mortgage or loan or shared ownership,123,111,80,4,76,31,0,12,10,0,1,1,0
S01012441,Rented or living rent free: Total,100,53,40,12,28,10,3,47,32,0,2,12,1
S01012441,Rented or living rent free: Social rented,59,29,22,8,14,4,3,30,17,0,1,11,1
S01012441,Rented or living rent free: Private rented or living rent free,41,24,18,4,14,6,0,17,15,0,1,1,0
S01012442,All HRPs aged 16 and over,423,282,206,39,167,68,8,141,115,2,7,13,4
S01012442,Owned: Total,311,208,149,18,131,55,4,103,99,0,0,3,1
S01012442,Owned: Owned outright,141,56,33,9,24,23,0,85,82,0,0,2,1
S01012442,Owned: Owned with a mortgage or loan or shared ownership,170,152,116,9,107,32,4,18,17,0,0,1,0
S01012442,Rented or living rent free: Total,112,74,57,21,36,13,4,38,16,2,7,10,3
S01012442,Rented or living rent free: Social rented,52,26,21,12,9,3,2,26,11,1,4,8,2
S01012442,Rented or living rent free: Private rented or living rent free,60,48,36,9,27,10,2,12,5,1,3,2,1
S01012443,All HRPs aged 16 and over,313,222,161,22,139,51,10,91,69,2,4,9,7
S01012443,Owned: Total,220,170,128,17,111,41,1,50,43,0,0,2,5
S01012443,Owned: Owned outright,96,60,35,12,23,24,1,36,31,0,0,1,4
S01012443,Owned: Owned with a mortgage or loan or shared ownership,124,110,93,5,88,17,0,14,12,0,0,1,1
S01012443,Rented or living rent free: Total,93,52,33,5,28,10,9,41,26,2,4,7,2
S01012443,Rented or living rent free: Social rented,41,15,8,0,8,1,6,26,15,2,3,4,2
S01012443,Rented or living rent free: Private rented or living rent free,52,37,25,5,20,9,3,15,11,0,1,3,0
S01012444,All HRPs aged 16 and over,292,173,129,22,107,41,3,119,106,0,3,9,1
S01012444,Owned: Total,246,145,106,16,90,38,1,101,97,0,3,0,1
S01012444,Owned: Owned outright,148,57,39,10,29,17,1,91,90,0,1,0,0
S01012444,Owned: Owned with a mortgage or loan or shared ownership,98,88,67,6,61,21,0,10,7,0,2,0,1
S01012444,Rented or living rent free: Total,46,28,23,6,17,3,2,18,9,0,0,9,0
S01012444,Rented or living rent free: Social rented,22,15,13,2,11,1,1,7,4,0,0,3,0
S01012444,Rented or living rent free: Private rented or living rent free,24,13,10,4,6,2,1,11,5,0,0,6,0
S01012445,All HRPs aged 16 and over,183,134,95,8,87,36,3,49,35,0,5,6,3
S01012445,Owned: Total,152,117,80,5,75,34,3,35,32,0,1,1,1
S01012445,Owned: Owned outright,52,27,15,2,13,10,2,25,24,0,0,1,0
S01012445,Owned: Owned with a mortgage or loan or shared ownership,100,90,65,3,62,24,1,10,8,0,1,0,1
S01012445,Rented or living rent free: Total,31,17,15,3,12,2,0,14,3,0,4,5,2
S01012445,Rented or living rent free: Social rented,21,8,8,3,5,0,0,13,2,0,4,5,2
S01012445,Rented or living rent free: Private rented or living rent free,10,9,7,0,7,2,0,1,1,0,0,0,0
S01012446,All HRPs aged 16 and over,252,146,127,28,99,15,4,106,87,0,5,9,5
S01012446,Owned: Total,150,103,91,14,77,10,2,47,44,0,1,2,0
S01012446,Owned: Owned outright,65,27,23,5,18,4,0,38,36,0,1,1,0
S01012446,Owned: Owned with a mortgage or loan or shared ownership,85,76,68,9,59,6,2,9,8,0,0,1,0
S01012446,Rented or living rent free: Total,102,43,36,14,22,5,2,59,43,0,4,7,5
S01012446,Rented or living rent free: Social rented,75,25,21,9,12,2,2,50,37,0,2,7,4
S01012446,Rented or living rent free: Private rented or living rent free,27,18,15,5,10,3,0,9,6,0,2,0,1
S01012447,All HRPs aged 16 and over,354,233,194,21,173,37,2,121,113,1,2,5,0
S01012447,Owned: Total,324,217,181,18,163,35,1,107,106,0,0,1,0
S01012447,Owned: Owned outright,154,58,40,8,32,18,0,96,96,0,0,0,0
S01012447,Owned: Owned with a mortgage or loan or shared ownership,170,159,141,10,131,17,1,11,10,0,0,1,0
S01012447,Rented or living rent free: Total,30,16,13,3,10,2,1,14,7,1,2,4,0
S01012447,Rented or living rent free: Social rented,7,4,2,1,1,1,1,3,1,0,0,2,0
S01012447,Rented or living rent free: Private rented or living rent free,23,12,11,2,9,1,0,11,6,1,2,2,0
S01012448,All HRPs aged 16 and over,361,259,202,22,180,46,11,102,83,3,4,9,3
S01012448,Owned: Total,296,216,172,14,158,41,3,80,74,1,2,2,1
S01012448,Owned: Owned outright,115,51,36,9,27,12,3,64,59,1,2,1,1
S01012448,Owned: Owned with a mortgage or loan or shared ownership,181,165,136,5,131,29,0,16,15,0,0,1,0
S01012448,Rented or living rent free: Total,65,43,30,8,22,5,8,22,9,2,2,7,2
S01012448,Rented or living rent free: Social rented,40,22,15,6,9,1,6,18,7,2,2,7,0
S01012448,Rented or living rent free: Private rented or living rent free,25,21,15,2,13,4,2,4,2,0,0,0,2
S01012449,All HRPs aged 16 and over,252,173,147,19,128,20,6,79,63,1,2,9,4
S01012449,Owned: Total,206,145,125,16,109,17,3,61,56,1,1,1,2
S01012449,Owned: Owned outright,87,33,25,6,19,5,3,54,50,1,1,0,2
S01012449,Owned: Owned with a mortgage or loan or shared ownership,119,112,100,10,90,12,0,7,6,0,0,1,0
S01012449,Rented or living rent free: Total,46,28,22,3,19,3,3,18,7,0,1,8,2
S01012449,Rented or living rent free: Social rented,20,11,7,2,5,2,2,9,3,0,1,5,0
S01012449,Rented or living rent free: Private rented or living rent free,26,17,15,1,14,1,1,9,4,0,0,3,2
S01012450,All HRPs aged 16 and over,322,234,169,21,148,59,6,88,77,1,3,7,0
S01012450,Owned: Total,276,200,140,16,124,56,4,76,73,0,1,2,0
S01012450,Owned: Owned outright,151,86,54,13,41,30,2,65,63,0,0,2,0
S01012450,Owned: Owned with a mortgage or loan or shared ownership,125,114,86,3,83,26,2,11,10,0,1,0,0
S01012450,Rented or living rent free: Total,46,34,29,5,24,3,2,12,4,1,2,5,0
S01012450,Rented or living rent free: Social rented,12,6,5,2,3,1,0,6,1,0,2,3,0
S01012450,Rented or living rent free: Private rented or living rent free,34,28,24,3,21,2,2,6,3,1,0,2,0
S01012451,All HRPs aged 16 and over,397,177,135,24,111,38,4,220,208,1,5,5,1
S01012451,Owned: Total,370,162,123,20,103,36,3,208,200,1,5,2,0
S01012451,Owned: Owned outright,254,63,49,11,38,11,3,191,187,1,2,1,0
S01012451,Owned: Owned with a mortgage or loan or shared ownership,116,99,74,9,65,25,0,17,13,0,3,1,0
S01012451,Rented or living rent free: Total,27,15,12,4,8,2,1,12,8,0,0,3,1
S01012451,Rented or living rent free: Social rented,5,3,2,1,1,0,1,2,1,0,0,1,0
S01012451,Rented or living rent free: Private rented or living rent free,22,12,10,3,7,2,0,10,7,0,0,2,1
S01012452,All HRPs aged 16 and over,301,159,135,28,107,23,1,142,136,0,2,4,0
S01012452,Owned: Total,276,142,121,23,98,20,1,134,133,0,0,1,0
S01012452,Owned: Owned outright,145,37,28,8,20,9,0,108,107,0,0,1,0
S01012452,Owned: Owned with a mortgage or loan or shared ownership,131,105,93,15,78,11,1,26,26,0,0,0,0
S01012452,Rented or living rent free: Total,25,17,14,5,9,3,0,8,3,0,2,3,0
S01012452,Rented or living rent free: Social rented,6,3,3,1,2,0,0,3,0,0,0,3,0
S01012452,Rented or living rent free: Private rented or living rent free,19,14,11,4,7,3,0,5,3,0,2,0,0
S01012453,All HRPs aged 16 and over,322,205,154,17,137,51,0,117,111,1,1,3,1
S01012453,Owned: Total,305,194,144,16,128,50,0,111,108,1,0,1,1
S01012453,Owned: Owned outright,179,73,54,11,43,19,0,106,103,1,0,1,1
S01012453,Owned: Owned with a mortgage or loan or shared ownership,126,121,90,5,85,31,0,5,5,0,0,0,0
S01012453,Rented or living rent free: Total,17,11,10,1,9,1,0,6,3,0,1,2,0
S01012453,Rented or living rent free: Social rented,3,1,1,0,1,0,0,2,0,0,0,2,0
S01012453,Rented or living rent free: Private rented or living rent free,14,10,9,1,8,1,0,4,3,0,1,0,0
S01012454,All HRPs aged 16 and over,301,154,122,23,99,30,2,147,143,0,0,4,0
S01012454,Owned: Total,290,149,119,21,98,29,1,141,140,0,0,1,0
S01012454,Owned: Owned outright,189,62,48,15,33,14,0,127,126,0,0,1,0
S01012454,Owned: Owned with a mortgage or loan or shared ownership,101,87,71,6,65,15,1,14,14,0,0,0,0
S01012454,Rented or living rent free: Total,11,5,3,2,1,1,1,6,3,0,0,3,0
S01012454,Rented or living rent free: Social rented,3,0,0,0,0,0,0,3,1,0,0,2,0
S01012454,Rented or living rent free: Private rented or living rent free,8,5,3,2,1,1,1,3,2,0,0,1,0
S01012455,All HRPs aged 16 and over,246,138,90,12,78,42,6,108,104,0,1,1,2
S01012455,Owned: Total,228,124,80,11,69,38,6,104,101,0,1,0,2
S01012455,Owned: Owned outright,154,54,35,7,28,17,2,100,99,0,1,0,0
S01012455,Owned: Owned with a mortgage or loan or shared ownership,74,70,45,4,41,21,4,4,2,0,0,0,2
S01012455,Rented or living rent free: Total,18,14,10,1,9,4,0,4,3,0,0,1,0
S01012455,Rented or living rent free: Social rented,0,0,0,0,0,0,0,0,0,0,0,0,0
S01012455,Rented or living rent free: Private rented or living rent free,18,14,10,1,9,4,0,4,3,0,0,1,0
S01012456,All HRPs aged 16 and over,300,162,123,21,102,35,4,138,134,0,0,3,1
S01012456,Owned: Total,277,145,111,18,93,32,2,132,130,0,0,1,1
S01012456,Owned: Owned outright,183,59,47,14,33,10,2,124,124,0,0,0,0
S01012456,Owned: Owned with a mortgage or loan or shared ownership,94,86,64,4,60,22,0,8,6,0,0,1,1
S01012456,Rented or living rent free: Total,23,17,12,3,9,3,2,6,4,0,0,2,0
S01012456,Rented or living rent free: Social rented,4,4,2,0,2,0,2,0,0,0,0,0,0
S01012456,Rented or living rent free: Private rented or living rent free,19,13,10,3,7,3,0,6,4,0,0,2,0
S01012457,All HRPs aged 16 and over,380,177,131,20,111,43,3,203,197,0,5,1,0
S01012457,Owned: Total,364,166,121,16,105,42,3,198,194,0,4,0,0
S01012457,Owned: Owned outright,253,75,50,11,39,23,2,178,176,0,2,0,0
S01012457,Owned: Owned with a mortgage or loan or shared ownership,111,91,71,5,66,19,1,20,18,0,2,0,0
S01012457,Rented or living rent free: Total,16,11,10,4,6,1,0,5,3,0,1,1,0
S01012457,Rented or living rent free: Social rented,6,4,3,2,1,1,0,2,2,0,0,0,0
S01012457,Rented or living rent free: Private rented or living rent free,10,7,7,2,5,0,0,3,1,0,1,1,0
S01012458,All HRPs aged 16 and over,330,188,144,17,127,42,2,142,140,0,1,0,1
S01012458,Owned: Total,300,162,123,10,113,38,1,138,137,0,0,0,1
S01012458,Owned: Owned outright,189,64,45,6,39,18,1,125,124,0,0,0,1
S01012458,Owned: Owned with a mortgage or loan or shared ownership,111,98,78,4,74,20,0,13,13,0,0,0,0
S01012458,Rented or living rent free: Total,30,26,21,7,14,4,1,4,3,0,1,0,0
S01012458,Rented or living rent free: Social rented,7,6,6,2,4,0,0,1,0,0,1,0,0
S01012458,Rented or living rent free: Private rented or living rent free,23,20,15,5,10,4,1,3,3,0,0,0,0
S01012459,All HRPs aged 16 and over,271,197,162,20,142,30,5,74,67,0,3,2,2
S01012459,Owned: Total,245,176,149,19,130,25,2,69,65,0,2,1,1
S01012459,Owned: Owned outright,113,50,38,10,28,10,2,63,59,0,2,1,1
S01012459,Owned: Owned with a mortgage or loan or shared ownership,132,126,111,9,102,15,0,6,6,0,0,0,0
S01012459,Rented or living rent free: Total,26,21,13,1,12,5,3,5,2,0,1,1,1
S01012459,Rented or living rent free: Social rented,7,4,2,0,2,2,0,3,2,0,0,1,0
S01012459,Rented or living rent free: Private rented or living rent free,19,17,11,1,10,3,3,2,0,0,1,0,1
S01012460,All HRPs aged 16 and over,242,129,108,18,90,21,0,113,107,1,1,2,2
S01012460,Owned: Total,228,120,100,17,83,20,0,108,103,1,1,2,1
S01012460,Owned: Owned outright,149,52,44,14,30,8,0,97,95,0,1,1,0
S01012460,Owned: Owned with a mortgage or loan or shared ownership,79,68,56,3,53,12,0,11,8,1,0,1,1
S01012460,Rented or living rent free: Total,14,9,8,1,7,1,0,5,4,0,0,0,1
S01012460,Rented or living rent free: Social rented,2,0,0,0,0,0,0,2,2,0,0,0,0
S01012460,Rented or living rent free: Private rented or living rent free,12,9,8,1,7,1,0,3,2,0,0,0,1
S01012461,All HRPs aged 16 and over,250,149,123,28,95,19,7,101,80,2,4,11,4
S01012461,Owned: Total,166,111,94,19,75,15,2,55,49,0,1,4,1
S01012461,Owned: Owned outright,67,22,15,7,8,7,0,45,41,0,0,3,1
S01012461,Owned: Owned with a mortgage or loan or shared ownership,99,89,79,12,67,8,2,10,8,0,1,1,0
S01012461,Rented or living rent free: Total,84,38,29,9,20,4,5,46,31,2,3,7,3
S01012461,Rented or living rent free: Social rented,57,24,17,7,10,2,5,33,26,0,2,5,0
S01012461,Rented or living rent free: Private rented or living rent free,27,14,12,2,10,2,0,13,5,2,1,2,3
S01012462,All HRPs aged 16 and over,386,215,175,45,130,15,25,171,122,2,7,29,11
S01012462,Owned: Total,216,126,115,24,91,8,3,90,86,1,1,0,2
S01012462,Owned: Owned outright,89,29,25,11,14,3,1,60,59,0,0,0,1
S01012462,Owned: Owned with a mortgage or loan or shared ownership,127,97,90,13,77,5,2,30,27,1,1,0,1
S01012462,Rented or living rent free: Total,170,89,60,21,39,7,22,81,36,1,6,29,9
S01012462,Rented or living rent free: Social rented,113,48,31,9,22,4,13,65,32,1,1,23,8
S01012462,Rented or living rent free: Private rented or living rent free,57,41,29,12,17,3,9,16,4,0,5,6,1
S01012463,All HRPs aged 16 and over,256,162,122,30,92,24,16,94,63,0,7,19,5
S01012463,Owned: Total,152,107,87,17,70,18,2,45,40,0,2,3,0
S01012463,Owned: Owned outright,50,18,16,9,7,2,0,32,31,0,0,1,0
S01012463,Owned: Owned with a mortgage or loan or shared ownership,102,89,71,8,63,16,2,13,9,0,2,2,0
S01012463,Rented or living rent free: Total,104,55,35,13,22,6,14,49,23,0,5,16,5
S01012463,Rented or living rent free: Social rented,75,40,24,10,14,5,11,35,21,0,2,10,2
S01012463,Rented or living rent free: Private rented or living rent free,29,15,11,3,8,1,3,14,2,0,3,6,3
S01012464,All HRPs aged 16 and over,255,190,152,43,109,16,22,65,36,3,3,16,7
S01012464,Owned: Total,141,120,104,18,86,11,5,21,17,0,0,3,1
S01012464,Owned: Owned outright,28,15,12,6,6,1,2,13,12,0,0,0,1
S01012464,Owned: Owned with a mortgage or loan or shared ownership,113,105,92,12,80,10,3,8,5,0,0,3,0
S01012464,Rented or living rent free: Total,114,70,48,25,23,5,17,44,19,3,3,13,6
S01012464,Rented or living rent free: Social rented,98,56,41,22,19,3,12,42,19,1,3,13,6
S01012464,Rented or living rent free: Private rented or living rent free,16,14,7,3,4,2,5,2,0,2,0,0,0
S01012465,All HRPs aged 16 and over,286,193,160,36,124,20,13,93,67,3,6,10,7
S01012465,Owned: Total,184,135,119,18,101,15,1,49,46,0,0,1,2
S01012465,Owned: Owned outright,58,25,20,5,15,5,0,33,32,0,0,0,1
S01012465,Owned: Owned with a mortgage or loan or shared ownership,126,110,99,13,86,10,1,16,14,0,0,1,1
S01012465,Rented or living rent free: Total,102,58,41,18,23,5,12,44,21,3,6,9,5
S01012465,Rented or living rent free: Social rented,70,40,28,13,15,4,8,30,16,2,3,6,3
S01012465,Rented or living rent free: Private rented or living rent free,32,18,13,5,8,1,4,14,5,1,3,3,2
S01012466,All HRPs aged 16 and over,349,196,151,35,116,34,11,153,125,6,4,12,6
S01012466,Owned: Total,256,139,105,18,87,30,4,117,110,1,1,2,3
S01012466,Owned: Owned outright,146,37,25,11,14,11,1,109,103,0,1,2,3
S01012466,Owned: Owned with a mortgage or loan or shared ownership,110,102,80,7,73,19,3,8,7,1,0,0,0
S01012466,Rented or living rent free: Total,93,57,46,17,29,4,7,36,15,5,3,10,3
S01012466,Rented or living rent free: Social rented,41,19,15,7,8,3,1,22,7,3,2,8,2
S01012466,Rented or living rent free: Private rented or living rent free,52,38,31,10,21,1,6,14,8,2,1,2,1
S01012467,All HRPs aged 16 and over,307,191,152,27,125,28,11,116,95,2,6,10,3
S01012467,Owned: Total,222,145,122,14,108,20,3,77,73,0,1,1,2
S01012467,Owned: Owned outright,111,45,37,5,32,7,1,66,65,0,0,1,0
S01012467,Owned: Owned with a mortgage or loan or shared ownership,111,100,85,9,76,13,2,11,8,0,1,0,2
S01012467,Rented or living rent free: Total,85,46,30,13,17,8,8,39,22,2,5,9,1
S01012467,Rented or living rent free: Social rented,42,19,13,8,5,5,1,23,13,1,2,6,1
S01012467,Rented or living rent free: Private rented or living rent free,43,27,17,5,12,3,7,16,9,1,3,3,0
S01012468,All HRPs aged 16 and over,316,192,157,23,134,29,6,124,108,3,7,2,4
S01012468,Owned: Total,256,156,128,16,112,26,2,100,92,2,2,1,3
S01012468,Owned: Owned outright,120,44,35,7,28,8,1,76,71,1,2,0,2
S01012468,Owned: Owned with a mortgage or loan or shared ownership,136,112,93,9,84,18,1,24,21,1,0,1,1
S01012468,Rented or living rent free: Total,60,36,29,7,22,3,4,24,16,1,5,1,1
S01012468,Rented or living rent free: Social rented,37,21,17,3,14,1,3,16,12,0,3,0,1
S01012468,Rented or living rent free: Private rented or living rent free,23,15,12,4,8,2,1,8,4,1,2,1,0
S01012469,All HRPs aged 16 and over,333,196,155,29,126,39,2,137,132,0,3,2,0
S01012469,Owned: Total,318,186,148,26,122,38,0,132,127,0,3,2,0
S01012469,Owned: Owned outright,188,67,50,16,34,17,0,121,118,0,2,1,0
S01012469,Owned: Owned with a mortgage or loan or shared ownership,130,119,98,10,88,21,0,11,9,0,1,1,0
S01012469,Rented or living rent free: Total,15,10,7,3,4,1,2,5,5,0,0,0,0
S01012469,Rented or living rent free: Social rented,1,0,0,0,0,0,0,1,1,0,0,0,0
S01012469,Rented or living rent free: Private rented or living rent free,14,10,7,3,4,1,2,4,4,0,0,0,0
S01012470,All HRPs aged 16 and over,492,265,216,49,167,28,21,227,183,1,9,22,12
S01012470,Owned: Total,331,173,150,23,127,20,3,158,147,1,1,6,3
S01012470,Owned: Owned outright,182,51,41,14,27,8,2,131,125,1,1,2,2
S01012470,Owned: Owned with a mortgage or loan or shared ownership,149,122,109,9,100,12,1,27,22,0,0,4,1
S01012470,Rented or living rent free: Total,161,92,66,26,40,8,18,69,36,0,8,16,9
S01012470,Rented or living rent free: Social rented,103,53,35,14,21,5,13,50,26,0,3,14,7
S01012470,Rented or living rent free: Private rented or living rent free,58,39,31,12,19,3,5,19,10,0,5,2,2
S01012471,All HRPs aged 16 and over,352,207,145,16,129,60,2,145,140,0,2,2,1
S01012471,Owned: Total,327,192,134,15,119,57,1,135,132,0,2,1,0
S01012471,Owned: Owned outright,204,78,55,14,41,23,0,126,125,0,1,0,0
S01012471,Owned: Owned with a mortgage or loan or shared ownership,123,114,79,1,78,34,1,9,7,0,1,1,0
S01012471,Rented or living rent free: Total,25,15,11,1,10,3,1,10,8,0,0,1,1
S01012471,Rented or living rent free: Social rented,3,0,0,0,0,0,0,3,2,0,0,1,0
S01012471,Rented or living rent free: Private rented or living rent free,22,15,11,1,10,3,1,7,6,0,0,0,1
S01012472,All HRPs aged 16 and over,317,152,127,20,107,23,2,165,155,2,2,4,2
S01012472,Owned: Total,299,143,121,18,103,22,0,156,150,1,1,2,2
S01012472,Owned: Owned outright,193,54,45,11,34,9,0,139,134,1,1,1,2
S01012472,Owned: Owned with a mortgage or loan or shared ownership,106,89,76,7,69,13,0,17,16,0,0,1,0
S01012472,Rented or living rent free: Total,18,9,6,2,4,1,2,9,5,1,1,2,0
S01012472,Rented or living rent free: Social rented,4,2,2,2,0,0,0,2,1,0,0,1,0
S01012472,Rented or living rent free: Private rented or living rent free,14,7,4,0,4,1,2,7,4,1,1,1,0
S01012473,All HRPs aged 16 and over,218,143,120,15,105,21,2,75,71,0,1,1,2
S01012473,Owned: Total,196,127,107,11,96,19,1,69,67,0,0,1,1
S01012473,Owned: Owned outright,104,44,38,8,30,6,0,60,59,0,0,0,1
S01012473,Owned: Owned with a mortgage or loan or shared ownership,92,83,69,3,66,13,1,9,8,0,0,1,0
S01012473,Rented or living rent free: Total,22,16,13,4,9,2,1,6,4,0,1,0,1
S01012473,Rented or living rent free: Social rented,4,2,0,0,0,1,1,2,2,0,0,0,0
S01012473,Rented or living rent free: Private rented or living rent free,18,14,13,4,9,1,0,4,2,0,1,0,1
S01012474,All HRPs aged 16 and over,371,175,146,34,112,23,6,196,158,3,5,25,5
S01012474,Owned: Total,237,130,106,18,88,21,3,107,98,1,2,5,1
S01012474,Owned: Owned outright,132,43,34,9,25,8,1,89,86,0,1,2,0
S01012474,Owned: Owned with a mortgage or loan or shared ownership,105,87,72,9,63,13,2,18,12,1,1,3,1
S01012474,Rented or living rent free: Total,134,45,40,16,24,2,3,89,60,2,3,20,4
S01012474,Rented or living rent free: Social rented,105,28,24,9,15,1,3,77,53,1,3,17,3
S01012474,Rented or living rent free: Private rented or living rent free,29,17,16,7,9,1,0,12,7,1,0,3,1
S01012475,All HRPs aged 16 and over,300,150,132,21,111,17,1,150,138,1,2,3,6
S01012475,Owned: Total,245,114,99,14,85,15,0,131,126,0,1,1,3
S01012475,Owned: Owned outright,160,38,31,9,22,7,0,122,118,0,0,1,3
S01012475,Owned: Owned with a mortgage or loan or shared ownership,85,76,68,5,63,8,0,9,8,0,1,0,0
S01012475,Rented or living rent free: Total,55,36,33,7,26,2,1,19,12,1,1,2,3
S01012475,Rented or living rent free: Social rented,14,5,5,1,4,0,0,9,4,0,1,2,2
S01012475,Rented or living rent free: Private rented or living rent free,41,31,28,6,22,2,1,10,8,1,0,0,1
S01012476,All HRPs aged 16 and over,422,236,199,43,156,28,9,186,147,7,7,21,4
S01012476,Owned: Total,302,179,154,21,133,22,3,123,119,1,0,2,1
S01012476,Owned: Owned outright,145,43,37,9,28,4,2,102,99,1,0,1,1
S01012476,Owned: Owned with a mortgage or loan or shared ownership,157,136,117,12,105,18,1,21,20,0,0,1,0
S01012476,Rented or living rent free: Total,120,57,45,22,23,6,6,63,28,6,7,19,3
S01012476,Rented or living rent free: Social rented,72,27,23,11,12,2,2,45,23,2,4,14,2
S01012476,Rented or living rent free: Private rented or living rent free,48,30,22,11,11,4,4,18,5,4,3,5,1
S01012477,All HRPs aged 16 and over,283,191,170,24,146,20,1,92,87,1,1,1,2
S01012477,Owned: Total,264,177,159,20,139,17,1,87,85,1,0,0,1
S01012477,Owned: Owned outright,132,60,51,16,35,8,1,72,71,0,0,0,1
S01012477,Owned: Owned with a mortgage or loan or shared ownership,132,117,108,4,104,9,0,15,14,1,0,0,0
S01012477,Rented or living rent free: Total,19,14,11,4,7,3,0,5,2,0,1,1,1
S01012477,Rented or living rent free: Social rented,6,3,3,2,1,0,0,3,2,0,0,0,1
S01012477,Rented or living rent free: Private rented or living rent free,13,11,8,2,6,3,0,2,0,0,1,1,0
S01012478,All HRPs aged 16 and over,368,234,201,63,138,28,5,134,112,1,8,11,2
S01012478,Owned: Total,266,172,147,34,113,23,2,94,90,1,0,2,1
S01012478,Owned: Owned outright,117,44,36,13,23,7,1,73,71,0,0,1,1
S01012478,Owned: Owned with a mortgage or loan or shared ownership,149,128,111,21,90,16,1,21,19,1,0,1,0
S01012478,Rented or living rent free: Total,102,62,54,29,25,5,3,40,22,0,8,9,1
S01012478,Rented or living rent free: Social rented,63,36,31,17,14,3,2,27,17,0,3,6,1
S01012478,Rented or living rent free: Private rented or living rent free,39,26,23,12,11,2,1,13,5,0,5,3,0
S01012479,All HRPs aged 16 and over,261,199,163,19,144,34,2,62,55,0,3,3,1
S01012479,Owned: Total,246,189,156,15,141,32,1,57,54,0,1,1,1
S01012479,Owned: Owned outright,101,50,40,8,32,9,1,51,49,0,1,1,0
S01012479,Owned: Owned with a mortgage or loan or shared ownership,145,139,116,7,109,23,0,6,5,0,0,0,1
S01012479,Rented or living rent free: Total,15,10,7,4,3,2,1,5,1,0,2,2,0
S01012479,Rented or living rent free: Social rented,5,2,1,1,0,0,1,3,1,0,1,1,0
S01012479,Rented or living rent free: Private rented or living rent free,10,8,6,3,3,2,0,2,0,0,1,1,0
S01012480,All HRPs aged 16 and over,339,220,180,26,154,28,12,119,82,4,5,25,3
S01012480,Owned: Total,130,92,71,5,66,19,2,38,34,0,0,2,2
S01012480,Owned: Owned outright,50,18,16,4,12,1,1,32,31,0,0,1,0
S01012480,Owned: Owned with a mortgage or loan or shared ownership,80,74,55,1,54,18,1,6,3,0,0,1,2
S01012480,Rented or living rent free: Total,209,128,109,21,88,9,10,81,48,4,5,23,1
S01012480,Rented or living rent free: Social rented,81,18,12,3,9,1,5,63,40,2,3,18,0
S01012480,Rented or living rent free: Private rented or living rent free,128,110,97,18,79,8,5,18,8,2,2,5,1
S01012481,All HRPs aged 16 and over,419,283,229,50,179,34,20,136,87,4,2,30,13
S01012481,Owned: Total,229,155,127,18,109,24,4,74,65,2,0,4,3
S01012481,Owned: Owned outright,101,37,28,11,17,6,3,64,58,0,0,4,2
S01012481,Owned: Owned with a mortgage or loan or shared ownership,128,118,99,7,92,18,1,10,7,2,0,0,1
S01012481,Rented or living rent free: Total,190,128,102,32,70,10,16,62,22,2,2,26,10
S01012481,Rented or living rent free: Social rented,29,10,6,1,5,1,3,19,6,0,1,8,4
S01012481,Rented or living rent free: Private rented or living rent free,161,118,96,31,65,9,13,43,16,2,1,18,6
S01012482,All HRPs aged 16 and over,439,190,140,27,113,36,14,249,228,2,3,10,6
S01012482,Owned: Total,341,124,87,12,75,32,5,217,214,0,2,0,1
S01012482,Owned: Owned outright,231,37,25,8,17,10,2,194,191,0,2,0,1
S01012482,Owned: Owned with a mortgage or loan or shared ownership,110,87,62,4,58,22,3,23,23,0,0,0,0
S01012482,Rented or living rent free: Total,98,66,53,15,38,4,9,32,14,2,1,10,5
S01012482,Rented or living rent free: Social rented,8,2,1,1,0,1,0,6,2,0,0,3,1
S01012482,Rented or living rent free: Private rented or living rent free,90,64,52,14,38,3,9,26,12,2,1,7,4
S01012483,All HRPs aged 16 and over,570,304,239,67,172,27,38,266,170,4,9,64,19
S01012483,Owned: Total,225,117,95,20,75,20,2,108,99,1,0,5,3
S01012483,Owned: Owned outright,134,44,34,10,24,10,0,90,83,1,0,4,2
S01012483,Owned: Owned with a mortgage or loan or shared ownership,91,73,61,10,51,10,2,18,16,0,0,1,1
S01012483,Rented or living rent free: Total,345,187,144,47,97,7,36,158,71,3,9,59,16
S01012483,Rented or living rent free: Social rented,162,58,41,17,24,1,16,104,59,0,3,32,10
S01012483,Rented or living rent free: Private rented or living rent free,183,129,103,30,73,6,20,54,12,3,6,27,6
S01012484,All HRPs aged 16 and over,366,207,151,19,132,47,9,159,126,1,3,23,6
S01012484,Owned: Total,283,161,120,16,104,41,0,122,112,0,2,6,2
S01012484,Owned: Owned outright,141,34,20,2,18,14,0,107,101,0,1,3,2
S01012484,Owned: Owned with a mortgage or loan or shared ownership,142,127,100,14,86,27,0,15,11,0,1,3,0
S01012484,Rented or living rent free: Total,83,46,31,3,28,6,9,37,14,1,1,17,4
S01012484,Rented or living rent free: Social rented,32,8,5,0,5,0,3,24,8,0,1,14,1
S01012484,Rented or living rent free: Private rented or living rent free,51,38,26,3,23,6,6,13,6,1,0,3,3
S01012485,All HRPs aged 16 and over,384,231,171,28,143,56,4,153,132,2,7,8,4
S01012485,Owned: Total,305,177,124,18,106,49,4,128,121,0,3,1,3
S01012485,Owned: Owned outright,184,68,43,10,33,23,2,116,114,0,0,0,2
S01012485,Owned: Owned with a mortgage or loan or shared ownership,121,109,81,8,73,26,2,12,7,0,3,1,1
S01012485,Rented or living rent free: Total,79,54,47,10,37,7,0,25,11,2,4,7,1
S01012485,Rented or living rent free: Social rented,2,0,0,0,0,0,0,2,0,0,0,2,0
S01012485,Rented or living rent free: Private rented or living rent free,77,54,47,10,37,7,0,23,11,2,4,5,1
S01012486,All HRPs aged 16 and over,268,114,80,16,64,33,1,154,149,3,0,0,2
S01012486,Owned: Total,246,100,68,12,56,31,1,146,144,0,0,0,2
S01012486,Owned: Owned outright,172,38,29,9,20,9,0,134,132,0,0,0,2
S01012486,Owned: Owned with a mortgage or loan or shared ownership,74,62,39,3,36,22,1,12,12,0,0,0,0
S01012486,Rented or living rent free: Total,22,14,12,4,8,2,0,8,5,3,0,0,0
S01012486,Rented or living rent free: Social rented,2,1,1,1,0,0,0,1,1,0,0,0,0
S01012486,Rented or living rent free: Private rented or living rent free,20,13,11,3,8,2,0,7,4,3,0,0,0
S01012487,All HRPs aged 16 and over,306,195,158,33,125,24,13,111,85,1,2,22,1
S01012487,Owned: Total,191,128,109,18,91,19,0,63,59,1,0,3,0
S01012487,Owned: Owned outright,83,29,24,8,16,5,0,54,51,1,0,2,0
S01012487,Owned: Owned with a mortgage or loan or shared ownership,108,99,85,10,75,14,0,9,8,0,0,1,0
S01012487,Rented or living rent free: Total,115,67,49,15,34,5,13,48,26,0,2,19,1
S01012487,Rented or living rent free: Social rented,67,26,16,9,7,1,9,41,22,0,1,17,1
S01012487,Rented or living rent free: Private rented or living rent free,48,41,33,6,27,4,4,7,4,0,1,2,0
S01012488,All HRPs aged 16 and over,483,272,228,42,186,26,18,211,166,1,5,30,9
S01012488,Owned: Total,305,197,176,27,149,19,2,108,99,1,0,8,0
S01012488,Owned: Owned outright,149,58,48,15,33,8,2,91,85,0,0,6,0
S01012488,Owned: Owned with a mortgage or loan or shared ownership,156,139,128,12,116,11,0,17,14,1,0,2,0
S01012488,Rented or living rent free: Total,178,75,52,15,37,7,16,103,67,0,5,22,9
S01012488,Rented or living rent free: Social rented,105,25,14,6,8,2,9,80,56,0,1,18,5
S01012488,Rented or living rent free: Private rented or living rent free,73,50,38,9,29,5,7,23,11,0,4,4,4
S01012489,All HRPs aged 16 and over,553,348,262,67,195,25,61,205,100,8,25,57,15
S01012489,Owned: Total,168,127,106,16,90,16,5,41,36,1,0,4,0
S01012489,Owned: Owned outright,55,24,17,4,13,6,1,31,30,0,0,1,0
S01012489,Owned: Owned with a mortgage or loan or shared ownership,113,103,89,12,77,10,4,10,6,1,0,3,0
S01012489,Rented or living rent free: Total,385,221,156,51,105,9,56,164,64,7,25,53,15
S01012489,Rented or living rent free: Social rented,267,137,93,44,49,3,41,130,52,4,18,44,12
S01012489,Rented or living rent free: Private rented or living rent free,118,84,63,7,56,6,15,34,12,3,7,9,3
S01012490,All HRPs aged 16 and over,606,350,270,68,202,25,55,256,142,2,15,82,15
S01012490,Owned: Total,166,110,96,13,83,9,5,56,48,0,2,4,2
S01012490,Owned: Owned outright,63,18,16,5,11,2,0,45,39,0,2,3,1
S01012490,Owned: Owned with a mortgage or loan or shared ownership,103,92,80,8,72,7,5,11,9,0,0,1,1
S01012490,Rented or living rent free: Total,440,240,174,55,119,16,50,200,94,2,13,78,13
S01012490,Rented or living rent free: Social rented,245,93,64,23,41,4,25,152,84,2,5,51,10
S01012490,Rented or living rent free: Private rented or living rent free,195,147,110,32,78,12,25,48,10,0,8,27,3
S01012491,All HRPs aged 16 and over,245,161,108,36,72,9,44,84,35,2,10,29,8
S01012491,Owned: Total,69,49,41,4,37,6,2,20,17,0,0,1,2
S01012491,Owned: Owned outright,23,7,5,0,5,2,0,16,14,0,0,1,1
S01012491,Owned: Owned with a mortgage or loan or shared ownership,46,42,36,4,32,4,2,4,3,0,0,0,1
S01012491,Rented or living rent free: Total,176,112,67,32,35,3,42,64,18,2,10,28,6
S01012491,Rented or living rent free: Social rented,138,87,49,26,23,3,35,51,17,2,5,22,5
S01012491,Rented or living rent free: Private rented or living rent free,38,25,18,6,12,0,7,13,1,0,5,6,1
S01012492,All HRPs aged 16 and over,490,244,169,46,123,16,59,246,126,2,14,81,23
S01012492,Owned: Total,137,81,68,7,61,10,3,56,47,0,0,7,2
S01012492,Owned: Owned outright,61,18,15,2,13,3,0,43,38,0,0,4,1
S01012492,Owned: Owned with a mortgage or loan or shared ownership,76,63,53,5,48,7,3,13,9,0,0,3,1
S01012492,Rented or living rent free: Total,353,163,101,39,62,6,56,190,79,2,14,74,21
S01012492,Rented or living rent free: Social rented,248,90,52,23,29,5,33,158,76,1,5,62,14
S01012492,Rented or living rent free: Private rented or living rent free,105,73,49,16,33,1,23,32,3,1,9,12,7
S01012493,All HRPs aged 16 and over,409,136,116,24,92,12,8,273,225,1,6,36,5
S01012493,Owned: Total,145,101,89,13,76,11,1,44,40,0,2,2,0
S01012493,Owned: Owned outright,76,38,33,7,26,5,0,38,35,0,2,1,0
S01012493,Owned: Owned with a mortgage or loan or shared ownership,69,63,56,6,50,6,1,6,5,0,0,1,0
S01012493,Rented or living rent free: Total,264,35,27,11,16,1,7,229,185,1,4,34,5
S01012493,Rented or living rent free: Social rented,246,22,16,6,10,0,6,224,183,1,2,33,5
S01012493,Rented or living rent free: Private rented or living rent free,18,13,11,5,6,1,1,5,2,0,2,1,0
S01012494,All HRPs aged 16 and over,383,225,195,52,143,23,7,158,133,1,10,13,1
S01012494,Owned: Total,270,163,144,31,113,18,1,107,101,0,1,5,0
S01012494,Owned: Owned outright,104,32,28,13,15,4,0,72,69,0,1,2,0
S01012494,Owned: Owned with a mortgage or loan or shared ownership,166,131,116,18,98,14,1,35,32,0,0,3,0
S01012494,Rented or living rent free: Total,113,62,51,21,30,5,6,51,32,1,9,8,1
S01012494,Rented or living rent free: Social rented,73,33,26,11,15,2,5,40,28,0,5,6,1
S01012494,Rented or living rent free: Private rented or living rent free,40,29,25,10,15,3,1,11,4,1,4,2,0
S01012495,All HRPs aged 16 and over,496,284,226,60,166,23,35,212,146,6,9,39,12
S01012495,Owned: Total,252,160,140,26,114,16,4,92,82,0,2,3,5
S01012495,Owned: Owned outright,108,38,30,9,21,5,3,70,63,0,1,2,4
S01012495,Owned: Owned with a mortgage or loan or shared ownership,144,122,110,17,93,11,1,22,19,0,1,1,1
S01012495,Rented or living rent free: Total,244,124,86,34,52,7,31,120,64,6,7,36,7
S01012495,Rented or living rent free: Social rented,177,76,51,18,33,5,20,101,62,3,2,29,5
S01012495,Rented or living rent free: Private rented or living rent free,67,48,35,16,19,2,11,19,2,3,5,7,2
S01012496,All HRPs aged 16 and over,314,176,150,48,102,17,9,138,102,0,13,17,6
S01012496,Owned: Total,182,105,88,17,71,14,3,77,75,0,2,0,0
S01012496,Owned: Owned outright,88,28,22,5,17,5,1,60,59,0,1,0,0
S01012496,Owned: Owned with a mortgage or loan or shared ownership,94,77,66,12,54,9,2,17,16,0,1,0,0
S01012496,Rented or living rent free: Total,132,71,62,31,31,3,6,61,27,0,11,17,6
S01012496,Rented or living rent free: Social rented,115,64,55,30,25,3,6,51,21,0,9,16,5
S01012496,Rented or living rent free: Private rented or living rent free,17,7,7,1,6,0,0,10,6,0,2,1,1
S01012497,All HRPs aged 16 and over,231,122,106,36,70,8,8,109,70,2,6,25,6
S01012497,Owned: Total,115,68,60,13,47,5,3,47,42,0,1,3,1
S01012497,Owned: Owned outright,56,22,18,6,12,1,3,34,31,0,0,2,1
S01012497,Owned: Owned with a mortgage or loan or shared ownership,59,46,42,7,35,4,0,13,11,0,1,1,0
S01012497,Rented or living rent free: Total,116,54,46,23,23,3,5,62,28,2,5,22,5
S01012497,Rented or living rent free: Social rented,102,45,39,19,20,1,5,57,27,1,3,21,5
S01012497,Rented or living rent free: Private rented or living rent free,14,9,7,4,3,2,0,5,1,1,2,1,0
S01012498,All HRPs aged 16 and over,343,204,162,53,109,11,31,139,70,4,21,32,12
S01012498,Owned: Total,105,68,62,12,50,6,0,37,32,0,0,5,0
S01012498,Owned: Owned outright,39,17,14,2,12,3,0,22,20,0,0,2,0
S01012498,Owned: Owned with a mortgage or loan or shared ownership,66,51,48,10,38,3,0,15,12,0,0,3,0
S01012498,Rented or living rent free: Total,238,136,100,41,59,5,31,102,38,4,21,27,12
S01012498,Rented or living rent free: Social rented,227,130,95,39,56,5,30,97,37,2,20,27,11
S01012498,Rented or living rent free: Private rented or living rent free,11,6,5,2,3,0,1,5,1,2,1,0,1
S01012499,All HRPs aged 16 and over,277,184,147,42,105,16,21,93,49,1,17,18,8
S01012499,Owned: Total,122,93,82,9,73,8,3,29,26,0,1,1,1
S01012499,Owned: Owned outright,34,16,12,0,12,2,2,18,16,0,0,1,1
S01012499,Owned: Owned with a mortgage or loan or shared ownership,88,77,70,9,61,6,1,11,10,0,1,0,0
S01012499,Rented or living rent free: Total,155,91,65,33,32,8,18,64,23,1,16,17,7
S01012499,Rented or living rent free: Social rented,119,65,49,25,24,3,13,54,17,0,15,17,5
S01012499,Rented or living rent free: Private rented or living rent free,36,26,16,8,8,5,5,10,6,1,1,0,2
S01012500,All HRPs aged 16 and over,217,130,100,35,65,8,22,87,43,2,9,28,5
S01012500,Owned: Total,91,60,53,10,43,6,1,31,30,0,0,0,1
S01012500,Owned: Owned outright,40,14,11,3,8,3,0,26,25,0,0,0,1
S01012500,Owned: Owned with a mortgage or loan or shared ownership,51,46,42,7,35,3,1,5,5,0,0,0,0
S01012500,Rented or living rent free: Total,126,70,47,25,22,2,21,56,13,2,9,28,4
S01012500,Rented or living rent free: Social rented,99,52,33,18,15,2,17,47,10,0,6,27,4
S01012500,Rented or living rent free: Private rented or living rent free,27,18,14,7,7,0,4,9,3,2,3,1,0
S01012501,All HRPs aged 16 and over,260,145,127,49,78,1,17,115,42,5,20,34,14
S01012501,Owned: Total,63,42,40,7,33,1,1,21,17,0,0,4,0
S01012501,Owned: Owned outright,23,9,8,2,6,0,1,14,11,0,0,3,0
S01012501,Owned: Owned with a mortgage or loan or shared ownership,40,33,32,5,27,1,0,7,6,0,0,1,0
S01012501,Rented or living rent free: Total,197,103,87,42,45,0,16,94,25,5,20,30,14
S01012501,Rented or living rent free: Social rented,171,88,74,38,36,0,14,83,25,3,15,28,12
S01012501,Rented or living rent free: Private rented or living rent free,26,15,13,4,9,0,2,11,0,2,5,2,2
S01012502,All HRPs aged 16 and over,360,224,152,69,83,20,52,136,59,3,21,39,14
S01012502,Owned: Total,103,68,53,14,39,12,3,35,31,0,1,3,0
S01012502,Owned: Owned outright,42,12,9,4,5,3,0,30,28,0,0,2,0
S01012502,Owned: Owned with a mortgage or loan or shared ownership,61,56,44,10,34,9,3,5,3,0,1,1,0
S01012502,Rented or living rent free: Total,257,156,99,55,44,8,49,101,28,3,20,36,14
S01012502,Rented or living rent free: Social rented,238,143,90,51,39,8,45,95,26,3,17,36,13
S01012502,Rented or living rent free: Private rented or living rent free,19,13,9,4,5,0,4,6,2,0,3,0,1
S01012503,All HRPs aged 16 and over,308,162,131,46,85,12,19,146,90,1,11,39,5
S01012503,Owned: Total,130,75,67,13,54,8,0,55,49,0,0,5,1
S01012503,Owned: Owned outright,59,18,18,7,11,0,0,41,38,0,0,2,1
S01012503,Owned: Owned with a mortgage or loan or shared ownership,71,57,49,6,43,8,0,14,11,0,0,3,0
S01012503,Rented or living rent free: Total,178,87,64,33,31,4,19,91,41,1,11,34,4
S01012503,Rented or living rent free: Social rented,155,72,54,30,24,2,16,83,39,0,8,32,4
S01012503,Rented or living rent free: Private rented or living rent free,23,15,10,3,7,2,3,8,2,1,3,2,0
S01012504,All HRPs aged 16 and over,282,176,139,43,96,11,26,106,63,4,9,23,7
S01012504,Owned: Total,138,89,76,16,60,9,4,49,44,0,0,5,0
S01012504,Owned: Owned outright,63,23,20,7,13,2,1,40,36,0,0,4,0
S01012504,Owned: Owned with a mortgage or loan or shared ownership,75,66,56,9,47,7,3,9,8,0,0,1,0
S01012504,Rented or living rent free: Total,144,87,63,27,36,2,22,57,19,4,9,18,7
S01012504,Rented or living rent free: Social rented,121,72,52,21,31,1,19,49,15,4,8,16,6
S01012504,Rented or living rent free: Private rented or living rent free,23,15,11,6,5,1,3,8,4,0,1,2,1
S01012505,All HRPs aged 16 and over,515,289,228,58,170,29,32,226,146,2,13,59,6
S01012505,Owned: Total,273,168,142,26,116,22,4,105,99,0,1,5,0
S01012505,Owned: Owned outright,134,46,36,14,22,9,1,88,85,0,1,2,0
S01012505,Owned: Owned with a mortgage or loan or shared ownership,139,122,106,12,94,13,3,17,14,0,0,3,0
S01012505,Rented or living rent free: Total,242,121,86,32,54,7,28,121,47,2,12,54,6
S01012505,Rented or living rent free: Social rented,202,97,70,29,41,3,24,105,42,2,10,47,4
S01012505,Rented or living rent free: Private rented or living rent free,40,24,16,3,13,4,4,16,5,0,2,7,2
S01012506,All HRPs aged 16 and over,241,131,105,15,90,18,8,110,94,2,3,10,1
S01012506,Owned: Total,170,93,77,7,70,16,0,77,73,1,2,1,0
S01012506,Owned: Owned outright,92,25,19,3,16,6,0,67,66,0,1,0,0
S01012506,Owned: Owned with a mortgage or loan or shared ownership,78,68,58,4,54,10,0,10,7,1,1,1,0
S01012506,Rented or living rent free: Total,71,38,28,8,20,2,8,33,21,1,1,9,1
S01012506,Rented or living rent free: Social rented,44,20,16,5,11,0,4,24,17,1,0,6,0
S01012506,Rented or living rent free: Private rented or living rent free,27,18,12,3,9,2,4,9,4,0,1,3,1
S01012507,All HRPs aged 16 and over,482,275,228,54,174,28,19,207,163,3,9,27,5
S01012507,Owned: Total,322,197,171,27,144,21,5,125,118,0,0,6,1
S01012507,Owned: Owned outright,137,45,36,10,26,5,4,92,89,0,0,2,1
S01012507,Owned: Owned with a mortgage or loan or shared ownership,185,152,135,17,118,16,1,33,29,0,0,4,0
S01012507,Rented or living rent free: Total,160,78,57,27,30,7,14,82,45,3,9,21,4
S01012507,Rented or living rent free: Social rented,97,31,21,10,11,4,6,66,40,0,5,18,3
S01012507,Rented or living rent free: Private rented or living rent free,63,47,36,17,19,3,8,16,5,3,4,3,1
S01012508,All HRPs aged 16 and over,399,241,202,31,171,23,16,158,122,0,2,31,3
S01012508,Owned: Total,272,179,154,13,141,21,4,93,91,0,0,2,0
S01012508,Owned: Owned outright,111,38,29,6,23,7,2,73,72,0,0,1,0
S01012508,Owned: Owned with a mortgage or loan or shared ownership,161,141,125,7,118,14,2,20,19,0,0,1,0
S01012508,Rented or living rent free: Total,127,62,48,18,30,2,12,65,31,0,2,29,3
S01012508,Rented or living rent free: Social rented,81,26,20,9,11,0,6,55,27,0,2,23,3
S01012508,Rented or living rent free: Private rented or living rent free,46,36,28,9,19,2,6,10,4,0,0,6,0
S01012509,All HRPs aged 16 and over,256,152,122,21,101,28,2,104,95,0,4,3,2
S01012509,Owned: Total,217,132,104,15,89,27,1,85,83,0,1,0,1
S01012509,Owned: Owned outright,115,37,28,11,17,9,0,78,77,0,0,0,1
S01012509,Owned: Owned with a mortgage or loan or shared ownership,102,95,76,4,72,18,1,7,6,0,1,0,0
S01012509,Rented or living rent free: Total,39,20,18,6,12,1,1,19,12,0,3,3,1
S01012509,Rented or living rent free: Social rented,16,6,5,4,1,1,0,10,6,0,1,3,0
S01012509,Rented or living rent free: Private rented or living rent free,23,14,13,2,11,0,1,9,6,0,2,0,1
S01012510,All HRPs aged 16 and over,381,267,237,34,203,17,13,114,95,0,2,12,5
S01012510,Owned: Total,322,234,210,23,187,17,7,88,85,0,0,1,2
S01012510,Owned: Owned outright,135,57,45,13,32,11,1,78,75,0,0,1,2
S01012510,Owned: Owned with a mortgage or loan or shared ownership,187,177,165,10,155,6,6,10,10,0,0,0,0
S01012510,Rented or living rent free: Total,59,33,27,11,16,0,6,26,10,0,2,11,3
S01012510,Rented or living rent free: Social rented,34,13,8,3,5,0,5,21,6,0,1,11,3
S01012510,Rented or living rent free: Private rented or living rent free,25,20,19,8,11,0,1,5,4,0,1,0,0
S01012511,All HRPs aged 16 and over,316,211,196,40,156,9,6,105,86,0,2,13,4
S01012511,Owned: Total,234,157,148,28,120,7,2,77,73,0,1,2,1
S01012511,Owned: Owned outright,107,38,35,14,21,2,1,69,66,0,1,1,1
S01012511,Owned: Owned with a mortgage or loan or shared ownership,127,119,113,14,99,5,1,8,7,0,0,1,0
S01012511,Rented or living rent free: Total,82,54,48,12,36,2,4,28,13,0,1,11,3
S01012511,Rented or living rent free: Social rented,47,25,24,6,18,0,1,22,10,0,1,9,2
S01012511,Rented or living rent free: Private rented or living rent free,35,29,24,6,18,2,3,6,3,0,0,2,1
S01012512,All HRPs aged 16 and over,286,180,140,33,107,18,22,106,65,2,8,26,5
S01012512,Owned: Total,175,115,96,13,83,16,3,60,57,1,1,1,0
S01012512,Owned: Owned outright,84,34,28,9,19,4,2,50,49,0,0,1,0
S01012512,Owned: Owned with a mortgage or loan or shared ownership,91,81,68,4,64,12,1,10,8,1,1,0,0
S01012512,Rented or living rent free: Total,111,65,44,20,24,2,19,46,8,1,7,25,5
S01012512,Rented or living rent free: Social rented,94,52,34,18,16,2,16,42,7,1,7,22,5
S01012512,Rented or living rent free: Private rented or living rent free,17,13,10,2,8,0,3,4,1,0,0,3,0
S01012513,All HRPs aged 16 and over,234,178,159,25,134,16,3,56,51,0,0,4,1
S01012513,Owned: Total,207,157,140,14,126,15,2,50,49,0,0,1,0
S01012513,Owned: Owned outright,74,32,26,4,22,6,0,42,41,0,0,1,0
S01012513,Owned: Owned with a mortgage or loan or shared ownership,133,125,114,10,104,9,2,8,8,0,0,0,0
S01012513,Rented or living rent free: Total,27,21,19,11,8,1,1,6,2,0,0,3,1
S01012513,Rented or living rent free: Social rented,7,4,2,2,0,1,1,3,0,0,0,3,0
S01012513,Rented or living rent free: Private rented or living rent free,20,17,17,9,8,0,0,3,2,0,0,0,1
S01012514,All HRPs aged 16 and over,392,351,309,41,268,35,7,41,28,3,5,3,2
S01012514,Owned: Total,331,303,270,27,243,28,5,28,26,0,1,1,0
S01012514,Owned: Owned outright,57,41,38,9,29,2,1,16,15,0,0,1,0
S01012514,Owned: Owned with a mortgage or loan or shared ownership,274,262,232,18,214,26,4,12,11,0,1,0,0
S01012514,Rented or living rent free: Total,61,48,39,14,25,7,2,13,2,3,4,2,2
S01012514,Rented or living rent free: Social rented,16,11,6,2,4,3,2,5,0,2,2,0,1
S01012514,Rented or living rent free: Private rented or living rent free,45,37,33,12,21,4,0,8,2,1,2,2,1
S01012515,All HRPs aged 16 and over,319,158,137,45,92,14,7,161,123,1,3,31,3
S01012515,Owned: Total,155,94,81,20,61,11,2,61,56,0,0,5,0
S01012515,Owned: Owned outright,68,21,16,8,8,4,1,47,45,0,0,2,0
S01012515,Owned: Owned with a mortgage or loan or shared ownership,87,73,65,12,53,7,1,14,11,0,0,3,0
S01012515,Rented or living rent free: Total,164,64,56,25,31,3,5,100,67,1,3,26,3
S01012515,Rented or living rent free: Social rented,141,46,42,21,21,2,2,95,66,1,2,23,3
S01012515,Rented or living rent free: Private rented or living rent free,23,18,14,4,10,1,3,5,1,0,1,3,0
S01012516,All HRPs aged 16 and over,301,170,136,30,106,18,16,131,106,0,6,15,4
S01012516,Owned: Total,202,122,104,19,85,15,3,80,76,0,1,2,1
S01012516,Owned: Owned outright,90,24,19,7,12,4,1,66,64,0,0,1,1
S01012516,Owned: Owned with a mortgage or loan or shared ownership,112,98,85,12,73,11,2,14,12,0,1,1,0
S01012516,Rented or living rent free: Total,99,48,32,11,21,3,13,51,30,0,5,13,3
S01012516,Rented or living rent free: Social rented,76,31,19,7,12,2,10,45,28,0,4,12,1
S01012516,Rented or living rent free: Private rented or living rent free,23,17,13,4,9,1,3,6,2,0,1,1,2
S01012517,All HRPs aged 16 and over,410,260,223,53,170,24,13,150,101,4,12,26,7
S01012517,Owned: Total,252,180,160,28,132,20,0,72,64,1,2,5,0
S01012517,Owned: Owned outright,99,42,37,16,21,5,0,57,56,1,0,0,0
S01012517,Owned: Owned with a mortgage or loan or shared ownership,153,138,123,12,111,15,0,15,8,0,2,5,0
S01012517,Rented or living rent free: Total,158,80,63,25,38,4,13,78,37,3,10,21,7
S01012517,Rented or living rent free: Social rented,97,42,32,18,14,1,9,55,30,0,4,18,3
S01012517,Rented or living rent free: Private rented or living rent free,61,38,31,7,24,3,4,23,7,3,6,3,4
S01012518,All HRPs aged 16 and over,277,166,126,18,108,34,6,111,99,1,1,7,3
S01012518,Owned: Total,214,127,96,8,88,28,3,87,84,1,0,1,1
S01012518,Owned: Owned outright,110,39,29,4,25,10,0,71,70,1,0,0,0
S01012518,Owned: Owned with a mortgage or loan or shared ownership,104,88,67,4,63,18,3,16,14,0,0,1,1
S01012518,Rented or living rent free: Total,63,39,30,10,20,6,3,24,15,0,1,6,2
S01012518,Rented or living rent free: Social rented,24,7,5,2,3,1,1,17,12,0,0,4,1
S01012518,Rented or living rent free: Private rented or living rent free,39,32,25,8,17,5,2,7,3,0,1,2,1
S01012519,All HRPs aged 16 and over,279,160,119,30,89,30,11,119,109,1,1,5,3
S01012519,Owned: Total,201,108,84,12,72,23,1,93,90,1,0,1,1
S01012519,Owned: Owned outright,113,31,23,6,17,7,1,82,80,1,0,1,0
S01012519,Owned: Owned with a mortgage or loan or shared ownership,88,77,61,6,55,16,0,11,10,0,0,0,1
S01012519,Rented or living rent free: Total,78,52,35,18,17,7,10,26,19,0,1,4,2
S01012519,Rented or living rent free: Social rented,12,4,2,1,1,0,2,8,7,0,0,1,0
S01012519,Rented or living rent free: Private rented or living rent free,66,48,33,17,16,7,8,18,12,0,1,3,2
S01012520,All HRPs aged 16 and over,345,198,161,19,142,33,4,147,138,0,1,5,3
S01012520,Owned: Total,314,178,143,16,127,32,3,136,130,0,1,3,2
S01012520,Owned: Owned outright,198,70,51,11,40,16,3,128,123,0,1,2,2
S01012520,Owned: Owned with a mortgage or loan or shared ownership,116,108,92,5,87,16,0,8,7,0,0,1,0
S01012520,Rented or living rent free: Total,31,20,18,3,15,1,1,11,8,0,0,2,1
S01012520,Rented or living rent free: Social rented,8,3,2,0,2,0,1,5,3,0,0,1,1
S01012520,Rented or living rent free: Private rented or living rent free,23,17,16,3,13,1,0,6,5,0,0,1,0
S01012521,All HRPs aged 16 and over,270,165,134,18,116,25,6,105,91,1,5,6,2
S01012521,Owned: Total,206,118,93,11,82,22,3,88,86,0,0,0,2
S01012521,Owned: Owned outright,106,30,21,3,18,8,1,76,75,0,0,0,1
S01012521,Owned: Owned with a mortgage or loan or shared ownership,100,88,72,8,64,14,2,12,11,0,0,0,1
S01012521,Rented or living rent free: Total,64,47,41,7,34,3,3,17,5,1,5,6,0
S01012521,Rented or living rent free: Social rented,5,3,1,1,0,2,0,2,0,0,1,1,0
S01012521,Rented or living rent free: Private rented or living rent free,59,44,40,6,34,1,3,15,5,1,4,5,0
S01012522,All HRPs aged 16 and over,360,218,158,25,133,53,7,142,134,0,0,8,0
S01012522,Owned: Total,325,195,142,22,120,49,4,130,127,0,0,3,0
S01012522,Owned: Owned outright,193,73,53,13,40,17,3,120,119,0,0,1,0
S01012522,Owned: Owned with a mortgage or loan or shared ownership,132,122,89,9,80,32,1,10,8,0,0,2,0
S01012522,Rented or living rent free: Total,35,23,16,3,13,4,3,12,7,0,0,5,0
S01012522,Rented or living rent free: Social rented,4,2,1,0,1,1,0,2,1,0,0,1,0
S01012522,Rented or living rent free: Private rented or living rent free,31,21,15,3,12,3,3,10,6,0,0,4,0
S01012523,All HRPs aged 16 and over,385,231,196,37,159,28,7,154,144,2,2,4,2
S01012523,Owned: Total,334,197,170,29,141,25,2,137,132,0,1,4,0
S01012523,Owned: Owned outright,182,61,52,21,31,7,2,121,116,0,1,4,0
S01012523,Owned: Owned with a mortgage or loan or shared ownership,152,136,118,8,110,18,0,16,16,0,0,0,0
S01012523,Rented or living rent free: Total,51,34,26,8,18,3,5,17,12,2,1,0,2
S01012523,Rented or living rent free: Social rented,21,17,10,5,5,2,5,4,2,1,0,0,1
S01012523,Rented or living rent free: Private rented or living rent free,30,17,16,3,13,1,0,13,10,1,1,0,1
S01012524,All HRPs aged 16 and over,467,232,196,31,165,33,3,235,226,0,0,6,3
S01012524,Owned: Total,397,200,171,24,147,28,1,197,194,0,0,2,1
S01012524,Owned: Owned outright,246,71,61,16,45,9,1,175,172,0,0,2,1
S01012524,Owned: Owned with a mortgage or loan or shared ownership,151,129,110,8,102,19,0,22,22,0,0,0,0
S01012524,Rented or living rent free: Total,70,32,25,7,18,5,2,38,32,0,0,4,2
S01012524,Rented or living rent free: Social rented,21,3,3,2,1,0,0,18,16,0,0,1,1
S01012524,Rented or living rent free: Private rented or living rent free,49,29,22,5,17,5,2,20,16,0,0,3,1
S01012525,All HRPs aged 16 and over,341,218,185,17,168,28,5,123,115,1,3,3,1
S01012525,Owned: Total,305,191,162,13,149,26,3,114,110,0,2,2,0
S01012525,Owned: Owned outright,152,54,43,5,38,9,2,98,95,0,2,1,0
S01012525,Owned: Owned with a mortgage or loan or shared ownership,153,137,119,8,111,17,1,16,15,0,0,1,0
S01012525,Rented or living rent free: Total,36,27,23,4,19,2,2,9,5,1,1,1,1
S01012525,Rented or living rent free: Social rented,6,3,3,1,2,0,0,3,2,0,0,0,1
S01012525,Rented or living rent free: Private rented or living rent free,30,24,20,3,17,2,2,6,3,1,1,1,0
S01012526,All HRPs aged 16 and over,334,187,157,21,136,29,1,147,142,0,1,2,2
S01012526,Owned: Total,313,173,144,18,126,28,1,140,137,0,1,1,1
S01012526,Owned: Owned outright,179,49,42,8,34,7,0,130,129,0,1,0,0
S01012526,Owned: Owned with a mortgage or loan or shared ownership,134,124,102,10,92,21,1,10,8,0,0,1,1
S01012526,Rented or living rent free: Total,21,14,13,3,10,1,0,7,5,0,0,1,1
S01012526,Rented or living rent free: Social rented,3,2,2,1,1,0,0,1,0,0,0,1,0
S01012526,Rented or living rent free: Private rented or living rent free,18,12,11,2,9,1,0,6,5,0,0,0,1
S01012527,All HRPs aged 16 and over,285,146,122,14,108,23,1,139,125,0,1,9,4
S01012527,Owned: Total,240,126,109,10,99,17,0,114,112,0,1,0,1
S01012527,Owned: Owned outright,140,46,41,9,32,5,0,94,93,0,1,0,0
S01012527,Owned: Owned with a mortgage or loan or shared ownership,100,80,68,1,67,12,0,20,19,0,0,0,1
S01012527,Rented or living rent free: Total,45,20,13,4,9,6,1,25,13,0,0,9,3
S01012527,Rented or living rent free: Social rented,31,9,7,1,6,2,0,22,11,0,0,8,3
S01012527,Rented or living rent free: Private rented or living rent free,14,11,6,3,3,4,1,3,2,0,0,1,0
S01012528,All HRPs aged 16 and over,337,227,193,42,151,27,7,110,86,3,7,12,2
S01012528,Owned: Total,226,168,145,25,120,20,3,58,56,0,0,1,1
S01012528,Owned: Owned outright,77,33,29,7,22,4,0,44,43,0,0,1,0
S01012528,Owned: Owned with a mortgage or loan or shared ownership,149,135,116,18,98,16,3,14,13,0,0,0,1
S01012528,Rented or living rent free: Total,111,59,48,17,31,7,4,52,30,3,7,11,1
S01012528,Rented or living rent free: Social rented,82,39,33,14,19,2,4,43,25,2,6,9,1
S01012528,Rented or living rent free: Private rented or living rent free,29,20,15,3,12,5,0,9,5,1,1,2,0
S01012529,All HRPs aged 16 and over,342,202,168,39,129,24,10,140,116,3,10,9,2
S01012529,Owned: Total,237,135,112,19,93,20,3,102,98,0,1,2,1
S01012529,Owned: Owned outright,124,40,33,14,19,5,2,84,81,0,0,2,1
S01012529,Owned: Owned with a mortgage or loan or shared ownership,113,95,79,5,74,15,1,18,17,0,1,0,0
S01012529,Rented or living rent free: Total,105,67,56,20,36,4,7,38,18,3,9,7,1
S01012529,Rented or living rent free: Social rented,56,32,24,11,13,3,5,24,14,1,3,5,1
S01012529,Rented or living rent free: Private rented or living rent free,49,35,32,9,23,1,2,14,4,2,6,2,0
S01012530,All HRPs aged 16 and over,400,209,180,25,155,24,5,191,185,1,2,2,1
S01012530,Owned: Total,372,196,171,23,148,22,3,176,173,1,1,0,1
S01012530,Owned: Owned outright,228,67,56,18,38,9,2,161,159,0,1,0,1
S01012530,Owned: Owned with a mortgage or loan or shared ownership,144,129,115,5,110,13,1,15,14,1,0,0,0
S01012530,Rented or living rent free: Total,28,13,9,2,7,2,2,15,12,0,1,2,0
S01012530,Rented or living rent free: Social rented,8,3,3,2,1,0,0,5,4,0,0,1,0
S01012530,Rented or living rent free: Private rented or living rent free,20,10,6,0,6,2,2,10,8,0,1,1,0
S01012531,All HRPs aged 16 and over,332,218,177,16,161,34,7,114,87,3,3,18,3
S01012531,Owned: Total,248,168,136,8,128,28,4,80,71,2,0,5,2
S01012531,Owned: Owned outright,105,38,24,1,23,13,1,67,61,1,0,3,2
S01012531,Owned: Owned with a mortgage or loan or shared ownership,143,130,112,7,105,15,3,13,10,1,0,2,0
S01012531,Rented or living rent free: Total,84,50,41,8,33,6,3,34,16,1,3,13,1
S01012531,Rented or living rent free: Social rented,30,13,11,6,5,1,1,17,8,0,2,7,0
S01012531,Rented or living rent free: Private rented or living rent free,54,37,30,2,28,5,2,17,8,1,1,6,1
S01012532,All HRPs aged 16 and over,348,217,168,22,146,42,7,131,115,0,1,14,1
S01012532,Owned: Total,251,164,131,15,116,31,2,87,83,0,0,4,0
S01012532,Owned: Owned outright,114,43,28,9,19,15,0,71,69,0,0,2,0
S01012532,Owned: Owned with a mortgage or loan or shared ownership,137,121,103,6,97,16,2,16,14,0,0,2,0
S01012532,Rented or living rent free: Total,97,53,37,7,30,11,5,44,32,0,1,10,1
S01012532,Rented or living rent free: Social rented,43,11,7,3,4,2,2,32,25,0,0,7,0
S01012532,Rented or living rent free: Private rented or living rent free,54,42,30,4,26,9,3,12,7,0,1,3,1
S01012533,All HRPs aged 16 and over,274,173,153,24,129,16,4,101,92,1,3,4,1
S01012533,Owned: Total,186,112,96,15,81,14,2,74,71,0,1,2,0
S01012533,Owned: Owned outright,98,34,29,8,21,5,0,64,62,0,1,1,0
S01012533,Owned: Owned with a mortgage or loan or shared ownership,88,78,67,7,60,9,2,10,9,0,0,1,0
S01012533,Rented or living rent free: Total,88,61,57,9,48,2,2,27,21,1,2,2,1
S01012533,Rented or living rent free: Social rented,23,9,9,4,5,0,0,14,10,0,1,2,1
S01012533,Rented or living rent free: Private rented or living rent free,65,52,48,5,43,2,2,13,11,1,1,0,0
S01012534,All HRPs aged 16 and over,288,161,142,23,119,13,6,127,98,0,6,20,3
S01012534,Owned: Total,190,130,115,13,102,12,3,60,52,0,2,5,1
S01012534,Owned: Owned outright,83,31,27,9,18,4,0,52,47,0,2,3,0
S01012534,Owned: Owned with a mortgage or loan or shared ownership,107,99,88,4,84,8,3,8,5,0,0,2,1
S01012534,Rented or living rent free: Total,98,31,27,10,17,1,3,67,46,0,4,15,2
S01012534,Rented or living rent free: Social rented,68,14,12,7,5,0,2,54,38,0,1,14,1
S01012534,Rented or living rent free: Private rented or living rent free,30,17,15,3,12,1,1,13,8,0,3,1,1
S01012535,All HRPs aged 16 and over,361,226,192,36,156,27,7,135,113,1,5,16,0
S01012535,Owned: Total,265,182,155,20,135,24,3,83,79,0,0,4,0
S01012535,Owned: Owned outright,110,47,38,10,28,7,2,63,61,0,0,2,0
S01012535,Owned: Owned with a mortgage or loan or shared ownership,155,135,117,10,107,17,1,20,18,0,0,2,0
S01012535,Rented or living rent free: Total,96,44,37,16,21,3,4,52,34,1,5,12,0
S01012535,Rented or living rent free: Social rented,75,29,24,11,13,2,3,46,32,1,4,9,0
S01012535,Rented or living rent free: Private rented or living rent free,21,15,13,5,8,1,1,6,2,0,1,3,0
S01012536,All HRPs aged 16 and over,312,206,169,43,126,28,9,106,82,4,3,15,2
S01012536,Owned: Total,210,148,125,22,103,23,0,62,59,0,1,1,1
S01012536,Owned: Owned outright,95,42,32,12,20,10,0,53,51,0,1,1,0
S01012536,Owned: Owned with a mortgage or loan or shared ownership,115,106,93,10,83,13,0,9,8,0,0,0,1
S01012536,Rented or living rent free: Total,102,58,44,21,23,5,9,44,23,4,2,14,1
S01012536,Rented or living rent free: Social rented,78,44,34,16,18,2,8,34,18,2,1,12,1
S01012536,Rented or living rent free: Private rented or living rent free,24,14,10,5,5,3,1,10,5,2,1,2,0
S01012537,All HRPs aged 16 and over,334,195,160,35,125,19,16,139,110,2,6,13,8
S01012537,Owned: Total,208,129,109,19,90,15,5,79,72,0,3,1,3
S01012537,Owned: Owned outright,94,35,25,12,13,6,4,59,56,0,1,1,1
S01012537,Owned: Owned with a mortgage or loan or shared ownership,114,94,84,7,77,9,1,20,16,0,2,0,2
S01012537,Rented or living rent free: Total,126,66,51,16,35,4,11,60,38,2,3,12,5
S01012537,Rented or living rent free: Social rented,88,37,26,9,17,3,8,51,34,1,2,9,5
S01012537,Rented or living rent free: Private rented or living rent free,38,29,25,7,18,1,3,9,4,1,1,3,0
S01012538,All HRPs aged 16 and over,476,304,243,63,180,38,23,172,128,0,13,25,6
S01012538,Owned: Total,321,219,179,32,147,34,6,102,95,0,2,5,0
S01012538,Owned: Owned outright,147,61,49,19,30,9,3,86,82,0,1,3,0
S01012538,Owned: Owned with a mortgage or loan or shared ownership,174,158,130,13,117,25,3,16,13,0,1,2,0
S01012538,Rented or living rent free: Total,155,85,64,31,33,4,17,70,33,0,11,20,6
S01012538,Rented or living rent free: Social rented,120,57,46,25,21,1,10,63,29,0,8,20,6
S01012538,Rented or living rent free: Private rented or living rent free,35,28,18,6,12,3,7,7,4,0,3,0,0
S01012539,All HRPs aged 16 and over,315,192,141,25,116,46,5,123,100,1,0,16,6
S01012539,Owned: Total,217,140,104,11,93,36,0,77,73,0,0,4,0
S01012539,Owned: Owned outright,118,53,34,6,28,19,0,65,62,0,0,3,0
S01012539,Owned: Owned with a mortgage or loan or shared ownership,99,87,70,5,65,17,0,12,11,0,0,1,0
S01012539,Rented or living rent free: Total,98,52,37,14,23,10,5,46,27,1,0,12,6
S01012539,Rented or living rent free: Social rented,62,30,23,11,12,2,5,32,19,1,0,10,2
S01012539,Rented or living rent free: Private rented or living rent free,36,22,14,3,11,8,0,14,8,0,0,2,4
S01012540,All HRPs aged 16 and over,299,166,136,28,108,18,12,133,96,2,8,21,6
S01012540,Owned: Total,160,101,88,14,74,12,1,59,52,1,1,4,1
S01012540,Owned: Owned outright,66,19,16,4,12,3,0,47,43,1,1,2,0
S01012540,Owned: Owned with a mortgage or loan or shared ownership,94,82,72,10,62,9,1,12,9,0,0,2,1
S01012540,Rented or living rent free: Total,139,65,48,14,34,6,11,74,44,1,7,17,5
S01012540,Rented or living rent free: Social rented,125,56,39,12,27,6,11,69,39,1,7,17,5
S01012540,Rented or living rent free: Private rented or living rent free,14,9,9,2,7,0,0,5,5,0,0,0,0
S01012541,All HRPs aged 16 and over,442,330,223,59,164,95,12,112,91,3,4,10,4
S01012541,Owned: Total,284,216,140,27,113,75,1,68,62,0,1,3,2
S01012541,Owned: Owned outright,151,98,51,16,35,46,1,53,49,0,1,2,1
S01012541,Owned: Owned with a mortgage or loan or shared ownership,133,118,89,11,78,29,0,15,13,0,0,1,1
S01012541,Rented or living rent free: Total,158,114,83,32,51,20,11,44,29,3,3,7,2
S01012541,Rented or living rent free: Social rented,87,58,52,26,26,1,5,29,16,2,3,6,2
S01012541,Rented or living rent free: Private rented or living rent free,71,56,31,6,25,19,6,15,13,1,0,1,0
S01012542,All HRPs aged 16 and over,380,224,178,29,149,41,5,156,140,3,3,10,0
S01012542,Owned: Total,302,184,142,15,127,40,2,118,111,2,1,4,0
S01012542,Owned: Owned outright,156,53,39,6,33,14,0,103,99,0,1,3,0
S01012542,Owned: Owned with a mortgage or loan or shared ownership,146,131,103,9,94,26,2,15,12,2,0,1,0
S01012542,Rented or living rent free: Total,78,40,36,14,22,1,3,38,29,1,2,6,0
S01012542,Rented or living rent free: Social rented,48,24,21,9,12,0,3,24,16,1,2,5,0
S01012542,Rented or living rent free: Private rented or living rent free,30,16,15,5,10,1,0,14,13,0,0,1,0
S01012543,All HRPs aged 16 and over,276,207,147,20,127,55,5,69,57,0,2,6,4
S01012543,Owned: Total,228,173,123,12,111,47,3,55,50,0,0,1,4
S01012543,Owned: Owned outright,91,50,28,3,25,22,0,41,40,0,0,0,1
S01012543,Owned: Owned with a mortgage or loan or shared ownership,137,123,95,9,86,25,3,14,10,0,0,1,3
S01012543,Rented or living rent free: Total,48,34,24,8,16,8,2,14,7,0,2,5,0
S01012543,Rented or living rent free: Social rented,22,11,8,3,5,1,2,11,6,0,1,4,0
S01012543,Rented or living rent free: Private rented or living rent free,26,23,16,5,11,7,0,3,1,0,1,1,0
S01012544,All HRPs aged 16 and over,341,228,180,32,148,40,8,113,86,2,7,16,2
S01012544,Owned: Total,245,171,138,14,124,32,1,74,69,0,2,2,1
S01012544,Owned: Owned outright,106,44,30,7,23,14,0,62,62,0,0,0,0
S01012544,Owned: Owned with a mortgage or loan or shared ownership,139,127,108,7,101,18,1,12,7,0,2,2,1
S01012544,Rented or living rent free: Total,96,57,42,18,24,8,7,39,17,2,5,14,1
S01012544,Rented or living rent free: Social rented,70,40,27,13,14,7,6,30,14,1,3,11,1
S01012544,Rented or living rent free: Private rented or living rent free,26,17,15,5,10,1,1,9,3,1,2,3,0
S01012545,All HRPs aged 16 and over,214,134,105,24,81,17,12,80,72,1,2,5,0
S01012545,Owned: Total,110,82,67,7,60,13,2,28,28,0,0,0,0
S01012545,Owned: Owned outright,43,20,15,5,10,4,1,23,23,0,0,0,0
S01012545,Owned: Owned with a mortgage or loan or shared ownership,67,62,52,2,50,9,1,5,5,0,0,0,0
S01012545,Rented or living rent free: Total,104,52,38,17,21,4,10,52,44,1,2,5,0
S01012545,Rented or living rent free: Social rented,97,47,37,17,20,2,8,50,43,1,2,4,0
S01012545,Rented or living rent free: Private rented or living rent free,7,5,1,0,1,2,2,2,1,0,0,1,0
S01012546,All HRPs aged 16 and over,322,211,162,23,139,38,11,111,80,2,7,16,6
S01012546,Owned: Total,234,164,130,14,116,32,2,70,63,0,2,3,2
S01012546,Owned: Owned outright,97,41,28,5,23,13,0,56,52,0,1,2,1
S01012546,Owned: Owned with a mortgage or loan or shared ownership,137,123,102,9,93,19,2,14,11,0,1,1,1
S01012546,Rented or living rent free: Total,88,47,32,9,23,6,9,41,17,2,5,13,4
S01012546,Rented or living rent free: Social rented,54,23,16,5,11,2,5,31,12,2,4,9,4
S01012546,Rented or living rent free: Private rented or living rent free,34,24,16,4,12,4,4,10,5,0,1,4,0
S01012547,All HRPs aged 16 and over,312,167,130,19,111,31,6,145,127,2,5,6,5
S01012547,Owned: Total,253,145,113,14,99,28,4,108,105,0,1,1,1
S01012547,Owned: Owned outright,152,62,48,10,38,12,2,90,89,0,0,0,1
S01012547,Owned: Owned with a mortgage or loan or shared ownership,101,83,65,4,61,16,2,18,16,0,1,1,0
S01012547,Rented or living rent free: Total,59,22,17,5,12,3,2,37,22,2,4,5,4
S01012547,Rented or living rent free: Social rented,46,16,12,4,8,2,2,30,17,2,4,4,3
S01012547,Rented or living rent free: Private rented or living rent free,13,6,5,1,4,1,0,7,5,0,0,1,1
S01012548,All HRPs aged 16 and over,394,225,177,24,153,42,6,169,155,2,1,8,3
S01012548,Owned: Total,335,195,157,20,137,33,5,140,134,2,0,2,2
S01012548,Owned: Owned outright,183,62,44,12,32,15,3,121,116,1,0,2,2
S01012548,Owned: Owned with a mortgage or loan or shared ownership,152,133,113,8,105,18,2,19,18,1,0,0,0
S01012548,Rented or living rent free: Total,59,30,20,4,16,9,1,29,21,0,1,6,1
S01012548,Rented or living rent free: Social rented,25,6,4,1,3,2,0,19,11,0,1,6,1
S01012548,Rented or living rent free: Private rented or living rent free,34,24,16,3,13,7,1,10,10,0,0,0,0
S01012549,All HRPs aged 16 and over,251,154,128,26,102,13,13,97,63,1,4,25,4
S01012549,Owned: Total,132,98,86,13,73,9,3,34,31,0,0,3,0
S01012549,Owned: Owned outright,44,19,14,4,10,3,2,25,23,0,0,2,0
S01012549,Owned: Owned with a mortgage or loan or shared ownership,88,79,72,9,63,6,1,9,8,0,0,1,0
S01012549,Rented or living rent free: Total,119,56,42,13,29,4,10,63,32,1,4,22,4
S01012549,Rented or living rent free: Social rented,88,33,26,8,18,2,5,55,29,1,3,19,3
S01012549,Rented or living rent free: Private rented or living rent free,31,23,16,5,11,2,5,8,3,0,1,3,1
S01012550,All HRPs aged 16 and over,345,220,180,43,137,26,14,125,99,3,2,17,4
S01012550,Owned: Total,244,170,146,31,115,19,5,74,63,0,1,9,1
S01012550,Owned: Owned outright,108,53,43,16,27,7,3,55,51,0,1,3,0
S01012550,Owned: Owned with a mortgage or loan or shared ownership,136,117,103,15,88,12,2,19,12,0,0,6,1
S01012550,Rented or living rent free: Total,101,50,34,12,22,7,9,51,36,3,1,8,3
S01012550,Rented or living rent free: Social rented,70,27,18,10,8,6,3,43,31,2,0,7,3
S01012550,Rented or living rent free: Private rented or living rent free,31,23,16,2,14,1,6,8,5,1,1,1,0
S01012551,All HRPs aged 16 and over,319,226,190,26,164,32,4,93,88,1,3,1,0
S01012551,Owned: Total,305,214,181,24,157,31,2,91,87,1,2,1,0
S01012551,Owned: Owned outright,158,78,66,18,48,10,2,80,79,1,0,0,0
S01012551,Owned: Owned with a mortgage or loan or shared ownership,147,136,115,6,109,21,0,11,8,0,2,1,0
S01012551,Rented or living rent free: Total,14,12,9,2,7,1,2,2,1,0,1,0,0
S01012551,Rented or living rent free: Social rented,4,3,2,1,1,0,1,1,0,0,1,0,0
S01012551,Rented or living rent free: Private rented or living rent free,10,9,7,1,6,1,1,1,1,0,0,0,0
S01012552,All HRPs aged 16 and over,352,236,198,18,180,36,2,116,112,1,3,0,0
S01012552,Owned: Total,326,217,185,15,170,31,1,109,107,0,2,0,0
S01012552,Owned: Owned outright,152,58,51,11,40,7,0,94,93,0,1,0,0
S01012552,Owned: Owned with a mortgage or loan or shared ownership,174,159,134,4,130,24,1,15,14,0,1,0,0
S01012552,Rented or living rent free: Total,26,19,13,3,10,5,1,7,5,1,1,0,0
S01012552,Rented or living rent free: Social rented,6,4,2,1,1,1,1,2,1,0,1,0,0
S01012552,Rented or living rent free: Private rented or living rent free,20,15,11,2,9,4,0,5,4,1,0,0,0
S01012553,All HRPs aged 16 and over,347,275,240,31,209,32,3,72,54,1,6,9,2
S01012553,Owned: Total,315,253,220,23,197,31,2,62,53,0,4,3,2
S01012553,Owned: Owned outright,88,45,38,6,32,6,1,43,39,0,0,3,1
S01012553,Owned: Owned with a mortgage or loan or shared ownership,227,208,182,17,165,25,1,19,14,0,4,0,1
S01012553,Rented or living rent free: Total,32,22,20,8,12,1,1,10,1,1,2,6,0
S01012553,Rented or living rent free: Social rented,7,1,1,0,1,0,0,6,1,1,0,4,0
S01012553,Rented or living rent free: Private rented or living rent free,25,21,19,8,11,1,1,4,0,0,2,2,0
S01012554,All HRPs aged 16 and over,190,138,115,22,93,19,4,52,47,0,2,2,1
S01012554,Owned: Total,173,125,105,18,87,17,3,48,46,0,1,0,1
S01012554,Owned: Owned outright,87,44,35,14,21,7,2,43,42,0,1,0,0
S01012554,Owned: Owned with a mortgage or loan or shared ownership,86,81,70,4,66,10,1,5,4,0,0,0,1
S01012554,Rented or living rent free: Total,17,13,10,4,6,2,1,4,1,0,1,2,0
S01012554,Rented or living rent free: Social rented,1,0,0,0,0,0,0,1,0,0,1,0,0
S01012554,Rented or living rent free: Private rented or living rent free,16,13,10,4,6,2,1,3,1,0,0,2,0
S01012555,All HRPs aged 16 and over,211,151,129,16,113,19,3,60,54,2,1,3,0
S01012555,Owned: Total,190,135,113,14,99,19,3,55,53,1,1,0,0
S01012555,Owned: Owned outright,86,37,27,9,18,8,2,49,48,0,1,0,0
S01012555,Owned: Owned with a mortgage or loan or shared ownership,104,98,86,5,81,11,1,6,5,1,0,0,0
S01012555,Rented or living rent free: Total,21,16,16,2,14,0,0,5,1,1,0,3,0
S01012555,Rented or living rent free: Social rented,3,1,1,0,1,0,0,2,0,0,0,2,0
S01012555,Rented or living rent free: Private rented or living rent free,18,15,15,2,13,0,0,3,1,1,0,1,0
S01012556,All HRPs aged 16 and over,221,140,114,12,102,23,3,81,77,0,0,3,1
S01012556,Owned: Total,207,131,108,12,96,20,3,76,73,0,0,2,1
S01012556,Owned: Owned outright,108,37,30,5,25,6,1,71,68,0,0,2,1
S01012556,Owned: Owned with a mortgage or loan or shared ownership,99,94,78,7,71,14,2,5,5,0,0,0,0
S01012556,Rented or living rent free: Total,14,9,6,0,6,3,0,5,4,0,0,1,0
S01012556,Rented or living rent free: Social rented,6,2,1,0,1,1,0,4,3,0,0,1,0
S01012556,Rented or living rent free: Private rented or living rent free,8,7,5,0,5,2,0,1,1,0,0,0,0
S01012557,All HRPs aged 16 and over,249,140,108,20,88,31,1,109,102,0,4,1,2
S01012557,Owned: Total,224,123,95,17,78,28,0,101,96,0,2,1,2
S01012557,Owned: Owned outright,146,53,44,13,31,9,0,93,88,0,2,1,2
S01012557,Owned: Owned with a mortgage or loan or shared ownership,78,70,51,4,47,19,0,8,8,0,0,0,0
S01012557,Rented or living rent free: Total,25,17,13,3,10,3,1,8,6,0,2,0,0
S01012557,Rented or living rent free: Social rented,6,5,3,1,2,1,1,1,1,0,0,0,0
S01012557,Rented or living rent free: Private rented or living rent free,19,12,10,2,8,2,0,7,5,0,2,0,0
S01012558,All HRPs aged 16 and over,279,182,144,26,118,18,20,97,70,0,5,15,7
S01012558,Owned: Total,164,115,101,10,91,11,3,49,45,0,0,0,4
S01012558,Owned: Owned outright,66,26,21,4,17,3,2,40,38,0,0,0,2
S01012558,Owned: Owned with a mortgage or loan or shared ownership,98,89,80,6,74,8,1,9,7,0,0,0,2
S01012558,Rented or living rent free: Total,115,67,43,16,27,7,17,48,25,0,5,15,3
S01012558,Rented or living rent free: Social rented,80,41,23,10,13,3,15,39,18,0,4,14,3
S01012558,Rented or living rent free: Private rented or living rent free,35,26,20,6,14,4,2,9,7,0,1,1,0
S01012559,All HRPs aged 16 and over,457,226,177,45,132,27,22,231,176,3,11,31,10
S01012559,Owned: Total,206,93,74,12,62,16,3,113,104,1,2,2,4
S01012559,Owned: Owned outright,111,17,11,3,8,4,2,94,88,0,1,1,4
S01012559,Owned: Owned with a mortgage or loan or shared ownership,95,76,63,9,54,12,1,19,16,1,1,1,0
S01012559,Rented or living rent free: Total,251,133,103,33,70,11,19,118,72,2,9,29,6
S01012559,Rented or living rent free: Social rented,166,76,60,26,34,0,16,90,55,2,9,20,4
S01012559,Rented or living rent free: Private rented or living rent free,85,57,43,7,36,11,3,28,17,0,0,9,2
S01012560,All HRPs aged 16 and over,264,134,116,29,87,12,6,130,117,0,5,6,2
S01012560,Owned: Total,171,100,89,14,75,10,1,71,68,0,2,1,0
S01012560,Owned: Owned outright,89,27,23,7,16,3,1,62,62,0,0,0,0
S01012560,Owned: Owned with a mortgage or loan or shared ownership,82,73,66,7,59,7,0,9,6,0,2,1,0
S01012560,Rented or living rent free: Total,93,34,27,15,12,2,5,59,49,0,3,5,2
S01012560,Rented or living rent free: Social rented,70,16,13,8,5,0,3,54,47,0,3,3,1
S01012560,Rented or living rent free: Private rented or living rent free,23,18,14,7,7,2,2,5,2,0,0,2,1
S01012561,All HRPs aged 16 and over,365,207,176,33,143,22,9,158,136,2,0,17,3
S01012561,Owned: Total,234,156,135,16,119,16,5,78,73,1,0,3,1
S01012561,Owned: Owned outright,97,36,34,9,25,2,0,61,59,1,0,1,0
S01012561,Owned: Owned with a mortgage or loan or shared ownership,137,120,101,7,94,14,5,17,14,0,0,2,1
S01012561,Rented or living rent free: Total,131,51,41,17,24,6,4,80,63,1,0,14,2
S01012561,Rented or living rent free: Social rented,93,26,20,6,14,3,3,67,54,0,0,12,1
S01012561,Rented or living rent free: Private rented or living rent free,38,25,21,11,10,3,1,13,9,1,0,2,1
S01012562,All HRPs aged 16 and over,434,259,213,36,177,25,21,175,124,3,5,39,4
S01012562,Owned: Total,238,153,133,15,118,15,5,85,76,1,1,6,1
S01012562,Owned: Owned outright,94,27,23,5,18,4,0,67,64,0,0,3,0
S01012562,Owned: Owned with a mortgage or loan or shared ownership,144,126,110,10,100,11,5,18,12,1,1,3,1
S01012562,Rented or living rent free: Total,196,106,80,21,59,10,16,90,48,2,4,33,3
S01012562,Rented or living rent free: Social rented,93,30,20,5,15,4,6,63,43,0,1,19,0
S01012562,Rented or living rent free: Private rented or living rent free,103,76,60,16,44,6,10,27,5,2,3,14,3
S01012563,All HRPs aged 16 and over,271,135,99,15,84,35,1,136,132,1,1,1,1
S01012563,Owned: Total,260,129,94,13,81,34,1,131,128,1,1,0,1
S01012563,Owned: Owned outright,179,53,37,12,25,15,1,126,124,1,0,0,1
S01012563,Owned: Owned with a mortgage or loan or shared ownership,81,76,57,1,56,19,0,5,4,0,1,0,0
S01012563,Rented or living rent free: Total,11,6,5,2,3,1,0,5,4,0,0,1,0
S01012563,Rented or living rent free: Social rented,2,0,0,0,0,0,0,2,2,0,0,0,0
S01012563,Rented or living rent free: Private rented or living rent free,9,6,5,2,3,1,0,3,2,0,0,1,0
S01012564,All HRPs aged 16 and over,373,203,156,19,137,46,1,170,158,1,1,9,1
S01012564,Owned: Total,342,184,140,16,124,44,0,158,153,0,0,4,1
S01012564,Owned: Owned outright,205,61,45,12,33,16,0,144,140,0,0,3,1
S01012564,Owned: Owned with a mortgage or loan or shared ownership,137,123,95,4,91,28,0,14,13,0,0,1,0
S01012564,Rented or living rent free: Total,31,19,16,3,13,2,1,12,5,1,1,5,0
S01012564,Rented or living rent free: Social rented,11,5,5,2,3,0,0,6,0,1,0,5,0
S01012564,Rented or living rent free: Private rented or living rent free,20,14,11,1,10,2,1,6,5,0,1,0,0
S01012565,All HRPs aged 16 and over,379,184,144,20,124,39,1,195,180,0,4,7,4
S01012565,Owned: Total,273,149,120,13,107,29,0,124,118,0,2,2,2
S01012565,Owned: Owned outright,145,48,33,5,28,15,0,97,94,0,0,2,1
S01012565,Owned: Owned with a mortgage or loan or shared ownership,128,101,87,8,79,14,0,27,24,0,2,0,1
S01012565,Rented or living rent free: Total,106,35,24,7,17,10,1,71,62,0,2,5,2
S01012565,Rented or living rent free: Social rented,67,1,0,0,0,1,0,66,60,0,2,3,1
S01012565,Rented or living rent free: Private rented or living rent free,39,34,24,7,17,9,1,5,2,0,0,2,1
S01012566,All HRPs aged 16 and over,445,272,208,38,170,48,16,173,137,1,3,23,9
S01012566,Owned: Total,253,159,122,19,103,32,5,94,85,0,2,5,2
S01012566,Owned: Owned outright,125,48,37,10,27,9,2,77,72,0,1,3,1
S01012566,Owned: Owned with a mortgage or loan or shared ownership,128,111,85,9,76,23,3,17,13,0,1,2,1
S01012566,Rented or living rent free: Total,192,113,86,19,67,16,11,79,52,1,1,18,7
S01012566,Rented or living rent free: Social rented,57,7,5,1,4,0,2,50,37,0,0,9,4
S01012566,Rented or living rent free: Private rented or living rent free,135,106,81,18,63,16,9,29,15,1,1,9,3
S01012567,All HRPs aged 16 and over,557,346,272,62,210,47,27,211,166,2,8,32,3
S01012567,Owned: Total,319,199,166,32,134,29,4,120,115,1,0,4,0
S01012567,Owned: Owned outright,160,70,56,19,37,11,3,90,88,0,0,2,0
S01012567,Owned: Owned with a mortgage or loan or shared ownership,159,129,110,13,97,18,1,30,27,1,0,2,0
S01012567,Rented or living rent free: Total,238,147,106,30,76,18,23,91,51,1,8,28,3
S01012567,Rented or living rent free: Social rented,108,45,32,12,20,4,9,63,32,1,6,21,3
S01012567,Rented or living rent free: Private rented or living rent free,130,102,74,18,56,14,14,28,19,0,2,7,0
S01012568,All HRPs aged 16 and over,281,145,101,12,89,37,7,136,120,1,2,10,3
S01012568,Owned: Total,237,129,91,11,80,34,4,108,107,0,0,1,0
S01012568,Owned: Owned outright,133,40,26,8,18,11,3,93,92,0,0,1,0
S01012568,Owned: Owned with a mortgage or loan or shared ownership,104,89,65,3,62,23,1,15,15,0,0,0,0
S01012568,Rented or living rent free: Total,44,16,10,1,9,3,3,28,13,1,2,9,3
S01012568,Rented or living rent free: Social rented,15,2,2,1,1,0,0,13,5,1,1,4,2
S01012568,Rented or living rent free: Private rented or living rent free,29,14,8,0,8,3,3,15,8,0,1,5,1
S01012569,All HRPs aged 16 and over,315,176,106,18,88,65,5,139,135,0,0,2,2
S01012569,Owned: Total,286,154,89,16,73,60,5,132,130,0,0,0,2
S01012569,Owned: Owned outright,180,60,39,11,28,18,3,120,118,0,0,0,2
S01012569,Owned: Owned with a mortgage or loan or shared ownership,106,94,50,5,45,42,2,12,12,0,0,0,0
S01012569,Rented or living rent free: Total,29,22,17,2,15,5,0,7,5,0,0,2,0
S01012569,Rented or living rent free: Social rented,5,4,2,1,1,2,0,1,0,0,0,1,0
S01012569,Rented or living rent free: Private rented or living rent free,24,18,15,1,14,3,0,6,5,0,0,1,0
S01012570,All HRPs aged 16 and over,197,148,108,14,94,35,5,49,45,0,0,3,1
S01012570,Owned: Total,134,97,69,8,61,26,2,37,35,0,0,1,1
S01012570,Owned: Owned outright,66,32,18,5,13,13,1,34,32,0,0,1,1
S01012570,Owned: Owned with a mortgage or loan or shared ownership,68,65,51,3,48,13,1,3,3,0,0,0,0
S01012570,Rented or living rent free: Total,63,51,39,6,33,9,3,12,10,0,0,2,0
S01012570,Rented or living rent free: Social rented,32,22,18,2,16,2,2,10,8,0,0,2,0
S01012570,Rented or living rent free: Private rented or living rent free,31,29,21,4,17,7,1,2,2,0,0,0,0
S01012571,All HRPs aged 16 and over,362,237,153,20,133,70,14,125,101,2,6,15,1
S01012571,Owned: Total,222,155,99,12,87,51,5,67,61,1,2,3,0
S01012571,Owned: Owned outright,121,60,32,7,25,26,2,61,56,1,1,3,0
S01012571,Owned: Owned with a mortgage or loan or shared ownership,101,95,67,5,62,25,3,6,5,0,1,0,0
S01012571,Rented or living rent free: Total,140,82,54,8,46,19,9,58,40,1,4,12,1
S01012571,Rented or living rent free: Social rented,58,27,19,4,15,2,6,31,20,0,1,9,1
S01012571,Rented or living rent free: Private rented or living rent free,82,55,35,4,31,17,3,27,20,1,3,3,0
S01012572,All HRPs aged 16 and over,224,159,108,17,91,44,7,65,53,2,5,2,3
S01012572,Owned: Total,150,107,72,9,63,34,1,43,36,1,3,0,3
S01012572,Owned: Owned outright,76,42,20,6,14,21,1,34,30,0,1,0,3
S01012572,Owned: Owned with a mortgage or loan or shared ownership,74,65,52,3,49,13,0,9,6,1,2,0,0
S01012572,Rented or living rent free: Total,74,52,36,8,28,10,6,22,17,1,2,2,0
S01012572,Rented or living rent free: Social rented,38,19,15,2,13,1,3,19,14,1,2,2,0
S01012572,Rented or living rent free: Private rented or living rent free,36,33,21,6,15,9,3,3,3,0,0,0,0
S01012573,All HRPs aged 16 and over,325,245,164,12,152,79,2,80,73,0,0,7,0
S01012573,Owned: Total,265,201,133,9,124,66,2,64,61,0,0,3,0
S01012573,Owned: Owned outright,131,78,45,6,39,32,1,53,51,0,0,2,0
S01012573,Owned: Owned with a mortgage or loan or shared ownership,134,123,88,3,85,34,1,11,10,0,0,1,0
S01012573,Rented or living rent free: Total,60,44,31,3,28,13,0,16,12,0,0,4,0
S01012573,Rented or living rent free: Social rented,9,4,4,0,4,0,0,5,4,0,0,1,0
S01012573,Rented or living rent free: Private rented or living rent free,51,40,27,3,24,13,0,11,8,0,0,3,0
S01012574,All HRPs aged 16 and over,359,242,178,20,158,61,3,117,111,0,2,2,2
S01012574,Owned: Total,297,211,154,13,141,56,1,86,83,0,1,1,1
S01012574,Owned: Owned outright,148,73,50,9,41,23,0,75,72,0,1,1,1
S01012574,Owned: Owned with a mortgage or loan or shared ownership,149,138,104,4,100,33,1,11,11,0,0,0,0
S01012574,Rented or living rent free: Total,62,31,24,7,17,5,2,31,28,0,1,1,1
S01012574,Rented or living rent free: Social rented,34,13,11,2,9,0,2,21,19,0,1,0,1
S01012574,Rented or living rent free: Private rented or living rent free,28,18,13,5,8,5,0,10,9,0,0,1,0
S01012575,All HRPs aged 16 and over,289,200,151,29,122,42,7,89,80,1,1,6,1
S01012575,Owned: Total,202,133,97,14,83,35,1,69,66,0,1,2,0
S01012575,Owned: Owned outright,107,51,34,7,27,16,1,56,55,0,0,1,0
S01012575,Owned: Owned with a mortgage or loan or shared ownership,95,82,63,7,56,19,0,13,11,0,1,1,0
S01012575,Rented or living rent free: Total,87,67,54,15,39,7,6,20,14,1,0,4,1
S01012575,Rented or living rent free: Social rented,35,23,17,6,11,1,5,12,8,1,0,2,1
S01012575,Rented or living rent free: Private rented or living rent free,52,44,37,9,28,6,1,8,6,0,0,2,0
S01012576,All HRPs aged 16 and over,370,242,186,24,162,51,5,128,121,2,3,2,0
S01012576,Owned: Total,285,180,133,17,116,46,1,105,102,0,1,2,0
S01012576,Owned: Owned outright,162,64,46,13,33,17,1,98,96,0,0,2,0
S01012576,Owned: Owned with a mortgage or loan or shared ownership,123,116,87,4,83,29,0,7,6,0,1,0,0
S01012576,Rented or living rent free: Total,85,62,53,7,46,5,4,23,19,2,2,0,0
S01012576,Rented or living rent free: Social rented,23,11,9,2,7,1,1,12,12,0,0,0,0
S01012576,Rented or living rent free: Private rented or living rent free,62,51,44,5,39,4,3,11,7,2,2,0,0
S01012577,All HRPs aged 16 and over,336,244,179,31,148,58,7,92,80,1,3,7,1
S01012577,Owned: Total,249,183,134,21,113,46,3,66,60,0,1,4,1
S01012577,Owned: Owned outright,122,67,44,11,33,22,1,55,50,0,0,4,1
S01012577,Owned: Owned with a mortgage or loan or shared ownership,127,116,90,10,80,24,2,11,10,0,1,0,0
S01012577,Rented or living rent free: Total,87,61,45,10,35,12,4,26,20,1,2,3,0
S01012577,Rented or living rent free: Social rented,41,25,21,8,13,2,2,16,12,0,1,3,0
S01012577,Rented or living rent free: Private rented or living rent free,46,36,24,2,22,10,2,10,8,1,1,0,0
S01012578,All HRPs aged 16 and over,463,250,195,28,167,50,5,213,192,3,3,7,8
S01012578,Owned: Total,297,181,138,17,121,42,1,116,112,0,0,1,3
S01012578,Owned: Owned outright,163,54,34,11,23,19,1,109,105,0,0,1,3
S01012578,Owned: Owned with a mortgage or loan or shared ownership,134,127,104,6,98,23,0,7,7,0,0,0,0
S01012578,Rented or living rent free: Total,166,69,57,11,46,8,4,97,80,3,3,6,5
S01012578,Rented or living rent free: Social rented,120,39,33,8,25,3,3,81,70,0,3,4,4
S01012578,Rented or living rent free: Private rented or living rent free,46,30,24,3,21,5,1,16,10,3,0,2,1
S01012579,All HRPs aged 16 and over,287,207,150,22,128,44,13,80,63,0,3,11,3
S01012579,Owned: Total,179,137,100,11,89,36,1,42,39,0,0,3,0
S01012579,Owned: Owned outright,72,41,22,6,16,18,1,31,30,0,0,1,0
S01012579,Owned: Owned with a mortgage or loan or shared ownership,107,96,78,5,73,18,0,11,9,0,0,2,0
S01012579,Rented or living rent free: Total,108,70,50,11,39,8,12,38,24,0,3,8,3
S01012579,Rented or living rent free: Social rented,79,46,31,10,21,6,9,33,20,0,2,8,3
S01012579,Rented or living rent free: Private rented or living rent free,29,24,19,1,18,2,3,5,4,0,1,0,0
S01012580,All HRPs aged 16 and over,325,256,174,17,157,75,7,69,60,0,2,5,2
S01012580,Owned: Total,251,200,134,12,122,64,2,51,49,0,1,0,1
S01012580,Owned: Owned outright,127,81,50,8,42,31,0,46,45,0,0,0,1
S01012580,Owned: Owned with a mortgage or loan or shared ownership,124,119,84,4,80,33,2,5,4,0,1,0,0
S01012580,Rented or living rent free: Total,74,56,40,5,35,11,5,18,11,0,1,5,1
S01012580,Rented or living rent free: Social rented,26,16,12,3,9,0,4,10,3,0,1,5,1
S01012580,Rented or living rent free: Private rented or living rent free,48,40,28,2,26,11,1,8,8,0,0,0,0
S01012581,All HRPs aged 16 and over,331,212,161,22,139,22,29,119,82,0,13,18,6
S01012581,Owned: Total,155,112,93,6,87,17,2,43,40,0,1,0,2
S01012581,Owned: Owned outright,69,35,27,5,22,6,2,34,32,0,0,0,2
S01012581,Owned: Owned with a mortgage or loan or shared ownership,86,77,66,1,65,11,0,9,8,0,1,0,0
S01012581,Rented or living rent free: Total,176,100,68,16,52,5,27,76,42,0,12,18,4
S01012581,Rented or living rent free: Social rented,157,85,57,14,43,5,23,72,39,0,11,18,4
S01012581,Rented or living rent free: Private rented or living rent free,19,15,11,2,9,0,4,4,3,0,1,0,0
S01012582,All HRPs aged 16 and over,365,276,209,29,180,62,5,89,74,0,3,9,3
S01012582,Owned: Total,282,220,164,17,147,54,2,62,57,0,2,3,0
S01012582,Owned: Owned outright,121,66,39,9,30,26,1,55,50,0,2,3,0
S01012582,Owned: Owned with a mortgage or loan or shared ownership,161,154,125,8,117,28,1,7,7,0,0,0,0
S01012582,Rented or living rent free: Total,83,56,45,12,33,8,3,27,17,0,1,6,3
S01012582,Rented or living rent free: Social rented,46,24,20,6,14,3,1,22,13,0,0,6,3
S01012582,Rented or living rent free: Private rented or living rent free,37,32,25,6,19,5,2,5,4,0,1,0,0
S01012583,All HRPs aged 16 and over,326,215,174,23,151,23,18,111,88,0,6,12,5
S01012583,Owned: Total,194,143,122,9,113,20,1,51,50,0,0,1,0
S01012583,Owned: Owned outright,93,49,36,5,31,12,1,44,44,0,0,0,0
S01012583,Owned: Owned with a mortgage or loan or shared ownership,101,94,86,4,82,8,0,7,6,0,0,1,0
S01012583,Rented or living rent free: Total,132,72,52,14,38,3,17,60,38,0,6,11,5
S01012583,Rented or living rent free: Social rented,112,60,42,11,31,3,15,52,33,0,5,10,4
S01012583,Rented or living rent free: Private rented or living rent free,20,12,10,3,7,0,2,8,5,0,1,1,1
S01012584,All HRPs aged 16 and over,331,210,165,26,139,42,3,121,104,1,0,10,6
S01012584,Owned: Total,254,174,134,14,120,40,0,80,72,0,0,4,4
S01012584,Owned: Owned outright,122,49,32,7,25,17,0,73,68,0,0,3,2
S01012584,Owned: Owned with a mortgage or loan or shared ownership,132,125,102,7,95,23,0,7,4,0,0,1,2
S01012584,Rented or living rent free: Total,77,36,31,12,19,2,3,41,32,1,0,6,2
S01012584,Rented or living rent free: Social rented,60,24,20,8,12,2,2,36,28,0,0,6,2
S01012584,Rented or living rent free: Private rented or living rent free,17,12,11,4,7,0,1,5,4,1,0,0,0
S01012585,All HRPs aged 16 and over,404,266,210,40,170,34,22,138,110,0,12,14,2
S01012585,Owned: Total,204,145,118,13,105,24,3,59,57,0,1,0,1
S01012585,Owned: Owned outright,92,37,29,8,21,6,2,55,54,0,1,0,0
S01012585,Owned: Owned with a mortgage or loan or shared ownership,112,108,89,5,84,18,1,4,3,0,0,0,1
S01012585,Rented or living rent free: Total,200,121,92,27,65,10,19,79,53,0,11,14,1
S01012585,Rented or living rent free: Social rented,165,97,75,21,54,8,14,68,46,0,9,13,0
S01012585,Rented or living rent free: Private rented or living rent free,35,24,17,6,11,2,5,11,7,0,2,1,1
S01012586,All HRPs aged 16 and over,313,246,188,15,173,54,4,67,58,1,3,5,0
S01012586,Owned: Total,270,219,167,11,156,50,2,51,46,1,2,2,0
S01012586,Owned: Owned outright,93,51,34,7,27,17,0,42,42,0,0,0,0
S01012586,Owned: Owned with a mortgage or loan or shared ownership,177,168,133,4,129,33,2,9,4,1,2,2,0
S01012586,Rented or living rent free: Total,43,27,21,4,17,4,2,16,12,0,1,3,0
S01012586,Rented or living rent free: Social rented,10,2,1,0,1,0,1,8,7,0,0,1,0
S01012586,Rented or living rent free: Private rented or living rent free,33,25,20,4,16,4,1,8,5,0,1,2,0
S01012587,All HRPs aged 16 and over,327,240,173,10,163,63,4,87,78,0,3,5,1
S01012587,Owned: Total,283,213,153,9,144,59,1,70,66,0,2,2,0
S01012587,Owned: Owned outright,133,70,38,7,31,32,0,63,61,0,1,1,0
S01012587,Owned: Owned with a mortgage or loan or shared ownership,150,143,115,2,113,27,1,7,5,0,1,1,0
S01012587,Rented or living rent free: Total,44,27,20,1,19,4,3,17,12,0,1,3,1
S01012587,Rented or living rent free: Social rented,9,4,3,0,3,0,1,5,3,0,0,1,1
S01012587,Rented or living rent free: Private rented or living rent free,35,23,17,1,16,4,2,12,9,0,1,2,0
S01012588,All HRPs aged 16 and over,256,192,143,11,132,45,4,64,57,0,2,4,1
S01012588,Owned: Total,219,169,127,9,118,39,3,50,44,0,2,3,1
S01012588,Owned: Owned outright,99,54,36,6,30,18,0,45,42,0,1,1,1
S01012588,Owned: Owned with a mortgage or loan or shared ownership,120,115,91,3,88,21,3,5,2,0,1,2,0
S01012588,Rented or living rent free: Total,37,23,16,2,14,6,1,14,13,0,0,1,0
S01012588,Rented or living rent free: Social rented,16,8,6,0,6,2,0,8,7,0,0,1,0
S01012588,Rented or living rent free: Private rented or living rent free,21,15,10,2,8,4,1,6,6,0,0,0,0
S01012589,All HRPs aged 16 and over,284,180,155,19,136,15,10,104,76,3,8,17,0
S01012589,Owned: Total,152,104,91,9,82,12,1,48,42,2,1,3,0
S01012589,Owned: Owned outright,68,27,21,4,17,5,1,41,37,2,1,1,0
S01012589,Owned: Owned with a mortgage or loan or shared ownership,84,77,70,5,65,7,0,7,5,0,0,2,0
S01012589,Rented or living rent free: Total,132,76,64,10,54,3,9,56,34,1,7,14,0
S01012589,Rented or living rent free: Social rented,118,68,58,9,49,2,8,50,31,0,5,14,0
S01012589,Rented or living rent free: Private rented or living rent free,14,8,6,1,5,1,1,6,3,1,2,0,0
S01012590,All HRPs aged 16 and over,371,217,172,25,147,22,23,154,107,1,15,27,4
S01012590,Owned: Total,191,132,112,8,104,19,1,59,52,0,2,5,0
S01012590,Owned: Owned outright,66,21,17,1,16,4,0,45,42,0,0,3,0
S01012590,Owned: Owned with a mortgage or loan or shared ownership,125,111,95,7,88,15,1,14,10,0,2,2,0
S01012590,Rented or living rent free: Total,180,85,60,17,43,3,22,95,55,1,13,22,4
S01012590,Rented or living rent free: Social rented,158,67,46,16,30,1,20,91,54,1,10,22,4
S01012590,Rented or living rent free: Private rented or living rent free,22,18,14,1,13,2,2,4,1,0,3,0,0
S01012591,All HRPs aged 16 and over,385,189,161,31,130,8,20,196,151,0,14,25,6
S01012591,Owned: Total,183,103,95,7,88,6,2,80,76,0,1,3,0
S01012591,Owned: Owned outright,103,37,32,5,27,4,1,66,65,0,1,0,0
S01012591,Owned: Owned with a mortgage or loan or shared ownership,80,66,63,2,61,2,1,14,11,0,0,3,0
S01012591,Rented or living rent free: Total,202,86,66,24,42,2,18,116,75,0,13,22,6
S01012591,Rented or living rent free: Social rented,189,80,61,22,39,1,18,109,71,0,12,20,6
S01012591,Rented or living rent free: Private rented or living rent free,13,6,5,2,3,1,0,7,4,0,1,2,0
S01012592,All HRPs aged 16 and over,215,161,118,11,107,40,3,54,46,0,1,6,1
S01012592,Owned: Total,201,151,112,10,102,38,1,50,45,0,1,3,1
S01012592,Owned: Owned outright,77,33,21,5,16,12,0,44,40,0,0,3,1
S01012592,Owned: Owned with a mortgage or loan or shared ownership,124,118,91,5,86,26,1,6,5,0,1,0,0
S01012592,Rented or living rent free: Total,14,10,6,1,5,2,2,4,1,0,0,3,0
S01012592,Rented or living rent free: Social rented,4,2,2,1,1,0,0,2,1,0,0,1,0
S01012592,Rented or living rent free: Private rented or living rent free,10,8,4,0,4,2,2,2,0,0,0,2,0
S01012593,All HRPs aged 16 and over,333,255,228,19,209,21,6,78,65,0,3,10,0
S01012593,Owned: Total,302,237,213,17,196,21,3,65,59,0,0,6,0
S01012593,Owned: Owned outright,114,58,50,10,40,7,1,56,54,0,0,2,0
S01012593,Owned: Owned with a mortgage or loan or shared ownership,188,179,163,7,156,14,2,9,5,0,0,4,0
S01012593,Rented or living rent free: Total,31,18,15,2,13,0,3,13,6,0,3,4,0
S01012593,Rented or living rent free: Social rented,14,6,5,1,4,0,1,8,4,0,1,3,0
S01012593,Rented or living rent free: Private rented or living rent free,17,12,10,1,9,0,2,5,2,0,2,1,0
S01012594,All HRPs aged 16 and over,212,128,115,22,93,10,3,84,71,0,0,10,3
S01012594,Owned: Total,174,112,101,16,85,10,1,62,59,0,0,2,1
S01012594,Owned: Owned outright,80,29,25,9,16,3,1,51,51,0,0,0,0
S01012594,Owned: Owned with a mortgage or loan or shared ownership,94,83,76,7,69,7,0,11,8,0,0,2,1
S01012594,Rented or living rent free: Total,38,16,14,6,8,0,2,22,12,0,0,8,2
S01012594,Rented or living rent free: Social rented,31,10,10,3,7,0,0,21,12,0,0,8,1
S01012594,Rented or living rent free: Private rented or living rent free,7,6,4,3,1,0,2,1,0,0,0,0,1
S01012595,All HRPs aged 16 and over,288,179,147,22,125,23,9,109,80,1,6,18,4
S01012595,Owned: Total,215,138,117,12,105,17,4,77,66,1,3,5,2
S01012595,Owned: Owned outright,96,36,27,6,21,7,2,60,52,1,1,4,2
S01012595,Owned: Owned with a mortgage or loan or shared ownership,119,102,90,6,84,10,2,17,14,0,2,1,0
S01012595,Rented or living rent free: Total,73,41,30,10,20,6,5,32,14,0,3,13,2
S01012595,Rented or living rent free: Social rented,53,31,22,8,14,4,5,22,10,0,2,8,2
S01012595,Rented or living rent free: Private rented or living rent free,20,10,8,2,6,2,0,10,4,0,1,5,0
S01012596,All HRPs aged 16 and over,347,227,188,44,144,18,21,120,80,1,13,21,5
S01012596,Owned: Total,192,146,131,22,109,11,4,46,44,0,1,1,0
S01012596,Owned: Owned outright,59,26,20,3,17,3,3,33,32,0,0,1,0
S01012596,Owned: Owned with a mortgage or loan or shared ownership,133,120,111,19,92,8,1,13,12,0,1,0,0
S01012596,Rented or living rent free: Total,155,81,57,22,35,7,17,74,36,1,12,20,5
S01012596,Rented or living rent free: Social rented,133,69,47,19,28,6,16,64,33,1,11,16,3
S01012596,Rented or living rent free: Private rented or living rent free,22,12,10,3,7,1,1,10,3,0,1,4,2
S01012597,All HRPs aged 16 and over,177,141,122,4,118,12,7,36,31,0,2,2,1
S01012597,Owned: Total,150,129,114,3,111,12,3,21,20,0,0,1,0
S01012597,Owned: Owned outright,35,17,12,1,11,4,1,18,18,0,0,0,0
S01012597,Owned: Owned with a mortgage or loan or shared ownership,115,112,102,2,100,8,2,3,2,0,0,1,0
S01012597,Rented or living rent free: Total,27,12,8,1,7,0,4,15,11,0,2,1,1
S01012597,Rented or living rent free: Social rented,22,11,8,1,7,0,3,11,11,0,0,0,0
S01012597,Rented or living rent free: Private rented or living rent free,5,1,0,0,0,0,1,4,0,0,2,1,1
S01012598,All HRPs aged 16 and over,302,217,192,22,170,23,2,85,80,0,2,2,1
S01012598,Owned: Total,251,192,170,21,149,22,0,59,58,0,0,0,1
S01012598,Owned: Owned outright,119,64,55,11,44,9,0,55,54,0,0,0,1
S01012598,Owned: Owned with a mortgage or loan or shared ownership,132,128,115,10,105,13,0,4,4,0,0,0,0
S01012598,Rented or living rent free: Total,51,25,22,1,21,1,2,26,22,0,2,2,0
S01012598,Rented or living rent free: Social rented,20,1,0,0,0,0,1,19,17,0,0,2,0
S01012598,Rented or living rent free: Private rented or living rent free,31,24,22,1,21,1,1,7,5,0,2,0,0
S01012599,All HRPs aged 16 and over,330,201,166,20,146,26,9,129,106,2,4,10,7
S01012599,Owned: Total,256,154,129,11,118,21,4,102,93,1,2,1,5
S01012599,Owned: Owned outright,131,39,29,7,22,8,2,92,87,0,0,0,5
S01012599,Owned: Owned with a mortgage or loan or shared ownership,125,115,100,4,96,13,2,10,6,1,2,1,0
S01012599,Rented or living rent free: Total,74,47,37,9,28,5,5,27,13,1,2,9,2
S01012599,Rented or living rent free: Social rented,32,14,11,3,8,1,2,18,10,1,0,6,1
S01012599,Rented or living rent free: Private rented or living rent free,42,33,26,6,20,4,3,9,3,0,2,3,1
S01012600,All HRPs aged 16 and over,308,229,205,24,181,21,3,79,67,1,3,5,3
S01012600,Owned: Total,278,210,189,23,166,19,2,68,62,1,1,2,2
S01012600,Owned: Owned outright,128,72,63,15,48,8,1,56,51,0,1,2,2
S01012600,Owned: Owned with a mortgage or loan or shared ownership,150,138,126,8,118,11,1,12,11,1,0,0,0
S01012600,Rented or living rent free: Total,30,19,16,1,15,2,1,11,5,0,2,3,1
S01012600,Rented or living rent free: Social rented,2,1,1,1,0,0,0,1,0,0,0,1,0
S01012600,Rented or living rent free: Private rented or living rent free,28,18,15,0,15,2,1,10,5,0,2,2,1
S01012601,All HRPs aged 16 and over,357,275,240,22,218,31,4,82,76,0,3,1,2
S01012601,Owned: Total,325,254,222,16,206,29,3,71,67,0,3,1,0
S01012601,Owned: Owned outright,124,67,52,7,45,14,1,57,55,0,1,1,0
S01012601,Owned: Owned with a mortgage or loan or shared ownership,201,187,170,9,161,15,2,14,12,0,2,0,0
S01012601,Rented or living rent free: Total,32,21,18,6,12,2,1,11,9,0,0,0,2
S01012601,Rented or living rent free: Social rented,18,11,11,5,6,0,0,7,6,0,0,0,1
S01012601,Rented or living rent free: Private rented or living rent free,14,10,7,1,6,2,1,4,3,0,0,0,1
S01012602,All HRPs aged 16 and over,329,158,134,15,119,11,13,171,120,0,3,41,7
S01012602,Owned: Total,139,93,81,6,75,8,4,46,43,0,0,2,1
S01012602,Owned: Owned outright,55,16,13,3,10,3,0,39,37,0,0,1,1
S01012602,Owned: Owned with a mortgage or loan or shared ownership,84,77,68,3,65,5,4,7,6,0,0,1,0
S01012602,Rented or living rent free: Total,190,65,53,9,44,3,9,125,77,0,3,39,6
S01012602,Rented or living rent free: Social rented,152,36,28,7,21,3,5,116,72,0,2,37,5
S01012602,Rented or living rent free: Private rented or living rent free,38,29,25,2,23,0,4,9,5,0,1,2,1
S01012603,All HRPs aged 16 and over,337,190,152,21,131,17,21,147,108,5,5,25,4
S01012603,Owned: Total,180,119,106,9,97,13,0,61,58,0,0,3,0
S01012603,Owned: Owned outright,75,29,22,2,20,7,0,46,46,0,0,0,0
S01012603,Owned: Owned with a mortgage or loan or shared ownership,105,90,84,7,77,6,0,15,12,0,0,3,0
S01012603,Rented or living rent free: Total,157,71,46,12,34,4,21,86,50,5,5,22,4
S01012603,Rented or living rent free: Social rented,131,57,33,9,24,4,20,74,43,5,1,21,4
S01012603,Rented or living rent free: Private rented or living rent free,26,14,13,3,10,0,1,12,7,0,4,1,0
S01012604,All HRPs aged 16 and over,275,177,151,28,123,13,13,98,78,1,4,12,3
S01012604,Owned: Total,191,129,114,16,98,13,2,62,57,0,2,2,1
S01012604,Owned: Owned outright,89,41,37,9,28,2,2,48,46,0,1,1,0
S01012604,Owned: Owned with a mortgage or loan or shared ownership,102,88,77,7,70,11,0,14,11,0,1,1,1
S01012604,Rented or living rent free: Total,84,48,37,12,25,0,11,36,21,1,2,10,2
S01012604,Rented or living rent free: Social rented,72,39,29,11,18,0,10,33,19,1,1,10,2
S01012604,Rented or living rent free: Private rented or living rent free,12,9,8,1,7,0,1,3,2,0,1,0,0
S01012605,All HRPs aged 16 and over,240,131,113,25,88,12,6,109,91,0,3,11,4
S01012605,Owned: Total,163,90,79,12,67,11,0,73,70,0,0,1,2
S01012605,Owned: Owned outright,98,34,32,7,25,2,0,64,62,0,0,0,2
S01012605,Owned: Owned with a mortgage or loan or shared ownership,65,56,47,5,42,9,0,9,8,0,0,1,0
S01012605,Rented or living rent free: Total,77,41,34,13,21,1,6,36,21,0,3,10,2
S01012605,Rented or living rent free: Social rented,67,34,29,11,18,1,4,33,20,0,2,10,1
S01012605,Rented or living rent free: Private rented or living rent free,10,7,5,2,3,0,2,3,1,0,1,0,1
S01012606,All HRPs aged 16 and over,249,241,220,7,213,20,1,8,7,0,0,1,0
S01012606,Owned: Total,243,236,215,5,210,20,1,7,7,0,0,0,0
S01012606,Owned: Owned outright,29,22,18,0,18,3,1,7,7,0,0,0,0
S01012606,Owned: Owned with a mortgage or loan or shared ownership,214,214,197,5,192,17,0,0,0,0,0,0,0
S01012606,Rented or living rent free: Total,6,5,5,2,3,0,0,1,0,0,0,1,0
S01012606,Rented or living rent free: Social rented,3,3,3,2,1,0,0,0,0,0,0,0,0
S01012606,Rented or living rent free: Private rented or living rent free,3,2,2,0,2,0,0,1,0,0,0,1,0
S01012607,All HRPs aged 16 and over,312,214,165,15,150,36,13,98,78,1,2,13,4
S01012607,Owned: Total,243,177,142,12,130,32,3,66,61,0,2,2,1
S01012607,Owned: Owned outright,93,45,29,5,24,14,2,48,46,0,1,1,0
S01012607,Owned: Owned with a mortgage or loan or shared ownership,150,132,113,7,106,18,1,18,15,0,1,1,1
S01012607,Rented or living rent free: Total,69,37,23,3,20,4,10,32,17,1,0,11,3
S01012607,Rented or living rent free: Social rented,53,28,18,2,16,3,7,25,13,1,0,10,1
S01012607,Rented or living rent free: Private rented or living rent free,16,9,5,1,4,1,3,7,4,0,0,1,2
S01012608,All HRPs aged 16 and over,358,218,186,36,150,21,11,140,103,2,6,15,14
S01012608,Owned: Total,220,150,133,12,121,17,0,70,59,1,2,1,7
S01012608,Owned: Owned outright,84,28,25,6,19,3,0,56,50,0,0,0,6
S01012608,Owned: Owned with a mortgage or loan or shared ownership,136,122,108,6,102,14,0,14,9,1,2,1,1
S01012608,Rented or living rent free: Total,138,68,53,24,29,4,11,70,44,1,4,14,7
S01012608,Rented or living rent free: Social rented,124,58,46,21,25,2,10,66,40,1,4,14,7
S01012608,Rented or living rent free: Private rented or living rent free,14,10,7,3,4,2,1,4,4,0,0,0,0
S01012609,All HRPs aged 16 and over,383,220,190,40,150,17,13,163,101,0,21,34,7
S01012609,Owned: Total,187,131,114,15,99,15,2,56,49,0,1,4,2
S01012609,Owned: Owned outright,69,24,19,6,13,5,0,45,39,0,1,3,2
S01012609,Owned: Owned with a mortgage or loan or shared ownership,118,107,95,9,86,10,2,11,10,0,0,1,0
S01012609,Rented or living rent free: Total,196,89,76,25,51,2,11,107,52,0,20,30,5
S01012609,Rented or living rent free: Social rented,182,84,71,24,47,2,11,98,49,0,17,27,5
S01012609,Rented or living rent free: Private rented or living rent free,14,5,5,1,4,0,0,9,3,0,3,3,0
S01012610,All HRPs aged 16 and over,425,262,222,48,174,16,24,163,84,3,24,49,3
S01012610,Owned: Total,175,126,116,11,105,9,1,49,44,0,0,4,1
S01012610,Owned: Owned outright,55,18,17,2,15,1,0,37,37,0,0,0,0
S01012610,Owned: Owned with a mortgage or loan or shared ownership,120,108,99,9,90,8,1,12,7,0,0,4,1
S01012610,Rented or living rent free: Total,250,136,106,37,69,7,23,114,40,3,24,45,2
S01012610,Rented or living rent free: Social rented,225,118,94,34,60,4,20,107,38,3,20,44,2
S01012610,Rented or living rent free: Private rented or living rent free,25,18,12,3,9,3,3,7,2,0,4,1,0
S01012611,All HRPs aged 16 and over,352,225,188,25,163,29,8,127,107,1,5,14,0
S01012611,Owned: Total,285,191,162,18,144,26,3,94,91,0,0,3,0
S01012611,Owned: Owned outright,137,52,37,8,29,13,2,85,83,0,0,2,0
S01012611,Owned: Owned with a mortgage or loan or shared ownership,148,139,125,10,115,13,1,9,8,0,0,1,0
S01012611,Rented or living rent free: Total,67,34,26,7,19,3,5,33,16,1,5,11,0
S01012611,Rented or living rent free: Social rented,54,23,17,6,11,3,3,31,15,1,4,11,0
S01012611,Rented or living rent free: Private rented or living rent free,13,11,9,1,8,0,2,2,1,0,1,0,0
S01012612,All HRPs aged 16 and over,294,175,145,26,119,18,12,119,92,1,11,11,4
S01012612,Owned: Total,199,121,104,12,92,16,1,78,74,0,2,0,2
S01012612,Owned: Owned outright,82,26,22,6,16,3,1,56,54,0,1,0,1
S01012612,Owned: Owned with a mortgage or loan or shared ownership,117,95,82,6,76,13,0,22,20,0,1,0,1
S01012612,Rented or living rent free: Total,95,54,41,14,27,2,11,41,18,1,9,11,2
S01012612,Rented or living rent free: Social rented,76,42,30,12,18,1,11,34,15,0,7,10,2
S01012612,Rented or living rent free: Private rented or living rent free,19,12,11,2,9,1,0,7,3,1,2,1,0
S01012613,All HRPs aged 16 and over,287,198,168,29,139,15,15,89,68,1,3,14,3
S01012613,Owned: Total,192,138,123,13,110,14,1,54,53,0,0,1,0
S01012613,Owned: Owned outright,83,33,30,5,25,3,0,50,49,0,0,1,0
S01012613,Owned: Owned with a mortgage or loan or shared ownership,109,105,93,8,85,11,1,4,4,0,0,0,0
S01012613,Rented or living rent free: Total,95,60,45,16,29,1,14,35,15,1,3,13,3
S01012613,Rented or living rent free: Social rented,83,51,38,14,24,1,12,32,15,1,2,12,2
S01012613,Rented or living rent free: Private rented or living rent free,12,9,7,2,5,0,2,3,0,0,1,1,1
S01012614,All HRPs aged 16 and over,455,296,260,45,215,21,15,159,128,2,4,21,4
S01012614,Owned: Total,333,233,210,27,183,20,3,100,95,0,0,5,0
S01012614,Owned: Owned outright,147,57,50,14,36,7,0,90,86,0,0,4,0
S01012614,Owned: Owned with a mortgage or loan or shared ownership,186,176,160,13,147,13,3,10,9,0,0,1,0
S01012614,Rented or living rent free: Total,122,63,50,18,32,1,12,59,33,2,4,16,4
S01012614,Rented or living rent free: Social rented,92,44,34,14,20,0,10,48,27,2,4,12,3
S01012614,Rented or living rent free: Private rented or living rent free,30,19,16,4,12,1,2,11,6,0,0,4,1
S01012615,All HRPs aged 16 and over,306,199,145,24,121,46,8,107,92,1,1,10,3
S01012615,Owned: Total,231,165,122,16,106,41,2,66,62,0,1,1,2
S01012615,Owned: Owned outright,111,58,36,9,27,21,1,53,52,0,0,0,1
S01012615,Owned: Owned with a mortgage or loan or shared ownership,120,107,86,7,79,20,1,13,10,0,1,1,1
S01012615,Rented or living rent free: Total,75,34,23,8,15,5,6,41,30,1,0,9,1
S01012615,Rented or living rent free: Social rented,56,20,12,4,8,3,5,36,25,1,0,9,1
S01012615,Rented or living rent free: Private rented or living rent free,19,14,11,4,7,2,1,5,5,0,0,0,0
S01012616,All HRPs aged 16 and over,384,248,175,17,158,65,8,136,107,0,8,15,6
S01012616,Owned: Total,290,203,142,12,130,59,2,87,78,0,1,5,3
S01012616,Owned: Owned outright,145,72,39,6,33,31,2,73,69,0,1,2,1
S01012616,Owned: Owned with a mortgage or loan or shared ownership,145,131,103,6,97,28,0,14,9,0,0,3,2
S01012616,Rented or living rent free: Total,94,45,33,5,28,6,6,49,29,0,7,10,3
S01012616,Rented or living rent free: Social rented,74,29,21,4,17,2,6,45,26,0,6,10,3
S01012616,Rented or living rent free: Private rented or living rent free,20,16,12,1,11,4,0,4,3,0,1,0,0
S01012617,All HRPs aged 16 and over,151,118,85,9,76,32,1,33,29,0,1,2,1
S01012617,Owned: Total,133,108,79,8,71,28,1,25,23,0,1,1,0
S01012617,Owned: Owned outright,58,38,20,2,18,17,1,20,20,0,0,0,0
S01012617,Owned: Owned with a mortgage or loan or shared ownership,75,70,59,6,53,11,0,5,3,0,1,1,0
S01012617,Rented or living rent free: Total,18,10,6,1,5,4,0,8,6,0,0,1,1
S01012617,Rented or living rent free: Social rented,4,2,1,0,1,1,0,2,1,0,0,1,0
S01012617,Rented or living rent free: Private rented or living rent free,14,8,5,1,4,3,0,6,5,0,0,0,1
S01012618,All HRPs aged 16 and over,209,158,127,13,114,27,4,51,37,1,5,6,2
S01012618,Owned: Total,150,121,97,7,90,23,1,29,25,0,0,3,1
S01012618,Owned: Owned outright,62,40,28,5,23,12,0,22,20,0,0,1,1
S01012618,Owned: Owned with a mortgage or loan or shared ownership,88,81,69,2,67,11,1,7,5,0,0,2,0
S01012618,Rented or living rent free: Total,59,37,30,6,24,4,3,22,12,1,5,3,1
S01012618,Rented or living rent free: Social rented,40,22,19,5,14,0,3,18,10,1,3,3,1
S01012618,Rented or living rent free: Private rented or living rent free,19,15,11,1,10,4,0,4,2,0,2,0,0
S01012619,All HRPs aged 16 and over,295,153,119,20,99,18,16,142,101,3,3,26,9
S01012619,Owned: Total,139,88,68,7,61,16,4,51,49,1,0,1,0
S01012619,Owned: Owned outright,71,25,18,4,14,7,0,46,45,1,0,0,0
S01012619,Owned: Owned with a mortgage or loan or shared ownership,68,63,50,3,47,9,4,5,4,0,0,1,0
S01012619,Rented or living rent free: Total,156,65,51,13,38,2,12,91,52,2,3,25,9
S01012619,Rented or living rent free: Social rented,119,36,28,7,21,1,7,83,48,1,2,24,8
S01012619,Rented or living rent free: Private rented or living rent free,37,29,23,6,17,1,5,8,4,1,1,1,1
S01012620,All HRPs aged 16 and over,325,204,155,22,133,46,3,121,112,0,0,5,4
S01012620,Owned: Total,295,189,140,21,119,46,3,106,102,0,0,1,3
S01012620,Owned: Owned outright,160,66,42,14,28,21,3,94,93,0,0,1,0
S01012620,Owned: Owned with a mortgage or loan or shared ownership,135,123,98,7,91,25,0,12,9,0,0,0,3
S01012620,Rented or living rent free: Total,30,15,15,1,14,0,0,15,10,0,0,4,1
S01012620,Rented or living rent free: Social rented,12,4,4,1,3,0,0,8,6,0,0,2,0
S01012620,Rented or living rent free: Private rented or living rent free,18,11,11,0,11,0,0,7,4,0,0,2,1
S01012621,All HRPs aged 16 and over,277,151,120,17,103,21,10,126,109,0,2,9,6
S01012621,Owned: Total,222,124,103,14,89,19,2,98,95,0,0,1,2
S01012621,Owned: Owned outright,129,39,33,7,26,6,0,90,88,0,0,0,2
S01012621,Owned: Owned with a mortgage or loan or shared ownership,93,85,70,7,63,13,2,8,7,0,0,1,0
S01012621,Rented or living rent free: Total,55,27,17,3,14,2,8,28,14,0,2,8,4
S01012621,Rented or living rent free: Social rented,35,16,9,2,7,1,6,19,6,0,2,7,4
S01012621,Rented or living rent free: Private rented or living rent free,20,11,8,1,7,1,2,9,8,0,0,1,0
S01012622,All HRPs aged 16 and over,341,220,180,30,150,26,14,121,99,1,2,14,5
S01012622,Owned: Total,239,162,133,16,117,25,4,77,73,0,1,3,0
S01012622,Owned: Owned outright,115,48,37,12,25,10,1,67,64,0,0,3,0
S01012622,Owned: Owned with a mortgage or loan or shared ownership,124,114,96,4,92,15,3,10,9,0,1,0,0
S01012622,Rented or living rent free: Total,102,58,47,14,33,1,10,44,26,1,1,11,5
S01012622,Rented or living rent free: Social rented,81,43,34,13,21,0,9,38,21,1,1,10,5
S01012622,Rented or living rent free: Private rented or living rent free,21,15,13,1,12,1,1,6,5,0,0,1,0
S01012623,All HRPs aged 16 and over,320,184,154,35,119,22,8,136,95,0,10,25,6
S01012623,Owned: Total,178,108,89,17,72,19,0,70,60,0,2,5,3
S01012623,Owned: Owned outright,88,32,27,8,19,5,0,56,50,0,2,2,2
S01012623,Owned: Owned with a mortgage or loan or shared ownership,90,76,62,9,53,14,0,14,10,0,0,3,1
S01012623,Rented or living rent free: Total,142,76,65,18,47,3,8,66,35,0,8,20,3
S01012623,Rented or living rent free: Social rented,114,56,45,15,30,3,8,58,29,0,7,19,3
S01012623,Rented or living rent free: Private rented or living rent free,28,20,20,3,17,0,0,8,6,0,1,1,0
S01012624,All HRPs aged 16 and over,334,204,172,31,141,20,12,130,102,4,6,17,1
S01012624,Owned: Total,205,135,114,14,100,17,4,70,64,0,0,6,0
S01012624,Owned: Owned outright,86,29,23,4,19,6,0,57,54,0,0,3,0
S01012624,Owned: Owned with a mortgage or loan or shared ownership,119,106,91,10,81,11,4,13,10,0,0,3,0
S01012624,Rented or living rent free: Total,129,69,58,17,41,3,8,60,38,4,6,11,1
S01012624,Rented or living rent free: Social rented,81,35,30,9,21,1,4,46,26,4,5,10,1
S01012624,Rented or living rent free: Private rented or living rent free,48,34,28,8,20,2,4,14,12,0,1,1,0
S01012625,All HRPs aged 16 and over,263,160,134,22,112,17,9,103,75,0,3,20,5
S01012625,Owned: Total,151,107,91,11,80,15,1,44,39,0,0,3,2
S01012625,Owned: Owned outright,63,29,27,8,19,1,1,34,30,0,0,3,1
S01012625,Owned: Owned with a mortgage or loan or shared ownership,88,78,64,3,61,14,0,10,9,0,0,0,1
S01012625,Rented or living rent free: Total,112,53,43,11,32,2,8,59,36,0,3,17,3
S01012625,Rented or living rent free: Social rented,100,47,38,11,27,2,7,53,34,0,0,16,3
S01012625,Rented or living rent free: Private rented or living rent free,12,6,5,0,5,0,1,6,2,0,3,1,0
S01012626,All HRPs aged 16 and over,216,143,121,18,103,18,4,73,69,0,0,3,1
S01012626,Owned: Total,189,123,106,15,91,15,2,66,63,0,0,2,1
S01012626,Owned: Owned outright,100,39,32,7,25,6,1,61,60,0,0,0,1
S01012626,Owned: Owned with a mortgage or loan or shared ownership,89,84,74,8,66,9,1,5,3,0,0,2,0
S01012626,Rented or living rent free: Total,27,20,15,3,12,3,2,7,6,0,0,1,0
S01012626,Rented or living rent free: Social rented,12,9,8,2,6,0,1,3,2,0,0,1,0
S01012626,Rented or living rent free: Private rented or living rent free,15,11,7,1,6,3,1,4,4,0,0,0,0
S01012627,All HRPs aged 16 and over,241,166,125,30,95,22,19,75,48,0,9,14,4
S01012627,Owned: Total,117,85,67,11,56,15,3,32,29,0,1,1,1
S01012627,Owned: Owned outright,63,36,27,10,17,7,2,27,26,0,0,1,0
S01012627,Owned: Owned with a mortgage or loan or shared ownership,54,49,40,1,39,8,1,5,3,0,1,0,1
S01012627,Rented or living rent free: Total,124,81,58,19,39,7,16,43,19,0,8,13,3
S01012627,Rented or living rent free: Social rented,106,71,52,18,34,3,16,35,17,0,5,10,3
S01012627,Rented or living rent free: Private rented or living rent free,18,10,6,1,5,4,0,8,2,0,3,3,0
S01012628,All HRPs aged 16 and over,334,266,224,15,209,39,3,68,65,0,1,2,0
S01012628,Owned: Total,299,237,197,13,184,38,2,62,61,0,1,0,0
S01012628,Owned: Owned outright,108,55,44,5,39,11,0,53,52,0,1,0,0
S01012628,Owned: Owned with a mortgage or loan or shared ownership,191,182,153,8,145,27,2,9,9,0,0,0,0
S01012628,Rented or living rent free: Total,35,29,27,2,25,1,1,6,4,0,0,2,0
S01012628,Rented or living rent free: Social rented,7,6,5,2,3,0,1,1,0,0,0,1,0
S01012628,Rented or living rent free: Private rented or living rent free,28,23,22,0,22,1,0,5,4,0,0,1,0
S01012629,All HRPs aged 16 and over,197,136,106,7,99,29,1,61,50,1,5,3,2
S01012629,Owned: Total,166,123,98,5,93,24,1,43,40,1,0,1,1
S01012629,Owned: Owned outright,79,37,28,3,25,8,1,42,39,1,0,1,1
S01012629,Owned: Owned with a mortgage or loan or shared ownership,87,86,70,2,68,16,0,1,1,0,0,0,0
S01012629,Rented or living rent free: Total,31,13,8,2,6,5,0,18,10,0,5,2,1
S01012629,Rented or living rent free: Social rented,4,2,1,1,0,1,0,2,0,0,1,0,1
S01012629,Rented or living rent free: Private rented or living rent free,27,11,7,1,6,4,0,16,10,0,4,2,0
S01012630,All HRPs aged 16 and over,508,256,194,28,166,44,18,252,204,2,4,29,13
S01012630,Owned: Total,273,152,111,10,101,34,7,121,111,0,0,4,6
S01012630,Owned: Owned outright,155,53,36,6,30,15,2,102,96,0,0,4,2
S01012630,Owned: Owned with a mortgage or loan or shared ownership,118,99,75,4,71,19,5,19,15,0,0,0,4
S01012630,Rented or living rent free: Total,235,104,83,18,65,10,11,131,93,2,4,25,7
S01012630,Rented or living rent free: Social rented,136,26,20,5,15,1,5,110,77,2,4,20,7
S01012630,Rented or living rent free: Private rented or living rent free,99,78,63,13,50,9,6,21,16,0,0,5,0
S01012631,All HRPs aged 16 and over,423,283,236,40,196,17,30,140,71,1,16,39,13
S01012631,Owned: Total,193,147,132,9,123,12,3,46,42,0,1,2,1
S01012631,Owned: Owned outright,72,28,26,5,21,0,2,44,40,0,1,2,1
S01012631,Owned: Owned with a mortgage or loan or shared ownership,121,119,106,4,102,12,1,2,2,0,0,0,0
S01012631,Rented or living rent free: Total,230,136,104,31,73,5,27,94,29,1,15,37,12
S01012631,Rented or living rent free: Social rented,205,123,95,29,66,1,27,82,26,1,13,34,8
S01012631,Rented or living rent free: Private rented or living rent free,25,13,9,2,7,4,0,12,3,0,2,3,4
S01012632,All HRPs aged 16 and over,304,217,147,13,134,66,4,87,71,0,8,6,2
S01012632,Owned: Total,252,190,128,10,118,59,3,62,58,0,2,2,0
S01012632,Owned: Owned outright,130,72,37,6,31,34,1,58,55,0,2,1,0
S01012632,Owned: Owned with a mortgage or loan or shared ownership,122,118,91,4,87,25,2,4,3,0,0,1,0
S01012632,Rented or living rent free: Total,52,27,19,3,16,7,1,25,13,0,6,4,2
S01012632,Rented or living rent free: Social rented,9,3,3,2,1,0,0,6,3,0,2,1,0
S01012632,Rented or living rent free: Private rented or living rent free,43,24,16,1,15,7,1,19,10,0,4,3,2
S01012633,All HRPs aged 16 and over,283,197,122,15,107,66,9,86,77,0,3,4,2
S01012633,Owned: Total,217,162,101,13,88,58,3,55,55,0,0,0,0
S01012633,Owned: Owned outright,124,75,43,11,32,30,2,49,49,0,0,0,0
S01012633,Owned: Owned with a mortgage or loan or shared ownership,93,87,58,2,56,28,1,6,6,0,0,0,0
S01012633,Rented or living rent free: Total,66,35,21,2,19,8,6,31,22,0,3,4,2
S01012633,Rented or living rent free: Social rented,42,19,11,2,9,2,6,23,15,0,3,3,2
S01012633,Rented or living rent free: Private rented or living rent free,24,16,10,0,10,6,0,8,7,0,0,1,0
S01012634,All HRPs aged 16 and over,339,202,161,39,122,27,14,137,100,3,6,23,5
S01012634,Owned: Total,216,147,122,23,99,23,2,69,63,0,0,5,1
S01012634,Owned: Owned outright,116,61,43,13,30,16,2,55,54,0,0,0,1
S01012634,Owned: Owned with a mortgage or loan or shared ownership,100,86,79,10,69,7,0,14,9,0,0,5,0
S01012634,Rented or living rent free: Total,123,55,39,16,23,4,12,68,37,3,6,18,4
S01012634,Rented or living rent free: Social rented,100,46,36,16,20,1,9,54,30,3,4,13,4
S01012634,Rented or living rent free: Private rented or living rent free,23,9,3,0,3,3,3,14,7,0,2,5,0
S01012635,All HRPs aged 16 and over,430,300,237,27,210,52,11,130,105,0,10,11,4
S01012635,Owned: Total,330,244,197,18,179,45,2,86,81,0,1,2,2
S01012635,Owned: Owned outright,151,80,57,11,46,22,1,71,68,0,1,1,1
S01012635,Owned: Owned with a mortgage or loan or shared ownership,179,164,140,7,133,23,1,15,13,0,0,1,1
S01012635,Rented or living rent free: Total,100,56,40,9,31,7,9,44,24,0,9,9,2
S01012635,Rented or living rent free: Social rented,71,34,28,9,19,1,5,37,18,0,9,9,1
S01012635,Rented or living rent free: Private rented or living rent free,29,22,12,0,12,6,4,7,6,0,0,0,1
S01012636,All HRPs aged 16 and over,250,186,128,18,110,56,2,64,52,1,1,8,2
S01012636,Owned: Total,199,160,106,10,96,52,2,39,39,0,0,0,0
S01012636,Owned: Owned outright,80,50,27,5,22,22,1,30,30,0,0,0,0
S01012636,Owned: Owned with a mortgage or loan or shared ownership,119,110,79,5,74,30,1,9,9,0,0,0,0
S01012636,Rented or living rent free: Total,51,26,22,8,14,4,0,25,13,1,1,8,2
S01012636,Rented or living rent free: Social rented,27,10,7,2,5,3,0,17,8,0,0,8,1
S01012636,Rented or living rent free: Private rented or living rent free,24,16,15,6,9,1,0,8,5,1,1,0,1
S01012637,All HRPs aged 16 and over,365,218,178,29,149,18,22,147,93,2,11,31,10
S01012637,Owned: Total,148,101,91,8,83,8,2,47,38,1,0,5,3
S01012637,Owned: Owned outright,65,25,22,5,17,3,0,40,35,0,0,2,3
S01012637,Owned: Owned with a mortgage or loan or shared ownership,83,76,69,3,66,5,2,7,3,1,0,3,0
S01012637,Rented or living rent free: Total,217,117,87,21,66,10,20,100,55,1,11,26,7
S01012637,Rented or living rent free: Social rented,193,103,76,18,58,7,20,90,50,1,9,23,7
S01012637,Rented or living rent free: Private rented or living rent free,24,14,11,3,8,3,0,10,5,0,2,3,0
S01012638,All HRPs aged 16 and over,406,227,182,21,161,29,16,179,138,1,6,27,7
S01012638,Owned: Total,231,160,132,10,122,25,3,71,65,0,2,4,0
S01012638,Owned: Owned outright,112,49,37,3,34,10,2,63,60,0,1,2,0
S01012638,Owned: Owned with a mortgage or loan or shared ownership,119,111,95,7,88,15,1,8,5,0,1,2,0
S01012638,Rented or living rent free: Total,175,67,50,11,39,4,13,108,73,1,4,23,7
S01012638,Rented or living rent free: Social rented,118,38,28,8,20,2,8,80,58,1,1,15,5
S01012638,Rented or living rent free: Private rented or living rent free,57,29,22,3,19,2,5,28,15,0,3,8,2
S01012639,All HRPs aged 16 and over,360,218,178,23,155,30,10,142,107,0,10,20,5
S01012639,Owned: Total,215,152,127,11,116,25,0,63,56,0,1,4,2
S01012639,Owned: Owned outright,84,38,33,7,26,5,0,46,43,0,0,2,1
S01012639,Owned: Owned with a mortgage or loan or shared ownership,131,114,94,4,90,20,0,17,13,0,1,2,1
S01012639,Rented or living rent free: Total,145,66,51,12,39,5,10,79,51,0,9,16,3
S01012639,Rented or living rent free: Social rented,128,55,42,10,32,3,10,73,49,0,9,13,2
S01012639,Rented or living rent free: Private rented or living rent free,17,11,9,2,7,2,0,6,2,0,0,3,1
S01012640,All HRPs aged 16 and over,439,254,162,44,118,42,50,185,126,3,15,35,6
S01012640,Owned: Total,162,104,79,12,67,23,2,58,54,0,1,2,1
S01012640,Owned: Owned outright,79,32,26,6,20,6,0,47,46,0,0,1,0
S01012640,Owned: Owned with a mortgage or loan or shared ownership,83,72,53,6,47,17,2,11,8,0,1,1,1
S01012640,Rented or living rent free: Total,277,150,83,32,51,19,48,127,72,3,14,33,5
S01012640,Rented or living rent free: Social rented,252,132,74,28,46,14,44,120,67,2,14,32,5
S01012640,Rented or living rent free: Private rented or living rent free,25,18,9,4,5,5,4,7,5,1,0,1,0
S01012641,All HRPs aged 16 and over,484,255,201,34,167,33,21,229,195,1,8,16,9
S01012641,Owned: Total,273,138,111,7,104,26,1,135,129,0,1,3,2
S01012641,Owned: Owned outright,153,38,30,2,28,7,1,115,114,0,0,0,1
S01012641,Owned: Owned with a mortgage or loan or shared ownership,120,100,81,5,76,19,0,20,15,0,1,3,1
S01012641,Rented or living rent free: Total,211,117,90,27,63,7,20,94,66,1,7,13,7
S01012641,Rented or living rent free: Social rented,129,63,49,18,31,4,10,66,41,1,5,13,6
S01012641,Rented or living rent free: Private rented or living rent free,82,54,41,9,32,3,10,28,25,0,2,0,1
S01012642,All HRPs aged 16 and over,380,209,158,38,120,14,37,171,110,1,11,43,6
S01012642,Owned: Total,142,83,72,8,64,8,3,59,56,0,0,3,0
S01012642,Owned: Owned outright,66,27,25,6,19,1,1,39,37,0,0,2,0
S01012642,Owned: Owned with a mortgage or loan or shared ownership,76,56,47,2,45,7,2,20,19,0,0,1,0
S01012642,Rented or living rent free: Total,238,126,86,30,56,6,34,112,54,1,11,40,6
S01012642,Rented or living rent free: Social rented,216,108,74,28,46,4,30,108,53,1,11,37,6
S01012642,Rented or living rent free: Private rented or living rent free,22,18,12,2,10,2,4,4,1,0,0,3,0
S01012643,All HRPs aged 16 and over,199,123,107,14,93,7,9,76,61,1,7,6,1
S01012643,Owned: Total,122,83,77,8,69,4,2,39,37,0,2,0,0
S01012643,Owned: Owned outright,52,20,18,6,12,0,2,32,31,0,1,0,0
S01012643,Owned: Owned with a mortgage or loan or shared ownership,70,63,59,2,57,4,0,7,6,0,1,0,0
S01012643,Rented or living rent free: Total,77,40,30,6,24,3,7,37,24,1,5,6,1
S01012643,Rented or living rent free: Social rented,59,27,20,4,16,2,5,32,21,1,4,5,1
S01012643,Rented or living rent free: Private rented or living rent free,18,13,10,2,8,1,2,5,3,0,1,1,0
S01012644,All HRPs aged 16 and over,301,182,152,32,120,17,13,119,87,1,9,18,4
S01012644,Owned: Total,174,118,102,14,88,14,2,56,54,0,1,1,0
S01012644,Owned: Owned outright,75,26,20,5,15,4,2,49,47,0,1,1,0
S01012644,Owned: Owned with a mortgage or loan or shared ownership,99,92,82,9,73,10,0,7,7,0,0,0,0
S01012644,Rented or living rent free: Total,127,64,50,18,32,3,11,63,33,1,8,17,4
S01012644,Rented or living rent free: Social rented,105,52,43,17,26,3,6,53,31,1,5,14,2
S01012644,Rented or living rent free: Private rented or living rent free,22,12,7,1,6,0,5,10,2,0,3,3,2
S01012645,All HRPs aged 16 and over,368,232,177,22,155,37,18,136,111,1,5,18,1
S01012645,Owned: Total,226,169,133,9,124,28,8,57,55,0,1,1,0
S01012645,Owned: Owned outright,107,54,39,7,32,12,3,53,53,0,0,0,0
S01012645,Owned: Owned with a mortgage or loan or shared ownership,119,115,94,2,92,16,5,4,2,0,1,1,0
S01012645,Rented or living rent free: Total,142,63,44,13,31,9,10,79,56,1,4,17,1
S01012645,Rented or living rent free: Social rented,95,28,17,3,14,3,8,67,48,1,3,14,1
S01012645,Rented or living rent free: Private rented or living rent free,47,35,27,10,17,6,2,12,8,0,1,3,0
S01012646,All HRPs aged 16 and over,405,288,229,21,208,50,9,117,99,2,2,7,7
S01012646,Owned: Total,324,239,192,11,181,43,4,85,82,0,0,2,1
S01012646,Owned: Owned outright,120,51,43,6,37,7,1,69,68,0,0,0,1
S01012646,Owned: Owned with a mortgage or loan or shared ownership,204,188,149,5,144,36,3,16,14,0,0,2,0
S01012646,Rented or living rent free: Total,81,49,37,10,27,7,5,32,17,2,2,5,6
S01012646,Rented or living rent free: Social rented,45,23,19,9,10,1,3,22,11,0,1,5,5
S01012646,Rented or living rent free: Private rented or living rent free,36,26,18,1,17,6,2,10,6,2,1,0,1
S01012647,All HRPs aged 16 and over,269,248,219,15,204,23,6,21,10,0,5,4,2
S01012647,Owned: Total,236,221,197,7,190,22,2,15,9,0,3,2,1
S01012647,Owned: Owned outright,27,18,14,3,11,3,1,9,9,0,0,0,0
S01012647,Owned: Owned with a mortgage or loan or shared ownership,209,203,183,4,179,19,1,6,0,0,3,2,1
S01012647,Rented or living rent free: Total,33,27,22,8,14,1,4,6,1,0,2,2,1
S01012647,Rented or living rent free: Social rented,3,3,3,2,1,0,0,0,0,0,0,0,0
S01012647,Rented or living rent free: Private rented or living rent free,30,24,19,6,13,1,4,6,1,0,2,2,1
S01012648,All HRPs aged 16 and over,229,139,118,27,91,10,11,90,65,0,9,11,5
S01012648,Owned: Total,120,86,78,12,66,8,0,34,32,0,0,2,0
S01012648,Owned: Owned outright,47,20,17,4,13,3,0,27,26,0,0,1,0
S01012648,Owned: Owned with a mortgage or loan or shared ownership,73,66,61,8,53,5,0,7,6,0,0,1,0
S01012648,Rented or living rent free: Total,109,53,40,15,25,2,11,56,33,0,9,9,5
S01012648,Rented or living rent free: Social rented,94,45,32,11,21,2,11,49,31,0,6,8,4
S01012648,Rented or living rent free: Private rented or living rent free,15,8,8,4,4,0,0,7,2,0,3,1,1
S01012649,All HRPs aged 16 and over,267,181,148,26,122,22,11,86,60,0,5,14,7
S01012649,Owned: Total,182,121,102,10,92,19,0,61,53,0,2,4,2
S01012649,Owned: Owned outright,94,41,36,7,29,5,0,53,49,0,0,2,2
S01012649,Owned: Owned with a mortgage or loan or shared ownership,88,80,66,3,63,14,0,8,4,0,2,2,0
S01012649,Rented or living rent free: Total,85,60,46,16,30,3,11,25,7,0,3,10,5
S01012649,Rented or living rent free: Social rented,75,54,40,14,26,3,11,21,6,0,1,9,5
S01012649,Rented or living rent free: Private rented or living rent free,10,6,6,2,4,0,0,4,1,0,2,1,0
S01012650,All HRPs aged 16 and over,266,177,140,19,121,33,4,89,73,0,1,9,6
S01012650,Owned: Total,208,151,117,12,105,33,1,57,48,0,0,8,1
S01012650,Owned: Owned outright,87,39,25,6,19,14,0,48,42,0,0,6,0
S01012650,Owned: Owned with a mortgage or loan or shared ownership,121,112,92,6,86,19,1,9,6,0,0,2,1
S01012650,Rented or living rent free: Total,58,26,23,7,16,0,3,32,25,0,1,1,5
S01012650,Rented or living rent free: Social rented,32,9,9,2,7,0,0,23,19,0,1,1,2
S01012650,Rented or living rent free: Private rented or living rent free,26,17,14,5,9,0,3,9,6,0,0,0,3
S01012651,All HRPs aged 16 and over,327,184,153,40,113,12,19,143,95,1,9,31,7
S01012651,Owned: Total,138,98,87,17,70,9,2,40,36,0,0,4,0
S01012651,Owned: Owned outright,52,26,23,8,15,1,2,26,25,0,0,1,0
S01012651,Owned: Owned with a mortgage or loan or shared ownership,86,72,64,9,55,8,0,14,11,0,0,3,0
S01012651,Rented or living rent free: Total,189,86,66,23,43,3,17,103,59,1,9,27,7
S01012651,Rented or living rent free: Social rented,174,76,59,20,39,2,15,98,58,1,6,26,7
S01012651,Rented or living rent free: Private rented or living rent free,15,10,7,3,4,1,2,5,1,0,3,1,0
S01012652,All HRPs aged 16 and over,431,311,271,25,246,30,10,120,114,0,2,2,2
S01012652,Owned: Total,394,287,254,22,232,28,5,107,104,0,0,1,2
S01012652,Owned: Owned outright,174,78,68,12,56,7,3,96,94,0,0,0,2
S01012652,Owned: Owned with a mortgage or loan or shared ownership,220,209,186,10,176,21,2,11,10,0,0,1,0
S01012652,Rented or living rent free: Total,37,24,17,3,14,2,5,13,10,0,2,1,0
S01012652,Rented or living rent free: Social rented,14,4,1,0,1,1,2,10,9,0,1,0,0
S01012652,Rented or living rent free: Private rented or living rent free,23,20,16,3,13,1,3,3,1,0,1,1,0
S01012653,All HRPs aged 16 and over,363,244,178,28,150,42,24,119,64,3,7,38,7
S01012653,Owned: Total,202,158,121,13,108,33,4,44,37,2,0,4,1
S01012653,Owned: Owned outright,80,50,34,7,27,15,1,30,26,0,0,4,0
S01012653,Owned: Owned with a mortgage or loan or shared ownership,122,108,87,6,81,18,3,14,11,2,0,0,1
S01012653,Rented or living rent free: Total,161,86,57,15,42,9,20,75,27,1,7,34,6
S01012653,Rented or living rent free: Social rented,137,69,44,10,34,5,20,68,25,0,6,32,5
S01012653,Rented or living rent free: Private rented or living rent free,24,17,13,5,8,4,0,7,2,1,1,2,1
S01012654,All HRPs aged 16 and over,326,244,188,26,162,46,10,82,66,1,3,8,4
S01012654,Owned: Total,256,202,157,20,137,41,4,54,49,0,1,3,1
S01012654,Owned: Owned outright,99,53,35,6,29,18,0,46,45,0,0,1,0
S01012654,Owned: Owned with a mortgage or loan or shared ownership,157,149,122,14,108,23,4,8,4,0,1,2,1
S01012654,Rented or living rent free: Total,70,42,31,6,25,5,6,28,17,1,2,5,3
S01012654,Rented or living rent free: Social rented,16,4,2,0,2,1,1,12,5,0,2,4,1
S01012654,Rented or living rent free: Private rented or living rent free,54,38,29,6,23,4,5,16,12,1,0,1,2
S01012655,All HRPs aged 16 and over,454,293,229,32,197,42,22,161,120,2,8,24,7
S01012655,Owned: Total,299,218,178,17,161,37,3,81,74,2,0,3,2
S01012655,Owned: Owned outright,121,58,44,4,40,12,2,63,61,0,0,2,0
S01012655,Owned: Owned with a mortgage or loan or shared ownership,178,160,134,13,121,25,1,18,13,2,0,1,2
S01012655,Rented or living rent free: Total,155,75,51,15,36,5,19,80,46,0,8,21,5
S01012655,Rented or living rent free: Social rented,131,63,41,14,27,3,19,68,41,0,5,18,4
S01012655,Rented or living rent free: Private rented or living rent free,24,12,10,1,9,2,0,12,5,0,3,3,1
S01012656,All HRPs aged 16 and over,405,222,185,30,155,22,15,183,134,1,9,26,13
S01012656,Owned: Total,240,153,136,11,125,17,0,87,76,0,1,9,1
S01012656,Owned: Owned outright,89,24,22,4,18,2,0,65,60,0,0,4,1
S01012656,Owned: Owned with a mortgage or loan or shared ownership,151,129,114,7,107,15,0,22,16,0,1,5,0
S01012656,Rented or living rent free: Total,165,69,49,19,30,5,15,96,58,1,8,17,12
S01012656,Rented or living rent free: Social rented,141,55,39,16,23,4,12,86,54,1,5,15,11
S01012656,Rented or living rent free: Private rented or living rent free,24,14,10,3,7,1,3,10,4,0,3,2,1
S01012657,All HRPs aged 16 and over,272,147,128,26,102,10,9,125,92,3,7,16,7
S01012657,Owned: Total,166,96,89,14,75,6,1,70,64,0,1,2,3
S01012657,Owned: Owned outright,70,19,14,4,10,4,1,51,49,0,0,0,2
S01012657,Owned: Owned with a mortgage or loan or shared ownership,96,77,75,10,65,2,0,19,15,0,1,2,1
S01012657,Rented or living rent free: Total,106,51,39,12,27,4,8,55,28,3,6,14,4
S01012657,Rented or living rent free: Social rented,67,30,26,9,17,1,3,37,21,1,2,12,1
S01012657,Rented or living rent free: Private rented or living rent free,39,21,13,3,10,3,5,18,7,2,4,2,3
S01012658,All HRPs aged 16 and over,424,261,220,17,203,36,5,163,144,0,3,12,4
S01012658,Owned: Total,383,241,206,16,190,34,1,142,132,0,1,7,2
S01012658,Owned: Owned outright,205,82,69,7,62,13,0,123,117,0,0,6,0
S01012658,Owned: Owned with a mortgage or loan or shared ownership,178,159,137,9,128,21,1,19,15,0,1,1,2
S01012658,Rented or living rent free: Total,41,20,14,1,13,2,4,21,12,0,2,5,2
S01012658,Rented or living rent free: Social rented,16,4,1,0,1,0,3,12,7,0,0,5,0
S01012658,Rented or living rent free: Private rented or living rent free,25,16,13,1,12,2,1,9,5,0,2,0,2
S01012659,All HRPs aged 16 and over,366,320,275,22,253,41,4,46,34,1,3,6,2
S01012659,Owned: Total,343,306,264,18,246,40,2,37,31,0,3,2,1
S01012659,Owned: Owned outright,76,46,43,8,35,2,1,30,28,0,1,0,1
S01012659,Owned: Owned with a mortgage or loan or shared ownership,267,260,221,10,211,38,1,7,3,0,2,2,0
S01012659,Rented or living rent free: Total,23,14,11,4,7,1,2,9,3,1,0,4,1
S01012659,Rented or living rent free: Social rented,6,4,2,2,0,1,1,2,0,0,0,1,1
S01012659,Rented or living rent free: Private rented or living rent free,17,10,9,2,7,0,1,7,3,1,0,3,0
S01012660,All HRPs aged 16 and over,326,182,153,31,122,20,9,144,114,1,9,16,4
S01012660,Owned: Total,186,134,116,10,106,17,1,52,45,1,0,6,0
S01012660,Owned: Owned outright,66,34,31,5,26,3,0,32,28,1,0,3,0
S01012660,Owned: Owned with a mortgage or loan or shared ownership,120,100,85,5,80,14,1,20,17,0,0,3,0
S01012660,Rented or living rent free: Total,140,48,37,21,16,3,8,92,69,0,9,10,4
S01012660,Rented or living rent free: Social rented,128,39,31,19,12,0,8,89,67,0,9,10,3
S01012660,Rented or living rent free: Private rented or living rent free,12,9,6,2,4,3,0,3,2,0,0,0,1
S01012661,All HRPs aged 16 and over,324,218,169,18,151,42,7,106,86,1,4,14,1
S01012661,Owned: Total,259,183,142,7,135,38,3,76,71,1,0,4,0
S01012661,Owned: Owned outright,108,48,35,4,31,12,1,60,56,0,0,4,0
S01012661,Owned: Owned with a mortgage or loan or shared ownership,151,135,107,3,104,26,2,16,15,1,0,0,0
S01012661,Rented or living rent free: Total,65,35,27,11,16,4,4,30,15,0,4,10,1
S01012661,Rented or living rent free: Social rented,22,7,6,3,3,1,0,15,8,0,1,5,1
S01012661,Rented or living rent free: Private rented or living rent free,43,28,21,8,13,3,4,15,7,0,3,5,0
S01012662,All HRPs aged 16 and over,370,196,163,28,135,22,11,174,134,2,13,25,0
S01012662,Owned: Total,217,132,111,9,102,17,4,85,78,0,4,3,0
S01012662,Owned: Owned outright,107,40,36,4,32,3,1,67,66,0,1,0,0
S01012662,Owned: Owned with a mortgage or loan or shared ownership,110,92,75,5,70,14,3,18,12,0,3,3,0
S01012662,Rented or living rent free: Total,153,64,52,19,33,5,7,89,56,2,9,22,0
S01012662,Rented or living rent free: Social rented,118,40,33,14,19,2,5,78,52,2,7,17,0
S01012662,Rented or living rent free: Private rented or living rent free,35,24,19,5,14,3,2,11,4,0,2,5,0
S01012663,All HRPs aged 16 and over,301,185,149,19,130,32,4,116,105,1,3,5,2
S01012663,Owned: Total,267,160,128,14,114,31,1,107,104,1,0,2,0
S01012663,Owned: Owned outright,150,53,43,9,34,10,0,97,95,0,0,2,0
S01012663,Owned: Owned with a mortgage or loan or shared ownership,117,107,85,5,80,21,1,10,9,1,0,0,0
S01012663,Rented or living rent free: Total,34,25,21,5,16,1,3,9,1,0,3,3,2
S01012663,Rented or living rent free: Social rented,4,2,2,1,1,0,0,2,0,0,2,0,0
S01012663,Rented or living rent free: Private rented or living rent free,30,23,19,4,15,1,3,7,1,0,1,3,2
S01012664,All HRPs aged 16 and over,462,303,233,36,197,49,21,159,127,1,4,18,9
S01012664,Owned: Total,322,226,183,21,162,40,3,96,89,0,0,5,2
S01012664,Owned: Owned outright,142,63,48,11,37,12,3,79,75,0,0,3,1
S01012664,Owned: Owned with a mortgage or loan or shared ownership,180,163,135,10,125,28,0,17,14,0,0,2,1
S01012664,Rented or living rent free: Total,140,77,50,15,35,9,18,63,38,1,4,13,7
S01012664,Rented or living rent free: Social rented,61,21,14,5,9,1,6,40,30,0,1,7,2
S01012664,Rented or living rent free: Private rented or living rent free,79,56,36,10,26,8,12,23,8,1,3,6,5
S01012665,All HRPs aged 16 and over,346,185,145,29,116,19,21,161,96,2,12,45,6
S01012665,Owned: Total,158,94,79,5,74,13,2,64,56,1,1,5,1
S01012665,Owned: Owned outright,63,14,11,0,11,3,0,49,45,0,0,4,0
S01012665,Owned: Owned with a mortgage or loan or shared ownership,95,80,68,5,63,10,2,15,11,1,1,1,1
S01012665,Rented or living rent free: Total,188,91,66,24,42,6,19,97,40,1,11,40,5
S01012665,Rented or living rent free: Social rented,162,74,53,21,32,5,16,88,37,0,10,36,5
S01012665,Rented or living rent free: Private rented or living rent free,26,17,13,3,10,1,3,9,3,1,1,4,0
S01012666,All HRPs aged 16 and over,337,181,144,31,113,14,23,156,115,1,6,29,5
S01012666,Owned: Total,172,103,92,12,80,9,2,69,62,0,0,6,1
S01012666,Owned: Owned outright,73,18,17,2,15,1,0,55,52,0,0,3,0
S01012666,Owned: Owned with a mortgage or loan or shared ownership,99,85,75,10,65,8,2,14,10,0,0,3,1
S01012666,Rented or living rent free: Total,165,78,52,19,33,5,21,87,53,1,6,23,4
S01012666,Rented or living rent free: Social rented,138,61,39,12,27,3,19,77,48,0,6,20,3
S01012666,Rented or living rent free: Private rented or living rent free,27,17,13,7,6,2,2,10,5,1,0,3,1
S01012667,All HRPs aged 16 and over,279,155,105,22,83,21,29,124,72,4,8,29,11
S01012667,Owned: Total,128,78,59,9,50,16,3,50,43,0,0,3,4
S01012667,Owned: Owned outright,70,32,22,4,18,8,2,38,36,0,0,0,2
S01012667,Owned: Owned with a mortgage or loan or shared ownership,58,46,37,5,32,8,1,12,7,0,0,3,2
S01012667,Rented or living rent free: Total,151,77,46,13,33,5,26,74,29,4,8,26,7
S01012667,Rented or living rent free: Social rented,139,72,43,12,31,4,25,67,24,4,8,24,7
S01012667,Rented or living rent free: Private rented or living rent free,12,5,3,1,2,1,1,7,5,0,0,2,0
S01012668,All HRPs aged 16 and over,347,211,162,32,130,30,19,136,85,0,9,33,9
S01012668,Owned: Total,212,150,121,19,102,27,2,62,57,0,1,3,1
S01012668,Owned: Owned outright,93,41,30,11,19,10,1,52,48,0,0,3,1
S01012668,Owned: Owned with a mortgage or loan or shared ownership,119,109,91,8,83,17,1,10,9,0,1,0,0
S01012668,Rented or living rent free: Total,135,61,41,13,28,3,17,74,28,0,8,30,8
S01012668,Rented or living rent free: Social rented,96,38,26,9,17,1,11,58,22,0,6,23,7
S01012668,Rented or living rent free: Private rented or living rent free,39,23,15,4,11,2,6,16,6,0,2,7,1
S01012669,All HRPs aged 16 and over,296,190,177,17,160,11,2,106,103,0,2,0,1
S01012669,Owned: Total,287,185,172,17,155,11,2,102,101,0,1,0,0
S01012669,Owned: Owned outright,142,51,46,6,40,5,0,91,90,0,1,0,0
S01012669,Owned: Owned with a mortgage or loan or shared ownership,145,134,126,11,115,6,2,11,11,0,0,0,0
S01012669,Rented or living rent free: Total,9,5,5,0,5,0,0,4,2,0,1,0,1
S01012669,Rented or living rent free: Social rented,3,2,2,0,2,0,0,1,0,0,1,0,0
S01012669,Rented or living rent free: Private rented or living rent free,6,3,3,0,3,0,0,3,2,0,0,0,1
S01012670,All HRPs aged 16 and over,295,173,143,17,126,26,4,122,114,2,2,3,1
S01012670,Owned: Total,280,165,138,15,123,25,2,115,110,2,1,2,0
S01012670,Owned: Owned outright,155,53,37,11,26,14,2,102,99,2,0,1,0
S01012670,Owned: Owned with a mortgage or loan or shared ownership,125,112,101,4,97,11,0,13,11,0,1,1,0
S01012670,Rented or living rent free: Total,15,8,5,2,3,1,2,7,4,0,1,1,1
S01012670,Rented or living rent free: Social rented,4,3,2,2,0,0,1,1,0,0,0,1,0
S01012670,Rented or living rent free: Private rented or living rent free,11,5,3,0,3,1,1,6,4,0,1,0,1
S01012671,All HRPs aged 16 and over,388,249,211,35,176,26,12,139,101,2,5,26,5
S01012671,Owned: Total,257,182,163,16,147,18,1,75,66,0,1,6,2
S01012671,Owned: Owned outright,103,46,39,3,36,6,1,57,54,0,0,2,1
S01012671,Owned: Owned with a mortgage or loan or shared ownership,154,136,124,13,111,12,0,18,12,0,1,4,1
S01012671,Rented or living rent free: Total,131,67,48,19,29,8,11,64,35,2,4,20,3
S01012671,Rented or living rent free: Social rented,111,52,40,17,23,5,7,59,34,0,3,19,3
S01012671,Rented or living rent free: Private rented or living rent free,20,15,8,2,6,3,4,5,1,2,1,1,0
S01012672,All HRPs aged 16 and over,361,176,137,32,105,16,23,185,104,1,16,51,13
S01012672,Owned: Total,123,76,63,8,55,10,3,47,39,0,2,4,2
S01012672,Owned: Owned outright,42,11,10,2,8,0,1,31,30,0,0,1,0
S01012672,Owned: Owned with a mortgage or loan or shared ownership,81,65,53,6,47,10,2,16,9,0,2,3,2
S01012672,Rented or living rent free: Total,238,100,74,24,50,6,20,138,65,1,14,47,11
S01012672,Rented or living rent free: Social rented,224,92,68,20,48,5,19,132,64,1,12,45,10
S01012672,Rented or living rent free: Private rented or living rent free,14,8,6,4,2,1,1,6,1,0,2,2,1
S01012673,All HRPs aged 16 and over,252,144,122,32,90,9,13,108,56,2,17,28,5
S01012673,Owned: Total,101,73,65,10,55,7,1,28,21,0,1,6,0
S01012673,Owned: Owned outright,36,17,16,1,15,1,0,19,15,0,1,3,0
S01012673,Owned: Owned with a mortgage or loan or shared ownership,65,56,49,9,40,6,1,9,6,0,0,3,0
S01012673,Rented or living rent free: Total,151,71,57,22,35,2,12,80,35,2,16,22,5
S01012673,Rented or living rent free: Social rented,128,59,47,20,27,1,11,69,34,1,12,18,4
S01012673,Rented or living rent free: Private rented or living rent free,23,12,10,2,8,1,1,11,1,1,4,4,1
S01012674,All HRPs aged 16 and over,240,136,102,28,74,7,27,104,53,0,20,24,7
S01012674,Owned: Total,101,71,60,7,53,4,7,30,18,0,5,5,2
S01012674,Owned: Owned outright,29,14,12,2,10,1,1,15,10,0,4,1,0
S01012674,Owned: Owned with a mortgage or loan or shared ownership,72,57,48,5,43,3,6,15,8,0,1,4,2
S01012674,Rented or living rent free: Total,139,65,42,21,21,3,20,74,35,0,15,19,5
S01012674,Rented or living rent free: Social rented,124,60,37,17,20,3,20,64,33,0,9,17,5
S01012674,Rented or living rent free: Private rented or living rent free,15,5,5,4,1,0,0,10,2,0,6,2,0
S01012675,All HRPs aged 16 and over,361,198,159,26,133,19,20,163,89,4,15,39,16
S01012675,Owned: Total,165,108,92,5,87,14,2,57,47,0,2,6,2
S01012675,Owned: Owned outright,50,18,12,3,9,6,0,32,28,0,1,2,1
S01012675,Owned: Owned with a mortgage or loan or shared ownership,115,90,80,2,78,8,2,25,19,0,1,4,1
S01012675,Rented or living rent free: Total,196,90,67,21,46,5,18,106,42,4,13,33,14
S01012675,Rented or living rent free: Social rented,170,71,55,18,37,4,12,99,40,3,11,31,14
S01012675,Rented or living rent free: Private rented or living rent free,26,19,12,3,9,1,6,7,2,1,2,2,0
S01012676,All HRPs aged 16 and over,307,225,184,33,151,27,14,82,62,2,4,13,1
S01012676,Owned: Total,216,163,134,17,117,24,5,53,50,0,1,2,0
S01012676,Owned: Owned outright,78,37,29,6,23,6,2,41,41,0,0,0,0
S01012676,Owned: Owned with a mortgage or loan or shared ownership,138,126,105,11,94,18,3,12,9,0,1,2,0
S01012676,Rented or living rent free: Total,91,62,50,16,34,3,9,29,12,2,3,11,1
S01012676,Rented or living rent free: Social rented,57,34,27,4,23,3,4,23,11,0,1,10,1
S01012676,Rented or living rent free: Private rented or living rent free,34,28,23,12,11,0,5,6,1,2,2,1,0
S01012677,All HRPs aged 16 and over,256,150,125,24,101,15,10,106,69,0,6,24,7
S01012677,Owned: Total,139,89,80,11,69,8,1,50,39,0,0,9,2
S01012677,Owned: Owned outright,59,25,23,4,19,2,0,34,27,0,0,5,2
S01012677,Owned: Owned with a mortgage or loan or shared ownership,80,64,57,7,50,6,1,16,12,0,0,4,0
S01012677,Rented or living rent free: Total,117,61,45,13,32,7,9,56,30,0,6,15,5
S01012677,Rented or living rent free: Social rented,92,46,34,9,25,5,7,46,25,0,5,13,3
S01012677,Rented or living rent free: Private rented or living rent free,25,15,11,4,7,2,2,10,5,0,1,2,2
S01012678,All HRPs aged 16 and over,268,224,197,29,168,23,4,44,40,0,1,3,0
S01012678,Owned: Total,250,214,189,25,164,21,4,36,34,0,1,1,0
S01012678,Owned: Owned outright,88,56,44,9,35,9,3,32,30,0,1,1,0
S01012678,Owned: Owned with a mortgage or loan or shared ownership,162,158,145,16,129,12,1,4,4,0,0,0,0
S01012678,Rented or living rent free: Total,18,10,8,4,4,2,0,8,6,0,0,2,0
S01012678,Rented or living rent free: Social rented,3,0,0,0,0,0,0,3,2,0,0,1,0
S01012678,Rented or living rent free: Private rented or living rent free,15,10,8,4,4,2,0,5,4,0,0,1,0
S01012679,All HRPs aged 16 and over,372,217,174,23,151,29,14,155,122,0,8,19,6
S01012679,Owned: Total,230,160,132,9,123,25,3,70,69,0,0,1,0
S01012679,Owned: Owned outright,88,31,24,3,21,5,2,57,57,0,0,0,0
S01012679,Owned: Owned with a mortgage or loan or shared ownership,142,129,108,6,102,20,1,13,12,0,0,1,0
S01012679,Rented or living rent free: Total,142,57,42,14,28,4,11,85,53,0,8,18,6
S01012679,Rented or living rent free: Social rented,126,45,34,13,21,2,9,81,50,0,8,17,6
S01012679,Rented or living rent free: Private rented or living rent free,16,12,8,1,7,2,2,4,3,0,0,1,0
S01012680,All HRPs aged 16 and over,210,159,136,11,125,21,2,51,43,1,1,6,0
S01012680,Owned: Total,191,149,128,8,120,20,1,42,40,0,0,2,0
S01012680,Owned: Owned outright,63,27,20,3,17,7,0,36,35,0,0,1,0
S01012680,Owned: Owned with a mortgage or loan or shared ownership,128,122,108,5,103,13,1,6,5,0,0,1,0
S01012680,Rented or living rent free: Total,19,10,8,3,5,1,1,9,3,1,1,4,0
S01012680,Rented or living rent free: Social rented,5,3,2,0,2,0,1,2,0,1,0,1,0
S01012680,Rented or living rent free: Private rented or living rent free,14,7,6,3,3,1,0,7,3,0,1,3,0
S01012681,All HRPs aged 16 and over,311,212,148,21,127,46,18,99,84,1,3,9,2
S01012681,Owned: Total,242,170,120,12,108,43,7,72,67,0,1,2,2
S01012681,Owned: Owned outright,123,59,32,5,27,23,4,64,60,0,1,1,2
S01012681,Owned: Owned with a mortgage or loan or shared ownership,119,111,88,7,81,20,3,8,7,0,0,1,0
S01012681,Rented or living rent free: Total,69,42,28,9,19,3,11,27,17,1,2,7,0
S01012681,Rented or living rent free: Social rented,22,15,10,4,6,1,4,7,6,0,0,1,0
S01012681,Rented or living rent free: Private rented or living rent free,47,27,18,5,13,2,7,20,11,1,2,6,0
S01012682,All HRPs aged 16 and over,315,185,150,22,128,32,3,130,118,0,0,8,4
S01012682,Owned: Total,249,160,130,15,115,29,1,89,85,0,0,2,2
S01012682,Owned: Owned outright,125,46,34,7,27,12,0,79,76,0,0,1,2
S01012682,Owned: Owned with a mortgage or loan or shared ownership,124,114,96,8,88,17,1,10,9,0,0,1,0
S01012682,Rented or living rent free: Total,66,25,20,7,13,3,2,41,33,0,0,6,2
S01012682,Rented or living rent free: Social rented,39,5,5,4,1,0,0,34,31,0,0,2,1
S01012682,Rented or living rent free: Private rented or living rent free,27,20,15,3,12,3,2,7,2,0,0,4,1
S01012683,All HRPs aged 16 and over,326,226,178,30,148,23,25,100,64,1,6,26,3
S01012683,Owned: Total,202,151,123,19,104,23,5,51,46,0,0,5,0
S01012683,Owned: Owned outright,82,38,28,4,24,9,1,44,43,0,0,1,0
S01012683,Owned: Owned with a mortgage or loan or shared ownership,120,113,95,15,80,14,4,7,3,0,0,4,0
S01012683,Rented or living rent free: Total,124,75,55,11,44,0,20,49,18,1,6,21,3
S01012683,Rented or living rent free: Social rented,103,61,45,11,34,0,16,42,14,0,5,21,2
S01012683,Rented or living rent free: Private rented or living rent free,21,14,10,0,10,0,4,7,4,1,1,0,1
S01012684,All HRPs aged 16 and over,219,159,126,14,112,28,5,60,44,3,2,6,5
S01012684,Owned: Total,183,140,110,10,100,28,2,43,36,0,2,3,2
S01012684,Owned: Owned outright,60,24,22,4,18,2,0,36,32,0,1,1,2
S01012684,Owned: Owned with a mortgage or loan or shared ownership,123,116,88,6,82,26,2,7,4,0,1,2,0
S01012684,Rented or living rent free: Total,36,19,16,4,12,0,3,17,8,3,0,3,3
S01012684,Rented or living rent free: Social rented,9,4,4,0,4,0,0,5,2,0,0,2,1
S01012684,Rented or living rent free: Private rented or living rent free,27,15,12,4,8,0,3,12,6,3,0,1,2
S01012685,All HRPs aged 16 and over,334,226,179,27,152,27,20,108,74,1,8,25,0
S01012685,Owned: Total,219,165,133,11,122,25,7,54,48,0,0,6,0
S01012685,Owned: Owned outright,67,24,16,3,13,6,2,43,39,0,0,4,0
S01012685,Owned: Owned with a mortgage or loan or shared ownership,152,141,117,8,109,19,5,11,9,0,0,2,0
S01012685,Rented or living rent free: Total,115,61,46,16,30,2,13,54,26,1,8,19,0
S01012685,Rented or living rent free: Social rented,104,53,40,15,25,2,11,51,25,1,6,19,0
S01012685,Rented or living rent free: Private rented or living rent free,11,8,6,1,5,0,2,3,1,0,2,0,0
S01012686,All HRPs aged 16 and over,434,305,235,25,210,60,10,129,111,1,4,9,4
S01012686,Owned: Total,347,237,191,19,172,45,1,110,104,1,0,4,1
S01012686,Owned: Owned outright,162,65,49,10,39,16,0,97,95,0,0,1,1
S01012686,Owned: Owned with a mortgage or loan or shared ownership,185,172,142,9,133,29,1,13,9,1,0,3,0
S01012686,Rented or living rent free: Total,87,68,44,6,38,15,9,19,7,0,4,5,3
S01012686,Rented or living rent free: Social rented,13,9,6,0,6,2,1,4,1,0,0,3,0
S01012686,Rented or living rent free: Private rented or living rent free,74,59,38,6,32,13,8,15,6,0,4,2,3
S01012687,All HRPs aged 16 and over,235,116,87,14,73,29,0,119,115,1,1,1,1
S01012687,Owned: Total,231,112,83,14,69,29,0,119,115,1,1,1,1
S01012687,Owned: Owned outright,153,51,36,13,23,15,0,102,100,0,1,1,0
S01012687,Owned: Owned with a mortgage or loan or shared ownership,78,61,47,1,46,14,0,17,15,1,0,0,1
S01012687,Rented or living rent free: Total,4,4,4,0,4,0,0,0,0,0,0,0,0
S01012687,Rented or living rent free: Social rented,1,1,1,0,1,0,0,0,0,0,0,0,0
S01012687,Rented or living rent free: Private rented or living rent free,3,3,3,0,3,0,0,0,0,0,0,0,0
S01012688,All HRPs aged 16 and over,449,265,212,18,194,34,19,184,154,0,4,22,4
S01012688,Owned: Total,291,168,137,7,130,27,4,123,116,0,2,4,1
S01012688,Owned: Owned outright,155,47,38,2,36,7,2,108,104,0,2,1,1
S01012688,Owned: Owned with a mortgage or loan or shared ownership,136,121,99,5,94,20,2,15,12,0,0,3,0
S01012688,Rented or living rent free: Total,158,97,75,11,64,7,15,61,38,0,2,18,3
S01012688,Rented or living rent free: Social rented,41,10,8,1,7,0,2,31,22,0,1,7,1
S01012688,Rented or living rent free: Private rented or living rent free,117,87,67,10,57,7,13,30,16,0,1,11,2
S01012689,All HRPs aged 16 and over,185,126,98,18,80,28,0,59,54,0,3,2,0
S01012689,Owned: Total,165,114,87,14,73,27,0,51,50,0,1,0,0
S01012689,Owned: Owned outright,84,36,26,6,20,10,0,48,47,0,1,0,0
S01012689,Owned: Owned with a mortgage or loan or shared ownership,81,78,61,8,53,17,0,3,3,0,0,0,0
S01012689,Rented or living rent free: Total,20,12,11,4,7,1,0,8,4,0,2,2,0
S01012689,Rented or living rent free: Social rented,9,4,4,1,3,0,0,5,3,0,1,1,0
S01012689,Rented or living rent free: Private rented or living rent free,11,8,7,3,4,1,0,3,1,0,1,1,0
S01012690,All HRPs aged 16 and over,202,139,120,17,103,17,2,63,57,0,1,5,0
S01012690,Owned: Total,178,124,108,13,95,15,1,54,53,0,0,1,0
S01012690,Owned: Owned outright,74,32,27,4,23,5,0,42,42,0,0,0,0
S01012690,Owned: Owned with a mortgage or loan or shared ownership,104,92,81,9,72,10,1,12,11,0,0,1,0
S01012690,Rented or living rent free: Total,24,15,12,4,8,2,1,9,4,0,1,4,0
S01012690,Rented or living rent free: Social rented,14,6,5,2,3,1,0,8,3,0,1,4,0
S01012690,Rented or living rent free: Private rented or living rent free,10,9,7,2,5,1,1,1,1,0,0,0,0
S01012691,All HRPs aged 16 and over,296,205,163,17,146,36,6,91,85,0,2,1,3
S01012691,Owned: Total,273,190,154,12,142,33,3,83,79,0,1,0,3
S01012691,Owned: Owned outright,123,50,37,6,31,12,1,73,70,0,0,0,3
S01012691,Owned: Owned with a mortgage or loan or shared ownership,150,140,117,6,111,21,2,10,9,0,1,0,0
S01012691,Rented or living rent free: Total,23,15,9,5,4,3,3,8,6,0,1,1,0
S01012691,Rented or living rent free: Social rented,2,1,1,1,0,0,0,1,0,0,0,1,0
S01012691,Rented or living rent free: Private rented or living rent free,21,14,8,4,4,3,3,7,6,0,1,0,0
S01012692,All HRPs aged 16 and over,334,191,155,21,134,30,6,143,121,5,3,10,4
S01012692,Owned: Total,232,156,131,18,113,25,0,76,70,4,0,0,2
S01012692,Owned: Owned outright,104,39,33,6,27,6,0,65,59,4,0,0,2
S01012692,Owned: Owned with a mortgage or loan or shared ownership,128,117,98,12,86,19,0,11,11,0,0,0,0
S01012692,Rented or living rent free: Total,102,35,24,3,21,5,6,67,51,1,3,10,2
S01012692,Rented or living rent free: Social rented,82,22,13,2,11,4,5,60,47,1,2,8,2
S01012692,Rented or living rent free: Private rented or living rent free,20,13,11,1,10,1,1,7,4,0,1,2,0
S01012693,All HRPs aged 16 and over,321,247,201,20,181,42,4,74,68,0,2,3,1
S01012693,Owned: Total,307,237,193,18,175,42,2,70,65,0,2,2,1
S01012693,Owned: Owned outright,132,74,58,9,49,15,1,58,57,0,0,1,0
S01012693,Owned: Owned with a mortgage or loan or shared ownership,175,163,135,9,126,27,1,12,8,0,2,1,1
S01012693,Rented or living rent free: Total,14,10,8,2,6,0,2,4,3,0,0,1,0
S01012693,Rented or living rent free: Social rented,7,4,3,1,2,0,1,3,2,0,0,1,0
S01012693,Rented or living rent free: Private rented or living rent free,7,6,5,1,4,0,1,1,1,0,0,0,0
S01012694,All HRPs aged 16 and over,200,134,118,16,102,15,1,66,55,0,1,8,2
S01012694,Owned: Total,147,110,98,9,89,12,0,37,31,0,1,4,1
S01012694,Owned: Owned outright,49,24,17,3,14,7,0,25,24,0,0,1,0
S01012694,Owned: Owned with a mortgage or loan or shared ownership,98,86,81,6,75,5,0,12,7,0,1,3,1
S01012694,Rented or living rent free: Total,53,24,20,7,13,3,1,29,24,0,0,4,1
S01012694,Rented or living rent free: Social rented,38,14,12,4,8,1,1,24,21,0,0,3,0
S01012694,Rented or living rent free: Private rented or living rent free,15,10,8,3,5,2,0,5,3,0,0,1,1
S01012695,All HRPs aged 16 and over,306,228,144,16,128,76,8,78,62,0,5,8,3
S01012695,Owned: Total,246,190,120,14,106,65,5,56,51,0,1,3,1
S01012695,Owned: Owned outright,113,74,36,9,27,36,2,39,38,0,0,0,1
S01012695,Owned: Owned with a mortgage or loan or shared ownership,133,116,84,5,79,29,3,17,13,0,1,3,0
S01012695,Rented or living rent free: Total,60,38,24,2,22,11,3,22,11,0,4,5,2
S01012695,Rented or living rent free: Social rented,29,14,12,1,11,1,1,15,9,0,1,4,1
S01012695,Rented or living rent free: Private rented or living rent free,31,24,12,1,11,10,2,7,2,0,3,1,1
S01012696,All HRPs aged 16 and over,272,222,125,7,118,94,3,50,47,0,1,0,2
S01012696,Owned: Total,242,194,110,6,104,83,1,48,45,0,1,0,2
S01012696,Owned: Owned outright,130,87,35,5,30,52,0,43,40,0,1,0,2
S01012696,Owned: Owned with a mortgage or loan or shared ownership,112,107,75,1,74,31,1,5,5,0,0,0,0
S01012696,Rented or living rent free: Total,30,28,15,1,14,11,2,2,2,0,0,0,0
S01012696,Rented or living rent free: Social rented,4,4,2,1,1,0,2,0,0,0,0,0,0
S01012696,Rented or living rent free: Private rented or living rent free,26,24,13,0,13,11,0,2,2,0,0,0,0
S01012697,All HRPs aged 16 and over,197,142,99,11,88,41,2,55,48,0,2,3,2
S01012697,Owned: Total,164,122,84,8,76,37,1,42,39,0,0,2,1
S01012697,Owned: Owned outright,82,47,21,4,17,25,1,35,33,0,0,1,1
S01012697,Owned: Owned with a mortgage or loan or shared ownership,82,75,63,4,59,12,0,7,6,0,0,1,0
S01012697,Rented or living rent free: Total,33,20,15,3,12,4,1,13,9,0,2,1,1
S01012697,Rented or living rent free: Social rented,9,5,3,0,3,1,1,4,3,0,0,0,1
S01012697,Rented or living rent free: Private rented or living rent free,24,15,12,3,9,3,0,9,6,0,2,1,0
S01012698,All HRPs aged 16 and over,339,228,168,38,130,54,6,111,99,0,1,7,4
S01012698,Owned: Total,288,198,149,34,115,48,1,90,86,0,1,0,3
S01012698,Owned: Owned outright,134,60,38,18,20,21,1,74,72,0,0,0,2
S01012698,Owned: Owned with a mortgage or loan or shared ownership,154,138,111,16,95,27,0,16,14,0,1,0,1
S01012698,Rented or living rent free: Total,51,30,19,4,15,6,5,21,13,0,0,7,1
S01012698,Rented or living rent free: Social rented,28,16,10,4,6,1,5,12,6,0,0,5,1
S01012698,Rented or living rent free: Private rented or living rent free,23,14,9,0,9,5,0,9,7,0,0,2,0
S01012699,All HRPs aged 16 and over,429,302,208,27,181,90,4,127,103,2,10,10,2
S01012699,Owned: Total,340,256,173,20,153,80,3,84,76,1,4,2,1
S01012699,Owned: Owned outright,148,77,42,7,35,35,0,71,67,1,1,1,1
S01012699,Owned: Owned with a mortgage or loan or shared ownership,192,179,131,13,118,45,3,13,9,0,3,1,0
S01012699,Rented or living rent free: Total,89,46,35,7,28,10,1,43,27,1,6,8,1
S01012699,Rented or living rent free: Social rented,55,19,16,4,12,2,1,36,21,1,5,8,1
S01012699,Rented or living rent free: Private rented or living rent free,34,27,19,3,16,8,0,7,6,0,1,0,0
S01012700,All HRPs aged 16 and over,320,219,164,22,142,50,5,101,90,0,5,6,0
S01012700,Owned: Total,261,185,140,14,126,44,1,76,75,0,0,1,0
S01012700,Owned: Owned outright,134,66,49,8,41,16,1,68,67,0,0,1,0
S01012700,Owned: Owned with a mortgage or loan or shared ownership,127,119,91,6,85,28,0,8,8,0,0,0,0
S01012700,Rented or living rent free: Total,59,34,24,8,16,6,4,25,15,0,5,5,0
S01012700,Rented or living rent free: Social rented,33,20,13,6,7,3,4,13,9,0,1,3,0
S01012700,Rented or living rent free: Private rented or living rent free,26,14,11,2,9,3,0,12,6,0,4,2,0
S01012701,All HRPs aged 16 and over,221,137,110,8,102,27,0,84,80,1,1,2,0
S01012701,Owned: Total,203,123,99,7,92,24,0,80,78,0,1,1,0
S01012701,Owned: Owned outright,124,49,37,5,32,12,0,75,73,0,1,1,0
S01012701,Owned: Owned with a mortgage or loan or shared ownership,79,74,62,2,60,12,0,5,5,0,0,0,0
S01012701,Rented or living rent free: Total,18,14,11,1,10,3,0,4,2,1,0,1,0
S01012701,Rented or living rent free: Social rented,5,3,2,0,2,1,0,2,1,0,0,1,0
S01012701,Rented or living rent free: Private rented or living rent free,13,11,9,1,8,2,0,2,1,1,0,0,0
S01012702,All HRPs aged 16 and over,254,183,148,13,135,29,6,71,62,0,1,5,3
S01012702,Owned: Total,188,135,111,3,108,23,1,53,52,0,0,1,0
S01012702,Owned: Owned outright,68,31,20,1,19,10,1,37,36,0,0,1,0
S01012702,Owned: Owned with a mortgage or loan or shared ownership,120,104,91,2,89,13,0,16,16,0,0,0,0
S01012702,Rented or living rent free: Total,66,48,37,10,27,6,5,18,10,0,1,4,3
S01012702,Rented or living rent free: Social rented,23,11,9,3,6,1,1,12,8,0,0,2,2
S01012702,Rented or living rent free: Private rented or living rent free,43,37,28,7,21,5,4,6,2,0,1,2,1
S01012703,All HRPs aged 16 and over,205,180,151,17,134,25,4,25,21,0,2,2,0
S01012703,Owned: Total,171,157,131,11,120,24,2,14,14,0,0,0,0
S01012703,Owned: Owned outright,28,20,15,2,13,5,0,8,8,0,0,0,0
S01012703,Owned: Owned with a mortgage or loan or shared ownership,143,137,116,9,107,19,2,6,6,0,0,0,0
S01012703,Rented or living rent free: Total,34,23,20,6,14,1,2,11,7,0,2,2,0
S01012703,Rented or living rent free: Social rented,25,15,14,4,10,1,0,10,7,0,1,2,0
S01012703,Rented or living rent free: Private rented or living rent free,9,8,6,2,4,0,2,1,0,0,1,0,0
S01012704,All HRPs aged 16 and over,329,213,169,32,137,19,25,116,70,1,7,32,6
S01012704,Owned: Total,192,142,125,14,111,14,3,50,44,0,1,5,0
S01012704,Owned: Owned outright,53,20,19,4,15,1,0,33,30,0,1,2,0
S01012704,Owned: Owned with a mortgage or loan or shared ownership,139,122,106,10,96,13,3,17,14,0,0,3,0
S01012704,Rented or living rent free: Total,137,71,44,18,26,5,22,66,26,1,6,27,6
S01012704,Rented or living rent free: Social rented,121,60,35,16,19,4,21,61,26,0,6,27,2
S01012704,Rented or living rent free: Private rented or living rent free,16,11,9,2,7,1,1,5,0,1,0,0,4
S01012705,All HRPs aged 16 and over,257,228,193,10,183,34,1,29,24,1,0,4,0
S01012705,Owned: Total,247,222,187,10,177,34,1,25,24,1,0,0,0
S01012705,Owned: Owned outright,59,36,32,4,28,4,0,23,23,0,0,0,0
S01012705,Owned: Owned with a mortgage or loan or shared ownership,188,186,155,6,149,30,1,2,1,1,0,0,0
S01012705,Rented or living rent free: Total,10,6,6,0,6,0,0,4,0,0,0,4,0
S01012705,Rented or living rent free: Social rented,3,0,0,0,0,0,0,3,0,0,0,3,0
S01012705,Rented or living rent free: Private rented or living rent free,7,6,6,0,6,0,0,1,0,0,0,1,0
S01012706,All HRPs aged 16 and over,297,187,152,33,119,19,16,110,73,1,9,20,7
S01012706,Owned: Total,185,131,111,15,96,16,4,54,47,1,1,4,1
S01012706,Owned: Owned outright,51,16,12,2,10,3,1,35,32,0,1,1,1
S01012706,Owned: Owned with a mortgage or loan or shared ownership,134,115,99,13,86,13,3,19,15,1,0,3,0
S01012706,Rented or living rent free: Total,112,56,41,18,23,3,12,56,26,0,8,16,6
S01012706,Rented or living rent free: Social rented,96,47,37,16,21,1,9,49,25,0,5,14,5
S01012706,Rented or living rent free: Private rented or living rent free,16,9,4,2,2,2,3,7,1,0,3,2,1
S01012707,All HRPs aged 16 and over,322,255,216,25,191,35,4,67,62,1,2,1,1
S01012707,Owned: Total,305,244,206,24,182,34,4,61,58,1,1,0,1
S01012707,Owned: Owned outright,134,80,69,15,54,9,2,54,53,1,0,0,0
S01012707,Owned: Owned with a mortgage or loan or shared ownership,171,164,137,9,128,25,2,7,5,0,1,0,1
S01012707,Rented or living rent free: Total,17,11,10,1,9,1,0,6,4,0,1,1,0
S01012707,Rented or living rent free: Social rented,4,0,0,0,0,0,0,4,3,0,1,0,0
S01012707,Rented or living rent free: Private rented or living rent free,13,11,10,1,9,1,0,2,1,0,0,1,0
S01012708,All HRPs aged 16 and over,332,194,156,36,120,18,20,138,86,1,7,36,8
S01012708,Owned: Total,199,134,113,17,96,17,4,65,57,1,1,6,0
S01012708,Owned: Owned outright,67,21,19,5,14,2,0,46,41,1,0,4,0
S01012708,Owned: Owned with a mortgage or loan or shared ownership,132,113,94,12,82,15,4,19,16,0,1,2,0
S01012708,Rented or living rent free: Total,133,60,43,19,24,1,16,73,29,0,6,30,8
S01012708,Rented or living rent free: Social rented,111,49,37,15,22,0,12,62,26,0,5,26,5
S01012708,Rented or living rent free: Private rented or living rent free,22,11,6,4,2,1,4,11,3,0,1,4,3
S01012709,All HRPs aged 16 and over,253,135,116,30,86,10,9,118,93,3,7,12,3
S01012709,Owned: Total,149,98,88,19,69,9,1,51,50,1,0,0,0
S01012709,Owned: Owned outright,72,25,23,10,13,2,0,47,47,0,0,0,0
S01012709,Owned: Owned with a mortgage or loan or shared ownership,77,73,65,9,56,7,1,4,3,1,0,0,0
S01012709,Rented or living rent free: Total,104,37,28,11,17,1,8,67,43,2,7,12,3
S01012709,Rented or living rent free: Social rented,92,29,20,10,10,1,8,63,40,1,7,12,3
S01012709,Rented or living rent free: Private rented or living rent free,12,8,8,1,7,0,0,4,3,1,0,0,0
S01012710,All HRPs aged 16 and over,356,207,173,35,138,25,9,149,101,0,8,32,8
S01012710,Owned: Total,186,131,112,15,97,17,2,55,48,0,1,6,0
S01012710,Owned: Owned outright,69,30,26,11,15,4,0,39,35,0,0,4,0
S01012710,Owned: Owned with a mortgage or loan or shared ownership,117,101,86,4,82,13,2,16,13,0,1,2,0
S01012710,Rented or living rent free: Total,170,76,61,20,41,8,7,94,53,0,7,26,8
S01012710,Rented or living rent free: Social rented,137,47,34,14,20,7,6,90,51,0,5,26,8
S01012710,Rented or living rent free: Private rented or living rent free,33,29,27,6,21,1,1,4,2,0,2,0,0
S01012711,All HRPs aged 16 and over,435,262,205,54,151,17,40,173,113,2,4,47,7
S01012711,Owned: Total,188,131,111,21,90,13,7,57,49,1,0,5,2
S01012711,Owned: Owned outright,76,34,29,5,24,2,3,42,38,0,0,2,2
S01012711,Owned: Owned with a mortgage or loan or shared ownership,112,97,82,16,66,11,4,15,11,1,0,3,0
S01012711,Rented or living rent free: Total,247,131,94,33,61,4,33,116,64,1,4,42,5
S01012711,Rented or living rent free: Social rented,194,91,65,26,39,4,22,103,62,1,4,32,4
S01012711,Rented or living rent free: Private rented or living rent free,53,40,29,7,22,0,11,13,2,0,0,10,1
S01012712,All HRPs aged 16 and over,335,195,159,24,135,32,4,140,133,1,3,2,1
S01012712,Owned: Total,316,184,152,23,129,30,2,132,130,1,0,0,1
S01012712,Owned: Owned outright,179,57,50,10,40,7,0,122,121,1,0,0,0
S01012712,Owned: Owned with a mortgage or loan or shared ownership,137,127,102,13,89,23,2,10,9,0,0,0,1
S01012712,Rented or living rent free: Total,19,11,7,1,6,2,2,8,3,0,3,2,0
S01012712,Rented or living rent free: Social rented,6,1,0,0,0,0,1,5,3,0,1,1,0
S01012712,Rented or living rent free: Private rented or living rent free,13,10,7,1,6,2,1,3,0,0,2,1,0
S01012713,All HRPs aged 16 and over,329,179,152,14,138,23,4,150,139,0,1,8,2
S01012713,Owned: Total,282,154,135,9,126,19,0,128,125,0,1,1,1
S01012713,Owned: Owned outright,168,51,44,5,39,7,0,117,114,0,1,1,1
S01012713,Owned: Owned with a mortgage or loan or shared ownership,114,103,91,4,87,12,0,11,11,0,0,0,0
S01012713,Rented or living rent free: Total,47,25,17,5,12,4,4,22,14,0,0,7,1
S01012713,Rented or living rent free: Social rented,22,8,4,3,1,2,2,14,10,0,0,4,0
S01012713,Rented or living rent free: Private rented or living rent free,25,17,13,2,11,2,2,8,4,0,0,3,1
S01012714,All HRPs aged 16 and over,264,140,118,17,101,22,0,124,118,0,1,2,3
S01012714,Owned: Total,249,128,106,16,90,22,0,121,116,0,1,1,3
S01012714,Owned: Owned outright,155,44,38,13,25,6,0,111,108,0,1,1,1
S01012714,Owned: Owned with a mortgage or loan or shared ownership,94,84,68,3,65,16,0,10,8,0,0,0,2
S01012714,Rented or living rent free: Total,15,12,12,1,11,0,0,3,2,0,0,1,0
S01012714,Rented or living rent free: Social rented,3,2,2,0,2,0,0,1,0,0,0,1,0
S01012714,Rented or living rent free: Private rented or living rent free,12,10,10,1,9,0,0,2,2,0,0,0,0
S01012715,All HRPs aged 16 and over,411,244,201,24,177,20,23,167,124,3,11,18,11
S01012715,Owned: Total,227,144,123,11,112,16,5,83,79,1,0,2,1
S01012715,Owned: Owned outright,99,35,26,7,19,6,3,64,62,1,0,0,1
S01012715,Owned: Owned with a mortgage or loan or shared ownership,128,109,97,4,93,10,2,19,17,0,0,2,0
S01012715,Rented or living rent free: Total,184,100,78,13,65,4,18,84,45,2,11,16,10
S01012715,Rented or living rent free: Social rented,109,44,29,9,20,1,14,65,39,1,7,11,7
S01012715,Rented or living rent free: Private rented or living rent free,75,56,49,4,45,3,4,19,6,1,4,5,3
S01012716,All HRPs aged 16 and over,369,216,165,17,148,47,4,153,144,1,1,5,2
S01012716,Owned: Total,303,174,129,11,118,43,2,129,123,1,1,3,1
S01012716,Owned: Owned outright,187,77,51,6,45,25,1,110,107,1,1,1,0
S01012716,Owned: Owned with a mortgage or loan or shared ownership,116,97,78,5,73,18,1,19,16,0,0,2,1
S01012716,Rented or living rent free: Total,66,42,36,6,30,4,2,24,21,0,0,2,1
S01012716,Rented or living rent free: Social rented,27,6,5,1,4,1,0,21,18,0,0,2,1
S01012716,Rented or living rent free: Private rented or living rent free,39,36,31,5,26,3,2,3,3,0,0,0,0
S01012717,All HRPs aged 16 and over,581,306,254,32,222,30,22,275,222,5,3,37,8
S01012717,Owned: Total,292,171,142,15,127,25,4,121,114,1,1,2,3
S01012717,Owned: Owned outright,164,59,49,8,41,9,1,105,101,0,1,1,2
S01012717,Owned: Owned with a mortgage or loan or shared ownership,128,112,93,7,86,16,3,16,13,1,0,1,1
S01012717,Rented or living rent free: Total,289,135,112,17,95,5,18,154,108,4,2,35,5
S01012717,Rented or living rent free: Social rented,158,34,26,8,18,1,7,124,94,1,1,26,2
S01012717,Rented or living rent free: Private rented or living rent free,131,101,86,9,77,4,11,30,14,3,1,9,3
S01012718,All HRPs aged 16 and over,489,317,260,39,221,46,11,172,143,0,4,22,3
S01012718,Owned: Total,350,225,183,29,154,37,5,125,118,0,2,3,2
S01012718,Owned: Owned outright,170,71,54,11,43,14,3,99,95,0,1,1,2
S01012718,Owned: Owned with a mortgage or loan or shared ownership,180,154,129,18,111,23,2,26,23,0,1,2,0
S01012718,Rented or living rent free: Total,139,92,77,10,67,9,6,47,25,0,2,19,1
S01012718,Rented or living rent free: Social rented,36,11,8,4,4,1,2,25,11,0,1,12,1
S01012718,Rented or living rent free: Private rented or living rent free,103,81,69,6,63,8,4,22,14,0,1,7,0
S01012719,All HRPs aged 16 and over,438,293,241,34,207,35,17,145,104,4,5,26,6
S01012719,Owned: Total,228,158,130,17,113,26,2,70,64,1,0,2,3
S01012719,Owned: Owned outright,91,38,32,4,28,5,1,53,50,1,0,1,1
S01012719,Owned: Owned with a mortgage or loan or shared ownership,137,120,98,13,85,21,1,17,14,0,0,1,2
S01012719,Rented or living rent free: Total,210,135,111,17,94,9,15,75,40,3,5,24,3
S01012719,Rented or living rent free: Social rented,63,19,14,4,10,2,3,44,23,0,2,17,2
S01012719,Rented or living rent free: Private rented or living rent free,147,116,97,13,84,7,12,31,17,3,3,7,1
S01012720,All HRPs aged 16 and over,318,252,208,27,181,25,19,66,36,6,1,18,5
S01012720,Owned: Total,163,140,117,12,105,18,5,23,17,0,0,4,2
S01012720,Owned: Owned outright,49,27,21,4,17,2,4,22,17,0,0,4,1
S01012720,Owned: Owned with a mortgage or loan or shared ownership,114,113,96,8,88,16,1,1,0,0,0,0,1
S01012720,Rented or living rent free: Total,155,112,91,15,76,7,14,43,19,6,1,14,3
S01012720,Rented or living rent free: Social rented,22,2,0,0,0,0,2,20,11,1,0,5,3
S01012720,Rented or living rent free: Private rented or living rent free,133,110,91,15,76,7,12,23,8,5,1,9,0
S01012721,All HRPs aged 16 and over,288,170,150,17,133,16,4,118,104,0,2,7,5
S01012721,Owned: Total,225,138,123,10,113,13,2,87,81,0,1,4,1
S01012721,Owned: Owned outright,99,31,27,7,20,4,0,68,66,0,0,2,0
S01012721,Owned: Owned with a mortgage or loan or shared ownership,126,107,96,3,93,9,2,19,15,0,1,2,1
S01012721,Rented or living rent free: Total,63,32,27,7,20,3,2,31,23,0,1,3,4
S01012721,Rented or living rent free: Social rented,36,17,13,4,9,2,2,19,17,0,1,1,0
S01012721,Rented or living rent free: Private rented or living rent free,27,15,14,3,11,1,0,12,6,0,0,2,4
S01012722,All HRPs aged 16 and over,413,224,174,31,143,15,35,189,117,7,8,47,10
S01012722,Owned: Total,200,125,105,19,86,11,9,75,61,1,0,11,2
S01012722,Owned: Owned outright,73,21,18,6,12,1,2,52,44,1,0,6,1
S01012722,Owned: Owned with a mortgage or loan or shared ownership,127,104,87,13,74,10,7,23,17,0,0,5,1
S01012722,Rented or living rent free: Total,213,99,69,12,57,4,26,114,56,6,8,36,8
S01012722,Rented or living rent free: Social rented,170,70,45,9,36,3,22,100,49,6,5,33,7
S01012722,Rented or living rent free: Private rented or living rent free,43,29,24,3,21,1,4,14,7,0,3,3,1
S01012723,All HRPs aged 16 and over,358,195,151,35,116,25,19,163,100,7,13,34,9
S01012723,Owned: Total,168,111,92,16,76,15,4,57,48,3,0,5,1
S01012723,Owned: Owned outright,71,26,21,6,15,4,1,45,37,3,0,4,1
S01012723,Owned: Owned with a mortgage or loan or shared ownership,97,85,71,10,61,11,3,12,11,0,0,1,0
S01012723,Rented or living rent free: Total,190,84,59,19,40,10,15,106,52,4,13,29,8
S01012723,Rented or living rent free: Social rented,157,63,49,15,34,5,9,94,46,3,12,27,6
S01012723,Rented or living rent free: Private rented or living rent free,33,21,10,4,6,5,6,12,6,1,1,2,2
S01012724,All HRPs aged 16 and over,412,247,200,32,168,33,14,165,126,2,5,26,6
S01012724,Owned: Total,268,172,141,18,123,26,5,96,92,0,0,4,0
S01012724,Owned: Owned outright,126,43,33,8,25,8,2,83,80,0,0,3,0
S01012724,Owned: Owned with a mortgage or loan or shared ownership,142,129,108,10,98,18,3,13,12,0,0,1,0
S01012724,Rented or living rent free: Total,144,75,59,14,45,7,9,69,34,2,5,22,6
S01012724,Rented or living rent free: Social rented,74,29,24,7,17,2,3,45,26,2,1,12,4
S01012724,Rented or living rent free: Private rented or living rent free,70,46,35,7,28,5,6,24,8,0,4,10,2
S01012725,All HRPs aged 16 and over,494,337,276,37,239,35,26,157,113,0,5,29,10
S01012725,Owned: Total,309,210,177,19,158,31,2,99,83,0,1,6,9
S01012725,Owned: Owned outright,124,46,39,8,31,7,0,78,71,0,0,5,2
S01012725,Owned: Owned with a mortgage or loan or shared ownership,185,164,138,11,127,24,2,21,12,0,1,1,7
S01012725,Rented or living rent free: Total,185,127,99,18,81,4,24,58,30,0,4,23,1
S01012725,Rented or living rent free: Social rented,75,40,26,11,15,1,13,35,16,0,1,17,1
S01012725,Rented or living rent free: Private rented or living rent free,110,87,73,7,66,3,11,23,14,0,3,6,0
S01012726,All HRPs aged 16 and over,283,150,117,19,98,21,12,133,115,1,3,9,5
S01012726,Owned: Total,211,108,89,8,81,17,2,103,98,0,0,3,2
S01012726,Owned: Owned outright,100,20,14,3,11,5,1,80,77,0,0,2,1
S01012726,Owned: Owned with a mortgage or loan or shared ownership,111,88,75,5,70,12,1,23,21,0,0,1,1
S01012726,Rented or living rent free: Total,72,42,28,11,17,4,10,30,17,1,3,6,3
S01012726,Rented or living rent free: Social rented,55,32,22,8,14,3,7,23,11,1,3,5,3
S01012726,Rented or living rent free: Private rented or living rent free,17,10,6,3,3,1,3,7,6,0,0,1,0
S01012727,All HRPs aged 16 and over,294,170,131,30,101,15,24,124,68,1,15,30,10
S01012727,Owned: Total,129,90,76,11,65,12,2,39,34,0,0,4,1
S01012727,Owned: Owned outright,44,16,15,5,10,1,0,28,26,0,0,2,0
S01012727,Owned: Owned with a mortgage or loan or shared ownership,85,74,61,6,55,11,2,11,8,0,0,2,1
S01012727,Rented or living rent free: Total,165,80,55,19,36,3,22,85,34,1,15,26,9
S01012727,Rented or living rent free: Social rented,154,76,52,17,35,2,22,78,31,1,14,25,7
S01012727,Rented or living rent free: Private rented or living rent free,11,4,3,2,1,1,0,7,3,0,1,1,2
S01012728,All HRPs aged 16 and over,339,197,148,39,109,15,34,142,60,5,21,42,14
S01012728,Owned: Total,91,60,54,7,47,6,0,31,23,0,1,5,2
S01012728,Owned: Owned outright,28,10,6,3,3,4,0,18,15,0,0,1,2
S01012728,Owned: Owned with a mortgage or loan or shared ownership,63,50,48,4,44,2,0,13,8,0,1,4,0
S01012728,Rented or living rent free: Total,248,137,94,32,62,9,34,111,37,5,20,37,12
S01012728,Rented or living rent free: Social rented,225,122,87,30,57,7,28,103,34,5,16,36,12
S01012728,Rented or living rent free: Private rented or living rent free,23,15,7,2,5,2,6,8,3,0,4,1,0
S01012729,All HRPs aged 16 and over,346,243,207,25,182,27,9,103,78,0,2,16,7
S01012729,Owned: Total,267,192,168,12,156,22,2,75,64,0,1,7,3
S01012729,Owned: Owned outright,86,27,19,4,15,7,1,59,55,0,1,2,1
S01012729,Owned: Owned with a mortgage or loan or shared ownership,181,165,149,8,141,15,1,16,9,0,0,5,2
S01012729,Rented or living rent free: Total,79,51,39,13,26,5,7,28,14,0,1,9,4
S01012729,Rented or living rent free: Social rented,58,34,25,9,16,3,6,24,14,0,0,9,1
S01012729,Rented or living rent free: Private rented or living rent free,21,17,14,4,10,2,1,4,0,0,1,0,3
S01012730,All HRPs aged 16 and over,266,175,150,33,117,10,15,91,55,1,8,20,7
S01012730,Owned: Total,150,110,99,14,85,7,4,40,36,1,0,2,1
S01012730,Owned: Owned outright,44,15,11,4,7,2,2,29,26,1,0,1,1
S01012730,Owned: Owned with a mortgage or loan or shared ownership,106,95,88,10,78,5,2,11,10,0,0,1,0
S01012730,Rented or living rent free: Total,116,65,51,19,32,3,11,51,19,0,8,18,6
S01012730,Rented or living rent free: Social rented,103,54,43,19,24,2,9,49,19,0,6,18,6
S01012730,Rented or living rent free: Private rented or living rent free,13,11,8,0,8,1,2,2,0,0,2,0,0
S01012731,All HRPs aged 16 and over,335,204,177,29,148,16,11,131,92,0,18,14,7
S01012731,Owned: Total,219,138,121,8,113,13,4,81,67,0,4,5,5
S01012731,Owned: Owned outright,82,21,19,4,15,1,1,61,57,0,0,3,1
S01012731,Owned: Owned with a mortgage or loan or shared ownership,137,117,102,4,98,12,3,20,10,0,4,2,4
S01012731,Rented or living rent free: Total,116,66,56,21,35,3,7,50,25,0,14,9,2
S01012731,Rented or living rent free: Social rented,99,57,48,19,29,3,6,42,22,0,9,9,2
S01012731,Rented or living rent free: Private rented or living rent free,17,9,8,2,6,0,1,8,3,0,5,0,0
S01012732,All HRPs aged 16 and over,292,196,166,36,130,15,15,96,73,1,3,17,2
S01012732,Owned: Total,200,140,120,18,102,13,7,60,54,0,0,5,1
S01012732,Owned: Owned outright,67,31,24,7,17,3,4,36,35,0,0,1,0
S01012732,Owned: Owned with a mortgage or loan or shared ownership,133,109,96,11,85,10,3,24,19,0,0,4,1
S01012732,Rented or living rent free: Total,92,56,46,18,28,2,8,36,19,1,3,12,1
S01012732,Rented or living rent free: Social rented,71,43,36,12,24,1,6,28,18,1,0,8,1
S01012732,Rented or living rent free: Private rented or living rent free,21,13,10,6,4,1,2,8,1,0,3,4,0
S01012733,All HRPs aged 16 and over,364,338,283,22,261,51,4,26,14,1,3,5,3
S01012733,Owned: Total,325,307,260,14,246,45,2,18,11,1,2,2,2
S01012733,Owned: Owned outright,41,31,20,4,16,10,1,10,9,0,0,0,1
S01012733,Owned: Owned with a mortgage or loan or shared ownership,284,276,240,10,230,35,1,8,2,1,2,2,1
S01012733,Rented or living rent free: Total,39,31,23,8,15,6,2,8,3,0,1,3,1
S01012733,Rented or living rent free: Social rented,11,4,3,2,1,0,1,7,2,0,1,3,1
S01012733,Rented or living rent free: Private rented or living rent free,28,27,20,6,14,6,1,1,1,0,0,0,0
S01012734,All HRPs aged 16 and over,198,187,156,8,148,29,2,11,8,0,1,1,1
S01012734,Owned: Total,188,180,149,8,141,29,2,8,7,0,0,1,0
S01012734,Owned: Owned outright,20,14,8,1,7,5,1,6,6,0,0,0,0
S01012734,Owned: Owned with a mortgage or loan or shared ownership,168,166,141,7,134,24,1,2,1,0,0,1,0
S01012734,Rented or living rent free: Total,10,7,7,0,7,0,0,3,1,0,1,0,1
S01012734,Rented or living rent free: Social rented,4,2,2,0,2,0,0,2,1,0,0,0,1
S01012734,Rented or living rent free: Private rented or living rent free,6,5,5,0,5,0,0,1,0,0,1,0,0
S01012735,All HRPs aged 16 and over,213,128,111,16,95,8,9,85,63,1,3,17,1
S01012735,Owned: Total,148,95,87,12,75,5,3,53,51,0,0,2,0
S01012735,Owned: Owned outright,63,17,17,5,12,0,0,46,44,0,0,2,0
S01012735,Owned: Owned with a mortgage or loan or shared ownership,85,78,70,7,63,5,3,7,7,0,0,0,0
S01012735,Rented or living rent free: Total,65,33,24,4,20,3,6,32,12,1,3,15,1
S01012735,Rented or living rent free: Social rented,45,23,19,3,16,1,3,22,11,0,0,10,1
S01012735,Rented or living rent free: Private rented or living rent free,20,10,5,1,4,2,3,10,1,1,3,5,0
S01012736,All HRPs aged 16 and over,376,274,245,36,209,22,7,102,74,0,3,18,7
S01012736,Owned: Total,280,219,197,24,173,20,2,61,57,0,0,2,2
S01012736,Owned: Owned outright,80,37,30,5,25,5,2,43,42,0,0,0,1
S01012736,Owned: Owned with a mortgage or loan or shared ownership,200,182,167,19,148,15,0,18,15,0,0,2,1
S01012736,Rented or living rent free: Total,96,55,48,12,36,2,5,41,17,0,3,16,5
S01012736,Rented or living rent free: Social rented,71,35,32,9,23,0,3,36,16,0,0,15,5
S01012736,Rented or living rent free: Private rented or living rent free,25,20,16,3,13,2,2,5,1,0,3,1,0
S01012737,All HRPs aged 16 and over,329,261,223,16,207,33,5,68,54,1,4,6,3
S01012737,Owned: Total,273,225,193,13,180,30,2,48,44,0,0,2,2
S01012737,Owned: Owned outright,62,28,23,3,20,5,0,34,34,0,0,0,0
S01012737,Owned: Owned with a mortgage or loan or shared ownership,211,197,170,10,160,25,2,14,10,0,0,2,2
S01012737,Rented or living rent free: Total,56,36,30,3,27,3,3,20,10,1,4,4,1
S01012737,Rented or living rent free: Social rented,26,12,9,1,8,0,3,14,7,0,2,4,1
S01012737,Rented or living rent free: Private rented or living rent free,30,24,21,2,19,3,0,6,3,1,2,0,0
S01012738,All HRPs aged 16 and over,255,167,143,30,113,15,9,88,62,0,6,17,3
S01012738,Owned: Total,172,127,112,15,97,15,0,45,40,0,1,2,2
S01012738,Owned: Owned outright,66,36,34,7,27,2,0,30,27,0,1,1,1
S01012738,Owned: Owned with a mortgage or loan or shared ownership,106,91,78,8,70,13,0,15,13,0,0,1,1
S01012738,Rented or living rent free: Total,83,40,31,15,16,0,9,43,22,0,5,15,1
S01012738,Rented or living rent free: Social rented,71,33,25,13,12,0,8,38,19,0,5,13,1
S01012738,Rented or living rent free: Private rented or living rent free,12,7,6,2,4,0,1,5,3,0,0,2,0
S01012739,All HRPs aged 16 and over,289,276,222,14,208,48,6,13,5,1,2,4,1
S01012739,Owned: Total,266,257,208,12,196,46,3,9,5,1,0,3,0
S01012739,Owned: Owned outright,31,25,14,3,11,9,2,6,3,1,0,2,0
S01012739,Owned: Owned with a mortgage or loan or shared ownership,235,232,194,9,185,37,1,3,2,0,0,1,0
S01012739,Rented or living rent free: Total,23,19,14,2,12,2,3,4,0,0,2,1,1
S01012739,Rented or living rent free: Social rented,4,3,1,0,1,0,2,1,0,0,0,1,0
S01012739,Rented or living rent free: Private rented or living rent free,19,16,13,2,11,2,1,3,0,0,2,0,1
S01012740,All HRPs aged 16 and over,308,280,226,20,206,49,5,28,15,2,3,8,0
S01012740,Owned: Total,247,236,190,9,181,45,1,11,9,1,1,0,0
S01012740,Owned: Owned outright,36,27,21,4,17,6,0,9,7,1,1,0,0
S01012740,Owned: Owned with a mortgage or loan or shared ownership,211,209,169,5,164,39,1,2,2,0,0,0,0
S01012740,Rented or living rent free: Total,61,44,36,11,25,4,4,17,6,1,2,8,0
S01012740,Rented or living rent free: Social rented,52,36,30,10,20,3,3,16,6,0,2,8,0
S01012740,Rented or living rent free: Private rented or living rent free,9,8,6,1,5,1,1,1,0,1,0,0,0
S01012741,All HRPs aged 16 and over,272,225,196,16,180,26,3,47,39,3,1,3,1
S01012741,Owned: Total,248,207,180,14,166,25,2,41,37,3,0,1,0
S01012741,Owned: Owned outright,78,48,38,7,31,9,1,30,27,3,0,0,0
S01012741,Owned: Owned with a mortgage or loan or shared ownership,170,159,142,7,135,16,1,11,10,0,0,1,0
S01012741,Rented or living rent free: Total,24,18,16,2,14,1,1,6,2,0,1,2,1
S01012741,Rented or living rent free: Social rented,7,3,2,1,1,0,1,4,1,0,0,2,1
S01012741,Rented or living rent free: Private rented or living rent free,17,15,14,1,13,1,0,2,1,0,1,0,0
S01012742,All HRPs aged 16 and over,276,190,160,19,141,30,0,86,81,0,2,1,2
S01012742,Owned: Total,256,178,153,19,134,25,0,78,77,0,0,0,1
S01012742,Owned: Owned outright,124,55,47,12,35,8,0,69,68,0,0,0,1
S01012742,Owned: Owned with a mortgage or loan or shared ownership,132,123,106,7,99,17,0,9,9,0,0,0,0
S01012742,Rented or living rent free: Total,20,12,7,0,7,5,0,8,4,0,2,1,1
S01012742,Rented or living rent free: Social rented,10,4,3,0,3,1,0,6,3,0,2,1,0
S01012742,Rented or living rent free: Private rented or living rent free,10,8,4,0,4,4,0,2,1,0,0,0,1
S01012743,All HRPs aged 16 and over,237,156,136,16,120,19,1,81,78,0,1,2,0
S01012743,Owned: Total,228,150,130,15,115,19,1,78,77,0,0,1,0
S01012743,Owned: Owned outright,128,58,50,13,37,7,1,70,69,0,0,1,0
S01012743,Owned: Owned with a mortgage or loan or shared ownership,100,92,80,2,78,12,0,8,8,0,0,0,0
S01012743,Rented or living rent free: Total,9,6,6,1,5,0,0,3,1,0,1,1,0
S01012743,Rented or living rent free: Social rented,1,0,0,0,0,0,0,1,0,0,0,1,0
S01012743,Rented or living rent free: Private rented or living rent free,8,6,6,1,5,0,0,2,1,0,1,0,0
S01012744,All HRPs aged 16 and over,277,226,196,11,185,27,3,51,48,0,1,1,1
S01012744,Owned: Total,258,211,181,9,172,27,3,47,45,0,0,1,1
S01012744,Owned: Owned outright,74,39,33,8,25,5,1,35,34,0,0,0,1
S01012744,Owned: Owned with a mortgage or loan or shared ownership,184,172,148,1,147,22,2,12,11,0,0,1,0
S01012744,Rented or living rent free: Total,19,15,15,2,13,0,0,4,3,0,1,0,0
S01012744,Rented or living rent free: Social rented,3,1,1,1,0,0,0,2,1,0,1,0,0
S01012744,Rented or living rent free: Private rented or living rent free,16,14,14,1,13,0,0,2,2,0,0,0,0
S01012745,All HRPs aged 16 and over,302,184,158,11,147,26,0,118,109,1,2,1,5
S01012745,Owned: Total,287,177,152,9,143,25,0,110,106,1,1,1,1
S01012745,Owned: Owned outright,147,48,42,6,36,6,0,99,97,0,0,1,1
S01012745,Owned: Owned with a mortgage or loan or shared ownership,140,129,110,3,107,19,0,11,9,1,1,0,0
S01012745,Rented or living rent free: Total,15,7,6,2,4,1,0,8,3,0,1,0,4
S01012745,Rented or living rent free: Social rented,6,2,2,1,1,0,0,4,2,0,1,0,1
S01012745,Rented or living rent free: Private rented or living rent free,9,5,4,1,3,1,0,4,1,0,0,0,3
S01012746,All HRPs aged 16 and over,311,245,204,21,183,35,6,66,54,1,1,7,3
S01012746,Owned: Total,259,207,174,17,157,30,3,52,47,1,0,3,1
S01012746,Owned: Owned outright,74,30,25,2,23,5,0,44,41,1,0,2,0
S01012746,Owned: Owned with a mortgage or loan or shared ownership,185,177,149,15,134,25,3,8,6,0,0,1,1
S01012746,Rented or living rent free: Total,52,38,30,4,26,5,3,14,7,0,1,4,2
S01012746,Rented or living rent free: Social rented,26,15,12,1,11,1,2,11,5,0,1,3,2
S01012746,Rented or living rent free: Private rented or living rent free,26,23,18,3,15,4,1,3,2,0,0,1,0
S01012747,All HRPs aged 16 and over,348,222,184,32,152,20,18,126,98,3,9,12,4
S01012747,Owned: Total,252,168,146,13,133,19,3,84,82,0,0,2,0
S01012747,Owned: Owned outright,110,37,30,6,24,6,1,73,71,0,0,2,0
S01012747,Owned: Owned with a mortgage or loan or shared ownership,142,131,116,7,109,13,2,11,11,0,0,0,0
S01012747,Rented or living rent free: Total,96,54,38,19,19,1,15,42,16,3,9,10,4
S01012747,Rented or living rent free: Social rented,82,45,30,16,14,1,14,37,15,2,9,9,2
S01012747,Rented or living rent free: Private rented or living rent free,14,9,8,3,5,0,1,5,1,1,0,1,2
S01012748,All HRPs aged 16 and over,369,199,145,47,98,23,31,170,89,5,17,46,13
S01012748,Owned: Total,123,85,66,14,52,15,4,38,33,1,0,4,0
S01012748,Owned: Owned outright,45,23,18,6,12,4,1,22,20,0,0,2,0
S01012748,Owned: Owned with a mortgage or loan or shared ownership,78,62,48,8,40,11,3,16,13,1,0,2,0
S01012748,Rented or living rent free: Total,246,114,79,33,46,8,27,132,56,4,17,42,13
S01012748,Rented or living rent free: Social rented,228,102,73,30,43,6,23,126,54,3,17,41,11
S01012748,Rented or living rent free: Private rented or living rent free,18,12,6,3,3,2,4,6,2,1,0,1,2
S01012749,All HRPs aged 16 and over,387,249,190,41,149,22,37,138,55,3,12,50,18
S01012749,Owned: Total,138,103,86,7,79,15,2,35,30,0,0,4,1
S01012749,Owned: Owned outright,41,16,13,0,13,2,1,25,22,0,0,2,1
S01012749,Owned: Owned with a mortgage or loan or shared ownership,97,87,73,7,66,13,1,10,8,0,0,2,0
S01012749,Rented or living rent free: Total,249,146,104,34,70,7,35,103,25,3,12,46,17
S01012749,Rented or living rent free: Social rented,212,123,94,33,61,5,24,89,22,2,11,39,15
S01012749,Rented or living rent free: Private rented or living rent free,37,23,10,1,9,2,11,14,3,1,1,7,2
S01012750,All HRPs aged 16 and over,336,228,181,54,127,12,35,108,62,4,11,26,5
S01012750,Owned: Total,151,107,93,16,77,8,6,44,39,0,1,3,1
S01012750,Owned: Owned outright,46,14,11,3,8,0,3,32,30,0,0,2,0
S01012750,Owned: Owned with a mortgage or loan or shared ownership,105,93,82,13,69,8,3,12,9,0,1,1,1
S01012750,Rented or living rent free: Total,185,121,88,38,50,4,29,64,23,4,10,23,4
S01012750,Rented or living rent free: Social rented,140,88,65,30,35,2,21,52,22,2,7,18,3
S01012750,Rented or living rent free: Private rented or living rent free,45,33,23,8,15,2,8,12,1,2,3,5,1
S01012751,All HRPs aged 16 and over,423,221,172,23,149,23,26,202,153,1,4,33,11
S01012751,Owned: Total,261,142,120,11,109,17,5,119,115,0,0,1,3
S01012751,Owned: Owned outright,129,30,23,4,19,4,3,99,97,0,0,1,1
S01012751,Owned: Owned with a mortgage or loan or shared ownership,132,112,97,7,90,13,2,20,18,0,0,0,2
S01012751,Rented or living rent free: Total,162,79,52,12,40,6,21,83,38,1,4,32,8
S01012751,Rented or living rent free: Social rented,140,63,37,10,27,6,20,77,36,0,3,31,7
S01012751,Rented or living rent free: Private rented or living rent free,22,16,15,2,13,0,1,6,2,1,1,1,1
S01012752,All HRPs aged 16 and over,375,253,209,43,166,26,18,122,77,11,8,19,7
S01012752,Owned: Total,216,163,146,20,126,16,1,53,41,4,1,4,3
S01012752,Owned: Owned outright,66,23,19,5,14,4,0,43,33,4,0,3,3
S01012752,Owned: Owned with a mortgage or loan or shared ownership,150,140,127,15,112,12,1,10,8,0,1,1,0
S01012752,Rented or living rent free: Total,159,90,63,23,40,10,17,69,36,7,7,15,4
S01012752,Rented or living rent free: Social rented,135,75,52,22,30,10,13,60,33,7,4,13,3
S01012752,Rented or living rent free: Private rented or living rent free,24,15,11,1,10,0,4,9,3,0,3,2,1
S01012753,All HRPs aged 16 and over,235,142,117,34,83,10,15,93,54,1,9,26,3
S01012753,Owned: Total,96,66,58,6,52,8,0,30,22,0,0,7,1
S01012753,Owned: Owned outright,31,14,13,3,10,1,0,17,12,0,0,4,1
S01012753,Owned: Owned with a mortgage or loan or shared ownership,65,52,45,3,42,7,0,13,10,0,0,3,0
S01012753,Rented or living rent free: Total,139,76,59,28,31,2,15,63,32,1,9,19,2
S01012753,Rented or living rent free: Social rented,121,63,48,23,25,2,13,58,31,1,5,19,2
S01012753,Rented or living rent free: Private rented or living rent free,18,13,11,5,6,0,2,5,1,0,4,0,0
S01012754,All HRPs aged 16 and over,255,148,118,17,101,14,16,107,79,4,3,17,4
S01012754,Owned: Total,149,100,85,10,75,12,3,49,44,1,1,2,1
S01012754,Owned: Owned outright,65,29,25,4,21,3,1,36,35,0,1,0,0
S01012754,Owned: Owned with a mortgage or loan or shared ownership,84,71,60,6,54,9,2,13,9,1,0,2,1
S01012754,Rented or living rent free: Total,106,48,33,7,26,2,13,58,35,3,2,15,3
S01012754,Rented or living rent free: Social rented,95,42,27,7,20,2,13,53,33,3,2,12,3
S01012754,Rented or living rent free: Private rented or living rent free,11,6,6,0,6,0,0,5,2,0,0,3,0
S01012755,All HRPs aged 16 and over,280,141,109,35,74,6,26,139,89,3,4,34,9
S01012755,Owned: Total,101,64,57,7,50,4,3,37,32,0,0,4,1
S01012755,Owned: Owned outright,40,16,15,4,11,0,1,24,22,0,0,2,0
S01012755,Owned: Owned with a mortgage or loan or shared ownership,61,48,42,3,39,4,2,13,10,0,0,2,1
S01012755,Rented or living rent free: Total,179,77,52,28,24,2,23,102,57,3,4,30,8
S01012755,Rented or living rent free: Social rented,162,66,44,23,21,2,20,96,55,3,4,28,6
S01012755,Rented or living rent free: Private rented or living rent free,17,11,8,5,3,0,3,6,2,0,0,2,2
S01012756,All HRPs aged 16 and over,271,112,97,13,84,14,1,159,126,0,3,28,2
S01012756,Owned: Total,159,93,78,10,68,14,1,66,62,0,0,4,0
S01012756,Owned: Owned outright,85,28,21,4,17,7,0,57,55,0,0,2,0
S01012756,Owned: Owned with a mortgage or loan or shared ownership,74,65,57,6,51,7,1,9,7,0,0,2,0
S01012756,Rented or living rent free: Total,112,19,19,3,16,0,0,93,64,0,3,24,2
S01012756,Rented or living rent free: Social rented,96,15,15,1,14,0,0,81,57,0,2,20,2
S01012756,Rented or living rent free: Private rented or living rent free,16,4,4,2,2,0,0,12,7,0,1,4,0
S01012757,All HRPs aged 16 and over,236,135,111,24,87,13,11,101,77,1,3,18,2
S01012757,Owned: Total,136,84,69,11,58,11,4,52,49,0,0,3,0
S01012757,Owned: Owned outright,55,18,12,5,7,4,2,37,36,0,0,1,0
S01012757,Owned: Owned with a mortgage or loan or shared ownership,81,66,57,6,51,7,2,15,13,0,0,2,0
S01012757,Rented or living rent free: Total,100,51,42,13,29,2,7,49,28,1,3,15,2
S01012757,Rented or living rent free: Social rented,85,40,34,12,22,2,4,45,25,1,2,15,2
S01012757,Rented or living rent free: Private rented or living rent free,15,11,8,1,7,0,3,4,3,0,1,0,0
S01012758,All HRPs aged 16 and over,274,161,125,24,101,22,14,113,78,1,8,23,3
S01012758,Owned: Total,175,110,86,9,77,21,3,65,56,1,1,6,1
S01012758,Owned: Owned outright,64,16,9,1,8,7,0,48,43,1,1,3,0
S01012758,Owned: Owned with a mortgage or loan or shared ownership,111,94,77,8,69,14,3,17,13,0,0,3,1
S01012758,Rented or living rent free: Total,99,51,39,15,24,1,11,48,22,0,7,17,2
S01012758,Rented or living rent free: Social rented,79,38,28,13,15,1,9,41,19,0,6,15,1
S01012758,Rented or living rent free: Private rented or living rent free,20,13,11,2,9,0,2,7,3,0,1,2,1
S01012759,All HRPs aged 16 and over,342,199,166,38,128,20,13,143,88,4,9,35,7
S01012759,Owned: Total,180,120,109,14,95,10,1,60,51,2,0,5,2
S01012759,Owned: Owned outright,68,27,22,5,17,5,0,41,39,0,0,2,0
S01012759,Owned: Owned with a mortgage or loan or shared ownership,112,93,87,9,78,5,1,19,12,2,0,3,2
S01012759,Rented or living rent free: Total,162,79,57,24,33,10,12,83,37,2,9,30,5
S01012759,Rented or living rent free: Social rented,144,69,51,21,30,7,11,75,36,2,5,29,3
S01012759,Rented or living rent free: Private rented or living rent free,18,10,6,3,3,3,1,8,1,0,4,1,2
S01012760,All HRPs aged 16 and over,424,257,203,46,157,19,35,167,91,4,19,39,14
S01012760,Owned: Total,203,137,122,20,102,9,6,66,56,0,1,6,3
S01012760,Owned: Owned outright,67,21,21,5,16,0,0,46,44,0,0,2,0
S01012760,Owned: Owned with a mortgage or loan or shared ownership,136,116,101,15,86,9,6,20,12,0,1,4,3
S01012760,Rented or living rent free: Total,221,120,81,26,55,10,29,101,35,4,18,33,11
S01012760,Rented or living rent free: Social rented,170,87,57,22,35,7,23,83,32,2,11,28,10
S01012760,Rented or living rent free: Private rented or living rent free,51,33,24,4,20,3,6,18,3,2,7,5,1
S01012761,All HRPs aged 16 and over,369,233,183,27,156,25,25,136,100,0,5,25,6
S01012761,Owned: Total,227,163,137,13,124,23,3,64,63,0,0,0,1
S01012761,Owned: Owned outright,78,30,24,4,20,5,1,48,47,0,0,0,1
S01012761,Owned: Owned with a mortgage or loan or shared ownership,149,133,113,9,104,18,2,16,16,0,0,0,0
S01012761,Rented or living rent free: Total,142,70,46,14,32,2,22,72,37,0,5,25,5
S01012761,Rented or living rent free: Social rented,113,50,29,9,20,1,20,63,34,0,1,23,5
S01012761,Rented or living rent free: Private rented or living rent free,29,20,17,5,12,1,2,9,3,0,4,2,0
S01012762,All HRPs aged 16 and over,315,191,159,23,136,23,9,124,107,6,1,6,4
S01012762,Owned: Total,251,156,134,14,120,18,4,95,87,3,0,5,0
S01012762,Owned: Owned outright,120,42,34,8,26,6,2,78,73,3,0,2,0
S01012762,Owned: Owned with a mortgage or loan or shared ownership,131,114,100,6,94,12,2,17,14,0,0,3,0
S01012762,Rented or living rent free: Total,64,35,25,9,16,5,5,29,20,3,1,1,4
S01012762,Rented or living rent free: Social rented,40,20,14,5,9,4,2,20,16,1,0,1,2
S01012762,Rented or living rent free: Private rented or living rent free,24,15,11,4,7,1,3,9,4,2,1,0,2
S01012763,All HRPs aged 16 and over,178,105,96,19,77,7,2,73,53,1,3,13,3
S01012763,Owned: Total,113,74,67,10,57,6,1,39,33,0,0,5,1
S01012763,Owned: Owned outright,40,14,13,1,12,0,1,26,25,0,0,1,0
S01012763,Owned: Owned with a mortgage or loan or shared ownership,73,60,54,9,45,6,0,13,8,0,0,4,1
S01012763,Rented or living rent free: Total,65,31,29,9,20,1,1,34,20,1,3,8,2
S01012763,Rented or living rent free: Social rented,57,26,24,7,17,1,1,31,19,1,3,6,2
S01012763,Rented or living rent free: Private rented or living rent free,8,5,5,2,3,0,0,3,1,0,0,2,0
S01012764,All HRPs aged 16 and over,348,195,166,27,139,18,11,153,104,2,6,31,10
S01012764,Owned: Total,193,128,112,14,98,15,1,65,55,0,1,8,1
S01012764,Owned: Owned outright,78,25,22,6,16,3,0,53,47,0,1,4,1
S01012764,Owned: Owned with a mortgage or loan or shared ownership,115,103,90,8,82,12,1,12,8,0,0,4,0
S01012764,Rented or living rent free: Total,155,67,54,13,41,3,10,88,49,2,5,23,9
S01012764,Rented or living rent free: Social rented,126,52,40,12,28,3,9,74,44,2,3,18,7
S01012764,Rented or living rent free: Private rented or living rent free,29,15,14,1,13,0,1,14,5,0,2,5,2
S01012765,All HRPs aged 16 and over,296,185,154,26,128,20,11,111,82,0,3,22,4
S01012765,Owned: Total,195,133,114,11,103,18,1,62,57,0,0,5,0
S01012765,Owned: Owned outright,77,32,28,5,23,4,0,45,45,0,0,0,0
S01012765,Owned: Owned with a mortgage or loan or shared ownership,118,101,86,6,80,14,1,17,12,0,0,5,0
S01012765,Rented or living rent free: Total,101,52,40,15,25,2,10,49,25,0,3,17,4
S01012765,Rented or living rent free: Social rented,95,48,37,14,23,1,10,47,24,0,3,17,3
S01012765,Rented or living rent free: Private rented or living rent free,6,4,3,1,2,1,0,2,1,0,0,0,1
S01012766,All HRPs aged 16 and over,358,245,206,42,164,22,17,113,62,2,14,30,5
S01012766,Owned: Total,200,159,136,14,122,18,5,41,32,0,4,4,1
S01012766,Owned: Owned outright,42,17,12,2,10,4,1,25,23,0,1,1,0
S01012766,Owned: Owned with a mortgage or loan or shared ownership,158,142,124,12,112,14,4,16,9,0,3,3,1
S01012766,Rented or living rent free: Total,158,86,70,28,42,4,12,72,30,2,10,26,4
S01012766,Rented or living rent free: Social rented,133,70,54,24,30,4,12,63,26,2,7,24,4
S01012766,Rented or living rent free: Private rented or living rent free,25,16,16,4,12,0,0,9,4,0,3,2,0
S01012767,All HRPs aged 16 and over,228,160,136,17,119,22,2,68,62,0,1,5,0
S01012767,Owned: Total,217,153,131,16,115,20,2,64,60,0,0,4,0
S01012767,Owned: Owned outright,103,47,40,10,30,6,1,56,54,0,0,2,0
S01012767,Owned: Owned with a mortgage or loan or shared ownership,114,106,91,6,85,14,1,8,6,0,0,2,0
S01012767,Rented or living rent free: Total,11,7,5,1,4,2,0,4,2,0,1,1,0
S01012767,Rented or living rent free: Social rented,6,3,2,0,2,1,0,3,2,0,1,0,0
S01012767,Rented or living rent free: Private rented or living rent free,5,4,3,1,2,1,0,1,0,0,0,1,0
S01012768,All HRPs aged 16 and over,291,215,194,24,170,20,1,76,71,0,0,4,1
S01012768,Owned: Total,279,205,185,21,164,20,0,74,69,0,0,4,1
S01012768,Owned: Owned outright,133,70,62,12,50,8,0,63,60,0,0,3,0
S01012768,Owned: Owned with a mortgage or loan or shared ownership,146,135,123,9,114,12,0,11,9,0,0,1,1
S01012768,Rented or living rent free: Total,12,10,9,3,6,0,1,2,2,0,0,0,0
S01012768,Rented or living rent free: Social rented,5,4,4,3,1,0,0,1,1,0,0,0,0
S01012768,Rented or living rent free: Private rented or living rent free,7,6,5,0,5,0,1,1,1,0,0,0,0
S01012769,All HRPs aged 16 and over,152,127,100,9,91,25,2,25,20,0,2,3,0
S01012769,Owned: Total,142,122,95,8,87,25,2,20,20,0,0,0,0
S01012769,Owned: Owned outright,45,28,22,4,18,4,2,17,17,0,0,0,0
S01012769,Owned: Owned with a mortgage or loan or shared ownership,97,94,73,4,69,21,0,3,3,0,0,0,0
S01012769,Rented or living rent free: Total,10,5,5,1,4,0,0,5,0,0,2,3,0
S01012769,Rented or living rent free: Social rented,1,0,0,0,0,0,0,1,0,0,0,1,0
S01012769,Rented or living rent free: Private rented or living rent free,9,5,5,1,4,0,0,4,0,0,2,2,0
S01012770,All HRPs aged 16 and over,408,246,201,29,172,30,15,162,128,6,3,18,7
S01012770,Owned: Total,265,173,143,14,129,26,4,92,82,2,0,7,1
S01012770,Owned: Owned outright,93,33,27,7,20,6,0,60,56,2,0,2,0
S01012770,Owned: Owned with a mortgage or loan or shared ownership,172,140,116,7,109,20,4,32,26,0,0,5,1
S01012770,Rented or living rent free: Total,143,73,58,15,43,4,11,70,46,4,3,11,6
S01012770,Rented or living rent free: Social rented,90,36,29,11,18,3,4,54,40,0,2,8,4
S01012770,Rented or living rent free: Private rented or living rent free,53,37,29,4,25,1,7,16,6,4,1,3,2
S01012771,All HRPs aged 16 and over,357,218,178,27,151,24,16,139,100,2,9,21,7
S01012771,Owned: Total,249,165,137,13,124,22,6,84,74,0,3,5,2
S01012771,Owned: Owned outright,96,30,23,4,19,2,5,66,61,0,1,3,1
S01012771,Owned: Owned with a mortgage or loan or shared ownership,153,135,114,9,105,20,1,18,13,0,2,2,1
S01012771,Rented or living rent free: Total,108,53,41,14,27,2,10,55,26,2,6,16,5
S01012771,Rented or living rent free: Social rented,81,35,26,11,15,2,7,46,20,2,6,14,4
S01012771,Rented or living rent free: Private rented or living rent free,27,18,15,3,12,0,3,9,6,0,0,2,1
S01012772,All HRPs aged 16 and over,285,170,135,35,100,16,19,115,74,1,8,28,4
S01012772,Owned: Total,158,104,87,13,74,12,5,54,47,0,0,6,1
S01012772,Owned: Owned outright,54,20,15,4,11,3,2,34,31,0,0,3,0
S01012772,Owned: Owned with a mortgage or loan or shared ownership,104,84,72,9,63,9,3,20,16,0,0,3,1
S01012772,Rented or living rent free: Total,127,66,48,22,26,4,14,61,27,1,8,22,3
S01012772,Rented or living rent free: Social rented,114,57,39,16,23,4,14,57,26,1,7,20,3
S01012772,Rented or living rent free: Private rented or living rent free,13,9,9,6,3,0,0,4,1,0,1,2,0
S01012773,All HRPs aged 16 and over,391,230,190,27,163,26,14,161,113,1,8,26,13
S01012773,Owned: Total,277,184,156,20,136,25,3,93,83,0,1,8,1
S01012773,Owned: Owned outright,105,41,29,8,21,12,0,64,62,0,0,2,0
S01012773,Owned: Owned with a mortgage or loan or shared ownership,172,143,127,12,115,13,3,29,21,0,1,6,1
S01012773,Rented or living rent free: Total,114,46,34,7,27,1,11,68,30,1,7,18,12
S01012773,Rented or living rent free: Social rented,89,33,22,7,15,1,10,56,28,1,5,15,7
S01012773,Rented or living rent free: Private rented or living rent free,25,13,12,0,12,0,1,12,2,0,2,3,5
S01012774,All HRPs aged 16 and over,408,306,249,32,217,27,30,102,70,0,3,19,10
S01012774,Owned: Total,251,192,168,15,153,22,2,59,56,0,0,3,0
S01012774,Owned: Owned outright,88,41,33,5,28,6,2,47,44,0,0,3,0
S01012774,Owned: Owned with a mortgage or loan or shared ownership,163,151,135,10,125,16,0,12,12,0,0,0,0
S01012774,Rented or living rent free: Total,157,114,81,17,64,5,28,43,14,0,3,16,10
S01012774,Rented or living rent free: Social rented,117,81,51,13,38,4,26,36,10,0,2,15,9
S01012774,Rented or living rent free: Private rented or living rent free,40,33,30,4,26,1,2,7,4,0,1,1,1
S01012775,All HRPs aged 16 and over,211,129,98,9,89,19,12,82,64,1,4,12,1
S01012775,Owned: Total,137,89,67,4,63,18,4,48,45,1,0,2,0
S01012775,Owned: Owned outright,61,24,17,1,16,5,2,37,36,0,0,1,0
S01012775,Owned: Owned with a mortgage or loan or shared ownership,76,65,50,3,47,13,2,11,9,1,0,1,0
S01012775,Rented or living rent free: Total,74,40,31,5,26,1,8,34,19,0,4,10,1
S01012775,Rented or living rent free: Social rented,48,21,17,4,13,0,4,27,15,0,2,9,1
S01012775,Rented or living rent free: Private rented or living rent free,26,19,14,1,13,1,4,7,4,0,2,1,0
S01012776,All HRPs aged 16 and over,359,227,188,41,147,17,22,132,93,0,6,27,6
S01012776,Owned: Total,211,153,137,22,115,13,3,58,50,0,0,6,2
S01012776,Owned: Owned outright,62,28,24,7,17,2,2,34,30,0,0,3,1
S01012776,Owned: Owned with a mortgage or loan or shared ownership,149,125,113,15,98,11,1,24,20,0,0,3,1
S01012776,Rented or living rent free: Total,148,74,51,19,32,4,19,74,43,0,6,21,4
S01012776,Rented or living rent free: Social rented,124,64,44,17,27,2,18,60,34,0,3,21,2
S01012776,Rented or living rent free: Private rented or living rent free,24,10,7,2,5,2,1,14,9,0,3,0,2
S01012777,All HRPs aged 16 and over,365,305,266,25,241,33,6,60,25,3,6,23,3
S01012777,Owned: Total,297,269,238,17,221,30,1,28,18,2,1,6,1
S01012777,Owned: Owned outright,40,19,19,4,15,0,0,21,16,0,1,4,0
S01012777,Owned: Owned with a mortgage or loan or shared ownership,257,250,219,13,206,30,1,7,2,2,0,2,1
S01012777,Rented or living rent free: Total,68,36,28,8,20,3,5,32,7,1,5,17,2
S01012777,Rented or living rent free: Social rented,40,15,14,5,9,0,1,25,5,0,5,13,2
S01012777,Rented or living rent free: Private rented or living rent free,28,21,14,3,11,3,4,7,2,1,0,4,0
S01012778,All HRPs aged 16 and over,295,209,172,29,143,16,21,86,37,4,3,28,14
S01012778,Owned: Total,153,137,120,9,111,14,3,16,14,0,0,2,0
S01012778,Owned: Owned outright,22,10,9,1,8,0,1,12,12,0,0,0,0
S01012778,Owned: Owned with a mortgage or loan or shared ownership,131,127,111,8,103,14,2,4,2,0,0,2,0
S01012778,Rented or living rent free: Total,142,72,52,20,32,2,18,70,23,4,3,26,14
S01012778,Rented or living rent free: Social rented,128,65,48,19,29,1,16,63,21,2,2,24,14
S01012778,Rented or living rent free: Private rented or living rent free,14,7,4,1,3,1,2,7,2,2,1,2,0
S01012779,All HRPs aged 16 and over,200,147,123,31,92,13,11,53,26,0,9,14,4
S01012779,Owned: Total,102,89,78,11,67,10,1,13,9,0,1,2,1
S01012779,Owned: Owned outright,12,6,6,3,3,0,0,6,5,0,0,1,0
S01012779,Owned: Owned with a mortgage or loan or shared ownership,90,83,72,8,64,10,1,7,4,0,1,1,1
S01012779,Rented or living rent free: Total,98,58,45,20,25,3,10,40,17,0,8,12,3
S01012779,Rented or living rent free: Social rented,82,51,40,18,22,3,8,31,15,0,6,7,3
S01012779,Rented or living rent free: Private rented or living rent free,16,7,5,2,3,0,2,9,2,0,2,5,0
S01012780,All HRPs aged 16 and over,346,212,170,43,127,13,29,134,83,2,18,20,11
S01012780,Owned: Total,136,106,93,10,83,9,4,30,27,0,0,2,1
S01012780,Owned: Owned outright,43,19,15,3,12,1,3,24,22,0,0,2,0
S01012780,Owned: Owned with a mortgage or loan or shared ownership,93,87,78,7,71,8,1,6,5,0,0,0,1
S01012780,Rented or living rent free: Total,210,106,77,33,44,4,25,104,56,2,18,18,10
S01012780,Rented or living rent free: Social rented,184,87,62,30,32,2,23,97,54,2,16,16,9
S01012780,Rented or living rent free: Private rented or living rent free,26,19,15,3,12,2,2,7,2,0,2,2,1
S01012781,All HRPs aged 16 and over,300,202,171,19,152,22,9,98,71,10,3,10,4
S01012781,Owned: Total,237,164,142,12,130,20,2,73,61,5,0,5,2
S01012781,Owned: Owned outright,90,35,31,8,23,4,0,55,49,1,0,4,1
S01012781,Owned: Owned with a mortgage or loan or shared ownership,147,129,111,4,107,16,2,18,12,4,0,1,1
S01012781,Rented or living rent free: Total,63,38,29,7,22,2,7,25,10,5,3,5,2
S01012781,Rented or living rent free: Social rented,35,19,15,6,9,0,4,16,7,1,2,5,1
S01012781,Rented or living rent free: Private rented or living rent free,28,19,14,1,13,2,3,9,3,4,1,0,1
S01012782,All HRPs aged 16 and over,313,174,144,36,108,10,20,139,83,0,15,35,6
S01012782,Owned: Total,133,89,81,11,70,5,3,44,39,0,0,5,0
S01012782,Owned: Owned outright,63,28,24,5,19,2,2,35,33,0,0,2,0
S01012782,Owned: Owned with a mortgage or loan or shared ownership,70,61,57,6,51,3,1,9,6,0,0,3,0
S01012782,Rented or living rent free: Total,180,85,63,25,38,5,17,95,44,0,15,30,6
S01012782,Rented or living rent free: Social rented,150,63,48,24,24,3,12,87,41,0,12,28,6
S01012782,Rented or living rent free: Private rented or living rent free,30,22,15,1,14,2,5,8,3,0,3,2,0
S01012783,All HRPs aged 16 and over,322,205,161,44,117,15,29,117,66,1,16,25,9
S01012783,Owned: Total,159,117,102,19,83,11,4,42,37,0,1,4,0
S01012783,Owned: Owned outright,47,18,14,6,8,2,2,29,27,0,1,1,0
S01012783,Owned: Owned with a mortgage or loan or shared ownership,112,99,88,13,75,9,2,13,10,0,0,3,0
S01012783,Rented or living rent free: Total,163,88,59,25,34,4,25,75,29,1,15,21,9
S01012783,Rented or living rent free: Social rented,137,69,49,23,26,3,17,68,28,1,11,20,8
S01012783,Rented or living rent free: Private rented or living rent free,26,19,10,2,8,1,8,7,1,0,4,1,1
S01012784,All HRPs aged 16 and over,391,234,200,30,170,12,22,157,94,5,12,26,20
S01012784,Owned: Total,197,136,127,11,116,6,3,61,52,2,1,2,4
S01012784,Owned: Owned outright,69,22,19,3,16,1,2,47,43,0,0,2,2
S01012784,Owned: Owned with a mortgage or loan or shared ownership,128,114,108,8,100,5,1,14,9,2,1,0,2
S01012784,Rented or living rent free: Total,194,98,73,19,54,6,19,96,42,3,11,24,16
S01012784,Rented or living rent free: Social rented,163,71,48,14,34,5,18,92,40,2,11,24,15
S01012784,Rented or living rent free: Private rented or living rent free,31,27,25,5,20,1,1,4,2,1,0,0,1
S01012785,All HRPs aged 16 and over,388,214,158,40,118,13,43,174,107,1,8,48,10
S01012785,Owned: Total,143,81,69,9,60,10,2,62,57,0,0,3,2
S01012785,Owned: Owned outright,57,13,9,4,5,4,0,44,42,0,0,1,1
S01012785,Owned: Owned with a mortgage or loan or shared ownership,86,68,60,5,55,6,2,18,15,0,0,2,1
S01012785,Rented or living rent free: Total,245,133,89,31,58,3,41,112,50,1,8,45,8
S01012785,Rented or living rent free: Social rented,214,105,66,23,43,3,36,109,48,1,7,45,8
S01012785,Rented or living rent free: Private rented or living rent free,31,28,23,8,15,0,5,3,2,0,1,0,0
S01012786,All HRPs aged 16 and over,423,249,174,44,130,13,62,174,84,13,5,59,13
S01012786,Owned: Total,109,75,66,11,55,4,5,34,27,0,0,3,4
S01012786,Owned: Owned outright,31,12,10,1,9,1,1,19,16,0,0,1,2
S01012786,Owned: Owned with a mortgage or loan or shared ownership,78,63,56,10,46,3,4,15,11,0,0,2,2
S01012786,Rented or living rent free: Total,314,174,108,33,75,9,57,140,57,13,5,56,9
S01012786,Rented or living rent free: Social rented,239,120,67,21,46,6,47,119,53,1,4,52,9
S01012786,Rented or living rent free: Private rented or living rent free,75,54,41,12,29,3,10,21,4,12,1,4,0
S01012787,All HRPs aged 16 and over,250,194,169,24,145,13,12,56,30,2,3,21,0
S01012787,Owned: Total,173,154,141,14,127,11,2,19,17,0,0,2,0
S01012787,Owned: Owned outright,26,13,12,2,10,1,0,13,13,0,0,0,0
S01012787,Owned: Owned with a mortgage or loan or shared ownership,147,141,129,12,117,10,2,6,4,0,0,2,0
S01012787,Rented or living rent free: Total,77,40,28,10,18,2,10,37,13,2,3,19,0
S01012787,Rented or living rent free: Social rented,47,17,9,4,5,0,8,30,12,0,1,17,0
S01012787,Rented or living rent free: Private rented or living rent free,30,23,19,6,13,2,2,7,1,2,2,2,0
S01012788,All HRPs aged 16 and over,259,150,122,23,99,14,14,109,53,3,14,27,12
S01012788,Owned: Total,132,96,86,10,76,8,2,36,26,1,3,5,1
S01012788,Owned: Owned outright,35,16,13,3,10,2,1,19,15,0,1,2,1
S01012788,Owned: Owned with a mortgage or loan or shared ownership,97,80,73,7,66,6,1,17,11,1,2,3,0
S01012788,Rented or living rent free: Total,127,54,36,13,23,6,12,73,27,2,11,22,11
S01012788,Rented or living rent free: Social rented,111,46,33,13,20,3,10,65,26,2,8,19,10
S01012788,Rented or living rent free: Private rented or living rent free,16,8,3,0,3,3,2,8,1,0,3,3,1
S01012789,All HRPs aged 16 and over,325,210,168,22,146,28,14,115,91,1,4,18,1
S01012789,Owned: Total,241,168,138,16,122,27,3,73,67,1,1,4,0
S01012789,Owned: Owned outright,92,34,30,5,25,4,0,58,55,0,1,2,0
S01012789,Owned: Owned with a mortgage or loan or shared ownership,149,134,108,11,97,23,3,15,12,1,0,2,0
S01012789,Rented or living rent free: Total,84,42,30,6,24,1,11,42,24,0,3,14,1
S01012789,Rented or living rent free: Social rented,68,30,21,5,16,0,9,38,22,0,3,12,1
S01012789,Rented or living rent free: Private rented or living rent free,16,12,9,1,8,1,2,4,2,0,0,2,0
S01012790,All HRPs aged 16 and over,289,220,187,25,162,28,5,69,64,0,1,4,0
S01012790,Owned: Total,195,171,143,10,133,26,2,24,24,0,0,0,0
S01012790,Owned: Owned outright,44,24,17,3,14,6,1,20,20,0,0,0,0
S01012790,Owned: Owned with a mortgage or loan or shared ownership,151,147,126,7,119,20,1,4,4,0,0,0,0
S01012790,Rented or living rent free: Total,94,49,44,15,29,2,3,45,40,0,1,4,0
S01012790,Rented or living rent free: Social rented,40,1,1,0,1,0,0,39,36,0,0,3,0
S01012790,Rented or living rent free: Private rented or living rent free,54,48,43,15,28,2,3,6,4,0,1,1,0
S01012791,All HRPs aged 16 and over,324,182,154,18,136,26,2,142,131,2,0,6,3
S01012791,Owned: Total,283,159,134,14,120,25,0,124,118,2,0,1,3
S01012791,Owned: Owned outright,170,60,52,13,39,8,0,110,104,2,0,1,3
S01012791,Owned: Owned with a mortgage or loan or shared ownership,113,99,82,1,81,17,0,14,14,0,0,0,0
S01012791,Rented or living rent free: Total,41,23,20,4,16,1,2,18,13,0,0,5,0
S01012791,Rented or living rent free: Social rented,17,7,6,1,5,0,1,10,7,0,0,3,0
S01012791,Rented or living rent free: Private rented or living rent free,24,16,14,3,11,1,1,8,6,0,0,2,0
S01012792,All HRPs aged 16 and over,496,299,253,46,207,27,19,197,164,7,1,23,2
S01012792,Owned: Total,306,212,180,23,157,24,8,94,85,3,1,3,2
S01012792,Owned: Owned outright,118,46,40,16,24,4,2,72,66,2,0,2,2
S01012792,Owned: Owned with a mortgage or loan or shared ownership,188,166,140,7,133,20,6,22,19,1,1,1,0
S01012792,Rented or living rent free: Total,190,87,73,23,50,3,11,103,79,4,0,20,0
S01012792,Rented or living rent free: Social rented,116,30,25,15,10,0,5,86,67,4,0,15,0
S01012792,Rented or living rent free: Private rented or living rent free,74,57,48,8,40,3,6,17,12,0,0,5,0
S01012793,All HRPs aged 16 and over,363,193,159,21,138,17,17,170,98,6,11,50,5
S01012793,Owned: Total,142,90,78,8,70,11,1,52,40,5,1,4,2
S01012793,Owned: Owned outright,59,24,20,6,14,3,1,35,31,4,0,0,0
S01012793,Owned: Owned with a mortgage or loan or shared ownership,83,66,58,2,56,8,0,17,9,1,1,4,2
S01012793,Rented or living rent free: Total,221,103,81,13,68,6,16,118,58,1,10,46,3
S01012793,Rented or living rent free: Social rented,162,53,37,9,28,5,11,109,54,1,7,44,3
S01012793,Rented or living rent free: Private rented or living rent free,59,50,44,4,40,1,5,9,4,0,3,2,0
S01012794,All HRPs aged 16 and over,378,260,216,16,200,31,13,118,95,4,2,12,5
S01012794,Owned: Total,234,156,130,8,122,23,3,78,68,3,2,2,3
S01012794,Owned: Owned outright,105,39,29,5,24,8,2,66,60,1,2,2,1
S01012794,Owned: Owned with a mortgage or loan or shared ownership,129,117,101,3,98,15,1,12,8,2,0,0,2
S01012794,Rented or living rent free: Total,144,104,86,8,78,8,10,40,27,1,0,10,2
S01012794,Rented or living rent free: Social rented,30,8,5,1,4,0,3,22,17,0,0,5,0
S01012794,Rented or living rent free: Private rented or living rent free,114,96,81,7,74,8,7,18,10,1,0,5,2
S01012795,All HRPs aged 16 and over,439,250,202,46,156,25,23,189,130,3,14,33,9
S01012795,Owned: Total,189,130,113,17,96,16,1,59,53,0,1,2,3
S01012795,Owned: Owned outright,58,17,13,1,12,4,0,41,38,0,1,0,2
S01012795,Owned: Owned with a mortgage or loan or shared ownership,131,113,100,16,84,12,1,18,15,0,0,2,1
S01012795,Rented or living rent free: Total,250,120,89,29,60,9,22,130,77,3,13,31,6
S01012795,Rented or living rent free: Social rented,232,106,83,27,56,5,18,126,77,3,9,31,6
S01012795,Rented or living rent free: Private rented or living rent free,18,14,6,2,4,4,4,4,0,0,4,0,0
S01012796,All HRPs aged 16 and over,347,247,198,27,171,27,22,100,60,3,7,28,2
S01012796,Owned: Total,206,169,145,16,129,21,3,37,29,1,0,7,0
S01012796,Owned: Owned outright,42,15,11,4,7,3,1,27,23,1,0,3,0
S01012796,Owned: Owned with a mortgage or loan or shared ownership,164,154,134,12,122,18,2,10,6,0,0,4,0
S01012796,Rented or living rent free: Total,141,78,53,11,42,6,19,63,31,2,7,21,2
S01012796,Rented or living rent free: Social rented,109,56,35,9,26,3,18,53,27,1,5,19,1
S01012796,Rented or living rent free: Private rented or living rent free,32,22,18,2,16,3,1,10,4,1,2,2,1
S01012797,All HRPs aged 16 and over,276,204,174,27,147,13,17,72,39,1,10,16,6
S01012797,Owned: Total,150,125,113,12,101,11,1,25,24,0,0,1,0
S01012797,Owned: Owned outright,40,22,20,3,17,2,0,18,18,0,0,0,0
S01012797,Owned: Owned with a mortgage or loan or shared ownership,110,103,93,9,84,9,1,7,6,0,0,1,0
S01012797,Rented or living rent free: Total,126,79,61,15,46,2,16,47,15,1,10,15,6
S01012797,Rented or living rent free: Social rented,106,62,44,13,31,2,16,44,14,1,9,14,6
S01012797,Rented or living rent free: Private rented or living rent free,20,17,17,2,15,0,0,3,1,0,1,1,0
S01012798,All HRPs aged 16 and over,329,210,154,14,140,50,6,119,104,5,0,4,6
S01012798,Owned: Total,277,177,129,11,118,47,1,100,90,5,0,3,2
S01012798,Owned: Owned outright,138,50,30,1,29,19,1,88,80,5,0,1,2
S01012798,Owned: Owned with a mortgage or loan or shared ownership,139,127,99,10,89,28,0,12,10,0,0,2,0
S01012798,Rented or living rent free: Total,52,33,25,3,22,3,5,19,14,0,0,1,4
S01012798,Rented or living rent free: Social rented,24,10,7,1,6,1,2,14,9,0,0,1,4
S01012798,Rented or living rent free: Private rented or living rent free,28,23,18,2,16,2,3,5,5,0,0,0,0
S01012799,All HRPs aged 16 and over,393,237,167,24,143,64,6,156,140,2,0,9,5
S01012799,Owned: Total,309,192,133,16,117,57,2,117,112,2,0,3,0
S01012799,Owned: Owned outright,166,63,42,11,31,19,2,103,101,1,0,1,0
S01012799,Owned: Owned with a mortgage or loan or shared ownership,143,129,91,5,86,38,0,14,11,1,0,2,0
S01012799,Rented or living rent free: Total,84,45,34,8,26,7,4,39,28,0,0,6,5
S01012799,Rented or living rent free: Social rented,35,3,3,1,2,0,0,32,23,0,0,4,5
S01012799,Rented or living rent free: Private rented or living rent free,49,42,31,7,24,7,4,7,5,0,0,2,0
S01012800,All HRPs aged 16 and over,398,288,206,26,180,73,9,110,101,2,2,5,0
S01012800,Owned: Total,340,243,175,24,151,65,3,97,93,0,1,3,0
S01012800,Owned: Owned outright,154,72,50,16,34,19,3,82,81,0,0,1,0
S01012800,Owned: Owned with a mortgage or loan or shared ownership,186,171,125,8,117,46,0,15,12,0,1,2,0
S01012800,Rented or living rent free: Total,58,45,31,2,29,8,6,13,8,2,1,2,0
S01012800,Rented or living rent free: Social rented,6,2,1,0,1,0,1,4,3,0,1,0,0
S01012800,Rented or living rent free: Private rented or living rent free,52,43,30,2,28,8,5,9,5,2,0,2,0
S01012801,All HRPs aged 16 and over,252,129,95,14,81,30,4,123,111,4,3,2,3
S01012801,Owned: Total,193,89,68,12,56,20,1,104,99,2,1,1,1
S01012801,Owned: Owned outright,135,43,33,7,26,10,0,92,90,0,0,1,1
S01012801,Owned: Owned with a mortgage or loan or shared ownership,58,46,35,5,30,10,1,12,9,2,1,0,0
S01012801,Rented or living rent free: Total,59,40,27,2,25,10,3,19,12,2,2,1,2
S01012801,Rented or living rent free: Social rented,5,2,1,1,0,0,1,3,1,0,1,0,1
S01012801,Rented or living rent free: Private rented or living rent free,54,38,26,1,25,10,2,16,11,2,1,1,1
S01012802,All HRPs aged 16 and over,207,161,115,14,101,45,1,46,39,1,3,3,0
S01012802,Owned: Total,191,149,103,14,89,45,1,42,39,0,3,0,0
S01012802,Owned: Owned outright,95,57,36,7,29,21,0,38,36,0,2,0,0
S01012802,Owned: Owned with a mortgage or loan or shared ownership,96,92,67,7,60,24,1,4,3,0,1,0,0
S01012802,Rented or living rent free: Total,16,12,12,0,12,0,0,4,0,1,0,3,0
S01012802,Rented or living rent free: Social rented,3,2,2,0,2,0,0,1,0,0,0,1,0
S01012802,Rented or living rent free: Private rented or living rent free,13,10,10,0,10,0,0,3,0,1,0,2,0
S01012803,All HRPs aged 16 and over,262,189,162,18,144,25,2,73,72,0,0,1,0
S01012803,Owned: Total,247,179,154,15,139,24,1,68,68,0,0,0,0
S01012803,Owned: Owned outright,116,56,50,11,39,6,0,60,60,0,0,0,0
S01012803,Owned: Owned with a mortgage or loan or shared ownership,131,123,104,4,100,18,1,8,8,0,0,0,0
S01012803,Rented or living rent free: Total,15,10,8,3,5,1,1,5,4,0,0,1,0
S01012803,Rented or living rent free: Social rented,5,3,2,2,0,0,1,2,1,0,0,1,0
S01012803,Rented or living rent free: Private rented or living rent free,10,7,6,1,5,1,0,3,3,0,0,0,0
S01012804,All HRPs aged 16 and over,351,218,167,32,135,30,21,133,99,3,7,18,6
S01012804,Owned: Total,191,134,106,15,91,26,2,57,52,1,1,3,0
S01012804,Owned: Owned outright,71,27,15,4,11,11,1,44,41,1,1,1,0
S01012804,Owned: Owned with a mortgage or loan or shared ownership,120,107,91,11,80,15,1,13,11,0,0,2,0
S01012804,Rented or living rent free: Total,160,84,61,17,44,4,19,76,47,2,6,15,6
S01012804,Rented or living rent free: Social rented,126,63,45,10,35,4,14,63,42,0,2,13,6
S01012804,Rented or living rent free: Private rented or living rent free,34,21,16,7,9,0,5,13,5,2,4,2,0
S01012805,All HRPs aged 16 and over,383,244,208,37,171,23,13,139,111,2,8,12,6
S01012805,Owned: Total,263,168,144,25,119,19,5,95,87,1,0,5,2
S01012805,Owned: Owned outright,101,39,34,12,22,4,1,62,60,0,0,0,2
S01012805,Owned: Owned with a mortgage or loan or shared ownership,162,129,110,13,97,15,4,33,27,1,0,5,0
S01012805,Rented or living rent free: Total,120,76,64,12,52,4,8,44,24,1,8,7,4
S01012805,Rented or living rent free: Social rented,94,57,52,10,42,1,4,37,21,1,5,6,4
S01012805,Rented or living rent free: Private rented or living rent free,26,19,12,2,10,3,4,7,3,0,3,1,0
S01012806,All HRPs aged 16 and over,299,222,183,27,156,28,11,77,59,2,4,11,1
S01012806,Owned: Total,213,165,137,18,119,24,4,48,42,2,2,1,1
S01012806,Owned: Owned outright,73,36,30,7,23,5,1,37,35,1,0,1,0
S01012806,Owned: Owned with a mortgage or loan or shared ownership,140,129,107,11,96,19,3,11,7,1,2,0,1
S01012806,Rented or living rent free: Total,86,57,46,9,37,4,7,29,17,0,2,10,0
S01012806,Rented or living rent free: Social rented,67,39,29,7,22,4,6,28,17,0,2,9,0
S01012806,Rented or living rent free: Private rented or living rent free,19,18,17,2,15,0,1,1,0,0,0,1,0
S01012807,All HRPs aged 16 and over,218,162,117,14,103,43,2,56,50,0,0,1,5
S01012807,Owned: Total,197,146,103,13,90,41,2,51,48,0,0,1,2
S01012807,Owned: Owned outright,96,50,34,7,27,15,1,46,44,0,0,1,1
S01012807,Owned: Owned with a mortgage or loan or shared ownership,101,96,69,6,63,26,1,5,4,0,0,0,1
S01012807,Rented or living rent free: Total,21,16,14,1,13,2,0,5,2,0,0,0,3
S01012807,Rented or living rent free: Social rented,1,1,0,0,0,1,0,0,0,0,0,0,0
S01012807,Rented or living rent free: Private rented or living rent free,20,15,14,1,13,1,0,5,2,0,0,0,3
S01012808,All HRPs aged 16 and over,475,296,226,24,202,56,14,179,157,3,4,11,4
S01012808,Owned: Total,362,247,191,19,172,47,9,115,105,0,1,6,3
S01012808,Owned: Owned outright,170,75,60,10,50,13,2,95,90,0,0,3,2
S01012808,Owned: Owned with a mortgage or loan or shared ownership,192,172,131,9,122,34,7,20,15,0,1,3,1
S01012808,Rented or living rent free: Total,113,49,35,5,30,9,5,64,52,3,3,5,1
S01012808,Rented or living rent free: Social rented,56,13,8,2,6,2,3,43,37,0,0,5,1
S01012808,Rented or living rent free: Private rented or living rent free,57,36,27,3,24,7,2,21,15,3,3,0,0
S01012809,All HRPs aged 16 and over,337,227,185,19,166,26,16,110,74,9,6,12,9
S01012809,Owned: Total,202,140,116,8,108,20,4,62,54,1,0,4,3
S01012809,Owned: Owned outright,86,32,27,4,23,4,1,54,50,0,0,1,3
S01012809,Owned: Owned with a mortgage or loan or shared ownership,116,108,89,4,85,16,3,8,4,1,0,3,0
S01012809,Rented or living rent free: Total,135,87,69,11,58,6,12,48,20,8,6,8,6
S01012809,Rented or living rent free: Social rented,21,12,10,1,9,1,1,9,2,0,0,4,3
S01012809,Rented or living rent free: Private rented or living rent free,114,75,59,10,49,5,11,39,18,8,6,4,3
S01012810,All HRPs aged 16 and over,481,276,222,31,191,33,21,205,128,7,4,53,13
S01012810,Owned: Total,187,133,107,9,98,25,1,54,45,2,0,5,2
S01012810,Owned: Owned outright,79,37,30,2,28,6,1,42,38,1,0,1,2
S01012810,Owned: Owned with a mortgage or loan or shared ownership,108,96,77,7,70,19,0,12,7,1,0,4,0
S01012810,Rented or living rent free: Total,294,143,115,22,93,8,20,151,83,5,4,48,11
S01012810,Rented or living rent free: Social rented,251,110,87,16,71,6,17,141,79,5,3,43,11
S01012810,Rented or living rent free: Private rented or living rent free,43,33,28,6,22,2,3,10,4,0,1,5,0
S01012811,All HRPs aged 16 and over,348,195,160,21,139,26,9,153,132,4,4,9,4
S01012811,Owned: Total,266,155,129,13,116,24,2,111,105,1,1,2,2
S01012811,Owned: Owned outright,134,44,31,9,22,13,0,90,85,1,1,1,2
S01012811,Owned: Owned with a mortgage or loan or shared ownership,132,111,98,4,94,11,2,21,20,0,0,1,0
S01012811,Rented or living rent free: Total,82,40,31,8,23,2,7,42,27,3,3,7,2
S01012811,Rented or living rent free: Social rented,62,24,18,7,11,1,5,38,26,3,1,6,2
S01012811,Rented or living rent free: Private rented or living rent free,20,16,13,1,12,1,2,4,1,0,2,1,0
S01012812,All HRPs aged 16 and over,285,213,184,30,154,25,4,72,59,0,2,9,2
S01012812,Owned: Total,228,178,153,22,131,23,2,50,49,0,0,1,0
S01012812,Owned: Owned outright,76,39,32,8,24,6,1,37,36,0,0,1,0
S01012812,Owned: Owned with a mortgage or loan or shared ownership,152,139,121,14,107,17,1,13,13,0,0,0,0
S01012812,Rented or living rent free: Total,57,35,31,8,23,2,2,22,10,0,2,8,2
S01012812,Rented or living rent free: Social rented,34,19,18,4,14,1,0,15,7,0,1,5,2
S01012812,Rented or living rent free: Private rented or living rent free,23,16,13,4,9,1,2,7,3,0,1,3,0
S01012813,All HRPs aged 16 and over,372,232,189,15,174,41,2,140,135,1,0,2,2
S01012813,Owned: Total,353,222,182,15,167,38,2,131,128,1,0,1,1
S01012813,Owned: Owned outright,188,64,50,12,38,13,1,124,123,1,0,0,0
S01012813,Owned: Owned with a mortgage or loan or shared ownership,165,158,132,3,129,25,1,7,5,0,0,1,1
S01012813,Rented or living rent free: Total,19,10,7,0,7,3,0,9,7,0,0,1,1
S01012813,Rented or living rent free: Social rented,4,1,0,0,0,1,0,3,1,0,0,1,1
S01012813,Rented or living rent free: Private rented or living rent free,15,9,7,0,7,2,0,6,6,0,0,0,0
S01012814,All HRPs aged 16 and over,333,285,245,26,219,31,9,48,40,0,3,1,4
S01012814,Owned: Total,305,263,229,22,207,29,5,42,36,0,2,0,4
S01012814,Owned: Owned outright,65,35,28,7,21,4,3,30,28,0,0,0,2
S01012814,Owned: Owned with a mortgage or loan or shared ownership,240,228,201,15,186,25,2,12,8,0,2,0,2
S01012814,Rented or living rent free: Total,28,22,16,4,12,2,4,6,4,0,1,1,0
S01012814,Rented or living rent free: Social rented,6,5,4,2,2,0,1,1,1,0,0,0,0
S01012814,Rented or living rent free: Private rented or living rent free,22,17,12,2,10,2,3,5,3,0,1,1,0
S01012815,All HRPs aged 16 and over,320,293,247,21,226,38,8,27,14,0,2,7,4
S01012815,Owned: Total,249,235,202,12,190,32,1,14,10,0,0,1,3
S01012815,Owned: Owned outright,33,26,21,2,19,5,0,7,7,0,0,0,0
S01012815,Owned: Owned with a mortgage or loan or shared ownership,216,209,181,10,171,27,1,7,3,0,0,1,3
S01012815,Rented or living rent free: Total,71,58,45,9,36,6,7,13,4,0,2,6,1
S01012815,Rented or living rent free: Social rented,13,7,5,3,2,0,2,6,1,0,1,3,1
S01012815,Rented or living rent free: Private rented or living rent free,58,51,40,6,34,6,5,7,3,0,1,3,0
S01012816,All HRPs aged 16 and over,229,192,155,17,138,31,6,37,22,0,4,10,1
S01012816,Owned: Total,179,159,130,13,117,27,2,20,16,0,2,2,0
S01012816,Owned: Owned outright,30,19,16,2,14,3,0,11,11,0,0,0,0
S01012816,Owned: Owned with a mortgage or loan or shared ownership,149,140,114,11,103,24,2,9,5,0,2,2,0
S01012816,Rented or living rent free: Total,50,33,25,4,21,4,4,17,6,0,2,8,1
S01012816,Rented or living rent free: Social rented,13,4,4,1,3,0,0,9,2,0,2,5,0
S01012816,Rented or living rent free: Private rented or living rent free,37,29,21,3,18,4,4,8,4,0,0,3,1
S01012817,All HRPs aged 16 and over,175,167,142,9,133,23,2,8,5,0,0,2,1
S01012817,Owned: Total,163,157,136,9,127,21,0,6,5,0,0,1,0
S01012817,Owned: Owned outright,18,14,12,3,9,2,0,4,4,0,0,0,0
S01012817,Owned: Owned with a mortgage or loan or shared ownership,145,143,124,6,118,19,0,2,1,0,0,1,0
S01012817,Rented or living rent free: Total,12,10,6,0,6,2,2,2,0,0,0,1,1
S01012817,Rented or living rent free: Social rented,6,4,1,0,1,1,2,2,0,0,0,1,1
S01012817,Rented or living rent free: Private rented or living rent free,6,6,5,0,5,1,0,0,0,0,0,0,0
S01012818,All HRPs aged 16 and over,271,224,191,14,177,29,4,47,36,1,2,5,3
S01012818,Owned: Total,247,208,179,12,167,27,2,39,31,1,1,3,3
S01012818,Owned: Owned outright,57,29,25,4,21,4,0,28,23,0,1,2,2
S01012818,Owned: Owned with a mortgage or loan or shared ownership,190,179,154,8,146,23,2,11,8,1,0,1,1
S01012818,Rented or living rent free: Total,24,16,12,2,10,2,2,8,5,0,1,2,0
S01012818,Rented or living rent free: Social rented,8,4,3,0,3,1,0,4,3,0,1,0,0
S01012818,Rented or living rent free: Private rented or living rent free,16,12,9,2,7,1,2,4,2,0,0,2,0
S01012819,All HRPs aged 16 and over,365,181,154,24,130,10,17,184,108,1,17,46,12
S01012819,Owned: Total,192,123,112,13,99,8,3,69,55,0,2,10,2
S01012819,Owned: Owned outright,73,18,15,3,12,3,0,55,47,0,1,5,2
S01012819,Owned: Owned with a mortgage or loan or shared ownership,119,105,97,10,87,5,3,14,8,0,1,5,0
S01012819,Rented or living rent free: Total,173,58,42,11,31,2,14,115,53,1,15,36,10
S01012819,Rented or living rent free: Social rented,146,49,34,10,24,2,13,97,50,1,9,32,5
S01012819,Rented or living rent free: Private rented or living rent free,27,9,8,1,7,0,1,18,3,0,6,4,5
S01012820,All HRPs aged 16 and over,370,330,280,26,254,45,5,40,21,2,3,9,5
S01012820,Owned: Total,324,294,250,20,230,42,2,30,21,1,1,4,3
S01012820,Owned: Owned outright,58,38,31,5,26,7,0,20,17,1,1,1,0
S01012820,Owned: Owned with a mortgage or loan or shared ownership,266,256,219,15,204,35,2,10,4,0,0,3,3
S01012820,Rented or living rent free: Total,46,36,30,6,24,3,3,10,0,1,2,5,2
S01012820,Rented or living rent free: Social rented,26,20,15,2,13,2,3,6,0,0,1,3,2
S01012820,Rented or living rent free: Private rented or living rent free,20,16,15,4,11,1,0,4,0,1,1,2,0
S01012821,All HRPs aged 16 and over,263,241,205,22,183,30,6,22,11,0,3,6,2
S01012821,Owned: Total,225,215,186,14,172,28,1,10,6,0,1,2,1
S01012821,Owned: Owned outright,18,14,11,1,10,3,0,4,4,0,0,0,0
S01012821,Owned: Owned with a mortgage or loan or shared ownership,207,201,175,13,162,25,1,6,2,0,1,2,1
S01012821,Rented or living rent free: Total,38,26,19,8,11,2,5,12,5,0,2,4,1
S01012821,Rented or living rent free: Social rented,10,5,4,2,2,0,1,5,3,0,0,1,1
S01012821,Rented or living rent free: Private rented or living rent free,28,21,15,6,9,2,4,7,2,0,2,3,0
S01012822,All HRPs aged 16 and over,256,157,119,39,80,10,28,99,39,5,16,32,7
S01012822,Owned: Total,79,65,55,13,42,6,4,14,12,0,0,2,0
S01012822,Owned: Owned outright,28,17,14,5,9,1,2,11,10,0,0,1,0
S01012822,Owned: Owned with a mortgage or loan or shared ownership,51,48,41,8,33,5,2,3,2,0,0,1,0
S01012822,Rented or living rent free: Total,177,92,64,26,38,4,24,85,27,5,16,30,7
S01012822,Rented or living rent free: Social rented,133,62,45,20,25,2,15,71,23,4,10,27,7
S01012822,Rented or living rent free: Private rented or living rent free,44,30,19,6,13,2,9,14,4,1,6,3,0
S01012823,All HRPs aged 16 and over,285,263,224,16,208,28,11,22,18,0,1,3,0
S01012823,Owned: Total,265,247,213,11,202,27,7,18,16,0,0,2,0
S01012823,Owned: Owned outright,37,26,22,4,18,2,2,11,10,0,0,1,0
S01012823,Owned: Owned with a mortgage or loan or shared ownership,228,221,191,7,184,25,5,7,6,0,0,1,0
S01012823,Rented or living rent free: Total,20,16,11,5,6,1,4,4,2,0,1,1,0
S01012823,Rented or living rent free: Social rented,3,1,0,0,0,1,0,2,1,0,1,0,0
S01012823,Rented or living rent free: Private rented or living rent free,17,15,11,5,6,0,4,2,1,0,0,1,0
S01012824,All HRPs aged 16 and over,273,200,169,21,148,24,7,73,50,5,8,9,1
S01012824,Owned: Total,220,168,143,16,127,22,3,52,42,4,2,3,1
S01012824,Owned: Owned outright,50,16,14,5,9,2,0,34,34,0,0,0,0
S01012824,Owned: Owned with a mortgage or loan or shared ownership,170,152,129,11,118,20,3,18,8,4,2,3,1
S01012824,Rented or living rent free: Total,53,32,26,5,21,2,4,21,8,1,6,6,0
S01012824,Rented or living rent free: Social rented,34,19,15,3,12,2,2,15,4,1,6,4,0
S01012824,Rented or living rent free: Private rented or living rent free,19,13,11,2,9,0,2,6,4,0,0,2,0
S01012825,All HRPs aged 16 and over,269,149,121,17,104,10,18,120,62,6,7,38,7
S01012825,Owned: Total,122,87,78,11,67,7,2,35,30,1,0,2,2
S01012825,Owned: Owned outright,45,18,17,6,11,0,1,27,24,0,0,2,1
S01012825,Owned: Owned with a mortgage or loan or shared ownership,77,69,61,5,56,7,1,8,6,1,0,0,1
S01012825,Rented or living rent free: Total,147,62,43,6,37,3,16,85,32,5,7,36,5
S01012825,Rented or living rent free: Social rented,112,44,31,4,27,2,11,68,28,1,5,30,4
S01012825,Rented or living rent free: Private rented or living rent free,35,18,12,2,10,1,5,17,4,4,2,6,1
S01012826,All HRPs aged 16 and over,231,152,121,45,76,13,18,79,12,8,13,41,5
S01012826,Owned: Total,55,52,45,5,40,6,1,3,2,0,0,1,0
S01012826,Owned: Owned outright,6,4,4,1,3,0,0,2,2,0,0,0,0
S01012826,Owned: Owned with a mortgage or loan or shared ownership,49,48,41,4,37,6,1,1,0,0,0,1,0
S01012826,Rented or living rent free: Total,176,100,76,40,36,7,17,76,10,8,13,40,5
S01012826,Rented or living rent free: Social rented,163,95,73,40,33,7,15,68,10,2,13,39,4
S01012826,Rented or living rent free: Private rented or living rent free,13,5,3,0,3,0,2,8,0,6,0,1,1
S01012827,All HRPs aged 16 and over,233,213,186,16,170,23,4,20,7,3,3,5,2
S01012827,Owned: Total,202,190,166,10,156,22,2,12,7,0,2,2,1
S01012827,Owned: Owned outright,20,12,9,0,9,2,1,8,6,0,0,1,1
S01012827,Owned: Owned with a mortgage or loan or shared ownership,182,178,157,10,147,20,1,4,1,0,2,1,0
S01012827,Rented or living rent free: Total,31,23,20,6,14,1,2,8,0,3,1,3,1
S01012827,Rented or living rent free: Social rented,12,6,5,4,1,0,1,6,0,3,0,2,1
S01012827,Rented or living rent free: Private rented or living rent free,19,17,15,2,13,1,1,2,0,0,1,1,0
S01012828,All HRPs aged 16 and over,254,229,201,11,190,23,5,25,12,3,3,2,5
S01012828,Owned: Total,228,209,186,9,177,19,4,19,12,2,1,0,4
S01012828,Owned: Owned outright,38,27,24,3,21,2,1,11,9,0,1,0,1
S01012828,Owned: Owned with a mortgage or loan or shared ownership,190,182,162,6,156,17,3,8,3,2,0,0,3
S01012828,Rented or living rent free: Total,26,20,15,2,13,4,1,6,0,1,2,2,1
S01012828,Rented or living rent free: Social rented,2,2,1,0,1,1,0,0,0,0,0,0,0
S01012828,Rented or living rent free: Private rented or living rent free,24,18,14,2,12,3,1,6,0,1,2,2,1
S01012829,All HRPs aged 16 and over,362,220,177,45,132,22,21,142,84,1,15,33,9
S01012829,Owned: Total,175,126,107,19,88,16,3,49,43,0,0,5,1
S01012829,Owned: Owned outright,53,19,15,6,9,4,0,34,32,0,0,2,0
S01012829,Owned: Owned with a mortgage or loan or shared ownership,122,107,92,13,79,12,3,15,11,0,0,3,1
S01012829,Rented or living rent free: Total,187,94,70,26,44,6,18,93,41,1,15,28,8
S01012829,Rented or living rent free: Social rented,161,76,56,24,32,4,16,85,39,0,12,26,8
S01012829,Rented or living rent free: Private rented or living rent free,26,18,14,2,12,2,2,8,2,1,3,2,0
S01012830,All HRPs aged 16 and over,313,179,140,20,120,27,12,134,90,1,7,28,8
S01012830,Owned: Total,188,135,109,11,98,23,3,53,44,0,2,4,3
S01012830,Owned: Owned outright,70,31,27,6,21,2,2,39,34,0,0,3,2
S01012830,Owned: Owned with a mortgage or loan or shared ownership,118,104,82,5,77,21,1,14,10,0,2,1,1
S01012830,Rented or living rent free: Total,125,44,31,9,22,4,9,81,46,1,5,24,5
S01012830,Rented or living rent free: Social rented,105,35,27,8,19,1,7,70,44,1,2,23,0
S01012830,Rented or living rent free: Private rented or living rent free,20,9,4,1,3,3,2,11,2,0,3,1,5
S01012831,All HRPs aged 16 and over,333,144,121,31,90,16,7,189,148,2,3,34,2
S01012831,Owned: Total,182,108,92,21,71,13,3,74,65,2,2,5,0
S01012831,Owned: Owned outright,85,29,25,9,16,3,1,56,50,2,2,2,0
S01012831,Owned: Owned with a mortgage or loan or shared ownership,97,79,67,12,55,10,2,18,15,0,0,3,0
S01012831,Rented or living rent free: Total,151,36,29,10,19,3,4,115,83,0,1,29,2
S01012831,Rented or living rent free: Social rented,133,25,20,8,12,2,3,108,81,0,1,25,1
S01012831,Rented or living rent free: Private rented or living rent free,18,11,9,2,7,1,1,7,2,0,0,4,1
S01012832,All HRPs aged 16 and over,215,140,110,18,92,18,12,75,48,0,8,12,7
S01012832,Owned: Total,138,101,82,12,70,13,6,37,32,0,0,2,3
S01012832,Owned: Owned outright,47,21,16,4,12,2,3,26,22,0,0,2,2
S01012832,Owned: Owned with a mortgage or loan or shared ownership,91,80,66,8,58,11,3,11,10,0,0,0,1
S01012832,Rented or living rent free: Total,77,39,28,6,22,5,6,38,16,0,8,10,4
S01012832,Rented or living rent free: Social rented,68,33,23,4,19,4,6,35,15,0,6,10,4
S01012832,Rented or living rent free: Private rented or living rent free,9,6,5,2,3,1,0,3,1,0,2,0,0
S01012833,All HRPs aged 16 and over,319,177,150,46,104,8,19,142,92,1,10,29,10
S01012833,Owned: Total,146,91,83,14,69,5,3,55,48,0,1,6,0
S01012833,Owned: Owned outright,62,19,17,3,14,2,0,43,39,0,0,4,0
S01012833,Owned: Owned with a mortgage or loan or shared ownership,84,72,66,11,55,3,3,12,9,0,1,2,0
S01012833,Rented or living rent free: Total,173,86,67,32,35,3,16,87,44,1,9,23,10
S01012833,Rented or living rent free: Social rented,159,74,57,29,28,2,15,85,43,1,8,23,10
S01012833,Rented or living rent free: Private rented or living rent free,14,12,10,3,7,1,1,2,1,0,1,0,0
S01012834,All HRPs aged 16 and over,289,194,140,26,114,29,25,95,68,2,9,13,3
S01012834,Owned: Total,175,124,94,11,83,23,7,51,46,0,0,4,1
S01012834,Owned: Owned outright,74,41,26,6,20,11,4,33,32,0,0,1,0
S01012834,Owned: Owned with a mortgage or loan or shared ownership,101,83,68,5,63,12,3,18,14,0,0,3,1
S01012834,Rented or living rent free: Total,114,70,46,15,31,6,18,44,22,2,9,9,2
S01012834,Rented or living rent free: Social rented,97,57,39,11,28,3,15,40,21,1,7,9,2
S01012834,Rented or living rent free: Private rented or living rent free,17,13,7,4,3,3,3,4,1,1,2,0,0
S01012835,All HRPs aged 16 and over,403,254,210,31,179,30,14,149,117,1,5,24,2
S01012835,Owned: Total,271,185,159,20,139,21,5,86,82,0,0,4,0
S01012835,Owned: Owned outright,105,43,32,12,20,9,2,62,59,0,0,3,0
S01012835,Owned: Owned with a mortgage or loan or shared ownership,166,142,127,8,119,12,3,24,23,0,0,1,0
S01012835,Rented or living rent free: Total,132,69,51,11,40,9,9,63,35,1,5,20,2
S01012835,Rented or living rent free: Social rented,91,37,27,4,23,6,4,54,33,1,2,18,0
S01012835,Rented or living rent free: Private rented or living rent free,41,32,24,7,17,3,5,9,2,0,3,2,2
S01012836,All HRPs aged 16 and over,220,200,159,14,145,40,1,20,7,0,8,3,2
S01012836,Owned: Total,203,192,153,10,143,38,1,11,6,0,3,2,0
S01012836,Owned: Owned outright,26,21,17,2,15,3,1,5,3,0,1,1,0
S01012836,Owned: Owned with a mortgage or loan or shared ownership,177,171,136,8,128,35,0,6,3,0,2,1,0
S01012836,Rented or living rent free: Total,17,8,6,4,2,2,0,9,1,0,5,1,2
S01012836,Rented or living rent free: Social rented,10,3,3,3,0,0,0,7,1,0,4,1,1
S01012836,Rented or living rent free: Private rented or living rent free,7,5,3,1,2,2,0,2,0,0,1,0,1
S01012837,All HRPs aged 16 and over,414,253,155,42,113,18,80,161,51,7,24,64,15
S01012837,Owned: Total,48,36,29,4,25,6,1,12,9,0,0,1,2
S01012837,Owned: Owned outright,14,5,4,1,3,1,0,9,8,0,0,0,1
S01012837,Owned: Owned with a mortgage or loan or shared ownership,34,31,25,3,22,5,1,3,1,0,0,1,1
S01012837,Rented or living rent free: Total,366,217,126,38,88,12,79,149,42,7,24,63,13
S01012837,Rented or living rent free: Social rented,355,210,121,34,87,12,77,145,41,7,24,60,13
S01012837,Rented or living rent free: Private rented or living rent free,11,7,5,4,1,0,2,4,1,0,0,3,0
S01012838,All HRPs aged 16 and over,528,318,214,48,166,12,92,210,66,5,35,78,26
S01012838,Owned: Total,42,30,25,2,23,3,2,12,6,0,2,2,2
S01012838,Owned: Owned outright,9,1,1,0,1,0,0,8,5,0,1,1,1
S01012838,Owned: Owned with a mortgage or loan or shared ownership,33,29,24,2,22,3,2,4,1,0,1,1,1
S01012838,Rented or living rent free: Total,486,288,189,46,143,9,90,198,60,5,33,76,24
S01012838,Rented or living rent free: Social rented,466,275,176,43,133,9,90,191,59,5,32,72,23
S01012838,Rented or living rent free: Private rented or living rent free,20,13,13,3,10,0,0,7,1,0,1,4,1
S01012839,All HRPs aged 16 and over,300,235,197,24,173,35,3,65,60,0,0,5,0
S01012839,Owned: Total,283,222,186,19,167,34,2,61,58,0,0,3,0
S01012839,Owned: Owned outright,97,47,41,7,34,6,0,50,48,0,0,2,0
S01012839,Owned: Owned with a mortgage or loan or shared ownership,186,175,145,12,133,28,2,11,10,0,0,1,0
S01012839,Rented or living rent free: Total,17,13,11,5,6,1,1,4,2,0,0,2,0
S01012839,Rented or living rent free: Social rented,9,6,5,3,2,0,1,3,2,0,0,1,0
S01012839,Rented or living rent free: Private rented or living rent free,8,7,6,2,4,1,0,1,0,0,0,1,0
S01012840,All HRPs aged 16 and over,285,252,209,19,190,38,5,33,24,0,4,2,3
S01012840,Owned: Total,251,226,190,15,175,36,0,25,22,0,2,0,1
S01012840,Owned: Owned outright,51,31,27,6,21,4,0,20,19,0,0,0,1
S01012840,Owned: Owned with a mortgage or loan or shared ownership,200,195,163,9,154,32,0,5,3,0,2,0,0
S01012840,Rented or living rent free: Total,34,26,19,4,15,2,5,8,2,0,2,2,2
S01012840,Rented or living rent free: Social rented,10,7,3,1,2,0,4,3,1,0,1,1,0
S01012840,Rented or living rent free: Private rented or living rent free,24,19,16,3,13,2,1,5,1,0,1,1,2
S01012841,All HRPs aged 16 and over,253,188,159,16,143,27,2,65,57,0,2,6,0
S01012841,Owned: Total,225,169,141,12,129,26,2,56,54,0,0,2,0
S01012841,Owned: Owned outright,95,50,37,5,32,12,1,45,44,0,0,1,0
S01012841,Owned: Owned with a mortgage or loan or shared ownership,130,119,104,7,97,14,1,11,10,0,0,1,0
S01012841,Rented or living rent free: Total,28,19,18,4,14,1,0,9,3,0,2,4,0
S01012841,Rented or living rent free: Social rented,16,9,9,1,8,0,0,7,3,0,1,3,0
S01012841,Rented or living rent free: Private rented or living rent free,12,10,9,3,6,1,0,2,0,0,1,1,0
S01012842,All HRPs aged 16 and over,198,160,140,18,122,19,1,38,31,0,4,3,0
S01012842,Owned: Total,180,149,130,14,116,18,1,31,28,0,2,1,0
S01012842,Owned: Owned outright,66,45,36,6,30,9,0,21,20,0,0,1,0
S01012842,Owned: Owned with a mortgage or loan or shared ownership,114,104,94,8,86,9,1,10,8,0,2,0,0
S01012842,Rented or living rent free: Total,18,11,10,4,6,1,0,7,3,0,2,2,0
S01012842,Rented or living rent free: Social rented,7,2,2,1,1,0,0,5,3,0,1,1,0
S01012842,Rented or living rent free: Private rented or living rent free,11,9,8,3,5,1,0,2,0,0,1,1,0
S01012843,All HRPs aged 16 and over,381,259,207,17,190,48,4,122,115,2,0,3,2
S01012843,Owned: Total,359,240,192,16,176,46,2,119,114,1,0,3,1
S01012843,Owned: Owned outright,172,70,55,10,45,14,1,102,100,0,0,2,0
S01012843,Owned: Owned with a mortgage or loan or shared ownership,187,170,137,6,131,32,1,17,14,1,0,1,1
S01012843,Rented or living rent free: Total,22,19,15,1,14,2,2,3,1,1,0,0,1
S01012843,Rented or living rent free: Social rented,9,7,4,1,3,1,2,2,1,0,0,0,1
S01012843,Rented or living rent free: Private rented or living rent free,13,12,11,0,11,1,0,1,0,1,0,0,0
S01012844,All HRPs aged 16 and over,249,188,135,11,124,52,1,61,55,0,2,2,2
S01012844,Owned: Total,235,179,127,8,119,51,1,56,53,0,2,0,1
S01012844,Owned: Owned outright,104,56,41,5,36,14,1,48,48,0,0,0,0
S01012844,Owned: Owned with a mortgage or loan or shared ownership,131,123,86,3,83,37,0,8,5,0,2,0,1
S01012844,Rented or living rent free: Total,14,9,8,3,5,1,0,5,2,0,0,2,1
S01012844,Rented or living rent free: Social rented,7,4,3,2,1,1,0,3,1,0,0,2,0
S01012844,Rented or living rent free: Private rented or living rent free,7,5,5,1,4,0,0,2,1,0,0,0,1
S01012845,All HRPs aged 16 and over,281,177,136,16,120,35,6,104,76,1,7,17,3
S01012845,Owned: Total,235,158,123,12,111,31,4,77,71,1,3,2,0
S01012845,Owned: Owned outright,107,43,33,4,29,8,2,64,61,1,1,1,0
S01012845,Owned: Owned with a mortgage or loan or shared ownership,128,115,90,8,82,23,2,13,10,0,2,1,0
S01012845,Rented or living rent free: Total,46,19,13,4,9,4,2,27,5,0,4,15,3
S01012845,Rented or living rent free: Social rented,21,9,8,2,6,1,0,12,3,0,3,5,1
S01012845,Rented or living rent free: Private rented or living rent free,25,10,5,2,3,3,2,15,2,0,1,10,2
S01012846,All HRPs aged 16 and over,543,258,211,38,173,23,24,285,212,2,15,43,13
S01012846,Owned: Total,218,149,132,12,120,15,2,69,61,0,0,7,1
S01012846,Owned: Owned outright,99,37,33,7,26,4,0,62,55,0,0,6,1
S01012846,Owned: Owned with a mortgage or loan or shared ownership,119,112,99,5,94,11,2,7,6,0,0,1,0
S01012846,Rented or living rent free: Total,325,109,79,26,53,8,22,216,151,2,15,36,12
S01012846,Rented or living rent free: Social rented,243,47,34,9,25,3,10,196,145,1,8,32,10
S01012846,Rented or living rent free: Private rented or living rent free,82,62,45,17,28,5,12,20,6,1,7,4,2
S01012847,All HRPs aged 16 and over,249,150,120,14,106,24,6,99,79,2,0,15,3
S01012847,Owned: Total,171,129,104,8,96,22,3,42,33,1,0,7,1
S01012847,Owned: Owned outright,62,30,23,5,18,6,1,32,27,1,0,4,0
S01012847,Owned: Owned with a mortgage or loan or shared ownership,109,99,81,3,78,16,2,10,6,0,0,3,1
S01012847,Rented or living rent free: Total,78,21,16,6,10,2,3,57,46,1,0,8,2
S01012847,Rented or living rent free: Social rented,62,14,9,5,4,2,3,48,38,0,0,8,2
S01012847,Rented or living rent free: Private rented or living rent free,16,7,7,1,6,0,0,9,8,1,0,0,0
S01012848,All HRPs aged 16 and over,283,207,165,17,148,34,8,76,66,0,3,4,3
S01012848,Owned: Total,238,176,144,14,130,28,4,62,59,0,0,1,2
S01012848,Owned: Owned outright,81,29,22,3,19,6,1,52,51,0,0,1,0
S01012848,Owned: Owned with a mortgage or loan or shared ownership,157,147,122,11,111,22,3,10,8,0,0,0,2
S01012848,Rented or living rent free: Total,45,31,21,3,18,6,4,14,7,0,3,3,1
S01012848,Rented or living rent free: Social rented,14,4,2,0,2,1,1,10,5,0,3,2,0
S01012848,Rented or living rent free: Private rented or living rent free,31,27,19,3,16,5,3,4,2,0,0,1,1
S01012849,All HRPs aged 16 and over,345,233,209,32,177,15,9,112,61,3,14,30,4
S01012849,Owned: Total,157,108,102,17,85,6,0,49,40,0,3,6,0
S01012849,Owned: Owned outright,62,27,25,6,19,2,0,35,30,0,2,3,0
S01012849,Owned: Owned with a mortgage or loan or shared ownership,95,81,77,11,66,4,0,14,10,0,1,3,0
S01012849,Rented or living rent free: Total,188,125,107,15,92,9,9,63,21,3,11,24,4
S01012849,Rented or living rent free: Social rented,76,33,22,5,17,4,7,43,17,1,6,15,4
S01012849,Rented or living rent free: Private rented or living rent free,112,92,85,10,75,5,2,20,4,2,5,9,0
S01012850,All HRPs aged 16 and over,339,169,147,26,121,16,6,170,134,0,5,28,3
S01012850,Owned: Total,240,132,117,18,99,13,2,108,92,0,2,13,1
S01012850,Owned: Owned outright,103,27,26,5,21,1,0,76,69,0,1,5,1
S01012850,Owned: Owned with a mortgage or loan or shared ownership,137,105,91,13,78,12,2,32,23,0,1,8,0
S01012850,Rented or living rent free: Total,99,37,30,8,22,3,4,62,42,0,3,15,2
S01012850,Rented or living rent free: Social rented,90,31,24,7,17,3,4,59,41,0,3,14,1
S01012850,Rented or living rent free: Private rented or living rent free,9,6,6,1,5,0,0,3,1,0,0,1,1
S01012851,All HRPs aged 16 and over,374,218,184,39,145,31,3,156,129,1,3,20,3
S01012851,Owned: Total,301,189,159,31,128,29,1,112,103,0,1,6,2
S01012851,Owned: Owned outright,142,57,43,15,28,13,1,85,81,0,0,3,1
S01012851,Owned: Owned with a mortgage or loan or shared ownership,159,132,116,16,100,16,0,27,22,0,1,3,1
S01012851,Rented or living rent free: Total,73,29,25,8,17,2,2,44,26,1,2,14,1
S01012851,Rented or living rent free: Social rented,64,25,22,7,15,1,2,39,24,1,2,11,1
S01012851,Rented or living rent free: Private rented or living rent free,9,4,3,1,2,1,0,5,2,0,0,3,0
S01012852,All HRPs aged 16 and over,298,205,171,21,150,27,7,93,86,2,1,2,2
S01012852,Owned: Total,276,189,157,18,139,26,6,87,82,1,1,1,2
S01012852,Owned: Owned outright,153,72,61,15,46,6,5,81,80,0,0,0,1
S01012852,Owned: Owned with a mortgage or loan or shared ownership,123,117,96,3,93,20,1,6,2,1,1,1,1
S01012852,Rented or living rent free: Total,22,16,14,3,11,1,1,6,4,1,0,1,0
S01012852,Rented or living rent free: Social rented,7,4,4,2,2,0,0,3,2,0,0,1,0
S01012852,Rented or living rent free: Private rented or living rent free,15,12,10,1,9,1,1,3,2,1,0,0,0
S01012853,All HRPs aged 16 and over,338,193,151,22,129,36,6,145,137,1,2,3,2
S01012853,Owned: Total,321,180,141,20,121,35,4,141,135,0,1,3,2
S01012853,Owned: Owned outright,195,66,52,7,45,12,2,129,125,0,0,2,2
S01012853,Owned: Owned with a mortgage or loan or shared ownership,126,114,89,13,76,23,2,12,10,0,1,1,0
S01012853,Rented or living rent free: Total,17,13,10,2,8,1,2,4,2,1,1,0,0
S01012853,Rented or living rent free: Social rented,3,1,1,0,1,0,0,2,1,0,1,0,0
S01012853,Rented or living rent free: Private rented or living rent free,14,12,9,2,7,1,2,2,1,1,0,0,0
S01012854,All HRPs aged 16 and over,374,284,246,25,221,27,11,90,80,2,3,2,3
S01012854,Owned: Total,341,260,232,22,210,23,5,81,75,1,1,2,2
S01012854,Owned: Owned outright,123,54,45,6,39,7,2,69,65,0,1,2,1
S01012854,Owned: Owned with a mortgage or loan or shared ownership,218,206,187,16,171,16,3,12,10,1,0,0,1
S01012854,Rented or living rent free: Total,33,24,14,3,11,4,6,9,5,1,2,0,1
S01012854,Rented or living rent free: Social rented,2,1,1,1,0,0,0,1,0,0,1,0,0
S01012854,Rented or living rent free: Private rented or living rent free,31,23,13,2,11,4,6,8,5,1,1,0,1
S01012855,All HRPs aged 16 and over,284,230,189,15,174,27,14,54,37,2,4,11,0
S01012855,Owned: Total,223,183,152,8,144,25,6,40,35,2,1,2,0
S01012855,Owned: Owned outright,66,36,25,4,21,8,3,30,28,0,1,1,0
S01012855,Owned: Owned with a mortgage or loan or shared ownership,157,147,127,4,123,17,3,10,7,2,0,1,0
S01012855,Rented or living rent free: Total,61,47,37,7,30,2,8,14,2,0,3,9,0
S01012855,Rented or living rent free: Social rented,7,5,5,2,3,0,0,2,0,0,1,1,0
S01012855,Rented or living rent free: Private rented or living rent free,54,42,32,5,27,2,8,12,2,0,2,8,0
S01012856,All HRPs aged 16 and over,414,206,180,27,153,16,10,208,154,3,2,40,9
S01012856,Owned: Total,230,146,133,17,116,11,2,84,75,1,1,5,2
S01012856,Owned: Owned outright,96,30,29,9,20,0,1,66,62,1,0,2,1
S01012856,Owned: Owned with a mortgage or loan or shared ownership,134,116,104,8,96,11,1,18,13,0,1,3,1
S01012856,Rented or living rent free: Total,184,60,47,10,37,5,8,124,79,2,1,35,7
S01012856,Rented or living rent free: Social rented,124,27,19,3,16,2,6,97,68,0,0,24,5
S01012856,Rented or living rent free: Private rented or living rent free,60,33,28,7,21,3,2,27,11,2,1,11,2
S01012857,All HRPs aged 16 and over,472,219,184,30,154,15,20,253,182,1,10,48,12
S01012857,Owned: Total,254,142,127,21,106,11,4,112,104,0,2,6,0
S01012857,Owned: Owned outright,134,43,34,9,25,7,2,91,86,0,1,4,0
S01012857,Owned: Owned with a mortgage or loan or shared ownership,120,99,93,12,81,4,2,21,18,0,1,2,0
S01012857,Rented or living rent free: Total,218,77,57,9,48,4,16,141,78,1,8,42,12
S01012857,Rented or living rent free: Social rented,174,51,37,8,29,2,12,123,71,1,3,37,11
S01012857,Rented or living rent free: Private rented or living rent free,44,26,20,1,19,2,4,18,7,0,5,5,1
S01012858,All HRPs aged 16 and over,422,247,214,42,172,15,18,175,96,2,7,60,10
S01012858,Owned: Total,177,134,121,14,107,10,3,43,38,0,2,3,0
S01012858,Owned: Owned outright,44,16,15,1,14,0,1,28,26,0,1,1,0
S01012858,Owned: Owned with a mortgage or loan or shared ownership,133,118,106,13,93,10,2,15,12,0,1,2,0
S01012858,Rented or living rent free: Total,245,113,93,28,65,5,15,132,58,2,5,57,10
S01012858,Rented or living rent free: Social rented,201,84,71,25,46,4,9,117,56,1,2,49,9
S01012858,Rented or living rent free: Private rented or living rent free,44,29,22,3,19,1,6,15,2,1,3,8,1
S01012859,All HRPs aged 16 and over,530,368,296,49,247,43,29,162,88,13,2,47,12
S01012859,Owned: Total,338,262,219,24,195,34,9,76,54,4,1,12,5
S01012859,Owned: Owned outright,85,38,27,4,23,9,2,47,42,0,0,4,1
S01012859,Owned: Owned with a mortgage or loan or shared ownership,253,224,192,20,172,25,7,29,12,4,1,8,4
S01012859,Rented or living rent free: Total,192,106,77,25,52,9,20,86,34,9,1,35,7
S01012859,Rented or living rent free: Social rented,95,46,31,8,23,4,11,49,20,1,0,24,4
S01012859,Rented or living rent free: Private rented or living rent free,97,60,46,17,29,5,9,37,14,8,1,11,3
S01012860,All HRPs aged 16 and over,382,210,171,30,141,33,6,172,151,5,8,6,2
S01012860,Owned: Total,320,172,139,21,118,30,3,148,136,4,2,4,2
S01012860,Owned: Owned outright,165,37,28,13,15,7,2,128,121,3,2,1,1
S01012860,Owned: Owned with a mortgage or loan or shared ownership,155,135,111,8,103,23,1,20,15,1,0,3,1
S01012860,Rented or living rent free: Total,62,38,32,9,23,3,3,24,15,1,6,2,0
S01012860,Rented or living rent free: Social rented,20,9,8,3,5,1,0,11,8,0,1,2,0
S01012860,Rented or living rent free: Private rented or living rent free,42,29,24,6,18,2,3,13,7,1,5,0,0
S01012861,All HRPs aged 16 and over,322,217,176,19,157,35,6,105,92,1,3,8,1
S01012861,Owned: Total,281,194,157,16,141,34,3,87,83,0,2,2,0
S01012861,Owned: Owned outright,127,49,35,7,28,14,0,78,76,0,0,2,0
S01012861,Owned: Owned with a mortgage or loan or shared ownership,154,145,122,9,113,20,3,9,7,0,2,0,0
S01012861,Rented or living rent free: Total,41,23,19,3,16,1,3,18,9,1,1,6,1
S01012861,Rented or living rent free: Social rented,13,4,4,1,3,0,0,9,3,1,1,3,1
S01012861,Rented or living rent free: Private rented or living rent free,28,19,15,2,13,1,3,9,6,0,0,3,0
S01012862,All HRPs aged 16 and over,369,197,154,27,127,15,28,172,101,5,6,53,7
S01012862,Owned: Total,134,85,71,11,60,9,5,49,39,4,0,4,2
S01012862,Owned: Owned outright,45,12,10,2,8,1,1,33,30,0,0,2,1
S01012862,Owned: Owned with a mortgage or loan or shared ownership,89,73,61,9,52,8,4,16,9,4,0,2,1
S01012862,Rented or living rent free: Total,235,112,83,16,67,6,23,123,62,1,6,49,5
S01012862,Rented or living rent free: Social rented,187,88,66,15,51,4,18,99,50,1,2,41,5
S01012862,Rented or living rent free: Private rented or living rent free,48,24,17,1,16,2,5,24,12,0,4,8,0
S01012863,All HRPs aged 16 and over,424,270,211,36,175,10,49,154,68,3,11,55,17
S01012863,Owned: Total,121,91,85,8,77,4,2,30,25,0,0,2,3
S01012863,Owned: Owned outright,35,12,10,1,9,1,1,23,18,0,0,2,3
S01012863,Owned: Owned with a mortgage or loan or shared ownership,86,79,75,7,68,3,1,7,7,0,0,0,0
S01012863,Rented or living rent free: Total,303,179,126,28,98,6,47,124,43,3,11,53,14
S01012863,Rented or living rent free: Social rented,232,125,85,17,68,5,35,107,39,3,9,45,11
S01012863,Rented or living rent free: Private rented or living rent free,71,54,41,11,30,1,12,17,4,0,2,8,3
S01012864,All HRPs aged 16 and over,469,289,223,48,175,23,43,180,82,15,17,55,11
S01012864,Owned: Total,173,133,119,12,107,12,2,40,32,1,1,6,0
S01012864,Owned: Owned outright,54,26,24,4,20,2,0,28,22,0,0,6,0
S01012864,Owned: Owned with a mortgage or loan or shared ownership,119,107,95,8,87,10,2,12,10,1,1,0,0
S01012864,Rented or living rent free: Total,296,156,104,36,68,11,41,140,50,14,16,49,11
S01012864,Rented or living rent free: Social rented,222,117,77,28,49,5,35,105,43,2,13,41,6
S01012864,Rented or living rent free: Private rented or living rent free,74,39,27,8,19,6,6,35,7,12,3,8,5
S01012865,All HRPs aged 16 and over,390,181,150,26,124,26,5,209,167,4,8,19,11
S01012865,Owned: Total,252,147,127,16,111,20,0,105,91,3,2,9,0
S01012865,Owned: Owned outright,112,32,24,5,19,8,0,80,75,2,0,3,0
S01012865,Owned: Owned with a mortgage or loan or shared ownership,140,115,103,11,92,12,0,25,16,1,2,6,0
S01012865,Rented or living rent free: Total,138,34,23,10,13,6,5,104,76,1,6,10,11
S01012865,Rented or living rent free: Social rented,113,23,14,6,8,5,4,90,69,1,3,8,9
S01012865,Rented or living rent free: Private rented or living rent free,25,11,9,4,5,1,1,14,7,0,3,2,2
S01012866,All HRPs aged 16 and over,374,242,206,42,164,19,17,132,89,7,9,23,4
S01012866,Owned: Total,259,188,171,33,138,13,4,71,57,6,0,5,3
S01012866,Owned: Owned outright,77,31,27,11,16,3,1,46,41,1,0,3,1
S01012866,Owned: Owned with a mortgage or loan or shared ownership,182,157,144,22,122,10,3,25,16,5,0,2,2
S01012866,Rented or living rent free: Total,115,54,35,9,26,6,13,61,32,1,9,18,1
S01012866,Rented or living rent free: Social rented,81,31,17,6,11,1,13,50,29,1,6,13,1
S01012866,Rented or living rent free: Private rented or living rent free,34,23,18,3,15,5,0,11,3,0,3,5,0
S01012867,All HRPs aged 16 and over,396,176,154,36,118,12,10,220,145,3,10,48,14
S01012867,Owned: Total,186,104,92,21,71,8,4,82,69,0,4,8,1
S01012867,Owned: Owned outright,80,27,24,11,13,2,1,53,47,0,1,4,1
S01012867,Owned: Owned with a mortgage or loan or shared ownership,106,77,68,10,58,6,3,29,22,0,3,4,0
S01012867,Rented or living rent free: Total,210,72,62,15,47,4,6,138,76,3,6,40,13
S01012867,Rented or living rent free: Social rented,186,61,51,14,37,4,6,125,73,2,4,39,7
S01012867,Rented or living rent free: Private rented or living rent free,24,11,11,1,10,0,0,13,3,1,2,1,6
S01012868,All HRPs aged 16 and over,321,178,149,33,116,14,15,143,90,0,7,38,8
S01012868,Owned: Total,174,109,97,17,80,9,3,65,51,0,1,11,2
S01012868,Owned: Owned outright,77,26,23,7,16,3,0,51,42,0,1,6,2
S01012868,Owned: Owned with a mortgage or loan or shared ownership,97,83,74,10,64,6,3,14,9,0,0,5,0
S01012868,Rented or living rent free: Total,147,69,52,16,36,5,12,78,39,0,6,27,6
S01012868,Rented or living rent free: Social rented,96,33,26,9,17,2,5,63,36,0,5,19,3
S01012868,Rented or living rent free: Private rented or living rent free,51,36,26,7,19,3,7,15,3,0,1,8,3
S01012869,All HRPs aged 16 and over,257,153,120,39,81,5,28,104,43,7,14,37,3
S01012869,Owned: Total,64,43,39,7,32,3,1,21,17,0,0,4,0
S01012869,Owned: Owned outright,25,8,6,3,3,2,0,17,15,0,0,2,0
S01012869,Owned: Owned with a mortgage or loan or shared ownership,39,35,33,4,29,1,1,4,2,0,0,2,0
S01012869,Rented or living rent free: Total,193,110,81,32,49,2,27,83,26,7,14,33,3
S01012869,Rented or living rent free: Social rented,177,96,73,30,43,1,22,81,26,6,14,32,3
S01012869,Rented or living rent free: Private rented or living rent free,16,14,8,2,6,1,5,2,0,1,0,1,0
S01012870,All HRPs aged 16 and over,450,256,209,32,177,40,7,194,148,2,3,34,7
S01012870,Owned: Total,353,227,185,28,157,39,3,126,114,0,0,6,6
S01012870,Owned: Owned outright,162,56,43,12,31,11,2,106,99,0,0,3,4
S01012870,Owned: Owned with a mortgage or loan or shared ownership,191,171,142,16,126,28,1,20,15,0,0,3,2
S01012870,Rented or living rent free: Total,97,29,24,4,20,1,4,68,34,2,3,28,1
S01012870,Rented or living rent free: Social rented,74,16,11,2,9,1,4,58,30,2,2,23,1
S01012870,Rented or living rent free: Private rented or living rent free,23,13,13,2,11,0,0,10,4,0,1,5,0
S01012871,All HRPs aged 16 and over,384,235,194,35,159,31,10,149,125,0,6,16,2
S01012871,Owned: Total,326,201,167,28,139,26,8,125,115,0,1,8,1
S01012871,Owned: Owned outright,156,49,41,12,29,4,4,107,100,0,0,6,1
S01012871,Owned: Owned with a mortgage or loan or shared ownership,170,152,126,16,110,22,4,18,15,0,1,2,0
S01012871,Rented or living rent free: Total,58,34,27,7,20,5,2,24,10,0,5,8,1
S01012871,Rented or living rent free: Social rented,13,6,3,2,1,3,0,7,3,0,1,3,0
S01012871,Rented or living rent free: Private rented or living rent free,45,28,24,5,19,2,2,17,7,0,4,5,1
S01012872,All HRPs aged 16 and over,318,241,209,39,170,19,13,77,54,1,8,9,5
S01012872,Owned: Total,242,185,164,23,141,16,5,57,47,1,1,6,2
S01012872,Owned: Owned outright,91,43,34,9,25,7,2,48,45,1,0,2,0
S01012872,Owned: Owned with a mortgage or loan or shared ownership,151,142,130,14,116,9,3,9,2,0,1,4,2
S01012872,Rented or living rent free: Total,76,56,45,16,29,3,8,20,7,0,7,3,3
S01012872,Rented or living rent free: Social rented,7,2,2,1,1,0,0,5,1,0,2,0,2
S01012872,Rented or living rent free: Private rented or living rent free,69,54,43,15,28,3,8,15,6,0,5,3,1
S01012873,All HRPs aged 16 and over,338,248,215,40,175,26,7,90,62,3,7,11,7
S01012873,Owned: Total,266,210,187,30,157,22,1,56,49,0,2,3,2
S01012873,Owned: Owned outright,84,39,34,7,27,4,1,45,41,0,2,0,2
S01012873,Owned: Owned with a mortgage or loan or shared ownership,182,171,153,23,130,18,0,11,8,0,0,3,0
S01012873,Rented or living rent free: Total,72,38,28,10,18,4,6,34,13,3,5,8,5
S01012873,Rented or living rent free: Social rented,15,7,4,2,2,0,3,8,4,0,2,0,2
S01012873,Rented or living rent free: Private rented or living rent free,57,31,24,8,16,4,3,26,9,3,3,8,3
S01012874,All HRPs aged 16 and over,383,218,167,31,136,25,26,165,103,3,12,38,9
S01012874,Owned: Total,206,130,109,17,92,20,1,76,64,1,2,6,3
S01012874,Owned: Owned outright,81,22,18,4,14,4,0,59,55,1,0,1,2
S01012874,Owned: Owned with a mortgage or loan or shared ownership,125,108,91,13,78,16,1,17,9,0,2,5,1
S01012874,Rented or living rent free: Total,177,88,58,14,44,5,25,89,39,2,10,32,6
S01012874,Rented or living rent free: Social rented,146,65,37,12,25,4,24,81,37,1,8,29,6
S01012874,Rented or living rent free: Private rented or living rent free,31,23,21,2,19,1,1,8,2,1,2,3,0
S01012875,All HRPs aged 16 and over,277,178,144,24,120,18,16,99,59,6,7,18,9
S01012875,Owned: Total,153,110,95,9,86,14,1,43,39,0,0,0,4
S01012875,Owned: Owned outright,57,24,21,6,15,3,0,33,30,0,0,0,3
S01012875,Owned: Owned with a mortgage or loan or shared ownership,96,86,74,3,71,11,1,10,9,0,0,0,1
S01012875,Rented or living rent free: Total,124,68,49,15,34,4,15,56,20,6,7,18,5
S01012875,Rented or living rent free: Social rented,93,50,35,12,23,3,12,43,18,0,5,17,3
S01012875,Rented or living rent free: Private rented or living rent free,31,18,14,3,11,1,3,13,2,6,2,1,2
S01012876,All HRPs aged 16 and over,371,192,165,49,116,15,12,179,134,1,5,29,10
S01012876,Owned: Total,213,131,118,28,90,10,3,82,73,0,1,7,1
S01012876,Owned: Owned outright,76,23,22,9,13,1,0,53,51,0,0,1,1
S01012876,Owned: Owned with a mortgage or loan or shared ownership,137,108,96,19,77,9,3,29,22,0,1,6,0
S01012876,Rented or living rent free: Total,158,61,47,21,26,5,9,97,61,1,4,22,9
S01012876,Rented or living rent free: Social rented,141,49,36,17,19,5,8,92,61,1,1,21,8
S01012876,Rented or living rent free: Private rented or living rent free,17,12,11,4,7,0,1,5,0,0,3,1,1
S01012877,All HRPs aged 16 and over,331,173,150,31,119,13,10,158,125,0,9,20,4
S01012877,Owned: Total,251,147,130,21,109,12,5,104,94,0,1,7,2
S01012877,Owned: Owned outright,102,28,24,4,20,2,2,74,73,0,0,1,0
S01012877,Owned: Owned with a mortgage or loan or shared ownership,149,119,106,17,89,10,3,30,21,0,1,6,2
S01012877,Rented or living rent free: Total,80,26,20,10,10,1,5,54,31,0,8,13,2
S01012877,Rented or living rent free: Social rented,73,23,19,10,9,1,3,50,29,0,6,13,2
S01012877,Rented or living rent free: Private rented or living rent free,7,3,1,0,1,0,2,4,2,0,2,0,0
S01012878,All HRPs aged 16 and over,373,275,229,20,209,43,3,98,85,2,3,4,4
S01012878,Owned: Total,338,251,209,17,192,41,1,87,82,0,0,2,3
S01012878,Owned: Owned outright,136,58,47,10,37,11,0,78,76,0,0,1,1
S01012878,Owned: Owned with a mortgage or loan or shared ownership,202,193,162,7,155,30,1,9,6,0,0,1,2
S01012878,Rented or living rent free: Total,35,24,20,3,17,2,2,11,3,2,3,2,1
S01012878,Rented or living rent free: Social rented,8,6,5,1,4,0,1,2,1,0,1,0,0
S01012878,Rented or living rent free: Private rented or living rent free,27,18,15,2,13,2,1,9,2,2,2,2,1
S01012879,All HRPs aged 16 and over,323,202,166,24,142,28,8,121,108,3,1,7,2
S01012879,Owned: Total,274,173,143,13,130,26,4,101,97,2,0,1,1
S01012879,Owned: Owned outright,133,47,35,10,25,10,2,86,84,1,0,0,1
S01012879,Owned: Owned with a mortgage or loan or shared ownership,141,126,108,3,105,16,2,15,13,1,0,1,0
S01012879,Rented or living rent free: Total,49,29,23,11,12,2,4,20,11,1,1,6,1
S01012879,Rented or living rent free: Social rented,12,7,5,2,3,0,2,5,2,0,1,2,0
S01012879,Rented or living rent free: Private rented or living rent free,37,22,18,9,9,2,2,15,9,1,0,4,1
S01012880,All HRPs aged 16 and over,374,230,187,21,166,41,2,144,132,4,5,2,1
S01012880,Owned: Total,349,217,176,18,158,39,2,132,125,4,1,1,1
S01012880,Owned: Owned outright,184,69,56,11,45,13,0,115,110,3,1,0,1
S01012880,Owned: Owned with a mortgage or loan or shared ownership,165,148,120,7,113,26,2,17,15,1,0,1,0
S01012880,Rented or living rent free: Total,25,13,11,3,8,2,0,12,7,0,4,1,0
S01012880,Rented or living rent free: Social rented,9,2,1,0,1,1,0,7,3,0,3,1,0
S01012880,Rented or living rent free: Private rented or living rent free,16,11,10,3,7,1,0,5,4,0,1,0,0
S01012881,All HRPs aged 16 and over,406,202,158,22,136,39,5,204,181,2,7,9,5
S01012881,Owned: Total,356,179,138,17,121,36,5,177,171,0,1,2,3
S01012881,Owned: Owned outright,220,59,43,11,32,13,3,161,157,0,1,0,3
S01012881,Owned: Owned with a mortgage or loan or shared ownership,136,120,95,6,89,23,2,16,14,0,0,2,0
S01012881,Rented or living rent free: Total,50,23,20,5,15,3,0,27,10,2,6,7,2
S01012881,Rented or living rent free: Social rented,30,10,9,4,5,1,0,20,6,1,5,7,1
S01012881,Rented or living rent free: Private rented or living rent free,20,13,11,1,10,2,0,7,4,1,1,0,1
S01012882,All HRPs aged 16 and over,287,169,133,43,90,13,23,118,72,3,11,27,5
S01012882,Owned: Total,137,86,72,14,58,10,4,51,47,0,1,2,1
S01012882,Owned: Owned outright,68,29,23,8,15,4,2,39,38,0,0,1,0
S01012882,Owned: Owned with a mortgage or loan or shared ownership,69,57,49,6,43,6,2,12,9,0,1,1,1
S01012882,Rented or living rent free: Total,150,83,61,29,32,3,19,67,25,3,10,25,4
S01012882,Rented or living rent free: Social rented,133,71,54,27,27,1,16,62,24,3,9,22,4
S01012882,Rented or living rent free: Private rented or living rent free,17,12,7,2,5,2,3,5,1,0,1,3,0
S01012883,All HRPs aged 16 and over,378,167,119,27,92,12,36,211,116,0,17,64,14
S01012883,Owned: Total,125,72,63,12,51,5,4,53,41,0,1,6,5
S01012883,Owned: Owned outright,57,13,10,1,9,1,2,44,35,0,1,3,5
S01012883,Owned: Owned with a mortgage or loan or shared ownership,68,59,53,11,42,4,2,9,6,0,0,3,0
S01012883,Rented or living rent free: Total,253,95,56,15,41,7,32,158,75,0,16,58,9
S01012883,Rented or living rent free: Social rented,244,87,51,14,37,7,29,157,74,0,16,58,9
S01012883,Rented or living rent free: Private rented or living rent free,9,8,5,1,4,0,3,1,1,0,0,0,0
S01012884,All HRPs aged 16 and over,285,132,94,11,83,21,17,153,116,1,6,27,3
S01012884,Owned: Total,113,83,58,5,53,19,6,30,27,1,1,1,0
S01012884,Owned: Owned outright,43,19,13,1,12,4,2,24,23,0,1,0,0
S01012884,Owned: Owned with a mortgage or loan or shared ownership,70,64,45,4,41,15,4,6,4,1,0,1,0
S01012884,Rented or living rent free: Total,172,49,36,6,30,2,11,123,89,0,5,26,3
S01012884,Rented or living rent free: Social rented,153,35,25,5,20,1,9,118,86,0,4,25,3
S01012884,Rented or living rent free: Private rented or living rent free,19,14,11,1,10,1,2,5,3,0,1,1,0
S01012885,All HRPs aged 16 and over,270,150,117,22,95,9,24,120,63,1,6,37,13
S01012885,Owned: Total,99,66,57,7,50,8,1,33,24,0,0,6,3
S01012885,Owned: Owned outright,45,17,13,3,10,4,0,28,23,0,0,3,2
S01012885,Owned: Owned with a mortgage or loan or shared ownership,54,49,44,4,40,4,1,5,1,0,0,3,1
S01012885,Rented or living rent free: Total,171,84,60,15,45,1,23,87,39,1,6,31,10
S01012885,Rented or living rent free: Social rented,132,56,41,9,32,1,14,76,35,1,5,27,8
S01012885,Rented or living rent free: Private rented or living rent free,39,28,19,6,13,0,9,11,4,0,1,4,2
S01012886,All HRPs aged 16 and over,315,204,169,23,146,29,6,111,99,2,2,5,3
S01012886,Owned: Total,279,182,150,20,130,27,5,97,88,1,2,5,1
S01012886,Owned: Owned outright,121,45,35,7,28,8,2,76,75,0,0,1,0
S01012886,Owned: Owned with a mortgage or loan or shared ownership,158,137,115,13,102,19,3,21,13,1,2,4,1
S01012886,Rented or living rent free: Total,36,22,19,3,16,2,1,14,11,1,0,0,2
S01012886,Rented or living rent free: Social rented,14,5,3,0,3,1,1,9,8,0,0,0,1
S01012886,Rented or living rent free: Private rented or living rent free,22,17,16,3,13,1,0,5,3,1,0,0,1
S01012887,All HRPs aged 16 and over,352,209,179,17,162,26,4,143,127,0,3,11,2
S01012887,Owned: Total,331,199,170,13,157,26,3,132,124,0,1,5,2
S01012887,Owned: Owned outright,170,52,42,10,32,7,3,118,111,0,1,4,2
S01012887,Owned: Owned with a mortgage or loan or shared ownership,161,147,128,3,125,19,0,14,13,0,0,1,0
S01012887,Rented or living rent free: Total,21,10,9,4,5,0,1,11,3,0,2,6,0
S01012887,Rented or living rent free: Social rented,10,3,2,1,1,0,1,7,1,0,2,4,0
S01012887,Rented or living rent free: Private rented or living rent free,11,7,7,3,4,0,0,4,2,0,0,2,0
S01012888,All HRPs aged 16 and over,333,195,152,15,137,42,1,138,128,0,4,5,1
S01012888,Owned: Total,302,181,142,13,129,39,0,121,118,0,2,1,0
S01012888,Owned: Owned outright,163,58,46,7,39,12,0,105,103,0,1,1,0
S01012888,Owned: Owned with a mortgage or loan or shared ownership,139,123,96,6,90,27,0,16,15,0,1,0,0
S01012888,Rented or living rent free: Total,31,14,10,2,8,3,1,17,10,0,2,4,1
S01012888,Rented or living rent free: Social rented,19,5,5,2,3,0,0,14,8,0,1,4,1
S01012888,Rented or living rent free: Private rented or living rent free,12,9,5,0,5,3,1,3,2,0,1,0,0
S01012889,All HRPs aged 16 and over,342,277,232,30,202,42,3,65,42,0,5,16,2
S01012889,Owned: Total,277,245,208,23,185,36,1,32,27,0,2,3,0
S01012889,Owned: Owned outright,51,32,27,9,18,5,0,19,17,0,0,2,0
S01012889,Owned: Owned with a mortgage or loan or shared ownership,226,213,181,14,167,31,1,13,10,0,2,1,0
S01012889,Rented or living rent free: Total,65,32,24,7,17,6,2,33,15,0,3,13,2
S01012889,Rented or living rent free: Social rented,43,13,11,2,9,0,2,30,14,0,3,12,1
S01012889,Rented or living rent free: Private rented or living rent free,22,19,13,5,8,6,0,3,1,0,0,1,1
S01012890,All HRPs aged 16 and over,300,179,142,24,118,19,18,121,60,1,16,38,6
S01012890,Owned: Total,144,95,81,3,78,12,2,49,38,0,0,9,2
S01012890,Owned: Owned outright,42,13,10,0,10,3,0,29,25,0,0,2,2
S01012890,Owned: Owned with a mortgage or loan or shared ownership,102,82,71,3,68,9,2,20,13,0,0,7,0
S01012890,Rented or living rent free: Total,156,84,61,21,40,7,16,72,22,1,16,29,4
S01012890,Rented or living rent free: Social rented,139,71,50,17,33,5,16,68,20,1,15,28,4
S01012890,Rented or living rent free: Private rented or living rent free,17,13,11,4,7,2,0,4,2,0,1,1,0
S01012891,All HRPs aged 16 and over,255,144,115,25,90,22,7,111,88,0,1,18,4
S01012891,Owned: Total,168,107,86,13,73,19,2,61,57,0,0,3,1
S01012891,Owned: Owned outright,65,25,20,7,13,3,2,40,39,0,0,1,0
S01012891,Owned: Owned with a mortgage or loan or shared ownership,103,82,66,6,60,16,0,21,18,0,0,2,1
S01012891,Rented or living rent free: Total,87,37,29,12,17,3,5,50,31,0,1,15,3
S01012891,Rented or living rent free: Social rented,79,29,25,10,15,1,3,50,31,0,1,15,3
S01012891,Rented or living rent free: Private rented or living rent free,8,8,4,2,2,2,2,0,0,0,0,0,0
S01012892,All HRPs aged 16 and over,566,306,239,57,182,24,43,260,157,1,13,75,14
S01012892,Owned: Total,267,170,146,18,128,17,7,97,88,0,0,6,3
S01012892,Owned: Owned outright,117,50,40,11,29,5,5,67,62,0,0,3,2
S01012892,Owned: Owned with a mortgage or loan or shared ownership,150,120,106,7,99,12,2,30,26,0,0,3,1
S01012892,Rented or living rent free: Total,299,136,93,39,54,7,36,163,69,1,13,69,11
S01012892,Rented or living rent free: Social rented,269,112,74,34,40,4,34,157,66,1,13,68,9
S01012892,Rented or living rent free: Private rented or living rent free,30,24,19,5,14,3,2,6,3,0,0,1,2
S01012893,All HRPs aged 16 and over,369,201,167,47,120,12,22,168,103,8,11,32,14
S01012893,Owned: Total,188,112,99,23,76,8,5,76,64,2,1,6,3
S01012893,Owned: Owned outright,91,28,23,6,17,4,1,63,56,2,1,4,0
S01012893,Owned: Owned with a mortgage or loan or shared ownership,97,84,76,17,59,4,4,13,8,0,0,2,3
S01012893,Rented or living rent free: Total,181,89,68,24,44,4,17,92,39,6,10,26,11
S01012893,Rented or living rent free: Social rented,169,78,59,21,38,4,15,91,38,6,10,26,11
S01012893,Rented or living rent free: Private rented or living rent free,12,11,9,3,6,0,2,1,1,0,0,0,0
S01012894,All HRPs aged 16 and over,311,232,191,33,158,36,5,79,47,3,4,21,4
S01012894,Owned: Total,210,187,155,17,138,31,1,23,21,0,0,1,1
S01012894,Owned: Owned outright,50,31,19,4,15,11,1,19,17,0,0,1,1
S01012894,Owned: Owned with a mortgage or loan or shared ownership,160,156,136,13,123,20,0,4,4,0,0,0,0
S01012894,Rented or living rent free: Total,101,45,36,16,20,5,4,56,26,3,4,20,3
S01012894,Rented or living rent free: Social rented,85,36,28,12,16,4,4,49,20,3,4,19,3
S01012894,Rented or living rent free: Private rented or living rent free,16,9,8,4,4,1,0,7,6,0,0,1,0
S01012895,All HRPs aged 16 and over,197,164,123,12,111,36,5,33,25,0,1,6,1
S01012895,Owned: Total,166,143,110,8,102,31,2,23,21,0,1,1,0
S01012895,Owned: Owned outright,50,30,17,3,14,13,0,20,20,0,0,0,0
S01012895,Owned: Owned with a mortgage or loan or shared ownership,116,113,93,5,88,18,2,3,1,0,1,1,0
S01012895,Rented or living rent free: Total,31,21,13,4,9,5,3,10,4,0,0,5,1
S01012895,Rented or living rent free: Social rented,19,11,8,2,6,0,3,8,2,0,0,5,1
S01012895,Rented or living rent free: Private rented or living rent free,12,10,5,2,3,5,0,2,2,0,0,0,0
S01012896,All HRPs aged 16 and over,482,255,213,36,177,25,17,227,174,1,5,36,11
S01012896,Owned: Total,194,116,100,10,90,13,3,78,73,0,0,4,1
S01012896,Owned: Owned outright,95,31,27,3,24,3,1,64,60,0,0,4,0
S01012896,Owned: Owned with a mortgage or loan or shared ownership,99,85,73,7,66,10,2,14,13,0,0,0,1
S01012896,Rented or living rent free: Total,288,139,113,26,87,12,14,149,101,1,5,32,10
S01012896,Rented or living rent free: Social rented,272,125,103,25,78,9,13,147,101,1,5,31,9
S01012896,Rented or living rent free: Private rented or living rent free,16,14,10,1,9,3,1,2,0,0,0,1,1
S01012897,All HRPs aged 16 and over,248,198,168,20,148,27,3,50,44,2,1,1,2
S01012897,Owned: Total,217,173,144,12,132,26,3,44,42,1,0,0,1
S01012897,Owned: Owned outright,82,45,35,4,31,8,2,37,36,1,0,0,0
S01012897,Owned: Owned with a mortgage or loan or shared ownership,135,128,109,8,101,18,1,7,6,0,0,0,1
S01012897,Rented or living rent free: Total,31,25,24,8,16,1,0,6,2,1,1,1,1
S01012897,Rented or living rent free: Social rented,6,4,4,2,2,0,0,2,0,1,0,1,0
S01012897,Rented or living rent free: Private rented or living rent free,25,21,20,6,14,1,0,4,2,0,1,0,1
S01012898,All HRPs aged 16 and over,177,165,137,9,128,25,3,12,8,0,2,2,0
S01012898,Owned: Total,161,153,129,6,123,23,1,8,7,0,0,1,0
S01012898,Owned: Owned outright,18,11,8,1,7,2,1,7,7,0,0,0,0
S01012898,Owned: Owned with a mortgage or loan or shared ownership,143,142,121,5,116,21,0,1,0,0,0,1,0
S01012898,Rented or living rent free: Total,16,12,8,3,5,2,2,4,1,0,2,1,0
S01012898,Rented or living rent free: Social rented,4,3,2,2,0,0,1,1,0,0,0,1,0
S01012898,Rented or living rent free: Private rented or living rent free,12,9,6,1,5,2,1,3,1,0,2,0,0
S01012899,All HRPs aged 16 and over,317,176,139,30,109,16,21,141,96,0,3,33,9
S01012899,Owned: Total,99,67,61,13,48,5,1,32,32,0,0,0,0
S01012899,Owned: Owned outright,41,15,13,3,10,2,0,26,26,0,0,0,0
S01012899,Owned: Owned with a mortgage or loan or shared ownership,58,52,48,10,38,3,1,6,6,0,0,0,0
S01012899,Rented or living rent free: Total,218,109,78,17,61,11,20,109,64,0,3,33,9
S01012899,Rented or living rent free: Social rented,201,94,67,14,53,9,18,107,62,0,3,33,9
S01012899,Rented or living rent free: Private rented or living rent free,17,15,11,3,8,2,2,2,2,0,0,0,0
S01012900,All HRPs aged 16 and over,226,167,129,17,112,36,2,59,55,1,2,0,1
S01012900,Owned: Total,181,129,97,9,88,31,1,52,49,1,1,0,1
S01012900,Owned: Owned outright,89,47,32,5,27,14,1,42,41,1,0,0,0
S01012900,Owned: Owned with a mortgage or loan or shared ownership,92,82,65,4,61,17,0,10,8,0,1,0,1
S01012900,Rented or living rent free: Total,45,38,32,8,24,5,1,7,6,0,1,0,0
S01012900,Rented or living rent free: Social rented,10,8,8,0,8,0,0,2,2,0,0,0,0
S01012900,Rented or living rent free: Private rented or living rent free,35,30,24,8,16,5,1,5,4,0,1,0,0
S01012901,All HRPs aged 16 and over,336,228,190,26,164,21,17,108,82,6,5,8,7
S01012901,Owned: Total,246,170,149,16,133,18,3,76,69,3,0,2,2
S01012901,Owned: Owned outright,95,36,31,8,23,4,1,59,56,1,0,1,1
S01012901,Owned: Owned with a mortgage or loan or shared ownership,151,134,118,8,110,14,2,17,13,2,0,1,1
S01012901,Rented or living rent free: Total,90,58,41,10,31,3,14,32,13,3,5,6,5
S01012901,Rented or living rent free: Social rented,39,21,17,2,15,1,3,18,9,1,3,5,0
S01012901,Rented or living rent free: Private rented or living rent free,51,37,24,8,16,2,11,14,4,2,2,1,5
S01012902,All HRPs aged 16 and over,359,247,203,25,178,23,21,112,81,6,9,12,4
S01012902,Owned: Total,250,178,154,16,138,18,6,72,68,1,0,2,1
S01012902,Owned: Owned outright,91,31,24,8,16,5,2,60,58,1,0,0,1
S01012902,Owned: Owned with a mortgage or loan or shared ownership,159,147,130,8,122,13,4,12,10,0,0,2,0
S01012902,Rented or living rent free: Total,109,69,49,9,40,5,15,40,13,5,9,10,3
S01012902,Rented or living rent free: Social rented,69,39,26,6,20,1,12,30,10,5,4,9,2
S01012902,Rented or living rent free: Private rented or living rent free,40,30,23,3,20,4,3,10,3,0,5,1,1
S01012903,All HRPs aged 16 and over,400,266,216,34,182,26,24,134,96,5,6,23,4
S01012903,Owned: Total,282,194,163,24,139,24,7,88,79,0,1,7,1
S01012903,Owned: Owned outright,109,38,27,8,19,7,4,71,67,0,0,3,1
S01012903,Owned: Owned with a mortgage or loan or shared ownership,173,156,136,16,120,17,3,17,12,0,1,4,0
S01012903,Rented or living rent free: Total,118,72,53,10,43,2,17,46,17,5,5,16,3
S01012903,Rented or living rent free: Social rented,70,35,27,9,18,1,7,35,14,5,2,11,3
S01012903,Rented or living rent free: Private rented or living rent free,48,37,26,1,25,1,10,11,3,0,3,5,0
S01012904,All HRPs aged 16 and over,371,254,209,42,167,25,20,117,84,1,11,19,2
S01012904,Owned: Total,252,181,159,20,139,19,3,71,67,0,2,1,1
S01012904,Owned: Owned outright,92,34,24,5,19,9,1,58,57,0,1,0,0
S01012904,Owned: Owned with a mortgage or loan or shared ownership,160,147,135,15,120,10,2,13,10,0,1,1,1
S01012904,Rented or living rent free: Total,119,73,50,22,28,6,17,46,17,1,9,18,1
S01012904,Rented or living rent free: Social rented,70,37,27,13,14,2,8,33,14,1,6,12,0
S01012904,Rented or living rent free: Private rented or living rent free,49,36,23,9,14,4,9,13,3,0,3,6,1
S01012905,All HRPs aged 16 and over,272,189,152,25,127,19,18,83,44,3,12,17,7
S01012905,Owned: Total,120,83,73,5,68,9,1,37,34,0,1,1,1
S01012905,Owned: Owned outright,50,18,13,2,11,5,0,32,31,0,0,0,1
S01012905,Owned: Owned with a mortgage or loan or shared ownership,70,65,60,3,57,4,1,5,3,0,1,1,0
S01012905,Rented or living rent free: Total,152,106,79,20,59,10,17,46,10,3,11,16,6
S01012905,Rented or living rent free: Social rented,119,82,60,18,42,9,13,37,9,3,10,12,3
S01012905,Rented or living rent free: Private rented or living rent free,33,24,19,2,17,1,4,9,1,0,1,4,3
S01012906,All HRPs aged 16 and over,482,330,282,32,250,34,14,152,128,3,4,12,5
S01012906,Owned: Total,347,258,223,21,202,29,6,89,81,0,2,4,2
S01012906,Owned: Owned outright,107,45,37,8,29,5,3,62,61,0,0,0,1
S01012906,Owned: Owned with a mortgage or loan or shared ownership,240,213,186,13,173,24,3,27,20,0,2,4,1
S01012906,Rented or living rent free: Total,135,72,59,11,48,5,8,63,47,3,2,8,3
S01012906,Rented or living rent free: Social rented,73,20,15,4,11,3,2,53,41,3,0,6,3
S01012906,Rented or living rent free: Private rented or living rent free,62,52,44,7,37,2,6,10,6,0,2,2,0
S01012907,All HRPs aged 16 and over,449,251,214,34,180,25,12,198,159,6,6,26,1
S01012907,Owned: Total,304,185,159,20,139,23,3,119,113,3,2,1,0
S01012907,Owned: Owned outright,131,33,27,10,17,4,2,98,93,3,1,1,0
S01012907,Owned: Owned with a mortgage or loan or shared ownership,173,152,132,10,122,19,1,21,20,0,1,0,0
S01012907,Rented or living rent free: Total,145,66,55,14,41,2,9,79,46,3,4,25,1
S01012907,Rented or living rent free: Social rented,97,36,29,7,22,1,6,61,40,0,2,19,0
S01012907,Rented or living rent free: Private rented or living rent free,48,30,26,7,19,1,3,18,6,3,2,6,1
S01012908,All HRPs aged 16 and over,355,189,160,22,138,14,15,166,118,8,8,28,4
S01012908,Owned: Total,241,139,124,13,111,12,3,102,96,0,1,4,1
S01012908,Owned: Owned outright,109,28,26,7,19,1,1,81,77,0,0,3,1
S01012908,Owned: Owned with a mortgage or loan or shared ownership,132,111,98,6,92,11,2,21,19,0,1,1,0
S01012908,Rented or living rent free: Total,114,50,36,9,27,2,12,64,22,8,7,24,3
S01012908,Rented or living rent free: Social rented,83,29,23,8,15,0,6,54,17,8,4,22,3
S01012908,Rented or living rent free: Private rented or living rent free,31,21,13,1,12,2,6,10,5,0,3,2,0
S01012909,All HRPs aged 16 and over,331,187,166,19,147,9,12,144,124,0,4,11,5
S01012909,Owned: Total,199,130,120,10,110,7,3,69,64,0,0,3,2
S01012909,Owned: Owned outright,72,23,19,3,16,3,1,49,46,0,0,2,1
S01012909,Owned: Owned with a mortgage or loan or shared ownership,127,107,101,7,94,4,2,20,18,0,0,1,1
S01012909,Rented or living rent free: Total,132,57,46,9,37,2,9,75,60,0,4,8,3
S01012909,Rented or living rent free: Social rented,84,21,18,4,14,1,2,63,55,0,1,6,1
S01012909,Rented or living rent free: Private rented or living rent free,48,36,28,5,23,1,7,12,5,0,3,2,2
S01012910,All HRPs aged 16 and over,485,269,208,30,178,32,29,216,143,7,12,47,7
S01012910,Owned: Total,209,136,114,14,100,18,4,73,69,0,0,4,0
S01012910,Owned: Owned outright,95,31,23,8,15,5,3,64,63,0,0,1,0
S01012910,Owned: Owned with a mortgage or loan or shared ownership,114,105,91,6,85,13,1,9,6,0,0,3,0
S01012910,Rented or living rent free: Total,276,133,94,16,78,14,25,143,74,7,12,43,7
S01012910,Rented or living rent free: Social rented,245,115,80,13,67,12,23,130,70,6,7,40,7
S01012910,Rented or living rent free: Private rented or living rent free,31,18,14,3,11,2,2,13,4,1,5,3,0
S01012911,All HRPs aged 16 and over,340,197,171,31,140,20,6,143,119,4,5,14,1
S01012911,Owned: Total,270,159,139,28,111,19,1,111,102,2,2,4,1
S01012911,Owned: Owned outright,136,45,40,13,27,5,0,91,84,2,1,3,1
S01012911,Owned: Owned with a mortgage or loan or shared ownership,134,114,99,15,84,14,1,20,18,0,1,1,0
S01012911,Rented or living rent free: Total,70,38,32,3,29,1,5,32,17,2,3,10,0
S01012911,Rented or living rent free: Social rented,37,13,9,1,8,0,4,24,14,0,3,7,0
S01012911,Rented or living rent free: Private rented or living rent free,33,25,23,2,21,1,1,8,3,2,0,3,0
S01012912,All HRPs aged 16 and over,339,178,149,18,131,20,9,161,130,1,7,19,4
S01012912,Owned: Total,229,128,112,9,103,15,1,101,96,1,1,3,0
S01012912,Owned: Owned outright,120,31,26,3,23,4,1,89,85,1,0,3,0
S01012912,Owned: Owned with a mortgage or loan or shared ownership,109,97,86,6,80,11,0,12,11,0,1,0,0
S01012912,Rented or living rent free: Total,110,50,37,9,28,5,8,60,34,0,6,16,4
S01012912,Rented or living rent free: Social rented,77,27,20,7,13,4,3,50,32,0,3,13,2
S01012912,Rented or living rent free: Private rented or living rent free,33,23,17,2,15,1,5,10,2,0,3,3,2
S01012913,All HRPs aged 16 and over,417,238,201,35,166,22,15,179,148,3,5,18,5
S01012913,Owned: Total,311,183,158,19,139,19,6,128,112,2,2,9,3
S01012913,Owned: Owned outright,148,51,38,11,27,10,3,97,90,1,1,4,1
S01012913,Owned: Owned with a mortgage or loan or shared ownership,163,132,120,8,112,9,3,31,22,1,1,5,2
S01012913,Rented or living rent free: Total,106,55,43,16,27,3,9,51,36,1,3,9,2
S01012913,Rented or living rent free: Social rented,67,30,23,10,13,0,7,37,27,0,3,6,1
S01012913,Rented or living rent free: Private rented or living rent free,39,25,20,6,14,3,2,14,9,1,0,3,1
S01012914,All HRPs aged 16 and over,410,273,231,36,195,24,18,137,96,3,7,24,7
S01012914,Owned: Total,263,183,163,21,142,14,6,80,67,2,1,8,2
S01012914,Owned: Owned outright,97,39,32,6,26,4,3,58,56,0,0,1,1
S01012914,Owned: Owned with a mortgage or loan or shared ownership,166,144,131,15,116,10,3,22,11,2,1,7,1
S01012914,Rented or living rent free: Total,147,90,68,15,53,10,12,57,29,1,6,16,5
S01012914,Rented or living rent free: Social rented,68,32,26,8,18,2,4,36,19,0,6,11,0
S01012914,Rented or living rent free: Private rented or living rent free,79,58,42,7,35,8,8,21,10,1,0,5,5
S01012915,All HRPs aged 16 and over,447,333,279,33,246,34,20,114,95,1,3,9,6
S01012915,Owned: Total,308,258,225,15,210,26,7,50,47,0,0,1,2
S01012915,Owned: Owned outright,75,39,30,5,25,7,2,36,34,0,0,0,2
S01012915,Owned: Owned with a mortgage or loan or shared ownership,233,219,195,10,185,19,5,14,13,0,0,1,0
S01012915,Rented or living rent free: Total,139,75,54,18,36,8,13,64,48,1,3,8,4
S01012915,Rented or living rent free: Social rented,86,26,18,9,9,2,6,60,47,0,2,7,4
S01012915,Rented or living rent free: Private rented or living rent free,53,49,36,9,27,6,7,4,1,1,1,1,0
S01012916,All HRPs aged 16 and over,331,196,171,28,143,14,11,135,119,4,1,8,3
S01012916,Owned: Total,224,152,138,18,120,10,4,72,71,0,0,1,0
S01012916,Owned: Owned outright,109,42,36,8,28,4,2,67,66,0,0,1,0
S01012916,Owned: Owned with a mortgage or loan or shared ownership,115,110,102,10,92,6,2,5,5,0,0,0,0
S01012916,Rented or living rent free: Total,107,44,33,10,23,4,7,63,48,4,1,7,3
S01012916,Rented or living rent free: Social rented,76,18,13,7,6,3,2,58,45,4,0,7,2
S01012916,Rented or living rent free: Private rented or living rent free,31,26,20,3,17,1,5,5,3,0,1,0,1
S01012917,All HRPs aged 16 and over,270,181,142,22,120,36,3,89,85,0,2,1,1
S01012917,Owned: Total,247,161,125,14,111,34,2,86,83,0,2,1,0
S01012917,Owned: Owned outright,120,42,29,11,18,11,2,78,75,0,2,1,0
S01012917,Owned: Owned with a mortgage or loan or shared ownership,127,119,96,3,93,23,0,8,8,0,0,0,0
S01012917,Rented or living rent free: Total,23,20,17,8,9,2,1,3,2,0,0,0,1
S01012917,Rented or living rent free: Social rented,10,8,7,4,3,1,0,2,2,0,0,0,0
S01012917,Rented or living rent free: Private rented or living rent free,13,12,10,4,6,1,1,1,0,0,0,0,1
S01012918,All HRPs aged 16 and over,255,162,140,17,123,12,10,93,78,1,2,9,3
S01012918,Owned: Total,170,107,96,8,88,8,3,63,60,0,0,2,1
S01012918,Owned: Owned outright,79,28,24,3,21,2,2,51,50,0,0,0,1
S01012918,Owned: Owned with a mortgage or loan or shared ownership,91,79,72,5,67,6,1,12,10,0,0,2,0
S01012918,Rented or living rent free: Total,85,55,44,9,35,4,7,30,18,1,2,7,2
S01012918,Rented or living rent free: Social rented,35,14,10,4,6,2,2,21,13,1,1,5,1
S01012918,Rented or living rent free: Private rented or living rent free,50,41,34,5,29,2,5,9,5,0,1,2,1
S01012919,All HRPs aged 16 and over,229,118,102,16,86,10,6,111,96,1,1,9,4
S01012919,Owned: Total,178,89,81,10,71,8,0,89,84,0,0,3,2
S01012919,Owned: Owned outright,99,22,21,5,16,1,0,77,73,0,0,2,2
S01012919,Owned: Owned with a mortgage or loan or shared ownership,79,67,60,5,55,7,0,12,11,0,0,1,0
S01012919,Rented or living rent free: Total,51,29,21,6,15,2,6,22,12,1,1,6,2
S01012919,Rented or living rent free: Social rented,33,13,9,3,6,0,4,20,11,1,0,6,2
S01012919,Rented or living rent free: Private rented or living rent free,18,16,12,3,9,2,2,2,1,0,1,0,0
S01012920,All HRPs aged 16 and over,258,140,108,13,95,28,4,118,115,0,0,1,2
S01012920,Owned: Total,248,136,105,13,92,27,4,112,110,0,0,1,1
S01012920,Owned: Owned outright,141,47,34,7,27,13,0,94,94,0,0,0,0
S01012920,Owned: Owned with a mortgage or loan or shared ownership,107,89,71,6,65,14,4,18,16,0,0,1,1
S01012920,Rented or living rent free: Total,10,4,3,0,3,1,0,6,5,0,0,0,1
S01012920,Rented or living rent free: Social rented,2,1,1,0,1,0,0,1,1,0,0,0,0
S01012920,Rented or living rent free: Private rented or living rent free,8,3,2,0,2,1,0,5,4,0,0,0,1
S01012921,All HRPs aged 16 and over,338,213,188,38,150,13,12,125,103,1,5,13,3
S01012921,Owned: Total,253,159,148,26,122,11,0,94,86,1,2,3,2
S01012921,Owned: Owned outright,96,30,28,10,18,2,0,66,65,0,0,0,1
S01012921,Owned: Owned with a mortgage or loan or shared ownership,157,129,120,16,104,9,0,28,21,1,2,3,1
S01012921,Rented or living rent free: Total,85,54,40,12,28,2,12,31,17,0,3,10,1
S01012921,Rented or living rent free: Social rented,43,19,15,3,12,0,4,24,12,0,2,9,1
S01012921,Rented or living rent free: Private rented or living rent free,42,35,25,9,16,2,8,7,5,0,1,1,0
S01012922,All HRPs aged 16 and over,437,304,260,36,224,27,17,133,100,3,3,21,6
S01012922,Owned: Total,328,236,211,21,190,21,4,92,88,0,0,3,1
S01012922,Owned: Owned outright,107,35,33,7,26,2,0,72,72,0,0,0,0
S01012922,Owned: Owned with a mortgage or loan or shared ownership,221,201,178,14,164,19,4,20,16,0,0,3,1
S01012922,Rented or living rent free: Total,109,68,49,15,34,6,13,41,12,3,3,18,5
S01012922,Rented or living rent free: Social rented,60,31,23,9,14,4,4,29,10,1,2,13,3
S01012922,Rented or living rent free: Private rented or living rent free,49,37,26,6,20,2,9,12,2,2,1,5,2
S01012923,All HRPs aged 16 and over,306,206,171,30,141,25,10,100,85,0,3,9,3
S01012923,Owned: Total,239,162,139,19,120,21,2,77,73,0,1,1,2
S01012923,Owned: Owned outright,96,26,22,3,19,3,1,70,67,0,0,1,2
S01012923,Owned: Owned with a mortgage or loan or shared ownership,143,136,117,16,101,18,1,7,6,0,1,0,0
S01012923,Rented or living rent free: Total,67,44,32,11,21,4,8,23,12,0,2,8,1
S01012923,Rented or living rent free: Social rented,31,14,9,2,7,1,4,17,11,0,1,5,0
S01012923,Rented or living rent free: Private rented or living rent free,36,30,23,9,14,3,4,6,1,0,1,3,1
S01012924,All HRPs aged 16 and over,243,175,146,23,123,19,10,68,47,1,1,17,2
S01012924,Owned: Total,169,133,113,15,98,18,2,36,33,0,0,3,0
S01012924,Owned: Owned outright,55,23,22,4,18,1,0,32,31,0,0,1,0
S01012924,Owned: Owned with a mortgage or loan or shared ownership,114,110,91,11,80,17,2,4,2,0,0,2,0
S01012924,Rented or living rent free: Total,74,42,33,8,25,1,8,32,14,1,1,14,2
S01012924,Rented or living rent free: Social rented,31,11,7,3,4,0,4,20,9,0,0,10,1
S01012924,Rented or living rent free: Private rented or living rent free,43,31,26,5,21,1,4,12,5,1,1,4,1
S01012925,All HRPs aged 16 and over,194,133,114,14,100,16,3,61,53,5,1,1,1
S01012925,Owned: Total,169,117,101,10,91,16,0,52,51,1,0,0,0
S01012925,Owned: Owned outright,76,26,22,8,14,4,0,50,49,1,0,0,0
S01012925,Owned: Owned with a mortgage or loan or shared ownership,93,91,79,2,77,12,0,2,2,0,0,0,0
S01012925,Rented or living rent free: Total,25,16,13,4,9,0,3,9,2,4,1,1,1
S01012925,Rented or living rent free: Social rented,8,3,3,1,2,0,0,5,2,2,0,1,0
S01012925,Rented or living rent free: Private rented or living rent free,17,13,10,3,7,0,3,4,0,2,1,0,1
S01012926,All HRPs aged 16 and over,333,240,198,27,171,30,12,93,72,2,2,14,3
S01012926,Owned: Total,247,179,149,16,133,25,5,68,64,0,0,2,2
S01012926,Owned: Owned outright,113,56,39,10,29,13,4,57,57,0,0,0,0
S01012926,Owned: Owned with a mortgage or loan or shared ownership,134,123,110,6,104,12,1,11,7,0,0,2,2
S01012926,Rented or living rent free: Total,86,61,49,11,38,5,7,25,8,2,2,12,1
S01012926,Rented or living rent free: Social rented,37,19,15,5,10,3,1,18,6,2,1,8,1
S01012926,Rented or living rent free: Private rented or living rent free,49,42,34,6,28,2,6,7,2,0,1,4,0
S01012927,All HRPs aged 16 and over,339,233,199,30,169,25,9,106,87,1,5,13,0
S01012927,Owned: Total,251,177,156,18,138,17,4,74,71,0,1,2,0
S01012927,Owned: Owned outright,103,41,37,7,30,3,1,62,62,0,0,0,0
S01012927,Owned: Owned with a mortgage or loan or shared ownership,148,136,119,11,108,14,3,12,9,0,1,2,0
S01012927,Rented or living rent free: Total,88,56,43,12,31,8,5,32,16,1,4,11,0
S01012927,Rented or living rent free: Social rented,44,19,14,4,10,4,1,25,12,1,4,8,0
S01012927,Rented or living rent free: Private rented or living rent free,44,37,29,8,21,4,4,7,4,0,0,3,0
S01012928,All HRPs aged 16 and over,353,219,183,30,153,28,8,134,122,3,1,8,0
S01012928,Owned: Total,301,186,158,21,137,26,2,115,112,2,0,1,0
S01012928,Owned: Owned outright,143,42,33,8,25,8,1,101,100,0,0,1,0
S01012928,Owned: Owned with a mortgage or loan or shared ownership,158,144,125,13,112,18,1,14,12,2,0,0,0
S01012928,Rented or living rent free: Total,52,33,25,9,16,2,6,19,10,1,1,7,0
S01012928,Rented or living rent free: Social rented,22,8,6,2,4,0,2,14,8,1,1,4,0
S01012928,Rented or living rent free: Private rented or living rent free,30,25,19,7,12,2,4,5,2,0,0,3,0
S01012929,All HRPs aged 16 and over,340,204,179,36,143,18,7,136,126,2,0,5,3
S01012929,Owned: Total,287,173,154,26,128,16,3,114,112,0,0,1,1
S01012929,Owned: Owned outright,141,47,40,12,28,7,0,94,93,0,0,1,0
S01012929,Owned: Owned with a mortgage or loan or shared ownership,146,126,114,14,100,9,3,20,19,0,0,0,1
S01012929,Rented or living rent free: Total,53,31,25,10,15,2,4,22,14,2,0,4,2
S01012929,Rented or living rent free: Social rented,27,11,7,1,6,0,4,16,11,1,0,3,1
S01012929,Rented or living rent free: Private rented or living rent free,26,20,18,9,9,2,0,6,3,1,0,1,1
S01012930,All HRPs aged 16 and over,512,273,221,34,187,35,17,239,208,1,0,21,9
S01012930,Owned: Total,282,160,131,20,111,23,6,122,114,0,0,7,1
S01012930,Owned: Owned outright,146,41,32,11,21,6,3,105,102,0,0,2,1
S01012930,Owned: Owned with a mortgage or loan or shared ownership,136,119,99,9,90,17,3,17,12,0,0,5,0
S01012930,Rented or living rent free: Total,230,113,90,14,76,12,11,117,94,1,0,14,8
S01012930,Rented or living rent free: Social rented,125,35,25,7,18,4,6,90,79,0,0,8,3
S01012930,Rented or living rent free: Private rented or living rent free,105,78,65,7,58,8,5,27,15,1,0,6,5
S01012931,All HRPs aged 16 and over,435,266,235,49,186,20,11,169,133,0,7,17,12
S01012931,Owned: Total,277,169,157,21,136,12,0,108,101,0,0,5,2
S01012931,Owned: Owned outright,112,25,23,4,19,2,0,87,81,0,0,4,2
S01012931,Owned: Owned with a mortgage or loan or shared ownership,165,144,134,17,117,10,0,21,20,0,0,1,0
S01012931,Rented or living rent free: Total,158,97,78,28,50,8,11,61,32,0,7,12,10
S01012931,Rented or living rent free: Social rented,95,49,43,21,22,0,6,46,28,0,2,10,6
S01012931,Rented or living rent free: Private rented or living rent free,63,48,35,7,28,8,5,15,4,0,5,2,4
S01012932,All HRPs aged 16 and over,211,145,107,18,89,34,4,66,57,3,1,2,3
S01012932,Owned: Total,174,128,93,11,82,34,1,46,44,2,0,0,0
S01012932,Owned: Owned outright,78,34,22,7,15,12,0,44,42,2,0,0,0
S01012932,Owned: Owned with a mortgage or loan or shared ownership,96,94,71,4,67,22,1,2,2,0,0,0,0
S01012932,Rented or living rent free: Total,37,17,14,7,7,0,3,20,13,1,1,2,3
S01012932,Rented or living rent free: Social rented,24,9,8,5,3,0,1,15,11,0,0,2,2
S01012932,Rented or living rent free: Private rented or living rent free,13,8,6,2,4,0,2,5,2,1,1,0,1
S01012933,All HRPs aged 16 and over,352,219,189,29,160,23,7,133,106,1,5,17,4
S01012933,Owned: Total,265,174,150,16,134,21,3,91,85,1,0,4,1
S01012933,Owned: Owned outright,110,36,27,4,23,8,1,74,70,0,0,3,1
S01012933,Owned: Owned with a mortgage or loan or shared ownership,155,138,123,12,111,13,2,17,15,1,0,1,0
S01012933,Rented or living rent free: Total,87,45,39,13,26,2,4,42,21,0,5,13,3
S01012933,Rented or living rent free: Social rented,61,24,22,10,12,0,2,37,17,0,4,13,3
S01012933,Rented or living rent free: Private rented or living rent free,26,21,17,3,14,2,2,5,4,0,1,0,0
S01012934,All HRPs aged 16 and over,360,186,156,30,126,20,10,174,137,1,6,24,6
S01012934,Owned: Total,235,121,97,14,83,19,5,114,107,1,0,4,2
S01012934,Owned: Owned outright,110,26,19,5,14,5,2,84,82,0,0,2,0
S01012934,Owned: Owned with a mortgage or loan or shared ownership,125,95,78,9,69,14,3,30,25,1,0,2,2
S01012934,Rented or living rent free: Total,125,65,59,16,43,1,5,60,30,0,6,20,4
S01012934,Rented or living rent free: Social rented,75,29,26,12,14,0,3,46,25,0,3,15,3
S01012934,Rented or living rent free: Private rented or living rent free,50,36,33,4,29,1,2,14,5,0,3,5,1
S01012935,All HRPs aged 16 and over,363,230,193,27,166,23,14,133,121,1,2,6,3
S01012935,Owned: Total,280,177,153,16,137,21,3,103,100,0,1,2,0
S01012935,Owned: Owned outright,130,45,37,6,31,5,3,85,84,0,1,0,0
S01012935,Owned: Owned with a mortgage or loan or shared ownership,150,132,116,10,106,16,0,18,16,0,0,2,0
S01012935,Rented or living rent free: Total,83,53,40,11,29,2,11,30,21,1,1,4,3
S01012935,Rented or living rent free: Social rented,57,31,22,6,16,1,8,26,19,0,1,4,2
S01012935,Rented or living rent free: Private rented or living rent free,26,22,18,5,13,1,3,4,2,1,0,0,1
S01012936,All HRPs aged 16 and over,351,219,180,34,146,30,9,132,109,1,5,13,4
S01012936,Owned: Total,240,153,135,17,118,17,1,87,84,0,0,2,1
S01012936,Owned: Owned outright,98,27,22,6,16,5,0,71,70,0,0,1,0
S01012936,Owned: Owned with a mortgage or loan or shared ownership,142,126,113,11,102,12,1,16,14,0,0,1,1
S01012936,Rented or living rent free: Total,111,66,45,17,28,13,8,45,25,1,5,11,3
S01012936,Rented or living rent free: Social rented,66,31,20,11,9,6,5,35,19,0,5,9,2
S01012936,Rented or living rent free: Private rented or living rent free,45,35,25,6,19,7,3,10,6,1,0,2,1
S01012937,All HRPs aged 16 and over,314,219,189,26,163,12,18,95,77,1,9,6,2
S01012937,Owned: Total,226,161,145,12,133,11,5,65,59,0,3,2,1
S01012937,Owned: Owned outright,83,34,30,3,27,0,4,49,47,0,1,1,0
S01012937,Owned: Owned with a mortgage or loan or shared ownership,143,127,115,9,106,11,1,16,12,0,2,1,1
S01012937,Rented or living rent free: Total,88,58,44,14,30,1,13,30,18,1,6,4,1
S01012937,Rented or living rent free: Social rented,49,29,20,9,11,0,9,20,13,0,4,3,0
S01012937,Rented or living rent free: Private rented or living rent free,39,29,24,5,19,1,4,10,5,1,2,1,1
S01012938,All HRPs aged 16 and over,307,178,137,13,124,36,5,129,126,1,0,2,0
S01012938,Owned: Total,254,163,126,10,116,35,2,91,88,1,0,2,0
S01012938,Owned: Owned outright,121,47,35,4,31,11,1,74,71,1,0,2,0
S01012938,Owned: Owned with a mortgage or loan or shared ownership,133,116,91,6,85,24,1,17,17,0,0,0,0
S01012938,Rented or living rent free: Total,53,15,11,3,8,1,3,38,38,0,0,0,0
S01012938,Rented or living rent free: Social rented,40,4,2,1,1,0,2,36,36,0,0,0,0
S01012938,Rented or living rent free: Private rented or living rent free,13,11,9,2,7,1,1,2,2,0,0,0,0
S01012939,All HRPs aged 16 and over,216,169,144,16,128,23,2,47,45,0,0,2,0
S01012939,Owned: Total,205,160,139,14,125,19,2,45,45,0,0,0,0
S01012939,Owned: Owned outright,73,33,28,7,21,5,0,40,40,0,0,0,0
S01012939,Owned: Owned with a mortgage or loan or shared ownership,132,127,111,7,104,14,2,5,5,0,0,0,0
S01012939,Rented or living rent free: Total,11,9,5,2,3,4,0,2,0,0,0,2,0
S01012939,Rented or living rent free: Social rented,3,1,1,0,1,0,0,2,0,0,0,2,0
S01012939,Rented or living rent free: Private rented or living rent free,8,8,4,2,2,4,0,0,0,0,0,0,0
S01012940,All HRPs aged 16 and over,268,210,174,18,156,34,2,58,52,0,1,4,1
S01012940,Owned: Total,252,196,161,16,145,33,2,56,51,0,1,4,0
S01012940,Owned: Owned outright,87,43,41,10,31,2,0,44,43,0,0,1,0
S01012940,Owned: Owned with a mortgage or loan or shared ownership,165,153,120,6,114,31,2,12,8,0,1,3,0
S01012940,Rented or living rent free: Total,16,14,13,2,11,1,0,2,1,0,0,0,1
S01012940,Rented or living rent free: Social rented,2,1,1,1,0,0,0,1,0,0,0,0,1
S01012940,Rented or living rent free: Private rented or living rent free,14,13,12,1,11,1,0,1,1,0,0,0,0
S01012941,All HRPs aged 16 and over,257,224,178,9,169,42,4,33,29,0,2,2,0
S01012941,Owned: Total,249,218,175,9,166,40,3,31,29,0,1,1,0
S01012941,Owned: Owned outright,92,65,48,6,42,15,2,27,25,0,1,1,0
S01012941,Owned: Owned with a mortgage or loan or shared ownership,157,153,127,3,124,25,1,4,4,0,0,0,0
S01012941,Rented or living rent free: Total,8,6,3,0,3,2,1,2,0,0,1,1,0
S01012941,Rented or living rent free: Social rented,3,2,0,0,0,1,1,1,0,0,0,1,0
S01012941,Rented or living rent free: Private rented or living rent free,5,4,3,0,3,1,0,1,0,0,1,0,0
S01012942,All HRPs aged 16 and over,364,231,198,41,157,15,18,133,92,6,11,20,4
S01012942,Owned: Total,204,152,136,22,114,11,5,52,47,1,1,1,2
S01012942,Owned: Owned outright,67,26,21,7,14,3,2,41,40,0,0,1,0
S01012942,Owned: Owned with a mortgage or loan or shared ownership,137,126,115,15,100,8,3,11,7,1,1,0,2
S01012942,Rented or living rent free: Total,160,79,62,19,43,4,13,81,45,5,10,19,2
S01012942,Rented or living rent free: Social rented,111,40,27,11,16,2,11,71,43,3,6,17,2
S01012942,Rented or living rent free: Private rented or living rent free,49,39,35,8,27,2,2,10,2,2,4,2,0
S01012943,All HRPs aged 16 and over,291,219,193,23,170,23,3,72,59,0,3,9,1
S01012943,Owned: Total,253,196,172,18,154,22,2,57,54,0,1,2,0
S01012943,Owned: Owned outright,81,32,25,1,24,6,1,49,48,0,1,0,0
S01012943,Owned: Owned with a mortgage or loan or shared ownership,172,164,147,17,130,16,1,8,6,0,0,2,0
S01012943,Rented or living rent free: Total,38,23,21,5,16,1,1,15,5,0,2,7,1
S01012943,Rented or living rent free: Social rented,18,7,5,2,3,1,1,11,2,0,1,7,1
S01012943,Rented or living rent free: Private rented or living rent free,20,16,16,3,13,0,0,4,3,0,1,0,0
S01012944,All HRPs aged 16 and over,207,145,124,11,113,19,2,62,56,1,0,2,3
S01012944,Owned: Total,198,140,120,10,110,18,2,58,54,1,0,0,3
S01012944,Owned: Owned outright,73,25,21,4,17,4,0,48,46,0,0,0,2
S01012944,Owned: Owned with a mortgage or loan or shared ownership,125,115,99,6,93,14,2,10,8,1,0,0,1
S01012944,Rented or living rent free: Total,9,5,4,1,3,1,0,4,2,0,0,2,0
S01012944,Rented or living rent free: Social rented,1,0,0,0,0,0,0,1,0,0,0,1,0
S01012944,Rented or living rent free: Private rented or living rent free,8,5,4,1,3,1,0,3,2,0,0,1,0
S01012945,All HRPs aged 16 and over,241,213,170,14,156,41,2,28,24,0,1,3,0
S01012945,Owned: Total,232,208,165,14,151,41,2,24,23,0,0,1,0
S01012945,Owned: Owned outright,62,42,33,6,27,8,1,20,20,0,0,0,0
S01012945,Owned: Owned with a mortgage or loan or shared ownership,170,166,132,8,124,33,1,4,3,0,0,1,0
S01012945,Rented or living rent free: Total,9,5,5,0,5,0,0,4,1,0,1,2,0
S01012945,Rented or living rent free: Social rented,4,1,1,0,1,0,0,3,1,0,0,2,0
S01012945,Rented or living rent free: Private rented or living rent free,5,4,4,0,4,0,0,1,0,0,1,0,0
S01012946,All HRPs aged 16 and over,338,275,236,23,213,34,5,63,53,3,0,4,3
S01012946,Owned: Total,282,229,196,18,178,29,4,53,49,2,0,0,2
S01012946,Owned: Owned outright,88,42,34,4,30,6,2,46,44,0,0,0,2
S01012946,Owned: Owned with a mortgage or loan or shared ownership,194,187,162,14,148,23,2,7,5,2,0,0,0
S01012946,Rented or living rent free: Total,56,46,40,5,35,5,1,10,4,1,0,4,1
S01012946,Rented or living rent free: Social rented,3,0,0,0,0,0,0,3,2,0,0,1,0
S01012946,Rented or living rent free: Private rented or living rent free,53,46,40,5,35,5,1,7,2,1,0,3,1
S01012947,All HRPs aged 16 and over,151,127,95,11,84,30,2,24,22,1,1,0,0
S01012947,Owned: Total,147,124,92,9,83,30,2,23,22,1,0,0,0
S01012947,Owned: Owned outright,51,32,25,4,21,5,2,19,18,1,0,0,0
S01012947,Owned: Owned with a mortgage or loan or shared ownership,96,92,67,5,62,25,0,4,4,0,0,0,0
S01012947,Rented or living rent free: Total,4,3,3,2,1,0,0,1,0,0,1,0,0
S01012947,Rented or living rent free: Social rented,2,1,1,1,0,0,0,1,0,0,1,0,0
S01012947,Rented or living rent free: Private rented or living rent free,2,2,2,1,1,0,0,0,0,0,0,0,0
S01012948,All HRPs aged 16 and over,249,198,161,26,135,36,1,51,46,0,2,3,0
S01012948,Owned: Total,240,193,156,26,130,36,1,47,45,0,1,1,0
S01012948,Owned: Owned outright,94,49,40,15,25,9,0,45,43,0,1,1,0
S01012948,Owned: Owned with a mortgage or loan or shared ownership,146,144,116,11,105,27,1,2,2,0,0,0,0
S01012948,Rented or living rent free: Total,9,5,5,0,5,0,0,4,1,0,1,2,0
S01012948,Rented or living rent free: Social rented,6,3,3,0,3,0,0,3,0,0,1,2,0
S01012948,Rented or living rent free: Private rented or living rent free,3,2,2,0,2,0,0,1,1,0,0,0,0
S01012949,All HRPs aged 16 and over,282,211,173,23,150,37,1,71,63,0,1,4,3
S01012949,Owned: Total,257,193,159,21,138,33,1,64,59,0,0,2,3
S01012949,Owned: Owned outright,109,60,46,9,37,13,1,49,45,0,0,2,2
S01012949,Owned: Owned with a mortgage or loan or shared ownership,148,133,113,12,101,20,0,15,14,0,0,0,1
S01012949,Rented or living rent free: Total,25,18,14,2,12,4,0,7,4,0,1,2,0
S01012949,Rented or living rent free: Social rented,5,3,2,1,1,1,0,2,0,0,1,1,0
S01012949,Rented or living rent free: Private rented or living rent free,20,15,12,1,11,3,0,5,4,0,0,1,0
S01012950,All HRPs aged 16 and over,273,242,206,9,197,34,2,31,27,0,3,1,0
S01012950,Owned: Total,255,230,196,8,188,34,0,25,24,0,1,0,0
S01012950,Owned: Owned outright,55,33,28,3,25,5,0,22,21,0,1,0,0
S01012950,Owned: Owned with a mortgage or loan or shared ownership,200,197,168,5,163,29,0,3,3,0,0,0,0
S01012950,Rented or living rent free: Total,18,12,10,1,9,0,2,6,3,0,2,1,0
S01012950,Rented or living rent free: Social rented,4,3,1,0,1,0,2,1,0,0,0,1,0
S01012950,Rented or living rent free: Private rented or living rent free,14,9,9,1,8,0,0,5,3,0,2,0,0
S01012951,All HRPs aged 16 and over,294,281,231,15,216,47,3,13,6,0,2,3,2
S01012951,Owned: Total,280,272,223,15,208,46,3,8,6,0,0,1,1
S01012951,Owned: Owned outright,46,38,31,7,24,7,0,8,6,0,0,1,1
S01012951,Owned: Owned with a mortgage or loan or shared ownership,234,234,192,8,184,39,3,0,0,0,0,0,0
S01012951,Rented or living rent free: Total,14,9,8,0,8,1,0,5,0,0,2,2,1
S01012951,Rented or living rent free: Social rented,2,1,1,0,1,0,0,1,0,0,0,0,1
S01012951,Rented or living rent free: Private rented or living rent free,12,8,7,0,7,1,0,4,0,0,2,2,0
S01012952,All HRPs aged 16 and over,247,164,94,11,83,70,0,83,75,3,1,3,1
S01012952,Owned: Total,234,155,86,11,75,69,0,79,72,3,1,3,0
S01012952,Owned: Owned outright,135,63,31,7,24,32,0,72,67,2,1,2,0
S01012952,Owned: Owned with a mortgage or loan or shared ownership,99,92,55,4,51,37,0,7,5,1,0,1,0
S01012952,Rented or living rent free: Total,13,9,8,0,8,1,0,4,3,0,0,0,1
S01012952,Rented or living rent free: Social rented,4,3,3,0,3,0,0,1,1,0,0,0,0
S01012952,Rented or living rent free: Private rented or living rent free,9,6,5,0,5,1,0,3,2,0,0,0,1
S01012953,All HRPs aged 16 and over,292,223,196,23,173,24,3,69,52,0,7,6,4
S01012953,Owned: Total,266,206,182,21,161,23,1,60,51,0,3,3,3
S01012953,Owned: Owned outright,100,55,47,11,36,8,0,45,39,0,2,1,3
S01012953,Owned: Owned with a mortgage or loan or shared ownership,166,151,135,10,125,15,1,15,12,0,1,2,0
S01012953,Rented or living rent free: Total,26,17,14,2,12,1,2,9,1,0,4,3,1
S01012953,Rented or living rent free: Social rented,3,0,0,0,0,0,0,3,1,0,1,0,1
S01012953,Rented or living rent free: Private rented or living rent free,23,17,14,2,12,1,2,6,0,0,3,3,0
S01012954,All HRPs aged 16 and over,173,142,122,18,104,18,2,31,29,0,0,1,1
S01012954,Owned: Total,162,133,116,16,100,17,0,29,28,0,0,0,1
S01012954,Owned: Owned outright,52,29,27,6,21,2,0,23,22,0,0,0,1
S01012954,Owned: Owned with a mortgage or loan or shared ownership,110,104,89,10,79,15,0,6,6,0,0,0,0
S01012954,Rented or living rent free: Total,11,9,6,2,4,1,2,2,1,0,0,1,0
S01012954,Rented or living rent free: Social rented,2,1,0,0,0,1,0,1,0,0,0,1,0
S01012954,Rented or living rent free: Private rented or living rent free,9,8,6,2,4,0,2,1,1,0,0,0,0
S01012955,All HRPs aged 16 and over,356,276,237,17,220,33,6,80,67,3,5,4,1
S01012955,Owned: Total,278,213,185,14,171,24,4,65,61,1,1,2,0
S01012955,Owned: Owned outright,92,38,33,6,27,2,3,54,53,0,0,1,0
S01012955,Owned: Owned with a mortgage or loan or shared ownership,186,175,152,8,144,22,1,11,8,1,1,1,0
S01012955,Rented or living rent free: Total,78,63,52,3,49,9,2,15,6,2,4,2,1
S01012955,Rented or living rent free: Social rented,12,6,5,1,4,0,1,6,2,0,1,2,1
S01012955,Rented or living rent free: Private rented or living rent free,66,57,47,2,45,9,1,9,4,2,3,0,0
S01012956,All HRPs aged 16 and over,458,246,201,38,163,24,21,212,164,2,7,31,8
S01012956,Owned: Total,303,178,154,24,130,21,3,125,115,1,2,3,4
S01012956,Owned: Owned outright,133,37,31,9,22,6,0,96,93,1,0,1,1
S01012956,Owned: Owned with a mortgage or loan or shared ownership,170,141,123,15,108,15,3,29,22,0,2,2,3
S01012956,Rented or living rent free: Total,155,68,47,14,33,3,18,87,49,1,5,28,4
S01012956,Rented or living rent free: Social rented,115,38,23,8,15,2,13,77,45,1,2,26,3
S01012956,Rented or living rent free: Private rented or living rent free,40,30,24,6,18,1,5,10,4,0,3,2,1
S01012957,All HRPs aged 16 and over,304,188,149,25,124,26,13,116,94,3,2,15,2
S01012957,Owned: Total,200,134,108,15,93,23,3,66,60,2,1,2,1
S01012957,Owned: Owned outright,86,32,21,7,14,8,3,54,53,0,0,1,0
S01012957,Owned: Owned with a mortgage or loan or shared ownership,114,102,87,8,79,15,0,12,7,2,1,1,1
S01012957,Rented or living rent free: Total,104,54,41,10,31,3,10,50,34,1,1,13,1
S01012957,Rented or living rent free: Social rented,79,33,24,6,18,1,8,46,31,0,1,13,1
S01012957,Rented or living rent free: Private rented or living rent free,25,21,17,4,13,2,2,4,3,1,0,0,0
S01012958,All HRPs aged 16 and over,206,152,126,24,102,23,3,54,43,1,6,4,0
S01012958,Owned: Total,161,128,105,18,87,20,3,33,31,0,2,0,0
S01012958,Owned: Owned outright,44,21,17,9,8,4,0,23,22,0,1,0,0
S01012958,Owned: Owned with a mortgage or loan or shared ownership,117,107,88,9,79,16,3,10,9,0,1,0,0
S01012958,Rented or living rent free: Total,45,24,21,6,15,3,0,21,12,1,4,4,0
S01012958,Rented or living rent free: Social rented,31,17,15,5,10,2,0,14,8,0,2,4,0
S01012958,Rented or living rent free: Private rented or living rent free,14,7,6,1,5,1,0,7,4,1,2,0,0
S01012959,All HRPs aged 16 and over,228,193,167,27,140,22,4,35,25,1,4,3,2
S01012959,Owned: Total,202,176,152,22,130,21,3,26,23,0,1,1,1
S01012959,Owned: Owned outright,36,20,17,3,14,3,0,16,15,0,0,1,0
S01012959,Owned: Owned with a mortgage or loan or shared ownership,166,156,135,19,116,18,3,10,8,0,1,0,1
S01012959,Rented or living rent free: Total,26,17,15,5,10,1,1,9,2,1,3,2,1
S01012959,Rented or living rent free: Social rented,12,8,6,1,5,1,1,4,1,0,1,1,1
S01012959,Rented or living rent free: Private rented or living rent free,14,9,9,4,5,0,0,5,1,1,2,1,0
S01012960,All HRPs aged 16 and over,229,166,141,22,119,20,5,63,45,1,7,7,3
S01012960,Owned: Total,161,122,103,11,92,17,2,39,36,1,0,1,1
S01012960,Owned: Owned outright,51,24,17,3,14,7,0,27,27,0,0,0,0
S01012960,Owned: Owned with a mortgage or loan or shared ownership,110,98,86,8,78,10,2,12,9,1,0,1,1
S01012960,Rented or living rent free: Total,68,44,38,11,27,3,3,24,9,0,7,6,2
S01012960,Rented or living rent free: Social rented,66,42,36,11,25,3,3,24,9,0,7,6,2
S01012960,Rented or living rent free: Private rented or living rent free,2,2,2,0,2,0,0,0,0,0,0,0,0
S01012961,All HRPs aged 16 and over,200,158,129,14,115,27,2,42,35,0,4,2,1
S01012961,Owned: Total,188,151,122,10,112,27,2,37,32,0,3,1,1
S01012961,Owned: Owned outright,63,39,28,5,23,10,1,24,23,0,0,0,1
S01012961,Owned: Owned with a mortgage or loan or shared ownership,125,112,94,5,89,17,1,13,9,0,3,1,0
S01012961,Rented or living rent free: Total,12,7,7,4,3,0,0,5,3,0,1,1,0
S01012961,Rented or living rent free: Social rented,3,0,0,0,0,0,0,3,2,0,0,1,0
S01012961,Rented or living rent free: Private rented or living rent free,9,7,7,4,3,0,0,2,1,0,1,0,0
S01012962,All HRPs aged 16 and over,236,173,145,23,122,27,1,63,62,0,1,0,0
S01012962,Owned: Total,223,162,136,21,115,26,0,61,60,0,1,0,0
S01012962,Owned: Owned outright,97,45,41,10,31,4,0,52,51,0,1,0,0
S01012962,Owned: Owned with a mortgage or loan or shared ownership,126,117,95,11,84,22,0,9,9,0,0,0,0
S01012962,Rented or living rent free: Total,13,11,9,2,7,1,1,2,2,0,0,0,0
S01012962,Rented or living rent free: Social rented,2,1,1,0,1,0,0,1,1,0,0,0,0
S01012962,Rented or living rent free: Private rented or living rent free,11,10,8,2,6,1,1,1,1,0,0,0,0
S01012963,All HRPs aged 16 and over,275,240,206,17,189,33,1,35,31,0,0,2,2
S01012963,Owned: Total,259,229,198,15,183,30,1,30,28,0,0,0,2
S01012963,Owned: Owned outright,53,35,29,8,21,6,0,18,17,0,0,0,1
S01012963,Owned: Owned with a mortgage or loan or shared ownership,206,194,169,7,162,24,1,12,11,0,0,0,1
S01012963,Rented or living rent free: Total,16,11,8,2,6,3,0,5,3,0,0,2,0
S01012963,Rented or living rent free: Social rented,5,3,2,0,2,1,0,2,0,0,0,2,0
S01012963,Rented or living rent free: Private rented or living rent free,11,8,6,2,4,2,0,3,3,0,0,0,0
S01012964,All HRPs aged 16 and over,200,189,157,16,141,30,2,11,9,0,2,0,0
S01012964,Owned: Total,186,178,147,12,135,29,2,8,7,0,1,0,0
S01012964,Owned: Owned outright,24,19,17,4,13,2,0,5,4,0,1,0,0
S01012964,Owned: Owned with a mortgage or loan or shared ownership,162,159,130,8,122,27,2,3,3,0,0,0,0
S01012964,Rented or living rent free: Total,14,11,10,4,6,1,0,3,2,0,1,0,0
S01012964,Rented or living rent free: Social rented,1,0,0,0,0,0,0,1,0,0,1,0,0
S01012964,Rented or living rent free: Private rented or living rent free,13,11,10,4,6,1,0,2,2,0,0,0,0
S01012965,All HRPs aged 16 and over,229,185,151,22,129,23,11,44,22,0,6,13,3
S01012965,Owned: Total,162,141,120,9,111,19,2,21,21,0,0,0,0
S01012965,Owned: Owned outright,36,21,20,3,17,0,1,15,15,0,0,0,0
S01012965,Owned: Owned with a mortgage or loan or shared ownership,126,120,100,6,94,19,1,6,6,0,0,0,0
S01012965,Rented or living rent free: Total,67,44,31,13,18,4,9,23,1,0,6,13,3
S01012965,Rented or living rent free: Social rented,60,38,26,11,15,3,9,22,1,0,5,13,3
S01012965,Rented or living rent free: Private rented or living rent free,7,6,5,2,3,1,0,1,0,0,1,0,0
S01012966,All HRPs aged 16 and over,262,217,190,34,156,26,1,45,37,1,1,4,2
S01012966,Owned: Total,215,184,161,22,139,23,0,31,28,1,0,2,0
S01012966,Owned: Owned outright,52,27,24,6,18,3,0,25,23,0,0,2,0
S01012966,Owned: Owned with a mortgage or loan or shared ownership,163,157,137,16,121,20,0,6,5,1,0,0,0
S01012966,Rented or living rent free: Total,47,33,29,12,17,3,1,14,9,0,1,2,2
S01012966,Rented or living rent free: Social rented,31,20,18,7,11,2,0,11,8,0,0,2,1
S01012966,Rented or living rent free: Private rented or living rent free,16,13,11,5,6,1,1,3,1,0,1,0,1
S01012967,All HRPs aged 16 and over,183,138,122,22,100,14,2,45,31,1,2,11,0
S01012967,Owned: Total,140,112,99,16,83,12,1,28,24,0,1,3,0
S01012967,Owned: Owned outright,47,24,23,6,17,1,0,23,20,0,1,2,0
S01012967,Owned: Owned with a mortgage or loan or shared ownership,93,88,76,10,66,11,1,5,4,0,0,1,0
S01012967,Rented or living rent free: Total,43,26,23,6,17,2,1,17,7,1,1,8,0
S01012967,Rented or living rent free: Social rented,31,15,14,5,9,0,1,16,6,1,1,8,0
S01012967,Rented or living rent free: Private rented or living rent free,12,11,9,1,8,2,0,1,1,0,0,0,0
S01012968,All HRPs aged 16 and over,271,200,172,30,142,21,7,71,39,2,13,13,4
S01012968,Owned: Total,177,146,126,20,106,18,2,31,27,1,0,3,0
S01012968,Owned: Owned outright,54,34,29,8,21,5,0,20,20,0,0,0,0
S01012968,Owned: Owned with a mortgage or loan or shared ownership,123,112,97,12,85,13,2,11,7,1,0,3,0
S01012968,Rented or living rent free: Total,94,54,46,10,36,3,5,40,12,1,13,10,4
S01012968,Rented or living rent free: Social rented,52,29,24,5,19,2,3,23,8,1,5,7,2
S01012968,Rented or living rent free: Private rented or living rent free,42,25,22,5,17,1,2,17,4,0,8,3,2
S01012969,All HRPs aged 16 and over,306,197,169,36,133,19,9,109,94,2,4,6,3
S01012969,Owned: Total,191,148,130,21,109,15,3,43,39,1,0,1,2
S01012969,Owned: Owned outright,66,32,26,9,17,4,2,34,33,0,0,0,1
S01012969,Owned: Owned with a mortgage or loan or shared ownership,125,116,104,12,92,11,1,9,6,1,0,1,1
S01012969,Rented or living rent free: Total,115,49,39,15,24,4,6,66,55,1,4,5,1
S01012969,Rented or living rent free: Social rented,87,30,23,9,14,3,4,57,52,0,3,2,0
S01012969,Rented or living rent free: Private rented or living rent free,28,19,16,6,10,1,2,9,3,1,1,3,1
S01012970,All HRPs aged 16 and over,236,168,145,21,124,17,6,68,60,0,2,4,2
S01012970,Owned: Total,158,126,111,8,103,12,3,32,30,0,0,1,1
S01012970,Owned: Owned outright,47,24,21,2,19,2,1,23,22,0,0,0,1
S01012970,Owned: Owned with a mortgage or loan or shared ownership,111,102,90,6,84,10,2,9,8,0,0,1,0
S01012970,Rented or living rent free: Total,78,42,34,13,21,5,3,36,30,0,2,3,1
S01012970,Rented or living rent free: Social rented,70,35,29,11,18,3,3,35,30,0,1,3,1
S01012970,Rented or living rent free: Private rented or living rent free,8,7,5,2,3,2,0,1,0,0,1,0,0
S01012971,All HRPs aged 16 and over,299,226,179,35,144,23,24,73,34,1,19,13,6
S01012971,Owned: Total,156,131,113,11,102,14,4,25,19,0,2,3,1
S01012971,Owned: Owned outright,47,29,22,7,15,6,1,18,15,0,1,1,1
S01012971,Owned: Owned with a mortgage or loan or shared ownership,109,102,91,4,87,8,3,7,4,0,1,2,0
S01012971,Rented or living rent free: Total,143,95,66,24,42,9,20,48,15,1,17,10,5
S01012971,Rented or living rent free: Social rented,118,79,58,21,37,8,13,39,14,1,12,9,3
S01012971,Rented or living rent free: Private rented or living rent free,25,16,8,3,5,1,7,9,1,0,5,1,2
S01012972,All HRPs aged 16 and over,329,214,181,34,147,22,11,115,82,1,13,15,4
S01012972,Owned: Total,181,134,118,16,102,14,2,47,40,0,2,3,2
S01012972,Owned: Owned outright,46,14,10,2,8,3,1,32,30,0,1,1,0
S01012972,Owned: Owned with a mortgage or loan or shared ownership,135,120,108,14,94,11,1,15,10,0,1,2,2
S01012972,Rented or living rent free: Total,148,80,63,18,45,8,9,68,42,1,11,12,2
S01012972,Rented or living rent free: Social rented,121,58,48,10,38,5,5,63,41,1,9,10,2
S01012972,Rented or living rent free: Private rented or living rent free,27,22,15,8,7,3,4,5,1,0,2,2,0
S01012973,All HRPs aged 16 and over,335,207,183,30,153,19,5,128,106,1,4,14,3
S01012973,Owned: Total,250,177,161,25,136,16,0,73,67,0,1,4,1
S01012973,Owned: Owned outright,88,27,25,11,14,2,0,61,57,0,0,3,1
S01012973,Owned: Owned with a mortgage or loan or shared ownership,162,150,136,14,122,14,0,12,10,0,1,1,0
S01012973,Rented or living rent free: Total,85,30,22,5,17,3,5,55,39,1,3,10,2
S01012973,Rented or living rent free: Social rented,60,14,10,1,9,2,2,46,33,0,2,9,2
S01012973,Rented or living rent free: Private rented or living rent free,25,16,12,4,8,1,3,9,6,1,1,1,0
S01012974,All HRPs aged 16 and over,446,268,224,45,179,25,19,178,143,1,7,23,4
S01012974,Owned: Total,291,187,165,25,140,17,5,104,97,1,0,5,1
S01012974,Owned: Owned outright,112,34,28,4,24,4,2,78,76,0,0,1,1
S01012974,Owned: Owned with a mortgage or loan or shared ownership,179,153,137,21,116,13,3,26,21,1,0,4,0
S01012974,Rented or living rent free: Total,155,81,59,20,39,8,14,74,46,0,7,18,3
S01012974,Rented or living rent free: Social rented,120,59,44,15,29,5,10,61,43,0,0,16,2
S01012974,Rented or living rent free: Private rented or living rent free,35,22,15,5,10,3,4,13,3,0,7,2,1
S01012975,All HRPs aged 16 and over,266,156,136,24,112,11,9,110,90,0,3,10,7
S01012975,Owned: Total,146,108,95,11,84,9,4,38,32,0,0,3,3
S01012975,Owned: Owned outright,41,17,14,5,9,1,2,24,24,0,0,0,0
S01012975,Owned: Owned with a mortgage or loan or shared ownership,105,91,81,6,75,8,2,14,8,0,0,3,3
S01012975,Rented or living rent free: Total,120,48,41,13,28,2,5,72,58,0,3,7,4
S01012975,Rented or living rent free: Social rented,102,31,25,8,17,1,5,71,58,0,3,7,3
S01012975,Rented or living rent free: Private rented or living rent free,18,17,16,5,11,1,0,1,0,0,0,0,1
S01012976,All HRPs aged 16 and over,229,147,128,26,102,11,8,82,64,1,5,10,2
S01012976,Owned: Total,148,103,92,13,79,10,1,45,39,0,1,3,2
S01012976,Owned: Owned outright,55,21,18,4,14,3,0,34,32,0,0,0,2
S01012976,Owned: Owned with a mortgage or loan or shared ownership,93,82,74,9,65,7,1,11,7,0,1,3,0
S01012976,Rented or living rent free: Total,81,44,36,13,23,1,7,37,25,1,4,7,0
S01012976,Rented or living rent free: Social rented,57,25,21,9,12,1,3,32,22,1,3,6,0
S01012976,Rented or living rent free: Private rented or living rent free,24,19,15,4,11,0,4,5,3,0,1,1,0
S01012977,All HRPs aged 16 and over,287,221,181,37,144,22,18,66,46,1,6,13,0
S01012977,Owned: Total,189,151,130,21,109,15,6,38,38,0,0,0,0
S01012977,Owned: Owned outright,58,23,16,5,11,6,1,35,35,0,0,0,0
S01012977,Owned: Owned with a mortgage or loan or shared ownership,131,128,114,16,98,9,5,3,3,0,0,0,0
S01012977,Rented or living rent free: Total,98,70,51,16,35,7,12,28,8,1,6,13,0
S01012977,Rented or living rent free: Social rented,70,49,35,12,23,4,10,21,7,1,2,11,0
S01012977,Rented or living rent free: Private rented or living rent free,28,21,16,4,12,3,2,7,1,0,4,2,0
S01012978,All HRPs aged 16 and over,334,237,198,39,159,28,11,97,61,3,5,23,5
S01012978,Owned: Total,206,170,149,22,127,20,1,36,30,0,0,4,2
S01012978,Owned: Owned outright,58,33,27,9,18,6,0,25,23,0,0,1,1
S01012978,Owned: Owned with a mortgage or loan or shared ownership,148,137,122,13,109,14,1,11,7,0,0,3,1
S01012978,Rented or living rent free: Total,128,67,49,17,32,8,10,61,31,3,5,19,3
S01012978,Rented or living rent free: Social rented,108,50,37,11,26,5,8,58,30,3,5,19,1
S01012978,Rented or living rent free: Private rented or living rent free,20,17,12,6,6,3,2,3,1,0,0,0,2
S01012979,All HRPs aged 16 and over,224,174,148,21,127,23,3,50,38,2,4,4,2
S01012979,Owned: Total,176,144,122,13,109,22,0,32,29,0,1,1,1
S01012979,Owned: Owned outright,45,22,18,4,14,4,0,23,22,0,0,0,1
S01012979,Owned: Owned with a mortgage or loan or shared ownership,131,122,104,9,95,18,0,9,7,0,1,1,0
S01012979,Rented or living rent free: Total,48,30,26,8,18,1,3,18,9,2,3,3,1
S01012979,Rented or living rent free: Social rented,37,23,20,7,13,0,3,14,8,1,2,2,1
S01012979,Rented or living rent free: Private rented or living rent free,11,7,6,1,5,1,0,4,1,1,1,1,0
S01012980,All HRPs aged 16 and over,311,219,186,29,157,15,18,92,59,5,9,15,4
S01012980,Owned: Total,201,155,142,15,127,10,3,46,42,0,2,2,0
S01012980,Owned: Owned outright,57,19,17,4,13,2,0,38,35,0,1,2,0
S01012980,Owned: Owned with a mortgage or loan or shared ownership,144,136,125,11,114,8,3,8,7,0,1,0,0
S01012980,Rented or living rent free: Total,110,64,44,14,30,5,15,46,17,5,7,13,4
S01012980,Rented or living rent free: Social rented,75,35,22,5,17,4,9,40,17,4,3,13,3
S01012980,Rented or living rent free: Private rented or living rent free,35,29,22,9,13,1,6,6,0,1,4,0,1
S01012981,All HRPs aged 16 and over,347,248,212,33,179,21,15,99,72,5,4,14,4
S01012981,Owned: Total,243,180,162,19,143,14,4,63,53,4,1,4,1
S01012981,Owned: Owned outright,68,25,24,7,17,1,0,43,41,0,1,1,0
S01012981,Owned: Owned with a mortgage or loan or shared ownership,175,155,138,12,126,13,4,20,12,4,0,3,1
S01012981,Rented or living rent free: Total,104,68,50,14,36,7,11,36,19,1,3,10,3
S01012981,Rented or living rent free: Social rented,67,36,28,9,19,4,4,31,18,1,3,8,1
S01012981,Rented or living rent free: Private rented or living rent free,37,32,22,5,17,3,7,5,1,0,0,2,2
S01012982,All HRPs aged 16 and over,383,271,242,28,214,12,17,112,87,2,7,15,1
S01012982,Owned: Total,271,197,183,20,163,10,4,74,69,1,0,3,1
S01012982,Owned: Owned outright,92,30,27,6,21,2,1,62,61,1,0,0,0
S01012982,Owned: Owned with a mortgage or loan or shared ownership,179,167,156,14,142,8,3,12,8,0,0,3,1
S01012982,Rented or living rent free: Total,112,74,59,8,51,2,13,38,18,1,7,12,0
S01012982,Rented or living rent free: Social rented,60,36,28,4,24,1,7,24,15,0,3,6,0
S01012982,Rented or living rent free: Private rented or living rent free,52,38,31,4,27,1,6,14,3,1,4,6,0
S01012983,All HRPs aged 16 and over,326,201,172,29,143,23,6,125,107,3,3,5,7
S01012983,Owned: Total,291,176,153,23,130,21,2,115,104,2,0,3,6
S01012983,Owned: Owned outright,133,42,38,12,26,3,1,91,88,0,0,1,2
S01012983,Owned: Owned with a mortgage or loan or shared ownership,158,134,115,11,104,18,1,24,16,2,0,2,4
S01012983,Rented or living rent free: Total,35,25,19,6,13,2,4,10,3,1,3,2,1
S01012983,Rented or living rent free: Social rented,9,5,4,0,4,0,1,4,1,1,1,1,0
S01012983,Rented or living rent free: Private rented or living rent free,26,20,15,6,9,2,3,6,2,0,2,1,1
S01012984,All HRPs aged 16 and over,279,196,168,15,153,19,9,83,74,1,0,6,2
S01012984,Owned: Total,225,154,142,11,131,10,2,71,66,0,0,4,1
S01012984,Owned: Owned outright,78,22,20,1,19,2,0,56,53,0,0,2,1
S01012984,Owned: Owned with a mortgage or loan or shared ownership,147,132,122,10,112,8,2,15,13,0,0,2,0
S01012984,Rented or living rent free: Total,54,42,26,4,22,9,7,12,8,1,0,2,1
S01012984,Rented or living rent free: Social rented,34,23,14,3,11,4,5,11,8,1,0,2,0
S01012984,Rented or living rent free: Private rented or living rent free,20,19,12,1,11,5,2,1,0,0,0,0,1
S01012985,All HRPs aged 16 and over,330,213,184,26,158,23,6,117,100,0,8,6,3
S01012985,Owned: Total,283,189,162,21,141,21,6,94,89,0,2,3,0
S01012985,Owned: Owned outright,117,41,37,8,29,3,1,76,74,0,2,0,0
S01012985,Owned: Owned with a mortgage or loan or shared ownership,166,148,125,13,112,18,5,18,15,0,0,3,0
S01012985,Rented or living rent free: Total,47,24,22,5,17,2,0,23,11,0,6,3,3
S01012985,Rented or living rent free: Social rented,29,12,12,4,8,0,0,17,9,0,2,3,3
S01012985,Rented or living rent free: Private rented or living rent free,18,12,10,1,9,2,0,6,2,0,4,0,0
S01012986,All HRPs aged 16 and over,394,242,212,25,187,15,15,152,105,5,4,27,11
S01012986,Owned: Total,253,168,152,13,139,12,4,85,80,1,0,2,2
S01012986,Owned: Owned outright,95,28,23,4,19,5,0,67,64,0,0,1,2
S01012986,Owned: Owned with a mortgage or loan or shared ownership,158,140,129,9,120,7,4,18,16,1,0,1,0
S01012986,Rented or living rent free: Total,141,74,60,12,48,3,11,67,25,4,4,25,9
S01012986,Rented or living rent free: Social rented,93,40,32,8,24,2,6,53,22,3,2,18,8
S01012986,Rented or living rent free: Private rented or living rent free,48,34,28,4,24,1,5,14,3,1,2,7,1
S01012987,All HRPs aged 16 and over,356,206,169,24,145,28,9,150,126,2,3,14,5
S01012987,Owned: Total,238,151,129,17,112,19,3,87,79,2,0,4,2
S01012987,Owned: Owned outright,98,34,28,7,21,5,1,64,59,2,0,1,2
S01012987,Owned: Owned with a mortgage or loan or shared ownership,140,117,101,10,91,14,2,23,20,0,0,3,0
S01012987,Rented or living rent free: Total,118,55,40,7,33,9,6,63,47,0,3,10,3
S01012987,Rented or living rent free: Social rented,85,27,19,5,14,5,3,58,44,0,2,9,3
S01012987,Rented or living rent free: Private rented or living rent free,33,28,21,2,19,4,3,5,3,0,1,1,0
S01012988,All HRPs aged 16 and over,463,251,209,35,174,24,18,212,175,10,5,8,14
S01012988,Owned: Total,315,182,157,15,142,22,3,133,124,3,0,0,6
S01012988,Owned: Owned outright,155,36,29,5,24,6,1,119,113,0,0,0,6
S01012988,Owned: Owned with a mortgage or loan or shared ownership,160,146,128,10,118,16,2,14,11,3,0,0,0
S01012988,Rented or living rent free: Total,148,69,52,20,32,2,15,79,51,7,5,8,8
S01012988,Rented or living rent free: Social rented,95,32,24,11,13,0,8,63,44,3,3,7,6
S01012988,Rented or living rent free: Private rented or living rent free,53,37,28,9,19,2,7,16,7,4,2,1,2
S01012989,All HRPs aged 16 and over,409,261,231,36,195,20,10,148,128,1,5,12,2
S01012989,Owned: Total,322,204,182,20,162,17,5,118,108,1,1,7,1
S01012989,Owned: Owned outright,134,35,29,7,22,5,1,99,92,0,0,6,1
S01012989,Owned: Owned with a mortgage or loan or shared ownership,188,169,153,13,140,12,4,19,16,1,1,1,0
S01012989,Rented or living rent free: Total,87,57,49,16,33,3,5,30,20,0,4,5,1
S01012989,Rented or living rent free: Social rented,53,33,30,12,18,1,2,20,17,0,1,1,1
S01012989,Rented or living rent free: Private rented or living rent free,34,24,19,4,15,2,3,10,3,0,3,4,0
S01012990,All HRPs aged 16 and over,303,156,135,28,107,13,8,147,116,5,2,19,5
S01012990,Owned: Total,175,111,97,15,82,11,3,64,59,0,0,3,2
S01012990,Owned: Owned outright,73,22,19,9,10,3,0,51,47,0,0,2,2
S01012990,Owned: Owned with a mortgage or loan or shared ownership,102,89,78,6,72,8,3,13,12,0,0,1,0
S01012990,Rented or living rent free: Total,128,45,38,13,25,2,5,83,57,5,2,16,3
S01012990,Rented or living rent free: Social rented,101,25,20,7,13,0,5,76,57,5,1,11,2
S01012990,Rented or living rent free: Private rented or living rent free,27,20,18,6,12,2,0,7,0,0,1,5,1
S01012991,All HRPs aged 16 and over,351,225,185,44,141,25,15,126,97,1,11,14,3
S01012991,Owned: Total,259,171,143,29,114,24,4,88,79,0,2,5,2
S01012991,Owned: Owned outright,101,34,27,8,19,6,1,67,63,0,0,3,1
S01012991,Owned: Owned with a mortgage or loan or shared ownership,158,137,116,21,95,18,3,21,16,0,2,2,1
S01012991,Rented or living rent free: Total,92,54,42,15,27,1,11,38,18,1,9,9,1
S01012991,Rented or living rent free: Social rented,46,23,16,8,8,0,7,23,13,0,3,6,1
S01012991,Rented or living rent free: Private rented or living rent free,46,31,26,7,19,1,4,15,5,1,6,3,0
S01012992,All HRPs aged 16 and over,380,216,189,28,161,16,11,164,136,0,9,16,3
S01012992,Owned: Total,268,162,146,14,132,13,3,106,102,0,1,2,1
S01012992,Owned: Owned outright,108,30,27,5,22,2,1,78,75,0,1,1,1
S01012992,Owned: Owned with a mortgage or loan or shared ownership,160,132,119,9,110,11,2,28,27,0,0,1,0
S01012992,Rented or living rent free: Total,112,54,43,14,29,3,8,58,34,0,8,14,2
S01012992,Rented or living rent free: Social rented,69,24,19,9,10,1,4,45,29,0,2,14,0
S01012992,Rented or living rent free: Private rented or living rent free,43,30,24,5,19,2,4,13,5,0,6,0,2
S01012993,All HRPs aged 16 and over,376,216,186,37,149,15,15,160,122,0,5,23,10
S01012993,Owned: Total,245,143,128,14,114,11,4,102,94,0,0,5,3
S01012993,Owned: Owned outright,120,38,32,6,26,4,2,82,78,0,0,2,2
S01012993,Owned: Owned with a mortgage or loan or shared ownership,125,105,96,8,88,7,2,20,16,0,0,3,1
S01012993,Rented or living rent free: Total,131,73,58,23,35,4,11,58,28,0,5,18,7
S01012993,Rented or living rent free: Social rented,79,39,28,8,20,2,9,40,23,0,5,9,3
S01012993,Rented or living rent free: Private rented or living rent free,52,34,30,15,15,2,2,18,5,0,0,9,4
S01012994,All HRPs aged 16 and over,502,299,240,55,185,28,31,203,146,4,5,35,13
S01012994,Owned: Total,266,171,143,26,117,20,8,95,88,0,1,4,2
S01012994,Owned: Owned outright,129,45,37,11,26,6,2,84,77,0,1,4,2
S01012994,Owned: Owned with a mortgage or loan or shared ownership,137,126,106,15,91,14,6,11,11,0,0,0,0
S01012994,Rented or living rent free: Total,236,128,97,29,68,8,23,108,58,4,4,31,11
S01012994,Rented or living rent free: Social rented,158,68,51,17,34,4,13,90,53,1,3,28,5
S01012994,Rented or living rent free: Private rented or living rent free,78,60,46,12,34,4,10,18,5,3,1,3,6
S01012995,All HRPs aged 16 and over,331,255,228,28,200,21,6,76,64,2,2,8,0
S01012995,Owned: Total,265,211,190,15,175,19,2,54,52,1,0,1,0
S01012995,Owned: Owned outright,68,28,25,7,18,2,1,40,40,0,0,0,0
S01012995,Owned: Owned with a mortgage or loan or shared ownership,197,183,165,8,157,17,1,14,12,1,0,1,0
S01012995,Rented or living rent free: Total,66,44,38,13,25,2,4,22,12,1,2,7,0
S01012995,Rented or living rent free: Social rented,45,27,23,8,15,2,2,18,10,0,1,7,0
S01012995,Rented or living rent free: Private rented or living rent free,21,17,15,5,10,0,2,4,2,1,1,0,0
S01012996,All HRPs aged 16 and over,246,190,155,24,131,25,10,56,40,2,2,12,0
S01012996,Owned: Total,173,144,119,14,105,24,1,29,28,0,0,1,0
S01012996,Owned: Owned outright,44,25,17,10,7,8,0,19,19,0,0,0,0
S01012996,Owned: Owned with a mortgage or loan or shared ownership,129,119,102,4,98,16,1,10,9,0,0,1,0
S01012996,Rented or living rent free: Total,73,46,36,10,26,1,9,27,12,2,2,11,0
S01012996,Rented or living rent free: Social rented,56,37,27,8,19,1,9,19,8,2,1,8,0
S01012996,Rented or living rent free: Private rented or living rent free,17,9,9,2,7,0,0,8,4,0,1,3,0
S01012997,All HRPs aged 16 and over,210,122,108,25,83,6,8,88,70,1,5,9,3
S01012997,Owned: Total,146,97,89,13,76,6,2,49,43,0,1,4,1
S01012997,Owned: Owned outright,46,14,12,4,8,1,1,32,31,0,0,0,1
S01012997,Owned: Owned with a mortgage or loan or shared ownership,100,83,77,9,68,5,1,17,12,0,1,4,0
S01012997,Rented or living rent free: Total,64,25,19,12,7,0,6,39,27,1,4,5,2
S01012997,Rented or living rent free: Social rented,49,15,13,9,4,0,2,34,25,0,4,3,2
S01012997,Rented or living rent free: Private rented or living rent free,15,10,6,3,3,0,4,5,2,1,0,2,0
S01012998,All HRPs aged 16 and over,414,307,258,37,221,41,8,107,85,2,8,7,5
S01012998,Owned: Total,307,236,198,21,177,35,3,71,71,0,0,0,0
S01012998,Owned: Owned outright,83,31,26,7,19,5,0,52,52,0,0,0,0
S01012998,Owned: Owned with a mortgage or loan or shared ownership,224,205,172,14,158,30,3,19,19,0,0,0,0
S01012998,Rented or living rent free: Total,107,71,60,16,44,6,5,36,14,2,8,7,5
S01012998,Rented or living rent free: Social rented,58,33,29,7,22,2,2,25,12,1,3,7,2
S01012998,Rented or living rent free: Private rented or living rent free,49,38,31,9,22,4,3,11,2,1,5,0,3
S01012999,All HRPs aged 16 and over,220,141,123,17,106,10,8,79,65,0,4,9,1
S01012999,Owned: Total,145,110,98,10,88,10,2,35,32,0,1,2,0
S01012999,Owned: Owned outright,40,14,13,4,9,1,0,26,26,0,0,0,0
S01012999,Owned: Owned with a mortgage or loan or shared ownership,105,96,85,6,79,9,2,9,6,0,1,2,0
S01012999,Rented or living rent free: Total,75,31,25,7,18,0,6,44,33,0,3,7,1
S01012999,Rented or living rent free: Social rented,58,17,16,5,11,0,1,41,33,0,1,6,1
S01012999,Rented or living rent free: Private rented or living rent free,17,14,9,2,7,0,5,3,0,0,2,1,0
S01013000,All HRPs aged 16 and over,322,199,169,26,143,18,12,123,106,0,2,10,5
S01013000,Owned: Total,217,136,115,6,109,17,4,81,80,0,0,0,1
S01013000,Owned: Owned outright,86,27,23,3,20,3,1,59,58,0,0,0,1
S01013000,Owned: Owned with a mortgage or loan or shared ownership,131,109,92,3,89,14,3,22,22,0,0,0,0
S01013000,Rented or living rent free: Total,105,63,54,20,34,1,8,42,26,0,2,10,4
S01013000,Rented or living rent free: Social rented,70,37,31,12,19,1,5,33,23,0,0,8,2
S01013000,Rented or living rent free: Private rented or living rent free,35,26,23,8,15,0,3,9,3,0,2,2,2
S01013001,All HRPs aged 16 and over,156,112,66,7,59,41,5,44,41,0,0,3,0
S01013001,Owned: Total,111,76,47,7,40,26,3,35,35,0,0,0,0
S01013001,Owned: Owned outright,66,35,18,4,14,15,2,31,31,0,0,0,0
S01013001,Owned: Owned with a mortgage or loan or shared ownership,45,41,29,3,26,11,1,4,4,0,0,0,0
S01013001,Rented or living rent free: Total,45,36,19,0,19,15,2,9,6,0,0,3,0
S01013001,Rented or living rent free: Social rented,10,8,4,0,4,3,1,2,0,0,0,2,0
S01013001,Rented or living rent free: Private rented or living rent free,35,28,15,0,15,12,1,7,6,0,0,1,0
S01013002,All HRPs aged 16 and over,205,147,94,9,85,50,3,58,51,1,3,1,2
S01013002,Owned: Total,149,103,63,5,58,40,0,46,44,1,1,0,0
S01013002,Owned: Owned outright,82,42,22,3,19,20,0,40,38,1,1,0,0
S01013002,Owned: Owned with a mortgage or loan or shared ownership,67,61,41,2,39,20,0,6,6,0,0,0,0
S01013002,Rented or living rent free: Total,56,44,31,4,27,10,3,12,7,0,2,1,2
S01013002,Rented or living rent free: Social rented,14,8,4,2,2,3,1,6,3,0,2,0,1
S01013002,Rented or living rent free: Private rented or living rent free,42,36,27,2,25,7,2,6,4,0,0,1,1
S01013003,All HRPs aged 16 and over,246,152,114,14,100,37,1,94,91,0,0,3,0
S01013003,Owned: Total,241,148,112,14,98,35,1,93,91,0,0,2,0
S01013003,Owned: Owned outright,133,50,36,8,28,14,0,83,81,0,0,2,0
S01013003,Owned: Owned with a mortgage or loan or shared ownership,108,98,76,6,70,21,1,10,10,0,0,0,0
S01013003,Rented or living rent free: Total,5,4,2,0,2,2,0,1,0,0,0,1,0
S01013003,Rented or living rent free: Social rented,2,1,1,0,1,0,0,1,0,0,0,1,0
S01013003,Rented or living rent free: Private rented or living rent free,3,3,1,0,1,2,0,0,0,0,0,0,0
S01013004,All HRPs aged 16 and over,264,187,136,18,118,48,3,77,70,1,2,4,0
S01013004,Owned: Total,228,165,119,12,107,43,3,63,60,1,0,2,0
S01013004,Owned: Owned outright,112,55,36,11,25,18,1,57,55,1,0,1,0
S01013004,Owned: Owned with a mortgage or loan or shared ownership,116,110,83,1,82,25,2,6,5,0,0,1,0
S01013004,Rented or living rent free: Total,36,22,17,6,11,5,0,14,10,0,2,2,0
S01013004,Rented or living rent free: Social rented,21,11,9,3,6,2,0,10,6,0,2,2,0
S01013004,Rented or living rent free: Private rented or living rent free,15,11,8,3,5,3,0,4,4,0,0,0,0
S01013005,All HRPs aged 16 and over,300,200,135,17,118,62,3,100,93,1,2,4,0
S01013005,Owned: Total,249,160,107,11,96,51,2,89,85,0,2,2,0
S01013005,Owned: Owned outright,152,73,44,6,38,27,2,79,78,0,1,0,0
S01013005,Owned: Owned with a mortgage or loan or shared ownership,97,87,63,5,58,24,0,10,7,0,1,2,0
S01013005,Rented or living rent free: Total,51,40,28,6,22,11,1,11,8,1,0,2,0
S01013005,Rented or living rent free: Social rented,14,7,5,3,2,1,1,7,5,0,0,2,0
S01013005,Rented or living rent free: Private rented or living rent free,37,33,23,3,20,10,0,4,3,1,0,0,0
S01013006,All HRPs aged 16 and over,240,185,126,17,109,55,4,55,49,3,2,1,0
S01013006,Owned: Total,185,144,91,9,82,51,2,41,41,0,0,0,0
S01013006,Owned: Owned outright,103,64,38,7,31,25,1,39,39,0,0,0,0
S01013006,Owned: Owned with a mortgage or loan or shared ownership,82,80,53,2,51,26,1,2,2,0,0,0,0
S01013006,Rented or living rent free: Total,55,41,35,8,27,4,2,14,8,3,2,1,0
S01013006,Rented or living rent free: Social rented,10,5,4,4,0,1,0,5,3,0,2,0,0
S01013006,Rented or living rent free: Private rented or living rent free,45,36,31,4,27,3,2,9,5,3,0,1,0
S01013007,All HRPs aged 16 and over,397,231,176,25,151,49,6,166,156,0,1,5,4
S01013007,Owned: Total,354,203,154,19,135,45,4,151,150,0,1,0,0
S01013007,Owned: Owned outright,205,68,47,12,35,19,2,137,136,0,1,0,0
S01013007,Owned: Owned with a mortgage or loan or shared ownership,149,135,107,7,100,26,2,14,14,0,0,0,0
S01013007,Rented or living rent free: Total,43,28,22,6,16,4,2,15,6,0,0,5,4
S01013007,Rented or living rent free: Social rented,11,5,4,3,1,0,1,6,3,0,0,3,0
S01013007,Rented or living rent free: Private rented or living rent free,32,23,18,3,15,4,1,9,3,0,0,2,4
S01013008,All HRPs aged 16 and over,330,211,154,23,131,51,6,119,108,0,3,8,0
S01013008,Owned: Total,248,159,117,16,101,41,1,89,86,0,2,1,0
S01013008,Owned: Owned outright,132,56,43,11,32,13,0,76,76,0,0,0,0
S01013008,Owned: Owned with a mortgage or loan or shared ownership,116,103,74,5,69,28,1,13,10,0,2,1,0
S01013008,Rented or living rent free: Total,82,52,37,7,30,10,5,30,22,0,1,7,0
S01013008,Rented or living rent free: Social rented,48,22,17,5,12,2,3,26,19,0,1,6,0
S01013008,Rented or living rent free: Private rented or living rent free,34,30,20,2,18,8,2,4,3,0,0,1,0
S01013009,All HRPs aged 16 and over,293,158,116,26,90,35,7,135,122,1,4,7,1
S01013009,Owned: Total,197,106,80,15,65,25,1,91,86,1,1,3,0
S01013009,Owned: Owned outright,116,37,27,5,22,9,1,79,76,0,1,2,0
S01013009,Owned: Owned with a mortgage or loan or shared ownership,81,69,53,10,43,16,0,12,10,1,0,1,0
S01013009,Rented or living rent free: Total,96,52,36,11,25,10,6,44,36,0,3,4,1
S01013009,Rented or living rent free: Social rented,64,27,18,5,13,5,4,37,31,0,2,3,1
S01013009,Rented or living rent free: Private rented or living rent free,32,25,18,6,12,5,2,7,5,0,1,1,0
S01013010,All HRPs aged 16 and over,246,180,109,13,96,67,4,66,60,0,1,3,2
S01013010,Owned: Total,207,149,93,10,83,53,3,58,57,0,1,0,0
S01013010,Owned: Owned outright,123,69,42,6,36,26,1,54,53,0,1,0,0
S01013010,Owned: Owned with a mortgage or loan or shared ownership,84,80,51,4,47,27,2,4,4,0,0,0,0
S01013010,Rented or living rent free: Total,39,31,16,3,13,14,1,8,3,0,0,3,2
S01013010,Rented or living rent free: Social rented,4,3,2,1,1,0,1,1,0,0,0,1,0
S01013010,Rented or living rent free: Private rented or living rent free,35,28,14,2,12,14,0,7,3,0,0,2,2
S01013011,All HRPs aged 16 and over,261,201,147,12,135,48,6,60,56,0,2,1,1
S01013011,Owned: Total,197,154,113,4,109,39,2,43,41,0,2,0,0
S01013011,Owned: Owned outright,69,30,19,1,18,11,0,39,38,0,1,0,0
S01013011,Owned: Owned with a mortgage or loan or shared ownership,128,124,94,3,91,28,2,4,3,0,1,0,0
S01013011,Rented or living rent free: Total,64,47,34,8,26,9,4,17,15,0,0,1,1
S01013011,Rented or living rent free: Social rented,47,33,25,5,20,6,2,14,12,0,0,1,1
S01013011,Rented or living rent free: Private rented or living rent free,17,14,9,3,6,3,2,3,3,0,0,0,0
S01013012,All HRPs aged 16 and over,292,184,150,21,129,29,5,108,88,1,8,11,0
S01013012,Owned: Total,181,121,99,9,90,20,2,60,58,0,1,1,0
S01013012,Owned: Owned outright,86,32,26,6,20,5,1,54,52,0,1,1,0
S01013012,Owned: Owned with a mortgage or loan or shared ownership,95,89,73,3,70,15,1,6,6,0,0,0,0
S01013012,Rented or living rent free: Total,111,63,51,12,39,9,3,48,30,1,7,10,0
S01013012,Rented or living rent free: Social rented,70,34,30,9,21,1,3,36,24,0,3,9,0
S01013012,Rented or living rent free: Private rented or living rent free,41,29,21,3,18,8,0,12,6,1,4,1,0
S01013013,All HRPs aged 16 and over,297,202,149,24,125,51,2,95,86,0,5,3,1
S01013013,Owned: Total,232,156,115,17,98,41,0,76,75,0,1,0,0
S01013013,Owned: Owned outright,118,55,35,8,27,20,0,63,62,0,1,0,0
S01013013,Owned: Owned with a mortgage or loan or shared ownership,114,101,80,9,71,21,0,13,13,0,0,0,0
S01013013,Rented or living rent free: Total,65,46,34,7,27,10,2,19,11,0,4,3,1
S01013013,Rented or living rent free: Social rented,28,15,15,5,10,0,0,13,6,0,4,3,0
S01013013,Rented or living rent free: Private rented or living rent free,37,31,19,2,17,10,2,6,5,0,0,0,1
S01013014,All HRPs aged 16 and over,336,201,136,17,119,56,9,135,117,1,4,12,1
S01013014,Owned: Total,223,138,90,11,79,45,3,85,83,0,1,1,0
S01013014,Owned: Owned outright,132,57,31,5,26,25,1,75,73,0,1,1,0
S01013014,Owned: Owned with a mortgage or loan or shared ownership,91,81,59,6,53,20,2,10,10,0,0,0,0
S01013014,Rented or living rent free: Total,113,63,46,6,40,11,6,50,34,1,3,11,1
S01013014,Rented or living rent free: Social rented,59,25,19,5,14,4,2,34,20,1,2,11,0
S01013014,Rented or living rent free: Private rented or living rent free,54,38,27,1,26,7,4,16,14,0,1,0,1
S01013015,All HRPs aged 16 and over,309,230,154,23,131,72,4,79,75,0,2,1,1
S01013015,Owned: Total,266,196,132,16,116,63,1,70,68,0,0,1,1
S01013015,Owned: Owned outright,152,88,51,9,42,37,0,64,63,0,0,0,1
S01013015,Owned: Owned with a mortgage or loan or shared ownership,114,108,81,7,74,26,1,6,5,0,0,1,0
S01013015,Rented or living rent free: Total,43,34,22,7,15,9,3,9,7,0,2,0,0
S01013015,Rented or living rent free: Social rented,10,7,3,1,2,1,3,3,3,0,0,0,0
S01013015,Rented or living rent free: Private rented or living rent free,33,27,19,6,13,8,0,6,4,0,2,0,0
S01013016,All HRPs aged 16 and over,244,185,101,17,84,80,4,59,52,0,3,2,2
S01013016,Owned: Total,190,142,77,12,65,63,2,48,43,0,2,1,2
S01013016,Owned: Owned outright,115,71,32,8,24,39,0,44,41,0,1,0,2
S01013016,Owned: Owned with a mortgage or loan or shared ownership,75,71,45,4,41,24,2,4,2,0,1,1,0
S01013016,Rented or living rent free: Total,54,43,24,5,19,17,2,11,9,0,1,1,0
S01013016,Rented or living rent free: Social rented,11,6,3,2,1,1,2,5,3,0,1,1,0
S01013016,Rented or living rent free: Private rented or living rent free,43,37,21,3,18,16,0,6,6,0,0,0,0
S01013017,All HRPs aged 16 and over,359,228,174,33,141,46,8,131,111,1,5,11,3
S01013017,Owned: Total,239,176,133,16,117,39,4,63,62,0,1,0,0
S01013017,Owned: Owned outright,105,51,37,9,28,14,0,54,53,0,1,0,0
S01013017,Owned: Owned with a mortgage or loan or shared ownership,134,125,96,7,89,25,4,9,9,0,0,0,0
S01013017,Rented or living rent free: Total,120,52,41,17,24,7,4,68,49,1,4,11,3
S01013017,Rented or living rent free: Social rented,103,42,35,15,20,4,3,61,44,1,2,11,3
S01013017,Rented or living rent free: Private rented or living rent free,17,10,6,2,4,3,1,7,5,0,2,0,0
S01013018,All HRPs aged 16 and over,387,278,192,32,160,79,7,109,98,0,3,6,2
S01013018,Owned: Total,312,230,158,22,136,68,4,82,77,0,3,1,1
S01013018,Owned: Owned outright,146,80,51,10,41,28,1,66,63,0,3,0,0
S01013018,Owned: Owned with a mortgage or loan or shared ownership,166,150,107,12,95,40,3,16,14,0,0,1,1
S01013018,Rented or living rent free: Total,75,48,34,10,24,11,3,27,21,0,0,5,1
S01013018,Rented or living rent free: Social rented,46,25,19,6,13,3,3,21,15,0,0,5,1
S01013018,Rented or living rent free: Private rented or living rent free,29,23,15,4,11,8,0,6,6,0,0,0,0
S01013019,All HRPs aged 16 and over,355,269,211,21,190,55,3,86,74,4,3,3,2
S01013019,Owned: Total,275,210,166,12,154,43,1,65,63,0,0,2,0
S01013019,Owned: Owned outright,111,54,33,6,27,21,0,57,56,0,0,1,0
S01013019,Owned: Owned with a mortgage or loan or shared ownership,164,156,133,6,127,22,1,8,7,0,0,1,0
S01013019,Rented or living rent free: Total,80,59,45,9,36,12,2,21,11,4,3,1,2
S01013019,Rented or living rent free: Social rented,8,3,3,2,1,0,0,5,2,0,0,1,2
S01013019,Rented or living rent free: Private rented or living rent free,72,56,42,7,35,12,2,16,9,4,3,0,0
S01013020,All HRPs aged 16 and over,226,132,115,17,98,13,4,94,82,0,0,8,4
S01013020,Owned: Total,134,85,73,5,68,11,1,49,43,0,0,3,3
S01013020,Owned: Owned outright,61,22,19,3,16,2,1,39,38,0,0,0,1
S01013020,Owned: Owned with a mortgage or loan or shared ownership,73,63,54,2,52,9,0,10,5,0,0,3,2
S01013020,Rented or living rent free: Total,92,47,42,12,30,2,3,45,39,0,0,5,1
S01013020,Rented or living rent free: Social rented,68,28,24,7,17,2,2,40,34,0,0,5,1
S01013020,Rented or living rent free: Private rented or living rent free,24,19,18,5,13,0,1,5,5,0,0,0,0
S01013021,All HRPs aged 16 and over,187,136,116,23,93,17,3,51,45,0,1,4,1
S01013021,Owned: Total,131,103,90,14,76,11,2,28,28,0,0,0,0
S01013021,Owned: Owned outright,48,25,19,4,15,5,1,23,23,0,0,0,0
S01013021,Owned: Owned with a mortgage or loan or shared ownership,83,78,71,10,61,6,1,5,5,0,0,0,0
S01013021,Rented or living rent free: Total,56,33,26,9,17,6,1,23,17,0,1,4,1
S01013021,Rented or living rent free: Social rented,42,21,18,6,12,2,1,21,17,0,1,3,0
S01013021,Rented or living rent free: Private rented or living rent free,14,12,8,3,5,4,0,2,0,0,0,1,1
S01013022,All HRPs aged 16 and over,186,137,119,27,92,10,8,49,26,0,8,9,6
S01013022,Owned: Total,97,76,71,6,65,3,2,21,17,0,2,0,2
S01013022,Owned: Owned outright,33,16,13,3,10,1,2,17,14,0,1,0,2
S01013022,Owned: Owned with a mortgage or loan or shared ownership,64,60,58,3,55,2,0,4,3,0,1,0,0
S01013022,Rented or living rent free: Total,89,61,48,21,27,7,6,28,9,0,6,9,4
S01013022,Rented or living rent free: Social rented,72,46,38,18,20,3,5,26,7,0,6,9,4
S01013022,Rented or living rent free: Private rented or living rent free,17,15,10,3,7,4,1,2,2,0,0,0,0
S01013023,All HRPs aged 16 and over,337,209,174,21,153,32,3,128,123,0,2,2,1
S01013023,Owned: Total,314,191,160,21,139,30,1,123,120,0,2,1,0
S01013023,Owned: Owned outright,187,73,57,13,44,15,1,114,113,0,1,0,0
S01013023,Owned: Owned with a mortgage or loan or shared ownership,127,118,103,8,95,15,0,9,7,0,1,1,0
S01013023,Rented or living rent free: Total,23,18,14,0,14,2,2,5,3,0,0,1,1
S01013023,Rented or living rent free: Social rented,5,4,2,0,2,1,1,1,0,0,0,1,0
S01013023,Rented or living rent free: Private rented or living rent free,18,14,12,0,12,1,1,4,3,0,0,0,1
S01013024,All HRPs aged 16 and over,227,136,118,18,100,17,1,91,86,0,2,1,2
S01013024,Owned: Total,194,117,101,14,87,16,0,77,75,0,1,0,1
S01013024,Owned: Owned outright,107,39,32,5,27,7,0,68,67,0,1,0,0
S01013024,Owned: Owned with a mortgage or loan or shared ownership,87,78,69,9,60,9,0,9,8,0,0,0,1
S01013024,Rented or living rent free: Total,33,19,17,4,13,1,1,14,11,0,1,1,1
S01013024,Rented or living rent free: Social rented,8,3,1,0,1,1,1,5,4,0,0,1,0
S01013024,Rented or living rent free: Private rented or living rent free,25,16,16,4,12,0,0,9,7,0,1,0,1
S01013025,All HRPs aged 16 and over,211,164,95,8,87,66,3,47,39,0,3,2,3
S01013025,Owned: Total,166,130,72,5,67,55,3,36,32,0,2,1,1
S01013025,Owned: Owned outright,94,64,23,2,21,38,3,30,29,0,0,0,1
S01013025,Owned: Owned with a mortgage or loan or shared ownership,72,66,49,3,46,17,0,6,3,0,2,1,0
S01013025,Rented or living rent free: Total,45,34,23,3,20,11,0,11,7,0,1,1,2
S01013025,Rented or living rent free: Social rented,8,3,2,2,0,1,0,5,3,0,0,0,2
S01013025,Rented or living rent free: Private rented or living rent free,37,31,21,1,20,10,0,6,4,0,1,1,0
S01013026,All HRPs aged 16 and over,410,296,256,26,230,24,16,114,76,2,6,25,5
S01013026,Owned: Total,272,215,194,8,186,19,2,57,51,0,1,3,2
S01013026,Owned: Owned outright,74,30,24,4,20,5,1,44,41,0,1,1,1
S01013026,Owned: Owned with a mortgage or loan or shared ownership,198,185,170,4,166,14,1,13,10,0,0,2,1
S01013026,Rented or living rent free: Total,138,81,62,18,44,5,14,57,25,2,5,22,3
S01013026,Rented or living rent free: Social rented,116,65,47,14,33,4,14,51,22,1,5,20,3
S01013026,Rented or living rent free: Private rented or living rent free,22,16,15,4,11,1,0,6,3,1,0,2,0
S01013027,All HRPs aged 16 and over,422,244,189,46,143,21,34,178,106,4,17,33,18
S01013027,Owned: Total,171,119,106,17,89,10,3,52,45,1,1,5,0
S01013027,Owned: Owned outright,73,36,32,7,25,3,1,37,35,0,0,2,0
S01013027,Owned: Owned with a mortgage or loan or shared ownership,98,83,74,10,64,7,2,15,10,1,1,3,0
S01013027,Rented or living rent free: Total,251,125,83,29,54,11,31,126,61,3,16,28,18
S01013027,Rented or living rent free: Social rented,225,107,72,25,47,9,26,118,60,3,15,24,16
S01013027,Rented or living rent free: Private rented or living rent free,26,18,11,4,7,2,5,8,1,0,1,4,2
S01013028,All HRPs aged 16 and over,191,149,116,13,103,31,2,42,34,0,2,5,1
S01013028,Owned: Total,137,113,84,6,78,29,0,24,22,0,0,2,0
S01013028,Owned: Owned outright,58,45,28,4,24,17,0,13,13,0,0,0,0
S01013028,Owned: Owned with a mortgage or loan or shared ownership,79,68,56,2,54,12,0,11,9,0,0,2,0
S01013028,Rented or living rent free: Total,54,36,32,7,25,2,2,18,12,0,2,3,1
S01013028,Rented or living rent free: Social rented,30,15,14,7,7,0,1,15,10,0,1,3,1
S01013028,Rented or living rent free: Private rented or living rent free,24,21,18,0,18,2,1,3,2,0,1,0,0
S01013029,All HRPs aged 16 and over,269,152,134,32,102,8,10,117,91,0,7,17,2
S01013029,Owned: Total,135,87,83,14,69,4,0,48,46,0,1,1,0
S01013029,Owned: Owned outright,64,22,21,9,12,1,0,42,41,0,0,1,0
S01013029,Owned: Owned with a mortgage or loan or shared ownership,71,65,62,5,57,3,0,6,5,0,1,0,0
S01013029,Rented or living rent free: Total,134,65,51,18,33,4,10,69,45,0,6,16,2
S01013029,Rented or living rent free: Social rented,122,57,45,18,27,4,8,65,43,0,5,16,1
S01013029,Rented or living rent free: Private rented or living rent free,12,8,6,0,6,0,2,4,2,0,1,0,1
S01013030,All HRPs aged 16 and over,225,156,133,30,103,14,9,69,44,1,12,11,1
S01013030,Owned: Total,109,85,73,12,61,11,1,24,21,0,0,2,1
S01013030,Owned: Owned outright,50,31,27,6,21,3,1,19,19,0,0,0,0
S01013030,Owned: Owned with a mortgage or loan or shared ownership,59,54,46,6,40,8,0,5,2,0,0,2,1
S01013030,Rented or living rent free: Total,116,71,60,18,42,3,8,45,23,1,12,9,0
S01013030,Rented or living rent free: Social rented,104,63,53,17,36,2,8,41,22,1,9,9,0
S01013030,Rented or living rent free: Private rented or living rent free,12,8,7,1,6,1,0,4,1,0,3,0,0
S01013031,All HRPs aged 16 and over,291,196,171,42,129,12,13,95,58,2,5,21,9
S01013031,Owned: Total,143,104,93,12,81,10,1,39,31,0,0,4,4
S01013031,Owned: Owned outright,53,23,23,6,17,0,0,30,24,0,0,2,4
S01013031,Owned: Owned with a mortgage or loan or shared ownership,90,81,70,6,64,10,1,9,7,0,0,2,0
S01013031,Rented or living rent free: Total,148,92,78,30,48,2,12,56,27,2,5,17,5
S01013031,Rented or living rent free: Social rented,131,78,67,24,43,2,9,53,26,2,4,16,5
S01013031,Rented or living rent free: Private rented or living rent free,17,14,11,6,5,0,3,3,1,0,1,1,0
S01013032,All HRPs aged 16 and over,309,271,233,27,206,34,4,38,15,1,7,13,2
S01013032,Owned: Total,244,226,191,15,176,32,3,18,11,1,2,2,2
S01013032,Owned: Owned outright,34,22,17,5,12,5,0,12,9,0,1,2,0
S01013032,Owned: Owned with a mortgage or loan or shared ownership,210,204,174,10,164,27,3,6,2,1,1,0,2
S01013032,Rented or living rent free: Total,65,45,42,12,30,2,1,20,4,0,5,11,0
S01013032,Rented or living rent free: Social rented,38,25,22,9,13,2,1,13,3,0,4,6,0
S01013032,Rented or living rent free: Private rented or living rent free,27,20,20,3,17,0,0,7,1,0,1,5,0
S01013033,All HRPs aged 16 and over,276,226,192,24,168,25,9,50,33,1,6,8,2
S01013033,Owned: Total,194,173,152,10,142,20,1,21,20,0,0,1,0
S01013033,Owned: Owned outright,32,17,15,5,10,2,0,15,15,0,0,0,0
S01013033,Owned: Owned with a mortgage or loan or shared ownership,162,156,137,5,132,18,1,6,5,0,0,1,0
S01013033,Rented or living rent free: Total,82,53,40,14,26,5,8,29,13,1,6,7,2
S01013033,Rented or living rent free: Social rented,50,31,26,10,16,1,4,19,13,0,1,5,0
S01013033,Rented or living rent free: Private rented or living rent free,32,22,14,4,10,4,4,10,0,1,5,2,2
S01013034,All HRPs aged 16 and over,296,189,167,37,130,13,9,107,78,2,8,17,2
S01013034,Owned: Total,184,125,114,21,93,11,0,59,52,0,1,5,1
S01013034,Owned: Owned outright,74,28,25,13,12,3,0,46,43,0,0,2,1
S01013034,Owned: Owned with a mortgage or loan or shared ownership,110,97,89,8,81,8,0,13,9,0,1,3,0
S01013034,Rented or living rent free: Total,112,64,53,16,37,2,9,48,26,2,7,12,1
S01013034,Rented or living rent free: Social rented,99,56,47,13,34,2,7,43,23,0,7,12,1
S01013034,Rented or living rent free: Private rented or living rent free,13,8,6,3,3,0,2,5,3,2,0,0,0
S01013035,All HRPs aged 16 and over,300,174,149,32,117,10,15,126,74,2,12,32,6
S01013035,Owned: Total,135,95,86,15,71,7,2,40,32,0,0,7,1
S01013035,Owned: Owned outright,49,24,22,4,18,1,1,25,21,0,0,3,1
S01013035,Owned: Owned with a mortgage or loan or shared ownership,86,71,64,11,53,6,1,15,11,0,0,4,0
S01013035,Rented or living rent free: Total,165,79,63,17,46,3,13,86,42,2,12,25,5
S01013035,Rented or living rent free: Social rented,154,73,58,16,42,3,12,81,39,2,11,24,5
S01013035,Rented or living rent free: Private rented or living rent free,11,6,5,1,4,0,1,5,3,0,1,1,0
S01013036,All HRPs aged 16 and over,280,188,154,34,120,21,13,92,55,4,11,19,3
S01013036,Owned: Total,126,94,80,11,69,12,2,32,29,0,0,3,0
S01013036,Owned: Owned outright,42,14,11,1,10,3,0,28,25,0,0,3,0
S01013036,Owned: Owned with a mortgage or loan or shared ownership,84,80,69,10,59,9,2,4,4,0,0,0,0
S01013036,Rented or living rent free: Total,154,94,74,23,51,9,11,60,26,4,11,16,3
S01013036,Rented or living rent free: Social rented,146,87,67,21,46,9,11,59,26,4,10,16,3
S01013036,Rented or living rent free: Private rented or living rent free,8,7,7,2,5,0,0,1,0,0,1,0,0
S01013037,All HRPs aged 16 and over,283,213,182,21,161,24,7,70,59,2,4,4,1
S01013037,Owned: Total,235,180,158,17,141,19,3,55,53,0,0,2,0
S01013037,Owned: Owned outright,98,50,42,12,30,6,2,48,46,0,0,2,0
S01013037,Owned: Owned with a mortgage or loan or shared ownership,137,130,116,5,111,13,1,7,7,0,0,0,0
S01013037,Rented or living rent free: Total,48,33,24,4,20,5,4,15,6,2,4,2,1
S01013037,Rented or living rent free: Social rented,20,10,5,1,4,2,3,10,3,1,4,2,0
S01013037,Rented or living rent free: Private rented or living rent free,28,23,19,3,16,3,1,5,3,1,0,0,1
S01013038,All HRPs aged 16 and over,434,265,227,37,190,27,11,169,120,0,10,33,6
S01013038,Owned: Total,250,174,156,18,138,16,2,76,71,0,1,3,1
S01013038,Owned: Owned outright,112,49,41,7,34,7,1,63,60,0,1,2,0
S01013038,Owned: Owned with a mortgage or loan or shared ownership,138,125,115,11,104,9,1,13,11,0,0,1,1
S01013038,Rented or living rent free: Total,184,91,71,19,52,11,9,93,49,0,9,30,5
S01013038,Rented or living rent free: Social rented,138,60,49,14,35,4,7,78,39,0,8,28,3
S01013038,Rented or living rent free: Private rented or living rent free,46,31,22,5,17,7,2,15,10,0,1,2,2
S01013039,All HRPs aged 16 and over,178,154,135,9,126,16,3,24,22,0,1,1,0
S01013039,Owned: Total,167,145,130,8,122,14,1,22,21,0,0,1,0
S01013039,Owned: Owned outright,48,32,32,5,27,0,0,16,16,0,0,0,0
S01013039,Owned: Owned with a mortgage or loan or shared ownership,119,113,98,3,95,14,1,6,5,0,0,1,0
S01013039,Rented or living rent free: Total,11,9,5,1,4,2,2,2,1,0,1,0,0
S01013039,Rented or living rent free: Social rented,4,3,1,0,1,1,1,1,1,0,0,0,0
S01013039,Rented or living rent free: Private rented or living rent free,7,6,4,1,3,1,1,1,0,0,1,0,0
S01013040,All HRPs aged 16 and over,324,183,150,24,126,24,9,141,124,1,3,12,1
S01013040,Owned: Total,202,129,109,18,91,18,2,73,73,0,0,0,0
S01013040,Owned: Owned outright,102,37,26,6,20,10,1,65,65,0,0,0,0
S01013040,Owned: Owned with a mortgage or loan or shared ownership,100,92,83,12,71,8,1,8,8,0,0,0,0
S01013040,Rented or living rent free: Total,122,54,41,6,35,6,7,68,51,1,3,12,1
S01013040,Rented or living rent free: Social rented,82,24,18,3,15,3,3,58,45,1,2,10,0
S01013040,Rented or living rent free: Private rented or living rent free,40,30,23,3,20,3,4,10,6,0,1,2,1
S01013041,All HRPs aged 16 and over,257,192,166,24,142,20,6,65,52,2,2,8,1
S01013041,Owned: Total,171,138,122,11,111,15,1,33,30,0,2,1,0
S01013041,Owned: Owned outright,56,33,29,2,27,4,0,23,22,0,1,0,0
S01013041,Owned: Owned with a mortgage or loan or shared ownership,115,105,93,9,84,11,1,10,8,0,1,1,0
S01013041,Rented or living rent free: Total,86,54,44,13,31,5,5,32,22,2,0,7,1
S01013041,Rented or living rent free: Social rented,54,30,25,10,15,3,2,24,18,1,0,4,1
S01013041,Rented or living rent free: Private rented or living rent free,32,24,19,3,16,2,3,8,4,1,0,3,0
S01013042,All HRPs aged 16 and over,318,237,186,27,159,43,8,81,54,0,7,14,6
S01013042,Owned: Total,220,186,146,18,128,37,3,34,29,0,1,2,2
S01013042,Owned: Owned outright,59,32,23,5,18,7,2,27,25,0,1,1,0
S01013042,Owned: Owned with a mortgage or loan or shared ownership,161,154,123,13,110,30,1,7,4,0,0,1,2
S01013042,Rented or living rent free: Total,98,51,40,9,31,6,5,47,25,0,6,12,4
S01013042,Rented or living rent free: Social rented,70,33,29,9,20,1,3,37,17,0,4,12,4
S01013042,Rented or living rent free: Private rented or living rent free,28,18,11,0,11,5,2,10,8,0,2,0,0
S01013043,All HRPs aged 16 and over,278,173,141,33,108,19,13,105,76,1,8,17,3
S01013043,Owned: Total,134,84,71,10,61,13,0,50,44,0,1,4,1
S01013043,Owned: Owned outright,63,22,19,2,17,3,0,41,38,0,1,2,0
S01013043,Owned: Owned with a mortgage or loan or shared ownership,71,62,52,8,44,10,0,9,6,0,0,2,1
S01013043,Rented or living rent free: Total,144,89,70,23,47,6,13,55,32,1,7,13,2
S01013043,Rented or living rent free: Social rented,128,79,63,21,42,5,11,49,29,0,6,12,2
S01013043,Rented or living rent free: Private rented or living rent free,16,10,7,2,5,1,2,6,3,1,1,1,0
S01013044,All HRPs aged 16 and over,323,209,183,35,148,18,8,114,80,3,10,14,7
S01013044,Owned: Total,184,129,118,18,100,9,2,55,48,1,1,2,3
S01013044,Owned: Owned outright,75,33,28,4,24,5,0,42,39,1,1,0,1
S01013044,Owned: Owned with a mortgage or loan or shared ownership,109,96,90,14,76,4,2,13,9,0,0,2,2
S01013044,Rented or living rent free: Total,139,80,65,17,48,9,6,59,32,2,9,12,4
S01013044,Rented or living rent free: Social rented,113,64,51,15,36,8,5,49,25,0,8,12,4
S01013044,Rented or living rent free: Private rented or living rent free,26,16,14,2,12,1,1,10,7,2,1,0,0
S01013045,All HRPs aged 16 and over,277,195,166,15,151,22,7,82,60,1,6,12,3
S01013045,Owned: Total,185,144,124,10,114,19,1,41,37,0,1,0,3
S01013045,Owned: Owned outright,56,29,22,8,14,7,0,27,26,0,0,0,1
S01013045,Owned: Owned with a mortgage or loan or shared ownership,129,115,102,2,100,12,1,14,11,0,1,0,2
S01013045,Rented or living rent free: Total,92,51,42,5,37,3,6,41,23,1,5,12,0
S01013045,Rented or living rent free: Social rented,65,33,27,3,24,2,4,32,17,0,4,11,0
S01013045,Rented or living rent free: Private rented or living rent free,27,18,15,2,13,1,2,9,6,1,1,1,0
S01013046,All HRPs aged 16 and over,214,127,118,29,89,8,1,87,62,0,6,16,3
S01013046,Owned: Total,120,79,76,15,61,3,0,41,37,0,0,2,2
S01013046,Owned: Owned outright,45,15,15,3,12,0,0,30,30,0,0,0,0
S01013046,Owned: Owned with a mortgage or loan or shared ownership,75,64,61,12,49,3,0,11,7,0,0,2,2
S01013046,Rented or living rent free: Total,94,48,42,14,28,5,1,46,25,0,6,14,1
S01013046,Rented or living rent free: Social rented,78,38,35,11,24,2,1,40,21,0,5,13,1
S01013046,Rented or living rent free: Private rented or living rent free,16,10,7,3,4,3,0,6,4,0,1,1,0
S01013047,All HRPs aged 16 and over,350,300,273,26,247,27,0,50,41,1,3,4,1
S01013047,Owned: Total,326,283,257,23,234,26,0,43,39,0,2,1,1
S01013047,Owned: Owned outright,85,50,44,11,33,6,0,35,32,0,1,1,1
S01013047,Owned: Owned with a mortgage or loan or shared ownership,241,233,213,12,201,20,0,8,7,0,1,0,0
S01013047,Rented or living rent free: Total,24,17,16,3,13,1,0,7,2,1,1,3,0
S01013047,Rented or living rent free: Social rented,7,2,2,1,1,0,0,5,1,0,1,3,0
S01013047,Rented or living rent free: Private rented or living rent free,17,15,14,2,12,1,0,2,1,1,0,0,0
S01013048,All HRPs aged 16 and over,401,331,301,28,273,18,12,70,59,4,2,4,1
S01013048,Owned: Total,302,251,236,19,217,12,3,51,47,1,0,2,1
S01013048,Owned: Owned outright,98,52,49,9,40,3,0,46,44,0,0,1,1
S01013048,Owned: Owned with a mortgage or loan or shared ownership,204,199,187,10,177,9,3,5,3,1,0,1,0
S01013048,Rented or living rent free: Total,99,80,65,9,56,6,9,19,12,3,2,2,0
S01013048,Rented or living rent free: Social rented,5,3,3,1,2,0,0,2,0,0,1,1,0
S01013048,Rented or living rent free: Private rented or living rent free,94,77,62,8,54,6,9,17,12,3,1,1,0
S01013049,All HRPs aged 16 and over,354,263,236,25,211,23,4,91,85,1,0,4,1
S01013049,Owned: Total,317,234,211,21,190,19,4,83,81,0,0,1,1
S01013049,Owned: Owned outright,144,65,60,11,49,5,0,79,77,0,0,1,1
S01013049,Owned: Owned with a mortgage or loan or shared ownership,173,169,151,10,141,14,4,4,4,0,0,0,0
S01013049,Rented or living rent free: Total,37,29,25,4,21,4,0,8,4,1,0,3,0
S01013049,Rented or living rent free: Social rented,8,5,4,1,3,1,0,3,1,0,0,2,0
S01013049,Rented or living rent free: Private rented or living rent free,29,24,21,3,18,3,0,5,3,1,0,1,0
S01013050,All HRPs aged 16 and over,351,201,166,19,147,22,13,150,103,2,11,31,3
S01013050,Owned: Total,197,128,108,7,101,18,2,69,63,0,0,4,2
S01013050,Owned: Owned outright,90,40,34,4,30,6,0,50,46,0,0,2,2
S01013050,Owned: Owned with a mortgage or loan or shared ownership,107,88,74,3,71,12,2,19,17,0,0,2,0
S01013050,Rented or living rent free: Total,154,73,58,12,46,4,11,81,40,2,11,27,1
S01013050,Rented or living rent free: Social rented,120,49,38,8,30,2,9,71,37,0,8,25,1
S01013050,Rented or living rent free: Private rented or living rent free,34,24,20,4,16,2,2,10,3,2,3,2,0
S01013051,All HRPs aged 16 and over,422,245,203,39,164,26,16,177,126,2,11,34,4
S01013051,Owned: Total,255,174,152,19,133,22,0,81,74,1,0,5,1
S01013051,Owned: Owned outright,101,33,28,10,18,5,0,68,64,0,0,3,1
S01013051,Owned: Owned with a mortgage or loan or shared ownership,154,141,124,9,115,17,0,13,10,1,0,2,0
S01013051,Rented or living rent free: Total,167,71,51,20,31,4,16,96,52,1,11,29,3
S01013051,Rented or living rent free: Social rented,135,50,35,14,21,3,12,85,47,0,8,28,2
S01013051,Rented or living rent free: Private rented or living rent free,32,21,16,6,10,1,4,11,5,1,3,1,1
S01013052,All HRPs aged 16 and over,391,199,169,30,139,18,12,192,145,1,6,31,9
S01013052,Owned: Total,244,142,130,17,113,12,0,102,97,0,0,3,2
S01013052,Owned: Owned outright,119,31,26,6,20,5,0,88,85,0,0,3,0
S01013052,Owned: Owned with a mortgage or loan or shared ownership,125,111,104,11,93,7,0,14,12,0,0,0,2
S01013052,Rented or living rent free: Total,147,57,39,13,26,6,12,90,48,1,6,28,7
S01013052,Rented or living rent free: Social rented,113,30,20,9,11,3,7,83,44,1,6,25,7
S01013052,Rented or living rent free: Private rented or living rent free,34,27,19,4,15,3,5,7,4,0,0,3,0
S01013053,All HRPs aged 16 and over,337,179,143,29,114,20,16,158,93,1,9,40,15
S01013053,Owned: Total,130,92,75,10,65,13,4,38,36,0,0,2,0
S01013053,Owned: Owned outright,59,30,23,3,20,4,3,29,29,0,0,0,0
S01013053,Owned: Owned with a mortgage or loan or shared ownership,71,62,52,7,45,9,1,9,7,0,0,2,0
S01013053,Rented or living rent free: Total,207,87,68,19,49,7,12,120,57,1,9,38,15
S01013053,Rented or living rent free: Social rented,162,55,46,13,33,2,7,107,51,1,6,35,14
S01013053,Rented or living rent free: Private rented or living rent free,45,32,22,6,16,5,5,13,6,0,3,3,1
S01013054,All HRPs aged 16 and over,305,178,154,24,130,21,3,127,107,2,2,12,4
S01013054,Owned: Total,230,131,114,13,101,17,0,99,94,2,0,2,1
S01013054,Owned: Owned outright,107,28,23,7,16,5,0,79,77,0,0,1,1
S01013054,Owned: Owned with a mortgage or loan or shared ownership,123,103,91,6,85,12,0,20,17,2,0,1,0
S01013054,Rented or living rent free: Total,75,47,40,11,29,4,3,28,13,0,2,10,3
S01013054,Rented or living rent free: Social rented,54,31,26,4,22,2,3,23,10,0,1,9,3
S01013054,Rented or living rent free: Private rented or living rent free,21,16,14,7,7,2,0,5,3,0,1,1,0
S01013055,All HRPs aged 16 and over,336,187,149,27,122,27,11,149,110,2,5,30,2
S01013055,Owned: Total,192,119,100,8,92,18,1,73,66,1,0,6,0
S01013055,Owned: Owned outright,89,29,22,3,19,6,1,60,54,0,0,6,0
S01013055,Owned: Owned with a mortgage or loan or shared ownership,103,90,78,5,73,12,0,13,12,1,0,0,0
S01013055,Rented or living rent free: Total,144,68,49,19,30,9,10,76,44,1,5,24,2
S01013055,Rented or living rent free: Social rented,98,41,29,12,17,6,6,57,33,0,4,19,1
S01013055,Rented or living rent free: Private rented or living rent free,46,27,20,7,13,3,4,19,11,1,1,5,1
S01013056,All HRPs aged 16 and over,431,244,195,38,157,37,12,187,130,2,10,36,9
S01013056,Owned: Total,251,154,121,16,105,31,2,97,89,0,0,6,2
S01013056,Owned: Owned outright,113,39,33,6,27,6,0,74,70,0,0,3,1
S01013056,Owned: Owned with a mortgage or loan or shared ownership,138,115,88,10,78,25,2,23,19,0,0,3,1
S01013056,Rented or living rent free: Total,180,90,74,22,52,6,10,90,41,2,10,30,7
S01013056,Rented or living rent free: Social rented,150,71,59,18,41,5,7,79,34,2,9,28,6
S01013056,Rented or living rent free: Private rented or living rent free,30,19,15,4,11,1,3,11,7,0,1,2,1
S01013057,All HRPs aged 16 and over,369,225,169,47,122,21,35,144,62,1,15,53,13
S01013057,Owned: Total,128,89,74,13,61,13,2,39,35,0,1,1,2
S01013057,Owned: Owned outright,51,21,17,5,12,3,1,30,28,0,0,0,2
S01013057,Owned: Owned with a mortgage or loan or shared ownership,77,68,57,8,49,10,1,9,7,0,1,1,0
S01013057,Rented or living rent free: Total,241,136,95,34,61,8,33,105,27,1,14,52,11
S01013057,Rented or living rent free: Social rented,223,125,88,32,56,5,32,98,25,1,10,52,10
S01013057,Rented or living rent free: Private rented or living rent free,18,11,7,2,5,3,1,7,2,0,4,0,1
S01013058,All HRPs aged 16 and over,213,188,165,11,154,21,2,25,17,3,2,2,1
S01013058,Owned: Total,174,158,140,6,134,18,0,16,15,1,0,0,0
S01013058,Owned: Owned outright,32,20,14,2,12,6,0,12,12,0,0,0,0
S01013058,Owned: Owned with a mortgage or loan or shared ownership,142,138,126,4,122,12,0,4,3,1,0,0,0
S01013058,Rented or living rent free: Total,39,30,25,5,20,3,2,9,2,2,2,2,1
S01013058,Rented or living rent free: Social rented,22,18,16,4,12,1,1,4,1,0,1,2,0
S01013058,Rented or living rent free: Private rented or living rent free,17,12,9,1,8,2,1,5,1,2,1,0,1
S01013059,All HRPs aged 16 and over,406,195,153,12,141,32,10,211,185,5,7,5,9
S01013059,Owned: Total,332,147,116,8,108,26,5,185,174,1,3,1,6
S01013059,Owned: Owned outright,225,52,37,6,31,12,3,173,164,1,3,1,4
S01013059,Owned: Owned with a mortgage or loan or shared ownership,107,95,79,2,77,14,2,12,10,0,0,0,2
S01013059,Rented or living rent free: Total,74,48,37,4,33,6,5,26,11,4,4,4,3
S01013059,Rented or living rent free: Social rented,13,5,3,0,3,0,2,8,3,0,1,4,0
S01013059,Rented or living rent free: Private rented or living rent free,61,43,34,4,30,6,3,18,8,4,3,0,3
S01013060,All HRPs aged 16 and over,227,149,115,17,98,28,6,78,74,0,1,3,0
S01013060,Owned: Total,189,119,91,9,82,26,2,70,67,0,1,2,0
S01013060,Owned: Owned outright,100,40,25,5,20,14,1,60,58,0,1,1,0
S01013060,Owned: Owned with a mortgage or loan or shared ownership,89,79,66,4,62,12,1,10,9,0,0,1,0
S01013060,Rented or living rent free: Total,38,30,24,8,16,2,4,8,7,0,0,1,0
S01013060,Rented or living rent free: Social rented,8,3,2,1,1,0,1,5,4,0,0,1,0
S01013060,Rented or living rent free: Private rented or living rent free,30,27,22,7,15,2,3,3,3,0,0,0,0
S01013061,All HRPs aged 16 and over,362,197,168,27,141,27,2,165,161,3,0,0,1
S01013061,Owned: Total,340,179,155,27,128,23,1,161,161,0,0,0,0
S01013061,Owned: Owned outright,222,69,61,24,37,8,0,153,153,0,0,0,0
S01013061,Owned: Owned with a mortgage or loan or shared ownership,118,110,94,3,91,15,1,8,8,0,0,0,0
S01013061,Rented or living rent free: Total,22,18,13,0,13,4,1,4,0,3,0,0,1
S01013061,Rented or living rent free: Social rented,0,0,0,0,0,0,0,0,0,0,0,0,0
S01013061,Rented or living rent free: Private rented or living rent free,22,18,13,0,13,4,1,4,0,3,0,0,1
S01013062,All HRPs aged 16 and over,403,231,177,20,157,52,2,172,155,9,1,3,4
S01013062,Owned: Total,323,166,119,15,104,45,2,157,147,3,1,2,4
S01013062,Owned: Owned outright,211,64,39,11,28,23,2,147,138,3,0,2,4
S01013062,Owned: Owned with a mortgage or loan or shared ownership,112,102,80,4,76,22,0,10,9,0,1,0,0
S01013062,Rented or living rent free: Total,80,65,58,5,53,7,0,15,8,6,0,1,0
S01013062,Rented or living rent free: Social rented,3,2,1,0,1,1,0,1,0,0,0,1,0
S01013062,Rented or living rent free: Private rented or living rent free,77,63,57,5,52,6,0,14,8,6,0,0,0
S01013063,All HRPs aged 16 and over,371,230,175,30,145,47,8,141,128,4,2,3,4
S01013063,Owned: Total,275,169,128,13,115,38,3,106,99,1,2,1,3
S01013063,Owned: Owned outright,160,63,45,10,35,16,2,97,91,0,2,1,3
S01013063,Owned: Owned with a mortgage or loan or shared ownership,115,106,83,3,80,22,1,9,8,1,0,0,0
S01013063,Rented or living rent free: Total,96,61,47,17,30,9,5,35,29,3,0,2,1
S01013063,Rented or living rent free: Social rented,43,16,12,6,6,2,2,27,25,0,0,2,0
S01013063,Rented or living rent free: Private rented or living rent free,53,45,35,11,24,7,3,8,4,3,0,0,1
S01013064,All HRPs aged 16 and over,386,211,172,28,144,30,9,175,140,5,3,20,7
S01013064,Owned: Total,247,161,133,13,120,24,4,86,83,2,0,0,1
S01013064,Owned: Owned outright,112,40,29,7,22,10,1,72,72,0,0,0,0
S01013064,Owned: Owned with a mortgage or loan or shared ownership,135,121,104,6,98,14,3,14,11,2,0,0,1
S01013064,Rented or living rent free: Total,139,50,39,15,24,6,5,89,57,3,3,20,6
S01013064,Rented or living rent free: Social rented,109,28,21,10,11,3,4,81,53,2,1,20,5
S01013064,Rented or living rent free: Private rented or living rent free,30,22,18,5,13,3,1,8,4,1,2,0,1
S01013065,All HRPs aged 16 and over,415,237,198,40,158,22,17,178,125,6,9,29,9
S01013065,Owned: Total,206,132,116,14,102,15,1,74,69,1,0,4,0
S01013065,Owned: Owned outright,90,30,25,7,18,4,1,60,57,1,0,2,0
S01013065,Owned: Owned with a mortgage or loan or shared ownership,116,102,91,7,84,11,0,14,12,0,0,2,0
S01013065,Rented or living rent free: Total,209,105,82,26,56,7,16,104,56,5,9,25,9
S01013065,Rented or living rent free: Social rented,133,49,37,13,24,3,9,84,47,1,8,24,4
S01013065,Rented or living rent free: Private rented or living rent free,76,56,45,13,32,4,7,20,9,4,1,1,5
S01013066,All HRPs aged 16 and over,347,247,191,35,156,29,27,100,65,3,3,22,7
S01013066,Owned: Total,195,150,128,11,117,20,2,45,39,1,1,2,2
S01013066,Owned: Owned outright,74,35,27,3,24,8,0,39,35,1,0,1,2
S01013066,Owned: Owned with a mortgage or loan or shared ownership,121,115,101,8,93,12,2,6,4,0,1,1,0
S01013066,Rented or living rent free: Total,152,97,63,24,39,9,25,55,26,2,2,20,5
S01013066,Rented or living rent free: Social rented,92,49,28,7,21,2,19,43,20,0,1,19,3
S01013066,Rented or living rent free: Private rented or living rent free,60,48,35,17,18,7,6,12,6,2,1,1,2
S01013067,All HRPs aged 16 and over,396,295,242,87,155,23,30,101,16,58,4,18,5
S01013067,Owned: Total,82,68,54,13,41,12,2,14,6,5,0,2,1
S01013067,Owned: Owned outright,24,12,6,4,2,5,1,12,6,3,0,2,1
S01013067,Owned: Owned with a mortgage or loan or shared ownership,58,56,48,9,39,7,1,2,0,2,0,0,0
S01013067,Rented or living rent free: Total,314,227,188,74,114,11,28,87,10,53,4,16,4
S01013067,Rented or living rent free: Social rented,61,30,18,5,13,4,8,31,5,9,2,13,2
S01013067,Rented or living rent free: Private rented or living rent free,253,197,170,69,101,7,20,56,5,44,2,3,2
S01013068,All HRPs aged 16 and over,406,265,197,64,133,18,50,141,53,24,9,45,10
S01013068,Owned: Total,83,65,55,11,44,9,1,18,12,2,1,2,1
S01013068,Owned: Owned outright,36,23,20,6,14,2,1,13,10,2,0,1,0
S01013068,Owned: Owned with a mortgage or loan or shared ownership,47,42,35,5,30,7,0,5,2,0,1,1,1
S01013068,Rented or living rent free: Total,323,200,142,53,89,9,49,123,41,22,8,43,9
S01013068,Rented or living rent free: Social rented,188,97,53,19,34,5,39,91,36,4,6,37,8
S01013068,Rented or living rent free: Private rented or living rent free,135,103,89,34,55,4,10,32,5,18,2,6,1
S01013069,All HRPs aged 16 and over,350,253,204,79,125,13,36,97,20,42,4,23,8
S01013069,Owned: Total,99,79,67,15,52,11,1,20,13,3,0,3,1
S01013069,Owned: Owned outright,49,34,25,10,15,8,1,15,12,0,0,3,0
S01013069,Owned: Owned with a mortgage or loan or shared ownership,50,45,42,5,37,3,0,5,1,3,0,0,1
S01013069,Rented or living rent free: Total,251,174,137,64,73,2,35,77,7,39,4,20,7
S01013069,Rented or living rent free: Social rented,76,42,28,10,18,1,13,34,6,3,2,16,7
S01013069,Rented or living rent free: Private rented or living rent free,175,132,109,54,55,1,22,43,1,36,2,4,0
S01013070,All HRPs aged 16 and over,301,193,159,63,96,12,22,108,31,45,7,16,9
S01013070,Owned: Total,69,53,46,7,39,7,0,16,11,4,0,0,1
S01013070,Owned: Owned outright,23,12,8,1,7,4,0,11,7,3,0,0,1
S01013070,Owned: Owned with a mortgage or loan or shared ownership,46,41,38,6,32,3,0,5,4,1,0,0,0
S01013070,Rented or living rent free: Total,232,140,113,56,57,5,22,92,20,41,7,16,8
S01013070,Rented or living rent free: Social rented,107,62,43,21,22,4,15,45,16,3,5,15,6
S01013070,Rented or living rent free: Private rented or living rent free,125,78,70,35,35,1,7,47,4,38,2,1,2
S01013071,All HRPs aged 16 and over,359,264,219,86,133,14,31,95,16,55,2,16,6
S01013071,Owned: Total,90,74,62,12,50,9,3,16,10,3,1,1,1
S01013071,Owned: Owned outright,30,17,16,3,13,1,0,13,8,2,1,1,1
S01013071,Owned: Owned with a mortgage or loan or shared ownership,60,57,46,9,37,8,3,3,2,1,0,0,0
S01013071,Rented or living rent free: Total,269,190,157,74,83,5,28,79,6,52,1,15,5
S01013071,Rented or living rent free: Social rented,35,15,7,2,5,0,8,20,4,5,1,5,5
S01013071,Rented or living rent free: Private rented or living rent free,234,175,150,72,78,5,20,59,2,47,0,10,0
S01013072,All HRPs aged 16 and over,227,121,101,25,76,8,12,106,66,0,7,28,5
S01013072,Owned: Total,50,27,23,2,21,4,0,23,20,0,0,2,1
S01013072,Owned: Owned outright,25,7,6,2,4,1,0,18,16,0,0,2,0
S01013072,Owned: Owned with a mortgage or loan or shared ownership,25,20,17,0,17,3,0,5,4,0,0,0,1
S01013072,Rented or living rent free: Total,177,94,78,23,55,4,12,83,46,0,7,26,4
S01013072,Rented or living rent free: Social rented,172,89,73,21,52,4,12,83,46,0,7,26,4
S01013072,Rented or living rent free: Private rented or living rent free,5,5,5,2,3,0,0,0,0,0,0,0,0
S01013073,All HRPs aged 16 and over,352,240,205,52,153,12,23,112,38,12,17,36,9
S01013073,Owned: Total,118,107,100,7,93,7,0,11,9,0,0,1,1
S01013073,Owned: Owned outright,23,15,10,4,6,5,0,8,8,0,0,0,0
S01013073,Owned: Owned with a mortgage or loan or shared ownership,95,92,90,3,87,2,0,3,1,0,0,1,1
S01013073,Rented or living rent free: Total,234,133,105,45,60,5,23,101,29,12,17,35,8
S01013073,Rented or living rent free: Social rented,193,102,82,35,47,3,17,91,29,2,17,35,8
S01013073,Rented or living rent free: Private rented or living rent free,41,31,23,10,13,2,6,10,0,10,0,0,0
S01013074,All HRPs aged 16 and over,302,167,116,41,75,23,28,135,65,6,18,41,5
S01013074,Owned: Total,64,42,32,5,27,10,0,22,21,1,0,0,0
S01013074,Owned: Owned outright,35,18,15,3,12,3,0,17,16,1,0,0,0
S01013074,Owned: Owned with a mortgage or loan or shared ownership,29,24,17,2,15,7,0,5,5,0,0,0,0
S01013074,Rented or living rent free: Total,238,125,84,36,48,13,28,113,44,5,18,41,5
S01013074,Rented or living rent free: Social rented,219,111,76,34,42,11,24,108,44,2,16,41,5
S01013074,Rented or living rent free: Private rented or living rent free,19,14,8,2,6,2,4,5,0,3,2,0,0
S01013075,All HRPs aged 16 and over,481,209,160,42,118,21,28,272,147,19,13,68,25
S01013075,Owned: Total,125,78,67,11,56,10,1,47,42,2,0,3,0
S01013075,Owned: Owned outright,63,33,27,7,20,6,0,30,27,2,0,1,0
S01013075,Owned: Owned with a mortgage or loan or shared ownership,62,45,40,4,36,4,1,17,15,0,0,2,0
S01013075,Rented or living rent free: Total,356,131,93,31,62,11,27,225,105,17,13,65,25
S01013075,Rented or living rent free: Social rented,309,105,77,28,49,5,23,204,102,6,11,61,24
S01013075,Rented or living rent free: Private rented or living rent free,47,26,16,3,13,6,4,21,3,11,2,4,1
S01013076,All HRPs aged 16 and over,172,135,109,22,87,22,4,37,21,8,1,5,2
S01013076,Owned: Total,112,93,76,13,63,17,0,19,16,0,0,3,0
S01013076,Owned: Owned outright,38,24,22,5,17,2,0,14,13,0,0,1,0
S01013076,Owned: Owned with a mortgage or loan or shared ownership,74,69,54,8,46,15,0,5,3,0,0,2,0
S01013076,Rented or living rent free: Total,60,42,33,9,24,5,4,18,5,8,1,2,2
S01013076,Rented or living rent free: Social rented,17,10,6,0,6,1,3,7,4,0,0,1,2
S01013076,Rented or living rent free: Private rented or living rent free,43,32,27,9,18,4,1,11,1,8,1,1,0
S01013077,All HRPs aged 16 and over,297,163,130,38,92,7,26,134,80,6,9,27,12
S01013077,Owned: Total,137,77,70,13,57,5,2,60,51,2,0,4,3
S01013077,Owned: Owned outright,67,20,18,7,11,2,0,47,43,0,0,2,2
S01013077,Owned: Owned with a mortgage or loan or shared ownership,70,57,52,6,46,3,2,13,8,2,0,2,1
S01013077,Rented or living rent free: Total,160,86,60,25,35,2,24,74,29,4,9,23,9
S01013077,Rented or living rent free: Social rented,140,72,48,18,30,2,22,68,27,2,8,22,9
S01013077,Rented or living rent free: Private rented or living rent free,20,14,12,7,5,0,2,6,2,2,1,1,0
S01013078,All HRPs aged 16 and over,252,151,123,38,85,10,18,101,39,5,13,36,8
S01013078,Owned: Total,67,48,40,5,35,7,1,19,16,0,0,1,2
S01013078,Owned: Owned outright,26,12,10,1,9,2,0,14,13,0,0,0,1
S01013078,Owned: Owned with a mortgage or loan or shared ownership,41,36,30,4,26,5,1,5,3,0,0,1,1
S01013078,Rented or living rent free: Total,185,103,83,33,50,3,17,82,23,5,13,35,6
S01013078,Rented or living rent free: Social rented,173,96,78,33,45,3,15,77,21,2,13,35,6
S01013078,Rented or living rent free: Private rented or living rent free,12,7,5,0,5,0,2,5,2,3,0,0,0
S01013079,All HRPs aged 16 and over,376,314,257,24,233,46,11,62,41,8,5,7,1
S01013079,Owned: Total,297,260,218,14,204,40,2,37,35,1,1,0,0
S01013079,Owned: Owned outright,76,49,35,4,31,12,2,27,27,0,0,0,0
S01013079,Owned: Owned with a mortgage or loan or shared ownership,221,211,183,10,173,28,0,10,8,1,1,0,0
S01013079,Rented or living rent free: Total,79,54,39,10,29,6,9,25,6,7,4,7,1
S01013079,Rented or living rent free: Social rented,45,28,20,6,14,0,8,17,5,1,4,6,1
S01013079,Rented or living rent free: Private rented or living rent free,34,26,19,4,15,6,1,8,1,6,0,1,0
S01013080,All HRPs aged 16 and over,374,232,190,35,155,40,2,142,117,16,4,2,3
S01013080,Owned: Total,230,155,122,12,110,32,1,75,63,8,2,1,1
S01013080,Owned: Owned outright,112,49,36,7,29,13,0,63,55,6,1,1,0
S01013080,Owned: Owned with a mortgage or loan or shared ownership,118,106,86,5,81,19,1,12,8,2,1,0,1
S01013080,Rented or living rent free: Total,144,77,68,23,45,8,1,67,54,8,2,1,2
S01013080,Rented or living rent free: Social rented,64,13,11,4,7,2,0,51,48,0,1,1,1
S01013080,Rented or living rent free: Private rented or living rent free,80,64,57,19,38,6,1,16,6,8,1,0,1
S01013081,All HRPs aged 16 and over,280,183,145,13,132,33,5,97,92,0,0,3,2
S01013081,Owned: Total,256,163,127,8,119,32,4,93,90,0,0,1,2
S01013081,Owned: Owned outright,152,64,45,7,38,15,4,88,86,0,0,1,1
S01013081,Owned: Owned with a mortgage or loan or shared ownership,104,99,82,1,81,17,0,5,4,0,0,0,1
S01013081,Rented or living rent free: Total,24,20,18,5,13,1,1,4,2,0,0,2,0
S01013081,Rented or living rent free: Social rented,5,4,3,2,1,0,1,1,0,0,0,1,0
S01013081,Rented or living rent free: Private rented or living rent free,19,16,15,3,12,1,0,3,2,0,0,1,0
S01013082,All HRPs aged 16 and over,394,243,211,23,188,31,1,151,136,4,1,6,4
S01013082,Owned: Total,362,227,195,18,177,31,1,135,130,1,0,4,0
S01013082,Owned: Owned outright,207,85,71,11,60,13,1,122,118,1,0,3,0
S01013082,Owned: Owned with a mortgage or loan or shared ownership,155,142,124,7,117,18,0,13,12,0,0,1,0
S01013082,Rented or living rent free: Total,32,16,16,5,11,0,0,16,6,3,1,2,4
S01013082,Rented or living rent free: Social rented,5,0,0,0,0,0,0,5,2,0,0,1,2
S01013082,Rented or living rent free: Private rented or living rent free,27,16,16,5,11,0,0,11,4,3,1,1,2
S01013083,All HRPs aged 16 and over,187,122,101,9,92,21,0,65,59,4,0,1,1
S01013083,Owned: Total,163,108,88,8,80,20,0,55,54,0,0,1,0
S01013083,Owned: Owned outright,84,31,24,4,20,7,0,53,53,0,0,0,0
S01013083,Owned: Owned with a mortgage or loan or shared ownership,79,77,64,4,60,13,0,2,1,0,0,1,0
S01013083,Rented or living rent free: Total,24,14,13,1,12,1,0,10,5,4,0,0,1
S01013083,Rented or living rent free: Social rented,4,1,1,0,1,0,0,3,1,1,0,0,1
S01013083,Rented or living rent free: Private rented or living rent free,20,13,12,1,11,1,0,7,4,3,0,0,0
S01013084,All HRPs aged 16 and over,307,183,144,20,124,39,0,124,119,0,2,2,1
S01013084,Owned: Total,289,171,134,18,116,37,0,118,116,0,0,1,1
S01013084,Owned: Owned outright,172,60,45,15,30,15,0,112,111,0,0,0,1
S01013084,Owned: Owned with a mortgage or loan or shared ownership,117,111,89,3,86,22,0,6,5,0,0,1,0
S01013084,Rented or living rent free: Total,18,12,10,2,8,2,0,6,3,0,2,1,0
S01013084,Rented or living rent free: Social rented,2,1,1,0,1,0,0,1,0,0,1,0,0
S01013084,Rented or living rent free: Private rented or living rent free,16,11,9,2,7,2,0,5,3,0,1,1,0
S01013085,All HRPs aged 16 and over,259,120,98,10,88,17,5,139,122,2,4,10,1
S01013085,Owned: Total,133,81,65,7,58,13,3,52,49,0,1,1,1
S01013085,Owned: Owned outright,64,23,16,2,14,4,3,41,39,0,0,1,1
S01013085,Owned: Owned with a mortgage or loan or shared ownership,69,58,49,5,44,9,0,11,10,0,1,0,0
S01013085,Rented or living rent free: Total,126,39,33,3,30,4,2,87,73,2,3,9,0
S01013085,Rented or living rent free: Social rented,98,21,17,3,14,2,2,77,66,0,2,9,0
S01013085,Rented or living rent free: Private rented or living rent free,28,18,16,0,16,2,0,10,7,2,1,0,0
S01013086,All HRPs aged 16 and over,448,290,231,44,187,46,13,158,110,33,3,3,9
S01013086,Owned: Total,253,162,118,18,100,38,6,91,86,2,1,0,2
S01013086,Owned: Owned outright,154,68,46,11,35,19,3,86,81,2,1,0,2
S01013086,Owned: Owned with a mortgage or loan or shared ownership,99,94,72,7,65,19,3,5,5,0,0,0,0
S01013086,Rented or living rent free: Total,195,128,113,26,87,8,7,67,24,31,2,3,7
S01013086,Rented or living rent free: Social rented,42,21,15,4,11,1,5,21,11,5,0,3,2
S01013086,Rented or living rent free: Private rented or living rent free,153,107,98,22,76,7,2,46,13,26,2,0,5
S01013087,All HRPs aged 16 and over,327,220,149,20,129,61,10,107,79,20,3,3,2
S01013087,Owned: Total,255,176,115,13,102,56,5,79,75,1,1,1,1
S01013087,Owned: Owned outright,165,94,53,10,43,36,5,71,69,1,0,1,0
S01013087,Owned: Owned with a mortgage or loan or shared ownership,90,82,62,3,59,20,0,8,6,0,1,0,1
S01013087,Rented or living rent free: Total,72,44,34,7,27,5,5,28,4,19,2,2,1
S01013087,Rented or living rent free: Social rented,5,3,3,3,0,0,0,2,1,0,0,1,0
S01013087,Rented or living rent free: Private rented or living rent free,67,41,31,4,27,5,5,26,3,19,2,1,1
S01013088,All HRPs aged 16 and over,388,252,179,25,154,68,5,136,126,5,1,1,3
S01013088,Owned: Total,342,219,156,21,135,59,4,123,120,0,1,0,2
S01013088,Owned: Owned outright,212,96,61,16,45,32,3,116,113,0,1,0,2
S01013088,Owned: Owned with a mortgage or loan or shared ownership,130,123,95,5,90,27,1,7,7,0,0,0,0
S01013088,Rented or living rent free: Total,46,33,23,4,19,9,1,13,6,5,0,1,1
S01013088,Rented or living rent free: Social rented,7,5,3,0,3,1,1,2,1,0,0,1,0
S01013088,Rented or living rent free: Private rented or living rent free,39,28,20,4,16,8,0,11,5,5,0,0,1
S01013089,All HRPs aged 16 and over,359,203,172,24,148,22,9,156,124,11,3,10,8
S01013089,Owned: Total,235,133,111,13,98,19,3,102,97,2,0,2,1
S01013089,Owned: Owned outright,131,42,35,9,26,7,0,89,86,1,0,1,1
S01013089,Owned: Owned with a mortgage or loan or shared ownership,104,91,76,4,72,12,3,13,11,1,0,1,0
S01013089,Rented or living rent free: Total,124,70,61,11,50,3,6,54,27,9,3,8,7
S01013089,Rented or living rent free: Social rented,64,27,21,2,19,1,5,37,18,2,3,7,7
S01013089,Rented or living rent free: Private rented or living rent free,60,43,40,9,31,2,1,17,9,7,0,1,0
S01013090,All HRPs aged 16 and over,349,263,219,52,167,30,14,86,52,21,3,4,6
S01013090,Owned: Total,185,136,107,17,90,24,5,49,45,2,1,1,0
S01013090,Owned: Owned outright,91,52,38,8,30,12,2,39,35,2,1,1,0
S01013090,Owned: Owned with a mortgage or loan or shared ownership,94,84,69,9,60,12,3,10,10,0,0,0,0
S01013090,Rented or living rent free: Total,164,127,112,35,77,6,9,37,7,19,2,3,6
S01013090,Rented or living rent free: Social rented,27,16,12,4,8,0,4,11,4,0,2,2,3
S01013090,Rented or living rent free: Private rented or living rent free,137,111,100,31,69,6,5,26,3,19,0,1,3
S01013091,All HRPs aged 16 and over,254,193,172,33,139,14,7,61,20,29,3,8,1
S01013091,Owned: Total,100,76,65,10,55,10,1,24,15,6,1,2,0
S01013091,Owned: Owned outright,42,20,18,5,13,2,0,22,14,6,1,1,0
S01013091,Owned: Owned with a mortgage or loan or shared ownership,58,56,47,5,42,8,1,2,1,0,0,1,0
S01013091,Rented or living rent free: Total,154,117,107,23,84,4,6,37,5,23,2,6,1
S01013091,Rented or living rent free: Social rented,23,11,9,0,9,0,2,12,3,2,2,5,0
S01013091,Rented or living rent free: Private rented or living rent free,131,106,98,23,75,4,4,25,2,21,0,1,1
S01013092,All HRPs aged 16 and over,440,302,247,44,203,38,17,138,94,17,7,13,7
S01013092,Owned: Total,241,165,146,20,126,18,1,76,69,1,1,2,3
S01013092,Owned: Owned outright,109,43,38,7,31,5,0,66,61,1,1,2,1
S01013092,Owned: Owned with a mortgage or loan or shared ownership,132,122,108,13,95,13,1,10,8,0,0,0,2
S01013092,Rented or living rent free: Total,199,137,101,24,77,20,16,62,25,16,6,11,4
S01013092,Rented or living rent free: Social rented,77,44,28,11,17,7,9,33,16,1,5,9,2
S01013092,Rented or living rent free: Private rented or living rent free,122,93,73,13,60,13,7,29,9,15,1,2,2
S01013093,All HRPs aged 16 and over,223,138,90,9,81,46,2,85,76,5,0,3,1
S01013093,Owned: Total,178,104,65,7,58,37,2,74,70,2,0,1,1
S01013093,Owned: Owned outright,123,54,25,3,22,28,1,69,65,2,0,1,1
S01013093,Owned: Owned with a mortgage or loan or shared ownership,55,50,40,4,36,9,1,5,5,0,0,0,0
S01013093,Rented or living rent free: Total,45,34,25,2,23,9,0,11,6,3,0,2,0
S01013093,Rented or living rent free: Social rented,8,5,3,0,3,2,0,3,1,0,0,2,0
S01013093,Rented or living rent free: Private rented or living rent free,37,29,22,2,20,7,0,8,5,3,0,0,0
S01013094,All HRPs aged 16 and over,230,150,126,14,112,22,2,80,80,0,0,0,0
S01013094,Owned: Total,225,147,123,14,109,22,2,78,78,0,0,0,0
S01013094,Owned: Owned outright,126,54,42,8,34,11,1,72,72,0,0,0,0
S01013094,Owned: Owned with a mortgage or loan or shared ownership,99,93,81,6,75,11,1,6,6,0,0,0,0
S01013094,Rented or living rent free: Total,5,3,3,0,3,0,0,2,2,0,0,0,0
S01013094,Rented or living rent free: Social rented,0,0,0,0,0,0,0,0,0,0,0,0,0
S01013094,Rented or living rent free: Private rented or living rent free,5,3,3,0,3,0,0,2,2,0,0,0,0
S01013095,All HRPs aged 16 and over,282,224,189,12,177,34,1,58,56,0,1,0,1
S01013095,Owned: Total,269,214,183,10,173,31,0,55,54,0,1,0,0
S01013095,Owned: Owned outright,114,60,53,7,46,7,0,54,54,0,0,0,0
S01013095,Owned: Owned with a mortgage or loan or shared ownership,155,154,130,3,127,24,0,1,0,0,1,0,0
S01013095,Rented or living rent free: Total,13,10,6,2,4,3,1,3,2,0,0,0,1
S01013095,Rented or living rent free: Social rented,1,0,0,0,0,0,0,1,1,0,0,0,0
S01013095,Rented or living rent free: Private rented or living rent free,12,10,6,2,4,3,1,2,1,0,0,0,1
S01013096,All HRPs aged 16 and over,213,144,123,22,101,15,6,69,58,0,1,9,1
S01013096,Owned: Total,120,80,68,11,57,10,2,40,38,0,0,2,0
S01013096,Owned: Owned outright,43,13,9,3,6,3,1,30,28,0,0,2,0
S01013096,Owned: Owned with a mortgage or loan or shared ownership,77,67,59,8,51,7,1,10,10,0,0,0,0
S01013096,Rented or living rent free: Total,93,64,55,11,44,5,4,29,20,0,1,7,1
S01013096,Rented or living rent free: Social rented,44,19,12,5,7,4,3,25,17,0,1,6,1
S01013096,Rented or living rent free: Private rented or living rent free,49,45,43,6,37,1,1,4,3,0,0,1,0
S01013097,All HRPs aged 16 and over,248,202,148,17,131,51,3,46,38,0,3,5,0
S01013097,Owned: Total,200,167,125,12,113,41,1,33,31,0,2,0,0
S01013097,Owned: Owned outright,93,66,39,6,33,26,1,27,27,0,0,0,0
S01013097,Owned: Owned with a mortgage or loan or shared ownership,107,101,86,6,80,15,0,6,4,0,2,0,0
S01013097,Rented or living rent free: Total,48,35,23,5,18,10,2,13,7,0,1,5,0
S01013097,Rented or living rent free: Social rented,6,2,1,0,1,1,0,4,1,0,0,3,0
S01013097,Rented or living rent free: Private rented or living rent free,42,33,22,5,17,9,2,9,6,0,1,2,0
S01013098,All HRPs aged 16 and over,189,176,149,3,146,27,0,13,12,0,0,1,0
S01013098,Owned: Total,183,170,143,2,141,27,0,13,12,0,0,1,0
S01013098,Owned: Owned outright,43,33,28,1,27,5,0,10,10,0,0,0,0
S01013098,Owned: Owned with a mortgage or loan or shared ownership,140,137,115,1,114,22,0,3,2,0,0,1,0
S01013098,Rented or living rent free: Total,6,6,6,1,5,0,0,0,0,0,0,0,0
S01013098,Rented or living rent free: Social rented,1,1,1,1,0,0,0,0,0,0,0,0,0
S01013098,Rented or living rent free: Private rented or living rent free,5,5,5,0,5,0,0,0,0,0,0,0,0
S01013099,All HRPs aged 16 and over,439,265,204,24,180,51,10,174,154,2,5,9,4
S01013099,Owned: Total,318,177,141,15,126,33,3,141,134,0,1,2,4
S01013099,Owned: Owned outright,175,47,36,7,29,10,1,128,123,0,1,2,2
S01013099,Owned: Owned with a mortgage or loan or shared ownership,143,130,105,8,97,23,2,13,11,0,0,0,2
S01013099,Rented or living rent free: Total,121,88,63,9,54,18,7,33,20,2,4,7,0
S01013099,Rented or living rent free: Social rented,22,12,7,4,3,3,2,10,4,0,3,3,0
S01013099,Rented or living rent free: Private rented or living rent free,99,76,56,5,51,15,5,23,16,2,1,4,0
S01013100,All HRPs aged 16 and over,265,141,108,13,95,33,0,124,114,4,1,2,3
S01013100,Owned: Total,247,130,98,13,85,32,0,117,113,0,1,1,2
S01013100,Owned: Owned outright,168,55,37,8,29,18,0,113,111,0,0,0,2
S01013100,Owned: Owned with a mortgage or loan or shared ownership,79,75,61,5,56,14,0,4,2,0,1,1,0
S01013100,Rented or living rent free: Total,18,11,10,0,10,1,0,7,1,4,0,1,1
S01013100,Rented or living rent free: Social rented,1,0,0,0,0,0,0,1,0,1,0,0,0
S01013100,Rented or living rent free: Private rented or living rent free,17,11,10,0,10,1,0,6,1,3,0,1,1
S01013101,All HRPs aged 16 and over,502,282,222,37,185,37,23,220,171,3,7,28,11
S01013101,Owned: Total,294,190,155,16,139,31,4,104,97,1,0,3,3
S01013101,Owned: Owned outright,131,46,33,5,28,11,2,85,81,0,0,2,2
S01013101,Owned: Owned with a mortgage or loan or shared ownership,163,144,122,11,111,20,2,19,16,1,0,1,1
S01013101,Rented or living rent free: Total,208,92,67,21,46,6,19,116,74,2,7,25,8
S01013101,Rented or living rent free: Social rented,153,58,40,12,28,2,16,95,64,0,3,21,7
S01013101,Rented or living rent free: Private rented or living rent free,55,34,27,9,18,4,3,21,10,2,4,4,1
S01013102,All HRPs aged 16 and over,291,141,124,11,113,14,3,150,145,0,1,3,1
S01013102,Owned: Total,257,124,110,10,100,13,1,133,131,0,1,0,1
S01013102,Owned: Owned outright,159,49,41,5,36,7,1,110,109,0,0,0,1
S01013102,Owned: Owned with a mortgage or loan or shared ownership,98,75,69,5,64,6,0,23,22,0,1,0,0
S01013102,Rented or living rent free: Total,34,17,14,1,13,1,2,17,14,0,0,3,0
S01013102,Rented or living rent free: Social rented,13,5,3,0,3,1,1,8,5,0,0,3,0
S01013102,Rented or living rent free: Private rented or living rent free,21,12,11,1,10,0,1,9,9,0,0,0,0
S01013103,All HRPs aged 16 and over,289,233,193,15,178,38,2,56,53,1,0,2,0
S01013103,Owned: Total,278,226,188,14,174,37,1,52,52,0,0,0,0
S01013103,Owned: Owned outright,97,49,38,10,28,10,1,48,48,0,0,0,0
S01013103,Owned: Owned with a mortgage or loan or shared ownership,181,177,150,4,146,27,0,4,4,0,0,0,0
S01013103,Rented or living rent free: Total,11,7,5,1,4,1,1,4,1,1,0,2,0
S01013103,Rented or living rent free: Social rented,4,2,1,0,1,0,1,2,1,0,0,1,0
S01013103,Rented or living rent free: Private rented or living rent free,7,5,4,1,3,1,0,2,0,1,0,1,0
S01013104,All HRPs aged 16 and over,404,260,204,17,187,52,4,144,139,0,1,3,1
S01013104,Owned: Total,377,243,193,15,178,47,3,134,133,0,0,1,0
S01013104,Owned: Owned outright,202,77,58,10,48,18,1,125,124,0,0,1,0
S01013104,Owned: Owned with a mortgage or loan or shared ownership,175,166,135,5,130,29,2,9,9,0,0,0,0
S01013104,Rented or living rent free: Total,27,17,11,2,9,5,1,10,6,0,1,2,1
S01013104,Rented or living rent free: Social rented,8,3,3,1,2,0,0,5,2,0,1,2,0
S01013104,Rented or living rent free: Private rented or living rent free,19,14,8,1,7,5,1,5,4,0,0,0,1
S01013105,All HRPs aged 16 and over,387,243,186,18,168,53,4,144,137,0,1,4,2
S01013105,Owned: Total,330,204,159,14,145,44,1,126,122,0,1,1,2
S01013105,Owned: Owned outright,182,67,50,12,38,16,1,115,113,0,0,1,1
S01013105,Owned: Owned with a mortgage or loan or shared ownership,148,137,109,2,107,28,0,11,9,0,1,0,1
S01013105,Rented or living rent free: Total,57,39,27,4,23,9,3,18,15,0,0,3,0
S01013105,Rented or living rent free: Social rented,15,6,4,2,2,2,0,9,6,0,0,3,0
S01013105,Rented or living rent free: Private rented or living rent free,42,33,23,2,21,7,3,9,9,0,0,0,0
S01013106,All HRPs aged 16 and over,350,230,174,21,153,49,7,120,105,1,3,8,3
S01013106,Owned: Total,254,171,132,11,121,36,3,83,77,1,0,2,3
S01013106,Owned: Owned outright,116,43,31,4,27,11,1,73,67,1,0,2,3
S01013106,Owned: Owned with a mortgage or loan or shared ownership,138,128,101,7,94,25,2,10,10,0,0,0,0
S01013106,Rented or living rent free: Total,96,59,42,10,32,13,4,37,28,0,3,6,0
S01013106,Rented or living rent free: Social rented,43,21,19,4,15,0,2,22,16,0,0,6,0
S01013106,Rented or living rent free: Private rented or living rent free,53,38,23,6,17,13,2,15,12,0,3,0,0
S01013107,All HRPs aged 16 and over,275,188,134,16,118,53,1,87,81,0,1,2,3
S01013107,Owned: Total,208,136,98,12,86,38,0,72,70,0,0,0,2
S01013107,Owned: Owned outright,126,61,41,8,33,20,0,65,63,0,0,0,2
S01013107,Owned: Owned with a mortgage or loan or shared ownership,82,75,57,4,53,18,0,7,7,0,0,0,0
S01013107,Rented or living rent free: Total,67,52,36,4,32,15,1,15,11,0,1,2,1
S01013107,Rented or living rent free: Social rented,5,2,1,0,1,1,0,3,0,0,1,2,0
S01013107,Rented or living rent free: Private rented or living rent free,62,50,35,4,31,14,1,12,11,0,0,0,1
S01013108,All HRPs aged 16 and over,255,169,128,19,109,32,9,86,72,2,3,6,3
S01013108,Owned: Total,163,110,83,8,75,26,1,53,52,0,1,0,0
S01013108,Owned: Owned outright,96,48,32,4,28,15,1,48,48,0,0,0,0
S01013108,Owned: Owned with a mortgage or loan or shared ownership,67,62,51,4,47,11,0,5,4,0,1,0,0
S01013108,Rented or living rent free: Total,92,59,45,11,34,6,8,33,20,2,2,6,3
S01013108,Rented or living rent free: Social rented,71,40,31,10,21,1,8,31,19,2,2,6,2
S01013108,Rented or living rent free: Private rented or living rent free,21,19,14,1,13,5,0,2,1,0,0,0,1
S01013109,All HRPs aged 16 and over,412,310,199,24,175,102,9,102,95,0,2,4,1
S01013109,Owned: Total,326,246,153,20,133,91,2,80,77,0,1,2,0
S01013109,Owned: Owned outright,178,106,62,10,52,43,1,72,69,0,1,2,0
S01013109,Owned: Owned with a mortgage or loan or shared ownership,148,140,91,10,81,48,1,8,8,0,0,0,0
S01013109,Rented or living rent free: Total,86,64,46,4,42,11,7,22,18,0,1,2,1
S01013109,Rented or living rent free: Social rented,20,9,6,1,5,1,2,11,8,0,1,1,1
S01013109,Rented or living rent free: Private rented or living rent free,66,55,40,3,37,10,5,11,10,0,0,1,0
S01013110,All HRPs aged 16 and over,245,176,102,14,88,68,6,69,55,1,3,4,6
S01013110,Owned: Total,171,125,71,10,61,53,1,46,42,0,1,1,2
S01013110,Owned: Owned outright,100,63,30,8,22,32,1,37,35,0,0,1,1
S01013110,Owned: Owned with a mortgage or loan or shared ownership,71,62,41,2,39,21,0,9,7,0,1,0,1
S01013110,Rented or living rent free: Total,74,51,31,4,27,15,5,23,13,1,2,3,4
S01013110,Rented or living rent free: Social rented,26,11,7,2,5,3,1,15,6,0,2,3,4
S01013110,Rented or living rent free: Private rented or living rent free,48,40,24,2,22,12,4,8,7,1,0,0,0
S01013111,All HRPs aged 16 and over,192,132,80,16,64,52,0,60,55,2,2,1,0
S01013111,Owned: Total,158,106,62,11,51,44,0,52,49,2,1,0,0
S01013111,Owned: Owned outright,98,51,29,8,21,22,0,47,46,0,1,0,0
S01013111,Owned: Owned with a mortgage or loan or shared ownership,60,55,33,3,30,22,0,5,3,2,0,0,0
S01013111,Rented or living rent free: Total,34,26,18,5,13,8,0,8,6,0,1,1,0
S01013111,Rented or living rent free: Social rented,17,12,6,4,2,6,0,5,4,0,1,0,0
S01013111,Rented or living rent free: Private rented or living rent free,17,14,12,1,11,2,0,3,2,0,0,1,0
S01013112,All HRPs aged 16 and over,265,186,152,22,130,26,8,79,62,1,3,9,4
S01013112,Owned: Total,179,129,104,8,96,23,2,50,45,0,0,3,2
S01013112,Owned: Owned outright,69,29,21,3,18,7,1,40,37,0,0,1,2
S01013112,Owned: Owned with a mortgage or loan or shared ownership,110,100,83,5,78,16,1,10,8,0,0,2,0
S01013112,Rented or living rent free: Total,86,57,48,14,34,3,6,29,17,1,3,6,2
S01013112,Rented or living rent free: Social rented,58,37,31,10,21,2,4,21,12,1,1,6,1
S01013112,Rented or living rent free: Private rented or living rent free,28,20,17,4,13,1,2,8,5,0,2,0,1
S01013113,All HRPs aged 16 and over,372,206,155,34,121,43,8,166,139,0,8,15,4
S01013113,Owned: Total,230,149,106,20,86,38,5,81,78,0,0,2,1
S01013113,Owned: Owned outright,110,43,29,12,17,10,4,67,64,0,0,2,1
S01013113,Owned: Owned with a mortgage or loan or shared ownership,120,106,77,8,69,28,1,14,14,0,0,0,0
S01013113,Rented or living rent free: Total,142,57,49,14,35,5,3,85,61,0,8,13,3
S01013113,Rented or living rent free: Social rented,128,47,41,12,29,5,1,81,58,0,8,12,3
S01013113,Rented or living rent free: Private rented or living rent free,14,10,8,2,6,0,2,4,3,0,0,1,0
S01013114,All HRPs aged 16 and over,337,220,149,22,127,63,8,117,104,1,1,9,2
S01013114,Owned: Total,213,123,82,9,73,37,4,90,87,0,0,2,1
S01013114,Owned: Owned outright,134,52,33,8,25,15,4,82,80,0,0,1,1
S01013114,Owned: Owned with a mortgage or loan or shared ownership,79,71,49,1,48,22,0,8,7,0,0,1,0
S01013114,Rented or living rent free: Total,124,97,67,13,54,26,4,27,17,1,1,7,1
S01013114,Rented or living rent free: Social rented,46,29,25,9,16,3,1,17,10,1,1,5,0
S01013114,Rented or living rent free: Private rented or living rent free,78,68,42,4,38,23,3,10,7,0,0,2,1
S01013115,All HRPs aged 16 and over,320,186,133,26,107,42,11,134,110,0,1,13,10
S01013115,Owned: Total,186,116,85,13,72,29,2,70,65,0,0,1,4
S01013115,Owned: Owned outright,103,41,25,7,18,14,2,62,58,0,0,1,3
S01013115,Owned: Owned with a mortgage or loan or shared ownership,83,75,60,6,54,15,0,8,7,0,0,0,1
S01013115,Rented or living rent free: Total,134,70,48,13,35,13,9,64,45,0,1,12,6
S01013115,Rented or living rent free: Social rented,75,26,18,7,11,4,4,49,34,0,1,10,4
S01013115,Rented or living rent free: Private rented or living rent free,59,44,30,6,24,9,5,15,11,0,0,2,2
S01013116,All HRPs aged 16 and over,331,177,129,23,106,47,1,154,146,0,3,1,4
S01013116,Owned: Total,311,166,120,21,99,45,1,145,140,0,3,1,1
S01013116,Owned: Owned outright,200,66,49,17,32,16,1,134,131,0,2,1,0
S01013116,Owned: Owned with a mortgage or loan or shared ownership,111,100,71,4,67,29,0,11,9,0,1,0,1
S01013116,Rented or living rent free: Total,20,11,9,2,7,2,0,9,6,0,0,0,3
S01013116,Rented or living rent free: Social rented,4,3,3,1,2,0,0,1,1,0,0,0,0
S01013116,Rented or living rent free: Private rented or living rent free,16,8,6,1,5,2,0,8,5,0,0,0,3
S01013117,All HRPs aged 16 and over,271,191,153,25,128,38,0,80,58,1,5,13,3
S01013117,Owned: Total,165,129,97,12,85,32,0,36,33,1,1,1,0
S01013117,Owned: Owned outright,66,37,27,7,20,10,0,29,28,1,0,0,0
S01013117,Owned: Owned with a mortgage or loan or shared ownership,99,92,70,5,65,22,0,7,5,0,1,1,0
S01013117,Rented or living rent free: Total,106,62,56,13,43,6,0,44,25,0,4,12,3
S01013117,Rented or living rent free: Social rented,78,36,32,9,23,4,0,42,23,0,4,12,3
S01013117,Rented or living rent free: Private rented or living rent free,28,26,24,4,20,2,0,2,2,0,0,0,0
S01013118,All HRPs aged 16 and over,195,137,95,16,79,40,2,58,53,0,1,2,2
S01013118,Owned: Total,156,110,76,13,63,34,0,46,46,0,0,0,0
S01013118,Owned: Owned outright,85,43,30,8,22,13,0,42,42,0,0,0,0
S01013118,Owned: Owned with a mortgage or loan or shared ownership,71,67,46,5,41,21,0,4,4,0,0,0,0
S01013118,Rented or living rent free: Total,39,27,19,3,16,6,2,12,7,0,1,2,2
S01013118,Rented or living rent free: Social rented,15,7,4,1,3,1,2,8,4,0,1,1,2
S01013118,Rented or living rent free: Private rented or living rent free,24,20,15,2,13,5,0,4,3,0,0,1,0
S01013119,All HRPs aged 16 and over,337,230,133,26,107,90,7,107,94,0,4,5,4
S01013119,Owned: Total,232,154,80,9,71,69,5,78,75,0,1,0,2
S01013119,Owned: Owned outright,138,73,31,7,24,39,3,65,63,0,1,0,1
S01013119,Owned: Owned with a mortgage or loan or shared ownership,94,81,49,2,47,30,2,13,12,0,0,0,1
S01013119,Rented or living rent free: Total,105,76,53,17,36,21,2,29,19,0,3,5,2
S01013119,Rented or living rent free: Social rented,56,41,28,14,14,11,2,15,9,0,2,4,0
S01013119,Rented or living rent free: Private rented or living rent free,49,35,25,3,22,10,0,14,10,0,1,1,2
S01013120,All HRPs aged 16 and over,440,294,197,39,158,89,8,146,125,3,3,9,6
S01013120,Owned: Total,248,163,94,15,79,67,2,85,82,0,1,1,1
S01013120,Owned: Owned outright,159,81,41,10,31,39,1,78,76,0,1,0,1
S01013120,Owned: Owned with a mortgage or loan or shared ownership,89,82,53,5,48,28,1,7,6,0,0,1,0
S01013120,Rented or living rent free: Total,192,131,103,24,79,22,6,61,43,3,2,8,5
S01013120,Rented or living rent free: Social rented,96,59,46,17,29,8,5,37,24,0,1,7,5
S01013120,Rented or living rent free: Private rented or living rent free,96,72,57,7,50,14,1,24,19,3,1,1,0
S01013121,All HRPs aged 16 and over,146,106,64,9,55,34,8,40,28,0,1,5,6
S01013121,Owned: Total,73,51,24,3,21,25,2,22,18,0,1,1,2
S01013121,Owned: Owned outright,44,26,9,3,6,17,0,18,14,0,1,1,2
S01013121,Owned: Owned with a mortgage or loan or shared ownership,29,25,15,0,15,8,2,4,4,0,0,0,0
S01013121,Rented or living rent free: Total,73,55,40,6,34,9,6,18,10,0,0,4,4
S01013121,Rented or living rent free: Social rented,49,34,27,6,21,2,5,15,9,0,0,3,3
S01013121,Rented or living rent free: Private rented or living rent free,24,21,13,0,13,7,1,3,1,0,0,1,1
S01013122,All HRPs aged 16 and over,332,192,137,40,97,6,49,140,60,1,12,53,14
S01013122,Owned: Total,74,47,43,9,34,2,2,27,20,0,1,3,3
S01013122,Owned: Owned outright,22,4,4,2,2,0,0,18,17,0,0,1,0
S01013122,Owned: Owned with a mortgage or loan or shared ownership,52,43,39,7,32,2,2,9,3,0,1,2,3
S01013122,Rented or living rent free: Total,258,145,94,31,63,4,47,113,40,1,11,50,11
S01013122,Rented or living rent free: Social rented,238,130,80,28,52,3,47,108,37,0,11,50,10
S01013122,Rented or living rent free: Private rented or living rent free,20,15,14,3,11,1,0,5,3,1,0,0,1
S01013123,All HRPs aged 16 and over,414,262,214,43,171,13,35,152,85,5,13,37,12
S01013123,Owned: Total,193,139,129,12,117,8,2,54,49,0,0,3,2
S01013123,Owned: Owned outright,66,27,26,6,20,1,0,39,37,0,0,1,1
S01013123,Owned: Owned with a mortgage or loan or shared ownership,127,112,103,6,97,7,2,15,12,0,0,2,1
S01013123,Rented or living rent free: Total,221,123,85,31,54,5,33,98,36,5,13,34,10
S01013123,Rented or living rent free: Social rented,186,103,69,24,45,5,29,83,31,4,9,31,8
S01013123,Rented or living rent free: Private rented or living rent free,35,20,16,7,9,0,4,15,5,1,4,3,2
S01013124,All HRPs aged 16 and over,334,204,185,27,158,9,10,130,86,1,6,27,10
S01013124,Owned: Total,213,150,138,18,120,9,3,63,51,0,0,7,5
S01013124,Owned: Owned outright,69,27,26,6,20,1,0,42,36,0,0,3,3
S01013124,Owned: Owned with a mortgage or loan or shared ownership,144,123,112,12,100,8,3,21,15,0,0,4,2
S01013124,Rented or living rent free: Total,121,54,47,9,38,0,7,67,35,1,6,20,5
S01013124,Rented or living rent free: Social rented,108,46,40,6,34,0,6,62,33,1,6,17,5
S01013124,Rented or living rent free: Private rented or living rent free,13,8,7,3,4,0,1,5,2,0,0,3,0
S01013125,All HRPs aged 16 and over,374,200,164,33,131,25,11,174,132,5,7,23,7
S01013125,Owned: Total,256,162,134,24,110,22,6,94,85,0,1,6,2
S01013125,Owned: Owned outright,111,39,32,11,21,5,2,72,67,0,0,4,1
S01013125,Owned: Owned with a mortgage or loan or shared ownership,145,123,102,13,89,17,4,22,18,0,1,2,1
S01013125,Rented or living rent free: Total,118,38,30,9,21,3,5,80,47,5,6,17,5
S01013125,Rented or living rent free: Social rented,92,27,25,9,16,0,2,65,42,1,2,15,5
S01013125,Rented or living rent free: Private rented or living rent free,26,11,5,0,5,3,3,15,5,4,4,2,0
S01013126,All HRPs aged 16 and over,342,208,154,46,108,13,41,134,46,2,26,49,11
S01013126,Owned: Total,100,75,64,14,50,8,3,25,22,0,1,2,0
S01013126,Owned: Owned outright,33,14,9,3,6,2,3,19,17,0,1,1,0
S01013126,Owned: Owned with a mortgage or loan or shared ownership,67,61,55,11,44,6,0,6,5,0,0,1,0
S01013126,Rented or living rent free: Total,242,133,90,32,58,5,38,109,24,2,25,47,11
S01013126,Rented or living rent free: Social rented,233,127,87,31,56,5,35,106,23,2,23,47,11
S01013126,Rented or living rent free: Private rented or living rent free,9,6,3,1,2,0,3,3,1,0,2,0,0
S01013127,All HRPs aged 16 and over,378,194,147,41,106,13,34,184,77,1,34,62,10
S01013127,Owned: Total,117,70,62,11,51,5,3,47,37,0,1,5,4
S01013127,Owned: Owned outright,52,16,14,3,11,1,1,36,31,0,0,3,2
S01013127,Owned: Owned with a mortgage or loan or shared ownership,65,54,48,8,40,4,2,11,6,0,1,2,2
S01013127,Rented or living rent free: Total,261,124,85,30,55,8,31,137,40,1,33,57,6
S01013127,Rented or living rent free: Social rented,248,118,81,27,54,7,30,130,39,1,31,53,6
S01013127,Rented or living rent free: Private rented or living rent free,13,6,4,3,1,1,1,7,1,0,2,4,0
S01013128,All HRPs aged 16 and over,455,308,259,48,211,5,44,147,70,8,7,56,6
S01013128,Owned: Total,163,139,136,14,122,1,2,24,22,0,0,2,0
S01013128,Owned: Owned outright,30,14,13,3,10,0,1,16,15,0,0,1,0
S01013128,Owned: Owned with a mortgage or loan or shared ownership,133,125,123,11,112,1,1,8,7,0,0,1,0
S01013128,Rented or living rent free: Total,292,169,123,34,89,4,42,123,48,8,7,54,6
S01013128,Rented or living rent free: Social rented,205,110,84,26,58,3,23,95,42,6,3,40,4
S01013128,Rented or living rent free: Private rented or living rent free,87,59,39,8,31,1,19,28,6,2,4,14,2
S01013129,All HRPs aged 16 and over,533,323,273,36,237,20,30,210,128,4,21,46,11
S01013129,Owned: Total,279,213,197,16,181,14,2,66,59,0,1,2,4
S01013129,Owned: Owned outright,82,31,28,4,24,3,0,51,46,0,0,2,3
S01013129,Owned: Owned with a mortgage or loan or shared ownership,197,182,169,12,157,11,2,15,13,0,1,0,1
S01013129,Rented or living rent free: Total,254,110,76,20,56,6,28,144,69,4,20,44,7
S01013129,Rented or living rent free: Social rented,208,83,56,18,38,5,22,125,67,3,11,38,6
S01013129,Rented or living rent free: Private rented or living rent free,46,27,20,2,18,1,6,19,2,1,9,6,1
S01013130,All HRPs aged 16 and over,340,215,161,39,122,18,36,125,53,2,32,28,10
S01013130,Owned: Total,107,86,75,5,70,11,0,21,18,0,0,1,2
S01013130,Owned: Owned outright,19,9,8,1,7,1,0,10,10,0,0,0,0
S01013130,Owned: Owned with a mortgage or loan or shared ownership,88,77,67,4,63,10,0,11,8,0,0,1,2
S01013130,Rented or living rent free: Total,233,129,86,34,52,7,36,104,35,2,32,27,8
S01013130,Rented or living rent free: Social rented,199,104,67,29,38,2,35,95,35,2,28,23,7
S01013130,Rented or living rent free: Private rented or living rent free,34,25,19,5,14,5,1,9,0,0,4,4,1
S01013131,All HRPs aged 16 and over,316,221,185,43,142,11,25,95,45,5,11,27,7
S01013131,Owned: Total,104,84,77,10,67,7,0,20,16,1,0,2,1
S01013131,Owned: Owned outright,29,13,12,4,8,1,0,16,14,0,0,1,1
S01013131,Owned: Owned with a mortgage or loan or shared ownership,75,71,65,6,59,6,0,4,2,1,0,1,0
S01013131,Rented or living rent free: Total,212,137,108,33,75,4,25,75,29,4,11,25,6
S01013131,Rented or living rent free: Social rented,197,130,101,31,70,4,25,67,29,3,6,23,6
S01013131,Rented or living rent free: Private rented or living rent free,15,7,7,2,5,0,0,8,0,1,5,2,0
S01013132,All HRPs aged 16 and over,318,180,138,30,108,15,27,138,76,2,17,30,13
S01013132,Owned: Total,63,55,48,6,42,5,2,8,7,0,0,1,0
S01013132,Owned: Owned outright,13,9,6,2,4,2,1,4,4,0,0,0,0
S01013132,Owned: Owned with a mortgage or loan or shared ownership,50,46,42,4,38,3,1,4,3,0,0,1,0
S01013132,Rented or living rent free: Total,255,125,90,24,66,10,25,130,69,2,17,29,13
S01013132,Rented or living rent free: Social rented,238,117,87,22,65,7,23,121,68,1,13,28,11
S01013132,Rented or living rent free: Private rented or living rent free,17,8,3,2,1,3,2,9,1,1,4,1,2
S01013133,All HRPs aged 16 and over,441,251,197,37,160,14,40,190,82,6,13,71,18
S01013133,Owned: Total,107,93,82,7,75,9,2,14,14,0,0,0,0
S01013133,Owned: Owned outright,22,12,8,2,6,2,2,10,10,0,0,0,0
S01013133,Owned: Owned with a mortgage or loan or shared ownership,85,81,74,5,69,7,0,4,4,0,0,0,0
S01013133,Rented or living rent free: Total,334,158,115,30,85,5,38,176,68,6,13,71,18
S01013133,Rented or living rent free: Social rented,309,142,100,30,70,5,37,167,68,2,10,70,17
S01013133,Rented or living rent free: Private rented or living rent free,25,16,15,0,15,0,1,9,0,4,3,1,1
S01013134,All HRPs aged 16 and over,376,225,183,26,157,32,10,151,110,4,9,22,6
S01013134,Owned: Total,237,166,140,14,126,26,0,71,67,0,1,2,1
S01013134,Owned: Owned outright,112,48,38,8,30,10,0,64,62,0,0,1,1
S01013134,Owned: Owned with a mortgage or loan or shared ownership,125,118,102,6,96,16,0,7,5,0,1,1,0
S01013134,Rented or living rent free: Total,139,59,43,12,31,6,10,80,43,4,8,20,5
S01013134,Rented or living rent free: Social rented,116,43,31,9,22,4,8,73,42,3,8,17,3
S01013134,Rented or living rent free: Private rented or living rent free,23,16,12,3,9,2,2,7,1,1,0,3,2
S01013135,All HRPs aged 16 and over,391,214,169,55,114,18,27,177,71,7,26,65,8
S01013135,Owned: Total,102,78,71,12,59,7,0,24,16,2,0,6,0
S01013135,Owned: Owned outright,28,12,11,4,7,1,0,16,13,0,0,3,0
S01013135,Owned: Owned with a mortgage or loan or shared ownership,74,66,60,8,52,6,0,8,3,2,0,3,0
S01013135,Rented or living rent free: Total,289,136,98,43,55,11,27,153,55,5,26,59,8
S01013135,Rented or living rent free: Social rented,267,131,94,40,54,11,26,136,47,4,24,55,6
S01013135,Rented or living rent free: Private rented or living rent free,22,5,4,3,1,0,1,17,8,1,2,4,2
S01013136,All HRPs aged 16 and over,395,198,169,27,142,15,14,197,154,2,9,24,8
S01013136,Owned: Total,258,139,126,21,105,11,2,119,111,1,2,2,3
S01013136,Owned: Owned outright,128,34,29,6,23,5,0,94,91,0,1,1,1
S01013136,Owned: Owned with a mortgage or loan or shared ownership,130,105,97,15,82,6,2,25,20,1,1,1,2
S01013136,Rented or living rent free: Total,137,59,43,6,37,4,12,78,43,1,7,22,5
S01013136,Rented or living rent free: Social rented,124,52,40,6,34,4,8,72,41,1,5,21,4
S01013136,Rented or living rent free: Private rented or living rent free,13,7,3,0,3,0,4,6,2,0,2,1,1
S01013137,All HRPs aged 16 and over,307,160,133,26,107,16,11,147,121,0,10,15,1
S01013137,Owned: Total,188,110,91,10,81,14,5,78,74,0,2,1,1
S01013137,Owned: Owned outright,111,46,40,6,34,5,1,65,61,0,2,1,1
S01013137,Owned: Owned with a mortgage or loan or shared ownership,77,64,51,4,47,9,4,13,13,0,0,0,0
S01013137,Rented or living rent free: Total,119,50,42,16,26,2,6,69,47,0,8,14,0
S01013137,Rented or living rent free: Social rented,116,48,40,15,25,2,6,68,46,0,8,14,0
S01013137,Rented or living rent free: Private rented or living rent free,3,2,2,1,1,0,0,1,1,0,0,0,0
S01013138,All HRPs aged 16 and over,342,205,159,54,105,12,34,137,61,3,25,36,12
S01013138,Owned: Total,91,62,55,10,45,7,0,29,23,0,0,3,3
S01013138,Owned: Owned outright,27,8,7,3,4,1,0,19,14,0,0,2,3
S01013138,Owned: Owned with a mortgage or loan or shared ownership,64,54,48,7,41,6,0,10,9,0,0,1,0
S01013138,Rented or living rent free: Total,251,143,104,44,60,5,34,108,38,3,25,33,9
S01013138,Rented or living rent free: Social rented,231,126,91,40,51,4,31,105,38,3,23,33,8
S01013138,Rented or living rent free: Private rented or living rent free,20,17,13,4,9,1,3,3,0,0,2,0,1
S01013139,All HRPs aged 16 and over,409,196,153,38,115,18,25,213,124,6,23,51,9
S01013139,Owned: Total,133,83,70,9,61,9,4,50,45,0,2,3,0
S01013139,Owned: Owned outright,56,20,15,3,12,3,2,36,36,0,0,0,0
S01013139,Owned: Owned with a mortgage or loan or shared ownership,77,63,55,6,49,6,2,14,9,0,2,3,0
S01013139,Rented or living rent free: Total,276,113,83,29,54,9,21,163,79,6,21,48,9
S01013139,Rented or living rent free: Social rented,258,103,75,24,51,8,20,155,78,1,19,48,9
S01013139,Rented or living rent free: Private rented or living rent free,18,10,8,5,3,1,1,8,1,5,2,0,0
S01013140,All HRPs aged 16 and over,366,174,143,36,107,15,16,192,122,6,14,40,10
S01013140,Owned: Total,154,90,79,10,69,11,0,64,54,0,3,6,1
S01013140,Owned: Owned outright,72,20,18,4,14,2,0,52,47,0,2,2,1
S01013140,Owned: Owned with a mortgage or loan or shared ownership,82,70,61,6,55,9,0,12,7,0,1,4,0
S01013140,Rented or living rent free: Total,212,84,64,26,38,4,16,128,68,6,11,34,9
S01013140,Rented or living rent free: Social rented,195,78,60,25,35,2,16,117,65,2,10,34,6
S01013140,Rented or living rent free: Private rented or living rent free,17,6,4,1,3,2,0,11,3,4,1,0,3
S01013141,All HRPs aged 16 and over,330,166,138,31,107,13,15,164,113,2,11,30,8
S01013141,Owned: Total,132,82,69,13,56,12,1,50,45,1,0,3,1
S01013141,Owned: Owned outright,50,11,8,2,6,2,1,39,35,1,0,2,1
S01013141,Owned: Owned with a mortgage or loan or shared ownership,82,71,61,11,50,10,0,11,10,0,0,1,0
S01013141,Rented or living rent free: Total,198,84,69,18,51,1,14,114,68,1,11,27,7
S01013141,Rented or living rent free: Social rented,164,63,49,13,36,1,13,101,65,1,5,26,4
S01013141,Rented or living rent free: Private rented or living rent free,34,21,20,5,15,0,1,13,3,0,6,1,3
S01013142,All HRPs aged 16 and over,517,199,154,37,117,14,31,318,212,8,12,69,17
S01013142,Owned: Total,51,35,28,1,27,4,3,16,16,0,0,0,0
S01013142,Owned: Owned outright,17,7,4,0,4,2,1,10,10,0,0,0,0
S01013142,Owned: Owned with a mortgage or loan or shared ownership,34,28,24,1,23,2,2,6,6,0,0,0,0
S01013142,Rented or living rent free: Total,466,164,126,36,90,10,28,302,196,8,12,69,17
S01013142,Rented or living rent free: Social rented,457,158,122,35,87,9,27,299,196,8,10,69,16
S01013142,Rented or living rent free: Private rented or living rent free,9,6,4,1,3,1,1,3,0,0,2,0,1
S01013143,All HRPs aged 16 and over,419,239,202,38,164,18,19,180,130,6,11,21,12
S01013143,Owned: Total,247,157,137,13,124,14,6,90,84,0,0,3,3
S01013143,Owned: Owned outright,104,33,29,5,24,4,0,71,68,0,0,2,1
S01013143,Owned: Owned with a mortgage or loan or shared ownership,143,124,108,8,100,10,6,19,16,0,0,1,2
S01013143,Rented or living rent free: Total,172,82,65,25,40,4,13,90,46,6,11,18,9
S01013143,Rented or living rent free: Social rented,150,71,56,25,31,3,12,79,44,0,10,17,8
S01013143,Rented or living rent free: Private rented or living rent free,22,11,9,0,9,1,1,11,2,6,1,1,1
S01013144,All HRPs aged 16 and over,427,212,178,33,145,19,15,215,171,3,4,34,3
S01013144,Owned: Total,266,149,128,13,115,17,4,117,107,0,0,10,0
S01013144,Owned: Owned outright,126,38,35,6,29,2,1,88,84,0,0,4,0
S01013144,Owned: Owned with a mortgage or loan or shared ownership,140,111,93,7,86,15,3,29,23,0,0,6,0
S01013144,Rented or living rent free: Total,161,63,50,20,30,2,11,98,64,3,4,24,3
S01013144,Rented or living rent free: Social rented,139,46,36,12,24,0,10,93,62,2,4,23,2
S01013144,Rented or living rent free: Private rented or living rent free,22,17,14,8,6,2,1,5,2,1,0,1,1
S01013145,All HRPs aged 16 and over,336,168,148,27,121,16,4,168,123,3,10,27,5
S01013145,Owned: Total,226,134,119,17,102,14,1,92,80,2,2,7,1
S01013145,Owned: Owned outright,87,18,17,6,11,1,0,69,64,2,1,2,0
S01013145,Owned: Owned with a mortgage or loan or shared ownership,139,116,102,11,91,13,1,23,16,0,1,5,1
S01013145,Rented or living rent free: Total,110,34,29,10,19,2,3,76,43,1,8,20,4
S01013145,Rented or living rent free: Social rented,96,25,21,5,16,2,2,71,40,1,8,20,2
S01013145,Rented or living rent free: Private rented or living rent free,14,9,8,5,3,0,1,5,3,0,0,0,2
S01013146,All HRPs aged 16 and over,197,107,86,17,69,17,4,90,69,0,6,12,3
S01013146,Owned: Total,131,83,68,8,60,13,2,48,42,0,1,5,0
S01013146,Owned: Owned outright,48,14,12,4,8,2,0,34,31,0,0,3,0
S01013146,Owned: Owned with a mortgage or loan or shared ownership,83,69,56,4,52,11,2,14,11,0,1,2,0
S01013146,Rented or living rent free: Total,66,24,18,9,9,4,2,42,27,0,5,7,3
S01013146,Rented or living rent free: Social rented,61,20,16,7,9,3,1,41,26,0,5,7,3
S01013146,Rented or living rent free: Private rented or living rent free,5,4,2,2,0,1,1,1,1,0,0,0,0
S01013147,All HRPs aged 16 and over,307,174,145,25,120,26,3,133,104,1,7,16,5
S01013147,Owned: Total,210,143,119,18,101,23,1,67,66,0,0,1,0
S01013147,Owned: Owned outright,83,36,29,9,20,6,1,47,46,0,0,1,0
S01013147,Owned: Owned with a mortgage or loan or shared ownership,127,107,90,9,81,17,0,20,20,0,0,0,0
S01013147,Rented or living rent free: Total,97,31,26,7,19,3,2,66,38,1,7,15,5
S01013147,Rented or living rent free: Social rented,87,24,20,6,14,2,2,63,37,1,7,15,3
S01013147,Rented or living rent free: Private rented or living rent free,10,7,6,1,5,1,0,3,1,0,0,0,2
S01013148,All HRPs aged 16 and over,381,240,203,24,179,24,13,141,117,2,0,19,3
S01013148,Owned: Total,277,185,168,11,157,15,2,92,87,0,0,4,1
S01013148,Owned: Owned outright,124,41,35,7,28,5,1,83,79,0,0,3,1
S01013148,Owned: Owned with a mortgage or loan or shared ownership,153,144,133,4,129,10,1,9,8,0,0,1,0
S01013148,Rented or living rent free: Total,104,55,35,13,22,9,11,49,30,2,0,15,2
S01013148,Rented or living rent free: Social rented,67,28,15,6,9,4,9,39,23,1,0,14,1
S01013148,Rented or living rent free: Private rented or living rent free,37,27,20,7,13,5,2,10,7,1,0,1,1
S01013149,All HRPs aged 16 and over,418,270,247,34,213,15,8,148,112,6,10,12,8
S01013149,Owned: Total,289,200,185,25,160,14,1,89,76,6,3,3,1
S01013149,Owned: Owned outright,98,34,31,9,22,3,0,64,62,0,1,1,0
S01013149,Owned: Owned with a mortgage or loan or shared ownership,191,166,154,16,138,11,1,25,14,6,2,2,1
S01013149,Rented or living rent free: Total,129,70,62,9,53,1,7,59,36,0,7,9,7
S01013149,Rented or living rent free: Social rented,88,38,34,7,27,1,3,50,33,0,6,8,3
S01013149,Rented or living rent free: Private rented or living rent free,41,32,28,2,26,0,4,9,3,0,1,1,4
S01013150,All HRPs aged 16 and over,403,224,196,44,152,15,13,179,143,2,4,26,4
S01013150,Owned: Total,274,164,150,31,119,10,4,110,101,0,2,6,1
S01013150,Owned: Owned outright,146,51,46,15,31,4,1,95,90,0,1,3,1
S01013150,Owned: Owned with a mortgage or loan or shared ownership,128,113,104,16,88,6,3,15,11,0,1,3,0
S01013150,Rented or living rent free: Total,129,60,46,13,33,5,9,69,42,2,2,20,3
S01013150,Rented or living rent free: Social rented,103,44,32,7,25,4,8,59,38,1,2,16,2
S01013150,Rented or living rent free: Private rented or living rent free,26,16,14,6,8,1,1,10,4,1,0,4,1
S01013151,All HRPs aged 16 and over,261,167,140,10,130,21,6,94,71,2,12,3,6
S01013151,Owned: Total,212,149,128,7,121,19,2,63,58,1,3,0,1
S01013151,Owned: Owned outright,85,35,29,5,24,5,1,50,49,0,0,0,1
S01013151,Owned: Owned with a mortgage or loan or shared ownership,127,114,99,2,97,14,1,13,9,1,3,0,0
S01013151,Rented or living rent free: Total,49,18,12,3,9,2,4,31,13,1,9,3,5
S01013151,Rented or living rent free: Social rented,23,5,1,0,1,2,2,18,12,0,2,2,2
S01013151,Rented or living rent free: Private rented or living rent free,26,13,11,3,8,0,2,13,1,1,7,1,3
S01013152,All HRPs aged 16 and over,386,240,201,37,164,33,6,146,102,1,8,34,1
S01013152,Owned: Total,265,184,156,17,139,27,1,81,69,0,2,10,0
S01013152,Owned: Owned outright,94,35,28,5,23,7,0,59,54,0,0,5,0
S01013152,Owned: Owned with a mortgage or loan or shared ownership,171,149,128,12,116,20,1,22,15,0,2,5,0
S01013152,Rented or living rent free: Total,121,56,45,20,25,6,5,65,33,1,6,24,1
S01013152,Rented or living rent free: Social rented,101,46,39,19,20,3,4,55,32,1,1,20,1
S01013152,Rented or living rent free: Private rented or living rent free,20,10,6,1,5,3,1,10,1,0,5,4,0
S01013153,All HRPs aged 16 and over,398,225,183,45,138,17,25,173,86,4,25,45,13
S01013153,Owned: Total,127,82,71,10,61,10,1,45,37,0,0,6,2
S01013153,Owned: Owned outright,51,17,13,4,9,3,1,34,29,0,0,3,2
S01013153,Owned: Owned with a mortgage or loan or shared ownership,76,65,58,6,52,7,0,11,8,0,0,3,0
S01013153,Rented or living rent free: Total,271,143,112,35,77,7,24,128,49,4,25,39,11
S01013153,Rented or living rent free: Social rented,258,135,108,35,73,5,22,123,45,4,24,39,11
S01013153,Rented or living rent free: Private rented or living rent free,13,8,4,0,4,2,2,5,4,0,1,0,0
S01013154,All HRPs aged 16 and over,452,284,225,70,155,15,44,168,109,6,22,27,4
S01013154,Owned: Total,204,129,113,15,98,10,6,75,73,0,2,0,0
S01013154,Owned: Owned outright,92,26,24,7,17,2,0,66,65,0,1,0,0
S01013154,Owned: Owned with a mortgage or loan or shared ownership,112,103,89,8,81,8,6,9,8,0,1,0,0
S01013154,Rented or living rent free: Total,248,155,112,55,57,5,38,93,36,6,20,27,4
S01013154,Rented or living rent free: Social rented,225,137,104,52,52,5,28,88,35,6,19,25,3
S01013154,Rented or living rent free: Private rented or living rent free,23,18,8,3,5,0,10,5,1,0,1,2,1
S01013155,All HRPs aged 16 and over,399,260,201,53,148,19,40,139,43,5,38,45,8
S01013155,Owned: Total,96,82,68,7,61,10,4,14,12,0,0,2,0
S01013155,Owned: Owned outright,25,14,9,3,6,3,2,11,11,0,0,0,0
S01013155,Owned: Owned with a mortgage or loan or shared ownership,71,68,59,4,55,7,2,3,1,0,0,2,0
S01013155,Rented or living rent free: Total,303,178,133,46,87,9,36,125,31,5,38,43,8
S01013155,Rented or living rent free: Social rented,269,157,118,41,77,9,30,112,30,4,32,38,8
S01013155,Rented or living rent free: Private rented or living rent free,34,21,15,5,10,0,6,13,1,1,6,5,0
S01013156,All HRPs aged 16 and over,354,214,176,58,118,10,28,140,52,2,27,50,9
S01013156,Owned: Total,81,57,53,10,43,4,0,24,21,0,0,3,0
S01013156,Owned: Owned outright,25,8,7,1,6,1,0,17,16,0,0,1,0
S01013156,Owned: Owned with a mortgage or loan or shared ownership,56,49,46,9,37,3,0,7,5,0,0,2,0
S01013156,Rented or living rent free: Total,273,157,123,48,75,6,28,116,31,2,27,47,9
S01013156,Rented or living rent free: Social rented,267,154,120,48,72,6,28,113,31,2,27,44,9
S01013156,Rented or living rent free: Private rented or living rent free,6,3,3,0,3,0,0,3,0,0,0,3,0
S01013157,All HRPs aged 16 and over,430,251,202,48,154,11,38,179,83,12,28,40,16
S01013157,Owned: Total,128,91,81,6,75,8,2,37,32,0,1,4,0
S01013157,Owned: Owned outright,40,16,13,1,12,3,0,24,23,0,1,0,0
S01013157,Owned: Owned with a mortgage or loan or shared ownership,88,75,68,5,63,5,2,13,9,0,0,4,0
S01013157,Rented or living rent free: Total,302,160,121,42,79,3,36,142,51,12,27,36,16
S01013157,Rented or living rent free: Social rented,287,155,116,42,74,3,36,132,50,3,27,36,16
S01013157,Rented or living rent free: Private rented or living rent free,15,5,5,0,5,0,0,10,1,9,0,0,0
S01013158,All HRPs aged 16 and over,205,150,118,9,109,27,5,55,51,0,1,3,0
S01013158,Owned: Total,182,130,104,9,95,24,2,52,50,0,0,2,0
S01013158,Owned: Owned outright,87,42,29,3,26,11,2,45,45,0,0,0,0
S01013158,Owned: Owned with a mortgage or loan or shared ownership,95,88,75,6,69,13,0,7,5,0,0,2,0
S01013158,Rented or living rent free: Total,23,20,14,0,14,3,3,3,1,0,1,1,0
S01013158,Rented or living rent free: Social rented,8,6,4,0,4,1,1,2,0,0,1,1,0
S01013158,Rented or living rent free: Private rented or living rent free,15,14,10,0,10,2,2,1,1,0,0,0,0
S01013159,All HRPs aged 16 and over,297,194,164,26,138,26,4,103,90,0,5,4,4
S01013159,Owned: Total,257,179,150,22,128,25,4,78,72,0,0,3,3
S01013159,Owned: Owned outright,120,48,39,11,28,8,1,72,69,0,0,1,2
S01013159,Owned: Owned with a mortgage or loan or shared ownership,137,131,111,11,100,17,3,6,3,0,0,2,1
S01013159,Rented or living rent free: Total,40,15,14,4,10,1,0,25,18,0,5,1,1
S01013159,Rented or living rent free: Social rented,26,9,9,4,5,0,0,17,15,0,0,1,1
S01013159,Rented or living rent free: Private rented or living rent free,14,6,5,0,5,1,0,8,3,0,5,0,0
S01013160,All HRPs aged 16 and over,264,203,162,27,135,37,4,61,56,1,2,1,1
S01013160,Owned: Total,252,196,156,24,132,36,4,56,55,0,0,1,0
S01013160,Owned: Owned outright,106,55,40,15,25,14,1,51,50,0,0,1,0
S01013160,Owned: Owned with a mortgage or loan or shared ownership,146,141,116,9,107,22,3,5,5,0,0,0,0
S01013160,Rented or living rent free: Total,12,7,6,3,3,1,0,5,1,1,2,0,1
S01013160,Rented or living rent free: Social rented,2,0,0,0,0,0,0,2,1,0,0,0,1
S01013160,Rented or living rent free: Private rented or living rent free,10,7,6,3,3,1,0,3,0,1,2,0,0
S01013161,All HRPs aged 16 and over,488,310,269,42,227,24,17,178,122,4,10,34,8
S01013161,Owned: Total,306,227,204,18,186,20,3,79,74,0,0,2,3
S01013161,Owned: Owned outright,102,40,37,5,32,3,0,62,59,0,0,2,1
S01013161,Owned: Owned with a mortgage or loan or shared ownership,204,187,167,13,154,17,3,17,15,0,0,0,2
S01013161,Rented or living rent free: Total,182,83,65,24,41,4,14,99,48,4,10,32,5
S01013161,Rented or living rent free: Social rented,155,64,52,22,30,3,9,91,44,4,8,31,4
S01013161,Rented or living rent free: Private rented or living rent free,27,19,13,2,11,1,5,8,4,0,2,1,1
S01013162,All HRPs aged 16 and over,426,217,169,28,141,23,25,209,163,0,10,29,7
S01013162,Owned: Total,227,136,111,14,97,17,8,91,81,0,1,8,1
S01013162,Owned: Owned outright,118,50,39,8,31,4,7,68,61,0,0,6,1
S01013162,Owned: Owned with a mortgage or loan or shared ownership,109,86,72,6,66,13,1,23,20,0,1,2,0
S01013162,Rented or living rent free: Total,199,81,58,14,44,6,17,118,82,0,9,21,6
S01013162,Rented or living rent free: Social rented,169,62,46,11,35,5,11,107,78,0,4,19,6
S01013162,Rented or living rent free: Private rented or living rent free,30,19,12,3,9,1,6,11,4,0,5,2,0
S01013163,All HRPs aged 16 and over,253,194,169,19,150,20,5,59,43,1,7,8,0
S01013163,Owned: Total,211,172,151,16,135,18,3,39,38,0,0,1,0
S01013163,Owned: Owned outright,93,58,50,9,41,8,0,35,34,0,0,1,0
S01013163,Owned: Owned with a mortgage or loan or shared ownership,118,114,101,7,94,10,3,4,4,0,0,0,0
S01013163,Rented or living rent free: Total,42,22,18,3,15,2,2,20,5,1,7,7,0
S01013163,Rented or living rent free: Social rented,34,20,17,3,14,1,2,14,3,0,4,7,0
S01013163,Rented or living rent free: Private rented or living rent free,8,2,1,0,1,1,0,6,2,1,3,0,0
S01013164,All HRPs aged 16 and over,485,278,215,36,179,40,23,207,132,3,21,43,8
S01013164,Owned: Total,265,180,148,18,130,32,0,85,77,2,2,3,1
S01013164,Owned: Owned outright,109,49,43,13,30,6,0,60,58,0,0,1,1
S01013164,Owned: Owned with a mortgage or loan or shared ownership,156,131,105,5,100,26,0,25,19,2,2,2,0
S01013164,Rented or living rent free: Total,220,98,67,18,49,8,23,122,55,1,19,40,7
S01013164,Rented or living rent free: Social rented,198,88,60,17,43,6,22,110,51,1,14,37,7
S01013164,Rented or living rent free: Private rented or living rent free,22,10,7,1,6,2,1,12,4,0,5,3,0
S01013165,All HRPs aged 16 and over,412,227,185,30,155,30,12,185,154,0,5,21,5
S01013165,Owned: Total,270,170,146,18,128,23,1,100,90,0,2,8,0
S01013165,Owned: Owned outright,125,41,33,8,25,8,0,84,80,0,1,3,0
S01013165,Owned: Owned with a mortgage or loan or shared ownership,145,129,113,10,103,15,1,16,10,0,1,5,0
S01013165,Rented or living rent free: Total,142,57,39,12,27,7,11,85,64,0,3,13,5
S01013165,Rented or living rent free: Social rented,123,45,33,12,21,4,8,78,58,0,2,13,5
S01013165,Rented or living rent free: Private rented or living rent free,19,12,6,0,6,3,3,7,6,0,1,0,0
S01013166,All HRPs aged 16 and over,387,219,161,44,117,15,43,168,66,4,12,72,14
S01013166,Owned: Total,50,35,30,3,27,4,1,15,10,0,1,1,3
S01013166,Owned: Owned outright,16,8,7,2,5,1,0,8,7,0,0,0,1
S01013166,Owned: Owned with a mortgage or loan or shared ownership,34,27,23,1,22,3,1,7,3,0,1,1,2
S01013166,Rented or living rent free: Total,337,184,131,41,90,11,42,153,56,4,11,71,11
S01013166,Rented or living rent free: Social rented,317,171,120,40,80,9,42,146,56,4,11,65,10
S01013166,Rented or living rent free: Private rented or living rent free,20,13,11,1,10,2,0,7,0,0,0,6,1
S01013167,All HRPs aged 16 and over,383,246,156,37,119,15,75,137,46,2,14,64,11
S01013167,Owned: Total,63,48,39,5,34,6,3,15,14,0,0,1,0
S01013167,Owned: Owned outright,20,7,6,0,6,1,0,13,13,0,0,0,0
S01013167,Owned: Owned with a mortgage or loan or shared ownership,43,41,33,5,28,5,3,2,1,0,0,1,0
S01013167,Rented or living rent free: Total,320,198,117,32,85,9,72,122,32,2,14,63,11
S01013167,Rented or living rent free: Social rented,309,188,111,30,81,8,69,121,31,2,14,63,11
S01013167,Rented or living rent free: Private rented or living rent free,11,10,6,2,4,1,3,1,1,0,0,0,0
S01013168,All HRPs aged 16 and over,408,207,166,35,131,14,27,201,134,2,20,42,3
S01013168,Owned: Total,203,128,113,17,96,10,5,75,69,1,0,4,1
S01013168,Owned: Owned outright,72,22,19,5,14,2,1,50,47,0,0,2,1
S01013168,Owned: Owned with a mortgage or loan or shared ownership,131,106,94,12,82,8,4,25,22,1,0,2,0
S01013168,Rented or living rent free: Total,205,79,53,18,35,4,22,126,65,1,20,38,2
S01013168,Rented or living rent free: Social rented,180,67,44,15,29,4,19,113,62,1,13,36,1
S01013168,Rented or living rent free: Private rented or living rent free,25,12,9,3,6,0,3,13,3,0,7,2,1
S01013169,All HRPs aged 16 and over,436,194,155,38,117,20,19,242,174,0,16,45,7
S01013169,Owned: Total,212,112,97,16,81,14,1,100,90,0,1,9,0
S01013169,Owned: Owned outright,93,24,22,6,16,1,1,69,63,0,1,5,0
S01013169,Owned: Owned with a mortgage or loan or shared ownership,119,88,75,10,65,13,0,31,27,0,0,4,0
S01013169,Rented or living rent free: Total,224,82,58,22,36,6,18,142,84,0,15,36,7
S01013169,Rented or living rent free: Social rented,207,71,48,20,28,6,17,136,82,0,11,36,7
S01013169,Rented or living rent free: Private rented or living rent free,17,11,10,2,8,0,1,6,2,0,4,0,0
S01013170,All HRPs aged 16 and over,265,138,102,22,80,10,26,127,81,1,8,31,6
S01013170,Owned: Total,104,70,63,8,55,6,1,34,30,0,0,2,2
S01013170,Owned: Owned outright,26,8,8,3,5,0,0,18,17,0,0,1,0
S01013170,Owned: Owned with a mortgage or loan or shared ownership,78,62,55,5,50,6,1,16,13,0,0,1,2
S01013170,Rented or living rent free: Total,161,68,39,14,25,4,25,93,51,1,8,29,4
S01013170,Rented or living rent free: Social rented,145,61,35,13,22,4,22,84,49,1,5,25,4
S01013170,Rented or living rent free: Private rented or living rent free,16,7,4,1,3,0,3,9,2,0,3,4,0
S01013171,All HRPs aged 16 and over,249,175,149,19,130,17,9,74,51,0,7,15,1
S01013171,Owned: Total,190,142,124,12,112,17,1,48,44,0,3,1,0
S01013171,Owned: Owned outright,58,21,16,6,10,4,1,37,36,0,0,1,0
S01013171,Owned: Owned with a mortgage or loan or shared ownership,132,121,108,6,102,13,0,11,8,0,3,0,0
S01013171,Rented or living rent free: Total,59,33,25,7,18,0,8,26,7,0,4,14,1
S01013171,Rented or living rent free: Social rented,49,27,19,6,13,0,8,22,3,0,4,14,1
S01013171,Rented or living rent free: Private rented or living rent free,10,6,6,1,5,0,0,4,4,0,0,0,0
S01013172,All HRPs aged 16 and over,319,200,172,28,144,14,14,119,83,1,7,25,3
S01013172,Owned: Total,197,146,128,13,115,14,4,51,48,0,1,2,0
S01013172,Owned: Owned outright,70,29,27,8,19,1,1,41,41,0,0,0,0
S01013172,Owned: Owned with a mortgage or loan or shared ownership,127,117,101,5,96,13,3,10,7,0,1,2,0
S01013172,Rented or living rent free: Total,122,54,44,15,29,0,10,68,35,1,6,23,3
S01013172,Rented or living rent free: Social rented,105,44,38,10,28,0,6,61,32,1,4,22,2
S01013172,Rented or living rent free: Private rented or living rent free,17,10,6,5,1,0,4,7,3,0,2,1,1
S01013173,All HRPs aged 16 and over,358,256,229,33,196,19,8,102,73,0,3,19,7
S01013173,Owned: Total,261,201,183,24,159,16,2,60,54,0,0,5,1
S01013173,Owned: Owned outright,70,27,26,7,19,1,0,43,41,0,0,2,0
S01013173,Owned: Owned with a mortgage or loan or shared ownership,191,174,157,17,140,15,2,17,13,0,0,3,1
S01013173,Rented or living rent free: Total,97,55,46,9,37,3,6,42,19,0,3,14,6
S01013173,Rented or living rent free: Social rented,60,26,21,5,16,2,3,34,18,0,1,11,4
S01013173,Rented or living rent free: Private rented or living rent free,37,29,25,4,21,1,3,8,1,0,2,3,2
S01013174,All HRPs aged 16 and over,284,236,202,20,182,28,6,48,44,0,2,2,0
S01013174,Owned: Total,266,226,193,18,175,27,6,40,37,0,1,2,0
S01013174,Owned: Owned outright,68,37,33,10,23,3,1,31,30,0,0,1,0
S01013174,Owned: Owned with a mortgage or loan or shared ownership,198,189,160,8,152,24,5,9,7,0,1,1,0
S01013174,Rented or living rent free: Total,18,10,9,2,7,1,0,8,7,0,1,0,0
S01013174,Rented or living rent free: Social rented,11,7,6,1,5,1,0,4,4,0,0,0,0
S01013174,Rented or living rent free: Private rented or living rent free,7,3,3,1,2,0,0,4,3,0,1,0,0
S01013175,All HRPs aged 16 and over,343,253,225,18,207,24,4,90,67,1,6,12,4
S01013175,Owned: Total,281,228,205,15,190,22,1,53,52,0,1,0,0
S01013175,Owned: Owned outright,75,39,35,4,31,3,1,36,36,0,0,0,0
S01013175,Owned: Owned with a mortgage or loan or shared ownership,206,189,170,11,159,19,0,17,16,0,1,0,0
S01013175,Rented or living rent free: Total,62,25,20,3,17,2,3,37,15,1,5,12,4
S01013175,Rented or living rent free: Social rented,44,15,10,1,9,2,3,29,14,1,3,9,2
S01013175,Rented or living rent free: Private rented or living rent free,18,10,10,2,8,0,0,8,1,0,2,3,2
S01013176,All HRPs aged 16 and over,411,247,215,30,185,22,10,164,143,0,2,14,5
S01013176,Owned: Total,287,201,178,23,155,21,2,86,81,0,2,3,0
S01013176,Owned: Owned outright,104,39,33,7,26,6,0,65,65,0,0,0,0
S01013176,Owned: Owned with a mortgage or loan or shared ownership,183,162,145,16,129,15,2,21,16,0,2,3,0
S01013176,Rented or living rent free: Total,124,46,37,7,30,1,8,78,62,0,0,11,5
S01013176,Rented or living rent free: Social rented,81,20,16,3,13,1,3,61,53,0,0,7,1
S01013176,Rented or living rent free: Private rented or living rent free,43,26,21,4,17,0,5,17,9,0,0,4,4
S01013177,All HRPs aged 16 and over,290,196,176,14,162,15,5,94,82,0,1,10,1
S01013177,Owned: Total,251,173,158,11,147,15,0,78,77,0,0,0,1
S01013177,Owned: Owned outright,99,33,27,3,24,6,0,66,66,0,0,0,0
S01013177,Owned: Owned with a mortgage or loan or shared ownership,152,140,131,8,123,9,0,12,11,0,0,0,1
S01013177,Rented or living rent free: Total,39,23,18,3,15,0,5,16,5,0,1,10,0
S01013177,Rented or living rent free: Social rented,16,4,1,0,1,0,3,12,2,0,1,9,0
S01013177,Rented or living rent free: Private rented or living rent free,23,19,17,3,14,0,2,4,3,0,0,1,0
S01013178,All HRPs aged 16 and over,346,231,197,30,167,25,9,115,92,1,3,18,1
S01013178,Owned: Total,252,183,157,23,134,23,3,69,64,0,0,4,1
S01013178,Owned: Owned outright,106,47,37,5,32,7,3,59,56,0,0,3,0
S01013178,Owned: Owned with a mortgage or loan or shared ownership,146,136,120,18,102,16,0,10,8,0,0,1,1
S01013178,Rented or living rent free: Total,94,48,40,7,33,2,6,46,28,1,3,14,0
S01013178,Rented or living rent free: Social rented,49,16,12,0,12,1,3,33,25,1,2,5,0
S01013178,Rented or living rent free: Private rented or living rent free,45,32,28,7,21,1,3,13,3,0,1,9,0
S01013179,All HRPs aged 16 and over,363,226,184,37,147,29,13,137,96,0,9,31,1
S01013179,Owned: Total,242,169,140,18,122,27,2,73,71,0,0,2,0
S01013179,Owned: Owned outright,115,52,38,3,35,13,1,63,63,0,0,0,0
S01013179,Owned: Owned with a mortgage or loan or shared ownership,127,117,102,15,87,14,1,10,8,0,0,2,0
S01013179,Rented or living rent free: Total,121,57,44,19,25,2,11,64,25,0,9,29,1
S01013179,Rented or living rent free: Social rented,89,36,28,14,14,1,7,53,21,0,4,27,1
S01013179,Rented or living rent free: Private rented or living rent free,32,21,16,5,11,1,4,11,4,0,5,2,0
S01013180,All HRPs aged 16 and over,170,133,115,15,100,14,4,37,28,2,1,5,1
S01013180,Owned: Total,151,120,106,14,92,12,2,31,27,1,0,2,1
S01013180,Owned: Owned outright,44,22,18,4,14,4,0,22,20,0,0,1,1
S01013180,Owned: Owned with a mortgage or loan or shared ownership,107,98,88,10,78,8,2,9,7,1,0,1,0
S01013180,Rented or living rent free: Total,19,13,9,1,8,2,2,6,1,1,1,3,0
S01013180,Rented or living rent free: Social rented,2,0,0,0,0,0,0,2,1,0,0,1,0
S01013180,Rented or living rent free: Private rented or living rent free,17,13,9,1,8,2,2,4,0,1,1,2,0
S01013181,All HRPs aged 16 and over,310,187,169,18,151,13,5,123,104,2,1,15,1
S01013181,Owned: Total,253,165,151,13,138,12,2,88,81,2,0,4,1
S01013181,Owned: Owned outright,111,41,36,8,28,3,2,70,68,1,0,0,1
S01013181,Owned: Owned with a mortgage or loan or shared ownership,142,124,115,5,110,9,0,18,13,1,0,4,0
S01013181,Rented or living rent free: Total,57,22,18,5,13,1,3,35,23,0,1,11,0
S01013181,Rented or living rent free: Social rented,44,11,10,5,5,0,1,33,21,0,1,11,0
S01013181,Rented or living rent free: Private rented or living rent free,13,11,8,0,8,1,2,2,2,0,0,0,0
S01013182,All HRPs aged 16 and over,372,178,149,23,126,13,16,194,152,0,5,33,4
S01013182,Owned: Total,224,130,117,13,104,10,3,94,90,0,0,4,0
S01013182,Owned: Owned outright,104,25,22,3,19,2,1,79,76,0,0,3,0
S01013182,Owned: Owned with a mortgage or loan or shared ownership,120,105,95,10,85,8,2,15,14,0,0,1,0
S01013182,Rented or living rent free: Total,148,48,32,10,22,3,13,100,62,0,5,29,4
S01013182,Rented or living rent free: Social rented,118,31,25,9,16,0,6,87,55,0,3,26,3
S01013182,Rented or living rent free: Private rented or living rent free,30,17,7,1,6,3,7,13,7,0,2,3,1
S01013183,All HRPs aged 16 and over,334,235,203,20,183,24,8,99,76,0,0,19,4
S01013183,Owned: Total,272,210,185,14,171,24,1,62,59,0,0,2,1
S01013183,Owned: Owned outright,133,76,65,8,57,10,1,57,54,0,0,2,1
S01013183,Owned: Owned with a mortgage or loan or shared ownership,139,134,120,6,114,14,0,5,5,0,0,0,0
S01013183,Rented or living rent free: Total,62,25,18,6,12,0,7,37,17,0,0,17,3
S01013183,Rented or living rent free: Social rented,56,21,14,5,9,0,7,35,15,0,0,17,3
S01013183,Rented or living rent free: Private rented or living rent free,6,4,4,1,3,0,0,2,2,0,0,0,0
S01013184,All HRPs aged 16 and over,279,167,123,36,87,8,36,112,44,3,18,38,9
S01013184,Owned: Total,77,57,51,7,44,4,2,20,19,0,0,1,0
S01013184,Owned: Owned outright,25,10,8,2,6,2,0,15,14,0,0,1,0
S01013184,Owned: Owned with a mortgage or loan or shared ownership,52,47,43,5,38,2,2,5,5,0,0,0,0
S01013184,Rented or living rent free: Total,202,110,72,29,43,4,34,92,25,3,18,37,9
S01013184,Rented or living rent free: Social rented,181,102,65,26,39,4,33,79,24,1,12,34,8
S01013184,Rented or living rent free: Private rented or living rent free,21,8,7,3,4,0,1,13,1,2,6,3,1
S01013185,All HRPs aged 16 and over,362,213,176,37,139,10,27,149,99,0,17,26,7
S01013185,Owned: Total,184,122,115,15,100,4,3,62,57,0,0,2,3
S01013185,Owned: Owned outright,64,14,13,3,10,0,1,50,46,0,0,2,2
S01013185,Owned: Owned with a mortgage or loan or shared ownership,120,108,102,12,90,4,2,12,11,0,0,0,1
S01013185,Rented or living rent free: Total,178,91,61,22,39,6,24,87,42,0,17,24,4
S01013185,Rented or living rent free: Social rented,166,85,57,22,35,6,22,81,40,0,13,24,4
S01013185,Rented or living rent free: Private rented or living rent free,12,6,4,0,4,0,2,6,2,0,4,0,0
S01013186,All HRPs aged 16 and over,292,187,146,31,115,12,29,105,53,2,17,22,11
S01013186,Owned: Total,122,84,72,5,67,9,3,38,34,0,1,1,2
S01013186,Owned: Owned outright,41,14,12,3,9,1,1,27,26,0,1,0,0
S01013186,Owned: Owned with a mortgage or loan or shared ownership,81,70,60,2,58,8,2,11,8,0,0,1,2
S01013186,Rented or living rent free: Total,170,103,74,26,48,3,26,67,19,2,16,21,9
S01013186,Rented or living rent free: Social rented,159,95,69,26,43,3,23,64,19,2,15,19,9
S01013186,Rented or living rent free: Private rented or living rent free,11,8,5,0,5,0,3,3,0,0,1,2,0
S01013187,All HRPs aged 16 and over,386,234,187,38,149,14,33,152,81,5,13,48,5
S01013187,Owned: Total,174,121,111,11,100,7,3,53,45,0,1,5,2
S01013187,Owned: Owned outright,63,20,19,5,14,0,1,43,41,0,0,1,1
S01013187,Owned: Owned with a mortgage or loan or shared ownership,111,101,92,6,86,7,2,10,4,0,1,4,1
S01013187,Rented or living rent free: Total,212,113,76,27,49,7,30,99,36,5,12,43,3
S01013187,Rented or living rent free: Social rented,198,103,67,24,43,6,30,95,35,5,11,42,2
S01013187,Rented or living rent free: Private rented or living rent free,14,10,9,3,6,1,0,4,1,0,1,1,1
S01013188,All HRPs aged 16 and over,348,242,222,28,194,14,6,106,88,0,5,9,4
S01013188,Owned: Total,269,195,182,20,162,11,2,74,72,0,0,1,1
S01013188,Owned: Owned outright,106,41,41,9,32,0,0,65,64,0,0,0,1
S01013188,Owned: Owned with a mortgage or loan or shared ownership,163,154,141,11,130,11,2,9,8,0,0,1,0
S01013188,Rented or living rent free: Total,79,47,40,8,32,3,4,32,16,0,5,8,3
S01013188,Rented or living rent free: Social rented,61,35,28,6,22,3,4,26,14,0,4,6,2
S01013188,Rented or living rent free: Private rented or living rent free,18,12,12,2,10,0,0,6,2,0,1,2,1
S01013189,All HRPs aged 16 and over,238,145,119,15,104,21,5,93,81,0,0,8,4
S01013189,Owned: Total,204,130,109,11,98,20,1,74,70,0,0,2,2
S01013189,Owned: Owned outright,96,34,28,7,21,6,0,62,59,0,0,1,2
S01013189,Owned: Owned with a mortgage or loan or shared ownership,108,96,81,4,77,14,1,12,11,0,0,1,0
S01013189,Rented or living rent free: Total,34,15,10,4,6,1,4,19,11,0,0,6,2
S01013189,Rented or living rent free: Social rented,24,11,7,3,4,1,3,13,7,0,0,6,0
S01013189,Rented or living rent free: Private rented or living rent free,10,4,3,1,2,0,1,6,4,0,0,0,2
S01013190,All HRPs aged 16 and over,367,213,191,37,154,12,10,154,108,0,4,36,6
S01013190,Owned: Total,211,157,148,16,132,8,1,54,49,0,0,1,4
S01013190,Owned: Owned outright,64,25,23,5,18,2,0,39,36,0,0,1,2
S01013190,Owned: Owned with a mortgage or loan or shared ownership,147,132,125,11,114,6,1,15,13,0,0,0,2
S01013190,Rented or living rent free: Total,156,56,43,21,22,4,9,100,59,0,4,35,2
S01013190,Rented or living rent free: Social rented,135,39,28,16,12,3,8,96,56,0,4,35,1
S01013190,Rented or living rent free: Private rented or living rent free,21,17,15,5,10,1,1,4,3,0,0,0,1
S01013191,All HRPs aged 16 and over,386,302,274,26,248,25,3,84,76,0,1,7,0
S01013191,Owned: Total,369,295,267,26,241,25,3,74,69,0,1,4,0
S01013191,Owned: Owned outright,138,70,64,14,50,4,2,68,64,0,1,3,0
S01013191,Owned: Owned with a mortgage or loan or shared ownership,231,225,203,12,191,21,1,6,5,0,0,1,0
S01013191,Rented or living rent free: Total,17,7,7,0,7,0,0,10,7,0,0,3,0
S01013191,Rented or living rent free: Social rented,7,0,0,0,0,0,0,7,5,0,0,2,0
S01013191,Rented or living rent free: Private rented or living rent free,10,7,7,0,7,0,0,3,2,0,0,1,0
S01013192,All HRPs aged 16 and over,417,254,227,28,199,19,8,163,131,1,2,22,7
S01013192,Owned: Total,318,206,186,18,168,19,1,112,105,1,0,1,5
S01013192,Owned: Owned outright,146,46,39,3,36,6,1,100,94,0,0,1,5
S01013192,Owned: Owned with a mortgage or loan or shared ownership,172,160,147,15,132,13,0,12,11,1,0,0,0
S01013192,Rented or living rent free: Total,99,48,41,10,31,0,7,51,26,0,2,21,2
S01013192,Rented or living rent free: Social rented,58,17,15,4,11,0,2,41,22,0,2,16,1
S01013192,Rented or living rent free: Private rented or living rent free,41,31,26,6,20,0,5,10,4,0,0,5,1
S01013193,All HRPs aged 16 and over,356,246,214,25,189,20,12,110,82,2,7,16,3
S01013193,Owned: Total,263,186,167,16,151,17,2,77,68,0,4,4,1
S01013193,Owned: Owned outright,89,31,26,5,21,5,0,58,56,0,1,0,1
S01013193,Owned: Owned with a mortgage or loan or shared ownership,174,155,141,11,130,12,2,19,12,0,3,4,0
S01013193,Rented or living rent free: Total,93,60,47,9,38,3,10,33,14,2,3,12,2
S01013193,Rented or living rent free: Social rented,29,11,7,3,4,1,3,18,10,1,0,6,1
S01013193,Rented or living rent free: Private rented or living rent free,64,49,40,6,34,2,7,15,4,1,3,6,1
S01013194,All HRPs aged 16 and over,319,233,203,33,170,17,13,86,59,1,2,20,4
S01013194,Owned: Total,206,157,140,18,122,11,6,49,44,0,0,5,0
S01013194,Owned: Owned outright,64,27,23,4,19,2,2,37,37,0,0,0,0
S01013194,Owned: Owned with a mortgage or loan or shared ownership,142,130,117,14,103,9,4,12,7,0,0,5,0
S01013194,Rented or living rent free: Total,113,76,63,15,48,6,7,37,15,1,2,15,4
S01013194,Rented or living rent free: Social rented,26,11,8,3,5,1,2,15,8,1,1,5,0
S01013194,Rented or living rent free: Private rented or living rent free,87,65,55,12,43,5,5,22,7,0,1,10,4
S01013195,All HRPs aged 16 and over,597,368,317,26,291,29,22,229,155,14,3,52,5
S01013195,Owned: Total,303,229,199,7,192,22,8,74,65,2,0,7,0
S01013195,Owned: Owned outright,86,31,24,5,19,4,3,55,52,0,0,3,0
S01013195,Owned: Owned with a mortgage or loan or shared ownership,217,198,175,2,173,18,5,19,13,2,0,4,0
S01013195,Rented or living rent free: Total,294,139,118,19,99,7,14,155,90,12,3,45,5
S01013195,Rented or living rent free: Social rented,137,29,23,4,19,1,5,108,76,8,1,20,3
S01013195,Rented or living rent free: Private rented or living rent free,157,110,95,15,80,6,9,47,14,4,2,25,2
S01013196,All HRPs aged 16 and over,371,277,245,30,215,24,8,94,76,2,1,13,2
S01013196,Owned: Total,274,206,187,20,167,13,6,68,61,0,0,5,2
S01013196,Owned: Owned outright,90,39,31,11,20,5,3,51,47,0,0,2,2
S01013196,Owned: Owned with a mortgage or loan or shared ownership,184,167,156,9,147,8,3,17,14,0,0,3,0
S01013196,Rented or living rent free: Total,97,71,58,10,48,11,2,26,15,2,1,8,0
S01013196,Rented or living rent free: Social rented,17,1,1,0,1,0,0,16,7,0,1,8,0
S01013196,Rented or living rent free: Private rented or living rent free,80,70,57,10,47,11,2,10,8,2,0,0,0
S01013197,All HRPs aged 16 and over,262,134,115,11,104,13,6,128,118,1,2,5,2
S01013197,Owned: Total,197,116,103,8,95,11,2,81,80,0,0,0,1
S01013197,Owned: Owned outright,95,29,24,5,19,4,1,66,65,0,0,0,1
S01013197,Owned: Owned with a mortgage or loan or shared ownership,102,87,79,3,76,7,1,15,15,0,0,0,0
S01013197,Rented or living rent free: Total,65,18,12,3,9,2,4,47,38,1,2,5,1
S01013197,Rented or living rent free: Social rented,48,7,4,1,3,1,2,41,36,1,0,4,0
S01013197,Rented or living rent free: Private rented or living rent free,17,11,8,2,6,1,2,6,2,0,2,1,1
S01013198,All HRPs aged 16 and over,379,200,153,24,129,31,16,179,126,1,6,40,6
S01013198,Owned: Total,210,133,106,10,96,22,5,77,65,0,3,5,4
S01013198,Owned: Owned outright,97,36,23,6,17,9,4,61,55,0,2,0,4
S01013198,Owned: Owned with a mortgage or loan or shared ownership,113,97,83,4,79,13,1,16,10,0,1,5,0
S01013198,Rented or living rent free: Total,169,67,47,14,33,9,11,102,61,1,3,35,2
S01013198,Rented or living rent free: Social rented,132,42,31,13,18,3,8,90,56,0,2,30,2
S01013198,Rented or living rent free: Private rented or living rent free,37,25,16,1,15,6,3,12,5,1,1,5,0
S01013199,All HRPs aged 16 and over,488,257,198,30,168,46,13,231,192,2,8,25,4
S01013199,Owned: Total,255,180,143,21,122,34,3,75,67,0,1,6,1
S01013199,Owned: Owned outright,118,51,40,10,30,11,0,67,61,0,1,5,0
S01013199,Owned: Owned with a mortgage or loan or shared ownership,137,129,103,11,92,23,3,8,6,0,0,1,1
S01013199,Rented or living rent free: Total,233,77,55,9,46,12,10,156,125,2,7,19,3
S01013199,Rented or living rent free: Social rented,188,46,33,7,26,3,10,142,119,1,2,17,3
S01013199,Rented or living rent free: Private rented or living rent free,45,31,22,2,20,9,0,14,6,1,5,2,0
S01013200,All HRPs aged 16 and over,313,180,148,28,120,18,14,133,79,0,14,27,13
S01013200,Owned: Total,168,109,93,7,86,16,0,59,50,0,1,5,3
S01013200,Owned: Owned outright,82,28,23,3,20,5,0,54,46,0,1,4,3
S01013200,Owned: Owned with a mortgage or loan or shared ownership,86,81,70,4,66,11,0,5,4,0,0,1,0
S01013200,Rented or living rent free: Total,145,71,55,21,34,2,14,74,29,0,13,22,10
S01013200,Rented or living rent free: Social rented,127,59,44,19,25,1,14,68,27,0,11,22,8
S01013200,Rented or living rent free: Private rented or living rent free,18,12,11,2,9,1,0,6,2,0,2,0,2
S01013201,All HRPs aged 16 and over,380,199,149,36,113,9,41,181,84,4,10,76,7
S01013201,Owned: Total,110,80,71,10,61,6,3,30,26,0,0,4,0
S01013201,Owned: Owned outright,38,18,16,3,13,1,1,20,18,0,0,2,0
S01013201,Owned: Owned with a mortgage or loan or shared ownership,72,62,55,7,48,5,2,10,8,0,0,2,0
S01013201,Rented or living rent free: Total,270,119,78,26,52,3,38,151,58,4,10,72,7
S01013201,Rented or living rent free: Social rented,267,117,77,26,51,2,38,150,57,4,10,72,7
S01013201,Rented or living rent free: Private rented or living rent free,3,2,1,0,1,1,0,1,1,0,0,0,0
S01013202,All HRPs aged 16 and over,235,146,106,23,83,7,33,89,44,3,11,25,6
S01013202,Owned: Total,103,69,63,8,55,6,0,34,30,0,0,4,0
S01013202,Owned: Owned outright,50,17,16,6,10,1,0,33,29,0,0,4,0
S01013202,Owned: Owned with a mortgage or loan or shared ownership,53,52,47,2,45,5,0,1,1,0,0,0,0
S01013202,Rented or living rent free: Total,132,77,43,15,28,1,33,55,14,3,11,21,6
S01013202,Rented or living rent free: Social rented,121,71,37,14,23,1,33,50,13,3,9,19,6
S01013202,Rented or living rent free: Private rented or living rent free,11,6,6,1,5,0,0,5,1,0,2,2,0
S01013203,All HRPs aged 16 and over,355,218,173,26,147,12,33,137,89,2,16,25,5
S01013203,Owned: Total,171,122,112,8,104,9,1,49,45,0,0,3,1
S01013203,Owned: Owned outright,65,28,24,0,24,4,0,37,35,0,0,1,1
S01013203,Owned: Owned with a mortgage or loan or shared ownership,106,94,88,8,80,5,1,12,10,0,0,2,0
S01013203,Rented or living rent free: Total,184,96,61,18,43,3,32,88,44,2,16,22,4
S01013203,Rented or living rent free: Social rented,166,89,57,17,40,3,29,77,39,1,13,20,4
S01013203,Rented or living rent free: Private rented or living rent free,18,7,4,1,3,0,3,11,5,1,3,2,0
S01013204,All HRPs aged 16 and over,332,257,235,18,217,11,11,75,56,2,7,9,1
S01013204,Owned: Total,264,220,211,13,198,5,4,44,41,0,1,2,0
S01013204,Owned: Owned outright,68,34,31,2,29,1,2,34,33,0,0,1,0
S01013204,Owned: Owned with a mortgage or loan or shared ownership,196,186,180,11,169,4,2,10,8,0,1,1,0
S01013204,Rented or living rent free: Total,68,37,24,5,19,6,7,31,15,2,6,7,1
S01013204,Rented or living rent free: Social rented,41,17,10,2,8,2,5,24,13,1,3,6,1
S01013204,Rented or living rent free: Private rented or living rent free,27,20,14,3,11,4,2,7,2,1,3,1,0
S01013205,All HRPs aged 16 and over,240,136,100,20,80,9,27,104,50,1,23,27,3
S01013205,Owned: Total,92,58,53,7,46,4,1,34,28,0,1,5,0
S01013205,Owned: Owned outright,28,8,8,1,7,0,0,20,17,0,1,2,0
S01013205,Owned: Owned with a mortgage or loan or shared ownership,64,50,45,6,39,4,1,14,11,0,0,3,0
S01013205,Rented or living rent free: Total,148,78,47,13,34,5,26,70,22,1,22,22,3
S01013205,Rented or living rent free: Social rented,140,75,46,13,33,4,25,65,21,1,20,21,2
S01013205,Rented or living rent free: Private rented or living rent free,8,3,1,0,1,1,1,5,1,0,2,1,1
S01013206,All HRPs aged 16 and over,298,166,130,27,103,8,28,132,75,3,15,29,10
S01013206,Owned: Total,144,96,90,14,76,5,1,48,42,0,0,3,3
S01013206,Owned: Owned outright,55,21,21,7,14,0,0,34,32,0,0,1,1
S01013206,Owned: Owned with a mortgage or loan or shared ownership,89,75,69,7,62,5,1,14,10,0,0,2,2
S01013206,Rented or living rent free: Total,154,70,40,13,27,3,27,84,33,3,15,26,7
S01013206,Rented or living rent free: Social rented,134,60,33,10,23,3,24,74,30,3,12,23,6
S01013206,Rented or living rent free: Private rented or living rent free,20,10,7,3,4,0,3,10,3,0,3,3,1
S01013207,All HRPs aged 16 and over,390,230,180,47,133,31,19,160,90,5,14,42,9
S01013207,Owned: Total,196,143,117,16,101,23,3,53,48,0,0,3,2
S01013207,Owned: Owned outright,87,42,32,8,24,8,2,45,42,0,0,2,1
S01013207,Owned: Owned with a mortgage or loan or shared ownership,109,101,85,8,77,15,1,8,6,0,0,1,1
S01013207,Rented or living rent free: Total,194,87,63,31,32,8,16,107,42,5,14,39,7
S01013207,Rented or living rent free: Social rented,158,63,44,20,24,5,14,95,38,5,12,33,7
S01013207,Rented or living rent free: Private rented or living rent free,36,24,19,11,8,3,2,12,4,0,2,6,0
S01013208,All HRPs aged 16 and over,436,257,207,39,168,23,27,179,67,10,14,73,15
S01013208,Owned: Total,161,123,108,12,96,12,3,38,31,0,0,5,2
S01013208,Owned: Owned outright,52,24,22,5,17,1,1,28,24,0,0,3,1
S01013208,Owned: Owned with a mortgage or loan or shared ownership,109,99,86,7,79,11,2,10,7,0,0,2,1
S01013208,Rented or living rent free: Total,275,134,99,27,72,11,24,141,36,10,14,68,13
S01013208,Rented or living rent free: Social rented,241,110,84,25,59,11,15,131,36,10,11,62,12
S01013208,Rented or living rent free: Private rented or living rent free,34,24,15,2,13,0,9,10,0,0,3,6,1
S01013209,All HRPs aged 16 and over,435,251,201,34,167,31,19,184,141,0,12,24,7
S01013209,Owned: Total,255,169,141,19,122,22,6,86,81,0,1,3,1
S01013209,Owned: Owned outright,99,37,30,9,21,4,3,62,59,0,1,1,1
S01013209,Owned: Owned with a mortgage or loan or shared ownership,156,132,111,10,101,18,3,24,22,0,0,2,0
S01013209,Rented or living rent free: Total,180,82,60,15,45,9,13,98,60,0,11,21,6
S01013209,Rented or living rent free: Social rented,111,32,25,11,14,2,5,79,46,0,9,19,5
S01013209,Rented or living rent free: Private rented or living rent free,69,50,35,4,31,7,8,19,14,0,2,2,1
S01013210,All HRPs aged 16 and over,253,171,139,18,121,27,5,82,75,1,3,3,0
S01013210,Owned: Total,227,159,128,17,111,27,4,68,68,0,0,0,0
S01013210,Owned: Owned outright,113,47,35,10,25,9,3,66,66,0,0,0,0
S01013210,Owned: Owned with a mortgage or loan or shared ownership,114,112,93,7,86,18,1,2,2,0,0,0,0
S01013210,Rented or living rent free: Total,26,12,11,1,10,0,1,14,7,1,3,3,0
S01013210,Rented or living rent free: Social rented,7,2,1,1,0,0,1,5,1,1,0,3,0
S01013210,Rented or living rent free: Private rented or living rent free,19,10,10,0,10,0,0,9,6,0,3,0,0
S01013211,All HRPs aged 16 and over,410,273,243,31,212,19,11,137,90,1,5,36,5
S01013211,Owned: Total,291,217,199,25,174,15,3,74,66,0,0,5,3
S01013211,Owned: Owned outright,101,43,39,12,27,3,1,58,53,0,0,3,2
S01013211,Owned: Owned with a mortgage or loan or shared ownership,190,174,160,13,147,12,2,16,13,0,0,2,1
S01013211,Rented or living rent free: Total,119,56,44,6,38,4,8,63,24,1,5,31,2
S01013211,Rented or living rent free: Social rented,89,37,27,5,22,3,7,52,23,0,5,22,2
S01013211,Rented or living rent free: Private rented or living rent free,30,19,17,1,16,1,1,11,1,1,0,9,0
S01013212,All HRPs aged 16 and over,192,175,153,9,144,21,1,17,14,1,1,1,0
S01013212,Owned: Total,180,166,145,7,138,21,0,14,13,0,1,0,0
S01013212,Owned: Owned outright,43,33,31,1,30,2,0,10,10,0,0,0,0
S01013212,Owned: Owned with a mortgage or loan or shared ownership,137,133,114,6,108,19,0,4,3,0,1,0,0
S01013212,Rented or living rent free: Total,12,9,8,2,6,0,1,3,1,1,0,1,0
S01013212,Rented or living rent free: Social rented,4,3,3,1,2,0,0,1,0,0,0,1,0
S01013212,Rented or living rent free: Private rented or living rent free,8,6,5,1,4,0,1,2,1,1,0,0,0
S01013213,All HRPs aged 16 and over,197,168,139,15,124,28,1,29,27,0,0,2,0
S01013213,Owned: Total,188,160,134,14,120,26,0,28,26,0,0,2,0
S01013213,Owned: Owned outright,62,40,32,7,25,8,0,22,22,0,0,0,0
S01013213,Owned: Owned with a mortgage or loan or shared ownership,126,120,102,7,95,18,0,6,4,0,0,2,0
S01013213,Rented or living rent free: Total,9,8,5,1,4,2,1,1,1,0,0,0,0
S01013213,Rented or living rent free: Social rented,4,3,3,0,3,0,0,1,1,0,0,0,0
S01013213,Rented or living rent free: Private rented or living rent free,5,5,2,1,1,2,1,0,0,0,0,0,0
S01013214,All HRPs aged 16 and over,159,135,118,8,110,16,1,24,22,0,0,2,0
S01013214,Owned: Total,153,131,114,7,107,16,1,22,21,0,0,1,0
S01013214,Owned: Owned outright,31,18,14,2,12,4,0,13,13,0,0,0,0
S01013214,Owned: Owned with a mortgage or loan or shared ownership,122,113,100,5,95,12,1,9,8,0,0,1,0
S01013214,Rented or living rent free: Total,6,4,4,1,3,0,0,2,1,0,0,1,0
S01013214,Rented or living rent free: Social rented,2,1,1,1,0,0,0,1,0,0,0,1,0
S01013214,Rented or living rent free: Private rented or living rent free,4,3,3,0,3,0,0,1,1,0,0,0,0
S01013215,All HRPs aged 16 and over,385,303,258,35,223,20,25,82,52,3,9,16,2
S01013215,Owned: Total,265,223,201,19,182,16,6,42,39,0,0,1,2
S01013215,Owned: Owned outright,57,30,26,4,22,2,2,27,25,0,0,0,2
S01013215,Owned: Owned with a mortgage or loan or shared ownership,208,193,175,15,160,14,4,15,14,0,0,1,0
S01013215,Rented or living rent free: Total,120,80,57,16,41,4,19,40,13,3,9,15,0
S01013215,Rented or living rent free: Social rented,63,38,25,8,17,3,10,25,10,3,1,11,0
S01013215,Rented or living rent free: Private rented or living rent free,57,42,32,8,24,1,9,15,3,0,8,4,0
S01013216,All HRPs aged 16 and over,237,163,140,35,105,10,13,74,36,0,14,19,5
S01013216,Owned: Total,120,99,89,12,77,8,2,21,19,0,0,1,1
S01013216,Owned: Owned outright,29,17,15,3,12,1,1,12,11,0,0,0,1
S01013216,Owned: Owned with a mortgage or loan or shared ownership,91,82,74,9,65,7,1,9,8,0,0,1,0
S01013216,Rented or living rent free: Total,117,64,51,23,28,2,11,53,17,0,14,18,4
S01013216,Rented or living rent free: Social rented,99,53,41,20,21,1,11,46,16,0,10,16,4
S01013216,Rented or living rent free: Private rented or living rent free,18,11,10,3,7,1,0,7,1,0,4,2,0
S01013217,All HRPs aged 16 and over,279,196,167,27,140,15,14,83,52,1,12,14,4
S01013217,Owned: Total,176,137,123,17,106,10,4,39,35,0,0,3,1
S01013217,Owned: Owned outright,59,30,28,6,22,1,1,29,29,0,0,0,0
S01013217,Owned: Owned with a mortgage or loan or shared ownership,117,107,95,11,84,9,3,10,6,0,0,3,1
S01013217,Rented or living rent free: Total,103,59,44,10,34,5,10,44,17,1,12,11,3
S01013217,Rented or living rent free: Social rented,86,48,36,7,29,2,10,38,17,1,8,10,2
S01013217,Rented or living rent free: Private rented or living rent free,17,11,8,3,5,3,0,6,0,0,4,1,1
S01013218,All HRPs aged 16 and over,251,161,132,34,98,8,21,90,40,1,23,25,1
S01013218,Owned: Total,94,72,67,8,59,5,0,22,19,0,0,3,0
S01013218,Owned: Owned outright,20,5,5,3,2,0,0,15,14,0,0,1,0
S01013218,Owned: Owned with a mortgage or loan or shared ownership,74,67,62,5,57,5,0,7,5,0,0,2,0
S01013218,Rented or living rent free: Total,157,89,65,26,39,3,21,68,21,1,23,22,1
S01013218,Rented or living rent free: Social rented,133,76,57,23,34,2,17,57,20,1,13,22,1
S01013218,Rented or living rent free: Private rented or living rent free,24,13,8,3,5,1,4,11,1,0,10,0,0
S01013219,All HRPs aged 16 and over,220,144,119,27,92,8,17,76,35,2,13,24,2
S01013219,Owned: Total,91,72,63,8,55,4,5,19,18,0,0,1,0
S01013219,Owned: Owned outright,35,19,17,0,17,2,0,16,15,0,0,1,0
S01013219,Owned: Owned with a mortgage or loan or shared ownership,56,53,46,8,38,2,5,3,3,0,0,0,0
S01013219,Rented or living rent free: Total,129,72,56,19,37,4,12,57,17,2,13,23,2
S01013219,Rented or living rent free: Social rented,117,65,51,18,33,4,10,52,16,2,9,23,2
S01013219,Rented or living rent free: Private rented or living rent free,12,7,5,1,4,0,2,5,1,0,4,0,0
S01013220,All HRPs aged 16 and over,313,170,129,31,98,11,30,143,87,1,23,21,11
S01013220,Owned: Total,153,96,85,16,69,8,3,57,49,0,2,5,1
S01013220,Owned: Owned outright,66,20,15,3,12,3,2,46,41,0,0,4,1
S01013220,Owned: Owned with a mortgage or loan or shared ownership,87,76,70,13,57,5,1,11,8,0,2,1,0
S01013220,Rented or living rent free: Total,160,74,44,15,29,3,27,86,38,1,21,16,10
S01013220,Rented or living rent free: Social rented,141,68,40,12,28,3,25,73,35,1,12,15,10
S01013220,Rented or living rent free: Private rented or living rent free,19,6,4,3,1,0,2,13,3,0,9,1,0
S01013221,All HRPs aged 16 and over,382,242,193,44,149,32,17,140,90,3,16,25,6
S01013221,Owned: Total,182,131,110,13,97,19,2,51,50,0,0,1,0
S01013221,Owned: Owned outright,74,36,24,5,19,11,1,38,37,0,0,1,0
S01013221,Owned: Owned with a mortgage or loan or shared ownership,108,95,86,8,78,8,1,13,13,0,0,0,0
S01013221,Rented or living rent free: Total,200,111,83,31,52,13,15,89,40,3,16,24,6
S01013221,Rented or living rent free: Social rented,175,96,73,25,48,11,12,79,37,3,14,21,4
S01013221,Rented or living rent free: Private rented or living rent free,25,15,10,6,4,2,3,10,3,0,2,3,2
S01013222,All HRPs aged 16 and over,316,150,121,23,98,14,15,166,97,4,13,46,6
S01013222,Owned: Total,92,72,61,4,57,9,2,20,18,0,0,2,0
S01013222,Owned: Owned outright,28,15,8,1,7,5,2,13,11,0,0,2,0
S01013222,Owned: Owned with a mortgage or loan or shared ownership,64,57,53,3,50,4,0,7,7,0,0,0,0
S01013222,Rented or living rent free: Total,224,78,60,19,41,5,13,146,79,4,13,44,6
S01013222,Rented or living rent free: Social rented,205,66,52,17,35,4,10,139,75,2,12,44,6
S01013222,Rented or living rent free: Private rented or living rent free,19,12,8,2,6,1,3,7,4,2,1,0,0
S01013223,All HRPs aged 16 and over,637,324,243,38,205,35,46,313,222,6,15,56,14
S01013223,Owned: Total,268,201,167,16,151,28,6,67,64,0,2,0,1
S01013223,Owned: Owned outright,80,26,22,7,15,4,0,54,52,0,1,0,1
S01013223,Owned: Owned with a mortgage or loan or shared ownership,188,175,145,9,136,24,6,13,12,0,1,0,0
S01013223,Rented or living rent free: Total,369,123,76,22,54,7,40,246,158,6,13,56,13
S01013223,Rented or living rent free: Social rented,292,77,38,12,26,3,36,215,142,3,9,52,9
S01013223,Rented or living rent free: Private rented or living rent free,77,46,38,10,28,4,4,31,16,3,4,4,4
S01013224,All HRPs aged 16 and over,370,254,209,34,175,20,25,116,69,0,6,33,8
S01013224,Owned: Total,227,177,156,17,139,14,7,50,45,0,1,1,3
S01013224,Owned: Owned outright,74,35,28,8,20,5,2,39,37,0,0,0,2
S01013224,Owned: Owned with a mortgage or loan or shared ownership,153,142,128,9,119,9,5,11,8,0,1,1,1
S01013224,Rented or living rent free: Total,143,77,53,17,36,6,18,66,24,0,5,32,5
S01013224,Rented or living rent free: Social rented,128,65,42,16,26,5,18,63,24,0,5,29,5
S01013224,Rented or living rent free: Private rented or living rent free,15,12,11,1,10,1,0,3,0,0,0,3,0
S01013225,All HRPs aged 16 and over,315,191,169,34,135,11,11,124,73,2,12,28,9
S01013225,Owned: Total,145,110,98,12,86,9,3,35,32,0,0,2,1
S01013225,Owned: Owned outright,46,21,15,6,9,5,1,25,22,0,0,2,1
S01013225,Owned: Owned with a mortgage or loan or shared ownership,99,89,83,6,77,4,2,10,10,0,0,0,0
S01013225,Rented or living rent free: Total,170,81,71,22,49,2,8,89,41,2,12,26,8
S01013225,Rented or living rent free: Social rented,159,73,63,21,42,2,8,86,40,2,12,24,8
S01013225,Rented or living rent free: Private rented or living rent free,11,8,8,1,7,0,0,3,1,0,0,2,0
S01013226,All HRPs aged 16 and over,207,171,151,19,132,15,5,36,26,1,4,4,1
S01013226,Owned: Total,165,142,123,14,109,15,4,23,22,1,0,0,0
S01013226,Owned: Owned outright,47,27,21,6,15,4,2,20,19,1,0,0,0
S01013226,Owned: Owned with a mortgage or loan or shared ownership,118,115,102,8,94,11,2,3,3,0,0,0,0
S01013226,Rented or living rent free: Total,42,29,28,5,23,0,1,13,4,0,4,4,1
S01013226,Rented or living rent free: Social rented,25,15,14,3,11,0,1,10,1,0,4,4,1
S01013226,Rented or living rent free: Private rented or living rent free,17,14,14,2,12,0,0,3,3,0,0,0,0
S01013227,All HRPs aged 16 and over,366,184,154,26,128,10,20,182,101,8,17,44,12
S01013227,Owned: Total,133,85,80,8,72,5,0,48,43,1,0,3,1
S01013227,Owned: Owned outright,48,18,17,3,14,1,0,30,27,0,0,2,1
S01013227,Owned: Owned with a mortgage or loan or shared ownership,85,67,63,5,58,4,0,18,16,1,0,1,0
S01013227,Rented or living rent free: Total,233,99,74,18,56,5,20,134,58,7,17,41,11
S01013227,Rented or living rent free: Social rented,222,91,72,17,55,1,18,131,57,7,17,41,9
S01013227,Rented or living rent free: Private rented or living rent free,11,8,2,1,1,4,2,3,1,0,0,0,2
S01013228,All HRPs aged 16 and over,416,283,208,32,176,34,41,133,75,1,16,33,8
S01013228,Owned: Total,229,174,147,16,131,21,6,55,47,1,4,0,3
S01013228,Owned: Owned outright,73,36,26,5,21,9,1,37,36,0,0,0,1
S01013228,Owned: Owned with a mortgage or loan or shared ownership,156,138,121,11,110,12,5,18,11,1,4,0,2
S01013228,Rented or living rent free: Total,187,109,61,16,45,13,35,78,28,0,12,33,5
S01013228,Rented or living rent free: Social rented,83,36,15,4,11,3,18,47,19,0,5,20,3
S01013228,Rented or living rent free: Private rented or living rent free,104,73,46,12,34,10,17,31,9,0,7,13,2
S01013229,All HRPs aged 16 and over,370,226,197,43,154,8,21,144,91,1,9,36,7
S01013229,Owned: Total,197,130,120,16,104,8,2,67,58,0,0,5,4
S01013229,Owned: Owned outright,65,19,18,5,13,1,0,46,41,0,0,3,2
S01013229,Owned: Owned with a mortgage or loan or shared ownership,132,111,102,11,91,7,2,21,17,0,0,2,2
S01013229,Rented or living rent free: Total,173,96,77,27,50,0,19,77,33,1,9,31,3
S01013229,Rented or living rent free: Social rented,147,79,60,24,36,0,19,68,31,1,6,27,3
S01013229,Rented or living rent free: Private rented or living rent free,26,17,17,3,14,0,0,9,2,0,3,4,0
S01013230,All HRPs aged 16 and over,327,162,149,26,123,11,2,165,136,0,5,21,3
S01013230,Owned: Total,198,115,105,14,91,9,1,83,78,0,0,4,1
S01013230,Owned: Owned outright,86,30,29,10,19,1,0,56,54,0,0,1,1
S01013230,Owned: Owned with a mortgage or loan or shared ownership,112,85,76,4,72,8,1,27,24,0,0,3,0
S01013230,Rented or living rent free: Total,129,47,44,12,32,2,1,82,58,0,5,17,2
S01013230,Rented or living rent free: Social rented,102,27,25,8,17,1,1,75,55,0,2,16,2
S01013230,Rented or living rent free: Private rented or living rent free,27,20,19,4,15,1,0,7,3,0,3,1,0
S01013231,All HRPs aged 16 and over,374,213,191,34,157,15,7,161,108,1,13,38,1
S01013231,Owned: Total,189,139,130,14,116,9,0,50,48,0,0,2,0
S01013231,Owned: Owned outright,71,32,31,6,25,1,0,39,38,0,0,1,0
S01013231,Owned: Owned with a mortgage or loan or shared ownership,118,107,99,8,91,8,0,11,10,0,0,1,0
S01013231,Rented or living rent free: Total,185,74,61,20,41,6,7,111,60,1,13,36,1
S01013231,Rented or living rent free: Social rented,152,57,47,19,28,3,7,95,56,1,4,33,1
S01013231,Rented or living rent free: Private rented or living rent free,33,17,14,1,13,3,0,16,4,0,9,3,0
S01013232,All HRPs aged 16 and over,331,162,144,22,122,15,3,169,122,0,13,31,3
S01013232,Owned: Total,192,117,103,11,92,14,0,75,67,0,1,6,1
S01013232,Owned: Owned outright,96,37,34,7,27,3,0,59,54,0,1,3,1
S01013232,Owned: Owned with a mortgage or loan or shared ownership,96,80,69,4,65,11,0,16,13,0,0,3,0
S01013232,Rented or living rent free: Total,139,45,41,11,30,1,3,94,55,0,12,25,2
S01013232,Rented or living rent free: Social rented,109,32,29,8,21,0,3,77,50,0,4,23,0
S01013232,Rented or living rent free: Private rented or living rent free,30,13,12,3,9,1,0,17,5,0,8,2,2
S01013233,All HRPs aged 16 and over,262,158,136,29,107,17,5,104,93,3,1,6,1
S01013233,Owned: Total,195,120,101,17,84,16,3,75,72,0,0,2,1
S01013233,Owned: Owned outright,102,43,35,7,28,5,3,59,57,0,0,1,1
S01013233,Owned: Owned with a mortgage or loan or shared ownership,93,77,66,10,56,11,0,16,15,0,0,1,0
S01013233,Rented or living rent free: Total,67,38,35,12,23,1,2,29,21,3,1,4,0
S01013233,Rented or living rent free: Social rented,43,20,19,9,10,0,1,23,18,0,1,4,0
S01013233,Rented or living rent free: Private rented or living rent free,24,18,16,3,13,1,1,6,3,3,0,0,0
S01013234,All HRPs aged 16 and over,137,117,94,11,83,22,1,20,16,0,2,0,2
S01013234,Owned: Total,125,111,89,11,78,21,1,14,13,0,1,0,0
S01013234,Owned: Owned outright,41,29,21,6,15,8,0,12,11,0,1,0,0
S01013234,Owned: Owned with a mortgage or loan or shared ownership,84,82,68,5,63,13,1,2,2,0,0,0,0
S01013234,Rented or living rent free: Total,12,6,5,0,5,1,0,6,3,0,1,0,2
S01013234,Rented or living rent free: Social rented,7,3,2,0,2,1,0,4,1,0,1,0,2
S01013234,Rented or living rent free: Private rented or living rent free,5,3,3,0,3,0,0,2,2,0,0,0,0
S01013235,All HRPs aged 16 and over,386,234,200,28,172,24,10,152,128,2,6,12,4
S01013235,Owned: Total,273,183,154,15,139,23,6,90,86,1,0,2,1
S01013235,Owned: Owned outright,121,50,34,8,26,12,4,71,68,1,0,2,0
S01013235,Owned: Owned with a mortgage or loan or shared ownership,152,133,120,7,113,11,2,19,18,0,0,0,1
S01013235,Rented or living rent free: Total,113,51,46,13,33,1,4,62,42,1,6,10,3
S01013235,Rented or living rent free: Social rented,64,20,18,9,9,0,2,44,32,0,0,9,3
S01013235,Rented or living rent free: Private rented or living rent free,49,31,28,4,24,1,2,18,10,1,6,1,0
S01013236,All HRPs aged 16 and over,381,218,169,28,141,44,5,163,143,2,8,8,2
S01013236,Owned: Total,325,187,145,21,124,40,2,138,135,0,1,1,1
S01013236,Owned: Owned outright,189,63,44,16,28,19,0,126,124,0,1,1,0
S01013236,Owned: Owned with a mortgage or loan or shared ownership,136,124,101,5,96,21,2,12,11,0,0,0,1
S01013236,Rented or living rent free: Total,56,31,24,7,17,4,3,25,8,2,7,7,1
S01013236,Rented or living rent free: Social rented,44,25,20,7,13,3,2,19,6,2,4,6,1
S01013236,Rented or living rent free: Private rented or living rent free,12,6,4,0,4,1,1,6,2,0,3,1,0
S01013237,All HRPs aged 16 and over,360,249,209,22,187,29,11,111,64,16,12,14,5
S01013237,Owned: Total,265,206,179,12,167,26,1,59,48,5,3,1,2
S01013237,Owned: Owned outright,70,32,29,7,22,3,0,38,36,1,0,1,0
S01013237,Owned: Owned with a mortgage or loan or shared ownership,195,174,150,5,145,23,1,21,12,4,3,0,2
S01013237,Rented or living rent free: Total,95,43,30,10,20,3,10,52,16,11,9,13,3
S01013237,Rented or living rent free: Social rented,62,24,13,4,9,2,9,38,15,3,8,10,2
S01013237,Rented or living rent free: Private rented or living rent free,33,19,17,6,11,1,1,14,1,8,1,3,1
S01013238,All HRPs aged 16 and over,389,192,144,43,101,13,35,197,115,1,20,53,8
S01013238,Owned: Total,130,80,70,14,56,7,3,50,47,0,2,1,0
S01013238,Owned: Owned outright,54,18,13,3,10,3,2,36,34,0,1,1,0
S01013238,Owned: Owned with a mortgage or loan or shared ownership,76,62,57,11,46,4,1,14,13,0,1,0,0
S01013238,Rented or living rent free: Total,259,112,74,29,45,6,32,147,68,1,18,52,8
S01013238,Rented or living rent free: Social rented,239,101,65,25,40,4,32,138,66,1,13,50,8
S01013238,Rented or living rent free: Private rented or living rent free,20,11,9,4,5,2,0,9,2,0,5,2,0
S01013239,All HRPs aged 16 and over,425,238,201,54,147,10,27,187,90,3,31,50,13
S01013239,Owned: Total,175,120,107,13,94,8,5,55,41,1,1,10,2
S01013239,Owned: Owned outright,64,25,21,5,16,3,1,39,35,0,0,4,0
S01013239,Owned: Owned with a mortgage or loan or shared ownership,111,95,86,8,78,5,4,16,6,1,1,6,2
S01013239,Rented or living rent free: Total,250,118,94,41,53,2,22,132,49,2,30,40,11
S01013239,Rented or living rent free: Social rented,228,106,85,36,49,1,20,122,46,2,28,39,7
S01013239,Rented or living rent free: Private rented or living rent free,22,12,9,5,4,1,2,10,3,0,2,1,4
S01013240,All HRPs aged 16 and over,256,141,112,34,78,9,20,115,53,1,14,41,6
S01013240,Owned: Total,75,54,46,12,34,6,2,21,16,0,0,2,3
S01013240,Owned: Owned outright,30,15,11,1,10,2,2,15,13,0,0,2,0
S01013240,Owned: Owned with a mortgage or loan or shared ownership,45,39,35,11,24,4,0,6,3,0,0,0,3
S01013240,Rented or living rent free: Total,181,87,66,22,44,3,18,94,37,1,14,39,3
S01013240,Rented or living rent free: Social rented,169,83,64,22,42,2,17,86,35,1,10,37,3
S01013240,Rented or living rent free: Private rented or living rent free,12,4,2,0,2,1,1,8,2,0,4,2,0
S01013241,All HRPs aged 16 and over,336,225,190,18,172,32,3,111,103,1,4,0,3
S01013241,Owned: Total,317,216,181,17,164,32,3,101,96,0,2,0,3
S01013241,Owned: Owned outright,175,81,61,11,50,18,2,94,90,0,2,0,2
S01013241,Owned: Owned with a mortgage or loan or shared ownership,142,135,120,6,114,14,1,7,6,0,0,0,1
S01013241,Rented or living rent free: Total,19,9,9,1,8,0,0,10,7,1,2,0,0
S01013241,Rented or living rent free: Social rented,9,1,1,1,0,0,0,8,6,0,2,0,0
S01013241,Rented or living rent free: Private rented or living rent free,10,8,8,0,8,0,0,2,1,1,0,0,0
S01013242,All HRPs aged 16 and over,229,148,85,11,74,62,1,81,75,0,2,3,1
S01013242,Owned: Total,188,124,66,8,58,57,1,64,63,0,0,0,1
S01013242,Owned: Owned outright,104,48,20,5,15,28,0,56,55,0,0,0,1
S01013242,Owned: Owned with a mortgage or loan or shared ownership,84,76,46,3,43,29,1,8,8,0,0,0,0
S01013242,Rented or living rent free: Total,41,24,19,3,16,5,0,17,12,0,2,3,0
S01013242,Rented or living rent free: Social rented,18,8,7,3,4,1,0,10,5,0,2,3,0
S01013242,Rented or living rent free: Private rented or living rent free,23,16,12,0,12,4,0,7,7,0,0,0,0
S01013243,All HRPs aged 16 and over,325,212,169,26,143,25,18,113,79,0,3,23,8
S01013243,Owned: Total,172,115,99,11,88,16,0,57,54,0,1,2,0
S01013243,Owned: Owned outright,88,34,31,7,24,3,0,54,52,0,1,1,0
S01013243,Owned: Owned with a mortgage or loan or shared ownership,84,81,68,4,64,13,0,3,2,0,0,1,0
S01013243,Rented or living rent free: Total,153,97,70,15,55,9,18,56,25,0,2,21,8
S01013243,Rented or living rent free: Social rented,122,78,59,12,47,3,16,44,19,0,2,18,5
S01013243,Rented or living rent free: Private rented or living rent free,31,19,11,3,8,6,2,12,6,0,0,3,3
S01013244,All HRPs aged 16 and over,351,182,140,24,116,21,21,169,132,0,12,21,4
S01013244,Owned: Total,163,107,92,7,85,12,3,56,51,0,0,3,2
S01013244,Owned: Owned outright,64,27,23,4,19,2,2,37,35,0,0,1,1
S01013244,Owned: Owned with a mortgage or loan or shared ownership,99,80,69,3,66,10,1,19,16,0,0,2,1
S01013244,Rented or living rent free: Total,188,75,48,17,31,9,18,113,81,0,12,18,2
S01013244,Rented or living rent free: Social rented,155,58,40,12,28,5,13,97,76,0,5,14,2
S01013244,Rented or living rent free: Private rented or living rent free,33,17,8,5,3,4,5,16,5,0,7,4,0
S01013245,All HRPs aged 16 and over,407,279,225,28,197,43,11,128,103,1,5,13,6
S01013245,Owned: Total,288,204,167,13,154,34,3,84,81,0,0,2,1
S01013245,Owned: Owned outright,110,40,36,7,29,4,0,70,69,0,0,0,1
S01013245,Owned: Owned with a mortgage or loan or shared ownership,178,164,131,6,125,30,3,14,12,0,0,2,0
S01013245,Rented or living rent free: Total,119,75,58,15,43,9,8,44,22,1,5,11,5
S01013245,Rented or living rent free: Social rented,89,54,43,14,29,3,8,35,19,1,2,11,2
S01013245,Rented or living rent free: Private rented or living rent free,30,21,15,1,14,6,0,9,3,0,3,0,3
S01013246,All HRPs aged 16 and over,184,124,102,8,94,19,3,60,42,0,6,11,1
S01013246,Owned: Total,127,103,85,3,82,17,1,24,18,0,1,5,0
S01013246,Owned: Owned outright,31,15,10,0,10,5,0,16,15,0,0,1,0
S01013246,Owned: Owned with a mortgage or loan or shared ownership,96,88,75,3,72,12,1,8,3,0,1,4,0
S01013246,Rented or living rent free: Total,57,21,17,5,12,2,2,36,24,0,5,6,1
S01013246,Rented or living rent free: Social rented,43,17,16,5,11,1,0,26,19,0,2,5,0
S01013246,Rented or living rent free: Private rented or living rent free,14,4,1,0,1,1,2,10,5,0,3,1,1
S01013247,All HRPs aged 16 and over,338,208,160,32,128,24,24,130,66,3,18,36,7
S01013247,Owned: Total,156,111,93,11,82,16,2,45,34,0,0,9,2
S01013247,Owned: Owned outright,58,22,18,5,13,4,0,36,29,0,0,7,0
S01013247,Owned: Owned with a mortgage or loan or shared ownership,98,89,75,6,69,12,2,9,5,0,0,2,2
S01013247,Rented or living rent free: Total,182,97,67,21,46,8,22,85,32,3,18,27,5
S01013247,Rented or living rent free: Social rented,142,70,45,11,34,6,19,72,29,3,13,25,2
S01013247,Rented or living rent free: Private rented or living rent free,40,27,22,10,12,2,3,13,3,0,5,2,3
S01013248,All HRPs aged 16 and over,300,182,150,41,109,12,20,118,76,0,7,27,8
S01013248,Owned: Total,117,74,64,9,55,6,4,43,39,0,2,1,1
S01013248,Owned: Owned outright,51,22,19,3,16,1,2,29,27,0,0,1,1
S01013248,Owned: Owned with a mortgage or loan or shared ownership,66,52,45,6,39,5,2,14,12,0,2,0,0
S01013248,Rented or living rent free: Total,183,108,86,32,54,6,16,75,37,0,5,26,7
S01013248,Rented or living rent free: Social rented,151,95,77,29,48,5,13,56,31,0,0,19,6
S01013248,Rented or living rent free: Private rented or living rent free,32,13,9,3,6,1,3,19,6,0,5,7,1
S01013249,All HRPs aged 16 and over,201,138,119,19,100,12,7,63,46,0,5,8,4
S01013249,Owned: Total,138,108,98,8,90,10,0,30,28,0,1,1,0
S01013249,Owned: Owned outright,49,24,23,3,20,1,0,25,23,0,1,1,0
S01013249,Owned: Owned with a mortgage or loan or shared ownership,89,84,75,5,70,9,0,5,5,0,0,0,0
S01013249,Rented or living rent free: Total,63,30,21,11,10,2,7,33,18,0,4,7,4
S01013249,Rented or living rent free: Social rented,49,21,14,9,5,1,6,28,15,0,3,6,4
S01013249,Rented or living rent free: Private rented or living rent free,14,9,7,2,5,1,1,5,3,0,1,1,0
S01013250,All HRPs aged 16 and over,339,256,172,19,153,73,11,83,62,1,8,7,5
S01013250,Owned: Total,221,184,121,12,109,61,2,37,35,0,1,0,1
S01013250,Owned: Owned outright,95,67,33,7,26,32,2,28,28,0,0,0,0
S01013250,Owned: Owned with a mortgage or loan or shared ownership,126,117,88,5,83,29,0,9,7,0,1,0,1
S01013250,Rented or living rent free: Total,118,72,51,7,44,12,9,46,27,1,7,7,4
S01013250,Rented or living rent free: Social rented,77,42,34,6,28,2,6,35,22,0,4,5,4
S01013250,Rented or living rent free: Private rented or living rent free,41,30,17,1,16,10,3,11,5,1,3,2,0
S01013251,All HRPs aged 16 and over,319,199,167,34,133,10,22,120,61,10,13,29,7
S01013251,Owned: Total,87,64,55,8,47,7,2,23,18,1,2,2,0
S01013251,Owned: Owned outright,30,16,12,3,9,2,2,14,14,0,0,0,0
S01013251,Owned: Owned with a mortgage or loan or shared ownership,57,48,43,5,38,5,0,9,4,1,2,2,0
S01013251,Rented or living rent free: Total,232,135,112,26,86,3,20,97,43,9,11,27,7
S01013251,Rented or living rent free: Social rented,196,114,95,23,72,2,17,82,37,4,8,26,7
S01013251,Rented or living rent free: Private rented or living rent free,36,21,17,3,14,1,3,15,6,5,3,1,0
S01013252,All HRPs aged 16 and over,288,188,148,21,127,23,17,100,63,2,11,20,4
S01013252,Owned: Total,159,119,98,11,87,18,3,40,37,0,0,1,2
S01013252,Owned: Owned outright,57,23,18,6,12,4,1,34,31,0,0,1,2
S01013252,Owned: Owned with a mortgage or loan or shared ownership,102,96,80,5,75,14,2,6,6,0,0,0,0
S01013252,Rented or living rent free: Total,129,69,50,10,40,5,14,60,26,2,11,19,2
S01013252,Rented or living rent free: Social rented,110,59,43,10,33,2,14,51,23,1,6,19,2
S01013252,Rented or living rent free: Private rented or living rent free,19,10,7,0,7,3,0,9,3,1,5,0,0
S01013253,All HRPs aged 16 and over,316,210,175,18,157,22,13,106,88,2,4,10,2
S01013253,Owned: Total,195,141,124,10,114,16,1,54,53,0,0,1,0
S01013253,Owned: Owned outright,74,27,18,6,12,8,1,47,47,0,0,0,0
S01013253,Owned: Owned with a mortgage or loan or shared ownership,121,114,106,4,102,8,0,7,6,0,0,1,0
S01013253,Rented or living rent free: Total,121,69,51,8,43,6,12,52,35,2,4,9,2
S01013253,Rented or living rent free: Social rented,77,38,33,8,25,3,2,39,26,0,4,8,1
S01013253,Rented or living rent free: Private rented or living rent free,44,31,18,0,18,3,10,13,9,2,0,1,1
S01013254,All HRPs aged 16 and over,297,180,146,34,112,16,18,117,76,0,10,23,8
S01013254,Owned: Total,110,80,70,3,67,10,0,30,28,0,1,1,0
S01013254,Owned: Owned outright,32,9,7,1,6,2,0,23,23,0,0,0,0
S01013254,Owned: Owned with a mortgage or loan or shared ownership,78,71,63,2,61,8,0,7,5,0,1,1,0
S01013254,Rented or living rent free: Total,187,100,76,31,45,6,18,87,48,0,9,22,8
S01013254,Rented or living rent free: Social rented,171,89,67,29,38,5,17,82,46,0,9,20,7
S01013254,Rented or living rent free: Private rented or living rent free,16,11,9,2,7,1,1,5,2,0,0,2,1
S01013255,All HRPs aged 16 and over,345,225,185,36,149,27,13,120,91,2,4,17,6
S01013255,Owned: Total,214,147,119,13,106,24,4,67,64,2,0,1,0
S01013255,Owned: Owned outright,106,45,29,8,21,13,3,61,61,0,0,0,0
S01013255,Owned: Owned with a mortgage or loan or shared ownership,108,102,90,5,85,11,1,6,3,2,0,1,0
S01013255,Rented or living rent free: Total,131,78,66,23,43,3,9,53,27,0,4,16,6
S01013255,Rented or living rent free: Social rented,115,66,56,19,37,2,8,49,26,0,3,14,6
S01013255,Rented or living rent free: Private rented or living rent free,16,12,10,4,6,1,1,4,1,0,1,2,0
S01013256,All HRPs aged 16 and over,322,216,179,27,152,31,6,106,85,1,2,17,1
S01013256,Owned: Total,189,145,123,10,113,22,0,44,43,0,0,1,0
S01013256,Owned: Owned outright,60,25,19,4,15,6,0,35,35,0,0,0,0
S01013256,Owned: Owned with a mortgage or loan or shared ownership,129,120,104,6,98,16,0,9,8,0,0,1,0
S01013256,Rented or living rent free: Total,133,71,56,17,39,9,6,62,42,1,2,16,1
S01013256,Rented or living rent free: Social rented,75,32,24,9,15,5,3,43,30,0,0,13,0
S01013256,Rented or living rent free: Private rented or living rent free,58,39,32,8,24,4,3,19,12,1,2,3,1
S01013257,All HRPs aged 16 and over,419,235,191,29,162,30,14,184,158,2,3,16,5
S01013257,Owned: Total,212,147,117,12,105,26,4,65,63,0,0,0,2
S01013257,Owned: Owned outright,107,45,30,7,23,13,2,62,60,0,0,0,2
S01013257,Owned: Owned with a mortgage or loan or shared ownership,105,102,87,5,82,13,2,3,3,0,0,0,0
S01013257,Rented or living rent free: Total,207,88,74,17,57,4,10,119,95,2,3,16,3
S01013257,Rented or living rent free: Social rented,164,63,52,15,37,2,9,101,81,1,2,15,2
S01013257,Rented or living rent free: Private rented or living rent free,43,25,22,2,20,2,1,18,14,1,1,1,1
S01013258,All HRPs aged 16 and over,312,209,175,16,159,29,5,103,91,1,2,8,1
S01013258,Owned: Total,255,179,153,13,140,23,3,76,74,0,0,2,0
S01013258,Owned: Owned outright,118,51,41,5,36,9,1,67,65,0,0,2,0
S01013258,Owned: Owned with a mortgage or loan or shared ownership,137,128,112,8,104,14,2,9,9,0,0,0,0
S01013258,Rented or living rent free: Total,57,30,22,3,19,6,2,27,17,1,2,6,1
S01013258,Rented or living rent free: Social rented,32,14,12,1,11,0,2,18,11,1,2,3,1
S01013258,Rented or living rent free: Private rented or living rent free,25,16,10,2,8,6,0,9,6,0,0,3,0
S01013259,All HRPs aged 16 and over,361,240,196,39,157,27,17,121,91,2,12,12,4
S01013259,Owned: Total,217,156,133,16,117,21,2,61,58,0,0,3,0
S01013259,Owned: Owned outright,92,42,31,7,24,9,2,50,49,0,0,1,0
S01013259,Owned: Owned with a mortgage or loan or shared ownership,125,114,102,9,93,12,0,11,9,0,0,2,0
S01013259,Rented or living rent free: Total,144,84,63,23,40,6,15,60,33,2,12,9,4
S01013259,Rented or living rent free: Social rented,95,51,43,15,28,3,5,44,29,0,5,7,3
S01013259,Rented or living rent free: Private rented or living rent free,49,33,20,8,12,3,10,16,4,2,7,2,1
S01013260,All HRPs aged 16 and over,382,253,216,36,180,11,26,129,69,5,15,30,10
S01013260,Owned: Total,167,131,121,13,108,9,1,36,32,1,0,1,2
S01013260,Owned: Owned outright,57,29,26,5,21,2,1,28,26,0,0,0,2
S01013260,Owned: Owned with a mortgage or loan or shared ownership,110,102,95,8,87,7,0,8,6,1,0,1,0
S01013260,Rented or living rent free: Total,215,122,95,23,72,2,25,93,37,4,15,29,8
S01013260,Rented or living rent free: Social rented,182,101,76,18,58,1,24,81,33,4,11,28,5
S01013260,Rented or living rent free: Private rented or living rent free,33,21,19,5,14,1,1,12,4,0,4,1,3
S01013261,All HRPs aged 16 and over,345,228,192,31,161,22,14,117,78,2,11,21,5
S01013261,Owned: Total,178,137,118,15,103,18,1,41,40,0,0,1,0
S01013261,Owned: Owned outright,66,34,27,5,22,6,1,32,31,0,0,1,0
S01013261,Owned: Owned with a mortgage or loan or shared ownership,112,103,91,10,81,12,0,9,9,0,0,0,0
S01013261,Rented or living rent free: Total,167,91,74,16,58,4,13,76,38,2,11,20,5
S01013261,Rented or living rent free: Social rented,143,74,64,15,49,2,8,69,34,2,9,20,4
S01013261,Rented or living rent free: Private rented or living rent free,24,17,10,1,9,2,5,7,4,0,2,0,1
S01013262,All HRPs aged 16 and over,276,164,130,23,107,23,11,112,79,2,5,22,4
S01013262,Owned: Total,165,107,87,10,77,17,3,58,56,0,0,2,0
S01013262,Owned: Owned outright,79,30,26,5,21,2,2,49,48,0,0,1,0
S01013262,Owned: Owned with a mortgage or loan or shared ownership,86,77,61,5,56,15,1,9,8,0,0,1,0
S01013262,Rented or living rent free: Total,111,57,43,13,30,6,8,54,23,2,5,20,4
S01013262,Rented or living rent free: Social rented,91,46,33,11,22,6,7,45,20,2,3,17,3
S01013262,Rented or living rent free: Private rented or living rent free,20,11,10,2,8,0,1,9,3,0,2,3,1
S01013263,All HRPs aged 16 and over,195,155,129,8,121,22,4,40,39,0,1,0,0
S01013263,Owned: Total,169,133,112,6,106,20,1,36,35,0,1,0,0
S01013263,Owned: Owned outright,72,42,37,2,35,5,0,30,29,0,1,0,0
S01013263,Owned: Owned with a mortgage or loan or shared ownership,97,91,75,4,71,15,1,6,6,0,0,0,0
S01013263,Rented or living rent free: Total,26,22,17,2,15,2,3,4,4,0,0,0,0
S01013263,Rented or living rent free: Social rented,3,2,2,0,2,0,0,1,1,0,0,0,0
S01013263,Rented or living rent free: Private rented or living rent free,23,20,15,2,13,2,3,3,3,0,0,0,0
S01013264,All HRPs aged 16 and over,163,146,127,6,121,17,2,17,13,0,0,2,2
S01013264,Owned: Total,155,139,122,6,116,15,2,16,13,0,0,1,2
S01013264,Owned: Owned outright,34,25,23,2,21,2,0,9,8,0,0,0,1
S01013264,Owned: Owned with a mortgage or loan or shared ownership,121,114,99,4,95,13,2,7,5,0,0,1,1
S01013264,Rented or living rent free: Total,8,7,5,0,5,2,0,1,0,0,0,1,0
S01013264,Rented or living rent free: Social rented,0,0,0,0,0,0,0,0,0,0,0,0,0
S01013264,Rented or living rent free: Private rented or living rent free,8,7,5,0,5,2,0,1,0,0,0,1,0
S01013265,All HRPs aged 16 and over,201,187,153,8,145,33,1,14,11,0,3,0,0
S01013265,Owned: Total,196,186,153,8,145,32,1,10,9,0,1,0,0
S01013265,Owned: Owned outright,35,27,22,2,20,4,1,8,8,0,0,0,0
S01013265,Owned: Owned with a mortgage or loan or shared ownership,161,159,131,6,125,28,0,2,1,0,1,0,0
S01013265,Rented or living rent free: Total,5,1,0,0,0,1,0,4,2,0,2,0,0
S01013265,Rented or living rent free: Social rented,3,0,0,0,0,0,0,3,2,0,1,0,0
S01013265,Rented or living rent free: Private rented or living rent free,2,1,0,0,0,1,0,1,0,0,1,0,0
S01013266,All HRPs aged 16 and over,189,170,145,12,133,23,2,19,17,1,1,0,0
S01013266,Owned: Total,175,158,134,12,122,22,2,17,16,0,1,0,0
S01013266,Owned: Owned outright,40,28,23,5,18,5,0,12,12,0,0,0,0
S01013266,Owned: Owned with a mortgage or loan or shared ownership,135,130,111,7,104,17,2,5,4,0,1,0,0
S01013266,Rented or living rent free: Total,14,12,11,0,11,1,0,2,1,1,0,0,0
S01013266,Rented or living rent free: Social rented,1,0,0,0,0,0,0,1,0,1,0,0,0
S01013266,Rented or living rent free: Private rented or living rent free,13,12,11,0,11,1,0,1,1,0,0,0,0
S01013267,All HRPs aged 16 and over,237,157,130,25,105,12,15,80,47,5,8,18,2
S01013267,Owned: Total,120,91,81,8,73,10,0,29,29,0,0,0,0
S01013267,Owned: Owned outright,41,20,17,4,13,3,0,21,21,0,0,0,0
S01013267,Owned: Owned with a mortgage or loan or shared ownership,79,71,64,4,60,7,0,8,8,0,0,0,0
S01013267,Rented or living rent free: Total,117,66,49,17,32,2,15,51,18,5,8,18,2
S01013267,Rented or living rent free: Social rented,106,59,42,14,28,2,15,47,16,5,7,17,2
S01013267,Rented or living rent free: Private rented or living rent free,11,7,7,3,4,0,0,4,2,0,1,1,0
S01013268,All HRPs aged 16 and over,328,233,199,23,176,27,7,95,69,1,9,13,3
S01013268,Owned: Total,253,198,174,18,156,22,2,55,47,1,1,5,1
S01013268,Owned: Owned outright,71,33,26,5,21,6,1,38,34,1,0,3,0
S01013268,Owned: Owned with a mortgage or loan or shared ownership,182,165,148,13,135,16,1,17,13,0,1,2,1
S01013268,Rented or living rent free: Total,75,35,25,5,20,5,5,40,22,0,8,8,2
S01013268,Rented or living rent free: Social rented,52,20,16,4,12,2,2,32,20,0,3,7,2
S01013268,Rented or living rent free: Private rented or living rent free,23,15,9,1,8,3,3,8,2,0,5,1,0
S01013269,All HRPs aged 16 and over,379,322,281,22,259,37,4,57,44,2,1,6,4
S01013269,Owned: Total,303,262,230,15,215,29,3,41,40,0,0,0,1
S01013269,Owned: Owned outright,89,53,42,6,36,10,1,36,36,0,0,0,0
S01013269,Owned: Owned with a mortgage or loan or shared ownership,214,209,188,9,179,19,2,5,4,0,0,0,1
S01013269,Rented or living rent free: Total,76,60,51,7,44,8,1,16,4,2,1,6,3
S01013269,Rented or living rent free: Social rented,14,5,3,1,2,1,1,9,2,2,0,4,1
S01013269,Rented or living rent free: Private rented or living rent free,62,55,48,6,42,7,0,7,2,0,1,2,2
S01013270,All HRPs aged 16 and over,285,254,216,13,203,37,1,31,29,1,0,1,0
S01013270,Owned: Total,274,247,210,12,198,36,1,27,25,1,0,1,0
S01013270,Owned: Owned outright,62,42,36,4,32,6,0,20,18,1,0,1,0
S01013270,Owned: Owned with a mortgage or loan or shared ownership,212,205,174,8,166,30,1,7,7,0,0,0,0
S01013270,Rented or living rent free: Total,11,7,6,1,5,1,0,4,4,0,0,0,0
S01013270,Rented or living rent free: Social rented,2,1,1,1,0,0,0,1,1,0,0,0,0
S01013270,Rented or living rent free: Private rented or living rent free,9,6,5,0,5,1,0,3,3,0,0,0,0
S01013271,All HRPs aged 16 and over,242,163,133,10,123,29,1,79,77,0,0,2,0
S01013271,Owned: Total,233,157,127,10,117,29,1,76,76,0,0,0,0
S01013271,Owned: Owned outright,127,57,47,9,38,10,0,70,70,0,0,0,0
S01013271,Owned: Owned with a mortgage or loan or shared ownership,106,100,80,1,79,19,1,6,6,0,0,0,0
S01013271,Rented or living rent free: Total,9,6,6,0,6,0,0,3,1,0,0,2,0
S01013271,Rented or living rent free: Social rented,0,0,0,0,0,0,0,0,0,0,0,0,0
S01013271,Rented or living rent free: Private rented or living rent free,9,6,6,0,6,0,0,3,1,0,0,2,0
S01013272,All HRPs aged 16 and over,253,220,191,10,181,25,4,33,32,0,0,1,0
S01013272,Owned: Total,236,207,181,8,173,24,2,29,28,0,0,1,0
S01013272,Owned: Owned outright,63,44,40,3,37,4,0,19,18,0,0,1,0
S01013272,Owned: Owned with a mortgage or loan or shared ownership,173,163,141,5,136,20,2,10,10,0,0,0,0
S01013272,Rented or living rent free: Total,17,13,10,2,8,1,2,4,4,0,0,0,0
S01013272,Rented or living rent free: Social rented,5,3,3,1,2,0,0,2,2,0,0,0,0
S01013272,Rented or living rent free: Private rented or living rent free,12,10,7,1,6,1,2,2,2,0,0,0,0
S01013273,All HRPs aged 16 and over,291,270,224,11,213,46,0,21,17,0,0,4,0
S01013273,Owned: Total,277,260,215,9,206,45,0,17,16,0,0,1,0
S01013273,Owned: Owned outright,36,23,16,1,15,7,0,13,13,0,0,0,0
S01013273,Owned: Owned with a mortgage or loan or shared ownership,241,237,199,8,191,38,0,4,3,0,0,1,0
S01013273,Rented or living rent free: Total,14,10,9,2,7,1,0,4,1,0,0,3,0
S01013273,Rented or living rent free: Social rented,3,1,0,0,0,1,0,2,0,0,0,2,0
S01013273,Rented or living rent free: Private rented or living rent free,11,9,9,2,7,0,0,2,1,0,0,1,0
S01013274,All HRPs aged 16 and over,348,260,223,17,206,29,8,88,77,3,1,5,2
S01013274,Owned: Total,302,224,194,14,180,27,3,78,74,0,0,4,0
S01013274,Owned: Owned outright,110,46,37,5,32,9,0,64,60,0,0,4,0
S01013274,Owned: Owned with a mortgage or loan or shared ownership,192,178,157,9,148,18,3,14,14,0,0,0,0
S01013274,Rented or living rent free: Total,46,36,29,3,26,2,5,10,3,3,1,1,2
S01013274,Rented or living rent free: Social rented,2,2,1,0,1,0,1,0,0,0,0,0,0
S01013274,Rented or living rent free: Private rented or living rent free,44,34,28,3,25,2,4,10,3,3,1,1,2
S01013275,All HRPs aged 16 and over,253,215,174,24,150,39,2,38,33,0,2,2,1
S01013275,Owned: Total,227,194,154,22,132,38,2,33,31,0,0,2,0
S01013275,Owned: Owned outright,93,63,51,16,35,12,0,30,29,0,0,1,0
S01013275,Owned: Owned with a mortgage or loan or shared ownership,134,131,103,6,97,26,2,3,2,0,0,1,0
S01013275,Rented or living rent free: Total,26,21,20,2,18,1,0,5,2,0,2,0,1
S01013275,Rented or living rent free: Social rented,1,1,1,0,1,0,0,0,0,0,0,0,0
S01013275,Rented or living rent free: Private rented or living rent free,25,20,19,2,17,1,0,5,2,0,2,0,1
S01013276,All HRPs aged 16 and over,233,200,177,9,168,18,5,33,28,1,1,2,1
S01013276,Owned: Total,205,177,156,7,149,17,4,28,25,0,1,2,0
S01013276,Owned: Owned outright,59,37,33,4,29,3,1,22,21,0,0,1,0
S01013276,Owned: Owned with a mortgage or loan or shared ownership,146,140,123,3,120,14,3,6,4,0,1,1,0
S01013276,Rented or living rent free: Total,28,23,21,2,19,1,1,5,3,1,0,0,1
S01013276,Rented or living rent free: Social rented,4,3,3,1,2,0,0,1,0,1,0,0,0
S01013276,Rented or living rent free: Private rented or living rent free,24,20,18,1,17,1,1,4,3,0,0,0,1
S01013277,All HRPs aged 16 and over,363,239,216,42,174,18,5,124,82,3,10,26,3
S01013277,Owned: Total,226,176,158,20,138,16,2,50,43,1,3,2,1
S01013277,Owned: Owned outright,67,34,28,5,23,5,1,33,32,1,0,0,0
S01013277,Owned: Owned with a mortgage or loan or shared ownership,159,142,130,15,115,11,1,17,11,0,3,2,1
S01013277,Rented or living rent free: Total,137,63,58,22,36,2,3,74,39,2,7,24,2
S01013277,Rented or living rent free: Social rented,93,32,29,12,17,2,1,61,36,2,3,19,1
S01013277,Rented or living rent free: Private rented or living rent free,44,31,29,10,19,0,2,13,3,0,4,5,1
S01013278,All HRPs aged 16 and over,322,213,174,37,137,19,20,109,64,4,7,30,4
S01013278,Owned: Total,157,127,109,20,89,16,2,30,29,0,0,1,0
S01013278,Owned: Owned outright,49,30,23,4,19,6,1,19,19,0,0,0,0
S01013278,Owned: Owned with a mortgage or loan or shared ownership,108,97,86,16,70,10,1,11,10,0,0,1,0
S01013278,Rented or living rent free: Total,165,86,65,17,48,3,18,79,35,4,7,29,4
S01013278,Rented or living rent free: Social rented,127,57,42,9,33,3,12,70,34,4,5,24,3
S01013278,Rented or living rent free: Private rented or living rent free,38,29,23,8,15,0,6,9,1,0,2,5,1
S01013279,All HRPs aged 16 and over,299,199,168,49,119,12,19,100,55,1,15,21,8
S01013279,Owned: Total,123,90,80,19,61,7,3,33,28,0,0,3,2
S01013279,Owned: Owned outright,42,20,17,10,7,1,2,22,18,0,0,2,2
S01013279,Owned: Owned with a mortgage or loan or shared ownership,81,70,63,9,54,6,1,11,10,0,0,1,0
S01013279,Rented or living rent free: Total,176,109,88,30,58,5,16,67,27,1,15,18,6
S01013279,Rented or living rent free: Social rented,144,89,72,25,47,5,12,55,24,1,10,14,6
S01013279,Rented or living rent free: Private rented or living rent free,32,20,16,5,11,0,4,12,3,0,5,4,0
S01013280,All HRPs aged 16 and over,227,156,139,17,122,12,5,71,66,1,1,2,1
S01013280,Owned: Total,179,127,117,7,110,9,1,52,52,0,0,0,0
S01013280,Owned: Owned outright,62,20,19,3,16,1,0,42,42,0,0,0,0
S01013280,Owned: Owned with a mortgage or loan or shared ownership,117,107,98,4,94,8,1,10,10,0,0,0,0
S01013280,Rented or living rent free: Total,48,29,22,10,12,3,4,19,14,1,1,2,1
S01013280,Rented or living rent free: Social rented,23,10,8,3,5,1,1,13,10,0,0,2,1
S01013280,Rented or living rent free: Private rented or living rent free,25,19,14,7,7,2,3,6,4,1,1,0,0
S01013281,All HRPs aged 16 and over,384,236,208,44,164,23,5,148,107,2,9,25,5
S01013281,Owned: Total,209,155,139,15,124,15,1,54,49,1,1,1,2
S01013281,Owned: Owned outright,57,23,20,4,16,2,1,34,33,0,1,0,0
S01013281,Owned: Owned with a mortgage or loan or shared ownership,152,132,119,11,108,13,0,20,16,1,0,1,2
S01013281,Rented or living rent free: Total,175,81,69,29,40,8,4,94,58,1,8,24,3
S01013281,Rented or living rent free: Social rented,120,42,34,13,21,5,3,78,53,1,4,20,0
S01013281,Rented or living rent free: Private rented or living rent free,55,39,35,16,19,3,1,16,5,0,4,4,3
S01013282,All HRPs aged 16 and over,346,245,206,37,169,13,26,101,41,2,15,38,5
S01013282,Owned: Total,133,116,101,8,93,10,5,17,13,0,0,4,0
S01013282,Owned: Owned outright,28,21,15,2,13,4,2,7,7,0,0,0,0
S01013282,Owned: Owned with a mortgage or loan or shared ownership,105,95,86,6,80,6,3,10,6,0,0,4,0
S01013282,Rented or living rent free: Total,213,129,105,29,76,3,21,84,28,2,15,34,5
S01013282,Rented or living rent free: Social rented,169,101,83,21,62,2,16,68,25,2,9,29,3
S01013282,Rented or living rent free: Private rented or living rent free,44,28,22,8,14,1,5,16,3,0,6,5,2
S01013283,All HRPs aged 16 and over,310,250,230,28,202,14,6,60,27,2,6,18,7
S01013283,Owned: Total,113,92,81,5,76,10,1,21,15,0,0,3,3
S01013283,Owned: Owned outright,27,13,13,3,10,0,0,14,13,0,0,0,1
S01013283,Owned: Owned with a mortgage or loan or shared ownership,86,79,68,2,66,10,1,7,2,0,0,3,2
S01013283,Rented or living rent free: Total,197,158,149,23,126,4,5,39,12,2,6,15,4
S01013283,Rented or living rent free: Social rented,78,48,44,12,32,0,4,30,9,1,2,14,4
S01013283,Rented or living rent free: Private rented or living rent free,119,110,105,11,94,4,1,9,3,1,4,1,0
S01013284,All HRPs aged 16 and over,301,248,226,18,208,20,2,53,45,2,1,3,2
S01013284,Owned: Total,251,208,190,14,176,18,0,43,39,1,0,1,2
S01013284,Owned: Owned outright,67,32,28,4,24,4,0,35,33,0,0,1,1
S01013284,Owned: Owned with a mortgage or loan or shared ownership,184,176,162,10,152,14,0,8,6,1,0,0,1
S01013284,Rented or living rent free: Total,50,40,36,4,32,2,2,10,6,1,1,2,0
S01013284,Rented or living rent free: Social rented,7,6,6,1,5,0,0,1,0,0,0,1,0
S01013284,Rented or living rent free: Private rented or living rent free,43,34,30,3,27,2,2,9,6,1,1,1,0
S01013285,All HRPs aged 16 and over,269,215,201,26,175,10,4,54,43,2,4,2,3
S01013285,Owned: Total,224,183,173,20,153,8,2,41,38,1,1,1,0
S01013285,Owned: Owned outright,66,35,33,9,24,1,1,31,29,0,1,1,0
S01013285,Owned: Owned with a mortgage or loan or shared ownership,158,148,140,11,129,7,1,10,9,1,0,0,0
S01013285,Rented or living rent free: Total,45,32,28,6,22,2,2,13,5,1,3,1,3
S01013285,Rented or living rent free: Social rented,6,3,2,0,2,1,0,3,1,0,1,1,0
S01013285,Rented or living rent free: Private rented or living rent free,39,29,26,6,20,1,2,10,4,1,2,0,3
S01013286,All HRPs aged 16 and over,284,229,206,26,180,22,1,55,50,1,0,3,1
S01013286,Owned: Total,251,204,182,23,159,21,1,47,44,0,0,3,0
S01013286,Owned: Owned outright,83,48,42,10,32,5,1,35,34,0,0,1,0
S01013286,Owned: Owned with a mortgage or loan or shared ownership,168,156,140,13,127,16,0,12,10,0,0,2,0
S01013286,Rented or living rent free: Total,33,25,24,3,21,1,0,8,6,1,0,0,1
S01013286,Rented or living rent free: Social rented,7,6,5,0,5,1,0,1,1,0,0,0,0
S01013286,Rented or living rent free: Private rented or living rent free,26,19,19,3,16,0,0,7,5,1,0,0,1
S01013287,All HRPs aged 16 and over,282,238,202,22,180,35,1,44,39,1,1,0,3
S01013287,Owned: Total,263,224,192,20,172,32,0,39,36,0,1,0,2
S01013287,Owned: Owned outright,77,46,39,10,29,7,0,31,31,0,0,0,0
S01013287,Owned: Owned with a mortgage or loan or shared ownership,186,178,153,10,143,25,0,8,5,0,1,0,2
S01013287,Rented or living rent free: Total,19,14,10,2,8,3,1,5,3,1,0,0,1
S01013287,Rented or living rent free: Social rented,5,3,2,0,2,1,0,2,1,0,0,0,1
S01013287,Rented or living rent free: Private rented or living rent free,14,11,8,2,6,2,1,3,2,1,0,0,0
S01013288,All HRPs aged 16 and over,315,199,168,17,151,23,8,116,95,2,3,8,8
S01013288,Owned: Total,215,150,131,9,122,19,0,65,61,2,1,1,0
S01013288,Owned: Owned outright,100,48,41,5,36,7,0,52,52,0,0,0,0
S01013288,Owned: Owned with a mortgage or loan or shared ownership,115,102,90,4,86,12,0,13,9,2,1,1,0
S01013288,Rented or living rent free: Total,100,49,37,8,29,4,8,51,34,0,2,7,8
S01013288,Rented or living rent free: Social rented,66,25,21,4,17,2,2,41,29,0,1,5,6
S01013288,Rented or living rent free: Private rented or living rent free,34,24,16,4,12,2,6,10,5,0,1,2,2
S01013289,All HRPs aged 16 and over,303,232,176,31,145,54,2,71,68,0,1,0,2
S01013289,Owned: Total,259,197,151,23,128,45,1,62,61,0,0,0,1
S01013289,Owned: Owned outright,127,74,51,12,39,23,0,53,52,0,0,0,1
S01013289,Owned: Owned with a mortgage or loan or shared ownership,132,123,100,11,89,22,1,9,9,0,0,0,0
S01013289,Rented or living rent free: Total,44,35,25,8,17,9,1,9,7,0,1,0,1
S01013289,Rented or living rent free: Social rented,8,4,3,3,0,0,1,4,2,0,1,0,1
S01013289,Rented or living rent free: Private rented or living rent free,36,31,22,5,17,9,0,5,5,0,0,0,0
S01013290,All HRPs aged 16 and over,361,286,247,34,213,27,12,75,59,1,1,12,2
S01013290,Owned: Total,273,225,197,16,181,23,5,48,41,0,0,5,2
S01013290,Owned: Owned outright,76,42,37,5,32,4,1,34,31,0,0,1,2
S01013290,Owned: Owned with a mortgage or loan or shared ownership,197,183,160,11,149,19,4,14,10,0,0,4,0
S01013290,Rented or living rent free: Total,88,61,50,18,32,4,7,27,18,1,1,7,0
S01013290,Rented or living rent free: Social rented,47,26,21,10,11,1,4,21,14,1,1,5,0
S01013290,Rented or living rent free: Private rented or living rent free,41,35,29,8,21,3,3,6,4,0,0,2,0
S01013291,All HRPs aged 16 and over,257,231,196,18,178,28,7,26,19,0,2,3,2
S01013291,Owned: Total,232,209,181,13,168,26,2,23,19,0,1,2,1
S01013291,Owned: Owned outright,42,27,22,6,16,4,1,15,14,0,0,1,0
S01013291,Owned: Owned with a mortgage or loan or shared ownership,190,182,159,7,152,22,1,8,5,0,1,1,1
S01013291,Rented or living rent free: Total,25,22,15,5,10,2,5,3,0,0,1,1,1
S01013291,Rented or living rent free: Social rented,13,10,10,5,5,0,0,3,0,0,1,1,1
S01013291,Rented or living rent free: Private rented or living rent free,12,12,5,0,5,2,5,0,0,0,0,0,0
S01013292,All HRPs aged 16 and over,284,226,199,24,175,19,8,58,52,0,4,1,1
S01013292,Owned: Total,252,198,177,15,162,19,2,54,52,0,1,0,1
S01013292,Owned: Owned outright,102,53,47,8,39,4,2,49,47,0,1,0,1
S01013292,Owned: Owned with a mortgage or loan or shared ownership,150,145,130,7,123,15,0,5,5,0,0,0,0
S01013292,Rented or living rent free: Total,32,28,22,9,13,0,6,4,0,0,3,1,0
S01013292,Rented or living rent free: Social rented,9,8,6,4,2,0,2,1,0,0,1,0,0
S01013292,Rented or living rent free: Private rented or living rent free,23,20,16,5,11,0,4,3,0,0,2,1,0
S01013293,All HRPs aged 16 and over,273,221,189,17,172,32,0,52,47,3,0,1,1
S01013293,Owned: Total,265,216,184,17,167,32,0,49,45,2,0,1,1
S01013293,Owned: Owned outright,92,49,41,8,33,8,0,43,41,2,0,0,0
S01013293,Owned: Owned with a mortgage or loan or shared ownership,173,167,143,9,134,24,0,6,4,0,0,1,1
S01013293,Rented or living rent free: Total,8,5,5,0,5,0,0,3,2,1,0,0,0
S01013293,Rented or living rent free: Social rented,1,0,0,0,0,0,0,1,1,0,0,0,0
S01013293,Rented or living rent free: Private rented or living rent free,7,5,5,0,5,0,0,2,1,1,0,0,0
S01013294,All HRPs aged 16 and over,306,236,206,28,178,22,8,70,55,3,2,8,2
S01013294,Owned: Total,243,206,183,20,163,20,3,37,34,0,1,1,1
S01013294,Owned: Owned outright,78,45,42,11,31,2,1,33,31,0,0,1,1
S01013294,Owned: Owned with a mortgage or loan or shared ownership,165,161,141,9,132,18,2,4,3,0,1,0,0
S01013294,Rented or living rent free: Total,63,30,23,8,15,2,5,33,21,3,1,7,1
S01013294,Rented or living rent free: Social rented,42,16,14,7,7,1,1,26,21,0,1,4,0
S01013294,Rented or living rent free: Private rented or living rent free,21,14,9,1,8,1,4,7,0,3,0,3,1
S01013295,All HRPs aged 16 and over,324,268,243,30,213,21,4,56,48,1,3,3,1
S01013295,Owned: Total,277,236,213,22,191,21,2,41,40,0,1,0,0
S01013295,Owned: Owned outright,91,57,50,11,39,6,1,34,34,0,0,0,0
S01013295,Owned: Owned with a mortgage or loan or shared ownership,186,179,163,11,152,15,1,7,6,0,1,0,0
S01013295,Rented or living rent free: Total,47,32,30,8,22,0,2,15,8,1,2,3,1
S01013295,Rented or living rent free: Social rented,9,4,4,2,2,0,0,5,3,0,0,2,0
S01013295,Rented or living rent free: Private rented or living rent free,38,28,26,6,20,0,2,10,5,1,2,1,1
S01013296,All HRPs aged 16 and over,310,189,155,39,116,17,17,121,90,3,9,16,3
S01013296,Owned: Total,167,109,95,17,78,12,2,58,53,0,1,3,1
S01013296,Owned: Owned outright,77,34,30,4,26,3,1,43,40,0,1,1,1
S01013296,Owned: Owned with a mortgage or loan or shared ownership,90,75,65,13,52,9,1,15,13,0,0,2,0
S01013296,Rented or living rent free: Total,143,80,60,22,38,5,15,63,37,3,8,13,2
S01013296,Rented or living rent free: Social rented,128,69,53,20,33,5,11,59,35,2,8,13,1
S01013296,Rented or living rent free: Private rented or living rent free,15,11,7,2,5,0,4,4,2,1,0,0,1
S01013297,All HRPs aged 16 and over,308,200,165,25,140,28,7,108,92,4,3,5,4
S01013297,Owned: Total,213,151,127,14,113,21,3,62,59,0,1,0,2
S01013297,Owned: Owned outright,93,36,31,9,22,4,1,57,55,0,1,0,1
S01013297,Owned: Owned with a mortgage or loan or shared ownership,120,115,96,5,91,17,2,5,4,0,0,0,1
S01013297,Rented or living rent free: Total,95,49,38,11,27,7,4,46,33,4,2,5,2
S01013297,Rented or living rent free: Social rented,64,29,24,10,14,2,3,35,28,2,1,2,2
S01013297,Rented or living rent free: Private rented or living rent free,31,20,14,1,13,5,1,11,5,2,1,3,0
S01013298,All HRPs aged 16 and over,310,194,157,26,131,31,6,116,103,0,1,8,4
S01013298,Owned: Total,203,136,109,12,97,25,2,67,66,0,0,0,1
S01013298,Owned: Owned outright,96,39,33,5,28,5,1,57,56,0,0,0,1
S01013298,Owned: Owned with a mortgage or loan or shared ownership,107,97,76,7,69,20,1,10,10,0,0,0,0
S01013298,Rented or living rent free: Total,107,58,48,14,34,6,4,49,37,0,1,8,3
S01013298,Rented or living rent free: Social rented,49,16,15,5,10,0,1,33,24,0,1,5,3
S01013298,Rented or living rent free: Private rented or living rent free,58,42,33,9,24,6,3,16,13,0,0,3,0
S01013299,All HRPs aged 16 and over,424,294,249,34,215,24,21,130,97,3,6,22,2
S01013299,Owned: Total,286,221,193,18,175,21,7,65,61,2,1,1,0
S01013299,Owned: Owned outright,92,37,34,5,29,3,0,55,54,1,0,0,0
S01013299,Owned: Owned with a mortgage or loan or shared ownership,194,184,159,13,146,18,7,10,7,1,1,1,0
S01013299,Rented or living rent free: Total,138,73,56,16,40,3,14,65,36,1,5,21,2
S01013299,Rented or living rent free: Social rented,104,50,36,12,24,1,13,54,30,0,3,19,2
S01013299,Rented or living rent free: Private rented or living rent free,34,23,20,4,16,2,1,11,6,1,2,2,0
S01013300,All HRPs aged 16 and over,264,155,130,15,115,17,8,109,82,2,3,19,3
S01013300,Owned: Total,157,99,84,9,75,14,1,58,53,0,0,4,1
S01013300,Owned: Owned outright,71,27,20,5,15,6,1,44,43,0,0,0,1
S01013300,Owned: Owned with a mortgage or loan or shared ownership,86,72,64,4,60,8,0,14,10,0,0,4,0
S01013300,Rented or living rent free: Total,107,56,46,6,40,3,7,51,29,2,3,15,2
S01013300,Rented or living rent free: Social rented,76,34,27,5,22,2,5,42,27,1,1,12,1
S01013300,Rented or living rent free: Private rented or living rent free,31,22,19,1,18,1,2,9,2,1,2,3,1
S01013301,All HRPs aged 16 and over,217,134,116,12,104,9,9,83,62,1,4,9,7
S01013301,Owned: Total,126,89,81,6,75,7,1,37,33,0,1,1,2
S01013301,Owned: Owned outright,47,20,18,4,14,2,0,27,23,0,1,1,2
S01013301,Owned: Owned with a mortgage or loan or shared ownership,79,69,63,2,61,5,1,10,10,0,0,0,0
S01013301,Rented or living rent free: Total,91,45,35,6,29,2,8,46,29,1,3,8,5
S01013301,Rented or living rent free: Social rented,63,29,23,4,19,0,6,34,26,0,0,7,1
S01013301,Rented or living rent free: Private rented or living rent free,28,16,12,2,10,2,2,12,3,1,3,1,4
S01013302,All HRPs aged 16 and over,270,200,158,17,141,35,7,70,62,0,3,5,0
S01013302,Owned: Total,218,167,130,12,118,33,4,51,50,0,1,0,0
S01013302,Owned: Owned outright,96,51,38,7,31,11,2,45,45,0,0,0,0
S01013302,Owned: Owned with a mortgage or loan or shared ownership,122,116,92,5,87,22,2,6,5,0,1,0,0
S01013302,Rented or living rent free: Total,52,33,28,5,23,2,3,19,12,0,2,5,0
S01013302,Rented or living rent free: Social rented,26,11,8,1,7,1,2,15,11,0,0,4,0
S01013302,Rented or living rent free: Private rented or living rent free,26,22,20,4,16,1,1,4,1,0,2,1,0
S01013303,All HRPs aged 16 and over,384,223,195,30,165,23,5,161,143,1,6,11,0
S01013303,Owned: Total,294,196,170,24,146,23,3,98,94,1,0,3,0
S01013303,Owned: Owned outright,125,46,41,6,35,3,2,79,78,0,0,1,0
S01013303,Owned: Owned with a mortgage or loan or shared ownership,169,150,129,18,111,20,1,19,16,1,0,2,0
S01013303,Rented or living rent free: Total,90,27,25,6,19,0,2,63,49,0,6,8,0
S01013303,Rented or living rent free: Social rented,64,8,8,4,4,0,0,56,42,0,6,8,0
S01013303,Rented or living rent free: Private rented or living rent free,26,19,17,2,15,0,2,7,7,0,0,0,0
S01013304,All HRPs aged 16 and over,422,291,245,43,202,15,31,131,69,12,11,32,7
S01013304,Owned: Total,167,132,119,14,105,10,3,35,31,1,1,2,0
S01013304,Owned: Owned outright,50,23,18,5,13,5,0,27,26,0,0,1,0
S01013304,Owned: Owned with a mortgage or loan or shared ownership,117,109,101,9,92,5,3,8,5,1,1,1,0
S01013304,Rented or living rent free: Total,255,159,126,29,97,5,28,96,38,11,10,30,7
S01013304,Rented or living rent free: Social rented,207,120,93,24,69,4,23,87,35,11,8,28,5
S01013304,Rented or living rent free: Private rented or living rent free,48,39,33,5,28,1,5,9,3,0,2,2,2
S01013305,All HRPs aged 16 and over,444,283,255,45,210,18,10,161,116,0,13,27,5
S01013305,Owned: Total,228,157,141,18,123,14,2,71,67,0,0,3,1
S01013305,Owned: Owned outright,68,22,16,6,10,5,1,46,44,0,0,2,0
S01013305,Owned: Owned with a mortgage or loan or shared ownership,160,135,125,12,113,9,1,25,23,0,0,1,1
S01013305,Rented or living rent free: Total,216,126,114,27,87,4,8,90,49,0,13,24,4
S01013305,Rented or living rent free: Social rented,141,59,49,17,32,3,7,82,46,0,10,23,3
S01013305,Rented or living rent free: Private rented or living rent free,75,67,65,10,55,1,1,8,3,0,3,1,1
S01013306,All HRPs aged 16 and over,501,314,242,56,186,14,58,187,71,5,23,69,19
S01013306,Owned: Total,86,65,58,7,51,4,3,21,19,0,0,1,1
S01013306,Owned: Owned outright,23,8,7,3,4,1,0,15,15,0,0,0,0
S01013306,Owned: Owned with a mortgage or loan or shared ownership,63,57,51,4,47,3,3,6,4,0,0,1,1
S01013306,Rented or living rent free: Total,415,249,184,49,135,10,55,166,52,5,23,68,18
S01013306,Rented or living rent free: Social rented,366,212,155,45,110,9,48,154,51,5,20,63,15
S01013306,Rented or living rent free: Private rented or living rent free,49,37,29,4,25,1,7,12,1,0,3,5,3
S01013307,All HRPs aged 16 and over,436,312,249,44,205,16,47,124,59,4,13,33,15
S01013307,Owned: Total,145,116,106,13,93,8,2,29,24,1,0,1,3
S01013307,Owned: Owned outright,39,19,17,5,12,2,0,20,20,0,0,0,0
S01013307,Owned: Owned with a mortgage or loan or shared ownership,106,97,89,8,81,6,2,9,4,1,0,1,3
S01013307,Rented or living rent free: Total,291,196,143,31,112,8,45,95,35,3,13,32,12
S01013307,Rented or living rent free: Social rented,230,152,104,27,77,6,42,78,31,2,11,30,4
S01013307,Rented or living rent free: Private rented or living rent free,61,44,39,4,35,2,3,17,4,1,2,2,8
S01013308,All HRPs aged 16 and over,374,260,207,53,154,15,38,114,48,7,16,37,6
S01013308,Owned: Total,86,62,54,8,46,6,2,24,20,0,0,4,0
S01013308,Owned: Owned outright,32,11,10,2,8,1,0,21,19,0,0,2,0
S01013308,Owned: Owned with a mortgage or loan or shared ownership,54,51,44,6,38,5,2,3,1,0,0,2,0
S01013308,Rented or living rent free: Total,288,198,153,45,108,9,36,90,28,7,16,33,6
S01013308,Rented or living rent free: Social rented,264,180,142,43,99,8,30,84,26,7,16,30,5
S01013308,Rented or living rent free: Private rented or living rent free,24,18,11,2,9,1,6,6,2,0,0,3,1
S01013309,All HRPs aged 16 and over,236,193,175,20,155,15,3,43,29,0,1,10,3
S01013309,Owned: Total,164,141,126,10,116,13,2,23,19,0,0,4,0
S01013309,Owned: Owned outright,46,28,22,4,18,4,2,18,15,0,0,3,0
S01013309,Owned: Owned with a mortgage or loan or shared ownership,118,113,104,6,98,9,0,5,4,0,0,1,0
S01013309,Rented or living rent free: Total,72,52,49,10,39,2,1,20,10,0,1,6,3
S01013309,Rented or living rent free: Social rented,14,6,5,2,3,1,0,8,4,0,0,3,1
S01013309,Rented or living rent free: Private rented or living rent free,58,46,44,8,36,1,1,12,6,0,1,3,2
S01013310,All HRPs aged 16 and over,241,176,160,23,137,10,6,65,51,2,4,8,0
S01013310,Owned: Total,156,122,115,13,102,6,1,34,32,1,1,0,0
S01013310,Owned: Owned outright,48,18,15,4,11,2,1,30,30,0,0,0,0
S01013310,Owned: Owned with a mortgage or loan or shared ownership,108,104,100,9,91,4,0,4,2,1,1,0,0
S01013310,Rented or living rent free: Total,85,54,45,10,35,4,5,31,19,1,3,8,0
S01013310,Rented or living rent free: Social rented,62,33,29,9,20,3,1,29,19,1,2,7,0
S01013310,Rented or living rent free: Private rented or living rent free,23,21,16,1,15,1,4,2,0,0,1,1,0
S01013311,All HRPs aged 16 and over,313,219,187,28,159,20,12,94,56,3,11,17,7
S01013311,Owned: Total,174,139,124,11,113,12,3,35,32,0,0,2,1
S01013311,Owned: Owned outright,62,34,31,6,25,2,1,28,27,0,0,0,1
S01013311,Owned: Owned with a mortgage or loan or shared ownership,112,105,93,5,88,10,2,7,5,0,0,2,0
S01013311,Rented or living rent free: Total,139,80,63,17,46,8,9,59,24,3,11,15,6
S01013311,Rented or living rent free: Social rented,90,43,33,8,25,6,4,47,21,2,6,15,3
S01013311,Rented or living rent free: Private rented or living rent free,49,37,30,9,21,2,5,12,3,1,5,0,3
S01013312,All HRPs aged 16 and over,486,323,275,39,236,25,23,163,101,4,15,32,11
S01013312,Owned: Total,256,193,174,22,152,14,5,63,57,1,1,4,0
S01013312,Owned: Owned outright,87,33,28,6,22,3,2,54,51,0,1,2,0
S01013312,Owned: Owned with a mortgage or loan or shared ownership,169,160,146,16,130,11,3,9,6,1,0,2,0
S01013312,Rented or living rent free: Total,230,130,101,17,84,11,18,100,44,3,14,28,11
S01013312,Rented or living rent free: Social rented,177,88,66,15,51,6,16,89,40,3,11,24,11
S01013312,Rented or living rent free: Private rented or living rent free,53,42,35,2,33,5,2,11,4,0,3,4,0
S01013313,All HRPs aged 16 and over,276,185,163,35,128,14,8,91,66,1,4,18,2
S01013313,Owned: Total,155,102,92,11,81,7,3,53,51,0,0,2,0
S01013313,Owned: Owned outright,69,23,19,5,14,4,0,46,45,0,0,1,0
S01013313,Owned: Owned with a mortgage or loan or shared ownership,86,79,73,6,67,3,3,7,6,0,0,1,0
S01013313,Rented or living rent free: Total,121,83,71,24,47,7,5,38,15,1,4,16,2
S01013313,Rented or living rent free: Social rented,81,50,43,16,27,5,2,31,12,0,3,14,2
S01013313,Rented or living rent free: Private rented or living rent free,40,33,28,8,20,2,3,7,3,1,1,2,0
S01013314,All HRPs aged 16 and over,304,180,159,34,125,15,6,124,94,2,7,18,3
S01013314,Owned: Total,158,107,98,14,84,9,0,51,48,0,1,2,0
S01013314,Owned: Owned outright,75,31,29,6,23,2,0,44,43,0,0,1,0
S01013314,Owned: Owned with a mortgage or loan or shared ownership,83,76,69,8,61,7,0,7,5,0,1,1,0
S01013314,Rented or living rent free: Total,146,73,61,20,41,6,6,73,46,2,6,16,3
S01013314,Rented or living rent free: Social rented,112,47,37,15,22,4,6,65,45,2,3,12,3
S01013314,Rented or living rent free: Private rented or living rent free,34,26,24,5,19,2,0,8,1,0,3,4,0
S01013315,All HRPs aged 16 and over,174,164,136,10,126,27,1,10,9,0,1,0,0
S01013315,Owned: Total,160,152,126,8,118,26,0,8,8,0,0,0,0
S01013315,Owned: Owned outright,27,20,16,4,12,4,0,7,7,0,0,0,0
S01013315,Owned: Owned with a mortgage or loan or shared ownership,133,132,110,4,106,22,0,1,1,0,0,0,0
S01013315,Rented or living rent free: Total,14,12,10,2,8,1,1,2,1,0,1,0,0
S01013315,Rented or living rent free: Social rented,2,0,0,0,0,0,0,2,1,0,1,0,0
S01013315,Rented or living rent free: Private rented or living rent free,12,12,10,2,8,1,1,0,0,0,0,0,0
S01013316,All HRPs aged 16 and over,273,168,136,13,123,28,4,105,94,0,7,3,1
S01013316,Owned: Total,222,150,126,9,117,24,0,72,69,0,3,0,0
S01013316,Owned: Owned outright,118,54,44,5,39,10,0,64,63,0,1,0,0
S01013316,Owned: Owned with a mortgage or loan or shared ownership,104,96,82,4,78,14,0,8,6,0,2,0,0
S01013316,Rented or living rent free: Total,51,18,10,4,6,4,4,33,25,0,4,3,1
S01013316,Rented or living rent free: Social rented,36,9,4,1,3,2,3,27,22,0,1,3,1
S01013316,Rented or living rent free: Private rented or living rent free,15,9,6,3,3,2,1,6,3,0,3,0,0
S01013317,All HRPs aged 16 and over,257,178,159,19,140,16,3,79,68,0,2,6,3
S01013317,Owned: Total,221,153,138,13,125,14,1,68,63,0,1,3,1
S01013317,Owned: Owned outright,91,34,29,9,20,4,1,57,54,0,1,2,0
S01013317,Owned: Owned with a mortgage or loan or shared ownership,130,119,109,4,105,10,0,11,9,0,0,1,1
S01013317,Rented or living rent free: Total,36,25,21,6,15,2,2,11,5,0,1,3,2
S01013317,Rented or living rent free: Social rented,2,0,0,0,0,0,0,2,1,0,0,1,0
S01013317,Rented or living rent free: Private rented or living rent free,34,25,21,6,15,2,2,9,4,0,1,2,2
S01013318,All HRPs aged 16 and over,245,204,188,19,169,13,3,41,32,0,2,3,4
S01013318,Owned: Total,209,173,161,13,148,11,1,36,31,0,0,2,3
S01013318,Owned: Owned outright,51,26,22,6,16,4,0,25,24,0,0,0,1
S01013318,Owned: Owned with a mortgage or loan or shared ownership,158,147,139,7,132,7,1,11,7,0,0,2,2
S01013318,Rented or living rent free: Total,36,31,27,6,21,2,2,5,1,0,2,1,1
S01013318,Rented or living rent free: Social rented,6,5,3,1,2,1,1,1,0,0,0,0,1
S01013318,Rented or living rent free: Private rented or living rent free,30,26,24,5,19,1,1,4,1,0,2,1,0
S01013319,All HRPs aged 16 and over,209,172,150,18,132,18,4,37,26,0,3,6,2
S01013319,Owned: Total,145,128,114,6,108,14,0,17,15,0,0,1,1
S01013319,Owned: Owned outright,27,15,13,2,11,2,0,12,12,0,0,0,0
S01013319,Owned: Owned with a mortgage or loan or shared ownership,118,113,101,4,97,12,0,5,3,0,0,1,1
S01013319,Rented or living rent free: Total,64,44,36,12,24,4,4,20,11,0,3,5,1
S01013319,Rented or living rent free: Social rented,50,31,24,8,16,4,3,19,11,0,2,5,1
S01013319,Rented or living rent free: Private rented or living rent free,14,13,12,4,8,0,1,1,0,0,1,0,0
S01013320,All HRPs aged 16 and over,357,331,292,19,273,32,7,26,15,1,2,5,3
S01013320,Owned: Total,287,270,239,10,229,29,2,17,14,0,1,0,2
S01013320,Owned: Owned outright,43,30,25,8,17,5,0,13,12,0,0,0,1
S01013320,Owned: Owned with a mortgage or loan or shared ownership,244,240,214,2,212,24,2,4,2,0,1,0,1
S01013320,Rented or living rent free: Total,70,61,53,9,44,3,5,9,1,1,1,5,1
S01013320,Rented or living rent free: Social rented,16,10,7,1,6,0,3,6,1,0,0,4,1
S01013320,Rented or living rent free: Private rented or living rent free,54,51,46,8,38,3,2,3,0,1,1,1,0
S01013321,All HRPs aged 16 and over,223,136,115,19,96,6,15,87,66,1,1,17,2
S01013321,Owned: Total,107,84,77,5,72,5,2,23,22,0,0,1,0
S01013321,Owned: Owned outright,26,15,11,1,10,3,1,11,11,0,0,0,0
S01013321,Owned: Owned with a mortgage or loan or shared ownership,81,69,66,4,62,2,1,12,11,0,0,1,0
S01013321,Rented or living rent free: Total,116,52,38,14,24,1,13,64,44,1,1,16,2
S01013321,Rented or living rent free: Social rented,93,36,25,11,14,1,10,57,40,1,0,14,2
S01013321,Rented or living rent free: Private rented or living rent free,23,16,13,3,10,0,3,7,4,0,1,2,0
S01013322,All HRPs aged 16 and over,267,201,180,29,151,14,7,66,41,3,6,14,2
S01013322,Owned: Total,180,154,140,15,125,11,3,26,22,1,1,1,1
S01013322,Owned: Owned outright,46,25,21,4,17,3,1,21,19,0,0,1,1
S01013322,Owned: Owned with a mortgage or loan or shared ownership,134,129,119,11,108,8,2,5,3,1,1,0,0
S01013322,Rented or living rent free: Total,87,47,40,14,26,3,4,40,19,2,5,13,1
S01013322,Rented or living rent free: Social rented,65,33,28,11,17,2,3,32,18,1,1,11,1
S01013322,Rented or living rent free: Private rented or living rent free,22,14,12,3,9,1,1,8,1,1,4,2,0
S01013323,All HRPs aged 16 and over,416,282,239,49,190,14,29,134,83,10,10,24,7
S01013323,Owned: Total,199,152,142,22,120,8,2,47,42,2,1,0,2
S01013323,Owned: Owned outright,54,23,22,10,12,1,0,31,31,0,0,0,0
S01013323,Owned: Owned with a mortgage or loan or shared ownership,145,129,120,12,108,7,2,16,11,2,1,0,2
S01013323,Rented or living rent free: Total,217,130,97,27,70,6,27,87,41,8,9,24,5
S01013323,Rented or living rent free: Social rented,180,98,73,24,49,1,24,82,38,8,9,22,5
S01013323,Rented or living rent free: Private rented or living rent free,37,32,24,3,21,5,3,5,3,0,0,2,0
S01013324,All HRPs aged 16 and over,275,191,157,42,115,10,24,84,46,6,10,17,5
S01013324,Owned: Total,104,83,74,11,63,7,2,21,21,0,0,0,0
S01013324,Owned: Owned outright,30,14,12,2,10,1,1,16,16,0,0,0,0
S01013324,Owned: Owned with a mortgage or loan or shared ownership,74,69,62,9,53,6,1,5,5,0,0,0,0
S01013324,Rented or living rent free: Total,171,108,83,31,52,3,22,63,25,6,10,17,5
S01013324,Rented or living rent free: Social rented,154,96,74,30,44,2,20,58,24,6,9,16,3
S01013324,Rented or living rent free: Private rented or living rent free,17,12,9,1,8,1,2,5,1,0,1,1,2
S01013325,All HRPs aged 16 and over,353,213,180,48,132,13,20,140,61,6,28,41,4
S01013325,Owned: Total,57,53,47,2,45,6,0,4,4,0,0,0,0
S01013325,Owned: Owned outright,10,8,7,1,6,1,0,2,2,0,0,0,0
S01013325,Owned: Owned with a mortgage or loan or shared ownership,47,45,40,1,39,5,0,2,2,0,0,0,0
S01013325,Rented or living rent free: Total,296,160,133,46,87,7,20,136,57,6,28,41,4
S01013325,Rented or living rent free: Social rented,285,151,128,46,82,5,18,134,57,6,26,41,4
S01013325,Rented or living rent free: Private rented or living rent free,11,9,5,0,5,2,2,2,0,0,2,0,0
S01013326,All HRPs aged 16 and over,218,139,113,20,93,13,13,79,48,5,8,16,2
S01013326,Owned: Total,98,73,61,7,54,11,1,25,22,0,0,2,1
S01013326,Owned: Owned outright,26,8,7,1,6,1,0,18,16,0,0,1,1
S01013326,Owned: Owned with a mortgage or loan or shared ownership,72,65,54,6,48,10,1,7,6,0,0,1,0
S01013326,Rented or living rent free: Total,120,66,52,13,39,2,12,54,26,5,8,14,1
S01013326,Rented or living rent free: Social rented,92,46,33,12,21,1,12,46,23,5,4,13,1
S01013326,Rented or living rent free: Private rented or living rent free,28,20,19,1,18,1,0,8,3,0,4,1,0
S01013327,All HRPs aged 16 and over,269,185,155,50,105,18,12,84,45,1,15,20,3
S01013327,Owned: Total,114,91,77,17,60,14,0,23,23,0,0,0,0
S01013327,Owned: Owned outright,36,18,14,6,8,4,0,18,18,0,0,0,0
S01013327,Owned: Owned with a mortgage or loan or shared ownership,78,73,63,11,52,10,0,5,5,0,0,0,0
S01013327,Rented or living rent free: Total,155,94,78,33,45,4,12,61,22,1,15,20,3
S01013327,Rented or living rent free: Social rented,129,79,65,28,37,2,12,50,19,0,11,17,3
S01013327,Rented or living rent free: Private rented or living rent free,26,15,13,5,8,2,0,11,3,1,4,3,0
S01013328,All HRPs aged 16 and over,236,158,140,28,112,12,6,78,38,1,11,16,12
S01013328,Owned: Total,95,75,68,6,62,7,0,20,17,0,0,2,1
S01013328,Owned: Owned outright,24,10,9,2,7,1,0,14,13,0,0,1,0
S01013328,Owned: Owned with a mortgage or loan or shared ownership,71,65,59,4,55,6,0,6,4,0,0,1,1
S01013328,Rented or living rent free: Total,141,83,72,22,50,5,6,58,21,1,11,14,11
S01013328,Rented or living rent free: Social rented,113,63,57,16,41,1,5,50,20,0,6,13,11
S01013328,Rented or living rent free: Private rented or living rent free,28,20,15,6,9,4,1,8,1,1,5,1,0
S01013329,All HRPs aged 16 and over,228,137,122,30,92,9,6,91,66,1,4,17,3
S01013329,Owned: Total,136,88,80,16,64,7,1,48,44,0,0,3,1
S01013329,Owned: Owned outright,60,23,21,6,15,2,0,37,36,0,0,1,0
S01013329,Owned: Owned with a mortgage or loan or shared ownership,76,65,59,10,49,5,1,11,8,0,0,2,1
S01013329,Rented or living rent free: Total,92,49,42,14,28,2,5,43,22,1,4,14,2
S01013329,Rented or living rent free: Social rented,68,32,29,10,19,0,3,36,22,1,3,9,1
S01013329,Rented or living rent free: Private rented or living rent free,24,17,13,4,9,2,2,7,0,0,1,5,1
S01013330,All HRPs aged 16 and over,430,378,336,27,309,31,11,52,28,0,6,15,3
S01013330,Owned: Total,288,257,230,15,215,25,2,31,23,0,0,7,1
S01013330,Owned: Owned outright,56,36,31,4,27,4,1,20,16,0,0,3,1
S01013330,Owned: Owned with a mortgage or loan or shared ownership,232,221,199,11,188,21,1,11,7,0,0,4,0
S01013330,Rented or living rent free: Total,142,121,106,12,94,6,9,21,5,0,6,8,2
S01013330,Rented or living rent free: Social rented,30,20,18,3,15,0,2,10,3,0,3,2,2
S01013330,Rented or living rent free: Private rented or living rent free,112,101,88,9,79,6,7,11,2,0,3,6,0
S01013331,All HRPs aged 16 and over,248,223,196,15,181,22,5,25,11,0,4,3,7
S01013331,Owned: Total,169,160,141,10,131,19,0,9,8,0,1,0,0
S01013331,Owned: Owned outright,27,20,17,3,14,3,0,7,7,0,0,0,0
S01013331,Owned: Owned with a mortgage or loan or shared ownership,142,140,124,7,117,16,0,2,1,0,1,0,0
S01013331,Rented or living rent free: Total,79,63,55,5,50,3,5,16,3,0,3,3,7
S01013331,Rented or living rent free: Social rented,7,3,2,0,2,1,0,4,1,0,1,1,1
S01013331,Rented or living rent free: Private rented or living rent free,72,60,53,5,48,2,5,12,2,0,2,2,6
S01013332,All HRPs aged 16 and over,285,190,161,28,133,21,8,95,73,3,7,11,1
S01013332,Owned: Total,174,139,121,20,101,16,2,35,34,0,0,1,0
S01013332,Owned: Owned outright,59,29,27,7,20,2,0,30,29,0,0,1,0
S01013332,Owned: Owned with a mortgage or loan or shared ownership,115,110,94,13,81,14,2,5,5,0,0,0,0
S01013332,Rented or living rent free: Total,111,51,40,8,32,5,6,60,39,3,7,10,1
S01013332,Rented or living rent free: Social rented,77,27,20,4,16,1,6,50,37,2,3,8,0
S01013332,Rented or living rent free: Private rented or living rent free,34,24,20,4,16,4,0,10,2,1,4,2,1
S01013333,All HRPs aged 16 and over,327,256,222,23,199,27,7,71,57,1,3,8,2
S01013333,Owned: Total,256,216,192,17,175,21,3,40,39,1,0,0,0
S01013333,Owned: Owned outright,64,35,28,5,23,6,1,29,29,0,0,0,0
S01013333,Owned: Owned with a mortgage or loan or shared ownership,192,181,164,12,152,15,2,11,10,1,0,0,0
S01013333,Rented or living rent free: Total,71,40,30,6,24,6,4,31,18,0,3,8,2
S01013333,Rented or living rent free: Social rented,36,9,8,4,4,0,1,27,17,0,1,8,1
S01013333,Rented or living rent free: Private rented or living rent free,35,31,22,2,20,6,3,4,1,0,2,0,1
S01013334,All HRPs aged 16 and over,294,216,190,40,150,14,12,78,34,0,17,16,11
S01013334,Owned: Total,155,131,120,18,102,10,1,24,18,0,1,4,1
S01013334,Owned: Owned outright,38,23,22,4,18,1,0,15,13,0,1,0,1
S01013334,Owned: Owned with a mortgage or loan or shared ownership,117,108,98,14,84,9,1,9,5,0,0,4,0
S01013334,Rented or living rent free: Total,139,85,70,22,48,4,11,54,16,0,16,12,10
S01013334,Rented or living rent free: Social rented,110,68,57,19,38,4,7,42,14,0,9,12,7
S01013334,Rented or living rent free: Private rented or living rent free,29,17,13,3,10,0,4,12,2,0,7,0,3
S01013335,All HRPs aged 16 and over,294,193,154,29,125,17,22,101,38,6,20,28,9
S01013335,Owned: Total,106,87,76,6,70,9,2,19,19,0,0,0,0
S01013335,Owned: Owned outright,29,14,10,1,9,4,0,15,15,0,0,0,0
S01013335,Owned: Owned with a mortgage or loan or shared ownership,77,73,66,5,61,5,2,4,4,0,0,0,0
S01013335,Rented or living rent free: Total,188,106,78,23,55,8,20,82,19,6,20,28,9
S01013335,Rented or living rent free: Social rented,173,98,71,21,50,7,20,75,19,5,17,26,8
S01013335,Rented or living rent free: Private rented or living rent free,15,8,7,2,5,1,0,7,0,1,3,2,1
S01013336,All HRPs aged 16 and over,339,222,172,31,141,21,29,117,47,1,15,43,11
S01013336,Owned: Total,105,82,69,8,61,10,3,23,17,0,1,3,2
S01013336,Owned: Owned outright,34,19,17,5,12,1,1,15,11,0,1,1,2
S01013336,Owned: Owned with a mortgage or loan or shared ownership,71,63,52,3,49,9,2,8,6,0,0,2,0
S01013336,Rented or living rent free: Total,234,140,103,23,80,11,26,94,30,1,14,40,9
S01013336,Rented or living rent free: Social rented,196,113,83,19,64,10,20,83,26,1,11,36,9
S01013336,Rented or living rent free: Private rented or living rent free,38,27,20,4,16,1,6,11,4,0,3,4,0
S01013337,All HRPs aged 16 and over,365,258,220,20,200,31,7,107,94,0,3,4,6
S01013337,Owned: Total,302,219,187,13,174,30,2,83,79,0,0,2,2
S01013337,Owned: Owned outright,124,54,44,7,37,10,0,70,68,0,0,1,1
S01013337,Owned: Owned with a mortgage or loan or shared ownership,178,165,143,6,137,20,2,13,11,0,0,1,1
S01013337,Rented or living rent free: Total,63,39,33,7,26,1,5,24,15,0,3,2,4
S01013337,Rented or living rent free: Social rented,34,16,14,2,12,0,2,18,11,0,3,1,3
S01013337,Rented or living rent free: Private rented or living rent free,29,23,19,5,14,1,3,6,4,0,0,1,1
S01013338,All HRPs aged 16 and over,165,156,129,10,119,25,2,9,6,0,2,0,1
S01013338,Owned: Total,146,138,117,8,109,21,0,8,6,0,2,0,0
S01013338,Owned: Owned outright,19,15,12,3,9,3,0,4,4,0,0,0,0
S01013338,Owned: Owned with a mortgage or loan or shared ownership,127,123,105,5,100,18,0,4,2,0,2,0,0
S01013338,Rented or living rent free: Total,19,18,12,2,10,4,2,1,0,0,0,0,1
S01013338,Rented or living rent free: Social rented,0,0,0,0,0,0,0,0,0,0,0,0,0
S01013338,Rented or living rent free: Private rented or living rent free,19,18,12,2,10,4,2,1,0,0,0,0,1
S01013339,All HRPs aged 16 and over,233,189,165,16,149,19,5,44,41,0,0,2,1
S01013339,Owned: Total,196,156,137,7,130,16,3,40,39,0,0,1,0
S01013339,Owned: Owned outright,74,41,36,2,34,4,1,33,32,0,0,1,0
S01013339,Owned: Owned with a mortgage or loan or shared ownership,122,115,101,5,96,12,2,7,7,0,0,0,0
S01013339,Rented or living rent free: Total,37,33,28,9,19,3,2,4,2,0,0,1,1
S01013339,Rented or living rent free: Social rented,4,3,3,2,1,0,0,1,0,0,0,0,1
S01013339,Rented or living rent free: Private rented or living rent free,33,30,25,7,18,3,2,3,2,0,0,1,0
S01013340,All HRPs aged 16 and over,335,251,212,18,194,36,3,84,75,0,0,6,3
S01013340,Owned: Total,310,232,197,15,182,35,0,78,73,0,0,4,1
S01013340,Owned: Owned outright,130,66,56,8,48,10,0,64,62,0,0,1,1
S01013340,Owned: Owned with a mortgage or loan or shared ownership,180,166,141,7,134,25,0,14,11,0,0,3,0
S01013340,Rented or living rent free: Total,25,19,15,3,12,1,3,6,2,0,0,2,2
S01013340,Rented or living rent free: Social rented,4,3,2,0,2,0,1,1,0,0,0,1,0
S01013340,Rented or living rent free: Private rented or living rent free,21,16,13,3,10,1,2,5,2,0,0,1,2
S01013341,All HRPs aged 16 and over,388,320,262,22,240,47,11,68,59,1,2,5,1
S01013341,Owned: Total,295,240,197,16,181,38,5,55,53,1,0,1,0
S01013341,Owned: Owned outright,110,60,40,6,34,16,4,50,49,0,0,1,0
S01013341,Owned: Owned with a mortgage or loan or shared ownership,185,180,157,10,147,22,1,5,4,1,0,0,0
S01013341,Rented or living rent free: Total,93,80,65,6,59,9,6,13,6,0,2,4,1
S01013341,Rented or living rent free: Social rented,13,6,3,3,0,0,3,7,3,0,0,4,0
S01013341,Rented or living rent free: Private rented or living rent free,80,74,62,3,59,9,3,6,3,0,2,0,1
S01013342,All HRPs aged 16 and over,286,176,154,32,122,9,13,110,76,0,7,25,2
S01013342,Owned: Total,133,89,82,7,75,7,0,44,37,0,3,4,0
S01013342,Owned: Owned outright,39,11,8,1,7,3,0,28,26,0,2,0,0
S01013342,Owned: Owned with a mortgage or loan or shared ownership,94,78,74,6,68,4,0,16,11,0,1,4,0
S01013342,Rented or living rent free: Total,153,87,72,25,47,2,13,66,39,0,4,21,2
S01013342,Rented or living rent free: Social rented,125,68,55,21,34,2,11,57,36,0,2,17,2
S01013342,Rented or living rent free: Private rented or living rent free,28,19,17,4,13,0,2,9,3,0,2,4,0
S01013343,All HRPs aged 16 and over,276,200,175,22,153,17,8,76,53,3,3,10,7
S01013343,Owned: Total,165,142,130,11,119,11,1,23,20,0,0,3,0
S01013343,Owned: Owned outright,40,22,19,4,15,3,0,18,18,0,0,0,0
S01013343,Owned: Owned with a mortgage or loan or shared ownership,125,120,111,7,104,8,1,5,2,0,0,3,0
S01013343,Rented or living rent free: Total,111,58,45,11,34,6,7,53,33,3,3,7,7
S01013343,Rented or living rent free: Social rented,89,41,31,6,25,5,5,48,32,2,1,7,6
S01013343,Rented or living rent free: Private rented or living rent free,22,17,14,5,9,1,2,5,1,1,2,0,1
S01013344,All HRPs aged 16 and over,356,184,161,36,125,14,9,172,116,1,15,37,3
S01013344,Owned: Total,128,87,77,15,62,10,0,41,39,0,1,1,0
S01013344,Owned: Owned outright,52,20,18,9,9,2,0,32,32,0,0,0,0
S01013344,Owned: Owned with a mortgage or loan or shared ownership,76,67,59,6,53,8,0,9,7,0,1,1,0
S01013344,Rented or living rent free: Total,228,97,84,21,63,4,9,131,77,1,14,36,3
S01013344,Rented or living rent free: Social rented,203,85,75,20,55,3,7,118,70,1,12,32,3
S01013344,Rented or living rent free: Private rented or living rent free,25,12,9,1,8,1,2,13,7,0,2,4,0
S01013345,All HRPs aged 16 and over,298,220,194,37,157,14,12,78,50,5,8,11,4
S01013345,Owned: Total,164,138,127,21,106,11,0,26,21,1,2,1,1
S01013345,Owned: Owned outright,36,21,20,9,11,1,0,15,13,0,0,1,1
S01013345,Owned: Owned with a mortgage or loan or shared ownership,128,117,107,12,95,10,0,11,8,1,2,0,0
S01013345,Rented or living rent free: Total,134,82,67,16,51,3,12,52,29,4,6,10,3
S01013345,Rented or living rent free: Social rented,97,53,47,13,34,2,4,44,27,4,4,7,2
S01013345,Rented or living rent free: Private rented or living rent free,37,29,20,3,17,1,8,8,2,0,2,3,1
S01013346,All HRPs aged 16 and over,282,253,230,18,212,17,6,29,18,0,6,5,0
S01013346,Owned: Total,225,207,191,10,181,15,1,18,15,0,1,2,0
S01013346,Owned: Owned outright,42,32,31,3,28,1,0,10,10,0,0,0,0
S01013346,Owned: Owned with a mortgage or loan or shared ownership,183,175,160,7,153,14,1,8,5,0,1,2,0
S01013346,Rented or living rent free: Total,57,46,39,8,31,2,5,11,3,0,5,3,0
S01013346,Rented or living rent free: Social rented,28,22,17,6,11,1,4,6,1,0,2,3,0
S01013346,Rented or living rent free: Private rented or living rent free,29,24,22,2,20,1,1,5,2,0,3,0,0
S01013347,All HRPs aged 16 and over,332,272,238,28,210,21,13,60,50,1,0,4,5
S01013347,Owned: Total,264,216,194,18,176,18,4,48,44,0,0,2,2
S01013347,Owned: Owned outright,77,36,31,7,24,4,1,41,38,0,0,2,1
S01013347,Owned: Owned with a mortgage or loan or shared ownership,187,180,163,11,152,14,3,7,6,0,0,0,1
S01013347,Rented or living rent free: Total,68,56,44,10,34,3,9,12,6,1,0,2,3
S01013347,Rented or living rent free: Social rented,17,13,8,2,6,1,4,4,2,0,0,2,0
S01013347,Rented or living rent free: Private rented or living rent free,51,43,36,8,28,2,5,8,4,1,0,0,3
S01013348,All HRPs aged 16 and over,169,153,130,12,118,21,2,16,13,1,1,1,0
S01013348,Owned: Total,150,138,120,10,110,17,1,12,12,0,0,0,0
S01013348,Owned: Owned outright,33,22,18,5,13,3,1,11,11,0,0,0,0
S01013348,Owned: Owned with a mortgage or loan or shared ownership,117,116,102,5,97,14,0,1,1,0,0,0,0
S01013348,Rented or living rent free: Total,19,15,10,2,8,4,1,4,1,1,1,1,0
S01013348,Rented or living rent free: Social rented,3,0,0,0,0,0,0,3,1,0,1,1,0
S01013348,Rented or living rent free: Private rented or living rent free,16,15,10,2,8,4,1,1,0,1,0,0,0
S01013349,All HRPs aged 16 and over,359,312,282,28,254,13,17,47,9,7,13,15,3
S01013349,Owned: Total,144,133,125,10,115,7,1,11,5,2,0,3,1
S01013349,Owned: Owned outright,13,8,7,0,7,1,0,5,4,0,0,1,0
S01013349,Owned: Owned with a mortgage or loan or shared ownership,131,125,118,10,108,6,1,6,1,2,0,2,1
S01013349,Rented or living rent free: Total,215,179,157,18,139,6,16,36,4,5,13,12,2
S01013349,Rented or living rent free: Social rented,35,20,12,3,9,1,7,15,2,1,3,9,0
S01013349,Rented or living rent free: Private rented or living rent free,180,159,145,15,130,5,9,21,2,4,10,3,2
S01013350,All HRPs aged 16 and over,285,197,172,25,147,15,10,88,62,3,4,14,5
S01013350,Owned: Total,124,103,89,10,79,10,4,21,16,0,1,2,2
S01013350,Owned: Owned outright,31,18,15,1,14,1,2,13,10,0,1,0,2
S01013350,Owned: Owned with a mortgage or loan or shared ownership,93,85,74,9,65,9,2,8,6,0,0,2,0
S01013350,Rented or living rent free: Total,161,94,83,15,68,5,6,67,46,3,3,12,3
S01013350,Rented or living rent free: Social rented,122,63,55,10,45,2,6,59,42,2,2,11,2
S01013350,Rented or living rent free: Private rented or living rent free,39,31,28,5,23,3,0,8,4,1,1,1,1
S01013351,All HRPs aged 16 and over,320,228,204,24,180,18,6,92,70,3,7,11,1
S01013351,Owned: Total,241,188,169,19,150,18,1,53,49,0,1,3,0
S01013351,Owned: Owned outright,87,46,41,5,36,4,1,41,39,0,0,2,0
S01013351,Owned: Owned with a mortgage or loan or shared ownership,154,142,128,14,114,14,0,12,10,0,1,1,0
S01013351,Rented or living rent free: Total,79,40,35,5,30,0,5,39,21,3,6,8,1
S01013351,Rented or living rent free: Social rented,45,19,15,3,12,0,4,26,16,0,2,7,1
S01013351,Rented or living rent free: Private rented or living rent free,34,21,20,2,18,0,1,13,5,3,4,1,0
S01013352,All HRPs aged 16 and over,355,257,228,32,196,19,10,98,78,1,9,9,1
S01013352,Owned: Total,249,194,177,19,158,14,3,55,54,0,1,0,0
S01013352,Owned: Owned outright,77,36,34,9,25,2,0,41,41,0,0,0,0
S01013352,Owned: Owned with a mortgage or loan or shared ownership,172,158,143,10,133,12,3,14,13,0,1,0,0
S01013352,Rented or living rent free: Total,106,63,51,13,38,5,7,43,24,1,8,9,1
S01013352,Rented or living rent free: Social rented,66,37,33,8,25,1,3,29,18,0,4,7,0
S01013352,Rented or living rent free: Private rented or living rent free,40,26,18,5,13,4,4,14,6,1,4,2,1
S01013353,All HRPs aged 16 and over,283,191,162,28,134,21,8,92,56,1,7,25,3
S01013353,Owned: Total,145,121,102,11,91,19,0,24,22,0,0,1,1
S01013353,Owned: Owned outright,36,19,18,3,15,1,0,17,17,0,0,0,0
S01013353,Owned: Owned with a mortgage or loan or shared ownership,109,102,84,8,76,18,0,7,5,0,0,1,1
S01013353,Rented or living rent free: Total,138,70,60,17,43,2,8,68,34,1,7,24,2
S01013353,Rented or living rent free: Social rented,120,57,49,15,34,1,7,63,33,1,4,24,1
S01013353,Rented or living rent free: Private rented or living rent free,18,13,11,2,9,1,1,5,1,0,3,0,1
S01013354,All HRPs aged 16 and over,317,229,201,23,178,23,5,88,76,2,0,9,1
S01013354,Owned: Total,238,186,166,13,153,19,1,52,50,0,0,2,0
S01013354,Owned: Owned outright,88,51,48,5,43,3,0,37,35,0,0,2,0
S01013354,Owned: Owned with a mortgage or loan or shared ownership,150,135,118,8,110,16,1,15,15,0,0,0,0
S01013354,Rented or living rent free: Total,79,43,35,10,25,4,4,36,26,2,0,7,1
S01013354,Rented or living rent free: Social rented,53,24,21,8,13,1,2,29,20,2,0,6,1
S01013354,Rented or living rent free: Private rented or living rent free,26,19,14,2,12,3,2,7,6,0,0,1,0
S01013355,All HRPs aged 16 and over,274,182,157,20,137,22,3,92,71,0,6,12,3
S01013355,Owned: Total,176,129,111,11,100,18,0,47,42,0,1,3,1
S01013355,Owned: Owned outright,61,26,23,4,19,3,0,35,34,0,0,1,0
S01013355,Owned: Owned with a mortgage or loan or shared ownership,115,103,88,7,81,15,0,12,8,0,1,2,1
S01013355,Rented or living rent free: Total,98,53,46,9,37,4,3,45,29,0,5,9,2
S01013355,Rented or living rent free: Social rented,72,38,35,8,27,3,0,34,21,0,5,8,0
S01013355,Rented or living rent free: Private rented or living rent free,26,15,11,1,10,1,3,11,8,0,0,1,2
S01013356,All HRPs aged 16 and over,323,221,164,48,116,24,33,102,59,7,10,23,3
S01013356,Owned: Total,134,104,80,15,65,22,2,30,30,0,0,0,0
S01013356,Owned: Owned outright,41,22,14,5,9,8,0,19,19,0,0,0,0
S01013356,Owned: Owned with a mortgage or loan or shared ownership,93,82,66,10,56,14,2,11,11,0,0,0,0
S01013356,Rented or living rent free: Total,189,117,84,33,51,2,31,72,29,7,10,23,3
S01013356,Rented or living rent free: Social rented,165,98,67,24,43,1,30,67,27,7,8,23,2
S01013356,Rented or living rent free: Private rented or living rent free,24,19,17,9,8,1,1,5,2,0,2,0,1
S01013357,All HRPs aged 16 and over,346,245,205,27,178,26,14,101,73,1,8,16,3
S01013357,Owned: Total,258,186,159,14,145,24,3,72,67,0,0,4,1
S01013357,Owned: Owned outright,106,43,36,7,29,7,0,63,60,0,0,3,0
S01013357,Owned: Owned with a mortgage or loan or shared ownership,152,143,123,7,116,17,3,9,7,0,0,1,1
S01013357,Rented or living rent free: Total,88,59,46,13,33,2,11,29,6,1,8,12,2
S01013357,Rented or living rent free: Social rented,71,51,41,13,28,1,9,20,1,1,6,11,1
S01013357,Rented or living rent free: Private rented or living rent free,17,8,5,0,5,1,2,9,5,0,2,1,1
S01013358,All HRPs aged 16 and over,382,235,198,21,177,28,9,147,117,5,5,14,6
S01013358,Owned: Total,227,180,156,15,141,23,1,47,41,1,2,1,2
S01013358,Owned: Owned outright,84,45,38,8,30,7,0,39,35,1,0,1,2
S01013358,Owned: Owned with a mortgage or loan or shared ownership,143,135,118,7,111,16,1,8,6,0,2,0,0
S01013358,Rented or living rent free: Total,155,55,42,6,36,5,8,100,76,4,3,13,4
S01013358,Rented or living rent free: Social rented,121,35,24,5,19,4,7,86,68,3,2,10,3
S01013358,Rented or living rent free: Private rented or living rent free,34,20,18,1,17,1,1,14,8,1,1,3,1
S01013359,All HRPs aged 16 and over,298,173,145,37,108,15,13,125,77,6,9,24,9
S01013359,Owned: Total,130,92,78,13,65,14,0,38,34,0,0,2,2
S01013359,Owned: Owned outright,55,26,19,5,14,7,0,29,28,0,0,0,1
S01013359,Owned: Owned with a mortgage or loan or shared ownership,75,66,59,8,51,7,0,9,6,0,0,2,1
S01013359,Rented or living rent free: Total,168,81,67,24,43,1,13,87,43,6,9,22,7
S01013359,Rented or living rent free: Social rented,147,67,55,20,35,1,11,80,40,6,8,20,6
S01013359,Rented or living rent free: Private rented or living rent free,21,14,12,4,8,0,2,7,3,0,1,2,1
S01013360,All HRPs aged 16 and over,299,179,145,28,117,17,17,120,84,0,8,21,7
S01013360,Owned: Total,163,109,93,14,79,13,3,54,52,0,0,0,2
S01013360,Owned: Owned outright,66,26,23,6,17,1,2,40,38,0,0,0,2
S01013360,Owned: Owned with a mortgage or loan or shared ownership,97,83,70,8,62,12,1,14,14,0,0,0,0
S01013360,Rented or living rent free: Total,136,70,52,14,38,4,14,66,32,0,8,21,5
S01013360,Rented or living rent free: Social rented,113,56,42,12,30,4,10,57,28,0,5,20,4
S01013360,Rented or living rent free: Private rented or living rent free,23,14,10,2,8,0,4,9,4,0,3,1,1
S01013361,All HRPs aged 16 and over,280,170,146,28,118,8,16,110,69,4,1,30,6
S01013361,Owned: Total,102,77,71,10,61,5,1,25,24,0,0,1,0
S01013361,Owned: Owned outright,34,17,15,3,12,2,0,17,16,0,0,1,0
S01013361,Owned: Owned with a mortgage or loan or shared ownership,68,60,56,7,49,3,1,8,8,0,0,0,0
S01013361,Rented or living rent free: Total,178,93,75,18,57,3,15,85,45,4,1,29,6
S01013361,Rented or living rent free: Social rented,157,81,64,14,50,3,14,76,40,1,1,28,6
S01013361,Rented or living rent free: Private rented or living rent free,21,12,11,4,7,0,1,9,5,3,0,1,0
S01013362,All HRPs aged 16 and over,220,120,102,17,85,10,8,100,69,1,7,18,5
S01013362,Owned: Total,133,80,72,5,67,7,1,53,48,0,0,4,1
S01013362,Owned: Owned outright,65,22,18,2,16,4,0,43,42,0,0,1,0
S01013362,Owned: Owned with a mortgage or loan or shared ownership,68,58,54,3,51,3,1,10,6,0,0,3,1
S01013362,Rented or living rent free: Total,87,40,30,12,18,3,7,47,21,1,7,14,4
S01013362,Rented or living rent free: Social rented,71,31,21,7,14,3,7,40,18,1,4,13,4
S01013362,Rented or living rent free: Private rented or living rent free,16,9,9,5,4,0,0,7,3,0,3,1,0
S01013363,All HRPs aged 16 and over,390,230,183,35,148,13,34,160,84,11,10,35,20
S01013363,Owned: Total,133,83,78,11,67,5,0,50,48,0,0,2,0
S01013363,Owned: Owned outright,66,25,22,5,17,3,0,41,39,0,0,2,0
S01013363,Owned: Owned with a mortgage or loan or shared ownership,67,58,56,6,50,2,0,9,9,0,0,0,0
S01013363,Rented or living rent free: Total,257,147,105,24,81,8,34,110,36,11,10,33,20
S01013363,Rented or living rent free: Social rented,226,120,85,23,62,4,31,106,34,11,9,33,19
S01013363,Rented or living rent free: Private rented or living rent free,31,27,20,1,19,4,3,4,2,0,1,0,1
S01013364,All HRPs aged 16 and over,366,254,223,23,200,25,6,112,77,2,8,23,2
S01013364,Owned: Total,253,204,177,17,160,23,4,49,46,0,0,3,0
S01013364,Owned: Owned outright,83,44,35,7,28,7,2,39,37,0,0,2,0
S01013364,Owned: Owned with a mortgage or loan or shared ownership,170,160,142,10,132,16,2,10,9,0,0,1,0
S01013364,Rented or living rent free: Total,113,50,46,6,40,2,2,63,31,2,8,20,2
S01013364,Rented or living rent free: Social rented,98,37,35,5,30,1,1,61,31,2,8,18,2
S01013364,Rented or living rent free: Private rented or living rent free,15,13,11,1,10,1,1,2,0,0,0,2,0
S01013365,All HRPs aged 16 and over,367,281,225,27,198,39,17,86,68,2,7,7,2
S01013365,Owned: Total,296,233,194,23,171,35,4,63,59,1,1,2,0
S01013365,Owned: Owned outright,122,67,51,9,42,16,0,55,54,0,1,0,0
S01013365,Owned: Owned with a mortgage or loan or shared ownership,174,166,143,14,129,19,4,8,5,1,0,2,0
S01013365,Rented or living rent free: Total,71,48,31,4,27,4,13,23,9,1,6,5,2
S01013365,Rented or living rent free: Social rented,7,4,3,1,2,1,0,3,0,0,1,2,0
S01013365,Rented or living rent free: Private rented or living rent free,64,44,28,3,25,3,13,20,9,1,5,3,2
S01013366,All HRPs aged 16 and over,348,280,244,30,214,29,7,68,44,0,5,17,2
S01013366,Owned: Total,278,247,220,19,201,25,2,31,30,0,0,0,1
S01013366,Owned: Owned outright,77,53,46,12,34,6,1,24,24,0,0,0,0
S01013366,Owned: Owned with a mortgage or loan or shared ownership,201,194,174,7,167,19,1,7,6,0,0,0,1
S01013366,Rented or living rent free: Total,70,33,24,11,13,4,5,37,14,0,5,17,1
S01013366,Rented or living rent free: Social rented,54,21,17,10,7,2,2,33,11,0,5,17,0
S01013366,Rented or living rent free: Private rented or living rent free,16,12,7,1,6,2,3,4,3,0,0,0,1
S01013367,All HRPs aged 16 and over,221,178,150,6,144,27,1,43,29,0,1,10,3
S01013367,Owned: Total,172,157,133,5,128,23,1,15,12,0,1,2,0
S01013367,Owned: Owned outright,37,28,22,2,20,5,1,9,7,0,0,2,0
S01013367,Owned: Owned with a mortgage or loan or shared ownership,135,129,111,3,108,18,0,6,5,0,1,0,0
S01013367,Rented or living rent free: Total,49,21,17,1,16,4,0,28,17,0,0,8,3
S01013367,Rented or living rent free: Social rented,37,11,10,0,10,1,0,26,17,0,0,7,2
S01013367,Rented or living rent free: Private rented or living rent free,12,10,7,1,6,3,0,2,0,0,0,1,1
S01013368,All HRPs aged 16 and over,284,197,159,23,136,30,8,87,71,1,6,5,4
S01013368,Owned: Total,217,162,132,13,119,27,3,55,51,0,1,1,2
S01013368,Owned: Owned outright,84,44,34,6,28,9,1,40,38,0,0,1,1
S01013368,Owned: Owned with a mortgage or loan or shared ownership,133,118,98,7,91,18,2,15,13,0,1,0,1
S01013368,Rented or living rent free: Total,67,35,27,10,17,3,5,32,20,1,5,4,2
S01013368,Rented or living rent free: Social rented,45,22,17,4,13,3,2,23,15,1,3,3,1
S01013368,Rented or living rent free: Private rented or living rent free,22,13,10,6,4,0,3,9,5,0,2,1,1
S01013369,All HRPs aged 16 and over,420,221,195,46,149,12,14,199,133,0,21,30,15
S01013369,Owned: Total,181,120,109,16,93,9,2,61,55,0,2,2,2
S01013369,Owned: Owned outright,75,28,25,9,16,3,0,47,42,0,1,2,2
S01013369,Owned: Owned with a mortgage or loan or shared ownership,106,92,84,7,77,6,2,14,13,0,1,0,0
S01013369,Rented or living rent free: Total,239,101,86,30,56,3,12,138,78,0,19,28,13
S01013369,Rented or living rent free: Social rented,195,81,69,25,44,3,9,114,75,0,5,23,11
S01013369,Rented or living rent free: Private rented or living rent free,44,20,17,5,12,0,3,24,3,0,14,5,2
S01013370,All HRPs aged 16 and over,298,173,138,32,106,8,27,125,71,7,5,33,9
S01013370,Owned: Total,114,73,64,11,53,6,3,41,40,0,0,1,0
S01013370,Owned: Owned outright,49,12,10,3,7,1,1,37,36,0,0,1,0
S01013370,Owned: Owned with a mortgage or loan or shared ownership,65,61,54,8,46,5,2,4,4,0,0,0,0
S01013370,Rented or living rent free: Total,184,100,74,21,53,2,24,84,31,7,5,32,9
S01013370,Rented or living rent free: Social rented,175,93,69,20,49,2,22,82,30,7,4,32,9
S01013370,Rented or living rent free: Private rented or living rent free,9,7,5,1,4,0,2,2,1,0,1,0,0
S01013371,All HRPs aged 16 and over,327,149,126,22,104,13,10,178,154,1,9,8,6
S01013371,Owned: Total,171,91,79,8,71,10,2,80,79,0,0,1,0
S01013371,Owned: Owned outright,102,31,27,6,21,3,1,71,71,0,0,0,0
S01013371,Owned: Owned with a mortgage or loan or shared ownership,69,60,52,2,50,7,1,9,8,0,0,1,0
S01013371,Rented or living rent free: Total,156,58,47,14,33,3,8,98,75,1,9,7,6
S01013371,Rented or living rent free: Social rented,130,48,39,11,28,2,7,82,63,1,7,6,5
S01013371,Rented or living rent free: Private rented or living rent free,26,10,8,3,5,1,1,16,12,0,2,1,1
S01013372,All HRPs aged 16 and over,489,297,225,55,170,17,55,192,107,11,17,42,15
S01013372,Owned: Total,147,95,87,8,79,6,2,52,50,0,0,0,2
S01013372,Owned: Owned outright,60,18,15,4,11,1,2,42,40,0,0,0,2
S01013372,Owned: Owned with a mortgage or loan or shared ownership,87,77,72,4,68,5,0,10,10,0,0,0,0
S01013372,Rented or living rent free: Total,342,202,138,47,91,11,53,140,57,11,17,42,13
S01013372,Rented or living rent free: Social rented,317,185,127,43,84,11,47,132,55,10,15,41,11
S01013372,Rented or living rent free: Private rented or living rent free,25,17,11,4,7,0,6,8,2,1,2,1,2
S01013373,All HRPs aged 16 and over,451,260,211,34,177,18,31,191,124,8,13,33,13
S01013373,Owned: Total,230,137,122,8,114,13,2,93,87,0,1,4,1
S01013373,Owned: Owned outright,98,33,31,5,26,2,0,65,63,0,0,2,0
S01013373,Owned: Owned with a mortgage or loan or shared ownership,132,104,91,3,88,11,2,28,24,0,1,2,1
S01013373,Rented or living rent free: Total,221,123,89,26,63,5,29,98,37,8,12,29,12
S01013373,Rented or living rent free: Social rented,181,102,73,20,53,3,26,79,30,5,7,26,11
S01013373,Rented or living rent free: Private rented or living rent free,40,21,16,6,10,2,3,19,7,3,5,3,1
S01013374,All HRPs aged 16 and over,453,246,188,54,134,20,38,207,133,1,16,41,16
S01013374,Owned: Total,140,89,72,9,63,14,3,51,45,0,1,1,4
S01013374,Owned: Owned outright,67,25,20,4,16,3,2,42,38,0,1,0,3
S01013374,Owned: Owned with a mortgage or loan or shared ownership,73,64,52,5,47,11,1,9,7,0,0,1,1
S01013374,Rented or living rent free: Total,313,157,116,45,71,6,35,156,88,1,15,40,12
S01013374,Rented or living rent free: Social rented,240,120,94,35,59,3,23,120,68,1,7,35,9
S01013374,Rented or living rent free: Private rented or living rent free,73,37,22,10,12,3,12,36,20,0,8,5,3
S01013375,All HRPs aged 16 and over,262,169,139,29,110,12,18,93,70,1,3,16,3
S01013375,Owned: Total,146,99,89,15,74,10,0,47,44,0,0,2,1
S01013375,Owned: Owned outright,66,30,24,7,17,6,0,36,34,0,0,1,1
S01013375,Owned: Owned with a mortgage or loan or shared ownership,80,69,65,8,57,4,0,11,10,0,0,1,0
S01013375,Rented or living rent free: Total,116,70,50,14,36,2,18,46,26,1,3,14,2
S01013375,Rented or living rent free: Social rented,96,55,42,11,31,1,12,41,21,1,3,14,2
S01013375,Rented or living rent free: Private rented or living rent free,20,15,8,3,5,1,6,5,5,0,0,0,0
S01013376,All HRPs aged 16 and over,272,150,119,25,94,16,15,122,93,1,9,12,7
S01013376,Owned: Total,146,89,72,10,62,14,3,57,51,1,0,3,2
S01013376,Owned: Owned outright,62,26,19,4,15,4,3,36,34,0,0,2,0
S01013376,Owned: Owned with a mortgage or loan or shared ownership,84,63,53,6,47,10,0,21,17,1,0,1,2
S01013376,Rented or living rent free: Total,126,61,47,15,32,2,12,65,42,0,9,9,5
S01013376,Rented or living rent free: Social rented,85,40,33,10,23,1,6,45,32,0,3,8,2
S01013376,Rented or living rent free: Private rented or living rent free,41,21,14,5,9,1,6,20,10,0,6,1,3
S01013377,All HRPs aged 16 and over,377,202,170,29,141,10,22,175,137,0,8,21,9
S01013377,Owned: Total,221,126,115,13,102,10,1,95,90,0,0,3,2
S01013377,Owned: Owned outright,108,39,34,5,29,5,0,69,68,0,0,0,1
S01013377,Owned: Owned with a mortgage or loan or shared ownership,113,87,81,8,73,5,1,26,22,0,0,3,1
S01013377,Rented or living rent free: Total,156,76,55,16,39,0,21,80,47,0,8,18,7
S01013377,Rented or living rent free: Social rented,115,55,41,12,29,0,14,60,36,0,4,15,5
S01013377,Rented or living rent free: Private rented or living rent free,41,21,14,4,10,0,7,20,11,0,4,3,2
S01013378,All HRPs aged 16 and over,426,289,228,38,190,23,38,137,93,11,11,17,5
S01013378,Owned: Total,237,181,158,15,143,20,3,56,54,0,1,1,0
S01013378,Owned: Owned outright,97,47,37,8,29,10,0,50,48,0,1,1,0
S01013378,Owned: Owned with a mortgage or loan or shared ownership,140,134,121,7,114,10,3,6,6,0,0,0,0
S01013378,Rented or living rent free: Total,189,108,70,23,47,3,35,81,39,11,10,16,5
S01013378,Rented or living rent free: Social rented,163,94,63,21,42,2,29,69,34,11,7,14,3
S01013378,Rented or living rent free: Private rented or living rent free,26,14,7,2,5,1,6,12,5,0,3,2,2
S01013379,All HRPs aged 16 and over,345,226,196,27,169,20,10,119,90,0,9,16,4
S01013379,Owned: Total,225,165,146,14,132,17,2,60,58,0,0,1,1
S01013379,Owned: Owned outright,84,34,30,9,21,4,0,50,48,0,0,1,1
S01013379,Owned: Owned with a mortgage or loan or shared ownership,141,131,116,5,111,13,2,10,10,0,0,0,0
S01013379,Rented or living rent free: Total,120,61,50,13,37,3,8,59,32,0,9,15,3
S01013379,Rented or living rent free: Social rented,93,46,40,11,29,2,4,47,30,0,3,13,1
S01013379,Rented or living rent free: Private rented or living rent free,27,15,10,2,8,1,4,12,2,0,6,2,2
S01013380,All HRPs aged 16 and over,36,21,14,0,14,7,0,15,13,0,0,2,0
S01013380,Owned: Total,27,18,12,0,12,6,0,9,8,0,0,1,0
S01013380,Owned: Owned outright,20,13,8,0,8,5,0,7,7,0,0,0,0
S01013380,Owned: Owned with a mortgage or loan or shared ownership,7,5,4,0,4,1,0,2,1,0,0,1,0
S01013380,Rented or living rent free: Total,9,3,2,0,2,1,0,6,5,0,0,1,0
S01013380,Rented or living rent free: Social rented,3,1,1,0,1,0,0,2,1,0,0,1,0
S01013380,Rented or living rent free: Private rented or living rent free,6,2,1,0,1,1,0,4,4,0,0,0,0
S01013381,All HRPs aged 16 and over,211,131,102,14,88,15,14,80,65,0,4,7,4
S01013381,Owned: Total,130,92,78,8,70,11,3,38,35,0,0,2,1
S01013381,Owned: Owned outright,60,26,24,2,22,2,0,34,33,0,0,1,0
S01013381,Owned: Owned with a mortgage or loan or shared ownership,70,66,54,6,48,9,3,4,2,0,0,1,1
S01013381,Rented or living rent free: Total,81,39,24,6,18,4,11,42,30,0,4,5,3
S01013381,Rented or living rent free: Social rented,73,34,21,6,15,3,10,39,27,0,4,5,3
S01013381,Rented or living rent free: Private rented or living rent free,8,5,3,0,3,1,1,3,3,0,0,0,0
S01013382,All HRPs aged 16 and over,225,167,146,18,128,17,4,58,47,0,1,8,2
S01013382,Owned: Total,174,143,128,11,117,15,0,31,30,0,0,0,1
S01013382,Owned: Owned outright,51,25,23,6,17,2,0,26,25,0,0,0,1
S01013382,Owned: Owned with a mortgage or loan or shared ownership,123,118,105,5,100,13,0,5,5,0,0,0,0
S01013382,Rented or living rent free: Total,51,24,18,7,11,2,4,27,17,0,1,8,1
S01013382,Rented or living rent free: Social rented,39,15,11,3,8,0,4,24,15,0,1,7,1
S01013382,Rented or living rent free: Private rented or living rent free,12,9,7,4,3,2,0,3,2,0,0,1,0
S01013383,All HRPs aged 16 and over,353,184,156,21,135,10,18,169,128,4,5,27,5
S01013383,Owned: Total,155,100,92,9,83,7,1,55,49,0,1,4,1
S01013383,Owned: Owned outright,57,19,18,3,15,0,1,38,36,0,0,1,1
S01013383,Owned: Owned with a mortgage or loan or shared ownership,98,81,74,6,68,7,0,17,13,0,1,3,0
S01013383,Rented or living rent free: Total,198,84,64,12,52,3,17,114,79,4,4,23,4
S01013383,Rented or living rent free: Social rented,169,68,53,9,44,3,12,101,73,2,2,20,4
S01013383,Rented or living rent free: Private rented or living rent free,29,16,11,3,8,0,5,13,6,2,2,3,0
S01013384,All HRPs aged 16 and over,337,180,153,14,139,18,9,157,127,0,7,21,2
S01013384,Owned: Total,180,123,108,6,102,13,2,57,52,0,0,4,1
S01013384,Owned: Owned outright,67,20,18,1,17,2,0,47,45,0,0,2,0
S01013384,Owned: Owned with a mortgage or loan or shared ownership,113,103,90,5,85,11,2,10,7,0,0,2,1
S01013384,Rented or living rent free: Total,157,57,45,8,37,5,7,100,75,0,7,17,1
S01013384,Rented or living rent free: Social rented,123,39,30,6,24,4,5,84,65,0,6,13,0
S01013384,Rented or living rent free: Private rented or living rent free,34,18,15,2,13,1,2,16,10,0,1,4,1
S01013385,All HRPs aged 16 and over,217,153,133,17,116,13,7,64,54,0,1,9,0
S01013385,Owned: Total,160,118,101,8,93,13,4,42,42,0,0,0,0
S01013385,Owned: Owned outright,69,34,25,4,21,7,2,35,35,0,0,0,0
S01013385,Owned: Owned with a mortgage or loan or shared ownership,91,84,76,4,72,6,2,7,7,0,0,0,0
S01013385,Rented or living rent free: Total,57,35,32,9,23,0,3,22,12,0,1,9,0
S01013385,Rented or living rent free: Social rented,40,23,21,6,15,0,2,17,8,0,1,8,0
S01013385,Rented or living rent free: Private rented or living rent free,17,12,11,3,8,0,1,5,4,0,0,1,0
S01013386,All HRPs aged 16 and over,335,245,210,14,196,28,7,90,77,1,1,5,6
S01013386,Owned: Total,291,221,192,9,183,28,1,70,70,0,0,0,0
S01013386,Owned: Owned outright,118,57,51,9,42,5,1,61,61,0,0,0,0
S01013386,Owned: Owned with a mortgage or loan or shared ownership,173,164,141,0,141,23,0,9,9,0,0,0,0
S01013386,Rented or living rent free: Total,44,24,18,5,13,0,6,20,7,1,1,5,6
S01013386,Rented or living rent free: Social rented,36,19,13,4,9,0,6,17,6,1,0,4,6
S01013386,Rented or living rent free: Private rented or living rent free,8,5,5,1,4,0,0,3,1,0,1,1,0
S01013387,All HRPs aged 16 and over,265,152,120,18,102,13,19,113,87,1,8,14,3
S01013387,Owned: Total,138,90,79,9,70,8,3,48,47,0,0,1,0
S01013387,Owned: Owned outright,55,17,15,4,11,2,0,38,38,0,0,0,0
S01013387,Owned: Owned with a mortgage or loan or shared ownership,83,73,64,5,59,6,3,10,9,0,0,1,0
S01013387,Rented or living rent free: Total,127,62,41,9,32,5,16,65,40,1,8,13,3
S01013387,Rented or living rent free: Social rented,118,56,38,7,31,5,13,62,39,1,6,13,3
S01013387,Rented or living rent free: Private rented or living rent free,9,6,3,2,1,0,3,3,1,0,2,0,0
S01013388,All HRPs aged 16 and over,382,207,165,31,134,28,14,175,144,3,2,20,6
S01013388,Owned: Total,224,140,117,14,103,22,1,84,75,2,0,6,1
S01013388,Owned: Owned outright,101,29,23,7,16,6,0,72,66,0,0,6,0
S01013388,Owned: Owned with a mortgage or loan or shared ownership,123,111,94,7,87,16,1,12,9,2,0,0,1
S01013388,Rented or living rent free: Total,158,67,48,17,31,6,13,91,69,1,2,14,5
S01013388,Rented or living rent free: Social rented,116,38,28,9,19,2,8,78,66,0,0,10,2
S01013388,Rented or living rent free: Private rented or living rent free,42,29,20,8,12,4,5,13,3,1,2,4,3
S01013389,All HRPs aged 16 and over,347,255,217,25,192,19,19,92,71,3,4,13,1
S01013389,Owned: Total,219,175,158,11,147,15,2,44,41,0,0,2,1
S01013389,Owned: Owned outright,68,30,30,4,26,0,0,38,35,0,0,2,1
S01013389,Owned: Owned with a mortgage or loan or shared ownership,151,145,128,7,121,15,2,6,6,0,0,0,0
S01013389,Rented or living rent free: Total,128,80,59,14,45,4,17,48,30,3,4,11,0
S01013389,Rented or living rent free: Social rented,98,58,44,10,34,3,11,40,27,2,2,9,0
S01013389,Rented or living rent free: Private rented or living rent free,30,22,15,4,11,1,6,8,3,1,2,2,0
S01013390,All HRPs aged 16 and over,210,133,112,12,100,15,6,77,57,0,1,12,7
S01013390,Owned: Total,137,96,83,6,77,11,2,41,35,0,0,4,2
S01013390,Owned: Owned outright,48,22,18,4,14,4,0,26,25,0,0,1,0
S01013390,Owned: Owned with a mortgage or loan or shared ownership,89,74,65,2,63,7,2,15,10,0,0,3,2
S01013390,Rented or living rent free: Total,73,37,29,6,23,4,4,36,22,0,1,8,5
S01013390,Rented or living rent free: Social rented,60,27,23,5,18,2,2,33,20,0,1,8,4
S01013390,Rented or living rent free: Private rented or living rent free,13,10,6,1,5,2,2,3,2,0,0,0,1
S01013391,All HRPs aged 16 and over,173,108,87,14,73,19,2,65,56,0,1,5,3
S01013391,Owned: Total,126,84,65,7,58,18,1,42,40,0,0,1,1
S01013391,Owned: Owned outright,57,20,15,2,13,4,1,37,35,0,0,1,1
S01013391,Owned: Owned with a mortgage or loan or shared ownership,69,64,50,5,45,14,0,5,5,0,0,0,0
S01013391,Rented or living rent free: Total,47,24,22,7,15,1,1,23,16,0,1,4,2
S01013391,Rented or living rent free: Social rented,31,16,14,4,10,1,1,15,11,0,0,2,2
S01013391,Rented or living rent free: Private rented or living rent free,16,8,8,3,5,0,0,8,5,0,1,2,0
S01013392,All HRPs aged 16 and over,270,252,219,10,209,32,1,18,12,3,2,1,0
S01013392,Owned: Total,240,225,196,8,188,29,0,15,12,3,0,0,0
S01013392,Owned: Owned outright,31,22,20,1,19,2,0,9,9,0,0,0,0
S01013392,Owned: Owned with a mortgage or loan or shared ownership,209,203,176,7,169,27,0,6,3,3,0,0,0
S01013392,Rented or living rent free: Total,30,27,23,2,21,3,1,3,0,0,2,1,0
S01013392,Rented or living rent free: Social rented,3,1,1,0,1,0,0,2,0,0,1,1,0
S01013392,Rented or living rent free: Private rented or living rent free,27,26,22,2,20,3,1,1,0,0,1,0,0
S01013393,All HRPs aged 16 and over,324,197,154,24,130,22,21,127,93,3,8,19,4
S01013393,Owned: Total,163,125,106,10,96,18,1,38,33,1,0,3,1
S01013393,Owned: Owned outright,59,28,25,5,20,3,0,31,30,0,0,1,0
S01013393,Owned: Owned with a mortgage or loan or shared ownership,104,97,81,5,76,15,1,7,3,1,0,2,1
S01013393,Rented or living rent free: Total,161,72,48,14,34,4,20,89,60,2,8,16,3
S01013393,Rented or living rent free: Social rented,135,56,36,13,23,3,17,79,56,1,6,14,2
S01013393,Rented or living rent free: Private rented or living rent free,26,16,12,1,11,1,3,10,4,1,2,2,1
S01013394,All HRPs aged 16 and over,288,169,139,28,111,14,16,119,63,2,17,30,7
S01013394,Owned: Total,140,96,89,9,80,7,0,44,39,0,1,4,0
S01013394,Owned: Owned outright,52,15,14,2,12,1,0,37,34,0,0,3,0
S01013394,Owned: Owned with a mortgage or loan or shared ownership,88,81,75,7,68,6,0,7,5,0,1,1,0
S01013394,Rented or living rent free: Total,148,73,50,19,31,7,16,75,24,2,16,26,7
S01013394,Rented or living rent free: Social rented,127,63,43,15,28,4,16,64,20,2,14,21,7
S01013394,Rented or living rent free: Private rented or living rent free,21,10,7,4,3,3,0,11,4,0,2,5,0
S01013395,All HRPs aged 16 and over,352,220,158,42,116,12,50,132,51,2,27,40,12
S01013395,Owned: Total,73,55,48,6,42,6,1,18,13,0,0,4,1
S01013395,Owned: Owned outright,22,5,3,1,2,2,0,17,13,0,0,3,1
S01013395,Owned: Owned with a mortgage or loan or shared ownership,51,50,45,5,40,4,1,1,0,0,0,1,0
S01013395,Rented or living rent free: Total,279,165,110,36,74,6,49,114,38,2,27,36,11
S01013395,Rented or living rent free: Social rented,257,151,102,35,67,4,45,106,37,1,26,32,10
S01013395,Rented or living rent free: Private rented or living rent free,22,14,8,1,7,2,4,8,1,1,1,4,1
S01013396,All HRPs aged 16 and over,255,244,205,8,197,35,4,11,6,2,1,2,0
S01013396,Owned: Total,224,215,182,5,177,32,1,9,5,2,0,2,0
S01013396,Owned: Owned outright,8,4,3,0,3,1,0,4,2,2,0,0,0
S01013396,Owned: Owned with a mortgage or loan or shared ownership,216,211,179,5,174,31,1,5,3,0,0,2,0
S01013396,Rented or living rent free: Total,31,29,23,3,20,3,3,2,1,0,1,0,0
S01013396,Rented or living rent free: Social rented,5,4,3,0,3,1,0,1,1,0,0,0,0
S01013396,Rented or living rent free: Private rented or living rent free,26,25,20,3,17,2,3,1,0,0,1,0,0
S01013397,All HRPs aged 16 and over,376,246,206,29,177,32,8,130,85,2,10,30,3
S01013397,Owned: Total,232,181,153,13,140,28,0,51,47,0,0,4,0
S01013397,Owned: Owned outright,66,27,22,5,17,5,0,39,37,0,0,2,0
S01013397,Owned: Owned with a mortgage or loan or shared ownership,166,154,131,8,123,23,0,12,10,0,0,2,0
S01013397,Rented or living rent free: Total,144,65,53,16,37,4,8,79,38,2,10,26,3
S01013397,Rented or living rent free: Social rented,115,51,45,14,31,0,6,64,34,2,8,19,1
S01013397,Rented or living rent free: Private rented or living rent free,29,14,8,2,6,4,2,15,4,0,2,7,2
S01013398,All HRPs aged 16 and over,183,167,151,10,141,15,1,16,15,0,0,1,0
S01013398,Owned: Total,170,158,145,9,136,12,1,12,12,0,0,0,0
S01013398,Owned: Owned outright,29,18,17,3,14,1,0,11,11,0,0,0,0
S01013398,Owned: Owned with a mortgage or loan or shared ownership,141,140,128,6,122,11,1,1,1,0,0,0,0
S01013398,Rented or living rent free: Total,13,9,6,1,5,3,0,4,3,0,0,1,0
S01013398,Rented or living rent free: Social rented,8,5,4,1,3,1,0,3,2,0,0,1,0
S01013398,Rented or living rent free: Private rented or living rent free,5,4,2,0,2,2,0,1,1,0,0,0,0
S01013399,All HRPs aged 16 and over,399,327,292,30,262,27,8,72,56,1,2,12,1
S01013399,Owned: Total,332,291,260,20,240,25,6,41,39,0,0,1,1
S01013399,Owned: Owned outright,58,26,25,5,20,1,0,32,31,0,0,0,1
S01013399,Owned: Owned with a mortgage or loan or shared ownership,274,265,235,15,220,24,6,9,8,0,0,1,0
S01013399,Rented or living rent free: Total,67,36,32,10,22,2,2,31,17,1,2,11,0
S01013399,Rented or living rent free: Social rented,43,16,15,6,9,0,1,27,16,0,1,10,0
S01013399,Rented or living rent free: Private rented or living rent free,24,20,17,4,13,2,1,4,1,1,1,1,0
S01013400,All HRPs aged 16 and over,314,227,191,19,172,21,15,87,57,1,8,12,9
S01013400,Owned: Total,171,135,118,12,106,15,2,36,34,0,0,0,2
S01013400,Owned: Owned outright,58,28,26,4,22,2,0,30,30,0,0,0,0
S01013400,Owned: Owned with a mortgage or loan or shared ownership,113,107,92,8,84,13,2,6,4,0,0,0,2
S01013400,Rented or living rent free: Total,143,92,73,7,66,6,13,51,23,1,8,12,7
S01013400,Rented or living rent free: Social rented,88,45,35,5,30,3,7,43,22,1,4,10,6
S01013400,Rented or living rent free: Private rented or living rent free,55,47,38,2,36,3,6,8,1,0,4,2,1
S01013401,All HRPs aged 16 and over,324,288,241,16,225,35,12,36,12,1,11,10,2
S01013401,Owned: Total,257,240,207,10,197,31,2,17,11,0,1,3,2
S01013401,Owned: Owned outright,33,20,15,5,10,5,0,13,11,0,0,2,0
S01013401,Owned: Owned with a mortgage or loan or shared ownership,224,220,192,5,187,26,2,4,0,0,1,1,2
S01013401,Rented or living rent free: Total,67,48,34,6,28,4,10,19,1,1,10,7,0
S01013401,Rented or living rent free: Social rented,36,23,17,3,14,0,6,13,0,0,7,6,0
S01013401,Rented or living rent free: Private rented or living rent free,31,25,17,3,14,4,4,6,1,1,3,1,0
S01013402,All HRPs aged 16 and over,429,409,369,19,350,28,12,20,9,0,5,4,2
S01013402,Owned: Total,343,337,309,11,298,24,4,6,6,0,0,0,0
S01013402,Owned: Owned outright,23,19,16,2,14,3,0,4,4,0,0,0,0
S01013402,Owned: Owned with a mortgage or loan or shared ownership,320,318,293,9,284,21,4,2,2,0,0,0,0
S01013402,Rented or living rent free: Total,86,72,60,8,52,4,8,14,3,0,5,4,2
S01013402,Rented or living rent free: Social rented,5,1,0,0,0,0,1,4,1,0,1,1,1
S01013402,Rented or living rent free: Private rented or living rent free,81,71,60,8,52,4,7,10,2,0,4,3,1
S01013403,All HRPs aged 16 and over,332,304,272,15,257,26,6,28,14,2,5,3,4
S01013403,Owned: Total,240,229,206,5,201,22,1,11,11,0,0,0,0
S01013403,Owned: Owned outright,17,11,10,1,9,1,0,6,6,0,0,0,0
S01013403,Owned: Owned with a mortgage or loan or shared ownership,223,218,196,4,192,21,1,5,5,0,0,0,0
S01013403,Rented or living rent free: Total,92,75,66,10,56,4,5,17,3,2,5,3,4
S01013403,Rented or living rent free: Social rented,26,15,9,3,6,3,3,11,2,1,3,1,4
S01013403,Rented or living rent free: Private rented or living rent free,66,60,57,7,50,1,2,6,1,1,2,2,0
S01013404,All HRPs aged 16 and over,211,186,166,24,142,14,6,25,11,1,7,5,1
S01013404,Owned: Total,135,129,118,11,107,11,0,6,5,0,0,1,0
S01013404,Owned: Owned outright,14,9,9,2,7,0,0,5,4,0,0,1,0
S01013404,Owned: Owned with a mortgage or loan or shared ownership,121,120,109,9,100,11,0,1,1,0,0,0,0
S01013404,Rented or living rent free: Total,76,57,48,13,35,3,6,19,6,1,7,4,1
S01013404,Rented or living rent free: Social rented,35,17,12,6,6,1,4,18,6,1,6,4,1
S01013404,Rented or living rent free: Private rented or living rent free,41,40,36,7,29,2,2,1,0,0,1,0,0
S01013405,All HRPs aged 16 and over,329,196,160,22,138,17,19,133,116,1,4,11,1
S01013405,Owned: Total,214,125,109,12,97,15,1,89,89,0,0,0,0
S01013405,Owned: Owned outright,114,31,27,10,17,4,0,83,83,0,0,0,0
S01013405,Owned: Owned with a mortgage or loan or shared ownership,100,94,82,2,80,11,1,6,6,0,0,0,0
S01013405,Rented or living rent free: Total,115,71,51,10,41,2,18,44,27,1,4,11,1
S01013405,Rented or living rent free: Social rented,77,45,29,9,20,2,14,32,20,0,3,8,1
S01013405,Rented or living rent free: Private rented or living rent free,38,26,22,1,21,0,4,12,7,1,1,3,0
S01013406,All HRPs aged 16 and over,270,164,138,30,108,9,17,106,73,0,5,17,11
S01013406,Owned: Total,120,80,76,10,66,3,1,40,37,0,0,2,1
S01013406,Owned: Owned outright,42,10,9,5,4,1,0,32,30,0,0,2,0
S01013406,Owned: Owned with a mortgage or loan or shared ownership,78,70,67,5,62,2,1,8,7,0,0,0,1
S01013406,Rented or living rent free: Total,150,84,62,20,42,6,16,66,36,0,5,15,10
S01013406,Rented or living rent free: Social rented,124,65,50,20,30,2,13,59,34,0,3,13,9
S01013406,Rented or living rent free: Private rented or living rent free,26,19,12,0,12,4,3,7,2,0,2,2,1
S01013407,All HRPs aged 16 and over,259,150,130,21,109,9,11,109,76,7,5,17,4
S01013407,Owned: Total,135,84,75,8,67,8,1,51,47,0,0,1,3
S01013407,Owned: Owned outright,56,19,16,2,14,2,1,37,33,0,0,1,3
S01013407,Owned: Owned with a mortgage or loan or shared ownership,79,65,59,6,53,6,0,14,14,0,0,0,0
S01013407,Rented or living rent free: Total,124,66,55,13,42,1,10,58,29,7,5,16,1
S01013407,Rented or living rent free: Social rented,98,53,44,11,33,0,9,45,24,2,5,13,1
S01013407,Rented or living rent free: Private rented or living rent free,26,13,11,2,9,1,1,13,5,5,0,3,0
S01013408,All HRPs aged 16 and over,302,174,140,32,108,13,21,128,98,1,13,10,6
S01013408,Owned: Total,119,75,71,11,60,3,1,44,41,0,1,1,1
S01013408,Owned: Owned outright,40,8,6,3,3,1,1,32,32,0,0,0,0
S01013408,Owned: Owned with a mortgage or loan or shared ownership,79,67,65,8,57,2,0,12,9,0,1,1,1
S01013408,Rented or living rent free: Total,183,99,69,21,48,10,20,84,57,1,12,9,5
S01013408,Rented or living rent free: Social rented,151,76,52,14,38,7,17,75,54,1,9,7,4
S01013408,Rented or living rent free: Private rented or living rent free,32,23,17,7,10,3,3,9,3,0,3,2,1
S01013409,All HRPs aged 16 and over,428,316,256,35,221,39,21,112,81,4,8,14,5
S01013409,Owned: Total,242,184,150,11,139,33,1,58,56,0,0,2,0
S01013409,Owned: Owned outright,79,30,24,5,19,6,0,49,47,0,0,2,0
S01013409,Owned: Owned with a mortgage or loan or shared ownership,163,154,126,6,120,27,1,9,9,0,0,0,0
S01013409,Rented or living rent free: Total,186,132,106,24,82,6,20,54,25,4,8,12,5
S01013409,Rented or living rent free: Social rented,135,97,78,20,58,4,15,38,19,2,5,8,4
S01013409,Rented or living rent free: Private rented or living rent free,51,35,28,4,24,2,5,16,6,2,3,4,1
S01013410,All HRPs aged 16 and over,290,214,168,46,122,12,34,76,28,1,15,25,7
S01013410,Owned: Total,56,43,42,1,41,1,0,13,11,0,1,0,1
S01013410,Owned: Owned outright,16,6,5,0,5,1,0,10,9,0,0,0,1
S01013410,Owned: Owned with a mortgage or loan or shared ownership,40,37,37,1,36,0,0,3,2,0,1,0,0
S01013410,Rented or living rent free: Total,234,171,126,45,81,11,34,63,17,1,14,25,6
S01013410,Rented or living rent free: Social rented,217,158,116,41,75,10,32,59,15,1,12,25,6
S01013410,Rented or living rent free: Private rented or living rent free,17,13,10,4,6,1,2,4,2,0,2,0,0
S01013411,All HRPs aged 16 and over,333,238,206,26,180,22,10,95,66,1,4,20,4
S01013411,Owned: Total,191,137,116,11,105,20,1,54,52,0,0,2,0
S01013411,Owned: Owned outright,80,31,26,5,21,5,0,49,48,0,0,1,0
S01013411,Owned: Owned with a mortgage or loan or shared ownership,111,106,90,6,84,15,1,5,4,0,0,1,0
S01013411,Rented or living rent free: Total,142,101,90,15,75,2,9,41,14,1,4,18,4
S01013411,Rented or living rent free: Social rented,64,36,30,10,20,0,6,28,6,0,2,16,4
S01013411,Rented or living rent free: Private rented or living rent free,78,65,60,5,55,2,3,13,8,1,2,2,0
S01013412,All HRPs aged 16 and over,364,243,201,39,162,21,21,121,76,0,7,32,6
S01013412,Owned: Total,209,156,137,17,120,17,2,53,47,0,3,3,0
S01013412,Owned: Owned outright,71,28,26,8,18,1,1,43,42,0,0,1,0
S01013412,Owned: Owned with a mortgage or loan or shared ownership,138,128,111,9,102,16,1,10,5,0,3,2,0
S01013412,Rented or living rent free: Total,155,87,64,22,42,4,19,68,29,0,4,29,6
S01013412,Rented or living rent free: Social rented,115,58,39,18,21,3,16,57,23,0,3,28,3
S01013412,Rented or living rent free: Private rented or living rent free,40,29,25,4,21,1,3,11,6,0,1,1,3
S01013413,All HRPs aged 16 and over,336,212,189,18,171,19,4,124,112,1,4,6,1
S01013413,Owned: Total,230,170,155,14,141,15,0,60,53,0,3,4,0
S01013413,Owned: Owned outright,84,37,33,6,27,4,0,47,45,0,0,2,0
S01013413,Owned: Owned with a mortgage or loan or shared ownership,146,133,122,8,114,11,0,13,8,0,3,2,0
S01013413,Rented or living rent free: Total,106,42,34,4,30,4,4,64,59,1,1,2,1
S01013413,Rented or living rent free: Social rented,68,15,13,4,9,1,1,53,51,0,1,1,0
S01013413,Rented or living rent free: Private rented or living rent free,38,27,21,0,21,3,3,11,8,1,0,1,1
S01013414,All HRPs aged 16 and over,484,272,223,27,196,23,26,212,175,0,4,28,5
S01013414,Owned: Total,199,118,100,7,93,17,1,81,80,0,0,1,0
S01013414,Owned: Owned outright,85,26,21,4,17,5,0,59,58,0,0,1,0
S01013414,Owned: Owned with a mortgage or loan or shared ownership,114,92,79,3,76,12,1,22,22,0,0,0,0
S01013414,Rented or living rent free: Total,285,154,123,20,103,6,25,131,95,0,4,27,5
S01013414,Rented or living rent free: Social rented,138,33,23,3,20,1,9,105,80,0,3,18,4
S01013414,Rented or living rent free: Private rented or living rent free,147,121,100,17,83,5,16,26,15,0,1,9,1
S01013415,All HRPs aged 16 and over,385,185,145,28,117,16,24,200,133,0,10,53,4
S01013415,Owned: Total,119,80,64,5,59,11,5,39,33,0,1,3,2
S01013415,Owned: Owned outright,47,19,13,3,10,4,2,28,25,0,0,2,1
S01013415,Owned: Owned with a mortgage or loan or shared ownership,72,61,51,2,49,7,3,11,8,0,1,1,1
S01013415,Rented or living rent free: Total,266,105,81,23,58,5,19,161,100,0,9,50,2
S01013415,Rented or living rent free: Social rented,223,77,59,19,40,3,15,146,93,0,4,47,2
S01013415,Rented or living rent free: Private rented or living rent free,43,28,22,4,18,2,4,15,7,0,5,3,0
S01013416,All HRPs aged 16 and over,276,174,143,18,125,14,17,102,60,1,8,26,7
S01013416,Owned: Total,128,92,81,7,74,8,3,36,30,0,0,3,3
S01013416,Owned: Owned outright,41,16,14,3,11,2,0,25,22,0,0,2,1
S01013416,Owned: Owned with a mortgage or loan or shared ownership,87,76,67,4,63,6,3,11,8,0,0,1,2
S01013416,Rented or living rent free: Total,148,82,62,11,51,6,14,66,30,1,8,23,4
S01013416,Rented or living rent free: Social rented,124,61,47,11,36,4,10,63,29,1,6,23,4
S01013416,Rented or living rent free: Private rented or living rent free,24,21,15,0,15,2,4,3,1,0,2,0,0
S01013417,All HRPs aged 16 and over,442,294,250,28,222,20,24,148,107,1,3,29,8
S01013417,Owned: Total,190,128,111,12,99,15,2,62,57,0,0,3,2
S01013417,Owned: Owned outright,80,28,23,6,17,5,0,52,50,0,0,2,0
S01013417,Owned: Owned with a mortgage or loan or shared ownership,110,100,88,6,82,10,2,10,7,0,0,1,2
S01013417,Rented or living rent free: Total,252,166,139,16,123,5,22,86,50,1,3,26,6
S01013417,Rented or living rent free: Social rented,155,86,68,11,57,2,16,69,38,0,3,22,6
S01013417,Rented or living rent free: Private rented or living rent free,97,80,71,5,66,3,6,17,12,1,0,4,0
S01013418,All HRPs aged 16 and over,256,170,145,16,129,18,7,86,60,0,4,15,7
S01013418,Owned: Total,147,104,91,4,87,13,0,43,41,0,0,1,1
S01013418,Owned: Owned outright,56,22,18,1,17,4,0,34,33,0,0,0,1
S01013418,Owned: Owned with a mortgage or loan or shared ownership,91,82,73,3,70,9,0,9,8,0,0,1,0
S01013418,Rented or living rent free: Total,109,66,54,12,42,5,7,43,19,0,4,14,6
S01013418,Rented or living rent free: Social rented,80,45,35,9,26,4,6,35,17,0,3,11,4
S01013418,Rented or living rent free: Private rented or living rent free,29,21,19,3,16,1,1,8,2,0,1,3,2
S01013419,All HRPs aged 16 and over,187,137,115,4,111,19,3,50,45,0,0,3,2
S01013419,Owned: Total,176,129,110,3,107,17,2,47,43,0,0,2,2
S01013419,Owned: Owned outright,72,30,20,2,18,9,1,42,39,0,0,1,2
S01013419,Owned: Owned with a mortgage or loan or shared ownership,104,99,90,1,89,8,1,5,4,0,0,1,0
S01013419,Rented or living rent free: Total,11,8,5,1,4,2,1,3,2,0,0,1,0
S01013419,Rented or living rent free: Social rented,6,3,1,0,1,2,0,3,2,0,0,1,0
S01013419,Rented or living rent free: Private rented or living rent free,5,5,4,1,3,0,1,0,0,0,0,0,0
S01013420,All HRPs aged 16 and over,265,181,164,13,151,8,9,84,69,2,4,8,1
S01013420,Owned: Total,184,139,131,4,127,8,0,45,40,2,0,3,0
S01013420,Owned: Owned outright,47,13,13,1,12,0,0,34,33,0,0,1,0
S01013420,Owned: Owned with a mortgage or loan or shared ownership,137,126,118,3,115,8,0,11,7,2,0,2,0
S01013420,Rented or living rent free: Total,81,42,33,9,24,0,9,39,29,0,4,5,1
S01013420,Rented or living rent free: Social rented,49,20,12,1,11,0,8,29,21,0,2,5,1
S01013420,Rented or living rent free: Private rented or living rent free,32,22,21,8,13,0,1,10,8,0,2,0,0
S01013421,All HRPs aged 16 and over,278,250,219,16,203,28,3,28,17,0,3,7,1
S01013421,Owned: Total,232,218,194,7,187,24,0,14,12,0,1,0,1
S01013421,Owned: Owned outright,30,18,17,4,13,1,0,12,11,0,0,0,1
S01013421,Owned: Owned with a mortgage or loan or shared ownership,202,200,177,3,174,23,0,2,1,0,1,0,0
S01013421,Rented or living rent free: Total,46,32,25,9,16,4,3,14,5,0,2,7,0
S01013421,Rented or living rent free: Social rented,32,18,16,6,10,0,2,14,5,0,2,7,0
S01013421,Rented or living rent free: Private rented or living rent free,14,14,9,3,6,4,1,0,0,0,0,0,0
S01013422,All HRPs aged 16 and over,303,202,181,41,140,14,7,101,79,0,5,12,5
S01013422,Owned: Total,182,136,123,20,103,10,3,46,42,0,1,1,2
S01013422,Owned: Owned outright,74,32,32,13,19,0,0,42,39,0,0,1,2
S01013422,Owned: Owned with a mortgage or loan or shared ownership,108,104,91,7,84,10,3,4,3,0,1,0,0
S01013422,Rented or living rent free: Total,121,66,58,21,37,4,4,55,37,0,4,11,3
S01013422,Rented or living rent free: Social rented,101,54,47,17,30,4,3,47,31,0,4,10,2
S01013422,Rented or living rent free: Private rented or living rent free,20,12,11,4,7,0,1,8,6,0,0,1,1
S01013423,All HRPs aged 16 and over,332,229,190,33,157,27,12,103,83,0,5,12,3
S01013423,Owned: Total,248,187,160,21,139,25,2,61,53,0,3,3,2
S01013423,Owned: Owned outright,93,43,36,9,27,7,0,50,45,0,1,2,2
S01013423,Owned: Owned with a mortgage or loan or shared ownership,155,144,124,12,112,18,2,11,8,0,2,1,0
S01013423,Rented or living rent free: Total,84,42,30,12,18,2,10,42,30,0,2,9,1
S01013423,Rented or living rent free: Social rented,65,34,23,8,15,1,10,31,22,0,1,8,0
S01013423,Rented or living rent free: Private rented or living rent free,19,8,7,4,3,1,0,11,8,0,1,1,1
S01013424,All HRPs aged 16 and over,188,140,123,14,109,17,0,48,44,1,1,1,1
S01013424,Owned: Total,159,125,110,12,98,15,0,34,34,0,0,0,0
S01013424,Owned: Owned outright,56,25,23,6,17,2,0,31,31,0,0,0,0
S01013424,Owned: Owned with a mortgage or loan or shared ownership,103,100,87,6,81,13,0,3,3,0,0,0,0
S01013424,Rented or living rent free: Total,29,15,13,2,11,2,0,14,10,1,1,1,1
S01013424,Rented or living rent free: Social rented,13,3,3,1,2,0,0,10,7,1,1,0,1
S01013424,Rented or living rent free: Private rented or living rent free,16,12,10,1,9,2,0,4,3,0,0,1,0
S01013425,All HRPs aged 16 and over,199,126,109,11,98,12,5,73,61,2,3,6,1
S01013425,Owned: Total,143,103,91,8,83,10,2,40,40,0,0,0,0
S01013425,Owned: Owned outright,54,18,15,2,13,3,0,36,36,0,0,0,0
S01013425,Owned: Owned with a mortgage or loan or shared ownership,89,85,76,6,70,7,2,4,4,0,0,0,0
S01013425,Rented or living rent free: Total,56,23,18,3,15,2,3,33,21,2,3,6,1
S01013425,Rented or living rent free: Social rented,30,7,7,2,5,0,0,23,19,0,0,4,0
S01013425,Rented or living rent free: Private rented or living rent free,26,16,11,1,10,2,3,10,2,2,3,2,1
S01013426,All HRPs aged 16 and over,368,220,185,33,152,23,12,148,106,1,15,22,4
S01013426,Owned: Total,196,134,116,12,104,16,2,62,59,0,1,2,0
S01013426,Owned: Owned outright,84,36,31,7,24,5,0,48,47,0,0,1,0
S01013426,Owned: Owned with a mortgage or loan or shared ownership,112,98,85,5,80,11,2,14,12,0,1,1,0
S01013426,Rented or living rent free: Total,172,86,69,21,48,7,10,86,47,1,14,20,4
S01013426,Rented or living rent free: Social rented,134,64,51,19,32,5,8,70,44,0,6,16,4
S01013426,Rented or living rent free: Private rented or living rent free,38,22,18,2,16,2,2,16,3,1,8,4,0
S01013427,All HRPs aged 16 and over,171,143,123,6,117,19,1,28,18,4,0,4,2
S01013427,Owned: Total,129,116,99,5,94,17,0,13,11,2,0,0,0
S01013427,Owned: Owned outright,31,19,15,0,15,4,0,12,10,2,0,0,0
S01013427,Owned: Owned with a mortgage or loan or shared ownership,98,97,84,5,79,13,0,1,1,0,0,0,0
S01013427,Rented or living rent free: Total,42,27,24,1,23,2,1,15,7,2,0,4,2
S01013427,Rented or living rent free: Social rented,8,1,0,0,0,1,0,7,2,0,0,3,2
S01013427,Rented or living rent free: Private rented or living rent free,34,26,24,1,23,1,1,8,5,2,0,1,0
S01013428,All HRPs aged 16 and over,379,253,206,37,169,28,19,126,63,6,8,46,3
S01013428,Owned: Total,170,135,111,7,104,21,3,35,28,1,0,6,0
S01013428,Owned: Owned outright,58,34,27,2,25,6,1,24,21,0,0,3,0
S01013428,Owned: Owned with a mortgage or loan or shared ownership,112,101,84,5,79,15,2,11,7,1,0,3,0
S01013428,Rented or living rent free: Total,209,118,95,30,65,7,16,91,35,5,8,40,3
S01013428,Rented or living rent free: Social rented,171,90,67,22,45,7,16,81,28,5,8,37,3
S01013428,Rented or living rent free: Private rented or living rent free,38,28,28,8,20,0,0,10,7,0,0,3,0
S01013429,All HRPs aged 16 and over,300,216,184,24,160,21,11,84,62,1,4,15,2
S01013429,Owned: Total,193,153,134,13,121,17,2,40,38,0,0,2,0
S01013429,Owned: Owned outright,56,31,26,7,19,4,1,25,25,0,0,0,0
S01013429,Owned: Owned with a mortgage or loan or shared ownership,137,122,108,6,102,13,1,15,13,0,0,2,0
S01013429,Rented or living rent free: Total,107,63,50,11,39,4,9,44,24,1,4,13,2
S01013429,Rented or living rent free: Social rented,71,33,27,7,20,0,6,38,20,0,4,12,2
S01013429,Rented or living rent free: Private rented or living rent free,36,30,23,4,19,4,3,6,4,1,0,1,0
S01013430,All HRPs aged 16 and over,277,206,177,20,157,23,6,71,58,0,4,8,1
S01013430,Owned: Total,216,172,148,14,134,22,2,44,39,0,1,3,1
S01013430,Owned: Owned outright,69,34,28,10,18,5,1,35,32,0,0,2,1
S01013430,Owned: Owned with a mortgage or loan or shared ownership,147,138,120,4,116,17,1,9,7,0,1,1,0
S01013430,Rented or living rent free: Total,61,34,29,6,23,1,4,27,19,0,3,5,0
S01013430,Rented or living rent free: Social rented,43,22,18,5,13,0,4,21,15,0,2,4,0
S01013430,Rented or living rent free: Private rented or living rent free,18,12,11,1,10,1,0,6,4,0,1,1,0
S01013431,All HRPs aged 16 and over,304,192,147,22,125,27,18,112,90,0,7,13,2
S01013431,Owned: Total,158,107,84,8,76,22,1,51,47,0,0,2,2
S01013431,Owned: Owned outright,69,27,20,3,17,7,0,42,41,0,0,0,1
S01013431,Owned: Owned with a mortgage or loan or shared ownership,89,80,64,5,59,15,1,9,6,0,0,2,1
S01013431,Rented or living rent free: Total,146,85,63,14,49,5,17,61,43,0,7,11,0
S01013431,Rented or living rent free: Social rented,124,75,56,12,44,2,17,49,32,0,6,11,0
S01013431,Rented or living rent free: Private rented or living rent free,22,10,7,2,5,3,0,12,11,0,1,0,0
S01013432,All HRPs aged 16 and over,293,213,165,22,143,37,11,80,52,0,4,15,9
S01013432,Owned: Total,191,149,116,9,107,31,2,42,34,0,2,3,3
S01013432,Owned: Owned outright,77,45,32,4,28,12,1,32,26,0,1,3,2
S01013432,Owned: Owned with a mortgage or loan or shared ownership,114,104,84,5,79,19,1,10,8,0,1,0,1
S01013432,Rented or living rent free: Total,102,64,49,13,36,6,9,38,18,0,2,12,6
S01013432,Rented or living rent free: Social rented,77,45,34,10,24,4,7,32,16,0,1,9,6
S01013432,Rented or living rent free: Private rented or living rent free,25,19,15,3,12,2,2,6,2,0,1,3,0
S01013433,All HRPs aged 16 and over,309,203,164,18,146,37,2,106,91,3,5,6,1
S01013433,Owned: Total,245,172,137,11,126,34,1,73,67,3,1,2,0
S01013433,Owned: Owned outright,102,42,33,7,26,9,0,60,54,3,1,2,0
S01013433,Owned: Owned with a mortgage or loan or shared ownership,143,130,104,4,100,25,1,13,13,0,0,0,0
S01013433,Rented or living rent free: Total,64,31,27,7,20,3,1,33,24,0,4,4,1
S01013433,Rented or living rent free: Social rented,47,22,20,5,15,1,1,25,21,0,1,2,1
S01013433,Rented or living rent free: Private rented or living rent free,17,9,7,2,5,2,0,8,3,0,3,2,0
S01013434,All HRPs aged 16 and over,207,159,101,7,94,56,2,48,41,1,3,2,1
S01013434,Owned: Total,171,138,86,6,80,51,1,33,31,0,1,0,1
S01013434,Owned: Owned outright,76,48,17,2,15,30,1,28,28,0,0,0,0
S01013434,Owned: Owned with a mortgage or loan or shared ownership,95,90,69,4,65,21,0,5,3,0,1,0,1
S01013434,Rented or living rent free: Total,36,21,15,1,14,5,1,15,10,1,2,2,0
S01013434,Rented or living rent free: Social rented,12,7,6,0,6,0,1,5,2,1,1,1,0
S01013434,Rented or living rent free: Private rented or living rent free,24,14,9,1,8,5,0,10,8,0,1,1,0
S01013435,All HRPs aged 16 and over,221,192,158,17,141,34,0,29,27,0,0,0,2
S01013435,Owned: Total,206,179,147,15,132,32,0,27,26,0,0,0,1
S01013435,Owned: Owned outright,80,60,50,8,42,10,0,20,20,0,0,0,0
S01013435,Owned: Owned with a mortgage or loan or shared ownership,126,119,97,7,90,22,0,7,6,0,0,0,1
S01013435,Rented or living rent free: Total,15,13,11,2,9,2,0,2,1,0,0,0,1
S01013435,Rented or living rent free: Social rented,5,3,2,0,2,1,0,2,1,0,0,0,1
S01013435,Rented or living rent free: Private rented or living rent free,10,10,9,2,7,1,0,0,0,0,0,0,0
S01013436,All HRPs aged 16 and over,339,241,211,45,166,25,5,98,80,1,1,13,3
S01013436,Owned: Total,215,170,152,22,130,17,1,45,42,1,1,1,0
S01013436,Owned: Owned outright,77,42,37,9,28,5,0,35,34,1,0,0,0
S01013436,Owned: Owned with a mortgage or loan or shared ownership,138,128,115,13,102,12,1,10,8,0,1,1,0
S01013436,Rented or living rent free: Total,124,71,59,23,36,8,4,53,38,0,0,12,3
S01013436,Rented or living rent free: Social rented,109,59,50,20,30,6,3,50,37,0,0,11,2
S01013436,Rented or living rent free: Private rented or living rent free,15,12,9,3,6,2,1,3,1,0,0,1,1
S01013437,All HRPs aged 16 and over,308,223,203,27,176,17,3,85,62,7,4,9,3
S01013437,Owned: Total,179,143,131,15,116,12,0,36,31,2,2,1,0
S01013437,Owned: Owned outright,60,33,30,7,23,3,0,27,24,2,0,1,0
S01013437,Owned: Owned with a mortgage or loan or shared ownership,119,110,101,8,93,9,0,9,7,0,2,0,0
S01013437,Rented or living rent free: Total,129,80,72,12,60,5,3,49,31,5,2,8,3
S01013437,Rented or living rent free: Social rented,72,33,29,4,25,1,3,39,28,0,1,7,3
S01013437,Rented or living rent free: Private rented or living rent free,57,47,43,8,35,4,0,10,3,5,1,1,0
S01013438,All HRPs aged 16 and over,285,174,132,27,105,31,11,111,80,1,9,14,7
S01013438,Owned: Total,141,91,71,12,59,18,2,50,45,1,1,2,1
S01013438,Owned: Owned outright,59,18,10,2,8,6,2,41,38,0,1,2,0
S01013438,Owned: Owned with a mortgage or loan or shared ownership,82,73,61,10,51,12,0,9,7,1,0,0,1
S01013438,Rented or living rent free: Total,144,83,61,15,46,13,9,61,35,0,8,12,6
S01013438,Rented or living rent free: Social rented,76,33,24,6,18,5,4,43,24,0,5,8,6
S01013438,Rented or living rent free: Private rented or living rent free,68,50,37,9,28,8,5,18,11,0,3,4,0
S01013439,All HRPs aged 16 and over,351,235,202,29,173,31,2,116,115,0,1,0,0
S01013439,Owned: Total,335,221,189,29,160,30,2,114,114,0,0,0,0
S01013439,Owned: Owned outright,192,82,65,22,43,17,0,110,110,0,0,0,0
S01013439,Owned: Owned with a mortgage or loan or shared ownership,143,139,124,7,117,13,2,4,4,0,0,0,0
S01013439,Rented or living rent free: Total,16,14,13,0,13,1,0,2,1,0,1,0,0
S01013439,Rented or living rent free: Social rented,4,2,2,0,2,0,0,2,1,0,1,0,0
S01013439,Rented or living rent free: Private rented or living rent free,12,12,11,0,11,1,0,0,0,0,0,0,0
S01013440,All HRPs aged 16 and over,378,246,206,20,186,40,0,132,123,1,3,2,3
S01013440,Owned: Total,361,237,198,19,179,39,0,124,120,0,2,0,2
S01013440,Owned: Owned outright,198,80,69,13,56,11,0,118,116,0,1,0,1
S01013440,Owned: Owned with a mortgage or loan or shared ownership,163,157,129,6,123,28,0,6,4,0,1,0,1
S01013440,Rented or living rent free: Total,17,9,8,1,7,1,0,8,3,1,1,2,1
S01013440,Rented or living rent free: Social rented,10,4,3,1,2,1,0,6,2,0,1,2,1
S01013440,Rented or living rent free: Private rented or living rent free,7,5,5,0,5,0,0,2,1,1,0,0,0
S01013441,All HRPs aged 16 and over,317,223,177,14,163,43,3,94,87,2,0,2,3
S01013441,Owned: Total,272,186,147,14,133,37,2,86,83,1,0,0,2
S01013441,Owned: Owned outright,157,74,56,9,47,17,1,83,82,1,0,0,0
S01013441,Owned: Owned with a mortgage or loan or shared ownership,115,112,91,5,86,20,1,3,1,0,0,0,2
S01013441,Rented or living rent free: Total,45,37,30,0,30,6,1,8,4,1,0,2,1
S01013441,Rented or living rent free: Social rented,8,7,6,0,6,1,0,1,0,1,0,0,0
S01013441,Rented or living rent free: Private rented or living rent free,37,30,24,0,24,5,1,7,4,0,0,2,1
S01013442,All HRPs aged 16 and over,328,251,217,24,193,31,3,77,60,0,4,11,2
S01013442,Owned: Total,265,215,184,15,169,30,1,50,46,0,1,2,1
S01013442,Owned: Owned outright,105,59,43,7,36,15,1,46,44,0,1,0,1
S01013442,Owned: Owned with a mortgage or loan or shared ownership,160,156,141,8,133,15,0,4,2,0,0,2,0
S01013442,Rented or living rent free: Total,63,36,33,9,24,1,2,27,14,0,3,9,1
S01013442,Rented or living rent free: Social rented,26,13,13,4,9,0,0,13,10,0,1,2,0
S01013442,Rented or living rent free: Private rented or living rent free,37,23,20,5,15,1,2,14,4,0,2,7,1
S01013443,All HRPs aged 16 and over,295,206,175,22,153,27,4,89,78,0,3,5,3
S01013443,Owned: Total,230,157,133,19,114,20,4,73,71,0,0,0,2
S01013443,Owned: Owned outright,114,50,41,11,30,7,2,64,63,0,0,0,1
S01013443,Owned: Owned with a mortgage or loan or shared ownership,116,107,92,8,84,13,2,9,8,0,0,0,1
S01013443,Rented or living rent free: Total,65,49,42,3,39,7,0,16,7,0,3,5,1
S01013443,Rented or living rent free: Social rented,14,1,1,0,1,0,0,13,5,0,3,4,1
S01013443,Rented or living rent free: Private rented or living rent free,51,48,41,3,38,7,0,3,2,0,0,1,0
S01013444,All HRPs aged 16 and over,520,309,242,32,210,48,19,211,176,4,2,20,9
S01013444,Owned: Total,251,161,120,11,109,37,4,90,85,2,0,1,2
S01013444,Owned: Owned outright,107,37,30,6,24,7,0,70,68,0,0,0,2
S01013444,Owned: Owned with a mortgage or loan or shared ownership,144,124,90,5,85,30,4,20,17,2,0,1,0
S01013444,Rented or living rent free: Total,269,148,122,21,101,11,15,121,91,2,2,19,7
S01013444,Rented or living rent free: Social rented,156,57,41,8,33,5,11,99,75,1,2,14,7
S01013444,Rented or living rent free: Private rented or living rent free,113,91,81,13,68,6,4,22,16,1,0,5,0
S01013445,All HRPs aged 16 and over,252,151,123,10,113,27,1,101,97,0,1,2,1
S01013445,Owned: Total,206,141,117,10,107,23,1,65,64,0,0,0,1
S01013445,Owned: Owned outright,111,47,39,7,32,8,0,64,63,0,0,0,1
S01013445,Owned: Owned with a mortgage or loan or shared ownership,95,94,78,3,75,15,1,1,1,0,0,0,0
S01013445,Rented or living rent free: Total,46,10,6,0,6,4,0,36,33,0,1,2,0
S01013445,Rented or living rent free: Social rented,35,2,1,0,1,1,0,33,31,0,0,2,0
S01013445,Rented or living rent free: Private rented or living rent free,11,8,5,0,5,3,0,3,2,0,1,0,0
S01013446,All HRPs aged 16 and over,309,201,179,30,149,17,5,108,92,2,1,8,5
S01013446,Owned: Total,223,147,134,21,113,13,0,76,71,1,0,1,3
S01013446,Owned: Owned outright,106,44,36,11,25,8,0,62,58,0,0,1,3
S01013446,Owned: Owned with a mortgage or loan or shared ownership,117,103,98,10,88,5,0,14,13,1,0,0,0
S01013446,Rented or living rent free: Total,86,54,45,9,36,4,5,32,21,1,1,7,2
S01013446,Rented or living rent free: Social rented,56,30,23,5,18,3,4,26,18,0,1,6,1
S01013446,Rented or living rent free: Private rented or living rent free,30,24,22,4,18,1,1,6,3,1,0,1,1
S01013447,All HRPs aged 16 and over,198,185,159,11,148,25,1,13,11,0,0,2,0
S01013447,Owned: Total,177,167,147,7,140,20,0,10,9,0,0,1,0
S01013447,Owned: Owned outright,41,34,30,1,29,4,0,7,7,0,0,0,0
S01013447,Owned: Owned with a mortgage or loan or shared ownership,136,133,117,6,111,16,0,3,2,0,0,1,0
S01013447,Rented or living rent free: Total,21,18,12,4,8,5,1,3,2,0,0,1,0
S01013447,Rented or living rent free: Social rented,3,3,2,2,0,1,0,0,0,0,0,0,0
S01013447,Rented or living rent free: Private rented or living rent free,18,15,10,2,8,4,1,3,2,0,0,1,0
S01013448,All HRPs aged 16 and over,390,223,184,19,165,34,5,167,157,2,0,7,1
S01013448,Owned: Total,337,185,152,18,134,31,2,152,150,2,0,0,0
S01013448,Owned: Owned outright,219,77,60,14,46,15,2,142,140,2,0,0,0
S01013448,Owned: Owned with a mortgage or loan or shared ownership,118,108,92,4,88,16,0,10,10,0,0,0,0
S01013448,Rented or living rent free: Total,53,38,32,1,31,3,3,15,7,0,0,7,1
S01013448,Rented or living rent free: Social rented,13,4,2,0,2,0,2,9,2,0,0,6,1
S01013448,Rented or living rent free: Private rented or living rent free,40,34,30,1,29,3,1,6,5,0,0,1,0
S01013449,All HRPs aged 16 and over,273,203,177,19,158,25,1,70,68,1,0,1,0
S01013449,Owned: Total,256,189,165,18,147,23,1,67,66,1,0,0,0
S01013449,Owned: Owned outright,121,57,49,8,41,8,0,64,64,0,0,0,0
S01013449,Owned: Owned with a mortgage or loan or shared ownership,135,132,116,10,106,15,1,3,2,1,0,0,0
S01013449,Rented or living rent free: Total,17,14,12,1,11,2,0,3,2,0,0,1,0
S01013449,Rented or living rent free: Social rented,3,1,1,1,0,0,0,2,1,0,0,1,0
S01013449,Rented or living rent free: Private rented or living rent free,14,13,11,0,11,2,0,1,1,0,0,0,0
S01013450,All HRPs aged 16 and over,249,203,186,13,173,15,2,46,42,0,1,1,2
S01013450,Owned: Total,214,173,161,8,153,11,1,41,40,0,0,0,1
S01013450,Owned: Owned outright,70,37,33,5,28,4,0,33,33,0,0,0,0
S01013450,Owned: Owned with a mortgage or loan or shared ownership,144,136,128,3,125,7,1,8,7,0,0,0,1
S01013450,Rented or living rent free: Total,35,30,25,5,20,4,1,5,2,0,1,1,1
S01013450,Rented or living rent free: Social rented,1,0,0,0,0,0,0,1,0,0,0,1,0
S01013450,Rented or living rent free: Private rented or living rent free,34,30,25,5,20,4,1,4,2,0,1,0,1
S01013451,All HRPs aged 16 and over,296,263,222,21,201,34,7,33,26,0,2,4,1
S01013451,Owned: Total,280,251,215,20,195,31,5,29,25,0,1,2,1
S01013451,Owned: Owned outright,96,69,52,14,38,15,2,27,25,0,0,2,0
S01013451,Owned: Owned with a mortgage or loan or shared ownership,184,182,163,6,157,16,3,2,0,0,1,0,1
S01013451,Rented or living rent free: Total,16,12,7,1,6,3,2,4,1,0,1,2,0
S01013451,Rented or living rent free: Social rented,5,4,2,1,1,0,2,1,0,0,0,1,0
S01013451,Rented or living rent free: Private rented or living rent free,11,8,5,0,5,3,0,3,1,0,1,1,0
S01013452,All HRPs aged 16 and over,300,233,194,13,181,36,3,67,59,2,0,6,0
S01013452,Owned: Total,259,205,171,11,160,31,3,54,53,0,0,1,0
S01013452,Owned: Owned outright,116,66,51,7,44,13,2,50,49,0,0,1,0
S01013452,Owned: Owned with a mortgage or loan or shared ownership,143,139,120,4,116,18,1,4,4,0,0,0,0
S01013452,Rented or living rent free: Total,41,28,23,2,21,5,0,13,6,2,0,5,0
S01013452,Rented or living rent free: Social rented,6,3,3,1,2,0,0,3,0,0,0,3,0
S01013452,Rented or living rent free: Private rented or living rent free,35,25,20,1,19,5,0,10,6,2,0,2,0
S01013453,All HRPs aged 16 and over,344,217,176,39,137,17,24,127,88,4,11,21,3
S01013453,Owned: Total,126,88,74,7,67,12,2,38,36,1,0,1,0
S01013453,Owned: Owned outright,56,26,21,4,17,4,1,30,28,1,0,1,0
S01013453,Owned: Owned with a mortgage or loan or shared ownership,70,62,53,3,50,8,1,8,8,0,0,0,0
S01013453,Rented or living rent free: Total,218,129,102,32,70,5,22,89,52,3,11,20,3
S01013453,Rented or living rent free: Social rented,201,115,90,28,62,5,20,86,51,2,10,20,3
S01013453,Rented or living rent free: Private rented or living rent free,17,14,12,4,8,0,2,3,1,1,1,0,0
S01013454,All HRPs aged 16 and over,316,235,196,18,178,36,3,81,72,0,2,6,1
S01013454,Owned: Total,253,194,159,15,144,34,1,59,57,0,0,1,1
S01013454,Owned: Owned outright,99,54,39,7,32,14,1,45,45,0,0,0,0
S01013454,Owned: Owned with a mortgage or loan or shared ownership,154,140,120,8,112,20,0,14,12,0,0,1,1
S01013454,Rented or living rent free: Total,63,41,37,3,34,2,2,22,15,0,2,5,0
S01013454,Rented or living rent free: Social rented,30,13,11,1,10,1,1,17,12,0,1,4,0
S01013454,Rented or living rent free: Private rented or living rent free,33,28,26,2,24,1,1,5,3,0,1,1,0
S01013455,All HRPs aged 16 and over,262,182,146,20,126,28,8,80,72,0,0,5,3
S01013455,Owned: Total,148,99,79,10,69,20,0,49,47,0,0,1,1
S01013455,Owned: Owned outright,72,32,25,6,19,7,0,40,39,0,0,0,1
S01013455,Owned: Owned with a mortgage or loan or shared ownership,76,67,54,4,50,13,0,9,8,0,0,1,0
S01013455,Rented or living rent free: Total,114,83,67,10,57,8,8,31,25,0,0,4,2
S01013455,Rented or living rent free: Social rented,36,18,15,4,11,0,3,18,14,0,0,3,1
S01013455,Rented or living rent free: Private rented or living rent free,78,65,52,6,46,8,5,13,11,0,0,1,1
S01013456,All HRPs aged 16 and over,372,223,183,23,160,24,16,149,120,2,2,15,10
S01013456,Owned: Total,212,148,132,8,124,16,0,64,61,1,1,0,1
S01013456,Owned: Owned outright,72,26,23,2,21,3,0,46,45,0,0,0,1
S01013456,Owned: Owned with a mortgage or loan or shared ownership,140,122,109,6,103,13,0,18,16,1,1,0,0
S01013456,Rented or living rent free: Total,160,75,51,15,36,8,16,85,59,1,1,15,9
S01013456,Rented or living rent free: Social rented,127,49,31,14,17,5,13,78,54,1,0,14,9
S01013456,Rented or living rent free: Private rented or living rent free,33,26,20,1,19,3,3,7,5,0,1,1,0
S01013457,All HRPs aged 16 and over,384,236,202,30,172,16,18,148,104,3,14,20,7
S01013457,Owned: Total,215,146,129,13,116,13,4,69,62,1,0,4,2
S01013457,Owned: Owned outright,85,34,25,5,20,7,2,51,49,0,0,1,1
S01013457,Owned: Owned with a mortgage or loan or shared ownership,130,112,104,8,96,6,2,18,13,1,0,3,1
S01013457,Rented or living rent free: Total,169,90,73,17,56,3,14,79,42,2,14,16,5
S01013457,Rented or living rent free: Social rented,141,74,66,15,51,2,6,67,37,2,10,15,3
S01013457,Rented or living rent free: Private rented or living rent free,28,16,7,2,5,1,8,12,5,0,4,1,2
S01013458,All HRPs aged 16 and over,333,247,198,20,178,33,16,86,71,1,4,10,0
S01013458,Owned: Total,242,183,151,10,141,29,3,59,58,0,1,0,0
S01013458,Owned: Owned outright,97,45,35,6,29,9,1,52,51,0,1,0,0
S01013458,Owned: Owned with a mortgage or loan or shared ownership,145,138,116,4,112,20,2,7,7,0,0,0,0
S01013458,Rented or living rent free: Total,91,64,47,10,37,4,13,27,13,1,3,10,0
S01013458,Rented or living rent free: Social rented,61,39,24,6,18,3,12,22,9,1,3,9,0
S01013458,Rented or living rent free: Private rented or living rent free,30,25,23,4,19,1,1,5,4,0,0,1,0
S01013459,All HRPs aged 16 and over,421,241,212,32,180,22,7,180,135,4,4,30,7
S01013459,Owned: Total,228,164,143,12,131,18,3,64,59,0,0,2,3
S01013459,Owned: Owned outright,86,33,24,5,19,7,2,53,51,0,0,2,0
S01013459,Owned: Owned with a mortgage or loan or shared ownership,142,131,119,7,112,11,1,11,8,0,0,0,3
S01013459,Rented or living rent free: Total,193,77,69,20,49,4,4,116,76,4,4,28,4
S01013459,Rented or living rent free: Social rented,129,41,37,11,26,2,2,88,60,1,4,21,2
S01013459,Rented or living rent free: Private rented or living rent free,64,36,32,9,23,2,2,28,16,3,0,7,2
S01013460,All HRPs aged 16 and over,346,219,191,32,159,20,8,127,93,1,12,15,6
S01013460,Owned: Total,215,141,124,16,108,17,0,74,70,0,0,2,2
S01013460,Owned: Owned outright,88,28,24,7,17,4,0,60,59,0,0,0,1
S01013460,Owned: Owned with a mortgage or loan or shared ownership,127,113,100,9,91,13,0,14,11,0,0,2,1
S01013460,Rented or living rent free: Total,131,78,67,16,51,3,8,53,23,1,12,13,4
S01013460,Rented or living rent free: Social rented,113,67,57,11,46,3,7,46,20,1,8,13,4
S01013460,Rented or living rent free: Private rented or living rent free,18,11,10,5,5,0,1,7,3,0,4,0,0
S01013461,All HRPs aged 16 and over,443,339,285,37,248,30,24,104,76,0,8,14,6
S01013461,Owned: Total,268,226,199,11,188,25,2,42,40,0,0,2,0
S01013461,Owned: Owned outright,60,27,21,2,19,5,1,33,33,0,0,0,0
S01013461,Owned: Owned with a mortgage or loan or shared ownership,208,199,178,9,169,20,1,9,7,0,0,2,0
S01013461,Rented or living rent free: Total,175,113,86,26,60,5,22,62,36,0,8,12,6
S01013461,Rented or living rent free: Social rented,128,79,57,18,39,2,20,49,32,0,4,9,4
S01013461,Rented or living rent free: Private rented or living rent free,47,34,29,8,21,3,2,13,4,0,4,3,2
S01013462,All HRPs aged 16 and over,354,294,256,22,234,30,8,60,47,0,2,10,1
S01013462,Owned: Total,278,244,213,14,199,26,5,34,33,0,0,1,0
S01013462,Owned: Owned outright,57,26,23,8,15,2,1,31,31,0,0,0,0
S01013462,Owned: Owned with a mortgage or loan or shared ownership,221,218,190,6,184,24,4,3,2,0,0,1,0
S01013462,Rented or living rent free: Total,76,50,43,8,35,4,3,26,14,0,2,9,1
S01013462,Rented or living rent free: Social rented,39,22,18,4,14,2,2,17,8,0,1,8,0
S01013462,Rented or living rent free: Private rented or living rent free,37,28,25,4,21,2,1,9,6,0,1,1,1
S01013463,All HRPs aged 16 and over,216,171,141,24,117,14,16,45,17,1,11,14,2
S01013463,Owned: Total,107,95,85,4,81,8,2,12,6,1,3,2,0
S01013463,Owned: Owned outright,26,19,17,1,16,2,0,7,5,0,0,2,0
S01013463,Owned: Owned with a mortgage or loan or shared ownership,81,76,68,3,65,6,2,5,1,1,3,0,0
S01013463,Rented or living rent free: Total,109,76,56,20,36,6,14,33,11,0,8,12,2
S01013463,Rented or living rent free: Social rented,92,63,47,18,29,3,13,29,10,0,5,12,2
S01013463,Rented or living rent free: Private rented or living rent free,17,13,9,2,7,3,1,4,1,0,3,0,0
S01013464,All HRPs aged 16 and over,323,192,170,22,148,21,1,131,118,2,1,8,2
S01013464,Owned: Total,265,158,139,15,124,19,0,107,99,1,0,6,1
S01013464,Owned: Owned outright,147,50,44,9,35,6,0,97,90,1,0,5,1
S01013464,Owned: Owned with a mortgage or loan or shared ownership,118,108,95,6,89,13,0,10,9,0,0,1,0
S01013464,Rented or living rent free: Total,58,34,31,7,24,2,1,24,19,1,1,2,1
S01013464,Rented or living rent free: Social rented,28,15,14,3,11,0,1,13,13,0,0,0,0
S01013464,Rented or living rent free: Private rented or living rent free,30,19,17,4,13,2,0,11,6,1,1,2,1
S01013465,All HRPs aged 16 and over,337,192,165,20,145,21,6,145,126,0,2,13,4
S01013465,Owned: Total,275,161,142,18,124,16,3,114,107,0,0,5,2
S01013465,Owned: Owned outright,144,45,38,10,28,5,2,99,96,0,0,1,2
S01013465,Owned: Owned with a mortgage or loan or shared ownership,131,116,104,8,96,11,1,15,11,0,0,4,0
S01013465,Rented or living rent free: Total,62,31,23,2,21,5,3,31,19,0,2,8,2
S01013465,Rented or living rent free: Social rented,37,16,11,2,9,3,2,21,12,0,1,7,1
S01013465,Rented or living rent free: Private rented or living rent free,25,15,12,0,12,2,1,10,7,0,1,1,1
S01013466,All HRPs aged 16 and over,116,83,58,8,50,21,4,33,31,0,0,1,1
S01013466,Owned: Total,88,59,39,4,35,19,1,29,28,0,0,0,1
S01013466,Owned: Owned outright,54,27,15,3,12,11,1,27,26,0,0,0,1
S01013466,Owned: Owned with a mortgage or loan or shared ownership,34,32,24,1,23,8,0,2,2,0,0,0,0
S01013466,Rented or living rent free: Total,28,24,19,4,15,2,3,4,3,0,0,1,0
S01013466,Rented or living rent free: Social rented,9,7,5,0,5,0,2,2,1,0,0,1,0
S01013466,Rented or living rent free: Private rented or living rent free,19,17,14,4,10,2,1,2,2,0,0,0,0
S01013467,All HRPs aged 16 and over,364,270,237,15,222,30,3,94,85,1,3,5,0
S01013467,Owned: Total,323,244,215,7,208,28,1,79,73,0,3,3,0
S01013467,Owned: Owned outright,95,32,29,2,27,2,1,63,60,0,1,2,0
S01013467,Owned: Owned with a mortgage or loan or shared ownership,228,212,186,5,181,26,0,16,13,0,2,1,0
S01013467,Rented or living rent free: Total,41,26,22,8,14,2,2,15,12,1,0,2,0
S01013467,Rented or living rent free: Social rented,22,10,7,3,4,2,1,12,10,0,0,2,0
S01013467,Rented or living rent free: Private rented or living rent free,19,16,15,5,10,0,1,3,2,1,0,0,0
S01013468,All HRPs aged 16 and over,312,188,148,19,129,25,15,124,102,0,5,16,1
S01013468,Owned: Total,161,125,100,11,89,20,5,36,33,0,0,3,0
S01013468,Owned: Owned outright,68,39,24,7,17,12,3,29,28,0,0,1,0
S01013468,Owned: Owned with a mortgage or loan or shared ownership,93,86,76,4,72,8,2,7,5,0,0,2,0
S01013468,Rented or living rent free: Total,151,63,48,8,40,5,10,88,69,0,5,13,1
S01013468,Rented or living rent free: Social rented,109,38,29,7,22,4,5,71,59,0,2,10,0
S01013468,Rented or living rent free: Private rented or living rent free,42,25,19,1,18,1,5,17,10,0,3,3,1
S01013469,All HRPs aged 16 and over,329,207,168,26,142,34,5,122,113,0,1,7,1
S01013469,Owned: Total,290,185,153,21,132,32,0,105,104,0,0,1,0
S01013469,Owned: Owned outright,149,60,47,11,36,13,0,89,89,0,0,0,0
S01013469,Owned: Owned with a mortgage or loan or shared ownership,141,125,106,10,96,19,0,16,15,0,0,1,0
S01013469,Rented or living rent free: Total,39,22,15,5,10,2,5,17,9,0,1,6,1
S01013469,Rented or living rent free: Social rented,21,9,4,4,0,1,4,12,6,0,1,5,0
S01013469,Rented or living rent free: Private rented or living rent free,18,13,11,1,10,1,1,5,3,0,0,1,1
S01013470,All HRPs aged 16 and over,321,216,180,27,153,17,19,105,64,2,11,23,5
S01013470,Owned: Total,145,110,94,7,87,12,4,35,29,0,2,2,2
S01013470,Owned: Owned outright,59,31,24,4,20,5,2,28,25,0,1,0,2
S01013470,Owned: Owned with a mortgage or loan or shared ownership,86,79,70,3,67,7,2,7,4,0,1,2,0
S01013470,Rented or living rent free: Total,176,106,86,20,66,5,15,70,35,2,9,21,3
S01013470,Rented or living rent free: Social rented,137,77,60,19,41,4,13,60,29,1,9,19,2
S01013470,Rented or living rent free: Private rented or living rent free,39,29,26,1,25,1,2,10,6,1,0,2,1
S01013471,All HRPs aged 16 and over,383,261,228,44,184,25,8,122,87,2,12,16,5
S01013471,Owned: Total,232,175,158,23,135,16,1,57,54,0,0,3,0
S01013471,Owned: Owned outright,98,47,37,11,26,10,0,51,49,0,0,2,0
S01013471,Owned: Owned with a mortgage or loan or shared ownership,134,128,121,12,109,6,1,6,5,0,0,1,0
S01013471,Rented or living rent free: Total,151,86,70,21,49,9,7,65,33,2,12,13,5
S01013471,Rented or living rent free: Social rented,128,70,57,17,40,6,7,58,29,1,12,13,3
S01013471,Rented or living rent free: Private rented or living rent free,23,16,13,4,9,3,0,7,4,1,0,0,2
S01013472,All HRPs aged 16 and over,208,194,164,6,158,27,3,14,9,0,2,3,0
S01013472,Owned: Total,186,176,147,5,142,26,3,10,8,0,1,1,0
S01013472,Owned: Owned outright,31,23,18,2,16,4,1,8,7,0,1,0,0
S01013472,Owned: Owned with a mortgage or loan or shared ownership,155,153,129,3,126,22,2,2,1,0,0,1,0
S01013472,Rented or living rent free: Total,22,18,17,1,16,1,0,4,1,0,1,2,0
S01013472,Rented or living rent free: Social rented,7,4,4,0,4,0,0,3,1,0,0,2,0
S01013472,Rented or living rent free: Private rented or living rent free,15,14,13,1,12,1,0,1,0,0,1,0,0
S01013473,All HRPs aged 16 and over,213,199,169,8,161,28,2,14,11,0,0,3,0
S01013473,Owned: Total,196,184,157,6,151,26,1,12,10,0,0,2,0
S01013473,Owned: Owned outright,29,19,15,3,12,3,1,10,9,0,0,1,0
S01013473,Owned: Owned with a mortgage or loan or shared ownership,167,165,142,3,139,23,0,2,1,0,0,1,0
S01013473,Rented or living rent free: Total,17,15,12,2,10,2,1,2,1,0,0,1,0
S01013473,Rented or living rent free: Social rented,5,5,4,1,3,0,1,0,0,0,0,0,0
S01013473,Rented or living rent free: Private rented or living rent free,12,10,8,1,7,2,0,2,1,0,0,1,0
S01013474,All HRPs aged 16 and over,238,197,172,13,159,24,1,41,33,1,2,2,3
S01013474,Owned: Total,201,171,152,9,143,19,0,30,28,0,0,1,1
S01013474,Owned: Owned outright,40,15,15,2,13,0,0,25,24,0,0,0,1
S01013474,Owned: Owned with a mortgage or loan or shared ownership,161,156,137,7,130,19,0,5,4,0,0,1,0
S01013474,Rented or living rent free: Total,37,26,20,4,16,5,1,11,5,1,2,1,2
S01013474,Rented or living rent free: Social rented,10,4,4,1,3,0,0,6,3,0,2,1,0
S01013474,Rented or living rent free: Private rented or living rent free,27,22,16,3,13,5,1,5,2,1,0,0,2
S01013475,All HRPs aged 16 and over,246,177,143,19,124,25,9,69,57,0,5,6,1
S01013475,Owned: Total,211,150,123,17,106,24,3,61,56,0,1,4,0
S01013475,Owned: Owned outright,96,43,39,11,28,4,0,53,51,0,0,2,0
S01013475,Owned: Owned with a mortgage or loan or shared ownership,115,107,84,6,78,20,3,8,5,0,1,2,0
S01013475,Rented or living rent free: Total,35,27,20,2,18,1,6,8,1,0,4,2,1
S01013475,Rented or living rent free: Social rented,15,9,5,1,4,1,3,6,0,0,3,2,1
S01013475,Rented or living rent free: Private rented or living rent free,20,18,15,1,14,0,3,2,1,0,1,0,0
S01013476,All HRPs aged 16 and over,271,168,141,15,126,20,7,103,83,2,5,8,5
S01013476,Owned: Total,197,120,106,9,97,14,0,77,73,0,2,2,0
S01013476,Owned: Owned outright,101,35,34,6,28,1,0,66,65,0,0,1,0
S01013476,Owned: Owned with a mortgage or loan or shared ownership,96,85,72,3,69,13,0,11,8,0,2,1,0
S01013476,Rented or living rent free: Total,74,48,35,6,29,6,7,26,10,2,3,6,5
S01013476,Rented or living rent free: Social rented,52,30,20,5,15,3,7,22,6,2,3,6,5
S01013476,Rented or living rent free: Private rented or living rent free,22,18,15,1,14,3,0,4,4,0,0,0,0
S01013477,All HRPs aged 16 and over,303,185,150,21,129,24,11,118,85,1,7,17,8
S01013477,Owned: Total,158,110,94,8,86,16,0,48,45,0,0,2,1
S01013477,Owned: Owned outright,67,30,23,5,18,7,0,37,34,0,0,2,1
S01013477,Owned: Owned with a mortgage or loan or shared ownership,91,80,71,3,68,9,0,11,11,0,0,0,0
S01013477,Rented or living rent free: Total,145,75,56,13,43,8,11,70,40,1,7,15,7
S01013477,Rented or living rent free: Social rented,110,49,37,12,25,4,8,61,37,0,3,15,6
S01013477,Rented or living rent free: Private rented or living rent free,35,26,19,1,18,4,3,9,3,1,4,0,1
S01013478,All HRPs aged 16 and over,358,282,236,34,202,32,14,76,41,1,8,20,6
S01013478,Owned: Total,215,197,166,18,148,28,3,18,17,0,0,0,1
S01013478,Owned: Owned outright,48,33,27,7,20,6,0,15,15,0,0,0,0
S01013478,Owned: Owned with a mortgage or loan or shared ownership,167,164,139,11,128,22,3,3,2,0,0,0,1
S01013478,Rented or living rent free: Total,143,85,70,16,54,4,11,58,24,1,8,20,5
S01013478,Rented or living rent free: Social rented,88,48,37,13,24,2,9,40,13,1,6,15,5
S01013478,Rented or living rent free: Private rented or living rent free,55,37,33,3,30,2,2,18,11,0,2,5,0
S01013479,All HRPs aged 16 and over,428,252,209,32,177,19,24,176,133,5,5,23,10
S01013479,Owned: Total,185,131,116,14,102,14,1,54,43,0,0,6,5
S01013479,Owned: Owned outright,73,26,22,6,16,3,1,47,39,0,0,4,4
S01013479,Owned: Owned with a mortgage or loan or shared ownership,112,105,94,8,86,11,0,7,4,0,0,2,1
S01013479,Rented or living rent free: Total,243,121,93,18,75,5,23,122,90,5,5,17,5
S01013479,Rented or living rent free: Social rented,182,71,48,12,36,3,20,111,85,5,4,16,1
S01013479,Rented or living rent free: Private rented or living rent free,61,50,45,6,39,2,3,11,5,0,1,1,4
S01013480,All HRPs aged 16 and over,302,165,143,20,123,16,6,137,122,0,3,7,5
S01013480,Owned: Total,200,105,94,11,83,10,1,95,92,0,0,1,2
S01013480,Owned: Owned outright,112,32,29,5,24,2,1,80,78,0,0,0,2
S01013480,Owned: Owned with a mortgage or loan or shared ownership,88,73,65,6,59,8,0,15,14,0,0,1,0
S01013480,Rented or living rent free: Total,102,60,49,9,40,6,5,42,30,0,3,6,3
S01013480,Rented or living rent free: Social rented,76,44,36,8,28,4,4,32,24,0,0,5,3
S01013480,Rented or living rent free: Private rented or living rent free,26,16,13,1,12,2,1,10,6,0,3,1,0
S01013481,All HRPs aged 16 and over,189,118,92,8,84,20,6,71,65,0,3,2,1
S01013481,Owned: Total,148,97,76,7,69,18,3,51,49,0,1,0,1
S01013481,Owned: Owned outright,74,27,21,5,16,6,0,47,46,0,0,0,1
S01013481,Owned: Owned with a mortgage or loan or shared ownership,74,70,55,2,53,12,3,4,3,0,1,0,0
S01013481,Rented or living rent free: Total,41,21,16,1,15,2,3,20,16,0,2,2,0
S01013481,Rented or living rent free: Social rented,27,11,9,1,8,0,2,16,13,0,1,2,0
S01013481,Rented or living rent free: Private rented or living rent free,14,10,7,0,7,2,1,4,3,0,1,0,0
